Year,Month,Day,Hour,Forecast_Demand_MWh,Adjusted_Demand_MWh,Adjusted_Generation_MWh,Adjusted_Interchange_MWh
2015,7,1,5,449,427,107,-320
2015,7,1,6,418,398,104,-294
2015,7,1,7,397,386,107,-279
2015,7,1,8,389,380,108,-272
2015,7,1,9,391,379,106,-273
2015,7,1,10,413,403,106,-297
2015,7,1,11,450,437,108,-329
2015,7,1,12,493,479,116,-363
2015,7,1,13,521,505,116,-389
2015,7,1,14,552,532,124,-408
2015,7,1,15,582,566,164,-402
2015,7,1,16,600,591,265,-326
2015,7,1,17,619,606,305,-301
2015,7,1,18,643,621,319,-302
2015,7,1,19,659,624,360,-264
2015,7,1,20,661,617,380,-237
2015,7,1,21,679,621,344,-277
2015,7,1,22,689,617,319,-298
2015,7,1,23,679,606,282,-324
2015,7,2,0,658,582,196,-386
2015,7,2,1,633,577,162,-415
2015,7,2,2,623,571,159,-412
2015,7,2,3,569,527,117,-410
2015,7,2,4,504,468,97,-371
2015,7,2,5,451,428,105,-323
2015,7,2,6,419,405,109,-296
2015,7,2,7,399,385,106,-279
2015,7,2,8,392,382,108,-274
2015,7,2,9,392,384,108,-276
2015,7,2,10,411,404,108,-296
2015,7,2,11,450,436,107,-329
2015,7,2,12,487,477,108,-369
2015,7,2,13,516,508,106,-402
2015,7,2,14,549,534,105,-429
2015,7,2,15,577,553,108,-445
2015,7,2,16,593,565,274,-291
2015,7,2,17,606,559,437,-122
2015,7,2,18,625,557,449,-108
2015,7,2,19,638,551,447,-104
2015,7,2,20,638,548,446,-102
2015,7,2,21,650,564,439,-125
2015,7,2,22,655,586,417,-169
2015,7,2,23,643,596,396,-200
2015,7,3,0,622,593,351,-242
2015,7,3,1,604,569,320,-249
2015,7,3,2,595,567,275,-292
2015,7,3,3,552,525,244,-281
2015,7,3,4,492,471,213,-258
2015,7,3,5,442,419,139,-280
2015,7,3,6,405,392,110,-282
2015,7,3,7,389,374,102,-272
2015,7,3,8,378,366,104,-262
2015,7,3,9,377,368,104,-264
2015,7,3,10,383,380,104,-276
2015,7,3,11,398,404,103,-301
2015,7,3,12,424,425,105,-320
2015,7,3,13,465,465,105,-360
2015,7,3,14,510,500,102,-398
2015,7,3,15,547,528,106,-422
2015,7,3,16,562,536,102,-434
2015,7,3,17,581,548,104,-444
2015,7,3,18,590,562,105,-457
2015,7,3,19,591,577,104,-473
2015,7,3,20,599,588,149,-439
2015,7,3,21,606,587,207,-380
2015,7,3,22,606,587,215,-372
2015,7,3,23,587,575,214,-361
2015,7,4,0,562,556,175,-381
2015,7,4,1,534,544,138,-406
2015,7,4,2,519,542,141,-401
2015,7,4,3,498,505,137,-368
2015,7,4,4,456,458,139,-319
2015,7,4,5,415,416,109,-307
2015,7,4,6,383,387,104,-283
2015,7,4,7,365,375,103,-272
2015,7,4,8,357,364,105,-259
2015,7,4,9,353,365,106,-259
2015,7,4,10,355,368,104,-264
2015,7,4,11,359,380,108,-272
2015,7,4,12,376,397,106,-291
2015,7,4,13,423,436,106,-330
2015,7,4,14,478,479,106,-373
2015,7,4,15,512,509,107,-402
2015,7,4,16,540,526,156,-370
2015,7,4,17,555,535,172,-363
2015,7,4,18,564,545,173,-372
2015,7,4,19,568,549,172,-377
2015,7,4,20,574,551,173,-378
2015,7,4,21,586,554,173,-381
2015,7,4,22,590,557,175,-382
2015,7,4,23,579,542,116,-426
2015,7,5,0,554,531,102,-429
2015,7,5,1,529,509,105,-404
2015,7,5,2,529,489,101,-388
2015,7,5,3,499,481,101,-380
2015,7,5,4,456,464,104,-360
2015,7,5,5,412,420,103,-317
2015,7,5,6,383,391,101,-290
2015,7,5,7,361,374,103,-271
2015,7,5,8,354,366,103,-263
2015,7,5,9,351,362,101,-261
2015,7,5,10,353,367,104,-263
2015,7,5,11,357,375,102,-273
2015,7,5,12,380,397,102,-295
2015,7,5,13,431,442,102,-340
2015,7,5,14,475,479,99,-380
2015,7,5,15,493,510,99,-411
2015,7,5,16,511,536,99,-437
2015,7,5,17,531,561,112,-449
2015,7,5,18,540,583,289,-294
2015,7,5,19,545,588,380,-208
2015,7,5,20,544,592,413,-179
2015,7,5,21,551,592,414,-178
2015,7,5,22,562,585,413,-172
2015,7,5,23,559,576,344,-232
2015,7,6,0,551,564,293,-271
2015,7,6,1,539,552,293,-259
2015,7,6,2,532,549,265,-284
2015,7,6,3,495,513,150,-363
2015,7,6,4,449,467,103,-364
2015,7,6,5,422,425,105,-320
2015,7,6,6,394,399,105,-294
2015,7,6,7,377,384,104,-280
2015,7,6,8,371,375,102,-273
2015,7,6,9,376,380,103,-277
2015,7,6,10,401,402,105,-297
2015,7,6,11,444,439,102,-337
2015,7,6,12,487,483,107,-376
2015,7,6,13,520,513,108,-405
2015,7,6,14,555,550,131,-419
2015,7,6,15,587,585,173,-412
2015,7,6,16,613,596,325,-271
2015,7,6,17,630,634,442,-192
2015,7,6,18,663,653,511,-142
2015,7,6,19,675,671,488,-183
2015,7,6,20,685,689,511,-178
2015,7,6,21,695,705,565,-140
2015,7,6,22,697,704,570,-134
2015,7,6,23,691,695,517,-178
2015,7,7,0,679,673,409,-264
2015,7,7,1,657,647,356,-291
2015,7,7,2,635,633,339,-294
2015,7,7,3,578,573,278,-295
2015,7,7,4,508,506,187,-319
2015,7,7,5,462,455,151,-304
2015,7,7,6,429,425,115,-310
2015,7,7,7,407,405,108,-297
2015,7,7,8,398,397,110,-287
2015,7,7,9,400,396,106,-290
2015,7,7,10,421,418,106,-312
2015,7,7,11,464,455,105,-350
2015,7,7,12,502,486,104,-382
2015,7,7,13,534,516,118,-398
2015,7,7,14,567,546,140,-406
2015,7,7,15,601,579,188,-391
2015,7,7,16,625,620,320,-300
2015,7,7,17,654,650,349,-301
2015,7,7,18,687,667,415,-252
2015,7,7,19,707,705,474,-231
2015,7,7,20,721,736,495,-241
2015,7,7,21,735,748,460,-288
2015,7,7,22,729,755,436,-319
2015,7,7,23,722,750,435,-315
2015,7,8,0,700,729,425,-304
2015,7,8,1,670,702,400,-302
2015,7,8,2,653,681,287,-394
2015,7,8,3,596,617,215,-402
2015,7,8,4,523,547,156,-391
2015,7,8,5,489,495,121,-374
2015,7,8,6,454,458,105,-356
2015,7,8,7,428,436,107,-332
2015,7,8,8,420,425,105,-323
2015,7,8,9,420,422,106,-319
2015,7,8,10,438,436,103,-336
2015,7,8,11,477,480,107,-376
2015,7,8,12,516,521,119,-402
2015,7,8,13,552,551,148,-403
2015,7,8,14,598,584,223,-361
2015,7,8,15,635,628,232,-396
2015,7,8,16,666,668,441,-227
2015,7,8,17,695,699,504,-195
2015,7,8,18,724,732,567,-165
2015,7,8,19,747,730,599,-131
2015,7,8,20,760,746,606,-140
2015,7,8,21,768,758,601,-157
2015,7,8,22,766,765,559,-206
2015,7,8,23,755,751,503,-248
2015,7,9,0,728,735,458,-277
2015,7,9,1,699,710,401,-309
2015,7,9,2,684,695,322,-373
2015,7,9,3,626,635,256,-379
2015,7,9,4,553,555,186,-369
2015,7,9,5,504,504,125,-379
2015,7,9,6,466,460,118,-345
2015,7,9,7,440,438,106,-335
2015,7,9,8,429,425,106,-322
2015,7,9,9,428,422,105,-320
2015,7,9,10,444,440,115,-328
2015,7,9,11,484,477,118,-362
2015,7,9,12,521,518,137,-381
2015,7,9,13,555,556,168,-388
2015,7,9,14,597,606,198,-408
2015,7,9,15,632,643,244,-399
2015,7,9,16,661,671,390,-281
2015,7,9,17,696,718,417,-301
2015,7,9,18,728,753,552,-201
2015,7,9,19,749,782,677,-105
2015,7,9,20,765,802,704,-98
2015,7,9,21,775,805,756,-49
2015,7,9,22,774,811,756,-55
2015,7,9,23,757,803,758,-45
2015,7,10,0,733,770,726,-44
2015,7,10,1,706,731,558,-173
2015,7,10,2,690,702,535,-167
2015,7,10,3,630,637,441,-196
2015,7,10,4,556,564,376,-188
2015,7,10,5,508,496,338,-158
2015,7,10,6,469,459,242,-217
2015,7,10,7,445,433,142,-291
2015,7,10,8,432,423,106,-317
2015,7,10,9,431,421,104,-317
2015,7,10,10,445,438,104,-334
2015,7,10,11,479,470,103,-367
2015,7,10,12,519,513,119,-394
2015,7,10,13,555,554,146,-408
2015,7,10,14,598,597,201,-396
2015,7,10,15,635,637,303,-334
2015,7,10,16,665,680,391,-289
2015,7,10,17,698,705,437,-268
2015,7,10,18,722,731,532,-199
2015,7,10,19,737,756,575,-181
2015,7,10,20,754,782,598,-184
2015,7,10,21,755,792,621,-171
2015,7,10,22,750,803,657,-146
2015,7,10,23,727,783,614,-169
2015,7,11,0,699,748,469,-279
2015,7,11,1,670,706,469,-237
2015,7,11,2,661,685,470,-215
2015,7,11,3,616,623,340,-283
2015,7,11,4,550,556,262,-294
2015,7,11,5,497,487,176,-311
2015,7,11,6,459,455,106,-352
2015,7,11,7,436,426,102,-327
2015,7,11,8,422,417,105,-315
2015,7,11,9,416,415,104,-314
2015,7,11,10,421,417,102,-318
2015,7,11,11,429,433,104,-332
2015,7,11,12,452,456,100,-359
2015,7,11,13,500,511,142,-369
2015,7,11,14,550,554,178,-376
2015,7,11,15,593,595,246,-349
2015,7,11,16,624,632,316,-316
2015,7,11,17,650,646,343,-303
2015,7,11,18,670,671,413,-258
2015,7,11,19,696,690,446,-244
2015,7,11,20,722,706,471,-235
2015,7,11,21,732,727,474,-253
2015,7,11,22,734,726,472,-254
2015,7,11,23,714,713,381,-332
2015,7,12,0,688,686,296,-390
2015,7,12,1,662,663,273,-390
2015,7,12,2,657,653,271,-382
2015,7,12,3,603,610,272,-338
2015,7,12,4,545,546,213,-333
2015,7,12,5,494,492,133,-359
2015,7,12,6,456,455,105,-353
2015,7,12,7,427,428,103,-328
2015,7,12,8,411,413,105,-311
2015,7,12,9,402,398,104,-297
2015,7,12,10,401,402,104,-301
2015,7,12,11,406,402,103,-302
2015,7,12,12,428,432,109,-326
2015,7,12,13,485,485,112,-373
2015,7,12,14,537,536,111,-425
2015,7,12,15,566,577,112,-465
2015,7,12,16,595,605,127,-478
2015,7,12,17,630,622,158,-464
2015,7,12,18,654,633,202,-431
2015,7,12,19,676,631,238,-393
2015,7,12,20,689,647,262,-385
2015,7,12,21,701,680,254,-426
2015,7,12,22,702,697,252,-445
2015,7,12,23,691,699,243,-456
2015,7,13,0,672,678,240,-438
2015,7,13,1,649,652,186,-466
2015,7,13,2,639,645,169,-476
2015,7,13,3,582,595,125,-470
2015,7,13,4,526,536,104,-432
2015,7,13,5,490,485,101,-384
2015,7,13,6,453,449,102,-347
2015,7,13,7,429,432,103,-329
2015,7,13,8,420,419,100,-319
2015,7,13,9,421,421,102,-319
2015,7,13,10,440,441,99,-342
2015,7,13,11,477,485,102,-383
2015,7,13,12,521,532,130,-402
2015,7,13,13,571,557,161,-396
2015,7,13,14,617,589,188,-401
2015,7,13,15,662,611,213,-398
2015,7,13,16,693,648,247,-401
2015,7,13,17,721,687,287,-400
2015,7,13,18,750,730,328,-402
2015,7,13,19,767,760,350,-410
2015,7,13,20,781,786,366,-420
2015,7,13,21,793,806,390,-416
2015,7,13,22,799,810,392,-418
2015,7,13,23,786,791,376,-415
2015,7,14,0,762,744,346,-398
2015,7,14,1,733,677,284,-393
2015,7,14,2,707,640,275,-365
2015,7,14,3,643,583,221,-362
2015,7,14,4,563,524,139,-385
2015,7,14,5,504,477,111,-366
2015,7,14,6,466,444,110,-334
2015,7,14,7,441,427,110,-317
2015,7,14,8,430,413,102,-311
2015,7,14,9,432,419,104,-315
2015,7,14,10,448,439,102,-337
2015,7,14,11,486,486,107,-379
2015,7,14,12,530,525,140,-385
2015,7,14,13,565,536,153,-383
2015,7,14,14,607,562,177,-385
2015,7,14,15,646,565,238,-327
2015,7,14,16,675,570,263,-307
2015,7,14,17,712,579,311,-268
2015,7,14,18,734,588,432,-156
2015,7,14,19,751,598,450,-148
2015,7,14,20,771,604,450,-154
2015,7,14,21,780,606,447,-159
2015,7,14,22,777,609,450,-159
2015,7,14,23,770,606,452,-154
2015,7,15,0,750,596,454,-142
2015,7,15,1,718,587,452,-135
2015,7,15,2,701,575,445,-130
2015,7,15,3,636,527,330,-197
2015,7,15,4,567,482,223,-259
2015,7,15,5,491,439,178,-261
2015,7,15,6,457,417,121,-296
2015,7,15,7,437,406,109,-297
2015,7,15,8,429,403,107,-296
2015,7,15,9,431,408,108,-300
2015,7,15,10,450,430,106,-324
2015,7,15,11,488,471,107,-364
2015,7,15,12,533,514,116,-398
2015,7,15,13,564,544,150,-394
2015,7,15,14,602,572,180,-392
2015,7,15,15,637,598,210,-388
2015,7,15,16,659,611,243,-368
2015,7,15,17,683,612,256,-356
2015,7,15,18,705,623,265,-358
2015,7,15,19,717,635,275,-360
2015,7,15,20,727,648,279,-369
2015,7,15,21,735,667,303,-364
2015,7,15,22,731,664,313,-351
2015,7,15,23,716,661,300,-361
2015,7,16,0,684,643,293,-350
2015,7,16,1,660,629,295,-334
2015,7,16,2,649,626,294,-332
2015,7,16,3,592,573,256,-317
2015,7,16,4,526,512,168,-344
2015,7,16,5,468,463,116,-347
2015,7,16,6,435,428,104,-324
2015,7,16,7,415,410,105,-305
2015,7,16,8,405,403,107,-296
2015,7,16,9,405,399,104,-295
2015,7,16,10,426,420,103,-317
2015,7,16,11,469,461,108,-353
2015,7,16,12,506,501,157,-344
2015,7,16,13,535,532,202,-330
2015,7,16,14,569,557,208,-349
2015,7,16,15,607,593,212,-381
2015,7,16,16,625,630,321,-309
2015,7,16,17,652,650,340,-310
2015,7,16,18,680,680,401,-279
2015,7,16,19,694,704,411,-293
2015,7,16,20,702,724,429,-295
2015,7,16,21,710,744,445,-299
2015,7,16,22,707,750,447,-303
2015,7,16,23,701,741,404,-337
2015,7,17,0,678,718,378,-340
2015,7,17,1,656,690,378,-312
2015,7,17,2,646,677,379,-298
2015,7,17,3,588,614,374,-240
2015,7,17,4,524,540,325,-215
2015,7,17,5,494,490,232,-258
2015,7,17,6,459,453,154,-299
2015,7,17,7,439,436,121,-315
2015,7,17,8,429,423,120,-303
2015,7,17,9,430,427,110,-317
2015,7,17,10,447,444,109,-335
2015,7,17,11,486,484,118,-366
2015,7,17,12,526,520,132,-388
2015,7,17,13,559,550,144,-406
2015,7,17,14,597,597,186,-411
2015,7,17,15,631,633,223,-410
2015,7,17,16,661,667,261,-406
2015,7,17,17,686,702,297,-405
2015,7,17,18,708,735,363,-372
2015,7,17,19,723,750,375,-375
2015,7,17,20,732,783,571,-212
2015,7,17,21,738,791,606,-185
2015,7,17,22,731,797,567,-230
2015,7,17,23,715,783,488,-295
2015,7,18,0,681,756,414,-342
2015,7,18,1,654,720,331,-389
2015,7,18,2,646,702,297,-405
2015,7,18,3,599,644,243,-401
2015,7,18,4,544,579,190,-389
2015,7,18,5,502,515,122,-393
2015,7,18,6,465,482,104,-378
2015,7,18,7,441,454,103,-351
2015,7,18,8,429,431,103,-328
2015,7,18,9,423,420,103,-317
2015,7,18,10,427,426,103,-323
2015,7,18,11,438,440,104,-336
2015,7,18,12,465,461,103,-358
2015,7,18,13,508,518,114,-404
2015,7,18,14,564,575,168,-407
2015,7,18,15,613,632,232,-400
2015,7,18,16,648,676,410,-266
2015,7,18,17,668,699,444,-255
2015,7,18,18,688,715,444,-271
2015,7,18,19,701,723,444,-279
2015,7,18,20,713,717,449,-268
2015,7,18,21,727,695,448,-247
2015,7,18,22,729,683,447,-236
2015,7,18,23,718,684,392,-292
2015,7,19,0,689,675,350,-325
2015,7,19,1,670,652,287,-365
2015,7,19,2,661,645,270,-375
2015,7,19,3,608,595,260,-335
2015,7,19,4,550,536,184,-352
2015,7,19,5,506,485,116,-369
2015,7,19,6,470,448,106,-342
2015,7,19,7,444,425,105,-320
2015,7,19,8,431,416,108,-308
2015,7,19,9,424,404,105,-299
2015,7,19,10,421,411,108,-303
2015,7,19,11,429,418,106,-312
2015,7,19,12,454,442,107,-335
2015,7,19,13,510,492,106,-386
2015,7,19,14,567,540,135,-405
2015,7,19,15,607,580,177,-403
2015,7,19,16,641,613,219,-394
2015,7,19,17,672,633,327,-306
2015,7,19,18,703,677,524,-153
2015,7,19,19,722,704,537,-167
2015,7,19,20,731,728,588,-140
2015,7,19,21,745,743,561,-182
2015,7,19,22,743,751,474,-277
2015,7,19,23,736,738,410,-328
2015,7,20,0,709,713,309,-404
2015,7,20,1,692,686,283,-403
2015,7,20,2,675,667,265,-402
2015,7,20,3,618,614,213,-401
2015,7,20,4,560,550,155,-395
2015,7,20,5,504,496,107,-389
2015,7,20,6,466,462,101,-361
2015,7,20,7,446,446,103,-343
2015,7,20,8,436,432,104,-328
2015,7,20,9,438,430,101,-329
2015,7,20,10,455,452,102,-350
2015,7,20,11,495,496,111,-385
2015,7,20,12,540,540,175,-365
2015,7,20,13,579,584,204,-380
2015,7,20,14,627,628,240,-388
2015,7,20,15,673,663,304,-359
2015,7,20,16,719,705,484,-221
2015,7,20,17,749,749,543,-206
2015,7,20,18,774,775,575,-200
2015,7,20,19,789,805,579,-226
2015,7,20,20,804,818,587,-231
2015,7,20,21,810,804,592,-212
2015,7,20,22,806,776,593,-183
2015,7,20,23,806,774,593,-181
2015,7,21,0,780,738,591,-147
2015,7,21,1,756,704,391,-313
2015,7,21,2,731,666,366,-300
2015,7,21,3,668,606,342,-264
2015,7,21,4,595,539,203,-336
2015,7,21,5,538,498,111,-387
2015,7,21,6,493,468,111,-357
2015,7,21,7,466,448,108,-340
2015,7,21,8,452,440,108,-332
2015,7,21,9,449,438,106,-332
2015,7,21,10,464,462,107,-355
2015,7,21,11,500,506,114,-392
2015,7,21,12,540,553,198,-355
2015,7,21,13,576,584,252,-332
2015,7,21,14,622,615,261,-354
2015,7,21,15,661,643,318,-325
2015,7,21,16,705,680,524,-156
2015,7,21,17,752,712,557,-155
2015,7,21,18,780,749,564,-185
2015,7,21,19,799,753,707,-46
2015,7,21,20,813,762,686,-76
2015,7,21,21,825,751,727,-24
2015,7,21,22,820,740,670,-70
2015,7,21,23,813,737,512,-225
2015,7,22,0,792,730,363,-367
2015,7,22,1,756,702,324,-378
2015,7,22,2,732,681,314,-367
2015,7,22,3,662,625,311,-314
2015,7,22,4,588,550,211,-339
2015,7,22,5,510,502,110,-392
2015,7,22,6,472,471,104,-367
2015,7,22,7,448,448,102,-346
2015,7,22,8,437,437,102,-335
2015,7,22,9,434,436,104,-332
2015,7,22,10,451,454,103,-351
2015,7,22,11,491,492,105,-387
2015,7,22,12,530,535,156,-379
2015,7,22,13,561,558,192,-366
2015,7,22,14,600,603,234,-369
2015,7,22,15,634,640,284,-356
2015,7,22,16,664,673,380,-293
2015,7,22,17,696,700,393,-307
2015,7,22,18,720,729,455,-274
2015,7,22,19,734,752,527,-225
2015,7,22,20,745,776,529,-247
2015,7,22,21,755,789,561,-228
2015,7,22,22,753,800,594,-206
2015,7,22,23,738,782,596,-186
2015,7,23,0,717,754,508,-246
2015,7,23,1,684,722,375,-347
2015,7,23,2,667,707,374,-333
2015,7,23,3,604,642,361,-281
2015,7,23,4,540,568,229,-339
2015,7,23,5,501,516,126,-390
2015,7,23,6,465,484,103,-381
2015,7,23,7,440,467,108,-359
2015,7,23,8,429,452,109,-343
2015,7,23,9,427,452,110,-342
2015,7,23,10,446,474,109,-365
2015,7,23,11,490,512,109,-403
2015,7,23,12,528,549,109,-440
2015,7,23,13,558,578,110,-468
2015,7,23,14,593,615,147,-468
2015,7,23,15,623,650,179,-471
2015,7,23,16,643,678,239,-439
2015,7,23,17,671,693,252,-441
2015,7,23,18,688,696,249,-447
2015,7,23,19,699,668,248,-420
2015,7,23,20,706,661,248,-413
2015,7,23,21,712,658,249,-409
2015,7,23,22,706,659,248,-411
2015,7,23,23,691,652,197,-455
2015,7,24,0,677,641,172,-469
2015,7,24,1,653,640,164,-476
2015,7,24,2,637,631,153,-478
2015,7,24,3,576,583,134,-449
2015,7,24,4,517,528,108,-420
2015,7,24,5,482,487,106,-381
2015,7,24,6,449,455,104,-351
2015,7,24,7,427,441,105,-336
2015,7,24,8,417,427,103,-324
2015,7,24,9,419,429,104,-325
2015,7,24,10,439,452,104,-348
2015,7,24,11,479,494,103,-391
2015,7,24,12,518,533,105,-428
2015,7,24,13,549,560,105,-455
2015,7,24,14,588,591,139,-452
2015,7,24,15,611,628,182,-446
2015,7,24,16,634,644,237,-407
2015,7,24,17,672,659,236,-423
2015,7,24,18,694,683,244,-439
2015,7,24,19,711,703,262,-441
2015,7,24,20,722,711,317,-394
2015,7,24,21,726,714,329,-385
2015,7,24,22,717,723,334,-389
2015,7,24,23,697,704,296,-408
2015,7,25,0,670,682,262,-420
2015,7,25,1,641,663,263,-400
2015,7,25,2,626,637,221,-416
2015,7,25,3,577,595,125,-470
2015,7,25,4,520,534,103,-431
2015,7,25,5,486,482,103,-379
2015,7,25,6,450,447,102,-345
2015,7,25,7,425,430,102,-328
2015,7,25,8,411,413,104,-309
2015,7,25,9,407,413,105,-308
2015,7,25,10,416,415,103,-312
2015,7,25,11,427,430,103,-327
2015,7,25,12,451,451,102,-349
2015,7,25,13,500,497,104,-393
2015,7,25,14,543,542,103,-439
2015,7,25,15,579,593,126,-467
2015,7,25,16,609,638,241,-397
2015,7,25,17,630,662,279,-383
2015,7,25,18,641,686,312,-374
2015,7,25,19,658,704,347,-357
2015,7,25,20,676,719,429,-290
2015,7,25,21,685,725,445,-280
2015,7,25,22,689,723,448,-275
2015,7,25,23,686,698,396,-302
2015,7,26,0,660,676,378,-298
2015,7,26,1,637,646,311,-335
2015,7,26,2,626,640,224,-416
2015,7,26,3,576,595,130,-465
2015,7,26,4,519,538,102,-436
2015,7,26,5,487,490,102,-388
2015,7,26,6,449,450,100,-350
2015,7,26,7,424,431,102,-329
2015,7,26,8,409,412,100,-312
2015,7,26,9,402,406,101,-305
2015,7,26,10,404,410,102,-308
2015,7,26,11,413,414,102,-312
2015,7,26,12,436,437,104,-333
2015,7,26,13,494,487,103,-384
2015,7,26,14,540,535,104,-431
2015,7,26,15,573,577,107,-470
2015,7,26,16,602,619,147,-472
2015,7,26,17,630,651,183,-468
2015,7,26,18,655,681,260,-421
2015,7,26,19,677,706,322,-384
2015,7,26,20,700,726,375,-351
2015,7,26,21,716,745,373,-372
2015,7,26,22,723,756,375,-381
2015,7,26,23,718,739,374,-365
2015,7,27,0,695,719,375,-344
2015,7,27,1,673,693,378,-315
2015,7,27,2,654,662,371,-291
2015,7,27,3,595,608,348,-260
2015,7,27,4,534,542,339,-203
2015,7,27,5,487,489,174,-315
2015,7,27,6,452,461,108,-353
2015,7,27,7,432,443,106,-337
2015,7,27,8,421,422,106,-316
2015,7,27,9,423,428,108,-320
2015,7,27,10,443,447,106,-341
2015,7,27,11,485,491,109,-382
2015,7,27,12,526,527,144,-383
2015,7,27,13,563,561,173,-388
2015,7,27,14,609,585,222,-363
2015,7,27,15,644,621,286,-335
2015,7,27,16,678,649,291,-358
2015,7,27,17,711,715,442,-273
2015,7,27,18,743,749,416,-333
2015,7,27,19,760,774,421,-353
2015,7,27,20,778,789,424,-365
2015,7,27,21,786,789,328,-461
2015,7,27,22,787,787,265,-522
2015,7,27,23,782,770,265,-505
2015,7,28,0,756,747,268,-479
2015,7,28,1,729,719,289,-430
2015,7,28,2,700,615,183,-432
2015,7,28,3,634,632,160,-472
2015,7,28,4,567,573,120,-453
2015,7,28,5,504,521,134,-387
2015,7,28,6,468,487,103,-384
2015,7,28,7,447,463,106,-357
2015,7,28,8,436,446,104,-342
2015,7,28,9,437,448,105,-343
2015,7,28,10,456,469,106,-363
2015,7,28,11,500,514,139,-375
2015,7,28,12,540,549,154,-395
2015,7,28,13,573,582,178,-404
2015,7,28,14,610,617,215,-402
2015,7,28,15,645,665,260,-405
2015,7,28,16,679,783,498,-285
2015,7,28,17,702,419,231,-188
2015,7,28,18,729,409,231,-178
2015,7,28,19,739,433,235,-198
2015,7,28,20,750,446,202,-244
2015,7,28,21,756,827,586,-241
2015,7,28,22,754,454,217,-237
2015,7,28,23,745,425,164,-261
2015,7,29,0,722,392,144,-248
2015,7,29,1,703,408,141,-267
2015,7,29,2,678,414,66,-348
2015,7,29,3,614,403,5,-398
2015,7,29,4,551,395,5,-390
2015,7,29,5,510,524,127,-397
2015,7,29,6,475,493,106,-387
2015,7,29,7,454,462,103,-359
2015,7,29,8,444,451,101,-350
2015,7,29,9,443,450,102,-348
2015,7,29,10,465,468,102,-366
2015,7,29,11,506,513,109,-404
2015,7,29,12,545,545,143,-402
2015,7,29,13,580,584,180,-404
2015,7,29,14,617,618,222,-396
2015,7,29,15,659,670,281,-389
2015,7,29,16,695,705,526,-179
2015,7,29,17,714,743,607,-136
2015,7,29,18,740,746,612,-134
2015,7,29,19,755,761,608,-153
2015,7,29,20,763,782,602,-180
2015,7,29,21,772,804,605,-199
2015,7,29,22,771,799,604,-195
2015,7,29,23,763,792,561,-231
2015,7,30,0,736,762,538,-224
2015,7,30,1,721,728,535,-193
2015,7,30,2,701,715,529,-186
2015,7,30,3,635,645,347,-298
2015,7,30,4,570,574,300,-274
2015,7,30,5,520,523,231,-292
2015,7,30,6,483,486,153,-333
2015,7,30,7,460,464,105,-359
2015,7,30,8,448,451,106,-345
2015,7,30,9,447,449,105,-344
2015,7,30,10,467,468,104,-364
2015,7,30,11,510,508,110,-398
2015,7,30,12,549,545,145,-400
2015,7,30,13,586,576,174,-402
2015,7,30,14,621,620,216,-404
2015,7,30,15,662,665,265,-400
2015,7,30,16,699,711,421,-290
2015,7,30,17,725,751,516,-235
2015,7,30,18,754,790,608,-182
2015,7,30,19,773,813,605,-208
2015,7,30,20,782,832,605,-227
2015,7,30,21,792,856,609,-247
2015,7,30,22,792,849,605,-244
2015,7,30,23,779,826,543,-283
2015,7,31,0,753,801,527,-274
2015,7,31,1,728,768,533,-235
2015,7,31,2,698,752,429,-323
2015,7,31,3,635,677,285,-392
2015,7,31,4,567,608,210,-398
2015,7,31,5,508,545,143,-402
2015,7,31,6,468,508,112,-396
2015,7,31,7,441,479,104,-375
2015,7,31,8,425,461,105,-356
2015,7,31,9,424,453,105,-348
2015,7,31,10,441,463,105,-358
2015,7,31,11,480,495,105,-390
2015,7,31,12,511,526,126,-400
2015,7,31,13,542,562,162,-400
2015,7,31,14,573,595,196,-399
2015,7,31,15,599,629,227,-402
2015,7,31,16,628,592,226,-366
2015,7,31,17,656,616,260,-356
2015,7,31,18,673,646,305,-341
2015,7,31,19,686,720,360,-360
2015,7,31,20,711,741,357,-384
2015,7,31,21,722,764,410,-354
2015,7,31,22,717,754,471,-283
2015,7,31,23,692,735,472,-263
2015,8,1,0,665,695,472,-223
2015,8,1,1,631,799,454,-345
2015,8,1,2,608,665,266,-399
2015,8,1,3,574,582,195,-387
2015,8,1,4,513,520,133,-387
2015,8,1,5,479,471,105,-366
2015,8,1,6,441,439,103,-336
2015,8,1,7,417,416,100,-316
2015,8,1,8,402,405,100,-305
2015,8,1,9,397,398,99,-299
2015,8,1,10,404,402,102,-300
2015,8,1,11,414,410,100,-310
2015,8,1,12,434,434,101,-333
2015,8,1,13,477,481,107,-374
2015,8,1,14,521,522,121,-401
2015,8,1,15,556,567,162,-405
2015,8,1,16,590,598,268,-330
2015,8,1,17,613,621,435,-186
2015,8,1,18,633,636,446,-190
2015,8,1,19,664,652,443,-209
2015,8,1,20,686,681,445,-236
2015,8,1,21,709,700,446,-254
2015,8,1,22,715,705,444,-261
2015,8,1,23,698,700,407,-293
2015,8,2,0,665,670,375,-295
2015,8,2,1,635,634,376,-258
2015,8,2,2,620,608,366,-242
2015,8,2,3,571,552,244,-308
2015,8,2,4,507,494,146,-348
2015,8,2,5,451,441,106,-335
2015,8,2,6,417,410,101,-309
2015,8,2,7,395,388,100,-288
2015,8,2,8,382,378,98,-280
2015,8,2,9,377,376,100,-276
2015,8,2,10,382,372,98,-274
2015,8,2,11,386,383,99,-284
2015,8,2,12,409,402,95,-307
2015,8,2,13,458,455,96,-359
2015,8,2,14,499,496,187,-309
2015,8,2,15,521,523,216,-307
2015,8,2,16,546,551,222,-329
2015,8,2,17,578,586,220,-366
2015,8,2,18,592,604,228,-376
2015,8,2,19,610,646,293,-353
2015,8,2,20,629,672,432,-240
2015,8,2,21,650,694,536,-158
2015,8,2,22,659,709,541,-168
2015,8,2,23,653,703,540,-163
2015,8,3,0,629,672,541,-131
2015,8,3,1,609,653,542,-111
2015,8,3,2,595,637,482,-155
2015,8,3,3,547,580,289,-291
2015,8,3,4,487,518,194,-324
2015,8,3,5,453,467,126,-341
2015,8,3,6,422,433,104,-329
2015,8,3,7,404,417,103,-314
2015,8,3,8,394,405,104,-301
2015,8,3,9,398,407,108,-299
2015,8,3,10,421,427,107,-320
2015,8,3,11,466,463,106,-357
2015,8,3,12,506,499,106,-393
2015,8,3,13,539,530,115,-415
2015,8,3,14,578,556,155,-401
2015,8,3,15,612,599,194,-405
2015,8,3,16,649,630,247,-383
2015,8,3,17,672,674,339,-335
2015,8,3,18,699,710,371,-339
2015,8,3,19,720,739,381,-358
2015,8,3,20,736,767,410,-357
2015,8,3,21,740,792,425,-367
2015,8,3,22,736,800,437,-363
2015,8,3,23,721,791,431,-360
2015,8,4,0,697,757,430,-327
2015,8,4,1,684,720,413,-307
2015,8,4,2,652,691,380,-311
2015,8,4,3,596,615,248,-367
2015,8,4,4,526,542,242,-300
2015,8,4,5,481,481,168,-313
2015,8,4,6,449,447,102,-345
2015,8,4,7,428,428,99,-329
2015,8,4,8,417,414,100,-314
2015,8,4,9,418,413,100,-313
2015,8,4,10,439,437,101,-336
2015,8,4,11,482,472,99,-373
2015,8,4,12,520,505,105,-400
2015,8,4,13,553,538,133,-405
2015,8,4,14,587,574,177,-397
2015,8,4,15,624,600,207,-393
2015,8,4,16,657,660,305,-355
2015,8,4,17,686,697,508,-189
2015,8,4,18,718,747,723,-24
2015,8,4,19,740,766,766,0
2015,8,4,20,762,769,752,-17
2015,8,4,21,771,772,749,-23
2015,8,4,22,763,780,750,-30
2015,8,4,23,751,778,702,-76
2015,8,5,0,728,761,690,-71
2015,8,5,1,715,731,531,-200
2015,8,5,2,677,701,509,-192
2015,8,5,3,618,630,411,-219
2015,8,5,4,549,562,247,-315
2015,8,5,5,497,505,184,-321
2015,8,5,6,465,471,113,-358
2015,8,5,7,442,450,102,-348
2015,8,5,8,431,438,104,-334
2015,8,5,9,431,438,102,-336
2015,8,5,10,450,453,103,-350
2015,8,5,11,492,496,104,-392
2015,8,5,12,530,530,131,-399
2015,8,5,13,559,554,158,-396
2015,8,5,14,597,588,192,-396
2015,8,5,15,641,634,274,-360
2015,8,5,16,674,681,398,-283
2015,8,5,17,703,723,534,-189
2015,8,5,18,735,770,677,-93
2015,8,5,19,759,775,755,-20
2015,8,5,20,777,797,758,-39
2015,8,5,21,787,787,762,-25
2015,8,5,22,785,749,737,-12
2015,8,5,23,769,713,684,-29
2015,8,6,0,740,691,625,-66
2015,8,6,1,725,664,501,-163
2015,8,6,2,691,639,351,-288
2015,8,6,3,628,589,200,-389
2015,8,6,4,556,525,189,-336
2015,8,6,5,496,479,183,-296
2015,8,6,6,463,447,111,-336
2015,8,6,7,440,431,107,-324
2015,8,6,8,427,420,105,-315
2015,8,6,9,426,422,102,-320
2015,8,6,10,447,444,101,-343
2015,8,6,11,488,491,103,-388
2015,8,6,12,524,529,125,-404
2015,8,6,13,551,552,150,-402
2015,8,6,14,584,574,174,-400
2015,8,6,15,615,595,216,-379
2015,8,6,16,642,599,337,-262
2015,8,6,17,670,621,484,-137
2015,8,6,18,692,648,510,-138
2015,8,6,19,713,668,508,-160
2015,8,6,20,720,678,449,-229
2015,8,6,21,726,705,331,-374
2015,8,6,22,721,708,361,-347
2015,8,6,23,708,689,303,-386
2015,8,7,0,683,676,274,-402
2015,8,7,1,688,666,265,-401
2015,8,7,2,653,645,243,-402
2015,8,7,3,592,593,193,-400
2015,8,7,4,529,536,151,-385
2015,8,7,5,482,482,142,-340
2015,8,7,6,452,451,141,-310
2015,8,7,7,433,437,136,-301
2015,8,7,8,424,432,109,-323
2015,8,7,9,426,432,103,-329
2015,8,7,10,445,450,105,-345
2015,8,7,11,490,492,106,-386
2015,8,7,12,525,524,122,-402
2015,8,7,13,555,556,161,-395
2015,8,7,14,585,589,192,-397
2015,8,7,15,626,610,211,-399
2015,8,7,16,652,630,231,-399
2015,8,7,17,674,632,232,-400
2015,8,7,18,692,651,252,-399
2015,8,7,19,705,674,262,-412
2015,8,7,20,707,687,281,-406
2015,8,7,21,702,710,298,-412
2015,8,7,22,689,714,304,-410
2015,8,7,23,667,689,281,-408
2015,8,8,0,640,660,261,-399
2015,8,8,1,629,646,249,-397
2015,8,8,2,613,630,244,-386
2015,8,8,3,569,579,192,-387
2015,8,8,4,513,528,131,-397
2015,8,8,5,483,479,104,-375
2015,8,8,6,451,448,104,-344
2015,8,8,7,428,426,104,-322
2015,8,8,8,416,418,104,-314
2015,8,8,9,413,412,105,-307
2015,8,8,10,420,413,103,-310
2015,8,8,11,436,438,104,-334
2015,8,8,12,460,465,105,-360
2015,8,8,13,506,500,103,-397
2015,8,8,14,557,540,104,-436
2015,8,8,15,598,579,111,-468
2015,8,8,16,631,617,175,-442
2015,8,8,17,646,644,185,-459
2015,8,8,18,659,667,192,-475
2015,8,8,19,676,694,218,-476
2015,8,8,20,686,716,262,-454
2015,8,8,21,691,739,322,-417
2015,8,8,22,690,744,434,-310
2015,8,8,23,681,734,390,-344
2015,8,9,0,655,695,374,-321
2015,8,9,1,639,674,295,-379
2015,8,9,2,619,647,215,-432
2015,8,9,3,573,602,141,-461
2015,8,9,4,515,540,110,-430
2015,8,9,5,479,489,107,-382
2015,8,9,6,447,450,106,-344
2015,8,9,7,426,432,107,-325
2015,8,9,8,414,419,104,-315
2015,8,9,9,409,411,104,-307
2015,8,9,10,412,413,103,-310
2015,8,9,11,427,417,103,-314
2015,8,9,12,450,437,102,-335
2015,8,9,13,503,489,102,-387
2015,8,9,14,552,540,105,-435
2015,8,9,15,591,571,104,-467
2015,8,9,16,627,608,133,-475
2015,8,9,17,655,644,167,-477
2015,8,9,18,681,666,202,-464
2015,8,9,19,704,682,237,-445
2015,8,9,20,724,685,242,-443
2015,8,9,21,734,701,243,-458
2015,8,9,22,743,716,244,-472
2015,8,9,23,734,713,259,-454
2015,8,10,0,709,692,252,-440
2015,8,10,1,688,673,243,-430
2015,8,10,2,661,645,185,-460
2015,8,10,3,605,593,144,-449
2015,8,10,4,543,533,116,-417
2015,8,10,5,470,485,110,-375
2015,8,10,6,442,453,110,-343
2015,8,10,7,423,422,97,-325
2015,8,10,8,412,423,111,-312
2015,8,10,9,415,424,109,-315
2015,8,10,10,439,443,110,-333
2015,8,10,11,486,484,109,-375
2015,8,10,12,525,519,108,-411
2015,8,10,13,558,544,102,-442
2015,8,10,14,595,594,136,-458
2015,8,10,15,635,642,188,-454
2015,8,10,16,677,685,241,-444
2015,8,10,17,690,727,269,-458
2015,8,10,18,722,753,299,-454
2015,8,10,19,743,763,322,-441
2015,8,10,20,742,726,337,-389
2015,8,10,21,743,696,337,-359
2015,8,10,22,734,699,336,-363
2015,8,10,23,723,691,338,-353
2015,8,11,0,704,684,337,-347
2015,8,11,1,707,672,337,-335
2015,8,11,2,671,630,305,-325
2015,8,11,3,611,581,191,-390
2015,8,11,4,546,522,112,-410
2015,8,11,5,501,480,101,-379
2015,8,11,6,467,462,103,-359
2015,8,11,7,443,439,101,-338
2015,8,11,8,430,436,103,-333
2015,8,11,9,430,437,101,-336
2015,8,11,10,451,462,102,-360
2015,8,11,11,495,509,102,-407
2015,8,11,12,532,543,106,-437
2015,8,11,13,561,574,142,-432
2015,8,11,14,592,592,156,-436
2015,8,11,15,626,615,183,-432
2015,8,11,16,668,637,274,-363
2015,8,11,17,686,663,288,-375
2015,8,11,18,716,688,336,-352
2015,8,11,19,733,721,360,-361
2015,8,11,20,736,742,370,-372
2015,8,11,21,741,765,371,-394
2015,8,11,22,735,769,394,-375
2015,8,11,23,723,754,387,-367
2015,8,12,0,698,715,353,-362
2015,8,12,1,687,690,353,-337
2015,8,12,2,651,664,352,-312
2015,8,12,3,592,598,241,-357
2015,8,12,4,527,537,133,-404
2015,8,12,5,479,483,105,-378
2015,8,12,6,448,455,108,-347
2015,8,12,7,424,431,105,-326
2015,8,12,8,413,422,104,-318
2015,8,12,9,415,422,103,-319
2015,8,12,10,439,444,103,-341
2015,8,12,11,484,488,105,-383
2015,8,12,12,519,522,103,-419
2015,8,12,13,544,557,118,-439
2015,8,12,14,571,591,169,-422
2015,8,12,15,600,619,182,-437
2015,8,12,16,624,644,255,-389
2015,8,12,17,642,663,321,-342
2015,8,12,18,658,682,336,-346
2015,8,12,19,672,696,370,-326
2015,8,12,20,679,714,487,-227
2015,8,12,21,689,721,511,-210
2015,8,12,22,684,728,516,-212
2015,8,12,23,668,713,460,-253
2015,8,13,0,646,684,323,-361
2015,8,13,1,634,656,324,-332
2015,8,13,2,611,631,224,-407
2015,8,13,3,557,566,131,-435
2015,8,13,4,497,507,109,-398
2015,8,13,5,464,453,102,-351
2015,8,13,6,434,424,100,-324
2015,8,13,7,414,405,100,-305
2015,8,13,8,405,397,101,-296
2015,8,13,9,407,399,103,-296
2015,8,13,10,431,419,100,-319
2015,8,13,11,478,464,100,-364
2015,8,13,12,510,497,101,-396
2015,8,13,13,536,524,102,-422
2015,8,13,14,558,548,102,-446
2015,8,13,15,585,577,105,-472
2015,8,13,16,605,604,162,-442
2015,8,13,17,623,622,212,-410
2015,8,13,18,644,649,270,-379
2015,8,13,19,664,669,308,-361
2015,8,13,20,677,686,412,-274
2015,8,13,21,691,688,447,-241
2015,8,13,22,689,690,445,-245
2015,8,13,23,671,676,389,-287
2015,8,14,0,653,653,337,-316
2015,8,14,1,642,648,267,-381
2015,8,14,2,617,623,196,-427
2015,8,14,3,562,568,126,-442
2015,8,14,4,503,513,109,-404
2015,8,14,5,462,459,108,-351
2015,8,14,6,433,432,108,-324
2015,8,14,7,412,414,107,-307
2015,8,14,8,404,408,108,-300
2015,8,14,9,408,408,110,-298
2015,8,14,10,431,432,112,-320
2015,8,14,11,476,475,112,-363
2015,8,14,12,509,505,110,-395
2015,8,14,13,536,536,113,-423
2015,8,14,14,569,569,118,-451
2015,8,14,15,596,606,206,-400
2015,8,14,16,614,639,226,-413
2015,8,14,17,639,668,286,-382
2015,8,14,18,658,685,296,-389
2015,8,14,19,672,707,332,-375
2015,8,14,20,679,691,330,-361
2015,8,14,21,679,660,334,-326
2015,8,14,22,671,625,330,-295
2015,8,14,23,650,606,333,-273
2015,8,15,0,627,583,331,-252
2015,8,15,1,617,582,331,-251
2015,8,15,2,596,567,322,-245
2015,8,15,3,555,528,245,-283
2015,8,15,4,501,474,171,-303
2015,8,15,5,465,437,105,-332
2015,8,15,6,433,413,105,-308
2015,8,15,7,412,392,103,-289
2015,8,15,8,400,387,108,-279
2015,8,15,9,399,381,104,-277
2015,8,15,10,407,393,105,-288
2015,8,15,11,425,415,106,-309
2015,8,15,12,445,435,108,-327
2015,8,15,13,484,472,121,-351
2015,8,15,14,527,508,120,-388
2015,8,15,15,560,531,135,-396
2015,8,15,16,590,556,226,-330
2015,8,15,17,608,578,254,-324
2015,8,15,18,625,595,265,-330
2015,8,15,19,644,602,300,-302
2015,8,15,20,654,606,342,-264
2015,8,15,21,665,623,339,-284
2015,8,15,22,662,624,377,-247
2015,8,15,23,653,605,306,-299
2015,8,16,0,627,587,227,-360
2015,8,16,1,616,582,119,-463
2015,8,16,2,597,568,113,-455
2015,8,16,3,551,525,86,-439
2015,8,16,4,496,476,54,-422
2015,8,16,5,445,432,51,-381
2015,8,16,6,415,403,50,-353
2015,8,16,7,396,391,50,-341
2015,8,16,8,386,378,49,-329
2015,8,16,9,382,375,51,-324
2015,8,16,10,389,379,53,-326
2015,8,16,11,403,393,53,-340
2015,8,16,12,426,411,51,-360
2015,8,16,13,474,464,60,-404
2015,8,16,14,517,500,74,-426
2015,8,16,15,540,526,85,-441
2015,8,16,16,568,554,85,-469
2015,8,16,17,600,589,105,-484
2015,8,16,18,621,611,148,-463
2015,8,16,19,641,628,290,-338
2015,8,16,20,658,640,323,-317
2015,8,16,21,672,650,312,-338
2015,8,16,22,675,661,300,-361
2015,8,16,23,670,653,287,-366
2015,8,17,0,652,636,286,-350
2015,8,17,1,641,634,288,-346
2015,8,17,2,612,609,259,-350
2015,8,17,3,562,554,122,-432
2015,8,17,4,503,502,103,-399
2015,8,17,5,454,455,61,-394
2015,8,17,6,426,427,51,-376
2015,8,17,7,408,411,51,-360
2015,8,17,8,400,402,50,-352
2015,8,17,9,404,408,52,-356
2015,8,17,10,429,431,56,-375
2015,8,17,11,478,483,56,-427
2015,8,17,12,514,514,55,-459
2015,8,17,13,545,543,58,-485
2015,8,17,14,577,574,57,-517
2015,8,17,15,609,610,67,-543
2015,8,17,16,643,635,218,-417
2015,8,17,17,659,661,247,-414
2015,8,17,18,686,670,358,-312
2015,8,17,19,709,676,375,-301
2015,8,17,20,714,698,342,-356
2015,8,17,21,727,693,338,-355
2015,8,17,22,723,674,367,-307
2015,8,17,23,710,663,375,-288
2015,8,18,0,691,648,314,-334
2015,8,18,1,702,642,216,-426
2015,8,18,2,655,619,187,-432
2015,8,18,3,591,562,90,-472
2015,8,18,4,529,506,50,-456
2015,8,18,5,471,463,49,-414
2015,8,18,6,444,439,49,-390
2015,8,18,7,424,423,48,-375
2015,8,18,8,417,417,49,-368
2015,8,18,9,420,423,49,-374
2015,8,18,10,443,451,50,-401
2015,8,18,11,496,510,58,-452
2015,8,18,12,529,543,60,-483
2015,8,18,13,555,566,60,-506
2015,8,18,14,578,581,59,-522
2015,8,18,15,601,616,81,-535
2015,8,18,16,615,640,131,-509
2015,8,18,17,625,648,132,-516
2015,8,18,18,640,668,246,-422
2015,8,18,19,656,683,404,-279
2015,8,18,20,665,682,413,-269
2015,8,18,21,675,669,413,-256
2015,8,18,22,673,672,412,-260
2015,8,18,23,666,667,351,-316
2015,8,19,0,657,662,342,-320
2015,8,19,1,663,667,336,-331
2015,8,19,2,630,636,216,-420
2015,8,19,3,566,575,112,-463
2015,8,19,4,510,519,81,-438
2015,8,19,5,462,478,95,-383
2015,8,19,6,437,445,101,-344
2015,8,19,7,421,432,106,-326
2015,8,19,8,416,425,104,-321
2015,8,19,9,422,429,105,-324
2015,8,19,10,450,461,104,-357
2015,8,19,11,506,529,133,-396
2015,8,19,12,538,549,139,-410
2015,8,19,13,565,577,142,-435
2015,8,19,14,592,608,142,-466
2015,8,19,15,624,645,179,-466
2015,8,19,16,641,679,225,-454
2015,8,19,17,658,705,248,-457
2015,8,19,18,687,720,265,-455
2015,8,19,19,715,737,386,-351
2015,8,19,20,726,737,447,-290
2015,8,19,21,727,739,444,-295
2015,8,19,22,719,737,444,-293
2015,8,19,23,706,720,400,-320
2015,8,20,0,690,693,379,-314
2015,8,20,1,698,677,341,-336
2015,8,20,2,658,641,230,-411
2015,8,20,3,594,584,179,-405
2015,8,20,4,535,528,109,-419
2015,8,20,5,483,487,102,-385
2015,8,20,6,455,457,100,-357
2015,8,20,7,436,444,103,-341
2015,8,20,8,429,431,101,-330
2015,8,20,9,432,435,101,-334
2015,8,20,10,457,463,101,-362
2015,8,20,11,513,529,99,-430
2015,8,20,12,544,555,100,-455
2015,8,20,13,569,577,103,-474
2015,8,20,14,594,613,134,-479
2015,8,20,15,628,641,165,-476
2015,8,20,16,641,670,230,-440
2015,8,20,17,660,693,240,-453
2015,8,20,18,689,711,275,-436
2015,8,20,19,713,711,381,-330
2015,8,20,20,711,699,413,-286
2015,8,20,21,706,729,414,-315
2015,8,20,22,694,744,413,-331
2015,8,20,23,676,719,351,-368
2015,8,21,0,661,695,341,-354
2015,8,21,1,684,682,312,-370
2015,8,21,2,640,651,303,-348
2015,8,21,3,575,588,248,-340
2015,8,21,4,517,521,123,-398
2015,8,21,5,478,473,102,-371
2015,8,21,6,447,444,102,-342
2015,8,21,7,427,425,102,-323
2015,8,21,8,417,421,102,-319
2015,8,21,9,419,421,99,-322
2015,8,21,10,444,449,100,-349
2015,8,21,11,499,510,100,-410
2015,8,21,12,524,533,100,-433
2015,8,21,13,548,554,103,-451
2015,8,21,14,573,574,109,-465
2015,8,21,15,600,606,141,-465
2015,8,21,16,614,627,162,-465
2015,8,21,17,628,644,197,-447
2015,8,21,18,647,668,213,-455
2015,8,21,19,669,688,332,-356
2015,8,21,20,679,690,376,-314
2015,8,21,21,679,700,377,-323
2015,8,21,22,675,702,377,-325
2015,8,21,23,658,689,366,-323
2015,8,22,0,627,655,244,-411
2015,8,22,1,622,640,163,-477
2015,8,22,2,596,608,131,-477
2015,8,22,3,546,562,106,-456
2015,8,22,4,494,503,100,-403
2015,8,22,5,454,456,98,-358
2015,8,22,6,425,426,99,-327
2015,8,22,7,405,405,98,-307
2015,8,22,8,395,393,98,-295
2015,8,22,9,392,391,97,-294
2015,8,22,10,404,399,96,-303
2015,8,22,11,423,420,100,-320
2015,8,22,12,443,438,96,-342
2015,8,22,13,483,484,99,-385
2015,8,22,14,520,527,100,-427
2015,8,22,15,552,559,100,-459
2015,8,22,16,571,586,199,-387
2015,8,22,17,580,606,308,-298
2015,8,22,18,595,634,397,-237
2015,8,22,19,613,652,417,-235
2015,8,22,20,636,670,444,-226
2015,8,22,21,650,686,448,-238
2015,8,22,22,652,687,447,-240
2015,8,22,23,650,670,389,-281
2015,8,23,0,625,649,379,-270
2015,8,23,1,615,638,379,-259
2015,8,23,2,594,600,345,-255
2015,8,23,3,542,555,182,-373
2015,8,23,4,490,499,108,-391
2015,8,23,5,444,459,102,-357
2015,8,23,6,417,435,103,-332
2015,8,23,7,399,418,103,-315
2015,8,23,8,391,406,101,-305
2015,8,23,9,389,398,101,-297
2015,8,23,10,395,408,103,-305
2015,8,23,11,417,419,102,-317
2015,8,23,12,438,442,102,-340
2015,8,23,13,488,489,114,-375
2015,8,23,14,531,529,153,-376
2015,8,23,15,554,551,159,-392
2015,8,23,16,580,561,156,-405
2015,8,23,17,606,585,184,-401
2015,8,23,18,627,611,202,-409
2015,8,23,19,641,614,250,-364
2015,8,23,20,655,626,250,-376
2015,8,23,21,663,646,251,-395
2015,8,23,22,668,657,252,-405
2015,8,23,23,662,653,233,-420
2015,8,24,0,643,646,175,-471
2015,8,24,1,641,643,166,-477
2015,8,24,2,610,608,135,-473
2015,8,24,3,557,553,102,-451
2015,8,24,4,501,497,102,-395
2015,8,24,5,452,452,101,-351
2015,8,24,6,428,428,103,-325
2015,8,24,7,413,412,102,-310
2015,8,24,8,409,403,101,-302
2015,8,24,9,415,407,102,-305
2015,8,24,10,445,441,103,-338
2015,8,24,11,504,507,101,-406
2015,8,24,12,538,539,170,-369
2015,8,24,13,570,554,236,-318
2015,8,24,14,602,582,255,-327
2015,8,24,15,637,626,265,-361
2015,8,24,16,675,663,310,-353
2015,8,24,17,702,670,338,-332
2015,8,24,18,734,713,457,-256
2015,8,24,19,748,724,576,-148
2015,8,24,20,755,749,568,-181
2015,8,24,21,764,763,563,-200
2015,8,24,22,765,764,561,-203
2015,8,24,23,748,754,548,-206
2015,8,25,0,720,720,532,-188
2015,8,25,1,707,706,599,-107
2015,8,25,2,666,667,567,-100
2015,8,25,3,597,587,415,-172
2015,8,25,4,528,523,258,-265
2015,8,25,5,457,469,242,-227
2015,8,25,6,427,438,220,-218
2015,8,25,7,407,412,139,-273
2015,8,25,8,397,407,105,-302
2015,8,25,9,399,409,103,-306
2015,8,25,10,429,433,101,-332
2015,8,25,11,495,501,103,-398
2015,8,25,12,515,520,102,-418
2015,8,25,13,523,533,103,-430
2015,8,25,14,534,557,103,-454
2015,8,25,15,558,578,123,-455
2015,8,25,16,575,592,155,-437
2015,8,25,17,589,619,203,-416
2015,8,25,18,611,647,377,-270
2015,8,25,19,624,643,367,-276
2015,8,25,20,630,671,453,-218
2015,8,25,21,642,694,532,-162
2015,8,25,22,645,694,556,-138
2015,8,25,23,634,676,541,-135
2015,8,26,0,618,643,528,-115
2015,8,26,1,615,634,530,-104
2015,8,26,2,585,599,430,-169
2015,8,26,3,520,532,264,-268
2015,8,26,4,464,467,159,-308
2015,8,26,5,429,428,111,-317
2015,8,26,6,403,404,107,-297
2015,8,26,7,385,391,109,-282
2015,8,26,8,382,384,109,-275
2015,8,26,9,389,389,111,-278
2015,8,26,10,420,414,110,-304
2015,8,26,11,490,480,113,-367
2015,8,26,12,507,501,112,-389
2015,8,26,13,518,518,114,-404
2015,8,26,14,528,531,113,-418
2015,8,26,15,547,549,110,-439
2015,8,26,16,561,570,112,-458
2015,8,26,17,575,582,114,-468
2015,8,26,18,591,614,139,-475
2015,8,26,19,602,630,157,-473
2015,8,26,20,609,647,159,-488
2015,8,26,21,625,666,184,-482
2015,8,26,22,633,666,222,-444
2015,8,26,23,623,655,179,-476
2015,8,27,0,604,630,151,-479
2015,8,27,1,609,625,146,-479
2015,8,27,2,581,594,133,-461
2015,8,27,3,518,535,131,-404
2015,8,27,4,465,469,124,-345
2015,8,27,5,427,435,100,-335
2015,8,27,6,403,400,89,-311
2015,8,27,7,390,393,102,-291
2015,8,27,8,385,388,103,-285
2015,8,27,9,389,390,102,-288
2015,8,27,10,419,421,104,-317
2015,8,27,11,492,476,102,-374
2015,8,27,12,513,495,102,-393
2015,8,27,13,521,512,102,-410
2015,8,27,14,537,542,108,-434
2015,8,27,15,558,557,122,-435
2015,8,27,16,570,579,160,-419
2015,8,27,17,585,595,188,-407
2015,8,27,18,603,615,221,-394
2015,8,27,19,612,636,224,-412
2015,8,27,20,623,648,222,-426
2015,8,27,21,636,665,244,-421
2015,8,27,22,638,665,262,-403
2015,8,27,23,628,652,261,-391
2015,8,28,0,614,634,254,-380
2015,8,28,1,621,633,171,-462
2015,8,28,2,591,601,127,-474
2015,8,28,3,527,540,108,-432
2015,8,28,4,475,479,100,-379
2015,8,28,5,439,435,98,-337
2015,8,28,6,412,406,98,-308
2015,8,28,7,397,396,98,-298
2015,8,28,8,390,384,97,-287
2015,8,28,9,395,394,99,-295
2015,8,28,10,426,421,98,-323
2015,8,28,11,497,482,100,-382
2015,8,28,12,515,502,110,-392
2015,8,28,13,526,525,108,-417
2015,8,28,14,546,548,103,-445
2015,8,28,15,567,572,105,-467
2015,8,28,16,582,583,122,-461
2015,8,28,17,593,606,128,-478
2015,8,28,18,610,623,148,-475
2015,8,28,19,620,641,154,-487
2015,8,28,20,630,652,163,-489
2015,8,28,21,644,666,172,-494
2015,8,28,22,644,662,170,-492
2015,8,28,23,631,642,155,-487
2015,8,29,0,605,609,129,-480
2015,8,29,1,606,603,121,-482
2015,8,29,2,582,573,109,-464
2015,8,29,3,530,533,107,-426
2015,8,29,4,480,475,104,-371
2015,8,29,5,437,433,105,-328
2015,8,29,6,410,403,100,-303
2015,8,29,7,392,390,100,-290
2015,8,29,8,383,376,99,-277
2015,8,29,9,383,377,102,-275
2015,8,29,10,394,387,102,-285
2015,8,29,11,418,398,100,-298
2015,8,29,12,435,425,103,-322
2015,8,29,13,472,456,100,-356
2015,8,29,14,507,489,102,-387
2015,8,29,15,536,514,116,-398
2015,8,29,16,556,534,166,-368
2015,8,29,17,568,553,173,-380
2015,8,29,18,583,581,174,-407
2015,8,29,19,596,597,172,-425
2015,8,29,20,610,614,175,-439
2015,8,29,21,619,623,173,-450
2015,8,29,22,622,621,174,-447
2015,8,29,23,611,605,137,-468
2015,8,30,0,597,586,115,-471
2015,8,30,1,597,591,122,-469
2015,8,30,2,570,560,102,-458
2015,8,30,3,522,519,99,-420
2015,8,30,4,470,475,99,-376
2015,8,30,5,419,434,100,-334
2015,8,30,6,393,406,100,-306
2015,8,30,7,376,391,101,-290
2015,8,30,8,367,379,99,-280
2015,8,30,9,364,381,102,-279
2015,8,30,10,372,381,99,-282
2015,8,30,11,389,398,100,-298
2015,8,30,12,409,423,99,-324
2015,8,30,13,453,462,99,-363
2015,8,30,14,487,489,99,-390
2015,8,30,15,504,501,100,-401
2015,8,30,16,523,513,109,-404
2015,8,30,17,536,521,109,-412
2015,8,30,18,555,534,114,-420
2015,8,30,19,563,546,113,-433
2015,8,30,20,580,555,114,-441
2015,8,30,21,595,565,117,-448
2015,8,30,22,603,558,114,-444
2015,8,30,23,600,560,113,-447
2015,8,31,0,592,565,114,-451
2015,8,31,1,597,574,117,-457
2015,8,31,2,562,540,113,-427
2015,8,31,3,508,492,115,-377
2015,8,31,4,456,444,108,-336
2015,8,31,5,416,405,92,-313
2015,8,31,6,394,392,101,-291
2015,8,31,7,382,386,102,-284
2015,8,31,8,378,381,102,-279
2015,8,31,9,386,386,102,-284
2015,8,31,10,421,419,103,-316
2015,8,31,11,494,480,100,-380
2015,8,31,12,518,510,103,-407
2015,8,31,13,535,524,105,-419
2015,8,31,14,555,543,105,-438
2015,8,31,15,585,569,106,-463
2015,8,31,16,605,593,116,-477
2015,8,31,17,623,616,137,-479
2015,8,31,18,644,639,167,-472
2015,8,31,19,655,654,171,-483
2015,8,31,20,664,677,193,-484
2015,8,31,21,674,689,206,-483
2015,8,31,22,675,689,207,-482
2015,8,31,23,664,689,207,-482
2015,9,1,0,648,676,203,-473
2015,9,1,1,653,679,211,-468
2015,9,1,2,616,642,176,-466
2015,9,1,3,550,567,165,-402
2015,9,1,4,492,504,120,-384
2015,9,1,5,447,459,102,-357
2015,9,1,6,420,427,104,-323
2015,9,1,7,407,410,102,-308
2015,9,1,8,400,402,103,-299
2015,9,1,9,407,409,104,-305
2015,9,1,10,440,436,110,-326
2015,9,1,11,509,505,153,-352
2015,9,1,12,536,527,152,-375
2015,9,1,13,553,541,153,-388
2015,9,1,14,575,559,150,-409
2015,9,1,15,600,596,154,-442
2015,9,1,16,622,636,165,-471
2015,9,1,17,647,658,271,-387
2015,9,1,18,674,694,340,-354
2015,9,1,19,688,684,334,-350
2015,9,1,20,701,762,530,-232
2015,9,1,21,713,723,539,-184
2015,9,1,22,710,728,566,-162
2015,9,1,23,697,721,527,-194
2015,9,2,0,674,695,488,-207
2015,9,2,1,679,701,503,-198
2015,9,2,2,632,658,454,-204
2015,9,2,3,567,585,367,-218
2015,9,2,4,509,517,265,-252
2015,9,2,5,475,473,185,-288
2015,9,2,6,443,447,159,-288
2015,9,2,7,426,425,123,-302
2015,9,2,8,418,421,103,-318
2015,9,2,9,420,421,101,-320
2015,9,2,10,452,451,104,-347
2015,9,2,11,517,513,101,-412
2015,9,2,12,542,539,102,-437
2015,9,2,13,559,557,101,-456
2015,9,2,14,589,591,125,-466
2015,9,2,15,616,626,173,-453
2015,9,2,16,652,654,392,-262
2015,9,2,17,685,683,415,-268
2015,9,2,18,715,717,567,-150
2015,9,2,19,741,737,544,-193
2015,9,2,20,753,751,486,-265
2015,9,2,21,770,751,555,-196
2015,9,2,22,767,737,611,-126
2015,9,2,23,748,725,580,-145
2015,9,3,0,718,710,558,-152
2015,9,3,1,712,705,593,-112
2015,9,3,2,662,660,422,-238
2015,9,3,3,596,591,253,-338
2015,9,3,4,532,530,154,-376
2015,9,3,5,484,482,128,-354
2015,9,3,6,450,454,128,-326
2015,9,3,7,431,432,127,-305
2015,9,3,8,421,424,130,-294
2015,9,3,9,423,425,125,-300
2015,9,3,10,453,455,116,-339
2015,9,3,11,519,523,134,-389
2015,9,3,12,544,549,134,-415
2015,9,3,13,563,561,134,-427
2015,9,3,14,592,582,139,-443
2015,9,3,15,628,619,245,-374
2015,9,3,16,662,648,376,-272
2015,9,3,17,690,681,519,-162
2015,9,3,18,724,702,527,-175
2015,9,3,19,750,730,648,-82
2015,9,3,20,760,742,683,-59
2015,9,3,21,769,761,683,-78
2015,9,3,22,764,763,681,-82
2015,9,3,23,743,750,684,-66
2015,9,4,0,719,727,564,-163
2015,9,4,1,712,715,538,-177
2015,9,4,2,663,673,504,-169
2015,9,4,3,596,582,323,-259
2015,9,4,4,532,522,177,-345
2015,9,4,5,483,475,102,-373
2015,9,4,6,451,443,98,-345
2015,9,4,7,431,424,98,-326
2015,9,4,8,422,421,99,-322
2015,9,4,9,424,417,96,-321
2015,9,4,10,450,442,99,-343
2015,9,4,11,512,501,99,-402
2015,9,4,12,539,523,99,-424
2015,9,4,13,561,539,99,-440
2015,9,4,14,591,570,106,-464
2015,9,4,15,620,603,133,-470
2015,9,4,16,662,643,181,-462
2015,9,4,17,682,674,242,-432
2015,9,4,18,716,702,327,-375
2015,9,4,19,731,727,506,-221
2015,9,4,20,742,732,538,-194
2015,9,4,21,745,707,532,-175
2015,9,4,22,732,675,536,-139
2015,9,4,23,709,643,503,-140
2015,9,5,0,684,613,319,-294
2015,9,5,1,674,606,183,-423
2015,9,5,2,636,576,116,-460
2015,9,5,3,582,539,103,-436
2015,9,5,4,522,487,100,-387
2015,9,5,5,474,441,101,-340
2015,9,5,6,442,416,103,-313
2015,9,5,7,421,392,102,-290
2015,9,5,8,409,382,101,-281
2015,9,5,9,404,380,101,-279
2015,9,5,10,414,386,102,-284
2015,9,5,11,432,404,102,-302
2015,9,5,12,457,426,102,-324
2015,9,5,13,495,463,104,-359
2015,9,5,14,536,506,150,-356
2015,9,5,15,568,538,150,-388
2015,9,5,16,586,559,192,-367
2015,9,5,17,606,574,202,-372
2015,9,5,18,623,598,218,-380
2015,9,5,19,634,605,258,-347
2015,9,5,20,644,597,254,-343
2015,9,5,21,649,593,260,-333
2015,9,5,22,640,589,269,-320
2015,9,5,23,628,577,239,-338
2015,9,6,0,612,568,214,-354
2015,9,6,1,611,572,211,-361
2015,9,6,2,575,550,213,-337
2015,9,6,3,527,510,204,-306
2015,9,6,4,477,458,141,-317
2015,9,6,5,427,419,104,-315
2015,9,6,6,401,392,103,-289
2015,9,6,7,385,384,106,-278
2015,9,6,8,375,371,103,-268
2015,9,6,9,373,371,104,-267
2015,9,6,10,376,375,104,-271
2015,9,6,11,385,387,103,-284
2015,9,6,12,409,412,105,-307
2015,9,6,13,458,455,104,-351
2015,9,6,14,497,492,111,-381
2015,9,6,15,518,512,112,-400
2015,9,6,16,534,530,112,-418
2015,9,6,17,563,553,111,-442
2015,9,6,18,576,577,112,-465
2015,9,6,19,579,597,132,-465
2015,9,6,20,586,614,136,-478
2015,9,6,21,598,623,144,-479
2015,9,6,22,597,632,153,-479
2015,9,6,23,591,615,138,-477
2015,9,7,0,583,587,132,-455
2015,9,7,1,592,577,131,-446
2015,9,7,2,552,552,132,-420
2015,9,7,3,507,502,122,-380
2015,9,7,4,459,460,102,-358
2015,9,7,5,418,414,99,-315
2015,9,7,6,392,388,100,-288
2015,9,7,7,376,375,100,-275
2015,9,7,8,369,366,100,-266
2015,9,7,9,371,365,99,-266
2015,9,7,10,384,378,100,-278
2015,9,7,11,405,397,98,-299
2015,9,7,12,423,420,96,-324
2015,9,7,13,458,451,96,-355
2015,9,7,14,497,485,100,-385
2015,9,7,15,534,518,98,-420
2015,9,7,16,560,549,100,-449
2015,9,7,17,580,577,111,-466
2015,9,7,18,589,598,143,-455
2015,9,7,19,588,614,174,-440
2015,9,7,20,602,629,273,-356
2015,9,7,21,618,647,325,-322
2015,9,7,22,622,662,372,-290
2015,9,7,23,622,654,371,-283
2015,9,8,0,613,636,370,-266
2015,9,8,1,619,643,371,-272
2015,9,8,2,576,595,368,-227
2015,9,8,3,526,529,295,-234
2015,9,8,4,472,473,167,-306
2015,9,8,5,445,427,109,-318
2015,9,8,6,420,403,103,-300
2015,9,8,7,408,385,99,-286
2015,9,8,8,403,385,102,-283
2015,9,8,9,409,388,99,-289
2015,9,8,10,440,420,101,-319
2015,9,8,11,512,492,143,-349
2015,9,8,12,539,520,159,-361
2015,9,8,13,554,539,162,-377
2015,9,8,14,582,559,158,-401
2015,9,8,15,608,588,160,-428
2015,9,8,16,637,618,162,-456
2015,9,8,17,664,635,163,-472
2015,9,8,18,696,653,193,-460
2015,9,8,19,711,651,263,-388
2015,9,8,20,723,662,274,-388
2015,9,8,21,737,673,278,-395
2015,9,8,22,729,686,286,-400
2015,9,8,23,721,688,323,-365
2015,9,9,0,704,673,350,-323
2015,9,9,1,698,675,350,-325
2015,9,9,2,648,627,282,-345
2015,9,9,3,582,561,164,-397
2015,9,9,4,521,500,104,-396
2015,9,9,5,452,466,98,-368
2015,9,9,6,427,442,97,-345
2015,9,9,7,414,426,98,-328
2015,9,9,8,410,419,95,-324
2015,9,9,9,415,422,98,-324
2015,9,9,10,446,447,96,-351
2015,9,9,11,517,516,121,-395
2015,9,9,12,544,542,121,-421
2015,9,9,13,559,559,121,-438
2015,9,9,14,583,578,135,-443
2015,9,9,15,605,596,184,-412
2015,9,9,16,624,604,201,-403
2015,9,9,17,642,621,248,-373
2015,9,9,18,666,643,328,-315
2015,9,9,19,680,639,419,-220
2015,9,9,20,690,645,437,-208
2015,9,9,21,697,652,427,-225
2015,9,9,22,689,648,425,-223
2015,9,9,23,683,640,402,-238
2015,9,10,0,667,630,395,-235
2015,9,10,1,666,642,377,-265
2015,9,10,2,625,604,317,-287
2015,9,10,3,562,546,247,-299
2015,9,10,4,504,491,175,-316
2015,9,10,5,456,450,107,-343
2015,9,10,6,428,434,105,-329
2015,9,10,7,413,417,100,-317
2015,9,10,8,408,410,97,-313
2015,9,10,9,411,415,95,-320
2015,9,10,10,443,455,97,-358
2015,9,10,11,511,521,95,-426
2015,9,10,12,540,547,96,-451
2015,9,10,13,554,567,99,-468
2015,9,10,14,576,586,177,-409
2015,9,10,15,599,596,262,-334
2015,9,10,16,614,604,359,-245
2015,9,10,17,636,622,502,-120
2015,9,10,18,662,648,536,-112
2015,9,10,19,672,648,539,-109
2015,9,10,20,676,647,537,-110
2015,9,10,21,679,649,539,-110
2015,9,10,22,665,640,538,-102
2015,9,10,23,654,630,539,-91
2015,9,11,0,641,626,513,-113
2015,9,11,1,644,633,429,-204
2015,9,11,2,603,602,378,-224
2015,9,11,3,542,545,348,-197
2015,9,11,4,487,492,287,-205
2015,9,11,5,443,448,243,-205
2015,9,11,6,418,422,188,-234
2015,9,11,7,402,406,124,-282
2015,9,11,8,395,403,103,-300
2015,9,11,9,399,405,103,-302
2015,9,11,10,430,434,102,-332
2015,9,11,11,491,494,103,-391
2015,9,11,12,517,528,104,-424
2015,9,11,13,531,539,103,-436
2015,9,11,14,550,558,103,-455
2015,9,11,15,569,581,112,-469
2015,9,11,16,580,585,118,-467
2015,9,11,17,594,603,131,-472
2015,9,11,18,614,622,151,-471
2015,9,11,19,626,637,157,-480
2015,9,11,20,640,652,169,-483
2015,9,11,21,646,667,186,-481
2015,9,11,22,639,659,212,-447
2015,9,11,23,631,641,217,-424
2015,9,12,0,611,615,233,-382
2015,9,12,1,609,609,233,-376
2015,9,12,2,576,572,213,-359
2015,9,12,3,528,524,119,-405
2015,9,12,4,475,474,103,-371
2015,9,12,5,430,434,103,-331
2015,9,12,6,405,411,103,-308
2015,9,12,7,388,397,105,-292
2015,9,12,8,380,384,103,-281
2015,9,12,9,380,387,104,-283
2015,9,12,10,388,392,104,-288
2015,9,12,11,408,414,103,-311
2015,9,12,12,433,437,104,-333
2015,9,12,13,470,466,103,-363
2015,9,12,14,502,498,107,-391
2015,9,12,15,527,516,246,-270
2015,9,12,16,536,513,252,-261
2015,9,12,17,544,513,252,-261
2015,9,12,18,554,510,244,-266
2015,9,12,19,554,508,163,-345
2015,9,12,20,551,516,107,-409
2015,9,12,21,555,518,105,-413
2015,9,12,22,548,515,104,-411
2015,9,12,23,538,511,106,-405
2015,9,13,0,532,507,107,-400
2015,9,13,1,535,519,107,-412
2015,9,13,2,505,493,107,-386
2015,9,13,3,465,455,105,-350
2015,9,13,4,423,416,106,-310
2015,9,13,5,389,382,107,-275
2015,9,13,6,367,362,106,-256
2015,9,13,7,355,348,107,-241
2015,9,13,8,349,345,105,-240
2015,9,13,9,350,344,108,-236
2015,9,13,10,355,349,106,-243
2015,9,13,11,369,368,106,-262
2015,9,13,12,397,392,106,-286
2015,9,13,13,441,430,106,-324
2015,9,13,14,470,457,102,-355
2015,9,13,15,476,459,103,-356
2015,9,13,16,481,458,103,-355
2015,9,13,17,493,459,104,-355
2015,9,13,18,501,458,102,-356
2015,9,13,19,499,458,102,-356
2015,9,13,20,502,461,116,-345
2015,9,13,21,511,468,122,-346
2015,9,13,22,516,482,123,-359
2015,9,13,23,521,487,122,-365
2015,9,14,0,528,502,123,-379
2015,9,14,1,535,515,122,-393
2015,9,14,2,500,486,122,-364
2015,9,14,3,457,447,111,-336
2015,9,14,4,418,405,100,-305
2015,9,14,5,383,378,102,-276
2015,9,14,6,366,361,101,-260
2015,9,14,7,360,360,102,-258
2015,9,14,8,361,358,101,-257
2015,9,14,9,373,367,101,-266
2015,9,14,10,408,409,99,-310
2015,9,14,11,484,482,101,-381
2015,9,14,12,517,518,100,-418
2015,9,14,13,521,528,100,-428
2015,9,14,14,531,528,100,-428
2015,9,14,15,531,526,98,-428
2015,9,14,16,529,527,107,-420
2015,9,14,17,536,520,105,-415
2015,9,14,18,544,522,100,-422
2015,9,14,19,539,523,102,-421
2015,9,14,20,555,526,100,-426
2015,9,14,21,554,532,101,-431
2015,9,14,22,556,541,100,-441
2015,9,14,23,558,549,114,-435
2015,9,15,0,566,550,102,-448
2015,9,15,1,572,565,99,-466
2015,9,15,2,536,526,98,-428
2015,9,15,3,486,475,99,-376
2015,9,15,4,433,427,98,-329
2015,9,15,5,397,377,85,-292
2015,9,15,6,381,376,98,-278
2015,9,15,7,374,371,100,-271
2015,9,15,8,373,364,97,-267
2015,9,15,9,383,382,102,-280
2015,9,15,10,415,410,97,-313
2015,9,15,11,486,485,99,-386
2015,9,15,12,515,494,85,-409
2015,9,15,13,527,520,98,-422
2015,9,15,14,532,523,100,-423
2015,9,15,15,537,526,98,-428
2015,9,15,16,542,527,98,-429
2015,9,15,17,548,530,100,-430
2015,9,15,18,558,544,104,-440
2015,9,15,19,558,548,174,-374
2015,9,15,20,575,550,179,-371
2015,9,15,21,577,561,208,-353
2015,9,15,22,579,559,220,-339
2015,9,15,23,576,560,205,-355
2015,9,16,0,577,558,146,-412
2015,9,16,1,583,571,103,-468
2015,9,16,2,546,534,102,-432
2015,9,16,3,492,481,103,-378
2015,9,16,4,439,430,102,-328
2015,9,16,5,402,397,96,-301
2015,9,16,6,384,376,94,-282
2015,9,16,7,375,369,97,-272
2015,9,16,8,375,366,96,-270
2015,9,16,9,383,375,98,-277
2015,9,16,10,417,411,98,-313
2015,9,16,11,485,478,97,-381
2015,9,16,12,515,510,99,-411
2015,9,16,13,519,513,95,-418
2015,9,16,14,534,516,97,-419
2015,9,16,15,539,523,99,-424
2015,9,16,16,540,526,99,-427
2015,9,16,17,545,525,97,-428
2015,9,16,18,554,533,95,-438
2015,9,16,19,558,535,96,-439
2015,9,16,20,567,537,95,-442
2015,9,16,21,573,541,95,-446
2015,9,16,22,576,540,93,-447
2015,9,16,23,573,548,104,-444
2015,9,17,0,575,551,113,-438
2015,9,17,1,581,562,111,-451
2015,9,17,2,547,526,111,-415
2015,9,17,3,494,483,111,-372
2015,9,17,4,442,432,101,-331
2015,9,17,5,402,392,102,-290
2015,9,17,6,383,378,103,-275
2015,9,17,7,374,369,103,-266
2015,9,17,8,373,367,102,-265
2015,9,17,9,381,372,101,-271
2015,9,17,10,412,410,105,-305
2015,9,17,11,481,479,118,-361
2015,9,17,12,510,508,119,-389
2015,9,17,13,515,510,119,-391
2015,9,17,14,530,517,118,-399
2015,9,17,15,538,523,122,-401
2015,9,17,16,542,531,171,-360
2015,9,17,17,546,536,229,-307
2015,9,17,18,558,551,253,-298
2015,9,17,19,566,555,251,-304
2015,9,17,20,574,573,271,-302
2015,9,17,21,585,590,311,-279
2015,9,17,22,584,592,360,-232
2015,9,17,23,578,584,359,-225
2015,9,18,0,585,577,285,-292
2015,9,18,1,588,581,243,-338
2015,9,18,2,552,544,134,-410
2015,9,18,3,499,484,108,-376
2015,9,18,4,448,439,112,-327
2015,9,18,5,409,405,108,-297
2015,9,18,6,386,380,101,-279
2015,9,18,7,369,371,103,-268
2015,9,18,8,364,365,101,-264
2015,9,18,9,369,372,102,-270
2015,9,18,10,399,400,101,-299
2015,9,18,11,462,466,103,-363
2015,9,18,12,485,488,101,-387
2015,9,18,13,502,503,101,-402
2015,9,18,14,520,516,103,-413
2015,9,18,15,538,524,101,-423
2015,9,18,16,547,542,150,-392
2015,9,18,17,565,546,243,-303
2015,9,18,18,576,553,313,-240
2015,9,18,19,581,568,419,-149
2015,9,18,20,590,589,458,-131
2015,9,18,21,596,601,473,-128
2015,9,18,22,593,609,472,-137
2015,9,18,23,587,596,398,-198
2015,9,19,0,580,571,334,-237
2015,9,19,1,580,574,278,-296
2015,9,19,2,546,537,168,-369
2015,9,19,3,503,487,116,-371
2015,9,19,4,453,447,101,-346
2015,9,19,5,413,404,99,-305
2015,9,19,6,388,380,100,-280
2015,9,19,7,373,363,99,-264
2015,9,19,8,364,357,100,-257
2015,9,19,9,364,355,100,-255
2015,9,19,10,374,367,100,-267
2015,9,19,11,394,385,100,-285
2015,9,19,12,418,414,101,-313
2015,9,19,13,449,446,100,-346
2015,9,19,14,485,475,100,-375
2015,9,19,15,506,500,206,-294
2015,9,19,16,515,512,248,-264
2015,9,19,17,530,521,263,-258
2015,9,19,18,539,530,340,-190
2015,9,19,19,546,552,397,-155
2015,9,19,20,560,567,476,-91
2015,9,19,21,577,584,486,-98
2015,9,19,22,578,589,495,-94
2015,9,19,23,580,581,445,-136
2015,9,20,0,580,567,316,-251
2015,9,20,1,575,558,278,-280
2015,9,20,2,538,521,174,-347
2015,9,20,3,494,486,105,-381
2015,9,20,4,447,437,102,-335
2015,9,20,5,410,402,103,-299
2015,9,20,6,385,375,101,-274
2015,9,20,7,370,357,102,-255
2015,9,20,8,360,354,102,-252
2015,9,20,9,357,349,102,-247
2015,9,20,10,360,357,104,-253
2015,9,20,11,376,375,103,-272
2015,9,20,12,403,399,101,-298
2015,9,20,13,442,440,103,-337
2015,9,20,14,472,463,103,-360
2015,9,20,15,487,479,102,-377
2015,9,20,16,499,494,103,-391
2015,9,20,17,520,518,143,-375
2015,9,20,18,533,534,312,-222
2015,9,20,19,545,547,432,-115
2015,9,20,20,554,563,468,-95
2015,9,20,21,571,570,478,-92
2015,9,20,22,576,579,486,-93
2015,9,20,23,581,574,438,-136
2015,9,21,0,584,581,423,-158
2015,9,21,1,583,581,404,-177
2015,9,21,2,540,544,271,-273
2015,9,21,3,491,496,262,-234
2015,9,21,4,440,447,284,-163
2015,9,21,5,399,410,227,-183
2015,9,21,6,376,386,125,-261
2015,9,21,7,360,377,104,-273
2015,9,21,8,356,373,102,-271
2015,9,21,9,361,379,100,-279
2015,9,21,10,391,411,103,-308
2015,9,21,11,460,478,155,-323
2015,9,21,12,487,511,183,-328
2015,9,21,13,498,514,182,-332
2015,9,21,14,513,527,180,-347
2015,9,21,15,531,542,305,-237
2015,9,21,16,540,554,345,-209
2015,9,21,17,545,557,345,-212
2015,9,21,18,550,562,343,-219
2015,9,21,19,544,569,346,-223
2015,9,21,20,548,571,346,-225
2015,9,21,21,546,571,345,-226
2015,9,21,22,547,573,346,-227
2015,9,21,23,550,574,346,-228
2015,9,22,0,556,588,347,-241
2015,9,22,1,564,587,417,-170
2015,9,22,2,526,538,387,-151
2015,9,22,3,472,484,219,-265
2015,9,22,4,422,433,118,-315
2015,9,22,5,401,400,103,-297
2015,9,22,6,379,383,103,-280
2015,9,22,7,366,372,103,-269
2015,9,22,8,360,366,105,-261
2015,9,22,9,365,368,103,-265
2015,9,22,10,396,405,104,-301
2015,9,22,11,463,476,163,-313
2015,9,22,12,491,507,275,-232
2015,9,22,13,498,509,224,-285
2015,9,22,14,510,523,208,-315
2015,9,22,15,526,538,244,-294
2015,9,22,16,536,547,319,-228
2015,9,22,17,544,553,327,-226
2015,9,22,18,556,568,327,-241
2015,9,22,19,562,582,327,-255
2015,9,22,20,573,596,328,-268
2015,9,22,21,582,606,327,-279
2015,9,22,22,583,605,326,-279
2015,9,22,23,585,592,324,-268
2015,9,23,0,587,591,282,-309
2015,9,23,1,584,591,209,-382
2015,9,23,2,547,550,126,-424
2015,9,23,3,487,485,94,-391
2015,9,23,4,433,449,103,-346
2015,9,23,5,397,405,103,-302
2015,9,23,6,374,382,102,-280
2015,9,23,7,362,375,103,-272
2015,9,23,8,359,364,103,-261
2015,9,23,9,364,373,102,-271
2015,9,23,10,397,404,104,-300
2015,9,23,11,464,470,127,-343
2015,9,23,12,489,505,222,-283
2015,9,23,13,493,505,238,-267
2015,9,23,14,506,518,239,-279
2015,9,23,15,521,534,240,-294
2015,9,23,16,531,546,246,-300
2015,9,23,17,537,554,272,-282
2015,9,23,18,548,573,315,-258
2015,9,23,19,557,587,338,-249
2015,9,23,20,567,594,337,-257
2015,9,23,21,581,608,370,-238
2015,9,23,22,582,606,344,-262
2015,9,23,23,583,599,267,-332
2015,9,24,0,584,598,321,-277
2015,9,24,1,583,594,342,-252
2015,9,24,2,547,545,284,-261
2015,9,24,3,493,486,192,-294
2015,9,24,4,440,429,81,-348
2015,9,24,5,400,401,52,-349
2015,9,24,6,376,377,56,-321
2015,9,24,7,365,369,49,-320
2015,9,24,8,362,363,47,-316
2015,9,24,9,366,367,43,-324
2015,9,24,10,397,397,55,-342
2015,9,24,11,466,465,86,-379
2015,9,24,12,491,483,88,-395
2015,9,24,13,496,497,53,-444
2015,9,24,14,507,509,60,-449
2015,9,24,15,517,514,151,-363
2015,9,24,16,525,515,182,-333
2015,9,24,17,528,521,185,-336
2015,9,24,18,533,529,185,-344
2015,9,24,19,538,532,183,-349
2015,9,24,20,543,533,185,-348
2015,9,24,21,548,531,184,-347
2015,9,24,22,542,531,184,-347
2015,9,24,23,545,538,184,-354
2015,9,25,0,552,551,184,-367
2015,9,25,1,556,543,166,-377
2015,9,25,2,521,508,83,-425
2015,9,25,3,472,461,69,-392
2015,9,25,4,429,416,53,-363
2015,9,25,5,397,379,52,-327
2015,9,25,6,377,364,54,-310
2015,9,25,7,368,355,54,-301
2015,9,25,8,365,349,53,-296
2015,9,25,9,373,357,55,-302
2015,9,25,10,404,386,70,-316
2015,9,25,11,472,450,129,-321
2015,9,25,12,499,484,186,-298
2015,9,25,13,503,494,191,-303
2015,9,25,14,514,513,193,-320
2015,9,25,15,521,519,192,-327
2015,9,25,16,524,525,191,-334
2015,9,25,17,526,517,191,-326
2015,9,25,18,528,514,191,-323
2015,9,25,19,525,510,190,-320
2015,9,25,20,528,501,186,-315
2015,9,25,21,531,501,185,-316
2015,9,25,22,532,501,186,-315
2015,9,25,23,535,505,163,-342
2015,9,26,0,538,511,89,-422
2015,9,26,1,538,508,56,-452
2015,9,26,2,506,482,57,-425
2015,9,26,3,468,440,53,-387
2015,9,26,4,427,402,52,-350
2015,9,26,5,394,368,52,-316
2015,9,26,6,370,352,52,-300
2015,9,26,7,355,343,53,-290
2015,9,26,8,348,337,53,-284
2015,9,26,9,349,341,53,-288
2015,9,26,10,359,349,51,-298
2015,9,26,11,382,372,53,-319
2015,9,26,12,409,398,52,-346
2015,9,26,13,442,433,53,-380
2015,9,26,14,474,460,52,-408
2015,9,26,15,488,479,52,-427
2015,9,26,16,494,485,54,-431
2015,9,26,17,497,481,51,-430
2015,9,26,18,499,478,54,-424
2015,9,26,19,492,472,51,-421
2015,9,26,20,495,471,53,-418
2015,9,26,21,500,477,52,-425
2015,9,26,22,503,483,53,-430
2015,9,26,23,501,487,54,-433
2015,9,27,0,510,495,54,-441
2015,9,27,1,507,493,53,-440
2015,9,27,2,478,472,54,-418
2015,9,27,3,443,443,49,-394
2015,9,27,4,403,404,52,-352
2015,9,27,5,381,370,49,-321
2015,9,27,6,355,353,51,-302
2015,9,27,7,343,345,51,-294
2015,9,27,8,336,339,50,-289
2015,9,27,9,332,339,51,-288
2015,9,27,10,340,347,52,-295
2015,9,27,11,359,362,49,-313
2015,9,27,12,387,393,51,-342
2015,9,27,13,429,430,50,-380
2015,9,27,14,458,452,51,-401
2015,9,27,15,464,463,52,-411
2015,9,27,16,469,460,49,-411
2015,9,27,17,481,467,51,-416
2015,9,27,18,485,468,50,-418
2015,9,27,19,482,467,51,-416
2015,9,27,20,488,472,51,-421
2015,9,27,21,500,480,50,-430
2015,9,27,22,511,486,50,-436
2015,9,27,23,511,499,51,-448
2015,9,28,0,533,518,67,-451
2015,9,28,1,535,518,76,-442
2015,9,28,2,502,487,65,-422
2015,9,28,3,462,443,54,-389
2015,9,28,4,421,411,54,-357
2015,9,28,5,385,377,53,-324
2015,9,28,6,368,364,53,-311
2015,9,28,7,356,357,53,-304
2015,9,28,8,354,354,51,-303
2015,9,28,9,361,364,53,-311
2015,9,28,10,394,400,51,-349
2015,9,28,11,461,464,76,-388
2015,9,28,12,494,503,84,-419
2015,9,28,13,511,513,81,-432
2015,9,28,14,528,531,99,-432
2015,9,28,15,545,544,112,-432
2015,9,28,16,546,554,113,-441
2015,9,28,17,552,552,129,-423
2015,9,28,18,556,542,202,-340
2015,9,28,19,549,565,232,-333
2015,9,28,20,549,569,234,-335
2015,9,28,21,559,570,233,-337
2015,9,28,22,563,575,235,-340
2015,9,28,23,570,581,238,-343
2015,9,29,0,587,600,281,-319
2015,9,29,1,595,594,303,-291
2015,9,29,2,558,544,125,-419
2015,9,29,3,504,504,110,-394
2015,9,29,4,456,457,109,-348
2015,9,29,5,408,422,110,-312
2015,9,29,6,390,400,109,-291
2015,9,29,7,379,389,110,-279
2015,9,29,8,374,379,109,-270
2015,9,29,9,380,389,109,-280
2015,9,29,10,413,418,110,-308
2015,9,29,11,480,492,131,-361
2015,9,29,12,509,524,154,-370
2015,9,29,13,524,537,185,-352
2015,9,29,14,536,549,272,-277
2015,9,29,15,551,568,290,-278
2015,9,29,16,561,571,288,-283
2015,9,29,17,569,569,312,-257
2015,9,29,18,578,578,437,-141
2015,9,29,19,577,571,442,-129
2015,9,29,20,578,571,442,-129
2015,9,29,21,581,582,455,-127
2015,9,29,22,577,581,472,-109
2015,9,29,23,577,589,477,-112
2015,9,30,0,587,605,494,-111
2015,9,30,1,587,600,486,-114
2015,9,30,2,546,548,373,-175
2015,9,30,3,487,499,243,-256
2015,9,30,4,438,452,159,-293
2015,9,30,5,414,416,144,-272
2015,9,30,6,392,398,151,-247
2015,9,30,7,378,386,150,-236
2015,9,30,8,374,377,150,-227
2015,9,30,9,377,384,150,-234
2015,9,30,10,411,415,150,-265
2015,9,30,11,475,477,151,-326
2015,9,30,12,506,510,150,-360
2015,9,30,13,516,521,152,-369
2015,9,30,14,529,542,170,-372
2015,9,30,15,547,556,198,-358
2015,9,30,16,557,573,221,-352
2015,9,30,17,567,582,222,-360
2015,9,30,18,578,717,348,-369
2015,9,30,19,580,611,365,-246
2015,9,30,20,582,604,363,-241
2015,9,30,21,588,605,360,-245
2015,9,30,22,585,601,361,-240
2015,9,30,23,582,603,360,-243
2015,10,1,0,589,580,334,-246
2015,10,1,1,582,471,218,-253
2015,10,1,2,544,557,217,-340
2015,10,1,3,488,500,199,-301
2015,10,1,4,437,450,128,-322
2015,10,1,5,414,418,120,-298
2015,10,1,6,392,398,120,-278
2015,10,1,7,377,383,120,-263
2015,10,1,8,373,375,120,-255
2015,10,1,9,379,378,119,-259
2015,10,1,10,413,410,154,-256
2015,10,1,11,482,473,223,-250
2015,10,1,12,513,508,229,-279
2015,10,1,13,521,507,228,-279
2015,10,1,14,527,522,207,-315
2015,10,1,15,536,529,203,-326
2015,10,1,16,537,536,204,-332
2015,10,1,17,531,536,210,-326
2015,10,1,18,531,539,228,-311
2015,10,1,19,529,533,218,-315
2015,10,1,20,528,527,204,-323
2015,10,1,21,536,531,207,-324
2015,10,1,22,539,533,204,-329
2015,10,1,23,551,538,199,-339
2015,10,2,0,570,557,199,-358
2015,10,2,1,561,547,196,-351
2015,10,2,2,529,516,198,-318
2015,10,2,3,475,469,166,-303
2015,10,2,4,434,425,123,-302
2015,10,2,5,400,392,116,-276
2015,10,2,6,380,373,116,-257
2015,10,2,7,368,359,118,-241
2015,10,2,8,364,358,122,-236
2015,10,2,9,374,368,123,-245
2015,10,2,10,406,393,127,-266
2015,10,2,11,475,456,155,-301
2015,10,2,12,510,494,159,-335
2015,10,2,13,517,504,158,-346
2015,10,2,14,523,511,157,-354
2015,10,2,15,533,518,155,-363
2015,10,2,16,535,521,158,-363
2015,10,2,17,532,520,153,-367
2015,10,2,18,526,516,157,-359
2015,10,2,19,526,512,160,-352
2015,10,2,20,529,504,157,-347
2015,10,2,21,539,507,159,-348
2015,10,2,22,543,511,157,-354
2015,10,2,23,547,517,129,-388
2015,10,3,0,559,529,118,-411
2015,10,3,1,541,517,115,-402
2015,10,3,2,514,494,118,-376
2015,10,3,3,481,456,117,-339
2015,10,3,4,436,415,116,-299
2015,10,3,5,409,385,119,-266
2015,10,3,6,387,363,118,-245
2015,10,3,7,374,353,120,-233
2015,10,3,8,368,346,130,-216
2015,10,3,9,373,351,130,-221
2015,10,3,10,384,360,134,-226
2015,10,3,11,407,381,130,-251
2015,10,3,12,441,408,130,-278
2015,10,3,13,478,448,129,-319
2015,10,3,14,504,486,132,-354
2015,10,3,15,512,512,131,-381
2015,10,3,16,510,523,131,-392
2015,10,3,17,504,512,130,-382
2015,10,3,18,492,504,129,-375
2015,10,3,19,481,493,129,-364
2015,10,3,20,480,490,130,-360
2015,10,3,21,484,490,129,-361
2015,10,3,22,488,503,119,-384
2015,10,3,23,493,505,133,-372
2015,10,4,0,514,514,145,-369
2015,10,4,1,509,499,144,-355
2015,10,4,2,482,478,146,-332
2015,10,4,3,448,442,145,-297
2015,10,4,4,414,407,141,-266
2015,10,4,5,388,372,135,-237
2015,10,4,6,367,352,121,-231
2015,10,4,7,354,344,122,-222
2015,10,4,8,348,339,112,-227
2015,10,4,9,352,332,123,-209
2015,10,4,10,359,343,128,-215
2015,10,4,11,376,363,131,-232
2015,10,4,12,407,390,141,-249
2015,10,4,13,451,435,167,-268
2015,10,4,14,477,458,176,-282
2015,10,4,15,477,470,175,-295
2015,10,4,16,477,467,165,-302
2015,10,4,17,478,469,185,-284
2015,10,4,18,477,470,178,-292
2015,10,4,19,471,468,165,-303
2015,10,4,20,472,466,149,-317
2015,10,4,21,477,477,158,-319
2015,10,4,22,484,483,157,-326
2015,10,4,23,493,485,159,-326
2015,10,5,0,521,515,164,-351
2015,10,5,1,516,510,161,-349
2015,10,5,2,484,474,151,-323
2015,10,5,3,444,442,136,-306
2015,10,5,4,407,400,139,-261
2015,10,5,5,372,368,135,-233
2015,10,5,6,352,353,138,-215
2015,10,5,7,340,346,138,-208
2015,10,5,8,336,342,137,-205
2015,10,5,9,346,348,137,-211
2015,10,5,10,382,388,138,-250
2015,10,5,11,451,448,137,-311
2015,10,5,12,483,491,167,-324
2015,10,5,13,494,503,175,-328
2015,10,5,14,507,521,173,-348
2015,10,5,15,516,536,177,-359
2015,10,5,16,524,543,158,-385
2015,10,5,17,520,548,145,-403
2015,10,5,18,524,560,120,-440
2015,10,5,19,524,566,119,-447
2015,10,5,20,533,574,118,-456
2015,10,5,21,537,588,131,-457
2015,10,5,22,537,577,133,-444
2015,10,5,23,543,575,120,-455
2015,10,6,0,558,597,121,-476
2015,10,6,1,546,582,118,-464
2015,10,6,2,509,544,118,-426
2015,10,6,3,455,495,128,-367
2015,10,6,4,414,443,154,-289
2015,10,6,5,391,401,141,-260
2015,10,6,6,371,385,141,-244
2015,10,6,7,360,370,132,-238
2015,10,6,8,356,363,129,-234
2015,10,6,9,365,372,118,-254
2015,10,6,10,399,400,119,-281
2015,10,6,11,468,471,138,-333
2015,10,6,12,502,506,145,-361
2015,10,6,13,506,511,145,-366
2015,10,6,14,511,521,150,-371
2015,10,6,15,514,523,152,-371
2015,10,6,16,519,529,159,-370
2015,10,6,17,516,534,170,-364
2015,10,6,18,521,548,178,-370
2015,10,6,19,522,559,188,-371
2015,10,6,20,535,567,191,-376
2015,10,6,21,542,579,196,-383
2015,10,6,22,546,578,199,-379
2015,10,6,23,556,575,201,-374
2015,10,7,0,570,590,201,-389
2015,10,7,1,555,581,201,-380
2015,10,7,2,524,539,199,-340
2015,10,7,3,470,487,198,-289
2015,10,7,4,424,437,202,-235
2015,10,7,5,391,400,201,-199
2015,10,7,6,373,384,198,-186
2015,10,7,7,361,375,199,-176
2015,10,7,8,359,376,199,-177
2015,10,7,9,367,378,201,-177
2015,10,7,10,400,412,206,-206
2015,10,7,11,467,482,207,-275
2015,10,7,12,501,517,214,-303
2015,10,7,13,505,520,215,-305
2015,10,7,14,516,526,220,-306
2015,10,7,15,521,535,221,-314
2015,10,7,16,526,536,227,-309
2015,10,7,17,525,544,234,-310
2015,10,7,18,539,563,291,-272
2015,10,7,19,547,559,319,-240
2015,10,7,20,557,579,338,-241
2015,10,7,21,571,584,341,-243
2015,10,7,22,576,587,351,-236
2015,10,7,23,582,583,368,-215
2015,10,8,0,592,599,373,-226
2015,10,8,1,575,590,378,-212
2015,10,8,2,539,548,314,-234
2015,10,8,3,485,493,254,-239
2015,10,8,4,434,438,247,-191
2015,10,8,5,399,404,244,-160
2015,10,8,6,377,389,245,-144
2015,10,8,7,365,375,245,-130
2015,10,8,8,362,371,245,-126
2015,10,8,9,369,377,246,-131
2015,10,8,10,399,410,225,-185
2015,10,8,11,466,480,229,-251
2015,10,8,12,497,507,229,-278
2015,10,8,13,506,510,229,-281
2015,10,8,14,517,520,231,-289
2015,10,8,15,524,520,230,-290
2015,10,8,16,529,530,231,-299
2015,10,8,17,527,547,284,-263
2015,10,8,18,537,555,364,-191
2015,10,8,19,545,552,372,-180
2015,10,8,20,554,562,393,-169
2015,10,8,21,565,569,426,-143
2015,10,8,22,568,574,452,-122
2015,10,8,23,571,567,439,-128
2015,10,9,0,588,591,403,-188
2015,10,9,1,577,577,367,-210
2015,10,9,2,539,542,308,-234
2015,10,9,3,485,491,249,-242
2015,10,9,4,437,439,243,-196
2015,10,9,5,399,399,203,-196
2015,10,9,6,377,381,178,-203
2015,10,9,7,363,367,177,-190
2015,10,9,8,359,364,176,-188
2015,10,9,9,366,373,179,-194
2015,10,9,10,396,398,179,-219
2015,10,9,11,459,465,179,-286
2015,10,9,12,491,500,179,-321
2015,10,9,13,499,509,179,-330
2015,10,9,14,515,522,181,-341
2015,10,9,15,527,531,178,-353
2015,10,9,16,534,533,180,-353
2015,10,9,17,536,540,181,-359
2015,10,9,18,555,544,178,-366
2015,10,9,19,548,539,239,-300
2015,10,9,20,558,540,242,-298
2015,10,9,21,561,543,242,-301
2015,10,9,22,559,546,244,-302
2015,10,9,23,551,539,244,-295
2015,10,10,0,562,551,240,-311
2015,10,10,1,537,542,201,-341
2015,10,10,2,515,516,180,-336
2015,10,10,3,478,480,170,-310
2015,10,10,4,433,432,143,-289
2015,10,10,5,402,400,99,-301
2015,10,10,6,377,372,53,-319
2015,10,10,7,361,361,53,-308
2015,10,10,8,353,352,52,-300
2015,10,10,9,356,352,51,-301
2015,10,10,10,363,367,55,-312
2015,10,10,11,385,392,64,-328
2015,10,10,12,418,425,106,-319
2015,10,10,13,455,463,130,-333
2015,10,10,14,485,490,137,-353
2015,10,10,15,499,516,219,-297
2015,10,10,16,501,519,229,-290
2015,10,10,17,497,514,229,-285
2015,10,10,18,495,504,227,-277
2015,10,10,19,488,493,219,-274
2015,10,10,20,481,491,211,-280
2015,10,10,21,485,497,217,-280
2015,10,10,22,485,497,215,-282
2015,10,10,23,494,507,215,-292
2015,10,11,0,516,516,214,-302
2015,10,11,1,505,507,214,-293
2015,10,11,2,480,482,215,-267
2015,10,11,3,449,446,186,-260
2015,10,11,4,415,409,132,-277
2015,10,11,5,403,378,120,-258
2015,10,11,6,383,359,118,-241
2015,10,11,7,371,347,116,-231
2015,10,11,8,366,346,115,-231
2015,10,11,9,366,340,116,-224
2015,10,11,10,374,353,114,-239
2015,10,11,11,392,372,115,-257
2015,10,11,12,424,406,115,-291
2015,10,11,13,464,446,112,-334
2015,10,11,14,481,476,116,-360
2015,10,11,15,476,475,115,-360
2015,10,11,16,465,472,118,-354
2015,10,11,17,464,472,116,-356
2015,10,11,18,467,470,117,-353
2015,10,11,19,462,467,116,-351
2015,10,11,20,465,468,117,-351
2015,10,11,21,471,476,116,-360
2015,10,11,22,480,493,118,-375
2015,10,11,23,495,497,135,-362
2015,10,12,0,527,527,142,-385
2015,10,12,1,514,521,139,-382
2015,10,12,2,481,489,123,-366
2015,10,12,3,444,445,117,-328
2015,10,12,4,406,407,117,-290
2015,10,12,5,377,378,116,-262
2015,10,12,6,360,357,114,-243
2015,10,12,7,351,349,114,-235
2015,10,12,8,349,350,115,-235
2015,10,12,9,360,360,116,-244
2015,10,12,10,396,394,114,-280
2015,10,12,11,467,464,114,-350
2015,10,12,12,507,504,118,-386
2015,10,12,13,513,510,120,-390
2015,10,12,14,522,523,124,-399
2015,10,12,15,522,528,128,-400
2015,10,12,16,519,522,125,-397
2015,10,12,17,516,520,122,-398
2015,10,12,18,515,521,122,-399
2015,10,12,19,513,520,122,-398
2015,10,12,20,519,524,121,-403
2015,10,12,21,524,535,126,-409
2015,10,12,22,528,548,134,-414
2015,10,12,23,537,549,151,-398
2015,10,13,0,568,570,171,-399
2015,10,13,1,552,558,161,-397
2015,10,13,2,514,520,129,-391
2015,10,13,3,466,470,124,-346
2015,10,13,4,419,419,125,-294
2015,10,13,5,388,388,125,-263
2015,10,13,6,372,369,124,-245
2015,10,13,7,362,363,124,-239
2015,10,13,8,358,358,121,-237
2015,10,13,9,368,369,123,-246
2015,10,13,10,402,405,145,-260
2015,10,13,11,470,475,180,-295
2015,10,13,12,509,512,182,-330
2015,10,13,13,517,517,182,-335
2015,10,13,14,524,525,182,-343
2015,10,13,15,525,525,182,-343
2015,10,13,16,529,531,160,-371
2015,10,13,17,526,533,131,-402
2015,10,13,18,527,543,138,-405
2015,10,13,19,528,514,127,-387
2015,10,13,20,537,539,135,-404
2015,10,13,21,542,542,140,-402
2015,10,13,22,543,547,155,-392
2015,10,13,23,544,547,170,-377
2015,10,14,0,573,573,197,-376
2015,10,14,1,557,562,195,-367
2015,10,14,2,517,521,195,-326
2015,10,14,3,469,471,201,-270
2015,10,14,4,426,426,170,-256
2015,10,14,5,400,394,156,-238
2015,10,14,6,386,380,133,-247
2015,10,14,7,380,372,122,-250
2015,10,14,8,380,370,123,-247
2015,10,14,9,391,381,123,-258
2015,10,14,10,428,412,122,-290
2015,10,14,11,503,487,152,-335
2015,10,14,12,543,520,172,-348
2015,10,14,13,544,526,172,-354
2015,10,14,14,548,528,148,-380
2015,10,14,15,538,525,142,-383
2015,10,14,16,527,516,142,-374
2015,10,14,17,518,519,147,-372
2015,10,14,18,534,521,148,-373
2015,10,14,19,509,512,145,-367
2015,10,14,20,502,523,149,-374
2015,10,14,21,506,528,151,-377
2015,10,14,22,514,532,162,-370
2015,10,14,23,531,533,137,-396
2015,10,15,0,558,557,219,-338
2015,10,15,1,533,551,212,-339
2015,10,15,2,522,518,138,-380
2015,10,15,3,481,471,68,-403
2015,10,15,4,438,426,56,-370
2015,10,15,5,410,395,54,-341
2015,10,15,6,396,379,52,-327
2015,10,15,7,391,373,52,-321
2015,10,15,8,392,374,52,-322
2015,10,15,9,403,386,53,-333
2015,10,15,10,446,429,54,-375
2015,10,15,11,525,506,95,-411
2015,10,15,12,568,548,174,-374
2015,10,15,13,568,550,176,-374
2015,10,15,14,564,551,179,-372
2015,10,15,15,546,543,178,-365
2015,10,15,16,532,527,178,-349
2015,10,15,17,518,524,205,-319
2015,10,15,18,529,521,218,-303
2015,10,15,19,504,513,218,-295
2015,10,15,20,499,510,216,-294
2015,10,15,21,501,517,213,-304
2015,10,15,22,507,523,208,-315
2015,10,15,23,524,527,208,-319
2015,10,16,0,557,557,208,-349
2015,10,16,1,535,550,161,-389
2015,10,16,2,521,524,133,-391
2015,10,16,3,480,474,72,-402
2015,10,16,4,440,434,53,-381
2015,10,16,5,402,407,53,-354
2015,10,16,6,388,391,55,-336
2015,10,16,7,382,386,53,-333
2015,10,16,8,382,387,54,-333
2015,10,16,9,394,399,55,-344
2015,10,16,10,427,435,54,-381
2015,10,16,11,500,512,90,-422
2015,10,16,12,535,549,144,-405
2015,10,16,13,546,553,152,-401
2015,10,16,14,550,554,154,-400
2015,10,16,15,540,547,189,-358
2015,10,16,16,527,535,191,-344
2015,10,16,17,522,523,191,-332
2015,10,16,18,523,511,191,-320
2015,10,16,19,509,507,193,-314
2015,10,16,20,512,504,192,-312
2015,10,16,21,512,507,191,-316
2015,10,16,22,517,506,191,-315
2015,10,16,23,520,513,190,-323
2015,10,17,0,546,535,204,-331
2015,10,17,1,534,541,198,-343
2015,10,17,2,510,525,178,-347
2015,10,17,3,483,496,177,-319
2015,10,17,4,442,462,179,-283
2015,10,17,5,424,430,158,-272
2015,10,17,6,408,421,86,-335
2015,10,17,7,405,416,55,-361
2015,10,17,8,410,419,55,-364
2015,10,17,9,420,432,56,-376
2015,10,17,10,443,449,53,-396
2015,10,17,11,484,495,88,-407
2015,10,17,12,526,543,138,-405
2015,10,17,13,563,582,174,-408
2015,10,17,14,570,582,176,-406
2015,10,17,15,557,557,151,-406
2015,10,17,16,530,534,131,-403
2015,10,17,17,506,511,126,-385
2015,10,17,18,487,489,126,-363
2015,10,17,19,472,481,193,-288
2015,10,17,20,467,473,195,-278
2015,10,17,21,471,476,192,-284
2015,10,17,22,480,491,191,-300
2015,10,17,23,500,508,190,-318
2015,10,18,0,536,546,191,-355
2015,10,18,1,537,544,160,-384
2015,10,18,2,518,535,131,-404
2015,10,18,3,491,507,123,-384
2015,10,18,4,465,475,79,-396
2015,10,18,5,449,452,57,-395
2015,10,18,6,439,446,57,-389
2015,10,18,7,438,442,56,-386
2015,10,18,8,444,449,57,-392
2015,10,18,9,453,457,60,-397
2015,10,18,10,472,485,86,-399
2015,10,18,11,508,519,117,-402
2015,10,18,12,556,569,161,-408
2015,10,18,13,605,615,201,-414
2015,10,18,14,608,614,208,-406
2015,10,18,15,582,573,170,-403
2015,10,18,16,548,543,141,-402
2015,10,18,17,523,525,139,-386
2015,10,18,18,502,507,135,-372
2015,10,18,19,481,495,136,-359
2015,10,18,20,475,483,133,-350
2015,10,18,21,483,492,134,-358
2015,10,18,22,502,513,130,-383
2015,10,18,23,536,537,137,-400
2015,10,19,0,572,583,182,-401
2015,10,19,1,579,596,208,-388
2015,10,19,2,555,567,179,-388
2015,10,19,3,526,536,138,-398
2015,10,19,4,497,507,109,-398
2015,10,19,5,467,489,91,-398
2015,10,19,6,459,489,89,-400
2015,10,19,7,458,493,95,-398
2015,10,19,8,463,506,105,-401
2015,10,19,9,483,530,130,-400
2015,10,19,10,526,583,180,-403
2015,10,19,11,611,662,292,-370
2015,10,19,12,657,710,373,-337
2015,10,19,13,655,715,396,-319
2015,10,19,14,637,688,360,-328
2015,10,19,15,609,648,323,-325
2015,10,19,16,588,610,263,-347
2015,10,19,17,569,580,246,-334
2015,10,19,18,550,554,154,-400
2015,10,19,19,529,533,139,-394
2015,10,19,20,524,526,134,-392
2015,10,19,21,529,529,133,-396
2015,10,19,22,540,541,153,-388
2015,10,19,23,561,564,164,-400
2015,10,20,0,606,607,163,-444
2015,10,20,1,607,600,154,-446
2015,10,20,2,580,574,133,-441
2015,10,20,3,539,540,130,-410
2015,10,20,4,500,499,127,-372
2015,10,20,5,485,473,99,-374
2015,10,20,6,477,474,57,-417
2015,10,20,7,476,481,55,-426
2015,10,20,8,484,491,53,-438
2015,10,20,9,504,515,97,-418
2015,10,20,10,550,567,155,-412
2015,10,20,11,628,648,229,-419
2015,10,20,12,675,694,260,-434
2015,10,20,13,671,692,259,-433
2015,10,20,14,645,664,260,-404
2015,10,20,15,609,619,252,-367
2015,10,20,16,576,583,147,-436
2015,10,20,17,551,550,76,-474
2015,10,20,18,549,538,78,-460
2015,10,20,19,520,523,75,-448
2015,10,20,20,514,521,76,-445
2015,10,20,21,517,520,75,-445
2015,10,20,22,519,531,61,-470
2015,10,20,23,541,553,91,-462
2015,10,21,0,573,586,124,-462
2015,10,21,1,558,577,128,-449
2015,10,21,2,546,548,125,-423
2015,10,21,3,503,499,77,-422
2015,10,21,4,464,459,59,-400
2015,10,21,5,445,437,58,-379
2015,10,21,6,435,433,59,-374
2015,10,21,7,435,431,58,-373
2015,10,21,8,444,441,58,-383
2015,10,21,9,465,467,58,-409
2015,10,21,10,509,520,82,-438
2015,10,21,11,595,602,205,-397
2015,10,21,12,635,649,259,-390
2015,10,21,13,629,650,258,-392
2015,10,21,14,612,622,189,-433
2015,10,21,15,584,586,150,-436
2015,10,21,16,560,563,118,-445
2015,10,21,17,547,536,118,-418
2015,10,21,18,543,529,118,-411
2015,10,21,19,527,516,118,-398
2015,10,21,20,525,521,120,-401
2015,10,21,21,525,525,124,-401
2015,10,21,22,532,533,182,-351
2015,10,21,23,545,549,193,-356
2015,10,22,0,573,571,189,-382
2015,10,22,1,561,564,170,-394
2015,10,22,2,534,535,126,-409
2015,10,22,3,492,487,72,-415
2015,10,22,4,450,448,62,-386
2015,10,22,5,408,418,59,-359
2015,10,22,6,396,409,58,-351
2015,10,22,7,392,409,58,-351
2015,10,22,8,395,420,61,-359
2015,10,22,9,411,435,58,-377
2015,10,22,10,457,486,88,-398
2015,10,22,11,542,572,160,-412
2015,10,22,12,589,618,221,-397
2015,10,22,13,586,610,213,-397
2015,10,22,14,572,598,189,-409
2015,10,22,15,556,569,145,-424
2015,10,22,16,539,544,122,-422
2015,10,22,17,532,524,76,-448
2015,10,22,18,527,518,58,-460
2015,10,22,19,525,509,53,-456
2015,10,22,20,532,510,56,-454
2015,10,22,21,535,516,83,-433
2015,10,22,22,541,526,87,-439
2015,10,22,23,545,531,119,-412
2015,10,23,0,574,562,151,-411
2015,10,23,1,563,556,124,-432
2015,10,23,2,529,526,122,-404
2015,10,23,3,483,482,102,-380
2015,10,23,4,437,438,59,-379
2015,10,23,5,410,407,46,-361
2015,10,23,6,396,400,52,-348
2015,10,23,7,389,393,50,-343
2015,10,23,8,388,398,54,-344
2015,10,23,9,401,412,55,-357
2015,10,23,10,439,452,55,-397
2015,10,23,11,514,532,55,-477
2015,10,23,12,554,574,66,-508
2015,10,23,13,557,578,73,-505
2015,10,23,14,553,572,64,-508
2015,10,23,15,541,549,51,-498
2015,10,23,16,536,532,53,-479
2015,10,23,17,528,518,53,-465
2015,10,23,18,530,521,53,-468
2015,10,23,19,527,519,65,-454
2015,10,23,20,534,516,130,-386
2015,10,23,21,535,519,180,-339
2015,10,23,22,539,517,177,-340
2015,10,23,23,536,520,167,-353
2015,10,24,0,549,536,191,-345
2015,10,24,1,534,522,124,-398
2015,10,24,2,505,497,123,-374
2015,10,24,3,474,464,123,-341
2015,10,24,4,431,427,122,-305
2015,10,24,5,403,396,125,-271
2015,10,24,6,384,372,122,-250
2015,10,24,7,375,366,124,-242
2015,10,24,8,371,366,123,-243
2015,10,24,9,373,375,124,-251
2015,10,24,10,384,391,122,-269
2015,10,24,11,410,424,123,-301
2015,10,24,12,447,461,124,-337
2015,10,24,13,480,497,122,-375
2015,10,24,14,503,515,125,-390
2015,10,24,15,508,516,136,-380
2015,10,24,16,497,501,138,-363
2015,10,24,17,488,490,147,-343
2015,10,24,18,480,483,169,-314
2015,10,24,19,473,475,166,-309
2015,10,24,20,474,477,170,-307
2015,10,24,21,477,476,168,-308
2015,10,24,22,485,483,148,-335
2015,10,24,23,498,503,160,-343
2015,10,25,0,515,517,168,-349
2015,10,25,1,499,504,129,-375
2015,10,25,2,473,482,121,-361
2015,10,25,3,445,445,119,-326
2015,10,25,4,408,410,119,-291
2015,10,25,5,380,384,121,-263
2015,10,25,6,361,363,119,-244
2015,10,25,7,352,358,121,-237
2015,10,25,8,348,347,118,-229
2015,10,25,9,350,355,120,-235
2015,10,25,10,358,360,119,-241
2015,10,25,11,378,381,119,-262
2015,10,25,12,417,424,118,-306
2015,10,25,13,462,460,117,-343
2015,10,25,14,487,481,118,-363
2015,10,25,15,488,483,119,-364
2015,10,25,16,482,470,116,-354
2015,10,25,17,482,473,118,-355
2015,10,25,18,481,467,118,-349
2015,10,25,19,479,463,116,-347
2015,10,25,20,485,461,118,-343
2015,10,25,21,489,468,150,-318
2015,10,25,22,501,484,177,-307
2015,10,25,23,513,505,198,-307
2015,10,26,0,533,528,265,-263
2015,10,26,1,520,511,290,-221
2015,10,26,2,488,477,222,-255
2015,10,26,3,451,441,171,-270
2015,10,26,4,409,406,175,-231
2015,10,26,5,377,379,174,-205
2015,10,26,6,361,361,174,-187
2015,10,26,7,351,357,175,-182
2015,10,26,8,351,355,174,-181
2015,10,26,9,364,365,175,-190
2015,10,26,10,397,395,190,-205
2015,10,26,11,468,453,248,-205
2015,10,26,12,521,502,316,-186
2015,10,26,13,534,517,322,-195
2015,10,26,14,550,539,324,-215
2015,10,26,15,555,551,323,-228
2015,10,26,16,558,557,317,-240
2015,10,26,17,557,556,279,-277
2015,10,26,18,547,554,249,-305
2015,10,26,19,532,548,246,-302
2015,10,26,20,532,550,245,-305
2015,10,26,21,541,551,234,-317
2015,10,26,22,554,566,216,-350
2015,10,26,23,571,591,257,-334
2015,10,27,0,594,599,312,-287
2015,10,27,1,580,581,314,-267
2015,10,27,2,548,549,271,-278
2015,10,27,3,508,508,209,-299
2015,10,27,4,458,465,161,-304
2015,10,27,5,449,444,127,-317
2015,10,27,6,433,431,129,-302
2015,10,27,7,423,429,128,-301
2015,10,27,8,423,427,126,-301
2015,10,27,9,434,438,126,-312
2015,10,27,10,468,477,146,-331
2015,10,27,11,537,539,222,-317
2015,10,27,12,582,574,237,-337
2015,10,27,13,588,594,239,-355
2015,10,27,14,599,601,242,-359
2015,10,27,15,600,606,254,-352
2015,10,27,16,600,605,257,-348
2015,10,27,17,596,602,256,-346
2015,10,27,18,593,594,257,-337
2015,10,27,19,574,586,257,-329
2015,10,27,20,577,579,210,-369
2015,10,27,21,586,586,183,-403
2015,10,27,22,597,603,198,-405
2015,10,27,23,615,629,233,-396
2015,10,28,0,632,637,239,-398
2015,10,28,1,621,614,240,-374
2015,10,28,2,585,577,192,-385
2015,10,28,3,539,525,122,-403
2015,10,28,4,493,483,98,-385
2015,10,28,5,463,445,94,-351
2015,10,28,6,446,429,95,-334
2015,10,28,7,437,416,93,-323
2015,10,28,8,435,417,94,-323
2015,10,28,9,446,425,94,-331
2015,10,28,10,479,465,135,-330
2015,10,28,11,546,533,300,-233
2015,10,28,12,584,557,335,-222
2015,10,28,13,586,558,290,-268
2015,10,28,14,584,557,284,-273
2015,10,28,15,573,557,287,-270
2015,10,28,16,561,558,295,-263
2015,10,28,17,550,548,327,-221
2015,10,28,18,540,543,342,-201
2015,10,28,19,530,524,335,-189
2015,10,28,20,524,531,322,-209
2015,10,28,21,529,533,339,-194
2015,10,28,22,535,540,331,-209
2015,10,28,23,549,556,332,-224
2015,10,29,0,566,580,332,-248
2015,10,29,1,559,560,332,-228
2015,10,29,2,532,534,332,-202
2015,10,29,3,485,480,278,-202
2015,10,29,4,443,442,212,-230
2015,10,29,5,409,409,200,-209
2015,10,29,6,391,394,200,-194
2015,10,29,7,383,391,186,-205
2015,10,29,8,383,390,185,-205
2015,10,29,9,393,403,185,-218
2015,10,29,10,427,442,205,-237
2015,10,29,11,496,518,297,-221
2015,10,29,12,542,548,305,-243
2015,10,29,13,553,547,305,-242
2015,10,29,14,557,558,307,-251
2015,10,29,15,551,561,305,-256
2015,10,29,16,541,557,276,-281
2015,10,29,17,536,552,260,-292
2015,10,29,18,531,545,260,-285
2015,10,29,19,524,537,262,-275
2015,10,29,20,522,522,262,-260
2015,10,29,21,527,524,261,-263
2015,10,29,22,536,529,262,-267
2015,10,29,23,549,553,268,-285
2015,10,30,0,571,587,280,-307
2015,10,30,1,559,586,283,-303
2015,10,30,2,534,556,280,-276
2015,10,30,3,490,516,274,-242
2015,10,30,4,452,470,207,-263
2015,10,30,5,430,447,157,-290
2015,10,30,6,417,440,156,-284
2015,10,30,7,414,433,146,-287
2015,10,30,8,421,438,143,-295
2015,10,30,9,439,453,141,-312
2015,10,30,10,483,492,141,-351
2015,10,30,11,557,574,165,-409
2015,10,30,12,605,611,210,-401
2015,10,30,13,613,611,213,-398
2015,10,30,14,611,591,208,-383
2015,10,30,15,591,569,207,-362
2015,10,30,16,568,551,209,-342
2015,10,30,17,547,531,206,-325
2015,10,30,18,533,516,207,-309
2015,10,30,19,514,506,207,-299
2015,10,30,20,508,500,209,-291
2015,10,30,21,506,499,208,-291
2015,10,30,22,513,508,208,-300
2015,10,30,23,531,526,209,-317
2015,10,31,0,552,546,210,-336
2015,10,31,1,540,542,206,-336
2015,10,31,2,523,533,208,-325
2015,10,31,3,497,505,199,-306
2015,10,31,4,462,474,145,-329
2015,10,31,5,442,460,140,-320
2015,10,31,6,429,448,136,-312
2015,10,31,7,424,445,137,-308
2015,10,31,8,425,446,138,-308
2015,10,31,9,437,452,136,-316
2015,10,31,10,457,465,102,-363
2015,10,31,11,494,498,102,-396
2015,10,31,12,535,536,134,-402
2015,10,31,13,572,567,178,-389
2015,10,31,14,582,576,224,-352
2015,10,31,15,573,582,234,-348
2015,10,31,16,549,561,215,-346
2015,10,31,17,522,543,195,-348
2015,10,31,18,501,522,186,-336
2015,10,31,19,486,513,134,-379
2015,10,31,20,481,521,127,-394
2015,10,31,21,484,524,127,-397
2015,10,31,22,493,523,127,-396
2015,10,31,23,509,526,127,-399
2015,11,1,0,527,528,128,-400
2015,11,1,1,518,520,126,-394
2015,11,1,2,495,511,127,-384
2015,11,1,3,470,479,125,-354
2015,11,1,4,437,446,106,-340
2015,11,1,5,-9999,417,100,-317
2015,11,1,6,-9999,388,101,-288
2015,11,1,7,-9999,401,100,-300
2015,11,1,8,-9999,377,99,-278
2015,11,1,9,-9999,372,101,-271
2015,11,1,10,-9999,374,100,-274
2015,11,1,11,-9999,390,101,-289
2015,11,1,12,-9999,411,98,-313
2015,11,1,13,-9999,451,101,-350
2015,11,1,14,-9999,492,124,-368
2015,11,1,15,-9999,507,179,-328
2015,11,1,16,-9999,500,148,-352
2015,11,1,17,-9999,489,108,-381
2015,11,1,18,-9999,492,111,-381
2015,11,1,19,-9999,491,110,-381
2015,11,1,20,-9999,484,111,-373
2015,11,1,21,-9999,480,109,-371
2015,11,1,22,-9999,505,211,-294
2015,11,1,23,-9999,536,351,-185
2015,11,2,0,-9999,552,376,-176
2015,11,2,1,-9999,536,376,-160
2015,11,2,2,-9999,515,360,-155
2015,11,2,3,-9999,476,288,-188
2015,11,2,4,-9999,440,197,-243
2015,11,2,5,-9999,406,116,-290
2015,11,2,6,396,387,101,-286
2015,11,2,7,381,371,100,-271
2015,11,2,8,373,364,101,-263
2015,11,2,9,371,367,105,-262
2015,11,2,10,385,378,104,-274
2015,11,2,11,426,420,103,-317
2015,11,2,12,503,492,147,-345
2015,11,2,13,538,524,164,-360
2015,11,2,14,541,534,165,-369
2015,11,2,15,545,550,170,-380
2015,11,2,16,543,558,226,-332
2015,11,2,17,538,558,265,-293
2015,11,2,18,532,555,252,-303
2015,11,2,19,528,549,244,-305
2015,11,2,20,520,536,243,-293
2015,11,2,21,525,535,231,-304
2015,11,2,22,537,543,229,-314
2015,11,2,23,578,579,270,-309
2015,11,3,0,606,599,353,-246
2015,11,3,1,590,585,289,-296
2015,11,3,2,568,555,187,-368
2015,11,3,3,534,523,117,-406
2015,11,3,4,486,477,106,-371
2015,11,3,5,445,435,102,-333
2015,11,3,6,428,408,101,-307
2015,11,3,7,413,389,100,-289
2015,11,3,8,404,382,102,-280
2015,11,3,9,404,385,102,-283
2015,11,3,10,418,387,101,-286
2015,11,3,11,458,424,163,-261
2015,11,3,12,533,497,217,-280
2015,11,3,13,566,520,253,-267
2015,11,3,14,564,524,285,-239
2015,11,3,15,555,524,304,-220
2015,11,3,16,548,527,306,-221
2015,11,3,17,538,526,288,-238
2015,11,3,18,530,526,265,-261
2015,11,3,19,526,527,265,-262
2015,11,3,20,518,522,256,-266
2015,11,3,21,524,522,256,-266
2015,11,3,22,537,528,255,-273
2015,11,3,23,577,560,290,-270
2015,11,4,0,603,586,373,-213
2015,11,4,1,591,583,377,-206
2015,11,4,2,569,558,375,-183
2015,11,4,3,538,520,366,-154
2015,11,4,4,488,468,261,-207
2015,11,4,5,446,427,128,-299
2015,11,4,6,413,398,104,-294
2015,11,4,7,398,386,106,-280
2015,11,4,8,388,378,105,-273
2015,11,4,9,389,377,105,-272
2015,11,4,10,403,385,104,-281
2015,11,4,11,444,418,108,-310
2015,11,4,12,521,495,118,-377
2015,11,4,13,554,520,122,-398
2015,11,4,14,551,520,119,-401
2015,11,4,15,546,532,124,-408
2015,11,4,16,540,530,127,-403
2015,11,4,17,533,533,125,-408
2015,11,4,18,523,529,124,-405
2015,11,4,19,518,532,124,-408
2015,11,4,20,512,524,123,-401
2015,11,4,21,514,527,123,-404
2015,11,4,22,529,534,126,-408
2015,11,4,23,570,555,192,-363
2015,11,5,0,595,585,279,-306
2015,11,5,1,580,574,276,-298
2015,11,5,2,561,552,173,-379
2015,11,5,3,530,515,119,-396
2015,11,5,4,480,472,112,-360
2015,11,5,5,439,431,111,-320
2015,11,5,6,402,398,110,-288
2015,11,5,7,385,388,113,-275
2015,11,5,8,376,379,113,-266
2015,11,5,9,375,374,111,-263
2015,11,5,10,386,385,113,-272
2015,11,5,11,423,418,114,-304
2015,11,5,12,499,490,124,-366
2015,11,5,13,527,519,161,-358
2015,11,5,14,530,521,160,-361
2015,11,5,15,527,527,161,-366
2015,11,5,16,523,528,155,-373
2015,11,5,17,525,532,154,-378
2015,11,5,18,518,533,156,-377
2015,11,5,19,520,531,156,-375
2015,11,5,20,518,531,155,-376
2015,11,5,21,524,525,154,-371
2015,11,5,22,538,538,158,-380
2015,11,5,23,567,567,195,-372
2015,11,6,0,583,585,241,-344
2015,11,6,1,567,574,242,-332
2015,11,6,2,545,552,193,-359
2015,11,6,3,513,522,147,-375
2015,11,6,4,463,477,140,-337
2015,11,6,5,422,430,132,-298
2015,11,6,6,398,400,135,-265
2015,11,6,7,377,386,134,-252
2015,11,6,8,369,376,136,-240
2015,11,6,9,366,375,136,-239
2015,11,6,10,375,384,133,-251
2015,11,6,11,409,417,143,-274
2015,11,6,12,478,480,205,-275
2015,11,6,13,503,512,222,-290
2015,11,6,14,505,518,230,-288
2015,11,6,15,515,529,231,-298
2015,11,6,16,520,532,230,-302
2015,11,6,17,525,534,231,-303
2015,11,6,18,521,532,231,-301
2015,11,6,19,527,547,231,-316
2015,11,6,20,522,536,232,-304
2015,11,6,21,529,530,231,-299
2015,11,6,22,536,539,232,-307
2015,11,6,23,558,553,293,-260
2015,11,7,0,566,565,285,-280
2015,11,7,1,546,553,229,-324
2015,11,7,2,519,532,180,-352
2015,11,7,3,492,506,158,-348
2015,11,7,4,461,471,137,-334
2015,11,7,5,423,430,138,-292
2015,11,7,6,401,398,137,-261
2015,11,7,7,383,378,139,-239
2015,11,7,8,375,366,138,-228
2015,11,7,9,369,357,138,-219
2015,11,7,10,375,363,140,-223
2015,11,7,11,392,376,139,-237
2015,11,7,12,420,400,137,-263
2015,11,7,13,453,432,141,-291
2015,11,7,14,484,465,137,-328
2015,11,7,15,498,497,139,-358
2015,11,7,16,507,509,140,-369
2015,11,7,17,500,513,139,-374
2015,11,7,18,491,504,137,-367
2015,11,7,19,491,498,138,-360
2015,11,7,20,485,497,139,-358
2015,11,7,21,476,495,137,-358
2015,11,7,22,492,510,137,-373
2015,11,7,23,533,533,136,-397
2015,11,8,0,553,537,143,-394
2015,11,8,1,536,524,142,-382
2015,11,8,2,517,506,141,-365
2015,11,8,3,497,487,140,-347
2015,11,8,4,470,459,141,-318
2015,11,8,5,441,431,140,-291
2015,11,8,6,434,408,135,-273
2015,11,8,7,420,391,132,-259
2015,11,8,8,411,387,134,-253
2015,11,8,9,410,378,127,-251
2015,11,8,10,416,386,130,-256
2015,11,8,11,437,400,128,-272
2015,11,8,12,466,430,130,-300
2015,11,8,13,502,468,126,-342
2015,11,8,14,535,516,128,-388
2015,11,8,15,539,533,148,-385
2015,11,8,16,523,527,152,-375
2015,11,8,17,503,513,151,-362
2015,11,8,18,495,515,152,-363
2015,11,8,19,488,513,154,-359
2015,11,8,20,480,504,152,-352
2015,11,8,21,477,497,150,-347
2015,11,8,22,502,513,153,-360
2015,11,8,23,550,566,233,-333
2015,11,9,0,584,591,288,-303
2015,11,9,1,577,583,287,-296
2015,11,9,2,567,568,284,-284
2015,11,9,3,534,536,273,-263
2015,11,9,4,504,498,210,-288
2015,11,9,5,472,467,175,-292
2015,11,9,6,448,442,134,-308
2015,11,9,7,438,431,135,-296
2015,11,9,8,433,432,137,-295
2015,11,9,9,436,433,134,-299
2015,11,9,10,449,447,135,-312
2015,11,9,11,488,491,135,-356
2015,11,9,12,561,571,168,-403
2015,11,9,13,592,605,236,-369
2015,11,9,14,595,610,239,-371
2015,11,9,15,601,618,241,-377
2015,11,9,16,605,619,238,-381
2015,11,9,17,603,614,240,-374
2015,11,9,18,598,595,241,-354
2015,11,9,19,596,582,239,-343
2015,11,9,20,586,568,239,-329
2015,11,9,21,586,568,239,-329
2015,11,9,22,601,580,239,-341
2015,11,9,23,650,620,316,-304
2015,11,10,0,690,634,365,-269
2015,11,10,1,677,619,369,-250
2015,11,10,2,655,601,371,-230
2015,11,10,3,615,559,368,-191
2015,11,10,4,566,507,264,-243
2015,11,10,5,522,463,138,-325
2015,11,10,6,476,438,108,-330
2015,11,10,7,464,423,99,-324
2015,11,10,8,457,415,100,-315
2015,11,10,9,457,414,98,-316
2015,11,10,10,469,429,99,-330
2015,11,10,11,506,468,122,-346
2015,11,10,12,575,539,161,-378
2015,11,10,13,599,563,187,-376
2015,11,10,14,599,557,188,-369
2015,11,10,15,585,548,184,-364
2015,11,10,16,569,536,183,-353
2015,11,10,17,557,524,184,-340
2015,11,10,18,543,515,220,-295
2015,11,10,19,535,513,240,-273
2015,11,10,20,523,509,239,-270
2015,11,10,21,521,513,238,-275
2015,11,10,22,533,520,230,-290
2015,11,10,23,577,554,234,-320
2015,11,11,0,611,593,260,-333
2015,11,11,1,608,587,260,-327
2015,11,11,2,592,575,261,-314
2015,11,11,3,562,545,259,-286
2015,11,11,4,517,517,262,-255
2015,11,11,5,479,478,258,-220
2015,11,11,6,471,456,254,-202
2015,11,11,7,463,452,253,-199
2015,11,11,8,463,454,241,-213
2015,11,11,9,476,463,225,-238
2015,11,11,10,487,486,228,-258
2015,11,11,11,526,522,245,-277
2015,11,11,12,577,585,317,-268
2015,11,11,13,610,625,314,-311
2015,11,11,14,616,619,240,-379
2015,11,11,15,605,594,189,-405
2015,11,11,16,588,570,175,-395
2015,11,11,17,566,547,175,-372
2015,11,11,18,542,523,175,-348
2015,11,11,19,535,521,176,-345
2015,11,11,20,526,505,172,-333
2015,11,11,21,511,505,174,-331
2015,11,11,22,524,522,226,-296
2015,11,11,23,556,556,362,-194
2015,11,12,0,581,583,366,-217
2015,11,12,1,581,579,295,-284
2015,11,12,2,558,567,200,-367
2015,11,12,3,529,545,140,-405
2015,11,12,4,481,506,123,-383
2015,11,12,5,449,467,123,-344
2015,11,12,6,419,449,124,-325
2015,11,12,7,407,442,101,-341
2015,11,12,8,403,436,101,-335
2015,11,12,9,405,440,103,-337
2015,11,12,10,418,450,99,-351
2015,11,12,11,458,498,142,-356
2015,11,12,12,537,564,266,-298
2015,11,12,13,563,579,252,-327
2015,11,12,14,562,564,235,-329
2015,11,12,15,554,556,235,-321
2015,11,12,16,541,545,223,-322
2015,11,12,17,529,528,137,-391
2015,11,12,18,517,516,122,-394
2015,11,12,19,514,513,121,-392
2015,11,12,20,504,504,118,-386
2015,11,12,21,505,507,122,-385
2015,11,12,22,519,515,119,-396
2015,11,12,23,557,552,149,-403
2015,11,13,0,589,582,225,-357
2015,11,13,1,587,577,224,-353
2015,11,13,2,573,560,225,-335
2015,11,13,3,543,531,226,-305
2015,11,13,4,503,487,204,-283
2015,11,13,5,467,452,101,-351
2015,11,13,6,451,430,99,-331
2015,11,13,7,442,424,98,-326
2015,11,13,8,441,426,98,-328
2015,11,13,9,448,430,99,-331
2015,11,13,10,468,449,98,-351
2015,11,13,11,514,498,108,-390
2015,11,13,12,601,585,181,-404
2015,11,13,13,632,607,241,-366
2015,11,13,14,627,604,249,-355
2015,11,13,15,619,602,249,-353
2015,11,13,16,601,584,250,-334
2015,11,13,17,584,563,249,-314
2015,11,13,18,562,553,250,-303
2015,11,13,19,548,537,250,-287
2015,11,13,20,537,526,251,-275
2015,11,13,21,531,527,250,-277
2015,11,13,22,542,545,250,-295
2015,11,13,23,592,599,250,-349
2015,11,14,0,625,634,250,-384
2015,11,14,1,628,629,232,-397
2015,11,14,2,621,625,218,-407
2015,11,14,3,602,607,200,-407
2015,11,14,4,577,573,175,-398
2015,11,14,5,550,543,175,-368
2015,11,14,6,523,518,176,-342
2015,11,14,7,514,509,174,-335
2015,11,14,8,512,506,177,-329
2015,11,14,9,524,513,175,-338
2015,11,14,10,542,519,171,-348
2015,11,14,11,569,552,175,-377
2015,11,14,12,607,597,198,-399
2015,11,14,13,647,630,242,-388
2015,11,14,14,674,636,245,-391
2015,11,14,15,661,628,250,-378
2015,11,14,16,628,596,251,-345
2015,11,14,17,602,564,249,-315
2015,11,14,18,565,542,251,-291
2015,11,14,19,540,516,250,-266
2015,11,14,20,527,504,251,-253
2015,11,14,21,526,500,249,-251
2015,11,14,22,543,530,268,-262
2015,11,14,23,592,576,320,-256
2015,11,15,0,628,612,350,-262
2015,11,15,1,615,618,349,-269
2015,11,15,2,614,611,347,-264
2015,11,15,3,597,603,338,-265
2015,11,15,4,573,577,251,-326
2015,11,15,5,549,554,163,-391
2015,11,15,6,526,530,125,-405
2015,11,15,7,522,538,133,-405
2015,11,15,8,530,542,134,-408
2015,11,15,9,534,550,135,-415
2015,11,15,10,557,573,194,-379
2015,11,15,11,579,591,252,-339
2015,11,15,12,618,629,266,-363
2015,11,15,13,657,670,293,-377
2015,11,15,14,683,683,338,-345
2015,11,15,15,657,626,346,-280
2015,11,15,16,600,599,333,-266
2015,11,15,17,556,557,286,-271
2015,11,15,18,524,536,219,-317
2015,11,15,19,503,530,186,-344
2015,11,15,20,491,511,191,-320
2015,11,15,21,491,526,227,-299
2015,11,15,22,503,524,244,-280
2015,11,15,23,552,640,403,-237
2015,11,16,0,583,630,360,-270
2015,11,16,1,584,612,287,-325
2015,11,16,2,581,606,242,-364
2015,11,16,3,554,587,232,-355
2015,11,16,4,528,557,230,-327
2015,11,16,5,502,531,158,-373
2015,11,16,6,479,520,134,-386
2015,11,16,7,478,521,134,-387
2015,11,16,8,482,525,129,-396
2015,11,16,9,495,542,143,-399
2015,11,16,10,522,573,231,-342
2015,11,16,11,572,632,268,-364
2015,11,16,12,664,715,272,-443
2015,11,16,13,697,745,275,-470
2015,11,16,14,688,724,267,-457
2015,11,16,15,658,690,205,-485
2015,11,16,16,626,646,222,-424
2015,11,16,17,594,604,264,-340
2015,11,16,18,570,567,266,-301
2015,11,16,19,556,548,267,-281
2015,11,16,20,543,537,268,-269
2015,11,16,21,541,531,267,-264
2015,11,16,22,550,545,268,-277
2015,11,16,23,591,598,298,-300
2015,11,17,0,621,629,403,-226
2015,11,17,1,621,624,415,-209
2015,11,17,2,604,601,414,-187
2015,11,17,3,569,565,380,-185
2015,11,17,4,528,526,294,-232
2015,11,17,5,485,482,222,-260
2015,11,17,6,472,459,157,-302
2015,11,17,7,464,448,143,-305
2015,11,17,8,460,440,142,-298
2015,11,17,9,469,447,142,-305
2015,11,17,10,484,457,137,-320
2015,11,17,11,532,503,179,-324
2015,11,17,12,614,581,320,-261
2015,11,17,13,638,600,337,-263
2015,11,17,14,631,589,259,-330
2015,11,17,15,616,584,187,-397
2015,11,17,16,601,575,175,-400
2015,11,17,17,584,559,156,-403
2015,11,17,18,569,553,147,-406
2015,11,17,19,560,548,144,-404
2015,11,17,20,544,544,146,-398
2015,11,17,21,543,547,167,-380
2015,11,17,22,555,568,257,-311
2015,11,17,23,600,604,334,-270
2015,11,18,0,627,624,345,-279
2015,11,18,1,622,613,314,-299
2015,11,18,2,604,595,314,-281
2015,11,18,3,568,557,276,-281
2015,11,18,4,524,515,222,-293
2015,11,18,5,481,471,188,-283
2015,11,18,6,450,441,150,-291
2015,11,18,7,438,433,146,-287
2015,11,18,8,428,429,145,-284
2015,11,18,9,430,433,146,-287
2015,11,18,10,441,448,144,-304
2015,11,18,11,479,488,158,-330
2015,11,18,12,555,562,243,-319
2015,11,18,13,580,588,284,-304
2015,11,18,14,571,583,314,-269
2015,11,18,15,568,591,343,-248
2015,11,18,16,563,585,397,-188
2015,11,18,17,553,580,415,-165
2015,11,18,18,545,574,416,-158
2015,11,18,19,540,566,414,-152
2015,11,18,20,530,563,384,-179
2015,11,18,21,528,561,379,-182
2015,11,18,22,545,576,383,-193
2015,11,18,23,589,605,398,-207
2015,11,19,0,611,611,414,-197
2015,11,19,1,600,598,416,-182
2015,11,19,2,580,577,415,-162
2015,11,19,3,547,545,410,-135
2015,11,19,4,505,495,376,-119
2015,11,19,5,461,447,373,-74
2015,11,19,6,425,412,230,-182
2015,11,19,7,411,399,141,-258
2015,11,19,8,403,393,113,-280
2015,11,19,9,404,396,114,-282
2015,11,19,10,416,404,112,-292
2015,11,19,11,455,443,112,-331
2015,11,19,12,538,520,145,-375
2015,11,19,13,563,549,230,-319
2015,11,19,14,559,541,262,-279
2015,11,19,15,550,544,289,-255
2015,11,19,16,539,537,289,-248
2015,11,19,17,528,529,289,-240
2015,11,19,18,518,520,295,-225
2015,11,19,19,514,516,309,-207
2015,11,19,20,507,505,302,-203
2015,11,19,21,508,503,263,-240
2015,11,19,22,527,518,225,-293
2015,11,19,23,570,545,196,-349
2015,11,20,0,599,575,208,-367
2015,11,20,1,595,579,188,-391
2015,11,20,2,584,576,185,-391
2015,11,20,3,554,551,187,-364
2015,11,20,4,516,513,186,-327
2015,11,20,5,477,473,165,-308
2015,11,20,6,448,448,116,-332
2015,11,20,7,437,441,99,-342
2015,11,20,8,435,440,101,-339
2015,11,20,9,444,443,94,-349
2015,11,20,10,465,463,92,-371
2015,11,20,11,514,512,100,-412
2015,11,20,12,601,594,192,-402
2015,11,20,13,628,628,234,-394
2015,11,20,14,622,625,269,-356
2015,11,20,15,618,607,394,-213
2015,11,20,16,604,588,419,-169
2015,11,20,17,587,564,330,-234
2015,11,20,18,564,547,240,-307
2015,11,20,19,552,534,220,-314
2015,11,20,20,543,523,224,-299
2015,11,20,21,539,521,256,-265
2015,11,20,22,553,537,257,-280
2015,11,20,23,603,573,267,-306
2015,11,21,0,634,618,261,-357
2015,11,21,1,625,619,307,-312
2015,11,21,2,619,618,269,-349
2015,11,21,3,600,609,263,-346
2015,11,21,4,576,585,194,-391
2015,11,21,5,548,553,179,-374
2015,11,21,6,522,533,180,-353
2015,11,21,7,514,524,162,-362
2015,11,21,8,512,528,156,-372
2015,11,21,9,518,529,153,-376
2015,11,21,10,536,544,154,-390
2015,11,21,11,564,572,188,-384
2015,11,21,12,603,640,321,-319
2015,11,21,13,643,651,343,-308
2015,11,21,14,668,671,344,-327
2015,11,21,15,658,637,324,-313
2015,11,21,16,631,599,285,-314
2015,11,21,17,605,567,262,-305
2015,11,21,18,572,540,260,-280
2015,11,21,19,546,518,255,-263
2015,11,21,20,533,502,202,-300
2015,11,21,21,529,507,84,-423
2015,11,21,22,547,528,83,-445
2015,11,21,23,599,573,129,-444
2015,11,22,0,624,592,150,-442
2015,11,22,1,610,579,137,-442
2015,11,22,2,612,566,111,-455
2015,11,22,3,594,541,109,-432
2015,11,22,4,570,514,111,-403
2015,11,22,5,543,476,109,-367
2015,11,22,6,503,457,96,-361
2015,11,22,7,498,445,88,-357
2015,11,22,8,500,447,85,-362
2015,11,22,9,508,447,83,-364
2015,11,22,10,523,467,84,-383
2015,11,22,11,553,501,97,-404
2015,11,22,12,593,547,172,-375
2015,11,22,13,643,606,316,-290
2015,11,22,14,689,650,314,-336
2015,11,22,15,692,665,317,-348
2015,11,22,16,667,648,321,-327
2015,11,22,17,634,624,319,-305
2015,11,22,18,625,607,328,-279
2015,11,22,19,612,585,352,-233
2015,11,22,20,603,547,366,-181
2015,11,22,21,609,601,280,-321
2015,11,22,22,636,623,250,-373
2015,11,22,23,703,693,316,-377
2015,11,23,0,724,734,392,-342
2015,11,23,1,723,734,368,-366
2015,11,23,2,730,731,333,-398
2015,11,23,3,701,702,336,-366
2015,11,23,4,689,664,325,-339
2015,11,23,5,651,630,320,-310
2015,11,23,6,622,614,320,-294
2015,11,23,7,621,615,322,-293
2015,11,23,8,625,619,320,-299
2015,11,23,9,637,634,321,-313
2015,11,23,10,660,661,321,-340
2015,11,23,11,706,720,333,-387
2015,11,23,12,792,812,540,-272
2015,11,23,13,821,839,565,-274
2015,11,23,14,807,808,569,-239
2015,11,23,15,774,766,568,-198
2015,11,23,16,733,727,558,-169
2015,11,23,17,693,680,508,-172
2015,11,23,18,662,648,488,-160
2015,11,23,19,639,596,460,-136
2015,11,23,20,622,565,310,-255
2015,11,23,21,617,594,309,-285
2015,11,23,22,632,619,328,-291
2015,11,23,23,688,688,333,-355
2015,11,24,0,735,739,371,-368
2015,11,24,1,742,746,403,-343
2015,11,24,2,736,748,410,-338
2015,11,24,3,706,716,406,-310
2015,11,24,4,671,675,337,-338
2015,11,24,5,632,639,185,-454
2015,11,24,6,596,627,166,-461
2015,11,24,7,593,621,176,-445
2015,11,24,8,593,631,165,-466
2015,11,24,9,607,645,171,-474
2015,11,24,10,628,672,270,-402
2015,11,24,11,678,728,300,-428
2015,11,24,12,759,812,498,-314
2015,11,24,13,787,841,584,-257
2015,11,24,14,777,809,559,-250
2015,11,24,15,744,751,474,-277
2015,11,24,16,699,688,409,-279
2015,11,24,17,660,643,329,-314
2015,11,24,18,625,608,321,-287
2015,11,24,19,602,583,321,-262
2015,11,24,20,584,548,188,-360
2015,11,24,21,584,562,147,-415
2015,11,24,22,600,579,147,-432
2015,11,24,23,644,643,194,-449
2015,11,25,0,682,675,279,-396
2015,11,25,1,685,684,257,-427
2015,11,25,2,686,676,211,-465
2015,11,25,3,654,656,210,-446
2015,11,25,4,615,622,210,-412
2015,11,25,5,582,591,210,-381
2015,11,25,6,566,558,162,-396
2015,11,25,7,564,569,146,-423
2015,11,25,8,565,565,138,-427
2015,11,25,9,580,582,144,-438
2015,11,25,10,601,605,146,-459
2015,11,25,11,650,649,255,-394
2015,11,25,12,714,706,278,-428
2015,11,25,13,753,752,326,-426
2015,11,25,14,744,748,367,-381
2015,11,25,15,720,710,354,-356
2015,11,25,16,686,664,280,-384
2015,11,25,17,655,638,247,-391
2015,11,25,18,625,601,218,-383
2015,11,25,19,604,584,218,-366
2015,11,25,20,592,575,218,-357
2015,11,25,21,590,573,218,-355
2015,11,25,22,605,583,218,-365
2015,11,25,23,647,632,323,-309
2015,11,26,0,682,652,309,-343
2015,11,26,1,685,657,279,-378
2015,11,26,2,680,645,280,-365
2015,11,26,3,649,618,258,-360
2015,11,26,4,612,585,248,-337
2015,11,26,5,570,532,166,-366
2015,11,26,6,521,504,135,-369
2015,11,26,7,500,497,135,-362
2015,11,26,8,497,495,134,-361
2015,11,26,9,502,504,135,-369
2015,11,26,10,507,519,134,-385
2015,11,26,11,541,552,194,-358
2015,11,26,12,575,577,273,-304
2015,11,26,13,615,620,280,-340
2015,11,26,14,643,643,278,-365
2015,11,26,15,656,651,279,-372
2015,11,26,16,664,622,276,-346
2015,11,26,17,649,587,259,-328
2015,11,26,18,606,542,226,-316
2015,11,26,19,561,500,200,-300
2015,11,26,20,528,470,162,-308
2015,11,26,21,511,459,148,-311
2015,11,26,22,507,452,146,-306
2015,11,26,23,529,469,143,-326
2015,11,27,0,545,489,144,-345
2015,11,27,1,539,494,144,-350
2015,11,27,2,540,497,144,-353
2015,11,27,3,529,492,143,-349
2015,11,27,4,505,470,143,-327
2015,11,27,5,482,446,143,-303
2015,11,27,6,459,426,145,-281
2015,11,27,7,450,415,142,-273
2015,11,27,8,441,411,144,-267
2015,11,27,9,446,407,142,-265
2015,11,27,10,458,418,145,-273
2015,11,27,11,485,441,143,-298
2015,11,27,12,510,478,150,-328
2015,11,27,13,540,509,209,-300
2015,11,27,14,541,530,216,-314
2015,11,27,15,542,524,214,-310
2015,11,27,16,533,504,172,-332
2015,11,27,17,522,486,142,-344
2015,11,27,18,504,470,141,-329
2015,11,27,19,483,453,141,-312
2015,11,27,20,471,446,140,-306
2015,11,27,21,469,441,138,-303
2015,11,27,22,486,459,142,-317
2015,11,27,23,527,505,193,-312
2015,11,28,0,547,518,287,-231
2015,11,28,1,542,505,228,-277
2015,11,28,2,530,492,163,-329
2015,11,28,3,517,477,142,-335
2015,11,28,4,492,448,141,-307
2015,11,28,5,465,413,141,-272
2015,11,28,6,445,391,142,-249
2015,11,28,7,430,377,136,-241
2015,11,28,8,423,374,130,-244
2015,11,28,9,426,377,133,-244
2015,11,28,10,435,383,131,-252
2015,11,28,11,460,401,131,-270
2015,11,28,12,496,434,132,-302
2015,11,28,13,527,471,149,-322
2015,11,28,14,553,500,156,-344
2015,11,28,15,556,516,160,-356
2015,11,28,16,542,516,159,-357
2015,11,28,17,517,508,158,-350
2015,11,28,18,495,488,153,-335
2015,11,28,19,477,467,153,-314
2015,11,28,20,467,452,154,-298
2015,11,28,21,468,451,152,-299
2015,11,28,22,484,472,189,-283
2015,11,28,23,528,505,278,-227
2015,11,29,0,550,507,223,-284
2015,11,29,1,536,512,154,-358
2015,11,29,2,522,500,137,-363
2015,11,29,3,501,474,137,-337
2015,11,29,4,474,447,140,-307
2015,11,29,5,446,408,136,-272
2015,11,29,6,408,382,137,-245
2015,11,29,7,392,370,130,-240
2015,11,29,8,386,359,129,-230
2015,11,29,9,383,359,131,-228
2015,11,29,10,390,365,129,-236
2015,11,29,11,405,382,131,-251
2015,11,29,12,437,404,129,-275
2015,11,29,13,475,438,129,-309
2015,11,29,14,513,471,136,-335
2015,11,29,15,525,489,145,-344
2015,11,29,16,510,481,142,-339
2015,11,29,17,491,478,136,-342
2015,11,29,18,485,475,131,-344
2015,11,29,19,481,478,131,-347
2015,11,29,20,471,477,139,-338
2015,11,29,21,472,480,136,-344
2015,11,29,22,488,503,185,-318
2015,11,29,23,541,543,232,-311
2015,11,30,0,558,557,234,-323
2015,11,30,1,552,550,150,-400
2015,11,30,2,541,535,138,-397
2015,11,30,3,509,504,139,-365
2015,11,30,4,477,464,136,-328
2015,11,30,5,437,428,138,-290
2015,11,30,6,409,402,136,-266
2015,11,30,7,397,385,139,-246
2015,11,30,8,388,380,138,-242
2015,11,30,9,393,383,141,-242
2015,11,30,10,408,393,138,-255
2015,11,30,11,451,384,97,-287
2015,11,30,12,530,498,141,-357
2015,11,30,13,569,539,152,-387
2015,11,30,14,570,549,213,-336
2015,11,30,15,576,554,260,-294
2015,11,30,16,577,567,276,-291
2015,11,30,17,569,565,274,-291
2015,11,30,18,563,550,276,-274
2015,11,30,19,560,580,274,-306
2015,11,30,20,555,560,275,-285
2015,11,30,21,562,562,223,-339
2015,11,30,22,581,579,180,-399
2015,11,30,23,626,620,253,-367
2015,12,1,0,651,625,254,-371
2015,12,1,1,643,617,238,-379
2015,12,1,2,627,597,217,-380
2015,12,1,3,590,559,163,-396
2015,12,1,4,550,512,138,-374
2015,12,1,5,503,465,137,-328
2015,12,1,6,449,434,138,-296
2015,12,1,7,434,415,136,-279
2015,12,1,8,424,405,130,-275
2015,12,1,9,426,408,137,-271
2015,12,1,10,439,411,131,-280
2015,12,1,11,479,455,143,-312
2015,12,1,12,552,526,176,-350
2015,12,1,13,582,566,283,-283
2015,12,1,14,575,560,340,-220
2015,12,1,15,574,565,335,-230
2015,12,1,16,567,567,278,-289
2015,12,1,17,556,565,272,-293
2015,12,1,18,548,565,274,-291
2015,12,1,19,535,562,274,-288
2015,12,1,20,526,558,272,-286
2015,12,1,21,530,555,230,-325
2015,12,1,22,548,579,158,-421
2015,12,1,23,595,611,291,-320
2015,12,2,0,612,619,337,-282
2015,12,2,1,601,609,335,-274
2015,12,2,2,590,591,318,-273
2015,12,2,3,560,559,289,-270
2015,12,2,4,512,506,241,-265
2015,12,2,5,465,467,181,-286
2015,12,2,6,443,432,141,-291
2015,12,2,7,426,417,140,-277
2015,12,2,8,417,412,143,-269
2015,12,2,9,419,410,141,-269
2015,12,2,10,432,418,141,-277
2015,12,2,11,468,456,148,-308
2015,12,2,12,546,526,208,-318
2015,12,2,13,577,564,282,-282
2015,12,2,14,572,563,283,-280
2015,12,2,15,571,566,287,-279
2015,12,2,16,566,572,334,-238
2015,12,2,17,557,574,342,-232
2015,12,2,18,552,564,343,-221
2015,12,2,19,544,562,343,-219
2015,12,2,20,533,555,343,-212
2015,12,2,21,535,560,342,-218
2015,12,2,22,561,574,329,-245
2015,12,2,23,618,629,283,-346
2015,12,3,0,651,651,277,-374
2015,12,3,1,652,646,275,-371
2015,12,3,2,653,640,266,-374
2015,12,3,3,631,619,265,-354
2015,12,3,4,585,579,233,-346
2015,12,3,5,548,536,159,-377
2015,12,3,6,516,514,146,-368
2015,12,3,7,508,505,147,-358
2015,12,3,8,511,506,146,-360
2015,12,3,9,524,517,146,-371
2015,12,3,10,548,545,153,-392
2015,12,3,11,598,600,168,-432
2015,12,3,12,689,694,269,-425
2015,12,3,13,720,736,341,-395
2015,12,3,14,715,720,301,-419
2015,12,3,15,713,701,326,-375
2015,12,3,16,689,690,341,-349
2015,12,3,17,662,668,339,-329
2015,12,3,18,644,644,341,-303
2015,12,3,19,626,625,342,-283
2015,12,3,20,613,600,340,-260
2015,12,3,21,609,598,340,-258
2015,12,3,22,635,625,366,-259
2015,12,3,23,696,692,381,-311
2015,12,4,0,731,736,387,-349
2015,12,4,1,736,747,386,-361
2015,12,4,2,740,744,375,-369
2015,12,4,3,716,722,316,-406
2015,12,4,4,673,684,277,-407
2015,12,4,5,641,652,206,-446
2015,12,4,6,609,627,141,-486
2015,12,4,7,603,629,135,-494
2015,12,4,8,605,637,136,-501
2015,12,4,9,616,650,156,-494
2015,12,4,10,635,678,204,-474
2015,12,4,11,670,729,314,-415
2015,12,4,12,754,809,390,-419
2015,12,4,13,782,839,393,-446
2015,12,4,14,769,816,392,-424
2015,12,4,15,739,769,356,-413
2015,12,4,16,698,706,284,-422
2015,12,4,17,664,655,243,-412
2015,12,4,18,627,611,236,-375
2015,12,4,19,611,585,235,-350
2015,12,4,20,594,565,235,-330
2015,12,4,21,592,556,256,-300
2015,12,4,22,601,577,290,-287
2015,12,4,23,650,635,350,-285
2015,12,5,0,670,670,388,-282
2015,12,5,1,676,677,386,-291
2015,12,5,2,687,685,388,-297
2015,12,5,3,669,676,385,-291
2015,12,5,4,642,659,387,-272
2015,12,5,5,611,627,334,-293
2015,12,5,6,578,610,249,-361
2015,12,5,7,570,604,180,-424
2015,12,5,8,571,610,137,-473
2015,12,5,9,580,624,139,-485
2015,12,5,10,601,645,193,-452
2015,12,5,11,628,672,276,-396
2015,12,5,12,667,711,277,-434
2015,12,5,13,708,754,298,-456
2015,12,5,14,723,773,398,-375
2015,12,5,15,699,736,389,-347
2015,12,5,16,658,677,325,-352
2015,12,5,17,620,621,246,-375
2015,12,5,18,584,572,138,-434
2015,12,5,19,554,545,101,-444
2015,12,5,20,544,527,108,-419
2015,12,5,21,546,517,113,-404
2015,12,5,22,563,539,134,-405
2015,12,5,23,618,605,173,-432
2015,12,6,0,644,639,274,-365
2015,12,6,1,639,649,275,-374
2015,12,6,2,640,653,234,-419
2015,12,6,3,631,649,161,-488
2015,12,6,4,604,636,148,-488
2015,12,6,5,579,615,149,-466
2015,12,6,6,541,598,151,-447
2015,12,6,7,533,591,148,-443
2015,12,6,8,535,595,149,-446
2015,12,6,9,544,607,151,-456
2015,12,6,10,563,616,147,-469
2015,12,6,11,588,646,150,-496
2015,12,6,12,626,685,182,-503
2015,12,6,13,668,724,314,-410
2015,12,6,14,701,750,346,-404
2015,12,6,15,674,712,314,-398
2015,12,6,16,621,636,199,-437
2015,12,6,17,579,591,138,-453
2015,12,6,18,553,562,139,-423
2015,12,6,19,531,534,137,-397
2015,12,6,20,515,517,138,-379
2015,12,6,21,522,511,138,-373
2015,12,6,22,536,532,136,-396
2015,12,6,23,597,590,165,-425
2015,12,7,0,620,626,184,-442
2015,12,7,1,614,630,186,-444
2015,12,7,2,614,636,187,-449
2015,12,7,3,590,612,184,-428
2015,12,7,4,557,580,181,-399
2015,12,7,5,524,553,140,-413
2015,12,7,6,498,540,143,-397
2015,12,7,7,492,537,137,-400
2015,12,7,8,494,542,141,-401
2015,12,7,9,508,557,140,-417
2015,12,7,10,528,580,138,-442
2015,12,7,11,587,641,211,-430
2015,12,7,12,672,718,307,-411
2015,12,7,13,715,746,380,-366
2015,12,7,14,708,733,341,-392
2015,12,7,15,690,701,314,-387
2015,12,7,16,665,648,298,-350
2015,12,7,17,632,612,267,-345
2015,12,7,18,609,582,262,-320
2015,12,7,19,592,574,275,-299
2015,12,7,20,575,552,273,-279
2015,12,7,21,575,521,262,-259
2015,12,7,22,592,576,231,-345
2015,12,7,23,644,631,288,-343
2015,12,8,0,680,669,316,-353
2015,12,8,1,682,670,317,-353
2015,12,8,2,677,663,316,-347
2015,12,8,3,646,638,316,-322
2015,12,8,4,607,596,282,-314
2015,12,8,5,561,556,182,-374
2015,12,8,6,518,543,136,-407
2015,12,8,7,509,544,135,-409
2015,12,8,8,508,552,137,-415
2015,12,8,9,518,569,136,-433
2015,12,8,10,536,598,137,-461
2015,12,8,11,587,653,163,-490
2015,12,8,12,671,737,272,-465
2015,12,8,13,705,767,393,-374
2015,12,8,14,691,742,421,-321
2015,12,8,15,673,721,411,-310
2015,12,8,16,647,668,339,-329
2015,12,8,17,618,625,245,-380
2015,12,8,18,593,588,290,-298
2015,12,8,19,575,569,310,-259
2015,12,8,20,556,552,309,-243
2015,12,8,21,558,539,205,-334
2015,12,8,22,573,563,139,-424
2015,12,8,23,626,617,173,-444
2015,12,9,0,654,657,292,-365
2015,12,9,1,660,661,323,-338
2015,12,9,2,655,654,360,-294
2015,12,9,3,631,635,362,-273
2015,12,9,4,588,592,289,-303
2015,12,9,5,546,559,173,-386
2015,12,9,6,518,539,146,-393
2015,12,9,7,511,532,141,-391
2015,12,9,8,509,544,144,-400
2015,12,9,9,516,557,143,-414
2015,12,9,10,538,585,181,-404
2015,12,9,11,586,640,349,-291
2015,12,9,12,669,725,411,-314
2015,12,9,13,705,761,412,-349
2015,12,9,14,691,740,383,-357
2015,12,9,15,669,700,306,-394
2015,12,9,16,641,650,278,-372
2015,12,9,17,613,600,265,-335
2015,12,9,18,588,582,275,-307
2015,12,9,19,573,565,277,-288
2015,12,9,20,560,548,276,-272
2015,12,9,21,553,554,265,-289
2015,12,9,22,574,581,275,-306
2015,12,9,23,624,630,295,-335
2015,12,10,0,656,648,317,-331
2015,12,10,1,653,642,318,-324
2015,12,10,2,650,623,315,-308
2015,12,10,3,626,595,317,-278
2015,12,10,4,585,538,255,-283
2015,12,10,5,537,497,205,-292
2015,12,10,6,497,467,172,-295
2015,12,10,7,486,461,135,-326
2015,12,10,8,485,464,135,-329
2015,12,10,9,490,476,137,-339
2015,12,10,10,510,499,136,-363
2015,12,10,11,559,549,136,-413
2015,12,10,12,639,638,143,-495
2015,12,10,13,673,679,226,-453
2015,12,10,14,657,665,272,-393
2015,12,10,15,640,639,275,-364
2015,12,10,16,616,600,273,-327
2015,12,10,17,592,569,276,-293
2015,12,10,18,571,539,274,-265
2015,12,10,19,558,528,267,-261
2015,12,10,20,546,515,193,-322
2015,12,10,21,542,523,128,-395
2015,12,10,22,556,539,137,-402
2015,12,10,23,603,590,188,-402
2015,12,11,0,627,614,235,-379
2015,12,11,1,631,617,236,-381
2015,12,11,2,627,604,196,-408
2015,12,11,3,600,579,162,-417
2015,12,11,4,558,530,128,-402
2015,12,11,5,513,484,79,-405
2015,12,11,6,468,459,78,-381
2015,12,11,7,454,451,80,-371
2015,12,11,8,446,452,79,-373
2015,12,11,9,448,460,79,-381
2015,12,11,10,462,479,77,-402
2015,12,11,11,505,527,81,-446
2015,12,11,12,580,604,145,-459
2015,12,11,13,611,638,212,-426
2015,12,11,14,601,622,212,-410
2015,12,11,15,592,598,193,-405
2015,12,11,16,570,568,118,-450
2015,12,11,17,550,546,85,-461
2015,12,11,18,535,527,88,-439
2015,12,11,19,531,514,89,-425
2015,12,11,20,516,510,92,-418
2015,12,11,21,512,504,91,-413
2015,12,11,22,532,516,91,-425
2015,12,11,23,571,555,91,-464
2015,12,12,0,593,574,88,-486
2015,12,12,1,582,561,86,-475
2015,12,12,2,569,550,86,-464
2015,12,12,3,547,535,88,-447
2015,12,12,4,513,496,86,-410
2015,12,12,5,473,458,87,-371
2015,12,12,6,428,426,87,-339
2015,12,12,7,409,410,87,-323
2015,12,12,8,398,404,87,-317
2015,12,12,9,395,399,87,-312
2015,12,12,10,402,410,87,-323
2015,12,12,11,421,430,86,-344
2015,12,12,12,455,465,89,-376
2015,12,12,13,490,499,86,-413
2015,12,12,14,517,530,87,-443
2015,12,12,15,532,542,87,-455
2015,12,12,16,529,529,85,-444
2015,12,12,17,516,514,87,-427
2015,12,12,18,504,497,84,-413
2015,12,12,19,488,487,88,-399
2015,12,12,20,481,481,87,-394
2015,12,12,21,489,480,87,-393
2015,12,12,22,507,494,87,-407
2015,12,12,23,546,533,87,-446
2015,12,13,0,562,546,87,-459
2015,12,13,1,545,537,87,-450
2015,12,13,2,530,522,87,-435
2015,12,13,3,508,503,87,-416
2015,12,13,4,480,476,88,-388
2015,12,13,5,443,440,87,-353
2015,12,13,6,420,409,87,-322
2015,12,13,7,402,397,87,-310
2015,12,13,8,394,391,87,-304
2015,12,13,9,391,394,87,-307
2015,12,13,10,397,400,86,-314
2015,12,13,11,414,421,88,-333
2015,12,13,12,441,443,85,-358
2015,12,13,13,481,484,88,-396
2015,12,13,14,515,521,86,-435
2015,12,13,15,530,523,87,-436
2015,12,13,16,514,510,88,-422
2015,12,13,17,495,487,86,-401
2015,12,13,18,492,483,87,-396
2015,12,13,19,485,478,88,-390
2015,12,13,20,475,471,87,-384
2015,12,13,21,480,469,86,-383
2015,12,13,22,499,492,87,-405
2015,12,13,23,546,536,87,-449
2015,12,14,0,566,556,86,-470
2015,12,14,1,557,554,87,-467
2015,12,14,2,548,543,87,-456
2015,12,14,3,519,509,86,-423
2015,12,14,4,479,470,88,-382
2015,12,14,5,440,425,86,-339
2015,12,14,6,403,394,86,-308
2015,12,14,7,387,379,87,-292
2015,12,14,8,380,374,86,-288
2015,12,14,9,381,372,88,-284
2015,12,14,10,394,381,87,-294
2015,12,14,11,439,421,87,-334
2015,12,14,12,520,489,92,-397
2015,12,14,13,563,523,86,-437
2015,12,14,14,559,525,88,-437
2015,12,14,15,560,529,86,-443
2015,12,14,16,555,535,82,-453
2015,12,14,17,547,541,81,-460
2015,12,14,18,541,539,81,-458
2015,12,14,19,538,534,80,-454
2015,12,14,20,528,524,81,-443
2015,12,14,21,531,513,79,-434
2015,12,14,22,553,522,94,-428
2015,12,14,23,603,565,110,-455
2015,12,15,0,632,599,108,-491
2015,12,15,1,629,600,111,-489
2015,12,15,2,614,586,93,-493
2015,12,15,3,581,558,90,-468
2015,12,15,4,537,516,89,-427
2015,12,15,5,491,465,88,-377
2015,12,15,6,455,440,88,-352
2015,12,15,7,441,426,91,-335
2015,12,15,8,434,423,88,-335
2015,12,15,9,438,424,86,-338
2015,12,15,10,453,441,88,-353
2015,12,15,11,503,488,92,-396
2015,12,15,12,588,570,120,-450
2015,12,15,13,628,566,112,-454
2015,12,15,14,614,590,233,-357
2015,12,15,15,598,579,86,-493
2015,12,15,16,573,554,86,-468
2015,12,15,17,553,535,85,-450
2015,12,15,18,534,520,86,-434
2015,12,15,19,533,511,86,-425
2015,12,15,20,521,511,116,-395
2015,12,15,21,514,500,91,-409
2015,12,15,22,535,533,146,-387
2015,12,15,23,582,560,127,-433
2015,12,16,0,614,597,128,-469
2015,12,16,1,616,595,128,-467
2015,12,16,2,607,587,127,-460
2015,12,16,3,579,565,109,-456
2015,12,16,4,532,526,99,-427
2015,12,16,5,491,488,97,-391
2015,12,16,6,439,462,94,-368
2015,12,16,7,428,457,95,-362
2015,12,16,8,427,463,96,-367
2015,12,16,9,433,471,96,-375
2015,12,16,10,452,493,94,-399
2015,12,16,11,504,550,94,-456
2015,12,16,12,592,630,194,-436
2015,12,16,13,635,677,274,-403
2015,12,16,14,627,668,272,-396
2015,12,16,15,616,634,174,-460
2015,12,16,16,594,590,121,-469
2015,12,16,17,573,553,89,-464
2015,12,16,18,550,532,81,-451
2015,12,16,19,541,520,79,-441
2015,12,16,20,536,507,80,-427
2015,12,16,21,529,507,67,-440
2015,12,16,22,543,520,70,-450
2015,12,16,23,584,572,88,-484
2015,12,17,0,606,599,100,-499
2015,12,17,1,598,605,159,-446
2015,12,17,2,586,586,177,-409
2015,12,17,3,559,562,179,-383
2015,12,17,4,512,509,177,-332
2015,12,17,5,465,461,178,-283
2015,12,17,6,445,425,173,-252
2015,12,17,7,432,404,146,-258
2015,12,17,8,425,406,144,-262
2015,12,17,9,427,404,144,-260
2015,12,17,10,439,417,143,-274
2015,12,17,11,481,457,154,-303
2015,12,17,12,560,523,175,-348
2015,12,17,13,597,564,177,-387
2015,12,17,14,594,566,176,-390
2015,12,17,15,590,572,201,-371
2015,12,17,16,585,571,195,-376
2015,12,17,17,574,569,174,-395
2015,12,17,18,564,552,173,-379
2015,12,17,19,557,553,159,-394
2015,12,17,20,545,539,158,-381
2015,12,17,21,544,536,160,-376
2015,12,17,22,569,555,167,-388
2015,12,17,23,618,591,206,-385
2015,12,18,0,654,614,229,-385
2015,12,18,1,654,607,202,-405
2015,12,18,2,647,597,138,-459
2015,12,18,3,626,573,108,-465
2015,12,18,4,584,532,106,-426
2015,12,18,5,542,483,105,-378
2015,12,18,6,501,442,95,-347
2015,12,18,7,490,442,105,-337
2015,12,18,8,491,445,108,-337
2015,12,18,9,501,449,114,-335
2015,12,18,10,521,475,131,-344
2015,12,18,11,570,526,136,-390
2015,12,18,12,650,612,137,-475
2015,12,18,13,694,661,150,-511
2015,12,18,14,693,661,149,-512
2015,12,18,15,687,660,159,-501
2015,12,18,16,667,644,148,-496
2015,12,18,17,649,622,152,-470
2015,12,18,18,629,610,138,-472
2015,12,18,19,616,611,138,-473
2015,12,18,20,605,614,133,-481
2015,12,18,21,608,628,135,-493
2015,12,18,22,623,677,187,-490
2015,12,18,23,691,743,273,-470
2015,12,19,0,719,783,286,-497
2015,12,19,1,732,780,285,-495
2015,12,19,2,719,773,279,-494
2015,12,19,3,707,757,267,-490
2015,12,19,4,677,726,238,-488
2015,12,19,5,639,696,205,-491
2015,12,19,6,646,672,197,-475
2015,12,19,7,641,658,135,-523
2015,12,19,8,640,657,103,-554
2015,12,19,9,652,655,102,-553
2015,12,19,10,663,667,121,-546
2015,12,19,11,698,685,138,-547
2015,12,19,12,743,718,190,-528
2015,12,19,13,789,761,210,-551
2015,12,19,14,804,780,229,-551
2015,12,19,15,787,758,211,-547
2015,12,19,16,746,719,203,-516
2015,12,19,17,701,685,159,-526
2015,12,19,18,664,646,132,-514
2015,12,19,19,627,612,135,-477
2015,12,19,20,603,593,114,-479
2015,12,19,21,599,590,116,-474
2015,12,19,22,624,620,119,-501
2015,12,19,23,683,687,139,-548
2015,12,20,0,705,723,174,-549
2015,12,20,1,706,725,173,-552
2015,12,20,2,709,723,172,-551
2015,12,20,3,699,711,167,-544
2015,12,20,4,670,687,157,-530
2015,12,20,5,630,643,154,-489
2015,12,20,6,617,624,119,-505
2015,12,20,7,614,612,117,-495
2015,12,20,8,613,611,115,-496
2015,12,20,9,622,619,115,-504
2015,12,20,10,640,634,116,-518
2015,12,20,11,661,664,140,-524
2015,12,20,12,701,699,182,-517
2015,12,20,13,754,747,196,-551
2015,12,20,14,784,776,222,-554
2015,12,20,15,761,742,193,-549
2015,12,20,16,712,672,185,-487
2015,12,20,17,659,614,117,-497
2015,12,20,18,631,583,106,-477
2015,12,20,19,598,572,108,-464
2015,12,20,20,578,557,106,-451
2015,12,20,21,575,557,108,-449
2015,12,20,22,597,585,105,-480
2015,12,20,23,658,643,113,-530
2015,12,21,0,677,673,175,-498
2015,12,21,1,678,672,172,-500
2015,12,21,2,673,674,176,-498
2015,12,21,3,653,647,174,-473
2015,12,21,4,618,611,174,-437
2015,12,21,5,581,569,171,-398
2015,12,21,6,550,537,113,-424
2015,12,21,7,544,523,105,-418
2015,12,21,8,543,518,105,-413
2015,12,21,9,559,520,105,-415
2015,12,21,10,581,534,104,-430
2015,12,21,11,628,563,163,-400
2015,12,21,12,698,611,174,-437
2015,12,21,13,746,648,174,-474
2015,12,21,14,755,653,174,-479
2015,12,21,15,747,653,175,-478
2015,12,21,16,714,655,175,-480
2015,12,21,17,678,641,173,-468
2015,12,21,18,649,634,176,-458
2015,12,21,19,630,624,156,-468
2015,12,21,20,614,610,107,-503
2015,12,21,21,609,606,104,-502
2015,12,21,22,627,611,108,-503
2015,12,21,23,670,641,164,-477
2015,12,22,0,696,653,179,-474
2015,12,22,1,687,635,177,-458
2015,12,22,2,672,614,173,-441
2015,12,22,3,637,584,176,-408
2015,12,22,4,596,539,176,-363
2015,12,22,5,547,490,175,-315
2015,12,22,6,490,457,176,-281
2015,12,22,7,473,437,122,-315
2015,12,22,8,465,423,102,-321
2015,12,22,9,459,421,104,-317
2015,12,22,10,469,433,104,-329
2015,12,22,11,503,458,104,-354
2015,12,22,12,559,498,119,-379
2015,12,22,13,593,549,198,-351
2015,12,22,14,600,562,199,-363
2015,12,22,15,602,572,179,-393
2015,12,22,16,591,576,178,-398
2015,12,22,17,574,560,173,-387
2015,12,22,18,555,548,176,-372
2015,12,22,19,548,527,174,-353
2015,12,22,20,540,518,174,-344
2015,12,22,21,532,514,176,-338
2015,12,22,22,541,526,174,-352
2015,12,22,23,577,567,175,-392
2015,12,23,0,594,588,175,-413
2015,12,23,1,588,578,177,-401
2015,12,23,2,572,565,172,-393
2015,12,23,3,551,541,130,-411
2015,12,23,4,506,508,121,-387
2015,12,23,5,463,458,88,-370
2015,12,23,6,432,419,46,-373
2015,12,23,7,413,395,46,-349
2015,12,23,8,400,391,50,-341
2015,12,23,9,396,384,50,-334
2015,12,23,10,408,396,51,-345
2015,12,23,11,440,422,52,-370
2015,12,23,12,497,464,62,-402
2015,12,23,13,533,509,121,-388
2015,12,23,14,549,530,123,-407
2015,12,23,15,564,546,125,-421
2015,12,23,16,559,557,129,-428
2015,12,23,17,548,556,151,-405
2015,12,23,18,534,549,136,-413
2015,12,23,19,529,543,128,-415
2015,12,23,20,523,532,129,-403
2015,12,23,21,526,525,129,-396
2015,12,23,22,540,529,129,-400
2015,12,23,23,570,566,140,-426
2015,12,24,0,581,580,154,-426
2015,12,24,1,566,559,154,-405
2015,12,24,2,552,545,155,-390
2015,12,24,3,531,524,153,-371
2015,12,24,4,487,491,137,-354
2015,12,24,5,438,442,99,-343
2015,12,24,6,414,406,59,-347
2015,12,24,7,385,377,55,-322
2015,12,24,8,371,367,55,-312
2015,12,24,9,365,359,56,-303
2015,12,24,10,369,353,67,-286
2015,12,24,11,389,368,126,-242
2015,12,24,12,428,387,125,-262
2015,12,24,13,463,419,126,-293
2015,12,24,14,491,465,126,-339
2015,12,24,15,513,500,124,-376
2015,12,24,16,524,519,125,-394
2015,12,24,17,521,493,126,-367
2015,12,24,18,511,516,125,-391
2015,12,24,19,498,516,125,-391
2015,12,24,20,490,504,125,-379
2015,12,24,21,489,503,176,-327
2015,12,24,22,498,502,199,-303
2015,12,24,23,520,517,206,-311
2015,12,25,0,513,518,192,-326
2015,12,25,1,495,500,192,-308
2015,12,25,2,493,489,194,-295
2015,12,25,3,480,476,179,-297
2015,12,25,4,448,455,131,-324
2015,12,25,5,406,417,123,-294
2015,12,25,6,373,382,125,-257
2015,12,25,7,343,359,123,-236
2015,12,25,8,327,347,125,-222
2015,12,25,9,322,334,123,-211
2015,12,25,10,320,336,124,-212
2015,12,25,11,326,346,125,-221
2015,12,25,12,349,365,124,-241
2015,12,25,13,368,402,125,-277
2015,12,25,14,406,440,124,-316
2015,12,25,15,427,469,124,-345
2015,12,25,16,451,481,124,-357
2015,12,25,17,463,488,124,-364
2015,12,25,18,465,484,126,-358
2015,12,25,19,452,468,124,-344
2015,12,25,20,430,460,124,-336
2015,12,25,21,427,453,125,-328
2015,12,25,22,427,454,125,-329
2015,12,25,23,445,471,124,-347
2015,12,26,0,431,480,113,-367
2015,12,26,1,425,477,106,-371
2015,12,26,2,407,464,125,-339
2015,12,26,3,415,444,124,-320
2015,12,26,4,416,423,97,-326
2015,12,26,5,390,390,121,-269
2015,12,26,6,391,361,125,-236
2015,12,26,7,370,346,124,-222
2015,12,26,8,358,337,125,-212
2015,12,26,9,349,335,125,-210
2015,12,26,10,348,341,125,-216
2015,12,26,11,358,353,124,-229
2015,12,26,12,375,375,92,-283
2015,12,26,13,398,398,109,-289
2015,12,26,14,442,438,147,-291
2015,12,26,15,473,463,146,-317
2015,12,26,16,495,478,146,-332
2015,12,26,17,496,478,146,-332
2015,12,26,18,511,476,147,-329
2015,12,26,19,509,468,146,-322
2015,12,26,20,502,462,144,-318
2015,12,26,21,507,461,146,-315
2015,12,26,22,520,466,145,-321
2015,12,26,23,549,505,158,-347
2015,12,27,0,542,527,195,-332
2015,12,27,1,527,517,195,-322
2015,12,27,2,507,506,195,-311
2015,12,27,3,487,480,156,-324
2015,12,27,4,450,454,146,-308
2015,12,27,5,413,413,145,-268
2015,12,27,6,381,384,145,-239
2015,12,27,7,357,357,147,-210
2015,12,27,8,346,349,146,-203
2015,12,27,9,340,340,146,-194
2015,12,27,10,343,344,146,-198
2015,12,27,11,351,350,146,-204
2015,12,27,12,373,367,147,-220
2015,12,27,13,398,398,147,-251
2015,12,27,14,440,430,145,-285
2015,12,27,15,467,459,147,-312
2015,12,27,16,464,463,146,-317
2015,12,27,17,462,470,147,-323
2015,12,27,18,464,471,147,-324
2015,12,27,19,459,468,146,-322
2015,12,27,20,454,463,146,-317
2015,12,27,21,461,462,146,-316
2015,12,27,22,477,471,157,-314
2015,12,27,23,522,512,231,-281
2015,12,28,0,540,533,207,-326
2015,12,28,1,525,524,189,-335
2015,12,28,2,513,505,149,-356
2015,12,28,3,486,481,146,-335
2015,12,28,4,453,447,147,-300
2015,12,28,5,413,406,146,-260
2015,12,28,6,387,369,143,-226
2015,12,28,7,370,352,143,-209
2015,12,28,8,361,341,143,-198
2015,12,28,9,361,342,143,-199
2015,12,28,10,372,356,144,-212
2015,12,28,11,403,378,142,-236
2015,12,28,12,456,424,142,-282
2015,12,28,13,494,466,142,-324
2015,12,28,14,515,490,143,-347
2015,12,28,15,531,505,142,-363
2015,12,28,16,531,530,145,-385
2015,12,28,17,530,532,147,-385
2015,12,28,18,526,531,145,-386
2015,12,28,19,519,525,147,-378
2015,12,28,20,522,513,145,-368
2015,12,28,21,516,511,147,-364
2015,12,28,22,534,524,146,-378
2015,12,28,23,572,553,146,-407
2015,12,29,0,599,575,147,-428
2015,12,29,1,585,560,147,-413
2015,12,29,2,571,543,148,-395
2015,12,29,3,541,513,145,-368
2015,12,29,4,494,472,132,-340
2015,12,29,5,451,431,127,-304
2015,12,29,6,428,395,122,-273
2015,12,29,7,410,373,121,-252
2015,12,29,8,398,372,127,-245
2015,12,29,9,397,364,126,-238
2015,12,29,10,410,373,127,-246
2015,12,29,11,439,395,126,-269
2015,12,29,12,491,441,126,-315
2015,12,29,13,529,480,126,-354
2015,12,29,14,548,498,127,-371
2015,12,29,15,551,512,126,-386
2015,12,29,16,544,520,126,-394
2015,12,29,17,535,516,125,-391
2015,12,29,18,526,510,126,-384
2015,12,29,19,514,511,127,-384
2015,12,29,20,513,508,127,-381
2015,12,29,21,505,507,125,-382
2015,12,29,22,522,515,127,-388
2015,12,29,23,559,544,134,-410
2015,12,30,0,586,573,151,-422
2015,12,30,1,577,562,136,-426
2015,12,30,2,566,546,137,-409
2015,12,30,3,540,516,132,-384
2015,12,30,4,487,477,126,-351
2015,12,30,5,448,437,127,-310
2015,12,30,6,407,403,123,-280
2015,12,30,7,387,387,126,-261
2015,12,30,8,378,380,125,-255
2015,12,30,9,377,373,122,-251
2015,12,30,10,389,388,126,-262
2015,12,30,11,417,411,125,-286
2015,12,30,12,466,458,147,-311
2015,12,30,13,510,505,148,-357
2015,12,30,14,527,527,148,-379
2015,12,30,15,538,543,145,-398
2015,12,30,16,538,562,126,-436
2015,12,30,17,533,561,117,-444
2015,12,30,18,526,545,91,-454
2015,12,30,19,518,540,87,-453
2015,12,30,20,518,540,88,-452
2015,12,30,21,511,541,121,-420
2015,12,30,22,523,555,127,-428
2015,12,30,23,567,576,141,-435
2015,12,31,0,589,589,161,-428
2015,12,31,1,577,574,161,-413
2015,12,31,2,563,555,159,-396
2015,12,31,3,540,532,129,-403
2015,12,31,4,492,491,127,-364
2015,12,31,5,450,448,124,-324
2015,12,31,6,439,412,124,-396
2015,12,31,7,422,395,124,-376
2015,12,31,8,412,382,123,-364
2015,12,31,9,414,380,126,-351
2015,12,31,10,420,387,122,-328
2015,12,31,11,448,416,124,-289
2015,12,31,12,489,453,88,-271
2015,12,31,13,533,501,93,-259
2015,12,31,14,544,526,123,-254
2015,12,31,15,565,542,121,-265
2015,12,31,16,556,547,130,-292
2015,12,31,17,534,539,136,-365
2015,12,31,18,526,524,140,-408
2015,12,31,19,510,509,141,-403
2015,12,31,20,506,499,144,-421
2015,12,31,21,502,498,164,-417
2015,12,31,22,515,515,185,-403
2015,12,31,23,560,560,185,-384
2016,1,1,0,589,589,0,-368
2016,1,1,1,571,582,0,-355
2016,1,1,2,555,562,0,-334
2016,1,1,3,538,545,0,-330
2016,1,1,4,507,525,0,-375
2016,1,1,5,486,502,0,-404
2016,1,1,6,490,480,173,-307
2016,1,1,7,474,468,174,-294
2016,1,1,8,473,460,174,-286
2016,1,1,9,472,459,174,-285
2016,1,1,10,487,471,176,-295
2016,1,1,11,498,482,172,-310
2016,1,1,12,533,509,173,-336
2016,1,1,13,557,546,176,-370
2016,1,1,14,585,570,173,-397
2016,1,1,15,602,593,173,-420
2016,1,1,16,613,592,175,-417
2016,1,1,17,609,583,173,-410
2016,1,1,18,585,580,174,-406
2016,1,1,19,567,574,173,-401
2016,1,1,20,549,580,175,-405
2016,1,1,21,547,584,173,-411
2016,1,1,22,563,608,178,-430
2016,1,1,23,598,656,275,-381
2016,1,2,0,623,680,353,-327
2016,1,2,1,618,672,313,-359
2016,1,2,2,604,663,219,-444
2016,1,2,3,591,654,185,-469
2016,1,2,4,589,630,184,-446
2016,1,2,5,560,601,181,-420
2016,1,2,6,543,581,179,-402
2016,1,2,7,537,577,179,-398
2016,1,2,8,536,576,179,-397
2016,1,2,9,547,588,183,-405
2016,1,2,10,560,604,187,-417
2016,1,2,11,589,627,188,-439
2016,1,2,12,628,667,206,-461
2016,1,2,13,672,705,253,-452
2016,1,2,14,704,733,267,-466
2016,1,2,15,700,719,271,-448
2016,1,2,16,670,689,273,-416
2016,1,2,17,637,646,221,-425
2016,1,2,18,604,604,203,-401
2016,1,2,19,569,570,177,-393
2016,1,2,20,549,549,176,-373
2016,1,2,21,547,546,176,-370
2016,1,2,22,560,569,175,-394
2016,1,2,23,612,631,204,-427
2016,1,3,0,651,672,259,-413
2016,1,3,1,653,682,256,-426
2016,1,3,2,652,677,257,-420
2016,1,3,3,638,670,258,-412
2016,1,3,4,611,650,255,-395
2016,1,3,5,584,627,203,-424
2016,1,3,6,573,611,181,-430
2016,1,3,7,562,603,182,-421
2016,1,3,8,564,607,181,-426
2016,1,3,9,571,617,182,-435
2016,1,3,10,586,629,180,-449
2016,1,3,11,609,652,183,-469
2016,1,3,12,645,685,213,-472
2016,1,3,13,692,715,258,-457
2016,1,3,14,727,747,277,-470
2016,1,3,15,710,733,276,-457
2016,1,3,16,662,673,214,-459
2016,1,3,17,614,631,180,-451
2016,1,3,18,585,609,180,-429
2016,1,3,19,552,596,182,-414
2016,1,3,20,525,580,172,-408
2016,1,3,21,525,547,172,-375
2016,1,3,22,539,569,181,-388
2016,1,3,23,594,630,183,-447
2016,1,4,0,637,680,212,-468
2016,1,4,1,645,685,217,-468
2016,1,4,2,637,689,217,-472
2016,1,4,3,615,661,209,-452
2016,1,4,4,586,630,182,-448
2016,1,4,5,560,600,185,-415
2016,1,4,6,566,581,183,-398
2016,1,4,7,566,575,182,-393
2016,1,4,8,575,580,183,-397
2016,1,4,9,592,591,184,-407
2016,1,4,10,620,610,182,-428
2016,1,4,11,670,672,245,-427
2016,1,4,12,740,744,358,-386
2016,1,4,13,785,781,391,-390
2016,1,4,14,800,790,392,-398
2016,1,4,15,797,799,379,-420
2016,1,4,16,785,805,378,-427
2016,1,4,17,762,803,351,-452
2016,1,4,18,737,790,318,-472
2016,1,4,19,724,779,305,-474
2016,1,4,20,707,784,315,-469
2016,1,4,21,700,783,334,-449
2016,1,4,22,724,804,335,-469
2016,1,4,23,787,873,458,-415
2016,1,5,0,843,902,522,-380
2016,1,5,1,849,839,478,-361
2016,1,5,2,845,840,455,-385
2016,1,5,3,813,832,455,-377
2016,1,5,4,774,785,453,-332
2016,1,5,5,741,747,424,-323
2016,1,5,6,734,727,374,-353
2016,1,5,7,730,732,349,-383
2016,1,5,8,728,737,374,-363
2016,1,5,9,743,748,435,-313
2016,1,5,10,760,773,451,-322
2016,1,5,11,801,830,450,-380
2016,1,5,12,870,909,514,-395
2016,1,5,13,905,950,569,-381
2016,1,5,14,900,946,625,-321
2016,1,5,15,868,892,521,-371
2016,1,5,16,832,828,429,-399
2016,1,5,17,789,770,381,-389
2016,1,5,18,752,724,332,-392
2016,1,5,19,726,692,331,-361
2016,1,5,20,704,665,332,-333
2016,1,5,21,699,661,335,-326
2016,1,5,22,727,685,420,-265
2016,1,5,23,794,754,436,-318
2016,1,6,0,845,813,436,-377
2016,1,6,1,854,827,437,-390
2016,1,6,2,855,820,436,-384
2016,1,6,3,836,802,437,-365
2016,1,6,4,794,762,438,-324
2016,1,6,5,756,727,437,-290
2016,1,6,6,726,709,435,-274
2016,1,6,7,727,713,439,-274
2016,1,6,8,738,717,436,-281
2016,1,6,9,755,737,436,-301
2016,1,6,10,782,768,441,-327
2016,1,6,11,837,825,441,-384
2016,1,6,12,903,906,532,-374
2016,1,6,13,945,961,605,-356
2016,1,6,14,934,936,590,-346
2016,1,6,15,892,874,518,-356
2016,1,6,16,841,818,459,-359
2016,1,6,17,780,749,358,-391
2016,1,6,18,731,701,287,-414
2016,1,6,19,699,666,276,-390
2016,1,6,20,667,638,279,-359
2016,1,6,21,648,631,276,-355
2016,1,6,22,663,660,294,-366
2016,1,6,23,730,725,366,-359
2016,1,7,0,780,762,437,-325
2016,1,7,1,773,776,441,-335
2016,1,7,2,768,771,439,-332
2016,1,7,3,744,752,422,-330
2016,1,7,4,710,708,347,-361
2016,1,7,5,664,671,264,-407
2016,1,7,6,681,642,189,-453
2016,1,7,7,684,639,187,-452
2016,1,7,8,694,640,192,-448
2016,1,7,9,710,656,194,-462
2016,1,7,10,731,671,254,-417
2016,1,7,11,788,727,298,-429
2016,1,7,12,867,803,360,-443
2016,1,7,13,900,840,362,-478
2016,1,7,14,883,822,336,-486
2016,1,7,15,829,778,319,-459
2016,1,7,16,763,721,282,-439
2016,1,7,17,704,663,258,-405
2016,1,7,18,665,620,200,-420
2016,1,7,19,632,589,182,-407
2016,1,7,20,611,566,181,-385
2016,1,7,21,605,559,150,-409
2016,1,7,22,621,573,176,-397
2016,1,7,23,667,619,182,-437
2016,1,8,0,709,660,256,-404
2016,1,8,1,707,665,271,-394
2016,1,8,2,701,650,265,-385
2016,1,8,3,672,624,267,-357
2016,1,8,4,628,582,265,-317
2016,1,8,5,591,540,267,-273
2016,1,8,6,533,509,227,-282
2016,1,8,7,521,498,178,-320
2016,1,8,8,518,499,176,-323
2016,1,8,9,526,497,177,-320
2016,1,8,10,543,510,177,-333
2016,1,8,11,589,552,178,-374
2016,1,8,12,666,622,188,-434
2016,1,8,13,712,656,193,-463
2016,1,8,14,707,650,195,-455
2016,1,8,15,695,651,195,-456
2016,1,8,16,679,643,194,-449
2016,1,8,17,653,620,190,-430
2016,1,8,18,632,596,190,-406
2016,1,8,19,612,580,188,-392
2016,1,8,20,600,566,191,-375
2016,1,8,21,594,554,189,-365
2016,1,8,22,611,571,192,-379
2016,1,8,23,649,608,203,-405
2016,1,9,0,674,631,212,-419
2016,1,9,1,664,623,175,-448
2016,1,9,2,656,603,178,-425
2016,1,9,3,636,587,176,-411
2016,1,9,4,601,551,175,-376
2016,1,9,5,567,514,177,-337
2016,1,9,6,555,485,175,-310
2016,1,9,7,537,476,177,-299
2016,1,9,8,530,463,174,-289
2016,1,9,9,532,462,178,-284
2016,1,9,10,537,467,177,-290
2016,1,9,11,562,491,180,-311
2016,1,9,12,601,518,177,-341
2016,1,9,13,638,553,177,-376
2016,1,9,14,661,590,180,-410
2016,1,9,15,666,612,178,-434
2016,1,9,16,645,613,178,-435
2016,1,9,17,625,605,177,-428
2016,1,9,18,599,584,160,-424
2016,1,9,19,576,569,177,-392
2016,1,9,20,561,560,178,-382
2016,1,9,21,553,566,179,-387
2016,1,9,22,568,583,178,-405
2016,1,9,23,610,612,179,-433
2016,1,10,0,654,630,179,-451
2016,1,10,1,655,613,179,-434
2016,1,10,2,642,598,178,-420
2016,1,10,3,618,572,178,-394
2016,1,10,4,590,542,180,-362
2016,1,10,5,557,504,177,-327
2016,1,10,6,519,484,179,-305
2016,1,10,7,503,461,178,-283
2016,1,10,8,495,458,180,-278
2016,1,10,9,498,448,178,-270
2016,1,10,10,500,456,178,-278
2016,1,10,11,521,473,179,-294
2016,1,10,12,550,501,177,-324
2016,1,10,13,590,544,178,-366
2016,1,10,14,630,584,176,-408
2016,1,10,15,644,602,191,-411
2016,1,10,16,631,598,200,-398
2016,1,10,17,625,592,169,-423
2016,1,10,18,623,601,177,-424
2016,1,10,19,621,611,176,-435
2016,1,10,20,625,625,176,-449
2016,1,10,21,624,641,176,-465
2016,1,10,22,650,685,208,-477
2016,1,10,23,700,736,266,-470
2016,1,11,0,743,761,322,-439
2016,1,11,1,759,766,292,-474
2016,1,11,2,751,766,291,-475
2016,1,11,3,731,747,291,-456
2016,1,11,4,700,713,272,-441
2016,1,11,5,678,696,256,-440
2016,1,11,6,647,687,231,-456
2016,1,11,7,649,693,243,-450
2016,1,11,8,666,711,256,-455
2016,1,11,9,677,727,275,-452
2016,1,11,10,708,758,304,-454
2016,1,11,11,757,797,304,-493
2016,1,11,12,838,949,524,-425
2016,1,11,13,890,911,555,-356
2016,1,11,14,876,938,522,-416
2016,1,11,15,840,897,522,-375
2016,1,11,16,794,837,476,-361
2016,1,11,17,744,794,372,-422
2016,1,11,18,705,757,314,-443
2016,1,11,19,675,720,251,-469
2016,1,11,20,651,689,246,-443
2016,1,11,21,640,682,247,-435
2016,1,11,22,652,705,248,-457
2016,1,11,23,714,768,291,-477
2016,1,12,0,776,831,407,-424
2016,1,12,1,796,834,419,-415
2016,1,12,2,783,820,430,-390
2016,1,12,3,750,791,445,-346
2016,1,12,4,716,758,440,-318
2016,1,12,5,677,724,325,-399
2016,1,12,6,673,707,257,-450
2016,1,12,7,669,702,161,-541
2016,1,12,8,681,716,171,-545
2016,1,12,9,689,720,181,-539
2016,1,12,10,717,745,231,-514
2016,1,12,11,766,792,358,-434
2016,1,12,12,842,866,495,-371
2016,1,12,13,889,907,625,-282
2016,1,12,14,875,885,502,-383
2016,1,12,15,833,826,428,-398
2016,1,12,16,788,765,363,-402
2016,1,12,17,737,725,322,-403
2016,1,12,18,695,696,282,-414
2016,1,12,19,664,677,240,-437
2016,1,12,20,635,664,239,-425
2016,1,12,21,618,679,240,-439
2016,1,12,22,632,708,300,-408
2016,1,12,23,687,756,311,-445
2016,1,13,0,750,797,364,-433
2016,1,13,1,753,799,386,-413
2016,1,13,2,750,787,361,-426
2016,1,13,3,725,750,296,-454
2016,1,13,4,687,714,245,-469
2016,1,13,5,652,679,206,-473
2016,1,13,6,649,664,184,-480
2016,1,13,7,649,667,183,-484
2016,1,13,8,660,674,188,-486
2016,1,13,9,675,688,188,-500
2016,1,13,10,705,722,228,-494
2016,1,13,11,762,777,319,-458
2016,1,13,12,847,865,434,-431
2016,1,13,13,887,893,507,-386
2016,1,13,14,891,884,514,-370
2016,1,13,15,860,832,409,-423
2016,1,13,16,825,781,329,-452
2016,1,13,17,775,733,222,-511
2016,1,13,18,734,700,183,-517
2016,1,13,19,706,674,183,-491
2016,1,13,20,683,647,182,-465
2016,1,13,21,671,642,184,-458
2016,1,13,22,684,667,186,-481
2016,1,13,23,743,708,202,-506
2016,1,14,0,790,766,298,-468
2016,1,14,1,794,783,363,-420
2016,1,14,2,779,797,427,-370
2016,1,14,3,752,777,408,-369
2016,1,14,4,718,733,319,-414
2016,1,14,5,677,697,206,-491
2016,1,14,6,642,680,138,-542
2016,1,14,7,634,676,133,-543
2016,1,14,8,636,675,129,-546
2016,1,14,9,642,685,139,-546
2016,1,14,10,665,706,171,-535
2016,1,14,11,707,748,343,-405
2016,1,14,12,783,823,445,-378
2016,1,14,13,821,853,453,-400
2016,1,14,14,810,823,440,-383
2016,1,14,15,774,769,383,-386
2016,1,14,16,734,706,328,-378
2016,1,14,17,691,657,233,-424
2016,1,14,18,651,610,135,-475
2016,1,14,19,622,589,105,-484
2016,1,14,20,598,564,103,-461
2016,1,14,21,593,559,104,-455
2016,1,14,22,606,575,138,-437
2016,1,14,23,640,619,186,-433
2016,1,15,0,685,674,217,-457
2016,1,15,1,684,690,221,-469
2016,1,15,2,677,683,222,-461
2016,1,15,3,648,660,221,-439
2016,1,15,4,613,627,225,-402
2016,1,15,5,578,574,206,-368
2016,1,15,6,546,557,215,-342
2016,1,15,7,537,566,129,-437
2016,1,15,8,538,561,105,-456
2016,1,15,9,547,567,100,-467
2016,1,15,10,571,589,98,-491
2016,1,15,11,619,632,161,-471
2016,1,15,12,709,703,340,-363
2016,1,15,13,742,725,432,-293
2016,1,15,14,748,717,441,-276
2016,1,15,15,731,711,416,-295
2016,1,15,16,699,705,337,-368
2016,1,15,17,670,708,276,-432
2016,1,15,18,652,712,219,-493
2016,1,15,19,629,708,185,-523
2016,1,15,20,609,706,186,-520
2016,1,15,21,609,711,177,-534
2016,1,15,22,620,716,181,-535
2016,1,15,23,663,717,217,-500
2016,1,16,0,696,731,315,-416
2016,1,16,1,690,709,315,-394
2016,1,16,2,683,694,318,-376
2016,1,16,3,656,665,317,-348
2016,1,16,4,620,629,319,-310
2016,1,16,5,587,585,316,-269
2016,1,16,6,588,555,252,-303
2016,1,16,7,572,538,199,-339
2016,1,16,8,561,531,179,-352
2016,1,16,9,562,536,180,-356
2016,1,16,10,570,547,177,-370
2016,1,16,11,594,575,178,-397
2016,1,16,12,627,609,177,-432
2016,1,16,13,664,653,181,-472
2016,1,16,14,692,679,199,-480
2016,1,16,15,693,665,189,-476
2016,1,16,16,669,639,181,-458
2016,1,16,17,647,609,179,-430
2016,1,16,18,622,585,178,-407
2016,1,16,19,595,565,178,-387
2016,1,16,20,580,555,180,-375
2016,1,16,21,569,567,203,-364
2016,1,16,22,581,589,180,-409
2016,1,16,23,627,643,182,-461
2016,1,17,0,667,686,206,-480
2016,1,17,1,670,691,203,-488
2016,1,17,2,662,681,201,-480
2016,1,17,3,642,659,181,-478
2016,1,17,4,612,638,176,-462
2016,1,17,5,586,597,172,-425
2016,1,17,6,555,577,171,-406
2016,1,17,7,544,567,172,-395
2016,1,17,8,544,560,171,-389
2016,1,17,9,549,565,171,-394
2016,1,17,10,563,576,173,-403
2016,1,17,11,592,591,145,-446
2016,1,17,12,626,636,169,-467
2016,1,17,13,671,657,189,-468
2016,1,17,14,711,719,259,-460
2016,1,17,15,715,723,362,-361
2016,1,17,16,683,687,409,-278
2016,1,17,17,650,677,410,-267
2016,1,17,18,629,674,404,-270
2016,1,17,19,607,651,357,-294
2016,1,17,20,586,642,307,-335
2016,1,17,21,583,648,251,-397
2016,1,17,22,598,667,249,-418
2016,1,17,23,655,717,255,-462
2016,1,18,0,704,767,345,-422
2016,1,18,1,711,770,345,-425
2016,1,18,2,707,762,343,-419
2016,1,18,3,687,741,344,-397
2016,1,18,4,665,713,346,-367
2016,1,18,5,641,679,320,-359
2016,1,18,6,679,669,254,-415
2016,1,18,7,686,661,250,-411
2016,1,18,8,704,660,174,-486
2016,1,18,9,719,681,135,-546
2016,1,18,10,747,716,187,-529
2016,1,18,11,790,762,259,-503
2016,1,18,12,835,810,404,-406
2016,1,18,13,884,896,521,-375
2016,1,18,14,903,926,540,-386
2016,1,18,15,905,915,497,-418
2016,1,18,16,885,898,462,-436
2016,1,18,17,851,866,434,-432
2016,1,18,18,813,838,323,-515
2016,1,18,19,790,810,273,-537
2016,1,18,20,772,790,249,-541
2016,1,18,21,766,793,249,-544
2016,1,18,22,796,819,304,-515
2016,1,18,23,851,897,543,-354
2016,1,19,0,935,958,553,-405
2016,1,19,1,927,971,557,-414
2016,1,19,2,928,961,557,-404
2016,1,19,3,898,947,561,-386
2016,1,19,4,863,903,526,-377
2016,1,19,5,827,878,451,-427
2016,1,19,6,852,868,451,-417
2016,1,19,7,855,873,452,-421
2016,1,19,8,870,880,450,-430
2016,1,19,9,879,899,451,-448
2016,1,19,10,908,924,452,-472
2016,1,19,11,947,971,572,-399
2016,1,19,12,1008,1027,629,-398
2016,1,19,13,1032,1071,622,-449
2016,1,19,14,1036,1073,623,-450
2016,1,19,15,1010,1032,624,-408
2016,1,19,16,957,977,582,-395
2016,1,19,17,910,927,554,-373
2016,1,19,18,860,876,478,-398
2016,1,19,19,828,834,381,-453
2016,1,19,20,799,803,381,-422
2016,1,19,21,787,789,381,-408
2016,1,19,22,818,807,382,-425
2016,1,19,23,870,857,422,-435
2016,1,20,0,928,928,553,-375
2016,1,20,1,934,941,555,-386
2016,1,20,2,924,937,555,-382
2016,1,20,3,894,909,547,-362
2016,1,20,4,836,870,493,-377
2016,1,20,5,807,832,406,-426
2016,1,20,6,789,815,382,-433
2016,1,20,7,784,807,383,-424
2016,1,20,8,788,796,382,-414
2016,1,20,9,789,788,383,-405
2016,1,20,10,812,793,389,-404
2016,1,20,11,851,818,540,-278
2016,1,20,12,916,878,558,-320
2016,1,20,13,940,899,554,-345
2016,1,20,14,935,896,556,-340
2016,1,20,15,905,896,557,-339
2016,1,20,16,870,877,556,-321
2016,1,20,17,825,847,547,-300
2016,1,20,18,793,822,458,-364
2016,1,20,19,771,811,334,-477
2016,1,20,20,742,814,315,-499
2016,1,20,21,732,811,314,-497
2016,1,20,22,753,820,319,-501
2016,1,20,23,802,845,352,-493
2016,1,21,0,851,872,527,-345
2016,1,21,1,852,850,531,-319
2016,1,21,2,829,822,453,-369
2016,1,21,3,787,785,424,-361
2016,1,21,4,736,729,306,-423
2016,1,21,5,698,689,226,-463
2016,1,21,6,684,667,201,-466
2016,1,21,7,674,659,161,-498
2016,1,21,8,668,659,159,-500
2016,1,21,9,676,672,182,-490
2016,1,21,10,690,690,215,-475
2016,1,21,11,727,731,362,-369
2016,1,21,12,802,787,471,-316
2016,1,21,13,835,828,485,-346
2016,1,21,14,823,844,486,-358
2016,1,21,15,793,811,420,-391
2016,1,21,16,766,749,332,-417
2016,1,21,17,737,709,418,-291
2016,1,21,18,714,668,236,-432
2016,1,21,19,691,638,258,-380
2016,1,21,20,674,624,240,-384
2016,1,21,21,669,618,114,-504
2016,1,21,22,693,625,111,-514
2016,1,21,23,729,678,132,-546
2016,1,22,0,767,727,262,-465
2016,1,22,1,763,734,288,-446
2016,1,22,2,755,721,284,-437
2016,1,22,3,728,701,288,-413
2016,1,22,4,682,665,286,-379
2016,1,22,5,639,633,210,-423
2016,1,22,6,662,611,140,-471
2016,1,22,7,657,606,107,-499
2016,1,22,8,656,615,109,-506
2016,1,22,9,666,629,106,-523
2016,1,22,10,684,661,114,-547
2016,1,22,11,719,690,173,-517
2016,1,22,12,787,735,291,-444
2016,1,22,13,825,763,313,-450
2016,1,22,14,833,797,358,-439
2016,1,22,15,841,822,382,-440
2016,1,22,16,838,825,435,-390
2016,1,22,17,827,819,464,-355
2016,1,22,18,813,822,468,-354
2016,1,22,19,806,804,465,-339
2016,1,22,20,792,791,466,-325
2016,1,22,21,792,758,464,-294
2016,1,22,22,808,750,464,-286
2016,1,22,23,851,811,465,-352
2016,1,23,0,878,810,499,-317
2016,1,23,1,858,804,519,-285
2016,1,23,2,838,782,375,-407
2016,1,23,3,809,752,283,-469
2016,1,23,4,753,713,245,-468
2016,1,23,5,743,679,175,-504
2016,1,23,6,738,654,148,-506
2016,1,23,7,723,654,161,-493
2016,1,23,8,717,666,181,-485
2016,1,23,9,717,680,242,-438
2016,1,23,10,725,701,347,-354
2016,1,23,11,746,722,390,-332
2016,1,23,12,770,758,445,-313
2016,1,23,13,805,796,466,-330
2016,1,23,14,837,832,469,-363
2016,1,23,15,843,857,469,-388
2016,1,23,16,835,869,469,-400
2016,1,23,17,816,873,433,-440
2016,1,23,18,791,833,363,-470
2016,1,23,19,765,807,345,-462
2016,1,23,20,751,811,307,-504
2016,1,23,21,747,828,301,-527
2016,1,23,22,771,857,326,-531
2016,1,23,23,807,880,443,-437
2016,1,24,0,846,917,474,-443
2016,1,24,1,850,902,474,-428
2016,1,24,2,846,885,476,-409
2016,1,24,3,838,850,474,-376
2016,1,24,4,793,817,402,-415
2016,1,24,5,776,783,388,-395
2016,1,24,6,793,762,384,-378
2016,1,24,7,781,758,350,-408
2016,1,24,8,777,766,321,-445
2016,1,24,9,779,780,324,-456
2016,1,24,10,783,801,312,-489
2016,1,24,11,799,831,333,-498
2016,1,24,12,823,860,375,-485
2016,1,24,13,857,901,490,-411
2016,1,24,14,885,915,528,-387
2016,1,24,15,854,892,484,-408
2016,1,24,16,786,829,399,-430
2016,1,24,17,729,780,272,-508
2016,1,24,18,697,728,208,-520
2016,1,24,19,665,681,147,-534
2016,1,24,20,632,647,142,-505
2016,1,24,21,618,626,142,-484
2016,1,24,22,625,639,142,-497
2016,1,24,23,674,695,189,-506
2016,1,25,0,735,754,245,-509
2016,1,25,1,743,758,246,-512
2016,1,25,2,746,753,250,-503
2016,1,25,3,727,725,235,-490
2016,1,25,4,711,713,185,-528
2016,1,25,5,678,692,168,-524
2016,1,25,6,661,673,178,-495
2016,1,25,7,664,674,211,-463
2016,1,25,8,667,676,258,-418
2016,1,25,9,680,675,269,-406
2016,1,25,10,703,695,325,-370
2016,1,25,11,750,737,358,-379
2016,1,25,12,832,794,367,-427
2016,1,25,13,873,843,361,-482
2016,1,25,14,866,841,302,-539
2016,1,25,15,828,814,337,-477
2016,1,25,16,777,776,265,-511
2016,1,25,17,735,733,228,-505
2016,1,25,18,700,681,224,-457
2016,1,25,19,667,649,147,-502
2016,1,25,20,636,629,121,-508
2016,1,25,21,630,623,120,-503
2016,1,25,22,645,634,122,-512
2016,1,25,23,681,677,180,-497
2016,1,26,0,736,743,288,-455
2016,1,26,1,745,754,318,-436
2016,1,26,2,727,739,328,-411
2016,1,26,3,695,711,286,-425
2016,1,26,4,659,678,204,-474
2016,1,26,5,614,643,194,-449
2016,1,26,6,582,621,121,-500
2016,1,26,7,573,622,140,-482
2016,1,26,8,568,620,150,-470
2016,1,26,9,576,629,157,-472
2016,1,26,10,597,633,229,-404
2016,1,26,11,640,664,286,-378
2016,1,26,12,720,711,400,-311
2016,1,26,13,757,739,451,-288
2016,1,26,14,753,741,454,-287
2016,1,26,15,732,727,320,-407
2016,1,26,16,701,718,238,-480
2016,1,26,17,678,695,216,-479
2016,1,26,18,658,669,190,-479
2016,1,26,19,637,657,179,-478
2016,1,26,20,620,653,173,-480
2016,1,26,21,618,650,171,-479
2016,1,26,22,631,669,188,-481
2016,1,26,23,665,700,223,-477
2016,1,27,0,703,728,272,-456
2016,1,27,1,714,731,297,-434
2016,1,27,2,699,713,296,-417
2016,1,27,3,666,671,224,-447
2016,1,27,4,618,627,149,-478
2016,1,27,5,581,588,133,-455
2016,1,27,6,590,558,113,-445
2016,1,27,7,577,547,119,-428
2016,1,27,8,572,541,115,-426
2016,1,27,9,576,549,116,-433
2016,1,27,10,595,562,113,-449
2016,1,27,11,638,609,191,-418
2016,1,27,12,716,676,216,-460
2016,1,27,13,747,739,274,-465
2016,1,27,14,745,756,273,-483
2016,1,27,15,735,757,278,-479
2016,1,27,16,710,742,279,-463
2016,1,27,17,689,699,265,-434
2016,1,27,18,669,657,216,-441
2016,1,27,19,653,647,213,-434
2016,1,27,20,640,631,211,-420
2016,1,27,21,636,639,212,-427
2016,1,27,22,648,659,213,-446
2016,1,27,23,696,700,232,-468
2016,1,28,0,741,750,279,-471
2016,1,28,1,747,764,293,-471
2016,1,28,2,743,765,295,-470
2016,1,28,3,720,749,294,-455
2016,1,28,4,684,710,244,-466
2016,1,28,5,645,672,201,-471
2016,1,28,6,619,660,187,-473
2016,1,28,7,608,661,188,-473
2016,1,28,8,606,669,198,-471
2016,1,28,9,607,684,212,-472
2016,1,28,10,629,712,266,-446
2016,1,28,11,672,758,297,-461
2016,1,28,12,749,830,401,-429
2016,1,28,13,774,876,420,-456
2016,1,28,14,765,873,405,-468
2016,1,28,15,740,852,369,-483
2016,1,28,16,702,813,351,-462
2016,1,28,17,671,779,305,-474
2016,1,28,18,641,711,246,-465
2016,1,28,19,616,643,176,-467
2016,1,28,20,597,604,142,-462
2016,1,28,21,589,597,127,-470
2016,1,28,22,598,623,151,-472
2016,1,28,23,632,672,243,-429
2016,1,29,0,678,726,309,-417
2016,1,29,1,683,744,310,-434
2016,1,29,2,680,735,309,-426
2016,1,29,3,654,716,310,-406
2016,1,29,4,618,677,261,-416
2016,1,29,5,583,640,190,-450
2016,1,29,6,611,616,177,-439
2016,1,29,7,603,608,144,-464
2016,1,29,8,606,604,142,-462
2016,1,29,9,611,606,142,-464
2016,1,29,10,642,620,169,-451
2016,1,29,11,678,653,256,-397
2016,1,29,12,742,728,354,-374
2016,1,29,13,787,748,374,-374
2016,1,29,14,792,748,393,-355
2016,1,29,15,776,702,351,-351
2016,1,29,16,750,682,251,-431
2016,1,29,17,718,662,212,-450
2016,1,29,18,684,636,211,-425
2016,1,29,19,664,618,213,-405
2016,1,29,20,647,594,205,-389
2016,1,29,21,645,588,124,-464
2016,1,29,22,650,609,171,-438
2016,1,29,23,694,646,214,-432
2016,1,30,0,734,707,227,-480
2016,1,30,1,740,717,237,-480
2016,1,30,2,731,714,253,-461
2016,1,30,3,710,701,244,-457
2016,1,30,4,692,678,242,-436
2016,1,30,5,653,651,206,-445
2016,1,30,6,616,633,181,-452
2016,1,30,7,606,633,181,-452
2016,1,30,8,604,635,181,-454
2016,1,30,9,605,647,181,-466
2016,1,30,10,620,667,184,-483
2016,1,30,11,641,699,219,-480
2016,1,30,12,677,736,262,-474
2016,1,30,13,712,777,353,-424
2016,1,30,14,738,791,368,-423
2016,1,30,15,719,757,370,-387
2016,1,30,16,678,706,367,-339
2016,1,30,17,638,646,338,-308
2016,1,30,18,595,596,281,-315
2016,1,30,19,560,555,202,-353
2016,1,30,20,539,531,159,-372
2016,1,30,21,530,526,160,-366
2016,1,30,22,538,539,161,-378
2016,1,30,23,570,566,159,-407
2016,1,31,0,613,626,206,-420
2016,1,31,1,613,636,259,-377
2016,1,31,2,603,627,312,-315
2016,1,31,3,585,616,274,-342
2016,1,31,4,553,591,167,-424
2016,1,31,5,525,562,135,-427
2016,1,31,6,518,549,109,-440
2016,1,31,7,507,540,109,-431
2016,1,31,8,506,543,110,-433
2016,1,31,9,506,549,108,-441
2016,1,31,10,518,565,111,-454
2016,1,31,11,542,589,217,-372
2016,1,31,12,574,624,238,-386
2016,1,31,13,615,667,238,-429
2016,1,31,14,646,699,239,-460
2016,1,31,15,636,672,238,-434
2016,1,31,16,595,620,229,-391
2016,1,31,17,565,564,176,-388
2016,1,31,18,539,530,148,-382
2016,1,31,19,519,504,109,-395
2016,1,31,20,501,492,106,-386
2016,1,31,21,508,492,122,-370
2016,1,31,22,512,505,123,-382
2016,1,31,23,540,526,115,-411
2016,2,1,0,582,582,116,-466
2016,2,1,1,583,591,117,-474
2016,2,1,2,570,573,115,-458
2016,2,1,3,540,548,116,-432
2016,2,1,4,509,515,116,-399
2016,2,1,5,476,479,115,-364
2016,2,1,6,454,432,89,-343
2016,2,1,7,444,449,114,-335
2016,2,1,8,439,453,116,-337
2016,2,1,9,441,455,115,-340
2016,2,1,10,458,481,115,-366
2016,2,1,11,499,524,164,-360
2016,2,1,12,579,616,210,-406
2016,2,1,13,617,636,224,-412
2016,2,1,14,618,628,227,-401
2016,2,1,15,613,598,226,-372
2016,2,1,16,598,575,226,-349
2016,2,1,17,584,552,224,-328
2016,2,1,18,569,540,187,-353
2016,2,1,19,556,524,117,-407
2016,2,1,20,545,520,118,-402
2016,2,1,21,540,519,133,-386
2016,2,1,22,552,528,210,-318
2016,2,1,23,577,570,246,-324
2016,2,2,0,620,607,247,-360
2016,2,2,1,628,603,246,-357
2016,2,2,2,611,587,246,-341
2016,2,2,3,578,548,244,-304
2016,2,2,4,547,509,174,-335
2016,2,2,5,497,460,137,-323
2016,2,2,6,465,426,121,-305
2016,2,2,7,452,423,131,-292
2016,2,2,8,444,425,134,-291
2016,2,2,9,444,419,130,-289
2016,2,2,10,458,439,132,-307
2016,2,2,11,496,479,133,-346
2016,2,2,12,572,562,233,-329
2016,2,2,13,608,596,217,-379
2016,2,2,14,604,588,219,-369
2016,2,2,15,597,584,245,-339
2016,2,2,16,587,578,250,-328
2016,2,2,17,578,580,251,-329
2016,2,2,18,563,574,252,-322
2016,2,2,19,552,565,251,-314
2016,2,2,20,540,551,251,-300
2016,2,2,21,534,549,251,-298
2016,2,2,22,550,561,253,-308
2016,2,2,23,573,599,321,-278
2016,2,3,0,618,633,379,-254
2016,2,3,1,614,637,396,-241
2016,2,3,2,596,617,363,-254
2016,2,3,3,565,582,286,-296
2016,2,3,4,526,535,245,-290
2016,2,3,5,479,492,240,-252
2016,2,3,6,452,462,196,-266
2016,2,3,7,440,444,135,-309
2016,2,3,8,433,433,131,-302
2016,2,3,9,432,437,134,-303
2016,2,3,10,447,445,136,-309
2016,2,3,11,485,476,218,-258
2016,2,3,12,563,537,234,-303
2016,2,3,13,597,580,242,-338
2016,2,3,14,594,574,240,-334
2016,2,3,15,583,571,242,-329
2016,2,3,16,569,572,243,-329
2016,2,3,17,557,566,242,-324
2016,2,3,18,542,557,242,-315
2016,2,3,19,534,551,248,-303
2016,2,3,20,527,526,281,-245
2016,2,3,21,517,526,241,-285
2016,2,3,22,534,530,238,-292
2016,2,3,23,562,550,238,-312
2016,2,4,0,610,594,240,-354
2016,2,4,1,611,590,243,-347
2016,2,4,2,599,583,246,-337
2016,2,4,3,577,553,245,-308
2016,2,4,4,536,514,243,-271
2016,2,4,5,496,477,241,-236
2016,2,4,6,475,448,242,-206
2016,2,4,7,467,434,237,-197
2016,2,4,8,465,440,241,-199
2016,2,4,9,473,454,248,-206
2016,2,4,10,495,479,245,-234
2016,2,4,11,543,536,246,-290
2016,2,4,12,635,626,245,-381
2016,2,4,13,673,673,244,-429
2016,2,4,14,670,681,243,-438
2016,2,4,15,662,680,245,-435
2016,2,4,16,653,655,243,-412
2016,2,4,17,645,636,244,-392
2016,2,4,18,632,601,254,-347
2016,2,4,19,619,583,234,-349
2016,2,4,20,607,563,153,-410
2016,2,4,21,600,547,155,-392
2016,2,4,22,615,581,158,-423
2016,2,4,23,650,660,233,-427
2016,2,5,0,704,720,307,-413
2016,2,5,1,726,738,377,-361
2016,2,5,2,713,726,412,-314
2016,2,5,3,691,697,393,-304
2016,2,5,4,650,659,291,-368
2016,2,5,5,616,632,244,-388
2016,2,5,6,636,610,240,-370
2016,2,5,7,638,615,242,-373
2016,2,5,8,647,621,242,-379
2016,2,5,9,662,637,243,-394
2016,2,5,10,684,666,241,-425
2016,2,5,11,732,727,292,-435
2016,2,5,12,808,816,373,-443
2016,2,5,13,844,855,399,-456
2016,2,5,14,843,834,406,-428
2016,2,5,15,815,799,336,-463
2016,2,5,16,779,756,265,-491
2016,2,5,17,747,718,175,-543
2016,2,5,18,713,682,136,-546
2016,2,5,19,692,654,134,-520
2016,2,5,20,674,627,133,-494
2016,2,5,21,673,621,135,-486
2016,2,5,22,689,630,137,-493
2016,2,5,23,725,679,298,-381
2016,2,6,0,769,738,356,-382
2016,2,6,1,783,755,365,-390
2016,2,6,2,770,760,388,-372
2016,2,6,3,743,752,418,-334
2016,2,6,4,731,725,464,-261
2016,2,6,5,697,692,467,-225
2016,2,6,6,692,679,453,-226
2016,2,6,7,685,674,446,-228
2016,2,6,8,692,676,446,-230
2016,2,6,9,696,678,445,-233
2016,2,6,10,708,699,451,-248
2016,2,6,11,740,724,486,-238
2016,2,6,12,775,762,486,-276
2016,2,6,13,813,800,489,-311
2016,2,6,14,828,816,488,-328
2016,2,6,15,809,786,484,-302
2016,2,6,16,771,727,411,-316
2016,2,6,17,736,688,286,-402
2016,2,6,18,696,661,258,-403
2016,2,6,19,658,632,260,-372
2016,2,6,20,642,594,259,-335
2016,2,6,21,633,583,260,-323
2016,2,6,22,642,603,261,-342
2016,2,6,23,681,642,267,-375
2016,2,7,0,728,702,287,-415
2016,2,7,1,739,719,374,-345
2016,2,7,2,737,714,405,-309
2016,2,7,3,724,708,412,-296
2016,2,7,4,716,687,414,-273
2016,2,7,5,674,665,411,-254
2016,2,7,6,608,645,403,-242
2016,2,7,7,605,642,353,-289
2016,2,7,8,607,649,356,-293
2016,2,7,9,616,660,354,-306
2016,2,7,10,628,675,364,-311
2016,2,7,11,651,700,409,-291
2016,2,7,12,693,728,452,-276
2016,2,7,13,732,773,453,-320
2016,2,7,14,769,801,453,-348
2016,2,7,15,755,763,453,-310
2016,2,7,16,707,694,451,-243
2016,2,7,17,661,643,452,-191
2016,2,7,18,633,616,453,-163
2016,2,7,19,601,589,437,-152
2016,2,7,20,579,566,379,-187
2016,2,7,21,572,564,380,-184
2016,2,7,22,577,571,378,-193
2016,2,7,23,605,614,390,-224
2016,2,8,0,663,647,484,-163
2016,2,8,1,683,650,480,-170
2016,2,8,2,674,653,417,-236
2016,2,8,3,648,654,404,-250
2016,2,8,4,639,646,337,-309
2016,2,8,5,598,635,300,-335
2016,2,8,6,562,612,235,-377
2016,2,8,7,559,609,238,-371
2016,2,8,8,565,607,232,-375
2016,2,8,9,579,618,235,-383
2016,2,8,10,609,655,302,-353
2016,2,8,11,661,700,471,-229
2016,2,8,12,743,769,486,-283
2016,2,8,13,784,800,486,-314
2016,2,8,14,793,792,485,-307
2016,2,8,15,776,769,427,-342
2016,2,8,16,744,758,420,-338
2016,2,8,17,712,737,417,-320
2016,2,8,18,681,695,367,-328
2016,2,8,19,652,667,295,-372
2016,2,8,20,629,659,294,-365
2016,2,8,21,622,660,282,-378
2016,2,8,22,634,676,247,-429
2016,2,8,23,678,720,281,-439
2016,2,9,0,730,769,360,-409
2016,2,9,1,749,783,367,-416
2016,2,9,2,746,769,353,-416
2016,2,9,3,716,736,306,-430
2016,2,9,4,696,693,287,-406
2016,2,9,5,652,660,187,-473
2016,2,9,6,628,651,148,-503
2016,2,9,7,629,650,152,-498
2016,2,9,8,638,658,153,-505
2016,2,9,9,652,671,166,-505
2016,2,9,10,681,701,233,-468
2016,2,9,11,731,740,283,-457
2016,2,9,12,805,805,353,-452
2016,2,9,13,851,844,413,-431
2016,2,9,14,863,861,422,-439
2016,2,9,15,852,867,391,-476
2016,2,9,16,841,863,310,-553
2016,2,9,17,813,858,307,-551
2016,2,9,18,786,848,298,-550
2016,2,9,19,776,843,293,-550
2016,2,9,20,764,836,289,-547
2016,2,9,21,767,833,318,-515
2016,2,9,22,794,835,317,-518
2016,2,9,23,826,873,453,-420
2016,2,10,0,879,923,535,-388
2016,2,10,1,902,932,556,-376
2016,2,10,2,902,917,555,-362
2016,2,10,3,867,881,554,-327
2016,2,10,4,833,838,488,-350
2016,2,10,5,798,798,398,-400
2016,2,10,6,840,777,321,-456
2016,2,10,7,839,777,307,-470
2016,2,10,8,852,784,302,-482
2016,2,10,9,866,796,312,-484
2016,2,10,10,886,821,334,-487
2016,2,10,11,932,867,478,-389
2016,2,10,12,988,940,560,-380
2016,2,10,13,1015,985,557,-428
2016,2,10,14,1017,984,557,-427
2016,2,10,15,1003,959,558,-401
2016,2,10,16,968,920,555,-365
2016,2,10,17,925,893,557,-336
2016,2,10,18,884,848,505,-343
2016,2,10,19,852,824,474,-350
2016,2,10,20,836,790,407,-383
2016,2,10,21,835,786,398,-388
2016,2,10,22,851,804,448,-356
2016,2,10,23,901,860,505,-355
2016,2,11,0,953,930,556,-374
2016,2,11,1,978,940,552,-388
2016,2,11,2,986,935,555,-380
2016,2,11,3,966,899,555,-344
2016,2,11,4,942,850,499,-351
2016,2,11,5,897,811,486,-325
2016,2,11,6,824,793,421,-372
2016,2,11,7,820,800,372,-428
2016,2,11,8,830,797,372,-425
2016,2,11,9,840,810,363,-447
2016,2,11,10,866,823,364,-459
2016,2,11,11,906,861,498,-363
2016,2,11,12,966,914,553,-361
2016,2,11,13,993,939,554,-385
2016,2,11,14,986,923,551,-372
2016,2,11,15,956,885,552,-333
2016,2,11,16,908,850,551,-299
2016,2,11,17,858,794,463,-331
2016,2,11,18,809,751,376,-375
2016,2,11,19,777,715,344,-371
2016,2,11,20,750,688,312,-376
2016,2,11,21,729,666,211,-455
2016,2,11,22,730,679,189,-490
2016,2,11,23,789,722,286,-436
2016,2,12,0,845,793,372,-421
2016,2,12,1,870,817,430,-387
2016,2,12,2,870,817,427,-390
2016,2,12,3,843,796,424,-372
2016,2,12,4,806,754,378,-376
2016,2,12,5,762,718,345,-373
2016,2,12,6,728,689,296,-393
2016,2,12,7,719,679,247,-432
2016,2,12,8,718,673,220,-453
2016,2,12,9,732,673,197,-476
2016,2,12,10,750,688,240,-448
2016,2,12,11,789,722,345,-377
2016,2,12,12,857,807,468,-339
2016,2,12,13,889,844,486,-358
2016,2,12,14,878,833,488,-345
2016,2,12,15,848,823,486,-337
2016,2,12,16,809,800,487,-313
2016,2,12,17,773,776,488,-288
2016,2,12,18,729,739,440,-299
2016,2,12,19,702,735,377,-358
2016,2,12,20,679,741,378,-363
2016,2,12,21,672,744,377,-367
2016,2,12,22,682,753,379,-374
2016,2,12,23,722,771,384,-387
2016,2,13,0,762,804,386,-418
2016,2,13,1,788,803,388,-415
2016,2,13,2,784,792,388,-404
2016,2,13,3,757,774,387,-387
2016,2,13,4,751,742,388,-354
2016,2,13,5,713,718,380,-338
2016,2,13,6,696,701,380,-321
2016,2,13,7,695,706,378,-328
2016,2,13,8,706,715,378,-337
2016,2,13,9,715,728,377,-351
2016,2,13,10,741,757,379,-378
2016,2,13,11,772,791,456,-335
2016,2,13,12,802,839,486,-353
2016,2,13,13,850,883,506,-377
2016,2,13,14,888,912,554,-358
2016,2,13,15,885,907,561,-346
2016,2,13,16,869,878,551,-327
2016,2,13,17,839,830,340,-490
2016,2,13,18,798,795,253,-542
2016,2,13,19,769,760,218,-542
2016,2,13,20,760,740,197,-543
2016,2,13,21,759,728,185,-543
2016,2,13,22,773,745,215,-530
2016,2,13,23,812,794,390,-404
2016,2,14,0,855,859,520,-339
2016,2,14,1,886,893,543,-350
2016,2,14,2,898,892,542,-350
2016,2,14,3,878,879,545,-334
2016,2,14,4,866,854,541,-313
2016,2,14,5,837,839,480,-359
2016,2,14,6,818,821,474,-347
2016,2,14,7,815,815,473,-342
2016,2,14,8,826,820,478,-342
2016,2,14,9,834,812,476,-336
2016,2,14,10,852,814,475,-339
2016,2,14,11,869,821,483,-338
2016,2,14,12,896,834,474,-360
2016,2,14,13,919,865,525,-340
2016,2,14,14,942,900,543,-357
2016,2,14,15,928,912,535,-377
2016,2,14,16,875,899,523,-376
2016,2,14,17,833,883,476,-407
2016,2,14,18,808,885,464,-421
2016,2,14,19,775,882,402,-480
2016,2,14,20,743,872,331,-541
2016,2,14,21,740,872,336,-536
2016,2,14,22,754,877,349,-528
2016,2,14,23,781,908,430,-478
2016,2,15,0,833,925,546,-379
2016,2,15,1,843,919,550,-369
2016,2,15,2,832,892,549,-343
2016,2,15,3,802,856,514,-342
2016,2,15,4,763,813,482,-331
2016,2,15,5,744,776,465,-311
2016,2,15,6,760,751,366,-385
2016,2,15,7,756,732,346,-386
2016,2,15,8,759,715,322,-393
2016,2,15,9,763,717,323,-394
2016,2,15,10,784,729,330,-399
2016,2,15,11,823,765,442,-323
2016,2,15,12,879,808,483,-325
2016,2,15,13,906,852,487,-365
2016,2,15,14,902,868,487,-381
2016,2,15,15,890,862,486,-376
2016,2,15,16,870,853,485,-368
2016,2,15,17,843,837,486,-351
2016,2,15,18,813,808,486,-322
2016,2,15,19,784,786,485,-301
2016,2,15,20,754,773,487,-286
2016,2,15,21,738,767,486,-281
2016,2,15,22,738,774,484,-290
2016,2,15,23,772,793,484,-309
2016,2,16,0,812,817,485,-332
2016,2,16,1,815,811,485,-326
2016,2,16,2,790,785,482,-303
2016,2,16,3,761,751,435,-316
2016,2,16,4,713,693,366,-327
2016,2,16,5,657,640,290,-350
2016,2,16,6,614,588,165,-423
2016,2,16,7,605,575,117,-458
2016,2,16,8,602,563,105,-458
2016,2,16,9,607,565,106,-459
2016,2,16,10,624,576,114,-462
2016,2,16,11,668,622,214,-408
2016,2,16,12,739,709,232,-477
2016,2,16,13,772,749,268,-481
2016,2,16,14,765,740,268,-472
2016,2,16,15,741,713,231,-482
2016,2,16,16,714,682,217,-465
2016,2,16,17,687,648,212,-436
2016,2,16,18,659,614,214,-400
2016,2,16,19,637,598,213,-385
2016,2,16,20,618,582,218,-364
2016,2,16,21,613,587,218,-369
2016,2,16,22,623,623,229,-394
2016,2,16,23,654,665,260,-405
2016,2,17,0,701,710,314,-396
2016,2,17,1,723,721,340,-381
2016,2,17,2,718,703,336,-367
2016,2,17,3,689,675,264,-411
2016,2,17,4,643,636,205,-431
2016,2,17,5,604,597,128,-469
2016,2,17,6,576,574,104,-470
2016,2,17,7,566,564,98,-466
2016,2,17,8,562,567,100,-467
2016,2,17,9,575,572,101,-471
2016,2,17,10,595,590,100,-490
2016,2,17,11,635,639,180,-459
2016,2,17,12,712,718,322,-396
2016,2,17,13,747,753,348,-405
2016,2,17,14,745,743,281,-462
2016,2,17,15,725,728,215,-513
2016,2,17,16,704,703,212,-491
2016,2,17,17,674,678,213,-465
2016,2,17,18,646,645,215,-430
2016,2,17,19,626,628,207,-421
2016,2,17,20,609,609,122,-487
2016,2,17,21,600,601,121,-480
2016,2,17,22,610,622,160,-462
2016,2,17,23,642,662,181,-481
2016,2,18,0,693,728,275,-453
2016,2,18,1,719,752,293,-459
2016,2,18,2,722,744,269,-475
2016,2,18,3,696,721,216,-505
2016,2,18,4,653,678,172,-506
2016,2,18,5,619,632,104,-528
2016,2,18,6,614,605,99,-506
2016,2,18,7,608,607,109,-498
2016,2,18,8,606,612,113,-499
2016,2,18,9,622,628,131,-497
2016,2,18,10,641,661,165,-496
2016,2,18,11,687,718,295,-423
2016,2,18,12,763,810,470,-340
2016,2,18,13,796,842,480,-362
2016,2,18,14,788,804,428,-376
2016,2,18,15,755,750,359,-391
2016,2,18,16,721,698,320,-378
2016,2,18,17,686,647,279,-368
2016,2,18,18,653,613,250,-363
2016,2,18,19,631,585,201,-384
2016,2,18,20,608,559,118,-441
2016,2,18,21,602,551,103,-448
2016,2,18,22,614,564,145,-419
2016,2,18,23,641,594,251,-343
2016,2,19,0,687,646,309,-337
2016,2,19,1,714,673,351,-322
2016,2,19,2,711,685,301,-384
2016,2,19,3,684,666,274,-392
2016,2,19,4,639,632,223,-409
2016,2,19,5,607,595,164,-431
2016,2,19,6,570,582,108,-474
2016,2,19,7,562,576,106,-470
2016,2,19,8,563,582,108,-474
2016,2,19,9,573,594,107,-487
2016,2,19,10,595,613,105,-508
2016,2,19,11,643,666,166,-500
2016,2,19,12,714,748,346,-402
2016,2,19,13,745,775,439,-336
2016,2,19,14,735,745,437,-308
2016,2,19,15,704,691,335,-356
2016,2,19,16,666,654,276,-378
2016,2,19,17,634,613,224,-389
2016,2,19,18,598,581,214,-367
2016,2,19,19,577,558,211,-347
2016,2,19,20,554,538,213,-325
2016,2,19,21,543,528,206,-322
2016,2,19,22,552,541,236,-305
2016,2,19,23,577,556,286,-270
2016,2,20,0,621,607,339,-268
2016,2,20,1,626,622,377,-245
2016,2,20,2,615,611,302,-309
2016,2,20,3,592,599,214,-385
2016,2,20,4,570,568,200,-368
2016,2,20,5,532,534,118,-416
2016,2,20,6,513,512,48,-464
2016,2,20,7,501,500,49,-451
2016,2,20,8,496,488,50,-438
2016,2,20,9,499,478,47,-431
2016,2,20,10,508,482,49,-433
2016,2,20,11,533,500,72,-428
2016,2,20,12,565,529,146,-383
2016,2,20,13,595,563,146,-417
2016,2,20,14,620,591,147,-444
2016,2,20,15,621,594,146,-448
2016,2,20,16,604,586,146,-440
2016,2,20,17,573,584,147,-437
2016,2,20,18,544,574,146,-428
2016,2,20,19,520,559,146,-413
2016,2,20,20,506,540,148,-392
2016,2,20,21,502,523,87,-436
2016,2,20,22,507,533,60,-473
2016,2,20,23,523,546,84,-462
2016,2,21,0,563,573,151,-422
2016,2,21,1,574,575,149,-426
2016,2,21,2,560,562,149,-413
2016,2,21,3,542,541,149,-392
2016,2,21,4,521,509,102,-407
2016,2,21,5,487,482,53,-429
2016,2,21,6,461,456,51,-405
2016,2,21,7,446,447,52,-395
2016,2,21,8,438,438,51,-387
2016,2,21,9,435,439,53,-386
2016,2,21,10,438,441,51,-390
2016,2,21,11,458,459,53,-406
2016,2,21,12,484,485,63,-422
2016,2,21,13,514,528,147,-381
2016,2,21,14,550,552,156,-396
2016,2,21,15,558,564,156,-408
2016,2,21,16,535,546,160,-386
2016,2,21,17,508,526,166,-360
2016,2,21,18,493,522,147,-375
2016,2,21,19,481,520,171,-349
2016,2,21,20,472,512,211,-301
2016,2,21,21,468,517,221,-296
2016,2,21,22,476,526,222,-304
2016,2,21,23,495,540,220,-320
2016,2,22,0,541,571,222,-349
2016,2,22,1,559,577,222,-355
2016,2,22,2,551,559,221,-338
2016,2,22,3,525,524,211,-313
2016,2,22,4,495,493,178,-315
2016,2,22,5,462,455,176,-279
2016,2,22,6,426,418,157,-261
2016,2,22,7,415,401,107,-294
2016,2,22,8,408,414,53,-361
2016,2,22,9,409,414,51,-363
2016,2,22,10,424,433,51,-382
2016,2,22,11,468,477,130,-347
2016,2,22,12,546,546,155,-391
2016,2,22,13,584,579,157,-422
2016,2,22,14,585,576,157,-419
2016,2,22,15,581,568,156,-412
2016,2,22,16,576,557,145,-412
2016,2,22,17,566,548,97,-451
2016,2,22,18,561,533,97,-436
2016,2,22,19,551,522,96,-426
2016,2,22,20,536,515,97,-418
2016,2,22,21,530,520,97,-423
2016,2,22,22,541,533,168,-365
2016,2,22,23,571,568,212,-356
2016,2,23,0,620,599,233,-366
2016,2,23,1,639,606,234,-372
2016,2,23,2,622,588,234,-354
2016,2,23,3,588,555,233,-322
2016,2,23,4,546,511,187,-324
2016,2,23,5,501,475,158,-317
2016,2,23,6,469,452,158,-294
2016,2,23,7,457,440,117,-323
2016,2,23,8,450,440,50,-390
2016,2,23,9,454,443,51,-392
2016,2,23,10,470,464,60,-404
2016,2,23,11,515,500,154,-346
2016,2,23,12,594,589,171,-418
2016,2,23,13,631,627,209,-418
2016,2,23,14,629,619,215,-404
2016,2,23,15,626,617,212,-405
2016,2,23,16,626,617,210,-407
2016,2,23,17,620,614,211,-403
2016,2,23,18,613,602,212,-390
2016,2,23,19,604,597,217,-380
2016,2,23,20,590,585,212,-373
2016,2,23,21,586,585,212,-373
2016,2,23,22,596,600,214,-386
2016,2,23,23,622,625,212,-413
2016,2,24,0,667,659,213,-446
2016,2,24,1,681,661,213,-448
2016,2,24,2,666,647,222,-425
2016,2,24,3,631,611,222,-389
2016,2,24,4,581,560,207,-353
2016,2,24,5,537,517,206,-311
2016,2,24,6,506,489,209,-280
2016,2,24,7,491,473,205,-268
2016,2,24,8,483,467,206,-261
2016,2,24,9,485,473,213,-260
2016,2,24,10,498,483,224,-259
2016,2,24,11,540,520,236,-284
2016,2,24,12,615,593,277,-316
2016,2,24,13,642,615,258,-357
2016,2,24,14,626,591,211,-380
2016,2,24,15,609,581,212,-369
2016,2,24,16,595,571,211,-360
2016,2,24,17,577,560,211,-349
2016,2,24,18,560,551,210,-341
2016,2,24,19,547,539,213,-326
2016,2,24,20,527,527,211,-316
2016,2,24,21,520,534,213,-321
2016,2,24,22,537,551,210,-341
2016,2,24,23,566,584,212,-372
2016,2,25,0,620,635,210,-425
2016,2,25,1,639,657,212,-445
2016,2,25,2,640,654,211,-443
2016,2,25,3,616,646,211,-435
2016,2,25,4,575,614,211,-403
2016,2,25,5,540,577,210,-367
2016,2,25,6,504,567,213,-354
2016,2,25,7,498,557,210,-347
2016,2,25,8,501,560,210,-350
2016,2,25,9,516,566,211,-355
2016,2,25,10,540,589,210,-379
2016,2,25,11,597,629,214,-415
2016,2,25,12,690,709,243,-466
2016,2,25,13,724,750,261,-489
2016,2,25,14,715,737,249,-488
2016,2,25,15,692,730,259,-471
2016,2,25,16,667,726,252,-474
2016,2,25,17,644,714,239,-475
2016,2,25,18,622,705,230,-475
2016,2,25,19,606,704,229,-475
2016,2,25,20,590,688,216,-472
2016,2,25,21,590,700,225,-475
2016,2,25,22,604,716,240,-476
2016,2,25,23,648,744,290,-454
2016,2,26,0,696,787,326,-461
2016,2,26,1,724,799,356,-443
2016,2,26,2,724,781,359,-422
2016,2,26,3,698,760,362,-398
2016,2,26,4,657,706,296,-410
2016,2,26,5,621,673,232,-441
2016,2,26,6,623,652,230,-422
2016,2,26,7,615,643,230,-413
2016,2,26,8,621,642,228,-414
2016,2,26,9,630,650,230,-420
2016,2,26,10,654,668,228,-440
2016,2,26,11,696,714,260,-454
2016,2,26,12,772,772,344,-428
2016,2,26,13,799,811,350,-461
2016,2,26,14,784,821,349,-472
2016,2,26,15,757,811,348,-463
2016,2,26,16,724,783,350,-433
2016,2,26,17,691,757,349,-408
2016,2,26,18,662,733,351,-382
2016,2,26,19,638,702,322,-380
2016,2,26,20,620,668,290,-378
2016,2,26,21,618,648,281,-367
2016,2,26,22,628,648,282,-366
2016,2,26,23,666,675,293,-382
2016,2,27,0,707,727,296,-431
2016,2,27,1,723,757,292,-465
2016,2,27,2,722,757,294,-463
2016,2,27,3,712,739,295,-444
2016,2,27,4,698,707,291,-416
2016,2,27,5,662,675,290,-385
2016,2,27,6,639,650,278,-372
2016,2,27,7,632,642,231,-411
2016,2,27,8,627,647,224,-423
2016,2,27,9,633,651,237,-414
2016,2,27,10,641,664,262,-402
2016,2,27,11,665,693,314,-379
2016,2,27,12,694,729,347,-382
2016,2,27,13,723,770,380,-390
2016,2,27,14,739,766,364,-402
2016,2,27,15,719,725,314,-411
2016,2,27,16,685,676,233,-443
2016,2,27,17,655,638,217,-421
2016,2,27,18,622,601,216,-385
2016,2,27,19,593,570,220,-350
2016,2,27,20,579,542,217,-325
2016,2,27,21,577,532,220,-312
2016,2,27,22,583,536,221,-315
2016,2,27,23,604,560,225,-335
2016,2,28,0,643,609,252,-357
2016,2,28,1,668,641,266,-375
2016,2,28,2,663,643,267,-376
2016,2,28,3,641,636,267,-369
2016,2,28,4,618,615,248,-367
2016,2,28,5,585,589,232,-357
2016,2,28,6,549,579,242,-337
2016,2,28,7,544,571,225,-346
2016,2,28,8,544,580,234,-346
2016,2,28,9,552,589,230,-359
2016,2,28,10,563,607,231,-376
2016,2,28,11,589,632,232,-400
2016,2,28,12,616,670,237,-433
2016,2,28,13,647,710,265,-445
2016,2,28,14,670,716,284,-432
2016,2,28,15,637,664,261,-403
2016,2,28,16,583,602,231,-371
2016,2,28,17,544,548,231,-317
2016,2,28,18,521,514,232,-282
2016,2,28,19,506,490,230,-260
2016,2,28,20,492,470,226,-244
2016,2,28,21,491,464,227,-237
2016,2,28,22,496,468,231,-237
2016,2,28,23,513,495,231,-264
2016,2,29,0,552,534,253,-281
2016,2,29,1,569,568,296,-272
2016,2,29,2,560,561,289,-272
2016,2,29,3,531,535,281,-254
2016,2,29,4,506,508,254,-254
2016,2,29,5,474,478,227,-251
2016,2,29,6,451,463,139,-324
2016,2,29,7,443,458,104,-354
2016,2,29,8,442,460,103,-357
2016,2,29,9,449,465,190,-275
2016,2,29,10,472,477,213,-264
2016,2,29,11,525,525,226,-299
2016,2,29,12,615,596,275,-321
2016,2,29,13,649,615,301,-314
2016,2,29,14,637,588,280,-308
2016,2,29,15,619,572,265,-307
2016,2,29,16,595,552,276,-276
2016,2,29,17,569,534,278,-256
2016,2,29,18,553,515,276,-239
2016,2,29,19,545,507,278,-229
2016,2,29,20,531,496,276,-220
2016,2,29,21,525,499,280,-219
2016,2,29,22,533,504,308,-196
2016,2,29,23,555,518,345,-173
2016,3,1,0,600,562,389,-173
2016,3,1,1,619,593,421,-172
2016,3,1,2,608,581,417,-164
2016,3,1,3,577,559,422,-137
2016,3,1,4,534,518,404,-114
2016,3,1,5,494,484,297,-187
2016,3,1,6,469,468,214,-254
2016,3,1,7,460,470,212,-258
2016,3,1,8,463,477,211,-266
2016,3,1,9,474,491,211,-280
2016,3,1,10,496,510,211,-299
2016,3,1,11,551,576,244,-332
2016,3,1,12,638,663,345,-318
2016,3,1,13,679,696,346,-350
2016,3,1,14,660,658,325,-333
2016,3,1,15,633,602,238,-364
2016,3,1,16,603,567,221,-346
2016,3,1,17,575,548,216,-332
2016,3,1,18,551,531,210,-321
2016,3,1,19,535,533,190,-343
2016,3,1,20,519,534,181,-353
2016,3,1,21,515,524,176,-348
2016,3,1,22,525,536,187,-349
2016,3,1,23,544,554,210,-344
2016,3,2,0,586,596,213,-383
2016,3,2,1,609,607,211,-396
2016,3,2,2,597,592,213,-379
2016,3,2,3,573,559,212,-347
2016,3,2,4,529,518,212,-306
2016,3,2,5,493,482,213,-269
2016,3,2,6,481,450,202,-248
2016,3,2,7,481,458,212,-246
2016,3,2,8,490,467,210,-257
2016,3,2,9,505,491,211,-280
2016,3,2,10,532,523,211,-312
2016,3,2,11,588,589,255,-334
2016,3,2,12,675,684,299,-385
2016,3,2,13,719,735,301,-434
2016,3,2,14,713,739,295,-444
2016,3,2,15,705,741,294,-447
2016,3,2,16,690,722,276,-446
2016,3,2,17,671,705,229,-476
2016,3,2,18,654,684,215,-469
2016,3,2,19,645,667,183,-484
2016,3,2,20,629,658,203,-455
2016,3,2,21,626,658,216,-442
2016,3,2,22,636,667,217,-450
2016,3,2,23,669,695,218,-477
2016,3,3,0,718,760,258,-502
2016,3,3,1,750,799,315,-484
2016,3,3,2,744,794,328,-466
2016,3,3,3,722,767,328,-439
2016,3,3,4,682,724,315,-409
2016,3,3,5,645,687,230,-457
2016,3,3,6,629,677,216,-461
2016,3,3,7,627,670,210,-460
2016,3,3,8,633,664,207,-457
2016,3,3,9,638,668,213,-455
2016,3,3,10,663,675,258,-417
2016,3,3,11,709,718,338,-380
2016,3,3,12,787,793,422,-371
2016,3,3,13,818,821,472,-349
2016,3,3,14,798,774,309,-465
2016,3,3,15,761,728,226,-502
2016,3,3,16,725,692,216,-476
2016,3,3,17,692,684,214,-470
2016,3,3,18,665,683,212,-471
2016,3,3,19,648,697,214,-483
2016,3,3,20,627,695,213,-482
2016,3,3,21,623,700,209,-491
2016,3,3,22,630,727,214,-513
2016,3,3,23,659,751,214,-537
2016,3,4,0,700,785,257,-528
2016,3,4,1,737,790,295,-495
2016,3,4,2,733,773,292,-481
2016,3,4,3,706,730,252,-478
2016,3,4,4,660,675,224,-451
2016,3,4,5,624,635,214,-421
2016,3,4,6,570,606,186,-420
2016,3,4,7,564,595,112,-483
2016,3,4,8,569,581,108,-473
2016,3,4,9,584,591,112,-479
2016,3,4,10,607,609,128,-481
2016,3,4,11,660,655,296,-359
2016,3,4,12,737,723,377,-346
2016,3,4,13,765,755,417,-338
2016,3,4,14,746,745,388,-357
2016,3,4,15,726,720,387,-333
2016,3,4,16,688,694,387,-307
2016,3,4,17,655,660,353,-307
2016,3,4,18,624,629,294,-335
2016,3,4,19,600,614,229,-385
2016,3,4,20,583,598,215,-383
2016,3,4,21,575,598,217,-381
2016,3,4,22,570,605,240,-365
2016,3,4,23,593,633,276,-357
2016,3,5,0,631,670,345,-325
2016,3,5,1,652,688,333,-355
2016,3,5,2,647,686,292,-394
2016,3,5,3,634,669,270,-399
2016,3,5,4,605,637,218,-419
2016,3,5,5,573,612,128,-484
2016,3,5,6,560,600,128,-472
2016,3,5,7,547,604,112,-492
2016,3,5,8,544,607,112,-495
2016,3,5,9,548,621,129,-492
2016,3,5,10,566,639,193,-446
2016,3,5,11,592,671,320,-351
2016,3,5,12,630,712,382,-330
2016,3,5,13,664,748,431,-317
2016,3,5,14,676,736,421,-315
2016,3,5,15,663,688,296,-392
2016,3,5,16,634,645,206,-439
2016,3,5,17,601,592,163,-429
2016,3,5,18,566,554,119,-435
2016,3,5,19,538,532,119,-413
2016,3,5,20,520,520,129,-391
2016,3,5,21,511,499,136,-363
2016,3,5,22,511,513,123,-390
2016,3,5,23,526,551,137,-414
2016,3,6,0,571,592,217,-375
2016,3,6,1,600,606,337,-269
2016,3,6,2,591,601,339,-262
2016,3,6,3,572,588,338,-250
2016,3,6,4,554,563,266,-297
2016,3,6,5,522,528,151,-377
2016,3,6,6,502,508,102,-406
2016,3,6,7,494,497,102,-395
2016,3,6,8,496,498,102,-396
2016,3,6,9,503,515,105,-410
2016,3,6,10,515,528,103,-425
2016,3,6,11,547,551,178,-373
2016,3,6,12,579,584,213,-371
2016,3,6,13,622,621,213,-408
2016,3,6,14,643,642,219,-423
2016,3,6,15,633,618,215,-403
2016,3,6,16,597,578,219,-359
2016,3,6,17,560,543,219,-324
2016,3,6,18,536,517,218,-299
2016,3,6,19,515,492,159,-333
2016,3,6,20,497,471,109,-362
2016,3,6,21,489,459,111,-348
2016,3,6,22,491,463,110,-353
2016,3,6,23,515,487,185,-302
2016,3,7,0,558,536,293,-243
2016,3,7,1,597,575,309,-266
2016,3,7,2,591,573,310,-263
2016,3,7,3,570,558,312,-246
2016,3,7,4,543,533,312,-221
2016,3,7,5,512,505,298,-207
2016,3,7,6,488,491,227,-264
2016,3,7,7,485,491,199,-292
2016,3,7,8,490,507,180,-327
2016,3,7,9,505,520,164,-356
2016,3,7,10,531,554,163,-391
2016,3,7,11,593,621,299,-322
2016,3,7,12,683,709,419,-290
2016,3,7,13,726,736,454,-282
2016,3,7,14,698,697,419,-278
2016,3,7,15,660,633,335,-298
2016,3,7,16,626,591,253,-338
2016,3,7,17,588,562,217,-345
2016,3,7,18,562,542,221,-321
2016,3,7,19,544,528,224,-304
2016,3,7,20,528,509,228,-281
2016,3,7,21,521,500,203,-297
2016,3,7,22,525,503,125,-378
2016,3,7,23,543,520,124,-396
2016,3,8,0,581,564,208,-356
2016,3,8,1,608,597,261,-336
2016,3,8,2,598,586,232,-354
2016,3,8,3,570,553,191,-362
2016,3,8,4,526,512,110,-402
2016,3,8,5,487,476,108,-368
2016,3,8,6,449,458,110,-348
2016,3,8,7,438,456,109,-347
2016,3,8,8,439,459,110,-349
2016,3,8,9,447,474,109,-365
2016,3,8,10,467,503,110,-393
2016,3,8,11,519,555,195,-360
2016,3,8,12,608,651,280,-371
2016,3,8,13,638,673,335,-338
2016,3,8,14,617,632,301,-331
2016,3,8,15,594,589,188,-401
2016,3,8,16,571,557,206,-351
2016,3,8,17,549,528,194,-334
2016,3,8,18,533,514,160,-354
2016,3,8,19,525,504,163,-341
2016,3,8,20,509,500,164,-336
2016,3,8,21,504,498,133,-365
2016,3,8,22,505,496,105,-391
2016,3,8,23,523,509,84,-425
2016,3,9,0,554,535,137,-398
2016,3,9,1,576,569,228,-341
2016,3,9,2,560,553,228,-325
2016,3,9,3,528,513,190,-323
2016,3,9,4,479,472,94,-378
2016,3,9,5,439,428,44,-384
2016,3,9,6,411,403,49,-354
2016,3,9,7,399,391,53,-338
2016,3,9,8,398,389,52,-337
2016,3,9,9,404,396,53,-343
2016,3,9,10,420,420,50,-370
2016,3,9,11,466,466,80,-386
2016,3,9,12,557,545,160,-385
2016,3,9,13,586,572,161,-411
2016,3,9,14,572,557,159,-398
2016,3,9,15,558,550,162,-388
2016,3,9,16,546,535,161,-374
2016,3,9,17,530,520,162,-358
2016,3,9,18,522,505,108,-397
2016,3,9,19,517,506,52,-454
2016,3,9,20,505,497,50,-447
2016,3,9,21,508,500,51,-449
2016,3,9,22,509,502,52,-450
2016,3,9,23,524,516,106,-410
2016,3,10,0,552,543,163,-380
2016,3,10,1,568,561,162,-399
2016,3,10,2,553,548,160,-388
2016,3,10,3,523,516,160,-356
2016,3,10,4,482,473,162,-311
2016,3,10,5,436,423,162,-261
2016,3,10,6,404,392,137,-255
2016,3,10,7,390,378,55,-323
2016,3,10,8,389,371,53,-318
2016,3,10,9,394,373,49,-324
2016,3,10,10,407,383,50,-333
2016,3,10,11,450,423,55,-368
2016,3,10,12,530,494,56,-438
2016,3,10,13,557,529,53,-476
2016,3,10,14,552,526,52,-474
2016,3,10,15,545,522,52,-470
2016,3,10,16,540,518,52,-466
2016,3,10,17,525,514,52,-462
2016,3,10,18,518,507,85,-422
2016,3,10,19,513,508,163,-345
2016,3,10,20,505,501,161,-340
2016,3,10,21,505,503,162,-341
2016,3,10,22,506,505,161,-344
2016,3,10,23,520,508,162,-346
2016,3,11,0,544,535,166,-369
2016,3,11,1,564,563,200,-363
2016,3,11,2,553,550,205,-345
2016,3,11,3,523,515,198,-317
2016,3,11,4,477,468,200,-268
2016,3,11,5,431,420,201,-219
2016,3,11,6,395,390,124,-266
2016,3,11,7,375,369,61,-308
2016,3,11,8,370,365,63,-302
2016,3,11,9,373,358,61,-297
2016,3,11,10,387,371,62,-309
2016,3,11,11,428,409,63,-346
2016,3,11,12,508,477,62,-415
2016,3,11,13,533,509,62,-447
2016,3,11,14,524,512,61,-451
2016,3,11,15,523,524,65,-459
2016,3,11,16,520,519,152,-367
2016,3,11,17,516,520,163,-357
2016,3,11,18,506,513,159,-354
2016,3,11,19,504,513,159,-354
2016,3,11,20,497,497,144,-353
2016,3,11,21,498,517,160,-357
2016,3,11,22,495,516,161,-355
2016,3,11,23,509,520,160,-360
2016,3,12,0,523,535,167,-368
2016,3,12,1,534,547,177,-370
2016,3,12,2,514,526,160,-366
2016,3,12,3,486,500,141,-359
2016,3,12,4,457,460,72,-388
2016,3,12,5,417,420,53,-367
2016,3,12,6,390,387,53,-334
2016,3,12,7,369,370,54,-316
2016,3,12,8,361,358,54,-304
2016,3,12,9,360,350,52,-298
2016,3,12,10,367,352,53,-299
2016,3,12,11,386,368,52,-316
2016,3,12,12,419,394,53,-341
2016,3,12,13,446,429,54,-375
2016,3,12,14,467,461,59,-402
2016,3,12,15,486,485,88,-397
2016,3,12,16,498,493,123,-370
2016,3,12,17,491,495,164,-331
2016,3,12,18,484,487,163,-324
2016,3,12,19,475,485,164,-321
2016,3,12,20,465,481,163,-318
2016,3,12,21,466,482,161,-321
2016,3,12,22,469,489,162,-327
2016,3,12,23,484,494,163,-331
2016,3,13,0,508,507,172,-335
2016,3,13,1,522,526,242,-284
2016,3,13,2,499,506,217,-289
2016,3,13,3,473,479,143,-336
2016,3,13,4,447,442,64,-378
2016,3,13,5,408,406,60,-346
2016,3,13,6,383,383,60,-9999
2016,3,13,7,364,364,54,-9999
2016,3,13,8,355,355,54,-9999
2016,3,13,9,352,352,52,-9999
2016,3,13,10,353,353,53,-9999
2016,3,13,11,366,366,52,-9999
2016,3,13,12,388,388,53,-9999
2016,3,13,13,424,424,54,-9999
2016,3,13,14,464,464,59,-9999
2016,3,13,15,491,491,88,-9999
2016,3,13,16,493,493,123,-9999
2016,3,13,17,491,491,164,-9999
2016,3,13,18,493,493,163,-9999
2016,3,13,19,486,486,164,-9999
2016,3,13,20,482,482,163,-9999
2016,3,13,21,474,474,161,-9999
2016,3,13,22,479,479,162,-9999
2016,3,13,23,481,481,163,-9999
2016,3,14,0,488,488,172,-9999
2016,3,14,1,506,506,242,-9999
2016,3,14,2,520,520,217,-9999
2016,3,14,3,498,498,143,-9999
2016,3,14,4,464,464,64,-9999
2016,3,14,5,387,384,56,-328
2016,3,14,6,372,355,40,-315
2016,3,14,7,366,356,52,-304
2016,3,14,8,367,344,40,-304
2016,3,14,9,380,370,53,-317
2016,3,14,10,419,408,51,-357
2016,3,14,11,498,479,52,-427
2016,3,14,12,538,528,147,-381
2016,3,14,13,541,532,69,-463
2016,3,14,14,544,522,52,-470
2016,3,14,15,540,528,52,-476
2016,3,14,16,540,523,54,-469
2016,3,14,17,534,517,117,-400
2016,3,14,18,529,526,202,-324
2016,3,14,19,526,515,246,-269
2016,3,14,20,522,510,238,-272
2016,3,14,21,524,519,238,-281
2016,3,14,22,527,521,240,-281
2016,3,14,23,531,538,292,-246
2016,3,15,0,547,552,299,-253
2016,3,15,1,566,561,300,-261
2016,3,15,2,533,521,257,-264
2016,3,15,3,485,480,235,-245
2016,3,15,4,437,433,227,-206
2016,3,15,5,404,398,137,-261
2016,3,15,6,391,380,105,-275
2016,3,15,7,386,373,56,-317
2016,3,15,8,390,373,55,-318
2016,3,15,9,402,379,53,-326
2016,3,15,10,444,418,115,-303
2016,3,15,11,520,487,105,-382
2016,3,15,12,563,528,103,-425
2016,3,15,13,556,526,101,-425
2016,3,15,14,553,524,106,-418
2016,3,15,15,538,521,105,-416
2016,3,15,16,530,514,106,-408
2016,3,15,17,518,502,99,-403
2016,3,15,18,513,508,191,-317
2016,3,15,19,507,513,214,-299
2016,3,15,20,511,516,215,-301
2016,3,15,21,520,526,213,-313
2016,3,15,22,520,532,215,-317
2016,3,15,23,527,533,213,-320
2016,3,16,0,546,547,233,-314
2016,3,16,1,572,570,239,-331
2016,3,16,2,543,537,192,-345
2016,3,16,3,492,488,75,-413
2016,3,16,4,443,433,54,-379
2016,3,16,5,399,390,47,-343
2016,3,16,6,381,370,48,-322
2016,3,16,7,374,361,48,-313
2016,3,16,8,376,359,48,-311
2016,3,16,9,386,366,46,-320
2016,3,16,10,426,402,48,-354
2016,3,16,11,501,472,65,-407
2016,3,16,12,537,511,69,-442
2016,3,16,13,539,505,68,-437
2016,3,16,14,545,508,70,-438
2016,3,16,15,541,511,69,-442
2016,3,16,16,541,508,70,-438
2016,3,16,17,535,508,68,-440
2016,3,16,18,529,508,72,-436
2016,3,16,19,525,511,198,-313
2016,3,16,20,519,510,281,-229
2016,3,16,21,520,520,294,-226
2016,3,16,22,518,520,290,-230
2016,3,16,23,524,530,289,-241
2016,3,17,0,539,534,272,-262
2016,3,17,1,556,553,271,-282
2016,3,17,2,528,525,232,-293
2016,3,17,3,484,474,134,-340
2016,3,17,4,442,422,50,-372
2016,3,17,5,410,394,52,-342
2016,3,17,6,399,381,49,-332
2016,3,17,7,401,377,51,-326
2016,3,17,8,407,380,50,-330
2016,3,17,9,419,396,51,-345
2016,3,17,10,474,441,65,-376
2016,3,17,11,565,523,71,-452
2016,3,17,12,613,571,58,-513
2016,3,17,13,609,569,51,-518
2016,3,17,14,600,555,122,-433
2016,3,17,15,579,534,157,-377
2016,3,17,16,557,519,156,-363
2016,3,17,17,538,504,157,-347
2016,3,17,18,522,501,157,-344
2016,3,17,19,518,496,155,-341
2016,3,17,20,504,490,157,-333
2016,3,17,21,501,497,157,-340
2016,3,17,22,502,501,156,-345
2016,3,17,23,511,516,158,-358
2016,3,18,0,539,537,157,-380
2016,3,18,1,566,561,153,-408
2016,3,18,2,546,546,156,-390
2016,3,18,3,502,433,118,-315
2016,3,18,4,465,436,47,-389
2016,3,18,5,418,404,43,-361
2016,3,18,6,405,388,44,-344
2016,3,18,7,408,385,43,-342
2016,3,18,8,411,388,43,-345
2016,3,18,9,430,404,43,-361
2016,3,18,10,482,448,42,-406
2016,3,18,11,562,531,56,-475
2016,3,18,12,612,574,86,-488
2016,3,18,13,610,578,91,-487
2016,3,18,14,600,565,80,-485
2016,3,18,15,583,538,94,-444
2016,3,18,16,558,522,126,-396
2016,3,18,17,540,507,162,-345
2016,3,18,18,527,496,188,-308
2016,3,18,19,516,488,250,-238
2016,3,18,20,507,484,288,-196
2016,3,18,21,509,483,288,-195
2016,3,18,22,508,487,283,-204
2016,3,18,23,514,492,270,-222
2016,3,19,0,532,508,256,-252
2016,3,19,1,555,524,330,-194
2016,3,19,2,538,507,339,-168
2016,3,19,3,512,474,307,-167
2016,3,19,4,472,435,225,-210
2016,3,19,5,413,406,136,-270
2016,3,19,6,396,389,108,-281
2016,3,19,7,389,386,108,-278
2016,3,19,8,388,384,106,-278
2016,3,19,9,396,386,107,-279
2016,3,19,10,415,399,105,-294
2016,3,19,11,450,426,101,-325
2016,3,19,12,497,462,103,-359
2016,3,19,13,532,491,102,-389
2016,3,19,14,552,514,103,-411
2016,3,19,15,549,517,189,-328
2016,3,19,16,535,497,216,-281
2016,3,19,17,521,491,179,-312
2016,3,19,18,504,485,108,-377
2016,3,19,19,494,471,107,-364
2016,3,19,20,484,469,105,-364
2016,3,19,21,491,473,104,-369
2016,3,19,22,496,486,143,-343
2016,3,19,23,507,490,197,-293
2016,3,20,0,541,503,273,-230
2016,3,20,1,568,517,267,-250
2016,3,20,2,559,506,268,-238
2016,3,20,3,537,476,269,-207
2016,3,20,4,509,441,243,-198
2016,3,20,5,449,411,211,-200
2016,3,20,6,439,399,208,-191
2016,3,20,7,439,395,147,-248
2016,3,20,8,444,395,105,-290
2016,3,20,9,456,402,104,-298
2016,3,20,10,480,420,104,-316
2016,3,20,11,520,450,104,-346
2016,3,20,12,569,490,102,-388
2016,3,20,13,609,543,103,-440
2016,3,20,14,616,562,100,-462
2016,3,20,15,594,564,107,-457
2016,3,20,16,574,556,117,-439
2016,3,20,17,559,561,173,-388
2016,3,20,18,545,554,240,-314
2016,3,20,19,531,558,244,-314
2016,3,20,20,520,568,242,-326
2016,3,20,21,528,588,241,-347
2016,3,20,22,547,602,243,-359
2016,3,20,23,567,600,242,-358
2016,3,21,0,603,630,244,-386
2016,3,21,1,633,654,241,-413
2016,3,21,2,621,630,241,-389
2016,3,21,3,588,597,243,-354
2016,3,21,4,562,564,244,-320
2016,3,21,5,518,540,242,-298
2016,3,21,6,515,526,186,-340
2016,3,21,7,521,530,104,-426
2016,3,21,8,536,544,102,-442
2016,3,21,9,559,564,102,-462
2016,3,21,10,612,619,178,-441
2016,3,21,11,693,684,404,-280
2016,3,21,12,737,746,538,-208
2016,3,21,13,733,745,557,-188
2016,3,21,14,705,726,556,-170
2016,3,21,15,671,701,554,-147
2016,3,21,16,646,671,556,-115
2016,3,21,17,622,644,557,-87
2016,3,21,18,605,614,509,-105
2016,3,21,19,594,578,405,-173
2016,3,21,20,588,562,339,-223
2016,3,21,21,590,558,338,-220
2016,3,21,22,596,558,243,-315
2016,3,21,23,613,582,272,-310
2016,3,22,0,642,621,289,-332
2016,3,22,1,674,671,330,-341
2016,3,22,2,650,648,351,-297
2016,3,22,3,603,606,272,-334
2016,3,22,4,564,578,218,-360
2016,3,22,5,554,554,210,-344
2016,3,22,6,544,554,188,-366
2016,3,22,7,545,560,103,-457
2016,3,22,8,556,573,103,-470
2016,3,22,9,576,604,124,-480
2016,3,22,10,627,661,337,-324
2016,3,22,11,703,735,568,-167
2016,3,22,12,738,779,612,-167
2016,3,22,13,723,762,556,-206
2016,3,22,14,687,704,380,-324
2016,3,22,15,640,639,294,-345
2016,3,22,16,606,592,152,-440
2016,3,22,17,571,558,101,-457
2016,3,22,18,547,537,101,-436
2016,3,22,19,529,515,113,-402
2016,3,22,20,520,505,114,-391
2016,3,22,21,525,500,117,-383
2016,3,22,22,523,508,145,-363
2016,3,22,23,535,521,237,-284
2016,3,23,0,559,543,261,-282
2016,3,23,1,585,577,262,-315
2016,3,23,2,565,547,189,-358
2016,3,23,3,520,508,119,-389
2016,3,23,4,480,468,119,-349
2016,3,23,5,458,442,130,-312
2016,3,23,6,448,437,131,-306
2016,3,23,7,448,440,130,-310
2016,3,23,8,459,447,129,-318
2016,3,23,9,479,472,130,-342
2016,3,23,10,532,528,139,-389
2016,3,23,11,614,618,259,-359
2016,3,23,12,656,659,429,-230
2016,3,23,13,644,646,318,-328
2016,3,23,14,623,610,206,-404
2016,3,23,15,593,568,172,-396
2016,3,23,16,562,542,145,-397
2016,3,23,17,538,519,139,-380
2016,3,23,18,528,508,137,-371
2016,3,23,19,520,498,136,-362
2016,3,23,20,510,496,137,-359
2016,3,23,21,509,501,138,-363
2016,3,23,22,507,506,151,-355
2016,3,23,23,516,512,153,-359
2016,3,24,0,535,523,146,-377
2016,3,24,1,561,555,146,-409
2016,3,24,2,539,531,158,-373
2016,3,24,3,493,482,158,-324
2016,3,24,4,449,433,159,-274
2016,3,24,5,413,400,160,-240
2016,3,24,6,398,386,159,-227
2016,3,24,7,396,387,160,-227
2016,3,24,8,400,385,160,-225
2016,3,24,9,414,400,159,-241
2016,3,24,10,458,450,159,-291
2016,3,24,11,538,527,233,-294
2016,3,24,12,585,571,279,-292
2016,3,24,13,581,560,275,-285
2016,3,24,14,575,548,277,-271
2016,3,24,15,555,534,280,-254
2016,3,24,16,537,523,277,-246
2016,3,24,17,521,508,276,-232
2016,3,24,18,516,503,215,-288
2016,3,24,19,506,495,235,-260
2016,3,24,20,498,493,333,-160
2016,3,24,21,499,503,403,-100
2016,3,24,22,500,505,436,-69
2016,3,24,23,508,527,442,-85
2016,3,25,0,531,533,441,-92
2016,3,25,1,561,537,427,-110
2016,3,25,2,538,508,332,-176
2016,3,25,3,492,462,213,-249
2016,3,25,4,448,422,189,-233
2016,3,25,5,399,388,189,-199
2016,3,25,6,376,367,189,-178
2016,3,25,7,367,359,187,-172
2016,3,25,8,365,356,187,-169
2016,3,25,9,372,361,188,-173
2016,3,25,10,402,387,243,-144
2016,3,25,11,457,426,295,-131
2016,3,25,12,492,460,295,-165
2016,3,25,13,499,483,295,-188
2016,3,25,14,507,497,297,-200
2016,3,25,15,504,501,297,-204
2016,3,25,16,495,494,298,-196
2016,3,25,17,485,481,296,-185
2016,3,25,18,476,468,237,-231
2016,3,25,19,471,463,189,-274
2016,3,25,20,466,464,188,-276
2016,3,25,21,475,465,197,-268
2016,3,25,22,474,468,234,-234
2016,3,25,23,477,473,218,-255
2016,3,26,0,484,473,195,-278
2016,3,26,1,503,500,201,-299
2016,3,26,2,489,483,194,-289
2016,3,26,3,457,453,130,-323
2016,3,26,4,423,421,47,-374
2016,3,26,5,411,389,42,-347
2016,3,26,6,396,379,44,-335
2016,3,26,7,394,376,43,-333
2016,3,26,8,393,380,44,-336
2016,3,26,9,402,392,45,-347
2016,3,26,10,428,414,42,-372
2016,3,26,11,464,450,63,-387
2016,3,26,12,507,496,91,-405
2016,3,26,13,536,530,117,-413
2016,3,26,14,544,533,125,-408
2016,3,26,15,532,513,114,-399
2016,3,26,16,516,487,115,-372
2016,3,26,17,500,466,86,-380
2016,3,26,18,485,454,57,-397
2016,3,26,19,473,447,51,-396
2016,3,26,20,460,445,51,-394
2016,3,26,21,467,453,53,-400
2016,3,26,22,464,459,53,-406
2016,3,26,23,470,465,133,-332
2016,3,27,0,488,469,160,-309
2016,3,27,1,512,499,160,-339
2016,3,27,2,497,484,97,-387
2016,3,27,3,466,455,65,-390
2016,3,27,4,434,409,53,-356
2016,3,27,5,416,383,59,-324
2016,3,27,6,400,359,54,-305
2016,3,27,7,394,347,54,-293
2016,3,27,8,392,349,56,-293
2016,3,27,9,395,351,50,-301
2016,3,27,10,409,362,49,-313
2016,3,27,11,431,387,51,-336
2016,3,27,12,465,416,49,-367
2016,3,27,13,501,458,50,-408
2016,3,27,14,516,486,78,-408
2016,3,27,15,502,478,77,-401
2016,3,27,16,488,469,75,-394
2016,3,27,17,485,460,74,-386
2016,3,27,18,478,451,77,-374
2016,3,27,19,469,436,74,-362
2016,3,27,20,461,430,74,-356
2016,3,27,21,464,437,77,-360
2016,3,27,22,465,443,76,-367
2016,3,27,23,472,455,76,-379
2016,3,28,0,492,474,75,-399
2016,3,28,1,519,486,77,-409
2016,3,28,2,497,466,76,-390
2016,3,28,3,461,434,75,-359
2016,3,28,4,429,398,61,-337
2016,3,28,5,405,368,51,-317
2016,3,28,6,391,353,49,-304
2016,3,28,7,387,349,51,-298
2016,3,28,8,389,350,50,-300
2016,3,28,9,403,362,51,-311
2016,3,28,10,445,401,76,-325
2016,3,28,11,520,440,122,-318
2016,3,28,12,564,491,126,-365
2016,3,28,13,562,505,130,-375
2016,3,28,14,558,505,128,-377
2016,3,28,15,546,507,123,-384
2016,3,28,16,531,508,118,-390
2016,3,28,17,520,498,152,-346
2016,3,28,18,513,490,148,-342
2016,3,28,19,508,482,148,-334
2016,3,28,20,502,475,148,-327
2016,3,28,21,504,480,149,-331
2016,3,28,22,511,485,148,-337
2016,3,28,23,524,498,192,-306
2016,3,29,0,546,514,216,-298
2016,3,29,1,570,540,216,-324
2016,3,29,2,547,526,217,-309
2016,3,29,3,506,479,133,-346
2016,3,29,4,466,447,53,-394
2016,3,29,5,448,419,49,-370
2016,3,29,6,437,415,49,-366
2016,3,29,7,438,414,49,-365
2016,3,29,8,448,421,49,-372
2016,3,29,9,471,440,49,-391
2016,3,29,10,525,485,52,-433
2016,3,29,11,608,554,163,-391
2016,3,29,12,653,605,259,-346
2016,3,29,13,641,604,213,-391
2016,3,29,14,619,584,154,-430
2016,3,29,15,592,562,149,-413
2016,3,29,16,565,538,151,-387
2016,3,29,17,541,518,98,-420
2016,3,29,18,525,501,50,-451
2016,3,29,19,515,488,51,-437
2016,3,29,20,506,482,51,-431
2016,3,29,21,509,482,50,-432
2016,3,29,22,511,489,51,-438
2016,3,29,23,521,498,51,-447
2016,3,30,0,543,512,135,-377
2016,3,30,1,574,547,157,-390
2016,3,30,2,558,527,156,-371
2016,3,30,3,516,492,119,-373
2016,3,30,4,479,454,51,-403
2016,3,30,5,453,432,52,-380
2016,3,30,6,442,427,50,-377
2016,3,30,7,444,434,51,-383
2016,3,30,8,455,441,50,-391
2016,3,30,9,478,467,51,-416
2016,3,30,10,531,508,69,-439
2016,3,30,11,611,579,157,-422
2016,3,30,12,657,625,158,-467
2016,3,30,13,639,620,155,-465
2016,3,30,14,615,591,157,-434
2016,3,30,15,587,553,155,-398
2016,3,30,16,559,532,158,-374
2016,3,30,17,532,508,104,-404
2016,3,30,18,518,500,51,-449
2016,3,30,19,508,492,51,-441
2016,3,30,20,502,484,50,-434
2016,3,30,21,507,491,112,-379
2016,3,30,22,505,496,157,-339
2016,3,30,23,517,503,157,-346
2016,3,31,0,525,514,158,-356
2016,3,31,1,555,542,201,-341
2016,3,31,2,541,520,207,-313
2016,3,31,3,494,480,170,-310
2016,3,31,4,452,431,82,-349
2016,3,31,5,416,400,51,-349
2016,3,31,6,401,385,50,-335
2016,3,31,7,399,382,52,-330
2016,3,31,8,400,383,51,-332
2016,3,31,9,414,388,51,-337
2016,3,31,10,456,422,107,-315
2016,3,31,11,526,472,155,-317
2016,3,31,12,568,515,160,-355
2016,3,31,13,562,525,160,-365
2016,3,31,14,555,536,161,-375
2016,3,31,15,544,540,163,-377
2016,3,31,16,529,518,167,-351
2016,3,31,17,517,522,270,-252
2016,3,31,18,511,515,260,-255
2016,3,31,19,503,513,274,-239
2016,3,31,20,502,514,285,-229
2016,3,31,21,506,519,274,-245
2016,3,31,22,510,532,335,-197
2016,3,31,23,517,530,412,-118
2016,4,1,0,527,526,334,-192
2016,4,1,1,556,546,293,-253
2016,4,1,2,536,519,238,-281
2016,4,1,3,484,476,188,-288
2016,4,1,4,435,427,101,-326
2016,4,1,5,401,395,67,-328
2016,4,1,6,379,377,64,-313
2016,4,1,7,366,372,66,-306
2016,4,1,8,362,372,68,-304
2016,4,1,9,370,373,64,-309
2016,4,1,10,397,404,69,-335
2016,4,1,11,450,458,113,-345
2016,4,1,12,489,497,136,-361
2016,4,1,13,501,506,241,-265
2016,4,1,14,508,516,316,-200
2016,4,1,15,509,520,373,-147
2016,4,1,16,509,520,395,-125
2016,4,1,17,505,513,398,-115
2016,4,1,18,497,514,407,-107
2016,4,1,19,493,506,417,-89
2016,4,1,20,497,504,427,-77
2016,4,1,21,500,503,428,-75
2016,4,1,22,500,500,428,-72
2016,4,1,23,497,496,426,-70
2016,4,2,0,497,502,430,-72
2016,4,2,1,511,514,386,-128
2016,4,2,2,489,496,263,-233
2016,4,2,3,455,458,214,-244
2016,4,2,4,412,415,149,-266
2016,4,2,5,392,379,71,-308
2016,4,2,6,374,366,51,-315
2016,4,2,7,363,355,49,-306
2016,4,2,8,358,353,49,-304
2016,4,2,9,364,356,51,-305
2016,4,2,10,377,366,50,-316
2016,4,2,11,406,396,49,-347
2016,4,2,12,442,434,50,-384
2016,4,2,13,477,469,49,-420
2016,4,2,14,504,487,49,-438
2016,4,2,15,509,491,94,-397
2016,4,2,16,502,481,156,-325
2016,4,2,17,495,469,155,-314
2016,4,2,18,483,459,155,-304
2016,4,2,19,472,450,130,-320
2016,4,2,20,469,449,49,-400
2016,4,2,21,475,452,64,-388
2016,4,2,22,481,465,78,-387
2016,4,2,23,482,476,184,-292
2016,4,3,0,500,491,202,-289
2016,4,3,1,524,524,201,-323
2016,4,3,2,514,516,157,-359
2016,4,3,3,488,485,94,-391
2016,4,3,4,456,451,74,-377
2016,4,3,5,445,429,55,-374
2016,4,3,6,443,414,53,-361
2016,4,3,7,447,409,53,-356
2016,4,3,8,458,415,55,-360
2016,4,3,9,481,430,53,-377
2016,4,3,10,508,458,53,-405
2016,4,3,11,549,494,53,-441
2016,4,3,12,591,538,52,-486
2016,4,3,13,623,579,71,-508
2016,4,3,14,609,572,82,-490
2016,4,3,15,567,544,79,-465
2016,4,3,16,536,518,81,-437
2016,4,3,17,510,493,80,-413
2016,4,3,18,493,472,81,-391
2016,4,3,19,469,455,81,-374
2016,4,3,20,460,443,80,-363
2016,4,3,21,464,445,81,-364
2016,4,3,22,473,462,97,-365
2016,4,3,23,482,469,187,-282
2016,4,4,0,504,490,187,-303
2016,4,4,1,539,518,187,-331
2016,4,4,2,527,504,186,-318
2016,4,4,3,497,471,186,-285
2016,4,4,4,459,439,117,-322
2016,4,4,5,417,418,50,-368
2016,4,4,6,408,413,51,-362
2016,4,4,7,409,418,50,-368
2016,4,4,8,419,430,50,-380
2016,4,4,9,439,457,53,-404
2016,4,4,10,491,510,122,-388
2016,4,4,11,574,576,204,-372
2016,4,4,12,617,638,371,-267
2016,4,4,13,607,619,260,-359
2016,4,4,14,580,581,145,-436
2016,4,4,15,554,549,124,-425
2016,4,4,16,532,525,126,-399
2016,4,4,17,513,504,125,-379
2016,4,4,18,506,498,124,-374
2016,4,4,19,491,490,126,-364
2016,4,4,20,488,485,125,-360
2016,4,4,21,489,494,125,-369
2016,4,4,22,492,502,126,-376
2016,4,4,23,503,511,126,-385
2016,4,5,0,514,522,126,-396
2016,4,5,1,545,543,147,-396
2016,4,5,2,523,521,151,-370
2016,4,5,3,484,477,152,-325
2016,4,5,4,439,431,150,-281
2016,4,5,5,399,395,83,-312
2016,4,5,6,387,380,49,-331
2016,4,5,7,388,374,49,-325
2016,4,5,8,395,380,49,-331
2016,4,5,9,414,397,47,-350
2016,4,5,10,468,451,118,-333
2016,4,5,11,556,536,170,-366
2016,4,5,12,606,588,169,-419
2016,4,5,13,600,599,169,-430
2016,4,5,14,588,592,170,-422
2016,4,5,15,578,573,171,-402
2016,4,5,16,563,551,168,-383
2016,4,5,17,547,532,134,-398
2016,4,5,18,538,518,119,-399
2016,4,5,19,522,502,98,-404
2016,4,5,20,520,493,51,-442
2016,4,5,21,522,493,53,-440
2016,4,5,22,529,500,111,-389
2016,4,5,23,543,515,120,-395
2016,4,6,0,562,532,120,-412
2016,4,6,1,593,574,120,-454
2016,4,6,2,580,562,121,-441
2016,4,6,3,544,525,120,-405
2016,4,6,4,498,489,118,-371
2016,4,6,5,484,470,120,-350
2016,4,6,6,483,470,121,-349
2016,4,6,7,488,473,121,-352
2016,4,6,8,502,479,120,-359
2016,4,6,9,534,503,119,-384
2016,4,6,10,594,556,154,-402
2016,4,6,11,683,643,350,-293
2016,4,6,12,727,677,400,-277
2016,4,6,13,714,661,348,-313
2016,4,6,14,680,620,188,-432
2016,4,6,15,639,591,56,-535
2016,4,6,16,601,572,53,-519
2016,4,6,17,569,541,52,-489
2016,4,6,18,549,529,53,-476
2016,4,6,19,530,516,51,-465
2016,4,6,20,523,524,52,-472
2016,4,6,21,528,528,52,-476
2016,4,6,22,532,545,53,-492
2016,4,6,23,546,554,52,-502
2016,4,7,0,557,576,61,-515
2016,4,7,1,595,605,145,-460
2016,4,7,2,578,575,151,-424
2016,4,7,3,538,528,111,-417
2016,4,7,4,491,481,78,-403
2016,4,7,5,435,448,55,-393
2016,4,7,6,423,435,52,-383
2016,4,7,7,419,431,50,-381
2016,4,7,8,422,433,51,-382
2016,4,7,9,434,448,56,-392
2016,4,7,10,482,499,110,-389
2016,4,7,11,555,570,162,-408
2016,4,7,12,591,612,163,-449
2016,4,7,13,585,599,162,-437
2016,4,7,14,576,573,162,-411
2016,4,7,15,563,561,163,-398
2016,4,7,16,546,543,162,-381
2016,4,7,17,532,524,162,-362
2016,4,7,18,520,517,163,-354
2016,4,7,19,503,505,164,-341
2016,4,7,20,497,504,106,-398
2016,4,7,21,500,511,91,-420
2016,4,7,22,509,519,95,-424
2016,4,7,23,518,530,162,-368
2016,4,8,0,536,553,163,-390
2016,4,8,1,567,582,163,-419
2016,4,8,2,550,568,163,-405
2016,4,8,3,511,529,136,-393
2016,4,8,4,470,488,52,-436
2016,4,8,5,455,442,31,-411
2016,4,8,6,446,456,49,-407
2016,4,8,7,446,450,49,-401
2016,4,8,8,453,462,50,-412
2016,4,8,9,473,472,53,-419
2016,4,8,10,517,519,66,-453
2016,4,8,11,594,592,160,-432
2016,4,8,12,632,628,162,-466
2016,4,8,13,624,626,162,-464
2016,4,8,14,609,622,158,-464
2016,4,8,15,591,599,73,-526
2016,4,8,16,570,585,52,-533
2016,4,8,17,546,564,53,-511
2016,4,8,18,531,556,52,-504
2016,4,8,19,519,530,54,-476
2016,4,8,20,510,521,54,-467
2016,4,8,21,509,514,52,-462
2016,4,8,22,516,523,54,-469
2016,4,8,23,519,541,52,-489
2016,4,9,0,533,560,54,-506
2016,4,9,1,559,588,53,-535
2016,4,9,2,547,583,53,-530
2016,4,9,3,525,557,54,-503
2016,4,9,4,494,520,51,-469
2016,4,9,5,484,498,53,-445
2016,4,9,6,476,494,53,-441
2016,4,9,7,476,494,55,-439
2016,4,9,8,485,499,56,-443
2016,4,9,9,498,505,55,-450
2016,4,9,10,524,526,55,-471
2016,4,9,11,562,553,55,-498
2016,4,9,12,603,594,56,-538
2016,4,9,13,631,620,68,-552
2016,4,9,14,638,621,71,-550
2016,4,9,15,625,618,70,-548
2016,4,9,16,602,604,65,-539
2016,4,9,17,576,580,49,-531
2016,4,9,18,552,555,51,-504
2016,4,9,19,536,531,51,-480
2016,4,9,20,525,517,51,-466
2016,4,9,21,523,514,52,-462
2016,4,9,22,531,517,52,-465
2016,4,9,23,537,525,51,-474
2016,4,10,0,550,549,66,-483
2016,4,10,1,593,596,79,-517
2016,4,10,2,589,598,81,-517
2016,4,10,3,569,573,79,-494
2016,4,10,4,546,546,74,-472
2016,4,10,5,535,535,57,-478
2016,4,10,6,534,528,55,-473
2016,4,10,7,539,530,54,-476
2016,4,10,8,553,544,57,-487
2016,4,10,9,573,556,58,-498
2016,4,10,10,599,585,116,-469
2016,4,10,11,639,606,140,-466
2016,4,10,12,676,652,195,-457
2016,4,10,13,692,671,285,-386
2016,4,10,14,662,634,299,-335
2016,4,10,15,603,585,285,-300
2016,4,10,16,563,540,87,-453
2016,4,10,17,527,513,57,-456
2016,4,10,18,504,484,56,-428
2016,4,10,19,483,467,58,-409
2016,4,10,20,468,470,53,-417
2016,4,10,21,468,477,53,-424
2016,4,10,22,478,492,52,-440
2016,4,10,23,487,496,51,-445
2016,4,11,0,507,519,51,-468
2016,4,11,1,549,551,85,-466
2016,4,11,2,537,538,118,-420
2016,4,11,3,499,500,110,-390
2016,4,11,4,464,468,67,-401
2016,4,11,5,429,435,44,-391
2016,4,11,6,420,429,44,-385
2016,4,11,7,416,434,47,-387
2016,4,11,8,424,442,48,-394
2016,4,11,9,440,461,47,-414
2016,4,11,10,490,509,92,-417
2016,4,11,11,564,586,141,-445
2016,4,11,12,600,610,154,-456
2016,4,11,13,593,596,138,-458
2016,4,11,14,574,562,122,-440
2016,4,11,15,554,540,122,-418
2016,4,11,16,533,519,121,-398
2016,4,11,17,519,507,122,-385
2016,4,11,18,513,499,123,-376
2016,4,11,19,496,483,121,-362
2016,4,11,20,490,480,122,-358
2016,4,11,21,490,486,124,-362
2016,4,11,22,497,491,122,-369
2016,4,11,23,508,506,157,-349
2016,4,12,0,514,522,182,-340
2016,4,12,1,546,533,218,-315
2016,4,12,2,522,512,176,-336
2016,4,12,3,475,462,113,-349
2016,4,12,4,427,408,79,-329
2016,4,12,5,399,374,48,-326
2016,4,12,6,385,365,55,-310
2016,4,12,7,377,360,56,-304
2016,4,12,8,377,359,55,-304
2016,4,12,9,389,371,56,-315
2016,4,12,10,428,405,89,-316
2016,4,12,11,498,478,182,-296
2016,4,12,12,533,509,181,-328
2016,4,12,13,534,520,183,-337
2016,4,12,14,528,521,156,-365
2016,4,12,15,523,524,112,-412
2016,4,12,16,516,520,111,-409
2016,4,12,17,513,512,110,-402
2016,4,12,18,508,503,91,-412
2016,4,12,19,496,494,90,-404
2016,4,12,20,495,486,89,-397
2016,4,12,21,504,487,65,-422
2016,4,12,22,516,490,85,-405
2016,4,12,23,523,496,124,-372
2016,4,13,0,535,510,122,-388
2016,4,13,1,560,536,121,-415
2016,4,13,2,538,524,100,-424
2016,4,13,3,493,476,50,-426
2016,4,13,4,447,432,52,-380
2016,4,13,5,-9999,397,43,-354
2016,4,13,6,-9999,399,52,-347
2016,4,13,7,-9999,403,51,-352
2016,4,13,8,-9999,409,51,-358
2016,4,13,9,-9999,431,51,-380
2016,4,13,10,-9999,479,52,-427
2016,4,13,11,-9999,566,74,-492
2016,4,13,12,-9999,598,150,-448
2016,4,13,13,-9999,584,152,-432
2016,4,13,14,-9999,557,132,-425
2016,4,13,15,-9999,533,81,-452
2016,4,13,16,-9999,515,80,-435
2016,4,13,17,-9999,498,79,-419
2016,4,13,18,-9999,491,81,-410
2016,4,13,19,-9999,482,60,-422
2016,4,13,20,-9999,480,50,-430
2016,4,13,21,-9999,486,52,-434
2016,4,13,22,-9999,494,98,-396
2016,4,13,23,-9999,503,122,-381
2016,4,14,0,-9999,515,123,-392
2016,4,14,1,-9999,542,121,-421
2016,4,14,2,-9999,523,122,-401
2016,4,14,3,-9999,474,123,-351
2016,4,14,4,-9999,431,97,-334
2016,4,14,5,412,397,52,-345
2016,4,14,6,401,385,51,-334
2016,4,14,7,398,386,52,-334
2016,4,14,8,401,392,51,-341
2016,4,14,9,415,410,59,-351
2016,4,14,10,460,454,158,-296
2016,4,14,11,539,534,183,-351
2016,4,14,12,572,566,182,-384
2016,4,14,13,566,557,183,-374
2016,4,14,14,556,534,144,-390
2016,4,14,15,540,526,131,-395
2016,4,14,16,527,512,129,-383
2016,4,14,17,512,499,88,-411
2016,4,14,18,504,489,60,-429
2016,4,14,19,491,480,59,-421
2016,4,14,20,486,484,60,-424
2016,4,14,21,491,486,58,-428
2016,4,14,22,496,491,59,-432
2016,4,14,23,505,496,58,-438
2016,4,15,0,519,503,60,-443
2016,4,15,1,548,531,150,-381
2016,4,15,2,535,512,143,-369
2016,4,15,3,495,465,60,-405
2016,4,15,4,450,421,52,-369
2016,4,15,5,419,389,50,-339
2016,4,15,6,409,379,52,-327
2016,4,15,7,408,376,52,-324
2016,4,15,8,411,380,52,-328
2016,4,15,9,431,394,50,-344
2016,4,15,10,478,437,51,-386
2016,4,15,11,558,523,97,-426
2016,4,15,12,589,556,177,-379
2016,4,15,13,581,557,184,-373
2016,4,15,14,560,544,184,-360
2016,4,15,15,540,525,91,-434
2016,4,15,16,521,511,76,-435
2016,4,15,17,506,495,78,-417
2016,4,15,18,493,487,77,-410
2016,4,15,19,482,476,78,-398
2016,4,15,20,479,471,77,-394
2016,4,15,21,481,476,78,-398
2016,4,15,22,485,480,78,-402
2016,4,15,23,487,479,84,-395
2016,4,16,0,495,485,75,-410
2016,4,16,1,519,508,60,-448
2016,4,16,2,510,497,53,-444
2016,4,16,3,481,472,41,-431
2016,4,16,4,440,430,0,-432
2016,4,16,5,441,406,0,-411
2016,4,16,6,432,400,0,-404
2016,4,16,7,429,397,0,-401
2016,4,16,8,437,405,0,-409
2016,4,16,9,449,416,0,-422
2016,4,16,10,474,441,57,-384
2016,4,16,11,511,481,77,-404
2016,4,16,12,545,520,136,-384
2016,4,16,13,566,540,136,-404
2016,4,16,14,560,528,137,-391
2016,4,16,15,540,512,140,-372
2016,4,16,16,515,491,87,-404
2016,4,16,17,488,473,71,-402
2016,4,16,18,471,459,69,-390
2016,4,16,19,457,450,41,-409
2016,4,16,20,451,451,0,-452
2016,4,16,21,455,454,0,-455
2016,4,16,22,454,465,0,-466
2016,4,16,23,459,468,0,-469
2016,4,17,0,468,476,42,-434
2016,4,17,1,498,492,69,-423
2016,4,17,2,496,484,71,-413
2016,4,17,3,467,455,70,-385
2016,4,17,4,432,417,65,-352
2016,4,17,5,402,392,3,-389
2016,4,17,6,389,379,0,-380
2016,4,17,7,387,381,0,-382
2016,4,17,8,395,388,0,-389
2016,4,17,9,407,398,0,-401
2016,4,17,10,434,427,0,-428
2016,4,17,11,466,461,53,-408
2016,4,17,12,505,497,115,-382
2016,4,17,13,532,534,138,-396
2016,4,17,14,522,515,135,-380
2016,4,17,15,493,487,107,-380
2016,4,17,16,469,460,15,-445
2016,4,17,17,453,453,0,-454
2016,4,17,18,447,447,0,-447
2016,4,17,19,435,438,0,-440
2016,4,17,20,432,443,0,-446
2016,4,17,21,437,454,0,-457
2016,4,17,22,445,469,0,-472
2016,4,17,23,457,480,38,-442
2016,4,18,0,468,487,67,-420
2016,4,18,1,500,513,67,-446
2016,4,18,2,486,494,58,-436
2016,4,18,3,451,446,0,-449
2016,4,18,4,411,406,16,-390
2016,4,18,5,371,371,23,-348
2016,4,18,6,358,360,41,-319
2016,4,18,7,353,362,47,-315
2016,4,18,8,355,363,47,-316
2016,4,18,9,368,384,49,-335
2016,4,18,10,404,430,80,-350
2016,4,18,11,465,517,189,-328
2016,4,18,12,517,559,204,-355
2016,4,18,13,526,550,143,-407
2016,4,18,14,524,532,73,-459
2016,4,18,15,518,521,53,-468
2016,4,18,16,511,511,54,-457
2016,4,18,17,508,510,95,-415
2016,4,18,18,504,520,160,-360
2016,4,18,19,498,519,190,-329
2016,4,18,20,503,523,173,-350
2016,4,18,21,508,536,191,-345
2016,4,18,22,516,545,192,-353
2016,4,18,23,521,552,192,-360
2016,4,19,0,525,553,193,-360
2016,4,19,1,548,564,189,-375
2016,4,19,2,528,542,192,-350
2016,4,19,3,481,485,193,-292
2016,4,19,4,427,417,167,-250
2016,4,19,5,392,390,135,-255
2016,4,19,6,376,367,102,-265
2016,4,19,7,366,361,56,-305
2016,4,19,8,367,359,56,-303
2016,4,19,9,378,370,52,-318
2016,4,19,10,412,410,64,-346
2016,4,19,11,476,483,158,-325
2016,4,19,12,525,510,179,-331
2016,4,19,13,525,511,101,-410
2016,4,19,14,523,511,53,-458
2016,4,19,15,515,514,54,-460
2016,4,19,16,513,512,53,-459
2016,4,19,17,509,505,47,-458
2016,4,19,18,514,512,75,-437
2016,4,19,19,516,512,120,-392
2016,4,19,20,517,519,124,-395
2016,4,19,21,526,522,125,-397
2016,4,19,22,533,522,124,-398
2016,4,19,23,536,522,125,-397
2016,4,20,0,538,528,126,-402
2016,4,20,1,555,551,124,-427
2016,4,20,2,535,523,124,-399
2016,4,20,3,484,469,76,-393
2016,4,20,4,430,421,54,-367
2016,4,20,5,396,387,50,-337
2016,4,20,6,377,370,52,-318
2016,4,20,7,366,358,51,-307
2016,4,20,8,367,358,51,-307
2016,4,20,9,377,366,53,-313
2016,4,20,10,409,402,53,-349
2016,4,20,11,467,469,53,-416
2016,4,20,12,505,501,53,-448
2016,4,20,13,514,510,53,-457
2016,4,20,14,518,508,52,-456
2016,4,20,15,517,510,53,-457
2016,4,20,16,515,516,52,-464
2016,4,20,17,515,516,55,-461
2016,4,20,18,511,524,67,-457
2016,4,20,19,512,528,104,-424
2016,4,20,20,515,531,132,-399
2016,4,20,21,520,547,144,-403
2016,4,20,22,524,548,150,-398
2016,4,20,23,524,549,148,-401
2016,4,21,0,526,544,148,-396
2016,4,21,1,544,558,148,-410
2016,4,21,2,523,538,134,-404
2016,4,21,3,475,486,67,-419
2016,4,21,4,422,430,58,-372
2016,4,21,5,390,391,56,-335
2016,4,21,6,372,373,56,-317
2016,4,21,7,364,364,56,-308
2016,4,21,8,363,362,51,-311
2016,4,21,9,372,368,48,-320
2016,4,21,10,404,399,50,-349
2016,4,21,11,465,471,96,-375
2016,4,21,12,503,503,121,-382
2016,4,21,13,511,509,99,-410
2016,4,21,14,511,514,54,-460
2016,4,21,15,512,518,51,-467
2016,4,21,16,509,517,54,-463
2016,4,21,17,507,522,54,-468
2016,4,21,18,500,518,52,-466
2016,4,21,19,499,523,52,-471
2016,4,21,20,503,530,75,-455
2016,4,21,21,509,533,114,-419
2016,4,21,22,512,524,174,-350
2016,4,21,23,514,527,184,-343
2016,4,22,0,521,530,187,-343
2016,4,22,1,539,547,211,-336
2016,4,22,2,517,526,196,-330
2016,4,22,3,469,476,157,-319
2016,4,22,4,421,424,107,-317
2016,4,22,5,391,395,57,-338
2016,4,22,6,373,373,59,-314
2016,4,22,7,363,366,56,-310
2016,4,22,8,361,359,56,-303
2016,4,22,9,372,371,57,-314
2016,4,22,10,400,399,56,-343
2016,4,22,11,457,462,75,-387
2016,4,22,12,497,493,91,-402
2016,4,22,13,510,505,98,-407
2016,4,22,14,511,516,137,-379
2016,4,22,15,511,524,156,-368
2016,4,22,16,510,523,155,-368
2016,4,22,17,510,522,206,-316
2016,4,22,18,507,518,198,-320
2016,4,22,19,507,510,167,-343
2016,4,22,20,510,501,137,-364
2016,4,22,21,512,483,106,-377
2016,4,22,22,511,502,121,-381
2016,4,22,23,506,507,120,-387
2016,4,23,0,503,508,120,-388
2016,4,23,1,511,516,120,-396
2016,4,23,2,496,499,121,-378
2016,4,23,3,460,465,120,-345
2016,4,23,4,411,424,81,-343
2016,4,23,5,387,390,51,-339
2016,4,23,6,368,375,51,-324
2016,4,23,7,355,363,51,-312
2016,4,23,8,351,360,51,-309
2016,4,23,9,354,365,52,-313
2016,4,23,10,365,378,50,-328
2016,4,23,11,384,405,50,-355
2016,4,23,12,418,436,52,-384
2016,4,23,13,449,469,53,-416
2016,4,23,14,469,487,54,-433
2016,4,23,15,475,481,55,-426
2016,4,23,16,469,475,56,-419
2016,4,23,17,466,472,55,-417
2016,4,23,18,459,463,72,-391
2016,4,23,19,458,464,152,-312
2016,4,23,20,461,459,155,-304
2016,4,23,21,469,465,155,-310
2016,4,23,22,478,472,157,-315
2016,4,23,23,476,476,157,-319
2016,4,24,0,475,477,161,-316
2016,4,24,1,488,492,175,-317
2016,4,24,2,479,483,185,-298
2016,4,24,3,445,451,155,-296
2016,4,24,4,402,408,149,-259
2016,4,24,5,371,379,71,-308
2016,4,24,6,352,363,51,-312
2016,4,24,7,339,356,51,-305
2016,4,24,8,337,356,50,-306
2016,4,24,9,339,362,50,-312
2016,4,24,10,347,378,49,-329
2016,4,24,11,362,410,52,-358
2016,4,24,12,398,446,51,-395
2016,4,24,13,441,483,50,-433
2016,4,24,14,454,488,52,-436
2016,4,24,15,446,468,50,-418
2016,4,24,16,439,455,52,-403
2016,4,24,17,443,448,49,-399
2016,4,24,18,439,449,52,-397
2016,4,24,19,440,444,51,-393
2016,4,24,20,444,453,52,-401
2016,4,24,21,455,468,51,-417
2016,4,24,22,471,492,74,-418
2016,4,24,23,478,498,86,-412
2016,4,25,0,484,504,102,-402
2016,4,25,1,504,514,110,-404
2016,4,25,2,489,501,118,-383
2016,4,25,3,448,458,65,-393
2016,4,25,4,404,406,60,-346
2016,4,25,5,365,369,59,-310
2016,4,25,6,350,349,56,-293
2016,4,25,7,342,344,54,-290
2016,4,25,8,342,343,55,-288
2016,4,25,9,355,352,50,-302
2016,4,25,10,388,392,50,-342
2016,4,25,11,448,463,73,-390
2016,4,25,12,490,499,115,-384
2016,4,25,13,507,502,123,-379
2016,4,25,14,513,506,124,-382
2016,4,25,15,515,515,124,-391
2016,4,25,16,515,514,113,-401
2016,4,25,17,514,519,122,-397
2016,4,25,18,519,528,142,-386
2016,4,25,19,518,534,174,-360
2016,4,25,20,519,542,221,-321
2016,4,25,21,524,550,221,-329
2016,4,25,22,533,557,220,-337
2016,4,25,23,537,563,228,-335
2016,4,26,0,538,560,249,-311
2016,4,26,1,553,568,244,-324
2016,4,26,2,535,547,199,-348
2016,4,26,3,487,493,150,-343
2016,4,26,4,432,429,76,-353
2016,4,26,5,391,390,50,-340
2016,4,26,6,368,374,52,-322
2016,4,26,7,357,363,54,-309
2016,4,26,8,356,356,53,-303
2016,4,26,9,366,365,53,-312
2016,4,26,10,398,401,54,-347
2016,4,26,11,462,463,56,-407
2016,4,26,12,492,494,55,-439
2016,4,26,13,508,504,55,-449
2016,4,26,14,512,515,56,-459
2016,4,26,15,518,526,55,-471
2016,4,26,16,519,531,56,-475
2016,4,26,17,531,535,58,-477
2016,4,26,18,537,549,91,-458
2016,4,26,19,539,560,122,-438
2016,4,26,20,543,561,186,-375
2016,4,26,21,554,581,186,-395
2016,4,26,22,561,591,186,-405
2016,4,26,23,564,588,191,-397
2016,4,27,0,565,586,193,-393
2016,4,27,1,574,596,187,-409
2016,4,27,2,555,570,143,-427
2016,4,27,3,496,515,100,-415
2016,4,27,4,441,451,56,-395
2016,4,27,5,402,412,54,-358
2016,4,27,6,380,389,54,-335
2016,4,27,7,366,379,53,-326
2016,4,27,8,363,368,53,-315
2016,4,27,9,372,380,54,-326
2016,4,27,10,405,403,53,-350
2016,4,27,11,470,474,71,-403
2016,4,27,12,498,499,68,-431
2016,4,27,13,507,506,57,-449
2016,4,27,14,514,525,56,-469
2016,4,27,15,526,540,55,-485
2016,4,27,16,529,557,56,-501
2016,4,27,17,540,566,56,-510
2016,4,27,18,549,586,72,-514
2016,4,27,19,554,595,92,-503
2016,4,27,20,557,591,134,-457
2016,4,27,21,569,603,211,-392
2016,4,27,22,571,593,213,-380
2016,4,27,23,573,585,214,-371
2016,4,28,0,570,567,205,-362
2016,4,28,1,576,580,165,-415
2016,4,28,2,558,555,166,-389
2016,4,28,3,500,514,134,-380
2016,4,28,4,444,441,54,-387
2016,4,28,5,407,407,53,-354
2016,4,28,6,387,381,53,-328
2016,4,28,7,372,377,52,-325
2016,4,28,8,367,369,54,-315
2016,4,28,9,373,376,53,-323
2016,4,28,10,403,404,53,-351
2016,4,28,11,467,472,53,-419
2016,4,28,12,496,500,52,-448
2016,4,28,13,504,515,53,-462
2016,4,28,14,514,531,55,-476
2016,4,28,15,527,547,71,-476
2016,4,28,16,530,561,94,-467
2016,4,28,17,538,578,99,-479
2016,4,28,18,548,582,129,-453
2016,4,28,19,550,600,194,-406
2016,4,28,20,548,604,239,-365
2016,4,28,21,558,616,234,-382
2016,4,28,22,558,615,219,-396
2016,4,28,23,555,606,221,-385
2016,4,29,0,558,593,228,-365
2016,4,29,1,564,597,229,-368
2016,4,29,2,548,576,228,-348
2016,4,29,3,492,517,227,-290
2016,4,29,4,439,445,146,-299
2016,4,29,5,409,412,113,-299
2016,4,29,6,384,390,61,-329
2016,4,29,7,366,376,57,-319
2016,4,29,8,362,367,53,-314
2016,4,29,9,371,373,56,-317
2016,4,29,10,399,402,56,-346
2016,4,29,11,462,462,56,-406
2016,4,29,12,488,492,59,-433
2016,4,29,13,498,498,56,-442
2016,4,29,14,508,518,57,-461
2016,4,29,15,518,524,81,-443
2016,4,29,16,521,532,130,-402
2016,4,29,17,530,540,129,-411
2016,4,29,18,540,555,133,-422
2016,4,29,19,546,565,150,-415
2016,4,29,20,549,578,176,-402
2016,4,29,21,560,587,219,-368
2016,4,29,22,557,584,250,-334
2016,4,29,23,555,573,232,-341
2016,4,30,0,540,552,216,-336
2016,4,30,1,543,557,169,-388
2016,4,30,2,529,537,96,-441
2016,4,30,3,490,493,54,-439
2016,4,30,4,432,444,53,-391
2016,4,30,5,404,400,53,-347
2016,4,30,6,377,375,52,-323
2016,4,30,7,360,361,53,-308
2016,4,30,8,355,355,53,-302
2016,4,30,9,357,354,53,-301
2016,4,30,10,365,365,53,-312
2016,4,30,11,383,380,52,-328
2016,4,30,12,408,409,53,-356
2016,4,30,13,446,448,54,-394
2016,4,30,14,473,467,51,-416
2016,4,30,15,484,483,52,-431
2016,4,30,16,482,489,52,-437
2016,4,30,17,483,492,54,-438
2016,4,30,18,482,496,51,-445
2016,4,30,19,490,506,68,-438
2016,4,30,20,493,514,124,-390
2016,4,30,21,506,526,124,-402
2016,4,30,22,516,532,125,-407
2016,4,30,23,514,523,123,-400
2016,5,1,0,509,513,125,-388
2016,5,1,1,516,513,124,-389
2016,5,1,2,508,496,123,-373
2016,5,1,3,470,461,124,-337
2016,5,1,4,421,421,74,-347
2016,5,1,5,383,381,49,-332
2016,5,1,6,360,361,50,-311
2016,5,1,7,343,350,49,-301
2016,5,1,8,337,342,49,-293
2016,5,1,9,336,342,49,-293
2016,5,1,10,342,349,49,-300
2016,5,1,11,355,372,48,-324
2016,5,1,12,382,387,50,-337
2016,5,1,13,426,436,49,-387
2016,5,1,14,459,464,48,-416
2016,5,1,15,466,481,49,-432
2016,5,1,16,468,487,49,-438
2016,5,1,17,476,504,49,-455
2016,5,1,18,483,513,48,-465
2016,5,1,19,487,524,52,-472
2016,5,1,20,493,528,51,-477
2016,5,1,21,509,536,116,-420
2016,5,1,22,517,542,212,-330
2016,5,1,23,513,538,276,-262
2016,5,2,0,511,538,295,-243
2016,5,2,1,518,547,294,-253
2016,5,2,2,507,530,286,-244
2016,5,2,3,460,481,221,-260
2016,5,2,4,415,427,106,-321
2016,5,2,5,398,391,50,-341
2016,5,2,6,377,372,52,-320
2016,5,2,7,366,357,52,-305
2016,5,2,8,362,354,52,-302
2016,5,2,9,370,362,53,-309
2016,5,2,10,403,395,51,-344
2016,5,2,11,476,456,52,-404
2016,5,2,12,498,487,52,-435
2016,5,2,13,516,504,53,-451
2016,5,2,14,540,520,51,-469
2016,5,2,15,556,537,81,-456
2016,5,2,16,568,535,107,-428
2016,5,2,17,565,571,160,-411
2016,5,2,18,574,581,222,-359
2016,5,2,19,581,582,235,-347
2016,5,2,20,590,581,251,-330
2016,5,2,21,590,592,252,-340
2016,5,2,22,593,594,250,-344
2016,5,2,23,592,595,253,-342
2016,5,3,0,584,599,251,-348
2016,5,3,1,592,590,249,-341
2016,5,3,2,570,551,239,-312
2016,5,3,3,512,497,125,-372
2016,5,3,4,451,438,53,-385
2016,5,3,5,406,398,51,-347
2016,5,3,6,382,381,52,-329
2016,5,3,7,368,369,52,-317
2016,5,3,8,365,362,51,-311
2016,5,3,9,373,373,54,-319
2016,5,3,10,405,399,51,-348
2016,5,3,11,472,470,52,-418
2016,5,3,12,498,495,52,-443
2016,5,3,13,507,511,53,-458
2016,5,3,14,516,517,67,-450
2016,5,3,15,525,530,84,-446
2016,5,3,16,529,534,99,-435
2016,5,3,17,528,542,187,-355
2016,5,3,18,529,548,195,-353
2016,5,3,19,532,541,190,-351
2016,5,3,20,545,549,195,-354
2016,5,3,21,553,554,195,-359
2016,5,3,22,556,560,195,-365
2016,5,3,23,555,552,213,-339
2016,5,4,0,547,549,218,-331
2016,5,4,1,554,551,191,-360
2016,5,4,2,534,535,146,-389
2016,5,4,3,475,480,82,-398
2016,5,4,4,424,424,51,-373
2016,5,4,5,398,389,52,-337
2016,5,4,6,381,371,61,-310
2016,5,4,7,372,359,60,-299
2016,5,4,8,370,356,62,-294
2016,5,4,9,380,364,62,-302
2016,5,4,10,414,403,61,-342
2016,5,4,11,491,468,61,-407
2016,5,4,12,517,492,60,-432
2016,5,4,13,520,504,61,-443
2016,5,4,14,522,508,61,-447
2016,5,4,15,519,509,61,-448
2016,5,4,16,518,510,67,-443
2016,5,4,17,515,500,64,-436
2016,5,4,18,515,494,108,-386
2016,5,4,19,514,490,135,-355
2016,5,4,20,516,494,134,-360
2016,5,4,21,529,498,135,-363
2016,5,4,22,533,505,135,-370
2016,5,4,23,536,515,134,-381
2016,5,5,0,531,531,134,-397
2016,5,5,1,544,540,135,-405
2016,5,5,2,534,521,114,-407
2016,5,5,3,487,474,61,-413
2016,5,5,4,436,428,62,-366
2016,5,5,5,413,399,61,-338
2016,5,5,6,399,383,60,-323
2016,5,5,7,394,378,58,-320
2016,5,5,8,396,380,54,-326
2016,5,5,9,407,393,55,-338
2016,5,5,10,451,436,54,-382
2016,5,5,11,537,512,84,-428
2016,5,5,12,569,545,115,-430
2016,5,5,13,569,549,72,-477
2016,5,5,14,573,552,65,-487
2016,5,5,15,571,542,64,-478
2016,5,5,16,564,541,65,-476
2016,5,5,17,551,528,66,-462
2016,5,5,18,550,526,122,-404
2016,5,5,19,541,514,141,-373
2016,5,5,20,541,508,133,-375
2016,5,5,21,549,518,166,-352
2016,5,5,22,556,524,160,-364
2016,5,5,23,569,541,91,-450
2016,5,6,0,578,559,66,-493
2016,5,6,1,588,581,84,-497
2016,5,6,2,574,568,113,-455
2016,5,6,3,529,525,69,-456
2016,5,6,4,480,477,50,-427
2016,5,6,5,440,453,50,-403
2016,5,6,6,425,437,50,-387
2016,5,6,7,417,429,50,-379
2016,5,6,8,417,427,50,-377
2016,5,6,9,430,436,50,-386
2016,5,6,10,468,473,60,-413
2016,5,6,11,540,541,80,-461
2016,5,6,12,563,568,81,-487
2016,5,6,13,559,560,81,-479
2016,5,6,14,557,540,163,-377
2016,5,6,15,546,446,92,-354
2016,5,6,16,534,533,81,-452
2016,5,6,17,524,525,80,-445
2016,5,6,18,514,514,82,-432
2016,5,6,19,502,500,81,-419
2016,5,6,20,500,489,80,-409
2016,5,6,21,502,486,81,-405
2016,5,6,22,501,492,81,-411
2016,5,6,23,504,495,82,-413
2016,5,7,0,508,497,85,-412
2016,5,7,1,521,518,84,-434
2016,5,7,2,518,514,85,-429
2016,5,7,3,485,487,79,-408
2016,5,7,4,443,450,53,-397
2016,5,7,5,416,420,50,-370
2016,5,7,6,397,404,51,-353
2016,5,7,7,386,400,51,-349
2016,5,7,8,384,394,50,-344
2016,5,7,9,385,401,50,-351
2016,5,7,10,400,423,51,-372
2016,5,7,11,428,455,51,-404
2016,5,7,12,458,483,50,-433
2016,5,7,13,482,505,49,-456
2016,5,7,14,497,509,50,-459
2016,5,7,15,493,497,51,-446
2016,5,7,16,484,488,51,-437
2016,5,7,17,472,478,51,-427
2016,5,7,18,465,466,50,-416
2016,5,7,19,460,456,51,-405
2016,5,7,20,469,455,50,-405
2016,5,7,21,476,464,61,-403
2016,5,7,22,484,473,117,-356
2016,5,7,23,482,478,118,-360
2016,5,8,0,480,478,116,-362
2016,5,8,1,492,491,115,-376
2016,5,8,2,495,491,79,-412
2016,5,8,3,454,461,52,-409
2016,5,8,4,411,415,49,-366
2016,5,8,5,377,377,50,-327
2016,5,8,6,354,355,53,-302
2016,5,8,7,341,343,49,-294
2016,5,8,8,337,339,51,-288
2016,5,8,9,339,338,51,-287
2016,5,8,10,345,349,51,-298
2016,5,8,11,357,362,50,-312
2016,5,8,12,387,393,50,-343
2016,5,8,13,438,437,51,-386
2016,5,8,14,464,464,50,-414
2016,5,8,15,468,469,49,-420
2016,5,8,16,469,472,51,-421
2016,5,8,17,477,479,51,-428
2016,5,8,18,484,484,51,-433
2016,5,8,19,491,485,49,-436
2016,5,8,20,499,493,50,-443
2016,5,8,21,515,507,125,-382
2016,5,8,22,530,519,151,-368
2016,5,8,23,531,527,150,-377
2016,5,9,0,524,527,152,-375
2016,5,9,1,530,534,151,-383
2016,5,9,2,518,524,76,-448
2016,5,9,3,470,479,51,-428
2016,5,9,4,421,424,50,-374
2016,5,9,5,391,382,48,-334
2016,5,9,6,368,362,49,-313
2016,5,9,7,357,349,49,-300
2016,5,9,8,351,346,48,-298
2016,5,9,9,357,356,49,-307
2016,5,9,10,388,387,47,-340
2016,5,9,11,458,450,49,-401
2016,5,9,12,486,481,48,-433
2016,5,9,13,501,496,48,-448
2016,5,9,14,522,508,54,-454
2016,5,9,15,539,518,67,-451
2016,5,9,16,551,518,62,-456
2016,5,9,17,565,521,65,-456
2016,5,9,18,582,533,147,-386
2016,5,9,19,590,531,155,-376
2016,5,9,20,606,528,150,-378
2016,5,9,21,617,536,152,-384
2016,5,9,22,623,545,152,-393
2016,5,9,23,621,550,152,-398
2016,5,10,0,607,553,152,-401
2016,5,10,1,601,564,150,-414
2016,5,10,2,580,541,151,-390
2016,5,10,3,517,492,95,-397
2016,5,10,4,454,433,51,-382
2016,5,10,5,401,400,49,-351
2016,5,10,6,376,378,50,-328
2016,5,10,7,361,366,50,-316
2016,5,10,8,358,361,51,-310
2016,5,10,9,368,368,48,-320
2016,5,10,10,399,400,51,-349
2016,5,10,11,467,464,50,-414
2016,5,10,12,492,494,51,-443
2016,5,10,13,505,500,48,-452
2016,5,10,14,515,521,53,-468
2016,5,10,15,520,529,66,-463
2016,5,10,16,537,541,66,-475
2016,5,10,17,543,552,64,-488
2016,5,10,18,555,561,132,-429
2016,5,10,19,561,567,135,-432
2016,5,10,20,568,570,134,-436
2016,5,10,21,584,577,133,-444
2016,5,10,22,589,580,134,-446
2016,5,10,23,591,588,136,-452
2016,5,11,0,584,580,134,-446
2016,5,11,1,586,581,136,-445
2016,5,11,2,573,563,127,-436
2016,5,11,3,509,506,69,-437
2016,5,11,4,453,448,67,-381
2016,5,11,5,-9999,407,61,-346
2016,5,11,6,-9999,385,57,-328
2016,5,11,7,-9999,369,55,-314
2016,5,11,8,-9999,369,57,-312
2016,5,11,9,-9999,371,57,-314
2016,5,11,10,-9999,398,56,-342
2016,5,11,11,-9999,461,55,-406
2016,5,11,12,-9999,494,57,-437
2016,5,11,13,-9999,507,56,-451
2016,5,11,14,-9999,520,56,-464
2016,5,11,15,-9999,527,56,-471
2016,5,11,16,-9999,525,53,-472
2016,5,11,17,-9999,527,57,-470
2016,5,11,18,-9999,533,132,-401
2016,5,11,19,-9999,535,148,-387
2016,5,11,20,-9999,548,152,-396
2016,5,11,21,-9999,565,196,-369
2016,5,11,22,-9999,582,227,-355
2016,5,11,23,-9999,583,226,-357
2016,5,12,0,-9999,580,227,-353
2016,5,12,1,-9999,578,148,-430
2016,5,12,2,-9999,563,120,-443
2016,5,12,3,-9999,510,82,-428
2016,5,12,4,-9999,448,57,-391
2016,5,12,5,411,405,53,-352
2016,5,12,6,385,380,52,-328
2016,5,12,7,373,370,53,-317
2016,5,12,8,365,366,53,-313
2016,5,12,9,371,370,53,-317
2016,5,12,10,399,401,53,-348
2016,5,12,11,466,462,52,-410
2016,5,12,12,493,491,53,-438
2016,5,12,13,503,506,52,-454
2016,5,12,14,521,524,55,-469
2016,5,12,15,531,539,96,-443
2016,5,12,16,553,559,138,-421
2016,5,12,17,566,571,129,-442
2016,5,12,18,589,593,171,-422
2016,5,12,19,601,587,190,-397
2016,5,12,20,613,582,190,-392
2016,5,12,21,627,581,191,-390
2016,5,12,22,623,573,202,-371
2016,5,12,23,622,580,199,-381
2016,5,13,0,606,571,185,-386
2016,5,13,1,606,568,187,-381
2016,5,13,2,591,551,157,-394
2016,5,13,3,529,499,70,-429
2016,5,13,4,471,440,51,-389
2016,5,13,5,412,403,52,-351
2016,5,13,6,388,379,52,-327
2016,5,13,7,371,368,53,-315
2016,5,13,8,363,366,52,-314
2016,5,13,9,368,369,52,-317
2016,5,13,10,395,393,43,-350
2016,5,13,11,457,458,48,-410
2016,5,13,12,484,489,48,-441
2016,5,13,13,496,498,46,-452
2016,5,13,14,513,511,49,-462
2016,5,13,15,521,519,47,-472
2016,5,13,16,524,526,47,-479
2016,5,13,17,523,519,48,-471
2016,5,13,18,523,518,47,-471
2016,5,13,19,524,525,48,-477
2016,5,13,20,528,529,47,-482
2016,5,13,21,532,540,67,-473
2016,5,13,22,539,537,150,-387
2016,5,13,23,531,533,151,-382
2016,5,14,0,520,520,152,-368
2016,5,14,1,520,510,150,-360
2016,5,14,2,511,508,109,-399
2016,5,14,3,472,468,46,-422
2016,5,14,4,419,421,47,-374
2016,5,14,5,394,383,45,-338
2016,5,14,6,374,365,47,-318
2016,5,14,7,359,352,46,-306
2016,5,14,8,355,348,45,-303
2016,5,14,9,358,354,46,-308
2016,5,14,10,366,370,47,-323
2016,5,14,11,386,388,47,-341
2016,5,14,12,422,422,48,-374
2016,5,14,13,458,453,65,-388
2016,5,14,14,477,465,85,-380
2016,5,14,15,479,470,86,-384
2016,5,14,16,480,471,88,-383
2016,5,14,17,474,473,88,-385
2016,5,14,18,469,471,86,-385
2016,5,14,19,465,472,88,-384
2016,5,14,20,469,471,86,-385
2016,5,14,21,479,479,156,-323
2016,5,14,22,483,481,231,-250
2016,5,14,23,483,485,284,-201
2016,5,15,0,479,482,272,-210
2016,5,15,1,484,474,218,-256
2016,5,15,2,486,474,164,-310
2016,5,15,3,453,440,119,-321
2016,5,15,4,410,404,52,-352
2016,5,15,5,379,371,51,-320
2016,5,15,6,363,358,52,-306
2016,5,15,7,357,348,52,-296
2016,5,15,8,357,356,53,-303
2016,5,15,9,360,358,51,-307
2016,5,15,10,381,375,51,-324
2016,5,15,11,409,401,52,-349
2016,5,15,12,450,442,51,-391
2016,5,15,13,494,482,51,-431
2016,5,15,14,504,493,52,-441
2016,5,15,15,488,480,50,-430
2016,5,15,16,474,464,52,-412
2016,5,15,17,464,456,53,-403
2016,5,15,18,463,445,51,-394
2016,5,15,19,451,434,51,-383
2016,5,15,20,451,434,53,-381
2016,5,15,21,459,440,52,-388
2016,5,15,22,467,454,52,-402
2016,5,15,23,478,462,51,-411
2016,5,16,0,485,481,52,-429
2016,5,16,1,505,497,52,-445
2016,5,16,2,504,496,51,-445
2016,5,16,3,473,458,50,-408
2016,5,16,4,433,424,53,-371
2016,5,16,5,403,372,27,-345
2016,5,16,6,392,386,52,-334
2016,5,16,7,392,384,52,-332
2016,5,16,8,399,389,52,-337
2016,5,16,9,418,407,51,-356
2016,5,16,10,466,457,54,-403
2016,5,16,11,548,530,59,-471
2016,5,16,12,582,562,90,-472
2016,5,16,13,579,554,83,-471
2016,5,16,14,569,543,71,-472
2016,5,16,15,546,526,58,-468
2016,5,16,16,541,518,54,-464
2016,5,16,17,529,504,52,-452
2016,5,16,18,525,501,52,-449
2016,5,16,19,519,495,52,-443
2016,5,16,20,515,495,51,-444
2016,5,16,21,519,497,56,-441
2016,5,16,22,522,509,84,-425
2016,5,16,23,533,518,140,-378
2016,5,17,0,535,521,157,-364
2016,5,17,1,543,535,158,-377
2016,5,17,2,535,527,158,-369
2016,5,17,3,487,475,157,-318
2016,5,17,4,433,424,92,-332
2016,5,17,5,394,387,52,-335
2016,5,17,6,376,368,50,-318
2016,5,17,7,366,360,51,-309
2016,5,17,8,363,357,50,-307
2016,5,17,9,372,371,52,-319
2016,5,17,10,404,404,50,-354
2016,5,17,11,472,469,57,-412
2016,5,17,12,505,499,59,-440
2016,5,17,13,517,512,58,-454
2016,5,17,14,520,514,76,-438
2016,5,17,15,521,524,79,-445
2016,5,17,16,529,531,79,-452
2016,5,17,17,527,522,79,-443
2016,5,17,18,532,537,139,-398
2016,5,17,19,535,507,148,-359
2016,5,17,20,547,516,189,-327
2016,5,17,21,558,520,200,-320
2016,5,17,22,559,528,200,-328
2016,5,17,23,559,526,198,-328
2016,5,18,0,557,533,200,-333
2016,5,18,1,560,534,187,-347
2016,5,18,2,550,530,115,-415
2016,5,18,3,498,478,78,-400
2016,5,18,4,442,426,91,-335
2016,5,18,5,392,392,110,-282
2016,5,18,6,372,373,107,-266
2016,5,18,7,360,362,101,-261
2016,5,18,8,356,367,108,-259
2016,5,18,9,363,373,106,-267
2016,5,18,10,396,407,108,-299
2016,5,18,11,460,463,102,-361
2016,5,18,12,490,498,106,-392
2016,5,18,13,499,508,106,-402
2016,5,18,14,508,512,106,-406
2016,5,18,15,511,516,126,-390
2016,5,18,16,521,523,144,-379
2016,5,18,17,516,531,174,-357
2016,5,18,18,521,505,184,-321
2016,5,18,19,522,541,233,-308
2016,5,18,20,535,566,273,-293
2016,5,18,21,542,568,313,-255
2016,5,18,22,546,570,311,-259
2016,5,18,23,545,567,313,-254
2016,5,19,0,541,562,317,-245
2016,5,19,1,541,564,314,-250
2016,5,19,2,530,554,293,-261
2016,5,19,3,480,508,259,-249
2016,5,19,4,427,478,206,-272
2016,5,19,5,397,414,127,-287
2016,5,19,6,374,387,102,-285
2016,5,19,7,361,377,105,-272
2016,5,19,8,358,365,102,-263
2016,5,19,9,364,379,101,-278
2016,5,19,10,395,404,101,-303
2016,5,19,11,459,469,102,-367
2016,5,19,12,487,502,105,-397
2016,5,19,13,496,509,105,-404
2016,5,19,14,506,522,104,-418
2016,5,19,15,513,533,93,-440
2016,5,19,16,519,531,50,-481
2016,5,19,17,519,528,71,-457
2016,5,19,18,519,525,116,-409
2016,5,19,19,516,519,140,-379
2016,5,19,20,521,515,143,-372
2016,5,19,21,528,520,136,-384
2016,5,19,22,529,524,114,-410
2016,5,19,23,534,530,140,-390
2016,5,20,0,533,535,146,-389
2016,5,20,1,533,540,142,-398
2016,5,20,2,524,522,64,-458
2016,5,20,3,471,479,48,-431
2016,5,20,4,422,426,49,-377
2016,5,20,5,398,394,48,-346
2016,5,20,6,379,374,49,-325
2016,5,20,7,366,365,49,-316
2016,5,20,8,364,360,49,-311
2016,5,20,9,371,368,51,-317
2016,5,20,10,402,401,49,-352
2016,5,20,11,464,467,51,-416
2016,5,20,12,497,492,49,-443
2016,5,20,13,507,511,56,-455
2016,5,20,14,510,520,127,-393
2016,5,20,15,508,526,96,-430
2016,5,20,16,508,532,97,-435
2016,5,20,17,506,517,92,-425
2016,5,20,18,495,523,97,-426
2016,5,20,19,494,512,98,-414
2016,5,20,20,500,507,96,-411
2016,5,20,21,503,521,98,-423
2016,5,20,22,508,522,97,-425
2016,5,20,23,511,518,97,-421
2016,5,21,0,505,515,94,-421
2016,5,21,1,504,517,50,-467
2016,5,21,2,503,507,52,-455
2016,5,21,3,468,472,50,-422
2016,5,21,4,427,433,52,-381
2016,5,21,5,402,399,50,-349
2016,5,21,6,381,381,50,-331
2016,5,21,7,365,369,52,-317
2016,5,21,8,359,366,50,-316
2016,5,21,9,359,367,52,-315
2016,5,21,10,370,381,51,-330
2016,5,21,11,383,401,62,-339
2016,5,21,12,415,431,73,-358
2016,5,21,13,452,461,71,-390
2016,5,21,14,471,480,119,-361
2016,5,21,15,482,487,120,-367
2016,5,21,16,485,489,124,-365
2016,5,21,17,478,489,122,-367
2016,5,21,18,478,489,126,-363
2016,5,21,19,480,488,128,-360
2016,5,21,20,491,490,133,-357
2016,5,21,21,499,484,122,-362
2016,5,21,22,506,496,127,-369
2016,5,21,23,501,493,123,-370
2016,5,22,0,495,480,78,-402
2016,5,22,1,492,495,79,-416
2016,5,22,2,495,486,79,-407
2016,5,22,3,456,455,68,-387
2016,5,22,4,410,411,49,-362
2016,5,22,5,375,375,48,-327
2016,5,22,6,352,355,50,-305
2016,5,22,7,336,347,49,-298
2016,5,22,8,330,338,48,-290
2016,5,22,9,331,343,50,-293
2016,5,22,10,336,348,49,-299
2016,5,22,11,343,372,50,-322
2016,5,22,12,375,397,61,-336
2016,5,22,13,429,441,63,-378
2016,5,22,14,450,462,64,-398
2016,5,22,15,455,459,64,-395
2016,5,22,16,458,454,66,-388
2016,5,22,17,464,458,72,-386
2016,5,22,18,466,451,73,-378
2016,5,22,19,467,450,71,-379
2016,5,22,20,473,453,74,-379
2016,5,22,21,482,459,72,-387
2016,5,22,22,491,477,71,-406
2016,5,22,23,493,483,69,-414
2016,5,23,0,492,490,69,-421
2016,5,23,1,494,494,69,-425
2016,5,23,2,489,497,70,-427
2016,5,23,3,447,453,66,-387
2016,5,23,4,402,410,50,-360
2016,5,23,5,370,380,51,-329
2016,5,23,6,352,359,49,-310
2016,5,23,7,342,357,49,-308
2016,5,23,8,339,354,49,-305
2016,5,23,9,349,369,50,-319
2016,5,23,10,380,408,50,-358
2016,5,23,11,445,473,49,-424
2016,5,23,12,483,506,51,-455
2016,5,23,13,496,504,48,-456
2016,5,23,14,503,510,49,-461
2016,5,23,15,498,506,49,-457
2016,5,23,16,519,526,49,-477
2016,5,23,17,520,518,50,-468
2016,5,23,18,527,520,51,-469
2016,5,23,19,526,495,51,-444
2016,5,23,20,532,524,121,-403
2016,5,23,21,536,528,119,-409
2016,5,23,22,539,538,119,-419
2016,5,23,23,546,545,120,-425
2016,5,24,0,544,547,121,-426
2016,5,24,1,543,548,120,-428
2016,5,24,2,532,538,119,-419
2016,5,24,3,483,486,91,-395
2016,5,24,4,429,427,49,-378
2016,5,24,5,390,388,49,-339
2016,5,24,6,372,369,45,-324
2016,5,24,7,360,362,51,-311
2016,5,24,8,356,358,48,-310
2016,5,24,9,366,371,50,-321
2016,5,24,10,398,407,50,-357
2016,5,24,11,458,465,44,-421
2016,5,24,12,491,507,50,-457
2016,5,24,13,506,509,55,-454
2016,5,24,14,514,513,52,-461
2016,5,24,15,513,516,68,-448
2016,5,24,16,530,518,115,-403
2016,5,24,17,534,523,152,-371
2016,5,24,18,543,532,201,-331
2016,5,24,19,548,540,208,-332
2016,5,24,20,558,548,177,-371
2016,5,24,21,567,570,190,-380
2016,5,24,22,574,583,221,-362
2016,5,24,23,576,590,242,-348
2016,5,25,0,572,585,237,-348
2016,5,25,1,569,579,196,-383
2016,5,25,2,555,564,159,-405
2016,5,25,3,503,507,78,-429
2016,5,25,4,448,446,51,-395
2016,5,25,5,405,402,50,-352
2016,5,25,6,382,381,49,-332
2016,5,25,7,370,370,49,-321
2016,5,25,8,366,365,49,-316
2016,5,25,9,375,372,49,-323
2016,5,25,10,407,405,49,-356
2016,5,25,11,466,464,50,-414
2016,5,25,12,499,496,68,-428
2016,5,25,13,515,507,74,-433
2016,5,25,14,528,512,74,-438
2016,5,25,15,531,520,74,-446
2016,5,25,16,558,537,74,-463
2016,5,25,17,564,638,166,-472
2016,5,25,18,576,568,217,-351
2016,5,25,19,579,582,309,-273
2016,5,25,20,593,594,346,-248
2016,5,25,21,605,607,369,-238
2016,5,25,22,615,615,368,-247
2016,5,25,23,615,610,367,-243
2016,5,26,0,603,601,368,-233
2016,5,26,1,597,605,265,-340
2016,5,26,2,584,585,142,-443
2016,5,26,3,532,530,125,-405
2016,5,26,4,473,466,101,-365
2016,5,26,5,416,423,54,-369
2016,5,26,6,393,401,55,-346
2016,5,26,7,377,381,55,-326
2016,5,26,8,371,372,53,-319
2016,5,26,9,376,383,55,-328
2016,5,26,10,408,407,53,-354
2016,5,26,11,469,475,54,-421
2016,5,26,12,501,503,54,-449
2016,5,26,13,514,517,55,-462
2016,5,26,14,530,532,83,-449
2016,5,26,15,537,556,121,-435
2016,5,26,16,566,571,161,-410
2016,5,26,17,576,594,260,-334
2016,5,26,18,594,601,356,-245
2016,5,26,19,603,590,359,-231
2016,5,26,20,617,579,370,-209
2016,5,26,21,627,593,385,-208
2016,5,26,22,627,609,404,-205
2016,5,26,23,621,605,413,-192
2016,5,27,0,610,596,412,-184
2016,5,27,1,603,594,272,-322
2016,5,27,2,587,590,171,-419
2016,5,27,3,533,530,104,-426
2016,5,27,4,473,471,55,-416
2016,5,27,5,427,420,53,-367
2016,5,27,6,400,397,56,-341
2016,5,27,7,384,377,54,-323
2016,5,27,8,375,374,54,-320
2016,5,27,9,380,377,55,-322
2016,5,27,10,408,404,53,-351
2016,5,27,11,463,455,53,-402
2016,5,27,12,495,491,56,-435
2016,5,27,13,508,511,54,-457
2016,5,27,14,527,535,54,-481
2016,5,27,15,544,561,54,-507
2016,5,27,16,561,575,135,-440
2016,5,27,17,602,593,252,-341
2016,5,27,18,597,593,252,-341
2016,5,27,19,605,592,265,-327
2016,5,27,20,623,593,298,-295
2016,5,27,21,626,597,358,-239
2016,5,27,22,623,599,359,-240
2016,5,27,23,608,596,361,-235
2016,5,28,0,585,578,299,-279
2016,5,28,1,575,567,260,-307
2016,5,28,2,564,559,197,-362
2016,5,28,3,522,522,70,-452
2016,5,28,4,466,464,51,-413
2016,5,28,5,427,418,50,-368
2016,5,28,6,400,390,51,-339
2016,5,28,7,382,375,52,-323
2016,5,28,8,372,364,50,-314
2016,5,28,9,370,362,52,-310
2016,5,28,10,379,369,50,-319
2016,5,28,11,393,379,51,-328
2016,5,28,12,424,413,52,-361
2016,5,28,13,462,453,49,-404
2016,5,28,14,494,488,51,-437
2016,5,28,15,519,509,52,-457
2016,5,28,16,534,527,122,-405
2016,5,28,17,541,536,127,-409
2016,5,28,18,547,547,126,-421
2016,5,28,19,561,557,125,-432
2016,5,28,20,574,577,141,-436
2016,5,28,21,590,595,191,-404
2016,5,28,22,598,604,209,-395
2016,5,28,23,594,590,155,-435
2016,5,29,0,574,569,134,-435
2016,5,29,1,559,560,136,-424
2016,5,29,2,555,552,134,-418
2016,5,29,3,514,512,104,-408
2016,5,29,4,458,461,63,-398
2016,5,29,5,415,418,61,-357
2016,5,29,6,387,383,60,-323
2016,5,29,7,369,368,60,-308
2016,5,29,8,359,361,60,-301
2016,5,29,9,354,359,62,-297
2016,5,29,10,357,360,58,-302
2016,5,29,11,359,374,60,-314
2016,5,29,12,388,402,61,-341
2016,5,29,13,438,440,59,-381
2016,5,29,14,472,470,60,-410
2016,5,29,15,488,485,59,-426
2016,5,29,16,499,486,118,-368
2016,5,29,17,514,494,132,-362
2016,5,29,18,529,504,133,-371
2016,5,29,19,537,508,131,-377
2016,5,29,20,546,513,131,-382
2016,5,29,21,561,515,131,-384
2016,5,29,22,572,520,132,-388
2016,5,29,23,569,519,75,-444
2016,5,30,0,562,514,55,-459
2016,5,30,1,553,511,54,-457
2016,5,30,2,545,516,55,-461
2016,5,30,3,500,479,55,-424
2016,5,30,4,446,434,51,-383
2016,5,30,5,390,397,52,-345
2016,5,30,6,366,367,50,-317
2016,5,30,7,352,354,49,-305
2016,5,30,8,346,350,50,-300
2016,5,30,9,347,348,49,-299
2016,5,30,10,363,364,49,-315
2016,5,30,11,382,377,50,-327
2016,5,30,12,411,401,49,-352
2016,5,30,13,446,441,52,-389
2016,5,30,14,489,476,51,-425
2016,5,30,15,516,512,56,-456
2016,5,30,16,531,539,56,-483
2016,5,30,17,548,557,55,-502
2016,5,30,18,571,572,56,-516
2016,5,30,19,581,589,78,-511
2016,5,30,20,600,602,92,-510
2016,5,30,21,621,613,118,-495
2016,5,30,22,633,634,154,-480
2016,5,30,23,631,635,155,-480
2016,5,31,0,612,615,141,-474
2016,5,31,1,594,600,129,-471
2016,5,31,2,585,584,129,-455
2016,5,31,3,534,528,98,-430
2016,5,31,4,475,467,50,-417
2016,5,31,5,434,423,53,-370
2016,5,31,6,407,394,53,-341
2016,5,31,7,390,377,53,-324
2016,5,31,8,381,374,54,-320
2016,5,31,9,387,377,52,-325
2016,5,31,10,415,406,54,-352
2016,5,31,11,467,464,53,-411
2016,5,31,12,504,500,53,-447
2016,5,31,13,524,525,53,-472
2016,5,31,14,544,525,37,-488
2016,5,31,15,567,580,245,-335
2016,5,31,16,584,609,352,-257
2016,5,31,17,603,634,413,-221
2016,5,31,18,627,650,416,-234
2016,5,31,19,635,642,420,-222
2016,5,31,20,656,627,420,-207
2016,5,31,21,671,624,420,-204
2016,5,31,22,678,618,377,-241
2016,5,31,23,673,615,312,-303
2016,6,1,0,653,604,295,-309
2016,6,1,1,636,603,298,-305
2016,6,1,2,619,596,286,-310
2016,6,1,3,558,539,131,-408
2016,6,1,4,493,479,65,-414
2016,6,1,5,434,431,50,-381
2016,6,1,6,406,406,51,-355
2016,6,1,7,389,389,51,-338
2016,6,1,8,384,384,51,-333
2016,6,1,9,388,387,52,-335
2016,6,1,10,415,414,50,-364
2016,6,1,11,472,468,51,-417
2016,6,1,12,506,500,51,-449
2016,6,1,13,522,526,75,-451
2016,6,1,14,545,552,80,-472
2016,6,1,15,568,582,119,-463
2016,6,1,16,591,606,243,-363
2016,6,1,17,610,628,414,-214
2016,6,1,18,620,656,456,-200
2016,6,1,19,633,653,474,-179
2016,6,1,20,642,661,501,-160
2016,6,1,21,649,669,479,-190
2016,6,1,22,648,679,486,-193
2016,6,1,23,636,677,476,-201
2016,6,2,0,620,646,389,-257
2016,6,2,1,607,636,270,-366
2016,6,2,2,596,605,123,-482
2016,6,2,3,543,563,73,-490
2016,6,2,4,488,502,51,-451
2016,6,2,5,446,453,52,-401
2016,6,2,6,415,423,49,-374
2016,6,2,7,397,404,51,-353
2016,6,2,8,391,395,51,-344
2016,6,2,9,394,398,51,-347
2016,6,2,10,422,427,51,-376
2016,6,2,11,475,481,51,-430
2016,6,2,12,511,515,67,-448
2016,6,2,13,531,535,76,-459
2016,6,2,14,553,551,75,-476
2016,6,2,15,582,575,90,-485
2016,6,2,16,609,596,148,-448
2016,6,2,17,627,656,217,-439
2016,6,2,18,644,575,200,-375
2016,6,2,19,661,627,281,-346
2016,6,2,20,668,647,306,-341
2016,6,2,21,673,651,302,-349
2016,6,2,22,665,638,336,-302
2016,6,2,23,652,618,295,-323
2016,6,3,0,636,598,147,-451
2016,6,3,1,626,593,120,-473
2016,6,3,2,613,583,89,-494
2016,6,3,3,558,533,52,-481
2016,6,3,4,502,475,50,-425
2016,6,3,5,454,437,50,-387
2016,6,3,6,421,412,50,-362
2016,6,3,7,402,395,50,-345
2016,6,3,8,393,388,50,-338
2016,6,3,9,397,394,51,-343
2016,6,3,10,421,420,50,-370
2016,6,3,11,471,475,51,-424
2016,6,3,12,506,511,51,-460
2016,6,3,13,529,525,50,-475
2016,6,3,14,557,549,54,-495
2016,6,3,15,585,570,89,-481
2016,6,3,16,607,600,120,-480
2016,6,3,17,645,625,148,-477
2016,6,3,18,660,654,210,-444
2016,6,3,19,671,669,330,-339
2016,6,3,20,677,671,335,-336
2016,6,3,21,684,669,332,-337
2016,6,3,22,682,667,315,-352
2016,6,3,23,674,640,227,-413
2016,6,4,0,643,617,139,-478
2016,6,4,1,624,604,124,-480
2016,6,4,2,607,599,125,-474
2016,6,4,3,569,556,123,-433
2016,6,4,4,510,502,84,-418
2016,6,4,5,459,446,57,-389
2016,6,4,6,425,420,52,-368
2016,6,4,7,404,392,48,-344
2016,6,4,8,394,386,49,-337
2016,6,4,9,390,383,50,-333
2016,6,4,10,402,390,49,-341
2016,6,4,11,412,403,50,-353
2016,6,4,12,444,437,49,-388
2016,6,4,13,484,476,49,-427
2016,6,4,14,524,517,50,-467
2016,6,4,15,554,554,59,-495
2016,6,4,16,581,597,164,-433
2016,6,4,17,607,620,262,-358
2016,6,4,18,627,646,385,-261
2016,6,4,19,649,639,354,-285
2016,6,4,20,668,641,357,-284
2016,6,4,21,680,622,349,-273
2016,6,4,22,683,637,354,-283
2016,6,4,23,675,619,305,-314
2016,6,5,0,647,613,286,-327
2016,6,5,1,622,590,247,-343
2016,6,5,2,611,577,78,-499
2016,6,5,3,566,536,53,-483
2016,6,5,4,506,479,49,-430
2016,6,5,5,455,439,51,-388
2016,6,5,6,419,411,51,-360
2016,6,5,7,395,396,51,-345
2016,6,5,8,383,382,50,-332
2016,6,5,9,376,380,49,-331
2016,6,5,10,379,388,51,-337
2016,6,5,11,385,394,50,-344
2016,6,5,12,415,426,50,-376
2016,6,5,13,463,474,51,-423
2016,6,5,14,502,508,50,-458
2016,6,5,15,519,529,49,-480
2016,6,5,16,533,549,52,-497
2016,6,5,17,562,563,64,-499
2016,6,5,18,577,562,81,-481
2016,6,5,19,585,547,84,-463
2016,6,5,20,595,543,245,-298
2016,6,5,21,604,556,180,-376
2016,6,5,22,610,569,129,-440
2016,6,5,23,605,583,129,-454
2016,6,6,0,590,577,130,-447
2016,6,6,1,576,573,131,-442
2016,6,6,2,563,561,128,-433
2016,6,6,3,520,519,128,-391
2016,6,6,4,463,469,88,-381
2016,6,6,5,417,429,57,-372
2016,6,6,6,391,399,54,-345
2016,6,6,7,377,390,55,-335
2016,6,6,8,370,379,53,-326
2016,6,6,9,376,387,54,-333
2016,6,6,10,407,421,55,-366
2016,6,6,11,461,473,54,-419
2016,6,6,12,497,511,54,-457
2016,6,6,13,519,534,65,-469
2016,6,6,14,543,550,85,-465
2016,6,6,15,572,576,135,-441
2016,6,6,16,593,600,148,-452
2016,6,6,17,617,531,141,-390
2016,6,6,18,635,551,141,-410
2016,6,6,19,649,544,137,-407
2016,6,6,20,658,536,140,-396
2016,6,6,21,669,540,139,-401
2016,6,6,22,670,542,140,-402
2016,6,6,23,665,541,140,-401
2016,6,7,0,646,537,139,-398
2016,6,7,1,625,575,141,-434
2016,6,7,2,608,596,125,-471
2016,6,7,3,550,541,60,-481
2016,6,7,4,486,479,48,-431
2016,6,7,5,440,432,49,-383
2016,6,7,6,409,404,51,-353
2016,6,7,7,392,388,50,-338
2016,6,7,8,384,380,49,-331
2016,6,7,9,387,385,50,-335
2016,6,7,10,414,414,50,-364
2016,6,7,11,467,465,49,-416
2016,6,7,12,501,504,49,-455
2016,6,7,13,519,527,54,-473
2016,6,7,14,538,548,54,-494
2016,6,7,15,562,573,73,-500
2016,6,7,16,581,588,177,-411
2016,6,7,17,601,602,208,-394
2016,6,7,18,612,614,236,-378
2016,6,7,19,628,621,279,-342
2016,6,7,20,646,627,373,-254
2016,6,7,21,660,646,387,-259
2016,6,7,22,663,651,416,-235
2016,6,7,23,656,646,424,-222
2016,6,8,0,634,629,407,-222
2016,6,8,1,615,604,257,-347
2016,6,8,2,597,595,147,-448
2016,6,8,3,541,538,98,-440
2016,6,8,4,482,473,49,-424
2016,6,8,5,437,424,49,-375
2016,6,8,6,406,397,50,-347
2016,6,8,7,389,377,47,-330
2016,6,8,8,379,378,49,-329
2016,6,8,9,382,375,48,-327
2016,6,8,10,408,399,49,-350
2016,6,8,11,460,456,48,-408
2016,6,8,12,492,487,47,-440
2016,6,8,13,508,507,49,-458
2016,6,8,14,521,520,50,-470
2016,6,8,15,537,529,48,-481
2016,6,8,16,548,533,88,-445
2016,6,8,17,568,540,123,-417
2016,6,8,18,556,546,121,-425
2016,6,8,19,570,562,137,-425
2016,6,8,20,574,576,156,-420
2016,6,8,21,582,591,179,-412
2016,6,8,22,588,602,189,-413
2016,6,8,23,582,600,134,-466
2016,6,9,0,565,589,119,-470
2016,6,9,1,563,569,88,-481
2016,6,9,2,557,561,60,-501
2016,6,9,3,508,512,53,-459
2016,6,9,4,452,453,51,-402
2016,6,9,5,414,403,51,-352
2016,6,9,6,389,376,51,-325
2016,6,9,7,375,364,52,-312
2016,6,9,8,371,362,51,-311
2016,6,9,9,376,367,51,-316
2016,6,9,10,405,390,51,-339
2016,6,9,11,459,434,50,-384
2016,6,9,12,490,479,52,-427
2016,6,9,13,513,491,50,-441
2016,6,9,14,522,509,52,-457
2016,6,9,15,535,525,51,-474
2016,6,9,16,544,538,99,-439
2016,6,9,17,561,547,119,-428
2016,6,9,18,557,561,145,-416
2016,6,9,19,567,588,210,-378
2016,6,9,20,574,606,209,-397
2016,6,9,21,585,629,187,-442
2016,6,9,22,595,634,180,-454
2016,6,9,23,591,631,134,-497
2016,6,10,0,584,608,113,-495
2016,6,10,1,580,584,111,-473
2016,6,10,2,572,575,86,-489
2016,6,10,3,523,525,60,-465
2016,6,10,4,466,469,60,-409
2016,6,10,5,421,417,53,-364
2016,6,10,6,393,392,0,-404
2016,6,10,7,378,379,0,-390
2016,6,10,8,373,370,0,-382
2016,6,10,9,376,376,0,-388
2016,6,10,10,401,396,0,-408
2016,6,10,11,450,436,48,-388
2016,6,10,12,482,478,61,-417
2016,6,10,13,507,500,68,-432
2016,6,10,14,530,525,71,-454
2016,6,10,15,552,542,76,-466
2016,6,10,16,572,560,94,-466
2016,6,10,17,592,580,114,-466
2016,6,10,18,599,602,120,-482
2016,6,10,19,617,626,125,-501
2016,6,10,20,638,642,140,-502
2016,6,10,21,650,674,213,-461
2016,6,10,22,653,689,218,-471
2016,6,10,23,641,680,259,-421
2016,6,11,0,618,656,176,-480
2016,6,11,1,597,626,151,-475
2016,6,11,2,590,605,137,-468
2016,6,11,3,551,562,76,-486
2016,6,11,4,492,500,70,-430
2016,6,11,5,446,448,63,-385
2016,6,11,6,414,416,48,-368
2016,6,11,7,395,391,47,-344
2016,6,11,8,385,381,46,-335
2016,6,11,9,383,377,46,-331
2016,6,11,10,394,385,49,-336
2016,6,11,11,408,396,68,-328
2016,6,11,12,437,429,96,-333
2016,6,11,13,476,468,125,-343
2016,6,11,14,517,513,135,-378
2016,6,11,15,545,587,186,-401
2016,6,11,16,571,583,192,-391
2016,6,11,17,595,615,263,-352
2016,6,11,18,607,645,318,-327
2016,6,11,19,625,669,329,-340
2016,6,11,20,641,693,334,-359
2016,6,11,21,651,710,344,-366
2016,6,11,22,659,717,439,-278
2016,6,11,23,655,682,372,-310
2016,6,12,0,634,691,373,-318
2016,6,12,1,612,662,372,-290
2016,6,12,2,600,639,372,-267
2016,6,12,3,562,591,373,-218
2016,6,12,4,502,529,273,-256
2016,6,12,5,458,471,119,-352
2016,6,12,6,423,435,111,-324
2016,6,12,7,402,405,108,-297
2016,6,12,8,389,390,108,-282
2016,6,12,9,383,385,108,-277
2016,6,12,10,386,389,110,-279
2016,6,12,11,395,393,108,-285
2016,6,12,12,424,427,109,-318
2016,6,12,13,477,477,108,-369
2016,6,12,14,520,526,107,-419
2016,6,12,15,553,557,198,-359
2016,6,12,16,581,587,254,-333
2016,6,12,17,608,622,259,-363
2016,6,12,18,631,645,258,-387
2016,6,12,19,645,663,257,-406
2016,6,12,20,662,678,263,-415
2016,6,12,21,674,701,325,-376
2016,6,12,22,689,712,326,-386
2016,6,12,23,684,677,252,-425
2016,6,13,0,665,677,252,-425
2016,6,13,1,640,652,252,-400
2016,6,13,2,625,640,253,-387
2016,6,13,3,579,584,247,-337
2016,6,13,4,518,528,176,-352
2016,6,13,5,458,471,105,-366
2016,6,13,6,423,440,106,-334
2016,6,13,7,403,418,106,-312
2016,6,13,8,393,407,95,-312
2016,6,13,9,395,413,93,-320
2016,6,13,10,417,439,95,-344
2016,6,13,11,456,474,93,-381
2016,6,13,12,502,520,94,-426
2016,6,13,13,539,562,96,-466
2016,6,13,14,572,596,111,-485
2016,6,13,15,617,635,141,-494
2016,6,13,16,645,680,184,-496
2016,6,13,17,679,709,213,-496
2016,6,13,18,700,735,228,-507
2016,6,13,19,721,754,245,-509
2016,6,13,20,729,770,264,-506
2016,6,13,21,734,785,278,-507
2016,6,13,22,734,766,259,-507
2016,6,13,23,724,779,314,-465
2016,6,14,0,702,758,381,-377
2016,6,14,1,672,721,326,-395
2016,6,14,2,648,692,254,-438
2016,6,14,3,593,629,161,-468
2016,6,14,4,524,552,112,-440
2016,6,14,5,482,495,112,-383
2016,6,14,6,446,448,109,-339
2016,6,14,7,422,425,104,-321
2016,6,14,8,412,416,105,-311
2016,6,14,9,411,417,105,-312
2016,6,14,10,434,438,105,-333
2016,6,14,11,471,469,100,-369
2016,6,14,12,514,516,104,-412
2016,6,14,13,546,549,103,-446
2016,6,14,14,574,588,104,-484
2016,6,14,15,612,629,166,-463
2016,6,14,16,638,677,293,-384
2016,6,14,17,686,714,402,-312
2016,6,14,18,698,755,415,-340
2016,6,14,19,723,769,405,-364
2016,6,14,20,738,770,450,-320
2016,6,14,21,750,789,569,-220
2016,6,14,22,751,790,573,-217
2016,6,14,23,743,759,530,-229
2016,6,15,0,720,730,511,-219
2016,6,15,1,691,704,515,-189
2016,6,15,2,672,672,366,-306
2016,6,15,3,610,611,259,-352
2016,6,15,4,541,545,172,-373
2016,6,15,5,485,490,110,-380
2016,6,15,6,452,459,108,-351
2016,6,15,7,430,439,100,-339
2016,6,15,8,420,430,100,-330
2016,6,15,9,420,434,101,-333
2016,6,15,10,443,450,99,-351
2016,6,15,11,481,492,101,-391
2016,6,15,12,524,531,103,-428
2016,6,15,13,558,565,101,-464
2016,6,15,14,592,600,110,-490
2016,6,15,15,629,639,144,-495
2016,6,15,16,657,677,223,-454
2016,6,15,17,690,701,251,-450
2016,6,15,18,700,717,252,-465
2016,6,15,19,721,727,428,-299
2016,6,15,20,725,750,597,-153
2016,6,15,21,733,748,556,-192
2016,6,15,22,733,765,543,-222
2016,6,15,23,727,760,496,-264
2016,6,16,0,698,740,474,-266
2016,6,16,1,675,710,461,-249
2016,6,16,2,657,694,282,-412
2016,6,16,3,605,639,176,-463
2016,6,16,4,539,569,118,-451
2016,6,16,5,494,509,104,-405
2016,6,16,6,459,474,106,-368
2016,6,16,7,435,449,106,-343
2016,6,16,8,424,432,106,-326
2016,6,16,9,423,442,106,-336
2016,6,16,10,444,472,104,-368
2016,6,16,11,483,503,142,-361
2016,6,16,12,526,550,151,-399
2016,6,16,13,561,589,152,-437
2016,6,16,14,599,627,152,-475
2016,6,16,15,638,660,164,-496
2016,6,16,16,667,690,230,-460
2016,6,16,17,702,705,326,-381
2016,6,16,18,723,740,395,-348
2016,6,16,19,745,763,406,-359
2016,6,16,20,753,783,438,-348
2016,6,16,21,766,785,437,-350
2016,6,16,22,770,807,445,-365
2016,6,16,23,765,796,443,-356
2016,6,17,0,735,770,371,-402
2016,6,17,1,708,729,237,-495
2016,6,17,2,685,708,235,-475
2016,6,17,3,627,649,230,-419
2016,6,17,4,556,582,149,-433
2016,6,17,5,502,528,62,-466
2016,6,17,6,463,499,64,-435
2016,6,17,7,435,480,63,-417
2016,6,17,8,422,470,64,-406
2016,6,17,9,420,471,64,-407
2016,6,17,10,435,493,65,-428
2016,6,17,11,470,522,66,-456
2016,6,17,12,508,565,69,-496
2016,6,17,13,538,597,94,-503
2016,6,17,14,564,627,135,-492
2016,6,17,15,590,660,157,-503
2016,6,17,16,610,683,179,-504
2016,6,17,17,634,689,185,-504
2016,6,17,18,655,698,182,-516
2016,6,17,19,666,699,182,-517
2016,6,17,20,681,697,182,-515
2016,6,17,21,681,712,196,-516
2016,6,17,22,680,710,195,-515
2016,6,17,23,665,702,184,-518
2016,6,18,0,637,679,164,-515
2016,6,18,1,610,655,148,-507
2016,6,18,2,604,637,147,-490
2016,6,18,3,564,587,102,-485
2016,6,18,4,502,522,74,-448
2016,6,18,5,466,473,70,-403
2016,6,18,6,430,437,63,-374
2016,6,18,7,407,415,64,-351
2016,6,18,8,392,404,66,-338
2016,6,18,9,388,400,66,-334
2016,6,18,10,396,406,66,-340
2016,6,18,11,401,422,66,-356
2016,6,18,12,428,441,66,-375
2016,6,18,13,463,484,66,-418
2016,6,18,14,490,517,65,-452
2016,6,18,15,517,543,68,-475
2016,6,18,16,523,556,125,-431
2016,6,18,17,551,564,139,-425
2016,6,18,18,559,575,137,-438
2016,6,18,19,568,588,139,-449
2016,6,18,20,572,602,140,-462
2016,6,18,21,582,614,138,-476
2016,6,18,22,579,619,139,-480
2016,6,18,23,588,609,101,-508
2016,6,19,0,568,599,83,-516
2016,6,19,1,542,573,66,-507
2016,6,19,2,540,567,70,-497
2016,6,19,3,502,527,66,-461
2016,6,19,4,448,474,66,-408
2016,6,19,5,413,426,67,-359
2016,6,19,6,383,395,65,-330
2016,6,19,7,362,375,66,-309
2016,6,19,8,354,364,65,-299
2016,6,19,9,351,358,65,-293
2016,6,19,10,352,363,64,-299
2016,6,19,11,354,372,64,-308
2016,6,19,12,384,400,62,-338
2016,6,19,13,435,444,70,-374
2016,6,19,14,462,475,96,-379
2016,6,19,15,477,485,113,-372
2016,6,19,16,487,498,116,-382
2016,6,19,17,505,510,116,-394
2016,6,19,18,517,531,120,-411
2016,6,19,19,526,539,117,-422
2016,6,19,20,532,567,146,-421
2016,6,19,21,548,583,206,-377
2016,6,19,22,563,599,234,-365
2016,6,19,23,561,593,182,-411
2016,6,20,0,554,581,82,-499
2016,6,20,1,540,563,49,-514
2016,6,20,2,534,553,47,-506
2016,6,20,3,496,511,47,-464
2016,6,20,4,446,458,45,-413
2016,6,20,5,406,411,41,-370
2016,6,20,6,381,385,42,-343
2016,6,20,7,364,368,43,-325
2016,6,20,8,359,362,43,-319
2016,6,20,9,365,366,42,-324
2016,6,20,10,389,395,44,-351
2016,6,20,11,430,429,41,-388
2016,6,20,12,471,472,45,-427
2016,6,20,13,503,504,50,-454
2016,6,20,14,525,527,47,-480
2016,6,20,15,554,553,60,-493
2016,6,20,16,576,573,69,-504
2016,6,20,17,596,591,89,-502
2016,6,20,18,612,620,114,-506
2016,6,20,19,637,645,132,-513
2016,6,20,20,650,672,175,-497
2016,6,20,21,663,698,186,-512
2016,6,20,22,667,709,186,-523
2016,6,20,23,668,715,195,-520
2016,6,21,0,652,691,200,-491
2016,6,21,1,628,659,173,-486
2016,6,21,2,616,642,173,-469
2016,6,21,3,565,579,164,-415
2016,6,21,4,504,511,93,-418
2016,6,21,5,445,462,95,-367
2016,6,21,6,416,429,104,-325
2016,6,21,7,399,406,97,-309
2016,6,21,8,390,399,100,-299
2016,6,21,9,394,399,99,-300
2016,6,21,10,417,420,99,-321
2016,6,21,11,457,460,100,-360
2016,6,21,12,500,497,98,-399
2016,6,21,13,530,532,100,-432
2016,6,21,14,557,554,98,-456
2016,6,21,15,584,596,143,-453
2016,6,21,16,606,635,217,-418
2016,6,21,17,625,667,238,-429
2016,6,21,18,642,692,241,-451
2016,6,21,19,657,728,241,-487
2016,6,21,20,674,749,240,-509
2016,6,21,21,688,758,242,-516
2016,6,21,22,693,745,268,-477
2016,6,21,23,690,723,262,-461
2016,6,22,0,671,706,241,-465
2016,6,22,1,653,682,239,-443
2016,6,22,2,637,653,174,-479
2016,6,22,3,585,601,133,-468
2016,6,22,4,523,542,99,-443
2016,6,22,5,484,488,100,-388
2016,6,22,6,450,454,99,-355
2016,6,22,7,428,438,100,-338
2016,6,22,8,420,423,97,-326
2016,6,22,9,420,429,100,-329
2016,6,22,10,442,450,99,-351
2016,6,22,11,480,489,100,-389
2016,6,22,12,521,531,97,-434
2016,6,22,13,556,579,102,-477
2016,6,22,14,591,626,130,-496
2016,6,22,15,627,671,171,-500
2016,6,22,16,662,687,215,-472
2016,6,22,17,684,748,239,-509
2016,6,22,18,712,756,370,-386
2016,6,22,19,737,766,518,-248
2016,6,22,20,755,789,572,-217
2016,6,22,21,766,787,580,-207
2016,6,22,22,773,794,593,-201
2016,6,22,23,764,834,542,-292
2016,6,23,0,736,782,523,-259
2016,6,23,1,705,748,452,-296
2016,6,23,2,686,723,412,-311
2016,6,23,3,629,661,306,-355
2016,6,23,4,561,582,302,-280
2016,6,23,5,511,527,270,-257
2016,6,23,6,475,488,147,-341
2016,6,23,7,452,463,109,-354
2016,6,23,8,443,447,109,-338
2016,6,23,9,441,448,109,-339
2016,6,23,10,462,465,107,-358
2016,6,23,11,502,504,110,-394
2016,6,23,12,543,545,105,-440
2016,6,23,13,582,591,103,-492
2016,6,23,14,622,637,142,-498
2016,6,23,15,662,687,190,-501
2016,6,23,16,693,724,267,-461
2016,6,23,17,723,747,300,-450
2016,6,23,18,757,777,424,-357
2016,6,23,19,787,798,448,-354
2016,6,23,20,809,804,530,-277
2016,6,23,21,818,807,572,-239
2016,6,23,22,824,817,578,-243
2016,6,23,23,814,814,548,-270
2016,6,24,0,789,788,520,-271
2016,6,24,1,754,752,505,-251
2016,6,24,2,733,728,471,-261
2016,6,24,3,667,673,346,-330
2016,6,24,4,597,599,295,-308
2016,6,24,5,529,539,184,-355
2016,6,24,6,490,495,107,-388
2016,6,24,7,465,474,106,-368
2016,6,24,8,451,452,107,-345
2016,6,24,9,450,448,104,-344
2016,6,24,10,467,470,106,-364
2016,6,24,11,501,501,105,-396
2016,6,24,12,543,536,120,-416
2016,6,24,13,587,570,146,-424
2016,6,24,14,635,598,163,-435
2016,6,24,15,677,633,207,-426
2016,6,24,16,708,671,248,-423
2016,6,24,17,752,693,247,-446
2016,6,24,18,777,709,247,-462
2016,6,24,19,797,734,253,-481
2016,6,24,20,813,755,323,-432
2016,6,24,21,811,756,318,-438
2016,6,24,22,817,763,302,-461
2016,6,24,23,811,754,303,-451
2016,6,25,0,764,727,302,-425
2016,6,25,1,719,694,278,-416
2016,6,25,2,706,680,254,-426
2016,6,25,3,651,630,171,-459
2016,6,25,4,579,561,137,-424
2016,6,25,5,513,500,136,-364
2016,6,25,6,473,460,106,-354
2016,6,25,7,445,434,104,-330
2016,6,25,8,430,418,103,-315
2016,6,25,9,422,416,103,-313
2016,6,25,10,426,417,100,-317
2016,6,25,11,435,431,103,-328
2016,6,25,12,465,463,112,-351
2016,6,25,13,507,505,123,-382
2016,6,25,14,555,554,121,-433
2016,6,25,15,602,602,122,-480
2016,6,25,16,639,642,172,-470
2016,6,25,17,668,667,193,-474
2016,6,25,18,685,690,193,-497
2016,6,25,19,702,708,197,-511
2016,6,25,20,712,728,217,-511
2016,6,25,21,723,751,239,-512
2016,6,25,22,726,762,253,-509
2016,6,25,23,714,747,237,-510
2016,6,26,0,686,729,217,-512
2016,6,26,1,658,695,186,-509
2016,6,26,2,644,680,184,-496
2016,6,26,3,599,632,174,-458
2016,6,26,4,537,564,160,-404
2016,6,26,5,482,509,143,-366
2016,6,26,6,446,466,142,-324
2016,6,26,7,424,438,88,-350
2016,6,26,8,410,427,49,-378
2016,6,26,9,403,417,80,-337
2016,6,26,10,406,420,104,-316
2016,6,26,11,414,433,106,-327
2016,6,26,12,443,454,104,-350
2016,6,26,13,496,504,105,-399
2016,6,26,14,542,541,104,-437
2016,6,26,15,576,571,123,-448
2016,6,26,16,606,603,229,-374
2016,6,26,17,644,642,263,-379
2016,6,26,18,665,670,262,-408
2016,6,26,19,678,700,263,-437
2016,6,26,20,692,721,261,-460
2016,6,26,21,703,742,280,-462
2016,6,26,22,710,758,313,-445
2016,6,26,23,705,748,311,-437
2016,6,27,0,684,730,313,-417
2016,6,27,1,656,702,285,-417
2016,6,27,2,640,685,239,-446
2016,6,27,3,592,630,156,-474
2016,6,27,4,531,567,107,-460
2016,6,27,5,481,512,106,-406
2016,6,27,6,447,473,104,-369
2016,6,27,7,425,454,104,-350
2016,6,27,8,414,442,102,-340
2016,6,27,9,415,445,100,-345
2016,6,27,10,435,464,117,-347
2016,6,27,11,470,500,142,-358
2016,6,27,12,516,542,107,-435
2016,6,27,13,554,583,108,-475
2016,6,27,14,591,626,126,-500
2016,6,27,15,635,663,161,-502
2016,6,27,16,671,708,210,-498
2016,6,27,17,697,728,229,-499
2016,6,27,18,727,701,195,-506
2016,6,27,19,750,678,204,-474
2016,6,27,20,758,671,250,-421
2016,6,27,21,769,706,265,-441
2016,6,27,22,772,703,221,-482
2016,6,27,23,767,699,197,-502
2016,6,28,0,742,676,189,-487
2016,6,28,1,709,649,145,-504
2016,6,28,2,686,649,133,-516
2016,6,28,3,627,593,121,-472
2016,6,28,4,558,534,111,-423
2016,6,28,5,489,479,117,-362
2016,6,28,6,455,452,98,-354
2016,6,28,7,431,434,99,-335
2016,6,28,8,420,425,98,-327
2016,6,28,9,419,429,97,-332
2016,6,28,10,441,454,96,-358
2016,6,28,11,477,506,100,-406
2016,6,28,12,519,545,97,-448
2016,6,28,13,552,565,98,-467
2016,6,28,14,576,589,101,-488
2016,6,28,15,601,605,113,-492
2016,6,28,16,623,614,158,-456
2016,6,28,17,643,625,183,-442
2016,6,28,18,666,658,181,-477
2016,6,28,19,684,688,184,-504
2016,6,28,20,693,713,206,-507
2016,6,28,21,703,737,226,-511
2016,6,28,22,704,744,233,-511
2016,6,28,23,701,738,244,-494
2016,6,29,0,673,725,277,-448
2016,6,29,1,649,687,274,-413
2016,6,29,2,633,666,271,-395
2016,6,29,3,577,603,231,-372
2016,6,29,4,513,532,162,-370
2016,6,29,5,475,475,116,-359
2016,6,29,6,442,442,109,-333
2016,6,29,7,420,413,102,-311
2016,6,29,8,410,401,101,-300
2016,6,29,9,413,408,102,-306
2016,6,29,10,436,429,102,-327
2016,6,29,11,473,458,102,-356
2016,6,29,12,517,500,101,-399
2016,6,29,13,550,532,103,-429
2016,6,29,14,580,496,32,-464
2016,6,29,15,618,501,5,-496
2016,6,29,16,644,527,55,-472
2016,6,29,17,681,557,74,-483
2016,6,29,18,710,585,74,-511
2016,6,29,19,726,582,75,-507
2016,6,29,20,740,698,204,-494
2016,6,29,21,749,727,304,-423
2016,6,29,22,752,733,394,-339
2016,6,29,23,742,715,277,-438
2016,6,30,0,712,694,195,-499
2016,6,30,1,680,662,149,-513
2016,6,30,2,668,647,138,-509
2016,6,30,3,611,589,108,-481
2016,6,30,4,544,521,105,-416
2016,6,30,5,469,460,97,-363
2016,6,30,6,438,435,106,-329
2016,6,30,7,417,415,105,-310
2016,6,30,8,407,401,105,-296
2016,6,30,9,409,404,104,-300
2016,6,30,10,432,424,105,-319
2016,6,30,11,471,457,105,-352
2016,6,30,12,513,501,105,-396
2016,6,30,13,541,534,106,-428
2016,6,30,14,569,566,103,-463
2016,6,30,15,596,605,115,-490
2016,6,30,16,620,639,187,-452
2016,6,30,17,647,669,205,-464
2016,6,30,18,665,704,207,-497
2016,6,30,19,678,727,263,-464
2016,6,30,20,684,741,273,-468
2016,6,30,21,691,743,270,-473
2016,6,30,22,693,751,273,-478
2016,6,30,23,683,737,249,-488
2016,7,1,0,666,705,231,-474
2016,7,1,1,645,677,231,-446
2016,7,1,2,636,664,232,-432
2016,7,1,3,584,615,201,-414
2016,7,1,4,524,552,116,-436
2016,7,1,5,480,496,97,-399
2016,7,1,6,444,463,97,-366
2016,7,1,7,420,440,96,-344
2016,7,1,8,410,425,96,-329
2016,7,1,9,417,425,96,-329
2016,7,1,10,436,441,95,-346
2016,7,1,11,472,474,94,-380
2016,7,1,12,510,514,94,-420
2016,7,1,13,544,549,98,-451
2016,7,1,14,559,581,97,-484
2016,7,1,15,587,626,123,-503
2016,7,1,16,611,662,159,-503
2016,7,1,17,641,687,185,-502
2016,7,1,18,652,710,196,-514
2016,7,1,19,666,727,212,-515
2016,7,1,20,708,747,231,-516
2016,7,1,21,718,757,251,-506
2016,7,1,22,710,756,300,-456
2016,7,1,23,698,738,250,-488
2016,7,2,0,670,700,225,-475
2016,7,2,1,641,673,226,-447
2016,7,2,2,625,655,226,-429
2016,7,2,3,587,604,225,-379
2016,7,2,4,526,540,171,-369
2016,7,2,5,475,480,120,-360
2016,7,2,6,435,447,118,-329
2016,7,2,7,411,414,107,-307
2016,7,2,8,398,401,106,-295
2016,7,2,9,397,395,105,-290
2016,7,2,10,403,400,105,-295
2016,7,2,11,411,403,104,-299
2016,7,2,12,436,431,105,-326
2016,7,2,13,479,479,113,-366
2016,7,2,14,522,525,113,-412
2016,7,2,15,564,566,111,-455
2016,7,2,16,595,609,211,-398
2016,7,2,17,621,643,261,-382
2016,7,2,18,641,675,278,-397
2016,7,2,19,658,698,318,-380
2016,7,2,20,675,715,321,-394
2016,7,2,21,688,726,324,-402
2016,7,2,22,693,728,379,-349
2016,7,2,23,681,716,382,-334
2016,7,3,0,657,691,361,-330
2016,7,3,1,630,663,347,-316
2016,7,3,2,618,639,339,-300
2016,7,3,3,575,591,280,-311
2016,7,3,4,520,536,229,-307
2016,7,3,5,477,479,122,-357
2016,7,3,6,436,438,100,-338
2016,7,3,7,409,415,99,-316
2016,7,3,8,395,403,101,-302
2016,7,3,9,389,393,101,-292
2016,7,3,10,387,393,100,-293
2016,7,3,11,390,399,100,-299
2016,7,3,12,413,427,101,-326
2016,7,3,13,466,479,100,-379
2016,7,3,14,513,523,99,-424
2016,7,3,15,550,565,110,-455
2016,7,3,16,583,602,113,-489
2016,7,3,17,619,642,138,-504
2016,7,3,18,645,672,170,-502
2016,7,3,19,664,697,197,-500
2016,7,3,20,683,714,213,-501
2016,7,3,21,700,713,210,-503
2016,7,3,22,709,715,211,-504
2016,7,3,23,700,709,197,-512
2016,7,4,0,685,684,194,-490
2016,7,4,1,658,665,196,-469
2016,7,4,2,635,653,192,-461
2016,7,4,3,587,611,119,-492
2016,7,4,4,529,552,105,-447
2016,7,4,5,470,495,102,-393
2016,7,4,6,430,460,104,-356
2016,7,4,7,404,436,102,-334
2016,7,4,8,393,427,105,-322
2016,7,4,9,389,421,102,-319
2016,7,4,10,396,429,103,-326
2016,7,4,11,411,440,104,-336
2016,7,4,12,434,464,103,-361
2016,7,4,13,480,505,102,-403
2016,7,4,14,530,563,106,-457
2016,7,4,15,586,617,147,-470
2016,7,4,16,612,671,179,-492
2016,7,4,17,648,707,190,-517
2016,7,4,18,672,726,181,-545
2016,7,4,19,685,717,183,-534
2016,7,4,20,701,751,235,-516
2016,7,4,21,708,763,273,-490
2016,7,4,22,718,776,358,-418
2016,7,4,23,710,759,372,-387
2016,7,5,0,686,730,306,-424
2016,7,5,1,646,691,293,-398
2016,7,5,2,607,659,295,-364
2016,7,5,3,573,630,247,-383
2016,7,5,4,532,581,143,-438
2016,7,5,5,492,522,106,-416
2016,7,5,6,459,480,104,-376
2016,7,5,7,438,458,104,-354
2016,7,5,8,427,446,103,-343
2016,7,5,9,429,446,104,-342
2016,7,5,10,448,459,104,-355
2016,7,5,11,483,494,102,-392
2016,7,5,12,521,539,105,-434
2016,7,5,13,560,586,103,-483
2016,7,5,14,601,636,150,-486
2016,7,5,15,645,688,223,-465
2016,7,5,16,681,721,338,-383
2016,7,5,17,712,752,438,-314
2016,7,5,18,741,730,511,-219
2016,7,5,19,754,677,561,-116
2016,7,5,20,764,679,523,-156
2016,7,5,21,771,703,514,-189
2016,7,5,22,773,733,512,-221
2016,7,5,23,765,733,458,-275
2016,7,6,0,743,713,441,-272
2016,7,6,1,708,680,366,-314
2016,7,6,2,684,662,319,-343
2016,7,6,3,626,613,315,-298
2016,7,6,4,564,547,232,-315
2016,7,6,5,505,496,162,-334
2016,7,6,6,469,462,109,-353
2016,7,6,7,445,437,108,-329
2016,7,6,8,434,424,107,-317
2016,7,6,9,436,425,107,-318
2016,7,6,10,457,446,110,-336
2016,7,6,11,493,480,106,-374
2016,7,6,12,531,520,109,-411
2016,7,6,13,566,559,108,-451
2016,7,6,14,602,605,114,-491
2016,7,6,15,645,647,152,-495
2016,7,6,16,675,678,229,-449
2016,7,6,17,701,711,274,-437
2016,7,6,18,732,743,314,-429
2016,7,6,19,750,771,360,-411
2016,7,6,20,765,791,408,-383
2016,7,6,21,773,805,412,-393
2016,7,6,22,775,817,427,-390
2016,7,6,23,771,796,375,-421
2016,7,7,0,745,734,359,-375
2016,7,7,1,710,683,358,-325
2016,7,7,2,689,641,359,-282
2016,7,7,3,633,588,336,-252
2016,7,7,4,564,524,267,-257
2016,7,7,5,516,476,243,-233
2016,7,7,6,479,443,242,-201
2016,7,7,7,456,420,205,-215
2016,7,7,8,444,407,152,-255
2016,7,7,9,445,412,105,-307
2016,7,7,10,465,434,106,-328
2016,7,7,11,503,471,104,-367
2016,7,7,12,540,511,105,-406
2016,7,7,13,578,543,106,-437
2016,7,7,14,618,582,168,-414
2016,7,7,15,661,621,221,-400
2016,7,7,16,699,641,333,-308
2016,7,7,17,732,662,426,-236
2016,7,7,18,761,684,430,-254
2016,7,7,19,784,710,419,-291
2016,7,7,20,799,697,356,-341
2016,7,7,21,808,671,334,-337
2016,7,7,22,808,670,334,-336
2016,7,7,23,797,678,298,-380
2016,7,8,0,775,661,304,-357
2016,7,8,1,740,609,271,-338
2016,7,8,2,714,563,281,-282
2016,7,8,3,652,541,207,-334
2016,7,8,4,582,493,111,-382
2016,7,8,5,507,450,105,-345
2016,7,8,6,470,427,106,-321
2016,7,8,7,447,408,103,-305
2016,7,8,8,435,405,107,-298
2016,7,8,9,438,379,103,-276
2016,7,8,10,455,446,105,-341
2016,7,8,11,489,461,104,-357
2016,7,8,12,527,501,103,-399
2016,7,8,13,569,538,106,-435
2016,7,8,14,617,580,114,-470
2016,7,8,15,660,620,161,-462
2016,7,8,16,692,646,184,-465
2016,7,8,17,728,675,273,-406
2016,7,8,18,767,709,317,-395
2016,7,8,19,795,737,393,-347
2016,7,8,20,825,759,551,-212
2016,7,8,21,837,794,582,-216
2016,7,8,22,841,784,669,-118
2016,7,8,23,816,793,683,-113
2016,7,9,0,781,726,693,-37
2016,7,9,1,744,689,516,-176
2016,7,9,2,720,620,347,-276
2016,7,9,3,671,572,211,-365
2016,7,9,4,602,515,113,-404
2016,7,9,5,525,469,108,-361
2016,7,9,6,486,437,106,-331
2016,7,9,7,445,422,109,-313
2016,7,9,8,447,406,107,-299
2016,7,9,9,439,401,105,-296
2016,7,9,10,445,413,108,-305
2016,7,9,11,454,423,105,-318
2016,7,9,12,478,454,108,-346
2016,7,9,13,522,497,106,-391
2016,7,9,14,583,527,120,-407
2016,7,9,15,626,552,237,-315
2016,7,9,16,667,575,300,-275
2016,7,9,17,696,602,377,-225
2016,7,9,18,723,634,443,-191
2016,7,9,19,736,663,440,-223
2016,7,9,20,746,687,440,-247
2016,7,9,21,750,709,430,-279
2016,7,9,22,758,721,428,-293
2016,7,9,23,740,719,408,-311
2016,7,10,0,712,694,362,-332
2016,7,10,1,687,659,363,-296
2016,7,10,2,665,643,363,-280
2016,7,10,3,618,595,298,-297
2016,7,10,4,554,532,211,-321
2016,7,10,5,484,479,144,-335
2016,7,10,6,445,440,106,-334
2016,7,10,7,419,416,108,-308
2016,7,10,8,405,400,107,-293
2016,7,10,9,399,391,107,-284
2016,7,10,10,398,399,109,-290
2016,7,10,11,406,405,107,-298
2016,7,10,12,430,434,109,-325
2016,7,10,13,478,473,105,-368
2016,7,10,14,521,522,114,-408
2016,7,10,15,549,557,233,-324
2016,7,10,16,576,591,271,-320
2016,7,10,17,614,622,244,-378
2016,7,10,18,638,651,253,-398
2016,7,10,19,651,671,296,-375
2016,7,10,20,673,689,374,-315
2016,7,10,21,687,713,373,-340
2016,7,10,22,695,731,372,-359
2016,7,10,23,685,726,373,-353
2016,7,11,0,669,712,376,-336
2016,7,11,1,646,673,371,-302
2016,7,11,2,625,653,298,-355
2016,7,11,3,578,603,279,-324
2016,7,11,4,520,541,261,-280
2016,7,11,5,466,484,138,-346
2016,7,11,6,434,447,104,-343
2016,7,11,7,413,426,106,-320
2016,7,11,8,403,413,104,-309
2016,7,11,9,407,412,105,-307
2016,7,11,10,432,432,105,-327
2016,7,11,11,472,465,104,-361
2016,7,11,12,512,507,119,-388
2016,7,11,13,547,547,176,-371
2016,7,11,14,582,573,233,-340
2016,7,11,15,620,592,255,-337
2016,7,11,16,653,593,259,-334
2016,7,11,17,683,651,295,-356
2016,7,11,18,713,710,399,-311
2016,7,11,19,734,741,495,-246
2016,7,11,20,750,752,522,-230
2016,7,11,21,761,698,452,-246
2016,7,11,22,764,715,369,-346
2016,7,11,23,758,725,342,-383
2016,7,12,0,737,711,294,-417
2016,7,12,1,703,691,263,-428
2016,7,12,2,674,665,307,-358
2016,7,12,3,618,599,341,-258
2016,7,12,4,553,537,305,-232
2016,7,12,5,493,485,203,-282
2016,7,12,6,458,453,110,-343
2016,7,12,7,435,430,102,-328
2016,7,12,8,423,415,99,-316
2016,7,12,9,424,412,97,-315
2016,7,12,10,447,447,107,-340
2016,7,12,11,486,478,100,-378
2016,7,12,12,525,521,101,-420
2016,7,12,13,558,549,102,-447
2016,7,12,14,592,582,112,-470
2016,7,12,15,633,622,156,-466
2016,7,12,16,665,657,223,-434
2016,7,12,17,694,693,258,-435
2016,7,12,18,717,718,387,-331
2016,7,12,19,736,763,546,-217
2016,7,12,20,748,764,603,-161
2016,7,12,21,760,744,605,-139
2016,7,12,22,760,706,605,-101
2016,7,12,23,754,680,547,-133
2016,7,13,0,732,661,541,-120
2016,7,13,1,699,627,535,-92
2016,7,13,2,670,626,495,-131
2016,7,13,3,612,567,368,-199
2016,7,13,4,549,515,357,-158
2016,7,13,5,496,464,299,-165
2016,7,13,6,462,436,250,-186
2016,7,13,7,439,421,159,-262
2016,7,13,8,429,405,108,-297
2016,7,13,9,430,408,106,-302
2016,7,13,10,453,427,105,-322
2016,7,13,11,490,467,108,-359
2016,7,13,12,528,500,145,-355
2016,7,13,13,564,537,184,-353
2016,7,13,14,603,580,225,-355
2016,7,13,15,650,626,280,-346
2016,7,13,16,680,665,362,-303
2016,7,13,17,709,693,440,-253
2016,7,13,18,741,737,585,-152
2016,7,13,19,765,758,608,-150
2016,7,13,20,781,768,652,-116
2016,7,13,21,796,774,700,-74
2016,7,13,22,801,747,660,-87
2016,7,13,23,792,720,585,-135
2016,7,14,0,762,701,546,-155
2016,7,14,1,729,678,530,-148
2016,7,14,2,702,587,351,-236
2016,7,14,3,641,608,351,-257
2016,7,14,4,576,541,346,-195
2016,7,14,5,510,487,349,-138
2016,7,14,6,473,456,317,-139
2016,7,14,7,449,433,230,-203
2016,7,14,8,436,421,125,-296
2016,7,14,9,434,423,101,-322
2016,7,14,10,456,441,108,-333
2016,7,14,11,492,478,197,-281
2016,7,14,12,530,521,234,-287
2016,7,14,13,566,558,251,-307
2016,7,14,14,608,597,288,-309
2016,7,14,15,655,720,478,-242
2016,7,14,16,693,692,553,-139
2016,7,14,17,721,736,595,-143
2016,7,14,18,757,771,744,-29
2016,7,14,19,784,769,757,-14
2016,7,14,20,806,778,757,-24
2016,7,14,21,823,810,755,-57
2016,7,14,22,823,805,743,-64
2016,7,14,23,812,743,675,-70
2016,7,15,0,784,697,655,-44
2016,7,15,1,753,669,547,-124
2016,7,15,2,722,634,504,-133
2016,7,15,3,659,577,446,-131
2016,7,15,4,600,511,374,-137
2016,7,15,5,515,467,378,-89
2016,7,15,6,480,431,366,-65
2016,7,15,7,458,414,319,-95
2016,7,15,8,443,402,300,-102
2016,7,15,9,442,406,279,-127
2016,7,15,10,458,425,249,-176
2016,7,15,11,493,460,274,-186
2016,7,15,12,529,497,319,-178
2016,7,15,13,567,532,347,-185
2016,7,15,14,610,567,362,-205
2016,7,15,15,652,587,373,-214
2016,7,15,16,682,598,408,-190
2016,7,15,17,713,626,537,-89
2016,7,15,18,749,669,541,-128
2016,7,15,19,767,710,682,-28
2016,7,15,20,779,681,666,-15
2016,7,15,21,764,660,541,-119
2016,7,15,22,765,639,522,-117
2016,7,15,23,747,626,373,-253
2016,7,16,0,718,613,375,-238
2016,7,16,1,691,599,376,-223
2016,7,16,2,655,593,364,-229
2016,7,16,3,624,549,317,-232
2016,7,16,4,564,496,261,-235
2016,7,16,5,482,464,195,-269
2016,7,16,6,447,438,134,-304
2016,7,16,7,426,418,81,-337
2016,7,16,8,412,409,95,-314
2016,7,16,9,408,407,100,-307
2016,7,16,10,414,416,100,-316
2016,7,16,11,426,426,97,-329
2016,7,16,12,454,452,119,-333
2016,7,16,13,496,498,142,-356
2016,7,16,14,539,544,142,-402
2016,7,16,15,588,579,141,-438
2016,7,16,16,620,610,187,-423
2016,7,16,17,645,646,233,-413
2016,7,16,18,666,660,283,-377
2016,7,16,19,676,676,321,-355
2016,7,16,20,686,669,341,-328
2016,7,16,21,696,644,358,-286
2016,7,16,22,700,635,372,-263
2016,7,16,23,692,614,349,-265
2016,7,17,0,673,588,271,-317
2016,7,17,1,645,583,235,-348
2016,7,17,2,633,577,190,-387
2016,7,17,3,589,542,130,-412
2016,7,17,4,532,466,103,-363
2016,7,17,5,481,445,106,-339
2016,7,17,6,444,415,104,-311
2016,7,17,7,420,399,106,-293
2016,7,17,8,406,387,104,-283
2016,7,17,9,399,385,105,-280
2016,7,17,10,403,386,105,-281
2016,7,17,11,411,401,105,-296
2016,7,17,12,438,420,105,-315
2016,7,17,13,486,468,107,-361
2016,7,17,14,531,499,104,-395
2016,7,17,15,566,534,104,-430
2016,7,17,16,606,573,107,-466
2016,7,17,17,643,615,132,-483
2016,7,17,18,674,649,169,-480
2016,7,17,19,690,666,218,-448
2016,7,17,20,707,704,252,-452
2016,7,17,21,722,706,331,-375
2016,7,17,22,732,704,334,-370
2016,7,17,23,723,704,331,-373
2016,7,18,0,709,690,328,-362
2016,7,18,1,681,660,261,-399
2016,7,18,2,664,650,177,-473
2016,7,18,3,610,603,173,-430
2016,7,18,4,554,539,125,-414
2016,7,18,5,490,490,79,-411
2016,7,18,6,455,451,51,-400
2016,7,18,7,435,432,43,-389
2016,7,18,8,423,416,44,-372
2016,7,18,9,422,420,42,-378
2016,7,18,10,445,440,45,-395
2016,7,18,11,481,486,42,-444
2016,7,18,12,522,524,74,-450
2016,7,18,13,560,564,111,-453
2016,7,18,14,609,610,184,-426
2016,7,18,15,657,665,275,-390
2016,7,18,16,694,702,292,-410
2016,7,18,17,730,736,302,-434
2016,7,18,18,769,756,363,-393
2016,7,18,19,795,766,401,-365
2016,7,18,20,804,774,438,-336
2016,7,18,21,815,792,439,-353
2016,7,18,22,809,800,424,-376
2016,7,18,23,802,808,433,-375
2016,7,19,0,773,784,421,-363
2016,7,19,1,742,743,397,-346
2016,7,19,2,705,724,295,-429
2016,7,19,3,637,656,277,-379
2016,7,19,4,574,583,181,-402
2016,7,19,5,521,526,182,-344
2016,7,19,6,483,486,172,-314
2016,7,19,7,458,466,120,-346
2016,7,19,8,444,447,72,-375
2016,7,19,9,441,446,45,-401
2016,7,19,10,462,468,44,-424
2016,7,19,11,497,504,43,-461
2016,7,19,12,536,547,67,-480
2016,7,19,13,574,582,108,-474
2016,7,19,14,616,604,151,-453
2016,7,19,15,666,631,183,-448
2016,7,19,16,693,690,332,-358
2016,7,19,17,736,730,395,-335
2016,7,19,18,775,756,406,-350
2016,7,19,19,802,788,432,-356
2016,7,19,20,821,799,488,-311
2016,7,19,21,833,774,501,-273
2016,7,19,22,829,744,505,-239
2016,7,19,23,816,726,520,-206
2016,7,20,0,786,709,407,-302
2016,7,20,1,752,684,305,-379
2016,7,20,2,710,667,287,-380
2016,7,20,3,643,609,187,-422
2016,7,20,4,581,548,127,-421
2016,7,20,5,522,494,91,-403
2016,7,20,6,483,461,56,-405
2016,7,20,7,457,439,51,-388
2016,7,20,8,443,425,48,-377
2016,7,20,9,441,431,50,-381
2016,7,20,10,461,447,49,-398
2016,7,20,11,496,487,49,-438
2016,7,20,12,534,528,49,-479
2016,7,20,13,570,554,85,-472
2016,7,20,14,611,599,163,-439
2016,7,20,15,657,642,196,-450
2016,7,20,16,685,689,255,-437
2016,7,20,17,722,723,321,-407
2016,7,20,18,760,763,357,-411
2016,7,20,19,785,794,387,-412
2016,7,20,20,806,814,410,-410
2016,7,20,21,820,838,412,-432
2016,7,20,22,818,843,410,-439
2016,7,20,23,805,832,380,-456
2016,7,21,0,771,798,343,-461
2016,7,21,1,732,753,345,-413
2016,7,21,2,701,723,343,-385
2016,7,21,3,637,654,343,-315
2016,7,21,4,567,576,195,-384
2016,7,21,5,521,521,179,-342
2016,7,21,6,482,487,165,-322
2016,7,21,7,458,460,103,-357
2016,7,21,8,442,446,85,-361
2016,7,21,9,440,446,77,-369
2016,7,21,10,456,461,93,-368
2016,7,21,11,494,508,102,-406
2016,7,21,12,532,539,99,-440
2016,7,21,13,566,568,138,-434
2016,7,21,14,604,608,192,-420
2016,7,21,15,649,655,227,-433
2016,7,21,16,682,700,300,-404
2016,7,21,17,717,739,357,-386
2016,7,21,18,752,769,495,-278
2016,7,21,19,780,795,590,-210
2016,7,21,20,804,805,575,-234
2016,7,21,21,814,786,582,-208
2016,7,21,22,810,785,603,-187
2016,7,21,23,796,788,550,-242
2016,7,22,0,766,765,530,-240
2016,7,22,1,738,733,526,-211
2016,7,22,2,706,715,528,-191
2016,7,22,3,644,644,462,-186
2016,7,22,4,581,576,312,-269
2016,7,22,5,523,523,254,-269
2016,7,22,6,484,483,235,-248
2016,7,22,7,460,456,161,-295
2016,7,22,8,443,436,104,-332
2016,7,22,9,444,438,103,-335
2016,7,22,10,458,453,101,-352
2016,7,22,11,497,489,104,-385
2016,7,22,12,532,523,103,-420
2016,7,22,13,569,557,102,-455
2016,7,22,14,613,590,120,-470
2016,7,22,15,666,629,172,-457
2016,7,22,16,695,674,200,-474
2016,7,22,17,735,706,302,-407
2016,7,22,18,765,754,419,-338
2016,7,22,19,793,779,480,-302
2016,7,22,20,815,798,492,-309
2016,7,22,21,826,790,491,-303
2016,7,22,22,821,748,497,-254
2016,7,22,23,801,705,489,-219
2016,7,23,0,776,681,481,-203
2016,7,23,1,740,655,435,-223
2016,7,23,2,703,642,312,-333
2016,7,23,3,659,594,206,-388
2016,7,23,4,601,536,127,-409
2016,7,23,5,512,486,105,-381
2016,7,23,6,475,451,104,-347
2016,7,23,7,447,428,105,-323
2016,7,23,8,432,411,105,-306
2016,7,23,9,426,404,104,-300
2016,7,23,10,432,410,107,-303
2016,7,23,11,446,426,105,-321
2016,7,23,12,469,454,107,-347
2016,7,23,13,511,495,105,-390
2016,7,23,14,563,550,108,-442
2016,7,23,15,614,594,124,-470
2016,7,23,16,650,646,222,-424
2016,7,23,17,691,682,294,-388
2016,7,23,18,722,719,414,-305
2016,7,23,19,749,730,461,-269
2016,7,23,20,769,734,463,-271
2016,7,23,21,777,742,511,-231
2016,7,23,22,777,740,589,-151
2016,7,23,23,767,728,547,-181
2016,7,24,0,745,707,516,-191
2016,7,24,1,719,674,514,-160
2016,7,24,2,687,663,508,-155
2016,7,24,3,630,606,327,-279
2016,7,24,4,579,548,217,-331
2016,7,24,5,512,490,118,-372
2016,7,24,6,474,458,104,-354
2016,7,24,7,448,430,103,-327
2016,7,24,8,434,417,103,-314
2016,7,24,9,427,410,103,-307
2016,7,24,10,426,412,104,-308
2016,7,24,11,438,418,102,-316
2016,7,24,12,459,447,103,-344
2016,7,24,13,514,496,103,-393
2016,7,24,14,564,546,107,-439
2016,7,24,15,611,588,139,-449
2016,7,24,16,645,634,205,-429
2016,7,24,17,684,683,256,-427
2016,7,24,18,718,721,331,-390
2016,7,24,19,741,753,529,-224
2016,7,24,20,765,774,531,-243
2016,7,24,21,778,783,530,-253
2016,7,24,22,784,785,536,-249
2016,7,24,23,776,769,533,-236
2016,7,25,0,749,746,534,-212
2016,7,25,1,723,720,535,-185
2016,7,25,2,688,697,532,-165
2016,7,25,3,636,639,490,-149
2016,7,25,4,580,574,325,-249
2016,7,25,5,524,520,266,-254
2016,7,25,6,487,483,176,-307
2016,7,25,7,464,459,125,-334
2016,7,25,8,450,442,103,-339
2016,7,25,9,447,442,102,-340
2016,7,25,10,469,467,106,-361
2016,7,25,11,501,504,143,-361
2016,7,25,12,538,542,166,-376
2016,7,25,13,578,585,173,-412
2016,7,25,14,627,630,177,-453
2016,7,25,15,682,687,249,-438
2016,7,25,16,721,738,376,-362
2016,7,25,17,758,787,580,-207
2016,7,25,18,801,825,691,-134
2016,7,25,19,834,849,691,-158
2016,7,25,20,859,849,690,-159
2016,7,25,21,870,836,687,-149
2016,7,25,22,863,817,691,-126
2016,7,25,23,824,793,688,-105
2016,7,26,0,809,761,677,-84
2016,7,26,1,774,732,539,-193
2016,7,26,2,736,706,509,-197
2016,7,26,3,681,640,467,-173
2016,7,26,4,614,581,356,-225
2016,7,26,5,555,531,341,-190
2016,7,26,6,516,491,340,-151
2016,7,26,7,487,473,321,-152
2016,7,26,8,472,456,256,-200
2016,7,26,9,467,456,197,-259
2016,7,26,10,487,479,178,-301
2016,7,26,11,522,516,210,-306
2016,7,26,12,558,550,248,-305
2016,7,26,13,596,591,284,-310
2016,7,26,14,644,635,305,-333
2016,7,26,15,699,682,330,-355
2016,7,26,16,734,728,404,-327
2016,7,26,17,777,770,512,-264
2016,7,26,18,832,809,637,-177
2016,7,26,19,843,836,643,-198
2016,7,26,20,866,815,643,-178
2016,7,26,21,875,772,672,-105
2016,7,26,22,873,752,667,-90
2016,7,26,23,828,747,631,-121
2016,7,27,0,817,750,626,-129
2016,7,27,1,776,729,643,-91
2016,7,27,2,739,711,624,-92
2016,7,27,3,673,651,501,-154
2016,7,27,4,614,594,341,-253
2016,7,27,5,548,539,331,-208
2016,7,27,6,509,501,309,-192
2016,7,27,7,481,479,315,-164
2016,7,27,8,466,460,263,-197
2016,7,27,9,462,461,192,-269
2016,7,27,10,483,478,182,-296
2016,7,27,11,521,517,216,-301
2016,7,27,12,555,558,252,-306
2016,7,27,13,591,595,256,-339
2016,7,27,14,636,644,280,-364
2016,7,27,15,689,698,304,-394
2016,7,27,16,726,748,436,-312
2016,7,27,17,764,785,569,-216
2016,7,27,18,803,823,604,-219
2016,7,27,19,831,848,683,-165
2016,7,27,20,856,868,683,-185
2016,7,27,21,865,858,669,-189
2016,7,27,22,858,870,674,-196
2016,7,27,23,824,853,649,-204
2016,7,28,0,806,828,630,-198
2016,7,28,1,772,791,611,-180
2016,7,28,2,724,758,599,-159
2016,7,28,3,679,689,461,-228
2016,7,28,4,615,609,378,-231
2016,7,28,5,552,554,363,-191
2016,7,28,6,513,514,332,-182
2016,7,28,7,484,486,279,-207
2016,7,28,8,471,471,202,-269
2016,7,28,9,462,468,136,-332
2016,7,28,10,483,487,125,-362
2016,7,28,11,515,521,199,-322
2016,7,28,12,552,564,251,-313
2016,7,28,13,586,607,277,-330
2016,7,28,14,629,655,310,-345
2016,7,28,15,681,689,339,-350
2016,7,28,16,718,739,544,-195
2016,7,28,17,758,766,590,-176
2016,7,28,18,794,790,657,-133
2016,7,28,19,820,816,707,-109
2016,7,28,20,841,813,698,-115
2016,7,28,21,849,809,693,-116
2016,7,28,22,839,801,690,-111
2016,7,28,23,825,793,657,-136
2016,7,29,0,793,774,637,-137
2016,7,29,1,765,756,643,-113
2016,7,29,2,719,720,567,-153
2016,7,29,3,668,665,376,-289
2016,7,29,4,602,603,377,-226
2016,7,29,5,545,543,373,-170
2016,7,29,6,504,513,344,-169
2016,7,29,7,476,484,237,-247
2016,7,29,8,457,470,165,-305
2016,7,29,9,455,468,126,-342
2016,7,29,10,472,485,128,-357
2016,7,29,11,511,520,146,-374
2016,7,29,12,541,556,182,-374
2016,7,29,13,580,584,203,-381
2016,7,29,14,619,623,236,-387
2016,7,29,15,669,653,249,-404
2016,7,29,16,703,692,330,-362
2016,7,29,17,735,718,345,-373
2016,7,29,18,769,750,385,-365
2016,7,29,19,796,773,474,-299
2016,7,29,20,811,789,506,-283
2016,7,29,21,809,803,603,-200
2016,7,29,22,799,791,609,-182
2016,7,29,23,774,756,616,-140
2016,7,30,0,745,718,516,-202
2016,7,30,1,715,692,491,-201
2016,7,30,2,689,669,343,-326
2016,7,30,3,635,616,338,-278
2016,7,30,4,572,563,295,-268
2016,7,30,5,511,515,229,-286
2016,7,30,6,473,481,192,-289
2016,7,30,7,447,455,130,-325
2016,7,30,8,430,436,102,-334
2016,7,30,9,424,429,99,-330
2016,7,30,10,428,436,100,-336
2016,7,30,11,442,449,102,-347
2016,7,30,12,466,473,114,-359
2016,7,30,13,507,508,198,-310
2016,7,30,14,552,562,234,-328
2016,7,30,15,600,611,270,-341
2016,7,30,16,637,641,373,-268
2016,7,30,17,670,677,493,-184
2016,7,30,18,704,707,589,-118
2016,7,30,19,723,713,632,-81
2016,7,30,20,736,693,623,-70
2016,7,30,21,744,671,637,-34
2016,7,30,22,741,679,639,-40
2016,7,30,23,727,682,464,-218
2016,7,31,0,704,667,371,-296
2016,7,31,1,679,646,316,-330
2016,7,31,2,663,630,316,-314
2016,7,31,3,610,584,308,-276
2016,7,31,4,550,531,255,-276
2016,7,31,5,497,477,212,-265
2016,7,31,6,461,448,152,-296
2016,7,31,7,438,418,118,-300
2016,7,31,8,424,407,107,-300
2016,7,31,9,417,401,107,-294
2016,7,31,10,420,407,108,-299
2016,7,31,11,430,418,107,-311
2016,7,31,12,453,443,106,-337
2016,7,31,13,502,492,124,-368
2016,7,31,14,550,538,161,-377
2016,7,31,15,584,579,190,-389
2016,7,31,16,622,623,227,-396
2016,7,31,17,658,660,347,-313
2016,7,31,18,694,699,496,-203
2016,7,31,19,713,724,508,-216
2016,7,31,20,728,740,505,-235
2016,7,31,21,741,743,515,-228
2016,7,31,22,747,762,507,-255
2016,7,31,23,740,754,473,-281
2016,8,1,0,719,726,318,-408
2016,8,1,1,696,684,289,-395
2016,8,1,2,674,658,300,-358
2016,8,1,3,617,605,268,-337
2016,8,1,4,557,541,208,-333
2016,8,1,5,502,485,173,-312
2016,8,1,6,468,460,135,-325
2016,8,1,7,447,439,105,-334
2016,8,1,8,434,429,103,-326
2016,8,1,9,434,429,104,-325
2016,8,1,10,453,452,103,-349
2016,8,1,11,494,494,129,-365
2016,8,1,12,531,531,162,-369
2016,8,1,13,566,564,183,-381
2016,8,1,14,608,601,192,-409
2016,8,1,15,657,647,239,-408
2016,8,1,16,703,689,302,-387
2016,8,1,17,744,725,336,-389
2016,8,1,18,782,754,323,-431
2016,8,1,19,817,766,314,-452
2016,8,1,20,833,759,370,-389
2016,8,1,21,834,746,370,-376
2016,8,1,22,819,730,370,-360
2016,8,1,23,803,747,372,-375
2016,8,2,0,774,724,355,-369
2016,8,2,1,739,709,361,-348
2016,8,2,2,704,684,366,-318
2016,8,2,3,642,626,321,-305
2016,8,2,4,572,566,251,-315
2016,8,2,5,515,516,191,-325
2016,8,2,6,479,479,121,-358
2016,8,2,7,456,456,102,-354
2016,8,2,8,443,444,101,-343
2016,8,2,9,443,447,107,-340
2016,8,2,10,463,471,116,-355
2016,8,2,11,502,509,122,-387
2016,8,2,12,540,550,123,-427
2016,8,2,13,574,579,123,-456
2016,8,2,14,614,613,141,-472
2016,8,2,15,656,646,187,-459
2016,8,2,16,702,696,290,-406
2016,8,2,17,734,730,378,-352
2016,8,2,18,769,740,507,-233
2016,8,2,19,799,719,573,-146
2016,8,2,20,809,708,576,-132
2016,8,2,21,810,728,573,-155
2016,8,2,22,795,736,510,-226
2016,8,2,23,775,732,449,-283
2016,8,3,0,753,709,378,-331
2016,8,3,1,728,693,353,-340
2016,8,3,2,697,674,358,-316
2016,8,3,3,638,624,320,-304
2016,8,3,4,573,553,245,-308
2016,8,3,5,517,505,169,-336
2016,8,3,6,484,473,106,-367
2016,8,3,7,459,454,109,-345
2016,8,3,8,448,444,109,-335
2016,8,3,9,449,446,126,-320
2016,8,3,10,469,466,135,-331
2016,8,3,11,513,507,160,-347
2016,8,3,12,550,549,200,-349
2016,8,3,13,579,582,229,-353
2016,8,3,14,614,613,267,-346
2016,8,3,15,660,653,304,-349
2016,8,3,16,700,690,336,-354
2016,8,3,17,739,718,334,-384
2016,8,3,18,769,751,362,-389
2016,8,3,19,786,780,461,-319
2016,8,3,20,786,802,514,-288
2016,8,3,21,788,816,567,-249
2016,8,3,22,780,815,571,-244
2016,8,3,23,772,805,529,-276
2016,8,4,0,748,768,501,-267
2016,8,4,1,723,739,456,-283
2016,8,4,2,699,709,345,-364
2016,8,4,3,639,644,347,-297
2016,8,4,4,574,578,287,-291
2016,8,4,5,509,511,208,-303
2016,8,4,6,476,486,128,-358
2016,8,4,7,453,461,80,-381
2016,8,4,8,442,457,81,-376
2016,8,4,9,442,453,80,-373
2016,8,4,10,464,476,80,-396
2016,8,4,11,508,524,88,-436
2016,8,4,12,546,559,131,-428
2016,8,4,13,570,591,173,-418
2016,8,4,14,602,619,223,-396
2016,8,4,15,638,645,286,-359
2016,8,4,16,670,666,367,-299
2016,8,4,17,696,687,408,-279
2016,8,4,18,727,716,412,-304
2016,8,4,19,744,730,410,-320
2016,8,4,20,736,730,423,-307
2016,8,4,21,737,737,443,-294
2016,8,4,22,724,734,445,-289
2016,8,4,23,710,713,391,-322
2016,8,5,0,692,687,354,-333
2016,8,5,1,677,674,329,-345
2016,8,5,2,662,655,329,-326
2016,8,5,3,606,606,324,-282
2016,8,5,4,547,549,264,-285
2016,8,5,5,489,499,190,-309
2016,8,5,6,459,472,134,-338
2016,8,5,7,439,452,112,-340
2016,8,5,8,429,439,110,-329
2016,8,5,9,430,443,111,-332
2016,8,5,10,451,465,109,-356
2016,8,5,11,496,507,116,-391
2016,8,5,12,530,545,143,-402
2016,8,5,13,563,569,172,-397
2016,8,5,14,591,595,204,-391
2016,8,5,15,621,627,231,-396
2016,8,5,16,653,667,269,-398
2016,8,5,17,679,698,291,-407
2016,8,5,18,708,732,366,-366
2016,8,5,19,732,754,397,-357
2016,8,5,20,738,747,394,-353
2016,8,5,21,737,729,387,-342
2016,8,5,22,726,715,395,-320
2016,8,5,23,720,713,395,-318
2016,8,6,0,689,687,366,-321
2016,8,6,1,668,670,372,-298
2016,8,6,2,653,647,371,-276
2016,8,6,3,608,603,361,-242
2016,8,6,4,553,542,316,-226
2016,8,6,5,499,496,264,-232
2016,8,6,6,467,459,198,-261
2016,8,6,7,444,434,123,-311
2016,8,6,8,434,429,115,-314
2016,8,6,9,429,421,113,-308
2016,8,6,10,438,432,108,-324
2016,8,6,11,459,449,109,-340
2016,8,6,12,481,469,109,-360
2016,8,6,13,522,507,119,-388
2016,8,6,14,576,553,154,-399
2016,8,6,15,632,604,200,-404
2016,8,6,16,676,648,271,-377
2016,8,6,17,715,687,312,-375
2016,8,6,18,742,705,468,-237
2016,8,6,19,766,725,618,-107
2016,8,6,20,773,745,675,-70
2016,8,6,21,782,754,686,-68
2016,8,6,22,788,765,707,-58
2016,8,6,23,777,753,665,-88
2016,8,7,0,742,727,609,-118
2016,8,7,1,716,708,608,-100
2016,8,7,2,699,686,514,-172
2016,8,7,3,656,625,442,-183
2016,8,7,4,589,563,332,-231
2016,8,7,5,523,514,284,-230
2016,8,7,6,488,475,235,-240
2016,8,7,7,458,448,184,-264
2016,8,7,8,445,434,152,-282
2016,8,7,9,435,423,136,-287
2016,8,7,10,435,426,114,-312
2016,8,7,11,447,430,112,-318
2016,8,7,12,470,458,113,-345
2016,8,7,13,516,505,111,-394
2016,8,7,14,571,554,153,-401
2016,8,7,15,616,588,205,-383
2016,8,7,16,665,616,258,-358
2016,8,7,17,702,644,329,-315
2016,8,7,18,735,701,507,-194
2016,8,7,19,751,717,527,-190
2016,8,7,20,759,694,525,-169
2016,8,7,21,767,671,529,-142
2016,8,7,22,772,659,467,-192
2016,8,7,23,761,651,407,-244
2016,8,8,0,733,636,350,-286
2016,8,8,1,709,621,346,-275
2016,8,8,2,685,603,339,-264
2016,8,8,3,631,569,330,-239
2016,8,8,4,565,527,216,-311
2016,8,8,5,496,488,114,-374
2016,8,8,6,464,459,106,-353
2016,8,8,7,445,442,108,-334
2016,8,8,8,434,432,110,-322
2016,8,8,9,437,436,120,-316
2016,8,8,10,462,460,120,-340
2016,8,8,11,507,503,119,-384
2016,8,8,12,548,545,144,-401
2016,8,8,13,580,573,175,-398
2016,8,8,14,620,600,200,-400
2016,8,8,15,664,631,233,-398
2016,8,8,16,714,654,256,-398
2016,8,8,17,748,678,296,-382
2016,8,8,18,777,710,350,-360
2016,8,8,19,790,731,365,-366
2016,8,8,20,786,745,365,-380
2016,8,8,21,778,764,367,-397
2016,8,8,22,776,769,364,-405
2016,8,8,23,770,758,363,-395
2016,8,9,0,751,726,360,-366
2016,8,9,1,727,713,366,-347
2016,8,9,2,699,686,361,-325
2016,8,9,3,635,630,312,-318
2016,8,9,4,569,566,177,-389
2016,8,9,5,499,514,116,-398
2016,8,9,6,467,486,103,-383
2016,8,9,7,448,464,103,-361
2016,8,9,8,439,455,102,-353
2016,8,9,9,441,454,100,-354
2016,8,9,10,468,475,101,-374
2016,8,9,11,516,516,101,-415
2016,8,9,12,554,558,101,-457
2016,8,9,13,584,585,119,-466
2016,8,9,14,619,607,139,-468
2016,8,9,15,656,636,173,-463
2016,8,9,16,697,659,241,-418
2016,8,9,17,725,676,289,-387
2016,8,9,18,756,694,364,-330
2016,8,9,19,770,707,485,-222
2016,8,9,20,765,729,533,-196
2016,8,9,21,760,748,535,-213
2016,8,9,22,749,741,527,-214
2016,8,9,23,742,718,499,-219
2016,8,10,0,726,687,388,-299
2016,8,10,1,708,680,356,-324
2016,8,10,2,687,656,302,-354
2016,8,10,3,624,608,243,-365
2016,8,10,4,563,550,152,-398
2016,8,10,5,513,505,105,-400
2016,8,10,6,480,479,104,-375
2016,8,10,7,457,455,106,-349
2016,8,10,8,444,447,105,-342
2016,8,10,9,446,449,107,-342
2016,8,10,10,469,467,105,-362
2016,8,10,11,519,511,105,-406
2016,8,10,12,554,547,107,-440
2016,8,10,13,581,575,113,-462
2016,8,10,14,615,604,169,-435
2016,8,10,15,655,635,222,-413
2016,8,10,16,690,657,322,-335
2016,8,10,17,724,668,477,-191
2016,8,10,18,760,687,568,-119
2016,8,10,19,788,693,602,-91
2016,8,10,20,797,688,618,-70
2016,8,10,21,801,697,647,-50
2016,8,10,22,797,693,670,-23
2016,8,10,23,795,686,629,-57
2016,8,11,0,762,668,636,-32
2016,8,11,1,740,656,514,-142
2016,8,11,2,715,643,337,-306
2016,8,11,3,649,593,231,-362
2016,8,11,4,580,540,165,-375
2016,8,11,5,509,498,159,-339
2016,8,11,6,477,471,113,-358
2016,8,11,7,455,450,105,-345
2016,8,11,8,444,447,105,-342
2016,8,11,9,446,447,105,-342
2016,8,11,10,468,471,105,-366
2016,8,11,11,520,516,109,-407
2016,8,11,12,554,553,204,-349
2016,8,11,13,583,584,254,-330
2016,8,11,14,614,617,262,-355
2016,8,11,15,652,651,286,-365
2016,8,11,16,688,684,427,-257
2016,8,11,17,772,698,519,-179
2016,8,11,18,749,738,590,-148
2016,8,11,19,773,750,659,-91
2016,8,11,20,782,778,692,-86
2016,8,11,21,778,786,741,-45
2016,8,11,22,781,791,765,-26
2016,8,11,23,782,777,717,-60
2016,8,12,0,746,747,697,-50
2016,8,12,1,727,719,696,-23
2016,8,12,2,697,698,590,-108
2016,8,12,3,638,635,484,-151
2016,8,12,4,572,571,269,-302
2016,8,12,5,520,519,186,-333
2016,8,12,6,487,490,163,-327
2016,8,12,7,467,469,109,-360
2016,8,12,8,456,457,102,-355
2016,8,12,9,457,458,101,-357
2016,8,12,10,479,476,101,-375
2016,8,12,11,527,518,104,-414
2016,8,12,12,560,552,102,-450
2016,8,12,13,596,592,147,-445
2016,8,12,14,633,635,220,-415
2016,8,12,15,672,675,354,-321
2016,8,12,16,708,707,441,-266
2016,8,12,17,739,738,528,-210
2016,8,12,18,768,763,569,-194
2016,8,12,19,790,775,654,-121
2016,8,12,20,792,792,664,-128
2016,8,12,21,797,800,659,-141
2016,8,12,22,785,810,665,-145
2016,8,12,23,773,785,663,-122
2016,8,13,0,739,755,662,-93
2016,8,13,1,720,734,616,-118
2016,8,13,2,699,707,384,-323
2016,8,13,3,647,650,281,-369
2016,8,13,4,595,587,233,-354
2016,8,13,5,529,536,164,-372
2016,8,13,6,492,502,114,-388
2016,8,13,7,465,441,108,-333
2016,8,13,8,452,452,107,-345
2016,8,13,9,443,447,108,-339
2016,8,13,10,452,451,109,-342
2016,8,13,11,470,466,108,-358
2016,8,13,12,494,484,109,-375
2016,8,13,13,532,536,142,-394
2016,8,13,14,585,588,205,-383
2016,8,13,15,636,639,249,-390
2016,8,13,16,681,668,366,-302
2016,8,13,17,715,704,572,-132
2016,8,13,18,744,721,580,-141
2016,8,13,19,766,746,632,-114
2016,8,13,20,769,763,689,-74
2016,8,13,21,779,775,758,-17
2016,8,13,22,781,779,758,-21
2016,8,13,23,765,762,664,-98
2016,8,14,0,737,740,618,-122
2016,8,14,1,714,703,592,-111
2016,8,14,2,687,683,492,-191
2016,8,14,3,631,622,369,-253
2016,8,14,4,571,560,297,-263
2016,8,14,5,520,511,246,-265
2016,8,14,6,482,466,242,-224
2016,8,14,7,455,446,243,-203
2016,8,14,8,441,426,213,-213
2016,8,14,9,431,415,111,-304
2016,8,14,10,436,414,98,-316
2016,8,14,11,450,427,102,-325
2016,8,14,12,473,450,104,-346
2016,8,14,13,515,499,106,-393
2016,8,14,14,565,551,145,-406
2016,8,14,15,607,599,180,-419
2016,8,14,16,649,642,257,-385
2016,8,14,17,698,687,371,-316
2016,8,14,18,735,699,389,-310
2016,8,14,19,757,689,384,-305
2016,8,14,20,767,700,388,-312
2016,8,14,21,775,711,432,-279
2016,8,14,22,777,704,464,-240
2016,8,14,23,769,697,486,-211
2016,8,15,0,740,684,458,-226
2016,8,15,1,717,677,345,-332
2016,8,15,2,684,654,344,-310
2016,8,15,3,624,595,306,-289
2016,8,15,4,565,542,193,-349
2016,8,15,5,513,496,124,-372
2016,8,15,6,479,462,103,-359
2016,8,15,7,454,439,102,-337
2016,8,15,8,441,428,103,-325
2016,8,15,9,441,431,103,-328
2016,8,15,10,460,453,104,-349
2016,8,15,11,506,494,103,-391
2016,8,15,12,539,531,102,-429
2016,8,15,13,575,567,139,-428
2016,8,15,14,616,605,279,-326
2016,8,15,15,664,666,464,-202
2016,8,15,16,704,716,574,-142
2016,8,15,17,744,746,647,-99
2016,8,15,18,789,785,668,-117
2016,8,15,19,806,799,677,-122
2016,8,15,20,820,813,774,-39
2016,8,15,21,822,830,798,-32
2016,8,15,22,822,822,792,-30
2016,8,15,23,810,796,779,-17
2016,8,16,0,785,759,730,-29
2016,8,16,1,765,743,684,-59
2016,8,16,2,726,704,671,-33
2016,8,16,3,656,636,491,-145
2016,8,16,4,582,569,318,-251
2016,8,16,5,524,517,187,-330
2016,8,16,6,488,481,112,-369
2016,8,16,7,463,458,107,-351
2016,8,16,8,450,442,107,-335
2016,8,16,9,450,443,108,-335
2016,8,16,10,470,462,112,-350
2016,8,16,11,516,505,131,-374
2016,8,16,12,549,545,224,-321
2016,8,16,13,582,580,240,-340
2016,8,16,14,618,619,253,-366
2016,8,16,15,661,674,408,-266
2016,8,16,16,703,724,449,-275
2016,8,16,17,735,758,621,-137
2016,8,16,18,782,788,620,-168
2016,8,16,19,800,816,687,-129
2016,8,16,20,811,829,729,-100
2016,8,16,21,817,822,734,-88
2016,8,16,22,813,822,732,-90
2016,8,16,23,799,800,688,-112
2016,8,17,0,769,768,663,-105
2016,8,17,1,752,750,648,-102
2016,8,17,2,716,720,606,-114
2016,8,17,3,647,650,360,-290
2016,8,17,4,576,586,318,-268
2016,8,17,5,526,535,270,-265
2016,8,17,6,491,498,210,-288
2016,8,17,7,464,473,143,-330
2016,8,17,8,453,461,104,-357
2016,8,17,9,452,459,101,-358
2016,8,17,10,472,476,102,-374
2016,8,17,11,519,516,101,-415
2016,8,17,12,549,554,125,-429
2016,8,17,13,580,590,175,-415
2016,8,17,14,616,630,186,-444
2016,8,17,15,657,678,340,-338
2016,8,17,16,695,661,473,-188
2016,8,17,17,725,677,601,-76
2016,8,17,18,761,776,722,-54
2016,8,17,19,780,738,728,-10
2016,8,17,20,790,707,708,1
2016,8,17,21,800,695,684,-11
2016,8,17,22,796,697,685,-12
2016,8,17,23,778,697,671,-26
2016,8,18,0,750,729,657,-72
2016,8,18,1,736,629,602,-27
2016,8,18,2,703,655,523,-132
2016,8,18,3,638,725,484,-241
2016,8,18,4,572,578,312,-266
2016,8,18,5,532,499,198,-301
2016,8,18,6,496,465,112,-353
2016,8,18,7,470,445,105,-340
2016,8,18,8,458,435,104,-331
2016,8,18,9,455,438,107,-331
2016,8,18,10,475,458,106,-352
2016,8,18,11,519,504,103,-401
2016,8,18,12,552,540,116,-424
2016,8,18,13,582,568,142,-426
2016,8,18,14,619,603,185,-418
2016,8,18,15,657,641,332,-309
2016,8,18,16,696,700,545,-155
2016,8,18,17,721,717,587,-130
2016,8,18,18,757,732,596,-136
2016,8,18,19,776,734,610,-124
2016,8,18,20,785,713,608,-105
2016,8,18,21,789,714,603,-111
2016,8,18,22,782,730,606,-124
2016,8,18,23,761,731,506,-225
2016,8,19,0,737,701,384,-317
2016,8,19,1,727,686,387,-299
2016,8,19,2,696,660,378,-282
2016,8,19,3,631,606,331,-275
2016,8,19,4,570,545,282,-263
2016,8,19,5,512,499,216,-283
2016,8,19,6,480,471,144,-327
2016,8,19,7,459,444,102,-342
2016,8,19,8,450,435,100,-335
2016,8,19,9,450,437,102,-335
2016,8,19,10,471,458,101,-357
2016,8,19,11,518,500,108,-392
2016,8,19,12,547,539,142,-397
2016,8,19,13,586,557,156,-401
2016,8,19,14,625,585,166,-419
2016,8,19,15,660,608,189,-419
2016,8,19,16,687,641,198,-443
2016,8,19,17,707,661,370,-291
2016,8,19,18,749,698,566,-132
2016,8,19,19,751,715,637,-78
2016,8,19,20,744,701,626,-75
2016,8,19,21,742,680,538,-142
2016,8,19,22,732,663,474,-189
2016,8,19,23,706,642,497,-145
2016,8,20,0,688,621,470,-151
2016,8,20,1,662,618,462,-156
2016,8,20,2,646,598,408,-190
2016,8,20,3,623,565,329,-236
2016,8,20,4,551,519,263,-256
2016,8,20,5,485,476,192,-284
2016,8,20,6,453,443,120,-323
2016,8,20,7,430,423,102,-321
2016,8,20,8,417,414,102,-312
2016,8,20,9,413,413,105,-308
2016,8,20,10,422,421,102,-319
2016,8,20,11,442,439,103,-336
2016,8,20,12,465,459,102,-357
2016,8,20,13,503,507,105,-402
2016,8,20,14,545,549,110,-439
2016,8,20,15,588,590,157,-433
2016,8,20,16,615,619,320,-299
2016,8,20,17,648,638,532,-106
2016,8,20,18,675,643,564,-79
2016,8,20,19,689,629,558,-71
2016,8,20,20,692,630,556,-74
2016,8,20,21,700,652,568,-84
2016,8,20,22,697,665,553,-112
2016,8,20,23,686,653,396,-257
2016,8,21,0,666,638,372,-266
2016,8,21,1,652,633,376,-257
2016,8,21,2,630,610,316,-294
2016,8,21,3,577,567,162,-405
2016,8,21,4,523,514,106,-408
2016,8,21,5,474,470,100,-370
2016,8,21,6,441,439,101,-338
2016,8,21,7,420,422,101,-321
2016,8,21,8,407,409,101,-308
2016,8,21,9,402,403,100,-303
2016,8,21,10,405,411,102,-309
2016,8,21,11,421,420,100,-320
2016,8,21,12,445,450,103,-347
2016,8,21,13,492,493,102,-391
2016,8,21,14,532,534,107,-427
2016,8,21,15,560,570,144,-426
2016,8,21,16,590,588,172,-416
2016,8,21,17,618,616,262,-354
2016,8,21,18,642,636,315,-321
2016,8,21,19,642,654,325,-329
2016,8,21,20,644,665,329,-336
2016,8,21,21,647,667,422,-245
2016,8,21,22,649,655,488,-167
2016,8,21,23,633,650,488,-162
2016,8,22,0,621,634,471,-163
2016,8,22,1,617,627,487,-140
2016,8,22,2,595,606,385,-221
2016,8,22,3,541,559,148,-411
2016,8,22,4,486,507,71,-436
2016,8,22,5,451,458,84,-374
2016,8,22,6,423,435,106,-329
2016,8,22,7,403,410,101,-309
2016,8,22,8,396,405,102,-303
2016,8,22,9,399,408,100,-308
2016,8,22,10,426,432,101,-331
2016,8,22,11,474,477,103,-374
2016,8,22,12,508,503,97,-406
2016,8,22,13,533,535,105,-430
2016,8,22,14,558,552,97,-455
2016,8,22,15,587,586,115,-471
2016,8,22,16,610,606,134,-472
2016,8,22,17,638,625,153,-472
2016,8,22,18,672,654,183,-471
2016,8,22,19,692,673,211,-462
2016,8,22,20,709,696,285,-411
2016,8,22,21,713,715,350,-365
2016,8,22,22,711,717,355,-362
2016,8,22,23,696,710,359,-351
2016,8,23,0,669,685,349,-336
2016,8,23,1,660,672,350,-322
2016,8,23,2,623,635,313,-322
2016,8,23,3,565,568,217,-351
2016,8,23,4,502,501,111,-390
2016,8,23,5,463,455,100,-355
2016,8,23,6,432,429,101,-328
2016,8,23,7,412,410,100,-310
2016,8,23,8,403,396,98,-298
2016,8,23,9,407,407,100,-307
2016,8,23,10,432,428,100,-328
2016,8,23,11,481,479,100,-379
2016,8,23,12,515,509,100,-409
2016,8,23,13,539,531,134,-397
2016,8,23,14,562,552,145,-407
2016,8,23,15,591,578,166,-412
2016,8,23,16,610,606,270,-336
2016,8,23,17,639,624,304,-320
2016,8,23,18,671,651,370,-281
2016,8,23,19,687,675,452,-223
2016,8,23,20,707,695,459,-236
2016,8,23,21,717,710,460,-250
2016,8,23,22,715,715,461,-254
2016,8,23,23,701,708,402,-306
2016,8,24,0,680,688,363,-325
2016,8,24,1,673,683,364,-319
2016,8,24,2,642,644,353,-291
2016,8,24,3,587,579,318,-261
2016,8,24,4,524,518,260,-258
2016,8,24,5,459,468,183,-285
2016,8,24,6,430,440,116,-324
2016,8,24,7,411,422,103,-319
2016,8,24,8,405,410,78,-332
2016,8,24,9,410,413,51,-362
2016,8,24,10,436,436,50,-386
2016,8,24,11,491,493,52,-441
2016,8,24,12,523,524,50,-474
2016,8,24,13,545,544,70,-474
2016,8,24,14,570,563,93,-470
2016,8,24,15,599,583,141,-442
2016,8,24,16,616,597,272,-325
2016,8,24,17,638,604,313,-292
2016,8,24,18,663,614,345,-269
2016,8,24,19,680,636,368,-269
2016,8,24,20,692,652,354,-300
2016,8,24,21,703,679,346,-336
2016,8,24,22,701,698,336,-364
2016,8,24,23,695,699,311,-391
2016,8,25,0,672,687,285,-402
2016,8,25,1,668,681,293,-389
2016,8,25,2,636,646,274,-372
2016,8,25,3,580,588,245,-343
2016,8,25,4,521,519,160,-359
2016,8,25,5,468,474,106,-368
2016,8,25,6,439,442,103,-339
2016,8,25,7,421,427,105,-322
2016,8,25,8,414,414,101,-313
2016,8,25,9,419,419,106,-313
2016,8,25,10,446,446,105,-341
2016,8,25,11,511,504,104,-400
2016,8,25,12,537,538,103,-435
2016,8,25,13,556,557,116,-441
2016,8,25,14,581,581,142,-439
2016,8,25,15,613,619,186,-433
2016,8,25,16,643,640,236,-404
2016,8,25,17,672,698,426,-272
2016,8,25,18,702,739,586,-153
2016,8,25,19,724,760,671,-89
2016,8,25,20,740,772,718,-54
2016,8,25,21,749,796,757,-39
2016,8,25,22,751,798,760,-38
2016,8,25,23,745,791,701,-90
2016,8,26,0,723,771,683,-88
2016,8,26,1,716,752,680,-72
2016,8,26,2,680,707,561,-146
2016,8,26,3,617,633,390,-243
2016,8,26,4,553,566,373,-193
2016,8,26,5,514,515,292,-223
2016,8,26,6,481,473,215,-258
2016,8,26,7,460,453,153,-300
2016,8,26,8,449,433,138,-295
2016,8,26,9,452,432,139,-293
2016,8,26,10,475,457,139,-318
2016,8,26,11,537,500,176,-324
2016,8,26,12,561,542,213,-329
2016,8,26,13,588,566,256,-310
2016,8,26,14,623,596,283,-313
2016,8,26,15,668,649,413,-236
2016,8,26,16,701,685,613,-72
2016,8,26,17,730,739,669,-70
2016,8,26,18,769,767,667,-100
2016,8,26,19,792,803,681,-122
2016,8,26,20,803,809,678,-131
2016,8,26,21,809,828,688,-140
2016,8,26,22,812,826,673,-153
2016,8,26,23,792,806,655,-151
2016,8,27,0,764,763,657,-106
2016,8,27,1,736,736,647,-89
2016,8,27,2,704,689,407,-282
2016,8,27,3,645,633,348,-285
2016,8,27,4,584,569,340,-229
2016,8,27,5,528,514,269,-245
2016,8,27,6,489,477,153,-324
2016,8,27,7,464,446,104,-342
2016,8,27,8,449,432,107,-325
2016,8,27,9,441,426,107,-319
2016,8,27,10,448,428,107,-321
2016,8,27,11,468,443,107,-336
2016,8,27,12,490,459,106,-353
2016,8,27,13,525,506,112,-394
2016,8,27,14,572,554,194,-360
2016,8,27,15,631,607,252,-355
2016,8,27,16,662,653,511,-142
2016,8,27,17,701,695,594,-101
2016,8,27,18,729,726,584,-142
2016,8,27,19,754,747,579,-168
2016,8,27,20,762,752,577,-175
2016,8,27,21,772,763,541,-222
2016,8,27,22,774,767,527,-240
2016,8,27,23,762,735,479,-256
2016,8,28,0,734,681,436,-245
2016,8,28,1,720,666,466,-200
2016,8,28,2,686,629,335,-294
2016,8,28,3,624,580,254,-326
2016,8,28,4,561,523,196,-327
2016,8,28,5,509,474,112,-362
2016,8,28,6,473,440,110,-330
2016,8,28,7,447,418,105,-313
2016,8,28,8,433,408,108,-300
2016,8,28,9,425,398,105,-293
2016,8,28,10,427,404,107,-297
2016,8,28,11,443,421,106,-315
2016,8,28,12,465,444,107,-337
2016,8,28,13,506,488,106,-382
2016,8,28,14,551,525,121,-404
2016,8,28,15,588,558,150,-408
2016,8,28,16,621,591,183,-408
2016,8,28,17,663,632,227,-405
2016,8,28,18,692,665,342,-323
2016,8,28,19,713,701,521,-180
2016,8,28,20,725,723,534,-189
2016,8,28,21,725,740,535,-205
2016,8,28,22,726,755,534,-221
2016,8,28,23,715,740,534,-206
2016,8,29,0,694,717,538,-179
2016,8,29,1,686,694,505,-189
2016,8,29,2,645,647,374,-273
2016,8,29,3,588,583,264,-319
2016,8,29,4,527,515,134,-381
2016,8,29,5,465,463,106,-357
2016,8,29,6,433,431,106,-325
2016,8,29,7,411,381,75,-306
2016,8,29,8,400,299,3,-296
2016,8,29,9,404,303,4,-299
2016,8,29,10,430,335,4,-331
2016,8,29,11,490,356,5,-351
2016,8,29,12,520,332,4,-332
2016,8,29,13,541,329,3,-330
2016,8,29,14,568,333,4,-333
2016,8,29,15,606,344,4,-344
2016,8,29,16,644,365,3,-366
2016,8,29,17,676,362,12,-354
2016,8,29,18,708,694,497,-202
2016,8,29,19,736,721,522,-203
2016,8,29,20,752,744,532,-216
2016,8,29,21,763,765,532,-237
2016,8,29,22,763,771,533,-242
2016,8,29,23,748,762,531,-235
2016,8,30,0,723,735,532,-207
2016,8,30,1,711,717,502,-219
2016,8,30,2,664,664,374,-294
2016,8,30,3,594,592,376,-220
2016,8,30,4,529,527,256,-271
2016,8,30,5,468,473,121,-352
2016,8,30,6,435,446,111,-335
2016,8,30,7,413,426,106,-320
2016,8,30,8,403,413,102,-311
2016,8,30,9,407,418,99,-319
2016,8,30,10,434,441,101,-340
2016,8,30,11,496,507,113,-394
2016,8,30,12,524,523,166,-361
2016,8,30,13,541,544,179,-369
2016,8,30,14,565,573,187,-390
2016,8,30,15,597,608,211,-401
2016,8,30,16,631,640,288,-356
2016,8,30,17,662,674,354,-324
2016,8,30,18,688,708,384,-329
2016,8,30,19,713,731,484,-251
2016,8,30,20,727,761,569,-196
2016,8,30,21,741,772,570,-206
2016,8,30,22,741,779,576,-207
2016,8,30,23,729,767,537,-234
2016,8,31,0,706,738,476,-266
2016,8,31,1,703,724,483,-245
2016,8,31,2,660,673,450,-227
2016,8,31,3,590,595,299,-300
2016,8,31,4,530,535,207,-328
2016,8,31,5,476,478,139,-339
2016,8,31,6,444,452,103,-349
2016,8,31,7,421,427,101,-326
2016,8,31,8,406,420,101,-319
2016,8,31,9,409,420,102,-318
2016,8,31,10,437,445,100,-345
2016,8,31,11,496,511,160,-351
2016,8,31,12,518,531,241,-290
2016,8,31,13,533,548,266,-284
2016,8,31,14,556,580,290,-292
2016,8,31,15,589,620,328,-294
2016,8,31,16,608,648,406,-244
2016,8,31,17,633,695,537,-160
2016,8,31,18,708,723,555,-170
2016,8,31,19,732,759,564,-197
2016,8,31,20,746,773,548,-227
2016,8,31,21,758,774,547,-229
2016,8,31,22,760,772,556,-218
2016,8,31,23,747,749,529,-222
2016,9,1,0,730,724,509,-217
2016,9,1,1,710,720,514,-209
2016,9,1,2,677,673,503,-172
2016,9,1,3,626,611,368,-243
2016,9,1,4,548,546,169,-377
2016,9,1,5,496,496,112,-384
2016,9,1,6,463,465,108,-357
2016,9,1,7,441,446,106,-340
2016,9,1,8,428,438,107,-331
2016,9,1,9,428,435,103,-332
2016,9,1,10,451,467,106,-361
2016,9,1,11,511,529,153,-376
2016,9,1,12,536,556,237,-319
2016,9,1,13,555,574,238,-336
2016,9,1,14,581,597,238,-359
2016,9,1,15,617,632,252,-380
2016,9,1,16,644,673,349,-324
2016,9,1,17,668,708,416,-292
2016,9,1,18,715,728,473,-255
2016,9,1,19,732,741,563,-178
2016,9,1,20,742,711,554,-157
2016,9,1,21,750,684,539,-145
2016,9,1,22,747,670,530,-140
2016,9,1,23,733,661,529,-132
2016,9,2,0,712,657,502,-155
2016,9,2,1,695,663,502,-161
2016,9,2,2,655,627,398,-229
2016,9,2,3,605,575,319,-256
2016,9,2,4,531,522,274,-248
2016,9,2,5,478,471,203,-268
2016,9,2,6,449,445,131,-314
2016,9,2,7,425,429,109,-320
2016,9,2,8,407,416,103,-313
2016,9,2,9,407,423,105,-318
2016,9,2,10,430,445,143,-302
2016,9,2,11,484,509,245,-264
2016,9,2,12,500,540,310,-230
2016,9,2,13,509,556,333,-223
2016,9,2,14,524,572,356,-216
2016,9,2,15,538,590,360,-230
2016,9,2,16,543,589,347,-242
2016,9,2,17,549,581,334,-247
2016,9,2,18,606,583,333,-250
2016,9,2,19,613,577,320,-257
2016,9,2,20,599,570,307,-263
2016,9,2,21,598,570,294,-276
2016,9,2,22,591,571,290,-281
2016,9,2,23,574,569,290,-279
2016,9,3,0,556,567,286,-281
2016,9,3,1,568,572,287,-285
2016,9,3,2,544,550,272,-278
2016,9,3,3,506,511,243,-268
2016,9,3,4,461,464,213,-251
2016,9,3,5,426,422,145,-277
2016,9,3,6,402,392,114,-278
2016,9,3,7,388,378,110,-268
2016,9,3,8,378,367,110,-257
2016,9,3,9,375,365,107,-258
2016,9,3,10,385,374,111,-263
2016,9,3,11,406,389,115,-274
2016,9,3,12,427,414,171,-243
2016,9,3,13,463,444,215,-229
2016,9,3,14,494,476,236,-240
2016,9,3,15,520,496,235,-261
2016,9,3,16,530,510,283,-227
2016,9,3,17,546,530,320,-210
2016,9,3,18,569,540,338,-202
2016,9,3,19,584,558,345,-213
2016,9,3,20,591,576,312,-264
2016,9,3,21,606,593,287,-306
2016,9,3,22,617,607,300,-307
2016,9,3,23,606,596,234,-362
2016,9,4,0,586,580,200,-380
2016,9,4,1,580,579,176,-403
2016,9,4,2,546,548,152,-396
2016,9,4,3,497,508,122,-386
2016,9,4,4,448,459,72,-387
2016,9,4,5,408,420,59,-361
2016,9,4,6,381,393,60,-333
2016,9,4,7,365,376,59,-317
2016,9,4,8,357,370,58,-312
2016,9,4,9,353,363,59,-304
2016,9,4,10,353,369,61,-308
2016,9,4,11,365,384,59,-325
2016,9,4,12,386,405,59,-346
2016,9,4,13,432,449,61,-388
2016,9,4,14,469,481,60,-421
2016,9,4,15,490,502,61,-441
2016,9,4,16,509,522,109,-413
2016,9,4,17,530,542,159,-383
2016,9,4,18,550,569,207,-362
2016,9,4,19,565,586,232,-354
2016,9,4,20,581,602,239,-363
2016,9,4,21,599,619,240,-379
2016,9,4,22,604,628,244,-384
2016,9,4,23,597,615,184,-431
2016,9,5,0,585,591,150,-441
2016,9,5,1,590,589,144,-445
2016,9,5,2,553,560,94,-466
2016,9,5,3,501,514,55,-459
2016,9,5,4,452,460,53,-407
2016,9,5,5,425,421,55,-366
2016,9,5,6,395,395,54,-341
2016,9,5,7,380,379,54,-325
2016,9,5,8,370,368,53,-315
2016,9,5,9,375,368,54,-314
2016,9,5,10,383,378,54,-324
2016,9,5,11,399,397,56,-341
2016,9,5,12,420,412,53,-359
2016,9,5,13,456,449,55,-394
2016,9,5,14,499,484,55,-429
2016,9,5,15,540,514,54,-460
2016,9,5,16,579,540,54,-486
2016,9,5,17,601,567,54,-513
2016,9,5,18,625,595,54,-541
2016,9,5,19,641,603,68,-535
2016,9,5,20,661,640,178,-462
2016,9,5,21,683,655,252,-403
2016,9,5,22,689,670,288,-382
2016,9,5,23,684,664,335,-329
2016,9,6,0,668,642,324,-318
2016,9,6,1,659,636,304,-332
2016,9,6,2,612,589,231,-358
2016,9,6,3,562,525,86,-439
2016,9,6,4,501,464,53,-411
2016,9,6,5,440,422,50,-372
2016,9,6,6,415,397,50,-347
2016,9,6,7,398,381,51,-330
2016,9,6,8,393,371,49,-322
2016,9,6,9,400,375,51,-324
2016,9,6,10,430,407,50,-357
2016,9,6,11,492,474,49,-425
2016,9,6,12,522,500,51,-449
2016,9,6,13,539,513,50,-463
2016,9,6,14,567,532,52,-480
2016,9,6,15,596,560,51,-509
2016,9,6,16,622,498,64,-434
2016,9,6,17,654,613,100,-513
2016,9,6,18,681,639,228,-411
2016,9,6,19,704,671,301,-370
2016,9,6,20,724,697,333,-364
2016,9,6,21,739,715,354,-361
2016,9,6,22,735,722,355,-367
2016,9,6,23,723,713,356,-357
2016,9,7,0,709,687,358,-329
2016,9,7,1,696,668,353,-315
2016,9,7,2,650,624,347,-277
2016,9,7,3,592,549,171,-378
2016,9,7,4,524,491,117,-374
2016,9,7,5,453,444,64,-380
2016,9,7,6,425,417,55,-362
2016,9,7,7,405,401,56,-345
2016,9,7,8,400,387,53,-334
2016,9,7,9,404,395,54,-341
2016,9,7,10,433,421,54,-367
2016,9,7,11,496,480,53,-427
2016,9,7,12,524,507,50,-457
2016,9,7,13,541,517,54,-463
2016,9,7,14,564,538,59,-479
2016,9,7,15,592,567,59,-508
2016,9,7,16,613,592,192,-400
2016,9,7,17,645,636,273,-363
2016,9,7,18,673,669,410,-259
2016,9,7,19,705,691,451,-240
2016,9,7,20,724,718,484,-234
2016,9,7,21,738,733,487,-246
2016,9,7,22,739,746,482,-264
2016,9,7,23,730,740,488,-252
2016,9,8,0,712,708,501,-207
2016,9,8,1,702,687,487,-200
2016,9,8,2,651,637,389,-248
2016,9,8,3,589,565,199,-366
2016,9,8,4,522,501,101,-400
2016,9,8,5,470,450,56,-394
2016,9,8,6,439,421,52,-369
2016,9,8,7,417,404,52,-352
2016,9,8,8,411,394,51,-343
2016,9,8,9,412,398,52,-346
2016,9,8,10,439,422,52,-370
2016,9,8,11,503,490,60,-430
2016,9,8,12,532,514,59,-455
2016,9,8,13,548,529,60,-469
2016,9,8,14,574,552,60,-492
2016,9,8,15,604,582,65,-517
2016,9,8,16,621,610,103,-507
2016,9,8,17,661,655,260,-395
2016,9,8,18,690,688,287,-401
2016,9,8,19,722,719,349,-370
2016,9,8,20,752,735,352,-383
2016,9,8,21,767,745,351,-394
2016,9,8,22,773,749,352,-397
2016,9,8,23,762,743,350,-393
2016,9,9,0,744,719,353,-366
2016,9,9,1,736,706,350,-356
2016,9,9,2,683,656,313,-343
2016,9,9,3,613,583,200,-383
2016,9,9,4,546,521,77,-444
2016,9,9,5,490,473,58,-415
2016,9,9,6,457,439,43,-396
2016,9,9,7,435,420,49,-371
2016,9,9,8,423,402,47,-355
2016,9,9,9,425,406,50,-356
2016,9,9,10,448,429,49,-380
2016,9,9,11,508,498,51,-447
2016,9,9,12,534,519,51,-468
2016,9,9,13,552,539,52,-487
2016,9,9,14,585,564,52,-512
2016,9,9,15,625,592,79,-513
2016,9,9,16,658,631,248,-383
2016,9,9,17,700,667,277,-390
2016,9,9,18,731,704,307,-397
2016,9,9,19,758,724,308,-416
2016,9,9,20,779,736,336,-400
2016,9,9,21,781,744,343,-401
2016,9,9,22,777,739,347,-392
2016,9,9,23,759,727,346,-381
2016,9,10,0,726,692,348,-344
2016,9,10,1,711,674,345,-329
2016,9,10,2,665,631,347,-284
2016,9,10,3,605,580,349,-231
2016,9,10,4,547,521,349,-172
2016,9,10,5,487,476,298,-178
2016,9,10,6,451,444,109,-335
2016,9,10,7,426,420,63,-357
2016,9,10,8,414,405,51,-354
2016,9,10,9,407,403,53,-350
2016,9,10,10,415,409,52,-357
2016,9,10,11,435,424,51,-373
2016,9,10,12,459,447,52,-395
2016,9,10,13,492,485,52,-433
2016,9,10,14,534,524,68,-456
2016,9,10,15,576,566,98,-468
2016,9,10,16,611,606,125,-481
2016,9,10,17,645,639,239,-400
2016,9,10,18,662,656,299,-357
2016,9,10,19,687,664,320,-344
2016,9,10,20,703,678,337,-341
2016,9,10,21,724,701,343,-358
2016,9,10,22,726,712,347,-365
2016,9,10,23,712,695,341,-354
2016,9,11,0,693,665,346,-319
2016,9,11,1,681,649,344,-305
2016,9,11,2,637,612,347,-265
2016,9,11,3,579,555,244,-311
2016,9,11,4,524,506,190,-316
2016,9,11,5,474,467,173,-294
2016,9,11,6,439,437,165,-272
2016,9,11,7,415,420,123,-297
2016,9,11,8,401,404,68,-336
2016,9,11,9,393,399,59,-340
2016,9,11,10,397,402,59,-343
2016,9,11,11,411,417,60,-357
2016,9,11,12,437,440,60,-380
2016,9,11,13,476,481,59,-422
2016,9,11,14,514,517,60,-457
2016,9,11,15,539,537,56,-481
2016,9,11,16,564,565,177,-388
2016,9,11,17,597,598,224,-374
2016,9,11,18,622,622,296,-326
2016,9,11,19,635,643,330,-313
2016,9,11,20,638,669,342,-327
2016,9,11,21,649,683,351,-332
2016,9,11,22,647,691,353,-338
2016,9,11,23,641,674,353,-321
2016,9,12,0,631,645,328,-317
2016,9,12,1,623,632,284,-348
2016,9,12,2,583,585,176,-409
2016,9,12,3,529,530,172,-358
2016,9,12,4,478,476,157,-319
2016,9,12,5,440,438,110,-328
2016,9,12,6,414,408,62,-346
2016,9,12,7,397,393,55,-338
2016,9,12,8,388,387,55,-332
2016,9,12,9,393,392,56,-336
2016,9,12,10,422,426,69,-357
2016,9,12,11,485,487,58,-429
2016,9,12,12,514,518,55,-463
2016,9,12,13,532,528,54,-474
2016,9,12,14,552,551,52,-499
2016,9,12,15,580,582,92,-490
2016,9,12,16,601,611,145,-466
2016,9,12,17,622,636,183,-453
2016,9,12,18,649,675,259,-416
2016,9,12,19,659,699,209,-490
2016,9,12,20,667,715,248,-467
2016,9,12,21,673,723,294,-429
2016,9,12,22,676,715,306,-409
2016,9,12,23,670,703,320,-383
2016,9,13,0,656,684,332,-352
2016,9,13,1,645,685,335,-350
2016,9,13,2,599,641,274,-367
2016,9,13,3,541,579,147,-432
2016,9,13,4,483,520,88,-432
2016,9,13,5,460,468,58,-410
2016,9,13,6,433,445,55,-390
2016,9,13,7,415,422,54,-368
2016,9,13,8,407,414,56,-358
2016,9,13,9,411,414,54,-360
2016,9,13,10,441,441,70,-371
2016,9,13,11,507,510,148,-362
2016,9,13,12,536,540,151,-389
2016,9,13,13,552,549,151,-398
2016,9,13,14,574,566,150,-416
2016,9,13,15,599,594,150,-444
2016,9,13,16,626,624,163,-461
2016,9,13,17,654,652,212,-440
2016,9,13,18,677,689,299,-390
2016,9,13,19,691,711,313,-398
2016,9,13,20,705,727,304,-423
2016,9,13,21,713,744,308,-436
2016,9,13,22,715,745,315,-430
2016,9,13,23,713,731,325,-406
2016,9,14,0,698,703,317,-386
2016,9,14,1,685,694,317,-377
2016,9,14,2,638,638,224,-414
2016,9,14,3,570,571,113,-458
2016,9,14,4,512,514,77,-437
2016,9,14,5,461,465,56,-409
2016,9,14,6,432,434,55,-379
2016,9,14,7,413,417,56,-361
2016,9,14,8,405,410,57,-353
2016,9,14,9,408,412,57,-355
2016,9,14,10,439,440,56,-384
2016,9,14,11,503,503,65,-438
2016,9,14,12,531,527,101,-426
2016,9,14,13,542,534,100,-434
2016,9,14,14,567,561,105,-456
2016,9,14,15,593,590,133,-457
2016,9,14,16,619,627,161,-466
2016,9,14,17,659,657,218,-439
2016,9,14,18,687,693,299,-394
2016,9,14,19,707,716,303,-413
2016,9,14,20,720,722,462,-260
2016,9,14,21,730,734,502,-232
2016,9,14,22,726,740,517,-223
2016,9,14,23,717,726,515,-211
2016,9,15,0,693,703,507,-196
2016,9,15,1,679,702,513,-189
2016,9,15,2,637,645,387,-258
2016,9,15,3,572,583,168,-415
2016,9,15,4,512,520,99,-421
2016,9,15,5,473,467,57,-410
2016,9,15,6,443,437,54,-383
2016,9,15,7,422,421,56,-365
2016,9,15,8,413,410,55,-355
2016,9,15,9,414,410,56,-354
2016,9,15,10,441,434,55,-379
2016,9,15,11,504,500,72,-428
2016,9,15,12,535,529,96,-433
2016,9,15,13,545,538,108,-430
2016,9,15,14,571,560,160,-400
2016,9,15,15,600,592,172,-420
2016,9,15,16,629,617,171,-446
2016,9,15,17,661,643,270,-373
2016,9,15,18,687,686,318,-368
2016,9,15,19,705,710,322,-388
2016,9,15,20,718,735,317,-418
2016,9,15,21,726,750,317,-433
2016,9,15,22,725,752,318,-434
2016,9,15,23,709,726,312,-414
2016,9,16,0,694,704,322,-382
2016,9,16,1,684,692,316,-376
2016,9,16,2,639,640,230,-410
2016,9,16,3,578,573,174,-399
2016,9,16,4,519,508,145,-363
2016,9,16,5,466,464,108,-356
2016,9,16,6,435,438,99,-339
2016,9,16,7,414,424,59,-365
2016,9,16,8,405,414,50,-364
2016,9,16,9,407,420,51,-369
2016,9,16,10,433,445,56,-389
2016,9,16,11,490,509,75,-434
2016,9,16,12,517,539,115,-424
2016,9,16,13,531,556,120,-436
2016,9,16,14,554,571,137,-434
2016,9,16,15,577,590,146,-444
2016,9,16,16,600,608,203,-405
2016,9,16,17,627,640,264,-376
2016,9,16,18,642,675,293,-382
2016,9,16,19,657,692,333,-359
2016,9,16,20,665,705,349,-356
2016,9,16,21,670,703,350,-353
2016,9,16,22,661,690,348,-342
2016,9,16,23,644,665,350,-315
2016,9,17,0,622,644,347,-297
2016,9,17,1,619,634,308,-326
2016,9,17,2,581,593,177,-416
2016,9,17,3,534,551,176,-375
2016,9,17,4,485,493,104,-389
2016,9,17,5,447,451,54,-397
2016,9,17,6,418,430,50,-380
2016,9,17,7,399,410,50,-360
2016,9,17,8,389,404,51,-353
2016,9,17,9,386,399,50,-349
2016,9,17,10,398,409,51,-358
2016,9,17,11,416,420,50,-370
2016,9,17,12,440,443,51,-392
2016,9,17,13,476,475,49,-426
2016,9,17,14,509,513,50,-463
2016,9,17,15,541,538,52,-486
2016,9,17,16,558,567,90,-477
2016,9,17,17,590,582,99,-483
2016,9,17,18,606,591,189,-402
2016,9,17,19,623,609,343,-266
2016,9,17,20,632,634,344,-290
2016,9,17,21,651,647,341,-306
2016,9,17,22,652,657,345,-312
2016,9,17,23,643,642,344,-298
2016,9,18,0,630,623,344,-279
2016,9,18,1,609,608,339,-269
2016,9,18,2,577,570,173,-397
2016,9,18,3,525,527,152,-375
2016,9,18,4,478,471,134,-337
2016,9,18,5,443,436,69,-367
2016,9,18,6,413,407,50,-357
2016,9,18,7,394,392,51,-341
2016,9,18,8,384,382,51,-331
2016,9,18,9,379,373,50,-323
2016,9,18,10,385,379,51,-328
2016,9,18,11,401,395,52,-343
2016,9,18,12,428,414,50,-364
2016,9,18,13,469,458,51,-407
2016,9,18,14,506,490,51,-439
2016,9,18,15,529,514,82,-432
2016,9,18,16,557,544,164,-380
2016,9,18,17,591,554,310,-244
2016,9,18,18,612,564,343,-221
2016,9,18,19,625,559,362,-197
2016,9,18,20,638,567,501,-66
2016,9,18,21,653,568,456,-112
2016,9,18,22,656,579,435,-144
2016,9,18,23,649,586,435,-151
2016,9,19,0,639,589,431,-158
2016,9,19,1,625,588,398,-190
2016,9,19,2,585,550,250,-300
2016,9,19,3,529,503,171,-332
2016,9,19,4,478,462,167,-295
2016,9,19,5,425,431,172,-259
2016,9,19,6,400,411,146,-265
2016,9,19,7,384,396,74,-322
2016,9,19,8,377,396,51,-345
2016,9,19,9,383,402,50,-352
2016,9,19,10,413,440,54,-386
2016,9,19,11,480,504,103,-401
2016,9,19,12,511,536,139,-397
2016,9,19,13,524,552,155,-397
2016,9,19,14,547,571,160,-411
2016,9,19,15,574,587,165,-422
2016,9,19,16,593,610,261,-349
2016,9,19,17,624,633,294,-339
2016,9,19,18,648,650,297,-353
2016,9,19,19,662,665,288,-377
2016,9,19,20,669,680,292,-388
2016,9,19,21,680,697,297,-400
2016,9,19,22,676,700,279,-421
2016,9,19,23,672,689,284,-405
2016,9,20,0,652,672,297,-375
2016,9,20,1,642,664,294,-370
2016,9,20,2,594,613,264,-349
2016,9,20,3,535,547,161,-386
2016,9,20,4,477,488,147,-341
2016,9,20,5,448,448,99,-349
2016,9,20,6,421,420,56,-364
2016,9,20,7,403,405,56,-349
2016,9,20,8,394,396,54,-342
2016,9,20,9,398,393,54,-339
2016,9,20,10,428,422,56,-366
2016,9,20,11,493,490,54,-436
2016,9,20,12,524,519,57,-462
2016,9,20,13,534,525,65,-460
2016,9,20,14,554,544,153,-391
2016,9,20,15,578,562,184,-378
2016,9,20,16,597,591,185,-406
2016,9,20,17,626,614,227,-387
2016,9,20,18,657,640,306,-334
2016,9,20,19,677,659,307,-352
2016,9,20,20,692,680,306,-374
2016,9,20,21,705,694,309,-385
2016,9,20,22,704,695,307,-388
2016,9,20,23,698,683,308,-375
2016,9,21,0,682,673,308,-365
2016,9,21,1,666,660,303,-357
2016,9,21,2,624,610,190,-420
2016,9,21,3,555,551,132,-419
2016,9,21,4,497,484,86,-398
2016,9,21,5,435,439,52,-387
2016,9,21,6,409,418,52,-366
2016,9,21,7,390,398,51,-347
2016,9,21,8,383,391,51,-340
2016,9,21,9,387,394,53,-341
2016,9,21,10,414,425,67,-358
2016,9,21,11,478,488,140,-348
2016,9,21,12,507,517,187,-330
2016,9,21,13,514,531,187,-344
2016,9,21,14,529,543,186,-357
2016,9,21,15,550,573,188,-385
2016,9,21,16,571,595,186,-409
2016,9,21,17,595,621,188,-433
2016,9,21,18,621,643,237,-406
2016,9,21,19,632,669,302,-367
2016,9,21,20,650,682,311,-371
2016,9,21,21,664,698,320,-378
2016,9,21,22,665,695,331,-364
2016,9,21,23,658,686,332,-354
2016,9,22,0,644,674,332,-342
2016,9,22,1,635,668,324,-344
2016,9,22,2,594,624,289,-335
2016,9,22,3,534,561,169,-392
2016,9,22,4,476,499,111,-388
2016,9,22,5,446,454,60,-394
2016,9,22,6,417,425,52,-373
2016,9,22,7,399,410,52,-358
2016,9,22,8,391,399,51,-348
2016,9,22,9,395,404,53,-351
2016,9,22,10,423,426,120,-306
2016,9,22,11,488,492,184,-308
2016,9,22,12,520,525,186,-339
2016,9,22,13,527,534,185,-349
2016,9,22,14,546,550,187,-363
2016,9,22,15,567,571,184,-387
2016,9,22,16,582,585,186,-399
2016,9,22,17,600,601,185,-416
2016,9,22,18,617,614,186,-428
2016,9,22,19,624,624,185,-439
2016,9,22,20,633,638,186,-452
2016,9,22,21,644,643,185,-458
2016,9,22,22,640,648,186,-462
2016,9,22,23,634,641,186,-455
2016,9,23,0,630,642,186,-456
2016,9,23,1,626,639,180,-459
2016,9,23,2,585,605,186,-419
2016,9,23,3,529,551,153,-398
2016,9,23,4,473,497,94,-403
2016,9,23,5,436,454,53,-401
2016,9,23,6,410,428,50,-378
2016,9,23,7,393,412,52,-360
2016,9,23,8,386,403,51,-352
2016,9,23,9,390,407,51,-356
2016,9,23,10,418,435,52,-383
2016,9,23,11,480,498,63,-435
2016,9,23,12,508,520,137,-383
2016,9,23,13,520,537,180,-357
2016,9,23,14,535,559,182,-377
2016,9,23,15,556,584,180,-404
2016,9,23,16,573,606,182,-424
2016,9,23,17,595,636,341,-295
2016,9,23,18,619,659,343,-316
2016,9,23,19,635,667,342,-325
2016,9,23,20,649,668,342,-326
2016,9,23,21,659,676,342,-334
2016,9,23,22,654,683,340,-343
2016,9,23,23,642,672,348,-324
2016,9,24,0,624,646,348,-298
2016,9,24,1,616,633,349,-284
2016,9,24,2,578,588,348,-240
2016,9,24,3,527,537,329,-208
2016,9,24,4,474,490,172,-318
2016,9,24,5,443,446,130,-316
2016,9,24,6,413,420,63,-357
2016,9,24,7,390,398,53,-345
2016,9,24,8,379,386,51,-335
2016,9,24,9,376,384,51,-333
2016,9,24,10,386,389,51,-338
2016,9,24,11,400,411,51,-360
2016,9,24,12,426,430,50,-380
2016,9,24,13,461,466,62,-404
2016,9,24,14,493,497,73,-424
2016,9,24,15,522,529,72,-457
2016,9,24,16,546,553,94,-459
2016,9,24,17,578,580,279,-301
2016,9,24,18,586,617,350,-267
2016,9,24,19,606,643,348,-295
2016,9,24,20,623,675,352,-323
2016,9,24,21,643,693,349,-344
2016,9,24,22,642,702,350,-352
2016,9,24,23,640,682,348,-334
2016,9,25,0,625,655,348,-307
2016,9,25,1,605,635,338,-297
2016,9,25,2,569,589,262,-327
2016,9,25,3,520,537,138,-399
2016,9,25,4,468,481,114,-367
2016,9,25,5,439,437,66,-371
2016,9,25,6,406,403,48,-355
2016,9,25,7,384,388,51,-337
2016,9,25,8,371,381,49,-332
2016,9,25,9,366,371,49,-322
2016,9,25,10,371,379,50,-329
2016,9,25,11,383,390,49,-341
2016,9,25,12,409,412,50,-362
2016,9,25,13,450,458,83,-375
2016,9,25,14,480,491,124,-367
2016,9,25,15,501,517,122,-395
2016,9,25,16,519,545,120,-425
2016,9,25,17,543,585,198,-387
2016,9,25,18,561,620,284,-336
2016,9,25,19,568,649,299,-350
2016,9,25,20,582,659,284,-375
2016,9,25,21,598,657,289,-368
2016,9,25,22,598,656,330,-326
2016,9,25,23,604,644,320,-324
2016,9,26,0,607,638,312,-326
2016,9,26,1,595,629,314,-315
2016,9,26,2,557,588,302,-286
2016,9,26,3,507,537,250,-287
2016,9,26,4,460,481,152,-329
2016,9,26,5,437,446,103,-343
2016,9,26,6,410,418,55,-363
2016,9,26,7,393,408,53,-355
2016,9,26,8,383,397,52,-345
2016,9,26,9,388,402,53,-349
2016,9,26,10,417,439,67,-372
2016,9,26,11,483,497,117,-380
2016,9,26,12,515,529,121,-408
2016,9,26,13,526,543,120,-423
2016,9,26,14,548,576,121,-455
2016,9,26,15,574,597,215,-382
2016,9,26,16,592,631,280,-351
2016,9,26,17,621,662,293,-369
2016,9,26,18,644,674,267,-407
2016,9,26,19,640,663,251,-412
2016,9,26,20,641,638,252,-386
2016,9,26,21,650,635,253,-382
2016,9,26,22,644,632,273,-359
2016,9,26,23,639,630,290,-340
2016,9,27,0,632,627,289,-338
2016,9,27,1,623,611,276,-335
2016,9,27,2,577,560,188,-372
2016,9,27,3,522,515,80,-435
2016,9,27,4,469,471,50,-421
2016,9,27,5,443,431,50,-381
2016,9,27,6,419,411,50,-361
2016,9,27,7,402,396,50,-346
2016,9,27,8,394,392,50,-342
2016,9,27,9,397,397,50,-347
2016,9,27,10,428,424,50,-374
2016,9,27,11,491,495,51,-444
2016,9,27,12,522,527,75,-452
2016,9,27,13,529,536,75,-461
2016,9,27,14,543,549,77,-472
2016,9,27,15,562,560,94,-466
2016,9,27,16,575,580,213,-367
2016,9,27,17,589,600,235,-365
2016,9,27,18,616,618,248,-370
2016,9,27,19,617,633,258,-375
2016,9,27,20,619,652,278,-374
2016,9,27,21,626,657,285,-372
2016,9,27,22,621,654,288,-366
2016,9,27,23,611,637,283,-354
2016,9,28,0,606,632,284,-348
2016,9,28,1,595,627,277,-350
2016,9,28,2,553,574,155,-419
2016,9,28,3,500,514,119,-395
2016,9,28,4,450,461,70,-391
2016,9,28,5,424,424,58,-366
2016,9,28,6,401,398,57,-341
2016,9,28,7,384,385,55,-330
2016,9,28,8,378,378,52,-326
2016,9,28,9,382,387,52,-335
2016,9,28,10,413,417,54,-363
2016,9,28,11,479,488,59,-429
2016,9,28,12,505,519,58,-461
2016,9,28,13,510,526,58,-468
2016,9,28,14,525,540,67,-473
2016,9,28,15,541,554,95,-459
2016,9,28,16,558,569,100,-469
2016,9,28,17,576,582,136,-446
2016,9,28,18,598,607,251,-356
2016,9,28,19,605,634,295,-339
2016,9,28,20,612,644,308,-336
2016,9,28,21,627,652,304,-348
2016,9,28,22,631,651,315,-336
2016,9,28,23,625,633,312,-321
2016,9,29,0,618,617,305,-312
2016,9,29,1,603,611,319,-292
2016,9,29,2,559,551,156,-395
2016,9,29,3,507,493,155,-338
2016,9,29,4,455,442,81,-361
2016,9,29,5,423,404,50,-354
2016,9,29,6,398,381,50,-331
2016,9,29,7,382,369,50,-319
2016,9,29,8,378,364,51,-313
2016,9,29,9,382,369,51,-318
2016,9,29,10,412,398,52,-346
2016,9,29,11,480,465,51,-414
2016,9,29,12,504,493,51,-442
2016,9,29,13,504,501,51,-450
2016,9,29,14,519,507,50,-457
2016,9,29,15,530,517,49,-468
2016,9,29,16,540,531,58,-473
2016,9,29,17,548,535,79,-456
2016,9,29,18,565,543,76,-467
2016,9,29,19,575,542,78,-464
2016,9,29,20,581,540,75,-465
2016,9,29,21,592,555,76,-479
2016,9,29,22,597,556,77,-479
2016,9,29,23,594,547,80,-467
2016,9,30,0,595,554,90,-464
2016,9,30,1,589,552,115,-437
2016,9,30,2,548,518,113,-405
2016,9,30,3,496,468,70,-398
2016,9,30,4,445,416,56,-360
2016,9,30,5,409,385,56,-329
2016,9,30,6,387,367,57,-310
2016,9,30,7,375,358,57,-301
2016,9,30,8,372,356,54,-302
2016,9,30,9,380,360,51,-309
2016,9,30,10,410,390,52,-338
2016,9,30,11,476,455,56,-399
2016,9,30,12,502,484,67,-417
2016,9,30,13,505,492,67,-425
2016,9,30,14,518,497,76,-421
2016,9,30,15,522,503,77,-426
2016,9,30,16,529,504,78,-426
2016,9,30,17,531,508,81,-427
2016,9,30,18,540,512,81,-431
2016,9,30,19,553,517,84,-433
2016,9,30,20,563,521,84,-437
2016,9,30,21,567,525,93,-432
2016,9,30,22,570,523,105,-418
2016,9,30,23,561,525,101,-424
2016,10,1,0,564,529,91,-438
2016,10,1,1,556,520,90,-430
2016,10,1,2,515,498,73,-425
2016,10,1,3,477,463,54,-409
2016,10,1,4,433,425,55,-370
2016,10,1,5,396,392,55,-337
2016,10,1,6,376,365,54,-311
2016,10,1,7,363,354,54,-300
2016,10,1,8,360,358,53,-305
2016,10,1,9,362,356,55,-301
2016,10,1,10,372,368,54,-314
2016,10,1,11,395,390,53,-337
2016,10,1,12,429,423,54,-369
2016,10,1,13,466,454,53,-401
2016,10,1,14,491,472,58,-414
2016,10,1,15,498,478,57,-421
2016,10,1,16,495,474,57,-417
2016,10,1,17,488,471,60,-411
2016,10,1,18,481,471,126,-345
2016,10,1,19,486,479,152,-327
2016,10,1,20,495,486,151,-335
2016,10,1,21,499,495,167,-328
2016,10,1,22,503,500,174,-326
2016,10,1,23,503,499,146,-353
2016,10,2,0,516,511,126,-385
2016,10,2,1,513,507,126,-381
2016,10,2,2,482,481,101,-380
2016,10,2,3,447,449,67,-382
2016,10,2,4,409,409,51,-358
2016,10,2,5,377,374,50,-324
2016,10,2,6,359,357,50,-307
2016,10,2,7,351,346,52,-294
2016,10,2,8,349,343,52,-291
2016,10,2,9,349,344,53,-291
2016,10,2,10,358,349,51,-298
2016,10,2,11,378,370,52,-318
2016,10,2,12,411,403,53,-350
2016,10,2,13,456,442,51,-391
2016,10,2,14,482,466,54,-412
2016,10,2,15,481,466,51,-415
2016,10,2,16,478,468,52,-416
2016,10,2,17,482,478,51,-427
2016,10,2,18,481,487,53,-434
2016,10,2,19,491,489,60,-429
2016,10,2,20,503,489,98,-391
2016,10,2,21,511,497,95,-402
2016,10,2,22,527,511,101,-410
2016,10,2,23,536,512,95,-417
2016,10,3,0,552,538,104,-434
2016,10,3,1,549,530,96,-434
2016,10,3,2,511,494,76,-418
2016,10,3,3,465,457,58,-399
2016,10,3,4,419,408,52,-356
2016,10,3,5,377,379,54,-325
2016,10,3,6,358,358,54,-304
2016,10,3,7,349,348,52,-296
2016,10,3,8,348,349,54,-295
2016,10,3,9,357,362,54,-308
2016,10,3,10,389,393,53,-340
2016,10,3,11,460,457,53,-404
2016,10,3,12,494,496,72,-424
2016,10,3,13,502,501,73,-428
2016,10,3,14,516,512,72,-440
2016,10,3,15,526,516,71,-445
2016,10,3,16,537,523,77,-446
2016,10,3,17,537,532,96,-436
2016,10,3,18,549,540,94,-446
2016,10,3,19,555,541,88,-453
2016,10,3,20,567,542,115,-427
2016,10,3,21,575,549,122,-427
2016,10,3,22,579,553,120,-433
2016,10,3,23,586,562,123,-439
2016,10,4,0,594,582,119,-463
2016,10,4,1,585,573,118,-455
2016,10,4,2,542,540,83,-457
2016,10,4,3,489,487,62,-425
2016,10,4,4,441,435,56,-379
2016,10,4,5,409,407,59,-348
2016,10,4,6,394,387,56,-331
2016,10,4,7,384,382,58,-324
2016,10,4,8,379,374,56,-318
2016,10,4,9,388,385,57,-328
2016,10,4,10,419,413,56,-357
2016,10,4,11,487,480,59,-421
2016,10,4,12,520,517,92,-425
2016,10,4,13,524,517,89,-428
2016,10,4,14,532,526,91,-435
2016,10,4,15,541,537,92,-445
2016,10,4,16,548,506,99,-407
2016,10,4,17,548,545,182,-363
2016,10,4,18,550,549,211,-338
2016,10,4,19,555,554,225,-329
2016,10,4,20,563,556,239,-317
2016,10,4,21,570,561,234,-327
2016,10,4,22,571,562,240,-322
2016,10,4,23,570,564,250,-314
2016,10,5,0,587,582,260,-322
2016,10,5,1,579,576,263,-313
2016,10,5,2,541,536,160,-376
2016,10,5,3,486,484,96,-388
2016,10,5,4,438,439,62,-377
2016,10,5,5,403,404,54,-350
2016,10,5,6,380,384,49,-335
2016,10,5,7,369,376,52,-324
2016,10,5,8,368,372,49,-323
2016,10,5,9,376,380,49,-331
2016,10,5,10,407,413,51,-362
2016,10,5,11,475,476,54,-422
2016,10,5,12,508,511,71,-440
2016,10,5,13,514,515,71,-444
2016,10,5,14,524,522,70,-452
2016,10,5,15,530,531,71,-460
2016,10,5,16,534,536,71,-465
2016,10,5,17,533,540,72,-468
2016,10,5,18,537,546,73,-473
2016,10,5,19,546,552,73,-479
2016,10,5,20,552,564,74,-490
2016,10,5,21,556,578,72,-506
2016,10,5,22,554,576,90,-486
2016,10,5,23,556,566,123,-443
2016,10,6,0,571,575,143,-432
2016,10,6,1,561,570,151,-419
2016,10,6,2,525,536,120,-416
2016,10,6,3,477,484,75,-409
2016,10,6,4,431,430,53,-377
2016,10,6,5,402,392,45,-347
2016,10,6,6,385,381,50,-331
2016,10,6,7,377,372,50,-322
2016,10,6,8,376,367,50,-317
2016,10,6,9,385,378,51,-327
2016,10,6,10,418,411,52,-359
2016,10,6,11,491,475,52,-423
2016,10,6,12,525,511,80,-431
2016,10,6,13,528,518,82,-436
2016,10,6,14,533,527,81,-446
2016,10,6,15,534,532,81,-451
2016,10,6,16,527,528,81,-447
2016,10,6,17,529,531,81,-450
2016,10,6,18,528,536,91,-445
2016,10,6,19,536,539,101,-438
2016,10,6,20,542,545,104,-441
2016,10,6,21,543,555,128,-427
2016,10,6,22,552,557,130,-427
2016,10,6,23,554,557,131,-426
2016,10,7,0,579,569,134,-435
2016,10,7,1,576,570,139,-431
2016,10,7,2,541,534,111,-423
2016,10,7,3,490,485,67,-418
2016,10,7,4,443,435,51,-384
2016,10,7,5,403,399,51,-348
2016,10,7,6,385,385,52,-333
2016,10,7,7,371,375,50,-325
2016,10,7,8,368,374,52,-322
2016,10,7,9,376,379,53,-326
2016,10,7,10,405,412,56,-356
2016,10,7,11,472,474,86,-388
2016,10,7,12,504,515,92,-423
2016,10,7,13,513,523,92,-431
2016,10,7,14,524,534,112,-422
2016,10,7,15,530,543,134,-409
2016,10,7,16,533,545,151,-394
2016,10,7,17,526,543,166,-377
2016,10,7,18,530,541,165,-376
2016,10,7,19,529,539,154,-385
2016,10,7,20,532,535,168,-367
2016,10,7,21,535,535,188,-347
2016,10,7,22,532,534,187,-347
2016,10,7,23,525,544,188,-356
2016,10,8,0,540,553,189,-364
2016,10,8,1,533,545,187,-358
2016,10,8,2,505,518,187,-331
2016,10,8,3,467,482,191,-291
2016,10,8,4,427,440,162,-278
2016,10,8,5,407,409,114,-295
2016,10,8,6,383,391,68,-323
2016,10,8,7,368,373,54,-319
2016,10,8,8,363,370,56,-314
2016,10,8,9,363,367,55,-312
2016,10,8,10,373,382,54,-328
2016,10,8,11,392,400,53,-347
2016,10,8,12,426,432,66,-366
2016,10,8,13,462,467,90,-377
2016,10,8,14,497,501,122,-379
2016,10,8,15,512,519,124,-395
2016,10,8,16,518,520,127,-393
2016,10,8,17,518,518,127,-391
2016,10,8,18,510,510,142,-368
2016,10,8,19,505,504,127,-377
2016,10,8,20,500,503,128,-375
2016,10,8,21,503,505,107,-398
2016,10,8,22,497,512,89,-423
2016,10,8,23,488,510,62,-448
2016,10,9,0,505,516,62,-454
2016,10,9,1,495,505,63,-442
2016,10,9,2,472,477,63,-414
2016,10,9,3,443,444,63,-381
2016,10,9,4,411,402,63,-339
2016,10,9,5,390,370,62,-308
2016,10,9,6,372,356,63,-293
2016,10,9,7,363,344,62,-282
2016,10,9,8,360,343,58,-285
2016,10,9,9,361,342,54,-288
2016,10,9,10,368,356,53,-303
2016,10,9,11,390,376,53,-323
2016,10,9,12,425,416,55,-361
2016,10,9,13,472,464,53,-411
2016,10,9,14,495,484,54,-430
2016,10,9,15,491,474,53,-421
2016,10,9,16,484,461,52,-409
2016,10,9,17,482,460,54,-406
2016,10,9,18,484,453,52,-401
2016,10,9,19,481,449,52,-397
2016,10,9,20,478,450,54,-396
2016,10,9,21,482,459,52,-407
2016,10,9,22,497,476,53,-423
2016,10,9,23,511,489,53,-436
2016,10,10,0,541,517,87,-430
2016,10,10,1,527,514,94,-420
2016,10,10,2,490,481,69,-412
2016,10,10,3,452,447,54,-393
2016,10,10,4,415,414,52,-362
2016,10,10,5,395,385,53,-332
2016,10,10,6,382,370,53,-317
2016,10,10,7,380,366,53,-313
2016,10,10,8,383,363,53,-310
2016,10,10,9,396,376,52,-324
2016,10,10,10,442,412,59,-353
2016,10,10,11,521,484,77,-407
2016,10,10,12,565,527,75,-452
2016,10,10,13,567,549,77,-472
2016,10,10,14,563,548,76,-472
2016,10,10,15,550,545,76,-469
2016,10,10,16,537,540,77,-463
2016,10,10,17,529,525,76,-449
2016,10,10,18,525,525,76,-449
2016,10,10,19,517,520,77,-443
2016,10,10,20,517,516,76,-440
2016,10,10,21,517,529,77,-452
2016,10,10,22,523,534,76,-458
2016,10,10,23,538,544,76,-468
2016,10,11,0,569,569,77,-492
2016,10,11,1,559,557,76,-481
2016,10,11,2,522,522,76,-446
2016,10,11,3,472,475,62,-413
2016,10,11,4,433,431,56,-375
2016,10,11,5,411,399,56,-343
2016,10,11,6,397,388,58,-330
2016,10,11,7,393,380,56,-324
2016,10,11,8,397,380,57,-323
2016,10,11,9,409,396,56,-340
2016,10,11,10,455,431,57,-374
2016,10,11,11,539,511,56,-455
2016,10,11,12,579,551,58,-493
2016,10,11,13,578,552,56,-496
2016,10,11,14,569,546,58,-488
2016,10,11,15,551,534,56,-478
2016,10,11,16,537,523,55,-468
2016,10,11,17,526,519,57,-462
2016,10,11,18,521,512,57,-455
2016,10,11,19,514,509,56,-453
2016,10,11,20,513,511,56,-455
2016,10,11,21,514,519,58,-461
2016,10,11,22,520,529,56,-473
2016,10,11,23,531,538,57,-481
2016,10,12,0,568,560,57,-503
2016,10,12,1,562,554,52,-502
2016,10,12,2,527,521,52,-469
2016,10,12,3,478,472,54,-418
2016,10,12,4,438,421,51,-370
2016,10,12,5,411,402,53,-349
2016,10,12,6,399,389,52,-337
2016,10,12,7,395,385,52,-333
2016,10,12,8,399,390,53,-337
2016,10,12,9,417,403,52,-351
2016,10,12,10,463,446,52,-394
2016,10,12,11,548,523,74,-449
2016,10,12,12,590,566,95,-471
2016,10,12,13,586,571,94,-477
2016,10,12,14,574,557,87,-470
2016,10,12,15,559,541,87,-454
2016,10,12,16,540,525,92,-433
2016,10,12,17,530,515,91,-424
2016,10,12,18,527,512,90,-422
2016,10,12,19,528,509,91,-418
2016,10,12,20,530,516,102,-414
2016,10,12,21,532,523,120,-403
2016,10,12,22,538,534,122,-412
2016,10,12,23,546,540,100,-440
2016,10,13,0,572,563,102,-461
2016,10,13,1,560,557,102,-455
2016,10,13,2,526,525,91,-434
2016,10,13,3,479,475,68,-407
2016,10,13,4,438,436,57,-379
2016,10,13,5,399,402,47,-355
2016,10,13,6,385,392,48,-344
2016,10,13,7,382,388,48,-340
2016,10,13,8,382,385,46,-339
2016,10,13,9,392,401,53,-348
2016,10,13,10,427,445,59,-386
2016,10,13,11,501,521,63,-458
2016,10,13,12,542,557,61,-496
2016,10,13,13,546,553,61,-492
2016,10,13,14,547,546,61,-485
2016,10,13,15,543,534,61,-473
2016,10,13,16,539,529,61,-468
2016,10,13,17,537,525,62,-463
2016,10,13,18,548,524,61,-463
2016,10,13,19,552,521,69,-452
2016,10,13,20,560,523,66,-457
2016,10,13,21,567,528,101,-427
2016,10,13,22,572,535,132,-403
2016,10,13,23,572,543,145,-398
2016,10,14,0,592,569,205,-364
2016,10,14,1,582,561,207,-354
2016,10,14,2,541,527,159,-368
2016,10,14,3,491,478,113,-365
2016,10,14,4,442,434,61,-373
2016,10,14,5,399,399,57,-342
2016,10,14,6,380,380,55,-325
2016,10,14,7,372,372,54,-318
2016,10,14,8,372,372,54,-318
2016,10,14,9,384,384,55,-329
2016,10,14,10,417,417,57,-360
2016,10,14,11,486,486,74,-412
2016,10,14,12,526,526,131,-395
2016,10,14,13,530,530,136,-394
2016,10,14,14,533,533,136,-397
2016,10,14,15,529,529,136,-393
2016,10,14,16,523,523,135,-388
2016,10,14,17,517,517,136,-381
2016,10,14,18,517,517,136,-381
2016,10,14,19,516,516,137,-379
2016,10,14,20,513,513,136,-377
2016,10,14,21,516,516,136,-380
2016,10,14,22,517,517,135,-382
2016,10,14,23,519,519,136,-383
2016,10,15,0,537,537,148,-389
2016,10,15,1,528,528,122,-406
2016,10,15,2,503,503,107,-396
2016,10,15,3,474,474,83,-391
2016,10,15,4,433,433,89,-344
2016,10,15,5,397,397,78,-319
2016,10,15,6,377,377,48,-329
2016,10,15,7,369,369,49,-320
2016,10,15,8,358,358,48,-310
2016,10,15,9,363,363,48,-315
2016,10,15,10,375,375,50,-325
2016,10,15,11,394,394,50,-344
2016,10,15,12,430,430,50,-380
2016,10,15,13,466,466,50,-416
2016,10,15,14,485,485,56,-429
2016,10,15,15,494,494,72,-422
2016,10,15,16,495,495,63,-432
2016,10,15,17,497,497,58,-439
2016,10,15,18,498,498,58,-440
2016,10,15,19,500,500,65,-435
2016,10,15,20,509,509,121,-388
2016,10,15,21,515,515,151,-364
2016,10,15,22,516,516,150,-366
2016,10,15,23,516,516,151,-365
2016,10,16,0,531,531,152,-379
2016,10,16,1,518,518,151,-367
2016,10,16,2,491,491,150,-341
2016,10,16,3,457,457,149,-308
2016,10,16,4,418,418,113,-305
2016,10,16,5,383,383,89,-294
2016,10,16,6,363,363,52,-311
2016,10,16,7,348,348,49,-299
2016,10,16,8,347,347,49,-298
2016,10,16,9,346,346,49,-297
2016,10,16,10,355,355,49,-306
2016,10,16,11,375,375,50,-325
2016,10,16,12,408,408,57,-351
2016,10,16,13,446,446,78,-368
2016,10,16,14,470,470,77,-393
2016,10,16,15,472,472,72,-400
2016,10,16,16,478,478,74,-404
2016,10,16,17,488,488,114,-374
2016,10,16,18,493,493,153,-340
2016,10,16,19,496,496,163,-333
2016,10,16,20,496,496,181,-315
2016,10,16,21,505,505,177,-328
2016,10,16,22,521,521,174,-347
2016,10,16,23,525,525,172,-353
2016,10,17,0,546,546,172,-374
2016,10,17,1,538,538,142,-396
2016,10,17,2,503,503,108,-395
2016,10,17,3,454,454,71,-383
2016,10,17,4,414,414,51,-363
2016,10,17,5,385,385,53,-332
2016,10,17,6,367,367,51,-316
2016,10,17,7,358,358,53,-305
2016,10,17,8,353,353,49,-304
2016,10,17,9,364,364,52,-312
2016,10,17,10,402,402,52,-350
2016,10,17,11,469,469,60,-409
2016,10,17,12,502,502,67,-435
2016,10,17,13,522,522,68,-454
2016,10,17,14,529,529,68,-461
2016,10,17,15,530,530,67,-463
2016,10,17,16,535,535,71,-464
2016,10,17,17,545,545,83,-462
2016,10,17,18,554,554,120,-434
2016,10,17,19,560,560,127,-433
2016,10,17,20,566,566,127,-439
2016,10,17,21,577,577,127,-450
2016,10,17,22,584,584,158,-426
2016,10,17,23,576,576,220,-356
2016,10,18,0,600,600,219,-381
2016,10,18,1,580,580,132,-448
2016,10,18,2,542,542,60,-482
2016,10,18,3,487,487,56,-431
2016,10,18,4,434,434,55,-379
2016,10,18,5,402,399,55,-344
2016,10,18,6,385,382,56,-326
2016,10,18,7,373,371,55,-316
2016,10,18,8,368,366,56,-310
2016,10,18,9,377,374,56,-318
2016,10,18,10,409,406,55,-351
2016,10,18,11,476,476,57,-419
2016,10,18,12,514,509,72,-437
2016,10,18,13,521,520,78,-442
2016,10,18,14,521,523,77,-446
2016,10,18,15,528,533,77,-456
2016,10,18,16,540,539,77,-462
2016,10,18,17,546,547,84,-463
2016,10,18,18,564,559,121,-438
2016,10,18,19,574,566,121,-445
2016,10,18,20,588,575,126,-449
2016,10,18,21,602,586,176,-410
2016,10,18,22,606,591,247,-344
2016,10,18,23,610,591,263,-328
2016,10,19,0,622,609,302,-307
2016,10,19,1,605,590,197,-393
2016,10,19,2,565,548,100,-448
2016,10,19,3,506,494,71,-423
2016,10,19,4,455,440,52,-388
2016,10,19,5,416,404,53,-351
2016,10,19,6,392,387,53,-334
2016,10,19,7,376,374,54,-320
2016,10,19,8,371,369,53,-316
2016,10,19,9,378,380,53,-327
2016,10,19,10,405,409,52,-357
2016,10,19,11,471,480,80,-400
2016,10,19,12,509,517,92,-425
2016,10,19,13,522,522,87,-435
2016,10,19,14,537,531,89,-442
2016,10,19,15,554,537,86,-451
2016,10,19,16,567,552,96,-456
2016,10,19,17,585,559,107,-452
2016,10,19,18,600,576,133,-443
2016,10,19,19,609,587,178,-409
2016,10,19,20,621,603,255,-348
2016,10,19,21,640,622,276,-346
2016,10,19,22,638,618,277,-341
2016,10,19,23,631,617,254,-363
2016,10,20,0,629,628,258,-370
2016,10,20,1,615,608,243,-365
2016,10,20,2,579,564,135,-429
2016,10,20,3,519,508,82,-426
2016,10,20,4,463,464,66,-398
2016,10,20,5,418,421,60,-361
2016,10,20,6,394,397,57,-340
2016,10,20,7,379,381,55,-326
2016,10,20,8,370,381,58,-323
2016,10,20,9,374,381,55,-326
2016,10,20,10,402,415,56,-359
2016,10,20,11,468,478,61,-417
2016,10,20,12,504,516,103,-413
2016,10,20,13,515,519,102,-417
2016,10,20,14,526,530,102,-428
2016,10,20,15,545,546,119,-427
2016,10,20,16,553,558,138,-420
2016,10,20,17,568,575,153,-422
2016,10,20,18,579,587,208,-379
2016,10,20,19,587,603,270,-333
2016,10,20,20,594,611,290,-321
2016,10,20,21,606,612,278,-334
2016,10,20,22,606,607,275,-332
2016,10,20,23,602,608,276,-332
2016,10,21,0,606,626,280,-346
2016,10,21,1,592,598,275,-323
2016,10,21,2,557,562,201,-361
2016,10,21,3,501,511,188,-323
2016,10,21,4,449,455,125,-330
2016,10,21,5,425,415,71,-344
2016,10,21,6,399,397,56,-341
2016,10,21,7,380,382,53,-329
2016,10,21,8,370,380,55,-325
2016,10,21,9,377,385,54,-331
2016,10,21,10,404,411,82,-329
2016,10,21,11,473,475,159,-316
2016,10,21,12,512,511,184,-327
2016,10,21,13,523,511,181,-330
2016,10,21,14,530,523,168,-355
2016,10,21,15,541,528,143,-385
2016,10,21,16,542,522,143,-379
2016,10,21,17,539,521,164,-357
2016,10,21,18,532,515,183,-332
2016,10,21,19,528,507,174,-333
2016,10,21,20,523,504,158,-346
2016,10,21,21,530,506,146,-360
2016,10,21,22,544,511,158,-353
2016,10,21,23,554,528,158,-370
2016,10,22,0,577,555,176,-379
2016,10,22,1,570,552,174,-378
2016,10,22,2,546,527,173,-354
2016,10,22,3,512,503,157,-346
2016,10,22,4,475,464,124,-340
2016,10,22,5,444,433,73,-360
2016,10,22,6,429,416,55,-361
2016,10,22,7,423,411,54,-357
2016,10,22,8,427,410,54,-356
2016,10,22,9,438,418,54,-364
2016,10,22,10,459,438,54,-384
2016,10,22,11,493,464,54,-410
2016,10,22,12,538,509,54,-455
2016,10,22,13,571,550,55,-495
2016,10,22,14,573,570,55,-515
2016,10,22,15,560,566,54,-512
2016,10,22,16,540,550,53,-497
2016,10,22,17,520,530,55,-475
2016,10,22,18,499,513,56,-457
2016,10,22,19,487,493,54,-439
2016,10,22,20,483,488,54,-434
2016,10,22,21,491,488,54,-434
2016,10,22,22,509,502,55,-447
2016,10,22,23,525,525,56,-469
2016,10,23,0,555,559,105,-454
2016,10,23,1,550,561,123,-438
2016,10,23,2,532,542,131,-411
2016,10,23,3,504,514,103,-411
2016,10,23,4,474,485,71,-414
2016,10,23,5,464,458,54,-404
2016,10,23,6,452,443,53,-390
2016,10,23,7,448,440,51,-389
2016,10,23,8,453,442,50,-392
2016,10,23,9,458,446,49,-397
2016,10,23,10,471,471,59,-412
2016,10,23,11,500,501,88,-413
2016,10,23,12,538,546,122,-424
2016,10,23,13,574,591,129,-462
2016,10,23,14,571,587,103,-484
2016,10,23,15,542,549,62,-487
2016,10,23,16,514,513,59,-454
2016,10,23,17,497,492,58,-434
2016,10,23,18,485,474,56,-418
2016,10,23,19,473,463,57,-406
2016,10,23,20,467,462,58,-404
2016,10,23,21,471,469,57,-412
2016,10,23,22,487,485,58,-427
2016,10,23,23,509,507,71,-436
2016,10,24,0,535,544,123,-421
2016,10,24,1,527,534,126,-408
2016,10,24,2,494,505,85,-420
2016,10,24,3,455,468,58,-410
2016,10,24,4,422,430,53,-377
2016,10,24,5,397,412,53,-359
2016,10,24,6,385,406,56,-350
2016,10,24,7,382,403,52,-351
2016,10,24,8,384,409,55,-354
2016,10,24,9,397,426,60,-366
2016,10,24,10,441,472,63,-409
2016,10,24,11,518,547,121,-426
2016,10,24,12,563,588,143,-445
2016,10,24,13,567,588,139,-449
2016,10,24,14,564,574,122,-452
2016,10,24,15,553,552,85,-467
2016,10,24,16,540,537,64,-473
2016,10,24,17,536,521,56,-465
2016,10,24,18,528,521,93,-428
2016,10,24,19,525,516,121,-395
2016,10,24,20,529,518,122,-396
2016,10,24,21,534,525,121,-404
2016,10,24,22,538,532,119,-413
2016,10,24,23,553,546,126,-420
2016,10,25,0,572,574,134,-440
2016,10,25,1,559,554,136,-418
2016,10,25,2,520,516,136,-380
2016,10,25,3,474,473,137,-336
2016,10,25,4,429,427,137,-290
2016,10,25,5,403,400,139,-261
2016,10,25,6,389,388,131,-257
2016,10,25,7,385,386,61,-325
2016,10,25,8,386,391,50,-341
2016,10,25,9,400,411,51,-360
2016,10,25,10,436,457,51,-406
2016,10,25,11,515,538,83,-455
2016,10,25,12,561,586,109,-477
2016,10,25,13,568,585,135,-450
2016,10,25,14,568,571,141,-430
2016,10,25,15,556,552,142,-410
2016,10,25,16,547,531,140,-391
2016,10,25,17,537,518,141,-377
2016,10,25,18,531,515,142,-373
2016,10,25,19,525,509,142,-367
2016,10,25,20,521,506,143,-363
2016,10,25,21,524,514,143,-371
2016,10,25,22,532,521,141,-380
2016,10,25,23,548,539,141,-398
2016,10,26,0,572,568,142,-426
2016,10,26,1,559,553,142,-411
2016,10,26,2,532,522,141,-381
2016,10,26,3,485,479,129,-350
2016,10,26,4,443,434,124,-310
2016,10,26,5,415,410,66,-344
2016,10,26,6,403,402,53,-349
2016,10,26,7,398,402,54,-348
2016,10,26,8,402,407,53,-354
2016,10,26,9,416,428,53,-375
2016,10,26,10,465,474,63,-411
2016,10,26,11,547,558,148,-410
2016,10,26,12,590,572,256,-316
2016,10,26,13,588,603,314,-289
2016,10,26,14,577,586,168,-418
2016,10,26,15,556,560,143,-417
2016,10,26,16,539,538,142,-396
2016,10,26,17,527,515,140,-375
2016,10,26,18,520,512,141,-371
2016,10,26,19,514,507,141,-366
2016,10,26,20,510,509,145,-364
2016,10,26,21,514,515,142,-373
2016,10,26,22,523,517,142,-375
2016,10,26,23,541,539,143,-396
2016,10,27,0,562,565,176,-389
2016,10,27,1,548,551,192,-359
2016,10,27,2,520,521,193,-328
2016,10,27,3,479,475,173,-302
2016,10,27,4,437,431,72,-359
2016,10,27,5,405,401,52,-349
2016,10,27,6,393,389,52,-337
2016,10,27,7,388,381,62,-319
2016,10,27,8,388,383,78,-305
2016,10,27,9,399,391,77,-314
2016,10,27,10,436,430,77,-353
2016,10,27,11,515,504,90,-414
2016,10,27,12,558,543,118,-425
2016,10,27,13,559,545,122,-423
2016,10,27,14,555,547,110,-437
2016,10,27,15,547,542,80,-462
2016,10,27,16,537,534,55,-479
2016,10,27,17,533,530,53,-477
2016,10,27,18,528,525,73,-452
2016,10,27,19,528,512,111,-401
2016,10,27,20,533,505,123,-382
2016,10,27,21,539,513,131,-382
2016,10,27,22,546,516,151,-365
2016,10,27,23,554,531,166,-365
2016,10,28,0,572,560,188,-372
2016,10,28,1,557,556,190,-366
2016,10,28,2,524,519,191,-328
2016,10,28,3,478,424,150,-274
2016,10,28,4,432,771,108,-663
2016,10,28,5,399,401,55,-346
2016,10,28,6,381,386,55,-331
2016,10,28,7,370,379,54,-325
2016,10,28,8,367,379,54,-325
2016,10,28,9,374,392,56,-336
2016,10,28,10,404,422,55,-367
2016,10,28,11,471,496,86,-410
2016,10,28,12,505,537,168,-369
2016,10,28,13,520,539,172,-367
2016,10,28,14,531,536,174,-362
2016,10,28,15,529,531,174,-357
2016,10,28,16,532,521,175,-346
2016,10,28,17,525,515,176,-339
2016,10,28,18,524,511,173,-338
2016,10,28,19,527,509,174,-335
2016,10,28,20,532,515,172,-343
2016,10,28,21,534,514,173,-341
2016,10,28,22,534,518,185,-333
2016,10,28,23,535,523,186,-337
2016,10,29,0,544,537,187,-350
2016,10,29,1,525,520,187,-333
2016,10,29,2,495,496,139,-357
2016,10,29,3,462,457,66,-391
2016,10,29,4,425,425,61,-364
2016,10,29,5,400,394,63,-331
2016,10,29,6,382,376,62,-314
2016,10,29,7,371,369,62,-307
2016,10,29,8,367,369,62,-307
2016,10,29,9,369,374,61,-313
2016,10,29,10,380,396,63,-333
2016,10,29,11,406,425,62,-363
2016,10,29,12,445,464,61,-403
2016,10,29,13,477,504,61,-443
2016,10,29,14,501,514,61,-453
2016,10,29,15,507,513,64,-449
2016,10,29,16,508,498,61,-437
2016,10,29,17,503,487,61,-426
2016,10,29,18,505,483,62,-421
2016,10,29,19,513,486,60,-426
2016,10,29,20,522,490,59,-431
2016,10,29,21,531,500,58,-442
2016,10,29,22,543,506,56,-450
2016,10,29,23,552,507,55,-452
2016,10,30,0,552,520,57,-463
2016,10,30,1,536,498,55,-443
2016,10,30,2,505,476,56,-420
2016,10,30,3,468,444,57,-387
2016,10,30,4,426,406,56,-350
2016,10,30,5,388,375,55,-320
2016,10,30,6,366,359,55,-304
2016,10,30,7,353,350,56,-294
2016,10,30,8,350,345,54,-291
2016,10,30,9,350,351,57,-294
2016,10,30,10,357,362,55,-307
2016,10,30,11,375,389,56,-333
2016,10,30,12,413,430,57,-373
2016,10,30,13,455,469,57,-412
2016,10,30,14,487,487,56,-431
2016,10,30,15,489,476,54,-422
2016,10,30,16,494,471,55,-416
2016,10,30,17,504,471,54,-417
2016,10,30,18,509,475,56,-419
2016,10,30,19,517,471,56,-415
2016,10,30,20,530,476,55,-421
2016,10,30,21,540,490,65,-425
2016,10,30,22,559,504,121,-383
2016,10,30,23,565,515,127,-388
2016,10,31,0,571,539,125,-414
2016,10,31,1,554,522,125,-397
2016,10,31,2,515,490,128,-362
2016,10,31,3,470,449,126,-323
2016,10,31,4,424,406,125,-281
2016,10,31,5,383,378,108,-270
2016,10,31,6,364,361,63,-298
2016,10,31,7,350,351,59,-292
2016,10,31,8,347,350,59,-291
2016,10,31,9,357,362,59,-303
2016,10,31,10,388,401,59,-342
2016,10,31,11,454,469,94,-375
2016,10,31,12,495,516,121,-395
2016,10,31,13,509,519,112,-407
2016,10,31,14,523,524,101,-423
2016,10,31,15,537,529,101,-428
2016,10,31,16,543,523,99,-424
2016,10,31,17,550,530,100,-430
2016,10,31,18,556,538,104,-434
2016,10,31,19,561,538,145,-393
2016,10,31,20,569,551,153,-398
2016,10,31,21,577,553,161,-392
2016,10,31,22,581,546,161,-385
2016,10,31,23,589,541,132,-409
2016,11,1,0,593,542,118,-424
2016,11,1,1,574,535,121,-414
2016,11,1,2,536,516,122,-394
2016,11,1,3,485,475,83,-392
2016,11,1,4,437,426,54,-372
2016,11,1,5,411,392,51,-341
2016,11,1,6,392,374,50,-324
2016,11,1,7,378,371,52,-319
2016,11,1,8,372,366,51,-315
2016,11,1,9,381,379,54,-325
2016,11,1,10,413,407,93,-314
2016,11,1,11,476,470,158,-312
2016,11,1,12,518,511,193,-318
2016,11,1,13,532,516,191,-325
2016,11,1,14,538,521,189,-332
2016,11,1,15,552,527,190,-337
2016,11,1,16,555,528,192,-336
2016,11,1,17,552,534,191,-343
2016,11,1,18,565,539,192,-347
2016,11,1,19,567,547,193,-354
2016,11,1,20,565,553,193,-360
2016,11,1,21,569,560,193,-367
2016,11,1,22,570,562,192,-370
2016,11,1,23,575,572,193,-379
2016,11,2,0,590,595,190,-405
2016,11,2,1,571,569,192,-377
2016,11,2,2,534,532,188,-344
2016,11,2,3,488,478,125,-353
2016,11,2,4,441,430,67,-363
2016,11,2,5,408,397,58,-339
2016,11,2,6,389,381,60,-321
2016,11,2,7,376,368,56,-312
2016,11,2,8,373,369,59,-310
2016,11,2,9,384,376,57,-319
2016,11,2,10,417,409,57,-352
2016,11,2,11,483,481,58,-423
2016,11,2,12,528,519,58,-461
2016,11,2,13,535,524,59,-465
2016,11,2,14,540,524,57,-467
2016,11,2,15,543,524,58,-466
2016,11,2,16,542,523,56,-467
2016,11,2,17,538,527,58,-469
2016,11,2,18,545,530,66,-464
2016,11,2,19,549,533,113,-420
2016,11,2,20,552,537,116,-421
2016,11,2,21,562,540,113,-427
2016,11,2,22,567,551,146,-405
2016,11,2,23,575,565,182,-383
2016,11,3,0,587,577,210,-367
2016,11,3,1,572,553,154,-399
2016,11,3,2,540,521,112,-409
2016,11,3,3,496,476,58,-418
2016,11,3,4,448,431,56,-375
2016,11,3,5,408,401,53,-348
2016,11,3,6,386,383,52,-331
2016,11,3,7,373,372,52,-320
2016,11,3,8,370,368,53,-315
2016,11,3,9,383,376,60,-316
2016,11,3,10,415,414,104,-310
2016,11,3,11,480,487,144,-343
2016,11,3,12,523,525,140,-385
2016,11,3,13,531,530,142,-388
2016,11,3,14,538,531,141,-390
2016,11,3,15,540,530,141,-389
2016,11,3,16,538,526,143,-383
2016,11,3,17,536,525,149,-376
2016,11,3,18,545,527,148,-379
2016,11,3,19,546,525,149,-376
2016,11,3,20,550,528,169,-359
2016,11,3,21,561,530,197,-333
2016,11,3,22,563,533,260,-273
2016,11,3,23,574,553,261,-292
2016,11,4,0,588,574,257,-317
2016,11,4,1,574,557,209,-348
2016,11,4,2,539,525,190,-335
2016,11,4,3,495,480,183,-297
2016,11,4,4,449,434,161,-273
2016,11,4,5,413,401,98,-303
2016,11,4,6,394,384,64,-320
2016,11,4,7,383,371,63,-308
2016,11,4,8,381,362,61,-301
2016,11,4,9,394,377,63,-314
2016,11,4,10,426,407,62,-345
2016,11,4,11,489,472,76,-396
2016,11,4,12,533,511,121,-390
2016,11,4,13,545,499,132,-367
2016,11,4,14,548,519,100,-419
2016,11,4,15,543,520,102,-418
2016,11,4,16,532,522,81,-441
2016,11,4,17,526,517,69,-448
2016,11,4,18,521,514,166,-348
2016,11,4,19,511,521,129,-392
2016,11,4,20,502,506,122,-384
2016,11,4,21,502,500,211,-289
2016,11,4,22,508,510,134,-376
2016,11,4,23,529,516,124,-392
2016,11,5,0,549,538,126,-412
2016,11,5,1,541,519,125,-394
2016,11,5,2,520,502,124,-378
2016,11,5,3,499,470,126,-344
2016,11,5,4,461,441,126,-315
2016,11,5,5,437,420,128,-292
2016,11,5,6,422,409,126,-283
2016,11,5,7,413,403,129,-274
2016,11,5,8,414,405,115,-290
2016,11,5,9,427,421,56,-365
2016,11,5,10,454,449,53,-396
2016,11,5,11,489,483,52,-431
2016,11,5,12,540,535,51,-484
2016,11,5,13,579,572,50,-522
2016,11,5,14,581,585,51,-534
2016,11,5,15,564,557,51,-506
2016,11,5,16,538,526,51,-475
2016,11,5,17,512,499,49,-450
2016,11,5,18,493,481,51,-430
2016,11,5,19,482,471,51,-420
2016,11,5,20,471,471,52,-419
2016,11,5,21,477,472,51,-421
2016,11,5,22,486,490,51,-439
2016,11,5,23,511,507,68,-439
2016,11,6,0,532,528,102,-426
2016,11,6,1,525,515,99,-416
2016,11,6,2,508,495,100,-395
2016,11,6,3,486,474,100,-374
2016,11,6,4,454,450,100,-350
2016,11,6,5,424,424,100,-324
2016,11,6,6,414,411,99,-312
2016,11,6,7,412,411,98,-313
2016,11,6,8,418,418,101,-317
2016,11,6,9,432,420,97,-323
2016,11,6,10,458,432,98,-334
2016,11,6,11,497,459,99,-360
2016,11,6,12,529,498,100,-398
2016,11,6,13,552,548,100,-448
2016,11,6,14,538,572,99,-473
2016,11,6,15,501,550,99,-451
2016,11,6,16,476,515,90,-425
2016,11,6,17,464,487,56,-431
2016,11,6,18,455,479,52,-427
2016,11,6,19,446,465,50,-415
2016,11,6,20,451,461,49,-412
2016,11,6,21,469,463,47,-416
2016,11,6,22,508,478,84,-394
2016,11,6,23,542,515,126,-389
2016,11,7,0,542,541,145,-396
2016,11,7,1,530,539,145,-394
2016,11,7,2,495,523,144,-379
2016,11,7,3,467,496,148,-348
2016,11,7,4,-9999,463,127,-336
2016,11,7,5,-9999,435,102,-333
2016,11,7,6,416,419,93,-326
2016,11,7,7,410,419,92,-327
2016,11,7,8,409,421,51,-370
2016,11,7,9,417,429,45,-384
2016,11,7,10,441,459,46,-413
2016,11,7,11,499,513,109,-404
2016,11,7,12,586,584,187,-397
2016,11,7,13,618,631,260,-371
2016,11,7,14,596,616,237,-379
2016,11,7,15,572,581,223,-358
2016,11,7,16,546,556,229,-327
2016,11,7,17,522,534,221,-313
2016,11,7,18,512,521,226,-295
2016,11,7,19,503,517,227,-290
2016,11,7,20,497,503,222,-281
2016,11,7,21,494,509,223,-286
2016,11,7,22,510,524,225,-299
2016,11,7,23,549,555,250,-305
2016,11,8,0,582,588,291,-297
2016,11,8,1,590,579,287,-292
2016,11,8,2,572,561,255,-306
2016,11,8,3,543,532,292,-240
2016,11,8,4,501,503,252,-251
2016,11,8,5,462,468,222,-246
2016,11,8,6,452,450,202,-248
2016,11,8,7,450,449,175,-274
2016,11,8,8,451,453,236,-217
2016,11,8,9,459,460,234,-226
2016,11,8,10,482,486,236,-250
2016,11,8,11,533,529,279,-250
2016,11,8,12,618,599,377,-222
2016,11,8,13,645,641,435,-206
2016,11,8,14,623,632,465,-167
2016,11,8,15,592,618,466,-152
2016,11,8,16,556,605,456,-149
2016,11,8,17,531,583,442,-141
2016,11,8,18,511,551,416,-135
2016,11,8,19,503,533,363,-170
2016,11,8,20,493,522,331,-191
2016,11,8,21,493,521,293,-228
2016,11,8,22,508,534,293,-241
2016,11,8,23,539,570,309,-261
2016,11,9,0,571,601,347,-254
2016,11,9,1,574,590,358,-232
2016,11,9,2,557,569,352,-217
2016,11,9,3,526,535,319,-216
2016,11,9,4,487,500,272,-228
2016,11,9,5,447,465,240,-225
2016,11,9,6,420,443,223,-220
2016,11,9,7,410,428,174,-254
2016,11,9,8,406,417,134,-283
2016,11,9,9,409,421,137,-284
2016,11,9,10,425,433,156,-277
2016,11,9,11,470,474,221,-253
2016,11,9,12,551,538,260,-278
2016,11,9,13,579,573,292,-281
2016,11,9,14,574,568,250,-318
2016,11,9,15,565,560,218,-342
2016,11,9,16,554,556,219,-337
2016,11,9,17,543,543,217,-326
2016,11,9,18,534,531,220,-311
2016,11,9,19,527,525,220,-305
2016,11,9,20,518,517,220,-297
2016,11,9,21,521,517,218,-299
2016,11,9,22,538,542,219,-323
2016,11,9,23,580,589,292,-297
2016,11,10,0,618,625,328,-297
2016,11,10,1,621,621,311,-310
2016,11,10,2,608,608,302,-306
2016,11,10,3,582,576,267,-309
2016,11,10,4,542,538,219,-319
2016,11,10,5,502,496,214,-282
2016,11,10,6,481,477,198,-279
2016,11,10,7,471,472,156,-316
2016,11,10,8,468,469,169,-300
2016,11,10,9,474,482,179,-303
2016,11,10,10,492,498,215,-283
2016,11,10,11,538,547,222,-325
2016,11,10,12,620,634,320,-314
2016,11,10,13,640,658,360,-298
2016,11,10,14,623,641,398,-243
2016,11,10,15,595,612,391,-221
2016,11,10,16,562,586,311,-275
2016,11,10,17,537,560,265,-295
2016,11,10,18,515,537,266,-271
2016,11,10,19,503,528,251,-277
2016,11,10,20,498,515,219,-296
2016,11,10,21,493,515,218,-297
2016,11,10,22,507,529,258,-271
2016,11,10,23,548,559,306,-253
2016,11,11,0,580,593,351,-242
2016,11,11,1,588,591,312,-279
2016,11,11,2,580,587,311,-276
2016,11,11,3,552,565,292,-273
2016,11,11,4,518,538,294,-244
2016,11,11,5,483,502,267,-235
2016,11,11,6,480,486,261,-225
2016,11,11,7,478,476,253,-223
2016,11,11,8,482,475,248,-227
2016,11,11,9,495,485,262,-223
2016,11,11,10,516,499,264,-235
2016,11,11,11,547,535,287,-248
2016,11,11,12,608,595,381,-214
2016,11,11,13,650,633,394,-239
2016,11,11,14,645,624,375,-249
2016,11,11,15,616,603,349,-254
2016,11,11,16,584,579,300,-279
2016,11,11,17,555,564,256,-308
2016,11,11,18,527,542,223,-319
2016,11,11,19,519,529,237,-292
2016,11,11,20,508,521,262,-259
2016,11,11,21,498,522,268,-254
2016,11,11,22,505,533,267,-266
2016,11,11,23,535,565,278,-287
2016,11,12,0,556,582,318,-264
2016,11,12,1,544,580,299,-281
2016,11,12,2,522,564,271,-293
2016,11,12,3,500,542,270,-272
2016,11,12,4,480,517,247,-270
2016,11,12,5,447,488,262,-226
2016,11,12,6,439,468,261,-207
2016,11,12,7,430,465,265,-200
2016,11,12,8,427,467,248,-219
2016,11,12,9,431,470,251,-219
2016,11,12,10,444,483,264,-219
2016,11,12,11,475,517,266,-251
2016,11,12,12,515,551,260,-291
2016,11,12,13,551,591,267,-324
2016,11,12,14,576,607,263,-344
2016,11,12,15,578,589,260,-329
2016,11,12,16,566,566,207,-359
2016,11,12,17,548,536,181,-355
2016,11,12,18,528,515,185,-330
2016,11,12,19,513,495,183,-312
2016,11,12,20,507,484,181,-303
2016,11,12,21,510,486,205,-281
2016,11,12,22,529,506,273,-233
2016,11,12,23,588,553,343,-210
2016,11,13,0,617,582,349,-233
2016,11,13,1,612,582,356,-226
2016,11,13,2,609,579,340,-239
2016,11,13,3,594,567,341,-226
2016,11,13,4,571,549,308,-241
2016,11,13,5,551,521,261,-260
2016,11,13,6,499,508,266,-242
2016,11,13,7,492,505,264,-241
2016,11,13,8,492,507,260,-247
2016,11,13,9,499,508,260,-248
2016,11,13,10,511,523,259,-264
2016,11,13,11,539,552,261,-291
2016,11,13,12,579,579,271,-308
2016,11,13,13,614,628,299,-329
2016,11,13,14,642,655,285,-370
2016,11,13,15,619,639,284,-355
2016,11,13,16,580,605,254,-351
2016,11,13,17,550,568,253,-315
2016,11,13,18,528,541,224,-317
2016,11,13,19,508,510,227,-283
2016,11,13,20,498,497,243,-254
2016,11,13,21,501,492,253,-239
2016,11,13,22,513,512,256,-256
2016,11,13,23,562,558,283,-275
2016,11,14,0,590,596,255,-341
2016,11,14,1,586,593,252,-341
2016,11,14,2,579,588,262,-326
2016,11,14,3,551,559,252,-307
2016,11,14,4,519,530,255,-275
2016,11,14,5,486,499,251,-248
2016,11,14,6,470,486,253,-233
2016,11,14,7,462,487,252,-235
2016,11,14,8,463,497,251,-246
2016,11,14,9,468,508,239,-269
2016,11,14,10,489,530,231,-299
2016,11,14,11,539,584,298,-286
2016,11,14,12,619,664,393,-271
2016,11,14,13,644,695,403,-292
2016,11,14,14,631,674,312,-362
2016,11,14,15,606,638,270,-368
2016,11,14,16,582,599,266,-333
2016,11,14,17,558,566,264,-302
2016,11,14,18,542,543,267,-276
2016,11,14,19,528,533,273,-260
2016,11,14,20,518,522,275,-247
2016,11,14,21,517,521,275,-246
2016,11,14,22,527,537,342,-195
2016,11,14,23,572,576,480,-96
2016,11,15,0,609,613,520,-93
2016,11,15,1,619,614,477,-137
2016,11,15,2,605,601,423,-178
2016,11,15,3,575,580,344,-236
2016,11,15,4,530,538,214,-324
2016,11,15,5,494,506,171,-335
2016,11,15,6,475,493,151,-342
2016,11,15,7,470,494,118,-376
2016,11,15,8,470,499,142,-357
2016,11,15,9,478,512,155,-357
2016,11,15,10,499,540,232,-308
2016,11,15,11,548,594,284,-310
2016,11,15,12,634,687,339,-348
2016,11,15,13,657,716,344,-372
2016,11,15,14,640,698,344,-354
2016,11,15,15,611,650,304,-346
2016,11,15,16,579,603,261,-342
2016,11,15,17,555,567,237,-330
2016,11,15,18,535,537,215,-322
2016,11,15,19,522,531,216,-315
2016,11,15,20,515,519,215,-304
2016,11,15,21,514,519,216,-303
2016,11,15,22,527,537,248,-289
2016,11,15,23,568,576,285,-291
2016,11,16,0,595,615,342,-273
2016,11,16,1,602,615,339,-276
2016,11,16,2,585,604,341,-263
2016,11,16,3,555,579,341,-238
2016,11,16,4,516,537,309,-228
2016,11,16,5,476,497,238,-259
2016,11,16,6,457,476,189,-287
2016,11,16,7,451,470,180,-290
2016,11,16,8,449,470,181,-289
2016,11,16,9,459,474,182,-292
2016,11,16,10,478,494,182,-312
2016,11,16,11,529,543,257,-286
2016,11,16,12,612,630,334,-296
2016,11,16,13,639,661,346,-315
2016,11,16,14,623,646,347,-299
2016,11,16,15,597,606,348,-258
2016,11,16,16,568,567,347,-220
2016,11,16,17,545,542,347,-195
2016,11,16,18,526,518,347,-171
2016,11,16,19,516,515,337,-178
2016,11,16,20,508,509,327,-182
2016,11,16,21,506,510,321,-189
2016,11,16,22,520,522,321,-201
2016,11,16,23,558,558,332,-226
2016,11,17,0,589,589,347,-242
2016,11,17,1,585,586,347,-239
2016,11,17,2,570,579,344,-235
2016,11,17,3,544,551,303,-248
2016,11,17,4,508,511,257,-254
2016,11,17,5,469,477,211,-266
2016,11,17,6,444,459,148,-311
2016,11,17,7,436,455,127,-328
2016,11,17,8,434,459,128,-331
2016,11,17,9,439,470,125,-345
2016,11,17,10,459,498,148,-350
2016,11,17,11,504,550,174,-376
2016,11,17,12,590,638,262,-376
2016,11,17,13,612,667,331,-336
2016,11,17,14,593,646,339,-307
2016,11,17,15,573,605,341,-264
2016,11,17,16,551,563,340,-223
2016,11,17,17,535,531,320,-211
2016,11,17,18,519,517,229,-288
2016,11,17,19,511,503,168,-335
2016,11,17,20,503,499,160,-339
2016,11,17,21,506,498,157,-341
2016,11,17,22,519,509,159,-350
2016,11,17,23,552,539,200,-339
2016,11,18,0,573,569,302,-267
2016,11,18,1,564,567,290,-277
2016,11,18,2,544,550,272,-278
2016,11,18,3,518,532,277,-255
2016,11,18,4,481,487,243,-244
2016,11,18,5,442,455,123,-332
2016,11,18,6,430,436,112,-324
2016,11,18,7,420,434,114,-320
2016,11,18,8,417,435,112,-323
2016,11,18,9,419,444,114,-330
2016,11,18,10,441,469,161,-308
2016,11,18,11,485,521,272,-249
2016,11,18,12,569,607,279,-328
2016,11,18,13,597,644,305,-339
2016,11,18,14,589,627,291,-336
2016,11,18,15,574,587,235,-352
2016,11,18,16,553,548,174,-374
2016,11,18,17,538,522,146,-376
2016,11,18,18,518,501,130,-371
2016,11,18,19,509,499,133,-366
2016,11,18,20,504,492,133,-359
2016,11,18,21,509,490,132,-358
2016,11,18,22,513,499,132,-367
2016,11,18,23,543,526,142,-384
2016,11,19,0,555,542,181,-361
2016,11,19,1,537,529,178,-351
2016,11,19,2,517,519,118,-401
2016,11,19,3,492,497,104,-393
2016,11,19,4,458,470,105,-365
2016,11,19,5,422,436,106,-330
2016,11,19,6,408,417,105,-312
2016,11,19,7,396,410,108,-302
2016,11,19,8,392,408,110,-298
2016,11,19,9,391,417,108,-309
2016,11,19,10,400,429,105,-324
2016,11,19,11,427,452,147,-305
2016,11,19,12,464,493,177,-316
2016,11,19,13,499,531,175,-356
2016,11,19,14,533,558,176,-382
2016,11,19,15,547,565,176,-389
2016,11,19,16,548,551,177,-374
2016,11,19,17,539,542,179,-363
2016,11,19,18,529,541,155,-386
2016,11,19,19,517,535,140,-395
2016,11,19,20,511,527,141,-386
2016,11,19,21,512,541,145,-396
2016,11,19,22,537,572,179,-393
2016,11,19,23,594,632,224,-408
2016,11,20,0,620,657,246,-411
2016,11,20,1,619,658,245,-413
2016,11,20,2,613,649,241,-408
2016,11,20,3,597,638,244,-394
2016,11,20,4,579,616,245,-371
2016,11,20,5,555,585,217,-368
2016,11,20,6,558,568,192,-376
2016,11,20,7,554,561,193,-368
2016,11,20,8,561,560,192,-368
2016,11,20,9,572,570,195,-375
2016,11,20,10,593,582,238,-344
2016,11,20,11,621,607,251,-356
2016,11,20,12,661,648,299,-349
2016,11,20,13,698,691,322,-369
2016,11,20,14,725,718,346,-372
2016,11,20,15,713,699,331,-368
2016,11,20,16,673,660,316,-344
2016,11,20,17,641,622,238,-384
2016,11,20,18,612,600,197,-403
2016,11,20,19,587,582,190,-392
2016,11,20,20,564,568,190,-378
2016,11,20,21,565,575,191,-384
2016,11,20,22,588,600,205,-395
2016,11,20,23,658,673,271,-402
2016,11,21,0,684,708,335,-373
2016,11,21,1,688,717,343,-374
2016,11,21,2,686,710,346,-364
2016,11,21,3,664,681,347,-334
2016,11,21,4,639,641,343,-298
2016,11,21,5,609,612,345,-267
2016,11,21,6,596,593,331,-262
2016,11,21,7,595,590,321,-269
2016,11,21,8,601,588,317,-271
2016,11,21,9,616,601,318,-283
2016,11,21,10,647,622,330,-292
2016,11,21,11,694,643,414,-229
2016,11,21,12,779,756,452,-304
2016,11,21,13,813,783,450,-333
2016,11,21,14,784,764,383,-381
2016,11,21,15,745,725,376,-349
2016,11,21,16,704,690,379,-311
2016,11,21,17,666,655,374,-281
2016,11,21,18,634,622,333,-289
2016,11,21,19,608,600,304,-296
2016,11,21,20,590,582,275,-307
2016,11,21,21,590,582,260,-322
2016,11,21,22,608,606,299,-307
2016,11,21,23,662,679,365,-314
2016,11,22,0,706,729,377,-352
2016,11,22,1,700,735,376,-359
2016,11,22,2,698,725,377,-348
2016,11,22,3,669,702,359,-343
2016,11,22,4,636,654,283,-371
2016,11,22,5,600,619,266,-353
2016,11,22,6,568,606,233,-373
2016,11,22,7,561,596,231,-365
2016,11,22,8,567,600,233,-367
2016,11,22,9,580,602,231,-371
2016,11,22,10,608,623,297,-326
2016,11,22,11,657,658,394,-264
2016,11,22,12,733,740,445,-295
2016,11,22,13,766,764,431,-333
2016,11,22,14,743,755,379,-376
2016,11,22,15,687,712,376,-336
2016,11,22,16,646,670,378,-292
2016,11,22,17,614,628,317,-311
2016,11,22,18,583,596,218,-378
2016,11,22,19,563,575,177,-398
2016,11,22,20,549,546,195,-351
2016,11,22,21,553,544,228,-316
2016,11,22,22,565,574,279,-295
2016,11,22,23,614,620,311,-309
2016,11,23,0,646,654,313,-341
2016,11,23,1,645,659,311,-348
2016,11,23,2,638,651,311,-340
2016,11,23,3,612,633,314,-319
2016,11,23,4,572,595,312,-283
2016,11,23,5,537,562,314,-248
2016,11,23,6,517,538,314,-224
2016,11,23,7,512,529,315,-214
2016,11,23,8,510,522,314,-208
2016,11,23,9,521,526,314,-212
2016,11,23,10,543,541,315,-226
2016,11,23,11,591,576,314,-262
2016,11,23,12,664,624,350,-274
2016,11,23,13,705,661,378,-283
2016,11,23,14,706,668,363,-305
2016,11,23,15,678,656,314,-342
2016,11,23,16,645,622,315,-307
2016,11,23,17,613,589,299,-290
2016,11,23,18,581,562,258,-304
2016,11,23,19,561,553,243,-310
2016,11,23,20,548,534,234,-300
2016,11,23,21,545,527,214,-313
2016,11,23,22,559,545,229,-316
2016,11,23,23,599,581,295,-286
2016,11,24,0,624,596,300,-296
2016,11,24,1,617,592,306,-286
2016,11,24,2,602,579,303,-276
2016,11,24,3,572,553,301,-252
2016,11,24,4,535,524,243,-281
2016,11,24,5,491,475,149,-326
2016,11,24,6,462,448,115,-333
2016,11,24,7,440,426,112,-314
2016,11,24,8,431,416,112,-304
2016,11,24,9,431,414,113,-301
2016,11,24,10,436,413,111,-302
2016,11,24,11,461,431,112,-319
2016,11,24,12,489,453,112,-341
2016,11,24,13,533,489,113,-376
2016,11,24,14,558,525,142,-383
2016,11,24,15,584,545,153,-392
2016,11,24,16,589,553,163,-390
2016,11,24,17,581,549,164,-385
2016,11,24,18,547,517,142,-375
2016,11,24,19,510,485,105,-380
2016,11,24,20,489,464,110,-354
2016,11,24,21,467,445,114,-331
2016,11,24,22,468,440,118,-322
2016,11,24,23,481,458,158,-300
2016,11,25,0,501,467,162,-305
2016,11,25,1,496,470,115,-355
2016,11,25,2,492,468,115,-353
2016,11,25,3,481,464,116,-348
2016,11,25,4,457,446,114,-332
2016,11,25,5,431,427,114,-313
2016,11,25,6,404,413,112,-301
2016,11,25,7,396,410,115,-295
2016,11,25,8,387,412,113,-299
2016,11,25,9,390,424,113,-311
2016,11,25,10,398,438,113,-325
2016,11,25,11,417,466,112,-354
2016,11,25,12,459,505,112,-393
2016,11,25,13,498,542,132,-410
2016,11,25,14,513,560,148,-412
2016,11,25,15,515,550,147,-403
2016,11,25,16,496,522,138,-384
2016,11,25,17,479,470,84,-386
2016,11,25,18,459,471,113,-358
2016,11,25,19,443,459,115,-344
2016,11,25,20,436,451,114,-337
2016,11,25,21,431,450,113,-337
2016,11,25,22,454,462,114,-348
2016,11,25,23,499,503,155,-348
2016,11,26,0,530,528,183,-345
2016,11,26,1,528,526,183,-343
2016,11,26,2,516,521,183,-338
2016,11,26,3,493,505,181,-324
2016,11,26,4,471,484,182,-302
2016,11,26,5,444,455,172,-283
2016,11,26,6,423,434,120,-314
2016,11,26,7,417,426,118,-308
2016,11,26,8,418,423,115,-308
2016,11,26,9,426,436,117,-319
2016,11,26,10,440,448,118,-330
2016,11,26,11,467,476,119,-357
2016,11,26,12,506,514,119,-395
2016,11,26,13,550,558,117,-441
2016,11,26,14,579,600,123,-477
2016,11,26,15,578,604,127,-477
2016,11,26,16,558,586,115,-471
2016,11,26,17,528,558,115,-443
2016,11,26,18,507,534,116,-418
2016,11,26,19,484,512,117,-395
2016,11,26,20,471,500,115,-385
2016,11,26,21,474,504,116,-388
2016,11,26,22,499,522,113,-409
2016,11,26,23,559,580,153,-427
2016,11,27,0,587,615,223,-392
2016,11,27,1,589,632,224,-408
2016,11,27,2,591,634,223,-411
2016,11,27,3,578,631,224,-407
2016,11,27,4,556,610,221,-389
2016,11,27,5,537,591,223,-368
2016,11,27,6,539,579,225,-354
2016,11,27,7,537,578,222,-356
2016,11,27,8,541,590,225,-365
2016,11,27,9,555,604,222,-382
2016,11,27,10,574,622,223,-399
2016,11,27,11,602,653,265,-388
2016,11,27,12,640,694,299,-395
2016,11,27,13,683,744,302,-442
2016,11,27,14,714,765,306,-459
2016,11,27,15,678,717,308,-409
2016,11,27,16,622,652,265,-387
2016,11,27,17,577,591,173,-418
2016,11,27,18,547,554,111,-443
2016,11,27,19,521,527,109,-418
2016,11,27,20,502,512,114,-398
2016,11,27,21,506,517,115,-402
2016,11,27,22,525,539,162,-377
2016,11,27,23,583,600,227,-373
2016,11,28,0,612,632,299,-333
2016,11,28,1,611,640,300,-340
2016,11,28,2,609,633,298,-335
2016,11,28,3,583,611,301,-310
2016,11,28,4,553,579,301,-278
2016,11,28,5,520,549,304,-245
2016,11,28,6,492,524,276,-248
2016,11,28,7,488,517,156,-361
2016,11,28,8,488,511,112,-399
2016,11,28,9,499,513,109,-404
2016,11,28,10,523,529,146,-383
2016,11,28,11,573,573,260,-313
2016,11,28,12,650,647,289,-358
2016,11,28,13,691,651,355,-296
2016,11,28,14,691,671,365,-306
2016,11,28,15,680,656,325,-331
2016,11,28,16,654,648,185,-463
2016,11,28,17,631,644,172,-472
2016,11,28,18,608,628,163,-465
2016,11,28,19,596,613,146,-467
2016,11,28,20,577,601,146,-455
2016,11,28,21,574,607,125,-482
2016,11,28,22,594,616,152,-464
2016,11,28,23,620,659,255,-404
2016,11,29,0,635,677,303,-374
2016,11,29,1,617,659,306,-353
2016,11,29,2,591,636,306,-330
2016,11,29,3,557,595,287,-308
2016,11,29,4,512,544,220,-324
2016,11,29,5,466,492,175,-317
2016,11,29,6,476,452,139,-313
2016,11,29,7,457,435,126,-309
2016,11,29,8,445,420,107,-313
2016,11,29,9,441,414,108,-306
2016,11,29,10,454,423,107,-316
2016,11,29,11,480,459,109,-350
2016,11,29,12,544,524,110,-414
2016,11,29,13,576,555,174,-381
2016,11,29,14,572,557,187,-370
2016,11,29,15,564,565,190,-375
2016,11,29,16,556,553,186,-367
2016,11,29,17,550,529,184,-345
2016,11,29,18,539,512,193,-319
2016,11,29,19,538,505,192,-313
2016,11,29,20,529,503,193,-310
2016,11,29,21,530,510,194,-316
2016,11,29,22,548,510,193,-317
2016,11,29,23,580,493,214,-279
2016,11,30,0,593,517,222,-295
2016,11,30,1,576,544,222,-322
2016,11,30,2,558,553,185,-368
2016,11,30,3,530,533,173,-360
2016,11,30,4,480,484,170,-314
2016,11,30,5,437,444,135,-309
2016,11,30,6,408,416,106,-310
2016,11,30,7,388,396,101,-295
2016,11,30,8,376,386,105,-281
2016,11,30,9,371,383,103,-280
2016,11,30,10,382,393,102,-291
2016,11,30,11,419,427,102,-325
2016,11,30,12,499,487,157,-330
2016,11,30,13,530,522,227,-295
2016,11,30,14,533,521,188,-333
2016,11,30,15,530,529,168,-361
2016,11,30,16,527,531,150,-381
2016,11,30,17,525,536,150,-386
2016,11,30,18,515,514,131,-383
2016,11,30,19,519,534,151,-383
2016,11,30,20,517,533,149,-384
2016,11,30,21,520,535,148,-387
2016,11,30,22,540,554,162,-392
2016,11,30,23,583,580,336,-244
2016,12,1,0,604,593,404,-189
2016,12,1,1,595,585,410,-175
2016,12,1,2,581,570,387,-183
2016,12,1,3,557,537,302,-235
2016,12,1,4,521,486,223,-263
2016,12,1,5,480,450,138,-312
2016,12,1,6,438,431,104,-327
2016,12,1,7,426,425,105,-320
2016,12,1,8,423,427,102,-325
2016,12,1,9,427,441,104,-337
2016,12,1,10,446,467,105,-362
2016,12,1,11,493,522,105,-417
2016,12,1,12,581,603,133,-470
2016,12,1,13,616,646,203,-443
2016,12,1,14,613,646,175,-471
2016,12,1,15,607,624,198,-426
2016,12,1,16,591,596,175,-421
2016,12,1,17,576,574,173,-401
2016,12,1,18,561,544,162,-382
2016,12,1,19,555,537,172,-365
2016,12,1,20,550,529,174,-355
2016,12,1,21,548,534,172,-362
2016,12,1,22,567,560,175,-385
2016,12,1,23,617,618,216,-402
2016,12,2,0,655,665,389,-276
2016,12,2,1,657,673,374,-299
2016,12,2,2,661,678,285,-393
2016,12,2,3,643,659,234,-425
2016,12,2,4,600,623,184,-439
2016,12,2,5,565,585,167,-418
2016,12,2,6,562,554,128,-426
2016,12,2,7,554,550,124,-426
2016,12,2,8,555,559,128,-431
2016,12,2,9,567,569,130,-439
2016,12,2,10,592,587,127,-460
2016,12,2,11,639,634,188,-446
2016,12,2,12,710,717,285,-432
2016,12,2,13,735,751,397,-354
2016,12,2,14,727,732,406,-326
2016,12,2,15,704,695,347,-348
2016,12,2,16,666,650,315,-335
2016,12,2,17,640,616,261,-355
2016,12,2,18,606,585,197,-388
2016,12,2,19,588,567,177,-390
2016,12,2,20,577,551,178,-373
2016,12,2,21,578,548,175,-373
2016,12,2,22,594,581,179,-402
2016,12,2,23,638,633,219,-414
2016,12,3,0,675,663,265,-398
2016,12,3,1,669,664,285,-379
2016,12,3,2,664,659,288,-371
2016,12,3,3,644,644,291,-353
2016,12,3,4,619,609,291,-318
2016,12,3,5,583,574,287,-287
2016,12,3,6,547,552,246,-306
2016,12,3,7,536,537,193,-344
2016,12,3,8,536,535,163,-372
2016,12,3,9,543,535,126,-409
2016,12,3,10,556,548,160,-388
2016,12,3,11,583,577,209,-368
2016,12,3,12,619,610,284,-326
2016,12,3,13,656,649,309,-340
2016,12,3,14,686,667,306,-361
2016,12,3,15,678,668,301,-367
2016,12,3,16,648,634,263,-371
2016,12,3,17,615,600,222,-378
2016,12,3,18,586,576,208,-368
2016,12,3,19,558,568,219,-349
2016,12,3,20,543,563,221,-342
2016,12,3,21,539,567,222,-345
2016,12,3,22,557,584,225,-359
2016,12,3,23,607,626,302,-324
2016,12,4,0,632,639,340,-299
2016,12,4,1,626,629,341,-288
2016,12,4,2,622,620,341,-279
2016,12,4,3,605,595,339,-256
2016,12,4,4,576,565,339,-226
2016,12,4,5,541,528,340,-188
2016,12,4,6,524,502,230,-272
2016,12,4,7,508,486,116,-370
2016,12,4,8,502,474,111,-363
2016,12,4,9,504,472,110,-362
2016,12,4,10,513,480,113,-367
2016,12,4,11,532,496,112,-384
2016,12,4,12,563,526,114,-412
2016,12,4,13,598,560,111,-449
2016,12,4,14,634,603,139,-464
2016,12,4,15,646,626,209,-417
2016,12,4,16,632,632,237,-395
2016,12,4,17,616,624,234,-390
2016,12,4,18,613,633,236,-397
2016,12,4,19,603,631,238,-393
2016,12,4,20,596,622,239,-383
2016,12,4,21,599,627,239,-388
2016,12,4,22,615,655,239,-416
2016,12,4,23,668,687,275,-412
2016,12,5,0,676,697,370,-327
2016,12,5,1,668,684,375,-309
2016,12,5,2,656,668,376,-292
2016,12,5,3,623,629,377,-252
2016,12,5,4,584,581,377,-204
2016,12,5,5,543,543,378,-165
2016,12,5,6,527,507,377,-130
2016,12,5,7,512,483,308,-175
2016,12,5,8,508,485,186,-299
2016,12,5,9,511,490,108,-382
2016,12,5,10,529,496,104,-392
2016,12,5,11,566,535,133,-402
2016,12,5,12,637,614,202,-412
2016,12,5,13,671,637,228,-409
2016,12,5,14,666,634,235,-399
2016,12,5,15,653,624,274,-350
2016,12,5,16,631,609,325,-284
2016,12,5,17,607,582,315,-267
2016,12,5,18,588,564,285,-279
2016,12,5,19,576,559,276,-283
2016,12,5,20,558,556,276,-280
2016,12,5,21,552,559,275,-284
2016,12,5,22,575,590,305,-285
2016,12,5,23,618,631,339,-292
2016,12,6,0,649,644,353,-291
2016,12,6,1,648,639,353,-286
2016,12,6,2,638,616,353,-263
2016,12,6,3,608,590,323,-267
2016,12,6,4,556,543,264,-279
2016,12,6,5,511,493,166,-327
2016,12,6,6,475,472,130,-342
2016,12,6,7,460,454,123,-331
2016,12,6,8,454,451,124,-327
2016,12,6,9,457,454,125,-329
2016,12,6,10,473,474,123,-351
2016,12,6,11,509,516,193,-323
2016,12,6,12,582,593,310,-283
2016,12,6,13,622,634,352,-282
2016,12,6,14,626,636,351,-285
2016,12,6,15,627,643,351,-292
2016,12,6,16,617,646,350,-296
2016,12,6,17,606,646,349,-297
2016,12,6,18,592,643,352,-291
2016,12,6,19,587,625,349,-276
2016,12,6,20,574,598,351,-247
2016,12,6,21,575,597,348,-249
2016,12,6,22,601,615,356,-259
2016,12,6,23,641,659,376,-283
2016,12,7,0,671,677,375,-302
2016,12,7,1,671,666,378,-288
2016,12,7,2,664,646,377,-269
2016,12,7,3,638,607,376,-231
2016,12,7,4,589,561,354,-207
2016,12,7,5,543,515,283,-232
2016,12,7,6,475,487,157,-330
2016,12,7,7,460,478,126,-352
2016,12,7,8,454,478,127,-351
2016,12,7,9,457,483,126,-357
2016,12,7,10,473,507,134,-373
2016,12,7,11,509,556,261,-295
2016,12,7,12,582,639,358,-281
2016,12,7,13,622,680,376,-304
2016,12,7,14,626,668,379,-289
2016,12,7,15,627,638,345,-293
2016,12,7,16,617,604,320,-284
2016,12,7,17,606,576,295,-281
2016,12,7,18,592,549,279,-270
2016,12,7,19,587,539,257,-282
2016,12,7,20,574,523,249,-274
2016,12,7,21,575,525,248,-277
2016,12,7,22,601,539,245,-294
2016,12,7,23,641,601,372,-229
2016,12,8,0,671,635,452,-183
2016,12,8,1,671,639,453,-186
2016,12,8,2,664,631,431,-200
2016,12,8,3,638,610,372,-238
2016,12,8,4,589,565,239,-326
2016,12,8,5,543,522,183,-339
2016,12,8,6,693,495,126,-369
2016,12,8,7,693,487,122,-365
2016,12,8,8,700,481,120,-361
2016,12,8,9,713,486,123,-363
2016,12,8,10,742,508,122,-386
2016,12,8,11,797,560,184,-376
2016,12,8,12,875,645,326,-319
2016,12,8,13,913,689,373,-316
2016,12,8,14,898,697,302,-395
2016,12,8,15,873,707,238,-469
2016,12,8,16,905,706,213,-493
2016,12,8,17,865,702,187,-515
2016,12,8,18,826,695,183,-512
2016,12,8,19,800,689,185,-504
2016,12,8,20,783,690,184,-506
2016,12,8,21,780,693,185,-508
2016,12,8,22,788,715,191,-524
2016,12,8,23,841,776,269,-507
2016,12,9,0,858,812,369,-443
2016,12,9,1,850,811,403,-408
2016,12,9,2,852,805,405,-400
2016,12,9,3,829,782,376,-406
2016,12,9,4,801,742,230,-512
2016,12,9,5,769,706,196,-510
2016,12,9,6,675,689,177,-512
2016,12,9,7,672,685,172,-513
2016,12,9,8,682,695,174,-521
2016,12,9,9,700,707,174,-533
2016,12,9,10,732,735,193,-542
2016,12,9,11,781,792,267,-525
2016,12,9,12,864,865,468,-397
2016,12,9,13,896,907,534,-373
2016,12,9,14,889,891,510,-381
2016,12,9,15,860,869,427,-442
2016,12,9,16,815,831,292,-539
2016,12,9,17,775,791,268,-523
2016,12,9,18,735,750,256,-494
2016,12,9,19,715,725,251,-474
2016,12,9,20,695,710,215,-495
2016,12,9,21,691,705,193,-512
2016,12,9,22,728,739,199,-540
2016,12,9,23,797,814,304,-510
2016,12,10,0,823,848,373,-475
2016,12,10,1,827,849,381,-468
2016,12,10,2,831,847,382,-465
2016,12,10,3,822,836,379,-457
2016,12,10,4,793,813,380,-433
2016,12,10,5,762,785,381,-404
2016,12,10,6,748,768,381,-387
2016,12,10,7,745,764,378,-386
2016,12,10,8,749,771,380,-391
2016,12,10,9,753,785,380,-405
2016,12,10,10,771,804,379,-425
2016,12,10,11,793,827,394,-433
2016,12,10,12,830,880,545,-335
2016,12,10,13,868,917,541,-376
2016,12,10,14,878,937,529,-408
2016,12,10,15,859,888,450,-438
2016,12,10,16,803,820,376,-444
2016,12,10,17,753,760,277,-483
2016,12,10,18,709,709,198,-511
2016,12,10,19,668,668,141,-527
2016,12,10,20,640,646,140,-506
2016,12,10,21,631,637,161,-476
2016,12,10,22,666,674,210,-464
2016,12,10,23,731,737,248,-489
2016,12,11,0,765,776,253,-523
2016,12,11,1,773,783,256,-527
2016,12,11,2,763,783,255,-528
2016,12,11,3,751,776,255,-521
2016,12,11,4,722,751,256,-495
2016,12,11,5,689,725,258,-467
2016,12,11,6,669,700,256,-444
2016,12,11,7,659,692,257,-435
2016,12,11,8,662,688,255,-433
2016,12,11,9,670,692,254,-438
2016,12,11,10,689,701,253,-448
2016,12,11,11,709,725,260,-465
2016,12,11,12,741,753,312,-441
2016,12,11,13,788,792,373,-419
2016,12,11,14,819,815,361,-454
2016,12,11,15,799,769,267,-502
2016,12,11,16,742,710,237,-473
2016,12,11,17,698,664,203,-461
2016,12,11,18,668,636,182,-454
2016,12,11,19,638,621,181,-440
2016,12,11,20,610,626,174,-452
2016,12,11,21,606,633,125,-508
2016,12,11,22,624,651,124,-527
2016,12,11,23,689,687,174,-513
2016,12,12,0,712,709,225,-484
2016,12,12,1,709,708,282,-426
2016,12,12,2,701,694,301,-393
2016,12,12,3,673,657,291,-366
2016,12,12,4,633,616,280,-336
2016,12,12,5,590,566,258,-308
2016,12,12,6,559,528,154,-374
2016,12,12,7,543,506,124,-382
2016,12,12,8,537,492,123,-369
2016,12,12,9,542,489,111,-378
2016,12,12,10,558,494,112,-382
2016,12,12,11,600,532,137,-395
2016,12,12,12,668,599,191,-408
2016,12,12,13,706,631,209,-422
2016,12,12,14,701,629,187,-442
2016,12,12,15,689,630,180,-450
2016,12,12,16,664,624,170,-454
2016,12,12,17,631,604,142,-462
2016,12,12,18,606,587,134,-453
2016,12,12,19,589,572,134,-438
2016,12,12,20,571,559,125,-434
2016,12,12,21,565,559,121,-438
2016,12,12,22,588,576,124,-452
2016,12,12,23,638,627,142,-485
2016,12,13,0,668,675,192,-483
2016,12,13,1,669,672,195,-477
2016,12,13,2,661,671,197,-474
2016,12,13,3,632,648,197,-451
2016,12,13,4,586,608,126,-482
2016,12,13,5,541,570,115,-455
2016,12,13,6,530,543,106,-437
2016,12,13,7,517,546,112,-434
2016,12,13,8,513,544,115,-429
2016,12,13,9,519,560,166,-394
2016,12,13,10,539,578,180,-398
2016,12,13,11,583,630,235,-395
2016,12,13,12,663,712,310,-402
2016,12,13,13,704,751,346,-405
2016,12,13,14,699,746,344,-402
2016,12,13,15,684,729,333,-396
2016,12,13,16,658,713,314,-399
2016,12,13,17,631,697,298,-399
2016,12,13,18,606,681,286,-395
2016,12,13,19,591,668,287,-381
2016,12,13,20,580,643,287,-356
2016,12,13,21,579,641,286,-355
2016,12,13,22,603,662,287,-375
2016,12,13,23,657,694,325,-369
2016,12,14,0,689,702,386,-316
2016,12,14,1,694,700,420,-280
2016,12,14,2,686,680,418,-262
2016,12,14,3,662,645,383,-262
2016,12,14,4,618,595,319,-276
2016,12,14,5,575,549,283,-266
2016,12,14,6,560,512,207,-305
2016,12,14,7,547,503,171,-332
2016,12,14,8,543,498,172,-326
2016,12,14,9,549,505,171,-334
2016,12,14,10,567,529,174,-355
2016,12,14,11,610,568,187,-381
2016,12,14,12,685,651,259,-392
2016,12,14,13,723,692,326,-366
2016,12,14,14,713,696,357,-339
2016,12,14,15,697,695,355,-340
2016,12,14,16,672,687,324,-363
2016,12,14,17,646,664,293,-371
2016,12,14,18,618,640,290,-350
2016,12,14,19,604,636,288,-348
2016,12,14,20,596,634,290,-344
2016,12,14,21,597,641,289,-352
2016,12,14,22,622,662,289,-373
2016,12,14,23,677,707,345,-362
2016,12,15,0,715,756,447,-309
2016,12,15,1,727,766,449,-317
2016,12,15,2,725,769,449,-320
2016,12,15,3,706,756,404,-352
2016,12,15,4,673,717,375,-342
2016,12,15,5,631,678,311,-367
2016,12,15,6,614,660,268,-392
2016,12,15,7,613,651,263,-388
2016,12,15,8,629,645,263,-382
2016,12,15,9,650,652,253,-399
2016,12,15,10,682,666,251,-415
2016,12,15,11,733,714,264,-450
2016,12,15,12,812,807,341,-466
2016,12,15,13,853,862,373,-489
2016,12,15,14,852,862,382,-480
2016,12,15,15,834,855,388,-467
2016,12,15,16,804,830,376,-454
2016,12,15,17,774,806,348,-458
2016,12,15,18,740,784,343,-441
2016,12,15,19,718,771,344,-427
2016,12,15,20,703,762,338,-424
2016,12,15,21,712,776,347,-429
2016,12,15,22,765,825,383,-442
2016,12,15,23,827,884,478,-406
2016,12,16,0,878,941,609,-332
2016,12,16,1,881,933,569,-364
2016,12,16,2,896,933,437,-496
2016,12,16,3,876,899,414,-485
2016,12,16,4,839,861,393,-468
2016,12,16,5,802,812,308,-504
2016,12,16,6,829,800,258,-542
2016,12,16,7,827,791,256,-535
2016,12,16,8,832,788,258,-530
2016,12,16,9,845,792,255,-537
2016,12,16,10,866,812,289,-523
2016,12,16,11,907,909,381,-528
2016,12,16,12,970,972,437,-535
2016,12,16,13,998,954,436,-518
2016,12,16,14,990,878,380,-498
2016,12,16,15,966,874,341,-533
2016,12,16,16,912,908,358,-550
2016,12,16,17,855,876,335,-541
2016,12,16,18,807,849,334,-515
2016,12,16,19,780,808,264,-544
2016,12,16,20,759,779,261,-518
2016,12,16,21,750,770,258,-512
2016,12,16,22,771,813,294,-519
2016,12,16,23,832,825,299,-526
2016,12,17,0,850,835,300,-535
2016,12,17,1,841,789,261,-528
2016,12,17,2,822,806,267,-539
2016,12,17,3,798,791,258,-533
2016,12,17,4,757,743,254,-489
2016,12,17,5,715,692,255,-437
2016,12,17,6,683,664,263,-401
2016,12,17,7,661,639,264,-375
2016,12,17,8,644,622,262,-360
2016,12,17,9,632,616,266,-350
2016,12,17,10,627,608,262,-346
2016,12,17,11,640,624,262,-362
2016,12,17,12,665,638,323,-315
2016,12,17,13,691,657,362,-295
2016,12,17,14,703,677,406,-271
2016,12,17,15,695,676,382,-294
2016,12,17,16,675,647,240,-407
2016,12,17,17,644,620,191,-429
2016,12,17,18,612,587,190,-397
2016,12,17,19,586,562,162,-400
2016,12,17,20,570,542,89,-453
2016,12,17,21,556,531,119,-412
2016,12,17,22,569,545,154,-391
2016,12,17,23,602,576,217,-359
2016,12,18,0,607,598,167,-431
2016,12,18,1,592,584,78,-506
2016,12,18,2,578,569,56,-513
2016,12,18,3,561,547,56,-491
2016,12,18,4,523,512,56,-456
2016,12,18,5,480,472,57,-415
2016,12,18,6,454,435,55,-380
2016,12,18,7,428,413,55,-358
2016,12,18,8,409,402,58,-344
2016,12,18,9,399,393,57,-336
2016,12,18,10,405,393,57,-336
2016,12,18,11,416,404,56,-348
2016,12,18,12,434,425,59,-366
2016,12,18,13,483,453,58,-395
2016,12,18,14,520,490,56,-434
2016,12,18,15,535,524,57,-467
2016,12,18,16,537,536,57,-479
2016,12,18,17,531,536,56,-480
2016,12,18,18,536,545,58,-487
2016,12,18,19,537,547,58,-489
2016,12,18,20,540,552,60,-492
2016,12,18,21,542,560,59,-501
2016,12,18,22,585,594,61,-533
2016,12,18,23,652,647,159,-488
2016,12,19,0,683,681,203,-478
2016,12,19,1,690,689,200,-489
2016,12,19,2,682,691,145,-546
2016,12,19,3,666,673,130,-543
2016,12,19,4,633,636,123,-513
2016,12,19,5,599,608,108,-500
2016,12,19,6,558,579,127,-452
2016,12,19,7,548,574,117,-457
2016,12,19,8,550,578,117,-461
2016,12,19,9,560,582,128,-454
2016,12,19,10,589,607,146,-461
2016,12,19,11,645,657,237,-420
2016,12,19,12,723,735,261,-474
2016,12,19,13,765,774,261,-513
2016,12,19,14,760,779,259,-520
2016,12,19,15,748,782,262,-520
2016,12,19,16,728,763,261,-502
2016,12,19,17,697,737,262,-475
2016,12,19,18,672,707,275,-432
2016,12,19,19,651,687,264,-423
2016,12,19,20,635,661,264,-397
2016,12,19,21,635,653,263,-390
2016,12,19,22,670,674,305,-369
2016,12,19,23,725,728,444,-284
2016,12,20,0,757,763,475,-288
2016,12,20,1,761,765,396,-369
2016,12,20,2,764,750,301,-449
2016,12,20,3,742,725,263,-462
2016,12,20,4,705,679,249,-430
2016,12,20,5,659,635,154,-481
2016,12,20,6,644,599,78,-521
2016,12,20,7,635,587,52,-535
2016,12,20,8,630,581,49,-532
2016,12,20,9,638,590,49,-541
2016,12,20,10,661,607,53,-554
2016,12,20,11,708,650,169,-481
2016,12,20,12,783,727,294,-433
2016,12,20,13,825,772,302,-470
2016,12,20,14,815,776,323,-453
2016,12,20,15,786,769,299,-470
2016,12,20,16,746,749,242,-507
2016,12,20,17,706,688,195,-493
2016,12,20,18,667,637,162,-475
2016,12,20,19,638,614,132,-482
2016,12,20,20,620,580,117,-463
2016,12,20,21,619,581,122,-459
2016,12,20,22,646,602,118,-484
2016,12,20,23,698,664,168,-496
2016,12,21,0,741,718,270,-448
2016,12,21,1,744,734,284,-450
2016,12,21,2,743,743,291,-452
2016,12,21,3,719,734,295,-439
2016,12,21,4,677,718,293,-425
2016,12,21,5,633,684,242,-442
2016,12,21,6,613,662,223,-439
2016,12,21,7,608,666,232,-434
2016,12,21,8,606,670,236,-434
2016,12,21,9,620,685,272,-413
2016,12,21,10,644,701,314,-387
2016,12,21,11,693,743,393,-350
2016,12,21,12,758,804,475,-329
2016,12,21,13,804,846,481,-365
2016,12,21,14,797,848,484,-364
2016,12,21,15,764,804,461,-343
2016,12,21,16,713,746,339,-407
2016,12,21,17,661,591,136,-455
2016,12,21,18,618,446,13,-433
2016,12,21,19,587,439,13,-426
2016,12,21,20,567,423,13,-410
2016,12,21,21,561,413,12,-401
2016,12,21,22,576,418,12,-406
2016,12,21,23,619,454,11,-443
2016,12,22,0,650,452,11,-441
2016,12,22,1,646,408,11,-397
2016,12,22,2,643,355,11,-344
2016,12,22,3,625,353,11,-342
2016,12,22,4,596,369,12,-357
2016,12,22,5,551,387,11,-376
2016,12,22,6,540,501,126,-375
2016,12,22,7,528,485,103,-382
2016,12,22,8,527,489,102,-387
2016,12,22,9,532,494,103,-391
2016,12,22,10,553,517,102,-415
2016,12,22,11,596,550,117,-433
2016,12,22,12,659,558,223,-335
2016,12,22,13,710,672,352,-320
2016,12,22,14,717,695,369,-326
2016,12,22,15,701,701,293,-408
2016,12,22,16,667,620,177,-443
2016,12,22,17,624,587,117,-470
2016,12,22,18,581,559,106,-453
2016,12,22,19,557,546,107,-439
2016,12,22,20,538,532,105,-427
2016,12,22,21,532,534,107,-427
2016,12,22,22,540,556,107,-449
2016,12,22,23,585,605,117,-488
2016,12,23,0,620,647,150,-497
2016,12,23,1,624,658,158,-500
2016,12,23,2,627,661,163,-498
2016,12,23,3,619,652,156,-496
2016,12,23,4,593,631,142,-489
2016,12,23,5,557,598,137,-461
2016,12,23,6,531,583,117,-466
2016,12,23,7,526,570,119,-451
2016,12,23,8,530,562,117,-445
2016,12,23,9,543,557,116,-441
2016,12,23,10,571,570,117,-453
2016,12,23,11,616,592,115,-477
2016,12,23,12,681,631,140,-491
2016,12,23,13,735,671,209,-462
2016,12,23,14,767,692,262,-430
2016,12,23,15,758,681,224,-457
2016,12,23,16,712,639,196,-443
2016,12,23,17,640,601,136,-465
2016,12,23,18,577,570,118,-452
2016,12,23,19,548,545,115,-430
2016,12,23,20,528,532,117,-415
2016,12,23,21,523,533,117,-416
2016,12,23,22,528,559,121,-438
2016,12,23,23,573,608,232,-376
2016,12,24,0,588,626,236,-390
2016,12,24,1,572,622,218,-404
2016,12,24,2,559,613,220,-393
2016,12,24,3,554,599,218,-381
2016,12,24,4,546,571,168,-403
2016,12,24,5,520,548,125,-423
2016,12,24,6,512,512,124,-388
2016,12,24,7,492,492,124,-368
2016,12,24,8,486,468,124,-344
2016,12,24,9,484,463,125,-338
2016,12,24,10,490,464,121,-343
2016,12,24,11,497,476,126,-350
2016,12,24,12,511,497,144,-353
2016,12,24,13,542,528,222,-306
2016,12,24,14,584,564,190,-374
2016,12,24,15,599,581,192,-389
2016,12,24,16,592,575,182,-393
2016,12,24,17,557,556,134,-422
2016,12,24,18,532,539,118,-421
2016,12,24,19,506,522,118,-404
2016,12,24,20,491,507,117,-390
2016,12,24,21,483,504,118,-386
2016,12,24,22,487,502,117,-385
2016,12,24,23,522,521,210,-311
2016,12,25,0,538,526,279,-247
2016,12,25,1,529,515,279,-236
2016,12,25,2,521,506,280,-226
2016,12,25,3,510,495,247,-248
2016,12,25,4,496,476,208,-268
2016,12,25,5,467,445,150,-295
2016,12,25,6,432,410,111,-299
2016,12,25,7,412,391,112,-279
2016,12,25,8,399,380,114,-266
2016,12,25,9,393,374,112,-262
2016,12,25,10,394,376,110,-266
2016,12,25,11,393,392,114,-278
2016,12,25,12,402,416,108,-308
2016,12,25,13,430,448,106,-342
2016,12,25,14,473,484,107,-377
2016,12,25,15,494,491,107,-384
2016,12,25,16,485,487,110,-377
2016,12,25,17,469,477,108,-369
2016,12,25,18,463,467,109,-358
2016,12,25,19,448,450,107,-343
2016,12,25,20,433,436,109,-327
2016,12,25,21,427,428,107,-321
2016,12,25,22,437,435,109,-326
2016,12,25,23,483,463,133,-330
2016,12,26,0,512,481,144,-337
2016,12,26,1,522,477,162,-315
2016,12,26,2,515,473,163,-310
2016,12,26,3,492,462,165,-297
2016,12,26,4,464,439,136,-303
2016,12,26,5,431,400,115,-285
2016,12,26,6,415,379,117,-262
2016,12,26,7,398,364,121,-243
2016,12,26,8,382,359,132,-227
2016,12,26,9,384,356,118,-238
2016,12,26,10,398,367,119,-248
2016,12,26,11,415,386,121,-265
2016,12,26,12,458,415,128,-287
2016,12,26,13,495,442,127,-315
2016,12,26,14,522,475,125,-350
2016,12,26,15,548,505,126,-379
2016,12,26,16,555,525,128,-397
2016,12,26,17,552,520,128,-392
2016,12,26,18,544,508,126,-382
2016,12,26,19,532,496,127,-369
2016,12,26,20,523,487,129,-358
2016,12,26,21,522,487,126,-361
2016,12,26,22,540,506,129,-377
2016,12,26,23,591,544,248,-296
2016,12,27,0,610,568,334,-234
2016,12,27,1,598,562,298,-264
2016,12,27,2,572,542,138,-404
2016,12,27,3,540,514,109,-405
2016,12,27,4,496,482,109,-373
2016,12,27,5,461,440,108,-332
2016,12,27,6,427,362,62,-300
2016,12,27,7,413,393,109,-284
2016,12,27,8,406,386,108,-278
2016,12,27,9,407,385,110,-275
2016,12,27,10,418,393,108,-285
2016,12,27,11,447,421,109,-312
2016,12,27,12,500,461,109,-352
2016,12,27,13,547,501,110,-391
2016,12,27,14,561,523,109,-414
2016,12,27,15,565,548,115,-433
2016,12,27,16,554,556,154,-402
2016,12,27,17,543,550,155,-395
2016,12,27,18,530,535,155,-380
2016,12,27,19,522,528,148,-380
2016,12,27,20,511,520,115,-405
2016,12,27,21,511,520,117,-403
2016,12,27,22,524,533,114,-419
2016,12,27,23,570,571,158,-413
2016,12,28,0,597,593,188,-405
2016,12,28,1,600,589,187,-402
2016,12,28,2,588,575,117,-458
2016,12,28,3,560,563,117,-446
2016,12,28,4,522,526,114,-412
2016,12,28,5,483,493,115,-378
2016,12,28,6,443,469,114,-355
2016,12,28,7,429,464,114,-350
2016,12,28,8,423,464,115,-349
2016,12,28,9,430,477,113,-364
2016,12,28,10,450,501,115,-386
2016,12,28,11,487,549,114,-435
2016,12,28,12,551,609,122,-487
2016,12,28,13,601,664,200,-464
2016,12,28,14,615,692,250,-442
2016,12,28,15,617,673,253,-420
2016,12,28,16,599,638,250,-388
2016,12,28,17,574,601,162,-439
2016,12,28,18,553,565,111,-454
2016,12,28,19,538,543,112,-431
2016,12,28,20,530,524,111,-413
2016,12,28,21,526,525,111,-414
2016,12,28,22,537,536,112,-424
2016,12,28,23,584,588,146,-442
2016,12,29,0,605,627,319,-308
2016,12,29,1,606,629,321,-308
2016,12,29,2,590,621,296,-325
2016,12,29,3,564,599,238,-361
2016,12,29,4,527,563,228,-335
2016,12,29,5,489,519,159,-360
2016,12,29,6,482,486,117,-369
2016,12,29,7,472,470,110,-360
2016,12,29,8,464,467,110,-357
2016,12,29,9,466,459,109,-350
2016,12,29,10,479,464,128,-336
2016,12,29,11,507,488,304,-184
2016,12,29,12,561,534,380,-154
2016,12,29,13,603,575,385,-190
2016,12,29,14,617,587,383,-204
2016,12,29,15,626,588,327,-261
2016,12,29,16,629,590,280,-310
2016,12,29,17,619,586,228,-358
2016,12,29,18,612,583,195,-388
2016,12,29,19,607,577,193,-384
2016,12,29,20,609,579,141,-438
2016,12,29,21,626,585,113,-472
2016,12,29,22,657,607,175,-432
2016,12,29,23,716,671,317,-354
2016,12,30,0,735,722,379,-343
2016,12,30,1,743,728,373,-355
2016,12,30,2,734,718,318,-400
2016,12,30,3,713,694,311,-383
2016,12,30,4,679,661,310,-351
2016,12,30,5,648,635,253,-382
2016,12,30,6,594,604,162,-442
2016,12,30,7,587,597,134,-463
2016,12,30,8,590,592,117,-475
2016,12,30,9,604,596,124,-472
2016,12,30,10,631,610,135,-475
2016,12,30,11,666,644,180,-464
2016,12,30,12,719,692,266,-426
2016,12,30,13,774,741,316,-425
2016,12,30,14,798,760,322,-438
2016,12,30,15,790,751,248,-503
2016,12,30,16,753,729,225,-504
2016,12,30,17,720,698,196,-502
2016,12,30,18,687,667,192,-475
2016,12,30,19,665,642,191,-451
2016,12,30,20,653,624,191,-433
2016,12,30,21,656,619,191,-428
2016,12,30,22,676,642,189,-453
2016,12,30,23,737,702,211,-491
2016,12,31,0,775,741,299,-442
2016,12,31,1,781,743,330,-413
2016,12,31,2,768,739,333,-406
2016,12,31,3,746,724,349,-375
2016,12,31,4,726,699,303,-396
2016,12,31,5,702,673,228,-445
2016,12,31,6,664,648,181,-467
2016,12,31,7,656,643,161,-482
2016,12,31,8,654,641,158,-483
2016,12,31,9,660,657,173,-484
2016,12,31,10,673,674,204,-470
2016,12,31,11,692,688,223,-465
2016,12,31,12,725,651,354,-297
2016,12,31,13,762,715,441,-274
2016,12,31,14,784,717,421,-296
2016,12,31,15,770,674,380,-294
2016,12,31,16,732,683,378,-305
2016,12,31,17,674,715,381,-334
2016,12,31,18,630,686,331,-355
2016,12,31,19,589,650,263,-387
2016,12,31,20,569,630,257,-373
2016,12,31,21,567,633,259,-374
2016,12,31,22,586,647,260,-387
2016,12,31,23,636,682,280,-402
2017,1,1,0,660,685,360,-325
2017,1,1,1,648,667,323,-344
2017,1,1,2,637,643,274,-369
2017,1,1,3,622,613,240,-373
2017,1,1,4,595,583,205,-378
2017,1,1,5,567,554,124,-430
2017,1,1,6,549,537,112,-425
2017,1,1,7,529,513,112,-401
2017,1,1,8,517,502,111,-391
2017,1,1,9,513,495,112,-383
2017,1,1,10,514,494,114,-380
2017,1,1,11,516,504,116,-388
2017,1,1,12,531,518,117,-401
2017,1,1,13,556,546,119,-427
2017,1,1,14,595,572,120,-452
2017,1,1,15,611,590,143,-447
2017,1,1,16,606,590,128,-462
2017,1,1,17,591,579,123,-456
2017,1,1,18,585,570,130,-440
2017,1,1,19,569,560,130,-430
2017,1,1,20,559,539,129,-410
2017,1,1,21,561,533,129,-404
2017,1,1,22,574,544,128,-416
2017,1,1,23,617,575,195,-380
2017,1,2,0,637,592,219,-373
2017,1,2,1,629,582,211,-371
2017,1,2,2,618,565,154,-411
2017,1,2,3,586,543,120,-423
2017,1,2,4,541,510,119,-391
2017,1,2,5,496,477,120,-357
2017,1,2,6,483,451,120,-331
2017,1,2,7,463,434,118,-316
2017,1,2,8,446,427,119,-308
2017,1,2,9,447,427,118,-309
2017,1,2,10,456,441,120,-321
2017,1,2,11,477,469,121,-348
2017,1,2,12,517,502,119,-383
2017,1,2,13,553,537,140,-397
2017,1,2,14,575,558,175,-383
2017,1,2,15,599,580,220,-360
2017,1,2,16,602,589,273,-316
2017,1,2,17,591,584,326,-258
2017,1,2,18,570,571,302,-269
2017,1,2,19,561,553,274,-279
2017,1,2,20,548,546,275,-271
2017,1,2,21,545,546,276,-270
2017,1,2,22,562,559,285,-274
2017,1,2,23,600,600,401,-199
2017,1,3,0,625,621,420,-201
2017,1,3,1,608,613,399,-214
2017,1,3,2,583,596,353,-243
2017,1,3,3,553,560,265,-295
2017,1,3,4,510,514,201,-313
2017,1,3,5,473,474,149,-325
2017,1,3,6,451,412,102,-310
2017,1,3,7,437,434,120,-314
2017,1,3,8,427,431,112,-319
2017,1,3,9,426,428,112,-316
2017,1,3,10,436,441,128,-313
2017,1,3,11,468,483,214,-269
2017,1,3,12,531,553,274,-279
2017,1,3,13,569,588,307,-281
2017,1,3,14,577,589,329,-260
2017,1,3,15,577,585,340,-245
2017,1,3,16,564,579,322,-257
2017,1,3,17,548,572,302,-270
2017,1,3,18,528,562,252,-310
2017,1,3,19,524,560,199,-361
2017,1,3,20,514,536,193,-343
2017,1,3,21,516,538,291,-247
2017,1,3,22,535,552,296,-256
2017,1,3,23,577,588,340,-248
2017,1,4,0,610,624,431,-193
2017,1,4,1,605,614,435,-179
2017,1,4,2,593,600,403,-197
2017,1,4,3,568,569,354,-215
2017,1,4,4,527,521,275,-246
2017,1,4,5,489,479,176,-303
2017,1,4,6,461,452,121,-331
2017,1,4,7,453,433,115,-318
2017,1,4,8,447,427,116,-311
2017,1,4,9,456,436,119,-317
2017,1,4,10,466,451,120,-331
2017,1,4,11,513,493,121,-372
2017,1,4,12,596,571,156,-415
2017,1,4,13,639,612,186,-426
2017,1,4,14,644,630,192,-438
2017,1,4,15,647,641,197,-444
2017,1,4,16,640,656,244,-412
2017,1,4,17,623,656,253,-403
2017,1,4,18,607,639,255,-384
2017,1,4,19,599,634,253,-381
2017,1,4,20,589,629,251,-378
2017,1,4,21,596,632,200,-432
2017,1,4,22,619,654,186,-468
2017,1,4,23,676,714,210,-504
2017,1,5,0,718,769,287,-482
2017,1,5,1,723,772,310,-462
2017,1,5,2,720,765,314,-451
2017,1,5,3,699,742,299,-443
2017,1,5,4,663,702,242,-460
2017,1,5,5,631,665,174,-491
2017,1,5,6,603,641,175,-466
2017,1,5,7,604,643,182,-461
2017,1,5,8,607,644,239,-405
2017,1,5,9,622,660,328,-332
2017,1,5,10,642,683,368,-315
2017,1,5,11,698,736,368,-368
2017,1,5,12,783,812,373,-439
2017,1,5,13,815,838,387,-451
2017,1,5,14,802,824,389,-435
2017,1,5,15,769,798,368,-430
2017,1,5,16,732,759,292,-467
2017,1,5,17,690,735,273,-462
2017,1,5,18,660,709,230,-479
2017,1,5,19,633,685,203,-482
2017,1,5,20,614,671,197,-474
2017,1,5,21,616,665,196,-469
2017,1,5,22,638,676,194,-482
2017,1,5,23,683,722,200,-522
2017,1,6,0,734,748,223,-525
2017,1,6,1,739,740,214,-526
2017,1,6,2,734,728,199,-529
2017,1,6,3,710,702,192,-510
2017,1,6,4,671,654,151,-503
2017,1,6,5,636,618,118,-500
2017,1,6,6,615,599,115,-484
2017,1,6,7,610,598,115,-483
2017,1,6,8,613,598,116,-482
2017,1,6,9,625,606,117,-489
2017,1,6,10,647,625,164,-461
2017,1,6,11,692,680,232,-448
2017,1,6,12,763,758,250,-508
2017,1,6,13,805,802,249,-553
2017,1,6,14,820,806,246,-560
2017,1,6,15,813,811,248,-563
2017,1,6,16,787,810,248,-562
2017,1,6,17,760,800,238,-562
2017,1,6,18,732,785,223,-562
2017,1,6,19,711,785,223,-562
2017,1,6,20,697,790,223,-567
2017,1,6,21,703,808,244,-564
2017,1,6,22,716,824,257,-567
2017,1,6,23,769,859,291,-568
2017,1,7,0,827,869,309,-560
2017,1,7,1,818,844,298,-546
2017,1,7,2,809,825,292,-533
2017,1,7,3,788,799,290,-509
2017,1,7,4,763,765,267,-498
2017,1,7,5,738,734,218,-516
2017,1,7,6,733,715,211,-504
2017,1,7,7,730,709,220,-489
2017,1,7,8,739,706,212,-494
2017,1,7,9,747,716,223,-493
2017,1,7,10,766,735,239,-496
2017,1,7,11,786,763,263,-500
2017,1,7,12,822,805,301,-504
2017,1,7,13,866,835,355,-480
2017,1,7,14,902,885,439,-446
2017,1,7,15,917,912,451,-461
2017,1,7,16,905,907,448,-459
2017,1,7,17,879,870,447,-423
2017,1,7,18,852,846,449,-397
2017,1,7,19,833,828,452,-376
2017,1,7,20,821,812,451,-361
2017,1,7,21,826,813,451,-362
2017,1,7,22,839,855,451,-404
2017,1,7,23,903,933,461,-472
2017,1,8,0,957,980,484,-496
2017,1,8,1,962,980,497,-483
2017,1,8,2,967,966,496,-470
2017,1,8,3,957,944,492,-452
2017,1,8,4,941,918,533,-385
2017,1,8,5,931,901,534,-367
2017,1,8,6,942,888,515,-373
2017,1,8,7,945,898,514,-384
2017,1,8,8,967,904,513,-391
2017,1,8,9,980,917,509,-408
2017,1,8,10,992,938,515,-423
2017,1,8,11,1008,963,512,-451
2017,1,8,12,1026,984,511,-473
2017,1,8,13,1049,1019,523,-496
2017,1,8,14,1087,1040,566,-474
2017,1,8,15,1076,1034,606,-428
2017,1,8,16,1013,1005,489,-516
2017,1,8,17,960,963,525,-438
2017,1,8,18,928,917,495,-422
2017,1,8,19,883,879,497,-382
2017,1,8,20,867,850,467,-383
2017,1,8,21,854,848,451,-397
2017,1,8,22,863,876,447,-429
2017,1,8,23,916,936,462,-474
2017,1,9,0,968,975,543,-432
2017,1,9,1,969,983,559,-424
2017,1,9,2,971,972,560,-412
2017,1,9,3,945,950,558,-392
2017,1,9,4,919,924,559,-365
2017,1,9,5,902,894,546,-348
2017,1,9,6,869,870,495,-375
2017,1,9,7,895,864,513,-351
2017,1,9,8,909,860,511,-349
2017,1,9,9,920,862,513,-349
2017,1,9,10,945,869,567,-302
2017,1,9,11,988,899,580,-319
2017,1,9,12,1041,928,583,-345
2017,1,9,13,1072,954,615,-339
2017,1,9,14,1078,961,612,-349
2017,1,9,15,1052,941,574,-367
2017,1,9,16,1005,913,501,-412
2017,1,9,17,940,862,443,-419
2017,1,9,18,880,839,447,-392
2017,1,9,19,837,805,443,-362
2017,1,9,20,807,772,376,-396
2017,1,9,21,783,764,377,-387
2017,1,9,22,814,789,374,-415
2017,1,9,23,879,847,400,-447
2017,1,10,0,942,883,442,-441
2017,1,10,1,941,880,449,-431
2017,1,10,2,919,856,450,-406
2017,1,10,3,892,816,399,-417
2017,1,10,4,843,777,382,-395
2017,1,10,5,811,734,382,-352
2017,1,10,6,748,714,384,-330
2017,1,10,7,765,704,383,-321
2017,1,10,8,770,706,385,-321
2017,1,10,9,777,710,385,-325
2017,1,10,10,789,732,387,-345
2017,1,10,11,833,762,457,-305
2017,1,10,12,897,812,523,-289
2017,1,10,13,932,853,557,-296
2017,1,10,14,932,854,553,-301
2017,1,10,15,899,844,442,-402
2017,1,10,16,848,818,389,-429
2017,1,10,17,793,777,389,-388
2017,1,10,18,744,732,391,-341
2017,1,10,19,709,705,345,-360
2017,1,10,20,674,686,316,-370
2017,1,10,21,660,682,275,-407
2017,1,10,22,679,697,271,-426
2017,1,10,23,731,750,299,-451
2017,1,11,0,768,778,372,-406
2017,1,11,1,754,771,386,-385
2017,1,11,2,732,749,384,-365
2017,1,11,3,700,707,385,-322
2017,1,11,4,650,657,377,-280
2017,1,11,5,603,612,291,-321
2017,1,11,6,552,576,174,-402
2017,1,11,7,543,560,145,-415
2017,1,11,8,533,551,136,-415
2017,1,11,9,536,556,134,-422
2017,1,11,10,546,564,134,-430
2017,1,11,11,587,598,252,-346
2017,1,11,12,653,658,386,-272
2017,1,11,13,691,700,441,-259
2017,1,11,14,693,709,468,-241
2017,1,11,15,682,689,408,-281
2017,1,11,16,661,668,347,-321
2017,1,11,17,636,651,345,-306
2017,1,11,18,612,629,344,-285
2017,1,11,19,596,616,341,-275
2017,1,11,20,580,594,316,-278
2017,1,11,21,572,586,311,-275
2017,1,11,22,585,602,311,-291
2017,1,11,23,619,634,317,-317
2017,1,12,0,659,659,341,-318
2017,1,12,1,654,647,313,-334
2017,1,12,2,636,630,321,-309
2017,1,12,3,607,599,272,-327
2017,1,12,4,563,552,159,-393
2017,1,12,5,522,507,128,-379
2017,1,12,6,484,478,127,-351
2017,1,12,7,475,469,121,-348
2017,1,12,8,464,457,115,-342
2017,1,12,9,466,465,118,-347
2017,1,12,10,475,474,117,-357
2017,1,12,11,515,512,171,-341
2017,1,12,12,587,586,390,-196
2017,1,12,13,621,615,424,-191
2017,1,12,14,622,607,425,-182
2017,1,12,15,617,600,324,-276
2017,1,12,16,601,571,207,-364
2017,1,12,17,588,563,138,-425
2017,1,12,18,571,548,136,-412
2017,1,12,19,561,544,137,-407
2017,1,12,20,548,535,136,-399
2017,1,12,21,543,528,135,-393
2017,1,12,22,556,539,133,-406
2017,1,12,23,600,566,135,-431
2017,1,13,0,634,592,215,-377
2017,1,13,1,637,596,280,-316
2017,1,13,2,620,579,259,-320
2017,1,13,3,589,553,252,-301
2017,1,13,4,547,507,248,-259
2017,1,13,5,510,469,209,-260
2017,1,13,6,464,437,126,-311
2017,1,13,7,448,429,117,-312
2017,1,13,8,439,423,117,-306
2017,1,13,9,441,428,119,-309
2017,1,13,10,451,445,122,-323
2017,1,13,11,488,486,143,-343
2017,1,13,12,556,563,274,-289
2017,1,13,13,590,590,304,-286
2017,1,13,14,593,595,315,-280
2017,1,13,15,587,584,230,-354
2017,1,13,16,571,584,125,-459
2017,1,13,17,559,567,114,-453
2017,1,13,18,546,549,115,-434
2017,1,13,19,533,536,111,-425
2017,1,13,20,528,529,109,-420
2017,1,13,21,520,523,110,-413
2017,1,13,22,529,534,112,-422
2017,1,13,23,555,553,108,-445
2017,1,14,0,583,576,111,-465
2017,1,14,1,569,569,110,-459
2017,1,14,2,554,556,108,-448
2017,1,14,3,533,531,108,-423
2017,1,14,4,503,504,117,-387
2017,1,14,5,467,466,119,-347
2017,1,14,6,435,441,118,-323
2017,1,14,7,418,427,119,-308
2017,1,14,8,407,418,120,-298
2017,1,14,9,406,419,121,-298
2017,1,14,10,413,423,121,-302
2017,1,14,11,431,444,122,-322
2017,1,14,12,467,465,120,-345
2017,1,14,13,503,501,121,-380
2017,1,14,14,534,531,121,-410
2017,1,14,15,557,554,123,-431
2017,1,14,16,553,557,124,-433
2017,1,14,17,545,547,120,-427
2017,1,14,18,534,531,123,-408
2017,1,14,19,522,518,123,-395
2017,1,14,20,512,512,124,-388
2017,1,14,21,509,510,120,-390
2017,1,14,22,527,521,122,-399
2017,1,14,23,562,551,128,-423
2017,1,15,0,590,571,220,-351
2017,1,15,1,581,568,221,-347
2017,1,15,2,561,553,210,-343
2017,1,15,3,531,526,165,-361
2017,1,15,4,500,500,111,-389
2017,1,15,5,472,465,110,-355
2017,1,15,6,463,434,109,-325
2017,1,15,7,445,421,136,-285
2017,1,15,8,434,413,169,-244
2017,1,15,9,431,411,122,-289
2017,1,15,10,435,411,110,-301
2017,1,15,11,447,425,124,-301
2017,1,15,12,472,444,136,-308
2017,1,15,13,507,478,132,-346
2017,1,15,14,539,512,133,-379
2017,1,15,15,553,532,132,-400
2017,1,15,16,535,529,133,-396
2017,1,15,17,517,512,135,-377
2017,1,15,18,507,503,134,-369
2017,1,15,19,498,495,133,-362
2017,1,15,20,488,488,132,-356
2017,1,15,21,481,489,133,-356
2017,1,15,22,495,500,134,-366
2017,1,15,23,538,524,145,-379
2017,1,16,0,575,556,241,-315
2017,1,16,1,578,543,240,-303
2017,1,16,2,561,535,243,-292
2017,1,16,3,532,509,143,-366
2017,1,16,4,500,480,120,-360
2017,1,16,5,471,448,110,-338
2017,1,16,6,434,421,110,-311
2017,1,16,7,426,406,109,-297
2017,1,16,8,414,407,112,-295
2017,1,16,9,416,405,110,-295
2017,1,16,10,428,414,108,-306
2017,1,16,11,456,442,118,-324
2017,1,16,12,507,491,126,-365
2017,1,16,13,554,533,125,-408
2017,1,16,14,574,555,125,-430
2017,1,16,15,590,567,182,-385
2017,1,16,16,595,572,262,-310
2017,1,16,17,586,558,287,-271
2017,1,16,18,576,540,298,-242
2017,1,16,19,565,515,246,-269
2017,1,16,20,546,535,380,-155
2017,1,16,21,537,541,360,-181
2017,1,16,22,549,555,259,-296
2017,1,16,23,596,589,323,-266
2017,1,17,0,637,616,395,-221
2017,1,17,1,632,608,391,-217
2017,1,17,2,609,594,375,-219
2017,1,17,3,576,554,289,-265
2017,1,17,4,533,510,281,-229
2017,1,17,5,493,471,174,-297
2017,1,17,6,466,439,112,-327
2017,1,17,7,455,429,110,-319
2017,1,17,8,446,425,111,-314
2017,1,17,9,446,424,109,-315
2017,1,17,10,458,435,109,-326
2017,1,17,11,496,476,125,-351
2017,1,17,12,566,544,262,-282
2017,1,17,13,601,578,315,-263
2017,1,17,14,600,577,282,-295
2017,1,17,15,592,575,197,-378
2017,1,17,16,579,570,191,-379
2017,1,17,17,569,568,192,-376
2017,1,17,18,555,557,191,-366
2017,1,17,19,550,546,190,-356
2017,1,17,20,537,536,186,-350
2017,1,17,21,532,539,191,-348
2017,1,17,22,543,553,191,-362
2017,1,17,23,572,581,192,-389
2017,1,18,0,608,607,238,-369
2017,1,18,1,603,605,230,-375
2017,1,18,2,584,580,220,-360
2017,1,18,3,558,547,215,-332
2017,1,18,4,508,501,161,-340
2017,1,18,5,466,456,146,-310
2017,1,18,6,436,426,109,-317
2017,1,18,7,420,413,111,-302
2017,1,18,8,410,401,109,-292
2017,1,18,9,413,401,109,-292
2017,1,18,10,424,410,108,-302
2017,1,18,11,463,449,108,-341
2017,1,18,12,537,522,120,-402
2017,1,18,13,576,557,127,-430
2017,1,18,14,577,561,131,-430
2017,1,18,15,571,547,130,-417
2017,1,18,16,566,541,132,-409
2017,1,18,17,556,534,131,-403
2017,1,18,18,545,529,132,-397
2017,1,18,19,541,521,132,-389
2017,1,18,20,535,516,131,-385
2017,1,18,21,531,519,132,-387
2017,1,18,22,542,526,183,-343
2017,1,18,23,580,558,253,-305
2017,1,19,0,620,609,259,-350
2017,1,19,1,617,611,308,-303
2017,1,19,2,601,609,311,-298
2017,1,19,3,575,585,309,-276
2017,1,19,4,532,552,304,-248
2017,1,19,5,492,520,215,-305
2017,1,19,6,497,499,149,-350
2017,1,19,7,488,493,150,-343
2017,1,19,8,487,493,172,-321
2017,1,19,9,496,499,246,-253
2017,1,19,10,514,522,250,-272
2017,1,19,11,563,570,303,-267
2017,1,19,12,641,655,418,-237
2017,1,19,13,679,688,476,-212
2017,1,19,14,674,682,458,-224
2017,1,19,15,654,648,393,-255
2017,1,19,16,623,600,364,-236
2017,1,19,17,596,570,283,-287
2017,1,19,18,569,554,254,-300
2017,1,19,19,550,551,178,-373
2017,1,19,20,541,544,149,-395
2017,1,19,21,533,541,146,-395
2017,1,19,22,542,545,171,-374
2017,1,19,23,573,576,190,-386
2017,1,20,0,616,617,192,-425
2017,1,20,1,618,616,189,-427
2017,1,20,2,604,602,191,-411
2017,1,20,3,578,570,214,-356
2017,1,20,4,540,523,202,-321
2017,1,20,5,496,482,154,-328
2017,1,20,6,459,450,121,-329
2017,1,20,7,448,439,120,-319
2017,1,20,8,442,433,122,-311
2017,1,20,9,446,436,121,-315
2017,1,20,10,457,448,121,-327
2017,1,20,11,496,485,135,-350
2017,1,20,12,569,551,253,-298
2017,1,20,13,602,585,272,-313
2017,1,20,14,604,577,269,-308
2017,1,20,15,592,578,225,-353
2017,1,20,16,571,558,195,-363
2017,1,20,17,557,541,192,-349
2017,1,20,18,541,525,191,-334
2017,1,20,19,531,523,191,-332
2017,1,20,20,520,515,193,-322
2017,1,20,21,516,505,190,-315
2017,1,20,22,520,511,192,-319
2017,1,20,23,542,525,189,-336
2017,1,21,0,578,560,191,-369
2017,1,21,1,567,554,188,-366
2017,1,21,2,553,544,191,-353
2017,1,21,3,531,520,152,-368
2017,1,21,4,501,495,119,-376
2017,1,21,5,468,462,115,-347
2017,1,21,6,433,440,115,-325
2017,1,21,7,417,429,113,-316
2017,1,21,8,407,423,115,-308
2017,1,21,9,408,424,114,-310
2017,1,21,10,415,433,116,-317
2017,1,21,11,435,452,115,-337
2017,1,21,12,464,476,112,-364
2017,1,21,13,502,520,117,-403
2017,1,21,14,534,550,115,-435
2017,1,21,15,554,569,114,-455
2017,1,21,16,546,573,121,-452
2017,1,21,17,533,566,146,-420
2017,1,21,18,516,558,146,-412
2017,1,21,19,500,552,146,-406
2017,1,21,20,492,553,144,-409
2017,1,21,21,489,551,146,-405
2017,1,21,22,499,542,145,-397
2017,1,21,23,523,537,122,-415
2017,1,22,0,556,587,145,-442
2017,1,22,1,549,575,144,-431
2017,1,22,2,533,559,146,-413
2017,1,22,3,509,534,147,-387
2017,1,22,4,480,501,132,-369
2017,1,22,5,447,469,113,-356
2017,1,22,6,433,438,111,-327
2017,1,22,7,417,425,112,-313
2017,1,22,8,408,413,110,-303
2017,1,22,9,406,415,112,-303
2017,1,22,10,408,411,111,-300
2017,1,22,11,422,429,116,-313
2017,1,22,12,450,449,114,-335
2017,1,22,13,482,480,116,-364
2017,1,22,14,519,522,115,-407
2017,1,22,15,535,530,127,-403
2017,1,22,16,523,523,134,-389
2017,1,22,17,509,512,157,-355
2017,1,22,18,503,507,156,-351
2017,1,22,19,496,506,158,-348
2017,1,22,20,488,505,158,-347
2017,1,22,21,484,514,157,-357
2017,1,22,22,492,527,160,-367
2017,1,22,23,522,552,162,-390
2017,1,23,0,563,577,166,-411
2017,1,23,1,563,574,163,-411
2017,1,23,2,549,552,174,-378
2017,1,23,3,517,526,156,-370
2017,1,23,4,484,486,138,-348
2017,1,23,5,454,452,122,-330
2017,1,23,6,445,428,122,-306
2017,1,23,7,434,417,126,-291
2017,1,23,8,428,413,126,-287
2017,1,23,9,433,417,137,-280
2017,1,23,10,448,433,216,-217
2017,1,23,11,487,476,289,-187
2017,1,23,12,555,549,320,-229
2017,1,23,13,597,590,403,-187
2017,1,23,14,605,598,289,-309
2017,1,23,15,612,599,220,-379
2017,1,23,16,611,595,218,-377
2017,1,23,17,603,589,216,-373
2017,1,23,18,591,590,215,-375
2017,1,23,19,585,593,218,-375
2017,1,23,20,571,578,215,-363
2017,1,23,21,567,585,215,-370
2017,1,23,22,578,614,218,-396
2017,1,23,23,617,638,272,-366
2017,1,24,0,666,669,358,-311
2017,1,24,1,669,664,343,-321
2017,1,24,2,655,647,317,-330
2017,1,24,3,623,613,283,-330
2017,1,24,4,581,566,255,-311
2017,1,24,5,543,514,214,-300
2017,1,24,6,515,504,222,-282
2017,1,24,7,503,495,222,-273
2017,1,24,8,500,482,221,-261
2017,1,24,9,506,488,222,-266
2017,1,24,10,523,510,222,-288
2017,1,24,11,567,558,310,-248
2017,1,24,12,639,637,443,-194
2017,1,24,13,678,671,457,-214
2017,1,24,14,675,662,452,-210
2017,1,24,15,655,656,450,-206
2017,1,24,16,630,637,272,-365
2017,1,24,17,606,618,218,-400
2017,1,24,18,584,601,223,-378
2017,1,24,19,569,590,226,-364
2017,1,24,20,553,566,224,-342
2017,1,24,21,550,559,226,-333
2017,1,24,22,562,573,226,-347
2017,1,24,23,601,614,228,-386
2017,1,25,0,654,663,318,-345
2017,1,25,1,662,683,364,-319
2017,1,25,2,652,666,322,-344
2017,1,25,3,621,651,269,-382
2017,1,25,4,577,610,246,-364
2017,1,25,5,544,577,222,-355
2017,1,25,6,533,561,142,-419
2017,1,25,7,523,560,132,-428
2017,1,25,8,521,569,132,-437
2017,1,25,9,529,576,160,-416
2017,1,25,10,548,599,258,-341
2017,1,25,11,592,654,310,-344
2017,1,25,12,672,721,337,-384
2017,1,25,13,707,759,352,-407
2017,1,25,14,698,753,338,-415
2017,1,25,15,663,702,311,-391
2017,1,25,16,618,646,266,-380
2017,1,25,17,585,599,259,-340
2017,1,25,18,559,563,241,-322
2017,1,25,19,549,538,265,-273
2017,1,25,20,535,527,277,-250
2017,1,25,21,529,521,183,-338
2017,1,25,22,536,532,185,-347
2017,1,25,23,558,555,210,-345
2017,1,26,0,596,599,217,-382
2017,1,26,1,596,603,219,-384
2017,1,26,2,580,585,218,-367
2017,1,26,3,551,558,168,-390
2017,1,26,4,509,506,112,-394
2017,1,26,5,471,469,113,-356
2017,1,26,6,456,438,113,-325
2017,1,26,7,446,428,113,-315
2017,1,26,8,441,420,111,-309
2017,1,26,9,447,420,112,-308
2017,1,26,10,462,431,111,-320
2017,1,26,11,509,479,113,-366
2017,1,26,12,588,554,113,-441
2017,1,26,13,632,598,112,-486
2017,1,26,14,635,596,112,-484
2017,1,26,15,635,585,115,-470
2017,1,26,16,630,579,115,-464
2017,1,26,17,623,566,113,-453
2017,1,26,18,614,565,115,-450
2017,1,26,19,607,549,174,-375
2017,1,26,20,593,546,209,-337
2017,1,26,21,595,553,121,-432
2017,1,26,22,608,572,213,-359
2017,1,26,23,654,623,260,-363
2017,1,27,0,705,688,270,-418
2017,1,27,1,717,702,270,-432
2017,1,27,2,704,700,271,-429
2017,1,27,3,679,682,215,-467
2017,1,27,4,644,644,191,-453
2017,1,27,5,612,613,150,-463
2017,1,27,6,600,591,113,-478
2017,1,27,7,596,587,122,-465
2017,1,27,8,602,583,119,-464
2017,1,27,9,613,596,123,-473
2017,1,27,10,642,611,139,-472
2017,1,27,11,688,658,248,-410
2017,1,27,12,769,735,310,-425
2017,1,27,13,807,768,379,-389
2017,1,27,14,806,763,385,-378
2017,1,27,15,779,751,300,-451
2017,1,27,16,741,754,264,-490
2017,1,27,17,715,744,257,-487
2017,1,27,18,687,721,238,-483
2017,1,27,19,662,709,225,-484
2017,1,27,20,649,691,207,-484
2017,1,27,21,643,681,199,-482
2017,1,27,22,656,695,234,-461
2017,1,27,23,698,742,368,-374
2017,1,28,0,747,791,391,-400
2017,1,28,1,753,788,373,-415
2017,1,28,2,750,787,359,-428
2017,1,28,3,732,767,334,-433
2017,1,28,4,706,733,322,-411
2017,1,28,5,677,704,270,-434
2017,1,28,6,667,659,170,-489
2017,1,28,7,659,642,146,-496
2017,1,28,8,661,637,150,-487
2017,1,28,9,666,640,146,-494
2017,1,28,10,682,641,146,-495
2017,1,28,11,705,578,221,-357
2017,1,28,12,738,703,413,-290
2017,1,28,13,780,746,463,-283
2017,1,28,14,805,768,485,-283
2017,1,28,15,785,750,465,-285
2017,1,28,16,746,776,392,-384
2017,1,28,17,701,719,218,-501
2017,1,28,18,660,645,122,-523
2017,1,28,19,627,610,122,-488
2017,1,28,20,605,582,121,-461
2017,1,28,21,598,573,119,-454
2017,1,28,22,605,587,118,-469
2017,1,28,23,647,627,135,-492
2017,1,29,0,703,681,228,-453
2017,1,29,1,709,696,197,-499
2017,1,29,2,706,689,158,-531
2017,1,29,3,691,672,165,-507
2017,1,29,4,662,645,152,-493
2017,1,29,5,640,608,135,-473
2017,1,29,6,615,580,114,-466
2017,1,29,7,608,568,118,-450
2017,1,29,8,611,561,119,-442
2017,1,29,9,621,564,120,-444
2017,1,29,10,639,572,120,-452
2017,1,29,11,663,588,152,-436
2017,1,29,12,690,614,296,-318
2017,1,29,13,736,654,351,-303
2017,1,29,14,776,693,364,-329
2017,1,29,15,764,705,243,-462
2017,1,29,16,730,673,128,-545
2017,1,29,17,694,654,126,-528
2017,1,29,18,664,654,126,-528
2017,1,29,19,641,648,122,-526
2017,1,29,20,624,643,126,-517
2017,1,29,21,625,640,123,-517
2017,1,29,22,636,668,136,-532
2017,1,29,23,681,706,184,-522
2017,1,30,0,731,745,229,-516
2017,1,30,1,748,751,261,-490
2017,1,30,2,739,741,291,-450
2017,1,30,3,716,723,278,-445
2017,1,30,4,691,681,191,-490
2017,1,30,5,667,660,189,-471
2017,1,30,6,622,632,135,-497
2017,1,30,7,619,634,118,-516
2017,1,30,8,627,643,116,-527
2017,1,30,9,643,653,115,-538
2017,1,30,10,673,689,133,-556
2017,1,30,11,721,745,192,-553
2017,1,30,12,791,804,314,-490
2017,1,30,13,834,850,403,-447
2017,1,30,14,838,861,413,-448
2017,1,30,15,826,826,343,-483
2017,1,30,16,810,791,246,-545
2017,1,30,17,781,758,201,-557
2017,1,30,18,756,724,167,-557
2017,1,30,19,732,691,153,-538
2017,1,30,20,715,669,120,-549
2017,1,30,21,709,651,121,-530
2017,1,30,22,730,659,130,-529
2017,1,30,23,761,700,168,-532
2017,1,31,0,818,766,320,-446
2017,1,31,1,823,786,388,-398
2017,1,31,2,810,775,430,-345
2017,1,31,3,772,755,375,-380
2017,1,31,4,727,712,346,-366
2017,1,31,5,683,673,273,-400
2017,1,31,6,648,658,167,-491
2017,1,31,7,640,653,130,-523
2017,1,31,8,634,656,126,-530
2017,1,31,9,638,660,126,-534
2017,1,31,10,657,679,126,-553
2017,1,31,11,701,658,152,-506
2017,1,31,12,771,773,294,-479
2017,1,31,13,800,812,342,-470
2017,1,31,14,780,803,297,-506
2017,1,31,15,720,755,255,-500
2017,1,31,16,666,756,239,-517
2017,1,31,17,630,623,122,-501
2017,1,31,18,600,598,127,-471
2017,1,31,19,578,571,121,-450
2017,1,31,20,561,550,121,-429
2017,1,31,21,558,541,122,-419
2017,1,31,22,564,550,120,-430
2017,1,31,23,587,574,133,-441
2017,2,1,0,633,630,161,-469
2017,2,1,1,645,641,145,-496
2017,2,1,2,634,634,137,-497
2017,2,1,3,608,613,118,-495
2017,2,1,4,566,576,119,-457
2017,2,1,5,530,547,120,-427
2017,2,1,6,486,523,113,-410
2017,2,1,7,480,521,116,-405
2017,2,1,8,480,532,119,-413
2017,2,1,9,487,538,118,-420
2017,2,1,10,509,561,120,-441
2017,2,1,11,559,600,170,-430
2017,2,1,12,639,623,288,-335
2017,2,1,13,675,729,411,-318
2017,2,1,14,668,752,345,-407
2017,2,1,15,644,688,230,-458
2017,2,1,16,613,626,179,-447
2017,2,1,17,586,586,138,-448
2017,2,1,18,569,554,115,-439
2017,2,1,19,551,540,117,-423
2017,2,1,20,537,526,117,-409
2017,2,1,21,529,517,119,-398
2017,2,1,22,538,529,123,-406
2017,2,1,23,561,539,121,-418
2017,2,2,0,609,503,162,-341
2017,2,2,1,615,603,273,-330
2017,2,2,2,604,648,230,-418
2017,2,2,3,581,614,177,-437
2017,2,2,4,547,516,123,-393
2017,2,2,5,508,481,125,-356
2017,2,2,6,474,453,123,-330
2017,2,2,7,465,444,124,-320
2017,2,2,8,462,444,122,-322
2017,2,2,9,466,446,122,-324
2017,2,2,10,483,464,125,-339
2017,2,2,11,525,507,124,-383
2017,2,2,12,609,532,155,-377
2017,2,2,13,646,572,246,-326
2017,2,2,14,647,638,324,-314
2017,2,2,15,639,718,277,-441
2017,2,2,16,637,632,157,-475
2017,2,2,17,608,615,154,-461
2017,2,2,18,591,609,155,-454
2017,2,2,19,577,595,155,-440
2017,2,2,20,561,588,165,-423
2017,2,2,21,553,590,162,-428
2017,2,2,22,565,602,158,-444
2017,2,2,23,595,628,154,-474
2017,2,3,0,654,615,177,-438
2017,2,3,1,661,626,232,-394
2017,2,3,2,661,663,279,-384
2017,2,3,3,642,633,266,-367
2017,2,3,4,607,660,224,-436
2017,2,3,5,575,568,141,-427
2017,2,3,6,541,515,114,-401
2017,2,3,7,534,509,114,-395
2017,2,3,8,537,506,113,-393
2017,2,3,9,544,509,111,-398
2017,2,3,10,564,530,114,-416
2017,2,3,11,611,573,113,-460
2017,2,3,12,679,636,125,-511
2017,2,3,13,734,594,137,-457
2017,2,3,14,744,738,239,-499
2017,2,3,15,724,736,220,-516
2017,2,3,16,692,681,192,-489
2017,2,3,17,663,670,198,-472
2017,2,3,18,635,662,198,-464
2017,2,3,19,611,660,192,-468
2017,2,3,20,593,661,185,-476
2017,2,3,21,587,658,179,-479
2017,2,3,22,596,677,183,-494
2017,2,3,23,632,715,195,-520
2017,2,4,0,673,707,233,-474
2017,2,4,1,714,730,304,-426
2017,2,4,2,726,776,362,-414
2017,2,4,3,712,766,343,-423
2017,2,4,4,683,746,313,-433
2017,2,4,5,657,706,241,-465
2017,2,4,6,650,690,184,-506
2017,2,4,7,645,693,149,-544
2017,2,4,8,650,696,156,-540
2017,2,4,9,662,714,198,-516
2017,2,4,10,680,733,249,-484
2017,2,4,11,692,768,312,-456
2017,2,4,12,755,811,404,-407
2017,2,4,13,799,858,459,-399
2017,2,4,14,826,876,478,-398
2017,2,4,15,810,843,470,-373
2017,2,4,16,786,781,416,-365
2017,2,4,17,730,724,305,-419
2017,2,4,18,677,679,239,-440
2017,2,4,19,636,636,161,-475
2017,2,4,20,601,607,117,-490
2017,2,4,21,590,594,112,-482
2017,2,4,22,601,607,130,-477
2017,2,4,23,642,651,180,-471
2017,2,5,0,696,716,252,-464
2017,2,5,1,710,736,334,-402
2017,2,5,2,704,742,372,-370
2017,2,5,3,683,725,374,-351
2017,2,5,4,659,703,379,-324
2017,2,5,5,631,668,371,-297
2017,2,5,6,658,634,328,-306
2017,2,5,7,651,613,295,-318
2017,2,5,8,649,603,250,-353
2017,2,5,9,655,602,251,-351
2017,2,5,10,664,599,219,-380
2017,2,5,11,675,619,187,-432
2017,2,5,12,713,640,248,-392
2017,2,5,13,741,680,295,-385
2017,2,5,14,760,711,301,-410
2017,2,5,15,732,700,301,-399
2017,2,5,16,688,651,276,-375
2017,2,5,17,646,605,171,-434
2017,2,5,18,619,571,124,-447
2017,2,5,19,595,539,118,-421
2017,2,5,20,576,517,118,-399
2017,2,5,21,570,515,124,-391
2017,2,5,22,576,527,123,-404
2017,2,5,23,599,555,165,-390
2017,2,6,0,653,592,210,-382
2017,2,6,1,656,596,184,-412
2017,2,6,2,650,591,156,-435
2017,2,6,3,625,588,150,-438
2017,2,6,4,595,571,153,-418
2017,2,6,5,564,558,141,-417
2017,2,6,6,528,537,114,-423
2017,2,6,7,522,536,115,-421
2017,2,6,8,523,543,113,-430
2017,2,6,9,532,563,114,-449
2017,2,6,10,553,595,115,-480
2017,2,6,11,608,654,184,-470
2017,2,6,12,685,741,382,-359
2017,2,6,13,710,786,442,-344
2017,2,6,14,730,768,456,-312
2017,2,6,15,706,714,318,-396
2017,2,6,16,668,660,200,-460
2017,2,6,17,627,609,140,-469
2017,2,6,18,597,568,122,-446
2017,2,6,19,573,548,122,-426
2017,2,6,20,553,537,125,-412
2017,2,6,21,545,541,125,-416
2017,2,6,22,553,556,130,-426
2017,2,6,23,572,583,171,-412
2017,2,7,0,608,618,227,-391
2017,2,7,1,613,621,267,-354
2017,2,7,2,606,604,284,-320
2017,2,7,3,584,575,245,-330
2017,2,7,4,547,532,180,-352
2017,2,7,5,503,491,132,-359
2017,2,7,6,471,465,123,-342
2017,2,7,7,462,456,116,-340
2017,2,7,8,457,450,116,-334
2017,2,7,9,459,455,121,-334
2017,2,7,10,473,460,120,-340
2017,2,7,11,515,505,152,-353
2017,2,7,12,588,576,375,-201
2017,2,7,13,619,611,408,-203
2017,2,7,14,623,596,314,-282
2017,2,7,15,613,581,187,-394
2017,2,7,16,586,565,118,-447
2017,2,7,17,561,536,102,-434
2017,2,7,18,546,532,110,-422
2017,2,7,19,531,530,112,-418
2017,2,7,20,518,520,121,-399
2017,2,7,21,511,517,119,-398
2017,2,7,22,521,532,185,-347
2017,2,7,23,537,568,242,-326
2017,2,8,0,573,598,322,-276
2017,2,8,1,584,599,338,-261
2017,2,8,2,580,583,298,-285
2017,2,8,3,558,549,234,-315
2017,2,8,4,515,506,156,-350
2017,2,8,5,473,467,115,-352
2017,2,8,6,444,433,104,-329
2017,2,8,7,429,437,114,-323
2017,2,8,8,423,436,115,-321
2017,2,8,9,424,444,113,-331
2017,2,8,10,438,466,113,-353
2017,2,8,11,474,513,124,-389
2017,2,8,12,548,591,151,-440
2017,2,8,13,576,624,187,-437
2017,2,8,14,585,614,159,-455
2017,2,8,15,579,613,147,-466
2017,2,8,16,560,595,144,-451
2017,2,8,17,540,569,144,-425
2017,2,8,18,527,536,144,-392
2017,2,8,19,517,530,152,-378
2017,2,8,20,511,527,205,-322
2017,2,8,21,508,527,216,-311
2017,2,8,22,519,538,223,-315
2017,2,8,23,538,542,242,-300
2017,2,9,0,568,518,293,-225
2017,2,9,1,572,609,367,-242
2017,2,9,2,562,656,316,-340
2017,2,9,3,539,600,220,-380
2017,2,9,4,500,514,128,-386
2017,2,9,5,462,468,126,-342
2017,2,9,6,480,445,127,-318
2017,2,9,7,476,433,126,-307
2017,2,9,8,482,435,127,-308
2017,2,9,9,495,453,127,-326
2017,2,9,10,521,484,126,-358
2017,2,9,11,576,549,125,-424
2017,2,9,12,662,643,172,-471
2017,2,9,13,713,711,253,-458
2017,2,9,14,732,723,237,-486
2017,2,9,15,730,726,239,-487
2017,2,9,16,712,717,232,-485
2017,2,9,17,689,707,221,-486
2017,2,9,18,676,698,213,-485
2017,2,9,19,668,685,199,-486
2017,2,9,20,671,677,194,-483
2017,2,9,21,683,674,188,-486
2017,2,9,22,712,686,212,-474
2017,2,9,23,756,728,287,-441
2017,2,10,0,806,800,448,-352
2017,2,10,1,833,825,440,-385
2017,2,10,2,848,822,436,-386
2017,2,10,3,826,800,410,-390
2017,2,10,4,785,761,364,-397
2017,2,10,5,754,725,346,-379
2017,2,10,6,675,709,337,-372
2017,2,10,7,675,705,327,-378
2017,2,10,8,678,709,351,-358
2017,2,10,9,687,718,354,-364
2017,2,10,10,711,746,369,-377
2017,2,10,11,759,791,379,-412
2017,2,10,12,823,866,526,-340
2017,2,10,13,859,904,534,-370
2017,2,10,14,847,872,501,-371
2017,2,10,15,803,823,370,-453
2017,2,10,16,736,762,250,-512
2017,2,10,17,672,701,189,-512
2017,2,10,18,622,648,157,-491
2017,2,10,19,586,612,126,-486
2017,2,10,20,566,581,112,-469
2017,2,10,21,559,564,126,-438
2017,2,10,22,572,570,166,-404
2017,2,10,23,588,589,222,-367
2017,2,11,0,599,634,301,-333
2017,2,11,1,636,559,319,-240
2017,2,11,2,656,651,415,-236
2017,2,11,3,627,677,433,-244
2017,2,11,4,591,664,411,-253
2017,2,11,5,551,590,364,-226
2017,2,11,6,539,549,260,-289
2017,2,11,7,528,537,148,-389
2017,2,11,8,524,531,121,-410
2017,2,11,9,526,532,122,-410
2017,2,11,10,537,538,122,-416
2017,2,11,11,558,551,119,-432
2017,2,11,12,587,573,113,-460
2017,2,11,13,621,596,115,-481
2017,2,11,14,641,616,182,-434
2017,2,11,15,634,611,220,-391
2017,2,11,16,597,594,220,-374
2017,2,11,17,563,564,201,-363
2017,2,11,18,541,539,125,-414
2017,2,11,19,521,521,116,-405
2017,2,11,20,505,505,115,-390
2017,2,11,21,495,503,114,-389
2017,2,11,22,499,506,115,-391
2017,2,11,23,512,471,116,-355
2017,2,12,0,554,489,209,-280
2017,2,12,1,556,552,304,-248
2017,2,12,2,539,544,277,-267
2017,2,12,3,519,594,217,-377
2017,2,12,4,492,485,126,-359
2017,2,12,5,458,444,120,-324
2017,2,12,6,425,421,118,-303
2017,2,12,7,404,402,108,-294
2017,2,12,8,395,396,111,-285
2017,2,12,9,389,391,112,-279
2017,2,12,10,392,393,112,-281
2017,2,12,11,405,406,113,-293
2017,2,12,12,426,427,112,-315
2017,2,12,13,458,459,113,-346
2017,2,12,14,493,495,113,-382
2017,2,12,15,508,503,111,-392
2017,2,12,16,500,495,115,-380
2017,2,12,17,485,481,113,-368
2017,2,12,18,478,481,115,-366
2017,2,12,19,471,474,113,-361
2017,2,12,20,462,470,114,-356
2017,2,12,21,463,462,112,-350
2017,2,12,22,474,389,118,-271
2017,2,12,23,498,504,213,-291
2017,2,13,0,539,534,298,-236
2017,2,13,1,543,549,356,-193
2017,2,13,2,528,530,354,-176
2017,2,13,3,507,542,355,-187
2017,2,13,4,480,522,246,-276
2017,2,13,5,456,432,125,-307
2017,2,13,6,420,402,101,-301
2017,2,13,7,413,411,112,-299
2017,2,13,8,415,407,99,-308
2017,2,13,9,423,436,114,-322
2017,2,13,10,449,469,111,-358
2017,2,13,11,497,530,118,-412
2017,2,13,12,586,628,210,-418
2017,2,13,13,635,683,290,-393
2017,2,13,14,657,679,296,-383
2017,2,13,15,663,663,292,-371
2017,2,13,16,655,641,188,-453
2017,2,13,17,621,612,133,-479
2017,2,13,18,604,581,119,-462
2017,2,13,19,588,564,118,-446
2017,2,13,20,577,544,118,-426
2017,2,13,21,570,539,117,-422
2017,2,13,22,578,548,116,-432
2017,2,13,23,611,517,137,-380
2017,2,14,0,658,598,280,-318
2017,2,14,1,669,670,401,-269
2017,2,14,2,693,670,415,-255
2017,2,14,3,676,678,361,-317
2017,2,14,4,649,696,232,-464
2017,2,14,5,603,583,117,-466
2017,2,14,6,540,564,108,-456
2017,2,14,7,536,565,108,-457
2017,2,14,8,538,575,110,-465
2017,2,14,9,549,588,113,-475
2017,2,14,10,575,615,135,-480
2017,2,14,11,619,672,305,-367
2017,2,14,12,702,765,476,-289
2017,2,14,13,737,796,489,-307
2017,2,14,14,740,776,396,-380
2017,2,14,15,707,731,230,-501
2017,2,14,16,661,676,196,-480
2017,2,14,17,610,630,144,-486
2017,2,14,18,580,585,120,-465
2017,2,14,19,555,566,118,-448
2017,2,14,20,538,546,117,-429
2017,2,14,21,538,559,118,-441
2017,2,14,22,550,575,115,-460
2017,2,14,23,569,611,125,-486
2017,2,15,0,603,644,157,-487
2017,2,15,1,623,644,156,-488
2017,2,15,2,629,632,144,-488
2017,2,15,3,601,597,118,-479
2017,2,15,4,565,556,116,-440
2017,2,15,5,519,521,117,-404
2017,2,15,6,497,490,111,-379
2017,2,15,7,491,481,110,-371
2017,2,15,8,490,483,117,-366
2017,2,15,9,500,485,117,-368
2017,2,15,10,522,510,115,-395
2017,2,15,11,568,563,118,-445
2017,2,15,12,642,638,125,-513
2017,2,15,13,692,679,156,-523
2017,2,15,14,699,676,153,-523
2017,2,15,15,690,685,163,-522
2017,2,15,16,675,668,155,-513
2017,2,15,17,649,647,147,-500
2017,2,15,18,631,629,124,-505
2017,2,15,19,613,610,118,-492
2017,2,15,20,596,594,117,-477
2017,2,15,21,595,593,119,-474
2017,2,15,22,607,604,115,-489
2017,2,15,23,629,641,131,-510
2017,2,16,0,671,704,197,-507
2017,2,16,1,710,726,212,-514
2017,2,16,2,729,725,209,-516
2017,2,16,3,713,701,193,-508
2017,2,16,4,679,666,153,-513
2017,2,16,5,625,629,127,-502
2017,2,16,6,584,612,112,-500
2017,2,16,7,579,607,110,-497
2017,2,16,8,584,612,112,-500
2017,2,16,9,597,624,110,-514
2017,2,16,10,624,647,139,-508
2017,2,16,11,675,690,267,-423
2017,2,16,12,742,777,439,-338
2017,2,16,13,791,810,491,-319
2017,2,16,14,785,792,501,-291
2017,2,16,15,749,742,452,-290
2017,2,16,16,701,716,377,-339
2017,2,16,17,660,684,317,-367
2017,2,16,18,624,651,216,-435
2017,2,16,19,599,618,133,-485
2017,2,16,20,579,596,122,-474
2017,2,16,21,575,587,135,-452
2017,2,16,22,586,595,137,-458
2017,2,16,23,611,622,137,-485
2017,2,17,0,643,679,175,-504
2017,2,17,1,676,704,178,-526
2017,2,17,2,699,701,179,-522
2017,2,17,3,677,684,181,-503
2017,2,17,4,639,643,175,-468
2017,2,17,5,595,609,147,-462
2017,2,17,6,565,590,141,-449
2017,2,17,7,558,593,117,-476
2017,2,17,8,557,595,107,-488
2017,2,17,9,566,614,116,-498
2017,2,17,10,593,634,120,-514
2017,2,17,11,641,675,155,-520
2017,2,17,12,706,758,342,-416
2017,2,17,13,739,794,358,-436
2017,2,17,14,729,762,355,-407
2017,2,17,15,686,699,348,-351
2017,2,17,16,629,642,228,-414
2017,2,17,17,586,599,144,-455
2017,2,17,18,558,567,104,-463
2017,2,17,19,538,541,57,-484
2017,2,17,20,526,523,55,-468
2017,2,17,21,516,515,65,-450
2017,2,17,22,519,513,92,-421
2017,2,17,23,523,530,120,-410
2017,2,18,0,554,567,160,-407
2017,2,18,1,583,581,124,-457
2017,2,18,2,586,574,103,-471
2017,2,18,3,569,563,59,-504
2017,2,18,4,553,543,56,-487
2017,2,18,5,505,514,57,-457
2017,2,18,6,482,501,56,-445
2017,2,18,7,475,500,59,-441
2017,2,18,8,474,503,58,-445
2017,2,18,9,479,513,58,-455
2017,2,18,10,490,529,62,-467
2017,2,18,11,511,550,106,-444
2017,2,18,12,556,570,115,-455
2017,2,18,13,589,520,129,-391
2017,2,18,14,615,629,224,-405
2017,2,18,15,615,635,225,-410
2017,2,18,16,594,627,226,-401
2017,2,18,17,556,674,185,-489
2017,2,18,18,526,573,76,-497
2017,2,18,19,506,544,63,-481
2017,2,18,20,492,536,63,-473
2017,2,18,21,484,538,62,-476
2017,2,18,22,482,549,64,-485
2017,2,18,23,499,551,77,-474
2017,2,19,0,535,588,112,-476
2017,2,19,1,560,603,73,-530
2017,2,19,2,550,588,63,-525
2017,2,19,3,545,566,62,-504
2017,2,19,4,510,535,63,-472
2017,2,19,5,471,499,69,-430
2017,2,19,6,453,478,63,-415
2017,2,19,7,437,468,63,-405
2017,2,19,8,431,463,63,-400
2017,2,19,9,429,459,62,-397
2017,2,19,10,432,461,66,-395
2017,2,19,11,448,475,63,-412
2017,2,19,12,477,494,63,-431
2017,2,19,13,508,524,62,-462
2017,2,19,14,533,568,63,-505
2017,2,19,15,548,581,61,-520
2017,2,19,16,531,573,55,-518
2017,2,19,17,506,556,57,-499
2017,2,19,18,498,538,54,-484
2017,2,19,19,490,524,57,-467
2017,2,19,20,480,491,57,-434
2017,2,19,21,468,479,58,-421
2017,2,19,22,459,484,56,-428
2017,2,19,23,502,506,92,-414
2017,2,20,0,544,554,233,-321
2017,2,20,1,559,578,231,-347
2017,2,20,2,547,574,220,-354
2017,2,20,3,539,547,128,-419
2017,2,20,4,501,517,63,-454
2017,2,20,5,452,489,62,-427
2017,2,20,6,450,475,65,-410
2017,2,20,7,437,469,61,-408
2017,2,20,8,432,480,64,-416
2017,2,20,9,437,489,61,-428
2017,2,20,10,456,528,75,-453
2017,2,20,11,506,580,130,-450
2017,2,20,12,576,652,213,-439
2017,2,20,13,627,708,349,-359
2017,2,20,14,611,693,366,-327
2017,2,20,15,600,648,242,-406
2017,2,20,16,573,600,88,-512
2017,2,20,17,554,562,64,-498
2017,2,20,18,539,538,66,-472
2017,2,20,19,524,527,65,-462
2017,2,20,20,508,515,66,-449
2017,2,20,21,491,510,69,-441
2017,2,20,22,503,509,65,-444
2017,2,20,23,518,530,99,-431
2017,2,21,0,556,572,184,-388
2017,2,21,1,561,589,196,-393
2017,2,21,2,558,570,193,-377
2017,2,21,3,534,538,190,-348
2017,2,21,4,484,495,137,-358
2017,2,21,5,445,461,74,-387
2017,2,21,6,423,435,66,-369
2017,2,21,7,415,426,68,-358
2017,2,21,8,419,432,64,-368
2017,2,21,9,427,436,62,-374
2017,2,21,10,444,457,68,-389
2017,2,21,11,495,506,144,-362
2017,2,21,12,575,592,250,-342
2017,2,21,13,618,626,299,-327
2017,2,21,14,615,610,266,-344
2017,2,21,15,603,579,194,-385
2017,2,21,16,577,564,170,-394
2017,2,21,17,556,554,98,-456
2017,2,21,18,542,538,62,-476
2017,2,21,19,531,529,65,-464
2017,2,21,20,517,517,63,-454
2017,2,21,21,514,514,84,-430
2017,2,21,22,524,523,139,-384
2017,2,21,23,540,546,141,-405
2017,2,22,0,578,587,179,-408
2017,2,22,1,602,595,194,-401
2017,2,22,2,598,581,196,-385
2017,2,22,3,570,547,196,-351
2017,2,22,4,528,499,160,-339
2017,2,22,5,481,456,90,-366
2017,2,22,6,430,429,62,-367
2017,2,22,7,418,420,64,-356
2017,2,22,8,411,411,61,-350
2017,2,22,9,414,414,63,-351
2017,2,22,10,428,424,68,-356
2017,2,22,11,468,466,149,-317
2017,2,22,12,538,542,193,-349
2017,2,22,13,572,578,195,-383
2017,2,22,14,577,579,193,-386
2017,2,22,15,580,586,196,-390
2017,2,22,16,572,581,164,-417
2017,2,22,17,560,581,95,-486
2017,2,22,18,552,574,77,-497
2017,2,22,19,542,563,78,-485
2017,2,22,20,534,551,70,-481
2017,2,22,21,535,515,60,-455
2017,2,22,22,546,482,80,-402
2017,2,22,23,561,634,146,-488
2017,2,23,0,578,497,122,-375
2017,2,23,1,605,594,213,-381
2017,2,23,2,605,655,199,-456
2017,2,23,3,575,590,130,-460
2017,2,23,4,525,504,78,-426
2017,2,23,5,473,461,71,-390
2017,2,23,6,450,402,40,-362
2017,2,23,7,433,418,71,-347
2017,2,23,8,424,423,70,-353
2017,2,23,9,424,425,70,-355
2017,2,23,10,436,443,69,-374
2017,2,23,11,473,483,73,-410
2017,2,23,12,543,556,96,-460
2017,2,23,13,562,591,100,-491
2017,2,23,14,567,586,99,-487
2017,2,23,15,564,572,68,-504
2017,2,23,16,550,551,65,-486
2017,2,23,17,540,538,65,-473
2017,2,23,18,527,525,65,-460
2017,2,23,19,520,520,102,-418
2017,2,23,20,511,508,149,-359
2017,2,23,21,514,502,193,-309
2017,2,23,22,521,509,195,-314
2017,2,23,23,533,506,193,-313
2017,2,24,0,553,455,207,-248
2017,2,24,1,581,589,301,-288
2017,2,24,2,580,642,275,-367
2017,2,24,3,551,533,115,-418
2017,2,24,4,498,483,61,-422
2017,2,24,5,452,440,59,-381
2017,2,24,6,423,420,60,-360
2017,2,24,7,406,405,58,-347
2017,2,24,8,399,405,60,-345
2017,2,24,9,398,409,59,-350
2017,2,24,10,410,427,60,-367
2017,2,24,11,445,467,57,-410
2017,2,24,12,519,548,59,-489
2017,2,24,13,541,580,60,-520
2017,2,24,14,542,575,61,-514
2017,2,24,15,545,553,60,-493
2017,2,24,16,535,539,64,-475
2017,2,24,17,532,522,61,-461
2017,2,24,18,521,513,69,-444
2017,2,24,19,514,506,78,-428
2017,2,24,20,505,501,79,-422
2017,2,24,21,499,496,80,-416
2017,2,24,22,491,505,79,-426
2017,2,24,23,532,506,75,-431
2017,2,25,0,520,525,77,-448
2017,2,25,1,547,539,74,-465
2017,2,25,2,552,521,65,-456
2017,2,25,3,515,495,62,-433
2017,2,25,4,473,463,62,-401
2017,2,25,5,436,424,60,-364
2017,2,25,6,413,394,61,-333
2017,2,25,7,398,381,60,-321
2017,2,25,8,390,371,61,-310
2017,2,25,9,387,364,58,-306
2017,2,25,10,395,370,60,-310
2017,2,25,11,415,381,59,-322
2017,2,25,12,443,410,61,-349
2017,2,25,13,468,436,58,-378
2017,2,25,14,513,474,66,-408
2017,2,25,15,529,508,69,-439
2017,2,25,16,532,508,70,-438
2017,2,25,17,532,501,68,-433
2017,2,25,18,508,494,70,-424
2017,2,25,19,495,479,68,-411
2017,2,25,20,483,471,69,-402
2017,2,25,21,483,467,67,-400
2017,2,25,22,498,480,67,-413
2017,2,25,23,526,500,66,-434
2017,2,26,0,578,544,66,-478
2017,2,26,1,600,570,66,-504
2017,2,26,2,604,572,66,-506
2017,2,26,3,593,565,67,-498
2017,2,26,4,577,553,66,-487
2017,2,26,5,558,535,86,-449
2017,2,26,6,523,523,105,-418
2017,2,26,7,519,525,112,-413
2017,2,26,8,527,531,119,-412
2017,2,26,9,541,549,123,-426
2017,2,26,10,563,563,126,-437
2017,2,26,11,593,594,125,-469
2017,2,26,12,633,633,152,-481
2017,2,26,13,667,680,185,-495
2017,2,26,14,696,702,205,-497
2017,2,26,15,674,681,188,-493
2017,2,26,16,620,641,162,-479
2017,2,26,17,584,598,155,-443
2017,2,26,18,543,566,126,-440
2017,2,26,19,518,540,119,-421
2017,2,26,20,502,510,119,-391
2017,2,26,21,499,501,120,-381
2017,2,26,22,516,504,119,-385
2017,2,26,23,540,530,119,-411
2017,2,27,0,582,580,141,-439
2017,2,27,1,604,625,165,-460
2017,2,27,2,603,628,163,-465
2017,2,27,3,579,613,165,-448
2017,2,27,4,552,586,161,-425
2017,2,27,5,525,569,142,-427
2017,2,27,6,509,535,107,-428
2017,2,27,7,504,538,112,-426
2017,2,27,8,511,550,123,-427
2017,2,27,9,521,553,125,-428
2017,2,27,10,543,565,184,-381
2017,2,27,11,596,612,356,-256
2017,2,27,12,679,681,386,-295
2017,2,27,13,718,633,396,-237
2017,2,27,14,708,766,480,-286
2017,2,27,15,683,731,362,-369
2017,2,27,16,656,655,243,-412
2017,2,27,17,627,638,190,-448
2017,2,27,18,598,622,141,-481
2017,2,27,19,579,619,133,-486
2017,2,27,20,561,605,121,-484
2017,2,27,21,559,604,120,-484
2017,2,27,22,567,609,124,-485
2017,2,27,23,585,626,137,-489
2017,2,28,0,615,657,172,-485
2017,2,28,1,637,658,194,-464
2017,2,28,2,630,632,189,-443
2017,2,28,3,593,591,181,-410
2017,2,28,4,547,542,173,-369
2017,2,28,5,502,501,126,-375
2017,2,28,6,482,477,115,-362
2017,2,28,7,469,470,116,-354
2017,2,28,8,464,481,122,-359
2017,2,28,9,466,489,121,-368
2017,2,28,10,481,509,120,-389
2017,2,28,11,523,560,174,-386
2017,2,28,12,595,640,295,-345
2017,2,28,13,620,668,317,-351
2017,2,28,14,605,634,220,-414
2017,2,28,15,590,596,138,-458
2017,2,28,16,574,567,123,-444
2017,2,28,17,560,550,125,-425
2017,2,28,18,547,535,124,-411
2017,2,28,19,540,529,128,-401
2017,2,28,20,526,525,166,-359
2017,2,28,21,524,525,194,-331
2017,2,28,22,531,550,274,-276
2017,2,28,23,551,571,315,-256
2017,3,1,0,561,596,379,-217
2017,3,1,1,591,601,378,-223
2017,3,1,2,592,577,313,-264
2017,3,1,3,552,540,270,-270
2017,3,1,4,493,498,208,-290
2017,3,1,5,448,457,141,-316
2017,3,1,6,411,427,128,-299
2017,3,1,7,394,412,125,-287
2017,3,1,8,386,407,128,-279
2017,3,1,9,386,401,125,-276
2017,3,1,10,399,413,127,-286
2017,3,1,11,438,449,128,-321
2017,3,1,12,512,520,166,-354
2017,3,1,13,536,547,168,-379
2017,3,1,14,544,537,170,-367
2017,3,1,15,538,531,172,-359
2017,3,1,16,530,535,170,-365
2017,3,1,17,530,532,170,-362
2017,3,1,18,518,524,172,-352
2017,3,1,19,514,518,169,-349
2017,3,1,20,507,514,171,-343
2017,3,1,21,511,513,172,-341
2017,3,1,22,512,529,194,-335
2017,3,1,23,529,548,195,-353
2017,3,2,0,554,569,293,-276
2017,3,2,1,574,568,295,-273
2017,3,2,2,569,549,301,-248
2017,3,2,3,538,520,301,-219
2017,3,2,4,496,475,294,-181
2017,3,2,5,459,441,190,-251
2017,3,2,6,447,472,178,-294
2017,3,2,7,437,438,130,-308
2017,3,2,8,438,456,131,-325
2017,3,2,9,448,469,127,-342
2017,3,2,10,470,501,130,-371
2017,3,2,11,526,550,134,-416
2017,3,2,12,612,559,226,-333
2017,3,2,13,654,698,344,-354
2017,3,2,14,645,684,337,-347
2017,3,2,15,622,722,335,-387
2017,3,2,16,603,683,249,-434
2017,3,2,17,586,618,190,-428
2017,3,2,18,563,596,149,-447
2017,3,2,19,551,576,131,-445
2017,3,2,20,541,557,132,-425
2017,3,2,21,534,552,133,-419
2017,3,2,22,541,560,173,-387
2017,3,2,23,572,592,209,-383
2017,3,3,0,617,587,216,-371
2017,3,3,1,644,634,297,-337
2017,3,3,2,663,686,376,-310
2017,3,3,3,644,739,373,-366
2017,3,3,4,612,652,297,-355
2017,3,3,5,575,592,272,-320
2017,3,3,6,554,557,228,-329
2017,3,3,7,552,570,149,-421
2017,3,3,8,560,576,122,-454
2017,3,3,9,572,587,112,-475
2017,3,3,10,595,617,162,-455
2017,3,3,11,649,655,258,-397
2017,3,3,12,729,652,323,-329
2017,3,3,13,748,763,464,-299
2017,3,3,14,746,743,421,-322
2017,3,3,15,703,749,376,-373
2017,3,3,16,660,762,277,-485
2017,3,3,17,636,658,171,-487
2017,3,3,18,609,633,144,-489
2017,3,3,19,589,609,121,-488
2017,3,3,20,575,592,116,-476
2017,3,3,21,568,583,115,-468
2017,3,3,22,566,593,130,-463
2017,3,3,23,610,627,208,-419
2017,3,4,0,633,680,300,-380
2017,3,4,1,686,711,382,-329
2017,3,4,2,704,713,378,-335
2017,3,4,3,678,702,364,-338
2017,3,4,4,649,676,361,-315
2017,3,4,5,622,647,354,-293
2017,3,4,6,613,633,339,-294
2017,3,4,7,610,633,341,-292
2017,3,4,8,616,634,350,-284
2017,3,4,9,630,648,358,-290
2017,3,4,10,645,661,358,-303
2017,3,4,11,666,684,360,-324
2017,3,4,12,711,639,372,-267
2017,3,4,13,747,767,463,-304
2017,3,4,14,759,757,397,-360
2017,3,4,15,726,716,375,-341
2017,3,4,16,686,704,320,-384
2017,3,4,17,633,685,224,-461
2017,3,4,18,586,570,124,-446
2017,3,4,19,548,536,67,-469
2017,3,4,20,525,511,66,-445
2017,3,4,21,518,497,59,-438
2017,3,4,22,522,502,59,-443
2017,3,4,23,538,523,57,-466
2017,3,5,0,577,567,92,-475
2017,3,5,1,614,592,112,-480
2017,3,5,2,616,595,121,-474
2017,3,5,3,612,586,121,-465
2017,3,5,4,580,569,117,-452
2017,3,5,5,554,551,78,-473
2017,3,5,6,526,539,58,-481
2017,3,5,7,522,541,55,-486
2017,3,5,8,525,547,57,-490
2017,3,5,9,538,559,87,-472
2017,3,5,10,560,580,136,-444
2017,3,5,11,587,597,143,-454
2017,3,5,12,624,638,264,-374
2017,3,5,13,665,587,274,-313
2017,3,5,14,686,689,333,-356
2017,3,5,15,658,648,283,-365
2017,3,5,16,614,586,171,-415
2017,3,5,17,569,625,170,-455
2017,3,5,18,541,535,80,-455
2017,3,5,19,518,496,56,-440
2017,3,5,20,497,481,56,-425
2017,3,5,21,491,481,56,-425
2017,3,5,22,480,492,55,-437
2017,3,5,23,511,522,55,-467
2017,3,6,0,550,560,70,-490
2017,3,6,1,585,588,102,-486
2017,3,6,2,576,584,133,-451
2017,3,6,3,559,556,184,-372
2017,3,6,4,526,525,153,-372
2017,3,6,5,485,491,78,-413
2017,3,6,6,455,471,61,-410
2017,3,6,7,451,463,61,-402
2017,3,6,8,454,456,60,-396
2017,3,6,9,463,461,61,-400
2017,3,6,10,485,479,64,-415
2017,3,6,11,534,520,120,-400
2017,3,6,12,608,496,163,-333
2017,3,6,13,654,631,371,-260
2017,3,6,14,645,635,303,-332
2017,3,6,15,631,649,317,-332
2017,3,6,16,618,709,281,-428
2017,3,6,17,588,618,71,-547
2017,3,6,18,573,591,61,-530
2017,3,6,19,557,577,63,-514
2017,3,6,20,537,557,60,-497
2017,3,6,21,533,546,57,-489
2017,3,6,22,535,562,60,-502
2017,3,6,23,555,576,59,-517
2017,3,7,0,586,609,76,-533
2017,3,7,1,621,623,87,-536
2017,3,7,2,611,604,85,-519
2017,3,7,3,572,571,87,-484
2017,3,7,4,525,521,86,-435
2017,3,7,5,483,478,67,-411
2017,3,7,6,446,451,64,-387
2017,3,7,7,432,437,55,-382
2017,3,7,8,425,434,57,-377
2017,3,7,9,427,436,57,-379
2017,3,7,10,441,447,55,-392
2017,3,7,11,482,485,60,-425
2017,3,7,12,551,547,95,-452
2017,3,7,13,588,490,146,-344
2017,3,7,14,580,630,233,-397
2017,3,7,15,570,617,137,-480
2017,3,7,16,561,563,81,-482
2017,3,7,17,550,557,73,-484
2017,3,7,18,543,553,70,-483
2017,3,7,19,536,545,74,-471
2017,3,7,20,520,538,66,-472
2017,3,7,21,515,535,63,-472
2017,3,7,22,525,541,69,-472
2017,3,7,23,549,564,105,-459
2017,3,8,0,575,533,138,-395
2017,3,8,1,611,558,211,-347
2017,3,8,2,603,589,231,-358
2017,3,8,3,567,625,228,-397
2017,3,8,4,516,530,128,-402
2017,3,8,5,476,461,58,-403
2017,3,8,6,446,429,54,-375
2017,3,8,7,435,411,50,-361
2017,3,8,8,431,415,51,-364
2017,3,8,9,438,435,56,-379
2017,3,8,10,453,460,54,-406
2017,3,8,11,504,509,56,-453
2017,3,8,12,571,600,80,-520
2017,3,8,13,618,636,93,-543
2017,3,8,14,606,620,95,-525
2017,3,8,15,589,594,93,-501
2017,3,8,16,570,571,93,-478
2017,3,8,17,537,550,95,-455
2017,3,8,18,520,538,93,-445
2017,3,8,19,508,522,94,-428
2017,3,8,20,498,516,107,-409
2017,3,8,21,484,506,121,-385
2017,3,8,22,488,513,137,-376
2017,3,8,23,527,528,148,-380
2017,3,9,0,541,560,185,-375
2017,3,9,1,585,594,268,-326
2017,3,9,2,599,587,338,-249
2017,3,9,3,568,569,351,-218
2017,3,9,4,520,538,280,-258
2017,3,9,5,487,505,191,-314
2017,3,9,6,460,495,122,-373
2017,3,9,7,457,504,111,-393
2017,3,9,8,456,501,106,-395
2017,3,9,9,470,520,108,-412
2017,3,9,10,491,551,108,-443
2017,3,9,11,547,610,168,-442
2017,3,9,12,623,704,291,-413
2017,3,9,13,658,731,260,-471
2017,3,9,14,658,697,216,-481
2017,3,9,15,628,642,192,-450
2017,3,9,16,584,590,130,-460
2017,3,9,17,549,553,122,-431
2017,3,9,18,531,533,122,-411
2017,3,9,19,514,521,122,-399
2017,3,9,20,505,511,121,-390
2017,3,9,21,491,504,137,-367
2017,3,9,22,487,513,184,-329
2017,3,9,23,522,513,205,-308
2017,3,10,0,519,445,237,-208
2017,3,10,1,560,577,398,-179
2017,3,10,2,571,572,413,-159
2017,3,10,3,541,620,426,-194
2017,3,10,4,484,542,245,-297
2017,3,10,5,442,470,135,-335
2017,3,10,6,416,441,107,-334
2017,3,10,7,403,445,117,-328
2017,3,10,8,402,444,117,-327
2017,3,10,9,409,446,115,-331
2017,3,10,10,426,462,115,-347
2017,3,10,11,468,488,134,-354
2017,3,10,12,531,476,245,-231
2017,3,10,13,584,607,364,-243
2017,3,10,14,578,603,392,-211
2017,3,10,15,575,616,393,-223
2017,3,10,16,578,662,331,-331
2017,3,10,17,549,574,246,-328
2017,3,10,18,547,560,158,-402
2017,3,10,19,536,555,141,-414
2017,3,10,20,519,538,143,-395
2017,3,10,21,517,536,141,-395
2017,3,10,22,529,545,149,-396
2017,3,10,23,564,566,172,-394
2017,3,11,0,584,614,199,-415
2017,3,11,1,623,653,212,-441
2017,3,11,2,629,655,205,-450
2017,3,11,3,609,642,205,-437
2017,3,11,4,577,621,181,-440
2017,3,11,5,550,588,151,-437
2017,3,11,6,534,572,143,-429
2017,3,11,7,529,561,118,-443
2017,3,11,8,532,566,115,-451
2017,3,11,9,549,578,121,-457
2017,3,11,10,569,590,120,-470
2017,3,11,11,603,608,167,-441
2017,3,11,12,636,559,213,-346
2017,3,11,13,679,685,322,-363
2017,3,11,14,713,701,321,-380
2017,3,11,15,701,735,319,-416
2017,3,11,16,686,759,282,-477
2017,3,11,17,667,686,192,-494
2017,3,11,18,610,675,187,-488
2017,3,11,19,581,664,185,-479
2017,3,11,20,560,639,184,-455
2017,3,11,21,560,628,187,-441
2017,3,11,22,566,632,183,-449
2017,3,11,23,598,645,188,-457
2017,3,12,0,638,683,234,-449
2017,3,12,1,674,697,273,-424
2017,3,12,2,672,688,271,-417
2017,3,12,3,659,665,243,-422
2017,3,12,4,632,628,169,-459
2017,3,12,5,602,592,157,-435
2017,3,12,6,593,579,158,-421
2017,3,12,7,584,576,157,-419
2017,3,12,8,588,585,159,-426
2017,3,12,9,594,598,156,-439
2017,3,12,10,603,623,159,-464
2017,3,12,11,620,637,166,-471
2017,3,12,12,653,585,201,-384
2017,3,12,13,685,696,317,-379
2017,3,12,14,745,715,376,-339
2017,3,12,15,737,698,385,-313
2017,3,12,16,710,724,393,-331
2017,3,12,17,704,694,339,-355
2017,3,12,18,648,612,248,-364
2017,3,12,19,617,575,137,-438
2017,3,12,20,593,552,121,-431
2017,3,12,21,577,538,120,-418
2017,3,12,22,580,544,123,-421
2017,3,12,23,598,562,145,-417
2017,3,13,0,617,603,159,-444
2017,3,13,1,651,647,209,-438
2017,3,13,2,689,641,204,-437
2017,3,13,3,678,622,203,-419
2017,3,13,4,652,598,154,-444
2017,3,13,5,596,571,105,-466
2017,3,13,6,590,573,103,-470
2017,3,13,7,597,597,131,-466
2017,3,13,8,608,609,158,-451
2017,3,13,9,633,633,210,-423
2017,3,13,10,673,674,268,-406
2017,3,13,11,721,674,326,-348
2017,3,13,12,793,819,459,-360
2017,3,13,13,809,819,453,-366
2017,3,13,14,807,791,425,-366
2017,3,13,15,802,813,402,-411
2017,3,13,16,750,719,313,-406
2017,3,13,17,723,659,257,-402
2017,3,13,18,706,644,257,-387
2017,3,13,19,689,653,257,-396
2017,3,13,20,679,651,257,-394
2017,3,13,21,695,665,313,-352
2017,3,13,22,716,676,347,-329
2017,3,13,23,702,701,354,-347
2017,3,14,0,736,725,355,-370
2017,3,14,1,778,723,353,-370
2017,3,14,2,760,697,355,-342
2017,3,14,3,699,651,341,-310
2017,3,14,4,646,612,290,-322
2017,3,14,5,609,585,196,-389
2017,3,14,6,595,576,183,-393
2017,3,14,7,592,574,186,-388
2017,3,14,8,598,580,186,-394
2017,3,14,9,616,599,205,-394
2017,3,14,10,658,631,242,-389
2017,3,14,11,712,623,317,-306
2017,3,14,12,771,759,453,-306
2017,3,14,13,777,767,459,-308
2017,3,14,14,770,769,458,-311
2017,3,14,15,755,779,449,-330
2017,3,14,16,711,861,400,-461
2017,3,14,17,682,808,281,-527
2017,3,14,18,663,789,248,-541
2017,3,14,19,648,777,215,-562
2017,3,14,20,638,780,219,-561
2017,3,14,21,646,797,236,-561
2017,3,14,22,671,825,264,-561
2017,3,14,23,649,852,350,-502
2017,3,15,0,711,880,388,-492
2017,3,15,1,765,887,387,-500
2017,3,15,2,763,862,389,-473
2017,3,15,3,711,817,386,-431
2017,3,15,4,671,788,387,-401
2017,3,15,5,657,770,387,-383
2017,3,15,6,659,775,387,-388
2017,3,15,7,674,785,386,-399
2017,3,15,8,691,802,388,-414
2017,3,15,9,723,831,388,-443
2017,3,15,10,770,798,382,-416
2017,3,15,11,817,893,523,-370
2017,3,15,12,894,984,566,-418
2017,3,15,13,904,1001,565,-436
2017,3,15,14,886,979,535,-444
2017,3,15,15,861,970,561,-409
2017,3,15,16,802,978,550,-428
2017,3,15,17,763,893,469,-424
2017,3,15,18,737,841,387,-454
2017,3,15,19,712,809,388,-421
2017,3,15,20,699,781,388,-393
2017,3,15,21,707,769,388,-381
2017,3,15,22,729,774,386,-388
2017,3,15,23,724,805,389,-416
2017,3,16,0,779,814,393,-421
2017,3,16,1,837,866,484,-382
2017,3,16,2,838,927,504,-423
2017,3,16,3,781,829,435,-394
2017,3,16,4,737,796,387,-409
2017,3,16,5,746,774,386,-388
2017,3,16,6,749,774,386,-388
2017,3,16,7,755,776,386,-390
2017,3,16,8,764,786,385,-401
2017,3,16,9,790,804,383,-421
2017,3,16,10,827,839,410,-429
2017,3,16,11,868,819,468,-351
2017,3,16,12,939,958,564,-394
2017,3,16,13,939,947,563,-384
2017,3,16,14,903,904,567,-337
2017,3,16,15,859,927,512,-415
2017,3,16,16,784,823,360,-463
2017,3,16,17,730,751,259,-492
2017,3,16,18,685,714,172,-542
2017,3,16,19,648,673,122,-551
2017,3,16,20,620,651,114,-537
2017,3,16,21,632,642,119,-523
2017,3,16,22,654,646,117,-529
2017,3,16,23,662,659,124,-535
2017,3,17,0,699,711,188,-523
2017,3,17,1,737,759,300,-459
2017,3,17,2,731,759,348,-411
2017,3,17,3,686,726,347,-379
2017,3,17,4,643,699,330,-369
2017,3,17,5,644,677,279,-398
2017,3,17,6,640,682,277,-405
2017,3,17,7,655,692,295,-397
2017,3,17,8,672,707,345,-362
2017,3,17,9,708,735,371,-364
2017,3,17,10,740,776,376,-400
2017,3,17,11,792,762,452,-310
2017,3,17,12,867,881,550,-331
2017,3,17,13,862,877,562,-315
2017,3,17,14,818,916,543,-373
2017,3,17,15,761,868,421,-447
2017,3,17,16,692,790,383,-407
2017,3,17,17,637,743,387,-356
2017,3,17,18,599,678,371,-307
2017,3,17,19,576,617,306,-311
2017,3,17,20,556,581,224,-357
2017,3,17,21,561,579,181,-398
2017,3,17,22,553,593,182,-411
2017,3,17,23,536,614,224,-390
2017,3,18,0,561,626,260,-366
2017,3,18,1,586,631,331,-300
2017,3,18,2,593,616,356,-260
2017,3,18,3,551,579,327,-252
2017,3,18,4,507,545,263,-282
2017,3,18,5,494,501,165,-336
2017,3,18,6,476,493,120,-373
2017,3,18,7,464,484,118,-366
2017,3,18,8,460,481,122,-359
2017,3,18,9,461,482,120,-362
2017,3,18,10,471,499,122,-377
2017,3,18,11,486,525,124,-401
2017,3,18,12,522,551,215,-336
2017,3,18,13,558,587,249,-338
2017,3,18,14,577,530,252,-278
2017,3,18,15,576,559,326,-233
2017,3,18,16,555,569,359,-210
2017,3,18,17,533,610,335,-275
2017,3,18,18,505,558,249,-309
2017,3,18,19,487,514,197,-317
2017,3,18,20,479,496,175,-321
2017,3,18,21,479,489,128,-361
2017,3,18,22,472,497,128,-369
2017,3,18,23,483,502,126,-376
2017,3,19,0,514,512,121,-391
2017,3,19,1,537,460,131,-329
2017,3,19,2,533,549,232,-317
2017,3,19,3,504,598,232,-366
2017,3,19,4,466,541,159,-382
2017,3,19,5,446,485,122,-363
2017,3,19,6,432,484,122,-362
2017,3,19,7,430,489,123,-366
2017,3,19,8,436,495,121,-374
2017,3,19,9,447,512,125,-387
2017,3,19,10,473,537,125,-412
2017,3,19,11,509,569,123,-446
2017,3,19,12,543,566,135,-431
2017,3,19,13,595,597,173,-424
2017,3,19,14,605,681,258,-423
2017,3,19,15,583,672,249,-423
2017,3,19,16,566,655,231,-424
2017,3,19,17,543,712,236,-476
2017,3,19,18,514,645,162,-483
2017,3,19,19,497,580,135,-445
2017,3,19,20,492,550,133,-417
2017,3,19,21,484,538,132,-406
2017,3,19,22,504,545,132,-413
2017,3,19,23,523,549,132,-417
2017,3,20,0,564,496,164,-332
2017,3,20,1,599,638,310,-328
2017,3,20,2,590,632,311,-321
2017,3,20,3,560,604,309,-295
2017,3,20,4,522,611,292,-319
2017,3,20,5,528,628,236,-392
2017,3,20,6,521,547,147,-400
2017,3,20,7,524,572,212,-360
2017,3,20,8,532,588,288,-300
2017,3,20,9,548,622,360,-262
2017,3,20,10,595,622,374,-248
2017,3,20,11,649,725,446,-279
2017,3,20,12,696,819,497,-322
2017,3,20,13,722,805,471,-334
2017,3,20,14,704,742,463,-279
2017,3,20,15,665,686,403,-283
2017,3,20,16,619,713,360,-353
2017,3,20,17,590,603,203,-400
2017,3,20,18,564,562,164,-398
2017,3,20,19,547,543,152,-391
2017,3,20,20,535,538,149,-389
2017,3,20,21,536,542,150,-392
2017,3,20,22,535,543,195,-348
2017,3,20,23,526,549,221,-328
2017,3,21,0,554,571,293,-278
2017,3,21,1,583,595,351,-244
2017,3,21,2,574,570,346,-224
2017,3,21,3,514,525,279,-246
2017,3,21,4,459,473,200,-273
2017,3,21,5,424,442,139,-303
2017,3,21,6,408,437,122,-315
2017,3,21,7,402,430,114,-316
2017,3,21,8,401,438,117,-321
2017,3,21,9,413,455,116,-339
2017,3,21,10,443,492,173,-319
2017,3,21,11,502,483,299,-184
2017,3,21,12,540,614,457,-157
2017,3,21,13,566,608,433,-175
2017,3,21,14,561,699,439,-260
2017,3,21,15,553,560,179,-381
2017,3,21,16,542,548,141,-407
2017,3,21,17,529,535,148,-387
2017,3,21,18,530,529,146,-383
2017,3,21,19,516,521,146,-375
2017,3,21,20,523,529,150,-379
2017,3,21,21,532,533,200,-333
2017,3,21,22,532,535,246,-289
2017,3,21,23,516,533,293,-240
2017,3,22,0,540,464,367,-97
2017,3,22,1,569,581,470,-111
2017,3,22,2,562,551,444,-107
2017,3,22,3,500,573,414,-159
2017,3,22,4,444,470,246,-224
2017,3,22,5,420,398,128,-270
2017,3,22,6,396,387,127,-260
2017,3,22,7,391,377,128,-249
2017,3,22,8,396,379,129,-250
2017,3,22,9,408,388,127,-261
2017,3,22,10,440,418,128,-290
2017,3,22,11,501,409,141,-268
2017,3,22,12,562,553,269,-284
2017,3,22,13,570,567,280,-287
2017,3,22,14,580,569,272,-297
2017,3,22,15,583,640,273,-367
2017,3,22,16,579,587,151,-436
2017,3,22,17,564,548,122,-426
2017,3,22,18,547,540,122,-418
2017,3,22,19,540,526,122,-404
2017,3,22,20,531,521,124,-397
2017,3,22,21,540,519,120,-399
2017,3,22,22,541,517,121,-396
2017,3,22,23,542,450,134,-316
2017,3,23,0,567,569,229,-340
2017,3,23,1,591,605,227,-378
2017,3,23,2,584,595,228,-367
2017,3,23,3,538,627,227,-400
2017,3,23,4,493,570,162,-408
2017,3,23,5,491,513,121,-392
2017,3,23,6,487,505,118,-387
2017,3,23,7,492,512,120,-392
2017,3,23,8,508,519,118,-401
2017,3,23,9,533,547,121,-426
2017,3,23,10,582,528,191,-337
2017,3,23,11,639,637,318,-319
2017,3,23,12,726,729,426,-303
2017,3,23,13,724,716,468,-248
2017,3,23,14,727,685,473,-212
2017,3,23,15,684,677,409,-268
2017,3,23,16,645,683,274,-409
2017,3,23,17,609,589,192,-397
2017,3,23,18,581,560,184,-376
2017,3,23,19,565,528,176,-352
2017,3,23,20,553,522,183,-339
2017,3,23,21,561,520,184,-336
2017,3,23,22,561,528,182,-346
2017,3,23,23,570,537,180,-357
2017,3,24,0,594,554,182,-372
2017,3,24,1,636,505,194,-311
2017,3,24,2,626,654,290,-364
2017,3,24,3,592,585,221,-364
2017,3,24,4,546,506,181,-325
2017,3,24,5,511,478,180,-298
2017,3,24,6,494,469,169,-300
2017,3,24,7,492,471,161,-310
2017,3,24,8,499,471,161,-310
2017,3,24,9,515,487,164,-323
2017,3,24,10,548,487,215,-272
2017,3,24,11,596,539,339,-200
2017,3,24,12,676,648,460,-188
2017,3,24,13,676,627,375,-252
2017,3,24,14,662,637,327,-310
2017,3,24,15,667,654,265,-389
2017,3,24,16,640,554,168,-386
2017,3,24,17,592,531,157,-374
2017,3,24,18,568,518,154,-364
2017,3,24,19,550,504,167,-337
2017,3,24,20,537,497,172,-325
2017,3,24,21,533,497,169,-328
2017,3,24,22,529,499,172,-327
2017,3,24,23,508,501,195,-306
2017,3,25,0,553,515,209,-306
2017,3,25,1,579,530,216,-314
2017,3,25,2,576,519,195,-324
2017,3,25,3,560,487,160,-327
2017,3,25,4,517,450,118,-332
2017,3,25,5,438,421,99,-322
2017,3,25,6,422,403,87,-316
2017,3,25,7,415,395,51,-344
2017,3,25,8,414,393,52,-341
2017,3,25,9,420,401,53,-348
2017,3,25,10,436,416,52,-364
2017,3,25,11,459,441,68,-373
2017,3,25,12,486,481,91,-390
2017,3,25,13,524,512,105,-407
2017,3,25,14,537,526,94,-432
2017,3,25,15,544,519,61,-458
2017,3,25,16,549,509,52,-457
2017,3,25,17,537,493,54,-439
2017,3,25,18,505,478,55,-423
2017,3,25,19,488,466,55,-411
2017,3,25,20,480,463,55,-408
2017,3,25,21,475,467,55,-412
2017,3,25,22,471,478,59,-419
2017,3,25,23,473,482,61,-421
2017,3,26,0,483,479,67,-412
2017,3,26,1,498,448,85,-363
2017,3,26,2,508,489,132,-357
2017,3,26,3,488,513,142,-371
2017,3,26,4,444,440,76,-364
2017,3,26,5,405,386,57,-329
2017,3,26,6,385,371,57,-314
2017,3,26,7,378,365,58,-307
2017,3,26,8,373,359,59,-300
2017,3,26,9,376,361,57,-304
2017,3,26,10,386,374,59,-315
2017,3,26,11,407,392,58,-334
2017,3,26,12,426,429,57,-372
2017,3,26,13,474,470,58,-412
2017,3,26,14,507,496,58,-438
2017,3,26,15,504,495,59,-436
2017,3,26,16,508,485,59,-426
2017,3,26,17,512,484,61,-423
2017,3,26,18,488,479,59,-420
2017,3,26,19,472,475,60,-415
2017,3,26,20,461,466,57,-409
2017,3,26,21,462,470,61,-409
2017,3,26,22,462,472,86,-386
2017,3,26,23,467,429,116,-313
2017,3,27,0,473,504,176,-328
2017,3,27,1,517,530,174,-356
2017,3,27,2,509,552,176,-376
2017,3,27,3,467,487,132,-355
2017,3,27,4,433,418,107,-311
2017,3,27,5,398,371,91,-280
2017,3,27,6,380,371,109,-262
2017,3,27,7,373,363,107,-256
2017,3,27,8,375,365,109,-256
2017,3,27,9,388,381,108,-273
2017,3,27,10,418,413,109,-304
2017,3,27,11,462,483,122,-361
2017,3,27,12,533,519,167,-352
2017,3,27,13,543,529,185,-344
2017,3,27,14,563,532,178,-354
2017,3,27,15,563,529,114,-415
2017,3,27,16,556,528,67,-461
2017,3,27,17,543,529,63,-466
2017,3,27,18,534,528,73,-455
2017,3,27,19,529,531,98,-433
2017,3,27,20,534,520,125,-395
2017,3,27,21,537,521,137,-384
2017,3,27,22,535,465,165,-300
2017,3,27,23,538,490,246,-244
2017,3,28,0,543,552,291,-261
2017,3,28,1,569,566,293,-273
2017,3,28,2,546,539,291,-248
2017,3,28,3,498,566,283,-283
2017,3,28,4,446,456,143,-313
2017,3,28,5,405,391,66,-325
2017,3,28,6,383,382,62,-320
2017,3,28,7,375,377,63,-314
2017,3,28,8,373,376,63,-313
2017,3,28,9,386,385,62,-323
2017,3,28,10,414,423,63,-360
2017,3,28,11,459,490,92,-398
2017,3,28,12,527,532,169,-363
2017,3,28,13,532,530,179,-351
2017,3,28,14,541,530,180,-350
2017,3,28,15,546,521,174,-347
2017,3,28,16,554,498,152,-346
2017,3,28,17,534,523,191,-332
2017,3,28,18,522,526,223,-303
2017,3,28,19,522,520,219,-301
2017,3,28,20,529,515,182,-333
2017,3,28,21,538,519,217,-302
2017,3,28,22,535,522,225,-297
2017,3,28,23,535,469,228,-241
2017,3,29,0,540,544,292,-252
2017,3,29,1,565,567,291,-276
2017,3,29,2,550,537,254,-283
2017,3,29,3,503,491,242,-249
2017,3,29,4,450,441,243,-198
2017,3,29,5,411,460,235,-225
2017,3,29,6,395,433,178,-255
2017,3,29,7,389,388,108,-280
2017,3,29,8,392,385,59,-326
2017,3,29,9,405,399,58,-341
2017,3,29,10,430,443,74,-369
2017,3,29,11,491,517,134,-383
2017,3,29,12,557,558,152,-406
2017,3,29,13,555,554,156,-398
2017,3,29,14,561,545,156,-389
2017,3,29,15,557,536,158,-378
2017,3,29,16,551,528,157,-371
2017,3,29,17,530,521,155,-366
2017,3,29,18,518,525,150,-375
2017,3,29,19,517,518,136,-382
2017,3,29,20,517,526,136,-390
2017,3,29,21,521,539,133,-406
2017,3,29,22,510,480,118,-362
2017,3,29,23,511,495,215,-280
2017,3,30,0,525,547,278,-269
2017,3,30,1,555,568,292,-276
2017,3,30,2,552,542,288,-254
2017,3,30,3,514,485,249,-236
2017,3,30,4,455,480,240,-240
2017,3,30,5,416,458,153,-305
2017,3,30,6,400,381,60,-321
2017,3,30,7,395,377,63,-314
2017,3,30,8,398,376,62,-314
2017,3,30,9,410,349,60,-289
2017,3,30,10,433,413,115,-298
2017,3,30,11,491,495,176,-319
2017,3,30,12,564,522,150,-372
2017,3,30,13,565,529,159,-370
2017,3,30,14,577,538,182,-356
2017,3,30,15,586,538,181,-357
2017,3,30,16,572,540,185,-355
2017,3,30,17,553,539,185,-354
2017,3,30,18,539,539,163,-376
2017,3,30,19,531,528,112,-416
2017,3,30,20,524,525,99,-426
2017,3,30,21,526,523,120,-403
2017,3,30,22,523,497,160,-337
2017,3,30,23,523,459,213,-246
2017,3,31,0,547,546,290,-256
2017,3,31,1,574,561,291,-270
2017,3,31,2,571,533,290,-243
2017,3,31,3,528,485,282,-203
2017,3,31,4,478,424,224,-200
2017,3,31,5,439,365,129,-236
2017,3,31,6,425,363,123,-240
2017,3,31,7,417,419,106,-313
2017,3,31,8,419,378,60,-318
2017,3,31,9,426,387,58,-329
2017,3,31,10,448,417,67,-350
2017,3,31,11,496,482,105,-377
2017,3,31,12,565,506,138,-368
2017,3,31,13,571,457,199,-258
2017,3,31,14,571,530,266,-264
2017,3,31,15,579,505,266,-239
2017,3,31,16,560,526,267,-259
2017,3,31,17,536,514,266,-248
2017,3,31,18,527,514,271,-243
2017,3,31,19,519,496,268,-228
2017,3,31,20,510,498,268,-230
2017,3,31,21,504,496,267,-229
2017,3,31,22,490,495,267,-228
2017,3,31,23,480,475,271,-204
2017,4,1,0,506,517,302,-215
2017,4,1,1,524,529,301,-228
2017,4,1,2,526,513,303,-210
2017,4,1,3,507,480,283,-197
2017,4,1,4,451,442,246,-196
2017,4,1,5,402,404,167,-237
2017,4,1,6,381,397,152,-245
2017,4,1,7,369,386,137,-249
2017,4,1,8,367,388,138,-250
2017,4,1,9,371,395,136,-259
2017,4,1,10,386,412,135,-277
2017,4,1,11,407,443,137,-306
2017,4,1,12,442,482,135,-347
2017,4,1,13,481,514,139,-375
2017,4,1,14,500,535,141,-394
2017,4,1,15,501,530,143,-387
2017,4,1,16,493,518,143,-375
2017,4,1,17,478,494,142,-352
2017,4,1,18,463,479,145,-334
2017,4,1,19,450,464,147,-317
2017,4,1,20,453,460,148,-312
2017,4,1,21,455,461,173,-288
2017,4,1,22,462,472,202,-270
2017,4,1,23,459,471,252,-219
2017,4,2,0,474,496,267,-229
2017,4,2,1,488,510,263,-247
2017,4,2,2,492,492,228,-264
2017,4,2,3,464,472,184,-288
2017,4,2,4,412,489,131,-358
2017,4,2,5,400,403,63,-340
2017,4,2,6,384,388,59,-329
2017,4,2,7,378,386,61,-325
2017,4,2,8,380,393,61,-332
2017,4,2,9,386,402,60,-342
2017,4,2,10,412,424,61,-363
2017,4,2,11,444,453,59,-394
2017,4,2,12,473,490,62,-428
2017,4,2,13,516,474,74,-400
2017,4,2,14,514,530,136,-394
2017,4,2,15,495,501,137,-364
2017,4,2,16,483,476,137,-339
2017,4,2,17,461,470,137,-333
2017,4,2,18,446,460,136,-324
2017,4,2,19,435,454,139,-315
2017,4,2,20,435,453,136,-317
2017,4,2,21,434,466,137,-329
2017,4,2,22,449,484,138,-346
2017,4,2,23,450,493,141,-352
2017,4,3,0,483,501,155,-346
2017,4,3,1,509,526,181,-345
2017,4,3,2,505,504,152,-352
2017,4,3,3,465,463,136,-327
2017,4,3,4,412,415,134,-281
2017,4,3,5,379,416,133,-283
2017,4,3,6,367,376,104,-272
2017,4,3,7,365,363,97,-266
2017,4,3,8,364,364,99,-265
2017,4,3,9,379,377,98,-279
2017,4,3,10,407,411,99,-312
2017,4,3,11,467,479,120,-359
2017,4,3,12,529,521,177,-344
2017,4,3,13,525,532,220,-312
2017,4,3,14,560,543,215,-328
2017,4,3,15,541,536,201,-335
2017,4,3,16,544,543,211,-332
2017,4,3,17,532,538,226,-312
2017,4,3,18,526,551,249,-302
2017,4,3,19,512,553,261,-292
2017,4,3,20,515,551,262,-289
2017,4,3,21,517,556,268,-288
2017,4,3,22,521,526,270,-256
2017,4,3,23,519,536,290,-246
2017,4,4,0,524,552,296,-256
2017,4,4,1,549,572,297,-275
2017,4,4,2,546,549,298,-251
2017,4,4,3,506,504,260,-244
2017,4,4,4,446,461,197,-264
2017,4,4,5,407,458,162,-296
2017,4,4,6,389,413,132,-281
2017,4,4,7,379,408,131,-277
2017,4,4,8,378,404,129,-275
2017,4,4,9,388,409,131,-278
2017,4,4,10,416,420,130,-290
2017,4,4,11,478,500,152,-348
2017,4,4,12,536,555,170,-385
2017,4,4,13,536,541,165,-376
2017,4,4,14,555,535,169,-366
2017,4,4,15,534,532,172,-360
2017,4,4,16,537,524,173,-351
2017,4,4,17,521,519,172,-347
2017,4,4,18,518,516,168,-348
2017,4,4,19,517,549,172,-377
2017,4,4,20,524,527,142,-385
2017,4,4,21,531,525,136,-389
2017,4,4,22,524,512,163,-349
2017,4,4,23,520,543,270,-273
2017,4,5,0,524,551,306,-245
2017,4,5,1,557,575,307,-268
2017,4,5,2,556,547,307,-240
2017,4,5,3,512,491,281,-210
2017,4,5,4,445,444,207,-237
2017,4,5,5,403,471,172,-299
2017,4,5,6,381,429,104,-325
2017,4,5,7,371,382,63,-319
2017,4,5,8,370,380,64,-316
2017,4,5,9,379,393,63,-330
2017,4,5,10,409,427,63,-364
2017,4,5,11,466,467,87,-380
2017,4,5,12,521,472,170,-302
2017,4,5,13,523,544,240,-304
2017,4,5,14,536,559,241,-318
2017,4,5,15,545,566,238,-328
2017,4,5,16,537,573,241,-332
2017,4,5,17,525,566,241,-325
2017,4,5,18,527,566,273,-293
2017,4,5,19,526,554,255,-299
2017,4,5,20,527,550,272,-278
2017,4,5,21,531,547,278,-269
2017,4,5,22,523,559,244,-315
2017,4,5,23,506,564,243,-321
2017,4,6,0,534,569,250,-319
2017,4,6,1,551,579,263,-316
2017,4,6,2,539,551,252,-299
2017,4,6,3,507,504,239,-265
2017,4,6,4,450,515,239,-276
2017,4,6,5,416,461,176,-285
2017,4,6,6,399,409,136,-273
2017,4,6,7,389,401,136,-265
2017,4,6,8,387,401,137,-264
2017,4,6,9,396,414,135,-279
2017,4,6,10,427,458,127,-331
2017,4,6,11,489,443,116,-327
2017,4,6,12,549,559,265,-294
2017,4,6,13,551,584,287,-297
2017,4,6,14,570,584,278,-306
2017,4,6,15,588,588,248,-340
2017,4,6,16,572,586,239,-347
2017,4,6,17,561,582,240,-342
2017,4,6,18,558,575,236,-339
2017,4,6,19,548,567,238,-329
2017,4,6,20,547,565,237,-328
2017,4,6,21,546,574,236,-338
2017,4,6,22,552,586,236,-350
2017,4,6,23,563,598,239,-359
2017,4,7,0,624,639,310,-329
2017,4,7,1,650,671,333,-338
2017,4,7,2,643,652,331,-321
2017,4,7,3,628,636,314,-322
2017,4,7,4,582,646,199,-447
2017,4,7,5,529,544,75,-469
2017,4,7,6,512,528,71,-457
2017,4,7,7,503,525,70,-455
2017,4,7,8,511,535,69,-466
2017,4,7,9,526,557,71,-486
2017,4,7,10,571,589,85,-504
2017,4,7,11,637,581,184,-397
2017,4,7,12,674,707,252,-455
2017,4,7,13,681,710,248,-462
2017,4,7,14,668,695,249,-446
2017,4,7,15,646,669,247,-422
2017,4,7,16,625,645,245,-400
2017,4,7,17,588,616,241,-375
2017,4,7,18,574,606,231,-375
2017,4,7,19,558,578,172,-406
2017,4,7,20,549,556,173,-383
2017,4,7,21,543,542,172,-370
2017,4,7,22,531,539,171,-368
2017,4,7,23,532,545,170,-375
2017,4,8,0,567,568,183,-385
2017,4,8,1,595,601,243,-358
2017,4,8,2,601,603,296,-307
2017,4,8,3,579,596,237,-359
2017,4,8,4,560,627,184,-443
2017,4,8,5,510,526,73,-453
2017,4,8,6,504,511,69,-442
2017,4,8,7,500,510,70,-440
2017,4,8,8,508,515,68,-447
2017,4,8,9,518,526,70,-456
2017,4,8,10,544,544,68,-476
2017,4,8,11,566,493,137,-356
2017,4,8,12,608,613,287,-326
2017,4,8,13,620,647,363,-284
2017,4,8,14,598,660,318,-342
2017,4,8,15,576,629,249,-380
2017,4,8,16,555,586,207,-379
2017,4,8,17,514,541,172,-369
2017,4,8,18,482,512,174,-338
2017,4,8,19,464,543,172,-371
2017,4,8,20,460,519,116,-403
2017,4,8,21,459,467,67,-400
2017,4,8,22,458,471,68,-403
2017,4,8,23,461,386,74,-312
2017,4,9,0,475,499,171,-328
2017,4,9,1,499,524,201,-323
2017,4,9,2,504,518,239,-279
2017,4,9,3,485,496,219,-277
2017,4,9,4,458,483,172,-311
2017,4,9,5,427,533,153,-380
2017,4,9,6,413,457,73,-384
2017,4,9,7,410,457,67,-390
2017,4,9,8,419,468,71,-397
2017,4,9,9,428,490,75,-415
2017,4,9,10,454,510,79,-431
2017,4,9,11,485,472,85,-387
2017,4,9,12,511,595,182,-413
2017,4,9,13,536,626,200,-426
2017,4,9,14,544,591,171,-420
2017,4,9,15,513,542,172,-370
2017,4,9,16,495,515,173,-342
2017,4,9,17,479,562,155,-407
2017,4,9,18,459,473,77,-396
2017,4,9,19,441,452,68,-384
2017,4,9,20,439,451,69,-382
2017,4,9,21,444,461,68,-393
2017,4,9,22,457,472,91,-381
2017,4,9,23,463,462,121,-341
2017,4,10,0,469,395,134,-261
2017,4,10,1,512,512,224,-288
2017,4,10,2,497,497,226,-271
2017,4,10,3,463,517,220,-297
2017,4,10,4,427,466,118,-348
2017,4,10,5,393,371,42,-329
2017,4,10,6,379,384,67,-317
2017,4,10,7,378,382,66,-316
2017,4,10,8,381,389,64,-325
2017,4,10,9,392,403,63,-340
2017,4,10,10,431,445,64,-381
2017,4,10,11,486,507,63,-444
2017,4,10,12,556,553,64,-489
2017,4,10,13,556,566,64,-502
2017,4,10,14,559,559,65,-494
2017,4,10,15,551,545,66,-479
2017,4,10,16,530,529,66,-463
2017,4,10,17,526,514,66,-448
2017,4,10,18,522,501,66,-435
2017,4,10,19,515,424,81,-343
2017,4,10,20,516,517,171,-346
2017,4,10,21,516,522,180,-342
2017,4,10,22,516,529,234,-295
2017,4,10,23,500,536,237,-299
2017,4,11,0,533,537,235,-302
2017,4,11,1,563,556,236,-320
2017,4,11,2,541,557,235,-322
2017,4,11,3,506,544,205,-339
2017,4,11,4,458,447,91,-356
2017,4,11,5,406,380,41,-339
2017,4,11,6,384,376,60,-316
2017,4,11,7,375,369,61,-308
2017,4,11,8,372,371,60,-311
2017,4,11,9,379,384,60,-324
2017,4,11,10,410,410,61,-349
2017,4,11,11,458,403,65,-338
2017,4,11,12,511,483,134,-349
2017,4,11,13,525,522,168,-354
2017,4,11,14,527,523,171,-352
2017,4,11,15,531,530,169,-361
2017,4,11,16,524,601,155,-446
2017,4,11,17,521,533,83,-450
2017,4,11,18,522,524,88,-436
2017,4,11,19,526,493,95,-398
2017,4,11,20,529,472,142,-330
2017,4,11,21,538,549,209,-340
2017,4,11,22,532,556,211,-345
2017,4,11,23,511,551,209,-342
2017,4,12,0,548,549,208,-341
2017,4,12,1,571,566,229,-337
2017,4,12,2,548,547,241,-306
2017,4,12,3,507,580,224,-356
2017,4,12,4,459,466,90,-376
2017,4,12,5,409,413,66,-347
2017,4,12,6,385,388,64,-324
2017,4,12,7,370,382,66,-316
2017,4,12,8,370,375,67,-308
2017,4,12,9,380,382,66,-316
2017,4,12,10,409,405,67,-338
2017,4,12,11,462,458,87,-371
2017,4,12,12,513,493,87,-406
2017,4,12,13,526,507,73,-434
2017,4,12,14,531,519,64,-455
2017,4,12,15,539,524,66,-458
2017,4,12,16,532,526,66,-460
2017,4,12,17,529,516,66,-450
2017,4,12,18,533,439,78,-361
2017,4,12,19,525,535,197,-338
2017,4,12,20,538,545,244,-301
2017,4,12,21,544,558,246,-312
2017,4,12,22,529,563,246,-317
2017,4,12,23,522,565,257,-308
2017,4,13,0,542,554,264,-290
2017,4,13,1,557,568,264,-304
2017,4,13,2,543,560,252,-308
2017,4,13,3,502,581,168,-413
2017,4,13,4,457,450,69,-381
2017,4,13,5,410,390,49,-341
2017,4,13,6,389,388,63,-325
2017,4,13,7,377,375,62,-313
2017,4,13,8,376,374,64,-310
2017,4,13,9,386,381,63,-318
2017,4,13,10,414,411,63,-348
2017,4,13,11,463,462,64,-398
2017,4,13,12,517,508,63,-445
2017,4,13,13,529,520,64,-456
2017,4,13,14,531,522,65,-457
2017,4,13,15,535,526,65,-461
2017,4,13,16,534,521,65,-456
2017,4,13,17,520,525,67,-458
2017,4,13,18,516,523,103,-420
2017,4,13,19,509,441,159,-282
2017,4,13,20,511,539,260,-279
2017,4,13,21,522,544,260,-284
2017,4,13,22,509,549,256,-293
2017,4,13,23,512,548,250,-298
2017,4,14,0,529,536,248,-288
2017,4,14,1,549,550,249,-301
2017,4,14,2,533,586,250,-336
2017,4,14,3,500,527,192,-335
2017,4,14,4,453,422,142,-280
2017,4,14,5,411,390,135,-255
2017,4,14,6,386,366,76,-290
2017,4,14,7,374,355,61,-294
2017,4,14,8,371,351,63,-288
2017,4,14,9,380,357,63,-294
2017,4,14,10,409,379,61,-318
2017,4,14,11,452,418,93,-325
2017,4,14,12,494,453,110,-343
2017,4,14,13,518,474,113,-361
2017,4,14,14,529,486,111,-375
2017,4,14,15,529,487,181,-306
2017,4,14,16,526,492,181,-311
2017,4,14,17,519,500,113,-387
2017,4,14,18,503,500,113,-387
2017,4,14,19,513,421,125,-296
2017,4,14,20,530,528,242,-286
2017,4,14,21,535,541,244,-297
2017,4,14,22,529,544,267,-277
2017,4,14,23,521,537,245,-292
2017,4,15,0,521,525,243,-282
2017,4,15,1,538,608,245,-363
2017,4,15,2,526,543,156,-387
2017,4,15,3,512,477,79,-398
2017,4,15,4,452,431,60,-371
2017,4,15,5,401,394,59,-335
2017,4,15,6,376,374,61,-313
2017,4,15,7,363,357,60,-297
2017,4,15,8,359,355,60,-295
2017,4,15,9,364,353,62,-291
2017,4,15,10,376,362,62,-300
2017,4,15,11,374,379,75,-304
2017,4,15,12,427,406,77,-329
2017,4,15,13,464,438,77,-361
2017,4,15,14,494,466,68,-398
2017,4,15,15,509,482,66,-416
2017,4,15,16,503,485,65,-420
2017,4,15,17,503,494,65,-429
2017,4,15,18,489,500,66,-434
2017,4,15,19,494,438,66,-372
2017,4,15,20,495,464,131,-333
2017,4,15,21,498,520,176,-344
2017,4,15,22,504,523,196,-327
2017,4,15,23,483,521,211,-310
2017,4,16,0,490,512,210,-302
2017,4,16,1,510,555,208,-347
2017,4,16,2,502,586,179,-407
2017,4,16,3,476,475,101,-374
2017,4,16,4,429,429,87,-342
2017,4,16,5,394,390,69,-321
2017,4,16,6,364,365,67,-298
2017,4,16,7,352,350,70,-280
2017,4,16,8,348,345,65,-280
2017,4,16,9,350,346,64,-282
2017,4,16,10,357,356,64,-292
2017,4,16,11,358,373,63,-310
2017,4,16,12,401,399,63,-336
2017,4,16,13,451,439,63,-376
2017,4,16,14,474,466,61,-405
2017,4,16,15,478,469,61,-408
2017,4,16,16,478,469,61,-408
2017,4,16,17,494,480,62,-418
2017,4,16,18,476,486,65,-421
2017,4,16,19,477,420,122,-298
2017,4,16,20,476,439,200,-239
2017,4,16,21,481,486,233,-253
2017,4,16,22,491,492,214,-278
2017,4,16,23,481,497,214,-283
2017,4,17,0,482,527,214,-313
2017,4,17,1,516,508,229,-279
2017,4,17,2,505,569,200,-369
2017,4,17,3,471,477,91,-386
2017,4,17,4,418,417,62,-355
2017,4,17,5,387,358,38,-320
2017,4,17,6,356,360,59,-301
2017,4,17,7,340,353,62,-291
2017,4,17,8,337,350,61,-289
2017,4,17,9,342,357,62,-295
2017,4,17,10,362,389,61,-328
2017,4,17,11,394,452,61,-391
2017,4,17,12,441,483,62,-421
2017,4,17,13,465,497,61,-436
2017,4,17,14,490,515,63,-452
2017,4,17,15,506,521,63,-458
2017,4,17,16,524,533,94,-439
2017,4,17,17,523,537,122,-415
2017,4,17,18,527,541,136,-405
2017,4,17,19,515,538,148,-390
2017,4,17,20,535,536,148,-388
2017,4,17,21,553,455,155,-300
2017,4,17,22,539,527,239,-288
2017,4,17,23,539,552,255,-297
2017,4,18,0,545,556,250,-306
2017,4,18,1,564,589,244,-345
2017,4,18,2,531,615,224,-391
2017,4,18,3,486,490,145,-345
2017,4,18,4,445,437,141,-296
2017,4,18,5,403,399,84,-315
2017,4,18,6,379,383,65,-318
2017,4,18,7,367,375,67,-308
2017,4,18,8,364,373,66,-307
2017,4,18,9,374,381,66,-315
2017,4,18,10,404,409,65,-344
2017,4,18,11,457,474,71,-403
2017,4,18,12,503,509,91,-418
2017,4,18,13,512,522,91,-431
2017,4,18,14,521,526,91,-435
2017,4,18,15,528,545,91,-454
2017,4,18,16,532,540,92,-448
2017,4,18,17,527,535,92,-443
2017,4,18,18,525,527,90,-437
2017,4,18,19,516,525,93,-432
2017,4,18,20,528,518,92,-426
2017,4,18,21,535,524,93,-431
2017,4,18,22,527,521,91,-430
2017,4,18,23,535,476,98,-378
2017,4,19,0,541,504,158,-346
2017,4,19,1,558,559,198,-361
2017,4,19,2,535,536,182,-354
2017,4,19,3,496,512,178,-334
2017,4,19,4,444,518,154,-364
2017,4,19,5,421,406,71,-335
2017,4,19,6,398,393,73,-320
2017,4,19,7,385,386,66,-320
2017,4,19,8,384,379,62,-317
2017,4,19,9,392,391,64,-327
2017,4,19,10,425,423,64,-359
2017,4,19,11,475,487,75,-412
2017,4,19,12,513,521,93,-428
2017,4,19,13,528,454,154,-300
2017,4,19,14,531,532,317,-215
2017,4,19,15,530,543,248,-295
2017,4,19,16,531,544,227,-317
2017,4,19,17,520,536,294,-242
2017,4,19,18,509,584,232,-352
2017,4,19,19,490,540,161,-379
2017,4,19,20,504,521,186,-335
2017,4,19,21,512,516,63,-453
2017,4,19,22,514,480,62,-418
2017,4,19,23,520,488,118,-370
2017,4,20,0,529,547,168,-379
2017,4,20,1,551,558,168,-390
2017,4,20,2,531,541,170,-371
2017,4,20,3,493,551,170,-381
2017,4,20,4,447,480,103,-377
2017,4,20,5,402,402,63,-339
2017,4,20,6,377,381,62,-319
2017,4,20,7,367,369,61,-308
2017,4,20,8,361,370,60,-310
2017,4,20,9,369,380,62,-318
2017,4,20,10,400,416,63,-353
2017,4,20,11,453,478,69,-409
2017,4,20,12,485,514,180,-334
2017,4,20,13,498,516,240,-276
2017,4,20,14,515,524,238,-286
2017,4,20,15,524,513,205,-308
2017,4,20,16,531,516,218,-298
2017,4,20,17,526,535,203,-332
2017,4,20,18,529,535,195,-340
2017,4,20,19,516,468,198,-270
2017,4,20,20,535,536,232,-304
2017,4,20,21,547,539,236,-303
2017,4,20,22,547,542,246,-296
2017,4,20,23,534,543,281,-262
2017,4,21,0,545,544,295,-249
2017,4,21,1,570,559,297,-262
2017,4,21,2,550,543,285,-258
2017,4,21,3,511,554,257,-297
2017,4,21,4,469,490,195,-295
2017,4,21,5,416,406,128,-278
2017,4,21,6,392,387,90,-297
2017,4,21,7,377,374,77,-297
2017,4,21,8,371,372,77,-295
2017,4,21,9,377,377,74,-303
2017,4,21,10,405,412,85,-327
2017,4,21,11,455,470,132,-338
2017,4,21,12,490,503,134,-369
2017,4,21,13,488,510,215,-295
2017,4,21,14,521,528,279,-249
2017,4,21,15,533,541,246,-295
2017,4,21,16,540,548,201,-347
2017,4,21,17,546,551,227,-324
2017,4,21,18,560,561,252,-309
2017,4,21,19,555,476,247,-229
2017,4,21,20,571,556,316,-240
2017,4,21,21,583,565,258,-307
2017,4,21,22,568,552,314,-238
2017,4,21,23,561,534,330,-204
2017,4,22,0,563,545,285,-260
2017,4,22,1,572,548,240,-308
2017,4,22,2,562,529,242,-287
2017,4,22,3,546,498,240,-258
2017,4,22,4,479,538,220,-318
2017,4,22,5,421,415,84,-331
2017,4,22,6,395,384,66,-318
2017,4,22,7,378,373,67,-306
2017,4,22,8,371,367,65,-302
2017,4,22,9,369,368,67,-301
2017,4,22,10,377,378,66,-312
2017,4,22,11,388,396,67,-329
2017,4,22,12,417,420,66,-354
2017,4,22,13,452,455,73,-382
2017,4,22,14,476,478,77,-401
2017,4,22,15,500,498,77,-421
2017,4,22,16,511,507,77,-430
2017,4,22,17,524,514,90,-424
2017,4,22,18,517,512,115,-397
2017,4,22,19,493,500,113,-387
2017,4,22,20,504,415,122,-293
2017,4,22,21,527,495,229,-266
2017,4,22,22,532,521,268,-253
2017,4,22,23,527,520,255,-265
2017,4,23,0,520,515,210,-305
2017,4,23,1,520,521,199,-322
2017,4,23,2,537,492,176,-316
2017,4,23,3,492,457,170,-287
2017,4,23,4,445,430,168,-262
2017,4,23,5,398,468,154,-314
2017,4,23,6,373,370,68,-302
2017,4,23,7,356,354,63,-291
2017,4,23,8,347,350,61,-289
2017,4,23,9,349,345,60,-285
2017,4,23,10,357,357,61,-296
2017,4,23,11,372,375,61,-314
2017,4,23,12,399,351,61,-290
2017,4,23,13,442,430,117,-313
2017,4,23,14,486,478,132,-346
2017,4,23,15,498,492,133,-359
2017,4,23,16,497,500,135,-365
2017,4,23,17,514,510,134,-376
2017,4,23,18,497,508,132,-376
2017,4,23,19,470,505,135,-370
2017,4,23,20,470,505,134,-371
2017,4,23,21,487,513,133,-380
2017,4,23,22,503,534,135,-399
2017,4,23,23,514,539,133,-406
2017,4,24,0,523,548,132,-416
2017,4,24,1,539,553,133,-420
2017,4,24,2,544,537,132,-405
2017,4,24,3,497,481,132,-349
2017,4,24,4,458,450,133,-317
2017,4,24,5,424,418,129,-289
2017,4,24,6,409,405,129,-276
2017,4,24,7,398,402,130,-272
2017,4,24,8,401,402,131,-271
2017,4,24,9,412,413,129,-284
2017,4,24,10,448,453,131,-322
2017,4,24,11,498,531,131,-400
2017,4,24,12,540,558,130,-428
2017,4,24,13,549,560,156,-404
2017,4,24,14,554,562,200,-362
2017,4,24,15,555,566,251,-315
2017,4,24,16,564,567,258,-309
2017,4,24,17,543,566,263,-303
2017,4,24,18,528,567,258,-309
2017,4,24,19,485,554,256,-298
2017,4,24,20,501,552,256,-296
2017,4,24,21,516,558,261,-297
2017,4,24,22,527,570,264,-306
2017,4,24,23,536,570,263,-307
2017,4,25,0,546,574,264,-310
2017,4,25,1,567,581,264,-317
2017,4,25,2,552,554,261,-293
2017,4,25,3,522,500,262,-238
2017,4,25,4,484,457,226,-231
2017,4,25,5,441,424,176,-248
2017,4,25,6,424,403,138,-265
2017,4,25,7,408,404,137,-267
2017,4,25,8,408,399,136,-263
2017,4,25,9,417,410,137,-273
2017,4,25,10,448,448,142,-306
2017,4,25,11,494,524,173,-351
2017,4,25,12,530,552,228,-324
2017,4,25,13,537,550,239,-311
2017,4,25,14,534,548,232,-316
2017,4,25,15,534,537,211,-326
2017,4,25,16,544,535,211,-324
2017,4,25,17,524,524,211,-313
2017,4,25,18,521,524,213,-311
2017,4,25,19,483,519,216,-303
2017,4,25,20,497,523,216,-307
2017,4,25,21,514,527,230,-297
2017,4,25,22,517,537,250,-287
2017,4,25,23,522,537,257,-280
2017,4,26,0,529,538,263,-275
2017,4,26,1,548,558,263,-295
2017,4,26,2,534,542,259,-283
2017,4,26,3,508,489,202,-287
2017,4,26,4,453,439,188,-251
2017,4,26,5,398,398,152,-246
2017,4,26,6,376,377,137,-240
2017,4,26,7,364,367,137,-230
2017,4,26,8,361,371,141,-230
2017,4,26,9,371,379,137,-242
2017,4,26,10,402,409,142,-267
2017,4,26,11,460,479,176,-303
2017,4,26,12,498,511,213,-298
2017,4,26,13,508,515,216,-299
2017,4,26,14,517,505,211,-294
2017,4,26,15,527,504,210,-294
2017,4,26,16,535,507,212,-295
2017,4,26,17,536,512,214,-298
2017,4,26,18,532,525,226,-299
2017,4,26,19,531,531,232,-299
2017,4,26,20,554,549,238,-311
2017,4,26,21,573,561,263,-298
2017,4,26,22,575,577,270,-307
2017,4,26,23,574,574,270,-304
2017,4,27,0,568,568,265,-303
2017,4,27,1,581,575,221,-354
2017,4,27,2,568,557,177,-380
2017,4,27,3,543,502,138,-364
2017,4,27,4,483,446,136,-310
2017,4,27,5,405,388,124,-264
2017,4,27,6,381,378,132,-246
2017,4,27,7,369,370,135,-235
2017,4,27,8,366,363,132,-231
2017,4,27,9,374,367,136,-231
2017,4,27,10,405,398,156,-242
2017,4,27,11,465,467,163,-304
2017,4,27,12,503,489,165,-324
2017,4,27,13,507,494,162,-332
2017,4,27,14,521,504,164,-340
2017,4,27,15,528,507,164,-343
2017,4,27,16,527,509,175,-334
2017,4,27,17,528,510,167,-343
2017,4,27,18,519,511,172,-339
2017,4,27,19,522,505,167,-338
2017,4,27,20,539,507,176,-331
2017,4,27,21,543,508,180,-328
2017,4,27,22,544,512,184,-328
2017,4,27,23,544,510,183,-327
2017,4,28,0,547,515,182,-333
2017,4,28,1,563,531,183,-348
2017,4,28,2,556,528,181,-347
2017,4,28,3,525,483,177,-306
2017,4,28,4,471,429,145,-284
2017,4,28,5,396,423,133,-290
2017,4,28,6,374,381,102,-279
2017,4,28,7,365,364,100,-264
2017,4,28,8,362,363,99,-264
2017,4,28,9,371,371,100,-271
2017,4,28,10,400,400,100,-300
2017,4,28,11,464,444,124,-320
2017,4,28,12,494,489,190,-299
2017,4,28,13,499,510,204,-306
2017,4,28,14,513,515,212,-303
2017,4,28,15,522,518,223,-295
2017,4,28,16,531,529,214,-315
2017,4,28,17,540,536,227,-309
2017,4,28,18,556,531,252,-279
2017,4,28,19,550,544,272,-272
2017,4,28,20,576,566,261,-305
2017,4,28,21,585,570,242,-328
2017,4,28,22,577,575,240,-335
2017,4,28,23,573,569,239,-330
2017,4,29,0,563,559,240,-319
2017,4,29,1,568,555,250,-305
2017,4,29,2,561,551,302,-249
2017,4,29,3,534,515,301,-214
2017,4,29,4,478,482,300,-182
2017,4,29,5,430,500,264,-236
2017,4,29,6,399,407,148,-259
2017,4,29,7,385,377,121,-256
2017,4,29,8,379,366,109,-257
2017,4,29,9,377,366,97,-269
2017,4,29,10,387,370,79,-291
2017,4,29,11,399,360,67,-293
2017,4,29,12,425,424,101,-323
2017,4,29,13,467,467,108,-359
2017,4,29,14,501,502,165,-337
2017,4,29,15,532,529,211,-318
2017,4,29,16,562,495,211,-284
2017,4,29,17,577,583,281,-302
2017,4,29,18,582,588,296,-292
2017,4,29,19,596,607,366,-241
2017,4,29,20,587,611,342,-269
2017,4,29,21,601,626,340,-286
2017,4,29,22,608,628,314,-314
2017,4,29,23,588,623,318,-305
2017,4,30,0,584,603,308,-295
2017,4,30,1,568,597,306,-291
2017,4,30,2,571,581,275,-306
2017,4,30,3,538,595,227,-368
2017,4,30,4,486,527,129,-398
2017,4,30,5,458,436,65,-371
2017,4,30,6,412,405,67,-338
2017,4,30,7,391,389,66,-323
2017,4,30,8,379,377,66,-311
2017,4,30,9,372,376,66,-310
2017,4,30,10,374,379,67,-312
2017,4,30,11,375,386,67,-319
2017,4,30,12,393,411,68,-343
2017,4,30,13,451,457,100,-357
2017,4,30,14,481,491,133,-358
2017,4,30,15,504,493,135,-358
2017,4,30,16,529,429,145,-284
2017,4,30,17,561,529,235,-294
2017,4,30,18,557,541,239,-302
2017,4,30,19,556,546,250,-296
2017,4,30,20,557,559,245,-314
2017,4,30,21,556,567,273,-294
2017,4,30,22,567,577,299,-278
2017,4,30,23,547,583,302,-281
2017,5,1,0,539,566,298,-268
2017,5,1,1,536,574,266,-308
2017,5,1,2,536,563,243,-320
2017,5,1,3,504,528,226,-302
2017,5,1,4,451,543,196,-347
2017,5,1,5,409,421,68,-353
2017,5,1,6,384,396,60,-336
2017,5,1,7,369,385,59,-326
2017,5,1,8,365,380,60,-320
2017,5,1,9,373,388,64,-324
2017,5,1,10,399,419,97,-322
2017,5,1,11,456,484,159,-325
2017,5,1,12,489,515,166,-349
2017,5,1,13,510,530,166,-364
2017,5,1,14,527,549,175,-374
2017,5,1,15,541,513,178,-335
2017,5,1,16,557,509,217,-292
2017,5,1,17,556,564,274,-290
2017,5,1,18,555,563,272,-291
2017,5,1,19,543,556,274,-282
2017,5,1,20,566,560,296,-264
2017,5,1,21,569,564,298,-266
2017,5,1,22,573,577,302,-275
2017,5,1,23,555,580,304,-276
2017,5,2,0,551,568,302,-266
2017,5,2,1,558,565,300,-265
2017,5,2,2,540,547,301,-246
2017,5,2,3,510,493,275,-218
2017,5,2,4,465,436,183,-253
2017,5,2,5,408,393,166,-227
2017,5,2,6,388,379,171,-208
2017,5,2,7,377,370,171,-199
2017,5,2,8,375,366,170,-196
2017,5,2,9,385,374,169,-205
2017,5,2,10,416,413,172,-241
2017,5,2,11,483,478,178,-300
2017,5,2,12,514,509,196,-313
2017,5,2,13,522,513,191,-322
2017,5,2,14,520,522,171,-351
2017,5,2,15,519,524,176,-348
2017,5,2,16,524,517,173,-344
2017,5,2,17,520,522,176,-346
2017,5,2,18,517,525,177,-348
2017,5,2,19,514,528,221,-307
2017,5,2,20,533,530,245,-285
2017,5,2,21,541,542,287,-255
2017,5,2,22,544,548,305,-243
2017,5,2,23,535,554,304,-250
2017,5,3,0,534,548,304,-244
2017,5,3,1,548,556,305,-251
2017,5,3,2,537,545,303,-242
2017,5,3,3,507,535,250,-285
2017,5,3,4,461,498,133,-365
2017,5,3,5,397,395,56,-339
2017,5,3,6,378,379,56,-323
2017,5,3,7,368,377,61,-316
2017,5,3,8,368,370,60,-310
2017,5,3,9,378,381,62,-319
2017,5,3,10,410,328,60,-268
2017,5,3,11,479,459,147,-312
2017,5,3,12,510,519,179,-340
2017,5,3,13,505,509,168,-341
2017,5,3,14,518,519,177,-342
2017,5,3,15,512,520,175,-345
2017,5,3,16,511,519,176,-343
2017,5,3,17,510,516,176,-340
2017,5,3,18,523,526,177,-349
2017,5,3,19,510,536,206,-330
2017,5,3,20,530,546,245,-301
2017,5,3,21,542,567,289,-278
2017,5,3,22,545,573,307,-266
2017,5,3,23,541,574,307,-267
2017,5,4,0,542,566,302,-264
2017,5,4,1,558,569,218,-351
2017,5,4,2,548,560,169,-391
2017,5,4,3,513,566,170,-396
2017,5,4,4,455,495,110,-385
2017,5,4,5,397,410,60,-350
2017,5,4,6,376,387,58,-329
2017,5,4,7,367,380,63,-317
2017,5,4,8,365,377,62,-315
2017,5,4,9,373,385,63,-322
2017,5,4,10,404,417,63,-354
2017,5,4,11,469,380,63,-317
2017,5,4,12,500,498,161,-337
2017,5,4,13,497,517,170,-347
2017,5,4,14,512,526,170,-356
2017,5,4,15,514,535,171,-364
2017,5,4,16,517,542,170,-372
2017,5,4,17,518,537,182,-355
2017,5,4,18,525,534,213,-321
2017,5,4,19,501,530,237,-293
2017,5,4,20,519,527,263,-264
2017,5,4,21,526,529,294,-235
2017,5,4,22,524,533,303,-230
2017,5,4,23,528,546,305,-241
2017,5,5,0,534,550,305,-245
2017,5,5,1,552,546,304,-242
2017,5,5,2,535,533,306,-227
2017,5,5,3,502,484,304,-180
2017,5,5,4,453,510,306,-204
2017,5,5,5,402,446,177,-269
2017,5,5,6,382,390,84,-306
2017,5,5,7,372,380,68,-312
2017,5,5,8,367,383,68,-315
2017,5,5,9,380,389,69,-320
2017,5,5,10,397,409,68,-341
2017,5,5,11,475,391,93,-298
2017,5,5,12,512,511,230,-281
2017,5,5,13,518,526,246,-280
2017,5,5,14,536,533,244,-289
2017,5,5,15,532,537,248,-289
2017,5,5,16,529,532,245,-287
2017,5,5,17,532,525,241,-284
2017,5,5,18,533,514,245,-269
2017,5,5,19,519,519,246,-273
2017,5,5,20,528,512,213,-299
2017,5,5,21,533,517,196,-321
2017,5,5,22,541,523,200,-323
2017,5,5,23,549,526,197,-329
2017,5,6,0,552,523,188,-335
2017,5,6,1,561,534,180,-354
2017,5,6,2,557,523,179,-344
2017,5,6,3,545,495,169,-326
2017,5,6,4,498,459,171,-288
2017,5,6,5,448,461,168,-293
2017,5,6,6,436,424,140,-284
2017,5,6,7,427,404,134,-270
2017,5,6,8,429,406,135,-271
2017,5,6,9,440,419,134,-285
2017,5,6,10,459,435,135,-300
2017,5,6,11,484,437,136,-301
2017,5,6,12,518,510,168,-342
2017,5,6,13,548,545,169,-376
2017,5,6,14,556,557,170,-387
2017,5,6,15,545,544,171,-373
2017,5,6,16,531,532,172,-360
2017,5,6,17,519,523,170,-353
2017,5,6,18,494,518,172,-346
2017,5,6,19,471,524,171,-353
2017,5,6,20,468,532,169,-363
2017,5,6,21,477,545,168,-377
2017,5,6,22,486,562,171,-391
2017,5,6,23,489,569,170,-399
2017,5,7,0,493,562,168,-394
2017,5,7,1,511,578,171,-407
2017,5,7,2,532,575,169,-406
2017,5,7,3,503,549,170,-379
2017,5,7,4,470,546,169,-377
2017,5,7,5,431,547,130,-417
2017,5,7,6,416,467,62,-405
2017,5,7,7,410,461,61,-400
2017,5,7,8,413,461,62,-399
2017,5,7,9,421,462,69,-393
2017,5,7,10,439,481,78,-403
2017,5,7,11,461,507,76,-431
2017,5,7,12,493,540,77,-463
2017,5,7,13,522,498,100,-398
2017,5,7,14,534,509,199,-310
2017,5,7,15,505,533,245,-288
2017,5,7,16,485,509,205,-304
2017,5,7,17,477,498,182,-316
2017,5,7,18,460,484,177,-307
2017,5,7,19,437,472,177,-295
2017,5,7,20,436,461,176,-285
2017,5,7,21,450,468,176,-292
2017,5,7,22,457,481,193,-288
2017,5,7,23,466,491,244,-247
2017,5,8,0,473,510,245,-265
2017,5,8,1,492,522,244,-278
2017,5,8,2,511,525,243,-282
2017,5,8,3,478,488,218,-270
2017,5,8,4,436,495,172,-323
2017,5,8,5,407,487,128,-359
2017,5,8,6,390,409,62,-347
2017,5,8,7,385,412,63,-349
2017,5,8,8,387,416,64,-352
2017,5,8,9,399,429,63,-366
2017,5,8,10,439,444,41,-403
2017,5,8,11,502,549,122,-427
2017,5,8,12,546,521,133,-388
2017,5,8,13,539,519,190,-329
2017,5,8,14,544,557,241,-316
2017,5,8,15,536,550,240,-310
2017,5,8,16,528,540,243,-297
2017,5,8,17,521,524,240,-284
2017,5,8,18,525,519,210,-309
2017,5,8,19,509,510,201,-309
2017,5,8,20,509,506,211,-295
2017,5,8,21,514,507,241,-266
2017,5,8,22,518,517,240,-277
2017,5,8,23,517,532,241,-291
2017,5,9,0,525,536,240,-296
2017,5,9,1,538,548,240,-308
2017,5,9,2,527,539,238,-301
2017,5,9,3,491,537,239,-298
2017,5,9,4,449,506,140,-366
2017,5,9,5,399,404,54,-350
2017,5,9,6,378,394,58,-336
2017,5,9,7,370,385,56,-329
2017,5,9,8,366,384,59,-325
2017,5,9,9,377,394,57,-337
2017,5,9,10,405,430,79,-351
2017,5,9,11,470,439,120,-319
2017,5,9,12,509,551,247,-304
2017,5,9,13,507,565,235,-330
2017,5,9,14,517,541,198,-343
2017,5,9,15,516,495,129,-366
2017,5,9,16,517,518,126,-392
2017,5,9,17,513,547,143,-404
2017,5,9,18,529,546,141,-405
2017,5,9,19,525,549,142,-407
2017,5,9,20,533,559,140,-419
2017,5,9,21,545,575,141,-434
2017,5,9,22,547,581,138,-443
2017,5,9,23,547,594,141,-453
2017,5,10,0,549,566,144,-422
2017,5,10,1,557,579,221,-358
2017,5,10,2,548,575,246,-329
2017,5,10,3,508,518,245,-273
2017,5,10,4,456,514,207,-307
2017,5,10,5,414,467,120,-347
2017,5,10,6,384,397,65,-332
2017,5,10,7,369,383,66,-317
2017,5,10,8,365,383,66,-317
2017,5,10,9,372,385,66,-319
2017,5,10,10,398,416,73,-343
2017,5,10,11,457,483,112,-371
2017,5,10,12,491,512,111,-401
2017,5,10,13,497,526,114,-412
2017,5,10,14,520,539,112,-427
2017,5,10,15,532,541,113,-428
2017,5,10,16,541,476,123,-353
2017,5,10,17,551,576,212,-364
2017,5,10,18,567,590,209,-381
2017,5,10,19,571,598,207,-391
2017,5,10,20,592,608,245,-363
2017,5,10,21,608,639,296,-343
2017,5,10,22,611,649,390,-259
2017,5,10,23,609,651,417,-234
2017,5,11,0,595,632,438,-194
2017,5,11,1,593,639,437,-202
2017,5,11,2,579,679,378,-301
2017,5,11,3,539,548,167,-381
2017,5,11,4,490,477,75,-402
2017,5,11,5,428,429,64,-365
2017,5,11,6,400,404,65,-339
2017,5,11,7,384,391,64,-327
2017,5,11,8,378,382,65,-317
2017,5,11,9,382,387,64,-323
2017,5,11,10,405,420,67,-353
2017,5,11,11,457,479,64,-415
2017,5,11,12,501,498,65,-433
2017,5,11,13,513,510,84,-426
2017,5,11,14,530,548,162,-386
2017,5,11,15,539,546,165,-381
2017,5,11,16,553,503,175,-328
2017,5,11,17,565,561,234,-327
2017,5,11,18,587,566,233,-333
2017,5,11,19,588,574,229,-345
2017,5,11,20,619,588,251,-337
2017,5,11,21,630,604,348,-256
2017,5,11,22,635,613,374,-239
2017,5,11,23,626,607,362,-245
2017,5,12,0,612,597,357,-240
2017,5,12,1,607,592,349,-243
2017,5,12,2,592,576,237,-339
2017,5,12,3,543,576,156,-420
2017,5,12,4,502,510,106,-404
2017,5,12,5,446,417,59,-358
2017,5,12,6,406,395,60,-335
2017,5,12,7,387,383,61,-322
2017,5,12,8,382,380,61,-319
2017,5,12,9,387,386,60,-326
2017,5,12,10,402,414,61,-353
2017,5,12,11,460,475,95,-380
2017,5,12,12,491,507,100,-407
2017,5,12,13,504,521,92,-429
2017,5,12,14,529,533,92,-441
2017,5,12,15,535,535,91,-444
2017,5,12,16,527,524,96,-428
2017,5,12,17,551,500,118,-382
2017,5,12,18,561,557,170,-387
2017,5,12,19,556,553,166,-387
2017,5,12,20,558,551,161,-390
2017,5,12,21,559,548,161,-387
2017,5,12,22,556,548,162,-386
2017,5,12,23,542,539,159,-380
2017,5,13,0,529,524,161,-363
2017,5,13,1,528,521,161,-360
2017,5,13,2,535,549,161,-388
2017,5,13,3,495,530,120,-410
2017,5,13,4,455,436,63,-373
2017,5,13,5,406,399,60,-339
2017,5,13,6,376,382,64,-318
2017,5,13,7,359,374,64,-310
2017,5,13,8,353,366,63,-303
2017,5,13,9,358,368,63,-305
2017,5,13,10,368,382,63,-319
2017,5,13,11,375,403,65,-338
2017,5,13,12,419,428,64,-364
2017,5,13,13,451,439,67,-372
2017,5,13,14,482,451,94,-357
2017,5,13,15,495,477,136,-341
2017,5,13,16,494,509,164,-345
2017,5,13,17,491,498,163,-335
2017,5,13,18,483,500,165,-335
2017,5,13,19,488,495,162,-333
2017,5,13,20,485,496,163,-333
2017,5,13,21,494,505,164,-341
2017,5,13,22,504,505,162,-343
2017,5,13,23,489,506,164,-342
2017,5,14,0,494,495,161,-334
2017,5,14,1,493,498,160,-338
2017,5,14,2,494,510,162,-348
2017,5,14,3,461,541,148,-393
2017,5,14,4,431,426,70,-356
2017,5,14,5,398,386,62,-324
2017,5,14,6,362,368,62,-306
2017,5,14,7,349,358,64,-294
2017,5,14,8,344,354,63,-291
2017,5,14,9,345,360,64,-296
2017,5,14,10,352,369,63,-306
2017,5,14,11,361,390,63,-327
2017,5,14,12,396,427,64,-363
2017,5,14,13,436,465,64,-401
2017,5,14,14,458,476,65,-411
2017,5,14,15,465,448,70,-378
2017,5,14,16,462,461,98,-363
2017,5,14,17,471,403,104,-299
2017,5,14,18,467,465,164,-301
2017,5,14,19,469,466,165,-301
2017,5,14,20,473,477,164,-313
2017,5,14,21,490,495,180,-315
2017,5,14,22,510,514,226,-288
2017,5,14,23,506,527,231,-296
2017,5,15,0,504,525,230,-295
2017,5,15,1,517,533,233,-300
2017,5,15,2,518,598,229,-369
2017,5,15,3,480,499,153,-346
2017,5,15,4,447,425,96,-329
2017,5,15,5,389,389,81,-308
2017,5,15,6,363,371,65,-306
2017,5,15,7,352,360,65,-295
2017,5,15,8,350,355,67,-288
2017,5,15,9,359,363,68,-295
2017,5,15,10,390,401,68,-333
2017,5,15,11,435,462,67,-395
2017,5,15,12,486,498,68,-430
2017,5,15,13,502,507,68,-439
2017,5,15,14,519,521,70,-451
2017,5,15,15,529,535,73,-462
2017,5,15,16,541,542,89,-453
2017,5,15,17,550,546,138,-408
2017,5,15,18,570,476,157,-319
2017,5,15,19,574,581,261,-320
2017,5,15,20,593,574,238,-336
2017,5,15,21,607,618,358,-260
2017,5,15,22,615,633,407,-226
2017,5,15,23,618,636,413,-223
2017,5,16,0,600,627,401,-226
2017,5,16,1,595,619,389,-230
2017,5,16,2,579,648,377,-271
2017,5,16,3,532,571,198,-373
2017,5,16,4,495,472,92,-380
2017,5,16,5,426,421,64,-357
2017,5,16,6,396,396,60,-336
2017,5,16,7,381,380,59,-321
2017,5,16,8,376,377,59,-318
2017,5,16,9,380,384,63,-321
2017,5,16,10,407,409,59,-350
2017,5,16,11,457,472,60,-412
2017,5,16,12,500,506,60,-446
2017,5,16,13,514,520,60,-460
2017,5,16,14,533,537,61,-476
2017,5,16,15,547,559,62,-497
2017,5,16,16,554,567,61,-506
2017,5,16,17,578,498,117,-381
2017,5,16,18,602,619,294,-325
2017,5,16,19,618,649,321,-328
2017,5,16,20,640,673,366,-307
2017,5,16,21,657,691,385,-306
2017,5,16,22,660,694,415,-279
2017,5,16,23,660,691,435,-256
2017,5,17,0,641,719,433,-286
2017,5,17,1,627,713,388,-325
2017,5,17,2,614,640,307,-333
2017,5,17,3,563,572,196,-376
2017,5,17,4,515,506,135,-371
2017,5,17,5,432,455,95,-360
2017,5,17,6,403,424,61,-363
2017,5,17,7,385,408,60,-348
2017,5,17,8,379,397,59,-338
2017,5,17,9,383,397,58,-339
2017,5,17,10,400,427,60,-367
2017,5,17,11,462,486,61,-425
2017,5,17,12,502,521,60,-461
2017,5,17,13,513,540,59,-481
2017,5,17,14,534,559,61,-498
2017,5,17,15,549,584,76,-508
2017,5,17,16,556,610,176,-434
2017,5,17,17,581,623,246,-377
2017,5,17,18,601,589,314,-275
2017,5,17,19,630,675,415,-260
2017,5,17,20,651,688,397,-291
2017,5,17,21,675,695,388,-307
2017,5,17,22,678,694,390,-304
2017,5,17,23,670,682,389,-293
2017,5,18,0,650,661,387,-274
2017,5,18,1,633,666,385,-281
2017,5,18,2,627,709,362,-347
2017,5,18,3,583,565,203,-362
2017,5,18,4,517,501,121,-380
2017,5,18,5,447,451,73,-378
2017,5,18,6,414,419,64,-355
2017,5,18,7,395,402,67,-335
2017,5,18,8,390,395,68,-327
2017,5,18,9,394,396,65,-331
2017,5,18,10,405,426,66,-360
2017,5,18,11,469,492,67,-425
2017,5,18,12,510,526,68,-458
2017,5,18,13,523,539,66,-473
2017,5,18,14,548,559,70,-489
2017,5,18,15,565,576,75,-501
2017,5,18,16,576,596,145,-451
2017,5,18,17,607,616,188,-428
2017,5,18,18,627,557,191,-366
2017,5,18,19,650,638,316,-322
2017,5,18,20,671,661,373,-288
2017,5,18,21,685,664,345,-319
2017,5,18,22,687,668,362,-306
2017,5,18,23,678,670,374,-296
2017,5,19,0,658,657,365,-292
2017,5,19,1,641,664,371,-293
2017,5,19,2,634,691,352,-339
2017,5,19,3,586,601,183,-418
2017,5,19,4,523,523,97,-426
2017,5,19,5,459,462,78,-384
2017,5,19,6,426,430,69,-361
2017,5,19,7,407,416,66,-350
2017,5,19,8,399,406,67,-339
2017,5,19,9,404,409,66,-343
2017,5,19,10,431,437,65,-372
2017,5,19,11,483,492,65,-427
2017,5,19,12,522,527,81,-446
2017,5,19,13,541,552,91,-461
2017,5,19,14,568,580,97,-483
2017,5,19,15,590,609,172,-437
2017,5,19,16,602,644,235,-409
2017,5,19,17,638,661,256,-405
2017,5,19,18,633,650,318,-332
2017,5,19,19,683,550,333,-217
2017,5,19,20,686,644,423,-221
2017,5,19,21,692,656,437,-219
2017,5,19,22,688,634,412,-222
2017,5,19,23,671,620,364,-256
2017,5,20,0,644,610,354,-256
2017,5,20,1,634,662,383,-279
2017,5,20,2,648,644,301,-343
2017,5,20,3,580,551,130,-421
2017,5,20,4,520,504,75,-429
2017,5,20,5,458,451,70,-381
2017,5,20,6,426,424,71,-353
2017,5,20,7,405,409,69,-340
2017,5,20,8,395,399,68,-331
2017,5,20,9,392,396,69,-327
2017,5,20,10,403,404,70,-334
2017,5,20,11,409,365,16,-349
2017,5,20,12,443,390,12,-378
2017,5,20,13,474,493,71,-422
2017,5,20,14,513,539,72,-467
2017,5,20,15,540,573,73,-500
2017,5,20,16,575,598,111,-487
2017,5,20,17,593,626,244,-382
2017,5,20,18,615,634,227,-407
2017,5,20,19,622,652,243,-409
2017,5,20,20,635,661,263,-398
2017,5,20,21,654,583,267,-316
2017,5,20,22,657,686,370,-316
2017,5,20,23,636,676,400,-276
2017,5,21,0,617,653,388,-265
2017,5,21,1,606,680,366,-314
2017,5,21,2,615,656,265,-391
2017,5,21,3,566,554,93,-461
2017,5,21,4,495,493,67,-426
2017,5,21,5,448,445,61,-384
2017,5,21,6,413,414,61,-353
2017,5,21,7,391,399,63,-336
2017,5,21,8,380,388,63,-325
2017,5,21,9,377,384,65,-319
2017,5,21,10,381,386,64,-322
2017,5,21,11,385,398,62,-336
2017,5,21,12,418,417,64,-353
2017,5,21,13,457,460,64,-396
2017,5,21,14,491,491,65,-426
2017,5,21,15,499,502,63,-439
2017,5,21,16,508,506,64,-442
2017,5,21,17,508,515,64,-451
2017,5,21,18,526,511,63,-448
2017,5,21,19,518,417,66,-351
2017,5,21,20,516,491,156,-335
2017,5,21,21,529,510,173,-337
2017,5,21,22,534,518,173,-345
2017,5,21,23,528,518,170,-348
2017,5,22,0,533,523,171,-352
2017,5,22,1,534,533,171,-362
2017,5,22,2,555,524,172,-352
2017,5,22,3,498,485,172,-313
2017,5,22,4,443,442,170,-272
2017,5,22,5,403,402,170,-232
2017,5,22,6,380,380,169,-211
2017,5,22,7,367,374,171,-203
2017,5,22,8,364,369,171,-198
2017,5,22,9,373,378,171,-207
2017,5,22,10,397,411,171,-240
2017,5,22,11,450,472,171,-301
2017,5,22,12,502,504,170,-334
2017,5,22,13,517,524,172,-352
2017,5,22,14,535,541,200,-341
2017,5,22,15,544,560,211,-349
2017,5,22,16,552,577,213,-364
2017,5,22,17,568,589,210,-379
2017,5,22,18,583,585,314,-271
2017,5,22,19,576,607,377,-230
2017,5,22,20,596,606,380,-226
2017,5,22,21,611,603,420,-183
2017,5,22,22,611,612,425,-187
2017,5,22,23,613,598,381,-217
2017,5,23,0,598,596,379,-217
2017,5,23,1,603,583,267,-316
2017,5,23,2,588,568,248,-320
2017,5,23,3,540,523,203,-320
2017,5,23,4,488,467,186,-281
2017,5,23,5,416,457,183,-274
2017,5,23,6,392,412,153,-259
2017,5,23,7,377,396,148,-248
2017,5,23,8,371,390,141,-249
2017,5,23,9,377,394,137,-257
2017,5,23,10,399,419,142,-277
2017,5,23,11,455,454,160,-294
2017,5,23,12,504,553,207,-346
2017,5,23,13,513,532,173,-359
2017,5,23,14,521,547,175,-372
2017,5,23,15,519,555,174,-381
2017,5,23,16,521,560,173,-387
2017,5,23,17,529,561,166,-395
2017,5,23,18,526,558,174,-384
2017,5,23,19,539,552,174,-378
2017,5,23,20,548,549,174,-375
2017,5,23,21,559,556,175,-381
2017,5,23,22,560,561,175,-386
2017,5,23,23,564,560,174,-386
2017,5,24,0,554,560,173,-387
2017,5,24,1,559,566,174,-392
2017,5,24,2,559,545,174,-371
2017,5,24,3,509,500,176,-324
2017,5,24,4,460,452,174,-278
2017,5,24,5,411,458,157,-301
2017,5,24,6,382,414,100,-314
2017,5,24,7,369,388,79,-309
2017,5,24,8,365,383,80,-303
2017,5,24,9,371,389,80,-309
2017,5,24,10,402,404,80,-324
2017,5,24,11,457,374,90,-284
2017,5,24,12,496,502,203,-299
2017,5,24,13,505,520,210,-310
2017,5,24,14,517,536,211,-325
2017,5,24,15,519,541,207,-334
2017,5,24,16,511,547,208,-339
2017,5,24,17,528,544,213,-331
2017,5,24,18,521,542,279,-263
2017,5,24,19,528,543,305,-238
2017,5,24,20,540,538,303,-235
2017,5,24,21,549,534,303,-231
2017,5,24,22,556,540,303,-237
2017,5,24,23,560,539,301,-238
2017,5,25,0,552,536,303,-233
2017,5,25,1,555,535,302,-233
2017,5,25,2,558,533,301,-232
2017,5,25,3,498,491,283,-208
2017,5,25,4,447,438,239,-199
2017,5,25,5,415,464,239,-225
2017,5,25,6,384,428,172,-256
2017,5,25,7,374,378,104,-274
2017,5,25,8,371,372,100,-272
2017,5,25,9,378,378,97,-281
2017,5,25,10,408,393,97,-296
2017,5,25,11,461,375,111,-264
2017,5,25,12,506,505,205,-300
2017,5,25,13,512,516,214,-302
2017,5,25,14,521,521,220,-301
2017,5,25,15,520,530,224,-306
2017,5,25,16,511,528,221,-307
2017,5,25,17,525,530,220,-310
2017,5,25,18,517,531,221,-310
2017,5,25,19,523,529,224,-305
2017,5,25,20,529,527,221,-306
2017,5,25,21,541,528,204,-324
2017,5,25,22,547,538,206,-332
2017,5,25,23,547,539,206,-333
2017,5,26,0,546,544,203,-341
2017,5,26,1,551,541,196,-345
2017,5,26,2,552,540,198,-342
2017,5,26,3,497,495,198,-297
2017,5,26,4,446,482,198,-284
2017,5,26,5,409,475,138,-337
2017,5,26,6,384,394,64,-330
2017,5,26,7,373,381,63,-318
2017,5,26,8,369,377,62,-315
2017,5,26,9,376,386,63,-323
2017,5,26,10,405,418,64,-354
2017,5,26,11,464,467,62,-405
2017,5,26,12,498,409,69,-340
2017,5,26,13,513,520,170,-350
2017,5,26,14,522,558,171,-387
2017,5,26,15,526,569,139,-430
2017,5,26,16,523,534,103,-431
2017,5,26,17,539,525,100,-425
2017,5,26,18,529,480,110,-370
2017,5,26,19,552,539,169,-370
2017,5,26,20,564,544,168,-376
2017,5,26,21,574,559,174,-385
2017,5,26,22,585,567,175,-392
2017,5,26,23,577,577,177,-400
2017,5,27,0,568,559,175,-384
2017,5,27,1,566,548,175,-373
2017,5,27,2,574,564,175,-389
2017,5,27,3,525,584,152,-432
2017,5,27,4,471,457,65,-392
2017,5,27,5,422,408,61,-347
2017,5,27,6,391,386,63,-323
2017,5,27,7,375,370,70,-300
2017,5,27,8,366,361,67,-294
2017,5,27,9,366,361,63,-298
2017,5,27,10,376,371,62,-309
2017,5,27,11,386,388,64,-324
2017,5,27,12,423,415,63,-352
2017,5,27,13,463,449,62,-387
2017,5,27,14,498,484,64,-420
2017,5,27,15,524,505,63,-442
2017,5,27,16,543,517,65,-452
2017,5,27,17,559,440,71,-369
2017,5,27,18,571,548,171,-377
2017,5,27,19,568,550,170,-380
2017,5,27,20,586,563,175,-388
2017,5,27,21,604,578,176,-402
2017,5,27,22,632,596,177,-419
2017,5,27,23,619,596,176,-420
2017,5,28,0,601,584,175,-409
2017,5,28,1,604,586,175,-411
2017,5,28,2,601,650,162,-488
2017,5,28,3,541,534,75,-459
2017,5,28,4,493,470,68,-402
2017,5,28,5,435,421,66,-355
2017,5,28,6,395,385,66,-319
2017,5,28,7,377,369,69,-300
2017,5,28,8,369,363,68,-295
2017,5,28,9,365,358,67,-291
2017,5,28,10,368,354,67,-287
2017,5,28,11,371,363,67,-296
2017,5,28,12,397,390,69,-321
2017,5,28,13,442,431,68,-363
2017,5,28,14,486,463,67,-396
2017,5,28,15,512,386,75,-311
2017,5,28,16,530,509,177,-332
2017,5,28,17,558,526,175,-351
2017,5,28,18,563,537,174,-363
2017,5,28,19,544,553,176,-377
2017,5,28,20,574,552,176,-376
2017,5,28,21,593,550,173,-377
2017,5,28,22,607,555,176,-379
2017,5,28,23,596,543,174,-369
2017,5,29,0,582,546,175,-371
2017,5,29,1,586,609,167,-442
2017,5,29,2,584,536,77,-459
2017,5,29,3,528,487,68,-419
2017,5,29,4,484,441,67,-374
2017,5,29,5,425,398,67,-331
2017,5,29,6,389,373,63,-310
2017,5,29,7,373,360,63,-297
2017,5,29,8,369,357,65,-292
2017,5,29,9,367,357,59,-298
2017,5,29,10,381,373,56,-317
2017,5,29,11,395,390,56,-334
2017,5,29,12,418,418,56,-362
2017,5,29,13,463,457,59,-398
2017,5,29,14,510,429,58,-371
2017,5,29,15,538,498,130,-368
2017,5,29,16,545,553,165,-388
2017,5,29,17,556,572,165,-407
2017,5,29,18,563,585,165,-420
2017,5,29,19,588,585,164,-421
2017,5,29,20,604,577,174,-403
2017,5,29,21,615,572,186,-386
2017,5,29,22,626,570,213,-357
2017,5,29,23,619,572,208,-364
2017,5,30,0,603,568,205,-363
2017,5,30,1,603,587,204,-383
2017,5,30,2,597,630,177,-453
2017,5,30,3,549,499,61,-438
2017,5,30,4,482,450,62,-388
2017,5,30,5,441,411,59,-352
2017,5,30,6,409,391,58,-333
2017,5,30,7,391,381,61,-320
2017,5,30,8,386,371,59,-312
2017,5,30,9,390,382,60,-322
2017,5,30,10,417,407,59,-348
2017,5,30,11,466,468,60,-408
2017,5,30,12,511,507,60,-447
2017,5,30,13,530,520,59,-461
2017,5,30,14,549,495,58,-437
2017,5,30,15,566,500,107,-393
2017,5,30,16,566,572,194,-378
2017,5,30,17,565,585,253,-332
2017,5,30,18,584,601,297,-304
2017,5,30,19,598,615,281,-334
2017,5,30,20,606,612,301,-311
2017,5,30,21,613,650,351,-299
2017,5,30,22,616,652,349,-303
2017,5,30,23,610,633,363,-270
2017,5,31,0,606,627,337,-290
2017,5,31,1,604,582,257,-325
2017,5,31,2,593,654,246,-408
2017,5,31,3,530,583,137,-446
2017,5,31,4,472,473,60,-413
2017,5,31,5,433,428,59,-369
2017,5,31,6,402,403,58,-345
2017,5,31,7,382,386,58,-328
2017,5,31,8,376,378,58,-320
2017,5,31,9,379,386,59,-327
2017,5,31,10,409,415,59,-356
2017,5,31,11,458,474,60,-414
2017,5,31,12,496,507,59,-448
2017,5,31,13,517,528,153,-375
2017,5,31,14,538,550,201,-349
2017,5,31,15,558,569,225,-344
2017,5,31,16,566,554,250,-304
2017,5,31,17,577,493,210,-283
2017,5,31,18,584,603,279,-324
2017,5,31,19,612,614,298,-316
2017,5,31,20,623,630,304,-326
2017,5,31,21,631,625,311,-314
2017,5,31,22,631,656,339,-317
2017,5,31,23,617,656,345,-311
2017,6,1,0,599,636,345,-291
2017,6,1,1,588,677,281,-396
2017,6,1,2,592,649,185,-464
2017,6,1,3,533,545,85,-460
2017,6,1,4,469,477,60,-417
2017,6,1,5,438,427,57,-370
2017,6,1,6,404,406,59,-347
2017,6,1,7,388,390,66,-324
2017,6,1,8,380,380,72,-308
2017,6,1,9,383,386,73,-313
2017,6,1,10,409,414,72,-342
2017,6,1,11,462,470,75,-395
2017,6,1,12,497,503,69,-434
2017,6,1,13,518,522,56,-466
2017,6,1,14,535,545,62,-483
2017,6,1,15,554,555,65,-490
2017,6,1,16,572,526,70,-456
2017,6,1,17,580,568,120,-448
2017,6,1,18,582,601,143,-458
2017,6,1,19,616,617,188,-429
2017,6,1,20,631,618,292,-326
2017,6,1,21,649,607,373,-234
2017,6,1,22,659,637,397,-240
2017,6,1,23,648,687,355,-332
2017,6,2,0,632,653,252,-401
2017,6,2,1,616,604,178,-426
2017,6,2,2,632,588,61,-527
2017,6,2,3,569,535,59,-476
2017,6,2,4,490,477,58,-419
2017,6,2,5,442,430,58,-372
2017,6,2,6,408,405,55,-350
2017,6,2,7,386,392,59,-333
2017,6,2,8,378,381,58,-323
2017,6,2,9,382,385,59,-326
2017,6,2,10,406,414,58,-356
2017,6,2,11,444,465,58,-407
2017,6,2,12,494,495,58,-437
2017,6,2,13,513,511,58,-453
2017,6,2,14,537,534,74,-460
2017,6,2,15,555,554,94,-460
2017,6,2,16,562,578,120,-458
2017,6,2,17,554,596,136,-460
2017,6,2,18,578,616,158,-458
2017,6,2,19,602,632,203,-429
2017,6,2,20,619,641,274,-367
2017,6,2,21,619,568,354,-214
2017,6,2,22,633,663,457,-206
2017,6,2,23,620,664,467,-197
2017,6,3,0,599,633,394,-239
2017,6,3,1,599,667,265,-402
2017,6,3,2,595,644,187,-457
2017,6,3,3,536,552,98,-454
2017,6,3,4,479,486,63,-423
2017,6,3,5,438,443,61,-382
2017,6,3,6,404,413,63,-350
2017,6,3,7,383,394,62,-332
2017,6,3,8,372,380,60,-320
2017,6,3,9,368,380,64,-316
2017,6,3,10,376,384,62,-322
2017,6,3,11,388,395,63,-332
2017,6,3,12,414,426,62,-364
2017,6,3,13,450,467,64,-403
2017,6,3,14,485,500,63,-437
2017,6,3,15,514,533,67,-466
2017,6,3,16,532,504,63,-441
2017,6,3,17,533,553,115,-438
2017,6,3,18,568,598,137,-461
2017,6,3,19,568,619,136,-483
2017,6,3,20,580,639,142,-497
2017,6,3,21,616,637,194,-443
2017,6,3,22,629,633,256,-377
2017,6,3,23,622,643,302,-341
2017,6,4,0,601,621,301,-320
2017,6,4,1,584,599,263,-336
2017,6,4,2,601,659,212,-447
2017,6,4,3,543,547,84,-463
2017,6,4,4,480,476,61,-415
2017,6,4,5,442,433,63,-370
2017,6,4,6,406,405,60,-345
2017,6,4,7,386,384,63,-321
2017,6,4,8,376,379,63,-316
2017,6,4,9,373,370,60,-310
2017,6,4,10,378,378,60,-318
2017,6,4,11,386,383,59,-324
2017,6,4,12,415,418,59,-359
2017,6,4,13,457,459,59,-400
2017,6,4,14,496,498,57,-441
2017,6,4,15,514,529,60,-469
2017,6,4,16,532,553,62,-491
2017,6,4,17,539,572,64,-508
2017,6,4,18,569,584,68,-516
2017,6,4,19,568,565,115,-450
2017,6,4,20,570,516,128,-388
2017,6,4,21,598,537,168,-369
2017,6,4,22,612,580,182,-398
2017,6,4,23,612,587,142,-445
2017,6,5,0,599,582,133,-449
2017,6,5,1,585,582,123,-459
2017,6,5,2,598,616,121,-495
2017,6,5,3,536,551,72,-479
2017,6,5,4,478,478,50,-428
2017,6,5,5,452,435,46,-389
2017,6,5,6,416,410,46,-364
2017,6,5,7,396,400,49,-351
2017,6,5,8,389,389,45,-344
2017,6,5,9,393,398,47,-351
2017,6,5,10,421,427,48,-379
2017,6,5,11,462,487,48,-439
2017,6,5,12,513,519,48,-471
2017,6,5,13,540,546,48,-498
2017,6,5,14,569,568,54,-514
2017,6,5,15,598,598,89,-509
2017,6,5,16,627,605,118,-487
2017,6,5,17,642,625,118,-507
2017,6,5,18,654,626,128,-498
2017,6,5,19,673,621,152,-469
2017,6,5,20,685,612,178,-434
2017,6,5,21,681,607,184,-423
2017,6,5,22,697,508,184,-324
2017,6,5,23,692,591,283,-308
2017,6,6,0,675,577,282,-295
2017,6,6,1,666,567,283,-284
2017,6,6,2,653,615,264,-351
2017,6,6,3,580,580,141,-439
2017,6,6,4,512,479,54,-425
2017,6,6,5,456,432,49,-383
2017,6,6,6,421,413,52,-361
2017,6,6,7,401,401,53,-348
2017,6,6,8,392,392,52,-340
2017,6,6,9,396,398,51,-347
2017,6,6,10,422,426,53,-373
2017,6,6,11,462,486,52,-434
2017,6,6,12,517,521,52,-469
2017,6,6,13,534,543,53,-490
2017,6,6,14,555,555,53,-502
2017,6,6,15,575,572,53,-519
2017,6,6,16,588,536,55,-481
2017,6,6,17,596,582,114,-468
2017,6,6,18,607,623,132,-491
2017,6,6,19,624,642,137,-505
2017,6,6,20,630,645,280,-365
2017,6,6,21,634,655,381,-274
2017,6,6,22,641,655,418,-237
2017,6,6,23,636,617,408,-209
2017,6,7,0,620,622,275,-347
2017,6,7,1,606,650,262,-388
2017,6,7,2,600,601,206,-395
2017,6,7,3,535,470,127,-343
2017,6,7,4,476,445,94,-351
2017,6,7,5,440,420,51,-369
2017,6,7,6,406,410,54,-356
2017,6,7,7,384,393,56,-337
2017,6,7,8,377,384,57,-327
2017,6,7,9,381,387,69,-318
2017,6,7,10,405,415,66,-349
2017,6,7,11,440,467,65,-402
2017,6,7,12,491,502,67,-435
2017,6,7,13,508,518,66,-452
2017,6,7,14,524,538,68,-470
2017,6,7,15,541,548,72,-476
2017,6,7,16,551,512,88,-424
2017,6,7,17,566,548,141,-407
2017,6,7,18,572,583,164,-419
2017,6,7,19,584,589,163,-426
2017,6,7,20,593,607,168,-439
2017,6,7,21,599,622,201,-421
2017,6,7,22,605,610,204,-406
2017,6,7,23,618,586,206,-380
2017,6,8,0,600,591,173,-418
2017,6,8,1,591,629,166,-463
2017,6,8,2,595,633,119,-514
2017,6,8,3,535,520,58,-462
2017,6,8,4,469,465,58,-407
2017,6,8,5,424,417,52,-365
2017,6,8,6,392,402,57,-345
2017,6,8,7,374,386,58,-328
2017,6,8,8,368,381,59,-322
2017,6,8,9,374,387,59,-328
2017,6,8,10,398,413,59,-354
2017,6,8,11,434,467,60,-407
2017,6,8,12,485,502,60,-442
2017,6,8,13,501,516,58,-458
2017,6,8,14,515,536,59,-477
2017,6,8,15,528,546,60,-486
2017,6,8,16,535,513,60,-453
2017,6,8,17,544,540,112,-428
2017,6,8,18,545,562,133,-429
2017,6,8,19,546,564,135,-429
2017,6,8,20,562,564,138,-426
2017,6,8,21,564,561,136,-425
2017,6,8,22,571,565,134,-431
2017,6,8,23,573,617,135,-482
2017,6,9,0,568,582,83,-499
2017,6,9,1,575,554,59,-495
2017,6,9,2,570,547,62,-485
2017,6,9,3,504,505,58,-447
2017,6,9,4,452,454,61,-393
2017,6,9,5,419,412,58,-354
2017,6,9,6,391,392,57,-335
2017,6,9,7,377,381,59,-322
2017,6,9,8,369,374,59,-315
2017,6,9,9,376,380,57,-323
2017,6,9,10,402,407,59,-348
2017,6,9,11,445,460,58,-402
2017,6,9,12,485,495,59,-436
2017,6,9,13,505,495,58,-437
2017,6,9,14,524,500,78,-422
2017,6,9,15,538,532,110,-422
2017,6,9,16,536,550,163,-387
2017,6,9,17,554,568,178,-390
2017,6,9,18,573,606,172,-434
2017,6,9,19,575,591,144,-447
2017,6,9,20,587,592,141,-451
2017,6,9,21,592,526,152,-374
2017,6,9,22,584,623,241,-382
2017,6,9,23,590,619,239,-380
2017,6,10,0,573,655,239,-416
2017,6,10,1,572,623,181,-442
2017,6,10,2,578,563,120,-443
2017,6,10,3,524,527,67,-460
2017,6,10,4,467,468,61,-407
2017,6,10,5,426,431,62,-369
2017,6,10,6,392,397,61,-336
2017,6,10,7,371,378,62,-316
2017,6,10,8,362,367,62,-305
2017,6,10,9,361,366,62,-304
2017,6,10,10,370,381,62,-319
2017,6,10,11,379,393,63,-330
2017,6,10,12,411,425,62,-363
2017,6,10,13,452,463,69,-394
2017,6,10,14,490,500,73,-427
2017,6,10,15,519,523,74,-449
2017,6,10,16,530,495,74,-421
2017,6,10,17,545,539,123,-416
2017,6,10,18,560,575,166,-409
2017,6,10,19,574,591,193,-398
2017,6,10,20,583,609,191,-418
2017,6,10,21,600,628,213,-415
2017,6,10,22,622,639,235,-404
2017,6,10,23,615,650,236,-414
2017,6,11,0,589,668,217,-451
2017,6,11,1,579,593,122,-471
2017,6,11,2,591,579,74,-505
2017,6,11,3,530,540,61,-479
2017,6,11,4,476,484,61,-423
2017,6,11,5,438,432,58,-374
2017,6,11,6,400,405,60,-345
2017,6,11,7,381,383,58,-325
2017,6,11,8,372,373,61,-312
2017,6,11,9,367,369,60,-309
2017,6,11,10,372,373,63,-310
2017,6,11,11,380,377,58,-319
2017,6,11,12,408,408,60,-348
2017,6,11,13,448,458,63,-395
2017,6,11,14,486,499,74,-425
2017,6,11,15,512,519,84,-435
2017,6,11,16,529,545,131,-414
2017,6,11,17,563,567,147,-420
2017,6,11,18,580,591,155,-436
2017,6,11,19,583,603,140,-463
2017,6,11,20,602,572,143,-429
2017,6,11,21,627,614,192,-422
2017,6,11,22,649,650,211,-439
2017,6,11,23,649,648,210,-438
2017,6,12,0,632,660,211,-449
2017,6,12,1,613,655,186,-469
2017,6,12,2,614,600,125,-475
2017,6,12,3,554,555,83,-472
2017,6,12,4,497,496,61,-435
2017,6,12,5,447,450,62,-388
2017,6,12,6,414,419,61,-358
2017,6,12,7,395,404,62,-342
2017,6,12,8,386,390,61,-329
2017,6,12,9,390,399,63,-336
2017,6,12,10,414,421,62,-359
2017,6,12,11,445,467,63,-404
2017,6,12,12,495,512,64,-448
2017,6,12,13,528,542,63,-479
2017,6,12,14,552,569,62,-507
2017,6,12,15,583,607,66,-541
2017,6,12,16,614,639,80,-559
2017,6,12,17,648,652,123,-529
2017,6,12,18,678,701,191,-510
2017,6,12,19,703,712,276,-436
2017,6,12,20,713,665,321,-344
2017,6,12,21,708,678,361,-317
2017,6,12,22,733,716,398,-318
2017,6,12,23,733,704,398,-306
2017,6,13,0,724,680,392,-288
2017,6,13,1,697,665,396,-269
2017,6,13,2,671,703,348,-355
2017,6,13,3,605,605,202,-403
2017,6,13,4,525,532,145,-387
2017,6,13,5,483,477,96,-381
2017,6,13,6,448,443,69,-374
2017,6,13,7,426,419,60,-359
2017,6,13,8,413,413,64,-349
2017,6,13,9,416,414,62,-352
2017,6,13,10,436,437,64,-373
2017,6,13,11,468,478,70,-408
2017,6,13,12,520,525,73,-452
2017,6,13,13,556,558,72,-486
2017,6,13,14,577,597,73,-524
2017,6,13,15,614,639,81,-558
2017,6,13,16,638,615,182,-433
2017,6,13,17,676,679,349,-330
2017,6,13,18,706,726,368,-358
2017,6,13,19,725,669,298,-371
2017,6,13,20,733,784,455,-329
2017,6,13,21,738,701,448,-253
2017,6,13,22,740,723,457,-266
2017,6,13,23,746,766,380,-386
2017,6,14,0,728,710,291,-419
2017,6,14,1,699,662,261,-401
2017,6,14,2,689,633,210,-423
2017,6,14,3,618,579,119,-460
2017,6,14,4,537,516,72,-444
2017,6,14,5,496,468,60,-408
2017,6,14,6,460,433,60,-373
2017,6,14,7,436,419,60,-359
2017,6,14,8,426,407,60,-347
2017,6,14,9,427,415,60,-355
2017,6,14,10,449,439,61,-378
2017,6,14,11,485,481,60,-421
2017,6,14,12,531,520,59,-461
2017,6,14,13,571,547,61,-486
2017,6,14,14,602,576,62,-514
2017,6,14,15,639,614,70,-544
2017,6,14,16,651,594,135,-459
2017,6,14,17,667,646,237,-409
2017,6,14,18,716,704,308,-396
2017,6,14,19,736,720,366,-354
2017,6,14,20,735,749,407,-342
2017,6,14,21,730,751,408,-343
2017,6,14,22,741,729,430,-299
2017,6,14,23,745,726,450,-276
2017,6,15,0,720,792,460,-332
2017,6,15,1,700,686,364,-322
2017,6,15,2,685,651,188,-463
2017,6,15,3,616,599,160,-439
2017,6,15,4,541,530,93,-437
2017,6,15,5,491,481,67,-414
2017,6,15,6,452,450,67,-383
2017,6,15,7,428,431,66,-365
2017,6,15,8,418,419,63,-356
2017,6,15,9,419,423,63,-360
2017,6,15,10,443,442,63,-379
2017,6,15,11,481,485,63,-422
2017,6,15,12,514,529,64,-465
2017,6,15,13,559,559,61,-498
2017,6,15,14,594,600,65,-535
2017,6,15,15,635,632,81,-551
2017,6,15,16,639,619,254,-365
2017,6,15,17,660,674,305,-369
2017,6,15,18,701,724,334,-390
2017,6,15,19,722,716,370,-346
2017,6,15,20,747,696,421,-275
2017,6,15,21,734,680,432,-248
2017,6,15,22,744,679,405,-274
2017,6,15,23,756,736,402,-334
2017,6,16,0,737,686,351,-335
2017,6,16,1,716,640,273,-367
2017,6,16,2,700,628,218,-410
2017,6,16,3,636,578,136,-442
2017,6,16,4,556,520,75,-445
2017,6,16,5,505,473,54,-419
2017,6,16,6,469,439,55,-384
2017,6,16,7,446,424,56,-368
2017,6,16,8,432,416,56,-360
2017,6,16,9,434,416,53,-363
2017,6,16,10,452,442,56,-386
2017,6,16,11,492,478,51,-427
2017,6,16,12,532,525,56,-469
2017,6,16,13,568,546,54,-492
2017,6,16,14,601,581,56,-525
2017,6,16,15,636,615,64,-551
2017,6,16,16,626,642,131,-511
2017,6,16,17,664,670,239,-431
2017,6,16,18,707,687,245,-442
2017,6,16,19,721,692,310,-382
2017,6,16,20,724,597,373,-224
2017,6,16,21,722,650,470,-180
2017,6,16,22,721,667,488,-179
2017,6,16,23,721,715,472,-243
2017,6,17,0,712,651,392,-259
2017,6,17,1,671,606,310,-296
2017,6,17,2,666,595,294,-301
2017,6,17,3,607,559,287,-272
2017,6,17,4,541,503,199,-304
2017,6,17,5,481,478,135,-343
2017,6,17,6,444,446,127,-319
2017,6,17,7,419,426,118,-308
2017,6,17,8,406,410,116,-294
2017,6,17,9,403,408,117,-291
2017,6,17,10,412,414,117,-297
2017,6,17,11,424,425,117,-308
2017,6,17,12,456,456,118,-338
2017,6,17,13,494,498,118,-380
2017,6,17,14,533,545,118,-427
2017,6,17,15,574,587,120,-467
2017,6,17,16,598,566,120,-446
2017,6,17,17,613,614,173,-441
2017,6,17,18,648,654,211,-443
2017,6,17,19,664,659,233,-426
2017,6,17,20,666,656,242,-414
2017,6,17,21,680,669,282,-387
2017,6,17,22,688,680,309,-371
2017,6,17,23,683,676,319,-357
2017,6,18,0,661,666,298,-368
2017,6,18,1,634,671,269,-402
2017,6,18,2,632,604,212,-392
2017,6,18,3,588,563,185,-378
2017,6,18,4,524,511,114,-397
2017,6,18,5,482,461,108,-353
2017,6,18,6,445,432,110,-322
2017,6,18,7,420,409,107,-302
2017,6,18,8,406,401,108,-293
2017,6,18,9,401,394,108,-286
2017,6,18,10,404,399,109,-290
2017,6,18,11,411,409,110,-299
2017,6,18,12,445,438,109,-329
2017,6,18,13,493,494,111,-383
2017,6,18,14,536,542,110,-432
2017,6,18,15,571,576,111,-465
2017,6,18,16,608,609,112,-497
2017,6,18,17,627,631,112,-519
2017,6,18,18,666,614,172,-442
2017,6,18,19,683,597,280,-317
2017,6,18,20,685,627,386,-241
2017,6,18,21,703,667,450,-217
2017,6,18,22,723,658,454,-204
2017,6,18,23,716,651,477,-174
2017,6,19,0,698,634,411,-223
2017,6,19,1,678,621,386,-235
2017,6,19,2,662,617,384,-233
2017,6,19,3,604,652,369,-283
2017,6,19,4,539,539,201,-338
2017,6,19,5,469,463,135,-328
2017,6,19,6,437,433,108,-325
2017,6,19,7,418,429,120,-309
2017,6,19,8,408,418,118,-300
2017,6,19,9,410,422,118,-304
2017,6,19,10,434,445,117,-328
2017,6,19,11,474,486,121,-365
2017,6,19,12,521,530,120,-410
2017,6,19,13,556,568,167,-401
2017,6,19,14,583,602,259,-343
2017,6,19,15,621,625,260,-365
2017,6,19,16,638,647,260,-387
2017,6,19,17,673,657,271,-386
2017,6,19,18,720,675,322,-353
2017,6,19,19,726,658,351,-307
2017,6,19,20,717,615,377,-238
2017,6,19,21,709,705,469,-236
2017,6,19,22,729,712,447,-265
2017,6,19,23,741,700,469,-231
2017,6,20,0,715,737,449,-288
2017,6,20,1,691,703,391,-312
2017,6,20,2,661,622,316,-306
2017,6,20,3,581,565,289,-276
2017,6,20,4,519,498,171,-327
2017,6,20,5,463,457,115,-342
2017,6,20,6,432,428,113,-315
2017,6,20,7,410,411,114,-297
2017,6,20,8,400,402,115,-287
2017,6,20,9,403,405,114,-291
2017,6,20,10,425,429,115,-314
2017,6,20,11,464,472,112,-360
2017,6,20,12,507,512,114,-398
2017,6,20,13,534,535,112,-423
2017,6,20,14,555,558,114,-444
2017,6,20,15,577,587,116,-471
2017,6,20,16,571,560,116,-444
2017,6,20,17,587,606,166,-440
2017,6,20,18,628,644,188,-456
2017,6,20,19,637,659,186,-473
2017,6,20,20,643,670,186,-484
2017,6,20,21,643,672,186,-486
2017,6,20,22,658,670,187,-483
2017,6,20,23,659,666,188,-478
2017,6,21,0,644,650,188,-462
2017,6,21,1,629,672,187,-485
2017,6,21,2,608,649,146,-503
2017,6,21,3,536,572,115,-457
2017,6,21,4,481,510,114,-396
2017,6,21,5,454,467,116,-351
2017,6,21,6,425,433,115,-318
2017,6,21,7,408,422,117,-305
2017,6,21,8,401,412,115,-297
2017,6,21,9,405,412,116,-296
2017,6,21,10,430,431,115,-316
2017,6,21,11,470,483,117,-366
2017,6,21,12,515,519,113,-406
2017,6,21,13,546,546,114,-432
2017,6,21,14,573,563,115,-448
2017,6,21,15,593,578,114,-464
2017,6,21,16,591,540,118,-422
2017,6,21,17,617,599,177,-422
2017,6,21,18,648,652,214,-438
2017,6,21,19,657,674,255,-419
2017,6,21,20,661,687,310,-377
2017,6,21,21,676,687,361,-326
2017,6,21,22,688,682,388,-294
2017,6,21,23,696,666,390,-276
2017,6,22,0,679,664,379,-285
2017,6,22,1,663,684,353,-331
2017,6,22,2,646,620,267,-353
2017,6,22,3,575,570,164,-406
2017,6,22,4,514,509,115,-394
2017,6,22,5,460,455,108,-347
2017,6,22,6,430,433,112,-321
2017,6,22,7,413,422,115,-307
2017,6,22,8,403,410,114,-296
2017,6,22,9,407,414,114,-300
2017,6,22,10,430,439,115,-324
2017,6,22,11,470,482,112,-370
2017,6,22,12,514,524,121,-403
2017,6,22,13,543,551,118,-433
2017,6,22,14,569,572,122,-450
2017,6,22,15,592,585,141,-444
2017,6,22,16,590,543,156,-387
2017,6,22,17,615,583,210,-373
2017,6,22,18,637,606,313,-293
2017,6,22,19,642,602,331,-271
2017,6,22,20,638,602,334,-268
2017,6,22,21,639,603,314,-289
2017,6,22,22,647,606,253,-353
2017,6,22,23,650,605,207,-398
2017,6,23,0,639,618,205,-413
2017,6,23,1,637,668,212,-456
2017,6,23,2,631,595,141,-454
2017,6,23,3,565,555,119,-436
2017,6,23,4,508,510,118,-392
2017,6,23,5,464,469,114,-355
2017,6,23,6,436,446,110,-336
2017,6,23,7,424,431,110,-321
2017,6,23,8,415,423,110,-313
2017,6,23,9,421,425,110,-315
2017,6,23,10,444,448,110,-338
2017,6,23,11,487,491,109,-382
2017,6,23,12,530,535,111,-424
2017,6,23,13,567,571,111,-460
2017,6,23,14,602,608,111,-497
2017,6,23,15,628,642,112,-530
2017,6,23,16,628,692,139,-553
2017,6,23,17,665,725,195,-530
2017,6,23,18,706,655,251,-404
2017,6,23,19,718,678,328,-350
2017,6,23,20,719,744,425,-319
2017,6,23,21,731,756,466,-290
2017,6,23,22,731,757,479,-278
2017,6,23,23,731,747,471,-276
2017,6,24,0,714,707,449,-258
2017,6,24,1,685,686,384,-302
2017,6,24,2,652,678,362,-316
2017,6,24,3,607,694,348,-346
2017,6,24,4,548,628,219,-409
2017,6,24,5,502,513,114,-399
2017,6,24,6,463,474,111,-363
2017,6,24,7,437,455,112,-343
2017,6,24,8,422,437,112,-325
2017,6,24,9,416,433,112,-321
2017,6,24,10,421,435,112,-323
2017,6,24,11,431,449,112,-337
2017,6,24,12,465,480,111,-369
2017,6,24,13,505,526,112,-414
2017,6,24,14,549,587,127,-460
2017,6,24,15,591,627,186,-441
2017,6,24,16,596,601,188,-413
2017,6,24,17,619,563,211,-352
2017,6,24,18,645,626,303,-323
2017,6,24,19,653,637,340,-297
2017,6,24,20,657,647,334,-313
2017,6,24,21,660,672,337,-335
2017,6,24,22,668,680,334,-346
2017,6,24,23,665,678,330,-348
2017,6,25,0,640,661,281,-380
2017,6,25,1,626,644,252,-392
2017,6,25,2,622,706,243,-463
2017,6,25,3,576,592,135,-457
2017,6,25,4,507,511,118,-393
2017,6,25,5,457,459,116,-343
2017,6,25,6,419,425,117,-308
2017,6,25,7,397,408,118,-290
2017,6,25,8,386,397,118,-279
2017,6,25,9,379,390,119,-271
2017,6,25,10,382,391,120,-271
2017,6,25,11,385,405,119,-286
2017,6,25,12,414,422,119,-303
2017,6,25,13,457,469,120,-349
2017,6,25,14,493,499,120,-379
2017,6,25,15,515,518,120,-398
2017,6,25,16,529,531,120,-411
2017,6,25,17,550,539,119,-420
2017,6,25,18,560,534,120,-414
2017,6,25,19,550,527,120,-407
2017,6,25,20,559,550,131,-419
2017,6,25,21,578,547,178,-369
2017,6,25,22,590,564,189,-375
2017,6,25,23,590,569,186,-383
2017,6,26,0,574,563,156,-407
2017,6,26,1,563,547,142,-405
2017,6,26,2,562,541,129,-412
2017,6,26,3,537,506,110,-396
2017,6,26,4,464,448,109,-339
2017,6,26,5,417,384,85,-299
2017,6,26,6,386,382,107,-275
2017,6,26,7,368,375,110,-265
2017,6,26,8,361,366,111,-255
2017,6,26,9,366,373,109,-264
2017,6,26,10,391,400,110,-290
2017,6,26,11,431,441,112,-329
2017,6,26,12,469,482,162,-320
2017,6,26,13,496,511,215,-296
2017,6,26,14,521,529,212,-317
2017,6,26,15,542,555,190,-365
2017,6,26,16,540,568,189,-379
2017,6,26,17,578,574,188,-386
2017,6,26,18,589,587,186,-401
2017,6,26,19,589,602,214,-388
2017,6,26,20,618,617,301,-316
2017,6,26,21,614,626,320,-306
2017,6,26,22,623,621,332,-289
2017,6,26,23,637,611,372,-239
2017,6,27,0,614,602,361,-241
2017,6,27,1,595,588,292,-296
2017,6,27,2,577,575,270,-305
2017,6,27,3,528,527,173,-354
2017,6,27,4,470,471,120,-351
2017,6,27,5,427,426,114,-312
2017,6,27,6,397,400,110,-290
2017,6,27,7,378,384,109,-275
2017,6,27,8,371,379,111,-268
2017,6,27,9,374,385,111,-274
2017,6,27,10,399,407,111,-296
2017,6,27,11,440,444,114,-330
2017,6,27,12,479,465,158,-307
2017,6,27,13,502,457,244,-213
2017,6,27,14,524,553,314,-239
2017,6,27,15,537,591,288,-303
2017,6,27,16,526,506,237,-269
2017,6,27,17,549,542,292,-250
2017,6,27,18,570,555,291,-264
2017,6,27,19,568,564,272,-292
2017,6,27,20,593,568,342,-226
2017,6,27,21,593,578,430,-148
2017,6,27,22,596,594,461,-133
2017,6,27,23,602,642,461,-181
2017,6,28,0,592,619,415,-204
2017,6,28,1,586,566,386,-180
2017,6,28,2,565,557,280,-277
2017,6,28,3,515,512,197,-315
2017,6,28,4,460,470,191,-279
2017,6,28,5,423,404,108,-296
2017,6,28,6,393,393,114,-279
2017,6,28,7,380,378,116,-262
2017,6,28,8,375,374,117,-257
2017,6,28,9,380,381,112,-269
2017,6,28,10,403,408,113,-295
2017,6,28,11,447,448,114,-334
2017,6,28,12,486,485,113,-372
2017,6,28,13,510,507,114,-393
2017,6,28,14,528,524,114,-410
2017,6,28,15,548,540,115,-425
2017,6,28,16,546,501,159,-342
2017,6,28,17,571,541,291,-250
2017,6,28,18,588,589,333,-256
2017,6,28,19,597,596,336,-260
2017,6,28,20,615,610,333,-277
2017,6,28,21,622,637,379,-258
2017,6,28,22,633,649,437,-212
2017,6,28,23,637,695,462,-233
2017,6,29,0,639,655,415,-240
2017,6,29,1,620,607,388,-219
2017,6,29,2,598,600,387,-213
2017,6,29,3,555,551,374,-177
2017,6,29,4,496,489,198,-291
2017,6,29,5,441,438,117,-321
2017,6,29,6,412,411,114,-297
2017,6,29,7,398,395,117,-278
2017,6,29,8,390,386,112,-274
2017,6,29,9,394,390,113,-277
2017,6,29,10,416,415,113,-302
2017,6,29,11,457,456,114,-342
2017,6,29,12,498,498,114,-384
2017,6,29,13,518,534,117,-417
2017,6,29,14,550,550,121,-429
2017,6,29,15,579,592,126,-466
2017,6,29,16,574,564,127,-437
2017,6,29,17,597,610,210,-400
2017,6,29,18,620,659,286,-373
2017,6,29,19,629,676,336,-340
2017,6,29,20,642,695,373,-322
2017,6,29,21,647,707,418,-289
2017,6,29,22,657,708,457,-251
2017,6,29,23,658,743,457,-286
2017,6,30,0,664,697,408,-289
2017,6,30,1,637,651,381,-270
2017,6,30,2,613,648,374,-274
2017,6,30,3,569,594,243,-351
2017,6,30,4,512,528,137,-391
2017,6,30,5,463,476,117,-359
2017,6,30,6,434,448,118,-330
2017,6,30,7,417,428,121,-307
2017,6,30,8,406,422,121,-301
2017,6,30,9,409,421,119,-302
2017,6,30,10,430,444,120,-324
2017,6,30,11,469,480,122,-358
2017,6,30,12,507,517,121,-396
2017,6,30,13,533,548,121,-427
2017,6,30,14,563,573,123,-450
2017,6,30,15,587,597,149,-448
2017,6,30,16,572,616,205,-411
2017,6,30,17,595,625,259,-366
2017,6,30,18,621,635,261,-374
2017,6,30,19,621,631,265,-366
2017,6,30,20,617,640,269,-371
2017,6,30,21,617,644,260,-384
2017,6,30,22,608,657,258,-399
2017,6,30,23,604,654,260,-394
2017,7,1,0,590,642,228,-414
2017,7,1,1,581,623,170,-453
2017,7,1,2,569,614,157,-457
2017,7,1,3,539,573,121,-452
2017,7,1,4,493,521,119,-402
2017,7,1,5,460,473,118,-355
2017,7,1,6,429,441,116,-325
2017,7,1,7,410,419,117,-302
2017,7,1,8,400,409,119,-290
2017,7,1,9,397,403,118,-285
2017,7,1,10,409,412,119,-293
2017,7,1,11,426,423,118,-305
2017,7,1,12,454,453,120,-333
2017,7,1,13,495,493,118,-375
2017,7,1,14,545,549,120,-429
2017,7,1,15,591,596,120,-476
2017,7,1,16,600,576,123,-453
2017,7,1,17,602,636,178,-458
2017,7,1,18,649,676,205,-471
2017,7,1,19,662,693,267,-426
2017,7,1,20,678,699,348,-351
2017,7,1,21,677,702,373,-329
2017,7,1,22,692,703,409,-294
2017,7,1,23,690,716,447,-269
2017,7,2,0,668,646,373,-273
2017,7,2,1,638,596,325,-271
2017,7,2,2,661,577,309,-268
2017,7,2,3,588,538,229,-309
2017,7,2,4,519,484,135,-349
2017,7,2,5,477,442,115,-327
2017,7,2,6,439,414,117,-297
2017,7,2,7,415,398,117,-281
2017,7,2,8,402,385,116,-269
2017,7,2,9,394,382,118,-264
2017,7,2,10,395,386,117,-269
2017,7,2,11,402,394,117,-277
2017,7,2,12,424,427,118,-309
2017,7,2,13,476,468,118,-350
2017,7,2,14,526,515,120,-395
2017,7,2,15,565,540,120,-420
2017,7,2,16,592,514,123,-391
2017,7,2,17,618,579,290,-289
2017,7,2,18,656,624,336,-288
2017,7,2,19,671,649,343,-306
2017,7,2,20,684,655,349,-306
2017,7,2,21,683,679,403,-276
2017,7,2,22,709,678,457,-221
2017,7,2,23,708,734,473,-261
2017,7,3,0,689,713,427,-286
2017,7,3,1,665,641,343,-298
2017,7,3,2,654,624,314,-310
2017,7,3,3,587,580,273,-307
2017,7,3,4,521,517,240,-277
2017,7,3,5,458,464,132,-332
2017,7,3,6,420,433,119,-314
2017,7,3,7,397,396,107,-289
2017,7,3,8,388,401,117,-284
2017,7,3,9,387,386,105,-281
2017,7,3,10,400,415,117,-298
2017,7,3,11,422,444,116,-328
2017,7,3,12,449,480,117,-363
2017,7,3,13,484,521,117,-404
2017,7,3,14,531,551,118,-433
2017,7,3,15,582,577,119,-458
2017,7,3,16,588,615,205,-410
2017,7,3,17,633,649,230,-419
2017,7,3,18,652,668,233,-435
2017,7,3,19,657,684,248,-436
2017,7,3,20,680,697,252,-445
2017,7,3,21,685,693,246,-447
2017,7,3,22,690,694,239,-455
2017,7,3,23,689,674,230,-444
2017,7,4,0,676,648,183,-465
2017,7,4,1,644,626,156,-470
2017,7,4,2,608,606,144,-462
2017,7,4,3,561,565,116,-449
2017,7,4,4,513,508,115,-393
2017,7,4,5,460,458,112,-346
2017,7,4,6,425,427,115,-312
2017,7,4,7,401,404,115,-289
2017,7,4,8,391,396,116,-280
2017,7,4,9,388,392,116,-276
2017,7,4,10,397,399,116,-283
2017,7,4,11,413,413,114,-299
2017,7,4,12,436,437,116,-321
2017,7,4,13,473,479,115,-364
2017,7,4,14,519,521,118,-403
2017,7,4,15,572,564,117,-447
2017,7,4,16,575,538,115,-423
2017,7,4,17,621,584,172,-412
2017,7,4,18,645,616,208,-408
2017,7,4,19,646,630,333,-297
2017,7,4,20,672,651,361,-290
2017,7,4,21,682,675,405,-270
2017,7,4,22,684,687,372,-315
2017,7,4,23,680,738,340,-398
2017,7,5,0,663,674,278,-396
2017,7,5,1,630,619,207,-412
2017,7,5,2,596,587,128,-459
2017,7,5,3,555,569,118,-451
2017,7,5,4,518,527,117,-410
2017,7,5,5,479,466,108,-358
2017,7,5,6,449,434,111,-323
2017,7,5,7,432,415,111,-304
2017,7,5,8,422,406,112,-294
2017,7,5,9,424,407,115,-292
2017,7,5,10,444,425,116,-309
2017,7,5,11,484,466,116,-350
2017,7,5,12,521,510,117,-393
2017,7,5,13,556,549,119,-430
2017,7,5,14,603,595,134,-461
2017,7,5,15,653,648,187,-461
2017,7,5,16,657,628,195,-433
2017,7,5,17,703,691,261,-430
2017,7,5,18,751,738,298,-440
2017,7,5,19,766,751,313,-438
2017,7,5,20,776,756,351,-405
2017,7,5,21,786,767,385,-382
2017,7,5,22,787,748,406,-342
2017,7,5,23,786,759,426,-333
2017,7,6,0,756,710,395,-315
2017,7,6,1,725,659,370,-289
2017,7,6,2,684,638,350,-288
2017,7,6,3,624,586,257,-329
2017,7,6,4,563,519,159,-360
2017,7,6,5,506,470,120,-350
2017,7,6,6,470,438,117,-321
2017,7,6,7,450,420,117,-303
2017,7,6,8,438,405,117,-288
2017,7,6,9,437,407,117,-290
2017,7,6,10,457,423,117,-306
2017,7,6,11,496,466,116,-350
2017,7,6,12,537,509,118,-391
2017,7,6,13,572,551,140,-411
2017,7,6,14,617,585,151,-434
2017,7,6,15,659,619,184,-435
2017,7,6,16,669,589,220,-369
2017,7,6,17,718,650,278,-372
2017,7,6,18,763,708,343,-365
2017,7,6,19,781,728,463,-265
2017,7,6,20,772,747,539,-208
2017,7,6,21,789,733,542,-191
2017,7,6,22,788,728,502,-226
2017,7,6,23,791,789,470,-319
2017,7,7,0,757,735,290,-445
2017,7,7,1,728,700,265,-435
2017,7,7,2,687,679,255,-424
2017,7,7,3,627,621,201,-420
2017,7,7,4,566,552,133,-419
2017,7,7,5,510,487,106,-381
2017,7,7,6,476,465,113,-352
2017,7,7,7,455,443,115,-328
2017,7,7,8,442,427,112,-315
2017,7,7,9,441,428,112,-316
2017,7,7,10,460,446,113,-333
2017,7,7,11,495,483,112,-371
2017,7,7,12,532,524,115,-409
2017,7,7,13,570,565,117,-448
2017,7,7,14,611,600,138,-462
2017,7,7,15,655,629,205,-424
2017,7,7,16,650,656,267,-389
2017,7,7,17,698,677,267,-410
2017,7,7,18,749,703,271,-432
2017,7,7,19,765,721,279,-442
2017,7,7,20,768,739,301,-438
2017,7,7,21,779,753,325,-428
2017,7,7,22,776,757,368,-389
2017,7,7,23,778,749,374,-375
2017,7,8,0,733,723,367,-356
2017,7,8,1,697,690,329,-361
2017,7,8,2,663,672,309,-363
2017,7,8,3,613,625,249,-376
2017,7,8,4,553,522,136,-386
2017,7,8,5,501,505,118,-387
2017,7,8,6,464,470,119,-351
2017,7,8,7,438,446,121,-325
2017,7,8,8,421,430,119,-311
2017,7,8,9,414,421,120,-301
2017,7,8,10,418,428,121,-307
2017,7,8,11,430,435,120,-315
2017,7,8,12,456,464,120,-344
2017,7,8,13,500,516,121,-395
2017,7,8,14,550,569,122,-447
2017,7,8,15,597,612,149,-463
2017,7,8,16,597,596,262,-334
2017,7,8,17,634,653,320,-333
2017,7,8,18,686,696,359,-337
2017,7,8,19,697,717,399,-318
2017,7,8,20,715,706,413,-293
2017,7,8,21,715,660,442,-218
2017,7,8,22,725,625,459,-166
2017,7,8,23,721,651,446,-205
2017,7,9,0,691,636,370,-266
2017,7,9,1,660,719,245,-474
2017,7,9,2,653,564,172,-392
2017,7,9,3,585,529,120,-409
2017,7,9,4,523,476,115,-361
2017,7,9,5,473,434,109,-325
2017,7,9,6,436,408,113,-295
2017,7,9,7,410,394,113,-281
2017,7,9,8,396,383,113,-270
2017,7,9,9,387,378,111,-267
2017,7,9,10,392,383,110,-273
2017,7,9,11,397,395,111,-284
2017,7,9,12,421,423,112,-311
2017,7,9,13,472,461,111,-350
2017,7,9,14,516,499,114,-385
2017,7,9,15,543,525,114,-411
2017,7,9,16,564,552,114,-438
2017,7,9,17,590,579,138,-441
2017,7,9,18,629,605,178,-427
2017,7,9,19,628,607,219,-388
2017,7,9,20,643,594,274,-320
2017,7,9,21,658,674,397,-277
2017,7,9,22,669,688,431,-257
2017,7,9,23,666,686,433,-253
2017,7,10,0,646,662,430,-232
2017,7,10,1,627,660,373,-287
2017,7,10,2,624,672,275,-397
2017,7,10,3,572,572,169,-403
2017,7,10,4,504,513,140,-373
2017,7,10,5,453,437,95,-342
2017,7,10,6,420,428,115,-313
2017,7,10,7,402,412,115,-297
2017,7,10,8,393,398,112,-286
2017,7,10,9,395,401,114,-287
2017,7,10,10,420,425,113,-312
2017,7,10,11,457,465,114,-351
2017,7,10,12,490,510,116,-394
2017,7,10,13,520,553,117,-436
2017,7,10,14,570,575,106,-469
2017,7,10,15,611,642,142,-500
2017,7,10,16,604,666,166,-500
2017,7,10,17,649,699,257,-442
2017,7,10,18,692,722,347,-375
2017,7,10,19,719,696,365,-331
2017,7,10,20,736,738,421,-317
2017,7,10,21,742,778,446,-332
2017,7,10,22,745,786,434,-352
2017,7,10,23,757,788,411,-377
2017,7,11,0,724,808,432,-376
2017,7,11,1,687,752,339,-413
2017,7,11,2,651,702,270,-432
2017,7,11,3,595,639,237,-402
2017,7,11,4,535,569,134,-435
2017,7,11,5,493,495,106,-389
2017,7,11,6,457,472,117,-355
2017,7,11,7,434,446,117,-329
2017,7,11,8,420,433,120,-313
2017,7,11,9,420,427,120,-307
2017,7,11,10,439,446,119,-327
2017,7,11,11,478,486,120,-366
2017,7,11,12,512,525,121,-404
2017,7,11,13,540,566,121,-445
2017,7,11,14,591,599,122,-477
2017,7,11,15,638,643,137,-506
2017,7,11,16,629,627,192,-435
2017,7,11,17,684,700,275,-425
2017,7,11,18,732,756,347,-409
2017,7,11,19,758,780,381,-399
2017,7,11,20,783,795,418,-377
2017,7,11,21,795,801,457,-344
2017,7,11,22,796,810,459,-351
2017,7,11,23,810,834,457,-377
2017,7,12,0,769,784,424,-360
2017,7,12,1,731,784,414,-370
2017,7,12,2,696,712,334,-378
2017,7,12,3,630,665,291,-374
2017,7,12,4,567,591,189,-402
2017,7,12,5,516,532,118,-414
2017,7,12,6,482,495,121,-374
2017,7,12,7,456,473,121,-352
2017,7,12,8,441,458,119,-339
2017,7,12,9,440,453,117,-336
2017,7,12,10,459,469,116,-353
2017,7,12,11,496,508,118,-390
2017,7,12,12,536,553,119,-434
2017,7,12,13,571,597,139,-458
2017,7,12,14,614,637,177,-460
2017,7,12,15,670,690,246,-444
2017,7,12,16,676,675,374,-301
2017,7,12,17,740,741,472,-269
2017,7,12,18,780,797,561,-236
2017,7,12,19,800,813,568,-245
2017,7,12,20,824,837,568,-269
2017,7,12,21,840,839,563,-276
2017,7,12,22,837,830,551,-279
2017,7,12,23,850,847,581,-266
2017,7,13,0,810,812,543,-269
2017,7,13,1,764,754,512,-242
2017,7,13,2,728,733,512,-221
2017,7,13,3,661,665,349,-316
2017,7,13,4,601,564,275,-289
2017,7,13,5,535,506,187,-319
2017,7,13,6,500,491,116,-375
2017,7,13,7,473,474,115,-359
2017,7,13,8,458,460,117,-343
2017,7,13,9,455,459,116,-343
2017,7,13,10,473,479,118,-361
2017,7,13,11,507,517,118,-399
2017,7,13,12,549,563,126,-437
2017,7,13,13,585,605,225,-380
2017,7,13,14,626,650,329,-321
2017,7,13,15,680,706,351,-355
2017,7,13,16,696,692,363,-329
2017,7,13,17,755,753,458,-295
2017,7,13,18,782,815,717,-98
2017,7,13,19,797,842,755,-87
2017,7,13,20,823,844,755,-89
2017,7,13,21,833,840,715,-125
2017,7,13,22,834,805,706,-99
2017,7,13,23,844,828,734,-94
2017,7,14,0,802,762,616,-146
2017,7,14,1,763,714,455,-259
2017,7,14,2,730,692,400,-292
2017,7,14,3,682,642,262,-380
2017,7,14,4,614,577,196,-381
2017,7,14,5,546,522,151,-371
2017,7,14,6,511,489,116,-373
2017,7,14,7,484,471,113,-358
2017,7,14,8,467,456,112,-344
2017,7,14,9,463,451,110,-341
2017,7,14,10,479,474,112,-362
2017,7,14,11,510,512,112,-400
2017,7,14,12,550,553,113,-440
2017,7,14,13,593,594,175,-419
2017,7,14,14,638,644,263,-381
2017,7,14,15,696,690,319,-371
2017,7,14,16,707,735,309,-426
2017,7,14,17,756,758,425,-333
2017,7,14,18,805,796,492,-304
2017,7,14,19,814,817,578,-239
2017,7,14,20,842,815,577,-238
2017,7,14,21,852,770,543,-227
2017,7,14,22,848,689,540,-149
2017,7,14,23,854,686,532,-154
2017,7,15,0,808,698,580,-118
2017,7,15,1,752,713,545,-168
2017,7,15,2,723,683,437,-246
2017,7,15,3,664,614,305,-309
2017,7,15,4,595,553,244,-309
2017,7,15,5,533,506,179,-327
2017,7,15,6,492,467,128,-339
2017,7,15,7,465,451,113,-338
2017,7,15,8,448,442,114,-328
2017,7,15,9,440,434,112,-322
2017,7,15,10,445,442,113,-329
2017,7,15,11,454,459,113,-346
2017,7,15,12,483,484,112,-372
2017,7,15,13,524,529,112,-417
2017,7,15,14,581,579,112,-467
2017,7,15,15,634,611,165,-446
2017,7,15,16,647,588,212,-376
2017,7,15,17,675,650,305,-345
2017,7,15,18,725,673,344,-329
2017,7,15,19,737,650,365,-285
2017,7,15,20,745,620,350,-270
2017,7,15,21,758,611,342,-269
2017,7,15,22,754,621,343,-278
2017,7,15,23,760,673,372,-301
2017,7,16,0,734,647,324,-323
2017,7,16,1,694,605,265,-340
2017,7,16,2,695,601,229,-372
2017,7,16,3,622,565,136,-429
2017,7,16,4,555,512,112,-400
2017,7,16,5,464,466,113,-353
2017,7,16,6,431,437,110,-327
2017,7,16,7,412,420,112,-308
2017,7,16,8,400,409,114,-295
2017,7,16,9,395,399,115,-284
2017,7,16,10,401,408,117,-291
2017,7,16,11,412,415,114,-301
2017,7,16,12,437,450,117,-333
2017,7,16,13,488,497,114,-383
2017,7,16,14,532,538,116,-422
2017,7,16,15,568,577,118,-459
2017,7,16,16,589,608,117,-491
2017,7,16,17,617,646,148,-498
2017,7,16,18,651,672,168,-504
2017,7,16,19,663,689,232,-457
2017,7,16,20,661,705,246,-459
2017,7,16,21,683,715,270,-445
2017,7,16,22,690,730,338,-392
2017,7,16,23,690,719,361,-358
2017,7,17,0,674,707,346,-361
2017,7,17,1,657,673,277,-396
2017,7,17,2,650,663,198,-465
2017,7,17,3,584,608,133,-475
2017,7,17,4,523,550,121,-429
2017,7,17,5,470,467,93,-374
2017,7,17,6,438,452,115,-337
2017,7,17,7,417,434,121,-313
2017,7,17,8,406,422,121,-301
2017,7,17,9,408,424,121,-303
2017,7,17,10,431,442,120,-322
2017,7,17,11,472,482,122,-360
2017,7,17,12,510,524,121,-403
2017,7,17,13,547,566,122,-444
2017,7,17,14,586,597,122,-475
2017,7,17,15,630,645,137,-508
2017,7,17,16,632,690,180,-510
2017,7,17,17,683,724,212,-512
2017,7,17,18,722,757,247,-510
2017,7,17,19,737,767,259,-508
2017,7,17,20,760,776,275,-501
2017,7,17,21,760,764,268,-496
2017,7,17,22,756,750,252,-498
2017,7,17,23,780,734,252,-482
2017,7,18,0,754,715,251,-464
2017,7,18,1,725,692,254,-438
2017,7,18,2,687,669,216,-453
2017,7,18,3,625,606,135,-471
2017,7,18,4,552,538,112,-426
2017,7,18,5,491,476,104,-372
2017,7,18,6,458,447,110,-337
2017,7,18,7,435,434,118,-316
2017,7,18,8,421,418,116,-302
2017,7,18,9,422,418,116,-302
2017,7,18,10,444,437,115,-322
2017,7,18,11,484,479,130,-349
2017,7,18,12,525,516,140,-376
2017,7,18,13,561,555,142,-413
2017,7,18,14,595,580,142,-438
2017,7,18,15,636,626,143,-483
2017,7,18,16,635,619,144,-475
2017,7,18,17,680,683,208,-475
2017,7,18,18,729,744,302,-442
2017,7,18,19,748,762,331,-431
2017,7,18,20,774,787,333,-454
2017,7,18,21,785,799,331,-468
2017,7,18,22,785,783,327,-456
2017,7,18,23,808,823,332,-491
2017,7,19,0,768,772,264,-508
2017,7,19,1,732,702,206,-496
2017,7,19,2,697,678,181,-497
2017,7,19,3,635,621,156,-465
2017,7,19,4,564,551,111,-440
2017,7,19,5,499,506,100,-406
2017,7,19,6,465,463,108,-355
2017,7,19,7,443,444,111,-333
2017,7,19,8,432,426,108,-318
2017,7,19,9,432,425,109,-316
2017,7,19,10,450,445,110,-335
2017,7,19,11,492,484,110,-374
2017,7,19,12,533,526,109,-417
2017,7,19,13,570,567,115,-452
2017,7,19,14,605,601,132,-469
2017,7,19,15,651,650,211,-439
2017,7,19,16,667,646,252,-394
2017,7,19,17,708,706,327,-379
2017,7,19,18,751,765,395,-370
2017,7,19,19,768,777,416,-361
2017,7,19,20,792,798,424,-374
2017,7,19,21,803,820,457,-363
2017,7,19,22,804,829,443,-386
2017,7,19,23,809,871,373,-498
2017,7,20,0,777,820,303,-517
2017,7,20,1,753,751,272,-479
2017,7,20,2,719,725,281,-444
2017,7,20,3,657,654,254,-400
2017,7,20,4,585,580,169,-411
2017,7,20,5,511,518,112,-406
2017,7,20,6,476,480,111,-369
2017,7,20,7,453,456,112,-344
2017,7,20,8,440,441,114,-327
2017,7,20,9,439,435,112,-323
2017,7,20,10,456,456,122,-334
2017,7,20,11,496,495,178,-317
2017,7,20,12,539,537,249,-288
2017,7,20,13,577,577,256,-321
2017,7,20,14,619,612,258,-354
2017,7,20,15,667,658,261,-397
2017,7,20,16,679,661,297,-364
2017,7,20,17,725,719,382,-337
2017,7,20,18,768,774,437,-337
2017,7,20,19,783,794,613,-181
2017,7,20,20,812,819,635,-184
2017,7,20,21,824,834,629,-205
2017,7,20,22,825,842,624,-218
2017,7,20,23,836,886,620,-266
2017,7,21,0,810,828,568,-260
2017,7,21,1,774,767,427,-340
2017,7,21,2,740,739,384,-355
2017,7,21,3,675,671,384,-287
2017,7,21,4,606,601,293,-308
2017,7,21,5,549,539,208,-331
2017,7,21,6,513,503,197,-306
2017,7,21,7,488,475,139,-336
2017,7,21,8,471,462,111,-351
2017,7,21,9,467,457,110,-347
2017,7,21,10,482,474,111,-363
2017,7,21,11,514,506,110,-396
2017,7,21,12,556,548,111,-437
2017,7,21,13,599,589,128,-461
2017,7,21,14,649,637,163,-474
2017,7,21,15,699,687,217,-470
2017,7,21,16,720,731,281,-450
2017,7,21,17,785,775,326,-449
2017,7,21,18,897,809,358,-451
2017,7,21,19,861,829,461,-368
2017,7,21,20,862,847,547,-300
2017,7,21,21,840,858,548,-310
2017,7,21,22,843,862,545,-317
2017,7,21,23,829,852,547,-305
2017,7,22,0,796,821,519,-302
2017,7,22,1,750,780,486,-294
2017,7,22,2,761,761,490,-271
2017,7,22,3,683,694,446,-248
2017,7,22,4,624,628,389,-239
2017,7,22,5,561,566,323,-243
2017,7,22,6,525,520,137,-383
2017,7,22,7,492,494,115,-379
2017,7,22,8,474,470,116,-354
2017,7,22,9,467,463,114,-349
2017,7,22,10,473,470,119,-351
2017,7,22,11,477,478,119,-359
2017,7,22,12,504,509,121,-388
2017,7,22,13,551,555,117,-438
2017,7,22,14,608,614,113,-501
2017,7,22,15,668,678,199,-479
2017,7,22,16,685,677,269,-408
2017,7,22,17,737,752,350,-402
2017,7,22,18,785,797,435,-362
2017,7,22,19,801,806,548,-258
2017,7,22,20,796,799,560,-239
2017,7,22,21,798,778,582,-196
2017,7,22,22,808,793,597,-196
2017,7,22,23,805,845,596,-249
2017,7,23,0,780,793,541,-252
2017,7,23,1,742,743,518,-225
2017,7,23,2,725,718,410,-308
2017,7,23,3,649,667,364,-303
2017,7,23,4,597,596,330,-266
2017,7,23,5,544,540,276,-264
2017,7,23,6,509,502,194,-308
2017,7,23,7,478,474,152,-322
2017,7,23,8,464,459,130,-329
2017,7,23,9,448,450,118,-332
2017,7,23,10,452,448,118,-330
2017,7,23,11,450,461,119,-342
2017,7,23,12,478,488,117,-371
2017,7,23,13,528,545,118,-427
2017,7,23,14,585,604,120,-484
2017,7,23,15,631,659,172,-487
2017,7,23,16,676,705,217,-488
2017,7,23,17,744,733,283,-450
2017,7,23,18,845,696,307,-389
2017,7,23,19,790,662,342,-320
2017,7,23,20,783,652,342,-310
2017,7,23,21,776,661,338,-323
2017,7,23,22,789,681,336,-345
2017,7,23,23,772,689,267,-422
2017,7,24,0,762,674,219,-455
2017,7,24,1,728,660,188,-472
2017,7,24,2,707,653,149,-504
2017,7,24,3,651,608,134,-474
2017,7,24,4,594,552,111,-441
2017,7,24,5,522,499,114,-385
2017,7,24,6,491,466,114,-352
2017,7,24,7,466,454,114,-340
2017,7,24,8,455,438,113,-325
2017,7,24,9,453,441,115,-326
2017,7,24,10,472,459,113,-346
2017,7,24,11,509,499,113,-386
2017,7,24,12,551,535,113,-422
2017,7,24,13,593,576,112,-464
2017,7,24,14,637,607,114,-493
2017,7,24,15,689,643,132,-511
2017,7,24,16,708,673,160,-513
2017,7,24,17,767,703,188,-515
2017,7,24,18,798,734,219,-515
2017,7,24,19,837,763,260,-503
2017,7,24,20,858,790,324,-466
2017,7,24,21,871,793,348,-445
2017,7,24,22,865,765,393,-372
2017,7,24,23,887,860,439,-421
2017,7,25,0,843,782,387,-395
2017,7,25,1,806,743,385,-358
2017,7,25,2,749,716,382,-334
2017,7,25,3,688,650,333,-317
2017,7,25,4,611,580,260,-320
2017,7,25,5,509,522,179,-343
2017,7,25,6,475,482,120,-362
2017,7,25,7,451,462,116,-346
2017,7,25,8,436,444,114,-330
2017,7,25,9,435,450,117,-333
2017,7,25,10,452,468,116,-352
2017,7,25,11,493,503,117,-386
2017,7,25,12,533,542,117,-425
2017,7,25,13,571,581,119,-462
2017,7,25,14,605,618,139,-479
2017,7,25,15,647,669,182,-487
2017,7,25,16,662,657,228,-429
2017,7,25,17,706,724,326,-398
2017,7,25,18,751,786,378,-408
2017,7,25,19,781,804,428,-376
2017,7,25,20,806,826,502,-324
2017,7,25,21,821,851,666,-185
2017,7,25,22,814,843,732,-111
2017,7,25,23,827,890,757,-133
2017,7,26,0,784,844,713,-131
2017,7,26,1,754,771,563,-208
2017,7,26,2,710,746,373,-373
2017,7,26,3,650,678,289,-389
2017,7,26,4,577,602,197,-405
2017,7,26,5,514,540,120,-420
2017,7,26,6,478,500,109,-391
2017,7,26,7,453,472,109,-363
2017,7,26,8,440,461,109,-352
2017,7,26,9,438,457,109,-348
2017,7,26,10,455,476,109,-367
2017,7,26,11,497,515,114,-401
2017,7,26,12,535,550,117,-433
2017,7,26,13,573,590,130,-460
2017,7,26,14,604,611,154,-457
2017,7,26,15,643,638,183,-455
2017,7,26,16,654,623,336,-287
2017,7,26,17,691,683,553,-130
2017,7,26,18,733,742,580,-162
2017,7,26,19,764,776,609,-167
2017,7,26,20,784,815,712,-103
2017,7,26,21,797,822,720,-102
2017,7,26,22,789,824,751,-73
2017,7,26,23,811,865,689,-176
2017,7,27,0,767,806,673,-133
2017,7,27,1,733,745,522,-223
2017,7,27,2,704,722,478,-244
2017,7,27,3,646,653,367,-286
2017,7,27,4,570,587,232,-355
2017,7,27,5,510,529,146,-383
2017,7,27,6,474,497,107,-390
2017,7,27,7,455,477,112,-365
2017,7,27,8,441,466,113,-353
2017,7,27,9,442,464,111,-353
2017,7,27,10,461,483,111,-372
2017,7,27,11,500,524,112,-412
2017,7,27,12,544,562,114,-448
2017,7,27,13,581,599,112,-487
2017,7,27,14,615,636,139,-497
2017,7,27,15,653,678,194,-484
2017,7,27,16,661,660,206,-454
2017,7,27,17,701,713,264,-449
2017,7,27,18,735,747,295,-452
2017,7,27,19,750,754,313,-441
2017,7,27,20,763,739,439,-300
2017,7,27,21,775,738,471,-267
2017,7,27,22,766,734,444,-290
2017,7,27,23,784,781,494,-287
2017,7,28,0,750,732,454,-278
2017,7,28,1,713,699,291,-408
2017,7,28,2,689,680,286,-394
2017,7,28,3,633,625,253,-372
2017,7,28,4,558,566,173,-393
2017,7,28,5,517,498,105,-393
2017,7,28,6,481,478,114,-364
2017,7,28,7,461,458,114,-344
2017,7,28,8,447,451,117,-334
2017,7,28,9,447,454,115,-339
2017,7,28,10,466,472,116,-356
2017,7,28,11,503,511,113,-398
2017,7,28,12,544,545,113,-432
2017,7,28,13,582,572,112,-460
2017,7,28,14,614,597,113,-484
2017,7,28,15,644,622,116,-506
2017,7,28,16,647,648,163,-485
2017,7,28,17,685,668,197,-471
2017,7,28,18,721,663,208,-455
2017,7,28,19,722,655,254,-401
2017,7,28,20,721,657,298,-359
2017,7,28,21,712,660,299,-361
2017,7,28,22,696,659,299,-360
2017,7,28,23,715,659,310,-349
2017,7,29,0,669,647,262,-385
2017,7,29,1,636,640,207,-433
2017,7,29,2,624,630,196,-434
2017,7,29,3,584,589,175,-414
2017,7,29,4,528,541,130,-411
2017,7,29,5,483,496,112,-384
2017,7,29,6,445,465,110,-355
2017,7,29,7,424,448,112,-336
2017,7,29,8,408,429,111,-318
2017,7,29,9,406,428,113,-315
2017,7,29,10,413,432,112,-320
2017,7,29,11,425,449,112,-337
2017,7,29,12,454,483,113,-370
2017,7,29,13,497,523,112,-411
2017,7,29,14,540,568,115,-453
2017,7,29,15,567,595,114,-481
2017,7,29,16,562,556,116,-440
2017,7,29,17,579,611,175,-436
2017,7,29,18,589,642,191,-451
2017,7,29,19,621,645,191,-454
2017,7,29,20,638,651,191,-460
2017,7,29,21,659,659,190,-469
2017,7,29,22,650,660,209,-451
2017,7,29,23,653,707,299,-408
2017,7,30,0,629,650,226,-424
2017,7,30,1,609,600,144,-456
2017,7,30,2,592,585,132,-453
2017,7,30,3,545,542,121,-421
2017,7,30,4,489,488,118,-370
2017,7,30,5,456,442,116,-326
2017,7,30,6,417,411,116,-295
2017,7,30,7,397,399,119,-280
2017,7,30,8,384,386,118,-268
2017,7,30,9,379,385,118,-267
2017,7,30,10,380,389,118,-271
2017,7,30,11,387,401,117,-284
2017,7,30,12,413,422,115,-307
2017,7,30,13,459,467,117,-350
2017,7,30,14,495,503,116,-387
2017,7,30,15,510,526,117,-409
2017,7,30,16,515,548,117,-431
2017,7,30,17,539,569,122,-447
2017,7,30,18,544,595,120,-475
2017,7,30,19,576,616,121,-495
2017,7,30,20,593,639,124,-515
2017,7,30,21,628,665,210,-455
2017,7,30,22,632,680,267,-413
2017,7,30,23,631,678,296,-382
2017,7,31,0,614,656,284,-372
2017,7,31,1,605,627,271,-356
2017,7,31,2,580,608,216,-392
2017,7,31,3,525,555,162,-393
2017,7,31,4,471,499,115,-384
2017,7,31,5,425,450,113,-337
2017,7,31,6,396,418,112,-306
2017,7,31,7,383,400,113,-287
2017,7,31,8,374,391,113,-278
2017,7,31,9,378,394,113,-281
2017,7,31,10,401,412,113,-299
2017,7,31,11,443,455,115,-340
2017,7,31,12,481,488,112,-376
2017,7,31,13,512,526,114,-412
2017,7,31,14,537,551,115,-436
2017,7,31,15,563,582,116,-466
2017,7,31,16,561,604,114,-490
2017,7,31,17,593,629,120,-509
2017,7,31,18,620,654,142,-512
2017,7,31,19,635,674,163,-511
2017,7,31,20,661,698,227,-471
2017,7,31,21,677,721,310,-411
2017,7,31,22,676,741,383,-358
2017,7,31,23,699,732,386,-346
2017,8,1,0,677,709,385,-324
2017,8,1,1,649,683,352,-331
2017,8,1,2,620,652,302,-350
2017,8,1,3,568,585,224,-361
2017,8,1,4,500,524,149,-375
2017,8,1,5,450,443,87,-356
2017,8,1,6,419,441,114,-327
2017,8,1,7,400,421,111,-310
2017,8,1,8,392,410,110,-300
2017,8,1,9,394,403,110,-293
2017,8,1,10,413,425,110,-315
2017,8,1,11,454,461,110,-351
2017,8,1,12,491,498,111,-387
2017,8,1,13,521,525,111,-414
2017,8,1,14,543,554,111,-443
2017,8,1,15,571,581,113,-468
2017,8,1,16,573,555,119,-436
2017,8,1,17,606,608,179,-429
2017,8,1,18,645,662,232,-430
2017,8,1,19,665,669,278,-391
2017,8,1,20,688,677,352,-325
2017,8,1,21,706,679,389,-290
2017,8,1,22,705,672,400,-272
2017,8,1,23,729,695,424,-271
2017,8,2,0,697,648,365,-283
2017,8,2,1,661,617,298,-319
2017,8,2,2,639,605,280,-325
2017,8,2,3,581,554,174,-380
2017,8,2,4,513,495,112,-383
2017,8,2,5,460,446,104,-342
2017,8,2,6,429,426,107,-319
2017,8,2,7,409,412,111,-301
2017,8,2,8,402,403,111,-292
2017,8,2,9,403,403,110,-293
2017,8,2,10,423,426,112,-314
2017,8,2,11,465,465,112,-353
2017,8,2,12,503,512,145,-367
2017,8,2,13,531,539,237,-302
2017,8,2,14,559,562,249,-313
2017,8,2,15,588,580,249,-331
2017,8,2,16,591,547,249,-298
2017,8,2,17,627,588,302,-286
2017,8,2,18,664,624,337,-287
2017,8,2,19,683,635,367,-268
2017,8,2,20,702,658,394,-264
2017,8,2,21,716,674,409,-265
2017,8,2,22,716,681,436,-245
2017,8,2,23,735,729,447,-282
2017,8,3,0,698,683,360,-323
2017,8,3,1,669,644,307,-337
2017,8,3,2,648,629,273,-356
2017,8,3,3,589,569,155,-414
2017,8,3,4,522,507,122,-385
2017,8,3,5,465,457,120,-337
2017,8,3,6,435,431,120,-311
2017,8,3,7,416,410,120,-290
2017,8,3,8,407,404,121,-283
2017,8,3,9,407,406,121,-285
2017,8,3,10,428,425,121,-304
2017,8,3,11,468,467,122,-345
2017,8,3,12,505,503,122,-381
2017,8,3,13,534,534,124,-410
2017,8,3,14,562,547,164,-383
2017,8,3,15,591,587,209,-378
2017,8,3,16,595,561,225,-336
2017,8,3,17,636,604,277,-327
2017,8,3,18,672,659,339,-320
2017,8,3,19,693,681,368,-313
2017,8,3,20,716,702,438,-264
2017,8,3,21,724,723,461,-262
2017,8,3,22,720,724,461,-263
2017,8,3,23,738,761,460,-301
2017,8,4,0,706,711,410,-301
2017,8,4,1,680,669,390,-279
2017,8,4,2,659,647,320,-327
2017,8,4,3,598,586,203,-383
2017,8,4,4,531,524,132,-392
2017,8,4,5,472,469,129,-340
2017,8,4,6,440,438,130,-308
2017,8,4,7,418,421,130,-291
2017,8,4,8,410,411,132,-279
2017,8,4,9,410,408,130,-278
2017,8,4,10,431,428,129,-299
2017,8,4,11,469,467,131,-336
2017,8,4,12,506,502,129,-373
2017,8,4,13,538,529,133,-396
2017,8,4,14,566,546,132,-414
2017,8,4,15,592,572,133,-439
2017,8,4,16,590,607,149,-458
2017,8,4,17,627,638,208,-430
2017,8,4,18,659,676,239,-437
2017,8,4,19,674,696,255,-441
2017,8,4,20,687,717,281,-436
2017,8,4,21,695,724,339,-385
2017,8,4,22,690,714,375,-339
2017,8,4,23,704,670,377,-293
2017,8,5,0,659,637,360,-277
2017,8,5,1,633,616,279,-337
2017,8,5,2,619,598,252,-346
2017,8,5,3,570,560,175,-385
2017,8,5,4,516,505,115,-390
2017,8,5,5,464,459,111,-348
2017,8,5,6,429,431,111,-320
2017,8,5,7,406,420,113,-307
2017,8,5,8,394,407,113,-294
2017,8,5,9,390,407,112,-295
2017,8,5,10,397,414,112,-302
2017,8,5,11,410,430,114,-316
2017,8,5,12,434,454,111,-343
2017,8,5,13,473,487,114,-373
2017,8,5,14,514,518,113,-405
2017,8,5,15,547,542,113,-429
2017,8,5,16,540,516,114,-402
2017,8,5,17,578,564,167,-397
2017,8,5,18,601,600,197,-403
2017,8,5,19,613,618,200,-418
2017,8,5,20,627,639,230,-409
2017,8,5,21,643,657,280,-377
2017,8,5,22,646,668,390,-278
2017,8,5,23,655,669,430,-239
2017,8,6,0,622,699,424,-275
2017,8,6,1,595,609,339,-270
2017,8,6,2,583,584,317,-267
2017,8,6,3,538,533,250,-283
2017,8,6,4,481,477,137,-340
2017,8,6,5,437,427,110,-317
2017,8,6,6,405,402,111,-291
2017,8,6,7,386,380,108,-272
2017,8,6,8,377,371,110,-261
2017,8,6,9,372,373,111,-262
2017,8,6,10,373,373,110,-263
2017,8,6,11,383,389,112,-277
2017,8,6,12,405,411,111,-300
2017,8,6,13,450,454,111,-343
2017,8,6,14,485,487,112,-375
2017,8,6,15,507,506,112,-394
2017,8,6,16,523,532,114,-418
2017,8,6,17,552,561,114,-447
2017,8,6,18,589,592,133,-459
2017,8,6,19,608,623,167,-456
2017,8,6,20,630,651,212,-439
2017,8,6,21,656,675,286,-389
2017,8,6,22,669,696,359,-337
2017,8,6,23,671,699,377,-322
2017,8,7,0,651,677,375,-302
2017,8,7,1,630,658,350,-308
2017,8,7,2,618,639,320,-319
2017,8,7,3,562,591,225,-366
2017,8,7,4,503,533,119,-414
2017,8,7,5,455,487,116,-371
2017,8,7,6,427,456,116,-340
2017,8,7,7,413,443,117,-326
2017,8,7,8,406,434,115,-319
2017,8,7,9,409,435,115,-320
2017,8,7,10,431,460,117,-343
2017,8,7,11,479,502,115,-387
2017,8,7,12,516,546,117,-429
2017,8,7,13,547,569,115,-454
2017,8,7,14,574,589,117,-472
2017,8,7,15,603,612,124,-488
2017,8,7,16,609,620,161,-459
2017,8,7,17,636,628,255,-373
2017,8,7,18,662,626,287,-339
2017,8,7,19,672,631,330,-301
2017,8,7,20,678,646,368,-278
2017,8,7,21,694,657,381,-276
2017,8,7,22,692,661,381,-280
2017,8,7,23,712,665,382,-283
2017,8,8,0,690,653,357,-296
2017,8,8,1,662,649,324,-325
2017,8,8,2,640,628,306,-322
2017,8,8,3,588,577,294,-283
2017,8,8,4,524,521,233,-288
2017,8,8,5,468,445,118,-327
2017,8,8,6,440,457,130,-327
2017,8,8,7,422,441,130,-311
2017,8,8,8,414,429,129,-300
2017,8,8,9,416,432,131,-301
2017,8,8,10,438,454,130,-324
2017,8,8,11,485,492,130,-362
2017,8,8,12,523,528,129,-399
2017,8,8,13,551,558,126,-432
2017,8,8,14,571,579,125,-454
2017,8,8,15,593,597,126,-471
2017,8,8,16,582,562,125,-437
2017,8,8,17,615,611,173,-438
2017,8,8,18,657,652,198,-454
2017,8,8,19,670,666,270,-396
2017,8,8,20,676,680,295,-385
2017,8,8,21,690,690,293,-397
2017,8,8,22,685,688,291,-397
2017,8,8,23,710,722,334,-388
2017,8,9,0,673,678,281,-397
2017,8,9,1,645,646,245,-401
2017,8,9,2,622,630,231,-399
2017,8,9,3,568,572,150,-422
2017,8,9,4,508,567,119,-448
2017,8,9,5,452,460,97,-363
2017,8,9,6,424,443,106,-337
2017,8,9,7,408,429,109,-320
2017,8,9,8,403,415,105,-310
2017,8,9,9,406,418,108,-310
2017,8,9,10,431,438,123,-315
2017,8,9,11,477,483,130,-353
2017,8,9,12,514,512,124,-388
2017,8,9,13,539,537,119,-418
2017,8,9,14,558,564,122,-442
2017,8,9,15,581,593,127,-466
2017,8,9,16,576,574,136,-438
2017,8,9,17,604,598,187,-411
2017,8,9,18,629,653,240,-413
2017,8,9,19,639,661,263,-398
2017,8,9,20,652,677,313,-364
2017,8,9,21,662,694,354,-340
2017,8,9,22,667,690,362,-328
2017,8,9,23,678,730,440,-290
2017,8,10,0,646,674,367,-307
2017,8,10,1,624,639,289,-350
2017,8,10,2,606,620,228,-392
2017,8,10,3,556,565,160,-405
2017,8,10,4,499,510,118,-392
2017,8,10,5,453,462,110,-352
2017,8,10,6,427,441,112,-329
2017,8,10,7,411,422,108,-314
2017,8,10,8,405,415,109,-306
2017,8,10,9,407,416,111,-305
2017,8,10,10,432,441,111,-330
2017,8,10,11,480,485,111,-374
2017,8,10,12,517,522,110,-412
2017,8,10,13,542,553,110,-443
2017,8,10,14,560,567,110,-457
2017,8,10,15,580,590,110,-480
2017,8,10,16,575,546,121,-425
2017,8,10,17,599,585,162,-423
2017,8,10,18,612,611,204,-407
2017,8,10,19,623,610,301,-309
2017,8,10,20,630,608,380,-228
2017,8,10,21,643,619,433,-186
2017,8,10,22,643,624,446,-178
2017,8,10,23,660,665,459,-206
2017,8,11,0,634,658,422,-236
2017,8,11,1,618,626,389,-237
2017,8,11,2,604,610,353,-257
2017,8,11,3,556,566,291,-275
2017,8,11,4,509,513,217,-296
2017,8,11,5,463,471,153,-318
2017,8,11,6,437,448,110,-338
2017,8,11,7,423,432,112,-320
2017,8,11,8,416,428,111,-317
2017,8,11,9,418,426,111,-315
2017,8,11,10,443,447,107,-340
2017,8,11,11,492,489,109,-380
2017,8,11,12,524,521,111,-410
2017,8,11,13,553,559,111,-448
2017,8,11,14,580,584,113,-471
2017,8,11,15,606,607,113,-494
2017,8,11,16,601,620,118,-502
2017,8,11,17,634,635,187,-448
2017,8,11,18,666,650,266,-384
2017,8,11,19,677,660,302,-358
2017,8,11,20,687,679,355,-324
2017,8,11,21,692,671,370,-301
2017,8,11,22,686,654,375,-279
2017,8,11,23,704,645,346,-299
2017,8,12,0,660,630,331,-299
2017,8,12,1,632,626,348,-278
2017,8,12,2,614,608,372,-236
2017,8,12,3,571,569,350,-219
2017,8,12,4,521,520,282,-238
2017,8,12,5,473,480,212,-268
2017,8,12,6,445,454,154,-300
2017,8,12,7,428,434,129,-305
2017,8,12,8,418,426,132,-294
2017,8,12,9,417,419,131,-288
2017,8,12,10,427,433,132,-301
2017,8,12,11,447,448,130,-318
2017,8,12,12,476,471,131,-340
2017,8,12,13,516,515,133,-382
2017,8,12,14,562,555,132,-423
2017,8,12,15,604,597,132,-465
2017,8,12,16,602,584,134,-450
2017,8,12,17,639,645,215,-430
2017,8,12,18,661,693,253,-440
2017,8,12,19,681,706,290,-416
2017,8,12,20,691,706,315,-391
2017,8,12,21,695,702,393,-309
2017,8,12,22,688,694,453,-241
2017,8,12,23,693,673,457,-216
2017,8,13,0,677,701,457,-244
2017,8,13,1,638,662,407,-255
2017,8,13,2,622,615,325,-290
2017,8,13,3,576,572,265,-307
2017,8,13,4,520,516,216,-300
2017,8,13,5,480,468,129,-339
2017,8,13,6,448,437,117,-320
2017,8,13,7,428,416,112,-304
2017,8,13,8,416,407,111,-296
2017,8,13,9,411,403,112,-291
2017,8,13,10,414,403,110,-293
2017,8,13,11,430,415,111,-304
2017,8,13,12,456,442,111,-331
2017,8,13,13,502,484,110,-374
2017,8,13,14,545,527,111,-416
2017,8,13,15,578,558,113,-445
2017,8,13,16,601,592,113,-479
2017,8,13,17,638,629,125,-504
2017,8,13,18,650,654,145,-509
2017,8,13,19,676,669,164,-505
2017,8,13,20,683,692,222,-470
2017,8,13,21,702,702,304,-398
2017,8,13,22,700,707,338,-369
2017,8,13,23,695,695,340,-355
2017,8,14,0,671,671,322,-349
2017,8,14,1,654,662,268,-394
2017,8,14,2,634,640,234,-406
2017,8,14,3,582,590,160,-430
2017,8,14,4,527,535,132,-403
2017,8,14,5,474,480,115,-365
2017,8,14,6,448,453,120,-333
2017,8,14,7,431,443,129,-314
2017,8,14,8,424,436,131,-305
2017,8,14,9,425,429,122,-307
2017,8,14,10,451,461,129,-332
2017,8,14,11,500,507,130,-377
2017,8,14,12,535,546,127,-419
2017,8,14,13,570,585,131,-454
2017,8,14,14,603,613,132,-481
2017,8,14,15,646,643,135,-508
2017,8,14,16,660,679,178,-501
2017,8,14,17,706,712,204,-508
2017,8,14,18,742,747,243,-504
2017,8,14,19,756,769,291,-478
2017,8,14,20,767,783,337,-446
2017,8,14,21,774,795,384,-411
2017,8,14,22,769,786,389,-397
2017,8,14,23,784,762,388,-374
2017,8,15,0,749,738,391,-347
2017,8,15,1,713,714,386,-328
2017,8,15,2,681,682,348,-334
2017,8,15,3,618,628,275,-353
2017,8,15,4,557,567,243,-324
2017,8,15,5,497,511,186,-325
2017,8,15,6,471,489,140,-349
2017,8,15,7,451,469,122,-347
2017,8,15,8,442,461,126,-335
2017,8,15,9,443,458,125,-333
2017,8,15,10,469,484,125,-359
2017,8,15,11,517,525,117,-408
2017,8,15,12,553,570,115,-455
2017,8,15,13,584,602,112,-490
2017,8,15,14,612,632,122,-510
2017,8,15,15,649,661,150,-511
2017,8,15,16,648,681,262,-419
2017,8,15,17,693,707,329,-378
2017,8,15,18,736,732,339,-393
2017,8,15,19,750,742,356,-386
2017,8,15,20,764,766,388,-378
2017,8,15,21,773,777,385,-392
2017,8,15,22,770,786,393,-393
2017,8,15,23,790,773,335,-438
2017,8,16,0,754,749,279,-470
2017,8,16,1,714,723,260,-463
2017,8,16,2,684,696,217,-479
2017,8,16,3,619,632,173,-459
2017,8,16,4,561,564,167,-397
2017,8,16,5,499,508,123,-385
2017,8,16,6,469,475,112,-363
2017,8,16,7,448,453,112,-341
2017,8,16,8,439,443,114,-329
2017,8,16,9,438,440,113,-327
2017,8,16,10,463,462,113,-349
2017,8,16,11,513,509,114,-395
2017,8,16,12,547,547,118,-429
2017,8,16,13,578,579,126,-453
2017,8,16,14,605,608,125,-483
2017,8,16,15,642,652,174,-478
2017,8,16,16,647,694,269,-425
2017,8,16,17,696,732,330,-402
2017,8,16,18,738,763,348,-415
2017,8,16,19,762,788,485,-303
2017,8,16,20,779,788,556,-232
2017,8,16,21,789,780,555,-225
2017,8,16,22,789,793,580,-213
2017,8,16,23,801,781,601,-180
2017,8,17,0,764,747,557,-190
2017,8,17,1,728,730,537,-193
2017,8,17,2,696,693,481,-212
2017,8,17,3,632,634,315,-319
2017,8,17,4,571,569,201,-368
2017,8,17,5,519,517,122,-395
2017,8,17,6,487,474,119,-355
2017,8,17,7,465,464,126,-338
2017,8,17,8,457,449,122,-327
2017,8,17,9,455,448,122,-326
2017,8,17,10,480,470,124,-346
2017,8,17,11,530,517,123,-394
2017,8,17,12,568,553,122,-431
2017,8,17,13,599,591,123,-468
2017,8,17,14,636,623,154,-469
2017,8,17,15,677,673,191,-482
2017,8,17,16,695,721,271,-450
2017,8,17,17,746,755,346,-409
2017,8,17,18,776,803,564,-239
2017,8,17,19,795,823,582,-241
2017,8,17,20,811,831,673,-158
2017,8,17,21,814,834,707,-127
2017,8,17,22,814,838,670,-168
2017,8,17,23,827,814,620,-194
2017,8,18,0,787,785,500,-285
2017,8,18,1,757,760,430,-330
2017,8,18,2,726,729,333,-396
2017,8,18,3,661,665,302,-363
2017,8,18,4,603,601,292,-309
2017,8,18,5,526,545,261,-284
2017,8,18,6,492,507,240,-267
2017,8,18,7,468,482,148,-334
2017,8,18,8,455,471,118,-353
2017,8,18,9,455,467,118,-349
2017,8,18,10,476,487,118,-369
2017,8,18,11,521,529,119,-410
2017,8,18,12,556,565,119,-446
2017,8,18,13,587,598,132,-466
2017,8,18,14,619,632,244,-388
2017,8,18,15,657,665,306,-359
2017,8,18,16,676,698,314,-384
2017,8,18,17,714,726,326,-400
2017,8,18,18,748,748,357,-391
2017,8,18,19,759,760,477,-283
2017,8,18,20,763,770,584,-186
2017,8,18,21,767,780,600,-180
2017,8,18,22,762,776,597,-179
2017,8,18,23,757,768,592,-176
2017,8,19,0,713,729,574,-155
2017,8,19,1,688,712,534,-178
2017,8,19,2,655,677,376,-301
2017,8,19,3,607,621,261,-360
2017,8,19,4,551,561,222,-339
2017,8,19,5,499,507,141,-366
2017,8,19,6,465,470,109,-361
2017,8,19,7,442,446,111,-335
2017,8,19,8,431,429,111,-318
2017,8,19,9,423,419,109,-310
2017,8,19,10,430,428,112,-316
2017,8,19,11,448,441,111,-330
2017,8,19,12,470,464,112,-352
2017,8,19,13,510,505,134,-371
2017,8,19,14,550,548,170,-378
2017,8,19,15,593,588,195,-393
2017,8,19,16,593,614,305,-309
2017,8,19,17,639,643,326,-317
2017,8,19,18,676,668,334,-334
2017,8,19,19,702,695,380,-315
2017,8,19,20,712,718,433,-285
2017,8,19,21,723,747,466,-281
2017,8,19,22,721,755,441,-314
2017,8,19,23,728,743,391,-352
2017,8,20,0,702,708,378,-330
2017,8,20,1,667,674,354,-320
2017,8,20,2,630,644,338,-306
2017,8,20,3,578,588,261,-327
2017,8,20,4,518,533,165,-368
2017,8,20,5,470,475,119,-356
2017,8,20,6,434,437,118,-319
2017,8,20,7,412,419,121,-298
2017,8,20,8,401,405,120,-285
2017,8,20,9,395,399,120,-279
2017,8,20,10,400,400,119,-281
2017,8,20,11,414,413,121,-292
2017,8,20,12,437,438,121,-317
2017,8,20,13,483,484,121,-363
2017,8,20,14,523,528,123,-405
2017,8,20,15,556,562,123,-439
2017,8,20,16,575,605,146,-459
2017,8,20,17,623,648,231,-417
2017,8,20,18,658,682,262,-420
2017,8,20,19,684,717,289,-428
2017,8,20,20,709,741,342,-399
2017,8,20,21,727,760,363,-397
2017,8,20,22,732,773,369,-404
2017,8,20,23,732,762,368,-394
2017,8,21,0,709,729,369,-360
2017,8,21,1,684,708,367,-341
2017,8,21,2,647,674,337,-337
2017,8,21,3,589,613,256,-357
2017,8,21,4,531,551,156,-395
2017,8,21,5,474,496,106,-390
2017,8,21,6,446,466,107,-359
2017,8,21,7,426,443,107,-336
2017,8,21,8,416,433,109,-324
2017,8,21,9,417,436,107,-329
2017,8,21,10,442,456,107,-349
2017,8,21,11,492,501,108,-393
2017,8,21,12,527,535,108,-427
2017,8,21,13,560,571,116,-455
2017,8,21,14,589,610,157,-453
2017,8,21,15,630,652,208,-444
2017,8,21,16,640,674,264,-410
2017,8,21,17,679,741,405,-336
2017,8,21,18,713,754,433,-321
2017,8,21,19,731,717,433,-284
2017,8,21,20,741,725,368,-357
2017,8,21,21,757,760,351,-409
2017,8,21,22,760,762,444,-318
2017,8,21,23,772,761,443,-318
2017,8,22,0,741,743,445,-298
2017,8,22,1,714,729,442,-287
2017,8,22,2,679,689,337,-352
2017,8,22,3,613,626,233,-393
2017,8,22,4,559,561,172,-389
2017,8,22,5,495,506,119,-388
2017,8,22,6,466,473,116,-357
2017,8,22,7,444,453,117,-336
2017,8,22,8,432,442,118,-324
2017,8,22,9,433,443,117,-326
2017,8,22,10,458,464,122,-342
2017,8,22,11,509,515,125,-390
2017,8,22,12,543,544,131,-413
2017,8,22,13,573,571,132,-439
2017,8,22,14,598,605,165,-440
2017,8,22,15,636,655,253,-402
2017,8,22,16,647,697,343,-354
2017,8,22,17,695,726,513,-213
2017,8,22,18,735,768,661,-107
2017,8,22,19,757,794,711,-83
2017,8,22,20,778,809,745,-64
2017,8,22,21,791,822,756,-66
2017,8,22,22,790,822,753,-69
2017,8,22,23,797,830,722,-108
2017,8,23,0,760,795,688,-107
2017,8,23,1,732,765,659,-106
2017,8,23,2,692,721,404,-317
2017,8,23,3,622,644,286,-358
2017,8,23,4,569,573,181,-392
2017,8,23,5,507,514,114,-400
2017,8,23,6,473,479,111,-368
2017,8,23,7,448,459,112,-347
2017,8,23,8,436,445,112,-333
2017,8,23,9,436,446,113,-333
2017,8,23,10,458,466,112,-354
2017,8,23,11,508,524,161,-363
2017,8,23,12,541,555,222,-333
2017,8,23,13,568,583,249,-334
2017,8,23,14,594,620,253,-367
2017,8,23,15,628,647,252,-395
2017,8,23,16,635,664,334,-330
2017,8,23,17,671,670,490,-180
2017,8,23,18,706,703,642,-61
2017,8,23,19,712,716,647,-69
2017,8,23,20,716,753,683,-70
2017,8,23,21,721,765,699,-66
2017,8,23,22,715,773,705,-68
2017,8,23,23,714,766,656,-110
2017,8,24,0,686,726,506,-220
2017,8,24,1,669,709,338,-371
2017,8,24,2,639,726,294,-432
2017,8,24,3,579,658,246,-412
2017,8,24,4,521,590,168,-422
2017,8,24,5,477,483,124,-359
2017,8,24,6,443,453,119,-334
2017,8,24,7,421,438,122,-316
2017,8,24,8,411,424,121,-303
2017,8,24,9,412,427,122,-305
2017,8,24,10,436,449,120,-329
2017,8,24,11,484,505,128,-377
2017,8,24,12,515,528,200,-328
2017,8,24,13,536,551,250,-301
2017,8,24,14,554,577,254,-323
2017,8,24,15,580,605,253,-352
2017,8,24,16,582,634,308,-326
2017,8,24,17,609,660,364,-296
2017,8,24,18,640,686,415,-271
2017,8,24,19,657,709,425,-284
2017,8,24,20,672,724,432,-292
2017,8,24,21,684,734,447,-287
2017,8,24,22,684,732,446,-286
2017,8,24,23,679,714,399,-315
2017,8,25,0,655,678,344,-334
2017,8,25,1,643,666,300,-366
2017,8,25,2,610,630,285,-345
2017,8,25,3,554,568,220,-348
2017,8,25,4,494,505,128,-377
2017,8,25,5,446,440,93,-347
2017,8,25,6,416,426,106,-320
2017,8,25,7,396,419,114,-305
2017,8,25,8,388,404,111,-293
2017,8,25,9,390,411,113,-298
2017,8,25,10,417,433,110,-323
2017,8,25,11,475,486,128,-358
2017,8,25,12,497,515,129,-386
2017,8,25,13,512,535,145,-390
2017,8,25,14,531,553,168,-385
2017,8,25,15,547,570,244,-326
2017,8,25,16,550,591,309,-282
2017,8,25,17,576,614,347,-267
2017,8,25,18,601,635,384,-251
2017,8,25,19,607,655,390,-265
2017,8,25,20,624,658,391,-267
2017,8,25,21,634,657,390,-267
2017,8,25,22,641,655,390,-265
2017,8,25,23,634,642,388,-254
2017,8,26,0,605,622,357,-265
2017,8,26,1,600,617,350,-267
2017,8,26,2,581,598,288,-310
2017,8,26,3,538,554,224,-330
2017,8,26,4,486,501,152,-349
2017,8,26,5,433,454,129,-325
2017,8,26,6,403,427,112,-315
2017,8,26,7,387,410,113,-297
2017,8,26,8,379,403,113,-290
2017,8,26,9,379,400,112,-288
2017,8,26,10,388,409,114,-295
2017,8,26,11,408,431,113,-318
2017,8,26,12,434,451,112,-339
2017,8,26,13,471,487,113,-374
2017,8,26,14,502,524,113,-411
2017,8,26,15,531,562,115,-447
2017,8,26,16,526,594,173,-421
2017,8,26,17,551,615,218,-397
2017,8,26,18,563,627,242,-385
2017,8,26,19,587,641,250,-391
2017,8,26,20,598,655,355,-300
2017,8,26,21,617,671,444,-227
2017,8,26,22,617,671,457,-214
2017,8,26,23,619,659,404,-255
2017,8,27,0,602,637,387,-250
2017,8,27,1,585,632,388,-244
2017,8,27,2,561,606,348,-258
2017,8,27,3,512,559,231,-328
2017,8,27,4,462,508,146,-362
2017,8,27,5,431,466,112,-354
2017,8,27,6,400,441,111,-330
2017,8,27,7,385,421,111,-310
2017,8,27,8,374,408,111,-297
2017,8,27,9,372,403,110,-293
2017,8,27,10,376,407,108,-299
2017,8,27,11,394,420,121,-299
2017,8,27,12,421,447,122,-325
2017,8,27,13,462,484,122,-362
2017,8,27,14,494,522,123,-399
2017,8,27,15,510,540,123,-417
2017,8,27,16,509,546,123,-423
2017,8,27,17,538,561,124,-437
2017,8,27,18,543,576,124,-452
2017,8,27,19,561,593,127,-466
2017,8,27,20,569,611,153,-458
2017,8,27,21,590,624,203,-421
2017,8,27,22,597,630,267,-363
2017,8,27,23,599,621,316,-305
2017,8,28,0,583,613,310,-303
2017,8,28,1,582,612,311,-301
2017,8,28,2,553,579,274,-305
2017,8,28,3,505,525,149,-376
2017,8,28,4,454,471,115,-356
2017,8,28,5,414,434,114,-320
2017,8,28,6,391,412,115,-297
2017,8,28,7,375,398,119,-279
2017,8,28,8,368,394,119,-275
2017,8,28,9,375,397,118,-279
2017,8,28,10,404,430,118,-312
2017,8,28,11,465,464,93,-371
2017,8,28,12,491,515,119,-396
2017,8,28,13,507,531,122,-409
2017,8,28,14,526,554,129,-425
2017,8,28,15,546,567,130,-437
2017,8,28,16,546,579,129,-450
2017,8,28,17,571,589,130,-459
2017,8,28,18,596,592,124,-468
2017,8,28,19,607,598,142,-456
2017,8,28,20,618,588,132,-456
2017,8,28,21,626,589,130,-459
2017,8,28,22,630,591,130,-461
2017,8,28,23,631,582,128,-454
2017,8,29,0,614,588,130,-458
2017,8,29,1,605,595,133,-462
2017,8,29,2,576,564,134,-430
2017,8,29,3,520,511,114,-397
2017,8,29,4,466,461,112,-349
2017,8,29,5,422,423,110,-313
2017,8,29,6,397,406,111,-295
2017,8,29,7,386,397,112,-285
2017,8,29,8,380,392,112,-280
2017,8,29,9,386,399,111,-288
2017,8,29,10,415,429,112,-317
2017,8,29,11,481,490,112,-378
2017,8,29,12,509,518,112,-406
2017,8,29,13,523,536,112,-424
2017,8,29,14,538,548,113,-435
2017,8,29,15,556,560,145,-415
2017,8,29,16,562,572,260,-312
2017,8,29,17,579,583,234,-349
2017,8,29,18,598,602,184,-418
2017,8,29,19,606,613,183,-430
2017,8,29,20,623,630,184,-446
2017,8,29,21,635,647,181,-466
2017,8,29,22,641,653,184,-469
2017,8,29,23,641,652,152,-500
2017,8,30,0,620,644,132,-512
2017,8,30,1,621,645,133,-512
2017,8,30,2,588,609,116,-493
2017,8,30,3,531,547,115,-432
2017,8,30,4,478,489,115,-374
2017,8,30,5,430,436,106,-330
2017,8,30,6,405,422,113,-309
2017,8,30,7,392,410,117,-293
2017,8,30,8,388,402,113,-289
2017,8,30,9,395,413,115,-298
2017,8,30,10,422,436,114,-322
2017,8,30,11,486,504,116,-388
2017,8,30,12,518,534,115,-419
2017,8,30,13,531,546,115,-431
2017,8,30,14,548,569,117,-452
2017,8,30,15,568,588,115,-473
2017,8,30,16,569,617,176,-441
2017,8,30,17,589,644,216,-428
2017,8,30,18,603,666,209,-457
2017,8,30,19,610,678,217,-461
2017,8,30,20,615,677,272,-405
2017,8,30,21,625,673,380,-293
2017,8,30,22,627,656,374,-282
2017,8,30,23,623,648,388,-260
2017,8,31,0,607,635,366,-269
2017,8,31,1,614,630,368,-262
2017,8,31,2,584,594,360,-234
2017,8,31,3,530,539,314,-225
2017,8,31,4,478,488,311,-177
2017,8,31,5,436,454,272,-182
2017,8,31,6,411,428,166,-262
2017,8,31,7,398,414,135,-279
2017,8,31,8,394,407,135,-272
2017,8,31,9,399,418,137,-281
2017,8,31,10,428,445,135,-310
2017,8,31,11,493,512,137,-375
2017,8,31,12,524,538,136,-402
2017,8,31,13,535,555,137,-418
2017,8,31,14,550,571,136,-435
2017,8,31,15,565,586,139,-447
2017,8,31,16,563,594,191,-403
2017,8,31,17,576,599,225,-374
2017,8,31,18,583,600,320,-280
2017,8,31,19,585,587,346,-241
2017,8,31,20,584,580,387,-193
2017,8,31,21,593,581,417,-164
2017,8,31,22,592,584,438,-146
2017,8,31,23,589,590,389,-201
2017,9,1,0,585,591,362,-229
2017,9,1,1,597,601,361,-240
2017,9,1,2,574,569,337,-232
2017,9,1,3,523,525,283,-242
2017,9,1,4,474,469,211,-258
2017,9,1,5,445,434,162,-272
2017,9,1,6,420,412,147,-265
2017,9,1,7,409,408,149,-259
2017,9,1,8,401,404,149,-255
2017,9,1,9,407,407,147,-260
2017,9,1,10,436,439,149,-290
2017,9,1,11,500,497,161,-336
2017,9,1,12,530,530,257,-273
2017,9,1,13,545,551,264,-287
2017,9,1,14,567,570,261,-309
2017,9,1,15,581,587,262,-325
2017,9,1,16,601,598,263,-335
2017,9,1,17,612,597,285,-312
2017,9,1,18,626,595,359,-236
2017,9,1,19,633,588,373,-215
2017,9,1,20,632,594,369,-225
2017,9,1,21,633,608,370,-238
2017,9,1,22,622,621,373,-248
2017,9,1,23,606,610,362,-248
2017,9,2,0,581,600,320,-280
2017,9,2,1,588,591,266,-325
2017,9,2,2,554,567,218,-349
2017,9,2,3,516,525,175,-350
2017,9,2,4,468,475,88,-387
2017,9,2,5,432,433,59,-374
2017,9,2,6,405,405,56,-349
2017,9,2,7,392,391,59,-332
2017,9,2,8,383,377,59,-318
2017,9,2,9,381,376,58,-318
2017,9,2,10,393,386,60,-326
2017,9,2,11,419,401,60,-341
2017,9,2,12,443,421,58,-363
2017,9,2,13,476,456,59,-397
2017,9,2,14,507,487,59,-428
2017,9,2,15,531,507,60,-447
2017,9,2,16,522,516,112,-404
2017,9,2,17,543,521,133,-388
2017,9,2,18,552,519,131,-388
2017,9,2,19,570,513,136,-377
2017,9,2,20,577,515,135,-380
2017,9,2,21,593,517,140,-377
2017,9,2,22,592,519,143,-376
2017,9,2,23,598,519,112,-407
2017,9,3,0,578,523,83,-440
2017,9,3,1,568,524,81,-443
2017,9,3,2,535,506,65,-441
2017,9,3,3,495,471,60,-411
2017,9,3,4,444,430,60,-370
2017,9,3,5,392,396,58,-338
2017,9,3,6,363,376,60,-316
2017,9,3,7,350,363,59,-304
2017,9,3,8,341,356,60,-296
2017,9,3,9,340,354,59,-295
2017,9,3,10,345,361,61,-300
2017,9,3,11,358,373,59,-314
2017,9,3,12,379,401,65,-336
2017,9,3,13,421,441,73,-368
2017,9,3,14,458,469,76,-393
2017,9,3,15,475,475,75,-400
2017,9,3,16,478,477,125,-352
2017,9,3,17,503,487,145,-342
2017,9,3,18,521,496,148,-348
2017,9,3,19,539,510,149,-361
2017,9,3,20,557,525,148,-377
2017,9,3,21,577,540,146,-394
2017,9,3,22,583,553,159,-394
2017,9,3,23,584,552,154,-398
2017,9,4,0,573,534,122,-412
2017,9,4,1,571,534,99,-435
2017,9,4,2,537,509,62,-447
2017,9,4,3,488,472,63,-409
2017,9,4,4,437,428,62,-366
2017,9,4,5,392,392,61,-331
2017,9,4,6,366,366,60,-306
2017,9,4,7,354,359,62,-297
2017,9,4,8,345,349,61,-288
2017,9,4,9,348,355,63,-292
2017,9,4,10,359,364,61,-303
2017,9,4,11,380,384,62,-322
2017,9,4,12,396,408,61,-347
2017,9,4,13,431,447,63,-384
2017,9,4,14,471,475,63,-412
2017,9,4,15,499,502,86,-416
2017,9,4,16,524,517,134,-383
2017,9,4,17,539,533,131,-402
2017,9,4,18,561,550,134,-416
2017,9,4,19,573,569,137,-432
2017,9,4,20,592,591,143,-448
2017,9,4,21,618,615,188,-427
2017,9,4,22,628,631,198,-433
2017,9,4,23,632,628,198,-430
2017,9,5,0,616,612,197,-415
2017,9,5,1,617,608,196,-412
2017,9,5,2,576,567,198,-369
2017,9,5,3,518,507,159,-348
2017,9,5,4,465,449,84,-365
2017,9,5,5,421,411,56,-355
2017,9,5,6,397,389,56,-333
2017,9,5,7,387,378,59,-319
2017,9,5,8,380,368,56,-312
2017,9,5,9,386,377,58,-319
2017,9,5,10,413,406,57,-349
2017,9,5,11,477,468,57,-411
2017,9,5,12,507,496,59,-437
2017,9,5,13,521,513,58,-455
2017,9,5,14,539,534,58,-476
2017,9,5,15,561,559,64,-495
2017,9,5,16,585,582,71,-511
2017,9,5,17,605,563,104,-459
2017,9,5,18,630,635,198,-437
2017,9,5,19,646,657,215,-442
2017,9,5,20,660,650,228,-422
2017,9,5,21,671,634,277,-357
2017,9,5,22,671,623,274,-349
2017,9,5,23,663,609,268,-341
2017,9,6,0,643,600,272,-328
2017,9,6,1,646,590,264,-326
2017,9,6,2,601,549,139,-410
2017,9,6,3,538,499,124,-375
2017,9,6,4,480,455,85,-370
2017,9,6,5,440,416,57,-359
2017,9,6,6,409,398,56,-342
2017,9,6,7,394,391,57,-334
2017,9,6,8,387,383,57,-326
2017,9,6,9,391,390,57,-333
2017,9,6,10,416,418,56,-362
2017,9,6,11,479,482,58,-424
2017,9,6,12,510,513,57,-456
2017,9,6,13,519,526,58,-468
2017,9,6,14,534,539,58,-481
2017,9,6,15,546,548,57,-491
2017,9,6,16,551,540,58,-482
2017,9,6,17,549,542,60,-482
2017,9,6,18,565,539,59,-480
2017,9,6,19,564,531,61,-470
2017,9,6,20,561,533,62,-471
2017,9,6,21,570,538,61,-477
2017,9,6,22,562,547,59,-488
2017,9,6,23,548,548,59,-489
2017,9,7,0,544,546,57,-489
2017,9,7,1,555,559,83,-476
2017,9,7,2,520,533,65,-468
2017,9,7,3,474,480,61,-419
2017,9,7,4,431,432,61,-371
2017,9,7,5,433,386,47,-339
2017,9,7,6,413,385,60,-325
2017,9,7,7,406,376,60,-316
2017,9,7,8,402,378,61,-317
2017,9,7,9,408,387,63,-324
2017,9,7,10,438,417,63,-354
2017,9,7,11,503,486,63,-423
2017,9,7,12,532,516,58,-458
2017,9,7,13,532,522,58,-464
2017,9,7,14,533,529,58,-471
2017,9,7,15,530,530,57,-473
2017,9,7,16,532,533,108,-425
2017,9,7,17,527,527,132,-395
2017,9,7,18,539,528,131,-397
2017,9,7,19,538,526,130,-396
2017,9,7,20,547,529,131,-398
2017,9,7,21,550,539,131,-408
2017,9,7,22,554,544,130,-414
2017,9,7,23,558,548,131,-417
2017,9,8,0,557,547,127,-420
2017,9,8,1,562,566,82,-484
2017,9,8,2,528,539,59,-480
2017,9,8,3,483,489,60,-429
2017,9,8,4,439,442,59,-383
2017,9,8,5,404,407,58,-349
2017,9,8,6,385,390,58,-332
2017,9,8,7,379,383,59,-324
2017,9,8,8,374,381,58,-323
2017,9,8,9,382,391,59,-332
2017,9,8,10,413,423,59,-364
2017,9,8,11,479,491,59,-432
2017,9,8,12,506,520,59,-461
2017,9,8,13,514,532,58,-474
2017,9,8,14,525,533,59,-474
2017,9,8,15,525,536,59,-477
2017,9,8,16,529,536,61,-475
2017,9,8,17,530,530,58,-472
2017,9,8,18,539,532,60,-472
2017,9,8,19,545,536,60,-476
2017,9,8,20,556,538,58,-480
2017,9,8,21,560,547,71,-476
2017,9,8,22,563,552,129,-423
2017,9,8,23,558,549,128,-421
2017,9,9,0,543,538,126,-412
2017,9,9,1,550,549,127,-422
2017,9,9,2,517,521,77,-444
2017,9,9,3,481,484,59,-425
2017,9,9,4,435,439,58,-381
2017,9,9,5,397,408,58,-350
2017,9,9,6,375,388,57,-331
2017,9,9,7,367,376,59,-317
2017,9,9,8,359,371,58,-313
2017,9,9,9,360,370,59,-311
2017,9,9,10,372,385,59,-326
2017,9,9,11,396,410,59,-351
2017,9,9,12,424,442,58,-384
2017,9,9,13,459,474,59,-415
2017,9,9,14,482,498,60,-438
2017,9,9,15,494,510,59,-451
2017,9,9,16,483,510,59,-451
2017,9,9,17,491,508,59,-449
2017,9,9,18,489,511,61,-450
2017,9,9,19,504,512,61,-451
2017,9,9,20,512,512,59,-453
2017,9,9,21,521,520,67,-453
2017,9,9,22,523,524,162,-362
2017,9,9,23,527,523,161,-362
2017,9,10,0,533,524,162,-362
2017,9,10,1,519,534,100,-434
2017,9,10,2,494,508,59,-449
2017,9,10,3,460,468,58,-410
2017,9,10,4,416,429,59,-370
2017,9,10,5,385,395,59,-336
2017,9,10,6,362,371,58,-313
2017,9,10,7,353,362,60,-302
2017,9,10,8,346,357,61,-296
2017,9,10,9,345,357,59,-298
2017,9,10,10,351,372,60,-312
2017,9,10,11,374,391,60,-331
2017,9,10,12,403,419,60,-359
2017,9,10,13,444,462,60,-402
2017,9,10,14,468,490,61,-429
2017,9,10,15,471,490,61,-429
2017,9,10,16,464,481,59,-422
2017,9,10,17,477,488,61,-427
2017,9,10,18,474,489,62,-427
2017,9,10,19,486,483,60,-423
2017,9,10,20,494,482,61,-421
2017,9,10,21,505,488,61,-427
2017,9,10,22,513,497,104,-393
2017,9,10,23,525,503,131,-372
2017,9,11,0,529,522,132,-390
2017,9,11,1,529,536,131,-405
2017,9,11,2,496,504,79,-425
2017,9,11,3,457,465,60,-405
2017,9,11,4,412,426,61,-365
2017,9,11,5,380,366,30,-336
2017,9,11,6,361,379,59,-320
2017,9,11,7,354,368,61,-307
2017,9,11,8,351,370,60,-310
2017,9,11,9,362,377,60,-317
2017,9,11,10,394,413,60,-354
2017,9,11,11,462,479,61,-418
2017,9,11,12,497,516,63,-453
2017,9,11,13,512,536,79,-457
2017,9,11,14,525,554,97,-457
2017,9,11,15,536,566,129,-437
2017,9,11,16,542,572,142,-430
2017,9,11,17,543,567,140,-427
2017,9,11,18,549,571,147,-424
2017,9,11,19,542,571,164,-407
2017,9,11,20,539,570,200,-370
2017,9,11,21,546,574,223,-351
2017,9,11,22,562,586,237,-349
2017,9,11,23,573,587,234,-353
2017,9,12,0,576,586,235,-351
2017,9,12,1,577,569,231,-338
2017,9,12,2,542,521,221,-300
2017,9,12,3,494,469,158,-311
2017,9,12,4,446,424,103,-321
2017,9,12,5,418,382,62,-320
2017,9,12,6,397,365,62,-303
2017,9,12,7,388,352,62,-290
2017,9,12,8,382,352,62,-290
2017,9,12,9,390,361,63,-298
2017,9,12,10,419,387,62,-325
2017,9,12,11,484,437,65,-372
2017,9,12,12,511,473,157,-316
2017,9,12,13,515,505,175,-330
2017,9,12,14,524,519,174,-345
2017,9,12,15,530,559,174,-385
2017,9,12,16,537,504,173,-331
2017,9,12,17,536,535,175,-360
2017,9,12,18,544,540,175,-365
2017,9,12,19,543,541,176,-365
2017,9,12,20,550,537,174,-363
2017,9,12,21,553,542,177,-365
2017,9,12,22,562,545,186,-359
2017,9,12,23,567,552,216,-336
2017,9,13,0,572,566,260,-306
2017,9,13,1,575,565,283,-282
2017,9,13,2,537,531,257,-274
2017,9,13,3,486,478,191,-287
2017,9,13,4,441,434,172,-262
2017,9,13,5,399,403,141,-262
2017,9,13,6,381,389,102,-287
2017,9,13,7,370,378,99,-279
2017,9,13,8,365,378,100,-278
2017,9,13,9,374,385,117,-268
2017,9,13,10,406,420,137,-283
2017,9,13,11,473,485,137,-348
2017,9,13,12,499,518,144,-374
2017,9,13,13,506,528,174,-354
2017,9,13,14,520,535,174,-361
2017,9,13,15,531,540,175,-365
2017,9,13,16,542,541,190,-351
2017,9,13,17,542,546,234,-312
2017,9,13,18,556,546,273,-273
2017,9,13,19,565,536,341,-195
2017,9,13,20,574,553,438,-115
2017,9,13,21,576,554,433,-121
2017,9,13,22,582,552,435,-117
2017,9,13,23,578,562,437,-125
2017,9,14,0,578,570,405,-165
2017,9,14,1,574,573,403,-170
2017,9,14,2,536,538,329,-209
2017,9,14,3,488,484,203,-281
2017,9,14,4,438,438,172,-266
2017,9,14,5,400,408,102,-306
2017,9,14,6,380,390,56,-334
2017,9,14,7,369,378,58,-320
2017,9,14,8,364,377,57,-320
2017,9,14,9,371,386,58,-328
2017,9,14,10,402,418,58,-360
2017,9,14,11,466,480,63,-417
2017,9,14,12,493,515,106,-409
2017,9,14,13,501,527,109,-418
2017,9,14,14,517,538,111,-427
2017,9,14,15,533,552,112,-440
2017,9,14,16,538,555,117,-438
2017,9,14,17,544,555,220,-335
2017,9,14,18,554,566,223,-343
2017,9,14,19,565,563,222,-341
2017,9,14,20,573,553,221,-332
2017,9,14,21,579,560,224,-336
2017,9,14,22,588,555,229,-326
2017,9,14,23,590,552,224,-328
2017,9,15,0,590,562,240,-322
2017,9,15,1,589,572,274,-298
2017,9,15,2,554,542,265,-277
2017,9,15,3,506,491,181,-310
2017,9,15,4,455,444,63,-381
2017,9,15,5,416,413,58,-355
2017,9,15,6,400,393,57,-336
2017,9,15,7,387,382,59,-323
2017,9,15,8,382,378,61,-317
2017,9,15,9,386,385,58,-327
2017,9,15,10,418,420,60,-360
2017,9,15,11,480,481,59,-422
2017,9,15,12,507,513,59,-454
2017,9,15,13,526,528,61,-467
2017,9,15,14,544,533,59,-474
2017,9,15,15,560,547,60,-487
2017,9,15,16,572,551,61,-490
2017,9,15,17,582,555,85,-470
2017,9,15,18,592,562,208,-354
2017,9,15,19,596,564,302,-262
2017,9,15,20,606,569,315,-254
2017,9,15,21,609,572,361,-211
2017,9,15,22,609,573,365,-208
2017,9,15,23,602,569,337,-232
2017,9,16,0,590,564,251,-313
2017,9,16,1,588,562,147,-415
2017,9,16,2,552,533,109,-424
2017,9,16,3,508,493,78,-415
2017,9,16,4,463,454,59,-395
2017,9,16,5,419,415,59,-356
2017,9,16,6,395,392,58,-334
2017,9,16,7,379,378,59,-319
2017,9,16,8,372,372,58,-314
2017,9,16,9,371,372,58,-314
2017,9,16,10,383,388,60,-328
2017,9,16,11,405,408,59,-349
2017,9,16,12,434,439,59,-380
2017,9,16,13,468,471,60,-411
2017,9,16,14,498,496,87,-409
2017,9,16,15,528,513,102,-411
2017,9,16,16,530,529,119,-410
2017,9,16,17,544,543,124,-419
2017,9,16,18,560,551,270,-281
2017,9,16,19,569,570,373,-197
2017,9,16,20,577,584,372,-212
2017,9,16,21,588,599,378,-221
2017,9,16,22,589,602,369,-233
2017,9,16,23,582,593,371,-222
2017,9,17,0,587,580,353,-227
2017,9,17,1,575,573,351,-222
2017,9,17,2,540,534,197,-337
2017,9,17,3,499,493,87,-406
2017,9,17,4,452,449,63,-386
2017,9,17,5,421,412,65,-347
2017,9,17,6,394,387,64,-323
2017,9,17,7,380,372,66,-306
2017,9,17,8,373,364,62,-302
2017,9,17,9,369,364,64,-300
2017,9,17,10,380,372,64,-308
2017,9,17,11,397,386,62,-324
2017,9,17,12,424,410,64,-346
2017,9,17,13,464,453,65,-388
2017,9,17,14,498,478,70,-408
2017,9,17,15,517,498,89,-409
2017,9,17,16,528,514,103,-411
2017,9,17,17,557,535,125,-410
2017,9,17,18,576,557,254,-303
2017,9,17,19,585,571,291,-280
2017,9,17,20,603,596,370,-226
2017,9,17,21,618,605,406,-199
2017,9,17,22,625,620,463,-157
2017,9,17,23,622,614,456,-158
2017,9,18,0,628,597,325,-272
2017,9,18,1,617,594,264,-330
2017,9,18,2,571,553,171,-382
2017,9,18,3,520,498,92,-406
2017,9,18,4,469,449,67,-382
2017,9,18,5,420,415,62,-353
2017,9,18,6,397,390,61,-329
2017,9,18,7,381,378,61,-317
2017,9,18,8,374,377,63,-314
2017,9,18,9,380,384,64,-320
2017,9,18,10,409,437,85,-352
2017,9,18,11,469,478,84,-394
2017,9,18,12,502,510,84,-426
2017,9,18,13,525,512,69,-443
2017,9,18,14,542,541,71,-470
2017,9,18,15,574,555,70,-485
2017,9,18,16,594,577,146,-431
2017,9,18,17,610,598,227,-371
2017,9,18,18,643,614,255,-359
2017,9,18,19,658,631,299,-332
2017,9,18,20,672,647,364,-283
2017,9,18,21,681,660,372,-288
2017,9,18,22,682,665,338,-327
2017,9,18,23,682,651,292,-359
2017,9,19,0,673,640,264,-376
2017,9,19,1,660,634,189,-445
2017,9,19,2,614,587,179,-408
2017,9,19,3,547,524,94,-430
2017,9,19,4,491,471,61,-410
2017,9,19,5,439,428,60,-368
2017,9,19,6,415,404,60,-344
2017,9,19,7,397,391,61,-330
2017,9,19,8,389,385,60,-325
2017,9,19,9,395,390,60,-330
2017,9,19,10,422,419,60,-359
2017,9,19,11,482,481,68,-413
2017,9,19,12,514,515,68,-447
2017,9,19,13,535,522,70,-452
2017,9,19,14,552,534,65,-469
2017,9,19,15,583,555,65,-490
2017,9,19,16,604,573,99,-474
2017,9,19,17,617,592,144,-448
2017,9,19,18,655,610,155,-455
2017,9,19,19,673,630,213,-417
2017,9,19,20,685,644,241,-403
2017,9,19,21,692,666,339,-327
2017,9,19,22,688,664,341,-323
2017,9,19,23,683,652,357,-295
2017,9,20,0,677,649,378,-271
2017,9,20,1,662,643,320,-323
2017,9,20,2,615,600,205,-395
2017,9,20,3,547,538,60,-478
2017,9,20,4,493,479,59,-420
2017,9,20,5,443,443,56,-387
2017,9,20,6,418,423,59,-364
2017,9,20,7,402,405,58,-347
2017,9,20,8,398,396,58,-338
2017,9,20,9,402,399,58,-341
2017,9,20,10,436,427,58,-369
2017,9,20,11,496,492,57,-435
2017,9,20,12,529,519,59,-460
2017,9,20,13,545,529,58,-471
2017,9,20,14,569,548,77,-471
2017,9,20,15,594,575,82,-493
2017,9,20,16,613,597,149,-448
2017,9,20,17,638,627,175,-452
2017,9,20,18,655,655,203,-452
2017,9,20,19,669,676,314,-362
2017,9,20,20,682,690,329,-361
2017,9,20,21,695,703,385,-318
2017,9,20,22,696,707,432,-275
2017,9,20,23,689,692,326,-366
2017,9,21,0,680,675,306,-369
2017,9,21,1,667,660,223,-437
2017,9,21,2,623,609,197,-412
2017,9,21,3,556,546,103,-443
2017,9,21,4,501,482,69,-413
2017,9,21,5,452,440,69,-371
2017,9,21,6,425,416,61,-355
2017,9,21,7,407,402,65,-337
2017,9,21,8,399,392,62,-330
2017,9,21,9,402,400,66,-334
2017,9,21,10,431,430,64,-366
2017,9,21,11,488,496,64,-432
2017,9,21,12,521,524,64,-460
2017,9,21,13,538,535,65,-470
2017,9,21,14,555,557,67,-490
2017,9,21,15,581,580,95,-485
2017,9,21,16,595,600,133,-467
2017,9,21,17,616,630,272,-358
2017,9,21,18,633,651,298,-353
2017,9,21,19,648,663,320,-343
2017,9,21,20,667,665,316,-349
2017,9,21,21,684,679,424,-255
2017,9,21,22,687,668,357,-311
2017,9,21,23,682,662,396,-266
2017,9,22,0,674,650,307,-343
2017,9,22,1,661,641,234,-407
2017,9,22,2,621,598,186,-412
2017,9,22,3,552,540,95,-445
2017,9,22,4,498,487,63,-424
2017,9,22,5,460,445,62,-383
2017,9,22,6,432,419,62,-357
2017,9,22,7,413,405,62,-343
2017,9,22,8,404,397,61,-336
2017,9,22,9,409,401,59,-342
2017,9,22,10,437,429,61,-368
2017,9,22,11,493,491,59,-432
2017,9,22,12,523,518,60,-458
2017,9,22,13,538,532,59,-473
2017,9,22,14,561,546,60,-486
2017,9,22,15,585,569,76,-493
2017,9,22,16,601,586,127,-459
2017,9,22,17,621,621,204,-417
2017,9,22,18,641,647,253,-394
2017,9,22,19,655,675,317,-358
2017,9,22,20,666,694,448,-246
2017,9,22,21,675,687,419,-268
2017,9,22,22,672,691,458,-233
2017,9,22,23,660,659,434,-225
2017,9,23,0,646,641,394,-247
2017,9,23,1,636,620,271,-349
2017,9,23,2,596,585,198,-387
2017,9,23,3,541,543,106,-437
2017,9,23,4,491,490,66,-424
2017,9,23,5,447,446,63,-383
2017,9,23,6,418,421,61,-360
2017,9,23,7,398,406,63,-343
2017,9,23,8,387,395,61,-334
2017,9,23,9,385,400,63,-337
2017,9,23,10,396,405,59,-346
2017,9,23,11,412,427,59,-368
2017,9,23,12,440,453,59,-394
2017,9,23,13,475,488,59,-429
2017,9,23,14,502,520,60,-460
2017,9,23,15,530,551,61,-490
2017,9,23,16,549,578,75,-503
2017,9,23,17,575,604,158,-446
2017,9,23,18,591,626,218,-408
2017,9,23,19,603,640,244,-396
2017,9,23,20,621,648,419,-229
2017,9,23,21,636,650,435,-215
2017,9,23,22,636,633,446,-187
2017,9,23,23,629,610,358,-252
2017,9,24,0,628,606,303,-303
2017,9,24,1,610,597,283,-314
2017,9,24,2,565,566,163,-403
2017,9,24,3,516,524,152,-372
2017,9,24,4,470,474,79,-395
2017,9,24,5,434,434,65,-369
2017,9,24,6,403,408,65,-343
2017,9,24,7,384,389,65,-324
2017,9,24,8,375,381,66,-315
2017,9,24,9,371,377,65,-312
2017,9,24,10,376,385,67,-318
2017,9,24,11,386,398,60,-338
2017,9,24,12,413,424,60,-364
2017,9,24,13,455,462,60,-402
2017,9,24,14,480,493,60,-433
2017,9,24,15,498,512,60,-452
2017,9,24,16,513,527,63,-464
2017,9,24,17,543,557,61,-496
2017,9,24,18,566,575,112,-463
2017,9,24,19,580,604,209,-395
2017,9,24,20,601,623,239,-384
2017,9,24,21,618,648,418,-230
2017,9,24,22,627,659,428,-231
2017,9,24,23,623,642,343,-299
2017,9,25,0,624,633,284,-349
2017,9,25,1,610,621,264,-357
2017,9,25,2,561,571,144,-427
2017,9,25,3,508,514,97,-417
2017,9,25,4,459,463,58,-405
2017,9,25,5,418,422,59,-364
2017,9,25,6,392,401,57,-344
2017,9,25,7,376,389,60,-329
2017,9,25,8,370,379,59,-320
2017,9,25,9,377,386,59,-327
2017,9,25,10,406,415,58,-357
2017,9,25,11,463,482,59,-423
2017,9,25,12,496,511,60,-451
2017,9,25,13,520,525,59,-466
2017,9,25,14,538,547,60,-487
2017,9,25,15,572,564,64,-500
2017,9,25,16,584,581,80,-501
2017,9,25,17,611,603,182,-421
2017,9,25,18,634,623,252,-371
2017,9,25,19,648,639,255,-384
2017,9,25,20,663,662,350,-312
2017,9,25,21,674,685,442,-243
2017,9,25,22,674,688,407,-281
2017,9,25,23,669,681,365,-316
2017,9,26,0,664,672,306,-366
2017,9,26,1,648,652,266,-386
2017,9,26,2,602,591,237,-354
2017,9,26,3,537,529,157,-372
2017,9,26,4,481,472,67,-405
2017,9,26,5,439,432,61,-371
2017,9,26,6,412,407,63,-344
2017,9,26,7,394,395,64,-331
2017,9,26,8,387,387,64,-323
2017,9,26,9,392,388,64,-324
2017,9,26,10,421,421,64,-357
2017,9,26,11,477,483,75,-408
2017,9,26,12,511,516,84,-432
2017,9,26,13,531,521,87,-434
2017,9,26,14,549,536,90,-446
2017,9,26,15,581,528,94,-434
2017,9,26,16,601,575,92,-483
2017,9,26,17,626,597,108,-489
2017,9,26,18,653,626,247,-379
2017,9,26,19,669,649,237,-412
2017,9,26,20,686,665,390,-275
2017,9,26,21,700,681,426,-255
2017,9,26,22,703,685,426,-259
2017,9,26,23,692,669,423,-246
2017,9,27,0,688,658,341,-317
2017,9,27,1,672,641,267,-374
2017,9,27,2,624,590,228,-362
2017,9,27,3,552,529,114,-415
2017,9,27,4,495,473,66,-407
2017,9,27,5,446,435,63,-372
2017,9,27,6,421,420,61,-359
2017,9,27,7,405,399,59,-340
2017,9,27,8,400,394,61,-333
2017,9,27,9,406,396,59,-337
2017,9,27,10,437,426,60,-366
2017,9,27,11,499,492,59,-433
2017,9,27,12,533,526,61,-465
2017,9,27,13,549,531,60,-471
2017,9,27,14,570,550,61,-489
2017,9,27,15,597,572,65,-507
2017,9,27,16,617,599,157,-442
2017,9,27,17,642,628,264,-364
2017,9,27,18,666,661,272,-389
2017,9,27,19,687,682,271,-411
2017,9,27,20,703,699,273,-426
2017,9,27,21,717,711,272,-439
2017,9,27,22,717,709,307,-402
2017,9,27,23,712,698,361,-337
2017,9,28,0,707,687,362,-325
2017,9,28,1,693,675,288,-387
2017,9,28,2,646,619,262,-357
2017,9,28,3,576,558,128,-430
2017,9,28,4,519,499,81,-418
2017,9,28,5,463,452,80,-372
2017,9,28,6,434,427,82,-345
2017,9,28,7,413,413,82,-331
2017,9,28,8,406,403,83,-320
2017,9,28,9,408,406,84,-322
2017,9,28,10,437,433,84,-349
2017,9,28,11,496,497,94,-403
2017,9,28,12,530,524,110,-414
2017,9,28,13,544,537,110,-427
2017,9,28,14,561,558,112,-446
2017,9,28,15,580,581,117,-464
2017,9,28,16,597,607,226,-381
2017,9,28,17,614,628,276,-352
2017,9,28,18,630,661,322,-339
2017,9,28,19,638,688,324,-364
2017,9,28,20,649,695,343,-352
2017,9,28,21,660,711,420,-291
2017,9,28,22,655,715,420,-295
2017,9,28,23,645,689,356,-333
2017,9,29,0,643,676,322,-354
2017,9,29,1,635,670,321,-349
2017,9,29,2,591,621,318,-303
2017,9,29,3,530,562,255,-307
2017,9,29,4,476,506,177,-329
2017,9,29,5,446,459,124,-335
2017,9,29,6,420,434,74,-360
2017,9,29,7,401,420,69,-351
2017,9,29,8,393,409,67,-342
2017,9,29,9,398,416,69,-347
2017,9,29,10,424,442,67,-375
2017,9,29,11,481,505,69,-436
2017,9,29,12,512,529,73,-456
2017,9,29,13,522,544,69,-475
2017,9,29,14,535,558,71,-487
2017,9,29,15,547,577,88,-489
2017,9,29,16,550,589,111,-478
2017,9,29,17,558,597,96,-501
2017,9,29,18,571,612,152,-460
2017,9,29,19,571,632,224,-408
2017,9,29,20,572,626,236,-390
2017,9,29,21,580,624,285,-339
2017,9,29,22,570,613,300,-313
2017,9,29,23,556,599,294,-305
2017,9,30,0,553,596,261,-335
2017,9,30,1,548,585,177,-408
2017,9,30,2,512,552,96,-456
2017,9,30,3,472,506,79,-427
2017,9,30,4,429,462,71,-391
2017,9,30,5,409,417,69,-348
2017,9,30,6,384,396,69,-327
2017,9,30,7,369,381,71,-310
2017,9,30,8,362,372,70,-302
2017,9,30,9,362,376,71,-305
2017,9,30,10,371,382,70,-312
2017,9,30,11,388,410,65,-345
2017,9,30,12,412,436,62,-374
2017,9,30,13,448,471,62,-409
2017,9,30,14,473,500,64,-436
2017,9,30,15,489,512,64,-448
2017,9,30,16,489,521,65,-456
2017,9,30,17,498,527,68,-459
2017,9,30,18,509,530,68,-462
2017,9,30,19,521,539,68,-471
2017,9,30,20,528,549,69,-480
2017,9,30,21,535,556,101,-455
2017,9,30,22,538,560,108,-452
2017,9,30,23,535,542,97,-445
2017,10,1,0,541,546,98,-448
2017,10,1,1,522,534,95,-439
2017,10,1,2,493,506,96,-410
2017,10,1,3,455,491,93,-398
2017,10,1,4,417,432,63,-369
2017,10,1,5,389,397,61,-336
2017,10,1,6,365,376,61,-315
2017,10,1,7,354,370,63,-307
2017,10,1,8,350,365,61,-304
2017,10,1,9,348,368,63,-305
2017,10,1,10,357,378,62,-316
2017,10,1,11,377,403,63,-340
2017,10,1,12,411,434,61,-373
2017,10,1,13,452,481,62,-419
2017,10,1,14,479,500,64,-436
2017,10,1,15,478,494,64,-430
2017,10,1,16,465,487,63,-424
2017,10,1,17,472,484,64,-420
2017,10,1,18,466,488,65,-423
2017,10,1,19,469,485,64,-421
2017,10,1,20,475,484,62,-422
2017,10,1,21,482,493,64,-429
2017,10,1,22,489,500,63,-437
2017,10,1,23,497,481,61,-420
2017,10,2,0,524,513,62,-451
2017,10,2,1,518,519,60,-459
2017,10,2,2,484,490,59,-431
2017,10,2,3,442,458,60,-398
2017,10,2,4,405,416,59,-357
2017,10,2,5,390,398,59,-339
2017,10,2,6,377,384,58,-326
2017,10,2,7,375,382,60,-322
2017,10,2,8,377,384,59,-325
2017,10,2,9,390,397,60,-337
2017,10,2,10,427,441,59,-382
2017,10,2,11,504,513,59,-454
2017,10,2,12,545,555,91,-464
2017,10,2,13,553,561,100,-461
2017,10,2,14,554,557,101,-456
2017,10,2,15,546,553,94,-459
2017,10,2,16,529,541,91,-450
2017,10,2,17,521,540,93,-447
2017,10,2,18,515,537,93,-444
2017,10,2,19,511,537,108,-429
2017,10,2,20,511,537,106,-431
2017,10,2,21,513,543,123,-420
2017,10,2,22,515,554,139,-415
2017,10,2,23,528,561,202,-359
2017,10,3,0,557,574,258,-316
2017,10,3,1,546,568,230,-338
2017,10,3,2,508,536,195,-341
2017,10,3,3,464,485,185,-300
2017,10,3,4,420,441,128,-313
2017,10,3,5,392,415,69,-346
2017,10,3,6,376,401,62,-339
2017,10,3,7,368,394,65,-329
2017,10,3,8,367,390,64,-326
2017,10,3,9,375,402,64,-338
2017,10,3,10,409,446,64,-382
2017,10,3,11,479,510,63,-447
2017,10,3,12,517,549,65,-484
2017,10,3,13,520,548,66,-482
2017,10,3,14,525,553,71,-482
2017,10,3,15,522,547,66,-481
2017,10,3,16,519,546,68,-478
2017,10,3,17,515,542,68,-474
2017,10,3,18,515,544,128,-416
2017,10,3,19,516,546,138,-408
2017,10,3,20,526,547,137,-410
2017,10,3,21,531,557,137,-420
2017,10,3,22,528,567,135,-432
2017,10,3,23,532,567,192,-375
2017,10,4,0,556,583,203,-380
2017,10,4,1,546,578,150,-428
2017,10,4,2,506,536,112,-424
2017,10,4,3,460,488,65,-423
2017,10,4,4,417,446,61,-385
2017,10,4,5,396,374,22,-352
2017,10,4,6,379,403,61,-342
2017,10,4,7,371,390,60,-330
2017,10,4,8,371,395,62,-333
2017,10,4,9,379,404,60,-344
2017,10,4,10,411,439,61,-378
2017,10,4,11,482,513,69,-444
2017,10,4,12,518,550,85,-465
2017,10,4,13,522,553,85,-468
2017,10,4,14,525,552,74,-478
2017,10,4,15,523,546,66,-480
2017,10,4,16,519,547,72,-475
2017,10,4,17,515,543,66,-477
2017,10,4,18,516,550,68,-482
2017,10,4,19,525,554,66,-488
2017,10,4,20,532,564,77,-487
2017,10,4,21,542,576,92,-484
2017,10,4,22,541,585,124,-461
2017,10,4,23,545,586,182,-404
2017,10,5,0,561,590,241,-349
2017,10,5,1,555,583,168,-415
2017,10,5,2,519,543,115,-428
2017,10,5,3,473,490,80,-410
2017,10,5,4,427,447,64,-383
2017,10,5,5,401,408,62,-346
2017,10,5,6,383,393,63,-330
2017,10,5,7,375,389,66,-323
2017,10,5,8,375,384,64,-320
2017,10,5,9,383,399,65,-334
2017,10,5,10,417,429,61,-368
2017,10,5,11,489,506,65,-441
2017,10,5,12,524,541,65,-476
2017,10,5,13,526,547,66,-481
2017,10,5,14,530,550,65,-485
2017,10,5,15,528,545,67,-478
2017,10,5,16,526,546,69,-477
2017,10,5,17,523,541,68,-473
2017,10,5,18,532,552,69,-483
2017,10,5,19,537,559,68,-491
2017,10,5,20,545,572,71,-501
2017,10,5,21,554,581,115,-466
2017,10,5,22,559,589,162,-427
2017,10,5,23,566,586,115,-471
2017,10,6,0,580,594,144,-450
2017,10,6,1,573,584,154,-430
2017,10,6,2,536,543,145,-398
2017,10,6,3,487,493,110,-383
2017,10,6,4,438,446,71,-375
2017,10,6,5,399,412,58,-354
2017,10,6,6,381,391,57,-334
2017,10,6,7,369,392,64,-328
2017,10,6,8,368,386,63,-323
2017,10,6,9,375,399,64,-335
2017,10,6,10,407,432,67,-365
2017,10,6,11,470,501,94,-407
2017,10,6,12,501,539,100,-439
2017,10,6,13,508,541,97,-444
2017,10,6,14,521,545,99,-446
2017,10,6,15,526,546,99,-447
2017,10,6,16,531,550,100,-450
2017,10,6,17,536,552,101,-451
2017,10,6,18,547,559,99,-460
2017,10,6,19,553,564,100,-464
2017,10,6,20,564,577,127,-450
2017,10,6,21,574,585,225,-360
2017,10,6,22,580,581,257,-324
2017,10,6,23,577,569,253,-316
2017,10,7,0,577,563,203,-360
2017,10,7,1,571,553,151,-402
2017,10,7,2,535,526,137,-389
2017,10,7,3,493,491,128,-363
2017,10,7,4,448,445,79,-366
2017,10,7,5,406,413,58,-355
2017,10,7,6,383,389,58,-331
2017,10,7,7,369,376,59,-317
2017,10,7,8,359,373,60,-313
2017,10,7,9,360,371,59,-312
2017,10,7,10,371,384,59,-325
2017,10,7,11,393,412,59,-353
2017,10,7,12,423,448,59,-389
2017,10,7,13,457,482,65,-417
2017,10,7,14,486,515,87,-428
2017,10,7,15,503,529,112,-417
2017,10,7,16,508,541,137,-404
2017,10,7,17,506,540,176,-364
2017,10,7,18,507,546,221,-325
2017,10,7,19,508,549,242,-307
2017,10,7,20,516,550,234,-316
2017,10,7,21,530,564,202,-362
2017,10,7,22,534,570,201,-369
2017,10,7,23,533,569,199,-370
2017,10,8,0,552,584,227,-357
2017,10,8,1,541,572,242,-330
2017,10,8,2,514,546,164,-382
2017,10,8,3,481,514,108,-406
2017,10,8,4,439,474,73,-401
2017,10,8,5,411,440,61,-379
2017,10,8,6,389,407,60,-347
2017,10,8,7,377,396,63,-333
2017,10,8,8,373,384,61,-323
2017,10,8,9,372,384,63,-321
2017,10,8,10,381,394,63,-331
2017,10,8,11,403,409,61,-348
2017,10,8,12,433,442,63,-379
2017,10,8,13,478,487,61,-426
2017,10,8,14,514,522,63,-459
2017,10,8,15,532,533,61,-472
2017,10,8,16,549,539,63,-476
2017,10,8,17,556,549,107,-442
2017,10,8,18,566,555,145,-410
2017,10,8,19,564,552,144,-408
2017,10,8,20,566,549,145,-404
2017,10,8,21,573,562,195,-367
2017,10,8,22,580,576,237,-339
2017,10,8,23,568,584,287,-297
2017,10,9,0,589,578,287,-291
2017,10,9,1,581,566,287,-279
2017,10,9,2,550,535,286,-249
2017,10,9,3,508,496,242,-254
2017,10,9,4,466,454,158,-296
2017,10,9,5,437,433,144,-289
2017,10,9,6,417,417,141,-276
2017,10,9,7,410,407,140,-267
2017,10,9,8,406,406,143,-263
2017,10,9,9,414,410,140,-270
2017,10,9,10,450,447,145,-302
2017,10,9,11,518,502,163,-339
2017,10,9,12,562,541,211,-330
2017,10,9,13,580,559,205,-354
2017,10,9,14,601,570,198,-372
2017,10,9,15,629,614,266,-348
2017,10,9,16,658,636,268,-368
2017,10,9,17,670,647,271,-376
2017,10,9,18,689,661,268,-393
2017,10,9,19,691,675,300,-375
2017,10,9,20,683,680,326,-354
2017,10,9,21,686,673,317,-356
2017,10,9,22,681,667,313,-354
2017,10,9,23,678,673,314,-359
2017,10,10,0,676,686,323,-363
2017,10,10,1,651,683,337,-346
2017,10,10,2,608,633,336,-297
2017,10,10,3,550,577,274,-303
2017,10,10,4,497,529,206,-323
2017,10,10,5,484,479,155,-324
2017,10,10,6,463,452,140,-312
2017,10,10,7,449,433,140,-293
2017,10,10,8,414,421,139,-282
2017,10,10,9,447,429,140,-289
2017,10,10,10,481,458,159,-299
2017,10,10,11,547,525,198,-327
2017,10,10,12,585,562,134,-428
2017,10,10,13,605,573,127,-446
2017,10,10,14,619,589,186,-403
2017,10,10,15,652,619,205,-414
2017,10,10,16,679,646,210,-436
2017,10,10,17,691,696,232,-464
2017,10,10,18,714,695,231,-464
2017,10,10,19,708,681,233,-448
2017,10,10,20,705,684,231,-453
2017,10,10,21,710,701,233,-468
2017,10,10,22,707,710,253,-457
2017,10,10,23,702,700,302,-398
2017,10,11,0,702,709,327,-382
2017,10,11,1,671,683,259,-424
2017,10,11,2,626,634,231,-403
2017,10,11,3,562,574,214,-360
2017,10,11,4,509,522,163,-359
2017,10,11,5,484,476,159,-317
2017,10,11,6,457,447,127,-320
2017,10,11,7,438,430,71,-359
2017,10,11,8,431,423,65,-358
2017,10,11,9,434,429,65,-364
2017,10,11,10,466,462,65,-397
2017,10,11,11,531,527,67,-460
2017,10,11,12,569,559,77,-482
2017,10,11,13,582,569,92,-477
2017,10,11,14,601,585,102,-483
2017,10,11,15,628,607,183,-424
2017,10,11,16,649,635,205,-430
2017,10,11,17,664,665,208,-457
2017,10,11,18,688,695,246,-449
2017,10,11,19,701,716,325,-391
2017,10,11,20,704,725,347,-378
2017,10,11,21,712,719,330,-389
2017,10,11,22,707,715,331,-384
2017,10,11,23,699,695,330,-365
2017,10,12,0,697,691,315,-376
2017,10,12,1,671,677,238,-439
2017,10,12,2,625,628,235,-393
2017,10,12,3,560,564,201,-363
2017,10,12,4,504,506,166,-340
2017,10,12,5,455,455,162,-293
2017,10,12,6,425,430,125,-305
2017,10,12,7,402,414,111,-303
2017,10,12,8,393,403,113,-290
2017,10,12,9,394,410,115,-295
2017,10,12,10,422,444,115,-329
2017,10,12,11,481,510,156,-354
2017,10,12,12,514,545,178,-367
2017,10,12,13,524,551,182,-369
2017,10,12,14,534,563,185,-378
2017,10,12,15,552,578,186,-392
2017,10,12,16,561,596,215,-381
2017,10,12,17,578,624,258,-366
2017,10,12,18,596,651,256,-395
2017,10,12,19,605,667,255,-412
2017,10,12,20,618,681,256,-425
2017,10,12,21,628,680,334,-346
2017,10,12,22,632,671,292,-379
2017,10,12,23,624,653,289,-364
2017,10,13,0,632,665,288,-377
2017,10,13,1,614,655,288,-367
2017,10,13,2,575,609,215,-394
2017,10,13,3,517,553,138,-415
2017,10,13,4,464,500,122,-378
2017,10,13,5,425,455,99,-356
2017,10,13,6,403,432,100,-332
2017,10,13,7,386,416,106,-310
2017,10,13,8,380,407,99,-308
2017,10,13,9,386,412,99,-313
2017,10,13,10,412,439,115,-324
2017,10,13,11,471,500,141,-359
2017,10,13,12,506,533,159,-374
2017,10,13,13,518,546,163,-383
2017,10,13,14,528,558,165,-393
2017,10,13,15,539,575,165,-410
2017,10,13,16,538,578,162,-416
2017,10,13,17,540,588,138,-450
2017,10,13,18,548,596,169,-427
2017,10,13,19,549,608,193,-415
2017,10,13,20,550,608,202,-406
2017,10,13,21,551,608,261,-347
2017,10,13,22,543,600,296,-304
2017,10,13,23,529,592,295,-297
2017,10,14,0,542,595,295,-300
2017,10,14,1,533,580,223,-357
2017,10,14,2,501,551,200,-351
2017,10,14,3,466,516,201,-315
2017,10,14,4,426,471,201,-270
2017,10,14,5,405,435,192,-243
2017,10,14,6,383,409,142,-267
2017,10,14,7,364,393,134,-259
2017,10,14,8,357,385,124,-261
2017,10,14,9,357,384,99,-285
2017,10,14,10,371,398,102,-296
2017,10,14,11,389,424,100,-324
2017,10,14,12,420,457,118,-339
2017,10,14,13,455,492,134,-358
2017,10,14,14,482,514,134,-380
2017,10,14,15,497,535,136,-399
2017,10,14,16,501,547,135,-412
2017,10,14,17,505,568,173,-395
2017,10,14,18,519,586,157,-429
2017,10,14,19,527,601,131,-470
2017,10,14,20,533,618,201,-417
2017,10,14,21,545,621,304,-317
2017,10,14,22,555,623,339,-284
2017,10,14,23,558,607,313,-294
2017,10,15,0,567,610,265,-345
2017,10,15,1,542,589,231,-358
2017,10,15,2,514,555,169,-386
2017,10,15,3,472,508,109,-399
2017,10,15,4,428,466,82,-384
2017,10,15,5,406,425,68,-357
2017,10,15,6,379,402,69,-333
2017,10,15,7,362,385,65,-320
2017,10,15,8,353,378,68,-310
2017,10,15,9,349,375,68,-307
2017,10,15,10,358,381,68,-313
2017,10,15,11,372,398,68,-330
2017,10,15,12,404,426,76,-350
2017,10,15,13,446,469,78,-391
2017,10,15,14,473,494,77,-417
2017,10,15,15,483,508,77,-431
2017,10,15,16,491,526,77,-449
2017,10,15,17,511,545,76,-469
2017,10,15,18,524,564,102,-462
2017,10,15,19,535,573,146,-427
2017,10,15,20,543,588,176,-412
2017,10,15,21,556,588,194,-394
2017,10,15,22,564,597,214,-383
2017,10,15,23,569,593,265,-328
2017,10,16,0,578,605,266,-339
2017,10,16,1,557,586,217,-369
2017,10,16,2,520,544,200,-344
2017,10,16,3,470,500,200,-300
2017,10,16,4,423,456,201,-255
2017,10,16,5,396,419,194,-225
2017,10,16,6,371,400,191,-209
2017,10,16,7,358,389,189,-200
2017,10,16,8,356,384,186,-198
2017,10,16,9,370,388,155,-233
2017,10,16,10,405,417,141,-276
2017,10,16,11,474,478,142,-336
2017,10,16,12,514,509,140,-369
2017,10,16,13,523,521,139,-382
2017,10,16,14,532,533,140,-393
2017,10,16,15,542,544,141,-403
2017,10,16,16,544,542,141,-401
2017,10,16,17,541,539,141,-398
2017,10,16,18,537,537,144,-393
2017,10,16,19,535,529,140,-389
2017,10,16,20,532,511,127,-384
2017,10,16,21,538,532,142,-390
2017,10,16,22,554,541,141,-400
2017,10,16,23,576,562,141,-421
2017,10,17,0,601,588,141,-447
2017,10,17,1,592,580,141,-439
2017,10,17,2,561,550,135,-415
2017,10,17,3,523,505,95,-410
2017,10,17,4,479,466,78,-388
2017,10,17,5,444,438,66,-372
2017,10,17,6,433,429,63,-366
2017,10,17,7,429,428,65,-363
2017,10,17,8,433,433,64,-369
2017,10,17,9,455,452,84,-368
2017,10,17,10,500,496,134,-362
2017,10,17,11,579,578,164,-414
2017,10,17,12,621,627,219,-408
2017,10,17,13,614,634,214,-420
2017,10,17,14,598,624,214,-410
2017,10,17,15,574,599,169,-430
2017,10,17,16,555,573,102,-471
2017,10,17,17,535,556,102,-454
2017,10,17,18,523,542,102,-440
2017,10,17,19,516,536,93,-443
2017,10,17,20,511,529,91,-438
2017,10,17,21,516,539,101,-438
2017,10,17,22,527,548,155,-393
2017,10,17,23,547,566,154,-412
2017,10,18,0,575,600,155,-445
2017,10,18,1,572,588,155,-433
2017,10,18,2,542,555,106,-449
2017,10,18,3,506,511,66,-445
2017,10,18,4,467,472,60,-412
2017,10,18,5,435,452,60,-392
2017,10,18,6,427,437,60,-377
2017,10,18,7,424,436,61,-375
2017,10,18,8,429,447,60,-387
2017,10,18,9,451,465,62,-403
2017,10,18,10,493,509,96,-413
2017,10,18,11,576,591,206,-385
2017,10,18,12,616,646,276,-370
2017,10,18,13,610,655,296,-359
2017,10,18,14,593,618,266,-352
2017,10,18,15,567,600,263,-337
2017,10,18,16,547,571,210,-361
2017,10,18,17,530,550,162,-388
2017,10,18,18,524,540,138,-402
2017,10,18,19,519,538,140,-398
2017,10,18,20,513,538,141,-397
2017,10,18,21,517,542,134,-408
2017,10,18,22,527,546,135,-411
2017,10,18,23,541,564,204,-360
2017,10,19,0,570,593,218,-375
2017,10,19,1,563,583,204,-379
2017,10,19,2,533,552,149,-403
2017,10,19,3,493,506,132,-374
2017,10,19,4,456,465,133,-332
2017,10,19,5,423,444,131,-313
2017,10,19,6,414,435,132,-303
2017,10,19,7,411,436,133,-303
2017,10,19,8,417,446,133,-313
2017,10,19,9,435,465,132,-333
2017,10,19,10,480,517,133,-384
2017,10,19,11,558,598,165,-433
2017,10,19,12,601,646,213,-433
2017,10,19,13,598,651,232,-419
2017,10,19,14,581,636,257,-379
2017,10,19,15,559,608,272,-336
2017,10,19,16,542,575,197,-378
2017,10,19,17,532,557,149,-408
2017,10,19,18,525,545,108,-437
2017,10,19,19,526,538,73,-465
2017,10,19,20,530,541,66,-475
2017,10,19,21,533,546,71,-475
2017,10,19,22,540,550,133,-417
2017,10,19,23,549,561,143,-418
2017,10,20,0,573,588,147,-441
2017,10,20,1,561,579,145,-434
2017,10,20,2,527,551,129,-422
2017,10,20,3,482,506,70,-436
2017,10,20,4,441,463,61,-402
2017,10,20,5,412,438,58,-380
2017,10,20,6,396,429,59,-370
2017,10,20,7,392,427,59,-368
2017,10,20,8,393,435,61,-374
2017,10,20,9,403,450,59,-391
2017,10,20,10,444,496,60,-436
2017,10,20,11,515,572,67,-505
2017,10,20,12,554,618,150,-468
2017,10,20,13,559,624,198,-426
2017,10,20,14,550,611,198,-413
2017,10,20,15,537,583,135,-448
2017,10,20,16,524,560,100,-460
2017,10,20,17,519,543,71,-472
2017,10,20,18,518,539,72,-467
2017,10,20,19,522,532,71,-461
2017,10,20,20,529,536,72,-464
2017,10,20,21,535,539,66,-473
2017,10,20,22,537,544,99,-445
2017,10,20,23,539,544,130,-414
2017,10,21,0,547,557,130,-427
2017,10,21,1,538,545,96,-449
2017,10,21,2,507,519,64,-455
2017,10,21,3,475,488,65,-423
2017,10,21,4,432,450,64,-386
2017,10,21,5,406,421,65,-356
2017,10,21,6,386,407,63,-344
2017,10,21,7,376,404,65,-339
2017,10,21,8,373,403,64,-339
2017,10,21,9,376,413,65,-348
2017,10,21,10,389,432,64,-368
2017,10,21,11,414,468,65,-403
2017,10,21,12,457,513,64,-449
2017,10,21,13,492,551,66,-485
2017,10,21,14,508,556,70,-486
2017,10,21,15,509,541,92,-449
2017,10,21,16,500,520,91,-429
2017,10,21,17,495,507,92,-415
2017,10,21,18,485,502,92,-410
2017,10,21,19,489,497,92,-405
2017,10,21,20,496,496,91,-405
2017,10,21,21,501,501,91,-410
2017,10,21,22,505,507,100,-407
2017,10,21,23,508,515,136,-379
2017,10,22,0,526,537,125,-412
2017,10,22,1,512,524,84,-440
2017,10,22,2,485,498,61,-437
2017,10,22,3,455,463,59,-404
2017,10,22,4,416,430,60,-370
2017,10,22,5,389,400,58,-342
2017,10,22,6,370,385,59,-326
2017,10,22,7,360,378,62,-316
2017,10,22,8,357,383,65,-318
2017,10,22,9,359,383,63,-320
2017,10,22,10,368,400,64,-336
2017,10,22,11,390,428,78,-350
2017,10,22,12,425,468,80,-388
2017,10,22,13,469,513,80,-433
2017,10,22,14,490,524,80,-444
2017,10,22,15,487,512,81,-431
2017,10,22,16,480,498,81,-417
2017,10,22,17,479,496,81,-415
2017,10,22,18,476,493,82,-411
2017,10,22,19,477,483,81,-402
2017,10,22,20,484,484,82,-402
2017,10,22,21,488,495,80,-415
2017,10,22,22,499,508,82,-426
2017,10,22,23,507,534,183,-351
2017,10,23,0,530,557,185,-372
2017,10,23,1,520,534,129,-405
2017,10,23,2,488,501,110,-391
2017,10,23,3,451,458,94,-364
2017,10,23,4,410,411,63,-348
2017,10,23,5,383,395,58,-337
2017,10,23,6,368,380,60,-320
2017,10,23,7,361,372,58,-314
2017,10,23,8,357,374,60,-314
2017,10,23,9,368,381,58,-323
2017,10,23,10,402,417,87,-330
2017,10,23,11,468,485,99,-386
2017,10,23,12,513,522,99,-423
2017,10,23,13,528,538,98,-440
2017,10,23,14,541,565,133,-432
2017,10,23,15,548,576,134,-442
2017,10,23,16,547,580,133,-447
2017,10,23,17,547,581,169,-412
2017,10,23,18,544,579,169,-410
2017,10,23,19,534,569,254,-315
2017,10,23,20,529,560,281,-279
2017,10,23,21,538,558,282,-276
2017,10,23,22,541,560,287,-273
2017,10,23,23,547,567,261,-306
2017,10,24,0,567,584,244,-340
2017,10,24,1,550,571,250,-321
2017,10,24,2,519,544,237,-307
2017,10,24,3,479,495,209,-286
2017,10,24,4,439,452,176,-276
2017,10,24,5,416,424,178,-246
2017,10,24,6,402,406,156,-250
2017,10,24,7,395,401,118,-283
2017,10,24,8,395,409,107,-302
2017,10,24,9,408,420,83,-337
2017,10,24,10,444,467,77,-390
2017,10,24,11,517,536,98,-438
2017,10,24,12,561,594,110,-484
2017,10,24,13,566,600,158,-442
2017,10,24,14,564,592,207,-385
2017,10,24,15,551,584,211,-373
2017,10,24,16,543,567,212,-355
2017,10,24,17,533,556,220,-336
2017,10,24,18,527,544,223,-321
2017,10,24,19,520,534,275,-259
2017,10,24,20,514,536,287,-249
2017,10,24,21,520,537,293,-244
2017,10,24,22,531,550,291,-259
2017,10,24,23,551,579,296,-283
2017,10,25,0,577,610,281,-329
2017,10,25,1,571,600,279,-321
2017,10,25,2,545,570,280,-290
2017,10,25,3,505,544,217,-327
2017,10,25,4,467,523,155,-368
2017,10,25,5,459,465,67,-398
2017,10,25,6,453,462,67,-395
2017,10,25,7,452,461,63,-398
2017,10,25,8,461,464,62,-402
2017,10,25,9,484,489,66,-423
2017,10,25,10,532,540,186,-354
2017,10,25,11,616,622,271,-351
2017,10,25,12,665,673,360,-313
2017,10,25,13,666,676,362,-314
2017,10,25,14,655,654,346,-308
2017,10,25,15,632,623,244,-379
2017,10,25,16,613,610,173,-437
2017,10,25,17,587,596,136,-460
2017,10,25,18,571,594,139,-455
2017,10,25,19,561,563,130,-433
2017,10,25,20,555,565,135,-430
2017,10,25,21,561,576,136,-440
2017,10,25,22,581,602,211,-391
2017,10,25,23,609,637,313,-324
2017,10,26,0,633,673,343,-330
2017,10,26,1,642,666,330,-336
2017,10,26,2,622,635,263,-372
2017,10,26,3,584,594,244,-350
2017,10,26,4,546,550,149,-401
2017,10,26,5,512,524,107,-417
2017,10,26,6,499,514,101,-413
2017,10,26,7,499,512,62,-450
2017,10,26,8,504,522,58,-464
2017,10,26,9,522,541,107,-434
2017,10,26,10,565,597,287,-310
2017,10,26,11,646,680,356,-324
2017,10,26,12,693,728,363,-365
2017,10,26,13,688,730,361,-369
2017,10,26,14,667,698,341,-357
2017,10,26,15,636,652,225,-427
2017,10,26,16,607,612,135,-477
2017,10,26,17,573,583,128,-455
2017,10,26,18,551,563,127,-436
2017,10,26,19,538,543,129,-414
2017,10,26,20,533,538,131,-407
2017,10,26,21,534,541,145,-396
2017,10,26,22,544,551,178,-373
2017,10,26,23,567,574,184,-390
2017,10,27,0,593,613,182,-431
2017,10,27,1,593,611,180,-431
2017,10,27,2,573,588,181,-407
2017,10,27,3,539,550,179,-371
2017,10,27,4,500,515,151,-364
2017,10,27,5,465,488,122,-366
2017,10,27,6,452,486,121,-365
2017,10,27,7,445,487,121,-366
2017,10,27,8,446,501,112,-389
2017,10,27,9,463,518,111,-407
2017,10,27,10,505,567,209,-358
2017,10,27,11,579,646,220,-426
2017,10,27,12,620,693,323,-370
2017,10,27,13,620,693,343,-350
2017,10,27,14,609,665,293,-372
2017,10,27,15,582,622,251,-371
2017,10,27,16,563,586,216,-370
2017,10,27,17,548,556,220,-336
2017,10,27,18,540,538,237,-301
2017,10,27,19,526,529,242,-287
2017,10,27,20,522,519,240,-279
2017,10,27,21,521,522,260,-262
2017,10,27,22,524,525,298,-227
2017,10,27,23,535,534,321,-213
2017,10,28,0,550,551,319,-232
2017,10,28,1,539,540,277,-263
2017,10,28,2,515,518,229,-289
2017,10,28,3,481,499,226,-273
2017,10,28,4,443,466,225,-241
2017,10,28,5,412,435,174,-261
2017,10,28,6,394,420,118,-302
2017,10,28,7,383,414,118,-296
2017,10,28,8,381,409,117,-292
2017,10,28,9,389,414,118,-296
2017,10,28,10,404,433,118,-315
2017,10,28,11,434,462,118,-344
2017,10,28,12,479,490,117,-373
2017,10,28,13,522,528,120,-408
2017,10,28,14,545,548,130,-418
2017,10,28,15,544,551,151,-400
2017,10,28,16,530,561,145,-416
2017,10,28,17,519,553,137,-416
2017,10,28,18,508,545,178,-367
2017,10,28,19,493,542,194,-348
2017,10,28,20,490,539,193,-346
2017,10,28,21,500,554,204,-350
2017,10,28,22,514,562,240,-322
2017,10,28,23,538,581,264,-317
2017,10,29,0,562,574,270,-304
2017,10,29,1,556,559,287,-272
2017,10,29,2,540,533,258,-275
2017,10,29,3,518,504,262,-242
2017,10,29,4,489,481,254,-227
2017,10,29,5,455,455,148,-307
2017,10,29,6,437,445,112,-333
2017,10,29,7,432,444,110,-334
2017,10,29,8,432,452,113,-339
2017,10,29,9,441,464,112,-352
2017,10,29,10,456,485,151,-334
2017,10,29,11,489,525,189,-336
2017,10,29,12,534,569,209,-360
2017,10,29,13,582,625,230,-395
2017,10,29,14,605,644,256,-388
2017,10,29,15,600,638,256,-382
2017,10,29,16,590,622,229,-393
2017,10,29,17,588,617,221,-396
2017,10,29,18,580,608,221,-387
2017,10,29,19,570,605,222,-383
2017,10,29,20,570,619,222,-397
2017,10,29,21,579,656,232,-424
2017,10,29,22,603,691,264,-427
2017,10,29,23,639,729,300,-429
2017,10,30,0,663,753,348,-405
2017,10,30,1,666,738,360,-378
2017,10,30,2,645,704,358,-346
2017,10,30,3,614,666,356,-310
2017,10,30,4,582,635,321,-314
2017,10,30,5,571,615,236,-379
2017,10,30,6,560,603,203,-400
2017,10,30,7,561,605,188,-417
2017,10,30,8,568,610,191,-419
2017,10,30,9,587,628,212,-416
2017,10,30,10,633,673,252,-421
2017,10,30,11,708,752,379,-373
2017,10,30,12,758,788,398,-390
2017,10,30,13,758,840,401,-439
2017,10,30,14,727,757,356,-401
2017,10,30,15,686,719,311,-408
2017,10,30,16,647,674,279,-395
2017,10,30,17,609,636,228,-408
2017,10,30,18,582,608,232,-376
2017,10,30,19,562,576,177,-399
2017,10,30,20,555,561,134,-427
2017,10,30,21,560,560,133,-427
2017,10,30,22,575,575,182,-393
2017,10,30,23,598,612,292,-320
2017,10,31,0,622,649,331,-318
2017,10,31,1,612,644,379,-265
2017,10,31,2,586,620,394,-226
2017,10,31,3,545,579,328,-251
2017,10,31,4,505,540,155,-385
2017,10,31,5,489,518,109,-409
2017,10,31,6,477,511,108,-403
2017,10,31,7,472,514,112,-402
2017,10,31,8,475,523,115,-408
2017,10,31,9,494,546,240,-306
2017,10,31,10,534,596,395,-201
2017,10,31,11,607,678,466,-212
2017,10,31,12,654,713,476,-237
2017,10,31,13,658,707,475,-232
2017,10,31,14,647,678,452,-226
2017,10,31,15,621,639,360,-279
2017,10,31,16,598,603,299,-304
2017,10,31,17,576,573,256,-317
2017,10,31,18,561,552,151,-401
2017,10,31,19,547,540,118,-422
2017,10,31,20,540,535,119,-416
2017,10,31,21,542,537,123,-414
2017,10,31,22,553,541,217,-324
2017,10,31,23,576,548,240,-308
2017,11,1,0,595,565,235,-330
2017,11,1,1,589,571,237,-334
2017,11,1,2,561,559,209,-350
2017,11,1,3,522,530,120,-410
2017,11,1,4,484,493,112,-381
2017,11,1,5,463,479,106,-373
2017,11,1,6,450,460,56,-404
2017,11,1,7,446,460,61,-399
2017,11,1,8,452,470,61,-409
2017,11,1,9,471,490,79,-411
2017,11,1,10,516,541,193,-348
2017,11,1,11,594,618,212,-406
2017,11,1,12,642,641,340,-301
2017,11,1,13,644,638,360,-278
2017,11,1,14,621,629,284,-345
2017,11,1,15,603,610,261,-349
2017,11,1,16,584,594,260,-334
2017,11,1,17,571,565,205,-360
2017,11,1,18,562,545,192,-353
2017,11,1,19,556,532,160,-372
2017,11,1,20,545,526,134,-392
2017,11,1,21,542,534,133,-401
2017,11,1,22,556,552,133,-419
2017,11,1,23,576,581,133,-448
2017,11,2,0,600,597,237,-360
2017,11,2,1,583,578,217,-361
2017,11,2,2,555,544,138,-406
2017,11,2,3,515,499,123,-376
2017,11,2,4,476,458,65,-393
2017,11,2,5,430,417,53,-364
2017,11,2,6,412,409,59,-350
2017,11,2,7,404,405,58,-347
2017,11,2,8,404,404,57,-347
2017,11,2,9,414,419,58,-361
2017,11,2,10,449,458,63,-395
2017,11,2,11,520,530,157,-373
2017,11,2,12,562,565,162,-403
2017,11,2,13,566,566,157,-409
2017,11,2,14,564,559,74,-485
2017,11,2,15,563,544,59,-485
2017,11,2,16,561,538,61,-477
2017,11,2,17,558,535,62,-473
2017,11,2,18,552,525,107,-418
2017,11,2,19,554,525,135,-390
2017,11,2,20,556,528,77,-451
2017,11,2,21,554,536,59,-477
2017,11,2,22,565,539,115,-424
2017,11,2,23,578,558,165,-393
2017,11,3,0,594,577,164,-413
2017,11,3,1,574,563,163,-400
2017,11,3,2,540,533,93,-440
2017,11,3,3,498,483,58,-425
2017,11,3,4,456,440,58,-382
2017,11,3,5,420,412,57,-355
2017,11,3,6,399,394,56,-338
2017,11,3,7,387,392,58,-334
2017,11,3,8,383,394,58,-336
2017,11,3,9,392,404,58,-346
2017,11,3,10,425,443,57,-386
2017,11,3,11,493,510,59,-451
2017,11,3,12,529,553,160,-393
2017,11,3,13,537,555,163,-392
2017,11,3,14,541,551,98,-453
2017,11,3,15,541,547,70,-477
2017,11,3,16,543,542,69,-473
2017,11,3,17,541,527,71,-456
2017,11,3,18,537,521,68,-453
2017,11,3,19,536,525,71,-454
2017,11,3,20,540,521,72,-449
2017,11,3,21,543,520,125,-395
2017,11,3,22,550,532,236,-296
2017,11,3,23,559,549,239,-310
2017,11,4,0,569,551,239,-312
2017,11,4,1,549,536,177,-359
2017,11,4,2,515,508,134,-374
2017,11,4,3,480,478,135,-343
2017,11,4,4,439,436,89,-347
2017,11,4,5,407,405,61,-344
2017,11,4,6,386,385,62,-323
2017,11,4,7,372,371,63,-308
2017,11,4,8,365,367,63,-304
2017,11,4,9,372,371,62,-309
2017,11,4,10,385,381,62,-319
2017,11,4,11,413,411,63,-348
2017,11,4,12,447,448,64,-384
2017,11,4,13,482,480,63,-417
2017,11,4,14,502,506,71,-435
2017,11,4,15,510,520,135,-385
2017,11,4,16,508,520,137,-383
2017,11,4,17,505,515,165,-350
2017,11,4,18,496,509,180,-329
2017,11,4,19,501,501,181,-320
2017,11,4,20,500,503,133,-370
2017,11,4,21,502,507,96,-411
2017,11,4,22,507,513,113,-400
2017,11,4,23,523,526,135,-391
2017,11,5,0,533,540,135,-405
2017,11,5,1,511,523,136,-387
2017,11,5,2,485,500,100,-400
2017,11,5,3,454,467,64,-403
2017,11,5,4,416,428,65,-363
2017,11,5,5,390,400,63,-337
2017,11,5,6,369,379,63,-316
2017,11,5,7,369,370,64,-306
2017,11,5,8,354,364,64,-300
2017,11,5,9,348,361,64,-297
2017,11,5,10,353,367,65,-302
2017,11,5,11,365,374,63,-311
2017,11,5,12,387,407,65,-342
2017,11,5,13,409,446,56,-390
2017,11,5,14,446,486,53,-433
2017,11,5,15,466,499,64,-435
2017,11,5,16,462,494,73,-421
2017,11,5,17,453,490,83,-407
2017,11,5,18,459,494,83,-411
2017,11,5,19,467,498,38,-460
2017,11,5,20,470,484,49,-435
2017,11,5,21,477,507,102,-405
2017,11,5,22,491,512,103,-409
2017,11,5,23,526,536,162,-374
2017,11,6,0,539,559,178,-381
2017,11,6,1,533,543,174,-369
2017,11,6,2,509,521,171,-350
2017,11,6,3,479,486,96,-390
2017,11,6,4,441,447,72,-375
2017,11,6,5,400,415,72,-343
2017,11,6,6,392,388,70,-318
2017,11,6,7,376,376,71,-305
2017,11,6,8,367,370,72,-298
2017,11,6,9,368,371,72,-299
2017,11,6,10,380,384,73,-311
2017,11,6,11,424,421,69,-352
2017,11,6,12,494,495,71,-424
2017,11,6,13,523,523,72,-451
2017,11,6,14,527,534,74,-460
2017,11,6,15,528,541,75,-466
2017,11,6,16,528,544,75,-469
2017,11,6,17,527,542,76,-466
2017,11,6,18,527,543,74,-469
2017,11,6,19,529,546,76,-470
2017,11,6,20,525,534,76,-458
2017,11,6,21,535,534,118,-416
2017,11,6,22,549,537,166,-371
2017,11,6,23,574,564,183,-381
2017,11,7,0,582,589,185,-404
2017,11,7,1,576,579,183,-396
2017,11,7,2,547,559,187,-372
2017,11,7,3,508,515,128,-387
2017,11,7,4,468,472,79,-393
2017,11,7,5,428,428,79,-349
2017,11,7,6,404,405,80,-325
2017,11,7,7,387,388,79,-309
2017,11,7,8,379,380,78,-302
2017,11,7,9,376,382,80,-302
2017,11,7,10,387,391,79,-312
2017,11,7,11,427,428,79,-349
2017,11,7,12,490,500,77,-423
2017,11,7,13,520,536,78,-458
2017,11,7,14,527,535,78,-457
2017,11,7,15,525,546,78,-468
2017,11,7,16,526,554,76,-478
2017,11,7,17,522,560,77,-483
2017,11,7,18,517,541,78,-463
2017,11,7,19,515,536,76,-460
2017,11,7,20,508,534,172,-362
2017,11,7,21,518,534,201,-333
2017,11,7,22,533,538,243,-295
2017,11,7,23,563,562,274,-288
2017,11,8,0,579,591,298,-293
2017,11,8,1,573,581,288,-293
2017,11,8,2,552,554,228,-326
2017,11,8,3,517,523,192,-331
2017,11,8,4,480,472,181,-291
2017,11,8,5,444,428,172,-256
2017,11,8,6,409,398,132,-266
2017,11,8,7,393,386,92,-294
2017,11,8,8,385,380,93,-287
2017,11,8,9,386,380,92,-288
2017,11,8,10,401,391,95,-296
2017,11,8,11,443,434,135,-299
2017,11,8,12,518,500,138,-362
2017,11,8,13,558,535,158,-377
2017,11,8,14,565,542,198,-344
2017,11,8,15,578,555,202,-353
2017,11,8,16,583,564,201,-363
2017,11,8,17,581,561,200,-361
2017,11,8,18,578,565,203,-362
2017,11,8,19,580,562,201,-361
2017,11,8,20,567,558,207,-351
2017,11,8,21,574,571,240,-331
2017,11,8,22,595,587,236,-351
2017,11,8,23,642,612,233,-379
2017,11,9,0,673,636,303,-333
2017,11,9,1,662,626,238,-388
2017,11,9,2,645,606,231,-375
2017,11,9,3,609,574,189,-385
2017,11,9,4,570,530,115,-415
2017,11,9,5,526,491,69,-422
2017,11,9,6,490,460,66,-394
2017,11,9,7,475,452,65,-387
2017,11,9,8,470,445,66,-379
2017,11,9,9,473,449,67,-382
2017,11,9,10,487,456,68,-388
2017,11,9,11,532,494,71,-423
2017,11,9,12,609,564,76,-488
2017,11,9,13,639,600,67,-533
2017,11,9,14,630,600,89,-511
2017,11,9,15,619,599,123,-476
2017,11,9,16,603,594,130,-464
2017,11,9,17,589,584,128,-456
2017,11,9,18,569,570,142,-428
2017,11,9,19,564,563,236,-327
2017,11,9,20,545,550,195,-355
2017,11,9,21,544,556,178,-378
2017,11,9,22,562,570,192,-378
2017,11,9,23,611,606,240,-366
2017,11,10,0,652,631,228,-403
2017,11,10,1,653,630,222,-408
2017,11,10,2,647,617,239,-378
2017,11,10,3,624,599,222,-377
2017,11,10,4,585,558,137,-421
2017,11,10,5,547,521,126,-395
2017,11,10,6,516,501,101,-400
2017,11,10,7,506,497,76,-421
2017,11,10,8,504,499,68,-431
2017,11,10,9,509,502,68,-434
2017,11,10,10,527,523,119,-404
2017,11,10,11,570,563,242,-321
2017,11,10,12,639,614,273,-341
2017,11,10,13,669,666,310,-356
2017,11,10,14,669,665,311,-354
2017,11,10,15,651,643,292,-351
2017,11,10,16,629,618,233,-385
2017,11,10,17,605,589,156,-433
2017,11,10,18,581,567,123,-444
2017,11,10,19,566,551,101,-450
2017,11,10,20,548,542,101,-441
2017,11,10,21,550,541,100,-441
2017,11,10,22,561,556,100,-456
2017,11,10,23,606,597,105,-492
2017,11,11,0,649,637,217,-420
2017,11,11,1,645,642,228,-414
2017,11,11,2,638,634,172,-462
2017,11,11,3,621,630,135,-495
2017,11,11,4,603,610,150,-460
2017,11,11,5,576,583,148,-435
2017,11,11,6,552,565,147,-418
2017,11,11,7,546,558,148,-410
2017,11,11,8,552,561,148,-413
2017,11,11,9,566,567,153,-414
2017,11,11,10,583,584,182,-402
2017,11,11,11,600,606,286,-320
2017,11,11,12,632,642,329,-313
2017,11,11,13,677,693,355,-338
2017,11,11,14,712,710,353,-357
2017,11,11,15,697,691,273,-418
2017,11,11,16,667,657,246,-411
2017,11,11,17,639,619,166,-453
2017,11,11,18,603,588,130,-458
2017,11,11,19,583,558,130,-428
2017,11,11,20,568,540,130,-410
2017,11,11,21,571,539,130,-409
2017,11,11,22,587,558,130,-428
2017,11,11,23,636,608,152,-456
2017,11,12,0,671,640,304,-336
2017,11,12,1,664,646,321,-325
2017,11,12,2,644,640,293,-347
2017,11,12,3,627,616,182,-434
2017,11,12,4,600,588,176,-412
2017,11,12,5,575,558,175,-383
2017,11,12,6,556,533,144,-389
2017,11,12,7,542,517,128,-389
2017,11,12,8,541,511,124,-387
2017,11,12,9,546,509,122,-387
2017,11,12,10,556,516,124,-392
2017,11,12,11,570,533,140,-393
2017,11,12,12,605,561,207,-354
2017,11,12,13,633,603,243,-360
2017,11,12,14,670,635,246,-389
2017,11,12,15,670,642,238,-404
2017,11,12,16,646,625,174,-451
2017,11,12,17,621,606,129,-477
2017,11,12,18,603,601,127,-474
2017,11,12,19,586,593,130,-463
2017,11,12,20,566,581,130,-451
2017,11,12,21,572,574,130,-444
2017,11,12,22,585,587,130,-457
2017,11,12,23,634,621,165,-456
2017,11,13,0,659,633,236,-397
2017,11,13,1,639,623,238,-385
2017,11,13,2,623,603,201,-402
2017,11,13,3,587,566,130,-436
2017,11,13,4,554,525,108,-417
2017,11,13,5,515,493,93,-400
2017,11,13,6,495,468,60,-408
2017,11,13,7,481,458,56,-402
2017,11,13,8,477,457,58,-399
2017,11,13,9,481,463,57,-406
2017,11,13,10,499,482,80,-402
2017,11,13,11,545,529,127,-402
2017,11,13,12,614,600,269,-331
2017,11,13,13,647,631,290,-341
2017,11,13,14,640,623,246,-377
2017,11,13,15,624,621,170,-451
2017,11,13,16,609,613,162,-451
2017,11,13,17,594,592,162,-430
2017,11,13,18,578,571,161,-410
2017,11,13,19,563,557,160,-397
2017,11,13,20,549,542,139,-403
2017,11,13,21,549,551,100,-451
2017,11,13,22,567,572,92,-480
2017,11,13,23,614,622,176,-446
2017,11,14,0,656,674,234,-440
2017,11,14,1,657,675,238,-437
2017,11,14,2,646,664,235,-429
2017,11,14,3,620,636,206,-430
2017,11,14,4,584,594,147,-447
2017,11,14,5,545,564,130,-434
2017,11,14,6,521,543,127,-416
2017,11,14,7,513,537,89,-448
2017,11,14,8,513,529,61,-468
2017,11,14,9,521,536,62,-474
2017,11,14,10,544,550,62,-488
2017,11,14,11,596,599,124,-475
2017,11,14,12,679,659,270,-389
2017,11,14,13,716,698,306,-392
2017,11,14,14,705,687,281,-406
2017,11,14,15,674,647,202,-445
2017,11,14,16,646,640,196,-444
2017,11,14,17,620,620,117,-503
2017,11,14,18,591,578,73,-505
2017,11,14,19,577,562,70,-492
2017,11,14,20,560,538,70,-468
2017,11,14,21,562,536,69,-467
2017,11,14,22,579,560,76,-484
2017,11,14,23,635,607,83,-524
2017,11,15,0,675,649,157,-492
2017,11,15,1,672,655,204,-451
2017,11,15,2,665,644,188,-456
2017,11,15,3,641,619,136,-483
2017,11,15,4,601,573,134,-439
2017,11,15,5,565,540,108,-432
2017,11,15,6,552,511,68,-443
2017,11,15,7,542,505,68,-437
2017,11,15,8,540,499,68,-431
2017,11,15,9,552,504,69,-435
2017,11,15,10,571,519,73,-446
2017,11,15,11,622,572,105,-467
2017,11,15,12,699,647,256,-391
2017,11,15,13,728,675,321,-354
2017,11,15,14,717,669,321,-348
2017,11,15,15,691,646,214,-432
2017,11,15,16,663,608,129,-479
2017,11,15,17,629,587,84,-503
2017,11,15,18,594,557,61,-496
2017,11,15,19,578,551,65,-486
2017,11,15,20,562,538,64,-474
2017,11,15,21,561,537,63,-474
2017,11,15,22,579,555,84,-471
2017,11,15,23,623,604,106,-498
2017,11,16,0,660,637,167,-470
2017,11,16,1,656,633,206,-427
2017,11,16,2,647,620,206,-414
2017,11,16,3,620,592,164,-428
2017,11,16,4,577,546,133,-413
2017,11,16,5,538,507,96,-411
2017,11,16,6,514,471,55,-416
2017,11,16,7,500,456,53,-403
2017,11,16,8,494,457,60,-397
2017,11,16,9,501,461,61,-400
2017,11,16,10,515,474,60,-414
2017,11,16,11,560,515,87,-428
2017,11,16,12,636,591,210,-381
2017,11,16,13,665,621,235,-386
2017,11,16,14,650,615,151,-464
2017,11,16,15,624,595,109,-486
2017,11,16,16,601,572,62,-510
2017,11,16,17,578,557,62,-495
2017,11,16,18,556,543,62,-481
2017,11,16,19,540,538,62,-476
2017,11,16,20,523,525,61,-464
2017,11,16,21,523,527,65,-462
2017,11,16,22,538,542,87,-455
2017,11,16,23,584,587,147,-440
2017,11,17,0,624,626,226,-400
2017,11,17,1,628,628,222,-406
2017,11,17,2,622,628,221,-407
2017,11,17,3,600,606,158,-448
2017,11,17,4,564,575,139,-436
2017,11,17,5,532,542,119,-423
2017,11,17,6,509,526,63,-463
2017,11,17,7,505,525,57,-468
2017,11,17,8,506,531,57,-474
2017,11,17,9,516,544,58,-486
2017,11,17,10,537,578,58,-520
2017,11,17,11,590,630,72,-558
2017,11,17,12,674,708,231,-477
2017,11,17,13,702,750,326,-424
2017,11,17,14,686,733,313,-420
2017,11,17,15,650,686,233,-453
2017,11,17,16,610,635,92,-543
2017,11,17,17,574,592,64,-528
2017,11,17,18,547,559,58,-501
2017,11,17,19,530,540,58,-482
2017,11,17,20,516,522,61,-461
2017,11,17,21,517,518,59,-459
2017,11,17,22,526,535,97,-438
2017,11,17,23,566,576,226,-350
2017,11,18,0,594,604,250,-354
2017,11,18,1,588,602,225,-377
2017,11,18,2,576,599,185,-414
2017,11,18,3,555,580,110,-470
2017,11,18,4,524,555,88,-467
2017,11,18,5,494,529,65,-464
2017,11,18,6,486,500,61,-439
2017,11,18,7,475,483,59,-424
2017,11,18,8,467,481,59,-422
2017,11,18,9,469,477,54,-423
2017,11,18,10,479,490,53,-437
2017,11,18,11,503,516,54,-462
2017,11,18,12,541,553,99,-454
2017,11,18,13,572,590,161,-429
2017,11,18,14,593,609,164,-445
2017,11,18,15,585,603,97,-506
2017,11,18,16,561,579,59,-520
2017,11,18,17,542,550,59,-491
2017,11,18,18,523,533,60,-473
2017,11,18,19,511,519,58,-461
2017,11,18,20,504,520,60,-460
2017,11,18,21,502,524,58,-466
2017,11,18,22,517,540,67,-473
2017,11,18,23,568,574,125,-449
2017,11,19,0,596,585,178,-407
2017,11,19,1,584,567,98,-469
2017,11,19,2,571,554,65,-489
2017,11,19,3,551,525,60,-465
2017,11,19,4,526,492,58,-434
2017,11,19,5,498,457,59,-398
2017,11,19,6,429,432,58,-374
2017,11,19,7,415,424,57,-367
2017,11,19,8,409,428,60,-368
2017,11,19,9,411,440,59,-381
2017,11,19,10,422,460,58,-402
2017,11,19,11,449,492,60,-432
2017,11,19,12,493,534,58,-476
2017,11,19,13,543,587,57,-530
2017,11,19,14,589,635,70,-565
2017,11,19,15,603,643,79,-564
2017,11,19,16,587,623,66,-557
2017,11,19,17,568,606,90,-516
2017,11,19,18,564,610,90,-520
2017,11,19,19,553,596,90,-506
2017,11,19,20,543,586,132,-454
2017,11,19,21,550,587,130,-457
2017,11,19,22,572,602,121,-481
2017,11,19,23,642,680,201,-479
2017,11,20,0,676,722,200,-522
2017,11,20,1,678,729,201,-528
2017,11,20,2,676,719,199,-520
2017,11,20,3,649,693,200,-493
2017,11,20,4,625,658,199,-459
2017,11,20,5,602,631,117,-514
2017,11,20,6,594,614,65,-549
2017,11,20,7,590,613,58,-555
2017,11,20,8,590,625,61,-564
2017,11,20,9,600,636,69,-567
2017,11,20,10,624,662,125,-537
2017,11,20,11,671,718,264,-454
2017,11,20,12,759,797,291,-506
2017,11,20,13,794,832,319,-513
2017,11,20,14,770,810,272,-538
2017,11,20,15,723,762,217,-545
2017,11,20,16,683,711,153,-558
2017,11,20,17,647,667,140,-527
2017,11,20,18,605,619,79,-540
2017,11,20,19,579,593,79,-514
2017,11,20,20,561,576,79,-497
2017,11,20,21,558,574,77,-497
2017,11,20,22,577,595,81,-514
2017,11,20,23,627,647,108,-539
2017,11,21,0,666,691,147,-544
2017,11,21,1,661,701,147,-554
2017,11,21,2,654,698,152,-546
2017,11,21,3,631,677,148,-529
2017,11,21,4,590,636,102,-534
2017,11,21,5,553,603,78,-525
2017,11,21,6,550,585,77,-508
2017,11,21,7,541,577,76,-501
2017,11,21,8,542,577,76,-501
2017,11,21,9,553,586,76,-510
2017,11,21,10,573,595,75,-520
2017,11,21,11,625,632,76,-556
2017,11,21,12,703,694,248,-446
2017,11,21,13,740,722,271,-451
2017,11,21,14,734,708,265,-443
2017,11,21,15,709,687,292,-395
2017,11,21,16,676,658,239,-419
2017,11,21,17,649,623,180,-443
2017,11,21,18,612,604,95,-509
2017,11,21,19,594,590,94,-496
2017,11,21,20,577,573,94,-479
2017,11,21,21,579,561,94,-467
2017,11,21,22,598,567,92,-475
2017,11,21,23,647,613,119,-494
2017,11,22,0,679,644,175,-469
2017,11,22,1,671,643,165,-478
2017,11,22,2,661,625,156,-469
2017,11,22,3,632,606,69,-537
2017,11,22,4,587,566,51,-515
2017,11,22,5,548,533,52,-481
2017,11,22,6,529,520,126,-394
2017,11,22,7,517,508,113,-395
2017,11,22,8,513,510,111,-399
2017,11,22,9,516,514,112,-402
2017,11,22,10,532,527,112,-415
2017,11,22,11,571,559,204,-355
2017,11,22,12,631,616,223,-393
2017,11,22,13,673,658,254,-404
2017,11,22,14,674,669,282,-387
2017,11,22,15,661,656,255,-401
2017,11,22,16,647,634,154,-480
2017,11,22,17,624,616,150,-466
2017,11,22,18,596,593,152,-441
2017,11,22,19,584,577,151,-426
2017,11,22,20,568,561,122,-439
2017,11,22,21,569,566,95,-471
2017,11,22,22,585,582,115,-467
2017,11,22,23,634,622,180,-442
2017,11,23,0,667,662,201,-461
2017,11,23,1,664,666,201,-465
2017,11,23,2,658,669,200,-469
2017,11,23,3,637,664,202,-462
2017,11,23,4,604,636,133,-503
2017,11,23,5,570,600,92,-508
2017,11,23,6,565,571,64,-507
2017,11,23,7,550,566,54,-512
2017,11,23,8,555,564,52,-512
2017,11,23,9,563,576,54,-522
2017,11,23,10,573,601,56,-545
2017,11,23,11,604,633,70,-563
2017,11,23,12,632,671,192,-479
2017,11,23,13,677,720,259,-461
2017,11,23,14,709,740,227,-513
2017,11,23,15,712,717,224,-493
2017,11,23,16,699,682,228,-454
2017,11,23,17,670,631,171,-460
2017,11,23,18,612,581,67,-514
2017,11,23,19,567,534,61,-473
2017,11,23,20,538,506,62,-444
2017,11,23,21,519,490,60,-430
2017,11,23,22,517,492,60,-432
2017,11,23,23,535,517,59,-458
2017,11,24,0,559,543,61,-482
2017,11,24,1,563,556,59,-497
2017,11,24,2,565,564,72,-492
2017,11,24,3,561,571,79,-492
2017,11,24,4,544,561,71,-490
2017,11,24,5,527,546,56,-490
2017,11,24,6,507,542,58,-484
2017,11,24,7,502,546,57,-489
2017,11,24,8,505,553,59,-494
2017,11,24,9,517,569,61,-508
2017,11,24,10,529,595,69,-526
2017,11,24,11,564,624,92,-532
2017,11,24,12,596,667,282,-385
2017,11,24,13,637,702,333,-369
2017,11,24,14,664,714,329,-385
2017,11,24,15,646,672,267,-405
2017,11,24,16,611,609,121,-488
2017,11,24,17,572,568,80,-488
2017,11,24,18,541,529,62,-467
2017,11,24,19,515,501,64,-437
2017,11,24,20,499,486,64,-422
2017,11,24,21,500,480,69,-411
2017,11,24,22,516,503,73,-430
2017,11,24,23,557,542,115,-427
2017,11,25,0,584,572,159,-413
2017,11,25,1,586,573,163,-410
2017,11,25,2,581,575,136,-439
2017,11,25,3,569,567,125,-442
2017,11,25,4,546,545,154,-391
2017,11,25,5,522,523,149,-374
2017,11,25,6,488,503,130,-373
2017,11,25,7,481,497,128,-369
2017,11,25,8,484,499,129,-370
2017,11,25,9,491,515,129,-386
2017,11,25,10,507,536,151,-385
2017,11,25,11,533,569,174,-395
2017,11,25,12,569,605,229,-376
2017,11,25,13,612,637,278,-359
2017,11,25,14,637,666,283,-383
2017,11,25,15,623,651,213,-438
2017,11,25,16,590,620,149,-471
2017,11,25,17,550,584,133,-451
2017,11,25,18,524,550,116,-434
2017,11,25,19,503,531,55,-476
2017,11,25,20,495,510,52,-458
2017,11,25,21,495,496,54,-442
2017,11,25,22,505,516,77,-439
2017,11,25,23,550,564,101,-463
2017,11,26,0,578,586,95,-491
2017,11,26,1,570,589,99,-490
2017,11,26,2,559,583,101,-482
2017,11,26,3,539,557,104,-453
2017,11,26,4,516,537,109,-428
2017,11,26,5,488,508,111,-397
2017,11,26,6,481,485,109,-376
2017,11,26,7,474,475,110,-365
2017,11,26,8,478,479,112,-367
2017,11,26,9,488,479,111,-368
2017,11,26,10,506,495,110,-385
2017,11,26,11,537,524,111,-413
2017,11,26,12,583,566,116,-450
2017,11,26,13,631,612,137,-475
2017,11,26,14,668,642,133,-509
2017,11,26,15,653,620,123,-497
2017,11,26,16,612,585,116,-469
2017,11,26,17,578,554,115,-439
2017,11,26,18,555,538,112,-426
2017,11,26,19,536,519,113,-406
2017,11,26,20,522,515,113,-402
2017,11,26,21,524,517,113,-404
2017,11,26,22,542,544,161,-383
2017,11,26,23,606,605,194,-411
2017,11,27,0,643,645,194,-451
2017,11,27,1,642,655,191,-464
2017,11,27,2,640,654,195,-459
2017,11,27,3,618,633,194,-439
2017,11,27,4,596,603,160,-443
2017,11,27,5,572,579,124,-455
2017,11,27,6,558,555,111,-444
2017,11,27,7,553,562,114,-448
2017,11,27,8,560,578,124,-454
2017,11,27,9,572,595,124,-471
2017,11,27,10,596,627,206,-421
2017,11,27,11,651,686,374,-312
2017,11,27,12,736,773,413,-360
2017,11,27,13,778,811,376,-435
2017,11,27,14,757,791,335,-456
2017,11,27,15,708,733,264,-469
2017,11,27,16,662,685,177,-508
2017,11,27,17,626,639,165,-474
2017,11,27,18,585,597,136,-461
2017,11,27,19,560,570,116,-454
2017,11,27,20,547,555,117,-438
2017,11,27,21,547,549,110,-439
2017,11,27,22,563,567,116,-451
2017,11,27,23,610,621,135,-486
2017,11,28,0,643,667,174,-493
2017,11,28,1,651,677,178,-499
2017,11,28,2,649,683,188,-495
2017,11,28,3,629,659,194,-465
2017,11,28,4,591,623,153,-470
2017,11,28,5,561,591,117,-474
2017,11,28,6,543,581,108,-473
2017,11,28,7,539,574,106,-468
2017,11,28,8,540,590,108,-482
2017,11,28,9,552,607,125,-482
2017,11,28,10,574,635,243,-392
2017,11,28,11,629,694,296,-398
2017,11,28,12,704,772,344,-428
2017,11,28,13,748,812,381,-431
2017,11,28,14,731,784,276,-508
2017,11,28,15,688,732,190,-542
2017,11,28,16,649,669,181,-488
2017,11,28,17,611,626,200,-426
2017,11,28,18,576,587,204,-383
2017,11,28,19,555,564,203,-361
2017,11,28,20,542,549,193,-356
2017,11,28,21,546,548,186,-362
2017,11,28,22,559,562,183,-379
2017,11,28,23,601,620,206,-414
2017,11,29,0,631,659,233,-426
2017,11,29,1,632,669,192,-477
2017,11,29,2,624,665,163,-502
2017,11,29,3,600,641,114,-527
2017,11,29,4,559,604,109,-495
2017,11,29,5,522,571,111,-460
2017,11,29,6,510,549,105,-444
2017,11,29,7,509,552,108,-444
2017,11,29,8,511,556,106,-450
2017,11,29,9,524,581,111,-470
2017,11,29,10,547,603,112,-491
2017,11,29,11,603,662,180,-482
2017,11,29,12,688,752,358,-394
2017,11,29,13,724,789,428,-361
2017,11,29,14,714,762,393,-369
2017,11,29,15,679,704,257,-447
2017,11,29,16,636,646,133,-513
2017,11,29,17,599,599,118,-481
2017,11,29,18,563,572,118,-454
2017,11,29,19,545,556,117,-439
2017,11,29,20,531,539,120,-419
2017,11,29,21,529,539,118,-421
2017,11,29,22,545,550,162,-388
2017,11,29,23,587,605,258,-347
2017,11,30,0,616,638,312,-326
2017,11,30,1,614,638,248,-390
2017,11,30,2,604,636,182,-454
2017,11,30,3,580,613,122,-491
2017,11,30,4,545,577,109,-468
2017,11,30,5,504,537,110,-427
2017,11,30,6,472,523,111,-412
2017,11,30,7,465,518,110,-408
2017,11,30,8,464,519,93,-426
2017,11,30,9,474,540,81,-459
2017,11,30,10,494,565,135,-430
2017,11,30,11,550,617,230,-387
2017,11,30,12,631,697,280,-417
2017,11,30,13,671,737,347,-390
2017,11,30,14,660,717,274,-443
2017,11,30,15,635,674,226,-448
2017,11,30,16,600,629,149,-480
2017,11,30,17,573,606,95,-511
2017,11,30,18,549,574,105,-469
2017,11,30,19,535,553,104,-449
2017,11,30,20,524,541,59,-482
2017,11,30,21,524,541,50,-491
2017,11,30,22,537,563,70,-493
2017,11,30,23,582,608,128,-480
2017,12,1,0,606,627,175,-452
2017,12,1,1,609,621,180,-441
2017,12,1,2,597,610,158,-452
2017,12,1,3,575,578,100,-478
2017,12,1,4,539,532,66,-466
2017,12,1,5,501,486,93,-393
2017,12,1,6,465,462,105,-357
2017,12,1,7,455,442,106,-336
2017,12,1,8,452,443,107,-336
2017,12,1,9,458,441,108,-333
2017,12,1,10,468,457,108,-349
2017,12,1,11,516,494,109,-385
2017,12,1,12,590,567,194,-373
2017,12,1,13,622,602,217,-385
2017,12,1,14,617,587,214,-373
2017,12,1,15,610,576,148,-428
2017,12,1,16,592,553,141,-412
2017,12,1,17,574,541,145,-396
2017,12,1,18,560,530,141,-389
2017,12,1,19,544,524,145,-379
2017,12,1,20,530,515,143,-372
2017,12,1,21,528,517,144,-373
2017,12,1,22,539,523,144,-379
2017,12,1,23,591,560,181,-379
2017,12,2,0,615,582,251,-331
2017,12,2,1,605,572,250,-322
2017,12,2,2,595,562,249,-313
2017,12,2,3,572,541,197,-344
2017,12,2,4,542,512,157,-355
2017,12,2,5,506,471,145,-326
2017,12,2,6,484,438,142,-296
2017,12,2,7,471,427,142,-285
2017,12,2,8,469,420,143,-277
2017,12,2,9,471,420,128,-292
2017,12,2,10,486,428,116,-312
2017,12,2,11,513,449,116,-333
2017,12,2,12,555,482,116,-366
2017,12,2,13,589,521,116,-405
2017,12,2,14,611,555,117,-438
2017,12,2,15,609,574,114,-460
2017,12,2,16,593,581,117,-464
2017,12,2,17,573,565,118,-447
2017,12,2,18,549,530,117,-413
2017,12,2,19,535,510,117,-393
2017,12,2,20,525,499,120,-379
2017,12,2,21,520,495,115,-380
2017,12,2,22,544,513,118,-395
2017,12,2,23,595,555,202,-353
2017,12,3,0,628,573,226,-347
2017,12,3,1,616,573,214,-359
2017,12,3,2,607,565,186,-379
2017,12,3,3,588,552,141,-411
2017,12,3,4,557,531,139,-392
2017,12,3,5,528,497,140,-357
2017,12,3,6,474,479,140,-339
2017,12,3,7,457,466,138,-328
2017,12,3,8,452,465,141,-324
2017,12,3,9,452,469,138,-331
2017,12,3,10,460,485,141,-344
2017,12,3,11,484,504,140,-364
2017,12,3,12,519,535,140,-395
2017,12,3,13,555,580,141,-439
2017,12,3,14,579,612,145,-467
2017,12,3,15,573,595,145,-450
2017,12,3,16,542,557,147,-410
2017,12,3,17,519,532,145,-387
2017,12,3,18,505,517,142,-375
2017,12,3,19,496,509,144,-365
2017,12,3,20,487,494,143,-351
2017,12,3,21,483,500,145,-355
2017,12,3,22,504,518,235,-283
2017,12,3,23,558,569,273,-296
2017,12,4,0,592,604,274,-330
2017,12,4,1,593,612,276,-336
2017,12,4,2,585,605,272,-333
2017,12,4,3,560,583,209,-374
2017,12,4,4,527,557,181,-376
2017,12,4,5,495,529,181,-348
2017,12,4,6,482,508,177,-331
2017,12,4,7,479,503,177,-326
2017,12,4,8,484,511,159,-352
2017,12,4,9,496,526,138,-388
2017,12,4,10,520,551,138,-413
2017,12,4,11,575,611,233,-378
2017,12,4,12,660,701,401,-300
2017,12,4,13,696,729,427,-302
2017,12,4,14,682,713,412,-301
2017,12,4,15,654,680,334,-346
2017,12,4,16,618,639,204,-435
2017,12,4,17,591,607,159,-448
2017,12,4,18,566,580,150,-430
2017,12,4,19,546,558,130,-428
2017,12,4,20,532,547,134,-413
2017,12,4,21,525,548,142,-406
2017,12,4,22,543,567,145,-422
2017,12,4,23,594,623,255,-368
2017,12,5,0,630,662,315,-347
2017,12,5,1,635,663,317,-346
2017,12,5,2,625,655,315,-340
2017,12,5,3,598,629,255,-374
2017,12,5,4,555,584,187,-397
2017,12,5,5,511,535,151,-384
2017,12,5,6,493,504,118,-386
2017,12,5,7,482,491,120,-371
2017,12,5,8,479,490,123,-367
2017,12,5,9,484,489,124,-365
2017,12,5,10,500,499,129,-370
2017,12,5,11,548,538,137,-401
2017,12,5,12,622,601,247,-354
2017,12,5,13,655,631,265,-366
2017,12,5,14,640,602,314,-288
2017,12,5,15,621,604,380,-224
2017,12,5,16,592,598,364,-234
2017,12,5,17,570,594,247,-347
2017,12,5,18,553,589,223,-366
2017,12,5,19,539,585,194,-391
2017,12,5,20,524,586,184,-402
2017,12,5,21,519,596,187,-409
2017,12,5,22,542,616,194,-422
2017,12,5,23,596,651,293,-358
2017,12,6,0,636,664,334,-330
2017,12,6,1,638,649,333,-316
2017,12,6,2,630,636,315,-321
2017,12,6,3,605,596,247,-349
2017,12,6,4,563,548,174,-374
2017,12,6,5,525,496,128,-368
2017,12,6,6,489,463,119,-344
2017,12,6,7,478,466,115,-351
2017,12,6,8,479,474,110,-364
2017,12,6,9,492,491,124,-367
2017,12,6,10,518,517,123,-394
2017,12,6,11,574,571,132,-439
2017,12,6,12,655,662,170,-492
2017,12,6,13,701,714,243,-471
2017,12,6,14,695,720,259,-461
2017,12,6,15,684,711,268,-443
2017,12,6,16,659,712,286,-426
2017,12,6,17,639,715,294,-421
2017,12,6,18,620,711,292,-419
2017,12,6,19,603,707,288,-419
2017,12,6,20,588,698,302,-396
2017,12,6,21,583,707,313,-394
2017,12,6,22,610,725,356,-369
2017,12,6,23,669,767,417,-350
2017,12,7,0,715,792,452,-340
2017,12,7,1,713,780,454,-326
2017,12,7,2,713,763,451,-312
2017,12,7,3,695,726,412,-314
2017,12,7,4,658,675,324,-351
2017,12,7,5,620,629,215,-414
2017,12,7,6,595,599,133,-466
2017,12,7,7,585,587,125,-462
2017,12,7,8,586,588,117,-471
2017,12,7,9,598,592,117,-475
2017,12,7,10,620,615,129,-486
2017,12,7,11,673,662,250,-412
2017,12,7,12,750,743,305,-438
2017,12,7,13,788,778,361,-417
2017,12,7,14,769,761,345,-416
2017,12,7,15,736,745,242,-503
2017,12,7,16,693,713,191,-522
2017,12,7,17,660,670,155,-515
2017,12,7,18,632,655,147,-508
2017,12,7,19,607,633,145,-488
2017,12,7,20,589,614,145,-469
2017,12,7,21,593,631,144,-487
2017,12,7,22,620,668,228,-440
2017,12,7,23,683,725,365,-360
2017,12,8,0,724,757,375,-382
2017,12,8,1,739,758,383,-375
2017,12,8,2,746,750,385,-365
2017,12,8,3,734,724,382,-342
2017,12,8,4,703,682,384,-298
2017,12,8,5,668,632,351,-281
2017,12,8,6,616,609,262,-347
2017,12,8,7,607,599,164,-435
2017,12,8,8,607,596,113,-483
2017,12,8,9,619,599,113,-486
2017,12,8,10,638,621,128,-493
2017,12,8,11,690,664,213,-451
2017,12,8,12,766,736,285,-451
2017,12,8,13,802,781,310,-471
2017,12,8,14,793,803,323,-480
2017,12,8,15,775,808,298,-510
2017,12,8,16,754,822,319,-503
2017,12,8,17,737,824,311,-513
2017,12,8,18,716,822,324,-498
2017,12,8,19,696,808,338,-470
2017,12,8,20,684,776,348,-428
2017,12,8,21,687,766,348,-418
2017,12,8,22,711,774,347,-427
2017,12,8,23,763,829,430,-399
2017,12,9,0,800,819,429,-390
2017,12,9,1,798,787,380,-407
2017,12,9,2,796,765,367,-398
2017,12,9,3,774,732,371,-361
2017,12,9,4,741,694,367,-327
2017,12,9,5,709,663,369,-294
2017,12,9,6,655,640,366,-274
2017,12,9,7,642,627,367,-260
2017,12,9,8,633,624,335,-289
2017,12,9,9,634,633,322,-311
2017,12,9,10,644,632,322,-310
2017,12,9,11,669,646,348,-298
2017,12,9,12,704,674,383,-291
2017,12,9,13,745,683,382,-301
2017,12,9,14,773,723,383,-340
2017,12,9,15,774,743,383,-360
2017,12,9,16,757,749,384,-365
2017,12,9,17,725,741,383,-358
2017,12,9,18,689,737,380,-357
2017,12,9,19,672,718,381,-337
2017,12,9,20,664,688,383,-305
2017,12,9,21,667,677,392,-285
2017,12,9,22,695,722,452,-270
2017,12,9,23,751,794,481,-313
2017,12,10,0,797,819,485,-334
2017,12,10,1,791,811,486,-325
2017,12,10,2,800,795,486,-309
2017,12,10,3,783,788,490,-298
2017,12,10,4,749,767,491,-276
2017,12,10,5,724,733,433,-300
2017,12,10,6,716,708,389,-319
2017,12,10,7,709,699,391,-308
2017,12,10,8,714,688,389,-299
2017,12,10,9,726,699,392,-307
2017,12,10,10,739,705,390,-315
2017,12,10,11,764,730,485,-245
2017,12,10,12,808,764,491,-273
2017,12,10,13,852,805,492,-313
2017,12,10,14,885,834,490,-344
2017,12,10,15,865,826,416,-410
2017,12,10,16,814,801,290,-511
2017,12,10,17,761,768,256,-512
2017,12,10,18,731,738,225,-513
2017,12,10,19,699,698,189,-509
2017,12,10,20,678,677,164,-513
2017,12,10,21,679,668,194,-474
2017,12,10,22,704,704,331,-373
2017,12,10,23,781,775,419,-356
2017,12,11,0,822,826,404,-422
2017,12,11,1,814,819,399,-420
2017,12,11,2,806,812,422,-390
2017,12,11,3,775,788,378,-410
2017,12,11,4,742,753,359,-394
2017,12,11,5,713,721,293,-428
2017,12,11,6,671,698,265,-433
2017,12,11,7,666,683,220,-463
2017,12,11,8,669,685,191,-494
2017,12,11,9,680,692,201,-491
2017,12,11,10,702,708,295,-413
2017,12,11,11,759,756,441,-315
2017,12,11,12,831,816,445,-371
2017,12,11,13,869,843,489,-354
2017,12,11,14,852,870,502,-368
2017,12,11,15,813,823,327,-496
2017,12,11,16,762,765,251,-514
2017,12,11,17,726,713,205,-508
2017,12,11,18,687,672,165,-507
2017,12,11,19,649,649,138,-511
2017,12,11,20,619,624,122,-502
2017,12,11,21,614,623,127,-496
2017,12,11,22,639,646,160,-486
2017,12,11,23,696,716,249,-467
2017,12,12,0,748,760,307,-453
2017,12,12,1,745,763,294,-469
2017,12,12,2,738,757,388,-369
2017,12,12,3,715,737,391,-346
2017,12,12,4,676,699,392,-307
2017,12,12,5,634,665,348,-317
2017,12,12,6,586,641,189,-452
2017,12,12,7,574,627,120,-507
2017,12,12,8,578,623,118,-505
2017,12,12,9,588,628,119,-509
2017,12,12,10,611,646,135,-511
2017,12,12,11,662,686,269,-417
2017,12,12,12,735,753,403,-350
2017,12,12,13,774,781,431,-350
2017,12,12,14,766,776,300,-476
2017,12,12,15,753,778,263,-515
2017,12,12,16,728,771,260,-511
2017,12,12,17,715,763,249,-514
2017,12,12,18,700,736,224,-512
2017,12,12,19,690,722,209,-513
2017,12,12,20,689,712,199,-513
2017,12,12,21,713,729,220,-509
2017,12,12,22,746,770,255,-515
2017,12,12,23,809,842,333,-509
2017,12,13,0,852,862,441,-421
2017,12,13,1,862,883,459,-424
2017,12,13,2,867,886,421,-465
2017,12,13,3,842,862,423,-439
2017,12,13,4,799,831,356,-475
2017,12,13,5,769,797,294,-503
2017,12,13,6,728,781,271,-510
2017,12,13,7,724,780,269,-511
2017,12,13,8,735,786,294,-492
2017,12,13,9,750,796,327,-469
2017,12,13,10,772,817,377,-440
2017,12,13,11,821,865,452,-413
2017,12,13,12,898,940,554,-386
2017,12,13,13,935,975,556,-419
2017,12,13,14,915,957,547,-410
2017,12,13,15,882,902,522,-380
2017,12,13,16,832,847,448,-399
2017,12,13,17,778,797,387,-410
2017,12,13,18,736,757,315,-442
2017,12,13,19,701,720,247,-473
2017,12,13,20,672,694,231,-463
2017,12,13,21,663,686,228,-458
2017,12,13,22,697,717,249,-468
2017,12,13,23,769,784,374,-410
2017,12,14,0,794,823,444,-379
2017,12,14,1,788,824,433,-391
2017,12,14,2,780,816,384,-432
2017,12,14,3,754,788,382,-406
2017,12,14,4,707,740,379,-361
2017,12,14,5,665,697,310,-387
2017,12,14,6,658,666,171,-495
2017,12,14,7,650,643,164,-479
2017,12,14,8,650,634,169,-465
2017,12,14,9,662,634,146,-488
2017,12,14,10,680,639,144,-495
2017,12,14,11,733,680,171,-509
2017,12,14,12,806,753,380,-373
2017,12,14,13,845,785,417,-368
2017,12,14,14,829,774,387,-387
2017,12,14,15,801,736,289,-447
2017,12,14,16,762,702,245,-457
2017,12,14,17,728,663,220,-443
2017,12,14,18,702,642,194,-448
2017,12,14,19,676,618,138,-480
2017,12,14,20,655,605,125,-480
2017,12,14,21,659,601,125,-476
2017,12,14,22,687,630,147,-483
2017,12,14,23,754,690,204,-486
2017,12,15,0,780,735,283,-452
2017,12,15,1,781,746,288,-458
2017,12,15,2,778,749,257,-492
2017,12,15,3,753,740,228,-512
2017,12,15,4,715,707,197,-510
2017,12,15,5,675,675,165,-510
2017,12,15,6,649,659,148,-511
2017,12,15,7,641,655,116,-539
2017,12,15,8,649,653,109,-544
2017,12,15,9,660,654,113,-541
2017,12,15,10,681,671,115,-556
2017,12,15,11,738,715,227,-488
2017,12,15,12,809,800,292,-508
2017,12,15,13,849,840,334,-506
2017,12,15,14,847,836,312,-524
2017,12,15,15,820,814,250,-564
2017,12,15,16,781,781,217,-564
2017,12,15,17,743,753,191,-562
2017,12,15,18,701,737,201,-536
2017,12,15,19,676,741,219,-522
2017,12,15,20,656,743,178,-565
2017,12,15,21,655,755,204,-551
2017,12,15,22,686,780,220,-560
2017,12,15,23,751,831,281,-550
2017,12,16,0,787,855,300,-555
2017,12,16,1,780,861,297,-564
2017,12,16,2,781,850,288,-562
2017,12,16,3,762,836,272,-564
2017,12,16,4,732,799,239,-560
2017,12,16,5,698,763,201,-562
2017,12,16,6,665,736,175,-561
2017,12,16,7,659,724,206,-518
2017,12,16,8,658,717,203,-514
2017,12,16,9,666,719,206,-513
2017,12,16,10,679,730,306,-424
2017,12,16,11,708,757,483,-274
2017,12,16,12,746,797,484,-313
2017,12,16,13,782,843,488,-355
2017,12,16,14,800,868,484,-384
2017,12,16,15,780,841,418,-423
2017,12,16,16,744,783,267,-516
2017,12,16,17,700,725,214,-511
2017,12,16,18,659,676,163,-513
2017,12,16,19,621,637,127,-510
2017,12,16,20,596,612,115,-497
2017,12,16,21,591,614,135,-479
2017,12,16,22,624,640,160,-480
2017,12,16,23,681,699,224,-475
2017,12,17,0,726,730,255,-475
2017,12,17,1,715,735,252,-483
2017,12,17,2,710,738,284,-454
2017,12,17,3,693,734,277,-457
2017,12,17,4,666,717,266,-451
2017,12,17,5,635,691,234,-457
2017,12,17,6,606,663,180,-483
2017,12,17,7,592,661,179,-482
2017,12,17,8,592,666,185,-481
2017,12,17,9,600,670,241,-429
2017,12,17,10,615,687,309,-378
2017,12,17,11,641,710,440,-270
2017,12,17,12,676,740,470,-270
2017,12,17,13,723,779,467,-312
2017,12,17,14,752,813,468,-345
2017,12,17,15,733,817,369,-448
2017,12,17,16,686,782,265,-517
2017,12,17,17,643,749,240,-509
2017,12,17,18,613,711,195,-516
2017,12,17,19,582,675,160,-515
2017,12,17,20,565,662,144,-518
2017,12,17,21,562,666,148,-518
2017,12,17,22,586,686,168,-518
2017,12,17,23,630,717,199,-518
2017,12,18,0,667,721,204,-517
2017,12,18,1,663,718,220,-498
2017,12,18,2,659,707,222,-485
2017,12,18,3,631,678,166,-512
2017,12,18,4,601,640,129,-511
2017,12,18,5,568,603,118,-485
2017,12,18,6,570,573,115,-458
2017,12,18,7,555,573,117,-456
2017,12,18,8,554,571,116,-455
2017,12,18,9,558,583,115,-468
2017,12,18,10,575,601,124,-477
2017,12,18,11,620,645,226,-419
2017,12,18,12,691,714,273,-441
2017,12,18,13,729,752,310,-442
2017,12,18,14,719,743,306,-437
2017,12,18,15,700,728,245,-483
2017,12,18,16,671,696,180,-516
2017,12,18,17,637,660,145,-515
2017,12,18,18,612,621,121,-500
2017,12,18,19,595,588,119,-469
2017,12,18,20,577,573,120,-453
2017,12,18,21,577,565,135,-430
2017,12,18,22,592,582,174,-408
2017,12,18,23,633,634,196,-438
2017,12,19,0,662,674,210,-464
2017,12,19,1,666,675,161,-514
2017,12,19,2,659,676,165,-511
2017,12,19,3,632,653,189,-464
2017,12,19,4,590,615,140,-475
2017,12,19,5,538,575,120,-455
2017,12,19,6,524,546,117,-429
2017,12,19,7,514,541,128,-413
2017,12,19,8,513,539,119,-420
2017,12,19,9,517,546,119,-427
2017,12,19,10,536,567,119,-448
2017,12,19,11,585,610,146,-464
2017,12,19,12,661,690,258,-432
2017,12,19,13,697,731,332,-399
2017,12,19,14,682,722,335,-387
2017,12,19,15,659,711,321,-390
2017,12,19,16,620,647,186,-461
2017,12,19,17,587,614,140,-474
2017,12,19,18,563,582,119,-463
2017,12,19,19,557,566,119,-447
2017,12,19,20,544,549,117,-432
2017,12,19,21,545,548,117,-431
2017,12,19,22,565,565,118,-447
2017,12,19,23,597,602,140,-462
2017,12,20,0,620,636,266,-370
2017,12,20,1,618,630,195,-435
2017,12,20,2,610,616,142,-474
2017,12,20,3,579,591,117,-474
2017,12,20,4,530,543,116,-427
2017,12,20,5,483,501,119,-382
2017,12,20,6,451,465,117,-348
2017,12,20,7,434,442,107,-335
2017,12,20,8,425,445,117,-328
2017,12,20,9,426,444,117,-327
2017,12,20,10,439,452,117,-335
2017,12,20,11,478,491,149,-342
2017,12,20,12,547,540,181,-359
2017,12,20,13,597,584,181,-403
2017,12,20,14,602,598,184,-414
2017,12,20,15,606,610,182,-428
2017,12,20,16,594,618,146,-472
2017,12,20,17,584,618,170,-448
2017,12,20,18,575,598,181,-417
2017,12,20,19,574,600,182,-418
2017,12,20,20,573,585,182,-403
2017,12,20,21,579,593,211,-382
2017,12,20,22,604,604,244,-360
2017,12,20,23,656,639,289,-350
2017,12,21,0,683,647,310,-337
2017,12,21,1,677,641,275,-366
2017,12,21,2,678,625,274,-351
2017,12,21,3,656,607,268,-339
2017,12,21,4,622,566,168,-398
2017,12,21,5,583,526,158,-368
2017,12,21,6,534,500,150,-350
2017,12,21,7,519,483,178,-305
2017,12,21,8,520,479,218,-261
2017,12,21,9,522,478,217,-261
2017,12,21,10,540,487,216,-271
2017,12,21,11,577,525,227,-298
2017,12,21,12,637,584,251,-333
2017,12,21,13,689,625,288,-337
2017,12,21,14,699,640,291,-349
2017,12,21,15,697,643,238,-405
2017,12,21,16,673,637,220,-417
2017,12,21,17,652,617,220,-397
2017,12,21,18,630,593,219,-374
2017,12,21,19,612,573,209,-364
2017,12,21,20,597,576,193,-383
2017,12,21,21,597,578,189,-389
2017,12,21,22,613,599,196,-403
2017,12,21,23,672,631,305,-326
2017,12,22,0,710,659,394,-265
2017,12,22,1,710,653,396,-257
2017,12,22,2,707,645,372,-273
2017,12,22,3,689,624,289,-335
2017,12,22,4,658,594,195,-399
2017,12,22,5,618,552,168,-384
2017,12,22,6,552,517,120,-397
2017,12,22,7,533,499,103,-396
2017,12,22,8,532,498,115,-383
2017,12,22,9,530,494,112,-382
2017,12,22,10,542,507,119,-388
2017,12,22,11,570,542,219,-323
2017,12,22,12,609,590,226,-364
2017,12,22,13,658,628,226,-402
2017,12,22,14,675,652,229,-423
2017,12,22,15,673,650,225,-425
2017,12,22,16,645,632,212,-420
2017,12,22,17,608,593,134,-459
2017,12,22,18,577,561,126,-435
2017,12,22,19,555,544,127,-417
2017,12,22,20,536,536,126,-410
2017,12,22,21,531,539,139,-400
2017,12,22,22,535,553,158,-395
2017,12,22,23,575,590,260,-330
2017,12,23,0,595,602,259,-343
2017,12,23,1,588,595,196,-399
2017,12,23,2,577,581,196,-385
2017,12,23,3,567,557,168,-389
2017,12,23,4,550,526,148,-378
2017,12,23,5,518,490,65,-425
2017,12,23,6,475,457,62,-395
2017,12,23,7,456,435,61,-374
2017,12,23,8,446,427,60,-367
2017,12,23,9,440,419,70,-349
2017,12,23,10,448,423,99,-324
2017,12,23,11,459,434,143,-291
2017,12,23,12,478,454,165,-289
2017,12,23,13,527,485,180,-305
2017,12,23,14,571,516,180,-336
2017,12,23,15,586,528,188,-340
2017,12,23,16,567,539,187,-352
2017,12,23,17,536,541,168,-373
2017,12,23,18,511,532,118,-414
2017,12,23,19,492,528,117,-411
2017,12,23,20,489,525,144,-381
2017,12,23,21,483,522,152,-370
2017,12,23,22,496,529,181,-348
2017,12,23,23,539,552,215,-337
2017,12,24,0,558,574,233,-341
2017,12,24,1,559,573,242,-331
2017,12,24,2,548,572,220,-352
2017,12,24,3,538,557,215,-342
2017,12,24,4,517,537,219,-318
2017,12,24,5,482,504,214,-290
2017,12,24,6,448,478,215,-263
2017,12,24,7,428,458,206,-252
2017,12,24,8,421,449,195,-254
2017,12,24,9,421,451,156,-295
2017,12,24,10,433,455,113,-342
2017,12,24,11,451,469,114,-355
2017,12,24,12,477,498,114,-384
2017,12,24,13,525,542,119,-423
2017,12,24,14,577,578,184,-394
2017,12,24,15,598,593,185,-408
2017,12,24,16,590,583,185,-398
2017,12,24,17,568,554,186,-368
2017,12,24,18,557,539,187,-352
2017,12,24,19,541,522,186,-336
2017,12,24,20,533,513,185,-328
2017,12,24,21,533,515,191,-324
2017,12,24,22,548,523,214,-309
2017,12,24,23,612,561,216,-345
2017,12,25,0,632,569,216,-353
2017,12,25,1,645,565,209,-356
2017,12,25,2,641,566,176,-390
2017,12,25,3,629,559,139,-420
2017,12,25,4,604,553,117,-436
2017,12,25,5,583,546,146,-400
2017,12,25,6,584,536,162,-374
2017,12,25,7,572,545,152,-393
2017,12,25,8,575,559,151,-408
2017,12,25,9,586,579,148,-431
2017,12,25,10,603,605,153,-452
2017,12,25,11,633,639,195,-444
2017,12,25,12,671,683,202,-481
2017,12,25,13,721,740,304,-436
2017,12,25,14,755,793,321,-472
2017,12,25,15,745,808,304,-504
2017,12,25,16,722,802,293,-509
2017,12,25,17,694,789,277,-512
2017,12,25,18,651,767,257,-510
2017,12,25,19,610,726,227,-499
2017,12,25,20,591,703,221,-482
2017,12,25,21,583,715,225,-490
2017,12,25,22,607,730,225,-505
2017,12,25,23,668,769,286,-483
2017,12,26,0,708,791,341,-450
2017,12,26,1,727,793,351,-442
2017,12,26,2,731,796,352,-444
2017,12,26,3,724,781,315,-466
2017,12,26,4,705,757,276,-481
2017,12,26,5,684,723,253,-470
2017,12,26,6,680,695,218,-477
2017,12,26,7,673,686,185,-501
2017,12,26,8,688,674,139,-535
2017,12,26,9,695,673,122,-551
2017,12,26,10,715,686,164,-522
2017,12,26,11,753,707,214,-493
2017,12,26,12,801,744,281,-463
2017,12,26,13,845,775,282,-493
2017,12,26,14,860,792,282,-510
2017,12,26,15,839,795,272,-523
2017,12,26,16,807,764,206,-558
2017,12,26,17,765,710,183,-527
2017,12,26,18,720,662,198,-464
2017,12,26,19,686,628,190,-438
2017,12,26,20,664,608,187,-421
2017,12,26,21,667,603,188,-415
2017,12,26,22,681,630,189,-441
2017,12,26,23,752,700,277,-423
2017,12,27,0,796,752,325,-427
2017,12,27,1,806,763,321,-442
2017,12,27,2,801,760,318,-442
2017,12,27,3,781,743,315,-428
2017,12,27,4,744,718,246,-472
2017,12,27,5,715,691,220,-471
2017,12,27,6,654,661,209,-452
2017,12,27,7,650,659,209,-450
2017,12,27,8,653,663,209,-454
2017,12,27,9,664,677,210,-467
2017,12,27,10,694,703,212,-491
2017,12,27,11,734,750,316,-434
2017,12,27,12,787,787,320,-467
2017,12,27,13,844,820,329,-491
2017,12,27,14,857,831,329,-502
2017,12,27,15,836,827,325,-502
2017,12,27,16,804,797,258,-539
2017,12,27,17,771,767,228,-539
2017,12,27,18,733,735,211,-524
2017,12,27,19,700,712,190,-522
2017,12,27,20,677,702,170,-532
2017,12,27,21,675,689,180,-509
2017,12,27,22,696,732,277,-455
2017,12,27,23,763,801,426,-375
2017,12,28,0,811,836,466,-370
2017,12,28,1,813,833,449,-384
2017,12,28,2,806,825,373,-452
2017,12,28,3,788,809,372,-437
2017,12,28,4,754,778,361,-417
2017,12,28,5,719,748,365,-383
2017,12,28,6,711,737,364,-373
2017,12,28,7,707,740,364,-376
2017,12,28,8,715,748,364,-384
2017,12,28,9,730,771,365,-406
2017,12,28,10,758,799,369,-430
2017,12,28,11,799,842,374,-468
2017,12,28,12,847,907,542,-365
2017,12,28,13,896,952,550,-402
2017,12,28,14,913,966,552,-414
2017,12,28,15,898,925,504,-421
2017,12,28,16,876,858,424,-434
2017,12,28,17,833,810,386,-424
2017,12,28,18,791,754,386,-368
2017,12,28,19,752,714,385,-329
2017,12,28,20,723,687,387,-300
2017,12,28,21,713,682,386,-296
2017,12,28,22,741,708,382,-326
2017,12,28,23,816,777,430,-347
2017,12,29,0,861,834,458,-376
2017,12,29,1,864,837,453,-384
2017,12,29,2,856,841,455,-386
2017,12,29,3,833,822,416,-406
2017,12,29,4,788,791,383,-408
2017,12,29,5,759,763,385,-378
2017,12,29,6,706,735,382,-353
2017,12,29,7,700,722,384,-338
2017,12,29,8,710,719,383,-336
2017,12,29,9,723,726,383,-343
2017,12,29,10,746,747,383,-364
2017,12,29,11,789,782,418,-364
2017,12,29,12,835,833,550,-283
2017,12,29,13,882,875,551,-324
2017,12,29,14,895,884,554,-330
2017,12,29,15,866,850,534,-316
2017,12,29,16,819,795,434,-361
2017,12,29,17,773,758,383,-375
2017,12,29,18,725,716,357,-359
2017,12,29,19,680,683,266,-417
2017,12,29,20,648,662,232,-430
2017,12,29,21,638,645,225,-420
2017,12,29,22,664,661,228,-433
2017,12,29,23,730,719,318,-401
2017,12,30,0,756,770,403,-367
2017,12,30,1,753,775,412,-363
2017,12,30,2,749,782,416,-366
2017,12,30,3,734,768,389,-379
2017,12,30,4,712,740,351,-389
2017,12,30,5,683,708,332,-376
2017,12,30,6,618,680,282,-398
2017,12,30,7,606,657,247,-410
2017,12,30,8,605,656,235,-421
2017,12,30,9,611,656,233,-423
2017,12,30,10,627,672,307,-365
2017,12,30,11,644,695,385,-310
2017,12,30,12,673,721,408,-313
2017,12,30,13,713,763,405,-358
2017,12,30,14,746,787,318,-469
2017,12,30,15,739,787,226,-561
2017,12,30,16,725,756,194,-562
2017,12,30,17,702,715,155,-560
2017,12,30,18,671,685,128,-557
2017,12,30,19,644,666,114,-552
2017,12,30,20,626,658,115,-543
2017,12,30,21,614,664,115,-549
2017,12,30,22,633,685,138,-547
2017,12,30,23,695,747,226,-521
2017,12,31,0,727,786,252,-534
2017,12,31,1,730,794,263,-531
2017,12,31,2,719,785,239,-546
2017,12,31,3,703,769,224,-545
2017,12,31,4,679,743,224,-519
2017,12,31,5,657,714,196,-518
2017,12,31,6,654,683,173,-510
2017,12,31,7,647,669,142,-527
2017,12,31,8,649,664,136,-528
2017,12,31,9,657,673,164,-509
2017,12,31,10,673,680,247,-433
2017,12,31,11,692,707,318,-389
2017,12,31,12,716,736,362,-374
2017,12,31,13,766,781,387,-394
2017,12,31,14,806,823,450,-373
2017,12,31,15,804,842,451,-391
2017,12,31,16,780,832,398,-434
2017,12,31,17,750,825,377,-448
2017,12,31,18,725,828,375,-453
2017,12,31,19,701,829,376,-453
2017,12,31,20,693,838,378,-460
2017,12,31,21,692,853,377,-476
2017,12,31,22,726,877,382,-495
2017,12,31,23,786,919,432,-487
2018,1,1,0,832,911,476,-434
2018,1,1,1,823,913,518,-395
2018,1,1,2,825,893,503,-390
2018,1,1,3,806,875,461,-414
2018,1,1,4,786,847,456,-391
2018,1,1,5,790,838,455,-383
2018,1,1,6,795,829,460,-369
2018,1,1,7,793,830,460,-370
2018,1,1,8,804,832,461,-371
2018,1,1,9,817,844,464,-380
2018,1,1,10,836,862,462,-400
2018,1,1,11,854,900,465,-435
2018,1,1,12,861,941,466,-475
2018,1,1,13,884,979,454,-525
2018,1,1,14,933,1017,511,-506
2018,1,1,15,951,1022,511,-511
2018,1,1,16,934,1001,524,-477
2018,1,1,17,913,963,447,-516
2018,1,1,18,879,931,469,-462
2018,1,1,19,849,900,477,-423
2018,1,1,20,835,884,508,-376
2018,1,1,21,841,890,506,-384
2018,1,1,22,869,935,505,-430
2018,1,1,23,941,1030,591,-439
2018,1,2,0,975,1056,657,-399
2018,1,2,1,981,1062,702,-360
2018,1,2,2,970,1058,742,-316
2018,1,2,3,956,1043,722,-321
2018,1,2,4,931,1025,665,-360
2018,1,2,5,915,1004,663,-341
2018,1,2,6,936,986,704,-282
2018,1,2,7,942,995,700,-295
2018,1,2,8,959,1006,691,-315
2018,1,2,9,973,1021,689,-332
2018,1,2,10,1002,1048,689,-359
2018,1,2,11,1043,1081,737,-344
2018,1,2,12,1091,1131,776,-355
2018,1,2,13,1119,1169,780,-389
2018,1,2,14,1123,1182,776,-406
2018,1,2,15,1090,1141,706,-435
2018,1,2,16,1017,1072,659,-413
2018,1,2,17,961,1000,657,-343
2018,1,2,18,901,928,618,-310
2018,1,2,19,851,868,535,-333
2018,1,2,20,824,826,534,-292
2018,1,2,21,820,813,524,-289
2018,1,2,22,850,830,541,-289
2018,1,2,23,925,919,555,-364
2018,1,3,0,976,976,551,-425
2018,1,3,1,978,988,664,-324
2018,1,3,2,981,980,711,-269
2018,1,3,3,962,968,712,-256
2018,1,3,4,933,946,709,-237
2018,1,3,5,910,932,680,-252
2018,1,3,6,899,923,672,-251
2018,1,3,7,897,924,648,-276
2018,1,3,8,901,917,588,-329
2018,1,3,9,907,925,637,-288
2018,1,3,10,923,929,657,-272
2018,1,3,11,959,957,746,-211
2018,1,3,12,1014,939,729,-210
2018,1,3,13,1033,1005,768,-237
2018,1,3,14,1030,1000,750,-250
2018,1,3,15,1003,1016,640,-376
2018,1,3,16,954,963,588,-375
2018,1,3,17,901,920,559,-361
2018,1,3,18,851,877,520,-357
2018,1,3,19,813,831,526,-305
2018,1,3,20,776,800,534,-266
2018,1,3,21,765,787,532,-255
2018,1,3,22,773,813,532,-281
2018,1,3,23,840,880,600,-280
2018,1,4,0,911,939,597,-342
2018,1,4,1,910,937,522,-415
2018,1,4,2,902,935,515,-420
2018,1,4,3,877,918,517,-401
2018,1,4,4,846,885,491,-394
2018,1,4,5,815,852,445,-407
2018,1,4,6,796,829,444,-385
2018,1,4,7,791,824,510,-314
2018,1,4,8,811,832,516,-316
2018,1,4,9,820,856,515,-341
2018,1,4,10,843,875,514,-361
2018,1,4,11,888,908,516,-392
2018,1,4,12,958,991,582,-409
2018,1,4,13,992,1039,621,-418
2018,1,4,14,997,1042,618,-424
2018,1,4,15,971,1049,549,-500
2018,1,4,16,934,1033,513,-520
2018,1,4,17,891,1010,516,-494
2018,1,4,18,845,987,513,-474
2018,1,4,19,815,978,517,-461
2018,1,4,20,785,968,515,-453
2018,1,4,21,788,974,515,-459
2018,1,4,22,804,1013,515,-498
2018,1,4,23,873,1079,601,-478
2018,1,5,0,945,1137,653,-484
2018,1,5,1,952,1130,624,-506
2018,1,5,2,950,1129,562,-567
2018,1,5,3,939,1103,541,-562
2018,1,5,4,905,1071,516,-555
2018,1,5,5,881,1040,546,-494
2018,1,5,6,864,1025,622,-403
2018,1,5,7,868,1021,551,-470
2018,1,5,8,880,1038,683,-355
2018,1,5,9,893,1035,610,-425
2018,1,5,10,924,1063,613,-450
2018,1,5,11,970,1083,637,-446
2018,1,5,12,1031,1138,717,-421
2018,1,5,13,1060,1172,687,-485
2018,1,5,14,1066,1167,611,-556
2018,1,5,15,1038,1145,615,-530
2018,1,5,16,987,1107,615,-492
2018,1,5,17,940,1047,579,-468
2018,1,5,18,883,1004,516,-488
2018,1,5,19,841,964,515,-449
2018,1,5,20,812,932,516,-416
2018,1,5,21,813,934,507,-427
2018,1,5,22,832,964,514,-450
2018,1,5,23,904,1018,527,-491
2018,1,6,0,972,1066,608,-458
2018,1,6,1,970,1055,610,-445
2018,1,6,2,971,1053,611,-442
2018,1,6,3,964,1034,561,-473
2018,1,6,4,948,1015,535,-480
2018,1,6,5,932,989,545,-444
2018,1,6,6,916,977,542,-435
2018,1,6,7,922,973,544,-429
2018,1,6,8,943,983,546,-437
2018,1,6,9,949,1000,546,-454
2018,1,6,10,976,1018,544,-474
2018,1,6,11,999,1040,548,-492
2018,1,6,12,1025,1078,638,-440
2018,1,6,13,1070,1116,666,-450
2018,1,6,14,1098,1142,650,-492
2018,1,6,15,1077,1104,579,-525
2018,1,6,16,1016,1054,551,-503
2018,1,6,17,948,1002,555,-447
2018,1,6,18,880,946,548,-398
2018,1,6,19,824,899,482,-417
2018,1,6,20,784,868,475,-393
2018,1,6,21,777,861,473,-388
2018,1,6,22,785,891,483,-408
2018,1,6,23,872,964,535,-429
2018,1,7,0,931,1010,580,-430
2018,1,7,1,942,1023,691,-332
2018,1,7,2,952,1025,707,-318
2018,1,7,3,933,1012,696,-316
2018,1,7,4,913,999,661,-338
2018,1,7,5,893,988,702,-286
2018,1,7,6,853,978,683,-295
2018,1,7,7,849,987,705,-282
2018,1,7,8,863,1004,710,-294
2018,1,7,9,870,1018,712,-306
2018,1,7,10,888,1027,707,-320
2018,1,7,11,917,1040,711,-329
2018,1,7,12,937,1069,730,-339
2018,1,7,13,977,1103,816,-287
2018,1,7,14,1015,1124,813,-311
2018,1,7,15,990,1085,777,-308
2018,1,7,16,923,998,577,-421
2018,1,7,17,864,932,524,-408
2018,1,7,18,813,881,471,-410
2018,1,7,19,768,824,451,-373
2018,1,7,20,733,792,452,-340
2018,1,7,21,722,799,472,-327
2018,1,7,22,730,818,620,-198
2018,1,7,23,803,866,650,-216
2018,1,8,0,843,905,650,-255
2018,1,8,1,851,900,648,-252
2018,1,8,2,839,897,650,-247
2018,1,8,3,794,874,655,-219
2018,1,8,4,764,837,626,-211
2018,1,8,5,733,807,590,-217
2018,1,8,6,712,789,508,-281
2018,1,8,7,700,781,541,-240
2018,1,8,8,703,780,575,-205
2018,1,8,9,709,781,584,-197
2018,1,8,10,722,787,581,-206
2018,1,8,11,770,801,562,-239
2018,1,8,12,839,844,508,-336
2018,1,8,13,865,871,526,-345
2018,1,8,14,872,870,605,-265
2018,1,8,15,854,859,436,-423
2018,1,8,16,822,856,357,-499
2018,1,8,17,794,844,336,-508
2018,1,8,18,761,813,264,-549
2018,1,8,19,734,782,221,-561
2018,1,8,20,708,755,199,-556
2018,1,8,21,712,744,191,-553
2018,1,8,22,728,753,210,-543
2018,1,8,23,779,780,261,-519
2018,1,9,0,819,800,297,-503
2018,1,9,1,822,791,340,-451
2018,1,9,2,802,765,400,-365
2018,1,9,3,770,736,395,-341
2018,1,9,4,727,694,314,-380
2018,1,9,5,687,657,222,-435
2018,1,9,6,649,628,165,-463
2018,1,9,7,627,617,132,-485
2018,1,9,8,613,613,120,-493
2018,1,9,9,613,611,126,-485
2018,1,9,10,622,635,131,-504
2018,1,9,11,657,690,181,-509
2018,1,9,12,721,770,373,-397
2018,1,9,13,750,810,416,-394
2018,1,9,14,753,799,417,-382
2018,1,9,15,749,769,369,-400
2018,1,9,16,730,658,283,-375
2018,1,9,17,711,659,213,-446
2018,1,9,18,683,611,177,-434
2018,1,9,19,667,589,123,-466
2018,1,9,20,646,568,111,-457
2018,1,9,21,644,569,120,-449
2018,1,9,22,656,586,211,-375
2018,1,9,23,694,612,220,-392
2018,1,10,0,721,658,243,-415
2018,1,10,1,712,663,251,-412
2018,1,10,2,700,646,183,-463
2018,1,10,3,666,625,123,-502
2018,1,10,4,621,591,108,-483
2018,1,10,5,583,558,114,-444
2018,1,10,6,557,537,112,-425
2018,1,10,7,542,527,112,-415
2018,1,10,8,538,522,111,-411
2018,1,10,9,544,524,112,-412
2018,1,10,10,561,540,113,-427
2018,1,10,11,603,579,129,-450
2018,1,10,12,677,651,244,-407
2018,1,10,13,715,685,267,-418
2018,1,10,14,719,681,258,-423
2018,1,10,15,716,666,235,-431
2018,1,10,16,704,661,236,-425
2018,1,10,17,690,649,230,-419
2018,1,10,18,672,628,153,-475
2018,1,10,19,655,615,146,-469
2018,1,10,20,640,608,147,-461
2018,1,10,21,637,606,143,-463
2018,1,10,22,651,613,156,-457
2018,1,10,23,688,651,174,-477
2018,1,11,0,714,685,222,-463
2018,1,11,1,698,679,247,-432
2018,1,11,2,686,662,221,-441
2018,1,11,3,648,634,138,-496
2018,1,11,4,604,581,118,-463
2018,1,11,5,558,534,113,-421
2018,1,11,6,536,509,112,-397
2018,1,11,7,516,498,113,-385
2018,1,11,8,507,492,115,-377
2018,1,11,9,508,493,114,-379
2018,1,11,10,519,505,113,-392
2018,1,11,11,559,541,166,-375
2018,1,11,12,629,613,346,-267
2018,1,11,13,662,648,378,-270
2018,1,11,14,657,642,341,-301
2018,1,11,15,656,637,263,-374
2018,1,11,16,636,632,219,-413
2018,1,11,17,633,625,171,-454
2018,1,11,18,618,615,121,-494
2018,1,11,19,611,605,115,-490
2018,1,11,20,600,597,114,-483
2018,1,11,21,596,600,177,-423
2018,1,11,22,617,620,221,-399
2018,1,11,23,650,634,219,-415
2018,1,12,0,675,658,254,-404
2018,1,12,1,668,648,255,-393
2018,1,12,2,651,625,252,-373
2018,1,12,3,613,588,283,-305
2018,1,12,4,569,538,263,-275
2018,1,12,5,528,492,233,-259
2018,1,12,6,464,459,234,-225
2018,1,12,7,446,443,223,-220
2018,1,12,8,436,431,221,-210
2018,1,12,9,436,431,220,-211
2018,1,12,10,449,437,218,-219
2018,1,12,11,485,471,233,-238
2018,1,12,12,551,537,248,-289
2018,1,12,13,590,570,248,-322
2018,1,12,14,596,570,218,-352
2018,1,12,15,596,573,209,-364
2018,1,12,16,591,580,216,-364
2018,1,12,17,583,583,215,-368
2018,1,12,18,571,574,210,-364
2018,1,12,19,561,563,211,-352
2018,1,12,20,551,557,211,-346
2018,1,12,21,548,561,210,-351
2018,1,12,22,557,585,211,-374
2018,1,12,23,596,610,210,-400
2018,1,13,0,629,624,213,-411
2018,1,13,1,632,609,208,-401
2018,1,13,2,622,605,211,-394
2018,1,13,3,602,592,209,-383
2018,1,13,4,575,591,208,-383
2018,1,13,5,546,584,207,-377
2018,1,13,6,510,585,208,-377
2018,1,13,7,512,603,209,-394
2018,1,13,8,520,618,208,-410
2018,1,13,9,537,639,223,-416
2018,1,13,10,566,666,262,-404
2018,1,13,11,605,707,282,-425
2018,1,13,12,656,759,297,-462
2018,1,13,13,707,815,407,-408
2018,1,13,14,757,873,479,-394
2018,1,13,15,778,907,485,-422
2018,1,13,16,778,923,488,-435
2018,1,13,17,764,924,498,-426
2018,1,13,18,741,904,529,-375
2018,1,13,19,722,873,508,-365
2018,1,13,20,702,846,506,-340
2018,1,13,21,705,847,508,-339
2018,1,13,22,743,876,526,-350
2018,1,13,23,805,930,571,-359
2018,1,14,0,847,969,610,-359
2018,1,14,1,859,966,612,-354
2018,1,14,2,867,961,613,-348
2018,1,14,3,854,941,611,-330
2018,1,14,4,837,910,596,-314
2018,1,14,5,819,888,533,-355
2018,1,14,6,817,875,512,-363
2018,1,14,7,809,869,511,-358
2018,1,14,8,815,876,508,-368
2018,1,14,9,823,890,516,-374
2018,1,14,10,835,912,530,-382
2018,1,14,11,850,940,583,-357
2018,1,14,12,878,966,584,-382
2018,1,14,13,917,1011,607,-404
2018,1,14,14,942,1043,633,-410
2018,1,14,15,922,1010,661,-349
2018,1,14,16,878,943,635,-308
2018,1,14,17,824,903,612,-291
2018,1,14,18,781,867,548,-319
2018,1,14,19,740,824,548,-276
2018,1,14,20,723,783,550,-233
2018,1,14,21,707,766,550,-216
2018,1,14,22,729,770,551,-219
2018,1,14,23,800,826,548,-278
2018,1,15,0,857,886,548,-338
2018,1,15,1,866,893,549,-344
2018,1,15,2,864,893,544,-349
2018,1,15,3,839,885,540,-345
2018,1,15,4,813,861,537,-324
2018,1,15,5,804,840,529,-311
2018,1,15,6,767,829,484,-345
2018,1,15,7,761,835,495,-340
2018,1,15,8,770,841,494,-347
2018,1,15,9,780,855,481,-374
2018,1,15,10,805,875,489,-386
2018,1,15,11,835,906,575,-331
2018,1,15,12,880,938,589,-349
2018,1,15,13,932,981,594,-387
2018,1,15,14,947,989,596,-393
2018,1,15,15,931,959,594,-365
2018,1,15,16,880,920,535,-385
2018,1,15,17,827,859,463,-396
2018,1,15,18,779,797,462,-335
2018,1,15,19,732,750,462,-288
2018,1,15,20,714,714,453,-261
2018,1,15,21,702,700,459,-241
2018,1,15,22,721,718,486,-232
2018,1,15,23,778,779,576,-203
2018,1,16,0,828,840,581,-259
2018,1,16,1,830,847,578,-269
2018,1,16,2,816,845,579,-266
2018,1,16,3,787,822,555,-267
2018,1,16,4,755,786,538,-248
2018,1,16,5,721,755,521,-234
2018,1,16,6,694,742,513,-229
2018,1,16,7,687,746,515,-231
2018,1,16,8,689,757,515,-242
2018,1,16,9,699,771,517,-254
2018,1,16,10,724,793,515,-278
2018,1,16,11,766,835,552,-283
2018,1,16,12,838,925,617,-308
2018,1,16,13,882,960,623,-337
2018,1,16,14,881,942,624,-318
2018,1,16,15,856,893,589,-304
2018,1,16,16,814,818,501,-317
2018,1,16,17,786,762,461,-301
2018,1,16,18,746,715,410,-305
2018,1,16,19,718,673,381,-292
2018,1,16,20,692,655,377,-278
2018,1,16,21,686,675,376,-299
2018,1,16,22,705,709,385,-324
2018,1,16,23,757,752,474,-278
2018,1,17,0,817,796,525,-271
2018,1,17,1,821,794,524,-270
2018,1,17,2,812,795,523,-272
2018,1,17,3,787,786,524,-262
2018,1,17,4,755,757,522,-235
2018,1,17,5,726,747,521,-226
2018,1,17,6,710,744,454,-290
2018,1,17,7,716,760,447,-313
2018,1,17,8,728,776,447,-329
2018,1,17,9,752,796,448,-348
2018,1,17,10,784,831,450,-381
2018,1,17,11,835,876,541,-335
2018,1,17,12,907,933,587,-346
2018,1,17,13,955,976,585,-391
2018,1,17,14,970,1005,585,-420
2018,1,17,15,973,1023,589,-434
2018,1,17,16,955,1018,587,-431
2018,1,17,17,936,1007,558,-449
2018,1,17,18,903,994,512,-482
2018,1,17,19,883,986,520,-466
2018,1,17,20,865,960,520,-440
2018,1,17,21,871,955,522,-433
2018,1,17,22,909,977,522,-455
2018,1,17,23,954,1052,615,-437
2018,1,18,0,998,1092,649,-443
2018,1,18,1,997,1085,644,-441
2018,1,18,2,991,1076,649,-427
2018,1,18,3,973,1051,647,-404
2018,1,18,4,944,1028,649,-379
2018,1,18,5,912,1014,657,-357
2018,1,18,6,959,1011,673,-338
2018,1,18,7,957,1018,601,-417
2018,1,18,8,958,1027,587,-440
2018,1,18,9,968,1042,657,-385
2018,1,18,10,987,1059,674,-385
2018,1,18,11,1017,1078,765,-313
2018,1,18,12,1057,1118,786,-332
2018,1,18,13,1092,1150,801,-349
2018,1,18,14,1079,1153,803,-350
2018,1,18,15,1035,1123,801,-322
2018,1,18,16,966,1047,710,-337
2018,1,18,17,896,972,551,-421
2018,1,18,18,829,907,503,-404
2018,1,18,19,773,857,459,-398
2018,1,18,20,747,810,407,-403
2018,1,18,21,745,781,371,-410
2018,1,18,22,767,793,390,-403
2018,1,18,23,814,842,429,-413
2018,1,19,0,878,901,480,-421
2018,1,19,1,877,904,489,-415
2018,1,19,2,877,893,507,-386
2018,1,19,3,850,867,508,-359
2018,1,19,4,808,832,429,-403
2018,1,19,5,779,804,390,-414
2018,1,19,6,811,790,388,-402
2018,1,19,7,805,790,388,-402
2018,1,19,8,809,794,389,-405
2018,1,19,9,816,811,390,-421
2018,1,19,10,842,837,394,-443
2018,1,19,11,877,883,554,-329
2018,1,19,12,936,943,553,-390
2018,1,19,13,971,993,555,-438
2018,1,19,14,960,988,554,-434
2018,1,19,15,909,929,503,-426
2018,1,19,16,836,846,322,-524
2018,1,19,17,780,788,223,-565
2018,1,19,18,735,731,194,-537
2018,1,19,19,701,698,193,-505
2018,1,19,20,669,660,255,-405
2018,1,19,21,666,643,297,-346
2018,1,19,22,677,647,306,-341
2018,1,19,23,724,693,307,-386
2018,1,20,0,773,755,378,-377
2018,1,20,1,772,770,351,-419
2018,1,20,2,760,769,292,-477
2018,1,20,3,735,765,332,-433
2018,1,20,4,714,746,401,-345
2018,1,20,5,684,724,308,-416
2018,1,20,6,653,705,280,-425
2018,1,20,7,645,711,272,-439
2018,1,20,8,647,723,256,-467
2018,1,20,9,655,726,253,-473
2018,1,20,10,671,743,285,-458
2018,1,20,11,692,757,316,-441
2018,1,20,12,729,782,360,-422
2018,1,20,13,768,808,424,-384
2018,1,20,14,791,822,425,-397
2018,1,20,15,761,804,372,-432
2018,1,20,16,714,751,305,-446
2018,1,20,17,685,696,196,-500
2018,1,20,18,643,648,183,-465
2018,1,20,19,609,612,169,-443
2018,1,20,20,588,578,123,-455
2018,1,20,21,585,565,116,-449
2018,1,20,22,592,570,116,-454
2018,1,20,23,631,600,179,-421
2018,1,21,0,666,639,276,-363
2018,1,21,1,662,649,311,-338
2018,1,21,2,649,644,284,-360
2018,1,21,3,626,637,201,-436
2018,1,21,4,601,615,188,-427
2018,1,21,5,567,596,157,-439
2018,1,21,6,553,582,155,-427
2018,1,21,7,537,579,154,-425
2018,1,21,8,536,589,155,-434
2018,1,21,9,539,598,158,-440
2018,1,21,10,551,614,240,-374
2018,1,21,11,568,641,316,-325
2018,1,21,12,595,674,347,-327
2018,1,21,13,636,722,358,-364
2018,1,21,14,679,752,361,-391
2018,1,21,15,677,733,271,-462
2018,1,21,16,640,663,173,-490
2018,1,21,17,614,607,124,-483
2018,1,21,18,587,585,119,-466
2018,1,21,19,560,568,121,-447
2018,1,21,20,538,549,122,-427
2018,1,21,21,538,531,121,-410
2018,1,21,22,546,535,189,-346
2018,1,21,23,581,568,261,-307
2018,1,22,0,613,618,306,-312
2018,1,22,1,619,626,234,-392
2018,1,22,2,602,615,215,-400
2018,1,22,3,572,598,202,-396
2018,1,22,4,544,569,169,-400
2018,1,22,5,507,540,114,-426
2018,1,22,6,491,514,101,-413
2018,1,22,7,483,515,105,-410
2018,1,22,8,483,528,111,-417
2018,1,22,9,492,538,113,-425
2018,1,22,10,515,562,131,-431
2018,1,22,11,562,608,222,-386
2018,1,22,12,632,686,413,-273
2018,1,22,13,684,727,484,-243
2018,1,22,14,692,724,424,-300
2018,1,22,15,686,707,322,-385
2018,1,22,16,653,686,246,-440
2018,1,22,17,646,655,143,-512
2018,1,22,18,618,619,125,-494
2018,1,22,19,597,596,126,-470
2018,1,22,20,584,589,126,-463
2018,1,22,21,584,594,124,-470
2018,1,22,22,592,615,158,-457
2018,1,22,23,621,645,220,-425
2018,1,23,0,663,678,315,-363
2018,1,23,1,664,672,312,-360
2018,1,23,2,646,649,233,-416
2018,1,23,3,613,611,175,-436
2018,1,23,4,578,557,176,-381
2018,1,23,5,536,505,127,-378
2018,1,23,6,514,472,111,-361
2018,1,23,7,501,458,112,-346
2018,1,23,8,492,454,112,-342
2018,1,23,9,493,453,114,-339
2018,1,23,10,510,467,123,-344
2018,1,23,11,550,514,173,-341
2018,1,23,12,613,591,173,-418
2018,1,23,13,657,632,173,-459
2018,1,23,14,656,627,173,-454
2018,1,23,15,657,616,177,-439
2018,1,23,16,638,600,177,-423
2018,1,23,17,635,583,154,-429
2018,1,23,18,618,569,118,-451
2018,1,23,19,613,559,118,-441
2018,1,23,20,605,547,116,-431
2018,1,23,21,610,548,114,-434
2018,1,23,22,628,571,118,-453
2018,1,23,23,658,617,174,-443
2018,1,24,0,706,682,175,-507
2018,1,24,1,712,696,180,-516
2018,1,24,2,701,691,185,-506
2018,1,24,3,674,669,184,-485
2018,1,24,4,642,634,152,-482
2018,1,24,5,612,598,119,-479
2018,1,24,6,577,578,117,-461
2018,1,24,7,570,575,118,-457
2018,1,24,8,574,582,118,-464
2018,1,24,9,591,595,115,-480
2018,1,24,10,621,621,125,-496
2018,1,24,11,668,672,190,-482
2018,1,24,12,752,757,298,-459
2018,1,24,13,800,796,427,-369
2018,1,24,14,795,788,424,-364
2018,1,24,15,768,762,285,-477
2018,1,24,16,733,722,206,-516
2018,1,24,17,700,683,194,-489
2018,1,24,18,671,650,220,-430
2018,1,24,19,650,628,253,-375
2018,1,24,20,629,610,250,-360
2018,1,24,21,629,613,251,-362
2018,1,24,22,643,637,274,-363
2018,1,24,23,682,699,375,-324
2018,1,25,0,752,761,372,-389
2018,1,25,1,760,771,371,-400
2018,1,25,2,757,770,374,-396
2018,1,25,3,735,747,372,-375
2018,1,25,4,699,708,360,-348
2018,1,25,5,667,671,215,-456
2018,1,25,6,641,656,158,-498
2018,1,25,7,637,650,159,-491
2018,1,25,8,643,661,161,-500
2018,1,25,9,657,669,170,-499
2018,1,25,10,684,689,190,-499
2018,1,25,11,731,741,326,-415
2018,1,25,12,810,826,380,-446
2018,1,25,13,857,861,384,-477
2018,1,25,14,847,839,387,-452
2018,1,25,15,807,796,343,-453
2018,1,25,16,766,743,319,-424
2018,1,25,17,720,696,285,-411
2018,1,25,18,678,658,214,-444
2018,1,25,19,645,631,148,-483
2018,1,25,20,621,606,126,-480
2018,1,25,21,616,598,124,-474
2018,1,25,22,626,610,134,-476
2018,1,25,23,669,659,246,-413
2018,1,26,0,727,723,269,-454
2018,1,26,1,743,748,291,-457
2018,1,26,2,746,755,299,-456
2018,1,26,3,728,742,291,-451
2018,1,26,4,690,701,276,-425
2018,1,26,5,657,672,237,-435
2018,1,26,6,631,662,227,-435
2018,1,26,7,627,658,210,-448
2018,1,26,8,632,670,222,-448
2018,1,26,9,644,684,243,-441
2018,1,26,10,670,704,300,-404
2018,1,26,11,710,761,369,-392
2018,1,26,12,789,838,473,-365
2018,1,26,13,829,885,555,-330
2018,1,26,14,823,868,554,-314
2018,1,26,15,791,827,504,-323
2018,1,26,16,752,767,384,-383
2018,1,26,17,707,706,290,-416
2018,1,26,18,672,653,231,-422
2018,1,26,19,639,630,189,-441
2018,1,26,20,616,618,184,-434
2018,1,26,21,610,611,187,-424
2018,1,26,22,621,620,201,-419
2018,1,26,23,655,658,216,-442
2018,1,27,0,695,703,335,-368
2018,1,27,1,694,704,341,-363
2018,1,27,2,682,701,332,-369
2018,1,27,3,661,683,282,-401
2018,1,27,4,633,652,281,-371
2018,1,27,5,601,613,278,-335
2018,1,27,6,592,584,210,-374
2018,1,27,7,581,568,133,-435
2018,1,27,8,583,553,111,-442
2018,1,27,9,591,552,112,-440
2018,1,27,10,611,551,114,-437
2018,1,27,11,633,566,116,-450
2018,1,27,12,663,585,157,-428
2018,1,27,13,699,621,296,-325
2018,1,27,14,727,649,312,-337
2018,1,27,15,727,668,218,-450
2018,1,27,16,705,667,146,-521
2018,1,27,17,679,656,145,-511
2018,1,27,18,657,637,128,-509
2018,1,27,19,631,624,119,-505
2018,1,27,20,611,607,113,-494
2018,1,27,21,603,596,113,-483
2018,1,27,22,607,613,115,-498
2018,1,27,23,637,635,126,-509
2018,1,28,0,672,649,187,-462
2018,1,28,1,667,635,186,-449
2018,1,28,2,649,617,188,-429
2018,1,28,3,618,584,144,-440
2018,1,28,4,588,553,126,-427
2018,1,28,5,551,517,122,-395
2018,1,28,6,529,487,121,-366
2018,1,28,7,508,474,121,-353
2018,1,28,8,499,466,122,-344
2018,1,28,9,498,466,123,-343
2018,1,28,10,507,465,120,-345
2018,1,28,11,522,481,121,-360
2018,1,28,12,548,503,151,-352
2018,1,28,13,584,541,177,-364
2018,1,28,14,618,581,176,-405
2018,1,28,15,626,607,176,-431
2018,1,28,16,608,604,167,-437
2018,1,28,17,583,592,118,-474
2018,1,28,18,573,588,118,-470
2018,1,28,19,559,584,117,-467
2018,1,28,20,549,580,116,-464
2018,1,28,21,541,585,117,-468
2018,1,28,22,551,598,119,-479
2018,1,28,23,593,624,176,-448
2018,1,29,0,633,639,177,-462
2018,1,29,1,639,630,176,-454
2018,1,29,2,631,615,178,-437
2018,1,29,3,603,586,178,-408
2018,1,29,4,571,547,177,-370
2018,1,29,5,545,511,177,-334
2018,1,29,6,531,490,129,-361
2018,1,29,7,519,478,114,-364
2018,1,29,8,519,479,118,-361
2018,1,29,9,527,481,115,-366
2018,1,29,10,550,495,116,-379
2018,1,29,11,596,547,126,-421
2018,1,29,12,678,624,176,-448
2018,1,29,13,724,662,176,-486
2018,1,29,14,726,668,176,-492
2018,1,29,15,716,674,184,-490
2018,1,29,16,695,654,184,-470
2018,1,29,17,678,628,181,-447
2018,1,29,18,656,604,171,-433
2018,1,29,19,636,591,122,-469
2018,1,29,20,625,576,122,-454
2018,1,29,21,627,574,123,-451
2018,1,29,22,638,593,137,-456
2018,1,29,23,688,640,174,-466
2018,1,30,0,751,699,235,-464
2018,1,30,1,766,720,263,-457
2018,1,30,2,756,715,256,-459
2018,1,30,3,731,684,253,-431
2018,1,30,4,696,649,246,-403
2018,1,30,5,668,629,192,-437
2018,1,30,6,632,626,139,-487
2018,1,30,7,632,643,125,-518
2018,1,30,8,643,652,128,-524
2018,1,30,9,660,673,130,-543
2018,1,30,10,691,701,136,-565
2018,1,30,11,742,758,228,-530
2018,1,30,12,825,821,260,-561
2018,1,30,13,873,877,360,-517
2018,1,30,14,871,889,345,-544
2018,1,30,15,847,884,318,-566
2018,1,30,16,814,854,291,-563
2018,1,30,17,784,802,237,-565
2018,1,30,18,752,786,223,-563
2018,1,30,19,719,756,195,-561
2018,1,30,20,707,726,169,-557
2018,1,30,21,709,719,157,-562
2018,1,30,22,724,731,168,-563
2018,1,30,23,772,789,240,-549
2018,1,31,0,841,827,361,-466
2018,1,31,1,851,850,439,-411
2018,1,31,2,848,861,478,-383
2018,1,31,3,830,833,429,-404
2018,1,31,4,791,797,407,-390
2018,1,31,5,766,772,380,-392
2018,1,31,6,765,762,342,-420
2018,1,31,7,766,768,372,-396
2018,1,31,8,773,777,338,-439
2018,1,31,9,783,799,336,-463
2018,1,31,10,811,826,336,-490
2018,1,31,11,852,880,483,-397
2018,1,31,12,932,951,512,-439
2018,1,31,13,968,978,544,-434
2018,1,31,14,948,954,514,-440
2018,1,31,15,885,886,416,-470
2018,1,31,16,801,799,257,-542
2018,1,31,17,735,743,208,-535
2018,1,31,18,681,692,157,-535
2018,1,31,19,644,656,122,-534
2018,1,31,20,622,630,119,-511
2018,1,31,21,617,623,118,-505
2018,1,31,22,633,634,113,-521
2018,1,31,23,676,672,167,-505
2018,2,1,0,731,736,301,-435
2018,2,1,1,737,756,331,-425
2018,2,1,2,730,758,340,-418
2018,2,1,3,703,736,351,-385
2018,2,1,4,667,692,357,-335
2018,2,1,5,640,658,297,-361
2018,2,1,6,608,641,237,-404
2018,2,1,7,603,637,179,-458
2018,2,1,8,606,640,158,-482
2018,2,1,9,618,649,152,-497
2018,2,1,10,645,673,170,-503
2018,2,1,11,690,727,283,-444
2018,2,1,12,763,798,371,-427
2018,2,1,13,806,829,376,-453
2018,2,1,14,798,814,312,-502
2018,2,1,15,766,782,266,-516
2018,2,1,16,717,737,250,-487
2018,2,1,17,684,697,187,-510
2018,2,1,18,655,663,164,-499
2018,2,1,19,629,632,126,-506
2018,2,1,20,610,606,112,-494
2018,2,1,21,604,608,113,-495
2018,2,1,22,617,624,116,-508
2018,2,1,23,648,644,139,-505
2018,2,2,0,688,686,186,-500
2018,2,2,1,702,680,183,-497
2018,2,2,2,709,666,184,-482
2018,2,2,3,693,630,183,-447
2018,2,2,4,668,607,186,-421
2018,2,2,5,635,588,174,-414
2018,2,2,6,609,583,119,-464
2018,2,2,7,605,583,118,-465
2018,2,2,8,612,598,121,-477
2018,2,2,9,629,619,119,-500
2018,2,2,10,657,645,118,-527
2018,2,2,11,713,702,172,-530
2018,2,2,12,793,780,212,-568
2018,2,2,13,840,840,275,-565
2018,2,2,14,847,864,297,-567
2018,2,2,15,841,848,284,-564
2018,2,2,16,815,827,261,-566
2018,2,2,17,792,802,243,-559
2018,2,2,18,764,777,212,-565
2018,2,2,19,743,757,202,-555
2018,2,2,20,722,742,203,-539
2018,2,2,21,712,736,196,-540
2018,2,2,22,729,758,199,-559
2018,2,2,23,781,677,130,-547
2018,2,3,0,836,552,98,-454
2018,2,3,1,859,562,149,-413
2018,2,3,2,881,565,148,-417
2018,2,3,3,872,552,148,-404
2018,2,3,4,853,535,92,-443
2018,2,3,5,837,505,26,-479
2018,2,3,6,797,823,343,-480
2018,2,3,7,792,824,339,-485
2018,2,3,8,801,832,339,-493
2018,2,3,9,808,834,341,-493
2018,2,3,10,825,834,345,-489
2018,2,3,11,847,841,344,-497
2018,2,3,12,876,874,486,-388
2018,2,3,13,919,917,510,-407
2018,2,3,14,936,935,513,-422
2018,2,3,15,907,889,508,-381
2018,2,3,16,848,820,430,-390
2018,2,3,17,787,754,328,-426
2018,2,3,18,739,697,243,-454
2018,2,3,19,692,672,197,-475
2018,2,3,20,662,648,191,-457
2018,2,3,21,651,657,190,-467
2018,2,3,22,666,688,187,-501
2018,2,3,23,709,728,248,-480
2018,2,4,0,740,774,258,-516
2018,2,4,1,753,780,287,-493
2018,2,4,2,753,768,291,-477
2018,2,4,3,730,744,287,-457
2018,2,4,4,710,715,279,-436
2018,2,4,5,674,683,201,-482
2018,2,4,6,636,658,149,-509
2018,2,4,7,627,644,118,-526
2018,2,4,8,625,639,114,-525
2018,2,4,9,629,633,112,-521
2018,2,4,10,636,636,110,-526
2018,2,4,11,661,655,174,-481
2018,2,4,12,691,683,176,-507
2018,2,4,13,730,717,176,-541
2018,2,4,14,772,756,188,-568
2018,2,4,15,781,781,220,-561
2018,2,4,16,760,782,221,-561
2018,2,4,17,743,767,207,-560
2018,2,4,18,723,757,198,-559
2018,2,4,19,699,717,187,-530
2018,2,4,20,683,688,184,-504
2018,2,4,21,678,667,181,-486
2018,2,4,22,686,667,179,-488
2018,2,4,23,712,693,181,-512
2018,2,5,0,732,709,186,-523
2018,2,5,1,737,690,188,-502
2018,2,5,2,740,676,186,-490
2018,2,5,3,716,657,188,-469
2018,2,5,4,689,635,190,-445
2018,2,5,5,657,611,187,-424
2018,2,5,6,613,466,21,-445
2018,2,5,7,606,465,3,-462
2018,2,5,8,611,472,12,-460
2018,2,5,9,624,480,13,-467
2018,2,5,10,654,514,13,-501
2018,2,5,11,706,692,181,-511
2018,2,5,12,781,779,222,-557
2018,2,5,13,832,833,266,-567
2018,2,5,14,839,847,278,-569
2018,2,5,15,818,839,276,-563
2018,2,5,16,783,819,256,-563
2018,2,5,17,753,774,221,-553
2018,2,5,18,721,728,218,-510
2018,2,5,19,690,685,220,-465
2018,2,5,20,663,644,215,-429
2018,2,5,21,647,626,175,-451
2018,2,5,22,654,635,171,-464
2018,2,5,23,703,671,218,-453
2018,2,6,0,752,738,224,-514
2018,2,6,1,772,761,261,-500
2018,2,6,2,773,763,271,-492
2018,2,6,3,748,737,267,-470
2018,2,6,4,711,700,223,-477
2018,2,6,5,668,662,188,-474
2018,2,6,6,641,645,132,-513
2018,2,6,7,630,642,113,-529
2018,2,6,8,630,650,115,-535
2018,2,6,9,636,655,118,-537
2018,2,6,10,658,660,136,-524
2018,2,6,11,702,691,258,-433
2018,2,6,12,777,760,334,-426
2018,2,6,13,813,785,329,-456
2018,2,6,14,803,769,257,-512
2018,2,6,15,765,745,195,-550
2018,2,6,16,715,719,197,-522
2018,2,6,17,674,671,198,-473
2018,2,6,18,642,646,168,-478
2018,2,6,19,616,648,131,-517
2018,2,6,20,594,638,124,-514
2018,2,6,21,587,631,135,-496
2018,2,6,22,603,634,169,-465
2018,2,6,23,632,657,233,-424
2018,2,7,0,673,700,329,-371
2018,2,7,1,680,693,292,-401
2018,2,7,2,681,677,277,-400
2018,2,7,3,652,642,249,-393
2018,2,7,4,610,594,223,-371
2018,2,7,5,568,545,192,-353
2018,2,7,6,533,515,118,-397
2018,2,7,7,516,498,114,-384
2018,2,7,8,510,494,114,-380
2018,2,7,9,512,493,115,-378
2018,2,7,10,527,504,114,-390
2018,2,7,11,578,541,180,-361
2018,2,7,12,649,615,224,-391
2018,2,7,13,683,646,259,-387
2018,2,7,14,675,647,224,-423
2018,2,7,15,662,646,216,-430
2018,2,7,16,636,666,230,-436
2018,2,7,17,610,609,228,-381
2018,2,7,18,592,621,231,-390
2018,2,7,19,576,599,231,-368
2018,2,7,20,562,586,232,-354
2018,2,7,21,558,579,208,-371
2018,2,7,22,578,597,172,-425
2018,2,7,23,613,635,253,-382
2018,2,8,0,659,673,329,-344
2018,2,8,1,676,684,319,-365
2018,2,8,2,678,684,240,-444
2018,2,8,3,657,660,230,-430
2018,2,8,4,624,629,230,-399
2018,2,8,5,592,602,230,-372
2018,2,8,6,569,589,229,-360
2018,2,8,7,560,600,229,-371
2018,2,8,8,565,610,229,-381
2018,2,8,9,578,627,228,-399
2018,2,8,10,600,658,230,-428
2018,2,8,11,654,710,228,-482
2018,2,8,12,737,793,264,-529
2018,2,8,13,780,835,315,-520
2018,2,8,14,776,817,302,-515
2018,2,8,15,749,775,281,-494
2018,2,8,16,706,729,243,-486
2018,2,8,17,658,688,232,-456
2018,2,8,18,624,650,235,-415
2018,2,8,19,599,623,234,-389
2018,2,8,20,576,595,235,-360
2018,2,8,21,569,590,225,-365
2018,2,8,22,584,604,227,-377
2018,2,8,23,616,642,229,-413
2018,2,9,0,666,702,302,-400
2018,2,9,1,679,727,384,-343
2018,2,9,2,685,733,395,-338
2018,2,9,3,664,719,365,-354
2018,2,9,4,631,685,251,-434
2018,2,9,5,599,661,192,-469
2018,2,9,6,612,649,182,-467
2018,2,9,7,606,651,190,-461
2018,2,9,8,611,658,224,-434
2018,2,9,9,620,673,298,-375
2018,2,9,10,642,703,400,-303
2018,2,9,11,688,752,408,-344
2018,2,9,12,766,836,426,-410
2018,2,9,13,795,861,438,-423
2018,2,9,14,786,839,441,-398
2018,2,9,15,750,775,390,-385
2018,2,9,16,709,704,247,-457
2018,2,9,17,657,653,172,-481
2018,2,9,18,631,607,121,-486
2018,2,9,19,601,582,120,-462
2018,2,9,20,578,559,122,-437
2018,2,9,21,570,549,119,-430
2018,2,9,22,584,554,212,-342
2018,2,9,23,603,580,227,-353
2018,2,10,0,630,627,264,-363
2018,2,10,1,633,644,291,-353
2018,2,10,2,629,637,290,-347
2018,2,10,3,604,624,306,-318
2018,2,10,4,573,590,278,-312
2018,2,10,5,543,554,163,-391
2018,2,10,6,528,526,127,-399
2018,2,10,7,514,507,115,-392
2018,2,10,8,515,498,113,-385
2018,2,10,9,515,497,115,-382
2018,2,10,10,525,507,166,-341
2018,2,10,11,545,525,222,-303
2018,2,10,12,573,543,219,-324
2018,2,10,13,607,582,223,-359
2018,2,10,14,639,607,222,-385
2018,2,10,15,655,627,221,-406
2018,2,10,16,647,624,220,-404
2018,2,10,17,630,612,224,-388
2018,2,10,18,605,580,208,-372
2018,2,10,19,586,565,133,-432
2018,2,10,20,564,557,127,-430
2018,2,10,21,559,561,139,-422
2018,2,10,22,560,569,221,-348
2018,2,10,23,569,586,312,-274
2018,2,11,0,582,603,341,-262
2018,2,11,1,588,595,260,-335
2018,2,11,2,578,573,233,-340
2018,2,11,3,555,542,224,-318
2018,2,11,4,525,510,224,-286
2018,2,11,5,486,478,225,-253
2018,2,11,6,450,445,224,-221
2018,2,11,7,427,426,222,-204
2018,2,11,8,417,419,226,-193
2018,2,11,9,411,414,224,-190
2018,2,11,10,414,412,224,-188
2018,2,11,11,423,427,226,-201
2018,2,11,12,445,442,225,-217
2018,2,11,13,473,473,220,-253
2018,2,11,14,513,516,221,-295
2018,2,11,15,533,538,221,-317
2018,2,11,16,527,543,222,-321
2018,2,11,17,513,537,223,-314
2018,2,11,18,514,533,219,-314
2018,2,11,19,505,524,217,-307
2018,2,11,20,494,521,221,-300
2018,2,11,21,490,520,223,-297
2018,2,11,22,497,527,220,-307
2018,2,11,23,518,555,221,-334
2018,2,12,0,540,576,239,-337
2018,2,12,1,553,574,243,-331
2018,2,12,2,546,556,244,-312
2018,2,12,3,524,526,252,-274
2018,2,12,4,493,488,248,-240
2018,2,12,5,458,450,219,-231
2018,2,12,6,418,422,217,-205
2018,2,12,7,402,408,216,-192
2018,2,12,8,395,401,217,-184
2018,2,12,9,396,404,217,-187
2018,2,12,10,410,420,217,-203
2018,2,12,11,453,453,213,-240
2018,2,12,12,530,526,216,-310
2018,2,12,13,563,564,214,-350
2018,2,12,14,573,573,216,-357
2018,2,12,15,576,579,216,-363
2018,2,12,16,573,579,216,-363
2018,2,12,17,563,582,216,-366
2018,2,12,18,559,577,217,-360
2018,2,12,19,548,573,241,-332
2018,2,12,20,537,566,247,-319
2018,2,12,21,536,561,243,-318
2018,2,12,22,549,584,246,-338
2018,2,12,23,577,612,246,-366
2018,2,13,0,621,652,246,-406
2018,2,13,1,645,648,220,-428
2018,2,13,2,636,635,221,-414
2018,2,13,3,606,604,223,-381
2018,2,13,4,568,556,221,-335
2018,2,13,5,525,515,221,-294
2018,2,13,6,497,491,222,-269
2018,2,13,7,486,476,220,-256
2018,2,13,8,482,479,220,-259
2018,2,13,9,489,488,221,-267
2018,2,13,10,509,512,221,-291
2018,2,13,11,556,567,221,-346
2018,2,13,12,636,644,239,-405
2018,2,13,13,677,680,319,-361
2018,2,13,14,679,679,298,-381
2018,2,13,15,678,680,271,-409
2018,2,13,16,666,671,258,-413
2018,2,13,17,643,652,258,-394
2018,2,13,18,636,631,261,-370
2018,2,13,19,622,611,259,-352
2018,2,13,20,605,584,261,-323
2018,2,13,21,600,571,248,-323
2018,2,13,22,616,578,247,-331
2018,2,13,23,649,598,319,-279
2018,2,14,0,681,654,425,-229
2018,2,14,1,694,679,464,-215
2018,2,14,2,690,670,467,-203
2018,2,14,3,660,646,460,-186
2018,2,14,4,618,609,441,-168
2018,2,14,5,580,568,395,-173
2018,2,14,6,556,535,279,-256
2018,2,14,7,543,531,221,-310
2018,2,14,8,539,533,218,-315
2018,2,14,9,544,535,216,-319
2018,2,14,10,556,551,227,-324
2018,2,14,11,594,596,232,-364
2018,2,14,12,666,673,265,-408
2018,2,14,13,690,699,303,-396
2018,2,14,14,680,695,251,-444
2018,2,14,15,658,689,235,-454
2018,2,14,16,628,675,236,-439
2018,2,14,17,599,643,236,-407
2018,2,14,18,578,598,235,-363
2018,2,14,19,562,566,223,-343
2018,2,14,20,547,541,206,-335
2018,2,14,21,540,539,176,-363
2018,2,14,22,550,541,172,-369
2018,2,14,23,570,561,199,-362
2018,2,15,0,602,601,242,-359
2018,2,15,1,609,597,242,-355
2018,2,15,2,602,582,236,-346
2018,2,15,3,579,553,173,-380
2018,2,15,4,529,511,164,-347
2018,2,15,5,488,470,171,-299
2018,2,15,6,456,442,174,-268
2018,2,15,7,437,432,174,-258
2018,2,15,8,429,423,172,-251
2018,2,15,9,430,426,173,-253
2018,2,15,10,438,439,173,-266
2018,2,15,11,475,480,174,-306
2018,2,15,12,544,548,173,-375
2018,2,15,13,574,578,175,-403
2018,2,15,14,573,570,177,-393
2018,2,15,15,578,544,159,-385
2018,2,15,16,554,548,170,-378
2018,2,15,17,543,538,169,-369
2018,2,15,18,534,528,169,-359
2018,2,15,19,527,531,172,-359
2018,2,15,20,517,524,168,-356
2018,2,15,21,524,518,168,-350
2018,2,15,22,529,527,168,-359
2018,2,15,23,543,537,170,-367
2018,2,16,0,572,564,168,-396
2018,2,16,1,578,578,168,-410
2018,2,16,2,579,564,167,-397
2018,2,16,3,546,528,168,-360
2018,2,16,4,513,480,167,-313
2018,2,16,5,466,439,168,-271
2018,2,16,6,427,405,165,-240
2018,2,16,7,411,396,168,-228
2018,2,16,8,405,392,169,-223
2018,2,16,9,402,387,167,-220
2018,2,16,10,412,398,168,-230
2018,2,16,11,450,428,178,-250
2018,2,16,12,517,497,208,-289
2018,2,16,13,544,521,201,-320
2018,2,16,14,546,529,173,-356
2018,2,16,15,551,535,170,-365
2018,2,16,16,558,543,172,-371
2018,2,16,17,545,532,161,-371
2018,2,16,18,540,528,171,-357
2018,2,16,19,540,525,169,-356
2018,2,16,20,524,521,169,-352
2018,2,16,21,517,524,171,-353
2018,2,16,22,529,530,212,-318
2018,2,16,23,557,547,233,-314
2018,2,17,0,591,568,232,-336
2018,2,17,1,598,567,233,-334
2018,2,17,2,586,555,233,-322
2018,2,17,3,557,541,234,-307
2018,2,17,4,533,512,232,-280
2018,2,17,5,504,477,216,-261
2018,2,17,6,446,450,169,-281
2018,2,17,7,432,437,164,-273
2018,2,17,8,427,433,165,-268
2018,2,17,9,427,434,176,-258
2018,2,17,10,436,441,179,-262
2018,2,17,11,458,460,178,-282
2018,2,17,12,496,488,177,-311
2018,2,17,13,532,536,180,-356
2018,2,17,14,573,570,177,-393
2018,2,17,15,608,602,173,-429
2018,2,17,16,618,621,153,-468
2018,2,17,17,613,619,152,-467
2018,2,17,18,607,604,160,-444
2018,2,17,19,598,593,162,-431
2018,2,17,20,590,576,160,-416
2018,2,17,21,596,575,161,-414
2018,2,17,22,608,584,163,-421
2018,2,17,23,629,599,166,-433
2018,2,18,0,655,612,217,-395
2018,2,18,1,660,509,135,-374
2018,2,18,2,649,476,117,-359
2018,2,18,3,625,470,115,-355
2018,2,18,4,600,472,115,-357
2018,2,18,5,567,451,116,-335
2018,2,18,6,529,472,164,-308
2018,2,18,7,512,462,164,-298
2018,2,18,8,510,455,164,-291
2018,2,18,9,511,456,166,-290
2018,2,18,10,520,471,165,-306
2018,2,18,11,539,493,163,-330
2018,2,18,12,568,534,168,-366
2018,2,18,13,601,579,165,-414
2018,2,18,14,635,607,165,-442
2018,2,18,15,634,604,167,-437
2018,2,18,16,607,569,162,-407
2018,2,18,17,585,542,165,-377
2018,2,18,18,562,519,165,-354
2018,2,18,19,543,498,164,-334
2018,2,18,20,528,484,164,-320
2018,2,18,21,517,483,165,-318
2018,2,18,22,527,490,163,-327
2018,2,18,23,551,514,162,-352
2018,2,19,0,581,560,165,-395
2018,2,19,1,596,582,164,-418
2018,2,19,2,586,571,164,-407
2018,2,19,3,560,545,164,-381
2018,2,19,4,528,502,163,-339
2018,2,19,5,492,470,165,-305
2018,2,19,6,455,437,160,-277
2018,2,19,7,441,425,158,-267
2018,2,19,8,439,427,164,-263
2018,2,19,9,438,429,160,-269
2018,2,19,10,455,444,160,-284
2018,2,19,11,493,489,161,-328
2018,2,19,12,561,556,166,-390
2018,2,19,13,601,592,202,-390
2018,2,19,14,582,592,207,-385
2018,2,19,15,578,599,206,-393
2018,2,19,16,571,592,201,-391
2018,2,19,17,555,584,186,-398
2018,2,19,18,546,571,168,-403
2018,2,19,19,534,562,172,-390
2018,2,19,20,525,546,170,-376
2018,2,19,21,510,537,171,-366
2018,2,19,22,520,542,172,-370
2018,2,19,23,530,556,171,-385
2018,2,20,0,578,597,193,-404
2018,2,20,1,580,605,200,-405
2018,2,20,2,568,586,201,-385
2018,2,20,3,546,553,197,-356
2018,2,20,4,500,504,165,-339
2018,2,20,5,461,464,163,-301
2018,2,20,6,451,432,166,-266
2018,2,20,7,443,417,168,-249
2018,2,20,8,444,410,166,-244
2018,2,20,9,449,409,166,-243
2018,2,20,10,461,419,167,-252
2018,2,20,11,504,457,143,-314
2018,2,20,12,577,526,134,-392
2018,2,20,13,605,560,135,-425
2018,2,20,14,601,547,133,-414
2018,2,20,15,590,542,136,-406
2018,2,20,16,575,536,136,-400
2018,2,20,17,552,530,135,-395
2018,2,20,18,537,523,138,-385
2018,2,20,19,534,522,137,-385
2018,2,20,20,521,513,135,-378
2018,2,20,21,516,513,134,-379
2018,2,20,22,525,523,135,-388
2018,2,20,23,539,529,187,-342
2018,2,21,0,587,566,256,-310
2018,2,21,1,599,581,279,-302
2018,2,21,2,587,564,276,-288
2018,2,21,3,557,524,233,-291
2018,2,21,4,511,483,182,-301
2018,2,21,5,469,439,173,-266
2018,2,21,6,420,409,165,-244
2018,2,21,7,403,392,164,-228
2018,2,21,8,395,384,165,-219
2018,2,21,9,395,386,166,-220
2018,2,21,10,406,396,167,-229
2018,2,21,11,445,423,163,-260
2018,2,21,12,517,493,166,-327
2018,2,21,13,539,527,201,-326
2018,2,21,14,541,528,176,-352
2018,2,21,15,547,534,169,-365
2018,2,21,16,546,538,143,-395
2018,2,21,17,534,537,136,-401
2018,2,21,18,529,539,161,-378
2018,2,21,19,522,541,171,-370
2018,2,21,20,514,535,170,-365
2018,2,21,21,515,536,170,-366
2018,2,21,22,523,543,172,-371
2018,2,21,23,536,546,170,-376
2018,2,22,0,558,570,173,-397
2018,2,22,1,574,582,200,-382
2018,2,22,2,563,566,194,-372
2018,2,22,3,529,529,164,-365
2018,2,22,4,484,481,143,-338
2018,2,22,5,442,434,109,-325
2018,2,22,6,418,407,102,-305
2018,2,22,7,399,388,101,-287
2018,2,22,8,390,383,104,-279
2018,2,22,9,389,379,103,-276
2018,2,22,10,397,387,102,-285
2018,2,22,11,434,420,100,-320
2018,2,22,12,505,489,145,-344
2018,2,22,13,529,518,168,-350
2018,2,22,14,529,524,170,-354
2018,2,22,15,536,533,172,-361
2018,2,22,16,534,535,170,-365
2018,2,22,17,525,539,176,-363
2018,2,22,18,525,541,175,-366
2018,2,22,19,527,544,126,-418
2018,2,22,20,519,545,116,-429
2018,2,22,21,520,544,136,-408
2018,2,22,22,528,556,147,-409
2018,2,22,23,542,559,160,-399
2018,2,23,0,562,573,192,-381
2018,2,23,1,575,585,251,-334
2018,2,23,2,561,568,250,-318
2018,2,23,3,526,534,243,-291
2018,2,23,4,486,486,230,-256
2018,2,23,5,441,444,207,-237
2018,2,23,6,417,401,97,-304
2018,2,23,7,401,377,58,-319
2018,2,23,8,394,380,64,-316
2018,2,23,9,393,379,65,-314
2018,2,23,10,405,388,68,-320
2018,2,23,11,440,421,139,-282
2018,2,23,12,507,491,170,-321
2018,2,23,13,531,519,168,-351
2018,2,23,14,533,512,166,-346
2018,2,23,15,541,523,170,-353
2018,2,23,16,535,525,160,-365
2018,2,23,17,528,522,78,-444
2018,2,23,18,519,519,66,-453
2018,2,23,19,522,520,69,-451
2018,2,23,20,513,519,65,-454
2018,2,23,21,516,522,65,-457
2018,2,23,22,519,525,150,-375
2018,2,23,23,529,527,182,-345
2018,2,24,0,545,539,209,-330
2018,2,24,1,549,548,226,-322
2018,2,24,2,541,529,188,-341
2018,2,24,3,508,502,167,-335
2018,2,24,4,480,467,109,-358
2018,2,24,5,440,434,63,-371
2018,2,24,6,414,397,60,-337
2018,2,24,7,394,385,61,-324
2018,2,24,8,387,376,62,-314
2018,2,24,9,385,374,63,-311
2018,2,24,10,392,376,62,-314
2018,2,24,11,409,391,96,-295
2018,2,24,12,431,418,164,-254
2018,2,24,13,463,451,166,-285
2018,2,24,14,495,487,169,-318
2018,2,24,15,525,502,177,-325
2018,2,24,16,514,514,177,-337
2018,2,24,17,507,510,177,-333
2018,2,24,18,498,502,136,-366
2018,2,24,19,496,502,77,-425
2018,2,24,20,487,494,72,-422
2018,2,24,21,491,496,74,-422
2018,2,24,22,495,504,163,-341
2018,2,24,23,509,506,212,-294
2018,2,25,0,523,533,247,-286
2018,2,25,1,525,534,239,-295
2018,2,25,2,524,518,189,-329
2018,2,25,3,493,493,173,-320
2018,2,25,4,471,461,175,-286
2018,2,25,5,431,426,174,-252
2018,2,25,6,408,396,115,-281
2018,2,25,7,385,379,69,-310
2018,2,25,8,379,369,69,-300
2018,2,25,9,372,360,69,-291
2018,2,25,10,373,361,69,-292
2018,2,25,11,387,374,74,-300
2018,2,25,12,407,394,72,-322
2018,2,25,13,429,424,71,-353
2018,2,25,14,475,464,71,-393
2018,2,25,15,503,494,70,-424
2018,2,25,16,508,501,70,-431
2018,2,25,17,506,498,70,-428
2018,2,25,18,513,505,129,-376
2018,2,25,19,512,506,131,-375
2018,2,25,20,502,499,127,-372
2018,2,25,21,498,498,130,-368
2018,2,25,22,505,509,153,-356
2018,2,25,23,514,522,160,-362
2018,2,26,0,539,554,179,-375
2018,2,26,1,556,558,191,-367
2018,2,26,2,541,543,164,-379
2018,2,26,3,511,509,162,-347
2018,2,26,4,478,474,161,-313
2018,2,26,5,447,440,160,-280
2018,2,26,6,423,409,103,-306
2018,2,26,7,407,401,66,-335
2018,2,26,8,407,398,66,-332
2018,2,26,9,412,398,64,-334
2018,2,26,10,427,413,66,-347
2018,2,26,11,474,455,81,-374
2018,2,26,12,547,521,87,-434
2018,2,26,13,578,555,100,-455
2018,2,26,14,582,561,181,-380
2018,2,26,15,578,568,201,-367
2018,2,26,16,581,560,197,-363
2018,2,26,17,565,552,193,-359
2018,2,26,18,555,547,192,-355
2018,2,26,19,547,546,187,-359
2018,2,26,20,534,543,186,-357
2018,2,26,21,531,546,191,-355
2018,2,26,22,544,536,196,-340
2018,2,26,23,558,558,223,-335
2018,2,27,0,609,605,224,-381
2018,2,27,1,635,635,232,-403
2018,2,27,2,616,635,232,-403
2018,2,27,3,584,609,227,-382
2018,2,27,4,543,581,230,-351
2018,2,27,5,507,554,178,-376
2018,2,27,6,511,532,123,-409
2018,2,27,7,503,539,123,-416
2018,2,27,8,508,548,125,-423
2018,2,27,9,520,559,124,-435
2018,2,27,10,541,592,225,-367
2018,2,27,11,596,650,364,-286
2018,2,27,12,677,733,470,-263
2018,2,27,13,705,768,455,-313
2018,2,27,14,693,719,357,-362
2018,2,27,15,665,643,276,-367
2018,2,27,16,644,630,237,-393
2018,2,27,17,605,589,173,-416
2018,2,27,18,575,553,125,-428
2018,2,27,19,554,542,117,-425
2018,2,27,20,536,527,121,-406
2018,2,27,21,528,518,123,-395
2018,2,27,22,541,522,122,-400
2018,2,27,23,554,541,236,-305
2018,2,28,0,596,596,339,-257
2018,2,28,1,625,612,347,-265
2018,2,28,2,612,610,349,-261
2018,2,28,3,581,586,351,-235
2018,2,28,4,537,543,285,-258
2018,2,28,5,502,512,147,-365
2018,2,28,6,488,486,126,-360
2018,2,28,7,481,478,127,-351
2018,2,28,8,482,476,127,-349
2018,2,28,9,491,481,123,-358
2018,2,28,10,512,493,126,-367
2018,2,28,11,561,532,268,-264
2018,2,28,12,635,605,301,-304
2018,2,28,13,665,636,295,-341
2018,2,28,14,659,631,261,-370
2018,2,28,15,645,633,252,-381
2018,2,28,16,633,628,177,-451
2018,2,28,17,605,626,155,-471
2018,2,28,18,587,606,170,-436
2018,2,28,19,574,573,164,-409
2018,2,28,20,559,618,217,-401
2018,2,28,21,556,592,197,-395
2018,2,28,22,564,600,177,-423
2018,2,28,23,581,615,173,-442
2018,3,1,0,616,638,251,-387
2018,3,1,1,632,639,304,-335
2018,3,1,2,614,621,303,-318
2018,3,1,3,578,590,303,-287
2018,3,1,4,539,544,255,-289
2018,3,1,5,503,494,177,-317
2018,3,1,6,509,466,182,-284
2018,3,1,7,491,450,177,-273
2018,3,1,8,485,441,179,-262
2018,3,1,9,486,441,179,-262
2018,3,1,10,498,454,199,-255
2018,3,1,11,532,496,212,-284
2018,3,1,12,594,568,278,-290
2018,3,1,13,634,597,306,-291
2018,3,1,14,617,595,277,-318
2018,3,1,15,591,600,265,-335
2018,3,1,16,591,595,231,-364
2018,3,1,17,564,590,232,-358
2018,3,1,18,544,584,234,-350
2018,3,1,19,532,578,225,-353
2018,3,1,20,517,560,222,-338
2018,3,1,21,510,557,222,-335
2018,3,1,22,513,564,222,-342
2018,3,1,23,526,577,253,-324
2018,3,2,0,569,617,321,-296
2018,3,2,1,598,627,335,-292
2018,3,2,2,592,605,327,-278
2018,3,2,3,572,574,329,-245
2018,3,2,4,536,540,304,-236
2018,3,2,5,505,511,280,-231
2018,3,2,6,482,496,222,-274
2018,3,2,7,471,492,222,-270
2018,3,2,8,470,493,220,-273
2018,3,2,9,477,503,222,-281
2018,3,2,10,500,529,223,-306
2018,3,2,11,546,575,318,-257
2018,3,2,12,615,663,364,-299
2018,3,2,13,668,701,366,-335
2018,3,2,14,663,692,357,-335
2018,3,2,15,649,667,294,-373
2018,3,2,16,640,631,253,-378
2018,3,2,17,618,617,278,-339
2018,3,2,18,591,608,235,-373
2018,3,2,19,570,590,236,-354
2018,3,2,20,568,577,236,-341
2018,3,2,21,557,563,235,-328
2018,3,2,22,559,570,233,-337
2018,3,2,23,573,598,243,-355
2018,3,3,0,605,654,360,-294
2018,3,3,1,642,688,461,-227
2018,3,3,2,646,686,491,-195
2018,3,3,3,634,672,487,-185
2018,3,3,4,610,645,464,-181
2018,3,3,5,585,608,488,-120
2018,3,3,6,573,598,438,-160
2018,3,3,7,564,593,368,-225
2018,3,3,8,568,595,341,-254
2018,3,3,9,580,602,348,-254
2018,3,3,10,601,616,397,-219
2018,3,3,11,631,647,413,-234
2018,3,3,12,662,685,367,-318
2018,3,3,13,717,719,362,-357
2018,3,3,14,733,729,307,-422
2018,3,3,15,713,708,243,-465
2018,3,3,16,685,672,232,-440
2018,3,3,17,642,639,237,-402
2018,3,3,18,610,601,235,-366
2018,3,3,19,576,578,239,-339
2018,3,3,20,555,551,238,-313
2018,3,3,21,545,542,237,-305
2018,3,3,22,551,551,239,-312
2018,3,3,23,565,576,236,-340
2018,3,4,0,603,621,277,-344
2018,3,4,1,625,653,319,-334
2018,3,4,2,632,657,324,-333
2018,3,4,3,622,641,322,-319
2018,3,4,4,597,622,314,-308
2018,3,4,5,574,598,271,-327
2018,3,4,6,560,582,233,-349
2018,3,4,7,556,576,219,-357
2018,3,4,8,562,585,222,-363
2018,3,4,9,574,595,218,-377
2018,3,4,10,596,604,253,-351
2018,3,4,11,623,633,283,-350
2018,3,4,12,651,675,284,-391
2018,3,4,13,707,715,287,-428
2018,3,4,14,728,717,274,-443
2018,3,4,15,702,674,252,-422
2018,3,4,16,656,619,222,-397
2018,3,4,17,613,575,225,-350
2018,3,4,18,580,542,225,-317
2018,3,4,19,548,514,223,-291
2018,3,4,20,529,495,225,-270
2018,3,4,21,517,490,224,-266
2018,3,4,22,518,500,226,-274
2018,3,4,23,544,519,223,-296
2018,3,5,0,575,567,247,-320
2018,3,5,1,600,604,237,-367
2018,3,5,2,608,604,224,-380
2018,3,5,3,594,594,221,-373
2018,3,5,4,565,564,216,-348
2018,3,5,5,536,548,217,-331
2018,3,5,6,509,544,216,-328
2018,3,5,7,505,544,215,-329
2018,3,5,8,513,560,217,-343
2018,3,5,9,527,579,217,-362
2018,3,5,10,551,613,218,-395
2018,3,5,11,606,666,229,-437
2018,3,5,12,682,751,339,-412
2018,3,5,13,731,777,343,-434
2018,3,5,14,716,752,288,-464
2018,3,5,15,680,715,284,-431
2018,3,5,16,653,666,221,-445
2018,3,5,17,619,622,215,-407
2018,3,5,18,588,593,216,-377
2018,3,5,19,565,571,218,-353
2018,3,5,20,545,553,214,-339
2018,3,5,21,534,550,216,-334
2018,3,5,22,540,553,162,-391
2018,3,5,23,551,576,163,-413
2018,3,6,0,586,627,171,-456
2018,3,6,1,616,641,166,-475
2018,3,6,2,612,627,156,-471
2018,3,6,3,589,598,150,-448
2018,3,6,4,547,559,123,-436
2018,3,6,5,506,522,123,-399
2018,3,6,6,491,494,66,-428
2018,3,6,7,483,485,55,-430
2018,3,6,8,484,477,53,-424
2018,3,6,9,490,488,57,-431
2018,3,6,10,511,500,58,-442
2018,3,6,11,556,543,184,-359
2018,3,6,12,626,607,250,-357
2018,3,6,13,675,647,291,-356
2018,3,6,14,670,653,271,-382
2018,3,6,15,656,646,261,-385
2018,3,6,16,649,649,302,-347
2018,3,6,17,627,648,257,-391
2018,3,6,18,602,643,262,-381
2018,3,6,19,591,637,321,-316
2018,3,6,20,578,619,363,-256
2018,3,6,21,573,608,410,-198
2018,3,6,22,582,613,422,-191
2018,3,6,23,598,631,463,-168
2018,3,7,0,639,657,539,-118
2018,3,7,1,668,683,588,-95
2018,3,7,2,671,663,590,-73
2018,3,7,3,649,630,456,-174
2018,3,7,4,613,588,386,-202
2018,3,7,5,579,551,297,-254
2018,3,7,6,549,532,233,-299
2018,3,7,7,539,531,192,-339
2018,3,7,8,541,540,192,-348
2018,3,7,9,553,554,193,-361
2018,3,7,10,575,584,196,-388
2018,3,7,11,623,633,279,-354
2018,3,7,12,698,713,374,-339
2018,3,7,13,749,760,398,-362
2018,3,7,14,740,770,397,-373
2018,3,7,15,716,764,395,-369
2018,3,7,16,699,764,401,-363
2018,3,7,17,665,753,386,-367
2018,3,7,18,642,730,271,-459
2018,3,7,19,626,706,192,-514
2018,3,7,20,609,690,191,-499
2018,3,7,21,598,687,221,-466
2018,3,7,22,608,689,233,-456
2018,3,7,23,632,725,312,-413
2018,3,8,0,678,777,391,-386
2018,3,8,1,714,806,403,-403
2018,3,8,2,721,800,408,-392
2018,3,8,3,703,769,410,-359
2018,3,8,4,666,721,349,-372
2018,3,8,5,634,678,308,-370
2018,3,8,6,645,656,272,-384
2018,3,8,7,640,643,289,-354
2018,3,8,8,646,643,358,-285
2018,3,8,9,659,644,366,-278
2018,3,8,10,682,662,366,-296
2018,3,8,11,725,703,456,-247
2018,3,8,12,796,777,470,-307
2018,3,8,13,840,816,473,-343
2018,3,8,14,825,798,443,-355
2018,3,8,15,789,768,418,-350
2018,3,8,16,766,762,359,-403
2018,3,8,17,733,741,293,-448
2018,3,8,18,702,718,232,-486
2018,3,8,19,675,703,233,-470
2018,3,8,20,658,687,239,-448
2018,3,8,21,647,690,320,-370
2018,3,8,22,659,703,335,-368
2018,3,8,23,679,749,364,-385
2018,3,9,0,718,802,451,-351
2018,3,9,1,755,835,473,-362
2018,3,9,2,767,831,473,-358
2018,3,9,3,754,807,454,-353
2018,3,9,4,716,762,369,-393
2018,3,9,5,685,729,367,-362
2018,3,9,6,687,710,353,-357
2018,3,9,7,684,706,277,-429
2018,3,9,8,691,706,267,-439
2018,3,9,9,704,714,249,-465
2018,3,9,10,727,735,268,-467
2018,3,9,11,772,778,390,-388
2018,3,9,12,838,845,399,-446
2018,3,9,13,875,866,372,-494
2018,3,9,14,857,829,328,-501
2018,3,9,15,812,793,296,-497
2018,3,9,16,766,748,254,-494
2018,3,9,17,720,701,207,-494
2018,3,9,18,687,662,171,-491
2018,3,9,19,655,628,139,-489
2018,3,9,20,633,599,134,-465
2018,3,9,21,622,592,136,-456
2018,3,9,22,620,604,157,-447
2018,3,9,23,636,630,215,-415
2018,3,10,0,663,665,330,-335
2018,3,10,1,680,681,335,-346
2018,3,10,2,679,677,334,-343
2018,3,10,3,660,656,332,-324
2018,3,10,4,632,625,333,-292
2018,3,10,5,600,590,242,-348
2018,3,10,6,575,568,170,-398
2018,3,10,7,563,563,169,-394
2018,3,10,8,564,566,149,-417
2018,3,10,9,571,579,156,-423
2018,3,10,10,585,592,227,-365
2018,3,10,11,608,612,321,-291
2018,3,10,12,634,646,334,-312
2018,3,10,13,681,687,334,-353
2018,3,10,14,697,697,341,-356
2018,3,10,15,683,687,297,-390
2018,3,10,16,656,663,232,-431
2018,3,10,17,622,634,153,-481
2018,3,10,18,586,617,148,-469
2018,3,10,19,561,603,103,-500
2018,3,10,20,541,590,91,-499
2018,3,10,21,531,588,87,-501
2018,3,10,22,536,597,109,-488
2018,3,10,23,550,613,227,-386
2018,3,11,0,571,619,206,-413
2018,3,11,1,595,633,183,-450
2018,3,11,2,596,618,201,-417
2018,3,11,3,581,596,275,-321
2018,3,11,4,552,565,205,-360
2018,3,11,5,519,532,136,-396
2018,3,11,6,-9999,532,136,-9999
2018,3,11,7,-9999,563,169,-9999
2018,3,11,8,-9999,566,149,-9999
2018,3,11,9,-9999,579,156,-9999
2018,3,11,10,-9999,592,227,-9999
2018,3,11,11,-9999,612,321,-9999
2018,3,11,12,-9999,646,334,-9999
2018,3,11,13,-9999,687,334,-9999
2018,3,11,14,-9999,697,341,-9999
2018,3,11,15,-9999,687,297,-9999
2018,3,11,16,-9999,663,232,-9999
2018,3,11,17,-9999,634,153,-9999
2018,3,11,18,-9999,617,148,-9999
2018,3,11,19,-9999,603,103,-9999
2018,3,11,20,-9999,590,91,-9999
2018,3,11,21,-9999,588,87,-9999
2018,3,11,22,-9999,597,109,-9999
2018,3,11,23,-9999,613,227,-9999
2018,3,12,0,-9999,619,206,-9999
2018,3,12,1,-9999,633,183,-9999
2018,3,12,2,-9999,618,201,-9999
2018,3,12,3,-9999,596,275,-9999
2018,3,12,4,-9999,565,205,-9999
2018,3,12,5,496,528,99,-429
2018,3,12,6,499,521,70,-451
2018,3,12,7,504,523,71,-452
2018,3,12,8,518,523,70,-453
2018,3,12,9,540,543,69,-474
2018,3,12,10,596,584,109,-475
2018,3,12,11,666,651,289,-362
2018,3,12,12,716,696,342,-354
2018,3,12,13,721,704,344,-360
2018,3,12,14,714,715,343,-372
2018,3,12,15,720,724,345,-379
2018,3,12,16,707,734,340,-394
2018,3,12,17,692,732,285,-447
2018,3,12,18,677,724,245,-479
2018,3,12,19,663,719,255,-464
2018,3,12,20,657,709,360,-349
2018,3,12,21,670,717,385,-332
2018,3,12,22,682,724,387,-337
2018,3,12,23,726,748,377,-371
2018,3,13,0,748,778,363,-415
2018,3,13,1,764,789,315,-474
2018,3,13,2,747,764,297,-467
2018,3,13,3,712,720,243,-477
2018,3,13,4,676,678,242,-436
2018,3,13,5,618,643,221,-422
2018,3,13,6,608,643,235,-408
2018,3,13,7,612,642,232,-410
2018,3,13,8,622,650,233,-417
2018,3,13,9,643,673,231,-442
2018,3,13,10,689,719,343,-376
2018,3,13,11,761,774,369,-405
2018,3,13,12,803,830,382,-448
2018,3,13,13,787,828,386,-442
2018,3,13,14,753,818,400,-418
2018,3,13,15,739,772,386,-386
2018,3,13,16,707,745,306,-439
2018,3,13,17,668,710,199,-511
2018,3,13,18,655,678,167,-511
2018,3,13,19,628,649,192,-457
2018,3,13,20,617,627,191,-436
2018,3,13,21,626,626,188,-438
2018,3,13,22,645,630,283,-347
2018,3,13,23,688,663,322,-341
2018,3,14,0,713,716,351,-365
2018,3,14,1,727,742,351,-391
2018,3,14,2,710,722,429,-293
2018,3,14,3,671,684,365,-319
2018,3,14,4,645,655,233,-422
2018,3,14,5,627,638,187,-451
2018,3,14,6,621,641,147,-494
2018,3,14,7,627,645,131,-514
2018,3,14,8,640,661,157,-504
2018,3,14,9,663,682,168,-514
2018,3,14,10,709,734,235,-499
2018,3,14,11,780,801,472,-329
2018,3,14,12,826,848,537,-311
2018,3,14,13,814,870,543,-327
2018,3,14,14,788,868,525,-343
2018,3,14,15,769,862,370,-492
2018,3,14,16,745,828,332,-496
2018,3,14,17,712,793,281,-512
2018,3,14,18,685,760,262,-498
2018,3,14,19,675,723,262,-461
2018,3,14,20,661,700,263,-437
2018,3,14,21,675,683,266,-417
2018,3,14,22,684,691,367,-324
2018,3,14,23,716,707,369,-338
2018,3,15,0,740,751,401,-350
2018,3,15,1,754,787,401,-386
2018,3,15,2,741,772,345,-427
2018,3,15,3,702,733,298,-435
2018,3,15,4,665,695,270,-425
2018,3,15,5,649,676,236,-440
2018,3,15,6,637,671,198,-473
2018,3,15,7,638,676,247,-429
2018,3,15,8,644,678,245,-433
2018,3,15,9,664,698,244,-454
2018,3,15,10,705,734,251,-483
2018,3,15,11,777,799,492,-307
2018,3,15,12,815,838,641,-197
2018,3,15,13,790,828,553,-275
2018,3,15,14,743,773,451,-322
2018,3,15,15,685,706,408,-298
2018,3,15,16,637,656,279,-377
2018,3,15,17,598,618,252,-366
2018,3,15,18,565,589,203,-386
2018,3,15,19,553,566,141,-425
2018,3,15,20,539,547,113,-434
2018,3,15,21,546,542,115,-427
2018,3,15,22,545,547,156,-391
2018,3,15,23,561,563,226,-337
2018,3,16,0,588,592,266,-326
2018,3,16,1,596,620,309,-311
2018,3,16,2,583,603,292,-311
2018,3,16,3,541,568,255,-313
2018,3,16,4,501,525,192,-333
2018,3,16,5,468,498,130,-368
2018,3,16,6,454,480,115,-365
2018,3,16,7,453,481,128,-353
2018,3,16,8,456,484,133,-351
2018,3,16,9,473,499,131,-368
2018,3,16,10,516,540,162,-378
2018,3,16,11,588,608,269,-339
2018,3,16,12,632,646,306,-340
2018,3,16,13,636,639,272,-367
2018,3,16,14,635,614,224,-390
2018,3,16,15,620,590,183,-407
2018,3,16,16,604,558,108,-450
2018,3,16,17,588,540,112,-428
2018,3,16,18,568,527,112,-415
2018,3,16,19,556,513,111,-402
2018,3,16,20,545,506,111,-395
2018,3,16,21,540,505,113,-392
2018,3,16,22,538,505,110,-395
2018,3,16,23,539,518,113,-405
2018,3,17,0,561,530,114,-416
2018,3,17,1,569,550,180,-370
2018,3,17,2,552,543,219,-324
2018,3,17,3,525,520,222,-298
2018,3,17,4,488,485,202,-283
2018,3,17,5,443,466,121,-345
2018,3,17,6,426,460,113,-347
2018,3,17,7,421,463,115,-348
2018,3,17,8,421,467,115,-352
2018,3,17,9,424,478,122,-356
2018,3,17,10,447,495,187,-308
2018,3,17,11,478,525,220,-305
2018,3,17,12,523,565,262,-303
2018,3,17,13,550,597,308,-289
2018,3,17,14,562,598,236,-362
2018,3,17,15,552,582,152,-430
2018,3,17,16,534,550,123,-427
2018,3,17,17,514,515,96,-419
2018,3,17,18,502,501,60,-441
2018,3,17,19,491,487,60,-427
2018,3,17,20,482,483,63,-420
2018,3,17,21,486,480,61,-419
2018,3,17,22,486,493,66,-427
2018,3,17,23,487,491,121,-370
2018,3,18,0,510,507,136,-371
2018,3,18,1,516,517,167,-350
2018,3,18,2,499,505,130,-375
2018,3,18,3,468,471,118,-353
2018,3,18,4,436,431,108,-323
2018,3,18,5,415,398,52,-346
2018,3,18,6,398,380,50,-330
2018,3,18,7,399,373,51,-322
2018,3,18,8,397,374,53,-321
2018,3,18,9,401,381,57,-324
2018,3,18,10,415,390,63,-327
2018,3,18,11,438,416,124,-292
2018,3,18,12,487,456,124,-332
2018,3,18,13,531,498,124,-374
2018,3,18,14,551,522,125,-397
2018,3,18,15,538,514,118,-396
2018,3,18,16,520,493,69,-424
2018,3,18,17,508,479,67,-412
2018,3,18,18,497,475,67,-408
2018,3,18,19,484,463,64,-399
2018,3,18,20,475,458,60,-398
2018,3,18,21,478,459,103,-356
2018,3,18,22,485,481,125,-356
2018,3,18,23,490,490,124,-366
2018,3,19,0,517,517,140,-377
2018,3,19,1,529,529,166,-363
2018,3,19,2,513,508,172,-336
2018,3,19,3,481,467,160,-307
2018,3,19,4,442,428,109,-319
2018,3,19,5,414,395,62,-333
2018,3,19,6,398,382,64,-318
2018,3,19,7,397,379,63,-316
2018,3,19,8,402,379,64,-315
2018,3,19,9,418,391,63,-328
2018,3,19,10,462,439,74,-365
2018,3,19,11,538,509,167,-342
2018,3,19,12,582,551,192,-359
2018,3,19,13,588,557,201,-356
2018,3,19,14,589,557,203,-354
2018,3,19,15,586,546,205,-341
2018,3,19,16,584,529,200,-329
2018,3,19,17,570,518,144,-374
2018,3,19,18,557,520,141,-379
2018,3,19,19,550,514,131,-383
2018,3,19,20,538,513,118,-395
2018,3,19,21,545,511,128,-383
2018,3,19,22,549,519,186,-333
2018,3,19,23,562,535,181,-354
2018,3,20,0,589,557,220,-337
2018,3,20,1,599,568,222,-346
2018,3,20,2,576,543,212,-331
2018,3,20,3,538,498,167,-331
2018,3,20,4,491,455,98,-357
2018,3,20,5,448,424,58,-366
2018,3,20,6,434,408,57,-351
2018,3,20,7,429,402,59,-343
2018,3,20,8,433,405,59,-346
2018,3,20,9,446,417,65,-352
2018,3,20,10,486,453,123,-330
2018,3,20,11,564,527,125,-402
2018,3,20,12,607,570,130,-440
2018,3,20,13,603,568,140,-428
2018,3,20,14,602,562,138,-424
2018,3,20,15,596,545,133,-412
2018,3,20,16,590,537,135,-402
2018,3,20,17,575,527,93,-434
2018,3,20,18,566,518,78,-440
2018,3,20,19,559,507,71,-436
2018,3,20,20,548,515,72,-443
2018,3,20,21,555,528,80,-448
2018,3,20,22,561,543,180,-363
2018,3,20,23,577,556,225,-331
2018,3,21,0,605,577,259,-318
2018,3,21,1,621,588,291,-297
2018,3,21,2,600,562,265,-297
2018,3,21,3,559,524,144,-380
2018,3,21,4,520,491,83,-408
2018,3,21,5,458,465,52,-413
2018,3,21,6,449,468,56,-412
2018,3,21,7,455,480,59,-421
2018,3,21,8,470,495,56,-439
2018,3,21,9,495,535,63,-472
2018,3,21,10,551,586,129,-457
2018,3,21,11,637,666,201,-465
2018,3,21,12,689,734,315,-419
2018,3,21,13,692,759,316,-443
2018,3,21,14,689,757,309,-448
2018,3,21,15,677,760,303,-457
2018,3,21,16,665,757,341,-416
2018,3,21,17,650,741,250,-491
2018,3,21,18,639,745,233,-512
2018,3,21,19,628,738,230,-508
2018,3,21,20,628,737,274,-463
2018,3,21,21,640,754,312,-442
2018,3,21,22,663,782,324,-458
2018,3,21,23,687,802,414,-388
2018,3,22,0,710,816,486,-330
2018,3,22,1,744,835,454,-381
2018,3,22,2,729,811,437,-374
2018,3,22,3,693,764,407,-357
2018,3,22,4,654,720,284,-436
2018,3,22,5,618,706,227,-479
2018,3,22,6,607,700,213,-487
2018,3,22,7,612,697,260,-437
2018,3,22,8,623,698,261,-437
2018,3,22,9,647,710,309,-401
2018,3,22,10,692,752,413,-339
2018,3,22,11,767,847,478,-369
2018,3,22,12,812,854,483,-371
2018,3,22,13,799,810,412,-398
2018,3,22,14,765,817,324,-493
2018,3,22,15,724,772,266,-506
2018,3,22,16,681,726,247,-479
2018,3,22,17,653,694,187,-507
2018,3,22,18,624,660,148,-512
2018,3,22,19,600,634,123,-511
2018,3,22,20,591,614,122,-492
2018,3,22,21,598,605,120,-485
2018,3,22,22,612,602,119,-483
2018,3,22,23,637,624,224,-400
2018,3,23,0,661,668,227,-441
2018,3,23,1,693,710,262,-448
2018,3,23,2,681,704,241,-463
2018,3,23,3,647,667,168,-499
2018,3,23,4,612,630,147,-483
2018,3,23,5,620,607,113,-494
2018,3,23,6,611,607,116,-491
2018,3,23,7,616,611,113,-498
2018,3,23,8,622,625,113,-512
2018,3,23,9,648,650,136,-514
2018,3,23,10,687,702,205,-497
2018,3,23,11,757,780,386,-394
2018,3,23,12,800,819,434,-385
2018,3,23,13,796,805,427,-378
2018,3,23,14,769,767,397,-370
2018,3,23,15,732,717,346,-371
2018,3,23,16,690,671,195,-476
2018,3,23,17,653,639,134,-505
2018,3,23,18,627,604,122,-482
2018,3,23,19,600,580,122,-458
2018,3,23,20,584,568,124,-444
2018,3,23,21,583,573,127,-446
2018,3,23,22,594,583,135,-448
2018,3,23,23,600,604,161,-443
2018,3,24,0,615,629,250,-379
2018,3,24,1,641,647,245,-402
2018,3,24,2,628,630,250,-380
2018,3,24,3,602,605,248,-357
2018,3,24,4,567,567,158,-409
2018,3,24,5,527,545,129,-416
2018,3,24,6,513,531,118,-413
2018,3,24,7,512,526,122,-404
2018,3,24,8,514,521,125,-396
2018,3,24,9,522,530,123,-407
2018,3,24,10,545,535,125,-410
2018,3,24,11,572,575,210,-365
2018,3,24,12,617,620,230,-390
2018,3,24,13,650,660,228,-432
2018,3,24,14,664,692,230,-462
2018,3,24,15,662,708,191,-517
2018,3,24,16,638,694,187,-507
2018,3,24,17,619,691,200,-491
2018,3,24,18,603,674,185,-489
2018,3,24,19,588,657,172,-485
2018,3,24,20,584,633,180,-453
2018,3,24,21,591,634,166,-468
2018,3,24,22,606,650,131,-519
2018,3,24,23,610,661,142,-519
2018,3,25,0,628,672,225,-447
2018,3,25,1,651,672,224,-448
2018,3,25,2,642,653,219,-434
2018,3,25,3,609,626,218,-408
2018,3,25,4,578,593,195,-398
2018,3,25,5,524,567,120,-447
2018,3,25,6,503,557,116,-441
2018,3,25,7,497,551,117,-434
2018,3,25,8,498,555,118,-437
2018,3,25,9,505,562,117,-445
2018,3,25,10,520,577,116,-461
2018,3,25,11,550,613,203,-410
2018,3,25,12,593,653,218,-435
2018,3,25,13,623,692,282,-410
2018,3,25,14,628,717,314,-403
2018,3,25,15,612,708,312,-396
2018,3,25,16,589,693,255,-438
2018,3,25,17,575,674,231,-443
2018,3,25,18,561,651,219,-432
2018,3,25,19,541,628,191,-437
2018,3,25,20,539,608,165,-443
2018,3,25,21,550,600,132,-468
2018,3,25,22,573,611,130,-481
2018,3,25,23,592,627,130,-497
2018,3,26,0,619,648,180,-468
2018,3,26,1,647,660,224,-436
2018,3,26,2,638,633,225,-408
2018,3,26,3,605,605,229,-376
2018,3,26,4,584,565,210,-355
2018,3,26,5,599,541,133,-408
2018,3,26,6,591,538,132,-406
2018,3,26,7,594,538,128,-410
2018,3,26,8,603,550,129,-421
2018,3,26,9,622,574,134,-440
2018,3,26,10,671,619,130,-489
2018,3,26,11,743,700,284,-416
2018,3,26,12,790,744,352,-392
2018,3,26,13,791,753,357,-396
2018,3,26,14,775,743,305,-438
2018,3,26,15,748,726,254,-472
2018,3,26,16,722,691,227,-464
2018,3,26,17,692,644,229,-415
2018,3,26,18,667,620,174,-446
2018,3,26,19,644,594,136,-458
2018,3,26,20,636,574,119,-455
2018,3,26,21,637,573,113,-460
2018,3,26,22,637,595,113,-482
2018,3,26,23,659,619,113,-506
2018,3,27,0,684,654,216,-438
2018,3,27,1,712,664,218,-446
2018,3,27,2,689,640,218,-422
2018,3,27,3,651,588,216,-372
2018,3,27,4,608,549,172,-377
2018,3,27,5,551,506,100,-406
2018,3,27,6,535,510,110,-400
2018,3,27,7,532,507,113,-394
2018,3,27,8,537,509,111,-398
2018,3,27,9,552,521,113,-408
2018,3,27,10,595,565,117,-448
2018,3,27,11,665,650,217,-433
2018,3,27,12,707,690,217,-473
2018,3,27,13,700,688,217,-471
2018,3,27,14,689,682,219,-463
2018,3,27,15,664,654,216,-438
2018,3,27,16,644,629,151,-478
2018,3,27,17,621,609,118,-491
2018,3,27,18,600,590,145,-445
2018,3,27,19,581,567,204,-363
2018,3,27,20,569,553,214,-339
2018,3,27,21,567,553,211,-342
2018,3,27,22,569,563,297,-266
2018,3,27,23,579,571,318,-253
2018,3,28,0,601,596,380,-216
2018,3,28,1,628,615,427,-188
2018,3,28,2,605,595,397,-198
2018,3,28,3,562,554,247,-307
2018,3,28,4,519,508,150,-358
2018,3,28,5,489,477,117,-360
2018,3,28,6,473,468,115,-353
2018,3,28,7,466,458,114,-344
2018,3,28,8,466,469,115,-354
2018,3,28,9,476,481,116,-365
2018,3,28,10,510,519,183,-336
2018,3,28,11,584,592,397,-195
2018,3,28,12,618,628,410,-218
2018,3,28,13,607,613,305,-308
2018,3,28,14,596,595,246,-349
2018,3,28,15,580,574,167,-407
2018,3,28,16,561,553,111,-442
2018,3,28,17,544,541,66,-475
2018,3,28,18,537,533,52,-481
2018,3,28,19,525,520,56,-464
2018,3,28,20,517,515,54,-461
2018,3,28,21,522,521,64,-457
2018,3,28,22,521,530,126,-404
2018,3,28,23,521,533,124,-409
2018,3,29,0,549,547,149,-398
2018,3,29,1,573,567,204,-363
2018,3,29,2,552,549,204,-345
2018,3,29,3,507,495,188,-307
2018,3,29,4,462,451,112,-339
2018,3,29,5,424,411,65,-346
2018,3,29,6,405,398,60,-338
2018,3,29,7,398,389,64,-325
2018,3,29,8,396,392,67,-325
2018,3,29,9,406,407,69,-338
2018,3,29,10,441,441,68,-373
2018,3,29,11,511,514,170,-344
2018,3,29,12,546,552,172,-380
2018,3,29,13,545,546,162,-384
2018,3,29,14,553,551,173,-378
2018,3,29,15,553,541,174,-367
2018,3,29,16,548,526,161,-365
2018,3,29,17,545,531,89,-442
2018,3,29,18,538,529,68,-461
2018,3,29,19,530,521,67,-454
2018,3,29,20,526,520,66,-454
2018,3,29,21,528,526,69,-457
2018,3,29,22,523,527,116,-411
2018,3,29,23,519,538,137,-401
2018,3,30,0,546,552,137,-415
2018,3,30,1,566,562,136,-426
2018,3,30,2,543,540,138,-402
2018,3,30,3,502,495,136,-359
2018,3,30,4,459,444,97,-347
2018,3,30,5,424,408,64,-344
2018,3,30,6,404,391,62,-329
2018,3,30,7,398,382,60,-322
2018,3,30,8,398,376,59,-317
2018,3,30,9,410,386,60,-326
2018,3,30,10,443,414,63,-351
2018,3,30,11,512,467,129,-338
2018,3,30,12,553,504,139,-365
2018,3,30,13,559,517,137,-380
2018,3,30,14,564,527,165,-362
2018,3,30,15,559,530,174,-356
2018,3,30,16,546,523,175,-348
2018,3,30,17,529,511,180,-331
2018,3,30,18,522,500,178,-322
2018,3,30,19,512,496,160,-336
2018,3,30,20,499,478,151,-327
2018,3,30,21,502,497,163,-334
2018,3,30,22,500,503,161,-342
2018,3,30,23,502,511,160,-351
2018,3,31,0,526,525,186,-339
2018,3,31,1,555,544,188,-356
2018,3,31,2,544,540,189,-351
2018,3,31,3,524,509,117,-392
2018,3,31,4,489,479,62,-417
2018,3,31,5,484,460,60,-400
2018,3,31,6,475,451,60,-391
2018,3,31,7,479,454,61,-393
2018,3,31,8,488,462,58,-404
2018,3,31,9,501,478,61,-417
2018,3,31,10,534,510,63,-447
2018,3,31,11,577,557,156,-401
2018,3,31,12,628,610,160,-450
2018,3,31,13,649,642,177,-465
2018,3,31,14,642,628,175,-453
2018,3,31,15,618,591,167,-424
2018,3,31,16,588,552,107,-445
2018,3,31,17,553,517,69,-448
2018,3,31,18,527,492,68,-424
2018,3,31,19,511,476,70,-406
2018,3,31,20,496,465,69,-396
2018,3,31,21,500,465,69,-396
2018,3,31,22,488,473,128,-345
2018,3,31,23,478,483,138,-345
2018,4,1,0,500,494,139,-355
2018,4,1,1,526,521,158,-363
2018,4,1,2,517,513,144,-369
2018,4,1,3,492,494,131,-363
2018,4,1,4,459,458,71,-387
2018,4,1,5,428,434,62,-372
2018,4,1,6,412,431,66,-365
2018,4,1,7,406,429,64,-365
2018,4,1,8,407,437,79,-358
2018,4,1,9,414,450,110,-340
2018,4,1,10,437,480,130,-350
2018,4,1,11,465,526,132,-394
2018,4,1,12,507,560,129,-431
2018,4,1,13,540,594,132,-462
2018,4,1,14,545,574,133,-441
2018,4,1,15,526,538,134,-404
2018,4,1,16,508,502,134,-368
2018,4,1,17,495,490,135,-355
2018,4,1,18,482,465,134,-331
2018,4,1,19,467,451,136,-315
2018,4,1,20,464,446,134,-312
2018,4,1,21,468,447,134,-313
2018,4,1,22,485,452,133,-319
2018,4,1,23,497,460,134,-326
2018,4,2,0,509,479,158,-321
2018,4,2,1,527,497,177,-320
2018,4,2,2,503,483,145,-338
2018,4,2,3,468,451,132,-319
2018,4,2,4,428,416,85,-331
2018,4,2,5,398,388,64,-324
2018,4,2,6,383,378,63,-315
2018,4,2,7,375,377,63,-314
2018,4,2,8,377,379,63,-316
2018,4,2,9,391,394,63,-331
2018,4,2,10,428,428,65,-363
2018,4,2,11,493,488,128,-360
2018,4,2,12,529,528,128,-400
2018,4,2,13,539,540,131,-409
2018,4,2,14,542,537,131,-406
2018,4,2,15,537,533,132,-401
2018,4,2,16,531,530,133,-397
2018,4,2,17,525,519,132,-387
2018,4,2,18,512,503,124,-379
2018,4,2,19,501,518,146,-372
2018,4,2,20,507,517,186,-331
2018,4,2,21,514,515,223,-292
2018,4,2,22,520,518,284,-234
2018,4,2,23,533,534,290,-244
2018,4,3,0,545,531,283,-248
2018,4,3,1,560,550,284,-266
2018,4,3,2,534,526,286,-240
2018,4,3,3,489,483,284,-199
2018,4,3,4,440,436,192,-244
2018,4,3,5,409,405,101,-304
2018,4,3,6,389,389,67,-322
2018,4,3,7,377,388,69,-319
2018,4,3,8,377,386,64,-322
2018,4,3,9,389,405,66,-339
2018,4,3,10,421,442,68,-374
2018,4,3,11,485,506,138,-368
2018,4,3,12,518,549,137,-412
2018,4,3,13,524,558,140,-418
2018,4,3,14,528,552,161,-391
2018,4,3,15,525,537,136,-401
2018,4,3,16,524,525,136,-389
2018,4,3,17,517,520,136,-384
2018,4,3,18,511,521,78,-443
2018,4,3,19,502,518,62,-456
2018,4,3,20,515,521,128,-393
2018,4,3,21,524,519,286,-233
2018,4,3,22,529,534,387,-147
2018,4,3,23,539,535,408,-127
2018,4,4,0,548,546,410,-136
2018,4,4,1,565,560,414,-146
2018,4,4,2,538,541,415,-126
2018,4,4,3,491,495,348,-147
2018,4,4,4,445,443,248,-195
2018,4,4,5,410,411,169,-242
2018,4,4,6,391,396,142,-254
2018,4,4,7,384,382,77,-305
2018,4,4,8,388,381,59,-322
2018,4,4,9,402,379,57,-322
2018,4,4,10,438,409,59,-350
2018,4,4,11,499,454,116,-338
2018,4,4,12,546,495,125,-370
2018,4,4,13,569,511,126,-385
2018,4,4,14,577,525,131,-394
2018,4,4,15,581,537,156,-381
2018,4,4,16,576,534,179,-355
2018,4,4,17,560,529,179,-350
2018,4,4,18,557,527,194,-333
2018,4,4,19,552,517,197,-320
2018,4,4,20,546,513,211,-302
2018,4,4,21,551,517,217,-300
2018,4,4,22,562,528,185,-343
2018,4,4,23,574,544,183,-361
2018,4,5,0,598,563,181,-382
2018,4,5,1,624,603,258,-345
2018,4,5,2,607,599,306,-293
2018,4,5,3,569,569,217,-352
2018,4,5,4,536,536,134,-402
2018,4,5,5,515,517,115,-402
2018,4,5,6,511,516,115,-401
2018,4,5,7,515,518,116,-402
2018,4,5,8,531,534,118,-416
2018,4,5,9,557,556,115,-441
2018,4,5,10,612,602,117,-485
2018,4,5,11,691,674,201,-473
2018,4,5,12,732,731,317,-414
2018,4,5,13,717,721,271,-450
2018,4,5,14,677,690,205,-485
2018,4,5,15,631,650,189,-461
2018,4,5,16,595,613,194,-419
2018,4,5,17,555,575,147,-428
2018,4,5,18,533,552,128,-424
2018,4,5,19,516,526,124,-402
2018,4,5,20,506,517,129,-388
2018,4,5,21,508,498,125,-373
2018,4,5,22,515,491,199,-292
2018,4,5,23,525,503,200,-303
2018,4,6,0,541,520,196,-324
2018,4,6,1,576,553,246,-307
2018,4,6,2,563,544,238,-306
2018,4,6,3,525,517,235,-282
2018,4,6,4,490,482,167,-315
2018,4,6,5,468,463,119,-344
2018,4,6,6,461,467,120,-347
2018,4,6,7,460,471,120,-351
2018,4,6,8,468,482,122,-360
2018,4,6,9,485,508,121,-387
2018,4,6,10,532,550,127,-423
2018,4,6,11,598,613,286,-327
2018,4,6,12,637,667,352,-315
2018,4,6,13,631,666,342,-324
2018,4,6,14,607,630,250,-380
2018,4,6,15,572,595,227,-368
2018,4,6,16,544,569,142,-427
2018,4,6,17,516,562,129,-433
2018,4,6,18,498,543,129,-414
2018,4,6,19,487,524,130,-394
2018,4,6,20,480,519,124,-395
2018,4,6,21,477,530,127,-403
2018,4,6,22,480,542,194,-348
2018,4,6,23,485,555,199,-356
2018,4,7,0,487,566,209,-357
2018,4,7,1,521,568,324,-244
2018,4,7,2,509,549,345,-204
2018,4,7,3,483,520,337,-183
2018,4,7,4,445,488,198,-290
2018,4,7,5,410,452,127,-325
2018,4,7,6,388,442,128,-314
2018,4,7,7,379,433,129,-304
2018,4,7,8,377,435,129,-306
2018,4,7,9,383,442,130,-312
2018,4,7,10,401,459,147,-312
2018,4,7,11,424,481,233,-248
2018,4,7,12,466,519,240,-279
2018,4,7,13,516,539,253,-286
2018,4,7,14,540,561,358,-203
2018,4,7,15,549,565,395,-170
2018,4,7,16,538,564,408,-156
2018,4,7,17,534,559,379,-180
2018,4,7,18,522,556,344,-212
2018,4,7,19,514,548,337,-211
2018,4,7,20,516,552,338,-214
2018,4,7,21,522,568,339,-229
2018,4,7,22,535,589,354,-235
2018,4,7,23,544,598,512,-86
2018,4,8,0,564,628,595,-33
2018,4,8,1,589,645,627,-18
2018,4,8,2,585,631,624,-7
2018,4,8,3,565,603,582,-21
2018,4,8,4,549,579,526,-53
2018,4,8,5,518,566,456,-110
2018,4,8,6,503,562,391,-171
2018,4,8,7,504,565,390,-175
2018,4,8,8,516,576,388,-188
2018,4,8,9,527,589,390,-199
2018,4,8,10,552,611,436,-175
2018,4,8,11,595,650,564,-86
2018,4,8,12,629,692,564,-128
2018,4,8,13,655,716,564,-152
2018,4,8,14,634,694,565,-129
2018,4,8,15,594,656,502,-154
2018,4,8,16,559,617,336,-281
2018,4,8,17,531,589,274,-315
2018,4,8,18,506,563,182,-381
2018,4,8,19,487,538,133,-405
2018,4,8,20,477,531,123,-408
2018,4,8,21,480,524,147,-377
2018,4,8,22,486,536,189,-347
2018,4,8,23,501,564,194,-370
2018,4,9,0,525,587,263,-324
2018,4,9,1,552,616,425,-191
2018,4,9,2,539,601,432,-169
2018,4,9,3,503,564,347,-217
2018,4,9,4,481,525,212,-313
2018,4,9,5,477,496,161,-335
2018,4,9,6,467,486,112,-374
2018,4,9,7,465,484,112,-372
2018,4,9,8,472,489,112,-377
2018,4,9,9,494,501,112,-389
2018,4,9,10,539,540,185,-355
2018,4,9,11,603,618,540,-78
2018,4,9,12,650,661,588,-73
2018,4,9,13,662,663,592,-71
2018,4,9,14,655,665,586,-79
2018,4,9,15,641,662,590,-72
2018,4,9,16,624,650,625,-25
2018,4,9,17,606,639,617,-22
2018,4,9,18,591,628,581,-47
2018,4,9,19,574,610,481,-129
2018,4,9,20,563,613,418,-195
2018,4,9,21,566,637,425,-212
2018,4,9,22,577,574,435,-139
2018,4,9,23,595,620,541,-79
2018,4,10,0,614,625,582,-43
2018,4,10,1,632,640,601,-39
2018,4,10,2,603,619,594,-25
2018,4,10,3,560,569,479,-90
2018,4,10,4,522,537,304,-233
2018,4,10,5,489,512,252,-260
2018,4,10,6,473,510,217,-293
2018,4,10,7,466,509,207,-302
2018,4,10,8,470,515,207,-308
2018,4,10,9,488,533,223,-310
2018,4,10,10,527,576,356,-220
2018,4,10,11,595,656,557,-99
2018,4,10,12,637,687,559,-128
2018,4,10,13,632,672,544,-128
2018,4,10,14,614,633,485,-148
2018,4,10,15,590,610,331,-279
2018,4,10,16,568,584,174,-410
2018,4,10,17,547,556,147,-409
2018,4,10,18,531,543,132,-411
2018,4,10,19,514,527,118,-409
2018,4,10,20,507,512,120,-392
2018,4,10,21,509,513,184,-329
2018,4,10,22,519,520,189,-331
2018,4,10,23,529,527,190,-337
2018,4,11,0,545,544,250,-294
2018,4,11,1,575,582,361,-221
2018,4,11,2,558,572,397,-175
2018,4,11,3,519,537,310,-227
2018,4,11,4,482,493,206,-287
2018,4,11,5,471,474,141,-333
2018,4,11,6,463,467,131,-336
2018,4,11,7,460,472,131,-341
2018,4,11,8,470,485,127,-358
2018,4,11,9,490,508,134,-374
2018,4,11,10,534,564,196,-368
2018,4,11,11,614,652,393,-259
2018,4,11,12,652,701,440,-261
2018,4,11,13,640,677,433,-244
2018,4,11,14,617,639,392,-247
2018,4,11,15,583,593,308,-285
2018,4,11,16,556,567,164,-403
2018,4,11,17,534,545,115,-430
2018,4,11,18,517,536,117,-419
2018,4,11,19,504,518,116,-402
2018,4,11,20,498,511,117,-394
2018,4,11,21,503,511,116,-395
2018,4,11,22,501,512,183,-329
2018,4,11,23,513,524,197,-327
2018,4,12,0,525,536,300,-236
2018,4,12,1,556,571,391,-180
2018,4,12,2,543,555,319,-236
2018,4,12,3,503,519,243,-276
2018,4,12,4,464,478,129,-349
2018,4,12,5,437,456,120,-336
2018,4,12,6,424,457,120,-337
2018,4,12,7,419,465,122,-343
2018,4,12,8,424,474,120,-354
2018,4,12,9,442,497,119,-378
2018,4,12,10,486,542,178,-364
2018,4,12,11,567,634,359,-275
2018,4,12,12,608,672,467,-205
2018,4,12,13,593,652,469,-183
2018,4,12,14,569,607,392,-215
2018,4,12,15,546,566,238,-328
2018,4,12,16,522,542,130,-412
2018,4,12,17,513,526,125,-401
2018,4,12,18,502,511,123,-388
2018,4,12,19,489,504,124,-380
2018,4,12,20,491,500,123,-377
2018,4,12,21,497,506,126,-380
2018,4,12,22,500,516,191,-325
2018,4,12,23,510,521,209,-312
2018,4,13,0,519,519,307,-212
2018,4,13,1,550,547,399,-148
2018,4,13,2,532,531,419,-112
2018,4,13,3,491,485,333,-152
2018,4,13,4,446,440,187,-253
2018,4,13,5,413,403,124,-279
2018,4,13,6,396,390,123,-267
2018,4,13,7,390,382,122,-260
2018,4,13,8,390,388,119,-269
2018,4,13,9,400,398,118,-280
2018,4,13,10,434,444,123,-321
2018,4,13,11,501,510,185,-325
2018,4,13,12,542,549,264,-285
2018,4,13,13,543,549,296,-253
2018,4,13,14,538,534,257,-277
2018,4,13,15,528,521,260,-261
2018,4,13,16,521,515,231,-284
2018,4,13,17,514,504,198,-306
2018,4,13,18,507,503,195,-308
2018,4,13,19,498,500,195,-305
2018,4,13,20,508,499,221,-278
2018,4,13,21,516,507,283,-224
2018,4,13,22,506,512,290,-222
2018,4,13,23,510,512,308,-204
2018,4,14,0,504,511,310,-201
2018,4,14,1,532,523,346,-177
2018,4,14,2,519,506,312,-194
2018,4,14,3,490,479,288,-191
2018,4,14,4,443,435,181,-254
2018,4,14,5,408,396,133,-263
2018,4,14,6,384,372,113,-259
2018,4,14,7,367,366,115,-251
2018,4,14,8,360,358,117,-241
2018,4,14,9,362,364,116,-248
2018,4,14,10,376,376,115,-261
2018,4,14,11,403,406,115,-291
2018,4,14,12,430,435,117,-318
2018,4,14,13,455,464,117,-347
2018,4,14,14,485,489,120,-369
2018,4,14,15,498,493,117,-376
2018,4,14,16,509,490,119,-371
2018,4,14,17,503,488,121,-367
2018,4,14,18,499,485,174,-311
2018,4,14,19,496,483,256,-227
2018,4,14,20,501,490,291,-199
2018,4,14,21,513,506,323,-183
2018,4,14,22,515,513,376,-137
2018,4,14,23,506,511,383,-128
2018,4,15,0,508,480,425,-55
2018,4,15,1,521,523,459,-64
2018,4,15,2,510,505,458,-47
2018,4,15,3,475,472,426,-46
2018,4,15,4,429,430,360,-70
2018,4,15,5,397,399,223,-176
2018,4,15,6,372,375,121,-254
2018,4,15,7,362,363,120,-243
2018,4,15,8,353,361,115,-246
2018,4,15,9,352,359,117,-242
2018,4,15,10,359,366,121,-245
2018,4,15,11,378,384,120,-264
2018,4,15,12,412,409,119,-290
2018,4,15,13,453,452,121,-331
2018,4,15,14,482,485,121,-364
2018,4,15,15,485,497,121,-376
2018,4,15,16,482,495,151,-344
2018,4,15,17,490,501,190,-311
2018,4,15,18,494,502,193,-309
2018,4,15,19,478,494,190,-304
2018,4,15,20,476,493,192,-301
2018,4,15,21,484,511,241,-270
2018,4,15,22,500,522,306,-216
2018,4,15,23,506,531,370,-161
2018,4,16,0,510,531,389,-142
2018,4,16,1,527,534,340,-194
2018,4,16,2,509,510,282,-228
2018,4,16,3,478,476,235,-241
2018,4,16,4,438,439,225,-214
2018,4,16,5,413,412,225,-187
2018,4,16,6,402,407,225,-182
2018,4,16,7,410,418,230,-188
2018,4,16,8,423,424,225,-199
2018,4,16,9,448,449,226,-223
2018,4,16,10,504,503,229,-274
2018,4,16,11,582,589,307,-282
2018,4,16,12,633,641,376,-265
2018,4,16,13,639,591,315,-276
2018,4,16,14,629,613,305,-308
2018,4,16,15,617,694,305,-389
2018,4,16,16,606,690,303,-387
2018,4,16,17,594,608,246,-362
2018,4,16,18,580,607,245,-362
2018,4,16,19,569,607,235,-372
2018,4,16,20,559,601,225,-376
2018,4,16,21,558,628,271,-357
2018,4,16,22,566,666,298,-368
2018,4,16,23,587,706,375,-331
2018,4,17,0,613,733,398,-335
2018,4,17,1,641,760,478,-282
2018,4,17,2,625,746,494,-252
2018,4,17,3,590,701,428,-273
2018,4,17,4,555,662,333,-329
2018,4,17,5,556,634,219,-415
2018,4,17,6,548,629,217,-412
2018,4,17,7,552,628,219,-409
2018,4,17,8,567,633,222,-411
2018,4,17,9,594,646,254,-392
2018,4,17,10,644,680,371,-309
2018,4,17,11,730,766,547,-219
2018,4,17,12,765,787,526,-261
2018,4,17,13,737,754,411,-343
2018,4,17,14,681,711,374,-337
2018,4,17,15,626,663,391,-272
2018,4,17,16,587,624,335,-289
2018,4,17,17,558,586,303,-283
2018,4,17,18,534,559,317,-242
2018,4,17,19,514,542,295,-247
2018,4,17,20,504,522,172,-350
2018,4,17,21,505,520,114,-406
2018,4,17,22,504,528,113,-415
2018,4,17,23,514,536,195,-341
2018,4,18,0,526,542,198,-344
2018,4,18,1,557,565,239,-326
2018,4,18,2,543,554,249,-305
2018,4,18,3,500,505,222,-283
2018,4,18,4,462,459,132,-327
2018,4,18,5,432,425,55,-370
2018,4,18,6,415,416,54,-362
2018,4,18,7,408,415,56,-359
2018,4,18,8,409,417,81,-336
2018,4,18,9,418,431,131,-300
2018,4,18,10,452,475,200,-275
2018,4,18,11,526,553,276,-277
2018,4,18,12,560,575,240,-335
2018,4,18,13,549,563,186,-377
2018,4,18,14,542,542,159,-383
2018,4,18,15,539,534,162,-372
2018,4,18,16,531,528,161,-367
2018,4,18,17,517,521,151,-370
2018,4,18,18,520,519,103,-416
2018,4,18,19,512,525,124,-401
2018,4,18,20,518,545,136,-409
2018,4,18,21,533,558,201,-357
2018,4,18,22,538,558,246,-312
2018,4,18,23,546,572,369,-203
2018,4,19,0,540,566,383,-183
2018,4,19,1,563,575,449,-126
2018,4,19,2,549,556,359,-197
2018,4,19,3,503,506,288,-218
2018,4,19,4,452,451,260,-191
2018,4,19,5,411,412,121,-291
2018,4,19,6,389,390,54,-336
2018,4,19,7,381,381,59,-322
2018,4,19,8,382,373,55,-318
2018,4,19,9,392,380,58,-322
2018,4,19,10,428,411,166,-245
2018,4,19,11,496,473,236,-237
2018,4,19,12,536,505,249,-256
2018,4,19,13,545,516,256,-260
2018,4,19,14,554,523,255,-268
2018,4,19,15,559,523,220,-303
2018,4,19,16,553,527,130,-397
2018,4,19,17,544,522,155,-367
2018,4,19,18,544,522,225,-297
2018,4,19,19,539,508,264,-244
2018,4,19,20,530,505,324,-181
2018,4,19,21,541,508,425,-83
2018,4,19,22,543,521,371,-150
2018,4,19,23,555,533,369,-164
2018,4,20,0,578,553,376,-177
2018,4,20,1,605,582,425,-157
2018,4,20,2,598,584,456,-128
2018,4,20,3,555,546,377,-169
2018,4,20,4,522,513,193,-320
2018,4,20,5,487,483,112,-371
2018,4,20,6,482,489,122,-367
2018,4,20,7,489,494,120,-374
2018,4,20,8,504,505,122,-383
2018,4,20,9,528,529,123,-406
2018,4,20,10,583,581,224,-357
2018,4,20,11,676,661,302,-359
2018,4,20,12,712,701,344,-357
2018,4,20,13,665,678,338,-340
2018,4,20,14,613,638,241,-397
2018,4,20,15,576,597,191,-406
2018,4,20,16,546,551,137,-414
2018,4,20,17,507,527,125,-402
2018,4,20,18,493,511,122,-389
2018,4,20,19,486,496,110,-386
2018,4,20,20,478,493,100,-393
2018,4,20,21,479,495,158,-337
2018,4,20,22,477,489,167,-322
2018,4,20,23,483,496,174,-322
2018,4,21,0,481,499,215,-284
2018,4,21,1,513,520,238,-282
2018,4,21,2,510,514,239,-275
2018,4,21,3,479,491,246,-245
2018,4,21,4,451,458,232,-226
2018,4,21,5,437,434,104,-330
2018,4,21,6,425,436,72,-364
2018,4,21,7,426,447,62,-385
2018,4,21,8,433,456,61,-395
2018,4,21,9,446,476,62,-414
2018,4,21,10,476,505,82,-423
2018,4,21,11,515,552,205,-347
2018,4,21,12,550,598,293,-305
2018,4,21,13,573,606,274,-332
2018,4,21,14,570,583,216,-367
2018,4,21,15,547,546,173,-373
2018,4,21,16,520,524,175,-349
2018,4,21,17,503,497,174,-323
2018,4,21,18,485,479,143,-336
2018,4,21,19,471,471,141,-330
2018,4,21,20,468,467,150,-317
2018,4,21,21,466,472,148,-324
2018,4,21,22,472,484,192,-292
2018,4,21,23,473,486,226,-260
2018,4,22,0,471,487,238,-249
2018,4,22,1,497,510,253,-257
2018,4,22,2,493,502,257,-245
2018,4,22,3,464,472,216,-256
2018,4,22,4,429,440,138,-302
2018,4,22,5,397,414,132,-282
2018,4,22,6,377,409,98,-311
2018,4,22,7,371,409,63,-346
2018,4,22,8,374,412,63,-349
2018,4,22,9,377,421,62,-359
2018,4,22,10,395,446,65,-381
2018,4,22,11,427,473,148,-325
2018,4,22,12,463,513,175,-338
2018,4,22,13,506,546,185,-361
2018,4,22,14,527,551,188,-363
2018,4,22,15,516,537,177,-360
2018,4,22,16,501,524,115,-409
2018,4,22,17,494,524,119,-405
2018,4,22,18,487,520,139,-381
2018,4,22,19,472,507,137,-370
2018,4,22,20,471,507,139,-368
2018,4,22,21,478,516,232,-284
2018,4,22,22,490,527,244,-283
2018,4,22,23,496,530,245,-285
2018,4,23,0,506,543,248,-295
2018,4,23,1,527,557,286,-271
2018,4,23,2,519,531,285,-246
2018,4,23,3,482,495,279,-216
2018,4,23,4,444,453,248,-205
2018,4,23,5,416,424,185,-239
2018,4,23,6,403,411,134,-277
2018,4,23,7,399,406,90,-316
2018,4,23,8,402,406,74,-332
2018,4,23,9,414,419,71,-348
2018,4,23,10,456,459,75,-384
2018,4,23,11,526,533,185,-348
2018,4,23,12,564,568,212,-356
2018,4,23,13,567,583,215,-368
2018,4,23,14,564,572,222,-350
2018,4,23,15,564,613,273,-340
2018,4,23,16,552,599,327,-272
2018,4,23,17,546,600,346,-254
2018,4,23,18,537,596,319,-277
2018,4,23,19,525,580,388,-192
2018,4,23,20,517,580,273,-307
2018,4,23,21,525,586,301,-285
2018,4,23,22,536,601,306,-295
2018,4,23,23,550,601,302,-299
2018,4,24,0,568,608,399,-209
2018,4,24,1,580,603,448,-155
2018,4,24,2,560,577,327,-250
2018,4,24,3,517,535,262,-273
2018,4,24,4,473,484,210,-274
2018,4,24,5,447,456,145,-311
2018,4,24,6,429,436,133,-303
2018,4,24,7,420,416,135,-281
2018,4,24,8,419,428,140,-288
2018,4,24,9,428,438,140,-298
2018,4,24,10,464,478,159,-319
2018,4,24,11,537,546,200,-346
2018,4,24,12,567,551,277,-274
2018,4,24,13,559,426,178,-248
2018,4,24,14,547,771,550,-221
2018,4,24,15,544,574,382,-192
2018,4,24,16,534,564,358,-206
2018,4,24,17,520,552,360,-192
2018,4,24,18,514,546,367,-179
2018,4,24,19,501,535,389,-146
2018,4,24,20,496,528,337,-191
2018,4,24,21,504,538,198,-340
2018,4,24,22,513,549,212,-337
2018,4,24,23,527,564,237,-327
2018,4,25,0,535,568,245,-323
2018,4,25,1,557,572,278,-294
2018,4,25,2,547,551,272,-279
2018,4,25,3,501,504,252,-252
2018,4,25,4,457,460,204,-256
2018,4,25,5,429,431,166,-265
2018,4,25,6,410,417,168,-249
2018,4,25,7,400,411,175,-236
2018,4,25,8,402,411,176,-235
2018,4,25,9,412,424,178,-246
2018,4,25,10,450,463,178,-285
2018,4,25,11,521,536,223,-313
2018,4,25,12,559,568,225,-343
2018,4,25,13,554,566,229,-337
2018,4,25,14,543,560,264,-296
2018,4,25,15,538,564,290,-274
2018,4,25,16,523,555,295,-260
2018,4,25,17,513,548,329,-219
2018,4,25,18,511,539,340,-199
2018,4,25,19,499,535,371,-164
2018,4,25,20,495,532,387,-145
2018,4,25,21,503,532,396,-136
2018,4,25,22,510,549,403,-146
2018,4,25,23,519,562,408,-154
2018,4,26,0,527,572,429,-143
2018,4,26,1,546,578,449,-129
2018,4,26,2,537,555,310,-245
2018,4,26,3,497,509,252,-257
2018,4,26,4,451,467,194,-273
2018,4,26,5,418,438,180,-258
2018,4,26,6,400,423,182,-241
2018,4,26,7,393,422,183,-239
2018,4,26,8,396,423,183,-240
2018,4,26,9,407,434,183,-251
2018,4,26,10,446,470,181,-289
2018,4,26,11,522,541,185,-356
2018,4,26,12,558,570,230,-340
2018,4,26,13,541,569,244,-325
2018,4,26,14,573,555,265,-290
2018,4,26,15,546,545,267,-278
2018,4,26,16,534,541,267,-274
2018,4,26,17,524,541,267,-274
2018,4,26,18,520,544,266,-278
2018,4,26,19,510,543,266,-277
2018,4,26,20,503,551,302,-249
2018,4,26,21,512,559,303,-256
2018,4,26,22,523,564,305,-259
2018,4,26,23,539,562,310,-252
2018,4,27,0,547,579,374,-205
2018,4,27,1,561,587,464,-123
2018,4,27,2,549,563,360,-203
2018,4,27,3,505,519,245,-274
2018,4,27,4,463,476,233,-243
2018,4,27,5,436,447,192,-255
2018,4,27,6,420,436,183,-253
2018,4,27,7,414,430,183,-247
2018,4,27,8,415,427,183,-244
2018,4,27,9,425,439,183,-256
2018,4,27,10,462,475,186,-289
2018,4,27,11,535,546,243,-303
2018,4,27,12,566,577,305,-272
2018,4,27,13,558,574,366,-208
2018,4,27,14,542,573,439,-134
2018,4,27,15,536,563,444,-119
2018,4,27,16,522,554,409,-145
2018,4,27,17,509,529,480,-49
2018,4,27,18,503,521,496,-25
2018,4,27,19,492,506,494,-12
2018,4,27,20,487,500,495,-5
2018,4,27,21,492,507,491,-16
2018,4,27,22,496,500,389,-111
2018,4,27,23,499,545,363,-182
2018,4,28,0,500,501,410,-91
2018,4,28,1,515,533,446,-87
2018,4,28,2,506,516,405,-111
2018,4,28,3,473,488,418,-70
2018,4,28,4,436,440,197,-243
2018,4,28,5,409,426,170,-256
2018,4,28,6,389,401,167,-234
2018,4,28,7,381,405,169,-236
2018,4,28,8,379,412,170,-242
2018,4,28,9,383,423,167,-256
2018,4,28,10,399,450,170,-280
2018,4,28,11,427,486,172,-314
2018,4,28,12,464,527,180,-347
2018,4,28,13,489,543,182,-361
2018,4,28,14,503,532,179,-353
2018,4,28,15,504,521,179,-342
2018,4,28,16,494,500,174,-326
2018,4,28,17,491,487,176,-311
2018,4,28,18,485,477,184,-293
2018,4,28,19,474,473,172,-301
2018,4,28,20,473,476,172,-304
2018,4,28,21,478,484,176,-308
2018,4,28,22,489,488,242,-246
2018,4,28,23,492,494,301,-193
2018,4,29,0,491,495,302,-193
2018,4,29,1,500,507,303,-204
2018,4,29,2,492,499,286,-213
2018,4,29,3,459,467,205,-262
2018,4,29,4,423,427,165,-262
2018,4,29,5,397,396,129,-267
2018,4,29,6,379,382,128,-254
2018,4,29,7,374,378,130,-248
2018,4,29,8,373,383,131,-252
2018,4,29,9,378,397,128,-269
2018,4,29,10,397,420,127,-293
2018,4,29,11,423,456,124,-332
2018,4,29,12,469,504,125,-379
2018,4,29,13,508,535,126,-409
2018,4,29,14,519,538,148,-390
2018,4,29,15,506,522,149,-373
2018,4,29,16,488,499,143,-356
2018,4,29,17,484,491,158,-333
2018,4,29,18,479,483,158,-325
2018,4,29,19,466,468,159,-309
2018,4,29,20,463,463,159,-304
2018,4,29,21,469,467,157,-310
2018,4,29,22,484,483,159,-324
2018,4,29,23,488,496,161,-335
2018,4,30,0,503,508,165,-343
2018,4,30,1,525,532,164,-368
2018,4,30,2,515,531,176,-355
2018,4,30,3,483,494,177,-317
2018,4,30,4,441,462,175,-287
2018,4,30,5,411,437,91,-346
2018,4,30,6,399,437,81,-356
2018,4,30,7,386,445,98,-347
2018,4,30,8,393,456,107,-349
2018,4,30,9,412,487,125,-362
2018,4,30,10,453,543,175,-368
2018,4,30,11,531,632,256,-376
2018,4,30,12,563,666,318,-348
2018,4,30,13,555,643,296,-347
2018,4,30,14,537,600,250,-350
2018,4,30,15,520,573,204,-369
2018,4,30,16,501,545,189,-356
2018,4,30,17,495,525,194,-331
2018,4,30,18,489,518,182,-336
2018,4,30,19,482,509,181,-328
2018,4,30,20,478,509,181,-328
2018,4,30,21,471,512,187,-325
2018,4,30,22,493,519,261,-258
2018,4,30,23,521,532,349,-183
2018,5,1,0,514,540,459,-81
2018,5,1,1,534,550,448,-102
2018,5,1,2,527,539,440,-99
2018,5,1,3,468,490,333,-157
2018,5,1,4,423,447,168,-279
2018,5,1,5,401,410,70,-340
2018,5,1,6,386,397,75,-322
2018,5,1,7,386,400,103,-297
2018,5,1,8,390,411,129,-282
2018,5,1,9,403,431,126,-305
2018,5,1,10,438,477,157,-320
2018,5,1,11,516,562,209,-353
2018,5,1,12,558,596,225,-371
2018,5,1,13,557,586,227,-359
2018,5,1,14,551,557,201,-356
2018,5,1,15,543,539,194,-345
2018,5,1,16,538,523,193,-330
2018,5,1,17,530,520,195,-325
2018,5,1,18,529,521,196,-325
2018,5,1,19,524,521,194,-327
2018,5,1,20,534,529,213,-316
2018,5,1,21,542,545,225,-320
2018,5,1,22,550,552,222,-330
2018,5,1,23,558,557,246,-311
2018,5,2,0,552,559,257,-302
2018,5,2,1,561,567,269,-298
2018,5,2,2,549,554,256,-298
2018,5,2,3,506,496,173,-323
2018,5,2,4,451,442,103,-339
2018,5,2,5,410,400,60,-340
2018,5,2,6,390,383,60,-323
2018,5,2,7,381,373,60,-313
2018,5,2,8,382,376,60,-316
2018,5,2,9,392,385,55,-330
2018,5,2,10,425,421,84,-337
2018,5,2,11,497,491,121,-370
2018,5,2,12,533,527,121,-406
2018,5,2,13,536,527,124,-403
2018,5,2,14,531,517,121,-396
2018,5,2,15,530,522,121,-401
2018,5,2,16,531,523,122,-401
2018,5,2,17,528,528,124,-404
2018,5,2,18,532,536,122,-414
2018,5,2,19,535,542,151,-391
2018,5,2,20,546,559,152,-407
2018,5,2,21,560,578,184,-394
2018,5,2,22,567,554,282,-272
2018,5,2,23,574,593,467,-126
2018,5,3,0,561,578,505,-73
2018,5,3,1,567,587,547,-40
2018,5,3,2,555,562,501,-61
2018,5,3,3,506,509,217,-292
2018,5,3,4,451,446,165,-281
2018,5,3,5,417,404,99,-305
2018,5,3,6,390,382,57,-325
2018,5,3,7,378,368,62,-306
2018,5,3,8,378,364,61,-303
2018,5,3,9,388,373,62,-311
2018,5,3,10,419,410,118,-292
2018,5,3,11,491,468,127,-341
2018,5,3,12,524,502,127,-375
2018,5,3,13,530,505,119,-386
2018,5,3,14,530,511,114,-397
2018,5,3,15,537,524,148,-376
2018,5,3,16,543,534,179,-355
2018,5,3,17,545,549,189,-360
2018,5,3,18,555,563,212,-351
2018,5,3,19,568,577,209,-368
2018,5,3,20,582,587,266,-321
2018,5,3,21,601,611,387,-224
2018,5,3,22,603,626,572,-54
2018,5,3,23,612,621,597,-24
2018,5,4,0,594,610,577,-33
2018,5,4,1,595,610,582,-28
2018,5,4,2,582,590,466,-124
2018,5,4,3,526,534,222,-312
2018,5,4,4,467,474,159,-315
2018,5,4,5,420,421,97,-324
2018,5,4,6,395,397,61,-336
2018,5,4,7,378,384,67,-317
2018,5,4,8,373,374,67,-307
2018,5,4,9,382,378,69,-309
2018,5,4,10,413,408,116,-292
2018,5,4,11,476,469,132,-337
2018,5,4,12,505,501,133,-368
2018,5,4,13,516,516,133,-383
2018,5,4,14,523,525,131,-394
2018,5,4,15,536,540,135,-405
2018,5,4,16,542,553,133,-420
2018,5,4,17,549,563,150,-413
2018,5,4,18,561,583,187,-396
2018,5,4,19,574,598,224,-374
2018,5,4,20,592,610,364,-246
2018,5,4,21,605,632,425,-207
2018,5,4,22,598,638,546,-92
2018,5,4,23,603,617,602,-15
2018,5,5,0,580,598,586,-12
2018,5,5,1,582,596,575,-21
2018,5,5,2,569,570,408,-162
2018,5,5,3,523,532,365,-167
2018,5,5,4,468,474,289,-185
2018,5,5,5,423,431,209,-222
2018,5,5,6,396,405,114,-291
2018,5,5,7,380,393,70,-323
2018,5,5,8,373,380,69,-311
2018,5,5,9,374,379,73,-306
2018,5,5,10,383,390,133,-257
2018,5,5,11,402,409,134,-275
2018,5,5,12,434,437,138,-299
2018,5,5,13,470,471,135,-336
2018,5,5,14,499,498,142,-356
2018,5,5,15,514,516,141,-375
2018,5,5,16,516,525,137,-388
2018,5,5,17,522,528,109,-419
2018,5,5,18,525,536,113,-423
2018,5,5,19,527,538,129,-409
2018,5,5,20,527,539,131,-408
2018,5,5,21,532,541,224,-317
2018,5,5,22,539,546,234,-312
2018,5,5,23,535,531,230,-301
2018,5,6,0,518,528,228,-300
2018,5,6,1,517,535,231,-304
2018,5,6,2,512,525,232,-293
2018,5,6,3,473,485,231,-254
2018,5,6,4,427,439,143,-296
2018,5,6,5,401,402,77,-325
2018,5,6,6,371,388,76,-312
2018,5,6,7,355,371,78,-293
2018,5,6,8,349,364,78,-286
2018,5,6,9,350,360,77,-283
2018,5,6,10,357,367,85,-282
2018,5,6,11,374,387,143,-244
2018,5,6,12,404,412,144,-268
2018,5,6,13,445,455,165,-290
2018,5,6,14,473,477,181,-296
2018,5,6,15,481,483,149,-334
2018,5,6,16,481,488,182,-306
2018,5,6,17,488,490,170,-320
2018,5,6,18,496,485,178,-307
2018,5,6,19,491,480,145,-335
2018,5,6,20,496,479,140,-339
2018,5,6,21,508,489,216,-273
2018,5,6,22,524,505,221,-284
2018,5,6,23,526,514,246,-268
2018,5,7,0,517,516,264,-252
2018,5,7,1,518,526,269,-257
2018,5,7,2,513,513,265,-248
2018,5,7,3,468,471,188,-283
2018,5,7,4,421,424,164,-260
2018,5,7,5,390,387,81,-306
2018,5,7,6,371,373,79,-294
2018,5,7,7,362,368,80,-288
2018,5,7,8,363,369,80,-289
2018,5,7,9,376,377,81,-296
2018,5,7,10,411,412,141,-271
2018,5,7,11,482,479,146,-333
2018,5,7,12,519,501,195,-306
2018,5,7,13,524,507,202,-305
2018,5,7,14,524,514,204,-310
2018,5,7,15,524,521,199,-322
2018,5,7,16,530,520,189,-331
2018,5,7,17,522,528,183,-345
2018,5,7,18,524,529,133,-396
2018,5,7,19,523,533,136,-397
2018,5,7,20,530,534,126,-408
2018,5,7,21,541,541,138,-403
2018,5,7,22,550,547,179,-368
2018,5,7,23,560,556,275,-281
2018,5,8,0,551,557,278,-279
2018,5,8,1,555,556,274,-282
2018,5,8,2,536,544,276,-268
2018,5,8,3,489,489,275,-214
2018,5,8,4,435,435,181,-254
2018,5,8,5,401,401,98,-303
2018,5,8,6,380,385,79,-306
2018,5,8,7,368,374,80,-294
2018,5,8,8,369,375,80,-295
2018,5,8,9,381,384,80,-304
2018,5,8,10,414,429,129,-300
2018,5,8,11,484,475,164,-311
2018,5,8,12,519,519,157,-362
2018,5,8,13,521,519,162,-357
2018,5,8,14,519,520,161,-359
2018,5,8,15,518,504,216,-288
2018,5,8,16,524,527,215,-312
2018,5,8,17,516,530,213,-317
2018,5,8,18,517,534,235,-299
2018,5,8,19,514,540,236,-304
2018,5,8,20,524,541,241,-300
2018,5,8,21,532,543,241,-302
2018,5,8,22,539,544,243,-301
2018,5,8,23,549,549,267,-282
2018,5,9,0,546,546,278,-268
2018,5,9,1,548,544,274,-270
2018,5,9,2,530,536,278,-258
2018,5,9,3,483,485,278,-207
2018,5,9,4,432,431,228,-203
2018,5,9,5,402,395,129,-266
2018,5,9,6,381,383,109,-274
2018,5,9,7,370,375,110,-265
2018,5,9,8,370,374,98,-276
2018,5,9,9,379,386,78,-308
2018,5,9,10,413,423,80,-343
2018,5,9,11,482,485,114,-371
2018,5,9,12,515,519,155,-364
2018,5,9,13,517,526,134,-392
2018,5,9,14,521,529,119,-410
2018,5,9,15,523,530,121,-409
2018,5,9,16,525,533,177,-356
2018,5,9,17,521,541,180,-361
2018,5,9,18,528,553,198,-355
2018,5,9,19,530,552,206,-346
2018,5,9,20,538,569,223,-346
2018,5,9,21,550,581,235,-346
2018,5,9,22,560,591,258,-333
2018,5,9,23,564,593,270,-323
2018,5,10,0,557,592,285,-307
2018,5,10,1,561,590,435,-155
2018,5,10,2,548,573,387,-186
2018,5,10,3,500,519,250,-269
2018,5,10,4,447,459,172,-287
2018,5,10,5,410,415,109,-306
2018,5,10,6,386,399,93,-306
2018,5,10,7,374,381,77,-304
2018,5,10,8,373,380,80,-300
2018,5,10,9,382,386,81,-305
2018,5,10,10,418,413,79,-334
2018,5,10,11,482,482,86,-396
2018,5,10,12,516,507,102,-405
2018,5,10,13,521,524,112,-412
2018,5,10,14,528,532,125,-407
2018,5,10,15,538,549,139,-410
2018,5,10,16,544,557,156,-401
2018,5,10,17,553,575,183,-392
2018,5,10,18,563,587,209,-378
2018,5,10,19,575,598,222,-376
2018,5,10,20,586,603,234,-369
2018,5,10,21,599,574,283,-291
2018,5,10,22,601,570,412,-158
2018,5,10,23,604,578,420,-158
2018,5,11,0,596,580,397,-183
2018,5,11,1,592,577,374,-203
2018,5,11,2,578,567,312,-255
2018,5,11,3,527,509,221,-288
2018,5,11,4,468,455,134,-321
2018,5,11,5,420,413,79,-334
2018,5,11,6,395,393,79,-314
2018,5,11,7,380,383,81,-302
2018,5,11,8,373,378,80,-298
2018,5,11,9,379,381,81,-300
2018,5,11,10,412,407,81,-326
2018,5,11,11,473,472,87,-385
2018,5,11,12,503,503,93,-410
2018,5,11,13,512,518,107,-411
2018,5,11,14,525,530,119,-411
2018,5,11,15,542,543,131,-412
2018,5,11,16,547,560,146,-414
2018,5,11,17,560,572,161,-411
2018,5,11,18,580,594,184,-410
2018,5,11,19,595,609,267,-342
2018,5,11,20,614,621,266,-355
2018,5,11,21,625,610,268,-342
2018,5,11,22,624,590,271,-319
2018,5,11,23,621,570,267,-303
2018,5,12,0,600,565,265,-300
2018,5,12,1,590,561,254,-307
2018,5,12,2,581,553,224,-329
2018,5,12,3,529,515,205,-310
2018,5,12,4,472,462,127,-335
2018,5,12,5,430,414,78,-336
2018,5,12,6,402,393,79,-314
2018,5,12,7,384,380,79,-301
2018,5,12,8,375,371,79,-292
2018,5,12,9,374,371,79,-292
2018,5,12,10,383,380,78,-302
2018,5,12,11,401,401,78,-323
2018,5,12,12,433,436,79,-357
2018,5,12,13,468,582,79,-503
2018,5,12,14,499,499,90,-409
2018,5,12,15,523,517,143,-374
2018,5,12,16,537,539,160,-379
2018,5,12,17,546,553,215,-338
2018,5,12,18,564,574,242,-332
2018,5,12,19,579,600,256,-344
2018,5,12,20,589,614,263,-351
2018,5,12,21,606,633,279,-354
2018,5,12,22,618,646,346,-300
2018,5,12,23,611,641,391,-250
2018,5,13,0,591,618,381,-237
2018,5,13,1,578,606,242,-364
2018,5,13,2,575,588,226,-362
2018,5,13,3,522,540,202,-338
2018,5,13,4,466,489,126,-363
2018,5,13,5,425,435,84,-351
2018,5,13,6,396,404,74,-330
2018,5,13,7,376,386,76,-310
2018,5,13,8,366,371,74,-297
2018,5,13,9,364,371,74,-297
2018,5,13,10,366,374,74,-300
2018,5,13,11,381,385,73,-312
2018,5,13,12,412,414,74,-340
2018,5,13,13,455,466,80,-386
2018,5,13,14,486,500,111,-389
2018,5,13,15,500,519,157,-362
2018,5,13,16,513,536,184,-352
2018,5,13,17,534,555,205,-350
2018,5,13,18,555,572,226,-346
2018,5,13,19,575,594,357,-237
2018,5,13,20,591,617,382,-235
2018,5,13,21,613,647,381,-266
2018,5,13,22,628,663,379,-284
2018,5,13,23,629,666,400,-266
2018,5,14,0,617,658,407,-251
2018,5,14,1,603,633,278,-355
2018,5,14,2,587,619,277,-342
2018,5,14,3,531,556,203,-353
2018,5,14,4,472,489,117,-372
2018,5,14,5,434,440,85,-355
2018,5,14,6,404,408,86,-322
2018,5,14,7,387,392,71,-321
2018,5,14,8,380,388,63,-325
2018,5,14,9,387,393,60,-333
2018,5,14,10,414,421,62,-359
2018,5,14,11,474,468,74,-394
2018,5,14,12,507,516,126,-390
2018,5,14,13,529,521,132,-389
2018,5,14,14,548,542,136,-406
2018,5,14,15,572,574,160,-414
2018,5,14,16,597,601,222,-379
2018,5,14,17,623,634,273,-361
2018,5,14,18,648,670,425,-245
2018,5,14,19,686,694,447,-247
2018,5,14,20,706,722,444,-278
2018,5,14,21,714,733,515,-218
2018,5,14,22,724,728,592,-136
2018,5,14,23,721,717,590,-127
2018,5,15,0,695,698,585,-113
2018,5,15,1,668,693,527,-166
2018,5,15,2,642,658,395,-263
2018,5,15,3,577,599,199,-400
2018,5,15,4,503,532,171,-361
2018,5,15,5,453,478,125,-353
2018,5,15,6,421,450,85,-365
2018,5,15,7,403,433,73,-360
2018,5,15,8,394,422,73,-349
2018,5,15,9,398,416,76,-340
2018,5,15,10,427,442,88,-354
2018,5,15,11,487,501,110,-391
2018,5,15,12,517,530,119,-411
2018,5,15,13,531,543,132,-411
2018,5,15,14,544,556,142,-414
2018,5,15,15,557,576,163,-413
2018,5,15,16,569,598,199,-399
2018,5,15,17,589,608,260,-348
2018,5,15,18,608,622,256,-366
2018,5,15,19,627,628,263,-365
2018,5,15,20,633,625,390,-235
2018,5,15,21,634,628,393,-235
2018,5,15,22,641,628,376,-252
2018,5,15,23,637,622,317,-305
2018,5,16,0,624,610,306,-304
2018,5,16,1,612,600,389,-211
2018,5,16,2,593,573,332,-241
2018,5,16,3,529,527,276,-251
2018,5,16,4,471,467,183,-284
2018,5,16,5,429,430,142,-288
2018,5,16,6,405,409,90,-319
2018,5,16,7,390,400,73,-327
2018,5,16,8,386,395,74,-321
2018,5,16,9,393,399,74,-325
2018,5,16,10,422,429,76,-353
2018,5,16,11,480,485,77,-408
2018,5,16,12,516,530,139,-391
2018,5,16,13,526,543,181,-362
2018,5,16,14,535,562,209,-353
2018,5,16,15,547,568,243,-325
2018,5,16,16,551,577,265,-312
2018,5,16,17,558,573,276,-297
2018,5,16,18,569,574,277,-297
2018,5,16,19,581,573,278,-295
2018,5,16,20,583,576,277,-299
2018,5,16,21,586,579,277,-302
2018,5,16,22,585,583,277,-306
2018,5,16,23,593,594,278,-316
2018,5,17,0,580,593,276,-317
2018,5,17,1,580,594,275,-319
2018,5,17,2,569,586,272,-314
2018,5,17,3,519,534,217,-317
2018,5,17,4,463,482,181,-301
2018,5,17,5,424,439,179,-260
2018,5,17,6,400,416,180,-236
2018,5,17,7,390,407,180,-227
2018,5,17,8,387,396,179,-217
2018,5,17,9,392,404,181,-223
2018,5,17,10,424,437,182,-255
2018,5,17,11,486,497,207,-290
2018,5,17,12,521,528,210,-318
2018,5,17,13,532,545,210,-335
2018,5,17,14,543,565,221,-344
2018,5,17,15,553,584,220,-364
2018,5,17,16,558,607,221,-386
2018,5,17,17,562,616,225,-391
2018,5,17,18,568,619,244,-375
2018,5,17,19,571,611,246,-365
2018,5,17,20,570,617,246,-371
2018,5,17,21,572,631,270,-361
2018,5,17,22,565,644,266,-378
2018,5,17,23,578,638,250,-388
2018,5,18,0,566,625,239,-386
2018,5,18,1,571,624,243,-381
2018,5,18,2,563,606,209,-397
2018,5,18,3,517,542,116,-426
2018,5,18,4,463,493,111,-382
2018,5,18,5,432,450,109,-341
2018,5,18,6,406,429,110,-319
2018,5,18,7,393,417,112,-305
2018,5,18,8,389,408,108,-300
2018,5,18,9,396,413,110,-303
2018,5,18,10,426,441,114,-327
2018,5,18,11,484,501,175,-326
2018,5,18,12,517,536,224,-312
2018,5,18,13,532,553,190,-363
2018,5,18,14,549,570,257,-313
2018,5,18,15,562,583,266,-317
2018,5,18,16,572,599,265,-334
2018,5,18,17,579,610,265,-345
2018,5,18,18,592,619,265,-354
2018,5,18,19,595,619,269,-350
2018,5,18,20,601,618,268,-350
2018,5,18,21,598,633,269,-364
2018,5,18,22,598,629,261,-368
2018,5,18,23,595,614,260,-354
2018,5,19,0,577,600,208,-392
2018,5,19,1,576,587,236,-351
2018,5,19,2,567,571,252,-319
2018,5,19,3,527,531,209,-322
2018,5,19,4,477,479,180,-299
2018,5,19,5,436,429,178,-251
2018,5,19,6,408,410,180,-230
2018,5,19,7,393,399,180,-219
2018,5,19,8,385,386,178,-208
2018,5,19,9,386,384,181,-203
2018,5,19,10,397,402,180,-222
2018,5,19,11,415,424,181,-243
2018,5,19,12,446,448,179,-269
2018,5,19,13,483,486,182,-304
2018,5,19,14,514,525,245,-280
2018,5,19,15,529,552,261,-291
2018,5,19,16,538,568,259,-309
2018,5,19,17,545,571,204,-367
2018,5,19,18,553,574,186,-388
2018,5,19,19,556,581,187,-394
2018,5,19,20,566,600,191,-409
2018,5,19,21,575,605,205,-400
2018,5,19,22,585,600,235,-365
2018,5,19,23,583,604,233,-371
2018,5,20,0,560,591,222,-369
2018,5,20,1,556,582,221,-361
2018,5,20,2,549,569,226,-343
2018,5,20,3,511,532,210,-322
2018,5,20,4,462,481,190,-291
2018,5,20,5,423,443,152,-291
2018,5,20,6,395,414,146,-268
2018,5,20,7,380,398,145,-253
2018,5,20,8,375,389,125,-264
2018,5,20,9,375,388,119,-269
2018,5,20,10,384,392,118,-274
2018,5,20,11,401,409,118,-291
2018,5,20,12,432,434,166,-268
2018,5,20,13,477,475,176,-299
2018,5,20,14,510,513,209,-304
2018,5,20,15,522,527,235,-292
2018,5,20,16,539,557,269,-288
2018,5,20,17,558,589,318,-271
2018,5,20,18,579,612,395,-217
2018,5,20,19,595,624,446,-178
2018,5,20,20,612,613,433,-180
2018,5,20,21,631,602,463,-139
2018,5,20,22,649,593,548,-45
2018,5,20,23,649,590,490,-100
2018,5,21,0,632,563,362,-201
2018,5,21,1,616,580,355,-225
2018,5,21,2,607,567,278,-289
2018,5,21,3,552,520,168,-352
2018,5,21,4,492,470,164,-306
2018,5,21,5,429,429,169,-260
2018,5,21,6,402,401,165,-236
2018,5,21,7,387,394,152,-242
2018,5,21,8,382,388,145,-243
2018,5,21,9,389,396,151,-245
2018,5,21,10,421,424,159,-265
2018,5,21,11,478,482,161,-321
2018,5,21,12,516,518,161,-357
2018,5,21,13,533,533,162,-371
2018,5,21,14,550,548,152,-396
2018,5,21,15,569,563,152,-411
2018,5,21,16,591,575,164,-411
2018,5,21,17,601,593,181,-412
2018,5,21,18,620,607,187,-420
2018,5,21,19,637,645,265,-380
2018,5,21,20,642,655,386,-269
2018,5,21,21,644,673,409,-264
2018,5,21,22,637,677,377,-300
2018,5,21,23,630,680,328,-352
2018,5,22,0,616,664,364,-300
2018,5,22,1,604,642,367,-275
2018,5,22,2,583,622,290,-332
2018,5,22,3,531,557,238,-319
2018,5,22,4,469,495,194,-301
2018,5,22,5,430,448,184,-264
2018,5,22,6,404,414,135,-279
2018,5,22,7,388,397,133,-264
2018,5,22,8,383,397,130,-267
2018,5,22,9,389,400,127,-273
2018,5,22,10,419,431,129,-302
2018,5,22,11,474,490,174,-316
2018,5,22,12,511,526,172,-354
2018,5,22,13,524,548,173,-375
2018,5,22,14,534,573,191,-382
2018,5,22,15,549,593,203,-390
2018,5,22,16,567,609,203,-406
2018,5,22,17,575,624,224,-400
2018,5,22,18,594,627,242,-385
2018,5,22,19,606,646,334,-312
2018,5,22,20,612,658,357,-301
2018,5,22,21,616,667,388,-279
2018,5,22,22,612,662,424,-238
2018,5,22,23,608,657,430,-227
2018,5,23,0,597,640,393,-247
2018,5,23,1,593,626,396,-230
2018,5,23,2,576,610,392,-218
2018,5,23,3,525,558,291,-267
2018,5,23,4,468,500,177,-323
2018,5,23,5,436,460,137,-323
2018,5,23,6,409,431,61,-370
2018,5,23,7,395,416,67,-349
2018,5,23,8,391,406,71,-335
2018,5,23,9,398,414,74,-340
2018,5,23,10,430,437,72,-365
2018,5,23,11,489,496,98,-398
2018,5,23,12,526,529,171,-358
2018,5,23,13,542,546,171,-375
2018,5,23,14,558,576,173,-403
2018,5,23,15,576,603,190,-413
2018,5,23,16,593,629,215,-414
2018,5,23,17,606,643,337,-306
2018,5,23,18,626,673,541,-132
2018,5,23,19,638,692,594,-98
2018,5,23,20,647,805,526,-279
2018,5,23,21,657,730,581,-149
2018,5,23,22,659,731,598,-133
2018,5,23,23,651,728,561,-167
2018,5,24,0,637,702,511,-191
2018,5,24,1,627,682,537,-145
2018,5,24,2,609,656,486,-170
2018,5,24,3,554,594,250,-344
2018,5,24,4,493,527,171,-356
2018,5,24,5,456,471,105,-366
2018,5,24,6,424,444,71,-373
2018,5,24,7,406,427,71,-356
2018,5,24,8,400,415,70,-345
2018,5,24,9,403,418,70,-348
2018,5,24,10,433,439,70,-369
2018,5,24,11,488,501,92,-409
2018,5,24,12,524,536,151,-385
2018,5,24,13,539,558,173,-385
2018,5,24,14,554,583,179,-404
2018,5,24,15,570,612,200,-412
2018,5,24,16,584,631,293,-338
2018,5,24,17,595,653,324,-329
2018,5,24,18,611,672,373,-299
2018,5,24,19,615,686,422,-264
2018,5,24,20,623,694,404,-290
2018,5,24,21,631,706,428,-278
2018,5,24,22,636,705,427,-278
2018,5,24,23,628,689,429,-260
2018,5,25,0,620,664,390,-274
2018,5,25,1,613,650,418,-232
2018,5,25,2,598,641,361,-280
2018,5,25,3,547,678,337,-341
2018,5,25,4,489,523,193,-330
2018,5,25,5,451,468,108,-360
2018,5,25,6,420,445,75,-370
2018,5,25,7,403,428,75,-353
2018,5,25,8,396,421,76,-345
2018,5,25,9,401,423,77,-346
2018,5,25,10,427,447,75,-372
2018,5,25,11,480,504,99,-405
2018,5,25,12,515,539,203,-336
2018,5,25,13,530,566,210,-356
2018,5,25,14,550,584,209,-375
2018,5,25,15,566,608,219,-389
2018,5,25,16,580,621,225,-396
2018,5,25,17,587,631,228,-403
2018,5,25,18,598,644,255,-389
2018,5,25,19,603,659,293,-366
2018,5,25,20,627,657,288,-369
2018,5,25,21,615,665,333,-332
2018,5,25,22,612,671,351,-320
2018,5,25,23,602,647,340,-307
2018,5,26,0,583,624,304,-320
2018,5,26,1,578,610,206,-404
2018,5,26,2,567,597,188,-409
2018,5,26,3,528,563,168,-395
2018,5,26,4,477,509,164,-345
2018,5,26,5,449,461,103,-358
2018,5,26,6,421,433,68,-365
2018,5,26,7,404,416,69,-347
2018,5,26,8,395,410,71,-339
2018,5,26,9,395,401,68,-333
2018,5,26,10,407,412,77,-335
2018,5,26,11,425,428,167,-261
2018,5,26,12,457,457,171,-286
2018,5,26,13,494,495,170,-325
2018,5,26,14,532,537,172,-365
2018,5,26,15,559,558,171,-387
2018,5,26,16,581,577,177,-400
2018,5,26,17,586,598,188,-410
2018,5,26,18,611,607,220,-387
2018,5,26,19,617,600,250,-350
2018,5,26,20,626,599,351,-248
2018,5,26,21,632,587,403,-184
2018,5,26,22,635,586,415,-171
2018,5,26,23,629,579,397,-182
2018,5,27,0,609,571,336,-235
2018,5,27,1,596,564,351,-213
2018,5,27,2,590,555,349,-206
2018,5,27,3,545,522,236,-286
2018,5,27,4,490,476,176,-300
2018,5,27,5,436,432,122,-310
2018,5,27,6,406,406,83,-323
2018,5,27,7,388,393,74,-319
2018,5,27,8,379,387,74,-313
2018,5,27,9,376,383,73,-310
2018,5,27,10,380,386,73,-313
2018,5,27,11,390,398,84,-314
2018,5,27,12,417,429,174,-255
2018,5,27,13,464,476,174,-302
2018,5,27,14,499,508,175,-333
2018,5,27,15,516,529,177,-352
2018,5,27,16,535,555,176,-379
2018,5,27,17,555,585,183,-402
2018,5,27,18,571,600,235,-365
2018,5,27,19,583,611,327,-284
2018,5,27,20,589,613,359,-254
2018,5,27,21,601,620,375,-245
2018,5,27,22,607,625,374,-251
2018,5,27,23,608,614,367,-247
2018,5,28,0,589,597,241,-356
2018,5,28,1,590,590,181,-409
2018,5,28,2,580,574,175,-399
2018,5,28,3,529,531,173,-358
2018,5,28,4,476,480,164,-316
2018,5,28,5,440,436,132,-304
2018,5,28,6,409,416,134,-282
2018,5,28,7,392,400,131,-269
2018,5,28,8,386,386,126,-260
2018,5,28,9,383,391,128,-263
2018,5,28,10,398,405,127,-278
2018,5,28,11,419,435,156,-279
2018,5,28,12,444,455,157,-298
2018,5,28,13,483,490,159,-331
2018,5,28,14,509,526,159,-367
2018,5,28,15,541,549,162,-387
2018,5,28,16,572,558,155,-403
2018,5,28,17,589,563,161,-402
2018,5,28,18,593,562,160,-402
2018,5,28,19,600,559,160,-399
2018,5,28,20,610,557,157,-400
2018,5,28,21,617,565,161,-404
2018,5,28,22,623,568,160,-408
2018,5,28,23,612,573,163,-410
2018,5,29,0,603,569,166,-403
2018,5,29,1,601,562,167,-395
2018,5,29,2,588,552,166,-386
2018,5,29,3,534,515,167,-348
2018,5,29,4,483,469,159,-310
2018,5,29,5,442,429,157,-272
2018,5,29,6,418,410,157,-253
2018,5,29,7,409,397,158,-239
2018,5,29,8,405,395,159,-236
2018,5,29,9,413,404,161,-243
2018,5,29,10,445,433,162,-271
2018,5,29,11,503,498,165,-333
2018,5,29,12,542,532,165,-367
2018,5,29,13,565,557,168,-389
2018,5,29,14,581,577,172,-405
2018,5,29,15,597,594,187,-407
2018,5,29,16,613,613,204,-409
2018,5,29,17,617,615,224,-391
2018,5,29,18,628,615,250,-365
2018,5,29,19,632,610,247,-363
2018,5,29,20,637,607,245,-362
2018,5,29,21,650,610,251,-359
2018,5,29,22,654,617,247,-370
2018,5,29,23,653,614,236,-378
2018,5,30,0,640,612,234,-378
2018,5,30,1,630,603,248,-355
2018,5,30,2,617,589,215,-374
2018,5,30,3,569,543,188,-355
2018,5,30,4,509,484,154,-330
2018,5,30,5,451,453,157,-296
2018,5,30,6,424,433,160,-273
2018,5,30,7,410,419,158,-261
2018,5,30,8,406,419,161,-258
2018,5,30,9,411,420,160,-260
2018,5,30,10,442,449,160,-289
2018,5,30,11,500,503,159,-344
2018,5,30,12,539,541,162,-379
2018,5,30,13,561,568,171,-397
2018,5,30,14,581,584,178,-406
2018,5,30,15,598,592,188,-404
2018,5,30,16,616,606,194,-412
2018,5,30,17,627,629,273,-356
2018,5,30,18,647,644,279,-365
2018,5,30,19,660,653,277,-376
2018,5,30,20,668,658,290,-368
2018,5,30,21,673,652,351,-301
2018,5,30,22,675,667,337,-330
2018,5,30,23,667,653,328,-325
2018,5,31,0,651,636,325,-311
2018,5,31,1,638,634,328,-306
2018,5,31,2,626,604,244,-360
2018,5,31,3,578,553,206,-347
2018,5,31,4,513,496,166,-330
2018,5,31,5,455,455,166,-9999
2018,5,31,6,426,426,160,-9999
2018,5,31,7,412,412,158,-9999
2018,5,31,8,406,406,161,-9999
2018,5,31,9,410,410,160,-9999
2018,5,31,10,441,441,160,-9999
2018,5,31,11,498,498,159,-9999
2018,5,31,12,537,537,162,-9999
2018,5,31,13,562,562,171,-9999
2018,5,31,14,586,586,178,-9999
2018,5,31,15,610,610,188,-9999
2018,5,31,16,642,642,194,-9999
2018,5,31,17,657,657,273,-9999
2018,5,31,18,678,678,279,-9999
2018,5,31,19,695,695,277,-9999
2018,5,31,20,710,710,290,-9999
2018,5,31,21,713,713,351,-9999
2018,5,31,22,711,711,337,-9999
2018,5,31,23,702,702,328,-9999
2018,6,1,0,681,681,325,-9999
2018,6,1,1,658,658,328,-9999
2018,6,1,2,640,640,244,-9999
2018,6,1,3,589,589,206,-9999
2018,6,1,4,526,526,166,-9999
2018,6,1,5,-9999,451,163,-288
2018,6,1,6,-9999,424,166,-258
2018,6,1,7,-9999,409,165,-244
2018,6,1,8,-9999,403,166,-237
2018,6,1,9,-9999,413,165,-248
2018,6,1,10,-9999,438,165,-273
2018,6,1,11,-9999,491,164,-327
2018,6,1,12,-9999,523,166,-357
2018,6,1,13,-9999,543,173,-370
2018,6,1,14,-9999,558,172,-386
2018,6,1,15,-9999,587,192,-395
2018,6,1,16,-9999,626,224,-402
2018,6,1,17,-9999,641,340,-301
2018,6,1,18,-9999,679,397,-282
2018,6,1,19,-9999,691,419,-272
2018,6,1,20,-9999,699,420,-279
2018,6,1,21,-9999,689,429,-260
2018,6,1,22,-9999,687,424,-263
2018,6,1,23,-9999,678,406,-272
2018,6,2,0,-9999,647,360,-287
2018,6,2,1,-9999,625,232,-393
2018,6,2,2,-9999,613,229,-384
2018,6,2,3,-9999,570,225,-345
2018,6,2,4,-9999,515,169,-346
2018,6,2,5,469,474,163,-311
2018,6,2,6,435,435,158,-277
2018,6,2,7,415,411,156,-255
2018,6,2,8,404,409,156,-253
2018,6,2,9,401,408,157,-251
2018,6,2,10,408,415,158,-257
2018,6,2,11,423,432,157,-275
2018,6,2,12,455,460,158,-302
2018,6,2,13,493,506,159,-347
2018,6,2,14,533,542,158,-384
2018,6,2,15,564,574,154,-420
2018,6,2,16,585,585,277,-308
2018,6,2,17,605,604,306,-298
2018,6,2,18,624,623,329,-294
2018,6,2,19,636,637,360,-277
2018,6,2,20,645,657,420,-237
2018,6,2,21,656,668,444,-224
2018,6,2,22,661,671,453,-218
2018,6,2,23,654,653,403,-250
2018,6,3,0,630,625,389,-236
2018,6,3,1,609,607,330,-277
2018,6,3,2,594,590,209,-381
2018,6,3,3,546,550,176,-374
2018,6,3,4,495,499,169,-330
2018,6,3,5,471,449,167,-282
2018,6,3,6,437,422,169,-253
2018,6,3,7,416,403,168,-235
2018,6,3,8,404,392,170,-222
2018,6,3,9,400,385,168,-217
2018,6,3,10,405,389,166,-223
2018,6,3,11,419,402,167,-235
2018,6,3,12,448,434,168,-266
2018,6,3,13,496,483,166,-317
2018,6,3,14,534,528,168,-360
2018,6,3,15,561,560,168,-392
2018,6,3,16,580,591,185,-406
2018,6,3,17,611,621,223,-398
2018,6,3,18,638,655,370,-285
2018,6,3,19,648,675,420,-255
2018,6,3,20,664,697,421,-276
2018,6,3,21,681,720,424,-296
2018,6,3,22,694,704,456,-248
2018,6,3,23,691,682,461,-221
2018,6,4,0,669,654,456,-198
2018,6,4,1,642,637,458,-179
2018,6,4,2,621,631,459,-172
2018,6,4,3,564,579,404,-175
2018,6,4,4,504,523,299,-224
2018,6,4,5,439,463,211,-252
2018,6,4,6,407,436,189,-247
2018,6,4,7,388,419,177,-242
2018,6,4,8,381,408,167,-241
2018,6,4,9,385,405,141,-264
2018,6,4,10,412,429,202,-227
2018,6,4,11,464,483,247,-236
2018,6,4,12,498,522,268,-254
2018,6,4,13,521,544,260,-284
2018,6,4,14,543,564,265,-299
2018,6,4,15,569,576,281,-295
2018,6,4,16,582,594,289,-305
2018,6,4,17,602,609,294,-315
2018,6,4,18,624,619,326,-293
2018,6,4,19,636,638,412,-226
2018,6,4,20,646,651,397,-254
2018,6,4,21,652,665,362,-303
2018,6,4,22,655,687,369,-318
2018,6,4,23,650,668,358,-310
2018,6,5,0,637,657,386,-271
2018,6,5,1,611,633,313,-320
2018,6,5,2,589,611,214,-397
2018,6,5,3,545,552,167,-385
2018,6,5,4,473,485,165,-320
2018,6,5,5,428,439,165,-274
2018,6,5,6,395,415,138,-277
2018,6,5,7,377,399,108,-291
2018,6,5,8,372,400,93,-307
2018,6,5,9,377,400,67,-333
2018,6,5,10,404,427,162,-265
2018,6,5,11,455,484,165,-319
2018,6,5,12,488,514,163,-351
2018,6,5,13,510,533,163,-370
2018,6,5,14,529,543,166,-377
2018,6,5,15,547,553,166,-387
2018,6,5,16,559,569,166,-403
2018,6,5,17,582,585,173,-412
2018,6,5,18,598,599,185,-414
2018,6,5,19,611,616,202,-414
2018,6,5,20,626,636,214,-422
2018,6,5,21,640,653,240,-413
2018,6,5,22,649,673,376,-297
2018,6,5,23,651,674,436,-238
2018,6,6,0,632,665,426,-239
2018,6,6,1,611,634,258,-376
2018,6,6,2,589,612,204,-408
2018,6,6,3,544,554,172,-382
2018,6,6,4,474,484,169,-315
2018,6,6,5,425,444,169,-275
2018,6,6,6,396,408,161,-247
2018,6,6,7,378,403,100,-303
2018,6,6,8,373,390,62,-328
2018,6,6,9,378,396,63,-333
2018,6,6,10,406,417,64,-353
2018,6,6,11,459,472,65,-407
2018,6,6,12,492,504,173,-331
2018,6,6,13,510,527,179,-348
2018,6,6,14,532,544,183,-361
2018,6,6,15,553,561,196,-365
2018,6,6,16,565,583,237,-346
2018,6,6,17,586,599,246,-353
2018,6,6,18,602,624,291,-333
2018,6,6,19,619,646,439,-207
2018,6,6,20,636,665,447,-218
2018,6,6,21,655,688,447,-241
2018,6,6,22,666,698,432,-266
2018,6,6,23,667,696,426,-270
2018,6,7,0,649,678,425,-253
2018,6,7,1,626,658,446,-212
2018,6,7,2,605,628,320,-308
2018,6,7,3,555,577,176,-401
2018,6,7,4,489,505,168,-337
2018,6,7,5,445,459,112,-347
2018,6,7,6,414,426,63,-363
2018,6,7,7,397,414,66,-348
2018,6,7,8,390,402,65,-337
2018,6,7,9,392,405,64,-341
2018,6,7,10,416,432,63,-369
2018,6,7,11,467,482,70,-412
2018,6,7,12,502,520,135,-385
2018,6,7,13,521,546,180,-366
2018,6,7,14,542,566,173,-393
2018,6,7,15,566,588,170,-418
2018,6,7,16,576,614,210,-404
2018,6,7,17,593,631,293,-338
2018,6,7,18,613,658,359,-299
2018,6,7,19,631,686,418,-268
2018,6,7,20,648,706,439,-267
2018,6,7,21,667,732,445,-287
2018,6,7,22,676,739,451,-288
2018,6,7,23,678,736,437,-299
2018,6,8,0,661,718,429,-289
2018,6,8,1,639,694,450,-244
2018,6,8,2,619,665,415,-250
2018,6,8,3,570,609,245,-364
2018,6,8,4,504,535,178,-357
2018,6,8,5,464,483,124,-359
2018,6,8,6,430,447,85,-362
2018,6,8,7,413,431,72,-359
2018,6,8,8,403,420,70,-350
2018,6,8,9,406,419,70,-349
2018,6,8,10,427,446,72,-374
2018,6,8,11,472,497,71,-426
2018,6,8,12,509,532,73,-459
2018,6,8,13,538,558,98,-460
2018,6,8,14,567,586,220,-366
2018,6,8,15,591,616,222,-394
2018,6,8,16,611,649,224,-425
2018,6,8,17,642,675,324,-351
2018,6,8,18,661,705,417,-288
2018,6,8,19,678,716,408,-308
2018,6,8,20,689,723,427,-296
2018,6,8,21,697,728,450,-278
2018,6,8,22,699,728,451,-277
2018,6,8,23,686,712,422,-290
2018,6,9,0,657,682,432,-250
2018,6,9,1,633,659,427,-232
2018,6,9,2,610,646,417,-229
2018,6,9,3,575,595,303,-292
2018,6,9,4,509,533,111,-422
2018,6,9,5,466,488,69,-419
2018,6,9,6,431,447,64,-383
2018,6,9,7,410,430,67,-363
2018,6,9,8,400,415,66,-349
2018,6,9,9,397,407,67,-340
2018,6,9,10,405,415,67,-348
2018,6,9,11,420,433,67,-366
2018,6,9,12,449,460,67,-393
2018,6,9,13,487,507,68,-439
2018,6,9,14,524,548,87,-461
2018,6,9,15,556,586,186,-400
2018,6,9,16,579,629,235,-394
2018,6,9,17,600,653,238,-415
2018,6,9,18,624,672,401,-271
2018,6,9,19,640,687,445,-242
2018,6,9,20,656,698,434,-264
2018,6,9,21,668,715,401,-314
2018,6,9,22,673,713,393,-320
2018,6,9,23,665,696,391,-305
2018,6,10,0,640,679,399,-280
2018,6,10,1,613,650,390,-260
2018,6,10,2,599,630,310,-320
2018,6,10,3,553,583,190,-393
2018,6,10,4,500,529,169,-360
2018,6,10,5,473,476,130,-346
2018,6,10,6,436,447,67,-380
2018,6,10,7,413,425,67,-358
2018,6,10,8,401,409,63,-346
2018,6,10,9,394,406,61,-345
2018,6,10,10,396,409,58,-351
2018,6,10,11,407,418,60,-358
2018,6,10,12,434,448,60,-388
2018,6,10,13,478,498,60,-438
2018,6,10,14,517,535,85,-450
2018,6,10,15,543,575,183,-392
2018,6,10,16,577,611,186,-425
2018,6,10,17,608,643,269,-374
2018,6,10,18,636,667,387,-280
2018,6,10,19,660,685,404,-281
2018,6,10,20,678,682,342,-340
2018,6,10,21,699,703,329,-374
2018,6,10,22,704,702,353,-349
2018,6,10,23,701,678,357,-321
2018,6,11,0,675,656,360,-296
2018,6,11,1,655,633,261,-372
2018,6,11,2,633,613,218,-395
2018,6,11,3,580,553,194,-359
2018,6,11,4,523,492,82,-410
2018,6,11,5,478,459,72,-387
2018,6,11,6,441,425,69,-356
2018,6,11,7,420,411,71,-340
2018,6,11,8,409,411,70,-341
2018,6,11,9,409,420,72,-348
2018,6,11,10,430,448,71,-377
2018,6,11,11,473,495,71,-424
2018,6,11,12,513,532,83,-449
2018,6,11,13,550,562,106,-456
2018,6,11,14,584,581,191,-390
2018,6,11,15,623,603,213,-390
2018,6,11,16,655,621,222,-399
2018,6,11,17,687,634,358,-276
2018,6,11,18,710,638,421,-217
2018,6,11,19,725,633,430,-203
2018,6,11,20,734,645,427,-218
2018,6,11,21,743,665,412,-253
2018,6,11,22,746,677,411,-266
2018,6,11,23,744,683,406,-277
2018,6,12,0,721,673,392,-281
2018,6,12,1,688,666,387,-279
2018,6,12,2,657,643,372,-271
2018,6,12,3,602,591,202,-389
2018,6,12,4,532,525,166,-359
2018,6,12,5,459,476,108,-368
2018,6,12,6,427,451,67,-384
2018,6,12,7,408,430,66,-364
2018,6,12,8,399,425,68,-357
2018,6,12,9,400,424,66,-358
2018,6,12,10,421,457,69,-388
2018,6,12,11,464,504,66,-438
2018,6,12,12,505,538,84,-454
2018,6,12,13,533,561,155,-406
2018,6,12,14,556,582,179,-403
2018,6,12,15,576,585,166,-419
2018,6,12,16,584,611,170,-441
2018,6,12,17,594,630,173,-457
2018,6,12,18,605,648,231,-417
2018,6,12,19,606,657,300,-357
2018,6,12,20,608,666,300,-366
2018,6,12,21,621,679,300,-379
2018,6,12,22,629,687,302,-385
2018,6,12,23,634,694,305,-389
2018,6,13,0,623,673,302,-371
2018,6,13,1,609,656,308,-348
2018,6,13,2,593,636,271,-365
2018,6,13,3,545,583,157,-426
2018,6,13,4,487,518,85,-433
2018,6,13,5,438,473,79,-394
2018,6,13,6,411,445,70,-375
2018,6,13,7,397,425,66,-359
2018,6,13,8,393,420,69,-351
2018,6,13,9,397,419,66,-353
2018,6,13,10,420,446,68,-378
2018,6,13,11,463,498,81,-417
2018,6,13,12,507,541,84,-457
2018,6,13,13,537,564,107,-457
2018,6,13,14,564,584,130,-454
2018,6,13,15,590,626,200,-426
2018,6,13,16,604,651,330,-321
2018,6,13,17,633,677,381,-296
2018,6,13,18,654,698,389,-309
2018,6,13,19,673,691,410,-281
2018,6,13,20,693,694,424,-270
2018,6,13,21,707,696,447,-249
2018,6,13,22,720,690,455,-235
2018,6,13,23,715,695,460,-235
2018,6,14,0,692,680,436,-244
2018,6,14,1,665,663,407,-256
2018,6,14,2,638,651,411,-240
2018,6,14,3,593,598,236,-362
2018,6,14,4,528,536,91,-445
2018,6,14,5,476,485,65,-420
2018,6,14,6,443,461,67,-394
2018,6,14,7,425,443,67,-376
2018,6,14,8,417,432,67,-365
2018,6,14,9,418,437,66,-371
2018,6,14,10,441,461,67,-394
2018,6,14,11,484,508,69,-439
2018,6,14,12,526,550,89,-461
2018,6,14,13,560,578,98,-480
2018,6,14,14,590,607,119,-488
2018,6,14,15,617,641,273,-368
2018,6,14,16,641,683,364,-319
2018,6,14,17,670,711,366,-345
2018,6,14,18,691,745,416,-329
2018,6,14,19,703,758,549,-209
2018,6,14,20,716,773,576,-197
2018,6,14,21,725,796,587,-209
2018,6,14,22,731,795,590,-205
2018,6,14,23,722,786,603,-183
2018,6,15,0,700,761,584,-177
2018,6,15,1,674,723,537,-186
2018,6,15,2,649,693,448,-245
2018,6,15,3,597,630,258,-372
2018,6,15,4,533,564,130,-434
2018,6,15,5,504,500,123,-377
2018,6,15,6,466,463,105,-358
2018,6,15,7,444,439,75,-364
2018,6,15,8,432,427,62,-365
2018,6,15,9,430,425,62,-363
2018,6,15,10,451,445,71,-374
2018,6,15,11,491,491,92,-399
2018,6,15,12,530,528,95,-433
2018,6,15,13,562,567,100,-467
2018,6,15,14,590,604,132,-472
2018,6,15,15,627,636,249,-387
2018,6,15,16,656,676,317,-359
2018,6,15,17,681,702,321,-381
2018,6,15,18,705,720,347,-373
2018,6,15,19,720,754,379,-375
2018,6,15,20,733,773,393,-380
2018,6,15,21,742,790,397,-393
2018,6,15,22,746,792,402,-390
2018,6,15,23,732,774,411,-363
2018,6,16,0,702,744,375,-369
2018,6,16,1,676,699,351,-348
2018,6,16,2,654,672,286,-386
2018,6,16,3,608,618,145,-473
2018,6,16,4,544,556,104,-452
2018,6,16,5,495,498,64,-434
2018,6,16,6,457,459,63,-396
2018,6,16,7,432,438,64,-374
2018,6,16,8,419,426,61,-365
2018,6,16,9,413,416,56,-360
2018,6,16,10,423,425,57,-368
2018,6,16,11,439,436,63,-373
2018,6,16,12,465,474,87,-387
2018,6,16,13,507,517,110,-407
2018,6,16,14,546,567,152,-415
2018,6,16,15,587,605,220,-385
2018,6,16,16,619,643,292,-351
2018,6,16,17,647,676,305,-371
2018,6,16,18,671,703,313,-390
2018,6,16,19,691,721,328,-393
2018,6,16,20,707,713,377,-336
2018,6,16,21,726,710,478,-232
2018,6,16,22,733,694,442,-252
2018,6,16,23,725,668,450,-218
2018,6,17,0,701,661,449,-212
2018,6,17,1,669,639,456,-183
2018,6,17,2,653,632,480,-152
2018,6,17,3,604,588,306,-282
2018,6,17,4,547,539,149,-390
2018,6,17,5,483,482,106,-376
2018,6,17,6,445,450,105,-345
2018,6,17,7,423,432,107,-325
2018,6,17,8,409,417,107,-310
2018,6,17,9,403,423,109,-314
2018,6,17,10,410,413,106,-307
2018,6,17,11,422,425,107,-318
2018,6,17,12,447,453,107,-346
2018,6,17,13,499,506,112,-394
2018,6,17,14,537,556,151,-405
2018,6,17,15,577,606,252,-354
2018,6,17,16,600,638,272,-366
2018,6,17,17,638,678,301,-377
2018,6,17,18,664,694,368,-326
2018,6,17,19,684,653,515,-138
2018,6,17,20,701,653,478,-175
2018,6,17,21,730,678,399,-279
2018,6,17,22,742,704,498,-206
2018,6,17,23,729,695,517,-178
2018,6,18,0,710,676,518,-158
2018,6,18,1,680,649,355,-294
2018,6,18,2,660,638,346,-292
2018,6,18,3,602,592,207,-385
2018,6,18,4,541,536,125,-411
2018,6,18,5,497,477,112,-365
2018,6,18,6,461,450,114,-336
2018,6,18,7,439,427,111,-316
2018,6,18,8,429,421,113,-308
2018,6,18,9,427,425,112,-313
2018,6,18,10,448,446,112,-334
2018,6,18,11,491,489,113,-376
2018,6,18,12,529,528,117,-411
2018,6,18,13,571,565,158,-407
2018,6,18,14,601,608,197,-411
2018,6,18,15,646,650,256,-394
2018,6,18,16,689,701,317,-384
2018,6,18,17,721,730,413,-317
2018,6,18,18,752,782,657,-125
2018,6,18,19,782,807,762,-45
2018,6,18,20,805,828,765,-63
2018,6,18,21,822,831,757,-74
2018,6,18,22,835,832,758,-74
2018,6,18,23,831,810,755,-55
2018,6,19,0,802,779,755,-24
2018,6,19,1,762,745,730,-15
2018,6,19,2,727,734,717,-17
2018,6,19,3,660,660,400,-260
2018,6,19,4,585,596,216,-380
2018,6,19,5,515,528,137,-391
2018,6,19,6,479,493,134,-359
2018,6,19,7,455,467,131,-336
2018,6,19,8,445,455,132,-323
2018,6,19,9,444,453,132,-321
2018,6,19,10,464,476,133,-343
2018,6,19,11,505,516,131,-385
2018,6,19,12,549,567,155,-412
2018,6,19,13,585,610,198,-412
2018,6,19,14,623,655,240,-415
2018,6,19,15,662,696,303,-393
2018,6,19,16,699,732,362,-370
2018,6,19,17,732,759,491,-268
2018,6,19,18,766,799,752,-47
2018,6,19,19,785,817,768,-49
2018,6,19,20,805,823,768,-55
2018,6,19,21,823,814,774,-40
2018,6,19,22,831,783,760,-23
2018,6,19,23,826,778,759,-19
2018,6,20,0,797,766,741,-25
2018,6,20,1,755,747,593,-154
2018,6,20,2,722,719,522,-197
2018,6,20,3,654,662,326,-336
2018,6,20,4,579,589,195,-394
2018,6,20,5,538,535,178,-357
2018,6,20,6,499,500,114,-386
2018,6,20,7,470,479,112,-367
2018,6,20,8,455,466,112,-354
2018,6,20,9,451,462,111,-351
2018,6,20,10,469,483,113,-370
2018,6,20,11,507,519,116,-403
2018,6,20,12,547,569,179,-390
2018,6,20,13,585,610,216,-394
2018,6,20,14,622,655,240,-415
2018,6,20,15,663,689,283,-406
2018,6,20,16,702,727,491,-236
2018,6,20,17,738,747,526,-221
2018,6,20,18,780,778,533,-245
2018,6,20,19,808,792,592,-200
2018,6,20,20,833,807,562,-245
2018,6,20,21,838,788,526,-262
2018,6,20,22,843,780,532,-248
2018,6,20,23,837,794,532,-262
2018,6,21,0,804,777,537,-240
2018,6,21,1,766,743,427,-316
2018,6,21,2,732,712,370,-342
2018,6,21,3,667,656,291,-365
2018,6,21,4,593,583,199,-384
2018,6,21,5,516,535,127,-408
2018,6,21,6,478,501,112,-389
2018,6,21,7,455,477,113,-364
2018,6,21,8,443,464,115,-349
2018,6,21,9,440,459,114,-345
2018,6,21,10,460,483,114,-369
2018,6,21,11,501,520,117,-403
2018,6,21,12,541,561,148,-413
2018,6,21,13,574,585,175,-410
2018,6,21,14,603,612,199,-413
2018,6,21,15,630,631,217,-414
2018,6,21,16,655,651,261,-390
2018,6,21,17,675,670,399,-271
2018,6,21,18,709,686,595,-91
2018,6,21,19,725,693,651,-42
2018,6,21,20,731,701,678,-23
2018,6,21,21,738,707,684,-23
2018,6,21,22,732,700,676,-24
2018,6,21,23,724,686,663,-23
2018,6,22,0,703,654,575,-79
2018,6,22,1,680,643,431,-212
2018,6,22,2,661,631,372,-259
2018,6,22,3,613,593,217,-376
2018,6,22,4,546,533,143,-390
2018,6,22,5,492,481,120,-361
2018,6,22,6,460,452,121,-331
2018,6,22,7,440,439,124,-315
2018,6,22,8,430,433,122,-311
2018,6,22,9,431,433,123,-310
2018,6,22,10,453,457,123,-334
2018,6,22,11,493,496,122,-374
2018,6,22,12,535,537,131,-406
2018,6,22,13,569,568,158,-410
2018,6,22,14,595,599,187,-412
2018,6,22,15,619,626,215,-411
2018,6,22,16,648,662,247,-415
2018,6,22,17,666,690,276,-414
2018,6,22,18,691,711,309,-402
2018,6,22,19,706,736,498,-238
2018,6,22,20,716,747,640,-107
2018,6,22,21,718,772,653,-119
2018,6,22,22,711,757,636,-121
2018,6,22,23,698,743,645,-98
2018,6,23,0,671,706,579,-127
2018,6,23,1,646,676,545,-131
2018,6,23,2,634,648,521,-127
2018,6,23,3,593,606,335,-271
2018,6,23,4,536,544,189,-355
2018,6,23,5,491,491,117,-374
2018,6,23,6,452,461,117,-344
2018,6,23,7,429,437,111,-326
2018,6,23,8,415,427,114,-313
2018,6,23,9,410,422,115,-307
2018,6,23,10,418,426,114,-312
2018,6,23,11,433,442,113,-329
2018,6,23,12,461,475,115,-360
2018,6,23,13,501,515,120,-395
2018,6,23,14,535,558,151,-407
2018,6,23,15,571,598,190,-408
2018,6,23,16,599,619,319,-300
2018,6,23,17,624,655,425,-230
2018,6,23,18,653,674,429,-245
2018,6,23,19,668,690,470,-220
2018,6,23,20,688,714,483,-231
2018,6,23,21,704,721,494,-227
2018,6,23,22,712,726,529,-197
2018,6,23,23,701,702,530,-172
2018,6,24,0,684,668,528,-140
2018,6,24,1,650,644,473,-171
2018,6,24,2,633,627,439,-188
2018,6,24,3,589,586,453,-133
2018,6,24,4,535,526,371,-155
2018,6,24,5,476,480,247,-233
2018,6,24,6,440,448,142,-306
2018,6,24,7,417,431,121,-310
2018,6,24,8,404,417,120,-297
2018,6,24,9,397,407,119,-288
2018,6,24,10,401,412,119,-293
2018,6,24,11,414,422,121,-301
2018,6,24,12,440,457,121,-336
2018,6,24,13,487,507,124,-383
2018,6,24,14,523,555,121,-434
2018,6,24,15,554,580,122,-458
2018,6,24,16,587,514,142,-372
2018,6,24,17,618,673,270,-403
2018,6,24,18,643,680,280,-400
2018,6,24,19,651,703,359,-344
2018,6,24,20,668,735,621,-114
2018,6,24,21,686,733,650,-83
2018,6,24,22,697,743,648,-95
2018,6,24,23,694,697,599,-98
2018,6,25,0,675,658,520,-138
2018,6,25,1,647,647,439,-208
2018,6,25,2,631,701,408,-293
2018,6,25,3,582,638,315,-323
2018,6,25,4,527,524,259,-265
2018,6,25,5,488,474,219,-255
2018,6,25,6,451,442,192,-250
2018,6,25,7,430,428,193,-235
2018,6,25,8,420,420,194,-226
2018,6,25,9,419,422,194,-228
2018,6,25,10,444,446,193,-253
2018,6,25,11,486,486,192,-294
2018,6,25,12,528,527,231,-296
2018,6,25,13,567,559,210,-349
2018,6,25,14,597,597,229,-368
2018,6,25,15,633,635,267,-368
2018,6,25,16,667,670,310,-360
2018,6,25,17,699,705,343,-362
2018,6,25,18,730,742,441,-301
2018,6,25,19,751,760,477,-283
2018,6,25,20,763,775,474,-301
2018,6,25,21,780,714,441,-273
2018,6,25,22,778,693,449,-244
2018,6,25,23,778,681,371,-310
2018,6,26,0,750,658,348,-310
2018,6,26,1,716,639,266,-373
2018,6,26,2,689,619,263,-356
2018,6,26,3,629,568,259,-309
2018,6,26,4,558,515,241,-274
2018,6,26,5,501,473,121,-352
2018,6,26,6,468,447,117,-330
2018,6,26,7,447,436,116,-320
2018,6,26,8,437,428,116,-312
2018,6,26,9,437,429,116,-313
2018,6,26,10,458,454,118,-336
2018,6,26,11,498,493,117,-376
2018,6,26,12,542,535,131,-404
2018,6,26,13,573,557,200,-357
2018,6,26,14,596,588,252,-336
2018,6,26,15,622,616,299,-317
2018,6,26,16,652,651,354,-297
2018,6,26,17,674,689,430,-259
2018,6,26,18,703,732,546,-186
2018,6,26,19,718,728,544,-184
2018,6,26,20,731,680,538,-142
2018,6,26,21,745,665,536,-129
2018,6,26,22,742,659,540,-119
2018,6,26,23,739,654,537,-117
2018,6,27,0,714,636,406,-230
2018,6,27,1,691,611,403,-208
2018,6,27,2,669,597,412,-185
2018,6,27,3,617,546,375,-171
2018,6,27,4,553,495,245,-250
2018,6,27,5,485,457,244,-213
2018,6,27,6,453,435,190,-245
2018,6,27,7,433,421,146,-275
2018,6,27,8,425,413,145,-268
2018,6,27,9,425,417,145,-272
2018,6,27,10,449,440,147,-293
2018,6,27,11,493,485,173,-312
2018,6,27,12,536,520,226,-294
2018,6,27,13,567,550,249,-301
2018,6,27,14,591,581,247,-334
2018,6,27,15,625,623,249,-374
2018,6,27,16,654,647,246,-401
2018,6,27,17,675,685,249,-436
2018,6,27,18,701,690,250,-440
2018,6,27,19,715,663,363,-300
2018,6,27,20,726,667,500,-167
2018,6,27,21,728,671,524,-147
2018,6,27,22,730,669,527,-142
2018,6,27,23,724,654,520,-134
2018,6,28,0,702,635,523,-112
2018,6,28,1,678,628,523,-105
2018,6,28,2,661,613,495,-118
2018,6,28,3,609,562,391,-171
2018,6,28,4,548,510,261,-249
2018,6,28,5,494,468,248,-220
2018,6,28,6,461,442,193,-249
2018,6,28,7,441,421,183,-238
2018,6,28,8,432,420,198,-222
2018,6,28,9,432,426,193,-233
2018,6,28,10,455,441,186,-255
2018,6,28,11,499,485,183,-302
2018,6,28,12,542,532,185,-347
2018,6,28,13,574,563,189,-374
2018,6,28,14,601,586,289,-297
2018,6,28,15,636,595,318,-277
2018,6,28,16,668,604,351,-253
2018,6,28,17,700,620,370,-250
2018,6,28,18,729,641,369,-272
2018,6,28,19,749,659,393,-266
2018,6,28,20,763,700,412,-288
2018,6,28,21,772,705,403,-302
2018,6,28,22,776,701,406,-295
2018,6,28,23,774,688,403,-285
2018,6,29,0,745,671,374,-297
2018,6,29,1,716,653,374,-279
2018,6,29,2,698,646,375,-271
2018,6,29,3,641,589,270,-319
2018,6,29,4,577,535,219,-316
2018,6,29,5,498,485,213,-272
2018,6,29,6,463,451,214,-237
2018,6,29,7,442,435,214,-221
2018,6,29,8,429,427,153,-274
2018,6,29,9,430,428,128,-300
2018,6,29,10,450,447,214,-233
2018,6,29,11,489,490,215,-275
2018,6,29,12,529,528,213,-315
2018,6,29,13,565,560,219,-341
2018,6,29,14,596,590,216,-374
2018,6,29,15,637,624,219,-405
2018,6,29,16,673,662,275,-387
2018,6,29,17,704,704,322,-382
2018,6,29,18,728,741,459,-282
2018,6,29,19,741,766,613,-153
2018,6,29,20,764,778,607,-171
2018,6,29,21,763,798,626,-172
2018,6,29,22,760,801,718,-83
2018,6,29,23,745,787,717,-70
2018,6,30,0,710,758,713,-45
2018,6,30,1,683,720,682,-38
2018,6,30,2,666,690,612,-78
2018,6,30,3,622,636,417,-219
2018,6,30,4,562,576,221,-355
2018,6,30,5,511,515,139,-376
2018,6,30,6,475,472,121,-351
2018,6,30,7,451,445,118,-327
2018,6,30,8,437,431,116,-315
2018,6,30,9,429,430,119,-311
2018,6,30,10,435,434,115,-319
2018,6,30,11,449,447,116,-331
2018,6,30,12,479,479,116,-363
2018,6,30,13,522,528,122,-406
2018,6,30,14,572,573,154,-419
2018,6,30,15,613,622,184,-438
2018,6,30,16,635,659,283,-376
2018,6,30,17,678,689,308,-381
2018,6,30,18,707,732,474,-258
2018,6,30,19,720,751,472,-279
2018,6,30,20,740,768,471,-297
2018,6,30,21,751,787,480,-307
2018,6,30,22,757,797,486,-311
2018,6,30,23,744,790,436,-354
2018,7,1,0,718,759,430,-329
2018,7,1,1,688,725,405,-320
2018,7,1,2,681,701,332,-369
2018,7,1,3,631,652,287,-365
2018,7,1,4,568,591,228,-363
2018,7,1,5,506,531,118,-413
2018,7,1,6,466,499,120,-379
2018,7,1,7,445,473,119,-354
2018,7,1,8,427,460,119,-341
2018,7,1,9,420,453,122,-331
2018,7,1,10,422,452,121,-331
2018,7,1,11,423,453,119,-334
2018,7,1,12,459,483,120,-363
2018,7,1,13,510,545,124,-421
2018,7,1,14,563,597,128,-469
2018,7,1,15,593,630,152,-478
2018,7,1,16,623,657,286,-371
2018,7,1,17,660,687,317,-370
2018,7,1,18,687,712,381,-331
2018,7,1,19,698,731,417,-314
2018,7,1,20,712,745,415,-330
2018,7,1,21,720,758,432,-326
2018,7,1,22,737,755,487,-268
2018,7,1,23,739,739,510,-229
2018,7,2,0,721,714,509,-205
2018,7,2,1,693,677,466,-211
2018,7,2,2,672,657,422,-235
2018,7,2,3,612,612,384,-228
2018,7,2,4,553,550,313,-237
2018,7,2,5,515,504,230,-274
2018,7,2,6,478,472,189,-283
2018,7,2,7,446,458,188,-270
2018,7,2,8,438,448,184,-264
2018,7,2,9,431,449,184,-265
2018,7,2,10,450,473,188,-285
2018,7,2,11,489,502,193,-309
2018,7,2,12,531,551,252,-299
2018,7,2,13,576,581,254,-327
2018,7,2,14,617,605,258,-347
2018,7,2,15,660,625,270,-355
2018,7,2,16,693,650,277,-373
2018,7,2,17,734,684,276,-408
2018,7,2,18,757,722,393,-329
2018,7,2,19,773,744,484,-260
2018,7,2,20,790,766,552,-214
2018,7,2,21,806,786,614,-172
2018,7,2,22,811,796,693,-103
2018,7,2,23,790,793,700,-93
2018,7,3,0,764,776,630,-146
2018,7,3,1,734,748,529,-219
2018,7,3,2,710,719,449,-270
2018,7,3,3,660,667,349,-318
2018,7,3,4,585,592,196,-396
2018,7,3,5,534,536,125,-411
2018,7,3,6,492,498,124,-374
2018,7,3,7,451,478,122,-356
2018,7,3,8,435,455,119,-336
2018,7,3,9,425,451,121,-330
2018,7,3,10,433,468,119,-349
2018,7,3,11,437,507,118,-389
2018,7,3,12,472,547,134,-413
2018,7,3,13,531,596,183,-413
2018,7,3,14,593,643,228,-415
2018,7,3,15,643,689,294,-395
2018,7,3,16,697,738,377,-361
2018,7,3,17,739,774,445,-329
2018,7,3,18,777,801,511,-290
2018,7,3,19,807,821,615,-206
2018,7,3,20,828,844,619,-225
2018,7,3,21,841,861,619,-242
2018,7,3,22,845,867,620,-247
2018,7,3,23,829,850,622,-228
2018,7,4,0,798,825,622,-203
2018,7,4,1,761,778,589,-189
2018,7,4,2,733,754,550,-204
2018,7,4,3,670,697,523,-174
2018,7,4,4,601,628,448,-180
2018,7,4,5,512,563,392,-171
2018,7,4,6,478,515,361,-154
2018,7,4,7,445,494,208,-286
2018,7,4,8,431,474,207,-267
2018,7,4,9,424,462,202,-260
2018,7,4,10,430,468,205,-263
2018,7,4,11,433,478,205,-273
2018,7,4,12,461,498,204,-294
2018,7,4,13,510,554,208,-346
2018,7,4,14,560,608,205,-403
2018,7,4,15,600,656,362,-294
2018,7,4,16,644,700,425,-275
2018,7,4,17,678,735,437,-298
2018,7,4,18,709,755,448,-307
2018,7,4,19,734,777,447,-330
2018,7,4,20,751,796,451,-345
2018,7,4,21,761,800,451,-349
2018,7,4,22,765,813,458,-355
2018,7,4,23,752,790,466,-324
2018,7,5,0,727,757,483,-274
2018,7,5,1,696,710,476,-234
2018,7,5,2,674,681,420,-261
2018,7,5,3,623,631,353,-278
2018,7,5,4,566,599,255,-344
2018,7,5,5,493,537,206,-331
2018,7,5,6,459,497,204,-293
2018,7,5,7,425,479,205,-274
2018,7,5,8,412,464,202,-262
2018,7,5,9,404,465,203,-262
2018,7,5,10,411,481,203,-278
2018,7,5,11,414,513,202,-311
2018,7,5,12,443,557,202,-355
2018,7,5,13,491,601,204,-397
2018,7,5,14,542,646,251,-395
2018,7,5,15,583,689,323,-366
2018,7,5,16,628,723,375,-348
2018,7,5,17,663,751,441,-310
2018,7,5,18,694,784,474,-310
2018,7,5,19,718,798,479,-319
2018,7,5,20,736,828,485,-343
2018,7,5,21,746,836,524,-312
2018,7,5,22,751,843,542,-301
2018,7,5,23,737,826,512,-314
2018,7,6,0,711,788,505,-283
2018,7,6,1,680,743,456,-287
2018,7,6,2,658,721,450,-271
2018,7,6,3,606,658,449,-209
2018,7,6,4,549,596,453,-143
2018,7,6,5,506,533,367,-166
2018,7,6,6,485,500,222,-278
2018,7,6,7,455,475,221,-254
2018,7,6,8,439,463,131,-332
2018,7,6,9,434,458,130,-328
2018,7,6,10,452,476,136,-340
2018,7,6,11,479,503,224,-279
2018,7,6,12,523,540,225,-315
2018,7,6,13,565,575,224,-351
2018,7,6,14,613,628,313,-315
2018,7,6,15,648,675,382,-293
2018,7,6,16,671,722,381,-341
2018,7,6,17,721,749,397,-352
2018,7,6,18,745,749,483,-266
2018,7,6,19,772,712,485,-227
2018,7,6,20,802,696,486,-210
2018,7,6,21,815,675,483,-192
2018,7,6,22,810,578,472,-106
2018,7,6,23,790,630,410,-220
2018,7,7,0,750,619,398,-221
2018,7,7,1,717,604,315,-289
2018,7,7,2,674,589,375,-214
2018,7,7,3,627,552,370,-182
2018,7,7,4,565,499,205,-294
2018,7,7,5,456,462,201,-261
2018,7,7,6,422,435,200,-235
2018,7,7,7,417,421,203,-218
2018,7,7,8,408,412,201,-211
2018,7,7,9,408,412,203,-209
2018,7,7,10,409,422,220,-202
2018,7,7,11,420,444,229,-215
2018,7,7,12,438,473,241,-232
2018,7,7,13,473,507,251,-256
2018,7,7,14,506,542,388,-154
2018,7,7,15,530,568,488,-80
2018,7,7,16,569,574,487,-87
2018,7,7,17,602,584,491,-93
2018,7,7,18,615,577,485,-92
2018,7,7,19,638,569,347,-222
2018,7,7,20,652,560,234,-326
2018,7,7,21,662,564,243,-321
2018,7,7,22,655,574,294,-280
2018,7,7,23,643,577,319,-258
2018,7,8,0,633,572,316,-256
2018,7,8,1,613,567,315,-252
2018,7,8,2,568,561,265,-296
2018,7,8,3,550,531,216,-315
2018,7,8,4,494,491,167,-324
2018,7,8,5,436,444,131,-313
2018,7,8,6,410,421,135,-286
2018,7,8,7,398,404,134,-270
2018,7,8,8,390,391,133,-258
2018,7,8,9,392,385,133,-252
2018,7,8,10,413,389,133,-256
2018,7,8,11,450,403,134,-269
2018,7,8,12,493,431,134,-297
2018,7,8,13,521,468,134,-334
2018,7,8,14,558,503,137,-366
2018,7,8,15,590,521,142,-379
2018,7,8,16,616,540,200,-340
2018,7,8,17,638,574,204,-370
2018,7,8,18,655,599,201,-398
2018,7,8,19,673,628,223,-405
2018,7,8,20,691,657,252,-405
2018,7,8,21,710,684,292,-392
2018,7,8,22,705,711,429,-282
2018,7,8,23,697,709,430,-279
2018,7,9,0,675,691,431,-260
2018,7,9,1,652,652,429,-223
2018,7,9,2,637,626,408,-218
2018,7,9,3,580,580,240,-340
2018,7,9,4,513,518,209,-309
2018,7,9,5,438,466,196,-270
2018,7,9,6,415,434,195,-239
2018,7,9,7,397,411,195,-216
2018,7,9,8,387,402,197,-205
2018,7,9,9,388,403,194,-209
2018,7,9,10,410,425,198,-227
2018,7,9,11,459,456,196,-260
2018,7,9,12,510,498,196,-302
2018,7,9,13,548,531,204,-327
2018,7,9,14,580,562,260,-302
2018,7,9,15,616,594,216,-378
2018,7,9,16,637,632,252,-380
2018,7,9,17,658,664,347,-317
2018,7,9,18,682,695,356,-339
2018,7,9,19,710,712,353,-359
2018,7,9,20,729,743,387,-356
2018,7,9,21,745,765,395,-370
2018,7,9,22,745,782,471,-311
2018,7,9,23,733,782,490,-292
2018,7,10,0,714,755,484,-271
2018,7,10,1,685,710,484,-226
2018,7,10,2,665,680,453,-227
2018,7,10,3,608,608,247,-361
2018,7,10,4,535,546,203,-343
2018,7,10,5,482,487,201,-286
2018,7,10,6,456,451,200,-251
2018,7,10,7,437,432,202,-230
2018,7,10,8,426,419,202,-217
2018,7,10,9,428,419,204,-215
2018,7,10,10,446,434,203,-231
2018,7,10,11,482,470,204,-266
2018,7,10,12,529,512,201,-311
2018,7,10,13,575,543,203,-340
2018,7,10,14,603,579,206,-373
2018,7,10,15,643,613,272,-341
2018,7,10,16,672,649,359,-290
2018,7,10,17,708,682,456,-226
2018,7,10,18,743,716,452,-264
2018,7,10,19,777,739,452,-287
2018,7,10,20,799,767,455,-312
2018,7,10,21,820,800,438,-362
2018,7,10,22,813,807,459,-348
2018,7,10,23,787,808,483,-325
2018,7,11,0,772,779,427,-352
2018,7,11,1,743,746,418,-328
2018,7,11,2,717,712,417,-295
2018,7,11,3,653,652,417,-235
2018,7,11,4,576,580,418,-162
2018,7,11,5,498,529,422,-107
2018,7,11,6,467,482,277,-205
2018,7,11,7,452,461,200,-261
2018,7,11,8,438,443,200,-243
2018,7,11,9,437,448,204,-244
2018,7,11,10,458,464,205,-259
2018,7,11,11,486,498,202,-296
2018,7,11,12,535,536,201,-335
2018,7,11,13,574,591,225,-366
2018,7,11,14,612,619,278,-341
2018,7,11,15,653,656,383,-273
2018,7,11,16,682,698,444,-254
2018,7,11,17,715,738,440,-298
2018,7,11,18,750,776,451,-325
2018,7,11,19,778,804,477,-327
2018,7,11,20,803,825,549,-276
2018,7,11,21,816,848,571,-277
2018,7,11,22,809,856,568,-288
2018,7,11,23,791,832,561,-271
2018,7,12,0,769,807,515,-292
2018,7,12,1,744,777,487,-290
2018,7,12,2,709,746,481,-265
2018,7,12,3,651,686,414,-272
2018,7,12,4,581,610,377,-233
2018,7,12,5,536,553,373,-180
2018,7,12,6,507,510,365,-145
2018,7,12,7,484,486,265,-221
2018,7,12,8,463,471,222,-249
2018,7,12,9,459,460,226,-234
2018,7,12,10,477,477,242,-235
2018,7,12,11,508,511,259,-252
2018,7,12,12,552,558,272,-286
2018,7,12,13,590,591,323,-268
2018,7,12,14,628,644,452,-192
2018,7,12,15,671,687,466,-221
2018,7,12,16,700,726,496,-230
2018,7,12,17,742,765,481,-284
2018,7,12,18,765,797,478,-319
2018,7,12,19,790,816,480,-336
2018,7,12,20,810,824,479,-345
2018,7,12,21,824,810,474,-336
2018,7,12,22,820,798,451,-347
2018,7,12,23,793,779,401,-378
2018,7,13,0,767,748,368,-380
2018,7,13,1,741,725,371,-354
2018,7,13,2,710,708,371,-337
2018,7,13,3,655,651,366,-285
2018,7,13,4,584,586,333,-253
2018,7,13,5,514,539,260,-279
2018,7,13,6,480,501,222,-279
2018,7,13,7,458,491,227,-264
2018,7,13,8,444,474,214,-260
2018,7,13,9,442,473,203,-270
2018,7,13,10,458,489,307,-182
2018,7,13,11,489,533,360,-173
2018,7,13,12,532,539,332,-207
2018,7,13,13,569,554,289,-265
2018,7,13,14,601,589,228,-361
2018,7,13,15,645,622,226,-396
2018,7,13,16,676,650,317,-333
2018,7,13,17,707,674,311,-363
2018,7,13,18,722,707,327,-380
2018,7,13,19,742,725,325,-400
2018,7,13,20,754,735,323,-412
2018,7,13,21,761,743,323,-420
2018,7,13,22,756,744,323,-421
2018,7,13,23,737,717,320,-397
2018,7,14,0,707,688,321,-367
2018,7,14,1,689,655,321,-334
2018,7,14,2,661,634,320,-314
2018,7,14,3,619,590,321,-269
2018,7,14,4,560,535,319,-216
2018,7,14,5,496,532,365,-167
2018,7,14,6,462,495,249,-246
2018,7,14,7,445,470,201,-269
2018,7,14,8,432,455,199,-256
2018,7,14,9,425,450,198,-252
2018,7,14,10,434,460,201,-259
2018,7,14,11,444,478,200,-278
2018,7,14,12,468,507,202,-305
2018,7,14,13,510,548,201,-347
2018,7,14,14,557,586,218,-368
2018,7,14,15,595,632,293,-339
2018,7,14,16,630,664,342,-322
2018,7,14,17,662,682,376,-306
2018,7,14,18,692,705,412,-293
2018,7,14,19,704,728,426,-302
2018,7,14,20,724,743,434,-309
2018,7,14,21,734,757,440,-317
2018,7,14,22,733,751,435,-316
2018,7,14,23,725,747,392,-355
2018,7,15,0,689,717,370,-347
2018,7,15,1,674,695,373,-322
2018,7,15,2,634,671,368,-303
2018,7,15,3,598,623,308,-315
2018,7,15,4,542,565,213,-352
2018,7,15,5,500,512,202,-310
2018,7,15,6,465,474,199,-275
2018,7,15,7,442,449,198,-251
2018,7,15,8,427,441,201,-240
2018,7,15,9,418,436,201,-235
2018,7,15,10,425,435,198,-237
2018,7,15,11,426,448,198,-250
2018,7,15,12,453,471,198,-273
2018,7,15,13,505,519,203,-316
2018,7,15,14,558,555,255,-300
2018,7,15,15,598,582,362,-220
2018,7,15,16,630,618,361,-257
2018,7,15,17,680,660,364,-296
2018,7,15,18,687,703,369,-334
2018,7,15,19,703,731,367,-364
2018,7,15,20,732,741,370,-371
2018,7,15,21,737,751,367,-384
2018,7,15,22,750,757,384,-373
2018,7,15,23,756,729,454,-275
2018,7,16,0,730,706,457,-249
2018,7,16,1,691,683,454,-229
2018,7,16,2,685,666,405,-261
2018,7,16,3,628,619,365,-254
2018,7,16,4,566,564,367,-197
2018,7,16,5,505,517,356,-161
2018,7,16,6,482,486,339,-147
2018,7,16,7,458,463,292,-171
2018,7,16,8,442,455,219,-236
2018,7,16,9,440,462,222,-240
2018,7,16,10,456,480,289,-191
2018,7,16,11,504,525,368,-157
2018,7,16,12,548,561,331,-230
2018,7,16,13,588,595,233,-362
2018,7,16,14,623,631,250,-381
2018,7,16,15,678,652,283,-369
2018,7,16,16,727,683,287,-396
2018,7,16,17,772,720,342,-378
2018,7,16,18,804,754,378,-376
2018,7,16,19,819,742,383,-359
2018,7,16,20,843,734,398,-336
2018,7,16,21,858,752,473,-279
2018,7,16,22,855,771,470,-301
2018,7,16,23,836,774,472,-302
2018,7,17,0,809,754,471,-283
2018,7,17,1,778,724,473,-251
2018,7,17,2,751,694,434,-260
2018,7,17,3,689,641,385,-256
2018,7,17,4,617,576,340,-236
2018,7,17,5,547,532,213,-319
2018,7,17,6,508,501,207,-294
2018,7,17,7,482,479,205,-274
2018,7,17,8,463,471,209,-262
2018,7,17,9,462,470,207,-263
2018,7,17,10,478,495,216,-279
2018,7,17,11,515,537,235,-302
2018,7,17,12,561,577,285,-292
2018,7,17,13,602,612,310,-302
2018,7,17,14,635,647,310,-337
2018,7,17,15,689,688,358,-330
2018,7,17,16,738,726,432,-294
2018,7,17,17,779,760,445,-315
2018,7,17,18,810,795,451,-344
2018,7,17,19,824,799,445,-354
2018,7,17,20,850,830,459,-371
2018,7,17,21,865,831,504,-327
2018,7,17,22,860,814,512,-302
2018,7,17,23,844,797,504,-293
2018,7,18,0,818,768,505,-263
2018,7,18,1,784,740,487,-253
2018,7,18,2,753,721,457,-264
2018,7,18,3,687,660,402,-258
2018,7,18,4,616,597,316,-281
2018,7,18,5,542,546,237,-309
2018,7,18,6,502,516,225,-291
2018,7,18,7,474,492,236,-256
2018,7,18,8,456,478,225,-253
2018,7,18,9,453,474,227,-247
2018,7,18,10,475,493,229,-264
2018,7,18,11,511,530,229,-301
2018,7,18,12,557,571,249,-322
2018,7,18,13,601,611,252,-359
2018,7,18,14,629,652,268,-384
2018,7,18,15,688,686,324,-362
2018,7,18,16,731,714,433,-281
2018,7,18,17,758,746,455,-291
2018,7,18,18,778,774,456,-318
2018,7,18,19,793,786,455,-331
2018,7,18,20,812,805,481,-324
2018,7,18,21,823,814,453,-361
2018,7,18,22,830,820,455,-365
2018,7,18,23,812,803,451,-352
2018,7,19,0,778,770,452,-318
2018,7,19,1,740,725,452,-273
2018,7,19,2,713,698,454,-244
2018,7,19,3,647,636,452,-184
2018,7,19,4,569,566,298,-268
2018,7,19,5,502,509,233,-276
2018,7,19,6,470,475,204,-271
2018,7,19,7,449,456,197,-259
2018,7,19,8,435,444,198,-246
2018,7,19,9,436,443,199,-244
2018,7,19,10,451,463,197,-266
2018,7,19,11,485,507,205,-302
2018,7,19,12,534,544,237,-307
2018,7,19,13,572,577,256,-321
2018,7,19,14,598,601,292,-309
2018,7,19,15,631,624,387,-237
2018,7,19,16,651,638,435,-203
2018,7,19,17,677,648,454,-194
2018,7,19,18,705,664,458,-206
2018,7,19,19,721,663,457,-206
2018,7,19,20,741,676,455,-221
2018,7,19,21,753,679,480,-199
2018,7,19,22,758,688,485,-203
2018,7,19,23,735,681,481,-200
2018,7,20,0,710,664,411,-253
2018,7,20,1,681,652,368,-284
2018,7,20,2,665,640,364,-276
2018,7,20,3,612,598,288,-310
2018,7,20,4,545,537,236,-301
2018,7,20,5,499,487,218,-269
2018,7,20,6,466,461,217,-244
2018,7,20,7,444,442,211,-231
2018,7,20,8,432,431,196,-235
2018,7,20,9,431,434,197,-237
2018,7,20,10,451,454,227,-227
2018,7,20,11,483,490,241,-249
2018,7,20,12,522,530,240,-290
2018,7,20,13,561,560,230,-330
2018,7,20,14,589,594,279,-315
2018,7,20,15,634,618,364,-254
2018,7,20,16,664,635,355,-280
2018,7,20,17,685,646,359,-287
2018,7,20,18,706,662,366,-296
2018,7,20,19,721,679,373,-306
2018,7,20,20,735,702,469,-233
2018,7,20,21,742,722,471,-251
2018,7,20,22,735,737,497,-240
2018,7,20,23,722,728,498,-230
2018,7,21,0,694,706,469,-237
2018,7,21,1,672,678,371,-307
2018,7,21,2,656,652,361,-291
2018,7,21,3,606,610,363,-247
2018,7,21,4,547,544,361,-183
2018,7,21,5,493,484,302,-182
2018,7,21,6,462,449,222,-227
2018,7,21,7,440,428,219,-209
2018,7,21,8,426,412,190,-222
2018,7,21,9,424,412,196,-216
2018,7,21,10,430,410,190,-220
2018,7,21,11,443,431,193,-238
2018,7,21,12,472,450,193,-257
2018,7,21,13,519,484,223,-261
2018,7,21,14,561,525,194,-331
2018,7,21,15,607,565,197,-368
2018,7,21,16,636,588,254,-334
2018,7,21,17,664,623,279,-344
2018,7,21,18,707,656,306,-350
2018,7,21,19,708,683,427,-256
2018,7,21,20,720,704,427,-277
2018,7,21,21,724,724,432,-292
2018,7,21,22,718,724,424,-300
2018,7,21,23,721,713,428,-285
2018,7,22,0,688,682,389,-293
2018,7,22,1,665,656,359,-297
2018,7,22,2,638,631,360,-271
2018,7,22,3,602,576,342,-234
2018,7,22,4,543,518,214,-304
2018,7,22,5,485,476,211,-265
2018,7,22,6,447,442,271,-171
2018,7,22,7,427,421,231,-190
2018,7,22,8,411,412,210,-202
2018,7,22,9,407,407,198,-209
2018,7,22,10,412,540,223,-317
2018,7,22,11,417,422,232,-190
2018,7,22,12,446,443,248,-195
2018,7,22,13,494,493,287,-206
2018,7,22,14,546,530,260,-270
2018,7,22,15,583,549,352,-197
2018,7,22,16,625,580,437,-143
2018,7,22,17,662,608,440,-168
2018,7,22,18,686,613,433,-180
2018,7,22,19,697,611,441,-170
2018,7,22,20,706,585,440,-145
2018,7,22,21,707,579,441,-138
2018,7,22,22,719,596,440,-156
2018,7,22,23,717,601,438,-163
2018,7,23,0,687,590,437,-153
2018,7,23,1,660,588,438,-150
2018,7,23,2,643,584,424,-160
2018,7,23,3,592,542,380,-162
2018,7,23,4,533,489,367,-122
2018,7,23,5,466,455,366,-89
2018,7,23,6,440,432,363,-69
2018,7,23,7,419,419,363,-56
2018,7,23,8,407,408,363,-45
2018,7,23,9,413,416,283,-133
2018,7,23,10,435,434,203,-231
2018,7,23,11,474,479,239,-240
2018,7,23,12,516,515,242,-273
2018,7,23,13,553,548,273,-275
2018,7,23,14,582,592,328,-264
2018,7,23,15,617,612,327,-285
2018,7,23,16,646,637,369,-268
2018,7,23,17,679,664,378,-286
2018,7,23,18,697,667,370,-297
2018,7,23,19,706,677,457,-220
2018,7,23,20,725,679,473,-206
2018,7,23,21,736,671,471,-200
2018,7,23,22,736,674,475,-199
2018,7,23,23,724,662,470,-192
2018,7,24,0,710,652,469,-183
2018,7,24,1,683,630,442,-188
2018,7,24,2,660,621,389,-232
2018,7,24,3,601,568,373,-195
2018,7,24,4,541,512,373,-139
2018,7,24,5,484,463,338,-125
2018,7,24,6,458,440,323,-117
2018,7,24,7,439,426,324,-102
2018,7,24,8,427,416,325,-91
2018,7,24,9,432,419,323,-96
2018,7,24,10,452,442,309,-133
2018,7,24,11,485,487,297,-190
2018,7,24,12,529,521,302,-219
2018,7,24,13,563,549,310,-239
2018,7,24,14,590,574,273,-301
2018,7,24,15,627,598,298,-300
2018,7,24,16,657,620,388,-232
2018,7,24,17,689,650,434,-216
2018,7,24,18,709,663,399,-264
2018,7,24,19,718,669,432,-237
2018,7,24,20,734,694,434,-260
2018,7,24,21,746,723,458,-265
2018,7,24,22,745,647,427,-220
2018,7,24,23,736,651,448,-203
2018,7,25,0,718,630,445,-185
2018,7,25,1,692,626,444,-182
2018,7,25,2,668,617,445,-172
2018,7,25,3,608,561,391,-170
2018,7,25,4,549,510,373,-137
2018,7,25,5,487,472,268,-204
2018,7,25,6,461,443,206,-237
2018,7,25,7,440,429,195,-234
2018,7,25,8,427,418,195,-223
2018,7,25,9,433,420,204,-216
2018,7,25,10,454,446,208,-238
2018,7,25,11,484,487,223,-264
2018,7,25,12,527,520,259,-261
2018,7,25,13,562,505,189,-316
2018,7,25,14,592,532,197,-335
2018,7,25,15,637,561,333,-228
2018,7,25,16,666,592,379,-213
2018,7,25,17,695,618,398,-220
2018,7,25,18,715,639,395,-244
2018,7,25,19,725,653,397,-256
2018,7,25,20,747,641,399,-242
2018,7,25,21,759,645,396,-249
2018,7,25,22,762,656,394,-262
2018,7,25,23,750,659,352,-307
2018,7,26,0,728,648,337,-311
2018,7,26,1,704,616,336,-280
2018,7,26,2,675,593,336,-257
2018,7,26,3,614,536,243,-293
2018,7,26,4,554,476,216,-260
2018,7,26,5,505,478,220,-258
2018,7,26,6,472,447,205,-242
2018,7,26,7,452,429,206,-223
2018,7,26,8,438,418,206,-212
2018,7,26,9,440,419,207,-212
2018,7,26,10,461,439,205,-234
2018,7,26,11,498,479,211,-268
2018,7,26,12,537,519,207,-312
2018,7,26,13,576,543,205,-338
2018,7,26,14,606,580,241,-339
2018,7,26,15,649,611,315,-296
2018,7,26,16,682,644,414,-230
2018,7,26,17,719,673,436,-237
2018,7,26,18,746,706,455,-251
2018,7,26,19,766,724,454,-270
2018,7,26,20,781,748,453,-295
2018,7,26,21,797,777,452,-325
2018,7,26,22,796,779,449,-330
2018,7,26,23,786,771,405,-366
2018,7,27,0,767,743,384,-359
2018,7,27,1,742,709,386,-323
2018,7,27,2,701,684,387,-297
2018,7,27,3,643,621,384,-237
2018,7,27,4,581,553,264,-289
2018,7,27,5,519,502,210,-292
2018,7,27,6,484,467,211,-256
2018,7,27,7,462,441,206,-235
2018,7,27,8,448,428,204,-224
2018,7,27,9,449,433,206,-227
2018,7,27,10,468,448,242,-206
2018,7,27,11,501,481,269,-212
2018,7,27,12,538,522,296,-226
2018,7,27,13,577,551,278,-273
2018,7,27,14,610,580,349,-231
2018,7,27,15,652,622,379,-243
2018,7,27,16,687,656,375,-281
2018,7,27,17,722,689,382,-307
2018,7,27,18,744,717,380,-337
2018,7,27,19,768,745,381,-364
2018,7,27,20,782,752,385,-367
2018,7,27,21,798,756,473,-283
2018,7,27,22,792,750,473,-277
2018,7,27,23,779,734,467,-267
2018,7,28,0,751,700,465,-235
2018,7,28,1,729,667,464,-203
2018,7,28,2,690,652,409,-243
2018,7,28,3,635,607,376,-231
2018,7,28,4,581,549,305,-244
2018,7,28,5,506,497,217,-280
2018,7,28,6,477,465,195,-270
2018,7,28,7,460,444,196,-248
2018,7,28,8,443,429,195,-234
2018,7,28,9,437,424,194,-230
2018,7,28,10,445,434,196,-238
2018,7,28,11,460,447,197,-250
2018,7,28,12,490,472,195,-277
2018,7,28,13,531,515,196,-319
2018,7,28,14,577,560,205,-355
2018,7,28,15,619,596,289,-307
2018,7,28,16,652,621,357,-264
2018,7,28,17,681,640,447,-193
2018,7,28,18,710,663,445,-218
2018,7,28,19,726,683,446,-237
2018,7,28,20,733,704,447,-257
2018,7,28,21,741,721,447,-274
2018,7,28,22,740,727,447,-280
2018,7,28,23,735,707,434,-273
2018,7,29,0,714,673,392,-281
2018,7,29,1,686,639,317,-322
2018,7,29,2,650,618,227,-391
2018,7,29,3,609,569,227,-342
2018,7,29,4,552,512,221,-291
2018,7,29,5,482,465,183,-282
2018,7,29,6,447,432,176,-256
2018,7,29,7,422,420,174,-246
2018,7,29,8,403,410,156,-254
2018,7,29,9,400,405,131,-274
2018,7,29,10,406,406,130,-276
2018,7,29,11,415,418,167,-251
2018,7,29,12,441,443,196,-247
2018,7,29,13,496,477,207,-270
2018,7,29,14,547,519,232,-287
2018,7,29,15,577,549,297,-252
2018,7,29,16,622,580,371,-209
2018,7,29,17,661,619,370,-249
2018,7,29,18,689,655,374,-281
2018,7,29,19,708,682,379,-303
2018,7,29,20,723,696,464,-232
2018,7,29,21,729,721,467,-254
2018,7,29,22,738,736,406,-330
2018,7,29,23,733,737,375,-362
2018,7,30,0,707,712,372,-340
2018,7,30,1,679,684,371,-313
2018,7,30,2,664,667,372,-295
2018,7,30,3,599,624,380,-244
2018,7,30,4,543,545,291,-254
2018,7,30,5,485,506,236,-270
2018,7,30,6,455,472,228,-244
2018,7,30,7,433,453,197,-256
2018,7,30,8,419,443,198,-245
2018,7,30,9,421,439,192,-247
2018,7,30,10,437,466,241,-225
2018,7,30,11,487,500,248,-252
2018,7,30,12,525,541,264,-277
2018,7,30,13,565,575,260,-315
2018,7,30,14,603,611,280,-331
2018,7,30,15,638,646,352,-294
2018,7,30,16,678,680,364,-316
2018,7,30,17,706,716,365,-351
2018,7,30,18,731,745,364,-381
2018,7,30,19,749,763,367,-396
2018,7,30,20,764,789,454,-335
2018,7,30,21,778,808,461,-347
2018,7,30,22,774,819,460,-359
2018,7,30,23,754,815,461,-354
2018,7,31,0,734,779,443,-336
2018,7,31,1,716,743,401,-342
2018,7,31,2,675,701,364,-337
2018,7,31,3,614,633,362,-271
2018,7,31,4,550,567,330,-237
2018,7,31,5,492,516,263,-253
2018,7,31,6,464,484,275,-209
2018,7,31,7,443,466,267,-199
2018,7,31,8,434,455,256,-199
2018,7,31,9,439,459,245,-214
2018,7,31,10,456,478,305,-173
2018,7,31,11,495,517,349,-168
2018,7,31,12,535,557,304,-253
2018,7,31,13,570,591,288,-303
2018,7,31,14,598,625,326,-299
2018,7,31,15,637,660,372,-288
2018,7,31,16,668,693,421,-272
2018,7,31,17,696,717,435,-282
2018,7,31,18,707,725,441,-284
2018,7,31,19,720,700,435,-265
2018,7,31,20,728,718,447,-271
2018,7,31,21,746,729,464,-265
2018,7,31,22,744,723,471,-252
2018,7,31,23,729,709,462,-247
2018,8,1,0,721,689,376,-313
2018,8,1,1,695,673,365,-308
2018,8,1,2,661,648,362,-286
2018,8,1,3,601,588,361,-227
2018,8,1,4,548,534,336,-198
2018,8,1,5,500,487,244,-243
2018,8,1,6,475,460,256,-204
2018,8,1,7,455,437,228,-209
2018,8,1,8,447,433,222,-211
2018,8,1,9,450,432,224,-208
2018,8,1,10,469,453,235,-218
2018,8,1,11,509,498,245,-253
2018,8,1,12,552,537,291,-246
2018,8,1,13,589,565,266,-299
2018,8,1,14,609,593,253,-340
2018,8,1,15,654,612,308,-304
2018,8,1,16,693,617,410,-207
2018,8,1,17,710,618,429,-189
2018,8,1,18,734,622,438,-184
2018,8,1,19,739,619,496,-123
2018,8,1,20,755,620,567,-53
2018,8,1,21,768,625,562,-63
2018,8,1,22,768,624,504,-120
2018,8,1,23,758,623,439,-184
2018,8,2,0,740,605,439,-166
2018,8,2,1,708,597,408,-189
2018,8,2,2,686,585,428,-157
2018,8,2,3,624,544,375,-169
2018,8,2,4,558,498,264,-234
2018,8,2,5,486,456,259,-197
2018,8,2,6,463,436,257,-179
2018,8,2,7,443,426,260,-166
2018,8,2,8,431,416,259,-157
2018,8,2,9,431,423,262,-161
2018,8,2,10,454,443,300,-143
2018,8,2,11,497,488,340,-148
2018,8,2,12,536,532,332,-200
2018,8,2,13,575,559,369,-190
2018,8,2,14,597,586,447,-139
2018,8,2,15,630,599,466,-133
2018,8,2,16,664,615,477,-138
2018,8,2,17,683,615,475,-140
2018,8,2,18,702,613,473,-140
2018,8,2,19,716,607,487,-120
2018,8,2,20,731,606,562,-44
2018,8,2,21,746,603,593,-10
2018,8,2,22,742,614,585,-29
2018,8,2,23,733,614,491,-123
2018,8,3,0,721,605,441,-164
2018,8,3,1,702,605,452,-153
2018,8,3,2,681,592,454,-138
2018,8,3,3,622,551,374,-177
2018,8,3,4,559,506,323,-183
2018,8,3,5,487,457,282,-175
2018,8,3,6,459,433,264,-169
2018,8,3,7,437,425,263,-162
2018,8,3,8,426,422,265,-157
2018,8,3,9,428,425,264,-161
2018,8,3,10,454,443,266,-177
2018,8,3,11,502,487,348,-139
2018,8,3,12,552,524,407,-117
2018,8,3,13,598,546,430,-116
2018,8,3,14,623,566,444,-122
2018,8,3,15,670,588,461,-127
2018,8,3,16,716,592,486,-106
2018,8,3,17,733,613,485,-128
2018,8,3,18,760,635,482,-153
2018,8,3,19,767,655,484,-171
2018,8,3,20,783,684,477,-207
2018,8,3,21,796,693,477,-216
2018,8,3,22,787,694,483,-211
2018,8,3,23,770,679,483,-196
2018,8,4,0,750,666,488,-178
2018,8,4,1,720,649,430,-219
2018,8,4,2,697,631,413,-218
2018,8,4,3,635,587,381,-206
2018,8,4,4,567,534,380,-154
2018,8,4,5,461,487,384,-103
2018,8,4,6,439,455,386,-69
2018,8,4,7,422,437,385,-52
2018,8,4,8,411,424,385,-39
2018,8,4,9,407,418,383,-35
2018,8,4,10,416,427,371,-56
2018,8,4,11,430,447,352,-95
2018,8,4,12,458,468,347,-121
2018,8,4,13,497,506,351,-155
2018,8,4,14,533,540,350,-190
2018,8,4,15,577,575,356,-219
2018,8,4,16,605,612,405,-207
2018,8,4,17,636,648,454,-194
2018,8,4,18,661,681,469,-212
2018,8,4,19,686,703,476,-227
2018,8,4,20,705,716,478,-238
2018,8,4,21,714,718,474,-244
2018,8,4,22,718,707,474,-233
2018,8,4,23,706,702,480,-222
2018,8,5,0,676,685,480,-205
2018,8,5,1,656,660,462,-198
2018,8,5,2,630,639,450,-189
2018,8,5,3,582,588,364,-224
2018,8,5,4,532,533,332,-201
2018,8,5,5,472,489,312,-177
2018,8,5,6,444,453,295,-158
2018,8,5,7,425,430,303,-127
2018,8,5,8,417,419,302,-117
2018,8,5,9,414,413,302,-111
2018,8,5,10,423,420,308,-112
2018,8,5,11,424,432,308,-124
2018,8,5,12,449,449,245,-204
2018,8,5,13,498,499,232,-267
2018,8,5,14,541,535,261,-274
2018,8,5,15,570,571,373,-198
2018,8,5,16,600,617,397,-220
2018,8,5,17,637,656,395,-261
2018,8,5,18,660,691,396,-295
2018,8,5,19,682,718,398,-320
2018,8,5,20,698,735,411,-324
2018,8,5,21,711,751,431,-320
2018,8,5,22,724,752,474,-278
2018,8,5,23,717,733,478,-255
2018,8,6,0,690,712,472,-240
2018,8,6,1,666,686,472,-214
2018,8,6,2,644,662,479,-183
2018,8,6,3,593,604,482,-122
2018,8,6,4,537,545,308,-237
2018,8,6,5,492,496,300,-196
2018,8,6,6,468,460,299,-161
2018,8,6,7,448,440,300,-140
2018,8,6,8,432,429,301,-128
2018,8,6,9,434,433,302,-131
2018,8,6,10,456,451,303,-148
2018,8,6,11,501,495,301,-194
2018,8,6,12,542,533,378,-155
2018,8,6,13,575,561,409,-152
2018,8,6,14,605,610,445,-165
2018,8,6,15,651,652,462,-190
2018,8,6,16,702,699,478,-221
2018,8,6,17,730,736,467,-269
2018,8,6,18,766,774,502,-272
2018,8,6,19,788,762,504,-258
2018,8,6,20,808,733,496,-237
2018,8,6,21,830,715,489,-226
2018,8,6,22,827,728,485,-243
2018,8,6,23,812,732,478,-254
2018,8,7,0,783,713,478,-235
2018,8,7,1,758,696,480,-216
2018,8,7,2,727,668,476,-192
2018,8,7,3,658,611,480,-131
2018,8,7,4,593,550,471,-79
2018,8,7,5,507,492,296,-196
2018,8,7,6,478,466,251,-215
2018,8,7,7,459,444,228,-216
2018,8,7,8,445,435,219,-216
2018,8,7,9,448,438,218,-220
2018,8,7,10,469,456,230,-226
2018,8,7,11,510,501,371,-130
2018,8,7,12,551,535,394,-141
2018,8,7,13,581,564,447,-117
2018,8,7,14,608,605,465,-140
2018,8,7,15,650,644,447,-197
2018,8,7,16,690,690,443,-247
2018,8,7,17,717,735,441,-294
2018,8,7,18,746,741,442,-299
2018,8,7,19,764,726,449,-277
2018,8,7,20,786,731,478,-253
2018,8,7,21,806,744,500,-244
2018,8,7,22,807,754,500,-254
2018,8,7,23,794,770,498,-272
2018,8,8,0,762,751,498,-253
2018,8,8,1,735,730,501,-229
2018,8,8,2,701,694,496,-198
2018,8,8,3,633,634,435,-199
2018,8,8,4,575,566,399,-167
2018,8,8,5,517,516,391,-125
2018,8,8,6,486,475,317,-158
2018,8,8,7,467,455,216,-239
2018,8,8,8,452,443,216,-227
2018,8,8,9,452,441,217,-224
2018,8,8,10,472,461,296,-165
2018,8,8,11,518,506,390,-116
2018,8,8,12,555,540,394,-146
2018,8,8,13,588,569,395,-174
2018,8,8,14,618,607,424,-183
2018,8,8,15,658,662,467,-195
2018,8,8,16,701,702,456,-246
2018,8,8,17,722,736,457,-279
2018,8,8,18,754,778,465,-313
2018,8,8,19,772,767,463,-304
2018,8,8,20,784,682,488,-194
2018,8,8,21,800,698,499,-199
2018,8,8,22,802,728,503,-225
2018,8,8,23,784,686,492,-194
2018,8,9,0,754,665,508,-157
2018,8,9,1,734,642,495,-147
2018,8,9,2,699,623,499,-124
2018,8,9,3,630,579,497,-82
2018,8,9,4,566,517,396,-121
2018,8,9,5,505,480,255,-225
2018,8,9,6,476,450,231,-219
2018,8,9,7,459,437,224,-213
2018,8,9,8,444,428,226,-202
2018,8,9,9,446,428,227,-201
2018,8,9,10,462,449,244,-205
2018,8,9,11,512,492,256,-236
2018,8,9,12,545,531,309,-222
2018,8,9,13,574,562,377,-185
2018,8,9,14,596,593,416,-177
2018,8,9,15,637,626,464,-162
2018,8,9,16,672,661,466,-195
2018,8,9,17,691,689,464,-225
2018,8,9,18,712,726,465,-261
2018,8,9,19,729,733,464,-269
2018,8,9,20,739,745,522,-223
2018,8,9,21,755,757,581,-176
2018,8,9,22,759,768,604,-164
2018,8,9,23,743,758,609,-149
2018,8,10,0,718,726,581,-145
2018,8,10,1,704,710,498,-212
2018,8,10,2,680,667,483,-184
2018,8,10,3,620,610,468,-142
2018,8,10,4,556,541,452,-89
2018,8,10,5,508,495,315,-180
2018,8,10,6,478,459,220,-239
2018,8,10,7,457,439,218,-221
2018,8,10,8,444,434,230,-204
2018,8,10,9,445,433,228,-205
2018,8,10,10,461,452,300,-152
2018,8,10,11,506,491,347,-144
2018,8,10,12,536,527,361,-166
2018,8,10,13,568,558,367,-191
2018,8,10,14,592,585,365,-220
2018,8,10,15,632,619,367,-252
2018,8,10,16,669,650,373,-277
2018,8,10,17,688,676,375,-301
2018,8,10,18,708,703,386,-317
2018,8,10,19,721,718,454,-264
2018,8,10,20,733,727,576,-151
2018,8,10,21,749,727,586,-141
2018,8,10,22,746,720,579,-141
2018,8,10,23,735,705,585,-120
2018,8,11,0,702,671,582,-89
2018,8,11,1,685,651,506,-145
2018,8,11,2,651,617,465,-152
2018,8,11,3,597,584,469,-115
2018,8,11,4,538,528,467,-61
2018,8,11,5,482,478,396,-82
2018,8,11,6,451,453,218,-235
2018,8,11,7,432,433,241,-192
2018,8,11,8,421,421,251,-170
2018,8,11,9,414,420,251,-169
2018,8,11,10,423,421,234,-187
2018,8,11,11,445,445,236,-209
2018,8,11,12,468,469,241,-228
2018,8,11,13,508,507,293,-214
2018,8,11,14,543,541,373,-168
2018,8,11,15,588,573,437,-136
2018,8,11,16,620,609,467,-142
2018,8,11,17,645,636,475,-161
2018,8,11,18,670,659,476,-183
2018,8,11,19,684,674,471,-203
2018,8,11,20,695,696,486,-210
2018,8,11,21,708,714,513,-201
2018,8,11,22,706,726,523,-203
2018,8,11,23,702,710,488,-222
2018,8,12,0,673,692,381,-311
2018,8,12,1,655,658,363,-295
2018,8,12,2,623,635,367,-268
2018,8,12,3,584,579,360,-219
2018,8,12,4,522,527,345,-182
2018,8,12,5,473,476,233,-243
2018,8,12,6,442,445,241,-204
2018,8,12,7,423,422,206,-216
2018,8,12,8,410,410,193,-217
2018,8,12,9,405,408,193,-215
2018,8,12,10,409,411,191,-220
2018,8,12,11,420,425,204,-221
2018,8,12,12,445,450,211,-239
2018,8,12,13,490,493,257,-236
2018,8,12,14,535,530,264,-266
2018,8,12,15,566,574,351,-223
2018,8,12,16,599,590,351,-239
2018,8,12,17,642,638,436,-202
2018,8,12,18,661,665,470,-195
2018,8,12,19,678,681,481,-200
2018,8,12,20,682,697,595,-102
2018,8,12,21,697,705,636,-69
2018,8,12,22,713,716,655,-61
2018,8,12,23,720,714,654,-60
2018,8,13,0,693,688,638,-50
2018,8,13,1,675,661,583,-78
2018,8,13,2,644,634,503,-131
2018,8,13,3,591,573,457,-116
2018,8,13,4,531,518,472,-46
2018,8,13,5,463,473,358,-115
2018,8,13,6,440,440,220,-220
2018,8,13,7,423,425,202,-223
2018,8,13,8,414,408,183,-225
2018,8,13,9,415,417,187,-230
2018,8,13,10,435,437,185,-252
2018,8,13,11,486,477,209,-268
2018,8,13,12,514,512,254,-258
2018,8,13,13,544,550,272,-278
2018,8,13,14,565,567,256,-311
2018,8,13,15,603,610,286,-324
2018,8,13,16,635,640,388,-252
2018,8,13,17,657,668,427,-241
2018,8,13,18,679,697,426,-271
2018,8,13,19,693,712,425,-287
2018,8,13,20,705,739,538,-201
2018,8,13,21,721,753,528,-225
2018,8,13,22,725,748,526,-222
2018,8,13,23,720,736,526,-210
2018,8,14,0,690,701,522,-179
2018,8,14,1,671,688,527,-161
2018,8,14,2,640,644,388,-256
2018,8,14,3,582,582,256,-326
2018,8,14,4,521,523,247,-276
2018,8,14,5,479,470,193,-277
2018,8,14,6,455,433,130,-303
2018,8,14,7,436,419,129,-290
2018,8,14,8,427,409,128,-281
2018,8,14,9,427,413,128,-285
2018,8,14,10,448,435,129,-306
2018,8,14,11,499,473,125,-348
2018,8,14,12,532,514,134,-380
2018,8,14,13,561,540,152,-388
2018,8,14,14,585,568,207,-361
2018,8,14,15,615,598,243,-355
2018,8,14,16,650,628,405,-223
2018,8,14,17,680,658,431,-227
2018,8,14,18,712,681,450,-231
2018,8,14,19,732,705,479,-226
2018,8,14,20,746,728,495,-233
2018,8,14,21,768,741,525,-216
2018,8,14,22,773,750,569,-181
2018,8,14,23,759,740,566,-174
2018,8,15,0,732,713,553,-160
2018,8,15,1,710,690,482,-208
2018,8,15,2,671,652,427,-225
2018,8,15,3,605,593,260,-333
2018,8,15,4,540,536,211,-325
2018,8,15,5,479,486,176,-310
2018,8,15,6,451,453,166,-287
2018,8,15,7,433,435,168,-267
2018,8,15,8,424,424,165,-259
2018,8,15,9,427,425,156,-269
2018,8,15,10,451,434,150,-284
2018,8,15,11,505,486,153,-333
2018,8,15,12,538,514,148,-366
2018,8,15,13,568,540,152,-388
2018,8,15,14,596,573,207,-366
2018,8,15,15,633,604,313,-291
2018,8,15,16,665,637,389,-248
2018,8,15,17,699,669,437,-232
2018,8,15,18,730,696,439,-257
2018,8,15,19,753,708,462,-246
2018,8,15,20,768,708,509,-199
2018,8,15,21,778,713,546,-167
2018,8,15,22,788,724,536,-188
2018,8,15,23,775,712,496,-216
2018,8,16,0,736,684,488,-196
2018,8,16,1,713,674,470,-204
2018,8,16,2,682,653,395,-258
2018,8,16,3,616,595,258,-337
2018,8,16,4,547,532,189,-343
2018,8,16,5,513,491,203,-288
2018,8,16,6,480,461,154,-307
2018,8,16,7,458,442,139,-303
2018,8,16,8,450,434,139,-295
2018,8,16,9,450,434,140,-294
2018,8,16,10,471,450,140,-310
2018,8,16,11,526,491,142,-349
2018,8,16,12,551,527,140,-387
2018,8,16,13,579,556,160,-396
2018,8,16,14,608,589,172,-417
2018,8,16,15,647,631,285,-346
2018,8,16,16,686,669,316,-353
2018,8,16,17,714,708,328,-380
2018,8,16,18,746,749,329,-420
2018,8,16,19,770,775,341,-434
2018,8,16,20,785,794,371,-423
2018,8,16,21,812,804,394,-410
2018,8,16,22,825,816,500,-316
2018,8,16,23,810,802,458,-344
2018,8,17,0,769,764,460,-304
2018,8,17,1,752,741,455,-286
2018,8,17,2,713,703,385,-318
2018,8,17,3,636,636,283,-353
2018,8,17,4,568,570,251,-319
2018,8,17,5,518,519,198,-321
2018,8,17,6,481,483,137,-346
2018,8,17,7,461,460,139,-321
2018,8,17,8,451,447,136,-311
2018,8,17,9,448,443,143,-300
2018,8,17,10,474,457,149,-308
2018,8,17,11,523,490,149,-341
2018,8,17,12,549,526,149,-377
2018,8,17,13,577,556,151,-405
2018,8,17,14,609,596,166,-430
2018,8,17,15,647,629,174,-455
2018,8,17,16,675,676,221,-455
2018,8,17,17,702,714,278,-436
2018,8,17,18,726,743,321,-422
2018,8,17,19,741,738,384,-354
2018,8,17,20,751,721,390,-331
2018,8,17,21,759,734,388,-346
2018,8,17,22,751,741,390,-351
2018,8,17,23,728,727,350,-377
2018,8,18,0,688,693,231,-462
2018,8,18,1,683,674,217,-457
2018,8,18,2,652,649,191,-458
2018,8,18,3,597,596,160,-436
2018,8,18,4,538,544,162,-382
2018,8,18,5,507,497,160,-337
2018,8,18,6,469,462,162,-300
2018,8,18,7,447,441,152,-289
2018,8,18,8,435,430,149,-281
2018,8,18,9,428,427,148,-279
2018,8,18,10,436,438,147,-291
2018,8,18,11,461,460,157,-303
2018,8,18,12,481,480,149,-331
2018,8,18,13,521,517,159,-358
2018,8,18,14,557,552,155,-397
2018,8,18,15,592,582,163,-419
2018,8,18,16,618,600,208,-392
2018,8,18,17,641,608,228,-380
2018,8,18,18,664,621,230,-391
2018,8,18,19,668,637,234,-403
2018,8,18,20,674,648,288,-360
2018,8,18,21,679,650,335,-315
2018,8,18,22,672,653,338,-315
2018,8,18,23,661,646,335,-311
2018,8,19,0,644,634,221,-413
2018,8,19,1,629,613,172,-441
2018,8,19,2,604,598,163,-435
2018,8,19,3,556,557,164,-393
2018,8,19,4,506,508,163,-345
2018,8,19,5,469,467,147,-320
2018,8,19,6,436,442,148,-294
2018,8,19,7,412,425,150,-275
2018,8,19,8,400,414,149,-265
2018,8,19,9,394,413,148,-265
2018,8,19,10,397,414,144,-270
2018,8,19,11,417,431,147,-284
2018,8,19,12,443,456,146,-310
2018,8,19,13,492,500,155,-345
2018,8,19,14,538,535,174,-361
2018,8,19,15,570,571,178,-393
2018,8,19,16,603,601,177,-424
2018,8,19,17,635,642,204,-438
2018,8,19,18,660,661,277,-384
2018,8,19,19,678,681,278,-403
2018,8,19,20,692,685,280,-405
2018,8,19,21,703,672,293,-379
2018,8,19,22,708,687,358,-329
2018,8,19,23,708,689,361,-328
2018,8,20,0,691,674,339,-335
2018,8,20,1,680,659,239,-420
2018,8,20,2,644,636,225,-411
2018,8,20,3,587,580,180,-400
2018,8,20,4,521,520,175,-345
2018,8,20,5,470,477,173,-304
2018,8,20,6,443,454,176,-278
2018,8,20,7,427,435,146,-289
2018,8,20,8,420,426,139,-287
2018,8,20,9,420,431,139,-292
2018,8,20,10,446,464,144,-320
2018,8,20,11,510,510,152,-358
2018,8,20,12,538,543,141,-402
2018,8,20,13,562,577,153,-424
2018,8,20,14,586,601,159,-442
2018,8,20,15,626,634,172,-462
2018,8,20,16,655,677,218,-459
2018,8,20,17,688,715,256,-459
2018,8,20,18,713,747,287,-460
2018,8,20,19,730,623,159,-464
2018,8,20,20,747,922,466,-456
2018,8,20,21,760,793,333,-460
2018,8,20,22,768,779,326,-453
2018,8,20,23,760,763,329,-434
2018,8,21,0,727,738,319,-419
2018,8,21,1,716,723,277,-446
2018,8,21,2,676,685,219,-466
2018,8,21,3,607,619,205,-414
2018,8,21,4,548,559,182,-377
2018,8,21,5,482,512,141,-371
2018,8,21,6,454,480,138,-342
2018,8,21,7,437,459,140,-319
2018,8,21,8,429,450,158,-292
2018,8,21,9,429,454,148,-306
2018,8,21,10,457,472,169,-303
2018,8,21,11,513,522,168,-354
2018,8,21,12,545,563,174,-389
2018,8,21,13,570,583,175,-408
2018,8,21,14,589,608,175,-433
2018,8,21,15,624,638,172,-466
2018,8,21,16,653,676,220,-456
2018,8,21,17,681,687,234,-453
2018,8,21,18,703,687,237,-450
2018,8,21,19,717,689,214,-475
2018,8,21,20,729,715,270,-445
2018,8,21,21,745,708,311,-397
2018,8,21,22,749,727,324,-403
2018,8,21,23,739,722,272,-450
2018,8,22,0,710,702,252,-450
2018,8,22,1,698,685,242,-443
2018,8,22,2,658,645,212,-433
2018,8,22,3,589,583,201,-382
2018,8,22,4,528,527,180,-347
2018,8,22,5,476,477,170,-307
2018,8,22,6,450,446,183,-263
2018,8,22,7,433,428,163,-265
2018,8,22,8,424,417,152,-265
2018,8,22,9,429,422,174,-248
2018,8,22,10,455,445,172,-273
2018,8,22,11,511,500,176,-324
2018,8,22,12,537,535,182,-353
2018,8,22,13,563,553,182,-371
2018,8,22,14,584,575,180,-395
2018,8,22,15,624,592,182,-410
2018,8,22,16,651,608,218,-390
2018,8,22,17,672,621,251,-370
2018,8,22,18,692,635,272,-363
2018,8,22,19,706,648,293,-355
2018,8,22,20,722,670,331,-339
2018,8,22,21,735,670,310,-360
2018,8,22,22,740,676,307,-369
2018,8,22,23,732,662,258,-404
2018,8,23,0,711,644,241,-403
2018,8,23,1,699,637,239,-398
2018,8,23,2,659,607,242,-365
2018,8,23,3,591,548,241,-307
2018,8,23,4,530,493,230,-263
2018,8,23,5,467,448,170,-278
2018,8,23,6,439,424,135,-289
2018,8,23,7,424,409,141,-268
2018,8,23,8,415,396,138,-258
2018,8,23,9,414,397,138,-259
2018,8,23,10,438,422,141,-281
2018,8,23,11,499,471,137,-334
2018,8,23,12,528,500,138,-362
2018,8,23,13,549,520,139,-381
2018,8,23,14,572,537,140,-397
2018,8,23,15,603,554,140,-414
2018,8,23,16,627,566,186,-380
2018,8,23,17,641,581,207,-374
2018,8,23,18,663,603,209,-394
2018,8,23,19,678,615,206,-409
2018,8,23,20,691,636,229,-407
2018,8,23,21,706,658,235,-423
2018,8,23,22,710,671,237,-434
2018,8,23,23,696,660,190,-470
2018,8,24,0,671,631,168,-463
2018,8,24,1,665,608,166,-442
2018,8,24,2,633,583,169,-414
2018,8,24,3,572,520,156,-364
2018,8,24,4,510,460,150,-310
2018,8,24,5,426,421,140,-281
2018,8,24,6,404,401,131,-270
2018,8,24,7,390,385,130,-255
2018,8,24,8,387,381,133,-248
2018,8,24,9,392,386,137,-249
2018,8,24,10,420,403,133,-270
2018,8,24,11,481,448,136,-312
2018,8,24,12,505,484,136,-348
2018,8,24,13,523,501,137,-364
2018,8,24,14,540,520,135,-385
2018,8,24,15,559,536,138,-398
2018,8,24,16,575,542,138,-404
2018,8,24,17,588,557,146,-411
2018,8,24,18,597,569,169,-400
2018,8,24,19,610,584,173,-411
2018,8,24,20,631,599,233,-366
2018,8,24,21,642,621,257,-364
2018,8,24,22,636,629,238,-391
2018,8,24,23,628,620,239,-381
2018,8,25,0,605,594,199,-395
2018,8,25,1,600,587,170,-417
2018,8,25,2,576,560,168,-392
2018,8,25,3,529,516,159,-357
2018,8,25,4,474,469,140,-329
2018,8,25,5,441,430,141,-289
2018,8,25,6,410,405,139,-266
2018,8,25,7,391,391,140,-251
2018,8,25,8,380,384,142,-242
2018,8,25,9,379,384,139,-245
2018,8,25,10,388,396,143,-253
2018,8,25,11,409,410,139,-271
2018,8,25,12,432,433,139,-294
2018,8,25,13,469,467,141,-326
2018,8,25,14,500,496,143,-353
2018,8,25,15,525,519,143,-376
2018,8,25,16,543,534,211,-323
2018,8,25,17,569,549,226,-323
2018,8,25,18,587,569,228,-341
2018,8,25,19,602,587,225,-362
2018,8,25,20,617,609,222,-387
2018,8,25,21,630,635,227,-408
2018,8,25,22,637,646,229,-417
2018,8,25,23,631,647,189,-458
2018,8,26,0,612,625,169,-456
2018,8,26,1,605,617,171,-446
2018,8,26,2,571,593,167,-426
2018,8,26,3,525,672,168,-504
2018,8,26,4,473,494,171,-323
2018,8,26,5,434,450,167,-283
2018,8,26,6,403,421,169,-252
2018,8,26,7,388,403,169,-234
2018,8,26,8,381,395,138,-257
2018,8,26,9,378,391,135,-256
2018,8,26,10,381,394,134,-260
2018,8,26,11,398,414,135,-279
2018,8,26,12,418,523,138,-385
2018,8,26,13,464,471,135,-336
2018,8,26,14,501,501,134,-367
2018,8,26,15,524,542,140,-402
2018,8,26,16,541,573,163,-410
2018,8,26,17,587,601,161,-440
2018,8,26,18,609,633,164,-469
2018,8,26,19,644,661,170,-491
2018,8,26,20,660,689,207,-482
2018,8,26,21,688,719,233,-486
2018,8,26,22,701,725,308,-417
2018,8,26,23,697,722,442,-280
2018,8,27,0,671,701,419,-282
2018,8,27,1,656,687,297,-390
2018,8,27,2,625,650,269,-381
2018,8,27,3,566,591,260,-331
2018,8,27,4,507,532,192,-340
2018,8,27,5,459,481,169,-312
2018,8,27,6,430,449,161,-288
2018,8,27,7,414,435,147,-288
2018,8,27,8,404,425,145,-280
2018,8,27,9,408,428,145,-283
2018,8,27,10,429,456,145,-311
2018,8,27,11,501,520,166,-354
2018,8,27,12,531,544,164,-380
2018,8,27,13,547,567,165,-402
2018,8,27,14,577,593,167,-426
2018,8,27,15,613,619,165,-454
2018,8,27,16,640,665,173,-492
2018,8,27,17,677,718,228,-490
2018,8,27,18,713,748,298,-450
2018,8,27,19,737,777,295,-482
2018,8,27,20,757,791,293,-498
2018,8,27,21,780,813,385,-428
2018,8,27,22,788,826,400,-426
2018,8,27,23,774,807,395,-412
2018,8,28,0,737,770,394,-376
2018,8,28,1,722,747,328,-419
2018,8,28,2,674,700,232,-468
2018,8,28,3,603,620,166,-454
2018,8,28,4,539,556,163,-393
2018,8,28,5,491,503,152,-351
2018,8,28,6,459,471,155,-316
2018,8,28,7,442,451,151,-300
2018,8,28,8,431,441,145,-296
2018,8,28,9,434,439,143,-296
2018,8,28,10,460,468,150,-318
2018,8,28,11,521,523,163,-360
2018,8,28,12,552,552,174,-378
2018,8,28,13,570,570,177,-393
2018,8,28,14,598,598,179,-419
2018,8,28,15,629,623,178,-445
2018,8,28,16,665,667,224,-443
2018,8,28,17,701,705,264,-441
2018,8,28,18,735,735,285,-450
2018,8,28,19,762,764,309,-455
2018,8,28,20,785,790,345,-445
2018,8,28,21,804,814,360,-454
2018,8,28,22,806,816,358,-458
2018,8,28,23,792,811,309,-502
2018,8,29,0,755,782,266,-516
2018,8,29,1,743,751,273,-478
2018,8,29,2,695,707,203,-504
2018,8,29,3,620,622,160,-462
2018,8,29,4,557,557,158,-399
2018,8,29,5,486,502,147,-355
2018,8,29,6,456,470,123,-347
2018,8,29,7,439,455,124,-331
2018,8,29,8,430,440,123,-317
2018,8,29,9,433,443,125,-318
2018,8,29,10,465,468,135,-333
2018,8,29,11,528,529,146,-383
2018,8,29,12,557,552,157,-395
2018,8,29,13,577,576,158,-418
2018,8,29,14,606,603,159,-444
2018,8,29,15,639,645,163,-482
2018,8,29,16,678,685,210,-475
2018,8,29,17,715,723,239,-484
2018,8,29,18,746,763,297,-466
2018,8,29,19,766,779,373,-406
2018,8,29,20,780,792,441,-351
2018,8,29,21,783,805,498,-307
2018,8,29,22,789,797,508,-289
2018,8,29,23,769,792,498,-294
2018,8,30,0,741,760,424,-336
2018,8,30,1,731,736,394,-342
2018,8,30,2,679,695,354,-341
2018,8,30,3,610,628,259,-369
2018,8,30,4,542,554,215,-339
2018,8,30,5,484,502,208,-294
2018,8,30,6,458,467,202,-265
2018,8,30,7,439,448,182,-266
2018,8,30,8,432,438,184,-254
2018,8,30,9,435,438,182,-256
2018,8,30,10,469,469,184,-285
2018,8,30,11,543,525,206,-319
2018,8,30,12,570,552,208,-344
2018,8,30,13,587,575,211,-364
2018,8,30,14,611,610,210,-400
2018,8,30,15,643,646,223,-423
2018,8,30,16,681,696,265,-431
2018,8,30,17,713,727,279,-448
2018,8,30,18,737,766,328,-438
2018,8,30,19,756,775,394,-381
2018,8,30,20,762,768,469,-299
2018,8,30,21,756,756,498,-258
2018,8,30,22,759,744,497,-247
2018,8,30,23,742,732,478,-254
2018,8,31,0,719,717,408,-309
2018,8,31,1,712,705,410,-295
2018,8,31,2,674,664,314,-350
2018,8,31,3,608,602,172,-430
2018,8,31,4,536,535,136,-399
2018,8,31,5,481,491,119,-372
2018,8,31,6,450,464,115,-349
2018,8,31,7,435,440,117,-323
2018,8,31,8,424,433,118,-315
2018,8,31,9,427,432,118,-314
2018,8,31,10,456,456,119,-337
2018,8,31,11,522,517,120,-397
2018,8,31,12,553,544,119,-425
2018,8,31,13,571,565,119,-446
2018,8,31,14,598,585,120,-465
2018,8,31,15,624,617,123,-494
2018,8,31,16,658,649,140,-509
2018,8,31,17,688,679,166,-513
2018,8,31,18,698,704,192,-512
2018,8,31,19,708,720,242,-478
2018,8,31,20,720,726,277,-449
2018,8,31,21,735,746,384,-362
2018,8,31,22,727,751,365,-386
2018,8,31,23,707,730,335,-395
2018,9,1,0,678,697,316,-381
2018,9,1,1,666,672,220,-452
2018,9,1,2,627,639,142,-497
2018,9,1,3,575,591,128,-463
2018,9,1,4,521,536,128,-408
2018,9,1,5,482,485,127,-358
2018,9,1,6,445,453,127,-326
2018,9,1,7,423,433,128,-305
2018,9,1,8,412,418,127,-291
2018,9,1,9,408,419,130,-289
2018,9,1,10,416,419,125,-294
2018,9,1,11,441,437,123,-314
2018,9,1,12,464,462,122,-340
2018,9,1,13,510,495,119,-376
2018,9,1,14,547,543,120,-423
2018,9,1,15,586,584,121,-463
2018,9,1,16,613,624,167,-457
2018,9,1,17,645,662,200,-462
2018,9,1,18,662,695,284,-411
2018,9,1,19,667,720,392,-328
2018,9,1,20,675,744,394,-350
2018,9,1,21,682,758,343,-415
2018,9,1,22,684,764,340,-424
2018,9,1,23,677,746,339,-407
2018,9,2,0,652,715,277,-438
2018,9,2,1,639,686,173,-513
2018,9,2,2,602,643,125,-518
2018,9,2,3,552,591,125,-466
2018,9,2,4,503,535,122,-413
2018,9,2,5,442,487,119,-368
2018,9,2,6,417,457,115,-342
2018,9,2,7,400,437,112,-325
2018,9,2,8,390,425,110,-315
2018,9,2,9,381,424,110,-314
2018,9,2,10,386,429,109,-320
2018,9,2,11,402,447,115,-332
2018,9,2,12,430,468,111,-357
2018,9,2,13,472,522,114,-408
2018,9,2,14,508,570,155,-415
2018,9,2,15,534,608,135,-473
2018,9,2,16,561,642,168,-474
2018,9,2,17,601,678,184,-494
2018,9,2,18,614,698,180,-518
2018,9,2,19,633,707,183,-524
2018,9,2,20,644,712,184,-528
2018,9,2,21,652,726,187,-539
2018,9,2,22,663,730,187,-543
2018,9,2,23,648,699,145,-554
2018,9,3,0,625,667,122,-545
2018,9,3,1,608,651,121,-530
2018,9,3,2,577,619,124,-495
2018,9,3,3,535,572,120,-452
2018,9,3,4,487,528,116,-412
2018,9,3,5,477,482,112,-370
2018,9,3,6,450,455,115,-340
2018,9,3,7,434,436,114,-322
2018,9,3,8,423,428,114,-314
2018,9,3,9,420,419,115,-304
2018,9,3,10,433,426,115,-311
2018,9,3,11,446,448,116,-332
2018,9,3,12,466,462,113,-349
2018,9,3,13,506,508,117,-391
2018,9,3,14,550,560,115,-445
2018,9,3,15,594,611,118,-493
2018,9,3,16,631,647,116,-531
2018,9,3,17,674,683,125,-558
2018,9,3,18,694,711,158,-553
2018,9,3,19,712,729,248,-481
2018,9,3,20,730,750,367,-383
2018,9,3,21,748,773,398,-375
2018,9,3,22,751,780,405,-375
2018,9,3,23,740,769,411,-358
2018,9,4,0,726,733,386,-347
2018,9,4,1,719,713,341,-372
2018,9,4,2,667,664,337,-327
2018,9,4,3,594,605,242,-363
2018,9,4,4,536,535,145,-390
2018,9,4,5,484,487,110,-377
2018,9,4,6,453,456,108,-348
2018,9,4,7,435,435,108,-327
2018,9,4,8,423,429,109,-320
2018,9,4,9,424,429,108,-321
2018,9,4,10,452,458,110,-348
2018,9,4,11,530,523,141,-382
2018,9,4,12,564,553,161,-392
2018,9,4,13,589,573,138,-435
2018,9,4,14,610,603,141,-462
2018,9,4,15,657,645,144,-501
2018,9,4,16,695,677,143,-534
2018,9,4,17,719,709,152,-557
2018,9,4,18,759,736,247,-489
2018,9,4,19,779,763,284,-479
2018,9,4,20,793,781,326,-455
2018,9,4,21,801,802,387,-415
2018,9,4,22,814,816,365,-451
2018,9,4,23,806,798,342,-456
2018,9,5,0,774,770,295,-475
2018,9,5,1,767,751,310,-441
2018,9,5,2,707,697,206,-491
2018,9,5,3,628,625,155,-470
2018,9,5,4,566,559,127,-432
2018,9,5,5,511,512,122,-390
2018,9,5,6,477,483,115,-368
2018,9,5,7,460,465,118,-347
2018,9,5,8,445,455,116,-339
2018,9,5,9,446,450,114,-336
2018,9,5,10,471,483,117,-366
2018,9,5,11,540,541,116,-425
2018,9,5,12,571,569,111,-458
2018,9,5,13,592,586,111,-475
2018,9,5,14,611,617,113,-504
2018,9,5,15,651,649,112,-537
2018,9,5,16,691,685,123,-562
2018,9,5,17,715,707,149,-558
2018,9,5,18,743,734,239,-495
2018,9,5,19,768,758,252,-506
2018,9,5,20,799,756,247,-509
2018,9,5,21,806,767,284,-483
2018,9,5,22,813,765,300,-465
2018,9,5,23,793,753,297,-456
2018,9,6,0,754,736,289,-447
2018,9,6,1,747,727,279,-448
2018,9,6,2,690,682,275,-407
2018,9,6,3,617,623,203,-420
2018,9,6,4,558,556,118,-438
2018,9,6,5,498,504,115,-389
2018,9,6,6,467,479,108,-371
2018,9,6,7,449,459,106,-353
2018,9,6,8,437,452,105,-347
2018,9,6,9,442,452,107,-345
2018,9,6,10,468,476,107,-369
2018,9,6,11,533,538,104,-434
2018,9,6,12,560,569,106,-463
2018,9,6,13,580,585,104,-481
2018,9,6,14,606,610,105,-505
2018,9,6,15,639,650,118,-532
2018,9,6,16,672,687,162,-525
2018,9,6,17,698,713,193,-520
2018,9,6,18,727,746,270,-476
2018,9,6,19,748,772,293,-479
2018,9,6,20,760,791,305,-486
2018,9,6,21,774,800,330,-470
2018,9,6,22,776,797,344,-453
2018,9,6,23,760,789,345,-444
2018,9,7,0,729,755,343,-412
2018,9,7,1,732,735,343,-392
2018,9,7,2,684,688,345,-343
2018,9,7,3,614,619,322,-297
2018,9,7,4,556,554,186,-368
2018,9,7,5,490,497,124,-373
2018,9,7,6,460,465,123,-342
2018,9,7,7,442,445,123,-322
2018,9,7,8,429,435,124,-311
2018,9,7,9,432,433,123,-310
2018,9,7,10,457,457,121,-336
2018,9,7,11,520,518,124,-394
2018,9,7,12,546,540,123,-417
2018,9,7,13,570,558,124,-434
2018,9,7,14,588,584,124,-460
2018,9,7,15,623,620,124,-496
2018,9,7,16,654,661,148,-513
2018,9,7,17,685,696,201,-495
2018,9,7,18,713,723,274,-449
2018,9,7,19,736,746,292,-454
2018,9,7,20,758,758,290,-468
2018,9,7,21,767,779,292,-487
2018,9,7,22,765,780,289,-491
2018,9,7,23,743,757,313,-444
2018,9,8,0,704,725,279,-446
2018,9,8,1,694,698,233,-465
2018,9,8,2,649,651,226,-425
2018,9,8,3,595,601,219,-382
2018,9,8,4,541,546,147,-399
2018,9,8,5,504,496,120,-376
2018,9,8,6,469,460,118,-342
2018,9,8,7,445,440,122,-318
2018,9,8,8,432,433,124,-309
2018,9,8,9,427,423,121,-302
2018,9,8,10,437,433,123,-310
2018,9,8,11,459,450,124,-326
2018,9,8,12,484,469,122,-347
2018,9,8,13,521,508,120,-388
2018,9,8,14,558,550,127,-423
2018,9,8,15,591,593,130,-463
2018,9,8,16,626,636,156,-480
2018,9,8,17,667,671,162,-509
2018,9,8,18,691,699,211,-488
2018,9,8,19,706,705,308,-397
2018,9,8,20,723,717,321,-396
2018,9,8,21,734,710,342,-368
2018,9,8,22,728,697,430,-267
2018,9,8,23,714,675,444,-231
2018,9,9,0,686,659,397,-262
2018,9,9,1,662,649,397,-252
2018,9,9,2,624,614,397,-217
2018,9,9,3,573,566,363,-203
2018,9,9,4,521,529,250,-279
2018,9,9,5,467,481,134,-347
2018,9,9,6,439,448,118,-330
2018,9,9,7,422,430,119,-311
2018,9,9,8,407,422,118,-304
2018,9,9,9,402,415,119,-296
2018,9,9,10,408,420,118,-302
2018,9,9,11,425,437,119,-318
2018,9,9,12,448,459,119,-340
2018,9,9,13,492,508,121,-387
2018,9,9,14,530,549,120,-429
2018,9,9,15,558,589,119,-470
2018,9,9,16,586,621,125,-496
2018,9,9,17,623,658,149,-509
2018,9,9,18,643,686,215,-471
2018,9,9,19,654,695,160,-535
2018,9,9,20,660,718,215,-503
2018,9,9,21,669,734,214,-520
2018,9,9,22,677,732,215,-517
2018,9,9,23,667,713,212,-501
2018,9,10,0,656,700,225,-475
2018,9,10,1,651,684,280,-404
2018,9,10,2,607,640,282,-358
2018,9,10,3,554,594,183,-411
2018,9,10,4,500,531,119,-412
2018,9,10,5,450,490,118,-372
2018,9,10,6,422,462,119,-343
2018,9,10,7,408,448,119,-329
2018,9,10,8,401,438,119,-319
2018,9,10,9,405,438,119,-319
2018,9,10,10,436,462,169,-293
2018,9,10,11,511,528,214,-314
2018,9,10,12,537,558,220,-338
2018,9,10,13,552,581,220,-361
2018,9,10,14,572,621,157,-464
2018,9,10,15,605,643,126,-517
2018,9,10,16,638,676,126,-550
2018,9,10,17,659,708,187,-521
2018,9,10,18,680,724,194,-530
2018,9,10,19,692,729,201,-528
2018,9,10,20,709,727,205,-522
2018,9,10,21,719,704,202,-502
2018,9,10,22,723,695,192,-503
2018,9,10,23,707,681,173,-508
2018,9,11,0,686,678,175,-503
2018,9,11,1,691,663,172,-491
2018,9,11,2,633,626,172,-454
2018,9,11,3,570,576,175,-401
2018,9,11,4,508,522,144,-378
2018,9,11,5,466,481,119,-362
2018,9,11,6,441,459,118,-341
2018,9,11,7,426,447,115,-332
2018,9,11,8,420,440,116,-324
2018,9,11,9,420,436,116,-320
2018,9,11,10,455,465,115,-350
2018,9,11,11,521,529,116,-413
2018,9,11,12,552,559,116,-443
2018,9,11,13,565,572,116,-456
2018,9,11,14,579,590,115,-475
2018,9,11,15,607,615,163,-452
2018,9,11,16,640,643,184,-459
2018,9,11,17,662,670,208,-462
2018,9,11,18,687,693,315,-378
2018,9,11,19,702,684,323,-361
2018,9,11,20,721,684,396,-288
2018,9,11,21,735,699,434,-265
2018,9,11,22,743,691,393,-298
2018,9,11,23,729,686,417,-269
2018,9,12,0,713,686,422,-264
2018,9,12,1,711,687,403,-284
2018,9,12,2,655,643,366,-277
2018,9,12,3,587,591,304,-287
2018,9,12,4,527,533,182,-351
2018,9,12,5,467,484,131,-353
2018,9,12,6,444,466,138,-328
2018,9,12,7,427,445,138,-307
2018,9,12,8,422,439,134,-305
2018,9,12,9,422,439,130,-309
2018,9,12,10,455,473,130,-343
2018,9,12,11,520,531,129,-402
2018,9,12,12,545,573,130,-443
2018,9,12,13,559,580,120,-460
2018,9,12,14,580,600,185,-415
2018,9,12,15,614,633,190,-443
2018,9,12,16,644,652,187,-465
2018,9,12,17,665,686,191,-495
2018,9,12,18,690,709,221,-488
2018,9,12,19,705,737,249,-488
2018,9,12,20,724,749,307,-442
2018,9,12,21,743,770,418,-352
2018,9,12,22,752,776,449,-327
2018,9,12,23,736,756,448,-308
2018,9,13,0,717,733,451,-282
2018,9,13,1,713,716,449,-267
2018,9,13,2,654,678,447,-231
2018,9,13,3,589,621,345,-276
2018,9,13,4,529,559,212,-347
2018,9,13,5,466,505,140,-365
2018,9,13,6,436,470,111,-359
2018,9,13,7,419,454,113,-341
2018,9,13,8,409,447,113,-334
2018,9,13,9,411,455,115,-340
2018,9,13,10,448,475,159,-316
2018,9,13,11,527,542,194,-348
2018,9,13,12,557,577,193,-384
2018,9,13,13,574,590,193,-397
2018,9,13,14,592,614,195,-419
2018,9,13,15,628,642,135,-507
2018,9,13,16,663,678,135,-543
2018,9,13,17,682,710,150,-560
2018,9,13,18,706,747,212,-535
2018,9,13,19,720,762,296,-466
2018,9,13,20,734,769,299,-470
2018,9,13,21,749,772,300,-472
2018,9,13,22,754,772,297,-475
2018,9,13,23,734,763,255,-508
2018,9,14,0,713,745,239,-506
2018,9,14,1,715,725,233,-492
2018,9,14,2,648,671,231,-440
2018,9,14,3,585,612,207,-405
2018,9,14,4,517,552,193,-359
2018,9,14,5,467,504,161,-343
2018,9,14,6,436,474,160,-314
2018,9,14,7,417,459,149,-310
2018,9,14,8,405,449,115,-334
2018,9,14,9,409,453,114,-339
2018,9,14,10,440,475,110,-365
2018,9,14,11,510,537,111,-426
2018,9,14,12,540,565,111,-454
2018,9,14,13,559,569,111,-458
2018,9,14,14,572,593,111,-482
2018,9,14,15,608,630,122,-508
2018,9,14,16,639,665,150,-515
2018,9,14,17,663,690,185,-505
2018,9,14,18,690,725,260,-465
2018,9,14,19,712,755,270,-485
2018,9,14,20,734,768,267,-501
2018,9,14,21,750,771,268,-503
2018,9,14,22,752,768,245,-523
2018,9,14,23,730,745,231,-514
2018,9,15,0,695,714,193,-521
2018,9,15,1,683,698,183,-515
2018,9,15,2,628,658,185,-473
2018,9,15,3,576,610,188,-422
2018,9,15,4,519,555,185,-370
2018,9,15,5,470,512,187,-325
2018,9,15,6,446,483,185,-298
2018,9,15,7,428,465,179,-286
2018,9,15,8,419,455,130,-325
2018,9,15,9,414,445,121,-324
2018,9,15,10,422,452,120,-332
2018,9,15,11,449,469,119,-350
2018,9,15,12,469,491,117,-374
2018,9,15,13,502,527,119,-408
2018,9,15,14,526,565,119,-446
2018,9,15,15,552,590,123,-467
2018,9,15,16,578,612,126,-486
2018,9,15,17,616,624,130,-494
2018,9,15,18,637,620,139,-481
2018,9,15,19,652,617,195,-422
2018,9,15,20,668,618,210,-408
2018,9,15,21,687,617,225,-392
2018,9,15,22,690,623,240,-383
2018,9,15,23,676,617,260,-357
2018,9,16,0,660,611,268,-343
2018,9,16,1,645,610,246,-364
2018,9,16,2,595,582,176,-406
2018,9,16,3,556,532,123,-409
2018,9,16,4,502,495,126,-369
2018,9,16,5,423,453,121,-332
2018,9,16,6,400,429,126,-303
2018,9,16,7,390,410,123,-287
2018,9,16,8,378,404,125,-279
2018,9,16,9,374,401,125,-276
2018,9,16,10,393,405,124,-281
2018,9,16,11,400,417,124,-293
2018,9,16,12,423,444,126,-318
2018,9,16,13,465,482,124,-358
2018,9,16,14,492,517,124,-393
2018,9,16,15,502,521,130,-391
2018,9,16,16,522,509,190,-319
2018,9,16,17,540,536,190,-346
2018,9,16,18,546,536,187,-349
2018,9,16,19,554,538,185,-353
2018,9,16,20,559,540,184,-356
2018,9,16,21,570,545,181,-364
2018,9,16,22,572,559,181,-378
2018,9,16,23,572,564,182,-382
2018,9,17,0,577,571,184,-387
2018,9,17,1,579,566,179,-387
2018,9,17,2,534,539,179,-360
2018,9,17,3,490,502,179,-323
2018,9,17,4,455,465,180,-285
2018,9,17,5,416,427,177,-250
2018,9,17,6,393,411,178,-233
2018,9,17,7,382,402,179,-223
2018,9,17,8,375,396,179,-217
2018,9,17,9,384,404,178,-226
2018,9,17,10,415,430,179,-251
2018,9,17,11,490,484,180,-304
2018,9,17,12,516,526,179,-347
2018,9,17,13,527,562,178,-384
2018,9,17,14,543,582,184,-398
2018,9,17,15,566,608,188,-420
2018,9,17,16,592,638,189,-449
2018,9,17,17,607,655,230,-425
2018,9,17,18,620,667,320,-347
2018,9,17,19,625,682,406,-276
2018,9,17,20,640,683,450,-233
2018,9,17,21,653,686,454,-232
2018,9,17,22,656,691,455,-236
2018,9,17,23,651,682,451,-231
2018,9,18,0,647,672,452,-220
2018,9,18,1,649,662,452,-210
2018,9,18,2,598,623,438,-185
2018,9,18,3,541,573,278,-295
2018,9,18,4,487,513,185,-328
2018,9,18,5,445,469,178,-291
2018,9,18,6,426,451,182,-269
2018,9,18,7,413,431,181,-250
2018,9,18,8,405,425,181,-244
2018,9,18,9,408,430,179,-251
2018,9,18,10,443,455,180,-275
2018,9,18,11,510,513,180,-333
2018,9,18,12,539,548,180,-368
2018,9,18,13,551,566,180,-386
2018,9,18,14,564,583,181,-402
2018,9,18,15,585,601,203,-398
2018,9,18,16,610,627,238,-389
2018,9,18,17,627,629,316,-313
2018,9,18,18,648,660,443,-217
2018,9,18,19,657,672,451,-221
2018,9,18,20,673,691,452,-239
2018,9,18,21,683,704,448,-256
2018,9,18,22,685,719,448,-271
2018,9,18,23,674,708,447,-261
2018,9,19,0,664,686,446,-240
2018,9,19,1,663,677,390,-287
2018,9,19,2,614,629,247,-382
2018,9,19,3,550,558,180,-378
2018,9,19,4,497,498,182,-316
2018,9,19,5,453,456,180,-276
2018,9,19,6,429,433,180,-253
2018,9,19,7,414,419,184,-235
2018,9,19,8,406,408,183,-225
2018,9,19,9,407,410,183,-227
2018,9,19,10,440,438,182,-256
2018,9,19,11,499,498,183,-315
2018,9,19,12,532,525,211,-314
2018,9,19,13,545,538,300,-238
2018,9,19,14,564,555,316,-239
2018,9,19,15,584,582,318,-264
2018,9,19,16,610,615,317,-298
2018,9,19,17,632,645,326,-319
2018,9,19,18,663,675,407,-268
2018,9,19,19,681,703,445,-258
2018,9,19,20,700,725,450,-275
2018,9,19,21,713,744,451,-293
2018,9,19,22,719,747,450,-297
2018,9,19,23,707,729,447,-282
2018,9,20,0,694,708,450,-258
2018,9,20,1,680,690,447,-243
2018,9,20,2,631,645,439,-206
2018,9,20,3,568,588,379,-209
2018,9,20,4,506,535,271,-264
2018,9,20,5,459,476,181,-295
2018,9,20,6,434,448,133,-315
2018,9,20,7,421,432,117,-315
2018,9,20,8,413,423,116,-307
2018,9,20,9,414,429,119,-310
2018,9,20,10,446,449,116,-333
2018,9,20,11,508,507,116,-391
2018,9,20,12,540,524,124,-400
2018,9,20,13,550,548,241,-307
2018,9,20,14,572,565,307,-258
2018,9,20,15,588,609,397,-212
2018,9,20,16,611,647,403,-244
2018,9,20,17,637,684,417,-267
2018,9,20,18,670,718,446,-272
2018,9,20,19,687,737,419,-318
2018,9,20,20,698,752,412,-340
2018,9,20,21,707,761,446,-315
2018,9,20,22,703,760,446,-314
2018,9,20,23,690,744,445,-299
2018,9,21,0,678,732,449,-283
2018,9,21,1,666,713,419,-294
2018,9,21,2,620,667,417,-250
2018,9,21,3,562,615,347,-268
2018,9,21,4,502,546,176,-370
2018,9,21,5,472,497,129,-368
2018,9,21,6,446,467,130,-337
2018,9,21,7,431,446,129,-317
2018,9,21,8,420,435,128,-307
2018,9,21,9,424,437,125,-312
2018,9,21,10,446,458,125,-333
2018,9,21,11,508,517,126,-391
2018,9,21,12,537,544,119,-425
2018,9,21,13,551,560,114,-446
2018,9,21,14,570,586,116,-470
2018,9,21,15,595,619,136,-483
2018,9,21,16,627,642,214,-428
2018,9,21,17,652,677,388,-289
2018,9,21,18,671,713,400,-313
2018,9,21,19,687,729,410,-319
2018,9,21,20,690,752,449,-303
2018,9,21,21,700,767,451,-316
2018,9,21,22,697,751,447,-304
2018,9,21,23,673,724,451,-273
2018,9,22,0,648,694,368,-326
2018,9,22,1,632,675,293,-382
2018,9,22,2,591,632,143,-489
2018,9,22,3,547,582,119,-463
2018,9,22,4,496,533,120,-413
2018,9,22,5,469,485,119,-366
2018,9,22,6,439,454,117,-337
2018,9,22,7,418,433,122,-311
2018,9,22,8,408,418,119,-299
2018,9,22,9,403,412,119,-293
2018,9,22,10,410,422,120,-302
2018,9,22,11,436,439,119,-320
2018,9,22,12,460,458,120,-338
2018,9,22,13,496,491,142,-349
2018,9,22,14,532,527,152,-375
2018,9,22,15,558,568,151,-417
2018,9,22,16,576,594,176,-418
2018,9,22,17,605,625,266,-359
2018,9,22,18,627,657,395,-262
2018,9,22,19,648,689,441,-248
2018,9,22,20,656,710,442,-268
2018,9,22,21,674,722,443,-279
2018,9,22,22,678,721,445,-276
2018,9,22,23,669,698,446,-252
2018,9,23,0,643,671,428,-243
2018,9,23,1,628,649,366,-283
2018,9,23,2,589,615,307,-308
2018,9,23,3,536,568,190,-378
2018,9,23,4,498,514,124,-390
2018,9,23,5,457,469,118,-351
2018,9,23,6,432,444,117,-327
2018,9,23,7,415,423,116,-307
2018,9,23,8,405,412,118,-294
2018,9,23,9,401,403,114,-289
2018,9,23,10,409,411,117,-294
2018,9,23,11,421,424,116,-308
2018,9,23,12,444,444,113,-331
2018,9,23,13,487,486,142,-344
2018,9,23,14,523,514,146,-368
2018,9,23,15,536,544,148,-396
2018,9,23,16,552,573,161,-412
2018,9,23,17,576,608,198,-410
2018,9,23,18,582,634,228,-406
2018,9,23,19,580,636,229,-407
2018,9,23,20,589,638,229,-409
2018,9,23,21,598,637,279,-358
2018,9,23,22,605,655,305,-350
2018,9,23,23,607,648,304,-344
2018,9,24,0,603,642,319,-323
2018,9,24,1,596,634,288,-346
2018,9,24,2,561,596,210,-386
2018,9,24,3,510,546,139,-407
2018,9,24,4,462,490,122,-368
2018,9,24,5,415,450,122,-328
2018,9,24,6,393,431,121,-310
2018,9,24,7,383,418,123,-295
2018,9,24,8,377,408,121,-287
2018,9,24,9,382,414,123,-291
2018,9,24,10,414,442,123,-319
2018,9,24,11,487,503,151,-352
2018,9,24,12,516,528,239,-289
2018,9,24,13,528,547,267,-280
2018,9,24,14,542,572,287,-285
2018,9,24,15,556,591,286,-305
2018,9,24,16,577,603,289,-314
2018,9,24,17,591,609,296,-313
2018,9,24,18,599,616,355,-261
2018,9,24,19,601,610,363,-247
2018,9,24,20,604,603,336,-267
2018,9,24,21,611,596,308,-288
2018,9,24,22,612,602,356,-246
2018,9,24,23,610,608,361,-247
2018,9,25,0,614,610,368,-242
2018,9,25,1,612,610,385,-225
2018,9,25,2,563,574,233,-341
2018,9,25,3,509,521,128,-393
2018,9,25,4,462,475,112,-363
2018,9,25,5,432,432,112,-9999
2018,9,25,6,411,411,121,-9999
2018,9,25,7,402,402,123,-9999
2018,9,25,8,395,395,121,-9999
2018,9,25,9,401,401,123,-9999
2018,9,25,10,432,432,123,-9999
2018,9,25,11,496,496,151,-9999
2018,9,25,12,528,528,239,-9999
2018,9,25,13,539,539,267,-9999
2018,9,25,14,555,555,287,-9999
2018,9,25,15,578,578,286,-9999
2018,9,25,16,601,601,289,-9999
2018,9,25,17,623,623,296,-9999
2018,9,25,18,646,646,355,-9999
2018,9,25,19,659,659,363,-9999
2018,9,25,20,668,668,336,-9999
2018,9,25,21,679,679,308,-9999
2018,9,25,22,683,683,356,-9999
2018,9,25,23,674,674,361,-9999
2018,9,26,0,673,673,368,-9999
2018,9,26,1,664,664,385,-9999
2018,9,26,2,615,615,233,-9999
2018,9,26,3,553,553,128,-9999
2018,9,26,4,500,500,112,-9999
2018,9,26,5,-9999,455,114,-341
2018,9,26,6,-9999,431,115,-316
2018,9,26,7,-9999,420,116,-304
2018,9,26,8,-9999,411,114,-297
2018,9,26,9,-9999,418,114,-304
2018,9,26,10,-9999,447,114,-333
2018,9,26,11,-9999,506,132,-374
2018,9,26,12,-9999,536,220,-316
2018,9,26,13,-9999,556,248,-308
2018,9,26,14,-9999,587,264,-323
2018,9,26,15,-9999,604,306,-298
2018,9,26,16,-9999,622,320,-302
2018,9,26,17,-9999,591,437,-154
2018,9,26,18,-9999,594,448,-146
2018,9,26,19,-9999,649,449,-200
2018,9,26,20,-9999,640,449,-191
2018,9,26,21,-9999,642,450,-192
2018,9,26,22,-9999,639,450,-189
2018,9,26,23,-9999,629,454,-175
2018,9,27,0,-9999,639,451,-188
2018,9,27,1,-9999,632,452,-180
2018,9,27,2,-9999,593,449,-144
2018,9,27,3,-9999,546,450,-96
2018,9,27,4,-9999,503,391,-112
2018,9,27,5,443,459,200,-259
2018,9,27,6,416,433,129,-304
2018,9,27,7,401,425,121,-304
2018,9,27,8,392,414,119,-295
2018,9,27,9,398,427,122,-305
2018,9,27,10,428,451,121,-330
2018,9,27,11,496,509,145,-364
2018,9,27,12,532,548,326,-222
2018,9,27,13,545,566,340,-226
2018,9,27,14,558,573,318,-255
2018,9,27,15,581,589,318,-271
2018,9,27,16,601,598,296,-302
2018,9,27,17,606,607,317,-290
2018,9,27,18,617,617,343,-274
2018,9,27,19,617,625,366,-259
2018,9,27,20,619,621,402,-219
2018,9,27,21,628,618,377,-241
2018,9,27,22,628,622,330,-292
2018,9,27,23,619,617,326,-291
2018,9,28,0,624,633,332,-301
2018,9,28,1,612,620,278,-342
2018,9,28,2,579,590,263,-327
2018,9,28,3,523,544,178,-366
2018,9,28,4,473,492,119,-373
2018,9,28,5,445,459,134,-325
2018,9,28,6,422,438,146,-292
2018,9,28,7,405,423,146,-277
2018,9,28,8,394,419,145,-274
2018,9,28,9,398,425,148,-277
2018,9,28,10,424,450,174,-276
2018,9,28,11,484,509,183,-326
2018,9,28,12,517,537,214,-323
2018,9,28,13,531,552,215,-337
2018,9,28,14,546,572,201,-371
2018,9,28,15,565,584,201,-383
2018,9,28,16,591,601,202,-399
2018,9,28,17,605,611,204,-407
2018,9,28,18,622,627,204,-423
2018,9,28,19,632,636,219,-417
2018,9,28,20,636,649,406,-243
2018,9,28,21,645,666,451,-215
2018,9,28,22,644,666,452,-214
2018,9,28,23,624,649,455,-194
2018,9,29,0,611,628,449,-179
2018,9,29,1,599,614,451,-163
2018,9,29,2,557,580,404,-176
2018,9,29,3,517,542,305,-237
2018,9,29,4,466,494,197,-297
2018,9,29,5,436,448,129,-319
2018,9,29,6,412,420,125,-295
2018,9,29,7,392,405,136,-269
2018,9,29,8,385,393,130,-263
2018,9,29,9,383,393,126,-267
2018,9,29,10,391,396,124,-272
2018,9,29,11,417,428,192,-236
2018,9,29,12,442,452,191,-261
2018,9,29,13,474,485,191,-294
2018,9,29,14,506,512,192,-320
2018,9,29,15,529,536,141,-395
2018,9,29,16,534,563,128,-435
2018,9,29,17,546,579,135,-444
2018,9,29,18,558,606,241,-365
2018,9,29,19,566,627,257,-370
2018,9,29,20,581,634,352,-282
2018,9,29,21,586,651,430,-221
2018,9,29,22,591,649,433,-216
2018,9,29,23,588,634,411,-223
2018,9,30,0,574,623,327,-296
2018,9,30,1,568,610,279,-331
2018,9,30,2,529,581,202,-379
2018,9,30,3,488,534,132,-402
2018,9,30,4,452,486,127,-359
2018,9,30,5,411,448,131,-317
2018,9,30,6,388,422,129,-293
2018,9,30,7,376,413,125,-288
2018,9,30,8,366,405,120,-285
2018,9,30,9,365,402,118,-284
2018,9,30,10,376,412,120,-292
2018,9,30,11,392,425,183,-242
2018,9,30,12,417,449,182,-267
2018,9,30,13,458,487,183,-304
2018,9,30,14,486,520,134,-386
2018,9,30,15,494,538,120,-418
2018,9,30,16,496,547,120,-427
2018,9,30,17,510,553,139,-414
2018,9,30,18,519,552,163,-389
2018,9,30,19,522,557,260,-297
2018,9,30,20,529,561,267,-294
2018,9,30,21,539,562,395,-167
2018,9,30,22,555,577,439,-138
2018,9,30,23,559,583,446,-137
2018,10,1,0,572,600,443,-157
2018,10,1,1,562,592,443,-149
2018,10,1,2,520,564,399,-165
2018,10,1,3,478,526,289,-237
2018,10,1,4,436,474,168,-306
2018,10,1,5,417,434,126,-308
2018,10,1,6,396,417,124,-293
2018,10,1,7,386,406,126,-280
2018,10,1,8,380,398,124,-274
2018,10,1,9,387,405,125,-280
2018,10,1,10,420,432,128,-304
2018,10,1,11,485,493,189,-304
2018,10,1,12,521,524,194,-330
2018,10,1,13,529,541,195,-346
2018,10,1,14,537,560,195,-365
2018,10,1,15,557,579,166,-413
2018,10,1,16,570,601,224,-377
2018,10,1,17,587,622,258,-364
2018,10,1,18,601,636,316,-320
2018,10,1,19,610,657,380,-277
2018,10,1,20,618,668,426,-242
2018,10,1,21,632,680,446,-234
2018,10,1,22,633,673,445,-228
2018,10,1,23,629,667,442,-225
2018,10,2,0,639,663,431,-232
2018,10,2,1,629,648,351,-297
2018,10,2,2,584,611,268,-343
2018,10,2,3,526,545,137,-408
2018,10,2,4,472,487,116,-371
2018,10,2,5,432,447,116,-331
2018,10,2,6,413,426,112,-314
2018,10,2,7,403,413,112,-301
2018,10,2,8,395,408,110,-298
2018,10,2,9,401,409,111,-298
2018,10,2,10,434,441,111,-330
2018,10,2,11,494,500,161,-339
2018,10,2,12,531,525,186,-339
2018,10,2,13,537,537,186,-351
2018,10,2,14,543,550,189,-361
2018,10,2,15,555,540,178,-362
2018,10,2,16,572,583,147,-436
2018,10,2,17,589,593,197,-396
2018,10,2,18,603,626,248,-378
2018,10,2,19,612,646,254,-392
2018,10,2,20,626,648,381,-267
2018,10,2,21,642,652,435,-217
2018,10,2,22,639,648,441,-207
2018,10,2,23,633,649,441,-208
2018,10,3,0,646,653,406,-247
2018,10,3,1,633,638,375,-263
2018,10,3,2,586,606,305,-301
2018,10,3,3,530,548,153,-395
2018,10,3,4,479,485,119,-366
2018,10,3,5,464,450,119,-331
2018,10,3,6,441,423,116,-307
2018,10,3,7,427,412,120,-292
2018,10,3,8,420,411,121,-290
2018,10,3,9,424,410,119,-291
2018,10,3,10,458,440,119,-321
2018,10,3,11,520,497,145,-352
2018,10,3,12,559,535,214,-321
2018,10,3,13,568,545,218,-327
2018,10,3,14,582,559,217,-342
2018,10,3,15,605,576,202,-374
2018,10,3,16,621,605,219,-386
2018,10,3,17,642,631,285,-346
2018,10,3,18,662,658,368,-290
2018,10,3,19,677,675,382,-293
2018,10,3,20,689,683,390,-293
2018,10,3,21,702,698,449,-249
2018,10,3,22,708,698,448,-250
2018,10,3,23,700,684,447,-237
2018,10,4,0,710,688,438,-250
2018,10,4,1,695,666,409,-257
2018,10,4,2,641,633,294,-339
2018,10,4,3,582,567,162,-405
2018,10,4,4,521,502,122,-380
2018,10,4,5,466,465,118,-347
2018,10,4,6,440,437,118,-319
2018,10,4,7,424,423,119,-304
2018,10,4,8,415,417,118,-299
2018,10,4,9,418,420,120,-300
2018,10,4,10,451,445,119,-326
2018,10,4,11,521,509,178,-331
2018,10,4,12,557,541,169,-372
2018,10,4,13,566,550,123,-427
2018,10,4,14,590,558,136,-422
2018,10,4,15,618,575,235,-340
2018,10,4,16,641,614,360,-254
2018,10,4,17,665,644,380,-264
2018,10,4,18,695,675,383,-292
2018,10,4,19,710,697,445,-252
2018,10,4,20,722,717,449,-268
2018,10,4,21,730,723,449,-274
2018,10,4,22,727,720,448,-272
2018,10,4,23,710,705,447,-258
2018,10,5,0,715,693,420,-273
2018,10,5,1,695,674,367,-307
2018,10,5,2,642,630,338,-292
2018,10,5,3,584,573,241,-332
2018,10,5,4,514,515,180,-335
2018,10,5,5,486,464,130,-334
2018,10,5,6,454,437,112,-325
2018,10,5,7,439,424,112,-312
2018,10,5,8,426,412,110,-302
2018,10,5,9,431,417,111,-306
2018,10,5,10,465,441,118,-323
2018,10,5,11,528,504,198,-306
2018,10,5,12,569,536,197,-339
2018,10,5,13,582,547,197,-350
2018,10,5,14,603,568,151,-417
2018,10,5,15,631,591,158,-433
2018,10,5,16,657,616,227,-389
2018,10,5,17,685,651,349,-302
2018,10,5,18,710,679,371,-308
2018,10,5,19,723,703,385,-318
2018,10,5,20,732,716,386,-330
2018,10,5,21,734,726,431,-295
2018,10,5,22,726,723,456,-267
2018,10,5,23,694,693,453,-240
2018,10,6,0,693,670,452,-218
2018,10,6,1,672,646,435,-211
2018,10,6,2,628,609,387,-222
2018,10,6,3,581,562,385,-177
2018,10,6,4,517,513,385,-128
2018,10,6,5,480,472,382,-90
2018,10,6,6,447,449,246,-203
2018,10,6,7,426,423,156,-267
2018,10,6,8,418,404,137,-267
2018,10,6,9,414,409,139,-270
2018,10,6,10,419,414,138,-276
2018,10,6,11,442,436,139,-297
2018,10,6,12,471,456,139,-317
2018,10,6,13,507,492,146,-346
2018,10,6,14,542,526,158,-368
2018,10,6,15,573,561,234,-327
2018,10,6,16,598,604,263,-341
2018,10,6,17,630,631,304,-327
2018,10,6,18,654,656,368,-288
2018,10,6,19,677,673,415,-258
2018,10,6,20,683,672,417,-255
2018,10,6,21,694,681,446,-235
2018,10,6,22,695,678,446,-232
2018,10,6,23,676,664,445,-219
2018,10,7,0,661,655,445,-210
2018,10,7,1,646,635,420,-215
2018,10,7,2,609,601,380,-221
2018,10,7,3,554,558,343,-215
2018,10,7,4,504,514,229,-285
2018,10,7,5,452,462,146,-316
2018,10,7,6,424,438,130,-308
2018,10,7,7,407,420,133,-287
2018,10,7,8,396,411,132,-279
2018,10,7,9,393,409,131,-278
2018,10,7,10,398,413,131,-282
2018,10,7,11,411,427,131,-296
2018,10,7,12,437,458,132,-326
2018,10,7,13,480,495,131,-364
2018,10,7,14,514,532,131,-401
2018,10,7,15,539,562,134,-428
2018,10,7,16,556,588,136,-452
2018,10,7,17,578,627,152,-475
2018,10,7,18,598,655,205,-450
2018,10,7,19,608,672,294,-378
2018,10,7,20,618,680,395,-285
2018,10,7,21,628,695,434,-261
2018,10,7,22,627,700,440,-260
2018,10,7,23,625,682,447,-235
2018,10,8,0,630,678,452,-226
2018,10,8,1,616,649,447,-202
2018,10,8,2,581,607,370,-237
2018,10,8,3,539,553,324,-229
2018,10,8,4,484,514,252,-262
2018,10,8,5,446,460,136,-324
2018,10,8,6,424,435,127,-308
2018,10,8,7,410,420,126,-294
2018,10,8,8,404,412,126,-286
2018,10,8,9,409,411,125,-286
2018,10,8,10,440,444,126,-318
2018,10,8,11,506,507,133,-374
2018,10,8,12,541,538,163,-375
2018,10,8,13,552,549,192,-357
2018,10,8,14,570,575,267,-308
2018,10,8,15,595,608,296,-312
2018,10,8,16,617,616,280,-336
2018,10,8,17,636,633,286,-347
2018,10,8,18,642,646,293,-353
2018,10,8,19,643,654,375,-279
2018,10,8,20,646,669,416,-253
2018,10,8,21,653,676,449,-227
2018,10,8,22,651,673,446,-227
2018,10,8,23,645,670,446,-224
2018,10,9,0,658,675,448,-227
2018,10,9,1,641,654,448,-206
2018,10,9,2,593,609,396,-213
2018,10,9,3,533,555,371,-184
2018,10,9,4,484,511,274,-237
2018,10,9,5,446,471,174,-297
2018,10,9,6,426,445,128,-317
2018,10,9,7,412,429,123,-306
2018,10,9,8,403,421,121,-300
2018,10,9,9,409,430,123,-307
2018,10,9,10,434,451,122,-329
2018,10,9,11,495,518,124,-394
2018,10,9,12,529,550,151,-399
2018,10,9,13,539,565,152,-413
2018,10,9,14,554,580,150,-430
2018,10,9,15,566,581,211,-370
2018,10,9,16,580,598,253,-345
2018,10,9,17,587,597,267,-330
2018,10,9,18,593,606,375,-231
2018,10,9,19,598,607,410,-197
2018,10,9,20,599,608,409,-199
2018,10,9,21,606,613,440,-173
2018,10,9,22,610,616,443,-173
2018,10,9,23,615,624,449,-175
2018,10,10,0,635,636,450,-186
2018,10,10,1,624,627,450,-177
2018,10,10,2,588,597,358,-239
2018,10,10,3,537,546,211,-335
2018,10,10,4,486,498,127,-371
2018,10,10,5,446,454,116,-338
2018,10,10,6,426,438,116,-322
2018,10,10,7,414,424,118,-306
2018,10,10,8,407,416,117,-299
2018,10,10,9,413,419,118,-301
2018,10,10,10,444,449,117,-332
2018,10,10,11,504,511,136,-375
2018,10,10,12,538,541,191,-350
2018,10,10,13,549,549,282,-267
2018,10,10,14,565,573,361,-212
2018,10,10,15,582,586,384,-202
2018,10,10,16,593,603,384,-219
2018,10,10,17,599,610,384,-226
2018,10,10,18,610,622,387,-235
2018,10,10,19,614,613,415,-198
2018,10,10,20,616,621,418,-203
2018,10,10,21,625,629,450,-179
2018,10,10,22,631,636,449,-187
2018,10,10,23,634,630,454,-176
2018,10,11,0,656,629,456,-173
2018,10,11,1,645,614,431,-183
2018,10,11,2,600,579,373,-206
2018,10,11,3,550,529,357,-172
2018,10,11,4,496,486,260,-226
2018,10,11,5,445,448,162,-286
2018,10,11,6,424,432,153,-279
2018,10,11,7,412,421,155,-266
2018,10,11,8,406,420,182,-238
2018,10,11,9,410,423,189,-234
2018,10,11,10,441,452,190,-262
2018,10,11,11,506,515,190,-325
2018,10,11,12,539,532,195,-337
2018,10,11,13,549,541,344,-197
2018,10,11,14,562,568,427,-141
2018,10,11,15,575,590,441,-149
2018,10,11,16,583,598,424,-174
2018,10,11,17,582,588,413,-175
2018,10,11,18,589,576,435,-141
2018,10,11,19,589,575,440,-135
2018,10,11,20,591,576,428,-148
2018,10,11,21,592,578,352,-226
2018,10,11,22,593,586,279,-307
2018,10,11,23,592,577,226,-351
2018,10,12,0,613,575,185,-390
2018,10,12,1,590,562,179,-383
2018,10,12,2,552,530,180,-350
2018,10,12,3,502,481,182,-299
2018,10,12,4,456,439,181,-258
2018,10,12,5,413,408,179,-229
2018,10,12,6,394,389,181,-208
2018,10,12,7,384,376,180,-196
2018,10,12,8,382,375,183,-192
2018,10,12,9,389,381,184,-197
2018,10,12,10,418,407,184,-223
2018,10,12,11,496,465,186,-279
2018,10,12,12,538,507,185,-322
2018,10,12,13,541,523,191,-332
2018,10,12,14,548,532,193,-339
2018,10,12,15,537,533,195,-338
2018,10,12,16,540,529,196,-333
2018,10,12,17,527,528,191,-337
2018,10,12,18,531,521,196,-325
2018,10,12,19,530,517,196,-321
2018,10,12,20,526,522,197,-325
2018,10,12,21,525,516,205,-311
2018,10,12,22,532,521,261,-260
2018,10,12,23,532,523,266,-257
2018,10,13,0,547,542,264,-278
2018,10,13,1,537,532,235,-297
2018,10,13,2,513,511,218,-293
2018,10,13,3,490,481,219,-262
2018,10,13,4,451,450,216,-234
2018,10,13,5,424,417,212,-205
2018,10,13,6,407,406,206,-200
2018,10,13,7,397,392,197,-195
2018,10,13,8,397,387,210,-177
2018,10,13,9,408,387,216,-171
2018,10,13,10,423,401,224,-177
2018,10,13,11,448,427,218,-209
2018,10,13,12,488,462,218,-244
2018,10,13,13,523,499,217,-282
2018,10,13,14,545,523,216,-307
2018,10,13,15,547,531,219,-312
2018,10,13,16,543,524,220,-304
2018,10,13,17,523,511,222,-289
2018,10,13,18,517,496,222,-274
2018,10,13,19,502,488,221,-267
2018,10,13,20,501,486,208,-278
2018,10,13,21,509,495,198,-297
2018,10,13,22,516,499,208,-291
2018,10,13,23,532,505,215,-290
2018,10,14,0,544,534,222,-312
2018,10,14,1,546,524,263,-261
2018,10,14,2,517,508,276,-232
2018,10,14,3,481,482,259,-223
2018,10,14,4,449,448,216,-232
2018,10,14,5,414,415,209,-206
2018,10,14,6,400,401,210,-191
2018,10,14,7,392,388,206,-182
2018,10,14,8,394,386,208,-178
2018,10,14,9,392,382,214,-168
2018,10,14,10,408,395,213,-182
2018,10,14,11,427,414,211,-203
2018,10,14,12,464,447,211,-236
2018,10,14,13,510,489,213,-276
2018,10,14,14,525,513,210,-303
2018,10,14,15,518,513,212,-301
2018,10,14,16,509,514,212,-302
2018,10,14,17,514,514,211,-303
2018,10,14,18,509,509,212,-297
2018,10,14,19,506,501,214,-287
2018,10,14,20,500,497,213,-284
2018,10,14,21,513,502,229,-273
2018,10,14,22,532,513,288,-225
2018,10,14,23,549,527,329,-198
2018,10,15,0,575,555,338,-217
2018,10,15,1,555,538,305,-233
2018,10,15,2,526,509,284,-225
2018,10,15,3,485,474,242,-232
2018,10,15,4,447,435,219,-216
2018,10,15,5,402,408,210,-198
2018,10,15,6,387,386,210,-176
2018,10,15,7,383,381,210,-171
2018,10,15,8,380,378,209,-169
2018,10,15,9,387,388,210,-178
2018,10,15,10,418,416,208,-208
2018,10,15,11,486,474,208,-266
2018,10,15,12,531,513,209,-304
2018,10,15,13,536,528,204,-324
2018,10,15,14,541,543,208,-335
2018,10,15,15,545,552,210,-342
2018,10,15,16,539,559,211,-348
2018,10,15,17,550,565,209,-356
2018,10,15,18,558,565,275,-290
2018,10,15,19,559,583,380,-203
2018,10,15,20,557,589,404,-185
2018,10,15,21,571,595,425,-170
2018,10,15,22,584,591,448,-143
2018,10,15,23,590,599,445,-154
2018,10,16,0,610,618,445,-173
2018,10,16,1,594,603,445,-158
2018,10,16,2,557,561,441,-120
2018,10,16,3,502,525,361,-164
2018,10,16,4,458,468,264,-204
2018,10,16,5,410,438,172,-266
2018,10,16,6,395,410,144,-266
2018,10,16,7,381,400,145,-255
2018,10,16,8,377,396,128,-268
2018,10,16,9,384,399,114,-285
2018,10,16,10,416,428,177,-251
2018,10,16,11,483,485,211,-274
2018,10,16,12,523,522,311,-211
2018,10,16,13,532,529,313,-216
2018,10,16,14,537,544,319,-225
2018,10,16,15,544,547,317,-230
2018,10,16,16,547,549,316,-233
2018,10,16,17,548,555,339,-216
2018,10,16,18,550,558,386,-172
2018,10,16,19,550,560,408,-152
2018,10,16,20,554,561,411,-150
2018,10,16,21,555,567,411,-156
2018,10,16,22,563,570,409,-161
2018,10,16,23,572,585,407,-178
2018,10,17,0,594,597,409,-188
2018,10,17,1,579,579,406,-173
2018,10,17,2,542,544,399,-145
2018,10,17,3,484,500,364,-136
2018,10,17,4,445,459,224,-235
2018,10,17,5,404,422,139,-283
2018,10,17,6,388,403,136,-267
2018,10,17,7,380,391,136,-255
2018,10,17,8,380,389,137,-252
2018,10,17,9,388,390,139,-251
2018,10,17,10,421,423,202,-221
2018,10,17,11,489,483,203,-280
2018,10,17,12,534,523,200,-323
2018,10,17,13,536,528,183,-345
2018,10,17,14,541,538,169,-369
2018,10,17,15,539,535,167,-368
2018,10,17,16,537,534,186,-348
2018,10,17,17,537,527,204,-323
2018,10,17,18,539,527,206,-321
2018,10,17,19,528,523,210,-313
2018,10,17,20,526,528,211,-317
2018,10,17,21,530,532,209,-323
2018,10,17,22,542,537,206,-331
2018,10,17,23,551,551,208,-343
2018,10,18,0,580,573,206,-367
2018,10,18,1,577,563,206,-357
2018,10,18,2,548,540,207,-333
2018,10,18,3,502,496,206,-290
2018,10,18,4,458,457,162,-295
2018,10,18,5,439,420,111,-309
2018,10,18,6,426,408,113,-295
2018,10,18,7,424,406,115,-291
2018,10,18,8,430,404,113,-291
2018,10,18,9,444,417,114,-303
2018,10,18,10,489,458,167,-291
2018,10,18,11,572,518,242,-276
2018,10,18,12,622,574,335,-239
2018,10,18,13,618,592,284,-308
2018,10,18,14,607,581,191,-390
2018,10,18,15,593,564,158,-406
2018,10,18,16,574,555,127,-428
2018,10,18,17,554,542,125,-417
2018,10,18,18,546,533,123,-410
2018,10,18,19,529,525,173,-352
2018,10,18,20,526,525,189,-336
2018,10,18,21,532,530,188,-342
2018,10,18,22,545,541,188,-353
2018,10,18,23,563,557,186,-371
2018,10,19,0,598,578,186,-392
2018,10,19,1,590,568,187,-381
2018,10,19,2,557,548,173,-375
2018,10,19,3,518,511,132,-379
2018,10,19,4,472,469,133,-336
2018,10,19,5,455,443,131,-312
2018,10,19,6,442,432,130,-302
2018,10,19,7,440,429,118,-311
2018,10,19,8,440,429,113,-316
2018,10,19,9,460,445,119,-326
2018,10,19,10,506,484,183,-301
2018,10,19,11,578,548,210,-338
2018,10,19,12,625,598,243,-355
2018,10,19,13,620,607,205,-402
2018,10,19,14,607,602,200,-402
2018,10,19,15,584,584,161,-423
2018,10,19,16,557,561,137,-424
2018,10,19,17,545,541,135,-406
2018,10,19,18,522,531,135,-396
2018,10,19,19,517,523,137,-386
2018,10,19,20,515,519,135,-384
2018,10,19,21,519,522,191,-331
2018,10,19,22,528,525,230,-295
2018,10,19,23,539,538,313,-225
2018,10,20,0,563,554,319,-235
2018,10,20,1,549,534,344,-190
2018,10,20,2,522,513,371,-142
2018,10,20,3,490,492,298,-194
2018,10,20,4,452,458,154,-304
2018,10,20,5,441,424,116,-308
2018,10,20,6,426,403,117,-286
2018,10,20,7,411,394,117,-277
2018,10,20,8,407,385,117,-268
2018,10,20,9,411,390,117,-273
2018,10,20,10,425,406,123,-283
2018,10,20,11,447,424,146,-278
2018,10,20,12,483,456,177,-279
2018,10,20,13,516,490,183,-307
2018,10,20,14,537,516,183,-333
2018,10,20,15,535,527,221,-306
2018,10,20,16,526,527,246,-281
2018,10,20,17,516,521,208,-313
2018,10,20,18,507,504,193,-311
2018,10,20,19,493,497,245,-252
2018,10,20,20,489,496,237,-259
2018,10,20,21,496,497,208,-289
2018,10,20,22,505,500,199,-301
2018,10,20,23,526,513,249,-264
2018,10,21,0,552,524,346,-178
2018,10,21,1,550,539,424,-115
2018,10,21,2,531,517,326,-191
2018,10,21,3,496,494,254,-240
2018,10,21,4,471,450,170,-280
2018,10,21,5,472,427,149,-278
2018,10,21,6,462,409,121,-288
2018,10,21,7,455,409,121,-288
2018,10,21,8,463,418,114,-304
2018,10,21,9,476,435,113,-322
2018,10,21,10,495,461,111,-350
2018,10,21,11,530,499,129,-370
2018,10,21,12,583,547,258,-289
2018,10,21,13,637,603,342,-261
2018,10,21,14,651,624,264,-360
2018,10,21,15,621,600,197,-403
2018,10,21,16,598,569,163,-406
2018,10,21,17,578,547,150,-397
2018,10,21,18,574,531,155,-376
2018,10,21,19,568,510,151,-359
2018,10,21,20,563,504,152,-352
2018,10,21,21,559,510,156,-354
2018,10,21,22,594,526,212,-314
2018,10,21,23,641,558,246,-312
2018,10,22,0,700,602,244,-358
2018,10,22,1,684,602,185,-417
2018,10,22,2,660,593,139,-454
2018,10,22,3,621,554,115,-439
2018,10,22,4,596,531,118,-413
2018,10,22,5,526,516,119,-397
2018,10,22,6,516,510,113,-397
2018,10,22,7,526,518,112,-406
2018,10,22,8,534,530,112,-418
2018,10,22,9,561,552,116,-436
2018,10,22,10,612,584,285,-299
2018,10,22,11,692,680,417,-263
2018,10,22,12,750,731,448,-283
2018,10,22,13,747,734,449,-285
2018,10,22,14,728,719,451,-268
2018,10,22,15,690,683,336,-347
2018,10,22,16,638,625,183,-442
2018,10,22,17,603,585,125,-460
2018,10,22,18,585,563,126,-437
2018,10,22,19,555,550,128,-422
2018,10,22,20,548,543,129,-414
2018,10,22,21,549,537,154,-383
2018,10,22,22,560,558,365,-193
2018,10,22,23,604,590,385,-205
2018,10,23,0,642,617,413,-204
2018,10,23,1,627,611,419,-192
2018,10,23,2,589,593,335,-258
2018,10,23,3,544,556,198,-358
2018,10,23,4,504,507,132,-375
2018,10,23,5,458,487,131,-356
2018,10,23,6,447,481,128,-353
2018,10,23,7,448,482,123,-359
2018,10,23,8,457,492,125,-367
2018,10,23,9,473,514,129,-385
2018,10,23,10,526,546,229,-317
2018,10,23,11,596,627,327,-300
2018,10,23,12,644,664,380,-284
2018,10,23,13,646,670,398,-272
2018,10,23,14,626,670,325,-345
2018,10,23,15,591,631,182,-449
2018,10,23,16,564,601,163,-438
2018,10,23,17,550,576,153,-423
2018,10,23,18,541,559,123,-436
2018,10,23,19,520,545,126,-419
2018,10,23,20,517,533,124,-409
2018,10,23,21,525,534,125,-409
2018,10,23,22,531,552,180,-372
2018,10,23,23,564,576,212,-364
2018,10,24,0,590,610,308,-302
2018,10,24,1,585,606,351,-255
2018,10,24,2,547,590,291,-299
2018,10,24,3,503,545,154,-391
2018,10,24,4,463,504,122,-382
2018,10,24,5,448,479,118,-361
2018,10,24,6,440,471,116,-355
2018,10,24,7,438,480,121,-359
2018,10,24,8,446,484,120,-364
2018,10,24,9,468,503,121,-382
2018,10,24,10,522,548,184,-364
2018,10,24,11,593,618,241,-377
2018,10,24,12,642,669,316,-353
2018,10,24,13,646,674,252,-422
2018,10,24,14,631,650,245,-405
2018,10,24,15,608,620,250,-370
2018,10,24,16,583,584,248,-336
2018,10,24,17,566,562,249,-313
2018,10,24,18,547,546,250,-296
2018,10,24,19,527,535,241,-294
2018,10,24,20,521,538,185,-353
2018,10,24,21,529,538,125,-413
2018,10,24,22,544,536,249,-287
2018,10,24,23,584,573,401,-172
2018,10,25,0,616,605,406,-199
2018,10,25,1,605,599,406,-193
2018,10,25,2,574,580,406,-174
2018,10,25,3,533,550,276,-274
2018,10,25,4,493,509,145,-364
2018,10,25,5,494,481,124,-357
2018,10,25,6,487,477,123,-354
2018,10,25,7,485,483,123,-360
2018,10,25,8,494,484,121,-363
2018,10,25,9,513,501,135,-366
2018,10,25,10,565,543,193,-350
2018,10,25,11,640,622,324,-298
2018,10,25,12,697,662,363,-299
2018,10,25,13,702,666,373,-293
2018,10,25,14,692,659,342,-317
2018,10,25,15,676,658,271,-387
2018,10,25,16,646,630,191,-439
2018,10,25,17,628,615,221,-394
2018,10,25,18,610,601,225,-376
2018,10,25,19,596,585,194,-391
2018,10,25,20,591,562,141,-421
2018,10,25,21,599,559,152,-407
2018,10,25,22,623,673,191,-482
2018,10,25,23,660,615,255,-360
2018,10,26,0,691,633,396,-237
2018,10,26,1,677,631,434,-197
2018,10,26,2,648,604,405,-199
2018,10,26,3,605,565,337,-228
2018,10,26,4,551,518,264,-254
2018,10,26,5,492,496,207,-289
2018,10,26,6,488,481,134,-347
2018,10,26,7,480,470,120,-350
2018,10,26,8,483,478,123,-355
2018,10,26,9,496,493,135,-358
2018,10,26,10,528,531,186,-345
2018,10,26,11,607,600,212,-388
2018,10,26,12,662,640,215,-425
2018,10,26,13,668,648,250,-398
2018,10,26,14,671,661,370,-291
2018,10,26,15,656,662,417,-245
2018,10,26,16,647,625,428,-197
2018,10,26,17,634,643,429,-214
2018,10,26,18,615,628,421,-207
2018,10,26,19,604,606,365,-241
2018,10,26,20,602,594,342,-252
2018,10,26,21,617,598,391,-207
2018,10,26,22,638,611,386,-225
2018,10,26,23,673,620,426,-194
2018,10,27,0,694,635,383,-252
2018,10,27,1,671,571,341,-230
2018,10,27,2,646,591,296,-295
2018,10,27,3,602,546,242,-304
2018,10,27,4,567,514,203,-311
2018,10,27,5,550,484,194,-290
2018,10,27,6,517,466,191,-275
2018,10,27,7,505,461,193,-268
2018,10,27,8,513,456,191,-265
2018,10,27,9,518,460,193,-267
2018,10,27,10,537,473,194,-279
2018,10,27,11,561,499,243,-256
2018,10,27,12,605,533,278,-255
2018,10,27,13,652,575,321,-254
2018,10,27,14,667,589,326,-263
2018,10,27,15,652,592,413,-179
2018,10,27,16,628,583,403,-180
2018,10,27,17,600,573,340,-233
2018,10,27,18,597,563,276,-287
2018,10,27,19,581,556,236,-320
2018,10,27,20,566,561,233,-328
2018,10,27,21,579,573,219,-354
2018,10,27,22,609,589,204,-385
2018,10,27,23,632,601,180,-421
2018,10,28,0,657,622,179,-443
2018,10,28,1,645,607,171,-436
2018,10,28,2,618,587,176,-411
2018,10,28,3,581,557,172,-385
2018,10,28,4,552,529,174,-355
2018,10,28,5,476,502,173,-329
2018,10,28,6,458,486,175,-311
2018,10,28,7,456,479,191,-288
2018,10,28,8,463,482,188,-294
2018,10,28,9,469,489,184,-305
2018,10,28,10,487,505,177,-328
2018,10,28,11,522,537,179,-358
2018,10,28,12,554,581,178,-403
2018,10,28,13,599,620,178,-442
2018,10,28,14,598,618,179,-439
2018,10,28,15,566,587,179,-408
2018,10,28,16,539,561,182,-379
2018,10,28,17,524,536,181,-355
2018,10,28,18,518,519,183,-336
2018,10,28,19,513,508,160,-348
2018,10,28,20,500,504,115,-389
2018,10,28,21,506,509,115,-394
2018,10,28,22,527,528,114,-414
2018,10,28,23,553,551,158,-393
2018,10,29,0,579,562,260,-302
2018,10,29,1,565,558,318,-240
2018,10,29,2,529,532,333,-199
2018,10,29,3,493,493,312,-181
2018,10,29,4,451,462,306,-156
2018,10,29,5,430,441,162,-279
2018,10,29,6,422,426,119,-307
2018,10,29,7,426,427,122,-305
2018,10,29,8,435,434,118,-316
2018,10,29,9,451,456,118,-338
2018,10,29,10,493,499,177,-322
2018,10,29,11,562,567,272,-295
2018,10,29,12,614,623,407,-216
2018,10,29,13,626,638,425,-213
2018,10,29,14,625,631,406,-225
2018,10,29,15,613,622,345,-277
2018,10,29,16,594,593,182,-411
2018,10,29,17,571,569,133,-436
2018,10,29,18,560,554,132,-422
2018,10,29,19,543,540,129,-411
2018,10,29,20,537,534,120,-414
2018,10,29,21,545,542,171,-371
2018,10,29,22,565,548,279,-269
2018,10,29,23,603,592,417,-175
2018,10,30,0,625,623,430,-193
2018,10,30,1,610,625,506,-119
2018,10,30,2,581,602,489,-113
2018,10,30,3,544,557,387,-170
2018,10,30,4,499,530,213,-317
2018,10,30,5,478,508,129,-379
2018,10,30,6,473,502,115,-387
2018,10,30,7,475,508,116,-392
2018,10,30,8,483,520,116,-404
2018,10,30,9,500,547,170,-377
2018,10,30,10,550,590,240,-350
2018,10,30,11,620,674,396,-278
2018,10,30,12,677,728,443,-285
2018,10,30,13,671,731,446,-285
2018,10,30,14,645,706,446,-260
2018,10,30,15,614,665,404,-261
2018,10,30,16,590,617,208,-409
2018,10,30,17,566,581,141,-440
2018,10,30,18,547,564,125,-439
2018,10,30,19,534,540,123,-417
2018,10,30,20,528,537,125,-412
2018,10,30,21,526,527,205,-322
2018,10,30,22,540,554,345,-209
2018,10,30,23,568,578,447,-131
2018,10,31,0,594,611,501,-110
2018,10,31,1,583,603,495,-108
2018,10,31,2,546,580,472,-108
2018,10,31,3,505,535,384,-151
2018,10,31,4,464,504,249,-255
2018,10,31,5,432,480,223,-257
2018,10,31,6,422,475,228,-247
2018,10,31,7,418,477,225,-252
2018,10,31,8,422,488,186,-302
2018,10,31,9,437,501,237,-264
2018,10,31,10,476,552,277,-275
2018,10,31,11,540,626,323,-303
2018,10,31,12,586,662,409,-253
2018,10,31,13,591,670,431,-239
2018,10,31,14,588,656,366,-290
2018,10,31,15,572,619,245,-374
2018,10,31,16,555,579,148,-431
2018,10,31,17,540,554,119,-435
2018,10,31,18,526,545,119,-426
2018,10,31,19,521,536,117,-419
2018,10,31,20,532,531,120,-411
2018,10,31,21,528,529,223,-306
2018,10,31,22,531,536,317,-219
2018,10,31,23,539,536,338,-198
2018,11,1,0,542,548,347,-201
2018,11,1,1,544,556,255,-301
2018,11,1,2,524,533,158,-375
2018,11,1,3,488,497,113,-384
2018,11,1,4,444,456,84,-372
2018,11,1,5,410,421,53,-368
2018,11,1,6,399,412,53,-359
2018,11,1,7,394,408,52,-356
2018,11,1,8,394,407,53,-354
2018,11,1,9,404,412,55,-357
2018,11,1,10,441,450,106,-344
2018,11,1,11,508,514,118,-396
2018,11,1,12,551,549,119,-430
2018,11,1,13,554,556,119,-437
2018,11,1,14,552,556,78,-478
2018,11,1,15,550,556,62,-494
2018,11,1,16,545,541,58,-483
2018,11,1,17,537,543,61,-482
2018,11,1,18,530,535,59,-476
2018,11,1,19,526,527,64,-463
2018,11,1,20,528,521,86,-435
2018,11,1,21,527,542,126,-416
2018,11,1,22,534,563,124,-439
2018,11,1,23,565,580,218,-362
2018,11,2,0,582,595,248,-347
2018,11,2,1,564,574,240,-334
2018,11,2,2,535,543,164,-379
2018,11,2,3,494,495,125,-370
2018,11,2,4,455,455,66,-389
2018,11,2,5,428,419,57,-362
2018,11,2,6,412,403,58,-345
2018,11,2,7,407,398,59,-339
2018,11,2,8,407,395,58,-337
2018,11,2,9,418,406,58,-348
2018,11,2,10,456,436,91,-345
2018,11,2,11,515,498,124,-374
2018,11,2,12,566,539,174,-365
2018,11,2,13,569,540,176,-364
2018,11,2,14,571,554,154,-400
2018,11,2,15,566,560,144,-416
2018,11,2,16,558,563,135,-428
2018,11,2,17,542,561,129,-432
2018,11,2,18,526,561,132,-429
2018,11,2,19,518,542,129,-413
2018,11,2,20,516,537,129,-408
2018,11,2,21,516,548,129,-419
2018,11,2,22,534,565,129,-436
2018,11,2,23,562,585,138,-447
2018,11,3,0,584,595,162,-433
2018,11,3,1,579,589,131,-458
2018,11,3,2,571,570,127,-443
2018,11,3,3,551,550,128,-422
2018,11,3,4,514,523,129,-394
2018,11,3,5,467,498,125,-373
2018,11,3,6,443,493,132,-361
2018,11,3,7,437,494,114,-380
2018,11,3,8,435,495,62,-433
2018,11,3,9,440,507,59,-448
2018,11,3,10,455,533,61,-472
2018,11,3,11,488,571,60,-511
2018,11,3,12,538,615,60,-555
2018,11,3,13,577,655,86,-569
2018,11,3,14,600,655,90,-565
2018,11,3,15,596,631,89,-542
2018,11,3,16,583,602,67,-535
2018,11,3,17,570,570,67,-503
2018,11,3,18,550,545,66,-479
2018,11,3,19,530,525,66,-459
2018,11,3,20,529,521,67,-454
2018,11,3,21,541,524,68,-456
2018,11,3,22,570,539,93,-446
2018,11,3,23,596,563,129,-434
2018,11,4,0,643,592,179,-413
2018,11,4,1,633,599,201,-398
2018,11,4,2,605,584,236,-348
2018,11,4,3,576,569,190,-379
2018,11,4,4,546,548,149,-399
2018,11,4,5,488,519,116,-403
2018,11,4,6,486,512,163,-349
2018,11,4,7,485,516,192,-324
2018,11,4,8,494,523,191,-332
2018,11,4,9,504,538,190,-348
2018,11,4,10,536,551,189,-362
2018,11,4,11,578,583,195,-388
2018,11,4,12,632,624,257,-367
2018,11,4,13,650,677,293,-384
2018,11,4,14,628,679,365,-314
2018,11,4,15,586,643,300,-343
2018,11,4,16,543,600,197,-403
2018,11,4,17,525,564,71,-493
2018,11,4,18,513,544,69,-475
2018,11,4,19,501,528,66,-462
2018,11,4,20,523,510,79,-431
2018,11,4,21,546,519,136,-383
2018,11,4,22,582,535,135,-400
2018,11,4,23,604,578,198,-380
2018,11,5,0,605,601,247,-354
2018,11,5,1,588,597,233,-364
2018,11,5,2,544,578,220,-358
2018,11,5,3,498,541,134,-407
2018,11,5,4,459,501,136,-365
2018,11,5,5,-9999,469,136,-333
2018,11,5,6,464,455,90,-365
2018,11,5,7,455,439,58,-381
2018,11,5,8,456,436,60,-376
2018,11,5,9,464,438,62,-376
2018,11,5,10,483,453,61,-392
2018,11,5,11,523,489,110,-379
2018,11,5,12,609,524,156,-368
2018,11,5,13,639,591,273,-318
2018,11,5,14,642,593,283,-310
2018,11,5,15,629,587,287,-300
2018,11,5,16,619,578,299,-279
2018,11,5,17,606,567,286,-281
2018,11,5,18,589,557,289,-268
2018,11,5,19,579,548,313,-235
2018,11,5,20,575,536,343,-193
2018,11,5,21,577,533,368,-165
2018,11,5,22,578,544,317,-227
2018,11,5,23,593,571,329,-242
2018,11,6,0,634,606,329,-277
2018,11,6,1,612,594,328,-266
2018,11,6,2,586,575,331,-244
2018,11,6,3,548,537,278,-259
2018,11,6,4,505,498,248,-250
2018,11,6,5,450,458,220,-238
2018,11,6,6,448,429,171,-258
2018,11,6,7,433,409,83,-326
2018,11,6,8,425,407,64,-343
2018,11,6,9,431,406,66,-340
2018,11,6,10,437,415,65,-350
2018,11,6,11,478,452,69,-383
2018,11,6,12,525,511,149,-362
2018,11,6,13,575,547,209,-338
2018,11,6,14,583,553,256,-297
2018,11,6,15,579,560,261,-299
2018,11,6,16,589,564,257,-307
2018,11,6,17,592,559,243,-316
2018,11,6,18,579,550,252,-298
2018,11,6,19,575,545,263,-282
2018,11,6,20,573,537,264,-273
2018,11,6,21,569,533,263,-270
2018,11,6,22,564,542,263,-279
2018,11,6,23,585,564,261,-303
2018,11,7,0,618,598,261,-337
2018,11,7,1,614,592,261,-331
2018,11,7,2,589,577,260,-317
2018,11,7,3,558,553,260,-293
2018,11,7,4,518,520,257,-263
2018,11,7,5,452,491,141,-350
2018,11,7,6,418,469,63,-406
2018,11,7,7,407,464,63,-401
2018,11,7,8,411,463,63,-400
2018,11,7,9,420,472,63,-409
2018,11,7,10,440,494,65,-429
2018,11,7,11,487,543,131,-412
2018,11,7,12,562,627,135,-492
2018,11,7,13,598,646,180,-466
2018,11,7,14,590,635,219,-416
2018,11,7,15,572,605,176,-429
2018,11,7,16,557,579,153,-426
2018,11,7,17,551,549,133,-416
2018,11,7,18,536,535,132,-403
2018,11,7,19,532,534,136,-398
2018,11,7,20,527,523,131,-392
2018,11,7,21,532,523,142,-381
2018,11,7,22,538,538,216,-322
2018,11,7,23,574,578,258,-320
2018,11,8,0,609,595,259,-336
2018,11,8,1,606,587,252,-335
2018,11,8,2,592,571,228,-343
2018,11,8,3,567,535,174,-361
2018,11,8,4,528,495,131,-364
2018,11,8,5,487,455,129,-326
2018,11,8,6,445,422,75,-347
2018,11,8,7,431,411,58,-353
2018,11,8,8,419,415,65,-350
2018,11,8,9,423,416,66,-350
2018,11,8,10,435,437,67,-370
2018,11,8,11,476,481,130,-351
2018,11,8,12,540,554,154,-400
2018,11,8,13,575,584,197,-387
2018,11,8,14,570,583,230,-353
2018,11,8,15,562,575,259,-316
2018,11,8,16,558,568,262,-306
2018,11,8,17,546,566,233,-333
2018,11,8,18,532,565,198,-367
2018,11,8,19,527,559,193,-366
2018,11,8,20,519,548,193,-355
2018,11,8,21,519,558,191,-367
2018,11,8,22,544,568,194,-374
2018,11,8,23,591,599,232,-367
2018,11,9,0,627,618,257,-361
2018,11,9,1,623,612,258,-354
2018,11,9,2,610,595,257,-338
2018,11,9,3,578,567,206,-361
2018,11,9,4,540,521,175,-346
2018,11,9,5,497,483,83,-400
2018,11,9,6,454,451,56,-395
2018,11,9,7,445,441,54,-387
2018,11,9,8,438,437,53,-384
2018,11,9,9,441,440,55,-385
2018,11,9,10,450,456,56,-400
2018,11,9,11,492,492,57,-435
2018,11,9,12,571,557,135,-422
2018,11,9,13,610,595,188,-407
2018,11,9,14,609,603,203,-400
2018,11,9,15,609,614,240,-374
2018,11,9,16,602,618,245,-373
2018,11,9,17,591,609,243,-366
2018,11,9,18,576,596,220,-376
2018,11,9,19,568,590,142,-448
2018,11,9,20,553,573,124,-449
2018,11,9,21,561,577,131,-446
2018,11,9,22,576,586,142,-444
2018,11,9,23,617,614,172,-442
2018,11,10,0,645,619,214,-405
2018,11,10,1,643,613,254,-359
2018,11,10,2,629,599,223,-376
2018,11,10,3,609,578,229,-349
2018,11,10,4,563,563,269,-294
2018,11,10,5,522,542,215,-327
2018,11,10,6,503,528,163,-365
2018,11,10,7,499,527,139,-388
2018,11,10,8,507,530,137,-393
2018,11,10,9,515,540,139,-401
2018,11,10,10,532,565,141,-424
2018,11,10,11,569,579,239,-340
2018,11,10,12,602,640,327,-313
2018,11,10,13,648,700,329,-371
2018,11,10,14,676,723,312,-411
2018,11,10,15,685,718,225,-493
2018,11,10,16,670,689,189,-500
2018,11,10,17,649,662,191,-471
2018,11,10,18,619,633,141,-492
2018,11,10,19,598,608,126,-482
2018,11,10,20,583,591,123,-468
2018,11,10,21,589,598,153,-445
2018,11,10,22,616,619,188,-431
2018,11,10,23,674,669,234,-435
2018,11,11,0,715,706,315,-391
2018,11,11,1,723,712,347,-365
2018,11,11,2,716,719,440,-279
2018,11,11,3,700,712,450,-262
2018,11,11,4,681,696,448,-248
2018,11,11,5,652,681,382,-299
2018,11,11,6,618,659,287,-372
2018,11,11,7,619,663,269,-394
2018,11,11,8,636,663,329,-334
2018,11,11,9,647,679,339,-340
2018,11,11,10,664,691,320,-371
2018,11,11,11,696,717,337,-380
2018,11,11,12,732,745,404,-341
2018,11,11,13,789,783,448,-335
2018,11,11,14,815,797,540,-257
2018,11,11,15,753,766,558,-208
2018,11,11,16,692,697,361,-336
2018,11,11,17,634,642,191,-451
2018,11,11,18,599,609,192,-417
2018,11,11,19,578,578,188,-390
2018,11,11,20,556,559,190,-369
2018,11,11,21,554,557,190,-367
2018,11,11,22,587,581,186,-395
2018,11,11,23,655,625,230,-395
2018,11,12,0,701,650,318,-332
2018,11,12,1,707,644,318,-326
2018,11,12,2,698,636,321,-315
2018,11,12,3,665,609,317,-292
2018,11,12,4,637,587,318,-269
2018,11,12,5,617,563,304,-259
2018,11,12,6,579,540,258,-282
2018,11,12,7,575,541,257,-284
2018,11,12,8,578,550,267,-283
2018,11,12,9,583,550,273,-277
2018,11,12,10,607,566,271,-295
2018,11,12,11,654,594,351,-243
2018,11,12,12,731,650,363,-287
2018,11,12,13,769,684,360,-324
2018,11,12,14,774,703,404,-299
2018,11,12,15,779,729,454,-275
2018,11,12,16,759,737,451,-286
2018,11,12,17,735,737,452,-285
2018,11,12,18,706,734,453,-281
2018,11,12,19,686,726,452,-274
2018,11,12,20,661,727,454,-273
2018,11,12,21,652,724,449,-275
2018,11,12,22,673,748,455,-293
2018,11,12,23,725,765,452,-313
2018,11,13,0,759,760,453,-307
2018,11,13,1,761,736,453,-283
2018,11,13,2,745,702,454,-248
2018,11,13,3,722,655,454,-201
2018,11,13,4,677,605,439,-166
2018,11,13,5,634,566,363,-203
2018,11,13,6,577,535,288,-247
2018,11,13,7,562,512,183,-329
2018,11,13,8,552,502,180,-322
2018,11,13,9,554,508,184,-324
2018,11,13,10,568,516,180,-336
2018,11,13,11,604,554,213,-341
2018,11,13,12,675,611,291,-320
2018,11,13,13,704,646,430,-216
2018,11,13,14,703,643,441,-202
2018,11,13,15,697,644,337,-307
2018,11,13,16,694,563,257,-306
2018,11,13,17,693,702,395,-307
2018,11,13,18,687,630,267,-363
2018,11,13,19,686,627,222,-405
2018,11,13,20,680,627,218,-409
2018,11,13,21,674,637,226,-411
2018,11,13,22,688,659,235,-424
2018,11,13,23,724,690,328,-362
2018,11,14,0,750,708,425,-283
2018,11,14,1,741,708,445,-263
2018,11,14,2,725,674,385,-289
2018,11,14,3,693,661,325,-336
2018,11,14,4,647,614,322,-292
2018,11,14,5,610,579,320,-259
2018,11,14,6,526,558,235,-323
2018,11,14,7,519,538,179,-359
2018,11,14,8,512,533,177,-356
2018,11,14,9,517,542,182,-360
2018,11,14,10,535,551,193,-358
2018,11,14,11,580,588,263,-325
2018,11,14,12,651,667,328,-339
2018,11,14,13,690,697,414,-283
2018,11,14,14,695,702,422,-280
2018,11,14,15,702,698,423,-275
2018,11,14,16,704,692,424,-268
2018,11,14,17,691,682,425,-257
2018,11,14,18,677,672,424,-248
2018,11,14,19,675,667,424,-243
2018,11,14,20,656,663,426,-237
2018,11,14,21,657,660,416,-244
2018,11,14,22,692,703,451,-252
2018,11,14,23,744,734,453,-281
2018,11,15,0,760,751,408,-343
2018,11,15,1,752,744,417,-327
2018,11,15,2,735,730,419,-311
2018,11,15,3,702,702,416,-286
2018,11,15,4,652,662,376,-286
2018,11,15,5,601,626,374,-252
2018,11,15,6,594,602,396,-206
2018,11,15,7,587,600,393,-207
2018,11,15,8,583,601,361,-240
2018,11,15,9,588,611,395,-216
2018,11,15,10,631,633,405,-228
2018,11,15,11,667,661,394,-267
2018,11,15,12,740,720,498,-222
2018,11,15,13,771,765,545,-220
2018,11,15,14,778,765,478,-287
2018,11,15,15,776,754,367,-387
2018,11,15,16,767,743,403,-340
2018,11,15,17,758,729,418,-311
2018,11,15,18,747,707,383,-324
2018,11,15,19,749,691,389,-302
2018,11,15,20,734,681,371,-310
2018,11,15,21,741,682,335,-347
2018,11,15,22,756,702,330,-372
2018,11,15,23,773,733,444,-289
2018,11,16,0,781,753,525,-228
2018,11,16,1,774,747,524,-223
2018,11,16,2,751,738,529,-209
2018,11,16,3,719,729,437,-292
2018,11,16,4,675,715,393,-322
2018,11,16,5,636,692,401,-291
2018,11,16,6,646,684,415,-269
2018,11,16,7,642,686,412,-274
2018,11,16,8,641,682,411,-271
2018,11,16,9,646,700,414,-286
2018,11,16,10,676,726,393,-333
2018,11,16,11,709,767,378,-389
2018,11,16,12,787,835,368,-467
2018,11,16,13,820,865,383,-482
2018,11,16,14,812,850,409,-441
2018,11,16,15,782,808,413,-395
2018,11,16,16,739,756,400,-356
2018,11,16,17,692,701,377,-324
2018,11,16,18,647,666,391,-275
2018,11,16,19,628,631,377,-254
2018,11,16,20,614,605,345,-260
2018,11,16,21,616,598,352,-246
2018,11,16,22,632,613,378,-235
2018,11,16,23,688,662,386,-276
2018,11,17,0,713,694,385,-309
2018,11,17,1,713,698,387,-311
2018,11,17,2,704,692,386,-306
2018,11,17,3,684,683,386,-297
2018,11,17,4,658,661,387,-274
2018,11,17,5,622,637,386,-251
2018,11,17,6,581,623,378,-245
2018,11,17,7,580,622,378,-244
2018,11,17,8,592,628,379,-249
2018,11,17,9,606,642,382,-260
2018,11,17,10,624,655,374,-281
2018,11,17,11,655,691,375,-316
2018,11,17,12,696,736,380,-356
2018,11,17,13,746,766,372,-394
2018,11,17,14,767,781,367,-414
2018,11,17,15,719,739,368,-371
2018,11,17,16,654,681,327,-354
2018,11,17,17,593,630,281,-349
2018,11,17,18,556,589,228,-361
2018,11,17,19,529,555,201,-354
2018,11,17,20,514,541,206,-335
2018,11,17,21,519,536,209,-327
2018,11,17,22,541,551,247,-304
2018,11,17,23,602,599,290,-309
2018,11,18,0,634,627,322,-305
2018,11,18,1,642,630,331,-299
2018,11,18,2,635,632,328,-304
2018,11,18,3,613,621,325,-296
2018,11,18,4,581,607,324,-283
2018,11,18,5,550,586,302,-284
2018,11,18,6,515,571,289,-282
2018,11,18,7,504,580,295,-285
2018,11,18,8,512,580,296,-284
2018,11,18,9,520,596,296,-300
2018,11,18,10,530,616,299,-317
2018,11,18,11,554,644,313,-331
2018,11,18,12,596,688,318,-370
2018,11,18,13,637,729,316,-413
2018,11,18,14,663,747,319,-428
2018,11,18,15,643,712,306,-406
2018,11,18,16,594,654,291,-363
2018,11,18,17,562,599,242,-357
2018,11,18,18,541,564,235,-329
2018,11,18,19,526,542,235,-307
2018,11,18,20,507,538,222,-316
2018,11,18,21,506,537,213,-324
2018,11,18,22,524,554,214,-340
2018,11,18,23,596,598,278,-320
2018,11,19,0,618,633,299,-334
2018,11,19,1,622,640,305,-335
2018,11,19,2,611,633,302,-331
2018,11,19,3,584,616,299,-317
2018,11,19,4,549,583,297,-286
2018,11,19,5,521,560,298,-262
2018,11,19,6,488,543,297,-246
2018,11,19,7,481,542,294,-248
2018,11,19,8,478,550,297,-253
2018,11,19,9,487,562,296,-266
2018,11,19,10,506,587,296,-291
2018,11,19,11,549,632,294,-338
2018,11,19,12,639,707,311,-396
2018,11,19,13,677,747,338,-409
2018,11,19,14,668,737,340,-397
2018,11,19,15,650,700,312,-388
2018,11,19,16,625,661,280,-381
2018,11,19,17,604,618,253,-365
2018,11,19,18,578,584,249,-335
2018,11,19,19,572,565,227,-338
2018,11,19,20,559,549,215,-334
2018,11,19,21,560,545,213,-332
2018,11,19,22,575,566,213,-353
2018,11,19,23,623,604,257,-347
2018,11,20,0,658,636,332,-304
2018,11,20,1,654,637,345,-292
2018,11,20,2,634,620,346,-274
2018,11,20,3,601,589,329,-260
2018,11,20,4,554,547,256,-291
2018,11,20,5,516,503,216,-287
2018,11,20,6,508,474,212,-262
2018,11,20,7,493,457,205,-252
2018,11,20,8,493,451,206,-245
2018,11,20,9,496,457,206,-251
2018,11,20,10,518,477,207,-270
2018,11,20,11,571,517,238,-279
2018,11,20,12,657,594,338,-256
2018,11,20,13,694,648,403,-245
2018,11,20,14,704,659,366,-293
2018,11,20,15,699,657,267,-390
2018,11,20,16,668,635,222,-413
2018,11,20,17,643,620,221,-399
2018,11,20,18,623,615,208,-407
2018,11,20,19,604,616,187,-429
2018,11,20,20,593,610,185,-425
2018,11,20,21,596,609,185,-424
2018,11,20,22,617,628,197,-431
2018,11,20,23,690,677,283,-394
2018,11,21,0,731,713,378,-335
2018,11,21,1,726,717,393,-324
2018,11,21,2,723,708,391,-317
2018,11,21,3,702,686,391,-295
2018,11,21,4,664,655,395,-260
2018,11,21,5,631,619,391,-228
2018,11,21,6,625,606,391,-215
2018,11,21,7,616,606,390,-216
2018,11,21,8,624,614,390,-224
2018,11,21,9,631,635,389,-246
2018,11,21,10,672,661,389,-272
2018,11,21,11,704,712,395,-317
2018,11,21,12,760,774,403,-371
2018,11,21,13,805,826,401,-425
2018,11,21,14,809,822,404,-418
2018,11,21,15,788,773,404,-369
2018,11,21,16,748,721,405,-316
2018,11,21,17,700,675,366,-309
2018,11,21,18,661,634,326,-308
2018,11,21,19,636,608,331,-277
2018,11,21,20,615,594,219,-375
2018,11,21,21,614,586,212,-374
2018,11,21,22,635,600,331,-269
2018,11,21,23,692,659,395,-264
2018,11,22,0,725,690,404,-286
2018,11,22,1,729,703,408,-295
2018,11,22,2,719,702,405,-297
2018,11,22,3,705,694,406,-288
2018,11,22,4,674,666,393,-273
2018,11,22,5,631,632,374,-258
2018,11,22,6,596,607,367,-240
2018,11,22,7,591,602,365,-237
2018,11,22,8,585,602,364,-238
2018,11,22,9,593,606,367,-239
2018,11,22,10,599,622,383,-239
2018,11,22,11,634,653,401,-252
2018,11,22,12,674,691,405,-286
2018,11,22,13,715,737,404,-333
2018,11,22,14,731,755,403,-352
2018,11,22,15,711,727,405,-322
2018,11,22,16,694,686,406,-280
2018,11,22,17,649,653,356,-297
2018,11,22,18,605,597,286,-311
2018,11,22,19,557,546,261,-285
2018,11,22,20,528,522,256,-266
2018,11,22,21,513,501,204,-297
2018,11,22,22,522,499,187,-312
2018,11,22,23,554,523,187,-336
2018,11,23,0,579,545,185,-360
2018,11,23,1,589,552,192,-360
2018,11,23,2,593,565,187,-378
2018,11,23,3,594,563,184,-379
2018,11,23,4,590,553,185,-368
2018,11,23,5,577,537,186,-351
2018,11,23,6,544,527,184,-343
2018,11,23,7,543,526,185,-341
2018,11,23,8,546,538,187,-351
2018,11,23,9,555,543,200,-343
2018,11,23,10,574,562,310,-252
2018,11,23,11,594,605,377,-228
2018,11,23,12,630,640,386,-254
2018,11,23,13,668,675,387,-288
2018,11,23,14,701,703,388,-315
2018,11,23,15,690,714,386,-328
2018,11,23,16,671,716,387,-329
2018,11,23,17,647,712,324,-388
2018,11,23,18,628,677,197,-480
2018,11,23,19,600,665,190,-475
2018,11,23,20,585,657,190,-467
2018,11,23,21,591,654,207,-447
2018,11,23,22,612,665,330,-335
2018,11,23,23,660,711,396,-315
2018,11,24,0,686,720,397,-323
2018,11,24,1,680,704,395,-309
2018,11,24,2,672,704,396,-308
2018,11,24,3,647,687,394,-293
2018,11,24,4,618,663,386,-277
2018,11,24,5,583,625,379,-246
2018,11,24,6,560,609,332,-277
2018,11,24,7,546,590,310,-280
2018,11,24,8,540,589,263,-326
2018,11,24,9,545,583,218,-365
2018,11,24,10,560,587,186,-401
2018,11,24,11,583,597,248,-349
2018,11,24,12,605,614,280,-334
2018,11,24,13,636,651,375,-276
2018,11,24,14,669,674,379,-295
2018,11,24,15,676,682,390,-292
2018,11,24,16,652,670,387,-283
2018,11,24,17,620,643,392,-251
2018,11,24,18,593,598,392,-206
2018,11,24,19,569,556,391,-165
2018,11,24,20,578,542,392,-150
2018,11,24,21,580,534,377,-157
2018,11,24,22,599,549,378,-171
2018,11,24,23,640,595,378,-217
2018,11,25,0,674,619,377,-242
2018,11,25,1,674,625,378,-247
2018,11,25,2,661,622,377,-245
2018,11,25,3,640,614,366,-248
2018,11,25,4,609,581,296,-285
2018,11,25,5,554,561,301,-260
2018,11,25,6,523,541,252,-289
2018,11,25,7,513,538,204,-334
2018,11,25,8,514,536,196,-340
2018,11,25,9,511,543,196,-347
2018,11,25,10,509,562,196,-366
2018,11,25,11,543,585,197,-388
2018,11,25,12,572,613,219,-394
2018,11,25,13,615,654,348,-306
2018,11,25,14,650,696,372,-324
2018,11,25,15,635,691,364,-327
2018,11,25,16,600,662,293,-369
2018,11,25,17,555,602,206,-396
2018,11,25,18,546,567,189,-378
2018,11,25,19,534,544,183,-361
2018,11,25,20,536,528,185,-343
2018,11,25,21,531,524,185,-339
2018,11,25,22,564,547,183,-364
2018,11,25,23,616,592,215,-377
2018,11,26,0,651,620,344,-276
2018,11,26,1,661,624,380,-244
2018,11,26,2,650,616,383,-233
2018,11,26,3,629,593,320,-273
2018,11,26,4,608,554,220,-334
2018,11,26,5,582,517,212,-305
2018,11,26,6,507,483,197,-286
2018,11,26,7,491,472,192,-280
2018,11,26,8,492,468,177,-291
2018,11,26,9,497,486,191,-295
2018,11,26,10,512,503,195,-308
2018,11,26,11,558,542,194,-348
2018,11,26,12,638,603,245,-358
2018,11,26,13,671,636,368,-268
2018,11,26,14,682,639,391,-248
2018,11,26,15,682,629,392,-237
2018,11,26,16,693,634,394,-240
2018,11,26,17,686,624,393,-231
2018,11,26,18,653,618,393,-225
2018,11,26,19,653,627,395,-232
2018,11,26,20,647,634,392,-242
2018,11,26,21,664,662,395,-267
2018,11,26,22,701,703,389,-314
2018,11,26,23,762,767,393,-374
2018,11,27,0,802,791,390,-401
2018,11,27,1,816,795,392,-403
2018,11,27,2,794,779,389,-390
2018,11,27,3,766,754,391,-363
2018,11,27,4,720,711,391,-320
2018,11,27,5,689,671,345,-326
2018,11,27,6,679,649,334,-315
2018,11,27,7,679,643,350,-293
2018,11,27,8,696,652,381,-271
2018,11,27,9,708,666,383,-283
2018,11,27,10,736,689,382,-307
2018,11,27,11,780,738,381,-357
2018,11,27,12,859,818,393,-425
2018,11,27,13,902,862,503,-359
2018,11,27,14,892,860,383,-477
2018,11,27,15,845,846,367,-479
2018,11,27,16,802,822,381,-441
2018,11,27,17,739,799,387,-412
2018,11,27,18,716,774,329,-445
2018,11,27,19,688,745,267,-478
2018,11,27,20,676,736,266,-470
2018,11,27,21,675,749,333,-416
2018,11,27,22,715,797,389,-408
2018,11,27,23,778,867,486,-381
2018,11,28,0,821,919,495,-424
2018,11,28,1,836,924,528,-396
2018,11,28,2,832,925,524,-401
2018,11,28,3,804,904,523,-381
2018,11,28,4,763,866,495,-371
2018,11,28,5,745,834,396,-438
2018,11,28,6,785,813,394,-419
2018,11,28,7,789,809,395,-414
2018,11,28,8,793,813,396,-417
2018,11,28,9,810,824,395,-429
2018,11,28,10,841,847,395,-452
2018,11,28,11,894,887,392,-495
2018,11,28,12,975,944,398,-546
2018,11,28,13,1004,975,402,-573
2018,11,28,14,990,968,397,-571
2018,11,28,15,941,958,401,-557
2018,11,28,16,882,906,402,-504
2018,11,28,17,829,860,403,-457
2018,11,28,18,774,818,403,-415
2018,11,28,19,752,785,395,-390
2018,11,28,20,736,754,352,-402
2018,11,28,21,733,755,392,-363
2018,11,28,22,768,792,398,-394
2018,11,28,23,835,867,400,-467
2018,11,29,0,871,902,399,-503
2018,11,29,1,872,899,399,-500
2018,11,29,2,871,874,399,-475
2018,11,29,3,845,853,469,-384
2018,11,29,4,812,817,469,-348
2018,11,29,5,784,774,403,-371
2018,11,29,6,776,754,401,-353
2018,11,29,7,778,757,403,-354
2018,11,29,8,785,756,402,-354
2018,11,29,9,802,773,400,-373
2018,11,29,10,835,797,410,-387
2018,11,29,11,870,843,469,-374
2018,11,29,12,956,900,469,-431
2018,11,29,13,987,926,473,-453
2018,11,29,14,959,900,470,-430
2018,11,29,15,907,855,414,-441
2018,11,29,16,845,787,404,-383
2018,11,29,17,764,721,406,-315
2018,11,29,18,720,687,402,-285
2018,11,29,19,688,676,402,-274
2018,11,29,20,659,668,400,-268
2018,11,29,21,664,664,400,-264
2018,11,29,22,689,686,400,-286
2018,11,29,23,748,726,400,-326
2018,11,30,0,786,746,370,-376
2018,11,30,1,788,740,348,-392
2018,11,30,2,786,720,329,-391
2018,11,30,3,760,681,341,-340
2018,11,30,4,718,635,356,-279
2018,11,30,5,681,594,337,-257
2018,11,30,6,580,563,170,-393
2018,11,30,7,566,539,112,-427
2018,11,30,8,558,540,113,-427
2018,11,30,9,561,543,112,-431
2018,11,30,10,577,564,118,-446
2018,11,30,11,616,590,291,-299
2018,11,30,12,692,672,392,-280
2018,11,30,13,733,696,393,-303
2018,11,30,14,719,674,386,-288
2018,11,30,15,703,669,392,-277
2018,11,30,16,680,646,362,-284
2018,11,30,17,664,628,318,-310
2018,11,30,18,641,609,310,-299
2018,11,30,19,637,605,237,-368
2018,11,30,20,621,585,192,-393
2018,11,30,21,619,592,194,-398
2018,11,30,22,633,603,190,-413
2018,11,30,23,660,623,248,-375
2018,12,1,0,676,633,360,-273
2018,12,1,1,664,621,385,-236
2018,12,1,2,654,605,393,-212
2018,12,1,3,627,589,394,-195
2018,12,1,4,592,559,339,-220
2018,12,1,5,560,516,278,-238
2018,12,1,6,532,482,170,-312
2018,12,1,7,520,466,148,-318
2018,12,1,8,515,453,142,-311
2018,12,1,9,518,453,146,-307
2018,12,1,10,524,459,151,-308
2018,12,1,11,547,479,214,-265
2018,12,1,12,596,510,214,-296
2018,12,1,13,624,542,268,-274
2018,12,1,14,657,585,295,-290
2018,12,1,15,661,610,301,-309
2018,12,1,16,650,623,306,-317
2018,12,1,17,619,621,346,-275
2018,12,1,18,588,614,346,-268
2018,12,1,19,564,608,333,-275
2018,12,1,20,534,592,310,-282
2018,12,1,21,531,591,310,-281
2018,12,1,22,546,605,311,-294
2018,12,1,23,592,621,347,-274
2018,12,2,0,614,625,416,-209
2018,12,2,1,611,614,400,-214
2018,12,2,2,598,591,384,-207
2018,12,2,3,576,582,358,-224
2018,12,2,4,552,547,227,-320
2018,12,2,5,521,502,179,-323
2018,12,2,6,488,478,180,-298
2018,12,2,7,476,452,178,-274
2018,12,2,8,471,443,181,-262
2018,12,2,9,467,441,178,-263
2018,12,2,10,468,445,180,-265
2018,12,2,11,504,460,179,-281
2018,12,2,12,533,481,179,-302
2018,12,2,13,577,517,180,-337
2018,12,2,14,626,543,181,-362
2018,12,2,15,630,550,180,-370
2018,12,2,16,597,543,199,-344
2018,12,2,17,566,519,207,-312
2018,12,2,18,550,512,213,-299
2018,12,2,19,537,509,213,-296
2018,12,2,20,534,499,213,-286
2018,12,2,21,536,504,213,-291
2018,12,2,22,555,504,278,-226
2018,12,2,23,601,548,398,-150
2018,12,3,0,619,577,428,-149
2018,12,3,1,625,577,432,-145
2018,12,3,2,616,565,433,-132
2018,12,3,3,586,549,411,-138
2018,12,3,4,557,513,346,-167
2018,12,3,5,499,490,319,-171
2018,12,3,6,447,466,217,-249
2018,12,3,7,440,451,184,-267
2018,12,3,8,445,457,184,-273
2018,12,3,9,452,466,179,-287
2018,12,3,10,467,490,179,-311
2018,12,3,11,506,537,178,-359
2018,12,3,12,579,608,226,-382
2018,12,3,13,621,651,376,-275
2018,12,3,14,624,656,399,-257
2018,12,3,15,609,638,317,-321
2018,12,3,16,589,604,210,-394
2018,12,3,17,579,582,197,-385
2018,12,3,18,568,566,197,-369
2018,12,3,19,555,554,198,-356
2018,12,3,20,544,550,204,-346
2018,12,3,21,546,540,234,-306
2018,12,3,22,564,560,362,-198
2018,12,3,23,620,619,444,-175
2018,12,4,0,654,668,457,-211
2018,12,4,1,656,677,456,-221
2018,12,4,2,650,686,456,-230
2018,12,4,3,631,665,453,-212
2018,12,4,4,596,631,446,-185
2018,12,4,5,560,599,424,-175
2018,12,4,6,607,573,394,-179
2018,12,4,7,606,577,398,-179
2018,12,4,8,614,576,291,-285
2018,12,4,9,627,576,293,-283
2018,12,4,10,648,593,356,-237
2018,12,4,11,700,647,417,-230
2018,12,4,12,776,727,403,-324
2018,12,4,13,814,765,429,-336
2018,12,4,14,803,766,427,-339
2018,12,4,15,782,763,379,-384
2018,12,4,16,756,754,353,-401
2018,12,4,17,748,746,354,-392
2018,12,4,18,731,711,354,-357
2018,12,4,19,714,692,356,-336
2018,12,4,20,696,681,368,-313
2018,12,4,21,692,690,414,-276
2018,12,4,22,711,726,432,-294
2018,12,4,23,775,789,447,-342
2018,12,5,0,811,822,449,-373
2018,12,5,1,821,817,451,-366
2018,12,5,2,818,809,455,-354
2018,12,5,3,789,777,453,-324
2018,12,5,4,753,728,450,-278
2018,12,5,5,718,691,448,-243
2018,12,5,6,708,708,448,-9999
2018,12,5,7,698,698,398,-9999
2018,12,5,8,710,710,291,-9999
2018,12,5,9,724,724,293,-9999
2018,12,5,10,755,755,356,-9999
2018,12,5,11,802,802,417,-9999
2018,12,5,12,870,870,403,-9999
2018,12,5,13,913,913,429,-9999
2018,12,5,14,901,901,427,-9999
2018,12,5,15,873,873,379,-9999
2018,12,5,16,830,830,353,-9999
2018,12,5,17,806,806,354,-9999
2018,12,5,18,766,766,354,-9999
2018,12,5,19,748,748,356,-9999
2018,12,5,20,739,739,368,-9999
2018,12,5,21,744,744,414,-9999
2018,12,5,22,778,778,432,-9999
2018,12,5,23,839,839,447,-9999
2018,12,6,0,882,882,449,-9999
2018,12,6,1,882,882,451,-9999
2018,12,6,2,871,871,455,-9999
2018,12,6,3,849,849,453,-9999
2018,12,6,4,821,821,450,-9999
2018,12,6,5,783,783,448,-9999
2018,12,6,6,-9999,745,455,-290
2018,12,6,7,-9999,749,457,-292
2018,12,6,8,-9999,760,457,-303
2018,12,6,9,-9999,776,457,-319
2018,12,6,10,-9999,801,458,-343
2018,12,6,11,-9999,847,519,-328
2018,12,6,12,-9999,929,543,-386
2018,12,6,13,-9999,962,578,-384
2018,12,6,14,-9999,945,531,-414
2018,12,6,15,-9999,897,534,-363
2018,12,6,16,-9999,845,459,-386
2018,12,6,17,-9999,773,451,-322
2018,12,6,18,-9999,731,448,-283
2018,12,6,19,-9999,713,419,-294
2018,12,6,20,-9999,701,449,-252
2018,12,6,21,-9999,705,459,-246
2018,12,6,22,-9999,727,459,-268
2018,12,6,23,-9999,789,460,-329
2018,12,7,0,-9999,818,457,-361
2018,12,7,1,-9999,820,453,-367
2018,12,7,2,-9999,811,456,-355
2018,12,7,3,-9999,777,456,-321
2018,12,7,4,-9999,724,453,-271
2018,12,7,5,-9999,677,452,-225
2018,12,7,6,702,651,446,-205
2018,12,7,7,687,639,367,-272
2018,12,7,8,689,627,406,-221
2018,12,7,9,696,634,440,-194
2018,12,7,10,712,650,452,-198
2018,12,7,11,759,694,458,-236
2018,12,7,12,817,765,455,-310
2018,12,7,13,885,787,454,-333
2018,12,7,14,857,782,458,-324
2018,12,7,15,825,770,454,-316
2018,12,7,16,767,759,458,-301
2018,12,7,17,717,732,409,-323
2018,12,7,18,676,702,406,-296
2018,12,7,19,653,686,408,-278
2018,12,7,20,630,679,409,-270
2018,12,7,21,630,679,408,-271
2018,12,7,22,651,698,409,-289
2018,12,7,23,720,731,430,-301
2018,12,8,0,763,757,459,-298
2018,12,8,1,766,754,456,-298
2018,12,8,2,759,758,459,-299
2018,12,8,3,740,742,458,-284
2018,12,8,4,715,708,461,-247
2018,12,8,5,680,661,456,-205
2018,12,8,6,667,630,405,-225
2018,12,8,7,650,612,386,-226
2018,12,8,8,641,600,387,-213
2018,12,8,9,647,599,390,-209
2018,12,8,10,658,608,393,-215
2018,12,8,11,678,628,456,-172
2018,12,8,12,714,658,457,-201
2018,12,8,13,753,694,455,-239
2018,12,8,14,799,728,456,-272
2018,12,8,15,804,743,457,-286
2018,12,8,16,801,740,456,-284
2018,12,8,17,783,728,456,-272
2018,12,8,18,755,727,456,-271
2018,12,8,19,720,731,458,-273
2018,12,8,20,705,732,451,-281
2018,12,8,21,715,749,451,-298
2018,12,8,22,744,769,452,-317
2018,12,8,23,789,807,430,-377
2018,12,9,0,805,808,420,-388
2018,12,9,1,801,789,420,-369
2018,12,9,2,780,765,424,-341
2018,12,9,3,764,756,328,-428
2018,12,9,4,735,712,237,-475
2018,12,9,5,709,657,241,-416
2018,12,9,6,675,612,212,-400
2018,12,9,7,677,588,210,-378
2018,12,9,8,681,573,212,-361
2018,12,9,9,687,561,212,-349
2018,12,9,10,700,574,212,-362
2018,12,9,11,715,612,216,-396
2018,12,9,12,748,642,275,-367
2018,12,9,13,797,661,276,-385
2018,12,9,14,841,686,277,-409
2018,12,9,15,854,695,279,-416
2018,12,9,16,864,694,278,-416
2018,12,9,17,853,686,273,-413
2018,12,9,18,836,667,269,-398
2018,12,9,19,825,647,271,-376
2018,12,9,20,814,633,276,-357
2018,12,9,21,820,646,275,-371
2018,12,9,22,851,667,277,-390
2018,12,9,23,878,707,276,-431
2018,12,10,0,883,733,276,-457
2018,12,10,1,889,715,278,-437
2018,12,10,2,885,694,279,-415
2018,12,10,3,865,664,280,-384
2018,12,10,4,839,643,278,-365
2018,12,10,5,811,616,275,-341
2018,12,10,6,629,593,280,-313
2018,12,10,7,618,587,281,-306
2018,12,10,8,620,585,278,-307
2018,12,10,9,629,598,282,-316
2018,12,10,10,655,609,283,-326
2018,12,10,11,702,629,283,-346
2018,12,10,12,771,662,284,-378
2018,12,10,13,811,692,283,-409
2018,12,10,14,813,719,285,-434
2018,12,10,15,802,731,280,-451
2018,12,10,16,787,726,281,-445
2018,12,10,17,768,719,280,-439
2018,12,10,18,760,719,284,-435
2018,12,10,19,752,712,285,-427
2018,12,10,20,744,703,285,-418
2018,12,10,21,746,704,287,-417
2018,12,10,22,767,732,290,-442
2018,12,10,23,814,779,288,-491
2018,12,11,0,844,803,285,-518
2018,12,11,1,828,791,286,-505
2018,12,11,2,818,773,282,-491
2018,12,11,3,789,746,284,-462
2018,12,11,4,751,712,287,-425
2018,12,11,5,710,678,277,-401
2018,12,11,6,678,640,259,-381
2018,12,11,7,676,643,252,-391
2018,12,11,8,674,647,216,-431
2018,12,11,9,686,665,218,-447
2018,12,11,10,702,686,217,-469
2018,12,11,11,762,723,228,-495
2018,12,11,12,830,765,281,-484
2018,12,11,13,878,826,281,-545
2018,12,11,14,863,847,282,-565
2018,12,11,15,825,816,280,-536
2018,12,11,16,777,780,275,-505
2018,12,11,17,724,740,222,-518
2018,12,11,18,681,708,225,-483
2018,12,11,19,660,685,226,-459
2018,12,11,20,640,665,230,-435
2018,12,11,21,638,664,221,-443
2018,12,11,22,671,688,231,-457
2018,12,11,23,739,731,233,-498
2018,12,12,0,803,764,260,-504
2018,12,12,1,818,808,297,-511
2018,12,12,2,823,799,295,-504
2018,12,12,3,803,774,275,-499
2018,12,12,4,767,753,243,-510
2018,12,12,5,720,766,248,-518
2018,12,12,6,720,699,202,-497
2018,12,12,7,712,695,199,-496
2018,12,12,8,727,708,201,-507
2018,12,12,9,738,716,199,-517
2018,12,12,10,765,736,218,-518
2018,12,12,11,818,762,284,-478
2018,12,12,12,891,817,306,-511
2018,12,12,13,933,858,309,-549
2018,12,12,14,926,869,311,-558
2018,12,12,15,882,849,313,-536
2018,12,12,16,819,822,318,-504
2018,12,12,17,756,787,279,-508
2018,12,12,18,711,742,248,-494
2018,12,12,19,673,715,232,-483
2018,12,12,20,650,748,215,-533
2018,12,12,21,645,752,217,-535
2018,12,12,22,657,750,211,-539
2018,12,12,23,734,795,275,-520
2018,12,13,0,769,817,310,-507
2018,12,13,1,772,812,314,-498
2018,12,13,2,772,801,316,-485
2018,12,13,3,755,781,315,-466
2018,12,13,4,717,736,263,-473
2018,12,13,5,677,695,190,-505
2018,12,13,6,634,675,185,-490
2018,12,13,7,628,655,181,-474
2018,12,13,8,628,656,189,-467
2018,12,13,9,645,659,191,-468
2018,12,13,10,670,677,248,-429
2018,12,13,11,707,707,274,-433
2018,12,13,12,789,765,277,-488
2018,12,13,13,836,805,280,-525
2018,12,13,14,824,810,277,-533
2018,12,13,15,802,796,274,-522
2018,12,13,16,761,764,282,-482
2018,12,13,17,735,738,254,-484
2018,12,13,18,698,704,238,-466
2018,12,13,19,676,680,230,-450
2018,12,13,20,658,667,232,-435
2018,12,13,21,655,667,234,-433
2018,12,13,22,671,680,235,-445
2018,12,13,23,733,741,279,-462
2018,12,14,0,768,766,281,-485
2018,12,14,1,774,765,281,-484
2018,12,14,2,760,750,279,-471
2018,12,14,3,736,723,280,-443
2018,12,14,4,692,672,282,-390
2018,12,14,5,631,633,253,-380
2018,12,14,6,610,599,221,-378
2018,12,14,7,599,584,203,-381
2018,12,14,8,602,585,212,-373
2018,12,14,9,608,586,211,-375
2018,12,14,10,638,606,222,-384
2018,12,14,11,679,633,235,-398
2018,12,14,12,745,699,261,-438
2018,12,14,13,788,741,286,-455
2018,12,14,14,784,751,281,-470
2018,12,14,15,758,747,279,-468
2018,12,14,16,739,747,284,-463
2018,12,14,17,728,745,287,-458
2018,12,14,18,730,735,274,-461
2018,12,14,19,727,722,235,-487
2018,12,14,20,713,708,234,-474
2018,12,14,21,716,701,234,-467
2018,12,14,22,723,714,233,-481
2018,12,14,23,738,742,234,-508
2018,12,15,0,752,740,237,-503
2018,12,15,1,750,729,238,-491
2018,12,15,2,727,711,232,-479
2018,12,15,3,705,688,235,-453
2018,12,15,4,670,653,236,-417
2018,12,15,5,638,614,231,-383
2018,12,15,6,555,582,240,-342
2018,12,15,7,543,566,237,-329
2018,12,15,8,536,554,231,-323
2018,12,15,9,538,553,235,-318
2018,12,15,10,540,557,237,-320
2018,12,15,11,553,574,237,-337
2018,12,15,12,590,603,239,-364
2018,12,15,13,635,641,242,-399
2018,12,15,14,677,671,236,-435
2018,12,15,15,681,678,236,-442
2018,12,15,16,676,677,239,-438
2018,12,15,17,653,669,239,-430
2018,12,15,18,633,649,241,-408
2018,12,15,19,606,617,244,-373
2018,12,15,20,599,598,241,-357
2018,12,15,21,601,603,237,-366
2018,12,15,22,628,621,239,-382
2018,12,15,23,675,655,244,-411
2018,12,16,0,687,672,248,-424
2018,12,16,1,684,669,245,-424
2018,12,16,2,668,663,247,-416
2018,12,16,3,651,647,248,-399
2018,12,16,4,627,616,246,-370
2018,12,16,5,589,587,245,-342
2018,12,16,6,552,564,245,-319
2018,12,16,7,537,548,245,-303
2018,12,16,8,525,544,248,-296
2018,12,16,9,520,542,247,-295
2018,12,16,10,517,555,246,-309
2018,12,16,11,538,575,248,-327
2018,12,16,12,574,609,242,-367
2018,12,16,13,626,645,237,-408
2018,12,16,14,670,684,235,-449
2018,12,16,15,672,687,234,-453
2018,12,16,16,638,671,226,-445
2018,12,16,17,602,634,212,-422
2018,12,16,18,586,617,211,-406
2018,12,16,19,568,603,212,-391
2018,12,16,20,569,593,208,-385
2018,12,16,21,571,597,210,-387
2018,12,16,22,608,618,206,-412
2018,12,16,23,656,670,204,-466
2018,12,17,0,676,690,203,-487
2018,12,17,1,687,689,207,-482
2018,12,17,2,682,679,205,-474
2018,12,17,3,658,659,205,-454
2018,12,17,4,628,619,202,-417
2018,12,17,5,593,584,206,-378
2018,12,17,6,557,541,190,-351
2018,12,17,7,544,530,193,-337
2018,12,17,8,550,537,201,-336
2018,12,17,9,559,545,205,-340
2018,12,17,10,581,565,205,-360
2018,12,17,11,620,611,205,-406
2018,12,17,12,695,686,214,-472
2018,12,17,13,736,738,225,-513
2018,12,17,14,738,736,222,-514
2018,12,17,15,711,712,227,-485
2018,12,17,16,676,677,221,-456
2018,12,17,17,637,643,213,-430
2018,12,17,18,614,622,214,-408
2018,12,17,19,597,599,212,-387
2018,12,17,20,579,586,211,-375
2018,12,17,21,582,590,212,-378
2018,12,17,22,606,614,210,-404
2018,12,17,23,669,673,208,-465
2018,12,18,0,705,720,211,-509
2018,12,18,1,709,722,220,-502
2018,12,18,2,712,726,240,-486
2018,12,18,3,687,707,234,-473
2018,12,18,4,653,668,194,-474
2018,12,18,5,623,630,186,-444
2018,12,18,6,606,606,179,-427
2018,12,18,7,604,600,180,-420
2018,12,18,8,615,600,180,-420
2018,12,18,9,629,608,180,-428
2018,12,18,10,655,633,180,-453
2018,12,18,11,700,674,192,-482
2018,12,18,12,773,721,232,-489
2018,12,18,13,817,703,231,-472
2018,12,18,14,810,778,272,-506
2018,12,18,15,774,850,336,-514
2018,12,18,16,724,755,252,-503
2018,12,18,17,688,657,194,-463
2018,12,18,18,651,622,229,-393
2018,12,18,19,625,602,194,-408
2018,12,18,20,607,578,183,-395
2018,12,18,21,609,583,183,-400
2018,12,18,22,632,598,200,-398
2018,12,18,23,682,647,221,-426
2018,12,19,0,714,687,319,-368
2018,12,19,1,723,700,341,-359
2018,12,19,2,720,705,340,-365
2018,12,19,3,700,689,341,-348
2018,12,19,4,668,658,338,-320
2018,12,19,5,632,630,272,-358
2018,12,19,6,605,605,187,-418
2018,12,19,7,598,603,181,-422
2018,12,19,8,604,605,178,-427
2018,12,19,9,619,623,179,-444
2018,12,19,10,644,651,176,-475
2018,12,19,11,682,693,197,-496
2018,12,19,12,749,765,279,-486
2018,12,19,13,796,817,286,-531
2018,12,19,14,792,811,287,-524
2018,12,19,15,764,784,265,-519
2018,12,19,16,725,737,253,-484
2018,12,19,17,701,693,254,-439
2018,12,19,18,661,655,185,-470
2018,12,19,19,641,629,186,-443
2018,12,19,20,628,615,184,-431
2018,12,19,21,630,611,183,-428
2018,12,19,22,658,639,186,-453
2018,12,19,23,717,689,183,-506
2018,12,20,0,745,717,191,-526
2018,12,20,1,745,717,207,-510
2018,12,20,2,736,712,202,-510
2018,12,20,3,716,692,179,-513
2018,12,20,4,670,639,175,-464
2018,12,20,5,625,596,174,-422
2018,12,20,6,568,561,173,-388
2018,12,20,7,552,541,170,-371
2018,12,20,8,556,540,175,-365
2018,12,20,9,560,539,172,-367
2018,12,20,10,584,552,172,-380
2018,12,20,11,630,591,177,-414
2018,12,20,12,714,645,171,-474
2018,12,20,13,765,688,173,-515
2018,12,20,14,753,694,178,-516
2018,12,20,15,735,708,202,-506
2018,12,20,16,699,705,199,-506
2018,12,20,17,677,702,196,-506
2018,12,20,18,643,699,203,-496
2018,12,20,19,619,691,199,-492
2018,12,20,20,593,681,200,-481
2018,12,20,21,596,676,199,-477
2018,12,20,22,618,687,199,-488
2018,12,20,23,671,710,203,-507
2018,12,21,0,709,711,203,-508
2018,12,21,1,712,694,203,-491
2018,12,21,2,705,678,203,-475
2018,12,21,3,687,648,203,-445
2018,12,21,4,650,602,203,-399
2018,12,21,5,588,557,202,-355
2018,12,21,6,543,517,201,-316
2018,12,21,7,529,503,201,-302
2018,12,21,8,525,498,192,-306
2018,12,21,9,531,487,177,-310
2018,12,21,10,552,501,180,-321
2018,12,21,11,584,533,180,-353
2018,12,21,12,645,585,180,-405
2018,12,21,13,681,629,181,-448
2018,12,21,14,701,649,181,-468
2018,12,21,15,704,666,182,-484
2018,12,21,16,701,675,180,-495
2018,12,21,17,684,684,182,-502
2018,12,21,18,660,683,180,-503
2018,12,21,19,649,689,180,-509
2018,12,21,20,642,691,179,-512
2018,12,21,21,640,704,181,-523
2018,12,21,22,656,724,226,-498
2018,12,21,23,697,766,242,-524
2018,12,22,0,721,777,287,-490
2018,12,22,1,714,763,292,-471
2018,12,22,2,715,746,294,-452
2018,12,22,3,696,730,232,-498
2018,12,22,4,659,691,184,-507
2018,12,22,5,633,647,176,-471
2018,12,22,6,610,619,176,-443
2018,12,22,7,600,610,175,-435
2018,12,22,8,599,606,178,-428
2018,12,22,9,608,606,175,-431
2018,12,22,10,613,622,176,-446
2018,12,22,11,636,651,176,-475
2018,12,22,12,664,683,177,-506
2018,12,22,13,702,729,184,-545
2018,12,22,14,738,766,203,-563
2018,12,22,15,729,778,218,-560
2018,12,22,16,698,743,210,-533
2018,12,22,17,676,709,196,-513
2018,12,22,18,634,678,195,-483
2018,12,22,19,606,645,192,-453
2018,12,22,20,594,624,192,-432
2018,12,22,21,597,617,190,-427
2018,12,22,22,617,643,189,-454
2018,12,22,23,672,690,188,-502
2018,12,23,0,692,731,186,-545
2018,12,23,1,702,742,198,-544
2018,12,23,2,704,749,190,-559
2018,12,23,3,694,747,190,-557
2018,12,23,4,679,736,189,-547
2018,12,23,5,650,717,190,-527
2018,12,23,6,639,695,188,-507
2018,12,23,7,632,682,206,-476
2018,12,23,8,627,681,258,-423
2018,12,23,9,632,702,317,-385
2018,12,23,10,645,712,315,-397
2018,12,23,11,662,733,314,-419
2018,12,23,12,714,769,315,-454
2018,12,23,13,758,813,322,-491
2018,12,23,14,801,843,368,-475
2018,12,23,15,782,810,333,-477
2018,12,23,16,724,748,265,-483
2018,12,23,17,675,684,202,-482
2018,12,23,18,642,654,197,-457
2018,12,23,19,628,643,199,-444
2018,12,23,20,607,620,197,-423
2018,12,23,21,603,611,189,-422
2018,12,23,22,620,621,186,-435
2018,12,23,23,671,658,182,-476
2018,12,24,0,683,664,181,-483
2018,12,24,1,687,662,180,-482
2018,12,24,2,677,652,178,-474
2018,12,24,3,657,641,181,-460
2018,12,24,4,634,617,180,-437
2018,12,24,5,600,584,180,-404
2018,12,24,6,591,564,178,-386
2018,12,24,7,581,555,179,-376
2018,12,24,8,584,559,179,-380
2018,12,24,9,590,575,180,-395
2018,12,24,10,596,591,181,-410
2018,12,24,11,614,624,184,-440
2018,12,24,12,645,666,188,-478
2018,12,24,13,702,711,187,-524
2018,12,24,14,747,747,187,-560
2018,12,24,15,751,750,186,-564
2018,12,24,16,730,726,184,-542
2018,12,24,17,676,690,183,-507
2018,12,24,18,637,651,184,-467
2018,12,24,19,610,624,185,-439
2018,12,24,20,589,604,184,-420
2018,12,24,21,589,601,184,-417
2018,12,24,22,596,616,184,-432
2018,12,24,23,637,660,183,-477
2018,12,25,0,674,690,187,-503
2018,12,25,1,680,706,190,-516
2018,12,25,2,686,710,188,-522
2018,12,25,3,687,716,191,-525
2018,12,25,4,673,710,190,-520
2018,12,25,5,658,693,188,-505
2018,12,25,6,656,674,189,-485
2018,12,25,7,644,664,187,-477
2018,12,25,8,648,671,197,-474
2018,12,25,9,652,677,197,-480
2018,12,25,10,656,692,198,-494
2018,12,25,11,686,705,195,-510
2018,12,25,12,716,729,215,-514
2018,12,25,13,749,758,237,-521
2018,12,25,14,786,784,239,-545
2018,12,25,15,773,767,237,-530
2018,12,25,16,726,734,228,-506
2018,12,25,17,681,677,190,-487
2018,12,25,18,629,645,188,-457
2018,12,25,19,592,620,195,-425
2018,12,25,20,562,593,214,-379
2018,12,25,21,545,581,215,-366
2018,12,25,22,557,578,212,-366
2018,12,25,23,608,624,214,-410
2018,12,26,0,632,648,212,-436
2018,12,26,1,643,654,214,-440
2018,12,26,2,643,652,215,-437
2018,12,26,3,641,638,212,-426
2018,12,26,4,628,624,213,-411
2018,12,26,5,608,604,213,-391
2018,12,26,6,577,597,194,-403
2018,12,26,7,571,596,180,-416
2018,12,26,8,567,606,178,-428
2018,12,26,9,573,622,179,-443
2018,12,26,10,596,647,178,-469
2018,12,26,11,611,684,196,-488
2018,12,26,12,654,744,241,-503
2018,12,26,13,701,791,242,-549
2018,12,26,14,730,812,243,-569
2018,12,26,15,714,779,242,-537
2018,12,26,16,683,726,225,-501
2018,12,26,17,671,671,199,-472
2018,12,26,18,635,624,188,-436
2018,12,26,19,601,593,189,-404
2018,12,26,20,586,576,199,-377
2018,12,26,21,578,566,186,-380
2018,12,26,22,594,588,184,-404
2018,12,26,23,661,645,195,-450
2018,12,27,0,695,688,230,-458
2018,12,27,1,692,689,235,-454
2018,12,27,2,684,685,232,-453
2018,12,27,3,668,674,233,-441
2018,12,27,4,636,636,232,-404
2018,12,27,5,595,601,232,-369
2018,12,27,6,562,578,233,-345
2018,12,27,7,552,569,233,-336
2018,12,27,8,558,571,236,-335
2018,12,27,9,563,567,231,-336
2018,12,27,10,588,580,235,-345
2018,12,27,11,630,606,233,-373
2018,12,27,12,684,649,234,-415
2018,12,27,13,744,689,234,-455
2018,12,27,14,775,708,224,-484
2018,12,27,15,762,716,184,-532
2018,12,27,16,741,724,177,-547
2018,12,27,17,738,711,174,-537
2018,12,27,18,722,709,180,-529
2018,12,27,19,700,697,185,-512
2018,12,27,20,656,686,218,-468
2018,12,27,21,656,680,221,-459
2018,12,27,22,694,693,229,-464
2018,12,27,23,733,717,255,-462
2018,12,28,0,743,727,233,-494
2018,12,28,1,723,708,190,-518
2018,12,28,2,704,689,179,-510
2018,12,28,3,677,656,178,-478
2018,12,28,4,621,614,171,-443
2018,12,28,5,571,566,123,-443
2018,12,28,6,531,530,124,-406
2018,12,28,7,517,507,122,-385
2018,12,28,8,510,501,125,-376
2018,12,28,9,512,494,127,-367
2018,12,28,10,522,498,125,-373
2018,12,28,11,548,522,124,-398
2018,12,28,12,583,565,126,-439
2018,12,28,13,624,604,125,-479
2018,12,28,14,646,630,127,-503
2018,12,28,15,647,648,127,-521
2018,12,28,16,629,655,128,-527
2018,12,28,17,625,647,126,-521
2018,12,28,18,607,642,127,-515
2018,12,28,19,588,626,127,-499
2018,12,28,20,566,614,129,-485
2018,12,28,21,566,604,127,-477
2018,12,28,22,580,610,128,-482
2018,12,28,23,601,634,130,-504
2018,12,29,0,628,629,212,-417
2018,12,29,1,617,629,202,-427
2018,12,29,2,599,618,164,-454
2018,12,29,3,573,596,164,-432
2018,12,29,4,541,568,165,-403
2018,12,29,5,512,538,164,-374
2018,12,29,6,477,514,164,-350
2018,12,29,7,475,503,161,-342
2018,12,29,8,475,498,124,-374
2018,12,29,9,484,501,121,-380
2018,12,29,10,503,510,120,-390
2018,12,29,11,540,530,121,-409
2018,12,29,12,586,557,122,-435
2018,12,29,13,628,586,125,-461
2018,12,29,14,650,624,127,-497
2018,12,29,15,635,636,126,-510
2018,12,29,16,606,617,125,-492
2018,12,29,17,578,590,138,-452
2018,12,29,18,550,565,140,-425
2018,12,29,19,533,541,128,-413
2018,12,29,20,519,528,125,-403
2018,12,29,21,519,529,127,-402
2018,12,29,22,529,535,143,-392
2018,12,29,23,570,587,202,-385
2018,12,30,0,600,622,159,-463
2018,12,30,1,601,622,130,-492
2018,12,30,2,595,618,130,-488
2018,12,30,3,578,607,131,-476
2018,12,30,4,551,584,131,-453
2018,12,30,5,516,544,127,-417
2018,12,30,6,497,516,128,-388
2018,12,30,7,480,495,124,-371
2018,12,30,8,479,488,131,-357
2018,12,30,9,476,485,132,-353
2018,12,30,10,488,495,134,-361
2018,12,30,11,517,501,134,-367
2018,12,30,12,551,531,133,-398
2018,12,30,13,585,571,134,-437
2018,12,30,14,622,613,134,-479
2018,12,30,15,644,616,125,-491
2018,12,30,16,648,614,138,-476
2018,12,30,17,635,596,134,-462
2018,12,30,18,605,585,138,-447
2018,12,30,19,575,569,137,-432
2018,12,30,20,561,549,134,-415
2018,12,30,21,553,540,142,-398
2018,12,30,22,568,556,146,-410
2018,12,30,23,622,592,144,-448
2018,12,31,0,636,619,143,-476
2018,12,31,1,635,610,158,-452
2018,12,31,2,615,607,158,-449
2018,12,31,3,592,582,155,-427
2018,12,31,4,558,549,160,-389
2018,12,31,5,514,515,160,-355
2018,12,31,6,473,467,142,-325
2018,12,31,7,447,459,152,-307
2018,12,31,8,440,452,152,-300
2018,12,31,9,448,449,156,-293
2018,12,31,10,458,451,155,-296
2018,12,31,11,475,478,157,-321
2018,12,31,12,505,521,164,-357
2018,12,31,13,552,550,165,-385
2018,12,31,14,580,569,168,-401
2018,12,31,15,602,582,184,-398
2018,12,31,16,604,583,191,-392
2018,12,31,17,599,577,188,-389
2018,12,31,18,591,565,189,-376
2018,12,31,19,579,551,193,-358
2018,12,31,20,571,546,195,-351
2018,12,31,21,554,538,214,-324
2018,12,31,22,574,549,250,-299
2018,12,31,23,604,578,266,-312
2019,1,1,0,598,595,305,-290
2019,1,1,1,584,575,224,-351
2019,1,1,2,561,531,169,-362
2019,1,1,3,539,507,170,-337
2019,1,1,4,519,479,172,-307
2019,1,1,5,491,448,167,-281
2019,1,1,6,480,430,175,-255
2019,1,1,7,461,414,175,-239
2019,1,1,8,451,398,180,-218
2019,1,1,9,442,389,183,-206
2019,1,1,10,434,398,179,-219
2019,1,1,11,443,408,175,-233
2019,1,1,12,454,430,177,-253
2019,1,1,13,490,457,179,-278
2019,1,1,14,517,486,180,-306
2019,1,1,15,551,526,183,-343
2019,1,1,16,560,549,182,-367
2019,1,1,17,560,553,179,-374
2019,1,1,18,567,556,183,-373
2019,1,1,19,559,543,180,-363
2019,1,1,20,548,533,184,-349
2019,1,1,21,542,528,180,-348
2019,1,1,22,560,538,181,-357
2019,1,1,23,588,582,192,-390
2019,1,2,0,619,609,216,-393
2019,1,2,1,611,602,215,-387
2019,1,2,2,585,596,183,-413
2019,1,2,3,565,567,178,-389
2019,1,2,4,535,540,179,-361
2019,1,2,5,504,514,178,-336
2019,1,2,6,484,489,175,-314
2019,1,2,7,481,483,180,-303
2019,1,2,8,483,483,175,-308
2019,1,2,9,500,490,178,-312
2019,1,2,10,517,508,177,-331
2019,1,2,11,545,546,177,-369
2019,1,2,12,618,615,178,-437
2019,1,2,13,656,642,169,-473
2019,1,2,14,678,657,162,-495
2019,1,2,15,676,661,167,-494
2019,1,2,16,663,654,161,-493
2019,1,2,17,652,646,174,-472
2019,1,2,18,628,634,202,-432
2019,1,2,19,621,623,202,-421
2019,1,2,20,604,618,236,-382
2019,1,2,21,600,613,240,-373
2019,1,2,22,611,633,293,-340
2019,1,2,23,663,669,304,-365
2019,1,3,0,695,687,348,-339
2019,1,3,1,690,685,379,-306
2019,1,3,2,675,672,265,-407
2019,1,3,3,639,623,187,-436
2019,1,3,4,599,578,183,-395
2019,1,3,5,544,535,177,-358
2019,1,3,6,505,511,180,-331
2019,1,3,7,501,494,178,-316
2019,1,3,8,506,488,179,-309
2019,1,3,9,508,486,180,-306
2019,1,3,10,516,495,179,-316
2019,1,3,11,550,532,178,-354
2019,1,3,12,598,597,180,-417
2019,1,3,13,649,629,179,-450
2019,1,3,14,644,637,180,-457
2019,1,3,15,637,638,179,-459
2019,1,3,16,631,636,179,-457
2019,1,3,17,624,600,152,-448
2019,1,3,18,615,617,181,-436
2019,1,3,19,600,604,179,-425
2019,1,3,20,580,587,178,-409
2019,1,3,21,590,584,180,-404
2019,1,3,22,600,594,178,-416
2019,1,3,23,639,632,179,-453
2019,1,4,0,678,664,180,-484
2019,1,4,1,674,658,179,-479
2019,1,4,2,660,645,179,-466
2019,1,4,3,633,614,180,-434
2019,1,4,4,596,568,176,-392
2019,1,4,5,543,532,180,-352
2019,1,4,6,524,502,177,-325
2019,1,4,7,514,489,181,-308
2019,1,4,8,514,483,179,-304
2019,1,4,9,526,491,181,-310
2019,1,4,10,535,494,183,-311
2019,1,4,11,580,529,182,-347
2019,1,4,12,656,590,182,-408
2019,1,4,13,688,623,181,-442
2019,1,4,14,678,633,180,-453
2019,1,4,15,677,643,173,-470
2019,1,4,16,669,656,135,-521
2019,1,4,17,656,635,116,-519
2019,1,4,18,648,632,172,-460
2019,1,4,19,633,627,178,-449
2019,1,4,20,631,609,181,-428
2019,1,4,21,618,607,182,-425
2019,1,4,22,641,608,179,-429
2019,1,4,23,676,639,181,-458
2019,1,5,0,702,648,183,-465
2019,1,5,1,690,634,180,-454
2019,1,5,2,674,625,182,-443
2019,1,5,3,648,610,182,-428
2019,1,5,4,604,586,178,-408
2019,1,5,5,552,555,176,-379
2019,1,5,6,535,539,180,-359
2019,1,5,7,523,524,179,-345
2019,1,5,8,526,527,183,-344
2019,1,5,9,533,529,181,-348
2019,1,5,10,547,541,181,-360
2019,1,5,11,582,564,178,-386
2019,1,5,12,641,603,182,-421
2019,1,5,13,673,641,181,-460
2019,1,5,14,702,672,180,-492
2019,1,5,15,709,673,173,-500
2019,1,5,16,675,655,187,-468
2019,1,5,17,637,628,199,-429
2019,1,5,18,599,602,194,-408
2019,1,5,19,574,580,200,-380
2019,1,5,20,552,561,195,-366
2019,1,5,21,552,560,202,-358
2019,1,5,22,566,575,200,-375
2019,1,5,23,606,616,212,-404
2019,1,6,0,639,658,230,-428
2019,1,6,1,643,654,225,-429
2019,1,6,2,641,653,228,-425
2019,1,6,3,622,633,226,-407
2019,1,6,4,603,614,224,-390
2019,1,6,5,574,586,208,-378
2019,1,6,6,565,563,203,-360
2019,1,6,7,555,559,204,-355
2019,1,6,8,551,557,205,-352
2019,1,6,9,551,565,206,-359
2019,1,6,10,560,582,206,-376
2019,1,6,11,573,609,206,-403
2019,1,6,12,607,642,206,-436
2019,1,6,13,653,677,205,-472
2019,1,6,14,690,717,209,-508
2019,1,6,15,686,691,207,-484
2019,1,6,16,630,639,207,-432
2019,1,6,17,591,587,210,-377
2019,1,6,18,569,555,209,-346
2019,1,6,19,551,533,209,-324
2019,1,6,20,536,513,208,-305
2019,1,6,21,526,511,210,-301
2019,1,6,22,534,523,208,-315
2019,1,6,23,575,569,207,-362
2019,1,7,0,618,612,203,-409
2019,1,7,1,619,613,199,-414
2019,1,7,2,607,615,204,-411
2019,1,7,3,586,586,200,-386
2019,1,7,4,550,552,200,-352
2019,1,7,5,497,520,201,-319
2019,1,7,6,477,501,203,-298
2019,1,7,7,472,488,199,-289
2019,1,7,8,479,490,199,-291
2019,1,7,9,492,499,201,-298
2019,1,7,10,500,519,201,-318
2019,1,7,11,547,563,197,-366
2019,1,7,12,632,641,197,-444
2019,1,7,13,673,671,197,-474
2019,1,7,14,672,669,196,-473
2019,1,7,15,667,643,207,-436
2019,1,7,16,660,611,233,-378
2019,1,7,17,653,586,237,-349
2019,1,7,18,631,574,246,-328
2019,1,7,19,617,557,243,-314
2019,1,7,20,606,549,247,-302
2019,1,7,21,598,547,242,-305
2019,1,7,22,610,563,243,-320
2019,1,7,23,645,608,242,-366
2019,1,8,0,687,655,242,-413
2019,1,8,1,685,656,242,-414
2019,1,8,2,672,634,240,-394
2019,1,8,3,641,603,241,-362
2019,1,8,4,594,564,241,-323
2019,1,8,5,552,530,239,-291
2019,1,8,6,522,495,180,-315
2019,1,8,7,516,480,178,-302
2019,1,8,8,518,476,178,-298
2019,1,8,9,524,482,178,-304
2019,1,8,10,536,499,179,-320
2019,1,8,11,574,538,177,-361
2019,1,8,12,654,617,179,-438
2019,1,8,13,688,646,235,-411
2019,1,8,14,675,647,232,-415
2019,1,8,15,662,630,207,-423
2019,1,8,16,625,588,180,-408
2019,1,8,17,602,585,181,-404
2019,1,8,18,596,560,178,-382
2019,1,8,19,584,555,172,-383
2019,1,8,20,572,540,178,-362
2019,1,8,21,573,539,180,-359
2019,1,8,22,574,549,179,-370
2019,1,8,23,588,586,178,-408
2019,1,9,0,644,624,178,-446
2019,1,9,1,656,620,176,-444
2019,1,9,2,648,610,180,-430
2019,1,9,3,622,580,180,-400
2019,1,9,4,580,542,180,-362
2019,1,9,5,568,511,180,-331
2019,1,9,6,558,504,180,-324
2019,1,9,7,555,510,179,-331
2019,1,9,8,558,523,180,-343
2019,1,9,9,572,542,179,-363
2019,1,9,10,598,575,181,-394
2019,1,9,11,644,628,179,-449
2019,1,9,12,730,704,185,-519
2019,1,9,13,777,745,282,-463
2019,1,9,14,785,668,248,-420
2019,1,9,15,771,722,227,-495
2019,1,9,16,735,694,152,-542
2019,1,9,17,713,673,183,-490
2019,1,9,18,689,651,183,-468
2019,1,9,19,670,635,184,-451
2019,1,9,20,664,622,186,-436
2019,1,9,21,666,626,185,-441
2019,1,9,22,688,655,184,-471
2019,1,9,23,745,712,282,-430
2019,1,10,0,809,771,385,-386
2019,1,10,1,828,791,441,-350
2019,1,10,2,822,790,432,-358
2019,1,10,3,804,776,406,-370
2019,1,10,4,775,743,402,-341
2019,1,10,5,751,728,326,-402
2019,1,10,6,732,700,218,-482
2019,1,10,7,741,703,214,-489
2019,1,10,8,752,707,213,-494
2019,1,10,9,766,728,214,-514
2019,1,10,10,804,746,212,-534
2019,1,10,11,841,788,312,-476
2019,1,10,12,929,870,470,-400
2019,1,10,13,969,922,515,-407
2019,1,10,14,958,913,549,-364
2019,1,10,15,926,880,625,-255
2019,1,10,16,858,837,515,-322
2019,1,10,17,811,809,379,-430
2019,1,10,18,771,768,254,-514
2019,1,10,19,733,730,194,-536
2019,1,10,20,712,700,182,-518
2019,1,10,21,700,700,183,-517
2019,1,10,22,729,721,263,-458
2019,1,10,23,794,796,403,-393
2019,1,11,0,857,855,487,-368
2019,1,11,1,872,864,516,-348
2019,1,11,2,868,820,514,-306
2019,1,11,3,845,801,516,-285
2019,1,11,4,803,786,445,-341
2019,1,11,5,777,756,448,-308
2019,1,11,6,773,743,446,-297
2019,1,11,7,780,752,432,-320
2019,1,11,8,796,757,306,-451
2019,1,11,9,803,764,238,-526
2019,1,11,10,839,787,237,-550
2019,1,11,11,876,835,308,-527
2019,1,11,12,963,910,497,-413
2019,1,11,13,1002,963,581,-382
2019,1,11,14,989,947,529,-418
2019,1,11,15,949,888,503,-385
2019,1,11,16,876,801,454,-347
2019,1,11,17,802,737,443,-294
2019,1,11,18,748,712,275,-437
2019,1,11,19,707,658,191,-467
2019,1,11,20,680,625,183,-442
2019,1,11,21,665,615,186,-429
2019,1,11,22,689,636,236,-400
2019,1,11,23,744,676,248,-428
2019,1,12,0,796,716,376,-340
2019,1,12,1,806,731,440,-291
2019,1,12,2,806,716,435,-281
2019,1,12,3,784,692,437,-255
2019,1,12,4,740,673,336,-337
2019,1,12,5,735,618,237,-381
2019,1,12,6,673,594,218,-376
2019,1,12,7,663,583,205,-378
2019,1,12,8,660,578,208,-370
2019,1,12,9,664,585,207,-378
2019,1,12,10,696,594,206,-388
2019,1,12,11,727,619,208,-411
2019,1,12,12,756,659,207,-452
2019,1,12,13,810,690,209,-481
2019,1,12,14,846,728,208,-520
2019,1,12,15,855,753,209,-544
2019,1,12,16,848,756,207,-549
2019,1,12,17,792,753,208,-545
2019,1,12,18,742,751,227,-524
2019,1,12,19,700,739,232,-507
2019,1,12,20,682,739,231,-508
2019,1,12,21,695,749,211,-538
2019,1,12,22,704,758,231,-527
2019,1,12,23,740,791,237,-554
2019,1,13,0,782,799,265,-534
2019,1,13,1,775,790,279,-511
2019,1,13,2,759,783,257,-526
2019,1,13,3,731,744,222,-522
2019,1,13,4,704,719,200,-519
2019,1,13,5,671,680,176,-504
2019,1,13,6,645,654,179,-475
2019,1,13,7,633,638,176,-462
2019,1,13,8,624,625,178,-447
2019,1,13,9,620,621,176,-445
2019,1,13,10,623,626,178,-448
2019,1,13,11,663,646,180,-466
2019,1,13,12,696,665,178,-487
2019,1,13,13,738,688,193,-495
2019,1,13,14,783,721,304,-417
2019,1,13,15,796,739,317,-422
2019,1,13,16,753,741,319,-422
2019,1,13,17,710,734,229,-505
2019,1,13,18,691,720,206,-514
2019,1,13,19,671,702,204,-498
2019,1,13,20,663,690,205,-485
2019,1,13,21,651,693,207,-486
2019,1,13,22,653,686,258,-428
2019,1,13,23,719,714,410,-304
2019,1,14,0,773,745,451,-294
2019,1,14,1,784,735,422,-313
2019,1,14,2,772,712,375,-337
2019,1,14,3,741,685,322,-363
2019,1,14,4,718,633,231,-402
2019,1,14,5,676,595,182,-413
2019,1,14,6,657,559,172,-387
2019,1,14,7,658,555,177,-378
2019,1,14,8,668,550,177,-373
2019,1,14,9,674,555,172,-383
2019,1,14,10,701,578,181,-397
2019,1,14,11,722,624,178,-446
2019,1,14,12,784,700,186,-514
2019,1,14,13,825,734,300,-434
2019,1,14,14,833,760,285,-475
2019,1,14,15,828,738,238,-500
2019,1,14,16,801,729,203,-526
2019,1,14,17,779,710,194,-516
2019,1,14,18,754,702,192,-510
2019,1,14,19,732,691,204,-487
2019,1,14,20,715,677,203,-474
2019,1,14,21,712,692,189,-503
2019,1,14,22,728,711,182,-529
2019,1,14,23,769,753,226,-527
2019,1,15,0,827,778,349,-429
2019,1,15,1,835,784,441,-343
2019,1,15,2,826,777,449,-328
2019,1,15,3,805,742,447,-295
2019,1,15,4,773,709,422,-287
2019,1,15,5,749,673,257,-416
2019,1,15,6,635,637,190,-447
2019,1,15,7,635,643,191,-452
2019,1,15,8,641,649,187,-462
2019,1,15,9,656,660,188,-472
2019,1,15,10,670,681,184,-497
2019,1,15,11,719,715,255,-460
2019,1,15,12,790,799,414,-385
2019,1,15,13,837,838,444,-394
2019,1,15,14,848,851,362,-489
2019,1,15,15,819,831,307,-524
2019,1,15,16,780,822,281,-541
2019,1,15,17,745,791,250,-541
2019,1,15,18,719,744,214,-530
2019,1,15,19,693,695,189,-506
2019,1,15,20,670,663,183,-480
2019,1,15,21,660,659,178,-481
2019,1,15,22,681,682,201,-481
2019,1,15,23,738,742,240,-502
2019,1,16,0,794,816,310,-506
2019,1,16,1,808,831,336,-495
2019,1,16,2,800,838,343,-495
2019,1,16,3,770,816,341,-475
2019,1,16,4,726,782,335,-447
2019,1,16,5,693,753,295,-458
2019,1,16,6,669,742,265,-477
2019,1,16,7,668,739,253,-486
2019,1,16,8,673,742,253,-489
2019,1,16,9,678,749,264,-485
2019,1,16,10,699,771,270,-501
2019,1,16,11,738,804,388,-416
2019,1,16,12,815,888,474,-414
2019,1,16,13,862,923,515,-408
2019,1,16,14,859,909,518,-391
2019,1,16,15,816,874,504,-370
2019,1,16,16,755,823,417,-406
2019,1,16,17,707,755,358,-397
2019,1,16,18,667,704,248,-456
2019,1,16,19,643,664,181,-483
2019,1,16,20,620,634,180,-454
2019,1,16,21,614,632,179,-453
2019,1,16,22,624,666,182,-484
2019,1,16,23,671,724,179,-545
2019,1,17,0,723,781,235,-546
2019,1,17,1,732,792,239,-553
2019,1,17,2,729,781,239,-542
2019,1,17,3,703,752,231,-521
2019,1,17,4,661,710,212,-498
2019,1,17,5,620,673,188,-485
2019,1,17,6,631,652,181,-471
2019,1,17,7,633,650,180,-470
2019,1,17,8,641,654,181,-473
2019,1,17,9,649,657,180,-477
2019,1,17,10,664,670,206,-464
2019,1,17,11,705,713,312,-401
2019,1,17,12,782,792,411,-381
2019,1,17,13,824,832,428,-404
2019,1,17,14,821,827,364,-463
2019,1,17,15,798,812,327,-485
2019,1,17,16,762,781,262,-519
2019,1,17,17,737,746,208,-538
2019,1,17,18,702,741,177,-564
2019,1,17,19,676,746,189,-557
2019,1,17,20,667,747,187,-560
2019,1,17,21,663,756,203,-553
2019,1,17,22,687,757,322,-435
2019,1,17,23,730,795,395,-400
2019,1,18,0,764,812,431,-381
2019,1,18,1,752,804,427,-377
2019,1,18,2,745,775,400,-375
2019,1,18,3,716,740,363,-377
2019,1,18,4,669,694,266,-428
2019,1,18,5,616,645,196,-449
2019,1,18,6,569,613,182,-431
2019,1,18,7,560,598,181,-417
2019,1,18,8,561,595,182,-413
2019,1,18,9,566,598,182,-416
2019,1,18,10,591,614,182,-432
2019,1,18,11,625,642,237,-405
2019,1,18,12,700,715,361,-354
2019,1,18,13,736,755,442,-313
2019,1,18,14,727,758,328,-430
2019,1,18,15,710,734,192,-542
2019,1,18,16,686,704,181,-523
2019,1,18,17,645,670,180,-490
2019,1,18,18,618,648,186,-462
2019,1,18,19,595,634,184,-450
2019,1,18,20,584,617,183,-434
2019,1,18,21,576,610,182,-428
2019,1,18,22,596,606,247,-359
2019,1,18,23,630,645,358,-287
2019,1,19,0,680,682,430,-252
2019,1,19,1,688,682,450,-232
2019,1,19,2,678,667,450,-217
2019,1,19,3,670,645,445,-200
2019,1,19,4,640,625,360,-265
2019,1,19,5,608,577,242,-335
2019,1,19,6,542,557,207,-350
2019,1,19,7,527,541,186,-355
2019,1,19,8,524,533,184,-349
2019,1,19,9,525,531,184,-347
2019,1,19,10,530,536,184,-352
2019,1,19,11,544,553,183,-370
2019,1,19,12,578,578,183,-395
2019,1,19,13,609,614,185,-429
2019,1,19,14,644,641,182,-459
2019,1,19,15,656,665,183,-482
2019,1,19,16,670,669,184,-485
2019,1,19,17,645,665,181,-484
2019,1,19,18,610,661,185,-476
2019,1,19,19,583,650,182,-468
2019,1,19,20,573,646,183,-463
2019,1,19,21,571,643,181,-462
2019,1,19,22,586,654,183,-471
2019,1,19,23,601,673,183,-490
2019,1,20,0,638,670,182,-488
2019,1,20,1,638,650,185,-465
2019,1,20,2,631,624,183,-441
2019,1,20,3,608,591,184,-407
2019,1,20,4,584,554,184,-370
2019,1,20,5,563,521,186,-335
2019,1,20,6,560,494,182,-312
2019,1,20,7,552,479,184,-295
2019,1,20,8,547,477,185,-292
2019,1,20,9,555,487,186,-301
2019,1,20,10,564,511,185,-326
2019,1,20,11,595,555,184,-371
2019,1,20,12,628,615,184,-431
2019,1,20,13,679,687,185,-502
2019,1,20,14,715,775,220,-555
2019,1,20,15,744,831,301,-530
2019,1,20,16,746,857,323,-534
2019,1,20,17,742,862,321,-541
2019,1,20,18,731,857,326,-531
2019,1,20,19,727,833,280,-553
2019,1,20,20,725,828,222,-606
2019,1,20,21,736,794,147,-647
2019,1,20,22,774,799,172,-627
2019,1,20,23,818,858,352,-506
2019,1,21,0,868,933,460,-473
2019,1,21,1,875,945,468,-477
2019,1,21,2,874,940,471,-469
2019,1,21,3,869,919,502,-417
2019,1,21,4,849,914,520,-394
2019,1,21,5,829,891,519,-372
2019,1,21,6,837,897,506,-391
2019,1,21,7,841,904,426,-478
2019,1,21,8,849,913,409,-504
2019,1,21,9,864,939,424,-515
2019,1,21,10,908,978,547,-431
2019,1,21,11,954,1022,571,-451
2019,1,21,12,1010,1074,593,-481
2019,1,21,13,1056,1112,593,-519
2019,1,21,14,1070,1121,589,-532
2019,1,21,15,1045,1100,597,-503
2019,1,21,16,972,1051,575,-476
2019,1,21,17,912,984,529,-455
2019,1,21,18,854,934,493,-441
2019,1,21,19,790,879,437,-442
2019,1,21,20,769,844,434,-410
2019,1,21,21,747,823,415,-408
2019,1,21,22,762,841,417,-424
2019,1,21,23,850,885,494,-391
2019,1,22,0,928,951,517,-434
2019,1,22,1,935,955,518,-437
2019,1,22,2,939,938,515,-423
2019,1,22,3,912,922,519,-403
2019,1,22,4,881,884,517,-367
2019,1,22,5,844,852,516,-336
2019,1,22,6,851,834,512,-322
2019,1,22,7,860,838,518,-320
2019,1,22,8,872,837,519,-318
2019,1,22,9,893,836,517,-319
2019,1,22,10,913,856,518,-338
2019,1,22,11,945,901,519,-382
2019,1,22,12,990,958,514,-444
2019,1,22,13,1023,998,590,-408
2019,1,22,14,1030,973,571,-402
2019,1,22,15,975,914,513,-401
2019,1,22,16,901,875,446,-429
2019,1,22,17,847,821,360,-461
2019,1,22,18,790,779,280,-499
2019,1,22,19,755,735,248,-487
2019,1,22,20,717,705,218,-487
2019,1,22,21,712,704,213,-491
2019,1,22,22,721,737,213,-524
2019,1,22,23,777,776,290,-486
2019,1,23,0,839,817,374,-443
2019,1,23,1,856,819,394,-425
2019,1,23,2,840,807,394,-413
2019,1,23,3,806,769,394,-375
2019,1,23,4,760,720,380,-340
2019,1,23,5,716,706,312,-394
2019,1,23,6,640,669,222,-447
2019,1,23,7,625,655,174,-481
2019,1,23,8,622,657,181,-476
2019,1,23,9,626,662,180,-482
2019,1,23,10,642,668,217,-451
2019,1,23,11,689,706,352,-354
2019,1,23,12,764,765,403,-362
2019,1,23,13,806,796,414,-382
2019,1,23,14,779,800,299,-501
2019,1,23,15,759,775,241,-534
2019,1,23,16,723,751,237,-514
2019,1,23,17,696,740,208,-532
2019,1,23,18,662,725,189,-536
2019,1,23,19,644,714,179,-535
2019,1,23,20,625,691,182,-509
2019,1,23,21,614,681,182,-499
2019,1,23,22,625,690,181,-509
2019,1,23,23,642,711,182,-529
2019,1,24,0,695,722,204,-518
2019,1,24,1,697,706,205,-501
2019,1,24,2,691,680,205,-475
2019,1,24,3,667,638,206,-432
2019,1,24,4,631,593,187,-406
2019,1,24,5,600,538,177,-361
2019,1,24,6,585,509,176,-333
2019,1,24,7,587,490,175,-315
2019,1,24,8,586,480,174,-306
2019,1,24,9,590,479,177,-302
2019,1,24,10,607,496,176,-320
2019,1,24,11,659,529,175,-354
2019,1,24,12,736,605,178,-427
2019,1,24,13,777,648,177,-471
2019,1,24,14,776,663,178,-485
2019,1,24,15,765,672,178,-494
2019,1,24,16,742,684,179,-505
2019,1,24,17,722,671,181,-490
2019,1,24,18,714,660,179,-481
2019,1,24,19,683,664,182,-482
2019,1,24,20,672,662,181,-481
2019,1,24,21,671,669,180,-489
2019,1,24,22,686,699,178,-521
2019,1,24,23,740,762,244,-518
2019,1,25,0,792,836,291,-545
2019,1,25,1,816,852,301,-551
2019,1,25,2,814,854,310,-544
2019,1,25,3,794,833,297,-536
2019,1,25,4,755,794,263,-531
2019,1,25,5,728,765,223,-542
2019,1,25,6,716,747,217,-530
2019,1,25,7,715,742,215,-527
2019,1,25,8,725,746,219,-527
2019,1,25,9,738,749,218,-531
2019,1,25,10,765,758,241,-517
2019,1,25,11,809,800,380,-420
2019,1,25,12,876,881,490,-391
2019,1,25,13,920,922,500,-422
2019,1,25,14,921,911,500,-411
2019,1,25,15,893,873,502,-371
2019,1,25,16,838,830,506,-324
2019,1,25,17,797,784,436,-348
2019,1,25,18,766,750,394,-356
2019,1,25,19,747,724,369,-355
2019,1,25,20,727,697,365,-332
2019,1,25,21,721,685,362,-323
2019,1,25,22,741,708,365,-343
2019,1,25,23,783,753,389,-364
2019,1,26,0,835,815,418,-397
2019,1,26,1,849,830,431,-399
2019,1,26,2,853,835,426,-409
2019,1,26,3,843,822,430,-392
2019,1,26,4,822,807,434,-373
2019,1,26,5,821,787,429,-358
2019,1,26,6,807,772,425,-347
2019,1,26,7,815,776,433,-343
2019,1,26,8,823,784,430,-354
2019,1,26,9,837,801,409,-392
2019,1,26,10,851,826,420,-406
2019,1,26,11,874,848,431,-417
2019,1,26,12,907,895,467,-428
2019,1,26,13,938,932,460,-472
2019,1,26,14,958,949,463,-486
2019,1,26,15,928,905,460,-445
2019,1,26,16,884,854,370,-484
2019,1,26,17,832,786,284,-502
2019,1,26,18,786,728,254,-474
2019,1,26,19,734,688,245,-443
2019,1,26,20,689,671,243,-428
2019,1,26,21,693,653,236,-417
2019,1,26,22,704,671,248,-423
2019,1,26,23,740,712,246,-466
2019,1,27,0,808,764,245,-519
2019,1,27,1,825,786,231,-555
2019,1,27,2,820,789,230,-559
2019,1,27,3,808,778,250,-528
2019,1,27,4,783,762,258,-504
2019,1,27,5,749,746,256,-490
2019,1,27,6,725,739,254,-485
2019,1,27,7,727,745,246,-499
2019,1,27,8,732,749,245,-504
2019,1,27,9,740,766,248,-518
2019,1,27,10,747,779,247,-532
2019,1,27,11,770,800,254,-546
2019,1,27,12,798,832,293,-539
2019,1,27,13,834,865,399,-466
2019,1,27,14,859,903,428,-475
2019,1,27,15,849,888,395,-493
2019,1,27,16,793,839,341,-498
2019,1,27,17,744,759,345,-414
2019,1,27,18,708,714,300,-414
2019,1,27,19,680,690,281,-409
2019,1,27,20,665,672,276,-396
2019,1,27,21,657,661,274,-387
2019,1,27,22,662,675,279,-396
2019,1,27,23,708,706,297,-409
2019,1,28,0,763,753,306,-447
2019,1,28,1,776,763,298,-465
2019,1,28,2,773,761,267,-494
2019,1,28,3,754,736,254,-482
2019,1,28,4,729,709,256,-453
2019,1,28,5,688,685,252,-433
2019,1,28,6,617,676,253,-423
2019,1,28,7,618,681,252,-429
2019,1,28,8,623,695,255,-440
2019,1,28,9,637,716,254,-462
2019,1,28,10,663,742,264,-478
2019,1,28,11,707,801,323,-478
2019,1,28,12,781,869,343,-526
2019,1,28,13,826,926,417,-509
2019,1,28,14,826,911,397,-514
2019,1,28,15,788,848,397,-451
2019,1,28,16,754,781,339,-442
2019,1,28,17,721,726,296,-430
2019,1,28,18,679,673,251,-422
2019,1,28,19,659,644,251,-393
2019,1,28,20,633,626,227,-399
2019,1,28,21,623,618,179,-439
2019,1,28,22,626,637,181,-456
2019,1,28,23,673,673,198,-475
2019,1,29,0,728,738,237,-501
2019,1,29,1,742,738,252,-486
2019,1,29,2,734,728,309,-419
2019,1,29,3,712,701,293,-408
2019,1,29,4,672,656,229,-427
2019,1,29,5,644,609,184,-425
2019,1,29,6,600,587,182,-405
2019,1,29,7,582,571,182,-389
2019,1,29,8,579,579,185,-394
2019,1,29,9,584,580,182,-398
2019,1,29,10,605,593,182,-411
2019,1,29,11,650,626,198,-428
2019,1,29,12,708,674,335,-339
2019,1,29,13,754,735,392,-343
2019,1,29,14,750,739,384,-355
2019,1,29,15,755,766,356,-410
2019,1,29,16,758,780,276,-504
2019,1,29,17,767,796,278,-518
2019,1,29,18,772,802,282,-520
2019,1,29,19,781,800,279,-521
2019,1,29,20,794,799,274,-525
2019,1,29,21,815,797,259,-538
2019,1,29,22,829,818,309,-509
2019,1,29,23,868,856,368,-488
2019,1,30,0,911,937,502,-435
2019,1,30,1,940,958,514,-444
2019,1,30,2,943,957,447,-510
2019,1,30,3,930,925,398,-527
2019,1,30,4,916,894,397,-497
2019,1,30,5,894,866,372,-494
2019,1,30,6,887,860,339,-521
2019,1,30,7,892,857,320,-537
2019,1,30,8,901,866,321,-545
2019,1,30,9,924,869,342,-527
2019,1,30,10,957,893,354,-539
2019,1,30,11,996,924,418,-506
2019,1,30,12,1041,998,506,-492
2019,1,30,13,1074,1047,578,-469
2019,1,30,14,1083,1050,562,-488
2019,1,30,15,1063,975,425,-550
2019,1,30,16,1019,909,364,-545
2019,1,30,17,959,869,345,-524
2019,1,30,18,916,843,321,-522
2019,1,30,19,869,822,262,-560
2019,1,30,20,848,794,259,-535
2019,1,30,21,838,783,258,-525
2019,1,30,22,852,808,259,-549
2019,1,30,23,896,864,347,-517
2019,1,31,0,958,927,441,-486
2019,1,31,1,967,955,581,-374
2019,1,31,2,968,946,512,-434
2019,1,31,3,960,930,493,-437
2019,1,31,4,950,896,444,-452
2019,1,31,5,941,869,427,-442
2019,1,31,6,879,848,381,-467
2019,1,31,7,884,850,448,-402
2019,1,31,8,902,861,509,-352
2019,1,31,9,915,881,515,-366
2019,1,31,10,944,903,513,-390
2019,1,31,11,985,949,531,-418
2019,1,31,12,1049,1008,580,-428
2019,1,31,13,1085,1038,576,-462
2019,1,31,14,1075,1014,583,-431
2019,1,31,15,1014,974,522,-452
2019,1,31,16,949,932,483,-449
2019,1,31,17,875,877,360,-517
2019,1,31,18,825,815,273,-542
2019,1,31,19,771,775,245,-530
2019,1,31,20,733,733,209,-524
2019,1,31,21,719,715,192,-523
2019,1,31,22,728,734,194,-540
2019,1,31,23,781,771,224,-547
2019,2,1,0,839,833,291,-542
2019,2,1,1,856,863,345,-518
2019,2,1,2,853,866,353,-513
2019,2,1,3,829,843,353,-490
2019,2,1,4,791,811,331,-480
2019,2,1,5,766,778,266,-512
2019,2,1,6,758,757,254,-503
2019,2,1,7,757,754,226,-528
2019,2,1,8,774,752,193,-559
2019,2,1,9,781,751,221,-530
2019,2,1,10,811,759,328,-431
2019,2,1,11,830,788,436,-352
2019,2,1,12,902,827,447,-380
2019,2,1,13,931,862,445,-417
2019,2,1,14,913,831,440,-391
2019,2,1,15,866,829,382,-447
2019,2,1,16,828,784,272,-512
2019,2,1,17,758,743,200,-543
2019,2,1,18,708,704,193,-511
2019,2,1,19,688,664,203,-461
2019,2,1,20,660,626,196,-430
2019,2,1,21,638,617,193,-424
2019,2,1,22,640,639,193,-446
2019,2,1,23,672,670,192,-478
2019,2,2,0,716,705,193,-512
2019,2,2,1,719,706,191,-515
2019,2,2,2,733,689,190,-499
2019,2,2,3,717,671,192,-479
2019,2,2,4,696,642,197,-445
2019,2,2,5,659,614,192,-422
2019,2,2,6,610,594,192,-402
2019,2,2,7,597,598,193,-405
2019,2,2,8,589,603,193,-410
2019,2,2,9,594,619,194,-425
2019,2,2,10,600,642,209,-433
2019,2,2,11,636,670,213,-457
2019,2,2,12,682,703,241,-462
2019,2,2,13,710,738,359,-379
2019,2,2,14,739,767,349,-418
2019,2,2,15,727,745,233,-512
2019,2,2,16,686,682,216,-466
2019,2,2,17,631,627,219,-408
2019,2,2,18,598,586,220,-366
2019,2,2,19,572,555,195,-360
2019,2,2,20,548,537,129,-408
2019,2,2,21,542,523,121,-402
2019,2,2,22,550,531,121,-410
2019,2,2,23,583,555,123,-432
2019,2,3,0,624,596,121,-475
2019,2,3,1,632,611,123,-488
2019,2,3,2,625,611,120,-491
2019,2,3,3,601,608,124,-484
2019,2,3,4,579,588,120,-468
2019,2,3,5,541,573,120,-453
2019,2,3,6,530,566,120,-446
2019,2,3,7,520,567,120,-447
2019,2,3,8,519,573,121,-452
2019,2,3,9,519,585,119,-466
2019,2,3,10,518,604,120,-484
2019,2,3,11,548,605,123,-482
2019,2,3,12,582,649,209,-440
2019,2,3,13,632,693,233,-460
2019,2,3,14,678,727,236,-491
2019,2,3,15,688,726,234,-492
2019,2,3,16,664,682,195,-487
2019,2,3,17,637,622,159,-463
2019,2,3,18,605,578,121,-457
2019,2,3,19,576,546,121,-425
2019,2,3,20,565,527,121,-406
2019,2,3,21,557,527,120,-407
2019,2,3,22,556,538,120,-418
2019,2,3,23,594,565,129,-436
2019,2,4,0,623,598,149,-449
2019,2,4,1,617,599,151,-448
2019,2,4,2,613,595,148,-447
2019,2,4,3,605,588,151,-437
2019,2,4,4,586,580,151,-429
2019,2,4,5,540,558,152,-406
2019,2,4,6,508,544,152,-392
2019,2,4,7,508,548,151,-397
2019,2,4,8,510,565,144,-421
2019,2,4,9,516,580,124,-456
2019,2,4,10,530,611,124,-487
2019,2,4,11,571,653,194,-459
2019,2,4,12,658,750,222,-528
2019,2,4,13,695,794,252,-542
2019,2,4,14,693,776,260,-516
2019,2,4,15,669,726,263,-463
2019,2,4,16,638,671,234,-437
2019,2,4,17,606,615,135,-480
2019,2,4,18,581,588,128,-460
2019,2,4,19,568,569,129,-440
2019,2,4,20,548,547,128,-419
2019,2,4,21,545,546,128,-418
2019,2,4,22,551,564,129,-435
2019,2,4,23,580,589,126,-463
2019,2,5,0,634,629,127,-502
2019,2,5,1,645,632,127,-505
2019,2,5,2,637,615,128,-487
2019,2,5,3,602,586,125,-461
2019,2,5,4,560,544,127,-417
2019,2,5,5,524,511,127,-384
2019,2,5,6,483,488,126,-362
2019,2,5,7,478,477,126,-351
2019,2,5,8,478,475,126,-349
2019,2,5,9,481,485,126,-359
2019,2,5,10,496,508,129,-379
2019,2,5,11,536,556,127,-429
2019,2,5,12,618,621,156,-465
2019,2,5,13,646,661,264,-397
2019,2,5,14,637,657,259,-398
2019,2,5,15,611,622,155,-467
2019,2,5,16,596,586,101,-485
2019,2,5,17,578,562,117,-445
2019,2,5,18,566,546,135,-411
2019,2,5,19,549,533,136,-397
2019,2,5,20,537,524,136,-388
2019,2,5,21,528,517,149,-368
2019,2,5,22,539,531,195,-336
2019,2,5,23,551,543,198,-345
2019,2,6,0,599,588,227,-361
2019,2,6,1,604,599,226,-373
2019,2,6,2,596,595,175,-420
2019,2,6,3,560,551,126,-425
2019,2,6,4,511,519,127,-392
2019,2,6,5,469,483,126,-357
2019,2,6,6,454,458,123,-335
2019,2,6,7,447,451,125,-326
2019,2,6,8,444,451,125,-326
2019,2,6,9,452,460,126,-334
2019,2,6,10,466,475,125,-350
2019,2,6,11,519,523,128,-395
2019,2,6,12,616,597,126,-471
2019,2,6,13,650,631,105,-526
2019,2,6,14,639,623,89,-534
2019,2,6,15,615,612,91,-521
2019,2,6,16,595,596,91,-505
2019,2,6,17,576,576,92,-484
2019,2,6,18,570,558,92,-466
2019,2,6,19,555,552,93,-459
2019,2,6,20,546,539,92,-447
2019,2,6,21,543,538,122,-416
2019,2,6,22,550,544,129,-415
2019,2,6,23,589,560,125,-435
2019,2,7,0,617,598,140,-458
2019,2,7,1,624,605,151,-454
2019,2,7,2,608,582,126,-456
2019,2,7,3,573,544,125,-419
2019,2,7,4,518,501,126,-375
2019,2,7,5,461,455,125,-330
2019,2,7,6,423,420,120,-300
2019,2,7,7,412,405,122,-283
2019,2,7,8,411,394,125,-269
2019,2,7,9,410,397,124,-273
2019,2,7,10,424,402,120,-282
2019,2,7,11,464,443,124,-319
2019,2,7,12,553,514,123,-391
2019,2,7,13,582,548,122,-426
2019,2,7,14,579,542,122,-420
2019,2,7,15,566,311,123,-188
2019,2,7,16,566,533,126,-407
2019,2,7,17,543,535,126,-409
2019,2,7,18,546,532,128,-404
2019,2,7,19,542,526,126,-400
2019,2,7,20,533,524,127,-397
2019,2,7,21,535,526,126,-400
2019,2,7,22,540,535,123,-412
2019,2,7,23,546,542,124,-418
2019,2,8,0,585,577,140,-437
2019,2,8,1,598,584,153,-431
2019,2,8,2,586,567,128,-439
2019,2,8,3,550,529,124,-405
2019,2,8,4,504,483,124,-359
2019,2,8,5,462,439,123,-316
2019,2,8,6,432,411,123,-288
2019,2,8,7,425,397,125,-272
2019,2,8,8,427,391,124,-267
2019,2,8,9,435,394,126,-268
2019,2,8,10,456,403,126,-277
2019,2,8,11,492,429,123,-306
2019,2,8,12,575,502,124,-378
2019,2,8,13,617,544,125,-419
2019,2,8,14,622,563,126,-437
2019,2,8,15,627,575,127,-448
2019,2,8,16,622,577,130,-447
2019,2,8,17,608,568,129,-439
2019,2,8,18,604,557,131,-426
2019,2,8,19,599,560,129,-431
2019,2,8,20,590,567,129,-438
2019,2,8,21,597,582,129,-453
2019,2,8,22,615,608,130,-478
2019,2,8,23,657,630,120,-510
2019,2,9,0,715,693,217,-476
2019,2,9,1,753,707,223,-484
2019,2,9,2,750,698,219,-479
2019,2,9,3,747,686,220,-466
2019,2,9,4,735,662,221,-441
2019,2,9,5,709,634,223,-411
2019,2,9,6,644,613,222,-391
2019,2,9,7,636,606,179,-427
2019,2,9,8,639,610,185,-425
2019,2,9,9,656,615,209,-406
2019,2,9,10,671,684,210,-474
2019,2,9,11,702,658,210,-448
2019,2,9,12,729,691,208,-483
2019,2,9,13,790,733,206,-527
2019,2,9,14,820,762,209,-553
2019,2,9,15,790,753,210,-543
2019,2,9,16,750,724,209,-515
2019,2,9,17,705,707,210,-497
2019,2,9,18,657,671,191,-480
2019,2,9,19,614,623,183,-440
2019,2,9,20,584,581,185,-396
2019,2,9,21,581,561,185,-376
2019,2,9,22,596,566,185,-381
2019,2,9,23,633,592,185,-407
2019,2,10,0,692,645,213,-432
2019,2,10,1,706,670,235,-435
2019,2,10,2,722,673,237,-436
2019,2,10,3,703,656,236,-420
2019,2,10,4,690,650,223,-427
2019,2,10,5,691,616,178,-438
2019,2,10,6,672,599,178,-421
2019,2,10,7,669,599,179,-420
2019,2,10,8,677,596,177,-419
2019,2,10,9,687,601,178,-423
2019,2,10,10,700,601,179,-422
2019,2,10,11,715,613,177,-436
2019,2,10,12,752,640,194,-446
2019,2,10,13,799,685,237,-448
2019,2,10,14,840,722,235,-487
2019,2,10,15,827,737,239,-498
2019,2,10,16,776,723,244,-479
2019,2,10,17,726,706,243,-463
2019,2,10,18,687,713,239,-474
2019,2,10,19,656,713,196,-517
2019,2,10,20,633,705,179,-526
2019,2,10,21,631,707,180,-527
2019,2,10,22,633,718,179,-539
2019,2,10,23,667,742,233,-509
2019,2,11,0,716,743,279,-464
2019,2,11,1,726,739,399,-340
2019,2,11,2,722,731,377,-354
2019,2,11,3,697,688,235,-453
2019,2,11,4,666,625,199,-426
2019,2,11,5,638,580,188,-392
2019,2,11,6,584,557,187,-370
2019,2,11,7,574,540,184,-356
2019,2,11,8,572,534,186,-348
2019,2,11,9,572,530,181,-349
2019,2,11,10,592,539,184,-355
2019,2,11,11,616,587,240,-347
2019,2,11,12,695,640,248,-392
2019,2,11,13,732,661,346,-315
2019,2,11,14,718,662,379,-283
2019,2,11,15,695,655,351,-304
2019,2,11,16,690,625,335,-290
2019,2,11,17,678,597,334,-263
2019,2,11,18,661,566,291,-275
2019,2,11,19,656,555,272,-283
2019,2,11,20,627,544,206,-338
2019,2,11,21,624,531,188,-343
2019,2,11,22,621,541,199,-342
2019,2,11,23,640,558,235,-323
2019,2,12,0,686,603,269,-334
2019,2,12,1,693,613,269,-344
2019,2,12,2,666,598,229,-369
2019,2,12,3,628,565,188,-377
2019,2,12,4,584,518,183,-335
2019,2,12,5,535,480,182,-298
2019,2,12,6,491,458,182,-276
2019,2,12,7,476,444,179,-265
2019,2,12,8,476,447,183,-264
2019,2,12,9,478,450,183,-267
2019,2,12,10,488,468,180,-288
2019,2,12,11,528,509,180,-329
2019,2,12,12,593,582,198,-384
2019,2,12,13,632,621,283,-338
2019,2,12,14,624,638,271,-367
2019,2,12,15,618,634,189,-445
2019,2,12,16,622,629,177,-452
2019,2,12,17,620,623,185,-438
2019,2,12,18,616,610,181,-429
2019,2,12,19,612,609,184,-425
2019,2,12,20,600,606,179,-427
2019,2,12,21,600,613,181,-432
2019,2,12,22,605,618,239,-379
2019,2,12,23,608,645,293,-352
2019,2,13,0,658,667,296,-371
2019,2,13,1,684,662,291,-371
2019,2,13,2,678,640,290,-350
2019,2,13,3,653,617,283,-334
2019,2,13,4,617,585,211,-374
2019,2,13,5,587,555,188,-367
2019,2,13,6,545,542,180,-362
2019,2,13,7,541,552,182,-370
2019,2,13,8,546,570,182,-388
2019,2,13,9,563,588,182,-406
2019,2,13,10,588,618,183,-435
2019,2,13,11,631,669,181,-488
2019,2,13,12,712,749,203,-546
2019,2,13,13,762,797,271,-526
2019,2,13,14,767,795,261,-534
2019,2,13,15,741,750,192,-558
2019,2,13,16,719,706,179,-527
2019,2,13,17,673,675,182,-493
2019,2,13,18,651,643,181,-462
2019,2,13,19,623,620,186,-434
2019,2,13,20,609,600,187,-413
2019,2,13,21,595,591,184,-407
2019,2,13,22,613,601,186,-415
2019,2,13,23,644,633,216,-417
2019,2,14,0,706,701,302,-399
2019,2,14,1,731,732,332,-400
2019,2,14,2,743,729,361,-368
2019,2,14,3,726,715,365,-350
2019,2,14,4,686,695,312,-383
2019,2,14,5,651,660,219,-441
2019,2,14,6,659,635,181,-454
2019,2,14,7,662,643,183,-460
2019,2,14,8,674,649,184,-465
2019,2,14,9,691,661,183,-478
2019,2,14,10,711,687,184,-503
2019,2,14,11,746,724,243,-481
2019,2,14,12,829,821,398,-423
2019,2,14,13,862,862,420,-442
2019,2,14,14,844,835,421,-414
2019,2,14,15,774,778,384,-394
2019,2,14,16,718,708,231,-477
2019,2,14,17,653,651,184,-467
2019,2,14,18,613,627,185,-442
2019,2,14,19,594,605,185,-420
2019,2,14,20,566,588,190,-398
2019,2,14,21,568,577,183,-394
2019,2,14,22,565,603,185,-418
2019,2,14,23,582,635,185,-450
2019,2,15,0,634,677,185,-492
2019,2,15,1,640,680,187,-493
2019,2,15,2,635,660,184,-476
2019,2,15,3,613,637,185,-452
2019,2,15,4,584,591,186,-405
2019,2,15,5,556,552,188,-364
2019,2,15,6,529,525,182,-343
2019,2,15,7,523,513,185,-328
2019,2,15,8,527,514,184,-330
2019,2,15,9,524,520,184,-336
2019,2,15,10,539,537,185,-352
2019,2,15,11,574,579,186,-393
2019,2,15,12,667,642,186,-456
2019,2,15,13,710,678,255,-423
2019,2,15,14,705,676,188,-488
2019,2,15,15,688,661,183,-478
2019,2,15,16,650,631,182,-449
2019,2,15,17,624,596,183,-413
2019,2,15,18,599,576,182,-394
2019,2,15,19,590,570,186,-384
2019,2,15,20,572,558,183,-375
2019,2,15,21,563,559,181,-378
2019,2,15,22,558,570,179,-391
2019,2,15,23,581,592,180,-412
2019,2,16,0,622,615,180,-435
2019,2,16,1,631,611,178,-433
2019,2,16,2,613,600,180,-420
2019,2,16,3,596,577,178,-399
2019,2,16,4,567,549,180,-369
2019,2,16,5,520,514,179,-335
2019,2,16,6,481,486,176,-310
2019,2,16,7,474,471,177,-294
2019,2,16,8,468,467,179,-288
2019,2,16,9,466,463,176,-287
2019,2,16,10,475,469,179,-290
2019,2,16,11,490,489,178,-311
2019,2,16,12,529,516,177,-339
2019,2,16,13,565,557,180,-377
2019,2,16,14,597,586,177,-409
2019,2,16,15,613,597,180,-417
2019,2,16,16,611,587,181,-406
2019,2,16,17,600,572,181,-391
2019,2,16,18,569,546,180,-366
2019,2,16,19,551,534,181,-353
2019,2,16,20,531,521,179,-342
2019,2,16,21,523,525,181,-344
2019,2,16,22,539,535,178,-357
2019,2,16,23,548,568,177,-391
2019,2,17,0,593,590,222,-368
2019,2,17,1,606,603,244,-359
2019,2,17,2,598,593,214,-379
2019,2,17,3,579,572,190,-382
2019,2,17,4,554,546,187,-359
2019,2,17,5,537,518,187,-331
2019,2,17,6,532,497,186,-311
2019,2,17,7,515,489,186,-303
2019,2,17,8,512,485,183,-302
2019,2,17,9,513,489,181,-308
2019,2,17,10,523,497,183,-314
2019,2,17,11,534,520,184,-336
2019,2,17,12,562,551,182,-369
2019,2,17,13,604,598,183,-415
2019,2,17,14,639,648,185,-463
2019,2,17,15,658,678,184,-494
2019,2,17,16,627,684,184,-500
2019,2,17,17,594,680,185,-495
2019,2,17,18,585,675,186,-489
2019,2,17,19,572,660,184,-476
2019,2,17,20,552,649,183,-466
2019,2,17,21,542,645,183,-462
2019,2,17,22,563,642,184,-458
2019,2,17,23,598,666,185,-481
2019,2,18,0,628,690,184,-506
2019,2,18,1,645,686,183,-503
2019,2,18,2,639,673,184,-489
2019,2,18,3,604,631,183,-448
2019,2,18,4,570,591,184,-407
2019,2,18,5,535,555,184,-371
2019,2,18,6,544,526,182,-344
2019,2,18,7,535,508,180,-328
2019,2,18,8,536,498,181,-317
2019,2,18,9,540,509,184,-325
2019,2,18,10,559,520,184,-336
2019,2,18,11,608,555,185,-370
2019,2,18,12,683,626,190,-436
2019,2,18,13,726,656,293,-363
2019,2,18,14,720,668,379,-289
2019,2,18,15,699,676,330,-346
2019,2,18,16,668,657,222,-435
2019,2,18,17,624,652,186,-466
2019,2,18,18,599,645,186,-459
2019,2,18,19,572,625,182,-443
2019,2,18,20,548,607,187,-420
2019,2,18,21,538,603,187,-416
2019,2,18,22,552,616,186,-430
2019,2,18,23,571,654,184,-470
2019,2,19,0,625,709,190,-519
2019,2,19,1,650,724,262,-462
2019,2,19,2,656,717,316,-401
2019,2,19,3,629,689,287,-402
2019,2,19,4,596,656,243,-413
2019,2,19,5,580,617,198,-419
2019,2,19,6,590,598,185,-413
2019,2,19,7,585,584,185,-399
2019,2,19,8,597,636,183,-453
2019,2,19,9,614,610,182,-428
2019,2,19,10,638,635,177,-458
2019,2,19,11,679,689,201,-488
2019,2,19,12,757,773,283,-490
2019,2,19,13,807,818,417,-401
2019,2,19,14,798,809,440,-369
2019,2,19,15,758,785,442,-343
2019,2,19,16,725,743,442,-301
2019,2,19,17,716,795,442,-353
2019,2,19,18,681,744,411,-333
2019,2,19,19,670,733,332,-401
2019,2,19,20,660,724,314,-410
2019,2,19,21,652,738,316,-422
2019,2,19,22,668,760,312,-448
2019,2,19,23,684,789,318,-471
2019,2,20,0,732,806,364,-442
2019,2,20,1,757,806,437,-369
2019,2,20,2,747,785,444,-341
2019,2,20,3,723,748,398,-350
2019,2,20,4,679,696,369,-327
2019,2,20,5,642,680,302,-378
2019,2,20,6,609,642,199,-443
2019,2,20,7,601,638,197,-441
2019,2,20,8,604,639,203,-436
2019,2,20,9,610,643,201,-442
2019,2,20,10,626,658,201,-457
2019,2,20,11,659,672,268,-404
2019,2,20,12,723,749,417,-332
2019,2,20,13,758,786,430,-356
2019,2,20,14,755,790,435,-355
2019,2,20,15,733,774,435,-339
2019,2,20,16,722,745,432,-313
2019,2,20,17,721,735,424,-311
2019,2,20,18,711,724,403,-321
2019,2,20,19,698,719,402,-317
2019,2,20,20,677,702,400,-302
2019,2,20,21,674,695,358,-337
2019,2,20,22,683,715,350,-365
2019,2,20,23,694,732,345,-387
2019,2,21,0,712,743,345,-398
2019,2,21,1,719,730,347,-383
2019,2,21,2,698,710,347,-363
2019,2,21,3,666,661,345,-316
2019,2,21,4,627,615,342,-273
2019,2,21,5,568,575,290,-285
2019,2,21,6,575,538,253,-285
2019,2,21,7,557,522,249,-273
2019,2,21,8,551,513,249,-264
2019,2,21,9,549,510,251,-259
2019,2,21,10,560,520,253,-267
2019,2,21,11,596,545,240,-305
2019,2,21,12,657,607,303,-304
2019,2,21,13,681,650,412,-238
2019,2,21,14,672,643,417,-226
2019,2,21,15,663,637,412,-225
2019,2,21,16,631,636,378,-258
2019,2,21,17,632,619,273,-346
2019,2,21,18,615,589,249,-340
2019,2,21,19,609,561,248,-313
2019,2,21,20,596,540,244,-296
2019,2,21,21,592,542,249,-293
2019,2,21,22,594,550,245,-305
2019,2,21,23,592,579,248,-331
2019,2,22,0,636,610,248,-362
2019,2,22,1,647,612,246,-366
2019,2,22,2,635,594,247,-347
2019,2,22,3,604,562,245,-317
2019,2,22,4,561,523,243,-280
2019,2,22,5,516,488,242,-246
2019,2,22,6,488,464,241,-223
2019,2,22,7,469,453,241,-212
2019,2,22,8,468,449,241,-208
2019,2,22,9,471,452,241,-211
2019,2,22,10,480,467,237,-230
2019,2,22,11,528,505,241,-264
2019,2,22,12,588,575,266,-309
2019,2,22,13,624,612,265,-347
2019,2,22,14,623,615,245,-370
2019,2,22,15,612,625,245,-380
2019,2,22,16,605,620,244,-376
2019,2,22,17,606,617,243,-374
2019,2,22,18,599,609,242,-367
2019,2,22,19,594,608,244,-364
2019,2,22,20,582,608,236,-372
2019,2,22,21,573,607,232,-375
2019,2,22,22,577,620,226,-394
2019,2,22,23,588,619,221,-398
2019,2,23,0,617,639,264,-375
2019,2,23,1,629,638,276,-362
2019,2,23,2,624,610,283,-327
2019,2,23,3,608,586,294,-292
2019,2,23,4,584,556,287,-269
2019,2,23,5,551,523,276,-247
2019,2,23,6,529,502,277,-225
2019,2,23,7,512,490,276,-214
2019,2,23,8,516,488,277,-211
2019,2,23,9,514,490,276,-214
2019,2,23,10,520,496,278,-218
2019,2,23,11,539,521,276,-245
2019,2,23,12,573,552,277,-275
2019,2,23,13,609,593,270,-323
2019,2,23,14,637,618,296,-322
2019,2,23,15,634,661,350,-311
2019,2,23,16,629,669,320,-349
2019,2,23,17,607,670,321,-349
2019,2,23,18,572,667,257,-410
2019,2,23,19,550,653,237,-416
2019,2,23,20,532,638,230,-408
2019,2,23,21,524,633,237,-396
2019,2,23,22,536,637,264,-373
2019,2,23,23,540,634,260,-374
2019,2,24,0,585,652,263,-389
2019,2,24,1,602,647,262,-385
2019,2,24,2,585,525,261,-264
2019,2,24,3,561,619,261,-358
2019,2,24,4,532,582,258,-324
2019,2,24,5,494,543,257,-286
2019,2,24,6,464,516,252,-264
2019,2,24,7,447,492,248,-244
2019,2,24,8,444,480,252,-228
2019,2,24,9,447,472,252,-220
2019,2,24,10,441,471,251,-220
2019,2,24,11,464,482,254,-228
2019,2,24,12,484,501,251,-250
2019,2,24,13,519,535,252,-283
2019,2,24,14,549,556,259,-297
2019,2,24,15,557,554,267,-287
2019,2,24,16,536,535,268,-267
2019,2,24,17,513,520,270,-250
2019,2,24,18,511,509,271,-238
2019,2,24,19,502,497,269,-228
2019,2,24,20,491,464,243,-221
2019,2,24,21,489,451,242,-209
2019,2,24,22,508,471,242,-229
2019,2,24,23,523,519,238,-281
2019,2,25,0,556,576,247,-329
2019,2,25,1,576,573,245,-328
2019,2,25,2,565,621,249,-372
2019,2,25,3,532,618,223,-395
2019,2,25,4,504,598,211,-387
2019,2,25,5,477,577,211,-366
2019,2,25,6,533,562,210,-352
2019,2,25,7,537,559,207,-352
2019,2,25,8,546,570,209,-361
2019,2,25,9,565,585,210,-375
2019,2,25,10,601,616,209,-407
2019,2,25,11,644,659,208,-451
2019,2,25,12,733,738,251,-487
2019,2,25,13,775,777,322,-455
2019,2,25,14,774,768,282,-486
2019,2,25,15,744,727,239,-488
2019,2,25,16,707,694,236,-458
2019,2,25,17,659,661,238,-423
2019,2,25,18,626,627,244,-383
2019,2,25,19,600,604,262,-342
2019,2,25,20,584,580,256,-324
2019,2,25,21,578,569,253,-316
2019,2,25,22,588,577,253,-324
2019,2,25,23,616,609,259,-350
2019,2,26,0,676,665,252,-413
2019,2,26,1,711,698,313,-385
2019,2,26,2,704,710,297,-413
2019,2,26,3,690,693,266,-427
2019,2,26,4,663,626,228,-398
2019,2,26,5,633,631,226,-405
2019,2,26,6,618,619,226,-393
2019,2,26,7,624,614,225,-389
2019,2,26,8,641,609,224,-385
2019,2,26,9,653,618,225,-393
2019,2,26,10,690,632,227,-405
2019,2,26,11,729,680,231,-449
2019,2,26,12,815,754,312,-442
2019,2,26,13,848,796,366,-430
2019,2,26,14,821,761,345,-416
2019,2,26,15,774,719,347,-372
2019,2,26,16,715,669,268,-401
2019,2,26,17,648,620,261,-359
2019,2,26,18,601,582,263,-319
2019,2,26,19,575,561,263,-298
2019,2,26,20,554,535,262,-273
2019,2,26,21,548,530,258,-272
2019,2,26,22,553,540,262,-278
2019,2,26,23,569,562,261,-301
2019,2,27,0,617,607,262,-345
2019,2,27,1,639,628,260,-368
2019,2,27,2,633,620,260,-360
2019,2,27,3,606,595,261,-334
2019,2,27,4,574,555,262,-293
2019,2,27,5,544,520,263,-257
2019,2,27,6,489,492,257,-235
2019,2,27,7,478,484,257,-227
2019,2,27,8,477,486,260,-226
2019,2,27,9,482,485,259,-226
2019,2,27,10,497,503,261,-242
2019,2,27,11,530,537,258,-279
2019,2,27,12,606,615,259,-356
2019,2,27,13,633,644,260,-384
2019,2,27,14,622,639,263,-376
2019,2,27,15,608,617,260,-357
2019,2,27,16,595,598,255,-343
2019,2,27,17,583,587,234,-353
2019,2,27,18,568,564,233,-331
2019,2,27,19,557,544,258,-286
2019,2,27,20,546,534,263,-271
2019,2,27,21,542,524,261,-263
2019,2,27,22,524,534,263,-271
2019,2,27,23,539,545,262,-283
2019,2,28,0,579,577,260,-317
2019,2,28,1,601,599,262,-337
2019,2,28,2,598,586,259,-327
2019,2,28,3,572,557,263,-294
2019,2,28,4,529,516,260,-256
2019,2,28,5,489,484,251,-233
2019,2,28,6,481,454,237,-217
2019,2,28,7,468,445,234,-211
2019,2,28,8,472,452,241,-211
2019,2,28,9,477,458,238,-220
2019,2,28,10,494,474,240,-234
2019,2,28,11,527,522,240,-282
2019,2,28,12,595,596,241,-355
2019,2,28,13,629,625,238,-387
2019,2,28,14,620,620,240,-380
2019,2,28,15,607,613,241,-372
2019,2,28,16,595,604,239,-365
2019,2,28,17,580,593,241,-352
2019,2,28,18,564,581,241,-340
2019,2,28,19,553,572,242,-330
2019,2,28,20,539,566,241,-325
2019,2,28,21,538,569,241,-328
2019,2,28,22,540,582,242,-340
2019,2,28,23,545,598,240,-358
2019,3,1,0,586,624,239,-385
2019,3,1,1,604,632,241,-391
2019,3,1,2,598,614,240,-374
2019,3,1,3,572,586,241,-345
2019,3,1,4,528,540,241,-299
2019,3,1,5,496,498,239,-259
2019,3,1,6,467,468,234,-234
2019,3,1,7,452,456,235,-221
2019,3,1,8,451,456,239,-217
2019,3,1,9,452,458,241,-217
2019,3,1,10,467,469,240,-229
2019,3,1,11,502,505,239,-266
2019,3,1,12,576,574,239,-335
2019,3,1,13,605,603,240,-363
2019,3,1,14,598,603,242,-361
2019,3,1,15,595,604,240,-364
2019,3,1,16,589,605,237,-368
2019,3,1,17,577,601,241,-360
2019,3,1,18,565,592,242,-350
2019,3,1,19,558,588,239,-349
2019,3,1,20,545,582,240,-342
2019,3,1,21,534,585,240,-345
2019,3,1,22,546,583,239,-344
2019,3,1,23,562,585,241,-344
2019,3,2,0,592,597,281,-316
2019,3,2,1,607,603,328,-275
2019,3,2,2,598,594,339,-255
2019,3,2,3,582,586,293,-293
2019,3,2,4,548,545,231,-314
2019,3,2,5,521,509,221,-288
2019,3,2,6,508,480,189,-291
2019,3,2,7,497,471,182,-289
2019,3,2,8,497,469,181,-288
2019,3,2,9,515,475,185,-290
2019,3,2,10,528,485,186,-299
2019,3,2,11,551,507,184,-323
2019,3,2,12,584,534,206,-328
2019,3,2,13,621,572,304,-268
2019,3,2,14,643,610,357,-253
2019,3,2,15,618,618,362,-256
2019,3,2,16,578,617,326,-291
2019,3,2,17,543,576,219,-357
2019,3,2,18,516,538,187,-351
2019,3,2,19,492,513,191,-322
2019,3,2,20,471,492,189,-303
2019,3,2,21,459,492,191,-301
2019,3,2,22,464,493,190,-303
2019,3,2,23,486,513,189,-324
2019,3,3,0,537,543,189,-354
2019,3,3,1,575,563,187,-376
2019,3,3,2,573,564,188,-376
2019,3,3,3,558,544,187,-357
2019,3,3,4,533,525,186,-339
2019,3,3,5,505,499,186,-313
2019,3,3,6,476,479,185,-294
2019,3,3,7,470,471,187,-284
2019,3,3,8,457,467,188,-279
2019,3,3,9,452,467,190,-277
2019,3,3,10,461,469,188,-281
2019,3,3,11,489,487,184,-303
2019,3,3,12,527,515,185,-330
2019,3,3,13,569,550,186,-364
2019,3,3,14,591,584,185,-399
2019,3,3,15,575,600,188,-412
2019,3,3,16,554,584,185,-399
2019,3,3,17,534,573,187,-386
2019,3,3,18,515,570,184,-386
2019,3,3,19,493,570,195,-375
2019,3,3,20,492,573,186,-387
2019,3,3,21,493,583,188,-395
2019,3,3,22,506,588,185,-403
2019,3,3,23,537,606,190,-416
2019,3,4,0,579,619,189,-430
2019,3,4,1,620,623,189,-434
2019,3,4,2,630,612,189,-423
2019,3,4,3,601,595,188,-407
2019,3,4,4,575,565,189,-376
2019,3,4,5,546,548,190,-358
2019,3,4,6,528,539,186,-353
2019,3,4,7,524,542,187,-355
2019,3,4,8,530,565,189,-376
2019,3,4,9,545,582,185,-397
2019,3,4,10,570,613,200,-413
2019,3,4,11,625,670,204,-466
2019,3,4,12,710,751,209,-542
2019,3,4,13,750,799,260,-539
2019,3,4,14,750,818,262,-556
2019,3,4,15,722,825,273,-552
2019,3,4,16,705,830,280,-550
2019,3,4,17,679,828,280,-548
2019,3,4,18,661,820,281,-539
2019,3,4,19,647,787,281,-506
2019,3,4,20,624,769,257,-512
2019,3,4,21,613,755,241,-514
2019,3,4,22,634,755,232,-523
2019,3,4,23,660,789,245,-544
2019,3,5,0,720,839,290,-549
2019,3,5,1,765,868,346,-522
2019,3,5,2,755,852,381,-471
2019,3,5,3,740,829,391,-438
2019,3,5,4,710,788,368,-420
2019,3,5,5,684,760,316,-444
2019,3,5,6,717,743,261,-482
2019,3,5,7,720,731,229,-502
2019,3,5,8,730,736,229,-507
2019,3,5,9,742,737,230,-507
2019,3,5,10,770,751,248,-503
2019,3,5,11,819,785,316,-469
2019,3,5,12,896,877,364,-513
2019,3,5,13,932,913,430,-483
2019,3,5,14,906,894,488,-406
2019,3,5,15,853,858,440,-418
2019,3,5,16,811,800,365,-435
2019,3,5,17,768,751,346,-405
2019,3,5,18,735,716,346,-370
2019,3,5,19,718,689,344,-345
2019,3,5,20,693,662,348,-314
2019,3,5,21,690,662,345,-317
2019,3,5,22,714,677,337,-340
2019,3,5,23,755,718,344,-374
2019,3,6,0,805,800,347,-453
2019,3,6,1,860,846,347,-499
2019,3,6,2,876,855,353,-502
2019,3,6,3,867,839,352,-487
2019,3,6,4,852,809,348,-461
2019,3,6,5,829,785,353,-432
2019,3,6,6,765,776,357,-419
2019,3,6,7,768,784,354,-430
2019,3,6,8,783,799,342,-457
2019,3,6,9,800,814,328,-486
2019,3,6,10,838,846,314,-532
2019,3,6,11,881,887,350,-537
2019,3,6,12,969,966,422,-544
2019,3,6,13,992,994,476,-518
2019,3,6,14,960,973,418,-555
2019,3,6,15,891,917,420,-497
2019,3,6,16,844,868,381,-487
2019,3,6,17,808,826,346,-480
2019,3,6,18,762,780,343,-437
2019,3,6,19,723,746,343,-403
2019,3,6,20,683,715,335,-380
2019,3,6,21,661,693,299,-394
2019,3,6,22,677,697,283,-414
2019,3,6,23,714,728,289,-439
2019,3,7,0,774,788,356,-432
2019,3,7,1,819,831,384,-447
2019,3,7,2,827,836,391,-445
2019,3,7,3,818,824,395,-429
2019,3,7,4,803,787,389,-398
2019,3,7,5,756,755,376,-379
2019,3,7,6,748,739,375,-364
2019,3,7,7,749,744,377,-367
2019,3,7,8,761,747,381,-366
2019,3,7,9,767,740,378,-362
2019,3,7,10,795,758,376,-382
2019,3,7,11,837,782,400,-382
2019,3,7,12,924,846,470,-376
2019,3,7,13,946,869,466,-403
2019,3,7,14,909,840,429,-411
2019,3,7,15,849,812,364,-448
2019,3,7,16,793,784,312,-472
2019,3,7,17,744,716,233,-483
2019,3,7,18,693,670,217,-453
2019,3,7,19,656,633,221,-412
2019,3,7,20,627,601,230,-371
2019,3,7,21,612,592,228,-364
2019,3,7,22,611,620,228,-392
2019,3,7,23,644,653,227,-426
2019,3,8,0,694,678,257,-421
2019,3,8,1,728,700,337,-363
2019,3,8,2,734,695,358,-337
2019,3,8,3,707,672,372,-300
2019,3,8,4,677,629,332,-297
2019,3,8,5,643,591,305,-286
2019,3,8,6,607,558,230,-328
2019,3,8,7,599,545,225,-320
2019,3,8,8,610,546,233,-313
2019,3,8,9,615,550,234,-316
2019,3,8,10,642,568,233,-335
2019,3,8,11,675,604,228,-376
2019,3,8,12,760,681,230,-451
2019,3,8,13,792,713,230,-483
2019,3,8,14,778,722,234,-488
2019,3,8,15,749,715,230,-485
2019,3,8,16,716,723,231,-492
2019,3,8,17,681,728,235,-493
2019,3,8,18,645,701,229,-472
2019,3,8,19,623,701,231,-470
2019,3,8,20,604,669,230,-439
2019,3,8,21,594,669,230,-439
2019,3,8,22,595,681,233,-448
2019,3,8,23,611,679,230,-449
2019,3,9,0,640,694,235,-459
2019,3,9,1,654,693,234,-459
2019,3,9,2,642,676,234,-442
2019,3,9,3,624,649,234,-415
2019,3,9,4,591,611,233,-378
2019,3,9,5,560,573,233,-340
2019,3,9,6,520,543,233,-310
2019,3,9,7,501,526,233,-293
2019,3,9,8,493,524,202,-322
2019,3,9,9,492,516,188,-328
2019,3,9,10,502,524,187,-337
2019,3,9,11,520,545,189,-356
2019,3,9,12,538,578,183,-395
2019,3,9,13,577,603,214,-389
2019,3,9,14,602,626,363,-263
2019,3,9,15,625,638,434,-204
2019,3,9,16,620,639,444,-195
2019,3,9,17,607,633,398,-235
2019,3,9,18,576,602,373,-229
2019,3,9,19,561,602,365,-237
2019,3,9,20,553,601,315,-286
2019,3,9,21,557,593,324,-269
2019,3,9,22,565,601,321,-280
2019,3,9,23,582,613,346,-267
2019,3,10,0,599,635,428,-207
2019,3,10,1,591,638,448,-190
2019,3,10,2,569,629,450,-179
2019,3,10,3,538,609,440,-169
2019,3,10,4,506,586,333,-253
2019,3,10,5,473,541,229,-312
2019,3,10,6,-9999,541,229,-9999
2019,3,10,7,-9999,526,233,-9999
2019,3,10,8,-9999,524,202,-9999
2019,3,10,9,-9999,516,188,-9999
2019,3,10,10,-9999,524,187,-9999
2019,3,10,11,-9999,545,189,-9999
2019,3,10,12,-9999,578,183,-9999
2019,3,10,13,-9999,603,214,-9999
2019,3,10,14,-9999,626,363,-9999
2019,3,10,15,-9999,638,434,-9999
2019,3,10,16,-9999,639,444,-9999
2019,3,10,17,-9999,633,398,-9999
2019,3,10,18,-9999,602,373,-9999
2019,3,10,19,-9999,602,365,-9999
2019,3,10,20,-9999,601,315,-9999
2019,3,10,21,-9999,593,324,-9999
2019,3,10,22,-9999,601,321,-9999
2019,3,10,23,-9999,613,346,-9999
2019,3,11,0,-9999,635,428,-9999
2019,3,11,1,-9999,638,448,-9999
2019,3,11,2,-9999,629,450,-9999
2019,3,11,3,-9999,609,440,-9999
2019,3,11,4,-9999,586,333,-9999
2019,3,11,5,438,420,179,-241
2019,3,11,6,427,421,190,-231
2019,3,11,7,426,417,188,-229
2019,3,11,8,436,421,204,-217
2019,3,11,9,458,441,231,-210
2019,3,11,10,502,486,233,-253
2019,3,11,11,579,555,232,-323
2019,3,11,12,640,604,236,-368
2019,3,11,13,656,614,233,-381
2019,3,11,14,660,618,234,-384
2019,3,11,15,647,610,212,-398
2019,3,11,16,637,600,189,-411
2019,3,11,17,607,583,189,-394
2019,3,11,18,580,584,193,-391
2019,3,11,19,557,586,193,-393
2019,3,11,20,557,591,191,-400
2019,3,11,21,564,602,191,-411
2019,3,11,22,576,601,191,-410
2019,3,11,23,589,608,188,-420
2019,3,12,0,617,613,239,-374
2019,3,12,1,649,641,323,-318
2019,3,12,2,637,633,298,-335
2019,3,12,3,605,594,218,-376
2019,3,12,4,562,550,194,-356
2019,3,12,5,507,517,186,-331
2019,3,12,6,506,519,196,-323
2019,3,12,7,512,521,195,-326
2019,3,12,8,517,532,196,-336
2019,3,12,9,541,554,196,-358
2019,3,12,10,594,599,223,-376
2019,3,12,11,666,690,284,-406
2019,3,12,12,727,739,335,-404
2019,3,12,13,726,742,330,-412
2019,3,12,14,709,720,246,-474
2019,3,12,15,673,653,190,-463
2019,3,12,16,645,632,190,-442
2019,3,12,17,618,600,192,-408
2019,3,12,18,593,576,192,-384
2019,3,12,19,561,553,193,-360
2019,3,12,20,553,534,189,-345
2019,3,12,21,543,538,194,-344
2019,3,12,22,548,544,191,-353
2019,3,12,23,564,560,191,-369
2019,3,13,0,599,589,217,-372
2019,3,13,1,630,618,315,-303
2019,3,13,2,608,603,332,-271
2019,3,13,3,566,579,296,-283
2019,3,13,4,523,544,219,-325
2019,3,13,5,502,506,187,-319
2019,3,13,6,500,506,192,-314
2019,3,13,7,500,517,199,-318
2019,3,13,8,504,520,198,-322
2019,3,13,9,520,539,254,-285
2019,3,13,10,569,586,343,-243
2019,3,13,11,631,657,381,-276
2019,3,13,12,685,696,389,-307
2019,3,13,13,685,673,394,-279
2019,3,13,14,671,654,395,-259
2019,3,13,15,649,634,364,-270
2019,3,13,16,622,607,236,-371
2019,3,13,17,603,580,190,-390
2019,3,13,18,585,551,189,-362
2019,3,13,19,561,535,189,-346
2019,3,13,20,552,523,188,-335
2019,3,13,21,548,529,190,-339
2019,3,13,22,558,539,188,-351
2019,3,13,23,575,548,230,-318
2019,3,14,0,602,565,346,-219
2019,3,14,1,623,597,436,-161
2019,3,14,2,600,583,419,-164
2019,3,14,3,559,547,318,-229
2019,3,14,4,513,510,232,-278
2019,3,14,5,463,460,181,-279
2019,3,14,6,451,459,187,-272
2019,3,14,7,447,457,193,-264
2019,3,14,8,448,458,195,-263
2019,3,14,9,460,458,194,-264
2019,3,14,10,498,480,222,-258
2019,3,14,11,570,550,336,-214
2019,3,14,12,617,597,380,-217
2019,3,14,13,611,600,375,-225
2019,3,14,14,611,600,314,-286
2019,3,14,15,590,585,238,-347
2019,3,14,16,577,571,196,-375
2019,3,14,17,568,569,192,-377
2019,3,14,18,558,557,188,-369
2019,3,14,19,546,548,190,-358
2019,3,14,20,539,542,190,-352
2019,3,14,21,546,548,188,-360
2019,3,14,22,559,558,189,-369
2019,3,14,23,574,567,188,-379
2019,3,15,0,589,566,220,-346
2019,3,15,1,606,577,312,-265
2019,3,15,2,574,558,298,-260
2019,3,15,3,526,518,206,-312
2019,3,15,4,478,459,183,-276
2019,3,15,5,449,422,173,-249
2019,3,15,6,429,410,183,-227
2019,3,15,7,427,403,185,-218
2019,3,15,8,420,404,184,-220
2019,3,15,9,427,408,184,-224
2019,3,15,10,462,437,183,-254
2019,3,15,11,525,504,185,-319
2019,3,15,12,558,537,184,-353
2019,3,15,13,560,543,186,-357
2019,3,15,14,561,546,183,-363
2019,3,15,15,549,559,188,-371
2019,3,15,16,550,555,183,-372
2019,3,15,17,546,542,186,-356
2019,3,15,18,544,532,188,-344
2019,3,15,19,530,518,186,-332
2019,3,15,20,528,503,187,-316
2019,3,15,21,529,502,189,-313
2019,3,15,22,537,506,187,-319
2019,3,15,23,538,507,186,-321
2019,3,16,0,563,521,185,-336
2019,3,16,1,575,540,186,-354
2019,3,16,2,564,533,186,-347
2019,3,16,3,540,513,187,-326
2019,3,16,4,500,487,188,-299
2019,3,16,5,470,464,175,-289
2019,3,16,6,464,467,183,-284
2019,3,16,7,468,477,185,-292
2019,3,16,8,480,490,187,-303
2019,3,16,9,496,513,182,-331
2019,3,16,10,536,549,189,-360
2019,3,16,11,578,589,187,-402
2019,3,16,12,631,639,186,-453
2019,3,16,13,680,684,189,-495
2019,3,16,14,677,688,188,-500
2019,3,16,15,661,673,191,-482
2019,3,16,16,641,648,191,-457
2019,3,16,17,611,621,191,-430
2019,3,16,18,585,591,192,-399
2019,3,16,19,561,564,190,-374
2019,3,16,20,536,554,190,-364
2019,3,16,21,539,547,188,-359
2019,3,16,22,552,558,189,-369
2019,3,16,23,558,572,189,-383
2019,3,17,0,604,595,199,-396
2019,3,17,1,644,628,295,-333
2019,3,17,2,646,638,330,-308
2019,3,17,3,622,626,285,-341
2019,3,17,4,593,602,230,-372
2019,3,17,5,558,572,174,-398
2019,3,17,6,556,574,180,-394
2019,3,17,7,560,581,183,-398
2019,3,17,8,579,587,182,-405
2019,3,17,9,585,597,224,-373
2019,3,17,10,616,618,230,-388
2019,3,17,11,639,646,267,-379
2019,3,17,12,673,693,380,-313
2019,3,17,13,739,743,438,-305
2019,3,17,14,725,726,448,-278
2019,3,17,15,662,680,377,-303
2019,3,17,16,615,625,219,-406
2019,3,17,17,578,581,183,-398
2019,3,17,18,568,555,183,-372
2019,3,17,19,544,530,187,-343
2019,3,17,20,528,509,183,-326
2019,3,17,21,519,505,183,-322
2019,3,17,22,537,517,184,-333
2019,3,17,23,564,525,195,-330
2019,3,18,0,600,475,168,-307
2019,3,18,1,645,425,82,-343
2019,3,18,2,635,412,81,-331
2019,3,18,3,605,420,81,-339
2019,3,18,4,580,441,81,-360
2019,3,18,5,574,526,173,-353
2019,3,18,6,568,540,183,-357
2019,3,18,7,586,550,184,-366
2019,3,18,8,600,564,182,-382
2019,3,18,9,630,593,223,-370
2019,3,18,10,685,640,312,-328
2019,3,18,11,754,724,413,-311
2019,3,18,12,828,770,440,-330
2019,3,18,13,831,764,430,-334
2019,3,18,14,814,735,359,-376
2019,3,18,15,788,691,272,-419
2019,3,18,16,735,655,206,-449
2019,3,18,17,685,627,196,-431
2019,3,18,18,657,607,197,-410
2019,3,18,19,615,585,199,-386
2019,3,18,20,600,566,210,-356
2019,3,18,21,608,572,286,-286
2019,3,18,22,605,593,329,-264
2019,3,18,23,624,618,354,-264
2019,3,19,0,670,660,361,-299
2019,3,19,1,726,697,381,-316
2019,3,19,2,723,685,444,-241
2019,3,19,3,688,653,446,-207
2019,3,19,4,644,626,414,-212
2019,3,19,5,624,597,288,-309
2019,3,19,6,628,599,186,-413
2019,3,19,7,639,608,184,-424
2019,3,19,8,654,626,179,-447
2019,3,19,9,683,658,180,-478
2019,3,19,10,733,700,200,-500
2019,3,19,11,790,790,323,-467
2019,3,19,12,865,849,370,-479
2019,3,19,13,857,848,403,-445
2019,3,19,14,828,809,375,-434
2019,3,19,15,793,741,324,-417
2019,3,19,16,744,684,290,-394
2019,3,19,17,697,640,290,-350
2019,3,19,18,661,614,277,-337
2019,3,19,19,623,582,214,-368
2019,3,19,20,613,560,197,-363
2019,3,19,21,608,557,196,-361
2019,3,19,22,618,562,196,-366
2019,3,19,23,628,578,194,-384
2019,3,20,0,675,608,198,-410
2019,3,20,1,725,629,308,-321
2019,3,20,2,705,638,436,-202
2019,3,20,3,674,626,395,-231
2019,3,20,4,648,596,219,-377
2019,3,20,5,639,560,169,-391
2019,3,20,6,636,575,185,-390
2019,3,20,7,643,587,186,-401
2019,3,20,8,662,602,187,-415
2019,3,20,9,684,622,293,-329
2019,3,20,10,737,695,419,-276
2019,3,20,11,804,780,518,-262
2019,3,20,12,862,840,597,-243
2019,3,20,13,848,828,537,-291
2019,3,20,14,815,771,451,-320
2019,3,20,15,775,712,447,-265
2019,3,20,16,718,662,370,-292
2019,3,20,17,682,620,275,-345
2019,3,20,18,649,582,203,-379
2019,3,20,19,629,552,196,-356
2019,3,20,20,614,538,197,-341
2019,3,20,21,606,528,192,-336
2019,3,20,22,603,533,205,-328
2019,3,20,23,631,542,321,-221
2019,3,21,0,657,581,435,-146
2019,3,21,1,690,614,445,-169
2019,3,21,2,678,602,445,-157
2019,3,21,3,643,584,401,-183
2019,3,21,4,596,552,237,-315
2019,3,21,5,560,507,181,-326
2019,3,21,6,557,517,192,-325
2019,3,21,7,560,520,193,-327
2019,3,21,8,567,528,193,-335
2019,3,21,9,582,545,193,-352
2019,3,21,10,632,596,234,-362
2019,3,21,11,723,667,244,-423
2019,3,21,12,776,700,345,-355
2019,3,21,13,759,706,434,-272
2019,3,21,14,743,689,449,-240
2019,3,21,15,710,656,390,-266
2019,3,21,16,671,626,272,-354
2019,3,21,17,638,604,205,-399
2019,3,21,18,611,597,183,-414
2019,3,21,19,589,595,183,-412
2019,3,21,20,587,608,183,-425
2019,3,21,21,590,635,186,-449
2019,3,21,22,606,641,184,-457
2019,3,21,23,619,625,229,-396
2019,3,22,0,652,684,373,-311
2019,3,22,1,679,698,440,-258
2019,3,22,2,663,684,451,-233
2019,3,22,3,632,652,426,-226
2019,3,22,4,589,613,282,-331
2019,3,22,5,559,578,197,-381
2019,3,22,6,549,578,186,-392
2019,3,22,7,552,581,186,-395
2019,3,22,8,556,586,187,-399
2019,3,22,9,576,591,275,-316
2019,3,22,10,623,646,406,-240
2019,3,22,11,707,729,442,-287
2019,3,22,12,757,773,442,-331
2019,3,22,13,742,774,443,-331
2019,3,22,14,716,743,444,-299
2019,3,22,15,670,717,425,-292
2019,3,22,16,638,675,251,-424
2019,3,22,17,609,627,168,-459
2019,3,22,18,586,597,167,-430
2019,3,22,19,562,565,190,-375
2019,3,22,20,553,547,188,-359
2019,3,22,21,556,542,190,-352
2019,3,22,22,558,544,187,-357
2019,3,22,23,568,552,185,-367
2019,3,23,0,578,556,248,-308
2019,3,23,1,603,594,406,-188
2019,3,23,2,589,593,437,-156
2019,3,23,3,564,576,409,-167
2019,3,23,4,526,550,370,-180
2019,3,23,5,550,497,266,-231
2019,3,23,6,554,502,251,-251
2019,3,23,7,556,514,242,-272
2019,3,23,8,574,525,245,-280
2019,3,23,9,592,531,318,-213
2019,3,23,10,634,577,397,-180
2019,3,23,11,670,623,430,-193
2019,3,23,12,728,673,437,-236
2019,3,23,13,750,701,442,-259
2019,3,23,14,735,679,444,-235
2019,3,23,15,694,640,443,-197
2019,3,23,16,654,618,365,-253
2019,3,23,17,585,573,251,-322
2019,3,23,18,551,535,188,-347
2019,3,23,19,517,508,188,-320
2019,3,23,20,495,489,186,-303
2019,3,23,21,496,495,190,-305
2019,3,23,22,504,497,186,-311
2019,3,23,23,520,494,215,-279
2019,3,24,0,542,520,334,-186
2019,3,24,1,582,560,382,-178
2019,3,24,2,585,554,378,-176
2019,3,24,3,563,545,356,-189
2019,3,24,4,535,533,306,-227
2019,3,24,5,499,502,190,-312
2019,3,24,6,486,504,190,-314
2019,3,24,7,492,505,191,-314
2019,3,24,8,500,507,224,-283
2019,3,24,9,504,524,277,-247
2019,3,24,10,529,555,381,-174
2019,3,24,11,556,603,407,-196
2019,3,24,12,589,656,425,-231
2019,3,24,13,639,689,450,-239
2019,3,24,14,623,671,435,-236
2019,3,24,15,587,609,264,-345
2019,3,24,16,548,548,195,-353
2019,3,24,17,518,520,192,-328
2019,3,24,18,505,492,190,-302
2019,3,24,19,491,487,192,-295
2019,3,24,20,486,484,189,-295
2019,3,24,21,490,488,189,-299
2019,3,24,22,507,505,190,-315
2019,3,24,23,522,506,198,-308
2019,3,25,0,541,522,304,-218
2019,3,25,1,553,546,371,-175
2019,3,25,2,538,544,331,-213
2019,3,25,3,498,496,193,-303
2019,3,25,4,455,452,184,-268
2019,3,25,5,425,428,182,-246
2019,3,25,6,415,426,185,-241
2019,3,25,7,414,431,187,-244
2019,3,25,8,420,435,185,-250
2019,3,25,9,431,465,188,-277
2019,3,25,10,468,487,274,-213
2019,3,25,11,545,585,381,-204
2019,3,25,12,593,630,370,-260
2019,3,25,13,592,627,374,-253
2019,3,25,14,592,615,372,-243
2019,3,25,15,579,601,372,-229
2019,3,25,16,564,606,330,-276
2019,3,25,17,555,586,200,-386
2019,3,25,18,544,574,181,-393
2019,3,25,19,536,571,182,-389
2019,3,25,20,533,552,167,-385
2019,3,25,21,542,580,183,-397
2019,3,25,22,547,594,181,-413
2019,3,25,23,546,612,181,-431
2019,3,26,0,566,614,197,-417
2019,3,26,1,598,617,269,-348
2019,3,26,2,569,587,272,-315
2019,3,26,3,528,546,264,-282
2019,3,26,4,484,503,234,-269
2019,3,26,5,455,470,206,-264
2019,3,26,6,449,464,182,-282
2019,3,26,7,449,458,182,-276
2019,3,26,8,457,457,182,-275
2019,3,26,9,474,474,183,-291
2019,3,26,10,517,494,240,-254
2019,3,26,11,602,575,346,-229
2019,3,26,12,655,627,433,-194
2019,3,26,13,662,634,444,-190
2019,3,26,14,657,630,446,-184
2019,3,26,15,640,623,446,-177
2019,3,26,16,638,616,439,-177
2019,3,26,17,606,606,267,-339
2019,3,26,18,592,564,180,-384
2019,3,26,19,574,549,182,-367
2019,3,26,20,574,541,182,-359
2019,3,26,21,572,542,181,-361
2019,3,26,22,578,543,180,-363
2019,3,26,23,583,555,207,-348
2019,3,27,0,641,576,369,-207
2019,3,27,1,704,624,442,-182
2019,3,27,2,665,612,415,-197
2019,3,27,3,633,574,337,-237
2019,3,27,4,598,542,302,-240
2019,3,27,5,579,521,238,-283
2019,3,27,6,574,524,196,-328
2019,3,27,7,580,534,195,-339
2019,3,27,8,590,552,198,-354
2019,3,27,9,608,570,214,-356
2019,3,27,10,655,634,302,-332
2019,3,27,11,732,715,424,-291
2019,3,27,12,780,764,432,-332
2019,3,27,13,785,753,391,-362
2019,3,27,14,746,713,311,-402
2019,3,27,15,701,679,262,-417
2019,3,27,16,663,602,131,-471
2019,3,27,17,621,577,131,-446
2019,3,27,18,589,560,135,-425
2019,3,27,19,563,539,135,-404
2019,3,27,20,563,524,135,-389
2019,3,27,21,566,525,137,-388
2019,3,27,22,571,521,155,-366
2019,3,27,23,584,531,210,-321
2019,3,28,0,606,563,263,-300
2019,3,28,1,647,594,263,-331
2019,3,28,2,640,585,204,-381
2019,3,28,3,610,549,194,-355
2019,3,28,4,565,511,190,-321
2019,3,28,5,523,491,183,-308
2019,3,28,6,517,510,191,-319
2019,3,28,7,519,517,192,-325
2019,3,28,8,530,536,191,-345
2019,3,28,9,550,559,213,-346
2019,3,28,10,612,618,272,-346
2019,3,28,11,711,711,434,-277
2019,3,28,12,759,758,437,-321
2019,3,28,13,748,745,425,-320
2019,3,28,14,712,695,353,-342
2019,3,28,15,648,641,209,-432
2019,3,28,16,602,590,129,-461
2019,3,28,17,565,556,129,-427
2019,3,28,18,539,538,133,-405
2019,3,28,19,532,513,146,-367
2019,3,28,20,519,514,144,-370
2019,3,28,21,528,511,149,-362
2019,3,28,22,534,509,173,-336
2019,3,28,23,541,523,256,-267
2019,3,29,0,565,551,265,-286
2019,3,29,1,602,575,262,-313
2019,3,29,2,581,554,264,-290
2019,3,29,3,541,521,263,-258
2019,3,29,4,492,480,261,-219
2019,3,29,5,493,451,214,-237
2019,3,29,6,488,457,164,-293
2019,3,29,7,489,457,138,-319
2019,3,29,8,496,473,136,-337
2019,3,29,9,512,490,140,-350
2019,3,29,10,556,527,212,-315
2019,3,29,11,624,624,435,-189
2019,3,29,12,679,669,436,-233
2019,3,29,13,677,662,436,-226
2019,3,29,14,647,624,422,-202
2019,3,29,15,612,586,285,-301
2019,3,29,16,578,556,239,-317
2019,3,29,17,557,535,159,-376
2019,3,29,18,538,517,131,-386
2019,3,29,19,519,512,134,-378
2019,3,29,20,508,500,130,-370
2019,3,29,21,509,507,132,-375
2019,3,29,22,514,498,161,-337
2019,3,29,23,519,507,234,-273
2019,3,30,0,527,520,262,-258
2019,3,30,1,551,535,263,-272
2019,3,30,2,537,520,263,-257
2019,3,30,3,514,495,229,-266
2019,3,30,4,478,446,173,-273
2019,3,30,5,446,411,141,-270
2019,3,30,6,441,403,134,-269
2019,3,30,7,440,395,134,-261
2019,3,30,8,442,398,132,-266
2019,3,30,9,451,402,130,-272
2019,3,30,10,474,423,133,-290
2019,3,30,11,500,452,131,-321
2019,3,30,12,540,493,131,-362
2019,3,30,13,568,526,133,-393
2019,3,30,14,580,537,87,-450
2019,3,30,15,568,534,83,-451
2019,3,30,16,548,514,102,-412
2019,3,30,17,528,496,122,-374
2019,3,30,18,510,479,119,-360
2019,3,30,19,489,474,123,-351
2019,3,30,20,486,469,119,-350
2019,3,30,21,490,475,124,-351
2019,3,30,22,497,489,153,-336
2019,3,30,23,503,488,170,-318
2019,3,31,0,518,487,218,-269
2019,3,31,1,536,510,307,-203
2019,3,31,2,524,502,300,-202
2019,3,31,3,495,474,233,-241
2019,3,31,4,460,434,206,-228
2019,3,31,5,415,390,178,-212
2019,3,31,6,402,384,189,-195
2019,3,31,7,393,373,132,-241
2019,3,31,8,388,374,146,-228
2019,3,31,9,394,378,157,-221
2019,3,31,10,409,389,184,-205
2019,3,31,11,434,416,186,-230
2019,3,31,12,477,459,183,-276
2019,3,31,13,517,518,184,-334
2019,3,31,14,542,551,180,-371
2019,3,31,15,542,555,183,-372
2019,3,31,16,538,554,184,-370
2019,3,31,17,536,552,183,-369
2019,3,31,18,523,552,185,-367
2019,3,31,19,506,541,185,-356
2019,3,31,20,494,535,184,-351
2019,3,31,21,506,534,184,-350
2019,3,31,22,518,544,187,-357
2019,3,31,23,536,552,288,-264
2019,4,1,0,579,591,381,-210
2019,4,1,1,611,641,429,-212
2019,4,1,2,578,638,434,-204
2019,4,1,3,551,609,369,-240
2019,4,1,4,532,593,322,-271
2019,4,1,5,570,569,212,-357
2019,4,1,6,572,564,192,-372
2019,4,1,7,587,574,192,-382
2019,4,1,8,600,582,202,-380
2019,4,1,9,633,604,294,-310
2019,4,1,10,673,641,388,-253
2019,4,1,11,734,745,571,-174
2019,4,1,12,823,794,624,-170
2019,4,1,13,828,785,607,-178
2019,4,1,14,787,761,513,-248
2019,4,1,15,742,698,389,-309
2019,4,1,16,692,670,320,-350
2019,4,1,17,638,618,255,-363
2019,4,1,18,617,589,251,-338
2019,4,1,19,580,562,251,-311
2019,4,1,20,564,547,252,-295
2019,4,1,21,568,546,250,-296
2019,4,1,22,567,554,249,-305
2019,4,1,23,584,570,251,-319
2019,4,2,0,632,594,324,-270
2019,4,2,1,675,631,419,-212
2019,4,2,2,671,626,444,-182
2019,4,2,3,636,594,450,-144
2019,4,2,4,600,568,447,-121
2019,4,2,5,562,563,298,-265
2019,4,2,6,564,554,161,-393
2019,4,2,7,568,544,133,-411
2019,4,2,8,581,552,156,-396
2019,4,2,9,599,562,162,-400
2019,4,2,10,656,590,408,-182
2019,4,2,11,729,688,621,-67
2019,4,2,12,778,724,624,-100
2019,4,2,13,778,722,630,-92
2019,4,2,14,731,690,630,-60
2019,4,2,15,691,659,626,-33
2019,4,2,16,646,627,584,-43
2019,4,2,17,610,602,559,-43
2019,4,2,18,581,586,544,-42
2019,4,2,19,559,570,542,-28
2019,4,2,20,553,563,544,-19
2019,4,2,21,559,576,542,-34
2019,4,2,22,561,582,557,-25
2019,4,2,23,577,596,557,-39
2019,4,3,0,596,612,444,-168
2019,4,3,1,626,653,452,-201
2019,4,3,2,620,637,450,-187
2019,4,3,3,583,601,448,-153
2019,4,3,4,540,567,410,-157
2019,4,3,5,513,550,381,-169
2019,4,3,6,509,566,347,-219
2019,4,3,7,509,564,261,-303
2019,4,3,8,517,573,270,-303
2019,4,3,9,531,601,338,-263
2019,4,3,10,579,663,450,-213
2019,4,3,11,648,737,453,-284
2019,4,3,12,696,775,449,-326
2019,4,3,13,686,752,454,-298
2019,4,3,14,646,692,453,-239
2019,4,3,15,612,662,402,-260
2019,4,3,16,581,611,248,-363
2019,4,3,17,558,561,158,-403
2019,4,3,18,542,544,146,-398
2019,4,3,19,537,529,135,-394
2019,4,3,20,526,524,133,-391
2019,4,3,21,523,525,134,-391
2019,4,3,22,523,530,195,-335
2019,4,3,23,546,537,194,-343
2019,4,4,0,556,536,216,-320
2019,4,4,1,577,562,367,-195
2019,4,4,2,560,562,439,-123
2019,4,4,3,519,517,437,-80
2019,4,4,4,478,481,383,-98
2019,4,4,5,454,471,301,-170
2019,4,4,6,444,458,171,-287
2019,4,4,7,444,455,126,-329
2019,4,4,8,451,461,124,-337
2019,4,4,9,467,483,122,-361
2019,4,4,10,508,509,251,-258
2019,4,4,11,582,609,420,-189
2019,4,4,12,627,662,448,-214
2019,4,4,13,623,648,449,-199
2019,4,4,14,603,630,404,-226
2019,4,4,15,578,584,241,-343
2019,4,4,16,552,550,193,-357
2019,4,4,17,546,529,184,-345
2019,4,4,18,535,517,135,-382
2019,4,4,19,530,506,127,-379
2019,4,4,20,516,506,126,-380
2019,4,4,21,515,512,129,-383
2019,4,4,22,514,515,196,-319
2019,4,4,23,518,516,359,-157
2019,4,5,0,544,557,441,-116
2019,4,5,1,566,569,443,-126
2019,4,5,2,550,546,443,-103
2019,4,5,3,511,497,438,-59
2019,4,5,4,469,453,381,-72
2019,4,5,5,417,433,356,-77
2019,4,5,6,399,431,201,-230
2019,4,5,7,399,405,117,-288
2019,4,5,8,394,410,115,-295
2019,4,5,9,404,421,115,-306
2019,4,5,10,443,445,202,-243
2019,4,5,11,520,516,368,-148
2019,4,5,12,546,575,415,-160
2019,4,5,13,545,580,391,-189
2019,4,5,14,542,586,375,-211
2019,4,5,15,531,577,367,-210
2019,4,5,16,527,572,347,-225
2019,4,5,17,517,550,329,-221
2019,4,5,18,517,543,274,-269
2019,4,5,19,513,529,239,-290
2019,4,5,20,517,526,183,-343
2019,4,5,21,523,520,203,-317
2019,4,5,22,529,519,221,-298
2019,4,5,23,532,519,275,-244
2019,4,6,0,532,528,332,-196
2019,4,6,1,553,537,387,-150
2019,4,6,2,538,526,427,-99
2019,4,6,3,483,502,415,-87
2019,4,6,4,433,473,309,-164
2019,4,6,5,445,431,202,-229
2019,4,6,6,431,409,184,-225
2019,4,6,7,421,403,188,-215
2019,4,6,8,424,402,188,-214
2019,4,6,9,429,394,214,-180
2019,4,6,10,444,422,278,-144
2019,4,6,11,472,447,278,-169
2019,4,6,12,514,476,295,-181
2019,4,6,13,536,484,349,-135
2019,4,6,14,545,539,490,-49
2019,4,6,15,538,532,416,-116
2019,4,6,16,532,495,222,-273
2019,4,6,17,523,489,211,-278
2019,4,6,18,510,478,178,-300
2019,4,6,19,494,469,230,-239
2019,4,6,20,495,479,217,-262
2019,4,6,21,499,484,174,-310
2019,4,6,22,504,488,171,-317
2019,4,6,23,505,493,170,-323
2019,4,7,0,508,490,171,-319
2019,4,7,1,528,514,239,-275
2019,4,7,2,511,503,255,-248
2019,4,7,3,480,475,228,-247
2019,4,7,4,441,437,109,-328
2019,4,7,5,411,399,58,-341
2019,4,7,6,392,379,57,-322
2019,4,7,7,384,372,57,-315
2019,4,7,8,380,367,59,-308
2019,4,7,9,380,367,65,-302
2019,4,7,10,394,381,132,-249
2019,4,7,11,414,405,132,-273
2019,4,7,12,450,433,131,-302
2019,4,7,13,483,476,132,-344
2019,4,7,14,507,498,131,-367
2019,4,7,15,505,493,154,-339
2019,4,7,16,496,491,202,-289
2019,4,7,17,494,495,155,-340
2019,4,7,18,491,492,132,-360
2019,4,7,19,492,486,134,-352
2019,4,7,20,495,489,134,-355
2019,4,7,21,506,490,133,-357
2019,4,7,22,522,501,148,-353
2019,4,7,23,530,504,209,-295
2019,4,8,0,537,518,253,-265
2019,4,8,1,558,529,256,-273
2019,4,8,2,538,510,257,-253
2019,4,8,3,491,469,259,-210
2019,4,8,4,440,428,252,-176
2019,4,8,5,394,406,174,-232
2019,4,8,6,375,392,108,-284
2019,4,8,7,364,382,63,-319
2019,4,8,8,360,378,60,-318
2019,4,8,9,373,389,67,-322
2019,4,8,10,406,417,128,-289
2019,4,8,11,484,477,130,-347
2019,4,8,12,527,499,195,-304
2019,4,8,13,530,520,229,-291
2019,4,8,14,527,523,256,-267
2019,4,8,15,534,533,343,-190
2019,4,8,16,535,542,391,-151
2019,4,8,17,540,544,381,-163
2019,4,8,18,547,536,477,-59
2019,4,8,19,546,531,509,-22
2019,4,8,20,545,538,515,-23
2019,4,8,21,552,540,517,-23
2019,4,8,22,557,542,519,-23
2019,4,8,23,556,557,531,-26
2019,4,9,0,568,568,533,-35
2019,4,9,1,582,570,535,-35
2019,4,9,2,551,530,424,-106
2019,4,9,3,497,457,230,-227
2019,4,9,4,445,452,200,-252
2019,4,9,5,410,424,98,-326
2019,4,9,6,389,401,65,-336
2019,4,9,7,377,395,68,-327
2019,4,9,8,370,392,67,-325
2019,4,9,9,380,394,76,-318
2019,4,9,10,413,426,135,-291
2019,4,9,11,486,488,134,-354
2019,4,9,12,528,515,168,-347
2019,4,9,13,531,520,316,-204
2019,4,9,14,528,532,478,-54
2019,4,9,15,531,542,523,-19
2019,4,9,16,539,509,448,-61
2019,4,9,17,538,504,419,-85
2019,4,9,18,546,507,409,-98
2019,4,9,19,542,514,452,-62
2019,4,9,20,545,533,490,-43
2019,4,9,21,555,528,444,-84
2019,4,9,22,564,534,484,-50
2019,4,9,23,569,540,509,-31
2019,4,10,0,568,539,489,-50
2019,4,10,1,587,564,467,-97
2019,4,10,2,556,544,349,-195
2019,4,10,3,498,488,288,-200
2019,4,10,4,445,433,195,-238
2019,4,10,5,399,405,181,-224
2019,4,10,6,385,399,145,-254
2019,4,10,7,380,391,130,-261
2019,4,10,8,379,388,128,-260
2019,4,10,9,389,399,130,-269
2019,4,10,10,426,436,138,-298
2019,4,10,11,494,504,186,-318
2019,4,10,12,536,543,247,-296
2019,4,10,13,534,543,262,-281
2019,4,10,14,529,537,259,-278
2019,4,10,15,531,527,190,-337
2019,4,10,16,531,521,131,-390
2019,4,10,17,534,517,131,-386
2019,4,10,18,544,516,131,-385
2019,4,10,19,541,509,141,-368
2019,4,10,20,539,510,277,-233
2019,4,10,21,548,535,412,-123
2019,4,10,22,560,549,418,-131
2019,4,10,23,564,554,416,-138
2019,4,11,0,563,555,419,-136
2019,4,11,1,579,567,420,-147
2019,4,11,2,553,541,412,-129
2019,4,11,3,496,485,347,-138
2019,4,11,4,443,439,241,-198
2019,4,11,5,400,400,154,-246
2019,4,11,6,387,380,127,-253
2019,4,11,7,382,379,127,-252
2019,4,11,8,381,379,130,-249
2019,4,11,9,392,384,126,-258
2019,4,11,10,429,421,129,-292
2019,4,11,11,506,483,135,-348
2019,4,11,12,541,517,160,-357
2019,4,11,13,539,522,158,-364
2019,4,11,14,534,525,155,-370
2019,4,11,15,527,524,133,-391
2019,4,11,16,523,523,129,-394
2019,4,11,17,516,517,130,-387
2019,4,11,18,529,520,142,-378
2019,4,11,19,530,521,162,-359
2019,4,11,20,532,523,188,-335
2019,4,11,21,532,531,247,-284
2019,4,11,22,533,541,264,-277
2019,4,11,23,536,540,250,-290
2019,4,12,0,543,548,253,-295
2019,4,12,1,566,566,264,-302
2019,4,12,2,530,543,283,-260
2019,4,12,3,490,510,264,-246
2019,4,12,4,439,457,177,-280
2019,4,12,5,401,412,165,-247
2019,4,12,6,385,399,178,-221
2019,4,12,7,381,390,170,-220
2019,4,12,8,377,383,170,-213
2019,4,12,9,387,390,171,-219
2019,4,12,10,418,405,190,-215
2019,4,12,11,486,469,323,-146
2019,4,12,12,526,506,380,-126
2019,4,12,13,532,523,386,-137
2019,4,12,14,534,534,387,-147
2019,4,12,15,534,547,361,-186
2019,4,12,16,535,560,312,-248
2019,4,12,17,523,549,218,-331
2019,4,12,18,529,543,185,-358
2019,4,12,19,526,549,175,-374
2019,4,12,20,524,544,188,-356
2019,4,12,21,525,541,222,-319
2019,4,12,22,530,545,256,-289
2019,4,12,23,529,542,257,-285
2019,4,13,0,534,539,256,-283
2019,4,13,1,543,547,254,-293
2019,4,13,2,513,542,220,-322
2019,4,13,3,479,492,164,-328
2019,4,13,4,441,451,155,-296
2019,4,13,5,407,413,121,-292
2019,4,13,6,380,389,115,-274
2019,4,13,7,372,377,120,-257
2019,4,13,8,364,372,124,-248
2019,4,13,9,371,369,122,-247
2019,4,13,10,380,380,125,-255
2019,4,13,11,407,405,127,-278
2019,4,13,12,447,429,127,-302
2019,4,13,13,481,466,127,-339
2019,4,13,14,517,483,158,-325
2019,4,13,15,533,496,237,-259
2019,4,13,16,521,505,265,-240
2019,4,13,17,522,514,231,-283
2019,4,13,18,522,498,209,-289
2019,4,13,19,516,497,207,-290
2019,4,13,20,525,495,207,-288
2019,4,13,21,529,508,207,-301
2019,4,13,22,531,522,210,-312
2019,4,13,23,528,519,207,-312
2019,4,14,0,526,515,205,-310
2019,4,14,1,538,527,207,-320
2019,4,14,2,515,502,205,-297
2019,4,14,3,470,476,161,-315
2019,4,14,4,435,432,128,-304
2019,4,14,5,385,398,128,-270
2019,4,14,6,366,380,129,-251
2019,4,14,7,357,370,130,-240
2019,4,14,8,347,363,129,-234
2019,4,14,9,350,362,130,-232
2019,4,14,10,363,368,130,-238
2019,4,14,11,383,386,127,-259
2019,4,14,12,419,420,131,-289
2019,4,14,13,452,455,127,-328
2019,4,14,14,476,485,129,-356
2019,4,14,15,483,498,131,-367
2019,4,14,16,479,497,130,-367
2019,4,14,17,486,497,130,-367
2019,4,14,18,486,500,129,-371
2019,4,14,19,486,496,130,-366
2019,4,14,20,490,489,154,-335
2019,4,14,21,499,501,163,-338
2019,4,14,22,513,512,164,-348
2019,4,14,23,510,516,161,-355
2019,4,15,0,524,523,169,-354
2019,4,15,1,541,516,212,-304
2019,4,15,2,522,498,211,-287
2019,4,15,3,474,465,147,-318
2019,4,15,4,427,428,112,-316
2019,4,15,5,390,392,97,-295
2019,4,15,6,376,380,99,-281
2019,4,15,7,378,375,97,-278
2019,4,15,8,384,380,99,-281
2019,4,15,9,406,397,100,-297
2019,4,15,10,457,429,108,-321
2019,4,15,11,530,497,146,-351
2019,4,15,12,587,530,220,-310
2019,4,15,13,596,585,316,-269
2019,4,15,14,587,586,253,-333
2019,4,15,15,571,578,196,-382
2019,4,15,16,558,559,182,-377
2019,4,15,17,542,552,173,-379
2019,4,15,18,530,543,178,-365
2019,4,15,19,522,525,175,-350
2019,4,15,20,520,518,176,-342
2019,4,15,21,526,523,178,-345
2019,4,15,22,532,523,194,-329
2019,4,15,23,550,545,340,-205
2019,4,16,0,595,562,384,-178
2019,4,16,1,600,584,385,-199
2019,4,16,2,575,576,384,-192
2019,4,16,3,542,546,295,-251
2019,4,16,4,495,506,130,-376
2019,4,16,5,472,484,103,-381
2019,4,16,6,463,473,98,-375
2019,4,16,7,461,478,99,-379
2019,4,16,8,462,485,101,-384
2019,4,16,9,482,504,108,-396
2019,4,16,10,534,546,259,-287
2019,4,16,11,624,624,341,-283
2019,4,16,12,654,666,340,-326
2019,4,16,13,629,651,341,-310
2019,4,16,14,591,618,309,-309
2019,4,16,15,550,580,239,-341
2019,4,16,16,539,553,184,-369
2019,4,16,17,518,532,166,-366
2019,4,16,18,514,529,167,-362
2019,4,16,19,502,519,133,-386
2019,4,16,20,505,521,134,-387
2019,4,16,21,507,526,142,-384
2019,4,16,22,510,533,154,-379
2019,4,16,23,527,543,170,-373
2019,4,17,0,537,538,168,-370
2019,4,17,1,558,559,172,-387
2019,4,17,2,541,538,168,-370
2019,4,17,3,488,492,161,-331
2019,4,17,4,437,446,132,-314
2019,4,17,5,400,409,128,-281
2019,4,17,6,391,397,129,-268
2019,4,17,7,387,395,131,-264
2019,4,17,8,392,393,128,-265
2019,4,17,9,408,408,128,-280
2019,4,17,10,449,449,131,-318
2019,4,17,11,520,509,155,-354
2019,4,17,12,553,550,195,-355
2019,4,17,13,550,561,212,-349
2019,4,17,14,539,547,153,-394
2019,4,17,15,533,530,144,-386
2019,4,17,16,526,523,145,-378
2019,4,17,17,518,527,146,-381
2019,4,17,18,521,528,143,-385
2019,4,17,19,520,535,143,-392
2019,4,17,20,522,541,138,-403
2019,4,17,21,538,537,197,-340
2019,4,17,22,544,554,263,-291
2019,4,17,23,554,555,264,-291
2019,4,18,0,551,549,264,-285
2019,4,18,1,567,563,263,-300
2019,4,18,2,546,544,263,-281
2019,4,18,3,493,500,265,-235
2019,4,18,4,440,462,203,-259
2019,4,18,5,389,411,125,-286
2019,4,18,6,378,390,125,-265
2019,4,18,7,375,387,129,-258
2019,4,18,8,375,383,131,-252
2019,4,18,9,384,392,130,-262
2019,4,18,10,427,415,130,-285
2019,4,18,11,493,468,131,-337
2019,4,18,12,532,502,131,-371
2019,4,18,13,542,517,131,-386
2019,4,18,14,535,524,132,-392
2019,4,18,15,531,528,132,-396
2019,4,18,16,529,533,133,-400
2019,4,18,17,528,542,133,-409
2019,4,18,18,528,542,133,-409
2019,4,18,19,531,545,134,-411
2019,4,18,20,532,544,131,-413
2019,4,18,21,535,547,134,-413
2019,4,18,22,543,551,132,-419
2019,4,18,23,558,552,133,-419
2019,4,19,0,562,545,130,-415
2019,4,19,1,575,558,132,-426
2019,4,19,2,546,541,133,-408
2019,4,19,3,490,497,132,-365
2019,4,19,4,435,450,131,-319
2019,4,19,5,417,414,131,-283
2019,4,19,6,390,397,132,-265
2019,4,19,7,376,381,130,-251
2019,4,19,8,368,375,136,-239
2019,4,19,9,372,375,135,-240
2019,4,19,10,394,390,134,-256
2019,4,19,11,444,429,135,-294
2019,4,19,12,480,463,134,-329
2019,4,19,13,501,481,147,-334
2019,4,19,14,516,510,158,-352
2019,4,19,15,524,524,148,-376
2019,4,19,16,531,530,149,-381
2019,4,19,17,517,529,148,-381
2019,4,19,18,517,526,148,-378
2019,4,19,19,514,522,149,-373
2019,4,19,20,509,516,150,-366
2019,4,19,21,519,502,146,-356
2019,4,19,22,526,509,137,-372
2019,4,19,23,526,507,129,-378
2019,4,20,0,532,503,129,-374
2019,4,20,1,545,514,128,-386
2019,4,20,2,530,495,128,-367
2019,4,20,3,484,467,128,-339
2019,4,20,4,439,433,127,-306
2019,4,20,5,414,410,128,-282
2019,4,20,6,400,394,125,-269
2019,4,20,7,389,388,127,-261
2019,4,20,8,392,386,127,-259
2019,4,20,9,403,397,128,-269
2019,4,20,10,425,418,129,-289
2019,4,20,11,460,448,126,-322
2019,4,20,12,510,488,127,-361
2019,4,20,13,544,529,128,-401
2019,4,20,14,565,556,129,-427
2019,4,20,15,558,554,146,-408
2019,4,20,16,551,551,154,-397
2019,4,20,17,544,545,142,-403
2019,4,20,18,532,537,129,-408
2019,4,20,19,517,527,131,-396
2019,4,20,20,513,523,134,-389
2019,4,20,21,514,538,155,-383
2019,4,20,22,511,551,167,-384
2019,4,20,23,501,561,194,-367
2019,4,21,0,511,572,202,-370
2019,4,21,1,552,590,223,-367
2019,4,21,2,540,589,226,-363
2019,4,21,3,513,559,226,-333
2019,4,21,4,475,526,227,-299
2019,4,21,5,450,502,206,-296
2019,4,21,6,447,484,170,-314
2019,4,21,7,444,471,159,-312
2019,4,21,8,448,473,160,-313
2019,4,21,9,453,476,161,-315
2019,4,21,10,474,497,161,-336
2019,4,21,11,506,524,170,-354
2019,4,21,12,535,561,198,-363
2019,4,21,13,570,591,198,-393
2019,4,21,14,563,608,199,-409
2019,4,21,15,522,594,200,-394
2019,4,21,16,498,573,200,-373
2019,4,21,17,489,549,201,-348
2019,4,21,18,479,520,202,-318
2019,4,21,19,465,489,201,-288
2019,4,21,20,459,467,198,-269
2019,4,21,21,464,466,200,-266
2019,4,21,22,473,469,201,-268
2019,4,21,23,490,482,201,-281
2019,4,22,0,508,499,200,-299
2019,4,22,1,529,527,201,-326
2019,4,22,2,520,525,198,-327
2019,4,22,3,489,501,198,-303
2019,4,22,4,440,461,224,-237
2019,4,22,5,387,441,232,-209
2019,4,22,6,378,431,226,-205
2019,4,22,7,378,444,205,-239
2019,4,22,8,383,452,169,-283
2019,4,22,9,400,468,151,-317
2019,4,22,10,449,510,148,-362
2019,4,22,11,507,570,183,-387
2019,4,22,12,541,622,321,-301
2019,4,22,13,546,611,338,-273
2019,4,22,14,543,582,269,-313
2019,4,22,15,538,552,266,-286
2019,4,22,16,538,544,258,-286
2019,4,22,17,538,529,258,-271
2019,4,22,18,535,519,255,-264
2019,4,22,19,530,514,265,-249
2019,4,22,20,538,522,309,-213
2019,4,22,21,549,528,345,-183
2019,4,22,22,556,539,348,-191
2019,4,22,23,571,548,344,-204
2019,4,23,0,564,553,341,-212
2019,4,23,1,578,571,342,-229
2019,4,23,2,560,556,281,-275
2019,4,23,3,514,496,182,-314
2019,4,23,4,460,456,182,-274
2019,4,23,5,400,411,168,-243
2019,4,23,6,380,402,167,-235
2019,4,23,7,373,392,162,-230
2019,4,23,8,374,394,161,-233
2019,4,23,9,385,410,162,-248
2019,4,23,10,418,450,163,-287
2019,4,23,11,489,524,161,-363
2019,4,23,12,526,556,174,-382
2019,4,23,13,526,550,186,-364
2019,4,23,14,526,550,327,-223
2019,4,23,15,527,540,306,-234
2019,4,23,16,525,542,308,-234
2019,4,23,17,523,536,305,-231
2019,4,23,18,526,534,324,-210
2019,4,23,19,526,555,401,-154
2019,4,23,20,534,563,490,-73
2019,4,23,21,548,583,508,-75
2019,4,23,22,553,591,512,-79
2019,4,23,23,562,599,510,-89
2019,4,24,0,555,595,521,-74
2019,4,24,1,566,591,516,-75
2019,4,24,2,549,568,450,-118
2019,4,24,3,493,515,278,-237
2019,4,24,4,443,464,194,-270
2019,4,24,5,404,417,160,-257
2019,4,24,6,383,398,162,-236
2019,4,24,7,369,385,161,-224
2019,4,24,8,367,385,161,-224
2019,4,24,9,377,393,163,-230
2019,4,24,10,414,421,161,-260
2019,4,24,11,480,487,162,-325
2019,4,24,12,516,517,161,-356
2019,4,24,13,521,525,164,-361
2019,4,24,14,524,527,162,-365
2019,4,24,15,530,532,191,-341
2019,4,24,16,537,545,203,-342
2019,4,24,17,537,550,201,-349
2019,4,24,18,542,561,237,-324
2019,4,24,19,549,584,373,-211
2019,4,24,20,562,591,356,-235
2019,4,24,21,579,605,419,-186
2019,4,24,22,590,621,537,-84
2019,4,24,23,593,615,540,-75
2019,4,25,0,584,600,542,-58
2019,4,25,1,591,599,544,-55
2019,4,25,2,568,579,542,-37
2019,4,25,3,513,521,388,-133
2019,4,25,4,454,467,266,-201
2019,4,25,5,420,420,169,-251
2019,4,25,6,400,393,154,-239
2019,4,25,7,389,381,154,-227
2019,4,25,8,387,380,154,-226
2019,4,25,9,393,388,153,-235
2019,4,25,10,420,416,153,-263
2019,4,25,11,466,482,155,-327
2019,4,25,12,497,511,154,-357
2019,4,25,13,506,521,155,-366
2019,4,25,14,513,528,155,-373
2019,4,25,15,525,532,154,-378
2019,4,25,16,532,532,155,-377
2019,4,25,17,534,519,201,-318
2019,4,25,18,539,535,363,-172
2019,4,25,19,548,539,381,-158
2019,4,25,20,564,531,386,-145
2019,4,25,21,573,533,384,-149
2019,4,25,22,579,542,484,-58
2019,4,25,23,583,541,517,-24
2019,4,26,0,569,543,520,-23
2019,4,26,1,575,553,516,-37
2019,4,26,2,556,545,521,-24
2019,4,26,3,512,498,326,-172
2019,4,26,4,462,456,230,-226
2019,4,26,5,416,423,156,-267
2019,4,26,6,394,399,133,-266
2019,4,26,7,380,393,135,-258
2019,4,26,8,378,385,133,-252
2019,4,26,9,384,389,156,-233
2019,4,26,10,408,413,222,-191
2019,4,26,11,465,474,255,-219
2019,4,26,12,509,511,258,-253
2019,4,26,13,523,529,224,-305
2019,4,26,14,525,533,172,-361
2019,4,26,15,534,530,175,-355
2019,4,26,16,538,525,228,-297
2019,4,26,17,535,529,256,-273
2019,4,26,18,534,520,260,-260
2019,4,26,19,524,507,259,-248
2019,4,26,20,520,492,261,-231
2019,4,26,21,524,492,259,-233
2019,4,26,22,535,506,262,-244
2019,4,26,23,529,504,259,-245
2019,4,27,0,514,511,259,-252
2019,4,27,1,529,523,260,-263
2019,4,27,2,514,513,257,-256
2019,4,27,3,478,502,225,-277
2019,4,27,4,431,457,155,-302
2019,4,27,5,409,426,132,-294
2019,4,27,6,398,406,131,-275
2019,4,27,7,392,404,134,-270
2019,4,27,8,397,401,130,-271
2019,4,27,9,404,405,129,-276
2019,4,27,10,434,432,132,-300
2019,4,27,11,463,463,130,-333
2019,4,27,12,496,507,133,-374
2019,4,27,13,521,529,134,-395
2019,4,27,14,523,526,134,-392
2019,4,27,15,507,511,135,-376
2019,4,27,16,491,498,134,-364
2019,4,27,17,482,486,136,-350
2019,4,27,18,474,478,137,-341
2019,4,27,19,468,476,137,-339
2019,4,27,20,473,479,137,-342
2019,4,27,21,474,494,136,-358
2019,4,27,22,477,509,135,-374
2019,4,27,23,480,505,156,-349
2019,4,28,0,484,500,219,-281
2019,4,28,1,498,510,261,-249
2019,4,28,2,488,502,265,-237
2019,4,28,3,459,470,266,-204
2019,4,28,4,418,434,236,-198
2019,4,28,5,376,404,177,-227
2019,4,28,6,365,381,135,-246
2019,4,28,7,356,367,134,-233
2019,4,28,8,357,365,132,-233
2019,4,28,9,361,366,134,-232
2019,4,28,10,373,377,134,-243
2019,4,28,11,386,399,134,-265
2019,4,28,12,414,425,133,-292
2019,4,28,13,454,465,134,-331
2019,4,28,14,474,484,135,-349
2019,4,28,15,461,486,136,-350
2019,4,28,16,448,487,136,-351
2019,4,28,17,467,495,138,-357
2019,4,28,18,473,501,135,-366
2019,4,28,19,484,509,138,-371
2019,4,28,20,486,520,138,-382
2019,4,28,21,508,523,167,-356
2019,4,28,22,534,545,256,-289
2019,4,28,23,528,555,265,-290
2019,4,29,0,524,549,266,-283
2019,4,29,1,531,552,265,-287
2019,4,29,2,521,530,266,-264
2019,4,29,3,468,493,242,-251
2019,4,29,4,421,442,152,-290
2019,4,29,5,383,397,124,-273
2019,4,29,6,364,379,126,-253
2019,4,29,7,355,371,124,-247
2019,4,29,8,355,368,124,-244
2019,4,29,9,362,375,123,-252
2019,4,29,10,400,412,125,-287
2019,4,29,11,467,476,128,-348
2019,4,29,12,504,500,173,-327
2019,4,29,13,514,514,184,-330
2019,4,29,14,516,533,159,-374
2019,4,29,15,519,527,128,-399
2019,4,29,16,521,525,126,-399
2019,4,29,17,527,526,130,-396
2019,4,29,18,531,539,130,-409
2019,4,29,19,529,545,132,-413
2019,4,29,20,531,545,163,-382
2019,4,29,21,537,561,237,-324
2019,4,29,22,548,579,266,-313
2019,4,29,23,556,585,268,-317
2019,4,30,0,551,580,269,-311
2019,4,30,1,563,581,269,-312
2019,4,30,2,542,564,267,-297
2019,4,30,3,493,514,255,-259
2019,4,30,4,439,465,212,-253
2019,4,30,5,411,423,147,-276
2019,4,30,6,388,397,133,-264
2019,4,30,7,378,387,134,-253
2019,4,30,8,371,384,134,-250
2019,4,30,9,379,389,134,-255
2019,4,30,10,406,413,136,-277
2019,4,30,11,472,474,201,-273
2019,4,30,12,508,510,264,-246
2019,4,30,13,518,523,267,-256
2019,4,30,14,531,537,263,-274
2019,4,30,15,540,544,203,-341
2019,4,30,16,553,553,248,-305
2019,4,30,17,563,569,270,-299
2019,4,30,18,581,581,275,-306
2019,4,30,19,597,601,400,-201
2019,4,30,20,615,618,423,-195
2019,4,30,21,630,639,426,-213
2019,4,30,22,629,647,424,-223
2019,4,30,23,637,637,424,-213
2019,5,1,0,622,628,426,-202
2019,5,1,1,619,629,429,-200
2019,5,1,2,594,604,429,-175
2019,5,1,3,534,551,376,-175
2019,5,1,4,472,499,198,-301
2019,5,1,5,441,444,131,-313
2019,5,1,6,413,418,129,-289
2019,5,1,7,399,403,131,-272
2019,5,1,8,389,392,128,-264
2019,5,1,9,395,398,130,-268
2019,5,1,10,424,423,129,-294
2019,5,1,11,479,477,158,-319
2019,5,1,12,513,509,198,-311
2019,5,1,13,526,524,199,-325
2019,5,1,14,545,544,200,-344
2019,5,1,15,564,564,201,-363
2019,5,1,16,582,577,246,-331
2019,5,1,17,596,590,273,-317
2019,5,1,18,617,611,272,-339
2019,5,1,19,634,614,313,-301
2019,5,1,20,652,618,354,-264
2019,5,1,21,669,636,414,-222
2019,5,1,22,670,636,416,-220
2019,5,1,23,675,628,418,-210
2019,5,2,0,655,611,402,-209
2019,5,2,1,648,612,408,-204
2019,5,2,2,617,596,340,-256
2019,5,2,3,555,546,259,-287
2019,5,2,4,482,486,151,-335
2019,5,2,5,440,437,130,-307
2019,5,2,6,412,416,130,-286
2019,5,2,7,398,402,132,-270
2019,5,2,8,389,393,133,-260
2019,5,2,9,393,397,132,-265
2019,5,2,10,418,422,131,-291
2019,5,2,11,469,486,134,-352
2019,5,2,12,502,512,132,-380
2019,5,2,13,515,533,133,-400
2019,5,2,14,528,549,132,-417
2019,5,2,15,549,570,134,-436
2019,5,2,16,563,592,134,-458
2019,5,2,17,569,592,160,-432
2019,5,2,18,583,604,280,-324
2019,5,2,19,594,616,340,-276
2019,5,2,20,611,624,370,-254
2019,5,2,21,622,642,393,-249
2019,5,2,22,625,650,434,-216
2019,5,2,23,625,640,432,-208
2019,5,3,0,615,624,432,-192
2019,5,3,1,618,617,432,-185
2019,5,3,2,590,592,427,-165
2019,5,3,3,533,537,301,-236
2019,5,3,4,468,490,227,-263
2019,5,3,5,428,431,134,-297
2019,5,3,6,404,405,129,-276
2019,5,3,7,388,392,130,-262
2019,5,3,8,381,384,130,-254
2019,5,3,9,385,387,131,-256
2019,5,3,10,409,412,130,-282
2019,5,3,11,457,473,130,-343
2019,5,3,12,496,505,131,-374
2019,5,3,13,511,519,131,-388
2019,5,3,14,516,534,130,-404
2019,5,3,15,530,551,133,-418
2019,5,3,16,549,564,133,-431
2019,5,3,17,554,568,140,-428
2019,5,3,18,558,577,168,-409
2019,5,3,19,567,581,208,-373
2019,5,3,20,573,566,310,-256
2019,5,3,21,588,582,430,-152
2019,5,3,22,591,598,432,-166
2019,5,3,23,584,596,430,-166
2019,5,4,0,555,578,405,-173
2019,5,4,1,558,573,407,-166
2019,5,4,2,538,560,407,-153
2019,5,4,3,500,524,289,-235
2019,5,4,4,449,476,269,-207
2019,5,4,5,413,439,210,-229
2019,5,4,6,388,408,136,-272
2019,5,4,7,377,388,128,-260
2019,5,4,8,371,381,129,-252
2019,5,4,9,369,381,129,-252
2019,5,4,10,379,391,127,-264
2019,5,4,11,398,414,130,-284
2019,5,4,12,424,438,129,-309
2019,5,4,13,460,470,129,-341
2019,5,4,14,490,498,130,-368
2019,5,4,15,507,518,130,-388
2019,5,4,16,528,525,143,-382
2019,5,4,17,536,534,227,-307
2019,5,4,18,539,550,264,-286
2019,5,4,19,544,540,263,-277
2019,5,4,20,560,523,305,-218
2019,5,4,21,558,528,339,-189
2019,5,4,22,560,525,395,-130
2019,5,4,23,553,527,407,-120
2019,5,5,0,552,522,377,-145
2019,5,5,1,546,528,336,-192
2019,5,5,2,526,514,296,-218
2019,5,5,3,485,487,245,-242
2019,5,5,4,441,444,184,-260
2019,5,5,5,404,403,154,-249
2019,5,5,6,380,385,152,-233
2019,5,5,7,366,374,156,-218
2019,5,5,8,360,362,154,-208
2019,5,5,9,357,358,154,-204
2019,5,5,10,360,366,156,-210
2019,5,5,11,374,385,156,-229
2019,5,5,12,397,410,134,-276
2019,5,5,13,439,452,135,-317
2019,5,5,14,470,476,128,-348
2019,5,5,15,477,487,143,-344
2019,5,5,16,486,493,138,-355
2019,5,5,17,514,507,132,-375
2019,5,5,18,515,505,131,-374
2019,5,5,19,522,499,131,-368
2019,5,5,20,524,503,132,-371
2019,5,5,21,536,513,132,-381
2019,5,5,22,549,525,143,-382
2019,5,5,23,550,536,193,-343
2019,5,6,0,536,545,211,-334
2019,5,6,1,542,535,220,-315
2019,5,6,2,534,528,243,-285
2019,5,6,3,484,486,205,-281
2019,5,6,4,438,439,139,-300
2019,5,6,5,393,395,121,-274
2019,5,6,6,370,379,123,-256
2019,5,6,7,360,368,122,-246
2019,5,6,8,357,368,124,-244
2019,5,6,9,363,375,123,-252
2019,5,6,10,391,408,133,-275
2019,5,6,11,451,466,135,-331
2019,5,6,12,486,502,141,-361
2019,5,6,13,496,506,137,-369
2019,5,6,14,507,520,161,-359
2019,5,6,15,523,524,172,-352
2019,5,6,16,541,542,183,-359
2019,5,6,17,553,542,185,-357
2019,5,6,18,556,549,184,-365
2019,5,6,19,560,553,183,-370
2019,5,6,20,570,566,185,-381
2019,5,6,21,583,583,190,-393
2019,5,6,22,595,585,202,-383
2019,5,6,23,602,592,309,-283
2019,5,7,0,584,581,394,-187
2019,5,7,1,590,583,441,-142
2019,5,7,2,566,564,452,-112
2019,5,7,3,513,507,450,-57
2019,5,7,4,455,472,357,-115
2019,5,7,5,411,418,224,-194
2019,5,7,6,389,385,194,-191
2019,5,7,7,379,383,197,-186
2019,5,7,8,374,375,193,-182
2019,5,7,9,380,385,194,-191
2019,5,7,10,407,414,196,-218
2019,5,7,11,466,475,194,-281
2019,5,7,12,499,507,197,-310
2019,5,7,13,511,512,198,-314
2019,5,7,14,525,564,200,-364
2019,5,7,15,535,524,197,-327
2019,5,7,16,550,545,200,-345
2019,5,7,17,559,550,208,-342
2019,5,7,18,566,557,250,-307
2019,5,7,19,582,557,289,-268
2019,5,7,20,597,569,344,-225
2019,5,7,21,610,577,422,-155
2019,5,7,22,613,598,448,-150
2019,5,7,23,617,601,447,-154
2019,5,8,0,602,594,448,-146
2019,5,8,1,603,587,444,-143
2019,5,8,2,577,574,447,-127
2019,5,8,3,525,532,419,-113
2019,5,8,4,468,476,303,-173
2019,5,8,5,430,427,209,-218
2019,5,8,6,407,401,190,-211
2019,5,8,7,394,390,197,-193
2019,5,8,8,387,389,193,-196
2019,5,8,9,390,391,195,-196
2019,5,8,10,416,412,190,-222
2019,5,8,11,469,478,193,-285
2019,5,8,12,499,508,193,-315
2019,5,8,13,516,519,194,-325
2019,5,8,14,532,539,195,-344
2019,5,8,15,555,555,196,-359
2019,5,8,16,570,569,197,-372
2019,5,8,17,578,572,216,-356
2019,5,8,18,583,586,364,-222
2019,5,8,19,592,615,448,-167
2019,5,8,20,601,628,453,-175
2019,5,8,21,609,636,455,-181
2019,5,8,22,612,641,454,-187
2019,5,8,23,611,639,451,-188
2019,5,9,0,606,624,454,-170
2019,5,9,1,608,611,418,-193
2019,5,9,2,581,597,450,-147
2019,5,9,3,527,549,400,-149
2019,5,9,4,468,488,318,-170
2019,5,9,5,426,447,234,-213
2019,5,9,6,400,415,189,-226
2019,5,9,7,388,400,185,-215
2019,5,9,8,380,395,185,-210
2019,5,9,9,383,403,185,-218
2019,5,9,10,410,427,185,-242
2019,5,9,11,468,485,187,-298
2019,5,9,12,500,513,188,-325
2019,5,9,13,516,533,192,-341
2019,5,9,14,533,543,189,-354
2019,5,9,15,555,554,192,-362
2019,5,9,16,574,564,190,-374
2019,5,9,17,580,579,193,-386
2019,5,9,18,594,525,161,-364
2019,5,9,19,604,624,365,-259
2019,5,9,20,619,596,420,-176
2019,5,9,21,629,609,434,-175
2019,5,9,22,634,599,435,-164
2019,5,9,23,629,595,443,-152
2019,5,10,0,620,589,447,-142
2019,5,10,1,622,589,444,-145
2019,5,10,2,594,586,443,-143
2019,5,10,3,541,551,334,-217
2019,5,10,4,480,480,194,-286
2019,5,10,5,431,433,180,-253
2019,5,10,6,406,413,181,-232
2019,5,10,7,390,396,181,-215
2019,5,10,8,382,392,181,-211
2019,5,10,9,385,398,182,-216
2019,5,10,10,408,428,182,-246
2019,5,10,11,461,484,181,-303
2019,5,10,12,497,515,183,-332
2019,5,10,13,517,530,183,-347
2019,5,10,14,532,544,179,-365
2019,5,10,15,552,561,184,-377
2019,5,10,16,576,576,185,-391
2019,5,10,17,580,591,186,-405
2019,5,10,18,591,598,214,-384
2019,5,10,19,599,611,325,-286
2019,5,10,20,606,638,371,-267
2019,5,10,21,618,646,392,-254
2019,5,10,22,624,625,386,-239
2019,5,10,23,610,604,388,-216
2019,5,11,0,581,583,386,-197
2019,5,11,1,581,580,387,-193
2019,5,11,2,556,567,378,-189
2019,5,11,3,517,526,336,-190
2019,5,11,4,462,489,257,-232
2019,5,11,5,415,432,197,-235
2019,5,11,6,394,407,191,-216
2019,5,11,7,382,395,190,-205
2019,5,11,8,374,387,191,-196
2019,5,11,9,372,387,190,-197
2019,5,11,10,386,396,191,-205
2019,5,11,11,408,412,192,-220
2019,5,11,12,434,442,191,-251
2019,5,11,13,463,472,190,-282
2019,5,11,14,493,506,191,-315
2019,5,11,15,502,526,191,-335
2019,5,11,16,516,530,191,-339
2019,5,11,17,521,529,195,-334
2019,5,11,18,521,515,257,-258
2019,5,11,19,516,517,307,-210
2019,5,11,20,537,508,335,-173
2019,5,11,21,538,513,392,-121
2019,5,11,22,545,519,394,-125
2019,5,11,23,538,519,391,-128
2019,5,12,0,532,518,387,-131
2019,5,12,1,522,539,369,-170
2019,5,12,2,509,518,325,-193
2019,5,12,3,470,496,287,-209
2019,5,12,4,429,464,175,-289
2019,5,12,5,400,417,124,-293
2019,5,12,6,378,388,120,-268
2019,5,12,7,362,378,126,-252
2019,5,12,8,355,370,125,-245
2019,5,12,9,352,374,126,-248
2019,5,12,10,358,376,125,-251
2019,5,12,11,371,391,125,-266
2019,5,12,12,398,420,124,-296
2019,5,12,13,442,464,126,-338
2019,5,12,14,470,494,126,-368
2019,5,12,15,474,499,125,-374
2019,5,12,16,474,512,128,-384
2019,5,12,17,493,513,131,-382
2019,5,12,18,493,513,138,-375
2019,5,12,19,495,507,131,-376
2019,5,12,20,508,502,130,-372
2019,5,12,21,524,525,159,-366
2019,5,12,22,537,535,160,-375
2019,5,12,23,533,532,159,-373
2019,5,13,0,524,528,160,-368
2019,5,13,1,528,525,180,-345
2019,5,13,2,534,514,228,-286
2019,5,13,3,488,482,172,-310
2019,5,13,4,436,436,154,-282
2019,5,13,5,390,396,148,-248
2019,5,13,6,365,382,153,-229
2019,5,13,7,358,377,155,-222
2019,5,13,8,355,376,154,-222
2019,5,13,9,360,379,153,-226
2019,5,13,10,395,406,154,-252
2019,5,13,11,461,467,154,-313
2019,5,13,12,496,494,153,-341
2019,5,13,13,507,510,153,-357
2019,5,13,14,517,520,154,-366
2019,5,13,15,524,534,157,-377
2019,5,13,16,540,530,156,-374
2019,5,13,17,542,529,154,-375
2019,5,13,18,543,533,157,-376
2019,5,13,19,537,532,156,-376
2019,5,13,20,545,531,154,-377
2019,5,13,21,553,538,158,-380
2019,5,13,22,566,541,214,-327
2019,5,13,23,573,558,249,-309
2019,5,14,0,563,552,245,-307
2019,5,14,1,563,553,240,-313
2019,5,14,2,543,539,250,-289
2019,5,14,3,496,502,223,-279
2019,5,14,4,441,446,168,-278
2019,5,14,5,413,404,147,-257
2019,5,14,6,398,398,158,-240
2019,5,14,7,394,393,160,-233
2019,5,14,8,398,389,163,-226
2019,5,14,9,409,406,171,-235
2019,5,14,10,448,440,166,-274
2019,5,14,11,519,510,164,-346
2019,5,14,12,552,540,163,-377
2019,5,14,13,547,537,163,-374
2019,5,14,14,536,539,164,-375
2019,5,14,15,526,536,161,-375
2019,5,14,16,522,531,159,-372
2019,5,14,17,516,519,146,-373
2019,5,14,18,515,515,156,-359
2019,5,14,19,511,508,165,-343
2019,5,14,20,515,508,169,-339
2019,5,14,21,525,518,170,-348
2019,5,14,22,532,530,170,-360
2019,5,14,23,542,533,168,-365
2019,5,15,0,550,538,166,-372
2019,5,15,1,548,545,166,-379
2019,5,15,2,527,536,161,-375
2019,5,15,3,497,491,171,-320
2019,5,15,4,454,447,177,-270
2019,5,15,5,424,407,169,-238
2019,5,15,6,410,403,177,-226
2019,5,15,7,407,404,173,-231
2019,5,15,8,410,404,166,-238
2019,5,15,9,424,421,166,-255
2019,5,15,10,470,460,168,-292
2019,5,15,11,540,535,168,-367
2019,5,15,12,576,563,167,-396
2019,5,15,13,572,558,166,-392
2019,5,15,14,562,553,157,-396
2019,5,15,15,555,542,159,-383
2019,5,15,16,548,532,157,-375
2019,5,15,17,536,522,158,-364
2019,5,15,18,537,528,157,-371
2019,5,15,19,531,525,166,-359
2019,5,15,20,528,525,177,-348
2019,5,15,21,533,535,143,-392
2019,5,15,22,539,538,129,-409
2019,5,15,23,548,543,128,-415
2019,5,16,0,562,537,128,-409
2019,5,16,1,564,549,135,-414
2019,5,16,2,554,540,131,-409
2019,5,16,3,512,491,126,-365
2019,5,16,4,453,447,125,-322
2019,5,16,5,407,413,125,-288
2019,5,16,6,391,397,124,-273
2019,5,16,7,385,387,124,-263
2019,5,16,8,385,388,123,-265
2019,5,16,9,396,402,123,-279
2019,5,16,10,433,436,125,-311
2019,5,16,11,498,502,126,-376
2019,5,16,12,532,533,145,-388
2019,5,16,13,537,534,172,-362
2019,5,16,14,539,540,184,-356
2019,5,16,15,535,530,188,-342
2019,5,16,16,537,531,191,-340
2019,5,16,17,536,543,199,-344
2019,5,16,18,540,538,141,-397
2019,5,16,19,543,549,204,-345
2019,5,16,20,549,561,252,-309
2019,5,16,21,568,583,259,-324
2019,5,16,22,579,577,140,-437
2019,5,16,23,581,592,183,-409
2019,5,17,0,572,587,218,-369
2019,5,17,1,569,582,230,-352
2019,5,17,2,562,577,222,-355
2019,5,17,3,516,519,180,-339
2019,5,17,4,463,464,140,-324
2019,5,17,5,419,419,123,-296
2019,5,17,6,395,398,124,-274
2019,5,17,7,380,389,125,-264
2019,5,17,8,378,386,126,-260
2019,5,17,9,385,391,126,-265
2019,5,17,10,410,416,125,-291
2019,5,17,11,466,476,126,-350
2019,5,17,12,504,510,129,-381
2019,5,17,13,523,519,127,-392
2019,5,17,14,537,533,133,-400
2019,5,17,15,538,536,135,-401
2019,5,17,16,552,547,165,-382
2019,5,17,17,562,554,153,-401
2019,5,17,18,573,568,161,-407
2019,5,17,19,592,584,250,-334
2019,5,17,20,604,599,307,-292
2019,5,17,21,622,626,372,-254
2019,5,17,22,626,629,341,-288
2019,5,17,23,617,627,395,-232
2019,5,18,0,589,613,402,-211
2019,5,18,1,581,593,256,-337
2019,5,18,2,566,578,247,-331
2019,5,18,3,529,550,205,-345
2019,5,18,4,476,483,141,-342
2019,5,18,5,434,434,134,-300
2019,5,18,6,409,404,133,-271
2019,5,18,7,389,388,132,-256
2019,5,18,8,384,384,132,-252
2019,5,18,9,382,385,133,-252
2019,5,18,10,390,394,134,-260
2019,5,18,11,404,404,132,-272
2019,5,18,12,437,443,133,-310
2019,5,18,13,471,479,135,-344
2019,5,18,14,512,509,136,-373
2019,5,18,15,534,531,147,-384
2019,5,18,16,551,554,200,-354
2019,5,18,17,567,574,278,-296
2019,5,18,18,584,596,350,-246
2019,5,18,19,601,620,357,-263
2019,5,18,20,621,634,387,-247
2019,5,18,21,634,644,387,-257
2019,5,18,22,638,655,335,-320
2019,5,18,23,637,655,326,-329
2019,5,19,0,610,626,290,-336
2019,5,19,1,596,610,263,-347
2019,5,19,2,583,592,265,-327
2019,5,19,3,538,545,263,-282
2019,5,19,4,480,507,248,-259
2019,5,19,5,443,455,158,-297
2019,5,19,6,412,421,133,-288
2019,5,19,7,393,400,134,-266
2019,5,19,8,384,389,134,-255
2019,5,19,9,380,386,135,-251
2019,5,19,10,380,385,133,-252
2019,5,19,11,397,398,134,-264
2019,5,19,12,422,427,134,-293
2019,5,19,13,468,473,136,-337
2019,5,19,14,507,514,135,-379
2019,5,19,15,530,541,203,-338
2019,5,19,16,556,563,227,-336
2019,5,19,17,571,580,310,-270
2019,5,19,18,594,603,382,-221
2019,5,19,19,618,622,397,-225
2019,5,19,20,629,630,412,-218
2019,5,19,21,644,650,415,-235
2019,5,19,22,656,655,412,-243
2019,5,19,23,655,653,413,-240
2019,5,20,0,639,641,370,-271
2019,5,20,1,617,625,260,-365
2019,5,20,2,603,600,259,-341
2019,5,20,3,546,555,232,-323
2019,5,20,4,486,495,139,-356
2019,5,20,5,447,440,122,-318
2019,5,20,6,416,411,125,-286
2019,5,20,7,400,398,127,-271
2019,5,20,8,390,391,126,-265
2019,5,20,9,397,395,126,-269
2019,5,20,10,420,422,139,-283
2019,5,20,11,475,478,153,-325
2019,5,20,12,513,510,163,-347
2019,5,20,13,537,536,181,-355
2019,5,20,14,559,560,184,-376
2019,5,20,15,583,580,192,-388
2019,5,20,16,602,611,230,-381
2019,5,20,17,618,628,235,-393
2019,5,20,18,631,646,297,-349
2019,5,20,19,646,660,361,-299
2019,5,20,20,654,677,375,-302
2019,5,20,21,663,687,342,-345
2019,5,20,22,671,694,380,-314
2019,5,20,23,663,696,388,-308
2019,5,21,0,644,677,383,-294
2019,5,21,1,632,651,386,-265
2019,5,21,2,613,630,377,-253
2019,5,21,3,562,565,335,-230
2019,5,21,4,496,504,236,-268
2019,5,21,5,446,445,164,-281
2019,5,21,6,418,414,161,-253
2019,5,21,7,404,398,165,-233
2019,5,21,8,396,388,163,-225
2019,5,21,9,398,393,165,-228
2019,5,21,10,425,423,170,-253
2019,5,21,11,476,479,196,-283
2019,5,21,12,510,508,196,-312
2019,5,21,13,530,526,200,-326
2019,5,21,14,551,541,198,-343
2019,5,21,15,575,561,200,-361
2019,5,21,16,597,560,279,-281
2019,5,21,17,614,599,384,-215
2019,5,21,18,627,629,404,-225
2019,5,21,19,651,653,404,-249
2019,5,21,20,666,685,407,-278
2019,5,21,21,680,713,408,-305
2019,5,21,22,685,726,406,-320
2019,5,21,23,679,730,407,-323
2019,5,22,0,655,708,408,-300
2019,5,22,1,643,681,408,-273
2019,5,22,2,620,653,406,-247
2019,5,22,3,565,599,340,-259
2019,5,22,4,502,523,194,-329
2019,5,22,5,455,464,161,-303
2019,5,22,6,433,434,162,-272
2019,5,22,7,413,417,161,-256
2019,5,22,8,406,411,162,-249
2019,5,22,9,407,408,162,-246
2019,5,22,10,426,438,165,-273
2019,5,22,11,478,485,160,-325
2019,5,22,12,508,529,165,-364
2019,5,22,13,530,542,153,-389
2019,5,22,14,556,564,192,-372
2019,5,22,15,571,590,194,-396
2019,5,22,16,593,608,193,-415
2019,5,22,17,612,631,196,-435
2019,5,22,18,631,651,207,-444
2019,5,22,19,651,672,236,-436
2019,5,22,20,664,693,250,-443
2019,5,22,21,676,712,249,-463
2019,5,22,22,680,704,290,-414
2019,5,22,23,676,704,336,-368
2019,5,23,0,656,686,348,-338
2019,5,23,1,638,676,351,-325
2019,5,23,2,620,642,342,-300
2019,5,23,3,567,607,310,-297
2019,5,23,4,503,532,194,-338
2019,5,23,5,478,481,156,-325
2019,5,23,6,446,454,150,-304
2019,5,23,7,431,441,152,-289
2019,5,23,8,419,429,150,-279
2019,5,23,9,421,436,153,-283
2019,5,23,10,444,464,151,-313
2019,5,23,11,496,521,151,-370
2019,5,23,12,528,556,152,-404
2019,5,23,13,553,578,152,-426
2019,5,23,14,577,600,165,-435
2019,5,23,15,612,629,183,-446
2019,5,23,16,642,663,207,-456
2019,5,23,17,661,688,254,-434
2019,5,23,18,685,716,282,-434
2019,5,23,19,714,720,293,-427
2019,5,23,20,732,743,369,-374
2019,5,23,21,739,751,353,-398
2019,5,23,22,745,750,388,-362
2019,5,23,23,731,743,397,-346
2019,5,24,0,709,731,409,-322
2019,5,24,1,692,702,401,-301
2019,5,24,2,658,681,405,-276
2019,5,24,3,605,618,405,-213
2019,5,24,4,533,559,296,-263
2019,5,24,5,491,493,163,-330
2019,5,24,6,459,450,127,-323
2019,5,24,7,439,432,131,-301
2019,5,24,8,426,420,129,-291
2019,5,24,9,426,420,130,-290
2019,5,24,10,450,444,130,-314
2019,5,24,11,500,491,136,-355
2019,5,24,12,538,525,196,-329
2019,5,24,13,565,553,196,-357
2019,5,24,14,593,589,199,-390
2019,5,24,15,628,624,199,-425
2019,5,24,16,658,646,210,-436
2019,5,24,17,684,677,254,-423
2019,5,24,18,705,694,329,-365
2019,5,24,19,742,733,401,-332
2019,5,24,20,760,748,409,-339
2019,5,24,21,770,758,426,-332
2019,5,24,22,775,760,439,-321
2019,5,24,23,753,740,446,-294
2019,5,25,0,724,719,455,-264
2019,5,25,1,698,687,455,-232
2019,5,25,2,667,655,455,-200
2019,5,25,3,619,600,455,-145
2019,5,25,4,550,555,424,-131
2019,5,25,5,487,489,244,-245
2019,5,25,6,447,448,181,-267
2019,5,25,7,426,429,152,-277
2019,5,25,8,414,410,125,-285
2019,5,25,9,406,399,123,-276
2019,5,25,10,411,402,122,-280
2019,5,25,11,421,419,124,-295
2019,5,25,12,451,450,124,-326
2019,5,25,13,494,495,125,-370
2019,5,25,14,543,538,126,-412
2019,5,25,15,572,584,176,-408
2019,5,25,16,609,620,188,-432
2019,5,25,17,643,635,273,-362
2019,5,25,18,670,673,334,-339
2019,5,25,19,676,697,374,-323
2019,5,25,20,698,724,439,-285
2019,5,25,21,719,748,446,-302
2019,5,25,22,735,754,449,-305
2019,5,25,23,723,749,452,-297
2019,5,26,0,700,718,451,-267
2019,5,26,1,662,679,451,-228
2019,5,26,2,638,653,450,-203
2019,5,26,3,581,608,441,-167
2019,5,26,4,518,553,351,-202
2019,5,26,5,457,493,195,-298
2019,5,26,6,427,450,125,-325
2019,5,26,7,407,426,118,-308
2019,5,26,8,395,408,117,-291
2019,5,26,9,389,400,114,-286
2019,5,26,10,388,402,113,-289
2019,5,26,11,401,408,114,-294
2019,5,26,12,433,438,113,-325
2019,5,26,13,481,485,113,-372
2019,5,26,14,520,534,119,-415
2019,5,26,15,544,567,165,-402
2019,5,26,16,582,596,178,-418
2019,5,26,17,620,623,180,-443
2019,5,26,18,655,642,282,-360
2019,5,26,19,677,668,361,-307
2019,5,26,20,698,695,402,-293
2019,5,26,21,716,714,422,-292
2019,5,26,22,723,728,440,-288
2019,5,26,23,693,724,444,-280
2019,5,27,0,680,699,448,-251
2019,5,27,1,647,649,435,-214
2019,5,27,2,637,625,431,-194
2019,5,27,3,583,574,433,-141
2019,5,27,4,524,532,384,-148
2019,5,27,5,465,480,203,-277
2019,5,27,6,442,431,128,-303
2019,5,27,7,422,407,125,-282
2019,5,27,8,416,398,127,-271
2019,5,27,9,410,397,117,-280
2019,5,27,10,415,408,118,-290
2019,5,27,11,439,425,118,-307
2019,5,27,12,464,454,118,-336
2019,5,27,13,501,492,118,-374
2019,5,27,14,545,543,156,-387
2019,5,27,15,580,586,182,-404
2019,5,27,16,614,629,216,-413
2019,5,27,17,648,654,250,-404
2019,5,27,18,686,684,276,-408
2019,5,27,19,714,694,296,-398
2019,5,27,20,732,708,417,-291
2019,5,27,21,750,736,448,-288
2019,5,27,22,762,741,451,-290
2019,5,27,23,749,736,448,-288
2019,5,28,0,728,713,436,-277
2019,5,28,1,690,686,385,-301
2019,5,28,2,677,664,339,-325
2019,5,28,3,604,599,227,-372
2019,5,28,4,543,517,191,-326
2019,5,28,5,474,465,140,-325
2019,5,28,6,444,432,121,-311
2019,5,28,7,427,411,120,-291
2019,5,28,8,417,402,123,-279
2019,5,28,9,423,397,119,-278
2019,5,28,10,448,428,122,-306
2019,5,28,11,503,481,119,-362
2019,5,28,12,547,513,120,-393
2019,5,28,13,585,551,123,-428
2019,5,28,14,607,579,143,-436
2019,5,28,15,656,619,221,-398
2019,5,28,16,688,630,290,-340
2019,5,28,17,705,680,431,-249
2019,5,28,18,738,722,441,-281
2019,5,28,19,767,752,444,-308
2019,5,28,20,783,770,444,-326
2019,5,28,21,791,797,450,-347
2019,5,28,22,800,798,448,-350
2019,5,28,23,787,792,447,-345
2019,5,29,0,775,769,448,-321
2019,5,29,1,741,734,450,-284
2019,5,29,2,713,695,448,-247
2019,5,29,3,644,641,386,-255
2019,5,29,4,560,558,199,-359
2019,5,29,5,511,486,150,-336
2019,5,29,6,478,453,148,-305
2019,5,29,7,455,438,138,-300
2019,5,29,8,443,425,135,-290
2019,5,29,9,442,425,135,-290
2019,5,29,10,466,447,133,-314
2019,5,29,11,521,499,134,-365
2019,5,29,12,557,536,135,-401
2019,5,29,13,592,564,135,-429
2019,5,29,14,620,597,142,-455
2019,5,29,15,657,634,210,-424
2019,5,29,16,694,655,316,-339
2019,5,29,17,723,695,406,-289
2019,5,29,18,753,739,447,-292
2019,5,29,19,792,769,447,-322
2019,5,29,20,808,786,449,-337
2019,5,29,21,825,806,447,-359
2019,5,29,22,837,811,445,-366
2019,5,29,23,816,799,444,-355
2019,5,30,0,784,770,443,-327
2019,5,30,1,761,730,446,-284
2019,5,30,2,718,689,393,-296
2019,5,30,3,649,628,380,-248
2019,5,30,4,566,565,250,-315
2019,5,30,5,522,490,136,-354
2019,5,30,6,487,453,124,-329
2019,5,30,7,464,434,126,-308
2019,5,30,8,452,425,126,-299
2019,5,30,9,450,423,125,-298
2019,5,30,10,476,449,126,-323
2019,5,30,11,529,499,126,-373
2019,5,30,12,566,539,127,-412
2019,5,30,13,602,563,128,-435
2019,5,30,14,629,597,147,-450
2019,5,30,15,668,640,164,-476
2019,5,30,16,704,669,222,-447
2019,5,30,17,742,703,227,-476
2019,5,30,18,762,716,278,-438
2019,5,30,19,787,759,348,-411
2019,5,30,20,799,766,424,-342
2019,5,30,21,808,790,445,-345
2019,5,30,22,819,784,462,-322
2019,5,30,23,812,769,598,-171
2019,5,31,0,786,738,550,-188
2019,5,31,1,765,710,535,-175
2019,5,31,2,727,677,426,-251
2019,5,31,3,660,626,370,-256
2019,5,31,4,571,560,254,-306
2019,5,31,5,521,494,142,-352
2019,5,31,6,482,458,121,-337
2019,5,31,7,460,442,120,-322
2019,5,31,8,444,427,116,-311
2019,5,31,9,440,436,119,-317
2019,5,31,10,458,457,118,-339
2019,5,31,11,503,509,118,-391
2019,5,31,12,535,535,130,-405
2019,5,31,13,564,566,155,-411
2019,5,31,14,594,568,167,-401
2019,5,31,15,619,781,187,-594
2019,5,31,16,653,650,225,-425
2019,5,31,17,676,663,308,-355
2019,5,31,18,694,672,332,-340
2019,5,31,19,731,684,405,-279
2019,5,31,20,747,692,448,-244
2019,5,31,21,759,689,452,-237
2019,5,31,22,775,684,455,-229
2019,5,31,23,762,644,451,-193
2019,6,1,0,731,629,401,-228
2019,6,1,1,707,591,265,-326
2019,6,1,2,684,572,157,-415
2019,6,1,3,627,534,120,-414
2019,6,1,4,559,484,79,-405
2019,6,1,5,455,436,62,-374
2019,6,1,6,424,411,61,-350
2019,6,1,7,407,390,62,-328
2019,6,1,8,395,384,63,-321
2019,6,1,9,392,378,61,-317
2019,6,1,10,400,394,63,-331
2019,6,1,11,415,407,63,-344
2019,6,1,12,443,434,66,-368
2019,6,1,13,479,471,67,-404
2019,6,1,14,510,497,68,-429
2019,6,1,15,534,520,70,-450
2019,6,1,16,553,537,131,-406
2019,6,1,17,565,551,133,-418
2019,6,1,18,574,566,132,-434
2019,6,1,19,582,586,132,-454
2019,6,1,20,598,603,132,-471
2019,6,1,21,615,628,137,-491
2019,6,1,22,619,631,205,-426
2019,6,1,23,622,634,253,-381
2019,6,2,0,604,612,261,-351
2019,6,2,1,576,592,262,-330
2019,6,2,2,563,578,254,-324
2019,6,2,3,528,536,120,-416
2019,6,2,4,477,475,74,-401
2019,6,2,5,426,428,66,-362
2019,6,2,6,398,400,63,-337
2019,6,2,7,379,382,65,-317
2019,6,2,8,371,373,65,-308
2019,6,2,9,365,371,65,-306
2019,6,2,10,373,376,63,-313
2019,6,2,11,380,389,65,-324
2019,6,2,12,404,415,65,-350
2019,6,2,13,449,456,65,-391
2019,6,2,14,481,486,66,-420
2019,6,2,15,494,507,73,-434
2019,6,2,16,501,533,130,-403
2019,6,2,17,532,554,129,-425
2019,6,2,18,543,576,129,-447
2019,6,2,19,563,592,148,-444
2019,6,2,20,577,620,168,-452
2019,6,2,21,598,642,180,-462
2019,6,2,22,619,662,227,-435
2019,6,2,23,611,656,252,-404
2019,6,3,0,591,639,261,-378
2019,6,3,1,574,630,235,-395
2019,6,3,2,566,605,127,-478
2019,6,3,3,524,554,110,-444
2019,6,3,4,462,495,78,-417
2019,6,3,5,436,447,69,-378
2019,6,3,6,408,415,67,-348
2019,6,3,7,393,400,68,-332
2019,6,3,8,385,396,70,-326
2019,6,3,9,385,395,69,-326
2019,6,3,10,409,425,66,-359
2019,6,3,11,459,474,65,-409
2019,6,3,12,496,507,65,-442
2019,6,3,13,517,531,67,-464
2019,6,3,14,533,556,72,-484
2019,6,3,15,548,582,97,-485
2019,6,3,16,564,599,106,-493
2019,6,3,17,570,616,119,-497
2019,6,3,18,576,630,134,-496
2019,6,3,19,587,626,142,-484
2019,6,3,20,599,664,230,-434
2019,6,3,21,612,681,320,-361
2019,6,3,22,623,683,341,-342
2019,6,3,23,614,675,343,-332
2019,6,4,0,592,648,341,-307
2019,6,4,1,581,620,158,-462
2019,6,4,2,564,600,142,-458
2019,6,4,3,516,547,125,-422
2019,6,4,4,460,481,81,-400
2019,6,4,5,427,430,71,-359
2019,6,4,6,404,402,72,-330
2019,6,4,7,389,390,70,-320
2019,6,4,8,386,387,73,-314
2019,6,4,9,390,390,70,-320
2019,6,4,10,416,417,72,-345
2019,6,4,11,461,474,72,-402
2019,6,4,12,496,501,71,-430
2019,6,4,13,508,519,91,-428
2019,6,4,14,522,530,105,-425
2019,6,4,15,535,506,110,-396
2019,6,4,16,546,568,143,-425
2019,6,4,17,557,588,146,-442
2019,6,4,18,569,605,143,-462
2019,6,4,19,578,616,137,-479
2019,6,4,20,592,635,137,-498
2019,6,4,21,605,657,142,-515
2019,6,4,22,610,665,173,-492
2019,6,4,23,612,672,246,-426
2019,6,5,0,600,660,259,-401
2019,6,5,1,583,639,263,-376
2019,6,5,2,581,622,263,-359
2019,6,5,3,536,573,237,-336
2019,6,5,4,480,505,190,-315
2019,6,5,5,441,457,97,-360
2019,6,5,6,416,426,68,-358
2019,6,5,7,402,411,71,-340
2019,6,5,8,396,407,75,-332
2019,6,5,9,397,413,67,-346
2019,6,5,10,424,442,67,-375
2019,6,5,11,466,498,65,-433
2019,6,5,12,504,529,62,-467
2019,6,5,13,531,548,63,-485
2019,6,5,14,550,569,74,-495
2019,6,5,15,580,589,109,-480
2019,6,5,16,599,604,141,-463
2019,6,5,17,610,607,136,-471
2019,6,5,18,633,613,134,-479
2019,6,5,19,652,600,136,-464
2019,6,5,20,667,597,135,-462
2019,6,5,21,678,589,136,-453
2019,6,5,22,686,599,135,-464
2019,6,5,23,679,600,142,-458
2019,6,6,0,659,604,177,-427
2019,6,6,1,638,601,177,-424
2019,6,6,2,622,593,176,-417
2019,6,6,3,570,548,160,-388
2019,6,6,4,507,494,140,-354
2019,6,6,5,460,445,108,-337
2019,6,6,6,431,423,103,-320
2019,6,6,7,415,410,105,-305
2019,6,6,8,405,403,102,-301
2019,6,6,9,407,405,101,-304
2019,6,6,10,429,433,103,-330
2019,6,6,11,478,482,101,-381
2019,6,6,12,516,520,104,-416
2019,6,6,13,539,538,103,-435
2019,6,6,14,565,561,105,-456
2019,6,6,15,595,583,103,-480
2019,6,6,16,617,605,129,-476
2019,6,6,17,632,624,136,-488
2019,6,6,18,652,632,190,-442
2019,6,6,19,665,634,247,-387
2019,6,6,20,679,641,245,-396
2019,6,6,21,693,660,244,-416
2019,6,6,22,699,679,229,-450
2019,6,6,23,686,669,206,-463
2019,6,7,0,666,656,211,-445
2019,6,7,1,646,640,225,-415
2019,6,7,2,631,620,186,-434
2019,6,7,3,581,570,124,-446
2019,6,7,4,518,519,107,-412
2019,6,7,5,468,470,93,-377
2019,6,7,6,439,444,94,-350
2019,6,7,7,420,429,94,-335
2019,6,7,8,409,421,94,-327
2019,6,7,9,412,421,91,-330
2019,6,7,10,433,447,94,-353
2019,6,7,11,476,497,94,-403
2019,6,7,12,515,529,92,-437
2019,6,7,13,543,550,94,-456
2019,6,7,14,567,567,95,-472
2019,6,7,15,591,581,96,-485
2019,6,7,16,614,588,99,-489
2019,6,7,17,631,599,111,-488
2019,6,7,18,639,605,130,-475
2019,6,7,19,652,600,131,-469
2019,6,7,20,661,599,131,-468
2019,6,7,21,670,616,131,-485
2019,6,7,22,672,631,129,-502
2019,6,7,23,654,621,123,-498
2019,6,8,0,635,605,128,-477
2019,6,8,1,622,597,129,-468
2019,6,8,2,608,582,129,-453
2019,6,8,3,569,542,130,-412
2019,6,8,4,516,493,129,-364
2019,6,8,5,454,455,127,-328
2019,6,8,6,423,431,128,-303
2019,6,8,7,406,413,128,-285
2019,6,8,8,395,402,129,-273
2019,6,8,9,391,403,129,-274
2019,6,8,10,402,411,128,-283
2019,6,8,11,422,430,130,-300
2019,6,8,12,451,454,128,-326
2019,6,8,13,489,501,130,-371
2019,6,8,14,530,536,129,-407
2019,6,8,15,550,566,131,-435
2019,6,8,16,559,589,132,-457
2019,6,8,17,574,588,130,-458
2019,6,8,18,572,587,131,-456
2019,6,8,19,575,586,129,-457
2019,6,8,20,586,577,129,-448
2019,6,8,21,591,576,132,-444
2019,6,8,22,586,564,130,-434
2019,6,8,23,572,553,131,-422
2019,6,9,0,564,548,131,-417
2019,6,9,1,562,541,131,-410
2019,6,9,2,557,538,129,-409
2019,6,9,3,520,505,129,-376
2019,6,9,4,476,470,131,-339
2019,6,9,5,438,430,129,-301
2019,6,9,6,412,409,130,-279
2019,6,9,7,396,392,128,-264
2019,6,9,8,387,390,131,-259
2019,6,9,9,382,386,131,-255
2019,6,9,10,382,395,129,-266
2019,6,9,11,396,406,128,-278
2019,6,9,12,423,431,128,-303
2019,6,9,13,457,475,129,-346
2019,6,9,14,489,500,137,-363
2019,6,9,15,512,517,133,-384
2019,6,9,16,536,530,131,-399
2019,6,9,17,558,545,128,-417
2019,6,9,18,572,554,131,-423
2019,6,9,19,594,561,131,-430
2019,6,9,20,603,569,128,-441
2019,6,9,21,608,582,129,-453
2019,6,9,22,615,595,129,-466
2019,6,9,23,604,602,131,-471
2019,6,10,0,590,592,129,-463
2019,6,10,1,572,589,131,-458
2019,6,10,2,559,568,129,-439
2019,6,10,3,524,530,130,-400
2019,6,10,4,473,479,127,-352
2019,6,10,5,446,435,119,-316
2019,6,10,6,417,419,128,-291
2019,6,10,7,402,410,129,-281
2019,6,10,8,392,403,129,-274
2019,6,10,9,398,408,129,-279
2019,6,10,10,422,437,130,-307
2019,6,10,11,474,487,103,-384
2019,6,10,12,516,526,94,-432
2019,6,10,13,547,551,94,-457
2019,6,10,14,572,576,96,-480
2019,6,10,15,610,600,98,-502
2019,6,10,16,638,612,124,-488
2019,6,10,17,656,636,147,-489
2019,6,10,18,671,638,225,-413
2019,6,10,19,674,637,351,-286
2019,6,10,20,687,633,377,-256
2019,6,10,21,696,626,379,-247
2019,6,10,22,699,622,363,-259
2019,6,10,23,690,629,238,-391
2019,6,11,0,681,620,163,-457
2019,6,11,1,653,609,147,-462
2019,6,11,2,636,593,140,-453
2019,6,11,3,584,549,141,-408
2019,6,11,4,525,497,135,-362
2019,6,11,5,470,445,127,-318
2019,6,11,6,441,428,137,-291
2019,6,11,7,424,410,137,-273
2019,6,11,8,415,399,136,-263
2019,6,11,9,419,400,138,-262
2019,6,11,10,441,422,136,-286
2019,6,11,11,485,469,138,-331
2019,6,11,12,530,498,136,-362
2019,6,11,13,562,521,139,-382
2019,6,11,14,582,532,139,-393
2019,6,11,15,614,544,139,-405
2019,6,11,16,644,550,141,-409
2019,6,11,17,658,569,140,-429
2019,6,11,18,667,584,139,-445
2019,6,11,19,668,596,138,-458
2019,6,11,20,682,605,146,-459
2019,6,11,21,691,633,171,-462
2019,6,11,22,692,633,171,-462
2019,6,11,23,683,636,171,-465
2019,6,12,0,675,611,170,-441
2019,6,12,1,651,590,151,-439
2019,6,12,2,630,568,143,-425
2019,6,12,3,577,521,135,-386
2019,6,12,4,521,466,138,-328
2019,6,12,5,421,416,133,-283
2019,6,12,6,399,397,134,-263
2019,6,12,7,387,384,136,-248
2019,6,12,8,383,379,136,-243
2019,6,12,9,392,381,135,-246
2019,6,12,10,419,406,134,-272
2019,6,12,11,463,451,138,-313
2019,6,12,12,502,483,135,-348
2019,6,12,13,517,511,134,-377
2019,6,12,14,526,530,137,-393
2019,6,12,15,536,535,136,-399
2019,6,12,16,540,544,137,-407
2019,6,12,17,549,550,138,-412
2019,6,12,18,558,560,138,-422
2019,6,12,19,553,558,126,-432
2019,6,12,20,557,579,147,-432
2019,6,12,21,554,583,138,-445
2019,6,12,22,563,585,137,-448
2019,6,12,23,561,578,136,-442
2019,6,13,0,560,571,138,-433
2019,6,13,1,554,565,136,-429
2019,6,13,2,540,553,134,-419
2019,6,13,3,494,511,128,-383
2019,6,13,4,441,456,125,-331
2019,6,13,5,420,417,98,-319
2019,6,13,6,404,393,90,-303
2019,6,13,7,395,388,95,-293
2019,6,13,8,395,382,96,-286
2019,6,13,9,400,392,96,-296
2019,6,13,10,428,413,92,-321
2019,6,13,11,469,454,93,-361
2019,6,13,12,512,492,94,-398
2019,6,13,13,528,517,95,-422
2019,6,13,14,536,536,97,-439
2019,6,13,15,544,542,97,-445
2019,6,13,16,552,541,121,-420
2019,6,13,17,571,552,130,-422
2019,6,13,18,577,561,130,-431
2019,6,13,19,568,566,130,-436
2019,6,13,20,576,567,128,-439
2019,6,13,21,581,582,130,-452
2019,6,13,22,581,586,128,-458
2019,6,13,23,574,584,101,-483
2019,6,14,0,566,575,97,-478
2019,6,14,1,556,559,96,-463
2019,6,14,2,542,549,66,-483
2019,6,14,3,501,508,60,-448
2019,6,14,4,449,454,62,-392
2019,6,14,5,404,414,60,-354
2019,6,14,6,391,395,62,-333
2019,6,14,7,384,383,61,-322
2019,6,14,8,385,376,61,-315
2019,6,14,9,396,388,61,-327
2019,6,14,10,425,405,61,-344
2019,6,14,11,463,444,61,-383
2019,6,14,12,504,486,64,-422
2019,6,14,13,515,507,62,-445
2019,6,14,14,518,518,64,-454
2019,6,14,15,525,528,130,-398
2019,6,14,16,535,526,132,-394
2019,6,14,17,555,520,123,-397
2019,6,14,18,564,539,132,-407
2019,6,14,19,561,545,131,-414
2019,6,14,20,561,562,131,-431
2019,6,14,21,566,582,128,-454
2019,6,14,22,575,598,132,-466
2019,6,14,23,571,593,129,-464
2019,6,15,0,552,578,128,-450
2019,6,15,1,534,557,123,-434
2019,6,15,2,530,545,72,-473
2019,6,15,3,494,506,61,-445
2019,6,15,4,446,459,60,-399
2019,6,15,5,423,420,61,-359
2019,6,15,6,403,394,60,-334
2019,6,15,7,393,378,60,-318
2019,6,15,8,379,372,62,-310
2019,6,15,9,376,375,61,-314
2019,6,15,10,395,381,60,-321
2019,6,15,11,417,398,61,-337
2019,6,15,12,441,426,60,-366
2019,6,15,13,478,459,62,-397
2019,6,15,14,516,488,91,-397
2019,6,15,15,544,499,128,-371
2019,6,15,16,559,512,131,-381
2019,6,15,17,561,521,131,-390
2019,6,15,18,565,535,130,-405
2019,6,15,19,572,553,130,-423
2019,6,15,20,592,568,129,-439
2019,6,15,21,596,584,151,-433
2019,6,15,22,592,607,216,-391
2019,6,15,23,596,609,253,-356
2019,6,16,0,584,598,257,-341
2019,6,16,1,575,586,226,-360
2019,6,16,2,562,574,180,-394
2019,6,16,3,524,537,109,-428
2019,6,16,4,473,481,68,-413
2019,6,16,5,429,434,68,-366
2019,6,16,6,397,408,68,-340
2019,6,16,7,379,389,67,-322
2019,6,16,8,374,383,71,-312
2019,6,16,9,374,374,68,-306
2019,6,16,10,379,381,69,-312
2019,6,16,11,390,392,69,-323
2019,6,16,12,413,419,68,-351
2019,6,16,13,458,466,70,-396
2019,6,16,14,494,503,76,-427
2019,6,16,15,519,535,139,-396
2019,6,16,16,551,566,165,-401
2019,6,16,17,578,593,167,-426
2019,6,16,18,596,620,167,-453
2019,6,16,19,607,632,177,-455
2019,6,16,20,630,667,245,-422
2019,6,16,21,641,686,279,-407
2019,6,16,22,654,711,417,-294
2019,6,16,23,652,713,428,-285
2019,6,17,0,647,694,421,-273
2019,6,17,1,624,675,384,-291
2019,6,17,2,610,667,254,-413
2019,6,17,3,564,598,115,-483
2019,6,17,4,514,551,118,-433
2019,6,17,5,470,498,69,-429
2019,6,17,6,438,463,64,-399
2019,6,17,7,418,436,63,-373
2019,6,17,8,409,426,63,-363
2019,6,17,9,408,426,63,-363
2019,6,17,10,432,444,61,-383
2019,6,17,11,472,483,62,-421
2019,6,17,12,513,515,87,-428
2019,6,17,13,550,563,133,-430
2019,6,17,14,581,609,134,-475
2019,6,17,15,619,654,181,-473
2019,6,17,16,641,688,205,-483
2019,6,17,17,680,718,245,-473
2019,6,17,18,693,747,287,-460
2019,6,17,19,706,760,300,-460
2019,6,17,20,717,771,327,-444
2019,6,17,21,734,773,342,-431
2019,6,17,22,744,761,440,-321
2019,6,17,23,732,744,529,-215
2019,6,18,0,712,705,480,-225
2019,6,18,1,683,676,338,-338
2019,6,18,2,659,655,310,-345
2019,6,18,3,606,592,201,-391
2019,6,18,4,540,535,165,-370
2019,6,18,5,487,482,66,-416
2019,6,18,6,457,445,60,-385
2019,6,18,7,438,434,61,-373
2019,6,18,8,429,427,62,-365
2019,6,18,9,429,422,61,-361
2019,6,18,10,448,446,63,-383
2019,6,18,11,482,484,60,-424
2019,6,18,12,522,526,88,-438
2019,6,18,13,553,555,146,-409
2019,6,18,14,581,580,153,-427
2019,6,18,15,614,610,155,-455
2019,6,18,16,639,629,156,-473
2019,6,18,17,671,648,157,-491
2019,6,18,18,686,671,221,-450
2019,6,18,19,698,674,312,-362
2019,6,18,20,708,660,328,-332
2019,6,18,21,722,643,336,-307
2019,6,18,22,728,634,344,-290
2019,6,18,23,721,632,340,-292
2019,6,19,0,702,621,339,-282
2019,6,19,1,676,613,286,-327
2019,6,19,2,651,598,266,-332
2019,6,19,3,600,572,244,-328
2019,6,19,4,540,514,145,-369
2019,6,19,5,480,467,129,-338
2019,6,19,6,451,441,128,-313
2019,6,19,7,430,426,129,-297
2019,6,19,8,421,420,128,-292
2019,6,19,9,422,424,128,-296
2019,6,19,10,445,447,131,-316
2019,6,19,11,481,493,131,-362
2019,6,19,12,519,530,126,-404
2019,6,19,13,555,563,129,-434
2019,6,19,14,583,589,129,-460
2019,6,19,15,620,616,129,-487
2019,6,19,16,649,629,129,-500
2019,6,19,17,673,658,191,-467
2019,6,19,18,686,670,211,-459
2019,6,19,19,701,688,219,-469
2019,6,19,20,710,682,245,-437
2019,6,19,21,723,686,388,-298
2019,6,19,22,738,716,427,-289
2019,6,19,23,732,725,426,-299
2019,6,20,0,711,705,429,-276
2019,6,20,1,688,670,428,-242
2019,6,20,2,662,645,428,-217
2019,6,20,3,606,588,346,-242
2019,6,20,4,541,530,269,-261
2019,6,20,5,488,502,222,-280
2019,6,20,6,457,458,136,-322
2019,6,20,7,442,440,132,-308
2019,6,20,8,431,426,132,-294
2019,6,20,9,432,426,130,-296
2019,6,20,10,452,447,130,-317
2019,6,20,11,495,489,130,-359
2019,6,20,12,537,527,131,-396
2019,6,20,13,574,563,133,-430
2019,6,20,14,600,584,132,-452
2019,6,20,15,636,616,132,-484
2019,6,20,16,663,495,160,-335
2019,6,20,17,680,501,202,-299
2019,6,20,18,701,497,202,-295
2019,6,20,19,712,483,205,-278
2019,6,20,20,729,475,215,-260
2019,6,20,21,740,568,214,-354
2019,6,20,22,749,614,215,-399
2019,6,20,23,740,624,189,-435
2019,6,21,0,717,599,177,-422
2019,6,21,1,692,582,176,-406
2019,6,21,2,674,623,178,-445
2019,6,21,3,621,583,159,-424
2019,6,21,4,556,520,134,-386
2019,6,21,5,503,474,134,-340
2019,6,21,6,471,441,132,-309
2019,6,21,7,452,424,135,-289
2019,6,21,8,440,413,134,-279
2019,6,21,9,440,414,134,-280
2019,6,21,10,456,431,133,-298
2019,6,21,11,493,467,133,-334
2019,6,21,12,535,505,133,-372
2019,6,21,13,566,539,133,-406
2019,6,21,14,598,569,137,-432
2019,6,21,15,631,585,135,-450
2019,6,21,16,656,598,136,-462
2019,6,21,17,680,618,136,-482
2019,6,21,18,694,630,131,-499
2019,6,21,19,709,659,233,-426
2019,6,21,20,730,681,241,-440
2019,6,21,21,744,700,252,-448
2019,6,21,22,757,697,319,-378
2019,6,21,23,753,701,370,-331
2019,6,22,0,720,676,367,-309
2019,6,22,1,692,645,370,-275
2019,6,22,2,670,622,224,-398
2019,6,22,3,624,582,168,-414
2019,6,22,4,562,526,140,-386
2019,6,22,5,503,471,85,-386
2019,6,22,6,473,441,73,-368
2019,6,22,7,451,419,74,-345
2019,6,22,8,435,409,75,-334
2019,6,22,9,428,408,77,-331
2019,6,22,10,436,417,76,-341
2019,6,22,11,458,428,76,-352
2019,6,22,12,485,457,77,-380
2019,6,22,13,522,489,76,-413
2019,6,22,14,542,527,78,-449
2019,6,22,15,578,550,127,-423
2019,6,22,16,602,584,141,-443
2019,6,22,17,631,613,139,-474
2019,6,22,18,653,609,141,-468
2019,6,22,19,665,576,140,-436
2019,6,22,20,688,562,139,-423
2019,6,22,21,701,569,143,-426
2019,6,22,22,710,592,139,-453
2019,6,22,23,702,611,139,-472
2019,6,23,0,688,605,138,-467
2019,6,23,1,662,587,137,-450
2019,6,23,2,634,574,136,-438
2019,6,23,3,592,538,139,-399
2019,6,23,4,542,490,139,-351
2019,6,23,5,463,447,137,-310
2019,6,23,6,431,419,137,-282
2019,6,23,7,410,407,137,-270
2019,6,23,8,400,396,131,-265
2019,6,23,9,395,393,130,-263
2019,6,23,10,397,396,130,-266
2019,6,23,11,407,409,129,-280
2019,6,23,12,435,434,127,-307
2019,6,23,13,478,477,131,-346
2019,6,23,14,514,513,131,-382
2019,6,23,15,539,549,132,-417
2019,6,23,16,560,574,131,-443
2019,6,23,17,602,609,133,-476
2019,6,23,18,624,639,133,-506
2019,6,23,19,652,643,181,-462
2019,6,23,20,659,680,205,-475
2019,6,23,21,667,690,206,-484
2019,6,23,22,680,707,206,-501
2019,6,23,23,669,715,217,-498
2019,6,24,0,654,712,226,-486
2019,6,24,1,627,676,200,-476
2019,6,24,2,613,655,197,-458
2019,6,24,3,566,601,132,-469
2019,6,24,4,502,540,137,-403
2019,6,24,5,452,488,135,-353
2019,6,24,6,426,456,134,-322
2019,6,24,7,411,436,137,-299
2019,6,24,8,398,421,131,-290
2019,6,24,9,402,430,133,-297
2019,6,24,10,420,448,131,-317
2019,6,24,11,469,492,131,-361
2019,6,24,12,513,529,132,-397
2019,6,24,13,548,565,133,-432
2019,6,24,14,577,599,133,-466
2019,6,24,15,612,650,133,-517
2019,6,24,16,642,689,213,-476
2019,6,24,17,668,723,285,-438
2019,6,24,18,692,754,401,-353
2019,6,24,19,713,770,422,-348
2019,6,24,20,730,791,426,-365
2019,6,24,21,741,798,423,-375
2019,6,24,22,751,798,424,-374
2019,6,24,23,744,777,424,-353
2019,6,25,0,721,741,423,-318
2019,6,25,1,691,694,428,-266
2019,6,25,2,659,652,411,-241
2019,6,25,3,601,609,237,-372
2019,6,25,4,537,538,162,-376
2019,6,25,5,496,487,130,-357
2019,6,25,6,463,450,127,-323
2019,6,25,7,447,433,128,-305
2019,6,25,8,436,426,128,-298
2019,6,25,9,436,430,128,-302
2019,6,25,10,454,452,129,-323
2019,6,25,11,490,486,128,-358
2019,6,25,12,529,524,127,-397
2019,6,25,13,563,556,129,-427
2019,6,25,14,592,580,129,-451
2019,6,25,15,622,618,133,-485
2019,6,25,16,655,632,129,-503
2019,6,25,17,680,640,210,-430
2019,6,25,18,706,655,309,-346
2019,6,25,19,729,679,397,-282
2019,6,25,20,742,691,411,-280
2019,6,25,21,747,701,418,-283
2019,6,25,22,753,697,431,-266
2019,6,25,23,737,701,433,-268
2019,6,26,0,716,695,408,-287
2019,6,26,1,690,672,291,-381
2019,6,26,2,656,640,140,-500
2019,6,26,3,603,588,128,-460
2019,6,26,4,544,526,129,-397
2019,6,26,5,474,472,78,-394
2019,6,26,6,444,443,61,-382
2019,6,26,7,425,424,62,-362
2019,6,26,8,416,414,63,-351
2019,6,26,9,414,409,61,-348
2019,6,26,10,437,431,64,-367
2019,6,26,11,472,471,79,-392
2019,6,26,12,516,513,132,-381
2019,6,26,13,549,535,129,-406
2019,6,26,14,582,563,132,-431
2019,6,26,15,617,599,132,-467
2019,6,26,16,643,623,181,-442
2019,6,26,17,667,650,201,-449
2019,6,26,18,687,678,227,-451
2019,6,26,19,708,705,426,-279
2019,6,26,20,719,728,526,-202
2019,6,26,21,735,745,502,-243
2019,6,26,22,743,763,416,-347
2019,6,26,23,733,746,279,-467
2019,6,27,0,701,718,346,-372
2019,6,27,1,665,693,398,-295
2019,6,27,2,647,668,377,-291
2019,6,27,3,590,617,236,-381
2019,6,27,4,523,546,160,-386
2019,6,27,5,482,482,82,-400
2019,6,27,6,445,451,66,-385
2019,6,27,7,427,430,68,-362
2019,6,27,8,416,424,67,-357
2019,6,27,9,418,419,67,-352
2019,6,27,10,433,441,69,-372
2019,6,27,11,469,479,67,-412
2019,6,27,12,511,517,70,-447
2019,6,27,13,547,547,88,-459
2019,6,27,14,572,569,87,-482
2019,6,27,15,612,606,128,-478
2019,6,27,16,640,646,206,-440
2019,6,27,17,665,671,308,-363
2019,6,27,18,683,710,504,-206
2019,6,27,19,700,741,541,-200
2019,6,27,20,718,769,590,-179
2019,6,27,21,735,786,592,-194
2019,6,27,22,754,799,590,-209
2019,6,27,23,744,793,590,-203
2019,6,28,0,712,760,517,-243
2019,6,28,1,682,721,427,-294
2019,6,28,2,661,694,425,-269
2019,6,28,3,606,637,403,-234
2019,6,28,4,545,573,172,-401
2019,6,28,5,492,505,70,-435
2019,6,28,6,458,475,68,-407
2019,6,28,7,428,445,65,-380
2019,6,28,8,420,434,65,-369
2019,6,28,9,420,435,61,-374
2019,6,28,10,437,451,61,-390
2019,6,28,11,476,489,70,-419
2019,6,28,12,523,521,80,-441
2019,6,28,13,567,559,100,-459
2019,6,28,14,598,601,103,-498
2019,6,28,15,639,644,161,-483
2019,6,28,16,663,686,238,-448
2019,6,28,17,697,706,243,-463
2019,6,28,18,721,723,274,-449
2019,6,28,19,727,736,331,-405
2019,6,28,20,752,763,333,-430
2019,6,28,21,758,771,332,-439
2019,6,28,22,752,758,346,-412
2019,6,28,23,740,750,415,-335
2019,6,29,0,709,723,428,-295
2019,6,29,1,668,679,427,-252
2019,6,29,2,659,663,312,-351
2019,6,29,3,608,611,126,-485
2019,6,29,4,541,542,66,-476
2019,6,29,5,479,486,61,-425
2019,6,29,6,442,454,63,-391
2019,6,29,7,422,429,62,-367
2019,6,29,8,410,413,63,-350
2019,6,29,9,399,411,63,-348
2019,6,29,10,407,412,63,-349
2019,6,29,11,421,425,64,-361
2019,6,29,12,450,453,64,-389
2019,6,29,13,488,492,64,-428
2019,6,29,14,536,536,64,-472
2019,6,29,15,578,574,116,-458
2019,6,29,16,616,614,132,-482
2019,6,29,17,639,642,182,-460
2019,6,29,18,670,676,208,-468
2019,6,29,19,689,697,347,-350
2019,6,29,20,707,724,396,-328
2019,6,29,21,727,743,419,-324
2019,6,29,22,731,756,426,-330
2019,6,29,23,716,751,428,-323
2019,6,30,0,693,723,374,-349
2019,6,30,1,655,695,257,-438
2019,6,30,2,637,655,209,-446
2019,6,30,3,583,607,173,-434
2019,6,30,4,538,544,83,-461
2019,6,30,5,508,491,62,-429
2019,6,30,6,458,455,64,-391
2019,6,30,7,430,430,64,-366
2019,6,30,8,414,416,64,-352
2019,6,30,9,409,406,65,-341
2019,6,30,10,414,407,65,-342
2019,6,30,11,414,414,62,-352
2019,6,30,12,447,442,65,-377
2019,6,30,13,491,489,63,-426
2019,6,30,14,546,540,65,-475
2019,6,30,15,582,585,72,-513
2019,6,30,16,606,617,131,-486
2019,6,30,17,652,643,155,-488
2019,6,30,18,686,675,279,-396
2019,6,30,19,705,708,288,-420
2019,6,30,20,720,732,334,-398
2019,6,30,21,742,751,463,-288
2019,6,30,22,748,783,526,-257
2019,6,30,23,735,763,522,-241
2019,7,1,0,722,721,540,-181
2019,7,1,1,689,694,442,-252
2019,7,1,2,671,659,192,-467
2019,7,1,3,612,611,92,-519
2019,7,1,4,552,538,66,-472
2019,7,1,5,516,486,77,-409
2019,7,1,6,475,453,60,-393
2019,7,1,7,452,429,60,-369
2019,7,1,8,442,423,62,-361
2019,7,1,9,436,422,61,-361
2019,7,1,10,454,439,61,-378
2019,7,1,11,483,475,60,-415
2019,7,1,12,520,509,80,-429
2019,7,1,13,559,554,92,-462
2019,7,1,14,606,596,96,-500
2019,7,1,15,654,641,144,-497
2019,7,1,16,697,685,286,-399
2019,7,1,17,711,711,288,-423
2019,7,1,18,742,737,348,-389
2019,7,1,19,766,761,415,-346
2019,7,1,20,785,780,418,-362
2019,7,1,21,787,796,422,-374
2019,7,1,22,789,808,423,-385
2019,7,1,23,769,805,419,-386
2019,7,2,0,746,782,422,-360
2019,7,2,1,719,745,422,-323
2019,7,2,2,693,710,402,-308
2019,7,2,3,635,654,323,-331
2019,7,2,4,568,574,92,-482
2019,7,2,5,512,502,66,-436
2019,7,2,6,471,459,62,-397
2019,7,2,7,448,443,64,-379
2019,7,2,8,435,428,63,-365
2019,7,2,9,432,424,63,-361
2019,7,2,10,447,440,65,-375
2019,7,2,11,480,474,63,-411
2019,7,2,12,526,512,82,-430
2019,7,2,13,559,554,112,-442
2019,7,2,14,593,604,117,-487
2019,7,2,15,637,652,225,-427
2019,7,2,16,666,689,280,-409
2019,7,2,17,703,723,320,-403
2019,7,2,18,736,755,351,-404
2019,7,2,19,758,773,388,-385
2019,7,2,20,778,803,417,-386
2019,7,2,21,796,824,425,-399
2019,7,2,22,799,830,422,-408
2019,7,2,23,801,815,424,-391
2019,7,3,0,765,777,376,-401
2019,7,3,1,720,738,358,-380
2019,7,3,2,692,701,359,-342
2019,7,3,3,640,650,342,-308
2019,7,3,4,578,585,128,-457
2019,7,3,5,526,510,73,-437
2019,7,3,6,478,477,84,-393
2019,7,3,7,455,448,84,-364
2019,7,3,8,438,434,86,-348
2019,7,3,9,436,431,85,-346
2019,7,3,10,451,450,79,-371
2019,7,3,11,486,478,62,-416
2019,7,3,12,535,522,70,-452
2019,7,3,13,569,560,85,-475
2019,7,3,14,610,589,87,-502
2019,7,3,15,658,615,130,-485
2019,7,3,16,697,656,237,-419
2019,7,3,17,728,683,317,-366
2019,7,3,18,764,719,384,-335
2019,7,3,19,788,758,420,-338
2019,7,3,20,808,793,426,-367
2019,7,3,21,824,806,425,-381
2019,7,3,22,833,794,422,-372
2019,7,3,23,824,779,418,-361
2019,7,4,0,786,745,356,-389
2019,7,4,1,737,725,337,-388
2019,7,4,2,707,695,294,-401
2019,7,4,3,651,621,262,-359
2019,7,4,4,587,558,101,-457
2019,7,4,5,540,499,64,-435
2019,7,4,6,486,461,64,-397
2019,7,4,7,452,437,64,-373
2019,7,4,8,433,424,64,-360
2019,7,4,9,428,419,64,-355
2019,7,4,10,433,423,65,-358
2019,7,4,11,439,435,64,-371
2019,7,4,12,466,456,64,-392
2019,7,4,13,511,497,66,-431
2019,7,4,14,568,543,66,-477
2019,7,4,15,617,592,115,-477
2019,7,4,16,669,632,164,-468
2019,7,4,17,708,673,252,-421
2019,7,4,18,728,709,295,-414
2019,7,4,19,745,727,355,-372
2019,7,4,20,766,752,392,-360
2019,7,4,21,770,771,368,-403
2019,7,4,22,784,775,322,-453
2019,7,4,23,765,752,316,-436
2019,7,5,0,732,707,251,-456
2019,7,5,1,683,666,207,-459
2019,7,5,2,638,622,114,-508
2019,7,5,3,598,597,90,-507
2019,7,5,4,563,549,90,-459
2019,7,5,5,511,497,70,-427
2019,7,5,6,478,454,63,-391
2019,7,5,7,445,432,66,-366
2019,7,5,8,434,413,66,-347
2019,7,5,9,435,420,69,-351
2019,7,5,10,452,430,64,-366
2019,7,5,11,493,451,61,-390
2019,7,5,12,528,491,64,-427
2019,7,5,13,570,524,63,-461
2019,7,5,14,615,561,63,-498
2019,7,5,15,662,600,73,-527
2019,7,5,16,708,653,143,-510
2019,7,5,17,730,705,197,-508
2019,7,5,18,748,735,194,-541
2019,7,5,19,762,749,281,-468
2019,7,5,20,792,739,312,-427
2019,7,5,21,801,739,314,-425
2019,7,5,22,786,735,349,-386
2019,7,5,23,778,755,387,-368
2019,7,6,0,748,736,347,-389
2019,7,6,1,700,700,337,-363
2019,7,6,2,683,671,295,-376
2019,7,6,3,626,625,209,-416
2019,7,6,4,551,576,149,-427
2019,7,6,5,483,516,82,-434
2019,7,6,6,455,479,63,-416
2019,7,6,7,430,460,63,-397
2019,7,6,8,418,444,64,-380
2019,7,6,9,410,439,65,-374
2019,7,6,10,416,440,62,-378
2019,7,6,11,433,453,64,-389
2019,7,6,12,460,485,64,-421
2019,7,6,13,501,521,94,-427
2019,7,6,14,555,570,100,-470
2019,7,6,15,594,613,149,-464
2019,7,6,16,634,656,217,-439
2019,7,6,17,662,673,240,-433
2019,7,6,18,687,665,243,-422
2019,7,6,19,706,674,315,-359
2019,7,6,20,728,663,410,-253
2019,7,6,21,730,676,417,-259
2019,7,6,22,741,701,425,-276
2019,7,6,23,735,714,425,-289
2019,7,7,0,717,694,409,-285
2019,7,7,1,669,677,366,-311
2019,7,7,2,633,653,275,-378
2019,7,7,3,586,602,160,-442
2019,7,7,4,542,562,92,-470
2019,7,7,5,515,503,63,-440
2019,7,7,6,475,466,63,-403
2019,7,7,7,450,442,65,-377
2019,7,7,8,440,436,66,-370
2019,7,7,9,432,421,63,-358
2019,7,7,10,438,430,66,-364
2019,7,7,11,441,437,64,-373
2019,7,7,12,471,464,64,-400
2019,7,7,13,516,507,65,-442
2019,7,7,14,564,553,67,-486
2019,7,7,15,606,595,115,-480
2019,7,7,16,639,639,130,-509
2019,7,7,17,672,690,233,-457
2019,7,7,18,704,717,271,-446
2019,7,7,19,728,742,312,-430
2019,7,7,20,745,765,334,-431
2019,7,7,21,754,779,339,-440
2019,7,7,22,771,759,332,-427
2019,7,7,23,757,742,336,-406
2019,7,8,0,739,724,310,-414
2019,7,8,1,710,689,267,-422
2019,7,8,2,686,670,267,-403
2019,7,8,3,638,626,202,-424
2019,7,8,4,577,564,142,-422
2019,7,8,5,518,503,103,-400
2019,7,8,6,482,472,104,-368
2019,7,8,7,457,452,105,-347
2019,7,8,8,444,436,104,-332
2019,7,8,9,438,442,106,-336
2019,7,8,10,467,460,105,-355
2019,7,8,11,503,502,105,-397
2019,7,8,12,546,541,106,-435
2019,7,8,13,584,583,108,-475
2019,7,8,14,627,622,147,-475
2019,7,8,15,669,671,175,-496
2019,7,8,16,699,710,226,-484
2019,7,8,17,738,753,354,-399
2019,7,8,18,753,791,397,-394
2019,7,8,19,775,809,419,-390
2019,7,8,20,795,826,426,-400
2019,7,8,21,803,839,423,-416
2019,7,8,22,807,853,425,-428
2019,7,8,23,805,844,423,-421
2019,7,9,0,750,814,425,-389
2019,7,9,1,738,771,426,-345
2019,7,9,2,704,736,400,-336
2019,7,9,3,652,683,280,-403
2019,7,9,4,580,607,98,-509
2019,7,9,5,526,540,66,-474
2019,7,9,6,493,501,63,-438
2019,7,9,7,469,474,62,-412
2019,7,9,8,455,460,63,-397
2019,7,9,9,454,462,64,-398
2019,7,9,10,470,480,63,-417
2019,7,9,11,511,515,63,-452
2019,7,9,12,554,555,63,-492
2019,7,9,13,590,584,58,-526
2019,7,9,14,626,627,75,-552
2019,7,9,15,670,615,79,-536
2019,7,9,16,704,630,136,-494
2019,7,9,17,731,660,134,-526
2019,7,9,18,757,660,136,-524
2019,7,9,19,778,647,135,-512
2019,7,9,20,802,657,135,-522
2019,7,9,21,810,617,189,-428
2019,7,9,22,818,619,241,-378
2019,7,9,23,809,614,264,-350
2019,7,10,0,780,596,252,-344
2019,7,10,1,748,562,197,-365
2019,7,10,2,709,600,182,-418
2019,7,10,3,654,600,142,-458
2019,7,10,4,587,590,125,-465
2019,7,10,5,502,542,82,-460
2019,7,10,6,472,506,68,-438
2019,7,10,7,453,487,66,-421
2019,7,10,8,442,467,65,-402
2019,7,10,9,442,466,65,-401
2019,7,10,10,460,482,66,-416
2019,7,10,11,497,522,64,-458
2019,7,10,12,535,568,65,-503
2019,7,10,13,568,594,65,-529
2019,7,10,14,600,621,73,-548
2019,7,10,15,640,654,130,-524
2019,7,10,16,669,705,238,-467
2019,7,10,17,697,749,239,-510
2019,7,10,18,716,777,253,-524
2019,7,10,19,736,801,308,-493
2019,7,10,20,752,819,340,-479
2019,7,10,21,757,840,417,-423
2019,7,10,22,769,848,424,-424
2019,7,10,23,758,839,422,-417
2019,7,11,0,737,812,421,-391
2019,7,11,1,706,772,375,-397
2019,7,11,2,678,750,402,-348
2019,7,11,3,627,688,238,-450
2019,7,11,4,562,623,127,-496
2019,7,11,5,531,568,90,-478
2019,7,11,6,500,524,62,-462
2019,7,11,7,479,505,63,-442
2019,7,11,8,469,490,61,-429
2019,7,11,9,469,490,62,-428
2019,7,11,10,484,510,61,-449
2019,7,11,11,521,544,60,-484
2019,7,11,12,558,587,62,-525
2019,7,11,13,591,613,81,-532
2019,7,11,14,627,654,149,-505
2019,7,11,15,670,699,212,-487
2019,7,11,16,697,756,245,-511
2019,7,11,17,726,757,300,-457
2019,7,11,18,749,798,381,-417
2019,7,11,19,774,759,419,-340
2019,7,11,20,791,711,426,-285
2019,7,11,21,798,688,422,-266
2019,7,11,22,808,691,357,-334
2019,7,11,23,795,689,354,-335
2019,7,12,0,767,690,327,-363
2019,7,12,1,738,670,270,-400
2019,7,12,2,711,648,296,-352
2019,7,12,3,660,607,240,-367
2019,7,12,4,596,552,127,-425
2019,7,12,5,554,554,127,-9999
2019,7,12,6,516,516,62,-9999
2019,7,12,7,491,491,63,-9999
2019,7,12,8,477,477,61,-9999
2019,7,12,9,475,475,62,-9999
2019,7,12,10,490,490,61,-9999
2019,7,12,11,526,526,60,-9999
2019,7,12,12,566,566,62,-9999
2019,7,12,13,603,603,81,-9999
2019,7,12,14,641,641,149,-9999
2019,7,12,15,681,681,212,-9999
2019,7,12,16,720,720,245,-9999
2019,7,12,17,750,750,300,-9999
2019,7,12,18,772,772,381,-9999
2019,7,12,19,796,796,419,-9999
2019,7,12,20,811,811,426,-9999
2019,7,12,21,814,814,422,-9999
2019,7,12,22,820,820,357,-9999
2019,7,12,23,799,799,354,-9999
2019,7,13,0,766,766,327,-9999
2019,7,13,1,735,735,270,-9999
2019,7,13,2,710,710,296,-9999
2019,7,13,3,667,667,240,-9999
2019,7,13,4,604,604,127,-9999
2019,7,13,5,-9999,527,195,-332
2019,7,13,6,-9999,497,159,-338
2019,7,13,7,-9999,471,102,-369
2019,7,13,8,-9999,449,68,-381
2019,7,13,9,-9999,446,70,-376
2019,7,13,10,-9999,449,67,-382
2019,7,13,11,-9999,466,68,-398
2019,7,13,12,-9999,496,69,-427
2019,7,13,13,-9999,534,69,-465
2019,7,13,14,-9999,584,89,-495
2019,7,13,15,-9999,622,150,-472
2019,7,13,16,-9999,666,237,-429
2019,7,13,17,-9999,697,328,-369
2019,7,13,18,-9999,710,384,-326
2019,7,13,19,-9999,706,410,-296
2019,7,13,20,-9999,685,415,-270
2019,7,13,21,-9999,676,414,-262
2019,7,13,22,-9999,669,415,-254
2019,7,13,23,-9999,672,419,-253
2019,7,14,0,-9999,657,419,-238
2019,7,14,1,-9999,642,361,-281
2019,7,14,2,-9999,636,250,-386
2019,7,14,3,-9999,597,143,-454
2019,7,14,4,-9999,539,90,-449
2019,7,14,5,522,486,106,-380
2019,7,14,6,481,458,103,-355
2019,7,14,7,451,439,101,-338
2019,7,14,8,438,431,106,-325
2019,7,14,9,430,419,105,-314
2019,7,14,10,436,422,104,-318
2019,7,14,11,444,433,105,-328
2019,7,14,12,469,465,126,-339
2019,7,14,13,524,512,137,-375
2019,7,14,14,572,554,136,-418
2019,7,14,15,606,577,138,-439
2019,7,14,16,649,602,138,-464
2019,7,14,17,690,624,209,-415
2019,7,14,18,718,646,299,-347
2019,7,14,19,739,663,318,-345
2019,7,14,20,759,695,350,-345
2019,7,14,21,779,725,413,-312
2019,7,14,22,788,730,423,-307
2019,7,14,23,771,736,425,-311
2019,7,15,0,753,722,423,-299
2019,7,15,1,715,687,423,-264
2019,7,15,2,705,659,422,-237
2019,7,15,3,648,619,267,-352
2019,7,15,4,580,558,173,-385
2019,7,15,5,535,494,104,-390
2019,7,15,6,504,463,98,-365
2019,7,15,7,488,442,99,-343
2019,7,15,8,475,433,98,-335
2019,7,15,9,476,435,98,-337
2019,7,15,10,494,457,99,-358
2019,7,15,11,531,496,97,-399
2019,7,15,12,571,536,99,-437
2019,7,15,13,613,578,100,-478
2019,7,15,14,649,618,117,-501
2019,7,15,15,696,670,165,-505
2019,7,15,16,726,699,210,-489
2019,7,15,17,761,736,315,-421
2019,7,15,18,784,763,365,-398
2019,7,15,19,812,810,398,-412
2019,7,15,20,835,813,390,-423
2019,7,15,21,847,819,389,-430
2019,7,15,22,850,775,392,-383
2019,7,15,23,840,732,392,-340
2019,7,16,0,810,702,391,-311
2019,7,16,1,779,672,391,-281
2019,7,16,2,749,652,381,-271
2019,7,16,3,689,610,206,-404
2019,7,16,4,621,550,141,-409
2019,7,16,5,551,491,70,-421
2019,7,16,6,513,461,70,-391
2019,7,16,7,488,444,73,-371
2019,7,16,8,476,436,74,-362
2019,7,16,9,476,435,72,-363
2019,7,16,10,490,458,74,-384
2019,7,16,11,527,498,73,-425
2019,7,16,12,564,535,72,-463
2019,7,16,13,599,569,74,-495
2019,7,16,14,634,599,102,-497
2019,7,16,15,667,620,173,-447
2019,7,16,16,708,690,260,-430
2019,7,16,17,747,729,376,-353
2019,7,16,18,791,770,489,-281
2019,7,16,19,814,776,494,-282
2019,7,16,20,838,785,464,-321
2019,7,16,21,851,798,555,-243
2019,7,16,22,862,801,572,-229
2019,7,16,23,847,801,519,-282
2019,7,17,0,818,778,411,-367
2019,7,17,1,777,748,413,-335
2019,7,17,2,754,718,389,-329
2019,7,17,3,695,657,274,-383
2019,7,17,4,626,602,131,-471
2019,7,17,5,554,530,67,-463
2019,7,17,6,514,491,65,-426
2019,7,17,7,487,465,67,-398
2019,7,17,8,471,448,65,-383
2019,7,17,9,468,444,66,-378
2019,7,17,10,484,457,66,-391
2019,7,17,11,525,494,76,-418
2019,7,17,12,563,534,79,-455
2019,7,17,13,597,569,83,-486
2019,7,17,14,633,610,91,-519
2019,7,17,15,681,641,170,-471
2019,7,17,16,725,674,294,-380
2019,7,17,17,760,718,344,-374
2019,7,17,18,808,729,398,-331
2019,7,17,19,827,721,458,-263
2019,7,17,20,851,709,458,-251
2019,7,17,21,864,704,460,-244
2019,7,17,22,870,687,445,-242
2019,7,17,23,856,685,389,-296
2019,7,18,0,823,681,406,-275
2019,7,18,1,780,666,351,-315
2019,7,18,2,757,653,353,-300
2019,7,18,3,692,600,215,-385
2019,7,18,4,623,542,193,-349
2019,7,18,5,536,505,123,-382
2019,7,18,6,499,466,70,-396
2019,7,18,7,474,445,68,-377
2019,7,18,8,462,434,71,-363
2019,7,18,9,460,437,74,-363
2019,7,18,10,476,455,74,-381
2019,7,18,11,519,498,73,-425
2019,7,18,12,559,541,74,-467
2019,7,18,13,593,580,73,-507
2019,7,18,14,627,613,78,-535
2019,7,18,15,672,665,176,-489
2019,7,18,16,707,703,302,-401
2019,7,18,17,735,731,405,-326
2019,7,18,18,762,763,417,-346
2019,7,18,19,775,780,415,-365
2019,7,18,20,794,808,562,-246
2019,7,18,21,805,829,573,-256
2019,7,18,22,805,838,574,-264
2019,7,18,23,797,812,564,-248
2019,7,19,0,773,770,371,-399
2019,7,19,1,738,743,351,-392
2019,7,19,2,709,711,348,-363
2019,7,19,3,655,667,248,-419
2019,7,19,4,590,601,115,-486
2019,7,19,5,538,542,66,-476
2019,7,19,6,503,506,62,-444
2019,7,19,7,479,482,65,-417
2019,7,19,8,465,466,63,-403
2019,7,19,9,465,465,64,-401
2019,7,19,10,479,478,69,-409
2019,7,19,11,518,511,63,-448
2019,7,19,12,558,554,64,-490
2019,7,19,13,592,588,85,-503
2019,7,19,14,633,634,136,-498
2019,7,19,15,676,678,332,-346
2019,7,19,16,718,717,416,-301
2019,7,19,17,756,760,425,-335
2019,7,19,18,787,793,445,-348
2019,7,19,19,798,812,581,-231
2019,7,19,20,820,828,579,-249
2019,7,19,21,829,839,574,-265
2019,7,19,22,820,834,575,-259
2019,7,19,23,808,794,577,-217
2019,7,20,0,772,747,498,-249
2019,7,20,1,738,706,390,-316
2019,7,20,2,712,683,354,-329
2019,7,20,3,664,634,297,-337
2019,7,20,4,605,582,153,-429
2019,7,20,5,530,529,89,-440
2019,7,20,6,497,481,64,-417
2019,7,20,7,475,462,64,-398
2019,7,20,8,453,448,70,-378
2019,7,20,9,447,443,71,-372
2019,7,20,10,450,450,67,-383
2019,7,20,11,466,465,69,-396
2019,7,20,12,491,491,69,-422
2019,7,20,13,532,536,70,-466
2019,7,20,14,587,592,71,-521
2019,7,20,15,638,637,190,-447
2019,7,20,16,672,688,229,-459
2019,7,20,17,712,724,238,-486
2019,7,20,18,740,748,261,-487
2019,7,20,19,761,758,261,-497
2019,7,20,20,784,753,288,-465
2019,7,20,21,796,778,333,-445
2019,7,20,22,794,783,352,-431
2019,7,20,23,785,780,394,-386
2019,7,21,0,749,749,372,-377
2019,7,21,1,719,708,353,-355
2019,7,21,2,698,688,340,-348
2019,7,21,3,642,642,153,-489
2019,7,21,4,587,576,71,-505
2019,7,21,5,555,522,63,-459
2019,7,21,6,501,480,62,-418
2019,7,21,7,470,459,62,-397
2019,7,21,8,449,443,63,-380
2019,7,21,9,440,436,63,-373
2019,7,21,10,442,435,61,-374
2019,7,21,11,448,449,63,-386
2019,7,21,12,477,474,64,-410
2019,7,21,13,526,522,62,-460
2019,7,21,14,580,571,71,-500
2019,7,21,15,625,620,99,-521
2019,7,21,16,659,646,192,-454
2019,7,21,17,704,700,334,-366
2019,7,21,18,738,735,411,-324
2019,7,21,19,758,753,419,-334
2019,7,21,20,775,764,417,-347
2019,7,21,21,794,774,421,-353
2019,7,21,22,807,783,418,-365
2019,7,21,23,798,768,414,-354
2019,7,22,0,779,742,418,-324
2019,7,22,1,741,704,394,-310
2019,7,22,2,718,684,347,-337
2019,7,22,3,659,635,227,-408
2019,7,22,4,589,575,115,-460
2019,7,22,5,531,524,69,-455
2019,7,22,6,496,486,61,-425
2019,7,22,7,468,466,62,-404
2019,7,22,8,454,457,63,-394
2019,7,22,9,454,455,63,-392
2019,7,22,10,471,475,62,-413
2019,7,22,11,510,512,63,-449
2019,7,22,12,547,553,65,-488
2019,7,22,13,583,585,62,-523
2019,7,22,14,622,615,95,-520
2019,7,22,15,660,664,162,-502
2019,7,22,16,697,703,225,-478
2019,7,22,17,740,744,227,-517
2019,7,22,18,762,760,280,-480
2019,7,22,19,781,741,314,-427
2019,7,22,20,802,713,330,-383
2019,7,22,21,815,699,354,-345
2019,7,22,22,814,707,400,-307
2019,7,22,23,802,700,364,-336
2019,7,23,0,775,692,338,-354
2019,7,23,1,740,671,330,-341
2019,7,23,2,708,642,308,-334
2019,7,23,3,643,588,263,-325
2019,7,23,4,588,537,263,-274
2019,7,23,5,486,508,206,-302
2019,7,23,6,456,464,135,-329
2019,7,23,7,435,449,135,-314
2019,7,23,8,426,438,135,-303
2019,7,23,9,428,443,135,-308
2019,7,23,10,451,463,135,-328
2019,7,23,11,498,503,134,-369
2019,7,23,12,540,542,135,-407
2019,7,23,13,575,569,137,-432
2019,7,23,14,603,594,139,-455
2019,7,23,15,618,609,135,-474
2019,7,23,16,632,610,136,-474
2019,7,23,17,642,603,138,-465
2019,7,23,18,637,597,157,-440
2019,7,23,19,637,593,194,-399
2019,7,23,20,640,589,195,-394
2019,7,23,21,637,595,198,-397
2019,7,23,22,633,610,196,-414
2019,7,23,23,632,621,188,-433
2019,7,24,0,611,614,177,-437
2019,7,24,1,588,596,146,-450
2019,7,24,2,579,566,122,-444
2019,7,24,3,522,535,134,-401
2019,7,24,4,470,479,131,-348
2019,7,24,5,453,434,124,-310
2019,7,24,6,424,412,130,-282
2019,7,24,7,403,405,133,-272
2019,7,24,8,392,395,132,-263
2019,7,24,9,394,398,131,-267
2019,7,24,10,415,422,133,-289
2019,7,24,11,453,462,132,-330
2019,7,24,12,497,498,131,-367
2019,7,24,13,526,520,133,-387
2019,7,24,14,543,534,132,-402
2019,7,24,15,575,554,135,-419
2019,7,24,16,597,568,135,-433
2019,7,24,17,618,584,134,-450
2019,7,24,18,630,596,134,-462
2019,7,24,19,643,603,136,-467
2019,7,24,20,661,615,185,-430
2019,7,24,21,677,639,197,-442
2019,7,24,22,679,653,198,-455
2019,7,24,23,677,652,195,-457
2019,7,25,0,658,632,194,-438
2019,7,25,1,627,605,197,-408
2019,7,25,2,609,589,196,-393
2019,7,25,3,550,539,158,-381
2019,7,25,4,495,477,135,-342
2019,7,25,5,462,437,137,-300
2019,7,25,6,434,413,137,-276
2019,7,25,7,415,397,116,-281
2019,7,25,8,404,389,74,-315
2019,7,25,9,406,393,71,-322
2019,7,25,10,426,415,70,-345
2019,7,25,11,463,452,83,-369
2019,7,25,12,504,491,137,-354
2019,7,25,13,532,516,137,-379
2019,7,25,14,554,534,137,-397
2019,7,25,15,585,557,137,-420
2019,7,25,16,612,575,142,-433
2019,7,25,17,634,585,137,-448
2019,7,25,18,653,594,151,-443
2019,7,25,19,668,624,234,-390
2019,7,25,20,690,637,287,-350
2019,7,25,21,708,672,391,-281
2019,7,25,22,710,677,409,-268
2019,7,25,23,709,680,421,-259
2019,7,26,0,680,657,416,-241
2019,7,26,1,655,628,335,-293
2019,7,26,2,639,619,184,-435
2019,7,26,3,583,559,91,-468
2019,7,26,4,526,494,74,-420
2019,7,26,5,468,450,68,-382
2019,7,26,6,439,423,67,-356
2019,7,26,7,419,407,65,-342
2019,7,26,8,408,398,65,-333
2019,7,26,9,407,397,65,-332
2019,7,26,10,427,418,64,-354
2019,7,26,11,458,455,66,-389
2019,7,26,12,491,491,63,-428
2019,7,26,13,528,520,114,-406
2019,7,26,14,554,541,133,-408
2019,7,26,15,573,562,134,-428
2019,7,26,16,595,585,136,-449
2019,7,26,17,603,596,135,-461
2019,7,26,18,630,609,134,-475
2019,7,26,19,656,612,201,-411
2019,7,26,20,672,655,412,-243
2019,7,26,21,684,675,420,-255
2019,7,26,22,679,688,419,-269
2019,7,26,23,662,680,422,-258
2019,7,27,0,640,668,380,-288
2019,7,27,1,621,628,194,-434
2019,7,27,2,604,608,166,-442
2019,7,27,3,564,570,146,-424
2019,7,27,4,511,506,77,-429
2019,7,27,5,465,458,61,-397
2019,7,27,6,436,431,59,-372
2019,7,27,7,419,411,62,-349
2019,7,27,8,403,396,61,-335
2019,7,27,9,401,390,62,-328
2019,7,27,10,408,395,60,-335
2019,7,27,11,420,412,62,-350
2019,7,27,12,444,440,107,-333
2019,7,27,13,480,476,131,-345
2019,7,27,14,524,511,130,-381
2019,7,27,15,558,543,133,-410
2019,7,27,16,581,574,133,-441
2019,7,27,17,612,601,133,-468
2019,7,27,18,631,619,133,-486
2019,7,27,19,647,637,132,-505
2019,7,27,20,657,645,188,-457
2019,7,27,21,684,665,202,-463
2019,7,27,22,687,674,201,-473
2019,7,27,23,681,676,201,-475
2019,7,28,0,660,646,159,-487
2019,7,28,1,633,624,125,-499
2019,7,28,2,617,602,59,-543
2019,7,28,3,568,559,58,-501
2019,7,28,4,513,507,60,-447
2019,7,28,5,451,462,58,-404
2019,7,28,6,420,431,59,-372
2019,7,28,7,405,407,58,-349
2019,7,28,8,395,393,59,-334
2019,7,28,9,393,388,60,-328
2019,7,28,10,412,390,59,-331
2019,7,28,11,408,403,62,-341
2019,7,28,12,430,424,63,-361
2019,7,28,13,473,466,63,-403
2019,7,28,14,514,504,62,-442
2019,7,28,15,542,535,111,-424
2019,7,28,16,564,562,135,-427
2019,7,28,17,594,602,138,-464
2019,7,28,18,624,626,137,-489
2019,7,28,19,652,636,262,-374
2019,7,28,20,668,661,402,-259
2019,7,28,21,682,667,418,-249
2019,7,28,22,698,683,425,-258
2019,7,28,23,699,672,425,-247
2019,7,29,0,672,654,426,-228
2019,7,29,1,642,627,227,-400
2019,7,29,2,624,629,137,-492
2019,7,29,3,574,558,61,-497
2019,7,29,4,513,503,61,-442
2019,7,29,5,472,451,58,-393
2019,7,29,6,442,425,95,-330
2019,7,29,7,422,407,269,-138
2019,7,29,8,411,402,389,-13
2019,7,29,9,415,413,390,-23
2019,7,29,10,437,427,386,-41
2019,7,29,11,466,468,347,-121
2019,7,29,12,500,504,224,-280
2019,7,29,13,542,539,219,-320
2019,7,29,14,571,562,174,-388
2019,7,29,15,609,612,144,-468
2019,7,29,16,634,649,248,-401
2019,7,29,17,665,681,357,-324
2019,7,29,18,694,718,359,-359
2019,7,29,19,720,725,358,-367
2019,7,29,20,737,741,390,-351
2019,7,29,21,757,748,412,-336
2019,7,29,22,757,738,413,-325
2019,7,29,23,752,730,414,-316
2019,7,30,0,734,710,413,-297
2019,7,30,1,706,689,409,-280
2019,7,30,2,672,664,275,-389
2019,7,30,3,612,592,77,-515
2019,7,30,4,553,532,64,-468
2019,7,30,5,497,483,62,-421
2019,7,30,6,463,453,61,-392
2019,7,30,7,441,436,63,-373
2019,7,30,8,429,422,63,-359
2019,7,30,9,431,425,64,-361
2019,7,30,10,449,444,64,-380
2019,7,30,11,481,485,66,-419
2019,7,30,12,516,520,70,-450
2019,7,30,13,551,551,70,-481
2019,7,30,14,578,579,71,-508
2019,7,30,15,610,616,73,-543
2019,7,30,16,641,657,187,-470
2019,7,30,17,666,692,257,-435
2019,7,30,18,701,726,296,-430
2019,7,30,19,726,742,314,-428
2019,7,30,20,747,728,365,-363
2019,7,30,21,768,715,406,-309
2019,7,30,22,765,706,412,-294
2019,7,30,23,754,691,418,-273
2019,7,31,0,735,671,415,-256
2019,7,31,1,713,653,379,-274
2019,7,31,2,682,635,353,-282
2019,7,31,3,618,595,125,-470
2019,7,31,4,560,526,67,-459
2019,7,31,5,505,481,61,-420
2019,7,31,6,471,451,64,-387
2019,7,31,7,449,435,64,-371
2019,7,31,8,435,425,66,-359
2019,7,31,9,436,429,63,-366
2019,7,31,10,456,447,65,-382
2019,7,31,11,491,490,64,-426
2019,7,31,12,525,525,65,-460
2019,7,31,13,557,554,66,-488
2019,7,31,14,586,583,65,-518
2019,7,31,15,626,615,114,-501
2019,7,31,16,648,652,216,-436
2019,7,31,17,687,678,234,-444
2019,7,31,18,708,698,296,-402
2019,7,31,19,727,725,369,-356
2019,7,31,20,742,750,413,-337
2019,7,31,21,758,759,420,-339
2019,7,31,22,766,764,418,-346
2019,7,31,23,753,737,418,-319
2019,8,1,0,740,694,419,-275
2019,8,1,1,712,674,392,-282
2019,8,1,2,674,655,324,-331
2019,8,1,3,616,589,152,-437
2019,8,1,4,557,525,120,-405
2019,8,1,5,508,476,64,-412
2019,8,1,6,471,448,62,-386
2019,8,1,7,449,432,60,-372
2019,8,1,8,435,422,62,-360
2019,8,1,9,435,421,61,-360
2019,8,1,10,452,443,61,-382
2019,8,1,11,490,486,62,-424
2019,8,1,12,528,520,65,-455
2019,8,1,13,560,545,67,-478
2019,8,1,14,587,572,131,-441
2019,8,1,15,628,609,133,-476
2019,8,1,16,659,643,183,-460
2019,8,1,17,686,673,296,-377
2019,8,1,18,726,716,343,-373
2019,8,1,19,746,699,347,-352
2019,8,1,20,760,686,344,-342
2019,8,1,21,780,682,326,-356
2019,8,1,22,784,677,273,-404
2019,8,1,23,773,666,267,-399
2019,8,2,0,744,656,266,-390
2019,8,2,1,719,648,266,-382
2019,8,2,2,684,636,265,-371
2019,8,2,3,628,593,189,-404
2019,8,2,4,576,527,104,-423
2019,8,2,5,499,481,64,-417
2019,8,2,6,466,453,63,-390
2019,8,2,7,447,432,64,-368
2019,8,2,8,436,425,66,-359
2019,8,2,9,436,428,65,-363
2019,8,2,10,452,448,64,-384
2019,8,2,11,488,486,64,-422
2019,8,2,12,524,524,67,-457
2019,8,2,13,560,547,131,-416
2019,8,2,14,589,569,131,-438
2019,8,2,15,632,593,133,-460
2019,8,2,16,662,616,132,-484
2019,8,2,17,694,640,180,-460
2019,8,2,18,725,642,217,-425
2019,8,2,19,732,655,266,-389
2019,8,2,20,746,667,284,-383
2019,8,2,21,758,680,282,-398
2019,8,2,22,761,673,326,-347
2019,8,2,23,743,666,340,-326
2019,8,3,0,712,643,344,-299
2019,8,3,1,678,625,314,-311
2019,8,3,2,654,613,264,-349
2019,8,3,3,612,579,176,-403
2019,8,3,4,563,520,72,-448
2019,8,3,5,478,467,67,-400
2019,8,3,6,448,445,73,-372
2019,8,3,7,429,424,71,-353
2019,8,3,8,413,412,73,-339
2019,8,3,9,406,409,72,-337
2019,8,3,10,412,414,69,-345
2019,8,3,11,435,429,69,-360
2019,8,3,12,457,453,67,-386
2019,8,3,13,500,491,69,-422
2019,8,3,14,547,528,117,-411
2019,8,3,15,585,562,134,-428
2019,8,3,16,615,601,136,-465
2019,8,3,17,642,628,140,-488
2019,8,3,18,658,659,257,-402
2019,8,3,19,674,666,282,-384
2019,8,3,20,688,673,289,-384
2019,8,3,21,686,667,300,-367
2019,8,3,22,688,685,381,-304
2019,8,3,23,688,678,409,-269
2019,8,4,0,667,651,370,-281
2019,8,4,1,643,626,224,-402
2019,8,4,2,623,603,198,-405
2019,8,4,3,574,569,93,-476
2019,8,4,4,522,507,65,-442
2019,8,4,5,462,459,65,-394
2019,8,4,6,432,430,68,-362
2019,8,4,7,412,415,71,-344
2019,8,4,8,401,405,70,-335
2019,8,4,9,395,397,68,-329
2019,8,4,10,397,403,71,-332
2019,8,4,11,410,417,70,-347
2019,8,4,12,435,437,70,-367
2019,8,4,13,480,481,70,-411
2019,8,4,14,523,523,74,-449
2019,8,4,15,553,549,70,-479
2019,8,4,16,583,591,73,-518
2019,8,4,17,629,622,87,-535
2019,8,4,18,653,660,280,-380
2019,8,4,19,671,666,314,-352
2019,8,4,20,678,665,318,-347
2019,8,4,21,691,666,338,-328
2019,8,4,22,702,688,389,-299
2019,8,4,23,702,684,389,-295
2019,8,5,0,679,660,383,-277
2019,8,5,1,650,638,275,-363
2019,8,5,2,620,610,151,-459
2019,8,5,3,571,572,98,-474
2019,8,5,4,516,511,74,-437
2019,8,5,5,473,468,73,-395
2019,8,5,6,443,440,73,-367
2019,8,5,7,425,428,71,-357
2019,8,5,8,414,416,69,-347
2019,8,5,9,418,421,69,-352
2019,8,5,10,440,445,71,-374
2019,8,5,11,480,489,69,-420
2019,8,5,12,514,522,70,-452
2019,8,5,13,553,560,73,-487
2019,8,5,14,584,577,70,-507
2019,8,5,15,624,610,72,-538
2019,8,5,16,661,635,126,-509
2019,8,5,17,693,676,147,-529
2019,8,5,18,721,705,198,-507
2019,8,5,19,730,721,249,-472
2019,8,5,20,746,746,284,-462
2019,8,5,21,750,766,301,-465
2019,8,5,22,760,762,301,-461
2019,8,5,23,754,739,299,-440
2019,8,6,0,725,711,260,-451
2019,8,6,1,696,681,233,-448
2019,8,6,2,664,650,208,-442
2019,8,6,3,606,597,186,-411
2019,8,6,4,552,534,68,-466
2019,8,6,5,490,480,65,-415
2019,8,6,6,458,453,64,-389
2019,8,6,7,438,431,63,-368
2019,8,6,8,426,425,64,-361
2019,8,6,9,428,428,65,-363
2019,8,6,10,446,444,63,-381
2019,8,6,11,487,486,62,-424
2019,8,6,12,522,520,66,-454
2019,8,6,13,557,542,63,-479
2019,8,6,14,587,572,66,-506
2019,8,6,15,622,611,110,-501
2019,8,6,16,659,642,165,-477
2019,8,6,17,690,677,236,-441
2019,8,6,18,722,690,300,-390
2019,8,6,19,735,708,386,-322
2019,8,6,20,754,742,418,-324
2019,8,6,21,759,766,419,-347
2019,8,6,22,768,773,414,-359
2019,8,6,23,761,770,420,-350
2019,8,7,0,736,736,417,-319
2019,8,7,1,708,709,390,-319
2019,8,7,2,678,688,339,-349
2019,8,7,3,619,572,119,-453
2019,8,7,4,568,553,70,-483
2019,8,7,5,506,498,62,-436
2019,8,7,6,472,467,62,-405
2019,8,7,7,452,444,60,-384
2019,8,7,8,440,431,61,-370
2019,8,7,9,440,437,62,-375
2019,8,7,10,459,451,61,-390
2019,8,7,11,502,494,62,-432
2019,8,7,12,535,528,62,-466
2019,8,7,13,568,555,62,-493
2019,8,7,14,599,582,64,-518
2019,8,7,15,637,669,213,-456
2019,8,7,16,670,644,262,-382
2019,8,7,17,707,681,381,-300
2019,8,7,18,739,723,411,-312
2019,8,7,19,752,748,412,-336
2019,8,7,20,768,763,413,-350
2019,8,7,21,775,781,418,-363
2019,8,7,22,783,782,414,-368
2019,8,7,23,772,776,415,-361
2019,8,8,0,744,743,408,-335
2019,8,8,1,712,707,356,-351
2019,8,8,2,681,685,342,-343
2019,8,8,3,622,600,132,-468
2019,8,8,4,564,554,77,-477
2019,8,8,5,503,493,62,-431
2019,8,8,6,468,461,60,-401
2019,8,8,7,448,440,62,-378
2019,8,8,8,437,427,61,-366
2019,8,8,9,437,426,61,-365
2019,8,8,10,455,441,62,-379
2019,8,8,11,497,484,60,-424
2019,8,8,12,530,519,64,-455
2019,8,8,13,564,546,63,-483
2019,8,8,14,597,562,76,-494
2019,8,8,15,635,607,162,-477
2019,8,8,16,665,605,259,-388
2019,8,8,17,702,628,293,-389
2019,8,8,18,736,690,330,-402
2019,8,8,19,753,726,355,-371
2019,8,8,20,773,765,416,-349
2019,8,8,21,779,764,417,-347
2019,8,8,22,786,761,389,-372
2019,8,8,23,769,734,360,-374
2019,8,9,0,741,706,352,-354
2019,8,9,1,713,689,355,-334
2019,8,9,2,683,659,346,-313
2019,8,9,3,624,597,188,-409
2019,8,9,4,567,545,130,-415
2019,8,9,5,514,481,69,-412
2019,8,9,6,479,448,61,-387
2019,8,9,7,459,428,61,-367
2019,8,9,8,450,419,62,-357
2019,8,9,9,450,423,63,-360
2019,8,9,10,466,436,60,-376
2019,8,9,11,504,477,63,-414
2019,8,9,12,535,515,64,-451
2019,8,9,13,571,541,62,-479
2019,8,9,14,598,533,107,-470
2019,8,9,15,638,513,169,-448
2019,8,9,16,672,527,219,-413
2019,8,9,17,700,569,347,-331
2019,8,9,18,729,589,439,-278
2019,8,9,19,746,588,502,-236
2019,8,9,20,764,606,584,-189
2019,8,9,21,770,765,448,-350
2019,8,9,22,775,804,416,-388
2019,8,9,23,758,789,366,-423
2019,8,10,0,724,751,352,-399
2019,8,10,1,690,711,351,-360
2019,8,10,2,666,681,351,-330
2019,8,10,3,620,627,199,-428
2019,8,10,4,570,569,144,-425
2019,8,10,5,508,504,125,-379
2019,8,10,6,474,474,129,-345
2019,8,10,7,443,452,130,-322
2019,8,10,8,438,434,128,-306
2019,8,10,9,426,433,122,-311
2019,8,10,10,433,437,74,-363
2019,8,10,11,448,454,71,-383
2019,8,10,12,470,474,70,-404
2019,8,10,13,510,510,69,-441
2019,8,10,14,549,509,102,-440
2019,8,10,15,587,504,143,-427
2019,8,10,16,628,435,298,-298
2019,8,10,17,654,458,309,-322
2019,8,10,18,678,489,385,-273
2019,8,10,19,702,492,446,-217
2019,8,10,20,713,529,494,-205
2019,8,10,21,736,560,490,-228
2019,8,10,22,743,729,382,-349
2019,8,10,23,735,727,353,-374
2019,8,11,0,698,703,284,-419
2019,8,11,1,669,675,259,-416
2019,8,11,2,634,650,245,-405
2019,8,11,3,588,605,188,-417
2019,8,11,4,533,557,125,-432
2019,8,11,5,510,503,74,-429
2019,8,11,6,465,461,60,-401
2019,8,11,7,435,439,62,-377
2019,8,11,8,424,428,68,-360
2019,8,11,9,414,416,67,-349
2019,8,11,10,413,418,66,-352
2019,8,11,11,429,429,64,-365
2019,8,11,12,455,447,76,-382
2019,8,11,13,499,452,120,-378
2019,8,11,14,546,435,177,-362
2019,8,11,15,580,453,191,-382
2019,8,11,16,618,488,198,-415
2019,8,11,17,658,525,289,-361
2019,8,11,18,689,538,383,-306
2019,8,11,19,705,562,383,-330
2019,8,11,20,730,618,436,-294
2019,8,11,21,751,659,504,-256
2019,8,11,22,761,738,462,-324
2019,8,11,23,755,773,411,-362
2019,8,12,0,731,745,413,-332
2019,8,12,1,702,718,415,-303
2019,8,12,2,666,680,371,-309
2019,8,12,3,611,624,254,-370
2019,8,12,4,552,571,163,-408
2019,8,12,5,507,516,93,-423
2019,8,12,6,471,471,67,-404
2019,8,12,7,450,455,69,-386
2019,8,12,8,440,438,67,-371
2019,8,12,9,442,447,70,-377
2019,8,12,10,461,465,67,-398
2019,8,12,11,503,509,67,-442
2019,8,12,12,537,526,84,-457
2019,8,12,13,576,478,133,-424
2019,8,12,14,610,540,164,-457
2019,8,12,15,662,562,161,-482
2019,8,12,16,707,608,281,-408
2019,8,12,17,744,656,361,-367
2019,8,12,18,788,685,426,-346
2019,8,12,19,810,706,439,-363
2019,8,12,20,824,698,465,-344
2019,8,12,21,836,637,583,-225
2019,8,12,22,848,753,473,-340
2019,8,12,23,842,798,412,-386
2019,8,13,0,805,776,410,-366
2019,8,13,1,770,755,410,-345
2019,8,13,2,748,720,359,-361
2019,8,13,3,663,657,342,-315
2019,8,13,4,607,607,288,-319
2019,8,13,5,555,558,112,-446
2019,8,13,6,516,510,67,-443
2019,8,13,7,489,488,67,-421
2019,8,13,8,474,473,67,-406
2019,8,13,9,470,465,67,-398
2019,8,13,10,485,489,69,-420
2019,8,13,11,522,529,66,-463
2019,8,13,12,560,563,68,-495
2019,8,13,13,597,597,68,-529
2019,8,13,14,636,638,155,-483
2019,8,13,15,684,687,195,-492
2019,8,13,16,729,744,366,-378
2019,8,13,17,764,788,409,-379
2019,8,13,18,805,815,489,-326
2019,8,13,19,830,819,567,-252
2019,8,13,20,838,775,566,-209
2019,8,13,21,851,768,571,-197
2019,8,13,22,860,792,570,-222
2019,8,13,23,855,795,527,-268
2019,8,14,0,818,777,337,-440
2019,8,14,1,782,757,327,-430
2019,8,14,2,766,707,224,-483
2019,8,14,3,678,650,160,-490
2019,8,14,4,621,583,76,-507
2019,8,14,5,558,524,64,-460
2019,8,14,6,523,493,64,-429
2019,8,14,7,494,468,65,-403
2019,8,14,8,480,457,66,-391
2019,8,14,9,478,457,66,-391
2019,8,14,10,496,477,66,-411
2019,8,14,11,528,525,65,-460
2019,8,14,12,564,560,66,-494
2019,8,14,13,599,581,66,-515
2019,8,14,14,641,611,68,-543
2019,8,14,15,688,657,195,-462
2019,8,14,16,740,679,282,-397
2019,8,14,17,766,714,333,-381
2019,8,14,18,806,750,479,-271
2019,8,14,19,824,783,588,-195
2019,8,14,20,831,773,584,-189
2019,8,14,21,847,761,587,-174
2019,8,14,22,858,766,570,-196
2019,8,14,23,852,765,538,-227
2019,8,15,0,809,747,460,-287
2019,8,15,1,776,718,348,-370
2019,8,15,2,747,700,273,-427
2019,8,15,3,668,616,132,-484
2019,8,15,4,609,548,65,-483
2019,8,15,5,538,498,65,-433
2019,8,15,6,501,466,68,-398
2019,8,15,7,475,441,67,-374
2019,8,15,8,462,433,67,-366
2019,8,15,9,458,435,67,-368
2019,8,15,10,475,457,66,-391
2019,8,15,11,517,505,67,-438
2019,8,15,12,546,540,65,-475
2019,8,15,13,580,568,85,-483
2019,8,15,14,615,603,115,-488
2019,8,15,15,654,638,155,-483
2019,8,15,16,690,689,397,-292
2019,8,15,17,720,723,401,-322
2019,8,15,18,752,751,393,-358
2019,8,15,19,768,770,480,-290
2019,8,15,20,780,798,553,-245
2019,8,15,21,800,808,553,-255
2019,8,15,22,808,809,554,-255
2019,8,15,23,794,796,556,-240
2019,8,16,0,755,763,416,-347
2019,8,16,1,735,726,320,-406
2019,8,16,2,692,689,319,-370
2019,8,16,3,626,630,249,-381
2019,8,16,4,572,566,134,-432
2019,8,16,5,493,509,81,-428
2019,8,16,6,458,466,75,-391
2019,8,16,7,438,449,77,-372
2019,8,16,8,428,441,78,-363
2019,8,16,9,429,431,75,-356
2019,8,16,10,442,450,78,-372
2019,8,16,11,487,491,76,-415
2019,8,16,12,522,526,94,-432
2019,8,16,13,553,556,186,-370
2019,8,16,14,580,589,250,-339
2019,8,16,15,619,619,262,-357
2019,8,16,16,648,666,360,-306
2019,8,16,17,685,712,411,-301
2019,8,16,18,718,725,461,-264
2019,8,16,19,743,779,567,-212
2019,8,16,20,759,802,561,-241
2019,8,16,21,778,813,486,-327
2019,8,16,22,785,818,481,-337
2019,8,16,23,762,796,470,-326
2019,8,17,0,721,756,499,-257
2019,8,17,1,687,705,347,-358
2019,8,17,2,660,668,345,-323
2019,8,17,3,605,626,174,-452
2019,8,17,4,552,543,68,-475
2019,8,17,5,494,490,70,-420
2019,8,17,6,456,453,70,-383
2019,8,17,7,433,434,72,-362
2019,8,17,8,421,421,73,-348
2019,8,17,9,416,415,73,-342
2019,8,17,10,420,420,72,-348
2019,8,17,11,437,435,73,-362
2019,8,17,12,456,456,72,-384
2019,8,17,13,499,497,73,-424
2019,8,17,14,541,536,74,-462
2019,8,17,15,585,585,74,-511
2019,8,17,16,631,627,136,-491
2019,8,17,17,667,674,239,-435
2019,8,17,18,698,712,317,-395
2019,8,17,19,717,729,354,-375
2019,8,17,20,742,757,407,-350
2019,8,17,21,761,772,418,-354
2019,8,17,22,765,784,419,-365
2019,8,17,23,744,769,369,-400
2019,8,18,0,720,731,347,-384
2019,8,18,1,689,699,348,-351
2019,8,18,2,659,671,276,-395
2019,8,18,3,598,612,145,-467
2019,8,18,4,553,555,84,-471
2019,8,18,5,498,490,64,-426
2019,8,18,6,456,461,63,-398
2019,8,18,7,431,437,60,-377
2019,8,18,8,416,428,62,-366
2019,8,18,9,410,414,60,-354
2019,8,18,10,406,419,60,-359
2019,8,18,11,425,430,62,-368
2019,8,18,12,449,453,60,-393
2019,8,18,13,495,502,62,-440
2019,8,18,14,537,553,63,-490
2019,8,18,15,575,596,62,-534
2019,8,18,16,616,628,93,-535
2019,8,18,17,647,689,200,-489
2019,8,18,18,690,725,243,-482
2019,8,18,19,712,748,271,-477
2019,8,18,20,744,754,328,-426
2019,8,18,21,764,782,351,-431
2019,8,18,22,779,795,412,-383
2019,8,18,23,766,788,414,-374
2019,8,19,0,743,762,370,-392
2019,8,19,1,723,731,347,-384
2019,8,19,2,677,690,348,-342
2019,8,19,3,615,634,262,-372
2019,8,19,4,561,562,78,-484
2019,8,19,5,493,502,66,-436
2019,8,19,6,457,468,60,-408
2019,8,19,7,434,444,60,-384
2019,8,19,8,424,435,60,-375
2019,8,19,9,426,440,61,-379
2019,8,19,10,450,462,59,-403
2019,8,19,11,496,526,59,-467
2019,8,19,12,527,547,60,-487
2019,8,19,13,565,575,60,-515
2019,8,19,14,596,609,68,-541
2019,8,19,15,646,654,171,-483
2019,8,19,16,675,707,239,-468
2019,8,19,17,725,751,328,-423
2019,8,19,18,761,793,468,-325
2019,8,19,19,790,767,513,-254
2019,8,19,20,806,751,507,-244
2019,8,19,21,824,731,463,-268
2019,8,19,22,830,726,325,-401
2019,8,19,23,810,729,262,-467
2019,8,20,0,777,701,200,-501
2019,8,20,1,750,691,200,-491
2019,8,20,2,714,657,196,-461
2019,8,20,3,636,606,154,-452
2019,8,20,4,578,539,74,-465
2019,8,20,5,515,485,66,-419
2019,8,20,6,478,453,67,-386
2019,8,20,7,451,442,69,-373
2019,8,20,8,441,430,69,-361
2019,8,20,9,441,432,67,-365
2019,8,20,10,461,457,68,-389
2019,8,20,11,508,520,70,-450
2019,8,20,12,539,543,69,-474
2019,8,20,13,570,557,70,-487
2019,8,20,14,603,586,72,-514
2019,8,20,15,643,597,107,-490
2019,8,20,16,680,658,221,-437
2019,8,20,17,721,700,240,-460
2019,8,20,18,761,727,301,-426
2019,8,20,19,783,721,379,-342
2019,8,20,20,802,730,411,-319
2019,8,20,21,816,747,415,-332
2019,8,20,22,820,756,414,-342
2019,8,20,23,806,756,376,-380
2019,8,21,0,773,730,350,-380
2019,8,21,1,744,708,349,-359
2019,8,21,2,710,667,342,-325
2019,8,21,3,637,614,174,-440
2019,8,21,4,585,542,86,-456
2019,8,21,5,519,492,68,-424
2019,8,21,6,481,456,64,-392
2019,8,21,7,458,437,67,-370
2019,8,21,8,446,433,70,-363
2019,8,21,9,443,433,68,-365
2019,8,21,10,465,461,70,-391
2019,8,21,11,517,519,73,-446
2019,8,21,12,546,543,121,-422
2019,8,21,13,572,566,126,-440
2019,8,21,14,607,602,226,-376
2019,8,21,15,651,642,343,-299
2019,8,21,16,691,693,439,-254
2019,8,21,17,727,735,448,-287
2019,8,21,18,767,771,536,-235
2019,8,21,19,789,786,580,-206
2019,8,21,20,798,768,584,-184
2019,8,21,21,813,741,491,-250
2019,8,21,22,828,745,416,-329
2019,8,21,23,812,756,398,-358
2019,8,22,0,771,738,350,-388
2019,8,22,1,750,720,350,-370
2019,8,22,2,713,685,340,-345
2019,8,22,3,638,614,246,-368
2019,8,22,4,582,565,158,-407
2019,8,22,5,521,509,82,-427
2019,8,22,6,485,471,69,-402
2019,8,22,7,462,452,69,-383
2019,8,22,8,450,440,70,-370
2019,8,22,9,448,442,69,-373
2019,8,22,10,468,471,71,-400
2019,8,22,11,520,523,78,-445
2019,8,22,12,547,556,145,-411
2019,8,22,13,574,582,181,-401
2019,8,22,14,606,610,241,-369
2019,8,22,15,648,646,245,-401
2019,8,22,16,680,700,359,-341
2019,8,22,17,714,718,371,-347
2019,8,22,18,742,686,413,-273
2019,8,22,19,762,671,531,-140
2019,8,22,20,772,685,527,-158
2019,8,22,21,785,715,386,-329
2019,8,22,22,788,737,302,-435
2019,8,22,23,770,743,281,-462
2019,8,23,0,742,718,218,-500
2019,8,23,1,716,707,300,-407
2019,8,23,2,678,656,203,-453
2019,8,23,3,613,606,138,-468
2019,8,23,4,558,546,75,-471
2019,8,23,5,512,491,102,-389
2019,8,23,6,477,466,139,-327
2019,8,23,7,453,451,140,-311
2019,8,23,8,443,439,135,-304
2019,8,23,9,442,443,135,-308
2019,8,23,10,461,470,136,-334
2019,8,23,11,513,521,132,-389
2019,8,23,12,541,553,218,-335
2019,8,23,13,567,568,300,-268
2019,8,23,14,601,589,300,-289
2019,8,23,15,630,631,315,-316
2019,8,23,16,667,662,430,-232
2019,8,23,17,702,683,496,-187
2019,8,23,18,723,725,578,-147
2019,8,23,19,732,745,597,-148
2019,8,23,20,742,749,619,-130
2019,8,23,21,753,742,610,-132
2019,8,23,22,754,722,540,-182
2019,8,23,23,733,697,415,-282
2019,8,24,0,695,687,389,-298
2019,8,24,1,684,672,373,-299
2019,8,24,2,646,649,277,-372
2019,8,24,3,598,592,138,-454
2019,8,24,4,550,541,132,-409
2019,8,24,5,471,491,128,-363
2019,8,24,6,442,468,130,-338
2019,8,24,7,430,448,129,-319
2019,8,24,8,418,441,132,-309
2019,8,24,9,416,431,130,-301
2019,8,24,10,426,444,130,-314
2019,8,24,11,446,457,145,-312
2019,8,24,12,461,484,179,-305
2019,8,24,13,496,524,232,-292
2019,8,24,14,538,558,233,-325
2019,8,24,15,566,579,232,-347
2019,8,24,16,578,596,283,-313
2019,8,24,17,576,610,299,-311
2019,8,24,18,581,626,299,-327
2019,8,24,19,569,625,298,-327
2019,8,24,20,580,626,300,-326
2019,8,24,21,587,619,298,-321
2019,8,24,22,579,616,304,-312
2019,8,24,23,578,596,163,-433
2019,8,25,0,569,576,69,-507
2019,8,25,1,563,570,68,-502
2019,8,25,2,532,544,68,-476
2019,8,25,3,501,507,66,-441
2019,8,25,4,459,469,67,-402
2019,8,25,5,432,428,63,-365
2019,8,25,6,405,404,63,-341
2019,8,25,7,391,389,63,-326
2019,8,25,8,382,383,62,-321
2019,8,25,9,375,382,63,-319
2019,8,25,10,382,385,63,-322
2019,8,25,11,403,400,63,-337
2019,8,25,12,425,423,65,-358
2019,8,25,13,460,461,67,-394
2019,8,25,14,492,496,71,-425
2019,8,25,15,515,499,71,-428
2019,8,25,16,520,510,71,-439
2019,8,25,17,537,524,72,-452
2019,8,25,18,542,533,73,-460
2019,8,25,19,552,533,71,-462
2019,8,25,20,557,538,72,-466
2019,8,25,21,575,542,71,-471
2019,8,25,22,583,554,70,-484
2019,8,25,23,600,556,71,-485
2019,8,26,0,592,556,75,-481
2019,8,26,1,590,558,69,-489
2019,8,26,2,554,533,68,-465
2019,8,26,3,510,492,69,-423
2019,8,26,4,462,449,66,-383
2019,8,26,5,424,415,64,-351
2019,8,26,6,401,398,61,-337
2019,8,26,7,390,389,60,-329
2019,8,26,8,385,387,60,-327
2019,8,26,9,391,392,60,-332
2019,8,26,10,419,421,60,-361
2019,8,26,11,482,484,62,-422
2019,8,26,12,508,509,92,-417
2019,8,26,13,530,529,75,-454
2019,8,26,14,554,545,62,-483
2019,8,26,15,573,557,62,-495
2019,8,26,16,597,572,67,-505
2019,8,26,17,608,576,115,-461
2019,8,26,18,612,592,132,-460
2019,8,26,19,612,585,129,-456
2019,8,26,20,620,584,130,-454
2019,8,26,21,633,585,138,-447
2019,8,26,22,642,594,164,-430
2019,8,26,23,648,592,207,-385
2019,8,27,0,629,599,235,-364
2019,8,27,1,626,604,212,-392
2019,8,27,2,590,579,163,-416
2019,8,27,3,534,534,123,-411
2019,8,27,4,486,476,76,-400
2019,8,27,5,436,435,74,-361
2019,8,27,6,412,417,79,-338
2019,8,27,7,398,411,77,-334
2019,8,27,8,391,404,73,-331
2019,8,27,9,399,409,72,-337
2019,8,27,10,424,439,66,-373
2019,8,27,11,484,501,66,-435
2019,8,27,12,516,530,66,-464
2019,8,27,13,532,539,71,-468
2019,8,27,14,553,556,72,-484
2019,8,27,15,577,566,119,-447
2019,8,27,16,603,576,133,-443
2019,8,27,17,618,576,133,-443
2019,8,27,18,636,575,132,-443
2019,8,27,19,650,574,133,-441
2019,8,27,20,665,574,133,-441
2019,8,27,21,679,584,140,-444
2019,8,27,22,689,592,133,-459
2019,8,27,23,684,599,112,-487
2019,8,28,0,666,596,64,-532
2019,8,28,1,660,608,67,-541
2019,8,28,2,620,579,66,-513
2019,8,28,3,561,531,65,-466
2019,8,28,4,510,485,68,-417
2019,8,28,5,435,447,66,-381
2019,8,28,6,415,425,66,-359
2019,8,28,7,405,412,65,-347
2019,8,28,8,398,409,67,-342
2019,8,28,9,406,414,65,-349
2019,8,28,10,434,447,65,-382
2019,8,28,11,500,512,67,-445
2019,8,28,12,524,536,65,-471
2019,8,28,13,539,552,67,-485
2019,8,28,14,560,575,67,-508
2019,8,28,15,581,598,71,-527
2019,8,28,16,609,617,123,-494
2019,8,28,17,625,635,177,-458
2019,8,28,18,656,661,219,-442
2019,8,28,19,673,671,270,-401
2019,8,28,20,690,688,308,-380
2019,8,28,21,694,705,402,-303
2019,8,28,22,700,717,401,-316
2019,8,28,23,688,707,398,-309
2019,8,29,0,664,676,360,-316
2019,8,29,1,652,655,329,-326
2019,8,29,2,618,623,201,-422
2019,8,29,3,552,563,108,-455
2019,8,29,4,499,496,70,-426
2019,8,29,5,445,446,67,-379
2019,8,29,6,417,418,67,-351
2019,8,29,7,399,403,67,-336
2019,8,29,8,395,397,68,-329
2019,8,29,9,399,399,65,-334
2019,8,29,10,427,426,69,-357
2019,8,29,11,494,485,69,-416
2019,8,29,12,516,509,70,-439
2019,8,29,13,530,523,70,-453
2019,8,29,14,552,544,72,-472
2019,8,29,15,576,556,72,-484
2019,8,29,16,604,574,117,-457
2019,8,29,17,632,588,139,-449
2019,8,29,18,651,606,139,-467
2019,8,29,19,664,622,139,-483
2019,8,29,20,679,640,139,-501
2019,8,29,21,684,668,209,-459
2019,8,29,22,676,678,207,-471
2019,8,29,23,675,669,158,-511
2019,8,30,0,670,646,141,-505
2019,8,30,1,661,623,137,-486
2019,8,30,2,620,587,86,-501
2019,8,30,3,558,532,70,-462
2019,8,30,4,496,474,70,-404
2019,8,30,5,447,430,69,-361
2019,8,30,6,415,410,71,-339
2019,8,30,7,397,391,70,-321
2019,8,30,8,388,387,71,-316
2019,8,30,9,393,389,70,-319
2019,8,30,10,423,416,70,-346
2019,8,30,11,487,471,71,-400
2019,8,30,12,513,493,69,-424
2019,8,30,13,527,506,69,-437
2019,8,30,14,546,524,70,-454
2019,8,30,15,568,544,72,-472
2019,8,30,16,589,554,70,-484
2019,8,30,17,620,574,71,-503
2019,8,30,18,628,596,71,-525
2019,8,30,19,653,619,77,-542
2019,8,30,20,684,631,209,-422
2019,8,30,21,700,668,396,-272
2019,8,30,22,695,692,435,-257
2019,8,30,23,685,684,435,-249
2019,8,31,0,653,649,378,-271
2019,8,31,1,634,629,288,-341
2019,8,31,2,605,604,138,-466
2019,8,31,3,553,543,72,-471
2019,8,31,4,498,487,68,-419
2019,8,31,5,450,441,67,-374
2019,8,31,6,421,414,67,-347
2019,8,31,7,402,394,68,-326
2019,8,31,8,394,386,69,-317
2019,8,31,9,395,374,67,-307
2019,8,31,10,397,386,69,-317
2019,8,31,11,412,404,67,-337
2019,8,31,12,433,426,66,-360
2019,8,31,13,467,464,65,-399
2019,8,31,14,506,495,65,-430
2019,8,31,15,540,523,66,-457
2019,8,31,16,561,549,120,-429
2019,8,31,17,590,576,131,-445
2019,8,31,18,602,602,131,-471
2019,8,31,19,624,612,168,-444
2019,8,31,20,648,659,365,-294
2019,8,31,21,670,682,390,-292
2019,8,31,22,680,687,401,-286
2019,8,31,23,654,679,353,-326
2019,9,1,0,633,646,316,-330
2019,9,1,1,627,625,166,-459
2019,9,1,2,588,594,116,-478
2019,9,1,3,544,532,74,-458
2019,9,1,4,491,478,72,-406
2019,9,1,5,440,437,70,-367
2019,9,1,6,408,408,71,-337
2019,9,1,7,393,386,68,-318
2019,9,1,8,383,379,71,-308
2019,9,1,9,378,369,68,-301
2019,9,1,10,385,375,70,-305
2019,9,1,11,402,390,71,-319
2019,9,1,12,423,408,68,-340
2019,9,1,13,468,450,69,-381
2019,9,1,14,503,483,70,-413
2019,9,1,15,529,509,70,-439
2019,9,1,16,549,530,115,-415
2019,9,1,17,574,562,137,-425
2019,9,1,18,588,588,135,-453
2019,9,1,19,599,608,144,-464
2019,9,1,20,608,626,261,-365
2019,9,1,21,620,665,386,-279
2019,9,1,22,637,674,395,-279
2019,9,1,23,622,665,358,-307
2019,9,2,0,608,636,322,-314
2019,9,2,1,589,614,170,-444
2019,9,2,2,555,589,149,-440
2019,9,2,3,520,546,87,-459
2019,9,2,4,472,485,71,-414
2019,9,2,5,436,438,70,-368
2019,9,2,6,404,413,71,-342
2019,9,2,7,390,395,71,-324
2019,9,2,8,386,384,70,-314
2019,9,2,9,383,382,73,-309
2019,9,2,10,396,387,71,-316
2019,9,2,11,415,405,71,-334
2019,9,2,12,430,429,71,-358
2019,9,2,13,468,458,69,-389
2019,9,2,14,500,497,71,-426
2019,9,2,15,547,534,74,-460
2019,9,2,16,577,567,72,-495
2019,9,2,17,609,607,72,-535
2019,9,2,18,628,618,118,-500
2019,9,2,19,640,664,297,-367
2019,9,2,20,657,688,421,-267
2019,9,2,21,677,717,435,-282
2019,9,2,22,690,734,438,-296
2019,9,2,23,684,724,431,-293
2019,9,3,0,660,695,354,-341
2019,9,3,1,658,676,333,-343
2019,9,3,2,604,630,255,-375
2019,9,3,3,549,570,155,-415
2019,9,3,4,488,501,69,-432
2019,9,3,5,441,453,62,-391
2019,9,3,6,416,424,62,-362
2019,9,3,7,401,410,62,-348
2019,9,3,8,395,400,62,-338
2019,9,3,9,402,405,59,-346
2019,9,3,10,426,426,58,-368
2019,9,3,11,494,491,58,-433
2019,9,3,12,522,520,61,-459
2019,9,3,13,542,543,59,-484
2019,9,3,14,563,569,60,-509
2019,9,3,15,596,597,82,-515
2019,9,3,16,619,624,270,-354
2019,9,3,17,643,678,331,-347
2019,9,3,18,672,715,331,-384
2019,9,3,19,684,742,331,-411
2019,9,3,20,700,771,335,-436
2019,9,3,21,708,791,391,-400
2019,9,3,22,722,798,433,-365
2019,9,3,23,708,792,432,-360
2019,9,4,0,692,761,362,-399
2019,9,4,1,676,741,331,-410
2019,9,4,2,630,690,335,-355
2019,9,4,3,565,626,213,-413
2019,9,4,4,509,552,69,-483
2019,9,4,5,495,500,64,-436
2019,9,4,6,461,466,62,-404
2019,9,4,7,445,447,62,-385
2019,9,4,8,432,433,60,-373
2019,9,4,9,433,433,59,-374
2019,9,4,10,459,455,58,-397
2019,9,4,11,516,516,60,-456
2019,9,4,12,540,535,57,-478
2019,9,4,13,562,557,60,-497
2019,9,4,14,584,580,60,-520
2019,9,4,15,615,603,70,-533
2019,9,4,16,645,659,180,-479
2019,9,4,17,681,690,207,-483
2019,9,4,18,711,739,287,-452
2019,9,4,19,743,784,460,-324
2019,9,4,20,768,814,492,-322
2019,9,4,21,781,837,551,-286
2019,9,4,22,790,843,556,-287
2019,9,4,23,780,820,557,-263
2019,9,5,0,747,772,506,-266
2019,9,5,1,731,744,489,-255
2019,9,5,2,684,701,453,-248
2019,9,5,3,613,627,273,-354
2019,9,5,4,549,551,102,-449
2019,9,5,5,469,496,74,-422
2019,9,5,6,444,465,75,-390
2019,9,5,7,429,447,75,-372
2019,9,5,8,423,440,77,-363
2019,9,5,9,426,437,74,-363
2019,9,5,10,449,462,73,-389
2019,9,5,11,514,528,76,-452
2019,9,5,12,540,552,72,-480
2019,9,5,13,557,566,73,-493
2019,9,5,14,577,590,93,-497
2019,9,5,15,605,622,98,-524
2019,9,5,16,632,659,130,-529
2019,9,5,17,650,692,250,-442
2019,9,5,18,664,729,272,-457
2019,9,5,19,680,745,259,-486
2019,9,5,20,690,769,360,-409
2019,9,5,21,696,772,352,-420
2019,9,5,22,699,782,386,-396
2019,9,5,23,693,769,390,-379
2019,9,6,0,670,753,326,-427
2019,9,6,1,668,738,311,-427
2019,9,6,2,634,694,303,-391
2019,9,6,3,570,622,297,-325
2019,9,6,4,513,561,202,-359
2019,9,6,5,462,515,150,-365
2019,9,6,6,433,478,87,-391
2019,9,6,7,419,448,69,-379
2019,9,6,8,410,435,70,-365
2019,9,6,9,412,434,67,-367
2019,9,6,10,433,454,66,-388
2019,9,6,11,487,513,66,-447
2019,9,6,12,515,537,67,-470
2019,9,6,13,533,558,68,-490
2019,9,6,14,550,583,70,-513
2019,9,6,15,577,610,97,-513
2019,9,6,16,605,628,162,-466
2019,9,6,17,625,705,338,-367
2019,9,6,18,653,677,267,-410
2019,9,6,19,676,709,356,-353
2019,9,6,20,700,712,429,-283
2019,9,6,21,713,732,566,-166
2019,9,6,22,713,728,558,-170
2019,9,6,23,685,704,499,-205
2019,9,7,0,657,663,337,-326
2019,9,7,1,638,641,326,-315
2019,9,7,2,599,600,231,-369
2019,9,7,3,550,568,178,-390
2019,9,7,4,498,516,101,-415
2019,9,7,5,437,462,67,-395
2019,9,7,6,410,434,66,-368
2019,9,7,7,392,417,67,-350
2019,9,7,8,387,409,66,-343
2019,9,7,9,387,404,66,-338
2019,9,7,10,403,407,66,-341
2019,9,7,11,430,425,65,-360
2019,9,7,12,467,447,111,-336
2019,9,7,13,509,484,245,-239
2019,9,7,14,539,530,245,-285
2019,9,7,15,562,570,245,-325
2019,9,7,16,580,595,250,-345
2019,9,7,17,597,617,297,-320
2019,9,7,18,612,645,335,-310
2019,9,7,19,632,668,450,-218
2019,9,7,20,651,691,504,-187
2019,9,7,21,670,713,520,-193
2019,9,7,22,676,714,529,-185
2019,9,7,23,663,700,483,-217
2019,9,8,0,644,662,357,-305
2019,9,8,1,638,636,360,-276
2019,9,8,2,586,598,275,-323
2019,9,8,3,536,541,195,-346
2019,9,8,4,479,492,195,-297
2019,9,8,5,458,444,195,-249
2019,9,8,6,424,416,194,-222
2019,9,8,7,403,404,195,-209
2019,9,8,8,393,391,196,-195
2019,9,8,9,388,382,194,-188
2019,9,8,10,388,389,195,-194
2019,9,8,11,405,409,182,-227
2019,9,8,12,425,435,113,-322
2019,9,8,13,468,468,140,-328
2019,9,8,14,507,497,191,-306
2019,9,8,15,537,521,193,-328
2019,9,8,16,566,549,191,-358
2019,9,8,17,606,583,181,-402
2019,9,8,18,638,605,187,-418
2019,9,8,19,667,644,404,-240
2019,9,8,20,693,686,430,-256
2019,9,8,21,716,716,430,-286
2019,9,8,22,731,731,423,-308
2019,9,8,23,705,723,411,-312
2019,9,9,0,689,691,413,-278
2019,9,9,1,667,673,360,-313
2019,9,9,2,623,615,353,-262
2019,9,9,3,567,558,200,-358
2019,9,9,4,509,508,132,-376
2019,9,9,5,452,454,76,-378
2019,9,9,6,426,423,68,-355
2019,9,9,7,410,409,68,-341
2019,9,9,8,403,404,68,-336
2019,9,9,9,407,405,68,-337
2019,9,9,10,430,433,69,-364
2019,9,9,11,483,489,69,-420
2019,9,9,12,514,515,66,-449
2019,9,9,13,537,533,151,-382
2019,9,9,14,561,564,148,-416
2019,9,9,15,598,572,169,-403
2019,9,9,16,636,614,283,-331
2019,9,9,17,670,665,441,-224
2019,9,9,18,706,704,442,-262
2019,9,9,19,737,739,571,-168
2019,9,9,20,766,770,589,-181
2019,9,9,21,781,795,687,-108
2019,9,9,22,788,809,675,-134
2019,9,9,23,774,794,524,-270
2019,9,10,0,739,753,513,-240
2019,9,10,1,725,726,464,-262
2019,9,10,2,668,664,283,-381
2019,9,10,3,604,597,198,-399
2019,9,10,4,544,549,131,-418
2019,9,10,5,478,476,67,-409
2019,9,10,6,438,449,72,-377
2019,9,10,7,418,431,72,-359
2019,9,10,8,405,420,70,-350
2019,9,10,9,416,421,71,-350
2019,9,10,10,449,452,74,-378
2019,9,10,11,544,503,70,-433
2019,9,10,12,591,532,95,-437
2019,9,10,13,613,552,156,-396
2019,9,10,14,636,578,274,-304
2019,9,10,15,667,617,268,-349
2019,9,10,16,702,644,338,-306
2019,9,10,17,718,698,422,-276
2019,9,10,18,743,752,431,-321
2019,9,10,19,754,781,455,-326
2019,9,10,20,776,806,439,-367
2019,9,10,21,795,817,603,-214
2019,9,10,22,791,820,657,-163
2019,9,10,23,778,794,673,-121
2019,9,11,0,770,763,500,-263
2019,9,11,1,761,743,457,-286
2019,9,11,2,699,673,271,-402
2019,9,11,3,608,616,187,-429
2019,9,11,4,533,561,102,-459
2019,9,11,5,501,502,69,-433
2019,9,11,6,468,468,68,-400
2019,9,11,7,450,447,67,-380
2019,9,11,8,440,435,68,-367
2019,9,11,9,441,441,71,-370
2019,9,11,10,464,463,69,-394
2019,9,11,11,527,519,68,-451
2019,9,11,12,557,535,97,-438
2019,9,11,13,570,551,134,-417
2019,9,11,14,600,751,277,-474
2019,9,11,15,643,616,282,-334
2019,9,11,16,684,660,372,-288
2019,9,11,17,712,708,429,-279
2019,9,11,18,748,760,481,-279
2019,9,11,19,774,788,531,-257
2019,9,11,20,796,808,539,-269
2019,9,11,21,810,805,518,-287
2019,9,11,22,814,798,621,-177
2019,9,11,23,783,765,613,-152
2019,9,12,0,755,733,445,-288
2019,9,12,1,738,716,448,-268
2019,9,12,2,690,662,253,-409
2019,9,12,3,618,606,197,-409
2019,9,12,4,559,548,151,-397
2019,9,12,5,519,497,119,-378
2019,9,12,6,486,455,69,-386
2019,9,12,7,466,436,69,-367
2019,9,12,8,455,426,67,-359
2019,9,12,9,455,426,66,-360
2019,9,12,10,478,455,68,-387
2019,9,12,11,541,513,88,-425
2019,9,12,12,569,539,249,-290
2019,9,12,13,581,559,261,-298
2019,9,12,14,609,586,260,-326
2019,9,12,15,643,536,186,-350
2019,9,12,16,677,755,484,-271
2019,9,12,17,715,697,472,-225
2019,9,12,18,750,761,522,-239
2019,9,12,19,781,795,657,-138
2019,9,12,20,800,814,681,-133
2019,9,12,21,816,819,687,-132
2019,9,12,22,820,813,709,-104
2019,9,12,23,790,806,691,-115
2019,9,13,0,763,763,537,-226
2019,9,13,1,749,750,546,-204
2019,9,13,2,698,695,497,-198
2019,9,13,3,634,628,361,-267
2019,9,13,4,575,571,239,-332
2019,9,13,5,512,516,121,-395
2019,9,13,6,476,478,68,-410
2019,9,13,7,446,449,65,-384
2019,9,13,8,432,442,65,-377
2019,9,13,9,433,441,62,-379
2019,9,13,10,455,463,64,-399
2019,9,13,11,519,514,80,-434
2019,9,13,12,550,542,113,-429
2019,9,13,13,566,557,113,-444
2019,9,13,14,611,582,132,-450
2019,9,13,15,631,617,173,-444
2019,9,13,16,658,675,320,-355
2019,9,13,17,688,718,353,-365
2019,9,13,18,709,759,350,-409
2019,9,13,19,726,773,352,-421
2019,9,13,20,736,784,352,-432
2019,9,13,21,746,753,356,-397
2019,9,13,22,751,721,419,-302
2019,9,13,23,717,703,413,-290
2019,9,14,0,683,688,251,-437
2019,9,14,1,673,652,195,-457
2019,9,14,2,622,619,184,-435
2019,9,14,3,581,575,164,-411
2019,9,14,4,521,530,162,-368
2019,9,14,5,479,491,163,-328
2019,9,14,6,451,465,162,-303
2019,9,14,7,433,445,173,-272
2019,9,14,8,428,436,135,-301
2019,9,14,9,421,432,63,-369
2019,9,14,10,427,436,68,-368
2019,9,14,11,446,455,70,-385
2019,9,14,12,466,476,74,-402
2019,9,14,13,497,512,78,-434
2019,9,14,14,539,543,84,-459
2019,9,14,15,572,577,129,-448
2019,9,14,16,601,597,146,-451
2019,9,14,17,630,634,267,-367
2019,9,14,18,646,658,307,-351
2019,9,14,19,665,689,285,-404
2019,9,14,20,664,685,332,-353
2019,9,14,21,680,649,346,-303
2019,9,14,22,672,627,345,-282
2019,9,14,23,660,614,346,-268
2019,9,15,0,637,599,213,-386
2019,9,15,1,621,588,188,-400
2019,9,15,2,581,562,193,-369
2019,9,15,3,531,522,193,-329
2019,9,15,4,490,496,154,-342
2019,9,15,5,479,451,72,-379
2019,9,15,6,439,415,58,-357
2019,9,15,7,416,405,73,-332
2019,9,15,8,406,391,71,-320
2019,9,15,9,395,393,76,-317
2019,9,15,10,395,394,85,-309
2019,9,15,11,415,413,93,-320
2019,9,15,12,442,442,89,-353
2019,9,15,13,493,478,97,-381
2019,9,15,14,536,509,116,-393
2019,9,15,15,558,528,156,-372
2019,9,15,16,589,550,181,-369
2019,9,15,17,625,588,280,-308
2019,9,15,18,663,637,316,-321
2019,9,15,19,686,672,353,-319
2019,9,15,20,700,701,357,-344
2019,9,15,21,716,722,404,-318
2019,9,15,22,726,744,529,-215
2019,9,15,23,710,723,529,-194
2019,9,16,0,704,686,524,-162
2019,9,16,1,691,662,414,-248
2019,9,16,2,627,607,367,-240
2019,9,16,3,569,569,359,-210
2019,9,16,4,503,510,243,-267
2019,9,16,5,448,459,154,-305
2019,9,16,6,422,421,122,-299
2019,9,16,7,405,407,119,-288
2019,9,16,8,396,396,118,-278
2019,9,16,9,403,403,118,-285
2019,9,16,10,432,428,116,-312
2019,9,16,11,492,486,115,-371
2019,9,16,12,519,512,116,-396
2019,9,16,13,537,533,115,-418
2019,9,16,14,568,544,128,-416
2019,9,16,15,585,578,166,-412
2019,9,16,16,617,585,223,-362
2019,9,16,17,650,640,315,-325
2019,9,16,18,685,686,336,-350
2019,9,16,19,716,709,335,-374
2019,9,16,20,741,745,402,-343
2019,9,16,21,755,760,430,-330
2019,9,16,22,763,776,509,-267
2019,9,16,23,739,763,515,-248
2019,9,17,0,712,731,468,-263
2019,9,17,1,696,702,450,-252
2019,9,17,2,644,642,448,-194
2019,9,17,3,590,575,432,-143
2019,9,17,4,528,549,345,-204
2019,9,17,5,468,485,169,-316
2019,9,17,6,440,443,118,-325
2019,9,17,7,422,427,118,-309
2019,9,17,8,412,419,116,-303
2019,9,17,9,415,425,114,-311
2019,9,17,10,439,452,112,-340
2019,9,17,11,501,481,158,-323
2019,9,17,12,528,522,302,-220
2019,9,17,13,542,544,320,-224
2019,9,17,14,570,570,322,-248
2019,9,17,15,589,607,324,-283
2019,9,17,16,620,640,323,-317
2019,9,17,17,655,683,369,-314
2019,9,17,18,694,731,385,-346
2019,9,17,19,731,762,382,-380
2019,9,17,20,759,785,376,-409
2019,9,17,21,775,798,398,-400
2019,9,17,22,775,806,427,-379
2019,9,17,23,750,780,463,-317
2019,9,18,0,720,749,467,-282
2019,9,18,1,705,727,372,-355
2019,9,18,2,651,677,331,-346
2019,9,18,3,593,616,332,-284
2019,9,18,4,539,578,278,-300
2019,9,18,5,481,522,161,-361
2019,9,18,6,450,480,113,-367
2019,9,18,7,432,466,117,-349
2019,9,18,8,420,457,118,-339
2019,9,18,9,423,457,117,-340
2019,9,18,10,446,482,116,-366
2019,9,18,11,509,546,115,-431
2019,9,18,12,535,569,155,-414
2019,9,18,13,544,584,158,-426
2019,9,18,14,579,581,171,-410
2019,9,18,15,589,593,246,-347
2019,9,18,16,614,605,266,-339
2019,9,18,17,632,606,253,-353
2019,9,18,18,646,598,265,-333
2019,9,18,19,656,602,326,-276
2019,9,18,20,663,613,334,-279
2019,9,18,21,672,607,336,-271
2019,9,18,22,668,604,397,-207
2019,9,18,23,649,608,401,-207
2019,9,19,0,636,606,348,-258
2019,9,19,1,631,604,334,-270
2019,9,19,2,582,581,325,-256
2019,9,19,3,526,551,193,-358
2019,9,19,4,480,474,118,-356
2019,9,19,5,434,444,125,-319
2019,9,19,6,409,420,114,-306
2019,9,19,7,396,410,119,-291
2019,9,19,8,392,409,123,-286
2019,9,19,9,397,409,118,-291
2019,9,19,10,422,442,119,-323
2019,9,19,11,485,501,143,-358
2019,9,19,12,509,515,282,-233
2019,9,19,13,516,521,282,-239
2019,9,19,14,526,531,283,-248
2019,9,19,15,536,534,282,-252
2019,9,19,16,547,538,285,-253
2019,9,19,17,557,539,284,-255
2019,9,19,18,562,541,283,-258
2019,9,19,19,561,538,282,-256
2019,9,19,20,569,536,268,-268
2019,9,19,21,575,531,138,-393
2019,9,19,22,579,544,206,-338
2019,9,19,23,574,553,217,-336
2019,9,20,0,575,569,198,-371
2019,9,20,1,573,571,180,-391
2019,9,20,2,529,549,181,-368
2019,9,20,3,479,499,179,-320
2019,9,20,4,432,455,181,-274
2019,9,20,5,404,433,164,-269
2019,9,20,6,386,402,116,-286
2019,9,20,7,377,387,129,-258
2019,9,20,8,371,389,132,-257
2019,9,20,9,374,395,129,-266
2019,9,20,10,405,421,127,-294
2019,9,20,11,465,471,128,-343
2019,9,20,12,496,500,146,-354
2019,9,20,13,505,511,154,-357
2019,9,20,14,516,518,151,-367
2019,9,20,15,521,531,154,-377
2019,9,20,16,530,542,155,-387
2019,9,20,17,538,553,156,-397
2019,9,20,18,543,569,186,-383
2019,9,20,19,544,593,200,-393
2019,9,20,20,544,603,211,-392
2019,9,20,21,555,619,307,-312
2019,9,20,22,561,638,388,-250
2019,9,20,23,552,625,395,-230
2019,9,21,0,552,606,336,-270
2019,9,21,1,550,591,336,-255
2019,9,21,2,515,558,325,-233
2019,9,21,3,479,541,295,-246
2019,9,21,4,434,488,159,-329
2019,9,21,5,401,436,122,-314
2019,9,21,6,382,408,124,-284
2019,9,21,7,367,395,124,-271
2019,9,21,8,360,384,124,-260
2019,9,21,9,358,386,119,-267
2019,9,21,10,368,393,117,-276
2019,9,21,11,390,412,115,-297
2019,9,21,12,416,433,133,-300
2019,9,21,13,450,468,153,-315
2019,9,21,14,479,493,152,-341
2019,9,21,15,498,512,153,-359
2019,9,21,16,509,538,155,-383
2019,9,21,17,524,545,184,-361
2019,9,21,18,541,584,265,-319
2019,9,21,19,556,587,316,-271
2019,9,21,20,580,611,370,-241
2019,9,21,21,591,640,419,-221
2019,9,21,22,608,651,447,-204
2019,9,21,23,607,636,471,-165
2019,9,22,0,580,613,422,-191
2019,9,22,1,572,596,422,-174
2019,9,22,2,537,568,394,-174
2019,9,22,3,494,544,248,-296
2019,9,22,4,456,478,128,-350
2019,9,22,5,418,431,119,-312
2019,9,22,6,387,402,118,-284
2019,9,22,7,375,389,125,-264
2019,9,22,8,366,380,130,-250
2019,9,22,9,362,375,133,-242
2019,9,22,10,366,380,121,-259
2019,9,22,11,385,396,123,-273
2019,9,22,12,407,421,124,-297
2019,9,22,13,444,460,123,-337
2019,9,22,14,471,484,131,-353
2019,9,22,15,490,503,137,-366
2019,9,22,16,506,525,146,-379
2019,9,22,17,528,552,170,-382
2019,9,22,18,555,570,183,-387
2019,9,22,19,583,576,236,-340
2019,9,22,20,611,620,325,-295
2019,9,22,21,631,640,356,-284
2019,9,22,22,653,662,449,-213
2019,9,22,23,642,648,435,-213
2019,9,23,0,626,628,385,-243
2019,9,23,1,606,610,386,-224
2019,9,23,2,561,563,382,-181
2019,9,23,3,517,538,248,-290
2019,9,23,4,468,457,154,-303
2019,9,23,5,422,422,146,-276
2019,9,23,6,398,396,124,-272
2019,9,23,7,382,384,124,-260
2019,9,23,8,374,364,107,-257
2019,9,23,9,378,367,102,-265
2019,9,23,10,408,410,117,-293
2019,9,23,11,465,458,135,-323
2019,9,23,12,490,465,214,-251
2019,9,23,13,505,536,286,-250
2019,9,23,14,523,525,254,-271
2019,9,23,15,539,553,257,-296
2019,9,23,16,560,577,258,-319
2019,9,23,17,583,581,290,-291
2019,9,23,18,606,623,348,-275
2019,9,23,19,631,651,353,-298
2019,9,23,20,657,676,354,-322
2019,9,23,21,677,696,388,-308
2019,9,23,22,695,706,417,-289
2019,9,23,23,685,692,417,-275
2019,9,24,0,670,691,368,-323
2019,9,24,1,651,670,350,-320
2019,9,24,2,602,626,351,-275
2019,9,24,3,544,585,292,-293
2019,9,24,4,490,531,203,-328
2019,9,24,5,441,473,131,-342
2019,9,24,6,414,440,122,-318
2019,9,24,7,401,428,127,-301
2019,9,24,8,391,419,126,-293
2019,9,24,9,392,422,129,-293
2019,9,24,10,418,445,124,-321
2019,9,24,11,476,495,165,-330
2019,9,24,12,505,522,234,-288
2019,9,24,13,520,547,258,-289
2019,9,24,14,534,571,257,-314
2019,9,24,15,545,591,257,-334
2019,9,24,16,563,607,271,-336
2019,9,24,17,587,622,337,-285
2019,9,24,18,606,654,354,-300
2019,9,24,19,624,673,359,-314
2019,9,24,20,638,690,354,-336
2019,9,24,21,658,702,357,-345
2019,9,24,22,669,706,418,-288
2019,9,24,23,658,689,423,-266
2019,9,25,0,645,667,382,-285
2019,9,25,1,631,643,355,-288
2019,9,25,2,585,600,346,-254
2019,9,25,3,531,557,254,-303
2019,9,25,4,480,478,140,-338
2019,9,25,5,437,427,130,-297
2019,9,25,6,408,396,131,-265
2019,9,25,7,393,392,127,-265
2019,9,25,8,386,390,129,-261
2019,9,25,9,392,396,127,-269
2019,9,25,10,419,423,125,-298
2019,9,25,11,476,481,130,-351
2019,9,25,12,504,510,139,-371
2019,9,25,13,508,515,140,-375
2019,9,25,14,517,511,197,-314
2019,9,25,15,529,549,260,-289
2019,9,25,16,547,561,259,-302
2019,9,25,17,571,582,258,-324
2019,9,25,18,592,596,291,-305
2019,9,25,19,617,638,353,-285
2019,9,25,20,640,670,355,-315
2019,9,25,21,663,698,360,-338
2019,9,25,22,666,709,422,-287
2019,9,25,23,660,697,421,-276
2019,9,26,0,648,675,377,-298
2019,9,26,1,631,654,354,-300
2019,9,26,2,588,610,349,-261
2019,9,26,3,531,570,255,-315
2019,9,26,4,478,487,146,-341
2019,9,26,5,442,446,132,-314
2019,9,26,6,412,417,129,-288
2019,9,26,7,398,403,129,-274
2019,9,26,8,389,402,126,-276
2019,9,26,9,394,405,126,-279
2019,9,26,10,425,436,128,-308
2019,9,26,11,482,495,126,-369
2019,9,26,12,509,523,129,-394
2019,9,26,13,522,524,133,-391
2019,9,26,14,531,550,165,-385
2019,9,26,15,545,561,179,-382
2019,9,26,16,570,583,295,-288
2019,9,26,17,598,619,352,-267
2019,9,26,18,627,651,352,-299
2019,9,26,19,661,672,354,-318
2019,9,26,20,693,689,353,-336
2019,9,26,21,710,709,358,-351
2019,9,26,22,721,726,422,-304
2019,9,26,23,708,708,420,-288
2019,9,27,0,695,705,346,-359
2019,9,27,1,676,690,309,-381
2019,9,27,2,623,638,261,-377
2019,9,27,3,568,582,251,-331
2019,9,27,4,518,539,201,-338
2019,9,27,5,473,485,144,-341
2019,9,27,6,442,452,141,-311
2019,9,27,7,423,434,129,-305
2019,9,27,8,412,421,127,-294
2019,9,27,9,415,426,129,-297
2019,9,27,10,439,453,127,-326
2019,9,27,11,492,503,129,-374
2019,9,27,12,521,534,167,-367
2019,9,27,13,538,548,171,-377
2019,9,27,14,562,568,172,-396
2019,9,27,15,591,581,215,-366
2019,9,27,16,622,612,289,-323
2019,9,27,17,645,654,349,-305
2019,9,27,18,667,697,359,-338
2019,9,27,19,686,721,364,-357
2019,9,27,20,704,739,398,-341
2019,9,27,21,714,749,362,-387
2019,9,27,22,716,738,421,-317
2019,9,27,23,692,712,411,-301
2019,9,28,0,683,689,356,-333
2019,9,28,1,659,666,357,-309
2019,9,28,2,609,625,357,-268
2019,9,28,3,566,578,359,-219
2019,9,28,4,524,548,308,-240
2019,9,28,5,476,502,168,-334
2019,9,28,6,443,459,125,-334
2019,9,28,7,423,442,123,-319
2019,9,28,8,416,428,122,-306
2019,9,28,9,411,428,123,-305
2019,9,28,10,415,434,123,-311
2019,9,28,11,435,455,123,-332
2019,9,28,12,460,482,121,-361
2019,9,28,13,492,517,120,-397
2019,9,28,14,532,552,150,-402
2019,9,28,15,565,590,163,-427
2019,9,28,16,602,613,163,-450
2019,9,28,17,638,645,165,-480
2019,9,28,18,668,677,178,-499
2019,9,28,19,684,666,184,-482
2019,9,28,20,699,643,166,-477
2019,9,28,21,711,649,185,-464
2019,9,28,22,732,652,230,-422
2019,9,28,23,699,638,220,-418
2019,9,29,0,676,625,223,-402
2019,9,29,1,650,621,214,-407
2019,9,29,2,602,590,151,-439
2019,9,29,3,558,541,132,-409
2019,9,29,4,512,491,129,-362
2019,9,29,5,480,452,129,-323
2019,9,29,6,436,427,130,-297
2019,9,29,7,416,410,131,-279
2019,9,29,8,403,402,131,-271
2019,9,29,9,396,401,122,-279
2019,9,29,10,395,409,124,-285
2019,9,29,11,415,426,142,-284
2019,9,29,12,443,447,143,-304
2019,9,29,13,481,484,142,-342
2019,9,29,14,525,518,154,-364
2019,9,29,15,557,544,172,-372
2019,9,29,16,596,567,235,-332
2019,9,29,17,634,629,325,-304
2019,9,29,18,670,679,347,-332
2019,9,29,19,690,705,355,-350
2019,9,29,20,705,733,362,-371
2019,9,29,21,726,748,367,-381
2019,9,29,22,746,744,414,-330
2019,9,29,23,728,718,431,-287
2019,9,30,0,713,707,376,-331
2019,9,30,1,682,680,347,-333
2019,9,30,2,625,629,347,-282
2019,9,30,3,582,572,344,-228
2019,9,30,4,527,518,344,-174
2019,9,30,5,455,496,307,-189
2019,9,30,6,426,459,164,-295
2019,9,30,7,408,427,121,-306
2019,9,30,8,398,419,121,-298
2019,9,30,9,403,422,120,-302
2019,9,30,10,433,449,121,-328
2019,9,30,11,493,495,173,-322
2019,9,30,12,518,538,250,-288
2019,9,30,13,543,554,257,-297
2019,9,30,14,557,581,260,-321
2019,9,30,15,589,616,262,-354
2019,9,30,16,616,641,256,-385
2019,9,30,17,649,691,290,-401
2019,9,30,18,673,722,339,-383
2019,9,30,19,692,744,376,-368
2019,9,30,20,710,723,378,-345
2019,9,30,21,720,714,385,-329
2019,9,30,22,727,705,411,-294
2019,9,30,23,712,689,407,-282
2019,10,1,0,705,686,382,-304
2019,10,1,1,681,666,350,-316
2019,10,1,2,628,615,349,-266
2019,10,1,3,572,563,351,-212
2019,10,1,4,518,534,232,-302
2019,10,1,5,460,465,129,-336
2019,10,1,6,429,435,124,-311
2019,10,1,7,415,422,123,-299
2019,10,1,8,407,415,119,-296
2019,10,1,9,412,421,120,-301
2019,10,1,10,437,441,118,-323
2019,10,1,11,498,498,145,-353
2019,10,1,12,530,502,267,-235
2019,10,1,13,546,533,365,-168
2019,10,1,14,560,561,376,-185
2019,10,1,15,580,582,367,-215
2019,10,1,16,607,609,346,-263
2019,10,1,17,637,650,345,-305
2019,10,1,18,665,695,343,-352
2019,10,1,19,678,726,343,-383
2019,10,1,20,700,737,364,-373
2019,10,1,21,705,755,372,-383
2019,10,1,22,705,752,431,-321
2019,10,1,23,698,736,440,-296
2019,10,2,0,688,721,440,-281
2019,10,2,1,665,696,361,-335
2019,10,2,2,617,644,343,-301
2019,10,2,3,565,587,337,-250
2019,10,2,4,513,553,272,-281
2019,10,2,5,463,476,118,-358
2019,10,2,6,433,445,116,-329
2019,10,2,7,417,431,118,-313
2019,10,2,8,406,422,118,-304
2019,10,2,9,411,426,117,-309
2019,10,2,10,438,452,117,-335
2019,10,2,11,498,507,147,-360
2019,10,2,12,528,540,198,-342
2019,10,2,13,546,555,201,-354
2019,10,2,14,559,574,202,-372
2019,10,2,15,590,601,221,-380
2019,10,2,16,610,638,253,-385
2019,10,2,17,646,684,295,-389
2019,10,2,18,676,729,366,-363
2019,10,2,19,695,764,510,-254
2019,10,2,20,720,786,515,-271
2019,10,2,21,728,789,516,-273
2019,10,2,22,730,788,548,-240
2019,10,2,23,714,760,582,-178
2019,10,3,0,706,736,552,-184
2019,10,3,1,680,717,350,-367
2019,10,3,2,631,657,350,-307
2019,10,3,3,571,608,345,-263
2019,10,3,4,518,554,202,-352
2019,10,3,5,467,485,127,-358
2019,10,3,6,434,454,123,-331
2019,10,3,7,415,435,119,-316
2019,10,3,8,406,424,117,-307
2019,10,3,9,410,418,115,-303
2019,10,3,10,435,452,119,-333
2019,10,3,11,497,499,117,-382
2019,10,3,12,528,528,161,-367
2019,10,3,13,550,542,166,-376
2019,10,3,14,562,566,169,-397
2019,10,3,15,585,585,186,-399
2019,10,3,16,612,606,257,-349
2019,10,3,17,637,671,418,-253
2019,10,3,18,670,715,513,-202
2019,10,3,19,698,752,513,-239
2019,10,3,20,723,778,513,-265
2019,10,3,21,734,783,589,-194
2019,10,3,22,748,776,719,-57
2019,10,3,23,740,753,721,-32
2019,10,4,0,733,731,675,-56
2019,10,4,1,706,705,474,-231
2019,10,4,2,654,665,372,-293
2019,10,4,3,593,595,213,-382
2019,10,4,4,538,530,154,-376
2019,10,4,5,463,473,119,-354
2019,10,4,6,431,446,116,-330
2019,10,4,7,415,426,115,-311
2019,10,4,8,404,415,116,-299
2019,10,4,9,402,416,116,-300
2019,10,4,10,422,437,116,-321
2019,10,4,11,460,486,120,-366
2019,10,4,12,496,521,139,-382
2019,10,4,13,522,531,142,-389
2019,10,4,14,539,538,165,-373
2019,10,4,15,563,556,254,-302
2019,10,4,16,599,606,332,-274
2019,10,4,17,630,641,353,-288
2019,10,4,18,667,682,356,-326
2019,10,4,19,688,702,356,-346
2019,10,4,20,709,729,357,-372
2019,10,4,21,716,743,362,-381
2019,10,4,22,707,730,416,-314
2019,10,4,23,684,696,424,-272
2019,10,5,0,650,667,374,-293
2019,10,5,1,620,638,358,-280
2019,10,5,2,591,596,357,-239
2019,10,5,3,554,581,264,-317
2019,10,5,4,497,496,161,-335
2019,10,5,5,407,449,151,-298
2019,10,5,6,384,419,146,-273
2019,10,5,7,372,405,147,-258
2019,10,5,8,366,395,146,-249
2019,10,5,9,372,395,146,-249
2019,10,5,10,401,408,148,-260
2019,10,5,11,468,426,144,-282
2019,10,5,12,496,451,146,-305
2019,10,5,13,505,479,146,-333
2019,10,5,14,511,502,148,-354
2019,10,5,15,522,505,137,-368
2019,10,5,16,536,518,148,-370
2019,10,5,17,540,514,148,-366
2019,10,5,18,548,510,150,-360
2019,10,5,19,547,505,148,-357
2019,10,5,20,555,502,148,-354
2019,10,5,21,560,501,146,-355
2019,10,5,22,559,509,149,-360
2019,10,5,23,558,513,143,-370
2019,10,6,0,557,523,143,-380
2019,10,6,1,555,507,143,-364
2019,10,6,2,521,493,135,-358
2019,10,6,3,471,456,124,-332
2019,10,6,4,419,418,123,-295
2019,10,6,5,386,392,126,-266
2019,10,6,6,366,371,122,-249
2019,10,6,7,353,361,125,-236
2019,10,6,8,347,362,128,-234
2019,10,6,9,345,359,128,-231
2019,10,6,10,354,363,126,-237
2019,10,6,11,370,383,127,-256
2019,10,6,12,401,416,130,-286
2019,10,6,13,446,448,126,-322
2019,10,6,14,462,472,129,-343
2019,10,6,15,464,481,128,-353
2019,10,6,16,469,485,129,-356
2019,10,6,17,483,492,126,-366
2019,10,6,18,485,482,136,-346
2019,10,6,19,483,482,246,-236
2019,10,6,20,496,491,335,-156
2019,10,6,21,514,512,357,-155
2019,10,6,22,536,523,401,-122
2019,10,6,23,538,527,419,-108
2019,10,7,0,547,546,408,-138
2019,10,7,1,538,539,357,-182
2019,10,7,2,498,499,350,-149
2019,10,7,3,462,470,357,-113
2019,10,7,4,414,439,356,-83
2019,10,7,5,392,423,239,-184
2019,10,7,6,368,390,146,-244
2019,10,7,7,358,377,126,-251
2019,10,7,8,358,375,127,-248
2019,10,7,9,365,383,128,-255
2019,10,7,10,395,413,127,-286
2019,10,7,11,450,467,136,-331
2019,10,7,12,489,503,207,-296
2019,10,7,13,508,520,228,-292
2019,10,7,14,511,550,211,-339
2019,10,7,15,521,554,173,-381
2019,10,7,16,534,549,216,-333
2019,10,7,17,552,560,294,-266
2019,10,7,18,564,573,304,-269
2019,10,7,19,576,574,336,-238
2019,10,7,20,589,579,353,-226
2019,10,7,21,605,579,359,-220
2019,10,7,22,612,585,424,-161
2019,10,7,23,612,591,419,-172
2019,10,8,0,618,608,373,-235
2019,10,8,1,599,589,354,-235
2019,10,8,2,560,556,356,-200
2019,10,8,3,506,516,349,-167
2019,10,8,4,462,492,215,-277
2019,10,8,5,414,426,122,-304
2019,10,8,6,390,410,119,-291
2019,10,8,7,379,396,118,-278
2019,10,8,8,377,392,119,-273
2019,10,8,9,381,397,119,-278
2019,10,8,10,408,426,118,-308
2019,10,8,11,472,475,138,-337
2019,10,8,12,508,513,225,-288
2019,10,8,13,520,531,254,-277
2019,10,8,14,528,546,256,-290
2019,10,8,15,527,550,257,-293
2019,10,8,16,534,557,256,-301
2019,10,8,17,536,563,257,-306
2019,10,8,18,533,568,256,-312
2019,10,8,19,529,564,258,-306
2019,10,8,20,528,546,281,-265
2019,10,8,21,534,561,315,-246
2019,10,8,22,548,559,397,-162
2019,10,8,23,553,573,504,-69
2019,10,9,0,569,587,405,-182
2019,10,9,1,551,577,340,-237
2019,10,9,2,519,545,295,-250
2019,10,9,3,479,511,193,-318
2019,10,9,4,439,454,130,-324
2019,10,9,5,399,421,85,-336
2019,10,9,6,384,401,66,-335
2019,10,9,7,378,387,64,-323
2019,10,9,8,370,383,63,-320
2019,10,9,9,374,394,66,-328
2019,10,9,10,393,421,64,-357
2019,10,9,11,464,478,71,-407
2019,10,9,12,497,514,87,-427
2019,10,9,13,502,529,88,-441
2019,10,9,14,504,535,80,-455
2019,10,9,15,505,538,79,-459
2019,10,9,16,509,541,83,-458
2019,10,9,17,520,543,86,-457
2019,10,9,18,523,541,86,-455
2019,10,9,19,525,545,88,-457
2019,10,9,20,525,557,99,-458
2019,10,9,21,536,569,171,-398
2019,10,9,22,551,572,195,-377
2019,10,9,23,558,573,222,-351
2019,10,10,0,575,588,226,-362
2019,10,10,1,556,583,184,-399
2019,10,10,2,520,552,90,-462
2019,10,10,3,477,492,68,-424
2019,10,10,4,443,445,67,-378
2019,10,10,5,411,419,68,-351
2019,10,10,6,390,393,65,-328
2019,10,10,7,381,391,68,-323
2019,10,10,8,380,383,67,-316
2019,10,10,9,387,389,67,-322
2019,10,10,10,417,419,67,-352
2019,10,10,11,482,481,68,-413
2019,10,10,12,518,514,67,-447
2019,10,10,13,525,528,68,-460
2019,10,10,14,525,533,69,-464
2019,10,10,15,522,538,69,-469
2019,10,10,16,523,540,70,-470
2019,10,10,17,526,543,70,-473
2019,10,10,18,533,558,70,-488
2019,10,10,19,536,562,68,-494
2019,10,10,20,538,569,68,-501
2019,10,10,21,548,569,87,-482
2019,10,10,22,559,577,213,-364
2019,10,10,23,559,581,225,-356
2019,10,11,0,577,593,227,-366
2019,10,11,1,566,578,202,-376
2019,10,11,2,529,548,161,-387
2019,10,11,3,481,513,118,-395
2019,10,11,4,439,450,66,-384
2019,10,11,5,423,418,64,-354
2019,10,11,6,405,400,62,-338
2019,10,11,7,395,389,64,-325
2019,10,11,8,392,382,63,-319
2019,10,11,9,401,388,61,-327
2019,10,11,10,432,418,61,-357
2019,10,11,11,501,476,62,-414
2019,10,11,12,545,509,62,-447
2019,10,11,13,555,519,64,-455
2019,10,11,14,561,526,64,-462
2019,10,11,15,561,529,66,-463
2019,10,11,16,567,530,65,-465
2019,10,11,17,573,530,68,-462
2019,10,11,18,582,539,67,-472
2019,10,11,19,583,546,67,-479
2019,10,11,20,588,557,67,-490
2019,10,11,21,600,564,82,-482
2019,10,11,22,604,558,135,-423
2019,10,11,23,604,557,175,-382
2019,10,12,0,610,565,156,-409
2019,10,12,1,589,547,93,-454
2019,10,12,2,555,518,74,-444
2019,10,12,3,522,480,70,-410
2019,10,12,4,470,444,73,-371
2019,10,12,5,425,407,71,-336
2019,10,12,6,401,388,66,-322
2019,10,12,7,386,377,63,-314
2019,10,12,8,377,372,65,-307
2019,10,12,9,380,375,65,-310
2019,10,12,10,387,383,63,-320
2019,10,12,11,414,405,64,-341
2019,10,12,12,444,437,67,-370
2019,10,12,13,483,462,57,-405
2019,10,12,14,505,496,69,-427
2019,10,12,15,513,508,69,-439
2019,10,12,16,528,518,129,-389
2019,10,12,17,532,528,134,-394
2019,10,12,18,543,542,134,-408
2019,10,12,19,551,536,135,-401
2019,10,12,20,564,535,135,-400
2019,10,12,21,580,535,136,-399
2019,10,12,22,585,530,135,-395
2019,10,12,23,565,519,94,-425
2019,10,13,0,564,538,90,-448
2019,10,13,1,552,518,68,-450
2019,10,13,2,520,492,66,-426
2019,10,13,3,487,460,67,-393
2019,10,13,4,442,419,62,-357
2019,10,13,5,397,390,63,-327
2019,10,13,6,372,369,62,-307
2019,10,13,7,361,363,65,-298
2019,10,13,8,361,358,62,-296
2019,10,13,9,360,358,64,-294
2019,10,13,10,371,369,64,-305
2019,10,13,11,396,389,66,-323
2019,10,13,12,430,422,64,-358
2019,10,13,13,469,456,62,-394
2019,10,13,14,490,488,67,-421
2019,10,13,15,494,493,64,-429
2019,10,13,16,493,489,64,-425
2019,10,13,17,495,498,66,-432
2019,10,13,18,492,497,65,-432
2019,10,13,19,491,475,85,-390
2019,10,13,20,488,495,160,-335
2019,10,13,21,500,506,165,-341
2019,10,13,22,512,522,205,-317
2019,10,13,23,522,530,230,-300
2019,10,14,0,555,550,231,-319
2019,10,14,1,539,536,231,-305
2019,10,14,2,498,496,181,-315
2019,10,14,3,463,461,164,-297
2019,10,14,4,422,431,97,-334
2019,10,14,5,402,395,68,-327
2019,10,14,6,383,376,67,-309
2019,10,14,7,378,375,69,-306
2019,10,14,8,379,374,70,-304
2019,10,14,9,391,385,69,-316
2019,10,14,10,423,420,64,-356
2019,10,14,11,489,484,64,-420
2019,10,14,12,533,514,91,-423
2019,10,14,13,543,547,154,-393
2019,10,14,14,547,562,107,-455
2019,10,14,15,548,548,71,-477
2019,10,14,16,543,542,71,-471
2019,10,14,17,551,556,71,-485
2019,10,14,18,556,623,70,-553
2019,10,14,19,554,515,112,-403
2019,10,14,20,555,531,158,-373
2019,10,14,21,563,545,163,-382
2019,10,14,22,576,546,273,-273
2019,10,14,23,586,563,384,-179
2019,10,15,0,603,583,387,-196
2019,10,15,1,583,566,345,-221
2019,10,15,2,545,543,297,-246
2019,10,15,3,498,487,94,-393
2019,10,15,4,456,444,68,-376
2019,10,15,5,401,417,68,-349
2019,10,15,6,382,402,66,-336
2019,10,15,7,377,401,68,-333
2019,10,15,8,377,399,69,-330
2019,10,15,9,385,414,68,-346
2019,10,15,10,417,450,67,-383
2019,10,15,11,480,517,86,-431
2019,10,15,12,521,561,118,-443
2019,10,15,13,528,577,97,-480
2019,10,15,14,531,575,75,-500
2019,10,15,15,525,548,63,-485
2019,10,15,16,523,545,68,-477
2019,10,15,17,529,534,66,-468
2019,10,15,18,529,533,70,-463
2019,10,15,19,528,520,73,-447
2019,10,15,20,528,518,148,-370
2019,10,15,21,531,534,164,-370
2019,10,15,22,543,541,169,-372
2019,10,15,23,553,564,224,-340
2019,10,16,0,572,583,236,-347
2019,10,16,1,555,568,188,-380
2019,10,16,2,520,537,170,-367
2019,10,16,3,481,503,127,-376
2019,10,16,4,444,450,76,-374
2019,10,16,5,415,414,67,-347
2019,10,16,6,397,401,66,-335
2019,10,16,7,391,391,67,-324
2019,10,16,8,390,388,68,-320
2019,10,16,9,395,399,67,-332
2019,10,16,10,426,429,66,-363
2019,10,16,11,492,470,100,-370
2019,10,16,12,527,525,165,-360
2019,10,16,13,533,535,163,-372
2019,10,16,14,536,543,163,-380
2019,10,16,15,534,545,165,-380
2019,10,16,16,532,550,168,-382
2019,10,16,17,524,534,168,-366
2019,10,16,18,518,535,166,-369
2019,10,16,19,515,531,168,-363
2019,10,16,20,513,520,144,-376
2019,10,16,21,521,520,154,-366
2019,10,16,22,534,536,164,-372
2019,10,16,23,542,555,224,-331
2019,10,17,0,563,581,234,-347
2019,10,17,1,556,574,188,-386
2019,10,17,2,531,561,146,-415
2019,10,17,3,497,517,98,-419
2019,10,17,4,461,468,88,-380
2019,10,17,5,440,446,86,-360
2019,10,17,6,425,439,88,-351
2019,10,17,7,425,439,88,-351
2019,10,17,8,432,443,87,-356
2019,10,17,9,452,466,88,-378
2019,10,17,10,487,506,86,-420
2019,10,17,11,564,571,116,-455
2019,10,17,12,610,630,169,-461
2019,10,17,13,623,649,161,-488
2019,10,17,14,616,633,97,-536
2019,10,17,15,598,606,73,-533
2019,10,17,16,586,585,72,-513
2019,10,17,17,556,562,71,-491
2019,10,17,18,548,554,74,-480
2019,10,17,19,529,539,72,-467
2019,10,17,20,517,536,72,-464
2019,10,17,21,524,526,86,-440
2019,10,17,22,546,550,131,-419
2019,10,17,23,571,568,209,-359
2019,10,18,0,606,610,237,-373
2019,10,18,1,603,608,179,-429
2019,10,18,2,583,583,169,-414
2019,10,18,3,546,567,133,-434
2019,10,18,4,514,499,61,-438
2019,10,18,5,481,484,69,-415
2019,10,18,6,462,479,70,-409
2019,10,18,7,459,478,72,-406
2019,10,18,8,467,486,69,-417
2019,10,18,9,485,500,65,-435
2019,10,18,10,536,548,61,-487
2019,10,18,11,620,609,111,-498
2019,10,18,12,678,664,266,-398
2019,10,18,13,678,675,265,-410
2019,10,18,14,668,659,188,-471
2019,10,18,15,630,613,95,-518
2019,10,18,16,596,577,75,-502
2019,10,18,17,574,550,75,-475
2019,10,18,18,548,534,75,-459
2019,10,18,19,528,517,71,-446
2019,10,18,20,522,515,74,-441
2019,10,18,21,523,518,71,-447
2019,10,18,22,539,521,76,-445
2019,10,18,23,558,535,75,-460
2019,10,19,0,581,553,73,-480
2019,10,19,1,570,549,73,-476
2019,10,19,2,545,532,70,-462
2019,10,19,3,510,500,62,-438
2019,10,19,4,471,477,67,-410
2019,10,19,5,439,449,66,-383
2019,10,19,6,425,441,62,-379
2019,10,19,7,421,438,61,-377
2019,10,19,8,421,437,59,-378
2019,10,19,9,432,448,61,-387
2019,10,19,10,444,468,60,-408
2019,10,19,11,478,500,62,-438
2019,10,19,12,514,530,68,-462
2019,10,19,13,555,561,105,-456
2019,10,19,14,581,579,158,-421
2019,10,19,15,588,572,171,-401
2019,10,19,16,581,567,156,-411
2019,10,19,17,558,547,139,-408
2019,10,19,18,542,540,136,-404
2019,10,19,19,522,537,136,-401
2019,10,19,20,507,538,136,-402
2019,10,19,21,512,551,135,-416
2019,10,19,22,524,561,144,-417
2019,10,19,23,556,588,171,-417
2019,10,20,0,583,588,171,-417
2019,10,20,1,560,573,171,-402
2019,10,20,2,531,557,165,-392
2019,10,20,3,504,520,89,-431
2019,10,20,4,468,467,59,-408
2019,10,20,5,437,445,65,-380
2019,10,20,6,415,425,65,-360
2019,10,20,7,409,415,65,-350
2019,10,20,8,409,411,61,-350
2019,10,20,9,405,408,61,-347
2019,10,20,10,412,419,60,-359
2019,10,20,11,437,446,61,-385
2019,10,20,12,476,479,90,-389
2019,10,20,13,515,517,89,-428
2019,10,20,14,538,533,94,-439
2019,10,20,15,522,523,116,-407
2019,10,20,16,506,512,131,-381
2019,10,20,17,498,500,127,-373
2019,10,20,18,485,497,129,-368
2019,10,20,19,478,486,128,-358
2019,10,20,20,478,487,128,-359
2019,10,20,21,487,496,129,-367
2019,10,20,22,503,509,127,-382
2019,10,20,23,520,520,126,-394
2019,10,21,0,548,531,172,-359
2019,10,21,1,535,537,197,-340
2019,10,21,2,499,511,120,-391
2019,10,21,3,464,465,101,-364
2019,10,21,4,429,428,97,-331
2019,10,21,5,398,402,67,-335
2019,10,21,6,380,390,66,-324
2019,10,21,7,376,381,65,-316
2019,10,21,8,376,380,65,-315
2019,10,21,9,387,387,64,-323
2019,10,21,10,417,422,63,-359
2019,10,21,11,483,480,69,-411
2019,10,21,12,524,518,167,-351
2019,10,21,13,536,532,170,-362
2019,10,21,14,542,553,130,-423
2019,10,21,15,541,556,108,-448
2019,10,21,16,543,558,111,-447
2019,10,21,17,541,550,111,-439
2019,10,21,18,538,546,109,-437
2019,10,21,19,529,536,107,-429
2019,10,21,20,527,537,109,-428
2019,10,21,21,535,548,109,-439
2019,10,21,22,550,548,169,-379
2019,10,21,23,570,573,223,-350
2019,10,22,0,593,590,230,-360
2019,10,22,1,570,586,196,-390
2019,10,22,2,537,542,140,-402
2019,10,22,3,490,492,112,-380
2019,10,22,4,450,448,75,-373
2019,10,22,5,421,419,67,-352
2019,10,22,6,400,403,61,-342
2019,10,22,7,394,398,58,-340
2019,10,22,8,392,395,55,-340
2019,10,22,9,399,402,55,-347
2019,10,22,10,426,429,60,-369
2019,10,22,11,490,491,75,-416
2019,10,22,12,529,528,100,-428
2019,10,22,13,536,534,121,-413
2019,10,22,14,541,552,131,-421
2019,10,22,15,539,555,131,-424
2019,10,22,16,536,557,128,-429
2019,10,22,17,534,540,128,-412
2019,10,22,18,519,533,146,-387
2019,10,22,19,508,526,187,-339
2019,10,22,20,504,531,230,-301
2019,10,22,21,510,534,294,-240
2019,10,22,22,522,540,338,-202
2019,10,22,23,542,558,348,-210
2019,10,23,0,562,586,350,-236
2019,10,23,1,560,569,299,-270
2019,10,23,2,534,557,260,-297
2019,10,23,3,505,518,167,-351
2019,10,23,4,465,468,117,-351
2019,10,23,5,429,444,111,-333
2019,10,23,6,419,432,109,-323
2019,10,23,7,420,434,105,-329
2019,10,23,8,425,435,97,-338
2019,10,23,9,446,452,100,-352
2019,10,23,10,487,490,101,-389
2019,10,23,11,573,562,155,-407
2019,10,23,12,611,611,210,-401
2019,10,23,13,620,628,220,-408
2019,10,23,14,610,626,168,-458
2019,10,23,15,587,599,121,-478
2019,10,23,16,573,577,112,-465
2019,10,23,17,548,559,116,-443
2019,10,23,18,536,538,114,-424
2019,10,23,19,516,530,116,-414
2019,10,23,20,506,544,88,-456
2019,10,23,21,513,539,66,-473
2019,10,23,22,531,551,109,-442
2019,10,23,23,558,575,122,-453
2019,10,24,0,595,589,147,-442
2019,10,24,1,590,605,198,-407
2019,10,24,2,561,589,95,-494
2019,10,24,3,522,540,51,-489
2019,10,24,4,483,507,52,-455
2019,10,24,5,484,487,51,-436
2019,10,24,6,469,486,51,-435
2019,10,24,7,471,488,53,-435
2019,10,24,8,480,496,56,-440
2019,10,24,9,506,519,57,-462
2019,10,24,10,546,565,61,-504
2019,10,24,11,624,642,214,-428
2019,10,24,12,670,697,418,-279
2019,10,24,13,669,710,430,-280
2019,10,24,14,653,683,410,-273
2019,10,24,15,620,637,274,-363
2019,10,24,16,589,605,91,-514
2019,10,24,17,562,568,64,-504
2019,10,24,18,543,545,64,-481
2019,10,24,19,523,533,59,-474
2019,10,24,20,517,528,58,-470
2019,10,24,21,523,533,57,-476
2019,10,24,22,539,529,81,-448
2019,10,24,23,564,554,169,-385
2019,10,25,0,591,595,254,-341
2019,10,25,1,585,587,235,-352
2019,10,25,2,554,561,185,-376
2019,10,25,3,519,544,158,-386
2019,10,25,4,481,489,71,-418
2019,10,25,5,443,450,51,-399
2019,10,25,6,430,452,59,-393
2019,10,25,7,429,450,60,-390
2019,10,25,8,434,454,59,-395
2019,10,25,9,452,471,60,-411
2019,10,25,10,487,490,75,-415
2019,10,25,11,552,558,185,-373
2019,10,25,12,596,603,253,-350
2019,10,25,13,618,604,203,-401
2019,10,25,14,614,605,188,-417
2019,10,25,15,599,608,178,-430
2019,10,25,16,584,609,97,-512
2019,10,25,17,565,576,62,-514
2019,10,25,18,549,558,57,-501
2019,10,25,19,536,549,59,-490
2019,10,25,20,536,546,59,-487
2019,10,25,21,543,558,59,-499
2019,10,25,22,549,546,162,-384
2019,10,25,23,574,578,242,-336
2019,10,26,0,610,575,252,-323
2019,10,26,1,580,561,215,-346
2019,10,26,2,558,534,193,-341
2019,10,26,3,530,526,149,-377
2019,10,26,4,496,469,66,-403
2019,10,26,5,464,423,49,-374
2019,10,26,6,442,413,59,-354
2019,10,26,7,437,399,57,-342
2019,10,26,8,438,397,61,-336
2019,10,26,9,443,397,58,-339
2019,10,26,10,459,410,58,-352
2019,10,26,11,483,438,61,-377
2019,10,26,12,523,470,59,-411
2019,10,26,13,557,501,59,-442
2019,10,26,14,584,532,59,-473
2019,10,26,15,574,546,61,-485
2019,10,26,16,562,543,91,-452
2019,10,26,17,545,535,87,-448
2019,10,26,18,531,523,113,-410
2019,10,26,19,505,530,142,-388
2019,10,26,20,500,523,159,-364
2019,10,26,21,508,520,180,-340
2019,10,26,22,537,526,240,-286
2019,10,26,23,549,543,259,-284
2019,10,27,0,578,542,254,-288
2019,10,27,1,576,526,255,-271
2019,10,27,2,551,503,256,-247
2019,10,27,3,535,485,254,-231
2019,10,27,4,510,460,170,-290
2019,10,27,5,414,411,102,-309
2019,10,27,6,388,396,94,-302
2019,10,27,7,380,380,94,-286
2019,10,27,8,372,378,94,-284
2019,10,27,9,373,372,93,-279
2019,10,27,10,376,381,94,-287
2019,10,27,11,404,402,95,-307
2019,10,27,12,432,431,94,-337
2019,10,27,13,460,473,96,-377
2019,10,27,14,478,497,126,-371
2019,10,27,15,496,498,127,-371
2019,10,27,16,504,494,126,-368
2019,10,27,17,505,492,132,-360
2019,10,27,18,515,469,221,-248
2019,10,27,19,511,495,339,-156
2019,10,27,20,513,496,336,-160
2019,10,27,21,527,504,338,-166
2019,10,27,22,536,517,398,-119
2019,10,27,23,546,528,397,-131
2019,10,28,0,560,546,392,-154
2019,10,28,1,537,533,420,-113
2019,10,28,2,495,505,381,-124
2019,10,28,3,465,488,274,-214
2019,10,28,4,427,410,133,-277
2019,10,28,5,392,397,135,-262
2019,10,28,6,374,392,144,-248
2019,10,28,7,371,382,123,-259
2019,10,28,8,371,387,113,-274
2019,10,28,9,385,404,115,-289
2019,10,28,10,416,440,115,-325
2019,10,28,11,483,505,114,-391
2019,10,28,12,526,538,122,-416
2019,10,28,13,537,561,154,-407
2019,10,28,14,548,574,135,-439
2019,10,28,15,541,558,106,-452
2019,10,28,16,537,544,104,-440
2019,10,28,17,532,539,104,-435
2019,10,28,18,531,533,117,-416
2019,10,28,19,522,526,115,-411
2019,10,28,20,522,525,151,-374
2019,10,28,21,528,544,214,-330
2019,10,28,22,542,551,208,-343
2019,10,28,23,567,565,208,-357
2019,10,29,0,589,587,213,-374
2019,10,29,1,564,556,239,-317
2019,10,29,2,532,530,272,-258
2019,10,29,3,493,501,235,-266
2019,10,29,4,453,437,168,-269
2019,10,29,5,417,427,158,-269
2019,10,29,6,397,404,119,-285
2019,10,29,7,392,403,115,-288
2019,10,29,8,391,402,108,-294
2019,10,29,9,404,415,108,-307
2019,10,29,10,437,443,108,-335
2019,10,29,11,499,511,154,-357
2019,10,29,12,544,554,205,-349
2019,10,29,13,549,566,215,-351
2019,10,29,14,551,574,198,-376
2019,10,29,15,542,562,199,-363
2019,10,29,16,537,548,199,-349
2019,10,29,17,534,541,208,-333
2019,10,29,18,529,540,245,-295
2019,10,29,19,521,529,295,-234
2019,10,29,20,522,541,369,-172
2019,10,29,21,529,542,366,-176
2019,10,29,22,544,553,366,-187
2019,10,29,23,569,569,367,-202
2019,10,30,0,589,593,382,-211
2019,10,30,1,564,583,373,-210
2019,10,30,2,532,547,317,-230
2019,10,30,3,492,502,253,-249
2019,10,30,4,454,441,233,-208
2019,10,30,5,421,421,210,-211
2019,10,30,6,402,399,202,-197
2019,10,30,7,397,396,208,-188
2019,10,30,8,393,395,208,-187
2019,10,30,9,402,393,213,-180
2019,10,30,10,433,436,289,-147
2019,10,30,11,498,588,309,-279
2019,10,30,12,538,535,250,-285
2019,10,30,13,542,539,251,-288
2019,10,30,14,545,549,251,-298
2019,10,30,15,542,555,241,-314
2019,10,30,16,544,563,221,-342
2019,10,30,17,538,562,231,-331
2019,10,30,18,532,556,304,-252
2019,10,30,19,523,558,342,-216
2019,10,30,20,518,554,340,-214
2019,10,30,21,532,564,340,-224
2019,10,30,22,554,580,341,-239
2019,10,30,23,576,592,341,-251
2019,10,31,0,586,591,362,-229
2019,10,31,1,567,570,370,-200
2019,10,31,2,540,542,371,-171
2019,10,31,3,496,503,370,-133
2019,10,31,4,453,473,315,-158
2019,10,31,5,429,436,254,-182
2019,10,31,6,405,411,244,-167
2019,10,31,7,397,405,246,-159
2019,10,31,8,396,402,245,-157
2019,10,31,9,403,402,253,-149
2019,10,31,10,433,428,312,-116
2019,10,31,11,501,497,358,-139
2019,10,31,12,539,532,364,-168
2019,10,31,13,539,548,361,-187
2019,10,31,14,557,554,363,-191
2019,10,31,15,550,574,412,-162
2019,10,31,16,548,575,423,-152
2019,10,31,17,544,565,484,-81
2019,10,31,18,536,573,553,-20
2019,10,31,19,528,560,602,42
2019,10,31,20,532,567,599,32
2019,10,31,21,533,560,585,25
2019,10,31,22,539,532,592,60
2019,10,31,23,524,544,578,34
2019,11,1,0,526,559,532,-27
2019,11,1,1,530,568,532,-36
2019,11,1,2,510,566,503,-63
2019,11,1,3,480,555,450,-105
2019,11,1,4,435,531,371,-160
2019,11,1,5,475,530,328,-202
2019,11,1,6,461,523,264,-259
2019,11,1,7,461,533,247,-286
2019,11,1,8,469,542,245,-297
2019,11,1,9,488,566,266,-300
2019,11,1,10,530,705,364,-341
2019,11,1,11,610,690,365,-325
2019,11,1,12,656,731,421,-310
2019,11,1,13,676,751,433,-318
2019,11,1,14,668,668,382,-286
2019,11,1,15,636,689,325,-364
2019,11,1,16,615,663,339,-324
2019,11,1,17,588,622,393,-229
2019,11,1,18,563,659,404,-255
2019,11,1,19,542,592,330,-262
2019,11,1,20,528,549,303,-246
2019,11,1,21,540,552,300,-252
2019,11,1,22,555,562,366,-196
2019,11,1,23,581,609,411,-198
2019,11,2,0,610,598,382,-216
2019,11,2,1,606,576,409,-167
2019,11,2,2,579,636,467,-169
2019,11,2,3,566,631,402,-229
2019,11,2,4,532,593,333,-260
2019,11,2,5,534,573,242,-331
2019,11,2,6,534,569,241,-328
2019,11,2,7,535,575,244,-331
2019,11,2,8,540,581,242,-339
2019,11,2,9,548,588,284,-304
2019,11,2,10,579,612,296,-316
2019,11,2,11,620,653,410,-243
2019,11,2,12,661,709,431,-278
2019,11,2,13,690,732,424,-308
2019,11,2,14,684,732,420,-312
2019,11,2,15,657,697,479,-218
2019,11,2,16,626,661,426,-235
2019,11,2,17,580,592,320,-272
2019,11,2,18,550,558,270,-288
2019,11,2,19,518,555,240,-315
2019,11,2,20,510,536,258,-278
2019,11,2,21,511,534,303,-231
2019,11,2,22,522,559,348,-211
2019,11,2,23,559,588,347,-241
2019,11,3,0,589,611,473,-138
2019,11,3,1,605,629,505,-124
2019,11,3,2,585,622,431,-191
2019,11,3,3,571,602,398,-204
2019,11,3,4,550,574,355,-219
2019,11,3,5,561,559,306,-253
2019,11,3,6,538,544,295,-249
2019,11,3,7,541,568,297,-271
2019,11,3,8,557,570,285,-285
2019,11,3,9,572,580,286,-294
2019,11,3,10,599,591,326,-265
2019,11,3,11,641,625,449,-176
2019,11,3,12,693,673,503,-170
2019,11,3,13,711,718,519,-199
2019,11,3,14,705,727,522,-205
2019,11,3,15,658,695,394,-301
2019,11,3,16,620,628,285,-343
2019,11,3,17,593,584,216,-368
2019,11,3,18,562,560,210,-350
2019,11,3,19,552,554,235,-319
2019,11,3,20,549,532,275,-257
2019,11,3,21,562,521,289,-232
2019,11,3,22,599,542,318,-224
2019,11,3,23,639,585,333,-252
2019,11,4,0,645,617,396,-221
2019,11,4,1,633,635,372,-263
2019,11,4,2,602,628,284,-344
2019,11,4,3,578,602,276,-326
2019,11,4,4,539,580,279,-301
2019,11,4,5,-9999,563,278,-285
2019,11,4,6,580,557,277,-280
2019,11,4,7,584,556,275,-281
2019,11,4,8,591,566,276,-290
2019,11,4,9,603,579,278,-301
2019,11,4,10,633,599,365,-234
2019,11,4,11,691,678,455,-223
2019,11,4,12,768,722,486,-236
2019,11,4,13,794,765,570,-195
2019,11,4,14,791,736,479,-257
2019,11,4,15,748,689,306,-383
2019,11,4,16,708,649,284,-365
2019,11,4,17,657,623,290,-333
2019,11,4,18,622,567,347,-220
2019,11,4,19,596,547,226,-321
2019,11,4,20,575,551,202,-349
2019,11,4,21,572,535,198,-337
2019,11,4,22,600,530,213,-317
2019,11,4,23,639,495,313,-182
2019,11,5,0,681,505,293,-212
2019,11,5,1,684,499,276,-223
2019,11,5,2,674,478,273,-205
2019,11,5,3,646,447,267,-180
2019,11,5,4,610,429,267,-162
2019,11,5,5,577,483,301,-182
2019,11,5,6,540,522,306,-216
2019,11,5,7,528,514,282,-232
2019,11,5,8,530,520,285,-235
2019,11,5,9,534,527,283,-244
2019,11,5,10,553,553,317,-236
2019,11,5,11,593,603,361,-242
2019,11,5,12,662,670,335,-335
2019,11,5,13,695,714,381,-333
2019,11,5,14,676,674,366,-308
2019,11,5,15,653,663,400,-263
2019,11,5,16,619,586,484,-102
2019,11,5,17,595,563,491,-72
2019,11,5,18,570,529,435,-94
2019,11,5,19,560,526,309,-217
2019,11,5,20,546,525,346,-179
2019,11,5,21,547,515,346,-169
2019,11,5,22,559,588,332,-256
2019,11,5,23,595,552,401,-151
2019,11,6,0,632,606,519,-87
2019,11,6,1,634,610,538,-72
2019,11,6,2,620,587,532,-55
2019,11,6,3,599,563,472,-91
2019,11,6,4,566,526,337,-189
2019,11,6,5,534,491,314,-177
2019,11,6,6,519,470,286,-184
2019,11,6,7,515,468,254,-214
2019,11,6,8,515,479,250,-229
2019,11,6,9,521,489,249,-240
2019,11,6,10,539,508,321,-187
2019,11,6,11,574,561,444,-117
2019,11,6,12,632,650,434,-216
2019,11,6,13,657,678,356,-322
2019,11,6,14,660,660,337,-323
2019,11,6,15,642,583,353,-230
2019,11,6,16,618,525,339,-186
2019,11,6,17,597,491,321,-170
2019,11,6,18,576,447,298,-149
2019,11,6,19,569,479,346,-133
2019,11,6,20,557,472,347,-125
2019,11,6,21,557,468,346,-122
2019,11,6,22,567,482,345,-137
2019,11,6,23,601,468,383,-85
2019,11,7,0,620,445,358,-87
2019,11,7,1,618,444,362,-82
2019,11,7,2,611,420,361,-59
2019,11,7,3,592,429,345,-84
2019,11,7,4,569,467,343,-124
2019,11,7,5,546,445,318,-127
2019,11,7,6,531,479,328,-151
2019,11,7,7,528,471,323,-148
2019,11,7,8,530,483,328,-155
2019,11,7,9,532,486,326,-160
2019,11,7,10,546,500,325,-175
2019,11,7,11,577,535,419,-116
2019,11,7,12,628,615,569,-46
2019,11,7,13,652,650,513,-137
2019,11,7,14,649,626,353,-273
2019,11,7,15,638,610,330,-280
2019,11,7,16,617,588,345,-243
2019,11,7,17,607,566,431,-135
2019,11,7,18,592,558,425,-133
2019,11,7,19,585,552,417,-135
2019,11,7,20,575,550,436,-114
2019,11,7,21,578,555,462,-93
2019,11,7,22,587,575,513,-62
2019,11,7,23,617,605,583,-22
2019,11,8,0,635,625,585,-40
2019,11,8,1,634,612,583,-29
2019,11,8,2,622,595,586,-9
2019,11,8,3,599,563,552,-11
2019,11,8,4,570,522,466,-56
2019,11,8,5,549,495,362,-133
2019,11,8,6,535,467,280,-187
2019,11,8,7,533,465,281,-184
2019,11,8,8,553,462,278,-184
2019,11,8,9,564,477,280,-197
2019,11,8,10,597,492,326,-166
2019,11,8,11,636,551,505,-46
2019,11,8,12,710,652,539,-113
2019,11,8,13,756,695,605,-90
2019,11,8,14,758,714,604,-110
2019,11,8,15,744,688,533,-155
2019,11,8,16,711,664,537,-127
2019,11,8,17,671,633,532,-101
2019,11,8,18,653,609,534,-75
2019,11,8,19,626,600,521,-79
2019,11,8,20,611,585,474,-111
2019,11,8,21,613,591,474,-117
2019,11,8,22,641,616,488,-128
2019,11,8,23,686,667,600,-67
2019,11,9,0,725,718,667,-51
2019,11,9,1,738,741,710,-31
2019,11,9,2,729,708,687,-21
2019,11,9,3,720,719,707,-12
2019,11,9,4,699,696,686,-10
2019,11,9,5,666,678,593,-85
2019,11,9,6,635,669,530,-139
2019,11,9,7,635,667,553,-114
2019,11,9,8,647,669,563,-106
2019,11,9,9,647,664,583,-81
2019,11,9,10,675,688,637,-51
2019,11,9,11,691,720,707,-13
2019,11,9,12,724,758,734,-24
2019,11,9,13,795,797,781,-16
2019,11,9,14,788,796,744,-52
2019,11,9,15,737,761,698,-63
2019,11,9,16,680,715,689,-26
2019,11,9,17,663,663,580,-83
2019,11,9,18,611,612,541,-71
2019,11,9,19,575,578,527,-51
2019,11,9,20,559,559,520,-39
2019,11,9,21,570,556,517,-39
2019,11,9,22,590,576,538,-38
2019,11,9,23,647,622,566,-56
2019,11,10,0,674,650,591,-59
2019,11,10,1,681,648,629,-19
2019,11,10,2,684,652,641,-11
2019,11,10,3,669,662,653,-9
2019,11,10,4,654,636,625,-11
2019,11,10,5,627,623,612,-11
2019,11,10,6,592,606,530,-76
2019,11,10,7,594,591,466,-125
2019,11,10,8,605,611,491,-120
2019,11,10,9,618,617,475,-142
2019,11,10,10,627,635,478,-157
2019,11,10,11,657,652,495,-157
2019,11,10,12,691,676,539,-137
2019,11,10,13,738,719,546,-173
2019,11,10,14,752,724,534,-190
2019,11,10,15,710,679,390,-289
2019,11,10,16,648,629,300,-329
2019,11,10,17,595,564,250,-314
2019,11,10,18,569,531,253,-278
2019,11,10,19,547,511,254,-257
2019,11,10,20,524,498,161,-337
2019,11,10,21,524,498,137,-361
2019,11,10,22,542,511,177,-334
2019,11,10,23,591,547,271,-276
2019,11,11,0,623,578,327,-251
2019,11,11,1,628,580,333,-247
2019,11,11,2,612,565,317,-248
2019,11,11,3,584,549,280,-269
2019,11,11,4,557,534,230,-304
2019,11,11,5,502,499,140,-359
2019,11,11,6,485,500,123,-377
2019,11,11,7,482,496,109,-387
2019,11,11,8,485,502,107,-395
2019,11,11,9,492,510,122,-388
2019,11,11,10,513,543,250,-293
2019,11,11,11,551,580,320,-260
2019,11,11,12,616,651,415,-236
2019,11,11,13,652,690,417,-273
2019,11,11,14,669,696,395,-301
2019,11,11,15,642,658,261,-397
2019,11,11,16,627,615,263,-352
2019,11,11,17,604,596,239,-357
2019,11,11,18,586,564,158,-406
2019,11,11,19,564,549,149,-400
2019,11,11,20,552,536,148,-388
2019,11,11,21,551,528,187,-341
2019,11,11,22,565,550,257,-293
2019,11,11,23,601,590,261,-329
2019,11,12,0,633,616,261,-355
2019,11,12,1,629,615,216,-399
2019,11,12,2,613,583,217,-366
2019,11,12,3,580,563,193,-370
2019,11,12,4,544,517,108,-409
2019,11,12,5,511,487,80,-407
2019,11,12,6,485,455,59,-396
2019,11,12,7,480,445,57,-388
2019,11,12,8,483,439,58,-381
2019,11,12,9,496,442,58,-384
2019,11,12,10,526,458,59,-399
2019,11,12,11,576,513,60,-453
2019,11,12,12,661,588,214,-374
2019,11,12,13,689,663,328,-335
2019,11,12,14,698,733,414,-319
2019,11,12,15,702,755,517,-238
2019,11,12,16,715,770,555,-215
2019,11,12,17,737,771,542,-229
2019,11,12,18,746,767,472,-295
2019,11,12,19,740,777,373,-404
2019,11,12,20,739,783,362,-421
2019,11,12,21,765,798,366,-432
2019,11,12,22,799,825,386,-439
2019,11,12,23,851,883,462,-421
2019,11,13,0,893,916,455,-461
2019,11,13,1,914,910,616,-294
2019,11,13,2,895,897,628,-269
2019,11,13,3,866,870,575,-295
2019,11,13,4,851,835,553,-282
2019,11,13,5,843,812,556,-256
2019,11,13,6,832,793,552,-241
2019,11,13,7,826,812,556,-256
2019,11,13,8,857,823,557,-266
2019,11,13,9,862,830,556,-274
2019,11,13,10,903,860,557,-303
2019,11,13,11,940,920,567,-353
2019,11,13,12,995,962,626,-336
2019,11,13,13,1026,986,627,-359
2019,11,13,14,995,968,631,-337
2019,11,13,15,933,911,632,-279
2019,11,13,16,857,820,587,-233
2019,11,13,17,764,773,407,-366
2019,11,13,18,729,718,397,-321
2019,11,13,19,699,704,391,-313
2019,11,13,20,678,635,316,-319
2019,11,13,21,671,654,341,-313
2019,11,13,22,706,689,350,-339
2019,11,13,23,774,758,365,-393
2019,11,14,0,825,805,432,-373
2019,11,14,1,830,813,464,-349
2019,11,14,2,823,819,515,-304
2019,11,14,3,797,793,543,-250
2019,11,14,4,759,764,497,-267
2019,11,14,5,738,740,502,-238
2019,11,14,6,718,721,521,-200
2019,11,14,7,721,720,525,-195
2019,11,14,8,727,722,523,-199
2019,11,14,9,739,731,521,-210
2019,11,14,10,761,756,549,-207
2019,11,14,11,801,802,585,-217
2019,11,14,12,873,862,590,-272
2019,11,14,13,904,877,662,-215
2019,11,14,14,875,866,693,-173
2019,11,14,15,831,840,668,-172
2019,11,14,16,775,810,570,-240
2019,11,14,17,710,785,543,-242
2019,11,14,18,671,739,500,-239
2019,11,14,19,646,685,485,-200
2019,11,14,20,632,643,460,-183
2019,11,14,21,643,635,477,-158
2019,11,14,22,658,696,518,-178
2019,11,14,23,711,734,515,-219
2019,11,15,0,745,755,513,-242
2019,11,15,1,749,813,465,-348
2019,11,15,2,736,745,306,-439
2019,11,15,3,705,701,368,-333
2019,11,15,4,666,662,342,-320
2019,11,15,5,625,619,270,-349
2019,11,15,6,599,586,256,-330
2019,11,15,7,590,575,256,-319
2019,11,15,8,585,573,247,-326
2019,11,15,9,585,582,251,-331
2019,11,15,10,604,596,311,-285
2019,11,15,11,633,630,381,-249
2019,11,15,12,713,717,468,-249
2019,11,15,13,745,751,472,-279
2019,11,15,14,749,745,447,-298
2019,11,15,15,739,719,429,-290
2019,11,15,16,717,678,440,-238
2019,11,15,17,678,653,384,-269
2019,11,15,18,641,622,378,-244
2019,11,15,19,631,582,375,-207
2019,11,15,20,607,576,380,-196
2019,11,15,21,611,572,377,-195
2019,11,15,22,634,594,476,-118
2019,11,15,23,660,641,544,-97
2019,11,16,0,694,661,549,-112
2019,11,16,1,704,653,554,-99
2019,11,16,2,696,651,551,-100
2019,11,16,3,675,631,490,-141
2019,11,16,4,650,608,486,-122
2019,11,16,5,602,576,467,-109
2019,11,16,6,590,557,469,-88
2019,11,16,7,586,548,471,-77
2019,11,16,8,584,548,469,-79
2019,11,16,9,588,555,470,-85
2019,11,16,10,594,571,483,-88
2019,11,16,11,625,603,421,-182
2019,11,16,12,663,649,544,-105
2019,11,16,13,683,690,610,-80
2019,11,16,14,705,709,615,-94
2019,11,16,15,688,701,609,-92
2019,11,16,16,651,646,555,-91
2019,11,16,17,610,613,361,-252
2019,11,16,18,577,572,269,-303
2019,11,16,19,552,532,231,-301
2019,11,16,20,548,512,320,-192
2019,11,16,21,549,520,404,-116
2019,11,16,22,563,532,394,-138
2019,11,16,23,619,575,475,-100
2019,11,17,0,648,612,539,-73
2019,11,17,1,654,610,541,-69
2019,11,17,2,657,607,546,-61
2019,11,17,3,646,599,543,-56
2019,11,17,4,631,583,494,-89
2019,11,17,5,618,565,475,-90
2019,11,17,6,573,548,470,-78
2019,11,17,7,569,552,363,-189
2019,11,17,8,579,541,339,-202
2019,11,17,9,582,551,382,-169
2019,11,17,10,592,559,374,-185
2019,11,17,11,615,578,373,-205
2019,11,17,12,653,606,382,-224
2019,11,17,13,696,642,413,-229
2019,11,17,14,715,667,477,-190
2019,11,17,15,695,640,465,-175
2019,11,17,16,649,597,390,-207
2019,11,17,17,599,558,328,-230
2019,11,17,18,583,534,321,-213
2019,11,17,19,564,517,321,-196
2019,11,17,20,561,505,321,-184
2019,11,17,21,560,502,330,-172
2019,11,17,22,584,518,358,-160
2019,11,17,23,650,570,401,-169
2019,11,18,0,683,594,405,-189
2019,11,18,1,681,594,410,-184
2019,11,18,2,675,584,408,-176
2019,11,18,3,651,557,328,-229
2019,11,18,4,618,520,281,-239
2019,11,18,5,572,491,235,-256
2019,11,18,6,487,487,246,-241
2019,11,18,7,472,485,260,-225
2019,11,18,8,471,477,342,-135
2019,11,18,9,480,475,373,-102
2019,11,18,10,498,496,443,-53
2019,11,18,11,539,554,504,-50
2019,11,18,12,638,626,546,-80
2019,11,18,13,676,659,563,-96
2019,11,18,14,688,654,498,-156
2019,11,18,15,684,643,444,-199
2019,11,18,16,681,627,453,-174
2019,11,18,17,661,603,582,-21
2019,11,18,18,645,575,500,-75
2019,11,18,19,630,557,492,-65
2019,11,18,20,611,548,454,-94
2019,11,18,21,606,536,420,-116
2019,11,18,22,621,565,456,-109
2019,11,18,23,676,615,465,-150
2019,11,19,0,729,655,419,-236
2019,11,19,1,738,662,498,-164
2019,11,19,2,721,653,517,-136
2019,11,19,3,683,632,480,-152
2019,11,19,4,631,612,384,-228
2019,11,19,5,582,577,310,-267
2019,11,19,6,537,558,294,-264
2019,11,19,7,530,550,245,-305
2019,11,19,8,534,543,213,-330
2019,11,19,9,542,547,235,-312
2019,11,19,10,561,565,231,-334
2019,11,19,11,593,608,268,-340
2019,11,19,12,677,689,383,-306
2019,11,19,13,707,709,359,-350
2019,11,19,14,703,699,337,-362
2019,11,19,15,690,627,292,-335
2019,11,19,16,660,566,301,-265
2019,11,19,17,619,598,305,-293
2019,11,19,18,590,574,249,-325
2019,11,19,19,578,580,200,-380
2019,11,19,20,563,562,197,-365
2019,11,19,21,564,560,299,-261
2019,11,19,22,590,591,396,-195
2019,11,19,23,635,645,561,-84
2019,11,20,0,677,662,624,-38
2019,11,20,1,687,660,513,-147
2019,11,20,2,682,656,490,-166
2019,11,20,3,652,619,473,-146
2019,11,20,4,611,574,480,-94
2019,11,20,5,575,536,416,-120
2019,11,20,6,549,524,355,-169
2019,11,20,7,541,514,321,-193
2019,11,20,8,544,514,321,-193
2019,11,20,9,553,518,323,-195
2019,11,20,10,571,527,414,-113
2019,11,20,11,600,575,443,-132
2019,11,20,12,678,655,505,-150
2019,11,20,13,711,676,468,-208
2019,11,20,14,702,680,517,-163
2019,11,20,15,682,658,364,-294
2019,11,20,16,643,659,443,-216
2019,11,20,17,612,632,463,-169
2019,11,20,18,586,599,487,-112
2019,11,20,19,577,590,520,-70
2019,11,20,20,560,570,485,-85
2019,11,20,21,560,570,481,-89
2019,11,20,22,584,592,539,-53
2019,11,20,23,628,645,631,-14
2019,11,21,0,655,697,616,-81
2019,11,21,1,658,681,640,-41
2019,11,21,2,652,680,615,-65
2019,11,21,3,627,670,537,-133
2019,11,21,4,589,624,508,-116
2019,11,21,5,549,599,515,-84
2019,11,21,6,527,579,476,-103
2019,11,21,7,521,538,435,-103
2019,11,21,8,528,569,440,-129
2019,11,21,9,540,576,441,-135
2019,11,21,10,572,604,439,-165
2019,11,21,11,612,659,446,-213
2019,11,21,12,695,745,532,-213
2019,11,21,13,718,773,678,-95
2019,11,21,14,685,770,520,-250
2019,11,21,15,649,699,308,-391
2019,11,21,16,624,645,273,-372
2019,11,21,17,596,615,249,-366
2019,11,21,18,570,576,227,-349
2019,11,21,19,562,566,200,-366
2019,11,21,20,544,555,195,-360
2019,11,21,21,546,570,317,-253
2019,11,21,22,558,567,419,-148
2019,11,21,23,601,611,480,-131
2019,11,22,0,628,627,481,-146
2019,11,22,1,629,626,482,-144
2019,11,22,2,613,610,479,-131
2019,11,22,3,582,585,451,-134
2019,11,22,4,543,549,418,-131
2019,11,22,5,507,515,347,-168
2019,11,22,6,479,516,310,-206
2019,11,22,7,462,490,255,-235
2019,11,22,8,456,489,255,-234
2019,11,22,9,462,496,255,-241
2019,11,22,10,480,512,284,-228
2019,11,22,11,515,534,316,-218
2019,11,22,12,589,616,396,-220
2019,11,22,13,622,641,368,-273
2019,11,22,14,612,652,319,-333
2019,11,22,15,608,623,288,-335
2019,11,22,16,594,609,270,-339
2019,11,22,17,582,589,221,-368
2019,11,22,18,567,562,216,-346
2019,11,22,19,563,553,187,-366
2019,11,22,20,547,540,189,-351
2019,11,22,21,545,536,193,-343
2019,11,22,22,548,549,189,-360
2019,11,22,23,582,582,274,-308
2019,11,23,0,599,595,338,-257
2019,11,23,1,593,577,332,-245
2019,11,23,2,585,565,333,-232
2019,11,23,3,579,546,308,-238
2019,11,23,4,563,522,279,-243
2019,11,23,5,536,477,259,-218
2019,11,23,6,477,449,260,-189
2019,11,23,7,469,432,258,-174
2019,11,23,8,463,426,258,-168
2019,11,23,9,462,427,260,-167
2019,11,23,10,475,433,259,-174
2019,11,23,11,498,448,265,-183
2019,11,23,12,528,474,291,-183
2019,11,23,13,556,516,308,-208
2019,11,23,14,590,521,214,-307
2019,11,23,15,600,588,312,-276
2019,11,23,16,618,678,438,-240
2019,11,23,17,590,653,490,-163
2019,11,23,18,578,654,523,-131
2019,11,23,19,580,648,523,-125
2019,11,23,20,572,638,520,-118
2019,11,23,21,572,704,621,-83
2019,11,23,22,592,674,633,-41
2019,11,23,23,611,683,656,-27
2019,11,24,0,633,688,641,-47
2019,11,24,1,618,689,580,-109
2019,11,24,2,610,671,570,-101
2019,11,24,3,592,641,559,-82
2019,11,24,4,565,539,489,-50
2019,11,24,5,528,603,502,-101
2019,11,24,6,486,504,422,-82
2019,11,24,7,475,495,423,-72
2019,11,24,8,472,501,423,-78
2019,11,24,9,473,513,423,-90
2019,11,24,10,485,537,422,-115
2019,11,24,11,521,561,421,-140
2019,11,24,12,555,595,427,-168
2019,11,24,13,602,644,322,-322
2019,11,24,14,650,687,383,-304
2019,11,24,15,648,701,362,-339
2019,11,24,16,621,661,334,-327
2019,11,24,17,594,645,326,-319
2019,11,24,18,571,621,299,-322
2019,11,24,19,557,598,294,-304
2019,11,24,20,551,590,284,-306
2019,11,24,21,543,581,201,-380
2019,11,24,22,572,606,226,-380
2019,11,24,23,643,663,288,-375
2019,11,25,0,677,690,348,-342
2019,11,25,1,674,713,394,-319
2019,11,25,2,664,712,393,-319
2019,11,25,3,642,693,337,-356
2019,11,25,4,617,664,298,-366
2019,11,25,5,584,633,238,-395
2019,11,25,6,571,626,234,-392
2019,11,25,7,563,614,207,-407
2019,11,25,8,576,617,221,-396
2019,11,25,9,587,638,247,-391
2019,11,25,10,612,658,300,-358
2019,11,25,11,655,705,275,-430
2019,11,25,12,733,790,509,-281
2019,11,25,13,766,817,580,-237
2019,11,25,14,766,796,407,-389
2019,11,25,15,726,766,374,-392
2019,11,25,16,682,706,270,-436
2019,11,25,17,631,649,247,-402
2019,11,25,18,600,611,246,-365
2019,11,25,19,579,585,207,-378
2019,11,25,20,562,564,202,-362
2019,11,25,21,556,562,341,-221
2019,11,25,22,583,581,397,-184
2019,11,25,23,637,624,436,-188
2019,11,26,0,674,677,490,-187
2019,11,26,1,679,672,501,-171
2019,11,26,2,668,679,503,-176
2019,11,26,3,645,659,495,-164
2019,11,26,4,612,628,292,-336
2019,11,26,5,573,596,234,-362
2019,11,26,6,530,582,233,-349
2019,11,26,7,519,588,235,-353
2019,11,26,8,520,602,220,-382
2019,11,26,9,527,609,203,-406
2019,11,26,10,547,623,272,-351
2019,11,26,11,588,684,413,-271
2019,11,26,12,672,765,560,-205
2019,11,26,13,708,801,501,-300
2019,11,26,14,696,780,433,-347
2019,11,26,15,665,748,367,-381
2019,11,26,16,628,704,225,-479
2019,11,26,17,602,667,213,-454
2019,11,26,18,581,615,170,-445
2019,11,26,19,569,578,186,-392
2019,11,26,20,551,577,158,-419
2019,11,26,21,544,564,184,-380
2019,11,26,22,561,600,325,-275
2019,11,26,23,609,634,375,-259
2019,11,27,0,636,657,408,-249
2019,11,27,1,634,648,411,-237
2019,11,27,2,621,633,408,-225
2019,11,27,3,593,610,411,-199
2019,11,27,4,549,578,379,-199
2019,11,27,5,508,535,155,-380
2019,11,27,6,469,497,135,-362
2019,11,27,7,447,481,130,-351
2019,11,27,8,437,471,129,-342
2019,11,27,9,435,473,131,-342
2019,11,27,10,435,473,130,-343
2019,11,27,11,452,483,220,-263
2019,11,27,12,473,548,288,-260
2019,11,27,13,510,587,300,-287
2019,11,27,14,545,604,302,-302
2019,11,27,15,566,602,302,-300
2019,11,27,16,575,602,305,-297
2019,11,27,17,570,584,272,-312
2019,11,27,18,538,554,248,-306
2019,11,27,19,506,532,249,-283
2019,11,27,20,485,521,245,-276
2019,11,27,21,466,529,230,-299
2019,11,27,22,461,530,205,-325
2019,11,27,23,479,553,310,-243
2019,11,28,0,488,585,385,-200
2019,11,28,1,491,588,371,-217
2019,11,28,2,489,591,300,-291
2019,11,28,3,485,581,250,-331
2019,11,28,4,477,545,201,-344
2019,11,28,5,467,511,201,-310
2019,11,28,6,536,493,195,-298
2019,11,28,7,529,487,170,-317
2019,11,28,8,526,494,164,-330
2019,11,28,9,545,503,165,-338
2019,11,28,10,560,518,161,-357
2019,11,28,11,595,544,164,-380
2019,11,28,12,636,588,198,-390
2019,11,28,13,693,633,212,-421
2019,11,28,14,727,665,243,-422
2019,11,28,15,727,663,243,-420
2019,11,28,16,705,649,237,-412
2019,11,28,17,666,621,214,-407
2019,11,28,18,627,579,202,-377
2019,11,28,19,588,536,201,-335
2019,11,28,20,553,506,202,-304
2019,11,28,21,531,499,203,-296
2019,11,28,22,542,496,200,-296
2019,11,28,23,573,524,202,-322
2019,11,29,0,602,544,200,-344
2019,11,29,1,602,554,203,-351
2019,11,29,2,612,557,187,-370
2019,11,29,3,601,546,139,-407
2019,11,29,4,582,528,138,-390
2019,11,29,5,542,506,136,-370
2019,11,29,6,509,487,136,-351
2019,11,29,7,505,472,134,-338
2019,11,29,8,506,469,135,-334
2019,11,29,9,513,470,139,-331
2019,11,29,10,538,479,168,-311
2019,11,29,11,562,498,170,-328
2019,11,29,12,619,531,203,-328
2019,11,29,13,671,550,198,-352
2019,11,29,14,703,574,201,-373
2019,11,29,15,700,581,199,-382
2019,11,29,16,661,564,203,-361
2019,11,29,17,619,537,158,-379
2019,11,29,18,587,519,131,-388
2019,11,29,19,538,502,131,-371
2019,11,29,20,492,503,137,-366
2019,11,29,21,482,500,183,-317
2019,11,29,22,521,516,167,-349
2019,11,29,23,590,542,232,-310
2019,11,30,0,624,557,340,-217
2019,11,30,1,619,553,290,-263
2019,11,30,2,615,551,217,-334
2019,11,30,3,598,522,189,-333
2019,11,30,4,567,504,135,-369
2019,11,30,5,520,472,81,-391
2019,11,30,6,500,443,69,-374
2019,11,30,7,485,427,66,-361
2019,11,30,8,481,424,67,-357
2019,11,30,9,482,423,79,-344
2019,11,30,10,488,429,70,-359
2019,11,30,11,509,446,69,-377
2019,11,30,12,537,469,125,-344
2019,11,30,13,583,508,191,-317
2019,11,30,14,608,539,212,-327
2019,11,30,15,621,558,225,-333
2019,11,30,16,618,554,229,-325
2019,11,30,17,578,540,219,-321
2019,11,30,18,542,527,203,-324
2019,11,30,19,526,510,204,-306
2019,11,30,20,520,494,208,-286
2019,11,30,21,522,497,208,-289
2019,11,30,22,539,526,249,-277
2019,11,30,23,571,541,360,-181
2019,12,1,0,590,558,447,-111
2019,12,1,1,595,556,440,-116
2019,12,1,2,592,551,421,-130
2019,12,1,3,577,515,186,-329
2019,12,1,4,550,485,130,-355
2019,12,1,5,528,454,101,-353
2019,12,1,6,485,430,129,-301
2019,12,1,7,465,410,125,-285
2019,12,1,8,454,409,129,-280
2019,12,1,9,450,402,126,-276
2019,12,1,10,450,407,126,-281
2019,12,1,11,477,421,127,-294
2019,12,1,12,512,448,128,-320
2019,12,1,13,550,481,127,-354
2019,12,1,14,596,517,128,-389
2019,12,1,15,588,517,127,-390
2019,12,1,16,558,510,156,-354
2019,12,1,17,527,495,220,-275
2019,12,1,18,513,492,232,-260
2019,12,1,19,502,487,224,-263
2019,12,1,20,494,482,211,-271
2019,12,1,21,496,484,242,-242
2019,12,1,22,525,507,266,-241
2019,12,1,23,567,560,351,-209
2019,12,2,0,605,584,408,-176
2019,12,2,1,615,593,421,-172
2019,12,2,2,608,584,333,-251
2019,12,2,3,586,566,328,-238
2019,12,2,4,560,540,197,-343
2019,12,2,5,536,521,131,-390
2019,12,2,6,539,509,134,-375
2019,12,2,7,538,510,146,-364
2019,12,2,8,545,516,203,-313
2019,12,2,9,563,531,201,-330
2019,12,2,10,598,564,236,-328
2019,12,2,11,642,609,299,-310
2019,12,2,12,727,686,331,-355
2019,12,2,13,770,742,518,-224
2019,12,2,14,784,770,467,-303
2019,12,2,15,767,765,356,-409
2019,12,2,16,755,764,329,-435
2019,12,2,17,748,743,324,-419
2019,12,2,18,714,715,342,-373
2019,12,2,19,696,710,448,-262
2019,12,2,20,683,716,471,-245
2019,12,2,21,680,727,484,-243
2019,12,2,22,712,748,578,-170
2019,12,2,23,784,817,617,-200
2019,12,3,0,821,840,581,-259
2019,12,3,1,826,840,582,-258
2019,12,3,2,812,821,594,-227
2019,12,3,3,783,790,381,-409
2019,12,3,4,752,737,356,-381
2019,12,3,5,708,698,368,-330
2019,12,3,6,693,678,365,-313
2019,12,3,7,683,667,365,-302
2019,12,3,8,696,667,379,-288
2019,12,3,9,708,674,421,-253
2019,12,3,10,731,688,380,-308
2019,12,3,11,772,728,472,-256
2019,12,3,12,839,798,601,-197
2019,12,3,13,881,834,646,-188
2019,12,3,14,869,842,641,-201
2019,12,3,15,825,806,472,-334
2019,12,3,16,773,775,353,-422
2019,12,3,17,706,757,318,-439
2019,12,3,18,676,704,290,-414
2019,12,3,19,637,683,264,-419
2019,12,3,20,634,647,253,-394
2019,12,3,21,632,657,259,-398
2019,12,3,22,678,677,307,-370
2019,12,3,23,739,750,484,-266
2019,12,4,0,777,787,570,-217
2019,12,4,1,784,800,567,-233
2019,12,4,2,781,779,638,-141
2019,12,4,3,757,755,682,-73
2019,12,4,4,718,721,623,-98
2019,12,4,5,676,685,602,-83
2019,12,4,6,656,661,600,-61
2019,12,4,7,655,664,565,-99
2019,12,4,8,660,662,518,-144
2019,12,4,9,676,670,520,-150
2019,12,4,10,695,690,522,-168
2019,12,4,11,746,728,493,-235
2019,12,4,12,825,816,574,-242
2019,12,4,13,861,840,597,-243
2019,12,4,14,855,827,568,-259
2019,12,4,15,808,777,457,-320
2019,12,4,16,740,703,446,-257
2019,12,4,17,673,656,439,-217
2019,12,4,18,632,630,439,-191
2019,12,4,19,616,613,438,-175
2019,12,4,20,603,600,438,-162
2019,12,4,21,603,600,438,-162
2019,12,4,22,630,627,485,-142
2019,12,4,23,688,684,568,-116
2019,12,5,0,727,723,587,-136
2019,12,5,1,730,726,602,-124
2019,12,5,2,725,716,596,-120
2019,12,5,3,708,684,634,-50
2019,12,5,4,675,645,593,-52
2019,12,5,5,627,621,491,-130
2019,12,5,6,605,587,412,-175
2019,12,5,7,601,567,374,-193
2019,12,5,8,607,566,373,-193
2019,12,5,9,621,573,377,-196
2019,12,5,10,647,589,313,-276
2019,12,5,11,693,604,359,-245
2019,12,5,12,786,707,550,-157
2019,12,5,13,825,749,673,-76
2019,12,5,14,821,762,733,-29
2019,12,5,15,779,725,594,-131
2019,12,5,16,719,661,538,-123
2019,12,5,17,666,626,534,-92
2019,12,5,18,627,597,532,-65
2019,12,5,19,607,578,511,-67
2019,12,5,20,588,567,461,-106
2019,12,5,21,587,565,460,-105
2019,12,5,22,614,582,460,-122
2019,12,5,23,667,630,489,-141
2019,12,6,0,696,673,607,-66
2019,12,6,1,707,702,687,-15
2019,12,6,2,698,705,692,-13
2019,12,6,3,672,693,677,-16
2019,12,6,4,634,654,567,-87
2019,12,6,5,588,629,540,-89
2019,12,6,6,611,620,527,-93
2019,12,6,7,607,612,514,-98
2019,12,6,8,609,609,534,-75
2019,12,6,9,624,600,541,-59
2019,12,6,10,652,602,542,-60
2019,12,6,11,680,637,608,-29
2019,12,6,12,748,698,631,-67
2019,12,6,13,781,732,708,-24
2019,12,6,14,770,727,705,-22
2019,12,6,15,745,725,701,-24
2019,12,6,16,700,714,685,-29
2019,12,6,17,656,705,663,-42
2019,12,6,18,625,677,660,-17
2019,12,6,19,607,648,642,-6
2019,12,6,20,593,635,568,-67
2019,12,6,21,587,625,535,-90
2019,12,6,22,610,625,568,-57
2019,12,6,23,648,670,615,-55
2019,12,7,0,664,678,576,-102
2019,12,7,1,665,673,495,-178
2019,12,7,2,656,667,486,-181
2019,12,7,3,644,653,498,-155
2019,12,7,4,610,633,431,-202
2019,12,7,5,588,597,375,-222
2019,12,7,6,577,576,332,-244
2019,12,7,7,569,565,313,-252
2019,12,7,8,568,565,314,-251
2019,12,7,9,570,569,315,-254
2019,12,7,10,581,591,348,-243
2019,12,7,11,593,619,373,-246
2019,12,7,12,628,667,397,-270
2019,12,7,13,663,711,544,-167
2019,12,7,14,701,737,556,-181
2019,12,7,15,708,713,509,-204
2019,12,7,16,686,646,481,-165
2019,12,7,17,657,599,481,-118
2019,12,7,18,626,555,478,-77
2019,12,7,19,600,530,478,-52
2019,12,7,20,596,518,432,-86
2019,12,7,21,606,517,414,-103
2019,12,7,22,616,537,442,-95
2019,12,7,23,659,573,498,-75
2019,12,8,0,680,606,549,-57
2019,12,8,1,684,606,513,-93
2019,12,8,2,681,608,537,-71
2019,12,8,3,670,594,536,-58
2019,12,8,4,651,571,536,-35
2019,12,8,5,624,544,499,-45
2019,12,8,6,559,532,422,-110
2019,12,8,7,544,513,374,-139
2019,12,8,8,548,504,395,-109
2019,12,8,9,550,519,444,-75
2019,12,8,10,545,521,461,-60
2019,12,8,11,574,543,484,-59
2019,12,8,12,607,573,500,-73
2019,12,8,13,651,615,513,-102
2019,12,8,14,686,652,547,-105
2019,12,8,15,694,661,539,-122
2019,12,8,16,661,641,438,-203
2019,12,8,17,632,603,399,-204
2019,12,8,18,611,582,405,-177
2019,12,8,19,600,563,420,-143
2019,12,8,20,597,545,416,-129
2019,12,8,21,606,551,389,-162
2019,12,8,22,630,568,393,-175
2019,12,8,23,689,634,551,-83
2019,12,9,0,705,669,585,-84
2019,12,9,1,697,671,591,-80
2019,12,9,2,684,663,602,-61
2019,12,9,3,652,625,566,-59
2019,12,9,4,609,608,538,-70
2019,12,9,5,561,561,414,-147
2019,12,9,6,533,520,364,-156
2019,12,9,7,522,508,389,-119
2019,12,9,8,522,507,388,-119
2019,12,9,9,528,515,372,-143
2019,12,9,10,550,530,371,-159
2019,12,9,11,577,562,446,-116
2019,12,9,12,650,632,599,-33
2019,12,9,13,687,656,635,-21
2019,12,9,14,692,664,643,-21
2019,12,9,15,666,667,648,-19
2019,12,9,16,647,656,644,-12
2019,12,9,17,638,643,621,-22
2019,12,9,18,626,614,597,-17
2019,12,9,19,611,598,567,-31
2019,12,9,20,600,588,538,-50
2019,12,9,21,592,586,496,-90
2019,12,9,22,613,579,504,-75
2019,12,9,23,656,630,619,-11
2019,12,10,0,670,655,580,-75
2019,12,10,1,667,646,525,-121
2019,12,10,2,649,634,524,-110
2019,12,10,3,624,604,512,-92
2019,12,10,4,586,564,347,-217
2019,12,10,5,526,504,254,-250
2019,12,10,6,490,472,254,-218
2019,12,10,7,474,453,251,-202
2019,12,10,8,475,449,267,-182
2019,12,10,9,480,448,303,-145
2019,12,10,10,496,459,318,-141
2019,12,10,11,542,495,318,-177
2019,12,10,12,609,560,408,-152
2019,12,10,13,629,599,514,-85
2019,12,10,14,626,602,507,-95
2019,12,10,15,609,604,497,-107
2019,12,10,16,594,605,489,-116
2019,12,10,17,594,609,484,-125
2019,12,10,18,585,616,491,-125
2019,12,10,19,581,620,382,-238
2019,12,10,20,570,618,308,-310
2019,12,10,21,566,640,351,-289
2019,12,10,22,583,676,467,-209
2019,12,10,23,631,713,526,-187
2019,12,11,0,655,741,564,-177
2019,12,11,1,662,744,530,-214
2019,12,11,2,651,739,467,-272
2019,12,11,3,634,716,468,-248
2019,12,11,4,603,695,441,-254
2019,12,11,5,571,656,341,-315
2019,12,11,6,585,637,326,-311
2019,12,11,7,569,630,321,-309
2019,12,11,8,585,639,320,-319
2019,12,11,9,597,650,320,-330
2019,12,11,10,614,673,400,-273
2019,12,11,11,657,715,439,-276
2019,12,11,12,733,794,466,-328
2019,12,11,13,775,859,451,-408
2019,12,11,14,778,867,529,-338
2019,12,11,15,763,850,512,-338
2019,12,11,16,738,819,582,-237
2019,12,11,17,724,797,605,-192
2019,12,11,18,706,770,565,-205
2019,12,11,19,697,713,537,-176
2019,12,11,20,678,685,299,-386
2019,12,11,21,680,692,277,-415
2019,12,11,22,714,716,300,-416
2019,12,11,23,769,789,363,-426
2019,12,12,0,795,834,408,-426
2019,12,12,1,794,841,416,-425
2019,12,12,2,791,838,413,-425
2019,12,12,3,774,809,395,-414
2019,12,12,4,730,775,361,-414
2019,12,12,5,686,739,333,-406
2019,12,12,6,722,728,333,-395
2019,12,12,7,716,724,330,-394
2019,12,12,8,726,731,332,-399
2019,12,12,9,739,746,353,-393
2019,12,12,10,762,776,419,-357
2019,12,12,11,812,826,468,-358
2019,12,12,12,887,912,603,-309
2019,12,12,13,922,944,725,-219
2019,12,12,14,913,918,794,-124
2019,12,12,15,872,861,708,-153
2019,12,12,16,813,780,659,-121
2019,12,12,17,763,726,527,-199
2019,12,12,18,720,695,362,-333
2019,12,12,19,694,668,312,-356
2019,12,12,20,680,648,276,-372
2019,12,12,21,681,654,282,-372
2019,12,12,22,706,681,362,-319
2019,12,12,23,762,756,413,-343
2019,12,13,0,799,791,441,-350
2019,12,13,1,817,795,446,-349
2019,12,13,2,809,778,378,-400
2019,12,13,3,788,739,342,-397
2019,12,13,4,744,712,347,-365
2019,12,13,5,700,663,336,-327
2019,12,13,6,671,654,294,-360
2019,12,13,7,658,645,241,-404
2019,12,13,8,654,634,221,-413
2019,12,13,9,659,636,224,-412
2019,12,13,10,672,651,237,-414
2019,12,13,11,698,667,276,-391
2019,12,13,12,767,740,337,-403
2019,12,13,13,800,773,382,-391
2019,12,13,14,794,787,380,-407
2019,12,13,15,773,778,384,-394
2019,12,13,16,738,766,415,-351
2019,12,13,17,739,752,409,-343
2019,12,13,18,725,735,414,-321
2019,12,13,19,712,721,413,-308
2019,12,13,20,686,705,394,-311
2019,12,13,21,684,701,403,-298
2019,12,13,22,694,713,431,-282
2019,12,13,23,713,725,425,-300
2019,12,14,0,715,724,355,-369
2019,12,14,1,706,704,352,-352
2019,12,14,2,687,687,312,-375
2019,12,14,3,663,672,290,-382
2019,12,14,4,625,633,223,-410
2019,12,14,5,614,577,171,-406
2019,12,14,6,578,543,165,-378
2019,12,14,7,560,526,164,-362
2019,12,14,8,555,514,166,-348
2019,12,14,9,553,507,166,-341
2019,12,14,10,556,515,193,-322
2019,12,14,11,570,533,198,-335
2019,12,14,12,604,562,199,-363
2019,12,14,13,641,602,201,-401
2019,12,14,14,675,637,227,-410
2019,12,14,15,683,651,231,-420
2019,12,14,16,673,648,221,-427
2019,12,14,17,639,643,202,-441
2019,12,14,18,622,625,200,-425
2019,12,14,19,596,616,202,-414
2019,12,14,20,576,618,201,-417
2019,12,14,21,577,616,197,-419
2019,12,14,22,587,649,206,-443
2019,12,14,23,616,691,230,-461
2019,12,15,0,637,702,240,-462
2019,12,15,1,641,703,244,-459
2019,12,15,2,634,687,243,-444
2019,12,15,3,620,676,244,-432
2019,12,15,4,596,644,233,-411
2019,12,15,5,586,615,210,-405
2019,12,15,6,582,585,199,-386
2019,12,15,7,566,575,201,-374
2019,12,15,8,568,585,205,-380
2019,12,15,9,568,601,212,-389
2019,12,15,10,562,620,215,-405
2019,12,15,11,592,641,241,-400
2019,12,15,12,626,671,262,-409
2019,12,15,13,666,713,335,-378
2019,12,15,14,694,743,319,-424
2019,12,15,15,689,720,241,-479
2019,12,15,16,647,655,224,-431
2019,12,15,17,611,610,227,-383
2019,12,15,18,581,589,179,-410
2019,12,15,19,565,561,134,-427
2019,12,15,20,555,547,136,-411
2019,12,15,21,556,545,134,-411
2019,12,15,22,581,568,197,-371
2019,12,15,23,645,618,252,-366
2019,12,16,0,670,655,270,-385
2019,12,16,1,664,649,312,-337
2019,12,16,2,656,639,380,-259
2019,12,16,3,625,653,373,-280
2019,12,16,4,590,602,267,-335
2019,12,16,5,527,570,241,-329
2019,12,16,6,500,541,235,-306
2019,12,16,7,485,536,224,-312
2019,12,16,8,478,541,201,-340
2019,12,16,9,474,548,200,-348
2019,12,16,10,482,566,199,-367
2019,12,16,11,533,611,200,-411
2019,12,16,12,633,679,272,-407
2019,12,16,13,650,697,268,-429
2019,12,16,14,641,711,358,-353
2019,12,16,15,630,672,266,-406
2019,12,16,16,618,632,219,-413
2019,12,16,17,594,605,201,-404
2019,12,16,18,587,588,203,-385
2019,12,16,19,575,577,201,-376
2019,12,16,20,564,563,201,-362
2019,12,16,21,550,556,201,-355
2019,12,16,22,563,575,202,-373
2019,12,16,23,602,605,242,-363
2019,12,17,0,631,635,397,-238
2019,12,17,1,628,638,396,-242
2019,12,17,2,612,627,372,-255
2019,12,17,3,588,588,339,-249
2019,12,17,4,548,541,259,-282
2019,12,17,5,502,531,136,-395
2019,12,17,6,458,454,129,-325
2019,12,17,7,446,440,128,-312
2019,12,17,8,445,433,129,-304
2019,12,17,9,444,431,129,-302
2019,12,17,10,464,447,131,-316
2019,12,17,11,500,479,129,-350
2019,12,17,12,574,547,133,-414
2019,12,17,13,612,585,198,-387
2019,12,17,14,614,589,200,-389
2019,12,17,15,624,595,198,-397
2019,12,17,16,611,597,197,-400
2019,12,17,17,607,598,199,-399
2019,12,17,18,611,594,199,-395
2019,12,17,19,614,598,200,-398
2019,12,17,20,613,600,198,-402
2019,12,17,21,636,628,204,-424
2019,12,17,22,669,657,199,-458
2019,12,17,23,716,716,225,-491
2019,12,18,0,748,755,246,-509
2019,12,18,1,754,767,252,-515
2019,12,18,2,742,766,256,-510
2019,12,18,3,728,749,246,-503
2019,12,18,4,698,715,228,-487
2019,12,18,5,684,693,214,-479
2019,12,18,6,653,668,194,-474
2019,12,18,7,647,674,196,-478
2019,12,18,8,659,686,195,-491
2019,12,18,9,689,706,195,-511
2019,12,18,10,724,726,198,-528
2019,12,18,11,764,768,272,-496
2019,12,18,12,838,867,424,-443
2019,12,18,13,888,910,458,-452
2019,12,18,14,887,903,453,-450
2019,12,18,15,853,856,445,-411
2019,12,18,16,808,813,371,-442
2019,12,18,17,768,776,262,-514
2019,12,18,18,733,728,210,-518
2019,12,18,19,709,707,197,-510
2019,12,18,20,696,686,210,-476
2019,12,18,21,695,697,222,-475
2019,12,18,22,728,717,243,-474
2019,12,18,23,795,794,306,-488
2019,12,19,0,832,835,425,-410
2019,12,19,1,839,845,438,-407
2019,12,19,2,833,840,442,-398
2019,12,19,3,814,825,445,-380
2019,12,19,4,783,788,444,-344
2019,12,19,5,746,744,444,-300
2019,12,19,6,741,730,445,-285
2019,12,19,7,733,729,445,-284
2019,12,19,8,745,738,446,-292
2019,12,19,9,751,752,446,-306
2019,12,19,10,778,778,442,-336
2019,12,19,11,822,831,448,-383
2019,12,19,12,903,913,451,-462
2019,12,19,13,936,946,503,-443
2019,12,19,14,921,933,459,-474
2019,12,19,15,881,879,453,-426
2019,12,19,16,817,811,401,-410
2019,12,19,17,764,757,349,-408
2019,12,19,18,703,699,341,-358
2019,12,19,19,662,663,340,-323
2019,12,19,20,639,646,313,-333
2019,12,19,21,640,633,288,-345
2019,12,19,22,658,647,313,-334
2019,12,19,23,723,720,350,-370
2019,12,20,0,769,767,352,-415
2019,12,20,1,789,789,382,-407
2019,12,20,2,789,797,425,-372
2019,12,20,3,776,783,431,-352
2019,12,20,4,746,757,445,-312
2019,12,20,5,714,724,451,-273
2019,12,20,6,694,707,446,-261
2019,12,20,7,687,701,445,-256
2019,12,20,8,697,717,454,-263
2019,12,20,9,704,728,447,-281
2019,12,20,10,731,757,458,-299
2019,12,20,11,784,803,444,-359
2019,12,20,12,845,875,547,-328
2019,12,20,13,887,921,649,-272
2019,12,20,14,868,914,645,-269
2019,12,20,15,834,858,526,-332
2019,12,20,16,774,780,369,-411
2019,12,20,17,703,729,327,-402
2019,12,20,18,639,659,284,-375
2019,12,20,19,600,630,258,-372
2019,12,20,20,589,602,250,-352
2019,12,20,21,588,604,252,-352
2019,12,20,22,619,630,248,-382
2019,12,20,23,666,676,265,-411
2019,12,21,0,702,709,296,-413
2019,12,21,1,699,719,305,-414
2019,12,21,2,701,711,296,-415
2019,12,21,3,686,704,258,-446
2019,12,21,4,653,673,281,-392
2019,12,21,5,641,640,258,-382
2019,12,21,6,653,612,208,-404
2019,12,21,7,641,606,210,-396
2019,12,21,8,632,610,206,-404
2019,12,21,9,639,608,204,-404
2019,12,21,10,649,624,210,-414
2019,12,21,11,681,650,205,-445
2019,12,21,12,704,677,207,-470
2019,12,21,13,758,711,211,-500
2019,12,21,14,781,749,223,-526
2019,12,21,15,777,760,243,-517
2019,12,21,16,752,725,241,-484
2019,12,21,17,720,686,237,-449
2019,12,21,18,679,640,209,-431
2019,12,21,19,643,619,213,-406
2019,12,21,20,630,600,203,-397
2019,12,21,21,612,594,200,-394
2019,12,21,22,649,621,214,-407
2019,12,21,23,690,658,237,-421
2019,12,22,0,713,667,242,-425
2019,12,22,1,720,662,255,-407
2019,12,22,2,712,656,268,-388
2019,12,22,3,700,643,264,-379
2019,12,22,4,673,616,252,-364
2019,12,22,5,661,576,242,-334
2019,12,22,6,611,554,238,-316
2019,12,22,7,588,547,240,-307
2019,12,22,8,582,542,243,-299
2019,12,22,9,595,547,259,-288
2019,12,22,10,577,563,286,-277
2019,12,22,11,624,587,373,-214
2019,12,22,12,665,620,441,-179
2019,12,22,13,714,669,436,-233
2019,12,22,14,743,701,478,-223
2019,12,22,15,741,714,347,-367
2019,12,22,16,706,694,266,-428
2019,12,22,17,664,673,200,-473
2019,12,22,18,609,664,199,-465
2019,12,22,19,598,660,201,-459
2019,12,22,20,590,650,196,-454
2019,12,22,21,595,656,198,-458
2019,12,22,22,636,672,200,-472
2019,12,22,23,666,676,211,-465
2019,12,23,0,671,619,214,-405
2019,12,23,1,667,600,213,-387
2019,12,23,2,658,546,212,-334
2019,12,23,3,641,501,204,-297
2019,12,23,4,609,498,153,-345
2019,12,23,5,574,483,153,-330
2019,12,23,6,566,533,202,-331
2019,12,23,7,541,504,200,-304
2019,12,23,8,534,497,209,-288
2019,12,23,9,530,497,211,-286
2019,12,23,10,540,507,208,-299
2019,12,23,11,566,531,268,-263
2019,12,23,12,602,572,248,-324
2019,12,23,13,645,596,271,-325
2019,12,23,14,665,625,358,-267
2019,12,23,15,665,636,383,-253
2019,12,23,16,651,647,411,-236
2019,12,23,17,638,637,401,-236
2019,12,23,18,624,635,344,-291
2019,12,23,19,615,614,267,-347
2019,12,23,20,605,591,285,-306
2019,12,23,21,590,599,279,-320
2019,12,23,22,598,603,289,-314
2019,12,23,23,631,621,332,-289
2019,12,24,0,650,633,307,-326
2019,12,24,1,656,643,277,-366
2019,12,24,2,639,612,216,-396
2019,12,24,3,627,586,205,-381
2019,12,24,4,604,552,207,-345
2019,12,24,5,564,510,206,-304
2019,12,24,6,506,471,203,-268
2019,12,24,7,484,459,208,-251
2019,12,24,8,480,447,207,-240
2019,12,24,9,479,442,206,-236
2019,12,24,10,483,452,207,-245
2019,12,24,11,493,471,205,-266
2019,12,24,12,531,504,205,-299
2019,12,24,13,578,542,208,-334
2019,12,24,14,605,571,205,-366
2019,12,24,15,607,585,205,-380
2019,12,24,16,584,578,207,-371
2019,12,24,17,559,555,203,-352
2019,12,24,18,528,521,136,-385
2019,12,24,19,512,503,136,-367
2019,12,24,20,498,495,138,-357
2019,12,24,21,500,495,142,-353
2019,12,24,22,506,499,140,-359
2019,12,24,23,533,522,140,-382
2019,12,25,0,550,540,142,-398
2019,12,25,1,554,532,140,-392
2019,12,25,2,552,527,140,-387
2019,12,25,3,560,533,141,-392
2019,12,25,4,551,519,137,-382
2019,12,25,5,524,503,138,-365
2019,12,25,6,495,489,140,-349
2019,12,25,7,484,478,139,-339
2019,12,25,8,492,485,142,-343
2019,12,25,9,496,492,133,-359
2019,12,25,10,511,507,83,-424
2019,12,25,11,530,539,108,-431
2019,12,25,12,571,583,253,-330
2019,12,25,13,620,630,367,-263
2019,12,25,14,645,673,377,-296
2019,12,25,15,636,654,365,-289
2019,12,25,16,590,607,226,-381
2019,12,25,17,545,558,205,-353
2019,12,25,18,528,517,169,-348
2019,12,25,19,489,486,128,-358
2019,12,25,20,464,470,118,-352
2019,12,25,21,462,464,138,-326
2019,12,25,22,463,479,142,-337
2019,12,25,23,510,511,159,-352
2019,12,26,0,527,536,178,-358
2019,12,26,1,547,537,256,-281
2019,12,26,2,542,539,254,-285
2019,12,26,3,530,533,253,-280
2019,12,26,4,506,522,254,-268
2019,12,26,5,471,501,251,-250
2019,12,26,6,446,494,253,-241
2019,12,26,7,438,490,252,-238
2019,12,26,8,434,502,254,-248
2019,12,26,9,439,517,251,-266
2019,12,26,10,458,542,252,-290
2019,12,26,11,487,582,252,-330
2019,12,26,12,554,631,340,-291
2019,12,26,13,586,677,397,-280
2019,12,26,14,613,704,433,-271
2019,12,26,15,605,694,286,-408
2019,12,26,16,568,642,222,-420
2019,12,26,17,539,594,207,-387
2019,12,26,18,525,554,231,-323
2019,12,26,19,499,530,236,-294
2019,12,26,20,485,513,237,-276
2019,12,26,21,484,509,251,-258
2019,12,26,22,498,524,339,-185
2019,12,26,23,542,569,409,-160
2019,12,27,0,575,596,515,-81
2019,12,27,1,577,596,525,-71
2019,12,27,2,566,591,531,-60
2019,12,27,3,550,572,448,-124
2019,12,27,4,517,545,417,-128
2019,12,27,5,484,520,418,-102
2019,12,27,6,446,496,381,-115
2019,12,27,7,442,494,344,-150
2019,12,27,8,441,503,321,-182
2019,12,27,9,447,519,322,-197
2019,12,27,10,464,544,322,-222
2019,12,27,11,512,586,322,-264
2019,12,27,12,565,643,322,-321
2019,12,27,13,618,690,330,-360
2019,12,27,14,638,708,381,-327
2019,12,27,15,622,681,393,-288
2019,12,27,16,600,645,393,-252
2019,12,27,17,575,603,394,-209
2019,12,27,18,563,572,396,-176
2019,12,27,19,537,544,398,-146
2019,12,27,20,529,533,396,-137
2019,12,27,21,514,537,396,-141
2019,12,27,22,532,546,396,-150
2019,12,27,23,579,590,400,-190
2019,12,28,0,600,602,397,-205
2019,12,28,1,596,587,395,-192
2019,12,28,2,584,578,397,-181
2019,12,28,3,564,560,399,-161
2019,12,28,4,527,531,397,-134
2019,12,28,5,513,495,390,-105
2019,12,28,6,483,477,391,-86
2019,12,28,7,468,465,363,-102
2019,12,28,8,463,468,327,-141
2019,12,28,9,460,472,326,-146
2019,12,28,10,470,486,330,-156
2019,12,28,11,484,516,413,-103
2019,12,28,12,507,552,422,-130
2019,12,28,13,556,591,420,-171
2019,12,28,14,588,627,421,-206
2019,12,28,15,600,607,411,-196
2019,12,28,16,606,601,410,-191
2019,12,28,17,590,585,389,-196
2019,12,28,18,553,538,380,-158
2019,12,28,19,543,514,388,-126
2019,12,28,20,524,496,384,-112
2019,12,28,21,509,498,386,-112
2019,12,28,22,510,514,394,-120
2019,12,28,23,547,551,395,-156
2019,12,29,0,563,574,394,-180
2019,12,29,1,559,567,395,-172
2019,12,29,2,555,546,391,-155
2019,12,29,3,535,530,395,-135
2019,12,29,4,507,499,389,-110
2019,12,29,5,486,463,360,-103
2019,12,29,6,454,434,343,-91
2019,12,29,7,433,413,367,-46
2019,12,29,8,426,406,338,-68
2019,12,29,9,420,402,350,-52
2019,12,29,10,418,407,361,-46
2019,12,29,11,440,418,378,-40
2019,12,29,12,463,434,378,-56
2019,12,29,13,498,467,381,-86
2019,12,29,14,528,500,365,-135
2019,12,29,15,544,523,387,-136
2019,12,29,16,522,526,384,-142
2019,12,29,17,515,523,387,-136
2019,12,29,18,514,517,390,-127
2019,12,29,19,503,511,395,-116
2019,12,29,20,478,509,394,-115
2019,12,29,21,484,508,397,-111
2019,12,29,22,512,514,394,-120
2019,12,29,23,554,538,414,-124
2019,12,30,0,571,561,434,-127
2019,12,30,1,563,551,434,-117
2019,12,30,2,546,535,433,-102
2019,12,30,3,532,508,435,-73
2019,12,30,4,503,476,414,-62
2019,12,30,5,484,438,396,-42
2019,12,30,6,423,398,374,-24
2019,12,30,7,408,391,322,-69
2019,12,30,8,405,380,341,-39
2019,12,30,9,407,379,326,-53
2019,12,30,10,411,384,335,-49
2019,12,30,11,437,410,335,-75
2019,12,30,12,482,454,356,-98
2019,12,30,13,538,500,377,-123
2019,12,30,14,557,534,384,-150
2019,12,30,15,568,542,406,-136
2019,12,30,16,570,545,407,-138
2019,12,30,17,547,535,402,-133
2019,12,30,18,532,526,387,-139
2019,12,30,19,518,522,401,-121
2019,12,30,20,511,512,398,-114
2019,12,30,21,505,512,397,-115
2019,12,30,22,532,530,402,-128
2019,12,30,23,586,570,404,-166
2019,12,31,0,616,608,437,-171
2019,12,31,1,617,616,448,-168
2019,12,31,2,611,608,443,-165
2019,12,31,3,589,602,448,-154
2019,12,31,4,559,574,417,-157
2019,12,31,5,540,543,413,-130
2019,12,31,6,530,519,410,-109
2019,12,31,7,534,516,415,-101
2019,12,31,8,534,514,414,-100
2019,12,31,9,549,528,417,-111
2019,12,31,10,572,547,413,-134
2019,12,31,11,605,589,415,-174
2019,12,31,12,653,650,418,-232
2019,12,31,13,702,696,437,-259
2019,12,31,14,736,714,564,-150
2019,12,31,15,730,692,385,-307
2019,12,31,16,686,664,371,-293
2019,12,31,17,648,631,383,-248
2019,12,31,18,612,608,382,-226
2019,12,31,19,582,588,383,-205
2019,12,31,20,573,573,400,-173
2019,12,31,21,565,576,403,-173
2019,12,31,22,591,593,401,-192
2019,12,31,23,644,642,401,-241
2020,1,1,0,681,677,445,-232
2020,1,1,1,682,686,474,-212
2020,1,1,2,660,672,470,-202
2020,1,1,3,648,661,475,-186
2020,1,1,4,636,635,470,-165
2020,1,1,5,640,622,476,-146
2020,1,1,6,623,606,442,-164
2020,1,1,7,608,602,418,-184
2020,1,1,8,609,597,417,-180
2020,1,1,9,615,601,419,-182
2020,1,1,10,639,608,425,-183
2020,1,1,11,660,626,485,-141
2020,1,1,12,688,648,480,-168
2020,1,1,13,731,677,576,-101
2020,1,1,14,763,709,535,-174
2020,1,1,15,755,697,481,-216
2020,1,1,16,719,678,397,-281
2020,1,1,17,685,665,392,-273
2020,1,1,18,661,632,383,-249
2020,1,1,19,624,596,320,-276
2020,1,1,20,600,574,320,-254
2020,1,1,21,581,568,315,-253
2020,1,1,22,605,592,336,-256
2020,1,1,23,650,638,423,-215
2020,1,2,0,695,688,479,-209
2020,1,2,1,690,697,482,-215
2020,1,2,2,684,695,479,-216
2020,1,2,3,666,682,483,-199
2020,1,2,4,641,663,474,-189
2020,1,2,5,603,639,434,-205
2020,1,2,6,605,620,380,-240
2020,1,2,7,598,614,366,-248
2020,1,2,8,609,606,365,-241
2020,1,2,9,618,604,365,-239
2020,1,2,10,641,620,375,-245
2020,1,2,11,675,646,448,-198
2020,1,2,12,750,690,497,-193
2020,1,2,13,788,726,501,-225
2020,1,2,14,785,728,499,-229
2020,1,2,15,760,727,498,-229
2020,1,2,16,728,720,495,-225
2020,1,2,17,711,711,483,-228
2020,1,2,18,667,699,421,-278
2020,1,2,19,644,696,422,-274
2020,1,2,20,616,684,419,-265
2020,1,2,21,614,675,416,-259
2020,1,2,22,617,683,420,-263
2020,1,2,23,669,707,421,-286
2020,1,3,0,708,717,470,-247
2020,1,3,1,710,701,477,-224
2020,1,3,2,696,678,479,-199
2020,1,3,3,662,643,481,-162
2020,1,3,4,620,595,476,-119
2020,1,3,5,575,570,461,-109
2020,1,3,6,530,513,403,-110
2020,1,3,7,510,509,413,-96
2020,1,3,8,506,502,413,-89
2020,1,3,9,506,494,413,-81
2020,1,3,10,515,507,414,-93
2020,1,3,11,546,525,407,-118
2020,1,3,12,601,568,407,-161
2020,1,3,13,639,604,411,-193
2020,1,3,14,643,616,412,-204
2020,1,3,15,633,620,410,-210
2020,1,3,16,636,625,408,-217
2020,1,3,17,608,621,404,-217
2020,1,3,18,588,613,408,-205
2020,1,3,19,586,604,412,-192
2020,1,3,20,574,589,411,-178
2020,1,3,21,579,581,410,-171
2020,1,3,22,586,577,408,-169
2020,1,3,23,610,609,413,-196
2020,1,4,0,634,613,410,-203
2020,1,4,1,624,598,410,-188
2020,1,4,2,614,582,411,-171
2020,1,4,3,582,557,411,-146
2020,1,4,4,540,528,412,-116
2020,1,4,5,482,495,412,-83
2020,1,4,6,473,463,409,-54
2020,1,4,7,463,451,412,-39
2020,1,4,8,459,436,405,-31
2020,1,4,9,457,436,345,-91
2020,1,4,10,468,442,375,-67
2020,1,4,11,475,461,393,-68
2020,1,4,12,512,486,399,-87
2020,1,4,13,541,515,396,-119
2020,1,4,14,577,553,400,-153
2020,1,4,15,630,569,398,-171
2020,1,4,16,651,585,404,-181
2020,1,4,17,630,589,413,-176
2020,1,4,18,626,590,413,-177
2020,1,4,19,617,593,418,-175
2020,1,4,20,620,574,407,-167
2020,1,4,21,639,581,338,-243
2020,1,4,22,657,637,385,-252
2020,1,4,23,694,689,423,-266
2020,1,5,0,720,724,421,-303
2020,1,5,1,726,725,420,-305
2020,1,5,2,716,727,419,-308
2020,1,5,3,693,721,421,-300
2020,1,5,4,663,688,410,-278
2020,1,5,5,635,665,421,-244
2020,1,5,6,622,645,419,-226
2020,1,5,7,613,640,419,-221
2020,1,5,8,610,637,420,-217
2020,1,5,9,598,642,421,-221
2020,1,5,10,614,652,419,-233
2020,1,5,11,641,678,418,-260
2020,1,5,12,666,700,418,-282
2020,1,5,13,720,740,471,-269
2020,1,5,14,750,777,593,-184
2020,1,5,15,767,773,595,-178
2020,1,5,16,717,738,501,-237
2020,1,5,17,656,699,454,-245
2020,1,5,18,663,666,417,-249
2020,1,5,19,641,635,420,-215
2020,1,5,20,612,614,421,-193
2020,1,5,21,570,604,420,-184
2020,1,5,22,600,624,423,-201
2020,1,5,23,676,682,424,-258
2020,1,6,0,730,729,422,-307
2020,1,6,1,719,739,424,-315
2020,1,6,2,726,730,421,-309
2020,1,6,3,719,708,420,-288
2020,1,6,4,697,667,417,-250
2020,1,6,5,660,643,422,-221
2020,1,6,6,619,607,413,-194
2020,1,6,7,616,592,417,-175
2020,1,6,8,624,587,422,-165
2020,1,6,9,639,591,423,-168
2020,1,6,10,660,600,423,-177
2020,1,6,11,699,621,480,-141
2020,1,6,12,775,741,701,-40
2020,1,6,13,823,763,697,-66
2020,1,6,14,823,756,583,-173
2020,1,6,15,801,727,519,-208
2020,1,6,16,748,689,445,-244
2020,1,6,17,694,642,385,-257
2020,1,6,18,648,611,396,-215
2020,1,6,19,620,587,339,-248
2020,1,6,20,602,571,331,-240
2020,1,6,21,604,573,333,-240
2020,1,6,22,616,595,391,-204
2020,1,6,23,679,646,403,-243
2020,1,7,0,732,694,443,-251
2020,1,7,1,743,706,502,-204
2020,1,7,2,734,724,511,-213
2020,1,7,3,710,697,505,-192
2020,1,7,4,684,653,503,-150
2020,1,7,5,652,628,484,-144
2020,1,7,6,594,587,423,-164
2020,1,7,7,590,569,415,-154
2020,1,7,8,592,565,416,-149
2020,1,7,9,603,568,416,-152
2020,1,7,10,620,572,435,-137
2020,1,7,11,656,608,495,-113
2020,1,7,12,731,684,520,-164
2020,1,7,13,775,705,518,-187
2020,1,7,14,792,697,517,-180
2020,1,7,15,779,687,518,-169
2020,1,7,16,745,715,462,-253
2020,1,7,17,691,686,426,-260
2020,1,7,18,653,672,423,-249
2020,1,7,19,637,661,424,-237
2020,1,7,20,627,634,424,-210
2020,1,7,21,629,627,421,-206
2020,1,7,22,639,637,421,-216
2020,1,7,23,706,690,423,-267
2020,1,8,0,773,742,424,-318
2020,1,8,1,797,744,426,-318
2020,1,8,2,786,733,422,-311
2020,1,8,3,767,708,425,-283
2020,1,8,4,736,669,424,-245
2020,1,8,5,702,634,420,-214
2020,1,8,6,634,616,422,-194
2020,1,8,7,633,608,420,-188
2020,1,8,8,637,617,421,-196
2020,1,8,9,645,614,432,-182
2020,1,8,10,665,659,476,-183
2020,1,8,11,705,707,477,-230
2020,1,8,12,783,788,478,-310
2020,1,8,13,827,814,478,-336
2020,1,8,14,824,795,479,-316
2020,1,8,15,792,754,462,-292
2020,1,8,16,734,691,430,-261
2020,1,8,17,682,646,392,-254
2020,1,8,18,643,619,335,-284
2020,1,8,19,618,599,327,-272
2020,1,8,20,600,586,324,-262
2020,1,8,21,598,583,370,-213
2020,1,8,22,612,607,415,-192
2020,1,8,23,662,658,416,-242
2020,1,9,0,711,701,417,-284
2020,1,9,1,726,710,419,-291
2020,1,9,2,724,706,417,-289
2020,1,9,3,708,689,417,-272
2020,1,9,4,681,662,416,-246
2020,1,9,5,649,633,414,-219
2020,1,9,6,635,628,415,-213
2020,1,9,7,639,631,413,-218
2020,1,9,8,651,642,415,-227
2020,1,9,9,662,661,413,-248
2020,1,9,10,685,684,413,-271
2020,1,9,11,715,722,472,-250
2020,1,9,12,791,814,509,-305
2020,1,9,13,830,850,510,-340
2020,1,9,14,820,840,505,-335
2020,1,9,15,794,787,423,-364
2020,1,9,16,747,710,393,-317
2020,1,9,17,695,657,412,-245
2020,1,9,18,650,624,421,-203
2020,1,9,19,629,601,392,-209
2020,1,9,20,604,596,397,-199
2020,1,9,21,604,599,393,-206
2020,1,9,22,618,627,438,-189
2020,1,9,23,669,668,458,-210
2020,1,10,0,709,712,466,-246
2020,1,10,1,721,698,453,-245
2020,1,10,2,710,680,452,-228
2020,1,10,3,684,651,453,-198
2020,1,10,4,644,600,452,-148
2020,1,10,5,607,560,455,-105
2020,1,10,6,580,519,440,-79
2020,1,10,7,571,502,441,-61
2020,1,10,8,566,500,442,-58
2020,1,10,9,568,498,443,-55
2020,1,10,10,586,511,442,-69
2020,1,10,11,617,545,442,-103
2020,1,10,12,688,608,443,-165
2020,1,10,13,728,630,439,-191
2020,1,10,14,715,625,442,-183
2020,1,10,15,697,622,443,-179
2020,1,10,16,666,612,440,-172
2020,1,10,17,633,602,441,-161
2020,1,10,18,611,581,343,-238
2020,1,10,19,599,566,292,-274
2020,1,10,20,584,552,287,-265
2020,1,10,21,587,549,336,-213
2020,1,10,22,593,558,335,-223
2020,1,10,23,618,581,333,-248
2020,1,11,0,640,603,335,-268
2020,1,11,1,633,587,326,-261
2020,1,11,2,615,573,332,-241
2020,1,11,3,583,549,329,-220
2020,1,11,4,544,522,289,-233
2020,1,11,5,513,483,250,-233
2020,1,11,6,471,457,246,-211
2020,1,11,7,468,435,248,-187
2020,1,11,8,460,424,249,-175
2020,1,11,9,459,423,250,-173
2020,1,11,10,470,425,250,-175
2020,1,11,11,480,437,248,-189
2020,1,11,12,502,456,247,-209
2020,1,11,13,524,485,251,-234
2020,1,11,14,564,513,253,-260
2020,1,11,15,586,531,251,-280
2020,1,11,16,603,549,253,-296
2020,1,11,17,587,549,255,-294
2020,1,11,18,579,533,252,-281
2020,1,11,19,558,527,252,-275
2020,1,11,20,542,515,252,-263
2020,1,11,21,532,514,252,-262
2020,1,11,22,546,523,252,-271
2020,1,11,23,553,552,254,-298
2020,1,12,0,571,554,255,-299
2020,1,12,1,563,537,255,-282
2020,1,12,2,552,515,257,-258
2020,1,12,3,531,492,256,-236
2020,1,12,4,503,468,258,-210
2020,1,12,5,497,435,256,-179
2020,1,12,6,477,403,250,-153
2020,1,12,7,461,386,251,-135
2020,1,12,8,454,381,229,-152
2020,1,12,9,449,386,176,-210
2020,1,12,10,458,399,177,-222
2020,1,12,11,467,418,178,-240
2020,1,12,12,489,454,185,-269
2020,1,12,13,536,502,187,-315
2020,1,12,14,588,543,195,-348
2020,1,12,15,600,553,252,-301
2020,1,12,16,579,536,308,-228
2020,1,12,17,559,513,371,-142
2020,1,12,18,542,502,370,-132
2020,1,12,19,528,495,369,-126
2020,1,12,20,516,487,368,-119
2020,1,12,21,508,460,241,-219
2020,1,12,22,527,616,435,-181
2020,1,12,23,554,545,443,-102
2020,1,13,0,599,575,439,-136
2020,1,13,1,597,577,441,-136
2020,1,13,2,586,565,442,-123
2020,1,13,3,562,541,439,-102
2020,1,13,4,530,510,436,-74
2020,1,13,5,478,479,412,-67
2020,1,13,6,438,456,374,-82
2020,1,13,7,429,448,377,-71
2020,1,13,8,428,448,377,-71
2020,1,13,9,436,457,379,-78
2020,1,13,10,448,471,377,-94
2020,1,13,11,487,511,378,-133
2020,1,13,12,562,582,427,-155
2020,1,13,13,602,625,431,-194
2020,1,13,14,590,627,427,-200
2020,1,13,15,584,626,415,-211
2020,1,13,16,575,623,428,-195
2020,1,13,17,565,611,440,-171
2020,1,13,18,557,602,447,-155
2020,1,13,19,543,590,445,-145
2020,1,13,20,539,568,432,-136
2020,1,13,21,538,561,433,-128
2020,1,13,22,544,573,434,-139
2020,1,13,23,566,607,441,-166
2020,1,14,0,598,634,443,-191
2020,1,14,1,600,625,442,-183
2020,1,14,2,581,601,431,-170
2020,1,14,3,547,566,428,-138
2020,1,14,4,508,523,423,-100
2020,1,14,5,462,475,395,-80
2020,1,14,6,445,458,375,-83
2020,1,14,7,430,440,368,-72
2020,1,14,8,430,429,371,-58
2020,1,14,9,429,426,369,-57
2020,1,14,10,440,435,372,-63
2020,1,14,11,489,470,381,-89
2020,1,14,12,567,539,383,-156
2020,1,14,13,595,571,411,-160
2020,1,14,14,591,573,426,-147
2020,1,14,15,579,576,392,-184
2020,1,14,16,568,578,400,-178
2020,1,14,17,554,576,334,-242
2020,1,14,18,538,565,301,-264
2020,1,14,19,532,550,297,-253
2020,1,14,20,523,539,294,-245
2020,1,14,21,528,540,286,-254
2020,1,14,22,535,558,197,-361
2020,1,14,23,562,585,232,-353
2020,1,15,0,594,600,270,-330
2020,1,15,1,603,606,335,-271
2020,1,15,2,585,577,288,-289
2020,1,15,3,554,549,220,-329
2020,1,15,4,518,511,189,-322
2020,1,15,5,480,471,189,-282
2020,1,15,6,423,445,188,-257
2020,1,15,7,413,433,189,-244
2020,1,15,8,411,425,189,-236
2020,1,15,9,411,430,190,-240
2020,1,15,10,426,440,191,-249
2020,1,15,11,463,480,211,-269
2020,1,15,12,536,546,241,-305
2020,1,15,13,571,577,247,-330
2020,1,15,14,563,582,192,-390
2020,1,15,15,556,572,236,-336
2020,1,15,16,556,562,294,-268
2020,1,15,17,533,553,290,-263
2020,1,15,18,526,543,290,-253
2020,1,15,19,517,537,298,-239
2020,1,15,20,513,532,297,-235
2020,1,15,21,519,534,295,-239
2020,1,15,22,523,543,300,-243
2020,1,15,23,546,575,355,-220
2020,1,16,0,573,599,400,-199
2020,1,16,1,575,588,390,-198
2020,1,16,2,564,572,391,-181
2020,1,16,3,534,548,362,-186
2020,1,16,4,496,503,296,-207
2020,1,16,5,457,456,277,-179
2020,1,16,6,431,439,269,-170
2020,1,16,7,419,426,263,-163
2020,1,16,8,423,417,264,-153
2020,1,16,9,428,420,264,-156
2020,1,16,10,450,430,262,-168
2020,1,16,11,499,470,287,-183
2020,1,16,12,576,541,298,-243
2020,1,16,13,618,577,297,-280
2020,1,16,14,608,591,294,-297
2020,1,16,15,599,589,290,-299
2020,1,16,16,562,583,185,-398
2020,1,16,17,555,571,181,-390
2020,1,16,18,548,572,185,-387
2020,1,16,19,537,560,182,-378
2020,1,16,20,536,547,187,-360
2020,1,16,21,543,566,201,-365
2020,1,16,22,565,594,250,-344
2020,1,16,23,619,640,318,-322
2020,1,17,0,668,694,440,-254
2020,1,17,1,689,698,452,-246
2020,1,17,2,690,689,428,-261
2020,1,17,3,669,677,479,-198
2020,1,17,4,636,637,496,-141
2020,1,17,5,600,615,455,-160
2020,1,17,6,584,596,452,-144
2020,1,17,7,579,599,469,-130
2020,1,17,8,584,606,501,-105
2020,1,17,9,593,609,467,-142
2020,1,17,10,617,632,524,-108
2020,1,17,11,648,673,579,-94
2020,1,17,12,729,752,662,-90
2020,1,17,13,769,785,681,-104
2020,1,17,14,770,778,619,-159
2020,1,17,15,735,755,600,-155
2020,1,17,16,687,711,587,-124
2020,1,17,17,660,663,456,-207
2020,1,17,18,655,649,393,-256
2020,1,17,19,632,639,379,-260
2020,1,17,20,623,633,382,-251
2020,1,17,21,608,643,382,-261
2020,1,17,22,615,668,495,-173
2020,1,17,23,662,704,541,-163
2020,1,18,0,715,719,536,-183
2020,1,18,1,719,716,543,-173
2020,1,18,2,715,702,545,-157
2020,1,18,3,700,686,539,-147
2020,1,18,4,676,654,541,-113
2020,1,18,5,640,619,549,-70
2020,1,18,6,633,604,552,-52
2020,1,18,7,628,594,550,-44
2020,1,18,8,628,587,549,-38
2020,1,18,9,634,597,549,-48
2020,1,18,10,660,611,552,-59
2020,1,18,11,688,631,550,-81
2020,1,18,12,723,659,551,-108
2020,1,18,13,765,688,549,-139
2020,1,18,14,794,724,552,-172
2020,1,18,15,792,744,549,-195
2020,1,18,16,775,748,552,-196
2020,1,18,17,727,742,549,-193
2020,1,18,18,682,731,552,-179
2020,1,18,19,638,718,549,-169
2020,1,18,20,621,699,550,-149
2020,1,18,21,630,681,551,-130
2020,1,18,22,637,675,551,-124
2020,1,18,23,667,686,551,-135
2020,1,19,0,698,686,548,-138
2020,1,19,1,694,665,551,-114
2020,1,19,2,679,640,549,-91
2020,1,19,3,648,612,551,-61
2020,1,19,4,620,576,547,-29
2020,1,19,5,575,541,524,-17
2020,1,19,6,556,516,505,-11
2020,1,19,7,556,508,475,-33
2020,1,19,8,554,501,465,-36
2020,1,19,9,561,508,467,-41
2020,1,19,10,579,516,476,-40
2020,1,19,11,602,542,511,-31
2020,1,19,12,636,580,495,-85
2020,1,19,13,679,635,481,-154
2020,1,19,14,723,693,485,-208
2020,1,19,15,728,720,477,-243
2020,1,19,16,683,687,465,-222
2020,1,19,17,658,662,432,-230
2020,1,19,18,645,640,440,-200
2020,1,19,19,633,630,398,-232
2020,1,19,20,611,612,380,-232
2020,1,19,21,610,617,409,-208
2020,1,19,22,622,652,471,-181
2020,1,19,23,681,715,480,-235
2020,1,20,0,752,780,537,-243
2020,1,20,1,758,796,544,-252
2020,1,20,2,766,802,545,-257
2020,1,20,3,752,800,543,-257
2020,1,20,4,738,781,529,-252
2020,1,20,5,719,765,509,-256
2020,1,20,6,760,756,506,-250
2020,1,20,7,762,765,483,-282
2020,1,20,8,772,767,414,-353
2020,1,20,9,786,779,381,-398
2020,1,20,10,818,802,402,-400
2020,1,20,11,850,813,546,-267
2020,1,20,12,911,894,705,-189
2020,1,20,13,955,934,720,-214
2020,1,20,14,970,953,586,-367
2020,1,20,15,941,962,547,-415
2020,1,20,16,908,935,635,-300
2020,1,20,17,859,902,649,-253
2020,1,20,18,802,841,616,-225
2020,1,20,19,766,834,495,-339
2020,1,20,20,761,818,485,-333
2020,1,20,21,754,833,525,-308
2020,1,20,22,788,858,623,-235
2020,1,20,23,849,917,674,-243
2020,1,21,0,912,968,729,-239
2020,1,21,1,929,963,698,-265
2020,1,21,2,918,947,768,-179
2020,1,21,3,898,911,740,-171
2020,1,21,4,863,869,682,-187
2020,1,21,5,816,836,629,-207
2020,1,21,6,796,817,626,-191
2020,1,21,7,810,808,626,-182
2020,1,21,8,824,808,625,-183
2020,1,21,9,835,817,627,-190
2020,1,21,10,872,836,676,-160
2020,1,21,11,906,887,792,-95
2020,1,21,12,976,956,895,-61
2020,1,21,13,1017,990,854,-136
2020,1,21,14,1021,998,804,-194
2020,1,21,15,977,985,811,-174
2020,1,21,16,926,954,751,-203
2020,1,21,17,896,897,626,-271
2020,1,21,18,834,851,620,-231
2020,1,21,19,794,801,553,-248
2020,1,21,20,774,781,553,-228
2020,1,21,21,764,770,554,-216
2020,1,21,22,786,795,557,-238
2020,1,21,23,846,875,666,-209
2020,1,22,0,912,921,735,-186
2020,1,22,1,922,933,736,-197
2020,1,22,2,922,932,735,-197
2020,1,22,3,902,911,714,-197
2020,1,22,4,878,977,723,-254
2020,1,22,5,845,853,617,-236
2020,1,22,6,837,848,589,-259
2020,1,22,7,847,856,589,-267
2020,1,22,8,864,866,611,-255
2020,1,22,9,872,886,616,-270
2020,1,22,10,899,914,622,-292
2020,1,22,11,937,972,688,-284
2020,1,22,12,1007,1054,803,-251
2020,1,22,13,1036,1080,923,-157
2020,1,22,14,1028,1043,906,-137
2020,1,22,15,971,972,714,-258
2020,1,22,16,897,893,623,-270
2020,1,22,17,810,810,589,-221
2020,1,22,18,753,753,521,-232
2020,1,22,19,717,710,518,-192
2020,1,22,20,678,690,509,-181
2020,1,22,21,665,687,527,-160
2020,1,22,22,673,681,540,-141
2020,1,22,23,731,737,468,-269
2020,1,23,0,792,795,549,-246
2020,1,23,1,802,811,553,-258
2020,1,23,2,800,811,553,-258
2020,1,23,3,782,783,554,-229
2020,1,23,4,750,744,552,-192
2020,1,23,5,721,705,548,-157
2020,1,23,6,697,689,549,-140
2020,1,23,7,701,682,547,-135
2020,1,23,8,710,684,553,-131
2020,1,23,9,721,688,553,-135
2020,1,23,10,749,700,552,-148
2020,1,23,11,797,744,556,-188
2020,1,23,12,880,810,608,-202
2020,1,23,13,935,832,684,-148
2020,1,23,14,931,818,695,-123
2020,1,23,15,886,803,627,-176
2020,1,23,16,829,786,625,-161
2020,1,23,17,788,750,548,-202
2020,1,23,18,754,692,531,-161
2020,1,23,19,712,652,529,-123
2020,1,23,20,673,635,525,-110
2020,1,23,21,661,627,526,-101
2020,1,23,22,668,650,541,-109
2020,1,23,23,714,689,550,-139
2020,1,24,0,774,727,551,-176
2020,1,24,1,783,721,551,-170
2020,1,24,2,773,711,553,-158
2020,1,24,3,753,701,553,-148
2020,1,24,4,703,707,543,-164
2020,1,24,5,654,607,529,-78
2020,1,24,6,614,584,528,-56
2020,1,24,7,607,579,529,-50
2020,1,24,8,611,579,530,-49
2020,1,24,9,615,581,532,-49
2020,1,24,10,637,595,532,-63
2020,1,24,11,672,630,543,-87
2020,1,24,12,737,695,555,-140
2020,1,24,13,774,723,552,-171
2020,1,24,14,781,721,552,-169
2020,1,24,15,769,727,553,-174
2020,1,24,16,737,731,551,-180
2020,1,24,17,713,723,548,-175
2020,1,24,18,689,703,538,-165
2020,1,24,19,669,691,539,-152
2020,1,24,20,654,674,534,-140
2020,1,24,21,649,662,538,-124
2020,1,24,22,657,651,560,-91
2020,1,24,23,688,670,468,-202
2020,1,25,0,726,694,446,-248
2020,1,25,1,728,686,442,-244
2020,1,25,2,720,678,445,-233
2020,1,25,3,700,649,434,-215
2020,1,25,4,680,613,433,-180
2020,1,25,5,655,588,462,-126
2020,1,25,6,614,569,460,-109
2020,1,25,7,606,564,462,-102
2020,1,25,8,600,573,466,-107
2020,1,25,9,610,576,464,-112
2020,1,25,10,620,588,468,-120
2020,1,25,11,642,604,463,-141
2020,1,25,12,668,641,457,-184
2020,1,25,13,703,670,437,-233
2020,1,25,14,750,721,446,-275
2020,1,25,15,755,732,446,-286
2020,1,25,16,731,733,432,-301
2020,1,25,17,705,710,410,-300
2020,1,25,18,664,691,396,-295
2020,1,25,19,625,669,393,-276
2020,1,25,20,623,648,393,-255
2020,1,25,21,611,642,406,-236
2020,1,25,22,625,661,459,-202
2020,1,25,23,647,706,489,-217
2020,1,26,0,690,746,501,-245
2020,1,26,1,705,755,561,-194
2020,1,26,2,700,754,436,-318
2020,1,26,3,684,740,436,-304
2020,1,26,4,665,712,433,-279
2020,1,26,5,650,685,432,-253
2020,1,26,6,617,670,433,-237
2020,1,26,7,622,663,431,-232
2020,1,26,8,618,661,436,-225
2020,1,26,9,626,667,440,-227
2020,1,26,10,626,685,465,-220
2020,1,26,11,658,704,471,-233
2020,1,26,12,685,741,511,-230
2020,1,26,13,732,781,539,-242
2020,1,26,14,776,808,535,-273
2020,1,26,15,779,775,470,-305
2020,1,26,16,720,728,495,-233
2020,1,26,17,686,681,510,-171
2020,1,26,18,672,647,495,-152
2020,1,26,19,651,635,460,-175
2020,1,26,20,618,633,365,-268
2020,1,26,21,607,624,400,-224
2020,1,26,22,628,616,484,-132
2020,1,26,23,670,668,471,-197
2020,1,27,0,715,801,565,-236
2020,1,27,1,723,748,494,-254
2020,1,27,2,724,699,465,-234
2020,1,27,3,694,669,465,-204
2020,1,27,4,670,628,463,-165
2020,1,27,5,637,596,466,-130
2020,1,27,6,618,576,465,-111
2020,1,27,7,621,567,483,-84
2020,1,27,8,625,568,536,-32
2020,1,27,9,643,574,550,-24
2020,1,27,10,663,590,552,-38
2020,1,27,11,704,638,555,-83
2020,1,27,12,783,715,553,-162
2020,1,27,13,822,748,552,-196
2020,1,27,14,827,749,554,-195
2020,1,27,15,796,738,546,-192
2020,1,27,16,741,724,537,-187
2020,1,27,17,702,719,538,-181
2020,1,27,18,669,711,535,-176
2020,1,27,19,647,697,532,-165
2020,1,27,20,620,673,536,-137
2020,1,27,21,612,668,536,-132
2020,1,27,22,619,686,541,-145
2020,1,27,23,647,729,550,-179
2020,1,28,0,706,756,552,-204
2020,1,28,1,718,749,554,-195
2020,1,28,2,716,736,555,-181
2020,1,28,3,692,720,552,-168
2020,1,28,4,656,684,537,-147
2020,1,28,5,617,632,533,-99
2020,1,28,6,615,609,535,-74
2020,1,28,7,607,607,550,-57
2020,1,28,8,617,609,548,-61
2020,1,28,9,630,616,548,-68
2020,1,28,10,651,638,546,-92
2020,1,28,11,699,685,553,-132
2020,1,28,12,789,760,558,-202
2020,1,28,13,833,802,558,-244
2020,1,28,14,839,799,557,-242
2020,1,28,15,801,749,519,-230
2020,1,28,16,742,696,503,-193
2020,1,28,17,694,654,438,-216
2020,1,28,18,654,632,442,-190
2020,1,28,19,633,607,438,-169
2020,1,28,20,596,587,435,-152
2020,1,28,21,598,581,455,-126
2020,1,28,22,616,600,490,-110
2020,1,28,23,658,648,536,-112
2020,1,29,0,729,702,548,-154
2020,1,29,1,755,720,552,-168
2020,1,29,2,748,714,553,-161
2020,1,29,3,727,692,554,-138
2020,1,29,4,686,660,556,-104
2020,1,29,5,638,629,550,-79
2020,1,29,6,619,625,549,-76
2020,1,29,7,615,620,549,-71
2020,1,29,8,620,637,556,-81
2020,1,29,9,636,656,559,-97
2020,1,29,10,663,678,556,-122
2020,1,29,11,708,728,557,-171
2020,1,29,12,795,744,558,-186
2020,1,29,13,837,661,559,-102
2020,1,29,14,845,668,557,-111
2020,1,29,15,815,790,549,-241
2020,1,29,16,775,750,533,-217
2020,1,29,17,728,704,525,-179
2020,1,29,18,700,675,527,-148
2020,1,29,19,680,654,531,-123
2020,1,29,20,649,627,543,-84
2020,1,29,21,622,630,532,-98
2020,1,29,22,641,648,533,-115
2020,1,29,23,687,686,548,-138
2020,1,30,0,754,722,549,-173
2020,1,30,1,773,720,552,-168
2020,1,30,2,766,703,550,-153
2020,1,30,3,753,673,552,-121
2020,1,30,4,712,630,525,-105
2020,1,30,5,662,588,500,-88
2020,1,30,6,646,570,494,-76
2020,1,30,7,639,559,534,-25
2020,1,30,8,642,562,528,-34
2020,1,30,9,658,567,530,-37
2020,1,30,10,672,580,531,-49
2020,1,30,11,714,623,521,-102
2020,1,30,12,803,693,553,-140
2020,1,30,13,845,729,557,-172
2020,1,30,14,839,728,525,-203
2020,1,30,15,798,714,499,-215
2020,1,30,16,739,699,487,-212
2020,1,30,17,681,683,451,-232
2020,1,30,18,647,647,427,-220
2020,1,30,19,620,622,428,-194
2020,1,30,20,586,600,433,-167
2020,1,30,21,583,593,471,-122
2020,1,30,22,599,610,495,-115
2020,1,30,23,636,648,541,-107
2020,1,31,0,698,695,553,-142
2020,1,31,1,718,698,553,-145
2020,1,31,2,712,687,554,-133
2020,1,31,3,697,658,557,-101
2020,1,31,4,670,616,556,-60
2020,1,31,5,637,573,547,-26
2020,1,31,6,624,560,548,-12
2020,1,31,7,617,549,541,-8
2020,1,31,8,619,558,547,-11
2020,1,31,9,631,570,558,-12
2020,1,31,10,643,599,558,-41
2020,1,31,11,684,646,559,-87
2020,1,31,12,761,727,561,-166
2020,1,31,13,798,763,560,-203
2020,1,31,14,797,761,559,-202
2020,1,31,15,764,762,558,-204
2020,1,31,16,714,765,563,-202
2020,1,31,17,671,767,562,-205
2020,1,31,18,639,765,561,-204
2020,1,31,19,618,756,560,-196
2020,1,31,20,590,743,560,-183
2020,1,31,21,576,741,560,-181
2020,1,31,22,589,734,559,-175
2020,1,31,23,619,746,562,-184
2020,2,1,0,669,754,560,-194
2020,2,1,1,676,740,560,-180
2020,2,1,2,672,728,560,-168
2020,2,1,3,658,701,560,-141
2020,2,1,4,631,669,560,-109
2020,2,1,5,587,631,560,-71
2020,2,1,6,579,609,559,-50
2020,2,1,7,568,597,550,-47
2020,2,1,8,562,587,534,-53
2020,2,1,9,563,592,535,-57
2020,2,1,10,566,601,536,-65
2020,2,1,11,588,616,547,-69
2020,2,1,12,626,646,554,-92
2020,2,1,13,653,679,554,-125
2020,2,1,14,688,711,554,-157
2020,2,1,15,700,719,544,-175
2020,2,1,16,683,689,297,-392
2020,2,1,17,649,663,440,-223
2020,2,1,18,615,636,416,-220
2020,2,1,19,592,617,411,-206
2020,2,1,20,583,608,502,-106
2020,2,1,21,595,618,561,-57
2020,2,1,22,605,639,548,-91
2020,2,1,23,628,665,544,-121
2020,2,2,0,653,699,552,-147
2020,2,2,1,668,698,551,-147
2020,2,2,2,662,689,543,-146
2020,2,2,3,643,670,518,-152
2020,2,2,4,625,644,510,-134
2020,2,2,5,589,618,498,-120
2020,2,2,6,566,603,500,-103
2020,2,2,7,554,597,499,-98
2020,2,2,8,573,596,500,-96
2020,2,2,9,572,601,502,-99
2020,2,2,10,577,610,507,-103
2020,2,2,11,609,635,520,-115
2020,2,2,12,650,670,520,-150
2020,2,2,13,694,709,523,-186
2020,2,2,14,730,736,534,-202
2020,2,2,15,717,704,544,-160
2020,2,2,16,660,649,524,-125
2020,2,2,17,622,602,473,-129
2020,2,2,18,593,576,462,-114
2020,2,2,19,561,548,457,-91
2020,2,2,20,549,527,455,-72
2020,2,2,21,532,522,451,-71
2020,2,2,22,549,533,463,-70
2020,2,2,23,577,562,500,-62
2020,2,3,0,612,588,526,-62
2020,2,3,1,607,583,462,-121
2020,2,3,2,598,575,457,-118
2020,2,3,3,594,562,455,-107
2020,2,3,4,579,542,456,-86
2020,2,3,5,553,510,447,-63
2020,2,3,6,498,491,454,-37
2020,2,3,7,495,486,456,-30
2020,2,3,8,498,500,464,-36
2020,2,3,9,510,514,466,-48
2020,2,3,10,531,539,482,-57
2020,2,3,11,577,588,526,-62
2020,2,3,12,669,669,532,-137
2020,2,3,13,700,702,536,-166
2020,2,3,14,697,692,530,-162
2020,2,3,15,666,652,490,-162
2020,2,3,16,622,608,443,-165
2020,2,3,17,589,543,295,-248
2020,2,3,18,563,566,286,-280
2020,2,3,19,549,568,291,-277
2020,2,3,20,531,529,266,-263
2020,2,3,21,526,523,286,-237
2020,2,3,22,532,533,334,-199
2020,2,3,23,557,557,338,-219
2020,2,4,0,607,603,338,-265
2020,2,4,1,620,602,337,-265
2020,2,4,2,610,585,341,-244
2020,2,4,3,577,554,342,-212
2020,2,4,4,538,508,340,-168
2020,2,4,5,491,474,297,-177
2020,2,4,6,471,436,274,-162
2020,2,4,7,458,436,282,-154
2020,2,4,8,458,433,287,-146
2020,2,4,9,468,436,287,-149
2020,2,4,10,487,453,338,-115
2020,2,4,11,535,489,348,-141
2020,2,4,12,617,560,349,-211
2020,2,4,13,649,595,349,-246
2020,2,4,14,645,596,352,-244
2020,2,4,15,629,593,350,-243
2020,2,4,16,605,589,347,-242
2020,2,4,17,592,591,347,-244
2020,2,4,18,572,593,266,-327
2020,2,4,19,558,585,261,-324
2020,2,4,20,538,575,264,-311
2020,2,4,21,533,576,275,-301
2020,2,4,22,548,580,286,-294
2020,2,4,23,564,603,344,-259
2020,2,5,0,604,632,441,-191
2020,2,5,1,607,633,452,-181
2020,2,5,2,593,608,451,-157
2020,2,5,3,563,570,424,-146
2020,2,5,4,527,533,341,-192
2020,2,5,5,485,495,325,-170
2020,2,5,6,459,464,291,-173
2020,2,5,7,450,445,276,-169
2020,2,5,8,448,437,228,-209
2020,2,5,9,452,429,206,-223
2020,2,5,10,466,440,222,-218
2020,2,5,11,499,481,332,-149
2020,2,5,12,573,549,345,-204
2020,2,5,13,604,580,344,-236
2020,2,5,14,604,576,348,-228
2020,2,5,15,588,578,349,-229
2020,2,5,16,573,585,349,-236
2020,2,5,17,564,577,349,-228
2020,2,5,18,550,573,323,-250
2020,2,5,19,539,571,350,-221
2020,2,5,20,526,563,349,-214
2020,2,5,21,525,568,346,-222
2020,2,5,22,530,584,349,-235
2020,2,5,23,544,604,381,-223
2020,2,6,0,580,621,447,-174
2020,2,6,1,588,605,391,-214
2020,2,6,2,574,585,411,-174
2020,2,6,3,547,547,377,-170
2020,2,6,4,512,508,286,-222
2020,2,6,5,464,468,257,-211
2020,2,6,6,436,436,255,-181
2020,2,6,7,428,422,254,-168
2020,2,6,8,428,415,256,-159
2020,2,6,9,430,419,259,-160
2020,2,6,10,444,422,256,-166
2020,2,6,11,473,460,209,-251
2020,2,6,12,552,521,219,-302
2020,2,6,13,584,563,258,-305
2020,2,6,14,586,571,258,-313
2020,2,6,15,584,582,258,-324
2020,2,6,16,573,583,258,-325
2020,2,6,17,563,583,209,-374
2020,2,6,18,550,572,184,-388
2020,2,6,19,541,573,186,-387
2020,2,6,20,535,572,212,-360
2020,2,6,21,535,573,255,-318
2020,2,6,22,540,584,255,-329
2020,2,6,23,553,601,301,-300
2020,2,7,0,606,618,429,-189
2020,2,7,1,618,610,395,-215
2020,2,7,2,605,590,371,-219
2020,2,7,3,585,554,287,-267
2020,2,7,4,564,514,188,-326
2020,2,7,5,541,483,184,-299
2020,2,7,6,461,459,183,-276
2020,2,7,7,455,450,186,-264
2020,2,7,8,461,452,186,-266
2020,2,7,9,472,459,188,-271
2020,2,7,10,494,487,187,-300
2020,2,7,11,539,549,199,-350
2020,2,7,12,626,632,269,-363
2020,2,7,13,663,695,281,-414
2020,2,7,14,674,722,382,-340
2020,2,7,15,672,739,455,-284
2020,2,7,16,671,759,461,-298
2020,2,7,17,657,765,469,-296
2020,2,7,18,643,762,484,-278
2020,2,7,19,642,747,484,-263
2020,2,7,20,646,734,484,-250
2020,2,7,21,653,736,501,-235
2020,2,7,22,671,757,517,-240
2020,2,7,23,699,790,537,-253
2020,2,8,0,743,835,542,-293
2020,2,8,1,759,836,537,-299
2020,2,8,2,752,825,539,-286
2020,2,8,3,737,801,539,-262
2020,2,8,4,719,765,538,-227
2020,2,8,5,697,739,540,-199
2020,2,8,6,684,720,539,-181
2020,2,8,7,690,709,537,-172
2020,2,8,8,693,716,542,-174
2020,2,8,9,698,726,540,-186
2020,2,8,10,712,740,539,-201
2020,2,8,11,743,768,558,-210
2020,2,8,12,771,810,712,-98
2020,2,8,13,812,855,717,-138
2020,2,8,14,823,877,679,-198
2020,2,8,15,784,871,642,-229
2020,2,8,16,748,853,602,-251
2020,2,8,17,715,835,587,-248
2020,2,8,18,665,824,540,-284
2020,2,8,19,624,808,538,-270
2020,2,8,20,620,791,541,-250
2020,2,8,21,596,775,538,-237
2020,2,8,22,618,752,539,-213
2020,2,8,23,644,767,539,-228
2020,2,9,0,693,806,640,-166
2020,2,9,1,720,814,713,-101
2020,2,9,2,709,806,671,-135
2020,2,9,3,692,789,629,-160
2020,2,9,4,678,717,529,-188
2020,2,9,5,645,729,521,-208
2020,2,9,6,638,710,530,-180
2020,2,9,7,624,703,529,-174
2020,2,9,8,626,700,536,-164
2020,2,9,9,648,699,538,-161
2020,2,9,10,650,715,541,-174
2020,2,9,11,674,739,540,-199
2020,2,9,12,698,769,539,-230
2020,2,9,13,732,808,539,-269
2020,2,9,14,751,843,520,-323
2020,2,9,15,736,832,420,-412
2020,2,9,16,674,769,438,-331
2020,2,9,17,634,697,513,-184
2020,2,9,18,599,638,450,-188
2020,2,9,19,575,599,423,-176
2020,2,9,20,548,574,423,-151
2020,2,9,21,545,561,443,-118
2020,2,9,22,554,577,476,-101
2020,2,9,23,604,613,519,-94
2020,2,10,0,646,672,541,-131
2020,2,10,1,663,694,544,-150
2020,2,10,2,659,694,540,-154
2020,2,10,3,635,673,541,-132
2020,2,10,4,605,642,539,-103
2020,2,10,5,571,618,542,-76
2020,2,10,6,580,603,541,-62
2020,2,10,7,573,594,539,-55
2020,2,10,8,572,595,543,-52
2020,2,10,9,576,595,540,-55
2020,2,10,10,591,610,542,-68
2020,2,10,11,628,645,540,-105
2020,2,10,12,705,710,539,-171
2020,2,10,13,740,730,535,-195
2020,2,10,14,719,715,534,-181
2020,2,10,15,683,710,438,-272
2020,2,10,16,660,704,403,-301
2020,2,10,17,628,703,478,-225
2020,2,10,18,614,688,489,-199
2020,2,10,19,612,669,520,-149
2020,2,10,20,592,654,528,-126
2020,2,10,21,578,642,536,-106
2020,2,10,22,587,652,536,-116
2020,2,10,23,611,666,534,-132
2020,2,11,0,646,692,536,-156
2020,2,11,1,651,681,537,-144
2020,2,11,2,629,657,537,-120
2020,2,11,3,593,615,528,-87
2020,2,11,4,546,567,487,-80
2020,2,11,5,504,501,426,-75
2020,2,11,6,477,489,369,-120
2020,2,11,7,465,473,353,-120
2020,2,11,8,463,466,354,-112
2020,2,11,9,453,464,351,-113
2020,2,11,10,461,475,353,-122
2020,2,11,11,496,508,352,-156
2020,2,11,12,559,578,353,-225
2020,2,11,13,595,607,352,-255
2020,2,11,14,595,605,350,-255
2020,2,11,15,585,604,349,-255
2020,2,11,16,587,594,349,-245
2020,2,11,17,577,578,299,-279
2020,2,11,18,566,573,345,-228
2020,2,11,19,557,556,347,-209
2020,2,11,20,543,543,346,-197
2020,2,11,21,540,540,347,-193
2020,2,11,22,550,549,348,-201
2020,2,11,23,561,567,348,-219
2020,2,12,0,598,603,351,-252
2020,2,12,1,606,608,351,-257
2020,2,12,2,589,587,349,-238
2020,2,12,3,557,558,350,-208
2020,2,12,4,514,516,347,-169
2020,2,12,5,477,461,304,-157
2020,2,12,6,450,446,311,-135
2020,2,12,7,437,432,306,-126
2020,2,12,8,436,429,285,-144
2020,2,12,9,440,449,281,-168
2020,2,12,10,454,484,283,-201
2020,2,12,11,495,524,297,-227
2020,2,12,12,564,595,358,-237
2020,2,12,13,604,634,359,-275
2020,2,12,14,599,636,358,-278
2020,2,12,15,595,631,356,-275
2020,2,12,16,595,615,298,-317
2020,2,12,17,594,613,355,-258
2020,2,12,18,590,596,359,-237
2020,2,12,19,585,589,357,-232
2020,2,12,20,561,578,355,-223
2020,2,12,21,553,578,357,-221
2020,2,12,22,564,591,359,-232
2020,2,12,23,577,613,355,-258
2020,2,13,0,615,640,359,-281
2020,2,13,1,617,632,356,-276
2020,2,13,2,610,616,359,-257
2020,2,13,3,580,577,355,-222
2020,2,13,4,554,529,352,-177
2020,2,13,5,506,486,350,-136
2020,2,13,6,458,457,311,-146
2020,2,13,7,445,440,283,-157
2020,2,13,8,441,431,287,-144
2020,2,13,9,448,429,276,-153
2020,2,13,10,465,435,291,-144
2020,2,13,11,516,472,346,-126
2020,2,13,12,592,537,350,-187
2020,2,13,13,627,579,351,-228
2020,2,13,14,627,583,350,-233
2020,2,13,15,617,587,348,-239
2020,2,13,16,584,584,350,-234
2020,2,13,17,583,575,347,-228
2020,2,13,18,580,563,346,-217
2020,2,13,19,547,549,343,-206
2020,2,13,20,542,540,352,-188
2020,2,13,21,540,544,351,-193
2020,2,13,22,553,574,358,-216
2020,2,13,23,572,619,510,-109
2020,2,14,0,628,668,537,-131
2020,2,14,1,663,690,539,-151
2020,2,14,2,667,693,533,-160
2020,2,14,3,656,677,532,-145
2020,2,14,4,625,643,498,-145
2020,2,14,5,607,625,484,-141
2020,2,14,6,597,606,479,-127
2020,2,14,7,594,612,481,-131
2020,2,14,8,603,618,479,-139
2020,2,14,9,617,631,524,-107
2020,2,14,10,640,660,536,-124
2020,2,14,11,672,705,537,-168
2020,2,14,12,754,784,556,-228
2020,2,14,13,796,827,556,-271
2020,2,14,14,809,805,546,-259
2020,2,14,15,778,782,548,-234
2020,2,14,16,727,730,513,-217
2020,2,14,17,691,703,457,-246
2020,2,14,18,640,666,435,-231
2020,2,14,19,621,644,380,-264
2020,2,14,20,605,629,383,-246
2020,2,14,21,601,627,427,-200
2020,2,14,22,602,642,445,-197
2020,2,14,23,646,688,491,-197
2020,2,15,0,685,752,532,-220
2020,2,15,1,703,772,542,-230
2020,2,15,2,692,776,544,-232
2020,2,15,3,684,770,544,-226
2020,2,15,4,668,754,539,-215
2020,2,15,5,660,732,532,-200
2020,2,15,6,679,721,529,-192
2020,2,15,7,684,724,529,-195
2020,2,15,8,691,738,532,-206
2020,2,15,9,694,750,537,-213
2020,2,15,10,720,767,538,-229
2020,2,15,11,756,798,541,-257
2020,2,15,12,795,837,544,-293
2020,2,15,13,837,878,576,-302
2020,2,15,14,849,879,598,-281
2020,2,15,15,829,828,558,-270
2020,2,15,16,780,777,536,-241
2020,2,15,17,729,725,530,-195
2020,2,15,18,684,676,482,-194
2020,2,15,19,642,635,462,-173
2020,2,15,20,608,606,443,-163
2020,2,15,21,577,601,454,-147
2020,2,15,22,596,612,484,-128
2020,2,15,23,631,645,537,-108
2020,2,16,0,680,695,546,-149
2020,2,16,1,704,717,546,-171
2020,2,16,2,708,710,546,-164
2020,2,16,3,691,697,514,-183
2020,2,16,4,669,678,508,-170
2020,2,16,5,648,651,509,-142
2020,2,16,6,654,635,509,-126
2020,2,16,7,656,632,508,-124
2020,2,16,8,668,635,510,-125
2020,2,16,9,667,637,508,-129
2020,2,16,10,686,645,509,-136
2020,2,16,11,688,663,506,-157
2020,2,16,12,723,701,531,-170
2020,2,16,13,768,735,544,-191
2020,2,16,14,810,761,544,-217
2020,2,16,15,777,755,534,-221
2020,2,16,16,702,742,538,-204
2020,2,16,17,656,730,531,-199
2020,2,16,18,622,700,528,-172
2020,2,16,19,592,670,528,-142
2020,2,16,20,552,657,527,-130
2020,2,16,21,536,654,505,-149
2020,2,16,22,539,657,532,-125
2020,2,16,23,570,659,541,-118
2020,2,17,0,615,694,544,-150
2020,2,17,1,630,704,544,-160
2020,2,17,2,626,691,544,-147
2020,2,17,3,603,667,510,-157
2020,2,17,4,579,640,507,-133
2020,2,17,5,548,609,498,-111
2020,2,17,6,539,589,481,-108
2020,2,17,7,536,602,456,-146
2020,2,17,8,544,618,461,-157
2020,2,17,9,548,635,484,-151
2020,2,17,10,566,658,501,-157
2020,2,17,11,609,713,507,-206
2020,2,17,12,686,792,510,-282
2020,2,17,13,724,826,543,-283
2020,2,17,14,719,820,538,-282
2020,2,17,15,704,781,527,-254
2020,2,17,16,661,717,481,-236
2020,2,17,17,629,661,468,-193
2020,2,17,18,603,613,455,-158
2020,2,17,19,572,584,394,-190
2020,2,17,20,552,563,392,-171
2020,2,17,21,538,554,413,-141
2020,2,17,22,567,562,461,-101
2020,2,17,23,596,585,488,-97
2020,2,18,0,638,640,539,-101
2020,2,18,1,652,656,541,-115
2020,2,18,2,640,649,542,-107
2020,2,18,3,610,621,537,-84
2020,2,18,4,564,583,527,-56
2020,2,18,5,512,544,390,-154
2020,2,18,6,520,517,348,-169
2020,2,18,7,510,511,357,-154
2020,2,18,8,514,509,357,-152
2020,2,18,9,521,511,357,-154
2020,2,18,10,536,526,360,-166
2020,2,18,11,579,566,368,-198
2020,2,18,12,659,640,524,-116
2020,2,18,13,693,667,543,-124
2020,2,18,14,682,657,541,-116
2020,2,18,15,660,645,542,-103
2020,2,18,16,642,628,483,-145
2020,2,18,17,610,618,449,-169
2020,2,18,18,592,589,453,-136
2020,2,18,19,579,574,447,-127
2020,2,18,20,572,569,456,-113
2020,2,18,21,566,579,466,-113
2020,2,18,22,584,595,485,-110
2020,2,18,23,599,621,532,-89
2020,2,19,0,639,642,537,-105
2020,2,19,1,653,639,538,-101
2020,2,19,2,644,616,533,-83
2020,2,19,3,619,582,511,-71
2020,2,19,4,577,540,472,-68
2020,2,19,5,546,499,384,-115
2020,2,19,6,512,470,346,-124
2020,2,19,7,510,468,347,-121
2020,2,19,8,512,472,334,-138
2020,2,19,9,526,478,332,-146
2020,2,19,10,547,499,333,-166
2020,2,19,11,594,546,393,-153
2020,2,19,12,678,622,524,-98
2020,2,19,13,713,661,535,-126
2020,2,19,14,716,663,534,-129
2020,2,19,15,699,659,536,-123
2020,2,19,16,676,660,534,-126
2020,2,19,17,621,658,534,-124
2020,2,19,18,601,642,532,-110
2020,2,19,19,588,623,531,-92
2020,2,19,20,575,610,531,-79
2020,2,19,21,575,605,531,-74
2020,2,19,22,589,607,539,-68
2020,2,19,23,621,639,547,-92
2020,2,20,0,676,686,553,-133
2020,2,20,1,701,702,553,-149
2020,2,20,2,701,690,552,-138
2020,2,20,3,691,668,555,-113
2020,2,20,4,662,629,555,-74
2020,2,20,5,650,597,553,-44
2020,2,20,6,576,571,551,-20
2020,2,20,7,566,559,553,-6
2020,2,20,8,572,556,531,-25
2020,2,20,9,579,560,530,-30
2020,2,20,10,597,580,530,-50
2020,2,20,11,647,615,529,-86
2020,2,20,12,714,669,532,-137
2020,2,20,13,757,709,535,-174
2020,2,20,14,768,725,539,-186
2020,2,20,15,771,740,542,-198
2020,2,20,16,773,749,537,-212
2020,2,20,17,749,767,535,-232
2020,2,20,18,747,781,542,-239
2020,2,20,19,737,790,544,-246
2020,2,20,20,725,783,543,-240
2020,2,20,21,730,788,543,-245
2020,2,20,22,756,789,538,-251
2020,2,20,23,772,822,656,-166
2020,2,21,0,823,831,709,-122
2020,2,21,1,847,826,618,-208
2020,2,21,2,829,804,636,-168
2020,2,21,3,796,772,637,-135
2020,2,21,4,754,730,544,-186
2020,2,21,5,716,705,542,-163
2020,2,21,6,739,694,544,-150
2020,2,21,7,735,696,543,-153
2020,2,21,8,727,696,545,-151
2020,2,21,9,752,707,543,-164
2020,2,21,10,774,728,544,-184
2020,2,21,11,817,761,540,-221
2020,2,21,12,875,829,624,-205
2020,2,21,13,915,876,695,-181
2020,2,21,14,918,889,660,-229
2020,2,21,15,878,860,719,-141
2020,2,21,16,846,830,690,-140
2020,2,21,17,796,784,548,-236
2020,2,21,18,745,747,548,-199
2020,2,21,19,716,705,542,-163
2020,2,21,20,696,675,534,-141
2020,2,21,21,677,658,534,-124
2020,2,21,22,688,660,541,-119
2020,2,21,23,704,685,547,-138
2020,2,22,0,752,749,554,-195
2020,2,22,1,794,782,552,-230
2020,2,22,2,797,779,551,-228
2020,2,22,3,790,770,545,-225
2020,2,22,4,771,756,553,-203
2020,2,22,5,752,736,551,-185
2020,2,22,6,747,730,552,-178
2020,2,22,7,758,729,548,-181
2020,2,22,8,760,766,651,-115
2020,2,22,9,770,742,682,-60
2020,2,22,10,784,787,703,-84
2020,2,22,11,825,817,709,-108
2020,2,22,12,866,853,699,-154
2020,2,22,13,891,892,668,-224
2020,2,22,14,910,893,690,-203
2020,2,22,15,865,827,593,-234
2020,2,22,16,798,761,535,-226
2020,2,22,17,736,696,521,-175
2020,2,22,18,678,641,475,-166
2020,2,22,19,636,594,435,-159
2020,2,22,20,608,562,313,-249
2020,2,22,21,592,546,281,-265
2020,2,22,22,586,555,331,-224
2020,2,22,23,618,573,350,-223
2020,2,23,0,655,622,477,-145
2020,2,23,1,681,647,549,-98
2020,2,23,2,682,655,547,-108
2020,2,23,3,672,658,548,-110
2020,2,23,4,651,649,548,-101
2020,2,23,5,640,635,549,-86
2020,2,23,6,616,629,549,-80
2020,2,23,7,618,635,546,-89
2020,2,23,8,625,648,549,-99
2020,2,23,9,636,667,550,-117
2020,2,23,10,644,684,549,-135
2020,2,23,11,689,717,551,-166
2020,2,23,12,717,749,566,-183
2020,2,23,13,755,787,615,-172
2020,2,23,14,782,806,550,-256
2020,2,23,15,743,764,512,-252
2020,2,23,16,691,691,469,-222
2020,2,23,17,640,633,457,-176
2020,2,23,18,611,598,343,-255
2020,2,23,19,573,567,271,-296
2020,2,23,20,558,538,269,-269
2020,2,23,21,542,528,303,-225
2020,2,23,22,535,533,349,-184
2020,2,23,23,564,563,360,-203
2020,2,24,0,616,600,509,-91
2020,2,24,1,646,623,521,-102
2020,2,24,2,646,619,524,-95
2020,2,24,3,624,588,519,-69
2020,2,24,4,598,561,473,-88
2020,2,24,5,568,528,418,-110
2020,2,24,6,526,514,391,-123
2020,2,24,7,514,505,391,-114
2020,2,24,8,522,498,389,-109
2020,2,24,9,528,511,391,-120
2020,2,24,10,555,527,390,-137
2020,2,24,11,598,574,500,-74
2020,2,24,12,695,652,545,-107
2020,2,24,13,730,688,539,-149
2020,2,24,14,732,698,545,-153
2020,2,24,15,720,706,530,-176
2020,2,24,16,700,699,508,-191
2020,2,24,17,681,702,513,-189
2020,2,24,18,654,687,529,-158
2020,2,24,19,639,673,528,-145
2020,2,24,20,619,658,522,-136
2020,2,24,21,609,657,527,-130
2020,2,24,22,622,669,536,-133
2020,2,24,23,654,692,545,-147
2020,2,25,0,691,713,542,-171
2020,2,25,1,704,711,545,-166
2020,2,25,2,688,687,540,-147
2020,2,25,3,654,641,525,-116
2020,2,25,4,611,601,522,-79
2020,2,25,5,566,557,377,-180
2020,2,25,6,528,523,342,-181
2020,2,25,7,518,515,348,-167
2020,2,25,8,515,507,356,-151
2020,2,25,9,516,502,353,-149
2020,2,25,10,527,520,356,-164
2020,2,25,11,559,626,424,-202
2020,2,25,12,634,651,412,-239
2020,2,25,13,674,661,424,-237
2020,2,25,14,668,651,422,-229
2020,2,25,15,645,562,352,-210
2020,2,25,16,628,582,351,-231
2020,2,25,17,613,560,346,-214
2020,2,25,18,586,545,347,-198
2020,2,25,19,566,538,341,-197
2020,2,25,20,552,529,343,-186
2020,2,25,21,545,518,341,-177
2020,2,25,22,559,536,344,-192
2020,2,25,23,572,558,346,-212
2020,2,26,0,612,591,401,-190
2020,2,26,1,625,603,527,-76
2020,2,26,2,611,598,497,-101
2020,2,26,3,580,571,352,-219
2020,2,26,4,542,533,351,-182
2020,2,26,5,504,504,353,-151
2020,2,26,6,481,468,343,-125
2020,2,26,7,473,471,353,-118
2020,2,26,8,475,475,356,-119
2020,2,26,9,486,487,357,-130
2020,2,26,10,504,505,353,-152
2020,2,26,11,546,557,356,-201
2020,2,26,12,615,639,429,-210
2020,2,26,13,659,671,464,-207
2020,2,26,14,665,657,465,-192
2020,2,26,15,657,621,463,-158
2020,2,26,16,639,592,462,-130
2020,2,26,17,624,569,457,-112
2020,2,26,18,603,558,455,-103
2020,2,26,19,586,561,454,-107
2020,2,26,20,570,559,454,-105
2020,2,26,21,572,562,457,-105
2020,2,26,22,578,596,459,-137
2020,2,26,23,595,632,461,-171
2020,2,27,0,640,670,464,-206
2020,2,27,1,666,689,464,-225
2020,2,27,2,668,696,466,-230
2020,2,27,3,658,687,468,-219
2020,2,27,4,633,660,468,-192
2020,2,27,5,608,638,468,-170
2020,2,27,6,596,629,457,-172
2020,2,27,7,598,644,467,-177
2020,2,27,8,616,656,468,-188
2020,2,27,9,636,672,466,-206
2020,2,27,10,668,710,468,-242
2020,2,27,11,712,760,491,-269
2020,2,27,12,799,825,550,-275
2020,2,27,13,838,871,546,-325
2020,2,27,14,843,878,546,-332
2020,2,27,15,806,854,462,-392
2020,2,27,16,781,815,468,-347
2020,2,27,17,754,775,463,-312
2020,2,27,18,712,735,460,-275
2020,2,27,19,677,702,459,-243
2020,2,27,20,658,674,458,-216
2020,2,27,21,652,655,458,-197
2020,2,27,22,664,668,471,-197
2020,2,27,23,700,693,546,-147
2020,2,28,0,755,751,548,-203
2020,2,28,1,797,788,545,-243
2020,2,28,2,799,787,547,-240
2020,2,28,3,788,769,546,-223
2020,2,28,4,755,736,547,-189
2020,2,28,5,730,704,545,-159
2020,2,28,6,738,687,544,-143
2020,2,28,7,741,686,546,-140
2020,2,28,8,753,686,547,-139
2020,2,28,9,763,699,548,-151
2020,2,28,10,789,704,544,-160
2020,2,28,11,812,750,547,-203
2020,2,28,12,885,806,642,-164
2020,2,28,13,907,837,661,-176
2020,2,28,14,901,812,551,-261
2020,2,28,15,863,763,544,-219
2020,2,28,16,821,720,481,-239
2020,2,28,17,769,701,464,-237
2020,2,28,18,719,694,466,-228
2020,2,28,19,683,690,466,-224
2020,2,28,20,665,689,476,-213
2020,2,28,21,650,706,517,-189
2020,2,28,22,658,718,529,-189
2020,2,28,23,682,744,543,-201
2020,2,29,0,719,779,544,-235
2020,2,29,1,746,793,546,-247
2020,2,29,2,738,790,553,-237
2020,2,29,3,736,767,484,-283
2020,2,29,4,730,737,463,-274
2020,2,29,5,730,706,460,-246
2020,2,29,6,692,684,459,-225
2020,2,29,7,695,671,461,-210
2020,2,29,8,708,667,460,-207
2020,2,29,9,722,667,460,-207
2020,2,29,10,756,684,463,-221
2020,2,29,11,783,711,458,-253
2020,2,29,12,825,746,460,-286
2020,2,29,13,873,786,461,-325
2020,2,29,14,882,808,460,-348
2020,2,29,15,865,807,504,-303
2020,2,29,16,802,785,469,-316
2020,2,29,17,751,750,456,-294
2020,2,29,18,710,714,466,-248
2020,2,29,19,680,677,446,-231
2020,2,29,20,640,650,385,-265
2020,2,29,21,627,634,380,-254
2020,2,29,22,647,640,464,-176
2020,2,29,23,671,670,528,-142
2020,3,1,0,719,724,547,-177
2020,3,1,1,765,756,546,-210
2020,3,1,2,783,761,548,-213
2020,3,1,3,783,744,479,-265
2020,3,1,4,762,724,457,-267
2020,3,1,5,741,703,457,-246
2020,3,1,6,715,687,455,-232
2020,3,1,7,720,685,455,-230
2020,3,1,8,740,695,456,-239
2020,3,1,9,754,711,457,-254
2020,3,1,10,784,728,454,-274
2020,3,1,11,795,884,582,-302
2020,3,1,12,833,849,637,-212
2020,3,1,13,879,821,623,-198
2020,3,1,14,890,732,522,-210
2020,3,1,15,835,713,488,-225
2020,3,1,16,767,706,468,-238
2020,3,1,17,709,641,431,-210
2020,3,1,18,668,595,318,-277
2020,3,1,19,621,560,246,-314
2020,3,1,20,593,534,245,-289
2020,3,1,21,560,524,263,-261
2020,3,1,22,577,535,331,-204
2020,3,1,23,601,554,346,-208
2020,3,2,0,651,604,463,-141
2020,3,2,1,687,626,512,-114
2020,3,2,2,685,622,539,-83
2020,3,2,3,662,593,537,-56
2020,3,2,4,632,564,533,-31
2020,3,2,5,593,532,515,-17
2020,3,2,6,536,515,497,-18
2020,3,2,7,526,514,470,-44
2020,3,2,8,532,512,468,-44
2020,3,2,9,540,519,481,-38
2020,3,2,10,570,549,520,-29
2020,3,2,11,608,598,539,-59
2020,3,2,12,705,673,541,-132
2020,3,2,13,723,695,542,-153
2020,3,2,14,708,689,482,-207
2020,3,2,15,678,684,468,-216
2020,3,2,16,641,670,454,-216
2020,3,2,17,611,655,416,-239
2020,3,2,18,591,644,423,-221
2020,3,2,19,574,639,457,-182
2020,3,2,20,577,630,464,-166
2020,3,2,21,562,617,472,-145
2020,3,2,22,565,621,506,-115
2020,3,2,23,584,633,454,-179
2020,3,3,0,623,671,515,-156
2020,3,3,1,640,681,523,-158
2020,3,3,2,622,658,511,-147
2020,3,3,3,595,620,445,-175
2020,3,3,4,555,579,373,-206
2020,3,3,5,512,539,354,-185
2020,3,3,6,514,519,385,-134
2020,3,3,7,501,503,345,-158
2020,3,3,8,495,503,361,-142
2020,3,3,9,501,497,343,-154
2020,3,3,10,518,511,369,-142
2020,3,3,11,542,545,346,-199
2020,3,3,12,628,619,416,-203
2020,3,3,13,644,639,503,-136
2020,3,3,14,639,645,513,-132
2020,3,3,15,615,645,476,-169
2020,3,3,16,604,642,497,-145
2020,3,3,17,585,637,502,-135
2020,3,3,18,572,611,441,-170
2020,3,3,19,558,571,396,-175
2020,3,3,20,549,548,344,-204
2020,3,3,21,543,536,340,-196
2020,3,3,22,548,538,336,-202
2020,3,3,23,560,558,338,-220
2020,3,4,0,597,591,339,-252
2020,3,4,1,622,608,340,-268
2020,3,4,2,600,593,339,-254
2020,3,4,3,574,575,336,-239
2020,3,4,4,537,533,315,-218
2020,3,4,5,505,501,300,-201
2020,3,4,6,490,488,270,-218
2020,3,4,7,479,484,270,-214
2020,3,4,8,484,487,331,-156
2020,3,4,9,495,498,339,-159
2020,3,4,10,524,514,341,-173
2020,3,4,11,561,563,341,-222
2020,3,4,12,647,641,448,-193
2020,3,4,13,674,669,457,-212
2020,3,4,14,664,661,457,-204
2020,3,4,15,637,632,457,-175
2020,3,4,16,597,612,464,-148
2020,3,4,17,579,604,479,-125
2020,3,4,18,565,586,463,-123
2020,3,4,19,550,568,513,-55
2020,3,4,20,533,554,405,-149
2020,3,4,21,529,548,344,-204
2020,3,4,22,537,561,344,-217
2020,3,4,23,555,579,342,-237
2020,3,5,0,597,622,365,-257
2020,3,5,1,628,626,424,-202
2020,3,5,2,625,617,415,-202
2020,3,5,3,606,586,325,-261
2020,3,5,4,575,552,287,-265
2020,3,5,5,536,514,245,-269
2020,3,5,6,532,493,214,-279
2020,3,5,7,523,487,215,-272
2020,3,5,8,528,484,214,-270
2020,3,5,9,541,500,216,-284
2020,3,5,10,558,516,237,-279
2020,3,5,11,595,567,287,-280
2020,3,5,12,671,623,382,-241
2020,3,5,13,708,667,493,-174
2020,3,5,14,706,662,492,-170
2020,3,5,15,700,656,460,-196
2020,3,5,16,700,641,457,-184
2020,3,5,17,692,621,429,-192
2020,3,5,18,683,604,455,-149
2020,3,5,19,666,607,455,-152
2020,3,5,20,652,601,456,-145
2020,3,5,21,656,602,456,-146
2020,3,5,22,674,617,472,-145
2020,3,5,23,704,625,491,-134
2020,3,6,0,730,658,504,-154
2020,3,6,1,753,679,501,-178
2020,3,6,2,731,676,490,-186
2020,3,6,3,709,651,469,-182
2020,3,6,4,665,616,433,-183
2020,3,6,5,629,596,440,-156
2020,3,6,6,637,548,412,-136
2020,3,6,7,640,566,415,-151
2020,3,6,8,646,570,416,-154
2020,3,6,9,652,578,424,-154
2020,3,6,10,668,583,429,-154
2020,3,6,11,698,619,463,-156
2020,3,6,12,771,690,585,-105
2020,3,6,13,809,720,638,-82
2020,3,6,14,791,702,463,-239
2020,3,6,15,761,707,426,-281
2020,3,6,16,755,720,426,-294
2020,3,6,17,735,722,425,-297
2020,3,6,18,712,719,428,-291
2020,3,6,19,696,723,417,-306
2020,3,6,20,681,649,371,-278
2020,3,6,21,683,735,419,-316
2020,3,6,22,698,755,450,-305
2020,3,6,23,743,773,468,-305
2020,3,7,0,796,798,466,-332
2020,3,7,1,828,802,473,-329
2020,3,7,2,825,785,487,-298
2020,3,7,3,801,761,496,-265
2020,3,7,4,761,726,489,-237
2020,3,7,5,724,694,491,-203
2020,3,7,6,694,673,480,-193
2020,3,7,7,697,674,480,-194
2020,3,7,8,721,657,478,-179
2020,3,7,9,734,666,493,-173
2020,3,7,10,765,678,490,-188
2020,3,7,11,784,696,499,-197
2020,3,7,12,828,730,503,-227
2020,3,7,13,891,759,500,-259
2020,3,7,14,879,773,441,-332
2020,3,7,15,827,748,414,-334
2020,3,7,16,774,716,416,-300
2020,3,7,17,723,672,414,-258
2020,3,7,18,656,633,412,-221
2020,3,7,19,614,599,363,-236
2020,3,7,20,589,569,333,-236
2020,3,7,21,584,550,335,-215
2020,3,7,22,572,549,366,-183
2020,3,7,23,593,586,425,-161
2020,3,8,0,642,616,424,-192
2020,3,8,1,678,659,418,-241
2020,3,8,2,706,666,447,-219
2020,3,8,3,699,661,464,-197
2020,3,8,4,689,660,484,-176
2020,3,8,5,668,635,478,-157
2020,3,8,6,654,616,457,-159
2020,3,8,7,645,622,438,-184
2020,3,8,8,645,650,524,-126
2020,3,8,9,658,658,602,-56
2020,3,8,10,679,687,597,-90
2020,3,8,11,711,728,627,-101
2020,3,8,12,743,768,669,-99
2020,3,8,13,765,813,668,-145
2020,3,8,14,750,780,534,-246
2020,3,8,15,724,719,511,-208
2020,3,8,16,688,643,432,-211
2020,3,8,17,646,597,389,-208
2020,3,8,18,620,553,283,-270
2020,3,8,19,600,523,268,-255
2020,3,8,20,570,505,268,-237
2020,3,8,21,555,504,270,-234
2020,3,8,22,558,515,287,-228
2020,3,8,23,570,532,347,-185
2020,3,9,0,614,565,349,-216
2020,3,9,1,622,600,348,-252
2020,3,9,2,604,589,346,-243
2020,3,9,3,575,567,346,-221
2020,3,9,4,550,540,369,-171
2020,3,9,5,501,530,478,-52
2020,3,9,6,492,529,481,-48
2020,3,9,7,496,540,493,-47
2020,3,9,8,515,564,500,-64
2020,3,9,9,538,594,499,-95
2020,3,9,10,580,652,500,-152
2020,3,9,11,672,737,519,-218
2020,3,9,12,732,789,520,-269
2020,3,9,13,732,786,509,-277
2020,3,9,14,722,761,497,-264
2020,3,9,15,681,702,426,-276
2020,3,9,16,646,635,408,-227
2020,3,9,17,615,516,289,-227
2020,3,9,18,595,484,267,-217
2020,3,9,19,572,463,321,-142
2020,3,9,20,558,447,340,-107
2020,3,9,21,550,442,341,-101
2020,3,9,22,557,456,343,-113
2020,3,9,23,572,454,348,-106
2020,3,10,0,603,442,348,-94
2020,3,10,1,628,483,348,-135
2020,3,10,2,598,515,353,-162
2020,3,10,3,555,528,348,-180
2020,3,10,4,514,490,350,-140
2020,3,10,5,484,458,346,-112
2020,3,10,6,471,450,351,-99
2020,3,10,7,472,439,346,-93
2020,3,10,8,480,443,350,-93
2020,3,10,9,494,452,347,-105
2020,3,10,10,534,489,351,-138
2020,3,10,11,612,555,368,-187
2020,3,10,12,665,599,487,-112
2020,3,10,13,660,595,479,-116
2020,3,10,14,656,608,490,-118
2020,3,10,15,634,598,508,-90
2020,3,10,16,617,590,458,-132
2020,3,10,17,590,572,374,-198
2020,3,10,18,565,560,347,-213
2020,3,10,19,548,541,344,-197
2020,3,10,20,535,533,346,-187
2020,3,10,21,542,540,344,-196
2020,3,10,22,549,550,345,-205
2020,3,10,23,562,571,346,-225
2020,3,11,0,593,592,350,-242
2020,3,11,1,614,592,345,-247
2020,3,11,2,590,566,348,-218
2020,3,11,3,552,523,345,-178
2020,3,11,4,510,482,345,-137
2020,3,11,5,478,453,338,-115
2020,3,11,6,456,437,338,-99
2020,3,11,7,454,438,347,-91
2020,3,11,8,454,438,348,-90
2020,3,11,9,468,452,349,-103
2020,3,11,10,503,486,345,-141
2020,3,11,11,579,551,480,-71
2020,3,11,12,622,592,512,-80
2020,3,11,13,616,594,470,-124
2020,3,11,14,608,591,399,-192
2020,3,11,15,591,568,363,-205
2020,3,11,16,575,546,364,-182
2020,3,11,17,559,529,378,-151
2020,3,11,18,550,525,312,-213
2020,3,11,19,532,509,326,-183
2020,3,11,20,531,512,336,-176
2020,3,11,21,542,522,337,-185
2020,3,11,22,548,533,351,-182
2020,3,11,23,558,558,415,-143
2020,3,12,0,575,559,433,-126
2020,3,12,1,596,572,405,-167
2020,3,12,2,573,544,335,-209
2020,3,12,3,525,510,337,-173
2020,3,12,4,478,468,337,-131
2020,3,12,5,461,447,335,-112
2020,3,12,6,444,435,334,-101
2020,3,12,7,447,442,338,-104
2020,3,12,8,449,446,336,-110
2020,3,12,9,465,468,337,-131
2020,3,12,10,502,602,422,-180
2020,3,12,11,580,653,425,-228
2020,3,12,12,627,566,425,-141
2020,3,12,13,626,582,424,-158
2020,3,12,14,612,618,423,-195
2020,3,12,15,597,579,405,-174
2020,3,12,16,587,551,407,-144
2020,3,12,17,561,576,438,-138
2020,3,12,18,550,512,401,-111
2020,3,12,19,536,524,407,-117
2020,3,12,20,532,520,408,-112
2020,3,12,21,543,602,495,-107
2020,3,12,22,551,542,452,-90
2020,3,12,23,560,546,407,-139
2020,3,13,0,581,569,437,-132
2020,3,13,1,601,571,438,-133
2020,3,13,2,571,546,410,-136
2020,3,13,3,531,506,353,-153
2020,3,13,4,486,460,335,-125
2020,3,13,5,455,429,336,-93
2020,3,13,6,434,409,332,-77
2020,3,13,7,430,403,326,-77
2020,3,13,8,425,403,323,-80
2020,3,13,9,432,408,324,-84
2020,3,13,10,461,433,332,-101
2020,3,13,11,536,495,337,-158
2020,3,13,12,577,528,335,-193
2020,3,13,13,577,543,339,-204
2020,3,13,14,579,547,335,-212
2020,3,13,15,575,555,342,-213
2020,3,13,16,568,546,340,-206
2020,3,13,17,560,536,342,-194
2020,3,13,18,542,532,345,-187
2020,3,13,19,532,525,343,-182
2020,3,13,20,525,515,345,-170
2020,3,13,21,527,509,342,-167
2020,3,13,22,527,519,346,-173
2020,3,13,23,524,521,343,-178
2020,3,14,0,539,541,343,-198
2020,3,14,1,560,545,343,-202
2020,3,14,2,548,523,343,-180
2020,3,14,3,520,495,344,-151
2020,3,14,4,483,460,344,-116
2020,3,14,5,447,435,340,-95
2020,3,14,6,431,424,310,-114
2020,3,14,7,426,416,275,-141
2020,3,14,8,432,410,272,-138
2020,3,14,9,440,419,276,-143
2020,3,14,10,463,432,280,-152
2020,3,14,11,498,461,344,-117
2020,3,14,12,543,495,353,-142
2020,3,14,13,577,529,358,-171
2020,3,14,14,601,548,347,-201
2020,3,14,15,594,555,391,-164
2020,3,14,16,583,552,373,-179
2020,3,14,17,570,546,360,-186
2020,3,14,18,556,525,341,-184
2020,3,14,19,537,519,343,-176
2020,3,14,20,522,516,375,-141
2020,3,14,21,528,521,408,-113
2020,3,14,22,540,529,413,-116
2020,3,14,23,565,534,412,-122
2020,3,15,0,587,534,410,-124
2020,3,15,1,604,547,410,-137
2020,3,15,2,598,529,413,-116
2020,3,15,3,581,500,410,-90
2020,3,15,4,545,470,414,-56
2020,3,15,5,475,408,336,-72
2020,3,15,6,451,418,330,-88
2020,3,15,7,446,408,331,-77
2020,3,15,8,452,407,322,-85
2020,3,15,9,463,408,311,-97
2020,3,15,10,476,420,324,-96
2020,3,15,11,508,435,337,-98
2020,3,15,12,539,466,342,-124
2020,3,15,13,590,500,351,-149
2020,3,15,14,620,526,354,-172
2020,3,15,15,629,542,356,-186
2020,3,15,16,612,545,354,-191
2020,3,15,17,608,545,355,-190
2020,3,15,18,606,529,352,-177
2020,3,15,19,580,508,352,-156
2020,3,15,20,563,492,350,-142
2020,3,15,21,577,488,351,-137
2020,3,15,22,589,497,347,-150
2020,3,15,23,607,512,351,-161
2020,3,16,0,646,532,353,-179
2020,3,16,1,669,544,355,-189
2020,3,16,2,630,521,358,-163
2020,3,16,3,594,490,355,-135
2020,3,16,4,544,464,361,-103
2020,3,16,5,476,436,358,-78
2020,3,16,6,456,428,359,-69
2020,3,16,7,459,419,360,-59
2020,3,16,8,466,437,364,-73
2020,3,16,9,477,456,362,-94
2020,3,16,10,516,495,362,-133
2020,3,16,11,593,550,361,-189
2020,3,16,12,644,603,368,-235
2020,3,16,13,649,623,500,-123
2020,3,16,14,648,633,500,-133
2020,3,16,15,646,637,450,-187
2020,3,16,16,632,637,434,-203
2020,3,16,17,613,624,433,-191
2020,3,16,18,601,605,433,-172
2020,3,16,19,587,586,433,-153
2020,3,16,20,579,569,430,-139
2020,3,16,21,590,557,432,-125
2020,3,16,22,595,575,431,-144
2020,3,16,23,617,588,429,-159
2020,3,17,0,634,599,431,-168
2020,3,17,1,649,633,457,-176
2020,3,17,2,629,590,431,-159
2020,3,17,3,600,551,433,-118
2020,3,17,4,550,513,433,-80
2020,3,17,5,514,488,401,-87
2020,3,17,6,487,471,307,-164
2020,3,17,7,482,471,312,-159
2020,3,17,8,481,476,316,-160
2020,3,17,9,490,485,331,-154
2020,3,17,10,530,513,416,-97
2020,3,17,11,602,563,427,-136
2020,3,17,12,644,604,466,-138
2020,3,17,13,639,617,472,-145
2020,3,17,14,626,628,487,-141
2020,3,17,15,594,634,509,-125
2020,3,17,16,570,623,509,-114
2020,3,17,17,549,592,514,-78
2020,3,17,18,540,561,483,-78
2020,3,17,19,527,539,397,-142
2020,3,17,20,522,527,349,-178
2020,3,17,21,543,525,346,-179
2020,3,17,22,547,535,348,-187
2020,3,17,23,565,547,348,-199
2020,3,18,0,569,559,350,-209
2020,3,18,1,578,567,352,-215
2020,3,18,2,561,535,353,-182
2020,3,18,3,520,496,354,-142
2020,3,18,4,474,458,355,-103
2020,3,18,5,460,424,323,-101
2020,3,18,6,438,414,321,-93
2020,3,18,7,437,409,322,-87
2020,3,18,8,441,415,322,-93
2020,3,18,9,451,429,347,-82
2020,3,18,10,488,456,356,-100
2020,3,18,11,562,513,362,-151
2020,3,18,12,600,557,361,-196
2020,3,18,13,594,573,361,-212
2020,3,18,14,595,578,362,-216
2020,3,18,15,584,568,359,-209
2020,3,18,16,576,568,355,-213
2020,3,18,17,565,568,356,-212
2020,3,18,18,551,562,355,-207
2020,3,18,19,547,550,355,-195
2020,3,18,20,539,553,357,-196
2020,3,18,21,544,558,355,-203
2020,3,18,22,560,575,356,-219
2020,3,18,23,570,584,356,-228
2020,3,19,0,575,582,355,-227
2020,3,19,1,590,571,354,-217
2020,3,19,2,564,543,354,-189
2020,3,19,3,520,500,351,-149
2020,3,19,4,473,462,352,-110
2020,3,19,5,446,436,344,-92
2020,3,19,6,422,416,310,-106
2020,3,19,7,417,410,279,-131
2020,3,19,8,415,409,274,-135
2020,3,19,9,421,416,284,-132
2020,3,19,10,455,439,349,-90
2020,3,19,11,524,483,351,-132
2020,3,19,12,564,523,353,-170
2020,3,19,13,565,536,351,-185
2020,3,19,14,562,536,350,-186
2020,3,19,15,555,539,349,-190
2020,3,19,16,546,532,345,-187
2020,3,19,17,548,534,343,-191
2020,3,19,18,548,529,339,-190
2020,3,19,19,547,520,338,-182
2020,3,19,20,545,509,337,-172
2020,3,19,21,554,510,336,-174
2020,3,19,22,558,520,337,-183
2020,3,19,23,572,537,340,-197
2020,3,20,0,577,545,339,-206
2020,3,20,1,588,554,340,-214
2020,3,20,2,562,524,341,-183
2020,3,20,3,515,471,331,-140
2020,3,20,4,472,435,341,-94
2020,3,20,5,419,406,311,-95
2020,3,20,6,391,390,306,-84
2020,3,20,7,378,384,307,-77
2020,3,20,8,382,382,309,-73
2020,3,20,9,390,385,309,-76
2020,3,20,10,418,401,341,-60
2020,3,20,11,478,442,341,-101
2020,3,20,12,522,475,344,-131
2020,3,20,13,538,498,344,-154
2020,3,20,14,552,506,339,-167
2020,3,20,15,557,513,339,-174
2020,3,20,16,554,527,339,-188
2020,3,20,17,547,521,332,-189
2020,3,20,18,530,530,336,-194
2020,3,20,19,520,520,339,-181
2020,3,20,20,509,513,340,-173
2020,3,20,21,505,515,340,-175
2020,3,20,22,506,517,336,-181
2020,3,20,23,513,525,338,-187
2020,3,21,0,514,531,339,-192
2020,3,21,1,530,531,347,-184
2020,3,21,2,515,497,350,-147
2020,3,21,3,482,464,351,-113
2020,3,21,4,437,429,350,-79
2020,3,21,5,407,399,350,-49
2020,3,21,6,390,384,350,-34
2020,3,21,7,382,372,349,-23
2020,3,21,8,381,371,351,-20
2020,3,21,9,381,374,350,-24
2020,3,21,10,398,384,350,-34
2020,3,21,11,422,406,352,-54
2020,3,21,12,458,426,350,-76
2020,3,21,13,484,454,350,-104
2020,3,21,14,510,479,350,-129
2020,3,21,15,514,489,348,-141
2020,3,21,16,511,492,345,-147
2020,3,21,17,508,486,345,-141
2020,3,21,18,493,476,342,-134
2020,3,21,19,482,469,343,-126
2020,3,21,20,478,467,345,-122
2020,3,21,21,480,470,344,-126
2020,3,21,22,490,488,348,-140
2020,3,21,23,487,498,351,-147
2020,3,22,0,504,503,353,-150
2020,3,22,1,520,517,358,-159
2020,3,22,2,510,492,356,-136
2020,3,22,3,495,470,357,-113
2020,3,22,4,466,438,358,-80
2020,3,22,5,420,411,322,-89
2020,3,22,6,407,405,324,-81
2020,3,22,7,410,405,277,-128
2020,3,22,8,417,408,243,-165
2020,3,22,9,425,417,243,-174
2020,3,22,10,442,435,263,-172
2020,3,22,11,482,461,341,-120
2020,3,22,12,509,492,343,-149
2020,3,22,13,556,534,469,-65
2020,3,22,14,581,552,507,-45
2020,3,22,15,570,554,505,-49
2020,3,22,16,555,555,477,-78
2020,3,22,17,524,549,449,-100
2020,3,22,18,518,520,447,-73
2020,3,22,19,499,507,448,-59
2020,3,22,20,488,512,448,-64
2020,3,22,21,494,516,461,-55
2020,3,22,22,505,532,508,-24
2020,3,22,23,512,549,512,-37
2020,3,23,0,553,558,520,-38
2020,3,23,1,590,557,520,-37
2020,3,23,2,559,536,512,-24
2020,3,23,3,537,505,483,-22
2020,3,23,4,503,479,452,-27
2020,3,23,5,485,457,403,-54
2020,3,23,6,484,444,245,-199
2020,3,23,7,487,441,196,-245
2020,3,23,8,498,443,221,-222
2020,3,23,9,518,457,226,-231
2020,3,23,10,558,485,236,-249
2020,3,23,11,618,453,270,-183
2020,3,23,12,650,433,270,-163
2020,3,23,13,637,458,272,-186
2020,3,23,14,607,468,270,-198
2020,3,23,15,568,467,272,-195
2020,3,23,16,532,466,270,-196
2020,3,23,17,508,476,268,-208
2020,3,23,18,481,465,268,-197
2020,3,23,19,463,439,266,-173
2020,3,23,20,455,412,264,-148
2020,3,23,21,457,398,264,-134
2020,3,23,22,464,400,264,-136
2020,3,23,23,482,403,264,-139
2020,3,24,0,501,410,263,-147
2020,3,24,1,515,415,262,-153
2020,3,24,2,502,389,263,-126
2020,3,24,3,487,357,264,-93
2020,3,24,4,469,325,264,-61
2020,3,24,5,461,451,422,-29
2020,3,24,6,443,443,427,-16
2020,3,24,7,436,433,425,-8
2020,3,24,8,441,438,423,-15
2020,3,24,9,454,442,423,-19
2020,3,24,10,479,472,426,-46
2020,3,24,11,537,521,429,-92
2020,3,24,12,586,560,429,-131
2020,3,24,13,595,572,426,-146
2020,3,24,14,592,585,434,-151
2020,3,24,15,581,595,436,-159
2020,3,24,16,572,598,430,-168
2020,3,24,17,554,600,434,-166
2020,3,24,18,536,600,422,-178
2020,3,24,19,528,588,388,-200
2020,3,24,20,526,579,397,-182
2020,3,24,21,526,593,406,-187
2020,3,24,22,539,607,423,-184
2020,3,24,23,551,608,426,-182
2020,3,25,0,562,612,431,-181
2020,3,25,1,572,590,422,-168
2020,3,25,2,554,555,406,-149
2020,3,25,3,514,524,401,-123
2020,3,25,4,472,486,343,-143
2020,3,25,5,449,459,260,-199
2020,3,25,6,431,449,264,-185
2020,3,25,7,425,441,262,-179
2020,3,25,8,427,439,260,-179
2020,3,25,9,435,447,262,-185
2020,3,25,10,461,468,274,-194
2020,3,25,11,521,515,340,-175
2020,3,25,12,561,550,348,-202
2020,3,25,13,563,567,409,-158
2020,3,25,14,557,571,425,-146
2020,3,25,15,548,566,381,-185
2020,3,25,16,530,557,340,-217
2020,3,25,17,521,546,337,-209
2020,3,25,18,513,535,317,-218
2020,3,25,19,497,515,223,-292
2020,3,25,20,496,498,233,-265
2020,3,25,21,502,501,310,-191
2020,3,25,22,514,519,422,-97
2020,3,25,23,520,526,406,-120
2020,3,26,0,528,532,286,-246
2020,3,26,1,539,550,393,-157
2020,3,26,2,524,525,433,-92
2020,3,26,3,484,494,410,-84
2020,3,26,4,441,460,345,-115
2020,3,26,5,441,441,340,-101
2020,3,26,6,432,432,284,-148
2020,3,26,7,429,435,332,-103
2020,3,26,8,436,444,335,-109
2020,3,26,9,448,461,342,-119
2020,3,26,10,483,495,340,-155
2020,3,26,11,538,546,346,-200
2020,3,26,12,587,589,372,-217
2020,3,26,13,599,600,375,-225
2020,3,26,14,590,580,367,-213
2020,3,26,15,563,562,371,-191
2020,3,26,16,547,544,369,-175
2020,3,26,17,530,530,369,-161
2020,3,26,18,514,511,322,-189
2020,3,26,19,503,495,269,-226
2020,3,26,20,495,490,269,-221
2020,3,26,21,500,494,270,-224
2020,3,26,22,505,509,280,-229
2020,3,26,23,515,520,269,-251
2020,3,27,0,524,526,268,-258
2020,3,27,1,538,540,271,-269
2020,3,27,2,520,508,268,-240
2020,3,27,3,485,470,270,-200
2020,3,27,4,446,433,270,-163
2020,3,27,5,420,407,268,-139
2020,3,27,6,402,389,268,-121
2020,3,27,7,394,385,269,-116
2020,3,27,8,397,385,270,-115
2020,3,27,9,404,397,270,-127
2020,3,27,10,426,442,205,-237
2020,3,27,11,471,441,176,-265
2020,3,27,12,525,493,173,-320
2020,3,27,13,537,518,173,-345
2020,3,27,14,538,511,168,-343
2020,3,27,15,527,503,167,-336
2020,3,27,16,523,497,169,-328
2020,3,27,17,522,506,170,-336
2020,3,27,18,522,507,170,-337
2020,3,27,19,529,510,171,-339
2020,3,27,20,519,517,174,-343
2020,3,27,21,524,524,293,-231
2020,3,27,22,528,541,313,-228
2020,3,27,23,536,544,317,-227
2020,3,28,0,523,542,330,-212
2020,3,28,1,524,551,350,-201
2020,3,28,2,509,519,329,-190
2020,3,28,3,469,475,325,-150
2020,3,28,4,430,432,317,-115
2020,3,28,5,404,397,300,-97
2020,3,28,6,382,375,324,-51
2020,3,28,7,374,366,322,-44
2020,3,28,8,371,354,273,-81
2020,3,28,9,372,358,273,-85
2020,3,28,10,386,360,250,-110
2020,3,28,11,406,374,227,-147
2020,3,28,12,438,392,196,-196
2020,3,28,13,466,421,202,-219
2020,3,28,14,484,443,203,-240
2020,3,28,15,500,463,205,-258
2020,3,28,16,507,479,205,-274
2020,3,28,17,507,493,247,-246
2020,3,28,18,508,510,275,-235
2020,3,28,19,512,523,304,-219
2020,3,28,20,525,541,320,-221
2020,3,28,21,550,557,330,-227
2020,3,28,22,576,569,387,-182
2020,3,28,23,575,562,404,-158
2020,3,29,0,553,553,228,-325
2020,3,29,1,541,556,165,-391
2020,3,29,2,526,517,155,-362
2020,3,29,3,490,472,153,-319
2020,3,29,4,442,433,155,-278
2020,3,29,5,393,394,152,-242
2020,3,29,6,369,372,152,-220
2020,3,29,7,360,361,155,-206
2020,3,29,8,354,352,154,-198
2020,3,29,9,354,346,152,-194
2020,3,29,10,356,351,154,-197
2020,3,29,11,375,366,156,-210
2020,3,29,12,402,382,155,-227
2020,3,29,13,438,410,154,-256
2020,3,29,14,469,443,157,-286
2020,3,29,15,485,459,154,-305
2020,3,29,16,491,477,156,-321
2020,3,29,17,484,489,156,-333
2020,3,29,18,503,486,152,-334
2020,3,29,19,506,490,153,-337
2020,3,29,20,518,496,155,-341
2020,3,29,21,532,538,195,-343
2020,3,29,22,547,491,256,-235
2020,3,29,23,531,521,391,-130
2020,3,30,0,527,516,389,-127
2020,3,30,1,532,513,376,-137
2020,3,30,2,510,482,282,-200
2020,3,30,3,477,444,228,-216
2020,3,30,4,429,408,153,-255
2020,3,30,5,372,379,153,-226
2020,3,30,6,356,362,155,-207
2020,3,30,7,353,354,154,-200
2020,3,30,8,353,353,155,-198
2020,3,30,9,364,357,153,-204
2020,3,30,10,389,381,155,-226
2020,3,30,11,445,417,158,-259
2020,3,30,12,503,460,154,-306
2020,3,30,13,519,484,152,-332
2020,3,30,14,522,495,153,-342
2020,3,30,15,509,500,157,-343
2020,3,30,16,506,501,171,-330
2020,3,30,17,498,494,158,-336
2020,3,30,18,501,488,153,-335
2020,3,30,19,489,484,149,-335
2020,3,30,20,480,486,150,-336
2020,3,30,21,479,492,152,-340
2020,3,30,22,497,504,151,-353
2020,3,30,23,503,514,169,-345
2020,3,31,0,511,520,182,-338
2020,3,31,1,519,528,181,-347
2020,3,31,2,501,498,183,-315
2020,3,31,3,465,456,179,-277
2020,3,31,4,425,426,180,-246
2020,3,31,5,400,403,166,-237
2020,3,31,6,385,386,150,-236
2020,3,31,7,383,379,150,-229
2020,3,31,8,389,385,153,-232
2020,3,31,9,402,392,153,-239
2020,3,31,10,425,414,152,-262
2020,3,31,11,476,455,199,-256
2020,3,31,12,536,502,175,-327
2020,3,31,13,554,523,279,-244
2020,3,31,14,564,545,283,-262
2020,3,31,15,547,561,280,-281
2020,3,31,16,542,579,281,-298
2020,3,31,17,530,588,267,-321
2020,3,31,18,531,585,221,-364
2020,3,31,19,518,557,220,-337
2020,3,31,20,517,565,222,-343
2020,3,31,21,520,552,225,-327
2020,3,31,22,532,583,254,-329
2020,3,31,23,544,593,275,-318
2020,4,1,0,548,591,280,-311
2020,4,1,1,569,594,287,-307
2020,4,1,2,568,548,220,-328
2020,4,1,3,528,523,221,-302
2020,4,1,4,494,502,222,-280
2020,4,1,5,472,480,219,-261
2020,4,1,6,459,475,244,-231
2020,4,1,7,457,474,241,-233
2020,4,1,8,462,475,241,-234
2020,4,1,9,476,488,265,-223
2020,4,1,10,507,515,339,-176
2020,4,1,11,553,564,352,-212
2020,4,1,12,611,612,455,-157
2020,4,1,13,625,645,436,-209
2020,4,1,14,619,653,354,-299
2020,4,1,15,596,660,312,-348
2020,4,1,16,585,644,299,-345
2020,4,1,17,554,627,298,-329
2020,4,1,18,545,612,326,-286
2020,4,1,19,525,601,340,-261
2020,4,1,20,521,598,339,-259
2020,4,1,21,526,602,339,-263
2020,4,1,22,537,614,342,-272
2020,4,1,23,550,623,435,-188
2020,4,2,0,559,630,463,-167
2020,4,2,1,591,631,479,-152
2020,4,2,2,587,596,476,-120
2020,4,2,3,549,572,481,-91
2020,4,2,4,516,542,482,-60
2020,4,2,5,530,519,477,-42
2020,4,2,6,521,508,478,-30
2020,4,2,7,522,440,416,-24
2020,4,2,8,530,488,400,-88
2020,4,2,9,546,546,432,-114
2020,4,2,10,578,598,410,-188
2020,4,2,11,642,602,395,-207
2020,4,2,12,696,520,294,-226
2020,4,2,13,697,528,341,-187
2020,4,2,14,678,587,350,-237
2020,4,2,15,625,544,270,-274
2020,4,2,16,596,570,302,-268
2020,4,2,17,552,557,325,-232
2020,4,2,18,535,602,282,-320
2020,4,2,19,508,557,204,-353
2020,4,2,20,493,454,161,-293
2020,4,2,21,493,544,321,-223
2020,4,2,22,505,476,203,-273
2020,4,2,23,509,507,261,-246
2020,4,3,0,527,540,270,-270
2020,4,3,1,553,554,269,-285
2020,4,3,2,546,539,270,-269
2020,4,3,3,517,507,268,-239
2020,4,3,4,476,483,270,-213
2020,4,3,5,468,468,269,-199
2020,4,3,6,466,463,268,-195
2020,4,3,7,468,467,268,-199
2020,4,3,8,483,485,270,-215
2020,4,3,9,500,502,269,-233
2020,4,3,10,534,543,273,-270
2020,4,3,11,596,602,331,-271
2020,4,3,12,655,626,331,-295
2020,4,3,13,658,642,341,-301
2020,4,3,14,649,613,346,-267
2020,4,3,15,596,561,336,-225
2020,4,3,16,562,545,340,-205
2020,4,3,17,528,522,339,-183
2020,4,3,18,508,506,339,-167
2020,4,3,19,491,491,342,-149
2020,4,3,20,478,482,338,-144
2020,4,3,21,476,483,279,-204
2020,4,3,22,477,491,290,-201
2020,4,3,23,478,505,364,-141
2020,4,4,0,490,506,360,-146
2020,4,4,1,511,526,370,-156
2020,4,4,2,504,497,353,-144
2020,4,4,3,482,463,315,-148
2020,4,4,4,452,431,250,-181
2020,4,4,5,439,410,207,-203
2020,4,4,6,431,400,203,-197
2020,4,4,7,427,399,203,-196
2020,4,4,8,431,406,203,-203
2020,4,4,9,447,413,204,-209
2020,4,4,10,469,425,199,-226
2020,4,4,11,497,452,233,-219
2020,4,4,12,540,468,269,-199
2020,4,4,13,579,505,310,-195
2020,4,4,14,588,526,359,-167
2020,4,4,15,563,522,357,-165
2020,4,4,16,540,487,351,-136
2020,4,4,17,515,465,348,-117
2020,4,4,18,508,453,347,-106
2020,4,4,19,497,433,344,-89
2020,4,4,20,484,434,343,-91
2020,4,4,21,486,445,342,-103
2020,4,4,22,490,466,341,-125
2020,4,4,23,493,484,345,-139
2020,4,5,0,504,482,344,-138
2020,4,5,1,511,494,347,-147
2020,4,5,2,500,470,350,-120
2020,4,5,3,465,437,352,-85
2020,4,5,4,434,405,355,-50
2020,4,5,5,393,379,307,-72
2020,4,5,6,383,364,290,-74
2020,4,5,7,376,357,292,-65
2020,4,5,8,377,360,291,-69
2020,4,5,9,376,369,296,-73
2020,4,5,10,383,378,301,-77
2020,4,5,11,403,404,360,-44
2020,4,5,12,438,429,360,-69
2020,4,5,13,478,458,360,-98
2020,4,5,14,495,479,352,-127
2020,4,5,15,484,483,350,-133
2020,4,5,16,473,474,347,-127
2020,4,5,17,467,469,300,-169
2020,4,5,18,451,454,276,-178
2020,4,5,19,446,453,190,-263
2020,4,5,20,456,452,142,-310
2020,4,5,21,466,460,202,-258
2020,4,5,22,470,482,207,-275
2020,4,5,23,479,486,248,-238
2020,4,6,0,490,487,253,-234
2020,4,6,1,502,495,254,-241
2020,4,6,2,484,470,253,-217
2020,4,6,3,447,439,229,-210
2020,4,6,4,417,401,203,-198
2020,4,6,5,399,374,174,-200
2020,4,6,6,386,362,170,-192
2020,4,6,7,383,362,172,-190
2020,4,6,8,390,362,171,-191
2020,4,6,9,401,371,170,-201
2020,4,6,10,427,400,175,-225
2020,4,6,11,468,450,205,-245
2020,4,6,12,508,491,243,-248
2020,4,6,13,537,517,268,-249
2020,4,6,14,542,508,264,-244
2020,4,6,15,533,501,254,-247
2020,4,6,16,523,497,210,-287
2020,4,6,17,520,503,205,-298
2020,4,6,18,515,496,203,-293
2020,4,6,19,506,501,210,-291
2020,4,6,20,510,498,222,-276
2020,4,6,21,513,507,211,-296
2020,4,6,22,525,520,221,-299
2020,4,6,23,529,508,221,-287
2020,4,7,0,544,526,231,-295
2020,4,7,1,550,533,243,-290
2020,4,7,2,526,499,223,-276
2020,4,7,3,479,460,225,-235
2020,4,7,4,428,421,219,-202
2020,4,7,5,396,386,158,-228
2020,4,7,6,390,371,139,-232
2020,4,7,7,389,362,135,-227
2020,4,7,8,388,357,135,-222
2020,4,7,9,394,368,139,-229
2020,4,7,10,425,390,167,-223
2020,4,7,11,485,431,260,-171
2020,4,7,12,523,469,267,-202
2020,4,7,13,528,487,265,-222
2020,4,7,14,536,494,263,-231
2020,4,7,15,528,498,258,-240
2020,4,7,16,513,503,258,-245
2020,4,7,17,504,503,255,-248
2020,4,7,18,510,494,252,-242
2020,4,7,19,509,491,251,-240
2020,4,7,20,508,495,230,-265
2020,4,7,21,517,505,213,-292
2020,4,7,22,522,526,213,-313
2020,4,7,23,524,528,214,-314
2020,4,8,0,530,522,213,-309
2020,4,8,1,545,532,215,-317
2020,4,8,2,522,504,217,-287
2020,4,8,3,472,465,217,-248
2020,4,8,4,428,428,221,-207
2020,4,8,5,386,392,201,-191
2020,4,8,6,371,374,165,-209
2020,4,8,7,367,363,167,-196
2020,4,8,8,366,352,167,-185
2020,4,8,9,376,356,166,-190
2020,4,8,10,408,380,166,-214
2020,4,8,11,455,414,164,-250
2020,4,8,12,488,444,165,-279
2020,4,8,13,504,472,165,-307
2020,4,8,14,515,483,164,-319
2020,4,8,15,512,497,166,-331
2020,4,8,16,512,504,165,-339
2020,4,8,17,517,505,165,-340
2020,4,8,18,529,508,213,-295
2020,4,8,19,524,505,215,-290
2020,4,8,20,528,508,212,-296
2020,4,8,21,536,527,296,-231
2020,4,8,22,549,547,310,-237
2020,4,8,23,551,549,320,-229
2020,4,9,0,540,538,356,-182
2020,4,9,1,554,542,362,-180
2020,4,9,2,526,505,296,-209
2020,4,9,3,474,462,250,-212
2020,4,9,4,436,415,224,-191
2020,4,9,5,384,378,238,-140
2020,4,9,6,365,365,217,-148
2020,4,9,7,361,358,214,-144
2020,4,9,8,358,351,237,-114
2020,4,9,9,362,357,245,-112
2020,4,9,10,390,371,245,-126
2020,4,9,11,437,406,260,-146
2020,4,9,12,476,432,261,-171
2020,4,9,13,498,457,243,-214
2020,4,9,14,503,474,201,-273
2020,4,9,15,500,486,202,-284
2020,4,9,16,498,488,202,-286
2020,4,9,17,499,493,227,-266
2020,4,9,18,498,483,227,-256
2020,4,9,19,492,484,231,-253
2020,4,9,20,490,481,236,-245
2020,4,9,21,495,487,239,-248
2020,4,9,22,504,497,230,-267
2020,4,9,23,508,506,233,-273
2020,4,10,0,509,503,227,-276
2020,4,10,1,528,517,233,-284
2020,4,10,2,510,487,225,-262
2020,4,10,3,477,454,209,-245
2020,4,10,4,436,417,204,-213
2020,4,10,5,415,387,201,-186
2020,4,10,6,411,375,201,-174
2020,4,10,7,418,375,203,-172
2020,4,10,8,428,374,202,-172
2020,4,10,9,454,386,203,-183
2020,4,10,10,501,410,207,-203
2020,4,10,11,554,454,221,-233
2020,4,10,12,604,493,219,-274
2020,4,10,13,620,534,221,-313
2020,4,10,14,633,547,207,-340
2020,4,10,15,623,550,149,-401
2020,4,10,16,604,534,181,-353
2020,4,10,17,574,529,206,-323
2020,4,10,18,565,509,203,-306
2020,4,10,19,537,490,207,-283
2020,4,10,20,515,474,204,-270
2020,4,10,21,519,474,205,-269
2020,4,10,22,521,488,207,-281
2020,4,10,23,532,503,206,-297
2020,4,11,0,543,516,209,-307
2020,4,11,1,582,538,209,-329
2020,4,11,2,604,534,204,-330
2020,4,11,3,590,519,227,-292
2020,4,11,4,569,489,151,-338
2020,4,11,5,512,477,151,-326
2020,4,11,6,517,474,154,-320
2020,4,11,7,515,497,176,-321
2020,4,11,8,515,490,181,-309
2020,4,11,9,522,528,213,-315
2020,4,11,10,551,527,222,-305
2020,4,11,11,593,523,188,-335
2020,4,11,12,639,585,246,-339
2020,4,11,13,647,613,263,-350
2020,4,11,14,626,556,207,-349
2020,4,11,15,579,524,152,-372
2020,4,11,16,538,514,154,-360
2020,4,11,17,486,485,153,-332
2020,4,11,18,463,458,152,-306
2020,4,11,19,445,441,153,-288
2020,4,11,20,452,433,153,-280
2020,4,11,21,454,440,153,-287
2020,4,11,22,474,458,155,-303
2020,4,11,23,472,464,153,-311
2020,4,12,0,471,472,153,-319
2020,4,12,1,499,486,153,-333
2020,4,12,2,501,470,153,-317
2020,4,12,3,477,445,154,-291
2020,4,12,4,436,416,153,-263
2020,4,12,5,430,392,124,-268
2020,4,12,6,412,384,121,-263
2020,4,12,7,405,379,119,-260
2020,4,12,8,414,383,120,-263
2020,4,12,9,411,390,121,-269
2020,4,12,10,428,407,121,-286
2020,4,12,11,457,423,118,-305
2020,4,12,12,490,449,119,-330
2020,4,12,13,537,480,120,-360
2020,4,12,14,555,521,121,-400
2020,4,12,15,531,534,126,-408
2020,4,12,16,511,550,138,-412
2020,4,12,17,490,545,135,-410
2020,4,12,18,482,525,120,-405
2020,4,12,19,463,502,115,-387
2020,4,12,20,448,501,173,-328
2020,4,12,21,457,515,237,-278
2020,4,12,22,472,513,300,-213
2020,4,12,23,484,510,268,-242
2020,4,13,0,496,506,268,-238
2020,4,13,1,517,497,267,-230
2020,4,13,2,501,473,268,-205
2020,4,13,3,475,441,268,-173
2020,4,13,4,436,409,267,-142
2020,4,13,5,387,379,266,-113
2020,4,13,6,370,371,269,-102
2020,4,13,7,371,356,265,-91
2020,4,13,8,368,356,268,-88
2020,4,13,9,381,363,268,-95
2020,4,13,10,420,376,267,-109
2020,4,13,11,482,408,292,-116
2020,4,13,12,515,439,354,-85
2020,4,13,13,528,466,361,-105
2020,4,13,14,534,479,362,-117
2020,4,13,15,521,490,326,-164
2020,4,13,16,520,497,268,-229
2020,4,13,17,506,495,265,-230
2020,4,13,18,493,488,266,-222
2020,4,13,19,489,485,266,-219
2020,4,13,20,489,479,265,-214
2020,4,13,21,497,487,271,-216
2020,4,13,22,500,501,269,-232
2020,4,13,23,514,507,265,-242
2020,4,14,0,529,506,357,-149
2020,4,14,1,551,521,411,-110
2020,4,14,2,535,490,337,-153
2020,4,14,3,489,456,316,-140
2020,4,14,4,452,424,315,-109
2020,4,14,5,420,399,313,-86
2020,4,14,6,413,386,313,-73
2020,4,14,7,416,386,315,-71
2020,4,14,8,423,391,315,-76
2020,4,14,9,443,402,314,-88
2020,4,14,10,492,430,283,-147
2020,4,14,11,559,478,233,-245
2020,4,14,12,593,521,319,-202
2020,4,14,13,600,550,326,-224
2020,4,14,14,588,549,324,-225
2020,4,14,15,564,525,315,-210
2020,4,14,16,558,514,324,-190
2020,4,14,17,527,505,324,-181
2020,4,14,18,512,490,325,-165
2020,4,14,19,512,481,326,-155
2020,4,14,20,506,478,323,-155
2020,4,14,21,516,491,327,-164
2020,4,14,22,520,504,361,-143
2020,4,14,23,538,514,388,-126
2020,4,15,0,548,520,436,-84
2020,4,15,1,570,532,436,-96
2020,4,15,2,558,513,435,-78
2020,4,15,3,515,486,399,-87
2020,4,15,4,481,458,435,-23
2020,4,15,5,452,437,429,-8
2020,4,15,6,440,437,403,-34
2020,4,15,7,440,440,417,-23
2020,4,15,8,442,446,379,-67
2020,4,15,9,460,468,367,-101
2020,4,15,10,500,502,375,-127
2020,4,15,11,566,567,433,-134
2020,4,15,12,605,613,434,-179
2020,4,15,13,620,637,406,-231
2020,4,15,14,625,620,378,-242
2020,4,15,15,606,607,385,-222
2020,4,15,16,602,579,388,-191
2020,4,15,17,568,558,388,-170
2020,4,15,18,550,539,389,-150
2020,4,15,19,536,509,310,-199
2020,4,15,20,527,497,310,-187
2020,4,15,21,527,497,376,-121
2020,4,15,22,525,515,377,-138
2020,4,15,23,552,533,377,-156
2020,4,16,0,566,547,377,-170
2020,4,16,1,602,574,392,-182
2020,4,16,2,600,568,416,-152
2020,4,16,3,569,543,417,-126
2020,4,16,4,548,519,417,-102
2020,4,16,5,536,506,416,-90
2020,4,16,6,529,502,415,-87
2020,4,16,7,540,513,418,-95
2020,4,16,8,545,523,416,-107
2020,4,16,9,569,551,419,-132
2020,4,16,10,623,588,418,-170
2020,4,16,11,686,643,472,-171
2020,4,16,12,727,685,580,-105
2020,4,16,13,707,678,581,-97
2020,4,16,14,680,642,580,-62
2020,4,16,15,632,601,452,-149
2020,4,16,16,608,573,406,-167
2020,4,16,17,562,548,279,-269
2020,4,16,18,540,527,276,-251
2020,4,16,19,529,502,282,-220
2020,4,16,20,515,495,342,-153
2020,4,16,21,516,495,442,-53
2020,4,16,22,518,513,445,-68
2020,4,16,23,534,520,442,-78
2020,4,17,0,554,530,442,-88
2020,4,17,1,592,549,445,-104
2020,4,17,2,588,539,440,-99
2020,4,17,3,550,506,430,-76
2020,4,17,4,508,488,422,-66
2020,4,17,5,457,474,412,-62
2020,4,17,6,448,467,380,-87
2020,4,17,7,455,478,383,-95
2020,4,17,8,466,492,352,-140
2020,4,17,9,485,513,343,-170
2020,4,17,10,524,548,343,-205
2020,4,17,11,588,603,418,-185
2020,4,17,12,626,645,440,-205
2020,4,17,13,614,640,437,-203
2020,4,17,14,583,597,396,-201
2020,4,17,15,543,552,448,-104
2020,4,17,16,518,529,447,-82
2020,4,17,17,498,497,440,-57
2020,4,17,18,482,486,439,-47
2020,4,17,19,465,469,380,-89
2020,4,17,20,462,463,381,-82
2020,4,17,21,468,465,383,-82
2020,4,17,22,466,469,399,-70
2020,4,17,23,471,489,438,-51
2020,4,18,0,478,485,440,-45
2020,4,18,1,498,502,443,-59
2020,4,18,2,485,489,420,-69
2020,4,18,3,458,455,333,-122
2020,4,18,4,425,422,327,-95
2020,4,18,5,386,393,326,-67
2020,4,18,6,371,382,329,-53
2020,4,18,7,369,374,329,-45
2020,4,18,8,366,372,328,-44
2020,4,18,9,370,377,327,-50
2020,4,18,10,385,384,325,-59
2020,4,18,11,414,406,327,-79
2020,4,18,12,446,429,324,-105
2020,4,18,13,474,464,328,-136
2020,4,18,14,491,485,327,-158
2020,4,18,15,487,490,325,-165
2020,4,18,16,474,493,321,-172
2020,4,18,17,461,479,300,-179
2020,4,18,18,450,463,307,-156
2020,4,18,19,427,452,326,-126
2020,4,18,20,422,437,323,-114
2020,4,18,21,424,448,327,-121
2020,4,18,22,426,461,327,-134
2020,4,18,23,450,474,414,-60
2020,4,19,0,454,480,444,-36
2020,4,19,1,489,492,444,-48
2020,4,19,2,488,483,443,-40
2020,4,19,3,463,465,445,-20
2020,4,19,4,439,437,374,-63
2020,4,19,5,416,425,269,-156
2020,4,19,6,401,421,270,-151
2020,4,19,7,395,429,270,-159
2020,4,19,8,405,440,288,-152
2020,4,19,9,412,454,326,-128
2020,4,19,10,426,473,393,-80
2020,4,19,11,454,507,416,-91
2020,4,19,12,487,537,328,-209
2020,4,19,13,520,566,328,-238
2020,4,19,14,524,577,325,-252
2020,4,19,15,515,576,326,-250
2020,4,19,16,492,571,328,-243
2020,4,19,17,471,571,433,-138
2020,4,19,18,464,521,377,-144
2020,4,19,19,454,477,327,-150
2020,4,19,20,454,458,326,-132
2020,4,19,21,460,457,325,-132
2020,4,19,22,474,483,327,-156
2020,4,19,23,485,492,361,-131
2020,4,20,0,495,493,390,-103
2020,4,20,1,512,509,407,-102
2020,4,20,2,487,481,386,-95
2020,4,20,3,453,452,386,-66
2020,4,20,4,419,420,382,-38
2020,4,20,5,407,397,367,-30
2020,4,20,6,399,388,354,-34
2020,4,20,7,402,384,346,-38
2020,4,20,8,409,386,349,-37
2020,4,20,9,430,397,365,-32
2020,4,20,10,464,424,386,-38
2020,4,20,11,533,466,385,-81
2020,4,20,12,575,510,400,-110
2020,4,20,13,569,541,423,-118
2020,4,20,14,565,561,432,-129
2020,4,20,15,536,568,442,-126
2020,4,20,16,526,567,425,-142
2020,4,20,17,509,552,420,-132
2020,4,20,18,502,525,405,-120
2020,4,20,19,487,507,406,-101
2020,4,20,20,486,503,335,-168
2020,4,20,21,501,490,330,-160
2020,4,20,22,502,501,330,-171
2020,4,20,23,516,511,414,-97
2020,4,21,0,525,515,441,-74
2020,4,21,1,536,520,438,-82
2020,4,21,2,527,509,440,-69
2020,4,21,3,484,482,412,-70
2020,4,21,4,452,449,325,-124
2020,4,21,5,426,419,276,-143
2020,4,21,6,413,411,257,-154
2020,4,21,7,414,417,258,-159
2020,4,21,8,421,425,258,-167
2020,4,21,9,438,437,258,-179
2020,4,21,10,478,468,273,-195
2020,4,21,11,544,515,364,-151
2020,4,21,12,584,553,362,-191
2020,4,21,13,580,577,364,-213
2020,4,21,14,574,582,365,-217
2020,4,21,15,543,563,367,-196
2020,4,21,16,531,543,362,-181
2020,4,21,17,517,524,361,-163
2020,4,21,18,512,510,356,-154
2020,4,21,19,493,499,356,-143
2020,4,21,20,493,493,356,-137
2020,4,21,21,503,493,329,-164
2020,4,21,22,509,505,187,-318
2020,4,21,23,520,514,283,-231
2020,4,22,0,531,516,300,-216
2020,4,22,1,547,527,301,-226
2020,4,22,2,529,513,303,-210
2020,4,22,3,484,481,302,-179
2020,4,22,4,446,446,296,-150
2020,4,22,5,413,425,285,-140
2020,4,22,6,409,413,298,-115
2020,4,22,7,416,417,303,-114
2020,4,22,8,424,422,299,-123
2020,4,22,9,446,440,301,-139
2020,4,22,10,492,477,299,-178
2020,4,22,11,573,530,298,-232
2020,4,22,12,601,578,302,-276
2020,4,22,13,588,578,298,-280
2020,4,22,14,572,562,300,-262
2020,4,22,15,541,542,256,-286
2020,4,22,16,526,525,175,-350
2020,4,22,17,501,511,144,-367
2020,4,22,18,490,501,143,-358
2020,4,22,19,477,489,143,-346
2020,4,22,20,472,485,142,-343
2020,4,22,21,484,487,171,-316
2020,4,22,22,486,500,312,-188
2020,4,22,23,498,512,390,-122
2020,4,23,0,504,513,447,-66
2020,4,23,1,524,529,446,-83
2020,4,23,2,513,506,448,-58
2020,4,23,3,472,468,413,-55
2020,4,23,4,437,429,391,-38
2020,4,23,5,401,402,364,-38
2020,4,23,6,390,386,363,-23
2020,4,23,7,387,382,363,-19
2020,4,23,8,392,384,365,-19
2020,4,23,9,406,395,365,-30
2020,4,23,10,432,416,365,-51
2020,4,23,11,490,458,411,-47
2020,4,23,12,527,500,459,-41
2020,4,23,13,531,532,480,-52
2020,4,23,14,530,550,479,-71
2020,4,23,15,511,565,477,-88
2020,4,23,16,502,575,475,-100
2020,4,23,17,491,585,478,-107
2020,4,23,18,485,568,474,-94
2020,4,23,19,476,553,473,-80
2020,4,23,20,479,540,467,-73
2020,4,23,21,489,537,472,-65
2020,4,23,22,493,539,472,-67
2020,4,23,23,500,536,482,-54
2020,4,24,0,504,537,470,-67
2020,4,24,1,519,535,465,-70
2020,4,24,2,506,508,477,-31
2020,4,24,3,468,470,457,-13
2020,4,24,4,430,437,406,-31
2020,4,24,5,397,410,377,-33
2020,4,24,6,380,395,369,-26
2020,4,24,7,372,386,367,-19
2020,4,24,8,370,386,369,-17
2020,4,24,9,380,388,367,-21
2020,4,24,10,408,412,369,-43
2020,4,24,11,461,444,396,-48
2020,4,24,12,493,478,445,-33
2020,4,24,13,501,499,452,-47
2020,4,24,14,501,507,470,-37
2020,4,24,15,491,505,466,-39
2020,4,24,16,483,505,456,-49
2020,4,24,17,473,505,454,-51
2020,4,24,18,472,495,452,-43
2020,4,24,19,466,484,450,-34
2020,4,24,20,465,486,461,-25
2020,4,24,21,472,488,467,-21
2020,4,24,22,482,496,469,-27
2020,4,24,23,483,500,471,-29
2020,4,25,0,480,499,471,-28
2020,4,25,1,487,508,470,-38
2020,4,25,2,475,499,469,-30
2020,4,25,3,438,463,444,-19
2020,4,25,4,408,429,347,-82
2020,4,25,5,383,398,298,-100
2020,4,25,6,365,374,271,-103
2020,4,25,7,361,368,270,-98
2020,4,25,8,362,367,273,-94
2020,4,25,9,366,372,271,-101
2020,4,25,10,381,385,272,-113
2020,4,25,11,402,404,297,-107
2020,4,25,12,431,424,269,-155
2020,4,25,13,456,453,271,-182
2020,4,25,14,472,469,338,-131
2020,4,25,15,467,478,345,-133
2020,4,25,16,467,488,345,-143
2020,4,25,17,457,479,347,-132
2020,4,25,18,440,459,346,-113
2020,4,25,19,434,442,344,-98
2020,4,25,20,430,438,344,-94
2020,4,25,21,435,438,347,-91
2020,4,25,22,446,443,346,-97
2020,4,25,23,450,460,344,-116
2020,4,26,0,449,471,345,-126
2020,4,26,1,463,475,348,-127
2020,4,26,2,458,454,345,-109
2020,4,26,3,434,430,335,-95
2020,4,26,4,403,409,291,-118
2020,4,26,5,384,382,278,-104
2020,4,26,6,365,367,281,-86
2020,4,26,7,357,358,281,-77
2020,4,26,8,358,357,280,-77
2020,4,26,9,361,360,316,-44
2020,4,26,10,371,378,339,-39
2020,4,26,11,394,397,343,-54
2020,4,26,12,421,418,342,-76
2020,4,26,13,468,445,342,-103
2020,4,26,14,486,467,342,-125
2020,4,26,15,479,463,337,-126
2020,4,26,16,465,463,345,-118
2020,4,26,17,454,467,343,-124
2020,4,26,18,466,454,341,-113
2020,4,26,19,459,443,342,-101
2020,4,26,20,458,448,340,-108
2020,4,26,21,469,468,343,-125
2020,4,26,22,481,495,345,-150
2020,4,26,23,494,505,344,-161
2020,4,27,0,509,510,343,-167
2020,4,27,1,529,526,344,-182
2020,4,27,2,510,514,340,-174
2020,4,27,3,477,492,320,-172
2020,4,27,4,455,463,295,-168
2020,4,27,5,416,439,278,-161
2020,4,27,6,407,427,278,-149
2020,4,27,7,412,435,281,-154
2020,4,27,8,420,437,280,-157
2020,4,27,9,444,449,278,-171
2020,4,27,10,485,490,308,-182
2020,4,27,11,559,538,319,-219
2020,4,27,12,597,581,314,-267
2020,4,27,13,593,591,337,-254
2020,4,27,14,576,573,342,-231
2020,4,27,15,538,565,288,-277
2020,4,27,16,524,543,279,-264
2020,4,27,17,498,527,275,-252
2020,4,27,18,490,512,301,-211
2020,4,27,19,473,494,293,-201
2020,4,27,20,468,487,271,-216
2020,4,27,21,479,489,303,-186
2020,4,27,22,489,505,342,-163
2020,4,27,23,506,516,345,-171
2020,4,28,0,512,521,345,-176
2020,4,28,1,522,534,352,-182
2020,4,28,2,509,510,346,-164
2020,4,28,3,468,482,351,-131
2020,4,28,4,426,452,343,-109
2020,4,28,5,414,434,339,-95
2020,4,28,6,408,428,320,-108
2020,4,28,7,415,432,303,-129
2020,4,28,8,430,441,306,-135
2020,4,28,9,449,461,333,-128
2020,4,28,10,491,498,344,-154
2020,4,28,11,560,551,345,-206
2020,4,28,12,594,594,347,-247
2020,4,28,13,588,592,348,-244
2020,4,28,14,571,572,335,-237
2020,4,28,15,532,551,301,-250
2020,4,28,16,518,542,272,-270
2020,4,28,17,499,528,298,-230
2020,4,28,18,490,507,316,-191
2020,4,28,19,474,489,316,-173
2020,4,28,20,470,485,336,-149
2020,4,28,21,477,489,334,-155
2020,4,28,22,488,505,335,-170
2020,4,28,23,500,513,337,-176
2020,4,29,0,505,514,339,-175
2020,4,29,1,513,521,337,-184
2020,4,29,2,499,506,343,-163
2020,4,29,3,454,467,345,-122
2020,4,29,4,420,424,344,-80
2020,4,29,5,389,394,345,-49
2020,4,29,6,378,382,345,-37
2020,4,29,7,378,373,348,-25
2020,4,29,8,383,370,345,-25
2020,4,29,9,395,376,346,-30
2020,4,29,10,423,401,345,-56
2020,4,29,11,485,443,347,-96
2020,4,29,12,518,474,345,-129
2020,4,29,13,525,496,355,-141
2020,4,29,14,520,503,359,-144
2020,4,29,15,508,495,400,-95
2020,4,29,16,495,496,448,-48
2020,4,29,17,486,509,450,-59
2020,4,29,18,484,501,355,-146
2020,4,29,19,477,508,351,-157
2020,4,29,20,480,509,348,-161
2020,4,29,21,488,522,355,-167
2020,4,29,22,497,540,338,-202
2020,4,29,23,504,545,339,-206
2020,4,30,0,504,532,341,-191
2020,4,30,1,511,515,338,-177
2020,4,30,2,506,496,341,-155
2020,4,30,3,469,464,341,-123
2020,4,30,4,436,430,344,-86
2020,4,30,5,388,405,352,-53
2020,4,30,6,374,393,350,-43
2020,4,30,7,374,388,350,-38
2020,4,30,8,379,392,352,-40
2020,4,30,9,391,404,351,-53
2020,4,30,10,423,431,352,-79
2020,4,30,11,485,476,351,-125
2020,4,30,12,519,518,351,-167
2020,4,30,13,537,541,351,-190
2020,4,30,14,534,550,351,-199
2020,4,30,15,517,546,347,-199
2020,4,30,16,508,551,350,-201
2020,4,30,17,489,545,346,-199
2020,4,30,18,484,548,353,-195
2020,4,30,19,474,536,359,-177
2020,4,30,20,470,533,373,-160
2020,4,30,21,479,535,439,-96
2020,4,30,22,490,545,512,-33
2020,4,30,23,497,558,533,-25
2020,5,1,0,508,565,557,-8
2020,5,1,1,520,569,423,-146
2020,5,1,2,527,548,339,-209
2020,5,1,3,500,517,339,-178
2020,5,1,4,469,486,341,-145
2020,5,1,5,437,452,338,-114
2020,5,1,6,424,444,340,-104
2020,5,1,7,421,441,348,-93
2020,5,1,8,425,441,351,-90
2020,5,1,9,440,451,352,-99
2020,5,1,10,474,474,353,-121
2020,5,1,11,538,522,355,-167
2020,5,1,12,564,556,353,-203
2020,5,1,13,571,573,354,-219
2020,5,1,14,571,568,353,-215
2020,5,1,15,560,558,334,-224
2020,5,1,16,550,533,318,-215
2020,5,1,17,529,518,323,-195
2020,5,1,18,521,498,322,-176
2020,5,1,19,499,482,321,-161
2020,5,1,20,484,474,325,-149
2020,5,1,21,489,474,323,-151
2020,5,1,22,491,488,336,-152
2020,5,1,23,495,504,384,-120
2020,5,2,0,496,494,483,-11
2020,5,2,1,510,508,445,-63
2020,5,2,2,508,500,448,-52
2020,5,2,3,482,475,386,-89
2020,5,2,4,451,439,355,-84
2020,5,2,5,419,411,341,-70
2020,5,2,6,404,400,328,-72
2020,5,2,7,402,398,320,-78
2020,5,2,8,404,401,319,-82
2020,5,2,9,411,410,338,-72
2020,5,2,10,432,429,337,-92
2020,5,2,11,454,459,339,-120
2020,5,2,12,488,487,338,-149
2020,5,2,13,502,510,306,-204
2020,5,2,14,516,498,268,-230
2020,5,2,15,501,485,270,-215
2020,5,2,16,484,463,269,-194
2020,5,2,17,460,458,272,-186
2020,5,2,18,447,448,269,-179
2020,5,2,19,438,445,271,-174
2020,5,2,20,442,448,273,-175
2020,5,2,21,448,552,406,-146
2020,5,2,22,463,555,471,-84
2020,5,2,23,471,468,446,-22
2020,5,3,0,467,506,462,-44
2020,5,3,1,481,508,471,-37
2020,5,3,2,472,432,417,-15
2020,5,3,3,447,354,339,-15
2020,5,3,4,406,407,350,-57
2020,5,3,5,370,376,345,-31
2020,5,3,6,348,356,331,-25
2020,5,3,7,336,348,323,-25
2020,5,3,8,331,344,310,-34
2020,5,3,9,332,344,305,-39
2020,5,3,10,341,358,316,-42
2020,5,3,11,359,375,306,-69
2020,5,3,12,387,399,298,-101
2020,5,3,13,434,424,270,-154
2020,5,3,14,456,445,271,-174
2020,5,3,15,462,447,270,-177
2020,5,3,16,467,454,273,-181
2020,5,3,17,483,463,324,-139
2020,5,3,18,498,472,334,-138
2020,5,3,19,512,477,330,-147
2020,5,3,20,526,499,328,-171
2020,5,3,21,550,521,329,-192
2020,5,3,22,564,545,328,-217
2020,5,3,23,573,553,331,-222
2020,5,4,0,556,546,331,-215
2020,5,4,1,546,544,332,-212
2020,5,4,2,530,525,331,-194
2020,5,4,3,484,481,330,-151
2020,5,4,4,431,441,331,-110
2020,5,4,5,387,404,331,-73
2020,5,4,6,368,379,332,-47
2020,5,4,7,349,368,293,-75
2020,5,4,8,341,362,271,-91
2020,5,4,9,346,364,270,-94
2020,5,4,10,372,378,291,-87
2020,5,4,11,424,416,305,-111
2020,5,4,12,454,450,334,-116
2020,5,4,13,481,477,345,-132
2020,5,4,14,497,494,345,-149
2020,5,4,15,505,507,344,-163
2020,5,4,16,519,520,342,-178
2020,5,4,17,518,534,342,-192
2020,5,4,18,522,538,340,-198
2020,5,4,19,524,543,339,-204
2020,5,4,20,531,553,336,-217
2020,5,4,21,542,569,335,-234
2020,5,4,22,549,578,333,-245
2020,5,4,23,556,469,335,-134
2020,5,5,0,546,457,337,-120
2020,5,5,1,540,470,342,-128
2020,5,5,2,520,502,341,-161
2020,5,5,3,472,488,342,-146
2020,5,5,4,425,442,342,-100
2020,5,5,5,388,402,341,-61
2020,5,5,6,364,387,342,-45
2020,5,5,7,354,375,346,-29
2020,5,5,8,350,367,343,-24
2020,5,5,9,355,369,344,-25
2020,5,5,10,381,387,343,-44
2020,5,5,11,433,421,347,-74
2020,5,5,12,467,454,345,-109
2020,5,5,13,484,481,346,-135
2020,5,5,14,495,493,347,-146
2020,5,5,15,500,494,346,-148
2020,5,5,16,511,506,345,-161
2020,5,5,17,514,519,343,-176
2020,5,5,18,516,522,341,-181
2020,5,5,19,518,527,342,-185
2020,5,5,20,528,536,343,-193
2020,5,5,21,538,542,343,-199
2020,5,5,22,551,547,345,-202
2020,5,5,23,553,551,344,-207
2020,5,6,0,542,540,347,-193
2020,5,6,1,542,530,345,-185
2020,5,6,2,519,507,361,-146
2020,5,6,3,471,477,418,-59
2020,5,6,4,427,430,218,-212
2020,5,6,5,378,391,150,-241
2020,5,6,6,363,373,150,-223
2020,5,6,7,357,359,165,-194
2020,5,6,8,357,358,217,-141
2020,5,6,9,366,364,154,-210
2020,5,6,10,402,383,153,-230
2020,5,6,11,462,422,154,-268
2020,5,6,12,496,464,182,-282
2020,5,6,13,506,484,184,-300
2020,5,6,14,507,492,210,-282
2020,5,6,15,513,499,216,-283
2020,5,6,16,519,495,191,-304
2020,5,6,17,512,487,157,-330
2020,5,6,18,514,510,159,-351
2020,5,6,19,500,503,152,-351
2020,5,6,20,502,513,152,-361
2020,5,6,21,495,512,153,-359
2020,5,6,22,511,527,152,-375
2020,5,6,23,523,545,157,-388
2020,5,7,0,528,560,172,-388
2020,5,7,1,535,569,203,-366
2020,5,7,2,536,559,203,-356
2020,5,7,3,510,521,178,-343
2020,5,7,4,482,490,188,-302
2020,5,7,5,459,468,195,-273
2020,5,7,6,451,463,197,-266
2020,5,7,7,454,466,198,-268
2020,5,7,8,458,467,210,-257
2020,5,7,9,477,484,235,-249
2020,5,7,10,519,520,237,-283
2020,5,7,11,591,652,321,-331
2020,5,7,12,625,608,317,-291
2020,5,7,13,626,636,277,-359
2020,5,7,14,596,590,297,-293
2020,5,7,15,571,459,188,-271
2020,5,7,16,555,546,155,-391
2020,5,7,17,528,525,151,-374
2020,5,7,18,510,504,150,-354
2020,5,7,19,489,485,131,-354
2020,5,7,20,475,474,86,-388
2020,5,7,21,488,476,86,-390
2020,5,7,22,494,489,135,-354
2020,5,7,23,503,502,155,-347
2020,5,8,0,515,501,178,-323
2020,5,8,1,529,510,193,-317
2020,5,8,2,529,512,207,-305
2020,5,8,3,501,487,203,-284
2020,5,8,4,458,461,183,-278
2020,5,8,5,438,441,188,-253
2020,5,8,6,429,434,190,-244
2020,5,8,7,428,438,195,-243
2020,5,8,8,435,441,191,-250
2020,5,8,9,451,462,195,-267
2020,5,8,10,491,485,194,-291
2020,5,8,11,557,527,234,-293
2020,5,8,12,587,563,237,-326
2020,5,8,13,590,581,234,-347
2020,5,8,14,583,586,233,-353
2020,5,8,15,564,577,233,-344
2020,5,8,16,549,566,234,-332
2020,5,8,17,531,561,232,-329
2020,5,8,18,519,559,233,-326
2020,5,8,19,507,556,235,-321
2020,5,8,20,507,552,233,-319
2020,5,8,21,509,559,233,-326
2020,5,8,22,513,569,234,-335
2020,5,8,23,522,569,232,-337
2020,5,9,0,525,564,235,-329
2020,5,9,1,534,563,234,-329
2020,5,9,2,544,545,232,-313
2020,5,9,3,534,524,233,-291
2020,5,9,4,517,499,235,-264
2020,5,9,5,462,333,82,-251
2020,5,9,6,454,330,81,-249
2020,5,9,7,455,332,83,-249
2020,5,9,8,471,336,83,-253
2020,5,9,9,490,348,84,-264
2020,5,9,10,526,363,82,-281
2020,5,9,11,550,388,81,-307
2020,5,9,12,603,432,83,-349
2020,5,9,13,620,398,82,-316
2020,5,9,14,617,408,82,-326
2020,5,9,15,602,422,81,-341
2020,5,9,16,584,461,84,-377
2020,5,9,17,544,455,83,-372
2020,5,9,18,526,427,82,-345
2020,5,9,19,509,404,82,-322
2020,5,9,20,489,387,83,-304
2020,5,9,21,493,384,83,-301
2020,5,9,22,502,399,84,-315
2020,5,9,23,506,411,84,-327
2020,5,10,0,527,417,82,-335
2020,5,10,1,555,431,84,-347
2020,5,10,2,582,436,83,-353
2020,5,10,3,567,425,83,-342
2020,5,10,4,543,425,84,-341
2020,5,10,5,500,480,153,-327
2020,5,10,6,498,479,151,-328
2020,5,10,7,496,491,153,-338
2020,5,10,8,505,499,153,-346
2020,5,10,9,519,516,154,-362
2020,5,10,10,536,545,155,-390
2020,5,10,11,572,572,153,-419
2020,5,10,12,601,608,181,-427
2020,5,10,13,603,604,181,-423
2020,5,10,14,585,577,165,-412
2020,5,10,15,542,548,155,-393
2020,5,10,16,521,513,153,-360
2020,5,10,17,486,489,201,-288
2020,5,10,18,480,459,226,-233
2020,5,10,19,470,436,239,-197
2020,5,10,20,467,429,256,-173
2020,5,10,21,476,439,277,-162
2020,5,10,22,495,451,302,-149
2020,5,10,23,499,467,335,-132
2020,5,11,0,502,470,334,-136
2020,5,11,1,524,481,314,-167
2020,5,11,2,521,479,247,-232
2020,5,11,3,492,457,154,-303
2020,5,11,4,459,425,154,-271
2020,5,11,5,432,407,154,-253
2020,5,11,6,429,394,153,-241
2020,5,11,7,435,395,156,-239
2020,5,11,8,447,396,153,-243
2020,5,11,9,471,413,163,-250
2020,5,11,10,514,448,264,-184
2020,5,11,11,594,508,431,-77
2020,5,11,12,641,554,436,-118
2020,5,11,13,640,572,374,-198
2020,5,11,14,629,573,362,-211
2020,5,11,15,594,564,311,-253
2020,5,11,16,579,552,350,-202
2020,5,11,17,546,542,305,-237
2020,5,11,18,530,526,260,-266
2020,5,11,19,509,511,308,-203
2020,5,11,20,491,500,262,-238
2020,5,11,21,496,502,270,-232
2020,5,11,22,513,516,297,-219
2020,5,11,23,535,535,282,-253
2020,5,12,0,538,541,306,-235
2020,5,12,1,559,547,331,-216
2020,5,12,2,571,547,335,-212
2020,5,12,3,539,512,292,-220
2020,5,12,4,507,480,274,-206
2020,5,12,5,477,464,273,-191
2020,5,12,6,468,456,258,-198
2020,5,12,7,469,462,225,-237
2020,5,12,8,479,475,264,-211
2020,5,12,9,500,496,274,-222
2020,5,12,10,542,537,353,-184
2020,5,12,11,614,596,402,-194
2020,5,12,12,652,632,408,-224
2020,5,12,13,638,649,409,-240
2020,5,12,14,624,644,424,-220
2020,5,12,15,582,621,456,-165
2020,5,12,16,569,587,400,-187
2020,5,12,17,543,566,366,-200
2020,5,12,18,527,537,348,-189
2020,5,12,19,505,513,311,-202
2020,5,12,20,496,504,310,-194
2020,5,12,21,510,500,335,-165
2020,5,12,22,514,516,336,-180
2020,5,12,23,526,523,351,-172
2020,5,13,0,529,524,359,-165
2020,5,13,1,538,535,328,-207
2020,5,13,2,539,524,319,-205
2020,5,13,3,507,493,232,-261
2020,5,13,4,475,461,241,-220
2020,5,13,5,437,436,208,-228
2020,5,13,6,428,429,288,-141
2020,5,13,7,425,428,291,-137
2020,5,13,8,433,430,291,-139
2020,5,13,9,449,439,318,-121
2020,5,13,10,489,466,348,-118
2020,5,13,11,558,515,362,-153
2020,5,13,12,586,551,363,-188
2020,5,13,13,582,572,363,-209
2020,5,13,14,584,575,361,-214
2020,5,13,15,575,569,360,-209
2020,5,13,16,569,545,354,-191
2020,5,13,17,554,530,355,-175
2020,5,13,18,537,520,352,-168
2020,5,13,19,526,509,332,-177
2020,5,13,20,523,508,310,-198
2020,5,13,21,529,507,326,-181
2020,5,13,22,534,511,347,-164
2020,5,13,23,546,522,348,-174
2020,5,14,0,549,520,349,-171
2020,5,14,1,549,520,348,-172
2020,5,14,2,543,511,350,-161
2020,5,14,3,504,475,348,-127
2020,5,14,4,461,442,343,-99
2020,5,14,5,432,413,292,-121
2020,5,14,6,414,404,276,-128
2020,5,14,7,408,398,265,-133
2020,5,14,8,410,403,260,-143
2020,5,14,9,422,414,243,-171
2020,5,14,10,452,441,252,-189
2020,5,14,11,514,482,305,-177
2020,5,14,12,545,518,325,-193
2020,5,14,13,544,538,321,-217
2020,5,14,14,537,531,316,-215
2020,5,14,15,524,520,313,-207
2020,5,14,16,515,512,309,-203
2020,5,14,17,510,506,306,-200
2020,5,14,18,510,510,304,-206
2020,5,14,19,506,509,330,-179
2020,5,14,20,507,512,339,-173
2020,5,14,21,516,519,340,-179
2020,5,14,22,522,533,338,-195
2020,5,14,23,529,542,338,-204
2020,5,15,0,531,539,339,-200
2020,5,15,1,534,536,341,-195
2020,5,15,2,525,523,340,-183
2020,5,15,3,486,475,336,-139
2020,5,15,4,437,434,341,-93
2020,5,15,5,399,391,307,-84
2020,5,15,6,377,376,299,-77
2020,5,15,7,368,363,302,-61
2020,5,15,8,367,361,306,-55
2020,5,15,9,375,364,306,-58
2020,5,15,10,406,380,310,-70
2020,5,15,11,468,412,339,-73
2020,5,15,12,501,451,340,-111
2020,5,15,13,509,476,331,-145
2020,5,15,14,512,485,312,-173
2020,5,15,15,512,494,336,-158
2020,5,15,16,517,499,339,-160
2020,5,15,17,522,506,338,-168
2020,5,15,18,521,515,339,-176
2020,5,15,19,535,515,335,-180
2020,5,15,20,545,528,335,-193
2020,5,15,21,557,539,334,-205
2020,5,15,22,562,556,336,-220
2020,5,15,23,554,558,337,-221
2020,5,16,0,544,543,338,-205
2020,5,16,1,538,535,342,-193
2020,5,16,2,531,521,340,-181
2020,5,16,3,491,481,339,-142
2020,5,16,4,450,437,339,-98
2020,5,16,5,397,390,304,-86
2020,5,16,6,379,375,306,-69
2020,5,16,7,362,358,307,-51
2020,5,16,8,357,350,306,-44
2020,5,16,9,350,353,306,-47
2020,5,16,10,362,357,253,-104
2020,5,16,11,386,367,289,-78
2020,5,16,12,418,390,305,-85
2020,5,16,13,454,421,307,-114
2020,5,16,14,482,441,307,-134
2020,5,16,15,497,454,306,-148
2020,5,16,16,500,470,313,-157
2020,5,16,17,503,484,337,-147
2020,5,16,18,514,500,330,-170
2020,5,16,19,530,514,334,-180
2020,5,16,20,546,529,301,-228
2020,5,16,21,560,548,332,-216
2020,5,16,22,582,568,334,-234
2020,5,16,23,580,564,333,-231
2020,5,17,0,559,552,338,-214
2020,5,17,1,540,529,339,-190
2020,5,17,2,532,517,341,-176
2020,5,17,3,494,474,343,-131
2020,5,17,4,445,429,345,-84
2020,5,17,5,404,393,317,-76
2020,5,17,6,379,369,315,-54
2020,5,17,7,366,355,315,-40
2020,5,17,8,356,346,310,-36
2020,5,17,9,354,341,303,-38
2020,5,17,10,357,349,297,-52
2020,5,17,11,380,356,248,-108
2020,5,17,12,409,372,280,-92
2020,5,17,13,451,404,282,-122
2020,5,17,14,472,438,332,-106
2020,5,17,15,472,457,341,-116
2020,5,17,16,498,473,337,-136
2020,5,17,17,515,493,337,-156
2020,5,17,18,541,504,336,-168
2020,5,17,19,567,510,336,-174
2020,5,17,20,570,528,334,-194
2020,5,17,21,591,547,335,-212
2020,5,17,22,612,567,336,-231
2020,5,17,23,615,568,335,-233
2020,5,18,0,597,558,338,-220
2020,5,18,1,586,544,339,-205
2020,5,18,2,568,527,338,-189
2020,5,18,3,516,489,312,-177
2020,5,18,4,461,443,276,-167
2020,5,18,5,406,405,328,-77
2020,5,18,6,381,379,277,-102
2020,5,18,7,364,368,276,-92
2020,5,18,8,358,362,276,-86
2020,5,18,9,361,367,310,-57
2020,5,18,10,383,385,328,-57
2020,5,18,11,436,415,328,-87
2020,5,18,12,465,456,331,-125
2020,5,18,13,502,486,338,-148
2020,5,18,14,520,508,339,-169
2020,5,18,15,531,525,338,-187
2020,5,18,16,553,533,337,-196
2020,5,18,17,560,535,337,-198
2020,5,18,18,564,535,338,-197
2020,5,18,19,570,528,336,-192
2020,5,18,20,572,528,337,-191
2020,5,18,21,574,532,337,-195
2020,5,18,22,583,544,336,-208
2020,5,18,23,585,543,337,-206
2020,5,19,0,574,533,337,-196
2020,5,19,1,557,526,338,-188
2020,5,19,2,530,508,338,-170
2020,5,19,3,487,474,338,-136
2020,5,19,4,441,434,338,-96
2020,5,19,5,409,403,335,-68
2020,5,19,6,382,381,328,-53
2020,5,19,7,371,372,316,-56
2020,5,19,8,364,368,298,-70
2020,5,19,9,371,372,297,-75
2020,5,19,10,400,390,336,-54
2020,5,19,11,446,422,338,-84
2020,5,19,12,484,458,339,-119
2020,5,19,13,498,485,253,-232
2020,5,19,14,503,499,257,-242
2020,5,19,15,506,514,271,-243
2020,5,19,16,518,523,340,-183
2020,5,19,17,519,528,345,-183
2020,5,19,18,519,524,344,-180
2020,5,19,19,512,519,347,-172
2020,5,19,20,521,510,345,-165
2020,5,19,21,526,513,348,-165
2020,5,19,22,547,519,347,-172
2020,5,19,23,549,525,348,-177
2020,5,20,0,538,523,348,-175
2020,5,20,1,530,515,347,-168
2020,5,20,2,518,498,348,-150
2020,5,20,3,472,464,346,-118
2020,5,20,4,424,426,294,-132
2020,5,20,5,390,401,277,-124
2020,5,20,6,373,384,275,-109
2020,5,20,7,368,378,275,-103
2020,5,20,8,369,378,276,-102
2020,5,20,9,375,386,276,-110
2020,5,20,10,407,409,305,-104
2020,5,20,11,459,460,343,-117
2020,5,20,12,492,500,344,-156
2020,5,20,13,505,535,348,-187
2020,5,20,14,506,553,346,-207
2020,5,20,15,497,568,347,-221
2020,5,20,16,501,570,347,-223
2020,5,20,17,501,574,347,-227
2020,5,20,18,509,562,347,-215
2020,5,20,19,506,546,346,-200
2020,5,20,20,505,548,346,-202
2020,5,20,21,516,557,349,-208
2020,5,20,22,538,574,348,-226
2020,5,20,23,538,583,351,-232
2020,5,21,0,528,575,352,-223
2020,5,21,1,524,565,351,-214
2020,5,21,2,516,544,346,-198
2020,5,21,3,477,504,345,-159
2020,5,21,4,433,470,305,-165
2020,5,21,5,405,441,292,-149
2020,5,21,6,387,425,302,-123
2020,5,21,7,385,420,293,-127
2020,5,21,8,389,416,274,-142
2020,5,21,9,399,425,298,-127
2020,5,21,10,422,442,325,-117
2020,5,21,11,466,491,347,-144
2020,5,21,12,497,522,350,-172
2020,5,21,13,520,540,286,-254
2020,5,21,14,520,553,293,-260
2020,5,21,15,504,547,349,-198
2020,5,21,16,503,539,351,-188
2020,5,21,17,504,529,350,-179
2020,5,21,18,512,519,350,-169
2020,5,21,19,505,505,347,-158
2020,5,21,20,501,501,346,-155
2020,5,21,21,504,505,344,-161
2020,5,21,22,516,516,347,-169
2020,5,21,23,524,523,347,-176
2020,5,22,0,518,527,351,-176
2020,5,22,1,505,524,350,-174
2020,5,22,2,495,514,351,-163
2020,5,22,3,464,478,352,-126
2020,5,22,4,432,441,344,-97
2020,5,22,5,393,403,328,-75
2020,5,22,6,374,385,326,-59
2020,5,22,7,368,382,308,-74
2020,5,22,8,370,378,285,-93
2020,5,22,9,374,379,292,-87
2020,5,22,10,396,396,337,-59
2020,5,22,11,436,432,350,-82
2020,5,22,12,468,464,350,-114
2020,5,22,13,494,485,343,-142
2020,5,22,14,506,494,340,-154
2020,5,22,15,499,497,317,-180
2020,5,22,16,511,505,338,-167
2020,5,22,17,521,512,342,-170
2020,5,22,18,525,518,344,-174
2020,5,22,19,532,516,346,-170
2020,5,22,20,539,505,347,-158
2020,5,22,21,548,504,348,-156
2020,5,22,22,559,509,347,-162
2020,5,22,23,557,509,343,-166
2020,5,23,0,541,502,346,-156
2020,5,23,1,519,499,345,-154
2020,5,23,2,505,495,347,-148
2020,5,23,3,477,468,350,-118
2020,5,23,4,446,429,344,-85
2020,5,23,5,360,397,338,-59
2020,5,23,6,350,373,340,-33
2020,5,23,7,339,367,327,-40
2020,5,23,8,338,358,283,-75
2020,5,23,9,335,362,274,-88
2020,5,23,10,350,370,276,-94
2020,5,23,11,382,382,274,-108
2020,5,23,12,413,406,275,-131
2020,5,23,13,439,430,292,-138
2020,5,23,14,462,453,349,-104
2020,5,23,15,472,469,340,-129
2020,5,23,16,480,480,299,-181
2020,5,23,17,474,495,332,-163
2020,5,23,18,470,503,336,-167
2020,5,23,19,473,513,335,-178
2020,5,23,20,490,519,335,-184
2020,5,23,21,500,543,333,-210
2020,5,23,22,512,565,334,-231
2020,5,23,23,508,574,333,-241
2020,5,24,0,501,560,331,-229
2020,5,24,1,490,543,332,-211
2020,5,24,2,482,538,341,-197
2020,5,24,3,454,493,336,-157
2020,5,24,4,412,450,342,-108
2020,5,24,5,394,413,345,-68
2020,5,24,6,369,379,341,-38
2020,5,24,7,356,368,339,-29
2020,5,24,8,348,355,329,-26
2020,5,24,9,347,346,281,-65
2020,5,24,10,351,351,276,-75
2020,5,24,11,369,362,275,-87
2020,5,24,12,397,383,275,-108
2020,5,24,13,441,417,318,-99
2020,5,24,14,465,456,283,-173
2020,5,24,15,489,481,278,-203
2020,5,24,16,515,515,335,-180
2020,5,24,17,526,538,331,-207
2020,5,24,18,543,550,327,-223
2020,5,24,19,552,552,373,-179
2020,5,24,20,573,536,407,-129
2020,5,24,21,580,528,420,-108
2020,5,24,22,589,544,428,-116
2020,5,24,23,580,548,409,-139
2020,5,25,0,569,539,340,-199
2020,5,25,1,547,534,338,-196
2020,5,25,2,522,526,339,-187
2020,5,25,3,494,485,335,-150
2020,5,25,4,443,441,337,-104
2020,5,25,5,402,402,314,-88
2020,5,25,6,377,376,272,-104
2020,5,25,7,363,365,273,-92
2020,5,25,8,356,354,274,-80
2020,5,25,9,354,352,298,-54
2020,5,25,10,356,362,323,-39
2020,5,25,11,373,373,258,-115
2020,5,25,12,402,398,288,-110
2020,5,25,13,447,427,299,-128
2020,5,25,14,468,462,299,-163
2020,5,25,15,489,490,326,-164
2020,5,25,16,514,507,332,-175
2020,5,25,17,523,529,332,-197
2020,5,25,18,538,539,332,-207
2020,5,25,19,544,549,332,-217
2020,5,25,20,560,562,332,-230
2020,5,25,21,566,574,331,-243
2020,5,25,22,575,589,333,-256
2020,5,25,23,561,586,331,-255
2020,5,26,0,552,572,331,-241
2020,5,26,1,538,561,334,-227
2020,5,26,2,513,541,331,-210
2020,5,26,3,486,501,333,-168
2020,5,26,4,438,445,321,-124
2020,5,26,5,419,417,328,-89
2020,5,26,6,391,385,327,-58
2020,5,26,7,379,382,333,-49
2020,5,26,8,374,374,319,-55
2020,5,26,9,377,381,316,-65
2020,5,26,10,395,400,332,-68
2020,5,26,11,431,437,332,-105
2020,5,26,12,469,474,334,-140
2020,5,26,13,500,503,333,-170
2020,5,26,14,518,526,333,-193
2020,5,26,15,535,539,332,-207
2020,5,26,16,555,551,332,-219
2020,5,26,17,567,558,332,-226
2020,5,26,18,578,555,333,-222
2020,5,26,19,580,552,333,-219
2020,5,26,20,587,554,333,-221
2020,5,26,21,595,559,334,-225
2020,5,26,22,604,564,332,-232
2020,5,26,23,601,573,333,-240
2020,5,27,0,589,558,332,-226
2020,5,27,1,568,550,333,-217
2020,5,27,2,544,537,332,-205
2020,5,27,3,501,498,333,-165
2020,5,27,4,458,451,331,-120
2020,5,27,5,401,418,333,-85
2020,5,27,6,381,394,332,-62
2020,5,27,7,372,380,333,-47
2020,5,27,8,369,374,331,-43
2020,5,27,9,371,375,333,-42
2020,5,27,10,388,396,334,-62
2020,5,27,11,424,427,332,-95
2020,5,27,12,452,471,332,-139
2020,5,27,13,481,498,334,-164
2020,5,27,14,495,519,331,-188
2020,5,27,15,505,539,335,-204
2020,5,27,16,519,544,333,-211
2020,5,27,17,530,551,333,-218
2020,5,27,18,540,548,331,-217
2020,5,27,19,544,544,332,-212
2020,5,27,20,548,543,333,-210
2020,5,27,21,555,546,333,-213
2020,5,27,22,568,546,332,-214
2020,5,27,23,575,550,333,-217
2020,5,28,0,560,535,331,-204
2020,5,28,1,547,534,334,-200
2020,5,28,2,528,526,332,-194
2020,5,28,3,486,489,332,-157
2020,5,28,4,446,444,327,-117
2020,5,28,5,398,410,329,-81
2020,5,28,6,376,389,331,-58
2020,5,28,7,367,380,331,-49
2020,5,28,8,364,373,332,-41
2020,5,28,9,367,380,331,-49
2020,5,28,10,384,399,333,-66
2020,5,28,11,423,432,331,-101
2020,5,28,12,453,472,332,-140
2020,5,28,13,488,497,332,-165
2020,5,28,14,508,519,331,-188
2020,5,28,15,518,535,331,-204
2020,5,28,16,533,555,332,-223
2020,5,28,17,540,569,333,-236
2020,5,28,18,550,569,333,-236
2020,5,28,19,557,586,330,-256
2020,5,28,20,559,594,403,-191
2020,5,28,21,568,617,401,-216
2020,5,28,22,586,627,454,-173
2020,5,28,23,589,628,477,-151
2020,5,29,0,580,611,443,-168
2020,5,29,1,567,557,330,-227
2020,5,29,2,545,578,334,-244
2020,5,29,3,502,530,333,-197
2020,5,29,4,460,482,334,-148
2020,5,29,5,420,438,333,-105
2020,5,29,6,395,409,333,-76
2020,5,29,7,383,393,332,-61
2020,5,29,8,377,382,333,-49
2020,5,29,9,377,385,333,-52
2020,5,29,10,394,400,334,-66
2020,5,29,11,428,429,341,-88
2020,5,29,12,462,465,339,-126
2020,5,29,13,498,493,339,-154
2020,5,29,14,516,511,338,-173
2020,5,29,15,534,528,337,-191
2020,5,29,16,554,542,333,-209
2020,5,29,17,566,567,331,-236
2020,5,29,18,580,624,370,-254
2020,5,29,19,592,616,398,-218
2020,5,29,20,591,591,398,-193
2020,5,29,21,598,610,399,-211
2020,5,29,22,607,614,399,-215
2020,5,29,23,602,593,386,-207
2020,5,30,0,580,529,330,-199
2020,5,30,1,556,569,333,-236
2020,5,30,2,538,551,331,-220
2020,5,30,3,505,514,333,-181
2020,5,30,4,466,464,338,-126
2020,5,30,5,404,421,337,-84
2020,5,30,6,382,398,336,-62
2020,5,30,7,360,381,339,-42
2020,5,30,8,355,366,337,-29
2020,5,30,9,351,366,339,-27
2020,5,30,10,359,370,341,-29
2020,5,30,11,386,382,339,-43
2020,5,30,12,415,404,341,-63
2020,5,30,13,449,442,341,-101
2020,5,30,14,486,466,336,-130
2020,5,30,15,503,506,334,-172
2020,5,30,16,522,532,331,-201
2020,5,30,17,532,545,329,-216
2020,5,30,18,529,546,351,-195
2020,5,30,19,535,562,397,-165
2020,5,30,20,551,577,408,-169
2020,5,30,21,557,587,466,-121
2020,5,30,22,572,595,545,-50
2020,5,30,23,557,582,514,-68
2020,5,31,0,545,571,475,-96
2020,5,31,1,530,545,473,-72
2020,5,31,2,512,534,423,-111
2020,5,31,3,473,479,334,-145
2020,5,31,4,430,444,336,-108
2020,5,31,5,391,402,335,-67
2020,5,31,6,366,377,334,-43
2020,5,31,7,355,365,337,-28
2020,5,31,8,348,355,337,-18
2020,5,31,9,345,349,332,-17
2020,5,31,10,348,356,317,-39
2020,5,31,11,361,363,283,-80
2020,5,31,12,389,387,320,-67
2020,5,31,13,429,419,336,-83
2020,5,31,14,449,454,339,-115
2020,5,31,15,457,469,336,-133
2020,5,31,16,460,479,337,-142
2020,5,31,17,464,492,334,-158
2020,5,31,18,469,496,333,-163
2020,5,31,19,476,507,337,-170
2020,5,31,20,486,518,331,-187
2020,5,31,21,493,534,333,-201
2020,5,31,22,507,549,332,-217
2020,5,31,23,508,554,333,-221
2020,6,1,0,507,543,337,-206
2020,6,1,1,506,517,336,-181
2020,6,1,2,490,509,339,-170
2020,6,1,3,460,473,337,-136
2020,6,1,4,412,423,336,-87
2020,6,1,5,369,396,221,-175
2020,6,1,6,345,369,157,-212
2020,6,1,7,339,359,224,-135
2020,6,1,8,337,355,228,-127
2020,6,1,9,345,357,220,-137
2020,6,1,10,365,398,238,-160
2020,6,1,11,405,424,227,-197
2020,6,1,12,456,460,220,-240
2020,6,1,13,500,464,202,-262
2020,6,1,14,514,517,213,-304
2020,6,1,15,515,509,147,-362
2020,6,1,16,531,514,145,-369
2020,6,1,17,541,527,152,-375
2020,6,1,18,551,533,173,-360
2020,6,1,19,548,542,231,-311
2020,6,1,20,544,556,230,-326
2020,6,1,21,545,573,254,-319
2020,6,1,22,566,593,350,-243
2020,6,1,23,575,604,381,-223
2020,6,2,0,558,591,338,-253
2020,6,2,1,545,562,147,-415
2020,6,2,2,523,549,154,-395
2020,6,2,3,478,500,165,-335
2020,6,2,4,431,454,182,-272
2020,6,2,5,376,408,152,-256
2020,6,2,6,362,383,149,-234
2020,6,2,7,356,372,139,-233
2020,6,2,8,354,366,114,-252
2020,6,2,9,360,368,114,-254
2020,6,2,10,377,386,132,-254
2020,6,2,11,411,416,145,-271
2020,6,2,12,453,456,146,-310
2020,6,2,13,493,483,147,-336
2020,6,2,14,511,497,145,-352
2020,6,2,15,513,517,147,-370
2020,6,2,16,527,537,148,-389
2020,6,2,17,542,580,187,-393
2020,6,2,18,551,675,288,-387
2020,6,2,19,563,611,315,-296
2020,6,2,20,576,628,316,-312
2020,6,2,21,592,656,321,-335
2020,6,2,22,618,661,326,-335
2020,6,2,23,625,679,343,-336
2020,6,3,0,603,624,418,-206
2020,6,3,1,580,527,391,-136
2020,6,3,2,554,608,411,-197
2020,6,3,3,511,549,333,-216
2020,6,3,4,466,492,337,-155
2020,6,3,5,425,440,310,-130
2020,6,3,6,397,414,308,-106
2020,6,3,7,383,396,306,-90
2020,6,3,8,375,385,292,-93
2020,6,3,9,374,384,280,-104
2020,6,3,10,379,403,299,-104
2020,6,3,11,416,441,308,-133
2020,6,3,12,457,481,305,-176
2020,6,3,13,505,515,307,-208
2020,6,3,14,531,544,333,-211
2020,6,3,15,557,575,330,-245
2020,6,3,16,587,597,460,-137
2020,6,3,17,617,515,450,-65
2020,6,3,18,638,541,460,-81
2020,6,3,19,664,569,486,-83
2020,6,3,20,680,576,488,-88
2020,6,3,21,699,583,486,-97
2020,6,3,22,723,592,485,-107
2020,6,3,23,725,557,486,-71
2020,6,4,0,694,535,488,-47
2020,6,4,1,656,510,489,-21
2020,6,4,2,612,630,495,-135
2020,6,4,3,561,574,500,-74
2020,6,4,4,508,514,498,-16
2020,6,4,5,451,454,431,-23
2020,6,4,6,417,423,411,-12
2020,6,4,7,400,403,394,-9
2020,6,4,8,390,390,382,-8
2020,6,4,9,387,387,381,-6
2020,6,4,10,403,401,395,-6
2020,6,4,11,432,431,426,-5
2020,6,4,12,471,470,462,-8
2020,6,4,13,520,505,487,-18
2020,6,4,14,548,537,485,-52
2020,6,4,15,573,581,483,-98
2020,6,4,16,610,614,479,-135
2020,6,4,17,643,646,480,-166
2020,6,4,18,661,670,475,-195
2020,6,4,19,687,682,478,-204
2020,6,4,20,703,690,478,-212
2020,6,4,21,720,691,479,-212
2020,6,4,22,740,671,477,-194
2020,6,4,23,737,647,477,-170
2020,6,5,0,704,626,477,-149
2020,6,5,1,669,610,478,-132
2020,6,5,2,627,589,342,-247
2020,6,5,3,579,543,317,-226
2020,6,5,4,521,488,316,-172
2020,6,5,5,459,449,266,-183
2020,6,5,6,425,419,260,-159
2020,6,5,7,406,400,261,-139
2020,6,5,8,398,393,262,-131
2020,6,5,9,394,395,270,-125
2020,6,5,10,407,406,323,-83
2020,6,5,11,432,442,324,-118
2020,6,5,12,471,474,322,-152
2020,6,5,13,517,510,322,-188
2020,6,5,14,542,542,324,-218
2020,6,5,15,569,561,322,-239
2020,6,5,16,599,576,322,-254
2020,6,5,17,630,544,322,-222
2020,6,5,18,644,530,313,-217
2020,6,5,19,662,532,319,-213
2020,6,5,20,676,531,323,-208
2020,6,5,21,684,498,325,-173
2020,6,5,22,700,481,323,-158
2020,6,5,23,692,467,323,-144
2020,6,6,0,659,505,316,-189
2020,6,6,1,622,568,322,-246
2020,6,6,2,589,573,323,-250
2020,6,6,3,559,529,323,-206
2020,6,6,4,513,478,322,-156
2020,6,6,5,449,433,323,-110
2020,6,6,6,419,400,320,-80
2020,6,6,7,396,382,323,-59
2020,6,6,8,387,374,323,-51
2020,6,6,9,384,371,325,-46
2020,6,6,10,388,373,322,-51
2020,6,6,11,402,385,323,-62
2020,6,6,12,437,407,324,-83
2020,6,6,13,487,450,322,-128
2020,6,6,14,522,491,323,-168
2020,6,6,15,554,531,324,-207
2020,6,6,16,587,560,327,-233
2020,6,6,17,610,588,327,-261
2020,6,6,18,619,572,324,-248
2020,6,6,19,642,543,324,-219
2020,6,6,20,648,561,325,-236
2020,6,6,21,659,524,321,-203
2020,6,6,22,675,544,324,-220
2020,6,6,23,667,537,323,-214
2020,6,7,0,640,519,324,-195
2020,6,7,1,611,478,324,-154
2020,6,7,2,588,456,324,-132
2020,6,7,3,540,546,327,-219
2020,6,7,4,510,501,329,-172
2020,6,7,5,479,441,284,-157
2020,6,7,6,438,404,264,-140
2020,6,7,7,422,385,268,-117
2020,6,7,8,407,371,265,-106
2020,6,7,9,399,366,265,-101
2020,6,7,10,406,371,266,-105
2020,6,7,11,425,376,267,-109
2020,6,7,12,452,402,267,-135
2020,6,7,13,499,447,325,-122
2020,6,7,14,539,488,328,-160
2020,6,7,15,576,535,329,-206
2020,6,7,16,619,576,325,-251
2020,6,7,17,643,616,323,-293
2020,6,7,18,663,656,323,-333
2020,6,7,19,676,674,319,-355
2020,6,7,20,689,693,400,-293
2020,6,7,21,707,722,452,-270
2020,6,7,22,704,735,449,-286
2020,6,7,23,689,738,553,-185
2020,6,8,0,670,717,473,-244
2020,6,8,1,642,676,423,-253
2020,6,8,2,622,656,412,-244
2020,6,8,3,575,596,371,-225
2020,6,8,4,520,536,322,-214
2020,6,8,5,450,482,277,-205
2020,6,8,6,418,443,262,-181
2020,6,8,7,399,424,266,-158
2020,6,8,8,391,413,265,-148
2020,6,8,9,391,413,266,-147
2020,6,8,10,404,428,266,-162
2020,6,8,11,429,456,266,-190
2020,6,8,12,465,494,266,-228
2020,6,8,13,514,539,271,-268
2020,6,8,14,543,577,330,-247
2020,6,8,15,574,612,327,-285
2020,6,8,16,602,641,345,-296
2020,6,8,17,639,675,396,-279
2020,6,8,18,656,704,424,-280
2020,6,8,19,668,725,425,-300
2020,6,8,20,674,740,446,-294
2020,6,8,21,683,745,479,-266
2020,6,8,22,695,758,460,-298
2020,6,8,23,698,755,460,-295
2020,6,9,0,670,728,468,-260
2020,6,9,1,635,697,397,-300
2020,6,9,2,601,675,417,-258
2020,6,9,3,560,621,398,-223
2020,6,9,4,508,561,320,-241
2020,6,9,5,483,514,266,-248
2020,6,9,6,449,478,263,-215
2020,6,9,7,430,459,265,-194
2020,6,9,8,422,447,267,-180
2020,6,9,9,420,446,265,-181
2020,6,9,10,430,461,265,-196
2020,6,9,11,451,490,266,-224
2020,6,9,12,492,529,265,-264
2020,6,9,13,542,573,282,-291
2020,6,9,14,580,607,334,-273
2020,6,9,15,612,647,345,-302
2020,6,9,16,654,686,399,-287
2020,6,9,17,684,717,413,-304
2020,6,9,18,696,739,410,-329
2020,6,9,19,710,759,450,-309
2020,6,9,20,711,780,463,-317
2020,6,9,21,721,793,460,-333
2020,6,9,22,738,795,470,-325
2020,6,9,23,737,781,477,-304
2020,6,10,0,707,739,480,-259
2020,6,10,1,669,708,480,-228
2020,6,10,2,635,679,463,-216
2020,6,10,3,590,621,398,-223
2020,6,10,4,540,561,367,-194
2020,6,10,5,484,512,265,-247
2020,6,10,6,447,477,265,-212
2020,6,10,7,427,457,266,-191
2020,6,10,8,415,442,266,-176
2020,6,10,9,413,436,268,-168
2020,6,10,10,423,451,265,-186
2020,6,10,11,451,482,263,-219
2020,6,10,12,490,520,266,-254
2020,6,10,13,542,549,272,-277
2020,6,10,14,577,569,376,-193
2020,6,10,15,611,593,412,-181
2020,6,10,16,647,610,475,-135
2020,6,10,17,672,637,473,-164
2020,6,10,18,682,651,483,-168
2020,6,10,19,695,657,476,-181
2020,6,10,20,697,660,475,-185
2020,6,10,21,706,671,475,-196
2020,6,10,22,730,688,482,-206
2020,6,10,23,725,681,485,-196
2020,6,11,0,688,666,482,-184
2020,6,11,1,643,645,482,-163
2020,6,11,2,612,632,481,-151
2020,6,11,3,566,588,375,-213
2020,6,11,4,512,532,296,-236
2020,6,11,5,432,487,270,-217
2020,6,11,6,406,457,264,-193
2020,6,11,7,390,437,266,-171
2020,6,11,8,384,423,264,-159
2020,6,11,9,386,426,266,-160
2020,6,11,10,398,439,278,-161
2020,6,11,11,422,471,328,-143
2020,6,11,12,457,505,329,-176
2020,6,11,13,504,534,331,-203
2020,6,11,14,532,554,339,-215
2020,6,11,15,555,571,337,-234
2020,6,11,16,580,595,347,-248
2020,6,11,17,605,612,404,-208
2020,6,11,18,617,630,405,-225
2020,6,11,19,621,651,403,-248
2020,6,11,20,622,673,403,-270
2020,6,11,21,634,682,404,-278
2020,6,11,22,646,685,404,-281
2020,6,11,23,644,684,404,-280
2020,6,12,0,629,653,404,-249
2020,6,12,1,601,625,409,-216
2020,6,12,2,574,601,405,-196
2020,6,12,3,533,556,404,-152
2020,6,12,4,491,500,406,-94
2020,6,12,5,412,450,336,-114
2020,6,12,6,387,425,290,-135
2020,6,12,7,373,410,337,-73
2020,6,12,8,369,395,336,-59
2020,6,12,9,368,400,336,-64
2020,6,12,10,381,408,334,-74
2020,6,12,11,395,429,279,-150
2020,6,12,12,432,468,271,-197
2020,6,12,13,476,499,272,-227
2020,6,12,14,498,524,275,-249
2020,6,12,15,511,531,333,-198
2020,6,12,16,530,550,334,-216
2020,6,12,17,549,569,335,-234
2020,6,12,18,562,587,331,-256
2020,6,12,19,579,612,332,-280
2020,6,12,20,585,627,331,-296
2020,6,12,21,596,634,323,-311
2020,6,12,22,617,658,416,-242
2020,6,12,23,612,652,421,-231
2020,6,13,0,582,622,401,-221
2020,6,13,1,554,588,351,-237
2020,6,13,2,535,568,333,-235
2020,6,13,3,507,529,333,-196
2020,6,13,4,464,475,266,-209
2020,6,13,5,406,426,268,-158
2020,6,13,6,377,402,264,-138
2020,6,13,7,367,386,255,-131
2020,6,13,8,360,375,266,-109
2020,6,13,9,358,369,270,-99
2020,6,13,10,365,373,270,-103
2020,6,13,11,382,383,272,-111
2020,6,13,12,412,408,334,-74
2020,6,13,13,444,438,334,-104
2020,6,13,14,468,468,330,-138
2020,6,13,15,487,488,287,-201
2020,6,13,16,502,509,299,-210
2020,6,13,17,514,526,306,-220
2020,6,13,18,521,540,331,-209
2020,6,13,19,537,553,331,-222
2020,6,13,20,547,569,330,-239
2020,6,13,21,560,585,331,-254
2020,6,13,22,578,598,331,-267
2020,6,13,23,564,588,332,-256
2020,6,14,0,551,568,331,-237
2020,6,14,1,535,545,311,-234
2020,6,14,2,527,534,268,-266
2020,6,14,3,494,499,270,-229
2020,6,14,4,444,445,267,-178
2020,6,14,5,404,407,267,-140
2020,6,14,6,374,381,260,-121
2020,6,14,7,355,362,220,-142
2020,6,14,8,347,358,218,-140
2020,6,14,9,345,355,226,-129
2020,6,14,10,350,358,253,-105
2020,6,14,11,361,366,216,-150
2020,6,14,12,389,388,203,-185
2020,6,14,13,434,428,223,-205
2020,6,14,14,471,457,331,-126
2020,6,14,15,494,477,331,-146
2020,6,14,16,497,490,332,-158
2020,6,14,17,509,501,330,-171
2020,6,14,18,526,521,331,-190
2020,6,14,19,535,536,333,-203
2020,6,14,20,549,522,330,-192
2020,6,14,21,549,520,335,-185
2020,6,14,22,571,523,332,-191
2020,6,14,23,575,510,333,-177
2020,6,15,0,568,504,313,-191
2020,6,15,1,563,492,335,-157
2020,6,15,2,548,490,334,-156
2020,6,15,3,509,456,332,-124
2020,6,15,4,441,424,333,-91
2020,6,15,5,395,392,298,-94
2020,6,15,6,372,374,283,-91
2020,6,15,7,363,365,281,-84
2020,6,15,8,360,358,269,-89
2020,6,15,9,366,362,269,-93
2020,6,15,10,377,385,269,-116
2020,6,15,11,401,421,270,-151
2020,6,15,12,436,455,271,-184
2020,6,15,13,480,486,276,-210
2020,6,15,14,499,509,332,-177
2020,6,15,15,511,519,334,-185
2020,6,15,16,522,532,335,-197
2020,6,15,17,531,534,334,-200
2020,6,15,18,536,537,331,-206
2020,6,15,19,530,538,334,-204
2020,6,15,20,528,542,334,-208
2020,6,15,21,520,544,333,-211
2020,6,15,22,528,550,334,-216
2020,6,15,23,529,553,334,-219
2020,6,16,0,515,543,333,-210
2020,6,16,1,498,531,335,-196
2020,6,16,2,481,518,333,-185
2020,6,16,3,452,482,333,-149
2020,6,16,4,417,440,334,-106
2020,6,16,5,396,408,307,-101
2020,6,16,6,383,390,301,-89
2020,6,16,7,375,382,299,-83
2020,6,16,8,372,376,276,-100
2020,6,16,9,378,383,241,-142
2020,6,16,10,395,399,282,-117
2020,6,16,11,422,439,292,-147
2020,6,16,12,460,467,301,-166
2020,6,16,13,499,498,303,-195
2020,6,16,14,512,526,334,-192
2020,6,16,15,516,533,334,-199
2020,6,16,16,526,537,334,-203
2020,6,16,17,533,533,335,-198
2020,6,16,18,533,537,333,-204
2020,6,16,19,521,536,335,-201
2020,6,16,20,510,532,335,-197
2020,6,16,21,514,540,334,-206
2020,6,16,22,521,547,334,-213
2020,6,16,23,524,545,334,-211
2020,6,17,0,508,532,332,-200
2020,6,17,1,500,527,333,-194
2020,6,17,2,487,518,334,-184
2020,6,17,3,462,482,332,-150
2020,6,17,4,434,446,335,-111
2020,6,17,5,406,412,278,-134
2020,6,17,6,393,395,218,-177
2020,6,17,7,385,385,209,-176
2020,6,17,8,384,381,226,-155
2020,6,17,9,388,386,244,-142
2020,6,17,10,402,405,268,-137
2020,6,17,11,430,444,253,-191
2020,6,17,12,466,482,264,-218
2020,6,17,13,501,502,234,-268
2020,6,17,14,515,518,222,-296
2020,6,17,15,517,522,280,-242
2020,6,17,16,520,529,279,-250
2020,6,17,17,523,539,281,-258
2020,6,17,18,529,538,281,-257
2020,6,17,19,522,532,280,-252
2020,6,17,20,514,539,284,-255
2020,6,17,21,517,545,329,-216
2020,6,17,22,524,547,335,-212
2020,6,17,23,528,546,332,-214
2020,6,18,0,511,541,334,-207
2020,6,18,1,495,533,333,-200
2020,6,18,2,488,525,332,-193
2020,6,18,3,458,496,334,-162
2020,6,18,4,427,449,285,-164
2020,6,18,5,403,416,267,-149
2020,6,18,6,388,397,253,-144
2020,6,18,7,381,382,216,-166
2020,6,18,8,379,377,213,-164
2020,6,18,9,385,381,214,-167
2020,6,18,10,400,399,262,-137
2020,6,18,11,424,439,262,-177
2020,6,18,12,459,480,275,-205
2020,6,18,13,496,507,278,-229
2020,6,18,14,512,524,280,-244
2020,6,18,15,516,531,339,-192
2020,6,18,16,523,541,338,-203
2020,6,18,17,530,548,336,-212
2020,6,18,18,533,555,336,-219
2020,6,18,19,525,556,336,-220
2020,6,18,20,526,550,337,-213
2020,6,18,21,534,561,337,-224
2020,6,18,22,546,572,334,-238
2020,6,18,23,548,572,331,-241
2020,6,19,0,537,567,337,-230
2020,6,19,1,521,550,334,-216
2020,6,19,2,509,545,338,-207
2020,6,19,3,475,506,336,-170
2020,6,19,4,440,467,292,-175
2020,6,19,5,403,428,274,-154
2020,6,19,6,380,401,272,-129
2020,6,19,7,368,389,249,-140
2020,6,19,8,366,381,244,-137
2020,6,19,9,370,383,243,-140
2020,6,19,10,381,396,273,-123
2020,6,19,11,399,432,284,-148
2020,6,19,12,439,464,280,-184
2020,6,19,13,484,493,279,-214
2020,6,19,14,506,512,276,-236
2020,6,19,15,523,531,272,-259
2020,6,19,16,533,550,274,-276
2020,6,19,17,548,561,331,-230
2020,6,19,18,556,573,334,-239
2020,6,19,19,561,566,333,-233
2020,6,19,20,563,564,329,-235
2020,6,19,21,574,588,332,-256
2020,6,19,22,587,591,331,-260
2020,6,19,23,584,586,332,-254
2020,6,20,0,561,577,335,-242
2020,6,20,1,535,560,335,-225
2020,6,20,2,523,543,335,-208
2020,6,20,3,495,511,334,-177
2020,6,20,4,461,463,289,-174
2020,6,20,5,425,422,272,-150
2020,6,20,6,394,394,271,-123
2020,6,20,7,376,376,273,-103
2020,6,20,8,367,367,273,-94
2020,6,20,9,367,370,269,-101
2020,6,20,10,374,371,271,-100
2020,6,20,11,391,384,267,-117
2020,6,20,12,420,406,273,-133
2020,6,20,13,453,446,272,-174
2020,6,20,14,492,473,275,-198
2020,6,20,15,531,492,319,-173
2020,6,20,16,553,517,332,-185
2020,6,20,17,576,538,329,-209
2020,6,20,18,592,559,324,-235
2020,6,20,19,606,581,392,-189
2020,6,20,20,625,600,402,-198
2020,6,20,21,633,623,414,-209
2020,6,20,22,644,647,439,-208
2020,6,20,23,634,642,447,-195
2020,6,21,0,616,617,397,-220
2020,6,21,1,592,591,397,-194
2020,6,21,2,568,576,361,-215
2020,6,21,3,533,537,329,-208
2020,6,21,4,479,480,284,-196
2020,6,21,5,426,436,263,-173
2020,6,21,6,397,404,256,-148
2020,6,21,7,378,388,250,-138
2020,6,21,8,371,376,261,-115
2020,6,21,9,367,371,248,-123
2020,6,21,10,372,373,237,-136
2020,6,21,11,383,378,230,-148
2020,6,21,12,408,403,256,-147
2020,6,21,13,447,440,326,-114
2020,6,21,14,486,487,333,-154
2020,6,21,15,517,518,327,-191
2020,6,21,16,543,553,328,-225
2020,6,21,17,579,589,335,-254
2020,6,21,18,601,606,338,-268
2020,6,21,19,623,625,365,-260
2020,6,21,20,630,644,404,-240
2020,6,21,21,645,654,553,-101
2020,6,21,22,655,650,569,-81
2020,6,21,23,659,625,573,-52
2020,6,22,0,647,596,583,-13
2020,6,22,1,606,571,566,-5
2020,6,22,2,591,558,521,-37
2020,6,22,3,544,519,519,0
2020,6,22,4,482,464,513,49
2020,6,22,5,436,434,519,85
2020,6,22,6,406,408,520,112
2020,6,22,7,390,397,521,124
2020,6,22,8,380,385,521,136
2020,6,22,9,382,390,521,131
2020,6,22,10,393,402,520,118
2020,6,22,11,412,439,525,86
2020,6,22,12,453,478,580,102
2020,6,22,13,500,517,583,66
2020,6,22,14,529,547,583,36
2020,6,22,15,567,575,569,-6
2020,6,22,16,592,612,585,-27
2020,6,22,17,630,646,584,-62
2020,6,22,18,653,678,575,-103
2020,6,22,19,667,705,573,-132
2020,6,22,20,680,652,574,-78
2020,6,22,21,685,635,578,-57
2020,6,22,22,700,639,579,-60
2020,6,22,23,693,668,577,-91
2020,6,23,0,664,651,579,-72
2020,6,23,1,624,629,582,-47
2020,6,23,2,611,607,579,-28
2020,6,23,3,559,560,553,-7
2020,6,23,4,507,506,501,-5
2020,6,23,5,460,450,442,-8
2020,6,23,6,428,429,424,-5
2020,6,23,7,411,416,411,-5
2020,6,23,8,400,406,399,-7
2020,6,23,9,400,402,435,33
2020,6,23,10,408,422,509,87
2020,6,23,11,427,458,518,60
2020,6,23,12,469,491,571,80
2020,6,23,13,510,525,523,-2
2020,6,23,14,542,552,546,-6
2020,6,23,15,569,580,574,-6
2020,6,23,16,592,608,582,-26
2020,6,23,17,622,612,584,-28
2020,6,23,18,648,603,584,-19
2020,6,23,19,657,602,585,-17
2020,6,23,20,666,621,583,-38
2020,6,23,21,672,640,579,-61
2020,6,23,22,683,658,580,-78
2020,6,23,23,679,673,578,-95
2020,6,24,0,651,645,576,-69
2020,6,24,1,612,616,580,-36
2020,6,24,2,603,590,578,-12
2020,6,24,3,556,541,536,-5
2020,6,24,4,511,492,484,-8
2020,6,24,5,464,450,443,-7
2020,6,24,6,433,421,415,-6
2020,6,24,7,416,404,400,-4
2020,6,24,8,404,399,398,-1
2020,6,24,9,404,398,441,43
2020,6,24,10,414,414,459,45
2020,6,24,11,433,449,490,41
2020,6,24,12,476,478,477,-1
2020,6,24,13,517,512,490,-22
2020,6,24,14,551,538,526,-12
2020,6,24,15,584,570,560,-10
2020,6,24,16,606,582,574,-8
2020,6,24,17,629,605,580,-25
2020,6,24,18,650,624,581,-43
2020,6,24,19,657,650,576,-74
2020,6,24,20,666,672,575,-97
2020,6,24,21,668,681,575,-106
2020,6,24,22,682,684,578,-106
2020,6,24,23,679,663,580,-83
2020,6,25,0,648,639,582,-57
2020,6,25,1,610,604,579,-25
2020,6,25,2,600,593,537,-56
2020,6,25,3,551,548,516,-32
2020,6,25,4,506,493,488,-5
2020,6,25,5,444,446,514,68
2020,6,25,6,414,423,514,91
2020,6,25,7,396,406,501,95
2020,6,25,8,386,396,490,94
2020,6,25,9,385,399,490,91
2020,6,25,10,400,419,516,97
2020,6,25,11,416,452,547,95
2020,6,25,12,455,489,576,87
2020,6,25,13,495,525,520,-5
2020,6,25,14,523,552,540,-12
2020,6,25,15,546,578,565,-13
2020,6,25,16,572,602,582,-20
2020,6,25,17,591,628,581,-47
2020,6,25,18,616,644,579,-65
2020,6,25,19,631,663,577,-86
2020,6,25,20,641,679,578,-101
2020,6,25,21,649,693,577,-116
2020,6,25,22,661,702,578,-124
2020,6,25,23,663,700,578,-122
2020,6,26,0,633,676,579,-97
2020,6,26,1,593,645,583,-62
2020,6,26,2,585,620,537,-83
2020,6,26,3,540,567,518,-49
2020,6,26,4,491,508,494,-14
2020,6,26,5,449,457,446,-11
2020,6,26,6,418,427,414,-13
2020,6,26,7,400,407,371,-36
2020,6,26,8,390,392,368,-24
2020,6,26,9,387,395,371,-24
2020,6,26,10,398,408,397,-11
2020,6,26,11,410,436,428,-8
2020,6,26,12,452,473,467,-6
2020,6,26,13,494,507,498,-9
2020,6,26,14,523,536,528,-8
2020,6,26,15,550,560,544,-16
2020,6,26,16,579,587,572,-15
2020,6,26,17,600,615,582,-33
2020,6,26,18,620,642,578,-64
2020,6,26,19,633,660,575,-85
2020,6,26,20,645,680,574,-106
2020,6,26,21,659,694,576,-118
2020,6,26,22,673,701,575,-126
2020,6,26,23,666,688,578,-110
2020,6,27,0,628,666,583,-83
2020,6,27,1,589,632,583,-49
2020,6,27,2,580,616,546,-70
2020,6,27,3,545,570,519,-51
2020,6,27,4,498,512,501,-11
2020,6,27,5,437,455,449,-6
2020,6,27,6,411,438,431,-7
2020,6,27,7,394,415,408,-7
2020,6,27,8,384,400,394,-6
2020,6,27,9,379,395,389,-6
2020,6,27,10,383,403,396,-7
2020,6,27,11,394,410,403,-7
2020,6,27,12,420,434,425,-9
2020,6,27,13,457,463,427,-36
2020,6,27,14,488,502,443,-59
2020,6,27,15,535,527,492,-35
2020,6,27,16,566,548,492,-56
2020,6,27,17,594,554,489,-65
2020,6,27,18,615,561,492,-69
2020,6,27,19,620,565,492,-73
2020,6,27,20,641,568,490,-78
2020,6,27,21,649,573,490,-83
2020,6,27,22,657,596,518,-78
2020,6,27,23,652,595,576,-19
2020,6,28,0,628,581,566,-15
2020,6,28,1,601,571,553,-18
2020,6,28,2,556,559,540,-19
2020,6,28,3,535,531,518,-13
2020,6,28,4,482,462,451,-11
2020,6,28,5,449,441,480,39
2020,6,28,6,424,416,460,44
2020,6,28,7,407,396,441,45
2020,6,28,8,401,383,431,48
2020,6,28,9,396,380,425,45
2020,6,28,10,398,385,427,42
2020,6,28,11,409,395,407,12
2020,6,28,12,433,415,407,-8
2020,6,28,13,469,457,406,-51
2020,6,28,14,508,498,423,-75
2020,6,28,15,534,545,534,-11
2020,6,28,16,559,574,564,-10
2020,6,28,17,598,612,575,-37
2020,6,28,18,625,637,567,-70
2020,6,28,19,645,651,568,-83
2020,6,28,20,666,645,570,-75
2020,6,28,21,676,653,573,-80
2020,6,28,22,689,657,572,-85
2020,6,28,23,675,629,571,-58
2020,6,29,0,660,607,574,-33
2020,6,29,1,632,585,562,-23
2020,6,29,2,613,572,538,-34
2020,6,29,3,570,533,509,-24
2020,6,29,4,516,482,477,-5
2020,6,29,5,448,442,508,66
2020,6,29,6,417,414,506,92
2020,6,29,7,401,403,499,96
2020,6,29,8,392,396,491,95
2020,6,29,9,394,400,497,97
2020,6,29,10,408,417,504,87
2020,6,29,11,421,448,509,61
2020,6,29,12,461,490,509,19
2020,6,29,13,514,520,517,-3
2020,6,29,14,548,557,545,-12
2020,6,29,15,583,588,571,-17
2020,6,29,16,612,605,573,-32
2020,6,29,17,630,623,574,-49
2020,6,29,18,648,648,574,-74
2020,6,29,19,655,673,572,-101
2020,6,29,20,665,702,571,-131
2020,6,29,21,671,725,571,-154
2020,6,29,22,691,743,571,-172
2020,6,29,23,694,734,572,-162
2020,6,30,0,667,700,570,-130
2020,6,30,1,634,679,572,-107
2020,6,30,2,616,648,573,-75
2020,6,30,3,569,591,570,-21
2020,6,30,4,524,541,531,-10
2020,6,30,5,455,488,482,-6
2020,6,30,6,424,455,546,91
2020,6,30,7,408,440,534,94
2020,6,30,8,399,423,519,96
2020,6,30,9,399,427,522,95
2020,6,30,10,410,437,533,96
2020,6,30,11,427,471,557,86
2020,6,30,12,472,506,497,-9
2020,6,30,13,521,539,513,-26
2020,6,30,14,555,563,506,-57
2020,6,30,15,589,549,429,-120
2020,6,30,16,624,605,567,-38
2020,6,30,17,643,621,571,-50
2020,6,30,18,666,651,571,-80
2020,6,30,19,670,678,572,-106
2020,6,30,20,679,692,573,-119
2020,6,30,21,684,702,571,-131
2020,6,30,22,694,709,572,-137
2020,6,30,23,692,705,573,-132
2020,7,1,0,660,673,571,-102
2020,7,1,1,623,651,573,-78
2020,7,1,2,613,632,544,-88
2020,7,1,3,568,582,535,-47
2020,7,1,4,523,522,515,-7
2020,7,1,5,458,477,469,-8
2020,7,1,6,427,443,435,-8
2020,7,1,7,411,423,415,-8
2020,7,1,8,400,414,407,-7
2020,7,1,9,399,420,411,-9
2020,7,1,10,409,434,426,-8
2020,7,1,11,429,465,456,-9
2020,7,1,12,468,502,475,-27
2020,7,1,13,511,546,482,-64
2020,7,1,14,544,577,510,-67
2020,7,1,15,576,612,540,-72
2020,7,1,16,594,639,573,-66
2020,7,1,17,614,669,574,-95
2020,7,1,18,632,698,643,-55
2020,7,1,19,632,716,645,-71
2020,7,1,20,637,711,642,-69
2020,7,1,21,642,697,576,-121
2020,7,1,22,654,707,576,-131
2020,7,1,23,653,709,574,-135
2020,7,2,0,626,687,575,-112
2020,7,2,1,594,653,575,-78
2020,7,2,2,589,632,575,-57
2020,7,2,3,543,586,567,-19
2020,7,2,4,500,525,510,-15
2020,7,2,5,457,474,467,-7
2020,7,2,6,426,443,436,-7
2020,7,2,7,409,425,419,-6
2020,7,2,8,397,415,409,-6
2020,7,2,9,398,412,405,-7
2020,7,2,10,410,427,418,-9
2020,7,2,11,428,453,446,-7
2020,7,2,12,469,492,483,-9
2020,7,2,13,516,529,511,-18
2020,7,2,14,549,560,549,-11
2020,7,2,15,580,595,570,-25
2020,7,2,16,614,634,572,-62
2020,7,2,17,646,664,579,-85
2020,7,2,18,672,694,683,-11
2020,7,2,19,686,712,700,-12
2020,7,2,20,700,737,709,-28
2020,7,2,21,706,747,711,-36
2020,7,2,22,715,756,717,-39
2020,7,2,23,708,758,714,-44
2020,7,3,0,676,730,617,-113
2020,7,3,1,636,689,565,-124
2020,7,3,2,627,657,564,-93
2020,7,3,3,580,599,564,-35
2020,7,3,4,535,537,516,-21
2020,7,3,5,441,476,469,-7
2020,7,3,6,410,438,430,-8
2020,7,3,7,391,424,419,-5
2020,7,3,8,383,407,402,-5
2020,7,3,9,377,405,398,-7
2020,7,3,10,380,410,405,-5
2020,7,3,11,389,423,416,-7
2020,7,3,12,417,447,445,-2
2020,7,3,13,459,487,485,-2
2020,7,3,14,501,535,525,-10
2020,7,3,15,531,575,541,-34
2020,7,3,16,556,615,537,-78
2020,7,3,17,594,652,533,-119
2020,7,3,18,621,677,532,-145
2020,7,3,19,641,707,529,-178
2020,7,3,20,659,728,551,-177
2020,7,3,21,672,743,560,-183
2020,7,3,22,683,743,571,-172
2020,7,3,23,680,721,575,-146
2020,7,4,0,652,695,577,-118
2020,7,4,1,620,659,578,-81
2020,7,4,2,606,636,580,-56
2020,7,4,3,561,593,577,-16
2020,7,4,4,505,536,530,-6
2020,7,4,5,469,481,476,-5
2020,7,4,6,434,441,493,52
2020,7,4,7,412,427,510,83
2020,7,4,8,400,411,509,98
2020,7,4,9,392,404,501,97
2020,7,4,10,394,408,492,84
2020,7,4,11,403,411,434,23
2020,7,4,12,432,431,475,44
2020,7,4,13,481,472,469,-3
2020,7,4,14,523,530,514,-16
2020,7,4,15,562,585,568,-17
2020,7,4,16,594,632,569,-63
2020,7,4,17,635,674,564,-110
2020,7,4,18,670,706,560,-146
2020,7,4,19,687,723,565,-158
2020,7,4,20,713,710,562,-148
2020,7,4,21,727,665,575,-90
2020,7,4,22,736,615,579,-36
2020,7,4,23,726,540,528,-12
2020,7,5,0,709,514,495,-19
2020,7,5,1,675,502,575,73
2020,7,5,2,640,491,574,83
2020,7,5,3,595,478,572,94
2020,7,5,4,533,496,568,72
2020,7,5,5,457,466,564,98
2020,7,5,6,426,430,528,98
2020,7,5,7,406,414,511,97
2020,7,5,8,395,401,497,96
2020,7,5,9,388,391,490,99
2020,7,5,10,392,390,488,98
2020,7,5,11,401,396,494,98
2020,7,5,12,430,416,508,92
2020,7,5,13,477,457,452,-5
2020,7,5,14,523,508,498,-10
2020,7,5,15,555,559,548,-11
2020,7,5,16,583,606,566,-40
2020,7,5,17,622,657,565,-92
2020,7,5,18,648,679,559,-120
2020,7,5,19,670,699,563,-136
2020,7,5,20,689,704,566,-138
2020,7,5,21,705,715,563,-152
2020,7,5,22,717,724,563,-161
2020,7,5,23,711,719,565,-154
2020,7,6,0,680,691,563,-128
2020,7,6,1,646,668,526,-142
2020,7,6,2,632,640,510,-130
2020,7,6,3,584,595,510,-85
2020,7,6,4,521,538,510,-28
2020,7,6,5,463,478,473,-5
2020,7,6,6,429,454,450,-4
2020,7,6,7,409,434,428,-6
2020,7,6,8,398,417,412,-5
2020,7,6,9,398,416,412,-4
2020,7,6,10,409,429,424,-5
2020,7,6,11,425,460,452,-8
2020,7,6,12,469,492,486,-6
2020,7,6,13,521,539,512,-27
2020,7,6,14,562,590,512,-78
2020,7,6,15,601,625,522,-103
2020,7,6,16,627,662,574,-88
2020,7,6,17,665,690,572,-118
2020,7,6,18,695,710,572,-138
2020,7,6,19,705,719,573,-146
2020,7,6,20,722,729,573,-156
2020,7,6,21,723,730,572,-158
2020,7,6,22,736,740,576,-164
2020,7,6,23,729,727,580,-147
2020,7,7,0,689,705,581,-124
2020,7,7,1,657,668,579,-89
2020,7,7,2,640,652,585,-67
2020,7,7,3,591,598,566,-32
2020,7,7,4,544,544,524,-20
2020,7,7,5,490,492,520,28
2020,7,7,6,454,459,523,64
2020,7,7,7,436,437,522,85
2020,7,7,8,423,429,518,89
2020,7,7,9,421,430,516,86
2020,7,7,10,431,439,516,77
2020,7,7,11,453,474,517,43
2020,7,7,12,497,511,518,7
2020,7,7,13,537,548,520,-28
2020,7,7,14,578,575,528,-47
2020,7,7,15,611,596,581,-15
2020,7,7,16,649,614,582,-32
2020,7,7,17,684,632,580,-52
2020,7,7,18,715,655,580,-75
2020,7,7,19,733,663,582,-81
2020,7,7,20,743,663,581,-82
2020,7,7,21,753,669,580,-89
2020,7,7,22,753,683,577,-106
2020,7,7,23,753,686,577,-109
2020,7,8,0,720,666,582,-84
2020,7,8,1,681,636,583,-53
2020,7,8,2,659,624,585,-39
2020,7,8,3,608,577,570,-7
2020,7,8,4,558,522,513,-9
2020,7,8,5,454,467,514,47
2020,7,8,6,425,441,521,80
2020,7,8,7,410,425,519,94
2020,7,8,8,398,414,510,96
2020,7,8,9,399,416,510,94
2020,7,8,10,412,431,521,90
2020,7,8,11,437,461,523,62
2020,7,8,12,476,501,521,20
2020,7,8,13,519,539,522,-17
2020,7,8,14,549,570,527,-43
2020,7,8,15,579,616,585,-31
2020,7,8,16,607,647,574,-73
2020,7,8,17,635,682,574,-108
2020,7,8,18,655,714,570,-144
2020,7,8,19,663,736,566,-170
2020,7,8,20,668,756,567,-189
2020,7,8,21,672,767,563,-204
2020,7,8,22,683,748,568,-180
2020,7,8,23,682,732,569,-163
2020,7,9,0,656,713,565,-148
2020,7,9,1,625,681,512,-169
2020,7,9,2,608,661,509,-152
2020,7,9,3,557,608,511,-97
2020,7,9,4,514,545,507,-38
2020,7,9,5,480,498,510,12
2020,7,9,6,446,465,508,43
2020,7,9,7,426,440,507,67
2020,7,9,8,411,430,508,78
2020,7,9,9,412,428,505,77
2020,7,9,10,424,446,509,63
2020,7,9,11,446,473,509,36
2020,7,9,12,485,512,527,15
2020,7,9,13,530,554,526,-28
2020,7,9,14,567,591,531,-60
2020,7,9,15,593,622,569,-53
2020,7,9,16,632,664,563,-101
2020,7,9,17,666,715,568,-147
2020,7,9,18,693,742,568,-174
2020,7,9,19,706,761,565,-196
2020,7,9,20,721,771,566,-205
2020,7,9,21,727,764,571,-193
2020,7,9,22,737,750,580,-170
2020,7,9,23,730,720,587,-133
2020,7,10,0,702,691,590,-101
2020,7,10,1,670,659,590,-69
2020,7,10,2,648,640,543,-97
2020,7,10,3,600,591,528,-63
2020,7,10,4,555,541,523,-18
2020,7,10,5,502,488,516,28
2020,7,10,6,462,460,516,56
2020,7,10,7,439,438,517,79
2020,7,10,8,423,432,517,85
2020,7,10,9,423,429,516,87
2020,7,10,10,431,445,517,72
2020,7,10,11,453,469,516,47
2020,7,10,12,506,506,517,11
2020,7,10,13,558,540,509,-31
2020,7,10,14,606,577,512,-65
2020,7,10,15,644,617,510,-107
2020,7,10,16,684,665,564,-101
2020,7,10,17,715,700,566,-134
2020,7,10,18,749,728,563,-165
2020,7,10,19,756,757,562,-195
2020,7,10,20,770,776,566,-210
2020,7,10,21,777,740,584,-156
2020,7,10,22,784,703,657,-46
2020,7,10,23,773,700,653,-47
2020,7,11,0,736,687,578,-109
2020,7,11,1,694,652,567,-85
2020,7,11,2,666,622,564,-58
2020,7,11,3,621,582,523,-59
2020,7,11,4,576,522,503,-19
2020,7,11,5,491,475,505,30
2020,7,11,6,468,434,501,67
2020,7,11,7,445,398,492,94
2020,7,11,8,433,409,489,80
2020,7,11,9,423,406,453,47
2020,7,11,10,429,407,488,81
2020,7,11,11,442,419,469,50
2020,7,11,12,470,446,440,-6
2020,7,11,13,508,488,481,-7
2020,7,11,14,555,523,501,-22
2020,7,11,15,610,563,552,-11
2020,7,11,16,651,587,563,-24
2020,7,11,17,677,615,561,-54
2020,7,11,18,693,634,563,-71
2020,7,11,19,707,658,563,-95
2020,7,11,20,723,674,563,-111
2020,7,11,21,726,696,564,-132
2020,7,11,22,738,709,563,-146
2020,7,11,23,738,702,562,-140
2020,7,12,0,707,680,564,-116
2020,7,12,1,681,637,564,-73
2020,7,12,2,632,616,560,-56
2020,7,12,3,601,570,503,-67
2020,7,12,4,532,508,493,-15
2020,7,12,5,480,457,482,25
2020,7,12,6,440,425,510,85
2020,7,12,7,419,406,509,103
2020,7,12,8,407,395,504,109
2020,7,12,9,398,384,459,75
2020,7,12,10,399,388,474,86
2020,7,12,11,409,387,410,23
2020,7,12,12,432,408,467,59
2020,7,12,13,476,454,518,64
2020,7,12,14,525,497,521,24
2020,7,12,15,561,530,519,-11
2020,7,12,16,602,564,522,-42
2020,7,12,17,651,601,572,-29
2020,7,12,18,676,632,570,-62
2020,7,12,19,704,653,566,-87
2020,7,12,20,716,672,561,-111
2020,7,12,21,732,690,564,-126
2020,7,12,22,741,699,567,-132
2020,7,12,23,718,698,570,-128
2020,7,13,0,690,688,573,-115
2020,7,13,1,665,652,536,-116
2020,7,13,2,639,629,508,-121
2020,7,13,3,598,580,509,-71
2020,7,13,4,546,518,509,-9
2020,7,13,5,477,467,507,40
2020,7,13,6,442,436,508,72
2020,7,13,7,424,420,510,90
2020,7,13,8,413,409,511,102
2020,7,13,9,415,405,508,103
2020,7,13,10,426,421,509,88
2020,7,13,11,448,449,509,60
2020,7,13,12,487,492,508,16
2020,7,13,13,534,534,509,-25
2020,7,13,14,575,575,509,-66
2020,7,13,15,606,606,507,-99
2020,7,13,16,642,651,538,-113
2020,7,13,17,680,684,570,-114
2020,7,13,18,703,719,569,-150
2020,7,13,19,719,741,565,-176
2020,7,13,20,723,759,564,-195
2020,7,13,21,730,780,566,-214
2020,7,13,22,732,794,568,-226
2020,7,13,23,726,788,513,-275
2020,7,14,0,697,763,507,-256
2020,7,14,1,663,714,509,-205
2020,7,14,2,638,682,507,-175
2020,7,14,3,590,621,509,-112
2020,7,14,4,537,546,507,-39
2020,7,14,5,497,497,508,11
2020,7,14,6,458,460,509,49
2020,7,14,7,435,440,508,68
2020,7,14,8,420,424,507,83
2020,7,14,9,419,422,509,87
2020,7,14,10,428,438,509,71
2020,7,14,11,449,458,507,49
2020,7,14,12,494,502,509,7
2020,7,14,13,539,538,508,-30
2020,7,14,14,576,577,509,-68
2020,7,14,15,604,609,507,-102
2020,7,14,16,639,655,563,-92
2020,7,14,17,680,696,569,-127
2020,7,14,18,701,732,568,-164
2020,7,14,19,714,755,622,-133
2020,7,14,20,726,783,705,-78
2020,7,14,21,733,815,712,-103
2020,7,14,22,738,828,819,-9
2020,7,14,23,730,829,874,45
2020,7,15,0,693,797,815,18
2020,7,15,1,664,755,638,-117
2020,7,15,2,640,726,511,-215
2020,7,15,3,591,656,511,-145
2020,7,15,4,540,580,511,-69
2020,7,15,5,490,522,512,-10
2020,7,15,6,458,483,510,27
2020,7,15,7,440,454,513,59
2020,7,15,8,428,437,512,75
2020,7,15,9,428,434,512,78
2020,7,15,10,438,447,510,63
2020,7,15,11,460,477,510,33
2020,7,15,12,505,514,515,1
2020,7,15,13,551,550,518,-32
2020,7,15,14,583,596,521,-75
2020,7,15,15,613,638,511,-127
2020,7,15,16,652,690,605,-85
2020,7,15,17,680,734,727,-7
2020,7,15,18,709,765,724,-41
2020,7,15,19,734,788,712,-76
2020,7,15,20,758,803,711,-92
2020,7,15,21,757,833,755,-78
2020,7,15,22,768,852,847,-5
2020,7,15,23,762,852,792,-60
2020,7,16,0,725,810,641,-169
2020,7,16,1,690,774,546,-228
2020,7,16,2,666,750,511,-239
2020,7,16,3,616,687,511,-176
2020,7,16,4,565,621,512,-109
2020,7,16,5,490,567,513,-54
2020,7,16,6,454,524,512,-12
2020,7,16,7,433,504,515,11
2020,7,16,8,418,482,513,31
2020,7,16,9,418,474,512,38
2020,7,16,10,427,489,515,26
2020,7,16,11,451,514,514,0
2020,7,16,12,491,553,514,-39
2020,7,16,13,538,597,513,-84
2020,7,16,14,577,639,513,-126
2020,7,16,15,609,678,512,-166
2020,7,16,16,653,724,559,-165
2020,7,16,17,697,761,567,-194
2020,7,16,18,733,781,565,-216
2020,7,16,19,762,797,579,-218
2020,7,16,20,781,826,655,-171
2020,7,16,21,796,837,633,-204
2020,7,16,22,799,854,662,-192
2020,7,16,23,783,822,711,-111
2020,7,17,0,753,795,678,-117
2020,7,17,1,715,761,581,-180
2020,7,17,2,691,745,564,-181
2020,7,17,3,630,684,530,-154
2020,7,17,4,577,606,491,-115
2020,7,17,5,524,554,410,-144
2020,7,17,6,488,509,375,-134
2020,7,17,7,459,487,374,-113
2020,7,17,8,441,475,369,-106
2020,7,17,9,437,468,370,-98
2020,7,17,10,443,481,370,-111
2020,7,17,11,462,498,374,-124
2020,7,17,12,501,537,376,-161
2020,7,17,13,542,580,379,-201
2020,7,17,14,584,629,392,-237
2020,7,17,15,617,681,403,-278
2020,7,17,16,665,732,404,-328
2020,7,17,17,707,772,407,-365
2020,7,17,18,744,800,429,-371
2020,7,17,19,765,813,555,-258
2020,7,17,20,783,810,542,-268
2020,7,17,21,792,796,603,-193
2020,7,17,22,797,793,602,-191
2020,7,17,23,777,795,601,-194
2020,7,18,0,742,768,543,-225
2020,7,18,1,702,732,469,-263
2020,7,18,2,679,701,457,-244
2020,7,18,3,635,652,392,-260
2020,7,18,4,588,590,388,-202
2020,7,18,5,518,538,398,-140
2020,7,18,6,487,497,394,-103
2020,7,18,7,460,473,392,-81
2020,7,18,8,447,456,387,-69
2020,7,18,9,440,447,388,-59
2020,7,18,10,443,449,385,-64
2020,7,18,11,453,453,384,-69
2020,7,18,12,482,475,385,-90
2020,7,18,13,522,521,390,-131
2020,7,18,14,578,582,399,-183
2020,7,18,15,626,636,409,-227
2020,7,18,16,661,689,467,-222
2020,7,18,17,686,726,528,-198
2020,7,18,18,708,757,633,-124
2020,7,18,19,725,773,639,-134
2020,7,18,20,720,754,648,-106
2020,7,18,21,719,726,647,-79
2020,7,18,22,718,720,606,-114
2020,7,18,23,700,705,535,-170
2020,7,19,0,674,693,484,-209
2020,7,19,1,647,664,444,-220
2020,7,19,2,638,647,427,-220
2020,7,19,3,590,604,428,-176
2020,7,19,4,536,547,402,-145
2020,7,19,5,506,499,398,-101
2020,7,19,6,464,461,396,-65
2020,7,19,7,443,436,364,-72
2020,7,19,8,429,423,367,-56
2020,7,19,9,418,422,359,-63
2020,7,19,10,420,419,358,-61
2020,7,19,11,424,427,358,-69
2020,7,19,12,450,449,363,-86
2020,7,19,13,500,498,389,-109
2020,7,19,14,547,557,387,-170
2020,7,19,15,599,608,404,-204
2020,7,19,16,636,664,406,-258
2020,7,19,17,670,713,423,-290
2020,7,19,18,696,752,551,-201
2020,7,19,19,711,737,553,-184
2020,7,19,20,724,707,565,-142
2020,7,19,21,728,701,645,-56
2020,7,19,22,723,719,648,-71
2020,7,19,23,714,733,659,-74
2020,7,20,0,673,711,587,-124
2020,7,20,1,644,678,530,-148
2020,7,20,2,623,654,539,-115
2020,7,20,3,587,599,427,-172
2020,7,20,4,542,543,424,-119
2020,7,20,5,496,498,391,-107
2020,7,20,6,463,464,442,-22
2020,7,20,7,440,449,443,-6
2020,7,20,8,427,437,429,-8
2020,7,20,9,427,438,430,-8
2020,7,20,10,440,453,445,-8
2020,7,20,11,466,487,479,-8
2020,7,20,12,506,527,511,-16
2020,7,20,13,548,573,515,-58
2020,7,20,14,594,626,510,-116
2020,7,20,15,638,680,509,-171
2020,7,20,16,681,728,610,-118
2020,7,20,17,721,779,645,-134
2020,7,20,18,753,821,751,-70
2020,7,20,19,773,826,813,-13
2020,7,20,20,787,774,851,77
2020,7,20,21,798,733,812,79
2020,7,20,22,802,734,811,77
2020,7,20,23,802,743,820,77
2020,7,21,0,767,729,806,77
2020,7,21,1,727,709,681,-28
2020,7,21,2,695,687,629,-58
2020,7,21,3,634,629,513,-116
2020,7,21,4,580,570,516,-54
2020,7,21,5,538,520,546,26
2020,7,21,6,500,488,550,62
2020,7,21,7,475,463,550,87
2020,7,21,8,457,451,547,96
2020,7,21,9,452,451,551,100
2020,7,21,10,460,460,549,89
2020,7,21,11,487,495,552,57
2020,7,21,12,530,533,552,19
2020,7,21,13,566,571,550,-21
2020,7,21,14,616,606,545,-61
2020,7,21,15,652,644,539,-105
2020,7,21,16,703,742,712,-30
2020,7,21,17,745,747,714,-33
2020,7,21,18,782,785,715,-70
2020,7,21,19,800,710,790,80
2020,7,21,20,811,735,882,147
2020,7,21,21,821,721,857,136
2020,7,21,22,826,719,851,132
2020,7,21,23,822,722,811,89
2020,7,22,0,784,668,708,40
2020,7,22,1,750,679,711,32
2020,7,22,2,724,655,675,20
2020,7,22,3,658,598,555,-43
2020,7,22,4,604,543,556,13
2020,7,22,5,534,496,556,60
2020,7,22,6,500,467,555,88
2020,7,22,7,471,447,557,110
2020,7,22,8,453,435,559,124
2020,7,22,9,450,430,559,129
2020,7,22,10,458,441,560,119
2020,7,22,11,488,473,533,60
2020,7,22,12,528,509,529,20
2020,7,22,13,562,552,530,-22
2020,7,22,14,604,583,521,-62
2020,7,22,15,638,625,512,-113
2020,7,22,16,678,663,575,-88
2020,7,22,17,723,718,691,-27
2020,7,22,18,749,755,817,62
2020,7,22,19,770,772,897,125
2020,7,22,20,780,764,898,134
2020,7,22,21,793,740,862,122
2020,7,22,22,798,751,876,125
2020,7,22,23,786,762,833,71
2020,7,23,0,744,749,868,119
2020,7,23,1,721,718,813,95
2020,7,23,2,689,696,790,94
2020,7,23,3,630,633,611,-22
2020,7,23,4,578,575,515,-60
2020,7,23,5,516,525,514,-11
2020,7,23,6,481,492,519,27
2020,7,23,7,456,463,519,56
2020,7,23,8,440,453,521,68
2020,7,23,9,439,451,523,72
2020,7,23,10,450,463,523,60
2020,7,23,11,478,491,524,33
2020,7,23,12,516,527,525,-2
2020,7,23,13,552,574,520,-54
2020,7,23,14,592,611,513,-98
2020,7,23,15,630,656,572,-84
2020,7,23,16,673,715,700,-15
2020,7,23,17,711,745,723,-22
2020,7,23,18,736,761,704,-57
2020,7,23,19,759,758,801,43
2020,7,23,20,771,762,768,6
2020,7,23,21,782,758,792,34
2020,7,23,22,787,772,712,-60
2020,7,23,23,786,739,688,-51
2020,7,24,0,756,688,629,-59
2020,7,24,1,715,654,567,-87
2020,7,24,2,685,632,522,-110
2020,7,24,3,627,587,502,-85
2020,7,24,4,577,532,499,-33
2020,7,24,5,514,488,499,11
2020,7,24,6,479,456,498,42
2020,7,24,7,454,441,498,57
2020,7,24,8,437,432,499,67
2020,7,24,9,436,436,498,62
2020,7,24,10,445,449,499,50
2020,7,24,11,469,481,499,18
2020,7,24,12,509,514,499,-15
2020,7,24,13,546,546,505,-41
2020,7,24,14,590,577,505,-72
2020,7,24,15,624,600,501,-99
2020,7,24,16,664,627,493,-134
2020,7,24,17,702,644,520,-124
2020,7,24,18,728,646,563,-83
2020,7,24,19,752,628,547,-81
2020,7,24,20,766,613,523,-90
2020,7,24,21,774,612,574,-38
2020,7,24,22,776,623,571,-52
2020,7,24,23,765,630,570,-60
2020,7,25,0,729,619,572,-47
2020,7,25,1,688,603,575,-28
2020,7,25,2,664,591,572,-19
2020,7,25,3,610,552,570,18
2020,7,25,4,564,512,573,61
2020,7,25,5,476,464,570,106
2020,7,25,6,452,435,548,113
2020,7,25,7,430,417,563,146
2020,7,25,8,417,408,547,139
2020,7,25,9,410,406,511,105
2020,7,25,10,413,407,511,104
2020,7,25,11,426,415,512,97
2020,7,25,12,446,438,512,74
2020,7,25,13,486,480,516,36
2020,7,25,14,537,521,516,-5
2020,7,25,15,576,568,527,-41
2020,7,25,16,620,618,576,-42
2020,7,25,17,640,657,573,-84
2020,7,25,18,664,677,567,-110
2020,7,25,19,688,676,566,-110
2020,7,25,20,704,650,573,-77
2020,7,25,21,716,637,571,-66
2020,7,25,22,718,640,572,-68
2020,7,25,23,712,649,572,-77
2020,7,26,0,682,637,571,-66
2020,7,26,1,642,617,528,-89
2020,7,26,2,632,601,510,-91
2020,7,26,3,576,561,511,-50
2020,7,26,4,527,512,503,-9
2020,7,26,5,460,464,506,42
2020,7,26,6,426,436,508,72
2020,7,26,7,410,421,509,88
2020,7,26,8,399,411,514,103
2020,7,26,9,392,404,510,106
2020,7,26,10,396,411,513,102
2020,7,26,11,405,413,498,85
2020,7,26,12,427,431,500,69
2020,7,26,13,472,475,515,40
2020,7,26,14,517,522,515,-7
2020,7,26,15,558,568,573,5
2020,7,26,16,607,610,573,-37
2020,7,26,17,639,653,573,-80
2020,7,26,18,675,690,568,-122
2020,7,26,19,691,719,566,-153
2020,7,26,20,699,733,562,-171
2020,7,26,21,712,731,570,-161
2020,7,26,22,725,718,576,-142
2020,7,26,23,733,703,579,-124
2020,7,27,0,694,678,578,-100
2020,7,27,1,666,653,581,-72
2020,7,27,2,630,632,543,-89
2020,7,27,3,584,583,520,-63
2020,7,27,4,539,526,521,-5
2020,7,27,5,489,479,518,39
2020,7,27,6,456,449,520,71
2020,7,27,7,433,429,520,91
2020,7,27,8,419,418,519,101
2020,7,27,9,420,423,518,95
2020,7,27,10,435,437,518,81
2020,7,27,11,459,473,514,41
2020,7,27,12,498,508,512,4
2020,7,27,13,544,548,511,-37
2020,7,27,14,594,584,513,-71
2020,7,27,15,636,629,508,-121
2020,7,27,16,680,679,506,-173
2020,7,27,17,717,727,566,-161
2020,7,27,18,751,756,613,-143
2020,7,27,19,767,792,686,-106
2020,7,27,20,781,785,728,-57
2020,7,27,21,790,780,730,-50
2020,7,27,22,803,766,726,-40
2020,7,27,23,799,748,721,-27
2020,7,28,0,761,710,692,-18
2020,7,28,1,729,675,737,62
2020,7,28,2,700,660,677,17
2020,7,28,3,635,598,534,-64
2020,7,28,4,580,546,515,-31
2020,7,28,5,516,499,510,11
2020,7,28,6,478,469,541,72
2020,7,28,7,456,450,543,93
2020,7,28,8,440,437,551,114
2020,7,28,9,436,435,550,115
2020,7,28,10,448,453,552,99
2020,7,28,11,474,488,555,67
2020,7,28,12,513,525,553,28
2020,7,28,13,555,563,553,-10
2020,7,28,14,603,594,544,-50
2020,7,28,15,639,628,568,-60
2020,7,28,16,690,675,643,-32
2020,7,28,17,720,709,676,-33
2020,7,28,18,760,746,852,106
2020,7,28,19,774,774,845,71
2020,7,28,20,793,786,810,24
2020,7,28,21,800,777,843,66
2020,7,28,22,813,742,835,93
2020,7,28,23,812,730,824,94
2020,7,29,0,768,703,761,58
2020,7,29,1,732,679,569,-110
2020,7,29,2,707,659,518,-141
2020,7,29,3,641,604,548,-56
2020,7,29,4,589,547,541,-6
2020,7,29,5,522,502,512,10
2020,7,29,6,485,474,537,63
2020,7,29,7,464,454,536,82
2020,7,29,8,447,440,537,97
2020,7,29,9,442,440,537,97
2020,7,29,10,452,453,535,82
2020,7,29,11,481,488,535,47
2020,7,29,12,519,528,540,12
2020,7,29,13,558,568,553,-15
2020,7,29,14,600,607,553,-54
2020,7,29,15,638,651,575,-76
2020,7,29,16,677,694,570,-124
2020,7,29,17,701,740,565,-175
2020,7,29,18,730,775,561,-214
2020,7,29,19,747,794,558,-236
2020,7,29,20,762,801,561,-240
2020,7,29,21,768,791,563,-228
2020,7,29,22,778,787,567,-220
2020,7,29,23,775,774,570,-204
2020,7,30,0,734,744,572,-172
2020,7,30,1,702,713,573,-140
2020,7,30,2,676,688,577,-111
2020,7,30,3,616,633,577,-56
2020,7,30,4,562,573,549,-24
2020,7,30,5,499,520,511,-9
2020,7,30,6,463,486,513,27
2020,7,30,7,442,468,513,45
2020,7,30,8,430,456,515,59
2020,7,30,9,429,454,513,59
2020,7,30,10,441,473,515,42
2020,7,30,11,469,504,513,9
2020,7,30,12,503,544,518,-26
2020,7,30,13,544,580,572,-8
2020,7,30,14,582,620,579,-41
2020,7,30,15,614,668,571,-97
2020,7,30,16,653,713,566,-147
2020,7,30,17,682,743,562,-181
2020,7,30,18,710,768,561,-207
2020,7,30,19,727,786,560,-226
2020,7,30,20,740,797,560,-237
2020,7,30,21,747,785,635,-150
2020,7,30,22,752,768,663,-105
2020,7,30,23,749,742,710,-32
2020,7,31,0,712,707,607,-100
2020,7,31,1,681,683,572,-111
2020,7,31,2,654,675,578,-97
2020,7,31,3,599,621,576,-45
2020,7,31,4,545,561,554,-7
2020,7,31,5,497,511,509,-2
2020,7,31,6,462,478,504,26
2020,7,31,7,441,462,505,43
2020,7,31,8,430,448,505,57
2020,7,31,9,429,446,506,60
2020,7,31,10,440,462,503,41
2020,7,31,11,461,495,505,10
2020,7,31,12,502,528,503,-25
2020,7,31,13,544,569,501,-68
2020,7,31,14,591,612,503,-109
2020,7,31,15,636,642,499,-143
2020,7,31,16,680,687,498,-189
2020,7,31,17,708,729,560,-169
2020,7,31,18,746,764,590,-174
2020,7,31,19,762,789,639,-150
2020,7,31,20,778,816,652,-164
2020,7,31,21,780,830,797,-33
2020,7,31,22,770,843,840,-3
2020,7,31,23,746,826,841,15
2020,8,1,0,707,786,800,14
2020,8,1,1,678,705,681,-24
2020,8,1,2,658,661,572,-89
2020,8,1,3,612,601,570,-31
2020,8,1,4,565,541,570,29
2020,8,1,5,496,501,574,73
2020,8,1,6,461,468,574,106
2020,8,1,7,440,449,575,126
2020,8,1,8,426,430,575,145
2020,8,1,9,417,428,573,145
2020,8,1,10,421,433,575,142
2020,8,1,11,435,445,574,129
2020,8,1,12,454,459,574,115
2020,8,1,13,495,500,575,75
2020,8,1,14,540,542,576,34
2020,8,1,15,584,586,576,-10
2020,8,1,16,626,627,570,-57
2020,8,1,17,662,671,568,-103
2020,8,1,18,690,694,564,-130
2020,8,1,19,708,718,562,-156
2020,8,1,20,726,735,585,-150
2020,8,1,21,731,747,693,-54
2020,8,1,22,726,761,641,-120
2020,8,1,23,712,766,566,-200
2020,8,2,0,679,735,565,-170
2020,8,2,1,651,700,567,-133
2020,8,2,2,633,672,567,-105
2020,8,2,3,581,621,564,-57
2020,8,2,4,529,562,566,4
2020,8,2,5,495,513,546,33
2020,8,2,6,446,472,508,36
2020,8,2,7,422,445,499,54
2020,8,2,8,410,429,499,70
2020,8,2,9,398,422,502,80
2020,8,2,10,402,420,499,79
2020,8,2,11,412,423,500,77
2020,8,2,12,435,446,499,53
2020,8,2,13,480,489,499,10
2020,8,2,14,529,546,502,-44
2020,8,2,15,568,589,498,-91
2020,8,2,16,618,620,560,-60
2020,8,2,17,659,656,562,-94
2020,8,2,18,689,681,560,-121
2020,8,2,19,705,705,561,-144
2020,8,2,20,711,723,560,-163
2020,8,2,21,730,734,562,-172
2020,8,2,22,747,741,565,-176
2020,8,2,23,740,722,562,-160
2020,8,3,0,706,691,566,-125
2020,8,3,1,677,660,568,-92
2020,8,3,2,638,632,571,-61
2020,8,3,3,588,583,566,-17
2020,8,3,4,538,529,524,-5
2020,8,3,5,484,484,531,47
2020,8,3,6,448,450,512,62
2020,8,3,7,425,437,520,83
2020,8,3,8,413,425,519,94
2020,8,3,9,415,429,526,97
2020,8,3,10,435,448,528,80
2020,8,3,11,470,478,525,47
2020,8,3,12,504,513,526,13
2020,8,3,13,541,553,524,-29
2020,8,3,14,569,585,524,-61
2020,8,3,15,610,606,546,-60
2020,8,3,16,641,607,523,-84
2020,8,3,17,674,613,530,-83
2020,8,3,18,697,609,589,-20
2020,8,3,19,714,614,577,-37
2020,8,3,20,731,619,585,-34
2020,8,3,21,737,619,584,-35
2020,8,3,22,747,622,586,-36
2020,8,3,23,737,621,587,-34
2020,8,4,0,706,607,583,-24
2020,8,4,1,674,591,570,-21
2020,8,4,2,638,576,567,-9
2020,8,4,3,584,536,528,-8
2020,8,4,4,527,489,483,-6
2020,8,4,5,477,448,535,87
2020,8,4,6,446,424,518,94
2020,8,4,7,429,413,508,95
2020,8,4,8,419,407,502,95
2020,8,4,9,420,403,497,94
2020,8,4,10,437,419,514,95
2020,8,4,11,471,455,449,-6
2020,8,4,12,509,492,485,-7
2020,8,4,13,539,521,516,-5
2020,8,4,14,564,549,542,-7
2020,8,4,15,599,571,565,-6
2020,8,4,16,626,606,577,-29
2020,8,4,17,646,645,576,-69
2020,8,4,18,668,671,572,-99
2020,8,4,19,674,688,565,-123
2020,8,4,20,689,699,577,-122
2020,8,4,21,694,702,577,-125
2020,8,4,22,702,710,579,-131
2020,8,4,23,697,702,578,-124
2020,8,5,0,676,686,580,-106
2020,8,5,1,651,665,582,-83
2020,8,5,2,626,633,566,-67
2020,8,5,3,572,583,519,-64
2020,8,5,4,525,527,516,-11
2020,8,5,5,474,485,519,34
2020,8,5,6,442,452,520,68
2020,8,5,7,423,436,521,85
2020,8,5,8,410,423,522,99
2020,8,5,9,412,424,522,98
2020,8,5,10,429,441,523,82
2020,8,5,11,468,477,522,45
2020,8,5,12,504,511,523,12
2020,8,5,13,536,543,523,-20
2020,8,5,14,562,564,550,-14
2020,8,5,15,603,588,583,-5
2020,8,5,16,633,635,575,-60
2020,8,5,17,661,677,569,-108
2020,8,5,18,687,708,612,-96
2020,8,5,19,706,702,639,-63
2020,8,5,20,726,684,651,-33
2020,8,5,21,734,680,657,-23
2020,8,5,22,743,622,661,39
2020,8,5,23,728,572,597,25
2020,8,6,0,702,633,584,-49
2020,8,6,1,676,628,587,-41
2020,8,6,2,650,607,586,-21
2020,8,6,3,593,562,554,-8
2020,8,6,4,539,510,501,-9
2020,8,6,5,487,461,455,-6
2020,8,6,6,454,437,430,-7
2020,8,6,7,432,422,512,90
2020,8,6,8,419,413,509,96
2020,8,6,9,420,419,514,95
2020,8,6,10,438,438,530,92
2020,8,6,11,473,473,522,49
2020,8,6,12,508,510,523,13
2020,8,6,13,540,545,521,-24
2020,8,6,14,571,571,520,-51
2020,8,6,15,609,594,516,-78
2020,8,6,16,642,637,567,-70
2020,8,6,17,679,676,565,-111
2020,8,6,18,706,711,571,-140
2020,8,6,19,719,724,652,-72
2020,8,6,20,731,736,642,-94
2020,8,6,21,747,744,634,-110
2020,8,6,22,755,754,640,-114
2020,8,6,23,743,740,637,-103
2020,8,7,0,711,697,537,-160
2020,8,7,1,688,670,516,-154
2020,8,7,2,663,632,517,-115
2020,8,7,3,606,588,518,-70
2020,8,7,4,550,531,515,-16
2020,8,7,5,490,485,518,33
2020,8,7,6,452,457,519,62
2020,8,7,7,430,441,520,79
2020,8,7,8,418,431,519,88
2020,8,7,9,418,428,518,90
2020,8,7,10,434,446,524,78
2020,8,7,11,466,477,584,107
2020,8,7,12,501,510,588,78
2020,8,7,13,537,545,589,44
2020,8,7,14,568,576,589,13
2020,8,7,15,607,601,582,-19
2020,8,7,16,640,643,578,-65
2020,8,7,17,677,681,575,-106
2020,8,7,18,701,713,571,-142
2020,8,7,19,715,723,573,-150
2020,8,7,20,722,730,572,-158
2020,8,7,21,734,733,567,-166
2020,8,7,22,742,734,572,-162
2020,8,7,23,724,636,576,-60
2020,8,8,0,691,624,583,-41
2020,8,8,1,662,627,587,-40
2020,8,8,2,639,611,548,-63
2020,8,8,3,592,564,518,-46
2020,8,8,4,542,515,507,-8
2020,8,8,5,486,464,520,56
2020,8,8,6,448,438,522,84
2020,8,8,7,431,421,523,102
2020,8,8,8,414,406,523,117
2020,8,8,9,408,401,504,103
2020,8,8,10,409,412,510,98
2020,8,8,11,425,427,516,89
2020,8,8,12,444,449,519,70
2020,8,8,13,483,480,523,43
2020,8,8,14,526,514,525,11
2020,8,8,15,570,548,535,-13
2020,8,8,16,611,587,571,-16
2020,8,8,17,644,626,571,-55
2020,8,8,18,665,665,569,-96
2020,8,8,19,687,693,571,-122
2020,8,8,20,698,724,635,-89
2020,8,8,21,714,742,655,-87
2020,8,8,22,726,745,719,-26
2020,8,8,23,722,738,712,-26
2020,8,9,0,688,701,667,-34
2020,8,9,1,650,666,624,-42
2020,8,9,2,626,632,536,-96
2020,8,9,3,578,577,536,-41
2020,8,9,4,526,522,518,-4
2020,8,9,5,476,465,500,35
2020,8,9,6,435,438,505,67
2020,8,9,7,414,408,503,95
2020,8,9,8,402,394,503,109
2020,8,9,9,395,391,505,114
2020,8,9,10,396,391,499,108
2020,8,9,11,410,404,490,86
2020,8,9,12,431,420,478,58
2020,8,9,13,475,463,533,70
2020,8,9,14,522,505,536,31
2020,8,9,15,552,542,548,6
2020,8,9,16,594,586,569,-17
2020,8,9,17,634,639,569,-70
2020,8,9,18,661,662,569,-93
2020,8,9,19,684,680,566,-114
2020,8,9,20,694,704,565,-139
2020,8,9,21,719,730,564,-166
2020,8,9,22,734,750,564,-186
2020,8,9,23,727,745,563,-182
2020,8,10,0,691,713,567,-146
2020,8,10,1,662,681,571,-110
2020,8,10,2,635,648,573,-75
2020,8,10,3,582,589,519,-70
2020,8,10,4,523,528,507,-21
2020,8,10,5,468,477,506,29
2020,8,10,6,433,446,508,62
2020,8,10,7,411,430,508,78
2020,8,10,8,400,419,509,90
2020,8,10,9,401,419,509,90
2020,8,10,10,421,435,509,74
2020,8,10,11,453,468,509,41
2020,8,10,12,489,506,507,1
2020,8,10,13,527,544,509,-35
2020,8,10,14,564,576,511,-65
2020,8,10,15,606,605,558,-47
2020,8,10,16,650,637,573,-64
2020,8,10,17,679,654,585,-69
2020,8,10,18,714,675,647,-28
2020,8,10,19,735,681,643,-38
2020,8,10,20,750,694,643,-51
2020,8,10,21,765,722,698,-24
2020,8,10,22,771,743,717,-26
2020,8,10,23,761,752,651,-101
2020,8,11,0,726,723,649,-74
2020,8,11,1,696,691,563,-128
2020,8,11,2,662,658,506,-152
2020,8,11,3,598,593,507,-86
2020,8,11,4,542,535,509,-26
2020,8,11,5,494,484,508,24
2020,8,11,6,457,460,507,47
2020,8,11,7,437,441,510,69
2020,8,11,8,425,428,509,81
2020,8,11,9,424,428,510,82
2020,8,11,10,440,449,510,61
2020,8,11,11,476,481,512,31
2020,8,11,12,510,515,511,-4
2020,8,11,13,546,546,511,-35
2020,8,11,14,579,571,508,-63
2020,8,11,15,616,594,511,-83
2020,8,11,16,654,629,578,-51
2020,8,11,17,688,675,574,-101
2020,8,11,18,719,713,569,-144
2020,8,11,19,735,739,629,-110
2020,8,11,20,752,770,652,-118
2020,8,11,21,770,796,655,-141
2020,8,11,22,778,801,649,-152
2020,8,11,23,766,805,649,-156
2020,8,12,0,731,774,640,-134
2020,8,12,1,699,738,604,-134
2020,8,12,2,673,695,515,-180
2020,8,12,3,610,636,513,-123
2020,8,12,4,552,571,513,-58
2020,8,12,5,497,516,511,-5
2020,8,12,6,460,483,515,32
2020,8,12,7,438,466,515,49
2020,8,12,8,426,451,524,73
2020,8,12,9,426,445,514,69
2020,8,12,10,442,463,513,50
2020,8,12,11,476,489,513,24
2020,8,12,12,512,525,514,-11
2020,8,12,13,544,557,513,-44
2020,8,12,14,577,595,513,-82
2020,8,12,15,618,640,512,-128
2020,8,12,16,656,690,572,-118
2020,8,12,17,676,721,564,-157
2020,8,12,18,704,756,693,-63
2020,8,12,19,721,774,713,-61
2020,8,12,20,736,791,667,-124
2020,8,12,21,750,806,648,-158
2020,8,12,22,762,804,665,-139
2020,8,12,23,749,771,687,-84
2020,8,13,0,716,742,630,-112
2020,8,13,1,690,714,617,-97
2020,8,13,2,657,674,535,-139
2020,8,13,3,598,619,512,-107
2020,8,13,4,548,558,511,-47
2020,8,13,5,498,512,512,0
2020,8,13,6,463,477,511,34
2020,8,13,7,441,459,512,53
2020,8,13,8,431,447,513,66
2020,8,13,9,430,449,515,66
2020,8,13,10,446,470,514,44
2020,8,13,11,482,506,512,6
2020,8,13,12,515,537,511,-26
2020,8,13,13,550,575,508,-67
2020,8,13,14,582,603,513,-90
2020,8,13,15,618,636,469,-167
2020,8,13,16,653,690,572,-118
2020,8,13,17,680,738,575,-163
2020,8,13,18,702,771,599,-172
2020,8,13,19,712,773,649,-124
2020,8,13,20,711,756,644,-112
2020,8,13,21,710,777,662,-115
2020,8,13,22,711,798,669,-129
2020,8,13,23,696,799,599,-200
2020,8,14,0,677,757,510,-247
2020,8,14,1,659,722,510,-212
2020,8,14,2,636,678,512,-166
2020,8,14,3,588,617,514,-103
2020,8,14,4,536,551,516,-35
2020,8,14,5,496,504,517,13
2020,8,14,6,466,479,518,39
2020,8,14,7,447,455,518,63
2020,8,14,8,436,444,520,76
2020,8,14,9,435,444,519,75
2020,8,14,10,448,460,518,58
2020,8,14,11,476,498,521,23
2020,8,14,12,512,525,524,-1
2020,8,14,13,553,558,587,29
2020,8,14,14,588,585,585,0
2020,8,14,15,614,608,581,-27
2020,8,14,16,648,641,576,-65
2020,8,14,17,677,671,574,-97
2020,8,14,18,697,699,570,-129
2020,8,14,19,707,722,573,-149
2020,8,14,20,708,723,577,-146
2020,8,14,21,706,719,575,-144
2020,8,14,22,700,710,569,-141
2020,8,14,23,677,701,573,-128
2020,8,15,0,651,674,572,-102
2020,8,15,1,634,657,573,-84
2020,8,15,2,613,627,571,-56
2020,8,15,3,574,588,570,-18
2020,8,15,4,527,533,506,-27
2020,8,15,5,472,497,508,11
2020,8,15,6,442,465,506,41
2020,8,15,7,419,450,506,56
2020,8,15,8,400,440,514,74
2020,8,15,9,397,435,537,102
2020,8,15,10,407,446,542,96
2020,8,15,11,425,463,571,108
2020,8,15,12,442,477,569,92
2020,8,15,13,483,517,575,58
2020,8,15,14,522,550,580,30
2020,8,15,15,562,580,580,0
2020,8,15,16,589,608,575,-33
2020,8,15,17,610,627,577,-50
2020,8,15,18,625,631,580,-51
2020,8,15,19,655,629,583,-46
2020,8,15,20,654,616,581,-35
2020,8,15,21,658,626,580,-46
2020,8,15,22,672,644,576,-68
2020,8,15,23,690,652,576,-76
2020,8,16,0,655,637,577,-60
2020,8,16,1,627,615,580,-35
2020,8,16,2,602,595,575,-20
2020,8,16,3,548,549,519,-30
2020,8,16,4,499,490,516,26
2020,8,16,5,453,452,520,68
2020,8,16,6,425,430,523,93
2020,8,16,7,401,414,524,110
2020,8,16,8,391,407,522,115
2020,8,16,9,383,404,523,119
2020,8,16,10,387,409,523,114
2020,8,16,11,399,423,525,102
2020,8,16,12,422,440,416,-24
2020,8,16,13,464,482,486,4
2020,8,16,14,508,526,521,-5
2020,8,16,15,540,553,523,-30
2020,8,16,16,579,577,582,5
2020,8,16,17,620,602,576,-26
2020,8,16,18,649,636,576,-60
2020,8,16,19,662,653,572,-81
2020,8,16,20,665,679,568,-111
2020,8,16,21,692,707,571,-136
2020,8,16,22,708,724,570,-154
2020,8,16,23,696,719,571,-148
2020,8,17,0,668,693,572,-121
2020,8,17,1,640,655,529,-126
2020,8,17,2,606,623,518,-105
2020,8,17,3,559,560,512,-48
2020,8,17,4,505,514,525,11
2020,8,17,5,459,468,526,58
2020,8,17,6,432,437,525,88
2020,8,17,7,415,420,467,47
2020,8,17,8,405,412,402,-10
2020,8,17,9,406,417,433,16
2020,8,17,10,424,443,501,58
2020,8,17,11,454,478,505,27
2020,8,17,12,491,518,505,-13
2020,8,17,13,533,549,501,-48
2020,8,17,14,565,584,509,-75
2020,8,17,15,601,617,508,-109
2020,8,17,16,642,650,506,-144
2020,8,17,17,674,685,499,-186
2020,8,17,18,703,713,500,-213
2020,8,17,19,719,733,498,-235
2020,8,17,20,735,746,506,-240
2020,8,17,21,752,752,567,-185
2020,8,17,22,764,764,572,-192
2020,8,17,23,750,755,573,-182
2020,8,18,0,715,711,576,-135
2020,8,18,1,690,668,528,-140
2020,8,18,2,651,636,514,-122
2020,8,18,3,590,573,513,-60
2020,8,18,4,536,510,515,5
2020,8,18,5,464,460,511,51
2020,8,18,6,436,433,510,77
2020,8,18,7,421,419,513,94
2020,8,18,8,412,408,507,99
2020,8,18,9,409,407,454,47
2020,8,18,10,423,427,482,55
2020,8,18,11,455,467,513,46
2020,8,18,12,492,500,512,12
2020,8,18,13,529,526,511,-15
2020,8,18,14,554,550,512,-38
2020,8,18,15,578,574,519,-55
2020,8,18,16,613,595,573,-22
2020,8,18,17,643,632,572,-60
2020,8,18,18,676,663,570,-93
2020,8,18,19,692,689,569,-120
2020,8,18,20,718,720,570,-150
2020,8,18,21,739,733,567,-166
2020,8,18,22,744,743,567,-176
2020,8,18,23,732,728,569,-159
2020,8,19,0,698,700,517,-183
2020,8,19,1,671,678,510,-168
2020,8,19,2,640,645,513,-132
2020,8,19,3,581,575,525,-50
2020,8,19,4,525,513,524,11
2020,8,19,5,472,472,524,52
2020,8,19,6,444,447,524,77
2020,8,19,7,426,429,525,96
2020,8,19,8,414,418,516,98
2020,8,19,9,414,422,514,92
2020,8,19,10,428,440,527,87
2020,8,19,11,463,482,530,48
2020,8,19,12,497,516,530,14
2020,8,19,13,531,544,532,-12
2020,8,19,14,561,558,526,-32
2020,8,19,15,592,588,529,-59
2020,8,19,16,624,625,582,-43
2020,8,19,17,646,662,575,-87
2020,8,19,18,674,690,571,-119
2020,8,19,19,688,686,579,-107
2020,8,19,20,705,678,581,-97
2020,8,19,21,720,676,579,-97
2020,8,19,22,725,667,578,-89
2020,8,19,23,708,656,585,-71
2020,8,20,0,680,634,531,-103
2020,8,20,1,658,618,525,-93
2020,8,20,2,630,585,523,-62
2020,8,20,3,572,539,526,-13
2020,8,20,4,519,492,527,35
2020,8,20,5,468,451,525,74
2020,8,20,6,434,430,529,99
2020,8,20,7,418,417,528,111
2020,8,20,8,407,411,530,119
2020,8,20,9,409,414,530,116
2020,8,20,10,430,437,530,93
2020,8,20,11,472,480,530,50
2020,8,20,12,504,514,531,17
2020,8,20,13,530,541,529,-12
2020,8,20,14,555,561,528,-33
2020,8,20,15,584,579,528,-51
2020,8,20,16,613,604,587,-17
2020,8,20,17,626,621,585,-36
2020,8,20,18,647,632,582,-50
2020,8,20,19,653,649,579,-70
2020,8,20,20,666,657,574,-83
2020,8,20,21,682,672,577,-95
2020,8,20,22,678,682,576,-106
2020,8,20,23,653,680,578,-102
2020,8,21,0,648,655,521,-134
2020,8,21,1,636,650,512,-138
2020,8,21,2,605,616,513,-103
2020,8,21,3,554,565,514,-51
2020,8,21,4,504,515,511,-4
2020,8,21,5,455,469,508,39
2020,8,21,6,425,448,508,60
2020,8,21,7,411,430,508,78
2020,8,21,8,400,421,511,90
2020,8,21,9,403,419,508,89
2020,8,21,10,423,437,508,71
2020,8,21,11,463,472,508,36
2020,8,21,12,498,514,507,-7
2020,8,21,13,523,538,510,-28
2020,8,21,14,545,557,562,5
2020,8,21,15,575,570,578,8
2020,8,21,16,601,577,577,0
2020,8,21,17,621,588,577,-11
2020,8,21,18,645,591,578,-13
2020,8,21,19,654,588,579,-9
2020,8,21,20,670,595,580,-15
2020,8,21,21,681,602,580,-22
2020,8,21,22,680,603,578,-25
2020,8,21,23,658,599,577,-22
2020,8,22,0,639,588,569,-19
2020,8,22,1,619,588,573,-15
2020,8,22,2,591,572,566,-6
2020,8,22,3,547,538,580,42
2020,8,22,4,504,495,581,86
2020,8,22,5,446,455,548,93
2020,8,22,6,418,432,547,115
2020,8,22,7,403,414,546,132
2020,8,22,8,388,404,547,143
2020,8,22,9,385,402,548,146
2020,8,22,10,394,411,548,137
2020,8,22,11,411,423,570,147
2020,8,22,12,430,443,578,135
2020,8,22,13,470,476,578,102
2020,8,22,14,506,513,579,66
2020,8,22,15,535,546,580,34
2020,8,22,16,564,578,576,-2
2020,8,22,17,590,614,572,-42
2020,8,22,18,603,633,569,-64
2020,8,22,19,630,652,570,-82
2020,8,22,20,637,646,575,-71
2020,8,22,21,640,648,578,-70
2020,8,22,22,651,658,578,-80
2020,8,22,23,663,657,571,-86
2020,8,23,0,635,632,570,-62
2020,8,23,1,606,624,578,-46
2020,8,23,2,578,589,574,-15
2020,8,23,3,525,547,577,30
2020,8,23,4,481,489,569,80
2020,8,23,5,440,456,576,120
2020,8,23,6,414,432,574,142
2020,8,23,7,394,416,562,146
2020,8,23,8,385,404,548,144
2020,8,23,9,378,400,495,95
2020,8,23,10,383,402,471,69
2020,8,23,11,395,413,515,102
2020,8,23,12,418,428,525,97
2020,8,23,13,455,461,546,85
2020,8,23,14,497,503,579,76
2020,8,23,15,518,535,580,45
2020,8,23,16,548,568,577,9
2020,8,23,17,581,604,573,-31
2020,8,23,18,609,641,571,-70
2020,8,23,19,628,654,570,-84
2020,8,23,20,642,673,573,-100
2020,8,23,21,652,683,570,-113
2020,8,23,22,664,695,572,-123
2020,8,23,23,652,681,572,-109
2020,8,24,0,629,651,574,-77
2020,8,24,1,610,633,575,-58
2020,8,24,2,581,598,547,-51
2020,8,24,3,531,553,543,-10
2020,8,24,4,481,487,535,48
2020,8,24,5,454,455,544,89
2020,8,24,6,429,428,546,118
2020,8,24,7,416,412,510,98
2020,8,24,8,410,406,451,45
2020,8,24,9,411,408,457,49
2020,8,24,10,434,433,547,114
2020,8,24,11,471,473,586,113
2020,8,24,12,499,518,586,68
2020,8,24,13,526,549,585,36
2020,8,24,14,547,566,581,15
2020,8,24,15,581,591,587,-4
2020,8,24,16,606,608,585,-23
2020,8,24,17,627,633,582,-51
2020,8,24,18,650,647,583,-64
2020,8,24,19,670,672,577,-95
2020,8,24,20,687,701,574,-127
2020,8,24,21,700,725,575,-150
2020,8,24,22,702,730,575,-155
2020,8,24,23,690,721,575,-146
2020,8,25,0,670,698,574,-124
2020,8,25,1,644,677,578,-99
2020,8,25,2,610,640,579,-61
2020,8,25,3,562,583,461,-122
2020,8,25,4,517,529,329,-200
2020,8,25,5,459,487,328,-159
2020,8,25,6,430,460,327,-133
2020,8,25,7,416,444,341,-103
2020,8,25,8,406,435,354,-81
2020,8,25,9,410,439,383,-56
2020,8,25,10,432,460,513,53
2020,8,25,11,478,499,514,15
2020,8,25,12,513,539,553,14
2020,8,25,13,539,563,578,15
2020,8,25,14,561,586,579,-7
2020,8,25,15,592,612,579,-33
2020,8,25,16,628,641,575,-66
2020,8,25,17,655,668,571,-97
2020,8,25,18,683,695,581,-114
2020,8,25,19,691,684,577,-107
2020,8,25,20,700,674,580,-94
2020,8,25,21,713,676,579,-97
2020,8,25,22,713,681,578,-103
2020,8,25,23,701,684,578,-106
2020,8,26,0,675,667,579,-88
2020,8,26,1,658,653,578,-75
2020,8,26,2,622,616,578,-38
2020,8,26,3,568,571,581,10
2020,8,26,4,514,517,578,61
2020,8,26,5,466,477,534,57
2020,8,26,6,435,449,513,64
2020,8,26,7,418,432,512,80
2020,8,26,8,408,427,515,88
2020,8,26,9,410,424,513,89
2020,8,26,10,433,445,579,134
2020,8,26,11,482,486,579,93
2020,8,26,12,512,525,579,54
2020,8,26,13,538,552,581,29
2020,8,26,14,560,567,576,9
2020,8,26,15,592,599,575,-24
2020,8,26,16,629,645,578,-67
2020,8,26,17,659,686,575,-111
2020,8,26,18,695,730,571,-159
2020,8,26,19,720,763,566,-197
2020,8,26,20,735,793,564,-229
2020,8,26,21,748,809,566,-243
2020,8,26,22,748,818,561,-257
2020,8,26,23,732,810,566,-244
2020,8,27,0,700,763,568,-195
2020,8,27,1,677,735,573,-162
2020,8,27,2,638,684,574,-110
2020,8,27,3,584,621,578,-43
2020,8,27,4,524,554,578,24
2020,8,27,5,486,499,576,77
2020,8,27,6,450,469,576,107
2020,8,27,7,431,452,578,126
2020,8,27,8,420,440,576,136
2020,8,27,9,421,436,578,142
2020,8,27,10,444,456,577,121
2020,8,27,11,490,497,582,85
2020,8,27,12,519,531,582,51
2020,8,27,13,546,564,583,19
2020,8,27,14,570,595,580,-15
2020,8,27,15,604,628,579,-49
2020,8,27,16,640,657,577,-80
2020,8,27,17,676,697,573,-124
2020,8,27,18,709,722,567,-155
2020,8,27,19,730,754,563,-191
2020,8,27,20,752,789,627,-162
2020,8,27,21,768,793,631,-162
2020,8,27,22,766,775,683,-92
2020,8,27,23,746,754,699,-55
2020,8,28,0,715,727,636,-91
2020,8,28,1,696,720,590,-130
2020,8,28,2,655,681,566,-115
2020,8,28,3,601,622,567,-55
2020,8,28,4,540,561,567,6
2020,8,28,5,494,508,563,55
2020,8,28,6,457,479,564,85
2020,8,28,7,439,467,567,100
2020,8,28,8,428,448,566,118
2020,8,28,9,427,447,567,120
2020,8,28,10,448,469,568,99
2020,8,28,11,491,503,566,63
2020,8,28,12,522,545,567,22
2020,8,28,13,547,568,567,-1
2020,8,28,14,575,600,569,-31
2020,8,28,15,609,621,565,-56
2020,8,28,16,650,659,568,-91
2020,8,28,17,674,701,565,-136
2020,8,28,18,700,729,562,-167
2020,8,28,19,717,745,563,-182
2020,8,28,20,730,757,562,-195
2020,8,28,21,740,760,563,-197
2020,8,28,22,737,755,565,-190
2020,8,28,23,705,734,568,-166
2020,8,29,0,678,707,567,-140
2020,8,29,1,662,698,524,-174
2020,8,29,2,622,661,503,-158
2020,8,29,3,582,609,505,-104
2020,8,29,4,529,560,504,-56
2020,8,29,5,471,510,501,-9
2020,8,29,6,441,481,501,20
2020,8,29,7,427,461,503,42
2020,8,29,8,412,452,507,55
2020,8,29,9,406,447,505,58
2020,8,29,10,411,452,511,59
2020,8,29,11,430,461,568,107
2020,8,29,12,448,483,569,86
2020,8,29,13,482,514,569,55
2020,8,29,14,517,554,569,15
2020,8,29,15,553,591,571,-20
2020,8,29,16,586,613,569,-44
2020,8,29,17,611,632,568,-64
2020,8,29,18,633,652,572,-80
2020,8,29,19,652,668,567,-101
2020,8,29,20,665,685,567,-118
2020,8,29,21,672,710,566,-144
2020,8,29,22,677,723,566,-157
2020,8,29,23,674,715,566,-149
2020,8,30,0,649,682,564,-118
2020,8,30,1,626,667,568,-99
2020,8,30,2,573,623,565,-58
2020,8,30,3,531,582,568,-14
2020,8,30,4,481,529,566,37
2020,8,30,5,444,482,535,53
2020,8,30,6,422,447,528,81
2020,8,30,7,404,431,535,104
2020,8,30,8,396,422,527,105
2020,8,30,9,390,416,491,75
2020,8,30,10,396,420,451,31
2020,8,30,11,408,428,477,49
2020,8,30,12,429,442,512,70
2020,8,30,13,469,486,547,61
2020,8,30,14,509,531,570,39
2020,8,30,15,545,557,569,12
2020,8,30,16,580,585,568,-17
2020,8,30,17,622,614,567,-47
2020,8,30,18,642,641,571,-70
2020,8,30,19,647,662,567,-95
2020,8,30,20,659,688,569,-119
2020,8,30,21,679,720,565,-155
2020,8,30,22,686,738,565,-173
2020,8,30,23,681,727,566,-161
2020,8,31,0,664,702,566,-136
2020,8,31,1,640,690,567,-123
2020,8,31,2,600,646,508,-138
2020,8,31,3,555,597,448,-149
2020,8,31,4,500,545,501,-44
2020,8,31,5,466,499,500,1
2020,8,31,6,434,466,500,34
2020,8,31,7,417,448,502,54
2020,8,31,8,409,433,502,69
2020,8,31,9,413,434,504,70
2020,8,31,10,438,452,501,49
2020,8,31,11,487,496,501,5
2020,8,31,12,520,535,501,-34
2020,8,31,13,545,563,501,-62
2020,8,31,14,566,581,502,-79
2020,8,31,15,600,602,506,-96
2020,8,31,16,631,625,567,-58
2020,8,31,17,655,652,569,-83
2020,8,31,18,673,678,566,-112
2020,8,31,19,687,709,569,-140
2020,8,31,20,696,725,567,-158
2020,8,31,21,708,727,569,-158
2020,8,31,22,712,735,567,-168
2020,8,31,23,699,734,567,-167
2020,9,1,0,687,717,567,-150
2020,9,1,1,669,698,567,-131
2020,9,1,2,623,657,566,-91
2020,9,1,3,571,605,518,-87
2020,9,1,4,520,540,499,-41
2020,9,1,5,474,503,500,-3
2020,9,1,6,443,480,501,21
2020,9,1,7,428,463,502,39
2020,9,1,8,422,454,501,47
2020,9,1,9,424,454,502,48
2020,9,1,10,448,473,501,28
2020,9,1,11,500,520,502,-18
2020,9,1,12,535,556,507,-49
2020,9,1,13,555,585,567,-18
2020,9,1,14,573,605,569,-36
2020,9,1,15,593,635,565,-70
2020,9,1,16,627,674,568,-106
2020,9,1,17,647,712,566,-146
2020,9,1,18,667,754,566,-188
2020,9,1,19,677,777,567,-210
2020,9,1,20,690,786,563,-223
2020,9,1,21,702,797,563,-234
2020,9,1,22,702,802,568,-234
2020,9,1,23,691,789,565,-224
2020,9,2,0,676,766,568,-198
2020,9,2,1,663,738,564,-174
2020,9,2,2,624,693,568,-125
2020,9,2,3,573,632,567,-65
2020,9,2,4,528,572,510,-62
2020,9,2,5,479,525,500,-25
2020,9,2,6,450,497,501,4
2020,9,2,7,432,478,503,25
2020,9,2,8,423,465,502,37
2020,9,2,9,426,464,500,36
2020,9,2,10,452,486,504,18
2020,9,2,11,510,531,502,-29
2020,9,2,12,539,567,501,-66
2020,9,2,13,555,596,509,-87
2020,9,2,14,582,624,564,-60
2020,9,2,15,606,670,567,-103
2020,9,2,16,650,717,565,-152
2020,9,2,17,678,753,602,-151
2020,9,2,18,705,792,645,-147
2020,9,2,19,712,821,673,-148
2020,9,2,20,726,839,695,-144
2020,9,2,21,732,849,649,-200
2020,9,2,22,726,855,674,-181
2020,9,2,23,712,845,711,-134
2020,9,3,0,685,804,710,-94
2020,9,3,1,674,776,711,-65
2020,9,3,2,626,719,577,-142
2020,9,3,3,574,653,502,-151
2020,9,3,4,519,584,501,-83
2020,9,3,5,539,533,502,-31
2020,9,3,6,504,495,500,5
2020,9,3,7,483,477,503,26
2020,9,3,8,475,462,502,40
2020,9,3,9,475,460,504,44
2020,9,3,10,506,477,504,27
2020,9,3,11,572,515,501,-14
2020,9,3,12,606,554,503,-51
2020,9,3,13,626,579,504,-75
2020,9,3,14,647,611,503,-108
2020,9,3,15,683,651,509,-142
2020,9,3,16,727,694,622,-72
2020,9,3,17,764,740,680,-60
2020,9,3,18,795,777,658,-119
2020,9,3,19,811,875,729,-146
2020,9,3,20,837,908,807,-101
2020,9,3,21,840,792,812,20
2020,9,3,22,830,816,763,-53
2020,9,3,23,831,756,736,-20
2020,9,4,0,798,788,684,-104
2020,9,4,1,782,647,516,-131
2020,9,4,2,722,698,506,-192
2020,9,4,3,660,647,510,-137
2020,9,4,4,597,590,515,-75
2020,9,4,5,534,542,512,-30
2020,9,4,6,507,513,514,1
2020,9,4,7,491,490,516,26
2020,9,4,8,481,477,517,40
2020,9,4,9,481,472,516,44
2020,9,4,10,501,488,519,31
2020,9,4,11,547,521,518,-3
2020,9,4,12,569,559,518,-41
2020,9,4,13,588,593,518,-75
2020,9,4,14,608,617,514,-103
2020,9,4,15,633,645,514,-131
2020,9,4,16,653,683,515,-168
2020,9,4,17,682,710,572,-138
2020,9,4,18,698,737,571,-166
2020,9,4,19,708,754,573,-181
2020,9,4,20,718,775,637,-138
2020,9,4,21,729,783,639,-144
2020,9,4,22,722,791,666,-125
2020,9,4,23,706,770,698,-72
2020,9,5,0,678,728,610,-118
2020,9,5,1,665,699,516,-183
2020,9,5,2,635,663,513,-150
2020,9,5,3,600,612,514,-98
2020,9,5,4,558,555,516,-39
2020,9,5,5,472,511,517,6
2020,9,5,6,431,474,516,42
2020,9,5,7,412,456,521,65
2020,9,5,8,405,438,502,64
2020,9,5,9,395,429,501,72
2020,9,5,10,403,425,498,73
2020,9,5,11,420,431,500,69
2020,9,5,12,435,445,498,53
2020,9,5,13,462,484,502,18
2020,9,5,14,506,512,501,-11
2020,9,5,15,534,545,504,-41
2020,9,5,16,560,555,542,-13
2020,9,5,17,579,582,565,-17
2020,9,5,18,578,597,567,-30
2020,9,5,19,581,616,566,-50
2020,9,5,20,588,636,568,-68
2020,9,5,21,593,650,565,-85
2020,9,5,22,594,650,564,-86
2020,9,5,23,586,627,535,-92
2020,9,6,0,559,597,500,-97
2020,9,6,1,554,578,501,-77
2020,9,6,2,527,549,501,-48
2020,9,6,3,491,504,500,-4
2020,9,6,4,441,463,502,39
2020,9,6,5,417,419,498,79
2020,9,6,6,392,392,498,106
2020,9,6,7,374,377,490,113
2020,9,6,8,367,370,484,114
2020,9,6,9,357,367,483,116
2020,9,6,10,364,369,459,90
2020,9,6,11,378,384,466,82
2020,9,6,12,399,402,454,52
2020,9,6,13,441,433,458,25
2020,9,6,14,468,463,482,19
2020,9,6,15,486,474,501,27
2020,9,6,16,499,492,542,50
2020,9,6,17,516,512,508,-4
2020,9,6,18,534,529,520,-9
2020,9,6,19,547,550,541,-9
2020,9,6,20,564,574,559,-15
2020,9,6,21,586,600,563,-37
2020,9,6,22,589,613,559,-54
2020,9,6,23,581,617,532,-85
2020,9,7,0,563,585,494,-91
2020,9,7,1,549,573,495,-78
2020,9,7,2,517,541,497,-44
2020,9,7,3,488,495,494,-1
2020,9,7,4,443,453,498,45
2020,9,7,5,405,408,490,82
2020,9,7,6,378,386,489,103
2020,9,7,7,368,381,497,116
2020,9,7,8,360,365,423,58
2020,9,7,9,361,365,439,74
2020,9,7,10,368,375,501,126
2020,9,7,11,386,396,542,146
2020,9,7,12,403,417,561,144
2020,9,7,13,438,444,576,132
2020,9,7,14,464,482,602,120
2020,9,7,15,500,501,596,95
2020,9,7,16,528,522,588,66
2020,9,7,17,562,547,580,33
2020,9,7,18,571,574,581,7
2020,9,7,19,598,593,572,-21
2020,9,7,20,623,621,573,-48
2020,9,7,21,642,641,572,-69
2020,9,7,22,649,662,573,-89
2020,9,7,23,651,656,574,-82
2020,9,8,0,620,630,581,-49
2020,9,8,1,616,618,584,-34
2020,9,8,2,568,570,565,-5
2020,9,8,3,518,518,513,-5
2020,9,8,4,460,469,571,102
2020,9,8,5,417,421,564,143
2020,9,8,6,395,403,552,149
2020,9,8,7,381,390,457,67
2020,9,8,8,373,383,398,15
2020,9,8,9,376,388,398,10
2020,9,8,10,405,408,474,66
2020,9,8,11,466,450,543,93
2020,9,8,12,490,485,542,57
2020,9,8,13,510,516,515,-1
2020,9,8,14,533,532,510,-22
2020,9,8,15,555,550,511,-39
2020,9,8,16,571,575,512,-63
2020,9,8,17,595,600,512,-88
2020,9,8,18,625,626,508,-118
2020,9,8,19,643,656,508,-148
2020,9,8,20,659,675,506,-169
2020,9,8,21,677,685,512,-173
2020,9,8,22,689,689,576,-113
2020,9,8,23,682,681,574,-107
2020,9,9,0,660,655,529,-126
2020,9,9,1,650,641,557,-84
2020,9,9,2,605,593,509,-84
2020,9,9,3,547,536,509,-27
2020,9,9,4,489,483,510,27
2020,9,9,5,448,439,506,67
2020,9,9,6,422,414,506,92
2020,9,9,7,409,406,510,104
2020,9,9,8,400,403,510,107
2020,9,9,9,398,406,509,103
2020,9,9,10,426,428,510,82
2020,9,9,11,484,471,523,52
2020,9,9,12,508,515,531,16
2020,9,9,13,527,536,533,-3
2020,9,9,14,544,554,528,-26
2020,9,9,15,565,576,520,-56
2020,9,9,16,590,596,520,-76
2020,9,9,17,601,606,515,-91
2020,9,9,18,626,625,516,-109
2020,9,9,19,647,634,516,-118
2020,9,9,20,662,655,513,-142
2020,9,9,21,677,659,513,-146
2020,9,9,22,679,668,516,-152
2020,9,9,23,667,662,517,-145
2020,9,10,0,654,649,519,-130
2020,9,10,1,649,643,520,-123
2020,9,10,2,601,606,521,-85
2020,9,10,3,547,556,522,-34
2020,9,10,4,489,503,521,18
2020,9,10,5,438,472,522,50
2020,9,10,6,415,444,521,77
2020,9,10,7,402,434,526,92
2020,9,10,8,396,425,524,99
2020,9,10,9,400,432,525,93
2020,9,10,10,425,452,523,71
2020,9,10,11,481,504,528,24
2020,9,10,12,508,537,519,-18
2020,9,10,13,524,563,520,-43
2020,9,10,14,545,582,517,-65
2020,9,10,15,574,609,515,-94
2020,9,10,16,600,641,512,-129
2020,9,10,17,621,668,508,-160
2020,9,10,18,639,699,502,-197
2020,9,10,19,647,725,501,-224
2020,9,10,20,656,741,502,-239
2020,9,10,21,660,754,582,-172
2020,9,10,22,664,762,587,-175
2020,9,10,23,666,749,653,-96
2020,9,11,0,647,719,602,-117
2020,9,11,1,644,708,588,-120
2020,9,11,2,602,657,577,-80
2020,9,11,3,550,601,518,-83
2020,9,11,4,498,551,522,-29
2020,9,11,5,451,502,519,17
2020,9,11,6,421,470,522,52
2020,9,11,7,406,454,523,69
2020,9,11,8,398,441,522,81
2020,9,11,9,401,439,524,85
2020,9,11,10,426,457,524,67
2020,9,11,11,474,500,526,26
2020,9,11,12,502,535,525,-10
2020,9,11,13,521,561,524,-37
2020,9,11,14,544,585,525,-60
2020,9,11,15,568,609,520,-89
2020,9,11,16,596,645,513,-132
2020,9,11,17,616,687,515,-172
2020,9,11,18,631,715,591,-124
2020,9,11,19,643,731,650,-81
2020,9,11,20,648,755,489,-266
2020,9,11,21,657,764,559,-205
2020,9,11,22,655,765,494,-271
2020,9,11,23,635,750,479,-271
2020,9,12,0,620,710,508,-202
2020,9,12,1,610,690,509,-181
2020,9,12,2,566,645,514,-131
2020,9,12,3,527,597,517,-80
2020,9,12,4,483,548,517,-31
2020,9,12,5,481,508,517,9
2020,9,12,6,452,478,518,40
2020,9,12,7,430,458,518,60
2020,9,12,8,425,446,520,74
2020,9,12,9,418,439,520,81
2020,9,12,10,427,445,520,75
2020,9,12,11,448,460,518,58
2020,9,12,12,466,469,520,51
2020,9,12,13,498,483,519,36
2020,9,12,14,541,524,519,-5
2020,9,12,15,572,551,517,-34
2020,9,12,16,596,578,516,-62
2020,9,12,17,601,592,518,-74
2020,9,12,18,603,605,519,-86
2020,9,12,19,609,607,515,-92
2020,9,12,20,607,612,521,-91
2020,9,12,21,609,612,581,-31
2020,9,12,22,625,613,582,-31
2020,9,12,23,603,604,584,-20
2020,9,13,0,583,599,581,-18
2020,9,13,1,584,593,583,-10
2020,9,13,2,551,563,560,-3
2020,9,13,3,507,530,541,11
2020,9,13,4,462,485,520,35
2020,9,13,5,443,442,515,73
2020,9,13,6,414,423,518,95
2020,9,13,7,401,418,525,107
2020,9,13,8,395,406,524,118
2020,9,13,9,390,399,523,124
2020,9,13,10,396,406,525,119
2020,9,13,11,409,417,524,107
2020,9,13,12,433,438,543,105
2020,9,13,13,470,473,592,119
2020,9,13,14,505,504,590,86
2020,9,13,15,535,529,592,63
2020,9,13,16,565,546,591,45
2020,9,13,17,593,575,560,-15
2020,9,13,18,604,593,581,-12
2020,9,13,19,612,618,579,-39
2020,9,13,20,627,644,577,-67
2020,9,13,21,637,678,577,-101
2020,9,13,22,650,690,575,-115
2020,9,13,23,635,684,577,-107
2020,9,14,0,612,662,583,-79
2020,9,14,1,606,644,579,-65
2020,9,14,2,558,603,581,-22
2020,9,14,3,522,544,580,36
2020,9,14,4,477,502,583,81
2020,9,14,5,438,461,580,119
2020,9,14,6,411,435,580,145
2020,9,14,7,399,421,570,149
2020,9,14,8,393,416,565,149
2020,9,14,9,399,419,568,149
2020,9,14,10,429,437,579,142
2020,9,14,11,482,487,583,96
2020,9,14,12,510,523,580,57
2020,9,14,13,533,552,583,31
2020,9,14,14,555,575,583,8
2020,9,14,15,576,604,583,-21
2020,9,14,16,610,636,582,-54
2020,9,14,17,624,669,577,-92
2020,9,14,18,641,692,578,-114
2020,9,14,19,651,688,608,-80
2020,9,14,20,658,680,651,-29
2020,9,14,21,663,681,653,-28
2020,9,14,22,666,664,651,-13
2020,9,14,23,656,656,635,-21
2020,9,15,0,646,650,581,-69
2020,9,15,1,633,640,581,-59
2020,9,15,2,584,605,581,-24
2020,9,15,3,528,554,579,25
2020,9,15,4,480,511,579,68
2020,9,15,5,440,469,580,111
2020,9,15,6,415,440,572,132
2020,9,15,7,402,422,569,147
2020,9,15,8,394,413,557,144
2020,9,15,9,398,410,556,146
2020,9,15,10,428,425,568,143
2020,9,15,11,482,467,573,106
2020,9,15,12,508,505,572,67
2020,9,15,13,524,522,565,43
2020,9,15,14,534,531,582,51
2020,9,15,15,548,545,592,47
2020,9,15,16,568,545,582,37
2020,9,15,17,580,567,564,-3
2020,9,15,18,591,583,568,-15
2020,9,15,19,597,590,580,-10
2020,9,15,20,605,600,581,-19
2020,9,15,21,610,602,578,-24
2020,9,15,22,613,610,584,-26
2020,9,15,23,610,601,579,-22
2020,9,16,0,600,589,571,-18
2020,9,16,1,600,584,576,-8
2020,9,16,2,555,551,548,-3
2020,9,16,3,504,509,588,79
2020,9,16,4,455,458,500,42
2020,9,16,5,418,424,426,2
2020,9,16,6,395,403,430,27
2020,9,16,7,383,390,430,40
2020,9,16,8,378,386,430,44
2020,9,16,9,385,392,431,39
2020,9,16,10,414,409,460,51
2020,9,16,11,469,452,488,36
2020,9,16,12,492,493,493,0
2020,9,16,13,505,512,465,-47
2020,9,16,14,511,520,440,-80
2020,9,16,15,526,527,297,-230
2020,9,16,16,534,538,284,-254
2020,9,16,17,538,557,299,-258
2020,9,16,18,544,558,324,-234
2020,9,16,19,542,574,331,-243
2020,9,16,20,544,588,333,-255
2020,9,16,21,550,585,330,-255
2020,9,16,22,561,590,335,-255
2020,9,16,23,566,591,331,-260
2020,9,17,0,570,597,336,-261
2020,9,17,1,566,590,332,-258
2020,9,17,2,532,559,271,-288
2020,9,17,3,487,511,270,-241
2020,9,17,4,436,464,271,-193
2020,9,17,5,422,427,269,-158
2020,9,17,6,397,411,270,-141
2020,9,17,7,384,399,270,-129
2020,9,17,8,379,392,300,-92
2020,9,17,9,385,398,305,-93
2020,9,17,10,415,416,302,-114
2020,9,17,11,472,460,318,-142
2020,9,17,12,494,502,338,-164
2020,9,17,13,512,530,338,-192
2020,9,17,14,526,545,339,-206
2020,9,17,15,532,555,337,-218
2020,9,17,16,542,567,339,-228
2020,9,17,17,542,569,339,-230
2020,9,17,18,547,568,338,-230
2020,9,17,19,542,562,338,-224
2020,9,17,20,541,561,336,-225
2020,9,17,21,543,565,336,-229
2020,9,17,22,546,579,335,-244
2020,9,17,23,551,588,336,-252
2020,9,18,0,558,589,335,-254
2020,9,18,1,551,579,335,-244
2020,9,18,2,520,550,338,-212
2020,9,18,3,480,508,335,-173
2020,9,18,4,438,466,339,-127
2020,9,18,5,406,431,334,-97
2020,9,18,6,387,412,336,-76
2020,9,18,7,377,401,340,-61
2020,9,18,8,374,392,337,-55
2020,9,18,9,379,399,341,-58
2020,9,18,10,406,417,338,-79
2020,9,18,11,456,451,339,-112
2020,9,18,12,483,491,340,-151
2020,9,18,13,502,513,338,-175
2020,9,18,14,515,535,337,-198
2020,9,18,15,520,547,337,-210
2020,9,18,16,529,556,339,-217
2020,9,18,17,532,560,336,-224
2020,9,18,18,533,565,333,-232
2020,9,18,19,526,570,337,-233
2020,9,18,20,526,570,334,-236
2020,9,18,21,533,568,335,-233
2020,9,18,22,538,560,335,-225
2020,9,18,23,536,560,339,-221
2020,9,19,0,536,553,338,-215
2020,9,19,1,529,548,339,-209
2020,9,19,2,497,517,343,-174
2020,9,19,3,466,485,345,-140
2020,9,19,4,429,445,346,-99
2020,9,19,5,394,407,341,-66
2020,9,19,6,376,387,343,-44
2020,9,19,7,363,377,334,-43
2020,9,19,8,366,369,273,-96
2020,9,19,9,365,372,271,-101
2020,9,19,10,376,381,285,-96
2020,9,19,11,405,398,343,-55
2020,9,19,12,434,421,322,-99
2020,9,19,13,462,451,331,-120
2020,9,19,14,486,477,325,-152
2020,9,19,15,489,489,309,-180
2020,9,19,16,497,493,291,-202
2020,9,19,17,489,492,236,-256
2020,9,19,18,474,484,255,-229
2020,9,19,19,481,486,335,-151
2020,9,19,20,484,490,336,-154
2020,9,19,21,489,494,338,-156
2020,9,19,22,499,502,336,-166
2020,9,19,23,498,505,338,-167
2020,9,20,0,498,509,337,-172
2020,9,20,1,506,511,337,-174
2020,9,20,2,484,482,335,-147
2020,9,20,3,455,454,338,-116
2020,9,20,4,420,414,337,-77
2020,9,20,5,392,387,336,-51
2020,9,20,6,380,367,336,-31
2020,9,20,7,379,357,326,-31
2020,9,20,8,380,353,295,-58
2020,9,20,9,382,355,296,-59
2020,9,20,10,390,361,296,-65
2020,9,20,11,410,376,305,-71
2020,9,20,12,433,404,335,-69
2020,9,20,13,473,440,295,-145
2020,9,20,14,491,465,273,-192
2020,9,20,15,480,462,271,-191
2020,9,20,16,474,462,274,-188
2020,9,20,17,481,456,274,-182
2020,9,20,18,470,454,293,-161
2020,9,20,19,476,451,320,-131
2020,9,20,20,494,455,331,-124
2020,9,20,21,500,468,339,-129
2020,9,20,22,515,490,340,-150
2020,9,20,23,510,495,338,-157
2020,9,21,0,525,498,337,-161
2020,9,21,1,524,500,337,-163
2020,9,21,2,492,472,336,-136
2020,9,21,3,460,436,335,-101
2020,9,21,4,426,402,337,-65
2020,9,21,5,392,368,292,-76
2020,9,21,6,382,361,273,-88
2020,9,21,7,381,357,274,-83
2020,9,21,8,382,354,273,-81
2020,9,21,9,398,367,275,-92
2020,9,21,10,432,394,293,-101
2020,9,21,11,492,455,303,-152
2020,9,21,12,538,500,302,-198
2020,9,21,13,556,529,285,-244
2020,9,21,14,556,529,232,-297
2020,9,21,15,542,522,295,-227
2020,9,21,16,534,516,280,-236
2020,9,21,17,527,513,300,-213
2020,9,21,18,526,506,306,-200
2020,9,21,19,522,503,304,-199
2020,9,21,20,520,508,337,-171
2020,9,21,21,518,513,339,-174
2020,9,21,22,524,522,336,-186
2020,9,21,23,536,530,337,-193
2020,9,22,0,547,533,335,-198
2020,9,22,1,547,531,336,-195
2020,9,22,2,515,502,336,-166
2020,9,22,3,478,457,336,-121
2020,9,22,4,437,417,324,-93
2020,9,22,5,415,385,276,-109
2020,9,22,6,404,377,246,-131
2020,9,22,7,402,378,257,-121
2020,9,22,8,401,379,268,-111
2020,9,22,9,415,389,288,-101
2020,9,22,10,450,421,302,-119
2020,9,22,11,508,477,303,-174
2020,9,22,12,550,528,302,-226
2020,9,22,13,565,548,287,-261
2020,9,22,14,568,539,266,-273
2020,9,22,15,551,524,265,-259
2020,9,22,16,540,506,265,-241
2020,9,22,17,531,501,268,-233
2020,9,22,18,532,488,265,-223
2020,9,22,19,522,488,269,-219
2020,9,22,20,523,489,271,-218
2020,9,22,21,522,494,280,-214
2020,9,22,22,529,501,338,-163
2020,9,22,23,540,506,339,-167
2020,9,23,0,551,521,339,-182
2020,9,23,1,550,517,338,-179
2020,9,23,2,519,488,338,-150
2020,9,23,3,480,444,337,-107
2020,9,23,4,440,410,340,-70
2020,9,23,5,407,374,284,-90
2020,9,23,6,392,368,267,-101
2020,9,23,7,384,361,240,-121
2020,9,23,8,382,361,253,-108
2020,9,23,9,393,370,267,-103
2020,9,23,10,425,397,272,-125
2020,9,23,11,487,446,323,-123
2020,9,23,12,523,482,271,-211
2020,9,23,13,534,502,271,-231
2020,9,23,14,534,503,272,-231
2020,9,23,15,532,499,273,-226
2020,9,23,16,532,499,273,-226
2020,9,23,17,530,492,330,-162
2020,9,23,18,530,494,334,-160
2020,9,23,19,530,494,332,-162
2020,9,23,20,534,497,333,-164
2020,9,23,21,536,498,330,-168
2020,9,23,22,547,511,331,-180
2020,9,23,23,556,521,332,-189
2020,9,24,0,563,529,333,-196
2020,9,24,1,558,515,330,-185
2020,9,24,2,526,485,334,-151
2020,9,24,3,479,439,314,-125
2020,9,24,4,434,405,272,-133
2020,9,24,5,406,371,269,-102
2020,9,24,6,390,358,270,-88
2020,9,24,7,382,349,270,-79
2020,9,24,8,380,349,270,-79
2020,9,24,9,390,353,272,-81
2020,9,24,10,419,373,268,-105
2020,9,24,11,478,420,270,-150
2020,9,24,12,511,465,268,-197
2020,9,24,13,527,487,265,-222
2020,9,24,14,533,504,268,-236
2020,9,24,15,539,514,266,-248
2020,9,24,16,536,518,267,-251
2020,9,24,17,537,520,301,-219
2020,9,24,18,534,518,333,-185
2020,9,24,19,529,511,335,-176
2020,9,24,20,533,508,334,-174
2020,9,24,21,537,511,333,-178
2020,9,24,22,542,525,332,-193
2020,9,24,23,548,532,332,-200
2020,9,25,0,561,537,334,-203
2020,9,25,1,554,520,331,-189
2020,9,25,2,523,488,329,-159
2020,9,25,3,483,453,297,-156
2020,9,25,4,443,417,229,-188
2020,9,25,5,416,379,193,-186
2020,9,25,6,398,368,193,-175
2020,9,25,7,390,358,193,-165
2020,9,25,8,387,358,198,-160
2020,9,25,9,394,361,214,-147
2020,9,25,10,419,386,338,-48
2020,9,25,11,471,427,337,-90
2020,9,25,12,506,469,297,-172
2020,9,25,13,523,496,254,-242
2020,9,25,14,533,504,251,-253
2020,9,25,15,531,505,252,-253
2020,9,25,16,534,520,253,-267
2020,9,25,17,535,523,254,-269
2020,9,25,18,532,512,254,-258
2020,9,25,19,527,505,266,-239
2020,9,25,20,526,502,270,-232
2020,9,25,21,526,497,274,-223
2020,9,25,22,532,505,304,-201
2020,9,25,23,538,509,380,-129
2020,9,26,0,547,515,476,-39
2020,9,26,1,534,506,471,-35
2020,9,26,2,506,482,350,-132
2020,9,26,3,473,451,350,-101
2020,9,26,4,437,414,351,-63
2020,9,26,5,403,381,347,-34
2020,9,26,6,384,362,345,-17
2020,9,26,7,373,352,343,-9
2020,9,26,8,370,349,295,-54
2020,9,26,9,375,352,305,-47
2020,9,26,10,385,359,327,-32
2020,9,26,11,413,378,339,-39
2020,9,26,12,438,404,339,-65
2020,9,26,13,461,433,308,-125
2020,9,26,14,489,462,321,-141
2020,9,26,15,507,476,342,-134
2020,9,26,16,508,485,343,-142
2020,9,26,17,508,488,344,-144
2020,9,26,18,502,490,343,-147
2020,9,26,19,506,488,343,-145
2020,9,26,20,518,492,342,-150
2020,9,26,21,519,506,343,-163
2020,9,26,22,531,514,342,-172
2020,9,26,23,528,515,342,-173
2020,9,27,0,514,520,343,-177
2020,9,27,1,521,513,343,-170
2020,9,27,2,490,490,343,-147
2020,9,27,3,459,455,342,-113
2020,9,27,4,421,419,338,-81
2020,9,27,5,388,383,308,-75
2020,9,27,6,365,365,288,-77
2020,9,27,7,355,351,283,-68
2020,9,27,8,351,349,285,-64
2020,9,27,9,350,342,283,-59
2020,9,27,10,355,349,284,-65
2020,9,27,11,375,362,299,-63
2020,9,27,12,396,387,329,-58
2020,9,27,13,434,423,320,-103
2020,9,27,14,466,450,311,-139
2020,9,27,15,481,459,318,-141
2020,9,27,16,489,472,340,-132
2020,9,27,17,510,486,340,-146
2020,9,27,18,523,495,339,-156
2020,9,27,19,526,497,342,-155
2020,9,27,20,538,506,341,-165
2020,9,27,21,551,520,340,-180
2020,9,27,22,562,533,338,-195
2020,9,27,23,557,539,339,-200
2020,9,28,0,563,543,341,-202
2020,9,28,1,550,540,341,-199
2020,9,28,2,516,505,340,-165
2020,9,28,3,476,463,340,-123
2020,9,28,4,438,423,340,-83
2020,9,28,5,390,394,339,-55
2020,9,28,6,366,371,337,-34
2020,9,28,7,355,365,341,-24
2020,9,28,8,348,358,333,-25
2020,9,28,9,356,367,340,-27
2020,9,28,10,383,390,340,-50
2020,9,28,11,431,432,339,-93
2020,9,28,12,464,472,340,-132
2020,9,28,13,491,500,340,-160
2020,9,28,14,504,523,341,-182
2020,9,28,15,516,544,341,-203
2020,9,28,16,534,555,340,-215
2020,9,28,17,543,575,339,-236
2020,9,28,18,546,592,337,-255
2020,9,28,19,555,591,336,-255
2020,9,28,20,560,605,337,-268
2020,9,28,21,577,606,335,-271
2020,9,28,22,585,613,338,-275
2020,9,28,23,584,603,338,-265
2020,9,29,0,597,605,341,-264
2020,9,29,1,590,593,341,-252
2020,9,29,2,545,549,342,-207
2020,9,29,3,495,504,341,-163
2020,9,29,4,453,459,340,-119
2020,9,29,5,410,425,339,-86
2020,9,29,6,384,405,340,-65
2020,9,29,7,371,394,340,-54
2020,9,29,8,365,389,330,-59
2020,9,29,9,368,389,339,-50
2020,9,29,10,393,402,340,-62
2020,9,29,11,440,447,342,-105
2020,9,29,12,479,485,342,-143
2020,9,29,13,498,507,339,-168
2020,9,29,14,507,527,342,-185
2020,9,29,15,509,533,340,-193
2020,9,29,16,516,545,341,-204
2020,9,29,17,523,538,343,-195
2020,9,29,18,524,534,341,-193
2020,9,29,19,516,523,343,-180
2020,9,29,20,516,529,342,-187
2020,9,29,21,521,535,342,-193
2020,9,29,22,540,556,343,-213
2020,9,29,23,563,563,341,-222
2020,9,30,0,571,570,342,-228
2020,9,30,1,556,553,341,-212
2020,9,30,2,521,514,341,-173
2020,9,30,3,491,475,340,-135
2020,9,30,4,447,447,341,-106
2020,9,30,5,411,415,305,-110
2020,9,30,6,394,409,306,-103
2020,9,30,7,386,404,285,-119
2020,9,30,8,384,404,283,-121
2020,9,30,9,392,407,289,-118
2020,9,30,10,423,437,331,-106
2020,9,30,11,474,492,342,-150
2020,9,30,12,513,539,343,-196
2020,9,30,13,530,549,288,-261
2020,9,30,14,531,548,283,-265
2020,9,30,15,533,539,270,-269
2020,9,30,16,533,532,235,-297
2020,9,30,17,526,525,237,-288
2020,9,30,18,520,516,234,-282
2020,9,30,19,512,512,235,-277
2020,9,30,20,510,517,305,-212
2020,9,30,21,518,524,342,-182
2020,9,30,22,528,534,343,-191
2020,9,30,23,539,547,343,-204
2020,10,1,0,551,556,343,-213
2020,10,1,1,549,551,340,-211
2020,10,1,2,521,520,343,-177
2020,10,1,3,486,480,343,-137
2020,10,1,4,442,438,340,-98
2020,10,1,5,427,409,326,-83
2020,10,1,6,411,399,321,-78
2020,10,1,7,402,397,304,-93
2020,10,1,8,402,395,289,-106
2020,10,1,9,411,408,308,-100
2020,10,1,10,443,438,328,-110
2020,10,1,11,489,494,344,-150
2020,10,1,12,527,535,341,-194
2020,10,1,13,543,557,342,-215
2020,10,1,14,542,549,324,-225
2020,10,1,15,535,540,313,-227
2020,10,1,16,517,531,318,-213
2020,10,1,17,513,522,337,-185
2020,10,1,18,512,519,344,-175
2020,10,1,19,502,525,343,-182
2020,10,1,20,504,531,343,-188
2020,10,1,21,514,536,344,-192
2020,10,1,22,530,544,344,-200
2020,10,1,23,542,552,343,-209
2020,10,2,0,553,560,343,-217
2020,10,2,1,539,544,342,-202
2020,10,2,2,517,517,344,-173
2020,10,2,3,483,476,343,-133
2020,10,2,4,441,439,344,-95
2020,10,2,5,411,408,323,-85
2020,10,2,6,397,396,277,-119
2020,10,2,7,393,396,302,-94
2020,10,2,8,396,397,286,-111
2020,10,2,9,406,410,287,-123
2020,10,2,10,435,443,321,-122
2020,10,2,11,482,494,338,-156
2020,10,2,12,526,544,342,-202
2020,10,2,13,543,570,343,-227
2020,10,2,14,553,560,341,-219
2020,10,2,15,541,549,323,-226
2020,10,2,16,528,533,235,-298
2020,10,2,17,514,521,235,-286
2020,10,2,18,509,509,253,-256
2020,10,2,19,495,502,323,-179
2020,10,2,20,489,496,338,-158
2020,10,2,21,492,506,349,-157
2020,10,2,22,508,522,352,-170
2020,10,2,23,526,535,343,-192
2020,10,3,0,545,551,340,-211
2020,10,3,1,543,543,334,-209
2020,10,3,2,529,524,342,-182
2020,10,3,3,508,498,341,-157
2020,10,3,4,476,472,342,-130
2020,10,3,5,417,448,340,-108
2020,10,3,6,397,434,297,-137
2020,10,3,7,404,431,282,-149
2020,10,3,8,411,428,281,-147
2020,10,3,9,422,437,282,-155
2020,10,3,10,436,459,282,-177
2020,10,3,11,466,495,311,-184
2020,10,3,12,504,535,341,-194
2020,10,3,13,538,569,342,-227
2020,10,3,14,539,582,318,-264
2020,10,3,15,528,564,329,-235
2020,10,3,16,519,537,298,-239
2020,10,3,17,490,516,304,-212
2020,10,3,18,475,497,339,-158
2020,10,3,19,461,488,328,-160
2020,10,3,20,466,486,323,-163
2020,10,3,21,463,489,332,-157
2020,10,3,22,478,498,342,-156
2020,10,3,23,488,514,344,-170
2020,10,4,0,503,532,343,-189
2020,10,4,1,502,524,343,-181
2020,10,4,2,468,507,342,-165
2020,10,4,3,450,478,343,-135
2020,10,4,4,416,448,343,-105
2020,10,4,5,405,428,313,-115
2020,10,4,6,385,416,305,-111
2020,10,4,7,379,409,304,-105
2020,10,4,8,385,413,299,-114
2020,10,4,9,385,420,299,-121
2020,10,4,10,398,443,308,-135
2020,10,4,11,422,465,308,-157
2020,10,4,12,462,502,309,-193
2020,10,4,13,495,540,309,-231
2020,10,4,14,518,555,310,-245
2020,10,4,15,508,535,310,-225
2020,10,4,16,491,515,310,-205
2020,10,4,17,487,500,341,-159
2020,10,4,18,475,487,333,-154
2020,10,4,19,447,478,338,-140
2020,10,4,20,459,480,339,-141
2020,10,4,21,473,490,336,-154
2020,10,4,22,496,508,345,-163
2020,10,4,23,515,515,343,-172
2020,10,5,0,522,538,345,-193
2020,10,5,1,510,531,342,-189
2020,10,5,2,477,496,344,-152
2020,10,5,3,441,464,342,-122
2020,10,5,4,405,431,333,-98
2020,10,5,5,386,409,285,-124
2020,10,5,6,376,397,241,-156
2020,10,5,7,376,393,277,-116
2020,10,5,8,377,398,275,-123
2020,10,5,9,392,411,298,-113
2020,10,5,10,418,444,308,-136
2020,10,5,11,482,500,311,-189
2020,10,5,12,532,549,311,-238
2020,10,5,13,549,574,310,-264
2020,10,5,14,555,571,309,-262
2020,10,5,15,543,559,307,-252
2020,10,5,16,530,546,298,-248
2020,10,5,17,520,537,331,-206
2020,10,5,18,516,531,342,-189
2020,10,5,19,507,527,345,-182
2020,10,5,20,505,532,344,-188
2020,10,5,21,507,539,342,-197
2020,10,5,22,518,551,344,-207
2020,10,5,23,530,560,342,-218
2020,10,6,0,552,573,345,-228
2020,10,6,1,543,557,339,-218
2020,10,6,2,507,527,301,-226
2020,10,6,3,468,484,276,-208
2020,10,6,4,427,446,275,-171
2020,10,6,5,397,413,272,-141
2020,10,6,6,378,402,272,-130
2020,10,6,7,371,399,276,-123
2020,10,6,8,372,396,274,-122
2020,10,6,9,380,410,275,-135
2020,10,6,10,409,436,274,-162
2020,10,6,11,464,496,279,-217
2020,10,6,12,510,543,290,-253
2020,10,6,13,522,562,285,-277
2020,10,6,14,525,563,273,-290
2020,10,6,15,520,544,273,-271
2020,10,6,16,520,536,274,-262
2020,10,6,17,516,531,296,-235
2020,10,6,18,515,529,336,-193
2020,10,6,19,507,533,343,-190
2020,10,6,20,514,534,341,-193
2020,10,6,21,518,550,344,-206
2020,10,6,22,534,558,341,-217
2020,10,6,23,546,567,343,-224
2020,10,7,0,561,576,342,-234
2020,10,7,1,549,561,343,-218
2020,10,7,2,514,523,342,-181
2020,10,7,3,469,479,344,-135
2020,10,7,4,430,438,343,-95
2020,10,7,5,401,407,292,-115
2020,10,7,6,383,392,275,-117
2020,10,7,7,375,386,277,-109
2020,10,7,8,373,383,277,-106
2020,10,7,9,380,397,278,-119
2020,10,7,10,409,426,277,-149
2020,10,7,11,468,472,275,-197
2020,10,7,12,510,520,276,-244
2020,10,7,13,522,540,273,-267
2020,10,7,14,524,541,274,-267
2020,10,7,15,520,526,273,-253
2020,10,7,16,516,529,276,-253
2020,10,7,17,512,528,339,-189
2020,10,7,18,514,532,341,-191
2020,10,7,19,508,539,341,-198
2020,10,7,20,512,548,340,-208
2020,10,7,21,518,560,335,-225
2020,10,7,22,533,573,339,-234
2020,10,7,23,542,573,337,-236
2020,10,8,0,560,581,341,-240
2020,10,8,1,546,564,342,-222
2020,10,8,2,515,522,342,-180
2020,10,8,3,471,479,343,-136
2020,10,8,4,433,449,324,-125
2020,10,8,5,386,407,274,-133
2020,10,8,6,364,394,277,-117
2020,10,8,7,355,387,278,-109
2020,10,8,8,347,383,278,-105
2020,10,8,9,357,395,279,-116
2020,10,8,10,384,421,277,-144
2020,10,8,11,444,474,278,-196
2020,10,8,12,483,518,277,-241
2020,10,8,13,497,542,278,-264
2020,10,8,14,506,540,278,-262
2020,10,8,15,505,536,278,-258
2020,10,8,16,504,543,283,-260
2020,10,8,17,502,544,339,-205
2020,10,8,18,501,553,338,-215
2020,10,8,19,495,568,339,-229
2020,10,8,20,498,569,336,-233
2020,10,8,21,499,574,336,-238
2020,10,8,22,508,579,340,-239
2020,10,8,23,521,582,338,-244
2020,10,9,0,540,592,341,-251
2020,10,9,1,528,573,342,-231
2020,10,9,2,498,539,343,-196
2020,10,9,3,460,491,337,-154
2020,10,9,4,424,443,273,-170
2020,10,9,5,382,414,274,-140
2020,10,9,6,366,396,275,-121
2020,10,9,7,362,389,277,-112
2020,10,9,8,358,383,276,-107
2020,10,9,9,364,384,278,-106
2020,10,9,10,390,398,276,-122
2020,10,9,11,448,446,280,-166
2020,10,9,12,492,487,281,-206
2020,10,9,13,505,508,280,-228
2020,10,9,14,510,518,281,-237
2020,10,9,15,506,528,280,-248
2020,10,9,16,502,529,285,-244
2020,10,9,17,502,530,347,-183
2020,10,9,18,504,523,346,-177
2020,10,9,19,498,519,344,-175
2020,10,9,20,499,528,348,-180
2020,10,9,21,499,530,347,-183
2020,10,9,22,505,540,345,-195
2020,10,9,23,508,547,347,-200
2020,10,10,0,522,553,350,-203
2020,10,10,1,507,538,323,-215
2020,10,10,2,479,510,312,-198
2020,10,10,3,450,478,284,-194
2020,10,10,4,416,442,294,-148
2020,10,10,5,377,414,284,-130
2020,10,10,6,361,392,275,-117
2020,10,10,7,358,376,277,-99
2020,10,10,8,354,375,275,-100
2020,10,10,9,362,375,275,-100
2020,10,10,10,374,383,274,-109
2020,10,10,11,389,405,275,-130
2020,10,10,12,423,430,275,-155
2020,10,10,13,452,461,275,-186
2020,10,10,14,472,496,275,-221
2020,10,10,15,480,522,272,-250
2020,10,10,16,477,535,282,-253
2020,10,10,17,474,531,338,-193
2020,10,10,18,471,526,339,-187
2020,10,10,19,463,519,339,-180
2020,10,10,20,472,513,337,-176
2020,10,10,21,473,512,337,-175
2020,10,10,22,485,526,338,-188
2020,10,10,23,481,536,339,-197
2020,10,11,0,508,539,337,-202
2020,10,11,1,496,519,336,-183
2020,10,11,2,462,504,346,-158
2020,10,11,3,446,474,347,-127
2020,10,11,4,413,430,337,-93
2020,10,11,5,385,407,345,-62
2020,10,11,6,364,390,345,-45
2020,10,11,7,356,380,345,-35
2020,10,11,8,355,374,346,-28
2020,10,11,9,351,375,346,-29
2020,10,11,10,362,381,345,-36
2020,10,11,11,380,395,345,-50
2020,10,11,12,409,420,344,-76
2020,10,11,13,443,460,346,-114
2020,10,11,14,469,486,344,-142
2020,10,11,15,472,506,343,-163
2020,10,11,16,474,514,342,-172
2020,10,11,17,486,522,337,-185
2020,10,11,18,493,523,339,-184
2020,10,11,19,491,515,340,-175
2020,10,11,20,494,514,341,-173
2020,10,11,21,505,522,341,-181
2020,10,11,22,510,537,341,-196
2020,10,11,23,512,546,342,-204
2020,10,12,0,530,551,344,-207
2020,10,12,1,520,535,344,-191
2020,10,12,2,486,506,343,-163
2020,10,12,3,450,468,344,-124
2020,10,12,4,414,427,335,-92
2020,10,12,5,379,405,342,-63
2020,10,12,6,360,387,342,-45
2020,10,12,7,351,377,340,-37
2020,10,12,8,349,374,325,-49
2020,10,12,9,353,383,336,-47
2020,10,12,10,377,402,343,-59
2020,10,12,11,420,452,344,-108
2020,10,12,12,452,492,344,-148
2020,10,12,13,474,522,345,-177
2020,10,12,14,488,537,346,-191
2020,10,12,15,497,545,343,-202
2020,10,12,16,513,553,342,-211
2020,10,12,17,515,561,340,-221
2020,10,12,18,529,568,340,-228
2020,10,12,19,524,574,339,-235
2020,10,12,20,533,584,337,-247
2020,10,12,21,540,587,336,-251
2020,10,12,22,540,602,337,-265
2020,10,12,23,538,603,336,-267
2020,10,13,0,551,609,337,-272
2020,10,13,1,537,583,337,-246
2020,10,13,2,505,546,338,-208
2020,10,13,3,466,500,336,-164
2020,10,13,4,429,458,336,-122
2020,10,13,5,411,427,336,-91
2020,10,13,6,383,403,335,-68
2020,10,13,7,372,389,335,-54
2020,10,13,8,367,383,334,-49
2020,10,13,9,371,393,337,-56
2020,10,13,10,395,413,336,-77
2020,10,13,11,447,462,336,-126
2020,10,13,12,490,503,335,-168
2020,10,13,13,504,526,336,-190
2020,10,13,14,517,537,338,-199
2020,10,13,15,522,544,337,-207
2020,10,13,16,533,550,340,-210
2020,10,13,17,540,555,338,-217
2020,10,13,18,551,561,338,-223
2020,10,13,19,552,552,338,-214
2020,10,13,20,559,555,337,-218
2020,10,13,21,567,558,337,-221
2020,10,13,22,566,566,339,-227
2020,10,13,23,570,565,337,-228
2020,10,14,0,583,573,335,-238
2020,10,14,1,565,558,334,-224
2020,10,14,2,529,522,335,-187
2020,10,14,3,483,483,338,-145
2020,10,14,4,436,441,336,-105
2020,10,14,5,399,416,336,-80
2020,10,14,6,373,400,334,-66
2020,10,14,7,364,394,335,-59
2020,10,14,8,361,398,337,-61
2020,10,14,9,364,408,335,-73
2020,10,14,10,387,437,336,-101
2020,10,14,11,444,495,336,-159
2020,10,14,12,485,549,336,-213
2020,10,14,13,498,569,332,-237
2020,10,14,14,502,568,338,-230
2020,10,14,15,509,558,336,-222
2020,10,14,16,518,546,336,-210
2020,10,14,17,523,540,337,-203
2020,10,14,18,536,533,336,-197
2020,10,14,19,540,529,335,-194
2020,10,14,20,551,542,340,-202
2020,10,14,21,561,549,337,-212
2020,10,14,22,569,560,337,-223
2020,10,14,23,575,569,337,-232
2020,10,15,0,582,579,337,-242
2020,10,15,1,560,562,335,-227
2020,10,15,2,526,528,337,-191
2020,10,15,3,483,484,335,-149
2020,10,15,4,433,448,337,-111
2020,10,15,5,396,420,336,-84
2020,10,15,6,370,403,336,-67
2020,10,15,7,362,400,334,-66
2020,10,15,8,358,402,336,-66
2020,10,15,9,360,402,333,-69
2020,10,15,10,383,434,336,-98
2020,10,15,11,440,491,335,-156
2020,10,15,12,483,546,338,-208
2020,10,15,13,496,559,336,-223
2020,10,15,14,504,557,338,-219
2020,10,15,15,504,546,336,-210
2020,10,15,16,518,536,337,-199
2020,10,15,17,522,535,337,-198
2020,10,15,18,531,539,337,-202
2020,10,15,19,530,540,336,-204
2020,10,15,20,538,544,336,-208
2020,10,15,21,546,558,335,-223
2020,10,15,22,555,564,337,-227
2020,10,15,23,557,572,342,-230
2020,10,16,0,571,583,341,-242
2020,10,16,1,547,561,340,-221
2020,10,16,2,514,528,343,-185
2020,10,16,3,471,489,342,-147
2020,10,16,4,422,446,342,-104
2020,10,16,5,382,413,339,-74
2020,10,16,6,362,398,341,-57
2020,10,16,7,354,389,341,-48
2020,10,16,8,351,387,341,-46
2020,10,16,9,359,394,341,-53
2020,10,16,10,390,417,340,-77
2020,10,16,11,446,463,338,-125
2020,10,16,12,495,512,339,-173
2020,10,16,13,511,541,342,-199
2020,10,16,14,519,554,341,-213
2020,10,16,15,510,555,340,-215
2020,10,16,16,508,555,341,-214
2020,10,16,17,498,554,341,-213
2020,10,16,18,498,548,340,-208
2020,10,16,19,489,539,343,-196
2020,10,16,20,483,524,339,-185
2020,10,16,21,486,525,343,-182
2020,10,16,22,510,537,346,-191
2020,10,16,23,542,553,347,-206
2020,10,17,0,565,577,345,-232
2020,10,17,1,562,572,346,-226
2020,10,17,2,552,552,345,-207
2020,10,17,3,528,528,345,-183
2020,10,17,4,514,497,344,-153
2020,10,17,5,428,477,318,-159
2020,10,17,6,413,462,294,-168
2020,10,17,7,407,465,237,-228
2020,10,17,8,410,468,223,-245
2020,10,17,9,413,479,298,-181
2020,10,17,10,434,504,322,-182
2020,10,17,11,460,535,349,-186
2020,10,17,12,507,587,347,-240
2020,10,17,13,546,626,348,-278
2020,10,17,14,566,633,351,-282
2020,10,17,15,552,601,351,-250
2020,10,17,16,543,566,351,-215
2020,10,17,17,516,536,349,-187
2020,10,17,18,496,512,351,-161
2020,10,17,19,471,491,349,-142
2020,10,17,20,480,487,350,-137
2020,10,17,21,479,498,350,-148
2020,10,17,22,499,514,350,-164
2020,10,17,23,512,535,350,-185
2020,10,18,0,545,564,350,-214
2020,10,18,1,541,558,349,-209
2020,10,18,2,512,538,349,-189
2020,10,18,3,490,517,348,-169
2020,10,18,4,457,493,350,-143
2020,10,18,5,451,470,317,-153
2020,10,18,6,441,460,315,-145
2020,10,18,7,435,471,320,-151
2020,10,18,8,447,471,319,-152
2020,10,18,9,454,483,319,-164
2020,10,18,10,469,499,323,-176
2020,10,18,11,490,531,349,-182
2020,10,18,12,534,577,350,-227
2020,10,18,13,585,620,351,-269
2020,10,18,14,589,614,352,-262
2020,10,18,15,562,574,324,-250
2020,10,18,16,535,547,320,-227
2020,10,18,17,500,520,317,-203
2020,10,18,18,494,502,318,-184
2020,10,18,19,477,483,319,-164
2020,10,18,20,479,477,322,-155
2020,10,18,21,486,489,349,-140
2020,10,18,22,514,509,347,-162
2020,10,18,23,535,526,348,-178
2020,10,19,0,554,551,351,-200
2020,10,19,1,548,545,356,-189
2020,10,19,2,508,515,350,-165
2020,10,19,3,477,485,322,-163
2020,10,19,4,441,451,322,-129
2020,10,19,5,397,432,291,-141
2020,10,19,6,383,423,289,-134
2020,10,19,7,382,422,291,-131
2020,10,19,8,386,431,291,-140
2020,10,19,9,400,447,291,-156
2020,10,19,10,430,486,297,-189
2020,10,19,11,494,545,350,-195
2020,10,19,12,549,594,351,-243
2020,10,19,13,559,614,351,-263
2020,10,19,14,563,609,351,-258
2020,10,19,15,553,587,352,-235
2020,10,19,16,534,563,352,-211
2020,10,19,17,522,544,348,-196
2020,10,19,18,519,532,346,-186
2020,10,19,19,505,529,343,-186
2020,10,19,20,506,527,342,-185
2020,10,19,21,507,540,341,-199
2020,10,19,22,524,546,343,-203
2020,10,19,23,545,559,344,-215
2020,10,20,0,567,579,347,-232
2020,10,20,1,550,558,347,-211
2020,10,20,2,523,522,305,-217
2020,10,20,3,483,483,286,-197
2020,10,20,4,437,433,277,-156
2020,10,20,5,421,414,286,-128
2020,10,20,6,403,410,285,-125
2020,10,20,7,401,403,287,-116
2020,10,20,8,402,405,286,-119
2020,10,20,9,411,417,288,-129
2020,10,20,10,442,438,286,-152
2020,10,20,11,499,507,295,-212
2020,10,20,12,550,552,349,-203
2020,10,20,13,561,572,349,-223
2020,10,20,14,561,568,349,-219
2020,10,20,15,556,551,350,-201
2020,10,20,16,544,533,350,-183
2020,10,20,17,530,526,348,-178
2020,10,20,18,525,522,345,-177
2020,10,20,19,513,521,340,-181
2020,10,20,20,510,525,339,-186
2020,10,20,21,517,544,338,-206
2020,10,20,22,536,553,337,-216
2020,10,20,23,565,566,340,-226
2020,10,21,0,595,581,342,-239
2020,10,21,1,578,565,346,-219
2020,10,21,2,558,526,347,-179
2020,10,21,3,517,486,303,-183
2020,10,21,4,476,444,286,-158
2020,10,21,5,407,411,284,-127
2020,10,21,6,388,398,285,-113
2020,10,21,7,382,394,286,-108
2020,10,21,8,379,394,287,-107
2020,10,21,9,388,403,286,-117
2020,10,21,10,415,427,286,-141
2020,10,21,11,478,484,298,-186
2020,10,21,12,521,530,285,-245
2020,10,21,13,531,554,288,-266
2020,10,21,14,532,550,286,-264
2020,10,21,15,537,545,289,-256
2020,10,21,16,531,545,346,-199
2020,10,21,17,535,544,343,-201
2020,10,21,18,542,551,405,-146
2020,10,21,19,542,558,412,-146
2020,10,21,20,548,564,451,-113
2020,10,21,21,558,569,488,-81
2020,10,21,22,562,584,499,-85
2020,10,21,23,568,588,499,-89
2020,10,22,0,578,599,501,-98
2020,10,22,1,561,575,451,-124
2020,10,22,2,532,537,440,-97
2020,10,22,3,491,488,367,-121
2020,10,22,4,446,449,348,-101
2020,10,22,5,403,417,300,-117
2020,10,22,6,382,398,280,-118
2020,10,22,7,375,389,281,-108
2020,10,22,8,371,384,281,-103
2020,10,22,9,379,391,281,-110
2020,10,22,10,408,421,281,-140
2020,10,22,11,468,469,282,-187
2020,10,22,12,509,518,276,-242
2020,10,22,13,523,538,277,-261
2020,10,22,14,527,547,276,-271
2020,10,22,15,531,548,277,-271
2020,10,22,16,530,548,273,-275
2020,10,22,17,535,553,306,-247
2020,10,22,18,541,553,333,-220
2020,10,22,19,538,560,418,-142
2020,10,22,20,543,567,425,-142
2020,10,22,21,549,575,421,-154
2020,10,22,22,554,583,475,-108
2020,10,22,23,560,588,494,-94
2020,10,23,0,576,596,465,-131
2020,10,23,1,558,578,374,-204
2020,10,23,2,526,528,344,-184
2020,10,23,3,486,484,296,-188
2020,10,23,4,442,449,283,-166
2020,10,23,5,415,411,280,-131
2020,10,23,6,394,401,285,-116
2020,10,23,7,386,387,283,-104
2020,10,23,8,384,384,283,-101
2020,10,23,9,392,394,284,-110
2020,10,23,10,420,418,284,-134
2020,10,23,11,474,461,283,-178
2020,10,23,12,516,506,282,-224
2020,10,23,13,530,528,281,-247
2020,10,23,14,533,537,282,-255
2020,10,23,15,531,538,280,-258
2020,10,23,16,530,536,269,-267
2020,10,23,17,537,546,308,-238
2020,10,23,18,537,556,330,-226
2020,10,23,19,530,557,330,-227
2020,10,23,20,528,553,330,-223
2020,10,23,21,530,553,330,-223
2020,10,23,22,539,557,330,-227
2020,10,23,23,547,559,331,-228
2020,10,24,0,561,569,331,-238
2020,10,24,1,537,549,330,-219
2020,10,24,2,511,523,331,-192
2020,10,24,3,481,488,331,-157
2020,10,24,4,442,447,326,-121
2020,10,24,5,410,411,272,-139
2020,10,24,6,393,390,271,-119
2020,10,24,7,376,383,272,-111
2020,10,24,8,373,374,270,-104
2020,10,24,9,373,378,270,-108
2020,10,24,10,389,387,270,-117
2020,10,24,11,414,410,271,-139
2020,10,24,12,448,441,270,-171
2020,10,24,13,466,474,271,-203
2020,10,24,14,488,501,269,-232
2020,10,24,15,503,513,283,-230
2020,10,24,16,497,510,326,-184
2020,10,24,17,502,508,327,-181
2020,10,24,18,496,517,329,-188
2020,10,24,19,499,521,334,-187
2020,10,24,20,514,519,321,-198
2020,10,24,21,512,526,331,-195
2020,10,24,22,524,532,331,-201
2020,10,24,23,526,546,330,-216
2020,10,25,0,521,551,330,-221
2020,10,25,1,523,536,332,-204
2020,10,25,2,496,509,331,-178
2020,10,25,3,472,473,330,-143
2020,10,25,4,434,437,331,-106
2020,10,25,5,389,404,283,-121
2020,10,25,6,369,386,269,-117
2020,10,25,7,362,373,269,-104
2020,10,25,8,358,367,270,-97
2020,10,25,9,356,370,269,-101
2020,10,25,10,364,376,270,-106
2020,10,25,11,386,391,269,-122
2020,10,25,12,410,421,271,-150
2020,10,25,13,450,457,279,-178
2020,10,25,14,478,489,333,-156
2020,10,25,15,485,504,333,-171
2020,10,25,16,489,511,332,-179
2020,10,25,17,490,514,332,-182
2020,10,25,18,487,514,333,-181
2020,10,25,19,486,510,332,-178
2020,10,25,20,486,509,332,-177
2020,10,25,21,494,513,331,-182
2020,10,25,22,505,526,334,-192
2020,10,25,23,526,538,332,-206
2020,10,26,0,547,549,332,-217
2020,10,26,1,527,530,332,-198
2020,10,26,2,495,499,334,-165
2020,10,26,3,462,464,330,-134
2020,10,26,4,418,429,331,-98
2020,10,26,5,394,397,287,-110
2020,10,26,6,373,378,270,-108
2020,10,26,7,366,374,262,-112
2020,10,26,8,367,368,260,-108
2020,10,26,9,376,379,264,-115
2020,10,26,10,412,402,270,-132
2020,10,26,11,470,457,276,-181
2020,10,26,12,510,500,280,-220
2020,10,26,13,526,526,333,-193
2020,10,26,14,531,538,341,-197
2020,10,26,15,525,544,343,-201
2020,10,26,16,528,551,339,-212
2020,10,26,17,538,554,337,-217
2020,10,26,18,543,560,335,-225
2020,10,26,19,534,564,345,-219
2020,10,26,20,532,568,352,-216
2020,10,26,21,537,574,349,-225
2020,10,26,22,552,578,352,-226
2020,10,26,23,575,590,363,-227
2020,10,27,0,586,595,372,-223
2020,10,27,1,561,569,410,-159
2020,10,27,2,529,534,555,21
2020,10,27,3,486,494,604,110
2020,10,27,4,441,447,580,133
2020,10,27,5,415,413,568,0
2020,10,27,6,394,396,565,0
2020,10,27,7,385,393,571,0
2020,10,27,8,385,388,572,0
2020,10,27,9,394,394,582,0
2020,10,27,10,430,423,605,0
2020,10,27,11,485,467,610,143
2020,10,27,12,525,516,613,97
2020,10,27,13,536,528,612,84
2020,10,27,14,537,537,614,77
2020,10,27,15,526,538,613,75
2020,10,27,16,525,538,611,73
2020,10,27,17,532,543,598,55
2020,10,27,18,542,547,595,48
2020,10,27,19,536,557,591,34
2020,10,27,20,538,564,589,25
2020,10,27,21,545,578,587,9
2020,10,27,22,553,587,588,1
2020,10,27,23,571,598,593,-5
2020,10,28,0,580,605,591,-14
2020,10,28,1,556,577,591,14
2020,10,28,2,528,541,591,50
2020,10,28,3,489,498,572,74
2020,10,28,4,441,450,474,24
2020,10,28,5,413,421,456,35
2020,10,28,6,394,401,453,52
2020,10,28,7,386,394,456,62
2020,10,28,8,385,387,474,87
2020,10,28,9,394,389,522,133
2020,10,28,10,430,414,547,133
2020,10,28,11,488,469,561,92
2020,10,28,12,526,511,558,47
2020,10,28,13,536,533,558,25
2020,10,28,14,536,556,560,4
2020,10,28,15,536,568,559,-9
2020,10,28,16,529,570,560,-10
2020,10,28,17,530,574,566,-8
2020,10,28,18,532,567,564,-3
2020,10,28,19,522,560,576,16
2020,10,28,20,524,555,596,41
2020,10,28,21,535,558,596,38
2020,10,28,22,548,571,599,28
2020,10,28,23,575,590,597,7
2020,10,29,0,582,591,596,5
2020,10,29,1,556,571,597,26
2020,10,29,2,535,535,597,62
2020,10,29,3,494,498,595,97
2020,10,29,4,448,458,596,138
2020,10,29,5,415,426,586,0
2020,10,29,6,393,406,588,0
2020,10,29,7,384,397,577,0
2020,10,29,8,383,394,574,0
2020,10,29,9,388,399,584,0
2020,10,29,10,421,421,591,0
2020,10,29,11,479,461,588,127
2020,10,29,12,514,499,588,89
2020,10,29,13,525,521,585,64
2020,10,29,14,536,532,583,51
2020,10,29,15,540,554,580,26
2020,10,29,16,544,570,526,-44
2020,10,29,17,547,584,566,-18
2020,10,29,18,555,590,568,-22
2020,10,29,19,548,605,570,-35
2020,10,29,20,548,607,546,-61
2020,10,29,21,550,627,519,-108
2020,10,29,22,554,662,641,-21
2020,10,29,23,566,571,633,62
2020,10,30,0,578,599,654,55
2020,10,30,1,556,591,619,28
2020,10,30,2,525,557,587,30
2020,10,30,3,490,518,593,75
2020,10,30,4,442,459,578,119
2020,10,30,5,415,417,334,-83
2020,10,30,6,392,393,320,-73
2020,10,30,7,380,388,312,-76
2020,10,30,8,378,382,312,-70
2020,10,30,9,388,391,310,-81
2020,10,30,10,420,418,311,-107
2020,10,30,11,473,467,319,-148
2020,10,30,12,516,515,326,-189
2020,10,30,13,530,547,329,-218
2020,10,30,14,543,563,320,-243
2020,10,30,15,550,570,330,-240
2020,10,30,16,553,563,280,-283
2020,10,30,17,540,550,270,-280
2020,10,30,18,536,534,271,-263
2020,10,30,19,516,527,269,-258
2020,10,30,20,513,520,272,-248
2020,10,30,21,521,527,322,-205
2020,10,30,22,543,540,329,-211
2020,10,30,23,564,572,331,-241
2020,10,31,0,563,591,328,-263
2020,10,31,1,545,585,330,-255
2020,10,31,2,536,575,332,-243
2020,10,31,3,527,535,327,-208
2020,10,31,4,502,514,324,-190
2020,10,31,5,489,490,303,-187
2020,10,31,6,457,483,311,-172
2020,10,31,7,461,485,301,-184
2020,10,31,8,473,489,330,-159
2020,10,31,9,479,511,333,-178
2020,10,31,10,499,533,329,-204
2020,10,31,11,527,570,350,-220
2020,10,31,12,578,613,367,-246
2020,10,31,13,612,650,367,-283
2020,10,31,14,632,652,363,-289
2020,10,31,15,624,641,338,-303
2020,10,31,16,588,617,333,-284
2020,10,31,17,544,580,335,-245
2020,10,31,18,517,542,328,-214
2020,10,31,19,504,515,328,-187
2020,10,31,20,503,509,323,-186
2020,10,31,21,507,510,317,-193
2020,10,31,22,525,524,342,-182
2020,10,31,23,544,543,345,-198
2020,11,1,0,550,563,344,-219
2020,11,1,1,537,555,354,-201
2020,11,1,2,518,540,352,-188
2020,11,1,3,510,523,341,-182
2020,11,1,4,473,491,335,-156
2020,11,1,5,472,466,298,-168
2020,11,1,6,457,451,279,-172
2020,11,1,7,450,432,268,-164
2020,11,1,8,471,436,269,-167
2020,11,1,9,478,432,270,-162
2020,11,1,10,494,438,284,-154
2020,11,1,11,539,450,289,-161
2020,11,1,12,581,476,290,-186
2020,11,1,13,613,507,290,-217
2020,11,1,14,613,536,320,-216
2020,11,1,15,577,543,350,-193
2020,11,1,16,536,516,342,-174
2020,11,1,17,514,496,344,-152
2020,11,1,18,513,490,339,-151
2020,11,1,19,485,482,327,-155
2020,11,1,20,501,474,318,-156
2020,11,1,21,523,481,326,-155
2020,11,1,22,549,499,339,-160
2020,11,1,23,577,535,348,-187
2020,11,2,0,582,560,348,-212
2020,11,2,1,567,565,355,-210
2020,11,2,2,540,556,357,-199
2020,11,2,3,519,542,358,-184
2020,11,2,4,505,530,342,-188
2020,11,2,5,-9999,515,324,-191
2020,11,2,6,492,511,274,-237
2020,11,2,7,494,517,280,-237
2020,11,2,8,503,536,303,-233
2020,11,2,9,515,549,342,-207
2020,11,2,10,544,581,365,-216
2020,11,2,11,594,624,420,-204
2020,11,2,12,664,702,430,-272
2020,11,2,13,704,746,430,-316
2020,11,2,14,719,744,481,-263
2020,11,2,15,696,715,538,-177
2020,11,2,16,663,684,525,-159
2020,11,2,17,617,654,517,-137
2020,11,2,18,598,628,545,-83
2020,11,2,19,574,610,573,-37
2020,11,2,20,576,597,565,-32
2020,11,2,21,576,598,596,-2
2020,11,2,22,592,621,600,-21
2020,11,2,23,620,678,606,-72
2020,11,3,0,679,722,607,-115
2020,11,3,1,702,719,626,-93
2020,11,3,2,671,705,630,-75
2020,11,3,3,652,678,629,-49
2020,11,3,4,619,651,630,-21
2020,11,3,5,604,622,631,9
2020,11,3,6,587,603,628,25
2020,11,3,7,587,601,629,28
2020,11,3,8,597,609,633,24
2020,11,3,9,608,612,630,18
2020,11,3,10,639,640,631,-9
2020,11,3,11,669,679,629,-50
2020,11,3,12,732,741,629,-112
2020,11,3,13,775,779,630,-149
2020,11,3,14,769,753,570,-183
2020,11,3,15,752,699,417,-282
2020,11,3,16,685,654,355,-299
2020,11,3,17,619,610,334,-276
2020,11,3,18,576,579,329,-250
2020,11,3,19,561,559,328,-231
2020,11,3,20,548,541,331,-210
2020,11,3,21,542,543,334,-209
2020,11,3,22,577,552,341,-211
2020,11,3,23,592,598,344,-254
2020,11,4,0,638,636,344,-292
2020,11,4,1,645,628,343,-285
2020,11,4,2,616,616,357,-259
2020,11,4,3,594,595,356,-239
2020,11,4,4,563,570,359,-211
2020,11,4,5,522,546,350,-196
2020,11,4,6,505,531,339,-192
2020,11,4,7,498,531,343,-188
2020,11,4,8,502,539,344,-195
2020,11,4,9,509,550,344,-206
2020,11,4,10,529,579,355,-224
2020,11,4,11,567,623,388,-235
2020,11,4,12,634,691,508,-183
2020,11,4,13,664,732,520,-212
2020,11,4,14,656,711,481,-230
2020,11,4,15,628,657,427,-230
2020,11,4,16,590,604,343,-261
2020,11,4,17,557,567,347,-220
2020,11,4,18,541,535,344,-191
2020,11,4,19,530,528,347,-181
2020,11,4,20,521,518,343,-175
2020,11,4,21,519,525,346,-179
2020,11,4,22,533,538,293,-245
2020,11,4,23,570,576,316,-260
2020,11,5,0,599,602,336,-266
2020,11,5,1,594,592,348,-244
2020,11,5,2,578,577,352,-225
2020,11,5,3,553,562,353,-209
2020,11,5,4,515,524,348,-176
2020,11,5,5,479,502,342,-160
2020,11,5,6,462,488,334,-154
2020,11,5,7,459,493,329,-164
2020,11,5,8,464,499,337,-162
2020,11,5,9,471,514,341,-173
2020,11,5,10,505,535,345,-190
2020,11,5,11,561,583,352,-231
2020,11,5,12,614,659,414,-245
2020,11,5,13,639,703,477,-226
2020,11,5,14,617,688,469,-219
2020,11,5,15,582,637,407,-230
2020,11,5,16,560,598,402,-196
2020,11,5,17,545,570,339,-231
2020,11,5,18,530,547,323,-224
2020,11,5,19,524,533,334,-199
2020,11,5,20,514,524,342,-182
2020,11,5,21,516,524,340,-184
2020,11,5,22,528,535,343,-192
2020,11,5,23,554,566,343,-223
2020,11,6,0,581,600,346,-254
2020,11,6,1,578,593,349,-244
2020,11,6,2,557,577,347,-230
2020,11,6,3,531,557,347,-210
2020,11,6,4,494,524,345,-179
2020,11,6,5,454,498,332,-166
2020,11,6,6,444,479,318,-161
2020,11,6,7,440,469,317,-152
2020,11,6,8,442,473,314,-159
2020,11,6,9,450,481,316,-165
2020,11,6,10,479,499,326,-173
2020,11,6,11,528,532,342,-190
2020,11,6,12,588,595,349,-246
2020,11,6,13,618,638,349,-289
2020,11,6,14,606,635,350,-285
2020,11,6,15,577,602,352,-250
2020,11,6,16,554,568,347,-221
2020,11,6,17,534,549,346,-203
2020,11,6,18,521,527,342,-185
2020,11,6,19,513,519,340,-179
2020,11,6,20,505,516,339,-177
2020,11,6,21,504,513,336,-177
2020,11,6,22,516,525,337,-188
2020,11,6,23,536,550,339,-211
2020,11,7,0,552,573,343,-230
2020,11,7,1,540,558,345,-213
2020,11,7,2,524,544,348,-196
2020,11,7,3,505,521,349,-172
2020,11,7,4,471,497,350,-147
2020,11,7,5,447,467,348,-119
2020,11,7,6,433,441,342,-99
2020,11,7,7,425,436,315,-121
2020,11,7,8,424,434,311,-123
2020,11,7,9,431,440,299,-141
2020,11,7,10,445,449,304,-145
2020,11,7,11,462,471,321,-150
2020,11,7,12,501,491,330,-161
2020,11,7,13,525,527,336,-191
2020,11,7,14,548,546,336,-210
2020,11,7,15,540,541,321,-220
2020,11,7,16,520,527,316,-211
2020,11,7,17,500,518,320,-198
2020,11,7,18,483,505,335,-170
2020,11,7,19,474,501,341,-160
2020,11,7,20,474,491,340,-151
2020,11,7,21,486,488,339,-149
2020,11,7,22,507,494,339,-155
2020,11,7,23,526,527,338,-189
2020,11,8,0,535,544,338,-206
2020,11,8,1,526,536,339,-197
2020,11,8,2,510,517,337,-180
2020,11,8,3,494,501,341,-160
2020,11,8,4,459,473,338,-135
2020,11,8,5,420,446,339,-107
2020,11,8,6,397,422,336,-86
2020,11,8,7,393,404,338,-66
2020,11,8,8,386,401,338,-63
2020,11,8,9,389,396,340,-56
2020,11,8,10,396,395,337,-58
2020,11,8,11,414,412,340,-72
2020,11,8,12,437,431,338,-93
2020,11,8,13,469,467,339,-128
2020,11,8,14,512,499,338,-161
2020,11,8,15,516,512,322,-190
2020,11,8,16,505,505,315,-190
2020,11,8,17,489,500,332,-168
2020,11,8,18,481,501,336,-165
2020,11,8,19,476,489,337,-152
2020,11,8,20,474,488,339,-149
2020,11,8,21,483,487,335,-152
2020,11,8,22,497,500,338,-162
2020,11,8,23,539,534,338,-196
2020,11,9,0,561,555,337,-218
2020,11,9,1,543,544,338,-206
2020,11,9,2,523,522,337,-185
2020,11,9,3,494,493,337,-156
2020,11,9,4,456,459,339,-120
2020,11,9,5,430,428,338,-90
2020,11,9,6,404,399,308,-91
2020,11,9,7,395,390,295,-95
2020,11,9,8,391,386,280,-106
2020,11,9,9,392,385,266,-119
2020,11,9,10,412,395,288,-107
2020,11,9,11,448,418,293,-125
2020,11,9,12,511,468,307,-161
2020,11,9,13,541,500,309,-191
2020,11,9,14,548,524,307,-217
2020,11,9,15,546,529,308,-221
2020,11,9,16,531,530,310,-220
2020,11,9,17,532,526,310,-216
2020,11,9,18,523,529,308,-221
2020,11,9,19,522,527,308,-219
2020,11,9,20,516,525,311,-214
2020,11,9,21,522,520,337,-183
2020,11,9,22,542,532,335,-197
2020,11,9,23,571,555,335,-220
2020,11,10,0,583,583,337,-246
2020,11,10,1,569,565,334,-231
2020,11,10,2,546,540,335,-205
2020,11,10,3,513,512,335,-177
2020,11,10,4,474,466,332,-134
2020,11,10,5,437,428,299,-129
2020,11,10,6,418,394,300,-94
2020,11,10,7,408,381,304,-77
2020,11,10,8,400,375,306,-69
2020,11,10,9,401,374,304,-70
2020,11,10,10,411,382,306,-76
2020,11,10,11,447,405,307,-98
2020,11,10,12,509,458,310,-148
2020,11,10,13,537,494,314,-180
2020,11,10,14,548,510,311,-199
2020,11,10,15,541,516,310,-206
2020,11,10,16,533,522,309,-213
2020,11,10,17,537,527,308,-219
2020,11,10,18,529,533,309,-224
2020,11,10,19,526,534,304,-230
2020,11,10,20,520,537,308,-229
2020,11,10,21,531,535,330,-205
2020,11,10,22,552,541,337,-204
2020,11,10,23,580,566,334,-232
2020,11,11,0,588,589,336,-253
2020,11,11,1,573,575,337,-238
2020,11,11,2,553,544,335,-209
2020,11,11,3,522,514,335,-179
2020,11,11,4,482,474,335,-139
2020,11,11,5,445,441,335,-106
2020,11,11,6,410,413,308,-105
2020,11,11,7,397,399,306,-93
2020,11,11,8,390,387,303,-84
2020,11,11,9,384,385,305,-80
2020,11,11,10,391,388,306,-82
2020,11,11,11,424,407,305,-102
2020,11,11,12,489,448,305,-143
2020,11,11,13,518,488,305,-183
2020,11,11,14,535,519,304,-215
2020,11,11,15,539,536,302,-234
2020,11,11,16,545,550,302,-248
2020,11,11,17,554,562,305,-257
2020,11,11,18,562,557,330,-227
2020,11,11,19,568,568,328,-240
2020,11,11,20,569,570,324,-246
2020,11,11,21,577,563,341,-222
2020,11,11,22,604,570,348,-222
2020,11,11,23,615,595,372,-223
2020,11,12,0,621,610,403,-207
2020,11,12,1,608,591,550,-41
2020,11,12,2,578,567,591,24
2020,11,12,3,543,537,593,56
2020,11,12,4,495,497,597,100
2020,11,12,5,447,454,594,140
2020,11,12,6,412,422,572,150
2020,11,12,7,397,405,555,150
2020,11,12,8,390,394,568,0
2020,11,12,9,384,391,594,0
2020,11,12,10,389,394,595,0
2020,11,12,11,419,415,566,0
2020,11,12,12,479,467,597,130
2020,11,12,13,512,503,596,93
2020,11,12,14,528,524,598,74
2020,11,12,15,530,535,596,61
2020,11,12,16,536,543,598,55
2020,11,12,17,542,545,596,51
2020,11,12,18,537,540,597,57
2020,11,12,19,531,551,595,44
2020,11,12,20,523,547,593,46
2020,11,12,21,526,551,596,45
2020,11,12,22,543,557,595,38
2020,11,12,23,565,577,598,21
2020,11,13,0,570,597,598,1
2020,11,13,1,550,578,599,21
2020,11,13,2,538,548,599,51
2020,11,13,3,514,516,598,82
2020,11,13,4,472,483,601,118
2020,11,13,5,437,443,585,142
2020,11,13,6,415,409,587,0
2020,11,13,7,402,398,577,0
2020,11,13,8,395,392,556,0
2020,11,13,9,390,384,526,142
2020,11,13,10,399,395,544,149
2020,11,13,11,428,420,594,0
2020,11,13,12,492,467,597,130
2020,11,13,13,527,500,596,96
2020,11,13,14,540,520,599,79
2020,11,13,15,540,516,597,81
2020,11,13,16,532,523,599,76
2020,11,13,17,518,522,599,77
2020,11,13,18,510,523,599,76
2020,11,13,19,505,519,599,80
2020,11,13,20,496,518,600,82
2020,11,13,21,498,517,639,122
2020,11,13,22,508,521,621,100
2020,11,13,23,531,549,597,48
2020,11,14,0,540,567,597,30
2020,11,14,1,547,555,597,42
2020,11,14,2,540,544,600,56
2020,11,14,3,529,523,597,74
2020,11,14,4,509,499,598,99
2020,11,14,5,488,472,563,91
2020,11,14,6,450,445,338,-107
2020,11,14,7,444,444,323,-121
2020,11,14,8,443,441,333,-108
2020,11,14,9,455,443,336,-107
2020,11,14,10,464,462,337,-125
2020,11,14,11,488,486,337,-149
2020,11,14,12,528,520,336,-184
2020,11,14,13,584,568,337,-231
2020,11,14,14,596,592,338,-254
2020,11,14,15,583,572,337,-235
2020,11,14,16,552,554,338,-216
2020,11,14,17,513,530,339,-191
2020,11,14,18,496,510,338,-172
2020,11,14,19,485,493,337,-156
2020,11,14,20,490,490,338,-152
2020,11,14,21,492,497,339,-158
2020,11,14,22,509,505,337,-168
2020,11,14,23,547,540,335,-205
2020,11,15,0,548,559,336,-223
2020,11,15,1,543,551,337,-214
2020,11,15,2,534,538,338,-200
2020,11,15,3,518,518,336,-182
2020,11,15,4,488,492,337,-155
2020,11,15,5,446,457,311,-146
2020,11,15,6,423,442,321,-121
2020,11,15,7,416,422,339,-83
2020,11,15,8,412,416,339,-77
2020,11,15,9,412,417,338,-79
2020,11,15,10,414,423,336,-87
2020,11,15,11,424,437,340,-97
2020,11,15,12,451,455,342,-113
2020,11,15,13,480,481,338,-143
2020,11,15,14,529,510,346,-164
2020,11,15,15,532,515,345,-170
2020,11,15,16,513,502,346,-156
2020,11,15,17,489,491,344,-147
2020,11,15,18,482,496,342,-154
2020,11,15,19,473,491,399,-92
2020,11,15,20,468,492,401,-91
2020,11,15,21,475,492,342,-150
2020,11,15,22,491,504,341,-163
2020,11,15,23,539,542,363,-179
2020,11,16,0,567,567,362,-205
2020,11,16,1,554,558,405,-153
2020,11,16,2,539,550,430,-120
2020,11,16,3,516,521,535,14
2020,11,16,4,483,504,606,102
2020,11,16,5,464,476,604,128
2020,11,16,6,476,460,602,142
2020,11,16,7,480,460,602,142
2020,11,16,8,484,464,586,122
2020,11,16,9,489,477,603,126
2020,11,16,10,517,497,603,106
2020,11,16,11,557,547,619,72
2020,11,16,12,634,616,625,9
2020,11,16,13,668,664,624,-40
2020,11,16,14,656,666,576,-90
2020,11,16,15,631,641,621,-20
2020,11,16,16,595,612,567,-45
2020,11,16,17,570,589,575,-14
2020,11,16,18,557,570,562,-8
2020,11,16,19,541,557,541,-16
2020,11,16,20,527,548,541,-7
2020,11,16,21,531,552,546,-6
2020,11,16,22,551,578,561,-17
2020,11,16,23,599,638,610,-28
2020,11,17,0,628,679,626,-53
2020,11,17,1,635,675,626,-49
2020,11,17,2,620,661,625,-36
2020,11,17,3,601,649,627,-22
2020,11,17,4,564,613,626,13
2020,11,17,5,539,593,625,32
2020,11,17,6,526,569,616,47
2020,11,17,7,520,581,624,43
2020,11,17,8,527,588,626,38
2020,11,17,9,537,594,626,32
2020,11,17,10,564,609,594,-15
2020,11,17,11,604,643,552,-91
2020,11,17,12,680,697,624,-73
2020,11,17,13,717,725,626,-99
2020,11,17,14,713,704,572,-132
2020,11,17,15,668,662,560,-102
2020,11,17,16,636,634,539,-95
2020,11,17,17,606,610,533,-77
2020,11,17,18,582,592,552,-40
2020,11,17,19,561,577,548,-29
2020,11,17,20,543,572,552,-20
2020,11,17,21,545,577,561,-16
2020,11,17,22,570,609,561,-48
2020,11,17,23,627,678,590,-88
2020,11,18,0,660,711,591,-120
2020,11,18,1,660,711,590,-121
2020,11,18,2,662,695,589,-106
2020,11,18,3,648,665,622,-43
2020,11,18,4,624,632,626,-6
2020,11,18,5,585,610,626,16
2020,11,18,6,578,586,624,38
2020,11,18,7,574,582,623,41
2020,11,18,8,589,589,624,35
2020,11,18,9,605,607,625,18
2020,11,18,10,634,629,624,-5
2020,11,18,11,673,678,623,-55
2020,11,18,12,746,753,623,-130
2020,11,18,13,780,797,624,-173
2020,11,18,14,772,788,522,-266
2020,11,18,15,729,732,544,-188
2020,11,18,16,681,693,561,-132
2020,11,18,17,630,659,562,-97
2020,11,18,18,605,621,560,-61
2020,11,18,19,582,597,437,-160
2020,11,18,20,559,579,404,-175
2020,11,18,21,559,576,413,-163
2020,11,18,22,582,601,429,-172
2020,11,18,23,649,653,467,-186
2020,11,19,0,687,694,498,-196
2020,11,19,1,685,694,524,-170
2020,11,19,2,694,685,525,-160
2020,11,19,3,679,667,530,-137
2020,11,19,4,651,640,532,-108
2020,11,19,5,618,610,524,-86
2020,11,19,6,606,594,480,-114
2020,11,19,7,600,596,474,-122
2020,11,19,8,617,604,465,-139
2020,11,19,9,631,608,475,-133
2020,11,19,10,657,636,520,-116
2020,11,19,11,693,680,596,-84
2020,11,19,12,764,746,615,-131
2020,11,19,13,796,789,580,-209
2020,11,19,14,781,774,518,-256
2020,11,19,15,726,715,472,-243
2020,11,19,16,679,663,441,-222
2020,11,19,17,631,618,433,-185
2020,11,19,18,598,585,388,-197
2020,11,19,19,576,563,398,-165
2020,11,19,20,554,549,422,-127
2020,11,19,21,554,548,451,-97
2020,11,19,22,575,566,490,-76
2020,11,19,23,625,620,513,-107
2020,11,20,0,651,651,524,-127
2020,11,20,1,646,652,526,-126
2020,11,20,2,648,641,522,-119
2020,11,20,3,623,620,515,-105
2020,11,20,4,595,594,502,-92
2020,11,20,5,562,566,482,-84
2020,11,20,6,529,555,492,-63
2020,11,20,7,521,553,452,-101
2020,11,20,8,521,561,462,-99
2020,11,20,9,535,578,471,-107
2020,11,20,10,553,598,474,-124
2020,11,20,11,595,645,528,-117
2020,11,20,12,666,711,528,-183
2020,11,20,13,709,756,526,-230
2020,11,20,14,688,749,516,-233
2020,11,20,15,642,691,352,-339
2020,11,20,16,603,640,354,-286
2020,11,20,17,570,593,339,-254
2020,11,20,18,542,558,345,-213
2020,11,20,19,525,540,349,-191
2020,11,20,20,512,532,346,-186
2020,11,20,21,513,529,346,-183
2020,11,20,22,527,540,344,-196
2020,11,20,23,558,577,348,-229
2020,11,21,0,580,596,348,-248
2020,11,21,1,566,592,350,-242
2020,11,21,2,561,585,310,-275
2020,11,21,3,548,571,290,-281
2020,11,21,4,516,550,290,-260
2020,11,21,5,478,522,290,-232
2020,11,21,6,472,503,280,-223
2020,11,21,7,457,503,278,-225
2020,11,21,8,447,507,288,-219
2020,11,21,9,447,515,288,-227
2020,11,21,10,452,530,290,-240
2020,11,21,11,469,560,291,-269
2020,11,21,12,497,597,289,-308
2020,11,21,13,525,638,348,-290
2020,11,21,14,563,656,352,-304
2020,11,21,15,585,622,353,-269
2020,11,21,16,597,578,339,-239
2020,11,21,17,595,549,311,-238
2020,11,21,18,589,527,304,-223
2020,11,21,19,583,503,311,-192
2020,11,21,20,569,495,330,-165
2020,11,21,21,569,496,341,-155
2020,11,21,22,581,511,344,-167
2020,11,21,23,595,551,344,-207
2020,11,22,0,600,573,347,-226
2020,11,22,1,588,567,354,-213
2020,11,22,2,569,553,333,-220
2020,11,22,3,561,542,337,-205
2020,11,22,4,528,517,309,-208
2020,11,22,5,490,490,283,-207
2020,11,22,6,465,468,269,-199
2020,11,22,7,453,464,272,-192
2020,11,22,8,456,465,290,-175
2020,11,22,9,450,464,289,-175
2020,11,22,10,454,475,289,-186
2020,11,22,11,471,494,288,-206
2020,11,22,12,498,519,290,-229
2020,11,22,13,519,556,292,-264
2020,11,22,14,557,583,289,-294
2020,11,22,15,576,582,285,-297
2020,11,22,16,553,560,220,-340
2020,11,22,17,545,538,266,-272
2020,11,22,18,527,524,270,-254
2020,11,22,19,512,500,277,-223
2020,11,22,20,510,490,333,-157
2020,11,22,21,509,494,343,-151
2020,11,22,22,523,511,346,-165
2020,11,22,23,565,558,343,-215
2020,11,23,0,579,575,345,-230
2020,11,23,1,576,566,345,-221
2020,11,23,2,566,546,347,-199
2020,11,23,3,544,517,346,-171
2020,11,23,4,514,491,335,-156
2020,11,23,5,503,463,333,-130
2020,11,23,6,472,438,297,-141
2020,11,23,7,458,431,302,-129
2020,11,23,8,462,427,304,-123
2020,11,23,9,466,440,289,-151
2020,11,23,10,485,463,382,-81
2020,11,23,11,526,509,473,-36
2020,11,23,12,598,577,508,-69
2020,11,23,13,648,637,536,-101
2020,11,23,14,653,661,596,-65
2020,11,23,15,648,649,555,-94
2020,11,23,16,624,628,542,-86
2020,11,23,17,598,608,552,-56
2020,11,23,18,571,594,546,-48
2020,11,23,19,561,576,546,-30
2020,11,23,20,554,563,554,-9
2020,11,23,21,558,573,562,-11
2020,11,23,22,578,596,586,-10
2020,11,23,23,640,662,605,-57
2020,11,24,0,674,699,604,-95
2020,11,24,1,664,700,605,-95
2020,11,24,2,648,695,606,-89
2020,11,24,3,632,674,605,-69
2020,11,24,4,600,647,605,-42
2020,11,24,5,585,619,604,-15
2020,11,24,6,562,604,575,-29
2020,11,24,7,552,609,570,-39
2020,11,24,8,551,624,575,-49
2020,11,24,9,561,634,573,-61
2020,11,24,10,591,660,573,-87
2020,11,24,11,630,703,576,-127
2020,11,24,12,700,774,639,-135
2020,11,24,13,742,814,636,-178
2020,11,24,14,733,804,638,-166
2020,11,24,15,701,742,639,-103
2020,11,24,16,677,688,631,-57
2020,11,24,17,631,647,629,-18
2020,11,24,18,601,618,608,-10
2020,11,24,19,577,589,599,10
2020,11,24,20,558,582,625,43
2020,11,24,21,562,584,633,49
2020,11,24,22,587,604,628,24
2020,11,24,23,651,665,577,-88
2020,11,25,0,688,695,574,-121
2020,11,25,1,682,694,575,-119
2020,11,25,2,658,683,576,-107
2020,11,25,3,627,653,574,-79
2020,11,25,4,603,621,576,-45
2020,11,25,5,561,583,575,-8
2020,11,25,6,578,554,573,19
2020,11,25,7,570,540,575,35
2020,11,25,8,571,532,573,41
2020,11,25,9,580,533,575,42
2020,11,25,10,587,544,575,31
2020,11,25,11,626,566,578,12
2020,11,25,12,690,604,634,30
2020,11,25,13,724,641,620,-21
2020,11,25,14,701,656,633,-23
2020,11,25,15,680,654,633,-21
2020,11,25,16,659,645,630,-15
2020,11,25,17,635,624,615,-9
2020,11,25,18,609,601,591,-10
2020,11,25,19,596,592,584,-8
2020,11,25,20,589,583,572,-11
2020,11,25,21,595,575,567,-8
2020,11,25,22,629,591,579,-12
2020,11,25,23,674,623,568,-55
2020,11,26,0,682,630,565,-65
2020,11,26,1,655,610,562,-48
2020,11,26,2,633,587,562,-25
2020,11,26,3,602,554,544,-10
2020,11,26,4,562,514,326,-188
2020,11,26,5,534,465,262,-203
2020,11,26,6,482,433,208,-225
2020,11,26,7,479,408,162,-246
2020,11,26,8,482,404,167,-237
2020,11,26,9,488,391,166,-225
2020,11,26,10,497,396,166,-230
2020,11,26,11,512,413,173,-240
2020,11,26,12,540,438,226,-212
2020,11,26,13,566,472,227,-245
2020,11,26,14,586,512,227,-285
2020,11,26,15,584,543,231,-312
2020,11,26,16,575,559,264,-295
2020,11,26,17,564,560,347,-213
2020,11,26,18,539,543,347,-196
2020,11,26,19,513,518,342,-176
2020,11,26,20,495,503,341,-162
2020,11,26,21,491,494,338,-156
2020,11,26,22,489,489,336,-153
2020,11,26,23,506,498,342,-156
2020,11,27,0,518,504,343,-161
2020,11,27,1,524,495,329,-166
2020,11,27,2,526,491,313,-178
2020,11,27,3,519,480,294,-186
2020,11,27,4,508,465,267,-198
2020,11,27,5,495,439,263,-176
2020,11,27,6,408,432,237,-195
2020,11,27,7,402,429,232,-197
2020,11,27,8,403,437,236,-201
2020,11,27,9,408,449,232,-217
2020,11,27,10,418,468,234,-234
2020,11,27,11,432,497,264,-233
2020,11,27,12,445,543,299,-244
2020,11,27,13,492,587,337,-250
2020,11,27,14,528,608,344,-264
2020,11,27,15,530,590,345,-245
2020,11,27,16,519,556,313,-243
2020,11,27,17,502,523,272,-251
2020,11,27,18,488,506,272,-234
2020,11,27,19,473,483,267,-216
2020,11,27,20,468,475,272,-203
2020,11,27,21,460,475,270,-205
2020,11,27,22,475,490,273,-217
2020,11,27,23,520,540,339,-201
2020,11,28,0,536,559,346,-213
2020,11,28,1,529,555,293,-262
2020,11,28,2,516,542,282,-260
2020,11,28,3,498,520,279,-241
2020,11,28,4,480,494,267,-227
2020,11,28,5,443,464,258,-206
2020,11,28,6,443,441,260,-181
2020,11,28,7,427,425,251,-174
2020,11,28,8,424,423,208,-215
2020,11,28,9,423,419,205,-214
2020,11,28,10,429,432,212,-220
2020,11,28,11,446,444,254,-190
2020,11,28,12,469,470,265,-205
2020,11,28,13,508,511,235,-276
2020,11,28,14,539,541,238,-303
2020,11,28,15,558,536,237,-299
2020,11,28,16,554,517,237,-280
2020,11,28,17,540,504,211,-293
2020,11,28,18,527,487,199,-288
2020,11,28,19,510,482,199,-283
2020,11,28,20,494,476,200,-276
2020,11,28,21,497,477,198,-279
2020,11,28,22,526,497,198,-299
2020,11,28,23,541,542,197,-345
2020,11,29,0,558,570,231,-339
2020,11,29,1,556,565,318,-247
2020,11,29,2,551,560,320,-240
2020,11,29,3,515,550,320,-230
2020,11,29,4,500,532,322,-210
2020,11,29,5,485,509,309,-200
2020,11,29,6,481,494,287,-207
2020,11,29,7,475,498,287,-211
2020,11,29,8,467,501,286,-215
2020,11,29,9,466,512,288,-224
2020,11,29,10,481,527,288,-239
2020,11,29,11,490,554,288,-266
2020,11,29,12,518,581,317,-264
2020,11,29,13,564,623,321,-302
2020,11,29,14,594,655,320,-335
2020,11,29,15,589,657,328,-329
2020,11,29,16,566,633,355,-278
2020,11,29,17,560,596,353,-243
2020,11,29,18,550,589,346,-243
2020,11,29,19,527,573,350,-223
2020,11,29,20,524,560,346,-214
2020,11,29,21,533,564,348,-216
2020,11,29,22,555,582,347,-235
2020,11,29,23,600,619,348,-271
2020,11,30,0,625,624,346,-278
2020,11,30,1,609,610,350,-260
2020,11,30,2,593,590,349,-241
2020,11,30,3,566,560,348,-212
2020,11,30,4,530,526,347,-179
2020,11,30,5,490,495,333,-162
2020,11,30,6,490,469,316,-153
2020,11,30,7,482,460,316,-144
2020,11,30,8,480,457,318,-139
2020,11,30,9,482,461,319,-142
2020,11,30,10,490,469,317,-152
2020,11,30,11,523,502,316,-186
2020,11,30,12,576,561,317,-244
2020,11,30,13,616,605,321,-284
2020,11,30,14,627,628,349,-279
2020,11,30,15,624,634,350,-284
2020,11,30,16,630,638,372,-266
2020,11,30,17,631,636,419,-217
2020,11,30,18,632,642,422,-220
2020,11,30,19,621,648,423,-225
2020,11,30,20,625,653,419,-234
2020,11,30,21,626,669,420,-249
2020,11,30,22,639,698,448,-250
2020,11,30,23,702,755,493,-262
2020,12,1,0,727,786,494,-292
2020,12,1,1,718,781,512,-269
2020,12,1,2,705,766,488,-278
2020,12,1,3,686,742,399,-343
2020,12,1,4,662,703,423,-280
2020,12,1,5,642,674,431,-243
2020,12,1,6,636,651,431,-220
2020,12,1,7,631,650,442,-208
2020,12,1,8,632,666,449,-217
2020,12,1,9,641,681,492,-189
2020,12,1,10,676,703,510,-193
2020,12,1,11,710,737,453,-284
2020,12,1,12,780,795,450,-345
2020,12,1,13,827,845,492,-353
2020,12,1,14,835,863,459,-404
2020,12,1,15,810,854,438,-416
2020,12,1,16,772,847,430,-417
2020,12,1,17,749,838,424,-414
2020,12,1,18,706,818,420,-398
2020,12,1,19,694,786,426,-360
2020,12,1,20,682,765,476,-289
2020,12,1,21,691,763,486,-277
2020,12,1,22,740,795,492,-303
2020,12,1,23,812,859,581,-278
2020,12,2,0,839,897,621,-276
2020,12,2,1,849,889,691,-198
2020,12,2,2,844,864,616,-248
2020,12,2,3,809,841,594,-247
2020,12,2,4,770,803,546,-257
2020,12,2,5,729,778,552,-226
2020,12,2,6,752,754,546,-208
2020,12,2,7,750,751,549,-202
2020,12,2,8,758,742,542,-200
2020,12,2,9,771,760,548,-212
2020,12,2,10,798,777,546,-231
2020,12,2,11,854,822,572,-250
2020,12,2,12,920,884,606,-278
2020,12,2,13,950,929,630,-299
2020,12,2,14,926,920,543,-377
2020,12,2,15,874,860,538,-322
2020,12,2,16,806,801,439,-362
2020,12,2,17,734,756,401,-355
2020,12,2,18,677,711,393,-318
2020,12,2,19,658,678,389,-289
2020,12,2,20,637,661,391,-270
2020,12,2,21,637,660,401,-259
2020,12,2,22,670,690,404,-286
2020,12,2,23,734,760,474,-286
2020,12,3,0,775,803,455,-348
2020,12,3,1,784,812,407,-405
2020,12,3,2,779,797,407,-390
2020,12,3,3,763,781,405,-376
2020,12,3,4,727,748,409,-339
2020,12,3,5,691,718,408,-310
2020,12,3,6,683,716,386,-330
2020,12,3,7,682,714,372,-342
2020,12,3,8,687,727,374,-353
2020,12,3,9,702,748,378,-370
2020,12,3,10,731,766,390,-376
2020,12,3,11,796,821,468,-353
2020,12,3,12,888,887,538,-349
2020,12,3,13,930,928,568,-360
2020,12,3,14,884,916,536,-380
2020,12,3,15,821,848,488,-360
2020,12,3,16,746,771,435,-336
2020,12,3,17,698,702,433,-269
2020,12,3,18,634,647,432,-215
2020,12,3,19,614,613,430,-183
2020,12,3,20,596,591,428,-163
2020,12,3,21,595,584,431,-153
2020,12,3,22,623,603,371,-232
2020,12,3,23,692,665,391,-274
2020,12,4,0,734,698,455,-243
2020,12,4,1,738,700,470,-230
2020,12,4,2,734,675,396,-279
2020,12,4,3,704,648,385,-263
2020,12,4,4,658,606,372,-234
2020,12,4,5,605,576,366,-210
2020,12,4,6,579,550,315,-235
2020,12,4,7,566,540,293,-247
2020,12,4,8,559,534,293,-241
2020,12,4,9,565,537,294,-243
2020,12,4,10,585,549,300,-249
2020,12,4,11,625,586,370,-216
2020,12,4,12,707,635,438,-197
2020,12,4,13,744,677,457,-220
2020,12,4,14,721,686,430,-256
2020,12,4,15,698,675,425,-250
2020,12,4,16,663,658,421,-237
2020,12,4,17,632,630,378,-252
2020,12,4,18,608,614,347,-267
2020,12,4,19,595,606,349,-257
2020,12,4,20,579,613,349,-264
2020,12,4,21,579,617,350,-267
2020,12,4,22,594,646,422,-224
2020,12,4,23,632,675,480,-195
2020,12,5,0,645,664,478,-186
2020,12,5,1,640,649,360,-289
2020,12,5,2,632,640,361,-279
2020,12,5,3,610,618,311,-307
2020,12,5,4,582,588,294,-294
2020,12,5,5,555,562,340,-222
2020,12,5,6,537,546,353,-193
2020,12,5,7,518,546,356,-190
2020,12,5,8,512,547,355,-192
2020,12,5,9,516,561,358,-203
2020,12,5,10,515,577,356,-221
2020,12,5,11,548,603,356,-247
2020,12,5,12,586,638,467,-171
2020,12,5,13,631,677,524,-153
2020,12,5,14,663,711,525,-186
2020,12,5,15,682,711,512,-199
2020,12,5,16,670,690,500,-190
2020,12,5,17,638,660,495,-165
2020,12,5,18,617,633,490,-143
2020,12,5,19,595,602,482,-120
2020,12,5,20,582,588,482,-106
2020,12,5,21,580,586,498,-88
2020,12,5,22,605,612,517,-95
2020,12,5,23,655,678,533,-145
2020,12,6,0,685,712,539,-173
2020,12,6,1,697,718,534,-184
2020,12,6,2,690,711,527,-184
2020,12,6,3,674,704,532,-172
2020,12,6,4,653,690,529,-161
2020,12,6,5,632,659,517,-142
2020,12,6,6,608,640,505,-135
2020,12,6,7,598,637,520,-117
2020,12,6,8,608,643,533,-110
2020,12,6,9,607,651,527,-124
2020,12,6,10,621,668,542,-126
2020,12,6,11,631,703,545,-158
2020,12,6,12,672,730,536,-194
2020,12,6,13,720,774,542,-232
2020,12,6,14,751,801,530,-271
2020,12,6,15,728,768,528,-240
2020,12,6,16,672,705,501,-204
2020,12,6,17,632,649,485,-164
2020,12,6,18,606,613,476,-137
2020,12,6,19,577,574,472,-102
2020,12,6,20,566,560,473,-87
2020,12,6,21,576,554,486,-68
2020,12,6,22,609,596,514,-82
2020,12,6,23,661,656,520,-136
2020,12,7,0,681,683,522,-161
2020,12,7,1,684,678,519,-159
2020,12,7,2,670,671,526,-145
2020,12,7,3,643,637,520,-117
2020,12,7,4,603,599,519,-80
2020,12,7,5,572,563,514,-49
2020,12,7,6,550,545,499,-46
2020,12,7,7,543,543,492,-51
2020,12,7,8,548,542,494,-48
2020,12,7,9,561,543,493,-50
2020,12,7,10,581,563,500,-63
2020,12,7,11,614,598,513,-85
2020,12,7,12,684,662,515,-147
2020,12,7,13,727,711,538,-173
2020,12,7,14,749,728,536,-192
2020,12,7,15,743,731,537,-194
2020,12,7,16,741,725,536,-189
2020,12,7,17,715,730,537,-193
2020,12,7,18,696,740,538,-202
2020,12,7,19,696,743,546,-197
2020,12,7,20,673,737,545,-192
2020,12,7,21,684,747,546,-201
2020,12,7,22,718,779,549,-230
2020,12,7,23,774,842,551,-291
2020,12,8,0,805,865,553,-312
2020,12,8,1,806,856,551,-305
2020,12,8,2,795,834,554,-280
2020,12,8,3,782,803,554,-249
2020,12,8,4,749,766,555,-211
2020,12,8,5,701,725,555,-170
2020,12,8,6,680,708,554,-154
2020,12,8,7,681,701,555,-146
2020,12,8,8,684,707,556,-151
2020,12,8,9,701,717,557,-160
2020,12,8,10,718,734,556,-178
2020,12,8,11,757,780,556,-224
2020,12,8,12,822,841,568,-273
2020,12,8,13,859,894,719,-175
2020,12,8,14,864,896,680,-216
2020,12,8,15,822,868,627,-241
2020,12,8,16,773,828,540,-288
2020,12,8,17,715,790,496,-294
2020,12,8,18,675,758,494,-264
2020,12,8,19,648,734,497,-237
2020,12,8,20,631,712,487,-225
2020,12,8,21,636,724,489,-235
2020,12,8,22,666,760,555,-205
2020,12,8,23,726,836,555,-281
2020,12,9,0,760,877,556,-321
2020,12,9,1,774,868,557,-311
2020,12,9,2,770,854,558,-296
2020,12,9,3,750,830,558,-272
2020,12,9,4,720,795,558,-237
2020,12,9,5,682,753,506,-247
2020,12,9,6,711,726,496,-230
2020,12,9,7,701,723,496,-227
2020,12,9,8,710,733,498,-235
2020,12,9,9,714,734,544,-190
2020,12,9,10,737,763,743,-20
2020,12,9,11,776,800,708,-92
2020,12,9,12,846,854,687,-167
2020,12,9,13,880,899,702,-197
2020,12,9,14,854,903,676,-227
2020,12,9,15,809,841,639,-202
2020,12,9,16,737,803,556,-247
2020,12,9,17,670,744,549,-195
2020,12,9,18,630,691,544,-147
2020,12,9,19,610,656,539,-117
2020,12,9,20,594,628,534,-94
2020,12,9,21,594,618,532,-86
2020,12,9,22,612,642,532,-110
2020,12,9,23,669,694,534,-160
2020,12,10,0,700,726,535,-191
2020,12,10,1,707,726,538,-188
2020,12,10,2,707,717,542,-175
2020,12,10,3,685,694,543,-151
2020,12,10,4,648,652,525,-127
2020,12,10,5,605,616,482,-134
2020,12,10,6,585,595,480,-115
2020,12,10,7,571,592,480,-112
2020,12,10,8,575,595,483,-112
2020,12,10,9,585,602,482,-120
2020,12,10,10,600,626,489,-137
2020,12,10,11,642,665,546,-119
2020,12,10,12,718,729,551,-178
2020,12,10,13,747,776,554,-222
2020,12,10,14,740,781,533,-248
2020,12,10,15,707,740,525,-215
2020,12,10,16,663,686,516,-170
2020,12,10,17,621,644,505,-139
2020,12,10,18,596,601,479,-122
2020,12,10,19,583,573,344,-229
2020,12,10,20,572,559,342,-217
2020,12,10,21,569,553,341,-212
2020,12,10,22,584,568,343,-225
2020,12,10,23,635,624,431,-193
2020,12,11,0,662,654,430,-224
2020,12,11,1,665,654,429,-225
2020,12,11,2,660,644,432,-212
2020,12,11,3,642,622,431,-191
2020,12,11,4,600,592,429,-163
2020,12,11,5,561,562,397,-165
2020,12,11,6,542,534,287,-247
2020,12,11,7,535,540,294,-246
2020,12,11,8,538,548,296,-252
2020,12,11,9,550,569,297,-272
2020,12,11,10,569,596,301,-295
2020,12,11,11,616,645,406,-239
2020,12,11,12,692,717,458,-259
2020,12,11,13,735,766,474,-292
2020,12,11,14,737,770,443,-327
2020,12,11,15,701,725,431,-294
2020,12,11,16,665,668,432,-236
2020,12,11,17,622,622,432,-190
2020,12,11,18,588,582,364,-218
2020,12,11,19,573,554,345,-209
2020,12,11,20,559,544,344,-200
2020,12,11,21,556,547,345,-202
2020,12,11,22,572,555,344,-211
2020,12,11,23,616,608,346,-262
2020,12,12,0,634,630,349,-281
2020,12,12,1,636,627,349,-278
2020,12,12,2,625,618,341,-277
2020,12,12,3,602,596,289,-307
2020,12,12,4,565,565,288,-277
2020,12,12,5,556,530,289,-241
2020,12,12,6,515,499,286,-213
2020,12,12,7,498,492,289,-203
2020,12,12,8,492,486,289,-197
2020,12,12,9,498,480,289,-191
2020,12,12,10,507,495,290,-205
2020,12,12,11,527,517,296,-221
2020,12,12,12,562,542,351,-191
2020,12,12,13,612,576,350,-226
2020,12,12,14,642,606,353,-253
2020,12,12,15,651,615,351,-264
2020,12,12,16,638,599,349,-250
2020,12,12,17,613,579,348,-231
2020,12,12,18,592,559,346,-213
2020,12,12,19,571,542,342,-200
2020,12,12,20,558,532,344,-188
2020,12,12,21,547,527,341,-186
2020,12,12,22,564,552,344,-208
2020,12,12,23,602,592,343,-249
2020,12,13,0,613,602,345,-257
2020,12,13,1,607,587,347,-240
2020,12,13,2,598,571,302,-269
2020,12,13,3,577,547,284,-263
2020,12,13,4,554,516,283,-233
2020,12,13,5,522,479,285,-194
2020,12,13,6,505,441,261,-180
2020,12,13,7,486,433,203,-230
2020,12,13,8,479,428,204,-224
2020,12,13,9,474,426,203,-223
2020,12,13,10,482,437,202,-235
2020,12,13,11,495,459,204,-255
2020,12,13,12,533,490,214,-276
2020,12,13,13,567,528,338,-190
2020,12,13,14,616,572,352,-220
2020,12,13,15,628,572,339,-233
2020,12,13,16,594,555,329,-226
2020,12,13,17,562,535,329,-206
2020,12,13,18,540,520,331,-189
2020,12,13,19,531,504,331,-173
2020,12,13,20,520,498,335,-163
2020,12,13,21,526,500,341,-159
2020,12,13,22,557,519,341,-178
2020,12,13,23,610,571,344,-227
2020,12,14,0,640,598,346,-252
2020,12,14,1,638,594,346,-248
2020,12,14,2,628,580,318,-262
2020,12,14,3,611,552,285,-267
2020,12,14,4,582,521,281,-240
2020,12,14,5,550,486,244,-242
2020,12,14,6,470,457,258,-199
2020,12,14,7,464,449,261,-188
2020,12,14,8,468,450,268,-182
2020,12,14,9,481,445,262,-183
2020,12,14,10,502,462,273,-189
2020,12,14,11,531,501,360,-141
2020,12,14,12,604,565,505,-60
2020,12,14,13,660,624,537,-87
2020,12,14,14,676,643,535,-108
2020,12,14,15,676,663,528,-135
2020,12,14,16,668,663,524,-139
2020,12,14,17,648,658,524,-134
2020,12,14,18,638,664,501,-163
2020,12,14,19,630,667,467,-200
2020,12,14,20,619,678,469,-209
2020,12,14,21,626,684,512,-172
2020,12,14,22,651,705,509,-196
2020,12,14,23,731,762,534,-228
2020,12,15,0,777,786,524,-262
2020,12,15,1,778,779,517,-262
2020,12,15,2,767,760,517,-243
2020,12,15,3,748,731,506,-225
2020,12,15,4,712,700,506,-194
2020,12,15,5,681,670,502,-168
2020,12,15,6,672,654,501,-153
2020,12,15,7,663,651,504,-147
2020,12,15,8,683,661,510,-151
2020,12,15,9,693,678,518,-160
2020,12,15,10,730,705,523,-182
2020,12,15,11,766,771,542,-229
2020,12,15,12,842,815,596,-219
2020,12,15,13,896,882,683,-199
2020,12,15,14,892,847,637,-210
2020,12,15,15,853,816,540,-276
2020,12,15,16,794,750,510,-240
2020,12,15,17,724,704,489,-215
2020,12,15,18,681,665,472,-193
2020,12,15,19,650,632,472,-160
2020,12,15,20,636,617,485,-132
2020,12,15,21,636,619,497,-122
2020,12,15,22,663,655,508,-147
2020,12,15,23,736,721,521,-200
2020,12,16,0,783,770,525,-245
2020,12,16,1,788,774,525,-249
2020,12,16,2,786,761,536,-225
2020,12,16,3,763,738,543,-195
2020,12,16,4,727,695,539,-156
2020,12,16,5,685,652,523,-129
2020,12,16,6,682,626,510,-116
2020,12,16,7,679,611,482,-129
2020,12,16,8,685,609,491,-118
2020,12,16,9,691,619,524,-95
2020,12,16,10,714,633,527,-106
2020,12,16,11,740,679,532,-147
2020,12,16,12,805,731,529,-202
2020,12,16,13,829,776,533,-243
2020,12,16,14,830,805,541,-264
2020,12,16,15,805,799,548,-251
2020,12,16,16,782,800,580,-220
2020,12,16,17,769,823,633,-190
2020,12,16,18,756,764,566,-198
2020,12,16,19,737,762,626,-136
2020,12,16,20,704,756,625,-131
2020,12,16,21,703,744,519,-225
2020,12,16,22,733,771,535,-236
2020,12,16,23,769,795,547,-248
2020,12,17,0,770,800,547,-253
2020,12,17,1,771,777,545,-232
2020,12,17,2,763,753,547,-206
2020,12,17,3,751,720,547,-173
2020,12,17,4,712,675,547,-128
2020,12,17,5,682,641,547,-94
2020,12,17,6,660,616,547,-69
2020,12,17,7,653,604,545,-59
2020,12,17,8,668,605,547,-58
2020,12,17,9,688,611,548,-63
2020,12,17,10,728,626,548,-78
2020,12,17,11,766,665,545,-120
2020,12,17,12,834,731,548,-183
2020,12,17,13,862,786,549,-237
2020,12,17,14,860,797,548,-249
2020,12,17,15,829,774,544,-230
2020,12,17,16,806,753,548,-205
2020,12,17,17,784,738,549,-189
2020,12,17,18,759,717,547,-170
2020,12,17,19,752,707,548,-159
2020,12,17,20,748,701,547,-154
2020,12,17,21,758,709,550,-159
2020,12,17,22,791,746,553,-193
2020,12,17,23,844,799,551,-248
2020,12,18,0,888,828,549,-279
2020,12,18,1,889,827,551,-276
2020,12,18,2,873,812,552,-260
2020,12,18,3,842,793,553,-240
2020,12,18,4,798,756,548,-208
2020,12,18,5,760,727,551,-176
2020,12,18,6,738,707,549,-158
2020,12,18,7,741,706,550,-156
2020,12,18,8,753,706,548,-158
2020,12,18,9,769,714,551,-163
2020,12,18,10,794,731,550,-181
2020,12,18,11,840,766,549,-217
2020,12,18,12,922,826,550,-276
2020,12,18,13,956,862,552,-310
2020,12,18,14,936,873,613,-260
2020,12,18,15,889,872,623,-249
2020,12,18,16,835,830,625,-205
2020,12,18,17,766,778,621,-157
2020,12,18,18,720,736,623,-113
2020,12,18,19,705,707,466,-241
2020,12,18,20,693,679,437,-242
2020,12,18,21,698,683,444,-239
2020,12,18,22,721,722,448,-274
2020,12,18,23,782,785,466,-319
2020,12,19,0,811,821,535,-286
2020,12,19,1,815,829,567,-262
2020,12,19,2,810,827,705,-122
2020,12,19,3,788,812,749,-63
2020,12,19,4,763,789,651,-138
2020,12,19,5,732,761,638,-123
2020,12,19,6,718,744,638,-106
2020,12,19,7,718,743,639,-104
2020,12,19,8,719,752,636,-116
2020,12,19,9,723,756,639,-117
2020,12,19,10,739,777,637,-140
2020,12,19,11,777,937,760,-177
2020,12,19,12,811,905,816,-89
2020,12,19,13,851,893,817,-76
2020,12,19,14,872,914,814,-100
2020,12,19,15,836,855,783,-72
2020,12,19,16,780,686,638,-48
2020,12,19,17,731,771,641,-130
2020,12,19,18,678,710,641,-69
2020,12,19,19,628,664,640,-24
2020,12,19,20,618,644,549,-95
2020,12,19,21,603,645,628,-17
2020,12,19,22,636,672,637,-35
2020,12,19,23,697,726,636,-90
2020,12,20,0,726,751,637,-114
2020,12,20,1,746,746,636,-110
2020,12,20,2,740,731,639,-92
2020,12,20,3,727,704,636,-68
2020,12,20,4,700,671,637,-34
2020,12,20,5,662,638,623,-15
2020,12,20,6,648,607,596,-11
2020,12,20,7,635,591,581,-10
2020,12,20,8,633,588,576,-12
2020,12,20,9,633,578,569,-9
2020,12,20,10,636,590,575,-15
2020,12,20,11,645,602,591,-11
2020,12,20,12,675,631,608,-23
2020,12,20,13,708,670,636,-34
2020,12,20,14,746,702,636,-66
2020,12,20,15,738,708,637,-71
2020,12,20,16,699,671,637,-34
2020,12,20,17,672,632,630,-2
2020,12,20,18,662,604,627,23
2020,12,20,19,646,580,619,39
2020,12,20,20,632,564,605,41
2020,12,20,21,643,564,604,40
2020,12,20,22,667,587,618,31
2020,12,20,23,713,644,621,-23
2020,12,21,0,732,681,633,-48
2020,12,21,1,727,687,633,-54
2020,12,21,2,726,683,635,-48
2020,12,21,3,705,668,637,-31
2020,12,21,4,675,644,636,-8
2020,12,21,5,644,613,611,-2
2020,12,21,6,548,597,585,-12
2020,12,21,7,553,600,590,-10
2020,12,21,8,566,609,634,25
2020,12,21,9,570,619,632,13
2020,12,21,10,591,642,632,-10
2020,12,21,11,626,683,633,-50
2020,12,21,12,688,747,632,-115
2020,12,21,13,746,803,632,-171
2020,12,21,14,779,821,635,-186
2020,12,21,15,750,788,631,-157
2020,12,21,16,720,740,635,-105
2020,12,21,17,659,682,632,-50
2020,12,21,18,627,644,628,-16
2020,12,21,19,594,616,597,-19
2020,12,21,20,581,593,580,-13
2020,12,21,21,588,587,572,-15
2020,12,21,22,605,612,620,8
2020,12,21,23,669,658,617,-41
2020,12,22,0,722,690,621,-69
2020,12,22,1,731,693,623,-70
2020,12,22,2,724,682,623,-59
2020,12,22,3,709,657,624,-33
2020,12,22,4,673,617,622,5
2020,12,22,5,635,585,625,40
2020,12,22,6,630,551,605,54
2020,12,22,7,628,549,602,53
2020,12,22,8,629,548,602,54
2020,12,22,9,647,552,604,52
2020,12,22,10,668,572,622,50
2020,12,22,11,694,608,621,13
2020,12,22,12,733,659,627,-32
2020,12,22,13,811,705,632,-73
2020,12,22,14,844,723,634,-89
2020,12,22,15,824,703,633,-70
2020,12,22,16,755,678,631,-47
2020,12,22,17,693,655,630,-25
2020,12,22,18,645,628,620,-8
2020,12,22,19,623,601,594,-7
2020,12,22,20,605,590,583,-7
2020,12,22,21,611,592,585,-7
2020,12,22,22,626,612,606,-6
2020,12,22,23,696,678,634,-44
2020,12,23,0,742,719,637,-82
2020,12,23,1,759,729,640,-89
2020,12,23,2,753,738,643,-95
2020,12,23,3,736,722,638,-84
2020,12,23,4,712,704,641,-63
2020,12,23,5,690,672,638,-34
2020,12,23,6,597,653,633,-20
2020,12,23,7,600,654,633,-21
2020,12,23,8,609,664,640,-24
2020,12,23,9,619,667,638,-29
2020,12,23,10,642,680,637,-43
2020,12,23,11,683,711,637,-74
2020,12,23,12,747,762,638,-124
2020,12,23,13,803,801,640,-161
2020,12,23,14,821,817,638,-179
2020,12,23,15,788,785,641,-144
2020,12,23,16,740,720,640,-80
2020,12,23,17,682,681,632,-49
2020,12,23,18,644,649,586,-63
2020,12,23,19,616,627,559,-68
2020,12,23,20,593,616,582,-34
2020,12,23,21,587,627,612,-15
2020,12,23,22,612,640,633,-7
2020,12,23,23,658,689,633,-56
2020,12,24,0,690,699,633,-66
2020,12,24,1,693,693,637,-56
2020,12,24,2,682,669,634,-35
2020,12,24,3,657,643,631,-12
2020,12,24,4,617,601,624,23
2020,12,24,5,585,551,595,44
2020,12,24,6,547,519,589,70
2020,12,24,7,533,497,558,61
2020,12,24,8,522,487,548,61
2020,12,24,9,520,482,548,66
2020,12,24,10,523,483,546,63
2020,12,24,11,527,497,551,54
2020,12,24,12,563,523,609,86
2020,12,24,13,617,556,574,18
2020,12,24,14,656,585,578,-7
2020,12,24,15,667,612,575,-37
2020,12,24,16,664,627,600,-27
2020,12,24,17,648,626,599,-27
2020,12,24,18,636,626,599,-27
2020,12,24,19,627,622,602,-20
2020,12,24,20,618,611,600,-11
2020,12,24,21,627,607,600,-7
2020,12,24,22,648,610,600,-10
2020,12,24,23,691,632,598,-34
2020,12,25,0,723,668,622,-46
2020,12,25,1,738,705,624,-81
2020,12,25,2,755,733,619,-114
2020,12,25,3,761,739,598,-141
2020,12,25,4,765,731,575,-156
2020,12,25,5,759,723,518,-205
2020,12,25,6,658,713,541,-172
2020,12,25,7,658,717,576,-141
2020,12,25,8,660,726,611,-115
2020,12,25,9,666,749,626,-123
2020,12,25,10,673,768,613,-155
2020,12,25,11,702,803,625,-178
2020,12,25,12,731,842,633,-209
2020,12,25,13,768,884,631,-253
2020,12,25,14,820,916,632,-284
2020,12,25,15,835,910,629,-281
2020,12,25,16,826,897,633,-264
2020,12,25,17,815,877,632,-245
2020,12,25,18,768,853,632,-221
2020,12,25,19,758,830,627,-203
2020,12,25,20,746,817,635,-182
2020,12,25,21,752,833,632,-201
2020,12,25,22,777,875,634,-241
2020,12,25,23,836,934,631,-303
2020,12,26,0,872,963,630,-333
2020,12,26,1,883,967,692,-275
2020,12,26,2,891,965,700,-265
2020,12,26,3,886,956,703,-253
2020,12,26,4,876,937,700,-237
2020,12,26,5,869,919,668,-251
2020,12,26,6,874,908,632,-276
2020,12,26,7,883,903,630,-273
2020,12,26,8,895,910,633,-277
2020,12,26,9,904,916,633,-283
2020,12,26,10,915,929,634,-295
2020,12,26,11,934,949,665,-284
2020,12,26,12,961,970,702,-268
2020,12,26,13,996,1008,705,-303
2020,12,26,14,1030,1025,701,-324
2020,12,26,15,974,990,698,-292
2020,12,26,16,870,931,653,-278
2020,12,26,17,802,873,631,-242
2020,12,26,18,719,818,618,-200
2020,12,26,19,642,767,582,-185
2020,12,26,20,621,733,563,-170
2020,12,26,21,598,718,601,-117
2020,12,26,22,614,738,641,-97
2020,12,26,23,690,802,641,-161
2020,12,27,0,742,840,640,-200
2020,12,27,1,758,840,638,-202
2020,12,27,2,763,832,637,-195
2020,12,27,3,759,813,636,-177
2020,12,27,4,748,788,636,-152
2020,12,27,5,724,764,638,-126
2020,12,27,6,670,751,636,-115
2020,12,27,7,673,748,636,-112
2020,12,27,8,680,756,634,-122
2020,12,27,9,692,769,638,-131
2020,12,27,10,705,778,636,-142
2020,12,27,11,728,802,635,-167
2020,12,27,12,758,832,636,-196
2020,12,27,13,791,863,635,-228
2020,12,27,14,826,895,636,-259
2020,12,27,15,803,871,630,-241
2020,12,27,16,755,804,617,-187
2020,12,27,17,704,731,599,-132
2020,12,27,18,672,693,586,-107
2020,12,27,19,628,641,565,-76
2020,12,27,20,611,613,550,-63
2020,12,27,21,614,609,588,-21
2020,12,27,22,613,634,620,-14
2020,12,27,23,691,699,638,-61
2020,12,28,0,734,741,637,-104
2020,12,28,1,733,739,640,-99
2020,12,28,2,733,731,641,-90
2020,12,28,3,713,710,640,-70
2020,12,28,4,691,682,641,-41
2020,12,28,5,645,655,640,-15
2020,12,28,6,615,632,626,-6
2020,12,28,7,616,621,615,-6
2020,12,28,8,625,627,620,-7
2020,12,28,9,640,636,630,-6
2020,12,28,10,666,662,639,-23
2020,12,28,11,704,697,640,-57
2020,12,28,12,758,744,641,-103
2020,12,28,13,817,787,642,-145
2020,12,28,14,843,798,639,-159
2020,12,28,15,815,797,641,-156
2020,12,28,16,778,784,642,-142
2020,12,28,17,725,742,636,-106
2020,12,28,18,690,701,630,-71
2020,12,28,19,655,671,610,-61
2020,12,28,20,643,655,589,-66
2020,12,28,21,619,653,623,-30
2020,12,28,22,634,666,634,-32
2020,12,28,23,688,712,633,-79
2020,12,29,0,740,741,637,-104
2020,12,29,1,751,733,638,-95
2020,12,29,2,755,722,639,-83
2020,12,29,3,733,700,638,-62
2020,12,29,4,708,667,637,-30
2020,12,29,5,684,638,624,-14
2020,12,29,6,599,610,599,-11
2020,12,29,7,591,611,599,-12
2020,12,29,8,596,614,601,-13
2020,12,29,9,606,617,604,-13
2020,12,29,10,628,641,628,-13
2020,12,29,11,670,680,636,-44
2020,12,29,12,713,736,639,-97
2020,12,29,13,770,782,639,-143
2020,12,29,14,800,802,639,-163
2020,12,29,15,776,771,638,-133
2020,12,29,16,734,722,637,-85
2020,12,29,17,691,677,597,-80
2020,12,29,18,645,638,576,-62
2020,12,29,19,616,613,544,-69
2020,12,29,20,598,586,539,-47
2020,12,29,21,590,590,580,-10
2020,12,29,22,617,610,600,-10
2020,12,29,23,667,667,630,-37
2020,12,30,0,717,703,632,-71
2020,12,30,1,729,703,638,-65
2020,12,30,2,721,694,639,-55
2020,12,30,3,701,664,639,-25
2020,12,30,4,670,637,625,-12
2020,12,30,5,640,602,591,-11
2020,12,30,6,604,580,572,-8
2020,12,30,7,600,574,564,-10
2020,12,30,8,611,575,564,-11
2020,12,30,9,618,581,570,-11
2020,12,30,10,645,598,587,-11
2020,12,30,11,681,631,616,-15
2020,12,30,12,731,670,635,-35
2020,12,30,13,815,717,639,-78
2020,12,30,14,860,741,637,-104
2020,12,30,15,844,752,635,-117
2020,12,30,16,803,757,600,-157
2020,12,30,17,785,753,601,-152
2020,12,30,18,741,746,598,-148
2020,12,30,19,717,725,600,-125
2020,12,30,20,701,709,600,-109
2020,12,30,21,698,702,597,-105
2020,12,30,22,707,701,600,-101
2020,12,30,23,761,731,601,-130
2020,12,31,0,790,740,600,-140
2020,12,31,1,765,717,599,-118
2020,12,31,2,749,691,601,-90
2020,12,31,3,721,657,597,-60
2020,12,31,4,683,613,594,-19
2020,12,31,5,636,561,557,-4
2020,12,31,6,604,527,588,61
2020,12,31,7,594,505,588,83
2020,12,31,8,588,494,586,92
2020,12,31,9,598,487,580,93
2020,12,31,10,618,490,582,92
2020,12,31,11,636,514,583,69
2020,12,31,12,679,554,584,30
2020,12,31,13,690,589,583,-6
2020,12,31,14,695,610,585,-25
2020,12,31,15,676,611,584,-27
2020,12,31,16,641,592,579,-13
2020,12,31,17,616,565,558,-7
2020,12,31,18,606,548,541,-7
2020,12,31,19,590,538,532,-6
2020,12,31,20,578,531,526,-5
2020,12,31,21,571,529,521,-8
2020,12,31,22,583,545,536,-9
2020,12,31,23,604,590,571,-19
2021,1,1,0,610,607,580,-27
2021,1,1,1,585,593,581,-12
2021,1,1,2,568,573,569,-4
2021,1,1,3,544,552,547,-5
2021,1,1,4,520,520,478,-42
2021,1,1,5,510,497,435,-62
2021,1,1,6,481,471,427,-44
2021,1,1,7,457,450,424,-26
2021,1,1,8,444,439,427,-12
2021,1,1,9,439,430,427,-3
2021,1,1,10,438,436,501,65
2021,1,1,11,465,448,550,102
2021,1,1,12,482,471,450,-21
2021,1,1,13,516,499,425,-74
2021,1,1,14,554,527,508,-19
2021,1,1,15,582,561,591,30
2021,1,1,16,608,598,593,-5
2021,1,1,17,609,616,593,-23
2021,1,1,18,611,633,596,-37
2021,1,1,19,611,631,594,-37
2021,1,1,20,614,632,596,-36
2021,1,1,21,614,635,598,-37
2021,1,1,22,634,641,595,-46
2021,1,1,23,658,669,597,-72
2021,1,2,0,685,671,598,-73
2021,1,2,1,669,648,599,-49
2021,1,2,2,647,626,599,-27
2021,1,2,3,616,602,599,-3
2021,1,2,4,589,569,601,32
2021,1,2,5,551,534,598,64
2021,1,2,6,490,503,595,92
2021,1,2,7,475,487,597,110
2021,1,2,8,466,479,576,97
2021,1,2,9,466,483,562,79
2021,1,2,10,478,484,573,89
2021,1,2,11,504,502,595,93
2021,1,2,12,528,529,599,70
2021,1,2,13,556,562,600,38
2021,1,2,14,590,596,602,6
2021,1,2,15,595,606,598,-8
2021,1,2,16,587,595,593,-2
2021,1,2,17,560,574,567,-7
2021,1,2,18,534,546,587,41
2021,1,2,19,515,523,582,59
2021,1,2,20,512,514,576,62
2021,1,2,21,505,505,574,69
2021,1,2,22,517,520,574,54
2021,1,2,23,559,561,574,13
2021,1,3,0,573,593,578,-15
2021,1,3,1,563,593,582,-11
2021,1,3,2,554,576,580,4
2021,1,3,3,530,559,584,25
2021,1,3,4,511,530,581,51
2021,1,3,5,495,501,573,72
2021,1,3,6,480,477,564,87
2021,1,3,7,462,467,579,112
2021,1,3,8,455,465,586,121
2021,1,3,9,460,466,573,107
2021,1,3,10,466,481,574,93
2021,1,3,11,491,494,591,97
2021,1,3,12,529,516,589,73
2021,1,3,13,560,549,592,43
2021,1,3,14,601,587,592,5
2021,1,3,15,627,615,590,-25
2021,1,3,16,614,626,593,-33
2021,1,3,17,587,619,591,-28
2021,1,3,18,570,620,591,-29
2021,1,3,19,551,610,567,-43
2021,1,3,20,538,598,551,-47
2021,1,3,21,526,602,587,-15
2021,1,3,22,585,633,593,-40
2021,1,3,23,617,690,601,-89
2021,1,4,0,672,720,602,-118
2021,1,4,1,671,718,602,-116
2021,1,4,2,664,705,604,-101
2021,1,4,3,637,678,602,-76
2021,1,4,4,607,647,605,-42
2021,1,4,5,556,617,605,-12
2021,1,4,6,543,595,598,3
2021,1,4,7,544,599,599,0
2021,1,4,8,557,604,601,-3
2021,1,4,9,571,615,603,-12
2021,1,4,10,604,644,602,-42
2021,1,4,11,645,697,602,-95
2021,1,4,12,713,763,599,-164
2021,1,4,13,797,818,603,-215
2021,1,4,14,774,830,604,-226
2021,1,4,15,760,797,605,-192
2021,1,4,16,732,741,605,-136
2021,1,4,17,663,692,602,-90
2021,1,4,18,642,654,600,-54
2021,1,4,19,612,630,597,-33
2021,1,4,20,608,609,594,-15
2021,1,4,21,590,608,592,-16
2021,1,4,22,614,627,591,-36
2021,1,4,23,674,690,594,-96
2021,1,5,0,721,725,596,-129
2021,1,5,1,715,725,595,-130
2021,1,5,2,717,715,600,-115
2021,1,5,3,699,691,603,-88
2021,1,5,4,662,652,603,-49
2021,1,5,5,619,615,601,-14
2021,1,5,6,600,595,602,7
2021,1,5,7,593,579,600,21
2021,1,5,8,605,576,603,27
2021,1,5,9,608,578,601,23
2021,1,5,10,640,593,601,8
2021,1,5,11,685,623,601,-22
2021,1,5,12,769,678,600,-78
2021,1,5,13,819,718,600,-118
2021,1,5,14,804,734,601,-133
2021,1,5,15,774,735,600,-135
2021,1,5,16,722,732,600,-132
2021,1,5,17,682,727,599,-128
2021,1,5,18,635,712,596,-116
2021,1,5,19,620,703,593,-110
2021,1,5,20,604,693,594,-99
2021,1,5,21,602,691,595,-96
2021,1,5,22,611,701,622,-79
2021,1,5,23,672,742,633,-109
2021,1,6,0,715,776,635,-141
2021,1,6,1,719,771,636,-135
2021,1,6,2,719,754,638,-116
2021,1,6,3,695,729,637,-92
2021,1,6,4,659,692,637,-55
2021,1,6,5,623,665,638,-27
2021,1,6,6,651,642,631,-11
2021,1,6,7,647,645,631,-14
2021,1,6,8,655,655,638,-17
2021,1,6,9,664,667,635,-32
2021,1,6,10,688,688,635,-53
2021,1,6,11,730,731,636,-95
2021,1,6,12,800,805,635,-170
2021,1,6,13,854,855,633,-222
2021,1,6,14,843,869,634,-235
2021,1,6,15,817,846,635,-211
2021,1,6,16,780,796,635,-161
2021,1,6,17,714,759,638,-121
2021,1,6,18,685,725,639,-86
2021,1,6,19,665,690,638,-52
2021,1,6,20,643,667,637,-30
2021,1,6,21,640,657,636,-21
2021,1,6,22,658,669,636,-33
2021,1,6,23,720,736,636,-100
2021,1,7,0,773,783,639,-144
2021,1,7,1,778,786,637,-149
2021,1,7,2,768,781,637,-144
2021,1,7,3,745,768,638,-130
2021,1,7,4,710,745,638,-107
2021,1,7,5,675,713,637,-76
2021,1,7,6,676,709,635,-74
2021,1,7,7,672,714,635,-79
2021,1,7,8,682,726,635,-91
2021,1,7,9,699,743,636,-107
2021,1,7,10,723,762,635,-127
2021,1,7,11,768,806,633,-173
2021,1,7,12,853,870,751,-119
2021,1,7,13,905,926,822,-104
2021,1,7,14,891,928,821,-107
2021,1,7,15,859,876,726,-150
2021,1,7,16,827,855,653,-202
2021,1,7,17,776,818,636,-182
2021,1,7,18,740,749,635,-114
2021,1,7,19,710,705,635,-70
2021,1,7,20,686,698,634,-64
2021,1,7,21,685,709,633,-76
2021,1,7,22,707,730,632,-98
2021,1,7,23,767,766,633,-133
2021,1,8,0,813,787,636,-151
2021,1,8,1,803,775,633,-142
2021,1,8,2,789,755,634,-121
2021,1,8,3,761,733,635,-98
2021,1,8,4,718,697,633,-64
2021,1,8,5,672,670,633,-37
2021,1,8,6,632,645,634,-11
2021,1,8,7,627,644,633,-11
2021,1,8,8,630,643,633,-10
2021,1,8,9,639,650,635,-15
2021,1,8,10,664,666,635,-31
2021,1,8,11,698,694,634,-60
2021,1,8,12,772,733,634,-99
2021,1,8,13,824,774,636,-138
2021,1,8,14,824,804,636,-168
2021,1,8,15,819,813,639,-174
2021,1,8,16,796,812,638,-174
2021,1,8,17,793,811,640,-171
2021,1,8,18,776,794,636,-158
2021,1,8,19,767,789,641,-148
2021,1,8,20,746,768,639,-129
2021,1,8,21,747,763,638,-125
2021,1,8,22,760,776,639,-137
2021,1,8,23,804,819,642,-177
2021,1,9,0,824,833,639,-194
2021,1,9,1,828,818,644,-174
2021,1,9,2,816,797,641,-156
2021,1,9,3,788,770,641,-129
2021,1,9,4,756,737,639,-98
2021,1,9,5,728,713,641,-72
2021,1,9,6,680,687,636,-51
2021,1,9,7,678,683,637,-46
2021,1,9,8,682,685,641,-44
2021,1,9,9,689,689,639,-50
2021,1,9,10,697,701,641,-60
2021,1,9,11,754,720,639,-81
2021,1,9,12,784,751,640,-111
2021,1,9,13,812,781,640,-141
2021,1,9,14,842,814,641,-173
2021,1,9,15,806,830,642,-188
2021,1,9,16,766,826,641,-185
2021,1,9,17,725,820,641,-179
2021,1,9,18,686,804,640,-164
2021,1,9,19,647,787,642,-145
2021,1,9,20,637,770,640,-130
2021,1,9,21,616,767,644,-123
2021,1,9,22,649,790,642,-148
2021,1,9,23,711,841,641,-200
2021,1,10,0,743,867,638,-229
2021,1,10,1,754,853,640,-213
2021,1,10,2,741,834,639,-195
2021,1,10,3,723,808,640,-168
2021,1,10,4,720,783,640,-143
2021,1,10,5,720,750,637,-113
2021,1,10,6,715,731,637,-94
2021,1,10,7,719,724,637,-87
2021,1,10,8,715,727,637,-90
2021,1,10,9,724,737,637,-100
2021,1,10,10,742,757,639,-118
2021,1,10,11,762,772,634,-138
2021,1,10,12,785,806,640,-166
2021,1,10,13,829,842,641,-201
2021,1,10,14,849,883,644,-239
2021,1,10,15,821,858,642,-216
2021,1,10,16,756,801,636,-165
2021,1,10,17,697,739,637,-102
2021,1,10,18,664,696,639,-57
2021,1,10,19,640,657,597,-60
2021,1,10,20,623,629,552,-77
2021,1,10,21,619,619,603,-16
2021,1,10,22,644,638,627,-11
2021,1,10,23,697,697,635,-62
2021,1,11,0,741,756,640,-116
2021,1,11,1,746,769,642,-127
2021,1,11,2,739,768,642,-126
2021,1,11,3,715,755,644,-111
2021,1,11,4,690,729,642,-87
2021,1,11,5,654,707,642,-65
2021,1,11,6,658,693,642,-51
2021,1,11,7,658,682,641,-41
2021,1,11,8,667,678,642,-36
2021,1,11,9,684,674,641,-33
2021,1,11,10,707,691,643,-48
2021,1,11,11,753,720,639,-81
2021,1,11,12,818,775,640,-135
2021,1,11,13,863,816,638,-178
2021,1,11,14,862,832,640,-192
2021,1,11,15,842,830,636,-194
2021,1,11,16,814,827,637,-190
2021,1,11,17,779,823,642,-181
2021,1,11,18,745,817,639,-178
2021,1,11,19,718,805,636,-169
2021,1,11,20,694,782,639,-143
2021,1,11,21,690,768,637,-131
2021,1,11,22,703,774,638,-136
2021,1,11,23,746,804,637,-167
2021,1,12,0,792,818,638,-180
2021,1,12,1,787,800,636,-164
2021,1,12,2,771,779,639,-140
2021,1,12,3,742,741,636,-105
2021,1,12,4,705,705,641,-64
2021,1,12,5,666,665,636,-29
2021,1,12,6,633,642,612,-30
2021,1,12,7,634,629,605,-24
2021,1,12,8,631,627,606,-21
2021,1,12,9,640,632,606,-26
2021,1,12,10,672,651,608,-43
2021,1,12,11,705,690,609,-81
2021,1,12,12,763,742,638,-104
2021,1,12,13,817,781,637,-144
2021,1,12,14,820,802,640,-162
2021,1,12,15,786,783,636,-147
2021,1,12,16,759,770,606,-164
2021,1,12,17,723,750,598,-152
2021,1,12,18,697,724,527,-197
2021,1,12,19,679,682,566,-116
2021,1,12,20,662,651,507,-144
2021,1,12,21,658,645,552,-93
2021,1,12,22,671,670,610,-60
2021,1,12,23,713,729,638,-91
2021,1,13,0,760,786,640,-146
2021,1,13,1,771,797,640,-157
2021,1,13,2,774,797,642,-155
2021,1,13,3,751,780,639,-141
2021,1,13,4,722,754,640,-114
2021,1,13,5,693,727,640,-87
2021,1,13,6,669,708,613,-95
2021,1,13,7,669,708,611,-97
2021,1,13,8,678,715,616,-99
2021,1,13,9,695,734,675,-59
2021,1,13,10,720,750,693,-57
2021,1,13,11,758,796,776,-20
2021,1,13,12,819,862,831,-31
2021,1,13,13,870,911,853,-58
2021,1,13,14,870,930,871,-59
2021,1,13,15,833,898,827,-71
2021,1,13,16,782,847,714,-133
2021,1,13,17,723,767,643,-124
2021,1,13,18,683,711,630,-81
2021,1,13,19,661,662,614,-48
2021,1,13,20,635,623,603,-20
2021,1,13,21,627,613,601,-12
2021,1,13,22,634,633,611,-22
2021,1,13,23,685,690,617,-73
2021,1,14,0,732,732,619,-113
2021,1,14,1,747,731,623,-108
2021,1,14,2,740,718,622,-96
2021,1,14,3,724,694,621,-73
2021,1,14,4,692,667,621,-46
2021,1,14,5,671,650,620,-30
2021,1,14,6,659,642,464,-178
2021,1,14,7,658,644,455,-189
2021,1,14,8,675,657,569,-88
2021,1,14,9,687,674,579,-95
2021,1,14,10,718,694,612,-82
2021,1,14,11,757,738,620,-118
2021,1,14,12,831,814,622,-192
2021,1,14,13,886,867,621,-246
2021,1,14,14,882,873,624,-249
2021,1,14,15,836,826,620,-206
2021,1,14,16,782,761,621,-140
2021,1,14,17,714,711,624,-87
2021,1,14,18,671,666,622,-44
2021,1,14,19,640,628,593,-35
2021,1,14,20,611,602,565,-37
2021,1,14,21,606,585,579,-6
2021,1,14,22,615,603,594,-9
2021,1,14,23,663,649,612,-37
2021,1,15,0,713,703,613,-90
2021,1,15,1,722,711,615,-96
2021,1,15,2,715,711,622,-89
2021,1,15,3,693,692,621,-71
2021,1,15,4,655,661,627,-34
2021,1,15,5,618,634,624,-10
2021,1,15,6,599,622,615,-7
2021,1,15,7,598,625,615,-10
2021,1,15,8,608,635,629,-6
2021,1,15,9,612,651,636,-15
2021,1,15,10,638,664,637,-27
2021,1,15,11,681,692,641,-51
2021,1,15,12,760,736,724,-12
2021,1,15,13,810,769,780,11
2021,1,15,14,806,780,697,-83
2021,1,15,15,773,763,623,-140
2021,1,15,16,724,738,622,-116
2021,1,15,17,696,723,621,-102
2021,1,15,18,646,699,625,-74
2021,1,15,19,631,660,621,-39
2021,1,15,20,607,634,617,-17
2021,1,15,21,616,623,613,-10
2021,1,15,22,628,639,614,-25
2021,1,15,23,700,694,617,-77
2021,1,16,0,760,740,623,-117
2021,1,16,1,778,741,620,-121
2021,1,16,2,776,736,623,-113
2021,1,16,3,742,727,624,-103
2021,1,16,4,702,705,623,-82
2021,1,16,5,655,686,624,-62
2021,1,16,6,650,674,568,-106
2021,1,16,7,645,678,560,-118
2021,1,16,8,645,684,562,-122
2021,1,16,9,651,699,563,-136
2021,1,16,10,676,703,566,-137
2021,1,16,11,724,713,624,-89
2021,1,16,12,762,739,623,-116
2021,1,16,13,809,771,627,-144
2021,1,16,14,838,802,623,-179
2021,1,16,15,819,808,626,-182
2021,1,16,16,792,805,622,-183
2021,1,16,17,757,804,626,-178
2021,1,16,18,720,803,625,-178
2021,1,16,19,686,777,623,-154
2021,1,16,20,684,769,625,-144
2021,1,16,21,668,761,624,-137
2021,1,16,22,692,778,624,-154
2021,1,16,23,735,821,624,-197
2021,1,17,0,772,855,626,-229
2021,1,17,1,768,842,625,-217
2021,1,17,2,757,819,621,-198
2021,1,17,3,745,788,623,-165
2021,1,17,4,731,747,624,-123
2021,1,17,5,717,709,647,-62
2021,1,17,6,690,687,560,-127
2021,1,17,7,687,677,560,-117
2021,1,17,8,672,680,563,-117
2021,1,17,9,688,685,577,-108
2021,1,17,10,696,692,623,-69
2021,1,17,11,737,703,622,-81
2021,1,17,12,762,724,624,-100
2021,1,17,13,801,752,625,-127
2021,1,17,14,833,795,625,-170
2021,1,17,15,803,806,624,-182
2021,1,17,16,760,781,622,-159
2021,1,17,17,727,757,625,-132
2021,1,17,18,704,716,625,-91
2021,1,17,19,680,681,623,-58
2021,1,17,20,649,667,616,-51
2021,1,17,21,648,661,625,-36
2021,1,17,22,683,688,622,-66
2021,1,17,23,717,735,625,-110
2021,1,18,0,785,763,625,-138
2021,1,18,1,775,750,625,-125
2021,1,18,2,770,735,632,-103
2021,1,18,3,749,713,635,-78
2021,1,18,4,720,686,637,-49
2021,1,18,5,692,661,634,-27
2021,1,18,6,638,653,589,-64
2021,1,18,7,630,651,573,-78
2021,1,18,8,628,661,577,-84
2021,1,18,9,631,674,575,-99
2021,1,18,10,660,694,581,-113
2021,1,18,11,724,727,637,-90
2021,1,18,12,800,768,636,-132
2021,1,18,13,842,812,637,-175
2021,1,18,14,831,832,638,-194
2021,1,18,15,817,835,636,-199
2021,1,18,16,777,824,638,-186
2021,1,18,17,745,778,633,-145
2021,1,18,18,724,749,632,-117
2021,1,18,19,678,722,618,-104
2021,1,18,20,655,696,594,-102
2021,1,18,21,654,696,619,-77
2021,1,18,22,700,714,636,-78
2021,1,18,23,730,767,636,-131
2021,1,19,0,810,816,638,-178
2021,1,19,1,807,817,637,-180
2021,1,19,2,798,801,637,-164
2021,1,19,3,764,785,638,-147
2021,1,19,4,732,752,594,-158
2021,1,19,5,689,728,575,-153
2021,1,19,6,699,720,575,-145
2021,1,19,7,707,721,576,-145
2021,1,19,8,716,725,575,-150
2021,1,19,9,728,734,579,-155
2021,1,19,10,751,746,578,-168
2021,1,19,11,789,780,638,-142
2021,1,19,12,857,831,686,-145
2021,1,19,13,906,874,764,-110
2021,1,19,14,898,874,691,-183
2021,1,19,15,858,856,648,-208
2021,1,19,16,791,830,647,-183
2021,1,19,17,717,791,642,-149
2021,1,19,18,667,760,635,-125
2021,1,19,19,658,709,629,-80
2021,1,19,20,642,666,608,-58
2021,1,19,21,636,663,620,-43
2021,1,19,22,653,670,619,-51
2021,1,19,23,688,697,621,-76
2021,1,20,0,746,736,626,-110
2021,1,20,1,748,735,629,-106
2021,1,20,2,745,725,634,-91
2021,1,20,3,718,701,635,-66
2021,1,20,4,688,667,592,-75
2021,1,20,5,664,637,578,-59
2021,1,20,6,657,619,576,-43
2021,1,20,7,659,613,576,-37
2021,1,20,8,667,607,577,-30
2021,1,20,9,676,611,571,-40
2021,1,20,10,713,620,577,-43
2021,1,20,11,734,658,605,-53
2021,1,20,12,808,730,609,-121
2021,1,20,13,869,781,639,-142
2021,1,20,14,871,793,628,-165
2021,1,20,15,844,776,626,-150
2021,1,20,16,804,747,623,-124
2021,1,20,17,754,707,564,-143
2021,1,20,18,713,672,455,-217
2021,1,20,19,688,659,450,-209
2021,1,20,20,665,634,456,-178
2021,1,20,21,656,620,489,-131
2021,1,20,22,681,646,589,-57
2021,1,20,23,733,700,629,-71
2021,1,21,0,786,762,628,-134
2021,1,21,1,802,774,626,-148
2021,1,21,2,797,770,618,-152
2021,1,21,3,774,748,567,-181
2021,1,21,4,741,705,563,-142
2021,1,21,5,702,672,564,-108
2021,1,21,6,674,649,565,-84
2021,1,21,7,667,637,564,-73
2021,1,21,8,674,637,564,-73
2021,1,21,9,681,641,565,-76
2021,1,21,10,705,658,566,-92
2021,1,21,11,739,683,566,-117
2021,1,21,12,802,751,628,-123
2021,1,21,13,850,795,636,-159
2021,1,21,14,843,810,638,-172
2021,1,21,15,809,785,636,-149
2021,1,21,16,759,760,635,-125
2021,1,21,17,710,742,630,-112
2021,1,21,18,677,728,630,-98
2021,1,21,19,649,716,627,-89
2021,1,21,20,626,712,629,-83
2021,1,21,21,623,702,622,-80
2021,1,21,22,636,715,629,-86
2021,1,21,23,667,741,630,-111
2021,1,22,0,716,776,635,-141
2021,1,22,1,712,764,629,-135
2021,1,22,2,697,747,578,-169
2021,1,22,3,672,718,571,-147
2021,1,22,4,638,682,574,-108
2021,1,22,5,587,646,574,-72
2021,1,22,6,604,626,570,-56
2021,1,22,7,601,622,569,-53
2021,1,22,8,609,630,546,-84
2021,1,22,9,618,636,558,-78
2021,1,22,10,648,651,572,-79
2021,1,22,11,674,694,578,-116
2021,1,22,12,743,755,633,-122
2021,1,22,13,789,804,637,-167
2021,1,22,14,792,824,635,-189
2021,1,22,15,773,788,637,-151
2021,1,22,16,736,737,634,-103
2021,1,22,17,694,703,600,-103
2021,1,22,18,672,664,526,-138
2021,1,22,19,630,651,535,-116
2021,1,22,20,609,620,569,-51
2021,1,22,21,605,601,496,-105
2021,1,22,22,625,617,590,-27
2021,1,22,23,674,656,619,-37
2021,1,23,0,722,709,627,-82
2021,1,23,1,735,717,628,-89
2021,1,23,2,736,703,627,-76
2021,1,23,3,713,687,627,-60
2021,1,23,4,687,662,608,-54
2021,1,23,5,651,641,574,-67
2021,1,23,6,646,633,574,-59
2021,1,23,7,642,628,574,-54
2021,1,23,8,641,637,575,-62
2021,1,23,9,655,653,578,-75
2021,1,23,10,676,673,577,-96
2021,1,23,11,721,702,580,-122
2021,1,23,12,767,743,640,-103
2021,1,23,13,809,786,638,-148
2021,1,23,14,838,814,626,-188
2021,1,23,15,800,796,637,-159
2021,1,23,16,762,755,623,-132
2021,1,23,17,719,713,591,-122
2021,1,23,18,676,673,573,-100
2021,1,23,19,640,635,549,-86
2021,1,23,20,627,609,530,-79
2021,1,23,21,609,600,575,-25
2021,1,23,22,631,617,607,-10
2021,1,23,23,673,665,632,-33
2021,1,24,0,716,722,634,-88
2021,1,24,1,727,740,610,-130
2021,1,24,2,720,742,577,-165
2021,1,24,3,701,732,574,-158
2021,1,24,4,684,711,577,-134
2021,1,24,5,662,688,575,-113
2021,1,24,6,649,659,573,-86
2021,1,24,7,639,644,575,-69
2021,1,24,8,642,633,576,-57
2021,1,24,9,647,626,573,-53
2021,1,24,10,670,639,576,-63
2021,1,24,11,693,653,576,-77
2021,1,24,12,724,683,634,-49
2021,1,24,13,769,731,639,-92
2021,1,24,14,815,757,636,-121
2021,1,24,15,807,746,637,-109
2021,1,24,16,754,710,632,-78
2021,1,24,17,709,680,538,-142
2021,1,24,18,676,641,486,-155
2021,1,24,19,647,631,503,-128
2021,1,24,20,608,623,581,-42
2021,1,24,21,595,620,616,-4
2021,1,24,22,627,632,624,-8
2021,1,24,23,669,662,619,-43
2021,1,25,0,719,691,570,-121
2021,1,25,1,712,682,566,-116
2021,1,25,2,695,658,567,-91
2021,1,25,3,660,627,566,-61
2021,1,25,4,626,596,569,-27
2021,1,25,5,579,561,555,-6
2021,1,25,6,578,531,510,-21
2021,1,25,7,573,529,467,-62
2021,1,25,8,568,529,456,-73
2021,1,25,9,571,533,475,-58
2021,1,25,10,581,550,536,-14
2021,1,25,11,606,585,578,-7
2021,1,25,12,682,641,619,-22
2021,1,25,13,718,689,636,-53
2021,1,25,14,710,704,631,-73
2021,1,25,15,695,710,630,-80
2021,1,25,16,662,707,630,-77
2021,1,25,17,646,692,627,-65
2021,1,25,18,630,672,618,-54
2021,1,25,19,614,646,610,-36
2021,1,25,20,594,627,612,-15
2021,1,25,21,591,608,598,-10
2021,1,25,22,602,619,605,-14
2021,1,25,23,618,640,601,-39
2021,1,26,0,660,661,608,-53
2021,1,26,1,656,644,605,-39
2021,1,26,2,643,613,602,-11
2021,1,26,3,608,580,601,21
2021,1,26,4,570,534,601,67
2021,1,26,5,522,494,598,104
2021,1,26,6,471,462,568,106
2021,1,26,7,460,448,568,120
2021,1,26,8,459,447,575,128
2021,1,26,9,457,444,574,130
2021,1,26,10,473,454,575,121
2021,1,26,11,511,487,591,104
2021,1,26,12,577,535,604,69
2021,1,26,13,618,581,606,25
2021,1,26,14,618,593,605,12
2021,1,26,15,620,584,606,22
2021,1,26,16,605,580,608,28
2021,1,26,17,573,557,606,49
2021,1,26,18,571,544,601,57
2021,1,26,19,538,526,589,63
2021,1,26,20,523,524,591,67
2021,1,26,21,536,526,596,70
2021,1,26,22,547,534,598,64
2021,1,26,23,583,567,606,39
2021,1,27,0,623,602,607,5
2021,1,27,1,632,603,609,6
2021,1,27,2,623,586,609,23
2021,1,27,3,594,563,610,47
2021,1,27,4,555,526,608,82
2021,1,27,5,510,497,611,114
2021,1,27,6,499,479,607,128
2021,1,27,7,488,473,608,135
2021,1,27,8,489,469,609,140
2021,1,27,9,504,471,609,138
2021,1,27,10,518,488,608,120
2021,1,27,11,560,524,609,85
2021,1,27,12,633,576,602,26
2021,1,27,13,675,632,612,-20
2021,1,27,14,684,647,667,20
2021,1,27,15,676,642,609,-33
2021,1,27,16,662,639,611,-28
2021,1,27,17,645,612,610,-2
2021,1,27,18,628,573,611,38
2021,1,27,19,616,552,611,59
2021,1,27,20,606,535,525,-10
2021,1,27,21,604,538,389,-149
2021,1,27,22,624,560,573,13
2021,1,27,23,671,599,615,16
2021,1,28,0,706,627,617,-10
2021,1,28,1,722,628,620,-8
2021,1,28,2,718,625,622,-3
2021,1,28,3,693,605,620,15
2021,1,28,4,652,579,620,41
2021,1,28,5,625,562,618,56
2021,1,28,6,609,558,554,-4
2021,1,28,7,605,574,565,-9
2021,1,28,8,618,595,584,-11
2021,1,28,9,631,613,603,-10
2021,1,28,10,659,650,620,-30
2021,1,28,11,706,704,618,-86
2021,1,28,12,778,771,620,-151
2021,1,28,13,836,832,623,-209
2021,1,28,14,846,857,621,-236
2021,1,28,15,824,861,620,-241
2021,1,28,16,805,850,620,-230
2021,1,28,17,792,855,622,-233
2021,1,28,18,762,825,622,-203
2021,1,28,19,744,778,620,-158
2021,1,28,20,729,749,623,-126
2021,1,28,21,715,740,621,-119
2021,1,28,22,737,755,621,-134
2021,1,28,23,795,814,622,-192
2021,1,29,0,850,878,620,-258
2021,1,29,1,866,891,622,-269
2021,1,29,2,866,880,621,-259
2021,1,29,3,840,858,622,-236
2021,1,29,4,808,826,620,-206
2021,1,29,5,786,795,621,-174
2021,1,29,6,791,786,619,-167
2021,1,29,7,799,788,615,-173
2021,1,29,8,806,794,622,-172
2021,1,29,9,820,813,672,-141
2021,1,29,10,848,839,687,-152
2021,1,29,11,900,880,700,-180
2021,1,29,12,971,950,696,-254
2021,1,29,13,1012,993,687,-306
2021,1,29,14,1001,1003,689,-314
2021,1,29,15,946,938,688,-250
2021,1,29,16,881,869,621,-248
2021,1,29,17,809,802,622,-180
2021,1,29,18,759,753,621,-132
2021,1,29,19,716,707,616,-91
2021,1,29,20,682,683,621,-62
2021,1,29,21,665,672,621,-51
2021,1,29,22,671,678,620,-58
2021,1,29,23,725,724,620,-104
2021,1,30,0,780,780,619,-161
2021,1,30,1,796,798,626,-172
2021,1,30,2,794,797,644,-153
2021,1,30,3,787,783,641,-142
2021,1,30,4,760,762,643,-119
2021,1,30,5,750,742,642,-100
2021,1,30,6,739,735,641,-94
2021,1,30,7,745,744,643,-101
2021,1,30,8,754,754,641,-113
2021,1,30,9,765,767,643,-124
2021,1,30,10,795,774,639,-135
2021,1,30,11,840,808,644,-164
2021,1,30,12,869,841,642,-199
2021,1,30,13,902,872,643,-229
2021,1,30,14,922,897,642,-255
2021,1,30,15,898,883,645,-238
2021,1,30,16,836,846,643,-203
2021,1,30,17,782,811,647,-164
2021,1,30,18,715,770,642,-128
2021,1,30,19,669,760,644,-116
2021,1,30,20,645,743,643,-100
2021,1,30,21,618,749,646,-103
2021,1,30,22,645,778,645,-133
2021,1,30,23,680,817,646,-171
2021,1,31,0,722,839,646,-193
2021,1,31,1,736,820,644,-176
2021,1,31,2,732,796,645,-151
2021,1,31,3,710,771,649,-122
2021,1,31,4,682,733,644,-89
2021,1,31,5,652,713,647,-66
2021,1,31,6,622,678,643,-35
2021,1,31,7,615,658,640,-18
2021,1,31,8,618,660,646,-14
2021,1,31,9,609,659,642,-17
2021,1,31,10,628,672,644,-28
2021,1,31,11,634,680,641,-39
2021,1,31,12,669,705,639,-66
2021,1,31,13,715,736,642,-94
2021,1,31,14,766,770,643,-127
2021,1,31,15,762,786,641,-145
2021,1,31,16,737,787,642,-145
2021,1,31,17,705,771,642,-129
2021,1,31,18,668,729,640,-89
2021,1,31,19,671,697,642,-55
2021,1,31,20,652,670,641,-29
2021,1,31,21,645,652,638,-14
2021,1,31,22,677,665,638,-27
2021,1,31,23,717,696,637,-59
2021,2,1,0,758,728,639,-89
2021,2,1,1,758,722,638,-84
2021,2,1,2,745,703,639,-64
2021,2,1,3,722,670,638,-32
2021,2,1,4,693,636,626,-10
2021,2,1,5,650,603,592,-11
2021,2,1,6,603,578,570,-8
2021,2,1,7,609,567,559,-8
2021,2,1,8,616,571,561,-10
2021,2,1,9,622,581,571,-10
2021,2,1,10,660,614,603,-11
2021,2,1,11,707,667,633,-34
2021,2,1,12,754,731,638,-93
2021,2,1,13,799,793,640,-153
2021,2,1,14,821,826,643,-183
2021,2,1,15,821,835,607,-228
2021,2,1,16,824,848,601,-247
2021,2,1,17,803,849,602,-247
2021,2,1,18,792,848,603,-245
2021,2,1,19,783,842,601,-241
2021,2,1,20,765,836,603,-233
2021,2,1,21,759,843,602,-241
2021,2,1,22,771,866,604,-262
2021,2,1,23,801,903,618,-285
2021,2,2,0,856,937,641,-296
2021,2,2,1,856,931,638,-293
2021,2,2,2,850,904,640,-264
2021,2,2,3,818,874,641,-233
2021,2,2,4,785,835,640,-195
2021,2,2,5,751,806,638,-168
2021,2,2,6,708,799,642,-157
2021,2,2,7,708,795,640,-155
2021,2,2,8,714,799,638,-161
2021,2,2,9,725,812,626,-186
2021,2,2,10,751,823,568,-255
2021,2,2,11,791,859,644,-215
2021,2,2,12,862,902,648,-254
2021,2,2,13,915,948,714,-234
2021,2,2,14,918,970,719,-251
2021,2,2,15,878,964,688,-276
2021,2,2,16,832,948,689,-259
2021,2,2,17,760,924,706,-218
2021,2,2,18,716,918,742,-176
2021,2,2,19,690,906,703,-203
2021,2,2,20,674,889,701,-188
2021,2,2,21,666,866,692,-174
2021,2,2,22,677,849,684,-165
2021,2,2,23,736,887,703,-184
2021,2,3,0,800,936,717,-219
2021,2,3,1,831,940,714,-226
2021,2,3,2,826,928,674,-254
2021,2,3,3,809,897,647,-250
2021,2,3,4,774,858,649,-209
2021,2,3,5,741,831,648,-183
2021,2,3,6,788,818,648,-170
2021,2,3,7,793,821,645,-176
2021,2,3,8,798,830,648,-182
2021,2,3,9,816,835,647,-188
2021,2,3,10,848,853,647,-206
2021,2,3,11,894,885,657,-228
2021,2,3,12,967,946,738,-208
2021,2,3,13,1011,988,748,-240
2021,2,3,14,1009,991,721,-270
2021,2,3,15,952,949,631,-318
2021,2,3,16,879,888,644,-244
2021,2,3,17,796,848,602,-246
2021,2,3,18,754,806,525,-281
2021,2,3,19,717,769,517,-252
2021,2,3,20,685,736,517,-219
2021,2,3,21,674,725,515,-210
2021,2,3,22,687,735,536,-199
2021,2,3,23,736,789,553,-236
2021,2,4,0,813,852,554,-298
2021,2,4,1,834,863,555,-308
2021,2,4,2,833,861,559,-302
2021,2,4,3,823,842,559,-283
2021,2,4,4,790,807,556,-251
2021,2,4,5,758,783,557,-226
2021,2,4,6,765,-9999,-9999,-9999
2021,2,4,7,771,-9999,-9999,-9999
2021,2,4,8,784,-9999,-9999,-9999
2021,2,4,9,801,-9999,-9999,-9999
2021,2,4,10,828,-9999,-9999,-9999
2021,2,4,11,875,-9999,-9999,-9999
2021,2,4,12,969,-9999,-9999,-9999
2021,2,4,13,1026,-9999,-9999,-9999
2021,2,4,14,1019,-9999,-9999,-9999
2021,2,4,15,957,-9999,-9999,-9999
2021,2,4,16,885,-9999,-9999,-9999
2021,2,4,17,827,-9999,-9999,-9999
2021,2,4,18,761,-9999,-9999,-9999
2021,2,4,19,720,-9999,-9999,-9999
2021,2,4,20,707,-9999,-9999,-9999
2021,2,4,21,690,-9999,-9999,-9999
2021,2,4,22,705,-9999,-9999,-9999
2021,2,4,23,736,-9999,-9999,-9999
2021,2,5,0,812,-9999,-9999,-9999
2021,2,5,1,821,-9999,-9999,-9999
2021,2,5,2,806,-9999,-9999,-9999
2021,2,5,3,771,-9999,-9999,-9999
2021,2,5,4,729,-9999,-9999,-9999
2021,2,5,5,678,-9999,-9999,-9999
