Year,Month,Day,Hour,Forecast_Demand_MWh,Adjusted_Demand_MWh,Adjusted_Generation_MWh,Adjusted_Interchange_MWh
2015,7,1,5,4873,6068,4605,-1463
2015,7,1,6,4492,5575,4222,-1353
2015,7,1,7,4186,5229,3953,-1276
2015,7,1,8,4012,5003,3758,-1245
2015,7,1,9,3979,4925,3729,-1196
2015,7,1,10,4093,5040,3830,-1210
2015,7,1,11,4389,5371,4073,-1298
2015,7,1,12,4655,5655,4295,-1360
2015,7,1,13,5101,6325,4699,-1626
2015,7,1,14,5592,7200,5218,-1982
2015,7,1,15,6226,8004,5934,-2070
2015,7,1,16,6794,8435,6348,-2087
2015,7,1,17,7179,8773,6654,-2119
2015,7,1,18,7459,9035,6886,-2149
2015,7,1,19,7806,9381,6993,-2388
2015,7,1,20,7955,9686,7173,-2513
2015,7,1,21,8134,10006,7334,-2672
2015,7,1,22,8190,10096,7357,-2739
2015,7,1,23,7708,9897,7174,-2723
2015,7,2,0,7283,9493,6775,-2718
2015,7,2,1,6977,8961,6393,-2568
2015,7,2,2,6613,8409,6088,-2321
2015,7,2,3,5968,7545,5396,-2149
2015,7,2,4,5365,6689,4883,-1806
2015,7,2,5,4780,5950,4475,-1475
2015,7,2,6,4390,5431,4067,-1364
2015,7,2,7,4109,5060,3761,-1299
2015,7,2,8,3966,4817,3579,-1238
2015,7,2,9,3952,4763,3526,-1237
2015,7,2,10,4058,4895,3638,-1257
2015,7,2,11,4322,5185,3849,-1336
2015,7,2,12,4600,5496,4040,-1456
2015,7,2,13,5038,6122,4444,-1678
2015,7,2,14,5693,6971,4964,-2007
2015,7,2,15,6292,7843,5566,-2277
2015,7,2,16,6816,8585,5974,-2611
2015,7,2,17,7276,9174,6410,-2764
2015,7,2,18,7656,9400,6717,-2683
2015,7,2,19,7794,9246,6742,-2504
2015,7,2,20,7856,8872,6434,-2438
2015,7,2,21,7708,8498,6022,-2476
2015,7,2,22,7517,8334,5798,-2536
2015,7,2,23,7280,8140,5617,-2523
2015,7,3,0,6807,7825,5346,-2479
2015,7,3,1,6529,7568,5274,-2294
2015,7,3,2,6265,7250,5161,-2089
2015,7,3,3,5701,6694,4690,-2004
2015,7,3,4,5171,6037,4341,-1696
2015,7,3,5,4761,5431,4063,-1368
2015,7,3,6,4393,4999,3829,-1170
2015,7,3,7,4142,4668,3560,-1108
2015,7,3,8,3992,4464,3397,-1067
2015,7,3,9,3915,4391,3342,-1049
2015,7,3,10,3943,4435,3378,-1057
2015,7,3,11,3999,4576,3482,-1094
2015,7,3,12,4153,4841,3611,-1230
2015,7,3,13,4750,5578,4137,-1441
2015,7,3,14,5509,6498,4751,-1747
2015,7,3,15,6213,7421,5172,-2249
2015,7,3,16,6793,8257,5667,-2590
2015,7,3,17,7303,8988,6295,-2693
2015,7,3,18,7642,9484,6748,-2736
2015,7,3,19,7803,9749,7053,-2696
2015,7,3,20,7853,9963,7240,-2723
2015,7,3,21,7786,10028,7326,-2702
2015,7,3,22,7625,9796,7196,-2600
2015,7,3,23,7316,9207,6602,-2605
2015,7,4,0,6781,8503,5997,-2506
2015,7,4,1,6300,7997,5528,-2469
2015,7,4,2,6080,7488,5165,-2323
2015,7,4,3,5737,6901,4800,-2101
2015,7,4,4,5276,6260,4484,-1776
2015,7,4,5,4805,5611,4177,-1434
2015,7,4,6,4460,5158,3901,-1257
2015,7,4,7,4146,4789,3618,-1171
2015,7,4,8,3980,4552,3428,-1124
2015,7,4,9,3881,4410,3305,-1105
2015,7,4,10,3843,4364,3268,-1096
2015,7,4,11,3824,4377,3278,-1099
2015,7,4,12,3986,4561,3344,-1217
2015,7,4,13,4605,5205,3765,-1440
2015,7,4,14,5448,6146,4318,-1828
2015,7,4,15,6058,7136,4947,-2189
2015,7,4,16,6671,8052,5576,-2476
2015,7,4,17,7147,8804,6032,-2772
2015,7,4,18,7437,9300,6531,-2769
2015,7,4,19,7636,9596,6838,-2758
2015,7,4,20,7676,9675,6991,-2684
2015,7,4,21,7567,9394,6789,-2605
2015,7,4,22,7376,8976,6410,-2566
2015,7,4,23,7031,8438,5899,-2539
2015,7,5,0,6622,7856,5391,-2465
2015,7,5,1,6318,7371,5028,-2343
2015,7,5,2,6065,6793,4658,-2135
2015,7,5,3,5701,6466,4450,-2016
2015,7,5,4,5286,6036,4238,-1798
2015,7,5,5,4677,5487,4082,-1405
2015,7,5,6,4337,5051,3859,-1192
2015,7,5,7,4053,4714,3620,-1094
2015,7,5,8,3901,4479,3460,-1019
2015,7,5,9,3803,4366,3354,-1012
2015,7,5,10,3761,4323,3290,-1033
2015,7,5,11,3747,4369,3325,-1044
2015,7,5,12,3926,4563,3463,-1100
2015,7,5,13,4496,5331,3909,-1422
2015,7,5,14,5230,6386,4683,-1703
2015,7,5,15,5826,7347,5244,-2103
2015,7,5,16,6397,8184,5859,-2325
2015,7,5,17,6829,8883,6393,-2490
2015,7,5,18,7250,9305,6823,-2482
2015,7,5,19,7356,9510,6969,-2541
2015,7,5,20,7447,9455,6996,-2459
2015,7,5,21,7467,9235,6982,-2253
2015,7,5,22,7324,8795,6598,-2197
2015,7,5,23,7089,8010,5912,-2098
2015,7,6,0,6671,7469,5421,-2048
2015,7,6,1,6332,7105,5139,-1966
2015,7,6,2,6034,6710,4782,-1928
2015,7,6,3,5495,6193,4324,-1869
2015,7,6,4,5096,5543,3975,-1568
2015,7,6,5,4650,5027,3769,-1258
2015,7,6,6,4312,4617,3546,-1071
2015,7,6,7,4052,4354,3421,-933
2015,7,6,8,3913,4165,3327,-838
2015,7,6,9,3893,4150,3364,-786
2015,7,6,10,4064,4309,3366,-943
2015,7,6,11,4351,4675,3529,-1146
2015,7,6,12,4595,5014,3857,-1157
2015,7,6,13,4991,5571,4259,-1312
2015,7,6,14,5594,6413,4791,-1622
2015,7,6,15,6177,7253,5262,-1991
2015,7,6,16,6769,8110,5782,-2328
2015,7,6,17,7239,8866,6213,-2653
2015,7,6,18,7538,9400,6546,-2854
2015,7,6,19,7732,9598,6985,-2613
2015,7,6,20,7758,9493,7054,-2439
2015,7,6,21,7781,9328,6999,-2329
2015,7,6,22,7583,8853,6537,-2316
2015,7,6,23,7393,8402,5983,-2419
2015,7,7,0,6928,8002,5578,-2424
2015,7,7,1,6579,7699,5247,-2452
2015,7,7,2,6174,7274,5051,-2223
2015,7,7,3,5594,6644,4635,-2009
2015,7,7,4,5129,5941,4224,-1717
2015,7,7,5,4650,5309,3932,-1377
2015,7,7,6,4283,4870,3668,-1202
2015,7,7,7,4017,4551,3410,-1141
2015,7,7,8,3878,4360,3262,-1098
2015,7,7,9,3830,4311,3219,-1092
2015,7,7,10,3986,4495,3375,-1120
2015,7,7,11,4237,4890,3701,-1189
2015,7,7,12,4528,5217,4071,-1146
2015,7,7,13,4890,5702,4365,-1337
2015,7,7,14,5471,6375,4739,-1636
2015,7,7,15,6013,7237,5239,-1998
2015,7,7,16,6579,8035,5805,-2230
2015,7,7,17,6943,8654,6213,-2441
2015,7,7,18,7258,8984,6445,-2539
2015,7,7,19,7519,8933,6468,-2465
2015,7,7,20,7607,8711,6252,-2459
2015,7,7,21,7641,8474,5984,-2490
2015,7,7,22,7455,8143,5691,-2452
2015,7,7,23,7218,7768,5411,-2357
2015,7,8,0,6858,7333,5034,-2299
2015,7,8,1,6596,7119,4806,-2313
2015,7,8,2,6226,6842,4612,-2230
2015,7,8,3,5617,6261,4309,-1952
2015,7,8,4,5148,5586,3971,-1615
2015,7,8,5,4412,5029,3659,-1370
2015,7,8,6,4088,4628,3462,-1166
2015,7,8,7,3871,4366,3269,-1097
2015,7,8,8,3747,4206,3177,-1029
2015,7,8,9,3719,4197,3172,-1025
2015,7,8,10,3887,4388,3282,-1106
2015,7,8,11,4122,4755,3546,-1209
2015,7,8,12,4422,5077,3852,-1225
2015,7,8,13,4811,5617,4249,-1368
2015,7,8,14,5376,6405,4694,-1711
2015,7,8,15,5971,7242,5216,-2026
2015,7,8,16,6475,7995,5654,-2341
2015,7,8,17,6849,8717,6172,-2545
2015,7,8,18,7174,9330,6678,-2652
2015,7,8,19,7323,9725,7059,-2666
2015,7,8,20,7400,9854,7295,-2559
2015,7,8,21,7416,9748,7232,-2516
2015,7,8,22,7194,9472,7067,-2405
2015,7,8,23,6912,9102,6697,-2405
2015,7,9,0,6547,8556,6130,-2426
2015,7,9,1,6333,8111,5676,-2435
2015,7,9,2,6037,7720,5447,-2273
2015,7,9,3,5436,7064,5012,-2052
2015,7,9,4,5007,6348,4659,-1689
2015,7,9,5,4565,5641,4246,-1395
2015,7,9,6,4206,5180,3940,-1240
2015,7,9,7,3955,4870,3696,-1174
2015,7,9,8,3822,4670,3544,-1126
2015,7,9,9,3798,4620,3514,-1106
2015,7,9,10,3899,4813,3667,-1146
2015,7,9,11,4223,5176,3919,-1257
2015,7,9,12,4465,5520,4321,-1199
2015,7,9,13,4941,6138,4729,-1409
2015,7,9,14,5526,6944,5222,-1722
2015,7,9,15,6175,7788,5700,-2088
2015,7,9,16,6751,8548,6131,-2417
2015,7,9,17,7165,9213,6482,-2731
2015,7,9,18,7537,9790,7134,-2656
2015,7,9,19,7770,10187,7547,-2640
2015,7,9,20,7902,10465,7776,-2689
2015,7,9,21,7912,10422,7706,-2716
2015,7,9,22,7738,10117,7331,-2786
2015,7,9,23,7447,9695,6916,-2779
2015,7,10,0,7015,9126,6395,-2731
2015,7,10,1,6743,8697,6025,-2672
2015,7,10,2,6454,8185,5755,-2430
2015,7,10,3,5860,7431,5277,-2154
2015,7,10,4,5288,6607,4883,-1724
2015,7,10,5,4755,5851,4369,-1482
2015,7,10,6,4378,5370,4045,-1325
2015,7,10,7,4115,5099,3876,-1223
2015,7,10,8,3938,4777,3585,-1192
2015,7,10,9,3887,4677,3505,-1172
2015,7,10,10,3971,4839,3610,-1229
2015,7,10,11,4239,5104,3862,-1242
2015,7,10,12,4458,5457,4165,-1292
2015,7,10,13,4926,6112,4612,-1500
2015,7,10,14,5594,6921,5089,-1832
2015,7,10,15,6256,7775,5516,-2259
2015,7,10,16,6924,8561,6181,-2380
2015,7,10,17,7306,9311,6555,-2756
2015,7,10,18,7726,9914,7171,-2743
2015,7,10,19,7999,10311,7565,-2746
2015,7,10,20,8148,10521,7822,-2699
2015,7,10,21,8180,10601,7920,-2681
2015,7,10,22,7956,10482,7858,-2624
2015,7,10,23,7634,10069,7442,-2627
2015,7,11,0,7130,9427,6856,-2571
2015,7,11,1,6853,8824,6274,-2550
2015,7,11,2,6474,8349,6034,-2315
2015,7,11,3,5953,7675,5515,-2160
2015,7,11,4,5454,6916,5063,-1853
2015,7,11,5,4926,6232,4680,-1552
2015,7,11,6,4521,5682,4310,-1372
2015,7,11,7,4230,5330,4051,-1279
2015,7,11,8,4028,5068,3838,-1230
2015,7,11,9,3909,4908,3710,-1198
2015,7,11,10,3882,4868,3697,-1171
2015,7,11,11,3910,4932,3750,-1182
2015,7,11,12,4102,5179,3950,-1229
2015,7,11,13,4733,5986,4510,-1476
2015,7,11,14,5525,6985,5155,-1830
2015,7,11,15,6144,7951,5716,-2235
2015,7,11,16,6724,8788,6286,-2502
2015,7,11,17,7214,9528,6790,-2738
2015,7,11,18,7615,10039,7379,-2660
2015,7,11,19,7863,10309,7642,-2667
2015,7,11,20,8031,10344,7738,-2606
2015,7,11,21,7981,10272,7575,-2697
2015,7,11,22,7828,9763,7091,-2672
2015,7,11,23,7553,8954,6414,-2540
2015,7,12,0,7145,8305,5919,-2386
2015,7,12,1,6835,7967,5744,-2223
2015,7,12,2,6549,7580,5472,-2108
2015,7,12,3,5992,7037,5061,-1976
2015,7,12,4,5478,6379,4616,-1763
2015,7,12,5,4880,5778,4298,-1480
2015,7,12,6,4533,5325,4044,-1281
2015,7,12,7,4240,5027,3828,-1199
2015,7,12,8,4060,4815,3649,-1166
2015,7,12,9,3934,4705,3581,-1124
2015,7,12,10,3894,4676,3565,-1111
2015,7,12,11,3848,4736,3544,-1192
2015,7,12,12,4052,4907,3676,-1231
2015,7,12,13,4619,5617,4152,-1465
2015,7,12,14,5432,6558,4707,-1851
2015,7,12,15,6037,7272,5098,-2174
2015,7,12,16,6648,7875,5453,-2422
2015,7,12,17,7176,8509,5888,-2621
2015,7,12,18,7501,8997,6471,-2526
2015,7,12,19,7801,9102,6691,-2411
2015,7,12,20,7927,8920,6512,-2408
2015,7,12,21,8032,8585,6184,-2401
2015,7,12,22,7803,8248,5773,-2475
2015,7,12,23,7594,7882,5421,-2461
2015,7,13,0,7206,7540,5200,-2340
2015,7,13,1,6785,7376,5073,-2303
2015,7,13,2,6530,7049,4917,-2132
2015,7,13,3,5961,6497,4611,-1886
2015,7,13,4,5380,5828,4227,-1601
2015,7,13,5,4893,5232,3907,-1325
2015,7,13,6,4536,4801,3675,-1126
2015,7,13,7,4290,4532,3453,-1079
2015,7,13,8,4094,4385,3290,-1095
2015,7,13,9,4023,4368,3264,-1104
2015,7,13,10,4149,4581,3429,-1152
2015,7,13,11,4502,4959,3734,-1225
2015,7,13,12,4716,5327,4071,-1256
2015,7,13,13,5139,5920,4453,-1467
2015,7,13,14,5753,6725,4971,-1754
2015,7,13,15,6409,7614,5496,-2118
2015,7,13,16,7025,8478,6034,-2444
2015,7,13,17,7557,9215,6534,-2681
2015,7,13,18,8110,9854,7102,-2752
2015,7,13,19,8360,10196,7478,-2718
2015,7,13,20,8431,10203,7634,-2569
2015,7,13,21,8333,10188,7621,-2567
2015,7,13,22,8072,10102,7414,-2688
2015,7,13,23,7764,9752,7016,-2736
2015,7,14,0,7380,9278,6602,-2676
2015,7,14,1,7085,8926,6291,-2635
2015,7,14,2,6705,8439,6015,-2424
2015,7,14,3,6123,7694,5533,-2161
2015,7,14,4,5521,6894,5001,-1893
2015,7,14,5,4813,6157,4579,-1578
2015,7,14,6,4465,5684,4224,-1460
2015,7,14,7,4230,5402,3989,-1413
2015,7,14,8,4067,5210,3818,-1392
2015,7,14,9,4035,5147,3769,-1378
2015,7,14,10,4163,5304,3906,-1398
2015,7,14,11,4462,5682,4257,-1425
2015,7,14,12,4706,6028,4579,-1449
2015,7,14,13,5109,6584,4863,-1721
2015,7,14,14,5728,7331,5322,-2009
2015,7,14,15,6389,8073,5889,-2184
2015,7,14,16,6986,8598,6395,-2203
2015,7,14,17,7452,8823,6462,-2361
2015,7,14,18,7868,8841,6592,-2249
2015,7,14,19,7992,8827,6539,-2288
2015,7,14,20,8013,8809,6270,-2539
2015,7,14,21,7911,8846,6234,-2612
2015,7,14,22,7610,9031,6286,-2745
2015,7,14,23,7412,8994,6266,-2728
2015,7,15,0,7109,8670,5977,-2693
2015,7,15,1,6855,8377,5819,-2558
2015,7,15,2,6497,8036,5693,-2343
2015,7,15,3,5978,7414,5271,-2143
2015,7,15,4,5418,6687,4871,-1816
2015,7,15,5,4674,6105,4501,-1604
2015,7,15,6,4355,5688,4190,-1498
2015,7,15,7,4140,5446,4025,-1421
2015,7,15,8,4006,5288,3909,-1379
2015,7,15,9,3969,5230,3865,-1365
2015,7,15,10,4117,5400,3959,-1441
2015,7,15,11,4402,5781,4302,-1479
2015,7,15,12,4640,6056,4459,-1597
2015,7,15,13,5079,6468,4583,-1885
2015,7,15,14,5666,7049,5043,-2006
2015,7,15,15,6254,7770,5668,-2102
2015,7,15,16,6784,8450,6093,-2357
2015,7,15,17,7090,8985,6367,-2618
2015,7,15,18,7420,9144,6582,-2562
2015,7,15,19,7645,8929,6408,-2521
2015,7,15,20,7676,8566,6034,-2532
2015,7,15,21,7618,8259,5741,-2518
2015,7,15,22,7446,8047,5534,-2513
2015,7,15,23,7341,7815,5342,-2473
2015,7,16,0,7039,7639,5192,-2447
2015,7,16,1,6828,7502,5230,-2272
2015,7,16,2,6511,7232,5158,-2074
2015,7,16,3,5940,6685,4731,-1954
2015,7,16,4,5367,6075,4404,-1671
2015,7,16,5,4565,5479,4025,-1454
2015,7,16,6,4300,5103,3749,-1354
2015,7,16,7,4098,4887,3608,-1279
2015,7,16,8,4001,4779,3531,-1248
2015,7,16,9,4000,4809,3546,-1263
2015,7,16,10,4167,5047,3726,-1321
2015,7,16,11,4483,5463,4024,-1439
2015,7,16,12,4709,5810,4227,-1583
2015,7,16,13,5086,6305,4511,-1794
2015,7,16,14,5559,6900,4989,-1911
2015,7,16,15,6195,7493,5459,-2034
2015,7,16,16,6622,7923,5808,-2115
2015,7,16,17,6879,8203,6076,-2127
2015,7,16,18,7045,8305,6299,-2006
2015,7,16,19,7169,8177,6236,-1941
2015,7,16,20,7158,8101,6113,-1988
2015,7,16,21,6992,8092,6000,-2092
2015,7,16,22,6996,8060,5914,-2146
2015,7,16,23,6723,7943,5736,-2207
2015,7,17,0,6388,7721,5513,-2208
2015,7,17,1,6275,7608,5413,-2195
2015,7,17,2,6007,7346,5237,-2109
2015,7,17,3,5490,6784,4788,-1996
2015,7,17,4,4998,6148,4464,-1684
2015,7,17,5,4425,5592,4087,-1505
2015,7,17,6,4136,5194,3812,-1382
2015,7,17,7,3958,4902,3589,-1313
2015,7,17,8,3811,4759,3458,-1301
2015,7,17,9,3828,4738,3422,-1316
2015,7,17,10,3979,4882,3532,-1350
2015,7,17,11,4288,5200,3789,-1411
2015,7,17,12,4507,5516,4082,-1434
2015,7,17,13,4842,6034,4394,-1640
2015,7,17,14,5328,6625,4719,-1906
2015,7,17,15,5845,7299,5244,-2055
2015,7,17,16,6194,7859,5700,-2159
2015,7,17,17,6467,8363,6017,-2346
2015,7,17,18,6737,8671,6235,-2436
2015,7,17,19,6858,8802,6360,-2442
2015,7,17,20,6718,8692,6260,-2432
2015,7,17,21,6518,8431,6110,-2321
2015,7,17,22,6389,8159,5874,-2285
2015,7,17,23,6298,7804,5550,-2254
2015,7,18,0,5927,7386,5149,-2237
2015,7,18,1,5849,7240,5070,-2170
2015,7,18,2,5617,6965,4879,-2086
2015,7,18,3,5205,6522,4519,-2003
2015,7,18,4,4761,6017,4254,-1763
2015,7,18,5,4320,5534,4001,-1533
2015,7,18,6,4089,5159,3746,-1413
2015,7,18,7,3861,4925,3609,-1316
2015,7,18,8,3718,4746,3477,-1269
2015,7,18,9,3649,4677,3420,-1257
2015,7,18,10,3676,4709,3417,-1292
2015,7,18,11,3777,4809,3488,-1321
2015,7,18,12,3935,5074,3681,-1393
2015,7,18,13,4370,5812,4107,-1705
2015,7,18,14,4953,6676,4672,-2004
2015,7,18,15,5534,7544,5356,-2188
2015,7,18,16,5969,8145,5902,-2243
2015,7,18,17,6378,8652,6294,-2358
2015,7,18,18,6591,8980,6521,-2459
2015,7,18,19,6777,9012,6534,-2478
2015,7,18,20,6848,8632,6278,-2354
2015,7,18,21,6698,8194,5906,-2288
2015,7,18,22,6598,7903,5639,-2264
2015,7,18,23,6311,7586,5324,-2262
2015,7,19,0,6051,7275,5031,-2244
2015,7,19,1,5831,7103,4925,-2178
2015,7,19,2,5616,6941,4803,-2138
2015,7,19,3,5161,6475,4467,-2008
2015,7,19,4,4735,5948,4244,-1704
2015,7,19,5,4264,5432,3904,-1528
2015,7,19,6,3960,5031,3604,-1427
2015,7,19,7,3748,4772,3435,-1337
2015,7,19,8,3619,4593,3300,-1293
2015,7,19,9,3561,4500,3227,-1273
2015,7,19,10,3561,4509,3228,-1281
2015,7,19,11,3656,4564,3273,-1291
2015,7,19,12,3853,4825,3465,-1360
2015,7,19,13,4415,5628,3943,-1685
2015,7,19,14,4995,6563,4568,-1995
2015,7,19,15,5593,7375,5203,-2172
2015,7,19,16,6151,7993,5806,-2187
2015,7,19,17,6524,8505,6103,-2402
2015,7,19,18,6896,8860,6319,-2541
2015,7,19,19,7110,8959,6432,-2527
2015,7,19,20,7049,8889,6338,-2551
2015,7,19,21,6950,8964,6284,-2680
2015,7,19,22,6722,9049,6380,-2669
2015,7,19,23,6614,8916,6310,-2606
2015,7,20,0,6325,8543,5971,-2572
2015,7,20,1,6041,8201,5744,-2457
2015,7,20,2,5799,7793,5564,-2229
2015,7,20,3,5250,7142,5059,-2083
2015,7,20,4,4730,6353,4570,-1783
2015,7,20,5,4455,5697,4164,-1533
2015,7,20,6,4148,5251,3820,-1431
2015,7,20,7,3891,4961,3600,-1361
2015,7,20,8,3776,4790,3470,-1320
2015,7,20,9,3746,4766,3454,-1312
2015,7,20,10,3888,4944,3598,-1346
2015,7,20,11,4258,5301,3905,-1396
2015,7,20,12,4506,5678,4174,-1504
2015,7,20,13,4930,6362,4644,-1718
2015,7,20,14,5401,7142,5120,-2022
2015,7,20,15,6047,7924,5720,-2204
2015,7,20,16,6515,8528,6308,-2220
2015,7,20,17,6911,9102,6860,-2242
2015,7,20,18,7173,9449,7164,-2285
2015,7,20,19,7387,9573,7287,-2286
2015,7,20,20,7398,9576,7314,-2262
2015,7,20,21,7448,9559,7299,-2260
2015,7,20,22,7199,9361,7066,-2295
2015,7,20,23,6963,8916,6522,-2394
2015,7,21,0,6701,8458,6047,-2411
2015,7,21,1,6439,8167,5905,-2262
2015,7,21,2,6129,7857,5943,-1914
2015,7,21,3,5550,7217,5284,-1933
2015,7,21,4,5013,6481,4770,-1711
2015,7,21,5,4565,5851,4382,-1469
2015,7,21,6,4243,5386,4068,-1318
2015,7,21,7,4018,5106,3818,-1288
2015,7,21,8,3883,4956,3642,-1314
2015,7,21,9,3884,4916,3608,-1308
2015,7,21,10,3971,5095,3747,-1348
2015,7,21,11,4286,5488,4044,-1444
2015,7,21,12,4540,5853,4268,-1585
2015,7,21,13,4956,6485,4716,-1769
2015,7,21,14,5472,7221,5231,-1990
2015,7,21,15,6110,7969,5617,-2352
2015,7,21,16,6475,8640,5994,-2646
2015,7,21,17,6928,9095,6453,-2642
2015,7,21,18,7225,9213,6694,-2519
2015,7,21,19,7430,9274,6789,-2485
2015,7,21,20,7452,9207,6728,-2479
2015,7,21,21,7506,9097,6547,-2550
2015,7,21,22,7321,8986,6350,-2636
2015,7,21,23,7109,8858,6204,-2654
2015,7,22,0,6793,8603,5964,-2639
2015,7,22,1,6513,8348,5940,-2408
2015,7,22,2,6182,7997,5717,-2280
2015,7,22,3,5551,7371,5190,-2181
2015,7,22,4,5008,6673,4799,-1874
2015,7,22,5,4901,6031,4429,-1602
2015,7,22,6,4520,5629,4135,-1494
2015,7,22,7,4295,5338,3936,-1402
2015,7,22,8,4159,5162,3798,-1364
2015,7,22,9,4094,5099,3770,-1329
2015,7,22,10,4243,5290,3894,-1396
2015,7,22,11,4483,5690,4167,-1523
2015,7,22,12,4785,5978,4411,-1567
2015,7,22,13,5251,6637,4823,-1814
2015,7,22,14,5760,7422,5292,-2130
2015,7,22,15,6371,8212,5857,-2355
2015,7,22,16,6963,8807,6394,-2413
2015,7,22,17,7266,9152,6777,-2375
2015,7,22,18,7508,9137,6738,-2399
2015,7,22,19,7758,9100,6632,-2468
2015,7,22,20,7772,9110,6591,-2519
2015,7,22,21,7742,9275,6611,-2664
2015,7,22,22,7708,9341,6611,-2730
2015,7,22,23,7492,9183,6430,-2753
2015,7,23,0,7238,8849,6130,-2719
2015,7,23,1,6986,8568,6033,-2535
2015,7,23,2,6601,8179,5824,-2355
2015,7,23,3,6032,7530,5327,-2203
2015,7,23,4,5406,6814,4948,-1866
2015,7,23,5,4924,6132,4532,-1600
2015,7,23,6,4546,5695,4221,-1474
2015,7,23,7,4326,5426,3994,-1432
2015,7,23,8,4191,5241,3866,-1375
2015,7,23,9,4176,5209,3815,-1394
2015,7,23,10,4298,5372,3969,-1403
2015,7,23,11,4589,5751,4260,-1491
2015,7,23,12,4846,6081,4556,-1525
2015,7,23,13,5284,6739,4883,-1856
2015,7,23,14,5838,7510,5385,-2125
2015,7,23,15,6442,8259,5860,-2399
2015,7,23,16,6922,8937,6410,-2527
2015,7,23,17,7239,9476,6757,-2719
2015,7,23,18,7620,9767,7062,-2705
2015,7,23,19,7796,9848,7184,-2664
2015,7,23,20,7785,9964,7246,-2718
2015,7,23,21,7732,9958,7235,-2723
2015,7,23,22,7453,9804,7070,-2734
2015,7,23,23,7170,9562,6827,-2735
2015,7,24,0,7000,9171,6539,-2632
2015,7,24,1,6772,8853,6418,-2435
2015,7,24,2,6428,8451,6058,-2393
2015,7,24,3,5907,7776,5520,-2256
2015,7,24,4,5322,7080,5126,-1954
2015,7,24,5,4952,6440,4744,-1696
2015,7,24,6,4591,5938,4394,-1544
2015,7,24,7,4393,5643,4152,-1491
2015,7,24,8,4262,5468,4006,-1462
2015,7,24,9,4252,5401,3953,-1448
2015,7,24,10,4378,5556,4084,-1472
2015,7,24,11,4635,5863,4371,-1492
2015,7,24,12,4846,6107,4562,-1545
2015,7,24,13,5248,6462,4709,-1753
2015,7,24,14,5709,6964,4964,-2000
2015,7,24,15,6205,7489,5427,-2062
2015,7,24,16,6639,7758,5633,-2125
2015,7,24,17,6769,7750,5628,-2122
2015,7,24,18,6956,7489,5383,-2106
2015,7,24,19,7008,7403,5258,-2145
2015,7,24,20,6927,7444,5297,-2147
2015,7,24,21,6853,7551,5379,-2172
2015,7,24,22,6638,7558,5395,-2163
2015,7,24,23,6451,7394,5287,-2107
2015,7,25,0,6262,7190,5114,-2076
2015,7,25,1,6117,7087,5039,-2048
2015,7,25,2,5925,6770,4803,-1967
2015,7,25,3,5531,6334,4475,-1859
2015,7,25,4,5006,5862,4252,-1610
2015,7,25,5,4060,5369,4047,-1322
2015,7,25,6,3825,5098,3836,-1262
2015,7,25,7,3654,4799,3624,-1175
2015,7,25,8,3556,4626,3460,-1166
2015,7,25,9,3507,4549,3370,-1179
2015,7,25,10,3556,4635,3403,-1232
2015,7,25,11,3672,4826,3565,-1261
2015,7,25,12,3859,5020,3749,-1271
2015,7,25,13,4331,5635,4170,-1465
2015,7,25,14,4817,6268,4532,-1736
2015,7,25,15,5306,6834,4788,-2046
2015,7,25,16,5641,7275,5113,-2162
2015,7,25,17,5791,7633,5351,-2282
2015,7,25,18,5827,7997,5618,-2379
2015,7,25,19,5817,8336,5854,-2482
2015,7,25,20,5687,8598,6110,-2488
2015,7,25,21,5557,8586,6146,-2440
2015,7,25,22,5567,8237,5973,-2264
2015,7,25,23,5447,7750,5535,-2215
2015,7,26,0,5264,7323,5135,-2188
2015,7,26,1,5167,7098,4941,-2157
2015,7,26,2,5132,6792,4683,-2109
2015,7,26,3,4803,6315,4335,-1980
2015,7,26,4,4453,5772,4077,-1695
2015,7,26,5,4276,5248,3805,-1443
2015,7,26,6,3985,4861,3626,-1235
2015,7,26,7,3804,4594,3410,-1184
2015,7,26,8,3695,4405,3260,-1145
2015,7,26,9,3644,4326,3202,-1124
2015,7,26,10,3640,4333,3197,-1136
2015,7,26,11,3707,4449,3277,-1172
2015,7,26,12,3855,4673,3468,-1205
2015,7,26,13,4376,5337,3938,-1399
2015,7,26,14,5016,6123,4405,-1718
2015,7,26,15,5615,6907,4824,-2083
2015,7,26,16,6039,7638,5385,-2253
2015,7,26,17,6435,8327,5902,-2425
2015,7,26,18,6714,8846,6292,-2554
2015,7,26,19,6890,9134,6577,-2557
2015,7,26,20,6843,9224,6705,-2519
2015,7,26,21,6824,9010,6541,-2469
2015,7,26,22,6636,8597,6237,-2360
2015,7,26,23,6399,8185,5829,-2356
2015,7,27,0,6091,7776,5475,-2301
2015,7,27,1,5922,7537,5265,-2272
2015,7,27,2,5642,7152,5014,-2138
2015,7,27,3,5161,6580,4531,-2049
2015,7,27,4,4690,5965,4200,-1765
2015,7,27,5,4120,5395,3947,-1448
2015,7,27,6,3833,5034,3750,-1284
2015,7,27,7,3647,4795,3578,-1217
2015,7,27,8,3544,4691,3508,-1183
2015,7,27,9,3551,4707,3515,-1192
2015,7,27,10,3711,4931,3683,-1248
2015,7,27,11,4027,5346,3995,-1351
2015,7,27,12,4257,5666,4286,-1380
2015,7,27,13,4611,6125,4623,-1502
2015,7,27,14,5079,6631,4876,-1755
2015,7,27,15,5582,7225,5167,-2058
2015,7,27,16,5976,7732,5543,-2189
2015,7,27,17,6228,8136,5885,-2251
2015,7,27,18,6337,8188,5944,-2244
2015,7,27,19,6461,8062,5839,-2223
2015,7,27,20,6439,8042,5735,-2307
2015,7,27,21,6420,8049,5699,-2350
2015,7,27,22,6328,7989,5632,-2357
2015,7,27,23,6140,7841,5491,-2350
2015,7,28,0,5956,7592,5263,-2329
2015,7,28,1,5755,7495,5250,-2245
2015,7,28,2,5486,7154,4997,-2157
2015,7,28,3,5009,6646,4603,-2043
2015,7,28,4,4597,6059,4340,-1719
2015,7,28,5,4187,5520,4103,-1417
2015,7,28,6,3931,5156,3848,-1308
2015,7,28,7,3790,4912,3696,-1216
2015,7,28,8,3716,4810,3601,-1209
2015,7,28,9,3733,4801,3593,-1208
2015,7,28,10,3908,5024,3763,-1261
2015,7,28,11,4244,5457,4104,-1353
2015,7,28,12,4498,5746,4364,-1382
2015,7,28,13,4803,6127,4639,-1488
2015,7,28,14,5299,6624,5048,-1576
2015,7,28,15,5792,7174,5444,-1730
2015,7,28,16,6105,7591,5772,-1819
2015,7,28,17,6326,7919,5963,-1956
2015,7,28,18,6551,8307,6211,-2096
2015,7,28,19,6654,8415,6268,-2147
2015,7,28,20,6588,8367,6282,-2085
2015,7,28,21,6485,8299,6203,-2096
2015,7,28,22,6371,8260,6132,-2128
2015,7,28,23,6180,8027,5945,-2082
2015,7,29,0,5889,7753,5762,-1991
2015,7,29,1,5786,7583,5671,-1912
2015,7,29,2,5563,7276,5466,-1810
2015,7,29,3,5066,6705,4974,-1731
2015,7,29,4,4601,6060,4544,-1516
2015,7,29,5,4236,5665,4315,-1350
2015,7,29,6,3946,5290,4024,-1266
2015,7,29,7,3788,5026,3804,-1222
2015,7,29,8,3708,4888,3705,-1183
2015,7,29,9,3721,4832,3667,-1165
2015,7,29,10,3884,5038,3825,-1213
2015,7,29,11,4206,5425,4123,-1302
2015,7,29,12,4473,5692,4346,-1346
2015,7,29,13,4841,6199,4695,-1504
2015,7,29,14,5309,6872,5083,-1789
2015,7,29,15,5836,7662,5515,-2147
2015,7,29,16,6293,8470,6195,-2275
2015,7,29,17,6474,9065,6696,-2369
2015,7,29,18,6560,9248,7033,-2215
2015,7,29,19,6590,9280,7183,-2097
2015,7,29,20,6641,9240,7348,-1892
2015,7,29,21,6627,9000,7200,-1800
2015,7,29,22,6515,8543,6706,-1837
2015,7,29,23,6285,8182,6304,-1878
2015,7,30,0,5978,7856,5781,-2075
2015,7,30,1,5848,7687,5652,-2035
2015,7,30,2,5646,7374,5336,-2038
2015,7,30,3,5208,6817,4870,-1947
2015,7,30,4,4710,6158,4575,-1583
2015,7,30,5,4527,5352,4009,-1343
2015,7,30,6,4213,4963,3775,-1188
2015,7,30,7,4003,4703,3554,-1149
2015,7,30,8,3896,4560,3422,-1138
2015,7,30,9,3894,4514,3382,-1132
2015,7,30,10,4034,4736,3549,-1187
2015,7,30,11,4345,5159,3864,-1295
2015,7,30,12,4580,5472,4148,-1324
2015,7,30,13,4924,6028,4583,-1445
2015,7,30,14,5388,6757,5069,-1688
2015,7,30,15,5861,7500,5471,-2029
2015,7,30,16,6213,8164,5984,-2180
2015,7,30,17,6455,8779,6570,-2209
2015,7,30,18,6633,9313,6899,-2414
2015,7,30,19,6764,9652,7249,-2403
2015,7,30,20,6705,9753,7361,-2392
2015,7,30,21,6617,9465,7211,-2254
2015,7,30,22,6515,9014,6806,-2208
2015,7,30,23,6323,8383,6148,-2235
2015,7,31,0,6071,7877,5603,-2274
2015,7,31,1,5966,7675,5458,-2217
2015,7,31,2,5721,7324,5201,-2123
2015,7,31,3,5253,6772,4758,-2014
2015,7,31,4,4753,6127,4397,-1730
2015,7,31,5,4385,5536,4112,-1424
2015,7,31,6,4073,5124,3877,-1247
2015,7,31,7,3875,4857,3648,-1209
2015,7,31,8,3774,4708,3548,-1160
2015,7,31,9,3755,4705,3530,-1175
2015,7,31,10,3899,4892,3676,-1216
2015,7,31,11,4222,5234,3972,-1262
2015,7,31,12,4459,5516,4175,-1341
2015,7,31,13,4856,6063,4577,-1486
2015,7,31,14,5334,6769,5140,-1629
2015,7,31,15,5806,7399,5766,-1633
2015,7,31,16,6168,7923,6068,-1855
2015,7,31,17,6393,8254,6303,-1951
2015,7,31,18,6539,8151,6260,-1891
2015,7,31,19,6571,8029,6195,-1834
2015,7,31,20,6484,8132,6198,-1934
2015,7,31,21,6389,8292,6198,-2094
2015,7,31,22,6259,8263,6009,-2254
2015,7,31,23,5991,8029,5804,-2225
2015,8,1,0,5689,7691,5543,-2148
2015,8,1,1,5589,7448,5497,-1951
2015,8,1,2,5411,7057,5308,-1749
2015,8,1,3,5068,6653,4999,-1654
2015,8,1,4,4666,6086,4622,-1464
2015,8,1,5,4150,5522,4336,-1186
2015,8,1,6,3916,5133,4043,-1090
2015,8,1,7,3736,4881,3825,-1056
2015,8,1,8,3607,4727,3699,-1028
2015,8,1,9,3569,4683,3661,-1022
2015,8,1,10,3620,4690,3676,-1014
2015,8,1,11,3741,4811,3758,-1053
2015,8,1,12,3936,4960,3905,-1055
2015,8,1,13,4349,5436,4180,-1256
2015,8,1,14,4963,6102,4596,-1506
2015,8,1,15,5429,6850,5082,-1768
2015,8,1,16,5940,7374,5562,-1812
2015,8,1,17,6261,7407,5621,-1786
2015,8,1,18,6382,7077,5315,-1762
2015,8,1,19,6450,6816,4987,-1829
2015,8,1,20,6364,6636,4817,-1819
2015,8,1,21,6231,6527,4724,-1803
2015,8,1,22,6016,6457,4725,-1732
2015,8,1,23,5685,6346,4643,-1703
2015,8,2,0,5405,6215,4523,-1692
2015,8,2,1,5281,6256,4539,-1717
2015,8,2,2,5144,6074,4399,-1675
2015,8,2,3,4793,5721,4225,-1496
2015,8,2,4,4426,5254,3961,-1293
2015,8,2,5,4326,4810,3732,-1078
2015,8,2,6,4096,4480,3479,-1001
2015,8,2,7,3892,4265,3343,-922
2015,8,2,8,3731,4118,3224,-894
2015,8,2,9,3659,4039,3191,-848
2015,8,2,10,3661,4092,3185,-907
2015,8,2,11,3720,4239,3280,-959
2015,8,2,12,3870,4455,3461,-994
2015,8,2,13,4407,5049,3837,-1212
2015,8,2,14,5118,5734,4217,-1517
2015,8,2,15,5709,6246,4535,-1711
2015,8,2,16,6288,6514,4704,-1810
2015,8,2,17,6632,6809,4989,-1820
2015,8,2,18,6862,6996,5170,-1826
2015,8,2,19,7020,6946,5085,-1861
2015,8,2,20,7010,6928,5043,-1885
2015,8,2,21,6966,6928,5056,-1872
2015,8,2,22,6788,6894,5042,-1852
2015,8,2,23,6573,6755,4907,-1848
2015,8,3,0,6279,6615,4759,-1856
2015,8,3,1,6118,6667,4858,-1809
2015,8,3,2,5855,6459,4738,-1721
2015,8,3,3,5340,6011,4473,-1538
2015,8,3,4,4822,5470,4167,-1303
2015,8,3,5,4054,4952,3845,-1107
2015,8,3,6,3784,4627,3592,-1035
2015,8,3,7,3667,4422,3441,-981
2015,8,3,8,3578,4334,3356,-978
2015,8,3,9,3575,4363,3386,-977
2015,8,3,10,3777,4611,3567,-1044
2015,8,3,11,4166,5033,3925,-1108
2015,8,3,12,4398,5386,4291,-1095
2015,8,3,13,4773,5681,4470,-1211
2015,8,3,14,5271,5933,4523,-1410
2015,8,3,15,5816,6204,4611,-1593
2015,8,3,16,6264,6339,4735,-1604
2015,8,3,17,6579,6476,4813,-1663
2015,8,3,18,6712,6620,4899,-1721
2015,8,3,19,6731,6788,5016,-1772
2015,8,3,20,6621,7016,5193,-1823
2015,8,3,21,6441,7198,5300,-1898
2015,8,3,22,6195,7400,5439,-1961
2015,8,3,23,5998,7362,5386,-1976
2015,8,4,0,5813,7238,5348,-1890
2015,8,4,1,5776,7186,5328,-1858
2015,8,4,2,5516,6939,5175,-1764
2015,8,4,3,5100,6422,4872,-1550
2015,8,4,4,4605,5817,4464,-1353
2015,8,4,5,4134,5224,3994,-1230
2015,8,4,6,3847,4808,3739,-1069
2015,8,4,7,3738,4580,3571,-1009
2015,8,4,8,3638,4450,3479,-971
2015,8,4,9,3625,4458,3484,-974
2015,8,4,10,3821,4675,3639,-1036
2015,8,4,11,4177,5070,3960,-1110
2015,8,4,12,4393,5363,4230,-1133
2015,8,4,13,4764,5876,4610,-1266
2015,8,4,14,5286,6585,5185,-1400
2015,8,4,15,5810,7318,5814,-1504
2015,8,4,16,6280,7942,6155,-1787
2015,8,4,17,6569,8425,6494,-1931
2015,8,4,18,6751,8842,6886,-1956
2015,8,4,19,6834,9093,7088,-2005
2015,8,4,20,6861,9108,7108,-2000
2015,8,4,21,6729,9051,7164,-1887
2015,8,4,22,6656,9009,7083,-1926
2015,8,4,23,6374,8867,6942,-1925
2015,8,5,0,6104,8518,6666,-1852
2015,8,5,1,5980,8234,6248,-1986
2015,8,5,2,5714,7744,5842,-1902
2015,8,5,3,5252,7088,5333,-1755
2015,8,5,4,4731,6296,4807,-1489
2015,8,5,5,4318,5819,4514,-1305
2015,8,5,6,4013,5360,4105,-1255
2015,8,5,7,3855,5044,3852,-1192
2015,8,5,8,3756,4840,3688,-1152
2015,8,5,9,3726,4808,3655,-1153
2015,8,5,10,3920,4977,3789,-1188
2015,8,5,11,4203,5337,4071,-1266
2015,8,5,12,4429,5576,4286,-1290
2015,8,5,13,4879,6181,4738,-1443
2015,8,5,14,5370,6919,5236,-1683
2015,8,5,15,5930,7772,5821,-1951
2015,8,5,16,6430,8559,6261,-2298
2015,8,5,17,6798,9312,6804,-2508
2015,8,5,18,6985,9840,7427,-2413
2015,8,5,19,7131,10220,7789,-2431
2015,8,5,20,7144,10452,8209,-2243
2015,8,5,21,7075,10444,8211,-2233
2015,8,5,22,6888,10271,8044,-2227
2015,8,5,23,6615,9846,7519,-2327
2015,8,6,0,6339,9252,6756,-2496
2015,8,6,1,6195,8847,6348,-2499
2015,8,6,2,5910,8339,6074,-2265
2015,8,6,3,5423,7618,5514,-2104
2015,8,6,4,4888,6805,4971,-1834
2015,8,6,5,4443,5903,4378,-1525
2015,8,6,6,4109,5385,4062,-1323
2015,8,6,7,3901,5033,3745,-1288
2015,8,6,8,3773,4812,3573,-1239
2015,8,6,9,3744,4748,3540,-1208
2015,8,6,10,3878,4887,3641,-1246
2015,8,6,11,4165,5257,3977,-1280
2015,8,6,12,4437,5527,4223,-1304
2015,8,6,13,4847,6124,4731,-1393
2015,8,6,14,5344,6899,5313,-1586
2015,8,6,15,5961,7703,5951,-1752
2015,8,6,16,6518,8469,6576,-1893
2015,8,6,17,6884,9196,7003,-2193
2015,8,6,18,7172,9734,7398,-2336
2015,8,6,19,7432,10095,7691,-2404
2015,8,6,20,7486,10284,7925,-2359
2015,8,6,21,7347,10369,7990,-2379
2015,8,6,22,7273,10315,7801,-2514
2015,8,6,23,6911,9953,7460,-2493
2015,8,7,0,6541,9378,6861,-2517
2015,8,7,1,6343,8993,6631,-2362
2015,8,7,2,6040,8430,6203,-2227
2015,8,7,3,5507,7703,5555,-2148
2015,8,7,4,4984,6920,5048,-1872
2015,8,7,5,4672,6182,4596,-1586
2015,8,7,6,4299,5695,4242,-1453
2015,8,7,7,4053,5334,3924,-1410
2015,8,7,8,3915,5123,3755,-1368
2015,8,7,9,3877,5055,3706,-1349
2015,8,7,10,4015,5247,3856,-1391
2015,8,7,11,4305,5617,4158,-1459
2015,8,7,12,4528,5865,4405,-1460
2015,8,7,13,4969,6425,4839,-1586
2015,8,7,14,5512,7091,5275,-1816
2015,8,7,15,6151,7819,5705,-2114
2015,8,7,16,6773,8417,6157,-2260
2015,8,7,17,7106,8754,6321,-2433
2015,8,7,18,7306,8714,6238,-2476
2015,8,7,19,7468,8807,6428,-2379
2015,8,7,20,7505,8960,6515,-2445
2015,8,7,21,7452,9029,6571,-2458
2015,8,7,22,7174,9065,6610,-2455
2015,8,7,23,6714,8884,6444,-2440
2015,8,8,0,6347,8414,6048,-2366
2015,8,8,1,6215,8115,5912,-2203
2015,8,8,2,5919,7622,5641,-1981
2015,8,8,3,5487,7049,5162,-1887
2015,8,8,4,5001,6344,4624,-1720
2015,8,8,5,4710,5715,4261,-1454
2015,8,8,6,4356,5263,3933,-1330
2015,8,8,7,4122,4972,3703,-1269
2015,8,8,8,3949,4755,3513,-1242
2015,8,8,9,3872,4677,3447,-1230
2015,8,8,10,3883,4747,3505,-1242
2015,8,8,11,3981,4936,3643,-1293
2015,8,8,12,4147,5143,3770,-1373
2015,8,8,13,4623,5849,4260,-1589
2015,8,8,14,5322,6619,4793,-1826
2015,8,8,15,5900,7255,5323,-1932
2015,8,8,16,6404,7556,5642,-1914
2015,8,8,17,6811,7637,5769,-1868
2015,8,8,18,7043,7629,5825,-1804
2015,8,8,19,7210,7641,5849,-1792
2015,8,8,20,7264,7833,5904,-1929
2015,8,8,21,6934,8062,5934,-2128
2015,8,8,22,6703,8099,5841,-2258
2015,8,8,23,6590,7918,5599,-2319
2015,8,9,0,6300,7617,5376,-2241
2015,8,9,1,6050,7488,5291,-2197
2015,8,9,2,5726,7097,5016,-2081
2015,8,9,3,5414,6572,4734,-1838
2015,8,9,4,4972,5978,4375,-1603
2015,8,9,5,4498,5419,4029,-1390
2015,8,9,6,4182,4996,3750,-1246
2015,8,9,7,3994,4701,3526,-1175
2015,8,9,8,3837,4555,3435,-1120
2015,8,9,9,3758,4445,3383,-1062
2015,8,9,10,3742,4429,3372,-1057
2015,8,9,11,3808,4499,3387,-1112
2015,8,9,12,3948,4680,3532,-1148
2015,8,9,13,4526,5422,3957,-1465
2015,8,9,14,5214,6359,4503,-1856
2015,8,9,15,5831,7222,5038,-2184
2015,8,9,16,6444,8048,5677,-2371
2015,8,9,17,6895,8745,6164,-2581
2015,8,9,18,7093,9262,6627,-2635
2015,8,9,19,7254,9628,6986,-2642
2015,8,9,20,7259,9921,7284,-2637
2015,8,9,21,7209,10035,7529,-2506
2015,8,9,22,6995,9893,7477,-2416
2015,8,9,23,6661,9416,7035,-2381
2015,8,10,0,6409,8850,6670,-2180
2015,8,10,1,6250,8495,6352,-2143
2015,8,10,2,5897,7956,5894,-2062
2015,8,10,3,5389,7206,5392,-1814
2015,8,10,4,4886,6369,4693,-1676
2015,8,10,5,4611,5613,4111,-1502
2015,8,10,6,4251,5165,3780,-1385
2015,8,10,7,4000,4845,3533,-1312
2015,8,10,8,3856,4662,3397,-1265
2015,8,10,9,3809,4629,3364,-1265
2015,8,10,10,3961,4812,3495,-1317
2015,8,10,11,4283,5192,3819,-1373
2015,8,10,12,4518,5508,4060,-1448
2015,8,10,13,4952,6029,4345,-1684
2015,8,10,14,5518,6793,4833,-1960
2015,8,10,15,6151,7660,5429,-2231
2015,8,10,16,6775,8428,5978,-2450
2015,8,10,17,7138,9134,6635,-2499
2015,8,10,18,7408,9702,7207,-2495
2015,8,10,19,7692,10105,7546,-2559
2015,8,10,20,7820,10318,7724,-2594
2015,8,10,21,7904,10382,7814,-2568
2015,8,10,22,7755,10248,7701,-2547
2015,8,10,23,7478,9918,7379,-2539
2015,8,11,0,7037,9384,6915,-2469
2015,8,11,1,6833,9007,6621,-2386
2015,8,11,2,6451,8411,6104,-2307
2015,8,11,3,5824,7628,5502,-2126
2015,8,11,4,5271,6745,4844,-1901
2015,8,11,5,4697,6050,4387,-1663
2015,8,11,6,4359,5536,4022,-1514
2015,8,11,7,4074,5199,3806,-1393
2015,8,11,8,3927,4948,3628,-1320
2015,8,11,9,3887,4852,3557,-1295
2015,8,11,10,4029,4977,3612,-1365
2015,8,11,11,4336,5361,3876,-1485
2015,8,11,12,4540,5585,4070,-1515
2015,8,11,13,4997,6195,4447,-1748
2015,8,11,14,5569,6952,4937,-2015
2015,8,11,15,6157,7794,5460,-2334
2015,8,11,16,6802,8610,5991,-2619
2015,8,11,17,7265,9357,6656,-2701
2015,8,11,18,7578,9978,7197,-2781
2015,8,11,19,7894,10403,7666,-2737
2015,8,11,20,7963,10630,7981,-2649
2015,8,11,21,7964,10741,8212,-2529
2015,8,11,22,7909,10604,8143,-2461
2015,8,11,23,7561,10158,7593,-2565
2015,8,12,0,7155,9637,7175,-2462
2015,8,12,1,6939,9300,6944,-2356
2015,8,12,2,6569,8651,6349,-2302
2015,8,12,3,5897,7867,5658,-2209
2015,8,12,4,5314,7037,5125,-1912
2015,8,12,5,4764,6303,4691,-1612
2015,8,12,6,4441,5851,4310,-1541
2015,8,12,7,4117,5539,4071,-1468
2015,8,12,8,3976,5342,3916,-1426
2015,8,12,9,3942,5240,3827,-1413
2015,8,12,10,4124,5380,3952,-1428
2015,8,12,11,4391,5759,4256,-1503
2015,8,12,12,4563,5973,4448,-1525
2015,8,12,13,5135,6547,4776,-1771
2015,8,12,14,5712,7342,5237,-2105
2015,8,12,15,6123,8168,5891,-2277
2015,8,12,16,6659,8899,6449,-2450
2015,8,12,17,7112,9507,6947,-2560
2015,8,12,18,7387,9994,7431,-2563
2015,8,12,19,7676,10283,7664,-2619
2015,8,12,20,7741,10396,7809,-2587
2015,8,12,21,7734,10348,7752,-2596
2015,8,12,22,7700,10112,7459,-2653
2015,8,12,23,7438,9790,7168,-2622
2015,8,13,0,7064,9316,6800,-2516
2015,8,13,1,6830,8976,6576,-2400
2015,8,13,2,6445,8463,6263,-2200
2015,8,13,3,5854,7765,5593,-2172
2015,8,13,4,5285,6995,5082,-1913
2015,8,13,5,4703,6326,4661,-1665
2015,8,13,6,4326,5884,4430,-1454
2015,8,13,7,4059,5580,4219,-1361
2015,8,13,8,3926,5416,4099,-1317
2015,8,13,9,3904,5381,4078,-1303
2015,8,13,10,4058,5515,4188,-1327
2015,8,13,11,4387,5898,4453,-1445
2015,8,13,12,4591,6098,4646,-1452
2015,8,13,13,4943,6587,5000,-1587
2015,8,13,14,5338,7214,5414,-1800
2015,8,13,15,5773,7845,5866,-1979
2015,8,13,16,6160,8383,6045,-2338
2015,8,13,17,6446,8868,6326,-2542
2015,8,13,18,6588,8835,6327,-2508
2015,8,13,19,6745,8617,6191,-2426
2015,8,13,20,6791,8465,6141,-2324
2015,8,13,21,6774,8135,5868,-2267
2015,8,13,22,6632,7814,5495,-2319
2015,8,13,23,6365,7641,5204,-2437
2015,8,14,0,6079,7417,4969,-2448
2015,8,14,1,5958,7367,5047,-2320
2015,8,14,2,5634,7030,4926,-2104
2015,8,14,3,5183,6481,4518,-1963
2015,8,14,4,4693,5830,4101,-1729
2015,8,14,5,4299,5254,3781,-1473
2015,8,14,6,3998,4810,3572,-1238
2015,8,14,7,3790,4555,3392,-1163
2015,8,14,8,3691,4384,3304,-1080
2015,8,14,9,3692,4359,3259,-1100
2015,8,14,10,3828,4518,3363,-1155
2015,8,14,11,4116,4942,3637,-1305
2015,8,14,12,4325,5214,3923,-1291
2015,8,14,13,4741,5721,4286,-1435
2015,8,14,14,5249,6415,4759,-1656
2015,8,14,15,5751,7170,5249,-1921
2015,8,14,16,6228,7775,5555,-2220
2015,8,14,17,6558,8413,6083,-2330
2015,8,14,18,6713,8962,6691,-2271
2015,8,14,19,6830,9320,7082,-2238
2015,8,14,20,6805,9524,7179,-2345
2015,8,14,21,6652,9521,7217,-2304
2015,8,14,22,6484,9198,6987,-2211
2015,8,14,23,6201,8592,6298,-2294
2015,8,15,0,5857,7918,5683,-2235
2015,8,15,1,5633,7549,5329,-2220
2015,8,15,2,5395,7093,4967,-2126
2015,8,15,3,4956,6553,4538,-2015
2015,8,15,4,4546,5943,4182,-1761
2015,8,15,5,4408,5376,3893,-1483
2015,8,15,6,4115,4942,3684,-1258
2015,8,15,7,3895,4666,3480,-1186
2015,8,15,8,3751,4483,3347,-1136
2015,8,15,9,3693,4374,3259,-1115
2015,8,15,10,3723,4394,3257,-1137
2015,8,15,11,3852,4529,3340,-1189
2015,8,15,12,3977,4697,3506,-1191
2015,8,15,13,4410,5311,3969,-1342
2015,8,15,14,5061,6172,4588,-1584
2015,8,15,15,5658,6990,5155,-1835
2015,8,15,16,6154,7720,5562,-2158
2015,8,15,17,6563,8385,6080,-2305
2015,8,15,18,6731,8877,6545,-2332
2015,8,15,19,6823,8977,6659,-2318
2015,8,15,20,6807,8785,6427,-2358
2015,8,15,21,6671,8513,6200,-2313
2015,8,15,22,6510,8182,5904,-2278
2015,8,15,23,6232,7761,5521,-2240
2015,8,16,0,5963,7247,5101,-2146
2015,8,16,1,5814,6900,4878,-2022
2015,8,16,2,5530,6471,4479,-1992
2015,8,16,3,5105,6006,4102,-1904
2015,8,16,4,4686,5439,3788,-1651
2015,8,16,5,4164,4938,3537,-1401
2015,8,16,6,3874,4593,3417,-1176
2015,8,16,7,3687,4353,3229,-1124
2015,8,16,8,3558,4185,3168,-1017
2015,8,16,9,3502,4106,3119,-987
2015,8,16,10,3537,4131,3128,-1003
2015,8,16,11,3616,4255,3162,-1093
2015,8,16,12,3756,4448,3289,-1159
2015,8,16,13,4203,5160,3784,-1376
2015,8,16,14,4896,6060,4380,-1680
2015,8,16,15,5509,6987,5013,-1974
2015,8,16,16,5951,7768,5564,-2204
2015,8,16,17,6360,8392,6168,-2224
2015,8,16,18,6648,8898,6564,-2334
2015,8,16,19,6838,9262,6948,-2314
2015,8,16,20,6789,9381,6986,-2395
2015,8,16,21,6717,9187,6937,-2250
2015,8,16,22,6646,8807,6409,-2398
2015,8,16,23,6419,8425,6112,-2313
2015,8,17,0,6181,8009,5757,-2252
2015,8,17,1,6004,7760,5543,-2217
2015,8,17,2,5665,7197,5130,-2067
2015,8,17,3,5141,6540,4575,-1965
2015,8,17,4,4644,5829,4150,-1679
2015,8,17,5,4315,5276,3851,-1425
2015,8,17,6,4019,4898,3689,-1209
2015,8,17,7,3820,4636,3494,-1142
2015,8,17,8,3714,4497,3384,-1113
2015,8,17,9,3724,4501,3387,-1114
2015,8,17,10,3928,4755,3568,-1187
2015,8,17,11,4295,5233,3955,-1278
2015,8,17,12,4537,5527,4242,-1285
2015,8,17,13,4904,6004,4633,-1371
2015,8,17,14,5498,6675,4998,-1677
2015,8,17,15,6106,7545,5577,-1968
2015,8,17,16,6601,8352,6145,-2207
2015,8,17,17,7070,9093,6649,-2444
2015,8,17,18,7208,9651,7056,-2595
2015,8,17,19,7296,10339,7663,-2676
2015,8,17,20,7229,10079,7491,-2588
2015,8,17,21,7113,9686,7048,-2638
2015,8,17,22,6942,9313,6664,-2649
2015,8,17,23,6704,8845,6215,-2630
2015,8,18,0,6475,8351,5886,-2465
2015,8,18,1,6382,8108,5629,-2479
2015,8,18,2,5948,7446,5194,-2252
2015,8,18,3,5452,6707,4715,-1992
2015,8,18,4,4928,5988,4272,-1716
2015,8,18,5,4607,5421,3966,-1455
2015,8,18,6,4264,5049,3817,-1232
2015,8,18,7,4026,4785,3606,-1179
2015,8,18,8,3903,4631,3491,-1140
2015,8,18,9,3894,4599,3470,-1129
2015,8,18,10,4041,4798,3605,-1193
2015,8,18,11,4382,5274,3981,-1293
2015,8,18,12,4595,5567,4266,-1301
2015,8,18,13,4886,6099,4673,-1426
2015,8,18,14,5449,6871,5125,-1746
2015,8,18,15,6063,7710,5683,-2027
2015,8,18,16,6598,8473,6192,-2281
2015,8,18,17,7098,9195,6589,-2606
2015,8,18,18,7341,9787,7016,-2771
2015,8,18,19,7533,10094,7365,-2729
2015,8,18,20,7566,10308,7572,-2736
2015,8,18,21,7527,10355,7653,-2702
2015,8,18,22,7372,10061,7347,-2714
2015,8,18,23,7069,9584,6906,-2678
2015,8,19,0,6732,9058,6446,-2612
2015,8,19,1,6553,8738,6244,-2494
2015,8,19,2,6149,8053,5842,-2211
2015,8,19,3,5565,7276,5199,-2077
2015,8,19,4,4994,6508,4728,-1780
2015,8,19,5,4701,5895,4338,-1557
2015,8,19,6,4346,5450,4104,-1346
2015,8,19,7,4081,5116,3868,-1248
2015,8,19,8,3940,4937,3726,-1211
2015,8,19,9,3901,4900,3683,-1217
2015,8,19,10,4065,5113,3861,-1252
2015,8,19,11,4416,5601,4236,-1365
2015,8,19,12,4624,5844,4486,-1358
2015,8,19,13,4999,6275,4757,-1518
2015,8,19,14,5558,7013,5245,-1768
2015,8,19,15,6158,7855,5858,-1997
2015,8,19,16,6667,8684,6320,-2364
2015,8,19,17,7105,9435,6788,-2647
2015,8,19,18,7408,10011,7259,-2752
2015,8,19,19,7700,10448,7723,-2725
2015,8,19,20,7771,10523,7837,-2686
2015,8,19,21,7748,10203,7548,-2655
2015,8,19,22,7675,9857,7135,-2722
2015,8,19,23,7358,9398,6758,-2640
2015,8,20,0,6959,8975,6372,-2603
2015,8,20,1,6783,8743,6263,-2480
2015,8,20,2,6332,8129,5946,-2183
2015,8,20,3,5796,7345,5168,-2177
2015,8,20,4,5236,6584,4716,-1868
2015,8,20,5,4708,5930,4390,-1540
2015,8,20,6,4356,5484,4179,-1305
2015,8,20,7,4113,5206,3934,-1272
2015,8,20,8,3980,5053,3827,-1226
2015,8,20,9,3965,4988,3781,-1207
2015,8,20,10,4147,5159,3913,-1246
2015,8,20,11,4489,5618,4297,-1321
2015,8,20,12,4694,5869,4526,-1343
2015,8,20,13,5010,6356,4862,-1494
2015,8,20,14,5479,7174,5421,-1753
2015,8,20,15,6169,8002,5933,-2069
2015,8,20,16,6732,8839,6572,-2267
2015,8,20,17,7171,9483,7026,-2457
2015,8,20,18,7359,9900,7408,-2492
2015,8,20,19,7574,10113,7877,-2236
2015,8,20,20,7678,10061,7799,-2262
2015,8,20,21,7585,10098,7841,-2257
2015,8,20,22,7432,9952,7682,-2270
2015,8,20,23,7284,9395,6978,-2417
2015,8,21,0,6907,8810,6431,-2379
2015,8,21,1,6731,8450,6037,-2413
2015,8,21,2,6310,7884,5597,-2287
2015,8,21,3,5730,7206,5045,-2161
2015,8,21,4,5173,6519,4659,-1860
2015,8,21,5,4760,5892,4247,-1645
2015,8,21,6,4378,5466,4010,-1456
2015,8,21,7,4105,5190,3790,-1400
2015,8,21,8,3956,4980,3617,-1363
2015,8,21,9,3916,4914,3562,-1352
2015,8,21,10,4079,5091,3700,-1391
2015,8,21,11,4441,5535,4043,-1492
2015,8,21,12,4661,5795,4360,-1435
2015,8,21,13,5055,6302,4693,-1609
2015,8,21,14,5653,7076,5234,-1842
2015,8,21,15,6246,7950,5775,-2175
2015,8,21,16,6815,8763,6510,-2253
2015,8,21,17,7306,9418,6933,-2485
2015,8,21,18,7634,9813,7349,-2464
2015,8,21,19,7866,10101,7742,-2359
2015,8,21,20,7993,10224,7968,-2256
2015,8,21,21,7990,10181,7932,-2249
2015,8,21,22,7777,9943,7637,-2306
2015,8,21,23,7412,9525,7212,-2313
2015,8,22,0,6998,8969,6302,-2667
2015,8,22,1,6774,8693,6135,-2558
2015,8,22,2,6366,8129,5757,-2372
2015,8,22,3,5883,7546,5389,-2157
2015,8,22,4,5362,6877,4970,-1907
2015,8,22,5,4948,6269,4688,-1581
2015,8,22,6,4597,5771,4309,-1462
2015,8,22,7,4312,5431,4011,-1420
2015,8,22,8,4126,5200,3837,-1363
2015,8,22,9,4032,5083,3740,-1343
2015,8,22,10,4047,5080,3722,-1358
2015,8,22,11,4180,5210,3824,-1386
2015,8,22,12,4293,5406,3995,-1411
2015,8,22,13,4831,6174,4559,-1615
2015,8,22,14,5549,7176,5247,-1929
2015,8,22,15,6175,8192,6001,-2191
2015,8,22,16,6777,9086,6579,-2507
2015,8,22,17,7231,9791,7333,-2458
2015,8,22,18,7497,10238,7747,-2491
2015,8,22,19,7704,10318,7795,-2523
2015,8,22,20,7857,9993,7558,-2435
2015,8,22,21,7872,9631,7215,-2416
2015,8,22,22,7773,9183,6861,-2322
2015,8,22,23,7466,8646,6069,-2577
2015,8,23,0,7145,8237,5665,-2572
2015,8,23,1,6896,8061,5689,-2372
2015,8,23,2,6396,7680,5513,-2167
2015,8,23,3,5892,7138,5001,-2137
2015,8,23,4,5371,6500,4655,-1845
2015,8,23,5,5030,5945,4333,-1612
2015,8,23,6,4599,5515,4027,-1488
2015,8,23,7,4272,5271,3824,-1447
2015,8,23,8,4083,5014,3613,-1401
2015,8,23,9,3967,4871,3508,-1363
2015,8,23,10,3948,4865,3490,-1375
2015,8,23,11,4031,4962,3561,-1401
2015,8,23,12,4139,5154,3766,-1388
2015,8,23,13,4755,5869,4303,-1566
2015,8,23,14,5500,6851,4920,-1931
2015,8,23,15,6220,7778,5607,-2171
2015,8,23,16,6799,8664,6343,-2321
2015,8,23,17,7370,9412,6815,-2597
2015,8,23,18,7686,9958,7336,-2622
2015,8,23,19,7865,10222,7546,-2676
2015,8,23,20,7980,10371,7695,-2676
2015,8,23,21,7949,10461,7658,-2803
2015,8,23,22,7775,10431,7598,-2833
2015,8,23,23,7427,10182,7490,-2692
2015,8,24,0,7115,9639,7014,-2625
2015,8,24,1,6887,9323,6812,-2511
2015,8,24,2,6387,8655,6462,-2193
2015,8,24,3,5803,7732,5758,-1974
2015,8,24,4,5222,6846,5189,-1657
2015,8,24,5,4822,6126,4697,-1429
2015,8,24,6,4470,5602,4334,-1268
2015,8,24,7,4239,5253,3991,-1262
2015,8,24,8,4089,5047,3822,-1225
2015,8,24,9,4056,4979,3768,-1211
2015,8,24,10,4245,5225,4034,-1191
2015,8,24,11,4694,5741,4400,-1341
2015,8,24,12,4906,5987,4621,-1366
2015,8,24,13,5193,6393,4766,-1627
2015,8,24,14,5797,7176,5336,-1840
2015,8,24,15,6489,7978,5860,-2118
2015,8,24,16,7090,8624,6514,-2110
2015,8,24,17,7704,9086,6986,-2100
2015,8,24,18,8139,9315,7501,-1814
2015,8,24,19,8468,9552,7650,-1902
2015,8,24,20,8596,9715,7849,-1866
2015,8,24,21,8632,9817,7796,-2021
2015,8,24,22,8347,9806,7616,-2190
2015,8,24,23,7992,9589,7249,-2340
2015,8,25,0,7619,9993,7505,-2488
2015,8,25,1,7290,8954,6408,-2546
2015,8,25,2,6843,8346,5997,-2349
2015,8,25,3,6115,7514,5264,-2250
2015,8,25,4,5510,6674,4785,-1889
2015,8,25,5,4912,6020,4398,-1622
2015,8,25,6,4546,5563,4067,-1496
2015,8,25,7,4258,5239,3849,-1390
2015,8,25,8,4101,5051,3696,-1355
2015,8,25,9,4060,5023,3679,-1344
2015,8,25,10,4251,5297,3885,-1412
2015,8,25,11,4675,5827,4285,-1542
2015,8,25,12,4880,6057,4323,-1734
2015,8,25,13,5245,6492,4644,-1848
2015,8,25,14,5899,7221,5170,-2051
2015,8,25,15,6581,8089,5885,-2204
2015,8,25,16,7185,8913,6474,-2439
2015,8,25,17,7798,9638,7142,-2496
2015,8,25,18,8213,10232,7720,-2512
2015,8,25,19,8518,10639,8161,-2478
2015,8,25,20,8676,10884,8520,-2364
2015,8,25,21,8658,10987,8608,-2379
2015,8,25,22,8460,10877,8530,-2347
2015,8,25,23,8125,10501,8256,-2245
2015,8,26,0,7639,9990,7770,-2220
2015,8,26,1,7418,9671,7363,-2308
2015,8,26,2,6860,8946,6686,-2260
2015,8,26,3,6169,8053,5862,-2191
2015,8,26,4,5516,7151,5193,-1958
2015,8,26,5,4875,6396,4665,-1731
2015,8,26,6,4486,5898,4399,-1499
2015,8,26,7,4180,5553,4161,-1392
2015,8,26,8,4034,5330,3959,-1371
2015,8,26,9,3992,5273,3906,-1367
2015,8,26,10,4189,5488,4067,-1421
2015,8,26,11,4613,6009,4500,-1509
2015,8,26,12,4774,6211,4795,-1416
2015,8,26,13,5069,6609,4975,-1634
2015,8,26,14,5643,7344,5472,-1872
2015,8,26,15,6235,8189,6122,-2067
2015,8,26,16,6793,9005,6892,-2113
2015,8,26,17,7364,9737,7507,-2230
2015,8,26,18,7689,10312,7894,-2418
2015,8,26,19,8004,10665,8258,-2407
2015,8,26,20,8089,10795,8516,-2279
2015,8,26,21,8027,10595,8294,-2301
2015,8,26,22,7855,10119,7737,-2382
2015,8,26,23,7506,9571,7218,-2353
2015,8,27,0,7072,8909,6646,-2263
2015,8,27,1,6855,8532,6339,-2193
2015,8,27,2,6363,7809,5710,-2099
2015,8,27,3,5711,7016,5070,-1946
2015,8,27,4,5098,6196,4453,-1743
2015,8,27,5,4619,5565,4126,-1439
2015,8,27,6,4269,5168,3910,-1258
2015,8,27,7,4079,4919,3731,-1188
2015,8,27,8,3963,4775,3630,-1145
2015,8,27,9,3898,4753,3605,-1148
2015,8,27,10,4075,5046,3837,-1209
2015,8,27,11,4488,5591,4302,-1289
2015,8,27,12,4672,5812,4563,-1249
2015,8,27,13,4847,5966,4656,-1310
2015,8,27,14,5365,6386,4852,-1534
2015,8,27,15,5918,6917,5170,-1747
2015,8,27,16,6503,7315,5352,-1963
2015,8,27,17,6977,7443,5368,-2075
2015,8,27,18,7290,7446,5233,-2213
2015,8,27,19,7518,7420,5067,-2353
2015,8,27,20,7576,7627,5177,-2450
2015,8,27,21,7541,8035,5546,-2489
2015,8,27,22,7307,8379,5743,-2636
2015,8,27,23,6948,8346,5716,-2630
2015,8,28,0,6553,7999,5509,-2490
2015,8,28,1,6430,7884,5581,-2303
2015,8,28,2,5976,7317,5227,-2090
2015,8,28,3,5351,6600,4671,-1929
2015,8,28,4,4768,5863,4244,-1619
2015,8,28,5,4185,5259,3805,-1454
2015,8,28,6,3911,4861,3637,-1224
2015,8,28,7,3746,4615,3461,-1154
2015,8,28,8,3652,4439,3318,-1121
2015,8,28,9,3654,4399,3286,-1113
2015,8,28,10,3867,4654,3456,-1198
2015,8,28,11,4318,5199,3898,-1301
2015,8,28,12,4531,5468,4128,-1340
2015,8,28,13,4755,5809,4354,-1455
2015,8,28,14,5236,6460,4771,-1689
2015,8,28,15,5771,7278,5334,-1944
2015,8,28,16,6269,7936,5661,-2275
2015,8,28,17,6604,8440,6105,-2335
2015,8,28,18,7003,8801,6427,-2374
2015,8,28,19,7204,8996,6683,-2313
2015,8,28,20,7251,9123,6907,-2216
2015,8,28,21,7130,9046,6790,-2256
2015,8,28,22,6903,8487,6251,-2236
2015,8,28,23,6511,7809,5704,-2105
2015,8,29,0,6199,7328,5282,-2046
2015,8,29,1,6063,7131,5071,-2060
2015,8,29,2,5687,6721,4747,-1974
2015,8,29,3,5218,6225,4341,-1884
2015,8,29,4,4766,5683,4080,-1603
2015,8,29,5,4280,5170,3853,-1317
2015,8,29,6,4003,4788,3635,-1153
2015,8,29,7,3789,4517,3429,-1088
2015,8,29,8,3664,4369,3304,-1065
2015,8,29,9,3621,4313,3254,-1059
2015,8,29,10,3659,4373,3288,-1085
2015,8,29,11,3813,4569,3429,-1140
2015,8,29,12,3942,4793,3578,-1215
2015,8,29,13,4387,5390,4025,-1365
2015,8,29,14,5016,6152,4416,-1736
2015,8,29,15,5573,6996,4952,-2044
2015,8,29,16,6033,7622,5423,-2199
2015,8,29,17,6450,8278,5963,-2315
2015,8,29,18,6607,8640,6261,-2379
2015,8,29,19,6689,8833,6472,-2361
2015,8,29,20,6712,8637,6321,-2316
2015,8,29,21,6622,8340,6086,-2254
2015,8,29,22,6445,7936,5732,-2204
2015,8,29,23,6117,7427,5316,-2111
2015,8,30,0,5887,7046,5007,-2039
2015,8,30,1,5773,6897,4868,-2029
2015,8,30,2,5405,6474,4527,-1947
2015,8,30,3,4967,6031,4141,-1890
2015,8,30,4,4547,5493,3981,-1512
2015,8,30,5,4292,5000,3741,-1259
2015,8,30,6,3983,4631,3497,-1134
2015,8,30,7,3791,4388,3292,-1096
2015,8,30,8,3605,4233,3227,-1006
2015,8,30,9,3476,4146,3217,-929
2015,8,30,10,3519,4186,3212,-974
2015,8,30,11,3600,4336,3233,-1103
2015,8,30,12,3768,4546,3367,-1179
2015,8,30,13,4243,5050,3726,-1324
2015,8,30,14,4878,5793,4108,-1685
2015,8,30,15,5526,6522,4480,-2042
2015,8,30,16,5974,7205,5001,-2204
2015,8,30,17,6451,7875,5469,-2406
2015,8,30,18,6795,8368,5876,-2492
2015,8,30,19,6979,8576,6236,-2340
2015,8,30,20,6984,8449,6128,-2321
2015,8,30,21,6964,8324,6047,-2277
2015,8,30,22,6673,8261,6027,-2234
2015,8,30,23,6518,7945,5683,-2262
2015,8,31,0,6269,7674,5394,-2280
2015,8,31,1,6134,7479,5180,-2299
2015,8,31,2,5722,6909,4735,-2174
2015,8,31,3,5156,6288,4295,-1993
2015,8,31,4,4618,5664,4037,-1627
2015,8,31,5,4050,5156,3769,-1387
2015,8,31,6,3805,4816,3620,-1196
2015,8,31,7,3661,4586,3443,-1143
2015,8,31,8,3536,4484,3366,-1118
2015,8,31,9,3546,4511,3390,-1121
2015,8,31,10,3768,4832,3643,-1189
2015,8,31,11,4334,5403,4079,-1324
2015,8,31,12,4565,5710,4353,-1357
2015,8,31,13,4773,5962,4496,-1466
2015,8,31,14,5276,6376,4686,-1690
2015,8,31,15,5760,6965,4969,-1996
2015,8,31,16,6189,7523,5295,-2228
2015,8,31,17,6587,8029,5499,-2530
2015,8,31,18,6860,8404,5713,-2691
2015,8,31,19,6997,8603,5819,-2784
2015,8,31,20,6948,8846,6010,-2836
2015,8,31,21,6835,8970,6169,-2801
2015,8,31,22,6722,8772,5981,-2791
2015,8,31,23,6487,8335,5657,-2678
2015,9,1,0,6260,7957,5339,-2618
2015,9,1,1,6167,7720,5300,-2420
2015,9,1,2,5774,7117,4943,-2174
2015,9,1,3,5136,6481,4494,-1987
2015,9,1,4,4597,5788,4164,-1624
2015,9,1,5,4259,5207,3856,-1351
2015,9,1,6,3957,4850,3680,-1170
2015,9,1,7,3765,4635,3516,-1119
2015,9,1,8,3639,4498,3405,-1093
2015,9,1,9,3632,4497,3412,-1085
2015,9,1,10,3854,4802,3652,-1150
2015,9,1,11,4294,5363,4098,-1265
2015,9,1,12,4504,5660,4337,-1323
2015,9,1,13,4812,5994,4562,-1432
2015,9,1,14,5323,6616,4924,-1692
2015,9,1,15,5947,7373,5328,-2045
2015,9,1,16,6513,7889,5763,-2126
2015,9,1,17,6994,8231,6021,-2210
2015,9,1,18,7340,8578,6295,-2283
2015,9,1,19,7639,8793,6540,-2253
2015,9,1,20,7749,8907,6707,-2200
2015,9,1,21,7720,8991,6817,-2174
2015,9,1,22,7508,8876,6624,-2252
2015,9,1,23,7174,8637,6378,-2259
2015,9,2,0,6783,8364,6216,-2148
2015,9,2,1,6714,8183,6037,-2146
2015,9,2,2,6160,7576,5467,-2109
2015,9,2,3,5563,6844,4846,-1998
2015,9,2,4,5002,6110,4411,-1699
2015,9,2,5,4627,5551,4078,-1473
2015,9,2,6,4256,5189,3911,-1278
2015,9,2,7,4026,4959,3724,-1235
2015,9,2,8,3845,4786,3598,-1188
2015,9,2,9,3806,4782,3619,-1163
2015,9,2,10,4002,5105,3853,-1252
2015,9,2,11,4396,5644,4288,-1356
2015,9,2,12,4619,5872,4520,-1352
2015,9,2,13,4976,6236,4795,-1441
2015,9,2,14,5423,6905,5335,-1570
2015,9,2,15,6115,7711,5895,-1816
2015,9,2,16,6843,8473,6421,-2052
2015,9,2,17,7163,9135,6928,-2207
2015,9,2,18,7561,9737,7428,-2309
2015,9,2,19,7901,10165,7756,-2409
2015,9,2,20,8110,10429,8032,-2397
2015,9,2,21,8122,10551,8098,-2453
2015,9,2,22,7875,10454,8005,-2449
2015,9,2,23,7591,10044,7587,-2457
2015,9,3,0,7232,9488,7068,-2420
2015,9,3,1,7023,9119,6730,-2389
2015,9,3,2,6526,8384,6064,-2320
2015,9,3,3,5886,7475,5365,-2110
2015,9,3,4,5253,6594,4652,-1942
2015,9,3,5,4972,5907,4320,-1587
2015,9,3,6,4568,5501,4179,-1322
2015,9,3,7,4280,5199,3911,-1288
2015,9,3,8,4096,5007,3771,-1236
2015,9,3,9,4047,4970,3757,-1213
2015,9,3,10,4223,5215,3952,-1263
2015,9,3,11,4615,5734,4372,-1362
2015,9,3,12,4827,5965,4583,-1382
2015,9,3,13,5166,6328,4833,-1495
2015,9,3,14,5696,7003,5283,-1720
2015,9,3,15,6362,7733,5814,-1919
2015,9,3,16,6961,8472,6156,-2316
2015,9,3,17,7566,9136,6514,-2622
2015,9,3,18,7932,9653,6960,-2693
2015,9,3,19,8221,9956,7297,-2659
2015,9,3,20,8399,10024,7369,-2655
2015,9,3,21,8434,10164,7509,-2655
2015,9,3,22,8173,10086,7492,-2594
2015,9,3,23,7841,9638,7069,-2569
2015,9,4,0,7393,9164,6604,-2560
2015,9,4,1,7193,8890,6485,-2405
2015,9,4,2,6628,8166,6033,-2133
2015,9,4,3,6013,7381,5401,-1980
2015,9,4,4,5418,6592,4836,-1756
2015,9,4,5,4857,5915,4401,-1514
2015,9,4,6,4458,5482,4164,-1318
2015,9,4,7,4186,5182,3931,-1251
2015,9,4,8,4019,5029,3806,-1223
2015,9,4,9,3968,4988,3776,-1212
2015,9,4,10,4136,5254,3963,-1291
2015,9,4,11,4522,5800,4422,-1378
2015,9,4,12,4739,6059,4729,-1330
2015,9,4,13,5055,6376,4935,-1441
2015,9,4,14,5528,6908,5298,-1610
2015,9,4,15,6131,7555,5741,-1814
2015,9,4,16,6629,8109,5960,-2149
2015,9,4,17,6990,8614,6316,-2298
2015,9,4,18,7284,9047,6695,-2352
2015,9,4,19,7488,9337,6989,-2348
2015,9,4,20,7546,9298,6981,-2317
2015,9,4,21,7498,8842,6572,-2270
2015,9,4,22,7234,8469,6231,-2238
2015,9,4,23,7019,8052,5783,-2269
2015,9,5,0,6651,7644,5387,-2257
2015,9,5,1,6385,7463,5186,-2277
2015,9,5,2,6004,6999,4915,-2084
2015,9,5,3,5516,6472,4590,-1882
2015,9,5,4,5016,5869,4178,-1691
2015,9,5,5,4422,5320,3866,-1454
2015,9,5,6,4101,4923,3719,-1204
2015,9,5,7,3858,4650,3530,-1120
2015,9,5,8,3722,4474,3389,-1085
2015,9,5,9,3656,4383,3368,-1015
2015,9,5,10,3686,4388,3395,-993
2015,9,5,11,3818,4494,3434,-1060
2015,9,5,12,3972,4688,3550,-1138
2015,9,5,13,4430,5327,4021,-1306
2015,9,5,14,5001,6117,4541,-1576
2015,9,5,15,5572,6905,5090,-1815
2015,9,5,16,6028,7674,5437,-2237
2015,9,5,17,6502,8333,5857,-2476
2015,9,5,18,6797,8822,6281,-2541
2015,9,5,19,6940,8890,6394,-2496
2015,9,5,20,7019,8554,6165,-2389
2015,9,5,21,6957,8388,6074,-2314
2015,9,5,22,6787,8220,5903,-2317
2015,9,5,23,6396,7873,5570,-2303
2015,9,6,0,6109,7511,5185,-2326
2015,9,6,1,5978,7336,5026,-2310
2015,9,6,2,5575,6861,4774,-2087
2015,9,6,3,5124,6356,4527,-1829
2015,9,6,4,4670,5777,4099,-1678
2015,9,6,5,4135,5244,3805,-1439
2015,9,6,6,3884,4851,3630,-1221
2015,9,6,7,3667,4566,3407,-1159
2015,9,6,8,3513,4401,3282,-1119
2015,9,6,9,3441,4310,3180,-1130
2015,9,6,10,3409,4321,3177,-1144
2015,9,6,11,3482,4456,3283,-1173
2015,9,6,12,3590,4619,3474,-1145
2015,9,6,13,4082,5244,3955,-1289
2015,9,6,14,4682,6111,4605,-1506
2015,9,6,15,5175,6920,5258,-1662
2015,9,6,16,5619,7615,5811,-1804
2015,9,6,17,5968,8226,6379,-1847
2015,9,6,18,6275,8668,6745,-1923
2015,9,6,19,6403,8819,6903,-1916
2015,9,6,20,6403,8722,6889,-1833
2015,9,6,21,6352,8367,6592,-1775
2015,9,6,22,6112,7961,6194,-1767
2015,9,6,23,5852,7527,5862,-1665
2015,9,7,0,5651,7177,5481,-1696
2015,9,7,1,5582,6954,5295,-1659
2015,9,7,2,5187,6479,4951,-1528
2015,9,7,3,4764,6021,4524,-1497
2015,9,7,4,4335,5484,4091,-1393
2015,9,7,5,4000,5001,3716,-1285
2015,9,7,6,3758,4635,3477,-1158
2015,9,7,7,3643,4419,3322,-1097
2015,9,7,8,3512,4290,3242,-1048
2015,9,7,9,3465,4257,3216,-1041
2015,9,7,10,3509,4345,3273,-1072
2015,9,7,11,3655,4538,3363,-1175
2015,9,7,12,3754,4723,3586,-1137
2015,9,7,13,4125,5253,3993,-1260
2015,9,7,14,4741,5892,4399,-1493
2015,9,7,15,5409,6445,4751,-1694
2015,9,7,16,5880,6884,4845,-2039
2015,9,7,17,6222,7185,4895,-2290
2015,9,7,18,6403,7420,5089,-2331
2015,9,7,19,6550,7467,5132,-2335
2015,9,7,20,6528,7387,5052,-2335
2015,9,7,21,6462,7284,4998,-2286
2015,9,7,22,6262,7312,5042,-2270
2015,9,7,23,6098,7111,4864,-2247
2015,9,8,0,5937,6987,4751,-2236
2015,9,8,1,5852,7002,4761,-2241
2015,9,8,2,5403,6538,4623,-1915
2015,9,8,3,4907,5973,4216,-1757
2015,9,8,4,4477,5366,3797,-1569
2015,9,8,5,4088,4902,3597,-1305
2015,9,8,6,3876,4565,3446,-1119
2015,9,8,7,3789,4369,3301,-1068
2015,9,8,8,3653,4272,3199,-1073
2015,9,8,9,3675,4282,3210,-1072
2015,9,8,10,3905,4616,3430,-1186
2015,9,8,11,4389,5240,3900,-1340
2015,9,8,12,4602,5559,4264,-1295
2015,9,8,13,4814,5916,4571,-1345
2015,9,8,14,5201,6498,4922,-1576
2015,9,8,15,5703,7161,5358,-1803
2015,9,8,16,6234,7735,5593,-2142
2015,9,8,17,6442,8120,5743,-2377
2015,9,8,18,6770,8374,6111,-2263
2015,9,8,19,6963,8497,6264,-2233
2015,9,8,20,7083,8689,6371,-2318
2015,9,8,21,7059,8915,6507,-2408
2015,9,8,22,6956,9003,6509,-2494
2015,9,8,23,6772,8795,6313,-2482
2015,9,9,0,6516,8386,6113,-2273
2015,9,9,1,6391,8168,5775,-2393
2015,9,9,2,5924,7475,5295,-2180
2015,9,9,3,5338,6725,4791,-1934
2015,9,9,4,4842,5961,4276,-1685
2015,9,9,5,4376,5357,3932,-1425
2015,9,9,6,4171,4937,3743,-1194
2015,9,9,7,4040,4694,3564,-1130
2015,9,9,8,3866,4551,3459,-1092
2015,9,9,9,3850,4536,3448,-1088
2015,9,9,10,4024,4814,3661,-1153
2015,9,9,11,4480,5369,4096,-1273
2015,9,9,12,4664,5610,4242,-1368
2015,9,9,13,4957,5991,4514,-1477
2015,9,9,14,5419,6610,4939,-1671
2015,9,9,15,6017,7415,5493,-1922
2015,9,9,16,6661,8204,5925,-2279
2015,9,9,17,6852,8929,6333,-2596
2015,9,9,18,7239,9491,6855,-2636
2015,9,9,19,7534,9872,7341,-2531
2015,9,9,20,7726,10125,7605,-2520
2015,9,9,21,7770,10265,7754,-2511
2015,9,9,22,7587,10136,7611,-2525
2015,9,9,23,7363,9730,7223,-2507
2015,9,10,0,7137,9281,6829,-2452
2015,9,10,1,6829,9008,6480,-2528
2015,9,10,2,6263,8254,6004,-2250
2015,9,10,3,5787,7415,5472,-1943
2015,9,10,4,5199,6589,4852,-1737
2015,9,10,5,4773,5911,4420,-1491
2015,9,10,6,4438,5473,4058,-1415
2015,9,10,7,4183,5203,3836,-1367
2015,9,10,8,4015,5046,3713,-1333
2015,9,10,9,3981,5013,3691,-1322
2015,9,10,10,4175,5267,3890,-1377
2015,9,10,11,4597,5816,4371,-1445
2015,9,10,12,4820,6037,4532,-1505
2015,9,10,13,5125,6265,4682,-1583
2015,9,10,14,5641,6791,5114,-1677
2015,9,10,15,6240,7501,5709,-1792
2015,9,10,16,6760,8198,6120,-2078
2015,9,10,17,7231,8796,6548,-2248
2015,9,10,18,7646,9346,6913,-2433
2015,9,10,19,7953,9748,7249,-2499
2015,9,10,20,8113,10020,7405,-2615
2015,9,10,21,8178,10100,7379,-2721
2015,9,10,22,8017,10000,7302,-2698
2015,9,10,23,7739,9670,7046,-2624
2015,9,11,0,7372,9244,6770,-2474
2015,9,11,1,7122,9000,6485,-2515
2015,9,11,2,6557,8305,6005,-2300
2015,9,11,3,5900,7531,5392,-2139
2015,9,11,4,5285,6688,4883,-1805
2015,9,11,5,4839,6012,4456,-1556
2015,9,11,6,4462,5536,4110,-1426
2015,9,11,7,4175,5200,3822,-1378
2015,9,11,8,4018,4979,3643,-1336
2015,9,11,9,3973,4936,3602,-1334
2015,9,11,10,4192,5163,3781,-1382
2015,9,11,11,4587,5698,4218,-1480
2015,9,11,12,4819,5947,4400,-1547
2015,9,11,13,5119,6239,4590,-1649
2015,9,11,14,5628,6971,5182,-1789
2015,9,11,15,6178,7815,5774,-2041
2015,9,11,16,6675,8582,6151,-2431
2015,9,11,17,7132,9262,6575,-2687
2015,9,11,18,7426,9865,7059,-2806
2015,9,11,19,7614,10230,7403,-2827
2015,9,11,20,7740,10495,7629,-2866
2015,9,11,21,7730,10511,7754,-2757
2015,9,11,22,7404,10312,7677,-2635
2015,9,11,23,7140,9709,7167,-2542
2015,9,12,0,6793,9125,6628,-2497
2015,9,12,1,6545,8724,6368,-2356
2015,9,12,2,6070,7973,5822,-2151
2015,9,12,3,5565,7263,5217,-2046
2015,9,12,4,5011,6588,4880,-1708
2015,9,12,5,4612,5976,4677,-1299
2015,9,12,6,4219,5519,4377,-1142
2015,9,12,7,3964,5204,4123,-1081
2015,9,12,8,3753,4963,3916,-1047
2015,9,12,9,3681,4886,3854,-1032
2015,9,12,10,3679,4878,3853,-1025
2015,9,12,11,3822,5015,3926,-1089
2015,9,12,12,3966,5228,4091,-1137
2015,9,12,13,4353,5612,4339,-1273
2015,9,12,14,4944,6124,4563,-1561
2015,9,12,15,5577,6590,4794,-1796
2015,9,12,16,5975,7205,5208,-1997
2015,9,12,17,6390,7967,5741,-2226
2015,9,12,18,6654,8245,6066,-2179
2015,9,12,19,6798,8278,6083,-2195
2015,9,12,20,6842,8285,6116,-2169
2015,9,12,21,6664,8063,5925,-2138
2015,9,12,22,6493,7832,5737,-2095
2015,9,12,23,6261,7420,5400,-2020
2015,9,13,0,5930,7053,5075,-1978
2015,9,13,1,5796,6854,4899,-1955
2015,9,13,2,5312,6410,4549,-1861
2015,9,13,3,4846,5951,4163,-1788
2015,9,13,4,4374,5466,4034,-1432
2015,9,13,5,4100,5061,3936,-1125
2015,9,13,6,3794,4714,3762,-952
2015,9,13,7,3588,4506,3601,-905
2015,9,13,8,3463,4349,3450,-899
2015,9,13,9,3404,4278,3429,-849
2015,9,13,10,3401,4304,3431,-873
2015,9,13,11,3494,4441,3530,-911
2015,9,13,12,3591,4664,3682,-982
2015,9,13,13,3949,5127,3974,-1153
2015,9,13,14,4527,5630,4264,-1366
2015,9,13,15,5038,6009,4523,-1486
2015,9,13,16,5456,6130,4624,-1506
2015,9,13,17,5868,6312,4735,-1577
2015,9,13,18,6182,6501,4834,-1667
2015,9,13,19,6325,6823,5079,-1744
2015,9,13,20,6385,7056,5229,-1827
2015,9,13,21,6359,7289,5510,-1779
2015,9,13,22,6156,7350,5678,-1672
2015,9,13,23,5887,7191,5587,-1604
2015,9,14,0,5672,6971,5368,-1603
2015,9,14,1,5531,6889,5224,-1665
2015,9,14,2,5117,6305,4746,-1559
2015,9,14,3,4636,5677,4345,-1332
2015,9,14,4,4158,4999,3936,-1063
2015,9,14,5,3824,4432,3493,-939
2015,9,14,6,3543,4046,3159,-887
2015,9,14,7,3385,3827,3093,-734
2015,9,14,8,3287,3700,3086,-614
2015,9,14,9,3325,3722,3095,-627
2015,9,14,10,3583,4014,3169,-845
2015,9,14,11,4077,4564,3584,-980
2015,9,14,12,4318,4871,3882,-989
2015,9,14,13,4539,5132,4035,-1097
2015,9,14,14,4897,5623,4248,-1375
2015,9,14,15,5450,6172,4576,-1596
2015,9,14,16,6005,6798,4928,-1870
2015,9,14,17,6450,7407,5377,-2030
2015,9,14,18,6806,7991,5853,-2138
2015,9,14,19,7096,8439,6242,-2197
2015,9,14,20,7204,8699,6420,-2279
2015,9,14,21,7217,8839,6528,-2311
2015,9,14,22,7044,8749,6439,-2310
2015,9,14,23,6719,8428,6179,-2249
2015,9,15,0,6502,8110,5894,-2216
2015,9,15,1,6329,7919,5723,-2196
2015,9,15,2,5846,7239,5223,-2016
2015,9,15,3,5236,6509,4651,-1858
2015,9,15,4,4688,5738,4118,-1620
2015,9,15,5,4177,5174,3818,-1356
2015,9,15,6,3902,4798,3581,-1217
2015,9,15,7,3749,4548,3389,-1159
2015,9,15,8,3665,4377,3284,-1093
2015,9,15,9,3685,4391,3321,-1070
2015,9,15,10,3943,4668,3524,-1144
2015,9,15,11,4434,5264,4032,-1232
2015,9,15,12,4689,5545,4289,-1256
2015,9,15,13,4869,5845,4488,-1357
2015,9,15,14,5368,6403,4789,-1614
2015,9,15,15,5883,7145,5297,-1848
2015,9,15,16,6264,7835,5666,-2169
2015,9,15,17,6629,8294,6002,-2292
2015,9,15,18,6887,8400,6115,-2285
2015,9,15,19,7025,8352,6052,-2300
2015,9,15,20,7087,8074,5837,-2237
2015,9,15,21,7119,7837,5656,-2181
2015,9,15,22,6996,7610,5460,-2150
2015,9,15,23,6737,7343,5189,-2154
2015,9,16,0,6581,7267,5117,-2150
2015,9,16,1,6396,7173,5059,-2114
2015,9,16,2,5883,6655,4669,-1986
2015,9,16,3,5301,6039,4179,-1860
2015,9,16,4,4749,5370,3843,-1527
2015,9,16,5,4134,4862,3609,-1253
2015,9,16,6,3890,4560,3425,-1135
2015,9,16,7,3773,4366,3248,-1118
2015,9,16,8,3696,4269,3188,-1081
2015,9,16,9,3717,4312,3229,-1083
2015,9,16,10,3976,4614,3478,-1136
2015,9,16,11,4435,5198,3909,-1289
2015,9,16,12,4661,5524,4203,-1321
2015,9,16,13,4828,5668,4312,-1356
2015,9,16,14,5189,6014,4471,-1543
2015,9,16,15,5617,6445,4685,-1760
2015,9,16,16,6009,6883,4859,-2024
2015,9,16,17,6330,7327,5179,-2148
2015,9,16,18,6547,7688,5450,-2238
2015,9,16,19,6676,7868,5591,-2277
2015,9,16,20,6677,7927,5671,-2256
2015,9,16,21,6612,7735,5496,-2239
2015,9,16,22,6438,7460,5258,-2202
2015,9,16,23,6224,7172,4994,-2178
2015,9,17,0,6090,7037,4892,-2145
2015,9,17,1,5920,6891,4781,-2110
2015,9,17,2,5497,6405,4415,-1990
2015,9,17,3,5018,5837,4000,-1837
2015,9,17,4,4534,5286,3810,-1476
2015,9,17,5,3876,4773,3483,-1290
2015,9,17,6,3612,4456,3322,-1134
2015,9,17,7,3507,4289,3178,-1111
2015,9,17,8,3425,4180,3102,-1078
2015,9,17,9,3463,4188,3103,-1085
2015,9,17,10,3674,4526,3359,-1167
2015,9,17,11,4134,5118,3858,-1260
2015,9,17,12,4365,5424,4099,-1325
2015,9,17,13,4493,5536,4193,-1343
2015,9,17,14,4749,5806,4384,-1422
2015,9,17,15,4969,6059,4547,-1512
2015,9,17,16,5304,6250,4676,-1574
2015,9,17,17,5585,6494,4839,-1655
2015,9,17,18,5764,6833,5088,-1745
2015,9,17,19,5894,7129,5299,-1830
2015,9,17,20,6025,7359,5487,-1872
2015,9,17,21,6012,7482,5555,-1927
2015,9,17,22,6002,7395,5558,-1837
2015,9,17,23,5608,7209,5344,-1865
2015,9,18,0,5500,7144,5300,-1844
2015,9,18,1,5389,7054,5236,-1818
2015,9,18,2,5143,6565,4861,-1704
2015,9,18,3,4690,5960,4395,-1565
2015,9,18,4,4196,5310,3967,-1343
2015,9,18,5,3766,4752,3555,-1197
2015,9,18,6,3506,4399,3278,-1121
2015,9,18,7,3377,4203,3142,-1061
2015,9,18,8,3273,4108,3063,-1045
2015,9,18,9,3306,4129,3078,-1051
2015,9,18,10,3547,4432,3282,-1150
2015,9,18,11,4014,5023,3696,-1327
2015,9,18,12,4254,5333,3959,-1374
2015,9,18,13,4454,5499,4107,-1392
2015,9,18,14,4689,5828,4355,-1473
2015,9,18,15,5162,6308,4631,-1677
2015,9,18,16,5567,6874,4931,-1943
2015,9,18,17,5836,7461,5312,-2149
2015,9,18,18,6115,7894,5637,-2257
2015,9,18,19,6211,8227,5915,-2312
2015,9,18,20,6175,8462,6113,-2349
2015,9,18,21,6117,8602,6195,-2407
2015,9,18,22,5895,8527,6165,-2362
2015,9,18,23,5730,8140,5852,-2288
2015,9,19,0,5566,7716,5569,-2147
2015,9,19,1,5406,7523,5469,-2054
2015,9,19,2,5069,6968,5016,-1952
2015,9,19,3,4681,6444,4573,-1871
2015,9,19,4,4285,5863,4251,-1612
2015,9,19,5,4066,5444,3984,-1460
2015,9,19,6,3820,4993,3635,-1358
2015,9,19,7,3626,4758,3422,-1336
2015,9,19,8,3484,4597,3293,-1304
2015,9,19,9,3454,4514,3248,-1266
2015,9,19,10,3479,4578,3291,-1287
2015,9,19,11,3566,4773,3439,-1334
2015,9,19,12,3712,4996,3628,-1368
2015,9,19,13,4111,5476,3864,-1612
2015,9,19,14,4662,6143,4217,-1926
2015,9,19,15,5322,6866,4662,-2204
2015,9,19,16,5804,7537,5126,-2411
2015,9,19,17,6312,8160,5580,-2580
2015,9,19,18,6615,8664,5948,-2716
2015,9,19,19,6824,9028,6200,-2828
2015,9,19,20,7042,9236,6429,-2807
2015,9,19,21,6981,9118,6337,-2781
2015,9,19,22,6794,8961,6177,-2784
2015,9,19,23,6399,8532,5809,-2723
2015,9,20,0,6286,8116,5586,-2530
2015,9,20,1,6078,7847,5395,-2452
2015,9,20,2,5688,7261,4931,-2330
2015,9,20,3,5142,6681,4489,-2192
2015,9,20,4,4665,6075,4336,-1739
2015,9,20,5,4144,5352,3905,-1447
2015,9,20,6,3849,4889,3596,-1293
2015,9,20,7,3661,4588,3392,-1196
2015,9,20,8,3499,4375,3240,-1135
2015,9,20,9,3395,4262,3144,-1118
2015,9,20,10,3370,4230,3086,-1144
2015,9,20,11,3478,4330,3141,-1189
2015,9,20,12,3661,4505,3276,-1229
2015,9,20,13,4103,5122,3611,-1511
2015,9,20,14,4686,5982,4140,-1842
2015,9,20,15,5431,6842,4801,-2041
2015,9,20,16,6059,7590,5256,-2334
2015,9,20,17,6384,8296,5705,-2591
2015,9,20,18,6766,8885,6135,-2750
2015,9,20,19,7002,9296,6537,-2759
2015,9,20,20,7138,9554,6773,-2781
2015,9,20,21,7272,9652,6851,-2801
2015,9,20,22,7286,9590,6808,-2782
2015,9,20,23,6939,9190,6524,-2666
2015,9,21,0,6679,8668,6064,-2604
2015,9,21,1,6549,8288,5715,-2573
2015,9,21,2,5932,7503,5233,-2270
2015,9,21,3,5356,6730,4735,-1995
2015,9,21,4,4833,5934,4344,-1590
2015,9,21,5,4296,5285,3991,-1294
2015,9,21,6,3941,4828,3685,-1143
2015,9,21,7,3699,4516,3404,-1112
2015,9,21,8,3562,4335,3225,-1110
2015,9,21,9,3563,4320,3188,-1132
2015,9,21,10,3778,4595,3406,-1189
2015,9,21,11,4232,5147,3838,-1309
2015,9,21,12,4489,5396,4063,-1333
2015,9,21,13,4702,5634,4195,-1439
2015,9,21,14,5178,6232,4425,-1807
2015,9,21,15,5720,6983,4978,-2005
2015,9,21,16,6213,7648,5402,-2246
2015,9,21,17,6696,8272,5819,-2453
2015,9,21,18,7090,8761,6286,-2475
2015,9,21,19,7359,9110,6630,-2480
2015,9,21,20,7598,9390,6806,-2584
2015,9,21,21,7626,9498,6885,-2613
2015,9,21,22,7496,9330,6743,-2587
2015,9,21,23,7156,8842,6247,-2595
2015,9,22,0,6950,8508,5971,-2537
2015,9,22,1,6740,8198,5683,-2515
2015,9,22,2,6231,7408,5208,-2200
2015,9,22,3,5461,6619,4666,-1953
2015,9,22,4,4872,5851,4272,-1579
2015,9,22,5,4221,5196,3884,-1312
2015,9,22,6,3884,4756,3645,-1111
2015,9,22,7,3670,4476,3399,-1077
2015,9,22,8,3545,4296,3265,-1031
2015,9,22,9,3540,4259,3206,-1053
2015,9,22,10,3766,4517,3425,-1092
2015,9,22,11,4222,5060,3823,-1237
2015,9,22,12,4461,5332,4039,-1293
2015,9,22,13,4575,5584,4250,-1334
2015,9,22,14,4955,6174,4598,-1576
2015,9,22,15,5497,6838,4958,-1880
2015,9,22,16,6044,7478,5425,-2053
2015,9,22,17,6579,8134,5941,-2193
2015,9,22,18,6953,8675,6412,-2263
2015,9,22,19,7175,9020,6793,-2227
2015,9,22,20,7282,9279,7034,-2245
2015,9,22,21,7244,9263,6997,-2266
2015,9,22,22,7034,9073,6784,-2289
2015,9,22,23,6733,8692,6471,-2221
2015,9,23,0,6512,8387,6142,-2245
2015,9,23,1,6283,8098,5959,-2139
2015,9,23,2,5766,7384,5391,-1993
2015,9,23,3,5154,6659,4720,-1939
2015,9,23,4,4587,5915,4281,-1634
2015,9,23,5,4073,5278,3867,-1411
2015,9,23,6,3744,4894,3688,-1206
2015,9,23,7,3534,4617,3465,-1152
2015,9,23,8,3474,4463,3318,-1145
2015,9,23,9,3448,4434,3271,-1163
2015,9,23,10,3702,4713,3459,-1254
2015,9,23,11,4128,5242,3816,-1426
2015,9,23,12,4362,5505,4084,-1421
2015,9,23,13,4481,5711,4238,-1473
2015,9,23,14,4831,6161,4485,-1676
2015,9,23,15,5353,6805,4888,-1917
2015,9,23,16,5767,7361,5344,-2017
2015,9,23,17,6018,7995,5781,-2214
2015,9,23,18,6320,8418,6154,-2264
2015,9,23,19,6590,8750,6311,-2439
2015,9,23,20,6649,8958,6456,-2502
2015,9,23,21,6644,9102,6576,-2526
2015,9,23,22,6444,9045,6570,-2475
2015,9,23,23,6196,8643,6258,-2385
2015,9,24,0,6034,8284,5927,-2357
2015,9,24,1,5869,8015,5724,-2291
2015,9,24,2,5403,7321,5246,-2075
2015,9,24,3,4817,6610,4705,-1905
2015,9,24,4,4290,5888,4253,-1635
2015,9,24,5,4002,5216,3874,-1342
2015,9,24,6,3710,4805,3668,-1137
2015,9,24,7,3527,4580,3474,-1106
2015,9,24,8,3446,4430,3367,-1063
2015,9,24,9,3423,4407,3340,-1067
2015,9,24,10,3672,4709,3560,-1149
2015,9,24,11,4141,5283,4025,-1258
2015,9,24,12,4384,5589,4271,-1318
2015,9,24,13,4485,5662,4379,-1283
2015,9,24,14,4814,5938,4384,-1554
2015,9,24,15,5304,6369,4507,-1862
2015,9,24,16,5647,6883,4878,-2005
2015,9,24,17,5944,7474,5319,-2155
2015,9,24,18,6325,8033,5755,-2278
2015,9,24,19,6445,8470,6194,-2276
2015,9,24,20,6549,8802,6463,-2339
2015,9,24,21,6428,8965,6537,-2428
2015,9,24,22,6219,8903,6426,-2477
2015,9,24,23,5923,8568,6184,-2384
2015,9,25,0,5808,8292,5958,-2334
2015,9,25,1,5644,8003,5786,-2217
2015,9,25,2,5255,7297,5159,-2138
2015,9,25,3,4707,6624,4639,-1985
2015,9,25,4,4229,5907,4269,-1638
2015,9,25,5,3879,5311,3909,-1402
2015,9,25,6,3587,4883,3683,-1200
2015,9,25,7,3406,4608,3514,-1094
2015,9,25,8,3314,4435,3337,-1098
2015,9,25,9,3278,4429,3348,-1081
2015,9,25,10,3525,4681,3541,-1140
2015,9,25,11,3995,5183,3937,-1246
2015,9,25,12,4262,5495,4231,-1264
2015,9,25,13,4484,5722,4393,-1329
2015,9,25,14,4931,6182,4619,-1563
2015,9,25,15,5475,6845,5010,-1835
2015,9,25,16,5870,7480,5473,-2007
2015,9,25,17,6349,8062,5945,-2117
2015,9,25,18,6693,8356,6056,-2300
2015,9,25,19,6924,8500,6042,-2458
2015,9,25,20,6983,8531,6054,-2477
2015,9,25,21,6972,8485,5962,-2523
2015,9,25,22,6775,8223,5684,-2539
2015,9,25,23,6389,7726,5252,-2474
2015,9,26,0,6146,7446,5077,-2369
2015,9,26,1,5960,7212,4915,-2297
2015,9,26,2,5580,6730,4657,-2073
2015,9,26,3,5024,6253,4407,-1846
2015,9,26,4,4541,5689,4063,-1626
2015,9,26,5,4223,5127,3762,-1365
2015,9,26,6,3893,4746,3499,-1247
2015,9,26,7,3687,4495,3304,-1191
2015,9,26,8,3548,4332,3178,-1154
2015,9,26,9,3462,4238,3093,-1145
2015,9,26,10,3480,4318,3120,-1198
2015,9,26,11,3613,4509,3286,-1223
2015,9,26,12,3755,4738,3517,-1221
2015,9,26,13,4137,5280,3861,-1419
2015,9,26,14,4794,6038,4443,-1595
2015,9,26,15,5388,6781,4833,-1948
2015,9,26,16,5882,7406,5174,-2232
2015,9,26,17,6313,8030,5533,-2497
2015,9,26,18,6693,8526,5897,-2629
2015,9,26,19,6918,8804,6042,-2762
2015,9,26,20,7097,8909,6130,-2779
2015,9,26,21,7158,8883,6054,-2829
2015,9,26,22,7004,8574,5862,-2712
2015,9,26,23,6556,8037,5492,-2545
2015,9,27,0,6357,7732,5244,-2488
2015,9,27,1,6121,7429,5138,-2291
2015,9,27,2,5690,6988,4924,-2064
2015,9,27,3,5178,6450,4537,-1913
2015,9,27,4,4703,5909,4246,-1663
2015,9,27,5,4299,5399,3937,-1462
2015,9,27,6,3975,5012,3696,-1316
2015,9,27,7,3750,4742,3463,-1279
2015,9,27,8,3601,4558,3344,-1214
2015,9,27,9,3532,4465,3260,-1205
2015,9,27,10,3521,4474,3267,-1207
2015,9,27,11,3596,4608,3365,-1243
2015,9,27,12,3746,4786,3570,-1216
2015,9,27,13,4129,5326,3864,-1462
2015,9,27,14,4670,6004,4355,-1649
2015,9,27,15,5134,6577,4622,-1955
2015,9,27,16,5625,7031,4877,-2154
2015,9,27,17,6132,7405,5056,-2349
2015,9,27,18,6514,7779,5385,-2394
2015,9,27,19,6707,8115,5636,-2479
2015,9,27,20,6849,8240,5715,-2525
2015,9,27,21,6844,8183,5462,-2721
2015,9,27,22,6634,7942,5403,-2539
2015,9,27,23,6364,7616,5155,-2461
2015,9,28,0,6287,7478,5054,-2424
2015,9,28,1,5996,7210,4950,-2260
2015,9,28,2,5516,6612,4639,-1973
2015,9,28,3,5024,6072,4235,-1837
2015,9,28,4,4547,5474,3930,-1544
2015,9,28,5,4074,4984,3622,-1362
2015,9,28,6,3775,4648,3414,-1234
2015,9,28,7,3607,4438,3259,-1179
2015,9,28,8,3514,4345,3181,-1164
2015,9,28,9,3542,4411,3222,-1189
2015,9,28,10,3773,4756,3483,-1273
2015,9,28,11,4254,5345,3970,-1375
2015,9,28,12,4521,5725,4305,-1420
2015,9,28,13,4662,5903,4436,-1467
2015,9,28,14,5009,6258,4697,-1561
2015,9,28,15,5552,6669,4870,-1799
2015,9,28,16,6079,7109,5110,-1999
2015,9,28,17,6425,7386,5192,-2194
2015,9,28,18,6772,7574,5316,-2258
2015,9,28,19,6900,7670,5448,-2222
2015,9,28,20,6994,7732,5567,-2165
2015,9,28,21,6893,7763,5500,-2263
2015,9,28,22,6733,7690,5388,-2302
2015,9,28,23,6500,7520,5221,-2299
2015,9,29,0,6420,7551,5247,-2304
2015,9,29,1,6228,7285,5163,-2122
2015,9,29,2,5745,6711,4841,-1870
2015,9,29,3,5177,6150,4426,-1724
2015,9,29,4,4681,5507,3906,-1601
2015,9,29,5,3976,4988,3611,-1377
2015,9,29,6,3734,4672,3407,-1265
2015,9,29,7,3627,4443,3219,-1224
2015,9,29,8,3564,4353,3151,-1202
2015,9,29,9,3619,4402,3290,-1112
2015,9,29,10,3876,4738,3475,-1263
2015,9,29,11,4355,5332,3922,-1410
2015,9,29,12,4622,5717,4245,-1472
2015,9,29,13,4721,5825,4316,-1509
2015,9,29,14,4982,6048,4451,-1597
2015,9,29,15,5372,6426,4693,-1733
2015,9,29,16,5772,6748,4791,-1957
2015,9,29,17,6115,7110,4937,-2173
2015,9,29,18,6369,7459,5187,-2272
2015,9,29,19,6451,7728,5385,-2343
2015,9,29,20,6432,7942,5527,-2415
2015,9,29,21,6296,8031,5574,-2457
2015,9,29,22,6068,8025,5534,-2491
2015,9,29,23,5886,7899,5451,-2448
2015,9,30,0,5982,7825,5384,-2441
2015,9,30,1,5832,7652,5357,-2295
2015,9,30,2,5437,7061,5045,-2016
2015,9,30,3,4907,6422,4577,-1845
2015,9,30,4,4439,5719,4067,-1652
2015,9,30,5,4221,5122,3736,-1386
2015,9,30,6,3951,4820,3520,-1300
2015,9,30,7,3797,4613,3371,-1242
2015,9,30,8,3673,4523,3294,-1229
2015,9,30,9,3677,4549,3318,-1231
2015,9,30,10,3904,4859,3542,-1317
2015,9,30,11,4358,5450,4008,-1442
2015,9,30,12,4597,5782,4305,-1477
2015,9,30,13,4678,5991,4439,-1552
2015,9,30,14,4964,6495,4789,-1706
2015,9,30,15,5397,7051,5097,-1954
2015,9,30,16,5885,7649,5408,-2241
2015,9,30,17,6229,8244,5850,-2394
2015,9,30,18,6529,8723,6331,-2392
2015,9,30,19,6731,9132,6847,-2285
2015,9,30,20,6864,9411,7279,-2132
2015,9,30,21,6840,9550,7357,-2193
2015,9,30,22,6688,9480,7335,-2145
2015,9,30,23,6428,9036,6965,-2071
2015,10,1,0,6297,8721,6636,-2085
2015,10,1,1,6106,8326,6445,-1881
2015,10,1,2,5633,7590,5904,-1686
2015,10,1,3,5132,6884,5217,-1667
2015,10,1,4,4626,6105,4593,-1512
2015,10,1,5,4370,5516,4077,-1439
2015,10,1,6,4064,5102,3797,-1305
2015,10,1,7,3869,4851,3577,-1274
2015,10,1,8,3758,4708,3471,-1237
2015,10,1,9,3753,4683,3579,-1104
2015,10,1,10,3985,4970,3807,-1163
2015,10,1,11,4443,5560,4283,-1277
2015,10,1,12,4702,5847,4640,-1207
2015,10,1,13,4863,6019,4766,-1253
2015,10,1,14,5292,6470,5119,-1351
2015,10,1,15,5722,7045,5711,-1334
2015,10,1,16,6145,7681,6048,-1633
2015,10,1,17,6519,8269,6331,-1938
2015,10,1,18,6793,8787,6738,-2049
2015,10,1,19,7036,9057,6996,-2061
2015,10,1,20,7113,9196,7084,-2112
2015,10,1,21,7064,9270,7094,-2176
2015,10,1,22,6871,9121,7025,-2096
2015,10,1,23,6577,8679,6653,-2025
2015,10,2,0,6432,8477,6519,-1957
2015,10,2,1,6305,8224,6471,-1752
2015,10,2,2,5780,7545,6045,-1500
2015,10,2,3,5196,6882,5443,-1439
2015,10,2,4,4633,6114,4728,-1386
2015,10,2,5,4166,5544,4160,-1384
2015,10,2,6,3821,5138,3875,-1263
2015,10,2,7,3607,4862,3658,-1204
2015,10,2,8,3500,4721,3541,-1180
2015,10,2,9,3480,4702,3513,-1189
2015,10,2,10,3654,4977,3727,-1250
2015,10,2,11,4071,5533,4169,-1364
2015,10,2,12,4345,5878,4437,-1441
2015,10,2,13,4597,5936,4431,-1505
2015,10,2,14,4948,6268,4632,-1636
2015,10,2,15,5390,6724,4935,-1788
2015,10,2,16,5763,7203,5230,-1972
2015,10,2,17,6117,7697,5528,-2168
2015,10,2,18,6361,8078,5960,-2117
2015,10,2,19,6580,8349,6335,-2013
2015,10,2,20,6705,8520,6538,-1981
2015,10,2,21,6738,8493,6531,-1961
2015,10,2,22,6513,8238,6312,-1926
2015,10,2,23,6176,7750,5839,-1911
2015,10,3,0,5879,7502,5587,-1915
2015,10,3,1,5659,7205,5500,-1705
2015,10,3,2,5230,6646,5063,-1583
2015,10,3,3,4705,6146,4501,-1645
2015,10,3,4,4263,5575,4057,-1518
2015,10,3,5,4107,5092,3793,-1299
2015,10,3,6,3696,4716,3529,-1187
2015,10,3,7,3494,4439,3315,-1124
2015,10,3,8,3329,4291,3196,-1095
2015,10,3,9,3254,4197,3107,-1090
2015,10,3,10,3270,4209,3114,-1095
2015,10,3,11,3386,4371,3230,-1140
2015,10,3,12,3538,4561,3394,-1166
2015,10,3,13,3931,4945,3567,-1378
2015,10,3,14,4359,5428,3845,-1583
2015,10,3,15,4748,5855,4175,-1679
2015,10,3,16,5067,6224,4502,-1720
2015,10,3,17,5189,6490,4728,-1761
2015,10,3,18,5382,6662,4906,-1756
2015,10,3,19,5493,6721,4947,-1772
2015,10,3,20,5588,6727,4925,-1801
2015,10,3,21,5563,6698,4896,-1801
2015,10,3,22,5494,6580,4785,-1795
2015,10,3,23,5191,6304,4556,-1748
2015,10,4,0,5234,6187,4439,-1748
2015,10,4,1,5097,6041,4314,-1727
2015,10,4,2,4801,5586,3956,-1630
2015,10,4,3,4445,5196,3758,-1438
2015,10,4,4,4017,4706,3442,-1264
2015,10,4,5,3658,4259,3226,-1033
2015,10,4,6,3429,3917,3009,-908
2015,10,4,7,3242,3695,2840,-855
2015,10,4,8,3130,3565,2724,-841
2015,10,4,9,3091,3497,2670,-827
2015,10,4,10,3091,3517,2672,-845
2015,10,4,11,3157,3672,2771,-901
2015,10,4,12,3313,3868,2908,-960
2015,10,4,13,3652,4306,3212,-1094
2015,10,4,14,4039,4844,3664,-1180
2015,10,4,15,4368,5186,3955,-1231
2015,10,4,16,4674,5429,4153,-1275
2015,10,4,17,4916,5632,4304,-1327
2015,10,4,18,5098,5735,4391,-1344
2015,10,4,19,5234,5811,4445,-1366
2015,10,4,20,5356,5872,4498,-1374
2015,10,4,21,5363,5906,4510,-1396
2015,10,4,22,5218,5845,4448,-1397
2015,10,4,23,5028,5751,4351,-1400
2015,10,5,0,5006,5909,4482,-1427
2015,10,5,1,4861,5810,4389,-1421
2015,10,5,2,4550,5350,4031,-1319
2015,10,5,3,4179,4853,3649,-1204
2015,10,5,4,3790,4301,3198,-1103
2015,10,5,5,3217,3846,2865,-981
2015,10,5,6,2998,3567,2682,-885
2015,10,5,7,2913,3414,2565,-849
2015,10,5,8,2796,3348,2523,-825
2015,10,5,9,2869,3431,2572,-859
2015,10,5,10,3096,3787,2831,-956
2015,10,5,11,3544,4375,3305,-1070
2015,10,5,12,3831,4699,3569,-1130
2015,10,5,13,4008,4837,3567,-1270
2015,10,5,14,4357,5109,3683,-1426
2015,10,5,15,4728,5459,3841,-1618
2015,10,5,16,5053,5784,3959,-1825
2015,10,5,17,5345,6107,4085,-2022
2015,10,5,18,5610,6388,4297,-2091
2015,10,5,19,5770,6604,4436,-2168
2015,10,5,20,5940,6808,4576,-2232
2015,10,5,21,5967,6963,4680,-2283
2015,10,5,22,5949,7008,4712,-2296
2015,10,5,23,5746,6874,4666,-2208
2015,10,6,0,5670,6889,4671,-2218
2015,10,6,1,5530,6667,4640,-2027
2015,10,6,2,5064,6094,4308,-1786
2015,10,6,3,4503,5485,3853,-1632
2015,10,6,4,3988,4817,3414,-1403
2015,10,6,5,3428,4293,3110,-1183
2015,10,6,6,3185,3961,2955,-1006
2015,10,6,7,3063,3777,2825,-952
2015,10,6,8,2933,3665,2739,-926
2015,10,6,9,2972,3698,2753,-945
2015,10,6,10,3199,4006,2983,-1023
2015,10,6,11,3666,4584,3396,-1188
2015,10,6,12,3967,4881,3658,-1223
2015,10,6,13,4069,4903,3661,-1242
2015,10,6,14,4344,5147,3782,-1365
2015,10,6,15,4740,5477,4008,-1469
2015,10,6,16,5012,5850,4116,-1734
2015,10,6,17,5335,6256,4244,-2012
2015,10,6,18,5562,6663,4541,-2122
2015,10,6,19,5822,6915,4741,-2174
2015,10,6,20,5921,7062,4901,-2161
2015,10,6,21,6005,7151,4898,-2253
2015,10,6,22,5976,7139,4789,-2350
2015,10,6,23,5735,6969,4643,-2326
2015,10,7,0,5656,6933,4579,-2354
2015,10,7,1,5539,6781,4652,-2129
2015,10,7,2,5099,6173,4306,-1867
2015,10,7,3,4564,5509,3814,-1695
2015,10,7,4,4016,4845,3399,-1446
2015,10,7,5,3659,4311,3100,-1211
2015,10,7,6,3412,3963,2839,-1124
2015,10,7,7,3244,3743,2674,-1069
2015,10,7,8,3145,3641,2587,-1054
2015,10,7,9,3165,3659,2600,-1059
2015,10,7,10,3395,3942,2808,-1134
2015,10,7,11,3835,4568,3289,-1279
2015,10,7,12,4111,4813,3417,-1396
2015,10,7,13,4251,4919,3346,-1573
2015,10,7,14,4558,5340,3677,-1663
2015,10,7,15,5030,5808,4091,-1717
2015,10,7,16,5328,6311,4358,-1953
2015,10,7,17,5630,6817,4604,-2213
2015,10,7,18,5878,7286,5035,-2251
2015,10,7,19,6189,7662,5279,-2383
2015,10,7,20,6329,7944,5497,-2447
2015,10,7,21,6403,8059,5643,-2416
2015,10,7,22,6347,7974,5625,-2349
2015,10,7,23,6014,7594,5332,-2262
2015,10,8,0,5920,7427,5125,-2302
2015,10,8,1,5762,7196,4991,-2205
2015,10,8,2,5295,6560,4607,-1953
2015,10,8,3,4733,5896,4111,-1785
2015,10,8,4,4204,5179,3687,-1492
2015,10,8,5,3645,4609,3351,-1258
2015,10,8,6,3383,4214,3099,-1115
2015,10,8,7,3193,3997,2907,-1090
2015,10,8,8,3109,3843,2797,-1046
2015,10,8,9,3130,3871,2801,-1070
2015,10,8,10,3372,4157,3004,-1153
2015,10,8,11,3787,4760,3445,-1315
2015,10,8,12,4069,5030,3597,-1433
2015,10,8,13,4247,5199,3716,-1483
2015,10,8,14,4559,5621,4069,-1552
2015,10,8,15,5008,6244,4577,-1667
2015,10,8,16,5498,6841,4897,-1944
2015,10,8,17,5806,7373,5169,-2204
2015,10,8,18,6105,7716,5515,-2201
2015,10,8,19,6384,7972,5708,-2264
2015,10,8,20,6553,8213,5933,-2280
2015,10,8,21,6622,8372,6022,-2350
2015,10,8,22,6370,8338,6018,-2320
2015,10,8,23,6108,7990,5737,-2253
2015,10,9,0,6048,7855,5671,-2184
2015,10,9,1,5802,7579,5455,-2124
2015,10,9,2,5316,6919,4879,-2040
2015,10,9,3,4765,6239,4390,-1849
2015,10,9,4,4262,5518,3874,-1644
2015,10,9,5,3917,4916,3389,-1527
2015,10,9,6,3620,4535,3079,-1456
2015,10,9,7,3439,4307,2929,-1378
2015,10,9,8,3383,4140,2802,-1338
2015,10,9,9,3384,4176,2827,-1349
2015,10,9,10,3618,4446,2974,-1472
2015,10,9,11,4012,5045,3434,-1611
2015,10,9,12,4285,5333,3662,-1671
2015,10,9,13,4491,5555,3757,-1798
2015,10,9,14,4824,6090,4207,-1883
2015,10,9,15,5286,6706,4730,-1976
2015,10,9,16,5705,7327,5163,-2164
2015,10,9,17,6080,7875,5683,-2192
2015,10,9,18,6301,8306,6130,-2176
2015,10,9,19,6500,8572,6451,-2121
2015,10,9,20,6611,8719,6620,-2099
2015,10,9,21,6576,8690,6595,-2095
2015,10,9,22,6340,8388,6275,-2113
2015,10,9,23,6070,7920,5751,-2169
2015,10,10,0,5952,7713,5509,-2204
2015,10,10,1,5687,7346,5173,-2173
2015,10,10,2,5257,6761,4685,-2076
2015,10,10,3,4826,6227,4226,-2001
2015,10,10,4,4424,5619,3753,-1866
2015,10,10,5,4165,5081,3356,-1725
2015,10,10,6,3864,4692,3129,-1563
2015,10,10,7,3697,4421,2970,-1451
2015,10,10,8,3578,4271,2901,-1370
2015,10,10,9,3517,4183,2824,-1359
2015,10,10,10,3534,4229,2827,-1402
2015,10,10,11,3649,4402,2936,-1466
2015,10,10,12,3827,4634,3010,-1624
2015,10,10,13,4146,5108,3158,-1950
2015,10,10,14,4632,5820,3752,-2068
2015,10,10,15,5046,6428,4285,-2143
2015,10,10,16,5515,6880,4704,-2176
2015,10,10,17,5765,7420,5186,-2234
2015,10,10,18,5991,7869,5479,-2390
2015,10,10,19,6064,8071,5736,-2335
2015,10,10,20,6144,8097,5772,-2325
2015,10,10,21,6085,8112,5736,-2376
2015,10,10,22,5939,8036,5654,-2382
2015,10,10,23,5547,7603,5265,-2338
2015,10,11,0,5531,7317,4992,-2325
2015,10,11,1,5221,6979,4670,-2309
2015,10,11,2,4873,6419,4236,-2183
2015,10,11,3,4495,5892,3802,-2090
2015,10,11,4,4115,5359,3376,-1983
2015,10,11,5,3905,4837,2979,-1858
2015,10,11,6,3588,4431,2834,-1597
2015,10,11,7,3351,4175,2807,-1368
2015,10,11,8,3227,4001,2688,-1313
2015,10,11,9,3165,3893,2602,-1291
2015,10,11,10,3170,3882,2586,-1296
2015,10,11,11,3224,4033,2669,-1364
2015,10,11,12,3330,4239,2845,-1394
2015,10,11,13,3715,4705,3042,-1663
2015,10,11,14,4220,5323,3340,-1983
2015,10,11,15,4745,5882,3799,-2083
2015,10,11,16,5170,6458,4334,-2124
2015,10,11,17,5426,6985,4751,-2234
2015,10,11,18,5649,7331,5027,-2304
2015,10,11,19,5835,7567,5273,-2294
2015,10,11,20,5887,7722,5356,-2366
2015,10,11,21,5945,7782,5388,-2394
2015,10,11,22,5741,7658,5333,-2325
2015,10,11,23,5542,7246,4959,-2287
2015,10,12,0,5438,7040,4786,-2254
2015,10,12,1,5237,6733,4584,-2149
2015,10,12,2,4755,6011,3973,-2038
2015,10,12,3,4285,5378,3522,-1856
2015,10,12,4,3838,4707,3094,-1613
2015,10,12,5,3443,4194,2866,-1328
2015,10,12,6,3179,3860,2762,-1098
2015,10,12,7,3013,3667,2641,-1026
2015,10,12,8,2920,3576,2573,-1003
2015,10,12,9,2963,3606,2586,-1020
2015,10,12,10,3205,3915,2807,-1108
2015,10,12,11,3632,4482,3181,-1301
2015,10,12,12,3917,4779,3402,-1377
2015,10,12,13,3989,4939,3586,-1353
2015,10,12,14,4247,5293,3694,-1599
2015,10,12,15,4573,5716,3901,-1815
2015,10,12,16,4968,6140,4280,-1860
2015,10,12,17,5261,6487,4543,-1944
2015,10,12,18,5549,6866,4867,-1999
2015,10,12,19,5812,7212,5087,-2125
2015,10,12,20,6001,7541,5435,-2106
2015,10,12,21,6048,7727,5597,-2130
2015,10,12,22,5844,7686,5555,-2131
2015,10,12,23,5586,7320,5322,-1998
2015,10,13,0,5562,7140,5202,-1938
2015,10,13,1,5258,6754,4777,-1977
2015,10,13,2,4792,6083,4230,-1853
2015,10,13,3,4323,5399,3785,-1614
2015,10,13,4,3838,4688,3332,-1356
2015,10,13,5,3363,4178,2962,-1216
2015,10,13,6,3147,3841,2774,-1067
2015,10,13,7,2966,3636,2612,-1024
2015,10,13,8,2882,3546,2533,-1013
2015,10,13,9,2902,3579,2560,-1019
2015,10,13,10,3136,3910,2835,-1075
2015,10,13,11,3578,4516,3221,-1295
2015,10,13,12,3826,4814,3434,-1380
2015,10,13,13,3912,4944,3540,-1404
2015,10,13,14,4173,5256,3739,-1517
2015,10,13,15,4487,5756,4001,-1755
2015,10,13,16,4881,6209,4378,-1831
2015,10,13,17,5147,6664,4707,-1957
2015,10,13,18,5494,7147,5108,-2039
2015,10,13,19,5786,7532,5469,-2063
2015,10,13,20,5995,7757,5647,-2110
2015,10,13,21,6126,7924,5807,-2117
2015,10,13,22,6074,7849,5819,-2030
2015,10,13,23,5818,7566,5572,-1994
2015,10,14,0,5774,7481,5456,-2025
2015,10,14,1,5554,7149,5130,-2019
2015,10,14,2,5076,6432,4498,-1934
2015,10,14,3,4540,5764,4017,-1747
2015,10,14,4,4021,5042,3594,-1448
2015,10,14,5,3615,4502,3224,-1278
2015,10,14,6,3353,4122,2989,-1133
2015,10,14,7,3202,3912,2835,-1077
2015,10,14,8,3083,3816,2770,-1046
2015,10,14,9,3112,3833,2787,-1046
2015,10,14,10,3335,4136,3021,-1115
2015,10,14,11,3761,4755,3412,-1343
2015,10,14,12,4076,5027,3631,-1396
2015,10,14,13,4178,5194,3779,-1415
2015,10,14,14,4458,5647,4033,-1614
2015,10,14,15,4939,6177,4370,-1807
2015,10,14,16,5313,6717,4761,-1956
2015,10,14,17,5681,7255,5160,-2095
2015,10,14,18,5993,7785,5646,-2139
2015,10,14,19,6278,8216,6026,-2190
2015,10,14,20,6464,8596,6400,-2196
2015,10,14,21,6626,8750,6583,-2167
2015,10,14,22,6578,8625,6570,-2055
2015,10,14,23,6233,8187,6067,-2120
2015,10,15,0,6085,7967,5919,-2048
2015,10,15,1,5839,7554,5553,-2001
2015,10,15,2,5279,6818,4895,-1923
2015,10,15,3,4673,6362,4716,-1646
2015,10,15,4,4160,5366,3958,-1408
2015,10,15,5,3582,4763,3541,-1222
2015,10,15,6,3263,4370,3307,-1063
2015,10,15,7,3069,4094,3065,-1029
2015,10,15,8,2960,3945,2948,-997
2015,10,15,9,2984,3898,2901,-997
2015,10,15,10,3209,4150,3087,-1063
2015,10,15,11,3705,4711,3490,-1221
2015,10,15,12,3984,4932,3630,-1302
2015,10,15,13,4082,5034,3699,-1335
2015,10,15,14,4370,5358,3847,-1511
2015,10,15,15,4740,5769,4061,-1708
2015,10,15,16,5104,6228,4446,-1782
2015,10,15,17,5385,6690,4817,-1873
2015,10,15,18,5756,7184,5238,-1946
2015,10,15,19,6054,7614,5529,-2085
2015,10,15,20,6293,7965,5801,-2164
2015,10,15,21,6481,8136,5939,-2197
2015,10,15,22,6335,8011,5850,-2161
2015,10,15,23,6052,7541,5441,-2100
2015,10,16,0,5922,7306,5315,-1991
2015,10,16,1,5606,6928,4983,-1945
2015,10,16,2,5107,6252,4429,-1823
2015,10,16,3,4565,5616,4044,-1572
2015,10,16,4,4012,4905,3600,-1305
2015,10,16,5,3589,4350,3212,-1138
2015,10,16,6,3299,3992,2946,-1046
2015,10,16,7,3089,3767,2773,-994
2015,10,16,8,2988,3687,2688,-999
2015,10,16,9,2990,3654,2668,-986
2015,10,16,10,3200,3929,2868,-1061
2015,10,16,11,3630,4518,3294,-1224
2015,10,16,12,3870,4814,3526,-1288
2015,10,16,13,4018,4912,3584,-1328
2015,10,16,14,4358,5201,3660,-1541
2015,10,16,15,4708,5585,3936,-1649
2015,10,16,16,5128,5930,4144,-1786
2015,10,16,17,5462,6251,4396,-1855
2015,10,16,18,5798,6530,4607,-1923
2015,10,16,19,6070,6690,4711,-1979
2015,10,16,20,6296,6791,4722,-2069
2015,10,16,21,6409,6786,4685,-2101
2015,10,16,22,6222,6655,4583,-2072
2015,10,16,23,5865,6347,4340,-2007
2015,10,17,0,5634,6344,4392,-1952
2015,10,17,1,5307,6067,4209,-1858
2015,10,17,2,4914,5621,3836,-1785
2015,10,17,3,4491,5161,3567,-1594
2015,10,17,4,4057,4650,3294,-1356
2015,10,17,5,3664,4192,3103,-1089
2015,10,17,6,3346,3867,2991,-876
2015,10,17,7,3161,3631,2774,-857
2015,10,17,8,3042,3530,2704,-826
2015,10,17,9,2986,3479,2641,-838
2015,10,17,10,3008,3531,2682,-849
2015,10,17,11,3156,3740,2814,-926
2015,10,17,12,3348,3971,2889,-1082
2015,10,17,13,3688,4387,3167,-1220
2015,10,17,14,4147,4881,3495,-1386
2015,10,17,15,4581,5339,3766,-1573
2015,10,17,16,4990,5781,4125,-1656
2015,10,17,17,5305,6281,4494,-1787
2015,10,17,18,5607,6759,4840,-1919
2015,10,17,19,5906,7191,5117,-2074
2015,10,17,20,6144,7513,5308,-2205
2015,10,17,21,6257,7634,5456,-2178
2015,10,17,22,6140,7491,5365,-2126
2015,10,17,23,5685,6967,4931,-2036
2015,10,18,0,5629,6754,4907,-1847
2015,10,18,1,5271,6356,4565,-1791
2015,10,18,2,4863,5855,4179,-1676
2015,10,18,3,4491,5397,3917,-1480
2015,10,18,4,4072,4888,3660,-1228
2015,10,18,5,3500,4404,3269,-1135
2015,10,18,6,3236,4052,3037,-1015
2015,10,18,7,3028,3836,2858,-978
2015,10,18,8,2911,3691,2737,-954
2015,10,18,9,2873,3604,2670,-934
2015,10,18,10,2870,3621,2667,-954
2015,10,18,11,2957,3732,2709,-1023
2015,10,18,12,3132,3949,2849,-1100
2015,10,18,13,3465,4301,3068,-1233
2015,10,18,14,3880,4772,3339,-1433
2015,10,18,15,4213,5121,3518,-1603
2015,10,18,16,4541,5439,3806,-1633
2015,10,18,17,4760,5780,4082,-1698
2015,10,18,18,4976,6032,4176,-1856
2015,10,18,19,5190,6173,4271,-1902
2015,10,18,20,5342,6256,4322,-1934
2015,10,18,21,5373,6279,4321,-1958
2015,10,18,22,5244,6196,4270,-1926
2015,10,18,23,4958,6032,4220,-1812
2015,10,19,0,4990,6165,4306,-1859
2015,10,19,1,4744,5903,4177,-1726
2015,10,19,2,4337,5357,3748,-1609
2015,10,19,3,3914,4834,3420,-1414
2015,10,19,4,3489,4237,3100,-1137
2015,10,19,5,3203,3817,2792,-1025
2015,10,19,6,2960,3518,2610,-908
2015,10,19,7,2794,3358,2483,-875
2015,10,19,8,2753,3309,2429,-880
2015,10,19,9,2766,3348,2433,-915
2015,10,19,10,3027,3654,2656,-998
2015,10,19,11,3481,4224,3072,-1152
2015,10,19,12,3750,4550,3341,-1209
2015,10,19,13,3763,4675,3505,-1170
2015,10,19,14,3973,4974,3582,-1392
2015,10,19,15,4180,5268,3729,-1539
2015,10,19,16,4398,5507,3961,-1546
2015,10,19,17,4603,5719,4144,-1575
2015,10,19,18,4826,5931,4298,-1633
2015,10,19,19,5080,6109,4459,-1650
2015,10,19,20,5282,6257,4564,-1693
2015,10,19,21,5357,6322,4610,-1712
2015,10,19,22,5208,6269,4555,-1714
2015,10,19,23,4995,6167,4440,-1727
2015,10,20,0,5137,6309,4484,-1825
2015,10,20,1,4873,6080,4332,-1748
2015,10,20,2,4422,5502,3903,-1599
2015,10,20,3,3993,4959,3575,-1384
2015,10,20,4,3527,4353,3212,-1141
2015,10,20,5,3106,3883,2891,-992
2015,10,20,6,2938,3589,2686,-903
2015,10,20,7,2830,3420,2568,-852
2015,10,20,8,2739,3340,2470,-870
2015,10,20,9,2768,3387,2456,-931
2015,10,20,10,3003,3707,2733,-974
2015,10,20,11,3409,4319,3181,-1138
2015,10,20,12,3722,4611,3410,-1201
2015,10,20,13,3799,4732,3502,-1230
2015,10,20,14,4054,4985,3585,-1399
2015,10,20,15,4369,5306,3741,-1564
2015,10,20,16,4649,5627,4014,-1612
2015,10,20,17,4819,5933,4270,-1662
2015,10,20,18,4980,6258,4554,-1703
2015,10,20,19,5177,6519,4757,-1762
2015,10,20,20,5348,6742,4916,-1825
2015,10,20,21,5427,6875,5000,-1874
2015,10,20,22,5386,6838,4966,-1872
2015,10,20,23,5163,6614,4745,-1869
2015,10,21,0,5251,6710,4779,-1931
2015,10,21,1,5148,6441,4634,-1807
2015,10,21,2,4710,5884,4291,-1593
2015,10,21,3,4216,5291,3824,-1467
2015,10,21,4,3760,4642,3434,-1208
2015,10,21,5,3380,4148,3128,-1020
2015,10,21,6,3106,3799,2898,-901
2015,10,21,7,2959,3637,2748,-889
2015,10,21,8,2906,3562,2679,-883
2015,10,21,9,2938,3620,2725,-895
2015,10,21,10,3211,3944,2970,-974
2015,10,21,11,3719,4552,3422,-1130
2015,10,21,12,4027,4866,3648,-1218
2015,10,21,13,4146,4969,3735,-1234
2015,10,21,14,4429,5320,3908,-1412
2015,10,21,15,4701,5705,4096,-1609
2015,10,21,16,4948,6071,4410,-1661
2015,10,21,17,5147,6437,4695,-1742
2015,10,21,18,5338,6697,4819,-1878
2015,10,21,19,5503,6893,4998,-1895
2015,10,21,20,5630,6993,5082,-1911
2015,10,21,21,5674,7029,5103,-1926
2015,10,21,22,5578,6977,5018,-1959
2015,10,21,23,5493,6777,4876,-1901
2015,10,22,0,5597,6881,4861,-2020
2015,10,22,1,5395,6617,4802,-1815
2015,10,22,2,4884,6054,4350,-1704
2015,10,22,3,4416,5448,3946,-1502
2015,10,22,4,3899,4819,3580,-1239
2015,10,22,5,3626,4305,3197,-1108
2015,10,22,6,3350,3989,2983,-1006
2015,10,22,7,3172,3796,2825,-971
2015,10,22,8,3082,3728,2767,-961
2015,10,22,9,3110,3739,2758,-981
2015,10,22,10,3330,4027,2958,-1069
2015,10,22,11,3782,4635,3404,-1231
2015,10,22,12,3988,4954,3669,-1285
2015,10,22,13,4067,5048,3753,-1295
2015,10,22,14,4319,5391,3834,-1557
2015,10,22,15,4712,5808,3946,-1862
2015,10,22,16,5042,6297,4221,-2076
2015,10,22,17,5331,6753,4593,-2160
2015,10,22,18,5619,7127,4831,-2296
2015,10,22,19,5858,7456,5089,-2367
2015,10,22,20,6036,7660,5295,-2365
2015,10,22,21,6059,7744,5375,-2369
2015,10,22,22,5930,7560,5217,-2343
2015,10,22,23,5718,7242,4932,-2310
2015,10,23,0,5635,7218,4869,-2349
2015,10,23,1,5413,6862,4688,-2174
2015,10,23,2,4985,6304,4209,-2095
2015,10,23,3,4530,5678,3806,-1872
2015,10,23,4,4051,4992,3504,-1488
2015,10,23,5,3677,4448,3196,-1252
2015,10,23,6,3362,4123,2981,-1142
2015,10,23,7,3185,3911,2811,-1100
2015,10,23,8,3079,3788,2702,-1086
2015,10,23,9,3088,3787,2688,-1099
2015,10,23,10,3308,4039,2896,-1143
2015,10,23,11,3758,4577,3279,-1298
2015,10,23,12,4021,4906,3525,-1381
2015,10,23,13,4153,5088,3593,-1495
2015,10,23,14,4462,5531,3826,-1705
2015,10,23,15,4850,6089,4262,-1827
2015,10,23,16,5260,6579,4547,-2032
2015,10,23,17,5595,7011,4860,-2151
2015,10,23,18,5922,7432,5085,-2347
2015,10,23,19,6145,7695,5362,-2333
2015,10,23,20,6279,7887,5486,-2401
2015,10,23,21,6309,7928,5522,-2406
2015,10,23,22,6147,7731,5368,-2363
2015,10,23,23,5818,7236,4967,-2269
2015,10,24,0,5649,7011,4723,-2288
2015,10,24,1,5378,6588,4428,-2160
2015,10,24,2,4958,6049,4084,-1965
2015,10,24,3,4549,5540,3805,-1735
2015,10,24,4,4081,5001,3525,-1476
2015,10,24,5,3738,4452,3280,-1172
2015,10,24,6,3433,4063,2954,-1109
2015,10,24,7,3222,3821,2767,-1054
2015,10,24,8,3095,3661,2642,-1019
2015,10,24,9,3045,3582,2558,-1024
2015,10,24,10,3076,3658,2597,-1061
2015,10,24,11,3200,3861,2754,-1107
2015,10,24,12,3412,4108,2953,-1155
2015,10,24,13,3759,4500,3119,-1381
2015,10,24,14,4183,5060,3383,-1677
2015,10,24,15,4613,5576,3772,-1804
2015,10,24,16,4968,6013,4006,-2007
2015,10,24,17,5269,6449,4205,-2244
2015,10,24,18,5563,6809,4548,-2261
2015,10,24,19,5786,7135,4852,-2283
2015,10,24,20,5981,7354,5083,-2271
2015,10,24,21,6042,7456,5148,-2308
2015,10,24,22,5907,7305,5082,-2223
2015,10,24,23,5621,6914,4673,-2241
2015,10,25,0,5518,6784,4539,-2245
2015,10,25,1,5255,6402,4266,-2136
2015,10,25,2,4868,5897,3966,-1931
2015,10,25,3,4446,5441,3640,-1801
2015,10,25,4,4044,4909,3420,-1489
2015,10,25,5,3702,4451,3188,-1263
2015,10,25,6,3412,4073,2942,-1131
2015,10,25,7,3185,3887,2783,-1104
2015,10,25,8,3070,3746,2671,-1075
2015,10,25,9,3023,3691,2624,-1067
2015,10,25,10,3037,3722,2666,-1056
2015,10,25,11,3140,3863,2797,-1066
2015,10,25,12,3336,4113,2971,-1142
2015,10,25,13,3700,4520,3121,-1399
2015,10,25,14,4158,5068,3380,-1688
2015,10,25,15,4593,5597,3789,-1808
2015,10,25,16,4965,6103,4086,-2017
2015,10,25,17,5311,6621,4349,-2272
2015,10,25,18,5570,7086,4848,-2238
2015,10,25,19,5785,7426,5147,-2279
2015,10,25,20,5940,7592,5248,-2344
2015,10,25,21,5987,7575,5312,-2263
2015,10,25,22,5948,7369,5118,-2251
2015,10,25,23,5699,7112,4783,-2329
2015,10,26,0,5614,7170,4845,-2325
2015,10,26,1,5389,6780,4537,-2243
2015,10,26,2,4946,6218,4174,-2044
2015,10,26,3,4499,5666,3840,-1826
2015,10,26,4,4035,5039,3533,-1506
2015,10,26,5,3658,4501,3232,-1269
2015,10,26,6,3357,4153,2991,-1162
2015,10,26,7,3160,3938,2841,-1097
2015,10,26,8,3056,3815,2749,-1066
2015,10,26,9,3080,3820,2751,-1069
2015,10,26,10,3336,4085,2980,-1105
2015,10,26,11,3803,4592,3318,-1274
2015,10,26,12,4073,4950,3615,-1335
2015,10,26,13,4250,5119,3665,-1454
2015,10,26,14,4548,5553,3859,-1694
2015,10,26,15,4903,6067,4257,-1810
2015,10,26,16,5292,6577,4701,-1876
2015,10,26,17,5523,6958,5126,-1832
2015,10,26,18,5828,7226,5287,-1939
2015,10,26,19,5996,7248,5286,-1962
2015,10,26,20,6074,7127,5193,-1934
2015,10,26,21,6134,7044,5139,-1905
2015,10,26,22,6089,6958,5031,-1927
2015,10,26,23,5871,6966,5019,-1947
2015,10,27,0,5788,7099,5106,-1993
2015,10,27,1,5615,6785,4837,-1948
2015,10,27,2,5184,6202,4387,-1815
2015,10,27,3,4618,5650,3898,-1752
2015,10,27,4,4069,5037,3540,-1497
2015,10,27,5,3632,4546,3280,-1266
2015,10,27,6,3357,4218,3089,-1129
2015,10,27,7,3198,4024,2930,-1094
2015,10,27,8,3107,3940,2856,-1084
2015,10,27,9,3125,3961,2864,-1097
2015,10,27,10,3379,4272,3103,-1169
2015,10,27,11,3888,4896,3525,-1371
2015,10,27,12,4184,5302,3760,-1542
2015,10,27,13,4301,5353,3707,-1646
2015,10,27,14,4613,5523,3833,-1690
2015,10,27,15,5047,5736,4034,-1702
2015,10,27,16,5418,5878,4083,-1795
2015,10,27,17,5737,5971,4117,-1854
2015,10,27,18,6013,6036,4209,-1827
2015,10,27,19,6139,6069,4195,-1874
2015,10,27,20,6232,6013,4126,-1887
2015,10,27,21,6231,6072,4162,-1910
2015,10,27,22,6096,6160,4091,-2069
2015,10,27,23,5858,6258,4110,-2148
2015,10,28,0,5858,6514,4314,-2200
2015,10,28,1,5620,6336,4157,-2179
2015,10,28,2,5169,5901,3941,-1960
2015,10,28,3,4719,5418,3678,-1740
2015,10,28,4,4210,4856,3430,-1426
2015,10,28,5,3718,4417,3189,-1228
2015,10,28,6,3506,4126,3009,-1117
2015,10,28,7,3383,3975,2876,-1099
2015,10,28,8,3306,3909,2834,-1075
2015,10,28,9,3319,3970,2867,-1103
2015,10,28,10,3578,4301,3117,-1184
2015,10,28,11,4075,4922,3548,-1374
2015,10,28,12,4373,5328,3849,-1479
2015,10,28,13,4462,5413,3756,-1657
2015,10,28,14,4757,5664,3897,-1767
2015,10,28,15,5133,5961,4143,-1818
2015,10,28,16,5521,6232,4244,-1988
2015,10,28,17,5832,6506,4279,-2227
2015,10,28,18,6052,6812,4474,-2338
2015,10,28,19,6147,7177,4706,-2471
2015,10,28,20,6109,7530,5044,-2486
2015,10,28,21,6052,7733,5285,-2448
2015,10,28,22,5943,7657,5303,-2354
2015,10,28,23,5659,7371,5013,-2358
2015,10,29,0,5598,7334,5015,-2319
2015,10,29,1,5400,6893,4717,-2176
2015,10,29,2,4956,6257,4302,-1955
2015,10,29,3,4492,5656,3917,-1739
2015,10,29,4,4037,4996,3524,-1472
2015,10,29,5,3658,4467,3220,-1247
2015,10,29,6,3381,4079,2969,-1110
2015,10,29,7,3239,3854,2785,-1069
2015,10,29,8,3152,3745,2661,-1084
2015,10,29,9,3158,3783,2683,-1100
2015,10,29,10,3377,4058,2892,-1166
2015,10,29,11,3826,4670,3326,-1344
2015,10,29,12,4103,4992,3522,-1470
2015,10,29,13,4191,5088,3473,-1615
2015,10,29,14,4491,5499,3790,-1709
2015,10,29,15,4803,6020,4232,-1788
2015,10,29,16,5103,6451,4573,-1878
2015,10,29,17,5391,6867,4889,-1978
2015,10,29,18,5610,7254,5351,-1903
2015,10,29,19,5820,7576,5613,-1963
2015,10,29,20,5953,7816,5776,-2040
2015,10,29,21,5961,7928,5878,-2050
2015,10,29,22,5920,7805,5807,-1998
2015,10,29,23,5687,7401,5449,-1952
2015,10,30,0,5567,7307,5336,-1971
2015,10,30,1,5437,6887,4940,-1947
2015,10,30,2,4962,6254,4430,-1824
2015,10,30,3,4461,5615,3919,-1696
2015,10,30,4,4001,4934,3484,-1450
2015,10,30,5,3528,4342,3139,-1203
2015,10,30,6,3261,3974,2897,-1077
2015,10,30,7,3082,3749,2705,-1044
2015,10,30,8,3000,3617,2577,-1040
2015,10,30,9,3003,3626,2583,-1043
2015,10,30,10,3213,3894,2795,-1099
2015,10,30,11,3605,4455,3152,-1303
2015,10,30,12,3880,4768,3324,-1444
2015,10,30,13,3999,4879,3305,-1574
2015,10,30,14,4261,5250,3558,-1692
2015,10,30,15,4613,5692,3971,-1721
2015,10,30,16,4913,6119,4266,-1853
2015,10,30,17,5122,6551,4672,-1879
2015,10,30,18,5347,6976,4911,-2065
2015,10,30,19,5587,7354,5036,-2318
2015,10,30,20,5748,7642,5193,-2449
2015,10,30,21,5809,7778,5285,-2493
2015,10,30,22,5691,7555,5119,-2436
2015,10,30,23,5446,7043,4750,-2292
2015,10,31,0,5268,6843,4523,-2319
2015,10,31,1,5079,6418,4194,-2223
2015,10,31,2,4700,5901,3888,-2012
2015,10,31,3,4328,5413,3597,-1815
2015,10,31,4,3918,4862,3362,-1500
2015,10,31,5,3520,4359,3158,-1201
2015,10,31,6,3178,3997,3027,-970
2015,10,31,7,3052,3757,2840,-917
2015,10,31,8,2948,3621,2717,-904
2015,10,31,9,2916,3556,2661,-895
2015,10,31,10,2935,3612,2691,-921
2015,10,31,11,3072,3809,2858,-951
2015,10,31,12,3263,4080,3037,-1043
2015,10,31,13,3624,4453,3238,-1215
2015,10,31,14,3947,5058,3713,-1345
2015,10,31,15,4310,5625,4176,-1449
2015,10,31,16,4716,6159,4514,-1645
2015,10,31,17,5012,6664,4794,-1870
2015,10,31,18,5284,7132,5169,-1963
2015,10,31,19,5487,7545,5467,-2078
2015,10,31,20,5745,7778,5663,-2115
2015,10,31,21,5851,7783,5689,-2094
2015,10,31,22,5899,7530,5515,-2013
2015,10,31,23,5660,7052,5095,-1956
2015,11,1,0,5306,6725,4860,-1865
2015,11,1,1,5096,6325,4522,-1802
2015,11,1,2,4740,5982,4270,-1712
2015,11,1,3,4372,5653,3972,-1680
2015,11,1,4,3998,5134,3577,-1556
2015,11,1,5,-9999,4687,3311,-1376
2015,11,1,6,-9999,4054,3007,-1170
2015,11,1,7,-9999,4312,2949,-1240
2015,11,1,8,-9999,3914,2750,-1164
2015,11,1,9,-9999,3812,2670,-1142
2015,11,1,10,-9999,3789,2655,-1134
2015,11,1,11,-9999,3883,2707,-1176
2015,11,1,12,-9999,4043,2848,-1195
2015,11,1,13,-9999,4510,3172,-1338
2015,11,1,14,-9999,5361,3794,-1567
2015,11,1,15,-9999,6219,4488,-1731
2015,11,1,16,-9999,6905,5095,-1810
2015,11,1,17,-9999,7469,5490,-1979
2015,11,1,18,-9999,7921,5791,-2130
2015,11,1,19,-9999,8210,5938,-2272
2015,11,1,20,-9999,8265,6086,-2179
2015,11,1,21,-9999,8265,6083,-2182
2015,11,1,22,-9999,8158,5979,-2179
2015,11,1,23,-9999,8051,5950,-2101
2015,11,2,0,-9999,8047,5934,-2113
2015,11,2,1,-9999,7580,5575,-2005
2015,11,2,2,-9999,7031,5026,-2005
2015,11,2,3,-9999,6369,4516,-1853
2015,11,2,4,-9999,5746,4042,-1704
2015,11,2,5,-9999,5174,3619,-1555
2015,11,2,6,3899,4739,3351,-1388
2015,11,2,7,3750,4427,3150,-1277
2015,11,2,8,3470,4252,3026,-1226
2015,11,2,9,3417,4170,2953,-1217
2015,11,2,10,3447,4276,3026,-1250
2015,11,2,11,3734,4632,3299,-1333
2015,11,2,12,4216,5257,3809,-1448
2015,11,2,13,4506,5680,4182,-1498
2015,11,2,14,4880,6173,4587,-1586
2015,11,2,15,5336,6825,5125,-1700
2015,11,2,16,5782,7510,5505,-2005
2015,11,2,17,6170,8118,5940,-2178
2015,11,2,18,6529,8631,6468,-2163
2015,11,2,19,6682,8930,6919,-2011
2015,11,2,20,6703,9042,6933,-2109
2015,11,2,21,6598,8932,6863,-2069
2015,11,2,22,6438,8713,6686,-2027
2015,11,2,23,6369,8472,6397,-2075
2015,11,3,0,6499,8484,6181,-2303
2015,11,3,1,6245,8065,5995,-2070
2015,11,3,2,5875,7486,5438,-2048
2015,11,3,3,5329,6763,4809,-1954
2015,11,3,4,4834,6123,4380,-1743
2015,11,3,5,4352,5458,3873,-1585
2015,11,3,6,3796,4926,3626,-1300
2015,11,3,7,3588,4624,3395,-1229
2015,11,3,8,3342,4459,3225,-1234
2015,11,3,9,3312,4379,3159,-1220
2015,11,3,10,3400,4394,3157,-1237
2015,11,3,11,3626,4711,3392,-1319
2015,11,3,12,4251,5267,3859,-1408
2015,11,3,13,4524,5659,4198,-1461
2015,11,3,14,4827,6150,4597,-1553
2015,11,3,15,5281,6776,5044,-1732
2015,11,3,16,5709,7489,5406,-2083
2015,11,3,17,6157,8119,5657,-2462
2015,11,3,18,6466,8674,6152,-2522
2015,11,3,19,6658,9013,6686,-2327
2015,11,3,20,6638,9133,6861,-2272
2015,11,3,21,6540,9084,6874,-2210
2015,11,3,22,6460,8859,6716,-2143
2015,11,3,23,6448,8553,6357,-2196
2015,11,4,0,6659,8564,6439,-2125
2015,11,4,1,6294,8137,6064,-2073
2015,11,4,2,5855,7579,5734,-1845
2015,11,4,3,5307,6885,5190,-1695
2015,11,4,4,4806,6199,4739,-1460
2015,11,4,5,4234,5486,4121,-1365
2015,11,4,6,3945,4956,3598,-1358
2015,11,4,7,3718,4591,3305,-1286
2015,11,4,8,3383,4356,3025,-1331
2015,11,4,9,3270,4241,2910,-1331
2015,11,4,10,3273,4246,2914,-1332
2015,11,4,11,3541,4545,3124,-1421
2015,11,4,12,4050,5141,3546,-1595
2015,11,4,13,4336,5483,3726,-1757
2015,11,4,14,4731,5950,4082,-1868
2015,11,4,15,5253,6590,4540,-2050
2015,11,4,16,5753,7245,5091,-2154
2015,11,4,17,6183,7869,5618,-2251
2015,11,4,18,6512,8366,6015,-2351
2015,11,4,19,6765,8653,6200,-2453
2015,11,4,20,6816,8782,6282,-2500
2015,11,4,21,6720,8712,6240,-2472
2015,11,4,22,6549,8465,6090,-2375
2015,11,4,23,6565,8215,5822,-2393
2015,11,5,0,6547,8259,5886,-2373
2015,11,5,1,6262,7884,5533,-2351
2015,11,5,2,5818,7436,5205,-2231
2015,11,5,3,5261,6774,4650,-2124
2015,11,5,4,4772,6193,4229,-1964
2015,11,5,5,4229,5590,3824,-1766
2015,11,5,6,3842,5102,3540,-1562
2015,11,5,7,3600,4777,3385,-1392
2015,11,5,8,3347,4579,3223,-1356
2015,11,5,9,3307,4441,3099,-1342
2015,11,5,10,3243,4476,3087,-1389
2015,11,5,11,3659,4728,3316,-1412
2015,11,5,12,4220,5339,3827,-1512
2015,11,5,13,4467,5670,4134,-1536
2015,11,5,14,4811,6188,4606,-1582
2015,11,5,15,5353,6781,4979,-1802
2015,11,5,16,5857,7404,5502,-1902
2015,11,5,17,6255,7909,5779,-2130
2015,11,5,18,6474,8320,6020,-2300
2015,11,5,19,6690,8608,6272,-2336
2015,11,5,20,6707,8769,6346,-2423
2015,11,5,21,6600,8743,6316,-2427
2015,11,5,22,6471,8611,6183,-2428
2015,11,5,23,6452,8267,5903,-2364
2015,11,6,0,6693,8249,5960,-2289
2015,11,6,1,6332,7829,5768,-2061
2015,11,6,2,5874,7320,5514,-1806
2015,11,6,3,5416,6684,4971,-1713
2015,11,6,4,4888,6048,4507,-1541
2015,11,6,5,4302,5365,3898,-1467
2015,11,6,6,3834,4829,3479,-1350
2015,11,6,7,3571,4467,3142,-1325
2015,11,6,8,3345,4234,2948,-1286
2015,11,6,9,3285,4092,2827,-1265
2015,11,6,10,3236,4119,2837,-1282
2015,11,6,11,3578,4405,3030,-1375
2015,11,6,12,4055,4984,3524,-1460
2015,11,6,13,4285,5366,3778,-1588
2015,11,6,14,4663,5884,4060,-1824
2015,11,6,15,5204,6538,4423,-2115
2015,11,6,16,5649,7136,4979,-2157
2015,11,6,17,6080,7686,5411,-2275
2015,11,6,18,6357,8204,5768,-2436
2015,11,6,19,6607,8539,6158,-2381
2015,11,6,20,6660,8661,6301,-2360
2015,11,6,21,6630,8593,6240,-2353
2015,11,6,22,6477,8338,6043,-2295
2015,11,6,23,6277,7994,5652,-2342
2015,11,7,0,6518,7849,5448,-2401
2015,11,7,1,6153,7371,5084,-2287
2015,11,7,2,5722,6879,4715,-2164
2015,11,7,3,5289,6337,4374,-1963
2015,11,7,4,4848,5842,4072,-1770
2015,11,7,5,4160,5268,3865,-1403
2015,11,7,6,3812,4777,3667,-1110
2015,11,7,7,3563,4411,3395,-1016
2015,11,7,8,3286,4145,3171,-974
2015,11,7,9,3188,4011,3048,-963
2015,11,7,10,3136,3942,3001,-941
2015,11,7,11,3195,3992,3039,-953
2015,11,7,12,3332,4184,3214,-970
2015,11,7,13,3543,4584,3434,-1150
2015,11,7,14,4076,5308,3924,-1384
2015,11,7,15,4635,6103,4497,-1606
2015,11,7,16,5097,6816,5085,-1731
2015,11,7,17,5501,7408,5517,-1891
2015,11,7,18,5816,7924,6010,-1914
2015,11,7,19,6002,8305,6360,-1945
2015,11,7,20,6092,8516,6600,-1916
2015,11,7,21,6052,8465,6593,-1872
2015,11,7,22,5910,8240,6343,-1897
2015,11,7,23,5850,7890,6001,-1889
2015,11,8,0,5906,7768,5827,-1941
2015,11,8,1,5537,7329,5495,-1834
2015,11,8,2,5175,6874,5148,-1726
2015,11,8,3,4779,6317,4702,-1615
2015,11,8,4,4403,5830,4294,-1536
2015,11,8,5,4030,5240,3985,-1255
2015,11,8,6,3931,4769,3671,-1098
2015,11,8,7,3703,4421,3396,-1025
2015,11,8,8,3388,4161,3189,-972
2015,11,8,9,3290,4013,3048,-965
2015,11,8,10,3213,3934,2997,-937
2015,11,8,11,3235,3965,3005,-960
2015,11,8,12,3333,4114,3143,-971
2015,11,8,13,3517,4508,3366,-1142
2015,11,8,14,4039,5334,3870,-1464
2015,11,8,15,4664,6166,4551,-1615
2015,11,8,16,5121,6860,5158,-1702
2015,11,8,17,5435,7421,5557,-1864
2015,11,8,18,5666,7883,6026,-1857
2015,11,8,19,5847,8108,6269,-1839
2015,11,8,20,5916,8028,6252,-1776
2015,11,8,21,5805,7757,5953,-1804
2015,11,8,22,5670,7476,5745,-1731
2015,11,8,23,5676,7441,5630,-1811
2015,11,9,0,5759,7510,5643,-1867
2015,11,9,1,5441,7216,5427,-1789
2015,11,9,2,5060,6841,5131,-1710
2015,11,9,3,4663,6236,4739,-1497
2015,11,9,4,4233,5679,4212,-1467
2015,11,9,5,3832,5094,3896,-1198
2015,11,9,6,3623,4691,3672,-1019
2015,11,9,7,3363,4382,3410,-972
2015,11,9,8,3211,4212,3271,-941
2015,11,9,9,3145,4111,3186,-925
2015,11,9,10,3220,4212,3250,-962
2015,11,9,11,3464,4595,3520,-1075
2015,11,9,12,3972,5231,4081,-1150
2015,11,9,13,4289,5649,4415,-1234
2015,11,9,14,4547,6050,4707,-1343
2015,11,9,15,4918,6475,4989,-1486
2015,11,9,16,5358,6947,5439,-1508
2015,11,9,17,5716,7292,5731,-1561
2015,11,9,18,5938,7484,5861,-1623
2015,11,9,19,6150,7537,5941,-1596
2015,11,9,20,6198,7465,5911,-1554
2015,11,9,21,6146,7295,5727,-1568
2015,11,9,22,6018,7153,5577,-1576
2015,11,9,23,6092,7288,5624,-1664
2015,11,10,0,6002,7470,5731,-1739
2015,11,10,1,5802,7162,5508,-1654
2015,11,10,2,5388,6743,5175,-1568
2015,11,10,3,5011,6163,4694,-1469
2015,11,10,4,4532,5621,4393,-1228
2015,11,10,5,4044,5063,3973,-1090
2015,11,10,6,3656,4603,3609,-994
2015,11,10,7,3380,4303,3374,-929
2015,11,10,8,3246,4137,3189,-948
2015,11,10,9,3183,4034,3140,-894
2015,11,10,10,3235,4092,3174,-918
2015,11,10,11,3468,4413,3410,-1003
2015,11,10,12,3962,5025,4026,-999
2015,11,10,13,4257,5407,4408,-999
2015,11,10,14,4507,5677,4372,-1305
2015,11,10,15,4831,6073,4594,-1479
2015,11,10,16,5276,6454,5027,-1427
2015,11,10,17,5690,6819,5322,-1497
2015,11,10,18,6055,7202,5768,-1434
2015,11,10,19,6261,7500,6243,-1257
2015,11,10,20,6324,7687,6521,-1166
2015,11,10,21,6283,7742,6490,-1252
2015,11,10,22,6149,7616,6328,-1288
2015,11,10,23,6003,7412,6121,-1291
2015,11,11,0,5959,7436,6063,-1373
2015,11,11,1,5737,7088,5661,-1427
2015,11,11,2,5351,6621,5148,-1473
2015,11,11,3,4920,6025,4593,-1432
2015,11,11,4,4399,5439,4172,-1267
2015,11,11,5,3875,4833,3842,-991
2015,11,11,6,3401,4377,3440,-937
2015,11,11,7,3131,4084,3184,-900
2015,11,11,8,2974,3918,3048,-870
2015,11,11,9,2918,3859,2997,-862
2015,11,11,10,2889,3890,3031,-859
2015,11,11,11,3099,4138,3210,-928
2015,11,11,12,3476,4681,3670,-1011
2015,11,11,13,3743,4982,3948,-1034
2015,11,11,14,4105,5249,4033,-1216
2015,11,11,15,4501,5540,4120,-1420
2015,11,11,16,4859,5974,4505,-1469
2015,11,11,17,5212,6443,4930,-1513
2015,11,11,18,5523,6941,5337,-1604
2015,11,11,19,5653,7392,5975,-1417
2015,11,11,20,5750,7693,6234,-1459
2015,11,11,21,5747,7787,6410,-1377
2015,11,11,22,5587,7651,6374,-1277
2015,11,11,23,5465,7331,6091,-1240
2015,11,12,0,5488,7302,6203,-1099
2015,11,12,1,5275,6843,5764,-1079
2015,11,12,2,4957,6368,5321,-1047
2015,11,12,3,4564,5762,4524,-1238
2015,11,12,4,4106,5185,3924,-1261
2015,11,12,5,3710,4565,3561,-1004
2015,11,12,6,3475,4110,3285,-825
2015,11,12,7,3193,3806,3042,-764
2015,11,12,8,3018,3643,2821,-822
2015,11,12,9,2914,3560,2736,-824
2015,11,12,10,2935,3600,2762,-838
2015,11,12,11,3250,3921,3041,-880
2015,11,12,12,3790,4618,3663,-955
2015,11,12,13,4098,4828,3732,-1096
2015,11,12,14,4404,5097,3904,-1193
2015,11,12,15,4910,5516,4170,-1346
2015,11,12,16,5349,6024,4657,-1367
2015,11,12,17,5825,6534,5030,-1504
2015,11,12,18,6171,7055,5521,-1534
2015,11,12,19,6374,7478,5918,-1560
2015,11,12,20,6482,7741,6163,-1578
2015,11,12,21,6574,7861,6267,-1594
2015,11,12,22,6432,7721,6197,-1524
2015,11,12,23,6309,7414,6001,-1413
2015,11,13,0,6293,7377,6028,-1349
2015,11,13,1,6007,6981,5583,-1398
2015,11,13,2,5592,6517,5079,-1438
2015,11,13,3,5123,5917,4527,-1390
2015,11,13,4,4557,5317,3986,-1331
2015,11,13,5,3998,4727,3708,-1019
2015,11,13,6,3541,4234,3379,-855
2015,11,13,7,3222,3907,3027,-880
2015,11,13,8,3043,3717,2858,-859
2015,11,13,9,2929,3634,2786,-848
2015,11,13,10,2965,3654,2797,-857
2015,11,13,11,3218,3961,3086,-875
2015,11,13,12,3780,4534,3601,-933
2015,11,13,13,4102,4869,3778,-1091
2015,11,13,14,4392,5147,3880,-1267
2015,11,13,15,4732,5485,4126,-1359
2015,11,13,16,5125,5821,4401,-1420
2015,11,13,17,5508,6183,4704,-1479
2015,11,13,18,5688,6615,5057,-1558
2015,11,13,19,5829,6969,5342,-1627
2015,11,13,20,5905,7231,5537,-1694
2015,11,13,21,5864,7312,5595,-1717
2015,11,13,22,5774,7114,5454,-1660
2015,11,13,23,5606,6814,5201,-1613
2015,11,14,0,5765,6721,5113,-1608
2015,11,14,1,5484,6298,4750,-1548
2015,11,14,2,5036,5887,4407,-1480
2015,11,14,3,4574,5413,4000,-1413
2015,11,14,4,4156,4927,3598,-1329
2015,11,14,5,3697,4390,3341,-1049
2015,11,14,6,3321,3951,3129,-822
2015,11,14,7,3010,3638,2872,-766
2015,11,14,8,2828,3468,2732,-736
2015,11,14,9,2738,3371,2641,-730
2015,11,14,10,2677,3358,2624,-734
2015,11,14,11,2801,3454,2668,-786
2015,11,14,12,3034,3685,2839,-846
2015,11,14,13,3308,3988,3088,-900
2015,11,14,14,3814,4440,3290,-1150
2015,11,14,15,4135,4763,3376,-1387
2015,11,14,16,4397,4969,3583,-1386
2015,11,14,17,4566,5132,3736,-1396
2015,11,14,18,4776,5320,3923,-1397
2015,11,14,19,4849,5456,4067,-1389
2015,11,14,20,4923,5473,4063,-1410
2015,11,14,21,4897,5430,4027,-1403
2015,11,14,22,4836,5373,3995,-1378
2015,11,14,23,4814,5492,4020,-1472
2015,11,15,0,4971,5645,4114,-1531
2015,11,15,1,4702,5437,3966,-1471
2015,11,15,2,4427,5172,3822,-1350
2015,11,15,3,4064,4842,3551,-1291
2015,11,15,4,3665,4501,3227,-1274
2015,11,15,5,3286,4129,3112,-1017
2015,11,15,6,3098,3806,2975,-831
2015,11,15,7,2892,3563,2811,-752
2015,11,15,8,2746,3408,2690,-718
2015,11,15,9,2717,3359,2638,-721
2015,11,15,10,2705,3343,2628,-715
2015,11,15,11,2779,3410,2619,-791
2015,11,15,12,2928,3582,2743,-839
2015,11,15,13,3216,3876,2966,-910
2015,11,15,14,3721,4385,3220,-1165
2015,11,15,15,4042,4775,3331,-1444
2015,11,15,16,4318,5017,3592,-1425
2015,11,15,17,4398,5155,3739,-1416
2015,11,15,18,4596,5334,3869,-1465
2015,11,15,19,4756,5394,3935,-1459
2015,11,15,20,4899,5454,3980,-1474
2015,11,15,21,4838,5488,4001,-1487
2015,11,15,22,4873,5499,4010,-1489
2015,11,15,23,4839,5684,4120,-1564
2015,11,16,0,5025,5965,4348,-1617
2015,11,16,1,4769,5753,4206,-1547
2015,11,16,2,4477,5494,4051,-1443
2015,11,16,3,4084,5033,3690,-1343
2015,11,16,4,3727,4539,3243,-1296
2015,11,16,5,3348,4046,3018,-1028
2015,11,16,6,3053,3653,2850,-803
2015,11,16,7,2846,3421,2682,-739
2015,11,16,8,2781,3309,2592,-717
2015,11,16,9,2741,3272,2585,-687
2015,11,16,10,2820,3350,2610,-740
2015,11,16,11,3080,3690,2832,-858
2015,11,16,12,3594,4299,3334,-965
2015,11,16,13,3865,4630,3713,-917
2015,11,16,14,4058,4888,3829,-1059
2015,11,16,15,4332,5268,3999,-1269
2015,11,16,16,4619,5652,4265,-1387
2015,11,16,17,4929,6020,4555,-1465
2015,11,16,18,5082,6358,4753,-1605
2015,11,16,19,5249,6642,5029,-1613
2015,11,16,20,5364,6833,5195,-1638
2015,11,16,21,5321,6891,5290,-1601
2015,11,16,22,5267,6827,5248,-1579
2015,11,16,23,5222,6777,5129,-1648
2015,11,17,0,5301,6938,5273,-1665
2015,11,17,1,5187,6622,5027,-1595
2015,11,17,2,4914,6178,4698,-1480
2015,11,17,3,4499,5609,4232,-1377
2015,11,17,4,4102,5064,3793,-1271
2015,11,17,5,3687,4504,3508,-996
2015,11,17,6,3361,4022,3146,-876
2015,11,17,7,3137,3737,2920,-817
2015,11,17,8,3015,3591,2805,-786
2015,11,17,9,2938,3546,2764,-782
2015,11,17,10,2991,3606,2801,-805
2015,11,17,11,3238,3965,3052,-913
2015,11,17,12,3713,4553,3517,-1036
2015,11,17,13,3965,4888,3839,-1049
2015,11,17,14,4178,5155,3952,-1203
2015,11,17,15,4527,5527,4196,-1331
2015,11,17,16,4901,5999,4524,-1475
2015,11,17,17,5270,6494,4945,-1549
2015,11,17,18,5469,6856,5192,-1664
2015,11,17,19,5711,7138,5602,-1536
2015,11,17,20,5886,7293,5790,-1503
2015,11,17,21,5911,7319,5943,-1376
2015,11,17,22,5859,7163,5827,-1336
2015,11,17,23,5898,7172,5794,-1378
2015,11,18,0,5929,7301,5776,-1525
2015,11,18,1,5653,7044,5529,-1515
2015,11,18,2,5300,6629,5215,-1414
2015,11,18,3,4831,6059,4712,-1347
2015,11,18,4,4412,5463,4081,-1382
2015,11,18,5,3948,4859,3680,-1179
2015,11,18,6,3706,4395,3386,-1009
2015,11,18,7,3453,4122,3187,-935
2015,11,18,8,3344,3952,3074,-878
2015,11,18,9,3253,3883,2982,-901
2015,11,18,10,3254,3919,3054,-865
2015,11,18,11,3469,4228,3243,-985
2015,11,18,12,3904,4823,3629,-1194
2015,11,18,13,4125,5177,4045,-1132
2015,11,18,14,4430,5559,4330,-1229
2015,11,18,15,4818,6048,4739,-1309
2015,11,18,16,5282,6561,4978,-1583
2015,11,18,17,5650,6996,5399,-1597
2015,11,18,18,5971,7394,5760,-1634
2015,11,18,19,6238,7660,6065,-1595
2015,11,18,20,6493,7764,6124,-1640
2015,11,18,21,6682,7790,6132,-1658
2015,11,18,22,6568,7549,5936,-1613
2015,11,18,23,6563,7475,5830,-1645
2015,11,19,0,6633,7585,5927,-1658
2015,11,19,1,6269,7314,5641,-1673
2015,11,19,2,5786,6972,5311,-1661
2015,11,19,3,5273,6462,4852,-1610
2015,11,19,4,4786,5916,4422,-1494
2015,11,19,5,4257,5290,3946,-1344
2015,11,19,6,3776,4769,3587,-1182
2015,11,19,7,3517,4462,3440,-1022
2015,11,19,8,3335,4271,3299,-972
2015,11,19,9,3273,4200,3252,-948
2015,11,19,10,3292,4249,3282,-967
2015,11,19,11,3502,4536,3495,-1041
2015,11,19,12,3979,5182,4030,-1152
2015,11,19,13,4253,5471,4217,-1254
2015,11,19,14,4459,5750,4379,-1371
2015,11,19,15,4816,6097,4627,-1470
2015,11,19,16,5132,6559,5047,-1512
2015,11,19,17,5476,6892,5339,-1553
2015,11,19,18,5710,7128,5535,-1593
2015,11,19,19,5918,7153,5580,-1573
2015,11,19,20,5989,7047,5441,-1606
2015,11,19,21,5913,6922,5350,-1572
2015,11,19,22,5801,6874,5288,-1586
2015,11,19,23,5760,6998,5340,-1658
2015,11,20,0,5777,7032,5326,-1706
2015,11,20,1,5600,6792,5113,-1679
2015,11,20,2,5287,6532,4926,-1606
2015,11,20,3,4943,6002,4524,-1478
2015,11,20,4,4466,5521,4133,-1388
2015,11,20,5,3952,4952,3778,-1174
2015,11,20,6,3587,4532,3516,-1016
2015,11,20,7,3287,4216,3253,-963
2015,11,20,8,3154,4025,3103,-922
2015,11,20,9,3101,3924,3033,-891
2015,11,20,10,3146,3992,3086,-906
2015,11,20,11,3372,4307,3295,-1012
2015,11,20,12,3821,4943,3821,-1122
2015,11,20,13,4115,5246,3995,-1251
2015,11,20,14,4351,5474,3967,-1507
2015,11,20,15,4658,5726,4114,-1612
2015,11,20,16,4998,6062,4392,-1670
2015,11,20,17,5342,6424,4663,-1761
2015,11,20,18,5437,6793,4866,-1927
2015,11,20,19,5576,7062,5084,-1978
2015,11,20,20,5583,7190,5201,-1989
2015,11,20,21,5609,7044,5123,-1921
2015,11,20,22,5487,6790,4953,-1837
2015,11,20,23,5453,6763,4864,-1899
2015,11,21,0,5385,6737,4857,-1880
2015,11,21,1,5100,6413,4654,-1759
2015,11,21,2,4847,6051,4378,-1673
2015,11,21,3,4544,5637,3972,-1665
2015,11,21,4,4168,5207,3582,-1625
2015,11,21,5,3792,4716,3315,-1401
2015,11,21,6,3441,4288,3165,-1123
2015,11,21,7,3199,3992,3042,-950
2015,11,21,8,3007,3781,2871,-910
2015,11,21,9,2915,3661,2779,-882
2015,11,21,10,2865,3677,2779,-898
2015,11,21,11,2914,3778,2840,-938
2015,11,21,12,3039,4034,3036,-998
2015,11,21,13,3231,4324,3292,-1032
2015,11,21,14,3644,4850,3603,-1247
2015,11,21,15,4065,5382,3893,-1489
2015,11,21,16,4358,5699,4128,-1571
2015,11,21,17,4616,5916,4214,-1702
2015,11,21,18,4768,6031,4147,-1884
2015,11,21,19,4875,6045,4183,-1862
2015,11,21,20,4924,5999,4175,-1824
2015,11,21,21,4876,5924,4125,-1799
2015,11,21,22,4817,5883,4096,-1787
2015,11,21,23,4874,6035,4127,-1908
2015,11,22,0,4982,6097,4242,-1855
2015,11,22,1,4746,5849,4070,-1779
2015,11,22,2,4501,5600,3863,-1737
2015,11,22,3,4181,5241,3582,-1659
2015,11,22,4,3924,4871,3298,-1573
2015,11,22,5,3583,4459,3070,-1389
2015,11,22,6,3312,4075,2978,-1097
2015,11,22,7,3115,3817,2878,-939
2015,11,22,8,2987,3644,2743,-901
2015,11,22,9,2903,3536,2657,-879
2015,11,22,10,2876,3506,2635,-871
2015,11,22,11,2886,3568,2686,-882
2015,11,22,12,2984,3766,2845,-921
2015,11,22,13,3168,4016,3046,-970
2015,11,22,14,3564,4543,3353,-1190
2015,11,22,15,3837,5035,3693,-1342
2015,11,22,16,4004,5387,4025,-1362
2015,11,22,17,4131,5590,4184,-1406
2015,11,22,18,4168,5772,4216,-1556
2015,11,22,19,4155,5847,4201,-1646
2015,11,22,20,4082,5742,4118,-1624
2015,11,22,21,4007,5569,4018,-1551
2015,11,22,22,3952,5485,3953,-1532
2015,11,22,23,4044,5587,3999,-1588
2015,11,23,0,4326,5792,4244,-1548
2015,11,23,1,4167,5573,4117,-1456
2015,11,23,2,3977,5302,3928,-1374
2015,11,23,3,3691,4923,3656,-1267
2015,11,23,4,3499,4488,3320,-1168
2015,11,23,5,3268,3994,2882,-1112
2015,11,23,6,3093,3603,2653,-950
2015,11,23,7,2922,3344,2495,-849
2015,11,23,8,2977,3235,2427,-808
2015,11,23,9,3023,3216,2415,-801
2015,11,23,10,3203,3319,2434,-885
2015,11,23,11,3690,3654,2530,-1124
2015,11,23,12,4440,4276,2826,-1450
2015,11,23,13,4797,4723,3047,-1676
2015,11,23,14,4797,4995,3266,-1729
2015,11,23,15,4604,5127,3391,-1736
2015,11,23,16,4472,5147,3470,-1677
2015,11,23,17,4409,5087,3416,-1671
2015,11,23,18,4324,5027,3346,-1681
2015,11,23,19,4216,4980,3351,-1629
2015,11,23,20,4124,4933,3302,-1631
2015,11,23,21,4042,4922,3306,-1616
2015,11,23,22,4018,4947,3294,-1653
2015,11,23,23,4314,5255,3477,-1778
2015,11,24,0,4642,5669,3842,-1827
2015,11,24,1,4654,5643,3828,-1815
2015,11,24,2,4605,5441,3562,-1879
2015,11,24,3,4378,5129,3303,-1826
2015,11,24,4,4116,4773,3051,-1722
2015,11,24,5,3835,4373,2873,-1500
2015,11,24,6,3167,4034,2787,-1247
2015,11,24,7,2998,3837,2730,-1107
2015,11,24,8,2922,3783,2671,-1112
2015,11,24,9,3016,3772,2662,-1110
2015,11,24,10,3169,3906,2750,-1156
2015,11,24,11,3554,4248,2997,-1251
2015,11,24,12,4267,4872,3423,-1449
2015,11,24,13,4481,5199,3727,-1472
2015,11,24,14,4468,5293,3755,-1538
2015,11,24,15,4352,5245,3791,-1454
2015,11,24,16,4379,5174,3791,-1383
2015,11,24,17,4313,5111,3716,-1395
2015,11,24,18,4222,5068,3682,-1386
2015,11,24,19,4158,5037,3672,-1365
2015,11,24,20,4164,4998,3665,-1333
2015,11,24,21,4142,4976,3649,-1327
2015,11,24,22,4075,4983,3682,-1301
2015,11,24,23,4231,5301,3835,-1466
2015,11,25,0,4475,5585,4092,-1493
2015,11,25,1,4405,5446,4016,-1430
2015,11,25,2,4272,5254,3848,-1406
2015,11,25,3,4077,4933,3574,-1359
2015,11,25,4,3703,4545,3272,-1273
2015,11,25,5,3372,4129,2987,-1142
2015,11,25,6,3103,3757,2751,-1006
2015,11,25,7,2970,3546,2576,-970
2015,11,25,8,2911,3451,2492,-959
2015,11,25,9,2890,3429,2485,-944
2015,11,25,10,2903,3528,2554,-974
2015,11,25,11,3050,3776,2710,-1066
2015,11,25,12,3436,4213,2980,-1233
2015,11,25,13,3702,4542,3252,-1290
2015,11,25,14,3926,4837,3503,-1334
2015,11,25,15,4004,5065,3690,-1375
2015,11,25,16,4103,5259,3936,-1323
2015,11,25,17,4143,5345,4006,-1339
2015,11,25,18,4103,5414,3991,-1423
2015,11,25,19,4136,5429,4021,-1408
2015,11,25,20,4148,5459,4048,-1411
2015,11,25,21,4136,5407,4019,-1388
2015,11,25,22,4091,5402,4014,-1388
2015,11,25,23,4216,5557,4088,-1469
2015,11,26,0,4547,5794,4279,-1515
2015,11,26,1,4417,5638,4168,-1470
2015,11,26,2,4213,5422,3991,-1431
2015,11,26,3,3952,5047,3736,-1311
2015,11,26,4,3595,4711,3462,-1249
2015,11,26,5,3211,4285,3097,-1188
2015,11,26,6,2977,3873,2890,-983
2015,11,26,7,2813,3583,2672,-911
2015,11,26,8,2629,3401,2519,-882
2015,11,26,9,2556,3312,2440,-872
2015,11,26,10,2529,3306,2435,-871
2015,11,26,11,2569,3395,2511,-884
2015,11,26,12,2812,3606,2639,-967
2015,11,26,13,3056,3960,2879,-1081
2015,11,26,14,3477,4633,3308,-1325
2015,11,26,15,4060,5299,3819,-1480
2015,11,26,16,4429,5821,4235,-1586
2015,11,26,17,4663,6170,4521,-1649
2015,11,26,18,4715,6302,4664,-1638
2015,11,26,19,4630,6227,4629,-1598
2015,11,26,20,4553,6106,4555,-1551
2015,11,26,21,4419,5831,4357,-1474
2015,11,26,22,4219,5490,4080,-1410
2015,11,26,23,3915,5204,3858,-1346
2015,11,27,0,4092,5224,3846,-1378
2015,11,27,1,3978,5067,3698,-1369
2015,11,27,2,3785,4874,3548,-1326
2015,11,27,3,3618,4639,3359,-1280
2015,11,27,4,3433,4343,3191,-1152
2015,11,27,5,3160,3985,2970,-1015
2015,11,27,6,2894,3660,2714,-946
2015,11,27,7,2724,3421,2566,-855
2015,11,27,8,2615,3268,2451,-817
2015,11,27,9,2637,3192,2407,-785
2015,11,27,10,2632,3221,2418,-803
2015,11,27,11,2766,3350,2496,-854
2015,11,27,12,2878,3576,2672,-904
2015,11,27,13,3139,3791,2774,-1017
2015,11,27,14,3442,4214,3128,-1086
2015,11,27,15,3738,4741,3450,-1291
2015,11,27,16,4070,5114,3740,-1374
2015,11,27,17,4309,5350,3922,-1428
2015,11,27,18,4428,5560,4057,-1503
2015,11,27,19,4562,5691,4180,-1511
2015,11,27,20,4689,5763,4273,-1490
2015,11,27,21,4684,5744,4322,-1422
2015,11,27,22,4625,5611,4148,-1463
2015,11,27,23,4544,5583,4100,-1483
2015,11,28,0,4727,5721,4184,-1537
2015,11,28,1,4639,5481,3999,-1482
2015,11,28,2,4437,5207,3810,-1397
2015,11,28,3,4156,4852,3551,-1301
2015,11,28,4,3862,4525,3285,-1240
2015,11,28,5,3491,4125,3028,-1097
2015,11,28,6,3117,3745,2790,-955
2015,11,28,7,2909,3488,2592,-896
2015,11,28,8,2797,3329,2459,-870
2015,11,28,9,2752,3234,2419,-815
2015,11,28,10,2742,3232,2418,-814
2015,11,28,11,2722,3324,2430,-894
2015,11,28,12,2884,3532,2614,-918
2015,11,28,13,3018,3822,2807,-1015
2015,11,28,14,3446,4310,3129,-1181
2015,11,28,15,3776,4845,3369,-1476
2015,11,28,16,4002,5194,3464,-1730
2015,11,28,17,4260,5453,3669,-1784
2015,11,28,18,4526,5647,3773,-1874
2015,11,28,19,4625,5770,3913,-1857
2015,11,28,20,4747,5832,3963,-1869
2015,11,28,21,4728,5825,3959,-1866
2015,11,28,22,4639,5689,3889,-1800
2015,11,28,23,4557,5675,3847,-1828
2015,11,29,0,4572,5803,3918,-1885
2015,11,29,1,4462,5602,3764,-1838
2015,11,29,2,4245,5285,3533,-1752
2015,11,29,3,3953,4940,3273,-1667
2015,11,29,4,3695,4581,3112,-1469
2015,11,29,5,3309,4203,3046,-1157
2015,11,29,6,3011,3831,3005,-826
2015,11,29,7,2826,3514,2761,-753
2015,11,29,8,2687,3347,2642,-705
2015,11,29,9,2663,3262,2568,-694
2015,11,29,10,2636,3276,2580,-696
2015,11,29,11,2639,3327,2620,-707
2015,11,29,12,2784,3510,2763,-747
2015,11,29,13,2933,3735,2826,-909
2015,11,29,14,3284,4279,3034,-1245
2015,11,29,15,3690,4775,3269,-1506
2015,11,29,16,3864,5093,3402,-1691
2015,11,29,17,4141,5345,3530,-1815
2015,11,29,18,4288,5582,3711,-1871
2015,11,29,19,4420,5686,3811,-1875
2015,11,29,20,4543,5724,3830,-1894
2015,11,29,21,4542,5727,3885,-1842
2015,11,29,22,4538,5708,3831,-1877
2015,11,29,23,4537,5831,3919,-1912
2015,11,30,0,4838,6107,4116,-1991
2015,11,30,1,4593,5917,3966,-1951
2015,11,30,2,4430,5587,3777,-1810
2015,11,30,3,4102,5091,3460,-1631
2015,11,30,4,3674,4612,3207,-1405
2015,11,30,5,3403,4092,2967,-1125
2015,11,30,6,3046,3696,2884,-812
2015,11,30,7,2848,3449,2732,-717
2015,11,30,8,2756,3317,2686,-631
2015,11,30,9,2725,3272,2680,-592
2015,11,30,10,2822,3368,2670,-698
2015,11,30,11,3050,3726,2906,-820
2015,11,30,12,3552,4333,3408,-925
2015,11,30,13,3762,4630,3608,-1022
2015,11,30,14,3922,4836,3722,-1114
2015,11,30,15,4140,5144,3911,-1233
2015,11,30,16,4383,5457,4158,-1299
2015,11,30,17,4617,5738,4399,-1339
2015,11,30,18,4807,5983,4538,-1445
2015,11,30,19,4960,6165,4704,-1461
2015,11,30,20,5066,6186,4737,-1449
2015,11,30,21,5092,6145,4662,-1483
2015,11,30,22,4998,6105,4626,-1479
2015,11,30,23,4989,6322,4724,-1598
2015,12,1,0,5202,6613,4912,-1701
2015,12,1,1,5068,6433,4797,-1636
2015,12,1,2,4793,6112,4555,-1557
2015,12,1,3,4428,5602,4225,-1377
2015,12,1,4,4026,5054,3741,-1313
2015,12,1,5,3555,4443,3369,-1074
2015,12,1,6,3231,3967,3075,-892
2015,12,1,7,3013,3670,2877,-793
2015,12,1,8,2871,3507,2739,-768
2015,12,1,9,2778,3436,2676,-760
2015,12,1,10,2812,3496,2714,-782
2015,12,1,11,3080,3826,2961,-865
2015,12,1,12,3574,4422,3474,-948
2015,12,1,13,3807,4666,3644,-1022
2015,12,1,14,3978,4861,3695,-1166
2015,12,1,15,4279,5156,3892,-1264
2015,12,1,16,4588,5504,4143,-1361
2015,12,1,17,4919,5849,4441,-1408
2015,12,1,18,5145,6132,4616,-1516
2015,12,1,19,5299,6291,4782,-1509
2015,12,1,20,5425,6393,4867,-1526
2015,12,1,21,5468,6478,4933,-1545
2015,12,1,22,5355,6475,4968,-1507
2015,12,1,23,5429,6609,4997,-1612
2015,12,2,0,5544,6891,5231,-1660
2015,12,2,1,5392,6658,5066,-1592
2015,12,2,2,5123,6317,4812,-1505
2015,12,2,3,4694,5781,4471,-1310
2015,12,2,4,4185,5203,4036,-1167
2015,12,2,5,3739,4580,3502,-1078
2015,12,2,6,3394,4110,3265,-845
2015,12,2,7,3131,3823,3043,-780
2015,12,2,8,3015,3668,2925,-743
2015,12,2,9,2923,3606,2875,-731
2015,12,2,10,2927,3662,2921,-741
2015,12,2,11,3206,3975,3139,-836
2015,12,2,12,3708,4569,3578,-991
2015,12,2,13,3895,4851,3823,-1028
2015,12,2,14,4064,5092,3947,-1145
2015,12,2,15,4373,5419,4144,-1275
2015,12,2,16,4707,5816,4433,-1383
2015,12,2,17,5077,6175,4780,-1395
2015,12,2,18,5262,6465,4925,-1540
2015,12,2,19,5425,6686,5060,-1626
2015,12,2,20,5549,6831,5178,-1653
2015,12,2,21,5651,6889,5235,-1654
2015,12,2,22,5462,6834,5253,-1581
2015,12,2,23,5668,6901,5302,-1599
2015,12,3,0,5695,7080,5493,-1587
2015,12,3,1,5495,6841,5385,-1456
2015,12,3,2,5186,6519,5113,-1406
2015,12,3,3,4811,5972,4682,-1290
2015,12,3,4,4269,5405,4190,-1215
2015,12,3,5,3766,4794,3650,-1144
2015,12,3,6,3379,4296,3179,-1117
2015,12,3,7,3140,3984,2988,-996
2015,12,3,8,2950,3820,2849,-971
2015,12,3,9,2885,3748,2817,-931
2015,12,3,10,2921,3804,2837,-967
2015,12,3,11,3170,4108,3078,-1030
2015,12,3,12,3651,4711,3531,-1180
2015,12,3,13,3915,5008,3780,-1228
2015,12,3,14,4051,5122,3887,-1235
2015,12,3,15,4187,5255,3970,-1285
2015,12,3,16,4369,5414,4108,-1306
2015,12,3,17,4507,5513,4221,-1292
2015,12,3,18,4577,5579,4270,-1309
2015,12,3,19,4581,5657,4316,-1341
2015,12,3,20,4545,5641,4321,-1320
2015,12,3,21,4481,5589,4270,-1319
2015,12,3,22,4510,5575,4233,-1342
2015,12,3,23,4702,5839,4370,-1469
2015,12,4,0,4889,6099,4558,-1541
2015,12,4,1,4679,5962,4439,-1523
2015,12,4,2,4509,5733,4286,-1447
2015,12,4,3,4131,5293,3948,-1345
2015,12,4,4,3795,4793,3554,-1239
2015,12,4,5,3385,4235,3133,-1102
2015,12,4,6,3065,3793,2953,-840
2015,12,4,7,2850,3555,2798,-757
2015,12,4,8,2762,3451,2696,-755
2015,12,4,9,2660,3413,2664,-749
2015,12,4,10,2730,3481,2701,-780
2015,12,4,11,3053,3811,2929,-882
2015,12,4,12,3478,4438,3383,-1055
2015,12,4,13,3830,4778,3723,-1055
2015,12,4,14,3934,4898,3754,-1144
2015,12,4,15,4139,5010,3729,-1281
2015,12,4,16,4228,5152,3850,-1302
2015,12,4,17,4233,5251,3961,-1290
2015,12,4,18,4276,5376,4027,-1349
2015,12,4,19,4312,5463,4147,-1316
2015,12,4,20,4311,5497,4185,-1312
2015,12,4,21,4329,5488,4193,-1295
2015,12,4,22,4341,5471,4268,-1203
2015,12,4,23,4434,5689,4402,-1287
2015,12,5,0,4632,5860,4533,-1327
2015,12,5,1,4380,5659,4284,-1375
2015,12,5,2,4263,5440,4086,-1354
2015,12,5,3,3991,5117,3862,-1255
2015,12,5,4,3774,4798,3528,-1270
2015,12,5,5,3466,4348,3271,-1077
2015,12,5,6,3081,3968,2969,-999
2015,12,5,7,2854,3695,2726,-969
2015,12,5,8,2749,3533,2613,-920
2015,12,5,9,2716,3454,2632,-822
2015,12,5,10,2721,3456,2641,-815
2015,12,5,11,2792,3581,2695,-886
2015,12,5,12,2983,3827,2911,-916
2015,12,5,13,3198,4113,3143,-970
2015,12,5,14,3548,4609,3485,-1124
2015,12,5,15,3828,4991,3636,-1355
2015,12,5,16,4029,5262,3870,-1392
2015,12,5,17,4124,5412,4013,-1399
2015,12,5,18,4152,5573,4188,-1385
2015,12,5,19,4183,5660,4271,-1389
2015,12,5,20,4215,5725,4313,-1412
2015,12,5,21,4190,5685,4323,-1362
2015,12,5,22,4132,5595,4231,-1364
2015,12,5,23,4302,5671,4266,-1405
2015,12,6,0,4560,5861,4393,-1468
2015,12,6,1,4364,5639,4171,-1468
2015,12,6,2,4180,5432,4052,-1380
2015,12,6,3,3969,5096,3800,-1296
2015,12,6,4,3697,4738,3471,-1267
2015,12,6,5,3390,4310,3249,-1061
2015,12,6,6,3170,3942,2953,-989
2015,12,6,7,2968,3648,2702,-946
2015,12,6,8,2855,3471,2574,-897
2015,12,6,9,2753,3388,2495,-893
2015,12,6,10,2748,3371,2449,-922
2015,12,6,11,2832,3480,2525,-955
2015,12,6,12,2971,3678,2697,-981
2015,12,6,13,3111,3948,2897,-1051
2015,12,6,14,3492,4428,3210,-1218
2015,12,6,15,3912,4904,3558,-1346
2015,12,6,16,4106,5224,3875,-1349
2015,12,6,17,4275,5439,4049,-1390
2015,12,6,18,4355,5689,4199,-1490
2015,12,6,19,4409,5846,4421,-1425
2015,12,6,20,4476,5870,4427,-1443
2015,12,6,21,4432,5833,4397,-1436
2015,12,6,22,4490,5741,4330,-1411
2015,12,6,23,4571,5904,4401,-1503
2015,12,7,0,4838,6174,4607,-1567
2015,12,7,1,4757,5995,4449,-1546
2015,12,7,2,4524,5737,4278,-1459
2015,12,7,3,4169,5293,3939,-1354
2015,12,7,4,3749,4756,3491,-1265
2015,12,7,5,3395,4173,3107,-1066
2015,12,7,6,3123,3728,2875,-853
2015,12,7,7,2881,3473,2690,-783
2015,12,7,8,2730,3332,2611,-721
2015,12,7,9,2704,3285,2560,-725
2015,12,7,10,2735,3393,2642,-751
2015,12,7,11,2986,3753,2877,-876
2015,12,7,12,3457,4385,3310,-1075
2015,12,7,13,3705,4698,3534,-1164
2015,12,7,14,3859,4845,3569,-1276
2015,12,7,15,4036,4953,3692,-1261
2015,12,7,16,4258,5052,3790,-1262
2015,12,7,17,4429,5103,3849,-1254
2015,12,7,18,4519,5183,3914,-1269
2015,12,7,19,4626,5222,3963,-1259
2015,12,7,20,4649,5278,3992,-1286
2015,12,7,21,4608,5312,4008,-1304
2015,12,7,22,4559,5338,4047,-1291
2015,12,7,23,4712,5575,4149,-1426
2015,12,8,0,4944,5983,4468,-1515
2015,12,8,1,4784,5856,4395,-1461
2015,12,8,2,4543,5606,4193,-1413
2015,12,8,3,4204,5157,3850,-1307
2015,12,8,4,3792,4666,3439,-1227
2015,12,8,5,3412,4123,3049,-1074
2015,12,8,6,2925,3735,2914,-821
2015,12,8,7,2733,3520,2748,-772
2015,12,8,8,2602,3452,2677,-775
2015,12,8,9,2660,3432,2650,-782
2015,12,8,10,2746,3564,2719,-845
2015,12,8,11,3031,3978,2963,-1015
2015,12,8,12,3604,4738,3363,-1375
2015,12,8,13,3872,5124,3797,-1327
2015,12,8,14,3944,5108,3836,-1272
2015,12,8,15,3998,5069,3769,-1300
2015,12,8,16,4052,5065,3704,-1361
2015,12,8,17,4199,5053,3736,-1317
2015,12,8,18,4280,5078,3747,-1331
2015,12,8,19,4236,5121,3760,-1361
2015,12,8,20,4224,5185,3791,-1394
2015,12,8,21,4272,5246,3843,-1403
2015,12,8,22,4299,5304,3876,-1428
2015,12,8,23,4461,5544,4132,-1412
2015,12,9,0,4764,5965,4431,-1534
2015,12,9,1,4586,5865,4385,-1480
2015,12,9,2,4471,5631,4233,-1398
2015,12,9,3,4156,5205,3916,-1289
2015,12,9,4,3759,4706,3434,-1272
2015,12,9,5,3297,4166,3129,-1037
2015,12,9,6,2975,3774,2961,-813
2015,12,9,7,2774,3579,2789,-790
2015,12,9,8,2646,3472,2710,-762
2015,12,9,9,2658,3459,2701,-758
2015,12,9,10,2673,3543,2747,-796
2015,12,9,11,2956,3928,3015,-913
2015,12,9,12,3516,4593,3442,-1151
2015,12,9,13,3766,4892,3611,-1281
2015,12,9,14,3893,4941,3593,-1348
2015,12,9,15,3973,5035,3700,-1335
2015,12,9,16,4106,5127,3816,-1311
2015,12,9,17,4172,5250,3885,-1365
2015,12,9,18,4199,5324,3874,-1450
2015,12,9,19,4274,5361,4048,-1313
2015,12,9,20,4282,5365,4064,-1301
2015,12,9,21,4249,5375,4071,-1304
2015,12,9,22,4241,5435,4194,-1241
2015,12,9,23,4545,5756,4396,-1360
2015,12,10,0,4813,6130,4678,-1452
2015,12,10,1,4708,5999,4494,-1505
2015,12,10,2,4508,5751,4295,-1456
2015,12,10,3,4175,5339,3984,-1355
2015,12,10,4,3756,4809,3537,-1272
2015,12,10,5,3320,4242,3196,-1046
2015,12,10,6,3074,3864,3018,-846
2015,12,10,7,2863,3620,2871,-749
2015,12,10,8,2750,3498,2753,-745
2015,12,10,9,2762,3479,2736,-743
2015,12,10,10,2830,3562,2781,-781
2015,12,10,11,3022,3950,3024,-926
2015,12,10,12,3565,4641,3561,-1080
2015,12,10,13,3802,4940,3743,-1197
2015,12,10,14,3893,5029,3697,-1332
2015,12,10,15,4015,5120,3781,-1339
2015,12,10,16,4154,5240,3920,-1320
2015,12,10,17,4267,5357,4063,-1294
2015,12,10,18,4328,5516,4189,-1327
2015,12,10,19,4388,5630,4272,-1358
2015,12,10,20,4395,5681,4325,-1356
2015,12,10,21,4409,5678,4337,-1341
2015,12,10,22,4387,5641,4285,-1356
2015,12,10,23,4591,5816,4468,-1348
2015,12,11,0,4843,6164,4664,-1499
2015,12,11,1,4709,6018,4523,-1495
2015,12,11,2,4516,5750,4324,-1426
2015,12,11,3,4221,5305,3979,-1326
2015,12,11,4,3840,4767,3578,-1189
2015,12,11,5,3406,4193,3177,-1016
2015,12,11,6,3057,3795,2989,-806
2015,12,11,7,2881,3549,2785,-764
2015,12,11,8,2815,3444,2687,-757
2015,12,11,9,2749,3408,2642,-766
2015,12,11,10,2827,3496,2725,-771
2015,12,11,11,3096,3875,2958,-917
2015,12,11,12,3617,4553,3379,-1174
2015,12,11,13,3891,4868,3551,-1317
2015,12,11,14,4002,4973,3596,-1377
2015,12,11,15,4081,5064,3718,-1346
2015,12,11,16,4165,5194,3866,-1328
2015,12,11,17,4277,5298,3942,-1356
2015,12,11,18,4334,5399,3992,-1407
2015,12,11,19,4382,5535,4185,-1350
2015,12,11,20,4404,5647,4274,-1373
2015,12,11,21,4511,5735,4366,-1369
2015,12,11,22,4500,5754,4417,-1337
2015,12,11,23,4618,5778,4363,-1415
2015,12,12,0,4882,5970,4498,-1472
2015,12,12,1,4760,5714,4283,-1431
2015,12,12,2,4516,5459,4080,-1379
2015,12,12,3,4236,5108,3797,-1311
2015,12,12,4,3885,4734,3498,-1236
2015,12,12,5,3562,4279,3230,-1049
2015,12,12,6,3198,3875,3034,-841
2015,12,12,7,3034,3603,2810,-793
2015,12,12,8,2941,3474,2699,-775
2015,12,12,9,2896,3415,2651,-764
2015,12,12,10,2883,3428,2642,-786
2015,12,12,11,2912,3589,2739,-850
2015,12,12,12,3137,3864,2948,-916
2015,12,12,13,3352,4187,3117,-1070
2015,12,12,14,3654,4654,3372,-1282
2015,12,12,15,3941,5023,3635,-1388
2015,12,12,16,4141,5279,3888,-1391
2015,12,12,17,4278,5522,4147,-1375
2015,12,12,18,4515,5738,4265,-1473
2015,12,12,19,4715,5962,4454,-1508
2015,12,12,20,4848,6104,4602,-1502
2015,12,12,21,4962,6152,4614,-1538
2015,12,12,22,4999,6093,4587,-1506
2015,12,12,23,4956,6088,4559,-1529
2015,12,13,0,5037,6281,4688,-1593
2015,12,13,1,4896,6008,4476,-1532
2015,12,13,2,4728,5723,4303,-1420
2015,12,13,3,4497,5355,4016,-1339
2015,12,13,4,4173,4946,3691,-1255
2015,12,13,5,3703,4440,3391,-1049
2015,12,13,6,3298,4001,3228,-773
2015,12,13,7,3067,3704,2955,-749
2015,12,13,8,2928,3518,2816,-702
2015,12,13,9,2847,3415,2735,-680
2015,12,13,10,2818,3382,2687,-695
2015,12,13,11,2851,3434,2701,-733
2015,12,13,12,2980,3593,2795,-798
2015,12,13,13,3162,3856,2944,-912
2015,12,13,14,3554,4409,3359,-1050
2015,12,13,15,3964,4956,3730,-1226
2015,12,13,16,4319,5338,4051,-1287
2015,12,13,17,4542,5645,4311,-1334
2015,12,13,18,4734,5903,4447,-1456
2015,12,13,19,4923,6075,4612,-1463
2015,12,13,20,5048,6116,4617,-1499
2015,12,13,21,5070,6074,4588,-1486
2015,12,13,22,5092,6037,4551,-1486
2015,12,13,23,5192,6307,4671,-1636
2015,12,14,0,5343,6595,4936,-1659
2015,12,14,1,5074,6415,4798,-1617
2015,12,14,2,4893,6187,4655,-1532
2015,12,14,3,4530,5720,4310,-1410
2015,12,14,4,4133,5169,3866,-1303
2015,12,14,5,3737,4552,3469,-1083
2015,12,14,6,3388,4090,3232,-858
2015,12,14,7,3170,3805,3000,-805
2015,12,14,8,3001,3648,2896,-752
2015,12,14,9,2915,3592,2852,-740
2015,12,14,10,2968,3664,2900,-764
2015,12,14,11,3219,4018,3149,-869
2015,12,14,12,3660,4666,3670,-996
2015,12,14,13,3897,5017,3913,-1104
2015,12,14,14,4164,5276,4049,-1227
2015,12,14,15,4512,5608,4266,-1342
2015,12,14,16,4842,5934,4571,-1363
2015,12,14,17,5163,6214,4825,-1389
2015,12,14,18,5371,6436,4999,-1437
2015,12,14,19,5567,6622,5112,-1510
2015,12,14,20,5714,6735,5192,-1543
2015,12,14,21,5750,6759,5195,-1564
2015,12,14,22,5852,6686,5158,-1528
2015,12,14,23,5883,6791,5220,-1571
2015,12,15,0,5981,7106,5424,-1682
2015,12,15,1,5683,6902,5259,-1643
2015,12,15,2,5429,6537,4956,-1581
2015,12,15,3,5026,6011,4561,-1450
2015,12,15,4,4548,5398,4079,-1319
2015,12,15,5,4047,4751,3676,-1075
2015,12,15,6,3568,4267,3396,-871
2015,12,15,7,3321,3960,3163,-797
2015,12,15,8,3093,3777,3012,-765
2015,12,15,9,2987,3721,2965,-756
2015,12,15,10,3023,3779,2994,-785
2015,12,15,11,3246,4130,3260,-870
2015,12,15,12,3696,4804,3814,-990
2015,12,15,13,3922,5129,4141,-988
2015,12,15,14,4154,5305,4119,-1186
2015,12,15,15,4465,5534,4216,-1318
2015,12,15,16,4764,5761,4360,-1401
2015,12,15,17,5044,5937,4536,-1401
2015,12,15,18,5280,6065,4642,-1423
2015,12,15,19,5483,6220,4765,-1455
2015,12,15,20,5619,6311,4858,-1453
2015,12,15,21,5586,6340,4895,-1445
2015,12,15,22,5678,6372,4920,-1452
2015,12,15,23,5734,6665,5138,-1527
2015,12,16,0,5766,6987,5385,-1602
2015,12,16,1,5487,6804,5218,-1586
2015,12,16,2,5301,6491,4965,-1526
2015,12,16,3,4918,5981,4624,-1357
2015,12,16,4,4438,5432,4118,-1314
2015,12,16,5,3939,4772,3663,-1109
2015,12,16,6,3416,4224,3359,-865
2015,12,16,7,3218,3901,3102,-799
2015,12,16,8,3048,3714,2961,-753
2015,12,16,9,2981,3645,2900,-745
2015,12,16,10,3028,3699,2941,-758
2015,12,16,11,3269,4006,3136,-870
2015,12,16,12,3716,4659,3665,-994
2015,12,16,13,3927,4937,3872,-1065
2015,12,16,14,4101,5100,3922,-1178
2015,12,16,15,4380,5453,4080,-1373
2015,12,16,16,4674,5888,4469,-1419
2015,12,16,17,4962,6346,4906,-1440
2015,12,16,18,5187,6719,5184,-1535
2015,12,16,19,5456,6989,5361,-1628
2015,12,16,20,5637,7243,5569,-1674
2015,12,16,21,5700,7315,5589,-1726
2015,12,16,22,5675,7250,5537,-1713
2015,12,16,23,5699,7174,5494,-1680
2015,12,17,0,5779,7399,5630,-1769
2015,12,17,1,5540,7123,5391,-1732
2015,12,17,2,5276,6720,5114,-1606
2015,12,17,3,4886,6188,4712,-1476
2015,12,17,4,4404,5597,4236,-1361
2015,12,17,5,3937,4313,3168,-1145
2015,12,17,6,3569,4374,3494,-880
2015,12,17,7,3314,4034,3224,-810
2015,12,17,8,3143,3836,3087,-749
2015,12,17,9,3075,3744,3016,-728
2015,12,17,10,3148,3787,3045,-742
2015,12,17,11,3393,4091,3235,-856
2015,12,17,12,3867,4764,3735,-1029
2015,12,17,13,4099,5100,3975,-1125
2015,12,17,14,4250,5263,4010,-1253
2015,12,17,15,4568,5568,4251,-1317
2015,12,17,16,4911,5951,4571,-1380
2015,12,17,17,5180,6335,4877,-1458
2015,12,17,18,5394,6647,5151,-1496
2015,12,17,19,5574,6863,5316,-1547
2015,12,17,20,5736,7120,5538,-1582
2015,12,17,21,5801,7155,5532,-1623
2015,12,17,22,5819,7075,5481,-1594
2015,12,17,23,5805,7120,5473,-1647
2015,12,18,0,5742,7385,5710,-1675
2015,12,18,1,5553,7155,5482,-1673
2015,12,18,2,5320,6831,5222,-1609
2015,12,18,3,4965,6327,4841,-1486
2015,12,18,4,4485,5739,4380,-1359
2015,12,18,5,4021,5123,3942,-1181
2015,12,18,6,3534,4602,3476,-1126
2015,12,18,7,3232,4244,3211,-1033
2015,12,18,8,3018,4055,3093,-962
2015,12,18,9,2953,3931,2975,-956
2015,12,18,10,2984,3956,2976,-980
2015,12,18,11,3206,4252,3186,-1066
2015,12,18,12,3684,4885,3619,-1266
2015,12,18,13,3933,5275,3940,-1335
2015,12,18,14,4064,5134,3758,-1376
2015,12,18,15,4270,5599,4223,-1376
2015,12,18,16,4385,5664,4320,-1344
2015,12,18,17,4498,5577,4233,-1344
2015,12,18,18,4536,5451,4130,-1321
2015,12,18,19,4474,5372,4053,-1319
2015,12,18,20,4358,5263,3972,-1291
2015,12,18,21,4265,5147,3883,-1264
2015,12,18,22,4242,5095,3815,-1280
2015,12,18,23,4401,5356,3963,-1393
2015,12,19,0,4665,5614,4137,-1477
2015,12,19,1,4551,5458,4029,-1429
2015,12,19,2,4399,5274,3902,-1372
2015,12,19,3,4090,4993,3658,-1335
2015,12,19,4,3902,4703,3372,-1331
2015,12,19,5,3770,4289,3121,-1168
2015,12,19,6,3627,4095,3008,-1087
2015,12,19,7,3584,3895,2832,-1063
2015,12,19,8,3553,3816,2763,-1053
2015,12,19,9,3631,3818,2744,-1074
2015,12,19,10,3733,3934,2768,-1166
2015,12,19,11,4007,4184,2862,-1322
2015,12,19,12,4426,4605,3130,-1475
2015,12,19,13,4881,5148,3525,-1623
2015,12,19,14,5050,5629,3883,-1746
2015,12,19,15,5024,5809,4072,-1737
2015,12,19,16,4821,5732,4114,-1618
2015,12,19,17,4521,5503,3957,-1546
2015,12,19,18,4297,5273,3796,-1477
2015,12,19,19,4211,5094,3694,-1400
2015,12,19,20,4021,4987,3613,-1374
2015,12,19,21,3968,4943,3593,-1350
2015,12,19,22,3950,4995,3622,-1373
2015,12,19,23,4226,5280,3805,-1475
2015,12,20,0,4479,5719,4123,-1596
2015,12,20,1,4476,5694,4101,-1593
2015,12,20,2,4424,5610,4028,-1582
2015,12,20,3,4299,5428,3850,-1578
2015,12,20,4,4059,5200,3668,-1532
2015,12,20,5,3858,4877,3497,-1380
2015,12,20,6,3509,4567,3299,-1268
2015,12,20,7,3402,4421,3161,-1260
2015,12,20,8,3393,4331,3057,-1274
2015,12,20,9,3398,4330,3036,-1294
2015,12,20,10,3515,4367,3044,-1323
2015,12,20,11,3691,4535,3079,-1456
2015,12,20,12,3958,4850,3284,-1566
2015,12,20,13,4244,5267,3587,-1680
2015,12,20,14,4563,5633,3866,-1767
2015,12,20,15,4491,5673,4087,-1586
2015,12,20,16,4170,5476,4131,-1345
2015,12,20,17,4013,5246,3904,-1342
2015,12,20,18,3887,5083,3691,-1392
2015,12,20,19,3767,5006,3645,-1361
2015,12,20,20,3660,4946,3649,-1297
2015,12,20,21,3543,4915,3673,-1242
2015,12,20,22,3616,4959,3690,-1269
2015,12,20,23,3987,5298,3856,-1442
2015,12,21,0,4359,5657,4111,-1546
2015,12,21,1,4298,5560,4034,-1526
2015,12,21,2,4157,5399,3932,-1467
2015,12,21,3,3915,5083,3703,-1380
2015,12,21,4,3527,4699,3444,-1255
2015,12,21,5,3174,4236,3155,-1081
2015,12,21,6,3047,3716,2875,-841
2015,12,21,7,2901,3487,2707,-780
2015,12,21,8,2843,3386,2652,-734
2015,12,21,9,2757,3363,2637,-726
2015,12,21,10,2879,3471,2664,-807
2015,12,21,11,3114,3768,2859,-909
2015,12,21,12,3480,4276,3205,-1071
2015,12,21,13,3771,4623,3426,-1197
2015,12,21,14,3928,4850,3527,-1323
2015,12,21,15,4165,5067,3720,-1347
2015,12,21,16,4283,5282,3950,-1332
2015,12,21,17,4336,5411,4074,-1337
2015,12,21,18,4448,5542,4203,-1339
2015,12,21,19,4584,5605,4244,-1361
2015,12,21,20,4643,5674,4218,-1456
2015,12,21,21,4706,5701,4322,-1379
2015,12,21,22,4601,5731,4319,-1412
2015,12,21,23,4693,6033,4511,-1522
2015,12,22,0,5088,6423,4757,-1666
2015,12,22,1,5024,6321,4731,-1590
2015,12,22,2,4860,6065,4595,-1470
2015,12,22,3,4507,5682,4257,-1425
2015,12,22,4,4166,5241,3875,-1366
2015,12,22,5,3716,4659,3535,-1124
2015,12,22,6,3246,4071,3196,-875
2015,12,22,7,2990,3744,2954,-790
2015,12,22,8,2866,3564,2813,-751
2015,12,22,9,2791,3482,2744,-738
2015,12,22,10,2848,3539,2784,-755
2015,12,22,11,3058,3770,2948,-822
2015,12,22,12,3472,4230,3218,-1012
2015,12,22,13,3781,4536,3284,-1252
2015,12,22,14,4066,4881,3362,-1519
2015,12,22,15,4440,5255,3534,-1721
2015,12,22,16,4732,5664,3842,-1822
2015,12,22,17,4948,5979,4127,-1852
2015,12,22,18,5114,6204,4266,-1938
2015,12,22,19,5303,6336,4390,-1946
2015,12,22,20,5402,6367,4439,-1928
2015,12,22,21,5424,6322,4457,-1865
2015,12,22,22,5432,6223,4381,-1842
2015,12,22,23,5508,6391,4488,-1903
2015,12,23,0,5706,6663,4682,-1981
2015,12,23,1,5565,6500,4553,-1947
2015,12,23,2,5255,6263,4378,-1885
2015,12,23,3,4894,5883,4073,-1810
2015,12,23,4,4449,5414,3745,-1669
2015,12,23,5,3894,4816,3542,-1274
2015,12,23,6,3569,4388,3516,-872
2015,12,23,7,3294,4017,3241,-776
2015,12,23,8,3113,3850,3103,-747
2015,12,23,9,3028,3768,3035,-733
2015,12,23,10,3046,3828,3070,-758
2015,12,23,11,3230,4062,3236,-826
2015,12,23,12,3558,4564,3560,-1004
2015,12,23,13,3860,4989,3831,-1158
2015,12,23,14,4193,5353,3895,-1458
2015,12,23,15,4571,5689,4014,-1675
2015,12,23,16,4911,5985,4248,-1737
2015,12,23,17,5152,6154,4375,-1779
2015,12,23,18,5309,6236,4436,-1800
2015,12,23,19,5527,6285,4495,-1790
2015,12,23,20,5715,6309,4534,-1775
2015,12,23,21,5748,6300,4519,-1781
2015,12,23,22,5733,6318,4525,-1793
2015,12,23,23,5777,6565,4770,-1795
2015,12,24,0,5955,6897,4952,-1945
2015,12,24,1,5742,6675,4770,-1905
2015,12,24,2,5400,6457,4595,-1862
2015,12,24,3,5062,6113,4302,-1811
2015,12,24,4,4672,5706,3993,-1713
2015,12,24,5,4166,5154,3776,-1378
2015,12,24,6,3619,4623,3634,-989
2015,12,24,7,3370,4204,3336,-868
2015,12,24,8,3181,3952,3158,-794
2015,12,24,9,3106,3809,3062,-747
2015,12,24,10,3110,3793,3024,-769
2015,12,24,11,3224,3934,3098,-836
2015,12,24,12,3442,4204,3232,-972
2015,12,24,13,3675,4503,3395,-1108
2015,12,24,14,4113,5017,3557,-1460
2015,12,24,15,4471,5595,3828,-1767
2015,12,24,16,4855,6110,4252,-1858
2015,12,24,17,5196,6521,4564,-1957
2015,12,24,18,5366,6791,4753,-2038
2015,12,24,19,5564,6991,4903,-2088
2015,12,24,20,5690,7081,5004,-2077
2015,12,24,21,5666,7112,5040,-2072
2015,12,24,22,5650,6997,4957,-2040
2015,12,24,23,5642,6990,4927,-2063
2015,12,25,0,5501,6954,4920,-2034
2015,12,25,1,5062,6595,4648,-1947
2015,12,25,2,4834,6248,4369,-1879
2015,12,25,3,4623,5887,4092,-1795
2015,12,25,4,4281,5542,3813,-1729
2015,12,25,5,3928,5044,3675,-1369
2015,12,25,6,3628,4647,3701,-946
2015,12,25,7,3307,4233,3399,-834
2015,12,25,8,3090,3957,3174,-783
2015,12,25,9,2929,3778,3041,-737
2015,12,25,10,2882,3730,2985,-745
2015,12,25,11,2876,3789,3015,-774
2015,12,25,12,2993,3977,3141,-836
2015,12,25,13,3218,4292,3327,-965
2015,12,25,14,3611,4850,3595,-1255
2015,12,25,15,4253,5521,3923,-1598
2015,12,25,16,4716,6127,4356,-1770
2015,12,25,17,5136,6676,4622,-2054
2015,12,25,18,5405,7109,4887,-2221
2015,12,25,19,5509,7357,5148,-2208
2015,12,25,20,5566,7457,5206,-2250
2015,12,25,21,5514,7391,5175,-2215
2015,12,25,22,5307,7129,5002,-2127
2015,12,25,23,5102,6772,4706,-2066
2015,12,26,0,5188,6752,4648,-2104
2015,12,26,1,4909,6437,4462,-1975
2015,12,26,2,4712,6151,4254,-1897
2015,12,26,3,4455,5779,4045,-1734
2015,12,26,4,4157,5402,3872,-1530
2015,12,26,5,3827,4905,3742,-1163
2015,12,26,6,3456,4354,3437,-917
2015,12,26,7,3245,3991,3166,-825
2015,12,26,8,3080,3756,2997,-759
2015,12,26,9,2965,3630,2902,-728
2015,12,26,10,2923,3599,2878,-721
2015,12,26,11,2926,3662,2890,-772
2015,12,26,12,2994,3841,3022,-819
2015,12,26,13,3155,4071,3152,-919
2015,12,26,14,3483,4580,3430,-1150
2015,12,26,15,3903,5247,3746,-1501
2015,12,26,16,4294,5859,4155,-1704
2015,12,26,17,4585,6370,4552,-1818
2015,12,26,18,4820,6768,4772,-1995
2015,12,26,19,4969,7002,4931,-2071
2015,12,26,20,5094,7037,5013,-2024
2015,12,26,21,5112,6857,4808,-2049
2015,12,26,22,5073,6625,4540,-2084
2015,12,26,23,5046,6589,4462,-2127
2015,12,27,0,5096,6811,4636,-2175
2015,12,27,1,4834,6596,4497,-2099
2015,12,27,2,4610,6325,4386,-1939
2015,12,27,3,4325,5941,4172,-1769
2015,12,27,4,4019,5547,4023,-1524
2015,12,27,5,3676,5047,3872,-1175
2015,12,27,6,3295,4578,3661,-917
2015,12,27,7,3024,4207,3394,-813
2015,12,27,8,2875,3955,3180,-775
2015,12,27,9,2728,3789,3052,-737
2015,12,27,10,2638,3726,3008,-718
2015,12,27,11,2714,3742,3023,-719
2015,12,27,12,3032,3837,3072,-765
2015,12,27,13,3123,4034,3159,-875
2015,12,27,14,3511,4561,3405,-1156
2015,12,27,15,4231,5285,3773,-1512
2015,12,27,16,4753,5874,4137,-1736
2015,12,27,17,5193,6261,4340,-1921
2015,12,27,18,5500,6550,4514,-2036
2015,12,27,19,5618,6730,4575,-2154
2015,12,27,20,5631,6809,4653,-2156
2015,12,27,21,5527,6832,4671,-2161
2015,12,27,22,5510,6778,4656,-2122
2015,12,27,23,5377,6759,4660,-2099
2015,12,28,0,5496,6969,4797,-2172
2015,12,28,1,5301,6704,4621,-2083
2015,12,28,2,4960,6370,4396,-1974
2015,12,28,3,4607,5930,4112,-1818
2015,12,28,4,4196,5445,3887,-1558
2015,12,28,5,4016,4880,3691,-1189
2015,12,28,6,3560,4391,3478,-913
2015,12,28,7,3326,4031,3195,-836
2015,12,28,8,3167,3822,3035,-787
2015,12,28,9,3056,3708,2940,-768
2015,12,28,10,3133,3733,2962,-771
2015,12,28,11,3288,3930,3105,-825
2015,12,28,12,3603,4319,3407,-912
2015,12,28,13,3833,4648,3648,-1000
2015,12,28,14,4170,5086,3878,-1208
2015,12,28,15,4492,5662,4163,-1499
2015,12,28,16,4807,6227,4534,-1693
2015,12,28,17,5127,6665,4816,-1849
2015,12,28,18,5260,7020,4953,-2067
2015,12,28,19,5362,7287,5275,-2012
2015,12,28,20,5563,7457,5412,-2045
2015,12,28,21,5575,7492,5435,-2057
2015,12,28,22,5538,7410,5377,-2033
2015,12,28,23,5476,7274,5197,-2077
2015,12,29,0,5539,7515,5359,-2156
2015,12,29,1,5366,7188,5128,-2060
2015,12,29,2,5044,6803,4844,-1959
2015,12,29,3,4689,6300,4534,-1766
2015,12,29,4,4356,5778,4204,-1574
2015,12,29,5,3886,5185,3990,-1195
2015,12,29,6,3590,4684,3691,-993
2015,12,29,7,3269,4303,3400,-903
2015,12,29,8,3098,4023,3170,-853
2015,12,29,9,3032,3885,3055,-830
2015,12,29,10,3010,3880,3052,-828
2015,12,29,11,3155,4062,3178,-884
2015,12,29,12,3427,4441,3533,-908
2015,12,29,13,3712,4759,3800,-959
2015,12,29,14,4025,5166,3990,-1176
2015,12,29,15,4379,5685,4215,-1470
2015,12,29,16,4680,6233,4562,-1671
2015,12,29,17,4964,6683,4868,-1815
2015,12,29,18,5224,7111,5104,-2007
2015,12,29,19,5417,7347,5285,-2062
2015,12,29,20,5604,7447,5391,-2056
2015,12,29,21,5601,7430,5388,-2042
2015,12,29,22,5568,7350,5319,-2031
2015,12,29,23,5545,7306,5198,-2108
2015,12,30,0,5676,7530,5348,-2182
2015,12,30,1,5492,7220,5131,-2089
2015,12,30,2,5151,6833,4829,-2004
2015,12,30,3,4812,6306,4509,-1797
2015,12,30,4,4451,5787,4229,-1558
2015,12,30,5,3991,5170,3924,-1246
2015,12,30,6,3692,4608,3654,-954
2015,12,30,7,3382,4226,3354,-872
2015,12,30,8,3206,3989,3179,-810
2015,12,30,9,3096,3842,3062,-780
2015,12,30,10,3090,3815,3031,-784
2015,12,30,11,3221,3997,3141,-856
2015,12,30,12,3528,4349,3422,-927
2015,12,30,13,3768,4659,3712,-947
2015,12,30,14,4084,5041,3859,-1182
2015,12,30,15,4536,5469,4002,-1467
2015,12,30,16,4853,6211,4558,-1653
2015,12,30,17,5203,6716,4887,-1829
2015,12,30,18,5380,7080,5063,-2017
2015,12,30,19,5635,7341,5227,-2114
2015,12,30,20,5763,7528,5373,-2155
2015,12,30,21,5687,7612,5432,-2180
2015,12,30,22,5554,7535,5425,-2110
2015,12,30,23,5653,7410,5287,-2123
2015,12,31,0,5787,7528,5358,-2170
2015,12,31,1,5555,7182,5115,-2067
2015,12,31,2,5299,6781,4772,-2009
2015,12,31,3,4951,6308,4391,-1917
2015,12,31,4,4574,5864,4070,-1794
2015,12,31,5,4111,5280,3877,-1403
2015,12,31,6,3697,4763,3877,-2052
2015,12,31,7,3400,4354,3354,-1943
2015,12,31,8,3201,4115,3179,-1812
2015,12,31,9,3090,3975,3062,-1746
2015,12,31,10,3091,3984,3031,-1398
2015,12,31,11,3185,4106,3141,-1171
2015,12,31,12,3423,4461,3330,-1067
2015,12,31,13,3626,4776,3576,-1011
2015,12,31,14,3954,5187,3779,-974
2015,12,31,15,4508,5697,3943,-974
2015,12,31,16,4866,6229,4301,-1007
2015,12,31,17,5168,6708,4703,-1131
2015,12,31,18,5320,7052,4950,-1200
2015,12,31,19,5581,7222,5084,-1408
2015,12,31,20,5636,7265,5109,-1754
2015,12,31,21,5604,7323,5172,-1928
2015,12,31,22,5536,7290,5151,-2005
2015,12,31,23,5592,7258,5112,-2102
2016,1,1,0,5646,7389,5112,-2138
2016,1,1,1,5366,6931,5115,-2156
2016,1,1,2,4969,0,4772,-2151
2016,1,1,3,4594,5830,4391,-2139
2016,1,1,4,4265,5405,4070,-2146
2016,1,1,5,3923,4969,3877,-2181
2016,1,1,6,3668,4617,3668,-949
2016,1,1,7,3381,4328,3444,-884
2016,1,1,8,3100,4018,3191,-827
2016,1,1,9,2985,3819,3046,-773
2016,1,1,10,2895,3730,2975,-755
2016,1,1,11,2861,3731,2944,-787
2016,1,1,12,2897,3849,3044,-805
2016,1,1,13,2978,3966,3136,-830
2016,1,1,14,3244,4378,3386,-992
2016,1,1,15,3760,5005,3689,-1316
2016,1,1,16,4237,5710,4255,-1455
2016,1,1,17,4562,6287,4713,-1574
2016,1,1,18,4771,6724,4952,-1772
2016,1,1,19,4888,6916,4976,-1940
2016,1,1,20,4975,6919,4942,-1977
2016,1,1,21,4906,6827,4875,-1952
2016,1,1,22,4803,6664,4784,-1880
2016,1,1,23,4727,6589,4685,-1904
2016,1,2,0,4804,6717,4868,-1849
2016,1,2,1,4572,6400,4799,-1601
2016,1,2,2,4267,6015,4565,-1450
2016,1,2,3,4037,5572,4188,-1384
2016,1,2,4,3779,5150,3895,-1255
2016,1,2,5,3522,4694,3708,-986
2016,1,2,6,3303,4241,3380,-861
2016,1,2,7,3079,3894,3102,-792
2016,1,2,8,2950,3679,2923,-756
2016,1,2,9,2855,3554,2815,-739
2016,1,2,10,2797,3486,2743,-743
2016,1,2,11,2850,3543,2773,-770
2016,1,2,12,2881,3687,2858,-829
2016,1,2,13,3105,3897,2965,-932
2016,1,2,14,3528,4295,3091,-1204
2016,1,2,15,3920,4687,3414,-1273
2016,1,2,16,4174,4929,3416,-1513
2016,1,2,17,4251,5038,3335,-1703
2016,1,2,18,4300,5100,3341,-1759
2016,1,2,19,4292,5110,3423,-1687
2016,1,2,20,4259,5108,3435,-1673
2016,1,2,21,4171,5059,3412,-1647
2016,1,2,22,4067,5037,3367,-1670
2016,1,2,23,4248,5257,3442,-1815
2016,1,3,0,4458,5517,3644,-1873
2016,1,3,1,4308,5350,3519,-1831
2016,1,3,2,4133,5081,3382,-1699
2016,1,3,3,3908,4808,3239,-1569
2016,1,3,4,3662,4502,3020,-1482
2016,1,3,5,3388,4136,2842,-1294
2016,1,3,6,3131,3781,2671,-1110
2016,1,3,7,2973,3536,2687,-849
2016,1,3,8,2826,3377,2582,-795
2016,1,3,9,2704,3320,2542,-778
2016,1,3,10,2721,3314,2546,-768
2016,1,3,11,2768,3421,2586,-835
2016,1,3,12,2864,3647,2713,-934
2016,1,3,13,3169,3964,2963,-1001
2016,1,3,14,3585,4434,3202,-1232
2016,1,3,15,3950,4827,3346,-1481
2016,1,3,16,4189,5024,3411,-1613
2016,1,3,17,4294,5110,3313,-1797
2016,1,3,18,4325,5193,3377,-1816
2016,1,3,19,4299,5176,3387,-1789
2016,1,3,20,4239,5169,3382,-1787
2016,1,3,21,4236,5181,3380,-1801
2016,1,3,22,4202,5322,3478,-1844
2016,1,3,23,4444,5598,3679,-1919
2016,1,4,0,4821,5863,3941,-1922
2016,1,4,1,4840,5757,3937,-1820
2016,1,4,2,4786,5563,3804,-1759
2016,1,4,3,4562,5202,3460,-1742
2016,1,4,4,4334,4792,3075,-1717
2016,1,4,5,3882,4348,2964,-1384
2016,1,4,6,3305,4154,3091,-1063
2016,1,4,7,3158,3959,2946,-1013
2016,1,4,8,3079,3906,2908,-998
2016,1,4,9,3077,3949,2929,-1020
2016,1,4,10,3231,4120,3034,-1086
2016,1,4,11,3763,4578,3234,-1344
2016,1,4,12,4479,5321,3757,-1564
2016,1,4,13,5010,5863,4239,-1624
2016,1,4,14,4958,5969,4350,-1619
2016,1,4,15,4633,5939,4365,-1574
2016,1,4,16,4556,5769,4205,-1564
2016,1,4,17,4456,5601,4238,-1363
2016,1,4,18,4430,5429,4130,-1299
2016,1,4,19,4306,5276,4110,-1166
2016,1,4,20,4276,5178,4153,-1025
2016,1,4,21,4216,5110,4127,-983
2016,1,4,22,4323,5186,4173,-1013
2016,1,4,23,4691,5526,4411,-1115
2016,1,5,0,5122,6174,4865,-1309
2016,1,5,1,5140,6247,4916,-1331
2016,1,5,2,4977,6169,4853,-1316
2016,1,5,3,4724,5831,4563,-1268
2016,1,5,4,4416,5421,4244,-1177
2016,1,5,5,3845,5029,3914,-1115
2016,1,5,6,3414,4587,3530,-1057
2016,1,5,7,3321,4447,3404,-1043
2016,1,5,8,3310,4433,3348,-1085
2016,1,5,9,3303,4500,3390,-1110
2016,1,5,10,3530,4681,3506,-1175
2016,1,5,11,3975,5230,3880,-1350
2016,1,5,12,4723,6081,4608,-1473
2016,1,5,13,5061,6489,4998,-1491
2016,1,5,14,4945,6434,4940,-1494
2016,1,5,15,4724,6210,4775,-1435
2016,1,5,16,4518,5962,4571,-1391
2016,1,5,17,4271,5697,4412,-1285
2016,1,5,18,4053,5453,4254,-1199
2016,1,5,19,3905,5230,4121,-1109
2016,1,5,20,3744,5138,4047,-1091
2016,1,5,21,3707,5103,4041,-1062
2016,1,5,22,3676,5298,4174,-1124
2016,1,5,23,4002,5736,4433,-1303
2016,1,6,0,4460,6295,4910,-1385
2016,1,6,1,4509,6246,4953,-1293
2016,1,6,2,4378,6047,4732,-1315
2016,1,6,3,4044,5648,4417,-1231
2016,1,6,4,3763,5194,3978,-1216
2016,1,6,5,3462,4699,3576,-1123
2016,1,6,6,3190,4371,3321,-1050
2016,1,6,7,2990,4179,3162,-1017
2016,1,6,8,2933,4102,3090,-1012
2016,1,6,9,2932,4144,3122,-1022
2016,1,6,10,2994,4321,3248,-1073
2016,1,6,11,3384,4806,3616,-1190
2016,1,6,12,4066,5490,4116,-1374
2016,1,6,13,4393,5893,4497,-1396
2016,1,6,14,4332,5897,4581,-1316
2016,1,6,15,4340,5826,4573,-1253
2016,1,6,16,4335,5740,4419,-1321
2016,1,6,17,4260,5574,4346,-1228
2016,1,6,18,4124,5357,4189,-1168
2016,1,6,19,4077,5226,4094,-1132
2016,1,6,20,4039,5151,4063,-1088
2016,1,6,21,3990,5144,4063,-1081
2016,1,6,22,4014,5288,4167,-1121
2016,1,6,23,4197,5693,4433,-1260
2016,1,7,0,4612,6107,4803,-1304
2016,1,7,1,4573,6049,4759,-1290
2016,1,7,2,4379,5829,4575,-1254
2016,1,7,3,4048,5418,4233,-1185
2016,1,7,4,3643,4941,3828,-1113
2016,1,7,5,3250,4451,3449,-1002
2016,1,7,6,3186,4089,3177,-912
2016,1,7,7,3011,3934,3035,-899
2016,1,7,8,2924,3839,2964,-875
2016,1,7,9,2864,3868,2976,-892
2016,1,7,10,2941,3970,3033,-937
2016,1,7,11,3268,4357,3292,-1065
2016,1,7,12,3813,5069,3845,-1224
2016,1,7,13,4072,5456,4241,-1215
2016,1,7,14,4082,5521,4295,-1226
2016,1,7,15,4167,5559,4348,-1211
2016,1,7,16,4192,5558,4370,-1188
2016,1,7,17,4222,5457,4323,-1134
2016,1,7,18,4251,5312,4231,-1081
2016,1,7,19,4269,5129,4130,-999
2016,1,7,20,4265,5018,4051,-967
2016,1,7,21,4264,4989,4063,-926
2016,1,7,22,4297,4961,4119,-842
2016,1,7,23,4413,5343,4294,-1049
2016,1,8,0,4689,5800,4620,-1180
2016,1,8,1,4580,5743,4571,-1172
2016,1,8,2,4395,5514,4382,-1132
2016,1,8,3,4082,5098,4059,-1039
2016,1,8,4,3706,4618,3683,-935
2016,1,8,5,3368,4120,3292,-828
2016,1,8,6,3109,3724,2927,-797
2016,1,8,7,2911,3528,2757,-771
2016,1,8,8,2788,3406,2669,-737
2016,1,8,9,2800,3390,2646,-744
2016,1,8,10,2842,3472,2688,-784
2016,1,8,11,3130,3811,2908,-903
2016,1,8,12,3640,4466,3401,-1065
2016,1,8,13,3900,4857,3774,-1083
2016,1,8,14,3951,4945,3777,-1168
2016,1,8,15,4028,5055,3833,-1222
2016,1,8,16,4195,5135,3870,-1265
2016,1,8,17,4257,5168,3861,-1307
2016,1,8,18,4285,5189,3886,-1303
2016,1,8,19,4274,5184,3900,-1284
2016,1,8,20,4261,5157,3893,-1264
2016,1,8,21,4234,5154,3896,-1258
2016,1,8,22,4212,5202,3967,-1235
2016,1,8,23,4308,5325,4057,-1268
2016,1,9,0,4598,5616,4278,-1338
2016,1,9,1,4443,5453,4139,-1314
2016,1,9,2,4278,5191,3945,-1246
2016,1,9,3,4007,4845,3657,-1188
2016,1,9,4,3695,4498,3337,-1161
2016,1,9,5,3390,4061,3072,-989
2016,1,9,6,3105,3687,2890,-797
2016,1,9,7,2917,3449,2697,-752
2016,1,9,8,2804,3337,2619,-718
2016,1,9,9,2752,3280,2557,-723
2016,1,9,10,2765,3294,2597,-697
2016,1,9,11,2763,3412,2684,-728
2016,1,9,12,2926,3677,2866,-811
2016,1,9,13,3188,3973,3143,-830
2016,1,9,14,3417,4441,3538,-903
2016,1,9,15,3760,4812,3858,-954
2016,1,9,16,3961,5006,4037,-969
2016,1,9,17,4194,5094,4064,-1030
2016,1,9,18,4215,5124,4031,-1093
2016,1,9,19,4218,5104,4026,-1078
2016,1,9,20,4240,5104,4034,-1070
2016,1,9,21,4219,5099,4101,-998
2016,1,9,22,4167,5187,4162,-1025
2016,1,9,23,4233,5376,4352,-1024
2016,1,10,0,4492,5560,4631,-929
2016,1,10,1,4363,5382,4499,-883
2016,1,10,2,4192,5136,4218,-918
2016,1,10,3,3955,4810,3865,-945
2016,1,10,4,3714,4509,3610,-899
2016,1,10,5,3401,4072,3209,-863
2016,1,10,6,3157,3762,2947,-815
2016,1,10,7,2952,3526,2767,-759
2016,1,10,8,2841,3384,2652,-732
2016,1,10,9,2748,3326,2609,-717
2016,1,10,10,2736,3321,2599,-722
2016,1,10,11,2771,3375,2604,-771
2016,1,10,12,2929,3559,2717,-842
2016,1,10,13,3138,3860,2981,-879
2016,1,10,14,3468,4329,3358,-971
2016,1,10,15,3780,4768,3759,-1009
2016,1,10,16,4017,4962,3930,-1032
2016,1,10,17,4101,5049,3958,-1091
2016,1,10,18,4149,5075,3986,-1089
2016,1,10,19,4115,5035,3945,-1090
2016,1,10,20,4030,4986,3900,-1086
2016,1,10,21,3937,0,3900,-1057
2016,1,10,22,3864,5007,3887,-1120
2016,1,10,23,3972,5240,4079,-1161
2016,1,11,0,4270,5716,4526,-1190
2016,1,11,1,4235,5662,4492,-1170
2016,1,11,2,4067,5496,4370,-1126
2016,1,11,3,3785,5143,4071,-1072
2016,1,11,4,3541,4745,3715,-1030
2016,1,11,5,3261,4311,3254,-1057
2016,1,11,6,3266,4029,3041,-988
2016,1,11,7,3181,3916,2954,-962
2016,1,11,8,3182,3910,2917,-993
2016,1,11,9,3255,4027,2996,-1031
2016,1,11,10,3502,4303,3242,-1061
2016,1,11,11,3983,4937,3791,-1146
2016,1,11,12,4692,6002,4740,-1262
2016,1,11,13,5186,6704,5610,-1094
2016,1,11,14,5192,6804,5879,-925
2016,1,11,15,5096,6606,5694,-912
2016,1,11,16,4858,6302,5318,-984
2016,1,11,17,4660,6004,4972,-1032
2016,1,11,18,4477,5735,4621,-1114
2016,1,11,19,4326,5527,4470,-1057
2016,1,11,20,4280,5310,4280,-1030
2016,1,11,21,4122,5240,4134,-1106
2016,1,11,22,4188,5346,4248,-1098
2016,1,11,23,4428,5830,4723,-1107
2016,1,12,0,4982,6677,5455,-1222
2016,1,12,1,5061,6905,5621,-1284
2016,1,12,2,4965,6918,5624,-1294
2016,1,12,3,4832,6734,5447,-1287
2016,1,12,4,4589,6417,5077,-1340
2016,1,12,5,4327,6060,4748,-1312
2016,1,12,6,4192,5845,4328,-1517
2016,1,12,7,4138,5765,4154,-1611
2016,1,12,8,4230,5787,4090,-1697
2016,1,12,9,4329,5814,4017,-1797
2016,1,12,10,4578,6017,4017,-2000
2016,1,12,11,5181,6635,4484,-2151
2016,1,12,12,5918,7567,5303,-2264
2016,1,12,13,6283,8073,5731,-2342
2016,1,12,14,6133,7848,5646,-2202
2016,1,12,15,5810,7239,5107,-2132
2016,1,12,16,5249,6620,4592,-2028
2016,1,12,17,4871,6045,4251,-1794
2016,1,12,18,4591,5663,4127,-1536
2016,1,12,19,4359,5371,4000,-1371
2016,1,12,20,4125,5187,3895,-1292
2016,1,12,21,4040,5127,3837,-1290
2016,1,12,22,4130,5240,3801,-1439
2016,1,12,23,4401,5661,3968,-1693
2016,1,13,0,4927,6460,4645,-1815
2016,1,13,1,4987,6604,4825,-1779
2016,1,13,2,4948,6589,4795,-1794
2016,1,13,3,4843,6315,4551,-1764
2016,1,13,4,4699,5943,4276,-1667
2016,1,13,5,4313,5506,4037,-1469
2016,1,13,6,3941,5274,3965,-1309
2016,1,13,7,3917,5207,3908,-1299
2016,1,13,8,3996,5216,3893,-1323
2016,1,13,9,4113,5293,3873,-1420
2016,1,13,10,4365,5502,4074,-1428
2016,1,13,11,4829,6087,4570,-1517
2016,1,13,12,5734,6933,5400,-1533
2016,1,13,13,6091,7304,5747,-1557
2016,1,13,14,5983,7151,5540,-1611
2016,1,13,15,5665,6792,5190,-1602
2016,1,13,16,5268,6438,4686,-1752
2016,1,13,17,4893,6144,4481,-1663
2016,1,13,18,4610,5908,4363,-1545
2016,1,13,19,4444,5665,4362,-1303
2016,1,13,20,4233,5566,4340,-1226
2016,1,13,21,4216,5559,4331,-1228
2016,1,13,22,4354,5747,4540,-1207
2016,1,13,23,4584,6207,4864,-1343
2016,1,14,0,5045,6772,5279,-1493
2016,1,14,1,5069,6861,5423,-1437
2016,1,14,2,5055,6767,5351,-1416
2016,1,14,3,4879,6460,5089,-1371
2016,1,14,4,4754,6009,4671,-1338
2016,1,14,5,4346,5554,4239,-1315
2016,1,14,6,3919,5277,4034,-1243
2016,1,14,7,3837,5208,3955,-1253
2016,1,14,8,3784,5227,3956,-1271
2016,1,14,9,3830,5326,4015,-1311
2016,1,14,10,4011,5566,4190,-1376
2016,1,14,11,4436,6143,4769,-1374
2016,1,14,12,5214,6984,5533,-1451
2016,1,14,13,5482,7435,5930,-1505
2016,1,14,14,5385,7256,5893,-1363
2016,1,14,15,5135,6931,5592,-1339
2016,1,14,16,4920,6542,5189,-1353
2016,1,14,17,4567,6076,4736,-1340
2016,1,14,18,4368,5669,4365,-1304
2016,1,14,19,4189,5415,4129,-1286
2016,1,14,20,4044,5300,4057,-1243
2016,1,14,21,4073,5206,3988,-1218
2016,1,14,22,4157,5314,4071,-1243
2016,1,14,23,4319,5687,4292,-1395
2016,1,15,0,4620,6111,4620,-1491
2016,1,15,1,4701,6057,4633,-1424
2016,1,15,2,4482,5828,4470,-1358
2016,1,15,3,4208,5459,4132,-1327
2016,1,15,4,3876,4987,3720,-1267
2016,1,15,5,3484,4482,3321,-1161
2016,1,15,6,3217,4063,2957,-1106
2016,1,15,7,3065,3846,2777,-1069
2016,1,15,8,2957,3727,2693,-1034
2016,1,15,9,2942,3687,2671,-1016
2016,1,15,10,3035,3757,2704,-1053
2016,1,15,11,3271,3923,2790,-1133
2016,1,15,12,3808,4666,3367,-1299
2016,1,15,13,4095,5058,3819,-1239
2016,1,15,14,4100,5173,3966,-1207
2016,1,15,15,4110,5376,4137,-1239
2016,1,15,16,4154,5500,4228,-1272
2016,1,15,17,4179,5452,4131,-1321
2016,1,15,18,4163,5329,4026,-1303
2016,1,15,19,4093,5204,3903,-1301
2016,1,15,20,4111,5139,3826,-1313
2016,1,15,21,4140,5105,3874,-1231
2016,1,15,22,4136,5086,3917,-1169
2016,1,15,23,4153,5116,3849,-1267
2016,1,16,0,4484,5428,4033,-1395
2016,1,16,1,4395,5343,3958,-1385
2016,1,16,2,4137,5116,3777,-1339
2016,1,16,3,3890,4886,3601,-1285
2016,1,16,4,3632,4563,3337,-1226
2016,1,16,5,3391,4177,3060,-1117
2016,1,16,6,3076,3857,2992,-865
2016,1,16,7,2896,3681,2866,-815
2016,1,16,8,2749,3622,2810,-812
2016,1,16,9,2669,3611,2799,-812
2016,1,16,10,2731,3700,2803,-897
2016,1,16,11,2829,3904,2996,-908
2016,1,16,12,3076,4259,3241,-1018
2016,1,16,13,3377,4647,3579,-1068
2016,1,16,14,3659,5020,3968,-1052
2016,1,16,15,3894,5145,4119,-1026
2016,1,16,16,4043,5141,4153,-988
2016,1,16,17,4093,5102,4148,-954
2016,1,16,18,4134,5073,4054,-1019
2016,1,16,19,4174,5022,4015,-1007
2016,1,16,20,4149,5018,4020,-998
2016,1,16,21,4101,5016,4019,-997
2016,1,16,22,4073,5022,4034,-988
2016,1,16,23,4108,5065,4042,-1023
2016,1,17,0,4357,5374,4266,-1108
2016,1,17,1,4234,5210,4138,-1072
2016,1,17,2,4028,4983,3957,-1026
2016,1,17,3,3804,4702,3753,-949
2016,1,17,4,3542,4365,3511,-854
2016,1,17,5,3272,3967,3141,-826
2016,1,17,6,2996,3631,2854,-777
2016,1,17,7,2828,3397,2674,-723
2016,1,17,8,2712,3272,2584,-688
2016,1,17,9,2660,3260,2559,-701
2016,1,17,10,2710,3238,2530,-708
2016,1,17,11,2758,3304,2559,-745
2016,1,17,12,2903,3535,2726,-809
2016,1,17,13,3192,3847,2979,-868
2016,1,17,14,3547,4384,3395,-989
2016,1,17,15,3822,4898,3784,-1114
2016,1,17,16,3967,5118,4001,-1117
2016,1,17,17,4016,5113,4104,-1009
2016,1,17,18,4058,5087,4032,-1055
2016,1,17,19,3989,4999,3932,-1067
2016,1,17,20,3955,4878,3860,-1018
2016,1,17,21,3912,4813,3808,-1005
2016,1,17,22,3922,4854,3820,-1034
2016,1,17,23,4068,5092,3990,-1102
2016,1,18,0,4407,5592,4357,-1235
2016,1,18,1,4367,5638,4389,-1249
2016,1,18,2,4214,5575,4323,-1252
2016,1,18,3,3955,5345,4161,-1184
2016,1,18,4,3758,5091,3925,-1166
2016,1,18,5,3494,4755,3601,-1154
2016,1,18,6,3680,4519,3367,-1152
2016,1,18,7,3591,4474,3315,-1159
2016,1,18,8,3613,4521,3279,-1242
2016,1,18,9,3732,4679,3350,-1329
2016,1,18,10,3896,4977,3582,-1395
2016,1,18,11,4303,5548,4043,-1505
2016,1,18,12,4811,6352,4682,-1670
2016,1,18,13,5345,7099,5305,-1794
2016,1,18,14,5561,7414,5575,-1839
2016,1,18,15,5433,7269,5484,-1785
2016,1,18,16,5180,6901,5202,-1699
2016,1,18,17,4918,6425,4897,-1528
2016,1,18,18,4718,6018,4481,-1537
2016,1,18,19,4450,5641,4298,-1343
2016,1,18,20,4327,5416,4128,-1288
2016,1,18,21,4227,5295,4030,-1265
2016,1,18,22,4277,5408,4014,-1394
2016,1,18,23,4566,5924,4456,-1468
2016,1,19,0,5142,6702,5024,-1678
2016,1,19,1,5287,6933,5216,-1717
2016,1,19,2,5296,6922,5323,-1599
2016,1,19,3,5083,6701,5086,-1615
2016,1,19,4,4857,6283,4487,-1796
2016,1,19,5,4616,5843,3981,-1862
2016,1,19,6,4461,5574,3892,-1682
2016,1,19,7,4356,5516,3822,-1694
2016,1,19,8,4469,5599,3872,-1727
2016,1,19,9,4566,5739,3888,-1851
2016,1,19,10,4931,6052,4086,-1966
2016,1,19,11,5479,6777,4653,-2124
2016,1,19,12,6311,7810,6014,-1796
2016,1,19,13,6691,8316,6535,-1781
2016,1,19,14,6515,8273,6081,-2192
2016,1,19,15,6261,7977,5890,-2087
2016,1,19,16,5804,7596,5578,-2018
2016,1,19,17,5402,7047,5053,-1994
2016,1,19,18,5094,6577,4581,-1996
2016,1,19,19,4829,6161,4450,-1711
2016,1,19,20,4579,5866,4367,-1499
2016,1,19,21,4447,5724,4294,-1430
2016,1,19,22,4480,5873,4386,-1487
2016,1,19,23,4926,6448,4637,-1811
2016,1,20,0,5696,7454,5245,-2209
2016,1,20,1,6006,7875,5655,-2220
2016,1,20,2,6077,7948,5760,-2188
2016,1,20,3,5862,7835,5705,-2130
2016,1,20,4,5650,7476,5292,-2184
2016,1,20,5,5260,7131,4926,-2205
2016,1,20,6,4692,6990,4863,-2127
2016,1,20,7,4595,7035,4849,-2186
2016,1,20,8,4671,7186,4924,-2262
2016,1,20,9,4731,7367,5126,-2241
2016,1,20,10,5009,7735,5459,-2276
2016,1,20,11,5611,8466,6223,-2243
2016,1,20,12,6438,9450,7293,-2157
2016,1,20,13,6836,9896,7560,-2336
2016,1,20,14,6754,9589,7184,-2405
2016,1,20,15,6108,8573,6439,-2134
2016,1,20,16,5460,7600,5697,-1903
2016,1,20,17,5105,6741,4884,-1857
2016,1,20,18,4759,6132,4438,-1694
2016,1,20,19,4488,5656,4156,-1500
2016,1,20,20,4294,5358,4051,-1307
2016,1,20,21,4217,5217,3940,-1277
2016,1,20,22,4210,5290,3971,-1319
2016,1,20,23,4427,5668,4208,-1460
2016,1,21,0,4975,6396,4721,-1675
2016,1,21,1,5006,6603,4886,-1717
2016,1,21,2,4956,6597,4871,-1726
2016,1,21,3,4752,6420,4715,-1705
2016,1,21,4,4477,6097,4457,-1640
2016,1,21,5,4154,5712,4186,-1526
2016,1,21,6,3995,5634,4204,-1430
2016,1,21,7,3894,5652,4193,-1459
2016,1,21,8,3858,5703,4213,-1490
2016,1,21,9,3918,5839,4274,-1565
2016,1,21,10,4110,6119,4569,-1550
2016,1,21,11,4577,6748,5139,-1609
2016,1,21,12,5258,7644,5955,-1689
2016,1,21,13,5556,8014,6354,-1660
2016,1,21,14,5364,7711,6086,-1625
2016,1,21,15,5019,7112,5515,-1597
2016,1,21,16,4722,6461,4865,-1596
2016,1,21,17,4508,5953,4456,-1497
2016,1,21,18,4270,5593,4190,-1403
2016,1,21,19,4165,5362,4039,-1323
2016,1,21,20,4065,5201,3922,-1279
2016,1,21,21,4056,5159,3893,-1266
2016,1,21,22,4029,5239,3937,-1302
2016,1,21,23,4167,5524,4138,-1386
2016,1,22,0,4452,6017,4466,-1551
2016,1,22,1,4480,6081,4528,-1553
2016,1,22,2,4372,5924,4431,-1493
2016,1,22,3,4114,5572,4139,-1433
2016,1,22,4,3830,5171,3819,-1352
2016,1,22,5,3461,4723,3546,-1177
2016,1,22,6,3211,4274,3296,-978
2016,1,22,7,3012,4109,3148,-961
2016,1,22,8,2950,4055,3092,-963
2016,1,22,9,2940,4062,3112,-950
2016,1,22,10,3008,4196,3179,-1017
2016,1,22,11,3305,4590,3482,-1108
2016,1,22,12,3892,5280,4015,-1265
2016,1,22,13,4217,5599,4354,-1245
2016,1,22,14,4261,5538,4353,-1185
2016,1,22,15,4299,5516,4372,-1144
2016,1,22,16,4337,5489,4384,-1105
2016,1,22,17,4336,5492,4395,-1097
2016,1,22,18,4317,5377,4315,-1062
2016,1,22,19,4311,5264,4258,-1006
2016,1,22,20,4272,5077,4107,-970
2016,1,22,21,4295,5012,4040,-972
2016,1,22,22,4296,5039,4042,-997
2016,1,22,23,4360,5209,4119,-1090
2016,1,23,0,4549,5679,4514,-1165
2016,1,23,1,4439,5700,4575,-1125
2016,1,23,2,4196,5612,4496,-1116
2016,1,23,3,4004,5388,4234,-1154
2016,1,23,4,3756,5132,3959,-1173
2016,1,23,5,3459,4803,3697,-1106
2016,1,23,6,3295,4516,3474,-1042
2016,1,23,7,3259,4395,3345,-1050
2016,1,23,8,3312,4438,3354,-1084
2016,1,23,9,3420,4550,3431,-1119
2016,1,23,10,3461,4773,3595,-1178
2016,1,23,11,3629,5129,3920,-1209
2016,1,23,12,3968,5676,4435,-1241
2016,1,23,13,4364,6339,5030,-1309
2016,1,23,14,4807,7060,5612,-1448
2016,1,23,15,5028,7582,6124,-1458
2016,1,23,16,5057,7852,6340,-1512
2016,1,23,17,4958,7751,5920,-1831
2016,1,23,18,4829,7429,5596,-1833
2016,1,23,19,4631,6957,5284,-1673
2016,1,23,20,4444,6606,4985,-1621
2016,1,23,21,4334,6414,4870,-1544
2016,1,23,22,4331,6491,4929,-1562
2016,1,23,23,4619,6982,5394,-1588
2016,1,24,0,5264,7754,6161,-1593
2016,1,24,1,5469,7970,6410,-1560
2016,1,24,2,5534,7930,6425,-1505
2016,1,24,3,5553,7780,6287,-1493
2016,1,24,4,5468,7506,5982,-1524
2016,1,24,5,5192,7216,5649,-1567
2016,1,24,6,5105,7037,5349,-1688
2016,1,24,7,5106,7000,5285,-1715
2016,1,24,8,5087,7034,5358,-1676
2016,1,24,9,5144,7186,5434,-1752
2016,1,24,10,5460,7412,5639,-1773
2016,1,24,11,5646,7833,6047,-1786
2016,1,24,12,6082,8458,6334,-2124
2016,1,24,13,6423,9180,6852,-2328
2016,1,24,14,6628,9538,7254,-2284
2016,1,24,15,6642,9181,7018,-2163
2016,1,24,16,6347,8518,6459,-2059
2016,1,24,17,5760,7737,5680,-2057
2016,1,24,18,5223,7063,5171,-1892
2016,1,24,19,4892,6496,4781,-1715
2016,1,24,20,4638,6041,4417,-1624
2016,1,24,21,4525,5794,4192,-1602
2016,1,24,22,4528,5836,4173,-1663
2016,1,24,23,4757,6260,4347,-1913
2016,1,25,0,5427,7141,4951,-2190
2016,1,25,1,5757,7682,5312,-2370
2016,1,25,2,5762,7842,5419,-2423
2016,1,25,3,5605,7795,5333,-2462
2016,1,25,4,5335,7562,5127,-2435
2016,1,25,5,5287,7268,4907,-2361
2016,1,25,6,4884,7220,4930,-2290
2016,1,25,7,4916,7304,5022,-2282
2016,1,25,8,4953,7493,5295,-2198
2016,1,25,9,5054,7739,5576,-2163
2016,1,25,10,5361,8096,5943,-2153
2016,1,25,11,5986,8851,6528,-2323
2016,1,25,12,6744,9860,7376,-2484
2016,1,25,13,7081,10356,7880,-2476
2016,1,25,14,6727,9852,7476,-2376
2016,1,25,15,6136,8669,6544,-2125
2016,1,25,16,5571,7543,5577,-1966
2016,1,25,17,5177,6699,4725,-1974
2016,1,25,18,4798,6034,4337,-1697
2016,1,25,19,4569,5564,4084,-1480
2016,1,25,20,4355,5273,3964,-1309
2016,1,25,21,4284,5117,3858,-1259
2016,1,25,22,4281,5162,3890,-1272
2016,1,25,23,4403,5458,4043,-1415
2016,1,26,0,4886,6152,4521,-1631
2016,1,26,1,4981,6332,4676,-1656
2016,1,26,2,4878,6235,4556,-1679
2016,1,26,3,4615,5943,4331,-1612
2016,1,26,4,4305,5511,3955,-1556
2016,1,26,5,3861,5027,3682,-1345
2016,1,26,6,3627,4748,3571,-1177
2016,1,26,7,3523,4622,3468,-1154
2016,1,26,8,3416,4630,3452,-1178
2016,1,26,9,3462,4743,3534,-1209
2016,1,26,10,3635,4980,3696,-1284
2016,1,26,11,4036,5478,4079,-1399
2016,1,26,12,4697,6291,4717,-1574
2016,1,26,13,4998,6559,5051,-1508
2016,1,26,14,4914,6339,4951,-1388
2016,1,26,15,4718,5963,4660,-1303
2016,1,26,16,4490,5618,4428,-1190
2016,1,26,17,4374,5347,4270,-1077
2016,1,26,18,4271,5176,4133,-1043
2016,1,26,19,4192,5090,4068,-1022
2016,1,26,20,4084,4997,4021,-976
2016,1,26,21,4083,4976,4003,-973
2016,1,26,22,4088,5018,4034,-984
2016,1,26,23,4242,5228,4157,-1071
2016,1,27,0,4642,5721,4501,-1220
2016,1,27,1,4697,5754,4557,-1197
2016,1,27,2,4539,5513,4373,-1140
2016,1,27,3,4235,5079,4024,-1055
2016,1,27,4,3787,4586,3649,-937
2016,1,27,5,3376,4068,3204,-864
2016,1,27,6,3114,3722,2846,-876
2016,1,27,7,2977,3529,2730,-799
2016,1,27,8,2859,3429,2636,-793
2016,1,27,9,2880,3407,2623,-784
2016,1,27,10,2936,3498,2685,-813
2016,1,27,11,3215,3864,2943,-921
2016,1,27,12,3802,4539,3497,-1042
2016,1,27,13,4078,4932,3888,-1044
2016,1,27,14,4138,4989,3985,-1004
2016,1,27,15,4212,5080,4050,-1030
2016,1,27,16,4270,5187,4130,-1057
2016,1,27,17,4316,5218,4168,-1050
2016,1,27,18,4282,5247,4224,-1023
2016,1,27,19,4180,5209,4195,-1014
2016,1,27,20,4168,5150,4152,-998
2016,1,27,21,4175,5172,4183,-989
2016,1,27,22,4166,5253,4241,-1012
2016,1,27,23,4262,5494,4408,-1086
2016,1,28,0,4583,5798,4633,-1165
2016,1,28,1,4543,5715,4559,-1156
2016,1,28,2,4337,5469,4369,-1100
2016,1,28,3,4046,5048,4028,-1020
2016,1,28,4,3708,4566,3650,-916
2016,1,28,5,3363,4062,3215,-847
2016,1,28,6,3080,3689,2893,-796
2016,1,28,7,2889,3476,2740,-736
2016,1,28,8,2761,3365,2638,-727
2016,1,28,9,2757,3334,2615,-719
2016,1,28,10,2790,3431,2686,-745
2016,1,28,11,3122,3813,2878,-935
2016,1,28,12,3732,4511,3312,-1199
2016,1,28,13,4050,4929,3528,-1401
2016,1,28,14,4123,5018,3616,-1402
2016,1,28,15,4195,5163,3761,-1402
2016,1,28,16,4296,5316,3881,-1435
2016,1,28,17,4283,5363,3953,-1410
2016,1,28,18,4232,5353,3923,-1430
2016,1,28,19,4151,5298,3878,-1420
2016,1,28,20,4139,5243,3861,-1382
2016,1,28,21,4137,5297,3871,-1426
2016,1,28,22,4195,5453,3981,-1472
2016,1,28,23,4332,5687,4224,-1463
2016,1,29,0,4577,5938,4410,-1528
2016,1,29,1,4599,5839,4325,-1514
2016,1,29,2,4471,5610,4110,-1500
2016,1,29,3,4274,5187,3703,-1484
2016,1,29,4,3913,4765,3371,-1394
2016,1,29,5,3618,4288,3117,-1171
2016,1,29,6,3285,3967,2959,-1008
2016,1,29,7,3177,3809,2914,-895
2016,1,29,8,3201,3774,2870,-904
2016,1,29,9,3275,3811,2896,-915
2016,1,29,10,3450,4047,3057,-990
2016,1,29,11,3951,4623,3456,-1167
2016,1,29,12,4736,5547,4132,-1415
2016,1,29,13,5193,6139,4638,-1501
2016,1,29,14,5043,6233,4757,-1476
2016,1,29,15,4835,6023,4683,-1340
2016,1,29,16,4658,5827,4605,-1222
2016,1,29,17,4449,5579,4452,-1127
2016,1,29,18,4242,5330,4245,-1085
2016,1,29,19,4119,5165,4074,-1091
2016,1,29,20,4016,5016,4036,-980
2016,1,29,21,3972,4933,3964,-969
2016,1,29,22,4004,4970,4003,-967
2016,1,29,23,4123,5166,4081,-1085
2016,1,30,0,4554,5719,4488,-1231
2016,1,30,1,4681,5859,4572,-1287
2016,1,30,2,4569,5807,4516,-1291
2016,1,30,3,4411,5684,4386,-1298
2016,1,30,4,4259,5434,4191,-1243
2016,1,30,5,4131,5159,3937,-1222
2016,1,30,6,3852,4920,3733,-1187
2016,1,30,7,3759,4786,3607,-1179
2016,1,30,8,3774,4773,3571,-1202
2016,1,30,9,3864,4838,3594,-1244
2016,1,30,10,3975,4992,3718,-1274
2016,1,30,11,4262,5291,3980,-1311
2016,1,30,12,4632,5787,4310,-1477
2016,1,30,13,5092,6348,4797,-1551
2016,1,30,14,5215,6734,5189,-1545
2016,1,30,15,5134,6457,4994,-1463
2016,1,30,16,4861,5962,4686,-1276
2016,1,30,17,4531,5532,4306,-1226
2016,1,30,18,4222,5170,4050,-1120
2016,1,30,19,4054,4923,3890,-1033
2016,1,30,20,3879,4775,3778,-997
2016,1,30,21,3829,4725,3729,-996
2016,1,30,22,3827,4741,3733,-1008
2016,1,30,23,3912,4891,3834,-1057
2016,1,31,0,4216,5339,4162,-1177
2016,1,31,1,4274,5370,4182,-1188
2016,1,31,2,4124,5268,4095,-1173
2016,1,31,3,3959,5078,3943,-1135
2016,1,31,4,3778,4874,3775,-1099
2016,1,31,5,3589,4577,3486,-1091
2016,1,31,6,3312,4327,3295,-1032
2016,1,31,7,3254,4180,3155,-1025
2016,1,31,8,3172,4128,3105,-1023
2016,1,31,9,3169,4195,3152,-1043
2016,1,31,10,3186,4277,3221,-1056
2016,1,31,11,3311,4472,3378,-1094
2016,1,31,12,3620,4799,3609,-1190
2016,1,31,13,3857,5271,3958,-1313
2016,1,31,14,4191,5690,4275,-1415
2016,1,31,15,4308,5813,4403,-1410
2016,1,31,16,4167,5615,4303,-1312
2016,1,31,17,4119,5332,4127,-1205
2016,1,31,18,4093,5145,3982,-1163
2016,1,31,19,4036,4995,3873,-1122
2016,1,31,20,3921,4883,3822,-1061
2016,1,31,21,3913,4850,3799,-1051
2016,1,31,22,3972,4903,3832,-1071
2016,1,31,23,4032,5139,3977,-1162
2016,2,1,0,4327,5557,4294,-1263
2016,2,1,1,4399,5538,4282,-1256
2016,2,1,2,4135,5327,4115,-1212
2016,2,1,3,3775,4904,3779,-1125
2016,2,1,4,3419,4491,3424,-1067
2016,2,1,5,3142,4019,3066,-953
2016,2,1,6,2976,3644,2782,-862
2016,2,1,7,2848,3457,2635,-822
2016,2,1,8,2741,3375,2586,-789
2016,2,1,9,2726,3372,2549,-823
2016,2,1,10,2813,3495,2634,-861
2016,2,1,11,3137,3923,2939,-984
2016,2,1,12,3698,4679,3521,-1158
2016,2,1,13,4026,5083,3919,-1164
2016,2,1,14,4007,5090,3948,-1142
2016,2,1,15,4124,5111,3975,-1136
2016,2,1,16,4279,5210,4037,-1173
2016,2,1,17,4290,5305,4247,-1058
2016,2,1,18,4361,5409,4375,-1034
2016,2,1,19,4429,5530,4449,-1081
2016,2,1,20,4526,5569,4483,-1086
2016,2,1,21,4501,5658,4559,-1099
2016,2,1,22,4521,5759,4613,-1146
2016,2,1,23,4560,5828,4632,-1196
2016,2,2,0,4753,6119,4811,-1308
2016,2,2,1,4808,6138,4882,-1256
2016,2,2,2,4598,5832,4626,-1206
2016,2,2,3,4237,5338,4260,-1078
2016,2,2,4,3860,4789,3693,-1096
2016,2,2,5,3406,4182,3202,-980
2016,2,2,6,2994,3722,2871,-851
2016,2,2,7,2837,3473,2669,-804
2016,2,2,8,2707,3340,2553,-787
2016,2,2,9,2733,3284,2490,-794
2016,2,2,10,2797,3367,2532,-835
2016,2,2,11,3100,3729,2785,-944
2016,2,2,12,3617,4422,3383,-1039
2016,2,2,13,3917,4806,3565,-1241
2016,2,2,14,4040,4873,3441,-1432
2016,2,2,15,4207,5008,3397,-1611
2016,2,2,16,4482,5239,3589,-1650
2016,2,2,17,4688,5466,3801,-1665
2016,2,2,18,4863,5694,3955,-1739
2016,2,2,19,4997,5893,4132,-1761
2016,2,2,20,5167,6068,4248,-1820
2016,2,2,21,5205,6167,4250,-1917
2016,2,2,22,5221,6230,4281,-1949
2016,2,2,23,5252,6219,4342,-1877
2016,2,3,0,5367,6421,4470,-1951
2016,2,3,1,5253,6439,4497,-1942
2016,2,3,2,4997,6135,4259,-1876
2016,2,3,3,4576,5598,3988,-1610
2016,2,3,4,4102,5033,3662,-1371
2016,2,3,5,3634,4400,3208,-1192
2016,2,3,6,3228,3952,2974,-978
2016,2,3,7,3034,3674,2742,-932
2016,2,3,8,2849,3551,2647,-904
2016,2,3,9,2826,3478,2582,-896
2016,2,3,10,2882,3531,2600,-931
2016,2,3,11,3133,3884,2885,-999
2016,2,3,12,3690,4575,3292,-1283
2016,2,3,13,3994,4949,3581,-1368
2016,2,3,14,4115,5105,3628,-1477
2016,2,3,15,4322,5375,3702,-1673
2016,2,3,16,4657,5698,3925,-1773
2016,2,3,17,4773,5985,4143,-1842
2016,2,3,18,4922,6222,4341,-1881
2016,2,3,19,4982,6422,4483,-1939
2016,2,3,20,5129,6538,4600,-1938
2016,2,3,21,5179,6615,4685,-1930
2016,2,3,22,5188,6654,4697,-1957
2016,2,3,23,5145,6573,4600,-1973
2016,2,4,0,5201,6726,4694,-2032
2016,2,4,1,5104,6652,4670,-1982
2016,2,4,2,4891,6311,4383,-1928
2016,2,4,3,4524,5796,4107,-1689
2016,2,4,4,4084,5220,3742,-1478
2016,2,4,5,3645,4563,3302,-1261
2016,2,4,6,3265,4096,3055,-1041
2016,2,4,7,3025,3791,2827,-964
2016,2,4,8,2878,3615,2690,-925
2016,2,4,9,2859,3529,2621,-908
2016,2,4,10,2902,3585,2665,-920
2016,2,4,11,3166,3931,2917,-1014
2016,2,4,12,3689,4592,3345,-1247
2016,2,4,13,4001,4953,3637,-1316
2016,2,4,14,4093,5085,3777,-1308
2016,2,4,15,4222,5335,3976,-1359
2016,2,4,16,4339,5559,4143,-1416
2016,2,4,17,4417,5735,4315,-1420
2016,2,4,18,4446,5845,4359,-1486
2016,2,4,19,4437,5864,4402,-1462
2016,2,4,20,4389,5826,4393,-1433
2016,2,4,21,4301,5766,4345,-1421
2016,2,4,22,4249,5797,4329,-1468
2016,2,4,23,4319,6235,4702,-1533
2016,2,5,0,4493,6157,4568,-1589
2016,2,5,1,4457,6025,4477,-1548
2016,2,5,2,4270,5706,4205,-1501
2016,2,5,3,3944,5212,3814,-1398
2016,2,5,4,3651,4724,3387,-1337
2016,2,5,5,3424,4201,2951,-1250
2016,2,5,6,3123,3842,2805,-1037
2016,2,5,7,3083,3692,2672,-1020
2016,2,5,8,3129,3655,2638,-1017
2016,2,5,9,3256,3743,2674,-1069
2016,2,5,10,3421,3981,2834,-1147
2016,2,5,11,3910,4608,3156,-1452
2016,2,5,12,4669,5684,3861,-1823
2016,2,5,13,5171,6437,4522,-1915
2016,2,5,14,5188,6639,4720,-1919
2016,2,5,15,5044,6491,4675,-1816
2016,2,5,16,4789,6260,4527,-1733
2016,2,5,17,4644,5933,4342,-1591
2016,2,5,18,4483,5607,4175,-1432
2016,2,5,19,4382,5355,4046,-1309
2016,2,5,20,4311,5159,3918,-1241
2016,2,5,21,4266,5085,3814,-1271
2016,2,5,22,4243,5128,3847,-1281
2016,2,5,23,4451,5363,4042,-1320
2016,2,6,0,4787,5956,4333,-1623
2016,2,6,1,4960,6203,4494,-1709
2016,2,6,2,4922,6276,4534,-1742
2016,2,6,3,4742,6164,4433,-1731
2016,2,6,4,4620,5937,4250,-1687
2016,2,6,5,4300,5624,3992,-1632
2016,2,6,6,4149,5373,3921,-1452
2016,2,6,7,4087,5259,3815,-1444
2016,2,6,8,4029,5223,3771,-1452
2016,2,6,9,4050,5263,3795,-1468
2016,2,6,10,4163,5347,3843,-1504
2016,2,6,11,4422,5538,3917,-1621
2016,2,6,12,4718,5930,4167,-1763
2016,2,6,13,5070,6355,4491,-1864
2016,2,6,14,5383,6597,4677,-1920
2016,2,6,15,5228,6425,4602,-1823
2016,2,6,16,4901,6156,4448,-1708
2016,2,6,17,4577,5972,4310,-1662
2016,2,6,18,4325,5907,4269,-1638
2016,2,6,19,4097,5820,4205,-1615
2016,2,6,20,3925,5823,4278,-1545
2016,2,6,21,3817,5858,4347,-1511
2016,2,6,22,3796,5978,4434,-1544
2016,2,6,23,4030,6181,4558,-1623
2016,2,7,0,4306,6450,4686,-1764
2016,2,7,1,4464,6430,4620,-1810
2016,2,7,2,4450,6297,4504,-1793
2016,2,7,3,4347,6051,4318,-1733
2016,2,7,4,4280,5800,4108,-1692
2016,2,7,5,4119,5470,3866,-1604
2016,2,7,6,4128,5228,3666,-1562
2016,2,7,7,4103,5127,3615,-1511
2016,2,7,8,4052,5152,3630,-1521
2016,2,7,9,4204,5211,3675,-1536
2016,2,7,10,4302,5437,3802,-1635
2016,2,7,11,4504,5704,4110,-1594
2016,2,7,12,4851,6125,4501,-1624
2016,2,7,13,5227,6739,5094,-1645
2016,2,7,14,5505,7346,5533,-1813
2016,2,7,15,5441,7473,5710,-1763
2016,2,7,16,5116,7379,5776,-1603
2016,2,7,17,4875,6887,5292,-1595
2016,2,7,18,4648,6456,4821,-1635
2016,2,7,19,4408,6046,4497,-1549
2016,2,7,20,4333,5765,4287,-1478
2016,2,7,21,4302,5598,4067,-1531
2016,2,7,22,4232,5638,3980,-1658
2016,2,7,23,4521,5905,4026,-1878
2016,2,8,0,5035,6469,4513,-1956
2016,2,8,1,5331,6671,4705,-1966
2016,2,8,2,5517,6770,4834,-1936
2016,2,8,3,5341,6742,4745,-1997
2016,2,8,4,5208,6561,4514,-2047
2016,2,8,5,4826,6338,4324,-2014
2016,2,8,6,4562,6080,4192,-1888
2016,2,8,7,4476,6058,4140,-1918
2016,2,8,8,4484,6193,4219,-1974
2016,2,8,9,4553,6388,4436,-1952
2016,2,8,10,4790,6757,4695,-2062
2016,2,8,11,5347,7538,5463,-2075
2016,2,8,12,6090,8574,6569,-2005
2016,2,8,13,6446,9045,7134,-1911
2016,2,8,14,6205,8646,6739,-1907
2016,2,8,15,5693,7669,5844,-1825
2016,2,8,16,5276,6844,4978,-1866
2016,2,8,17,4919,6228,4516,-1712
2016,2,8,18,4604,5818,4242,-1576
2016,2,8,19,4412,5530,4121,-1409
2016,2,8,20,4246,5318,4036,-1282
2016,2,8,21,4136,5192,3984,-1208
2016,2,8,22,4176,5271,4031,-1240
2016,2,8,23,4289,5573,4194,-1379
2016,2,9,0,4772,6219,4596,-1623
2016,2,9,1,4978,6431,4840,-1591
2016,2,9,2,4960,6241,4623,-1618
2016,2,9,3,4693,5845,4354,-1491
2016,2,9,4,4425,5362,3972,-1390
2016,2,9,5,4018,4902,3660,-1242
2016,2,9,6,4110,4651,3519,-1132
2016,2,9,7,4054,4564,3413,-1151
2016,2,9,8,4120,4589,3405,-1184
2016,2,9,9,4239,4732,3439,-1293
2016,2,9,10,4411,5021,3484,-1537
2016,2,9,11,4869,5676,3968,-1708
2016,2,9,12,5572,6728,4801,-1927
2016,2,9,13,5955,7220,5337,-1883
2016,2,9,14,5836,7069,5196,-1873
2016,2,9,15,5578,6804,4936,-1868
2016,2,9,16,5350,6584,4765,-1819
2016,2,9,17,5080,6300,4510,-1790
2016,2,9,18,4849,6096,4277,-1819
2016,2,9,19,4789,5833,4136,-1697
2016,2,9,20,4629,5591,4024,-1567
2016,2,9,21,4607,5553,3965,-1588
2016,2,9,22,4666,5687,3961,-1726
2016,2,9,23,5043,6081,4255,-1826
2016,2,10,0,5581,6861,4973,-1888
2016,2,10,1,5922,7145,5266,-1879
2016,2,10,2,5971,7087,5261,-1826
2016,2,10,3,5730,6731,4964,-1767
2016,2,10,4,5426,6299,4609,-1690
2016,2,10,5,5092,5820,4146,-1674
2016,2,10,6,4353,5601,4038,-1563
2016,2,10,7,4274,5547,3949,-1598
2016,2,10,8,4349,5619,3957,-1662
2016,2,10,9,4498,5789,4036,-1753
2016,2,10,10,4708,6136,4218,-1918
2016,2,10,11,5322,6928,4949,-1979
2016,2,10,12,6164,8031,6021,-2010
2016,2,10,13,6581,8652,6626,-2026
2016,2,10,14,6350,8197,6421,-1776
2016,2,10,15,6119,7512,5761,-1751
2016,2,10,16,5626,7067,5224,-1843
2016,2,10,17,5340,6616,4767,-1849
2016,2,10,18,5051,6264,4309,-1955
2016,2,10,19,4837,5929,4057,-1872
2016,2,10,20,4669,5744,4000,-1744
2016,2,10,21,4673,5630,3919,-1711
2016,2,10,22,4812,5822,3907,-1915
2016,2,10,23,5010,6344,4292,-2052
2016,2,11,0,5672,7303,5081,-2222
2016,2,11,1,5971,7780,5599,-2181
2016,2,11,2,6065,7928,5706,-2222
2016,2,11,3,5886,7783,5572,-2211
2016,2,11,4,5803,7408,5206,-2202
2016,2,11,5,5517,7033,4947,-2086
2016,2,11,6,5086,6872,4719,-2153
2016,2,11,7,5061,6920,4863,-2057
2016,2,11,8,5197,7051,5007,-2044
2016,2,11,9,5276,7231,5068,-2163
2016,2,11,10,5540,7642,5491,-2151
2016,2,11,11,6107,8394,6327,-2067
2016,2,11,12,6963,9437,7294,-2143
2016,2,11,13,7277,9821,7673,-2148
2016,2,11,14,6951,9140,7097,-2043
2016,2,11,15,6264,8068,6113,-1955
2016,2,11,16,5735,7124,5247,-1877
2016,2,11,17,5314,6285,4438,-1847
2016,2,11,18,4922,5760,4174,-1586
2016,2,11,19,4617,5405,4039,-1366
2016,2,11,20,4440,5147,3970,-1177
2016,2,11,21,4333,5046,3961,-1085
2016,2,11,22,4289,5074,3968,-1106
2016,2,11,23,4532,5263,4013,-1250
2016,2,12,0,4925,5810,4301,-1509
2016,2,12,1,5215,6130,4546,-1584
2016,2,12,2,5173,6129,4520,-1609
2016,2,12,3,4994,5930,4358,-1572
2016,2,12,4,4786,5618,4130,-1488
2016,2,12,5,4391,5227,3824,-1403
2016,2,12,6,4059,5008,3650,-1358
2016,2,12,7,3966,4928,3648,-1280
2016,2,12,8,3989,4959,3662,-1297
2016,2,12,9,4070,5052,3648,-1404
2016,2,12,10,4265,5290,3812,-1478
2016,2,12,11,4704,5906,4311,-1595
2016,2,12,12,5504,6807,5067,-1740
2016,2,12,13,5779,7144,5292,-1852
2016,2,12,14,5547,6734,4998,-1736
2016,2,12,15,5057,6113,4567,-1546
2016,2,12,16,4699,5654,4201,-1453
2016,2,12,17,4437,5316,3932,-1384
2016,2,12,18,4244,5135,3806,-1329
2016,2,12,19,4144,5042,3753,-1289
2016,2,12,20,4055,4991,3752,-1239
2016,2,12,21,4049,4962,3796,-1166
2016,2,12,22,4044,4961,3802,-1159
2016,2,12,23,4061,5003,3719,-1284
2016,2,13,0,4388,5288,3848,-1440
2016,2,13,1,4481,5381,3910,-1471
2016,2,13,2,4335,5201,3779,-1422
2016,2,13,3,4075,4933,3573,-1360
2016,2,13,4,3870,4610,3370,-1240
2016,2,13,5,3591,4247,3152,-1095
2016,2,13,6,3394,3953,3052,-901
2016,2,13,7,3286,3778,2913,-865
2016,2,13,8,3311,3730,2881,-849
2016,2,13,9,3312,3733,2861,-872
2016,2,13,10,3361,3793,2886,-907
2016,2,13,11,3516,4001,2998,-1003
2016,2,13,12,3832,4374,3169,-1205
2016,2,13,13,4081,4815,3437,-1378
2016,2,13,14,4285,5210,3722,-1488
2016,2,13,15,4411,5346,3857,-1489
2016,2,13,16,4317,5310,3853,-1457
2016,2,13,17,4221,5169,3776,-1393
2016,2,13,18,4132,5030,3680,-1350
2016,2,13,19,4009,4875,3626,-1249
2016,2,13,20,3928,4775,3572,-1203
2016,2,13,21,3904,4723,3534,-1189
2016,2,13,22,3943,4742,3540,-1202
2016,2,13,23,4048,4864,3630,-1234
2016,2,14,0,4267,5230,3818,-1412
2016,2,14,1,4394,5406,3958,-1448
2016,2,14,2,4302,5363,3898,-1465
2016,2,14,3,4173,5250,3800,-1450
2016,2,14,4,4032,5099,3653,-1446
2016,2,14,5,4018,4929,3523,-1406
2016,2,14,6,3883,4782,3449,-1333
2016,2,14,7,3812,4771,3425,-1346
2016,2,14,8,3760,4832,3486,-1346
2016,2,14,9,3889,5000,3567,-1433
2016,2,14,10,3998,5226,3675,-1551
2016,2,14,11,4221,5609,3928,-1681
2016,2,14,12,4576,6169,4438,-1731
2016,2,14,13,5034,6784,4906,-1878
2016,2,14,14,5197,7055,5146,-1909
2016,2,14,15,5035,6728,4925,-1803
2016,2,14,16,4794,6129,4483,-1646
2016,2,14,17,4474,5596,4100,-1496
2016,2,14,18,4220,5225,3858,-1367
2016,2,14,19,4043,4967,3802,-1165
2016,2,14,20,3908,4815,3690,-1125
2016,2,14,21,3862,4716,3626,-1090
2016,2,14,22,3971,4720,3617,-1103
2016,2,14,23,4012,4866,3703,-1163
2016,2,15,0,4278,5246,3844,-1402
2016,2,15,1,4471,5419,3979,-1440
2016,2,15,2,4395,5244,3845,-1399
2016,2,15,3,4132,4930,3611,-1319
2016,2,15,4,3898,4632,3367,-1265
2016,2,15,5,3625,4260,3206,-1054
2016,2,15,6,3143,3960,3088,-872
2016,2,15,7,2999,3834,2973,-861
2016,2,15,8,2991,3809,2944,-865
2016,2,15,9,3008,3872,2973,-899
2016,2,15,10,3183,4052,3111,-941
2016,2,15,11,3455,4459,3398,-1061
2016,2,15,12,3963,5093,3900,-1193
2016,2,15,13,4325,5538,4278,-1260
2016,2,15,14,4311,5708,4426,-1282
2016,2,15,15,4305,5692,4443,-1249
2016,2,15,16,4236,5677,4446,-1231
2016,2,15,17,4154,5516,4383,-1133
2016,2,15,18,4130,5409,4298,-1111
2016,2,15,19,4088,5282,4237,-1045
2016,2,15,20,4027,5170,4171,-999
2016,2,15,21,4024,5122,4103,-1019
2016,2,15,22,3989,5153,4135,-1018
2016,2,15,23,4066,5344,4248,-1096
2016,2,16,0,4424,5745,4503,-1242
2016,2,16,1,4584,5801,4593,-1208
2016,2,16,2,4354,5518,4369,-1149
2016,2,16,3,4015,5094,4059,-1035
2016,2,16,4,3682,4600,3679,-921
2016,2,16,5,3278,4092,3264,-828
2016,2,16,6,2913,3701,2889,-812
2016,2,16,7,2750,3488,2721,-767
2016,2,16,8,2679,3370,2625,-745
2016,2,16,9,2688,3326,2579,-747
2016,2,16,10,2806,3410,2628,-782
2016,2,16,11,3034,3795,2902,-893
2016,2,16,12,3583,4500,3430,-1070
2016,2,16,13,3889,4915,3800,-1115
2016,2,16,14,3963,5026,3911,-1115
2016,2,16,15,4000,5076,3990,-1086
2016,2,16,16,4096,5138,4057,-1081
2016,2,16,17,4223,5155,4082,-1073
2016,2,16,18,4278,5179,4072,-1107
2016,2,16,19,4296,5179,4126,-1053
2016,2,16,20,4316,5180,4093,-1087
2016,2,16,21,4361,5192,4112,-1080
2016,2,16,22,4359,5265,4186,-1079
2016,2,16,23,4310,5310,4188,-1122
2016,2,17,0,4597,5611,4385,-1226
2016,2,17,1,4737,5735,4482,-1253
2016,2,17,2,4473,5522,4324,-1198
2016,2,17,3,4092,5106,3985,-1121
2016,2,17,4,3770,4610,3590,-1020
2016,2,17,5,3312,4143,3213,-930
2016,2,17,6,2948,3797,2922,-875
2016,2,17,7,2799,3670,2783,-887
2016,2,17,8,2832,3692,2795,-897
2016,2,17,9,2873,3770,2832,-938
2016,2,17,10,2963,3993,2992,-1001
2016,2,17,11,3380,4562,3378,-1184
2016,2,17,12,4021,5522,4170,-1352
2016,2,17,13,4315,6011,4654,-1357
2016,2,17,14,4323,5889,4628,-1261
2016,2,17,15,4236,5569,4388,-1181
2016,2,17,16,4233,5312,4174,-1138
2016,2,17,17,4261,5159,4049,-1110
2016,2,17,18,4262,5089,3969,-1120
2016,2,17,19,4238,5034,3938,-1096
2016,2,17,20,4207,5043,3954,-1089
2016,2,17,21,4192,5085,3999,-1086
2016,2,17,22,4244,5160,4038,-1122
2016,2,17,23,4329,5254,4102,-1152
2016,2,18,0,4549,5529,4407,-1122
2016,2,18,1,4652,5690,4524,-1166
2016,2,18,2,4477,5474,4278,-1196
2016,2,18,3,4143,5110,3990,-1120
2016,2,18,4,3848,4641,3596,-1045
2016,2,18,5,3445,4189,3208,-981
2016,2,18,6,3257,3886,3001,-885
2016,2,18,7,3193,3734,2872,-862
2016,2,18,8,3227,3725,2825,-900
2016,2,18,9,3327,3827,2882,-945
2016,2,18,10,3545,4071,2944,-1127
2016,2,18,11,3994,4658,3221,-1437
2016,2,18,12,4788,5614,3984,-1630
2016,2,18,13,5161,6103,4517,-1586
2016,2,18,14,5031,5990,4354,-1636
2016,2,18,15,4744,5686,4160,-1526
2016,2,18,16,4504,5458,4040,-1418
2016,2,18,17,4336,5232,3998,-1234
2016,2,18,18,4188,5152,3988,-1164
2016,2,18,19,4094,5065,3947,-1118
2016,2,18,20,4049,5020,3922,-1098
2016,2,18,21,4007,4994,3877,-1117
2016,2,18,22,4035,5060,3888,-1172
2016,2,18,23,4144,5147,3859,-1288
2016,2,19,0,4392,5500,4061,-1439
2016,2,19,1,4554,5703,4236,-1467
2016,2,19,2,4469,5574,4135,-1439
2016,2,19,3,4195,5217,3857,-1360
2016,2,19,4,3881,4801,3501,-1300
2016,2,19,5,3543,4359,3240,-1119
2016,2,19,6,3147,4099,3040,-1059
2016,2,19,7,3006,3968,2915,-1053
2016,2,19,8,2978,3966,2900,-1066
2016,2,19,9,3006,4012,2910,-1102
2016,2,19,10,3119,4214,3052,-1162
2016,2,19,11,3525,4748,3359,-1389
2016,2,19,12,4169,5609,4084,-1525
2016,2,19,13,4432,5986,4437,-1549
2016,2,19,14,4416,5860,4306,-1554
2016,2,19,15,4345,5552,4117,-1435
2016,2,19,16,4255,5333,3988,-1345
2016,2,19,17,4198,5189,3904,-1285
2016,2,19,18,4137,5132,3879,-1253
2016,2,19,19,4118,5069,3834,-1235
2016,2,19,20,4080,5036,3807,-1229
2016,2,19,21,4053,5053,3817,-1236
2016,2,19,22,4061,5063,3812,-1251
2016,2,19,23,4104,5095,3828,-1267
2016,2,20,0,4340,5309,3971,-1338
2016,2,20,1,4428,5400,4039,-1361
2016,2,20,2,4261,5188,3878,-1310
2016,2,20,3,3979,4877,3633,-1244
2016,2,20,4,3716,4575,3309,-1266
2016,2,20,5,3529,4195,3112,-1083
2016,2,20,6,3217,3877,2879,-998
2016,2,20,7,3067,3749,2782,-967
2016,2,20,8,3053,3712,2731,-981
2016,2,20,9,3063,3774,2767,-1007
2016,2,20,10,3104,3907,2840,-1067
2016,2,20,11,3267,4153,3002,-1151
2016,2,20,12,3508,4539,3191,-1348
2016,2,20,13,3762,4986,3453,-1533
2016,2,20,14,4030,5278,3696,-1582
2016,2,20,15,4148,5254,3765,-1489
2016,2,20,16,4183,5139,3729,-1410
2016,2,20,17,4194,5053,3696,-1357
2016,2,20,18,4174,4989,3652,-1337
2016,2,20,19,4138,4955,3627,-1328
2016,2,20,20,4124,4955,3628,-1327
2016,2,20,21,4144,4995,3665,-1330
2016,2,20,22,4130,5034,3694,-1340
2016,2,20,23,4123,5035,3708,-1327
2016,2,21,0,4292,5187,3769,-1418
2016,2,21,1,4371,5241,3837,-1404
2016,2,21,2,4160,5019,3667,-1352
2016,2,21,3,3892,4670,3402,-1268
2016,2,21,4,3680,4367,3162,-1205
2016,2,21,5,3389,3972,2941,-1031
2016,2,21,6,3037,3663,2693,-970
2016,2,21,7,2949,3459,2612,-847
2016,2,21,8,2898,3402,2607,-795
2016,2,21,9,2894,3405,2602,-803
2016,2,21,10,2891,3507,2664,-843
2016,2,21,11,3035,3676,2764,-912
2016,2,21,12,3291,4026,2998,-1028
2016,2,21,13,3520,4459,3315,-1144
2016,2,21,14,3808,4842,3625,-1217
2016,2,21,15,4000,4944,3664,-1280
2016,2,21,16,4026,4930,3624,-1306
2016,2,21,17,4046,4951,3611,-1340
2016,2,21,18,4079,4988,3614,-1374
2016,2,21,19,4074,5040,3658,-1382
2016,2,21,20,4057,5061,3683,-1378
2016,2,21,21,4100,5093,3697,-1396
2016,2,21,22,4114,5153,3737,-1416
2016,2,21,23,4162,5220,3799,-1421
2016,2,22,0,4378,5444,3974,-1470
2016,2,22,1,4454,5575,4051,-1524
2016,2,22,2,4247,5289,3854,-1435
2016,2,22,3,3891,4817,3591,-1226
2016,2,22,4,3576,4353,3255,-1098
2016,2,22,5,3205,3848,2986,-862
2016,2,22,6,2968,3491,2729,-762
2016,2,22,7,2743,3298,2608,-690
2016,2,22,8,2694,3210,2586,-624
2016,2,22,9,2719,3222,2587,-635
2016,2,22,10,2814,3359,2591,-768
2016,2,22,11,3132,3804,2741,-1063
2016,2,22,12,3648,4562,3262,-1300
2016,2,22,13,3969,4975,3616,-1359
2016,2,22,14,4038,5039,3715,-1324
2016,2,22,15,4102,5072,3746,-1326
2016,2,22,16,4184,5219,3897,-1322
2016,2,22,17,4218,5312,3996,-1316
2016,2,22,18,4233,5417,4057,-1360
2016,2,22,19,4288,5499,4132,-1367
2016,2,22,20,4313,5558,4199,-1359
2016,2,22,21,4390,5643,4277,-1366
2016,2,22,22,4407,5719,4314,-1405
2016,2,22,23,4447,5771,4315,-1456
2016,2,23,0,4715,6024,4460,-1564
2016,2,23,1,4835,6145,4546,-1599
2016,2,23,2,4599,5830,4347,-1483
2016,2,23,3,4215,5318,3995,-1323
2016,2,23,4,3779,4766,3633,-1133
2016,2,23,5,3379,4184,3293,-891
2016,2,23,6,3041,3737,2917,-820
2016,2,23,7,2879,3484,2691,-793
2016,2,23,8,2757,3338,2576,-762
2016,2,23,9,2721,3295,2575,-720
2016,2,23,10,2820,3374,2623,-751
2016,2,23,11,3132,3710,2760,-950
2016,2,23,12,3638,4370,3120,-1250
2016,2,23,13,3912,4664,3380,-1284
2016,2,23,14,4040,4878,3579,-1299
2016,2,23,15,4224,5127,3823,-1304
2016,2,23,16,4431,5420,4083,-1337
2016,2,23,17,4566,5649,4294,-1355
2016,2,23,18,4707,5831,4414,-1417
2016,2,23,19,4825,5900,4422,-1478
2016,2,23,20,4925,5902,4408,-1494
2016,2,23,21,4982,5904,4380,-1524
2016,2,23,22,4989,6001,4489,-1512
2016,2,23,23,4987,6032,4522,-1510
2016,2,24,0,5038,6194,4581,-1613
2016,2,24,1,4950,6301,4676,-1625
2016,2,24,2,4801,5998,4469,-1529
2016,2,24,3,4404,5480,4153,-1327
2016,2,24,4,3993,4932,3748,-1184
2016,2,24,5,3522,4318,3396,-922
2016,2,24,6,3228,3859,3026,-833
2016,2,24,7,3002,3590,2812,-778
2016,2,24,8,2853,3442,2698,-744
2016,2,24,9,2807,3385,2671,-714
2016,2,24,10,2833,3462,2705,-757
2016,2,24,11,3102,3833,2954,-879
2016,2,24,12,3646,4499,3335,-1164
2016,2,24,13,3986,4933,3666,-1267
2016,2,24,14,4203,5151,3861,-1290
2016,2,24,15,4399,5349,3999,-1350
2016,2,24,16,4551,5570,4155,-1415
2016,2,24,17,4622,5719,4313,-1406
2016,2,24,18,4675,5864,4400,-1464
2016,2,24,19,4685,5895,4438,-1457
2016,2,24,20,4694,5810,4395,-1415
2016,2,24,21,4647,5670,4320,-1350
2016,2,24,22,4649,5584,4322,-1262
2016,2,24,23,4548,5505,4180,-1325
2016,2,25,0,4651,5646,4202,-1444
2016,2,25,1,4657,5741,4306,-1435
2016,2,25,2,4490,5490,4104,-1386
2016,2,25,3,4166,5040,3837,-1203
2016,2,25,4,3780,4534,3444,-1090
2016,2,25,5,3366,4036,3161,-875
2016,2,25,6,3037,3690,2913,-777
2016,2,25,7,2945,3526,2767,-759
2016,2,25,8,2830,3453,2704,-749
2016,2,25,9,2849,3472,2694,-778
2016,2,25,10,2907,3645,2821,-824
2016,2,25,11,3400,4148,3050,-1098
2016,2,25,12,4041,5030,3612,-1418
2016,2,25,13,4447,5492,3926,-1566
2016,2,25,14,4537,5517,4000,-1517
2016,2,25,15,4472,5462,4008,-1454
2016,2,25,16,4374,5368,3972,-1396
2016,2,25,17,4248,5208,3874,-1334
2016,2,25,18,4169,5115,3817,-1298
2016,2,25,19,4098,4982,3721,-1261
2016,2,25,20,4061,4881,3662,-1219
2016,2,25,21,4085,4841,3626,-1215
2016,2,25,22,4091,4911,3677,-1234
2016,2,25,23,4184,5065,3749,-1316
2016,2,26,0,4503,5549,4083,-1466
2016,2,26,1,4753,5901,4332,-1569
2016,2,26,2,4688,5869,4296,-1573
2016,2,26,3,4442,5576,4068,-1508
2016,2,26,4,4293,5221,3775,-1446
2016,2,26,5,3979,4779,3397,-1382
2016,2,26,6,3812,4478,3224,-1254
2016,2,26,7,3749,4379,3134,-1245
2016,2,26,8,3755,4376,3118,-1258
2016,2,26,9,3865,4454,3169,-1285
2016,2,26,10,4046,4658,3220,-1438
2016,2,26,11,4568,5211,3537,-1674
2016,2,26,12,5365,6098,4128,-1970
2016,2,26,13,5731,6482,4331,-2151
2016,2,26,14,5513,6282,4244,-2038
2016,2,26,15,5240,6018,4114,-1904
2016,2,26,16,4963,5752,3906,-1846
2016,2,26,17,4687,5481,3750,-1731
2016,2,26,18,4484,5318,3589,-1729
2016,2,26,19,4305,5102,3556,-1546
2016,2,26,20,4204,4957,3472,-1485
2016,2,26,21,4203,4895,3405,-1490
2016,2,26,22,4239,4909,3425,-1484
2016,2,26,23,4254,5063,3506,-1557
2016,2,27,0,4609,5506,3631,-1875
2016,2,27,1,4831,5876,3940,-1936
2016,2,27,2,4981,5908,3931,-1977
2016,2,27,3,4901,5838,3859,-1979
2016,2,27,4,4720,5633,3670,-1963
2016,2,27,5,4466,5399,3468,-1931
2016,2,27,6,4336,5270,3381,-1889
2016,2,27,7,4286,5249,3323,-1926
2016,2,27,8,4292,5315,3339,-1976
2016,2,27,9,4384,5498,3461,-2037
2016,2,27,10,4604,5709,3718,-1991
2016,2,27,11,4927,6114,4027,-2087
2016,2,27,12,5395,6697,4524,-2173
2016,2,27,13,5656,7359,5234,-2125
2016,2,27,14,5815,7314,5242,-2072
2016,2,27,15,5708,6812,4767,-2045
2016,2,27,16,5102,6238,4295,-1943
2016,2,27,17,4740,5718,3829,-1889
2016,2,27,18,4417,5329,3549,-1780
2016,2,27,19,4159,5023,3464,-1559
2016,2,27,20,4000,4838,3339,-1499
2016,2,27,21,3917,4741,3332,-1409
2016,2,27,22,3959,4734,3317,-1417
2016,2,27,23,4027,4849,3377,-1472
2016,2,28,0,4369,5242,3446,-1796
2016,2,28,1,4563,5570,3668,-1902
2016,2,28,2,4606,5580,3649,-1931
2016,2,28,3,4517,5522,3579,-1943
2016,2,28,4,4352,5381,3468,-1913
2016,2,28,5,4153,5188,3308,-1880
2016,2,28,6,3940,5088,3213,-1875
2016,2,28,7,3894,5048,3167,-1881
2016,2,28,8,3901,5118,3203,-1915
2016,2,28,9,3969,5235,3262,-1973
2016,2,28,10,4066,5428,3410,-2018
2016,2,28,11,4264,5723,3675,-2048
2016,2,28,12,4602,6216,4097,-2119
2016,2,28,13,4841,6761,4589,-2172
2016,2,28,14,5090,6798,4662,-2136
2016,2,28,15,4909,6274,4230,-2044
2016,2,28,16,4697,5709,3772,-1937
2016,2,28,17,4342,5287,3484,-1803
2016,2,28,18,4206,5027,3296,-1731
2016,2,28,19,4066,4856,3319,-1537
2016,2,28,20,3969,4743,3258,-1485
2016,2,28,21,3894,4738,3266,-1472
2016,2,28,22,3888,4773,3287,-1486
2016,2,28,23,4045,4897,3371,-1526
2016,2,29,0,4247,5196,3456,-1740
2016,2,29,1,4363,5498,3652,-1846
2016,2,29,2,4234,5298,3499,-1799
2016,2,29,3,3932,4932,3226,-1706
2016,2,29,4,3620,4517,3017,-1500
2016,2,29,5,3259,4131,2874,-1257
2016,2,29,6,3030,3890,2797,-1093
2016,2,29,7,2889,3740,2672,-1068
2016,2,29,8,2867,3733,2645,-1088
2016,2,29,9,2825,3798,2694,-1104
2016,2,29,10,2967,4020,2830,-1190
2016,2,29,11,3337,4571,3312,-1259
2016,2,29,12,3998,5436,3935,-1501
2016,2,29,13,4277,5887,4364,-1523
2016,2,29,14,4224,5725,4264,-1461
2016,2,29,15,4221,5420,3967,-1453
2016,2,29,16,4198,5251,3885,-1366
2016,2,29,17,4275,5151,3840,-1311
2016,2,29,18,4228,5164,3837,-1327
2016,2,29,19,4220,5140,3859,-1281
2016,2,29,20,4205,5135,3870,-1265
2016,2,29,21,4265,5186,3899,-1287
2016,2,29,22,4255,5275,3971,-1304
2016,2,29,23,4258,5365,4010,-1355
2016,3,1,0,4466,5588,4113,-1475
2016,3,1,1,4648,5818,4311,-1507
2016,3,1,2,4411,5547,4209,-1338
2016,3,1,3,4007,5059,3787,-1272
2016,3,1,4,3679,4557,3373,-1184
2016,3,1,5,3259,4070,2993,-1077
2016,3,1,6,2966,3742,2817,-925
2016,3,1,7,2785,3568,2678,-890
2016,3,1,8,2757,3560,2635,-925
2016,3,1,9,2728,3598,2638,-960
2016,3,1,10,2927,3813,2782,-1031
2016,3,1,11,3219,4327,3151,-1176
2016,3,1,12,3820,5206,3683,-1523
2016,3,1,13,4091,5571,3901,-1670
2016,3,1,14,4117,5417,3694,-1723
2016,3,1,15,4091,5246,3600,-1646
2016,3,1,16,4144,5184,3570,-1614
2016,3,1,17,4210,5173,3560,-1613
2016,3,1,18,4210,5242,3621,-1621
2016,3,1,19,4255,5363,3741,-1622
2016,3,1,20,4267,5459,3809,-1650
2016,3,1,21,4363,5584,3905,-1679
2016,3,1,22,4332,5666,3966,-1700
2016,3,1,23,4319,5693,4011,-1682
2016,3,2,0,4536,5869,4146,-1723
2016,3,2,1,4824,6037,4356,-1681
2016,3,2,2,4565,5745,4137,-1608
2016,3,2,3,4150,5210,3657,-1553
2016,3,2,4,3687,4700,3359,-1341
2016,3,2,5,3296,4123,3152,-971
2016,3,2,6,3022,3716,2842,-874
2016,3,2,7,2794,3473,2643,-830
2016,3,2,8,2701,3352,2540,-812
2016,3,2,9,2682,3308,2489,-819
2016,3,2,10,2750,3400,2569,-831
2016,3,2,11,2968,3741,2808,-933
2016,3,2,12,3465,4438,3238,-1200
2016,3,2,13,3761,4701,3505,-1196
2016,3,2,14,3960,4815,3591,-1224
2016,3,2,15,4034,4989,3732,-1257
2016,3,2,16,4188,5203,3914,-1289
2016,3,2,17,4311,5360,4054,-1306
2016,3,2,18,4325,5507,4136,-1371
2016,3,2,19,4467,5612,4244,-1368
2016,3,2,20,4477,5709,4367,-1342
2016,3,2,21,4509,5716,4379,-1337
2016,3,2,22,4533,5720,4382,-1338
2016,3,2,23,4378,5711,4330,-1381
2016,3,3,0,4498,5837,4405,-1432
2016,3,3,1,4679,5954,4506,-1448
2016,3,3,2,4410,5669,4289,-1380
2016,3,3,3,4022,5195,3917,-1278
2016,3,3,4,3679,4637,3452,-1185
2016,3,3,5,3278,4075,3117,-958
2016,3,3,6,2875,3720,2940,-780
2016,3,3,7,2733,3521,2784,-737
2016,3,3,8,2678,3453,2718,-735
2016,3,3,9,2690,3473,2699,-774
2016,3,3,10,2813,3629,2805,-824
2016,3,3,11,3249,4117,2999,-1118
2016,3,3,12,3921,4955,3592,-1363
2016,3,3,13,4194,5341,3966,-1375
2016,3,3,14,4102,5337,4018,-1319
2016,3,3,15,4057,5260,3975,-1285
2016,3,3,16,4087,5172,3860,-1312
2016,3,3,17,4132,5161,3866,-1295
2016,3,3,18,4205,5221,3928,-1293
2016,3,3,19,4221,5274,3975,-1299
2016,3,3,20,4249,5336,4037,-1299
2016,3,3,21,4328,5395,4065,-1330
2016,3,3,22,4377,5406,4086,-1320
2016,3,3,23,4367,5430,4100,-1330
2016,3,4,0,4499,5652,4245,-1407
2016,3,4,1,4710,5841,4366,-1475
2016,3,4,2,4516,5626,4228,-1398
2016,3,4,3,4136,5158,3868,-1290
2016,3,4,4,3696,4661,3463,-1198
2016,3,4,5,3255,4143,3180,-963
2016,3,4,6,3032,3731,2932,-799
2016,3,4,7,2835,3507,2749,-758
2016,3,4,8,2703,3407,2668,-739
2016,3,4,9,2633,3382,2656,-726
2016,3,4,10,2640,3466,2712,-754
2016,3,4,11,2969,3815,2940,-875
2016,3,4,12,3494,4471,3339,-1132
2016,3,4,13,3818,4803,3498,-1305
2016,3,4,14,3915,4996,3674,-1322
2016,3,4,15,4019,5151,3820,-1331
2016,3,4,16,4116,5306,3953,-1353
2016,3,4,17,4236,5383,4023,-1360
2016,3,4,18,4313,5435,4066,-1369
2016,3,4,19,4386,5458,4095,-1363
2016,3,4,20,4390,5510,4135,-1375
2016,3,4,21,4394,5528,4152,-1376
2016,3,4,22,4377,5523,4210,-1313
2016,3,4,23,4277,5464,4097,-1367
2016,3,5,0,4338,5452,4077,-1375
2016,3,5,1,4514,5545,4120,-1425
2016,3,5,2,4241,5302,3937,-1365
2016,3,5,3,3930,5008,3661,-1347
2016,3,5,4,3614,4652,3379,-1273
2016,3,5,5,3285,4223,3118,-1105
2016,3,5,6,3091,3913,2869,-1044
2016,3,5,7,2887,3721,2691,-1030
2016,3,5,8,2821,3657,2629,-1028
2016,3,5,9,2786,3699,2638,-1061
2016,3,5,10,2776,3805,2700,-1105
2016,3,5,11,2914,4032,2860,-1172
2016,3,5,12,3124,4452,3189,-1263
2016,3,5,13,3432,4918,3521,-1397
2016,3,5,14,3688,5267,3763,-1504
2016,3,5,15,3804,5270,3859,-1411
2016,3,5,16,3855,5149,3766,-1383
2016,3,5,17,3911,5026,3661,-1365
2016,3,5,18,3978,4960,3630,-1330
2016,3,5,19,3971,4903,3592,-1311
2016,3,5,20,3985,4879,3559,-1320
2016,3,5,21,4007,4896,3573,-1323
2016,3,5,22,4059,4942,3628,-1314
2016,3,5,23,4078,4970,3664,-1306
2016,3,6,0,4090,5099,3732,-1367
2016,3,6,1,4263,5283,3871,-1412
2016,3,6,2,4081,5071,3703,-1368
2016,3,6,3,3690,4783,3473,-1310
2016,3,6,4,3439,4458,3213,-1245
2016,3,6,5,3225,4084,2999,-1085
2016,3,6,6,2862,3805,2771,-1034
2016,3,6,7,2734,3618,2617,-1001
2016,3,6,8,2720,3567,2553,-1014
2016,3,6,9,2711,3570,2532,-1038
2016,3,6,10,2744,3684,2621,-1063
2016,3,6,11,2944,3888,2759,-1129
2016,3,6,12,3151,4246,3011,-1235
2016,3,6,13,3409,4689,3342,-1347
2016,3,6,14,3679,5038,3534,-1504
2016,3,6,15,3838,5123,3653,-1470
2016,3,6,16,3895,5022,3639,-1383
2016,3,6,17,3942,4921,3589,-1332
2016,3,6,18,4000,4877,3564,-1313
2016,3,6,19,3997,4863,3553,-1310
2016,3,6,20,3953,4885,3578,-1307
2016,3,6,21,4013,4931,3603,-1328
2016,3,6,22,4029,5016,3686,-1330
2016,3,6,23,3985,5085,3739,-1346
2016,3,7,0,4127,5266,3848,-1418
2016,3,7,1,4309,5518,4046,-1472
2016,3,7,2,4149,5276,3852,-1424
2016,3,7,3,3816,4837,3514,-1323
2016,3,7,4,3483,4407,3165,-1242
2016,3,7,5,3080,3941,2919,-1022
2016,3,7,6,2896,3655,2672,-983
2016,3,7,7,2803,3561,2576,-985
2016,3,7,8,2729,3550,2553,-997
2016,3,7,9,2701,3634,2601,-1033
2016,3,7,10,2859,3859,2740,-1119
2016,3,7,11,3238,4404,3111,-1293
2016,3,7,12,3805,5277,3579,-1698
2016,3,7,13,4015,5679,3824,-1855
2016,3,7,14,4096,5495,3714,-1781
2016,3,7,15,4073,5156,3414,-1742
2016,3,7,16,4118,5198,3490,-1708
2016,3,7,17,4163,5205,3511,-1694
2016,3,7,18,4199,5217,3524,-1693
2016,3,7,19,4187,5245,3548,-1697
2016,3,7,20,4160,5336,3625,-1711
2016,3,7,21,4210,5454,3702,-1752
2016,3,7,22,4208,5551,3731,-1820
2016,3,7,23,4270,5581,3781,-1800
2016,3,8,0,4427,5703,3774,-1929
2016,3,8,1,4647,5934,3925,-2009
2016,3,8,2,4432,5623,3808,-1815
2016,3,8,3,4082,5164,3672,-1492
2016,3,8,4,3706,4633,3431,-1202
2016,3,8,5,3276,4094,3091,-1003
2016,3,8,6,2948,3684,2734,-950
2016,3,8,7,2745,3463,2568,-895
2016,3,8,8,2691,3382,2492,-890
2016,3,8,9,2657,3363,2474,-889
2016,3,8,10,2797,3483,2550,-933
2016,3,8,11,3076,3888,2824,-1064
2016,3,8,12,3646,4602,3205,-1397
2016,3,8,13,3882,4938,3420,-1518
2016,3,8,14,3942,5011,3308,-1703
2016,3,8,15,4010,5061,3374,-1687
2016,3,8,16,4142,5186,3500,-1686
2016,3,8,17,4216,5300,3600,-1700
2016,3,8,18,4276,5417,3688,-1729
2016,3,8,19,4342,5541,3783,-1758
2016,3,8,20,4396,5661,3889,-1772
2016,3,8,21,4547,5804,3969,-1835
2016,3,8,22,4584,5925,4135,-1790
2016,3,8,23,4613,5895,4131,-1764
2016,3,9,0,4664,5950,4281,-1669
2016,3,9,1,4892,6139,4448,-1691
2016,3,9,2,4626,5853,4253,-1600
2016,3,9,3,4241,5346,3842,-1504
2016,3,9,4,3796,4812,3314,-1498
2016,3,9,5,3390,4217,2933,-1284
2016,3,9,6,2990,3802,2814,-988
2016,3,9,7,2786,3520,2608,-912
2016,3,9,8,2694,3376,2501,-875
2016,3,9,9,2630,3354,2477,-877
2016,3,9,10,2705,3428,2514,-914
2016,3,9,11,2970,3783,2775,-1008
2016,3,9,12,3504,4417,3141,-1276
2016,3,9,13,3753,4743,3440,-1303
2016,3,9,14,3879,4943,3499,-1444
2016,3,9,15,4020,5114,3449,-1665
2016,3,9,16,4209,5320,3614,-1706
2016,3,9,17,4320,5473,3734,-1739
2016,3,9,18,4525,5661,3877,-1784
2016,3,9,19,4694,5834,4019,-1815
2016,3,9,20,4816,6025,4160,-1865
2016,3,9,21,4970,6204,4280,-1924
2016,3,9,22,5042,6307,4375,-1932
2016,3,9,23,5091,6277,4401,-1876
2016,3,10,0,4948,6254,4362,-1892
2016,3,10,1,5042,6393,4477,-1916
2016,3,10,2,4792,6095,4246,-1849
2016,3,10,3,4423,5560,3777,-1783
2016,3,10,4,3982,4965,3294,-1671
2016,3,10,5,3528,4344,2974,-1370
2016,3,10,6,3121,3900,2910,-990
2016,3,10,7,2885,3604,2677,-927
2016,3,10,8,2771,3462,2569,-893
2016,3,10,9,2708,3399,2505,-894
2016,3,10,10,2756,3458,2558,-900
2016,3,10,11,3052,3808,2794,-1014
2016,3,10,12,3541,4428,3169,-1259
2016,3,10,13,3799,4741,3464,-1277
2016,3,10,14,3960,5002,3560,-1442
2016,3,10,15,4299,5288,3617,-1671
2016,3,10,16,4575,5594,3842,-1752
2016,3,10,17,4803,5870,4035,-1835
2016,3,10,18,5094,6120,4228,-1892
2016,3,10,19,5242,6423,4479,-1944
2016,3,10,20,5440,6665,4680,-1985
2016,3,10,21,5573,6883,4831,-2052
2016,3,10,22,5615,6988,4916,-2072
2016,3,10,23,5722,6872,4813,-2059
2016,3,11,0,5486,6711,4617,-2094
2016,3,11,1,5351,6805,4748,-2057
2016,3,11,2,5049,6434,4465,-1969
2016,3,11,3,4690,5806,3995,-1811
2016,3,11,4,4168,5213,3506,-1707
2016,3,11,5,3648,4568,3219,-1349
2016,3,11,6,3217,4050,3047,-1003
2016,3,11,7,2985,3722,2809,-913
2016,3,11,8,2785,3527,2639,-888
2016,3,11,9,2762,3422,2565,-857
2016,3,11,10,2803,3482,2606,-876
2016,3,11,11,3018,3808,2821,-987
2016,3,11,12,3438,4388,3149,-1239
2016,3,11,13,3722,4751,3437,-1314
2016,3,11,14,3943,5088,3597,-1491
2016,3,11,15,4207,5391,3661,-1730
2016,3,11,16,4490,5713,3880,-1833
2016,3,11,17,4699,6003,4116,-1887
2016,3,11,18,4951,6241,4230,-2011
2016,3,11,19,5240,6480,4428,-2052
2016,3,11,20,5376,6719,4617,-2102
2016,3,11,21,5485,6954,4818,-2136
2016,3,11,22,5451,6965,4841,-2124
2016,3,11,23,5229,6788,4703,-2085
2016,3,12,0,5152,6532,4473,-2059
2016,3,12,1,5179,6468,4415,-2053
2016,3,12,2,4863,6081,4113,-1968
2016,3,12,3,4408,5614,3785,-1829
2016,3,12,4,4091,5131,3404,-1727
2016,3,12,5,3611,4587,3261,-1326
2016,3,12,6,3219,4107,3027,-1080
2016,3,12,7,2965,3773,2838,-935
2016,3,12,8,2805,3549,2717,-832
2016,3,12,9,2740,3461,2640,-821
2016,3,12,10,2702,3426,2620,-806
2016,3,12,11,2824,3568,2678,-890
2016,3,12,12,3028,3757,2796,-961
2016,3,12,13,3302,4106,2940,-1166
2016,3,12,14,3686,4651,3203,-1448
2016,3,12,15,4091,5170,3429,-1741
2016,3,12,16,4402,5563,3753,-1810
2016,3,12,17,4672,5847,3964,-1883
2016,3,12,18,4817,6046,4099,-1947
2016,3,12,19,4944,6238,4253,-1985
2016,3,12,20,5050,6387,4370,-2017
2016,3,12,21,5032,6516,4511,-2005
2016,3,12,22,4908,6556,4540,-2016
2016,3,12,23,4827,6411,4423,-1988
2016,3,13,0,4817,6301,4308,-1993
2016,3,13,1,4800,6309,4300,-2009
2016,3,13,2,4553,5989,4068,-1921
2016,3,13,3,4228,5538,3722,-1816
2016,3,13,4,3895,5115,3374,-1741
2016,3,13,5,3576,4606,3225,-1381
2016,3,13,6,3257,4606,3225,-9999
2016,3,13,7,2991,3773,2838,-9999
2016,3,13,8,2909,3549,2717,-9999
2016,3,13,9,2819,3461,2640,-9999
2016,3,13,10,2736,3426,2620,-9999
2016,3,13,11,2763,3568,2678,-9999
2016,3,13,12,2827,3757,2796,-9999
2016,3,13,13,2967,4106,2940,-9999
2016,3,13,14,3327,4651,3203,-9999
2016,3,13,15,3716,5170,3429,-9999
2016,3,13,16,4126,5563,3753,-9999
2016,3,13,17,4316,5847,3964,-9999
2016,3,13,18,4543,6046,4099,-9999
2016,3,13,19,4818,6238,4253,-9999
2016,3,13,20,5022,6387,4370,-9999
2016,3,13,21,5142,6516,4511,-9999
2016,3,13,22,5323,6556,4540,-9999
2016,3,13,23,5218,6411,4423,-9999
2016,3,14,0,5173,6301,4308,-9999
2016,3,14,1,5042,6309,4300,-9999
2016,3,14,2,5045,5989,4068,-9999
2016,3,14,3,4682,5538,3722,-9999
2016,3,14,4,4262,5115,3374,-9999
2016,3,14,5,3329,4166,3080,-1086
2016,3,14,6,3042,3822,2888,-934
2016,3,14,7,2907,3621,2808,-813
2016,3,14,8,2794,3549,2750,-799
2016,3,14,9,2809,3596,2803,-793
2016,3,14,10,3025,3885,2914,-971
2016,3,14,11,3460,4477,3272,-1205
2016,3,14,12,3806,4908,3609,-1299
2016,3,14,13,3904,5028,3584,-1444
2016,3,14,14,4096,5357,3657,-1700
2016,3,14,15,4410,5800,3970,-1830
2016,3,14,16,4691,6250,4368,-1882
2016,3,14,17,4972,6649,4520,-2129
2016,3,14,18,5137,6987,4825,-2162
2016,3,14,19,5405,7275,5114,-2161
2016,3,14,20,5547,7537,5405,-2132
2016,3,14,21,5633,7726,5598,-2128
2016,3,14,22,5745,7754,5647,-2107
2016,3,14,23,5591,7539,5448,-2091
2016,3,15,0,5380,7289,5142,-2147
2016,3,15,1,5336,7270,5111,-2159
2016,3,15,2,5043,6719,4688,-2031
2016,3,15,3,4485,6084,4207,-1877
2016,3,15,4,3909,5385,3869,-1516
2016,3,15,5,3459,4725,3458,-1267
2016,3,15,6,3139,4336,3308,-1028
2016,3,15,7,2955,4075,3113,-962
2016,3,15,8,2860,3944,3010,-934
2016,3,15,9,2863,3943,3000,-943
2016,3,15,10,3071,4184,3113,-1071
2016,3,15,11,3508,4772,3526,-1246
2016,3,15,12,3823,5118,3784,-1334
2016,3,15,13,3926,5177,3883,-1294
2016,3,15,14,4177,5469,4075,-1394
2016,3,15,15,4471,5896,4389,-1507
2016,3,15,16,4718,6374,4754,-1620
2016,3,15,17,5071,6811,5094,-1717
2016,3,15,18,5239,7175,5512,-1663
2016,3,15,19,5427,7512,5786,-1726
2016,3,15,20,5522,7879,5910,-1969
2016,3,15,21,5689,8092,6087,-2005
2016,3,15,22,5746,8113,6211,-1902
2016,3,15,23,5595,7833,6024,-1809
2016,3,16,0,5350,7459,5744,-1715
2016,3,16,1,5339,7328,5696,-1632
2016,3,16,2,4945,6720,5242,-1478
2016,3,16,3,4432,6031,4598,-1433
2016,3,16,4,3902,5262,3980,-1282
2016,3,16,5,3528,4591,3425,-1166
2016,3,16,6,3199,4184,3188,-996
2016,3,16,7,2995,3942,2987,-955
2016,3,16,8,2880,3860,2924,-936
2016,3,16,9,2900,3864,2930,-934
2016,3,16,10,3100,4154,3145,-1009
2016,3,16,11,3549,4743,3514,-1229
2016,3,16,12,3829,5139,3815,-1324
2016,3,16,13,3930,5240,3918,-1322
2016,3,16,14,4171,5550,4165,-1385
2016,3,16,15,4494,5951,4510,-1441
2016,3,16,16,4847,6413,4914,-1499
2016,3,16,17,5123,6883,5160,-1723
2016,3,16,18,5503,7329,5371,-1958
2016,3,16,19,5757,7714,5720,-1994
2016,3,16,20,5962,8021,5967,-2054
2016,3,16,21,6086,8182,6195,-1987
2016,3,16,22,6083,8179,6267,-1912
2016,3,16,23,5817,7847,5955,-1892
2016,3,17,0,5528,7519,5702,-1817
2016,3,17,1,5477,7407,5636,-1771
2016,3,17,2,5042,6842,5226,-1616
2016,3,17,3,4544,6200,4668,-1532
2016,3,17,4,4010,5399,4094,-1305
2016,3,17,5,3611,4748,3691,-1057
2016,3,17,6,3274,4289,3391,-898
2016,3,17,7,3064,4046,3206,-840
2016,3,17,8,2953,3917,3091,-826
2016,3,17,9,2953,3931,3108,-823
2016,3,17,10,3153,4207,3298,-909
2016,3,17,11,3592,4779,3670,-1109
2016,3,17,12,3882,5155,3928,-1227
2016,3,17,13,4005,5271,4048,-1223
2016,3,17,14,4270,5531,4249,-1282
2016,3,17,15,4607,5940,4533,-1407
2016,3,17,16,4975,6439,4932,-1507
2016,3,17,17,5271,6871,5239,-1632
2016,3,17,18,5432,7246,5463,-1783
2016,3,17,19,5679,7500,5699,-1801
2016,3,17,20,5806,7636,5891,-1745
2016,3,17,21,5972,7585,5801,-1784
2016,3,17,22,6062,7382,5656,-1726
2016,3,17,23,5863,6965,5247,-1718
2016,3,18,0,5577,6692,4969,-1723
2016,3,18,1,5517,6633,4963,-1670
2016,3,18,2,5124,6135,4703,-1432
2016,3,18,3,4636,5555,4269,-1286
2016,3,18,4,4102,4862,3765,-1097
2016,3,18,5,3578,4329,3350,-979
2016,3,18,6,3241,3952,3136,-816
2016,3,18,7,3043,3741,2950,-791
2016,3,18,8,2934,3607,2854,-753
2016,3,18,9,2933,3619,2855,-764
2016,3,18,10,3114,3841,3024,-817
2016,3,18,11,3518,4364,3333,-1031
2016,3,18,12,3817,4770,3637,-1133
2016,3,18,13,3986,4924,3750,-1174
2016,3,18,14,4249,5217,3981,-1236
2016,3,18,15,4622,5584,4274,-1310
2016,3,18,16,4926,5867,4522,-1345
2016,3,18,17,5185,6124,4737,-1387
2016,3,18,18,5432,6418,5001,-1417
2016,3,18,19,5627,6690,5088,-1602
2016,3,18,20,5794,6881,5234,-1647
2016,3,18,21,5906,6882,5235,-1647
2016,3,18,22,5848,6736,5099,-1637
2016,3,18,23,5510,6668,4969,-1699
2016,3,19,0,5173,6375,4774,-1601
2016,3,19,1,5149,6378,4884,-1494
2016,3,19,2,4814,5999,4617,-1382
2016,3,19,3,4412,5569,4266,-1303
2016,3,19,4,3920,5029,3866,-1163
2016,3,19,5,3366,4507,3431,-1076
2016,3,19,6,3056,4145,3199,-946
2016,3,19,7,2895,3901,3010,-891
2016,3,19,8,2783,3760,2890,-870
2016,3,19,9,2769,3706,2846,-860
2016,3,19,10,2789,3746,2859,-887
2016,3,19,11,2931,3956,2933,-1023
2016,3,19,12,3197,4203,3075,-1128
2016,3,19,13,3563,4621,3251,-1370
2016,3,19,14,4005,5111,3451,-1660
2016,3,19,15,4382,5469,3728,-1741
2016,3,19,16,4656,5564,3797,-1767
2016,3,19,17,4804,5517,3772,-1745
2016,3,19,18,4927,5416,3684,-1732
2016,3,19,19,5085,5315,3593,-1722
2016,3,19,20,5225,5285,3548,-1737
2016,3,19,21,5247,5342,3578,-1764
2016,3,19,22,5180,5348,3571,-1777
2016,3,19,23,4943,5309,3531,-1778
2016,3,20,0,4783,5386,3608,-1778
2016,3,20,1,4846,5508,3695,-1813
2016,3,20,2,4523,5243,3399,-1844
2016,3,20,3,4155,4893,3232,-1661
2016,3,20,4,3713,4439,3085,-1354
2016,3,20,5,3341,4013,2933,-1080
2016,3,20,6,3025,3690,2789,-901
2016,3,20,7,2882,3487,2624,-863
2016,3,20,8,2767,3401,2559,-842
2016,3,20,9,2727,3374,2528,-846
2016,3,20,10,2724,3441,2584,-857
2016,3,20,11,2811,3623,2724,-899
2016,3,20,12,3067,3937,2856,-1081
2016,3,20,13,3432,4290,2953,-1337
2016,3,20,14,3782,4734,3095,-1639
2016,3,20,15,3986,5101,3379,-1722
2016,3,20,16,4117,5419,3635,-1784
2016,3,20,17,4217,5718,3892,-1826
2016,3,20,18,4285,5996,4112,-1884
2016,3,20,19,4278,6187,4238,-1949
2016,3,20,20,4264,6280,4317,-1963
2016,3,20,21,4288,6310,4333,-1977
2016,3,20,22,4235,6285,4284,-2001
2016,3,20,23,4113,6035,4123,-1912
2016,3,21,0,4116,5864,3991,-1873
2016,3,21,1,4189,5871,3982,-1889
2016,3,21,2,3890,5401,3672,-1729
2016,3,21,3,3622,4879,3242,-1637
2016,3,21,4,3271,4278,2974,-1304
2016,3,21,5,2976,3822,2682,-1140
2016,3,21,6,2829,3497,2521,-976
2016,3,21,7,2821,3323,2387,-936
2016,3,21,8,2871,3273,2322,-951
2016,3,21,9,3061,3331,2351,-980
2016,3,21,10,3498,3647,2554,-1093
2016,3,21,11,4066,4208,2957,-1251
2016,3,21,12,4508,4730,3365,-1365
2016,3,21,13,4557,5043,3586,-1457
2016,3,21,14,4515,5257,3786,-1471
2016,3,21,15,4465,5365,3906,-1459
2016,3,21,16,4391,5353,3955,-1398
2016,3,21,17,4297,5259,3894,-1365
2016,3,21,18,4230,5139,3856,-1283
2016,3,21,19,4247,5019,3741,-1278
2016,3,21,20,4249,4949,3677,-1272
2016,3,21,21,4276,4974,3689,-1285
2016,3,21,22,4429,5054,3712,-1342
2016,3,21,23,4497,5123,3753,-1370
2016,3,22,0,4629,5280,3885,-1395
2016,3,22,1,4927,5582,4101,-1481
2016,3,22,2,4739,5338,3877,-1461
2016,3,22,3,4447,4944,3560,-1384
2016,3,22,4,4042,4529,3261,-1268
2016,3,22,5,3593,4202,2961,-1241
2016,3,22,6,3435,4062,2824,-1238
2016,3,22,7,3424,4053,2801,-1252
2016,3,22,8,3403,4125,2841,-1284
2016,3,22,9,3567,4342,2964,-1378
2016,3,22,10,3972,4823,3306,-1517
2016,3,22,11,4687,5626,3880,-1746
2016,3,22,12,4917,6176,4368,-1808
2016,3,22,13,4849,6258,4548,-1710
2016,3,22,14,4644,5897,4243,-1654
2016,3,22,15,4408,5572,4041,-1531
2016,3,22,16,4226,5293,3899,-1394
2016,3,22,17,4093,5127,3776,-1351
2016,3,22,18,4097,5015,3715,-1300
2016,3,22,19,4077,4971,3687,-1284
2016,3,22,20,4125,4978,3686,-1292
2016,3,22,21,4154,5089,3754,-1335
2016,3,22,22,4129,5226,3844,-1382
2016,3,22,23,4156,5253,3890,-1363
2016,3,23,0,4266,5258,3868,-1390
2016,3,23,1,4366,5456,4014,-1442
2016,3,23,2,4177,5133,3768,-1365
2016,3,23,3,3839,4700,3408,-1292
2016,3,23,4,3506,4186,3021,-1165
2016,3,23,5,3006,3812,2782,-1030
2016,3,23,6,2861,3620,2684,-936
2016,3,23,7,2820,3553,2612,-941
2016,3,23,8,2843,3564,2603,-961
2016,3,23,9,2941,3726,2703,-1023
2016,3,23,10,3258,4133,2873,-1260
2016,3,23,11,3533,4778,3303,-1475
2016,3,23,12,3902,5220,3646,-1574
2016,3,23,13,4030,5323,3752,-1571
2016,3,23,14,4050,5218,3747,-1471
2016,3,23,15,4075,5150,3775,-1375
2016,3,23,16,4105,5122,3780,-1342
2016,3,23,17,4168,5156,3828,-1328
2016,3,23,18,4194,5244,3907,-1337
2016,3,23,19,4274,5386,4048,-1338
2016,3,23,20,4358,5554,4169,-1385
2016,3,23,21,4514,5821,4320,-1501
2016,3,23,22,4570,5986,4447,-1539
2016,3,23,23,4633,5957,4461,-1496
2016,3,24,0,4530,5808,4344,-1464
2016,3,24,1,4605,5894,4378,-1516
2016,3,24,2,4281,5489,4104,-1385
2016,3,24,3,3871,4977,3654,-1323
2016,3,24,4,3402,4366,3206,-1160
2016,3,24,5,2994,3883,2869,-1014
2016,3,24,6,2755,3583,2703,-880
2016,3,24,7,2638,3396,2560,-836
2016,3,24,8,2611,3347,2497,-850
2016,3,24,9,2642,3406,2525,-881
2016,3,24,10,2879,3685,2662,-1023
2016,3,24,11,3292,4210,2964,-1246
2016,3,24,12,3585,4554,3241,-1313
2016,3,24,13,3753,4726,3280,-1446
2016,3,24,14,3924,4911,3280,-1631
2016,3,24,15,4106,5129,3439,-1690
2016,3,24,16,4299,5344,3653,-1691
2016,3,24,17,4530,5590,3822,-1768
2016,3,24,18,4747,5804,3881,-1923
2016,3,24,19,5050,6003,4069,-1934
2016,3,24,20,5303,6262,4218,-2044
2016,3,24,21,5418,6530,4427,-2103
2016,3,24,22,5578,6631,4471,-2160
2016,3,24,23,5527,6562,4411,-2151
2016,3,25,0,5333,6456,4411,-2045
2016,3,25,1,5347,6416,4414,-2002
2016,3,25,2,4975,5945,4042,-1903
2016,3,25,3,4487,5451,3673,-1778
2016,3,25,4,3956,4846,3382,-1464
2016,3,25,5,3506,4300,3061,-1239
2016,3,25,6,3239,3830,2742,-1088
2016,3,25,7,3054,3562,2596,-966
2016,3,25,8,2982,3443,2509,-934
2016,3,25,9,2998,3434,2479,-955
2016,3,25,10,3173,3603,2533,-1070
2016,3,25,11,3464,3966,2771,-1195
2016,3,25,12,3817,4290,2945,-1345
2016,3,25,13,4154,4584,3044,-1540
2016,3,25,14,4540,4988,3354,-1634
2016,3,25,15,4848,5285,3575,-1710
2016,3,25,16,5091,5485,3756,-1729
2016,3,25,17,5275,5602,3843,-1759
2016,3,25,18,5509,5681,3870,-1811
2016,3,25,19,5720,5727,3941,-1786
2016,3,25,20,5942,5575,3819,-1756
2016,3,25,21,6115,5490,3713,-1777
2016,3,25,22,6148,5515,3679,-1836
2016,3,25,23,5856,0,3679,-1840
2016,3,26,0,5534,5446,3605,-1841
2016,3,26,1,5532,5549,3693,-1856
2016,3,26,2,5196,5287,3530,-1757
2016,3,26,3,4782,4962,3281,-1681
2016,3,26,4,4317,4534,3148,-1386
2016,3,26,5,3481,4091,2907,-1184
2016,3,26,6,3200,3746,2753,-993
2016,3,26,7,3022,3558,2602,-956
2016,3,26,8,2926,3471,2545,-926
2016,3,26,9,2911,3455,2497,-958
2016,3,26,10,2979,3541,2568,-973
2016,3,26,11,3121,3755,2730,-1025
2016,3,26,12,3375,4055,2796,-1259
2016,3,26,13,3736,4500,2947,-1553
2016,3,26,14,4200,5038,3292,-1746
2016,3,26,15,4599,5444,3630,-1814
2016,3,26,16,4886,5846,3946,-1900
2016,3,26,17,5180,6288,4346,-1942
2016,3,26,18,5361,6657,4662,-1995
2016,3,26,19,5484,6944,4950,-1994
2016,3,26,20,5493,7113,5098,-2015
2016,3,26,21,5519,7159,5145,-2014
2016,3,26,22,5547,7047,5063,-1984
2016,3,26,23,5415,6714,4803,-1911
2016,3,27,0,5239,6465,4520,-1945
2016,3,27,1,5153,6365,4418,-1947
2016,3,27,2,4820,5977,4101,-1876
2016,3,27,3,4506,5549,3767,-1782
2016,3,27,4,4016,4996,3495,-1501
2016,3,27,5,3460,4470,3206,-1264
2016,3,27,6,3165,4077,2979,-1098
2016,3,27,7,2999,3845,2853,-992
2016,3,27,8,2893,3728,2764,-964
2016,3,27,9,2843,3681,2722,-959
2016,3,27,10,2869,3769,2770,-999
2016,3,27,11,2982,3963,2901,-1062
2016,3,27,12,3236,4260,2998,-1262
2016,3,27,13,3657,4753,3166,-1587
2016,3,27,14,4188,5399,3558,-1841
2016,3,27,15,4620,5950,3998,-1952
2016,3,27,16,4976,6441,4395,-2046
2016,3,27,17,5243,6874,4565,-2309
2016,3,27,18,5446,7200,4950,-2250
2016,3,27,19,5610,7382,5204,-2178
2016,3,27,20,5703,7452,5297,-2155
2016,3,27,21,5743,7444,5389,-2055
2016,3,27,22,5679,7228,5242,-1986
2016,3,27,23,5570,7034,5023,-2011
2016,3,28,0,5361,6898,5034,-1864
2016,3,28,1,5299,6919,5163,-1756
2016,3,28,2,4902,6461,4910,-1551
2016,3,28,3,4455,5890,4352,-1538
2016,3,28,4,3957,5199,3959,-1240
2016,3,28,5,3701,4731,3687,-1044
2016,3,28,6,3362,4371,3404,-967
2016,3,28,7,3167,4135,3207,-928
2016,3,28,8,3059,4032,3126,-906
2016,3,28,9,3074,4039,3135,-904
2016,3,28,10,3296,4324,3358,-966
2016,3,28,11,3665,4864,3763,-1101
2016,3,28,12,4006,5235,4014,-1221
2016,3,28,13,4284,5414,3997,-1417
2016,3,28,14,4674,5744,4255,-1489
2016,3,28,15,5072,6055,4516,-1539
2016,3,28,16,5430,6263,4684,-1579
2016,3,28,17,5742,6442,4800,-1642
2016,3,28,18,6021,6519,4904,-1615
2016,3,28,19,6221,6649,4995,-1654
2016,3,28,20,6320,6814,5123,-1691
2016,3,28,21,6351,6846,5149,-1697
2016,3,28,22,6208,6900,5168,-1732
2016,3,28,23,5985,6871,5058,-1813
2016,3,29,0,5748,6833,5044,-1789
2016,3,29,1,5685,6907,5121,-1786
2016,3,29,2,5210,6444,4759,-1685
2016,3,29,3,4715,5832,4280,-1552
2016,3,29,4,4180,5142,3920,-1222
2016,3,29,5,3578,4441,3475,-966
2016,3,29,6,3258,4049,3174,-875
2016,3,29,7,3060,3849,2999,-850
2016,3,29,8,2983,3737,2905,-832
2016,3,29,9,2980,3765,2916,-849
2016,3,29,10,3203,4044,3115,-929
2016,3,29,11,3623,4666,3611,-1055
2016,3,29,12,3888,5061,3879,-1182
2016,3,29,13,4062,5177,3841,-1336
2016,3,29,14,4342,5457,4041,-1416
2016,3,29,15,4618,5874,4375,-1499
2016,3,29,16,4889,6167,4641,-1526
2016,3,29,17,5091,6262,4735,-1527
2016,3,29,18,5263,6251,4737,-1514
2016,3,29,19,5405,6162,4656,-1506
2016,3,29,20,5526,6033,4560,-1473
2016,3,29,21,5594,5931,4456,-1475
2016,3,29,22,5536,5831,4315,-1516
2016,3,29,23,5315,5743,4195,-1548
2016,3,30,0,5128,5749,4188,-1561
2016,3,30,1,5240,5790,4207,-1583
2016,3,30,2,4909,5413,3926,-1487
2016,3,30,3,4441,4913,3559,-1354
2016,3,30,4,3874,4336,3238,-1098
2016,3,30,5,3217,3878,3010,-868
2016,3,30,6,2974,3607,2824,-783
2016,3,30,7,2803,3501,2744,-757
2016,3,30,8,2747,3386,2613,-773
2016,3,30,9,2758,3435,2646,-789
2016,3,30,10,2985,3748,2856,-892
2016,3,30,11,3394,4357,3333,-1024
2016,3,30,12,3643,4700,3524,-1176
2016,3,30,13,3877,4832,3517,-1315
2016,3,30,14,4133,5050,3702,-1348
2016,3,30,15,4411,5336,3931,-1405
2016,3,30,16,4685,5579,4147,-1432
2016,3,30,17,4940,5821,4321,-1500
2016,3,30,18,5164,6086,4555,-1531
2016,3,30,19,5385,6388,4753,-1635
2016,3,30,20,5599,6676,4960,-1716
2016,3,30,21,5674,6929,5138,-1791
2016,3,30,22,5771,6964,5165,-1799
2016,3,30,23,5726,6779,5003,-1776
2016,3,31,0,5485,6583,4836,-1747
2016,3,31,1,5406,6642,4895,-1747
2016,3,31,2,5071,6118,4508,-1610
2016,3,31,3,4556,5526,4046,-1480
2016,3,31,4,4016,4834,3671,-1163
2016,3,31,5,3455,4165,3230,-935
2016,3,31,6,3163,3866,2994,-872
2016,3,31,7,3008,3633,2809,-824
2016,3,31,8,2917,3533,2723,-810
2016,3,31,9,2916,3581,2743,-838
2016,3,31,10,3136,3873,2961,-912
2016,3,31,11,3584,4515,3447,-1068
2016,3,31,12,3865,4874,3683,-1191
2016,3,31,13,4069,5055,3699,-1356
2016,3,31,14,4371,5424,3990,-1434
2016,3,31,15,4677,5874,4339,-1535
2016,3,31,16,5000,6272,4684,-1588
2016,3,31,17,5260,6712,4974,-1738
2016,3,31,18,5527,7144,5371,-1773
2016,3,31,19,5746,7583,5748,-1835
2016,3,31,20,5935,7960,6193,-1767
2016,3,31,21,6031,8123,6386,-1737
2016,3,31,22,5962,8189,6409,-1780
2016,3,31,23,5943,7989,6244,-1745
2016,4,1,0,5714,7633,5931,-1702
2016,4,1,1,5679,7476,5735,-1741
2016,4,1,2,5311,6841,5168,-1673
2016,4,1,3,4813,6135,4541,-1594
2016,4,1,4,4287,5318,4046,-1272
2016,4,1,5,3764,4667,3633,-1034
2016,4,1,6,3460,4239,3295,-944
2016,4,1,7,3279,3988,3080,-908
2016,4,1,8,3172,3858,3030,-828
2016,4,1,9,3172,3851,3026,-825
2016,4,1,10,3309,4104,3179,-925
2016,4,1,11,3678,4740,3662,-1078
2016,4,1,12,3996,5155,3880,-1275
2016,4,1,13,4241,5435,4003,-1432
2016,4,1,14,4607,5870,4380,-1490
2016,4,1,15,4981,6423,4811,-1612
2016,4,1,16,5273,6990,5261,-1729
2016,4,1,17,5541,7511,5712,-1799
2016,4,1,18,5844,7963,6152,-1811
2016,4,1,19,6058,8285,6422,-1863
2016,4,1,20,6254,8494,6695,-1799
2016,4,1,21,6340,8528,6757,-1771
2016,4,1,22,6227,8399,6656,-1743
2016,4,1,23,5972,8048,6196,-1852
2016,4,2,0,5700,7622,5787,-1835
2016,4,2,1,5593,7450,5611,-1839
2016,4,2,2,5256,6195,4457,-1738
2016,4,2,3,4855,6298,4679,-1619
2016,4,2,4,4390,5646,4299,-1347
2016,4,2,5,3911,5041,3935,-1106
2016,4,2,6,3583,4625,3603,-1022
2016,4,2,7,3359,4369,3376,-993
2016,4,2,8,3258,4204,3223,-981
2016,4,2,9,3193,4152,3207,-945
2016,4,2,10,3274,4234,3275,-959
2016,4,2,11,3456,4460,3462,-998
2016,4,2,12,3648,4759,3613,-1146
2016,4,2,13,3973,5180,3820,-1360
2016,4,2,14,4343,5666,4318,-1348
2016,4,2,15,4542,5998,4692,-1306
2016,4,2,16,4799,6196,4844,-1352
2016,4,2,17,4980,6186,4836,-1350
2016,4,2,18,5048,6111,4787,-1324
2016,4,2,19,5114,6020,4709,-1311
2016,4,2,20,5121,6046,4646,-1400
2016,4,2,21,5016,6012,4555,-1457
2016,4,2,22,4916,5985,4448,-1537
2016,4,2,23,4651,5842,4299,-1543
2016,4,3,0,4589,5777,4255,-1522
2016,4,3,1,4615,5832,4305,-1527
2016,4,3,2,4286,5484,4024,-1460
2016,4,3,3,3958,5102,3704,-1398
2016,4,3,4,3540,4590,3430,-1160
2016,4,3,5,3274,4082,3168,-914
2016,4,3,6,2995,3715,2960,-755
2016,4,3,7,2800,3454,2755,-699
2016,4,3,8,2692,3305,2627,-678
2016,4,3,9,2606,3220,2551,-669
2016,4,3,10,2634,3286,2584,-702
2016,4,3,11,2760,3460,2710,-750
2016,4,3,12,3006,3719,2902,-817
2016,4,3,13,3288,4183,3244,-939
2016,4,3,14,3646,4570,3470,-1100
2016,4,3,15,3810,4776,3568,-1208
2016,4,3,16,3935,4844,3523,-1321
2016,4,3,17,3978,4943,3581,-1362
2016,4,3,18,4040,5033,3637,-1396
2016,4,3,19,4090,5180,3778,-1402
2016,4,3,20,4119,5388,3926,-1462
2016,4,3,21,4205,5633,4108,-1525
2016,4,3,22,4238,5778,4211,-1567
2016,4,3,23,4243,5728,4156,-1572
2016,4,4,0,4194,5566,4030,-1536
2016,4,4,1,4229,5650,4078,-1572
2016,4,4,2,3973,5221,3746,-1475
2016,4,4,3,3597,4688,3352,-1336
2016,4,4,4,3190,4094,2998,-1096
2016,4,4,5,2973,3634,2775,-859
2016,4,4,6,2752,3347,2633,-714
2016,4,4,7,2660,3203,2526,-677
2016,4,4,8,2596,3179,2509,-670
2016,4,4,9,2687,3266,2560,-706
2016,4,4,10,2894,3622,2828,-794
2016,4,4,11,3313,4283,3323,-960
2016,4,4,12,3614,4614,3623,-991
2016,4,4,13,3719,4729,3733,-996
2016,4,4,14,3849,4888,3745,-1143
2016,4,4,15,4010,5058,3704,-1354
2016,4,4,16,4140,5251,3841,-1410
2016,4,4,17,4243,5422,3981,-1441
2016,4,4,18,4372,5680,4166,-1514
2016,4,4,19,4533,5938,4339,-1599
2016,4,4,20,4706,6233,4444,-1789
2016,4,4,21,4841,6548,4741,-1807
2016,4,4,22,4879,6683,4868,-1815
2016,4,4,23,4812,6590,4807,-1783
2016,4,5,0,4735,6269,4556,-1713
2016,4,5,1,4742,6248,4648,-1600
2016,4,5,2,4405,5715,4228,-1487
2016,4,5,3,3943,5064,3690,-1374
2016,4,5,4,3473,4335,3231,-1104
2016,4,5,5,3089,3794,2908,-886
2016,4,5,6,2862,3461,2633,-828
2016,4,5,7,2725,3320,2526,-794
2016,4,5,8,2654,3278,2498,-780
2016,4,5,9,2714,3292,2491,-801
2016,4,5,10,2949,3659,2755,-904
2016,4,5,11,3409,4304,3278,-1026
2016,4,5,12,3716,4623,3427,-1196
2016,4,5,13,3802,4761,3421,-1340
2016,4,5,14,3895,4934,3586,-1348
2016,4,5,15,4066,5127,3774,-1353
2016,4,5,16,4191,5338,3946,-1392
2016,4,5,17,4282,5559,4118,-1441
2016,4,5,18,4403,5817,4326,-1491
2016,4,5,19,4567,6167,4595,-1572
2016,4,5,20,4763,6586,4769,-1817
2016,4,5,21,4915,6930,5013,-1917
2016,4,5,22,4959,7061,5088,-1973
2016,4,5,23,4862,6885,4927,-1958
2016,4,6,0,4821,6492,4640,-1852
2016,4,6,1,4856,6444,4746,-1698
2016,4,6,2,4520,5896,4313,-1583
2016,4,6,3,4057,5210,3814,-1396
2016,4,6,4,3540,4495,3362,-1133
2016,4,6,5,3163,3953,2993,-960
2016,4,6,6,2885,3597,2710,-887
2016,4,6,7,2725,3438,2579,-859
2016,4,6,8,2656,3360,2510,-850
2016,4,6,9,2691,3431,2542,-889
2016,4,6,10,2867,3731,2763,-968
2016,4,6,11,3307,4327,3274,-1053
2016,4,6,12,3600,4563,3382,-1181
2016,4,6,13,3695,4697,3377,-1320
2016,4,6,14,3873,4891,3550,-1341
2016,4,6,15,4101,5127,3768,-1359
2016,4,6,16,4244,5322,4028,-1294
2016,4,6,17,4357,5522,4259,-1263
2016,4,6,18,4468,5807,4548,-1259
2016,4,6,19,4637,6083,4644,-1439
2016,4,6,20,4836,6361,4954,-1407
2016,4,6,21,4979,6581,5197,-1384
2016,4,6,22,5003,6670,5240,-1430
2016,4,6,23,4968,6555,5100,-1455
2016,4,7,0,4836,6304,4889,-1415
2016,4,7,1,4881,6328,4859,-1469
2016,4,7,2,4534,5853,4538,-1315
2016,4,7,3,4068,5246,4085,-1161
2016,4,7,4,3531,4577,3528,-1049
2016,4,7,5,3177,4060,3086,-974
2016,4,7,6,2951,3732,2846,-886
2016,4,7,7,2803,3529,2664,-865
2016,4,7,8,2731,3453,2600,-853
2016,4,7,9,2789,3492,2610,-882
2016,4,7,10,3002,3808,2841,-967
2016,4,7,11,3479,4431,3242,-1189
2016,4,7,12,3746,4730,3415,-1315
2016,4,7,13,3822,4872,3562,-1310
2016,4,7,14,4041,5133,3818,-1315
2016,4,7,15,4280,5420,4052,-1368
2016,4,7,16,4460,5695,4257,-1438
2016,4,7,17,4589,5952,4456,-1496
2016,4,7,18,4763,6222,4660,-1562
2016,4,7,19,4932,6492,4873,-1619
2016,4,7,20,5092,6754,5066,-1688
2016,4,7,21,5235,6951,5310,-1641
2016,4,7,22,5212,6948,5318,-1630
2016,4,7,23,5036,6779,5179,-1600
2016,4,8,0,4879,6411,4881,-1530
2016,4,8,1,4854,6386,4820,-1566
2016,4,8,2,4496,5893,4410,-1483
2016,4,8,3,4069,5289,3886,-1403
2016,4,8,4,3536,4582,3246,-1336
2016,4,8,5,3210,4019,2945,-1074
2016,4,8,6,2959,3668,2770,-898
2016,4,8,7,2778,3519,2665,-854
2016,4,8,8,2713,3365,2535,-830
2016,4,8,9,2727,3417,2564,-853
2016,4,8,10,2905,3696,2775,-921
2016,4,8,11,3378,4306,3352,-954
2016,4,8,12,3674,4616,3522,-1094
2016,4,8,13,3828,4821,3690,-1131
2016,4,8,14,4017,5084,3928,-1156
2016,4,8,15,4247,5337,3955,-1382
2016,4,8,16,4413,5619,4171,-1448
2016,4,8,17,4587,5912,4424,-1488
2016,4,8,18,4829,6238,4802,-1436
2016,4,8,19,5038,6550,5220,-1330
2016,4,8,20,5206,6804,5504,-1300
2016,4,8,21,5330,6954,5484,-1470
2016,4,8,22,5318,6915,5430,-1485
2016,4,8,23,5119,6626,5328,-1298
2016,4,9,0,4817,6185,4941,-1243
2016,4,9,1,4774,6116,4762,-1354
2016,4,9,2,4436,5709,4220,-1489
2016,4,9,3,4080,5205,3801,-1403
2016,4,9,4,3618,4591,3298,-1293
2016,4,9,5,3231,4062,2990,-1072
2016,4,9,6,2951,3700,2799,-901
2016,4,9,7,2790,3466,2611,-855
2016,4,9,8,2715,3371,2523,-848
2016,4,9,9,2684,3337,2488,-849
2016,4,9,10,2749,3407,2536,-871
2016,4,9,11,2889,3671,2915,-756
2016,4,9,12,3099,3893,3009,-884
2016,4,9,13,3478,4331,3226,-1105
2016,4,9,14,3726,4693,3515,-1178
2016,4,9,15,3870,4863,3685,-1178
2016,4,9,16,3910,4580,3404,-1176
2016,4,9,17,3913,5000,3821,-1179
2016,4,9,18,3968,5060,3889,-1171
2016,4,9,19,3996,5193,4030,-1163
2016,4,9,20,4058,5358,4144,-1214
2016,4,9,21,4110,5545,4265,-1280
2016,4,9,22,4165,5641,4339,-1301
2016,4,9,23,4140,5527,4270,-1256
2016,4,10,0,4045,5266,4049,-1216
2016,4,10,1,4136,5308,4078,-1229
2016,4,10,2,3926,4972,3814,-1158
2016,4,10,3,3610,4547,3501,-1046
2016,4,10,4,3246,4082,3115,-966
2016,4,10,5,2946,3681,2969,-711
2016,4,10,6,2731,3423,2929,-494
2016,4,10,7,2665,3243,2818,-425
2016,4,10,8,2608,3180,2748,-432
2016,4,10,9,2622,3192,2748,-444
2016,4,10,10,2697,3292,2806,-486
2016,4,10,11,2827,3503,2930,-573
2016,4,10,12,3033,3763,3250,-513
2016,4,10,13,3356,4222,3555,-667
2016,4,10,14,3616,4583,3748,-835
2016,4,10,15,3722,4763,3779,-984
2016,4,10,16,3803,4883,3919,-964
2016,4,10,17,3847,5019,4032,-987
2016,4,10,18,3883,5161,4143,-1018
2016,4,10,19,4010,5376,4328,-1048
2016,4,10,20,4090,5677,4545,-1132
2016,4,10,21,4321,5957,4750,-1207
2016,4,10,22,4436,6149,4922,-1226
2016,4,10,23,4333,6087,4874,-1212
2016,4,11,0,4308,5886,4703,-1183
2016,4,11,1,4213,5952,4751,-1200
2016,4,11,2,3985,5539,4302,-1237
2016,4,11,3,3591,4913,3788,-1124
2016,4,11,4,3173,4297,3021,-1275
2016,4,11,5,2956,3707,2680,-1027
2016,4,11,6,2766,3413,2537,-876
2016,4,11,7,2655,3245,2410,-835
2016,4,11,8,2618,3177,2353,-824
2016,4,11,9,2705,3259,2410,-849
2016,4,11,10,2961,3607,2787,-820
2016,4,11,11,3436,4220,3283,-937
2016,4,11,12,3693,4535,3476,-1059
2016,4,11,13,3819,4707,3657,-1050
2016,4,11,14,3999,4926,3973,-953
2016,4,11,15,4216,5207,4107,-1100
2016,4,11,16,4374,5455,4317,-1138
2016,4,11,17,4515,5729,4524,-1205
2016,4,11,18,4749,6028,4755,-1273
2016,4,11,19,5009,6310,4986,-1324
2016,4,11,20,5232,6571,5190,-1381
2016,4,11,21,5420,6801,5277,-1524
2016,4,11,22,5493,6936,5345,-1591
2016,4,11,23,5354,6794,5202,-1592
2016,4,12,0,5132,6568,5020,-1548
2016,4,12,1,5099,6486,5003,-1483
2016,4,12,2,4714,5933,4591,-1342
2016,4,12,3,4231,5232,4091,-1141
2016,4,12,4,3715,4521,3445,-1076
2016,4,12,5,3309,4023,3194,-829
2016,4,12,6,3044,3678,3068,-610
2016,4,12,7,2893,3479,2892,-587
2016,4,12,8,2818,3390,2810,-580
2016,4,12,9,2840,3410,2811,-599
2016,4,12,10,3059,3706,3031,-675
2016,4,12,11,3527,4331,3613,-718
2016,4,12,12,3742,4624,3944,-680
2016,4,12,13,3875,4749,4050,-699
2016,4,12,14,4093,5021,4155,-866
2016,4,12,15,4377,5331,4184,-1147
2016,4,12,16,4641,5635,4416,-1219
2016,4,12,17,4871,6035,4718,-1317
2016,4,12,18,5146,6426,5031,-1395
2016,4,12,19,5365,6778,5309,-1469
2016,4,12,20,5597,7134,5593,-1541
2016,4,12,21,5792,7372,5784,-1588
2016,4,12,22,5830,7421,5874,-1547
2016,4,12,23,5763,7191,5697,-1494
2016,4,13,0,5434,6899,5415,-1484
2016,4,13,1,5383,6876,5357,-1519
2016,4,13,2,5024,6367,4958,-1409
2016,4,13,3,4450,5673,4426,-1247
2016,4,13,4,3903,4876,3785,-1091
2016,4,13,5,-9999,4295,3506,-789
2016,4,13,6,-9999,3935,3305,-630
2016,4,13,7,-9999,3686,3071,-615
2016,4,13,8,-9999,3575,2968,-607
2016,4,13,9,-9999,3634,3021,-613
2016,4,13,10,-9999,3919,3239,-680
2016,4,13,11,-9999,4533,3842,-691
2016,4,13,12,-9999,4813,4177,-636
2016,4,13,13,-9999,5019,4166,-853
2016,4,13,14,-9999,5363,4458,-905
2016,4,13,15,-9999,5750,4823,-927
2016,4,13,16,-9999,6156,5116,-1040
2016,4,13,17,-9999,6600,5445,-1155
2016,4,13,18,-9999,6978,5748,-1230
2016,4,13,19,-9999,7226,5953,-1273
2016,4,13,20,-9999,7360,6141,-1219
2016,4,13,21,-9999,7418,6189,-1229
2016,4,13,22,-9999,7351,6179,-1172
2016,4,13,23,-9999,7128,5954,-1174
2016,4,14,0,-9999,6931,5748,-1183
2016,4,14,1,-9999,6825,5594,-1231
2016,4,14,2,-9999,6302,5184,-1118
2016,4,14,3,-9999,5678,4691,-987
2016,4,14,4,-9999,4974,4100,-874
2016,4,14,5,3568,4429,3733,-696
2016,4,14,6,3264,4084,3451,-633
2016,4,14,7,3078,3863,3283,-580
2016,4,14,8,2980,3788,3230,-558
2016,4,14,9,3008,3802,3231,-571
2016,4,14,10,3225,4075,3441,-634
2016,4,14,11,3697,4694,4107,-587
2016,4,14,12,3922,4995,4363,-632
2016,4,14,13,4071,5150,4355,-795
2016,4,14,14,4308,5461,4587,-874
2016,4,14,15,4577,5802,4872,-930
2016,4,14,16,4851,6209,5248,-961
2016,4,14,17,5069,6611,5601,-1010
2016,4,14,18,5342,7067,5992,-1075
2016,4,14,19,5542,7330,6125,-1205
2016,4,14,20,5707,7557,6233,-1324
2016,4,14,21,5825,7692,6467,-1225
2016,4,14,22,5778,7512,6352,-1160
2016,4,14,23,5561,7128,6034,-1094
2016,4,15,0,5360,6865,5782,-1083
2016,4,15,1,5357,6796,5668,-1128
2016,4,15,2,4966,6267,5235,-1032
2016,4,15,3,4454,5645,4757,-888
2016,4,15,4,3905,4966,4237,-729
2016,4,15,5,3457,4341,3675,-666
2016,4,15,6,3169,4001,3367,-634
2016,4,15,7,3006,3805,3210,-595
2016,4,15,8,2897,3721,3142,-579
2016,4,15,9,2932,3721,3127,-594
2016,4,15,10,3146,4006,3360,-646
2016,4,15,11,3640,4617,3997,-620
2016,4,15,12,3892,4966,4393,-573
2016,4,15,13,4068,5132,4464,-668
2016,4,15,14,4330,5395,4704,-689
2016,4,15,15,4583,5657,4837,-820
2016,4,15,16,4827,5842,4957,-884
2016,4,15,17,4943,6017,5086,-930
2016,4,15,18,5086,6205,5259,-946
2016,4,15,19,5215,6273,5419,-854
2016,4,15,20,5285,6383,5513,-870
2016,4,15,21,5276,6447,5439,-1008
2016,4,15,22,5108,6376,5392,-984
2016,4,15,23,4906,6194,5232,-962
2016,4,16,0,4732,5998,5019,-979
2016,4,16,1,4749,6046,5055,-991
2016,4,16,2,4468,5756,4843,-913
2016,4,16,3,4152,5345,4508,-837
2016,4,16,4,3737,4811,4001,-810
2016,4,16,5,3399,4318,3653,-665
2016,4,16,6,3131,3964,3366,-598
2016,4,16,7,2974,3766,3213,-553
2016,4,16,8,2878,3658,3114,-544
2016,4,16,9,2841,3632,3095,-537
2016,4,16,10,2900,3714,3164,-550
2016,4,16,11,3057,3956,3586,-370
2016,4,16,12,3221,4184,3767,-417
2016,4,16,13,3551,4656,3965,-691
2016,4,16,14,3937,5123,4175,-948
2016,4,16,15,4165,5432,4246,-1186
2016,4,16,16,4357,5639,4396,-1243
2016,4,16,17,4504,5850,4535,-1315
2016,4,16,18,4601,0,4535,-1337
2016,4,16,19,4676,6143,4755,-1388
2016,4,16,20,4756,6268,4871,-1397
2016,4,16,21,4827,6262,4871,-1391
2016,4,16,22,4743,6161,4788,-1373
2016,4,16,23,4593,5933,4739,-1194
2016,4,17,0,4461,5623,4503,-1120
2016,4,17,1,4505,5643,4520,-1123
2016,4,17,2,4261,5329,4131,-1198
2016,4,17,3,3909,4932,3810,-1122
2016,4,17,4,3536,4443,3376,-1067
2016,4,17,5,3216,3984,3166,-818
2016,4,17,6,2970,3654,2998,-656
2016,4,17,7,2810,3414,2834,-580
2016,4,17,8,2721,3314,2752,-562
2016,4,17,9,2687,3261,2712,-549
2016,4,17,10,2738,3317,2746,-571
2016,4,17,11,2860,3474,2842,-632
2016,4,17,12,3009,3698,3037,-661
2016,4,17,13,3388,4185,3323,-862
2016,4,17,14,3772,4667,3563,-1103
2016,4,17,15,4017,4988,3831,-1157
2016,4,17,16,4251,5234,4022,-1212
2016,4,17,17,4394,5453,4222,-1231
2016,4,17,18,4549,5668,4382,-1286
2016,4,17,19,4686,5876,4544,-1331
2016,4,17,20,4812,6051,4674,-1376
2016,4,17,21,4916,6199,4786,-1413
2016,4,17,22,4916,6237,4814,-1423
2016,4,17,23,4801,6102,4812,-1290
2016,4,18,0,4647,5856,4628,-1228
2016,4,18,1,4613,5875,4649,-1226
2016,4,18,2,4279,5511,4276,-1235
2016,4,18,3,3886,4941,3861,-1080
2016,4,18,4,3406,4226,3245,-981
2016,4,18,5,3163,3730,2981,-749
2016,4,18,6,2900,3413,2813,-600
2016,4,18,7,2769,3263,2693,-570
2016,4,18,8,2718,3217,2647,-570
2016,4,18,9,2749,3284,2695,-589
2016,4,18,10,2983,3648,2942,-706
2016,4,18,11,3460,4267,3335,-932
2016,4,18,12,3691,4554,3512,-1042
2016,4,18,13,3869,4737,3678,-1059
2016,4,18,14,4136,4952,3851,-1101
2016,4,18,15,4355,5214,4068,-1146
2016,4,18,16,4604,5465,4268,-1197
2016,4,18,17,4727,5699,4446,-1253
2016,4,18,18,4983,5961,4533,-1428
2016,4,18,19,5202,6230,4788,-1442
2016,4,18,20,5348,6512,4966,-1546
2016,4,18,21,5464,6753,5022,-1731
2016,4,18,22,5458,6859,5067,-1792
2016,4,18,23,5316,6728,4959,-1769
2016,4,19,0,5118,6376,4705,-1671
2016,4,19,1,5063,6312,4673,-1639
2016,4,19,2,4689,5802,4297,-1505
2016,4,19,3,4177,5119,3765,-1354
2016,4,19,4,3641,4425,3164,-1261
2016,4,19,5,3170,3899,2896,-1003
2016,4,19,6,2901,3586,2831,-755
2016,4,19,7,2750,3394,2680,-714
2016,4,19,8,2686,3322,2636,-686
2016,4,19,9,2696,3380,2638,-742
2016,4,19,10,2895,3668,2779,-889
2016,4,19,11,3409,4282,3154,-1128
2016,4,19,12,3690,4563,3287,-1276
2016,4,19,13,3801,4724,3429,-1295
2016,4,19,14,4007,4939,3633,-1306
2016,4,19,15,4200,5197,3828,-1369
2016,4,19,16,4399,5404,3990,-1414
2016,4,19,17,4538,5693,4224,-1469
2016,4,19,18,4810,5992,4462,-1530
2016,4,19,19,5061,6352,4727,-1625
2016,4,19,20,5351,6655,4860,-1795
2016,4,19,21,5562,6972,5222,-1750
2016,4,19,22,5597,7076,5364,-1712
2016,4,19,23,5484,6890,5101,-1789
2016,4,20,0,5239,6523,4858,-1665
2016,4,20,1,5181,6461,4807,-1654
2016,4,20,2,4816,5920,4368,-1552
2016,4,20,3,4280,5262,3814,-1448
2016,4,20,4,3706,4500,3187,-1313
2016,4,20,5,3253,3990,2951,-1039
2016,4,20,6,2969,3656,2791,-865
2016,4,20,7,2804,3457,2660,-797
2016,4,20,8,2742,3377,2582,-795
2016,4,20,9,2769,3421,2612,-809
2016,4,20,10,2945,3729,2830,-899
2016,4,20,11,3392,4301,3175,-1126
2016,4,20,12,3636,4585,3276,-1309
2016,4,20,13,3767,4758,3426,-1332
2016,4,20,14,4019,4950,3604,-1346
2016,4,20,15,4226,5221,3829,-1392
2016,4,20,16,4454,5496,4049,-1447
2016,4,20,17,4627,5745,4294,-1451
2016,4,20,18,4918,6073,4533,-1540
2016,4,20,19,5198,6383,4774,-1609
2016,4,20,20,5477,6734,5095,-1639
2016,4,20,21,5673,7020,5317,-1703
2016,4,20,22,5708,7053,5371,-1682
2016,4,20,23,5565,6836,5121,-1715
2016,4,21,0,5265,6525,4821,-1704
2016,4,21,1,5230,6539,4842,-1697
2016,4,21,2,4871,6042,4437,-1605
2016,4,21,3,4337,5400,3941,-1459
2016,4,21,4,3785,4691,3369,-1322
2016,4,21,5,3314,4142,3054,-1088
2016,4,21,6,3036,3775,2883,-892
2016,4,21,7,2870,3566,2715,-851
2016,4,21,8,2789,3453,2636,-817
2016,4,21,9,2806,3505,2669,-836
2016,4,21,10,3027,3798,2876,-922
2016,4,21,11,3491,4381,3249,-1132
2016,4,21,12,3697,4661,3378,-1283
2016,4,21,13,3889,4889,3563,-1326
2016,4,21,14,4164,5189,3801,-1388
2016,4,21,15,4440,5539,4083,-1456
2016,4,21,16,4751,5855,4338,-1517
2016,4,21,17,4977,6173,4581,-1592
2016,4,21,18,5256,6526,4927,-1599
2016,4,21,19,5498,6831,5154,-1677
2016,4,21,20,5712,7140,5487,-1653
2016,4,21,21,5868,7329,5638,-1691
2016,4,21,22,5880,7353,5633,-1720
2016,4,21,23,5767,7136,5339,-1797
2016,4,22,0,5447,6771,4983,-1788
2016,4,22,1,5370,6731,4961,-1770
2016,4,22,2,5006,6267,4598,-1669
2016,4,22,3,4481,5570,4061,-1509
2016,4,22,4,3919,4858,3515,-1343
2016,4,22,5,3483,4319,3189,-1130
2016,4,22,6,3197,3915,2976,-939
2016,4,22,7,3029,3694,2796,-898
2016,4,22,8,2910,3579,2726,-853
2016,4,22,9,2922,3582,2733,-849
2016,4,22,10,3126,3867,2916,-951
2016,4,22,11,3497,4439,3291,-1148
2016,4,22,12,3760,4750,3444,-1306
2016,4,22,13,4032,5025,3681,-1344
2016,4,22,14,4368,5396,4000,-1396
2016,4,22,15,4702,5786,4325,-1461
2016,4,22,16,4998,6198,4625,-1573
2016,4,22,17,5154,6611,4969,-1642
2016,4,22,18,5382,6972,5232,-1740
2016,4,22,19,5526,7208,5422,-1786
2016,4,22,20,5644,7449,5588,-1861
2016,4,22,21,5697,7538,5683,-1855
2016,4,22,22,5613,7302,5540,-1762
2016,4,22,23,5459,6915,5194,-1721
2016,4,23,0,5193,6435,4842,-1593
2016,4,23,1,5113,6215,4597,-1618
2016,4,23,2,4821,5831,4280,-1551
2016,4,23,3,4400,5400,3932,-1468
2016,4,23,4,3939,4831,3451,-1380
2016,4,23,5,3475,4379,3348,-1031
2016,4,23,6,3184,4038,3190,-848
2016,4,23,7,3021,3834,3020,-814
2016,4,23,8,2908,3727,2925,-802
2016,4,23,9,2873,3704,2896,-808
2016,4,23,10,2924,3763,2928,-835
2016,4,23,11,3043,3934,3085,-849
2016,4,23,12,3200,4168,3283,-885
2016,4,23,13,3595,4702,3646,-1056
2016,4,23,14,4065,5211,4110,-1101
2016,4,23,15,4447,5610,4434,-1176
2016,4,23,16,4782,5974,4756,-1218
2016,4,23,17,5032,6320,5032,-1288
2016,4,23,18,5218,6669,5302,-1367
2016,4,23,19,5383,6976,5616,-1360
2016,4,23,20,5498,7241,5805,-1436
2016,4,23,21,5564,7388,5950,-1438
2016,4,23,22,5522,7388,5960,-1428
2016,4,23,23,5427,7124,5676,-1448
2016,4,24,0,5081,6663,5276,-1387
2016,4,24,1,4918,6500,5175,-1325
2016,4,24,2,4631,6054,4819,-1235
2016,4,24,3,4239,5536,4362,-1174
2016,4,24,4,3827,4918,3871,-1047
2016,4,24,5,3461,4370,3434,-936
2016,4,24,6,3169,3960,3134,-826
2016,4,24,7,2947,3692,2927,-765
2016,4,24,8,2829,3525,2786,-739
2016,4,24,9,2786,3458,2724,-734
2016,4,24,10,2769,3497,2741,-756
2016,4,24,11,2906,3619,2818,-801
2016,4,24,12,3055,3845,3005,-840
2016,4,24,13,3494,4399,3314,-1085
2016,4,24,14,3938,5021,3624,-1397
2016,4,24,15,4380,5598,4081,-1517
2016,4,24,16,4663,6114,4495,-1619
2016,4,24,17,4961,6629,4843,-1786
2016,4,24,18,5225,7026,5180,-1846
2016,4,24,19,5495,7408,5589,-1819
2016,4,24,20,5661,7656,5834,-1822
2016,4,24,21,5722,7849,6020,-1829
2016,4,24,22,5800,7894,6046,-1848
2016,4,24,23,5639,7622,5797,-1825
2016,4,25,0,5385,7139,5359,-1780
2016,4,25,1,5316,6973,5196,-1777
2016,4,25,2,4929,6462,4755,-1707
2016,4,25,3,4456,5797,4227,-1570
2016,4,25,4,3871,5027,3607,-1420
2016,4,25,5,3435,4432,3335,-1097
2016,4,25,6,3169,4044,3100,-944
2016,4,25,7,2983,3780,2904,-876
2016,4,25,8,2882,3682,2807,-875
2016,4,25,9,2875,3684,2838,-846
2016,4,25,10,3122,3975,3005,-970
2016,4,25,11,3555,4553,3367,-1186
2016,4,25,12,3806,4880,3533,-1347
2016,4,25,13,4051,5196,3795,-1401
2016,4,25,14,4393,5598,4145,-1453
2016,4,25,15,4751,6027,4482,-1545
2016,4,25,16,5104,6430,4792,-1638
2016,4,25,17,5366,6837,5026,-1811
2016,4,25,18,5696,7194,5166,-2028
2016,4,25,19,5929,7466,5370,-2096
2016,4,25,20,6106,7695,5558,-2137
2016,4,25,21,6228,7786,5637,-2149
2016,4,25,22,6212,7690,5550,-2140
2016,4,25,23,6069,7446,5320,-2126
2016,4,26,0,5756,7111,5050,-2061
2016,4,26,1,5598,7026,4971,-2055
2016,4,26,2,5162,6485,4559,-1926
2016,4,26,3,4634,5812,4057,-1755
2016,4,26,4,4086,5047,3401,-1646
2016,4,26,5,3623,4444,3185,-1259
2016,4,26,6,3305,4044,2978,-1066
2016,4,26,7,3126,3767,2751,-1016
2016,4,26,8,3003,3640,2642,-998
2016,4,26,9,3004,3671,2670,-1001
2016,4,26,10,3238,3940,2855,-1085
2016,4,26,11,3689,4508,3142,-1366
2016,4,26,12,3935,4781,3169,-1612
2016,4,26,13,4152,5050,3414,-1636
2016,4,26,14,4489,5430,3737,-1693
2016,4,26,15,4872,5904,4132,-1772
2016,4,26,16,5240,6388,4487,-1901
2016,4,26,17,5601,6904,4872,-2032
2016,4,26,18,5923,7356,5217,-2139
2016,4,26,19,6160,7755,5547,-2208
2016,4,26,20,6382,8070,5942,-2128
2016,4,26,21,6508,8338,6089,-2249
2016,4,26,22,6472,8384,6113,-2271
2016,4,26,23,6292,8159,5916,-2243
2016,4,27,0,5964,7667,5423,-2244
2016,4,27,1,5764,7444,5305,-2139
2016,4,27,2,5315,6854,4846,-2008
2016,4,27,3,4724,6083,4395,-1688
2016,4,27,4,4161,5241,3803,-1438
2016,4,27,5,3673,4703,3523,-1180
2016,4,27,6,3367,4297,3216,-1081
2016,4,27,7,3170,4032,3062,-970
2016,4,27,8,3061,3906,2980,-926
2016,4,27,9,3053,3914,2973,-941
2016,4,27,10,3307,4171,3097,-1074
2016,4,27,11,3704,4730,3600,-1130
2016,4,27,12,3947,5035,3780,-1255
2016,4,27,13,4192,5354,3951,-1403
2016,4,27,14,4558,5793,4121,-1672
2016,4,27,15,4961,6312,4483,-1829
2016,4,27,16,5400,6868,4900,-1968
2016,4,27,17,5670,7411,5411,-2000
2016,4,27,18,5986,7907,5781,-2126
2016,4,27,19,6306,8273,6119,-2154
2016,4,27,20,6498,8572,6383,-2189
2016,4,27,21,6611,8731,6504,-2227
2016,4,27,22,6584,8645,6467,-2178
2016,4,27,23,6348,8317,6195,-2122
2016,4,28,0,6036,7897,5739,-2158
2016,4,28,1,5838,7722,5634,-2088
2016,4,28,2,5400,7096,5071,-2025
2016,4,28,3,4860,6341,4509,-1832
2016,4,28,4,4307,5512,3952,-1560
2016,4,28,5,3834,4780,3549,-1231
2016,4,28,6,3490,4360,3313,-1047
2016,4,28,7,3318,4091,3107,-984
2016,4,28,8,3171,3961,3030,-931
2016,4,28,9,3180,3941,3030,-911
2016,4,28,10,3394,4202,3103,-1099
2016,4,28,11,3820,4778,3486,-1292
2016,4,28,12,4083,5034,3723,-1311
2016,4,28,13,4364,5370,3886,-1484
2016,4,28,14,4779,5861,4134,-1727
2016,4,28,15,5211,6457,4572,-1885
2016,4,28,16,5675,7065,5036,-2029
2016,4,28,17,6057,7723,5489,-2234
2016,4,28,18,6451,8238,5788,-2450
2016,4,28,19,6794,8618,6196,-2422
2016,4,28,20,7041,8896,6527,-2369
2016,4,28,21,7219,9095,6747,-2348
2016,4,28,22,7224,9023,6702,-2321
2016,4,28,23,6891,8695,6355,-2340
2016,4,29,0,6503,8133,5762,-2371
2016,4,29,1,6317,7853,5520,-2333
2016,4,29,2,5870,7212,5086,-2126
2016,4,29,3,5218,6473,4547,-1926
2016,4,29,4,4590,5657,4022,-1635
2016,4,29,5,4011,4999,3670,-1329
2016,4,29,6,3637,4530,3382,-1148
2016,4,29,7,3402,4249,3219,-1030
2016,4,29,8,3256,4065,3091,-974
2016,4,29,9,3240,4047,3070,-977
2016,4,29,10,3433,4297,3231,-1066
2016,4,29,11,3855,4833,3563,-1270
2016,4,29,12,4112,5120,3856,-1264
2016,4,29,13,4408,5498,4036,-1462
2016,4,29,14,4800,6026,4239,-1787
2016,4,29,15,5280,6638,4737,-1901
2016,4,29,16,5776,7312,5258,-2054
2016,4,29,17,6275,7998,5695,-2303
2016,4,29,18,6687,8581,6020,-2561
2016,4,29,19,7002,9075,6453,-2622
2016,4,29,20,7270,9405,6811,-2594
2016,4,29,21,7388,9588,6939,-2649
2016,4,29,22,7255,9428,6818,-2610
2016,4,29,23,6951,8975,6484,-2491
2016,4,30,0,6478,8359,6064,-2295
2016,4,30,1,6225,7992,5810,-2182
2016,4,30,2,5752,7354,5244,-2110
2016,4,30,3,5233,6698,4698,-2000
2016,4,30,4,4704,5952,4278,-1674
2016,4,30,5,4299,5316,4020,-1296
2016,4,30,6,3892,4837,3724,-1113
2016,4,30,7,3548,4483,3427,-1056
2016,4,30,8,3391,4275,3273,-1002
2016,4,30,9,3288,4161,3200,-961
2016,4,30,10,3314,4188,3161,-1027
2016,4,30,11,3422,4329,3174,-1155
2016,4,30,12,3599,4608,3385,-1223
2016,4,30,13,4070,5245,3740,-1505
2016,4,30,14,4676,5944,4118,-1826
2016,4,30,15,5236,6598,4564,-2034
2016,4,30,16,5681,7152,4987,-2165
2016,4,30,17,6125,7644,5422,-2222
2016,4,30,18,6511,8051,5741,-2310
2016,4,30,19,6789,8393,6074,-2319
2016,4,30,20,7050,8596,6251,-2345
2016,4,30,21,7171,8694,6323,-2371
2016,4,30,22,7102,8557,6114,-2443
2016,4,30,23,6829,8182,5736,-2446
2016,5,1,0,6364,7653,5353,-2300
2016,5,1,1,6074,7484,5214,-2270
2016,5,1,2,5620,6951,4875,-2076
2016,5,1,3,5123,6351,4434,-1917
2016,5,1,4,4631,5662,4087,-1575
2016,5,1,5,4126,5037,3752,-1285
2016,5,1,6,3740,4555,3447,-1108
2016,5,1,7,3478,4217,3186,-1031
2016,5,1,8,3336,4036,3052,-984
2016,5,1,9,3223,3914,2951,-963
2016,5,1,10,3211,3931,2943,-988
2016,5,1,11,3281,4055,3011,-1044
2016,5,1,12,3459,4299,3211,-1088
2016,5,1,13,3941,4958,3523,-1435
2016,5,1,14,4586,5690,3915,-1775
2016,5,1,15,5133,6374,4436,-1938
2016,5,1,16,5611,6997,4899,-2098
2016,5,1,17,6030,7602,5323,-2279
2016,5,1,18,6345,8124,5669,-2455
2016,5,1,19,6605,8577,6103,-2474
2016,5,1,20,6828,8883,6452,-2431
2016,5,1,21,6900,9102,6680,-2422
2016,5,1,22,6934,9107,6631,-2476
2016,5,1,23,6698,8812,6353,-2459
2016,5,2,0,6319,8285,5948,-2337
2016,5,2,1,6094,7982,5692,-2290
2016,5,2,2,5634,7355,5207,-2148
2016,5,2,3,5051,6601,4674,-1927
2016,5,2,4,4519,5763,4170,-1593
2016,5,2,5,3946,5204,3892,-1312
2016,5,2,6,3595,4739,3568,-1171
2016,5,2,7,3421,4467,3515,-952
2016,5,2,8,3314,4315,3463,-852
2016,5,2,9,3291,4319,3430,-889
2016,5,2,10,3517,4564,3566,-998
2016,5,2,11,3941,5109,3928,-1181
2016,5,2,12,4222,5451,4232,-1219
2016,5,2,13,4506,5861,4416,-1445
2016,5,2,14,4890,6419,4705,-1714
2016,5,2,15,5338,7063,5247,-1816
2016,5,2,16,5791,7679,5838,-1841
2016,5,2,17,6215,8242,6236,-2006
2016,5,2,18,6592,8759,6679,-2080
2016,5,2,19,6928,9169,7048,-2121
2016,5,2,20,7148,9496,7370,-2126
2016,5,2,21,7245,9658,7442,-2216
2016,5,2,22,7134,9622,7385,-2237
2016,5,2,23,6853,9243,7037,-2206
2016,5,3,0,6514,8729,6595,-2134
2016,5,3,1,6245,8385,6215,-2170
2016,5,3,2,5780,7656,5568,-2088
2016,5,3,3,5165,6797,4836,-1961
2016,5,3,4,4575,5984,4336,-1648
2016,5,3,5,4234,5226,3870,-1356
2016,5,3,6,3846,4796,3577,-1219
2016,5,3,7,3587,4499,3335,-1164
2016,5,3,8,3449,4336,3212,-1124
2016,5,3,9,3401,4301,3179,-1122
2016,5,3,10,3596,4546,3368,-1178
2016,5,3,11,4009,5136,3822,-1314
2016,5,3,12,4272,5425,4084,-1341
2016,5,3,13,4569,5839,4287,-1552
2016,5,3,14,5001,6378,4516,-1862
2016,5,3,15,5507,7013,5051,-1962
2016,5,3,16,5901,7631,5557,-2074
2016,5,3,17,6379,8172,5986,-2186
2016,5,3,18,6709,8568,6435,-2133
2016,5,3,19,7014,8829,6671,-2158
2016,5,3,20,7186,9074,6879,-2195
2016,5,3,21,7248,9103,6962,-2141
2016,5,3,22,7143,8860,6785,-2075
2016,5,3,23,6892,8501,6446,-2055
2016,5,4,0,6553,8125,6106,-2019
2016,5,4,1,6281,7980,5889,-2091
2016,5,4,2,5805,7436,5411,-2025
2016,5,4,3,5176,6675,4769,-1906
2016,5,4,4,4566,5866,4282,-1584
2016,5,4,5,4366,5284,3986,-1298
2016,5,4,6,3851,4859,3691,-1168
2016,5,4,7,3498,4585,3471,-1114
2016,5,4,8,3324,4464,3369,-1095
2016,5,4,9,3295,4470,3374,-1096
2016,5,4,10,3570,4741,3582,-1159
2016,5,4,11,4129,5285,4002,-1283
2016,5,4,12,4543,5370,4072,-1298
2016,5,4,13,4906,5378,3921,-1457
2016,5,4,14,5246,5552,3874,-1678
2016,5,4,15,5689,5701,3964,-1737
2016,5,4,16,5991,5774,4050,-1724
2016,5,4,17,6160,5767,4033,-1734
2016,5,4,18,6250,5743,3958,-1785
2016,5,4,19,6228,5722,3927,-1795
2016,5,4,20,6135,5733,3911,-1822
2016,5,4,21,6100,5790,3944,-1846
2016,5,4,22,5919,5868,3951,-1917
2016,5,4,23,5764,5866,3879,-1987
2016,5,5,0,5579,5764,3812,-1952
2016,5,5,1,5511,5801,3913,-1888
2016,5,5,2,5107,5536,3758,-1778
2016,5,5,3,4418,4992,3389,-1603
2016,5,5,4,3692,4400,3062,-1338
2016,5,5,5,3367,3912,2843,-1069
2016,5,5,6,3099,3617,2665,-952
2016,5,5,7,2960,3438,2534,-904
2016,5,5,8,2876,3376,2475,-901
2016,5,5,9,2914,3402,2488,-914
2016,5,5,10,3137,3684,2681,-1003
2016,5,5,11,3555,4210,3066,-1144
2016,5,5,12,3757,4510,3304,-1206
2016,5,5,13,3947,4670,3328,-1342
2016,5,5,14,4211,4910,3339,-1571
2016,5,5,15,4475,5185,3548,-1637
2016,5,5,16,4740,5435,3754,-1681
2016,5,5,17,5029,5674,3986,-1688
2016,5,5,18,5289,5931,4212,-1719
2016,5,5,19,5456,6164,4364,-1800
2016,5,5,20,5635,6390,4450,-1940
2016,5,5,21,5716,6543,4558,-1985
2016,5,5,22,5681,6550,4587,-1963
2016,5,5,23,5389,6353,4396,-1957
2016,5,6,0,5066,6003,4195,-1808
2016,5,6,1,5003,5957,4130,-1827
2016,5,6,2,4689,5613,3910,-1703
2016,5,6,3,4184,5046,3478,-1568
2016,5,6,4,3661,4388,3090,-1298
2016,5,6,5,3198,3908,2839,-1069
2016,5,6,6,2884,3585,2619,-966
2016,5,6,7,2762,3381,2452,-929
2016,5,6,8,2698,3323,2402,-921
2016,5,6,9,2708,3361,2431,-930
2016,5,6,10,2883,3654,2636,-1018
2016,5,6,11,3327,4184,2980,-1204
2016,5,6,12,3608,4420,3248,-1172
2016,5,6,13,3757,4567,3252,-1315
2016,5,6,14,3893,4741,3220,-1521
2016,5,6,15,4108,4971,3388,-1583
2016,5,6,16,4249,5091,3494,-1597
2016,5,6,17,4327,5199,3576,-1623
2016,5,6,18,4610,5369,3713,-1656
2016,5,6,19,4830,5542,3853,-1689
2016,5,6,20,5052,5757,4035,-1722
2016,5,6,21,5198,5960,4175,-1785
2016,5,6,22,5193,5980,4178,-1802
2016,5,6,23,4802,5763,3996,-1767
2016,5,7,0,4622,5429,3747,-1682
2016,5,7,1,4595,5388,3690,-1698
2016,5,7,2,4309,5123,3487,-1636
2016,5,7,3,3887,4697,3176,-1521
2016,5,7,4,3418,4221,2886,-1335
2016,5,7,5,3089,3795,2774,-1021
2016,5,7,6,2856,3513,2664,-849
2016,5,7,7,2686,3343,2608,-735
2016,5,7,8,2643,3261,2581,-680
2016,5,7,9,2656,3241,2536,-705
2016,5,7,10,2703,3360,2604,-756
2016,5,7,11,2853,3555,2659,-896
2016,5,7,12,3084,3809,2771,-1038
2016,5,7,13,3448,4227,2910,-1317
2016,5,7,14,3751,4612,3048,-1564
2016,5,7,15,3945,4861,3247,-1614
2016,5,7,16,4027,5013,3379,-1634
2016,5,7,17,4133,5165,3501,-1664
2016,5,7,18,4290,5354,3655,-1699
2016,5,7,19,4460,5600,3842,-1758
2016,5,7,20,4707,5875,4032,-1843
2016,5,7,21,4909,6133,4217,-1916
2016,5,7,22,4988,6265,4305,-1960
2016,5,7,23,4933,6120,4208,-1912
2016,5,8,0,4578,5782,3964,-1818
2016,5,8,1,4473,5655,3833,-1822
2016,5,8,2,4274,5355,3642,-1713
2016,5,8,3,3913,4902,3292,-1610
2016,5,8,4,3528,4355,2986,-1369
2016,5,8,5,3149,3875,2810,-1065
2016,5,8,6,2970,3538,2667,-871
2016,5,8,7,2769,3344,2592,-752
2016,5,8,8,2652,3246,2532,-714
2016,5,8,9,2622,3208,2504,-704
2016,5,8,10,2675,3280,2530,-750
2016,5,8,11,2712,3404,2537,-867
2016,5,8,12,2887,3650,2624,-1026
2016,5,8,13,3270,4187,2876,-1311
2016,5,8,14,3729,4674,3081,-1593
2016,5,8,15,4157,5055,3371,-1684
2016,5,8,16,4430,5386,3631,-1755
2016,5,8,17,4663,5753,3909,-1844
2016,5,8,18,4909,6179,4214,-1965
2016,5,8,19,5174,6664,4546,-2118
2016,5,8,20,5361,7090,4869,-2221
2016,5,8,21,5624,7385,5088,-2297
2016,5,8,22,5670,7483,5191,-2292
2016,5,8,23,5560,7269,5066,-2203
2016,5,9,0,5239,6891,4845,-2046
2016,5,9,1,5230,6600,4576,-2024
2016,5,9,2,4919,6136,4259,-1877
2016,5,9,3,4446,5463,3754,-1709
2016,5,9,4,3847,4674,3264,-1410
2016,5,9,5,3323,4089,2953,-1136
2016,5,9,6,3008,3698,2711,-987
2016,5,9,7,2855,3462,2536,-926
2016,5,9,8,2770,3348,2457,-891
2016,5,9,9,2787,3389,2459,-930
2016,5,9,10,3048,3694,2672,-1022
2016,5,9,11,3456,4214,3047,-1167
2016,5,9,12,3603,4480,3283,-1197
2016,5,9,13,3861,4796,3431,-1365
2016,5,9,14,4193,5146,3508,-1638
2016,5,9,15,4517,5549,3811,-1738
2016,5,9,16,4831,6022,4181,-1841
2016,5,9,17,5194,6495,4516,-1979
2016,5,9,18,5597,7005,4830,-2175
2016,5,9,19,5925,7499,5295,-2204
2016,5,9,20,6208,7920,5673,-2247
2016,5,9,21,6426,8231,6026,-2205
2016,5,9,22,6462,8358,6120,-2238
2016,5,9,23,6302,8152,5992,-2160
2016,5,10,0,5931,7647,5547,-2100
2016,5,10,1,5689,7354,5260,-2094
2016,5,10,2,5323,6782,4771,-2011
2016,5,10,3,4742,6013,4199,-1814
2016,5,10,4,4144,5192,3670,-1522
2016,5,10,5,3652,4556,3331,-1225
2016,5,10,6,3331,4147,3174,-973
2016,5,10,7,3141,3884,2972,-912
2016,5,10,8,3038,3753,2867,-886
2016,5,10,9,3009,3770,2874,-896
2016,5,10,10,3224,4034,3059,-975
2016,5,10,11,3589,4575,3362,-1213
2016,5,10,12,3868,4834,3591,-1243
2016,5,10,13,4129,5087,3665,-1422
2016,5,10,14,4476,5442,3763,-1679
2016,5,10,15,4933,5941,4099,-1842
2016,5,10,16,5322,6410,4438,-1972
2016,5,10,17,5654,6840,4810,-2030
2016,5,10,18,6051,7304,5170,-2134
2016,5,10,19,6356,7747,5578,-2169
2016,5,10,20,6618,8076,5908,-2168
2016,5,10,21,6791,8402,6168,-2234
2016,5,10,22,6736,8433,6216,-2217
2016,5,10,23,6547,8077,5866,-2211
2016,5,11,0,6101,7631,5352,-2279
2016,5,11,1,5857,7434,5165,-2269
2016,5,11,2,5407,6900,4806,-2094
2016,5,11,3,4845,6189,4289,-1900
2016,5,11,4,4247,5381,3811,-1570
2016,5,11,5,-9999,4770,3503,-1267
2016,5,11,6,-9999,4399,3282,-1117
2016,5,11,7,-9999,4188,3127,-1061
2016,5,11,8,-9999,4057,3025,-1032
2016,5,11,9,-9999,4042,2992,-1050
2016,5,11,10,-9999,4275,3158,-1117
2016,5,11,11,-9999,4811,3505,-1306
2016,5,11,12,-9999,5077,3760,-1317
2016,5,11,13,-9999,5380,3885,-1495
2016,5,11,14,-9999,5842,4054,-1788
2016,5,11,15,-9999,6468,4549,-1919
2016,5,11,16,-9999,7040,4970,-2070
2016,5,11,17,-9999,7598,5378,-2220
2016,5,11,18,-9999,8050,5728,-2322
2016,5,11,19,-9999,8501,6149,-2352
2016,5,11,20,-9999,8754,6473,-2281
2016,5,11,21,-9999,8925,6561,-2364
2016,5,11,22,-9999,8909,6619,-2290
2016,5,11,23,-9999,8692,6393,-2299
2016,5,12,0,-9999,8187,5929,-2258
2016,5,12,1,-9999,7966,5700,-2266
2016,5,12,2,-9999,7322,5078,-2244
2016,5,12,3,-9999,6513,4513,-2000
2016,5,12,4,-9999,5678,4059,-1619
2016,5,12,5,3948,5026,3699,-1327
2016,5,12,6,3603,4571,3403,-1168
2016,5,12,7,3382,4298,3171,-1127
2016,5,12,8,3265,4120,3037,-1083
2016,5,12,9,3245,4121,3030,-1091
2016,5,12,10,3424,4362,3209,-1153
2016,5,12,11,3826,4915,3593,-1322
2016,5,12,12,4093,5173,3899,-1274
2016,5,12,13,4387,5427,3985,-1442
2016,5,12,14,4790,5858,4118,-1740
2016,5,12,15,5248,6339,4456,-1883
2016,5,12,16,5654,6804,4907,-1897
2016,5,12,17,6047,7353,5272,-2081
2016,5,12,18,6493,7820,5699,-2121
2016,5,12,19,6808,8216,5986,-2230
2016,5,12,20,7059,8576,6356,-2220
2016,5,12,21,7184,8777,6500,-2277
2016,5,12,22,7104,8803,6483,-2320
2016,5,12,23,6883,8581,6293,-2288
2016,5,13,0,6496,7824,5508,-2316
2016,5,13,1,6182,7832,5486,-2346
2016,5,13,2,5761,7279,5074,-2205
2016,5,13,3,5165,6512,4561,-1951
2016,5,13,4,4553,5713,4098,-1615
2016,5,13,5,4040,5060,3727,-1333
2016,5,13,6,3685,4586,3343,-1243
2016,5,13,7,3449,4278,3121,-1157
2016,5,13,8,3321,4098,2994,-1104
2016,5,13,9,3321,4046,2903,-1143
2016,5,13,10,3479,4269,3065,-1204
2016,5,13,11,3847,4800,3465,-1335
2016,5,13,12,4112,5097,3737,-1360
2016,5,13,13,4433,5538,3943,-1595
2016,5,13,14,4831,6101,4249,-1852
2016,5,13,15,5374,6753,4720,-2033
2016,5,13,16,5824,7357,5177,-2180
2016,5,13,17,6205,7964,5673,-2291
2016,5,13,18,6583,8507,6168,-2339
2016,5,13,19,6921,8948,6562,-2386
2016,5,13,20,7189,9249,6791,-2458
2016,5,13,21,7324,9410,6892,-2518
2016,5,13,22,7273,9278,6755,-2523
2016,5,13,23,7059,8851,6326,-2525
2016,5,14,0,6675,8250,5804,-2446
2016,5,14,1,6348,7856,5520,-2336
2016,5,14,2,5890,7349,5120,-2229
2016,5,14,3,5241,6683,4742,-1941
2016,5,14,4,4629,5944,4404,-1540
2016,5,14,5,4139,5296,3870,-1426
2016,5,14,6,3725,4834,3525,-1309
2016,5,14,7,3444,4501,3276,-1225
2016,5,14,8,3264,4277,3106,-1171
2016,5,14,9,3183,4167,3041,-1126
2016,5,14,10,3187,4187,3018,-1169
2016,5,14,11,3245,4318,3115,-1203
2016,5,14,12,3440,4597,3353,-1244
2016,5,14,13,3948,5318,3793,-1525
2016,5,14,14,4469,6027,4158,-1869
2016,5,14,15,4963,6737,4691,-2046
2016,5,14,16,5421,7330,5149,-2181
2016,5,14,17,5830,7883,5545,-2338
2016,5,14,18,6220,8361,5748,-2613
2016,5,14,19,6458,8706,6109,-2597
2016,5,14,20,6672,8951,6327,-2624
2016,5,14,21,6877,9073,6472,-2601
2016,5,14,22,6801,8993,6350,-2643
2016,5,14,23,6530,8625,6046,-2579
2016,5,15,0,6003,7997,5515,-2482
2016,5,15,1,5725,7496,5266,-2230
2016,5,15,2,5360,6875,4812,-2063
2016,5,15,3,4868,6191,4298,-1893
2016,5,15,4,4382,5429,3846,-1583
2016,5,15,5,3895,4739,3430,-1309
2016,5,15,6,3507,4238,3048,-1190
2016,5,15,7,3223,3910,2793,-1117
2016,5,15,8,3072,3741,2660,-1081
2016,5,15,9,2950,3645,2621,-1024
2016,5,15,10,2937,3644,2561,-1083
2016,5,15,11,3005,3709,2596,-1113
2016,5,15,12,3185,3925,2843,-1082
2016,5,15,13,3689,4595,3203,-1392
2016,5,15,14,4257,5304,3805,-1499
2016,5,15,15,4762,5902,4238,-1664
2016,5,15,16,5218,6526,4702,-1824
2016,5,15,17,5613,7167,5154,-2013
2016,5,15,18,6075,7710,5606,-2104
2016,5,15,19,6414,8123,6027,-2096
2016,5,15,20,6669,8420,6327,-2093
2016,5,15,21,6795,8660,6498,-2162
2016,5,15,22,6867,8752,6562,-2190
2016,5,15,23,6718,8551,6344,-2207
2016,5,16,0,6298,8019,5842,-2177
2016,5,16,1,6040,7628,5494,-2134
2016,5,16,2,5583,7027,5029,-1998
2016,5,16,3,4989,6245,4478,-1767
2016,5,16,4,4380,5426,3814,-1612
2016,5,16,5,3833,4740,3418,-1322
2016,5,16,6,3463,4282,3119,-1163
2016,5,16,7,3256,3997,2897,-1100
2016,5,16,8,3131,3868,2803,-1065
2016,5,16,9,3132,3896,2829,-1067
2016,5,16,10,3334,4165,3039,-1126
2016,5,16,11,3741,4685,3404,-1281
2016,5,16,12,4006,5040,3751,-1289
2016,5,16,13,4303,5487,3975,-1512
2016,5,16,14,4700,6072,4239,-1833
2016,5,16,15,5237,6826,4837,-1989
2016,5,16,16,5719,7548,5400,-2148
2016,5,16,17,6181,8162,5848,-2314
2016,5,16,18,6619,8652,6190,-2462
2016,5,16,19,7007,8895,6425,-2470
2016,5,16,20,7305,8958,6556,-2402
2016,5,16,21,7454,8888,6520,-2368
2016,5,16,22,7478,8677,6335,-2342
2016,5,16,23,7369,8251,5892,-2359
2016,5,17,0,6939,7860,5540,-2320
2016,5,17,1,6640,7634,5431,-2203
2016,5,17,2,6144,7084,4984,-2100
2016,5,17,3,5471,6389,4481,-1908
2016,5,17,4,4832,5686,4073,-1613
2016,5,17,5,4155,5137,3779,-1358
2016,5,17,6,3800,4787,3578,-1209
2016,5,17,7,3580,4414,3238,-1176
2016,5,17,8,3437,4395,3255,-1140
2016,5,17,9,3416,4408,3270,-1138
2016,5,17,10,3614,4658,3435,-1223
2016,5,17,11,4001,5256,3869,-1387
2016,5,17,12,4263,5508,4142,-1366
2016,5,17,13,4548,5787,4214,-1573
2016,5,17,14,4972,6237,4384,-1853
2016,5,17,15,5475,6811,4861,-1950
2016,5,17,16,5975,7467,5436,-2031
2016,5,17,17,6353,7989,5768,-2221
2016,5,17,18,6742,8335,6114,-2221
2016,5,17,19,6957,8558,6342,-2216
2016,5,17,20,7150,8499,6444,-2055
2016,5,17,21,7240,8239,6264,-1975
2016,5,17,22,7140,7879,5908,-1971
2016,5,17,23,6897,7370,5413,-1957
2016,5,18,0,6518,6986,4980,-2006
2016,5,18,1,6320,6689,4770,-1919
2016,5,18,2,5896,6230,4417,-1813
2016,5,18,3,5261,5710,3972,-1738
2016,5,18,4,4695,5049,3567,-1482
2016,5,18,5,3843,4567,3353,-1214
2016,5,18,6,3558,4230,3158,-1072
2016,5,18,7,3373,4032,3017,-1015
2016,5,18,8,3271,3904,2896,-1008
2016,5,18,9,3306,3936,2913,-1023
2016,5,18,10,3504,4228,3118,-1110
2016,5,18,11,3885,4819,3532,-1287
2016,5,18,12,4172,5127,3804,-1323
2016,5,18,13,4436,5403,3915,-1488
2016,5,18,14,4774,5844,4073,-1771
2016,5,18,15,5222,6419,4542,-1877
2016,5,18,16,5663,7051,5013,-2038
2016,5,18,17,5988,7718,5401,-2317
2016,5,18,18,6295,8357,6082,-2275
2016,5,18,19,6535,8804,6531,-2273
2016,5,18,20,6667,9101,6796,-2305
2016,5,18,21,6631,9369,7003,-2366
2016,5,18,22,6496,9451,7051,-2400
2016,5,18,23,6213,9203,6838,-2365
2016,5,19,0,5896,8692,6291,-2401
2016,5,19,1,5754,8316,6013,-2303
2016,5,19,2,5467,7737,5566,-2171
2016,5,19,3,4972,6954,4969,-1985
2016,5,19,4,4478,6161,4447,-1714
2016,5,19,5,3940,5458,4070,-1388
2016,5,19,6,3639,5000,3770,-1230
2016,5,19,7,3425,4693,3555,-1138
2016,5,19,8,3327,4519,3415,-1104
2016,5,19,9,3332,4496,3365,-1131
2016,5,19,10,3534,4702,3514,-1188
2016,5,19,11,3900,5259,3900,-1359
2016,5,19,12,4182,5557,4216,-1341
2016,5,19,13,4485,5924,4344,-1580
2016,5,19,14,4918,6426,4559,-1867
2016,5,19,15,5461,7025,5008,-2017
2016,5,19,16,5920,7609,5445,-2164
2016,5,19,17,6387,8168,5843,-2325
2016,5,19,18,6804,8639,6255,-2384
2016,5,19,19,7111,9067,6584,-2483
2016,5,19,20,7337,9214,6754,-2460
2016,5,19,21,7450,9165,6693,-2472
2016,5,19,22,7355,9196,6689,-2507
2016,5,19,23,7083,9040,6601,-2439
2016,5,20,0,6712,8588,6272,-2316
2016,5,20,1,6438,8248,5988,-2260
2016,5,20,2,6015,7702,5550,-2152
2016,5,20,3,5426,6915,4891,-2024
2016,5,20,4,4855,6065,4299,-1766
2016,5,20,5,4280,5356,3881,-1475
2016,5,20,6,3952,4888,3561,-1327
2016,5,20,7,3707,4584,3322,-1262
2016,5,20,8,3585,4425,3223,-1202
2016,5,20,9,3549,4382,3214,-1168
2016,5,20,10,3743,4591,3323,-1268
2016,5,20,11,4114,5125,3717,-1408
2016,5,20,12,4396,5480,4091,-1389
2016,5,20,13,4729,5908,4320,-1588
2016,5,20,14,5225,6523,4617,-1906
2016,5,20,15,5898,7248,5163,-2085
2016,5,20,16,6422,7822,5671,-2151
2016,5,20,17,6861,7866,5761,-2105
2016,5,20,18,7209,7717,5697,-2020
2016,5,20,19,7516,7448,5418,-2030
2016,5,20,20,7716,7769,5624,-2145
2016,5,20,21,7763,8233,5981,-2252
2016,5,20,22,7644,8328,6025,-2303
2016,5,20,23,7397,8020,5761,-2259
2016,5,21,0,6954,7541,5396,-2145
2016,5,21,1,6664,7346,5245,-2101
2016,5,21,2,6203,6876,4933,-1943
2016,5,21,3,5623,6297,4628,-1669
2016,5,21,4,5034,5618,4252,-1366
2016,5,21,5,4500,5048,3990,-1058
2016,5,21,6,4121,4633,3650,-983
2016,5,21,7,3852,4370,3449,-921
2016,5,21,8,3686,4207,3259,-948
2016,5,21,9,3588,4125,3195,-930
2016,5,21,10,3606,4137,3199,-938
2016,5,21,11,3629,4267,3290,-977
2016,5,21,12,3822,4470,3419,-1051
2016,5,21,13,4333,5133,3897,-1236
2016,5,21,14,4965,5805,4208,-1597
2016,5,21,15,5548,6519,4778,-1741
2016,5,21,16,5998,7100,5234,-1866
2016,5,21,17,6431,7644,5651,-1993
2016,5,21,18,6600,8118,6022,-2096
2016,5,21,19,6786,8467,6154,-2313
2016,5,21,20,6879,8725,6323,-2402
2016,5,21,21,6921,8874,6403,-2471
2016,5,21,22,6791,8838,6385,-2453
2016,5,21,23,6584,8517,6243,-2274
2016,5,22,0,6140,7929,5952,-1977
2016,5,22,1,5867,7453,5539,-1914
2016,5,22,2,5559,6993,5159,-1834
2016,5,22,3,5067,6354,4661,-1693
2016,5,22,4,4611,5682,4297,-1385
2016,5,22,5,4127,5096,3948,-1148
2016,5,22,6,3792,4654,3588,-1066
2016,5,22,7,3538,4366,3370,-996
2016,5,22,8,3404,4195,3224,-971
2016,5,22,9,3307,4122,3165,-957
2016,5,22,10,3297,4109,3154,-955
2016,5,22,11,3310,4196,3209,-987
2016,5,22,12,3506,4476,3414,-1062
2016,5,22,13,4055,5225,3886,-1339
2016,5,22,14,4665,6010,4348,-1662
2016,5,22,15,5249,6683,4920,-1763
2016,5,22,16,5723,7302,5378,-1924
2016,5,22,17,6017,7773,5772,-2001
2016,5,22,18,6357,8142,6072,-2070
2016,5,22,19,6602,8405,6166,-2239
2016,5,22,20,6695,8497,6225,-2272
2016,5,22,21,6715,8572,6236,-2336
2016,5,22,22,6658,8410,6142,-2268
2016,5,22,23,6483,8018,5849,-2169
2016,5,23,0,6076,7517,5489,-2028
2016,5,23,1,5793,7279,5400,-1879
2016,5,23,2,5389,6799,5023,-1776
2016,5,23,3,4886,6087,4482,-1605
2016,5,23,4,4334,5366,4074,-1292
2016,5,23,5,3794,4755,3676,-1079
2016,5,23,6,3428,4280,3313,-967
2016,5,23,7,3202,4004,3106,-898
2016,5,23,8,3078,3856,2965,-891
2016,5,23,9,3088,3845,2960,-885
2016,5,23,10,3255,4085,3132,-953
2016,5,23,11,3646,4588,3603,-985
2016,5,23,12,3919,4933,3898,-1035
2016,5,23,13,4204,5390,4155,-1235
2016,5,23,14,4600,5902,4385,-1517
2016,5,23,15,5038,6455,4825,-1630
2016,5,23,16,5495,7024,5275,-1749
2016,5,23,17,5904,7548,5669,-1879
2016,5,23,18,6287,8023,6092,-1931
2016,5,23,19,6580,8449,6483,-1966
2016,5,23,20,6803,8766,6627,-2139
2016,5,23,21,6969,8993,6771,-2222
2016,5,23,22,6873,9017,6714,-2303
2016,5,23,23,6512,8749,6550,-2199
2016,5,24,0,6138,8205,6151,-2054
2016,5,24,1,5803,7718,5774,-1944
2016,5,24,2,5421,7098,5259,-1839
2016,5,24,3,4851,6249,4634,-1615
2016,5,24,4,4274,5399,4113,-1286
2016,5,24,5,3846,4734,3743,-991
2016,5,24,6,3497,4288,3392,-896
2016,5,24,7,3273,3996,3146,-850
2016,5,24,8,3155,3834,3028,-806
2016,5,24,9,3166,3804,3003,-801
2016,5,24,10,3309,4061,3178,-883
2016,5,24,11,3696,4547,3569,-978
2016,5,24,12,3960,4879,3889,-990
2016,5,24,13,4225,5308,4097,-1211
2016,5,24,14,4591,5850,4393,-1457
2016,5,24,15,5103,6511,4899,-1612
2016,5,24,16,5539,7152,5377,-1775
2016,5,24,17,6002,7742,5819,-1923
2016,5,24,18,6438,8298,6227,-2071
2016,5,24,19,6765,8621,6455,-2166
2016,5,24,20,7013,8750,6440,-2310
2016,5,24,21,7194,8864,6549,-2315
2016,5,24,22,7150,8885,6642,-2243
2016,5,24,23,6804,8654,6452,-2202
2016,5,25,0,6410,8095,5968,-2127
2016,5,25,1,6185,7683,5676,-2007
2016,5,25,2,5728,7186,5305,-1881
2016,5,25,3,5124,6406,4723,-1683
2016,5,25,4,4545,5609,4234,-1375
2016,5,25,5,3993,4948,3834,-1114
2016,5,25,6,3642,4508,3484,-1024
2016,5,25,7,3420,4230,3289,-941
2016,5,25,8,3278,4068,3152,-916
2016,5,25,9,3255,4056,3144,-912
2016,5,25,10,3453,4303,3311,-992
2016,5,25,11,3815,4816,3742,-1074
2016,5,25,12,4063,5146,4092,-1054
2016,5,25,13,4370,5575,4320,-1255
2016,5,25,14,4791,6139,4556,-1583
2016,5,25,15,5263,6814,5064,-1750
2016,5,25,16,5743,7438,5568,-1870
2016,5,25,17,6130,8002,5978,-2024
2016,5,25,18,6502,8486,6370,-2116
2016,5,25,19,6801,8900,6632,-2268
2016,5,25,20,7091,9128,6798,-2330
2016,5,25,21,7285,9247,6903,-2344
2016,5,25,22,7252,9141,6906,-2235
2016,5,25,23,6915,8829,6640,-2189
2016,5,26,0,6565,8269,6207,-2062
2016,5,26,1,6197,7815,5817,-1998
2016,5,26,2,5752,7288,5389,-1899
2016,5,26,3,5160,6437,4786,-1651
2016,5,26,4,4517,5602,4188,-1414
2016,5,26,5,3953,4883,3782,-1101
2016,5,26,6,3577,4446,3446,-1000
2016,5,26,7,3346,4147,3212,-935
2016,5,26,8,3209,3990,3095,-895
2016,5,26,9,3178,3938,3051,-887
2016,5,26,10,3359,4168,3192,-976
2016,5,26,11,3728,4628,3570,-1058
2016,5,26,12,4014,4945,3912,-1033
2016,5,26,13,4317,5317,4092,-1225
2016,5,26,14,4697,5824,4293,-1531
2016,5,26,15,5130,6426,4711,-1715
2016,5,26,16,5617,6966,5285,-1681
2016,5,26,17,5933,7508,5679,-1829
2016,5,26,18,6320,8057,6099,-1958
2016,5,26,19,6688,8447,6390,-2057
2016,5,26,20,6920,8764,6646,-2118
2016,5,26,21,7082,8970,6895,-2075
2016,5,26,22,6937,8958,6900,-2058
2016,5,26,23,6576,8662,6654,-2008
2016,5,27,0,6177,8152,6230,-1922
2016,5,27,1,5955,7770,5843,-1927
2016,5,27,2,5558,7271,5384,-1887
2016,5,27,3,5002,6491,4771,-1720
2016,5,27,4,4411,5692,4284,-1408
2016,5,27,5,3772,5024,3898,-1126
2016,5,27,6,3419,4514,3506,-1008
2016,5,27,7,3186,4219,3278,-941
2016,5,27,8,3045,4044,3151,-893
2016,5,27,9,3043,3992,3109,-883
2016,5,27,10,3236,4221,3278,-943
2016,5,27,11,3626,4670,3510,-1160
2016,5,27,12,3911,4998,3738,-1260
2016,5,27,13,4233,5466,4033,-1433
2016,5,27,14,4646,6028,4295,-1733
2016,5,27,15,5140,6625,4701,-1924
2016,5,27,16,5542,7178,5124,-2054
2016,5,27,17,5931,7701,5497,-2204
2016,5,27,18,6301,8151,5775,-2376
2016,5,27,19,6595,8502,5977,-2525
2016,5,27,20,6834,8777,6182,-2595
2016,5,27,21,6989,8891,6236,-2655
2016,5,27,22,6924,8782,6115,-2667
2016,5,27,23,6586,8448,5824,-2624
2016,5,28,0,6169,7978,5562,-2416
2016,5,28,1,5902,7628,5360,-2268
2016,5,28,2,5574,7245,5068,-2177
2016,5,28,3,5073,6652,4557,-2095
2016,5,28,4,4523,5979,4248,-1731
2016,5,28,5,4090,5331,3982,-1349
2016,5,28,6,3750,4851,3609,-1242
2016,5,28,7,3460,4504,3333,-1171
2016,5,28,8,3319,4287,3172,-1115
2016,5,28,9,3235,4169,3086,-1083
2016,5,28,10,3250,4181,3076,-1105
2016,5,28,11,3309,4234,3082,-1152
2016,5,28,12,3519,4552,3321,-1231
2016,5,28,13,4048,5261,3743,-1518
2016,5,28,14,4637,6070,4188,-1882
2016,5,28,15,5172,6819,4737,-2082
2016,5,28,16,5602,7505,5266,-2239
2016,5,28,17,5990,8114,5702,-2412
2016,5,28,18,6343,8606,6094,-2512
2016,5,28,19,6637,8978,6403,-2575
2016,5,28,20,6785,9199,6562,-2637
2016,5,28,21,6832,9355,6651,-2704
2016,5,28,22,6775,9318,6651,-2667
2016,5,28,23,6521,9062,6546,-2516
2016,5,29,0,6054,8500,6019,-2481
2016,5,29,1,5763,8029,5677,-2352
2016,5,29,2,5475,7542,5282,-2260
2016,5,29,3,5047,6895,4815,-2080
2016,5,29,4,4552,6209,4404,-1805
2016,5,29,5,4234,5553,4110,-1443
2016,5,29,6,3832,5024,3709,-1315
2016,5,29,7,3573,4687,3445,-1242
2016,5,29,8,3435,4443,3268,-1175
2016,5,29,9,3361,4285,3169,-1116
2016,5,29,10,3341,4258,3093,-1165
2016,5,29,11,3339,4287,3111,-1176
2016,5,29,12,3539,4568,3324,-1244
2016,5,29,13,4091,5349,3793,-1556
2016,5,29,14,4853,6184,4239,-1945
2016,5,29,15,5415,6993,4864,-2129
2016,5,29,16,5870,7722,5417,-2305
2016,5,29,17,6268,8283,5829,-2454
2016,5,29,18,6608,8537,6080,-2457
2016,5,29,19,6799,8708,6352,-2356
2016,5,29,20,6962,8812,6567,-2245
2016,5,29,21,6978,8761,6472,-2289
2016,5,29,22,6935,8631,6284,-2347
2016,5,29,23,6588,8266,5885,-2381
2016,5,30,0,6262,7751,5449,-2302
2016,5,30,1,6019,7387,5164,-2223
2016,5,30,2,5661,6970,4842,-2128
2016,5,30,3,5191,6438,4438,-2000
2016,5,30,4,4682,5806,4082,-1724
2016,5,30,5,4151,5184,3791,-1393
2016,5,30,6,3745,4723,3447,-1276
2016,5,30,7,3535,4414,3201,-1213
2016,5,30,8,3356,4213,3039,-1174
2016,5,30,9,3329,4130,2963,-1167
2016,5,30,10,3326,4165,2993,-1172
2016,5,30,11,3394,4265,3083,-1182
2016,5,30,12,3572,4530,3272,-1258
2016,5,30,13,4115,5287,3734,-1553
2016,5,30,14,4830,6215,4266,-1949
2016,5,30,15,5527,7165,4950,-2215
2016,5,30,16,6195,7986,5555,-2431
2016,5,30,17,6527,8606,6063,-2543
2016,5,30,18,6876,8927,6217,-2710
2016,5,30,19,7142,9174,6562,-2612
2016,5,30,20,7349,9384,6814,-2570
2016,5,30,21,7430,9495,6935,-2560
2016,5,30,22,7368,9309,6801,-2508
2016,5,30,23,7154,8867,6375,-2492
2016,5,31,0,6718,8411,6049,-2362
2016,5,31,1,6496,8084,5744,-2340
2016,5,31,2,6086,7513,5275,-2238
2016,5,31,3,5545,6735,4670,-2065
2016,5,31,4,4935,5685,3984,-1701
2016,5,31,5,4196,5233,3885,-1348
2016,5,31,6,3809,4772,3537,-1235
2016,5,31,7,3600,4492,3288,-1204
2016,5,31,8,3447,4306,3171,-1135
2016,5,31,9,3455,4282,3157,-1125
2016,5,31,10,3627,4506,3335,-1171
2016,5,31,11,4040,4989,3724,-1265
2016,5,31,12,4338,5371,4017,-1354
2016,5,31,13,4753,5898,4296,-1602
2016,5,31,14,5301,6549,4612,-1937
2016,5,31,15,5890,7362,5223,-2139
2016,5,31,16,6467,8153,5806,-2347
2016,5,31,17,6856,8839,6436,-2403
2016,5,31,18,7275,9377,6850,-2527
2016,5,31,19,7621,9749,7190,-2559
2016,5,31,20,7745,9965,7400,-2565
2016,5,31,21,7829,9957,7449,-2508
2016,5,31,22,7681,9863,7420,-2443
2016,5,31,23,7516,9491,7066,-2425
2016,6,1,0,7149,8901,6529,-2372
2016,6,1,1,6837,8386,6164,-2222
2016,6,1,2,6382,7788,5643,-2145
2016,6,1,3,5741,6990,4933,-2057
2016,6,1,4,5103,6142,4425,-1717
2016,6,1,5,4503,5413,4066,-1347
2016,6,1,6,4111,4957,3689,-1268
2016,6,1,7,3837,4668,3462,-1206
2016,6,1,8,3670,4496,3349,-1147
2016,6,1,9,3594,4446,3303,-1143
2016,6,1,10,3744,4628,3423,-1205
2016,6,1,11,4094,5071,3780,-1291
2016,6,1,12,4369,5445,3997,-1448
2016,6,1,13,4733,5950,4401,-1549
2016,6,1,14,5235,6621,4804,-1817
2016,6,1,15,5946,7397,5353,-2044
2016,6,1,16,6500,8168,5929,-2239
2016,6,1,17,6922,8867,6467,-2400
2016,6,1,18,7407,9458,6973,-2485
2016,6,1,19,7714,9858,7400,-2458
2016,6,1,20,7999,10066,7595,-2471
2016,6,1,21,8099,10106,7565,-2541
2016,6,1,22,7918,9899,7427,-2472
2016,6,1,23,7728,9476,6977,-2499
2016,6,2,0,7266,8927,6434,-2493
2016,6,2,1,6917,8504,6082,-2422
2016,6,2,2,6476,8039,5733,-2306
2016,6,2,3,5829,7244,5231,-2013
2016,6,2,4,5174,6429,4691,-1738
2016,6,2,5,4553,5719,4132,-1587
2016,6,2,6,4167,5179,3695,-1484
2016,6,2,7,3910,4810,3446,-1364
2016,6,2,8,3748,4605,3333,-1272
2016,6,2,9,3707,4553,3291,-1262
2016,6,2,10,3857,4766,3416,-1350
2016,6,2,11,4201,5187,3700,-1487
2016,6,2,12,4473,5554,4072,-1482
2016,6,2,13,4868,6098,4524,-1574
2016,6,2,14,5471,6835,5083,-1752
2016,6,2,15,6084,7616,5711,-1905
2016,6,2,16,6656,8389,6161,-2228
2016,6,2,17,7241,9124,6691,-2433
2016,6,2,18,7568,9678,7176,-2502
2016,6,2,19,7827,10081,7544,-2537
2016,6,2,20,8045,10289,7722,-2567
2016,6,2,21,8171,10416,7818,-2598
2016,6,2,22,8031,10393,7798,-2595
2016,6,2,23,7794,10145,7561,-2584
2016,6,3,0,7298,9619,7041,-2578
2016,6,3,1,6953,9200,6655,-2545
2016,6,3,2,6472,8623,6286,-2337
2016,6,3,3,5856,7803,5720,-2083
2016,6,3,4,5206,6917,5032,-1885
2016,6,3,5,4712,6333,4652,-1681
2016,6,3,6,4324,5785,4221,-1564
2016,6,3,7,4035,5358,3917,-1441
2016,6,3,8,3910,5106,3720,-1386
2016,6,3,9,3837,4997,3631,-1366
2016,6,3,10,3964,5171,3766,-1405
2016,6,3,11,4248,5600,4059,-1541
2016,6,3,12,4546,6068,4508,-1560
2016,6,3,13,4956,6709,5074,-1635
2016,6,3,14,5569,7438,5517,-1921
2016,6,3,15,6180,8261,6115,-2146
2016,6,3,16,6666,9060,6626,-2434
2016,6,3,17,7113,9758,7183,-2575
2016,6,3,18,7490,10278,7688,-2590
2016,6,3,19,7762,10638,7940,-2698
2016,6,3,20,7890,10779,7997,-2782
2016,6,3,21,7940,10697,8003,-2694
2016,6,3,22,7765,10425,7845,-2579
2016,6,3,23,7539,9942,7519,-2422
2016,6,4,0,7116,9393,6956,-2437
2016,6,4,1,6767,8969,6646,-2323
2016,6,4,2,6354,8478,6164,-2314
2016,6,4,3,5841,7804,5703,-2101
2016,6,4,4,5253,7058,5161,-1896
2016,6,4,5,4723,6220,4581,-1638
2016,6,4,6,4338,5688,4172,-1516
2016,6,4,7,4055,5292,3877,-1415
2016,6,4,8,3883,5055,3673,-1382
2016,6,4,9,3777,4897,3544,-1353
2016,6,4,10,3796,4864,3507,-1357
2016,6,4,11,3777,4906,3498,-1408
2016,6,4,12,3989,5253,3783,-1470
2016,6,4,13,4540,6080,4435,-1645
2016,6,4,14,5209,7004,5058,-1946
2016,6,4,15,5744,7912,5764,-2148
2016,6,4,16,6246,8698,6306,-2392
2016,6,4,17,6756,9341,6709,-2632
2016,6,4,18,7035,9818,7056,-2762
2016,6,4,19,7194,10142,7360,-2782
2016,6,4,20,7364,10298,7448,-2850
2016,6,4,21,7433,10326,7501,-2825
2016,6,4,22,7323,10242,7433,-2809
2016,6,4,23,7098,9951,7214,-2737
2016,6,5,0,6656,9411,6659,-2752
2016,6,5,1,6321,8923,6417,-2506
2016,6,5,2,5983,8449,6035,-2414
2016,6,5,3,5537,7772,5442,-2330
2016,6,5,4,5037,7019,5012,-2007
2016,6,5,5,4713,6339,4610,-1729
2016,6,5,6,4314,5806,4182,-1624
2016,6,5,7,4032,5433,3925,-1508
2016,6,5,8,3816,5134,3688,-1446
2016,6,5,9,3714,4954,3541,-1413
2016,6,5,10,3690,4878,3469,-1409
2016,6,5,11,3616,4879,3429,-1450
2016,6,5,12,3856,5208,3711,-1497
2016,6,5,13,4464,6090,4319,-1771
2016,6,5,14,5175,7020,4989,-2031
2016,6,5,15,5795,7865,5559,-2306
2016,6,5,16,6319,8589,6107,-2482
2016,6,5,17,6779,9188,6589,-2599
2016,6,5,18,7141,9449,6888,-2561
2016,6,5,19,7370,9520,7006,-2514
2016,6,5,20,7548,9398,6974,-2424
2016,6,5,21,7665,9047,6663,-2384
2016,6,5,22,7559,8647,6260,-2387
2016,6,5,23,7263,8196,5814,-2382
2016,6,6,0,7018,7731,5432,-2299
2016,6,6,1,6638,7504,5218,-2286
2016,6,6,2,6277,7073,4833,-2240
2016,6,6,3,5773,6525,4468,-2057
2016,6,6,4,5169,5799,4016,-1783
2016,6,6,5,4719,5290,3755,-1535
2016,6,6,6,4340,4921,3451,-1470
2016,6,6,7,4095,4722,3339,-1383
2016,6,6,8,3935,4571,3212,-1359
2016,6,6,9,3917,4577,3222,-1355
2016,6,6,10,4008,4773,3400,-1373
2016,6,6,11,4395,5285,3773,-1512
2016,6,6,12,4635,5595,4063,-1532
2016,6,6,13,4992,5841,4235,-1606
2016,6,6,14,5407,6186,4431,-1755
2016,6,6,15,5959,6635,4705,-1930
2016,6,6,16,6248,6997,4879,-2118
2016,6,6,17,6246,7258,5032,-2226
2016,6,6,18,6324,7319,5085,-2234
2016,6,6,19,6319,7270,5080,-2190
2016,6,6,20,6295,7289,5103,-2186
2016,6,6,21,6327,7193,4984,-2209
2016,6,6,22,6202,6779,4549,-2230
2016,6,6,23,6356,6957,4729,-2228
2016,6,7,0,6047,6870,4658,-2212
2016,6,7,1,5885,6875,4643,-2232
2016,6,7,2,5560,6667,4534,-2133
2016,6,7,3,5137,6262,4257,-2005
2016,6,7,4,4644,5727,3989,-1738
2016,6,7,5,4203,5317,3780,-1537
2016,6,7,6,3932,5064,3575,-1489
2016,6,7,7,3791,4924,3499,-1425
2016,6,7,8,3666,4856,3448,-1408
2016,6,7,9,3700,4886,3474,-1412
2016,6,7,10,3835,5102,3637,-1465
2016,6,7,11,4269,5589,4009,-1580
2016,6,7,12,4545,5896,4373,-1523
2016,6,7,13,4998,6120,4556,-1564
2016,6,7,14,5488,6455,4700,-1755
2016,6,7,15,6027,6864,4839,-2025
2016,6,7,16,6440,7366,5103,-2263
2016,6,7,17,6753,7838,5494,-2344
2016,6,7,18,6987,8371,5949,-2422
2016,6,7,19,7079,8859,6423,-2436
2016,6,7,20,7228,9213,6731,-2482
2016,6,7,21,7285,9410,6897,-2513
2016,6,7,22,7252,9413,6899,-2514
2016,6,7,23,6935,9250,6750,-2500
2016,6,8,0,6617,8801,6424,-2377
2016,6,8,1,6381,8381,6034,-2347
2016,6,8,2,6061,7891,5664,-2227
2016,6,8,3,5553,7203,5082,-2121
2016,6,8,4,5022,6447,4631,-1816
2016,6,8,5,4519,5748,4195,-1553
2016,6,8,6,4192,5251,3779,-1472
2016,6,8,7,3991,4975,3621,-1354
2016,6,8,8,3872,4833,3508,-1325
2016,6,8,9,3843,4823,3505,-1318
2016,6,8,10,3997,5055,3692,-1363
2016,6,8,11,4334,5514,4014,-1500
2016,6,8,12,4663,5870,4316,-1554
2016,6,8,13,5082,6321,4669,-1652
2016,6,8,14,5639,6950,5046,-1904
2016,6,8,15,6187,7638,5419,-2219
2016,6,8,16,6679,8297,5906,-2391
2016,6,8,17,7027,8910,6392,-2518
2016,6,8,18,7324,9369,6852,-2517
2016,6,8,19,7483,9684,7073,-2611
2016,6,8,20,7533,9844,7183,-2661
2016,6,8,21,7490,9744,7079,-2665
2016,6,8,22,7304,9578,6909,-2669
2016,6,8,23,7085,9346,6510,-2836
2016,6,9,0,6704,8939,6406,-2533
2016,6,9,1,6480,8508,6064,-2444
2016,6,9,2,6127,7991,5629,-2362
2016,6,9,3,5615,7254,5082,-2172
2016,6,9,4,5058,6476,4652,-1824
2016,6,9,5,4616,5750,4194,-1556
2016,6,9,6,4304,5232,3772,-1460
2016,6,9,7,4069,4940,3531,-1409
2016,6,9,8,3914,4775,3409,-1366
2016,6,9,9,3890,4754,3393,-1361
2016,6,9,10,4037,4933,3520,-1413
2016,6,9,11,4351,5340,3811,-1529
2016,6,9,12,4637,5699,4154,-1545
2016,6,9,13,5019,6101,4480,-1621
2016,6,9,14,5507,6680,4829,-1851
2016,6,9,15,6041,7405,5209,-2196
2016,6,9,16,6455,8068,5708,-2360
2016,6,9,17,6803,8715,6240,-2475
2016,6,9,18,7086,9250,6670,-2580
2016,6,9,19,7241,9449,6837,-2612
2016,6,9,20,7260,9322,6759,-2563
2016,6,9,21,7295,8980,6502,-2478
2016,6,9,22,7112,8615,6089,-2526
2016,6,9,23,6886,8284,5827,-2457
2016,6,10,0,6540,7938,5555,-2383
2016,6,10,1,6320,7743,5420,-2323
2016,6,10,2,6015,7460,5149,-2311
2016,6,10,3,5532,6849,4671,-2178
2016,6,10,4,4982,6158,4298,-1860
2016,6,10,5,4617,5567,3975,-1592
2016,6,10,6,4258,5113,3617,-1496
2016,6,10,7,4031,4836,3427,-1409
2016,6,10,8,3891,4653,3363,-1290
2016,6,10,9,3847,4641,3391,-1250
2016,6,10,10,3985,4812,3513,-1299
2016,6,10,11,4252,5221,3891,-1330
2016,6,10,12,4573,5602,4284,-1318
2016,6,10,13,4960,6130,4602,-1528
2016,6,10,14,5447,6815,4910,-1905
2016,6,10,15,6024,7564,5294,-2270
2016,6,10,16,6492,8340,5795,-2545
2016,6,10,17,6928,8998,6366,-2632
2016,6,10,18,7238,9547,6876,-2671
2016,6,10,19,7541,9835,7090,-2745
2016,6,10,20,7666,9838,7016,-2822
2016,6,10,21,7691,9574,6832,-2742
2016,6,10,22,7537,9193,6574,-2619
2016,6,10,23,7216,8672,6353,-2319
2016,6,11,0,6819,8144,5861,-2283
2016,6,11,1,6505,7901,5501,-2400
2016,6,11,2,6172,7519,5236,-2283
2016,6,11,3,5710,6976,4893,-2083
2016,6,11,4,5192,6333,4496,-1837
2016,6,11,5,4633,5721,4148,-1573
2016,6,11,6,4277,5269,3799,-1470
2016,6,11,7,4011,4952,3570,-1382
2016,6,11,8,3862,4751,3397,-1354
2016,6,11,9,3757,4644,3301,-1343
2016,6,11,10,3751,4619,3272,-1347
2016,6,11,11,3780,4699,3270,-1429
2016,6,11,12,3981,5023,3594,-1429
2016,6,11,13,4544,5738,4150,-1588
2016,6,11,14,5170,6504,4666,-1838
2016,6,11,15,5731,7221,5031,-2190
2016,6,11,16,6267,7841,5550,-2291
2016,6,11,17,6631,8334,6069,-2265
2016,6,11,18,6952,8552,6177,-2375
2016,6,11,19,7169,8664,6303,-2361
2016,6,11,20,7268,8758,6375,-2383
2016,6,11,21,7247,8794,6392,-2402
2016,6,11,22,7069,8778,6339,-2439
2016,6,11,23,6843,8449,6065,-2384
2016,6,12,0,6443,8038,5758,-2280
2016,6,12,1,6136,7792,5472,-2320
2016,6,12,2,5823,7405,5083,-2322
2016,6,12,3,5403,6829,4689,-2140
2016,6,12,4,4930,6187,4304,-1883
2016,6,12,5,4497,5540,3908,-1632
2016,6,12,6,4174,5083,3548,-1535
2016,6,12,7,3937,4737,3272,-1465
2016,6,12,8,3752,4520,3101,-1419
2016,6,12,9,3666,4408,3060,-1348
2016,6,12,10,3657,4387,2985,-1402
2016,6,12,11,3660,4438,3025,-1413
2016,6,12,12,3893,4763,3336,-1427
2016,6,12,13,4478,5540,3953,-1587
2016,6,12,14,5248,6388,4537,-1851
2016,6,12,15,5889,7151,4999,-2152
2016,6,12,16,6426,7879,5568,-2311
2016,6,12,17,6868,8540,6070,-2470
2016,6,12,18,7217,9066,6561,-2505
2016,6,12,19,7479,9471,6879,-2592
2016,6,12,20,7476,9608,6999,-2609
2016,6,12,21,7494,9544,6975,-2569
2016,6,12,22,7365,9220,6764,-2456
2016,6,12,23,7246,8770,6373,-2397
2016,6,13,0,6856,8291,5973,-2318
2016,6,13,1,6574,7896,5657,-2239
2016,6,13,2,6196,7471,5272,-2199
2016,6,13,3,5687,6876,4840,-2036
2016,6,13,4,5112,6188,4396,-1792
2016,6,13,5,4532,5761,4236,-1525
2016,6,13,6,4197,5311,3859,-1452
2016,6,13,7,3988,5031,3657,-1374
2016,6,13,8,3862,4874,3525,-1349
2016,6,13,9,3843,4854,3522,-1332
2016,6,13,10,3973,5055,3667,-1388
2016,6,13,11,4267,5459,3962,-1497
2016,6,13,12,4585,5904,4380,-1524
2016,6,13,13,5054,6572,4913,-1659
2016,6,13,14,5668,7376,5448,-1928
2016,6,13,15,6396,8231,6055,-2176
2016,6,13,16,7016,9028,6765,-2263
2016,6,13,17,7421,9734,7264,-2470
2016,6,13,18,7830,10341,7627,-2714
2016,6,13,19,8082,10732,7895,-2837
2016,6,13,20,8204,10911,8066,-2845
2016,6,13,21,8136,10857,7991,-2866
2016,6,13,22,7955,10590,7751,-2839
2016,6,13,23,7725,10148,7390,-2758
2016,6,14,0,7345,13152,10586,-2566
2016,6,14,1,7015,9312,6755,-2557
2016,6,14,2,6620,8759,6425,-2334
2016,6,14,3,6074,8032,5820,-2212
2016,6,14,4,5479,7209,5211,-1998
2016,6,14,5,5001,6351,4659,-1692
2016,6,14,6,4608,5831,4254,-1577
2016,6,14,7,4330,5477,3973,-1504
2016,6,14,8,4154,5263,3803,-1460
2016,6,14,9,4092,5188,3720,-1468
2016,6,14,10,4181,5329,3827,-1502
2016,6,14,11,4453,5674,4124,-1550
2016,6,14,12,4753,6096,4497,-1599
2016,6,14,13,5252,6754,5046,-1708
2016,6,14,14,5778,7536,5651,-1885
2016,6,14,15,6386,8403,6305,-2098
2016,6,14,16,6994,9239,6828,-2411
2016,6,14,17,7388,9914,7318,-2596
2016,6,14,18,7746,10425,7741,-2684
2016,6,14,19,8006,10752,7881,-2871
2016,6,14,20,8102,10977,8013,-2964
2016,6,14,21,8062,11095,8082,-3013
2016,6,14,22,7927,10898,8006,-2892
2016,6,14,23,7708,10387,7644,-2743
2016,6,15,0,7353,9785,7116,-2669
2016,6,15,1,7018,9288,6782,-2506
2016,6,15,2,6617,8764,6443,-2321
2016,6,15,3,6053,7974,5855,-2119
2016,6,15,4,5433,7128,5224,-1904
2016,6,15,5,4940,6436,4735,-1701
2016,6,15,6,4510,5911,4302,-1609
2016,6,15,7,4213,5562,4042,-1520
2016,6,15,8,4028,5357,3887,-1470
2016,6,15,9,3966,5270,3818,-1452
2016,6,15,10,4065,5437,3937,-1500
2016,6,15,11,4289,5803,4197,-1606
2016,6,15,12,4631,6194,4574,-1620
2016,6,15,13,5117,6877,5123,-1754
2016,6,15,14,5715,7675,5660,-2015
2016,6,15,15,6407,8480,6284,-2196
2016,6,15,16,6975,9220,6924,-2296
2016,6,15,17,7430,9811,7071,-2740
2016,6,15,18,7825,10323,7456,-2867
2016,6,15,19,8069,10668,7697,-2971
2016,6,15,20,8165,10726,7710,-3016
2016,6,15,21,8144,10716,7682,-3034
2016,6,15,22,7899,10624,7603,-3021
2016,6,15,23,7687,10321,7355,-2966
2016,6,16,0,7413,9784,7147,-2637
2016,6,16,1,6926,9296,6918,-2378
2016,6,16,2,6536,8790,6635,-2155
2016,6,16,3,5984,8016,6049,-1967
2016,6,16,4,5356,7172,5420,-1752
2016,6,16,5,5086,6427,4866,-1561
2016,6,16,6,4605,5903,4354,-1549
2016,6,16,7,4288,5565,4090,-1475
2016,6,16,8,4098,5361,3904,-1457
2016,6,16,9,4047,5323,3875,-1448
2016,6,16,10,4175,5465,3950,-1515
2016,6,16,11,4454,5830,4205,-1625
2016,6,16,12,4891,6238,4558,-1680
2016,6,16,13,5433,6916,5089,-1827
2016,6,16,14,6128,7656,5680,-1976
2016,6,16,15,6950,8380,6240,-2140
2016,6,16,16,7535,9032,6758,-2274
2016,6,16,17,8028,9496,6964,-2532
2016,6,16,18,8414,9873,7201,-2672
2016,6,16,19,8650,9996,7347,-2649
2016,6,16,20,8730,9929,7302,-2627
2016,6,16,21,8763,9749,7181,-2568
2016,6,16,22,8528,9280,6716,-2564
2016,6,16,23,8207,8858,6260,-2598
2016,6,17,0,7720,8536,5964,-2572
2016,6,17,1,7389,8288,5968,-2320
2016,6,17,2,6960,7941,5747,-2194
2016,6,17,3,6320,7374,5330,-2044
2016,6,17,4,5600,6731,4921,-1810
2016,6,17,5,4788,6235,4610,-1625
2016,6,17,6,4380,5790,4243,-1547
2016,6,17,7,4122,5512,4010,-1502
2016,6,17,8,3980,5351,3886,-1465
2016,6,17,9,3934,5343,3858,-1485
2016,6,17,10,4037,5517,3998,-1519
2016,6,17,11,4306,5878,4261,-1617
2016,6,17,12,4604,6274,4600,-1674
2016,6,17,13,5065,6887,5145,-1742
2016,6,17,14,5656,7520,5602,-1918
2016,6,17,15,6245,8011,6014,-1997
2016,6,17,16,6779,8223,6241,-1982
2016,6,17,17,7259,8234,6173,-2061
2016,6,17,18,7529,8419,6226,-2193
2016,6,17,19,7703,8586,6341,-2245
2016,6,17,20,7852,8803,6474,-2329
2016,6,17,21,7710,8984,6567,-2417
2016,6,17,22,7544,9037,6561,-2476
2016,6,17,23,7295,8939,6507,-2432
2016,6,18,0,6848,8539,6205,-2334
2016,6,18,1,6561,8230,5986,-2244
2016,6,18,2,6258,7895,5759,-2136
2016,6,18,3,5806,7388,5399,-1989
2016,6,18,4,5274,6772,4912,-1860
2016,6,18,5,4682,6149,4586,-1563
2016,6,18,6,4338,5700,4238,-1462
2016,6,18,7,4080,5407,4004,-1403
2016,6,18,8,3935,5174,3814,-1360
2016,6,18,9,3836,5064,3702,-1362
2016,6,18,10,3863,5066,3683,-1383
2016,6,18,11,3910,5136,3694,-1442
2016,6,18,12,4121,5421,3906,-1515
2016,6,18,13,4679,6240,4552,-1688
2016,6,18,14,5331,7148,5237,-1911
2016,6,18,15,5919,7983,5899,-2084
2016,6,18,16,6347,8610,6283,-2327
2016,6,18,17,6777,9157,6655,-2502
2016,6,18,18,6972,9497,7061,-2436
2016,6,18,19,7138,9683,7239,-2444
2016,6,18,20,7193,9632,7273,-2359
2016,6,18,21,7115,9156,6820,-2336
2016,6,18,22,6939,8592,6331,-2261
2016,6,18,23,6669,8059,5938,-2121
2016,6,19,0,6324,7527,5641,-1886
2016,6,19,1,6031,7150,5354,-1796
2016,6,19,2,5773,6803,5039,-1764
2016,6,19,3,5361,6325,4488,-1837
2016,6,19,4,4900,5727,4087,-1640
2016,6,19,5,4494,5203,3808,-1395
2016,6,19,6,4135,4774,3534,-1240
2016,6,19,7,3849,4506,3326,-1180
2016,6,19,8,3679,4328,3164,-1164
2016,6,19,9,3577,4258,3125,-1133
2016,6,19,10,3536,4261,3116,-1145
2016,6,19,11,3525,4357,3193,-1164
2016,6,19,12,3732,4642,3378,-1264
2016,6,19,13,4336,5309,3780,-1529
2016,6,19,14,4986,6076,4272,-1804
2016,6,19,15,5514,6713,4704,-2009
2016,6,19,16,6060,7233,5060,-2173
2016,6,19,17,6522,7700,5495,-2205
2016,6,19,18,6845,8094,5812,-2282
2016,6,19,19,7039,8390,6130,-2260
2016,6,19,20,7106,8524,6196,-2328
2016,6,19,21,7102,8491,6128,-2363
2016,6,19,22,6895,8388,6085,-2303
2016,6,19,23,6589,8134,5907,-2227
2016,6,20,0,6202,7681,5543,-2138
2016,6,20,1,5912,7332,5303,-2029
2016,6,20,2,5597,7023,4994,-2029
2016,6,20,3,5105,6397,4449,-1948
2016,6,20,4,4570,5747,4041,-1706
2016,6,20,5,4214,5079,3666,-1413
2016,6,20,6,3828,4581,3291,-1290
2016,6,20,7,3557,4283,3071,-1212
2016,6,20,8,3437,4112,2937,-1175
2016,6,20,9,3389,4103,2928,-1175
2016,6,20,10,3510,4315,3086,-1229
2016,6,20,11,3827,4722,3370,-1352
2016,6,20,12,4166,5070,3701,-1369
2016,6,20,13,4603,5479,4004,-1475
2016,6,20,14,5094,6071,4387,-1684
2016,6,20,15,5606,6729,4767,-1962
2016,6,20,16,6107,7272,5173,-2099
2016,6,20,17,6514,7787,5614,-2173
2016,6,20,18,6897,8229,5945,-2284
2016,6,20,19,7103,8550,6178,-2372
2016,6,20,20,7253,8782,6358,-2424
2016,6,20,21,7380,8950,6481,-2469
2016,6,20,22,7312,8929,6455,-2474
2016,6,20,23,6983,8655,6229,-2426
2016,6,21,0,6461,8177,5879,-2298
2016,6,21,1,6175,7678,5453,-2225
2016,6,21,2,5812,7202,5048,-2154
2016,6,21,3,5235,6495,4549,-1946
2016,6,21,4,4636,5659,3991,-1668
2016,6,21,5,4182,4957,3598,-1359
2016,6,21,6,3799,4466,3307,-1159
2016,6,21,7,3532,4126,3059,-1067
2016,6,21,8,3387,3956,2920,-1036
2016,6,21,9,3360,3877,2897,-980
2016,6,21,10,3495,4051,2971,-1080
2016,6,21,11,3808,4429,3232,-1197
2016,6,21,12,4165,4738,3473,-1265
2016,6,21,13,4569,5210,3738,-1472
2016,6,21,14,5067,5822,4073,-1749
2016,6,21,15,5594,6515,4571,-1944
2016,6,21,16,6045,7127,4975,-2152
2016,6,21,17,6455,7718,5470,-2248
2016,6,21,18,6798,8293,5988,-2305
2016,6,21,19,7017,8743,6306,-2437
2016,6,21,20,7211,9098,6613,-2485
2016,6,21,21,7319,9341,6782,-2559
2016,6,21,22,7247,9372,6812,-2560
2016,6,21,23,7021,9139,6617,-2522
2016,6,22,0,6639,8603,6159,-2444
2016,6,22,1,6385,8089,5780,-2309
2016,6,22,2,6071,7664,5501,-2163
2016,6,22,3,5538,6988,4986,-2002
2016,6,22,4,4958,6186,4433,-1753
2016,6,22,5,4276,5510,4040,-1470
2016,6,22,6,3931,4964,3749,-1215
2016,6,22,7,3737,4608,3473,-1135
2016,6,22,8,3612,4400,3309,-1091
2016,6,22,9,3584,4306,3245,-1061
2016,6,22,10,3734,4471,3368,-1103
2016,6,22,11,3984,4825,3610,-1215
2016,6,22,12,4283,5175,3898,-1277
2016,6,22,13,4675,5753,4222,-1531
2016,6,22,14,5249,6458,4618,-1840
2016,6,22,15,5878,7194,5184,-2010
2016,6,22,16,6429,7925,5729,-2196
2016,6,22,17,6868,8595,6136,-2459
2016,6,22,18,7310,9216,6766,-2450
2016,6,22,19,7612,9717,7200,-2517
2016,6,22,20,7799,10133,7555,-2578
2016,6,22,21,7889,10382,7823,-2559
2016,6,22,22,7780,10400,7809,-2591
2016,6,22,23,7545,10156,7647,-2509
2016,6,23,0,7205,9633,7202,-2431
2016,6,23,1,6895,9061,6733,-2328
2016,6,23,2,6508,8547,6221,-2326
2016,6,23,3,5982,7638,5425,-2213
2016,6,23,4,5372,7010,5074,-1936
2016,6,23,5,4754,6258,4650,-1608
2016,6,23,6,4319,5722,4270,-1452
2016,6,23,7,4080,5358,3972,-1386
2016,6,23,8,3911,5131,3791,-1340
2016,6,23,9,3880,5065,3743,-1322
2016,6,23,10,3989,5204,3842,-1362
2016,6,23,11,4264,5562,4088,-1474
2016,6,23,12,4564,5934,4363,-1571
2016,6,23,13,5017,6585,4861,-1724
2016,6,23,14,5623,7376,5369,-2007
2016,6,23,15,6294,8219,5996,-2223
2016,6,23,16,6932,8966,6600,-2366
2016,6,23,17,7442,9555,7111,-2444
2016,6,23,18,7872,10009,7450,-2559
2016,6,23,19,8182,10405,7722,-2683
2016,6,23,20,8363,10677,8020,-2657
2016,6,23,21,8447,10822,8144,-2678
2016,6,23,22,8339,10740,8079,-2661
2016,6,23,23,8006,10441,7875,-2566
2016,6,24,0,7486,9930,7454,-2476
2016,6,24,1,7178,9399,6977,-2422
2016,6,24,2,6740,8942,6535,-2407
2016,6,24,3,6188,8192,5954,-2238
2016,6,24,4,5568,7365,5347,-2018
2016,6,24,5,5085,6673,4893,-1780
2016,6,24,6,4633,6143,4484,-1659
2016,6,24,7,4320,5752,4214,-1538
2016,6,24,8,4116,5461,3982,-1479
2016,6,24,9,4041,5340,3897,-1443
2016,6,24,10,4119,5422,3959,-1463
2016,6,24,11,4366,5676,4139,-1537
2016,6,24,12,4673,6021,4440,-1581
2016,6,24,13,5214,6664,4943,-1721
2016,6,24,14,5815,7477,5577,-1900
2016,6,24,15,6508,8356,6176,-2180
2016,6,24,16,7087,9173,6730,-2443
2016,6,24,17,7640,9750,7140,-2610
2016,6,24,18,8085,10250,7480,-2770
2016,6,24,19,8383,10671,7853,-2818
2016,6,24,20,8586,10847,8016,-2831
2016,6,24,21,8586,10852,8023,-2829
2016,6,24,22,8322,10695,7928,-2767
2016,6,24,23,7947,10309,7580,-2729
2016,6,25,0,7545,9797,7098,-2699
2016,6,25,1,7091,9213,6749,-2464
2016,6,25,2,6754,8693,6321,-2372
2016,6,25,3,6288,8027,5795,-2232
2016,6,25,4,5739,7342,5266,-2076
2016,6,25,5,5083,6644,4865,-1779
2016,6,25,6,4667,6106,4462,-1644
2016,6,25,7,4344,5717,4139,-1578
2016,6,25,8,4133,5438,3966,-1472
2016,6,25,9,4019,5324,3877,-1447
2016,6,25,10,3991,5305,3864,-1441
2016,6,25,11,4005,5332,3830,-1502
2016,6,25,12,4227,5564,4013,-1551
2016,6,25,13,4875,6269,4598,-1671
2016,6,25,14,5615,7110,5237,-1873
2016,6,25,15,6346,7952,5802,-2150
2016,6,25,16,7028,8683,6260,-2423
2016,6,25,17,7617,9224,6613,-2611
2016,6,25,18,8039,9778,7026,-2752
2016,6,25,19,8315,10199,7433,-2766
2016,6,25,20,8484,10468,7627,-2841
2016,6,25,21,8514,10439,7602,-2837
2016,6,25,22,8310,10113,7424,-2689
2016,6,25,23,7984,9650,7021,-2629
2016,6,26,0,7513,9151,6617,-2534
2016,6,26,1,7062,8791,6337,-2454
2016,6,26,2,6669,8403,6095,-2308
2016,6,26,3,6180,7799,5614,-2185
2016,6,26,4,5629,7089,5139,-1950
2016,6,26,5,5103,6445,4678,-1767
2016,6,26,6,4700,5899,4290,-1609
2016,6,26,7,4354,5522,3995,-1527
2016,6,26,8,4127,5219,3744,-1475
2016,6,26,9,4015,5065,3614,-1451
2016,6,26,10,3947,5002,3575,-1427
2016,6,26,11,3900,5027,3595,-1432
2016,6,26,12,4067,5289,3763,-1526
2016,6,26,13,4634,6119,4382,-1737
2016,6,26,14,5391,7109,5147,-1962
2016,6,26,15,6065,8033,5767,-2266
2016,6,26,16,6646,8789,6321,-2468
2016,6,26,17,7140,9391,6778,-2613
2016,6,26,18,7520,9744,7163,-2581
2016,6,26,19,7766,9737,7295,-2442
2016,6,26,20,7802,9283,6964,-2319
2016,6,26,21,7751,8650,6364,-2286
2016,6,26,22,7568,8295,6014,-2281
2016,6,26,23,7407,8023,5734,-2289
2016,6,27,0,6947,7747,5519,-2228
2016,6,27,1,6624,7514,5351,-2163
2016,6,27,2,6236,7185,5094,-2091
2016,6,27,3,5763,6597,4637,-1960
2016,6,27,4,5194,5934,4173,-1761
2016,6,27,5,4761,5323,3796,-1527
2016,6,27,6,4368,4873,3475,-1398
2016,6,27,7,4142,4601,3258,-1343
2016,6,27,8,3983,4430,3122,-1308
2016,6,27,9,3961,4393,3098,-1295
2016,6,27,10,4084,4566,3225,-1341
2016,6,27,11,4366,4939,3511,-1428
2016,6,27,12,4690,5381,3876,-1505
2016,6,27,13,5118,6013,4425,-1588
2016,6,27,14,5681,6799,5023,-1776
2016,6,27,15,6276,7693,5625,-2068
2016,6,27,16,6833,8496,6331,-2165
2016,6,27,17,7246,9176,6893,-2283
2016,6,27,18,7664,9715,7368,-2347
2016,6,27,19,7914,10010,7575,-2435
2016,6,27,20,8015,10072,7570,-2502
2016,6,27,21,7972,10164,7624,-2540
2016,6,27,22,7776,9998,7480,-2518
2016,6,27,23,7545,9597,7197,-2400
2016,6,28,0,7185,9091,6783,-2308
2016,6,28,1,6873,8690,6386,-2304
2016,6,28,2,6512,8192,6035,-2157
2016,6,28,3,5973,7457,5407,-2050
2016,6,28,4,5384,6689,4826,-1863
2016,6,28,5,4835,6038,4406,-1632
2016,6,28,6,4514,5515,4038,-1477
2016,6,28,7,4156,5184,3767,-1417
2016,6,28,8,3965,4968,3600,-1368
2016,6,28,9,3911,4918,3558,-1360
2016,6,28,10,4028,5057,3675,-1382
2016,6,28,11,4318,5444,3965,-1479
2016,6,28,12,4589,5764,4231,-1533
2016,6,28,13,4993,6314,4677,-1637
2016,6,28,14,5588,7113,5186,-1927
2016,6,28,15,6212,8029,5824,-2205
2016,6,28,16,6892,8869,6411,-2458
2016,6,28,17,7250,9568,7060,-2508
2016,6,28,18,7724,10075,7529,-2546
2016,6,28,19,7770,10339,7769,-2570
2016,6,28,20,7839,10448,7809,-2639
2016,6,28,21,7830,10499,7857,-2642
2016,6,28,22,7795,10221,7737,-2484
2016,6,28,23,7528,9862,7421,-2441
2016,6,29,0,7137,9399,7037,-2362
2016,6,29,1,6813,8992,6761,-2231
2016,6,29,2,6481,8505,6424,-2081
2016,6,29,3,6062,7831,5946,-1885
2016,6,29,4,5458,6972,5224,-1748
2016,6,29,5,5003,6293,4690,-1603
2016,6,29,6,4566,5811,4241,-1570
2016,6,29,7,4304,5416,3926,-1490
2016,6,29,8,4167,5152,3719,-1433
2016,6,29,9,4108,5065,3670,-1395
2016,6,29,10,4211,5159,3714,-1445
2016,6,29,11,4424,5533,4072,-1461
2016,6,29,12,4705,5828,4378,-1450
2016,6,29,13,5176,6400,4850,-1550
2016,6,29,14,5751,7214,5513,-1701
2016,6,29,15,6372,8084,6109,-1975
2016,6,29,16,6872,8856,6671,-2185
2016,6,29,17,7245,9452,7152,-2300
2016,6,29,18,7481,9896,7406,-2490
2016,6,29,19,7892,10158,7601,-2557
2016,6,29,20,7846,10247,7665,-2582
2016,6,29,21,7796,10171,7549,-2622
2016,6,29,22,7629,10001,7393,-2608
2016,6,29,23,7495,9699,7182,-2517
2016,6,30,0,7123,9268,6919,-2349
2016,6,30,1,6763,8810,6598,-2212
2016,6,30,2,6475,8376,6311,-2065
2016,6,30,3,5936,7666,5761,-1905
2016,6,30,4,5367,6815,5087,-1728
2016,6,30,5,4778,6159,4577,-1582
2016,6,30,6,4369,5617,4126,-1491
2016,6,30,7,4151,5326,3857,-1469
2016,6,30,8,3982,5133,3694,-1439
2016,6,30,9,3955,5014,3648,-1366
2016,6,30,10,4079,5171,3724,-1447
2016,6,30,11,4374,5529,4025,-1504
2016,6,30,12,4641,5861,4419,-1442
2016,6,30,13,5124,6474,4906,-1568
2016,6,30,14,5632,7252,5524,-1728
2016,6,30,15,6180,8075,6189,-1886
2016,6,30,16,6690,8730,6671,-2059
2016,6,30,17,7026,9216,7033,-2183
2016,6,30,18,7355,9542,7353,-2189
2016,6,30,19,7553,9864,7564,-2300
2016,6,30,20,7589,10044,7723,-2321
2016,6,30,21,7598,10030,7690,-2340
2016,6,30,22,7361,9785,7431,-2354
2016,6,30,23,7128,9302,7056,-2246
2016,7,1,0,6819,8704,6589,-2115
2016,7,1,1,6532,8305,6260,-2045
2016,7,1,2,6209,7874,5962,-1912
2016,7,1,3,5740,7255,5453,-1802
2016,7,1,4,5170,6522,4915,-1607
2016,7,1,5,4672,5895,4421,-1474
2016,7,1,6,4344,5414,3995,-1419
2016,7,1,7,4085,5127,3701,-1426
2016,7,1,8,3922,4955,3566,-1389
2016,7,1,9,3881,4877,3548,-1329
2016,7,1,10,3994,5038,3616,-1421
2016,7,1,11,4216,5329,3860,-1468
2016,7,1,12,4505,5677,4245,-1431
2016,7,1,13,5037,6334,4751,-1581
2016,7,1,14,5696,7109,5383,-1725
2016,7,1,15,6288,7943,6022,-1919
2016,7,1,16,6805,8618,6533,-2084
2016,7,1,17,7262,9133,6926,-2206
2016,7,1,18,7535,9488,7191,-2296
2016,7,1,19,7838,9725,7400,-2325
2016,7,1,20,7859,9804,7427,-2376
2016,7,1,21,7865,9724,7354,-2369
2016,7,1,22,7734,9520,7088,-2432
2016,7,1,23,7328,9215,6717,-2498
2016,7,2,0,7039,8711,6399,-2312
2016,7,2,1,6668,8326,6108,-2218
2016,7,2,2,6359,7949,5773,-2176
2016,7,2,3,5874,7317,5107,-2210
2016,7,2,4,5408,6642,4749,-1893
2016,7,2,5,4839,6073,4479,-1594
2016,7,2,6,4482,5597,4111,-1486
2016,7,2,7,4222,5273,3819,-1454
2016,7,2,8,4038,5034,3608,-1426
2016,7,2,9,3955,4911,3543,-1368
2016,7,2,10,3940,4874,3490,-1384
2016,7,2,11,3959,4933,3517,-1416
2016,7,2,12,4154,5211,3779,-1432
2016,7,2,13,4744,5939,4327,-1612
2016,7,2,14,5399,6754,4811,-1943
2016,7,2,15,6022,7612,5397,-2215
2016,7,2,16,6622,8386,6032,-2354
2016,7,2,17,7032,8756,6390,-2366
2016,7,2,18,7251,8842,6561,-2281
2016,7,2,19,7409,8766,6587,-2179
2016,7,2,20,7469,8365,6218,-2147
2016,7,2,21,7398,8086,5788,-2298
2016,7,2,22,7239,7870,5534,-2336
2016,7,2,23,6963,7665,5300,-2365
2016,7,3,0,6583,7389,5056,-2333
2016,7,3,1,6324,7226,4910,-2316
2016,7,3,2,6047,6998,4746,-2252
2016,7,3,3,5656,6626,4543,-2083
2016,7,3,4,5224,6080,4214,-1866
2016,7,3,5,4706,5556,3935,-1621
2016,7,3,6,4358,5118,3627,-1491
2016,7,3,7,4121,4828,3417,-1411
2016,7,3,8,3911,4611,3236,-1375
2016,7,3,9,3831,4540,3223,-1317
2016,7,3,10,3833,4537,3207,-1330
2016,7,3,11,3834,4598,3223,-1375
2016,7,3,12,4038,4873,3452,-1421
2016,7,3,13,4640,5703,4058,-1645
2016,7,3,14,5395,6559,4594,-1965
2016,7,3,15,5968,7483,5266,-2217
2016,7,3,16,6580,8274,5949,-2325
2016,7,3,17,7103,8921,6424,-2497
2016,7,3,18,7384,9378,6802,-2576
2016,7,3,19,7563,9686,7056,-2630
2016,7,3,20,7694,9916,7193,-2723
2016,7,3,21,7548,10002,7254,-2748
2016,7,3,22,7311,9933,7197,-2736
2016,7,3,23,7035,9749,7102,-2647
2016,7,4,0,6697,9211,6691,-2520
2016,7,4,1,6361,8677,6146,-2531
2016,7,4,2,6032,8157,5618,-2539
2016,7,4,3,5659,7653,5283,-2370
2016,7,4,4,5208,6965,4829,-2136
2016,7,4,5,4458,6305,4499,-1806
2016,7,4,6,4102,5800,4221,-1579
2016,7,4,7,3884,5422,3921,-1501
2016,7,4,8,3714,5163,3714,-1449
2016,7,4,9,3651,5063,3635,-1428
2016,7,4,10,3709,5041,3604,-1437
2016,7,4,11,3719,5082,3647,-1435
2016,7,4,12,3954,5285,3857,-1428
2016,7,4,13,4594,6155,4458,-1697
2016,7,4,14,5476,7244,5032,-2212
2016,7,4,15,6123,8393,6177,-2216
2016,7,4,16,6802,9296,6495,-2801
2016,7,4,17,7381,9972,7001,-2971
2016,7,4,18,7609,10336,7318,-3018
2016,7,4,19,7777,10569,7545,-3024
2016,7,4,20,7897,10664,7601,-3063
2016,7,4,21,7626,10654,7601,-3053
2016,7,4,22,7368,10470,7448,-3022
2016,7,4,23,7011,10098,7140,-2958
2016,7,5,0,6626,9644,6735,-2909
2016,7,5,1,6386,9043,6372,-2671
2016,7,5,2,5927,8509,6150,-2359
2016,7,5,3,5691,8031,5791,-2240
2016,7,5,4,5344,7401,5299,-2102
2016,7,5,5,5142,6713,4902,-1811
2016,7,5,6,4731,6146,4460,-1686
2016,7,5,7,4471,5721,4121,-1600
2016,7,5,8,4287,5452,3898,-1554
2016,7,5,9,4206,5382,3847,-1535
2016,7,5,10,4337,5522,3950,-1572
2016,7,5,11,4560,5852,4237,-1615
2016,7,5,12,4887,6174,4545,-1629
2016,7,5,13,5448,6864,5064,-1800
2016,7,5,14,6121,7782,5811,-1971
2016,7,5,15,6789,8738,6363,-2375
2016,7,5,16,7459,9506,7043,-2463
2016,7,5,17,7962,10066,7495,-2571
2016,7,5,18,8308,10392,7878,-2514
2016,7,5,19,8529,10684,8140,-2544
2016,7,5,20,8585,10986,8297,-2689
2016,7,5,21,8602,11073,8331,-2742
2016,7,5,22,8476,11083,8315,-2768
2016,7,5,23,8147,10881,8174,-2707
2016,7,6,0,7766,10440,7742,-2698
2016,7,6,1,7338,9969,7368,-2601
2016,7,6,2,6940,9389,7031,-2358
2016,7,6,3,6320,8658,6480,-2178
2016,7,6,4,5766,7762,5797,-1965
2016,7,6,5,5277,7014,5308,-1706
2016,7,6,6,4884,6404,4913,-1491
2016,7,6,7,4639,5978,4509,-1469
2016,7,6,8,4456,5673,4271,-1402
2016,7,6,9,4386,5548,4172,-1376
2016,7,6,10,4507,5686,4278,-1408
2016,7,6,11,4735,6007,4553,-1454
2016,7,6,12,5017,6309,4841,-1468
2016,7,6,13,5553,6971,5305,-1666
2016,7,6,14,6210,7836,5927,-1909
2016,7,6,15,6850,8712,6509,-2203
2016,7,6,16,7651,9622,7219,-2403
2016,7,6,17,8077,10171,7538,-2633
2016,7,6,18,8537,10634,7928,-2706
2016,7,6,19,8796,11023,8222,-2801
2016,7,6,20,8847,11446,8552,-2894
2016,7,6,21,8821,11385,8449,-2936
2016,7,6,22,8479,11313,8377,-2936
2016,7,6,23,8232,11082,8221,-2861
2016,7,7,0,7819,10598,7881,-2717
2016,7,7,1,7484,9906,7393,-2513
2016,7,7,2,7063,9262,6907,-2355
2016,7,7,3,6507,8461,6301,-2160
2016,7,7,4,5973,7588,5752,-1836
2016,7,7,5,5280,6864,5189,-1675
2016,7,7,6,4844,6242,4705,-1537
2016,7,7,7,4538,5845,4387,-1458
2016,7,7,8,4353,5591,4171,-1420
2016,7,7,9,4282,5487,4077,-1410
2016,7,7,10,4392,5604,4187,-1417
2016,7,7,11,4671,5908,4428,-1480
2016,7,7,12,4940,6239,4753,-1486
2016,7,7,13,5465,6910,5216,-1694
2016,7,7,14,6207,7776,5876,-1900
2016,7,7,15,6974,8701,6536,-2165
2016,7,7,16,7699,9590,7221,-2369
2016,7,7,17,8224,10244,7559,-2685
2016,7,7,18,8658,10643,7848,-2795
2016,7,7,19,8919,10860,7882,-2978
2016,7,7,20,9034,10807,7842,-2965
2016,7,7,21,8992,10843,7916,-2927
2016,7,7,22,8746,10626,7755,-2871
2016,7,7,23,8376,10197,7360,-2837
2016,7,8,0,7880,9726,7096,-2630
2016,7,8,1,7517,9300,6962,-2338
2016,7,8,2,7122,8827,6570,-2257
2016,7,8,3,6523,8099,6049,-2050
2016,7,8,4,5915,7341,5471,-1870
2016,7,8,5,5702,6651,5119,-1532
2016,7,8,6,5224,6127,4755,-1372
2016,7,8,7,4881,5770,4482,-1288
2016,7,8,8,4641,5484,4241,-1243
2016,7,8,9,4544,5366,4150,-1216
2016,7,8,10,4653,5581,4349,-1232
2016,7,8,11,4910,5754,4467,-1287
2016,7,8,12,5193,6074,4721,-1353
2016,7,8,13,5695,6775,5264,-1511
2016,7,8,14,6343,7695,5891,-1804
2016,7,8,15,6963,8610,6424,-2186
2016,7,8,16,7647,9413,6994,-2419
2016,7,8,17,7993,9976,7380,-2596
2016,7,8,18,8335,10408,7602,-2806
2016,7,8,19,8631,10831,7911,-2920
2016,7,8,20,9006,11107,8132,-2975
2016,7,8,21,8901,11181,8268,-2913
2016,7,8,22,8816,11020,8142,-2878
2016,7,8,23,8682,10709,7900,-2809
2016,7,9,0,8332,10179,7559,-2620
2016,7,9,1,7807,9653,7167,-2486
2016,7,9,2,7293,9123,6778,-2345
2016,7,9,3,6722,8450,6289,-2161
2016,7,9,4,6087,7635,5751,-1884
2016,7,9,5,5189,6957,5237,-1720
2016,7,9,6,4789,6387,4832,-1555
2016,7,9,7,4484,5981,4509,-1472
2016,7,9,8,4279,5675,4230,-1445
2016,7,9,9,4176,5480,4088,-1392
2016,7,9,10,4117,5461,4067,-1394
2016,7,9,11,4169,5518,4117,-1401
2016,7,9,12,4357,5729,4288,-1441
2016,7,9,13,5065,6539,4916,-1623
2016,7,9,14,5854,7528,5696,-1832
2016,7,9,15,6563,8467,6302,-2165
2016,7,9,16,7271,9289,6866,-2423
2016,7,9,17,7799,9931,7339,-2592
2016,7,9,18,8210,10375,7593,-2782
2016,7,9,19,8460,10696,7836,-2860
2016,7,9,20,8629,10908,8024,-2884
2016,7,9,21,8599,10938,8115,-2823
2016,7,9,22,8482,10851,8047,-2804
2016,7,9,23,8146,10358,7654,-2704
2016,7,10,0,7708,9762,7216,-2546
2016,7,10,1,7253,9221,6741,-2480
2016,7,10,2,6738,8725,6399,-2326
2016,7,10,3,6225,8082,5899,-2183
2016,7,10,4,5683,7303,5467,-1836
2016,7,10,5,5207,6648,4995,-1653
2016,7,10,6,4747,6118,4579,-1539
2016,7,10,7,4388,5692,4255,-1437
2016,7,10,8,4170,5396,4035,-1361
2016,7,10,9,4017,5198,3880,-1318
2016,7,10,10,3956,5163,3842,-1321
2016,7,10,11,3934,5176,3856,-1320
2016,7,10,12,4103,5405,4015,-1390
2016,7,10,13,4794,6280,4665,-1615
2016,7,10,14,5594,7259,5475,-1784
2016,7,10,15,6364,8219,6109,-2110
2016,7,10,16,7049,8991,6608,-2383
2016,7,10,17,7571,9541,7030,-2511
2016,7,10,18,8138,9956,7269,-2687
2016,7,10,19,8414,10155,7453,-2702
2016,7,10,20,8508,10209,7522,-2687
2016,7,10,21,8463,9950,7281,-2669
2016,7,10,22,8305,9701,7067,-2634
2016,7,10,23,7993,9459,6881,-2578
2016,7,11,0,7611,9108,6735,-2373
2016,7,11,1,7121,8759,6458,-2301
2016,7,11,2,6728,8336,6153,-2183
2016,7,11,3,6148,7665,5625,-2040
2016,7,11,4,5554,6909,5184,-1725
2016,7,11,5,5010,6235,4661,-1574
2016,7,11,6,4610,5747,4292,-1455
2016,7,11,7,4336,5409,4040,-1369
2016,7,11,8,4156,5209,3870,-1339
2016,7,11,9,4106,5139,3826,-1313
2016,7,11,10,4243,5306,3960,-1346
2016,7,11,11,4534,5686,4286,-1400
2016,7,11,12,4841,6048,4577,-1471
2016,7,11,13,5341,6741,5163,-1578
2016,7,11,14,6092,7659,5830,-1829
2016,7,11,15,6756,8602,6573,-2029
2016,7,11,16,7454,9461,7083,-2378
2016,7,11,17,7876,10171,7625,-2546
2016,7,11,18,8339,10657,8030,-2627
2016,7,11,19,8581,10961,8258,-2703
2016,7,11,20,8680,11060,8338,-2722
2016,7,11,21,8659,11086,8344,-2742
2016,7,11,22,8485,11057,8341,-2716
2016,7,11,23,8302,10646,8022,-2624
2016,7,12,0,7774,10144,7711,-2433
2016,7,12,1,7423,9658,7256,-2402
2016,7,12,2,6962,8923,6626,-2297
2016,7,12,3,6372,8146,6100,-2046
2016,7,12,4,5759,7256,5555,-1701
2016,7,12,5,5166,6552,4872,-1680
2016,7,12,6,4756,5998,4377,-1621
2016,7,12,7,4479,5627,4107,-1520
2016,7,12,8,4292,5381,3905,-1476
2016,7,12,9,4232,5294,3847,-1447
2016,7,12,10,4350,5419,3927,-1492
2016,7,12,11,4627,5775,4209,-1566
2016,7,12,12,4913,6069,4574,-1495
2016,7,12,13,5369,6764,5101,-1663
2016,7,12,14,5978,7628,5786,-1842
2016,7,12,15,6713,8544,6560,-1984
2016,7,12,16,7335,9400,7185,-2215
2016,7,12,17,7804,10064,7633,-2431
2016,7,12,18,8259,10483,7833,-2650
2016,7,12,19,8483,10684,7974,-2710
2016,7,12,20,8575,10915,8211,-2704
2016,7,12,21,8558,11115,8381,-2734
2016,7,12,22,8347,11037,8335,-2702
2016,7,12,23,8033,10521,7914,-2607
2016,7,13,0,7740,9831,7435,-2396
2016,7,13,1,7340,9267,6946,-2321
2016,7,13,2,6931,8505,6396,-2109
2016,7,13,3,6343,7650,5717,-1933
2016,7,13,4,5722,6824,5074,-1750
2016,7,13,5,5223,6172,4586,-1586
2016,7,13,6,4797,5695,4194,-1501
2016,7,13,7,4519,5347,3915,-1432
2016,7,13,8,4336,5125,3732,-1393
2016,7,13,9,4278,5051,3684,-1367
2016,7,13,10,4392,5168,3754,-1414
2016,7,13,11,4649,5492,4004,-1488
2016,7,13,12,4921,5790,4368,-1422
2016,7,13,13,5376,6451,4898,-1553
2016,7,13,14,6060,7248,5498,-1750
2016,7,13,15,6840,8158,6146,-2012
2016,7,13,16,7456,9055,6853,-2202
2016,7,13,17,7871,9836,7342,-2494
2016,7,13,18,8341,10397,7671,-2726
2016,7,13,19,8618,10580,7788,-2792
2016,7,13,20,8743,10516,7713,-2803
2016,7,13,21,8753,10280,7480,-2800
2016,7,13,22,8600,10014,7248,-2766
2016,7,13,23,8292,9584,6920,-2664
2016,7,14,0,7833,8958,6594,-2364
2016,7,14,1,7469,8431,6168,-2263
2016,7,14,2,7043,7926,5770,-2156
2016,7,14,3,6458,7294,5303,-1991
2016,7,14,4,5831,6509,4728,-1781
2016,7,14,5,5073,5846,4185,-1661
2016,7,14,6,4634,5341,3810,-1531
2016,7,14,7,4347,5005,3557,-1448
2016,7,14,8,4166,4823,3414,-1409
2016,7,14,9,4106,4779,3390,-1389
2016,7,14,10,4241,4963,3543,-1420
2016,7,14,11,4509,5363,3886,-1477
2016,7,14,12,4818,5715,4267,-1448
2016,7,14,13,5246,6338,4757,-1581
2016,7,14,14,5872,7188,5395,-1793
2016,7,14,15,6626,8136,6061,-2075
2016,7,14,16,7223,9009,6721,-2288
2016,7,14,17,7667,9719,7316,-2403
2016,7,14,18,8057,10282,7775,-2507
2016,7,14,19,8355,10689,8032,-2657
2016,7,14,20,8470,10910,8153,-2757
2016,7,14,21,8474,11058,8256,-2802
2016,7,14,22,8270,10901,8114,-2787
2016,7,14,23,8053,10204,7632,-2572
2016,7,15,0,7600,9601,7185,-2416
2016,7,15,1,7288,9055,6697,-2358
2016,7,15,2,6860,8528,6274,-2254
2016,7,15,3,6308,7831,5768,-2063
2016,7,15,4,5677,7031,5147,-1884
2016,7,15,5,4927,6366,4632,-1734
2016,7,15,6,4528,5829,4244,-1585
2016,7,15,7,4272,5435,3935,-1500
2016,7,15,8,4132,5216,3770,-1446
2016,7,15,9,4079,5140,3713,-1427
2016,7,15,10,4203,5301,3864,-1437
2016,7,15,11,4486,5645,4153,-1492
2016,7,15,12,4744,5912,4474,-1438
2016,7,15,13,5151,6604,4977,-1627
2016,7,15,14,5716,7411,5602,-1809
2016,7,15,15,6396,8289,6197,-2092
2016,7,15,16,7064,9088,6773,-2315
2016,7,15,17,7578,9707,7119,-2588
2016,7,15,18,7974,10226,7471,-2755
2016,7,15,19,8345,10555,7810,-2745
2016,7,15,20,8473,10692,7943,-2749
2016,7,15,21,8480,10710,7988,-2722
2016,7,15,22,8318,10536,7854,-2682
2016,7,15,23,8009,10006,7563,-2443
2016,7,16,0,7491,9270,6950,-2320
2016,7,16,1,7164,8717,6441,-2276
2016,7,16,2,6767,8160,5953,-2207
2016,7,16,3,6232,7484,5462,-2022
2016,7,16,4,5588,6727,4867,-1860
2016,7,16,5,5124,6124,4490,-1634
2016,7,16,6,4715,5683,4185,-1498
2016,7,16,7,4418,5319,3878,-1441
2016,7,16,8,4216,5074,3695,-1379
2016,7,16,9,4100,4949,3593,-1356
2016,7,16,10,4090,4957,3597,-1360
2016,7,16,11,4123,5048,3682,-1366
2016,7,16,12,4327,5314,3947,-1367
2016,7,16,13,4908,6128,4536,-1592
2016,7,16,14,5607,7076,5186,-1890
2016,7,16,15,6354,7981,5854,-2127
2016,7,16,16,7021,8785,6429,-2356
2016,7,16,17,7499,9444,6933,-2511
2016,7,16,18,7823,9899,7283,-2616
2016,7,16,19,8030,10059,7438,-2621
2016,7,16,20,8082,9818,7147,-2671
2016,7,16,21,7921,9621,7127,-2494
2016,7,16,22,7662,9365,6934,-2431
2016,7,16,23,7311,9002,6665,-2337
2016,7,17,0,6880,8524,6264,-2260
2016,7,17,1,6628,8163,5868,-2295
2016,7,17,2,6308,7684,5363,-2321
2016,7,17,3,5880,7079,4974,-2105
2016,7,17,4,5415,6428,4585,-1843
2016,7,17,5,4987,5818,4242,-1576
2016,7,17,6,4614,5364,3945,-1419
2016,7,17,7,4334,5029,3743,-1286
2016,7,17,8,4118,4841,3575,-1266
2016,7,17,9,4025,4714,3473,-1241
2016,7,17,10,3995,4697,3454,-1243
2016,7,17,11,3969,4770,3519,-1251
2016,7,17,12,4133,5021,3741,-1280
2016,7,17,13,4669,5810,4377,-1433
2016,7,17,14,5435,6846,5054,-1792
2016,7,17,15,6201,7794,5667,-2127
2016,7,17,16,6801,8613,6298,-2315
2016,7,17,17,7285,9362,6913,-2449
2016,7,17,18,7670,9781,7171,-2610
2016,7,17,19,7957,10038,7326,-2712
2016,7,17,20,8039,10293,7508,-2785
2016,7,17,21,8077,10315,7552,-2763
2016,7,17,22,7978,10348,7602,-2746
2016,7,17,23,7647,10026,7365,-2661
2016,7,18,0,7219,9366,6803,-2563
2016,7,18,1,6910,8784,6355,-2429
2016,7,18,2,6500,8244,5844,-2400
2016,7,18,3,5981,7569,5382,-2187
2016,7,18,4,5444,6776,4864,-1912
2016,7,18,5,4941,6325,4650,-1675
2016,7,18,6,4537,5823,4268,-1555
2016,7,18,7,4276,5507,4024,-1483
2016,7,18,8,4118,5297,3862,-1435
2016,7,18,9,4073,5257,3838,-1419
2016,7,18,10,4194,5449,3985,-1464
2016,7,18,11,4531,5856,4327,-1529
2016,7,18,12,4801,6199,4733,-1466
2016,7,18,13,5245,6787,5202,-1585
2016,7,18,14,5886,7543,5707,-1836
2016,7,18,15,6614,8329,6222,-2107
2016,7,18,16,7176,9025,6760,-2265
2016,7,18,17,7576,9407,6978,-2429
2016,7,18,18,7929,9487,6941,-2546
2016,7,18,19,8185,9606,7063,-2543
2016,7,18,20,8307,9708,7212,-2496
2016,7,18,21,8307,9457,7026,-2431
2016,7,18,22,8122,9139,6624,-2515
2016,7,18,23,7829,8921,6296,-2625
2016,7,19,0,7437,8678,6116,-2562
2016,7,19,1,7107,8398,5913,-2485
2016,7,19,2,6676,8001,5657,-2344
2016,7,19,3,6115,7400,5264,-2136
2016,7,19,4,5516,6677,4821,-1856
2016,7,19,5,5040,5837,4238,-1599
2016,7,19,6,4644,5402,3948,-1454
2016,7,19,7,4356,5105,3703,-1402
2016,7,19,8,4187,4911,3561,-1350
2016,7,19,9,4134,4850,3512,-1338
2016,7,19,10,4251,5017,3624,-1393
2016,7,19,11,4556,5412,3968,-1444
2016,7,19,12,4817,5760,4320,-1440
2016,7,19,13,5235,6426,4826,-1600
2016,7,19,14,5813,7195,5351,-1844
2016,7,19,15,6491,8006,5874,-2132
2016,7,19,16,7048,8836,6481,-2355
2016,7,19,17,7452,9475,7024,-2451
2016,7,19,18,7830,9699,7231,-2468
2016,7,19,19,8110,9512,7135,-2377
2016,7,19,20,8253,9074,6821,-2253
2016,7,19,21,8202,8663,6314,-2349
2016,7,19,22,8001,8460,6060,-2400
2016,7,19,23,7724,8256,5885,-2371
2016,7,20,0,7349,7950,5582,-2368
2016,7,20,1,7014,7752,5403,-2349
2016,7,20,2,6576,7423,5166,-2257
2016,7,20,3,6008,6850,4838,-2012
2016,7,20,4,5375,6165,4383,-1782
2016,7,20,5,4955,5554,4010,-1544
2016,7,20,6,4550,5142,3730,-1412
2016,7,20,7,4307,4854,3495,-1359
2016,7,20,8,4162,4706,3396,-1310
2016,7,20,9,4109,4700,3404,-1296
2016,7,20,10,4228,4884,3535,-1349
2016,7,20,11,4524,5298,3872,-1426
2016,7,20,12,4786,5617,4159,-1458
2016,7,20,13,5223,6241,4672,-1569
2016,7,20,14,5790,7045,5246,-1799
2016,7,20,15,6485,7884,5871,-2013
2016,7,20,16,7105,8715,6481,-2234
2016,7,20,17,7555,9440,7032,-2408
2016,7,20,18,7909,10040,7583,-2457
2016,7,20,19,8200,10520,7994,-2526
2016,7,20,20,8277,10712,8053,-2659
2016,7,20,21,8282,10701,8010,-2691
2016,7,20,22,8142,10638,7927,-2711
2016,7,20,23,7747,10390,7766,-2624
2016,7,21,0,7443,9869,7308,-2561
2016,7,21,1,7051,9385,6801,-2584
2016,7,21,2,6630,8799,6381,-2418
2016,7,21,3,6103,0,6381,-2212
2016,7,21,4,5562,7205,5165,-2040
2016,7,21,5,5063,6512,4674,-1838
2016,7,21,6,4637,5960,4281,-1679
2016,7,21,7,4407,5577,3989,-1588
2016,7,21,8,4263,5335,3793,-1542
2016,7,21,9,4213,5262,3740,-1522
2016,7,21,10,4342,5393,3849,-1544
2016,7,21,11,4657,5755,4159,-1596
2016,7,21,12,4926,6051,4524,-1527
2016,7,21,13,5405,6670,4998,-1672
2016,7,21,14,5990,7461,5519,-1942
2016,7,21,15,6679,8385,6162,-2223
2016,7,21,16,7153,9146,6760,-2386
2016,7,21,17,7618,9781,7261,-2520
2016,7,21,18,7946,10151,7575,-2576
2016,7,21,19,8194,10355,7722,-2633
2016,7,21,20,8283,10386,7756,-2630
2016,7,21,21,8215,9920,7386,-2534
2016,7,21,22,8056,9266,6822,-2444
2016,7,21,23,7713,8796,6395,-2401
2016,7,22,0,7393,8391,6051,-2340
2016,7,22,1,7042,8095,5791,-2304
2016,7,22,2,6606,7719,5564,-2155
2016,7,22,3,6062,7131,5141,-1990
2016,7,22,4,5483,6476,4618,-1858
2016,7,22,5,5070,5920,4285,-1635
2016,7,22,6,4616,5472,3994,-1478
2016,7,22,7,4350,5151,3748,-1403
2016,7,22,8,4203,4951,3565,-1386
2016,7,22,9,4136,4919,3543,-1376
2016,7,22,10,4230,5052,3655,-1397
2016,7,22,11,4561,5382,3857,-1525
2016,7,22,12,4806,5703,4227,-1476
2016,7,22,13,5257,6253,4647,-1606
2016,7,22,14,5835,6976,5069,-1907
2016,7,22,15,6501,7894,5692,-2202
2016,7,22,16,6924,8738,6353,-2385
2016,7,22,17,7390,9396,6935,-2461
2016,7,22,18,7698,9827,7262,-2565
2016,7,22,19,7962,9965,7439,-2526
2016,7,22,20,7990,9742,7285,-2457
2016,7,22,21,7985,9329,6872,-2457
2016,7,22,22,7798,8787,6452,-2335
2016,7,22,23,7402,8567,6483,-2084
2016,7,23,0,7118,8182,6263,-1919
2016,7,23,1,6707,7740,5761,-1979
2016,7,23,2,6279,7201,5108,-2093
2016,7,23,3,5833,6637,4648,-1989
2016,7,23,4,5353,6005,4178,-1827
2016,7,23,5,4837,5624,4040,-1584
2016,7,23,6,4457,5165,3701,-1464
2016,7,23,7,4230,4849,3445,-1404
2016,7,23,8,4075,4615,3278,-1337
2016,7,23,9,3991,4516,3196,-1320
2016,7,23,10,4006,4527,3207,-1320
2016,7,23,11,4082,4651,3297,-1354
2016,7,23,12,4264,4852,3536,-1316
2016,7,23,13,4801,5566,4081,-1485
2016,7,23,14,5525,6460,4838,-1622
2016,7,23,15,6173,7337,5414,-1923
2016,7,23,16,6846,8154,6037,-2117
2016,7,23,17,7368,8883,6589,-2294
2016,7,23,18,7708,9375,6944,-2431
2016,7,23,19,8003,9628,7102,-2526
2016,7,23,20,8124,9715,7177,-2538
2016,7,23,21,8089,9815,7282,-2533
2016,7,23,22,7911,9771,7269,-2502
2016,7,23,23,7534,9605,7088,-2517
2016,7,24,0,7128,9073,6591,-2482
2016,7,24,1,6726,8525,6008,-2517
2016,7,24,2,6362,7908,5537,-2371
2016,7,24,3,5899,7290,5137,-2153
2016,7,24,4,5441,6628,4699,-1929
2016,7,24,5,4721,6091,4398,-1693
2016,7,24,6,4329,5594,4032,-1562
2016,7,24,7,4069,5208,3771,-1437
2016,7,24,8,3908,4960,3553,-1407
2016,7,24,9,3822,4810,3458,-1352
2016,7,24,10,3795,4724,3376,-1348
2016,7,24,11,3811,4818,3464,-1354
2016,7,24,12,3968,5026,3679,-1347
2016,7,24,13,4495,5842,4281,-1561
2016,7,24,14,5228,6808,4937,-1871
2016,7,24,15,5914,7708,5661,-2047
2016,7,24,16,6491,8538,6349,-2189
2016,7,24,17,7024,9234,6885,-2349
2016,7,24,18,7319,9728,7240,-2488
2016,7,24,19,7548,9973,7440,-2533
2016,7,24,20,7626,10090,7528,-2562
2016,7,24,21,7537,9937,7460,-2477
2016,7,24,22,7384,9572,7105,-2467
2016,7,24,23,7041,8983,6640,-2343
2016,7,25,0,6627,8431,6151,-2280
2016,7,25,1,6334,8051,5869,-2182
2016,7,25,2,5998,7587,5488,-2099
2016,7,25,3,5491,6975,5024,-1951
2016,7,25,4,5054,6222,4436,-1786
2016,7,25,5,4811,5509,3950,-1559
2016,7,25,6,4446,5053,3641,-1412
2016,7,25,7,4165,4779,3442,-1337
2016,7,25,8,4024,4598,3292,-1306
2016,7,25,9,3949,4591,3275,-1316
2016,7,25,10,4029,4792,3416,-1376
2016,7,25,11,4392,5202,3772,-1430
2016,7,25,12,4627,5537,4142,-1395
2016,7,25,13,5062,6145,4609,-1536
2016,7,25,14,5611,6920,5095,-1825
2016,7,25,15,6281,7756,5663,-2093
2016,7,25,16,6812,8462,6211,-2251
2016,7,25,17,7192,9113,6673,-2440
2016,7,25,18,7519,9653,7198,-2455
2016,7,25,19,7802,9995,7508,-2487
2016,7,25,20,7863,10137,7557,-2580
2016,7,25,21,7891,10207,7731,-2476
2016,7,25,22,7784,10083,7624,-2459
2016,7,25,23,7381,9804,7405,-2399
2016,7,26,0,7006,9340,6864,-2476
2016,7,26,1,6759,8904,6426,-2478
2016,7,26,2,6385,8373,6030,-2343
2016,7,26,3,5855,7623,5466,-2157
2016,7,26,4,5276,6843,4925,-1918
2016,7,26,5,4594,6344,4694,-1650
2016,7,26,6,4271,5837,4331,-1506
2016,7,26,7,4064,5482,4043,-1439
2016,7,26,8,3937,5253,3855,-1398
2016,7,26,9,3927,5185,3801,-1384
2016,7,26,10,4072,5371,3931,-1440
2016,7,26,11,4377,5729,4254,-1475
2016,7,26,12,4632,6042,4565,-1477
2016,7,26,13,5031,6636,5041,-1595
2016,7,26,14,5694,7427,5580,-1847
2016,7,26,15,6295,8294,6209,-2085
2016,7,26,16,6916,9112,6822,-2290
2016,7,26,17,7409,9847,7326,-2521
2016,7,26,18,7810,10416,7889,-2527
2016,7,26,19,8083,10797,8247,-2550
2016,7,26,20,8160,11042,8425,-2617
2016,7,26,21,8083,11199,8534,-2665
2016,7,26,22,7938,11117,8510,-2607
2016,7,26,23,7654,10807,8182,-2625
2016,7,27,0,7253,10323,7865,-2458
2016,7,27,1,6979,9857,7437,-2420
2016,7,27,2,6537,9302,7091,-2211
2016,7,27,3,6012,8529,6438,-2091
2016,7,27,4,5459,7690,5722,-1968
2016,7,27,5,4975,6747,4979,-1768
2016,7,27,6,4628,6205,4586,-1619
2016,7,27,7,4382,5849,4298,-1551
2016,7,27,8,4202,5596,4096,-1500
2016,7,27,9,4147,5494,4016,-1478
2016,7,27,10,4257,5607,4103,-1504
2016,7,27,11,4491,5915,4381,-1534
2016,7,27,12,4727,6140,4614,-1526
2016,7,27,13,5172,6710,5055,-1655
2016,7,27,14,5727,7533,5677,-1856
2016,7,27,15,6464,8501,6353,-2148
2016,7,27,16,7077,9398,7052,-2346
2016,7,27,17,7511,10120,7668,-2452
2016,7,27,18,7980,10684,7990,-2694
2016,7,27,19,8373,11096,8271,-2825
2016,7,27,20,8503,11320,8673,-2647
2016,7,27,21,8481,11460,8725,-2735
2016,7,27,22,8324,11405,8620,-2785
2016,7,27,23,7960,11095,8244,-2851
2016,7,28,0,7501,10483,7845,-2638
2016,7,28,1,7174,9920,7387,-2533
2016,7,28,2,6763,9331,6867,-2464
2016,7,28,3,6217,8537,6340,-2197
2016,7,28,4,5614,7667,5724,-1943
2016,7,28,5,5466,7152,5526,-1626
2016,7,28,6,5026,6567,5082,-1485
2016,7,28,7,4724,6128,4735,-1393
2016,7,28,8,4538,5858,4427,-1431
2016,7,28,9,4457,5714,4294,-1420
2016,7,28,10,4563,5804,4359,-1445
2016,7,28,11,4855,6160,4686,-1474
2016,7,28,12,5105,6397,4943,-1454
2016,7,28,13,5570,7006,5450,-1556
2016,7,28,14,6246,7834,6009,-1825
2016,7,28,15,6926,8774,6635,-2139
2016,7,28,16,7594,9622,7212,-2410
2016,7,28,17,8049,10312,7748,-2564
2016,7,28,18,8520,10957,8334,-2623
2016,7,28,19,8891,11363,8643,-2720
2016,7,28,20,9057,11607,8852,-2755
2016,7,28,21,9087,11692,8902,-2790
2016,7,28,22,8933,11585,8845,-2740
2016,7,28,23,8599,11260,8581,-2679
2016,7,29,0,8213,10727,8196,-2531
2016,7,29,1,7870,10184,7698,-2486
2016,7,29,2,7360,9620,7221,-2399
2016,7,29,3,6774,8847,6504,-2343
2016,7,29,4,6146,8037,5921,-2116
2016,7,29,5,5436,7080,5253,-1827
2016,7,29,6,5037,6504,4830,-1674
2016,7,29,7,4772,6058,4505,-1553
2016,7,29,8,4584,5765,4230,-1535
2016,7,29,9,4500,5631,4140,-1491
2016,7,29,10,4585,5680,4163,-1517
2016,7,29,11,4832,5987,4428,-1559
2016,7,29,12,5036,6189,4730,-1459
2016,7,29,13,5458,6851,5299,-1552
2016,7,29,14,6083,7685,5880,-1805
2016,7,29,15,6778,8503,6376,-2127
2016,7,29,16,7439,9084,6876,-2208
2016,7,29,17,7936,9508,7181,-2327
2016,7,29,18,8339,9705,7297,-2408
2016,7,29,19,8620,9708,7228,-2480
2016,7,29,20,8788,9548,7039,-2509
2016,7,29,21,8897,9252,6733,-2519
2016,7,29,22,8813,9065,6487,-2578
2016,7,29,23,8603,8785,6159,-2626
2016,7,30,0,8152,8407,5741,-2666
2016,7,30,1,7751,8172,5663,-2509
2016,7,30,2,7309,7803,5449,-2354
2016,7,30,3,6747,7284,5128,-2156
2016,7,30,4,6135,6691,4713,-1978
2016,7,30,5,5115,6080,4396,-1684
2016,7,30,6,4760,5655,4126,-1529
2016,7,30,7,4482,5342,3872,-1470
2016,7,30,8,4271,5141,3739,-1402
2016,7,30,9,4173,5032,3640,-1392
2016,7,30,10,4174,5055,3670,-1385
2016,7,30,11,4169,5170,3790,-1380
2016,7,30,12,4315,5363,3946,-1417
2016,7,30,13,4842,6143,4523,-1620
2016,7,30,14,5539,7079,5246,-1833
2016,7,30,15,6203,7875,5878,-1997
2016,7,30,16,6840,8355,6226,-2129
2016,7,30,17,7311,8769,6558,-2211
2016,7,30,18,7745,9144,6787,-2357
2016,7,30,19,8077,9345,6866,-2479
2016,7,30,20,8220,9377,7007,-2370
2016,7,30,21,8186,9240,6941,-2299
2016,7,30,22,8084,8886,6538,-2348
2016,7,30,23,7799,8514,6112,-2402
2016,7,31,0,7352,8181,5782,-2399
2016,7,31,1,7048,8023,5709,-2314
2016,7,31,2,6607,7648,5467,-2181
2016,7,31,3,6112,7084,4997,-2087
2016,7,31,4,5581,6536,4636,-1900
2016,7,31,5,4964,5985,4319,-1666
2016,7,31,6,4572,5510,4006,-1504
2016,7,31,7,4271,5173,3722,-1451
2016,7,31,8,4081,4947,3551,-1396
2016,7,31,9,3962,4798,3422,-1376
2016,7,31,10,3926,4767,3390,-1377
2016,7,31,11,3966,4836,3444,-1392
2016,7,31,12,4118,5018,3635,-1383
2016,7,31,13,4745,5817,4215,-1602
2016,7,31,14,5602,6764,4944,-1820
2016,7,31,15,6353,7713,5696,-2017
2016,7,31,16,6866,8612,6347,-2265
2016,7,31,17,7370,9379,6946,-2433
2016,7,31,18,7682,9875,7301,-2574
2016,7,31,19,7884,10247,7565,-2682
2016,7,31,20,7950,10515,7762,-2753
2016,7,31,21,7880,10620,7836,-2784
2016,7,31,22,7753,10628,7937,-2691
2016,7,31,23,7458,10283,7705,-2578
2016,8,1,0,6973,9697,7218,-2479
2016,8,1,1,6708,9192,6844,-2348
2016,8,1,2,6328,8506,6352,-2154
2016,8,1,3,5832,7705,5742,-1963
2016,8,1,4,5305,6874,5061,-1813
2016,8,1,5,4910,6355,4871,-1484
2016,8,1,6,4537,5798,4332,-1466
2016,8,1,7,4299,5437,4022,-1415
2016,8,1,8,4127,5182,3824,-1358
2016,8,1,9,4087,5123,3778,-1345
2016,8,1,10,4207,5315,3933,-1382
2016,8,1,11,4533,5707,4278,-1429
2016,8,1,12,4767,6002,4685,-1317
2016,8,1,13,5241,6588,5276,-1312
2016,8,1,14,5878,7420,5839,-1581
2016,8,1,15,6556,8313,6425,-1888
2016,8,1,16,7246,9148,7044,-2104
2016,8,1,17,7737,9813,7466,-2347
2016,8,1,18,8113,10405,7939,-2466
2016,8,1,19,8429,10756,8247,-2509
2016,8,1,20,8498,10902,8416,-2486
2016,8,1,21,8514,10923,8401,-2522
2016,8,1,22,8249,10698,8279,-2417
2016,8,1,23,7905,10308,7916,-2390
2016,8,2,0,7503,9794,7527,-2266
2016,8,2,1,7156,9420,7236,-2182
2016,8,2,2,6727,8818,6807,-2010
2016,8,2,3,6154,8104,6263,-1840
2016,8,2,4,5539,7373,5630,-1742
2016,8,2,5,5112,6460,5033,-1427
2016,8,2,6,4723,5971,4610,-1361
2016,8,2,7,4465,5640,4254,-1386
2016,8,2,8,4282,5377,4029,-1348
2016,8,2,9,4228,5288,3941,-1347
2016,8,2,10,4333,5408,4049,-1359
2016,8,2,11,4639,5796,4464,-1332
2016,8,2,12,4857,6004,4807,-1197
2016,8,2,13,5271,6514,5266,-1248
2016,8,2,14,5895,7330,5911,-1419
2016,8,2,15,6539,8238,6495,-1743
2016,8,2,16,7215,9077,7134,-1943
2016,8,2,17,7660,9762,7480,-2282
2016,8,2,18,8026,10322,7966,-2356
2016,8,2,19,8322,10699,8202,-2497
2016,8,2,20,8383,10783,8305,-2478
2016,8,2,21,8369,10590,8109,-2481
2016,8,2,22,8169,10352,7863,-2489
2016,8,2,23,7777,10120,7733,-2387
2016,8,3,0,7373,9661,7288,-2373
2016,8,3,1,7112,9174,6845,-2329
2016,8,3,2,6706,8545,6401,-2144
2016,8,3,3,6138,7749,5749,-2000
2016,8,3,4,5524,6943,5247,-1696
2016,8,3,5,5030,6292,4874,-1418
2016,8,3,6,4656,5764,4412,-1352
2016,8,3,7,4411,5415,4074,-1341
2016,8,3,8,4240,5219,3915,-1304
2016,8,3,9,4206,5160,3861,-1299
2016,8,3,10,4337,5264,3940,-1324
2016,8,3,11,4661,5642,4329,-1313
2016,8,3,12,4881,5867,4611,-1256
2016,8,3,13,5326,6392,4993,-1399
2016,8,3,14,5937,7114,5514,-1600
2016,8,3,15,6589,7972,6108,-1864
2016,8,3,16,7136,8800,6832,-1968
2016,8,3,17,7629,9364,7225,-2139
2016,8,3,18,7958,9709,7467,-2242
2016,8,3,19,8175,9833,7489,-2344
2016,8,3,20,8195,9950,7537,-2413
2016,8,3,21,8105,10078,7641,-2437
2016,8,3,22,7863,10162,7680,-2482
2016,8,3,23,7483,9892,7458,-2434
2016,8,4,0,7065,9354,6920,-2434
2016,8,4,1,6874,9016,6595,-2421
2016,8,4,2,6495,8446,6147,-2299
2016,8,4,3,5962,7751,5689,-2062
2016,8,4,4,5415,6946,5111,-1835
2016,8,4,5,4853,6316,4630,-1686
2016,8,4,6,4505,5821,4337,-1484
2016,8,4,7,4277,5468,4007,-1461
2016,8,4,8,4124,5265,3858,-1407
2016,8,4,9,4098,5219,3829,-1390
2016,8,4,10,4233,5391,3951,-1440
2016,8,4,11,4533,5798,4293,-1505
2016,8,4,12,4750,6016,4517,-1499
2016,8,4,13,5098,6482,4879,-1603
2016,8,4,14,5632,7079,5251,-1828
2016,8,4,15,6244,7766,5772,-1994
2016,8,4,16,6819,8236,6131,-2105
2016,8,4,17,7114,8507,6313,-2194
2016,8,4,18,7360,8725,6473,-2252
2016,8,4,19,7480,8797,6477,-2320
2016,8,4,20,7487,8809,6458,-2351
2016,8,4,21,7457,8792,6459,-2333
2016,8,4,22,7255,8572,6331,-2241
2016,8,4,23,7055,8330,5986,-2344
2016,8,5,0,6708,8044,5751,-2293
2016,8,5,1,6529,7867,5607,-2260
2016,8,5,2,6165,7451,5207,-2244
2016,8,5,3,5674,6869,4825,-2044
2016,8,5,4,5153,6216,4425,-1791
2016,8,5,5,4474,5657,4080,-1577
2016,8,5,6,4164,5256,3802,-1454
2016,8,5,7,4002,4972,3579,-1393
2016,8,5,8,3885,4850,3468,-1382
2016,8,5,9,3896,4814,3449,-1365
2016,8,5,10,4018,4980,3587,-1393
2016,8,5,11,4329,5438,3959,-1479
2016,8,5,12,4553,5712,4339,-1373
2016,8,5,13,4901,6277,4881,-1396
2016,8,5,14,5452,7053,5306,-1747
2016,8,5,15,5934,7899,6033,-1866
2016,8,5,16,6509,8610,6599,-2011
2016,8,5,17,6663,9106,7034,-2072
2016,8,5,18,6910,9438,7479,-1959
2016,8,5,19,6928,9408,7494,-1914
2016,8,5,20,6853,9173,7331,-1842
2016,8,5,21,6820,8733,6917,-1816
2016,8,5,22,6602,8359,6536,-1823
2016,8,5,23,6356,8053,6275,-1778
2016,8,6,0,6007,7746,5989,-1757
2016,8,6,1,5892,7581,5789,-1792
2016,8,6,2,5646,7251,5424,-1827
2016,8,6,3,5263,6769,5083,-1686
2016,8,6,4,4843,6167,4626,-1541
2016,8,6,5,4503,5693,4220,-1473
2016,8,6,6,4202,5278,3850,-1428
2016,8,6,7,4016,4948,3584,-1364
2016,8,6,8,3891,4791,3436,-1355
2016,8,6,9,3840,4722,3391,-1331
2016,8,6,10,3880,4769,3418,-1351
2016,8,6,11,3989,4967,3609,-1358
2016,8,6,12,4139,5155,3846,-1309
2016,8,6,13,4594,5700,4335,-1365
2016,8,6,14,5226,6419,4885,-1534
2016,8,6,15,5769,7130,5350,-1780
2016,8,6,16,6208,7694,5919,-1775
2016,8,6,17,6507,8034,6255,-1779
2016,8,6,18,6596,8183,6411,-1772
2016,8,6,19,6626,8208,6384,-1824
2016,8,6,20,6719,8073,6233,-1840
2016,8,6,21,6700,7904,6084,-1820
2016,8,6,22,6519,7654,5735,-1919
2016,8,6,23,6295,7370,5480,-1890
2016,8,7,0,5860,7115,5234,-1881
2016,8,7,1,5721,7054,5159,-1895
2016,8,7,2,5459,6801,5091,-1710
2016,8,7,3,5080,6406,5024,-1382
2016,8,7,4,4678,5921,4550,-1371
2016,8,7,5,4514,5494,4239,-1255
2016,8,7,6,4218,5132,3939,-1193
2016,8,7,7,4021,4873,3753,-1120
2016,8,7,8,3867,4755,3643,-1112
2016,8,7,9,3794,4699,3587,-1112
2016,8,7,10,3800,4684,3561,-1123
2016,8,7,11,3881,4837,3688,-1149
2016,8,7,12,3997,5028,3913,-1115
2016,8,7,13,4448,5583,4438,-1145
2016,8,7,14,5073,6214,4937,-1277
2016,8,7,15,5705,6797,5297,-1500
2016,8,7,16,6057,7069,5551,-1518
2016,8,7,17,6328,7154,5596,-1558
2016,8,7,18,6473,7230,5467,-1763
2016,8,7,19,6568,7320,5383,-1937
2016,8,7,20,6515,7504,5520,-1984
2016,8,7,21,6363,7698,5631,-2067
2016,8,7,22,6267,7789,5668,-2121
2016,8,7,23,5999,7638,5526,-2112
2016,8,8,0,5714,7350,5346,-2004
2016,8,8,1,5658,7255,5280,-1975
2016,8,8,2,5399,6887,4988,-1899
2016,8,8,3,4950,6378,4760,-1618
2016,8,8,4,4517,5832,4212,-1620
2016,8,8,5,4177,5417,3928,-1489
2016,8,8,6,3923,5025,3683,-1342
2016,8,8,7,3766,4761,3476,-1285
2016,8,8,8,3673,4631,3374,-1257
2016,8,8,9,3669,4625,3360,-1265
2016,8,8,10,3847,4917,3590,-1327
2016,8,8,11,4235,5381,3975,-1406
2016,8,8,12,4479,5635,4270,-1365
2016,8,8,13,4870,5965,4498,-1467
2016,8,8,14,5337,6351,4841,-1510
2016,8,8,15,5796,6870,5130,-1740
2016,8,8,16,6289,7391,5536,-1855
2016,8,8,17,6501,7646,5728,-1918
2016,8,8,18,6724,7753,5745,-2008
2016,8,8,19,6826,7792,5802,-1990
2016,8,8,20,6824,7889,5879,-2010
2016,8,8,21,6679,8046,5983,-2063
2016,8,8,22,6606,7967,5893,-2074
2016,8,8,23,6424,7842,5726,-2116
2016,8,9,0,6083,7596,5524,-2072
2016,8,9,1,5946,7564,5525,-2039
2016,8,9,2,5677,7156,5239,-1917
2016,8,9,3,5234,6636,4960,-1676
2016,8,9,4,4729,6046,4407,-1639
2016,8,9,5,4201,5428,3928,-1500
2016,8,9,6,3929,5048,3555,-1493
2016,8,9,7,3784,4789,3350,-1439
2016,8,9,8,3684,4661,3252,-1409
2016,8,9,9,3662,4626,3229,-1397
2016,8,9,10,3826,4887,3423,-1464
2016,8,9,11,4204,5390,3840,-1550
2016,8,9,12,4441,5608,4081,-1527
2016,8,9,13,4801,5947,4314,-1633
2016,8,9,14,5262,6344,4525,-1819
2016,8,9,15,5715,6824,4798,-2026
2016,8,9,16,6259,7276,5132,-2144
2016,8,9,17,6495,7717,5528,-2189
2016,8,9,18,6752,8108,5764,-2344
2016,8,9,19,6858,8345,6091,-2254
2016,8,9,20,6862,8246,6053,-2193
2016,8,9,21,6746,7986,5759,-2227
2016,8,9,22,6615,7933,5678,-2255
2016,8,9,23,6461,7798,5572,-2226
2016,8,10,0,6102,7594,5407,-2187
2016,8,10,1,5997,7519,5290,-2229
2016,8,10,2,5710,7075,4939,-2136
2016,8,10,3,5264,6555,4589,-1966
2016,8,10,4,4767,5913,4183,-1730
2016,8,10,5,4356,5375,3911,-1464
2016,8,10,6,4084,4949,3664,-1285
2016,8,10,7,3940,4702,3496,-1206
2016,8,10,8,3842,4606,3419,-1187
2016,8,10,9,3763,4612,3423,-1189
2016,8,10,10,3966,4879,3543,-1336
2016,8,10,11,4376,5372,3975,-1397
2016,8,10,12,4593,5607,4219,-1388
2016,8,10,13,5003,5992,4551,-1441
2016,8,10,14,5509,6624,5069,-1555
2016,8,10,15,6121,7350,5576,-1774
2016,8,10,16,6659,8158,6182,-1976
2016,8,10,17,6966,8884,6766,-2118
2016,8,10,18,7314,9523,7176,-2347
2016,8,10,19,7472,9877,7463,-2414
2016,8,10,20,7540,9895,7411,-2484
2016,8,10,21,7460,9732,7215,-2517
2016,8,10,22,7211,9435,6958,-2477
2016,8,10,23,6967,8986,6697,-2289
2016,8,11,0,6574,8563,6403,-2160
2016,8,11,1,6493,8332,6259,-2073
2016,8,11,2,6118,7773,5869,-1904
2016,8,11,3,5642,7046,5356,-1690
2016,8,11,4,5136,6323,4694,-1629
2016,8,11,5,4751,5696,4068,-1628
2016,8,11,6,4463,5232,3782,-1450
2016,8,11,7,4294,4931,3534,-1397
2016,8,11,8,4187,4759,3414,-1345
2016,8,11,9,4156,4741,3404,-1337
2016,8,11,10,4311,4978,3586,-1392
2016,8,11,11,4697,5481,3981,-1500
2016,8,11,12,4907,5707,4280,-1427
2016,8,11,13,5307,6107,4589,-1518
2016,8,11,14,5852,6728,5009,-1719
2016,8,11,15,6485,7524,5409,-2115
2016,8,11,16,7038,8373,6066,-2307
2016,8,11,17,7458,9125,6681,-2444
2016,8,11,18,7751,9732,7244,-2488
2016,8,11,19,7884,10110,7509,-2601
2016,8,11,20,7844,10357,7762,-2595
2016,8,11,21,7665,10410,7875,-2535
2016,8,11,22,7460,9981,7493,-2488
2016,8,11,23,7136,9416,6916,-2500
2016,8,12,0,6860,8858,6357,-2501
2016,8,12,1,6734,8510,6001,-2509
2016,8,12,2,6342,7914,5571,-2343
2016,8,12,3,5849,7216,5203,-2013
2016,8,12,4,5331,6488,4636,-1852
2016,8,12,5,4792,6040,4428,-1612
2016,8,12,6,4461,5580,4112,-1468
2016,8,12,7,4276,5271,3863,-1408
2016,8,12,8,4152,5086,3707,-1379
2016,8,12,9,3997,5027,3674,-1353
2016,8,12,10,4205,5232,3827,-1405
2016,8,12,11,4602,5686,4197,-1489
2016,8,12,12,4827,5927,4486,-1441
2016,8,12,13,5227,6445,4874,-1571
2016,8,12,14,5726,7174,5334,-1840
2016,8,12,15,6412,7924,5756,-2168
2016,8,12,16,7013,8717,6348,-2369
2016,8,12,17,7459,9449,6996,-2453
2016,8,12,18,7835,10042,7516,-2526
2016,8,12,19,7952,10416,7851,-2565
2016,8,12,20,8002,10651,8003,-2648
2016,8,12,21,7876,10476,7854,-2622
2016,8,12,22,7665,10011,7510,-2501
2016,8,12,23,7337,9443,7072,-2371
2016,8,13,0,6899,8887,6519,-2368
2016,8,13,1,6696,8562,6126,-2436
2016,8,13,2,6321,8009,5666,-2343
2016,8,13,3,5848,7417,5362,-2055
2016,8,13,4,5352,6736,4850,-1886
2016,8,13,5,4845,5949,4315,-1634
2016,8,13,6,4511,5464,4006,-1458
2016,8,13,7,4282,5150,3681,-1469
2016,8,13,8,4120,4914,3541,-1373
2016,8,13,9,3984,4793,3443,-1350
2016,8,13,10,4023,4791,3458,-1333
2016,8,13,11,4163,4908,3555,-1353
2016,8,13,12,4321,5117,3748,-1369
2016,8,13,13,4865,5860,4280,-1580
2016,8,13,14,5495,6806,4937,-1869
2016,8,13,15,6251,7740,5541,-2199
2016,8,13,16,6842,8580,6146,-2434
2016,8,13,17,7362,9302,6858,-2444
2016,8,13,18,7664,9793,7304,-2489
2016,8,13,19,7763,10166,7619,-2547
2016,8,13,20,7872,10373,7796,-2577
2016,8,13,21,7804,10485,7890,-2595
2016,8,13,22,7689,10261,7688,-2573
2016,8,13,23,7349,9423,6887,-2536
2016,8,14,0,6963,8757,6198,-2559
2016,8,14,1,6665,8383,5854,-2529
2016,8,14,2,6287,8132,5804,-2328
2016,8,14,3,5836,7212,5170,-2042
2016,8,14,4,5346,6568,4662,-1906
2016,8,14,5,4835,5986,4354,-1632
2016,8,14,6,4456,5507,4014,-1493
2016,8,14,7,4198,5167,3764,-1403
2016,8,14,8,4014,4958,3595,-1363
2016,8,14,9,3875,4878,3538,-1340
2016,8,14,10,3856,4876,3519,-1357
2016,8,14,11,3922,5013,3623,-1390
2016,8,14,12,4032,5179,3796,-1383
2016,8,14,13,4542,5673,4153,-1520
2016,8,14,14,5277,6393,4580,-1813
2016,8,14,15,5956,7108,5080,-2028
2016,8,14,16,6499,7842,5637,-2205
2016,8,14,17,7035,8485,6220,-2265
2016,8,14,18,7330,8994,6612,-2382
2016,8,14,19,7579,9179,6657,-2522
2016,8,14,20,7721,8903,6350,-2553
2016,8,14,21,7881,8503,6153,-2350
2016,8,14,22,7481,8335,6073,-2262
2016,8,14,23,7248,8006,5796,-2210
2016,8,15,0,6849,7698,5490,-2208
2016,8,15,1,6694,7643,5421,-2222
2016,8,15,2,6284,7213,5129,-2084
2016,8,15,3,5800,6577,4811,-1766
2016,8,15,4,5285,5910,4278,-1632
2016,8,15,5,4758,5391,3916,-1475
2016,8,15,6,4431,5010,3667,-1343
2016,8,15,7,4237,4800,3494,-1306
2016,8,15,8,4121,4698,3395,-1303
2016,8,15,9,4065,4765,3456,-1309
2016,8,15,10,4261,5129,3736,-1393
2016,8,15,11,4649,5762,4245,-1517
2016,8,15,12,4922,6081,4603,-1478
2016,8,15,13,5328,6468,4887,-1581
2016,8,15,14,5833,7170,5391,-1779
2016,8,15,15,6531,8017,5827,-2190
2016,8,15,16,7134,8872,6582,-2290
2016,8,15,17,7696,9579,7138,-2441
2016,8,15,18,8097,10097,7588,-2509
2016,8,15,19,8353,10429,7918,-2511
2016,8,15,20,8438,10294,7790,-2504
2016,8,15,21,8476,10023,7561,-2462
2016,8,15,22,8162,9764,7319,-2445
2016,8,15,23,7986,9476,7019,-2457
2016,8,16,0,7534,9086,6547,-2539
2016,8,16,1,7255,8852,6306,-2546
2016,8,16,2,6828,8239,5833,-2406
2016,8,16,3,6215,7527,5442,-2085
2016,8,16,4,5629,6767,4885,-1882
2016,8,16,5,5057,6112,4457,-1655
2016,8,16,6,4671,5675,4135,-1540
2016,8,16,7,4414,5400,3916,-1484
2016,8,16,8,4261,5216,3787,-1429
2016,8,16,9,4141,5177,3736,-1441
2016,8,16,10,4314,5437,3938,-1499
2016,8,16,11,4729,5974,4388,-1586
2016,8,16,12,4930,6221,4693,-1528
2016,8,16,13,5301,6719,5075,-1644
2016,8,16,14,5792,7442,5549,-1893
2016,8,16,15,6414,8223,5995,-2228
2016,8,16,16,7085,9002,6617,-2385
2016,8,16,17,7676,9517,7039,-2478
2016,8,16,18,8125,9689,7195,-2494
2016,8,16,19,8411,9623,7194,-2429
2016,8,16,20,8535,9353,7067,-2286
2016,8,16,21,8496,8884,6681,-2203
2016,8,16,22,8229,8476,6249,-2227
2016,8,16,23,7899,8192,5968,-2224
2016,8,17,0,7503,7944,5721,-2223
2016,8,17,1,7259,7891,5618,-2273
2016,8,17,2,6795,7441,5308,-2133
2016,8,17,3,6143,6789,4894,-1895
2016,8,17,4,5525,6078,4313,-1765
2016,8,17,5,5137,5513,3936,-1577
2016,8,17,6,4759,5104,3670,-1434
2016,8,17,7,4486,4865,3496,-1369
2016,8,17,8,4337,4709,3367,-1342
2016,8,17,9,4304,4773,3418,-1355
2016,8,17,10,4460,5068,3658,-1410
2016,8,17,11,4769,5682,4134,-1548
2016,8,17,12,4951,5917,4425,-1492
2016,8,17,13,5300,6386,4778,-1608
2016,8,17,14,5870,7091,5243,-1848
2016,8,17,15,6573,7881,5651,-2230
2016,8,17,16,7182,8636,6236,-2400
2016,8,17,17,7589,9336,6812,-2524
2016,8,17,18,7951,9844,7233,-2611
2016,8,17,19,8186,10112,7510,-2602
2016,8,17,20,8244,10356,7718,-2638
2016,8,17,21,8137,10617,7926,-2691
2016,8,17,22,7883,10636,7927,-2709
2016,8,17,23,7577,10312,7666,-2646
2016,8,18,0,7181,9713,7145,-2568
2016,8,18,1,6992,9224,6699,-2525
2016,8,18,2,6527,8461,6089,-2372
2016,8,18,3,5926,7621,5519,-2102
2016,8,18,4,5335,6753,4801,-1952
2016,8,18,5,4690,6087,4423,-1664
2016,8,18,6,4382,5573,4039,-1534
2016,8,18,7,4184,5257,3794,-1463
2016,8,18,8,4078,5070,3661,-1409
2016,8,18,9,4056,5014,3619,-1395
2016,8,18,10,4264,5215,3768,-1447
2016,8,18,11,4628,5753,4207,-1546
2016,8,18,12,4845,5957,4437,-1520
2016,8,18,13,5167,6448,4833,-1615
2016,8,18,14,5726,7171,5302,-1869
2016,8,18,15,6417,7953,5679,-2274
2016,8,18,16,7114,8762,6343,-2419
2016,8,18,17,7617,9443,6859,-2584
2016,8,18,18,8067,9945,7383,-2562
2016,8,18,19,8314,10061,7541,-2520
2016,8,18,20,8362,10093,7519,-2574
2016,8,18,21,8214,10154,7588,-2566
2016,8,18,22,7919,9748,7254,-2494
2016,8,18,23,7683,9284,6880,-2404
2016,8,19,0,7264,8828,6460,-2368
2016,8,19,1,7082,8559,6200,-2359
2016,8,19,2,6619,7970,5702,-2268
2016,8,19,3,6035,7259,5291,-1968
2016,8,19,4,5444,6461,4577,-1884
2016,8,19,5,4994,5880,4249,-1631
2016,8,19,6,4571,5416,3934,-1482
2016,8,19,7,4315,5122,3709,-1413
2016,8,19,8,4094,4927,3527,-1400
2016,8,19,9,4069,4899,3512,-1387
2016,8,19,10,4199,5130,3686,-1444
2016,8,19,11,4584,5667,4101,-1566
2016,8,19,12,4823,5893,4367,-1526
2016,8,19,13,5276,6384,4774,-1610
2016,8,19,14,5937,7134,5247,-1887
2016,8,19,15,6652,7936,5636,-2300
2016,8,19,16,7239,8752,6362,-2390
2016,8,19,17,7824,9500,7042,-2458
2016,8,19,18,8143,10071,7591,-2480
2016,8,19,19,8428,10441,7980,-2461
2016,8,19,20,8524,10656,8152,-2504
2016,8,19,21,8479,10596,8136,-2460
2016,8,19,22,8263,10330,7905,-2425
2016,8,19,23,7956,9898,7542,-2356
2016,8,20,0,7400,9270,6916,-2354
2016,8,20,1,7144,8897,6564,-2333
2016,8,20,2,6643,8299,6129,-2170
2016,8,20,3,6115,7672,5751,-1921
2016,8,20,4,5594,6949,5088,-1861
2016,8,20,5,5127,6287,4612,-1675
2016,8,20,6,4742,5768,4331,-1437
2016,8,20,7,4454,5424,4048,-1376
2016,8,20,8,4281,5183,3863,-1320
2016,8,20,9,4180,5057,3752,-1305
2016,8,20,10,4177,5040,3730,-1310
2016,8,20,11,4266,5184,3845,-1339
2016,8,20,12,4417,5315,4004,-1311
2016,8,20,13,4912,6018,4417,-1601
2016,8,20,14,5650,6978,5098,-1880
2016,8,20,15,6356,7868,5783,-2085
2016,8,20,16,6928,8572,6299,-2273
2016,8,20,17,7422,9040,6653,-2387
2016,8,20,18,7671,9416,7011,-2405
2016,8,20,19,7826,9778,7351,-2427
2016,8,20,20,7946,10025,7534,-2491
2016,8,20,21,7861,10186,7663,-2523
2016,8,20,22,7742,10140,7599,-2541
2016,8,20,23,7473,9887,7341,-2546
2016,8,21,0,7110,9348,6858,-2490
2016,8,21,1,6675,8954,6532,-2422
2016,8,21,2,6264,8319,6147,-2172
2016,8,21,3,5809,7655,5667,-1988
2016,8,21,4,5315,6922,5077,-1845
2016,8,21,5,5030,6255,4573,-1682
2016,8,21,6,4629,5730,4260,-1470
2016,8,21,7,4383,5346,3973,-1373
2016,8,21,8,4173,5087,3760,-1327
2016,8,21,9,4064,4988,3686,-1302
2016,8,21,10,4027,4930,3643,-1287
2016,8,21,11,4016,5027,3721,-1306
2016,8,21,12,4165,5154,3878,-1276
2016,8,21,13,4708,5929,4342,-1587
2016,8,21,14,5432,6954,5094,-1860
2016,8,21,15,6055,7890,5786,-2104
2016,8,21,16,6778,8798,6441,-2357
2016,8,21,17,7305,9456,6964,-2492
2016,8,21,18,7710,9991,7439,-2552
2016,8,21,19,7960,10367,7787,-2580
2016,8,21,20,8125,10561,7979,-2582
2016,8,21,21,8154,10701,8102,-2599
2016,8,21,22,8062,10626,8070,-2556
2016,8,21,23,7841,10363,7865,-2498
2016,8,22,0,7402,9845,7411,-2434
2016,8,22,1,7115,9483,7018,-2465
2016,8,22,2,6687,8756,6525,-2231
2016,8,22,3,6067,7925,5901,-2024
2016,8,22,4,5484,7069,5193,-1876
2016,8,22,5,5019,6331,4637,-1694
2016,8,22,6,4624,5813,4341,-1472
2016,8,22,7,4374,5478,4089,-1389
2016,8,22,8,4199,5240,3898,-1342
2016,8,22,9,4154,5164,3851,-1313
2016,8,22,10,4331,5400,4050,-1350
2016,8,22,11,4806,5904,4459,-1445
2016,8,22,12,5017,6146,4719,-1427
2016,8,22,13,5378,6633,4998,-1635
2016,8,22,14,5953,7435,5567,-1868
2016,8,22,15,6647,8298,6151,-2147
2016,8,22,16,7301,9076,6678,-2398
2016,8,22,17,7685,9829,7319,-2510
2016,8,22,18,8127,10404,7813,-2591
2016,8,22,19,8415,10861,8231,-2630
2016,8,22,20,8586,11151,8489,-2662
2016,8,22,21,8580,11306,8571,-2735
2016,8,22,22,8328,11219,8531,-2688
2016,8,22,23,8062,10957,8335,-2622
2016,8,23,0,7684,10444,7880,-2564
2016,8,23,1,7387,10013,7518,-2495
2016,8,23,2,6880,9254,6971,-2283
2016,8,23,3,6210,8343,6272,-2071
2016,8,23,4,5612,7441,5520,-1921
2016,8,23,5,5245,6768,4994,-1774
2016,8,23,6,4887,6253,4639,-1614
2016,8,23,7,4546,5882,4342,-1540
2016,8,23,8,4391,5633,4131,-1502
2016,8,23,9,4313,5560,4064,-1496
2016,8,23,10,4465,5774,4233,-1541
2016,8,23,11,4874,6282,4649,-1633
2016,8,23,12,5067,6460,4839,-1621
2016,8,23,13,5399,6928,5234,-1694
2016,8,23,14,6022,7710,5764,-1946
2016,8,23,15,6676,8673,6479,-2194
2016,8,23,16,7332,9613,7157,-2456
2016,8,23,17,7742,10389,7785,-2604
2016,8,23,18,8201,10910,8167,-2743
2016,8,23,19,8517,11166,8401,-2765
2016,8,23,20,8650,11197,8465,-2732
2016,8,23,21,8581,10985,8354,-2631
2016,8,23,22,8345,10716,8176,-2540
2016,8,23,23,8112,10257,7794,-2463
2016,8,24,0,7655,9758,7380,-2378
2016,8,24,1,7417,9451,7174,-2277
2016,8,24,2,6889,8700,6676,-2024
2016,8,24,3,6236,7919,6146,-1773
2016,8,24,4,5603,7115,5520,-1595
2016,8,24,5,5231,6486,4994,-1492
2016,8,24,6,4808,6093,4590,-1503
2016,8,24,7,4475,5779,4274,-1505
2016,8,24,8,4295,5562,4076,-1486
2016,8,24,9,4230,5516,4042,-1474
2016,8,24,10,4399,5778,4247,-1531
2016,8,24,11,4791,6326,4740,-1586
2016,8,24,12,4972,6543,5117,-1426
2016,8,24,13,5332,6788,5382,-1406
2016,8,24,14,5899,7325,5713,-1612
2016,8,24,15,6574,7999,6154,-1845
2016,8,24,16,7167,8545,6538,-2007
2016,8,24,17,7756,8986,6801,-2185
2016,8,24,18,8035,9342,7108,-2234
2016,8,24,19,8233,9472,7256,-2216
2016,8,24,20,8256,9718,7471,-2247
2016,8,24,21,8138,9964,7662,-2302
2016,8,24,22,7911,10019,7615,-2404
2016,8,24,23,7704,9754,7426,-2328
2016,8,25,0,7239,9291,6990,-2301
2016,8,25,1,7109,9035,6811,-2224
2016,8,25,2,6588,8368,6475,-1893
2016,8,25,3,6027,7619,5973,-1646
2016,8,25,4,5458,6867,5263,-1604
2016,8,25,5,4878,6229,4657,-1572
2016,8,25,6,4510,5784,4259,-1525
2016,8,25,7,4259,5489,4014,-1475
2016,8,25,8,4120,5301,3867,-1434
2016,8,25,9,4106,5237,3816,-1421
2016,8,25,10,4325,5446,3968,-1477
2016,8,25,11,4810,5955,4389,-1565
2016,8,25,12,4994,6104,4686,-1418
2016,8,25,13,5231,6493,5017,-1476
2016,8,25,14,5781,7215,5607,-1608
2016,8,25,15,6391,7979,6246,-1733
2016,8,25,16,7082,8709,6691,-2018
2016,8,25,17,7576,9318,7108,-2210
2016,8,25,18,7940,9848,7459,-2389
2016,8,25,19,8142,10220,7862,-2358
2016,8,25,20,8211,10450,8049,-2401
2016,8,25,21,8064,10573,8123,-2450
2016,8,25,22,7843,10512,8055,-2457
2016,8,25,23,7568,10138,7705,-2433
2016,8,26,0,7112,9528,7196,-2332
2016,8,26,1,6935,9235,6966,-2269
2016,8,26,2,6424,8468,6543,-1925
2016,8,26,3,5835,7609,5930,-1679
2016,8,26,4,5264,6789,5188,-1601
2016,8,26,5,4851,6329,4827,-1502
2016,8,26,6,4456,5870,4433,-1437
2016,8,26,7,4175,5567,4134,-1433
2016,8,26,8,4013,5368,3942,-1426
2016,8,26,9,3990,5347,3930,-1417
2016,8,26,10,4193,5564,4098,-1466
2016,8,26,11,4652,6099,4533,-1566
2016,8,26,12,4832,6315,4768,-1547
2016,8,26,13,5052,6737,5115,-1622
2016,8,26,14,5605,7454,5627,-1827
2016,8,26,15,6162,8260,6121,-2139
2016,8,26,16,6732,8998,6683,-2315
2016,8,26,17,7263,9576,7377,-2199
2016,8,26,18,7596,10090,7895,-2195
2016,8,26,19,7774,10379,8143,-2236
2016,8,26,20,7846,10489,8169,-2320
2016,8,26,21,7727,10445,8112,-2333
2016,8,26,22,7492,10029,7738,-2290
2016,8,26,23,7142,9408,7136,-2272
2016,8,27,0,6646,8867,6629,-2238
2016,8,27,1,6503,8573,6393,-2180
2016,8,27,2,6046,8023,5812,-2211
2016,8,27,3,5536,7486,5374,-2111
2016,8,27,4,5036,6870,4834,-2036
2016,8,27,5,4912,6095,4392,-1703
2016,8,27,6,4568,5637,4079,-1558
2016,8,27,7,4322,5323,3837,-1485
2016,8,27,8,4142,5103,3673,-1429
2016,8,27,9,4069,5010,3597,-1412
2016,8,27,10,4058,5025,3606,-1419
2016,8,27,11,4183,5163,3723,-1440
2016,8,27,12,4317,5308,3976,-1332
2016,8,27,13,4852,5917,4409,-1508
2016,8,27,14,5419,6793,5005,-1788
2016,8,27,15,6037,7604,5562,-2042
2016,8,27,16,6533,8352,6037,-2315
2016,8,27,17,7018,9121,6678,-2443
2016,8,27,18,7252,9684,7196,-2488
2016,8,27,19,7360,10056,7482,-2574
2016,8,27,20,7481,10239,7613,-2626
2016,8,27,21,7482,10064,7473,-2591
2016,8,27,22,7246,9437,6908,-2529
2016,8,27,23,6948,8918,6394,-2523
2016,8,28,0,6580,8370,5925,-2444
2016,8,28,1,6434,8097,5736,-2361
2016,8,28,2,6029,7534,5476,-2057
2016,8,28,3,5571,7038,5184,-1854
2016,8,28,4,5150,6453,4696,-1757
2016,8,28,5,4718,6095,4414,-1680
2016,8,28,6,4386,5737,4199,-1537
2016,8,28,7,4158,5466,3967,-1498
2016,8,28,8,3995,5320,3886,-1433
2016,8,28,9,3904,5227,3822,-1404
2016,8,28,10,3896,5268,3817,-1451
2016,8,28,11,4005,5379,3897,-1482
2016,8,28,12,4140,5565,4094,-1471
2016,8,28,13,4655,6281,4586,-1695
2016,8,28,14,5281,7253,5262,-1991
2016,8,28,15,5906,8075,5852,-2223
2016,8,28,16,6471,8833,6358,-2475
2016,8,28,17,7005,9485,7070,-2415
2016,8,28,18,7288,9956,7437,-2519
2016,8,28,19,7502,10286,7700,-2586
2016,8,28,20,7500,10433,7863,-2570
2016,8,28,21,7477,10352,7833,-2519
2016,8,28,22,7338,10029,7531,-2498
2016,8,28,23,7058,9555,7079,-2476
2016,8,29,0,6690,9076,6688,-2388
2016,8,29,1,6644,8850,6408,-2441
2016,8,29,2,6158,8167,5970,-2197
2016,8,29,3,5621,7467,5495,-1971
2016,8,29,4,5102,6726,4946,-1779
2016,8,29,5,4612,5937,4289,-1647
2016,8,29,6,4298,5547,4002,-1544
2016,8,29,7,4087,5289,3797,-1492
2016,8,29,8,3953,5118,3679,-1438
2016,8,29,9,3951,5134,3664,-1470
2016,8,29,10,4177,5388,3861,-1527
2016,8,29,11,4689,5943,4312,-1631
2016,8,29,12,4906,6181,4615,-1566
2016,8,29,13,5166,6606,4965,-1641
2016,8,29,14,5619,7334,5406,-1928
2016,8,29,15,6204,8040,5869,-2171
2016,8,29,16,6720,8667,6293,-2374
2016,8,29,17,7065,9214,6846,-2368
2016,8,29,18,7337,9512,7115,-2397
2016,8,29,19,7561,9497,7087,-2410
2016,8,29,20,7588,9452,7072,-2380
2016,8,29,21,7451,9005,6746,-2259
2016,8,29,22,7314,8722,6396,-2326
2016,8,29,23,7011,8381,6118,-2263
2016,8,30,0,6675,8032,5749,-2283
2016,8,30,1,6592,7928,5561,-2367
2016,8,30,2,6093,7388,5219,-2169
2016,8,30,3,5529,6686,4801,-1885
2016,8,30,4,4988,6005,4290,-1715
2016,8,30,5,4610,5497,3969,-1528
2016,8,30,6,4298,5170,3760,-1410
2016,8,30,7,4112,4913,3559,-1354
2016,8,30,8,3972,4763,3441,-1322
2016,8,30,9,3965,4768,3443,-1325
2016,8,30,10,4167,5059,3665,-1394
2016,8,30,11,4575,5641,4139,-1502
2016,8,30,12,4785,5879,4352,-1527
2016,8,30,13,5019,6155,4535,-1620
2016,8,30,14,5452,6733,4939,-1794
2016,8,30,15,6052,7396,5256,-2140
2016,8,30,16,6544,8072,5733,-2339
2016,8,30,17,6917,8619,6229,-2390
2016,8,30,18,7231,9059,6622,-2437
2016,8,30,19,7445,9101,6636,-2465
2016,8,30,20,7509,9137,6576,-2561
2016,8,30,21,7406,8965,6473,-2492
2016,8,30,22,7296,8810,6348,-2462
2016,8,30,23,6972,8437,6045,-2392
2016,8,31,0,6733,8081,5644,-2437
2016,8,31,1,6639,7889,5517,-2372
2016,8,31,2,6191,7328,5170,-2158
2016,8,31,3,5574,6685,4689,-1996
2016,8,31,4,4990,6027,4183,-1844
2016,8,31,5,4448,5523,3934,-1589
2016,8,31,6,4160,5182,3826,-1356
2016,8,31,7,4041,4992,3683,-1309
2016,8,31,8,3926,4882,3612,-1270
2016,8,31,9,3962,4891,3601,-1290
2016,8,31,10,4189,5195,3839,-1356
2016,8,31,11,4577,5753,4301,-1452
2016,8,31,12,4776,6018,4607,-1411
2016,8,31,13,4966,6147,4562,-1585
2016,8,31,14,5320,6354,4557,-1797
2016,8,31,15,5807,6542,4582,-1960
2016,8,31,16,6115,6684,4731,-1953
2016,8,31,17,6440,6938,4929,-2009
2016,8,31,18,6661,7108,5059,-2049
2016,8,31,19,6657,7199,5123,-2076
2016,8,31,20,6668,7233,5157,-2076
2016,8,31,21,6648,7237,5202,-2035
2016,8,31,22,6577,7114,5071,-2043
2016,8,31,23,6468,9453,7391,-2062
2016,9,1,0,6276,6932,4822,-2110
2016,9,1,1,6198,6903,4853,-2050
2016,9,1,2,5763,6456,4575,-1881
2016,9,1,3,5265,5980,4174,-1806
2016,9,1,4,4812,5461,3748,-1713
2016,9,1,5,4201,4998,3533,-1465
2016,9,1,6,3968,4700,3425,-1275
2016,9,1,7,3817,4496,3283,-1213
2016,9,1,8,3783,4392,3193,-1199
2016,9,1,9,3818,4426,3225,-1201
2016,9,1,10,3984,4704,3448,-1256
2016,9,1,11,4462,5230,3867,-1363
2016,9,1,12,4717,5498,4192,-1306
2016,9,1,13,4894,5721,4196,-1525
2016,9,1,14,5024,6094,4327,-1767
2016,9,1,15,5343,6570,4576,-1994
2016,9,1,16,5711,6990,4911,-2079
2016,9,1,17,5858,7255,5161,-2094
2016,9,1,18,6053,7348,5239,-2109
2016,9,1,19,6105,7308,5230,-2078
2016,9,1,20,6084,7224,5165,-2059
2016,9,1,21,6039,7231,5148,-2083
2016,9,1,22,5953,7278,5186,-2092
2016,9,1,23,5868,7167,5047,-2120
2016,9,2,0,5765,7122,4977,-2145
2016,9,2,1,5785,7091,5002,-2089
2016,9,2,2,5468,6741,4867,-1874
2016,9,2,3,5046,6312,4555,-1757
2016,9,2,4,4556,5844,4119,-1724
2016,9,2,5,4009,5497,3983,-1502
2016,9,2,6,3754,5202,3905,-1275
2016,9,2,7,3571,4994,3792,-1176
2016,9,2,8,3503,4846,3623,-1209
2016,9,2,9,3535,4785,3461,-1311
2016,9,2,10,3766,4917,3787,-1115
2016,9,2,11,4246,5217,4004,-1197
2016,9,2,12,4529,5478,4281,-1181
2016,9,2,13,4759,5739,4294,-1426
2016,9,2,14,5001,5997,4274,-1700
2016,9,2,15,5314,6290,4367,-1899
2016,9,2,16,5557,6474,4446,-2006
2016,9,2,17,5763,6759,4725,-2020
2016,9,2,18,5976,7079,5044,-2022
2016,9,2,19,6024,7445,5293,-2156
2016,9,2,20,6042,7653,5499,-2160
2016,9,2,21,6006,7716,5581,-2140
2016,9,2,22,5802,7625,5503,-2129
2016,9,2,23,5690,7287,5196,-2098
2016,9,3,0,5387,7010,4982,-2034
2016,9,3,1,5340,6986,5047,-1945
2016,9,3,2,4975,6584,4961,-1629
2016,9,3,3,4648,6153,4632,-1526
2016,9,3,4,4271,5647,4152,-1498
2016,9,3,5,4369,5159,3937,-1227
2016,9,3,6,4102,4789,3764,-1030
2016,9,3,7,3941,4565,3565,-1005
2016,9,3,8,3822,4420,3446,-980
2016,9,3,9,3790,4382,3417,-970
2016,9,3,10,3774,4418,3413,-1010
2016,9,3,11,3952,4586,3545,-1046
2016,9,3,12,4091,4787,3793,-997
2016,9,3,13,4542,5298,4081,-1219
2016,9,3,14,5005,6002,4531,-1472
2016,9,3,15,5378,6566,4867,-1699
2016,9,3,16,5648,6957,5200,-1757
2016,9,3,17,6120,7063,5374,-1689
2016,9,3,18,6329,7082,5352,-1732
2016,9,3,19,6354,7429,5598,-1833
2016,9,3,20,6382,7849,5843,-2005
2016,9,3,21,6303,8180,5980,-2201
2016,9,3,22,6282,8351,6151,-2200
2016,9,3,23,6014,8167,6020,-2147
2016,9,4,0,5750,7727,5707,-2018
2016,9,4,1,5668,7551,5658,-1898
2016,9,4,2,5268,7013,5267,-1748
2016,9,4,3,4926,6515,4882,-1636
2016,9,4,4,4575,5941,4399,-1549
2016,9,4,5,4271,5419,4122,-1304
2016,9,4,6,3993,4997,3888,-1116
2016,9,4,7,3781,4707,3673,-1042
2016,9,4,8,3667,4499,3497,-1006
2016,9,4,9,3561,4424,3437,-992
2016,9,4,10,3566,4392,3409,-989
2016,9,4,11,3718,4514,3483,-1037
2016,9,4,12,3810,4724,3722,-1006
2016,9,4,13,4374,5226,3986,-1242
2016,9,4,14,4935,5937,4380,-1557
2016,9,4,15,5482,6777,4860,-1917
2016,9,4,16,5802,7608,5472,-2132
2016,9,4,17,6253,8345,6174,-2165
2016,9,4,18,6514,8864,6604,-2254
2016,9,4,19,6604,9249,6878,-2371
2016,9,4,20,6674,9395,7025,-2370
2016,9,4,21,6627,9176,6922,-2254
2016,9,4,22,6577,8701,6532,-2169
2016,9,4,23,6295,8175,6070,-2105
2016,9,5,0,6097,7657,5643,-2014
2016,9,5,1,5996,7349,5385,-1964
2016,9,5,2,5548,6871,5123,-1748
2016,9,5,3,5118,6335,4727,-1608
2016,9,5,4,4735,5816,4292,-1524
2016,9,5,5,4484,5320,4027,-1293
2016,9,5,6,4167,4905,3809,-1096
2016,9,5,7,3967,4626,3586,-1040
2016,9,5,8,3823,4461,3434,-1027
2016,9,5,9,3726,4403,3378,-1025
2016,9,5,10,3797,4455,3396,-1059
2016,9,5,11,3954,4645,3549,-1096
2016,9,5,12,4031,4788,3718,-1070
2016,9,5,13,4506,5269,3858,-1411
2016,9,5,14,5126,6018,4238,-1780
2016,9,5,15,5803,6847,4710,-2137
2016,9,5,16,6403,7570,5328,-2242
2016,9,5,17,6793,8154,5848,-2306
2016,9,5,18,7020,8467,6117,-2350
2016,9,5,19,7225,8664,6289,-2375
2016,9,5,20,7207,8631,6283,-2348
2016,9,5,21,7191,8484,6183,-2301
2016,9,5,22,6979,8139,5798,-2341
2016,9,5,23,6852,7795,5533,-2262
2016,9,6,0,6504,7509,5208,-2301
2016,9,6,1,6311,7367,5128,-2239
2016,9,6,2,5817,6809,4801,-2008
2016,9,6,3,5268,6197,4370,-1827
2016,9,6,4,4771,5502,3797,-1705
2016,9,6,5,4227,5082,3681,-1401
2016,9,6,6,3934,4680,3516,-1164
2016,9,6,7,3760,4420,3318,-1102
2016,9,6,8,3662,4280,3218,-1062
2016,9,6,9,3636,4249,3185,-1064
2016,9,6,10,3852,4502,3394,-1108
2016,9,6,11,4315,5061,3804,-1257
2016,9,6,12,4536,5303,4118,-1185
2016,9,6,13,4755,5617,4235,-1382
2016,9,6,14,5282,6166,4456,-1710
2016,9,6,15,5786,6846,4866,-1980
2016,9,6,16,6381,7477,5345,-2132
2016,9,6,17,6829,8126,5874,-2252
2016,9,6,18,7219,8710,6431,-2279
2016,9,6,19,7471,9144,6873,-2271
2016,9,6,20,7655,9458,7178,-2280
2016,9,6,21,7689,9640,7279,-2361
2016,9,6,22,7496,9345,7016,-2329
2016,9,6,23,7358,8999,6754,-2245
2016,9,7,0,6904,8499,6265,-2234
2016,9,7,1,6574,8223,5946,-2277
2016,9,7,2,6031,7469,5380,-2089
2016,9,7,3,5447,6703,4783,-1920
2016,9,7,4,4818,5919,4163,-1756
2016,9,7,5,4379,5500,4150,-1350
2016,9,7,6,4062,5059,3912,-1147
2016,9,7,7,3842,4779,3700,-1079
2016,9,7,8,3728,4573,3538,-1035
2016,9,7,9,3696,4537,3506,-1031
2016,9,7,10,3874,4764,3618,-1146
2016,9,7,11,4328,5299,4001,-1298
2016,9,7,12,4571,5471,4008,-1463
2016,9,7,13,4784,5751,4035,-1716
2016,9,7,14,5243,6355,4389,-1966
2016,9,7,15,5843,7075,4863,-2212
2016,9,7,16,6536,7716,5236,-2480
2016,9,7,17,7052,8380,5738,-2642
2016,9,7,18,7507,8994,6258,-2736
2016,9,7,19,7869,9471,6737,-2734
2016,9,7,20,8110,9790,7038,-2752
2016,9,7,21,8153,9947,7026,-2921
2016,9,7,22,7968,9885,6971,-2914
2016,9,7,23,7794,9244,6411,-2833
2016,9,8,0,7434,8674,5806,-2868
2016,9,8,1,7239,8281,5430,-2851
2016,9,8,2,6652,7500,4928,-2572
2016,9,8,3,5990,6682,4438,-2244
2016,9,8,4,5371,5851,4069,-1782
2016,9,8,5,4631,5240,3787,-1453
2016,9,8,6,4263,4807,3606,-1201
2016,9,8,7,4014,4480,3376,-1104
2016,9,8,8,3888,4303,3224,-1079
2016,9,8,9,3872,4281,3217,-1064
2016,9,8,10,4041,4530,3384,-1146
2016,9,8,11,4442,5060,3735,-1325
2016,9,8,12,4653,5266,3918,-1348
2016,9,8,13,4874,5559,4049,-1510
2016,9,8,14,5345,6152,4384,-1768
2016,9,8,15,5966,6880,4883,-1997
2016,9,8,16,6603,7593,5203,-2390
2016,9,8,17,6970,8266,5664,-2602
2016,9,8,18,7409,8899,6241,-2658
2016,9,8,19,7692,9416,6649,-2767
2016,9,8,20,7849,9760,6942,-2818
2016,9,8,21,7861,9963,7081,-2882
2016,9,8,22,7736,9892,6994,-2898
2016,9,8,23,7424,9511,6614,-2897
2016,9,9,0,7072,8959,6160,-2799
2016,9,9,1,6823,8662,5904,-2758
2016,9,9,2,6252,7881,5314,-2567
2016,9,9,3,5750,7150,4881,-2269
2016,9,9,4,5208,6289,4317,-1972
2016,9,9,5,4619,5603,4057,-1546
2016,9,9,6,4277,5109,3856,-1253
2016,9,9,7,4056,4791,3618,-1173
2016,9,9,8,3902,4601,3482,-1119
2016,9,9,9,3873,4571,3452,-1119
2016,9,9,10,4053,4782,3597,-1185
2016,9,9,11,4467,5315,3979,-1336
2016,9,9,12,4693,5555,4295,-1260
2016,9,9,13,4954,5909,4390,-1519
2016,9,9,14,5456,6622,4748,-1874
2016,9,9,15,6033,7438,5342,-2096
2016,9,9,16,6534,8160,5844,-2316
2016,9,9,17,6924,8815,6419,-2396
2016,9,9,18,7301,9404,7043,-2361
2016,9,9,19,7511,9770,7326,-2444
2016,9,9,20,7632,10044,7547,-2497
2016,9,9,21,7566,10181,7667,-2514
2016,9,9,22,7379,10050,7551,-2499
2016,9,9,23,7072,9531,7061,-2470
2016,9,10,0,6696,9045,6577,-2468
2016,9,10,1,6458,8731,6302,-2429
2016,9,10,2,5974,8097,5958,-2139
2016,9,10,3,5546,7487,5517,-1970
2016,9,10,4,5093,6847,5041,-1806
2016,9,10,5,4703,6210,4629,-1581
2016,9,10,6,4338,5735,4340,-1395
2016,9,10,7,4089,5364,4035,-1329
2016,9,10,8,3924,5109,3830,-1279
2016,9,10,9,3856,4953,3699,-1254
2016,9,10,10,3862,4936,3681,-1255
2016,9,10,11,3931,5042,3759,-1283
2016,9,10,12,4094,5159,3897,-1262
2016,9,10,13,4536,5788,4176,-1612
2016,9,10,14,5198,6689,4731,-1958
2016,9,10,15,5780,7608,5317,-2291
2016,9,10,16,6283,8467,6030,-2437
2016,9,10,17,6753,9222,6683,-2539
2016,9,10,18,7062,9792,7188,-2604
2016,9,10,19,7288,10123,7581,-2542
2016,9,10,20,7421,10246,7658,-2588
2016,9,10,21,7357,10069,7465,-2604
2016,9,10,22,7253,9880,7340,-2540
2016,9,10,23,7008,0,7340,-2420
2016,9,11,0,6690,8829,6394,-2435
2016,9,11,1,6446,8458,6072,-2386
2016,9,11,2,5955,7828,5653,-2175
2016,9,11,3,5516,7114,5007,-2107
2016,9,11,4,5072,6450,4505,-1945
2016,9,11,5,4660,6070,4427,-1643
2016,9,11,6,4318,5568,4161,-1407
2016,9,11,7,4055,5195,3872,-1323
2016,9,11,8,3868,4950,3674,-1276
2016,9,11,9,3784,4794,3548,-1246
2016,9,11,10,3756,4734,3494,-1240
2016,9,11,11,3810,4845,3577,-1268
2016,9,11,12,3947,4973,3736,-1237
2016,9,11,13,4405,5650,4061,-1589
2016,9,11,14,5050,6573,4666,-1907
2016,9,11,15,5786,7486,5221,-2265
2016,9,11,16,6342,8372,5959,-2413
2016,9,11,17,6930,9183,6686,-2497
2016,9,11,18,7336,9702,7108,-2594
2016,9,11,19,7631,10082,7421,-2661
2016,9,11,20,7744,10192,7507,-2685
2016,9,11,21,7775,10260,7562,-2698
2016,9,11,22,7662,10149,7505,-2644
2016,9,11,23,7397,9823,7163,-2660
2016,9,12,0,7115,9305,6807,-2498
2016,9,12,1,6839,9010,6522,-2488
2016,9,12,2,6261,8172,5923,-2249
2016,9,12,3,5718,7398,5281,-2117
2016,9,12,4,5154,6586,4642,-1944
2016,9,12,5,4680,6001,4408,-1593
2016,9,12,6,4329,5471,4095,-1376
2016,9,12,7,4076,5156,3838,-1318
2016,9,12,8,3929,4941,3667,-1274
2016,9,12,9,3916,4948,3671,-1277
2016,9,12,10,4122,5194,3876,-1318
2016,9,12,11,4570,5767,4331,-1436
2016,9,12,12,4813,5998,4575,-1423
2016,9,12,13,5026,6298,4661,-1637
2016,9,12,14,5449,6891,4998,-1893
2016,9,12,15,6025,7711,5625,-2086
2016,9,12,16,6523,8424,6242,-2182
2016,9,12,17,6973,9063,6709,-2354
2016,9,12,18,7321,9506,7108,-2398
2016,9,12,19,7497,9762,7361,-2401
2016,9,12,20,7532,9584,7237,-2347
2016,9,12,21,7424,9235,7003,-2232
2016,9,12,22,7268,8914,6697,-2217
2016,9,12,23,6985,8541,6327,-2214
2016,9,13,0,6809,8243,5965,-2278
2016,9,13,1,6602,8096,5890,-2206
2016,9,13,2,6034,7416,5341,-2075
2016,9,13,3,5463,6771,4805,-1966
2016,9,13,4,4914,6110,4339,-1771
2016,9,13,5,4421,5555,4154,-1401
2016,9,13,6,4118,5185,3960,-1225
2016,9,13,7,3939,4911,3732,-1179
2016,9,13,8,3834,4762,3596,-1166
2016,9,13,9,3854,4771,3604,-1167
2016,9,13,10,4077,5073,3835,-1238
2016,9,13,11,4552,5641,4280,-1361
2016,9,13,12,4800,5898,4482,-1416
2016,9,13,13,4929,6085,4491,-1594
2016,9,13,14,5303,6560,4709,-1851
2016,9,13,15,5759,7069,4972,-2097
2016,9,13,16,6214,7573,5340,-2233
2016,9,13,17,6484,7991,5765,-2226
2016,9,13,18,6767,8389,6126,-2263
2016,9,13,19,6867,8564,6294,-2270
2016,9,13,20,6853,8656,6400,-2256
2016,9,13,21,6745,8807,6512,-2295
2016,9,13,22,6659,8705,6451,-2254
2016,9,13,23,6456,8382,6105,-2277
2016,9,14,0,6254,8160,5910,-2250
2016,9,14,1,6108,7992,5735,-2257
2016,9,14,2,5636,7323,5235,-2088
2016,9,14,3,5114,6723,4773,-1950
2016,9,14,4,4611,0,4773,-1749
2016,9,14,5,4292,5482,3998,-1484
2016,9,14,6,4032,5101,3782,-1319
2016,9,14,7,3896,4885,3614,-1271
2016,9,14,8,3803,4761,3510,-1251
2016,9,14,9,3828,4776,3531,-1245
2016,9,14,10,4039,5049,3725,-1324
2016,9,14,11,4484,5648,4203,-1445
2016,9,14,12,4685,5884,4450,-1434
2016,9,14,13,4924,6129,4528,-1601
2016,9,14,14,5171,6729,4824,-1905
2016,9,14,15,5617,7410,5277,-2133
2016,9,14,16,6038,8015,5743,-2272
2016,9,14,17,6302,8542,6272,-2270
2016,9,14,18,6554,9013,6811,-2202
2016,9,14,19,6649,9312,7070,-2242
2016,9,14,20,6614,9424,7183,-2241
2016,9,14,21,6529,9375,7093,-2282
2016,9,14,22,6417,9187,6872,-2315
2016,9,14,23,6216,8877,6583,-2294
2016,9,15,0,6080,8572,6306,-2266
2016,9,15,1,5983,8340,6071,-2269
2016,9,15,2,5561,7660,5529,-2131
2016,9,15,3,5115,6954,4996,-1958
2016,9,15,4,4668,6200,4389,-1811
2016,9,15,5,4319,5626,4136,-1490
2016,9,15,6,4026,5217,4000,-1217
2016,9,15,7,3876,4932,3817,-1115
2016,9,15,8,3769,4795,3704,-1091
2016,9,15,9,3792,4793,3706,-1087
2016,9,15,10,4015,5055,3914,-1141
2016,9,15,11,4448,5640,4288,-1352
2016,9,15,12,4674,5892,4434,-1458
2016,9,15,13,4845,6192,4546,-1646
2016,9,15,14,5195,6800,4906,-1894
2016,9,15,15,5693,7468,5339,-2129
2016,9,15,16,6110,8135,5840,-2295
2016,9,15,17,6447,8728,6445,-2283
2016,9,15,18,6750,9159,6885,-2274
2016,9,15,19,6890,9434,7120,-2314
2016,9,15,20,7029,9583,7256,-2327
2016,9,15,21,6892,9501,7134,-2367
2016,9,15,22,6821,9262,6879,-2383
2016,9,15,23,6514,8918,6501,-2417
2016,9,16,0,6299,8572,6198,-2374
2016,9,16,1,6178,8407,6057,-2350
2016,9,16,2,5744,7720,5590,-2130
2016,9,16,3,5240,6998,5022,-1976
2016,9,16,4,4789,6262,4440,-1822
2016,9,16,5,4530,5665,4164,-1501
2016,9,16,6,4189,5269,4016,-1253
2016,9,16,7,3979,4962,3802,-1160
2016,9,16,8,3850,4774,3612,-1162
2016,9,16,9,3833,4762,3627,-1135
2016,9,16,10,4014,5009,3827,-1182
2016,9,16,11,4449,5573,4236,-1337
2016,9,16,12,4675,5795,4413,-1382
2016,9,16,13,4904,6148,4546,-1602
2016,9,16,14,5389,6828,4991,-1837
2016,9,16,15,5935,7560,5641,-1919
2016,9,16,16,6412,8232,6188,-2044
2016,9,16,17,6855,8949,6948,-2001
2016,9,16,18,7217,9493,7437,-2056
2016,9,16,19,7357,9803,7662,-2141
2016,9,16,20,7454,9979,7932,-2047
2016,9,16,21,7327,9810,7813,-1997
2016,9,16,22,7163,9373,7247,-2126
2016,9,16,23,6820,8871,6891,-1980
2016,9,17,0,6530,8417,6548,-1869
2016,9,17,1,6304,8139,6304,-1835
2016,9,17,2,5857,7563,5823,-1740
2016,9,17,3,5413,6960,5263,-1697
2016,9,17,4,4967,6349,4645,-1704
2016,9,17,5,4806,5766,4625,-1141
2016,9,17,6,4442,5343,4359,-984
2016,9,17,7,4199,5025,4032,-993
2016,9,17,8,4016,4830,3875,-955
2016,9,17,9,3932,4703,3770,-933
2016,9,17,10,3959,4746,3792,-954
2016,9,17,11,4087,4918,3923,-995
2016,9,17,12,4259,5102,4120,-982
2016,9,17,13,4703,5683,4514,-1169
2016,9,17,14,5288,6547,5118,-1429
2016,9,17,15,5981,7394,5768,-1626
2016,9,17,16,6630,8196,6464,-1732
2016,9,17,17,7111,8875,7172,-1703
2016,9,17,18,7475,9389,7708,-1681
2016,9,17,19,7662,9716,7909,-1807
2016,9,17,20,7698,9830,7955,-1875
2016,9,17,21,7579,9765,7879,-1886
2016,9,17,22,7343,9453,7728,-1725
2016,9,17,23,7029,8947,7328,-1619
2016,9,18,0,6846,8498,6874,-1624
2016,9,18,1,6557,8193,6513,-1680
2016,9,18,2,6048,7599,5935,-1664
2016,9,18,3,5596,0,5935,-1649
2016,9,18,4,5152,6397,4955,-1442
2016,9,18,5,4704,5858,4672,-1186
2016,9,18,6,4331,5407,4457,-950
2016,9,18,7,4068,5099,4155,-944
2016,9,18,8,3877,4917,3997,-920
2016,9,18,9,3769,4782,3911,-871
2016,9,18,10,3747,4803,3913,-890
2016,9,18,11,3804,4879,3959,-920
2016,9,18,12,3958,5009,4183,-826
2016,9,18,13,4475,5629,4569,-1060
2016,9,18,14,5133,6505,5130,-1375
2016,9,18,15,5798,7322,5717,-1605
2016,9,18,16,6397,8122,6395,-1727
2016,9,18,17,6925,8881,7158,-1723
2016,9,18,18,7351,9408,7710,-1698
2016,9,18,19,7635,9731,7929,-1802
2016,9,18,20,7696,9848,7994,-1854
2016,9,18,21,7626,9897,8061,-1836
2016,9,18,22,7413,9802,7983,-1819
2016,9,18,23,7099,9453,7731,-1722
2016,9,19,0,6857,9049,7311,-1738
2016,9,19,1,6648,8744,6934,-1810
2016,9,19,2,6078,7966,6321,-1645
2016,9,19,3,5545,7219,5655,-1564
2016,9,19,4,5026,6448,5010,-1438
2016,9,19,5,4623,5796,4572,-1224
2016,9,19,6,4281,5359,4362,-997
2016,9,19,7,4048,5068,4130,-938
2016,9,19,8,3917,4886,3993,-893
2016,9,19,9,3906,4859,3962,-897
2016,9,19,10,4116,5135,4217,-918
2016,9,19,11,4583,5697,4716,-981
2016,9,19,12,4824,5929,4997,-932
2016,9,19,13,4962,6261,5129,-1132
2016,9,19,14,5450,6941,5537,-1404
2016,9,19,15,5959,7741,6188,-1553
2016,9,19,16,6431,8512,6721,-1791
2016,9,19,17,6876,9235,7446,-1789
2016,9,19,18,7231,9832,7945,-1887
2016,9,19,19,7429,10182,8251,-1931
2016,9,19,20,7381,10379,8518,-1861
2016,9,19,21,7246,10337,8534,-1803
2016,9,19,22,7140,9960,8212,-1748
2016,9,19,23,6933,9356,7649,-1707
2016,9,20,0,6755,8936,7175,-1761
2016,9,20,1,6525,8520,6722,-1798
2016,9,20,2,6008,7767,6148,-1619
2016,9,20,3,5437,6982,5473,-1509
2016,9,20,4,4902,6227,4883,-1344
2016,9,20,5,4462,5622,4548,-1074
2016,9,20,6,4155,5168,4333,-835
2016,9,20,7,3972,4881,4114,-767
2016,9,20,8,3858,4695,3957,-738
2016,9,20,9,3881,4677,3945,-732
2016,9,20,10,4119,4918,4133,-785
2016,9,20,11,4570,5487,4574,-913
2016,9,20,12,4809,5708,4826,-882
2016,9,20,13,4972,6007,4952,-1055
2016,9,20,14,5443,6562,5262,-1300
2016,9,20,15,5964,7141,5730,-1411
2016,9,20,16,6505,7749,6269,-1480
2016,9,20,17,6891,8372,6967,-1405
2016,9,20,18,7259,8945,7383,-1562
2016,9,20,19,7447,9255,7607,-1648
2016,9,20,20,7555,9429,7794,-1635
2016,9,20,21,7309,9519,7877,-1642
2016,9,20,22,7166,9548,7877,-1671
2016,9,20,23,6918,9155,7554,-1601
2016,9,21,0,6755,8740,7146,-1594
2016,9,21,1,6574,8420,6836,-1584
2016,9,21,2,5967,7635,6115,-1520
2016,9,21,3,5332,6914,5490,-1424
2016,9,21,4,4762,6154,4897,-1257
2016,9,21,5,4425,5569,4492,-1077
2016,9,21,6,4118,5170,4298,-872
2016,9,21,7,3908,4912,4101,-811
2016,9,21,8,3801,4746,3962,-784
2016,9,21,9,3780,4755,3970,-785
2016,9,21,10,3984,5015,4173,-842
2016,9,21,11,4430,5596,4643,-953
2016,9,21,12,4688,5847,4948,-899
2016,9,21,13,4845,6037,4974,-1063
2016,9,21,14,5251,6603,5282,-1321
2016,9,21,15,5755,7312,5687,-1625
2016,9,21,16,6281,7999,6220,-1779
2016,9,21,17,6677,8688,6905,-1783
2016,9,21,18,6989,9182,7484,-1698
2016,9,21,19,7322,9581,8058,-1523
2016,9,21,20,7441,9863,8464,-1399
2016,9,21,21,7517,10025,8683,-1342
2016,9,21,22,7426,9891,8535,-1356
2016,9,21,23,7064,9451,8078,-1373
2016,9,22,0,6800,8994,7532,-1462
2016,9,22,1,6571,8660,7027,-1633
2016,9,22,2,6030,7797,6238,-1559
2016,9,22,3,5475,7001,5413,-1588
2016,9,22,4,4949,6253,4878,-1375
2016,9,22,5,4542,5671,4591,-1080
2016,9,22,6,4226,5254,4399,-855
2016,9,22,7,4017,5019,4208,-811
2016,9,22,8,3884,4828,4070,-758
2016,9,22,9,3891,4809,4052,-757
2016,9,22,10,4099,5005,4194,-811
2016,9,22,11,4527,5585,4642,-943
2016,9,22,12,4746,5778,4917,-861
2016,9,22,13,4925,6057,5008,-1049
2016,9,22,14,5345,6715,5373,-1342
2016,9,22,15,5908,7499,5855,-1644
2016,9,22,16,6390,8251,6628,-1623
2016,9,22,17,6852,8988,7404,-1584
2016,9,22,18,7209,9505,7913,-1592
2016,9,22,19,7409,9913,8389,-1524
2016,9,22,20,7508,10128,8546,-1582
2016,9,22,21,7387,10278,8642,-1636
2016,9,22,22,7259,10090,8536,-1554
2016,9,22,23,6891,9582,8085,-1497
2016,9,23,0,6670,9115,7467,-1648
2016,9,23,1,6465,8696,7025,-1671
2016,9,23,2,5933,7912,6193,-1719
2016,9,23,3,5359,7129,5515,-1614
2016,9,23,4,4838,6380,5010,-1370
2016,9,23,5,4579,5738,4642,-1096
2016,9,23,6,4231,5303,4410,-893
2016,9,23,7,4001,4988,4126,-862
2016,9,23,8,3845,4793,3949,-844
2016,9,23,9,3837,4749,3911,-838
2016,9,23,10,4023,4956,4079,-877
2016,9,23,11,4448,5510,4597,-913
2016,9,23,12,4659,5712,4868,-844
2016,9,23,13,4914,6029,4976,-1053
2016,9,23,14,5371,6652,5344,-1308
2016,9,23,15,5938,7463,5904,-1559
2016,9,23,16,6425,8203,6697,-1506
2016,9,23,17,6957,8921,7322,-1599
2016,9,23,18,7348,9438,7673,-1765
2016,9,23,19,7622,9820,8044,-1776
2016,9,23,20,7786,10085,8264,-1821
2016,9,23,21,7787,10154,8214,-1940
2016,9,23,22,7672,9913,7970,-1943
2016,9,23,23,7233,9408,7634,-1774
2016,9,24,0,6878,8915,7253,-1662
2016,9,24,1,6624,8483,6886,-1597
2016,9,24,2,6084,7783,6141,-1642
2016,9,24,3,5571,7157,5548,-1609
2016,9,24,4,5057,6506,5075,-1431
2016,9,24,5,4616,5896,4751,-1145
2016,9,24,6,4269,5438,4526,-912
2016,9,24,7,4052,5113,4263,-850
2016,9,24,8,3933,4878,4080,-798
2016,9,24,9,3839,4765,3994,-771
2016,9,24,10,3820,4755,3974,-781
2016,9,24,11,3846,4920,4111,-809
2016,9,24,12,4009,5075,4300,-775
2016,9,24,13,4447,5586,4533,-1053
2016,9,24,14,5085,6439,5065,-1374
2016,9,24,15,5698,7343,5662,-1681
2016,9,24,16,6179,8236,6386,-1850
2016,9,24,17,6661,8958,7185,-1773
2016,9,24,18,6984,9450,7800,-1650
2016,9,24,19,7240,9793,8155,-1638
2016,9,24,20,7342,9992,8318,-1674
2016,9,24,21,7250,10018,8351,-1667
2016,9,24,22,7097,9749,8140,-1609
2016,9,24,23,6717,9211,7641,-1570
2016,9,25,0,6482,8687,7023,-1664
2016,9,25,1,6240,8318,6588,-1730
2016,9,25,2,5743,7650,5913,-1737
2016,9,25,3,5305,7027,5386,-1641
2016,9,25,4,4877,6362,4895,-1467
2016,9,25,5,4598,5789,4583,-1206
2016,9,25,6,4237,5351,4339,-1012
2016,9,25,7,3974,5035,4163,-872
2016,9,25,8,3784,4796,3980,-816
2016,9,25,9,3696,4668,3890,-778
2016,9,25,10,3673,4638,3859,-779
2016,9,25,11,3706,4753,3948,-805
2016,9,25,12,3833,4921,4137,-784
2016,9,25,13,4268,5460,4406,-1054
2016,9,25,14,4956,6362,4978,-1384
2016,9,25,15,5602,7227,5515,-1712
2016,9,25,16,6177,8124,6253,-1871
2016,9,25,17,6632,8936,7090,-1846
2016,9,25,18,7000,9436,7678,-1758
2016,9,25,19,7252,9702,8056,-1646
2016,9,25,20,7355,9812,8182,-1630
2016,9,25,21,7389,9721,8117,-1604
2016,9,25,22,7298,9496,7962,-1534
2016,9,25,23,7026,9012,7557,-1455
2016,9,26,0,6720,8705,7246,-1459
2016,9,26,1,6491,8291,6766,-1525
2016,9,26,2,5918,7587,5940,-1647
2016,9,26,3,5363,6847,5306,-1541
2016,9,26,4,4804,6096,4753,-1343
2016,9,26,5,4455,5655,4610,-1045
2016,9,26,6,4110,5247,4429,-818
2016,9,26,7,3873,4994,4232,-762
2016,9,26,8,3722,4859,4121,-738
2016,9,26,9,3749,4860,4128,-732
2016,9,26,10,3942,5131,4332,-799
2016,9,26,11,4410,5669,4777,-892
2016,9,26,12,4623,5975,5103,-872
2016,9,26,13,4842,6225,5164,-1061
2016,9,26,14,5230,6857,5523,-1334
2016,9,26,15,5789,7590,5990,-1600
2016,9,26,16,6403,8349,6621,-1728
2016,9,26,17,6784,8966,7466,-1500
2016,9,26,18,7227,9212,7620,-1592
2016,9,26,19,7453,9077,7563,-1514
2016,9,26,20,7596,8879,7379,-1500
2016,9,26,21,7510,8736,7277,-1459
2016,9,26,22,7388,8333,6956,-1377
2016,9,26,23,7098,7917,6414,-1503
2016,9,27,0,6936,7802,6273,-1529
2016,9,27,1,6625,10859,9295,-1564
2016,9,27,2,6018,6906,5405,-1501
2016,9,27,3,5377,6298,4865,-1433
2016,9,27,4,4788,5757,4487,-1270
2016,9,27,5,4306,5032,4050,-982
2016,9,27,6,3980,4704,3878,-826
2016,9,27,7,3751,4475,3729,-746
2016,9,27,8,3606,4316,3591,-725
2016,9,27,9,3632,4302,3576,-726
2016,9,27,10,3831,4568,3773,-795
2016,9,27,11,4266,5130,4218,-912
2016,9,27,12,4483,5369,4461,-908
2016,9,27,13,4680,5624,4655,-969
2016,9,27,14,5029,6198,4947,-1251
2016,9,27,15,5556,6932,5481,-1451
2016,9,27,16,6169,7649,6110,-1539
2016,9,27,17,6563,8373,6743,-1630
2016,9,27,18,7008,8953,7152,-1801
2016,9,27,19,7225,9380,7451,-1929
2016,9,27,20,7382,9549,7552,-1997
2016,9,27,21,7356,9480,7468,-2012
2016,9,27,22,7208,9193,7218,-1975
2016,9,27,23,6933,8817,6939,-1878
2016,9,28,0,6780,8494,6711,-1783
2016,9,28,1,6523,8157,6477,-1680
2016,9,28,2,5921,7379,5864,-1515
2016,9,28,3,5292,6605,5142,-1463
2016,9,28,4,4700,5860,4586,-1274
2016,9,28,5,4227,5416,4391,-1025
2016,9,28,6,3945,5062,4222,-840
2016,9,28,7,3766,4792,3968,-824
2016,9,28,8,3657,4635,3840,-795
2016,9,28,9,3659,4632,3791,-841
2016,9,28,10,3868,4919,3991,-928
2016,9,28,11,4246,5477,4433,-1044
2016,9,28,12,4466,5707,4696,-1011
2016,9,28,13,4599,5981,4773,-1208
2016,9,28,14,4964,6580,5235,-1345
2016,9,28,15,5488,7281,5758,-1523
2016,9,28,16,6031,7919,6152,-1767
2016,9,28,17,6289,8531,6682,-1849
2016,9,28,18,6603,9032,7096,-1936
2016,9,28,19,6839,9314,7334,-1980
2016,9,28,20,6969,9314,7289,-2025
2016,9,28,21,6855,9115,7131,-1984
2016,9,28,22,6738,8899,6951,-1948
2016,9,28,23,6497,8502,6645,-1857
2016,9,29,0,6406,8277,6466,-1811
2016,9,29,1,6236,7833,6147,-1686
2016,9,29,2,5625,7177,5684,-1493
2016,9,29,3,5069,6512,5017,-1495
2016,9,29,4,4536,5853,4475,-1378
2016,9,29,5,4262,5136,3959,-1177
2016,9,29,6,3966,4797,3794,-1003
2016,9,29,7,3775,4558,3614,-944
2016,9,29,8,3650,4414,3490,-924
2016,9,29,9,3669,4394,3462,-932
2016,9,29,10,3865,4685,3670,-1015
2016,9,29,11,4272,5296,4146,-1150
2016,9,29,12,4503,5561,4445,-1116
2016,9,29,13,4656,5825,4551,-1274
2016,9,29,14,5042,6417,4877,-1540
2016,9,29,15,5501,7144,5358,-1786
2016,9,29,16,6016,7703,6007,-1696
2016,9,29,17,6318,8146,6500,-1646
2016,9,29,18,6609,8160,6516,-1644
2016,9,29,19,6866,7929,6265,-1664
2016,9,29,20,6973,8143,6368,-1775
2016,9,29,21,6861,8515,6584,-1931
2016,9,29,22,6765,8536,6493,-2043
2016,9,29,23,6527,8237,6245,-1992
2016,9,30,0,6381,8041,6110,-1931
2016,9,30,1,6150,7697,5831,-1866
2016,9,30,2,5605,7026,5186,-1840
2016,9,30,3,5061,6367,4618,-1749
2016,9,30,4,4548,5699,4175,-1524
2016,9,30,5,4081,5158,3948,-1210
2016,9,30,6,3784,4788,3752,-1036
2016,9,30,7,3589,4527,3555,-972
2016,9,30,8,3474,4396,3442,-954
2016,9,30,9,3465,4401,3445,-956
2016,9,30,10,3657,4704,3685,-1019
2016,9,30,11,4071,5291,4164,-1127
2016,9,30,12,4317,5579,4520,-1059
2016,9,30,13,4489,5809,4569,-1240
2016,9,30,14,4827,6392,4872,-1520
2016,9,30,15,5286,7057,5278,-1779
2016,9,30,16,5826,7677,5637,-2040
2016,9,30,17,6124,8292,6155,-2137
2016,9,30,18,6408,8845,6633,-2212
2016,9,30,19,6610,9183,6904,-2279
2016,9,30,20,6724,9348,7028,-2320
2016,9,30,21,6615,9230,7028,-2202
2016,9,30,22,6482,8789,6575,-2214
2016,9,30,23,6152,8244,6121,-2123
2016,10,1,0,5916,7819,5779,-2040
2016,10,1,1,5614,7525,5766,-1759
2016,10,1,2,5152,6959,5299,-1660
2016,10,1,3,4725,6411,4765,-1646
2016,10,1,4,4317,5777,4290,-1487
2016,10,1,5,4134,5231,4020,-1211
2016,10,1,6,3824,4781,3763,-1018
2016,10,1,7,3615,4500,3551,-949
2016,10,1,8,3479,4290,3390,-900
2016,10,1,9,3427,4221,3336,-885
2016,10,1,10,3441,4275,3369,-906
2016,10,1,11,3577,4465,3510,-955
2016,10,1,12,3772,4675,3731,-944
2016,10,1,13,4171,5079,3919,-1160
2016,10,1,14,4753,5713,4252,-1461
2016,10,1,15,5308,6379,4680,-1699
2016,10,1,16,5724,7115,5317,-1798
2016,10,1,17,6116,7824,5982,-1842
2016,10,1,18,6388,8477,6509,-1968
2016,10,1,19,6618,8886,6716,-2170
2016,10,1,20,6743,9134,6883,-2251
2016,10,1,21,6723,9182,6910,-2272
2016,10,1,22,6587,9022,6795,-2227
2016,10,1,23,6248,8479,6347,-2132
2016,10,2,0,6064,7962,5963,-1999
2016,10,2,1,5792,7450,5635,-1815
2016,10,2,2,5341,6840,5077,-1763
2016,10,2,3,4924,6317,4621,-1696
2016,10,2,4,4515,5725,4233,-1492
2016,10,2,5,3936,5203,3985,-1218
2016,10,2,6,3634,4800,3759,-1041
2016,10,2,7,3422,4499,3518,-981
2016,10,2,8,3304,4325,3390,-935
2016,10,2,9,3246,4212,3300,-912
2016,10,2,10,3235,4229,3295,-934
2016,10,2,11,3324,4346,3374,-972
2016,10,2,12,3476,4517,3584,-933
2016,10,2,13,3908,5024,3824,-1200
2016,10,2,14,4392,5831,4330,-1501
2016,10,2,15,4943,6622,4849,-1773
2016,10,2,16,5456,7327,5454,-1873
2016,10,2,17,5797,8081,6110,-1971
2016,10,2,18,6057,8645,6546,-2099
2016,10,2,19,6273,8980,6734,-2246
2016,10,2,20,6349,9176,6870,-2306
2016,10,2,21,6410,9090,6903,-2187
2016,10,2,22,6288,8734,6611,-2123
2016,10,2,23,5973,8287,6289,-1998
2016,10,3,0,5903,8073,6162,-1911
2016,10,3,1,5652,7539,5737,-1802
2016,10,3,2,5173,6848,5175,-1673
2016,10,3,3,4743,6200,4584,-1616
2016,10,3,4,4272,5551,4068,-1483
2016,10,3,5,3973,5035,3863,-1172
2016,10,3,6,3696,4674,3663,-1011
2016,10,3,7,3528,4429,3479,-950
2016,10,3,8,3436,4327,3387,-940
2016,10,3,9,3443,4366,3423,-943
2016,10,3,10,3651,4661,3639,-1022
2016,10,3,11,4116,5248,4097,-1151
2016,10,3,12,4384,5535,4477,-1058
2016,10,3,13,4494,5681,4464,-1217
2016,10,3,14,4854,6092,4610,-1482
2016,10,3,15,5389,6608,4863,-1745
2016,10,3,16,5728,7075,5316,-1759
2016,10,3,17,6063,7604,5839,-1765
2016,10,3,18,6390,8105,6238,-1867
2016,10,3,19,6551,8452,6466,-1986
2016,10,3,20,6602,8546,6580,-1966
2016,10,3,21,6509,8386,6414,-1972
2016,10,3,22,6348,8126,6180,-1946
2016,10,3,23,6174,7816,5910,-1906
2016,10,4,0,6121,7716,5881,-1835
2016,10,4,1,5965,7359,5603,-1756
2016,10,4,2,5432,6743,5067,-1676
2016,10,4,3,4948,6134,4504,-1630
2016,10,4,4,4424,5535,4042,-1493
2016,10,4,5,4012,5053,3889,-1164
2016,10,4,6,3772,4706,3711,-995
2016,10,4,7,3622,4513,3558,-955
2016,10,4,8,3537,4406,3468,-938
2016,10,4,9,3538,4416,3475,-941
2016,10,4,10,3786,4729,3715,-1014
2016,10,4,11,4257,5362,4228,-1134
2016,10,4,12,4516,5664,4542,-1122
2016,10,4,13,4691,5817,4556,-1261
2016,10,4,14,5055,6252,4768,-1484
2016,10,4,15,5570,6916,5218,-1698
2016,10,4,16,6004,7582,5777,-1805
2016,10,4,17,6394,8168,6350,-1818
2016,10,4,18,6752,8482,6582,-1900
2016,10,4,19,6957,8538,6617,-1921
2016,10,4,20,6985,8429,6482,-1947
2016,10,4,21,6909,8370,6488,-1882
2016,10,4,22,6680,8307,6433,-1874
2016,10,4,23,6424,7991,6161,-1830
2016,10,5,0,6441,7933,6148,-1785
2016,10,5,1,6264,7709,5923,-1786
2016,10,5,2,5705,7093,5352,-1741
2016,10,5,3,5198,6455,4759,-1696
2016,10,5,4,4677,5765,4309,-1456
2016,10,5,5,4257,5191,3999,-1192
2016,10,5,6,3995,4821,3787,-1034
2016,10,5,7,3833,4592,3600,-992
2016,10,5,8,3729,4460,3480,-980
2016,10,5,9,3750,4472,3482,-990
2016,10,5,10,3928,4769,3691,-1078
2016,10,5,11,4391,5402,4203,-1199
2016,10,5,12,4629,5725,4532,-1193
2016,10,5,13,4808,5844,4530,-1314
2016,10,5,14,5269,6229,4649,-1580
2016,10,5,15,5758,6783,5027,-1756
2016,10,5,16,6156,7408,5570,-1838
2016,10,5,17,6555,8052,6075,-1977
2016,10,5,18,6839,8650,6508,-2142
2016,10,5,19,7061,9113,6858,-2255
2016,10,5,20,7065,9352,7052,-2300
2016,10,5,21,6980,9400,7100,-2300
2016,10,5,22,6805,9173,6838,-2335
2016,10,5,23,6626,8759,6489,-2270
2016,10,6,0,6540,8574,6354,-2220
2016,10,6,1,6335,8264,6119,-2145
2016,10,6,2,5820,7603,5561,-2042
2016,10,6,3,5290,6958,4976,-1982
2016,10,6,4,4804,6245,4511,-1734
2016,10,6,5,4502,5680,4207,-1473
2016,10,6,6,4214,5251,3977,-1274
2016,10,6,7,4068,4994,3772,-1222
2016,10,6,8,3951,4842,3640,-1202
2016,10,6,9,3984,4861,3654,-1207
2016,10,6,10,4197,5127,3756,-1371
2016,10,6,11,4597,5673,4191,-1482
2016,10,6,12,4897,6010,4547,-1463
2016,10,6,13,5006,6214,4594,-1620
2016,10,6,14,5268,6629,4743,-1886
2016,10,6,15,5649,7050,5166,-1884
2016,10,6,16,5988,7472,5679,-1793
2016,10,6,17,6190,7925,6170,-1755
2016,10,6,18,6243,8201,6364,-1837
2016,10,6,19,6371,8126,6392,-1734
2016,10,6,20,6285,8058,6255,-1803
2016,10,6,21,6158,7955,6172,-1783
2016,10,6,22,5921,7780,5992,-1788
2016,10,6,23,5896,7472,5710,-1762
2016,10,7,0,5998,7384,5632,-1752
2016,10,7,1,5887,7034,5338,-1696
2016,10,7,2,5467,6502,4784,-1718
2016,10,7,3,5004,6046,4312,-1734
2016,10,7,4,4564,5516,3923,-1593
2016,10,7,5,4417,5100,3919,-1181
2016,10,7,6,4198,4779,3690,-1089
2016,10,7,7,4072,4558,3508,-1050
2016,10,7,8,4007,4464,3441,-1023
2016,10,7,9,4051,4430,3413,-1017
2016,10,7,10,4233,4574,3507,-1067
2016,10,7,11,4528,4830,3708,-1122
2016,10,7,12,4838,5088,3909,-1179
2016,10,7,13,4932,5279,4058,-1221
2016,10,7,14,5261,5581,4320,-1261
2016,10,7,15,5570,5795,4550,-1245
2016,10,7,16,5699,5893,4723,-1170
2016,10,7,17,5700,5984,4898,-1086
2016,10,7,18,5742,6068,4960,-1108
2016,10,7,19,5838,6142,4953,-1189
2016,10,7,20,5838,6204,4901,-1303
2016,10,7,21,5738,6288,4914,-1374
2016,10,7,22,5639,6330,4927,-1403
2016,10,7,23,5544,6284,4775,-1509
2016,10,8,0,5493,6411,4902,-1509
2016,10,8,1,5323,6357,4797,-1560
2016,10,8,2,4987,6049,4526,-1523
2016,10,8,3,4643,0,4526,-1335
2016,10,8,4,4338,5259,4087,-1172
2016,10,8,5,3831,4836,3836,-1000
2016,10,8,6,3642,4543,3628,-915
2016,10,8,7,3551,4312,3436,-876
2016,10,8,8,3469,4202,3347,-855
2016,10,8,9,3427,4175,3323,-852
2016,10,8,10,3479,4203,3354,-849
2016,10,8,11,3524,4409,3504,-905
2016,10,8,12,3713,4634,3665,-969
2016,10,8,13,3994,5177,4080,-1097
2016,10,8,14,4384,5971,4699,-1272
2016,10,8,15,4702,6649,5342,-1307
2016,10,8,16,5040,7227,5888,-1339
2016,10,8,17,5367,7721,6376,-1345
2016,10,8,18,5558,8168,6768,-1400
2016,10,8,19,5642,8523,7109,-1414
2016,10,8,20,5636,8771,7297,-1474
2016,10,8,21,5514,8806,7323,-1483
2016,10,8,22,5625,8583,7179,-1404
2016,10,8,23,5286,8137,6835,-1302
2016,10,9,0,5158,7808,6594,-1214
2016,10,9,1,4915,7387,6226,-1161
2016,10,9,2,4600,6748,5652,-1096
2016,10,9,3,4349,6205,5045,-1160
2016,10,9,4,4087,5648,4516,-1132
2016,10,9,5,4064,5116,4099,-1017
2016,10,9,6,3762,4725,3795,-930
2016,10,9,7,3591,4427,3570,-857
2016,10,9,8,3401,4237,3440,-797
2016,10,9,9,3318,4167,3341,-826
2016,10,9,10,3315,4168,3341,-827
2016,10,9,11,3341,4304,3450,-854
2016,10,9,12,3504,4458,3547,-911
2016,10,9,13,3893,4961,3933,-1028
2016,10,9,14,4380,5685,4489,-1196
2016,10,9,15,4869,6310,4863,-1447
2016,10,9,16,5165,6879,5337,-1542
2016,10,9,17,5633,7429,5783,-1646
2016,10,9,18,5877,7888,6116,-1772
2016,10,9,19,6114,8244,6331,-1913
2016,10,9,20,6260,8487,6497,-1990
2016,10,9,21,6246,8585,6572,-2013
2016,10,9,22,6266,8410,6463,-1947
2016,10,9,23,6007,7948,6107,-1841
2016,10,10,0,5920,7653,5883,-1770
2016,10,10,1,5565,7223,5553,-1670
2016,10,10,2,4970,6441,4946,-1495
2016,10,10,3,4492,5776,4388,-1388
2016,10,10,4,4088,5140,3886,-1254
2016,10,10,5,3588,4481,3510,-971
2016,10,10,6,3281,4046,3150,-896
2016,10,10,7,3086,3807,2940,-867
2016,10,10,8,3010,3649,2835,-814
2016,10,10,9,3013,3650,2799,-851
2016,10,10,10,3229,3914,2992,-922
2016,10,10,11,3599,4400,3322,-1078
2016,10,10,12,3823,4661,3547,-1114
2016,10,10,13,3931,4855,3793,-1062
2016,10,10,14,4213,5205,4118,-1087
2016,10,10,15,4512,5623,4410,-1213
2016,10,10,16,4760,5977,4556,-1421
2016,10,10,17,4973,6291,4760,-1531
2016,10,10,18,5261,6577,4959,-1618
2016,10,10,19,5487,6766,5110,-1656
2016,10,10,20,5626,6907,5209,-1698
2016,10,10,21,5713,6951,5226,-1725
2016,10,10,22,5655,6869,5132,-1737
2016,10,10,23,5426,6675,4979,-1696
2016,10,11,0,5404,6732,5036,-1696
2016,10,11,1,5208,6500,4792,-1708
2016,10,11,2,4768,5941,4512,-1429
2016,10,11,3,4319,5353,4181,-1172
2016,10,11,4,3863,4701,3577,-1124
2016,10,11,5,3353,4221,3056,-1165
2016,10,11,6,3100,3912,2778,-1134
2016,10,11,7,2957,3727,2609,-1118
2016,10,11,8,2871,3642,2553,-1089
2016,10,11,9,2897,3706,2583,-1123
2016,10,11,10,3102,4006,2777,-1229
2016,10,11,11,3543,4600,3275,-1325
2016,10,11,12,3785,4874,3597,-1277
2016,10,11,13,3870,4986,3719,-1267
2016,10,11,14,4135,5188,3932,-1256
2016,10,11,15,4454,5475,4109,-1366
2016,10,11,16,4773,5802,4234,-1568
2016,10,11,17,5079,6109,4430,-1679
2016,10,11,18,5369,6370,4646,-1724
2016,10,11,19,5594,6594,4786,-1808
2016,10,11,20,5780,6690,4794,-1896
2016,10,11,21,5903,6732,4805,-1927
2016,10,11,22,5775,6698,4754,-1944
2016,10,11,23,5675,6605,4688,-1917
2016,10,12,0,5598,6744,4849,-1895
2016,10,12,1,5357,6563,4832,-1731
2016,10,12,2,4898,6040,4683,-1357
2016,10,12,3,4404,5505,4414,-1091
2016,10,12,4,3930,4925,3820,-1105
2016,10,12,5,3511,4452,3406,-1046
2016,10,12,6,3268,4119,3124,-995
2016,10,12,7,3117,3915,2961,-954
2016,10,12,8,3035,3829,2890,-939
2016,10,12,9,3049,3892,2920,-972
2016,10,12,10,3288,4204,3086,-1118
2016,10,12,11,3735,4782,3545,-1237
2016,10,12,12,3979,5091,3844,-1247
2016,10,12,13,4102,5209,3983,-1226
2016,10,12,14,4411,5511,4255,-1256
2016,10,12,15,4827,5800,4361,-1439
2016,10,12,16,5252,6372,4691,-1681
2016,10,12,17,5597,6813,5071,-1742
2016,10,12,18,5855,7160,5204,-1956
2016,10,12,19,6169,7408,5257,-2151
2016,10,12,20,6227,7585,5398,-2187
2016,10,12,21,6260,7653,5432,-2221
2016,10,12,22,6120,7601,5350,-2251
2016,10,12,23,5917,7328,5137,-2191
2016,10,13,0,5824,7340,5165,-2175
2016,10,13,1,5568,7075,5070,-2005
2016,10,13,2,5081,6481,4809,-1672
2016,10,13,3,4622,5860,4590,-1270
2016,10,13,4,4148,5207,4138,-1069
2016,10,13,5,3679,4667,3819,-848
2016,10,13,6,3383,4348,3517,-831
2016,10,13,7,3224,4153,3351,-802
2016,10,13,8,3142,4026,3267,-759
2016,10,13,9,3144,4044,3279,-765
2016,10,13,10,3371,4343,3432,-911
2016,10,13,11,3784,4921,3711,-1210
2016,10,13,12,4038,5195,3917,-1278
2016,10,13,13,4171,5349,4139,-1210
2016,10,13,14,4479,5751,4390,-1361
2016,10,13,15,4855,6260,4645,-1615
2016,10,13,16,5287,6805,4993,-1812
2016,10,13,17,5637,7268,5211,-2057
2016,10,13,18,5950,7608,5404,-2204
2016,10,13,19,6182,7881,5658,-2223
2016,10,13,20,6286,8075,5922,-2153
2016,10,13,21,6274,8163,6014,-2149
2016,10,13,22,6084,7972,5819,-2153
2016,10,13,23,5864,7598,5443,-2155
2016,10,14,0,5783,7516,5394,-2122
2016,10,14,1,5508,7233,5296,-1937
2016,10,14,2,5019,6654,4962,-1692
2016,10,14,3,4596,6029,4571,-1458
2016,10,14,4,4117,5387,4126,-1261
2016,10,14,5,3889,4810,3805,-1005
2016,10,14,6,3602,4427,3517,-910
2016,10,14,7,3405,4187,3318,-869
2016,10,14,8,3302,4057,3217,-840
2016,10,14,9,3305,4055,3215,-840
2016,10,14,10,3488,4290,3384,-906
2016,10,14,11,3891,4814,3672,-1142
2016,10,14,12,4131,5095,3860,-1235
2016,10,14,13,4316,5308,4082,-1226
2016,10,14,14,4706,5809,4660,-1149
2016,10,14,15,5150,6357,5053,-1304
2016,10,14,16,5462,6792,5148,-1644
2016,10,14,17,5749,7204,5298,-1906
2016,10,14,18,6035,7612,5584,-2028
2016,10,14,19,6276,7948,5887,-2061
2016,10,14,20,6429,8154,6108,-2046
2016,10,14,21,6470,8213,6201,-2012
2016,10,14,22,6318,7991,6026,-1965
2016,10,14,23,5937,7509,5637,-1872
2016,10,15,0,5794,7323,5429,-1894
2016,10,15,1,5537,6963,5177,-1786
2016,10,15,2,5163,6485,4956,-1529
2016,10,15,3,4847,6040,4758,-1282
2016,10,15,4,4411,5450,4173,-1277
2016,10,15,5,4006,4909,3648,-1261
2016,10,15,6,3711,4534,3434,-1100
2016,10,15,7,3517,4288,3322,-966
2016,10,15,8,3430,4167,3222,-945
2016,10,15,9,3400,4139,3196,-943
2016,10,15,10,3467,4226,3257,-969
2016,10,15,11,3623,4432,3418,-1014
2016,10,15,12,3828,4711,3631,-1080
2016,10,15,13,4069,5093,3880,-1213
2016,10,15,14,4465,5621,4378,-1243
2016,10,15,15,4850,6131,4694,-1437
2016,10,15,16,5274,6690,5065,-1625
2016,10,15,17,5609,7155,5364,-1791
2016,10,15,18,5955,7565,5698,-1867
2016,10,15,19,6142,7810,5883,-1927
2016,10,15,20,6216,7916,5961,-1955
2016,10,15,21,6194,7888,5938,-1950
2016,10,15,22,6019,7644,5717,-1927
2016,10,15,23,5705,7235,5378,-1857
2016,10,16,0,5671,7165,5215,-1950
2016,10,16,1,5445,6876,5095,-1781
2016,10,16,2,5100,6430,4901,-1529
2016,10,16,3,4801,6018,4719,-1299
2016,10,16,4,4448,5517,4292,-1225
2016,10,16,5,4093,5046,3840,-1206
2016,10,16,6,3787,4658,3572,-1086
2016,10,16,7,3552,4358,3353,-1005
2016,10,16,8,3440,4208,3237,-971
2016,10,16,9,3358,4111,3163,-948
2016,10,16,10,3370,4132,3170,-962
2016,10,16,11,3473,4260,3270,-990
2016,10,16,12,3644,4496,3435,-1061
2016,10,16,13,3943,4901,3683,-1218
2016,10,16,14,4460,5570,4290,-1280
2016,10,16,15,5001,6257,4778,-1479
2016,10,16,16,5471,6861,5086,-1775
2016,10,16,17,5854,7395,5428,-1967
2016,10,16,18,6181,7814,5787,-2027
2016,10,16,19,6422,8107,6089,-2018
2016,10,16,20,6476,8188,6199,-1989
2016,10,16,21,6446,8152,6165,-1987
2016,10,16,22,6202,7856,5881,-1975
2016,10,16,23,5892,7454,5526,-1928
2016,10,17,0,5853,7372,5372,-2000
2016,10,17,1,5596,7050,5257,-1793
2016,10,17,2,5100,6400,4913,-1487
2016,10,17,3,4617,5761,4557,-1204
2016,10,17,4,4135,5088,3937,-1151
2016,10,17,5,3716,4540,3432,-1108
2016,10,17,6,3416,4185,3125,-1060
2016,10,17,7,3267,3978,2966,-1012
2016,10,17,8,3200,3891,2888,-1003
2016,10,17,9,3203,3908,2904,-1004
2016,10,17,10,3475,4235,3141,-1094
2016,10,17,11,3903,4763,3575,-1188
2016,10,17,12,4199,5121,3970,-1151
2016,10,17,13,4386,5349,4184,-1165
2016,10,17,14,4782,5859,4533,-1326
2016,10,17,15,5239,6449,4861,-1588
2016,10,17,16,5647,6988,5027,-1961
2016,10,17,17,6013,7496,5319,-2177
2016,10,17,18,6345,7971,5760,-2211
2016,10,17,19,6616,8316,6078,-2238
2016,10,17,20,6764,8524,6271,-2253
2016,10,17,21,6811,8589,6341,-2248
2016,10,17,22,6662,8410,6192,-2218
2016,10,17,23,6321,7971,5839,-2132
2016,10,18,0,6253,7862,5750,-2112
2016,10,18,1,5963,7468,5571,-1897
2016,10,18,2,5400,6742,5102,-1640
2016,10,18,3,4884,6052,4568,-1484
2016,10,18,4,4334,5306,3914,-1392
2016,10,18,5,3871,4724,3482,-1242
2016,10,18,6,3556,4328,3238,-1090
2016,10,18,7,3361,4070,3122,-948
2016,10,18,8,3274,3950,3019,-931
2016,10,18,9,3268,3944,3006,-938
2016,10,18,10,3473,4243,3276,-967
2016,10,18,11,3908,4840,3732,-1108
2016,10,18,12,4162,5111,4036,-1075
2016,10,18,13,4307,5236,4154,-1082
2016,10,18,14,4623,5691,4677,-1014
2016,10,18,15,5091,6268,5051,-1217
2016,10,18,16,5573,6834,5138,-1696
2016,10,18,17,5927,7351,5527,-1824
2016,10,18,18,6215,7843,6086,-1757
2016,10,18,19,6475,8246,6566,-1680
2016,10,18,20,6630,8484,6558,-1926
2016,10,18,21,6707,8606,6649,-1957
2016,10,18,22,6581,8497,6586,-1911
2016,10,18,23,6204,8064,6256,-1808
2016,10,19,0,6170,7959,6170,-1789
2016,10,19,1,5932,7525,5847,-1678
2016,10,19,2,5332,6788,5323,-1465
2016,10,19,3,4816,6044,4822,-1222
2016,10,19,4,4300,5083,3931,-1152
2016,10,19,5,3828,4706,3645,-1061
2016,10,19,6,3531,4313,3395,-918
2016,10,19,7,3336,3999,3145,-854
2016,10,19,8,3238,3886,3036,-850
2016,10,19,9,3215,3854,3006,-848
2016,10,19,10,3400,4131,3218,-913
2016,10,19,11,3823,4688,3614,-1074
2016,10,19,12,4093,4965,3911,-1054
2016,10,19,13,4233,5050,3971,-1079
2016,10,19,14,4578,5471,4417,-1054
2016,10,19,15,4973,5999,4843,-1156
2016,10,19,16,5454,6492,5226,-1266
2016,10,19,17,5855,7005,5618,-1387
2016,10,19,18,6148,7468,6065,-1403
2016,10,19,19,6416,7801,6203,-1598
2016,10,19,20,6587,8072,6433,-1639
2016,10,19,21,6651,8218,6549,-1669
2016,10,19,22,6547,8076,6454,-1622
2016,10,19,23,6226,7666,6293,-1373
2016,10,20,0,6119,7517,6155,-1362
2016,10,20,1,5846,7116,5850,-1266
2016,10,20,2,5260,6355,5247,-1108
2016,10,20,3,4758,5698,4743,-955
2016,10,20,4,4267,5072,4216,-856
2016,10,20,5,3776,4634,3683,-951
2016,10,20,6,3490,4237,3425,-812
2016,10,20,7,3279,4008,3322,-686
2016,10,20,8,3176,3898,3243,-655
2016,10,20,9,3183,3935,3269,-666
2016,10,20,10,3397,4230,3482,-748
2016,10,20,11,3831,4777,3859,-918
2016,10,20,12,4094,5054,4137,-917
2016,10,20,13,4230,5187,4284,-903
2016,10,20,14,4552,5561,4651,-910
2016,10,20,15,4960,6041,5067,-974
2016,10,20,16,5439,6532,5445,-1087
2016,10,20,17,5726,7031,5757,-1274
2016,10,20,18,6059,7477,6136,-1341
2016,10,20,19,6325,7854,6328,-1526
2016,10,20,20,6473,8160,6561,-1599
2016,10,20,21,6516,8298,6645,-1653
2016,10,20,22,6448,8230,6585,-1645
2016,10,20,23,6152,7802,6333,-1469
2016,10,21,0,6046,7664,6288,-1376
2016,10,21,1,5798,7262,5977,-1285
2016,10,21,2,5242,6592,5438,-1154
2016,10,21,3,4749,5931,4870,-1061
2016,10,21,4,4270,5292,4300,-992
2016,10,21,5,3712,4559,3706,-853
2016,10,21,6,3405,4190,3479,-711
2016,10,21,7,3228,3965,3286,-679
2016,10,21,8,3127,3863,3179,-684
2016,10,21,9,3124,3876,3174,-702
2016,10,21,10,3329,4164,3455,-709
2016,10,21,11,3696,4737,3944,-793
2016,10,21,12,3936,5061,4136,-925
2016,10,21,13,4117,5158,4149,-1009
2016,10,21,14,4495,5562,4507,-1055
2016,10,21,15,4826,6039,4953,-1086
2016,10,21,16,5264,6569,5367,-1202
2016,10,21,17,5501,7058,5621,-1437
2016,10,21,18,5819,7529,5918,-1611
2016,10,21,19,6051,7828,6188,-1640
2016,10,21,20,6181,8020,6333,-1687
2016,10,21,21,6109,8062,6382,-1680
2016,10,21,22,5921,7859,6231,-1628
2016,10,21,23,5463,7336,5821,-1515
2016,10,22,0,5252,7171,5624,-1547
2016,10,22,1,5090,6691,5198,-1493
2016,10,22,2,4666,6146,4856,-1290
2016,10,22,3,4288,5591,4432,-1159
2016,10,22,4,3863,4974,3861,-1113
2016,10,22,5,3516,4435,3344,-1091
2016,10,22,6,3263,4015,3057,-958
2016,10,22,7,3119,3729,2826,-903
2016,10,22,8,3027,3562,2676,-886
2016,10,22,9,2979,3487,2618,-869
2016,10,22,10,2995,3544,2556,-988
2016,10,22,11,3105,3711,2555,-1156
2016,10,22,12,3291,3897,2663,-1234
2016,10,22,13,3559,4222,2882,-1340
2016,10,22,14,3908,4570,3009,-1561
2016,10,22,15,4147,4777,3092,-1685
2016,10,22,16,4341,4902,3078,-1824
2016,10,22,17,4460,5000,3126,-1874
2016,10,22,18,4646,5131,3216,-1915
2016,10,22,19,4808,5255,3319,-1936
2016,10,22,20,4828,5402,3425,-1977
2016,10,22,21,4799,5496,3507,-1989
2016,10,22,22,4710,5458,3461,-1997
2016,10,22,23,4530,5256,3329,-1927
2016,10,23,0,4513,5264,3320,-1944
2016,10,23,1,4265,5025,3246,-1779
2016,10,23,2,3957,4665,3101,-1564
2016,10,23,3,3656,4325,3028,-1297
2016,10,23,4,3394,3940,2735,-1205
2016,10,23,5,3159,3636,2604,-1032
2016,10,23,6,2966,3385,2491,-894
2016,10,23,7,2884,3244,2370,-874
2016,10,23,8,2784,3198,2320,-878
2016,10,23,9,2793,3219,2320,-899
2016,10,23,10,2846,3298,2306,-992
2016,10,23,11,2989,3507,2345,-1162
2016,10,23,12,3151,3769,2477,-1292
2016,10,23,13,3379,4228,2770,-1458
2016,10,23,14,3607,4598,2930,-1668
2016,10,23,15,3761,4747,2999,-1748
2016,10,23,16,3893,4814,2919,-1895
2016,10,23,17,4122,4899,3001,-1898
2016,10,23,18,4224,5022,3111,-1911
2016,10,23,19,4423,5170,3232,-1938
2016,10,23,20,4585,5347,3394,-1953
2016,10,23,21,4702,5530,3535,-1995
2016,10,23,22,4707,5590,3577,-2013
2016,10,23,23,4634,5504,3514,-1990
2016,10,24,0,4707,5665,3620,-2045
2016,10,24,1,4439,5458,3572,-1886
2016,10,24,2,4084,4950,3330,-1620
2016,10,24,3,3705,4467,3112,-1355
2016,10,24,4,3374,3961,2738,-1223
2016,10,24,5,2976,3597,2571,-1026
2016,10,24,6,2772,3353,2448,-905
2016,10,24,7,2656,3237,2340,-897
2016,10,24,8,2607,3208,2302,-906
2016,10,24,9,2691,3281,2356,-925
2016,10,24,10,2982,3661,2538,-1123
2016,10,24,11,3450,4282,2887,-1395
2016,10,24,12,3708,4631,3130,-1501
2016,10,24,13,3727,4705,3204,-1501
2016,10,24,14,3842,4891,3360,-1531
2016,10,24,15,3966,5043,3538,-1505
2016,10,24,16,4137,5195,3711,-1484
2016,10,24,17,4236,5360,3864,-1496
2016,10,24,18,4429,5532,4011,-1521
2016,10,24,19,4686,5721,4159,-1562
2016,10,24,20,4893,5912,4313,-1599
2016,10,24,21,5067,6077,4434,-1643
2016,10,24,22,5064,6125,4471,-1654
2016,10,24,23,4875,5999,4346,-1653
2016,10,25,0,4994,6128,4439,-1689
2016,10,25,1,4819,5846,4233,-1613
2016,10,25,2,4406,5289,3782,-1507
2016,10,25,3,3969,4712,3381,-1331
2016,10,25,4,3536,4165,2927,-1238
2016,10,25,5,3007,3743,2735,-1008
2016,10,25,6,2752,3510,2604,-906
2016,10,25,7,2650,3364,2484,-880
2016,10,25,8,2601,3343,2454,-889
2016,10,25,9,2638,3406,2480,-926
2016,10,25,10,2859,3755,2648,-1107
2016,10,25,11,3367,4386,3032,-1354
2016,10,25,12,3629,4694,3266,-1428
2016,10,25,13,3673,4744,3311,-1433
2016,10,25,14,3790,4858,3399,-1459
2016,10,25,15,4027,5009,3545,-1464
2016,10,25,16,4214,5160,3687,-1473
2016,10,25,17,4472,5356,3851,-1505
2016,10,25,18,4713,5608,4070,-1538
2016,10,25,19,5009,5891,4274,-1617
2016,10,25,20,5233,6186,4519,-1667
2016,10,25,21,5410,6361,4550,-1811
2016,10,25,22,5414,6365,4520,-1845
2016,10,25,23,5275,6256,4421,-1835
2016,10,26,0,5268,6403,4599,-1804
2016,10,26,1,5115,6159,4443,-1716
2016,10,26,2,4691,5579,3999,-1580
2016,10,26,3,4214,5042,3608,-1434
2016,10,26,4,3731,4247,2979,-1268
2016,10,26,5,3296,4035,2957,-1078
2016,10,26,6,3024,3742,2787,-955
2016,10,26,7,2900,3575,2673,-902
2016,10,26,8,2827,3519,2619,-900
2016,10,26,9,2846,3590,2642,-948
2016,10,26,10,3071,3886,2861,-1025
2016,10,26,11,3545,4459,3251,-1208
2016,10,26,12,3790,4787,3600,-1187
2016,10,26,13,3868,4861,3649,-1212
2016,10,26,14,4109,5106,3882,-1224
2016,10,26,15,4473,5493,4188,-1305
2016,10,26,16,4807,5840,4477,-1363
2016,10,26,17,5081,6162,4655,-1507
2016,10,26,18,5361,6457,4718,-1739
2016,10,26,19,5596,6760,5091,-1669
2016,10,26,20,5792,7009,5378,-1631
2016,10,26,21,5872,7150,5464,-1686
2016,10,26,22,5844,7079,5388,-1691
2016,10,26,23,5676,6433,4784,-1649
2016,10,27,0,5607,6886,5207,-1679
2016,10,27,1,5372,6575,4997,-1578
2016,10,27,2,4923,6014,4634,-1380
2016,10,27,3,4457,5401,4207,-1194
2016,10,27,4,3980,4748,3747,-1001
2016,10,27,5,3533,4251,3492,-759
2016,10,27,6,3251,3926,3113,-813
2016,10,27,7,3097,3736,2960,-776
2016,10,27,8,3016,3637,2874,-763
2016,10,27,9,3036,3682,2902,-780
2016,10,27,10,3269,3968,3105,-863
2016,10,27,11,3729,4531,3392,-1139
2016,10,27,12,3991,4877,3521,-1356
2016,10,27,13,4078,4964,3489,-1475
2016,10,27,14,4320,5260,3724,-1536
2016,10,27,15,4665,5623,3921,-1702
2016,10,27,16,5054,5977,4188,-1789
2016,10,27,17,5259,6305,4516,-1789
2016,10,27,18,5525,6601,4830,-1771
2016,10,27,19,5714,6859,5077,-1782
2016,10,27,20,5829,7007,5154,-1853
2016,10,27,21,5853,7029,5184,-1845
2016,10,27,22,5780,6891,5034,-1857
2016,10,27,23,5595,6759,4910,-1849
2016,10,28,0,5526,6856,4984,-1872
2016,10,28,1,5328,6625,4816,-1809
2016,10,28,2,4877,6070,4390,-1680
2016,10,28,3,4397,5487,3834,-1653
2016,10,28,4,3939,4650,3222,-1428
2016,10,28,5,3522,4358,3206,-1152
2016,10,28,6,3230,4033,2932,-1101
2016,10,28,7,3075,3831,2769,-1062
2016,10,28,8,2997,3738,2698,-1040
2016,10,28,9,3012,3763,2708,-1055
2016,10,28,10,3232,4029,2899,-1130
2016,10,28,11,3689,4565,3273,-1292
2016,10,28,12,3954,4909,3569,-1340
2016,10,28,13,4066,4988,3644,-1344
2016,10,28,14,4349,5264,3714,-1550
2016,10,28,15,4663,5669,3970,-1699
2016,10,28,16,5009,6038,4311,-1727
2016,10,28,17,5318,6424,4739,-1685
2016,10,28,18,5552,6690,5022,-1668
2016,10,28,19,5732,6886,5165,-1721
2016,10,28,20,5868,6998,5221,-1777
2016,10,28,21,5914,7048,5253,-1795
2016,10,28,22,5772,6872,5111,-1761
2016,10,28,23,5441,6581,4867,-1714
2016,10,29,0,5315,6519,4819,-1700
2016,10,29,1,5100,6217,4505,-1712
2016,10,29,2,4676,5778,4102,-1676
2016,10,29,3,4325,5327,3679,-1648
2016,10,29,4,3906,4810,3226,-1584
2016,10,29,5,3664,4301,2955,-1346
2016,10,29,6,3324,3975,2884,-1091
2016,10,29,7,3152,3770,2757,-1013
2016,10,29,8,3005,3653,2698,-955
2016,10,29,9,2964,3634,2622,-1012
2016,10,29,10,3010,3711,2676,-1035
2016,10,29,11,3169,3901,2820,-1081
2016,10,29,12,3370,4178,3053,-1125
2016,10,29,13,3664,4555,3338,-1217
2016,10,29,14,4153,5099,3791,-1308
2016,10,29,15,4501,5594,4217,-1377
2016,10,29,16,4904,6040,4560,-1480
2016,10,29,17,5174,6400,4855,-1545
2016,10,29,18,5476,6734,5152,-1582
2016,10,29,19,5694,6956,5377,-1579
2016,10,29,20,5865,7092,5528,-1564
2016,10,29,21,5837,7168,5604,-1564
2016,10,29,22,5839,7004,5437,-1567
2016,10,29,23,5610,6672,5096,-1576
2016,10,30,0,5307,6604,5002,-1602
2016,10,30,1,5014,6246,4738,-1508
2016,10,30,2,4612,5758,4352,-1406
2016,10,30,3,4279,5354,4032,-1322
2016,10,30,4,3943,4874,3601,-1273
2016,10,30,5,3542,4422,3282,-1140
2016,10,30,6,3242,4078,3030,-1048
2016,10,30,7,3069,3825,2809,-1016
2016,10,30,8,2950,3704,2750,-954
2016,10,30,9,2939,3652,2676,-976
2016,10,30,10,2929,3689,2701,-988
2016,10,30,11,3040,3841,2823,-1018
2016,10,30,12,3201,4074,3019,-1055
2016,10,30,13,3501,4501,3284,-1217
2016,10,30,14,3866,5121,3816,-1305
2016,10,30,15,4313,5650,4277,-1373
2016,10,30,16,4760,6182,4665,-1517
2016,10,30,17,4949,6682,5056,-1626
2016,10,30,18,5371,7144,5474,-1670
2016,10,30,19,5533,7487,5841,-1646
2016,10,30,20,5663,7720,6058,-1662
2016,10,30,21,5721,7792,6109,-1683
2016,10,30,22,5626,7626,5973,-1653
2016,10,30,23,5495,7217,5564,-1653
2016,10,31,0,5474,7150,5505,-1645
2016,10,31,1,5205,6734,5093,-1641
2016,10,31,2,4712,6049,4570,-1479
2016,10,31,3,4249,5453,4123,-1330
2016,10,31,4,3788,4764,3627,-1137
2016,10,31,5,3534,4261,3240,-1021
2016,10,31,6,3220,3888,2953,-935
2016,10,31,7,3032,3700,2825,-875
2016,10,31,8,2950,3597,2783,-814
2016,10,31,9,2980,3638,2795,-843
2016,10,31,10,3216,3955,3076,-879
2016,10,31,11,3648,4529,3476,-1053
2016,10,31,12,3916,4865,3763,-1102
2016,10,31,13,4011,4983,3858,-1125
2016,10,31,14,4316,5315,4094,-1221
2016,10,31,15,4717,5740,4447,-1293
2016,10,31,16,5048,6168,4751,-1417
2016,10,31,17,5360,6604,5082,-1522
2016,10,31,18,5598,7058,5492,-1566
2016,10,31,19,5831,7452,5850,-1602
2016,10,31,20,5930,7731,6135,-1596
2016,10,31,21,5960,7880,6246,-1634
2016,10,31,22,5843,7716,6100,-1616
2016,10,31,23,5656,7181,5685,-1496
2016,11,1,0,5618,6810,5353,-1457
2016,11,1,1,5349,6436,4954,-1482
2016,11,1,2,4890,6044,4631,-1413
2016,11,1,3,4389,5503,4215,-1288
2016,11,1,4,3913,4776,3652,-1124
2016,11,1,5,3394,4211,3215,-996
2016,11,1,6,3099,3880,2910,-970
2016,11,1,7,2927,3697,2770,-927
2016,11,1,8,2854,3588,2672,-916
2016,11,1,9,2898,3620,2679,-941
2016,11,1,10,3121,3906,2995,-911
2016,11,1,11,3600,4465,3383,-1082
2016,11,1,12,3919,4794,3693,-1101
2016,11,1,13,3986,4863,3767,-1096
2016,11,1,14,4248,5192,4027,-1165
2016,11,1,15,4512,5618,4367,-1251
2016,11,1,16,4894,6036,4723,-1313
2016,11,1,17,5256,6428,5009,-1419
2016,11,1,18,5531,6814,5304,-1510
2016,11,1,19,5808,7166,5668,-1498
2016,11,1,20,5993,7436,5909,-1527
2016,11,1,21,6071,7585,6071,-1514
2016,11,1,22,6031,7510,5974,-1536
2016,11,1,23,5846,7202,5684,-1518
2016,11,2,0,5810,7207,5638,-1569
2016,11,2,1,5546,6733,5178,-1555
2016,11,2,2,5041,6072,4662,-1410
2016,11,2,3,4558,5454,4147,-1307
2016,11,2,4,4073,4603,3376,-1227
2016,11,2,5,3579,4307,3177,-1130
2016,11,2,6,3287,3947,2891,-1056
2016,11,2,7,3111,3782,2745,-1037
2016,11,2,8,3033,3700,2668,-1032
2016,11,2,9,3089,3759,2711,-1048
2016,11,2,10,3304,4062,2918,-1144
2016,11,2,11,3777,4669,3427,-1242
2016,11,2,12,4082,5050,3858,-1192
2016,11,2,13,4144,5131,3925,-1206
2016,11,2,14,4408,5419,4169,-1250
2016,11,2,15,4717,5868,4556,-1312
2016,11,2,16,5117,6319,4912,-1407
2016,11,2,17,5281,6762,5242,-1520
2016,11,2,18,5555,7108,5511,-1597
2016,11,2,19,5780,7380,5766,-1614
2016,11,2,20,5870,7556,5990,-1566
2016,11,2,21,5846,7642,6089,-1553
2016,11,2,22,5637,7518,5973,-1545
2016,11,2,23,5455,7253,5703,-1550
2016,11,3,0,5510,7267,5652,-1615
2016,11,3,1,5303,6831,5273,-1558
2016,11,3,2,4832,6188,4739,-1449
2016,11,3,3,4387,5558,4245,-1313
2016,11,3,4,3919,4907,3639,-1268
2016,11,3,5,3557,4441,3308,-1133
2016,11,3,6,3299,4059,3095,-964
2016,11,3,7,3130,3827,2899,-928
2016,11,3,8,3056,3712,2823,-889
2016,11,3,9,3097,3731,2838,-893
2016,11,3,10,3314,4019,3043,-976
2016,11,3,11,3782,4564,3504,-1060
2016,11,3,12,4096,4908,3723,-1185
2016,11,3,13,4149,4947,3645,-1302
2016,11,3,14,4381,5212,3765,-1447
2016,11,3,15,4673,5605,4100,-1505
2016,11,3,16,5003,5989,4392,-1597
2016,11,3,17,5242,6365,4655,-1710
2016,11,3,18,5459,6727,4933,-1794
2016,11,3,19,5666,7038,5210,-1828
2016,11,3,20,5757,7294,5442,-1852
2016,11,3,21,5777,7367,5479,-1888
2016,11,3,22,5688,7240,5362,-1878
2016,11,3,23,5501,7003,5164,-1839
2016,11,4,0,5494,7019,5175,-1844
2016,11,4,1,5229,6666,4874,-1792
2016,11,4,2,4800,6054,4378,-1676
2016,11,4,3,4327,5445,3889,-1556
2016,11,4,4,3869,4791,3390,-1401
2016,11,4,5,3394,4251,3073,-1178
2016,11,4,6,3147,3920,2800,-1120
2016,11,4,7,2997,3677,2609,-1068
2016,11,4,8,2930,3559,2485,-1074
2016,11,4,9,2967,3582,2502,-1080
2016,11,4,10,3179,3861,2706,-1155
2016,11,4,11,3619,4436,3132,-1304
2016,11,4,12,3982,4799,3361,-1438
2016,11,4,13,4018,4925,3457,-1468
2016,11,4,14,4277,5199,3728,-1471
2016,11,4,15,4525,5588,4061,-1527
2016,11,4,16,4777,5934,4322,-1612
2016,11,4,17,5013,6332,4640,-1692
2016,11,4,18,5209,6754,4967,-1787
2016,11,4,19,5395,7131,5235,-1896
2016,11,4,20,5468,7402,5473,-1929
2016,11,4,21,5481,7484,5549,-1935
2016,11,4,22,5354,7312,5402,-1910
2016,11,4,23,5083,6923,5052,-1871
2016,11,5,0,5013,6781,4950,-1831
2016,11,5,1,4744,6400,4655,-1745
2016,11,5,2,4423,5926,4283,-1643
2016,11,5,3,4091,5473,3829,-1644
2016,11,5,4,3652,4985,3526,-1459
2016,11,5,5,3422,4534,3295,-1239
2016,11,5,6,3150,4174,2993,-1181
2016,11,5,7,2979,3922,2783,-1139
2016,11,5,8,2897,3745,2632,-1113
2016,11,5,9,2884,3671,2578,-1093
2016,11,5,10,2913,3728,2619,-1109
2016,11,5,11,3098,3891,2878,-1013
2016,11,5,12,3345,4122,3090,-1032
2016,11,5,13,3638,4488,3370,-1118
2016,11,5,14,4044,4986,3654,-1332
2016,11,5,15,4274,5370,3812,-1558
2016,11,5,16,4473,5684,4092,-1592
2016,11,5,17,4601,5964,4281,-1683
2016,11,5,18,4735,6213,4466,-1747
2016,11,5,19,4795,6355,4562,-1793
2016,11,5,20,4794,6428,4609,-1819
2016,11,5,21,4736,6416,4601,-1815
2016,11,5,22,4566,6230,4461,-1769
2016,11,5,23,4482,5941,4193,-1748
2016,11,6,0,4469,5929,4212,-1717
2016,11,6,1,4258,5599,3960,-1639
2016,11,6,2,3956,5176,3787,-1389
2016,11,6,3,3676,4819,3637,-1182
2016,11,6,4,3358,4370,3288,-1082
2016,11,6,5,3013,3965,3025,-940
2016,11,6,6,2787,3649,2755,-894
2016,11,6,7,2620,3457,2599,-858
2016,11,6,8,2576,3355,2475,-880
2016,11,6,9,2558,3310,2438,-872
2016,11,6,10,2588,3330,2449,-881
2016,11,6,11,2699,3415,2493,-922
2016,11,6,12,2911,3603,2636,-967
2016,11,6,13,3380,4023,2965,-1058
2016,11,6,14,3743,4563,3411,-1152
2016,11,6,15,4005,4973,3572,-1401
2016,11,6,16,4412,5284,3628,-1656
2016,11,6,17,4633,5587,3889,-1698
2016,11,6,18,4806,5869,4113,-1756
2016,11,6,19,4865,6050,4320,-1730
2016,11,6,20,4784,6165,4402,-1763
2016,11,6,21,4768,6163,4374,-1789
2016,11,6,22,4856,6099,4296,-1803
2016,11,6,23,4636,6122,4292,-1830
2016,11,7,0,4325,6314,4477,-1837
2016,11,7,1,3880,6043,4246,-1797
2016,11,7,2,3500,5658,3989,-1669
2016,11,7,3,3248,5111,3738,-1373
2016,11,7,4,-9999,4623,3488,-1544
2016,11,7,5,-9999,4126,3079,-1047
2016,11,7,6,2997,3760,2807,-953
2016,11,7,7,2813,3525,2611,-914
2016,11,7,8,2750,3390,2492,-898
2016,11,7,9,2722,3328,2445,-883
2016,11,7,10,2788,3410,2504,-906
2016,11,7,11,3062,3768,2775,-993
2016,11,7,12,3528,4339,3234,-1105
2016,11,7,13,3788,4645,3463,-1182
2016,11,7,14,4008,4898,3711,-1187
2016,11,7,15,4315,5190,3989,-1201
2016,11,7,16,4596,5507,4270,-1237
2016,11,7,17,4852,5731,4491,-1240
2016,11,7,18,5060,5888,4428,-1460
2016,11,7,19,5119,6037,4605,-1432
2016,11,7,20,5242,6091,4686,-1405
2016,11,7,21,5308,6128,4716,-1412
2016,11,7,22,5207,6089,4691,-1398
2016,11,7,23,5124,6072,4643,-1429
2016,11,8,0,5157,6328,4805,-1523
2016,11,8,1,4957,6083,4795,-1288
2016,11,8,2,4565,5750,4476,-1274
2016,11,8,3,4113,5190,3938,-1252
2016,11,8,4,3690,4668,3502,-1166
2016,11,8,5,3391,4119,3065,-1054
2016,11,8,6,3067,3729,2735,-994
2016,11,8,7,2866,3494,2547,-947
2016,11,8,8,2743,3358,2435,-923
2016,11,8,9,2748,3316,2408,-908
2016,11,8,10,2784,3375,2439,-936
2016,11,8,11,3027,3739,2771,-968
2016,11,8,12,3487,4331,3289,-1042
2016,11,8,13,3703,4623,3638,-985
2016,11,8,14,3912,4847,3889,-958
2016,11,8,15,4138,5131,4136,-995
2016,11,8,16,4389,5446,4391,-1055
2016,11,8,17,4671,5706,4620,-1086
2016,11,8,18,4849,5958,4703,-1255
2016,11,8,19,5052,6147,4954,-1193
2016,11,8,20,5183,6284,5086,-1198
2016,11,8,21,5198,6313,5042,-1271
2016,11,8,22,5113,6267,5014,-1253
2016,11,8,23,4981,6260,5025,-1235
2016,11,9,0,5150,6463,5184,-1279
2016,11,9,1,4923,6209,4977,-1232
2016,11,9,2,4589,5810,4667,-1143
2016,11,9,3,4196,5294,4279,-1015
2016,11,9,4,3790,4787,3891,-896
2016,11,9,5,3393,4271,3327,-944
2016,11,9,6,3021,3924,2989,-935
2016,11,9,7,2812,3669,2725,-944
2016,11,9,8,2727,3512,2553,-959
2016,11,9,9,2719,3429,2497,-932
2016,11,9,10,2787,3508,2541,-967
2016,11,9,11,3066,3828,2855,-973
2016,11,9,12,3503,4379,3381,-998
2016,11,9,13,3740,4683,3738,-945
2016,11,9,14,3923,4925,3938,-987
2016,11,9,15,4127,5167,4009,-1158
2016,11,9,16,4384,5375,4027,-1348
2016,11,9,17,4576,5535,4110,-1425
2016,11,9,18,4686,5699,4259,-1440
2016,11,9,19,4797,5751,4329,-1422
2016,11,9,20,4865,5754,4340,-1414
2016,11,9,21,4845,5771,4341,-1430
2016,11,9,22,4759,5797,4341,-1456
2016,11,9,23,4765,5980,4462,-1518
2016,11,10,0,4920,6191,4612,-1579
2016,11,10,1,4725,6012,4458,-1554
2016,11,10,2,4417,5706,4276,-1430
2016,11,10,3,4011,5221,3982,-1239
2016,11,10,4,3618,4713,3720,-993
2016,11,10,5,3245,4202,3210,-992
2016,11,10,6,2975,3801,2917,-884
2016,11,10,7,2782,3567,2655,-912
2016,11,10,8,2715,3429,2549,-880
2016,11,10,9,2748,3363,2458,-905
2016,11,10,10,2828,3455,2539,-916
2016,11,10,11,3091,3792,2862,-930
2016,11,10,12,3550,4384,3390,-994
2016,11,10,13,3756,4676,3660,-1016
2016,11,10,14,3926,4848,3826,-1022
2016,11,10,15,4052,5060,4037,-1023
2016,11,10,16,4221,5273,4259,-1014
2016,11,10,17,4322,5462,4428,-1034
2016,11,10,18,4421,5703,4628,-1075
2016,11,10,19,4471,5962,4851,-1111
2016,11,10,20,4555,6120,4978,-1142
2016,11,10,21,4536,6169,5020,-1149
2016,11,10,22,4482,6128,5000,-1128
2016,11,10,23,4589,5985,4852,-1133
2016,11,11,0,4687,6102,4879,-1223
2016,11,11,1,4568,5830,4668,-1162
2016,11,11,2,4302,5479,4382,-1097
2016,11,11,3,3913,5022,3950,-1072
2016,11,11,4,3593,4522,3543,-979
2016,11,11,5,3321,4041,3048,-993
2016,11,11,6,2942,3692,2760,-932
2016,11,11,7,2779,3471,2526,-945
2016,11,11,8,2651,3353,2374,-979
2016,11,11,9,2628,3328,2340,-988
2016,11,11,10,2755,3403,2439,-964
2016,11,11,11,2976,3734,2766,-968
2016,11,11,12,3489,4256,3194,-1062
2016,11,11,13,3782,4645,3592,-1053
2016,11,11,14,3939,4882,3785,-1097
2016,11,11,15,4108,5041,3962,-1079
2016,11,11,16,4221,5167,4112,-1055
2016,11,11,17,4395,5305,4258,-1047
2016,11,11,18,4480,5437,4376,-1061
2016,11,11,19,4558,5529,4459,-1070
2016,11,11,20,4617,5611,4529,-1082
2016,11,11,21,4668,5616,4542,-1074
2016,11,11,22,4571,5551,4486,-1065
2016,11,11,23,4597,5542,4444,-1098
2016,11,12,0,4676,5613,4463,-1150
2016,11,12,1,4356,5357,4255,-1102
2016,11,12,2,4098,5071,4024,-1047
2016,11,12,3,3789,4743,3754,-989
2016,11,12,4,3520,4385,3458,-927
2016,11,12,5,3255,3997,2998,-999
2016,11,12,6,2859,3728,2761,-967
2016,11,12,7,2686,3538,2615,-923
2016,11,12,8,2547,3407,2524,-883
2016,11,12,9,2562,3375,2527,-848
2016,11,12,10,2678,3407,2559,-848
2016,11,12,11,2777,3526,2616,-910
2016,11,12,12,3059,3789,2720,-1069
2016,11,12,13,3248,4121,2936,-1185
2016,11,12,14,3610,4543,3302,-1241
2016,11,12,15,3704,4796,3517,-1279
2016,11,12,16,3907,4898,3655,-1243
2016,11,12,17,3973,4951,3718,-1233
2016,11,12,18,4012,5065,3811,-1254
2016,11,12,19,4067,5188,3937,-1251
2016,11,12,20,4092,5292,4021,-1271
2016,11,12,21,4130,5347,4061,-1286
2016,11,12,22,4124,5298,4041,-1257
2016,11,12,23,4193,5291,4002,-1289
2016,11,13,0,4354,5423,4066,-1357
2016,11,13,1,4201,5165,3796,-1369
2016,11,13,2,3982,4910,3682,-1228
2016,11,13,3,3701,4577,3461,-1116
2016,11,13,4,3443,4228,3096,-1132
2016,11,13,5,3259,3896,2897,-999
2016,11,13,6,2929,3589,2721,-868
2016,11,13,7,2760,3394,2556,-838
2016,11,13,8,2623,3272,2491,-781
2016,11,13,9,2583,3222,2421,-801
2016,11,13,10,2605,3224,2422,-802
2016,11,13,11,2615,3326,2492,-834
2016,11,13,12,2841,3534,2551,-983
2016,11,13,13,2980,3834,2748,-1086
2016,11,13,14,3415,4331,3137,-1194
2016,11,13,15,3680,4760,3489,-1271
2016,11,13,16,3935,5030,3749,-1281
2016,11,13,17,4113,5240,3956,-1284
2016,11,13,18,4254,5480,4030,-1450
2016,11,13,19,4322,5743,4231,-1512
2016,11,13,20,4377,5923,4399,-1524
2016,11,13,21,4377,5976,4436,-1540
2016,11,13,22,4312,5923,4434,-1489
2016,11,13,23,4467,5950,4420,-1530
2016,11,14,0,4667,6100,4527,-1573
2016,11,14,1,4520,5852,4318,-1534
2016,11,14,2,4265,5553,4205,-1348
2016,11,14,3,3878,5050,3805,-1245
2016,11,14,4,3541,4590,3448,-1142
2016,11,14,5,3229,4092,3088,-1004
2016,11,14,6,2840,3745,2821,-924
2016,11,14,7,2662,3508,2596,-912
2016,11,14,8,2612,3409,2458,-951
2016,11,14,9,2605,3369,2479,-890
2016,11,14,10,2683,3473,2582,-891
2016,11,14,11,2956,3831,2817,-1014
2016,11,14,12,3392,4432,3236,-1196
2016,11,14,13,3647,4774,3560,-1214
2016,11,14,14,3810,4956,3723,-1233
2016,11,14,15,3919,5160,3905,-1255
2016,11,14,16,4057,5293,4049,-1244
2016,11,14,17,4155,5367,4110,-1257
2016,11,14,18,4259,5400,4143,-1257
2016,11,14,19,4279,5370,4138,-1232
2016,11,14,20,4323,5327,4099,-1228
2016,11,14,21,4319,5278,4049,-1229
2016,11,14,22,4345,5332,4065,-1267
2016,11,14,23,4534,5614,4250,-1364
2016,11,15,0,4690,5872,4423,-1449
2016,11,15,1,4527,5753,4336,-1417
2016,11,15,2,4291,5466,4106,-1360
2016,11,15,3,3904,5013,3772,-1241
2016,11,15,4,3531,4564,3401,-1163
2016,11,15,5,3153,4073,3044,-1029
2016,11,15,6,2816,3733,2796,-937
2016,11,15,7,2690,3522,2618,-904
2016,11,15,8,2658,3441,2509,-932
2016,11,15,9,2625,3411,2472,-939
2016,11,15,10,2750,3512,2532,-980
2016,11,15,11,3063,3882,2789,-1093
2016,11,15,12,3595,4525,3192,-1333
2016,11,15,13,3825,4804,3494,-1310
2016,11,15,14,3996,4919,3621,-1298
2016,11,15,15,4044,4984,3570,-1414
2016,11,15,16,4176,5027,3637,-1390
2016,11,15,17,4240,5030,3756,-1274
2016,11,15,18,4325,5054,3787,-1267
2016,11,15,19,4353,5086,3827,-1259
2016,11,15,20,4436,5100,3848,-1252
2016,11,15,21,4418,5181,3919,-1262
2016,11,15,22,4471,5247,4016,-1231
2016,11,15,23,4550,5434,4157,-1277
2016,11,16,0,4728,5711,4318,-1393
2016,11,16,1,4565,5600,4225,-1375
2016,11,16,2,4337,5367,4020,-1347
2016,11,16,3,3971,4981,3741,-1240
2016,11,16,4,3554,4476,3292,-1184
2016,11,16,5,3109,4036,3008,-1028
2016,11,16,6,2897,3702,2720,-982
2016,11,16,7,2793,3517,2508,-1009
2016,11,16,8,2693,3442,2421,-1021
2016,11,16,9,2749,3454,2403,-1051
2016,11,16,10,2848,3605,2503,-1102
2016,11,16,11,3164,3995,2786,-1209
2016,11,16,12,3699,4683,3266,-1417
2016,11,16,13,3929,4992,3653,-1339
2016,11,16,14,3953,5006,3679,-1327
2016,11,16,15,3984,5021,3734,-1287
2016,11,16,16,4061,5075,3832,-1243
2016,11,16,17,4127,5128,3826,-1302
2016,11,16,18,4203,5197,3864,-1333
2016,11,16,19,4218,5246,3936,-1310
2016,11,16,20,4240,5331,4003,-1328
2016,11,16,21,4281,5389,4035,-1354
2016,11,16,22,4322,5405,4120,-1285
2016,11,16,23,4435,5535,4260,-1275
2016,11,17,0,4634,5765,4409,-1356
2016,11,17,1,4481,5639,4365,-1274
2016,11,17,2,4243,5383,4100,-1283
2016,11,17,3,3951,4996,3808,-1188
2016,11,17,4,3607,4513,3310,-1203
2016,11,17,5,3261,4081,2962,-1119
2016,11,17,6,2901,3760,2713,-1047
2016,11,17,7,2701,3573,2605,-968
2016,11,17,8,2681,3506,2595,-911
2016,11,17,9,2738,3530,2604,-926
2016,11,17,10,2833,3680,2696,-984
2016,11,17,11,3140,4102,2935,-1167
2016,11,17,12,3702,4817,3494,-1323
2016,11,17,13,3951,5120,3842,-1278
2016,11,17,14,4023,5160,3934,-1226
2016,11,17,15,4007,5104,3857,-1247
2016,11,17,16,4114,5118,3930,-1188
2016,11,17,17,4165,5141,3943,-1198
2016,11,17,18,4225,5214,4024,-1190
2016,11,17,19,4240,5310,4116,-1194
2016,11,17,20,4296,5493,4257,-1236
2016,11,17,21,4333,5564,4365,-1199
2016,11,17,22,4451,5584,4421,-1163
2016,11,17,23,4505,5675,4504,-1171
2016,11,18,0,4699,5906,4621,-1285
2016,11,18,1,4565,5769,4522,-1247
2016,11,18,2,4355,5486,4292,-1194
2016,11,18,3,3986,5078,3925,-1153
2016,11,18,4,3630,4559,3441,-1118
2016,11,18,5,3288,4100,3000,-1100
2016,11,18,6,3007,3724,2695,-1029
2016,11,18,7,2827,3549,2630,-919
2016,11,18,8,2696,3457,2586,-871
2016,11,18,9,2665,3463,2574,-889
2016,11,18,10,2765,3598,2636,-962
2016,11,18,11,3012,4010,2821,-1189
2016,11,18,12,3538,4673,3328,-1345
2016,11,18,13,3811,5005,3763,-1242
2016,11,18,14,3950,5065,3809,-1256
2016,11,18,15,4039,5099,3897,-1202
2016,11,18,16,4172,5210,4004,-1206
2016,11,18,17,4231,5282,4104,-1178
2016,11,18,18,4342,5396,4191,-1205
2016,11,18,19,4492,5538,4371,-1167
2016,11,18,20,4566,5622,4502,-1120
2016,11,18,21,4682,5680,4534,-1146
2016,11,18,22,4640,5649,4545,-1104
2016,11,18,23,4654,5637,4504,-1133
2016,11,19,0,4849,5743,4575,-1168
2016,11,19,1,4607,5507,4330,-1177
2016,11,19,2,4361,5223,4166,-1057
2016,11,19,3,4021,4864,3764,-1100
2016,11,19,4,3693,4480,3350,-1130
2016,11,19,5,3392,4085,3114,-971
2016,11,19,6,3053,3769,2992,-777
2016,11,19,7,2844,3555,2818,-737
2016,11,19,8,2723,3452,2717,-735
2016,11,19,9,2723,3399,2668,-731
2016,11,19,10,2725,3449,2687,-762
2016,11,19,11,2832,3590,2768,-822
2016,11,19,12,3014,3864,2953,-911
2016,11,19,13,3258,4208,3189,-1019
2016,11,19,14,3657,4649,3569,-1080
2016,11,19,15,3883,4916,3865,-1051
2016,11,19,16,4035,5107,4095,-1012
2016,11,19,17,4164,5206,4062,-1144
2016,11,19,18,4266,5340,4164,-1176
2016,11,19,19,4403,5425,4186,-1239
2016,11,19,20,4446,5493,4221,-1272
2016,11,19,21,4475,5522,4172,-1350
2016,11,19,22,4538,5468,4157,-1311
2016,11,19,23,4507,5464,4119,-1345
2016,11,20,0,4576,5573,4200,-1373
2016,11,20,1,4436,5345,4007,-1338
2016,11,20,2,4175,5098,3738,-1360
2016,11,20,3,3809,4819,3580,-1239
2016,11,20,4,3543,4471,3258,-1213
2016,11,20,5,3224,4076,2956,-1120
2016,11,20,6,2938,3702,2787,-915
2016,11,20,7,2867,3470,2705,-765
2016,11,20,8,2864,3332,2587,-745
2016,11,20,9,2952,3324,2551,-773
2016,11,20,10,2960,3404,2591,-813
2016,11,20,11,3124,3599,2707,-892
2016,11,20,12,3251,3937,2919,-1018
2016,11,20,13,3603,4413,3359,-1054
2016,11,20,14,3946,4967,4006,-961
2016,11,20,15,4133,5185,4109,-1076
2016,11,20,16,4171,5165,3995,-1170
2016,11,20,17,3977,5060,3811,-1249
2016,11,20,18,3997,4967,3691,-1276
2016,11,20,19,3887,4895,3623,-1272
2016,11,20,20,3800,4837,3569,-1268
2016,11,20,21,3765,4828,3578,-1250
2016,11,20,22,3812,4888,3633,-1255
2016,11,20,23,4067,5170,3783,-1387
2016,11,21,0,4437,5556,4070,-1486
2016,11,21,1,4419,5525,4028,-1497
2016,11,21,2,4348,5400,4038,-1362
2016,11,21,3,4180,5124,3964,-1160
2016,11,21,4,3974,4812,3788,-1024
2016,11,21,5,3703,4496,3465,-1031
2016,11,21,6,3753,4282,3194,-1088
2016,11,21,7,3730,4198,3086,-1112
2016,11,21,8,3820,4181,3032,-1149
2016,11,21,9,3960,4305,3115,-1190
2016,11,21,10,4131,4553,3317,-1236
2016,11,21,11,4659,5121,3567,-1554
2016,11,21,12,5283,5957,4051,-1906
2016,11,21,13,5591,6510,4356,-2154
2016,11,21,14,5393,6425,4360,-2065
2016,11,21,15,5067,6107,4237,-1870
2016,11,21,16,4840,5759,4160,-1599
2016,11,21,17,4491,5487,3919,-1568
2016,11,21,18,4296,5283,3726,-1557
2016,11,21,19,4180,5122,3633,-1489
2016,11,21,20,4102,5024,3609,-1415
2016,11,21,21,4038,4995,3591,-1404
2016,11,21,22,4070,5080,3608,-1472
2016,11,21,23,4359,5471,3625,-1846
2016,11,22,0,4669,5947,3943,-2004
2016,11,22,1,4650,5984,3985,-1999
2016,11,22,2,4533,5886,3890,-1996
2016,11,22,3,4311,5667,3793,-1874
2016,11,22,4,4025,5331,3499,-1832
2016,11,22,5,3767,4975,3364,-1611
2016,11,22,6,3623,4770,3190,-1580
2016,11,22,7,3557,4679,3130,-1549
2016,11,22,8,3614,4722,3099,-1623
2016,11,22,9,3676,4820,3167,-1653
2016,11,22,10,3842,5087,3396,-1691
2016,11,22,11,4231,5601,3653,-1948
2016,11,22,12,4840,6352,4167,-2185
2016,11,22,13,5094,6763,4534,-2229
2016,11,22,14,4913,6505,4366,-2139
2016,11,22,15,4660,6054,4296,-1758
2016,11,22,16,4479,5657,4187,-1470
2016,11,22,17,4334,5358,3994,-1364
2016,11,22,18,4210,5183,3826,-1357
2016,11,22,19,4105,5097,3754,-1343
2016,11,22,20,4087,5039,3708,-1331
2016,11,22,21,4063,5034,3716,-1318
2016,11,22,22,4072,5100,3766,-1334
2016,11,22,23,4313,5329,3991,-1338
2016,11,23,0,4559,5683,4221,-1462
2016,11,23,1,4418,5570,4159,-1411
2016,11,23,2,4332,5380,3970,-1410
2016,11,23,3,4077,5066,3714,-1352
2016,11,23,4,3744,4679,3407,-1272
2016,11,23,5,3384,4295,3091,-1204
2016,11,23,6,3159,3962,2898,-1064
2016,11,23,7,3032,3817,2774,-1043
2016,11,23,8,2939,3745,2700,-1045
2016,11,23,9,2940,3778,2714,-1064
2016,11,23,10,2984,3909,2805,-1104
2016,11,23,11,3166,4243,3033,-1210
2016,11,23,12,3553,4748,3338,-1410
2016,11,23,13,3823,5096,3623,-1473
2016,11,23,14,4065,5240,3814,-1426
2016,11,23,15,4212,5279,3903,-1376
2016,11,23,16,4311,5347,4023,-1324
2016,11,23,17,4389,5391,4080,-1311
2016,11,23,18,4366,5438,4109,-1329
2016,11,23,19,4390,5498,4191,-1307
2016,11,23,20,4317,5534,4221,-1313
2016,11,23,21,4295,5514,4187,-1327
2016,11,23,22,4286,5505,4192,-1313
2016,11,23,23,4519,5669,4282,-1387
2016,11,24,0,4714,5888,4435,-1453
2016,11,24,1,4497,5718,4313,-1405
2016,11,24,2,4344,5453,4071,-1382
2016,11,24,3,4022,5134,3834,-1300
2016,11,24,4,3752,4723,3490,-1233
2016,11,24,5,3377,4269,3134,-1135
2016,11,24,6,2974,3870,2850,-1020
2016,11,24,7,2710,3611,2801,-810
2016,11,24,8,2602,3428,2654,-774
2016,11,24,9,2507,3363,2591,-772
2016,11,24,10,2483,3390,2594,-796
2016,11,24,11,2525,3537,2706,-831
2016,11,24,12,2684,3786,2817,-969
2016,11,24,13,2941,4166,3045,-1121
2016,11,24,14,3411,4805,3393,-1412
2016,11,24,15,3884,5349,3841,-1508
2016,11,24,16,4280,5813,4262,-1551
2016,11,24,17,4592,6164,4411,-1753
2016,11,24,18,4733,6367,4612,-1755
2016,11,24,19,4776,6370,4627,-1743
2016,11,24,20,4791,6308,4591,-1717
2016,11,24,21,4563,6124,4626,-1498
2016,11,24,22,4311,5769,4382,-1387
2016,11,24,23,4070,5443,4092,-1351
2016,11,25,0,4150,5396,4042,-1354
2016,11,25,1,3997,5149,3851,-1298
2016,11,25,2,3802,4914,3641,-1273
2016,11,25,3,3603,4646,3551,-1095
2016,11,25,4,3419,4337,3304,-1033
2016,11,25,5,3195,3987,3098,-889
2016,11,25,6,2937,3695,2908,-787
2016,11,25,7,2772,3461,2731,-730
2016,11,25,8,2669,3342,2617,-725
2016,11,25,9,2596,3292,2573,-719
2016,11,25,10,2613,3304,2570,-734
2016,11,25,11,2689,3467,2605,-862
2016,11,25,12,2893,3711,2766,-945
2016,11,25,13,3053,3957,2852,-1105
2016,11,25,14,3365,4386,3192,-1194
2016,11,25,15,3781,4789,3535,-1254
2016,11,25,16,4084,5133,3855,-1278
2016,11,25,17,4243,5407,4043,-1364
2016,11,25,18,4428,5599,4157,-1442
2016,11,25,19,4629,5740,4294,-1446
2016,11,25,20,4692,5828,4367,-1461
2016,11,25,21,4722,5842,4386,-1456
2016,11,25,22,4634,5768,4331,-1437
2016,11,25,23,4582,5703,4235,-1468
2016,11,26,0,4649,5788,4342,-1446
2016,11,26,1,4586,5516,4113,-1403
2016,11,26,2,4316,5246,3892,-1354
2016,11,26,3,4034,4937,3768,-1169
2016,11,26,4,3766,4563,3468,-1095
2016,11,26,5,3435,4159,3220,-939
2016,11,26,6,3099,3801,2978,-823
2016,11,26,7,2865,3544,2778,-766
2016,11,26,8,2740,3387,2665,-722
2016,11,26,9,2673,3314,2568,-746
2016,11,26,10,2664,3321,2559,-762
2016,11,26,11,2693,3420,2640,-780
2016,11,26,12,2794,3625,2738,-887
2016,11,26,13,2931,3850,2820,-1030
2016,11,26,14,3391,4331,3119,-1212
2016,11,26,15,3769,4740,3464,-1276
2016,11,26,16,4006,5023,3712,-1311
2016,11,26,17,4178,5191,3866,-1325
2016,11,26,18,4327,5312,3962,-1350
2016,11,26,19,4416,5360,4030,-1330
2016,11,26,20,4475,5337,4004,-1333
2016,11,26,21,4469,5245,3938,-1307
2016,11,26,22,4360,5174,3874,-1300
2016,11,26,23,4410,5253,3914,-1339
2016,11,27,0,4516,5420,4030,-1390
2016,11,27,1,4383,5222,3830,-1392
2016,11,27,2,4128,4936,3612,-1324
2016,11,27,3,3834,4674,3542,-1132
2016,11,27,4,3576,4351,3278,-1073
2016,11,27,5,3256,3995,3091,-904
2016,11,27,6,2976,3711,2852,-859
2016,11,27,7,2756,3489,2664,-825
2016,11,27,8,2578,3382,2566,-816
2016,11,27,9,2579,3361,2539,-822
2016,11,27,10,2642,3407,2702,-705
2016,11,27,11,2739,3536,2783,-753
2016,11,27,12,2915,3791,2763,-1028
2016,11,27,13,3124,4106,2910,-1196
2016,11,27,14,3497,4540,3118,-1422
2016,11,27,15,3681,4804,3370,-1434
2016,11,27,16,3799,4917,3523,-1394
2016,11,27,17,3944,4964,3625,-1339
2016,11,27,18,4051,5052,3697,-1355
2016,11,27,19,4104,5094,3739,-1355
2016,11,27,20,4149,5146,3784,-1362
2016,11,27,21,4186,5172,3809,-1363
2016,11,27,22,4194,5174,3820,-1354
2016,11,27,23,4335,5370,3942,-1428
2016,11,28,0,4499,5662,4156,-1506
2016,11,28,1,4371,5509,4149,-1360
2016,11,28,2,4122,5232,3843,-1389
2016,11,28,3,3786,4828,3665,-1163
2016,11,28,4,3457,4369,3307,-1062
2016,11,28,5,3155,3903,3032,-871
2016,11,28,6,2847,3536,2748,-788
2016,11,28,7,2685,3342,2588,-754
2016,11,28,8,2558,3255,2494,-761
2016,11,28,9,2516,3232,2480,-752
2016,11,28,10,2629,3387,2585,-802
2016,11,28,11,2935,3809,2895,-914
2016,11,28,12,3446,4473,3390,-1083
2016,11,28,13,3747,4795,3584,-1211
2016,11,28,14,3922,4898,3567,-1331
2016,11,28,15,4106,5008,3707,-1301
2016,11,28,16,4248,5141,3871,-1270
2016,11,28,17,4354,5261,3976,-1285
2016,11,28,18,4520,5385,4055,-1330
2016,11,28,19,4766,5442,4244,-1198
2016,11,28,20,4867,5493,4210,-1283
2016,11,28,21,4876,5476,4164,-1312
2016,11,28,22,4865,5509,4185,-1324
2016,11,28,23,4788,5788,4324,-1464
2016,11,29,0,5034,6120,4580,-1540
2016,11,29,1,4971,5993,4471,-1522
2016,11,29,2,4686,5697,4223,-1474
2016,11,29,3,4306,5249,4026,-1223
2016,11,29,4,3891,4723,3606,-1117
2016,11,29,5,3489,4210,3229,-981
2016,11,29,6,3157,3848,3007,-841
2016,11,29,7,2962,3616,2864,-752
2016,11,29,8,2835,3489,2762,-727
2016,11,29,9,2760,3434,2712,-722
2016,11,29,10,2819,3496,2765,-731
2016,11,29,11,3100,3837,3007,-830
2016,11,29,12,3558,4425,3413,-1012
2016,11,29,13,3785,4748,3687,-1061
2016,11,29,14,4014,4952,3725,-1227
2016,11,29,15,4278,5241,3798,-1443
2016,11,29,16,4525,5575,3914,-1661
2016,11,29,17,4817,5886,4042,-1844
2016,11,29,18,5049,6142,4214,-1928
2016,11,29,19,5221,6314,4394,-1920
2016,11,29,20,5360,6450,4557,-1893
2016,11,29,21,5416,6517,4614,-1903
2016,11,29,22,5388,6420,4552,-1868
2016,11,29,23,5363,6567,4588,-1979
2016,11,30,0,5394,6804,4802,-2002
2016,11,30,1,5234,6591,4575,-2016
2016,11,30,2,4997,6215,4223,-1992
2016,11,30,3,4599,5718,4037,-1681
2016,11,30,4,4158,5158,3677,-1481
2016,11,30,5,3733,4576,3401,-1175
2016,11,30,6,3382,4109,3022,-1087
2016,11,30,7,3134,3857,2843,-1014
2016,11,30,8,3005,3683,2703,-980
2016,11,30,9,2921,3618,2642,-976
2016,11,30,10,2939,3655,2667,-988
2016,11,30,11,3225,3982,2880,-1102
2016,11,30,12,3710,4592,3303,-1289
2016,11,30,13,3940,4921,3622,-1299
2016,11,30,14,4160,5187,3841,-1346
2016,11,30,15,4378,5548,4008,-1540
2016,11,30,16,4676,5956,4200,-1756
2016,11,30,17,4995,6280,4474,-1806
2016,11,30,18,5251,6493,4598,-1895
2016,11,30,19,5467,6589,4784,-1805
2016,11,30,20,5644,6597,4816,-1781
2016,11,30,21,5681,6571,4786,-1785
2016,11,30,22,5658,6508,4695,-1813
2016,11,30,23,5651,6630,4743,-1887
2016,12,1,0,5597,6832,4886,-1946
2016,12,1,1,5404,6636,4720,-1916
2016,12,1,2,5126,6291,4351,-1940
2016,12,1,3,4722,5838,4029,-1809
2016,12,1,4,4282,5255,3691,-1564
2016,12,1,5,3788,4653,3337,-1316
2016,12,1,6,3391,4177,3033,-1144
2016,12,1,7,3177,3914,2909,-1005
2016,12,1,8,3036,3765,2828,-937
2016,12,1,9,2959,3707,2822,-885
2016,12,1,10,2978,3757,2809,-948
2016,12,1,11,3192,4100,3052,-1048
2016,12,1,12,3588,4702,3442,-1260
2016,12,1,13,3792,5035,3777,-1258
2016,12,1,14,3911,5299,3969,-1330
2016,12,1,15,4140,5611,4111,-1500
2016,12,1,16,4430,5972,4300,-1672
2016,12,1,17,4626,6192,4559,-1633
2016,12,1,18,4827,6349,4589,-1760
2016,12,1,19,4925,6540,4771,-1769
2016,12,1,20,5001,6474,4725,-1749
2016,12,1,21,5001,6444,4680,-1764
2016,12,1,22,4924,6343,4549,-1794
2016,12,1,23,4796,6414,4554,-1860
2016,12,2,0,5069,6640,4684,-1956
2016,12,2,1,4898,6404,4496,-1908
2016,12,2,2,4641,6068,4213,-1855
2016,12,2,3,4273,5612,3938,-1674
2016,12,2,4,3945,5037,3617,-1420
2016,12,2,5,3531,4464,3216,-1248
2016,12,2,6,3134,4033,2929,-1104
2016,12,2,7,2901,3719,2750,-969
2016,12,2,8,2719,3576,2722,-854
2016,12,2,9,2689,3516,2719,-797
2016,12,2,10,2732,3612,2763,-849
2016,12,2,11,2873,3965,2961,-1004
2016,12,2,12,3461,4588,3442,-1146
2016,12,2,13,3720,4911,3758,-1153
2016,12,2,14,3918,5030,3919,-1111
2016,12,2,15,4071,5101,3988,-1113
2016,12,2,16,4216,5167,4075,-1092
2016,12,2,17,4310,5175,4118,-1057
2016,12,2,18,4411,5205,4172,-1033
2016,12,2,19,4532,5259,4260,-999
2016,12,2,20,4546,5316,4291,-1025
2016,12,2,21,4525,5334,4289,-1045
2016,12,2,22,4505,5350,4307,-1043
2016,12,2,23,4641,5493,4339,-1154
2016,12,3,0,4727,5721,4482,-1239
2016,12,3,1,4459,5561,4326,-1235
2016,12,3,2,4282,5378,4172,-1206
2016,12,3,3,4010,5113,3939,-1174
2016,12,3,4,3733,4764,3660,-1104
2016,12,3,5,3360,4340,3281,-1059
2016,12,3,6,3037,4014,2984,-1030
2016,12,3,7,2861,3781,2790,-991
2016,12,3,8,2705,3723,2756,-967
2016,12,3,9,2680,3695,2705,-990
2016,12,3,10,2713,3714,2713,-1001
2016,12,3,11,2790,3852,2811,-1041
2016,12,3,12,3022,4152,3022,-1130
2016,12,3,13,3181,4512,3321,-1191
2016,12,3,14,3549,4900,3658,-1242
2016,12,3,15,3775,5064,3845,-1219
2016,12,3,16,3881,5121,3965,-1156
2016,12,3,17,3949,5123,3999,-1124
2016,12,3,18,3995,5146,4055,-1091
2016,12,3,19,3991,5196,4109,-1087
2016,12,3,20,4039,5242,4163,-1079
2016,12,3,21,4032,5274,4197,-1077
2016,12,3,22,4070,5251,4139,-1112
2016,12,3,23,4273,5346,4164,-1182
2016,12,4,0,4453,5581,4363,-1218
2016,12,4,1,4238,5400,4223,-1177
2016,12,4,2,4075,5192,4049,-1143
2016,12,4,3,3835,4930,3841,-1089
2016,12,4,4,3577,4599,3566,-1033
2016,12,4,5,3301,0,3566,-958
2016,12,4,6,3052,3848,2939,-909
2016,12,4,7,2837,3611,2674,-937
2016,12,4,8,2711,3480,2566,-914
2016,12,4,9,2663,3410,2505,-905
2016,12,4,10,2652,3411,2495,-916
2016,12,4,11,2740,3503,2541,-962
2016,12,4,12,2807,3732,2710,-1022
2016,12,4,13,2975,4010,2943,-1067
2016,12,4,14,3320,4460,3245,-1215
2016,12,4,15,3779,4857,3606,-1251
2016,12,4,16,4009,5111,3755,-1356
2016,12,4,17,4208,5335,3937,-1398
2016,12,4,18,4334,5616,4149,-1467
2016,12,4,19,4482,5831,4342,-1489
2016,12,4,20,4607,6023,4476,-1547
2016,12,4,21,4601,6160,4569,-1591
2016,12,4,22,4529,6105,4527,-1578
2016,12,4,23,4613,6238,4597,-1641
2016,12,5,0,4789,6491,4796,-1695
2016,12,5,1,4664,6269,4647,-1622
2016,12,5,2,4456,5954,4410,-1544
2016,12,5,3,4125,5495,4074,-1421
2016,12,5,4,3787,4892,3574,-1318
2016,12,5,5,3437,4319,3087,-1232
2016,12,5,6,3178,3927,2848,-1079
2016,12,5,7,3002,3663,2647,-1016
2016,12,5,8,2898,3534,2532,-1002
2016,12,5,9,2843,3477,2485,-992
2016,12,5,10,2895,3562,2532,-1030
2016,12,5,11,3139,3920,2770,-1150
2016,12,5,12,3581,4551,3302,-1249
2016,12,5,13,3835,4821,3599,-1222
2016,12,5,14,4032,5066,3759,-1307
2016,12,5,15,4373,5454,3932,-1522
2016,12,5,16,4755,5838,4070,-1768
2016,12,5,17,5032,6210,4240,-1970
2016,12,5,18,5250,6538,4507,-2031
2016,12,5,19,5492,6796,4802,-1994
2016,12,5,20,5619,6950,4936,-2014
2016,12,5,21,5634,6996,5020,-1976
2016,12,5,22,5564,6901,4978,-1923
2016,12,5,23,5631,7106,5089,-2017
2016,12,6,0,5829,7446,5352,-2094
2016,12,6,1,5666,7253,5225,-2028
2016,12,6,2,5286,6909,5079,-1830
2016,12,6,3,4883,6431,4801,-1630
2016,12,6,4,4439,5821,4371,-1450
2016,12,6,5,3978,5168,3829,-1339
2016,12,6,6,3516,4649,3405,-1244
2016,12,6,7,3269,4336,3178,-1158
2016,12,6,8,3110,4170,3055,-1115
2016,12,6,9,3039,4109,3010,-1099
2016,12,6,10,3089,4189,3071,-1118
2016,12,6,11,3330,4548,3320,-1228
2016,12,6,12,3800,5198,3836,-1362
2016,12,6,13,4135,5548,4172,-1376
2016,12,6,14,4259,5798,4308,-1490
2016,12,6,15,4543,6163,4610,-1553
2016,12,6,16,4869,6485,4856,-1629
2016,12,6,17,5036,6622,5198,-1424
2016,12,6,18,5165,6639,5074,-1565
2016,12,6,19,5299,6508,5002,-1506
2016,12,6,20,5346,6454,4960,-1494
2016,12,6,21,5333,6454,4947,-1507
2016,12,6,22,5275,6418,4930,-1488
2016,12,6,23,5283,6520,4981,-1539
2016,12,7,0,5460,6816,5248,-1568
2016,12,7,1,5369,6618,5118,-1500
2016,12,7,2,5088,6185,4688,-1497
2016,12,7,3,4688,5718,4266,-1452
2016,12,7,4,4205,5081,3827,-1254
2016,12,7,5,3706,4439,3322,-1117
2016,12,7,6,3516,3973,3089,-884
2016,12,7,7,3269,3698,2880,-818
2016,12,7,8,3110,3557,2759,-798
2016,12,7,9,3039,3461,2673,-788
2016,12,7,10,3089,3535,2718,-817
2016,12,7,11,3330,3854,2931,-923
2016,12,7,12,3800,4490,3419,-1071
2016,12,7,13,4135,4746,3679,-1067
2016,12,7,14,4259,4869,3794,-1075
2016,12,7,15,4543,5074,3985,-1089
2016,12,7,16,4869,5274,4185,-1089
2016,12,7,17,5036,5434,4315,-1119
2016,12,7,18,5165,5645,4473,-1172
2016,12,7,19,5299,5819,4620,-1199
2016,12,7,20,5346,5970,4737,-1233
2016,12,7,21,5333,6019,4783,-1236
2016,12,7,22,5275,5963,4744,-1219
2016,12,7,23,5283,6054,4775,-1279
2016,12,8,0,5460,6345,4975,-1370
2016,12,8,1,5369,6151,4806,-1345
2016,12,8,2,5088,5866,4561,-1305
2016,12,8,3,4688,5418,4226,-1192
2016,12,8,4,4205,4852,3774,-1078
2016,12,8,5,3706,4259,3292,-967
2016,12,8,6,3097,3873,2995,-878
2016,12,8,7,2921,3644,2799,-845
2016,12,8,8,2852,3535,2714,-821
2016,12,8,9,2891,3500,2662,-838
2016,12,8,10,2988,3608,2728,-880
2016,12,8,11,3324,3977,2966,-1011
2016,12,8,12,3951,4673,3505,-1168
2016,12,8,13,4274,4977,3805,-1172
2016,12,8,14,4370,5034,3880,-1154
2016,12,8,15,4382,5095,3992,-1103
2016,12,8,16,4440,5147,4054,-1093
2016,12,8,17,4438,5185,4095,-1090
2016,12,8,18,4263,5195,4128,-1067
2016,12,8,19,4259,5232,4160,-1072
2016,12,8,20,4218,5185,4160,-1025
2016,12,8,21,4138,5200,4155,-1045
2016,12,8,22,4209,5276,4205,-1071
2016,12,8,23,4579,5684,4485,-1199
2016,12,9,0,4948,5984,4700,-1284
2016,12,9,1,4871,5903,4615,-1288
2016,12,9,2,4776,5710,4437,-1273
2016,12,9,3,4609,5345,4156,-1189
2016,12,9,4,4392,4825,3750,-1075
2016,12,9,5,4089,4292,3294,-998
2016,12,9,6,3046,3936,3051,-885
2016,12,9,7,2896,3723,2869,-854
2016,12,9,8,2812,3639,2784,-855
2016,12,9,9,2900,3654,2780,-874
2016,12,9,10,3041,3789,2874,-915
2016,12,9,11,3460,4197,3136,-1061
2016,12,9,12,4041,4948,3709,-1239
2016,12,9,13,4413,5402,4078,-1324
2016,12,9,14,4432,5593,4253,-1340
2016,12,9,15,4381,5747,4380,-1367
2016,12,9,16,4507,5833,4471,-1362
2016,12,9,17,4470,5763,4454,-1309
2016,12,9,18,4402,5551,4320,-1231
2016,12,9,19,4371,5358,4213,-1145
2016,12,9,20,4320,5191,4100,-1091
2016,12,9,21,4305,5149,4059,-1090
2016,12,9,22,4380,5263,4121,-1142
2016,12,9,23,4700,5777,4455,-1322
2016,12,10,0,5058,6139,4684,-1455
2016,12,10,1,5063,6104,4640,-1464
2016,12,10,2,4918,6036,4562,-1474
2016,12,10,3,4734,5854,4411,-1443
2016,12,10,4,4468,5549,4180,-1369
2016,12,10,5,4243,5179,3910,-1269
2016,12,10,6,3898,4895,3704,-1191
2016,12,10,7,3782,4727,3558,-1169
2016,12,10,8,3801,4667,3497,-1170
2016,12,10,9,3862,4672,3490,-1182
2016,12,10,10,3992,4785,3569,-1216
2016,12,10,11,4091,5012,3704,-1308
2016,12,10,12,4326,5413,3988,-1425
2016,12,10,13,4745,5859,4390,-1469
2016,12,10,14,4949,6205,4742,-1463
2016,12,10,15,4731,6110,4667,-1443
2016,12,10,16,4563,5797,4401,-1396
2016,12,10,17,4188,5466,4186,-1280
2016,12,10,18,4073,5228,3997,-1231
2016,12,10,19,4083,5028,3876,-1152
2016,12,10,20,4069,4937,3829,-1108
2016,12,10,21,3984,4889,3802,-1087
2016,12,10,22,3906,4925,3827,-1098
2016,12,10,23,4202,5191,3994,-1197
2016,12,11,0,4366,4788,3486,-1302
2016,12,11,1,4150,5417,4133,-1284
2016,12,11,2,4079,5312,4046,-1266
2016,12,11,3,3915,5133,3895,-1238
2016,12,11,4,3715,4855,3653,-1202
2016,12,11,5,3363,4516,3426,-1090
2016,12,11,6,3162,4209,3179,-1030
2016,12,11,7,3005,4043,3026,-1017
2016,12,11,8,2940,3969,2972,-997
2016,12,11,9,2891,3963,2958,-1005
2016,12,11,10,2883,4008,2980,-1028
2016,12,11,11,2975,4177,3107,-1070
2016,12,11,12,3187,4444,3295,-1149
2016,12,11,13,3314,4770,3495,-1275
2016,12,11,14,3649,5116,3792,-1324
2016,12,11,15,3843,5237,3928,-1309
2016,12,11,16,3953,5170,3939,-1231
2016,12,11,17,4079,5138,3942,-1196
2016,12,11,18,4063,5142,3960,-1182
2016,12,11,19,4069,5110,3941,-1169
2016,12,11,20,4156,5061,3906,-1155
2016,12,11,21,4182,5054,3896,-1158
2016,12,11,22,4175,5145,3971,-1174
2016,12,11,23,4288,5520,4248,-1272
2016,12,12,0,4636,5835,4416,-1419
2016,12,12,1,4535,5752,4360,-1392
2016,12,12,2,4324,5575,4238,-1337
2016,12,12,3,4020,5207,4041,-1166
2016,12,12,4,3692,4731,3685,-1046
2016,12,12,5,3281,4176,3301,-875
2016,12,12,6,2929,3770,2958,-812
2016,12,12,7,2726,3506,2729,-777
2016,12,12,8,2631,3375,2621,-754
2016,12,12,9,2639,3347,2591,-756
2016,12,12,10,2664,3459,2676,-783
2016,12,12,11,3001,3831,2942,-889
2016,12,12,12,3484,4467,3438,-1029
2016,12,12,13,3742,4807,3704,-1103
2016,12,12,14,3858,4931,3804,-1127
2016,12,12,15,4045,5150,3976,-1174
2016,12,12,16,4232,5387,3966,-1421
2016,12,12,17,4461,5620,4077,-1543
2016,12,12,18,4610,5812,4124,-1688
2016,12,12,19,4696,5982,4270,-1712
2016,12,12,20,4807,6101,4375,-1726
2016,12,12,21,4798,6214,4332,-1882
2016,12,12,22,4750,6210,4329,-1881
2016,12,12,23,4884,6345,4389,-1956
2016,12,13,0,5122,6695,4643,-2052
2016,12,13,1,4967,6523,4519,-2004
2016,12,13,2,4792,6175,4380,-1795
2016,12,13,3,4406,5688,4006,-1682
2016,12,13,4,3982,5044,3576,-1468
2016,12,13,5,3508,4418,3324,-1094
2016,12,13,6,3227,3931,2967,-964
2016,12,13,7,2934,3632,2724,-908
2016,12,13,8,2810,3478,2594,-884
2016,12,13,9,2768,3405,2528,-877
2016,12,13,10,2760,3490,2578,-912
2016,12,13,11,3011,3848,2763,-1085
2016,12,13,12,3582,4487,3241,-1246
2016,12,13,13,3828,4784,3594,-1190
2016,12,13,14,3943,4902,3664,-1238
2016,12,13,15,4174,5136,3892,-1244
2016,12,13,16,4441,5458,3960,-1498
2016,12,13,17,4702,5739,4088,-1651
2016,12,13,18,4856,6033,4305,-1728
2016,12,13,19,5032,6291,4524,-1767
2016,12,13,20,5105,6465,4677,-1788
2016,12,13,21,5148,6554,4807,-1747
2016,12,13,22,5155,6508,4819,-1689
2016,12,13,23,5177,6549,4815,-1734
2016,12,14,0,5395,6771,5027,-1744
2016,12,14,1,5236,6542,4832,-1710
2016,12,14,2,4944,6209,4514,-1695
2016,12,14,3,4555,5709,4013,-1696
2016,12,14,4,4092,5099,3593,-1506
2016,12,14,5,3588,4472,3244,-1228
2016,12,14,6,3189,4008,2953,-1055
2016,12,14,7,2934,3722,2800,-922
2016,12,14,8,2824,3571,2685,-886
2016,12,14,9,2764,3497,2593,-904
2016,12,14,10,2779,3566,2715,-851
2016,12,14,11,3046,3902,2945,-957
2016,12,14,12,3512,4469,3372,-1097
2016,12,14,13,3745,4780,3714,-1066
2016,12,14,14,3861,4899,3854,-1045
2016,12,14,15,4067,5082,4012,-1070
2016,12,14,16,4305,5351,4233,-1118
2016,12,14,17,4554,5639,4537,-1102
2016,12,14,18,4612,5915,4800,-1115
2016,12,14,19,4732,6159,5012,-1147
2016,12,14,20,4797,6313,5109,-1204
2016,12,14,21,4830,6330,5086,-1244
2016,12,14,22,4787,6292,5052,-1240
2016,12,14,23,4902,6442,5219,-1223
2016,12,15,0,5147,6693,5438,-1255
2016,12,15,1,4990,6549,5322,-1227
2016,12,15,2,4749,6242,5003,-1239
2016,12,15,3,4394,5801,4627,-1174
2016,12,15,4,3951,5187,4118,-1069
2016,12,15,5,3470,4575,3527,-1048
2016,12,15,6,3141,4119,3155,-964
2016,12,15,7,2877,3834,2926,-908
2016,12,15,8,2747,3696,2811,-885
2016,12,15,9,2716,3669,2792,-877
2016,12,15,10,2773,3744,2893,-851
2016,12,15,11,3030,4054,3155,-899
2016,12,15,12,3511,4647,3620,-1027
2016,12,15,13,3772,4917,3839,-1078
2016,12,15,14,3887,5043,4011,-1032
2016,12,15,15,4036,5224,4172,-1052
2016,12,15,16,4198,5371,4315,-1056
2016,12,15,17,4297,5518,4457,-1061
2016,12,15,18,4312,5600,4603,-997
2016,12,15,19,4351,5720,4763,-957
2016,12,15,20,4323,5815,4777,-1038
2016,12,15,21,4292,5807,4766,-1041
2016,12,15,22,4305,5748,4750,-998
2016,12,15,23,4534,5860,4780,-1080
2016,12,16,0,4705,6147,5035,-1112
2016,12,16,1,4525,5972,4854,-1118
2016,12,16,2,4385,5775,4651,-1124
2016,12,16,3,4091,5403,4303,-1100
2016,12,16,4,3735,4900,3785,-1115
2016,12,16,5,3317,4332,3333,-999
2016,12,16,6,3094,3926,3025,-901
2016,12,16,7,2912,3723,2844,-879
2016,12,16,8,2842,3651,2868,-783
2016,12,16,9,2818,3662,2867,-795
2016,12,16,10,2929,3821,2965,-856
2016,12,16,11,3209,4235,3233,-1002
2016,12,16,12,3764,4976,3816,-1160
2016,12,16,13,4059,5352,4104,-1248
2016,12,16,14,4102,5416,4087,-1329
2016,12,16,15,4079,5383,4103,-1280
2016,12,16,16,4088,5330,4125,-1205
2016,12,16,17,4089,5302,4151,-1151
2016,12,16,18,4172,5308,4176,-1132
2016,12,16,19,4187,5348,4244,-1104
2016,12,16,20,4209,5414,4306,-1108
2016,12,16,21,4207,5433,4345,-1088
2016,12,16,22,4214,5477,4359,-1118
2016,12,16,23,4437,5655,4466,-1189
2016,12,17,0,4643,5903,4638,-1265
2016,12,17,1,4480,5727,4495,-1232
2016,12,17,2,4316,5493,4288,-1205
2016,12,17,3,4061,5203,4063,-1140
2016,12,17,4,3742,4821,3757,-1064
2016,12,17,5,3365,4367,3421,-946
2016,12,17,6,3039,3979,3100,-879
2016,12,17,7,2825,3715,2881,-834
2016,12,17,8,2709,3539,2731,-808
2016,12,17,9,2676,3496,2694,-802
2016,12,17,10,2699,3517,2697,-820
2016,12,17,11,2766,3654,2797,-857
2016,12,17,12,2961,3907,2913,-994
2016,12,17,13,3165,4205,3049,-1156
2016,12,17,14,3490,4645,3302,-1343
2016,12,17,15,3883,5027,3646,-1381
2016,12,17,16,4163,5305,3909,-1396
2016,12,17,17,4374,5526,4087,-1439
2016,12,17,18,4527,5714,4223,-1491
2016,12,17,19,4642,5756,4248,-1508
2016,12,17,20,4753,5996,4479,-1517
2016,12,17,21,4798,6109,4622,-1487
2016,12,17,22,4727,6104,4610,-1494
2016,12,17,23,4739,6101,4580,-1521
2016,12,18,0,4883,6251,4743,-1508
2016,12,18,1,4777,5965,4575,-1390
2016,12,18,2,4578,5686,4259,-1427
2016,12,18,3,4339,5398,4011,-1387
2016,12,18,4,4055,5023,3716,-1307
2016,12,18,5,3644,4583,3512,-1071
2016,12,18,6,3399,4150,3275,-875
2016,12,18,7,3178,3856,3040,-816
2016,12,18,8,3015,3671,2887,-784
2016,12,18,9,2930,3567,2793,-774
2016,12,18,10,2901,3561,2786,-775
2016,12,18,11,2936,3651,2841,-810
2016,12,18,12,3049,3871,3007,-864
2016,12,18,13,3190,4158,3212,-946
2016,12,18,14,3577,4735,3562,-1173
2016,12,18,15,4113,5324,3844,-1480
2016,12,18,16,4466,5808,3995,-1813
2016,12,18,17,4823,6192,4183,-2009
2016,12,18,18,5115,6588,4488,-2100
2016,12,18,19,5360,6858,4685,-2173
2016,12,18,20,5536,7017,4785,-2232
2016,12,18,21,5544,7063,4856,-2207
2016,12,18,22,5497,6956,4808,-2148
2016,12,18,23,5418,6919,4754,-2165
2016,12,19,0,5635,7145,4884,-2261
2016,12,19,1,5447,6880,4865,-2015
2016,12,19,2,5172,6536,4622,-1914
2016,12,19,3,4763,6077,4364,-1713
2016,12,19,4,4326,5538,4044,-1494
2016,12,19,5,3906,4936,3679,-1257
2016,12,19,6,3506,4407,3481,-926
2016,12,19,7,3233,4063,3210,-853
2016,12,19,8,3053,3877,3059,-818
2016,12,19,9,2975,3812,3001,-811
2016,12,19,10,3011,3843,3025,-818
2016,12,19,11,3224,4129,3213,-916
2016,12,19,12,3657,4617,3734,-883
2016,12,19,13,3893,4953,4141,-812
2016,12,19,14,4115,5281,4281,-1000
2016,12,19,15,4393,5763,4464,-1299
2016,12,19,16,4701,6199,4607,-1592
2016,12,19,17,4933,6623,4809,-1814
2016,12,19,18,5126,7024,5097,-1927
2016,12,19,19,5294,7344,5288,-2056
2016,12,19,20,5343,7523,5441,-2082
2016,12,19,21,5282,7574,5490,-2084
2016,12,19,22,5242,7360,5393,-1967
2016,12,19,23,5383,7329,5264,-2065
2016,12,20,0,5490,7513,5370,-2143
2016,12,20,1,5310,7234,5200,-2034
2016,12,20,2,5052,6846,4947,-1899
2016,12,20,3,4693,6366,4749,-1617
2016,12,20,4,4246,5780,4371,-1409
2016,12,20,5,3698,5093,3878,-1215
2016,12,20,6,3340,4536,3649,-887
2016,12,20,7,3099,4173,3351,-822
2016,12,20,8,2923,3936,3152,-784
2016,12,20,9,2853,3831,3051,-780
2016,12,20,10,2860,3864,3066,-798
2016,12,20,11,3083,4107,3239,-868
2016,12,20,12,3524,4606,3719,-887
2016,12,20,13,3769,4920,4025,-895
2016,12,20,14,3956,5111,4179,-932
2016,12,20,15,4220,5282,4296,-986
2016,12,20,16,4378,5426,4349,-1077
2016,12,20,17,4455,5521,4428,-1093
2016,12,20,18,4526,5600,4528,-1072
2016,12,20,19,4664,5591,4563,-1028
2016,12,20,20,4681,5568,4391,-1177
2016,12,20,21,4592,5627,4419,-1208
2016,12,20,22,4598,5683,4478,-1205
2016,12,20,23,4847,5972,4638,-1334
2016,12,21,0,5029,6300,4877,-1423
2016,12,21,1,4835,6174,4788,-1386
2016,12,21,2,4618,5964,4608,-1356
2016,12,21,3,4293,5596,4421,-1175
2016,12,21,4,3858,5108,3979,-1129
2016,12,21,5,3399,4532,3553,-979
2016,12,21,6,3113,4029,3204,-825
2016,12,21,7,2906,3789,2971,-818
2016,12,21,8,2786,3646,2854,-792
2016,12,21,9,2746,3592,2800,-792
2016,12,21,10,2807,3695,2854,-841
2016,12,21,11,3047,4044,3116,-928
2016,12,21,12,3472,4467,3422,-1045
2016,12,21,13,3699,4875,3752,-1123
2016,12,21,14,3878,5061,3912,-1149
2016,12,21,15,4069,5259,4072,-1187
2016,12,21,16,4102,5362,4180,-1182
2016,12,21,17,4144,5342,4186,-1156
2016,12,21,18,4222,5295,4166,-1129
2016,12,21,19,4359,5227,4137,-1090
2016,12,21,20,4401,5185,4098,-1087
2016,12,21,21,4305,5175,4095,-1080
2016,12,21,22,4335,5208,4123,-1085
2016,12,21,23,4549,5489,4302,-1187
2016,12,22,0,4768,5914,4593,-1321
2016,12,22,1,4587,5864,4542,-1322
2016,12,22,2,4411,5697,4401,-1296
2016,12,22,3,4166,5419,4156,-1263
2016,12,22,4,3819,5009,3842,-1167
2016,12,22,5,3371,4550,3529,-1021
2016,12,22,6,3115,4209,3238,-971
2016,12,22,7,2926,4005,3045,-960
2016,12,22,8,2822,3903,2942,-961
2016,12,22,9,2814,3922,2941,-981
2016,12,22,10,2895,4021,2969,-1052
2016,12,22,11,3087,4349,3259,-1090
2016,12,22,12,3466,4921,3777,-1144
2016,12,22,13,3735,5324,4187,-1137
2016,12,22,14,3912,5504,4330,-1174
2016,12,22,15,3988,5498,4299,-1199
2016,12,22,16,4057,5389,4204,-1185
2016,12,22,17,4046,5289,4125,-1164
2016,12,22,18,4069,5230,4079,-1151
2016,12,22,19,4122,5205,4116,-1089
2016,12,22,20,4111,5266,4188,-1078
2016,12,22,21,4126,5294,4206,-1088
2016,12,22,22,4134,5289,4159,-1130
2016,12,22,23,4292,5469,4275,-1194
2016,12,23,0,4610,5834,4548,-1286
2016,12,23,1,4522,5706,4433,-1273
2016,12,23,2,4366,5490,4263,-1227
2016,12,23,3,4132,5204,4033,-1171
2016,12,23,4,3809,4817,3714,-1103
2016,12,23,5,3465,4340,3359,-981
2016,12,23,6,3092,3939,3017,-922
2016,12,23,7,2866,3657,2800,-857
2016,12,23,8,2781,3525,2682,-843
2016,12,23,9,2708,3492,2624,-868
2016,12,23,10,2774,3526,2654,-872
2016,12,23,11,2960,3757,2816,-941
2016,12,23,12,3253,4155,3109,-1046
2016,12,23,13,3586,4507,3415,-1092
2016,12,23,14,3872,4823,3671,-1152
2016,12,23,15,4024,5068,3892,-1176
2016,12,23,16,4091,5206,4031,-1175
2016,12,23,17,4077,5271,4109,-1162
2016,12,23,18,4079,5358,4179,-1179
2016,12,23,19,4081,5470,4292,-1178
2016,12,23,20,4093,5575,4385,-1190
2016,12,23,21,4070,5641,4423,-1218
2016,12,23,22,4050,5641,4443,-1198
2016,12,23,23,4179,5707,4467,-1240
2016,12,24,0,4465,5974,4604,-1370
2016,12,24,1,4293,5769,4472,-1297
2016,12,24,2,4128,5550,4317,-1233
2016,12,24,3,4041,5280,4090,-1190
2016,12,24,4,3830,4934,3823,-1111
2016,12,24,5,3489,4464,3484,-980
2016,12,24,6,3129,4051,3149,-902
2016,12,24,7,2880,3728,2899,-829
2016,12,24,8,2725,3533,2712,-821
2016,12,24,9,2665,3440,2635,-805
2016,12,24,10,2673,3434,2626,-808
2016,12,24,11,2652,3523,2662,-861
2016,12,24,12,2718,3740,2818,-922
2016,12,24,13,2963,4029,3008,-1021
2016,12,24,14,3310,4556,3413,-1143
2016,12,24,15,3895,5051,3843,-1208
2016,12,24,16,4246,5421,4169,-1252
2016,12,24,17,4415,5754,4382,-1372
2016,12,24,18,4668,6031,4484,-1547
2016,12,24,19,4805,6238,4609,-1629
2016,12,24,20,4938,6445,4733,-1712
2016,12,24,21,4987,6529,4704,-1825
2016,12,24,22,4807,6453,4678,-1775
2016,12,24,23,4769,6304,4654,-1650
2016,12,25,0,4803,6332,4701,-1631
2016,12,25,1,4579,5989,4341,-1648
2016,12,25,2,4390,5655,3977,-1678
2016,12,25,3,4141,5318,3819,-1499
2016,12,25,4,3907,4962,3677,-1285
2016,12,25,5,3633,4554,3539,-1015
2016,12,25,6,3298,4101,3208,-893
2016,12,25,7,3066,3784,2960,-824
2016,12,25,8,2902,3545,2781,-764
2016,12,25,9,2765,3412,2670,-742
2016,12,25,10,2705,3369,2612,-757
2016,12,25,11,2692,3431,2646,-785
2016,12,25,12,2715,3621,2767,-854
2016,12,25,13,2845,3947,3002,-945
2016,12,25,14,3268,4505,3413,-1092
2016,12,25,15,3811,5084,3883,-1201
2016,12,25,16,4147,5545,4290,-1255
2016,12,25,17,4494,5926,4575,-1351
2016,12,25,18,4831,6228,4715,-1513
2016,12,25,19,4912,6356,4702,-1654
2016,12,25,20,4945,6409,4640,-1769
2016,12,25,21,4976,6328,4570,-1758
2016,12,25,22,4772,6096,4381,-1715
2016,12,25,23,4624,5930,4133,-1797
2016,12,26,0,4740,6021,4177,-1844
2016,12,26,1,4647,5799,4122,-1677
2016,12,26,2,4428,5564,3896,-1668
2016,12,26,3,4158,5247,3755,-1492
2016,12,26,4,3853,4859,3598,-1261
2016,12,26,5,3455,4162,3182,-980
2016,12,26,6,3235,3993,3117,-876
2016,12,26,7,3039,3674,2864,-810
2016,12,26,8,2885,3476,2702,-774
2016,12,26,9,2811,3393,2644,-749
2016,12,26,10,2798,3407,2648,-759
2016,12,26,11,2895,3480,2677,-803
2016,12,26,12,2999,3696,2865,-831
2016,12,26,13,3247,3911,3023,-888
2016,12,26,14,3682,4373,3374,-999
2016,12,26,15,4209,5015,3867,-1148
2016,12,26,16,4571,5557,4330,-1227
2016,12,26,17,4851,5919,4510,-1409
2016,12,26,18,4982,6163,4492,-1671
2016,12,26,19,5228,6278,4465,-1813
2016,12,26,20,5353,6323,4470,-1853
2016,12,26,21,5307,6292,4443,-1849
2016,12,26,22,5286,6210,4409,-1801
2016,12,26,23,5213,6242,4401,-1841
2016,12,27,0,5352,6518,4610,-1908
2016,12,27,1,5255,6318,4508,-1810
2016,12,27,2,4951,6022,4297,-1725
2016,12,27,3,4623,5611,4093,-1518
2016,12,27,4,4307,5096,3834,-1262
2016,12,27,5,3749,4554,3588,-966
2016,12,27,6,3495,4046,3186,-860
2016,12,27,7,3225,3709,2915,-794
2016,12,27,8,3043,3512,2752,-760
2016,12,27,9,2931,3410,2667,-743
2016,12,27,10,2931,3451,2678,-773
2016,12,27,11,3034,3666,2808,-858
2016,12,27,12,3332,4013,3076,-937
2016,12,27,13,3539,4307,3324,-983
2016,12,27,14,3911,4685,3561,-1124
2016,12,27,15,4313,5151,3944,-1207
2016,12,27,16,4668,5610,4340,-1270
2016,12,27,17,4998,5953,4483,-1470
2016,12,27,18,5224,6276,4598,-1678
2016,12,27,19,5385,6502,4762,-1740
2016,12,27,20,5425,6623,4806,-1817
2016,12,27,21,5469,6703,4866,-1837
2016,12,27,22,5475,6603,4793,-1810
2016,12,27,23,5388,6538,4715,-1823
2016,12,28,0,5487,6767,4787,-1980
2016,12,28,1,5312,6498,4514,-1984
2016,12,28,2,5042,6150,4254,-1896
2016,12,28,3,4672,5703,3954,-1749
2016,12,28,4,4283,5150,3641,-1509
2016,12,28,5,3793,4594,3458,-1136
2016,12,28,6,3353,4100,3193,-907
2016,12,28,7,3062,3802,2966,-836
2016,12,28,8,2891,3627,2802,-825
2016,12,28,9,2831,3541,2725,-816
2016,12,28,10,2821,3547,2716,-831
2016,12,28,11,2954,3719,2828,-891
2016,12,28,12,3225,4036,3053,-983
2016,12,28,13,3542,4309,3346,-963
2016,12,28,14,3903,4641,3554,-1087
2016,12,28,15,4210,5088,3794,-1294
2016,12,28,16,4476,5486,4125,-1361
2016,12,28,17,4845,5861,4239,-1622
2016,12,28,18,5033,6195,4364,-1831
2016,12,28,19,5149,6437,4416,-2021
2016,12,28,20,5184,6601,4470,-2131
2016,12,28,21,5245,6668,4544,-2124
2016,12,28,22,5150,6563,4483,-2080
2016,12,28,23,5061,6448,4400,-2048
2016,12,29,0,5316,6637,4505,-2132
2016,12,29,1,5177,6356,4395,-1961
2016,12,29,2,4993,5984,4105,-1879
2016,12,29,3,4539,5551,3824,-1727
2016,12,29,4,4136,5024,3603,-1421
2016,12,29,5,3669,4513,3324,-1189
2016,12,29,6,3193,4193,3272,-921
2016,12,29,7,2931,3869,3018,-851
2016,12,29,8,2754,3702,2868,-834
2016,12,29,9,2691,3621,2792,-829
2016,12,29,10,2740,3639,2807,-832
2016,12,29,11,2771,3827,2929,-898
2016,12,29,12,3097,4168,3182,-986
2016,12,29,13,3335,4455,3474,-981
2016,12,29,14,3629,4776,3669,-1107
2016,12,29,15,3938,5173,3939,-1234
2016,12,29,16,4232,5557,4305,-1252
2016,12,29,17,4444,5820,4517,-1303
2016,12,29,18,4635,6065,4699,-1366
2016,12,29,19,4706,6249,4868,-1381
2016,12,29,20,4749,6326,4832,-1494
2016,12,29,21,4723,6234,4743,-1491
2016,12,29,22,4687,6150,4783,-1367
2016,12,29,23,4633,6288,4870,-1418
2016,12,30,0,4894,6585,5014,-1571
2016,12,30,1,4693,6387,4863,-1524
2016,12,30,2,4421,6042,4646,-1396
2016,12,30,3,4097,5523,4253,-1270
2016,12,30,4,3781,4971,3802,-1169
2016,12,30,5,3317,4452,3351,-1101
2016,12,30,6,3095,3879,2937,-942
2016,12,30,7,2860,3579,2713,-866
2016,12,30,8,2783,3472,2598,-874
2016,12,30,9,2837,3448,2568,-880
2016,12,30,10,2938,3566,2634,-932
2016,12,30,11,3255,3862,2830,-1032
2016,12,30,12,3700,4417,3246,-1171
2016,12,30,13,4164,4960,3670,-1290
2016,12,30,14,4440,5420,4119,-1301
2016,12,30,15,4591,5642,4371,-1271
2016,12,30,16,4735,5715,4388,-1327
2016,12,30,17,4630,5557,4270,-1287
2016,12,30,18,4472,5391,4117,-1274
2016,12,30,19,4381,5262,4008,-1254
2016,12,30,20,4218,5169,3810,-1359
2016,12,30,21,4156,5085,3668,-1417
2016,12,30,22,4305,5192,3743,-1449
2016,12,30,23,4561,5647,4034,-1613
2016,12,31,0,4848,6199,4461,-1738
2016,12,31,1,5016,6261,4502,-1759
2016,12,31,2,5116,6268,4484,-1784
2016,12,31,3,5062,6156,4394,-1762
2016,12,31,4,4864,5928,4200,-1728
2016,12,31,5,4472,5635,4027,-1608
2016,12,31,6,4210,5443,3836,-1607
2016,12,31,7,4095,5377,3673,-1704
2016,12,31,8,4101,5362,3632,-1730
2016,12,31,9,4127,5430,3611,-1819
2016,12,31,10,4276,5574,3735,-1839
2016,12,31,11,4400,5815,3896,-1919
2016,12,31,12,4772,6211,4184,-2027
2016,12,31,13,4977,6690,4551,-2139
2016,12,31,14,5217,6948,4781,-2167
2016,12,31,15,4980,6671,4654,-2017
2016,12,31,16,4609,6160,4204,-1956
2016,12,31,17,4431,5676,3862,-1814
2016,12,31,18,4230,5317,3689,-1628
2016,12,31,19,4054,5087,3657,-1430
2016,12,31,20,3981,4998,3610,-1388
2016,12,31,21,3912,4949,3660,-1289
2016,12,31,22,3896,4981,3831,-1150
2016,12,31,23,4151,5206,3983,-1223
2017,1,1,0,4380,5597,4261,-1336
2017,1,1,1,4161,5442,4169,-1273
2017,1,1,2,3928,5123,3934,-1189
2017,1,1,3,3735,4860,3739,-1121
2017,1,1,4,3665,4587,3472,-1115
2017,1,1,5,3485,4330,3295,-1035
2017,1,1,6,3266,4125,3034,-1091
2017,1,1,7,3108,3991,2902,-1089
2017,1,1,8,3033,3825,2789,-1036
2017,1,1,9,2951,3737,2699,-1038
2017,1,1,10,2968,3734,2683,-1051
2017,1,1,11,3014,3784,2707,-1077
2017,1,1,12,3113,3965,2829,-1136
2017,1,1,13,3231,4163,3011,-1152
2017,1,1,14,3455,4453,3224,-1229
2017,1,1,15,3686,4651,3412,-1239
2017,1,1,16,3925,4771,3550,-1221
2017,1,1,17,4102,4897,3689,-1208
2017,1,1,18,4222,5060,3815,-1245
2017,1,1,19,4291,5169,3916,-1253
2017,1,1,20,4341,5272,3997,-1275
2017,1,1,21,4329,5341,4051,-1290
2017,1,1,22,4259,5347,4058,-1289
2017,1,1,23,4249,5419,4098,-1321
2017,1,2,0,4477,5700,4305,-1395
2017,1,2,1,4413,5530,4175,-1355
2017,1,2,2,4153,5231,3962,-1269
2017,1,2,3,3949,4897,3726,-1171
2017,1,2,4,3660,4499,3393,-1106
2017,1,2,5,3244,4066,3108,-958
2017,1,2,6,3065,3679,2782,-897
2017,1,2,7,2838,3405,2556,-849
2017,1,2,8,2675,3243,2429,-814
2017,1,2,9,2614,3177,2366,-811
2017,1,2,10,2634,3195,2370,-825
2017,1,2,11,2741,3359,2497,-862
2017,1,2,12,2984,3655,2709,-946
2017,1,2,13,3184,3935,2919,-1016
2017,1,2,14,3623,4368,3220,-1148
2017,1,2,15,3978,4849,3466,-1383
2017,1,2,16,4382,5307,3796,-1511
2017,1,2,17,4585,5688,4119,-1569
2017,1,2,18,4713,5976,4376,-1600
2017,1,2,19,4787,6202,4427,-1775
2017,1,2,20,4872,6365,4604,-1761
2017,1,2,21,4964,6480,4688,-1792
2017,1,2,22,4920,6497,4687,-1810
2017,1,2,23,4854,6496,4660,-1836
2017,1,3,0,5000,6719,4768,-1951
2017,1,3,1,4904,6472,4607,-1865
2017,1,3,2,4577,6074,4507,-1567
2017,1,3,3,4182,5639,4285,-1354
2017,1,3,4,3909,5112,3798,-1314
2017,1,3,5,3655,4562,3441,-1121
2017,1,3,6,3269,4178,3214,-964
2017,1,3,7,3032,3848,2939,-909
2017,1,3,8,2908,3648,2770,-878
2017,1,3,9,2803,3572,2700,-872
2017,1,3,10,2828,3634,2748,-886
2017,1,3,11,2998,3925,2978,-947
2017,1,3,12,3390,4454,3391,-1063
2017,1,3,13,3625,4877,3759,-1118
2017,1,3,14,3890,5157,3932,-1225
2017,1,3,15,4206,5443,3986,-1457
2017,1,3,16,4528,5802,4108,-1694
2017,1,3,17,4768,6182,4271,-1911
2017,1,3,18,5024,6523,4472,-2051
2017,1,3,19,5203,6746,4612,-2134
2017,1,3,20,5274,6890,4750,-2140
2017,1,3,21,5300,6864,4721,-2143
2017,1,3,22,5239,6765,4618,-2147
2017,1,3,23,5338,6786,4630,-2156
2017,1,4,0,5385,7063,4750,-2313
2017,1,4,1,5239,6882,4728,-2154
2017,1,4,2,4952,6503,4659,-1844
2017,1,4,3,4524,5997,4452,-1545
2017,1,4,4,4131,5443,4111,-1332
2017,1,4,5,3642,4875,3720,-1155
2017,1,4,6,3454,4373,3395,-978
2017,1,4,7,3198,4047,3115,-932
2017,1,4,8,3026,3857,2972,-885
2017,1,4,9,2934,3752,2881,-871
2017,1,4,10,2961,3778,2876,-902
2017,1,4,11,3201,4063,3072,-991
2017,1,4,12,3629,4601,3480,-1121
2017,1,4,13,3880,4940,3795,-1145
2017,1,4,14,3996,5063,3906,-1157
2017,1,4,15,4188,5281,4088,-1193
2017,1,4,16,4396,5496,4116,-1380
2017,1,4,17,4585,5644,4066,-1578
2017,1,4,18,4727,5824,4078,-1746
2017,1,4,19,4796,5962,4185,-1777
2017,1,4,20,4849,5998,4222,-1776
2017,1,4,21,4780,5959,4190,-1769
2017,1,4,22,4752,5851,4108,-1743
2017,1,4,23,4841,5849,4082,-1767
2017,1,5,0,5047,6127,4268,-1859
2017,1,5,1,4863,5940,4116,-1824
2017,1,5,2,4574,5605,3985,-1620
2017,1,5,3,4184,5178,3812,-1366
2017,1,5,4,3797,4649,3527,-1122
2017,1,5,5,3416,4138,3156,-982
2017,1,5,6,3057,3756,2865,-891
2017,1,5,7,2868,3542,2715,-827
2017,1,5,8,2719,3443,2580,-863
2017,1,5,9,2660,3414,2571,-843
2017,1,5,10,2747,3502,2616,-886
2017,1,5,11,3045,3852,2934,-918
2017,1,5,12,3551,4498,3465,-1033
2017,1,5,13,3816,4906,3917,-989
2017,1,5,14,3936,5026,4032,-994
2017,1,5,15,3984,5098,4009,-1089
2017,1,5,16,4109,5204,4127,-1077
2017,1,5,17,4179,5269,4216,-1053
2017,1,5,18,4298,5342,4282,-1060
2017,1,5,19,4404,5427,4383,-1044
2017,1,5,20,4428,5481,4433,-1048
2017,1,5,21,4399,5531,4474,-1057
2017,1,5,22,4385,5550,4501,-1049
2017,1,5,23,4410,5609,4567,-1042
2017,1,6,0,4653,5960,4864,-1096
2017,1,6,1,4528,5865,4793,-1072
2017,1,6,2,4356,5612,4598,-1014
2017,1,6,3,4023,5201,4170,-1031
2017,1,6,4,3682,4727,3757,-970
2017,1,6,5,3348,4235,3258,-977
2017,1,6,6,3080,3880,3032,-848
2017,1,6,7,2954,3672,2853,-819
2017,1,6,8,2890,3564,2754,-810
2017,1,6,9,2858,3563,2744,-819
2017,1,6,10,2935,3697,2816,-881
2017,1,6,11,3237,4046,3080,-966
2017,1,6,12,3721,4741,3616,-1125
2017,1,6,13,3984,5173,4046,-1127
2017,1,6,14,4029,5286,4191,-1095
2017,1,6,15,4134,5297,4219,-1078
2017,1,6,16,4192,5316,4228,-1088
2017,1,6,17,4181,5354,4297,-1057
2017,1,6,18,4244,5396,4307,-1089
2017,1,6,19,4266,5463,4392,-1071
2017,1,6,20,4302,5563,4479,-1084
2017,1,6,21,4260,5602,4516,-1086
2017,1,6,22,4280,5568,4544,-1024
2017,1,6,23,4355,5707,4634,-1073
2017,1,7,0,4565,5891,4839,-1052
2017,1,7,1,4460,5723,4714,-1009
2017,1,7,2,4253,5485,4438,-1047
2017,1,7,3,3957,5161,4113,-1048
2017,1,7,4,3629,4788,3776,-1012
2017,1,7,5,3372,4368,3487,-881
2017,1,7,6,3050,4160,3343,-817
2017,1,7,7,2875,3916,3146,-770
2017,1,7,8,2805,3785,3036,-749
2017,1,7,9,2745,3729,2974,-755
2017,1,7,10,2747,3764,3001,-763
2017,1,7,11,2858,3897,3079,-818
2017,1,7,12,3019,4124,3243,-881
2017,1,7,13,3193,4445,3493,-952
2017,1,7,14,3570,4882,3819,-1063
2017,1,7,15,3910,5335,4142,-1193
2017,1,7,16,4089,5640,4493,-1147
2017,1,7,17,4199,5773,4597,-1176
2017,1,7,18,4180,5752,4557,-1195
2017,1,7,19,4142,5684,4450,-1234
2017,1,7,20,4100,5620,4355,-1265
2017,1,7,21,4035,5581,4331,-1250
2017,1,7,22,4077,5670,4391,-1279
2017,1,7,23,4100,6054,4645,-1409
2017,1,8,0,4582,6683,5185,-1498
2017,1,8,1,4650,6826,5284,-1542
2017,1,8,2,4700,6906,5318,-1588
2017,1,8,3,4700,6893,5302,-1591
2017,1,8,4,4693,6751,5165,-1586
2017,1,8,5,4650,6563,4887,-1676
2017,1,8,6,5068,6285,4671,-1614
2017,1,8,7,5102,6229,4585,-1644
2017,1,8,8,5158,6286,4568,-1718
2017,1,8,9,5235,6458,4665,-1793
2017,1,8,10,5320,6744,4838,-1906
2017,1,8,11,5558,7133,4942,-2191
2017,1,8,12,5850,7740,5461,-2279
2017,1,8,13,6316,8487,6155,-2332
2017,1,8,14,6670,8996,6625,-2371
2017,1,8,15,6582,8896,6520,-2376
2017,1,8,16,6053,8388,5912,-2476
2017,1,8,17,5669,7800,5406,-2394
2017,1,8,18,5263,7259,5029,-2230
2017,1,8,19,4952,6787,4807,-1980
2017,1,8,20,4733,6471,4583,-1888
2017,1,8,21,4681,6329,4490,-1839
2017,1,8,22,4789,6453,4572,-1881
2017,1,8,23,4998,7020,5013,-2007
2017,1,9,0,5824,7870,5632,-2238
2017,1,9,1,5996,8155,5796,-2359
2017,1,9,2,6167,8236,5724,-2512
2017,1,9,3,5905,8057,5591,-2466
2017,1,9,4,5704,7720,5340,-2380
2017,1,9,5,5209,7368,5174,-2194
2017,1,9,6,5009,7132,5032,-2100
2017,1,9,7,4973,7064,4952,-2112
2017,1,9,8,4994,7079,4945,-2134
2017,1,9,9,5041,7135,4993,-2142
2017,1,9,10,5223,7385,5241,-2144
2017,1,9,11,5622,8032,5753,-2279
2017,1,9,12,6374,8916,6477,-2439
2017,1,9,13,6542,9361,6881,-2480
2017,1,9,14,6201,9046,6613,-2433
2017,1,9,15,5848,8323,5940,-2383
2017,1,9,16,5486,7526,5269,-2257
2017,1,9,17,5023,6791,4620,-2171
2017,1,9,18,4735,6211,4162,-2049
2017,1,9,19,4549,5777,3853,-1924
2017,1,9,20,4392,5505,3679,-1826
2017,1,9,21,4232,5377,3561,-1816
2017,1,9,22,4325,5464,3610,-1854
2017,1,9,23,4678,5887,3894,-1993
2017,1,10,0,5063,6625,4533,-2092
2017,1,10,1,5101,6761,4777,-1984
2017,1,10,2,5001,6668,4848,-1820
2017,1,10,3,4764,6337,4595,-1742
2017,1,10,4,4446,5978,4296,-1682
2017,1,10,5,4060,5550,4037,-1513
2017,1,10,6,3962,5319,4021,-1298
2017,1,10,7,3874,5235,3963,-1272
2017,1,10,8,3852,5230,3948,-1282
2017,1,10,9,3912,5330,3997,-1333
2017,1,10,10,4082,5578,4184,-1394
2017,1,10,11,4476,6184,4717,-1467
2017,1,10,12,5151,7063,5518,-1545
2017,1,10,13,5455,7422,5776,-1646
2017,1,10,14,5330,7154,5571,-1583
2017,1,10,15,4968,6560,5101,-1459
2017,1,10,16,4692,6068,4767,-1301
2017,1,10,17,4500,5675,4458,-1217
2017,1,10,18,4249,5425,4274,-1151
2017,1,10,19,4153,5274,4187,-1087
2017,1,10,20,4070,5147,4086,-1061
2017,1,10,21,4018,5112,4039,-1073
2017,1,10,22,4020,5201,4107,-1094
2017,1,10,23,4191,8577,7379,-1198
2017,1,11,0,4572,5960,4621,-1339
2017,1,11,1,4600,5937,4597,-1340
2017,1,11,2,4459,5729,4428,-1301
2017,1,11,3,4188,5383,4158,-1225
2017,1,11,4,3836,4959,3830,-1129
2017,1,11,5,3466,4480,3461,-1019
2017,1,11,6,3111,4165,3163,-1002
2017,1,11,7,2949,4033,3028,-1005
2017,1,11,8,2876,4013,3004,-1009
2017,1,11,9,2876,4080,3044,-1036
2017,1,11,10,2975,4267,3184,-1083
2017,1,11,11,3296,4759,3503,-1256
2017,1,11,12,3821,5588,4169,-1419
2017,1,11,13,4143,5954,4540,-1414
2017,1,11,14,4154,5822,4468,-1354
2017,1,11,15,4148,5548,4276,-1272
2017,1,11,16,4116,5351,4186,-1165
2017,1,11,17,4152,5270,4115,-1155
2017,1,11,18,4160,5208,4103,-1105
2017,1,11,19,4164,5172,4116,-1056
2017,1,11,20,4196,5148,4085,-1063
2017,1,11,21,4261,5119,4071,-1048
2017,1,11,22,4250,5183,4100,-1083
2017,1,11,23,4312,5398,4271,-1127
2017,1,12,0,4692,5806,4542,-1264
2017,1,12,1,4580,5760,4497,-1263
2017,1,12,2,4302,5556,4361,-1195
2017,1,12,3,4020,5199,4082,-1117
2017,1,12,4,3605,4717,3698,-1019
2017,1,12,5,3321,4224,3297,-927
2017,1,12,6,3013,3881,2913,-968
2017,1,12,7,2812,3719,2762,-957
2017,1,12,8,2761,3662,2704,-958
2017,1,12,9,2720,3679,2711,-968
2017,1,12,10,2811,3840,2814,-1026
2017,1,12,11,3146,4301,3103,-1198
2017,1,12,12,3696,5091,3724,-1367
2017,1,12,13,4011,5472,4110,-1362
2017,1,12,14,4038,5457,4129,-1328
2017,1,12,15,4071,5336,4122,-1214
2017,1,12,16,4098,5319,4133,-1186
2017,1,12,17,4176,5307,4157,-1150
2017,1,12,18,4217,5362,4211,-1151
2017,1,12,19,4258,5418,4266,-1152
2017,1,12,20,4310,5486,4278,-1208
2017,1,12,21,4411,5524,4308,-1216
2017,1,12,22,4405,5555,4251,-1304
2017,1,12,23,4419,5642,4265,-1377
2017,1,13,0,4752,5986,4633,-1353
2017,1,13,1,4713,5923,4596,-1327
2017,1,13,2,4430,5656,4390,-1266
2017,1,13,3,4034,5245,4076,-1169
2017,1,13,4,3682,4729,3663,-1066
2017,1,13,5,3316,4205,3231,-974
2017,1,13,6,2999,3825,2896,-929
2017,1,13,7,2810,3582,2700,-882
2017,1,13,8,2703,3480,2624,-856
2017,1,13,9,2680,3436,2590,-846
2017,1,13,10,2748,3532,2639,-893
2017,1,13,11,2995,3900,2904,-996
2017,1,13,12,3541,4567,3411,-1156
2017,1,13,13,3845,4908,3764,-1144
2017,1,13,14,3929,5048,3869,-1179
2017,1,13,15,4020,5189,4011,-1178
2017,1,13,16,4165,5348,4231,-1117
2017,1,13,17,4223,5460,4339,-1121
2017,1,13,18,4275,5507,4330,-1177
2017,1,13,19,4341,5519,4350,-1169
2017,1,13,20,4447,5518,4315,-1203
2017,1,13,21,4438,5510,4304,-1206
2017,1,13,22,4343,5527,4339,-1188
2017,1,13,23,4350,5587,4349,-1238
2017,1,14,0,4612,5815,4494,-1321
2017,1,14,1,4538,5667,4387,-1280
2017,1,14,2,4316,5431,4209,-1222
2017,1,14,3,3935,5085,3953,-1132
2017,1,14,4,3640,4717,3657,-1060
2017,1,14,5,3324,4297,3291,-1006
2017,1,14,6,3125,3912,2974,-938
2017,1,14,7,2919,3649,2749,-900
2017,1,14,8,2844,3479,2628,-851
2017,1,14,9,2792,3417,2570,-847
2017,1,14,10,2792,3413,2559,-854
2017,1,14,11,2877,3525,2618,-907
2017,1,14,12,3088,3774,2777,-997
2017,1,14,13,3339,4109,3078,-1031
2017,1,14,14,3675,4561,3416,-1145
2017,1,14,15,3829,4960,3752,-1208
2017,1,14,16,4020,5203,3980,-1223
2017,1,14,17,4151,5358,4200,-1158
2017,1,14,18,4220,5448,4237,-1211
2017,1,14,19,4276,5470,4227,-1243
2017,1,14,20,4313,5471,4226,-1245
2017,1,14,21,4306,5479,4214,-1265
2017,1,14,22,4252,5446,4201,-1245
2017,1,14,23,4238,5419,4158,-1261
2017,1,15,0,4452,5652,4324,-1328
2017,1,15,1,4314,5478,4192,-1286
2017,1,15,2,4104,5210,3991,-1219
2017,1,15,3,3812,4874,3719,-1155
2017,1,15,4,3546,4491,3421,-1070
2017,1,15,5,3204,4102,3104,-998
2017,1,15,6,2993,3734,2821,-913
2017,1,15,7,2774,3492,2614,-878
2017,1,15,8,2682,3359,2505,-854
2017,1,15,9,2607,3305,2467,-838
2017,1,15,10,2627,3313,2464,-849
2017,1,15,11,2681,3404,2514,-890
2017,1,15,12,2909,3621,2656,-965
2017,1,15,13,3215,3910,2911,-999
2017,1,15,14,3553,4406,3263,-1143
2017,1,15,15,3773,4798,3616,-1182
2017,1,15,16,3961,5026,3830,-1196
2017,1,15,17,4099,5185,3980,-1205
2017,1,15,18,4173,5314,4090,-1224
2017,1,15,19,4273,5393,4138,-1255
2017,1,15,20,4292,5424,4164,-1260
2017,1,15,21,4268,5413,4160,-1253
2017,1,15,22,4242,5401,4147,-1254
2017,1,15,23,4245,5445,4178,-1267
2017,1,16,0,4494,5746,4386,-1360
2017,1,16,1,4379,5555,4252,-1303
2017,1,16,2,4089,5330,4096,-1234
2017,1,16,3,3807,4933,3782,-1151
2017,1,16,4,3475,4495,3439,-1056
2017,1,16,5,3115,4052,3065,-987
2017,1,16,6,2849,3674,2764,-910
2017,1,16,7,2633,3434,2579,-855
2017,1,16,8,2584,3303,2468,-835
2017,1,16,9,2501,3264,2437,-827
2017,1,16,10,2582,3337,2483,-854
2017,1,16,11,2816,3600,2683,-917
2017,1,16,12,3246,4015,2996,-1019
2017,1,16,13,3542,4390,3338,-1052
2017,1,16,14,3849,4747,3627,-1120
2017,1,16,15,4105,5064,3903,-1161
2017,1,16,16,4240,5287,4091,-1196
2017,1,16,17,4403,5455,4239,-1216
2017,1,16,18,4461,5580,4269,-1311
2017,1,16,19,4530,5663,4339,-1324
2017,1,16,20,4527,5739,4377,-1362
2017,1,16,21,4571,5795,4451,-1344
2017,1,16,22,4530,5860,4493,-1367
2017,1,16,23,4560,5877,4493,-1384
2017,1,17,0,4856,6163,4655,-1508
2017,1,17,1,4787,6054,4574,-1480
2017,1,17,2,4494,5714,4385,-1329
2017,1,17,3,4120,5239,4028,-1211
2017,1,17,4,3728,4679,3602,-1077
2017,1,17,5,3247,4138,3181,-957
2017,1,17,6,3009,3730,2851,-879
2017,1,17,7,2751,3498,2654,-844
2017,1,17,8,2575,3385,2560,-825
2017,1,17,9,2571,3331,2506,-825
2017,1,17,10,2590,3439,2558,-881
2017,1,17,11,2887,3814,2821,-993
2017,1,17,12,3431,4495,3346,-1149
2017,1,17,13,3813,4852,3691,-1161
2017,1,17,14,3887,4953,3877,-1076
2017,1,17,15,4000,5078,4032,-1046
2017,1,17,16,4161,5264,4107,-1157
2017,1,17,17,4282,5446,4144,-1302
2017,1,17,18,4451,5589,4115,-1474
2017,1,17,19,4657,5699,4081,-1618
2017,1,17,20,4708,5757,4124,-1633
2017,1,17,21,4787,5830,4200,-1630
2017,1,17,22,4785,5821,4171,-1650
2017,1,17,23,4756,5890,4179,-1711
2017,1,18,0,5000,6217,4355,-1862
2017,1,18,1,4955,6140,4347,-1793
2017,1,18,2,4687,5809,4247,-1562
2017,1,18,3,4289,5332,4062,-1270
2017,1,18,4,3851,4761,3568,-1193
2017,1,18,5,3403,4176,3062,-1114
2017,1,18,6,3098,3764,2859,-905
2017,1,18,7,2877,3536,2680,-856
2017,1,18,8,2723,3428,2616,-812
2017,1,18,9,2725,3390,2598,-792
2017,1,18,10,2755,3487,2639,-848
2017,1,18,11,2954,3854,2903,-951
2017,1,18,12,3437,4507,3383,-1124
2017,1,18,13,3805,4854,3745,-1109
2017,1,18,14,3890,4917,3814,-1103
2017,1,18,15,4050,5030,3930,-1100
2017,1,18,16,4228,5208,4107,-1101
2017,1,18,17,4401,5378,4090,-1288
2017,1,18,18,4620,5582,4098,-1484
2017,1,18,19,4797,5769,4133,-1636
2017,1,18,20,4898,5908,4248,-1660
2017,1,18,21,4951,6005,4316,-1689
2017,1,18,22,4922,6043,4402,-1641
2017,1,18,23,4865,5515,3812,-1703
2017,1,19,0,5028,5745,3945,-1800
2017,1,19,1,4960,5633,3869,-1764
2017,1,19,2,4640,5342,3759,-1583
2017,1,19,3,4250,4873,3554,-1319
2017,1,19,4,3833,4280,3079,-1201
2017,1,19,5,3428,3719,2622,-1097
2017,1,19,6,3063,3885,2982,-903
2017,1,19,7,2836,3653,2792,-861
2017,1,19,8,2674,3547,2721,-826
2017,1,19,9,2669,3506,2682,-824
2017,1,19,10,2697,3604,2756,-848
2017,1,19,11,2957,3977,3031,-946
2017,1,19,12,3479,4625,3575,-1050
2017,1,19,13,3790,4989,3964,-1025
2017,1,19,14,3927,5064,3930,-1134
2017,1,19,15,4050,5226,4083,-1143
2017,1,19,16,4193,5433,4274,-1159
2017,1,19,17,4341,5635,4381,-1254
2017,1,19,18,4491,5822,4451,-1371
2017,1,19,19,4649,6013,4544,-1469
2017,1,19,20,4682,6188,4662,-1526
2017,1,19,21,4727,6215,4691,-1524
2017,1,19,22,4711,6179,4698,-1481
2017,1,19,23,4730,6162,4716,-1446
2017,1,20,0,4947,6435,4807,-1628
2017,1,20,1,4885,6308,4788,-1520
2017,1,20,2,4606,5975,4548,-1427
2017,1,20,3,4225,5509,4108,-1401
2017,1,20,4,3809,4966,3651,-1315
2017,1,20,5,3384,4421,3184,-1237
2017,1,20,6,3079,3852,2812,-1040
2017,1,20,7,2830,3586,2722,-864
2017,1,20,8,2695,3459,2634,-825
2017,1,20,9,2720,3406,2583,-823
2017,1,20,10,2771,3477,2600,-877
2017,1,20,11,2967,3813,2845,-968
2017,1,20,12,3400,4453,3352,-1101
2017,1,20,13,3700,4854,3742,-1112
2017,1,20,14,3890,4996,3884,-1112
2017,1,20,15,4049,5177,3912,-1265
2017,1,20,16,4257,5378,3930,-1448
2017,1,20,17,4446,5494,3912,-1582
2017,1,20,18,4599,5724,4082,-1642
2017,1,20,19,4769,6028,4325,-1703
2017,1,20,20,4809,6234,4502,-1732
2017,1,20,21,4826,6377,4614,-1763
2017,1,20,22,4786,6331,4585,-1746
2017,1,20,23,4664,6214,4487,-1727
2017,1,21,0,4813,6329,4559,-1770
2017,1,21,1,4729,6119,4388,-1731
2017,1,21,2,4505,5738,4223,-1515
2017,1,21,3,4139,5362,4078,-1284
2017,1,21,4,3838,4956,3814,-1142
2017,1,21,5,3567,4262,3252,-1010
2017,1,21,6,3265,4028,3107,-921
2017,1,21,7,3021,3746,2861,-885
2017,1,21,8,2868,3587,2737,-850
2017,1,21,9,2800,3488,2658,-830
2017,1,21,10,2746,3477,2637,-840
2017,1,21,11,2906,3545,2660,-885
2017,1,21,12,3116,3792,2832,-960
2017,1,21,13,3363,4089,3100,-989
2017,1,21,14,3692,4581,3482,-1099
2017,1,21,15,4094,5044,3864,-1180
2017,1,21,16,4369,5436,4180,-1256
2017,1,21,17,4650,5702,4305,-1397
2017,1,21,18,4808,5928,4456,-1472
2017,1,21,19,4873,6082,4556,-1526
2017,1,21,20,4885,6202,4641,-1561
2017,1,21,21,4874,6248,4640,-1608
2017,1,21,22,4806,6149,4518,-1631
2017,1,21,23,4786,6007,4447,-1560
2017,1,22,0,4924,6128,4537,-1591
2017,1,22,1,4813,5935,4405,-1530
2017,1,22,2,4537,5608,4328,-1280
2017,1,22,3,4277,5247,4056,-1191
2017,1,22,4,3956,4852,3762,-1090
2017,1,22,5,3631,4440,3404,-1036
2017,1,22,6,3343,4050,3096,-954
2017,1,22,7,3080,3773,2860,-913
2017,1,22,8,2940,3612,2747,-865
2017,1,22,9,2873,3545,2694,-851
2017,1,22,10,2876,3547,2694,-853
2017,1,22,11,2946,3636,2750,-886
2017,1,22,12,3171,3854,2911,-943
2017,1,22,13,3396,4154,3162,-992
2017,1,22,14,3737,4687,3537,-1150
2017,1,22,15,4080,5153,3793,-1360
2017,1,22,16,4459,5683,4109,-1574
2017,1,22,17,4664,6070,4497,-1573
2017,1,22,18,4799,6462,4856,-1606
2017,1,22,19,4796,6664,4999,-1665
2017,1,22,20,4801,6715,5066,-1649
2017,1,22,21,4818,6635,5008,-1627
2017,1,22,22,4774,6530,4845,-1685
2017,1,22,23,4670,6555,4841,-1714
2017,1,23,0,4896,6732,5014,-1718
2017,1,23,1,4896,6442,4867,-1575
2017,1,23,2,4628,5928,4468,-1460
2017,1,23,3,4199,5370,4071,-1299
2017,1,23,4,3786,4771,3710,-1061
2017,1,23,5,3386,4191,3224,-967
2017,1,23,6,3019,3782,2906,-876
2017,1,23,7,2796,3520,2699,-821
2017,1,23,8,2681,3389,2581,-808
2017,1,23,9,2645,3307,2487,-820
2017,1,23,10,2651,3378,2525,-853
2017,1,23,11,2986,3706,2748,-958
2017,1,23,12,3503,4348,3219,-1129
2017,1,23,13,3803,4718,3588,-1130
2017,1,23,14,3945,4871,3762,-1109
2017,1,23,15,4172,4997,3774,-1223
2017,1,23,16,4245,5183,3798,-1385
2017,1,23,17,4294,5224,3838,-1386
2017,1,23,18,4338,5260,3826,-1434
2017,1,23,19,4334,5209,3793,-1416
2017,1,23,20,4261,5157,3754,-1403
2017,1,23,21,4196,5143,3739,-1404
2017,1,23,22,4161,5186,3757,-1429
2017,1,23,23,4289,5355,3854,-1501
2017,1,24,0,4668,5794,4159,-1635
2017,1,24,1,4689,5812,4209,-1603
2017,1,24,2,4512,5555,4007,-1548
2017,1,24,3,4253,5144,3681,-1463
2017,1,24,4,3960,4628,3421,-1207
2017,1,24,5,3522,4138,3014,-1124
2017,1,24,6,3144,3912,2993,-919
2017,1,24,7,2993,3738,2932,-806
2017,1,24,8,2907,3649,2852,-797
2017,1,24,9,2921,3610,2813,-797
2017,1,24,10,3032,3737,2889,-848
2017,1,24,11,3391,4169,3238,-931
2017,1,24,12,4004,4905,3835,-1070
2017,1,24,13,4339,5270,4229,-1041
2017,1,24,14,4336,5316,4308,-1008
2017,1,24,15,4301,5307,4279,-1028
2017,1,24,16,4243,5311,4290,-1021
2017,1,24,17,4200,5318,4292,-1026
2017,1,24,18,4200,5319,4265,-1054
2017,1,24,19,4200,5323,4218,-1105
2017,1,24,20,4200,5346,4203,-1143
2017,1,24,21,4250,5367,4215,-1152
2017,1,24,22,4300,5407,4315,-1092
2017,1,24,23,4500,5518,4505,-1013
2017,1,25,0,4600,5892,4794,-1098
2017,1,25,1,4490,5839,4722,-1117
2017,1,25,2,4277,5758,4715,-1043
2017,1,25,3,3977,5364,4284,-1080
2017,1,25,4,3639,4917,3829,-1088
2017,1,25,5,3241,4478,3483,-995
2017,1,25,6,2975,4010,3108,-902
2017,1,25,7,2881,3866,3022,-844
2017,1,25,8,2835,3825,2938,-887
2017,1,25,9,2853,3871,2928,-943
2017,1,25,10,2941,4060,3120,-940
2017,1,25,11,3297,4597,3541,-1056
2017,1,25,12,3838,5455,4110,-1345
2017,1,25,13,4180,5871,4347,-1524
2017,1,25,14,4200,5788,4265,-1523
2017,1,25,15,4200,5557,4100,-1457
2017,1,25,16,4200,5378,3969,-1409
2017,1,25,17,4209,5243,3887,-1356
2017,1,25,18,4200,5237,3806,-1431
2017,1,25,19,4202,5260,3852,-1408
2017,1,25,20,4200,5319,3897,-1422
2017,1,25,21,4200,5418,3994,-1424
2017,1,25,22,4200,5499,4048,-1451
2017,1,25,23,4319,5588,4088,-1500
2017,1,26,0,4648,5921,4267,-1654
2017,1,26,1,4673,5902,4255,-1647
2017,1,26,2,4434,5654,4131,-1523
2017,1,26,3,4053,5239,3889,-1350
2017,1,26,4,3668,4714,3629,-1085
2017,1,26,5,3264,4196,3325,-871
2017,1,26,6,2984,3824,2970,-854
2017,1,26,7,2872,3692,2856,-836
2017,1,26,8,2884,3472,2663,-809
2017,1,26,9,2880,3448,2645,-803
2017,1,26,10,2863,3549,2718,-831
2017,1,26,11,3126,3901,2942,-959
2017,1,26,12,3597,4563,3286,-1277
2017,1,26,13,3876,4866,3443,-1423
2017,1,26,14,4050,4979,3444,-1535
2017,1,26,15,4213,5126,3526,-1600
2017,1,26,16,4314,5288,3584,-1704
2017,1,26,17,4449,5451,3716,-1735
2017,1,26,18,4569,5612,3803,-1809
2017,1,26,19,4576,5733,3936,-1797
2017,1,26,20,4594,5840,4037,-1803
2017,1,26,21,4593,5952,4139,-1813
2017,1,26,22,4612,5999,4194,-1805
2017,1,26,23,4548,6006,4125,-1881
2017,1,27,0,4854,6274,4259,-2015
2017,1,27,1,4816,6211,4239,-1972
2017,1,27,2,4541,5911,4094,-1817
2017,1,27,3,4153,5464,3969,-1495
2017,1,27,4,3732,4904,3701,-1203
2017,1,27,5,3318,4368,3373,-995
2017,1,27,6,3030,4041,3116,-925
2017,1,27,7,2832,3793,2900,-893
2017,1,27,8,2788,3654,2789,-865
2017,1,27,9,2725,3579,2715,-864
2017,1,27,10,2833,3671,2751,-920
2017,1,27,11,3184,4033,2992,-1041
2017,1,27,12,3752,4682,3477,-1205
2017,1,27,13,4110,5127,3869,-1258
2017,1,27,14,4200,5222,3958,-1264
2017,1,27,15,4299,5325,4067,-1258
2017,1,27,16,4306,5420,4165,-1255
2017,1,27,17,4314,5378,4177,-1201
2017,1,27,18,4274,5321,4134,-1187
2017,1,27,19,4188,5258,4106,-1152
2017,1,27,20,4131,5205,3950,-1255
2017,1,27,21,4123,5183,3912,-1271
2017,1,27,22,4127,5223,3963,-1260
2017,1,27,23,4315,5392,4004,-1388
2017,1,28,0,4625,5782,4285,-1497
2017,1,28,1,4637,5798,4274,-1524
2017,1,28,2,4534,5676,4333,-1343
2017,1,28,3,4389,5437,4148,-1289
2017,1,28,4,4155,5106,3873,-1233
2017,1,28,5,3871,4742,3631,-1111
2017,1,28,6,3555,4350,3332,-1018
2017,1,28,7,3516,4172,3205,-967
2017,1,28,8,3516,4118,3151,-967
2017,1,28,9,3599,4166,3172,-994
2017,1,28,10,3708,4284,3239,-1045
2017,1,28,11,3920,4524,3390,-1134
2017,1,28,12,4384,4965,3701,-1264
2017,1,28,13,4749,5552,4128,-1424
2017,1,28,14,5059,6052,4528,-1524
2017,1,28,15,5120,6196,4685,-1511
2017,1,28,16,4822,6087,4645,-1442
2017,1,28,17,4565,5936,4560,-1376
2017,1,28,18,4439,5754,4433,-1321
2017,1,28,19,4295,5616,4333,-1283
2017,1,28,20,4187,5530,4285,-1245
2017,1,28,21,4144,5627,4345,-1282
2017,1,28,22,4079,5850,4487,-1363
2017,1,28,23,4210,6104,4668,-1436
2017,1,29,0,4562,6421,4823,-1598
2017,1,29,1,4687,6356,4693,-1663
2017,1,29,2,4613,6220,4637,-1583
2017,1,29,3,4497,5981,4552,-1429
2017,1,29,4,4325,5695,4348,-1347
2017,1,29,5,4125,5361,4107,-1254
2017,1,29,6,3897,5096,3898,-1198
2017,1,29,7,3614,4930,3766,-1164
2017,1,29,8,3586,4850,3699,-1151
2017,1,29,9,3599,4828,3693,-1135
2017,1,29,10,3733,4878,3707,-1171
2017,1,29,11,3814,5032,3792,-1240
2017,1,29,12,4047,5307,3989,-1318
2017,1,29,13,4308,5771,4337,-1434
2017,1,29,14,4675,6266,4729,-1537
2017,1,29,15,4860,6643,5062,-1581
2017,1,29,16,4881,6708,5167,-1541
2017,1,29,17,4703,6626,5150,-1476
2017,1,29,18,4656,6465,5067,-1398
2017,1,29,19,4589,6249,4942,-1307
2017,1,29,20,4392,5892,4670,-1222
2017,1,29,21,4286,5664,4472,-1192
2017,1,29,22,4270,5594,4396,-1198
2017,1,29,23,4308,5775,4517,-1258
2017,1,30,0,4723,6330,4920,-1410
2017,1,30,1,4950,6490,5049,-1441
2017,1,30,2,4886,6343,4937,-1406
2017,1,30,3,4605,6038,4694,-1344
2017,1,30,4,4355,5604,4337,-1267
2017,1,30,5,4122,5183,4021,-1162
2017,1,30,6,3900,4920,3806,-1114
2017,1,30,7,3854,4796,3689,-1107
2017,1,30,8,3890,4771,3664,-1107
2017,1,30,9,3921,4851,3700,-1151
2017,1,30,10,4117,5099,3863,-1236
2017,1,30,11,4554,5674,4295,-1379
2017,1,30,12,5267,6585,5016,-1569
2017,1,30,13,5604,7058,5390,-1668
2017,1,30,14,5501,6938,5319,-1619
2017,1,30,15,5214,6616,5130,-1486
2017,1,30,16,4974,6371,4985,-1386
2017,1,30,17,4801,6044,4767,-1277
2017,1,30,18,4594,5737,4539,-1198
2017,1,30,19,4423,5474,4331,-1143
2017,1,30,20,4319,5269,4174,-1095
2017,1,30,21,4278,5171,4105,-1066
2017,1,30,22,4340,5263,4158,-1105
2017,1,30,23,4598,5573,4373,-1200
2017,1,31,0,5054,6310,4908,-1402
2017,1,31,1,5270,6627,5128,-1499
2017,1,31,2,5286,6663,5171,-1492
2017,1,31,3,5134,6442,4985,-1457
2017,1,31,4,4882,6090,4682,-1408
2017,1,31,5,4532,5734,4403,-1331
2017,1,31,6,4327,5579,4234,-1345
2017,1,31,7,4202,5573,4153,-1420
2017,1,31,8,4236,5677,4167,-1510
2017,1,31,9,4306,5824,4219,-1605
2017,1,31,10,4554,6140,4355,-1785
2017,1,31,11,5136,6817,4877,-1940
2017,1,31,12,5897,7823,5835,-1988
2017,1,31,13,6235,8223,6165,-2058
2017,1,31,14,6003,7733,5833,-1900
2017,1,31,15,5550,6847,5108,-1739
2017,1,31,16,5056,6141,4516,-1625
2017,1,31,17,4801,5650,4301,-1349
2017,1,31,18,4595,5337,4066,-1271
2017,1,31,19,4252,5145,4089,-1056
2017,1,31,20,4179,5052,4028,-1024
2017,1,31,21,4133,5034,4005,-1029
2017,1,31,22,4154,5081,4036,-1045
2017,1,31,23,4252,5257,4130,-1127
2017,2,1,0,4510,5754,4514,-1240
2017,2,1,1,4706,5911,4612,-1299
2017,2,1,2,4615,5759,4503,-1256
2017,2,1,3,4378,5460,4268,-1192
2017,2,1,4,4078,5039,3924,-1115
2017,2,1,5,3684,4641,3612,-1029
2017,2,1,6,3443,4418,3392,-1026
2017,2,1,7,3392,4369,3317,-1052
2017,2,1,8,3465,4440,3366,-1074
2017,2,1,9,3526,4571,3451,-1120
2017,2,1,10,3689,4853,3656,-1197
2017,2,1,11,4144,5490,4224,-1266
2017,2,1,12,4884,6447,5141,-1306
2017,2,1,13,5188,6907,5538,-1369
2017,2,1,14,5041,6611,5285,-1326
2017,2,1,15,4751,6041,4802,-1239
2017,2,1,16,4483,5609,4430,-1179
2017,2,1,17,4314,5293,4163,-1130
2017,2,1,18,4161,5171,4061,-1110
2017,2,1,19,4023,5078,3999,-1079
2017,2,1,20,3981,5048,3993,-1055
2017,2,1,21,3997,5065,3986,-1079
2017,2,1,22,4059,5144,4062,-1082
2017,2,1,23,4158,5267,4123,-1144
2017,2,2,0,4517,5625,4377,-1248
2017,2,2,1,4656,5715,4443,-1272
2017,2,2,2,4558,5550,4283,-1267
2017,2,2,3,4226,5191,4001,-1190
2017,2,2,4,3879,4751,3634,-1117
2017,2,2,5,3485,4341,3354,-987
2017,2,2,6,3200,4073,3093,-980
2017,2,2,7,3069,3988,3006,-982
2017,2,2,8,3066,4001,2992,-1009
2017,2,2,9,3079,4078,3047,-1031
2017,2,2,10,3219,4306,3204,-1102
2017,2,2,11,3562,4854,3623,-1231
2017,2,2,12,4212,5740,4325,-1415
2017,2,2,13,4465,6152,4525,-1627
2017,2,2,14,4343,5982,4384,-1598
2017,2,2,15,4277,5661,4308,-1353
2017,2,2,16,4257,5399,4183,-1216
2017,2,2,17,4220,5276,4114,-1162
2017,2,2,18,4221,5247,4112,-1135
2017,2,2,19,4255,5261,4113,-1148
2017,2,2,20,4237,5292,4118,-1174
2017,2,2,21,4278,5347,4190,-1157
2017,2,2,22,4309,5385,4224,-1161
2017,2,2,23,4308,5458,4263,-1195
2017,2,3,0,4564,5766,4401,-1365
2017,2,3,1,4600,5813,4434,-1379
2017,2,3,2,4402,5544,4298,-1246
2017,2,3,3,4105,5155,4002,-1153
2017,2,3,4,3743,4630,3573,-1057
2017,2,3,5,3369,4127,3217,-910
2017,2,3,6,3000,3807,2961,-846
2017,2,3,7,2786,3659,2833,-826
2017,2,3,8,2734,3593,2779,-814
2017,2,3,9,2731,3633,2791,-842
2017,2,3,10,2838,3775,2877,-898
2017,2,3,11,3157,4232,3242,-990
2017,2,3,12,3754,5026,3803,-1223
2017,2,3,13,4056,5476,4152,-1324
2017,2,3,14,4087,5477,4210,-1267
2017,2,3,15,4088,5354,4138,-1216
2017,2,3,16,4121,5301,4182,-1119
2017,2,3,17,4194,5313,4236,-1077
2017,2,3,18,4216,5345,4280,-1065
2017,2,3,19,4218,5383,4309,-1074
2017,2,3,20,4226,5434,4302,-1132
2017,2,3,21,4268,5513,4352,-1161
2017,2,3,22,4302,5560,4389,-1171
2017,2,3,23,4271,5503,4374,-1129
2017,2,4,0,4499,5627,4417,-1210
2017,2,4,1,4571,5569,4367,-1202
2017,2,4,2,4317,5328,4161,-1167
2017,2,4,3,3978,5010,3917,-1093
2017,2,4,4,3649,4607,3602,-1005
2017,2,4,5,3315,4194,3288,-906
2017,2,4,6,3060,3833,2996,-837
2017,2,4,7,2846,3635,2829,-806
2017,2,4,8,2802,3509,2721,-788
2017,2,4,9,2737,3471,2678,-793
2017,2,4,10,2754,3504,2698,-806
2017,2,4,11,2853,3627,2756,-871
2017,2,4,12,3136,3918,2956,-962
2017,2,4,13,3520,4306,3236,-1070
2017,2,4,14,3748,4772,3595,-1177
2017,2,4,15,3990,5070,3939,-1131
2017,2,4,16,4014,5203,4009,-1194
2017,2,4,17,4022,5208,4033,-1175
2017,2,4,18,4061,5219,4067,-1152
2017,2,4,19,4030,5174,4055,-1119
2017,2,4,20,4014,5167,4085,-1082
2017,2,4,21,3999,5168,4086,-1082
2017,2,4,22,4026,5180,4092,-1088
2017,2,4,23,3997,5173,4040,-1133
2017,2,5,0,4194,5426,4201,-1225
2017,2,5,1,4102,5409,4175,-1234
2017,2,5,2,3937,5183,4000,-1183
2017,2,5,3,3716,4883,3778,-1105
2017,2,5,4,3463,4541,3498,-1043
2017,2,5,5,3188,4167,3179,-988
2017,2,5,6,2967,3855,2911,-944
2017,2,5,7,2813,3667,2759,-908
2017,2,5,8,2746,3591,2685,-906
2017,2,5,9,2736,3574,2670,-904
2017,2,5,10,2778,3626,2697,-929
2017,2,5,11,2849,3753,2769,-984
2017,2,5,12,3106,4040,2970,-1070
2017,2,5,13,3386,4418,3264,-1154
2017,2,5,14,3729,4932,3640,-1292
2017,2,5,15,3889,5230,3933,-1297
2017,2,5,16,3937,5266,4016,-1250
2017,2,5,17,3925,5145,3947,-1198
2017,2,5,18,3997,5182,4053,-1129
2017,2,5,19,4000,5211,4104,-1107
2017,2,5,20,4013,5286,4189,-1097
2017,2,5,21,4031,5292,4125,-1167
2017,2,5,22,4059,5354,4184,-1170
2017,2,5,23,4047,5367,4184,-1183
2017,2,6,0,4264,5532,4299,-1233
2017,2,6,1,4160,5360,4161,-1199
2017,2,6,2,4000,5151,3980,-1171
2017,2,6,3,3754,4883,3783,-1100
2017,2,6,4,3463,4546,3500,-1046
2017,2,6,5,3146,4245,3246,-999
2017,2,6,6,2830,3974,3061,-913
2017,2,6,7,2663,3798,2907,-891
2017,2,6,8,2618,3766,2862,-904
2017,2,6,9,2641,3809,2886,-923
2017,2,6,10,2762,3992,2999,-993
2017,2,6,11,3113,4480,3351,-1129
2017,2,6,12,3720,5273,3972,-1301
2017,2,6,13,4034,5705,4355,-1350
2017,2,6,14,4056,5687,4394,-1293
2017,2,6,15,4056,5519,4312,-1207
2017,2,6,16,4131,5433,4299,-1134
2017,2,6,17,4192,5386,4265,-1121
2017,2,6,18,4233,5412,4284,-1128
2017,2,6,19,4284,5447,4270,-1177
2017,2,6,20,4354,5525,4267,-1258
2017,2,6,21,4424,5650,4290,-1360
2017,2,6,22,4463,5736,4294,-1442
2017,2,6,23,4389,5794,4302,-1492
2017,2,7,0,4670,6099,4501,-1598
2017,2,7,1,4784,6123,4543,-1580
2017,2,7,2,4532,5831,4310,-1521
2017,2,7,3,4127,5358,4019,-1339
2017,2,7,4,3720,4773,3552,-1221
2017,2,7,5,3306,4249,3215,-1034
2017,2,7,6,2991,3747,2793,-954
2017,2,7,7,2806,3557,2622,-935
2017,2,7,8,2713,3474,2553,-921
2017,2,7,9,2671,3482,2549,-933
2017,2,7,10,2770,3607,2620,-987
2017,2,7,11,3087,4009,2811,-1198
2017,2,7,12,3656,4761,3355,-1406
2017,2,7,13,3943,5110,3713,-1397
2017,2,7,14,3965,5154,3752,-1402
2017,2,7,15,4069,5196,3821,-1375
2017,2,7,16,4204,5326,3914,-1412
2017,2,7,17,4317,5474,4010,-1464
2017,2,7,18,4435,5659,4024,-1635
2017,2,7,19,4599,5807,4143,-1664
2017,2,7,20,4704,5973,4274,-1699
2017,2,7,21,4816,6084,4272,-1812
2017,2,7,22,4870,6131,4304,-1827
2017,2,7,23,4781,6142,4281,-1861
2017,2,8,0,4865,6352,4407,-1945
2017,2,8,1,4974,6364,4425,-1939
2017,2,8,2,4729,6010,4294,-1716
2017,2,8,3,4315,5481,4099,-1382
2017,2,8,4,3861,4889,3653,-1236
2017,2,8,5,3418,4299,3289,-1010
2017,2,8,6,3172,3823,2900,-923
2017,2,8,7,2954,3531,2643,-888
2017,2,8,8,2842,3393,2515,-878
2017,2,8,9,2751,3343,2481,-862
2017,2,8,10,2796,3426,2532,-894
2017,2,8,11,3017,3765,2693,-1072
2017,2,8,12,3582,4430,3217,-1213
2017,2,8,13,3834,4784,3521,-1263
2017,2,8,14,4003,4912,3643,-1269
2017,2,8,15,4199,5115,3845,-1270
2017,2,8,16,4455,5357,3947,-1410
2017,2,8,17,4685,5595,3988,-1607
2017,2,8,18,4927,5811,4134,-1677
2017,2,8,19,5096,6006,4322,-1684
2017,2,8,20,5169,6178,4480,-1698
2017,2,8,21,5288,6290,4576,-1714
2017,2,8,22,5353,6352,4628,-1724
2017,2,8,23,5319,6365,4593,-1772
2017,2,9,0,5348,6591,4742,-1849
2017,2,9,1,5151,6584,4723,-1861
2017,2,9,2,4971,6274,4480,-1794
2017,2,9,3,4590,5808,4259,-1549
2017,2,9,4,4143,5219,3902,-1317
2017,2,9,5,3693,4647,3518,-1129
2017,2,9,6,3234,4216,3174,-1042
2017,2,9,7,3006,3963,2999,-964
2017,2,9,8,2838,3801,2865,-936
2017,2,9,9,2741,3742,2805,-937
2017,2,9,10,2800,3819,2856,-963
2017,2,9,11,3063,4145,3071,-1074
2017,2,9,12,3614,4819,3546,-1273
2017,2,9,13,3877,5173,3841,-1332
2017,2,9,14,4039,5345,3986,-1359
2017,2,9,15,4209,5591,4195,-1396
2017,2,9,16,4391,5884,4343,-1541
2017,2,9,17,4550,6079,4359,-1720
2017,2,9,18,4599,6227,4478,-1749
2017,2,9,19,4646,6296,4554,-1742
2017,2,9,20,4651,6307,4580,-1727
2017,2,9,21,4634,6254,4420,-1834
2017,2,9,22,4572,6196,4372,-1824
2017,2,9,23,4435,6062,4351,-1711
2017,2,10,0,4629,6096,4323,-1773
2017,2,10,1,4615,6046,4274,-1772
2017,2,10,2,4427,5742,4138,-1604
2017,2,10,3,4080,5253,3848,-1405
2017,2,10,4,3669,4709,3406,-1303
2017,2,10,5,3176,4159,2925,-1234
2017,2,10,6,3018,3829,2623,-1206
2017,2,10,7,3001,3623,2429,-1194
2017,2,10,8,2988,3578,2389,-1189
2017,2,10,9,3058,3616,2381,-1235
2017,2,10,10,3244,3778,2483,-1295
2017,2,10,11,3662,4285,2751,-1534
2017,2,10,12,4350,5178,3403,-1775
2017,2,10,13,4797,5751,3915,-1836
2017,2,10,14,4746,5815,4006,-1809
2017,2,10,15,4528,5723,3978,-1745
2017,2,10,16,4326,5541,3859,-1682
2017,2,10,17,4217,5355,3709,-1646
2017,2,10,18,4144,5211,3624,-1587
2017,2,10,19,4094,5132,3712,-1420
2017,2,10,20,4097,5098,3801,-1297
2017,2,10,21,4070,5097,3846,-1251
2017,2,10,22,4118,5163,3872,-1291
2017,2,10,23,4119,5188,3891,-1297
2017,2,11,0,4256,5420,4033,-1387
2017,2,11,1,4286,5500,4096,-1404
2017,2,11,2,4152,5343,3981,-1362
2017,2,11,3,3908,5096,3767,-1329
2017,2,11,4,3677,4806,3500,-1306
2017,2,11,5,3388,4438,3182,-1256
2017,2,11,6,3099,4161,3004,-1157
2017,2,11,7,3006,3978,2974,-1004
2017,2,11,8,2930,3942,2936,-1006
2017,2,11,9,2895,3930,2912,-1018
2017,2,11,10,2938,4038,2973,-1065
2017,2,11,11,3116,4246,3086,-1160
2017,2,11,12,3383,4632,3337,-1295
2017,2,11,13,3654,5132,3703,-1429
2017,2,11,14,3927,5436,3987,-1449
2017,2,11,15,4031,5367,4034,-1333
2017,2,11,16,4034,5251,4035,-1216
2017,2,11,17,4085,5154,4007,-1147
2017,2,11,18,4055,5160,4034,-1126
2017,2,11,19,4044,5173,4058,-1115
2017,2,11,20,4029,5269,4101,-1168
2017,2,11,21,4042,5378,4206,-1172
2017,2,11,22,4016,5487,4298,-1189
2017,2,11,23,3972,5463,4136,-1327
2017,2,12,0,4117,5501,4140,-1361
2017,2,12,1,4146,5480,4118,-1362
2017,2,12,2,3934,5195,3929,-1266
2017,2,12,3,3707,4870,3862,-1008
2017,2,12,4,3450,4501,3552,-949
2017,2,12,5,3209,4066,3228,-838
2017,2,12,6,3046,3740,2948,-792
2017,2,12,7,2842,3519,2750,-769
2017,2,12,8,2818,3406,2658,-748
2017,2,12,9,2746,3385,2631,-754
2017,2,12,10,2765,3416,2645,-771
2017,2,12,11,2843,3559,2754,-805
2017,2,12,12,3072,3853,2929,-924
2017,2,12,13,3353,4257,3241,-1016
2017,2,12,14,3655,4726,3601,-1125
2017,2,12,15,3858,4976,3818,-1158
2017,2,12,16,4014,5080,3919,-1161
2017,2,12,17,4079,5156,3933,-1223
2017,2,12,18,4209,5281,3866,-1415
2017,2,12,19,4297,5414,3965,-1449
2017,2,12,20,4335,5559,4083,-1476
2017,2,12,21,4365,5689,4047,-1642
2017,2,12,22,4393,5754,4102,-1652
2017,2,12,23,4353,5760,4101,-1659
2017,2,13,0,4504,5925,4209,-1716
2017,2,13,1,4559,5960,4247,-1713
2017,2,13,2,4318,5621,4003,-1618
2017,2,13,3,3964,5178,3780,-1398
2017,2,13,4,3596,4621,3360,-1261
2017,2,13,5,3225,4098,2940,-1158
2017,2,13,6,2939,3711,2697,-1014
2017,2,13,7,2731,3472,2517,-955
2017,2,13,8,2631,3351,2420,-931
2017,2,13,9,2613,3344,2415,-929
2017,2,13,10,2677,3441,2489,-952
2017,2,13,11,2932,3804,2735,-1069
2017,2,13,12,3471,4477,3175,-1302
2017,2,13,13,3759,4840,3376,-1464
2017,2,13,14,3860,5028,3454,-1574
2017,2,13,15,3977,5228,3593,-1635
2017,2,13,16,4138,5470,3819,-1651
2017,2,13,17,4239,5611,3954,-1657
2017,2,13,18,4331,5743,4043,-1700
2017,2,13,19,4396,5838,4104,-1734
2017,2,13,20,4479,5890,4129,-1761
2017,2,13,21,4488,5974,4181,-1793
2017,2,13,22,4481,6005,4262,-1743
2017,2,13,23,4492,5991,4246,-1745
2017,2,14,0,4682,6155,4385,-1770
2017,2,14,1,4700,6202,4430,-1772
2017,2,14,2,4472,5863,4130,-1733
2017,2,14,3,4078,5376,3755,-1621
2017,2,14,4,3672,4795,3282,-1513
2017,2,14,5,3265,4224,2905,-1319
2017,2,14,6,3006,3787,2669,-1118
2017,2,14,7,2800,3557,2568,-989
2017,2,14,8,2710,3439,2474,-965
2017,2,14,9,2655,3415,2459,-956
2017,2,14,10,2718,3526,2526,-1000
2017,2,14,11,2993,3913,2791,-1122
2017,2,14,12,3530,4624,3251,-1373
2017,2,14,13,3824,4952,3403,-1549
2017,2,14,14,3924,5015,3303,-1712
2017,2,14,15,4001,5131,3222,-1909
2017,2,14,16,4145,5347,3469,-1878
2017,2,14,17,4263,5491,3706,-1785
2017,2,14,18,4412,5687,3856,-1831
2017,2,14,19,4524,5905,4036,-1869
2017,2,14,20,4676,6089,4099,-1990
2017,2,14,21,4721,6238,4170,-2068
2017,2,14,22,4739,6307,4251,-2056
2017,2,14,23,4696,6261,4238,-2023
2017,2,15,0,4799,6369,4305,-2064
2017,2,15,1,4834,6365,4307,-2058
2017,2,15,2,4635,6009,4194,-1815
2017,2,15,3,4233,5504,3820,-1684
2017,2,15,4,3791,4941,3391,-1550
2017,2,15,5,3357,4338,3043,-1295
2017,2,15,6,3065,3899,2767,-1132
2017,2,15,7,2856,3642,2637,-1005
2017,2,15,8,2746,3490,2531,-959
2017,2,15,9,2710,3454,2499,-955
2017,2,15,10,2774,3556,2560,-996
2017,2,15,11,3024,3872,2779,-1093
2017,2,15,12,3535,4527,3243,-1284
2017,2,15,13,3757,4838,3521,-1317
2017,2,15,14,3884,5018,3693,-1325
2017,2,15,15,4067,5235,3863,-1372
2017,2,15,16,4255,5466,3951,-1515
2017,2,15,17,4401,5642,3949,-1693
2017,2,15,18,4516,5814,3874,-1940
2017,2,15,19,4566,5954,3968,-1986
2017,2,15,20,4627,5998,4037,-1961
2017,2,15,21,4695,6001,4043,-1958
2017,2,15,22,4712,5968,3989,-1979
2017,2,15,23,4489,5921,3955,-1966
2017,2,16,0,4716,6072,4055,-2017
2017,2,16,1,4801,6153,4116,-2037
2017,2,16,2,4532,5819,4037,-1782
2017,2,16,3,4168,5322,3636,-1686
2017,2,16,4,3750,4759,3209,-1550
2017,2,16,5,3355,4204,2919,-1285
2017,2,16,6,2998,3773,2694,-1079
2017,2,16,7,2763,3550,2587,-963
2017,2,16,8,2629,3427,2486,-941
2017,2,16,9,2659,3416,2472,-944
2017,2,16,10,2769,3529,2547,-982
2017,2,16,11,3139,3913,2806,-1107
2017,2,16,12,3715,4599,3239,-1360
2017,2,16,13,4138,4988,3521,-1467
2017,2,16,14,4092,5104,3627,-1477
2017,2,16,15,4150,5149,3717,-1432
2017,2,16,16,4171,5209,3789,-1420
2017,2,16,17,4184,5213,3714,-1499
2017,2,16,18,4195,5176,3371,-1805
2017,2,16,19,4252,5160,3349,-1811
2017,2,16,20,4240,5174,3354,-1820
2017,2,16,21,4223,5196,3392,-1804
2017,2,16,22,4267,5255,3458,-1797
2017,2,16,23,4187,5342,3501,-1841
2017,2,17,0,4502,5633,3680,-1953
2017,2,17,1,4632,5813,3802,-2011
2017,2,17,2,4462,5643,3623,-2020
2017,2,17,3,4300,5310,3536,-1774
2017,2,17,4,4032,4909,3208,-1701
2017,2,17,5,3732,4484,2862,-1622
2017,2,17,6,3192,4240,2651,-1589
2017,2,17,7,3089,4121,2530,-1591
2017,2,17,8,3058,4110,2491,-1619
2017,2,17,9,3127,4226,2545,-1681
2017,2,17,10,3270,4475,2613,-1862
2017,2,17,11,3660,5074,2965,-2109
2017,2,17,12,4296,6058,3739,-2319
2017,2,17,13,4771,6621,4223,-2398
2017,2,17,14,4624,6482,4180,-2302
2017,2,17,15,4396,6021,3846,-2175
2017,2,17,16,4275,5632,3572,-2060
2017,2,17,17,4138,5361,3480,-1881
2017,2,17,18,4073,5214,3431,-1783
2017,2,17,19,4097,5140,3256,-1884
2017,2,17,20,4147,5144,3295,-1849
2017,2,17,21,4104,5208,3412,-1796
2017,2,17,22,4100,5259,3549,-1710
2017,2,17,23,4038,5257,3521,-1736
2017,2,18,0,4186,5425,3625,-1800
2017,2,18,1,4286,5486,3652,-1834
2017,2,18,2,4088,5311,3565,-1746
2017,2,18,3,3825,5066,3502,-1564
2017,2,18,4,3584,4747,3245,-1502
2017,2,18,5,3314,4377,3177,-1200
2017,2,18,6,3103,4093,3074,-1019
2017,2,18,7,2953,3904,2932,-972
2017,2,18,8,2895,3840,2875,-965
2017,2,18,9,2882,3819,2851,-968
2017,2,18,10,2950,3887,2871,-1016
2017,2,18,11,3085,4059,2983,-1076
2017,2,18,12,3306,4378,3257,-1121
2017,2,18,13,3610,4775,3641,-1134
2017,2,18,14,3850,5137,3995,-1142
2017,2,18,15,3986,5224,4128,-1096
2017,2,18,16,4070,5231,4080,-1151
2017,2,18,17,4028,5229,4061,-1168
2017,2,18,18,4007,5232,4017,-1215
2017,2,18,19,4009,5246,3977,-1269
2017,2,18,20,3994,5175,3887,-1288
2017,2,18,21,3959,5095,3844,-1251
2017,2,18,22,3940,5091,3838,-1253
2017,2,18,23,3963,5154,3862,-1292
2017,2,19,0,4165,5371,4159,-1212
2017,2,19,1,4204,5388,4270,-1118
2017,2,19,2,4051,5189,4084,-1105
2017,2,19,3,3825,4902,3795,-1107
2017,2,19,4,3580,4550,3515,-1035
2017,2,19,5,3337,4161,3227,-934
2017,2,19,6,3080,3817,2938,-879
2017,2,19,7,2865,3583,2759,-824
2017,2,19,8,2750,3431,2633,-798
2017,2,19,9,2708,3359,2571,-788
2017,2,19,10,2648,3333,2543,-790
2017,2,19,11,2684,3442,2598,-844
2017,2,19,12,2828,3676,2768,-908
2017,2,19,13,3046,3995,3003,-992
2017,2,19,14,3424,4489,3374,-1115
2017,2,19,15,3747,4930,3607,-1323
2017,2,19,16,4004,5171,3700,-1471
2017,2,19,17,4054,5345,3770,-1575
2017,2,19,18,4295,5535,3968,-1567
2017,2,19,19,4458,5689,4154,-1535
2017,2,19,20,4513,5830,4274,-1556
2017,2,19,21,4527,5944,4363,-1581
2017,2,19,22,4574,6021,4324,-1697
2017,2,19,23,4500,5987,4303,-1684
2017,2,20,0,4569,5964,4273,-1691
2017,2,20,1,4595,5954,4261,-1693
2017,2,20,2,4266,5590,4213,-1377
2017,2,20,3,3975,5141,3977,-1164
2017,2,20,4,3658,4632,3646,-986
2017,2,20,5,3286,4095,3190,-905
2017,2,20,6,2970,3694,2868,-826
2017,2,20,7,2781,3458,2670,-788
2017,2,20,8,2689,3338,2588,-750
2017,2,20,9,2694,3296,2546,-750
2017,2,20,10,2761,3416,2624,-792
2017,2,20,11,3005,3726,2846,-880
2017,2,20,12,3442,4297,3346,-951
2017,2,20,13,3812,4706,3631,-1075
2017,2,20,14,3963,5024,3740,-1284
2017,2,20,15,4108,5240,3829,-1411
2017,2,20,16,4323,5472,3999,-1473
2017,2,20,17,4402,5659,4030,-1629
2017,2,20,18,4590,5890,4204,-1686
2017,2,20,19,4817,6116,4386,-1730
2017,2,20,20,4918,6366,4571,-1795
2017,2,20,21,5034,6581,4729,-1852
2017,2,20,22,5034,6663,4701,-1962
2017,2,20,23,4977,6608,4690,-1918
2017,2,21,0,4966,6608,4678,-1930
2017,2,21,1,5017,6597,4677,-1920
2017,2,21,2,4744,6177,4480,-1697
2017,2,21,3,4320,5605,4174,-1431
2017,2,21,4,3882,4981,3756,-1225
2017,2,21,5,3417,4333,3306,-1027
2017,2,21,6,3030,3854,2870,-984
2017,2,21,7,2823,3575,2627,-948
2017,2,21,8,2731,3439,2514,-925
2017,2,21,9,2714,3395,2469,-926
2017,2,21,10,2762,3483,2542,-941
2017,2,21,11,3001,3839,2793,-1046
2017,2,21,12,3511,4485,3200,-1285
2017,2,21,13,3773,4833,3544,-1289
2017,2,21,14,3906,4972,3646,-1326
2017,2,21,15,4016,5114,3730,-1384
2017,2,21,16,4250,5288,3822,-1466
2017,2,21,17,4357,5399,3931,-1468
2017,2,21,18,4504,5481,3946,-1535
2017,2,21,19,4574,5550,4068,-1482
2017,2,21,20,4720,5637,4108,-1529
2017,2,21,21,4822,5686,4157,-1529
2017,2,21,22,4842,5775,4241,-1534
2017,2,21,23,4775,5872,4262,-1610
2017,2,22,0,4870,6113,4398,-1715
2017,2,22,1,4921,6218,4458,-1760
2017,2,22,2,4701,5902,4175,-1727
2017,2,22,3,4279,5431,3849,-1582
2017,2,22,4,3826,4855,3342,-1513
2017,2,22,5,3383,4297,3138,-1159
2017,2,22,6,3099,3901,2856,-1045
2017,2,22,7,2873,3648,2654,-994
2017,2,22,8,2732,3513,2541,-972
2017,2,22,9,2730,3479,2513,-966
2017,2,22,10,2786,3559,2573,-986
2017,2,22,11,3026,3912,2910,-1002
2017,2,22,12,3514,4510,3365,-1145
2017,2,22,13,3786,4950,3772,-1178
2017,2,22,14,3916,5074,3882,-1192
2017,2,22,15,4054,5227,3907,-1320
2017,2,22,16,4244,5396,3914,-1482
2017,2,22,17,4386,5436,3903,-1533
2017,2,22,18,4445,5448,3897,-1551
2017,2,22,19,4474,5417,3890,-1527
2017,2,22,20,4513,5358,3835,-1523
2017,2,22,21,4517,5339,3791,-1548
2017,2,22,22,4503,5376,3814,-1562
2017,2,22,23,4491,5481,3866,-1615
2017,2,23,0,4622,5720,4045,-1675
2017,2,23,1,4709,5807,4117,-1690
2017,2,23,2,4484,5593,3991,-1602
2017,2,23,3,4125,5206,3849,-1357
2017,2,23,4,3737,4696,3524,-1172
2017,2,23,5,3284,4161,3168,-993
2017,2,23,6,2945,3747,2980,-767
2017,2,23,7,2730,3540,2716,-824
2017,2,23,8,2602,3399,2594,-805
2017,2,23,9,2601,3367,2576,-791
2017,2,23,10,2661,3499,2678,-821
2017,2,23,11,2965,3855,3002,-853
2017,2,23,12,3494,4508,3566,-942
2017,2,23,13,3787,4899,3898,-1001
2017,2,23,14,3963,5001,3853,-1148
2017,2,23,15,4070,5114,3923,-1191
2017,2,23,16,4166,5279,4066,-1213
2017,2,23,17,4278,5373,4150,-1223
2017,2,23,18,4361,5493,4255,-1238
2017,2,23,19,4465,5606,4339,-1267
2017,2,23,20,4518,5694,4342,-1352
2017,2,23,21,4574,5763,4339,-1424
2017,2,23,22,4587,5835,4408,-1427
2017,2,23,23,4560,5856,4423,-1433
2017,2,24,0,4688,5997,4502,-1495
2017,2,24,1,4753,6148,4673,-1475
2017,2,24,2,4519,5929,4561,-1368
2017,2,24,3,4168,5497,4255,-1242
2017,2,24,4,3808,4959,3824,-1135
2017,2,24,5,3360,4372,3380,-992
2017,2,24,6,3048,3921,2988,-933
2017,2,24,7,2861,3646,2661,-985
2017,2,24,8,2698,3496,2543,-953
2017,2,24,9,2703,3439,2494,-945
2017,2,24,10,2744,3510,2539,-971
2017,2,24,11,2962,3818,2813,-1005
2017,2,24,12,3452,4476,3311,-1165
2017,2,24,13,3719,4794,3622,-1172
2017,2,24,14,3920,5011,3802,-1209
2017,2,24,15,4119,5250,3919,-1331
2017,2,24,16,4354,5571,4057,-1514
2017,2,24,17,4595,5792,4120,-1672
2017,2,24,18,4762,6114,4354,-1760
2017,2,24,19,4941,6371,4552,-1819
2017,2,24,20,5087,6627,4715,-1912
2017,2,24,21,5175,6778,4862,-1916
2017,2,24,22,5117,6814,4888,-1926
2017,2,24,23,4997,6589,4699,-1890
2017,2,25,0,5058,6374,4598,-1776
2017,2,25,1,5033,6287,4541,-1746
2017,2,25,2,4742,5920,4337,-1583
2017,2,25,3,4368,5498,4152,-1346
2017,2,25,4,4006,5059,3950,-1109
2017,2,25,5,3564,4552,3511,-1041
2017,2,25,6,3254,4086,3175,-911
2017,2,25,7,3008,3769,2919,-850
2017,2,25,8,2888,3580,2774,-806
2017,2,25,9,2816,3482,2685,-797
2017,2,25,10,2777,3447,2648,-799
2017,2,25,11,2830,3525,2703,-822
2017,2,25,12,3031,3755,2930,-825
2017,2,25,13,3257,4092,3241,-851
2017,2,25,14,3625,4630,3721,-909
2017,2,25,15,3948,5079,3975,-1104
2017,2,25,16,4248,5401,4098,-1303
2017,2,25,17,4451,5556,4042,-1514
2017,2,25,18,4586,5672,4026,-1646
2017,2,25,19,4730,5883,4185,-1698
2017,2,25,20,4873,6074,4284,-1790
2017,2,25,21,4900,6236,4414,-1822
2017,2,25,22,4860,6264,4462,-1802
2017,2,25,23,4650,6118,4333,-1785
2017,2,26,0,4651,5967,4216,-1751
2017,2,26,1,4675,5936,4198,-1738
2017,2,26,2,4398,5603,4074,-1529
2017,2,26,3,4004,5221,3917,-1304
2017,2,26,4,3670,4800,3714,-1086
2017,2,26,5,3283,4367,3416,-951
2017,2,26,6,3035,3909,3044,-865
2017,2,26,7,2795,3636,2815,-821
2017,2,26,8,2632,3453,2670,-783
2017,2,26,9,2633,3365,2597,-768
2017,2,26,10,2613,3346,2557,-789
2017,2,26,11,2718,3419,2597,-822
2017,2,26,12,2938,3662,2744,-918
2017,2,26,13,3234,4044,2992,-1052
2017,2,26,14,3602,4556,3367,-1189
2017,2,26,15,3805,4913,3765,-1148
2017,2,26,16,3886,5012,3846,-1166
2017,2,26,17,3940,5045,3861,-1184
2017,2,26,18,4077,5139,3954,-1185
2017,2,26,19,4059,5230,4056,-1174
2017,2,26,20,4074,5333,4147,-1186
2017,2,26,21,4097,5468,4249,-1219
2017,2,26,22,4151,5565,4309,-1256
2017,2,26,23,4153,5536,4289,-1247
2017,2,27,0,4305,5592,4333,-1259
2017,2,27,1,4397,5735,4416,-1319
2017,2,27,2,4163,5421,4191,-1230
2017,2,27,3,3820,4989,3857,-1132
2017,2,27,4,3407,4508,3438,-1070
2017,2,27,5,3164,4017,3091,-926
2017,2,27,6,2817,3695,2827,-868
2017,2,27,7,2595,3492,2654,-838
2017,2,27,8,2498,3412,2584,-828
2017,2,27,9,2504,3423,2580,-843
2017,2,27,10,2573,3552,2673,-879
2017,2,27,11,2907,3985,2957,-1028
2017,2,27,12,3488,4713,3511,-1202
2017,2,27,13,3805,5075,3846,-1229
2017,2,27,14,3938,5148,3984,-1164
2017,2,27,15,3982,5239,3976,-1263
2017,2,27,16,4124,5407,3986,-1421
2017,2,27,17,4234,5660,4078,-1582
2017,2,27,18,4360,5911,4278,-1633
2017,2,27,19,4571,6138,4516,-1622
2017,2,27,20,4709,6374,4675,-1699
2017,2,27,21,4859,6584,4888,-1696
2017,2,27,22,4926,6746,5041,-1705
2017,2,27,23,4971,6704,5015,-1689
2017,2,28,0,4948,6707,5064,-1643
2017,2,28,1,4970,6768,5099,-1669
2017,2,28,2,4759,6384,4807,-1577
2017,2,28,3,4383,5828,4462,-1366
2017,2,28,4,3995,5189,4042,-1147
2017,2,28,5,3509,4543,3574,-969
2017,2,28,6,3227,4087,3020,-1067
2017,2,28,7,2986,3804,2771,-1033
2017,2,28,8,2843,3619,2620,-999
2017,2,28,9,2809,3553,2567,-986
2017,2,28,10,2841,3626,2626,-1000
2017,2,28,11,3098,3976,2849,-1127
2017,2,28,12,3558,4593,3357,-1236
2017,2,28,13,3824,4900,3632,-1268
2017,2,28,14,4061,5119,3827,-1292
2017,2,28,15,4305,5451,4002,-1449
2017,2,28,16,4600,5899,4207,-1692
2017,2,28,17,4886,6315,4427,-1888
2017,2,28,18,5113,6744,4745,-1999
2017,2,28,19,5318,7085,5043,-2042
2017,2,28,20,5447,7364,5391,-1973
2017,2,28,21,5584,7507,5494,-2013
2017,2,28,22,5586,7593,5549,-2044
2017,2,28,23,5536,7433,5407,-2026
2017,3,1,0,5548,7284,5288,-1996
2017,3,1,1,5476,7258,5242,-2016
2017,3,1,2,5179,6797,5013,-1784
2017,3,1,3,4718,6177,4679,-1498
2017,3,1,4,4229,5580,4256,-1324
2017,3,1,5,3759,4896,3665,-1231
2017,3,1,6,3395,4343,3384,-959
2017,3,1,7,3105,3996,3102,-894
2017,3,1,8,2955,3803,2951,-852
2017,3,1,9,2880,3716,2890,-826
2017,3,1,10,2910,3744,2900,-844
2017,3,1,11,3140,4017,3079,-938
2017,3,1,12,3583,4637,3566,-1071
2017,3,1,13,3835,4941,3781,-1160
2017,3,1,14,4028,5255,4044,-1211
2017,3,1,15,4300,5631,4210,-1421
2017,3,1,16,4636,6084,4446,-1638
2017,3,1,17,4878,6510,4698,-1812
2017,3,1,18,5088,6952,5036,-1916
2017,3,1,19,5337,7354,5348,-2006
2017,3,1,20,5526,7624,5650,-1974
2017,3,1,21,5652,7805,5799,-2006
2017,3,1,22,5662,7779,5814,-1965
2017,3,1,23,5626,7541,5684,-1857
2017,3,2,0,5544,7261,5454,-1807
2017,3,2,1,5466,7162,5187,-1975
2017,3,2,2,5169,6768,4805,-1963
2017,3,2,3,4742,6156,4348,-1808
2017,3,2,4,4279,5475,3802,-1673
2017,3,2,5,3809,4774,3474,-1300
2017,3,2,6,3485,4252,3176,-1076
2017,3,2,7,3176,3923,3041,-882
2017,3,2,8,3020,3745,2920,-825
2017,3,2,9,2945,3660,2838,-822
2017,3,2,10,2957,3711,2875,-836
2017,3,2,11,3214,4027,3097,-930
2017,3,2,12,3703,4642,3575,-1067
2017,3,2,13,3948,4983,3844,-1139
2017,3,2,14,4125,5278,4094,-1184
2017,3,2,15,4458,5581,4222,-1359
2017,3,2,16,4716,5946,4396,-1550
2017,3,2,17,4924,6291,4549,-1742
2017,3,2,18,5093,6633,4835,-1798
2017,3,2,19,5267,6947,5059,-1888
2017,3,2,20,5390,7206,5285,-1921
2017,3,2,21,5491,7241,5312,-1929
2017,3,2,22,5461,7106,5235,-1871
2017,3,2,23,5234,6829,4968,-1861
2017,3,3,0,5130,6649,4807,-1842
2017,3,3,1,5217,6556,4709,-1847
2017,3,3,2,4946,6175,4512,-1663
2017,3,3,3,4485,5679,4247,-1432
2017,3,3,4,4065,5067,3891,-1176
2017,3,3,5,3600,4457,3491,-966
2017,3,3,6,3152,3971,3092,-879
2017,3,3,7,2886,3691,2846,-845
2017,3,3,8,2746,3547,2732,-815
2017,3,3,9,2674,3481,2664,-817
2017,3,3,10,2696,3565,2694,-871
2017,3,3,11,2933,3945,2943,-1002
2017,3,3,12,3460,4634,3418,-1216
2017,3,3,13,3822,5042,3801,-1241
2017,3,3,14,4004,5154,3953,-1201
2017,3,3,15,4120,5210,4071,-1139
2017,3,3,16,4168,5237,4154,-1083
2017,3,3,17,4240,5256,4209,-1047
2017,3,3,18,4343,5268,4197,-1071
2017,3,3,19,4467,5304,4230,-1074
2017,3,3,20,4525,5356,4298,-1058
2017,3,3,21,4584,5412,4355,-1057
2017,3,3,22,4585,5451,4380,-1071
2017,3,3,23,4481,5364,4284,-1080
2017,3,4,0,4460,5388,4278,-1110
2017,3,4,1,4504,5506,4365,-1141
2017,3,4,2,4284,5303,4178,-1125
2017,3,4,3,3991,5031,3937,-1094
2017,3,4,4,3689,4679,3635,-1044
2017,3,4,5,3345,4313,3306,-1007
2017,3,4,6,3108,4008,3009,-999
2017,3,4,7,2914,3849,2861,-988
2017,3,4,8,2858,3805,2806,-999
2017,3,4,9,2825,3815,2786,-1029
2017,3,4,10,2834,3942,2877,-1065
2017,3,4,11,2981,4167,2973,-1194
2017,3,4,12,3234,4573,3330,-1243
2017,3,4,13,3568,5082,3723,-1359
2017,3,4,14,3800,5357,3920,-1437
2017,3,4,15,3919,5345,3993,-1352
2017,3,4,16,3932,5227,3990,-1237
2017,3,4,17,3940,5090,3932,-1158
2017,3,4,18,3941,5014,3895,-1119
2017,3,4,19,3904,4974,3878,-1096
2017,3,4,20,3899,4963,3871,-1092
2017,3,4,21,3920,5018,3913,-1105
2017,3,4,22,3937,5061,3951,-1110
2017,3,4,23,3963,5051,3933,-1118
2017,3,5,0,4005,5171,4044,-1127
2017,3,5,1,4175,5300,4149,-1151
2017,3,5,2,4010,5097,3979,-1118
2017,3,5,3,3806,4806,3757,-1049
2017,3,5,4,3539,4468,3440,-1028
2017,3,5,5,3220,4074,3109,-965
2017,3,5,6,2930,3778,2902,-876
2017,3,5,7,2749,3558,2713,-845
2017,3,5,8,2637,3465,2631,-834
2017,3,5,9,2600,3429,2588,-841
2017,3,5,10,2608,3472,2603,-869
2017,3,5,11,2667,3585,2662,-923
2017,3,5,12,2829,3848,2838,-1010
2017,3,5,13,3128,4202,3014,-1188
2017,3,5,14,3480,4654,3243,-1411
2017,3,5,15,3679,4928,3355,-1573
2017,3,5,16,3761,5011,3375,-1636
2017,3,5,17,3801,5047,3410,-1637
2017,3,5,18,3846,5089,3446,-1643
2017,3,5,19,3932,5083,3449,-1634
2017,3,5,20,3977,5110,3470,-1640
2017,3,5,21,4017,5107,3429,-1678
2017,3,5,22,4062,5122,3446,-1676
2017,3,5,23,4096,5169,3452,-1717
2017,3,6,0,4181,5387,3611,-1776
2017,3,6,1,4282,5570,3715,-1855
2017,3,6,2,4083,5336,3566,-1770
2017,3,6,3,3735,4935,3340,-1595
2017,3,6,4,3407,4436,2942,-1494
2017,3,6,5,3134,3942,2715,-1227
2017,3,6,6,2831,3703,2681,-1022
2017,3,6,7,2644,3504,2667,-837
2017,3,6,8,2551,3425,2607,-818
2017,3,6,9,2511,3432,2604,-828
2017,3,6,10,2616,3558,2699,-859
2017,3,6,11,2959,3955,2988,-967
2017,3,6,12,3438,4669,3514,-1155
2017,3,6,13,3760,4986,3737,-1249
2017,3,6,14,3904,5077,3705,-1372
2017,3,6,15,4013,5180,3681,-1499
2017,3,6,16,4125,5301,3758,-1543
2017,3,6,17,4200,5377,3722,-1655
2017,3,6,18,4279,5457,3760,-1697
2017,3,6,19,4340,5530,3832,-1698
2017,3,6,20,4380,5584,3894,-1690
2017,3,6,21,4434,5670,3960,-1710
2017,3,6,22,4449,5713,3980,-1733
2017,3,6,23,4457,5747,4002,-1745
2017,3,7,0,4527,5872,4080,-1792
2017,3,7,1,4654,6074,4236,-1838
2017,3,7,2,4439,5794,4047,-1747
2017,3,7,3,4084,5319,3716,-1603
2017,3,7,4,3715,4784,3283,-1501
2017,3,7,5,3257,4260,3054,-1206
2017,3,7,6,2926,3746,2776,-970
2017,3,7,7,2715,3530,2722,-808
2017,3,7,8,2572,3411,2632,-779
2017,3,7,9,2566,3400,2647,-753
2017,3,7,10,2658,3510,2678,-832
2017,3,7,11,2969,3929,2996,-933
2017,3,7,12,3487,4594,3480,-1114
2017,3,7,13,3773,4955,3866,-1089
2017,3,7,14,3909,5015,3747,-1268
2017,3,7,15,4040,5095,3708,-1387
2017,3,7,16,4185,5245,3765,-1480
2017,3,7,17,4294,5388,3885,-1503
2017,3,7,18,4427,5576,4037,-1539
2017,3,7,19,4527,5724,4196,-1528
2017,3,7,20,4651,5796,4222,-1574
2017,3,7,21,4718,5865,4244,-1621
2017,3,7,22,4758,5938,4282,-1656
2017,3,7,23,4725,5992,4309,-1683
2017,3,8,0,4736,6117,4410,-1707
2017,3,8,1,4877,6280,4529,-1751
2017,3,8,2,4635,5969,4285,-1684
2017,3,8,3,4252,5495,3937,-1558
2017,3,8,4,3830,4914,3457,-1457
2017,3,8,5,3356,4324,3072,-1252
2017,3,8,6,3069,3878,2831,-1047
2017,3,8,7,2846,3613,2777,-836
2017,3,8,8,2743,3492,2684,-808
2017,3,8,9,2710,3422,2624,-798
2017,3,8,10,2780,3502,2685,-817
2017,3,8,11,3035,3875,2936,-939
2017,3,8,12,3511,4486,3390,-1096
2017,3,8,13,3761,4827,3725,-1102
2017,3,8,14,3945,5035,3835,-1200
2017,3,8,15,4145,5259,3888,-1371
2017,3,8,16,4404,5552,3944,-1608
2017,3,8,17,4654,5835,4148,-1687
2017,3,8,18,4871,6109,4371,-1738
2017,3,8,19,5056,6344,4418,-1926
2017,3,8,20,5213,6549,4528,-2021
2017,3,8,21,5370,6673,4629,-2044
2017,3,8,22,5409,6704,4678,-2026
2017,3,8,23,5357,6624,4640,-1984
2017,3,9,0,5213,6597,4631,-1966
2017,3,9,1,5192,6652,4667,-1985
2017,3,9,2,4960,6316,4561,-1755
2017,3,9,3,4535,5806,4188,-1618
2017,3,9,4,4073,5169,3662,-1507
2017,3,9,5,3595,4535,3253,-1282
2017,3,9,6,3163,4030,2992,-1038
2017,3,9,7,2907,3727,2894,-833
2017,3,9,8,2791,3556,2769,-787
2017,3,9,9,2748,3475,2693,-782
2017,3,9,10,2802,3576,2767,-809
2017,3,9,11,3055,3897,2996,-901
2017,3,9,12,3525,4489,3510,-979
2017,3,9,13,3783,4840,3874,-966
2017,3,9,14,3968,5039,3859,-1180
2017,3,9,15,4173,5316,3921,-1395
2017,3,9,16,4455,5656,4080,-1576
2017,3,9,17,4719,6003,4383,-1620
2017,3,9,18,4955,6340,4517,-1823
2017,3,9,19,5160,6665,4738,-1927
2017,3,9,20,5340,6905,4867,-2038
2017,3,9,21,5474,7074,4983,-2091
2017,3,9,22,5522,7144,5028,-2116
2017,3,9,23,5435,6991,4901,-2090
2017,3,10,0,5273,6776,4798,-1978
2017,3,10,1,5256,6766,4830,-1936
2017,3,10,2,4989,6397,4549,-1848
2017,3,10,3,4588,5859,4192,-1667
2017,3,10,4,4154,5200,3669,-1531
2017,3,10,5,3655,4559,3305,-1254
2017,3,10,6,3154,4071,3039,-1032
2017,3,10,7,2909,3775,2935,-840
2017,3,10,8,2772,3579,2781,-798
2017,3,10,9,2724,3510,2715,-795
2017,3,10,10,2747,3549,2733,-816
2017,3,10,11,2962,3863,2946,-917
2017,3,10,12,3382,4410,3374,-1036
2017,3,10,13,3687,4776,3716,-1060
2017,3,10,14,3917,5021,3847,-1174
2017,3,10,15,4104,5317,3910,-1407
2017,3,10,16,4381,5649,4092,-1557
2017,3,10,17,4616,5897,4301,-1596
2017,3,10,18,4877,6161,4400,-1761
2017,3,10,19,5093,6416,4531,-1885
2017,3,10,20,5321,6626,4615,-2011
2017,3,10,21,5418,6829,4717,-2112
2017,3,10,22,5506,6901,4796,-2105
2017,3,10,23,5380,6737,4667,-2070
2017,3,11,0,5114,6449,4509,-1940
2017,3,11,1,5119,6385,4530,-1855
2017,3,11,2,4823,6011,4266,-1745
2017,3,11,3,4400,5588,3996,-1592
2017,3,11,4,4047,5058,3577,-1481
2017,3,11,5,3612,4550,3364,-1186
2017,3,11,6,3217,4100,3192,-908
2017,3,11,7,2974,3793,3046,-747
2017,3,11,8,2837,3612,2892,-720
2017,3,11,9,2757,3509,2800,-709
2017,3,11,10,2720,3469,2699,-770
2017,3,11,11,2793,3550,2728,-822
2017,3,11,12,2930,3781,2858,-923
2017,3,11,13,3164,4139,3138,-1001
2017,3,11,14,3557,4654,3540,-1114
2017,3,11,15,3924,5030,3896,-1134
2017,3,11,16,4121,5317,4017,-1300
2017,3,11,17,4326,5538,3918,-1620
2017,3,11,18,4546,5833,4000,-1833
2017,3,11,19,4765,6109,4224,-1885
2017,3,11,20,4928,6341,4417,-1924
2017,3,11,21,5055,6478,4520,-1958
2017,3,11,22,5112,6507,4551,-1956
2017,3,11,23,5043,6316,4410,-1906
2017,3,12,0,4922,6104,4244,-1860
2017,3,12,1,4863,6052,4320,-1732
2017,3,12,2,4618,5714,4074,-1640
2017,3,12,3,4245,5305,3886,-1419
2017,3,12,4,3912,4862,3544,-1318
2017,3,12,5,3501,4365,3259,-1106
2017,3,12,6,3091,4090,3204,-886
2017,3,12,7,2808,3820,2994,-826
2017,3,12,8,2719,3650,2856,-794
2017,3,12,9,2650,3590,2801,-789
2017,3,12,10,2616,3611,2810,-801
2017,3,12,11,2630,3747,2899,-848
2017,3,12,12,2715,3981,3158,-823
2017,3,12,13,2994,4265,3331,-934
2017,3,12,14,3378,4739,3700,-1039
2017,3,12,15,3769,5117,3882,-1235
2017,3,12,16,4005,5409,3977,-1432
2017,3,12,17,4224,5659,4052,-1607
2017,3,12,18,4424,5825,4165,-1660
2017,3,12,19,4483,5880,4252,-1628
2017,3,12,20,4550,5884,4243,-1641
2017,3,12,21,4648,5946,4272,-1674
2017,3,12,22,4655,5963,4286,-1677
2017,3,12,23,4640,5897,4216,-1681
2017,3,13,0,4496,5906,4333,-1573
2017,3,13,1,4559,5937,4366,-1571
2017,3,13,2,4430,5561,4212,-1349
2017,3,13,3,4150,5052,3733,-1319
2017,3,13,4,3679,4502,3426,-1076
2017,3,13,5,2999,3867,2995,-872
2017,3,13,6,2695,3560,2742,-818
2017,3,13,7,2640,3408,2607,-801
2017,3,13,8,2637,3343,2557,-786
2017,3,13,9,2767,3420,2589,-831
2017,3,13,10,3060,3720,2894,-826
2017,3,13,11,3414,4243,3334,-909
2017,3,13,12,3679,4648,3727,-921
2017,3,13,13,3801,4802,3809,-993
2017,3,13,14,4050,5028,3768,-1260
2017,3,13,15,4213,5280,3858,-1422
2017,3,13,16,4347,5457,3900,-1557
2017,3,13,17,4435,5591,4002,-1589
2017,3,13,18,4473,5664,4070,-1594
2017,3,13,19,4574,5696,4182,-1514
2017,3,13,20,4680,5685,4175,-1510
2017,3,13,21,4753,5718,4180,-1538
2017,3,13,22,4741,5761,4178,-1583
2017,3,13,23,4638,5817,4190,-1627
2017,3,14,0,4733,5943,4299,-1644
2017,3,14,1,4644,5857,4212,-1645
2017,3,14,2,4234,5477,4027,-1450
2017,3,14,3,3740,5004,3647,-1357
2017,3,14,4,3353,4494,3360,-1134
2017,3,14,5,3044,4071,3199,-872
2017,3,14,6,2769,3788,2913,-875
2017,3,14,7,2726,3616,2774,-842
2017,3,14,8,2711,3540,2702,-838
2017,3,14,9,2829,3588,2723,-865
2017,3,14,10,3085,3862,2916,-946
2017,3,14,11,3471,4371,3307,-1064
2017,3,14,12,3734,4801,3725,-1076
2017,3,14,13,3857,4942,3826,-1116
2017,3,14,14,3996,5121,3825,-1296
2017,3,14,15,4143,5264,3808,-1456
2017,3,14,16,4236,5299,3743,-1556
2017,3,14,17,4323,5257,3704,-1553
2017,3,14,18,4382,5167,3649,-1518
2017,3,14,19,4411,5110,3605,-1505
2017,3,14,20,4506,5109,3617,-1492
2017,3,14,21,4576,5189,3693,-1496
2017,3,14,22,4522,5249,3706,-1543
2017,3,14,23,4476,5299,3786,-1513
2017,3,15,0,4523,5613,4035,-1578
2017,3,15,1,4537,5765,4083,-1682
2017,3,15,2,4236,5479,3976,-1503
2017,3,15,3,3763,5031,3615,-1416
2017,3,15,4,3333,4561,3392,-1169
2017,3,15,5,2979,4191,3224,-967
2017,3,15,6,2830,4024,3037,-987
2017,3,15,7,2857,3984,2984,-1000
2017,3,15,8,2993,4037,3020,-1017
2017,3,15,9,3189,4214,3155,-1059
2017,3,15,10,3668,4688,3579,-1109
2017,3,15,11,4058,5452,4101,-1351
2017,3,15,12,4419,6035,4533,-1502
2017,3,15,13,4395,6221,4562,-1659
2017,3,15,14,4397,6239,4502,-1737
2017,3,15,15,4369,6184,4532,-1652
2017,3,15,16,4315,5964,4608,-1356
2017,3,15,17,4333,5710,4338,-1372
2017,3,15,18,4242,5451,4176,-1275
2017,3,15,19,4183,5281,4065,-1216
2017,3,15,20,4225,5172,3977,-1195
2017,3,15,21,4292,5177,3946,-1231
2017,3,15,22,4278,5254,3828,-1426
2017,3,15,23,4350,5369,3751,-1618
2017,3,16,0,4540,5726,3996,-1730
2017,3,16,1,4725,6198,4334,-1864
2017,3,16,2,4498,6150,4397,-1753
2017,3,16,3,4297,5915,4199,-1716
2017,3,16,4,3810,5580,4037,-1543
2017,3,16,5,4112,5341,3924,-1417
2017,3,16,6,4041,5297,3905,-1392
2017,3,16,7,4040,5379,3937,-1442
2017,3,16,8,4153,5530,3992,-1538
2017,3,16,9,4433,5833,4116,-1717
2017,3,16,10,4956,6464,4463,-2001
2017,3,16,11,5805,7420,5134,-2286
2017,3,16,12,6401,8105,5684,-2421
2017,3,16,13,6300,8213,5658,-2555
2017,3,16,14,5985,7782,5344,-2438
2017,3,16,15,5461,7225,5115,-2110
2017,3,16,16,5101,6718,5014,-1704
2017,3,16,17,4873,6220,4724,-1496
2017,3,16,18,4573,5792,4478,-1314
2017,3,16,19,4409,5474,4254,-1220
2017,3,16,20,4414,5290,4097,-1193
2017,3,16,21,4370,5230,4018,-1212
2017,3,16,22,4456,5268,3880,-1388
2017,3,16,23,4390,5332,3782,-1550
2017,3,17,0,4554,5643,4006,-1637
2017,3,17,1,4891,6079,4334,-1745
2017,3,17,2,4802,6012,4371,-1641
2017,3,17,3,4642,5732,4149,-1583
2017,3,17,4,4340,5410,4032,-1378
2017,3,17,5,4079,5186,3844,-1342
2017,3,17,6,3993,5123,3771,-1352
2017,3,17,7,4032,5192,3782,-1410
2017,3,17,8,4071,5336,3832,-1504
2017,3,17,9,4256,5583,3924,-1659
2017,3,17,10,4645,6098,4207,-1891
2017,3,17,11,5332,6804,4814,-1990
2017,3,17,12,5824,7498,5471,-2027
2017,3,17,13,5690,7573,5505,-2068
2017,3,17,14,5346,7041,5079,-1962
2017,3,17,15,4887,6440,4613,-1827
2017,3,17,16,4538,5917,4304,-1613
2017,3,17,17,4371,5540,4173,-1367
2017,3,17,18,4134,5293,4172,-1121
2017,3,17,19,3892,5130,4054,-1076
2017,3,17,20,3868,5063,3989,-1074
2017,3,17,21,3830,5058,4008,-1050
2017,3,17,22,3886,5093,4003,-1090
2017,3,17,23,3871,5039,3946,-1093
2017,3,18,0,3967,5075,3966,-1109
2017,3,18,1,4214,5264,4091,-1173
2017,3,18,2,4037,5059,3942,-1117
2017,3,18,3,3857,4745,3703,-1042
2017,3,18,4,3581,4402,3414,-988
2017,3,18,5,3342,4155,3201,-954
2017,3,18,6,3122,3999,3072,-927
2017,3,18,7,3148,3967,3017,-950
2017,3,18,8,3147,4025,3038,-987
2017,3,18,9,3178,4169,3117,-1052
2017,3,18,10,3308,4414,3282,-1132
2017,3,18,11,3564,4843,3563,-1280
2017,3,18,12,3991,5356,3901,-1455
2017,3,18,13,4180,5752,4276,-1476
2017,3,18,14,4174,5648,4281,-1367
2017,3,18,15,4060,5395,4110,-1285
2017,3,18,16,3984,5170,4034,-1136
2017,3,18,17,3860,5047,3889,-1158
2017,3,18,18,3745,4986,3859,-1127
2017,3,18,19,3741,4979,3852,-1127
2017,3,18,20,3808,5039,3898,-1141
2017,3,18,21,3907,5149,3990,-1159
2017,3,18,22,3905,5228,4045,-1183
2017,3,18,23,3864,5213,4047,-1166
2017,3,19,0,4014,5128,3954,-1174
2017,3,19,1,4178,5247,4045,-1202
2017,3,19,2,4020,4967,3843,-1124
2017,3,19,3,3695,4617,3545,-1072
2017,3,19,4,3320,4181,3230,-951
2017,3,19,5,3012,3798,2925,-873
2017,3,19,6,2775,3535,2718,-817
2017,3,19,7,2683,3408,2608,-800
2017,3,19,8,2614,3347,2553,-794
2017,3,19,9,2604,3384,2576,-808
2017,3,19,10,2680,3480,2668,-812
2017,3,19,11,2867,3715,2806,-909
2017,3,19,12,3183,4015,3040,-975
2017,3,19,13,3484,4404,3319,-1085
2017,3,19,14,3808,4739,3481,-1258
2017,3,19,15,3916,4941,3508,-1433
2017,3,19,16,3977,5052,3489,-1563
2017,3,19,17,4007,5108,3528,-1580
2017,3,19,18,4084,5150,3568,-1582
2017,3,19,19,4117,5199,3599,-1600
2017,3,19,20,4201,5294,3680,-1614
2017,3,19,21,4283,5396,3748,-1648
2017,3,19,22,4275,5449,3794,-1655
2017,3,19,23,4174,5378,3725,-1653
2017,3,20,0,4240,5300,3659,-1641
2017,3,20,1,4353,5404,3720,-1684
2017,3,20,2,4056,5095,3611,-1484
2017,3,20,3,3681,4604,3259,-1345
2017,3,20,4,3252,4089,2997,-1092
2017,3,20,5,2894,3694,2832,-862
2017,3,20,6,2587,3472,2639,-833
2017,3,20,7,2605,3406,2567,-839
2017,3,20,8,2640,3465,2587,-878
2017,3,20,9,2666,3650,2717,-933
2017,3,20,10,3036,4095,3018,-1077
2017,3,20,11,3636,4846,3372,-1474
2017,3,20,12,4038,5452,3827,-1625
2017,3,20,13,4187,5609,3973,-1636
2017,3,20,14,4214,5485,3836,-1649
2017,3,20,15,4172,5330,3734,-1596
2017,3,20,16,4197,5253,3667,-1586
2017,3,20,17,4161,5230,3665,-1565
2017,3,20,18,4143,5244,3670,-1574
2017,3,20,19,4196,5291,3728,-1563
2017,3,20,20,4279,5382,3791,-1591
2017,3,20,21,4382,5562,3913,-1649
2017,3,20,22,4369,5710,4025,-1685
2017,3,20,23,4364,5665,3959,-1706
2017,3,21,0,4463,5685,3954,-1731
2017,3,21,1,4498,5763,3988,-1775
2017,3,21,2,4239,5349,3838,-1511
2017,3,21,3,3805,4810,3450,-1360
2017,3,21,4,3353,4263,3175,-1088
2017,3,21,5,2972,3835,2961,-874
2017,3,21,6,2750,3613,2761,-852
2017,3,21,7,2743,3506,2696,-810
2017,3,21,8,2752,3515,2674,-841
2017,3,21,9,2850,3643,2748,-895
2017,3,21,10,3178,4039,3015,-1024
2017,3,21,11,3655,4732,3519,-1213
2017,3,21,12,4009,5187,3933,-1254
2017,3,21,13,4089,5261,4010,-1251
2017,3,21,14,4043,5202,3886,-1316
2017,3,21,15,4101,5172,3776,-1396
2017,3,21,16,4146,5213,3710,-1503
2017,3,21,17,4144,5272,3770,-1502
2017,3,21,18,4143,5374,3849,-1525
2017,3,21,19,4215,5554,3975,-1579
2017,3,21,20,4335,5797,4138,-1659
2017,3,21,21,4497,6067,4441,-1626
2017,3,21,22,4562,6242,4566,-1676
2017,3,21,23,4481,6200,4571,-1629
2017,3,22,0,4520,6051,4478,-1573
2017,3,22,1,4638,6101,4487,-1614
2017,3,22,2,4277,5650,4195,-1455
2017,3,22,3,3811,5046,3698,-1348
2017,3,22,4,3358,4415,3309,-1106
2017,3,22,5,3072,3920,3039,-881
2017,3,22,6,2820,3643,2843,-800
2017,3,22,7,2712,3475,2719,-756
2017,3,22,8,2656,3439,2683,-756
2017,3,22,9,2709,3521,2716,-805
2017,3,22,10,2931,3804,2906,-898
2017,3,22,11,3380,4371,3341,-1030
2017,3,22,12,3717,4734,3660,-1074
2017,3,22,13,3802,4857,3813,-1044
2017,3,22,14,3985,5032,3879,-1153
2017,3,22,15,4133,5280,3971,-1309
2017,3,22,16,4308,5424,3980,-1444
2017,3,22,17,4393,5642,4090,-1552
2017,3,22,18,4690,5918,4311,-1607
2017,3,22,19,4910,6079,4216,-1863
2017,3,22,20,5119,6467,4529,-1938
2017,3,22,21,5301,6801,4835,-1966
2017,3,22,22,5338,6924,4960,-1964
2017,3,22,23,5299,6804,4866,-1938
2017,3,23,0,5072,6534,4674,-1860
2017,3,23,1,5049,6457,4585,-1872
2017,3,23,2,4687,5953,4330,-1623
2017,3,23,3,4261,5305,3870,-1435
2017,3,23,4,3712,4649,3479,-1170
2017,3,23,5,3294,4446,3536,-910
2017,3,23,6,2971,4103,3273,-830
2017,3,23,7,2814,3888,3107,-781
2017,3,23,8,2778,3776,3002,-774
2017,3,23,9,2815,3800,3009,-791
2017,3,23,10,3021,4054,3187,-867
2017,3,23,11,3422,4557,3583,-974
2017,3,23,12,3772,4925,3912,-1013
2017,3,23,13,3868,5029,4008,-1021
2017,3,23,14,4112,5338,4122,-1216
2017,3,23,15,4348,5672,4253,-1419
2017,3,23,16,4513,5920,4166,-1754
2017,3,23,17,4635,6094,4267,-1827
2017,3,23,18,4736,6277,4445,-1832
2017,3,23,19,4907,6408,4543,-1865
2017,3,23,20,5077,6453,4565,-1888
2017,3,23,21,5102,6419,4517,-1902
2017,3,23,22,5021,6343,4443,-1900
2017,3,23,23,4878,6156,4258,-1898
2017,3,24,0,4812,6025,4150,-1875
2017,3,24,1,4776,6108,4242,-1866
2017,3,24,2,4387,5745,4238,-1507
2017,3,24,3,3930,5214,3878,-1336
2017,3,24,4,3435,4608,3530,-1078
2017,3,24,5,3224,4091,3250,-841
2017,3,24,6,2910,3659,2874,-785
2017,3,24,7,2734,3475,2737,-738
2017,3,24,8,2672,3405,2673,-732
2017,3,24,9,2686,3478,2699,-779
2017,3,24,10,2901,3753,2888,-865
2017,3,24,11,3332,4285,3313,-972
2017,3,24,12,3699,4669,3660,-1009
2017,3,24,13,3877,4806,3760,-1046
2017,3,24,14,4106,5023,3819,-1204
2017,3,24,15,4276,5246,3882,-1364
2017,3,24,16,4404,5364,3873,-1491
2017,3,24,17,4495,5508,3928,-1580
2017,3,24,18,4627,5622,4060,-1562
2017,3,24,19,4794,5785,4174,-1611
2017,3,24,20,4969,5953,4282,-1671
2017,3,24,21,5026,6057,4375,-1682
2017,3,24,22,4937,6073,4369,-1704
2017,3,24,23,4783,5911,4238,-1673
2017,3,25,0,4703,5742,4109,-1633
2017,3,25,1,4767,5795,4154,-1641
2017,3,25,2,4403,5476,4030,-1446
2017,3,25,3,4050,5044,3691,-1353
2017,3,25,4,3628,4536,3427,-1109
2017,3,25,5,3123,4063,3195,-868
2017,3,25,6,2837,3746,2935,-811
2017,3,25,7,2652,3537,2775,-762
2017,3,25,8,2583,3429,2683,-746
2017,3,25,9,2559,3407,2653,-754
2017,3,25,10,2603,3471,2666,-805
2017,3,25,11,2723,3709,2829,-880
2017,3,25,12,2900,4006,3072,-934
2017,3,25,13,3290,4406,3389,-1017
2017,3,25,14,3684,4795,3596,-1199
2017,3,25,15,3949,5120,3728,-1392
2017,3,25,16,4137,5284,3771,-1513
2017,3,25,17,4381,5484,3908,-1576
2017,3,25,18,4640,5694,4092,-1602
2017,3,25,19,4899,5891,4129,-1762
2017,3,25,20,5145,6102,4291,-1811
2017,3,25,21,5324,6287,4431,-1856
2017,3,25,22,5347,6350,4484,-1866
2017,3,25,23,5154,6203,4391,-1812
2017,3,26,0,4850,5898,4226,-1672
2017,3,26,1,4768,5887,4196,-1691
2017,3,26,2,4473,5503,4054,-1449
2017,3,26,3,4076,5051,3678,-1373
2017,3,26,4,3635,4543,3421,-1122
2017,3,26,5,3292,3998,3126,-872
2017,3,26,6,2996,3678,2881,-797
2017,3,26,7,2799,3459,2698,-761
2017,3,26,8,2699,3358,2620,-738
2017,3,26,9,2645,3312,2583,-729
2017,3,26,10,2643,3365,2608,-757
2017,3,26,11,2761,3551,2717,-834
2017,3,26,12,2910,3796,2939,-857
2017,3,26,13,3254,4232,3255,-977
2017,3,26,14,3676,4728,3526,-1202
2017,3,26,15,3951,5154,3744,-1410
2017,3,26,16,4193,5463,3873,-1590
2017,3,26,17,4499,5840,4184,-1656
2017,3,26,18,4780,6138,4348,-1790
2017,3,26,19,5086,6425,4608,-1817
2017,3,26,20,5327,6695,4794,-1901
2017,3,26,21,5529,6891,4932,-1959
2017,3,26,22,5516,6975,4997,-1978
2017,3,26,23,5247,6781,4858,-1923
2017,3,27,0,5142,6473,4620,-1853
2017,3,27,1,5043,6488,4632,-1856
2017,3,27,2,4686,5987,4360,-1627
2017,3,27,3,4186,5302,3853,-1449
2017,3,27,4,3664,4572,3421,-1151
2017,3,27,5,3191,4047,3166,-881
2017,3,27,6,2900,3691,2902,-789
2017,3,27,7,2730,3494,2733,-761
2017,3,27,8,2636,3406,2649,-757
2017,3,27,9,2668,3428,2670,-758
2017,3,27,10,2904,3767,2894,-873
2017,3,27,11,3404,4367,3367,-1000
2017,3,27,12,3700,4763,3764,-999
2017,3,27,13,3840,4930,3941,-989
2017,3,27,14,4113,5227,4175,-1052
2017,3,27,15,4391,5573,4447,-1126
2017,3,27,16,4669,5904,4544,-1360
2017,3,27,17,4954,6270,4810,-1460
2017,3,27,18,5239,6622,4900,-1722
2017,3,27,19,5518,6968,5153,-1815
2017,3,27,20,5750,7233,5408,-1825
2017,3,27,21,5912,7439,5659,-1780
2017,3,27,22,5911,7403,5623,-1780
2017,3,27,23,5754,7228,5433,-1795
2017,3,28,0,5489,6905,5120,-1785
2017,3,28,1,5365,6831,5185,-1646
2017,3,28,2,5024,6258,4737,-1521
2017,3,28,3,4393,5527,4155,-1372
2017,3,28,4,3826,4746,3705,-1041
2017,3,28,5,3373,4168,3256,-912
2017,3,28,6,3057,3823,2987,-836
2017,3,28,7,2881,3609,2815,-794
2017,3,28,8,2776,3520,2771,-749
2017,3,28,9,2781,3550,2783,-767
2017,3,28,10,2999,3840,2977,-863
2017,3,28,11,3517,4473,3465,-1008
2017,3,28,12,3767,4821,3803,-1018
2017,3,28,13,3903,4939,3928,-1011
2017,3,28,14,4192,5218,4165,-1053
2017,3,28,15,4462,5568,4473,-1095
2017,3,28,16,4760,5888,4542,-1346
2017,3,28,17,5064,6310,4754,-1556
2017,3,28,18,5418,6772,5120,-1652
2017,3,28,19,5747,7141,5447,-1694
2017,3,28,20,6012,7488,5773,-1715
2017,3,28,21,6208,7753,6050,-1703
2017,3,28,22,6237,7770,6167,-1603
2017,3,28,23,6133,7633,6038,-1595
2017,3,29,0,5786,7258,5614,-1644
2017,3,29,1,5648,7123,5469,-1654
2017,3,29,2,5234,6566,4965,-1601
2017,3,29,3,4605,5800,4396,-1404
2017,3,29,4,4017,4996,3895,-1101
2017,3,29,5,3522,4514,3579,-935
2017,3,29,6,3182,4126,3255,-871
2017,3,29,7,2959,3910,3091,-819
2017,3,29,8,2855,3798,2997,-801
2017,3,29,9,2862,3823,2992,-831
2017,3,29,10,3072,4104,3184,-920
2017,3,29,11,3547,4690,3645,-1045
2017,3,29,12,3791,5027,4029,-998
2017,3,29,13,3928,5163,4140,-1023
2017,3,29,14,4233,5476,4403,-1073
2017,3,29,15,4580,5859,4576,-1283
2017,3,29,16,4900,6298,4805,-1493
2017,3,29,17,5277,6797,5287,-1510
2017,3,29,18,5630,7354,5779,-1575
2017,3,29,19,5986,7840,6206,-1634
2017,3,29,20,6267,8199,6444,-1755
2017,3,29,21,6474,8459,6611,-1848
2017,3,29,22,6504,8519,6687,-1832
2017,3,29,23,6431,8200,6536,-1664
2017,3,30,0,6011,7760,6109,-1651
2017,3,30,1,5812,7652,6141,-1511
2017,3,30,2,5394,7027,5546,-1481
2017,3,30,3,4734,6217,4794,-1423
2017,3,30,4,4131,5426,4308,-1118
2017,3,30,5,3648,4597,3610,-987
2017,3,30,6,3298,4145,3265,-880
2017,3,30,7,3071,3881,3063,-818
2017,3,30,8,2969,3735,2951,-784
2017,3,30,9,2994,3735,2951,-784
2017,3,30,10,3165,4030,3156,-874
2017,3,30,11,3617,4618,3602,-1016
2017,3,30,12,3888,4964,3957,-1007
2017,3,30,13,4035,5171,4141,-1030
2017,3,30,14,4305,5501,4436,-1065
2017,3,30,15,4672,5942,4612,-1330
2017,3,30,16,5055,6377,4917,-1460
2017,3,30,17,5492,6891,5281,-1610
2017,3,30,18,5821,7347,5691,-1656
2017,3,30,19,6146,7681,5891,-1790
2017,3,30,20,6423,8019,6018,-2001
2017,3,30,21,6618,8225,6243,-1982
2017,3,30,22,6614,8208,6223,-1985
2017,3,30,23,6551,7933,5995,-1938
2017,3,31,0,6087,7508,5584,-1924
2017,3,31,1,5932,7354,5517,-1837
2017,3,31,2,5482,6806,5269,-1537
2017,3,31,3,4809,5994,4576,-1418
2017,3,31,4,4219,5218,4088,-1130
2017,3,31,5,3688,4655,3685,-970
2017,3,31,6,3328,4214,3313,-901
2017,3,31,7,3100,3958,3099,-859
2017,3,31,8,2954,3840,2975,-865
2017,3,31,9,2941,3851,2989,-862
2017,3,31,10,3118,4138,3189,-949
2017,3,31,11,3556,4741,3647,-1094
2017,3,31,12,3814,5130,4075,-1055
2017,3,31,13,3990,5300,4254,-1046
2017,3,31,14,4281,5551,4434,-1117
2017,3,31,15,4620,5977,4595,-1382
2017,3,31,16,4887,6427,4919,-1508
2017,3,31,17,5180,6823,5225,-1598
2017,3,31,18,5447,7179,5199,-1980
2017,3,31,19,5672,7484,5347,-2137
2017,3,31,20,5869,7773,5454,-2319
2017,3,31,21,6004,7952,5696,-2256
2017,3,31,22,5862,7939,5779,-2160
2017,3,31,23,5636,7581,5578,-2003
2017,4,1,0,5260,7104,5370,-1734
2017,4,1,1,5175,6969,5448,-1521
2017,4,1,2,4881,6561,5201,-1360
2017,4,1,3,4379,5978,4668,-1310
2017,4,1,4,3930,5309,4117,-1192
2017,4,1,5,3717,4735,3705,-1030
2017,4,1,6,3372,4315,3377,-938
2017,4,1,7,3131,4020,3131,-889
2017,4,1,8,2968,3841,2990,-851
2017,4,1,9,2914,3777,2940,-837
2017,4,1,10,2922,3801,2960,-841
2017,4,1,11,3054,3993,3132,-861
2017,4,1,12,3188,4199,3288,-911
2017,4,1,13,3517,4650,3681,-969
2017,4,1,14,3934,5217,3959,-1258
2017,4,1,15,4338,5677,4158,-1519
2017,4,1,16,4715,6094,4411,-1683
2017,4,1,17,5203,6581,4760,-1821
2017,4,1,18,5567,7056,5138,-1918
2017,4,1,19,5892,7508,5462,-2046
2017,4,1,20,6138,7901,5682,-2219
2017,4,1,21,6342,8145,5860,-2285
2017,4,1,22,6288,8174,5864,-2310
2017,4,1,23,5912,7886,5785,-2101
2017,4,2,0,5463,7271,5333,-1938
2017,4,2,1,5299,6976,5050,-1926
2017,4,2,2,4954,6430,4766,-1664
2017,4,2,3,4473,5743,4230,-1513
2017,4,2,4,3988,5079,3927,-1152
2017,4,2,5,3581,4498,3540,-958
2017,4,2,6,3242,4042,3177,-865
2017,4,2,7,2997,3747,2941,-806
2017,4,2,8,2854,3589,2813,-776
2017,4,2,9,2778,3539,2744,-795
2017,4,2,10,2769,3564,2774,-790
2017,4,2,11,2915,3748,2904,-844
2017,4,2,12,3055,3938,3088,-850
2017,4,2,13,3401,4463,3490,-973
2017,4,2,14,3890,5064,3937,-1127
2017,4,2,15,4312,5580,4114,-1466
2017,4,2,16,4676,6179,4534,-1645
2017,4,2,17,5271,6843,5037,-1806
2017,4,2,18,5643,7504,5329,-2175
2017,4,2,19,6014,8045,5827,-2218
2017,4,2,20,6334,8443,6115,-2328
2017,4,2,21,6555,8597,6222,-2375
2017,4,2,22,6635,8515,6093,-2422
2017,4,2,23,6234,8112,5885,-2227
2017,4,3,0,5983,7645,5594,-2051
2017,4,3,1,5840,7480,5416,-2064
2017,4,3,2,5416,6918,5062,-1856
2017,4,3,3,4840,6223,4518,-1705
2017,4,3,4,4267,5485,4181,-1304
2017,4,3,5,3810,4867,3763,-1104
2017,4,3,6,3455,4457,3436,-1021
2017,4,3,7,3248,4236,3275,-961
2017,4,3,8,3105,4083,3155,-928
2017,4,3,9,3088,4098,3154,-944
2017,4,3,10,3316,4401,3456,-945
2017,4,3,11,3763,5060,4026,-1034
2017,4,3,12,4104,5425,4391,-1034
2017,4,3,13,4293,5671,4686,-985
2017,4,3,14,4650,6091,4911,-1180
2017,4,3,15,5108,6684,5185,-1499
2017,4,3,16,5497,7336,5737,-1599
2017,4,3,17,5964,7890,6261,-1629
2017,4,3,18,6375,8342,6465,-1877
2017,4,3,19,6725,8703,6695,-2008
2017,4,3,20,6951,8967,6801,-2166
2017,4,3,21,6967,9185,6978,-2207
2017,4,3,22,6963,9202,6978,-2224
2017,4,3,23,6686,8899,6796,-2103
2017,4,4,0,6367,8485,6659,-1826
2017,4,4,1,6224,8259,6695,-1564
2017,4,4,2,5748,7615,6188,-1427
2017,4,4,3,5128,6795,5388,-1407
2017,4,4,4,4560,5910,4751,-1159
2017,4,4,5,4018,5097,4107,-990
2017,4,4,6,3640,4723,3747,-976
2017,4,4,7,3449,4433,3510,-923
2017,4,4,8,3260,4238,3350,-888
2017,4,4,9,3222,4233,3334,-899
2017,4,4,10,3422,4526,3561,-965
2017,4,4,11,3898,5192,4160,-1032
2017,4,4,12,4216,5516,4290,-1226
2017,4,4,13,4395,5722,4321,-1401
2017,4,4,14,4771,6088,4630,-1458
2017,4,4,15,5224,6475,4911,-1564
2017,4,4,16,5637,6778,4976,-1802
2017,4,4,17,6016,7077,5216,-1861
2017,4,4,18,6410,7253,5384,-1869
2017,4,4,19,6708,7255,5413,-1842
2017,4,4,20,6895,7156,5347,-1809
2017,4,4,21,6935,7178,5358,-1820
2017,4,4,22,6903,7155,5310,-1845
2017,4,4,23,6655,7014,5109,-1905
2017,4,5,0,6362,6835,4929,-1906
2017,4,5,1,6239,6788,4912,-1876
2017,4,5,2,5799,6392,4704,-1688
2017,4,5,3,5144,5738,4396,-1342
2017,4,5,4,4608,5084,4026,-1058
2017,4,5,5,4098,4512,3678,-834
2017,4,5,6,3765,4157,3322,-835
2017,4,5,7,3549,3969,3143,-826
2017,4,5,8,3385,3861,3044,-817
2017,4,5,9,3343,3873,3050,-823
2017,4,5,10,3557,4188,3303,-885
2017,4,5,11,3976,4857,3892,-965
2017,4,5,12,4295,5196,3953,-1243
2017,4,5,13,4513,5380,3863,-1517
2017,4,5,14,4907,5822,4174,-1648
2017,4,5,15,5497,6410,4592,-1818
2017,4,5,16,5931,7025,5053,-1972
2017,4,5,17,6274,7685,5574,-2111
2017,4,5,18,6712,8270,5907,-2363
2017,4,5,19,7054,8770,6365,-2405
2017,4,5,20,7290,9144,6649,-2495
2017,4,5,21,7329,9344,6805,-2539
2017,4,5,22,7236,9306,6762,-2544
2017,4,5,23,6942,8981,6547,-2434
2017,4,6,0,6633,8483,6299,-2184
2017,4,6,1,6342,8323,6207,-2116
2017,4,6,2,5874,7682,5680,-2002
2017,4,6,3,5166,6850,5056,-1794
2017,4,6,4,4647,6009,4583,-1426
2017,4,6,5,4092,5324,4276,-1048
2017,4,6,6,3722,4920,3874,-1046
2017,4,6,7,3507,4684,3675,-1009
2017,4,6,8,3345,4565,3605,-960
2017,4,6,9,3330,4587,3637,-950
2017,4,6,10,3543,4750,3768,-982
2017,4,6,11,3903,5239,4225,-1014
2017,4,6,12,4194,5556,4546,-1010
2017,4,6,13,4275,5592,4643,-949
2017,4,6,14,4412,5766,4700,-1066
2017,4,6,15,4668,5946,4903,-1043
2017,4,6,16,4767,6119,5122,-997
2017,4,6,17,4945,6237,5241,-996
2017,4,6,18,5019,6351,5340,-1011
2017,4,6,19,5124,6455,5429,-1026
2017,4,6,20,5217,6574,5514,-1060
2017,4,6,21,5300,6554,5480,-1074
2017,4,6,22,5214,6606,5545,-1061
2017,4,6,23,4984,6324,5297,-1027
2017,4,7,0,4852,5971,4997,-974
2017,4,7,1,4854,5982,4976,-1006
2017,4,7,2,4502,5599,4625,-974
2017,4,7,3,3985,5011,4114,-897
2017,4,7,4,3520,4341,3459,-882
2017,4,7,5,3184,3869,3040,-829
2017,4,7,6,2906,3565,2793,-772
2017,4,7,7,2758,3398,2653,-745
2017,4,7,8,2647,3346,2613,-733
2017,4,7,9,2711,3412,2661,-751
2017,4,7,10,2933,3750,2952,-798
2017,4,7,11,3486,4389,3554,-835
2017,4,7,12,3801,4712,3867,-845
2017,4,7,13,3912,4844,3954,-890
2017,4,7,14,3966,4980,4072,-908
2017,4,7,15,4011,5096,4135,-961
2017,4,7,16,4069,5110,4084,-1026
2017,4,7,17,4187,5127,4071,-1056
2017,4,7,18,4292,5155,4104,-1051
2017,4,7,19,4438,5204,4136,-1068
2017,4,7,20,4579,5318,4251,-1067
2017,4,7,21,4598,5415,4411,-1004
2017,4,7,22,4579,5450,4388,-1062
2017,4,7,23,4414,5315,4300,-1015
2017,4,8,0,4337,5158,4154,-1004
2017,4,8,1,4215,5268,4181,-1087
2017,4,8,2,4071,5032,4001,-1031
2017,4,8,3,3791,4629,3674,-955
2017,4,8,4,3488,4203,3257,-946
2017,4,8,5,3034,3808,2968,-840
2017,4,8,6,2855,3550,2744,-806
2017,4,8,7,2763,3425,2630,-795
2017,4,8,8,2667,3387,2593,-794
2017,4,8,9,2680,3449,2625,-824
2017,4,8,10,2784,3638,2753,-885
2017,4,8,11,3134,4001,3079,-922
2017,4,8,12,3412,4386,3471,-915
2017,4,8,13,3817,4789,3821,-968
2017,4,8,14,3996,4970,4024,-946
2017,4,8,15,4046,4980,4024,-956
2017,4,8,16,4018,4940,3918,-1022
2017,4,8,17,4049,4927,3920,-1007
2017,4,8,18,4023,4933,3874,-1059
2017,4,8,19,4040,5006,3981,-1025
2017,4,8,20,4052,5143,4085,-1058
2017,4,8,21,4070,5296,4277,-1019
2017,4,8,22,4159,5403,4391,-1012
2017,4,8,23,4110,5334,4254,-1080
2017,4,9,0,4050,5174,4060,-1114
2017,4,9,1,4075,5249,4077,-1172
2017,4,9,2,3945,4955,3811,-1144
2017,4,9,3,3608,4550,3543,-1007
2017,4,9,4,3297,4115,3094,-1021
2017,4,9,5,2991,3885,3088,-797
2017,4,9,6,2797,3638,2885,-753
2017,4,9,7,2682,3498,2758,-740
2017,4,9,8,2626,3475,2737,-738
2017,4,9,9,2636,3511,2757,-754
2017,4,9,10,2720,3640,2817,-823
2017,4,9,11,2854,3932,3004,-928
2017,4,9,12,3093,4281,3327,-954
2017,4,9,13,3453,4720,3755,-965
2017,4,9,14,3712,4975,4023,-952
2017,4,9,15,3868,5044,3962,-1082
2017,4,9,16,3985,5102,3783,-1319
2017,4,9,17,3939,5212,3827,-1385
2017,4,9,18,4058,5344,3931,-1413
2017,4,9,19,4187,5585,4151,-1434
2017,4,9,20,4369,5867,4378,-1489
2017,4,9,21,4554,6178,4610,-1568
2017,4,9,22,4730,6356,4702,-1654
2017,4,9,23,4693,6278,4612,-1666
2017,4,10,0,4536,6071,4550,-1521
2017,4,10,1,4563,6131,4668,-1463
2017,4,10,2,4266,5722,4481,-1241
2017,4,10,3,3803,5073,4023,-1050
2017,4,10,4,3316,4421,3541,-880
2017,4,10,5,3030,3748,2976,-772
2017,4,10,6,2807,3460,2724,-736
2017,4,10,7,2681,3319,2622,-697
2017,4,10,8,2630,3282,2592,-690
2017,4,10,9,2680,3354,2631,-723
2017,4,10,10,2930,3687,2886,-801
2017,4,10,11,3304,4318,3316,-1002
2017,4,10,12,3571,4669,3667,-1002
2017,4,10,13,3731,4837,3838,-999
2017,4,10,14,3948,5068,3921,-1147
2017,4,10,15,4251,5323,4120,-1203
2017,4,10,16,4417,5562,4340,-1222
2017,4,10,17,4524,5836,4620,-1216
2017,4,10,18,4787,6084,4911,-1173
2017,4,10,19,5008,6407,5181,-1226
2017,4,10,20,5243,6675,5382,-1293
2017,4,10,21,5419,6969,5675,-1294
2017,4,10,22,5435,7108,5771,-1337
2017,4,10,23,5413,7012,5797,-1215
2017,4,11,0,5134,6751,5574,-1177
2017,4,11,1,5124,6693,5531,-1162
2017,4,11,2,4775,6174,5117,-1057
2017,4,11,3,4225,5438,4583,-855
2017,4,11,4,3699,4662,3972,-690
2017,4,11,5,3348,4097,3313,-784
2017,4,11,6,3070,3728,2954,-774
2017,4,11,7,2900,3532,2784,-748
2017,4,11,8,2825,3430,2697,-733
2017,4,11,9,2836,3467,2722,-745
2017,4,11,10,3069,3765,2939,-826
2017,4,11,11,3508,4387,3393,-994
2017,4,11,12,3746,4678,3663,-1015
2017,4,11,13,3922,4881,3840,-1041
2017,4,11,14,4168,5119,4083,-1036
2017,4,11,15,4463,5385,4251,-1134
2017,4,11,16,4697,5666,4470,-1196
2017,4,11,17,4917,5999,4850,-1149
2017,4,11,18,5129,6372,5134,-1238
2017,4,11,19,5330,6716,5407,-1309
2017,4,11,20,5510,7066,5748,-1318
2017,4,11,21,5727,7332,5966,-1366
2017,4,11,22,5740,7428,6063,-1365
2017,4,11,23,5634,7205,5909,-1296
2017,4,12,0,5384,6830,5582,-1248
2017,4,12,1,5297,6778,5526,-1252
2017,4,12,2,4979,6289,5016,-1273
2017,4,12,3,4405,5580,4497,-1083
2017,4,12,4,3851,4822,3865,-957
2017,4,12,5,3352,4223,3325,-898
2017,4,12,6,3077,3838,2999,-839
2017,4,12,7,2913,3639,2839,-800
2017,4,12,8,2839,3540,2764,-776
2017,4,12,9,2858,3581,2799,-782
2017,4,12,10,3072,3886,3030,-856
2017,4,12,11,3487,4488,3480,-1008
2017,4,12,12,3695,4786,3828,-958
2017,4,12,13,3848,4985,4000,-985
2017,4,12,14,4071,5262,4259,-1003
2017,4,12,15,4358,5578,4446,-1132
2017,4,12,16,4586,5914,4747,-1167
2017,4,12,17,4823,6224,5027,-1197
2017,4,12,18,5059,6643,5326,-1317
2017,4,12,19,5319,7023,5638,-1385
2017,4,12,20,5557,7311,5941,-1370
2017,4,12,21,5726,7505,6099,-1406
2017,4,12,22,5756,7440,6095,-1345
2017,4,12,23,5617,7209,5891,-1318
2017,4,13,0,5357,6906,5611,-1295
2017,4,13,1,5287,6896,5577,-1319
2017,4,13,2,4961,6446,5169,-1277
2017,4,13,3,4416,5747,4633,-1114
2017,4,13,4,3876,4974,3981,-993
2017,4,13,5,3384,4392,3480,-912
2017,4,13,6,3072,4002,3161,-841
2017,4,13,7,2907,3742,2968,-774
2017,4,13,8,2848,3620,2868,-752
2017,4,13,9,2871,3660,2902,-758
2017,4,13,10,3080,3937,3100,-837
2017,4,13,11,3528,4521,3522,-999
2017,4,13,12,3745,4807,3826,-981
2017,4,13,13,3921,5040,4041,-999
2017,4,13,14,4130,5350,4308,-1042
2017,4,13,15,4385,5723,4564,-1159
2017,4,13,16,4602,6027,4818,-1209
2017,4,13,17,4877,6347,5120,-1227
2017,4,13,18,5107,6696,5409,-1287
2017,4,13,19,5349,7007,5700,-1307
2017,4,13,20,5605,7262,5969,-1293
2017,4,13,21,5759,7445,6062,-1383
2017,4,13,22,5809,7413,6022,-1391
2017,4,13,23,5645,7198,5859,-1339
2017,4,14,0,5318,6779,5455,-1324
2017,4,14,1,5297,6714,5406,-1308
2017,4,14,2,4928,6272,5055,-1217
2017,4,14,3,4429,5566,4522,-1044
2017,4,14,4,3913,4846,3882,-964
2017,4,14,5,3443,4283,3359,-924
2017,4,14,6,3124,3908,3051,-857
2017,4,14,7,2945,3690,2883,-807
2017,4,14,8,2863,3547,2781,-766
2017,4,14,9,2865,3560,2761,-799
2017,4,14,10,3045,3777,2911,-866
2017,4,14,11,3413,4221,3227,-994
2017,4,14,12,3644,4495,3498,-997
2017,4,14,13,3899,4846,3801,-1045
2017,4,14,14,4199,5285,4221,-1064
2017,4,14,15,4505,5649,4470,-1179
2017,4,14,16,4758,5952,4689,-1263
2017,4,14,17,5014,6279,4873,-1406
2017,4,14,18,5252,6616,5184,-1432
2017,4,14,19,5466,6941,5493,-1448
2017,4,14,20,5678,7219,5637,-1582
2017,4,14,21,5790,7428,5792,-1636
2017,4,14,22,5753,7396,5774,-1622
2017,4,14,23,5595,7087,5538,-1549
2017,4,15,0,5199,6621,5296,-1325
2017,4,15,1,5099,6504,5210,-1294
2017,4,15,2,4854,6141,4894,-1247
2017,4,15,3,4440,5594,4411,-1183
2017,4,15,4,3979,4996,3966,-1030
2017,4,15,5,3485,4447,3455,-992
2017,4,15,6,3191,4043,3145,-898
2017,4,15,7,2995,3787,2942,-845
2017,4,15,8,2881,3638,2822,-816
2017,4,15,9,2830,3570,2755,-815
2017,4,15,10,2875,3620,2779,-841
2017,4,15,11,2999,3790,2891,-899
2017,4,15,12,3181,4015,3106,-909
2017,4,15,13,3618,4593,3553,-1040
2017,4,15,14,4063,5168,4112,-1056
2017,4,15,15,4445,5574,4434,-1140
2017,4,15,16,4723,5952,4641,-1311
2017,4,15,17,5003,6309,4902,-1407
2017,4,15,18,5216,6691,5189,-1502
2017,4,15,19,5488,6966,5368,-1598
2017,4,15,20,5710,7150,5505,-1645
2017,4,15,21,5823,7212,5597,-1615
2017,4,15,22,5864,7104,5488,-1616
2017,4,15,23,5697,6793,5154,-1639
2017,4,16,0,5274,6445,4980,-1465
2017,4,16,1,5112,6408,4975,-1433
2017,4,16,2,4808,6059,4702,-1357
2017,4,16,3,4392,5523,4368,-1155
2017,4,16,4,3946,4915,3891,-1024
2017,4,16,5,3606,4338,3369,-969
2017,4,16,6,3283,3920,3024,-896
2017,4,16,7,3033,3631,2807,-824
2017,4,16,8,2890,3488,2688,-800
2017,4,16,9,2853,3435,2647,-788
2017,4,16,10,2844,3502,2695,-807
2017,4,16,11,2939,3685,2801,-884
2017,4,16,12,3084,3920,3012,-908
2017,4,16,13,3526,4504,3460,-1044
2017,4,16,14,4007,5117,4043,-1074
2017,4,16,15,4410,5537,4348,-1189
2017,4,16,16,4718,5928,4587,-1341
2017,4,16,17,5043,6377,4927,-1450
2017,4,16,18,5317,6727,5177,-1550
2017,4,16,19,5544,6979,5413,-1566
2017,4,16,20,5771,7155,5539,-1616
2017,4,16,21,5876,7225,5600,-1625
2017,4,16,22,5925,7169,5565,-1604
2017,4,16,23,5689,6939,5370,-1569
2017,4,17,0,5368,6571,5076,-1495
2017,4,17,1,5314,6551,5069,-1482
2017,4,17,2,4964,6162,4757,-1405
2017,4,17,3,4413,5487,4315,-1172
2017,4,17,4,3864,4762,3779,-983
2017,4,17,5,3299,4187,3226,-961
2017,4,17,6,2972,3810,2906,-904
2017,4,17,7,2792,3576,2747,-829
2017,4,17,8,2722,3486,2660,-826
2017,4,17,9,2740,3529,2698,-831
2017,4,17,10,2936,3823,2921,-902
2017,4,17,11,3376,4407,3386,-1021
2017,4,17,12,3635,4691,3714,-977
2017,4,17,13,3905,4972,3964,-1008
2017,4,17,14,4264,5401,4383,-1018
2017,4,17,15,4596,5834,4699,-1135
2017,4,17,16,4956,6230,4859,-1371
2017,4,17,17,5373,6636,5154,-1482
2017,4,17,18,5678,7022,5449,-1573
2017,4,17,19,5918,7349,5822,-1527
2017,4,17,20,6132,7631,6053,-1578
2017,4,17,21,6288,7879,6191,-1688
2017,4,17,22,6303,7894,6160,-1734
2017,4,17,23,6056,7684,5995,-1689
2017,4,18,0,5899,7280,5673,-1607
2017,4,18,1,5744,7142,5560,-1582
2017,4,18,2,5305,6616,5180,-1436
2017,4,18,3,4614,5871,4673,-1198
2017,4,18,4,4040,5098,4082,-1016
2017,4,18,5,3516,4465,3436,-1029
2017,4,18,6,3194,4071,3106,-965
2017,4,18,7,3023,3812,2890,-922
2017,4,18,8,2917,3677,2789,-888
2017,4,18,9,2941,3684,2782,-902
2017,4,18,10,3161,3964,2976,-988
2017,4,18,11,3619,4554,3447,-1107
2017,4,18,12,3843,4846,3860,-986
2017,4,18,13,4064,5093,4095,-998
2017,4,18,14,4367,5503,4517,-986
2017,4,18,15,4702,5987,4822,-1165
2017,4,18,16,5091,6455,5134,-1321
2017,4,18,17,5484,6885,5462,-1423
2017,4,18,18,5847,7323,5618,-1705
2017,4,18,19,6087,7697,6016,-1681
2017,4,18,20,6356,8040,6316,-1724
2017,4,18,21,6550,8256,6448,-1808
2017,4,18,22,6521,8254,6422,-1832
2017,4,18,23,6280,7999,6206,-1793
2017,4,19,0,6109,7548,5881,-1667
2017,4,19,1,5938,7433,5900,-1533
2017,4,19,2,5480,6900,5465,-1435
2017,4,19,3,4793,6143,4894,-1249
2017,4,19,4,4190,5325,4230,-1095
2017,4,19,5,3683,4677,3631,-1046
2017,4,19,6,3347,4272,3243,-1029
2017,4,19,7,3138,3995,3034,-961
2017,4,19,8,3021,3829,2919,-910
2017,4,19,9,3045,3869,2932,-937
2017,4,19,10,3255,4138,3132,-1006
2017,4,19,11,3678,4712,3604,-1108
2017,4,19,12,3887,4993,3955,-1038
2017,4,19,13,4115,5254,4219,-1035
2017,4,19,14,4401,5649,4630,-1019
2017,4,19,15,4800,6119,5000,-1119
2017,4,19,16,5150,6576,5205,-1371
2017,4,19,17,5476,6971,5432,-1539
2017,4,19,18,5846,7359,5641,-1718
2017,4,19,19,6081,7734,5910,-1824
2017,4,19,20,6334,8067,6156,-1911
2017,4,19,21,6506,8267,6272,-1995
2017,4,19,22,6460,8295,6287,-2008
2017,4,19,23,6248,8022,6035,-1987
2017,4,20,0,5989,7567,5652,-1915
2017,4,20,1,5825,7432,5643,-1789
2017,4,20,2,5402,6901,5232,-1669
2017,4,20,3,4747,6134,4760,-1374
2017,4,20,4,4156,5326,4276,-1050
2017,4,20,5,3643,4677,3613,-1064
2017,4,20,6,3301,4221,3230,-991
2017,4,20,7,3095,3955,3025,-930
2017,4,20,8,2984,3794,2912,-882
2017,4,20,9,3003,3793,2906,-887
2017,4,20,10,3213,4045,3087,-958
2017,4,20,11,3644,4591,3545,-1046
2017,4,20,12,3864,4850,3860,-990
2017,4,20,13,4095,5075,4044,-1031
2017,4,20,14,4401,5482,4469,-1013
2017,4,20,15,4754,5912,4816,-1096
2017,4,20,16,5086,6365,5078,-1287
2017,4,20,17,5448,6799,5352,-1447
2017,4,20,18,5809,7288,5713,-1575
2017,4,20,19,6024,7764,6188,-1576
2017,4,20,20,6296,8125,6535,-1590
2017,4,20,21,6491,8396,6762,-1634
2017,4,20,22,6411,8426,6744,-1682
2017,4,20,23,6159,8147,6492,-1655
2017,4,21,0,5928,7636,6032,-1604
2017,4,21,1,5776,7417,5831,-1586
2017,4,21,2,5350,6832,5278,-1554
2017,4,21,3,4697,6078,4796,-1282
2017,4,21,4,4117,5260,4225,-1035
2017,4,21,5,3623,4633,3613,-1020
2017,4,21,6,3288,4188,3231,-957
2017,4,21,7,3102,3883,2993,-890
2017,4,21,8,2974,3736,2922,-814
2017,4,21,9,2973,3703,2895,-808
2017,4,21,10,3170,3953,3029,-924
2017,4,21,11,3597,4479,3464,-1015
2017,4,21,12,3809,4764,3774,-990
2017,4,21,13,4088,5078,4052,-1026
2017,4,21,14,4479,5506,4468,-1038
2017,4,21,15,4918,5917,4802,-1115
2017,4,21,16,5326,6319,5045,-1274
2017,4,21,17,5703,6825,5429,-1396
2017,4,21,18,6076,7313,5778,-1535
2017,4,21,19,6345,7853,6113,-1740
2017,4,21,20,6668,8314,6568,-1746
2017,4,21,21,6790,8573,6805,-1768
2017,4,21,22,6649,8519,6738,-1781
2017,4,21,23,6297,8178,6479,-1699
2017,4,22,0,5930,7558,5938,-1620
2017,4,22,1,5764,7218,5668,-1550
2017,4,22,2,5336,6751,5292,-1459
2017,4,22,3,4801,6102,4882,-1220
2017,4,22,4,4268,5427,4361,-1066
2017,4,22,5,3760,4771,3736,-1035
2017,4,22,6,3401,4286,3334,-952
2017,4,22,7,3160,3977,3088,-889
2017,4,22,8,3023,3774,2916,-858
2017,4,22,9,2958,3696,2864,-832
2017,4,22,10,2979,3731,2875,-856
2017,4,22,11,3103,3904,2999,-905
2017,4,22,12,3266,4140,3241,-899
2017,4,22,13,3729,4703,3693,-1010
2017,4,22,14,4216,5348,4312,-1036
2017,4,22,15,4705,5898,4694,-1204
2017,4,22,16,5154,6367,5019,-1348
2017,4,22,17,5528,6816,5370,-1446
2017,4,22,18,5867,7205,5547,-1658
2017,4,22,19,6161,7567,5852,-1715
2017,4,22,20,6387,7823,6134,-1689
2017,4,22,21,6550,7899,6175,-1724
2017,4,22,22,6547,7805,6073,-1732
2017,4,22,23,6234,7511,5875,-1636
2017,4,23,0,5793,7123,5539,-1584
2017,4,23,1,5659,6989,5440,-1549
2017,4,23,2,5262,6553,5134,-1419
2017,4,23,3,4757,5986,4770,-1216
2017,4,23,4,4281,5394,4306,-1088
2017,4,23,5,3827,4850,3781,-1069
2017,4,23,6,3465,4411,3432,-979
2017,4,23,7,3216,4127,3202,-925
2017,4,23,8,3088,3947,3057,-890
2017,4,23,9,3007,3850,2985,-865
2017,4,23,10,3015,3877,2994,-883
2017,4,23,11,3115,4023,3088,-935
2017,4,23,12,3282,4200,3257,-943
2017,4,23,13,3757,4792,3741,-1051
2017,4,23,14,4304,5548,4398,-1150
2017,4,23,15,4850,6203,4864,-1339
2017,4,23,16,5308,6728,5230,-1498
2017,4,23,17,5640,7221,5442,-1779
2017,4,23,18,5982,7667,5843,-1824
2017,4,23,19,6257,7991,6147,-1844
2017,4,23,20,6416,8184,6306,-1878
2017,4,23,21,6484,8284,6366,-1918
2017,4,23,22,6383,8292,6358,-1934
2017,4,23,23,6144,8104,6438,-1666
2017,4,24,0,5813,7641,6128,-1513
2017,4,24,1,5738,7456,5943,-1513
2017,4,24,2,5306,6961,5444,-1517
2017,4,24,3,4750,6154,4877,-1277
2017,4,24,4,4162,5394,4318,-1076
2017,4,24,5,3611,4798,3769,-1029
2017,4,24,6,3253,4408,3461,-947
2017,4,24,7,3055,4152,3251,-901
2017,4,24,8,2954,4004,3134,-870
2017,4,24,9,2978,4020,3134,-886
2017,4,24,10,3218,4295,3332,-963
2017,4,24,11,3647,4857,3764,-1093
2017,4,24,12,3895,5171,4081,-1090
2017,4,24,13,4107,5447,4301,-1146
2017,4,24,14,4408,5716,4519,-1197
2017,4,24,15,4706,6013,4674,-1339
2017,4,24,16,5006,6265,4916,-1349
2017,4,24,17,5150,6536,5077,-1459
2017,4,24,18,5332,6760,5328,-1432
2017,4,24,19,5530,6906,5588,-1318
2017,4,24,20,5651,6951,5646,-1305
2017,4,24,21,5691,6999,5721,-1278
2017,4,24,22,5569,6946,5671,-1275
2017,4,24,23,5434,6687,5477,-1210
2017,4,25,0,5227,6386,5197,-1189
2017,4,25,1,5222,6340,5148,-1192
2017,4,25,2,4838,5936,4798,-1138
2017,4,25,3,4300,5237,4170,-1067
2017,4,25,4,3733,4565,3611,-954
2017,4,25,5,3238,4056,3169,-887
2017,4,25,6,2946,3732,2895,-837
2017,4,25,7,2796,3559,2764,-795
2017,4,25,8,2713,3476,2694,-782
2017,4,25,9,2745,3523,2724,-799
2017,4,25,10,3008,3816,2919,-897
2017,4,25,11,3484,4376,3318,-1058
2017,4,25,12,3733,4625,3658,-967
2017,4,25,13,3891,4804,3833,-971
2017,4,25,14,4157,5038,3904,-1134
2017,4,25,15,4432,5318,4060,-1258
2017,4,25,16,4737,5558,4384,-1174
2017,4,25,17,5092,5854,4631,-1223
2017,4,25,18,5405,6148,4855,-1293
2017,4,25,19,5727,6495,5240,-1255
2017,4,25,20,5990,6873,5541,-1332
2017,4,25,21,6180,7127,5851,-1276
2017,4,25,22,6174,7257,5960,-1297
2017,4,25,23,6041,7117,5803,-1314
2017,4,26,0,5687,6744,5511,-1233
2017,4,26,1,5590,6616,5374,-1242
2017,4,26,2,5203,6126,4989,-1137
2017,4,26,3,4600,5386,4355,-1031
2017,4,26,4,3964,4672,3765,-907
2017,4,26,5,3309,4111,3226,-885
2017,4,26,6,3030,3762,2891,-871
2017,4,26,7,2851,3591,2746,-845
2017,4,26,8,2778,3509,2669,-840
2017,4,26,9,2798,3553,2703,-850
2017,4,26,10,3047,3863,2916,-947
2017,4,26,11,3490,4416,3342,-1074
2017,4,26,12,3665,4709,3695,-1014
2017,4,26,13,3891,4887,3895,-992
2017,4,26,14,4168,5155,4117,-1038
2017,4,26,15,4474,5444,4280,-1164
2017,4,26,16,4766,5751,4534,-1217
2017,4,26,17,5134,6141,4857,-1284
2017,4,26,18,5479,6567,5283,-1284
2017,4,26,19,5805,7010,5634,-1376
2017,4,26,20,6112,7507,5995,-1512
2017,4,26,21,6303,7945,6366,-1579
2017,4,26,22,6284,8175,6668,-1507
2017,4,26,23,6125,8091,6622,-1469
2017,4,27,0,5773,7650,6203,-1447
2017,4,27,1,5641,7429,5879,-1550
2017,4,27,2,5254,6865,5393,-1472
2017,4,27,3,4653,6047,4844,-1203
2017,4,27,4,4061,5258,4247,-1011
2017,4,27,5,3519,4625,3638,-987
2017,4,27,6,3224,4242,3331,-911
2017,4,27,7,3055,4004,3128,-876
2017,4,27,8,2954,3883,3043,-840
2017,4,27,9,2987,3915,3047,-868
2017,4,27,10,3219,4194,3259,-935
2017,4,27,11,3667,4774,3702,-1072
2017,4,27,12,3917,5062,4030,-1032
2017,4,27,13,4207,5433,4348,-1085
2017,4,27,14,4572,5946,4878,-1068
2017,4,27,15,5081,6616,5392,-1224
2017,4,27,16,5479,7287,5844,-1443
2017,4,27,17,6073,7928,6342,-1586
2017,4,27,18,6532,8513,6882,-1631
2017,4,27,19,6892,9073,7292,-1781
2017,4,27,20,7170,9530,7477,-2053
2017,4,27,21,7349,9816,7784,-2032
2017,4,27,22,7300,9838,7845,-1993
2017,4,27,23,7076,9577,7591,-1986
2017,4,28,0,6714,9020,7055,-1965
2017,4,28,1,6523,8660,6862,-1798
2017,4,28,2,6015,8042,6485,-1557
2017,4,28,3,5385,7167,5798,-1369
2017,4,28,4,4781,6264,5129,-1135
2017,4,28,5,4292,5485,4495,-990
2017,4,28,6,3918,4981,4088,-893
2017,4,28,7,3668,4624,3803,-821
2017,4,28,8,3503,4399,3625,-774
2017,4,28,9,3466,4353,3577,-776
2017,4,28,10,3652,4546,3714,-832
2017,4,28,11,4052,5037,4121,-916
2017,4,28,12,4331,5377,4490,-887
2017,4,28,13,4699,5821,4906,-915
2017,4,28,14,5229,6475,5460,-1015
2017,4,28,15,5872,7207,5902,-1305
2017,4,28,16,6364,7987,6296,-1691
2017,4,28,17,6895,8709,6781,-1928
2017,4,28,18,7304,9377,7362,-2015
2017,4,28,19,7633,9891,7686,-2205
2017,4,28,20,7882,10250,8012,-2238
2017,4,28,21,7993,10396,8079,-2317
2017,4,28,22,7863,10264,7944,-2320
2017,4,28,23,7530,9813,7567,-2246
2017,4,29,0,7093,9167,7070,-2097
2017,4,29,1,6848,8737,6737,-2000
2017,4,29,2,6381,8162,6328,-1834
2017,4,29,3,5732,7384,5836,-1548
2017,4,29,4,5126,6630,5365,-1265
2017,4,29,5,4643,5937,4821,-1116
2017,4,29,6,4207,5437,4441,-996
2017,4,29,7,3899,5053,4158,-895
2017,4,29,8,3694,4812,3916,-896
2017,4,29,9,3564,4679,3792,-887
2017,4,29,10,3551,4700,3793,-907
2017,4,29,11,3664,4825,3920,-905
2017,4,29,12,3837,5098,4205,-893
2017,4,29,13,4366,5786,4785,-1001
2017,4,29,14,5140,6538,5446,-1092
2017,4,29,15,5681,7286,5964,-1322
2017,4,29,16,6225,7901,6406,-1495
2017,4,29,17,6695,8505,6822,-1683
2017,4,29,18,7045,9002,7199,-1803
2017,4,29,19,7387,9384,7477,-1907
2017,4,29,20,7615,9619,7652,-1967
2017,4,29,21,7687,9685,7723,-1962
2017,4,29,22,7550,9585,7649,-1936
2017,4,29,23,7231,9203,7353,-1850
2017,4,30,0,6718,8562,6868,-1694
2017,4,30,1,6498,8171,6585,-1586
2017,4,30,2,6024,7628,6175,-1453
2017,4,30,3,5443,6934,5608,-1326
2017,4,30,4,4899,6233,5028,-1205
2017,4,30,5,4269,5622,4534,-1088
2017,4,30,6,3868,5139,4179,-960
2017,4,30,7,3552,4815,3919,-896
2017,4,30,8,3399,4625,3696,-929
2017,4,30,9,3272,4527,3591,-936
2017,4,30,10,3255,4517,3597,-920
2017,4,30,11,3343,4611,3663,-948
2017,4,30,12,3510,4779,3857,-922
2017,4,30,13,4057,5353,4401,-952
2017,4,30,14,4747,6104,5013,-1091
2017,4,30,15,5327,6732,5366,-1366
2017,4,30,16,5863,7298,5783,-1515
2017,4,30,17,6352,7863,6282,-1581
2017,4,30,18,6805,8425,6704,-1721
2017,4,30,19,7088,8903,7071,-1832
2017,4,30,20,7250,9176,7369,-1807
2017,4,30,21,7343,9349,7507,-1842
2017,4,30,22,7304,9325,7487,-1838
2017,4,30,23,7001,9073,7297,-1776
2017,5,1,0,6570,8555,6829,-1726
2017,5,1,1,6414,8268,6611,-1657
2017,5,1,2,5972,7716,6222,-1494
2017,5,1,3,5357,6936,5632,-1304
2017,5,1,4,4754,6174,5027,-1147
2017,5,1,5,4094,5513,4469,-1044
2017,5,1,6,3744,5039,4113,-926
2017,5,1,7,3511,4726,3821,-905
2017,5,1,8,3390,4562,3640,-922
2017,5,1,9,3380,4543,3637,-906
2017,5,1,10,3591,4787,3883,-904
2017,5,1,11,4046,5325,4327,-998
2017,5,1,12,4306,5651,4661,-990
2017,5,1,13,4646,6036,5028,-1008
2017,5,1,14,5130,6498,5386,-1112
2017,5,1,15,5555,7158,5798,-1360
2017,5,1,16,6046,7782,6326,-1456
2017,5,1,17,6396,8330,6823,-1507
2017,5,1,18,6815,8782,7289,-1493
2017,5,1,19,7133,9126,7577,-1549
2017,5,1,20,7303,9222,7691,-1531
2017,5,1,21,7420,9080,7499,-1581
2017,5,1,22,7344,10054,8457,-1597
2017,5,1,23,7158,8710,7187,-1523
2017,5,2,0,6751,8350,6857,-1493
2017,5,2,1,6435,8158,6632,-1526
2017,5,2,2,5979,7592,6126,-1466
2017,5,2,3,5314,6806,5531,-1275
2017,5,2,4,4690,6048,4938,-1110
2017,5,2,5,4140,5442,4499,-943
2017,5,2,6,3783,5016,4071,-945
2017,5,2,7,3555,4764,3770,-994
2017,5,2,8,3417,4611,3633,-978
2017,5,2,9,3384,4608,3631,-977
2017,5,2,10,3591,4872,3940,-932
2017,5,2,11,4002,5474,4502,-972
2017,5,2,12,4245,5739,4800,-939
2017,5,2,13,4498,5964,5021,-943
2017,5,2,14,4887,6295,5301,-994
2017,5,2,15,5237,6669,5608,-1061
2017,5,2,16,5603,6960,5845,-1115
2017,5,2,17,5938,7295,6172,-1123
2017,5,2,18,6225,7645,6439,-1206
2017,5,2,19,6472,8040,6745,-1295
2017,5,2,20,6612,8363,6849,-1514
2017,5,2,21,6567,8638,7062,-1576
2017,5,2,22,6448,8740,7235,-1505
2017,5,2,23,6261,8479,7037,-1442
2017,5,3,0,6050,7982,6640,-1342
2017,5,3,1,5855,7686,6438,-1248
2017,5,3,2,5468,7207,6023,-1184
2017,5,3,3,4862,6382,5346,-1036
2017,5,3,4,4298,5596,4627,-969
2017,5,3,5,3884,4931,3988,-943
2017,5,3,6,3553,4520,3582,-938
2017,5,3,7,3337,4230,3333,-897
2017,5,3,8,3207,4087,3250,-837
2017,5,3,9,3196,4083,3212,-871
2017,5,3,10,3403,4344,3398,-946
2017,5,3,11,3783,4866,3808,-1058
2017,5,3,12,4035,5147,4119,-1028
2017,5,3,13,4292,5501,4503,-998
2017,5,3,14,4705,6005,4992,-1013
2017,5,3,15,5138,6628,5378,-1250
2017,5,3,16,5543,7248,5810,-1438
2017,5,3,17,5970,7826,6397,-1429
2017,5,3,18,6371,8358,6846,-1512
2017,5,3,19,6759,8802,7381,-1421
2017,5,3,20,7081,9109,7624,-1485
2017,5,3,21,7292,9305,7617,-1688
2017,5,3,22,7359,9300,7736,-1564
2017,5,3,23,7017,9001,7503,-1498
2017,5,4,0,6634,8396,6902,-1494
2017,5,4,1,6410,8058,6524,-1534
2017,5,4,2,5943,7449,5886,-1563
2017,5,4,3,5277,6597,5272,-1325
2017,5,4,4,4664,5736,4720,-1016
2017,5,4,5,4150,5042,4130,-912
2017,5,4,6,3791,4598,3655,-943
2017,5,4,7,3553,4312,3416,-896
2017,5,4,8,3416,4170,3293,-877
2017,5,4,9,3408,4196,3304,-892
2017,5,4,10,3618,4450,3516,-934
2017,5,4,11,4016,5016,4064,-952
2017,5,4,12,4286,5321,4325,-996
2017,5,4,13,4590,5702,4678,-1024
2017,5,4,14,4996,6290,5219,-1071
2017,5,4,15,5477,6906,5572,-1334
2017,5,4,16,5840,7475,6135,-1340
2017,5,4,17,6184,8039,6688,-1351
2017,5,4,18,6544,8521,7071,-1450
2017,5,4,19,6852,8859,7363,-1496
2017,5,4,20,7044,8969,7500,-1469
2017,5,4,21,7157,9012,7579,-1433
2017,5,4,22,7066,8467,7107,-1360
2017,5,4,23,6857,7888,6682,-1206
2017,5,5,0,6517,7468,6329,-1139
2017,5,5,1,6190,7311,6030,-1281
2017,5,5,2,5762,6891,5599,-1292
2017,5,5,3,5102,6235,5054,-1181
2017,5,5,4,4531,5593,4644,-949
2017,5,5,5,4083,5009,4148,-861
2017,5,5,6,3695,4650,3711,-939
2017,5,5,7,3509,4400,3490,-910
2017,5,5,8,3337,4245,3376,-869
2017,5,5,9,3335,4258,3377,-881
2017,5,5,10,3492,4470,3552,-918
2017,5,5,11,3877,4941,3971,-970
2017,5,5,12,4048,5121,4192,-929
2017,5,5,13,4206,5255,4308,-947
2017,5,5,14,4419,5477,4571,-906
2017,5,5,15,4566,5686,4760,-926
2017,5,5,16,4661,5795,4871,-924
2017,5,5,17,4816,5932,4983,-949
2017,5,5,18,4888,6091,5127,-964
2017,5,5,19,4986,6247,5235,-1012
2017,5,5,20,5012,6345,5326,-1019
2017,5,5,21,5060,6421,5372,-1049
2017,5,5,22,4995,6356,5318,-1038
2017,5,5,23,4905,6100,5105,-995
2017,5,6,0,4671,5747,4795,-952
2017,5,6,1,4643,5696,4748,-948
2017,5,6,2,4416,5454,4511,-943
2017,5,6,3,4070,4999,4048,-951
2017,5,6,4,3624,4525,3564,-961
2017,5,6,5,3211,4080,3186,-894
2017,5,6,6,2994,3746,2930,-816
2017,5,6,7,2760,3546,2770,-776
2017,5,6,8,2671,3414,2679,-735
2017,5,6,9,2670,3397,2657,-740
2017,5,6,10,2700,3444,2670,-774
2017,5,6,11,2786,3592,2762,-830
2017,5,6,12,2959,3834,3054,-780
2017,5,6,13,3446,4260,3495,-765
2017,5,6,14,3822,4654,3849,-805
2017,5,6,15,4081,4931,4076,-855
2017,5,6,16,4257,5093,4162,-931
2017,5,6,17,4403,5206,4240,-966
2017,5,6,18,4560,5404,4388,-1016
2017,5,6,19,4671,5604,4452,-1152
2017,5,6,20,4791,5801,4623,-1178
2017,5,6,21,4837,5995,4726,-1269
2017,5,6,22,4851,6019,4762,-1257
2017,5,6,23,4816,5854,4654,-1200
2017,5,7,0,4577,5539,4470,-1069
2017,5,7,1,4564,5457,4485,-972
2017,5,7,2,4315,5201,4300,-901
2017,5,7,3,3948,4750,3948,-802
2017,5,7,4,3534,4228,3458,-770
2017,5,7,5,3142,3816,3054,-762
2017,5,7,6,2907,3510,2731,-779
2017,5,7,7,2760,3333,2603,-730
2017,5,7,8,2677,3252,2529,-723
2017,5,7,9,2651,3244,2498,-746
2017,5,7,10,2685,3306,2536,-770
2017,5,7,11,2698,3442,2622,-820
2017,5,7,12,2871,3675,2909,-766
2017,5,7,13,3307,4145,3351,-794
2017,5,7,14,3716,4610,3762,-848
2017,5,7,15,3993,4984,4070,-914
2017,5,7,16,4290,5302,4321,-981
2017,5,7,17,4606,5662,4598,-1064
2017,5,7,18,4836,6047,4860,-1187
2017,5,7,19,5130,6488,4966,-1522
2017,5,7,20,5359,6915,5113,-1802
2017,5,7,21,5626,7280,5297,-1983
2017,5,7,22,5745,7456,5429,-2027
2017,5,7,23,5632,7359,5412,-1947
2017,5,8,0,5305,6972,5290,-1682
2017,5,8,1,5185,6724,5255,-1469
2017,5,8,2,4896,6299,5105,-1194
2017,5,8,3,4365,5545,4545,-1000
2017,5,8,4,3841,4795,3936,-859
2017,5,8,5,3321,4207,3409,-798
2017,5,8,6,3043,3832,2990,-842
2017,5,8,7,2920,3620,2824,-796
2017,5,8,8,2827,3507,2748,-759
2017,5,8,9,2831,3529,2751,-778
2017,5,8,10,3076,3825,3033,-792
2017,5,8,11,3482,4363,3518,-845
2017,5,8,12,3702,4663,3826,-837
2017,5,8,13,3979,4984,4174,-810
2017,5,8,14,4300,5391,4434,-957
2017,5,8,15,4728,5842,4707,-1135
2017,5,8,16,5140,6352,5108,-1244
2017,5,8,17,5513,6845,5493,-1352
2017,5,8,18,5857,7363,5871,-1492
2017,5,8,19,6193,7849,6387,-1462
2017,5,8,20,6499,8264,6704,-1560
2017,5,8,21,6682,8563,6914,-1649
2017,5,8,22,6745,8666,6983,-1683
2017,5,8,23,6573,8435,6828,-1607
2017,5,9,0,6207,7871,6392,-1479
2017,5,9,1,5973,7452,6076,-1376
2017,5,9,2,5513,6859,5526,-1333
2017,5,9,3,4876,5991,4810,-1181
2017,5,9,4,4314,5147,4242,-905
2017,5,9,5,3671,4480,3690,-790
2017,5,9,6,3353,4072,3255,-817
2017,5,9,7,3169,3799,3031,-768
2017,5,9,8,3041,3670,2927,-743
2017,5,9,9,3020,3658,2940,-718
2017,5,9,10,3235,3928,3180,-748
2017,5,9,11,3646,4446,3697,-749
2017,5,9,12,3892,4732,3921,-811
2017,5,9,13,4178,5000,4195,-805
2017,5,9,14,4534,5410,4536,-874
2017,5,9,15,4994,5906,4818,-1088
2017,5,9,16,5406,6416,5142,-1274
2017,5,9,17,5813,6998,5596,-1402
2017,5,9,18,6212,7692,6249,-1443
2017,5,9,19,6605,8294,6726,-1568
2017,5,9,20,6922,8773,7020,-1753
2017,5,9,21,7102,9138,7215,-1923
2017,5,9,22,7148,9226,7250,-1976
2017,5,9,23,7000,8984,7186,-1798
2017,5,10,0,6550,8403,6765,-1638
2017,5,10,1,6313,7899,6387,-1512
2017,5,10,2,5827,7299,5895,-1404
2017,5,10,3,5148,6416,5111,-1305
2017,5,10,4,4500,5553,4575,-978
2017,5,10,5,3938,4849,3948,-901
2017,5,10,6,3580,4353,3449,-904
2017,5,10,7,3359,4043,3210,-833
2017,5,10,8,3204,3887,3096,-791
2017,5,10,9,3184,3862,3083,-779
2017,5,10,10,3383,4093,3234,-859
2017,5,10,11,3772,4637,3687,-950
2017,5,10,12,4009,4862,3968,-894
2017,5,10,13,4317,5232,4317,-915
2017,5,10,14,4700,5680,4734,-946
2017,5,10,15,5264,6308,5144,-1164
2017,5,10,16,5733,6987,5551,-1436
2017,5,10,17,6323,7732,6115,-1617
2017,5,10,18,6819,8458,6878,-1580
2017,5,10,19,7278,9073,7426,-1647
2017,5,10,20,7641,9577,7683,-1894
2017,5,10,21,7910,9904,7921,-1983
2017,5,10,22,7870,9909,7901,-2008
2017,5,10,23,7641,9597,7607,-1990
2017,5,11,0,7124,8925,7059,-1866
2017,5,11,1,6812,8420,6682,-1738
2017,5,11,2,6245,7801,6208,-1593
2017,5,11,3,5541,6835,5338,-1497
2017,5,11,4,4844,5896,4721,-1175
2017,5,11,5,4101,5165,4067,-1098
2017,5,11,6,3712,4607,3616,-991
2017,5,11,7,3441,4275,3347,-928
2017,5,11,8,3286,4069,3193,-876
2017,5,11,9,3255,4031,3167,-864
2017,5,11,10,3432,4277,3316,-961
2017,5,11,11,3856,4734,3696,-1038
2017,5,11,12,4172,4984,3973,-1011
2017,5,11,13,4507,5360,4349,-1011
2017,5,11,14,4935,5873,4776,-1097
2017,5,11,15,5472,6476,5127,-1349
2017,5,11,16,5941,7209,5739,-1470
2017,5,11,17,6447,7950,6472,-1478
2017,5,11,18,6993,8633,7026,-1607
2017,5,11,19,7457,9191,7441,-1750
2017,5,11,20,7864,9682,7900,-1782
2017,5,11,21,8054,9924,8182,-1742
2017,5,11,22,8030,9816,8110,-1706
2017,5,11,23,7773,9351,7695,-1656
2017,5,12,0,7244,8732,7220,-1512
2017,5,12,1,6919,8392,6780,-1612
2017,5,12,2,6368,7780,6165,-1615
2017,5,12,3,5617,6867,5379,-1488
2017,5,12,4,4880,5976,4603,-1373
2017,5,12,5,4205,5239,4150,-1089
2017,5,12,6,3789,4727,3733,-994
2017,5,12,7,3490,4416,3498,-918
2017,5,12,8,3324,4229,3345,-884
2017,5,12,9,3281,4190,3303,-887
2017,5,12,10,3451,4402,3458,-944
2017,5,12,11,3825,4863,3825,-1038
2017,5,12,12,4110,5164,4121,-1043
2017,5,12,13,4415,5426,4192,-1234
2017,5,12,14,4864,6051,4626,-1425
2017,5,12,15,5353,6676,5040,-1636
2017,5,12,16,5771,7226,5510,-1716
2017,5,12,17,6272,7809,5957,-1852
2017,5,12,18,6675,8367,6510,-1857
2017,5,12,19,7017,8821,6898,-1923
2017,5,12,20,7337,9130,7166,-1964
2017,5,12,21,7514,9266,7273,-1993
2017,5,12,22,7409,9118,7166,-1952
2017,5,12,23,7239,8649,6769,-1880
2017,5,13,0,6796,8036,6137,-1899
2017,5,13,1,6423,7705,5876,-1829
2017,5,13,2,6005,7215,5508,-1707
2017,5,13,3,5354,6520,4917,-1603
2017,5,13,4,4762,5813,4454,-1359
2017,5,13,5,4211,5208,4263,-945
2017,5,13,6,3840,4716,3800,-916
2017,5,13,7,3587,4432,3504,-928
2017,5,13,8,3455,4218,3353,-865
2017,5,13,9,3368,4126,3270,-856
2017,5,13,10,3385,4162,3263,-899
2017,5,13,11,3496,4319,3365,-954
2017,5,13,12,3711,4610,3646,-964
2017,5,13,13,4237,5187,4090,-1097
2017,5,13,14,4760,5728,4426,-1302
2017,5,13,15,5241,6158,4665,-1493
2017,5,13,16,5570,6439,4933,-1506
2017,5,13,17,5883,6614,5289,-1325
2017,5,13,18,6148,6654,5342,-1312
2017,5,13,19,6335,6523,5207,-1316
2017,5,13,20,6448,6335,5048,-1287
2017,5,13,21,6462,6238,4939,-1299
2017,5,13,22,6290,6097,4809,-1288
2017,5,13,23,6041,6041,4737,-1304
2017,5,14,0,5738,5896,4637,-1259
2017,5,14,1,5505,5909,4628,-1281
2017,5,14,2,5164,5794,4496,-1298
2017,5,14,3,4732,5418,4177,-1241
2017,5,14,4,4302,4911,3814,-1097
2017,5,14,5,3982,4433,3552,-881
2017,5,14,6,3643,4046,3172,-874
2017,5,14,7,3374,3808,2970,-838
2017,5,14,8,3237,3669,2854,-815
2017,5,14,9,3155,3617,2815,-802
2017,5,14,10,3125,3638,2827,-811
2017,5,14,11,3139,3758,2895,-863
2017,5,14,12,3323,4076,3205,-871
2017,5,14,13,3926,4744,3791,-953
2017,5,14,14,4482,5399,4424,-975
2017,5,14,15,5007,5941,4758,-1183
2017,5,14,16,5392,6415,5189,-1226
2017,5,14,17,5889,6853,5554,-1299
2017,5,14,18,6304,7276,5918,-1358
2017,5,14,19,6621,7711,6289,-1422
2017,5,14,20,6860,8015,6455,-1560
2017,5,14,21,6973,8202,6572,-1630
2017,5,14,22,6955,8257,6614,-1643
2017,5,14,23,6689,8074,6464,-1610
2017,5,15,0,6332,7645,6212,-1433
2017,5,15,1,6085,7346,5860,-1486
2017,5,15,2,5729,6958,5330,-1628
2017,5,15,3,5094,6247,4879,-1368
2017,5,15,4,4526,5449,4263,-1186
2017,5,15,5,4072,4852,3873,-979
2017,5,15,6,3724,4433,3472,-961
2017,5,15,7,3502,4158,3278,-880
2017,5,15,8,3369,4005,3172,-833
2017,5,15,9,3364,3979,3138,-841
2017,5,15,10,3583,4251,3338,-913
2017,5,15,11,4004,4764,3766,-998
2017,5,15,12,4287,5136,4166,-970
2017,5,15,13,4641,5524,4557,-967
2017,5,15,14,5095,6031,4949,-1082
2017,5,15,15,5680,6645,5388,-1257
2017,5,15,16,6180,7336,6053,-1283
2017,5,15,17,6636,7936,6446,-1490
2017,5,15,18,7068,8533,7169,-1364
2017,5,15,19,7374,9004,7647,-1357
2017,5,15,20,7560,9393,7935,-1458
2017,5,15,21,7736,9662,8106,-1556
2017,5,15,22,7700,9694,8117,-1577
2017,5,15,23,7418,9416,7895,-1521
2017,5,16,0,7051,8876,7360,-1516
2017,5,16,1,6764,8408,6986,-1422
2017,5,16,2,6361,7842,6375,-1467
2017,5,16,3,5666,6960,5505,-1455
2017,5,16,4,5002,6088,4763,-1325
2017,5,16,5,4244,5355,4303,-1052
2017,5,16,6,3839,4835,3843,-992
2017,5,16,7,3575,4492,3497,-995
2017,5,16,8,3418,4294,3336,-958
2017,5,16,9,3368,4240,3300,-940
2017,5,16,10,3556,4477,3485,-992
2017,5,16,11,3964,4947,3973,-974
2017,5,16,12,4253,5309,4387,-922
2017,5,16,13,4636,5755,4658,-1097
2017,5,16,14,5147,6382,5076,-1306
2017,5,16,15,5655,7064,5594,-1470
2017,5,16,16,6144,7752,6065,-1687
2017,5,16,17,6711,8432,6680,-1752
2017,5,16,18,7180,9054,7226,-1828
2017,5,16,19,7563,9557,7782,-1775
2017,5,16,20,7834,9917,8080,-1837
2017,5,16,21,7956,10162,8196,-1966
2017,5,16,22,7925,10152,8260,-1892
2017,5,16,23,7641,9808,7916,-1892
2017,5,17,0,7186,9202,7258,-1944
2017,5,17,1,6824,8794,6941,-1853
2017,5,17,2,6390,8240,6574,-1666
2017,5,17,3,5665,7365,5724,-1641
2017,5,17,4,5009,6501,5118,-1383
2017,5,17,5,4472,5747,4559,-1188
2017,5,17,6,4082,5215,4094,-1121
2017,5,17,7,3806,4864,3820,-1044
2017,5,17,8,3642,4640,3631,-1009
2017,5,17,9,3581,4580,3598,-982
2017,5,17,10,3752,4784,3739,-1045
2017,5,17,11,4110,5218,4086,-1132
2017,5,17,12,4367,5590,4477,-1113
2017,5,17,13,4715,6103,4833,-1270
2017,5,17,14,5212,6737,5334,-1403
2017,5,17,15,5783,7444,5751,-1693
2017,5,17,16,6322,8167,6324,-1843
2017,5,17,17,6773,8787,6868,-1919
2017,5,17,18,7220,9294,7437,-1857
2017,5,17,19,7585,9743,7715,-2028
2017,5,17,20,7851,10070,7924,-2146
2017,5,17,21,7944,10245,8015,-2230
2017,5,17,22,7903,10159,7953,-2206
2017,5,17,23,7652,9779,7643,-2136
2017,5,18,0,7178,9217,7073,-2144
2017,5,18,1,6867,8781,6767,-2014
2017,5,18,2,6410,8214,6429,-1785
2017,5,18,3,5749,7380,5697,-1683
2017,5,18,4,5112,6522,5063,-1459
2017,5,18,5,4541,5796,4648,-1148
2017,5,18,6,4142,5291,4184,-1107
2017,5,18,7,3851,4945,3855,-1090
2017,5,18,8,3686,4743,3716,-1027
2017,5,18,9,3645,4661,3641,-1020
2017,5,18,10,3824,4867,3808,-1059
2017,5,18,11,4180,5286,4145,-1141
2017,5,18,12,4469,5628,4578,-1050
2017,5,18,13,4876,6076,4813,-1263
2017,5,18,14,5415,6682,5237,-1445
2017,5,18,15,5987,7358,5711,-1647
2017,5,18,16,6459,8059,6225,-1834
2017,5,18,17,6904,8714,6864,-1850
2017,5,18,18,7335,9295,7351,-1944
2017,5,18,19,7691,9745,7708,-2037
2017,5,18,20,7930,10079,7974,-2105
2017,5,18,21,8025,10260,8089,-2171
2017,5,18,22,8013,10219,8059,-2160
2017,5,18,23,7735,9868,7778,-2090
2017,5,19,0,7313,9301,7311,-1990
2017,5,19,1,6910,8888,6966,-1922
2017,5,19,2,6492,8345,6590,-1755
2017,5,19,3,5756,7461,5831,-1630
2017,5,19,4,5171,6600,5224,-1376
2017,5,19,5,4649,5841,4724,-1117
2017,5,19,6,4247,5363,4259,-1104
2017,5,19,7,3946,5012,3962,-1050
2017,5,19,8,3794,4821,3795,-1026
2017,5,19,9,3747,4800,3768,-1032
2017,5,19,10,3920,4998,3935,-1063
2017,5,19,11,4275,5444,4299,-1145
2017,5,19,12,4581,5813,4686,-1127
2017,5,19,13,5004,6264,4975,-1289
2017,5,19,14,5577,6878,5339,-1539
2017,5,19,15,6246,7535,5762,-1773
2017,5,19,16,6749,8145,6383,-1762
2017,5,19,17,7325,8686,6761,-1925
2017,5,19,18,7727,9138,7172,-1966
2017,5,19,19,8033,9566,7490,-2076
2017,5,19,20,8267,9795,7655,-2140
2017,5,19,21,8325,9728,7643,-2085
2017,5,19,22,8209,9313,7359,-1954
2017,5,19,23,7900,8666,6788,-1878
2017,5,20,0,7478,8100,6330,-1770
2017,5,20,1,7053,7865,6099,-1766
2017,5,20,2,6681,7486,5792,-1694
2017,5,20,3,6080,6962,5402,-1560
2017,5,20,4,5433,6339,5020,-1319
2017,5,20,5,4678,5803,4655,-1148
2017,5,20,6,4248,5372,4221,-1151
2017,5,20,7,4014,5049,3908,-1141
2017,5,20,8,3836,4859,3761,-1098
2017,5,20,9,3755,4779,3696,-1083
2017,5,20,10,3766,4769,3688,-1081
2017,5,20,11,3842,4846,3749,-1097
2017,5,20,12,4066,5135,4114,-1021
2017,5,20,13,4680,5882,4646,-1236
2017,5,20,14,5370,6740,5194,-1546
2017,5,20,15,6051,7542,5701,-1841
2017,5,20,16,6429,8298,6313,-1985
2017,5,20,17,6922,8978,6821,-2157
2017,5,20,18,7254,9488,7252,-2236
2017,5,20,19,7365,9908,7563,-2345
2017,5,20,20,7520,10162,7766,-2396
2017,5,20,21,7519,10263,7811,-2452
2017,5,20,22,7332,10105,7702,-2403
2017,5,20,23,7084,9694,7401,-2293
2017,5,21,0,6531,9066,7000,-2066
2017,5,21,1,6240,8546,6637,-1909
2017,5,21,2,5935,7971,6268,-1703
2017,5,21,3,5430,7215,5601,-1614
2017,5,21,4,4913,6512,5089,-1423
2017,5,21,5,4536,5820,4608,-1212
2017,5,21,6,4138,5298,4080,-1218
2017,5,21,7,3838,4916,3769,-1147
2017,5,21,8,3652,4689,3604,-1085
2017,5,21,9,3529,4541,3496,-1045
2017,5,21,10,3498,4501,3466,-1035
2017,5,21,11,3526,4550,3525,-1025
2017,5,21,12,3715,4866,3824,-1042
2017,5,21,13,4311,5611,4335,-1276
2017,5,21,14,5051,6446,4885,-1561
2017,5,21,15,5703,7157,5429,-1728
2017,5,21,16,6253,7853,6090,-1763
2017,5,21,17,6725,8439,6508,-1931
2017,5,21,18,7118,8890,6860,-2030
2017,5,21,19,7391,9193,7104,-2089
2017,5,21,20,7501,9367,7240,-2127
2017,5,21,21,7518,9413,7261,-2152
2017,5,21,22,7425,9333,7194,-2139
2017,5,21,23,7140,8926,6873,-2053
2017,5,22,0,6688,8445,6489,-1956
2017,5,22,1,6407,8190,6373,-1817
2017,5,22,2,6052,7693,6106,-1587
2017,5,22,3,5467,6943,5290,-1653
2017,5,22,4,4912,6185,4710,-1475
2017,5,22,5,4440,5542,4303,-1239
2017,5,22,6,4046,5092,3951,-1141
2017,5,22,7,3805,4785,3706,-1079
2017,5,22,8,3675,4603,3568,-1035
2017,5,22,9,3643,4598,3560,-1038
2017,5,22,10,3845,4821,3737,-1084
2017,5,22,11,4268,5340,4171,-1169
2017,5,22,12,4564,5668,4524,-1144
2017,5,22,13,4944,6120,4779,-1341
2017,5,22,14,5442,6732,5173,-1559
2017,5,22,15,6094,7483,5751,-1732
2017,5,22,16,6580,8272,6394,-1878
2017,5,22,17,7096,9022,7111,-1911
2017,5,22,18,7444,9494,7525,-1969
2017,5,22,19,7818,9836,7785,-2051
2017,5,22,20,7998,9930,7793,-2137
2017,5,22,21,8058,9899,7760,-2139
2017,5,22,22,7955,9692,7491,-2201
2017,5,22,23,7630,9288,7066,-2222
2017,5,23,0,7155,8669,6572,-2097
2017,5,23,1,6869,8187,6183,-2004
2017,5,23,2,6438,7612,5864,-1748
2017,5,23,3,5782,6855,5197,-1658
2017,5,23,4,5119,6079,4579,-1500
2017,5,23,5,4546,5480,4233,-1247
2017,5,23,6,4135,5032,3882,-1150
2017,5,23,7,3873,4737,3660,-1077
2017,5,23,8,3707,4605,3556,-1049
2017,5,23,9,3673,4577,3533,-1044
2017,5,23,10,3838,4824,3727,-1097
2017,5,23,11,4230,5363,4159,-1204
2017,5,23,12,4540,5715,4581,-1134
2017,5,23,13,4891,6071,4740,-1331
2017,5,23,14,5375,6509,4948,-1561
2017,5,23,15,6016,7130,5527,-1603
2017,5,23,16,6424,7660,6040,-1620
2017,5,23,17,6925,8090,6532,-1558
2017,5,23,18,7222,8515,6778,-1737
2017,5,23,19,7522,8909,7094,-1815
2017,5,23,20,7630,9141,7281,-1860
2017,5,23,21,7634,9214,7349,-1865
2017,5,23,22,7529,8928,7090,-1838
2017,5,23,23,7267,8552,6765,-1787
2017,5,24,0,6884,8225,6613,-1612
2017,5,24,1,6643,8076,6313,-1763
2017,5,24,2,6242,7676,6014,-1662
2017,5,24,3,5622,6998,5356,-1642
2017,5,24,4,5014,6330,4808,-1522
2017,5,24,5,4463,5789,4473,-1316
2017,5,24,6,4134,5411,4190,-1221
2017,5,24,7,3938,5178,4002,-1176
2017,5,24,8,3803,5074,3905,-1169
2017,5,24,9,3785,5114,3945,-1169
2017,5,24,10,3998,5375,4153,-1222
2017,5,24,11,4371,5905,4572,-1333
2017,5,24,12,4670,6204,4937,-1267
2017,5,24,13,5035,6578,5094,-1484
2017,5,24,14,5571,7024,5310,-1714
2017,5,24,15,5990,7494,5634,-1860
2017,5,24,16,6248,7900,5930,-1970
2017,5,24,17,6546,8145,6176,-1969
2017,5,24,18,6661,8219,6276,-1943
2017,5,24,19,6738,7935,6060,-1875
2017,5,24,20,6680,7504,5710,-1794
2017,5,24,21,6596,7027,5250,-1777
2017,5,24,22,6482,6797,5008,-1789
2017,5,24,23,6348,6682,4894,-1788
2017,5,25,0,6079,6560,4782,-1778
2017,5,25,1,5872,6630,4813,-1817
2017,5,25,2,5631,6476,4841,-1635
2017,5,25,3,5136,5993,4499,-1494
2017,5,25,4,4612,5455,4157,-1298
2017,5,25,5,4193,4954,3913,-1041
2017,5,25,6,3881,4603,3635,-968
2017,5,25,7,3687,4389,3467,-922
2017,5,25,8,3585,4282,3391,-891
2017,5,25,9,3565,4293,3374,-919
2017,5,25,10,3740,4482,3491,-991
2017,5,25,11,4098,4994,3885,-1109
2017,5,25,12,4352,5248,4227,-1021
2017,5,25,13,4575,5446,4265,-1181
2017,5,25,14,4886,5680,4367,-1313
2017,5,25,15,5209,6021,4556,-1465
2017,5,25,16,5503,6398,4870,-1528
2017,5,25,17,5703,6787,5192,-1595
2017,5,25,18,5916,7182,5501,-1681
2017,5,25,19,6127,7582,5797,-1785
2017,5,25,20,6211,7916,6047,-1869
2017,5,25,21,6194,8133,6227,-1906
2017,5,25,22,6027,8141,6224,-1917
2017,5,25,23,5783,7900,6073,-1827
2017,5,26,0,5512,7352,5635,-1717
2017,5,26,1,5381,6911,5256,-1655
2017,5,26,2,5135,6497,5024,-1473
2017,5,26,3,4665,5785,4442,-1343
2017,5,26,4,4212,5045,3932,-1113
2017,5,26,5,3702,4431,3507,-924
2017,5,26,6,3383,4018,3157,-861
2017,5,26,7,3173,3744,2925,-819
2017,5,26,8,3053,3594,2814,-780
2017,5,26,9,3054,3612,2814,-798
2017,5,26,10,3228,3826,2988,-838
2017,5,26,11,3511,4238,3301,-937
2017,5,26,12,3813,4540,3609,-931
2017,5,26,13,4195,4963,3827,-1136
2017,5,26,14,4583,5424,4058,-1366
2017,5,26,15,5072,5890,4298,-1592
2017,5,26,16,5571,6425,4685,-1740
2017,5,26,17,5971,6984,5128,-1856
2017,5,26,18,6413,7578,5571,-2007
2017,5,26,19,6768,8103,5973,-2130
2017,5,26,20,6992,8517,6248,-2269
2017,5,26,21,7143,8790,6455,-2335
2017,5,26,22,7020,8860,6540,-2320
2017,5,26,23,6623,8556,6311,-2245
2017,5,27,0,6191,7945,5855,-2090
2017,5,27,1,5887,7302,5353,-1949
2017,5,27,2,5604,6739,5041,-1698
2017,5,27,3,5107,6033,4487,-1546
2017,5,27,4,4594,5299,4032,-1267
2017,5,27,5,3876,4681,3637,-1044
2017,5,27,6,3456,4240,3308,-932
2017,5,27,7,3207,3941,3094,-847
2017,5,27,8,3048,3761,2950,-811
2017,5,27,9,2967,3679,2940,-739
2017,5,27,10,2954,3679,2893,-786
2017,5,27,11,2920,3739,2929,-810
2017,5,27,12,3115,4000,3143,-857
2017,5,27,13,3764,4629,3662,-967
2017,5,27,14,4350,5287,4186,-1101
2017,5,27,15,5014,5940,4570,-1370
2017,5,27,16,5586,6594,4919,-1675
2017,5,27,17,6001,7262,5349,-1913
2017,5,27,18,6526,7898,5884,-2014
2017,5,27,19,7009,8455,6392,-2063
2017,5,27,20,7308,8847,6733,-2114
2017,5,27,21,7392,9104,6925,-2179
2017,5,27,22,7369,9097,6929,-2168
2017,5,27,23,6973,8842,6760,-2082
2017,5,28,0,6496,8259,6191,-2068
2017,5,28,1,6231,7640,5651,-1989
2017,5,28,2,5836,7096,5334,-1762
2017,5,28,3,5303,6328,4744,-1584
2017,5,28,4,4732,5609,4228,-1381
2017,5,28,5,4122,4993,3878,-1115
2017,5,28,6,3759,4503,3484,-1019
2017,5,28,7,3482,4165,3220,-945
2017,5,28,8,3351,3974,3045,-929
2017,5,28,9,3222,3894,2976,-918
2017,5,28,10,3198,3895,3010,-885
2017,5,28,11,3277,3957,3034,-923
2017,5,28,12,3505,4223,3275,-948
2017,5,28,13,4030,4993,3912,-1081
2017,5,28,14,4723,5859,4608,-1251
2017,5,28,15,5320,6643,5078,-1565
2017,5,28,16,5853,7423,5521,-1902
2017,5,28,17,6359,8146,5999,-2147
2017,5,28,18,6803,8762,6536,-2226
2017,5,28,19,7042,9237,6946,-2291
2017,5,28,20,7265,9562,7242,-2320
2017,5,28,21,7394,9778,7422,-2356
2017,5,28,22,7332,9797,7433,-2364
2017,5,28,23,6990,9496,7232,-2264
2017,5,29,0,6651,8908,6761,-2147
2017,5,29,1,6339,8416,6328,-2088
2017,5,29,2,5982,7928,6023,-1905
2017,5,29,3,5424,7208,5425,-1783
2017,5,29,4,4862,6445,4860,-1585
2017,5,29,5,4400,5788,4464,-1324
2017,5,29,6,4058,5245,4055,-1190
2017,5,29,7,3837,4877,3768,-1109
2017,5,29,8,3667,4627,3566,-1061
2017,5,29,9,3593,4555,3492,-1063
2017,5,29,10,3572,4612,3598,-1014
2017,5,29,11,3598,4719,3700,-1019
2017,5,29,12,3764,4991,3970,-1021
2017,5,29,13,4357,5752,4567,-1185
2017,5,29,14,5125,6698,5275,-1423
2017,5,29,15,5879,7614,5854,-1760
2017,5,29,16,6447,8446,6364,-2082
2017,5,29,17,6904,9119,6836,-2283
2017,5,29,18,7207,9633,7368,-2265
2017,5,29,19,7466,10014,7742,-2272
2017,5,29,20,7659,10336,8018,-2318
2017,5,29,21,7802,10522,8141,-2381
2017,5,29,22,7696,10545,8149,-2396
2017,5,29,23,7366,10222,7946,-2276
2017,5,30,0,7026,9628,7384,-2244
2017,5,30,1,6798,9136,6962,-2174
2017,5,30,2,6401,8567,6588,-1979
2017,5,30,3,5819,7643,5806,-1837
2017,5,30,4,5181,6750,5140,-1610
2017,5,30,5,4604,6047,4717,-1330
2017,5,30,6,4182,5475,4297,-1178
2017,5,30,7,3933,5123,4005,-1118
2017,5,30,8,3744,4890,3828,-1062
2017,5,30,9,3724,4851,3784,-1067
2017,5,30,10,3876,5013,3909,-1104
2017,5,30,11,4147,5407,4237,-1170
2017,5,30,12,4471,5745,4624,-1121
2017,5,30,13,4939,6207,4998,-1209
2017,5,30,14,5511,6785,5462,-1323
2017,5,30,15,6199,7575,5935,-1640
2017,5,30,16,6801,8359,6367,-1992
2017,5,30,17,7250,9062,6907,-2155
2017,5,30,18,7709,9786,7508,-2278
2017,5,30,19,8130,10243,7897,-2346
2017,5,30,20,8327,10478,8211,-2267
2017,5,30,21,8403,10584,8135,-2449
2017,5,30,22,8289,10478,7994,-2484
2017,5,30,23,8074,10004,7669,-2335
2017,5,31,0,7591,9369,7185,-2184
2017,5,31,1,7278,8856,6813,-2043
2017,5,31,2,6824,8094,6311,-1783
2017,5,31,3,6159,7132,5480,-1652
2017,5,31,4,5460,6466,4996,-1470
2017,5,31,5,4934,5799,4580,-1219
2017,5,31,6,4477,5304,4139,-1165
2017,5,31,7,4178,4999,3913,-1086
2017,5,31,8,3950,4805,3772,-1033
2017,5,31,9,3936,4758,3730,-1028
2017,5,31,10,4051,4920,3850,-1070
2017,5,31,11,4344,5297,4165,-1132
2017,5,31,12,4687,5624,4565,-1059
2017,5,31,13,5117,6078,5025,-1053
2017,5,31,14,5672,6771,5681,-1090
2017,5,31,15,6246,7563,6163,-1400
2017,5,31,16,6825,8445,6815,-1630
2017,5,31,17,7249,9139,7254,-1885
2017,5,31,18,7726,9725,7636,-2089
2017,5,31,19,8045,10179,7827,-2352
2017,5,31,20,8268,10410,8020,-2390
2017,5,31,21,8423,10514,8087,-2427
2017,5,31,22,8218,10278,7902,-2376
2017,5,31,23,8075,9701,7399,-2302
2017,6,1,0,7555,8977,6850,-2127
2017,6,1,1,7230,8554,6670,-1884
2017,6,1,2,6827,8013,6324,-1689
2017,6,1,3,6101,7226,5571,-1655
2017,6,1,4,5420,6418,5048,-1370
2017,6,1,5,4662,5737,4655,-1082
2017,6,1,6,4274,5244,4159,-1085
2017,6,1,7,4013,4894,3810,-1084
2017,6,1,8,3878,4706,3664,-1042
2017,6,1,9,3847,4629,3605,-1024
2017,6,1,10,3973,4803,3723,-1080
2017,6,1,11,4261,5170,4111,-1059
2017,6,1,12,4601,5527,4567,-960
2017,6,1,13,5017,6074,4887,-1187
2017,6,1,14,5533,6824,5338,-1486
2017,6,1,15,6091,7644,5862,-1782
2017,6,1,16,6661,8468,6631,-1837
2017,6,1,17,7066,9221,7223,-1998
2017,6,1,18,7502,9827,7730,-2097
2017,6,1,19,7814,10136,7989,-2147
2017,6,1,20,7922,10160,8065,-2095
2017,6,1,21,7913,9869,7837,-2032
2017,6,1,22,7654,9310,7278,-2032
2017,6,1,23,7352,8732,6733,-1999
2017,6,2,0,6933,8272,6373,-1899
2017,6,2,1,6619,8065,6206,-1859
2017,6,2,2,6257,7607,5965,-1642
2017,6,2,3,5703,6897,5273,-1624
2017,6,2,4,5068,6166,4801,-1365
2017,6,2,5,4510,5559,4463,-1096
2017,6,2,6,4136,5108,4034,-1074
2017,6,2,7,3905,4843,3743,-1100
2017,6,2,8,3760,4682,3630,-1052
2017,6,2,9,3715,4674,3617,-1057
2017,6,2,10,3855,4871,3772,-1099
2017,6,2,11,4121,5271,4189,-1082
2017,6,2,12,4423,5519,4530,-989
2017,6,2,13,4799,5832,4665,-1167
2017,6,2,14,5353,6196,4705,-1491
2017,6,2,15,5898,6726,5081,-1645
2017,6,2,16,6377,7291,5557,-1734
2017,6,2,17,6749,7810,5998,-1812
2017,6,2,18,7107,8218,6288,-1930
2017,6,2,19,7322,8441,6459,-1982
2017,6,2,20,7390,8433,6407,-2026
2017,6,2,21,7407,8222,6142,-2080
2017,6,2,22,7174,7861,5809,-2052
2017,6,2,23,6888,7542,5543,-1999
2017,6,3,0,6523,7178,5270,-1908
2017,6,3,1,6174,6996,5158,-1838
2017,6,3,2,5866,6737,5092,-1645
2017,6,3,3,5358,6230,4732,-1498
2017,6,3,4,4806,5646,4355,-1291
2017,6,3,5,4263,5141,4046,-1095
2017,6,3,6,3939,4709,3642,-1067
2017,6,3,7,3731,4444,3424,-1020
2017,6,3,8,3595,4286,3298,-988
2017,6,3,9,3514,4219,3251,-968
2017,6,3,10,3540,4128,3152,-976
2017,6,3,11,3615,4228,3231,-997
2017,6,3,12,3828,4575,3568,-1007
2017,6,3,13,4259,5169,3957,-1212
2017,6,3,14,4805,5886,4507,-1379
2017,6,3,15,5283,6632,4939,-1693
2017,6,3,16,5633,7331,5452,-1879
2017,6,3,17,5933,7865,5842,-2023
2017,6,3,18,6064,8175,6174,-2001
2017,6,3,19,6126,11450,9424,-2026
2017,6,3,20,6213,8612,6621,-1991
2017,6,3,21,6188,8597,6530,-2067
2017,6,3,22,6038,8411,6392,-2019
2017,6,3,23,5894,7992,5940,-2052
2017,6,4,0,5641,7606,5656,-1950
2017,6,4,1,5431,7335,5372,-1963
2017,6,4,2,5224,6977,5281,-1696
2017,6,4,3,4857,6405,4873,-1532
2017,6,4,4,4442,5819,4498,-1321
2017,6,4,5,4227,5289,4195,-1094
2017,6,4,6,3930,4835,3728,-1107
2017,6,4,7,3707,4539,3469,-1070
2017,6,4,8,3540,4363,3336,-1027
2017,6,4,9,3503,4253,3263,-990
2017,6,4,10,3468,4272,3267,-1005
2017,6,4,11,3454,4374,3348,-1026
2017,6,4,12,3715,4603,3599,-1004
2017,6,4,13,4216,5116,3881,-1235
2017,6,4,14,4861,5726,4318,-1408
2017,6,4,15,5418,6180,4547,-1633
2017,6,4,16,5850,6559,4828,-1731
2017,6,4,17,6146,6900,5099,-1801
2017,6,4,18,6418,7047,5300,-1747
2017,6,4,19,6587,7178,5464,-1714
2017,6,4,20,6644,7289,5631,-1658
2017,6,4,21,6695,7421,5740,-1681
2017,6,4,22,6575,7381,5687,-1694
2017,6,4,23,6447,7218,5471,-1747
2017,6,5,0,6227,6962,5139,-1823
2017,6,5,1,5902,6883,5087,-1796
2017,6,5,2,5613,6640,5046,-1594
2017,6,5,3,5183,6131,4663,-1468
2017,6,5,4,4679,5532,4284,-1248
2017,6,5,5,4179,5013,3941,-1072
2017,6,5,6,3871,4641,3565,-1076
2017,6,5,7,3689,4433,3405,-1028
2017,6,5,8,3572,4302,3304,-998
2017,6,5,9,3588,4352,3336,-1016
2017,6,5,10,3755,4619,3546,-1073
2017,6,5,11,4082,5061,3913,-1148
2017,6,5,12,4408,5396,4242,-1154
2017,6,5,13,4800,5762,4480,-1282
2017,6,5,14,5335,6186,4728,-1458
2017,6,5,15,5953,6732,5102,-1630
2017,6,5,16,6472,7181,5430,-1751
2017,6,5,17,6970,7502,5683,-1819
2017,6,5,18,7331,7571,5740,-1831
2017,6,5,19,7569,7559,5646,-1913
2017,6,5,20,7647,7402,5407,-1995
2017,6,5,21,7654,7282,5270,-2012
2017,6,5,22,7502,7171,5153,-2018
2017,6,5,23,7323,7046,5047,-1999
2017,6,6,0,6930,6868,4936,-1932
2017,6,6,1,6587,6823,4923,-1900
2017,6,6,2,6221,6585,4858,-1727
2017,6,6,3,5663,6065,4447,-1618
2017,6,6,4,5096,5481,4064,-1417
2017,6,6,5,4198,4992,3832,-1160
2017,6,6,6,3885,4664,3585,-1079
2017,6,6,7,3710,4458,3427,-1031
2017,6,6,8,3599,4337,3325,-1012
2017,6,6,9,3613,4368,3346,-1022
2017,6,6,10,3780,4592,3535,-1057
2017,6,6,11,4098,5053,3895,-1158
2017,6,6,12,4413,5385,4238,-1147
2017,6,6,13,4772,5693,4351,-1342
2017,6,6,14,5137,6117,4551,-1566
2017,6,6,15,5625,6603,4797,-1806
2017,6,6,16,6113,6995,5128,-1867
2017,6,6,17,6492,7268,5371,-1897
2017,6,6,18,6847,7329,5434,-1895
2017,6,6,19,7069,7101,5290,-1811
2017,6,6,20,7154,6835,5031,-1804
2017,6,6,21,7141,6694,4881,-1813
2017,6,6,22,6997,6615,4808,-1807
2017,6,6,23,6732,6616,4789,-1827
2017,6,7,0,6429,6588,4778,-1810
2017,6,7,1,6128,6545,4852,-1693
2017,6,7,2,5807,6445,4917,-1528
2017,6,7,3,5303,6000,4527,-1473
2017,6,7,4,4819,5432,4044,-1388
2017,6,7,5,4172,5032,3896,-1136
2017,6,7,6,3901,4716,3645,-1071
2017,6,7,7,3714,4533,3504,-1029
2017,6,7,8,3615,4445,3431,-1014
2017,6,7,9,3633,4515,3489,-1026
2017,6,7,10,3781,4740,3647,-1093
2017,6,7,11,4052,5208,4013,-1195
2017,6,7,12,4383,5547,4405,-1142
2017,6,7,13,4732,5870,4609,-1261
2017,6,7,14,5120,6173,4763,-1410
2017,6,7,15,5525,6453,4897,-1556
2017,6,7,16,5930,6526,5026,-1500
2017,6,7,17,6158,6432,4842,-1590
2017,6,7,18,6258,6452,4848,-1604
2017,6,7,19,6295,6593,4900,-1693
2017,6,7,20,6267,6758,5006,-1752
2017,6,7,21,6173,6933,5125,-1808
2017,6,7,22,5952,7093,5295,-1798
2017,6,7,23,5760,7115,5335,-1780
2017,6,8,0,5479,6980,5160,-1820
2017,6,8,1,5397,6884,5056,-1828
2017,6,8,2,5266,6688,4933,-1755
2017,6,8,3,4888,6164,4560,-1604
2017,6,8,4,4454,5582,4183,-1399
2017,6,8,5,4020,5001,3856,-1145
2017,6,8,6,3776,4660,3598,-1062
2017,6,8,7,3638,4434,3430,-1004
2017,6,8,8,3555,4315,3335,-980
2017,6,8,9,3586,4331,3345,-986
2017,6,8,10,3733,4538,3490,-1048
2017,6,8,11,4004,4945,3807,-1138
2017,6,8,12,4361,5251,4111,-1140
2017,6,8,13,4685,5682,4312,-1370
2017,6,8,14,5027,6127,4534,-1593
2017,6,8,15,5522,6574,4866,-1708
2017,6,8,16,5933,6959,5117,-1842
2017,6,8,17,6197,7110,5251,-1859
2017,6,8,18,6375,7296,5423,-1873
2017,6,8,19,6554,7460,5543,-1917
2017,6,8,20,6538,7645,5690,-1955
2017,6,8,21,6496,7768,5800,-1968
2017,6,8,22,6347,7774,5752,-2022
2017,6,8,23,6129,7571,5587,-1984
2017,6,9,0,5903,7288,5380,-1908
2017,6,9,1,5732,7031,5226,-1805
2017,6,9,2,5528,6810,5154,-1656
2017,6,9,3,5090,6206,4622,-1584
2017,6,9,4,4603,5520,4143,-1377
2017,6,9,5,4104,4934,3833,-1101
2017,6,9,6,3789,4506,3518,-988
2017,6,9,7,3579,4216,3265,-951
2017,6,9,8,3451,4034,3132,-902
2017,6,9,9,3451,4009,3113,-896
2017,6,9,10,3601,4168,3238,-930
2017,6,9,11,3852,4486,3477,-1009
2017,6,9,12,4188,4847,3787,-1060
2017,6,9,13,4559,5340,4096,-1244
2017,6,9,14,5044,5948,4537,-1411
2017,6,9,15,5592,6569,5074,-1495
2017,6,9,16,6150,7233,5577,-1656
2017,6,9,17,6509,7850,5898,-1952
2017,6,9,18,6857,8377,6494,-1883
2017,6,9,19,7087,8755,6935,-1820
2017,6,9,20,7206,9010,7202,-1808
2017,6,9,21,7260,9199,7218,-1981
2017,6,9,22,7068,9163,7155,-2008
2017,6,9,23,6746,8833,7000,-1833
2017,6,10,0,6342,8275,6537,-1738
2017,6,10,1,6120,7730,6047,-1683
2017,6,10,2,5808,7313,5613,-1700
2017,6,10,3,5357,6721,5122,-1599
2017,6,10,4,4878,6062,4696,-1366
2017,6,10,5,4453,5465,4244,-1221
2017,6,10,6,4110,5011,3911,-1100
2017,6,10,7,3853,4680,3637,-1043
2017,6,10,8,3712,4484,3478,-1006
2017,6,10,9,3653,4373,3387,-986
2017,6,10,10,3627,4389,3379,-1010
2017,6,10,11,3681,4467,3424,-1043
2017,6,10,12,3916,4780,3700,-1080
2017,6,10,13,4431,5469,4018,-1451
2017,6,10,14,5056,6271,4413,-1858
2017,6,10,15,5638,7133,5127,-2006
2017,6,10,16,6114,7871,5789,-2082
2017,6,10,17,6420,8348,6077,-2271
2017,6,10,18,6585,8616,6334,-2282
2017,6,10,19,6762,8466,6197,-2269
2017,6,10,20,6817,8101,5931,-2170
2017,6,10,21,6788,7860,5697,-2163
2017,6,10,22,6646,7620,5514,-2106
2017,6,10,23,6410,7277,5172,-2105
2017,6,11,0,6086,6976,4952,-2024
2017,6,11,1,5852,6828,4707,-2121
2017,6,11,2,5590,6615,4676,-1939
2017,6,11,3,5180,6169,4293,-1876
2017,6,11,4,4747,5633,3900,-1733
2017,6,11,5,4348,5141,3664,-1477
2017,6,11,6,4012,4734,3376,-1358
2017,6,11,7,3778,4459,3168,-1291
2017,6,11,8,3597,4320,3087,-1233
2017,6,11,9,3537,4252,3049,-1203
2017,6,11,10,3512,4273,2985,-1288
2017,6,11,11,3534,4339,3045,-1294
2017,6,11,12,3786,4673,3333,-1340
2017,6,11,13,4299,5346,3721,-1625
2017,6,11,14,5057,6065,4123,-1942
2017,6,11,15,5617,6710,4554,-2156
2017,6,11,16,6112,7368,5196,-2172
2017,6,11,17,6498,7954,5684,-2270
2017,6,11,18,6783,8370,5993,-2377
2017,6,11,19,7029,8653,6231,-2422
2017,6,11,20,7038,8664,6158,-2506
2017,6,11,21,7121,8174,5698,-2476
2017,6,11,22,6958,7566,5335,-2231
2017,6,11,23,6705,7215,5225,-1990
2017,6,12,0,6373,6841,4878,-1963
2017,6,12,1,6162,6706,4739,-1967
2017,6,12,2,5867,6448,4624,-1824
2017,6,12,3,5393,5947,4031,-1916
2017,6,12,4,4863,5380,3883,-1497
2017,6,12,5,4162,4765,3623,-1142
2017,6,12,6,3855,4514,3448,-1066
2017,6,12,7,3656,4309,3310,-999
2017,6,12,8,3555,4220,3231,-989
2017,6,12,9,3586,4258,3247,-1011
2017,6,12,10,3753,4493,3414,-1079
2017,6,12,11,4094,4960,3788,-1172
2017,6,12,12,4412,5348,4166,-1182
2017,6,12,13,4807,5677,4317,-1360
2017,6,12,14,5321,6066,4386,-1680
2017,6,12,15,5932,6594,4783,-1811
2017,6,12,16,6407,7073,5071,-2002
2017,6,12,17,6751,7633,5534,-2099
2017,6,12,18,6924,8133,5927,-2206
2017,6,12,19,7029,8568,6107,-2461
2017,6,12,20,7057,8760,6250,-2510
2017,6,12,21,6957,8675,6106,-2569
2017,6,12,22,6554,8360,5743,-2617
2017,6,12,23,6339,7989,5419,-2570
2017,6,13,0,6172,7495,5109,-2386
2017,6,13,1,6039,7238,4854,-2384
2017,6,13,2,5787,6905,4793,-2112
2017,6,13,3,5317,6318,4514,-1804
2017,6,13,4,4797,5677,4069,-1608
2017,6,13,5,4181,5161,3827,-1334
2017,6,13,6,3867,4781,3541,-1240
2017,6,13,7,3672,4525,3154,-1371
2017,6,13,8,3522,4394,3043,-1351
2017,6,13,9,3537,4410,3034,-1376
2017,6,13,10,3687,4634,3088,-1546
2017,6,13,11,3967,5098,3467,-1631
2017,6,13,12,4276,5404,3822,-1582
2017,6,13,13,4625,5744,3839,-1905
2017,6,13,14,4994,6116,4005,-2111
2017,6,13,15,5492,6548,4327,-2221
2017,6,13,16,5958,7024,4754,-2270
2017,6,13,17,6241,7639,5207,-2432
2017,6,13,18,6424,8139,5617,-2522
2017,6,13,19,6561,8212,5652,-2560
2017,6,13,20,6572,8170,5632,-2538
2017,6,13,21,6518,8015,5526,-2489
2017,6,13,22,6315,7771,5326,-2445
2017,6,13,23,6145,7351,4953,-2398
2017,6,14,0,5917,7007,4694,-2313
2017,6,14,1,5765,6840,4669,-2171
2017,6,14,2,5571,6604,4616,-1988
2017,6,14,3,5108,6069,4180,-1889
2017,6,14,4,4638,5461,3822,-1639
2017,6,14,5,4164,4940,3556,-1384
2017,6,14,6,3868,4571,3275,-1296
2017,6,14,7,3661,4331,3097,-1234
2017,6,14,8,3548,4215,3011,-1204
2017,6,14,9,3571,4233,3016,-1217
2017,6,14,10,3742,4457,3174,-1283
2017,6,14,11,3989,4932,3520,-1412
2017,6,14,12,4296,5251,3909,-1342
2017,6,14,13,4653,5646,4172,-1474
2017,6,14,14,5187,6098,4365,-1733
2017,6,14,15,5700,6716,4766,-1950
2017,6,14,16,6247,7382,5219,-2163
2017,6,14,17,6629,8043,5936,-2107
2017,6,14,18,6929,8631,6482,-2149
2017,6,14,19,7171,8752,6580,-2172
2017,6,14,20,7243,8550,6287,-2263
2017,6,14,21,7202,8208,6075,-2133
2017,6,14,22,7000,7668,5592,-2076
2017,6,14,23,6761,7263,5297,-1966
2017,6,15,0,6425,6998,5046,-1952
2017,6,15,1,6257,6820,4937,-1883
2017,6,15,2,5955,6654,4835,-1819
2017,6,15,3,5449,6216,4487,-1729
2017,6,15,4,4883,5474,3855,-1619
2017,6,15,5,4328,4918,3512,-1406
2017,6,15,6,3999,4550,3284,-1266
2017,6,15,7,3783,4300,3083,-1217
2017,6,15,8,3661,4200,3010,-1190
2017,6,15,9,3676,4196,3008,-1188
2017,6,15,10,3820,4377,3128,-1249
2017,6,15,11,4111,4797,3471,-1326
2017,6,15,12,4401,5124,3806,-1318
2017,6,15,13,4854,5543,4096,-1447
2017,6,15,14,5306,6123,4486,-1637
2017,6,15,15,5787,6817,5034,-1783
2017,6,15,16,6305,7512,5546,-1966
2017,6,15,17,6672,8095,6045,-2050
2017,6,15,18,6894,8623,6417,-2206
2017,6,15,19,7054,9035,6914,-2121
2017,6,15,20,7052,8885,6835,-2050
2017,6,15,21,7020,8556,6516,-2040
2017,6,15,22,6806,8275,6252,-2023
2017,6,15,23,6501,7876,5827,-2049
2017,6,16,0,6197,7378,5415,-1963
2017,6,16,1,5975,7077,5139,-1938
2017,6,16,2,5698,6823,5009,-1814
2017,6,16,3,5236,6250,4463,-1787
2017,6,16,4,4769,5604,4135,-1469
2017,6,16,5,4117,5037,3811,-1226
2017,6,16,6,3887,4627,3440,-1187
2017,6,16,7,3705,4382,3247,-1135
2017,6,16,8,3585,4238,3135,-1103
2017,6,16,9,3578,4282,3179,-1103
2017,6,16,10,3719,4393,3247,-1146
2017,6,16,11,3990,4766,3584,-1182
2017,6,16,12,4302,5130,4006,-1124
2017,6,16,13,4649,5647,4299,-1348
2017,6,16,14,5079,6264,4631,-1633
2017,6,16,15,5565,6914,4980,-1934
2017,6,16,16,6036,7460,5397,-2063
2017,6,16,17,6329,7841,5707,-2134
2017,6,16,18,6579,8115,6089,-2026
2017,6,16,19,6700,8062,6072,-1990
2017,6,16,20,6644,7877,5789,-2088
2017,6,16,21,6565,7860,5699,-2161
2017,6,16,22,6212,7860,5628,-2232
2017,6,16,23,6065,0,5628,-2192
2017,6,17,0,5785,7444,5295,-2149
2017,6,17,1,5616,7151,5109,-2042
2017,6,17,2,5426,6916,5022,-1894
2017,6,17,3,5034,6425,4667,-1758
2017,6,17,4,4569,5825,4297,-1528
2017,6,17,5,4279,5244,4084,-1160
2017,6,17,6,3967,4799,3787,-1012
2017,6,17,7,3767,4484,3505,-979
2017,6,17,8,3617,4317,3314,-1003
2017,6,17,9,3553,4229,3252,-977
2017,6,17,10,3565,4248,3287,-961
2017,6,17,11,3581,4340,3311,-1029
2017,6,17,12,3825,4678,3727,-951
2017,6,17,13,4306,5437,4417,-1020
2017,6,17,14,4933,6315,4983,-1332
2017,6,17,15,5527,7116,5480,-1636
2017,6,17,16,6000,7796,5870,-1926
2017,6,17,17,6419,8434,6356,-2078
2017,6,17,18,6555,8885,6733,-2152
2017,6,17,19,6692,9207,6999,-2208
2017,6,17,20,6776,9453,7229,-2224
2017,6,17,21,6698,9583,7293,-2290
2017,6,17,22,6552,9436,7177,-2259
2017,6,17,23,6393,8871,6710,-2161
2017,6,18,0,6049,8323,6291,-2032
2017,6,18,1,5844,7818,5928,-1890
2017,6,18,2,5588,7438,5754,-1684
2017,6,18,3,5181,6811,5270,-1541
2017,6,18,4,4703,6178,4913,-1265
2017,6,18,5,4219,5569,4604,-965
2017,6,18,6,3909,5085,4086,-999
2017,6,18,7,3689,4762,3747,-1015
2017,6,18,8,3517,4539,3568,-971
2017,6,18,9,3440,4431,3467,-964
2017,6,18,10,3455,4412,3456,-956
2017,6,18,11,3514,4490,3520,-970
2017,6,18,12,3734,4851,3893,-958
2017,6,18,13,4318,5733,4700,-1033
2017,6,18,14,4928,6640,5285,-1355
2017,6,18,15,5577,7531,5802,-1729
2017,6,18,16,6178,8289,6268,-2021
2017,6,18,17,6502,8963,6837,-2126
2017,6,18,18,6772,9439,7241,-2198
2017,6,18,19,7014,9639,7433,-2206
2017,6,18,20,7004,9627,7400,-2227
2017,6,18,21,6904,9312,7043,-2269
2017,6,18,22,6770,8680,6549,-2131
2017,6,18,23,6524,8141,6120,-2021
2017,6,19,0,6208,7660,5729,-1931
2017,6,19,1,6014,7478,5640,-1838
2017,6,19,2,5719,7191,5542,-1649
2017,6,19,3,5228,6586,5101,-1485
2017,6,19,4,4672,5917,4683,-1234
2017,6,19,5,4477,5356,4380,-976
2017,6,19,6,4119,4938,3913,-1025
2017,6,19,7,3903,4674,3631,-1043
2017,6,19,8,3777,4534,3526,-1008
2017,6,19,9,3781,4544,3535,-1009
2017,6,19,10,3918,4728,3669,-1059
2017,6,19,11,4198,5173,4136,-1037
2017,6,19,12,4506,5542,4607,-935
2017,6,19,13,4922,5975,4811,-1164
2017,6,19,14,5463,6487,5092,-1395
2017,6,19,15,5947,7139,5487,-1652
2017,6,19,16,6415,7692,5912,-1780
2017,6,19,17,6749,8072,6202,-1870
2017,6,19,18,7020,8175,6267,-1908
2017,6,19,19,7252,7938,6009,-1929
2017,6,19,20,7281,7610,5722,-1888
2017,6,19,21,7232,7287,5505,-1782
2017,6,19,22,7111,7103,5366,-1737
2017,6,19,23,6859,6955,5243,-1712
2017,6,20,0,6527,6758,5101,-1657
2017,6,20,1,6296,6753,5111,-1642
2017,6,20,2,5976,6557,5069,-1488
2017,6,20,3,5452,6073,4704,-1369
2017,6,20,4,4934,5528,4336,-1192
2017,6,20,5,4242,5001,4014,-987
2017,6,20,6,3919,4675,3683,-992
2017,6,20,7,3747,4451,3428,-1023
2017,6,20,8,3626,4379,3372,-1007
2017,6,20,9,3643,4431,3419,-1012
2017,6,20,10,3759,4722,3665,-1057
2017,6,20,11,3976,5192,4146,-1046
2017,6,20,12,4271,5591,4631,-960
2017,6,20,13,4648,5996,4830,-1166
2017,6,20,14,5114,6563,5145,-1418
2017,6,20,15,5488,7152,5478,-1674
2017,6,20,16,6051,7735,5938,-1797
2017,6,20,17,6306,8205,6305,-1900
2017,6,20,18,6590,8626,6630,-1996
2017,6,20,19,6714,8903,6855,-2048
2017,6,20,20,6648,9030,6978,-2052
2017,6,20,21,6572,8969,6940,-2029
2017,6,20,22,6227,8887,6839,-2048
2017,6,20,23,6065,8684,6657,-2027
2017,6,21,0,5826,8297,6335,-1962
2017,6,21,1,5714,8024,6112,-1912
2017,6,21,2,5552,7636,5916,-1720
2017,6,21,3,5144,6986,5404,-1582
2017,6,21,4,4627,6267,4926,-1341
2017,6,21,5,4414,5757,4575,-1182
2017,6,21,6,4074,5365,4207,-1158
2017,6,21,7,3882,5124,4003,-1121
2017,6,21,8,3762,4971,3881,-1090
2017,6,21,9,3759,4962,3865,-1097
2017,6,21,10,3883,5168,4018,-1150
2017,6,21,11,4147,5579,4372,-1207
2017,6,21,12,4451,5924,4778,-1146
2017,6,21,13,4791,6323,4973,-1350
2017,6,21,14,5264,6863,5321,-1542
2017,6,21,15,5696,7491,5681,-1810
2017,6,21,16,6334,8156,6219,-1937
2017,6,21,17,6770,8816,6721,-2095
2017,6,21,18,7162,9393,7162,-2231
2017,6,21,19,7394,9676,7332,-2344
2017,6,21,20,7416,9890,7506,-2384
2017,6,21,21,7370,10049,7686,-2363
2017,6,21,22,7107,9952,7731,-2221
2017,6,21,23,6875,9493,7374,-2119
2017,6,22,0,6536,8922,6903,-2019
2017,6,22,1,6311,8394,6449,-1945
2017,6,22,2,6057,7916,6165,-1751
2017,6,22,3,5602,7225,5705,-1520
2017,6,22,4,4966,6521,5218,-1303
2017,6,22,5,4582,5881,4642,-1239
2017,6,22,6,4220,5370,4201,-1169
2017,6,22,7,4024,5056,3958,-1098
2017,6,22,8,3910,4846,3779,-1067
2017,6,22,9,3881,4803,3729,-1074
2017,6,22,10,4020,4998,3889,-1109
2017,6,22,11,4293,5420,4251,-1169
2017,6,22,12,4598,5812,4624,-1188
2017,6,22,13,5047,6415,4958,-1457
2017,6,22,14,5640,7169,5401,-1768
2017,6,22,15,6260,7951,5875,-2076
2017,6,22,16,6857,8738,6549,-2189
2017,6,22,17,7282,9443,7075,-2368
2017,6,22,18,7761,10049,7502,-2547
2017,6,22,19,7901,10524,7806,-2718
2017,6,22,20,7941,10774,8058,-2716
2017,6,22,21,7871,10905,8146,-2759
2017,6,22,22,7629,10795,8224,-2571
2017,6,22,23,7489,10407,7958,-2449
2017,6,23,0,7033,9759,7310,-2449
2017,6,23,1,6693,9166,6833,-2333
2017,6,23,2,6374,8625,6516,-2109
2017,6,23,3,5846,7732,5809,-1923
2017,6,23,4,5164,6894,5160,-1734
2017,6,23,5,4581,6207,4811,-1396
2017,6,23,6,4212,5634,4370,-1264
2017,6,23,7,3968,5260,4074,-1186
2017,6,23,8,3827,5024,3874,-1150
2017,6,23,9,3786,4912,3792,-1120
2017,6,23,10,3892,5029,3894,-1135
2017,6,23,11,4123,5289,4102,-1187
2017,6,23,12,4415,5634,4455,-1179
2017,6,23,13,4904,6263,4818,-1445
2017,6,23,14,5495,7000,5281,-1719
2017,6,23,15,6091,7791,5767,-2024
2017,6,23,16,6741,8518,6403,-2115
2017,6,23,17,7253,9145,6843,-2302
2017,6,23,18,7672,9729,7323,-2406
2017,6,23,19,7947,10128,7631,-2497
2017,6,23,20,8101,10410,7880,-2530
2017,6,23,21,8103,10553,7993,-2560
2017,6,23,22,7965,10551,7987,-2564
2017,6,23,23,7568,10236,7804,-2432
2017,6,24,0,7073,9734,7302,-2432
2017,6,24,1,6779,9151,6797,-2354
2017,6,24,2,6415,8706,6573,-2133
2017,6,24,3,5853,7955,6055,-1900
2017,6,24,4,5326,7172,5387,-1785
2017,6,24,5,4926,6457,4949,-1508
2017,6,24,6,4517,5909,4533,-1376
2017,6,24,7,4232,5508,4216,-1292
2017,6,24,8,4071,5256,4020,-1236
2017,6,24,9,3959,5111,3909,-1202
2017,6,24,10,3946,5203,4009,-1194
2017,6,24,11,3946,5160,3961,-1199
2017,6,24,12,4162,5437,4179,-1258
2017,6,24,13,4728,6198,4644,-1554
2017,6,24,14,5412,7135,5321,-1814
2017,6,24,15,6089,8027,5976,-2051
2017,6,24,16,6696,8710,6514,-2196
2017,6,24,17,7172,9297,6986,-2311
2017,6,24,18,7602,9783,7393,-2390
2017,6,24,19,7872,10092,7720,-2372
2017,6,24,20,7979,10286,7903,-2383
2017,6,24,21,7968,10366,7965,-2401
2017,6,24,22,7742,10347,7887,-2460
2017,6,24,23,7388,9979,7561,-2418
2017,6,25,0,6967,9545,7248,-2297
2017,6,25,1,6663,8987,6805,-2182
2017,6,25,2,6350,8488,6538,-1950
2017,6,25,3,5872,7754,5859,-1895
2017,6,25,4,5358,7063,5375,-1688
2017,6,25,5,4853,6431,4972,-1459
2017,6,25,6,4436,5887,4548,-1339
2017,6,25,7,4170,5474,4220,-1254
2017,6,25,8,3988,5243,4038,-1205
2017,6,25,9,3846,5103,3925,-1178
2017,6,25,10,3828,5102,3936,-1166
2017,6,25,11,3856,5148,3978,-1170
2017,6,25,12,4114,5376,4143,-1233
2017,6,25,13,4697,6064,4454,-1610
2017,6,25,14,5445,6867,4990,-1877
2017,6,25,15,6073,7685,5616,-2069
2017,6,25,16,6760,8373,6118,-2255
2017,6,25,17,7196,8964,6509,-2455
2017,6,25,18,7642,9366,6877,-2489
2017,6,25,19,7878,9598,7091,-2507
2017,6,25,20,7878,9821,7233,-2588
2017,6,25,21,7880,9983,7396,-2587
2017,6,25,22,7657,10007,7388,-2619
2017,6,25,23,7376,9764,7142,-2622
2017,6,26,0,7053,9254,6795,-2459
2017,6,26,1,6646,8830,6436,-2394
2017,6,26,2,6369,8377,6193,-2184
2017,6,26,3,5858,7605,5490,-2115
2017,6,26,4,5252,6840,4958,-1882
2017,6,26,5,4657,6215,4618,-1597
2017,6,26,6,4305,5699,4237,-1462
2017,6,26,7,4079,5366,3952,-1414
2017,6,26,8,3906,5147,3797,-1350
2017,6,26,9,3879,5113,3775,-1338
2017,6,26,10,3995,5329,3926,-1403
2017,6,26,11,4341,5733,4284,-1449
2017,6,26,12,4645,6042,4487,-1555
2017,6,26,13,5045,6563,4767,-1796
2017,6,26,14,5557,7297,5161,-2136
2017,6,26,15,6110,8142,5675,-2467
2017,6,26,16,6716,8794,6203,-2591
2017,6,26,17,7237,9298,6859,-2439
2017,6,26,18,7674,9605,7282,-2323
2017,6,26,19,7943,9641,7283,-2358
2017,6,26,20,8052,9449,7120,-2329
2017,6,26,21,8073,9239,6858,-2381
2017,6,26,22,7909,9020,6616,-2404
2017,6,26,23,7645,8842,6495,-2347
2017,6,27,0,7208,8474,6240,-2234
2017,6,27,1,6857,8205,6025,-2180
2017,6,27,2,6508,7831,5878,-1953
2017,6,27,3,5943,7167,5201,-1966
2017,6,27,4,5341,6496,4811,-1685
2017,6,27,5,4724,5856,4530,-1326
2017,6,27,6,4342,5398,4081,-1317
2017,6,27,7,4104,5098,3759,-1339
2017,6,27,8,3905,4891,3555,-1336
2017,6,27,9,3880,4838,3471,-1367
2017,6,27,10,3995,4995,3486,-1509
2017,6,27,11,4294,5362,3681,-1681
2017,6,27,12,4573,5764,4095,-1669
2017,6,27,13,4906,6324,4515,-1809
2017,6,27,14,5414,6917,4824,-2093
2017,6,27,15,5905,7746,5372,-2374
2017,6,27,16,6425,8572,5985,-2587
2017,6,27,17,6768,9267,6665,-2602
2017,6,27,18,7128,9786,7311,-2475
2017,6,27,19,7405,10074,7377,-2697
2017,6,27,20,7525,10172,7477,-2695
2017,6,27,21,7495,9949,7288,-2661
2017,6,27,22,7338,9497,6879,-2618
2017,6,27,23,7094,9020,6594,-2426
2017,6,28,0,6657,8534,6249,-2285
2017,6,28,1,6414,8098,5948,-2150
2017,6,28,2,6083,7675,5752,-1923
2017,6,28,3,5530,6975,5121,-1854
2017,6,28,4,4973,6261,4645,-1616
2017,6,28,5,4482,5575,4254,-1321
2017,6,28,6,4119,5098,3812,-1286
2017,6,28,7,3884,4793,3576,-1217
2017,6,28,8,3743,4615,3436,-1179
2017,6,28,9,3733,4573,3325,-1248
2017,6,28,10,3847,4737,3349,-1388
2017,6,28,11,4063,5127,3507,-1620
2017,6,28,12,4333,5485,3869,-1616
2017,6,28,13,4746,5990,4217,-1773
2017,6,28,14,5303,6625,4668,-1957
2017,6,28,15,5842,7363,5140,-2223
2017,6,28,16,6422,8089,5699,-2390
2017,6,28,17,6811,8812,6386,-2426
2017,6,28,18,7204,9364,6748,-2616
2017,6,28,19,7411,9758,7034,-2724
2017,6,28,20,7460,9992,7183,-2809
2017,6,28,21,7422,10087,7148,-2939
2017,6,28,22,7185,9979,7091,-2888
2017,6,28,23,6985,9599,7111,-2488
2017,6,29,0,6611,9028,6752,-2276
2017,6,29,1,6376,8597,6250,-2347
2017,6,29,2,6101,8076,5971,-2105
2017,6,29,3,5564,7316,5400,-1916
2017,6,29,4,5024,6602,4958,-1644
2017,6,29,5,4578,5929,4538,-1391
2017,6,29,6,4217,5433,4069,-1364
2017,6,29,7,3991,5133,3808,-1325
2017,6,29,8,3870,4937,3665,-1272
2017,6,29,9,3880,4897,3638,-1259
2017,6,29,10,3983,5129,3806,-1323
2017,6,29,11,4168,5468,4081,-1387
2017,6,29,12,4458,5823,4342,-1481
2017,6,29,13,4883,6416,4665,-1751
2017,6,29,14,5418,7132,5103,-2029
2017,6,29,15,5972,7920,5617,-2303
2017,6,29,16,6641,8681,6154,-2527
2017,6,29,17,6955,9399,6753,-2646
2017,6,29,18,7328,9898,7193,-2705
2017,6,29,19,7506,10206,7436,-2770
2017,6,29,20,7524,10386,7368,-3018
2017,6,29,21,7597,10372,7432,-2940
2017,6,29,22,7460,10050,7385,-2665
2017,6,29,23,7302,9623,7057,-2566
2017,6,30,0,6915,9072,6686,-2386
2017,6,30,1,6620,8704,6493,-2211
2017,6,30,2,6341,8247,6061,-2186
2017,6,30,3,5775,7566,5510,-2056
2017,6,30,4,5213,6820,5048,-1772
2017,6,30,5,4832,6335,4647,-1688
2017,6,30,6,4408,5845,4283,-1562
2017,6,30,7,4175,5499,3992,-1507
2017,6,30,8,4014,5293,3816,-1477
2017,6,30,9,3967,5215,3763,-1452
2017,6,30,10,4101,5332,3842,-1490
2017,6,30,11,4328,5628,4074,-1554
2017,6,30,12,4629,5980,4376,-1604
2017,6,30,13,5106,6632,4721,-1911
2017,6,30,14,5695,7466,5190,-2276
2017,6,30,15,6283,8312,5894,-2418
2017,6,30,16,6929,9075,6429,-2646
2017,6,30,17,7510,9706,6945,-2761
2017,6,30,18,7884,10094,7223,-2871
2017,6,30,19,8096,10330,7409,-2921
2017,6,30,20,8203,10506,7609,-2897
2017,6,30,21,8134,10378,7546,-2832
2017,6,30,22,7890,9952,7057,-2895
2017,6,30,23,7591,9455,6612,-2843
2017,7,1,0,7125,8956,6379,-2577
2017,7,1,1,6852,8487,6164,-2323
2017,7,1,2,6540,8012,5787,-2225
2017,7,1,3,6040,7390,5252,-2138
2017,7,1,4,5474,6762,4746,-2016
2017,7,1,5,5085,6021,4294,-1727
2017,7,1,6,4632,5515,3924,-1591
2017,7,1,7,4353,5212,3648,-1564
2017,7,1,8,4144,4998,3489,-1509
2017,7,1,9,4031,4880,3392,-1488
2017,7,1,10,4036,4887,3383,-1504
2017,7,1,11,4064,4984,3446,-1538
2017,7,1,12,4284,5264,3680,-1584
2017,7,1,13,4887,6076,4224,-1852
2017,7,1,14,5656,6990,4907,-2083
2017,7,1,15,6274,7820,5527,-2293
2017,7,1,16,6906,8406,5867,-2539
2017,7,1,17,7417,8754,6238,-2516
2017,7,1,18,7681,8969,6462,-2507
2017,7,1,19,7729,9035,6548,-2487
2017,7,1,20,7738,8597,6151,-2446
2017,7,1,21,7635,8299,5765,-2534
2017,7,1,22,7451,8069,5490,-2579
2017,7,1,23,7193,7824,5439,-2385
2017,7,2,0,6785,7546,5222,-2324
2017,7,2,1,6493,7369,5103,-2266
2017,7,2,2,6232,7164,5038,-2126
2017,7,2,3,5762,6669,4588,-2081
2017,7,2,4,5298,6105,4116,-1989
2017,7,2,5,4683,5590,3825,-1765
2017,7,2,6,4388,5144,3519,-1625
2017,7,2,7,4241,4839,3289,-1550
2017,7,2,8,4050,4630,3174,-1456
2017,7,2,9,3940,4549,3158,-1391
2017,7,2,10,3914,4562,3178,-1384
2017,7,2,11,3906,4607,3177,-1430
2017,7,2,12,4095,4887,3394,-1493
2017,7,2,13,4706,5687,3869,-1818
2017,7,2,14,5530,6636,4550,-2086
2017,7,2,15,6159,7531,5202,-2329
2017,7,2,16,6906,8363,5828,-2535
2017,7,2,17,7399,9071,6333,-2738
2017,7,2,18,7769,9545,6716,-2829
2017,7,2,19,7933,9817,6901,-2916
2017,7,2,20,7920,10040,7083,-2957
2017,7,2,21,7845,10062,7121,-2941
2017,7,2,22,7687,9927,7111,-2816
2017,7,2,23,7325,9530,6889,-2641
2017,7,3,0,7004,9006,6412,-2594
2017,7,3,1,6607,8577,6227,-2350
2017,7,3,2,6290,8178,6005,-2173
2017,7,3,3,5798,7518,5411,-2107
2017,7,3,4,5278,6833,4837,-1996
2017,7,3,5,4642,6228,4618,-1610
2017,7,3,6,4283,5754,4309,-1445
2017,7,3,7,4037,5426,4009,-1417
2017,7,3,8,3872,5234,3865,-1369
2017,7,3,9,3856,5118,3808,-1310
2017,7,3,10,3950,5260,3881,-1379
2017,7,3,11,4140,5484,4083,-1401
2017,7,3,12,4326,5807,4374,-1433
2017,7,3,13,4763,6514,4741,-1773
2017,7,3,14,5441,7379,5374,-2005
2017,7,3,15,6129,8254,5951,-2303
2017,7,3,16,6804,9059,6555,-2504
2017,7,3,17,7437,9656,6934,-2722
2017,7,3,18,7755,9987,7156,-2831
2017,7,3,19,7988,10081,7286,-2795
2017,7,3,20,8034,9999,7393,-2606
2017,7,3,21,8027,9551,6993,-2558
2017,7,3,22,7765,8911,6390,-2521
2017,7,3,23,7504,8384,5927,-2457
2017,7,4,0,7072,7950,5534,-2416
2017,7,4,1,6759,7664,5466,-2198
2017,7,4,2,6337,7420,5467,-1953
2017,7,4,3,5843,6901,4957,-1944
2017,7,4,4,5367,6319,4477,-1842
2017,7,4,5,4814,5752,4243,-1509
2017,7,4,6,4442,5303,3889,-1414
2017,7,4,7,4170,4978,3632,-1346
2017,7,4,8,3993,4740,3441,-1299
2017,7,4,9,3930,4622,3367,-1255
2017,7,4,10,3929,4638,3361,-1277
2017,7,4,11,3984,4721,3444,-1277
2017,7,4,12,4133,4973,3675,-1298
2017,7,4,13,4657,5740,4108,-1632
2017,7,4,14,5439,6778,4814,-1964
2017,7,4,15,6108,7848,5565,-2283
2017,7,4,16,6845,8777,6150,-2627
2017,7,4,17,7433,9509,6645,-2864
2017,7,4,18,7782,9992,7067,-2925
2017,7,4,19,7927,10310,7456,-2854
2017,7,4,20,7995,10440,7488,-2952
2017,7,4,21,7886,10332,7501,-2831
2017,7,4,22,7613,9710,6939,-2771
2017,7,4,23,7193,9080,6321,-2759
2017,7,5,0,6720,8363,5827,-2536
2017,7,5,1,6440,7867,5616,-2251
2017,7,5,2,6042,7504,5485,-2019
2017,7,5,3,5695,7136,5143,-1993
2017,7,5,4,5308,6573,4734,-1839
2017,7,5,5,4895,5920,4414,-1506
2017,7,5,6,4502,5452,4084,-1368
2017,7,5,7,4222,5146,3847,-1299
2017,7,5,8,4056,4938,3686,-1252
2017,7,5,9,3994,4864,3640,-1224
2017,7,5,10,4089,5070,3798,-1272
2017,7,5,11,4325,5372,4050,-1322
2017,7,5,12,4641,5585,4180,-1405
2017,7,5,13,5172,6479,4760,-1719
2017,7,5,14,5893,7339,5363,-1976
2017,7,5,15,6564,8256,5955,-2301
2017,7,5,16,7205,9126,6499,-2627
2017,7,5,17,7717,9886,7050,-2836
2017,7,5,18,8106,10457,7623,-2834
2017,7,5,19,8332,10846,7951,-2895
2017,7,5,20,8500,11057,8176,-2881
2017,7,5,21,8473,11088,8196,-2892
2017,7,5,22,8282,10821,7869,-2952
2017,7,5,23,7930,10504,7631,-2873
2017,7,6,0,7412,13074,10336,-2738
2017,7,6,1,7059,9519,7038,-2481
2017,7,6,2,6710,8900,6632,-2268
2017,7,6,3,6136,8040,5867,-2173
2017,7,6,4,5569,7237,5301,-1936
2017,7,6,5,5068,6534,4908,-1626
2017,7,6,6,4668,5983,4506,-1477
2017,7,6,7,4385,5634,4233,-1401
2017,7,6,8,4206,5415,4054,-1361
2017,7,6,9,4138,5312,3985,-1327
2017,7,6,10,4229,5428,4061,-1367
2017,7,6,11,4452,5673,4261,-1412
2017,7,6,12,4747,5998,4497,-1501
2017,7,6,13,5244,6646,4843,-1803
2017,7,6,14,5975,7475,5450,-2025
2017,7,6,15,6642,8311,5997,-2314
2017,7,6,16,7461,9146,6659,-2487
2017,7,6,17,7846,9835,7258,-2577
2017,7,6,18,8275,10386,7684,-2702
2017,7,6,19,8539,10705,7937,-2768
2017,7,6,20,8639,10940,8091,-2849
2017,7,6,21,8611,11013,8185,-2828
2017,7,6,22,8356,10944,8146,-2798
2017,7,6,23,8082,10593,7811,-2782
2017,7,7,0,7555,10097,7391,-2706
2017,7,7,1,7247,9541,6911,-2630
2017,7,7,2,6795,9078,6661,-2417
2017,7,7,3,6183,8198,5885,-2313
2017,7,7,4,5569,7386,5269,-2117
2017,7,7,5,4951,6685,4819,-1866
2017,7,7,6,4535,6097,4385,-1712
2017,7,7,7,4234,5673,4069,-1604
2017,7,7,8,4085,5434,3857,-1577
2017,7,7,9,4016,5286,3749,-1537
2017,7,7,10,4153,5389,3815,-1574
2017,7,7,11,4372,5619,3860,-1759
2017,7,7,12,4683,5950,4137,-1813
2017,7,7,13,5117,6612,4526,-2086
2017,7,7,14,5820,7501,5153,-2348
2017,7,7,15,6438,8381,5814,-2567
2017,7,7,16,7170,9207,6485,-2722
2017,7,7,17,7564,9813,6956,-2857
2017,7,7,18,7918,10183,7276,-2907
2017,7,7,19,8116,10406,7538,-2868
2017,7,7,20,8227,10525,7740,-2785
2017,7,7,21,8296,10467,7777,-2690
2017,7,7,22,8052,10378,7614,-2764
2017,7,7,23,7692,10113,7382,-2731
2017,7,8,0,7218,9596,6957,-2639
2017,7,8,1,6942,9135,6721,-2414
2017,7,8,2,6553,8633,6422,-2211
2017,7,8,3,6008,7921,5771,-2150
2017,7,8,4,5471,7238,5243,-1995
2017,7,8,5,5074,6586,4809,-1777
2017,7,8,6,4642,6048,4385,-1663
2017,7,8,7,4345,5690,4103,-1587
2017,7,8,8,4132,5413,3905,-1508
2017,7,8,9,4005,5267,3766,-1501
2017,7,8,10,4027,5205,3692,-1513
2017,7,8,11,4079,5185,3521,-1664
2017,7,8,12,4283,5485,3750,-1735
2017,7,8,13,4871,6301,4232,-2069
2017,7,8,14,5616,7234,4854,-2380
2017,7,8,15,6252,7930,5470,-2460
2017,7,8,16,6950,8308,5777,-2531
2017,7,8,17,7327,8422,5891,-2531
2017,7,8,18,7564,8467,5928,-2539
2017,7,8,19,7718,8561,6022,-2539
2017,7,8,20,7747,8501,5840,-2661
2017,7,8,21,7838,8590,5871,-2719
2017,7,8,22,7705,8626,5821,-2805
2017,7,8,23,7292,8445,5680,-2765
2017,7,9,0,6877,7898,5264,-2634
2017,7,9,1,6580,7753,5335,-2418
2017,7,9,2,6266,7442,5241,-2201
2017,7,9,3,5783,6881,4689,-2192
2017,7,9,4,5314,6299,4290,-2009
2017,7,9,5,4845,5754,4149,-1605
2017,7,9,6,4465,5309,3866,-1443
2017,7,9,7,4187,4995,3650,-1345
2017,7,9,8,4018,4788,3479,-1309
2017,7,9,9,3905,4638,3382,-1256
2017,7,9,10,3874,4612,3348,-1264
2017,7,9,11,3888,4649,3375,-1274
2017,7,9,12,4099,4922,3584,-1338
2017,7,9,13,4670,5662,3963,-1699
2017,7,9,14,5463,6580,4596,-1984
2017,7,9,15,6094,7524,5196,-2328
2017,7,9,16,6807,8335,5705,-2630
2017,7,9,17,7111,9046,6237,-2809
2017,7,9,18,7430,9519,6728,-2791
2017,7,9,19,7628,9853,6970,-2883
2017,7,9,20,7597,9989,7091,-2898
2017,7,9,21,7565,9903,7109,-2794
2017,7,9,22,7433,9661,6963,-2698
2017,7,9,23,7096,9180,6450,-2730
2017,7,10,0,6694,8656,6069,-2587
2017,7,10,1,6435,8272,5941,-2331
2017,7,10,2,6120,7875,5770,-2105
2017,7,10,3,5615,7153,5079,-2074
2017,7,10,4,5100,6461,4610,-1851
2017,7,10,5,4634,5831,4351,-1480
2017,7,10,6,4273,5363,3981,-1382
2017,7,10,7,4018,5055,3746,-1309
2017,7,10,8,3866,4848,3594,-1254
2017,7,10,9,3834,4834,3580,-1254
2017,7,10,10,3936,5044,3731,-1313
2017,7,10,11,4262,5403,4021,-1382
2017,7,10,12,4571,5801,4366,-1435
2017,7,10,13,5063,6481,4715,-1766
2017,7,10,14,5684,7297,5263,-2034
2017,7,10,15,6269,8171,5835,-2336
2017,7,10,16,7033,8984,6380,-2604
2017,7,10,17,7386,9587,6892,-2695
2017,7,10,18,7692,10067,7371,-2696
2017,7,10,19,7917,10332,7659,-2673
2017,7,10,20,8068,10415,7586,-2829
2017,7,10,21,8112,10397,7601,-2796
2017,7,10,22,7955,9725,7046,-2679
2017,7,10,23,7660,8883,6291,-2592
2017,7,11,0,7223,8244,5792,-2452
2017,7,11,1,6960,7773,5501,-2272
2017,7,11,2,6548,7297,5296,-2001
2017,7,11,3,5960,6675,4712,-1963
2017,7,11,4,5386,5988,4274,-1714
2017,7,11,5,4791,5618,4234,-1384
2017,7,11,6,4400,5220,3942,-1278
2017,7,11,7,4126,4942,3725,-1217
2017,7,11,8,3958,4786,3618,-1168
2017,7,11,9,3926,4763,3603,-1160
2017,7,11,10,4071,4948,3729,-1219
2017,7,11,11,4380,5354,4025,-1329
2017,7,11,12,4634,5676,4307,-1369
2017,7,11,13,5073,6349,4675,-1674
2017,7,11,14,5730,7152,5242,-1910
2017,7,11,15,6411,8023,5818,-2205
2017,7,11,16,7013,8831,6403,-2428
2017,7,11,17,7419,9507,6986,-2521
2017,7,11,18,7803,9950,7264,-2686
2017,7,11,19,8107,10067,7424,-2643
2017,7,11,20,8207,9824,7203,-2621
2017,7,11,21,8183,9521,6902,-2619
2017,7,11,22,8028,9430,6852,-2578
2017,7,11,23,7715,9178,6652,-2526
2017,7,12,0,7388,8737,6289,-2448
2017,7,12,1,7093,8336,6113,-2223
2017,7,12,2,6700,7948,5959,-1989
2017,7,12,3,6094,7257,5351,-1906
2017,7,12,4,5489,6564,4842,-1722
2017,7,12,5,4944,5743,4339,-1404
2017,7,12,6,4535,5280,3982,-1298
2017,7,12,7,4258,4953,3733,-1220
2017,7,12,8,4107,4781,3576,-1205
2017,7,12,9,4045,4758,3567,-1191
2017,7,12,10,4162,4948,3704,-1244
2017,7,12,11,4435,5304,3982,-1322
2017,7,12,12,4717,5645,4285,-1360
2017,7,12,13,5209,6243,4580,-1663
2017,7,12,14,5817,7045,5091,-1954
2017,7,12,15,6518,7888,5673,-2215
2017,7,12,16,7080,8704,6235,-2469
2017,7,12,17,7520,9284,6654,-2630
2017,7,12,18,7889,9620,6896,-2724
2017,7,12,19,8201,9882,7188,-2694
2017,7,12,20,8404,10039,7370,-2669
2017,7,12,21,8451,9976,7336,-2640
2017,7,12,22,8269,9408,6838,-2570
2017,7,12,23,8021,8838,6233,-2605
2017,7,13,0,7582,8327,5791,-2536
2017,7,13,1,7254,7975,5633,-2342
2017,7,13,2,6852,7592,5549,-2043
2017,7,13,3,6249,6958,4936,-2022
2017,7,13,4,5627,6245,4373,-1872
2017,7,13,5,4831,5638,4143,-1495
2017,7,13,6,4427,5198,3832,-1366
2017,7,13,7,4204,4924,3597,-1327
2017,7,13,8,4007,4728,3463,-1265
2017,7,13,9,3970,4711,3452,-1259
2017,7,13,10,4077,4930,3624,-1306
2017,7,13,11,4349,5329,3939,-1390
2017,7,13,12,4628,5703,4203,-1500
2017,7,13,13,5064,6338,4580,-1758
2017,7,13,14,5679,7149,5135,-2014
2017,7,13,15,6383,7953,5644,-2309
2017,7,13,16,6950,8657,6118,-2539
2017,7,13,17,7319,9174,6552,-2622
2017,7,13,18,7638,9379,6762,-2617
2017,7,13,19,7857,9379,6891,-2488
2017,7,13,20,7829,9300,6751,-2549
2017,7,13,21,7637,9219,6603,-2616
2017,7,13,22,7502,9021,6460,-2561
2017,7,13,23,7265,8735,6237,-2498
2017,7,14,0,6920,8468,6044,-2424
2017,7,14,1,6688,8260,6020,-2240
2017,7,14,2,6350,7976,5912,-2064
2017,7,14,3,5830,7360,5311,-2049
2017,7,14,4,5328,6711,4819,-1892
2017,7,14,5,4629,6109,4437,-1672
2017,7,14,6,4253,5679,4090,-1589
2017,7,14,7,4046,5386,3923,-1463
2017,7,14,8,3906,5165,3760,-1405
2017,7,14,9,3858,5109,3710,-1399
2017,7,14,10,3968,5226,3799,-1427
2017,7,14,11,4252,5535,4015,-1520
2017,7,14,12,4544,5819,4238,-1581
2017,7,14,13,5037,6405,4741,-1664
2017,7,14,14,5701,7167,5369,-1798
2017,7,14,15,6420,7951,5813,-2138
2017,7,14,16,7112,8692,6175,-2517
2017,7,14,17,7475,9282,6631,-2651
2017,7,14,18,7822,9700,6954,-2746
2017,7,14,19,8101,9830,7045,-2785
2017,7,14,20,8183,9550,6861,-2689
2017,7,14,21,8153,9172,6524,-2648
2017,7,14,22,7937,8759,6147,-2612
2017,7,14,23,7699,8287,5697,-2590
2017,7,15,0,7250,7877,5392,-2485
2017,7,15,1,6895,7712,5414,-2298
2017,7,15,2,6526,7445,5354,-2091
2017,7,15,3,5994,6931,4812,-2119
2017,7,15,4,5437,6376,4435,-1941
2017,7,15,5,4987,5857,4041,-1816
2017,7,15,6,4612,5423,3719,-1704
2017,7,15,7,4373,5115,3491,-1624
2017,7,15,8,4174,4917,3327,-1590
2017,7,15,9,4061,4789,3199,-1590
2017,7,15,10,4062,4809,3223,-1586
2017,7,15,11,4090,4884,3272,-1612
2017,7,15,12,4274,5191,3409,-1782
2017,7,15,13,4844,6035,4090,-1945
2017,7,15,14,5539,6927,4804,-2123
2017,7,15,15,6226,7772,5456,-2316
2017,7,15,16,6797,8521,6048,-2473
2017,7,15,17,7152,9221,6558,-2663
2017,7,15,18,7390,9720,6906,-2814
2017,7,15,19,7701,10045,7386,-2659
2017,7,15,20,7812,10211,7466,-2745
2017,7,15,21,7887,10232,7526,-2706
2017,7,15,22,7777,10127,7439,-2688
2017,7,15,23,7509,9834,7209,-2625
2017,7,16,0,7103,9227,6527,-2700
2017,7,16,1,6764,8776,6083,-2693
2017,7,16,2,6398,8348,5860,-2488
2017,7,16,3,5902,7645,5279,-2366
2017,7,16,4,5408,6963,4924,-2039
2017,7,16,5,4805,6279,4496,-1783
2017,7,16,6,4433,5753,3974,-1779
2017,7,16,7,4154,5375,3695,-1680
2017,7,16,8,3969,5123,3498,-1625
2017,7,16,9,3851,4967,3386,-1581
2017,7,16,10,3797,4916,3327,-1589
2017,7,16,11,3773,4934,3367,-1567
2017,7,16,12,3972,5189,3635,-1554
2017,7,16,13,4492,5990,4426,-1564
2017,7,16,14,5355,6958,5075,-1883
2017,7,16,15,6038,7870,5641,-2229
2017,7,16,16,6616,8714,6198,-2516
2017,7,16,17,7160,9406,6636,-2770
2017,7,16,18,7501,9822,6957,-2865
2017,7,16,19,7688,10067,7103,-2964
2017,7,16,20,7894,10023,7132,-2891
2017,7,16,21,7980,9870,7027,-2843
2017,7,16,22,7765,9722,6835,-2887
2017,7,16,23,7508,9513,6751,-2762
2017,7,17,0,7085,9069,6493,-2576
2017,7,17,1,6813,8680,6179,-2501
2017,7,17,2,6407,8259,5860,-2399
2017,7,17,3,5844,7532,5245,-2287
2017,7,17,4,5293,6745,4734,-2011
2017,7,17,5,4913,6068,4379,-1689
2017,7,17,6,4498,5538,3904,-1634
2017,7,17,7,4222,5235,3651,-1584
2017,7,17,8,4048,5018,3474,-1544
2017,7,17,9,4005,4993,3455,-1538
2017,7,17,10,4132,5189,3600,-1589
2017,7,17,11,4469,5552,3978,-1574
2017,7,17,12,4728,5905,4130,-1775
2017,7,17,13,5207,6555,4732,-1823
2017,7,17,14,5819,7408,5458,-1950
2017,7,17,15,6544,8268,6061,-2207
2017,7,17,16,7069,9082,6597,-2485
2017,7,17,17,7548,9694,7025,-2669
2017,7,17,18,7889,9978,7238,-2740
2017,7,17,19,8119,9958,7102,-2856
2017,7,17,20,8150,9763,6984,-2779
2017,7,17,21,8028,9413,6772,-2641
2017,7,17,22,7864,8814,6220,-2594
2017,7,17,23,7558,8347,5873,-2474
2017,7,18,0,7103,7982,5606,-2376
2017,7,18,1,6862,7653,5300,-2353
2017,7,18,2,6455,7333,5136,-2197
2017,7,18,3,5888,6700,4605,-2095
2017,7,18,4,5339,6002,4207,-1795
2017,7,18,5,4881,5454,3856,-1598
2017,7,18,6,4486,5055,3534,-1521
2017,7,18,7,4211,4820,3348,-1472
2017,7,18,8,4026,4684,3249,-1435
2017,7,18,9,3963,4670,3240,-1430
2017,7,18,10,4089,4866,3377,-1489
2017,7,18,11,4352,5256,3685,-1571
2017,7,18,12,4605,5574,3812,-1762
2017,7,18,13,5033,6177,4256,-1921
2017,7,18,14,5654,6933,4899,-2034
2017,7,18,15,6327,7796,5503,-2293
2017,7,18,16,6920,8357,5932,-2425
2017,7,18,17,7265,8717,6271,-2446
2017,7,18,18,7611,9057,6582,-2475
2017,7,18,19,7797,9227,6727,-2500
2017,7,18,20,7776,9340,6800,-2540
2017,7,18,21,7692,9414,6776,-2638
2017,7,18,22,7573,9288,6681,-2607
2017,7,18,23,7318,8775,6243,-2532
2017,7,19,0,6979,8370,5930,-2440
2017,7,19,1,6795,8023,5650,-2373
2017,7,19,2,6394,7638,5342,-2296
2017,7,19,3,5880,6981,4767,-2214
2017,7,19,4,5340,6262,4304,-1958
2017,7,19,5,4530,5683,3959,-1724
2017,7,19,6,4211,5227,3567,-1660
2017,7,19,7,3995,4939,3342,-1597
2017,7,19,8,3883,4768,3211,-1557
2017,7,19,9,3877,4753,3197,-1556
2017,7,19,10,4034,4946,3356,-1590
2017,7,19,11,4340,5338,3662,-1676
2017,7,19,12,4617,5699,3899,-1800
2017,7,19,13,5065,6313,4528,-1785
2017,7,19,14,5613,6923,5021,-1902
2017,7,19,15,6273,7478,5297,-2181
2017,7,19,16,6853,8106,5636,-2470
2017,7,19,17,7156,8813,6250,-2563
2017,7,19,18,7452,9338,6710,-2628
2017,7,19,19,7552,9755,7047,-2708
2017,7,19,20,7494,9969,7234,-2735
2017,7,19,21,7333,9995,7253,-2742
2017,7,19,22,7075,9834,7073,-2761
2017,7,19,23,6819,9463,6736,-2727
2017,7,20,0,6476,8939,6265,-2674
2017,7,20,1,6354,8479,5881,-2598
2017,7,20,2,6018,8026,5703,-2323
2017,7,20,3,5532,7264,5017,-2247
2017,7,20,4,5055,6517,4553,-1964
2017,7,20,5,4509,5876,4170,-1706
2017,7,20,6,4182,5398,3718,-1680
2017,7,20,7,3956,5084,3468,-1616
2017,7,20,8,3849,4896,3321,-1575
2017,7,20,9,3824,4877,3308,-1569
2017,7,20,10,3959,5046,3437,-1609
2017,7,20,11,4206,5433,3758,-1675
2017,7,20,12,4457,5707,3891,-1816
2017,7,20,13,4865,6294,4478,-1816
2017,7,20,14,5411,7078,5140,-1938
2017,7,20,15,6042,7908,5634,-2274
2017,7,20,16,6473,8680,6066,-2614
2017,7,20,17,6911,9358,6655,-2703
2017,7,20,18,7150,9807,7028,-2779
2017,7,20,19,7380,10143,7299,-2844
2017,7,20,20,7456,10347,7501,-2846
2017,7,20,21,7401,10213,7383,-2830
2017,7,20,22,7113,9685,6784,-2901
2017,7,20,23,6859,9148,6413,-2735
2017,7,21,0,6583,8662,5944,-2718
2017,7,21,1,6339,8188,5624,-2564
2017,7,21,2,5976,7722,5414,-2308
2017,7,21,3,5492,7035,4867,-2168
2017,7,21,4,4990,6372,4505,-1867
2017,7,21,5,4555,5762,4139,-1623
2017,7,21,6,4193,5321,3730,-1591
2017,7,21,7,3990,5027,3494,-1533
2017,7,21,8,3842,4848,3344,-1504
2017,7,21,9,3823,4798,3308,-1490
2017,7,21,10,3952,4962,3436,-1526
2017,7,21,11,4222,5323,3724,-1599
2017,7,21,12,4503,5614,3877,-1737
2017,7,21,13,4941,6167,4398,-1769
2017,7,21,14,5506,6900,4999,-1901
2017,7,21,15,6131,7740,5504,-2236
2017,7,21,16,6545,8490,5942,-2548
2017,7,21,17,6980,8996,6331,-2665
2017,7,21,18,7235,9451,6849,-2602
2017,7,21,19,7467,9521,6755,-2766
2017,7,21,20,7547,9224,6486,-2738
2017,7,21,21,7467,8789,6258,-2531
2017,7,21,22,7179,8308,5803,-2505
2017,7,21,23,6917,7863,5440,-2423
2017,7,22,0,6614,7539,5207,-2332
2017,7,22,1,6322,7383,5094,-2289
2017,7,22,2,5971,7138,5035,-2103
2017,7,22,3,5552,6639,4583,-2056
2017,7,22,4,5077,6124,4317,-1807
2017,7,22,5,4654,5596,4042,-1554
2017,7,22,6,4317,5189,3749,-1440
2017,7,22,7,4069,4881,3506,-1375
2017,7,22,8,3899,4703,3345,-1358
2017,7,22,9,3809,4627,3293,-1334
2017,7,22,10,3821,4652,3325,-1327
2017,7,22,11,3918,4794,3428,-1366
2017,7,22,12,4112,5028,3488,-1540
2017,7,22,13,4648,5738,4098,-1640
2017,7,22,14,5365,6600,4698,-1902
2017,7,22,15,6003,7403,5134,-2269
2017,7,22,16,6513,8024,5502,-2522
2017,7,22,17,6981,8381,5860,-2521
2017,7,22,18,7182,8246,5845,-2401
2017,7,22,19,7434,7666,5290,-2376
2017,7,22,20,7610,7394,5046,-2348
2017,7,22,21,7518,7371,4993,-2378
2017,7,22,22,7273,7358,4959,-2399
2017,7,22,23,6882,7213,4849,-2364
2017,7,23,0,6570,7029,4722,-2307
2017,7,23,1,6290,6996,4706,-2290
2017,7,23,2,5990,6836,4720,-2116
2017,7,23,3,5529,6410,4353,-2057
2017,7,23,4,5079,5943,4167,-1776
2017,7,23,5,4328,5463,3998,-1465
2017,7,23,6,4077,5064,3585,-1479
2017,7,23,7,3934,4826,3389,-1437
2017,7,23,8,3809,4681,3271,-1410
2017,7,23,9,3693,4627,3249,-1378
2017,7,23,10,3695,4634,3252,-1382
2017,7,23,11,3759,4757,3318,-1439
2017,7,23,12,3950,4927,3344,-1583
2017,7,23,13,4465,5464,3830,-1634
2017,7,23,14,5201,6007,4234,-1773
2017,7,23,15,5868,6488,4521,-1967
2017,7,23,16,6380,6850,4717,-2133
2017,7,23,17,6907,6868,4693,-2175
2017,7,23,18,7200,6812,4618,-2194
2017,7,23,19,7432,6823,4617,-2206
2017,7,23,20,7391,6934,4692,-2242
2017,7,23,21,7389,7096,4823,-2273
2017,7,23,22,7200,7252,4936,-2316
2017,7,23,23,6881,7306,4969,-2337
2017,7,24,0,6626,7146,4854,-2292
2017,7,24,1,6355,7091,4879,-2212
2017,7,24,2,6043,6913,5000,-1913
2017,7,24,3,5544,6387,4682,-1705
2017,7,24,4,5060,5803,4341,-1462
2017,7,24,5,4086,5280,4059,-1221
2017,7,24,6,3819,4924,3717,-1207
2017,7,24,7,3714,4713,3539,-1174
2017,7,24,8,3643,4603,3461,-1142
2017,7,24,9,3696,4662,3502,-1160
2017,7,24,10,3850,4888,3676,-1212
2017,7,24,11,4199,5346,4043,-1303
2017,7,24,12,4477,5672,4342,-1330
2017,7,24,13,4910,6118,4715,-1403
2017,7,24,14,5481,6765,5174,-1591
2017,7,24,15,6103,7512,5528,-1984
2017,7,24,16,6740,8068,5795,-2273
2017,7,24,17,7294,8550,6164,-2386
2017,7,24,18,7543,8888,6364,-2524
2017,7,24,19,7822,9154,6557,-2597
2017,7,24,20,7848,9240,6598,-2642
2017,7,24,21,7828,9192,6520,-2672
2017,7,24,22,7595,9117,6411,-2706
2017,7,24,23,7314,8931,6243,-2688
2017,7,25,0,7023,8629,6013,-2616
2017,7,25,1,6737,8365,5826,-2539
2017,7,25,2,6354,7998,5681,-2317
2017,7,25,3,5822,7308,5134,-2174
2017,7,25,4,5282,6564,4687,-1877
2017,7,25,5,4788,5896,4337,-1559
2017,7,25,6,4433,5440,3939,-1501
2017,7,25,7,4217,5150,3697,-1453
2017,7,25,8,4076,4955,3527,-1428
2017,7,25,9,4022,4917,3500,-1417
2017,7,25,10,4163,5078,3643,-1435
2017,7,25,11,4493,5457,3950,-1507
2017,7,25,12,4763,5756,4097,-1659
2017,7,25,13,5192,6316,4583,-1733
2017,7,25,14,5766,7094,5133,-1961
2017,7,25,15,6414,7945,5714,-2231
2017,7,25,16,6976,8733,6273,-2460
2017,7,25,17,7516,9485,6761,-2724
2017,7,25,18,7752,10056,7331,-2725
2017,7,25,19,8061,10485,7690,-2795
2017,7,25,20,8152,10815,7935,-2880
2017,7,25,21,8185,11017,8057,-2960
2017,7,25,22,7926,10965,8063,-2902
2017,7,25,23,7619,10636,7810,-2826
2017,7,26,0,7297,10051,7459,-2592
2017,7,26,1,6995,9547,7127,-2420
2017,7,26,2,6574,8952,6711,-2241
2017,7,26,3,5997,8053,5876,-2177
2017,7,26,4,5421,7160,5110,-2050
2017,7,26,5,4949,6413,4770,-1643
2017,7,26,6,4560,5866,4277,-1589
2017,7,26,7,4312,5497,3987,-1510
2017,7,26,8,4165,5270,3794,-1476
2017,7,26,9,4115,5221,3754,-1467
2017,7,26,10,4236,5379,3860,-1519
2017,7,26,11,4511,5746,4166,-1580
2017,7,26,12,4749,5989,4322,-1667
2017,7,26,13,5189,6531,4823,-1708
2017,7,26,14,5780,7350,5369,-1981
2017,7,26,15,6444,8305,6081,-2224
2017,7,26,16,7026,9152,6773,-2379
2017,7,26,17,7553,9862,7271,-2591
2017,7,26,18,7889,10427,7624,-2803
2017,7,26,19,8210,10826,7922,-2904
2017,7,26,20,8347,11093,8163,-2930
2017,7,26,21,8300,11197,8300,-2897
2017,7,26,22,8076,11030,8175,-2855
2017,7,26,23,7721,10619,7817,-2802
2017,7,27,0,7335,10054,7292,-2762
2017,7,27,1,7049,9571,6958,-2613
2017,7,27,2,6648,9077,6699,-2378
2017,7,27,3,6057,8228,5921,-2307
2017,7,27,4,5489,7401,5323,-2078
2017,7,27,5,5082,6681,4921,-1760
2017,7,27,6,4673,6164,4492,-1672
2017,7,27,7,4377,5797,4201,-1596
2017,7,27,8,4215,5572,4030,-1542
2017,7,27,9,4165,5504,3985,-1519
2017,7,27,10,4276,5681,4120,-1561
2017,7,27,11,4552,5994,4248,-1746
2017,7,27,12,4790,6213,4346,-1867
2017,7,27,13,5220,6651,4726,-1925
2017,7,27,14,5830,7364,5332,-2032
2017,7,27,15,6523,8217,5892,-2325
2017,7,27,16,7071,9093,6552,-2541
2017,7,27,17,7765,9811,7201,-2610
2017,7,27,18,8147,10431,7689,-2742
2017,7,27,19,8402,10822,8036,-2786
2017,7,27,20,8483,11039,8137,-2902
2017,7,27,21,8452,11017,8044,-2973
2017,7,27,22,8220,10770,7805,-2965
2017,7,27,23,7875,10286,7415,-2871
2017,7,28,0,7402,9617,6783,-2834
2017,7,28,1,7114,9161,6495,-2666
2017,7,28,2,6719,8665,6223,-2442
2017,7,28,3,6135,7897,5607,-2290
2017,7,28,4,5579,7112,5021,-2091
2017,7,28,5,5023,6422,4582,-1840
2017,7,28,6,4591,5903,4104,-1799
2017,7,28,7,4301,5600,3874,-1726
2017,7,28,8,4115,5375,3700,-1675
2017,7,28,9,4048,5319,3661,-1658
2017,7,28,10,4153,5457,3764,-1693
2017,7,28,11,4415,5783,4042,-1741
2017,7,28,12,4667,6010,4134,-1876
2017,7,28,13,5138,6616,4679,-1937
2017,7,28,14,5775,7546,5375,-2171
2017,7,28,15,6562,8435,5991,-2444
2017,7,28,16,7203,9224,6498,-2726
2017,7,28,17,7785,9799,7016,-2783
2017,7,28,18,8160,10244,7444,-2800
2017,7,28,19,8432,10513,7578,-2935
2017,7,28,20,8553,10523,7627,-2896
2017,7,28,21,8509,10200,7338,-2862
2017,7,28,22,8251,0,7338,-2750
2017,7,28,23,7886,9681,6914,-2767
2017,7,29,0,7372,9287,6583,-2704
2017,7,29,1,7009,8884,6203,-2681
2017,7,29,2,6666,8458,5991,-2467
2017,7,29,3,6179,7791,5445,-2346
2017,7,29,4,5663,7126,5067,-2059
2017,7,29,5,5272,6533,4730,-1803
2017,7,29,6,4869,6020,4270,-1750
2017,7,29,7,4562,5674,3967,-1707
2017,7,29,8,4362,5455,3795,-1660
2017,7,29,9,4235,5347,3701,-1646
2017,7,29,10,4220,5358,3700,-1658
2017,7,29,11,4297,5440,3777,-1663
2017,7,29,12,4470,5678,3841,-1837
2017,7,29,13,5026,6462,4535,-1927
2017,7,29,14,5779,7393,5345,-2048
2017,7,29,15,6491,8196,5835,-2361
2017,7,29,16,7165,8782,6246,-2536
2017,7,29,17,7670,9045,6414,-2631
2017,7,29,18,7953,9173,6445,-2728
2017,7,29,19,8040,9428,6637,-2791
2017,7,29,20,7997,9459,6679,-2780
2017,7,29,21,7894,9457,6590,-2867
2017,7,29,22,7729,9397,6567,-2830
2017,7,29,23,7359,9088,6374,-2714
2017,7,30,0,7025,0,6374,-2634
2017,7,30,1,6711,8455,5869,-2586
2017,7,30,2,6395,7919,5584,-2335
2017,7,30,3,5911,7494,5238,-2256
2017,7,30,4,5438,6928,4909,-2019
2017,7,30,5,4841,6414,4584,-1830
2017,7,30,6,4447,5960,4311,-1649
2017,7,30,7,4190,5677,4097,-1580
2017,7,30,8,4031,5484,3934,-1550
2017,7,30,9,3947,5388,3838,-1550
2017,7,30,10,3934,5383,3684,-1699
2017,7,30,11,4007,5478,3861,-1617
2017,7,30,12,4164,5668,3983,-1685
2017,7,30,13,4690,6160,4413,-1747
2017,7,30,14,5376,6664,4756,-1908
2017,7,30,15,5890,7044,4953,-2091
2017,7,30,16,6343,7260,4996,-2264
2017,7,30,17,6668,7340,5049,-2291
2017,7,30,18,6848,7302,4867,-2435
2017,7,30,19,6944,7334,4820,-2514
2017,7,30,20,6855,7401,4820,-2581
2017,7,30,21,6790,7444,4827,-2617
2017,7,30,22,6658,7446,4817,-2629
2017,7,30,23,6433,7291,4699,-2592
2017,7,31,0,6111,7094,4690,-2404
2017,7,31,1,5991,7008,4676,-2332
2017,7,31,2,5691,6837,4668,-2169
2017,7,31,3,5218,6340,4248,-2092
2017,7,31,4,4777,5775,3882,-1893
2017,7,31,5,4300,5295,3687,-1608
2017,7,31,6,3973,4939,3404,-1535
2017,7,31,7,3760,4688,3181,-1507
2017,7,31,8,3658,4580,3158,-1422
2017,7,31,9,3656,4587,3154,-1433
2017,7,31,10,3819,4839,3338,-1501
2017,7,31,11,4238,5299,3709,-1590
2017,7,31,12,4488,5556,3807,-1749
2017,7,31,13,4755,5889,4063,-1826
2017,7,31,14,5210,6342,4364,-1978
2017,7,31,15,5651,6829,4582,-2247
2017,7,31,16,5968,7200,4690,-2510
2017,7,31,17,6482,7470,4858,-2612
2017,7,31,18,6773,7658,5014,-2644
2017,7,31,19,6878,7838,5162,-2676
2017,7,31,20,7012,7978,5358,-2620
2017,7,31,21,7051,8072,5484,-2588
2017,7,31,22,6778,8045,5437,-2608
2017,7,31,23,6536,7930,5330,-2600
2017,8,1,0,6229,7620,5110,-2510
2017,8,1,1,6017,7403,4962,-2441
2017,8,1,2,5747,7117,4817,-2300
2017,8,1,3,5294,6513,4300,-2213
2017,8,1,4,4766,5856,3935,-1921
2017,8,1,5,4266,5311,3656,-1655
2017,8,1,6,3964,4905,3594,-1311
2017,8,1,7,3787,4655,3475,-1180
2017,8,1,8,3658,4525,3398,-1127
2017,8,1,9,3696,4516,3391,-1125
2017,8,1,10,3838,4761,3599,-1162
2017,8,1,11,4113,5171,3893,-1278
2017,8,1,12,4367,5383,4069,-1314
2017,8,1,13,4684,5862,4352,-1510
2017,8,1,14,5040,6550,4586,-1964
2017,8,1,15,5470,7366,5315,-2051
2017,8,1,16,5796,8179,5875,-2304
2017,8,1,17,6118,8919,6421,-2498
2017,8,1,18,6390,9537,6758,-2779
2017,8,1,19,6563,10021,7104,-2917
2017,8,1,20,6643,10367,7390,-2977
2017,8,1,21,6728,10564,7529,-3035
2017,8,1,22,6588,10566,7526,-3040
2017,8,1,23,6337,10254,7303,-2951
2017,8,2,0,6084,9670,6911,-2759
2017,8,2,1,5960,9106,6564,-2542
2017,8,2,2,5689,8605,6354,-2251
2017,8,2,3,5210,7775,5646,-2129
2017,8,2,4,4712,6964,4969,-1995
2017,8,2,5,4654,6238,4533,-1705
2017,8,2,6,4313,5747,4181,-1566
2017,8,2,7,4091,5378,3856,-1522
2017,8,2,8,3967,5167,3659,-1508
2017,8,2,9,3963,5104,3591,-1513
2017,8,2,10,4064,5307,3747,-1560
2017,8,2,11,4355,5703,4175,-1528
2017,8,2,12,4564,5962,4552,-1410
2017,8,2,13,4883,6386,4932,-1454
2017,8,2,14,5335,6793,5011,-1782
2017,8,2,15,5852,7271,5244,-2027
2017,8,2,16,6398,7645,5406,-2239
2017,8,2,17,6728,7867,5598,-2269
2017,8,2,18,6978,7888,5632,-2256
2017,8,2,19,7058,7710,5441,-2269
2017,8,2,20,7037,7425,5201,-2224
2017,8,2,21,7076,7286,4998,-2288
2017,8,2,22,6737,7276,4971,-2305
2017,8,2,23,6500,7152,4857,-2295
2017,8,3,0,6209,7012,4737,-2275
2017,8,3,1,6075,7024,4769,-2255
2017,8,3,2,5747,6844,4757,-2087
2017,8,3,3,5293,6364,4389,-1975
2017,8,3,4,4798,5794,4077,-1717
2017,8,3,5,4381,5337,3896,-1441
2017,8,3,6,4063,4974,3598,-1376
2017,8,3,7,3907,4774,3409,-1365
2017,8,3,8,3744,4659,3302,-1357
2017,8,3,9,3794,4684,3334,-1350
2017,8,3,10,3957,4926,3511,-1415
2017,8,3,11,4412,5365,3965,-1400
2017,8,3,12,4663,5642,4337,-1305
2017,8,3,13,5020,6032,4644,-1388
2017,8,3,14,5531,6622,4871,-1751
2017,8,3,15,6185,7312,5321,-1991
2017,8,3,16,6787,8061,5765,-2296
2017,8,3,17,7266,8816,6329,-2487
2017,8,3,18,7602,9420,6848,-2572
2017,8,3,19,7838,9785,7256,-2529
2017,8,3,20,7858,9887,7422,-2465
2017,8,3,21,7793,9747,7270,-2477
2017,8,3,22,7638,9099,6659,-2440
2017,8,3,23,7254,8414,5966,-2448
2017,8,4,0,6911,7945,5582,-2363
2017,8,4,1,6674,7737,5408,-2329
2017,8,4,2,6334,7382,5243,-2139
2017,8,4,3,5770,6780,4739,-2041
2017,8,4,4,5247,6129,4369,-1760
2017,8,4,5,4700,5562,4082,-1480
2017,8,4,6,4358,5137,3653,-1484
2017,8,4,7,4175,4900,3409,-1491
2017,8,4,8,4013,4754,3299,-1455
2017,8,4,9,4035,4721,3264,-1457
2017,8,4,10,4166,4925,3397,-1528
2017,8,4,11,4543,5352,3838,-1514
2017,8,4,12,4757,5625,4159,-1466
2017,8,4,13,5146,5998,4522,-1476
2017,8,4,14,5690,6703,4921,-1782
2017,8,4,15,6346,7533,5434,-2099
2017,8,4,16,6882,8407,5962,-2445
2017,8,4,17,7371,9161,6512,-2649
2017,8,4,18,7671,9767,7288,-2479
2017,8,4,19,7916,10163,7775,-2388
2017,8,4,20,7967,10446,7756,-2690
2017,8,4,21,7895,10574,8018,-2556
2017,8,4,22,7671,10467,7950,-2517
2017,8,4,23,7334,10054,7610,-2444
2017,8,5,0,6920,9411,7070,-2341
2017,8,5,1,6633,8961,6567,-2394
2017,8,5,2,6330,8466,6176,-2290
2017,8,5,3,5864,7725,5521,-2204
2017,8,5,4,5412,7020,5099,-1921
2017,8,5,5,5051,6363,4686,-1677
2017,8,5,6,4665,5846,4169,-1677
2017,8,5,7,4424,5448,3847,-1601
2017,8,5,8,4249,5237,3666,-1571
2017,8,5,9,4158,5123,3571,-1552
2017,8,5,10,4164,5131,3569,-1562
2017,8,5,11,4267,5267,3686,-1581
2017,8,5,12,4423,5461,3886,-1575
2017,8,5,13,4972,6128,4522,-1606
2017,8,5,14,5641,7029,5147,-1882
2017,8,5,15,6234,7916,5811,-2105
2017,8,5,16,6808,8746,6286,-2460
2017,8,5,17,7239,9399,6788,-2611
2017,8,5,18,7527,9836,7179,-2657
2017,8,5,19,7720,10125,7439,-2686
2017,8,5,20,7737,10269,7566,-2703
2017,8,5,21,7676,10274,7555,-2719
2017,8,5,22,7423,10015,7318,-2697
2017,8,5,23,7033,9422,6774,-2648
2017,8,6,0,6728,8752,6170,-2582
2017,8,6,1,6509,8384,5783,-2601
2017,8,6,2,6140,7959,5575,-2384
2017,8,6,3,5700,7336,5113,-2223
2017,8,6,4,5251,6692,4739,-1953
2017,8,6,5,4866,6144,4425,-1719
2017,8,6,6,4491,5642,4029,-1613
2017,8,6,7,4252,5296,3756,-1540
2017,8,6,8,4058,5070,3575,-1495
2017,8,6,9,3950,4941,3496,-1445
2017,8,6,10,3926,4950,3509,-1441
2017,8,6,11,3970,5019,3572,-1447
2017,8,6,12,4097,5220,3783,-1437
2017,8,6,13,4598,5982,4447,-1535
2017,8,6,14,5343,6926,5041,-1885
2017,8,6,15,5983,7860,5701,-2159
2017,8,6,16,6537,8697,6179,-2518
2017,8,6,17,7089,9406,6672,-2734
2017,8,6,18,7459,9917,7162,-2755
2017,8,6,19,7696,10289,7448,-2841
2017,8,6,20,7806,10545,7621,-2924
2017,8,6,21,7826,10745,7921,-2824
2017,8,6,22,7657,10752,7830,-2922
2017,8,6,23,7391,10335,7458,-2877
2017,8,7,0,6971,9658,6798,-2860
2017,8,7,1,6723,9219,6451,-2768
2017,8,7,2,6402,8706,6174,-2532
2017,8,7,3,5847,7952,5620,-2332
2017,8,7,4,5304,7174,5142,-2032
2017,8,7,5,4779,6471,4707,-1764
2017,8,7,6,4407,5950,4197,-1753
2017,8,7,7,4203,5600,3894,-1706
2017,8,7,8,4029,5360,3750,-1610
2017,8,7,9,4035,5289,3688,-1601
2017,8,7,10,4193,5543,3834,-1709
2017,8,7,11,4656,5909,4177,-1732
2017,8,7,12,4859,6132,4434,-1698
2017,8,7,13,5230,6765,4921,-1844
2017,8,7,14,5775,7584,5346,-2238
2017,8,7,15,6442,8447,5997,-2450
2017,8,7,16,6993,9255,6517,-2738
2017,8,7,17,7568,9934,7015,-2919
2017,8,7,18,7925,10470,7690,-2780
2017,8,7,19,8235,10813,8112,-2701
2017,8,7,20,8358,11101,8442,-2659
2017,8,7,21,8356,11122,8463,-2659
2017,8,7,22,8220,10839,8208,-2631
2017,8,7,23,7822,10425,7888,-2537
2017,8,8,0,7371,9797,7231,-2566
2017,8,8,1,7097,9381,6783,-2598
2017,8,8,2,6672,8774,6481,-2293
2017,8,8,3,6098,7917,5745,-2172
2017,8,8,4,5510,7106,5010,-2096
2017,8,8,5,4854,6410,4611,-1799
2017,8,8,6,4438,5933,4321,-1612
2017,8,8,7,4215,5584,4056,-1528
2017,8,8,8,4034,5416,3916,-1500
2017,8,8,9,3998,5359,3879,-1480
2017,8,8,10,4176,5576,4033,-1543
2017,8,8,11,4548,5985,4380,-1605
2017,8,8,12,4752,6273,4639,-1634
2017,8,8,13,5162,6874,5121,-1753
2017,8,8,14,5704,7679,5475,-2204
2017,8,8,15,6398,8464,6074,-2390
2017,8,8,16,7060,9259,6711,-2548
2017,8,8,17,7607,9958,7348,-2610
2017,8,8,18,8032,10505,7824,-2681
2017,8,8,19,8333,10882,8181,-2701
2017,8,8,20,8481,11060,8374,-2686
2017,8,8,21,8446,11054,8386,-2668
2017,8,8,22,8315,10855,8192,-2663
2017,8,8,23,7897,10491,7731,-2760
2017,8,9,0,7540,9991,7279,-2712
2017,8,9,1,7193,9567,6830,-2737
2017,8,9,2,6765,8993,6485,-2508
2017,8,9,3,6201,8127,5684,-2443
2017,8,9,4,5638,7307,5107,-2200
2017,8,9,5,5096,6594,4748,-1846
2017,8,9,6,4668,6069,4320,-1749
2017,8,9,7,4415,5714,4017,-1697
2017,8,9,8,4234,5490,3840,-1650
2017,8,9,9,4186,5410,3780,-1630
2017,8,9,10,4365,5632,3949,-1683
2017,8,9,11,4698,6033,4267,-1766
2017,8,9,12,4891,6221,4499,-1722
2017,8,9,13,5311,6752,4925,-1827
2017,8,9,14,5870,7490,5391,-2099
2017,8,9,15,6564,8349,6058,-2291
2017,8,9,16,7243,9222,6556,-2666
2017,8,9,17,7867,9929,7213,-2716
2017,8,9,18,8362,10460,7775,-2685
2017,8,9,19,8671,10722,8062,-2660
2017,8,9,20,8847,10945,8298,-2647
2017,8,9,21,8808,10941,8282,-2659
2017,8,9,22,8613,10646,8095,-2551
2017,8,9,23,8164,10184,7570,-2614
2017,8,10,0,7787,9650,6989,-2661
2017,8,10,1,7467,9345,6756,-2589
2017,8,10,2,6976,8860,6469,-2391
2017,8,10,3,6386,8030,5773,-2257
2017,8,10,4,5799,7189,5243,-1946
2017,8,10,5,5165,6519,4858,-1661
2017,8,10,6,4763,6011,4439,-1572
2017,8,10,7,4488,5675,4148,-1527
2017,8,10,8,4328,5477,3982,-1495
2017,8,10,9,4290,5382,3900,-1482
2017,8,10,10,4455,5624,3953,-1671
2017,8,10,11,4792,6041,4287,-1754
2017,8,10,12,4992,6247,4543,-1704
2017,8,10,13,5355,6756,4963,-1793
2017,8,10,14,5886,7501,5625,-1876
2017,8,10,15,6497,8342,6236,-2106
2017,8,10,16,7110,9161,6676,-2485
2017,8,10,17,7575,9846,7101,-2745
2017,8,10,18,7972,10396,7642,-2754
2017,8,10,19,8274,10717,7897,-2820
2017,8,10,20,8371,10776,8020,-2756
2017,8,10,21,8309,10717,8040,-2677
2017,8,10,22,8135,10604,7873,-2731
2017,8,10,23,7687,10298,7577,-2721
2017,8,11,0,7273,9760,6993,-2767
2017,8,11,1,7043,9419,6674,-2745
2017,8,11,2,6609,8821,6350,-2471
2017,8,11,3,6019,8031,5725,-2306
2017,8,11,4,5445,7231,5277,-1954
2017,8,11,5,5228,6509,4919,-1590
2017,8,11,6,4810,6010,4510,-1500
2017,8,11,7,4549,5678,4235,-1443
2017,8,11,8,4369,5447,4049,-1398
2017,8,11,9,4297,5352,3977,-1375
2017,8,11,10,4454,5554,4158,-1396
2017,8,11,11,4773,5994,4526,-1468
2017,8,11,12,4967,6189,4739,-1450
2017,8,11,13,5378,6615,5107,-1508
2017,8,11,14,5959,7284,5338,-1946
2017,8,11,15,6641,8076,5747,-2329
2017,8,11,16,7285,8835,6177,-2658
2017,8,11,17,7653,9472,6685,-2787
2017,8,11,18,7987,9894,7062,-2832
2017,8,11,19,8181,10116,7249,-2867
2017,8,11,20,8251,10138,7250,-2888
2017,8,11,21,8098,10081,7208,-2873
2017,8,11,22,7982,9831,6998,-2833
2017,8,11,23,7609,9408,6631,-2777
2017,8,12,0,7271,8926,6202,-2724
2017,8,12,1,7031,8676,6042,-2634
2017,8,12,2,6669,8231,5819,-2412
2017,8,12,3,6172,7567,5276,-2291
2017,8,12,4,5689,6928,4868,-2060
2017,8,12,5,5225,6293,4384,-1909
2017,8,12,6,4833,5808,3990,-1818
2017,8,12,7,4544,5486,3739,-1747
2017,8,12,8,4351,5289,3606,-1683
2017,8,12,9,4233,5210,3549,-1661
2017,8,12,10,4233,5223,3551,-1672
2017,8,12,11,4307,5331,3633,-1698
2017,8,12,12,4436,5481,3774,-1707
2017,8,12,13,5046,6039,4196,-1843
2017,8,12,14,5695,6733,4574,-2159
2017,8,12,15,6387,7496,5124,-2372
2017,8,12,16,7060,8275,5675,-2600
2017,8,12,17,7678,9016,6259,-2757
2017,8,12,18,7995,9637,6845,-2792
2017,8,12,19,8161,9999,7171,-2828
2017,8,12,20,8281,10056,7169,-2887
2017,8,12,21,8248,9899,7048,-2851
2017,8,12,22,8073,9546,6773,-2773
2017,8,12,23,7902,9043,6232,-2811
2017,8,13,0,7360,8587,5760,-2827
2017,8,13,1,7099,8234,5452,-2782
2017,8,13,2,6708,7712,5142,-2570
2017,8,13,3,6210,7150,4696,-2454
2017,8,13,4,5701,6554,4396,-2158
2017,8,13,5,5034,6025,4296,-1729
2017,8,13,6,4673,5581,3886,-1695
2017,8,13,7,4432,5287,3583,-1704
2017,8,13,8,4279,5108,3454,-1654
2017,8,13,9,4147,5000,3389,-1611
2017,8,13,10,4167,4983,3355,-1628
2017,8,13,11,4220,5068,3433,-1635
2017,8,13,12,4361,5278,3703,-1575
2017,8,13,13,4900,6039,4378,-1661
2017,8,13,14,5663,6999,5067,-1932
2017,8,13,15,6380,7791,5630,-2161
2017,8,13,16,7016,8475,6032,-2443
2017,8,13,17,7556,8972,6430,-2542
2017,8,13,18,7932,9252,6695,-2557
2017,8,13,19,8158,9240,6609,-2631
2017,8,13,20,8160,9082,6432,-2650
2017,8,13,21,8225,9109,6395,-2714
2017,8,13,22,7987,9063,6301,-2762
2017,8,13,23,7803,8793,6024,-2769
2017,8,14,0,7441,8476,5742,-2734
2017,8,14,1,7142,8327,5644,-2683
2017,8,14,2,6771,7848,5415,-2433
2017,8,14,3,6186,7184,4910,-2274
2017,8,14,4,5595,6460,4481,-1979
2017,8,14,5,4910,5910,4236,-1674
2017,8,14,6,4544,5604,3969,-1635
2017,8,14,7,4297,5211,3555,-1656
2017,8,14,8,4150,5032,3426,-1606
2017,8,14,9,4132,5018,3423,-1595
2017,8,14,10,4326,5342,3653,-1689
2017,8,14,11,4766,5861,4175,-1686
2017,8,14,12,4980,6123,4551,-1572
2017,8,14,13,5384,6633,4965,-1668
2017,8,14,14,5946,7406,5571,-1835
2017,8,14,15,6635,8262,6097,-2165
2017,8,14,16,7233,9102,6602,-2500
2017,8,14,17,7787,9789,7156,-2633
2017,8,14,18,8175,10352,7584,-2768
2017,8,14,19,8431,10629,7814,-2815
2017,8,14,20,8515,10767,8033,-2734
2017,8,14,21,8474,10965,8267,-2698
2017,8,14,22,8335,10954,8263,-2691
2017,8,14,23,8002,10613,7962,-2651
2017,8,15,0,7638,9990,7316,-2674
2017,8,15,1,7329,9559,6920,-2639
2017,8,15,2,6885,8943,6555,-2388
2017,8,15,3,6224,8065,5848,-2217
2017,8,15,4,5641,7220,5268,-1952
2017,8,15,5,5085,6510,4858,-1652
2017,8,15,6,4713,6022,4322,-1700
2017,8,15,7,4467,5704,4051,-1653
2017,8,15,8,4319,5492,3884,-1608
2017,8,15,9,4278,5447,3853,-1594
2017,8,15,10,4478,5736,4065,-1671
2017,8,15,11,4877,6206,4513,-1693
2017,8,15,12,5084,6421,4839,-1582
2017,8,15,13,5499,6927,5281,-1646
2017,8,15,14,6069,7666,5749,-1917
2017,8,15,15,6769,8416,6401,-2015
2017,8,15,16,7399,9088,6852,-2236
2017,8,15,17,7972,9457,7045,-2412
2017,8,15,18,8388,9982,7505,-2477
2017,8,15,19,8644,10339,7763,-2576
2017,8,15,20,8771,10623,8041,-2582
2017,8,15,21,8708,10796,8183,-2613
2017,8,15,22,8551,10843,8242,-2601
2017,8,15,23,8218,10645,8022,-2623
2017,8,16,0,7807,10136,7470,-2666
2017,8,16,1,7463,9717,7132,-2585
2017,8,16,2,7007,9096,6781,-2315
2017,8,16,3,6319,8214,6071,-2143
2017,8,16,4,5722,7344,5369,-1975
2017,8,16,5,5149,6697,5070,-1627
2017,8,16,6,4763,6185,4611,-1574
2017,8,16,7,4496,5838,4260,-1578
2017,8,16,8,4351,5629,4076,-1553
2017,8,16,9,4299,5547,4007,-1540
2017,8,16,10,4501,5816,4207,-1609
2017,8,16,11,4871,6287,4636,-1651
2017,8,16,12,5069,6452,4934,-1518
2017,8,16,13,5481,6985,5340,-1645
2017,8,16,14,6048,7774,5950,-1824
2017,8,16,15,6739,8579,6581,-1998
2017,8,16,16,7395,9256,7033,-2223
2017,8,16,17,7904,9672,7147,-2525
2017,8,16,18,8341,10023,7602,-2421
2017,8,16,19,8599,10202,7705,-2497
2017,8,16,20,8741,10078,7572,-2506
2017,8,16,21,8672,10003,7397,-2606
2017,8,16,22,8537,9839,7217,-2622
2017,8,16,23,8216,9616,7010,-2606
2017,8,17,0,7828,9221,6571,-2650
2017,8,17,1,7497,8931,6362,-2569
2017,8,17,2,7027,8436,5984,-2452
2017,8,17,3,6357,7605,5346,-2259
2017,8,17,4,5763,6800,4891,-1909
2017,8,17,5,5144,6225,4602,-1623
2017,8,17,6,4744,5778,4103,-1675
2017,8,17,7,4495,5489,3858,-1631
2017,8,17,8,4343,5352,3747,-1605
2017,8,17,9,4315,5328,3732,-1596
2017,8,17,10,4509,5604,3925,-1679
2017,8,17,11,4870,6113,4476,-1637
2017,8,17,12,5070,6311,4746,-1565
2017,8,17,13,5400,6807,5147,-1660
2017,8,17,14,5980,7581,5594,-1987
2017,8,17,15,6657,8429,6149,-2280
2017,8,17,16,7250,9189,6521,-2668
2017,8,17,17,7617,9719,6892,-2827
2017,8,17,18,7970,10207,7373,-2834
2017,8,17,19,8169,10541,7830,-2711
2017,8,17,20,8218,10667,7935,-2732
2017,8,17,21,8117,10485,7834,-2651
2017,8,17,22,8017,9998,7315,-2683
2017,8,17,23,7655,9468,6829,-2639
2017,8,18,0,7320,9040,6321,-2719
2017,8,18,1,7080,8748,6110,-2638
2017,8,18,2,6644,8229,5830,-2399
2017,8,18,3,6036,7470,5262,-2208
2017,8,18,4,5479,6746,4851,-1895
2017,8,18,5,4994,6105,4336,-1769
2017,8,18,6,4630,5634,3935,-1699
2017,8,18,7,4368,5349,3722,-1627
2017,8,18,8,4204,5149,3564,-1585
2017,8,18,9,4204,5128,3548,-1580
2017,8,18,10,4386,5397,3740,-1657
2017,8,18,11,4743,5913,4174,-1739
2017,8,18,12,4940,6157,4425,-1732
2017,8,18,13,5284,6624,4792,-1832
2017,8,18,14,5875,7386,5241,-2145
2017,8,18,15,6419,8239,5881,-2358
2017,8,18,16,7008,8984,6399,-2585
2017,8,18,17,7304,9369,6772,-2597
2017,8,18,18,7625,9674,7087,-2587
2017,8,18,19,7803,9848,7363,-2485
2017,8,18,20,7858,9684,7339,-2345
2017,8,18,21,7696,9291,6939,-2352
2017,8,18,22,7538,8907,6609,-2298
2017,8,18,23,7298,8496,6084,-2412
2017,8,19,0,6885,8003,5592,-2411
2017,8,19,1,6661,7800,5365,-2435
2017,8,19,2,6325,7437,5177,-2260
2017,8,19,3,5849,6911,4661,-2250
2017,8,19,4,5391,6308,4321,-1987
2017,8,19,5,4929,5770,4024,-1746
2017,8,19,6,4586,5296,3673,-1623
2017,8,19,7,4324,5011,3429,-1582
2017,8,19,8,4142,4827,3302,-1525
2017,8,19,9,4081,4745,3295,-1450
2017,8,19,10,4075,4760,3307,-1453
2017,8,19,11,4142,4867,3316,-1551
2017,8,19,12,4301,4996,3471,-1525
2017,8,19,13,4840,5692,4002,-1690
2017,8,19,14,5668,6609,4637,-1972
2017,8,19,15,6347,7497,5287,-2210
2017,8,19,16,7001,8378,5845,-2533
2017,8,19,17,7578,9110,6374,-2736
2017,8,19,18,7914,9621,6736,-2885
2017,8,19,19,8102,10000,7029,-2971
2017,8,19,20,8176,10280,7272,-3008
2017,8,19,21,8178,10494,7432,-3062
2017,8,19,22,8037,10503,7449,-3054
2017,8,19,23,7586,10218,7223,-2995
2017,8,20,0,7199,9609,6752,-2857
2017,8,20,1,6879,9153,6409,-2744
2017,8,20,2,6470,8555,6071,-2484
2017,8,20,3,5978,7808,5427,-2381
2017,8,20,4,5493,7114,4956,-2158
2017,8,20,5,5033,6477,4681,-1796
2017,8,20,6,4625,5976,4295,-1681
2017,8,20,7,4354,5603,3995,-1608
2017,8,20,8,4187,5347,3796,-1551
2017,8,20,9,4071,5200,3684,-1516
2017,8,20,10,4050,5151,3645,-1506
2017,8,20,11,4072,5220,3694,-1526
2017,8,20,12,4224,5335,3819,-1516
2017,8,20,13,4793,6022,4325,-1697
2017,8,20,14,5447,7029,4925,-2104
2017,8,20,15,6057,7982,5613,-2369
2017,8,20,16,6598,8901,6202,-2699
2017,8,20,17,7059,9566,6723,-2843
2017,8,20,18,7357,9971,6972,-2999
2017,8,20,19,7679,10096,7112,-2984
2017,8,20,20,7592,10039,7117,-2922
2017,8,20,21,7405,9896,7012,-2884
2017,8,20,22,7169,9659,6845,-2814
2017,8,20,23,6941,9245,6433,-2812
2017,8,21,0,6667,8747,5915,-2832
2017,8,21,1,6541,8481,5736,-2745
2017,8,21,2,6130,7945,5458,-2487
2017,8,21,3,5554,7244,4887,-2357
2017,8,21,4,5045,6549,4416,-2133
2017,8,21,5,4789,6024,4232,-1792
2017,8,21,6,4438,5616,3913,-1703
2017,8,21,7,4213,5349,3722,-1627
2017,8,21,8,4081,5164,3586,-1578
2017,8,21,9,4079,5140,3562,-1578
2017,8,21,10,4308,5428,3779,-1649
2017,8,21,11,4780,5917,4177,-1740
2017,8,21,12,4984,6153,4451,-1702
2017,8,21,13,5314,6668,4876,-1792
2017,8,21,14,5764,7440,5354,-2086
2017,8,21,15,6311,8251,5899,-2352
2017,8,21,16,6877,9010,6382,-2628
2017,8,21,17,7324,9529,6854,-2675
2017,8,21,18,7658,9856,7075,-2781
2017,8,21,19,7849,9668,6890,-2778
2017,8,21,20,7847,9463,6745,-2718
2017,8,21,21,7981,9912,7111,-2801
2017,8,21,22,8035,10091,7273,-2818
2017,8,21,23,7873,9924,7178,-2746
2017,8,22,0,7575,9457,6773,-2684
2017,8,22,1,7225,9125,6453,-2672
2017,8,22,2,6755,8425,6029,-2396
2017,8,22,3,6100,7566,5314,-2252
2017,8,22,4,5495,6750,4690,-2060
2017,8,22,5,5050,6095,4305,-1790
2017,8,22,6,4687,5632,3920,-1712
2017,8,22,7,4413,5316,3672,-1644
2017,8,22,8,4247,5094,3510,-1584
2017,8,22,9,4215,5048,3469,-1579
2017,8,22,10,4419,5303,3661,-1642
2017,8,22,11,4816,5797,4064,-1733
2017,8,22,12,5027,5984,4303,-1681
2017,8,22,13,5366,6366,4664,-1702
2017,8,22,14,5953,7087,4997,-2090
2017,8,22,15,6611,7900,5471,-2429
2017,8,22,16,7262,8703,6050,-2653
2017,8,22,17,7732,9461,6712,-2749
2017,8,22,18,8140,10135,7271,-2864
2017,8,22,19,8382,10577,7684,-2893
2017,8,22,20,8558,10900,7915,-2985
2017,8,22,21,8603,11014,7977,-3037
2017,8,22,22,8473,10989,7973,-3016
2017,8,22,23,8236,10655,7717,-2938
2017,8,23,0,7859,10032,7251,-2781
2017,8,23,1,7463,9630,6956,-2674
2017,8,23,2,6995,8892,6499,-2393
2017,8,23,3,6292,7994,5645,-2349
2017,8,23,4,5659,7145,5020,-2125
2017,8,23,5,5201,6470,4650,-1820
2017,8,23,6,4796,5963,4256,-1707
2017,8,23,7,4538,5588,3956,-1632
2017,8,23,8,4373,5362,3780,-1582
2017,8,23,9,4335,5288,3730,-1558
2017,8,23,10,4518,5534,3915,-1619
2017,8,23,11,4852,5979,4278,-1701
2017,8,23,12,5048,6161,4497,-1664
2017,8,23,13,5379,6564,4834,-1730
2017,8,23,14,5979,7221,5221,-2000
2017,8,23,15,6632,8012,5800,-2212
2017,8,23,16,7265,8869,6252,-2617
2017,8,23,17,7681,9618,6777,-2841
2017,8,23,18,8138,10214,7257,-2957
2017,8,23,19,8380,10646,7609,-3037
2017,8,23,20,8506,10927,7829,-3098
2017,8,23,21,8518,10907,7856,-3051
2017,8,23,22,8345,10588,7529,-3059
2017,8,23,23,8055,10118,7073,-3045
2017,8,24,0,7703,9491,6518,-2973
2017,8,24,1,7367,9062,6330,-2732
2017,8,24,2,6892,8459,5942,-2517
2017,8,24,3,6213,7642,5336,-2306
2017,8,24,4,5600,6825,4735,-2090
2017,8,24,5,5034,6190,4360,-1830
2017,8,24,6,4592,5737,4015,-1722
2017,8,24,7,4377,5449,3785,-1664
2017,8,24,8,4226,5252,3623,-1629
2017,8,24,9,4213,5204,3572,-1632
2017,8,24,10,4404,5474,3779,-1695
2017,8,24,11,4740,5961,4183,-1778
2017,8,24,12,4994,6151,4418,-1733
2017,8,24,13,5221,6527,4777,-1750
2017,8,24,14,5827,7222,5193,-2029
2017,8,24,15,6317,8003,5706,-2297
2017,8,24,16,6972,8787,6100,-2687
2017,8,24,17,7449,9535,6671,-2864
2017,8,24,18,7785,10028,7165,-2863
2017,8,24,19,8041,10394,7349,-3045
2017,8,24,20,8067,10621,7608,-3013
2017,8,24,21,8084,10645,7685,-2960
2017,8,24,22,7908,10372,7463,-2909
2017,8,24,23,7490,9826,7025,-2801
2017,8,25,0,7268,9263,6501,-2762
2017,8,25,1,6896,8983,6289,-2694
2017,8,25,2,6541,8314,5866,-2448
2017,8,25,3,5949,7488,5236,-2252
2017,8,25,4,5346,6713,4662,-2051
2017,8,25,5,4692,6090,4286,-1804
2017,8,25,6,4368,5654,4034,-1620
2017,8,25,7,4197,5369,3816,-1553
2017,8,25,8,4058,5211,3695,-1516
2017,8,25,9,4067,5177,3677,-1500
2017,8,25,10,4264,5422,3843,-1579
2017,8,25,11,4735,5941,4272,-1669
2017,8,25,12,4937,6136,4529,-1607
2017,8,25,13,5141,6455,4824,-1631
2017,8,25,14,5704,6964,5036,-1928
2017,8,25,15,6296,7626,5457,-2169
2017,8,25,16,6864,8241,5808,-2433
2017,8,25,17,7251,8802,6216,-2586
2017,8,25,18,7519,9207,6538,-2669
2017,8,25,19,7628,9478,6787,-2691
2017,8,25,20,7656,9613,6863,-2750
2017,8,25,21,7499,9614,6917,-2697
2017,8,25,22,7340,9365,6716,-2649
2017,8,25,23,7016,8874,6344,-2530
2017,8,26,0,6747,8359,5882,-2477
2017,8,26,1,6529,8145,5672,-2473
2017,8,26,2,6138,7747,5424,-2323
2017,8,26,3,5666,7126,4947,-2179
2017,8,26,4,5188,6534,4532,-2002
2017,8,26,5,4717,6035,4342,-1693
2017,8,26,6,4343,5639,4016,-1623
2017,8,26,7,4145,5360,3792,-1568
2017,8,26,8,4009,5181,3646,-1535
2017,8,26,9,3944,5089,3562,-1527
2017,8,26,10,3966,5105,3573,-1532
2017,8,26,11,4084,5274,3699,-1575
2017,8,26,12,4205,5456,3968,-1488
2017,8,26,13,4659,5925,4395,-1530
2017,8,26,14,5253,6565,4692,-1873
2017,8,26,15,5813,7151,5070,-2081
2017,8,26,16,6362,7747,5346,-2401
2017,8,26,17,6809,8333,5768,-2565
2017,8,26,18,7006,8786,6139,-2647
2017,8,26,19,7105,9120,6336,-2784
2017,8,26,20,7130,9340,6495,-2845
2017,8,26,21,7117,9427,6542,-2885
2017,8,26,22,6992,9216,6363,-2853
2017,8,26,23,6780,8716,5997,-2719
2017,8,27,0,6385,8217,5610,-2607
2017,8,27,1,6280,7958,5434,-2524
2017,8,27,2,5889,7445,5162,-2283
2017,8,27,3,5459,6878,4725,-2153
2017,8,27,4,5053,6318,4426,-1892
2017,8,27,5,4491,5842,4135,-1707
2017,8,27,6,4157,5543,3944,-1599
2017,8,27,7,3969,5280,3730,-1550
2017,8,27,8,3836,5067,3561,-1506
2017,8,27,9,3766,5008,3510,-1498
2017,8,27,10,3783,5002,3503,-1499
2017,8,27,11,3883,5131,3610,-1521
2017,8,27,12,4012,5300,3797,-1503
2017,8,27,13,4479,5740,4167,-1573
2017,8,27,14,5105,6322,4467,-1855
2017,8,27,15,5685,6918,4747,-2171
2017,8,27,16,6207,7434,4965,-2469
2017,8,27,17,6665,7998,5372,-2626
2017,8,27,18,6876,8432,5688,-2744
2017,8,27,19,6994,8631,5880,-2751
2017,8,27,20,7013,8515,5807,-2708
2017,8,27,21,6989,8288,5617,-2671
2017,8,27,22,6882,8101,5490,-2611
2017,8,27,23,6719,7898,5373,-2525
2017,8,28,0,6498,7678,5208,-2470
2017,8,28,1,6355,7580,5146,-2434
2017,8,28,2,5927,7102,4882,-2220
2017,8,28,3,5427,6499,4442,-2057
2017,8,28,4,4948,5905,4105,-1800
2017,8,28,5,4333,5416,3765,-1651
2017,8,28,6,4061,5078,3555,-1523
2017,8,28,7,3910,4876,3398,-1478
2017,8,28,8,3828,4768,3314,-1454
2017,8,28,9,3873,4819,3343,-1476
2017,8,28,10,4139,5140,3584,-1556
2017,8,28,11,4586,5759,4093,-1666
2017,8,28,12,4768,6031,4537,-1494
2017,8,28,13,5014,6270,4730,-1540
2017,8,28,14,5463,6753,4932,-1821
2017,8,28,15,5976,7227,5123,-2104
2017,8,28,16,6448,7712,5373,-2339
2017,8,28,17,6755,8138,5699,-2439
2017,8,28,18,7024,8381,5897,-2484
2017,8,28,19,7093,8422,5917,-2505
2017,8,28,20,7059,8311,5820,-2491
2017,8,28,21,6946,8209,5732,-2477
2017,8,28,22,6821,8032,5503,-2529
2017,8,28,23,6621,7868,5472,-2396
2017,8,29,0,6334,7674,5296,-2378
2017,8,29,1,6218,7486,5154,-2332
2017,8,29,2,5850,7011,4886,-2125
2017,8,29,3,5330,6383,4392,-1991
2017,8,29,4,4877,5792,4046,-1746
2017,8,29,5,4265,5344,3691,-1653
2017,8,29,6,4045,4989,3479,-1510
2017,8,29,7,3916,4765,3333,-1432
2017,8,29,8,3837,4675,3260,-1415
2017,8,29,9,3878,4706,3274,-1432
2017,8,29,10,4058,5012,3504,-1508
2017,8,29,11,4593,5609,3971,-1638
2017,8,29,12,4771,5865,4382,-1483
2017,8,29,13,5000,6084,4694,-1390
2017,8,29,14,5432,6586,4909,-1677
2017,8,29,15,5991,7142,5292,-1850
2017,8,29,16,6373,7653,5487,-2166
2017,8,29,17,6810,8145,5883,-2262
2017,8,29,18,7151,8523,6201,-2322
2017,8,29,19,7309,8552,6276,-2276
2017,8,29,20,7380,8410,6130,-2280
2017,8,29,21,7299,8501,6182,-2319
2017,8,29,22,7203,8442,6058,-2384
2017,8,29,23,6906,8230,5844,-2386
2017,8,30,0,6651,7948,5590,-2358
2017,8,30,1,6550,7794,5461,-2333
2017,8,30,2,6145,7273,5175,-2098
2017,8,30,3,5538,6567,4613,-1954
2017,8,30,4,5007,5883,4166,-1717
2017,8,30,5,4433,5318,3830,-1488
2017,8,30,6,4173,4905,3511,-1394
2017,8,30,7,4002,4674,3308,-1366
2017,8,30,8,3855,4555,3219,-1336
2017,8,30,9,3852,4556,3202,-1354
2017,8,30,10,4103,4829,3398,-1431
2017,8,30,11,4644,5401,3946,-1455
2017,8,30,12,4818,5646,4245,-1401
2017,8,30,13,5067,5942,4558,-1384
2017,8,30,14,5599,6566,4812,-1754
2017,8,30,15,6248,7300,5117,-2183
2017,8,30,16,6763,8126,5725,-2401
2017,8,30,17,7297,8924,6158,-2766
2017,8,30,18,7751,9626,6741,-2885
2017,8,30,19,7948,10191,7138,-3053
2017,8,30,20,8249,10531,7550,-2981
2017,8,30,21,8314,10768,7746,-3022
2017,8,30,22,8289,10730,7711,-3019
2017,8,30,23,7870,10426,7370,-3056
2017,8,31,0,7471,9909,6949,-2960
2017,8,31,1,7270,9479,6766,-2713
2017,8,31,2,6748,8746,6305,-2441
2017,8,31,3,6037,7872,5649,-2223
2017,8,31,4,5461,7022,5010,-2012
2017,8,31,5,4907,6345,4729,-1616
2017,8,31,6,4569,5869,4283,-1586
2017,8,31,7,4328,5505,3874,-1631
2017,8,31,8,4166,5302,3690,-1612
2017,8,31,9,4163,5250,3656,-1594
2017,8,31,10,4359,5477,3835,-1642
2017,8,31,11,4751,5988,4322,-1666
2017,8,31,12,4974,6212,4679,-1533
2017,8,31,13,5259,6646,5049,-1597
2017,8,31,14,5821,7421,5488,-1933
2017,8,31,15,6421,8309,5988,-2321
2017,8,31,16,7112,9210,6673,-2537
2017,8,31,17,7520,9973,7287,-2686
2017,8,31,18,7893,10547,7816,-2731
2017,8,31,19,8168,10836,8046,-2790
2017,8,31,20,8326,10947,8022,-2925
2017,8,31,21,8274,10939,8013,-2926
2017,8,31,22,8201,10622,7794,-2828
2017,8,31,23,7896,10107,7390,-2717
2017,9,1,0,7499,9533,6957,-2576
2017,9,1,1,7241,9233,6669,-2564
2017,9,1,2,6735,8589,6271,-2318
2017,9,1,3,6022,7772,5577,-2195
2017,9,1,4,5411,6921,5011,-1910
2017,9,1,5,4979,6208,4566,-1642
2017,9,1,6,4588,5770,4199,-1571
2017,9,1,7,4319,5453,3904,-1549
2017,9,1,8,4091,5234,3693,-1541
2017,9,1,9,4065,5179,3656,-1523
2017,9,1,10,4233,5376,3835,-1541
2017,9,1,11,4589,5902,4364,-1538
2017,9,1,12,4863,6117,4614,-1503
2017,9,1,13,5161,6556,4943,-1613
2017,9,1,14,5708,7327,5415,-1912
2017,9,1,15,6335,8202,5934,-2268
2017,9,1,16,6736,9024,6587,-2437
2017,9,1,17,7112,9750,7129,-2621
2017,9,1,18,7439,10215,7474,-2741
2017,9,1,19,7804,10382,7692,-2690
2017,9,1,20,7899,10367,7696,-2671
2017,9,1,21,7825,10237,7600,-2637
2017,9,1,22,7591,9650,7132,-2518
2017,9,1,23,7210,8817,6321,-2496
2017,9,2,0,6848,8266,5860,-2406
2017,9,2,1,6583,7972,5600,-2372
2017,9,2,2,6114,7369,5251,-2118
2017,9,2,3,5604,6725,4768,-1957
2017,9,2,4,5069,6139,4379,-1760
2017,9,2,5,4832,5775,4214,-1561
2017,9,2,6,4462,5382,3911,-1471
2017,9,2,7,4203,5129,3708,-1421
2017,9,2,8,4045,4923,3546,-1377
2017,9,2,9,3877,4812,3449,-1363
2017,9,2,10,3861,4837,3480,-1357
2017,9,2,11,3949,4994,3592,-1402
2017,9,2,12,4068,5190,3761,-1429
2017,9,2,13,4515,5607,4173,-1434
2017,9,2,14,5064,6204,4510,-1694
2017,9,2,15,5489,6815,4848,-1967
2017,9,2,16,5971,7477,5207,-2270
2017,9,2,17,6302,8089,5684,-2405
2017,9,2,18,6496,8502,6022,-2480
2017,9,2,19,6654,8618,6127,-2491
2017,9,2,20,6716,8164,5727,-2437
2017,9,2,21,6679,8233,5860,-2373
2017,9,2,22,6513,7911,5594,-2317
2017,9,2,23,6232,7540,5277,-2263
2017,9,3,0,5936,7247,4921,-2326
2017,9,3,1,5789,7113,4783,-2330
2017,9,3,2,5358,6740,4605,-2135
2017,9,3,3,4949,6274,4265,-2009
2017,9,3,4,4521,5792,3977,-1815
2017,9,3,5,4208,5157,3582,-1575
2017,9,3,6,3907,4782,3390,-1392
2017,9,3,7,3674,4548,3229,-1319
2017,9,3,8,3543,4394,3106,-1288
2017,9,3,9,3475,4343,3065,-1278
2017,9,3,10,3437,4385,3107,-1278
2017,9,3,11,3496,4555,3251,-1304
2017,9,3,12,3643,4754,3427,-1327
2017,9,3,13,4129,5252,3880,-1372
2017,9,3,14,4750,5851,4196,-1655
2017,9,3,15,5321,6464,4499,-1965
2017,9,3,16,5743,7048,4790,-2258
2017,9,3,17,6377,7587,5168,-2419
2017,9,3,18,6757,8089,5501,-2588
2017,9,3,19,6991,8470,5818,-2652
2017,9,3,20,6998,8663,5961,-2702
2017,9,3,21,7001,8797,6045,-2752
2017,9,3,22,6748,8774,6093,-2681
2017,9,3,23,6516,8559,5940,-2619
2017,9,4,0,6176,8115,5584,-2531
2017,9,4,1,5940,7849,5388,-2461
2017,9,4,2,5576,7309,5110,-2199
2017,9,4,3,5151,6702,4646,-2056
2017,9,4,4,4720,6067,4210,-1857
2017,9,4,5,4205,5515,3933,-1582
2017,9,4,6,3913,5080,3583,-1497
2017,9,4,7,3711,4771,3360,-1411
2017,9,4,8,3621,4611,3240,-1371
2017,9,4,9,3585,4554,3199,-1355
2017,9,4,10,3638,4598,3239,-1359
2017,9,4,11,3776,4791,3418,-1373
2017,9,4,12,3873,4934,3558,-1376
2017,9,4,13,4349,5565,4158,-1407
2017,9,4,14,5057,6543,4906,-1637
2017,9,4,15,5794,7471,5494,-1977
2017,9,4,16,6344,8240,5988,-2252
2017,9,4,17,6911,8863,6517,-2346
2017,9,4,18,7244,9261,6911,-2350
2017,9,4,19,7533,9497,7115,-2382
2017,9,4,20,7608,9562,7305,-2257
2017,9,4,21,7697,9415,7143,-2272
2017,9,4,22,7734,9156,6788,-2368
2017,9,4,23,7351,8722,6546,-2176
2017,9,5,0,7026,8277,5989,-2288
2017,9,5,1,6895,8066,5758,-2308
2017,9,5,2,6425,7466,5432,-2034
2017,9,5,3,5699,6736,4918,-1818
2017,9,5,4,5164,6049,4562,-1487
2017,9,5,5,4740,5491,3982,-1509
2017,9,5,6,4401,5116,3655,-1461
2017,9,5,7,4183,4835,3433,-1402
2017,9,5,8,4058,4683,3311,-1372
2017,9,5,9,4032,4702,3291,-1411
2017,9,5,10,4239,4985,3554,-1431
2017,9,5,11,4684,5572,4063,-1509
2017,9,5,12,4900,5825,4425,-1400
2017,9,5,13,5150,6122,4730,-1392
2017,9,5,14,5618,6688,4944,-1744
2017,9,5,15,6182,7465,5386,-2079
2017,9,5,16,6695,8140,5717,-2423
2017,9,5,17,7114,8785,6196,-2589
2017,9,5,18,7447,9243,6622,-2621
2017,9,5,19,7669,9536,6837,-2699
2017,9,5,20,7751,9808,7024,-2784
2017,9,5,21,7809,9958,7161,-2797
2017,9,5,22,7648,9811,7005,-2806
2017,9,5,23,7360,9363,6572,-2791
2017,9,6,0,7020,8984,6277,-2707
2017,9,6,1,6875,8757,6122,-2635
2017,9,6,2,6326,8104,5764,-2340
2017,9,6,3,5664,7341,5177,-2164
2017,9,6,4,5084,6604,4749,-1855
2017,9,6,5,4765,5974,4282,-1692
2017,9,6,6,4406,5540,3996,-1544
2017,9,6,7,4176,5259,3774,-1485
2017,9,6,8,4044,5084,3615,-1469
2017,9,6,9,4024,5044,3606,-1438
2017,9,6,10,4224,5321,3800,-1521
2017,9,6,11,4637,5885,4375,-1510
2017,9,6,12,4822,6129,4660,-1469
2017,9,6,13,5063,6278,4902,-1376
2017,9,6,14,5463,6604,4941,-1663
2017,9,6,15,5924,6971,5084,-1887
2017,9,6,16,6426,7243,5108,-2135
2017,9,6,17,6943,7389,5148,-2241
2017,9,6,18,7320,7661,5289,-2372
2017,9,6,19,7530,7903,5480,-2423
2017,9,6,20,7609,8110,5639,-2471
2017,9,6,21,7512,8409,5842,-2567
2017,9,6,22,7286,8707,6050,-2657
2017,9,6,23,6982,8609,6022,-2587
2017,9,7,0,6633,8367,5838,-2529
2017,9,7,1,6546,8197,5741,-2456
2017,9,7,2,6099,7633,5427,-2206
2017,9,7,3,5462,6911,4863,-2048
2017,9,7,4,4914,6204,4424,-1780
2017,9,7,5,4285,5652,3973,-1679
2017,9,7,6,4011,5235,3748,-1487
2017,9,7,7,3836,4959,3504,-1455
2017,9,7,8,3751,4759,3376,-1383
2017,9,7,9,3769,4761,3372,-1389
2017,9,7,10,3989,5017,3564,-1453
2017,9,7,11,4438,5503,3951,-1552
2017,9,7,12,4636,5708,4175,-1533
2017,9,7,13,4847,6082,4523,-1559
2017,9,7,14,5141,6716,4791,-1925
2017,9,7,15,5588,7475,5165,-2310
2017,9,7,16,6044,8258,5611,-2647
2017,9,7,17,6550,8934,6031,-2903
2017,9,7,18,6950,9542,6464,-3078
2017,9,7,19,7197,9958,6866,-3092
2017,9,7,20,7345,10227,7082,-3145
2017,9,7,21,7404,10293,7202,-3091
2017,9,7,22,7250,10151,7083,-3068
2017,9,7,23,6890,9681,6750,-2931
2017,9,8,0,6583,9159,6305,-2854
2017,9,8,1,6440,8907,6080,-2827
2017,9,8,2,6029,8259,5659,-2600
2017,9,8,3,5490,7519,5053,-2466
2017,9,8,4,4983,6807,4659,-2148
2017,9,8,5,4485,6192,4410,-1782
2017,9,8,6,4153,5724,4109,-1615
2017,9,8,7,3927,5399,3863,-1536
2017,9,8,8,3809,5196,3700,-1496
2017,9,8,9,3805,5165,3664,-1501
2017,9,8,10,4010,5308,3770,-1538
2017,9,8,11,4429,5619,4029,-1590
2017,9,8,12,4650,5827,4263,-1564
2017,9,8,13,4854,6317,4669,-1648
2017,9,8,14,5294,7061,4908,-2153
2017,9,8,15,5834,7884,5558,-2326
2017,9,8,16,6299,8619,6262,-2357
2017,9,8,17,6716,9103,6712,-2391
2017,9,8,18,7089,9459,6857,-2602
2017,9,8,19,7318,9678,7166,-2512
2017,9,8,20,7387,9612,6935,-2677
2017,9,8,21,7325,9330,6792,-2538
2017,9,8,22,7107,8847,6270,-2577
2017,9,8,23,6855,8291,5755,-2536
2017,9,9,0,6494,7849,5375,-2474
2017,9,9,1,6274,7661,5148,-2513
2017,9,9,2,5886,7187,4932,-2255
2017,9,9,3,5454,6609,4402,-2207
2017,9,9,4,4987,6069,4016,-2053
2017,9,9,5,4786,5588,3921,-1667
2017,9,9,6,4432,5207,4051,-1156
2017,9,9,7,4191,4947,3885,-1062
2017,9,9,8,4050,4795,3762,-1033
2017,9,9,9,3960,4732,3724,-1008
2017,9,9,10,3981,4802,3754,-1048
2017,9,9,11,4064,4959,3870,-1089
2017,9,9,12,4263,5118,3980,-1138
2017,9,9,13,4518,5592,4490,-1102
2017,9,9,14,4959,6317,4922,-1395
2017,9,9,15,5466,7075,5370,-1705
2017,9,9,16,6034,7591,5442,-2149
2017,9,9,17,6397,7984,5627,-2357
2017,9,9,18,6637,8207,5810,-2397
2017,9,9,19,6689,8239,5983,-2256
2017,9,9,20,6635,8097,5952,-2145
2017,9,9,21,6328,7884,5811,-2073
2017,9,9,22,6004,7601,5476,-2125
2017,9,9,23,5739,7311,5245,-2066
2017,9,10,0,5534,7021,4948,-2073
2017,9,10,1,5377,6826,4776,-2050
2017,9,10,2,5133,6511,4678,-1833
2017,9,10,3,4760,6070,4369,-1701
2017,9,10,4,4323,5592,4194,-1398
2017,9,10,5,3896,5263,4153,-1110
2017,9,10,6,3648,4907,3918,-989
2017,9,10,7,3456,4657,3765,-892
2017,9,10,8,3314,4510,3590,-920
2017,9,10,9,3232,4428,3522,-906
2017,9,10,10,3244,4456,3526,-930
2017,9,10,11,3291,4527,3564,-963
2017,9,10,12,3414,4714,3684,-1030
2017,9,10,13,3683,5125,3967,-1158
2017,9,10,14,4011,5634,4294,-1340
2017,9,10,15,4298,5960,4484,-1476
2017,9,10,16,4441,6085,4516,-1569
2017,9,10,17,4553,6023,4529,-1494
2017,9,10,18,4563,5853,4446,-1407
2017,9,10,19,4500,5613,4303,-1310
2017,9,10,20,4500,5422,4086,-1336
2017,9,10,21,4479,5354,3943,-1411
2017,9,10,22,4415,5343,3887,-1456
2017,9,10,23,4313,5216,3789,-1427
2017,9,11,0,4238,5065,3721,-1344
2017,9,11,1,4113,4597,3403,-1194
2017,9,11,2,3903,3946,3038,-908
2017,9,11,3,3758,3413,2864,-549
2017,9,11,4,3756,2968,2617,-351
2017,9,11,5,3040,2614,2426,-188
2017,9,11,6,2902,2324,2118,-206
2017,9,11,7,2760,2129,2037,-92
2017,9,11,8,2729,1978,1730,-248
2017,9,11,9,2749,1833,1610,-223
2017,9,11,10,2826,1787,1570,-217
2017,9,11,11,3051,1756,1542,-214
2017,9,11,12,3252,1739,1519,-220
2017,9,11,13,3583,1774,1529,-245
2017,9,11,14,3785,1854,1509,-345
2017,9,11,15,3995,1735,1430,-305
2017,9,11,16,4199,1839,1447,-392
2017,9,11,17,4284,2012,1486,-526
2017,9,11,18,4449,2251,1614,-637
2017,9,11,19,4485,2446,1716,-730
2017,9,11,20,4452,2727,1688,-1039
2017,9,11,21,4483,2893,1787,-1106
2017,9,11,22,4487,2999,1982,-1017
2017,9,11,23,4470,3026,2001,-1025
2017,9,12,0,4369,3056,1972,-1084
2017,9,12,1,4110,3161,2101,-1060
2017,9,12,2,3990,3080,2171,-909
2017,9,12,3,3685,2845,2038,-807
2017,9,12,4,3614,2551,1943,-608
2017,9,12,5,1770,2399,1982,-417
2017,9,12,6,1725,2248,1893,-355
2017,9,12,7,1798,2202,1861,-341
2017,9,12,8,1906,2140,1837,-303
2017,9,12,9,2044,2167,1844,-323
2017,9,12,10,2147,2213,1864,-349
2017,9,12,11,2314,2372,1982,-390
2017,9,12,12,2570,2502,2084,-418
2017,9,12,13,2710,2882,2373,-509
2017,9,12,14,2890,3364,2567,-797
2017,9,12,15,2996,3798,2635,-1163
2017,9,12,16,3212,4215,2822,-1393
2017,9,12,17,3330,4599,3035,-1564
2017,9,12,18,3422,4957,3243,-1714
2017,9,12,19,3464,5213,3676,-1537
2017,9,12,20,3496,5456,3811,-1645
2017,9,12,21,3502,5630,3866,-1764
2017,9,12,22,3482,5690,3841,-1849
2017,9,12,23,3422,5675,3734,-1941
2017,9,13,0,3377,5461,3579,-1882
2017,9,13,1,3347,5333,3542,-1791
2017,9,13,2,3231,4884,3369,-1515
2017,9,13,3,3318,4348,3151,-1197
2017,9,13,4,3500,3825,2853,-972
2017,9,13,5,3507,3596,2862,-734
2017,9,13,6,3288,3307,2648,-659
2017,9,13,7,3174,3112,2495,-617
2017,9,13,8,3178,2965,2412,-553
2017,9,13,9,3204,2936,2325,-611
2017,9,13,10,3430,3042,2308,-734
2017,9,13,11,3735,3262,2397,-865
2017,9,13,12,4060,3422,2521,-901
2017,9,13,13,4203,3798,2842,-956
2017,9,13,14,4372,4328,3076,-1252
2017,9,13,15,4477,4888,3318,-1570
2017,9,13,16,4730,5475,3669,-1806
2017,9,13,17,4842,6017,4164,-1853
2017,9,13,18,4910,6466,4477,-1989
2017,9,13,19,5006,6815,4805,-2010
2017,9,13,20,5057,7039,4983,-2056
2017,9,13,21,5058,7182,5235,-1947
2017,9,13,22,4932,7183,5232,-1951
2017,9,13,23,4838,7039,4977,-2062
2017,9,14,0,4723,6789,4771,-2018
2017,9,14,1,4704,6645,4625,-2020
2017,9,14,2,4564,6159,4387,-1772
2017,9,14,3,4455,5611,3902,-1709
2017,9,14,4,4321,5045,3541,-1504
2017,9,14,5,3012,4566,3411,-1155
2017,9,14,6,2762,4229,3313,-916
2017,9,14,7,2616,3989,3167,-822
2017,9,14,8,2549,3822,3000,-822
2017,9,14,9,2577,3797,2992,-805
2017,9,14,10,2730,3938,3023,-915
2017,9,14,11,3076,4210,3162,-1048
2017,9,14,12,3254,4394,3230,-1164
2017,9,14,13,3517,4751,3428,-1323
2017,9,14,14,3985,5351,3750,-1601
2017,9,14,15,4500,6029,4194,-1835
2017,9,14,16,5008,6751,4721,-2030
2017,9,14,17,5464,7309,5138,-2171
2017,9,14,18,5736,7763,5450,-2313
2017,9,14,19,5922,8050,5733,-2317
2017,9,14,20,6018,8230,6037,-2193
2017,9,14,21,6010,8258,5982,-2276
2017,9,14,22,5823,8114,5830,-2284
2017,9,14,23,5583,7861,5605,-2256
2017,9,15,0,5339,7616,5407,-2209
2017,9,15,1,5184,7292,5137,-2155
2017,9,15,2,4754,6795,4821,-1974
2017,9,15,3,4284,6208,4362,-1846
2017,9,15,4,4098,5609,3914,-1695
2017,9,15,5,4040,5067,3600,-1467
2017,9,15,6,3619,4708,3408,-1300
2017,9,15,7,3338,4431,3226,-1205
2017,9,15,8,3355,4313,3145,-1168
2017,9,15,9,3343,4255,3100,-1155
2017,9,15,10,3489,4398,3183,-1215
2017,9,15,11,3984,4678,3393,-1285
2017,9,15,12,4077,4881,3598,-1283
2017,9,15,13,4300,5300,3889,-1411
2017,9,15,14,4996,5946,4236,-1710
2017,9,15,15,5544,6660,4622,-2038
2017,9,15,16,6070,7439,5160,-2279
2017,9,15,17,6591,8146,5839,-2307
2017,9,15,18,6753,8679,6272,-2407
2017,9,15,19,6912,9046,6580,-2466
2017,9,15,20,7069,9219,6705,-2514
2017,9,15,21,6909,9265,6749,-2516
2017,9,15,22,6747,9105,6645,-2460
2017,9,15,23,6366,8613,6195,-2418
2017,9,16,0,6107,8188,5883,-2305
2017,9,16,1,5894,7896,5685,-2211
2017,9,16,2,5447,7378,5358,-2020
2017,9,16,3,4962,6743,4846,-1897
2017,9,16,4,4716,6114,4443,-1671
2017,9,16,5,4515,5629,4271,-1358
2017,9,16,6,4226,5229,3984,-1245
2017,9,16,7,4053,4942,3748,-1194
2017,9,16,8,3882,4743,3599,-1144
2017,9,16,9,3826,4610,3485,-1125
2017,9,16,10,3861,4622,3470,-1152
2017,9,16,11,3960,4719,3567,-1152
2017,9,16,12,4133,4857,3693,-1164
2017,9,16,13,4573,5433,4134,-1299
2017,9,16,14,5136,6251,4749,-1502
2017,9,16,15,5668,7049,5256,-1793
2017,9,16,16,6095,7759,5695,-2064
2017,9,16,17,6483,8405,6420,-1985
2017,9,16,18,6775,8884,6902,-1982
2017,9,16,19,6944,9246,7210,-2036
2017,9,16,20,6953,9422,7325,-2097
2017,9,16,21,6914,9425,7341,-2084
2017,9,16,22,6683,9276,7241,-2035
2017,9,16,23,6465,8812,6774,-2038
2017,9,17,0,6265,8428,6481,-1947
2017,9,17,1,6084,8153,6241,-1912
2017,9,17,2,5663,7540,5762,-1778
2017,9,17,3,5243,6895,5222,-1673
2017,9,17,4,4837,6229,4729,-1500
2017,9,17,5,4465,5632,4320,-1312
2017,9,17,6,4128,5200,4057,-1143
2017,9,17,7,3885,4892,3831,-1061
2017,9,17,8,3717,4678,3666,-1012
2017,9,17,9,3626,4581,3599,-982
2017,9,17,10,3587,4551,3560,-991
2017,9,17,11,3625,4660,3633,-1027
2017,9,17,12,3776,4756,3738,-1018
2017,9,17,13,4214,5331,4195,-1136
2017,9,17,14,4877,6113,4658,-1455
2017,9,17,15,5487,6852,5102,-1750
2017,9,17,16,5875,7571,5582,-1989
2017,9,17,17,6294,8249,6284,-1965
2017,9,17,18,6654,8779,6714,-2065
2017,9,17,19,6811,9131,6979,-2152
2017,9,17,20,6865,9358,7206,-2152
2017,9,17,21,6824,9499,7308,-2191
2017,9,17,22,6708,9448,7305,-2143
2017,9,17,23,6444,9068,7041,-2027
2017,9,18,0,6238,8606,6665,-1941
2017,9,18,1,5994,8274,6363,-1911
2017,9,18,2,5476,7530,5712,-1818
2017,9,18,3,4979,6736,5038,-1698
2017,9,18,4,4414,5998,4540,-1458
2017,9,18,5,4420,5542,4300,-1242
2017,9,18,6,4066,5114,4070,-1044
2017,9,18,7,3804,4804,3843,-961
2017,9,18,8,3654,4632,3694,-938
2017,9,18,9,3662,4594,3655,-939
2017,9,18,10,3891,4836,3824,-1012
2017,9,18,11,4263,5287,4178,-1109
2017,9,18,12,4481,5517,4436,-1081
2017,9,18,13,4717,5823,4732,-1091
2017,9,18,14,5157,6409,5061,-1348
2017,9,18,15,5669,7053,5428,-1625
2017,9,18,16,6136,7688,5835,-1853
2017,9,18,17,6610,8234,6344,-1890
2017,9,18,18,6935,8643,6752,-1891
2017,9,18,19,7198,8895,6977,-1918
2017,9,18,20,7292,9001,7073,-1928
2017,9,18,21,7316,9002,7052,-1950
2017,9,18,22,7346,8941,7006,-1935
2017,9,18,23,7097,8690,6802,-1888
2017,9,19,0,6908,8460,6607,-1853
2017,9,19,1,6634,8286,6494,-1792
2017,9,19,2,6104,7716,6099,-1617
2017,9,19,3,5538,7010,5569,-1441
2017,9,19,4,4952,6246,4910,-1336
2017,9,19,5,3952,5443,4228,-1215
2017,9,19,6,3539,5017,3984,-1033
2017,9,19,7,3233,4752,3791,-961
2017,9,19,8,3254,4560,3627,-933
2017,9,19,9,3309,4551,3619,-932
2017,9,19,10,3418,4789,3799,-990
2017,9,19,11,3971,5260,4155,-1105
2017,9,19,12,3984,5476,4431,-1045
2017,9,19,13,4227,5725,4648,-1077
2017,9,19,14,4673,6263,4939,-1324
2017,9,19,15,5070,6979,5370,-1609
2017,9,19,16,5697,7661,5866,-1795
2017,9,19,17,6082,8150,6311,-1839
2017,9,19,18,6591,8750,6802,-1948
2017,9,19,19,6723,9070,7187,-1883
2017,9,19,20,7028,9305,7353,-1952
2017,9,19,21,7043,9450,7475,-1975
2017,9,19,22,6919,9370,7445,-1925
2017,9,19,23,6817,9026,7091,-1935
2017,9,20,0,6695,8681,6759,-1922
2017,9,20,1,6433,8453,6545,-1908
2017,9,20,2,5872,7787,6098,-1689
2017,9,20,3,5256,7019,5402,-1617
2017,9,20,4,4581,6240,4798,-1442
2017,9,20,5,4193,5566,4327,-1239
2017,9,20,6,3824,5111,4016,-1095
2017,9,20,7,3561,4806,3771,-1035
2017,9,20,8,3465,4597,3604,-993
2017,9,20,9,3490,4565,3590,-975
2017,9,20,10,3657,4798,3764,-1034
2017,9,20,11,4070,5309,4161,-1148
2017,9,20,12,4146,5541,4471,-1070
2017,9,20,13,4409,5840,4722,-1118
2017,9,20,14,4944,6451,5177,-1274
2017,9,20,15,5329,7225,5701,-1524
2017,9,20,16,6080,7939,6120,-1819
2017,9,20,17,6457,8650,6696,-1954
2017,9,20,18,6948,9306,7269,-2037
2017,9,20,19,7152,9732,7653,-2079
2017,9,20,20,7444,9988,7866,-2122
2017,9,20,21,7398,10058,7930,-2128
2017,9,20,22,7293,9918,7813,-2105
2017,9,20,23,7019,9513,7478,-2035
2017,9,21,0,6872,9034,7135,-1899
2017,9,21,1,6637,8685,6857,-1828
2017,9,21,2,6082,8143,6191,-1952
2017,9,21,3,5468,7299,5605,-1694
2017,9,21,4,4870,6329,4918,-1411
2017,9,21,5,4308,5648,4410,-1238
2017,9,21,6,3956,5169,4005,-1164
2017,9,21,7,3718,4862,3752,-1110
2017,9,21,8,3613,4668,3605,-1063
2017,9,21,9,3619,4642,3587,-1055
2017,9,21,10,3780,4870,3760,-1110
2017,9,21,11,4184,5372,4153,-1219
2017,9,21,12,4308,5608,4414,-1194
2017,9,21,13,4563,5896,4701,-1195
2017,9,21,14,5083,6498,5267,-1231
2017,9,21,15,5563,7220,5738,-1482
2017,9,21,16,6253,7977,6082,-1895
2017,9,21,17,6622,8635,6371,-2264
2017,9,21,18,7100,9166,6842,-2324
2017,9,21,19,7266,9569,7196,-2373
2017,9,21,20,7497,9778,7288,-2490
2017,9,21,21,7427,9831,7392,-2439
2017,9,21,22,7282,9658,7247,-2411
2017,9,21,23,7114,9221,6908,-2313
2017,9,22,0,6951,8809,6613,-2196
2017,9,22,1,6714,8465,6427,-2038
2017,9,22,2,6142,7773,6041,-1732
2017,9,22,3,5534,6967,5504,-1463
2017,9,22,4,4920,6196,4856,-1340
2017,9,22,5,4515,5590,4336,-1254
2017,9,22,6,4165,5122,3954,-1168
2017,9,22,7,3933,4814,3707,-1107
2017,9,22,8,3781,4647,3582,-1065
2017,9,22,9,3821,4615,3568,-1047
2017,9,22,10,4018,4889,3768,-1121
2017,9,22,11,4370,5418,4174,-1244
2017,9,22,12,4603,5659,4431,-1228
2017,9,22,13,4817,5996,4751,-1245
2017,9,22,14,5243,6620,5224,-1396
2017,9,22,15,5747,7406,5698,-1708
2017,9,22,16,6145,8090,6159,-1931
2017,9,22,17,6460,8712,6732,-1980
2017,9,22,18,6785,9197,7246,-1951
2017,9,22,19,6941,9457,7413,-2044
2017,9,22,20,6945,9431,7235,-2196
2017,9,22,21,6788,9302,7093,-2209
2017,9,22,22,6527,9048,6883,-2165
2017,9,22,23,6388,8507,6391,-2116
2017,9,23,0,6135,8075,6042,-2033
2017,9,23,1,5945,7873,5984,-1889
2017,9,23,2,5506,7345,5675,-1670
2017,9,23,3,5050,6744,5100,-1644
2017,9,23,4,4615,6154,4672,-1482
2017,9,23,5,4590,5749,4510,-1239
2017,9,23,6,4261,5333,4209,-1124
2017,9,23,7,4030,5041,3970,-1071
2017,9,23,8,3861,4846,3829,-1017
2017,9,23,9,3797,4749,3746,-1003
2017,9,23,10,3801,4774,3759,-1015
2017,9,23,11,3865,4926,3887,-1039
2017,9,23,12,4003,5138,4054,-1084
2017,9,23,13,4367,5678,4429,-1249
2017,9,23,14,4913,6443,5143,-1300
2017,9,23,15,5463,7270,5835,-1435
2017,9,23,16,5942,7993,6226,-1767
2017,9,23,17,6348,8596,6597,-1999
2017,9,23,18,6621,9068,7038,-2030
2017,9,23,19,6780,9279,7181,-2098
2017,9,23,20,6815,9295,7130,-2165
2017,9,23,21,6887,9200,7167,-2033
2017,9,23,22,6702,8917,6989,-1928
2017,9,23,23,6491,8428,6521,-1907
2017,9,24,0,6238,8047,6224,-1823
2017,9,24,1,6022,7766,6174,-1592
2017,9,24,2,5571,7294,5935,-1359
2017,9,24,3,5141,6741,5575,-1166
2017,9,24,4,4720,6189,4969,-1220
2017,9,24,5,4159,5521,4320,-1201
2017,9,24,6,3852,5139,4013,-1126
2017,9,24,7,3677,4882,3824,-1058
2017,9,24,8,3555,4709,3706,-1003
2017,9,24,9,3505,4601,3582,-1019
2017,9,24,10,3498,4626,3597,-1029
2017,9,24,11,3606,4780,3712,-1068
2017,9,24,12,3748,4992,3908,-1084
2017,9,24,13,4122,5530,4358,-1172
2017,9,24,14,4758,6389,4807,-1582
2017,9,24,15,5351,7181,5326,-1855
2017,9,24,16,5865,7864,5690,-2174
2017,9,24,17,6339,10087,7739,-2348
2017,9,24,18,6675,8933,6477,-2456
2017,9,24,19,6909,9306,6810,-2496
2017,9,24,20,6981,9540,7131,-2409
2017,9,24,21,6978,9553,7204,-2349
2017,9,24,22,6895,9434,7138,-2296
2017,9,24,23,6546,8919,6763,-2156
2017,9,25,0,6348,8594,6557,-2037
2017,9,25,1,6136,8311,6434,-1877
2017,9,25,2,5634,7678,6029,-1649
2017,9,25,3,5109,6956,5333,-1623
2017,9,25,4,4577,6242,4749,-1493
2017,9,25,5,4160,5625,4322,-1303
2017,9,25,6,3853,5183,3987,-1196
2017,9,25,7,3661,4947,3794,-1153
2017,9,25,8,3545,4793,3679,-1114
2017,9,25,9,3574,4787,3668,-1119
2017,9,25,10,3795,5072,3909,-1163
2017,9,25,11,4179,5578,4306,-1272
2017,9,25,12,4397,5847,4583,-1264
2017,9,25,13,4623,6118,4846,-1272
2017,9,25,14,5122,6652,5234,-1418
2017,9,25,15,5602,7347,5629,-1718
2017,9,25,16,6141,8078,6117,-1961
2017,9,25,17,6583,8840,6769,-2071
2017,9,25,18,6912,9485,7360,-2125
2017,9,25,19,7141,9893,7755,-2138
2017,9,25,20,7236,10179,7921,-2258
2017,9,25,21,7158,10300,7998,-2302
2017,9,25,22,7033,10185,7904,-2281
2017,9,25,23,6756,9739,7550,-2189
2017,9,26,0,6576,9318,7192,-2126
2017,9,26,1,6367,8883,6778,-2105
2017,9,26,2,5847,8121,6219,-1902
2017,9,26,3,5255,7260,5487,-1773
2017,9,26,4,4713,6464,4936,-1528
2017,9,26,5,4234,5804,4453,-1351
2017,9,26,6,3917,5356,4101,-1255
2017,9,26,7,3708,5072,3884,-1188
2017,9,26,8,3569,4880,3735,-1145
2017,9,26,9,3590,4835,3700,-1135
2017,9,26,10,3762,5065,3870,-1195
2017,9,26,11,4152,5550,4254,-1296
2017,9,26,12,4350,5788,4522,-1266
2017,9,26,13,4623,6084,4809,-1275
2017,9,26,14,5180,6709,5266,-1443
2017,9,26,15,5616,7487,5740,-1747
2017,9,26,16,6227,8281,6252,-2029
2017,9,26,17,6629,9114,6995,-2119
2017,9,26,18,7019,9712,7392,-2320
2017,9,26,19,7229,10149,7777,-2372
2017,9,26,20,7375,10378,8121,-2257
2017,9,26,21,7399,10518,8216,-2302
2017,9,26,22,7241,10360,8028,-2332
2017,9,26,23,6985,9892,7684,-2208
2017,9,27,0,6774,9437,7242,-2195
2017,9,27,1,6522,9045,6952,-2093
2017,9,27,2,6038,8298,6515,-1783
2017,9,27,3,5429,7422,5726,-1696
2017,9,27,4,4827,6629,5078,-1551
2017,9,27,5,4488,5966,4594,-1372
2017,9,27,6,4189,5527,4251,-1276
2017,9,27,7,3988,5056,3861,-1195
2017,9,27,8,3821,5011,3859,-1152
2017,9,27,9,3809,4956,3793,-1163
2017,9,27,10,4017,5231,4007,-1224
2017,9,27,11,4398,5698,4374,-1324
2017,9,27,12,4599,5927,4639,-1288
2017,9,27,13,4820,6237,4935,-1302
2017,9,27,14,5377,6901,5336,-1565
2017,9,27,15,5953,7703,5825,-1878
2017,9,27,16,6438,8492,6377,-2115
2017,9,27,17,6892,9211,7119,-2092
2017,9,27,18,7305,9794,7545,-2249
2017,9,27,19,7657,10198,7904,-2294
2017,9,27,20,7870,10493,8103,-2390
2017,9,27,21,7964,10576,8248,-2328
2017,9,27,22,7897,10402,8087,-2315
2017,9,27,23,7652,9893,7679,-2214
2017,9,28,0,7215,9828,7796,-2032
2017,9,28,1,6823,8943,6898,-2045
2017,9,28,2,6315,8199,6426,-1773
2017,9,28,3,5664,7355,5608,-1747
2017,9,28,4,4993,6567,5039,-1528
2017,9,28,5,4547,5921,4584,-1337
2017,9,28,6,4238,5448,4234,-1214
2017,9,28,7,4016,5136,3971,-1165
2017,9,28,8,3834,4915,3791,-1124
2017,9,28,9,3810,4878,3749,-1129
2017,9,28,10,3993,5143,3888,-1255
2017,9,28,11,4409,5637,4113,-1524
2017,9,28,12,4613,5833,4328,-1505
2017,9,28,13,4832,6130,4715,-1415
2017,9,28,14,5395,6830,5297,-1533
2017,9,28,15,5991,7655,5725,-1930
2017,9,28,16,6527,8507,6117,-2390
2017,9,28,17,6988,9265,6841,-2424
2017,9,28,18,7393,9862,7349,-2513
2017,9,28,19,7735,10278,7555,-2723
2017,9,28,20,7973,10564,7645,-2919
2017,9,28,21,8044,10683,7769,-2914
2017,9,28,22,7992,10538,7720,-2818
2017,9,28,23,7754,10024,7338,-2686
2017,9,29,0,7431,9601,7076,-2525
2017,9,29,1,7030,10037,7761,-2276
2017,9,29,2,6397,8424,6241,-2183
2017,9,29,3,5664,7575,5488,-2087
2017,9,29,4,5068,6774,4940,-1834
2017,9,29,5,4586,6129,4392,-1737
2017,9,29,6,4249,5670,4113,-1557
2017,9,29,7,4019,5353,3877,-1476
2017,9,29,8,3821,5135,3696,-1439
2017,9,29,9,3791,5045,3623,-1422
2017,9,29,10,3958,5293,3814,-1479
2017,9,29,11,4315,5767,4213,-1554
2017,9,29,12,4502,6011,4476,-1535
2017,9,29,13,4760,6275,4574,-1701
2017,9,29,14,5253,6841,4854,-1987
2017,9,29,15,5903,7593,5392,-2201
2017,9,29,16,6481,8354,5841,-2513
2017,9,29,17,6983,9032,6421,-2611
2017,9,29,18,7429,9548,6761,-2787
2017,9,29,19,7705,9760,6975,-2785
2017,9,29,20,7800,9604,6852,-2752
2017,9,29,21,7722,9330,6652,-2678
2017,9,29,22,7542,8872,6228,-2644
2017,9,29,23,7247,8300,5730,-2570
2017,9,30,0,6854,7883,5441,-2442
2017,9,30,1,6430,7540,5183,-2357
2017,9,30,2,5895,7051,4930,-2121
2017,9,30,3,5345,6565,4493,-2072
2017,9,30,4,4859,6022,4184,-1838
2017,9,30,5,4502,5533,3960,-1573
2017,9,30,6,4148,5201,3701,-1500
2017,9,30,7,3932,4958,3514,-1444
2017,9,30,8,3780,4814,3407,-1407
2017,9,30,9,3707,4724,3335,-1389
2017,9,30,10,3733,4776,3370,-1406
2017,9,30,11,3876,4924,3482,-1442
2017,9,30,12,4025,5201,3744,-1457
2017,9,30,13,4349,5654,4044,-1610
2017,9,30,14,4948,6298,4508,-1790
2017,9,30,15,5445,6901,4883,-2018
2017,9,30,16,5961,7486,5500,-1986
2017,9,30,17,6248,8012,5954,-2058
2017,9,30,18,6475,8446,6306,-2140
2017,9,30,19,6612,8675,6481,-2194
2017,9,30,20,6574,8746,6576,-2170
2017,9,30,21,6522,8680,6500,-2180
2017,9,30,22,6340,8318,5955,-2363
2017,9,30,23,6029,7857,5497,-2360
2017,10,1,0,5954,7654,5325,-2329
2017,10,1,1,5603,7351,5080,-2271
2017,10,1,2,5174,6877,4881,-1996
2017,10,1,3,4788,6379,4489,-1890
2017,10,1,4,4387,5861,4179,-1682
2017,10,1,5,4300,5414,3878,-1536
2017,10,1,6,4005,5045,3626,-1419
2017,10,1,7,3821,4803,3433,-1370
2017,10,1,8,3714,4650,3315,-1335
2017,10,1,9,3612,4570,3248,-1322
2017,10,1,10,3606,4616,3271,-1345
2017,10,1,11,3722,4763,3387,-1376
2017,10,1,12,3874,4976,3607,-1369
2017,10,1,13,4218,5484,3902,-1582
2017,10,1,14,4799,6240,4473,-1767
2017,10,1,15,5399,6945,4876,-2069
2017,10,1,16,5806,7595,5333,-2262
2017,10,1,17,6128,8128,5722,-2406
2017,10,1,18,6395,8483,5994,-2489
2017,10,1,19,6660,8652,6190,-2462
2017,10,1,20,6704,8762,6337,-2425
2017,10,1,21,6580,8683,6242,-2441
2017,10,1,22,6582,8301,5850,-2451
2017,10,1,23,6382,7866,5521,-2345
2017,10,2,0,6200,7773,5448,-2325
2017,10,2,1,6005,7518,5274,-2244
2017,10,2,2,5542,7011,4997,-2014
2017,10,2,3,5062,6386,4507,-1879
2017,10,2,4,4607,5755,4103,-1652
2017,10,2,5,4159,5246,3824,-1422
2017,10,2,6,3889,4956,3753,-1203
2017,10,2,7,3709,4766,3624,-1142
2017,10,2,8,3630,4665,3549,-1116
2017,10,2,9,3655,4694,3513,-1181
2017,10,2,10,3837,5027,3749,-1278
2017,10,2,11,4272,5619,4269,-1350
2017,10,2,12,4519,5870,4563,-1307
2017,10,2,13,4681,5965,4610,-1355
2017,10,2,14,5043,6283,4737,-1546
2017,10,2,15,5496,6786,4887,-1899
2017,10,2,16,5946,7281,5274,-2007
2017,10,2,17,6265,7747,5594,-2153
2017,10,2,18,6591,8105,5831,-2274
2017,10,2,19,6861,8305,5974,-2331
2017,10,2,20,6912,8470,6071,-2399
2017,10,2,21,6838,8548,6128,-2420
2017,10,2,22,6643,8416,6005,-2411
2017,10,2,23,6449,8034,5752,-2282
2017,10,3,0,6274,7852,5619,-2233
2017,10,3,1,6105,7557,5389,-2168
2017,10,3,2,5625,6956,5024,-1932
2017,10,3,3,5081,6273,4562,-1711
2017,10,3,4,4576,5381,3924,-1457
2017,10,3,5,4036,5118,3823,-1295
2017,10,3,6,3756,4773,3640,-1133
2017,10,3,7,3539,4536,3456,-1080
2017,10,3,8,3405,4413,3344,-1069
2017,10,3,9,3405,4436,3346,-1090
2017,10,3,10,3626,4764,3600,-1164
2017,10,3,11,4041,5364,4090,-1274
2017,10,3,12,4253,5617,4372,-1245
2017,10,3,13,4428,5814,4432,-1382
2017,10,3,14,4769,6259,4550,-1709
2017,10,3,15,5148,6760,4862,-1898
2017,10,3,16,5530,7207,5211,-1996
2017,10,3,17,5824,7455,5372,-2083
2017,10,3,18,6162,7662,5536,-2126
2017,10,3,19,6424,7802,5707,-2095
2017,10,3,20,6578,7898,5758,-2140
2017,10,3,21,6644,7956,5764,-2192
2017,10,3,22,6412,7876,5671,-2205
2017,10,3,23,6110,7676,5494,-2182
2017,10,4,0,6109,7693,5525,-2168
2017,10,4,1,5896,7545,5390,-2155
2017,10,4,2,5394,7060,5084,-1976
2017,10,4,3,4876,6422,4631,-1791
2017,10,4,4,4383,5762,4204,-1558
2017,10,4,5,4080,5402,4156,-1246
2017,10,4,6,3800,5005,3860,-1145
2017,10,4,7,3602,4774,3660,-1114
2017,10,4,8,3512,4621,3511,-1110
2017,10,4,9,3487,4579,3485,-1094
2017,10,4,10,3695,4848,3691,-1157
2017,10,4,11,4099,5393,4135,-1258
2017,10,4,12,4305,5594,4410,-1184
2017,10,4,13,4439,5798,4505,-1293
2017,10,4,14,4767,6263,4630,-1633
2017,10,4,15,5259,6808,4900,-1908
2017,10,4,16,5675,7305,5180,-2125
2017,10,4,17,5966,7553,5233,-2320
2017,10,4,18,6345,7785,5447,-2338
2017,10,4,19,6651,7827,5488,-2339
2017,10,4,20,6778,7824,5512,-2312
2017,10,4,21,6867,7889,5558,-2331
2017,10,4,22,6713,7897,5550,-2347
2017,10,4,23,6409,7694,5371,-2323
2017,10,5,0,6307,7647,5356,-2291
2017,10,5,1,6079,7478,5247,-2231
2017,10,5,2,5599,6983,4969,-2014
2017,10,5,3,5095,6331,4480,-1851
2017,10,5,4,4608,5687,4047,-1640
2017,10,5,5,4081,4983,3691,-1292
2017,10,5,6,3811,4643,3362,-1281
2017,10,5,7,3655,4421,3192,-1229
2017,10,5,8,3599,4337,3111,-1226
2017,10,5,9,3611,4389,3154,-1235
2017,10,5,10,3841,4728,3411,-1317
2017,10,5,11,4267,5327,3874,-1453
2017,10,5,12,4492,5658,4246,-1412
2017,10,5,13,4645,5785,4391,-1394
2017,10,5,14,4963,6041,4489,-1552
2017,10,5,15,5372,6391,4790,-1601
2017,10,5,16,5697,6714,4993,-1721
2017,10,5,17,5993,6968,5138,-1830
2017,10,5,18,6201,7123,5282,-1841
2017,10,5,19,6351,7177,5297,-1880
2017,10,5,20,6408,7205,5342,-1863
2017,10,5,21,6377,7213,5338,-1875
2017,10,5,22,6317,7205,5338,-1867
2017,10,5,23,6115,7107,5250,-1857
2017,10,6,0,6048,7193,5294,-1899
2017,10,6,1,5774,7071,5234,-1837
2017,10,6,2,5406,6625,4956,-1669
2017,10,6,3,4972,6079,4544,-1535
2017,10,6,4,4523,5492,4115,-1377
2017,10,6,5,4061,5040,3670,-1370
2017,10,6,6,3812,4730,3349,-1381
2017,10,6,7,3689,4522,3187,-1335
2017,10,6,8,3614,4414,3092,-1322
2017,10,6,9,3642,4461,3120,-1341
2017,10,6,10,3864,4790,3386,-1404
2017,10,6,11,4278,5428,3933,-1495
2017,10,6,12,4533,5761,4446,-1315
2017,10,6,13,4778,5942,4548,-1394
2017,10,6,14,5173,6369,4627,-1742
2017,10,6,15,5628,6871,4969,-1902
2017,10,6,16,6152,7533,5548,-1985
2017,10,6,17,6483,8218,6041,-2177
2017,10,6,18,6782,8751,6451,-2300
2017,10,6,19,6925,10159,7752,-2407
2017,10,6,20,6984,9453,7149,-2304
2017,10,6,21,6967,9323,7040,-2283
2017,10,6,22,6789,8847,6571,-2276
2017,10,6,23,6559,8329,6067,-2262
2017,10,7,0,6448,8085,5868,-2217
2017,10,7,1,6290,7773,5657,-2116
2017,10,7,2,5921,7300,5362,-1938
2017,10,7,3,5499,6780,4935,-1845
2017,10,7,4,5062,6275,4566,-1709
2017,10,7,5,4634,5814,4267,-1547
2017,10,7,6,4352,5507,3980,-1527
2017,10,7,7,4156,5287,3808,-1479
2017,10,7,8,3990,5155,3693,-1462
2017,10,7,9,3896,5105,3635,-1470
2017,10,7,10,3911,5150,3667,-1483
2017,10,7,11,4008,5347,3841,-1506
2017,10,7,12,4196,5617,4147,-1470
2017,10,7,13,4595,6135,4634,-1501
2017,10,7,14,5190,6772,4908,-1864
2017,10,7,15,5785,7460,5442,-2018
2017,10,7,16,6189,8221,5933,-2288
2017,10,7,17,6476,8920,6500,-2420
2017,10,7,18,6700,9364,6820,-2544
2017,10,7,19,6839,9662,7191,-2471
2017,10,7,20,6785,9788,7318,-2470
2017,10,7,21,6718,9788,7294,-2494
2017,10,7,22,6539,9502,7085,-2417
2017,10,7,23,6389,8846,6576,-2270
2017,10,8,0,6230,8509,6245,-2264
2017,10,8,1,6064,8076,5821,-2255
2017,10,8,2,5627,7579,5608,-1971
2017,10,8,3,5251,7015,5084,-1931
2017,10,8,4,4866,6517,4799,-1718
2017,10,8,5,4499,6181,4498,-1683
2017,10,8,6,4170,5801,4175,-1626
2017,10,8,7,4020,5544,3959,-1585
2017,10,8,8,3920,5385,3831,-1554
2017,10,8,9,3859,5329,3787,-1542
2017,10,8,10,3882,5352,3793,-1559
2017,10,8,11,3996,5519,3924,-1595
2017,10,8,12,4185,5730,4114,-1616
2017,10,8,13,4520,6254,4640,-1614
2017,10,8,14,5043,7081,5250,-1831
2017,10,8,15,5544,7898,5864,-2034
2017,10,8,16,6043,8634,6312,-2322
2017,10,8,17,6404,9290,6964,-2326
2017,10,8,18,6662,9744,7401,-2343
2017,10,8,19,6809,9928,7518,-2410
2017,10,8,20,6775,9936,7600,-2336
2017,10,8,21,6678,9784,7466,-2318
2017,10,8,22,6518,9188,6901,-2287
2017,10,8,23,6400,8684,6284,-2400
2017,10,9,0,6391,8442,6017,-2425
2017,10,9,1,6081,8051,5621,-2430
2017,10,9,2,5499,0,5621,-2104
2017,10,9,3,5035,6730,4763,-1967
2017,10,9,4,4583,6112,4490,-1622
2017,10,9,5,4616,5612,4054,-1558
2017,10,9,6,4308,5263,3752,-1511
2017,10,9,7,4133,5018,3574,-1444
2017,10,9,8,4050,4908,3471,-1437
2017,10,9,9,4046,4927,3478,-1449
2017,10,9,10,4271,5237,3729,-1508
2017,10,9,11,4744,5819,4216,-1603
2017,10,9,12,5016,6107,4453,-1654
2017,10,9,13,5149,6348,4648,-1700
2017,10,9,14,5582,6922,5058,-1864
2017,10,9,15,6101,7650,5798,-1852
2017,10,9,16,6611,8419,6357,-2062
2017,10,9,17,7019,9093,6871,-2222
2017,10,9,18,7362,9578,7222,-2356
2017,10,9,19,7523,9886,7515,-2371
2017,10,9,20,7649,10080,7691,-2389
2017,10,9,21,7529,10090,7829,-2261
2017,10,9,22,7361,9875,7694,-2181
2017,10,9,23,7073,9393,7322,-2071
2017,10,10,0,7015,9113,7096,-2017
2017,10,10,1,6728,8673,6733,-1940
2017,10,10,2,6115,7940,6233,-1707
2017,10,10,3,5503,7161,5618,-1543
2017,10,10,4,4955,6420,4984,-1436
2017,10,10,5,4491,5851,4412,-1439
2017,10,10,6,4196,5441,3974,-1467
2017,10,10,7,4016,5171,3748,-1423
2017,10,10,8,3859,5005,3615,-1390
2017,10,10,9,3865,5006,3601,-1405
2017,10,10,10,4090,5254,3786,-1468
2017,10,10,11,4576,5833,4349,-1484
2017,10,10,12,4831,6086,4780,-1306
2017,10,10,13,4984,6305,4966,-1339
2017,10,10,14,5436,6906,5362,-1544
2017,10,10,15,6045,7601,5911,-1690
2017,10,10,16,6589,8305,6291,-2014
2017,10,10,17,6955,8956,6754,-2202
2017,10,10,18,7254,9504,7200,-2304
2017,10,10,19,7478,9914,7525,-2389
2017,10,10,20,7538,10158,7781,-2377
2017,10,10,21,7493,10218,7876,-2342
2017,10,10,22,7337,10043,7764,-2279
2017,10,10,23,7046,9524,7354,-2170
2017,10,11,0,6934,9253,7072,-2181
2017,10,11,1,6691,8770,6684,-2086
2017,10,11,2,6159,8057,6111,-1946
2017,10,11,3,5578,7235,5383,-1852
2017,10,11,4,5033,6464,4747,-1717
2017,10,11,5,4625,5821,4239,-1582
2017,10,11,6,4348,5350,3848,-1502
2017,10,11,7,4177,5060,3620,-1440
2017,10,11,8,4035,4844,3447,-1397
2017,10,11,9,4076,4798,3439,-1359
2017,10,11,10,4294,5016,3578,-1438
2017,10,11,11,4738,5545,4018,-1527
2017,10,11,12,4978,5804,4282,-1522
2017,10,11,13,5135,6037,4481,-1556
2017,10,11,14,5596,6646,4831,-1815
2017,10,11,15,6223,7334,5347,-1987
2017,10,11,16,6771,7993,5883,-2110
2017,10,11,17,7078,8607,6471,-2136
2017,10,11,18,7399,9159,7018,-2141
2017,10,11,19,7650,9551,7320,-2231
2017,10,11,20,7700,9783,7415,-2368
2017,10,11,21,7641,9831,7446,-2385
2017,10,11,22,7465,9668,7324,-2344
2017,10,11,23,7180,9130,6937,-2193
2017,10,12,0,7071,8873,6739,-2134
2017,10,12,1,6764,8378,6267,-2111
2017,10,12,2,6215,7657,5650,-2007
2017,10,12,3,5639,6862,4976,-1886
2017,10,12,4,5082,6061,4395,-1666
2017,10,12,5,4313,5434,3964,-1470
2017,10,12,6,4006,4966,3566,-1400
2017,10,12,7,3774,4660,3309,-1351
2017,10,12,8,3673,4457,3137,-1320
2017,10,12,9,3676,4405,3100,-1305
2017,10,12,10,3882,4647,3290,-1357
2017,10,12,11,4299,5191,3730,-1461
2017,10,12,12,4526,5440,3986,-1454
2017,10,12,13,4685,5639,4149,-1490
2017,10,12,14,5051,6641,4760,-1881
2017,10,12,15,5627,6769,4740,-2029
2017,10,12,16,6112,7346,5198,-2148
2017,10,12,17,6521,7934,5744,-2190
2017,10,12,18,6924,8474,6279,-2195
2017,10,12,19,7276,8889,6655,-2234
2017,10,12,20,7427,9150,6863,-2287
2017,10,12,21,7488,9184,6880,-2304
2017,10,12,22,7261,9061,6784,-2277
2017,10,12,23,6884,8677,6457,-2220
2017,10,13,0,6680,8439,6218,-2221
2017,10,13,1,6339,8033,5884,-2149
2017,10,13,2,5807,7378,5338,-2040
2017,10,13,3,5311,6668,4694,-1974
2017,10,13,4,4773,5952,4235,-1717
2017,10,13,5,4310,5352,3875,-1477
2017,10,13,6,4031,4923,3518,-1405
2017,10,13,7,3792,4636,3296,-1340
2017,10,13,8,3655,4495,3191,-1304
2017,10,13,9,3647,4500,3196,-1304
2017,10,13,10,3813,4752,3404,-1348
2017,10,13,11,4161,5345,3883,-1462
2017,10,13,12,4432,5648,4203,-1445
2017,10,13,13,4575,5911,4414,-1497
2017,10,13,14,4993,6536,4796,-1740
2017,10,13,15,5571,7226,5463,-1763
2017,10,13,16,6016,7814,5919,-1895
2017,10,13,17,6430,8265,6354,-1911
2017,10,13,18,6693,8614,6653,-1961
2017,10,13,19,6924,8889,6939,-1950
2017,10,13,20,7000,9055,6993,-2062
2017,10,13,21,6967,9014,6930,-2084
2017,10,13,22,6707,8694,6652,-2042
2017,10,13,23,6388,8091,6105,-1986
2017,10,14,0,6237,7850,5875,-1975
2017,10,14,1,5928,7504,5547,-1957
2017,10,14,2,5528,7061,5265,-1796
2017,10,14,3,5173,6565,4695,-1870
2017,10,14,4,4747,6054,4363,-1691
2017,10,14,5,4349,5546,4015,-1531
2017,10,14,6,4091,5187,3731,-1456
2017,10,14,7,3893,4914,3500,-1414
2017,10,14,8,3802,4786,3407,-1379
2017,10,14,9,3730,4756,3399,-1357
2017,10,14,10,3739,4808,3435,-1373
2017,10,14,11,3837,4991,3551,-1440
2017,10,14,12,4047,5281,3860,-1421
2017,10,14,13,4363,5736,4190,-1546
2017,10,14,14,4896,6441,4617,-1824
2017,10,14,15,5391,7134,5238,-1896
2017,10,14,16,5841,7722,5806,-1916
2017,10,14,17,6188,8254,6225,-2029
2017,10,14,18,6346,8650,6529,-2121
2017,10,14,19,6407,8892,6735,-2157
2017,10,14,20,6437,8902,6765,-2137
2017,10,14,21,6460,8866,6703,-2163
2017,10,14,22,6278,8660,6550,-2110
2017,10,14,23,6023,8125,6066,-2059
2017,10,15,0,5967,7787,5724,-2063
2017,10,15,1,5640,7345,5371,-1974
2017,10,15,2,5244,6853,4908,-1945
2017,10,15,3,4882,6263,4478,-1785
2017,10,15,4,4495,5715,4127,-1588
2017,10,15,5,4217,5213,3734,-1479
2017,10,15,6,3915,4851,3467,-1384
2017,10,15,7,3703,4561,3253,-1308
2017,10,15,8,3594,4391,3111,-1280
2017,10,15,9,3508,4298,3024,-1274
2017,10,15,10,3497,4323,3039,-1284
2017,10,15,11,3606,4457,3124,-1333
2017,10,15,12,3750,4697,3371,-1326
2017,10,15,13,4129,5265,3778,-1487
2017,10,15,14,4738,6120,4352,-1768
2017,10,15,15,5386,6909,4852,-2057
2017,10,15,16,5936,7630,5506,-2124
2017,10,15,17,6329,8291,6019,-2272
2017,10,15,18,6703,8901,6545,-2356
2017,10,15,19,6951,9250,6933,-2317
2017,10,15,20,7060,9494,7124,-2370
2017,10,15,21,7130,9507,7135,-2372
2017,10,15,22,6969,9304,6944,-2360
2017,10,15,23,6641,8799,6518,-2281
2017,10,16,0,6538,8491,6184,-2307
2017,10,16,1,6259,8000,5817,-2183
2017,10,16,2,5763,7388,5143,-2245
2017,10,16,3,5209,6662,4621,-2041
2017,10,16,4,4705,5994,4274,-1720
2017,10,16,5,4264,5396,3881,-1515
2017,10,16,6,3958,4994,3564,-1430
2017,10,16,7,3751,4749,3371,-1378
2017,10,16,8,3652,4582,3242,-1340
2017,10,16,9,3668,4583,3232,-1351
2017,10,16,10,3902,4818,3411,-1407
2017,10,16,11,4336,5347,3823,-1524
2017,10,16,12,4586,5649,4164,-1485
2017,10,16,13,4763,5956,4446,-1510
2017,10,16,14,5258,6560,4759,-1801
2017,10,16,15,5816,7291,5415,-1876
2017,10,16,16,6270,8012,6147,-1865
2017,10,16,17,6621,8676,6733,-1943
2017,10,16,18,6868,9233,7382,-1851
2017,10,16,19,7115,9438,7574,-1864
2017,10,16,20,7192,9765,7951,-1814
2017,10,16,21,7168,9753,7983,-1770
2017,10,16,22,6974,9455,7679,-1776
2017,10,16,23,6649,8972,7140,-1832
2017,10,17,0,6560,8765,6802,-1963
2017,10,17,1,6234,8323,6459,-1864
2017,10,17,2,5723,7618,5732,-1886
2017,10,17,3,5188,6884,5030,-1854
2017,10,17,4,4678,6162,4486,-1676
2017,10,17,5,4219,5570,4001,-1569
2017,10,17,6,3899,5114,3592,-1522
2017,10,17,7,3685,4823,3365,-1458
2017,10,17,8,3585,4653,3227,-1426
2017,10,17,9,3556,4640,3218,-1422
2017,10,17,10,3776,4895,3412,-1483
2017,10,17,11,4185,5476,3864,-1612
2017,10,17,12,4425,5757,4208,-1549
2017,10,17,13,4545,5780,4248,-1532
2017,10,17,14,4843,5945,4126,-1819
2017,10,17,15,5158,6232,4218,-2014
2017,10,17,16,5438,6531,4377,-2154
2017,10,17,17,5639,6773,4625,-2148
2017,10,17,18,5825,6891,4742,-2149
2017,10,17,19,5987,6933,4834,-2099
2017,10,17,20,6041,6931,4883,-2048
2017,10,17,21,5953,6943,4895,-2048
2017,10,17,22,5794,6865,4735,-2130
2017,10,17,23,5664,6841,4598,-2243
2017,10,18,0,5666,6945,4650,-2295
2017,10,18,1,5486,6688,4458,-2230
2017,10,18,2,5113,6241,4241,-2000
2017,10,18,3,4657,5627,3745,-1882
2017,10,18,4,4212,5035,3451,-1584
2017,10,18,5,3604,4579,3216,-1363
2017,10,18,6,3348,4218,2930,-1288
2017,10,18,7,3173,4013,2764,-1249
2017,10,18,8,3099,3897,2681,-1216
2017,10,18,9,3102,3929,2681,-1248
2017,10,18,10,3360,4249,2938,-1311
2017,10,18,11,3803,4872,3417,-1455
2017,10,18,12,4042,5202,3791,-1411
2017,10,18,13,4155,5311,3889,-1422
2017,10,18,14,4481,5612,3876,-1736
2017,10,18,15,4866,5946,3999,-1947
2017,10,18,16,5284,6270,4060,-2210
2017,10,18,17,5607,6583,4269,-2314
2017,10,18,18,5933,6858,4525,-2333
2017,10,18,19,6144,7082,4762,-2320
2017,10,18,20,6282,7278,4974,-2304
2017,10,18,21,6318,7376,5093,-2283
2017,10,18,22,6169,7317,5028,-2289
2017,10,18,23,5906,7084,4828,-2256
2017,10,19,0,5831,7098,4820,-2278
2017,10,19,1,5527,6806,4596,-2210
2017,10,19,2,5140,6325,4316,-2009
2017,10,19,3,4649,5717,3768,-1949
2017,10,19,4,4184,5096,3451,-1645
2017,10,19,5,3847,4594,3193,-1401
2017,10,19,6,3536,4224,2911,-1313
2017,10,19,7,3359,4032,2764,-1268
2017,10,19,8,3264,3936,2693,-1243
2017,10,19,9,3293,3963,2709,-1254
2017,10,19,10,3525,4255,2917,-1338
2017,10,19,11,3991,4842,3392,-1450
2017,10,19,12,4258,5124,3690,-1434
2017,10,19,13,4339,5274,3817,-1457
2017,10,19,14,4671,5686,3890,-1796
2017,10,19,15,5096,6188,4169,-2019
2017,10,19,16,5513,6687,4395,-2292
2017,10,19,17,5842,7182,4867,-2315
2017,10,19,18,6147,7622,5190,-2432
2017,10,19,19,6389,7972,5563,-2409
2017,10,19,20,6523,8170,5778,-2392
2017,10,19,21,6557,8272,5862,-2410
2017,10,19,22,6412,8134,5739,-2395
2017,10,19,23,6150,7735,5410,-2325
2017,10,20,0,6055,7613,5297,-2316
2017,10,20,1,5735,7355,5106,-2249
2017,10,20,2,5312,6795,4772,-2023
2017,10,20,3,4826,6097,4119,-1978
2017,10,20,4,4360,5403,3737,-1666
2017,10,20,5,3907,4916,3491,-1425
2017,10,20,6,3581,4537,3171,-1366
2017,10,20,7,3388,4316,2975,-1341
2017,10,20,8,3273,4170,2848,-1322
2017,10,20,9,3275,4173,2852,-1321
2017,10,20,10,3474,4411,3012,-1399
2017,10,20,11,3896,4981,3493,-1488
2017,10,20,12,4157,5275,3782,-1493
2017,10,20,13,4299,5453,3953,-1500
2017,10,20,14,4683,5924,4093,-1831
2017,10,20,15,5122,6475,4437,-2038
2017,10,20,16,5541,6947,4677,-2270
2017,10,20,17,5914,7372,5064,-2308
2017,10,20,18,6223,7773,5391,-2382
2017,10,20,19,6469,8102,5631,-2471
2017,10,20,20,6595,8324,5801,-2523
2017,10,20,21,6614,8359,5829,-2530
2017,10,20,22,6371,8161,5656,-2505
2017,10,20,23,6105,7606,5222,-2384
2017,10,21,0,5920,7359,5040,-2319
2017,10,21,1,5597,6919,4725,-2194
2017,10,21,2,5202,6440,4488,-1952
2017,10,21,3,4805,5911,4004,-1907
2017,10,21,4,4396,5380,3679,-1701
2017,10,21,5,4049,4892,3471,-1421
2017,10,21,6,3737,4503,3163,-1340
2017,10,21,7,3498,4287,3003,-1284
2017,10,21,8,3376,4121,2866,-1255
2017,10,21,9,3315,4073,2812,-1261
2017,10,21,10,3313,4128,2848,-1280
2017,10,21,11,3453,4316,2977,-1339
2017,10,21,12,3654,4582,3197,-1385
2017,10,21,13,3973,5025,3576,-1449
2017,10,21,14,4516,5658,3788,-1870
2017,10,21,15,5051,6277,4262,-2015
2017,10,21,16,5519,6836,4601,-2235
2017,10,21,17,5832,7288,4981,-2307
2017,10,21,18,6114,7628,5199,-2429
2017,10,21,19,6346,7870,5357,-2513
2017,10,21,20,6472,7939,5406,-2533
2017,10,21,21,6578,7842,5332,-2510
2017,10,21,22,6430,7618,5168,-2450
2017,10,21,23,6145,7286,4946,-2340
2017,10,22,0,5968,7169,4850,-2319
2017,10,22,1,5665,6834,4602,-2232
2017,10,22,2,5227,6395,4436,-1959
2017,10,22,3,4783,5920,4018,-1902
2017,10,22,4,4410,5439,3683,-1756
2017,10,22,5,4083,4933,3435,-1498
2017,10,22,6,3737,4591,3166,-1425
2017,10,22,7,3588,4350,2980,-1370
2017,10,22,8,3479,4190,2877,-1313
2017,10,22,9,3394,4165,2846,-1319
2017,10,22,10,3392,4193,2865,-1328
2017,10,22,11,3489,4361,2985,-1376
2017,10,22,12,3678,4599,3205,-1394
2017,10,22,13,4025,5070,3553,-1517
2017,10,22,14,4709,5788,3846,-1942
2017,10,22,15,5345,6580,4445,-2135
2017,10,22,16,5862,7238,4842,-2396
2017,10,22,17,6176,7821,5259,-2562
2017,10,22,18,6533,8335,5632,-2703
2017,10,22,19,6772,8728,5972,-2756
2017,10,22,20,6895,8846,6063,-2783
2017,10,22,21,6833,8733,5931,-2802
2017,10,22,22,6753,8456,5711,-2745
2017,10,22,23,6601,8148,5491,-2657
2017,10,23,0,6584,8066,5426,-2640
2017,10,23,1,6193,7655,5216,-2439
2017,10,23,2,5695,7097,4986,-2111
2017,10,23,3,5200,6433,4418,-2015
2017,10,23,4,4699,5826,4038,-1788
2017,10,23,5,4230,5362,3693,-1669
2017,10,23,6,3911,5003,3532,-1471
2017,10,23,7,3743,4806,3373,-1433
2017,10,23,8,3640,4681,3291,-1390
2017,10,23,9,3671,4736,3327,-1409
2017,10,23,10,3896,5052,3548,-1504
2017,10,23,11,4328,5639,4016,-1623
2017,10,23,12,4600,5947,4347,-1600
2017,10,23,13,4725,6107,4521,-1586
2017,10,23,14,5094,6410,4585,-1825
2017,10,23,15,5524,6768,4819,-1949
2017,10,23,16,5787,7178,5014,-2164
2017,10,23,17,5988,7548,5253,-2295
2017,10,23,18,6105,7756,5416,-2340
2017,10,23,19,6145,7721,5421,-2300
2017,10,23,20,6070,7627,5353,-2274
2017,10,23,21,5890,7552,5259,-2293
2017,10,23,22,5708,7420,5097,-2323
2017,10,23,23,5557,7279,4979,-2300
2017,10,24,0,5548,7296,4979,-2317
2017,10,24,1,5324,6965,4762,-2203
2017,10,24,2,4981,6474,4550,-1924
2017,10,24,3,4617,5849,4013,-1836
2017,10,24,4,4213,5237,3619,-1618
2017,10,24,5,4064,4789,3270,-1519
2017,10,24,6,3766,4467,3160,-1307
2017,10,24,7,3570,4271,3015,-1256
2017,10,24,8,3461,4160,2929,-1231
2017,10,24,9,3465,4215,2970,-1245
2017,10,24,10,3697,4531,3196,-1335
2017,10,24,11,4111,5138,3682,-1456
2017,10,24,12,4412,5400,4026,-1374
2017,10,24,13,4513,5440,4031,-1409
2017,10,24,14,4789,5687,4053,-1634
2017,10,24,15,5067,5960,4178,-1782
2017,10,24,16,5422,6164,4203,-1961
2017,10,24,17,5547,6326,4254,-2072
2017,10,24,18,5695,6515,4372,-2143
2017,10,24,19,5781,6741,4530,-2211
2017,10,24,20,5728,7098,4859,-2239
2017,10,24,21,5638,7150,4936,-2214
2017,10,24,22,5441,7172,4912,-2260
2017,10,24,23,5306,6837,4698,-2139
2017,10,25,0,5309,6821,4666,-2155
2017,10,25,1,5032,6435,4367,-2068
2017,10,25,2,4717,5847,4024,-1823
2017,10,25,3,4195,5183,3438,-1745
2017,10,25,4,3735,4539,3049,-1490
2017,10,25,5,3319,3974,2849,-1125
2017,10,25,6,3072,3768,2790,-978
2017,10,25,7,2914,3587,2668,-919
2017,10,25,8,2843,3515,2614,-901
2017,10,25,9,2895,3567,2646,-921
2017,10,25,10,3106,3843,2820,-1023
2017,10,25,11,3460,4389,3210,-1179
2017,10,25,12,3692,4648,3534,-1114
2017,10,25,13,3750,4648,3532,-1116
2017,10,25,14,3839,4768,3569,-1199
2017,10,25,15,3978,4942,3690,-1252
2017,10,25,16,4103,5034,3761,-1273
2017,10,25,17,4170,5112,3844,-1268
2017,10,25,18,4260,5198,3904,-1294
2017,10,25,19,4329,5283,3984,-1299
2017,10,25,20,4352,5404,4078,-1326
2017,10,25,21,4331,5504,4156,-1348
2017,10,25,22,4321,5506,4123,-1383
2017,10,25,23,4205,5405,4021,-1384
2017,10,26,0,4339,5598,4141,-1457
2017,10,26,1,4219,5423,3968,-1455
2017,10,26,2,3824,5030,3741,-1289
2017,10,26,3,3443,4512,3372,-1140
2017,10,26,4,3160,4041,3087,-954
2017,10,26,5,2996,3699,2905,-794
2017,10,26,6,2781,3477,2721,-756
2017,10,26,7,2711,3395,2704,-691
2017,10,26,8,2731,3345,2558,-787
2017,10,26,9,2802,3450,2634,-816
2017,10,26,10,3125,3855,2981,-874
2017,10,26,11,3591,4499,3555,-944
2017,10,26,12,3847,4883,3950,-933
2017,10,26,13,3943,4935,3992,-943
2017,10,26,14,3944,4992,3922,-1070
2017,10,26,15,4010,5017,3720,-1297
2017,10,26,16,3981,4979,3549,-1430
2017,10,26,17,4051,4961,3555,-1406
2017,10,26,18,4153,4981,3566,-1415
2017,10,26,19,4287,5043,3624,-1419
2017,10,26,20,4360,5127,3771,-1356
2017,10,26,21,4492,5284,3859,-1425
2017,10,26,22,4506,5348,4018,-1330
2017,10,26,23,4419,5341,3994,-1347
2017,10,27,0,4536,5549,4143,-1406
2017,10,27,1,4397,5395,4036,-1359
2017,10,27,2,4023,5028,3815,-1213
2017,10,27,3,3612,4553,3355,-1198
2017,10,27,4,3326,4066,2993,-1073
2017,10,27,5,2851,3746,2870,-876
2017,10,27,6,2683,3559,2698,-861
2017,10,27,7,2640,3471,2646,-825
2017,10,27,8,2656,3461,2620,-841
2017,10,27,9,2743,3559,2674,-885
2017,10,27,10,3017,3928,2965,-963
2017,10,27,11,3413,4552,3528,-1024
2017,10,27,12,3695,4893,3821,-1072
2017,10,27,13,3828,4946,3951,-995
2017,10,27,14,3859,5012,3882,-1130
2017,10,27,15,3890,5082,3807,-1275
2017,10,27,16,3995,5126,3709,-1417
2017,10,27,17,4057,5212,3808,-1404
2017,10,27,18,4096,5351,3971,-1380
2017,10,27,19,4274,5485,4139,-1346
2017,10,27,20,4421,5698,4342,-1356
2017,10,27,21,4518,5853,4451,-1402
2017,10,27,22,4456,5855,4463,-1392
2017,10,27,23,4414,5666,4300,-1366
2017,10,28,0,4446,5727,4333,-1394
2017,10,28,1,4316,5488,4154,-1334
2017,10,28,2,4014,5134,3940,-1194
2017,10,28,3,3696,4722,3542,-1180
2017,10,28,4,3397,4277,3212,-1065
2017,10,28,5,3038,3909,3106,-803
2017,10,28,6,2809,3665,2922,-743
2017,10,28,7,2680,3495,2777,-718
2017,10,28,8,2585,3397,2684,-713
2017,10,28,9,2596,3402,2683,-719
2017,10,28,10,2611,3503,2740,-763
2017,10,28,11,2651,3742,2909,-833
2017,10,28,12,2821,4053,3204,-849
2017,10,28,13,3042,4446,3489,-957
2017,10,28,14,3528,4832,3780,-1052
2017,10,28,15,3874,5162,4071,-1091
2017,10,28,16,4154,5431,4328,-1103
2017,10,28,17,4289,5668,4542,-1126
2017,10,28,18,4454,5823,4662,-1161
2017,10,28,19,4639,5891,4681,-1210
2017,10,28,20,4852,5896,4641,-1255
2017,10,28,21,5056,5880,4707,-1173
2017,10,28,22,4994,5826,4745,-1081
2017,10,28,23,4755,5771,4717,-1054
2017,10,29,0,4693,5821,4746,-1075
2017,10,29,1,4493,5619,4680,-939
2017,10,29,2,4152,5335,4444,-891
2017,10,29,3,3859,4938,4036,-902
2017,10,29,4,3539,4520,3600,-920
2017,10,29,5,3299,4127,3284,-843
2017,10,29,6,3020,3844,3062,-782
2017,10,29,7,2824,3644,2891,-753
2017,10,29,8,2714,3533,2794,-739
2017,10,29,9,2668,3510,2774,-736
2017,10,29,10,2669,3569,2804,-765
2017,10,29,11,2787,3770,2954,-816
2017,10,29,12,2999,4049,3201,-848
2017,10,29,13,3320,4401,3467,-934
2017,10,29,14,3725,4747,3595,-1152
2017,10,29,15,3948,4963,3661,-1302
2017,10,29,16,4099,5051,3771,-1280
2017,10,29,17,4234,5043,3821,-1222
2017,10,29,18,4291,5004,3793,-1211
2017,10,29,19,4320,4996,3794,-1202
2017,10,29,20,4320,4964,3835,-1129
2017,10,29,21,4298,5013,3873,-1140
2017,10,29,22,4231,4995,3887,-1108
2017,10,29,23,4168,5081,3925,-1156
2017,10,30,0,4293,5393,4152,-1241
2017,10,30,1,4073,5272,4068,-1204
2017,10,30,2,3721,4928,3767,-1161
2017,10,30,3,3318,4498,3311,-1187
2017,10,30,4,2959,4063,2970,-1093
2017,10,30,5,3040,3803,2892,-911
2017,10,30,6,2866,3647,2764,-883
2017,10,30,7,2809,3593,2703,-890
2017,10,30,8,2876,3615,2711,-904
2017,10,30,9,3007,3779,2812,-967
2017,10,30,10,3439,4248,3225,-1023
2017,10,30,11,4105,5057,3841,-1216
2017,10,30,12,4476,5540,4288,-1252
2017,10,30,13,4578,5646,4366,-1280
2017,10,30,14,4497,5585,4342,-1243
2017,10,30,15,4311,5452,4303,-1149
2017,10,30,16,4199,5289,4052,-1237
2017,10,30,17,4155,5132,3909,-1223
2017,10,30,18,4097,4987,3806,-1181
2017,10,30,19,4050,4911,3761,-1150
2017,10,30,20,4063,4927,3773,-1154
2017,10,30,21,4021,4990,3803,-1187
2017,10,30,22,4032,5102,3974,-1128
2017,10,30,23,4105,5255,4104,-1151
2017,10,31,0,4564,5623,4287,-1336
2017,10,31,1,4383,5525,4258,-1267
2017,10,31,2,4107,5226,4090,-1136
2017,10,31,3,3735,6482,5379,-1103
2017,10,31,4,3476,4354,3322,-1032
2017,10,31,5,3216,4084,3003,-1081
2017,10,31,6,3055,3939,2857,-1082
2017,10,31,7,3007,3912,2821,-1091
2017,10,31,8,3098,3933,2825,-1108
2017,10,31,9,3236,4110,2965,-1145
2017,10,31,10,3622,4604,3390,-1214
2017,10,31,11,4103,5391,4063,-1328
2017,10,31,12,4453,5804,4436,-1368
2017,10,31,13,4484,5775,4418,-1357
2017,10,31,14,4320,5561,4308,-1253
2017,10,31,15,4161,5348,4162,-1186
2017,10,31,16,4042,5161,3947,-1214
2017,10,31,17,3979,5076,3890,-1186
2017,10,31,18,3974,5037,3864,-1173
2017,10,31,19,4004,5035,3871,-1164
2017,10,31,20,4101,5122,3930,-1192
2017,10,31,21,4183,5247,4002,-1245
2017,10,31,22,4265,5291,4041,-1250
2017,10,31,23,4295,5142,3940,-1202
2017,11,1,0,4309,5135,3816,-1319
2017,11,1,1,4232,5044,3850,-1194
2017,11,1,2,4029,4933,3804,-1129
2017,11,1,3,3621,4549,3488,-1061
2017,11,1,4,3316,4076,3052,-1024
2017,11,1,5,3030,3733,2771,-962
2017,11,1,6,2749,3573,2730,-843
2017,11,1,7,2638,3488,2652,-836
2017,11,1,8,2628,3508,2665,-843
2017,11,1,9,2712,3646,2743,-903
2017,11,1,10,3007,4018,2997,-1021
2017,11,1,11,3461,4672,3463,-1209
2017,11,1,12,3774,5039,3931,-1108
2017,11,1,13,3829,5063,3952,-1111
2017,11,1,14,3923,5064,3892,-1172
2017,11,1,15,3968,5122,3930,-1192
2017,11,1,16,4045,5171,3975,-1196
2017,11,1,17,4075,5252,4064,-1188
2017,11,1,18,4209,5394,4236,-1158
2017,11,1,19,4372,5513,4382,-1131
2017,11,1,20,4542,5704,4683,-1021
2017,11,1,21,4646,5854,4752,-1102
2017,11,1,22,4617,5920,4766,-1154
2017,11,1,23,4595,5878,4634,-1244
2017,11,2,0,4740,6047,4782,-1265
2017,11,2,1,4569,5801,4602,-1199
2017,11,2,2,4267,5318,4263,-1055
2017,11,2,3,3789,4745,3806,-939
2017,11,2,4,3436,4198,3266,-932
2017,11,2,5,3060,3755,2874,-881
2017,11,2,6,2822,3543,2782,-761
2017,11,2,7,2716,3451,2703,-748
2017,11,2,8,2685,3399,2656,-743
2017,11,2,9,2744,3470,2696,-774
2017,11,2,10,2992,3832,2936,-896
2017,11,2,11,3430,4429,3378,-1051
2017,11,2,12,3739,4787,3783,-1004
2017,11,2,13,3805,4842,3840,-1002
2017,11,2,14,3972,4981,3847,-1134
2017,11,2,15,4108,5190,4023,-1167
2017,11,2,16,4360,5437,4238,-1199
2017,11,2,17,4456,5685,4444,-1241
2017,11,2,18,4559,5933,4646,-1287
2017,11,2,19,4777,6190,4942,-1248
2017,11,2,20,4944,6442,5170,-1272
2017,11,2,21,4945,6640,5371,-1269
2017,11,2,22,4920,6614,5345,-1269
2017,11,2,23,4782,6406,5154,-1252
2017,11,3,0,4887,6498,5227,-1271
2017,11,3,1,4689,6173,4886,-1287
2017,11,3,2,4380,5681,4431,-1250
2017,11,3,3,3964,5042,3873,-1169
2017,11,3,4,3541,4458,3402,-1056
2017,11,3,5,3245,3992,3161,-831
2017,11,3,6,2986,3706,2915,-791
2017,11,3,7,2848,3546,2817,-729
2017,11,3,8,2772,3475,2752,-723
2017,11,3,9,2825,3523,2783,-740
2017,11,3,10,3035,3835,2994,-841
2017,11,3,11,3454,4410,3439,-971
2017,11,3,12,3726,4766,3811,-955
2017,11,3,13,3822,4908,3967,-941
2017,11,3,14,4087,5136,4040,-1096
2017,11,3,15,4292,5448,4358,-1090
2017,11,3,16,4547,5723,4652,-1071
2017,11,3,17,4781,5967,4767,-1200
2017,11,3,18,4995,6218,4935,-1283
2017,11,3,19,5177,6436,5095,-1341
2017,11,3,20,5385,6649,5234,-1415
2017,11,3,21,5467,6800,5352,-1448
2017,11,3,22,5353,6695,5246,-1449
2017,11,3,23,5091,6398,5023,-1375
2017,11,4,0,4964,6346,4982,-1364
2017,11,4,1,4750,6012,4798,-1214
2017,11,4,2,4486,5557,4397,-1160
2017,11,4,3,4108,5087,3978,-1109
2017,11,4,4,3711,4575,3484,-1091
2017,11,4,5,3554,4123,3229,-894
2017,11,4,6,3295,3810,3039,-771
2017,11,4,7,3100,3611,2858,-753
2017,11,4,8,2964,3506,2790,-716
2017,11,4,9,2915,3480,2756,-724
2017,11,4,10,2949,3584,2832,-752
2017,11,4,11,3036,3840,3020,-820
2017,11,4,12,3256,4131,3280,-851
2017,11,4,13,3591,4544,3588,-956
2017,11,4,14,4081,4994,3825,-1169
2017,11,4,15,4457,5362,4068,-1294
2017,11,4,16,4829,5682,4272,-1410
2017,11,4,17,5128,6012,4466,-1546
2017,11,4,18,5340,6353,4715,-1638
2017,11,4,19,5481,6681,4941,-1740
2017,11,4,20,5604,6923,5163,-1760
2017,11,4,21,5708,6970,5251,-1719
2017,11,4,22,5633,6820,5073,-1747
2017,11,4,23,5460,6450,4746,-1704
2017,11,5,0,5225,6334,4556,-1778
2017,11,5,1,4845,5971,4286,-1685
2017,11,5,2,4593,5520,3953,-1567
2017,11,5,3,4168,5037,3562,-1475
2017,11,5,4,3763,4593,3330,-1263
2017,11,5,5,3330,4187,3116,-1071
2017,11,5,6,3063,3847,2840,-1007
2017,11,5,7,3063,3642,2737,-905
2017,11,5,8,2911,3488,2605,-883
2017,11,5,9,2779,3441,2567,-874
2017,11,5,10,2769,3472,2594,-878
2017,11,5,11,2802,3578,2665,-913
2017,11,5,12,2894,3816,2831,-985
2017,11,5,13,3150,4223,3191,-1032
2017,11,5,14,3600,4784,3544,-1240
2017,11,5,15,4072,5243,3797,-1446
2017,11,5,16,4451,5550,3943,-1607
2017,11,5,17,4771,5891,4170,-1721
2017,11,5,18,5107,6269,4529,-1740
2017,11,5,19,5319,6615,4808,-1807
2017,11,5,20,5521,6844,4921,-1923
2017,11,5,21,5530,6922,4970,-1952
2017,11,5,22,5390,6857,4910,-1947
2017,11,5,23,5258,6719,4715,-2004
2017,11,6,0,5225,6797,4681,-2116
2017,11,6,1,5055,6496,4467,-2029
2017,11,6,2,4691,6035,4003,-2032
2017,11,6,3,4285,5525,3707,-1818
2017,11,6,4,3864,4975,3289,-1686
2017,11,6,5,3526,4452,3042,-1410
2017,11,6,6,3213,4071,2912,-1159
2017,11,6,7,3004,3851,2743,-1108
2017,11,6,8,2881,3735,2641,-1094
2017,11,6,9,2890,3678,2591,-1087
2017,11,6,10,2994,3801,2681,-1120
2017,11,6,11,3176,4179,2965,-1214
2017,11,6,12,3622,4806,3494,-1312
2017,11,6,13,3914,5134,3820,-1314
2017,11,6,14,4225,5357,3988,-1369
2017,11,6,15,4544,5595,4043,-1552
2017,11,6,16,4863,5968,4411,-1557
2017,11,6,17,5270,6457,4842,-1615
2017,11,6,18,5549,6920,5277,-1643
2017,11,6,19,5799,7251,5689,-1562
2017,11,6,20,5917,7470,5964,-1506
2017,11,6,21,5955,7260,5718,-1542
2017,11,6,22,5906,7468,5932,-1536
2017,11,6,23,5775,7246,5747,-1499
2017,11,7,0,5739,7284,5711,-1573
2017,11,7,1,5518,6931,5390,-1541
2017,11,7,2,5180,6446,4915,-1531
2017,11,7,3,4680,5858,4364,-1494
2017,11,7,4,4212,5221,3818,-1403
2017,11,7,5,3730,4620,3325,-1295
2017,11,7,6,3375,4186,3176,-1010
2017,11,7,7,3145,3889,2960,-929
2017,11,7,8,2987,3702,2822,-880
2017,11,7,9,2977,3625,2728,-897
2017,11,7,10,3032,3707,2779,-928
2017,11,7,11,3232,4044,3056,-988
2017,11,7,12,3627,4670,3533,-1137
2017,11,7,13,3916,4970,3720,-1250
2017,11,7,14,4243,5253,3897,-1356
2017,11,7,15,4681,5611,4055,-1556
2017,11,7,16,5073,6133,4375,-1758
2017,11,7,17,5412,6311,4452,-1859
2017,11,7,18,5779,6907,4956,-1951
2017,11,7,19,5987,7286,5279,-2007
2017,11,7,20,6117,7543,5535,-2008
2017,11,7,21,6087,7648,5691,-1957
2017,11,7,22,6104,7537,5611,-1926
2017,11,7,23,5911,7268,5361,-1907
2017,11,8,0,5889,7209,5313,-1896
2017,11,8,1,5577,6828,4830,-1998
2017,11,8,2,5253,6362,4391,-1971
2017,11,8,3,4712,5786,3951,-1835
2017,11,8,4,4269,5137,3362,-1775
2017,11,8,5,3810,4556,3095,-1461
2017,11,8,6,3396,4121,3004,-1117
2017,11,8,7,3168,3839,2863,-976
2017,11,8,8,3020,3698,2763,-935
2017,11,8,9,2997,3620,2696,-924
2017,11,8,10,3016,3668,2727,-941
2017,11,8,11,3227,3991,2936,-1055
2017,11,8,12,3660,4568,3392,-1176
2017,11,8,13,3927,4877,3467,-1410
2017,11,8,14,4211,5164,3681,-1483
2017,11,8,15,4605,5506,3881,-1625
2017,11,8,16,5013,5922,4086,-1836
2017,11,8,17,5380,6372,4416,-1956
2017,11,8,18,5718,6825,4822,-2003
2017,11,8,19,5951,7163,5073,-2090
2017,11,8,20,6068,7346,5201,-2145
2017,11,8,21,6120,7359,5206,-2153
2017,11,8,22,6062,7211,5105,-2106
2017,11,8,23,5880,7056,4954,-2102
2017,11,9,0,5859,7088,4954,-2134
2017,11,9,1,5579,6765,4659,-2106
2017,11,9,2,5225,6298,4171,-2127
2017,11,9,3,4741,5778,3808,-1970
2017,11,9,4,4249,5152,3305,-1847
2017,11,9,5,3809,4594,3094,-1500
2017,11,9,6,3389,4153,2906,-1247
2017,11,9,7,3156,3879,2708,-1171
2017,11,9,8,3016,3729,2586,-1143
2017,11,9,9,2962,3658,2520,-1138
2017,11,9,10,2998,3708,2555,-1153
2017,11,9,11,3234,4006,2751,-1255
2017,11,9,12,3674,4599,3237,-1362
2017,11,9,13,3932,4887,3364,-1523
2017,11,9,14,4174,5156,3579,-1577
2017,11,9,15,4526,5505,3725,-1780
2017,11,9,16,4902,5958,4101,-1857
2017,11,9,17,5144,6378,4332,-2046
2017,11,9,18,5464,6787,4669,-2118
2017,11,9,19,5696,7057,4864,-2193
2017,11,9,20,5768,7167,4959,-2208
2017,11,9,21,5798,7098,4922,-2176
2017,11,9,22,5744,6956,4789,-2167
2017,11,9,23,5619,6882,4646,-2236
2017,11,10,0,5535,6973,4649,-2324
2017,11,10,1,5288,6664,4367,-2297
2017,11,10,2,4973,6288,4081,-2207
2017,11,10,3,4533,5766,3762,-2004
2017,11,10,4,4090,5208,3314,-1894
2017,11,10,5,3648,4429,2886,-1543
2017,11,10,6,3265,4226,2952,-1274
2017,11,10,7,3040,3964,2742,-1222
2017,11,10,8,2895,3829,2630,-1199
2017,11,10,9,2815,3747,2557,-1190
2017,11,10,10,2822,3777,2559,-1218
2017,11,10,11,3053,4014,2755,-1259
2017,11,10,12,3377,4560,3175,-1385
2017,11,10,13,3657,4865,3175,-1690
2017,11,10,14,3980,5111,3356,-1755
2017,11,10,15,4295,5313,3404,-1909
2017,11,10,16,4585,5462,3571,-1891
2017,11,10,17,4773,5518,3470,-2048
2017,11,10,18,4975,5553,3441,-2112
2017,11,10,19,5135,5605,3401,-2204
2017,11,10,20,5142,5632,3412,-2220
2017,11,10,21,5105,5590,3441,-2149
2017,11,10,22,5044,5551,3406,-2145
2017,11,10,23,4887,5650,3462,-2188
2017,11,11,0,4925,5764,3551,-2213
2017,11,11,1,4613,5539,3366,-2173
2017,11,11,2,4339,5286,3182,-2104
2017,11,11,3,4034,4941,3031,-1910
2017,11,11,4,3767,4575,2737,-1838
2017,11,11,5,3509,4220,2688,-1532
2017,11,11,6,3118,3877,2573,-1304
2017,11,11,7,2903,3659,2417,-1242
2017,11,11,8,2773,3526,2330,-1196
2017,11,11,9,2721,3465,2308,-1157
2017,11,11,10,2717,3509,2325,-1184
2017,11,11,11,2762,3611,2396,-1215
2017,11,11,12,2908,3864,2573,-1291
2017,11,11,13,3110,4248,2900,-1348
2017,11,11,14,3583,4754,3340,-1414
2017,11,11,15,3938,5135,3674,-1461
2017,11,11,16,4239,5423,3950,-1473
2017,11,11,17,4466,5605,3994,-1611
2017,11,11,18,4666,5775,3948,-1827
2017,11,11,19,4828,5902,3976,-1926
2017,11,11,20,4910,5980,4074,-1906
2017,11,11,21,4838,5952,4062,-1890
2017,11,11,22,4697,5875,3997,-1878
2017,11,11,23,4625,5892,3966,-1926
2017,11,12,0,4711,6011,4059,-1952
2017,11,12,1,4463,5802,3880,-1922
2017,11,12,2,4175,5557,3715,-1842
2017,11,12,3,3937,5241,3662,-1579
2017,11,12,4,3671,4881,3388,-1493
2017,11,12,5,3394,4487,3147,-1340
2017,11,12,6,3092,4132,2998,-1134
2017,11,12,7,2893,3859,2891,-968
2017,11,12,8,2756,3710,2752,-958
2017,11,12,9,2693,3621,2691,-930
2017,11,12,10,2684,3621,2686,-935
2017,11,12,11,2693,3691,2721,-970
2017,11,12,12,2794,3884,2842,-1042
2017,11,12,13,2968,4199,3121,-1078
2017,11,12,14,3418,4766,3490,-1276
2017,11,12,15,3904,5259,3639,-1620
2017,11,12,16,4250,5581,3899,-1682
2017,11,12,17,4590,5811,3817,-1994
2017,11,12,18,4768,5995,3948,-2047
2017,11,12,19,4908,5995,3898,-2097
2017,11,12,20,5007,5943,3852,-2091
2017,11,12,21,4971,5898,3832,-2066
2017,11,12,22,4952,5883,3820,-2063
2017,11,12,23,4810,6071,3950,-2121
2017,11,13,0,4971,6319,4145,-2174
2017,11,13,1,4851,6139,4038,-2101
2017,11,13,2,4561,5838,3834,-2004
2017,11,13,3,4181,5392,3677,-1715
2017,11,13,4,3814,4891,3301,-1590
2017,11,13,5,3460,4379,2971,-1408
2017,11,13,6,3177,3998,2905,-1093
2017,11,13,7,2982,3750,2813,-937
2017,11,13,8,2824,3597,2687,-910
2017,11,13,9,2760,3568,2662,-906
2017,11,13,10,2811,3647,2714,-933
2017,11,13,11,3066,4007,2978,-1029
2017,11,13,12,3547,4643,3465,-1178
2017,11,13,13,3811,5003,3749,-1254
2017,11,13,14,4031,5257,3862,-1395
2017,11,13,15,4274,5616,3934,-1682
2017,11,13,16,4518,5998,4238,-1760
2017,11,13,17,4699,6350,4388,-1962
2017,11,13,18,4854,6662,4708,-1954
2017,11,13,19,4987,6879,4878,-2001
2017,11,13,20,4990,6959,4861,-2098
2017,11,13,21,4963,6949,4996,-1953
2017,11,13,22,4932,6773,4772,-2001
2017,11,13,23,4884,6669,4683,-1986
2017,11,14,0,5054,6823,4760,-2063
2017,11,14,1,4895,6546,4552,-1994
2017,11,14,2,4629,6158,4199,-1959
2017,11,14,3,4236,5622,3777,-1845
2017,11,14,4,3805,5002,3254,-1748
2017,11,14,5,3387,4456,2985,-1471
2017,11,14,6,3167,4048,2948,-1100
2017,11,14,7,2942,3793,2823,-970
2017,11,14,8,2816,3632,2686,-946
2017,11,14,9,2763,3555,2625,-930
2017,11,14,10,2787,3643,2666,-977
2017,11,14,11,3062,3982,2950,-1032
2017,11,14,12,3544,4565,3407,-1158
2017,11,14,13,3778,4871,3667,-1204
2017,11,14,14,3968,5088,3796,-1292
2017,11,14,15,4085,5373,3819,-1554
2017,11,14,16,4278,5635,4029,-1606
2017,11,14,17,4454,5876,4067,-1809
2017,11,14,18,4623,6130,4244,-1886
2017,11,14,19,4733,6301,4384,-1917
2017,11,14,20,4726,6377,4436,-1941
2017,11,14,21,4724,6285,4374,-1911
2017,11,14,22,4698,6198,4274,-1924
2017,11,14,23,4747,6203,4264,-1939
2017,11,15,0,4918,6364,4356,-2008
2017,11,15,1,4729,6153,4189,-1964
2017,11,15,2,4446,5803,3871,-1932
2017,11,15,3,4081,5334,3733,-1601
2017,11,15,4,3643,4717,3291,-1426
2017,11,15,5,3254,4201,2972,-1229
2017,11,15,6,2988,3844,2984,-860
2017,11,15,7,2812,3625,2831,-794
2017,11,15,8,2712,3528,2732,-796
2017,11,15,9,2651,3531,2738,-793
2017,11,15,10,2716,3622,2784,-838
2017,11,15,11,2957,3998,3051,-947
2017,11,15,12,3434,4651,3591,-1060
2017,11,15,13,3689,4980,3957,-1023
2017,11,15,14,3876,5075,3907,-1168
2017,11,15,15,3972,5145,3813,-1332
2017,11,15,16,4129,5238,3916,-1322
2017,11,15,17,4241,5362,4074,-1288
2017,11,15,18,4355,5490,4237,-1253
2017,11,15,19,4480,5630,4351,-1279
2017,11,15,20,4501,5738,4437,-1301
2017,11,15,21,4518,5765,4444,-1321
2017,11,15,22,4516,5731,4166,-1565
2017,11,15,23,4615,5799,4164,-1635
2017,11,16,0,4737,6042,4325,-1717
2017,11,16,1,4549,5889,4198,-1691
2017,11,16,2,4293,5616,4084,-1532
2017,11,16,3,3971,5232,3898,-1334
2017,11,16,4,3588,4697,3361,-1336
2017,11,16,5,3237,4206,2882,-1324
2017,11,16,6,2969,3863,2755,-1108
2017,11,16,7,2784,3669,2684,-985
2017,11,16,8,2730,3570,2591,-979
2017,11,16,9,2691,3560,2571,-989
2017,11,16,10,2765,3661,2636,-1025
2017,11,16,11,3024,4040,2949,-1091
2017,11,16,12,3502,4674,3522,-1152
2017,11,16,13,3754,4967,3555,-1412
2017,11,16,14,3932,5054,3633,-1421
2017,11,16,15,4065,5139,3563,-1576
2017,11,16,16,4210,5260,3639,-1621
2017,11,16,17,4255,5329,3718,-1611
2017,11,16,18,4342,5453,3666,-1787
2017,11,16,19,4432,5531,3745,-1786
2017,11,16,20,4459,5624,3797,-1827
2017,11,16,21,4451,5641,3831,-1810
2017,11,16,22,4484,5613,3816,-1797
2017,11,16,23,4574,5667,3789,-1878
2017,11,17,0,4693,5893,3924,-1969
2017,11,17,1,4524,5720,3798,-1922
2017,11,17,2,4291,5488,3738,-1750
2017,11,17,3,3994,5110,3459,-1651
2017,11,17,4,3613,4629,3110,-1519
2017,11,17,5,3275,4154,2931,-1223
2017,11,17,6,2978,3850,2891,-959
2017,11,17,7,2796,3672,2825,-847
2017,11,17,8,2706,3589,2746,-843
2017,11,17,9,2672,3599,2728,-871
2017,11,17,10,2777,3703,2793,-910
2017,11,17,11,3054,4098,3060,-1038
2017,11,17,12,3549,4788,3534,-1254
2017,11,17,13,3799,5123,3752,-1371
2017,11,17,14,3957,5161,3889,-1272
2017,11,17,15,4077,5163,3801,-1362
2017,11,17,16,4220,5184,3768,-1416
2017,11,17,17,4263,5258,3780,-1478
2017,11,17,18,4329,5340,3700,-1640
2017,11,17,19,4426,5473,3843,-1630
2017,11,17,20,4450,5589,3953,-1636
2017,11,17,21,4471,5650,4013,-1637
2017,11,17,22,4456,5631,4024,-1607
2017,11,17,23,4501,5620,4018,-1602
2017,11,18,0,4613,5719,4055,-1664
2017,11,18,1,4433,5510,3732,-1778
2017,11,18,2,4204,5265,3459,-1806
2017,11,18,3,3950,4947,3226,-1721
2017,11,18,4,3614,4587,2938,-1649
2017,11,18,5,3315,4200,2963,-1237
2017,11,18,6,3013,3858,2722,-1136
2017,11,18,7,2829,3664,2652,-1012
2017,11,18,8,2721,3554,2704,-850
2017,11,18,9,2658,3537,2687,-850
2017,11,18,10,2670,3595,2705,-890
2017,11,18,11,2735,3735,2803,-932
2017,11,18,12,2892,4035,3008,-1027
2017,11,18,13,3130,4409,3409,-1000
2017,11,18,14,3550,4834,3822,-1012
2017,11,18,15,3884,5063,3760,-1303
2017,11,18,16,4096,5164,3710,-1454
2017,11,18,17,4289,5280,3606,-1674
2017,11,18,18,4409,5434,3612,-1822
2017,11,18,19,4539,5565,3657,-1908
2017,11,18,20,4647,5712,3764,-1948
2017,11,18,21,4693,5800,3836,-1964
2017,11,18,22,4616,5773,3819,-1954
2017,11,18,23,4549,5698,3752,-1946
2017,11,19,0,4693,5746,3781,-1965
2017,11,19,1,4462,5478,3577,-1901
2017,11,19,2,4214,5189,3362,-1827
2017,11,19,3,3978,4874,3218,-1656
2017,11,19,4,3661,4516,2872,-1644
2017,11,19,5,3269,4128,2625,-1503
2017,11,19,6,3018,3790,2582,-1208
2017,11,19,7,2799,3564,2613,-951
2017,11,19,8,2706,3438,2673,-765
2017,11,19,9,2636,3383,2632,-751
2017,11,19,10,2613,3395,2638,-757
2017,11,19,11,2616,3497,2716,-781
2017,11,19,12,2678,3690,2819,-871
2017,11,19,13,2915,4022,3112,-910
2017,11,19,14,3326,4552,3526,-1026
2017,11,19,15,3649,5010,3702,-1308
2017,11,19,16,3905,5292,3830,-1462
2017,11,19,17,4023,5493,3935,-1558
2017,11,19,18,4113,5617,4123,-1494
2017,11,19,19,4162,5534,4129,-1405
2017,11,19,20,4166,5478,4065,-1413
2017,11,19,21,4130,5420,3997,-1423
2017,11,19,22,4082,5429,3942,-1487
2017,11,19,23,4160,5587,4026,-1561
2017,11,20,0,4324,5809,4164,-1645
2017,11,20,1,4138,5610,4000,-1610
2017,11,20,2,3945,5338,3870,-1468
2017,11,20,3,3599,4956,3771,-1185
2017,11,20,4,3299,4536,3351,-1185
2017,11,20,5,3057,4105,3107,-998
2017,11,20,6,2881,3821,2899,-922
2017,11,20,7,2674,3649,2745,-904
2017,11,20,8,2635,3598,2699,-899
2017,11,20,9,2652,3650,2705,-945
2017,11,20,10,2765,3819,2824,-995
2017,11,20,11,3069,4256,3005,-1251
2017,11,20,12,3656,4912,3220,-1692
2017,11,20,13,4024,5340,3531,-1809
2017,11,20,14,4131,5510,3705,-1805
2017,11,20,15,4119,5459,3705,-1754
2017,11,20,16,4137,5385,3623,-1762
2017,11,20,17,4112,5302,3564,-1738
2017,11,20,18,4103,5288,3586,-1702
2017,11,20,19,4099,5309,3621,-1688
2017,11,20,20,4076,5327,3627,-1700
2017,11,20,21,4042,5354,3651,-1703
2017,11,20,22,4126,5391,3712,-1679
2017,11,20,23,4322,5542,3891,-1651
2017,11,21,0,4572,5848,4159,-1689
2017,11,21,1,4486,5710,4044,-1666
2017,11,21,2,4351,5452,3921,-1531
2017,11,21,3,4070,5103,3743,-1360
2017,11,21,4,3709,4646,3281,-1365
2017,11,21,5,3312,4205,3100,-1105
2017,11,21,6,3016,3851,2830,-1021
2017,11,21,7,2860,3662,2688,-974
2017,11,21,8,2777,3548,2591,-957
2017,11,21,9,2769,3491,2534,-957
2017,11,21,10,2951,3591,2582,-1009
2017,11,21,11,3333,3854,2596,-1258
2017,11,21,12,3804,4314,2815,-1499
2017,11,21,13,4147,4622,3055,-1567
2017,11,21,14,4125,4901,3332,-1569
2017,11,21,15,4122,5111,3548,-1563
2017,11,21,16,4114,5287,3707,-1580
2017,11,21,17,4148,5420,3824,-1596
2017,11,21,18,4164,5485,3861,-1624
2017,11,21,19,4164,5475,3949,-1526
2017,11,21,20,4160,5428,3911,-1517
2017,11,21,21,4132,5395,3869,-1526
2017,11,21,22,4123,5414,3901,-1513
2017,11,21,23,4307,5628,4025,-1603
2017,11,22,0,4514,5897,4206,-1691
2017,11,22,1,4395,5729,4080,-1649
2017,11,22,2,4224,5468,3880,-1588
2017,11,22,3,3980,5149,3716,-1433
2017,11,22,4,3672,4746,3299,-1447
2017,11,22,5,3327,4300,2882,-1418
2017,11,22,6,3004,3897,2758,-1139
2017,11,22,7,2789,3684,2748,-936
2017,11,22,8,2688,3548,2635,-913
2017,11,22,9,2652,3507,2611,-896
2017,11,22,10,2754,3571,2643,-928
2017,11,22,11,2922,3790,2795,-995
2017,11,22,12,3264,4205,3088,-1117
2017,11,22,13,3508,4542,3212,-1330
2017,11,22,14,3785,4887,3273,-1614
2017,11,22,15,4044,5202,3395,-1807
2017,11,22,16,4271,5497,3665,-1832
2017,11,22,17,4469,5757,3808,-1949
2017,11,22,18,4528,6003,3898,-2105
2017,11,22,19,4637,6194,4064,-2130
2017,11,22,20,4647,6282,4119,-2163
2017,11,22,21,4621,6226,4094,-2132
2017,11,22,22,4526,6101,4013,-2088
2017,11,22,23,4592,6148,4055,-2093
2017,11,23,0,4746,6252,4108,-2144
2017,11,23,1,4593,6011,3928,-2083
2017,11,23,2,4368,5738,3753,-1985
2017,11,23,3,4092,5420,3543,-1877
2017,11,23,4,3759,5016,3181,-1835
2017,11,23,5,3399,4571,2988,-1583
2017,11,23,6,3220,4218,2966,-1252
2017,11,23,7,2998,3931,2943,-988
2017,11,23,8,2848,3710,2781,-929
2017,11,23,9,2714,3636,2730,-906
2017,11,23,10,2726,3616,2703,-913
2017,11,23,11,2763,3708,2765,-943
2017,11,23,12,2888,3953,2847,-1106
2017,11,23,13,3078,4321,3034,-1287
2017,11,23,14,3521,4978,3237,-1741
2017,11,23,15,4116,5649,3559,-2090
2017,11,23,16,4493,6137,3972,-2165
2017,11,23,17,4732,6447,4189,-2258
2017,11,23,18,4809,6510,4236,-2274
2017,11,23,19,4662,6365,4183,-2182
2017,11,23,20,4534,6116,4037,-2079
2017,11,23,21,4318,5812,3816,-1996
2017,11,23,22,4108,5478,3576,-1902
2017,11,23,23,4013,5342,3448,-1894
2017,11,24,0,4028,5289,3574,-1715
2017,11,24,1,3859,5135,3689,-1446
2017,11,24,2,3688,4968,3730,-1238
2017,11,24,3,3589,4794,3610,-1184
2017,11,24,4,3442,4511,3376,-1135
2017,11,24,5,3148,4208,3081,-1127
2017,11,24,6,2864,3852,2865,-987
2017,11,24,7,2691,3630,2839,-791
2017,11,24,8,2547,3466,2720,-746
2017,11,24,9,2507,3414,2655,-759
2017,11,24,10,2546,3450,2686,-764
2017,11,24,11,2627,3594,2795,-799
2017,11,24,12,2766,3815,2938,-877
2017,11,24,13,2941,4078,2974,-1104
2017,11,24,14,3313,4477,2994,-1483
2017,11,24,15,3641,4814,3202,-1612
2017,11,24,16,3893,5013,3386,-1627
2017,11,24,17,3980,5048,3443,-1605
2017,11,24,18,4108,5035,3440,-1595
2017,11,24,19,4175,4960,3396,-1564
2017,11,24,20,4153,4889,3340,-1549
2017,11,24,21,4062,4859,3312,-1547
2017,11,24,22,3987,4873,3309,-1564
2017,11,24,23,4051,5082,3468,-1614
2017,11,25,0,4048,5266,3589,-1677
2017,11,25,1,3844,5129,3488,-1641
2017,11,25,2,3712,4963,3352,-1611
2017,11,25,3,3524,4743,3181,-1562
2017,11,25,4,3366,4443,2953,-1490
2017,11,25,5,3176,4110,2637,-1473
2017,11,25,6,2916,3818,2611,-1207
2017,11,25,7,2702,3616,2731,-885
2017,11,25,8,2635,3506,2671,-835
2017,11,25,9,2555,3443,2613,-830
2017,11,25,10,2501,3484,2620,-864
2017,11,25,11,2535,3620,2710,-910
2017,11,25,12,2776,3824,2826,-998
2017,11,25,13,2984,4322,3075,-1247
2017,11,25,14,3353,4666,3096,-1570
2017,11,25,15,3646,0,3096,-1597
2017,11,25,16,3809,5071,3487,-1584
2017,11,25,17,3891,5018,3494,-1524
2017,11,25,18,3964,5048,3541,-1507
2017,11,25,19,3996,5086,3585,-1501
2017,11,25,20,3987,5087,3616,-1471
2017,11,25,21,4022,5093,3398,-1695
2017,11,25,22,3990,5079,3344,-1735
2017,11,25,23,4074,5183,3406,-1777
2017,11,26,0,4145,5365,3547,-1818
2017,11,26,1,3981,5219,3432,-1787
2017,11,26,2,3797,4999,3251,-1748
2017,11,26,3,3553,4763,3196,-1567
2017,11,26,4,3342,4451,2946,-1505
2017,11,26,5,3041,4101,2634,-1467
2017,11,26,6,2824,3785,2600,-1185
2017,11,26,7,2747,3588,2592,-996
2017,11,26,8,2721,3463,2504,-959
2017,11,26,9,2680,3426,2463,-963
2017,11,26,10,2690,3450,2461,-989
2017,11,26,11,2778,3573,2470,-1103
2017,11,26,12,3006,3807,2611,-1196
2017,11,26,13,3225,4151,2752,-1399
2017,11,26,14,3502,4577,2930,-1647
2017,11,26,15,3728,4948,3148,-1800
2017,11,26,16,3868,4965,3193,-1772
2017,11,26,17,3935,5045,3280,-1765
2017,11,26,18,4006,5137,3367,-1770
2017,11,26,19,4027,5223,3451,-1772
2017,11,26,20,4056,5266,3501,-1765
2017,11,26,21,4060,5250,3494,-1756
2017,11,26,22,4102,5245,3481,-1764
2017,11,26,23,4255,5407,3590,-1817
2017,11,27,0,4394,5718,3810,-1908
2017,11,27,1,4284,5558,3679,-1879
2017,11,27,2,4038,5279,3467,-1812
2017,11,27,3,3707,4943,3335,-1608
2017,11,27,4,3389,4527,2990,-1537
2017,11,27,5,3043,4092,2761,-1331
2017,11,27,6,2744,3775,2711,-1064
2017,11,27,7,2619,3605,2564,-1041
2017,11,27,8,2588,3508,2483,-1025
2017,11,27,9,2599,3516,2485,-1031
2017,11,27,10,2685,3667,2581,-1086
2017,11,27,11,2982,4141,2849,-1292
2017,11,27,12,3513,4881,3394,-1487
2017,11,27,13,3731,5236,3636,-1600
2017,11,27,14,3866,5297,3565,-1732
2017,11,27,15,3947,5246,3568,-1678
2017,11,27,16,4002,5254,3634,-1620
2017,11,27,17,4128,5253,3658,-1595
2017,11,27,18,4172,5296,3707,-1589
2017,11,27,19,4212,5359,3772,-1587
2017,11,27,20,4260,5443,3847,-1596
2017,11,27,21,4288,5490,3843,-1647
2017,11,27,22,4363,5563,3883,-1680
2017,11,27,23,4500,5762,4008,-1754
2017,11,28,0,4698,6124,4268,-1856
2017,11,28,1,4631,5960,4135,-1825
2017,11,28,2,4382,5678,3895,-1783
2017,11,28,3,4026,5301,3599,-1702
2017,11,28,4,3649,4757,3309,-1448
2017,11,28,5,3284,4244,3015,-1229
2017,11,28,6,2970,3911,2831,-1080
2017,11,28,7,2781,3678,2642,-1036
2017,11,28,8,2661,3565,2548,-1017
2017,11,28,9,2616,3559,2531,-1028
2017,11,28,10,2693,3656,2592,-1064
2017,11,28,11,2949,4023,2812,-1211
2017,11,28,12,3397,4658,3271,-1387
2017,11,28,13,3633,4952,3486,-1466
2017,11,28,14,3805,5035,3441,-1594
2017,11,28,15,3972,5172,3612,-1560
2017,11,28,16,4121,5354,3799,-1555
2017,11,28,17,4274,5525,3976,-1549
2017,11,28,18,4420,5697,4131,-1566
2017,11,28,19,4524,5844,4258,-1586
2017,11,28,20,4646,5987,4359,-1628
2017,11,28,21,4674,6061,4372,-1689
2017,11,28,22,4621,6101,4374,-1727
2017,11,28,23,4682,6238,4614,-1624
2017,11,29,0,4874,6535,4880,-1655
2017,11,29,1,4790,6355,4650,-1705
2017,11,29,2,4600,6060,4333,-1727
2017,11,29,3,4227,5605,3989,-1616
2017,11,29,4,3836,5024,3652,-1372
2017,11,29,5,3425,4446,3281,-1165
2017,11,29,6,3104,4037,3012,-1025
2017,11,29,7,2911,3772,2797,-975
2017,11,29,8,2802,3618,2691,-927
2017,11,29,9,2764,3556,2631,-925
2017,11,29,10,2798,3638,2671,-967
2017,11,29,11,3065,3970,2915,-1055
2017,11,29,12,3549,4575,3378,-1197
2017,11,29,13,3783,4862,3695,-1167
2017,11,29,14,3965,5074,3691,-1383
2017,11,29,15,4194,5370,3893,-1477
2017,11,29,16,4440,5684,4009,-1675
2017,11,29,17,4686,5969,4228,-1741
2017,11,29,18,4912,6224,4354,-1870
2017,11,29,19,5106,6419,4445,-1974
2017,11,29,20,5205,6567,4560,-2007
2017,11,29,21,5232,6592,4640,-1952
2017,11,29,22,5190,6528,4570,-1958
2017,11,29,23,5165,6494,4491,-2003
2017,11,30,0,5225,6638,4638,-2000
2017,11,30,1,5105,6445,4427,-2018
2017,11,30,2,4847,6093,4026,-2067
2017,11,30,3,4466,5627,3677,-1950
2017,11,30,4,4039,5076,3266,-1810
2017,11,30,5,3591,4488,3022,-1466
2017,11,30,6,3272,4049,2866,-1183
2017,11,30,7,3060,3788,2820,-968
2017,11,30,8,2906,3629,2631,-998
2017,11,30,9,2847,3583,2674,-909
2017,11,30,10,2847,3671,2727,-944
2017,11,30,11,3129,3992,2886,-1106
2017,11,30,12,3580,4581,3339,-1242
2017,11,30,13,3795,4864,3519,-1345
2017,11,30,14,3973,5080,3453,-1627
2017,11,30,15,4213,5308,3502,-1806
2017,11,30,16,4455,5617,3733,-1884
2017,11,30,17,4718,5886,4054,-1832
2017,11,30,18,4902,6137,4472,-1665
2017,11,30,19,5092,6361,4665,-1696
2017,11,30,20,5212,6474,4737,-1737
2017,11,30,21,5228,6474,4693,-1781
2017,11,30,22,5193,6386,4618,-1768
2017,11,30,23,5187,6274,4492,-1782
2017,12,1,0,5321,6445,4607,-1838
2017,12,1,1,5111,6197,4407,-1790
2017,12,1,2,4825,5848,3988,-1860
2017,12,1,3,4422,5413,3575,-1838
2017,12,1,4,4005,4882,3280,-1602
2017,12,1,5,3547,4338,3067,-1271
2017,12,1,6,3184,3900,2702,-1198
2017,12,1,7,2968,3616,2638,-978
2017,12,1,8,2840,3478,2537,-941
2017,12,1,9,2795,3431,2493,-938
2017,12,1,10,2846,3521,2566,-955
2017,12,1,11,3062,3843,2723,-1120
2017,12,1,12,3491,4478,3201,-1277
2017,12,1,13,3707,4787,3284,-1503
2017,12,1,14,3893,4951,3187,-1764
2017,12,1,15,4096,5118,3213,-1905
2017,12,1,16,4309,5322,3245,-2077
2017,12,1,17,4502,5570,3450,-2120
2017,12,1,18,4650,5798,3638,-2160
2017,12,1,19,4878,6015,3837,-2178
2017,12,1,20,5076,6187,3943,-2244
2017,12,1,21,5107,6283,3974,-2309
2017,12,1,22,5022,6223,3952,-2271
2017,12,1,23,4922,6154,3859,-2295
2017,12,2,0,5124,6148,3794,-2354
2017,12,2,1,4866,5871,3571,-2300
2017,12,2,2,4606,5562,3324,-2238
2017,12,2,3,4289,5262,3242,-2020
2017,12,2,4,3950,4841,3057,-1784
2017,12,2,5,3584,4388,3004,-1384
2017,12,2,6,3171,3982,2762,-1220
2017,12,2,7,2946,3675,2686,-989
2017,12,2,8,2805,3509,2562,-947
2017,12,2,9,2750,3447,2509,-938
2017,12,2,10,2690,3479,2535,-944
2017,12,2,11,2780,3601,2543,-1058
2017,12,2,12,2943,3873,2731,-1142
2017,12,2,13,3161,4183,2878,-1305
2017,12,2,14,3528,4661,2995,-1666
2017,12,2,15,3858,5060,3169,-1891
2017,12,2,16,4107,5377,3310,-2067
2017,12,2,17,4247,5624,3486,-2138
2017,12,2,18,4431,5895,3722,-2173
2017,12,2,19,4528,6116,3948,-2168
2017,12,2,20,4682,6238,4071,-2167
2017,12,2,21,4673,6231,4015,-2216
2017,12,2,22,4596,6134,3950,-2184
2017,12,2,23,4594,6029,3934,-2095
2017,12,3,0,4772,6104,4041,-2063
2017,12,3,1,4526,5814,3836,-1978
2017,12,3,2,4308,5515,3457,-2058
2017,12,3,3,4025,5196,3328,-1868
2017,12,3,4,3690,4780,3134,-1646
2017,12,3,5,3371,4298,2987,-1311
2017,12,3,6,3121,3929,2852,-1077
2017,12,3,7,2890,3642,2725,-917
2017,12,3,8,2760,3468,2596,-872
2017,12,3,9,2702,3411,2534,-877
2017,12,3,10,2618,3404,2534,-870
2017,12,3,11,2701,3504,2554,-950
2017,12,3,12,2834,3733,2697,-1036
2017,12,3,13,3060,4032,2957,-1075
2017,12,3,14,3486,4516,3123,-1393
2017,12,3,15,3813,4896,3205,-1691
2017,12,3,16,4029,5173,3184,-1989
2017,12,3,17,4172,5387,3361,-2026
2017,12,3,18,4348,5657,3558,-2099
2017,12,3,19,4496,5873,3734,-2139
2017,12,3,20,4614,5990,3910,-2080
2017,12,3,21,4631,6017,3897,-2120
2017,12,3,22,4586,6007,3878,-2129
2017,12,3,23,4702,6105,3946,-2159
2017,12,4,0,4974,6311,4113,-2198
2017,12,4,1,4797,6065,3880,-2185
2017,12,4,2,4560,5760,3653,-2107
2017,12,4,3,4227,5360,3442,-1918
2017,12,4,4,3798,4810,3138,-1672
2017,12,4,5,3418,4251,2902,-1349
2017,12,4,6,3108,3813,2710,-1103
2017,12,4,7,2888,3565,2626,-939
2017,12,4,8,2754,3422,2527,-895
2017,12,4,9,2714,3363,2454,-909
2017,12,4,10,2803,3453,2510,-943
2017,12,4,11,3024,3817,2764,-1053
2017,12,4,12,3484,4462,3266,-1196
2017,12,4,13,3704,4767,3477,-1290
2017,12,4,14,3847,4919,3399,-1520
2017,12,4,15,4084,5104,3306,-1798
2017,12,4,16,4328,5313,3286,-2027
2017,12,4,17,4578,5523,3466,-2057
2017,12,4,18,4808,5707,3560,-2147
2017,12,4,19,5015,5774,3655,-2119
2017,12,4,20,5140,5754,3606,-2148
2017,12,4,21,5158,5773,3604,-2169
2017,12,4,22,5138,5840,3738,-2102
2017,12,4,23,5108,6084,3947,-2137
2017,12,5,0,5338,6453,4234,-2219
2017,12,5,1,5168,6305,4143,-2162
2017,12,5,2,4885,6004,3795,-2209
2017,12,5,3,4518,5509,3480,-2029
2017,12,5,4,4062,4965,3166,-1799
2017,12,5,5,3587,4339,3003,-1336
2017,12,5,6,3257,3898,2774,-1124
2017,12,5,7,3022,3631,2662,-969
2017,12,5,8,2888,3474,2548,-926
2017,12,5,9,2839,3435,2511,-924
2017,12,5,10,2867,3529,2599,-930
2017,12,5,11,3117,3861,2815,-1046
2017,12,5,12,3567,4486,3212,-1274
2017,12,5,13,3784,4760,3436,-1324
2017,12,5,14,3932,4933,3295,-1638
2017,12,5,15,4183,5165,3352,-1813
2017,12,5,16,4455,5456,3454,-2002
2017,12,5,17,4752,5743,3705,-2038
2017,12,5,18,5024,6065,3898,-2167
2017,12,5,19,5320,6292,4077,-2215
2017,12,5,20,5488,6474,4275,-2199
2017,12,5,21,5535,6577,4375,-2202
2017,12,5,22,5475,6542,4376,-2166
2017,12,5,23,5473,6551,4351,-2200
2017,12,6,0,5603,6777,4519,-2258
2017,12,6,1,5359,6553,4288,-2265
2017,12,6,2,5132,6175,3985,-2190
2017,12,6,3,4738,5740,3746,-1994
2017,12,6,4,4247,5135,3418,-1717
2017,12,6,5,3760,4539,3170,-1369
2017,12,6,6,3369,4082,2941,-1141
2017,12,6,7,3138,3802,2848,-954
2017,12,6,8,2991,3641,2726,-915
2017,12,6,9,2904,3543,2640,-903
2017,12,6,10,2954,3593,2692,-901
2017,12,6,11,3200,3945,2909,-1036
2017,12,6,12,3648,4590,3384,-1206
2017,12,6,13,3869,4860,3618,-1242
2017,12,6,14,4020,5066,3605,-1461
2017,12,6,15,4262,5325,3536,-1789
2017,12,6,16,4541,5667,3827,-1840
2017,12,6,17,4825,6006,4113,-1893
2017,12,6,18,5082,6320,4320,-2000
2017,12,6,19,5313,6556,4505,-2051
2017,12,6,20,5463,6705,4656,-2049
2017,12,6,21,5495,6778,4685,-2093
2017,12,6,22,5428,6718,4619,-2099
2017,12,6,23,5294,6750,4768,-1982
2017,12,7,0,5484,6953,4889,-2064
2017,12,7,1,5262,6677,4512,-2165
2017,12,7,2,5020,6289,4203,-2086
2017,12,7,3,4606,5828,3884,-1944
2017,12,7,4,4126,5161,3519,-1642
2017,12,7,5,3655,4570,3190,-1380
2017,12,7,6,3293,4203,3084,-1119
2017,12,7,7,3055,3938,2987,-951
2017,12,7,8,2915,3771,2861,-910
2017,12,7,9,2830,3707,2772,-935
2017,12,7,10,2853,3812,2898,-914
2017,12,7,11,3150,4154,3129,-1025
2017,12,7,12,3622,4850,3675,-1175
2017,12,7,13,3829,5184,3983,-1201
2017,12,7,14,3932,5339,3882,-1457
2017,12,7,15,4078,5510,3831,-1679
2017,12,7,16,4217,5639,3925,-1714
2017,12,7,17,4338,5707,4016,-1691
2017,12,7,18,4472,5743,4030,-1713
2017,12,7,19,4592,5772,4062,-1710
2017,12,7,20,4613,5821,4118,-1703
2017,12,7,21,4580,5860,4143,-1717
2017,12,7,22,4521,5908,4164,-1744
2017,12,7,23,4695,6240,4388,-1852
2017,12,8,0,4866,6500,4585,-1915
2017,12,8,1,4652,6395,4499,-1896
2017,12,8,2,4406,6127,4308,-1819
2017,12,8,3,4101,5766,4055,-1711
2017,12,8,4,3725,5236,3571,-1665
2017,12,8,5,3387,4664,3161,-1503
2017,12,8,6,3040,4155,2900,-1255
2017,12,8,7,2856,3911,2866,-1045
2017,12,8,8,2755,3776,2751,-1025
2017,12,8,9,2694,3718,2696,-1022
2017,12,8,10,2790,3801,2758,-1043
2017,12,8,11,3037,4151,3069,-1082
2017,12,8,12,3502,4777,3548,-1229
2017,12,8,13,3745,5131,3778,-1353
2017,12,8,14,3877,5291,3815,-1476
2017,12,8,15,4050,5488,3931,-1557
2017,12,8,16,4244,5714,4136,-1578
2017,12,8,17,4348,5945,4347,-1598
2017,12,8,18,4440,6186,4582,-1604
2017,12,8,19,4519,6355,4717,-1638
2017,12,8,20,4561,6401,4761,-1640
2017,12,8,21,4541,6409,4744,-1665
2017,12,8,22,4506,6455,4768,-1687
2017,12,8,23,4658,6714,4855,-1859
2017,12,9,0,4798,6859,4841,-2018
2017,12,9,1,4552,6692,4619,-2073
2017,12,9,2,4282,6466,4477,-1989
2017,12,9,3,4040,6156,4374,-1782
2017,12,9,4,3731,5706,4018,-1688
2017,12,9,5,3393,5094,3618,-1476
2017,12,9,6,3248,4594,3396,-1198
2017,12,9,7,2967,4251,3239,-1012
2017,12,9,8,2812,4017,3028,-989
2017,12,9,9,2707,3874,2891,-983
2017,12,9,10,2727,3811,2803,-1008
2017,12,9,11,2759,3927,2837,-1090
2017,12,9,12,2953,4187,3029,-1158
2017,12,9,13,3107,4544,3241,-1303
2017,12,9,14,3473,5022,3473,-1549
2017,12,9,15,3897,5391,3607,-1784
2017,12,9,16,4151,5561,3746,-1815
2017,12,9,17,4362,5602,3780,-1822
2017,12,9,18,4450,5632,3740,-1892
2017,12,9,19,4505,5561,3566,-1995
2017,12,9,20,4540,5522,3384,-2138
2017,12,9,21,4533,5439,3231,-2208
2017,12,9,22,4547,5467,3245,-2222
2017,12,9,23,4696,5837,3504,-2333
2017,12,10,0,5140,6290,3937,-2353
2017,12,10,1,5158,6328,3975,-2353
2017,12,10,2,5038,6328,4018,-2310
2017,12,10,3,4919,6253,4086,-2167
2017,12,10,4,4721,6038,3879,-2159
2017,12,10,5,4605,5765,3743,-2022
2017,12,10,6,4454,5577,3625,-1952
2017,12,10,7,4309,5482,3537,-1945
2017,12,10,8,4241,5437,3475,-1962
2017,12,10,9,4249,5541,3587,-1954
2017,12,10,10,4368,5691,3794,-1897
2017,12,10,11,4754,6020,3792,-2228
2017,12,10,12,5225,6491,4080,-2411
2017,12,10,13,5667,7118,4558,-2560
2017,12,10,14,5908,7539,5024,-2515
2017,12,10,15,5794,7402,4967,-2435
2017,12,10,16,5514,7021,4666,-2355
2017,12,10,17,5291,6522,4359,-2163
2017,12,10,18,5077,6130,4099,-2031
2017,12,10,19,4950,5816,4000,-1816
2017,12,10,20,4837,5584,3860,-1724
2017,12,10,21,4811,5518,3829,-1689
2017,12,10,22,4835,5683,3813,-1870
2017,12,10,23,5046,6304,4037,-2267
2017,12,11,0,5444,7014,4565,-2449
2017,12,11,1,5582,7238,4795,-2443
2017,12,11,2,5648,7353,4871,-2482
2017,12,11,3,5553,7201,4897,-2304
2017,12,11,4,5320,6887,4572,-2315
2017,12,11,5,4958,6569,4473,-2096
2017,12,11,6,4541,6348,4303,-2045
2017,12,11,7,4413,6317,4223,-2094
2017,12,11,8,4420,6377,4303,-2074
2017,12,11,9,4521,6537,4532,-2005
2017,12,11,10,4897,6858,4781,-2077
2017,12,11,11,5570,7562,5025,-2537
2017,12,11,12,6385,8494,5734,-2760
2017,12,11,13,6603,8957,6157,-2800
2017,12,11,14,6225,8594,5898,-2696
2017,12,11,15,5805,7834,5407,-2427
2017,12,11,16,5317,7153,4815,-2338
2017,12,11,17,4944,6552,4431,-2121
2017,12,11,18,4745,6068,3983,-2085
2017,12,11,19,4596,7484,5706,-1778
2017,12,11,20,4493,5477,3799,-1678
2017,12,11,21,4478,5396,3778,-1618
2017,12,11,22,4520,5575,3785,-1790
2017,12,11,23,4762,6248,4132,-2116
2017,12,12,0,5262,7042,4671,-2371
2017,12,12,1,5555,7248,4859,-2389
2017,12,12,2,5510,7290,4888,-2402
2017,12,12,3,5182,7081,4776,-2305
2017,12,12,4,4740,6686,4418,-2268
2017,12,12,5,4311,6272,4327,-1945
2017,12,12,6,4393,6057,4154,-1903
2017,12,12,7,4312,5974,4068,-1906
2017,12,12,8,4316,5957,4038,-1919
2017,12,12,9,4349,5986,4089,-1897
2017,12,12,10,4548,6158,4254,-1904
2017,12,12,11,4921,6639,4389,-2250
2017,12,12,12,5503,7409,4854,-2555
2017,12,12,13,5801,7557,5037,-2520
2017,12,12,14,5496,7076,4606,-2470
2017,12,12,15,5130,6415,4076,-2339
2017,12,12,16,4917,5894,3778,-2116
2017,12,12,17,4703,5527,3692,-1835
2017,12,12,18,4538,5350,3576,-1774
2017,12,12,19,4479,5212,3641,-1571
2017,12,12,20,4412,5136,3581,-1555
2017,12,12,21,4305,5140,3557,-1583
2017,12,12,22,4403,5253,3529,-1724
2017,12,12,23,4754,5646,3564,-2082
2017,12,13,0,4985,6195,3818,-2377
2017,12,13,1,4948,6178,3784,-2394
2017,12,13,2,4804,6074,3698,-2376
2017,12,13,3,4605,5798,3630,-2168
2017,12,13,4,4325,5350,3308,-2042
2017,12,13,5,4019,4962,3238,-1724
2017,12,13,6,3752,4742,3162,-1580
2017,12,13,7,3673,4695,3097,-1598
2017,12,13,8,3767,4758,3145,-1613
2017,12,13,9,3906,4936,3210,-1726
2017,12,13,10,4171,5243,3479,-1764
2017,12,13,11,4767,5959,3810,-2149
2017,12,13,12,5673,6936,4422,-2514
2017,12,13,13,6023,7400,4828,-2572
2017,12,13,14,5808,7184,4789,-2395
2017,12,13,15,5496,6747,4434,-2313
2017,12,13,16,5103,6344,4137,-2207
2017,12,13,17,4856,5940,3814,-2126
2017,12,13,18,4606,5639,3663,-1976
2017,12,13,19,4434,5436,3759,-1677
2017,12,13,20,4290,5295,3688,-1607
2017,12,13,21,4276,5288,3664,-1624
2017,12,13,22,4399,5466,3684,-1782
2017,12,13,23,4792,6102,3961,-2141
2017,12,14,0,5172,6828,4476,-2352
2017,12,14,1,5306,7055,4689,-2366
2017,12,14,2,5320,7098,4740,-2358
2017,12,14,3,5223,6934,4752,-2182
2017,12,14,4,4976,6528,4342,-2186
2017,12,14,5,4562,6139,4227,-1912
2017,12,14,6,4222,5873,4083,-1790
2017,12,14,7,4103,5771,3984,-1787
2017,12,14,8,4029,5742,3943,-1799
2017,12,14,9,4136,5778,3992,-1786
2017,12,14,10,4297,5966,4158,-1808
2017,12,14,11,4637,6427,4327,-2100
2017,12,14,12,5220,7176,4823,-2353
2017,12,14,13,5532,7356,4947,-2409
2017,12,14,14,5402,6917,4566,-2351
2017,12,14,15,5030,6375,4122,-2253
2017,12,14,16,4813,5910,3789,-2121
2017,12,14,17,4486,5568,3643,-1925
2017,12,14,18,4261,5376,3489,-1887
2017,12,14,19,4210,5267,3664,-1603
2017,12,14,20,4187,5237,3687,-1550
2017,12,14,21,4147,5213,3669,-1544
2017,12,14,22,4215,5313,3642,-1671
2017,12,14,23,4405,5677,3676,-2001
2017,12,15,0,4690,6088,3948,-2140
2017,12,15,1,4700,6048,3909,-2139
2017,12,15,2,4576,5878,3791,-2087
2017,12,15,3,4357,5565,3610,-1955
2017,12,15,4,4017,5058,3200,-1858
2017,12,15,5,3612,4528,3027,-1501
2017,12,15,6,3350,4135,2909,-1226
2017,12,15,7,3167,3939,2895,-1044
2017,12,15,8,3147,3832,2830,-1002
2017,12,15,9,3132,3829,2819,-1010
2017,12,15,10,3253,3957,2891,-1066
2017,12,15,11,3593,4351,3191,-1160
2017,12,15,12,4140,5026,3649,-1377
2017,12,15,13,4364,5319,3939,-1380
2017,12,15,14,4343,5345,3971,-1374
2017,12,15,15,4396,5307,3987,-1320
2017,12,15,16,4273,5306,4007,-1299
2017,12,15,17,4276,5293,4017,-1276
2017,12,15,18,4292,5285,4020,-1265
2017,12,15,19,4311,5282,3930,-1352
2017,12,15,20,4293,5293,3906,-1387
2017,12,15,21,4239,5316,3898,-1418
2017,12,15,22,4289,5357,3968,-1389
2017,12,15,23,4514,5550,4179,-1371
2017,12,16,0,4746,5800,4353,-1447
2017,12,16,1,4655,5656,4240,-1416
2017,12,16,2,4435,5442,4057,-1385
2017,12,16,3,4159,5186,3867,-1319
2017,12,16,4,3802,4852,3588,-1264
2017,12,16,5,3477,4427,3240,-1187
2017,12,16,6,3171,4188,3117,-1071
2017,12,16,7,3023,4009,2983,-1026
2017,12,16,8,2920,3894,2895,-999
2017,12,16,9,2908,3886,2831,-1055
2017,12,16,10,2920,3957,2885,-1072
2017,12,16,11,3060,4160,3033,-1127
2017,12,16,12,3302,4470,3253,-1217
2017,12,16,13,3598,4897,3553,-1344
2017,12,16,14,3875,5308,3733,-1575
2017,12,16,15,4096,5531,3773,-1758
2017,12,16,16,4049,5538,3806,-1732
2017,12,16,17,4022,5426,3758,-1668
2017,12,16,18,3996,5333,3668,-1665
2017,12,16,19,3948,5293,3660,-1633
2017,12,16,20,3879,5256,3657,-1599
2017,12,16,21,3792,5270,3658,-1612
2017,12,16,22,3754,5285,3675,-1610
2017,12,16,23,4027,5509,3810,-1699
2017,12,17,0,4185,5791,4027,-1764
2017,12,17,1,4093,5625,3888,-1737
2017,12,17,2,3956,5446,3733,-1713
2017,12,17,3,3839,5248,3637,-1611
2017,12,17,4,3669,4924,3350,-1574
2017,12,17,5,3314,4603,3211,-1392
2017,12,17,6,2980,4210,3010,-1200
2017,12,17,7,2780,3996,2895,-1101
2017,12,17,8,2714,3891,2802,-1089
2017,12,17,9,2652,3860,2769,-1091
2017,12,17,10,2680,3924,2814,-1110
2017,12,17,11,2806,4071,2916,-1155
2017,12,17,12,3001,4348,3107,-1241
2017,12,17,13,3210,4718,3305,-1413
2017,12,17,14,3463,5079,3478,-1601
2017,12,17,15,3755,5226,3518,-1708
2017,12,17,16,3772,5214,3571,-1643
2017,12,17,17,3946,5211,3619,-1592
2017,12,17,18,4004,5263,3627,-1636
2017,12,17,19,4042,5314,3691,-1623
2017,12,17,20,4150,5374,3745,-1629
2017,12,17,21,4220,5431,3772,-1659
2017,12,17,22,4236,5483,3859,-1624
2017,12,17,23,4378,5652,3945,-1707
2017,12,18,0,4659,5974,4189,-1785
2017,12,18,1,4577,5846,4090,-1756
2017,12,18,2,4411,5631,3946,-1685
2017,12,18,3,4093,5271,3736,-1535
2017,12,18,4,3713,4789,3365,-1424
2017,12,18,5,3442,4242,3020,-1222
2017,12,18,6,3106,3828,2821,-1007
2017,12,18,7,2968,3571,2675,-896
2017,12,18,8,2784,3445,2564,-881
2017,12,18,9,2791,3431,2542,-889
2017,12,18,10,2856,3530,2604,-926
2017,12,18,11,3082,3934,2907,-1027
2017,12,18,12,3540,4569,3329,-1240
2017,12,18,13,3803,4933,3566,-1367
2017,12,18,14,3915,5074,3533,-1541
2017,12,18,15,4119,5225,3669,-1556
2017,12,18,16,4290,5460,3875,-1585
2017,12,18,17,4486,5672,4057,-1615
2017,12,18,18,4654,5885,4187,-1698
2017,12,18,19,4783,6076,4275,-1801
2017,12,18,20,4882,6217,4324,-1893
2017,12,18,21,5005,6274,4361,-1913
2017,12,18,22,4950,6284,4404,-1880
2017,12,18,23,5044,6493,4518,-1975
2017,12,19,0,5177,6814,4809,-2005
2017,12,19,1,5132,6666,4736,-1930
2017,12,19,2,4918,6288,4464,-1824
2017,12,19,3,4577,5819,4164,-1655
2017,12,19,4,4177,5223,3670,-1553
2017,12,19,5,3682,4591,3292,-1299
2017,12,19,6,3288,4105,2971,-1134
2017,12,19,7,3080,3786,2799,-987
2017,12,19,8,2948,3614,2663,-951
2017,12,19,9,2914,3546,2597,-949
2017,12,19,10,2998,3619,2654,-965
2017,12,19,11,3233,3929,2882,-1047
2017,12,19,12,3671,4534,3271,-1263
2017,12,19,13,3899,4828,3423,-1405
2017,12,19,14,4000,5021,3408,-1613
2017,12,19,15,4211,5281,3503,-1778
2017,12,19,16,4445,5603,3779,-1824
2017,12,19,17,4701,5902,3979,-1923
2017,12,19,18,4906,6215,4165,-2050
2017,12,19,19,5139,6504,4407,-2097
2017,12,19,20,5318,6698,4445,-2253
2017,12,19,21,5383,6764,4509,-2255
2017,12,19,22,5345,6690,4485,-2205
2017,12,19,23,5367,6690,4529,-2161
2017,12,20,0,5460,6955,4685,-2270
2017,12,20,1,5359,6689,4497,-2192
2017,12,20,2,5116,6325,4217,-2108
2017,12,20,3,4739,5827,3848,-1979
2017,12,20,4,4292,5241,3422,-1819
2017,12,20,5,3764,4624,3116,-1508
2017,12,20,6,3334,4118,2986,-1132
2017,12,20,7,3101,3785,2783,-1002
2017,12,20,8,2961,3606,2643,-963
2017,12,20,9,2908,3539,2606,-933
2017,12,20,10,2950,3602,2634,-968
2017,12,20,11,3169,3915,2872,-1043
2017,12,20,12,3582,4509,3258,-1251
2017,12,20,13,3798,4793,3331,-1462
2017,12,20,14,3950,4983,3323,-1660
2017,12,20,15,4164,5252,3412,-1840
2017,12,20,16,4415,5529,3517,-2012
2017,12,20,17,4670,5741,3662,-2079
2017,12,20,18,4879,5877,3731,-2146
2017,12,20,19,5107,6045,3864,-2181
2017,12,20,20,5249,6238,3997,-2241
2017,12,20,21,5266,6310,4081,-2229
2017,12,20,22,5314,6279,4067,-2212
2017,12,20,23,5350,6306,4040,-2266
2017,12,21,0,5384,6602,4229,-2373
2017,12,21,1,5243,6429,4109,-2320
2017,12,21,2,5016,6169,4041,-2128
2017,12,21,3,4636,5806,3815,-1991
2017,12,21,4,4251,5263,3400,-1863
2017,12,21,5,3808,4650,3106,-1544
2017,12,21,6,3370,4165,2976,-1189
2017,12,21,7,3114,3888,2848,-1040
2017,12,21,8,2957,3721,2727,-994
2017,12,21,9,2916,3639,2664,-975
2017,12,21,10,2958,3717,2730,-987
2017,12,21,11,3148,4010,2953,-1057
2017,12,21,12,3537,4575,3320,-1255
2017,12,21,13,3772,4943,3479,-1464
2017,12,21,14,3990,5229,3531,-1698
2017,12,21,15,4181,5518,3617,-1901
2017,12,21,16,4384,5808,3723,-2085
2017,12,21,17,4594,6066,3912,-2154
2017,12,21,18,4747,6351,4070,-2281
2017,12,21,19,4874,6558,4238,-2320
2017,12,21,20,4965,6683,4343,-2340
2017,12,21,21,4935,6716,4380,-2336
2017,12,21,22,4873,6610,4318,-2292
2017,12,21,23,4936,6529,4249,-2280
2017,12,22,0,5168,6671,4331,-2340
2017,12,22,1,5033,6393,4127,-2266
2017,12,22,2,4796,6080,4005,-2075
2017,12,22,3,4482,5686,3757,-1929
2017,12,22,4,4122,5109,3302,-1807
2017,12,22,5,3682,4514,3040,-1474
2017,12,22,6,3324,4186,3077,-1109
2017,12,22,7,3042,3774,2758,-1016
2017,12,22,8,2870,3574,2629,-945
2017,12,22,9,2783,3493,2564,-929
2017,12,22,10,2813,3523,2575,-948
2017,12,22,11,2959,3785,2759,-1026
2017,12,22,12,3256,4254,3027,-1227
2017,12,22,13,3526,4630,3206,-1424
2017,12,22,14,3828,4875,3216,-1659
2017,12,22,15,4061,5180,3312,-1868
2017,12,22,16,4285,5352,3341,-2011
2017,12,22,17,4454,5431,3404,-2027
2017,12,22,18,4616,5518,3406,-2112
2017,12,22,19,4828,5659,3524,-2135
2017,12,22,20,4982,5786,3628,-2158
2017,12,22,21,5055,5903,3722,-2181
2017,12,22,22,5066,5908,3754,-2154
2017,12,22,23,4917,5911,3722,-2189
2017,12,23,0,4992,6117,3857,-2260
2017,12,23,1,4816,5869,3661,-2208
2017,12,23,2,4594,5614,3584,-2030
2017,12,23,3,4391,5321,3403,-1918
2017,12,23,4,4088,4928,3097,-1831
2017,12,23,5,3796,4463,2958,-1505
2017,12,23,6,3378,4058,2900,-1158
2017,12,23,7,3111,3722,2709,-1013
2017,12,23,8,2930,3541,2602,-939
2017,12,23,9,2856,3443,2494,-949
2017,12,23,10,2837,3463,2490,-973
2017,12,23,11,2864,3572,2554,-1018
2017,12,23,12,3001,3807,2720,-1087
2017,12,23,13,3214,4093,2825,-1268
2017,12,23,14,3578,4576,3015,-1561
2017,12,23,15,3987,5051,3151,-1900
2017,12,23,16,4324,5388,3305,-2083
2017,12,23,17,4550,5566,3454,-2112
2017,12,23,18,4753,5723,3520,-2203
2017,12,23,19,5106,5851,3650,-2201
2017,12,23,20,5268,5926,3705,-2221
2017,12,23,21,5262,5949,3717,-2232
2017,12,23,22,5205,5891,3697,-2194
2017,12,23,23,5068,5918,3675,-2243
2017,12,24,0,5060,6079,3789,-2290
2017,12,24,1,4849,5877,3638,-2239
2017,12,24,2,4618,5596,3535,-2061
2017,12,24,3,4308,5323,3390,-1933
2017,12,24,4,4040,4915,3055,-1860
2017,12,24,5,3669,4442,2907,-1535
2017,12,24,6,3309,4014,2853,-1161
2017,12,24,7,3088,3693,2688,-1005
2017,12,24,8,2935,3500,2616,-884
2017,12,24,9,2820,3399,2481,-918
2017,12,24,10,2839,3418,2482,-936
2017,12,24,11,2985,3480,2483,-997
2017,12,24,12,3080,3740,2675,-1065
2017,12,24,13,3238,4032,2772,-1260
2017,12,24,14,3576,4582,3008,-1574
2017,12,24,15,3992,5117,3161,-1956
2017,12,24,16,4272,5446,3313,-2133
2017,12,24,17,4489,5726,3531,-2195
2017,12,24,18,4672,5971,3713,-2258
2017,12,24,19,4825,6173,3882,-2291
2017,12,24,20,4936,6323,4003,-2320
2017,12,24,21,4954,6355,4030,-2325
2017,12,24,22,4807,6298,4005,-2293
2017,12,24,23,4557,6215,3923,-2292
2017,12,25,0,4825,6282,3978,-2304
2017,12,25,1,4609,5974,3741,-2233
2017,12,25,2,4310,5617,3574,-2043
2017,12,25,3,4052,5350,3386,-1964
2017,12,25,4,3682,4958,3097,-1861
2017,12,25,5,3383,4567,2976,-1591
2017,12,25,6,3061,4141,3165,-976
2017,12,25,7,2791,3846,2990,-856
2017,12,25,8,2611,3626,2816,-810
2017,12,25,9,2480,3505,2719,-786
2017,12,25,10,2449,3454,2672,-782
2017,12,25,11,2538,3516,2688,-828
2017,12,25,12,2713,3723,2806,-917
2017,12,25,13,2976,4072,3034,-1038
2017,12,25,14,3328,4617,3339,-1278
2017,12,25,15,3584,5062,3681,-1381
2017,12,25,16,3749,5313,3893,-1420
2017,12,25,17,3929,5396,3924,-1472
2017,12,25,18,3943,5437,3965,-1472
2017,12,25,19,3898,5419,3987,-1432
2017,12,25,20,3843,5359,3953,-1406
2017,12,25,21,3812,5272,3892,-1380
2017,12,25,22,3725,5133,3802,-1331
2017,12,25,23,3780,5094,3723,-1371
2017,12,26,0,3912,5350,3879,-1471
2017,12,26,1,3842,5266,3862,-1404
2017,12,26,2,3753,5142,3746,-1396
2017,12,26,3,3596,4974,3616,-1358
2017,12,26,4,3430,4674,3369,-1305
2017,12,26,5,3284,4327,3033,-1294
2017,12,26,6,3040,4070,2762,-1308
2017,12,26,7,2900,3897,2686,-1211
2017,12,26,8,2822,3842,2629,-1213
2017,12,26,9,2825,3860,2623,-1237
2017,12,26,10,2932,4009,2723,-1286
2017,12,26,11,3165,4357,2937,-1420
2017,12,26,12,3352,4856,3226,-1630
2017,12,26,13,3615,5288,3488,-1800
2017,12,26,14,3870,5571,3600,-1971
2017,12,26,15,3975,5634,3705,-1929
2017,12,26,16,4001,5565,3726,-1839
2017,12,26,17,4008,5414,3675,-1739
2017,12,26,18,3954,5315,3584,-1731
2017,12,26,19,3958,5216,3556,-1660
2017,12,26,20,3949,5146,3496,-1650
2017,12,26,21,3925,5134,3489,-1645
2017,12,26,22,3928,5173,3541,-1632
2017,12,26,23,4138,5397,3654,-1743
2017,12,27,0,4473,5824,3939,-1885
2017,12,27,1,4355,5707,3879,-1828
2017,12,27,2,4241,5477,3692,-1785
2017,12,27,3,4023,5202,3554,-1648
2017,12,27,4,3667,4787,3180,-1607
2017,12,27,5,3328,4336,2980,-1356
2017,12,27,6,3061,3978,2822,-1156
2017,12,27,7,2899,3736,2691,-1045
2017,12,27,8,2808,3645,2615,-1030
2017,12,27,9,2775,3601,2564,-1037
2017,12,27,10,2841,3675,2620,-1055
2017,12,27,11,3033,3938,2797,-1141
2017,12,27,12,3327,4377,3067,-1310
2017,12,27,13,3670,4750,3254,-1496
2017,12,27,14,3916,5004,3325,-1679
2017,12,27,15,4056,5225,3531,-1694
2017,12,27,16,4142,5358,3675,-1683
2017,12,27,17,4204,5473,3804,-1669
2017,12,27,18,4239,5547,3838,-1709
2017,12,27,19,4319,5589,3871,-1718
2017,12,27,20,4254,5610,3896,-1714
2017,12,27,21,4258,5581,3862,-1719
2017,12,27,22,4249,5573,3843,-1730
2017,12,27,23,4354,5778,3941,-1837
2017,12,28,0,4614,6115,4202,-1913
2017,12,28,1,4490,5960,4246,-1714
2017,12,28,2,4366,5724,4115,-1609
2017,12,28,3,4129,5376,4002,-1374
2017,12,28,4,3802,4936,3597,-1339
2017,12,28,5,3416,4421,3116,-1305
2017,12,28,6,3024,4037,2976,-1061
2017,12,28,7,2851,3803,2853,-950
2017,12,28,8,2697,3643,2723,-920
2017,12,28,9,2641,3603,2652,-951
2017,12,28,10,2684,3684,2692,-992
2017,12,28,11,2899,3924,2846,-1078
2017,12,28,12,3207,4347,3103,-1244
2017,12,28,13,3510,4714,3379,-1335
2017,12,28,14,3806,5018,3635,-1383
2017,12,28,15,4056,5330,3892,-1438
2017,12,28,16,4221,5486,4048,-1438
2017,12,28,17,4253,5555,4095,-1460
2017,12,28,18,4273,5592,4132,-1460
2017,12,28,19,4263,5576,4118,-1458
2017,12,28,20,4255,5544,4127,-1417
2017,12,28,21,4237,5524,4075,-1449
2017,12,28,22,4177,5612,4184,-1428
2017,12,28,23,4373,5890,4379,-1511
2017,12,29,0,4675,6216,4740,-1476
2017,12,29,1,4539,6085,4640,-1445
2017,12,29,2,4289,5265,3869,-1396
2017,12,29,3,4035,5545,4208,-1337
2017,12,29,4,3722,5107,3768,-1339
2017,12,29,5,3331,4667,3371,-1296
2017,12,29,6,3080,4188,3022,-1166
2017,12,29,7,2888,4042,2914,-1128
2017,12,29,8,2738,3924,2818,-1106
2017,12,29,9,2733,3903,2780,-1123
2017,12,29,10,2801,3985,2839,-1146
2017,12,29,11,3015,4251,3084,-1167
2017,12,29,12,3324,4720,3477,-1243
2017,12,29,13,3633,5113,3788,-1325
2017,12,29,14,3888,5485,4091,-1394
2017,12,29,15,4083,5816,4378,-1438
2017,12,29,16,4172,5962,4496,-1466
2017,12,29,17,4192,5960,4496,-1464
2017,12,29,18,4145,5890,4483,-1407
2017,12,29,19,4102,5744,4397,-1347
2017,12,29,20,4036,5625,4314,-1311
2017,12,29,21,3956,5596,4287,-1309
2017,12,29,22,3951,5714,4378,-1336
2017,12,29,23,4086,6115,4528,-1587
2017,12,30,0,4338,6496,4834,-1662
2017,12,30,1,4296,6412,4772,-1640
2017,12,30,2,4141,6310,4824,-1486
2017,12,30,3,3948,6091,4632,-1459
2017,12,30,4,3749,5741,4351,-1390
2017,12,30,5,3547,5321,4008,-1313
2017,12,30,6,3464,4940,3720,-1220
2017,12,30,7,3241,4730,3513,-1217
2017,12,30,8,3160,4614,3404,-1210
2017,12,30,9,3136,4575,3367,-1208
2017,12,30,10,3198,4660,3447,-1213
2017,12,30,11,3340,4842,3618,-1224
2017,12,30,12,3586,5222,3879,-1343
2017,12,30,13,3971,5643,4185,-1458
2017,12,30,14,4228,6077,4508,-1569
2017,12,30,15,4378,6242,4652,-1590
2017,12,30,16,4267,6099,4588,-1511
2017,12,30,17,4159,5764,4379,-1385
2017,12,30,18,4085,5486,4189,-1297
2017,12,30,19,4000,5230,4012,-1218
2017,12,30,20,3956,5053,3887,-1166
2017,12,30,21,3909,5002,3877,-1125
2017,12,30,22,3913,5070,3916,-1154
2017,12,30,23,4095,5354,4107,-1247
2017,12,31,0,4245,5872,4481,-1391
2017,12,31,1,4176,5901,4501,-1400
2017,12,31,2,4067,5844,4443,-1401
2017,12,31,3,3898,5758,4347,-1411
2017,12,31,4,3661,5544,4144,-1400
2017,12,31,5,3493,5283,3927,-1356
2017,12,31,6,3646,5030,3631,-1399
2017,12,31,7,3514,4925,3524,-1401
2017,12,31,8,3417,4861,3455,-1406
2017,12,31,9,3418,4925,3499,-1426
2017,12,31,10,3495,5066,3610,-1456
2017,12,31,11,3797,5268,3818,-1450
2017,12,31,12,4141,5631,4140,-1491
2017,12,31,13,4445,6047,4539,-1508
2017,12,31,14,4625,6289,4724,-1565
2017,12,31,15,4616,6274,4773,-1501
2017,12,31,16,4420,5968,4594,-1374
2017,12,31,17,4276,5664,4259,-1405
2017,12,31,18,4132,5418,3953,-1465
2017,12,31,19,4004,5251,3848,-1403
2017,12,31,20,3959,5156,3785,-1371
2017,12,31,21,3966,5115,3752,-1363
2017,12,31,22,4036,5208,3815,-1393
2017,12,31,23,4202,5475,4095,-1380
2018,1,1,0,4457,5862,4539,-1323
2018,1,1,1,4507,5661,4342,-1319
2018,1,1,2,4263,5368,4145,-1223
2018,1,1,3,4076,5090,3805,-1285
2018,1,1,4,3882,4782,3443,-1339
2018,1,1,5,3639,4552,3301,-1251
2018,1,1,6,3536,4342,3202,-1140
2018,1,1,7,3402,4190,3104,-1086
2018,1,1,8,3300,4019,2961,-1058
2018,1,1,9,3250,3912,2854,-1058
2018,1,1,10,3266,3907,2829,-1078
2018,1,1,11,3269,4028,2895,-1133
2018,1,1,12,3377,4264,2983,-1281
2018,1,1,13,3554,4564,3262,-1302
2018,1,1,14,3831,5030,3545,-1485
2018,1,1,15,4194,5593,3954,-1639
2018,1,1,16,4471,6122,4368,-1754
2018,1,1,17,4514,6467,4636,-1831
2018,1,1,18,4505,6675,4896,-1779
2018,1,1,19,4484,6772,5017,-1755
2018,1,1,20,4431,6865,5222,-1643
2018,1,1,21,4387,7044,5369,-1675
2018,1,1,22,4340,7353,5589,-1764
2018,1,1,23,4526,7926,6239,-1687
2018,1,2,0,4920,8339,6721,-1618
2018,1,2,1,5065,8444,6774,-1670
2018,1,2,2,4984,8424,6762,-1662
2018,1,2,3,4850,8250,6586,-1664
2018,1,2,4,4652,7902,6223,-1679
2018,1,2,5,4511,7477,5905,-1572
2018,1,2,6,4742,7161,5397,-1764
2018,1,2,7,4573,7060,5172,-1888
2018,1,2,8,4514,7025,5100,-1925
2018,1,2,9,4580,7127,5114,-2013
2018,1,2,10,4856,7401,5442,-1959
2018,1,2,11,5158,8005,6167,-1838
2018,1,2,12,5704,8650,6850,-1800
2018,1,2,13,6201,9135,7323,-1812
2018,1,2,14,6155,9321,7637,-1684
2018,1,2,15,5931,9332,7413,-1919
2018,1,2,16,5716,9133,7238,-1895
2018,1,2,17,5498,8737,6982,-1755
2018,1,2,18,5277,8241,6533,-1708
2018,1,2,19,5163,7830,6175,-1655
2018,1,2,20,5108,7610,5983,-1627
2018,1,2,21,5111,7632,5964,-1668
2018,1,2,22,5299,7924,6202,-1722
2018,1,2,23,5652,8492,6830,-1662
2018,1,3,0,6147,9050,7402,-1648
2018,1,3,1,6182,9058,7345,-1713
2018,1,3,2,5995,8872,6895,-1977
2018,1,3,3,5765,8488,6502,-1986
2018,1,3,4,5394,7982,5926,-2056
2018,1,3,5,4789,7426,5369,-2057
2018,1,3,6,4828,7095,5292,-1803
2018,1,3,7,4657,6902,5133,-1769
2018,1,3,8,4609,0,5133,-1895
2018,1,3,9,4674,6812,4913,-1899
2018,1,3,10,4841,7033,5061,-1972
2018,1,3,11,5294,7478,5734,-1744
2018,1,3,12,5983,8038,6358,-1680
2018,1,3,13,6676,8437,6815,-1622
2018,1,3,14,6764,8632,6874,-1758
2018,1,3,15,6427,8919,7013,-1906
2018,1,3,16,6098,9317,7281,-2036
2018,1,3,17,5795,9373,7519,-1854
2018,1,3,18,5556,9028,7238,-1790
2018,1,3,19,5309,8422,6688,-1734
2018,1,3,20,5152,7782,6039,-1743
2018,1,3,21,5123,7532,5796,-1736
2018,1,3,22,5357,7618,5878,-1740
2018,1,3,23,5969,8327,6545,-1782
2018,1,4,0,6398,9283,7469,-1814
2018,1,4,1,6495,9584,7680,-1904
2018,1,4,2,6537,9693,7855,-1838
2018,1,4,3,6357,9647,7878,-1769
2018,1,4,4,6059,9416,7569,-1847
2018,1,4,5,5735,9197,7203,-1994
2018,1,4,6,6170,9173,6945,-2228
2018,1,4,7,5908,9257,6925,-2332
2018,1,4,8,6158,9411,7179,-2232
2018,1,4,9,6157,9654,7502,-2152
2018,1,4,10,6407,10015,7929,-2086
2018,1,4,11,7155,10569,8349,-2220
2018,1,4,12,7799,11204,8724,-2480
2018,1,4,13,8162,11520,8804,-2716
2018,1,4,14,7938,11267,8612,-2655
2018,1,4,15,7517,10535,8087,-2448
2018,1,4,16,6901,9696,7351,-2345
2018,1,4,17,6449,8994,6749,-2245
2018,1,4,18,6042,8337,5792,-2545
2018,1,4,19,5798,7760,5250,-2510
2018,1,4,20,5525,7325,4912,-2413
2018,1,4,21,5513,7099,4695,-2404
2018,1,4,22,5662,7298,4816,-2482
2018,1,4,23,6276,8106,5456,-2650
2018,1,5,0,7019,9107,6373,-2734
2018,1,5,1,7252,9338,6450,-2888
2018,1,5,2,7327,9376,6505,-2871
2018,1,5,3,7167,9207,6468,-2739
2018,1,5,4,6881,8867,6213,-2654
2018,1,5,5,6583,8530,5859,-2671
2018,1,5,6,7200,8405,5864,-2541
2018,1,5,7,7150,8481,5924,-2557
2018,1,5,8,7150,8662,6142,-2520
2018,1,5,9,7200,8907,6377,-2530
2018,1,5,10,7500,9283,6745,-2538
2018,1,5,11,8300,9932,7126,-2806
2018,1,5,12,8962,10797,7665,-3132
2018,1,5,13,9188,11322,7978,-3344
2018,1,5,14,8554,11212,8184,-3028
2018,1,5,15,8143,10711,7793,-2918
2018,1,5,16,7400,9880,6888,-2992
2018,1,5,17,6810,9127,6273,-2854
2018,1,5,18,6427,8293,5597,-2696
2018,1,5,19,6034,7600,5101,-2499
2018,1,5,20,5704,7137,4640,-2497
2018,1,5,21,5577,6952,4489,-2463
2018,1,5,22,5618,7119,4628,-2491
2018,1,5,23,6327,7818,5130,-2688
2018,1,6,0,6972,8625,5688,-2937
2018,1,6,1,7163,8771,5840,-2931
2018,1,6,2,7321,8908,5963,-2945
2018,1,6,3,7176,8876,6052,-2824
2018,1,6,4,6990,8682,5783,-2899
2018,1,6,5,6732,8436,5537,-2899
2018,1,6,6,5920,8318,5772,-2546
2018,1,6,7,5936,8324,5944,-2380
2018,1,6,8,5924,8427,6084,-2343
2018,1,6,9,6040,8655,6264,-2391
2018,1,6,10,6239,8896,6207,-2689
2018,1,6,11,6525,9308,6436,-2872
2018,1,6,12,6823,9861,6889,-2972
2018,1,6,13,7487,10346,7351,-2995
2018,1,6,14,7625,10439,7408,-3031
2018,1,6,15,7313,9905,6989,-2916
2018,1,6,16,6631,9154,6544,-2610
2018,1,6,17,6100,8287,5869,-2418
2018,1,6,18,5492,7573,5271,-2302
2018,1,6,19,5061,6927,4937,-1990
2018,1,6,20,4787,6460,4576,-1884
2018,1,6,21,4677,6211,4357,-1854
2018,1,6,22,4700,6323,4323,-2000
2018,1,6,23,4950,6918,4607,-2311
2018,1,7,0,5570,7760,5278,-2482
2018,1,7,1,5632,8113,5564,-2549
2018,1,7,2,5681,8360,5754,-2606
2018,1,7,3,5609,8371,5903,-2468
2018,1,7,4,5416,8241,5787,-2454
2018,1,7,5,5170,8080,5865,-2215
2018,1,7,6,5092,7953,5860,-2093
2018,1,7,7,4980,8007,6020,-1987
2018,1,7,8,4945,8088,6170,-1918
2018,1,7,9,5016,8225,6154,-2071
2018,1,7,10,5170,8402,6252,-2150
2018,1,7,11,5410,8665,6389,-2276
2018,1,7,12,5785,9035,6702,-2333
2018,1,7,13,6199,9433,7111,-2322
2018,1,7,14,6254,9507,7367,-2140
2018,1,7,15,5949,8902,6840,-2062
2018,1,7,16,5510,7977,5990,-1987
2018,1,7,17,5018,7138,5312,-1826
2018,1,7,18,4694,6503,4716,-1787
2018,1,7,19,4492,6039,4370,-1669
2018,1,7,20,4304,5707,4135,-1572
2018,1,7,21,4160,5560,4010,-1550
2018,1,7,22,4178,5623,3907,-1716
2018,1,7,23,4423,6055,4146,-1909
2018,1,8,0,4872,6670,4667,-2003
2018,1,8,1,4909,6757,4868,-1889
2018,1,8,2,4848,6701,4842,-1859
2018,1,8,3,4624,6444,4608,-1836
2018,1,8,4,4266,6026,4221,-1805
2018,1,8,5,4154,5644,3985,-1659
2018,1,8,6,3991,5376,3765,-1611
2018,1,8,7,3856,5324,3667,-1657
2018,1,8,8,3803,5321,3662,-1659
2018,1,8,9,3847,5442,3627,-1815
2018,1,8,10,4012,5662,3753,-1909
2018,1,8,11,4406,6229,4200,-2029
2018,1,8,12,4988,6994,4900,-2094
2018,1,8,13,5296,7312,5224,-2088
2018,1,8,14,5233,7207,5157,-2050
2018,1,8,15,5054,6865,4905,-1960
2018,1,8,16,4849,6454,4620,-1834
2018,1,8,17,4782,6107,4310,-1797
2018,1,8,18,4429,5835,4131,-1704
2018,1,8,19,4382,5620,4151,-1469
2018,1,8,20,4308,5437,3959,-1478
2018,1,8,21,4237,5317,3833,-1484
2018,1,8,22,4282,5360,3763,-1597
2018,1,8,23,4438,5709,4033,-1676
2018,1,9,0,4818,6166,4376,-1790
2018,1,9,1,4717,6122,4338,-1784
2018,1,9,2,4554,5856,4124,-1732
2018,1,9,3,4296,5435,3749,-1686
2018,1,9,4,3963,4971,3392,-1579
2018,1,9,5,3585,4462,3121,-1341
2018,1,9,6,3230,4141,2938,-1203
2018,1,9,7,3122,3892,2826,-1066
2018,1,9,8,2938,3797,2767,-1030
2018,1,9,9,2914,3765,2757,-1008
2018,1,9,10,3014,3886,2777,-1109
2018,1,9,11,3216,4307,3082,-1225
2018,1,9,12,3793,5010,3636,-1374
2018,1,9,13,4068,5395,3975,-1420
2018,1,9,14,4152,5401,4045,-1356
2018,1,9,15,4240,5352,3993,-1359
2018,1,9,16,4321,5308,4000,-1308
2018,1,9,17,4370,5273,3967,-1306
2018,1,9,18,4361,5275,3923,-1352
2018,1,9,19,4400,5266,3971,-1295
2018,1,9,20,4425,5233,3926,-1307
2018,1,9,21,4401,5245,3913,-1332
2018,1,9,22,4402,5332,4021,-1311
2018,1,9,23,4513,5571,4169,-1402
2018,1,10,0,4820,5975,4466,-1509
2018,1,10,1,4692,5923,4430,-1493
2018,1,10,2,4458,5642,4222,-1420
2018,1,10,3,4127,5279,3963,-1316
2018,1,10,4,3796,4749,3549,-1200
2018,1,10,5,3430,4198,3081,-1117
2018,1,10,6,3141,3778,2818,-960
2018,1,10,7,3009,3579,2662,-917
2018,1,10,8,2825,3473,2560,-913
2018,1,10,9,2817,3418,2519,-899
2018,1,10,10,2899,3515,2518,-997
2018,1,10,11,3124,3879,2791,-1088
2018,1,10,12,3682,4546,3288,-1258
2018,1,10,13,3922,4956,3682,-1274
2018,1,10,14,4019,5041,3881,-1160
2018,1,10,15,4132,5135,3858,-1277
2018,1,10,16,4318,5244,3948,-1296
2018,1,10,17,4416,5337,4023,-1314
2018,1,10,18,4486,5377,4054,-1323
2018,1,10,19,4550,5375,4062,-1313
2018,1,10,20,4560,5385,4084,-1301
2018,1,10,21,4567,5416,4106,-1310
2018,1,10,22,4563,5471,4143,-1328
2018,1,10,23,4646,5648,4263,-1385
2018,1,11,0,4904,6034,4528,-1506
2018,1,11,1,4756,5969,4489,-1480
2018,1,11,2,4508,5684,4281,-1403
2018,1,11,3,4190,5300,3985,-1315
2018,1,11,4,3822,4752,3567,-1185
2018,1,11,5,3426,4231,3120,-1111
2018,1,11,6,3155,3841,2842,-999
2018,1,11,7,3009,3605,2664,-941
2018,1,11,8,2876,3480,2556,-924
2018,1,11,9,2854,3443,2525,-918
2018,1,11,10,2938,3510,2494,-1016
2018,1,11,11,3193,4645,3536,-1109
2018,1,11,12,3747,4487,3231,-1256
2018,1,11,13,3959,4845,3524,-1321
2018,1,11,14,4070,4965,3636,-1329
2018,1,11,15,4234,5107,3764,-1343
2018,1,11,16,4420,5241,3869,-1372
2018,1,11,17,4632,5350,3963,-1387
2018,1,11,18,4747,5434,4036,-1398
2018,1,11,19,4850,5550,4142,-1408
2018,1,11,20,4942,5607,4177,-1430
2018,1,11,21,4984,5659,4214,-1445
2018,1,11,22,4964,5698,4264,-1434
2018,1,11,23,4995,5781,4274,-1507
2018,1,12,0,5065,6113,4514,-1599
2018,1,12,1,4968,6038,4464,-1574
2018,1,12,2,4737,5757,4253,-1504
2018,1,12,3,4405,5348,3946,-1402
2018,1,12,4,4021,4817,3541,-1276
2018,1,12,5,3600,4297,3130,-1167
2018,1,12,6,3168,3882,2894,-988
2018,1,12,7,2987,3637,2697,-940
2018,1,12,8,2845,3506,2585,-921
2018,1,12,9,2808,3473,2550,-923
2018,1,12,10,2911,3545,2606,-939
2018,1,12,11,3139,3888,2848,-1040
2018,1,12,12,3649,4529,3331,-1198
2018,1,12,13,3890,4942,3626,-1316
2018,1,12,14,4008,5107,3769,-1338
2018,1,12,15,4128,5289,3913,-1376
2018,1,12,16,4334,5483,4092,-1391
2018,1,12,17,4447,5597,4185,-1412
2018,1,12,18,4526,5675,4267,-1408
2018,1,12,19,4506,5653,4245,-1408
2018,1,12,20,4514,5606,4239,-1367
2018,1,12,21,4530,5541,4181,-1360
2018,1,12,22,4466,5519,4148,-1371
2018,1,12,23,4419,5629,4194,-1435
2018,1,13,0,4598,5816,4305,-1511
2018,1,13,1,4481,5649,4178,-1471
2018,1,13,2,4216,5381,3975,-1406
2018,1,13,3,3896,5072,3712,-1360
2018,1,13,4,3624,4704,3411,-1293
2018,1,13,5,3429,4298,3115,-1183
2018,1,13,6,3170,3938,2980,-958
2018,1,13,7,2985,3710,2783,-927
2018,1,13,8,2871,3610,2674,-936
2018,1,13,9,2828,3568,2626,-942
2018,1,13,10,2892,3602,2626,-976
2018,1,13,11,3038,3781,2735,-1046
2018,1,13,12,3273,4086,2939,-1147
2018,1,13,13,3649,4542,3181,-1361
2018,1,13,14,4090,5094,3571,-1523
2018,1,13,15,4364,5563,3966,-1597
2018,1,13,16,4330,5758,4220,-1538
2018,1,13,17,4355,5800,4276,-1524
2018,1,13,18,4248,5760,4202,-1558
2018,1,13,19,4180,5706,4165,-1541
2018,1,13,20,4071,5694,4101,-1593
2018,1,13,21,4070,5790,4149,-1641
2018,1,13,22,4066,6006,4312,-1694
2018,1,13,23,4320,6440,4810,-1630
2018,1,14,0,4608,6914,5317,-1597
2018,1,14,1,4809,7014,5518,-1496
2018,1,14,2,4856,7038,5528,-1510
2018,1,14,3,4790,6894,5378,-1516
2018,1,14,4,4760,6733,5215,-1518
2018,1,14,5,4626,6523,4860,-1663
2018,1,14,6,4778,6447,4806,-1641
2018,1,14,7,4812,6474,4846,-1628
2018,1,14,8,4864,6613,4930,-1683
2018,1,14,9,4970,6834,4958,-1876
2018,1,14,10,5119,7144,5066,-2078
2018,1,14,11,5329,7526,5186,-2340
2018,1,14,12,5728,8119,5480,-2639
2018,1,14,13,6420,8799,5931,-2868
2018,1,14,14,6814,9224,6431,-2793
2018,1,14,15,6549,8919,6229,-2690
2018,1,14,16,6219,8165,5714,-2451
2018,1,14,17,5638,7377,5252,-2125
2018,1,14,18,5194,6709,4790,-1919
2018,1,14,19,4820,6200,4327,-1873
2018,1,14,20,4617,5833,4061,-1772
2018,1,14,21,4495,5634,3904,-1730
2018,1,14,22,4504,5706,3953,-1753
2018,1,14,23,4761,6184,4259,-1925
2018,1,15,0,5368,6898,4871,-2027
2018,1,15,1,5655,7035,4768,-2267
2018,1,15,2,5792,7065,4793,-2272
2018,1,15,3,5648,6971,4834,-2137
2018,1,15,4,5416,6693,4493,-2200
2018,1,15,5,5157,6418,4271,-2147
2018,1,15,6,5100,6257,4204,-2053
2018,1,15,7,5060,6234,4222,-2012
2018,1,15,8,5050,6328,4399,-1929
2018,1,15,9,5200,6486,4517,-1969
2018,1,15,10,5418,6746,4647,-2099
2018,1,15,11,5857,7229,5000,-2229
2018,1,15,12,6313,7914,5640,-2274
2018,1,15,13,6703,8460,6095,-2365
2018,1,15,14,6789,8569,6207,-2362
2018,1,15,15,6483,8157,5845,-2312
2018,1,15,16,5854,7574,5388,-2186
2018,1,15,17,5259,6912,4779,-2133
2018,1,15,18,4916,6339,4413,-1926
2018,1,15,19,4595,5904,4150,-1754
2018,1,15,20,4450,5617,3934,-1683
2018,1,15,21,4394,5502,3858,-1644
2018,1,15,22,4417,5582,3920,-1662
2018,1,15,23,4599,6022,4218,-1804
2018,1,16,0,4928,6777,4789,-1988
2018,1,16,1,5098,7018,4875,-2143
2018,1,16,2,5115,7019,4902,-2117
2018,1,16,3,5007,6846,4659,-2187
2018,1,16,4,4780,6500,4343,-2157
2018,1,16,5,4497,6198,4081,-2117
2018,1,16,6,4126,6051,4122,-1929
2018,1,16,7,4055,6044,4104,-1940
2018,1,16,8,4054,6094,4046,-2048
2018,1,16,9,4154,6220,4113,-2107
2018,1,16,10,4355,6488,4245,-2243
2018,1,16,11,4859,7134,4870,-2264
2018,1,16,12,5616,8101,5777,-2324
2018,1,16,13,5918,8489,6251,-2238
2018,1,16,14,5737,8108,6043,-2065
2018,1,16,15,5311,7302,5440,-1862
2018,1,16,16,4979,6600,4763,-1837
2018,1,16,17,4677,5983,4406,-1577
2018,1,16,18,4459,5539,3987,-1552
2018,1,16,19,4238,5362,3953,-1409
2018,1,16,20,4088,5210,3870,-1340
2018,1,16,21,4064,5155,3824,-1331
2018,1,16,22,4084,5227,3870,-1357
2018,1,16,23,4337,5497,3903,-1594
2018,1,17,0,4654,6110,4250,-1860
2018,1,17,1,4778,6257,4370,-1887
2018,1,17,2,4756,6145,4279,-1866
2018,1,17,3,4561,5915,4191,-1724
2018,1,17,4,4279,5554,3889,-1665
2018,1,17,5,3990,5214,3652,-1562
2018,1,17,6,3839,5051,3774,-1257
2018,1,17,7,3765,5029,3783,-1216
2018,1,17,8,3799,5106,3828,-1243
2018,1,17,9,3923,5276,3920,-1312
2018,1,17,10,4147,5597,4189,-1358
2018,1,17,11,4706,6298,4763,-1478
2018,1,17,12,5473,7313,5651,-1590
2018,1,17,13,6001,7796,6009,-1717
2018,1,17,14,5917,7584,5856,-1652
2018,1,17,15,5626,6944,5354,-1515
2018,1,17,16,5232,6381,4918,-1379
2018,1,17,17,4845,5975,4365,-1515
2018,1,17,18,4603,5821,4175,-1549
2018,1,17,19,4388,5770,4134,-1541
2018,1,17,20,4272,5731,4144,-1493
2018,1,17,21,4272,5886,4217,-1570
2018,1,17,22,4336,6244,4507,-1638
2018,1,17,23,4613,6815,5123,-1593
2018,1,18,0,5148,7626,5785,-1744
2018,1,18,1,5559,7969,6027,-1844
2018,1,18,2,5836,8156,6174,-1884
2018,1,18,3,5940,8150,6150,-1900
2018,1,18,4,5944,7968,6012,-1866
2018,1,18,5,5845,7814,5863,-1872
2018,1,18,6,5584,7925,6026,-1899
2018,1,18,7,5872,8259,6120,-2139
2018,1,18,8,6139,8672,6287,-2385
2018,1,18,9,6432,9140,6528,-2612
2018,1,18,10,7223,9782,7001,-2781
2018,1,18,11,8052,10709,7620,-3089
2018,1,18,12,8996,11821,8600,-3221
2018,1,18,13,9055,12443,9225,-3218
2018,1,18,14,8331,12184,8848,-3336
2018,1,18,15,7641,11474,8231,-3243
2018,1,18,16,6792,10577,7619,-2958
2018,1,18,17,6150,9583,7006,-2577
2018,1,18,18,5713,8738,6588,-2150
2018,1,18,19,5535,7924,5973,-1951
2018,1,18,20,5415,7365,5361,-2004
2018,1,18,21,5421,7123,5169,-1954
2018,1,18,22,5378,7247,5143,-2104
2018,1,18,23,5750,7997,5779,-2218
2018,1,19,0,6754,9145,6509,-2636
2018,1,19,1,7163,9604,6852,-2752
2018,1,19,2,7324,9774,6973,-2801
2018,1,19,3,7146,9685,7029,-2656
2018,1,19,4,6944,9366,6772,-2594
2018,1,19,5,6720,9125,6686,-2439
2018,1,19,6,6625,9087,6775,-2312
2018,1,19,7,6728,9219,6853,-2366
2018,1,19,8,6853,9422,6969,-2453
2018,1,19,9,6954,9667,7007,-2660
2018,1,19,10,7184,10024,7212,-2812
2018,1,19,11,7863,10666,7604,-3062
2018,1,19,12,8530,11572,8571,-3001
2018,1,19,13,8803,11834,8933,-2901
2018,1,19,14,8363,11341,8482,-2859
2018,1,19,15,7540,10383,7499,-2884
2018,1,19,16,6778,9285,6630,-2655
2018,1,19,17,6026,8248,5780,-2468
2018,1,19,18,5514,7337,5155,-2182
2018,1,19,19,5064,6596,4658,-1938
2018,1,19,20,4837,6038,4357,-1681
2018,1,19,21,4780,5791,4183,-1608
2018,1,19,22,4817,5828,4189,-1639
2018,1,19,23,5068,6116,4213,-1903
2018,1,20,0,5536,6940,4729,-2211
2018,1,20,1,5717,7243,4988,-2255
2018,1,20,2,5771,7404,5089,-2315
2018,1,20,3,5624,7432,5184,-2248
2018,1,20,4,5411,6863,4614,-2249
2018,1,20,5,5173,7536,5349,-2187
2018,1,20,6,4844,6955,4983,-1972
2018,1,20,7,4681,6979,5023,-1956
2018,1,20,8,4586,7026,5046,-1980
2018,1,20,9,4606,7143,5111,-2032
2018,1,20,10,4774,7318,5098,-2220
2018,1,20,11,5046,7639,5171,-2468
2018,1,20,12,5437,8054,5420,-2634
2018,1,20,13,5814,8538,5820,-2718
2018,1,20,14,5814,8796,6236,-2560
2018,1,20,15,5574,8162,5695,-2467
2018,1,20,16,5112,7361,5053,-2308
2018,1,20,17,4694,6572,4578,-1994
2018,1,20,18,4397,6011,4245,-1766
2018,1,20,19,4132,5665,4156,-1509
2018,1,20,20,3982,5453,4163,-1290
2018,1,20,21,3931,5378,4130,-1248
2018,1,20,22,4004,5418,4154,-1264
2018,1,20,23,4251,5677,4305,-1372
2018,1,21,0,4399,6050,4621,-1429
2018,1,21,1,4453,6007,4585,-1422
2018,1,21,2,4376,5879,4475,-1404
2018,1,21,3,4196,5637,4291,-1346
2018,1,21,4,3963,5346,4076,-1270
2018,1,21,5,3664,4984,3733,-1251
2018,1,21,6,3470,4731,3566,-1165
2018,1,21,7,3282,4569,3438,-1131
2018,1,21,8,3215,4509,3373,-1136
2018,1,21,9,3197,4502,3373,-1129
2018,1,21,10,3279,4600,3430,-1170
2018,1,21,11,3491,4805,3569,-1236
2018,1,21,12,3738,5161,3804,-1357
2018,1,21,13,4030,5584,4134,-1450
2018,1,21,14,4267,5974,4496,-1478
2018,1,21,15,4329,5927,4502,-1425
2018,1,21,16,4231,5691,4326,-1365
2018,1,21,17,4213,5445,4195,-1250
2018,1,21,18,4170,5312,4119,-1193
2018,1,21,19,4142,5227,4082,-1145
2018,1,21,20,4098,5197,4076,-1121
2018,1,21,21,4065,5193,4071,-1122
2018,1,21,22,4127,5246,4113,-1133
2018,1,21,23,4277,5332,4164,-1168
2018,1,22,0,4378,5781,4496,-1285
2018,1,22,1,4373,5760,4493,-1267
2018,1,22,2,4240,5513,4342,-1171
2018,1,22,3,3944,5112,4004,-1108
2018,1,22,4,3584,4619,3634,-985
2018,1,22,5,3347,4135,3207,-928
2018,1,22,6,3088,3813,2951,-862
2018,1,22,7,2935,3656,2811,-845
2018,1,22,8,2831,3612,2765,-847
2018,1,22,9,2857,3671,2802,-869
2018,1,22,10,2989,3830,2902,-928
2018,1,22,11,3360,4326,3255,-1071
2018,1,22,12,3987,5143,3886,-1257
2018,1,22,13,4237,5594,4308,-1286
2018,1,22,14,4267,5581,4331,-1250
2018,1,22,15,4281,5488,4303,-1185
2018,1,22,16,4314,5429,4287,-1142
2018,1,22,17,4336,5418,4284,-1134
2018,1,22,18,4348,5475,4339,-1136
2018,1,22,19,4335,5495,4379,-1116
2018,1,22,20,4361,5570,4446,-1124
2018,1,22,21,4372,5642,4502,-1140
2018,1,22,22,4354,5726,4560,-1166
2018,1,22,23,4468,5865,4624,-1241
2018,1,23,0,4874,6231,4868,-1363
2018,1,23,1,4839,6138,4837,-1301
2018,1,23,2,4498,5835,4612,-1223
2018,1,23,3,4190,5379,4266,-1113
2018,1,23,4,3804,4823,3853,-970
2018,1,23,5,3446,4300,3402,-898
2018,1,23,6,3146,3912,3061,-851
2018,1,23,7,2966,3663,2863,-800
2018,1,23,8,2871,3515,2747,-768
2018,1,23,9,2869,3449,2697,-752
2018,1,23,10,2949,3564,2771,-793
2018,1,23,11,3275,3885,2993,-892
2018,1,23,12,3772,4554,3544,-1010
2018,1,23,13,4085,4946,3865,-1081
2018,1,23,14,4163,5057,3936,-1121
2018,1,23,15,4220,5215,4085,-1130
2018,1,23,16,4324,5450,4292,-1158
2018,1,23,17,4382,5648,4470,-1178
2018,1,23,18,4427,5779,4566,-1213
2018,1,23,19,4440,5836,4632,-1204
2018,1,23,20,4447,5856,4581,-1275
2018,1,23,21,4461,5833,4559,-1274
2018,1,23,22,4452,5783,4614,-1169
2018,1,23,23,4495,5814,4667,-1147
2018,1,24,0,4741,6130,4950,-1180
2018,1,24,1,4724,6105,4935,-1170
2018,1,24,2,4510,5800,4647,-1153
2018,1,24,3,4148,5324,4225,-1099
2018,1,24,4,3748,4806,3767,-1039
2018,1,24,5,3390,4292,3298,-994
2018,1,24,6,3128,3959,3100,-859
2018,1,24,7,3007,3796,2948,-848
2018,1,24,8,2962,3778,2915,-863
2018,1,24,9,3017,3826,2928,-898
2018,1,24,10,3145,4047,3147,-900
2018,1,24,11,3570,4612,3590,-1022
2018,1,24,12,4254,5591,4321,-1270
2018,1,24,13,4722,6182,4798,-1384
2018,1,24,14,4741,6223,4859,-1364
2018,1,24,15,4626,6063,4781,-1282
2018,1,24,16,4533,5788,4543,-1245
2018,1,24,17,4491,5525,4363,-1162
2018,1,24,18,4393,5330,4202,-1128
2018,1,24,19,4290,5208,4120,-1088
2018,1,24,20,4248,5126,4067,-1059
2018,1,24,21,4232,5119,4059,-1060
2018,1,24,22,4240,5213,4125,-1088
2018,1,24,23,4268,5486,4306,-1180
2018,1,25,0,4589,6068,4864,-1204
2018,1,25,1,4677,6180,5002,-1178
2018,1,25,2,4578,6047,4810,-1237
2018,1,25,3,4391,5752,4596,-1156
2018,1,25,4,4114,5316,4219,-1097
2018,1,25,5,3808,4907,3830,-1077
2018,1,25,6,3612,4622,3475,-1147
2018,1,25,7,3620,4527,3380,-1147
2018,1,25,8,3627,4542,3361,-1181
2018,1,25,9,3743,4644,3420,-1224
2018,1,25,10,3909,4894,3551,-1343
2018,1,25,11,4434,5459,3869,-1590
2018,1,25,12,5311,6361,4408,-1953
2018,1,25,13,5797,6840,4852,-1988
2018,1,25,14,5594,6855,4893,-1962
2018,1,25,15,5289,6681,4891,-1790
2018,1,25,16,4872,6379,4801,-1578
2018,1,25,17,4642,6019,4606,-1413
2018,1,25,18,4363,5674,4507,-1167
2018,1,25,19,4338,5404,4325,-1079
2018,1,25,20,4191,5230,4205,-1025
2018,1,25,21,4150,5158,4123,-1035
2018,1,25,22,4199,5226,4171,-1055
2018,1,25,23,4313,5500,4379,-1121
2018,1,26,0,4666,6085,4820,-1265
2018,1,26,1,4755,6242,4939,-1303
2018,1,26,2,4716,6190,4880,-1310
2018,1,26,3,4457,5933,4644,-1289
2018,1,26,4,4144,5555,4278,-1277
2018,1,26,5,3776,5177,3901,-1276
2018,1,26,6,3526,4892,3691,-1201
2018,1,26,7,3471,4831,3629,-1202
2018,1,26,8,3426,4883,3663,-1220
2018,1,26,9,3396,4969,3725,-1244
2018,1,26,10,3516,5183,3867,-1316
2018,1,26,11,3895,6666,5312,-1354
2018,1,26,12,4620,6489,4812,-1677
2018,1,26,13,4977,6874,5173,-1701
2018,1,26,14,4841,6680,5087,-1593
2018,1,26,15,4725,6183,4869,-1314
2018,1,26,16,4526,5784,4595,-1189
2018,1,26,17,4361,5489,4363,-1126
2018,1,26,18,4238,5337,4250,-1087
2018,1,26,19,4252,5169,4132,-1037
2018,1,26,20,4156,5086,4081,-1005
2018,1,26,21,4116,5040,4047,-993
2018,1,26,22,4151,5093,4073,-1020
2018,1,26,23,4255,5185,4140,-1045
2018,1,27,0,4521,5522,4347,-1175
2018,1,27,1,4446,5475,4313,-1162
2018,1,27,2,4363,5298,4181,-1117
2018,1,27,3,4092,5037,3982,-1055
2018,1,27,4,3760,4680,3707,-973
2018,1,27,5,3523,4296,3415,-881
2018,1,27,6,3238,3958,3076,-882
2018,1,27,7,3100,3768,2914,-854
2018,1,27,8,3042,3662,2821,-841
2018,1,27,9,2998,3603,2776,-827
2018,1,27,10,3064,3685,2815,-870
2018,1,27,11,3162,3823,2894,-929
2018,1,27,12,3431,4123,3103,-1020
2018,1,27,13,3816,4529,3427,-1102
2018,1,27,14,4090,4956,3762,-1194
2018,1,27,15,4305,5136,3931,-1205
2018,1,27,16,4248,5174,4000,-1174
2018,1,27,17,4239,5148,3995,-1153
2018,1,27,18,4168,5098,3960,-1138
2018,1,27,19,4109,5021,3889,-1132
2018,1,27,20,4067,4970,3875,-1095
2018,1,27,21,4109,4934,3828,-1106
2018,1,27,22,4118,4978,3870,-1108
2018,1,27,23,4104,5060,3902,-1158
2018,1,28,0,4348,5355,4120,-1235
2018,1,28,1,4335,5271,4080,-1191
2018,1,28,2,4173,5050,3923,-1127
2018,1,28,3,3966,4792,3741,-1051
2018,1,28,4,3677,4424,3439,-985
2018,1,28,5,3338,4062,3170,-892
2018,1,28,6,3120,3721,2925,-796
2018,1,28,7,2914,3490,2739,-751
2018,1,28,8,2793,3360,2605,-755
2018,1,28,9,2778,3332,2582,-750
2018,1,28,10,2730,3323,2567,-756
2018,1,28,11,2814,3439,2634,-805
2018,1,28,12,2952,3679,2795,-884
2018,1,28,13,3176,4003,3035,-968
2018,1,28,14,3583,4488,3417,-1071
2018,1,28,15,3881,4876,3749,-1127
2018,1,28,16,4144,5131,3959,-1172
2018,1,28,17,4286,5290,4057,-1233
2018,1,28,18,4333,5383,4137,-1246
2018,1,28,19,4389,5379,4153,-1226
2018,1,28,20,4375,5362,4142,-1220
2018,1,28,21,4356,5375,4154,-1221
2018,1,28,22,4397,5456,4227,-1229
2018,1,28,23,4398,5629,4327,-1302
2018,1,29,0,4622,5796,4462,-1334
2018,1,29,1,4618,5691,4400,-1291
2018,1,29,2,4384,5387,4188,-1199
2018,1,29,3,4004,5031,3925,-1106
2018,1,29,4,3666,4551,3544,-1007
2018,1,29,5,3280,4059,3169,-890
2018,1,29,6,2990,3696,2880,-816
2018,1,29,7,2827,3462,2690,-772
2018,1,29,8,2716,3351,2604,-747
2018,1,29,9,2696,3315,2564,-751
2018,1,29,10,2806,3427,2656,-771
2018,1,29,11,3138,3840,2953,-887
2018,1,29,12,3632,4524,3492,-1032
2018,1,29,13,3895,4928,3869,-1059
2018,1,29,14,4032,5050,3981,-1069
2018,1,29,15,4103,5212,4109,-1103
2018,1,29,16,4326,5355,4226,-1129
2018,1,29,17,4442,5447,4314,-1133
2018,1,29,18,4464,5447,4117,-1330
2018,1,29,19,4428,5394,4064,-1330
2018,1,29,20,4349,5305,3967,-1338
2018,1,29,21,4265,5263,3911,-1352
2018,1,29,22,4259,5287,3943,-1344
2018,1,29,23,4379,5487,4062,-1425
2018,1,30,0,4596,5881,4525,-1356
2018,1,30,1,4577,5859,4514,-1345
2018,1,30,2,4384,5609,4318,-1291
2018,1,30,3,4083,5238,4032,-1206
2018,1,30,4,3770,4760,3666,-1094
2018,1,30,5,3460,4303,3311,-992
2018,1,30,6,3096,4039,3111,-928
2018,1,30,7,3060,3946,3029,-917
2018,1,30,8,3092,3968,3010,-958
2018,1,30,9,3198,4069,2979,-1090
2018,1,30,10,3420,4350,3104,-1246
2018,1,30,11,3893,4947,3441,-1506
2018,1,30,12,4704,5938,4173,-1765
2018,1,30,13,5205,6586,4681,-1905
2018,1,30,14,5151,6674,4774,-1900
2018,1,30,15,4988,6544,4711,-1833
2018,1,30,16,4727,6314,4602,-1712
2018,1,30,17,4528,5963,4407,-1556
2018,1,30,18,4363,5665,4292,-1373
2018,1,30,19,4263,5417,4139,-1278
2018,1,30,20,4192,5231,4010,-1221
2018,1,30,21,4155,5161,3949,-1212
2018,1,30,22,4208,5279,4020,-1259
2018,1,30,23,4414,5637,4151,-1486
2018,1,31,0,4889,6416,4829,-1587
2018,1,31,1,5091,6772,5130,-1642
2018,1,31,2,5076,6839,5159,-1680
2018,1,31,3,4926,6678,5047,-1631
2018,1,31,4,4693,6434,4788,-1646
2018,1,31,5,4384,6143,4550,-1593
2018,1,31,6,4256,5983,4327,-1656
2018,1,31,7,4161,5979,4285,-1694
2018,1,31,8,4276,6111,4179,-1932
2018,1,31,9,4357,6259,4260,-1999
2018,1,31,10,4614,6581,4436,-2145
2018,1,31,11,5150,7239,4826,-2413
2018,1,31,12,6037,8234,5607,-2627
2018,1,31,13,6549,8599,6014,-2585
2018,1,31,14,6183,8186,5739,-2447
2018,1,31,15,5862,7406,4982,-2424
2018,1,31,16,5230,6682,4562,-2120
2018,1,31,17,4797,6103,4272,-1831
2018,1,31,18,4517,5652,4007,-1645
2018,1,31,19,4357,5359,3819,-1540
2018,1,31,20,4202,5174,3798,-1376
2018,1,31,21,4132,5106,3743,-1363
2018,1,31,22,4174,5165,3766,-1399
2018,1,31,23,4292,5397,3893,-1504
2018,2,1,0,4750,5969,4145,-1824
2018,2,1,1,4896,6147,4245,-1902
2018,2,1,2,4820,6091,4202,-1889
2018,2,1,3,4624,5827,4131,-1696
2018,2,1,4,4337,5450,3945,-1505
2018,2,1,5,4050,5069,3727,-1342
2018,2,1,6,3588,4859,3669,-1190
2018,2,1,7,3458,4816,3607,-1209
2018,2,1,8,3438,4866,3620,-1246
2018,2,1,9,3496,4998,3709,-1289
2018,2,1,10,3660,5269,3971,-1298
2018,2,1,11,4142,5913,4609,-1304
2018,2,1,12,4840,6844,5486,-1358
2018,2,1,13,5186,7224,5863,-1361
2018,2,1,14,5077,6878,5597,-1281
2018,2,1,15,4688,6247,5072,-1175
2018,2,1,16,4597,5737,4564,-1173
2018,2,1,17,4391,5412,4298,-1114
2018,2,1,18,4263,5228,4171,-1057
2018,2,1,19,4171,5135,4088,-1047
2018,2,1,20,4132,5057,4046,-1011
2018,2,1,21,4101,5062,4034,-1028
2018,2,1,22,4126,5145,4083,-1062
2018,2,1,23,4214,5293,4185,-1108
2018,2,2,0,4504,5707,4475,-1232
2018,2,2,1,4551,5806,4529,-1277
2018,2,2,2,4478,5594,4360,-1234
2018,2,2,3,4232,5243,4095,-1148
2018,2,2,4,3866,4756,3716,-1040
2018,2,2,5,3460,4173,3211,-962
2018,2,2,6,3290,3994,3099,-895
2018,2,2,7,3174,3844,2977,-867
2018,2,2,8,3133,3795,2932,-863
2018,2,2,9,3130,3820,2944,-876
2018,2,2,10,3221,3963,3028,-935
2018,2,2,11,3546,4440,3411,-1029
2018,2,2,12,4197,5256,4089,-1167
2018,2,2,13,4510,5657,4529,-1128
2018,2,2,14,4515,5643,4569,-1074
2018,2,2,15,4411,5517,4429,-1088
2018,2,2,16,4349,5461,4328,-1133
2018,2,2,17,4305,5362,4245,-1117
2018,2,2,18,4267,5255,4177,-1078
2018,2,2,19,4247,5214,4179,-1035
2018,2,2,20,4218,5176,4158,-1018
2018,2,2,21,4221,5144,4139,-1005
2018,2,2,22,4215,5188,4173,-1015
2018,2,2,23,4239,5242,4162,-1080
2018,2,3,0,4329,5533,4352,-1181
2018,2,3,1,4390,5570,4359,-1211
2018,2,3,2,4274,5392,4201,-1191
2018,2,3,3,4102,5145,3998,-1147
2018,2,3,4,3886,4871,3749,-1122
2018,2,3,5,3614,4518,3480,-1038
2018,2,3,6,3238,4268,3251,-1017
2018,2,3,7,3104,4135,3134,-1001
2018,2,3,8,3078,4144,3118,-1026
2018,2,3,9,3094,4223,3178,-1045
2018,2,3,10,3219,4350,3250,-1100
2018,2,3,11,3384,4615,3452,-1163
2018,2,3,12,3767,4997,3784,-1213
2018,2,3,13,4140,5490,4254,-1236
2018,2,3,14,4410,5922,4582,-1340
2018,2,3,15,4438,5987,4712,-1275
2018,2,3,16,4281,5818,4601,-1217
2018,2,3,17,4190,5559,4325,-1234
2018,2,3,18,4020,5336,4178,-1158
2018,2,3,19,3948,5169,4096,-1073
2018,2,3,20,3875,5037,3994,-1043
2018,2,3,21,3848,4986,3932,-1054
2018,2,3,22,3864,5041,3963,-1078
2018,2,3,23,3916,5186,4054,-1132
2018,2,4,0,4132,5479,4297,-1182
2018,2,4,1,4142,5451,4267,-1184
2018,2,4,2,4036,5266,4095,-1171
2018,2,4,3,3890,4997,3897,-1100
2018,2,4,4,3681,4674,3637,-1037
2018,2,4,5,3476,4335,3392,-943
2018,2,4,6,3123,4030,3150,-880
2018,2,4,7,2921,3863,2995,-868
2018,2,4,8,2866,3784,2939,-845
2018,2,4,9,2812,3766,2922,-844
2018,2,4,10,2870,3799,2914,-885
2018,2,4,11,2942,3931,2991,-940
2018,2,4,12,3188,4189,3162,-1027
2018,2,4,13,3451,4499,3429,-1070
2018,2,4,14,3766,4880,3737,-1143
2018,2,4,15,3896,5138,3997,-1141
2018,2,4,16,4025,5248,4122,-1126
2018,2,4,17,4082,5338,4218,-1120
2018,2,4,18,4125,5408,4264,-1144
2018,2,4,19,4066,5429,4294,-1135
2018,2,4,20,4109,5420,4282,-1138
2018,2,4,21,4094,5452,4301,-1151
2018,2,4,22,4164,5587,4413,-1174
2018,2,4,23,4190,5706,4494,-1212
2018,2,5,0,4342,5721,4520,-1201
2018,2,5,1,4280,5439,4296,-1143
2018,2,5,2,4064,5175,4068,-1107
2018,2,5,3,3819,4884,3853,-1031
2018,2,5,4,3531,4552,3601,-951
2018,2,5,5,3272,4208,3376,-832
2018,2,5,6,2959,3901,3125,-776
2018,2,5,7,2798,3638,2902,-736
2018,2,5,8,2705,3532,2824,-708
2018,2,5,9,2654,3514,2797,-717
2018,2,5,10,2699,3630,2867,-763
2018,2,5,11,3063,4028,3187,-841
2018,2,5,12,3592,4748,3806,-942
2018,2,5,13,3910,5169,4230,-939
2018,2,5,14,4037,5319,4342,-977
2018,2,5,15,4106,5403,4382,-1021
2018,2,5,16,4195,5459,4442,-1017
2018,2,5,17,4209,5494,4441,-1053
2018,2,5,18,4236,5511,4414,-1097
2018,2,5,19,4250,5541,4459,-1082
2018,2,5,20,4269,5526,4453,-1073
2018,2,5,21,4248,5540,4484,-1056
2018,2,5,22,4260,5586,4537,-1049
2018,2,5,23,4291,5645,4596,-1049
2018,2,6,0,4565,5956,4910,-1046
2018,2,6,1,4602,6029,4950,-1079
2018,2,6,2,4388,5754,4742,-1012
2018,2,6,3,4088,5331,4323,-1008
2018,2,6,4,3738,4816,3814,-1002
2018,2,6,5,3299,4370,3462,-908
2018,2,6,6,2960,3901,2981,-920
2018,2,6,7,2747,3748,2845,-903
2018,2,6,8,2636,3734,2816,-918
2018,2,6,9,2627,3810,2862,-948
2018,2,6,10,2718,3987,2963,-1024
2018,2,6,11,3106,4486,3328,-1158
2018,2,6,12,3722,5342,4059,-1283
2018,2,6,13,4095,5757,4478,-1279
2018,2,6,14,4119,5672,4403,-1269
2018,2,6,15,4118,5432,4272,-1160
2018,2,6,16,4145,5303,4357,-946
2018,2,6,17,4224,5302,4385,-917
2018,2,6,18,4264,5365,4391,-974
2018,2,6,19,4262,5453,4514,-939
2018,2,6,20,4302,5566,4618,-948
2018,2,6,21,4337,5694,4712,-982
2018,2,6,22,4402,5789,4785,-1004
2018,2,6,23,4381,5828,4771,-1057
2018,2,7,0,4675,6077,4824,-1253
2018,2,7,1,4741,6085,4838,-1247
2018,2,7,2,4529,5787,4714,-1073
2018,2,7,3,4199,5335,4390,-945
2018,2,7,4,3804,4732,3819,-913
2018,2,7,5,3356,4187,3343,-844
2018,2,7,6,3086,3776,2931,-845
2018,2,7,7,2863,3532,2702,-830
2018,2,7,8,2750,3405,2609,-796
2018,2,7,9,2717,3354,2560,-794
2018,2,7,10,2794,3457,2640,-817
2018,2,7,11,3062,3815,2890,-925
2018,2,7,12,3636,4521,3437,-1084
2018,2,7,13,3952,4862,3737,-1125
2018,2,7,14,4055,4980,3853,-1127
2018,2,7,15,4138,5128,3970,-1158
2018,2,7,16,4296,5309,4127,-1182
2018,2,7,17,4482,5472,4276,-1196
2018,2,7,18,4609,5659,4407,-1252
2018,2,7,19,4756,5821,4538,-1283
2018,2,7,20,4871,5977,4669,-1308
2018,2,7,21,4944,6067,4772,-1295
2018,2,7,22,5011,6129,4833,-1296
2018,2,7,23,4894,6182,4934,-1248
2018,2,8,0,4994,6383,4996,-1387
2018,2,8,1,4982,6354,4958,-1396
2018,2,8,2,4727,6019,4719,-1300
2018,2,8,3,4369,5673,4498,-1175
2018,2,8,4,4036,4965,3917,-1048
2018,2,8,5,3478,4401,3517,-884
2018,2,8,6,3168,3929,3121,-808
2018,2,8,7,2992,3651,2882,-769
2018,2,8,8,2812,3501,2761,-740
2018,2,8,9,2752,3420,2695,-725
2018,2,8,10,2823,3525,2756,-769
2018,2,8,11,3092,3892,3019,-873
2018,2,8,12,3636,4538,3504,-1034
2018,2,8,13,4020,4903,3817,-1086
2018,2,8,14,4125,5086,3970,-1116
2018,2,8,15,4227,5262,4091,-1171
2018,2,8,16,4348,5488,4301,-1187
2018,2,8,17,4482,5695,4478,-1217
2018,2,8,18,4541,5873,4636,-1237
2018,2,8,19,4558,5903,4675,-1228
2018,2,8,20,4570,5896,4694,-1202
2018,2,8,21,4585,5874,4646,-1228
2018,2,8,22,4594,5814,4607,-1207
2018,2,8,23,4586,5802,4530,-1272
2018,2,9,0,4842,6043,4678,-1365
2018,2,9,1,4852,6036,4639,-1397
2018,2,9,2,4606,5731,4426,-1305
2018,2,9,3,4248,5293,4054,-1239
2018,2,9,4,3848,4748,3643,-1105
2018,2,9,5,3336,4227,3272,-955
2018,2,9,6,3045,3834,2999,-835
2018,2,9,7,2850,3586,2781,-805
2018,2,9,8,2692,3469,2680,-789
2018,2,9,9,2635,3449,2657,-792
2018,2,9,10,2693,3551,2691,-860
2018,2,9,11,2992,3904,2956,-948
2018,2,9,12,3554,4584,3470,-1114
2018,2,9,13,3830,4936,3803,-1133
2018,2,9,14,3978,5089,3946,-1143
2018,2,9,15,4100,5285,4121,-1164
2018,2,9,16,4250,5491,4313,-1178
2018,2,9,17,4423,5688,4486,-1202
2018,2,9,18,4575,5869,4644,-1225
2018,2,9,19,4697,6062,4816,-1246
2018,2,9,20,4783,6177,4901,-1276
2018,2,9,21,4812,6271,4954,-1317
2018,2,9,22,4829,6291,4981,-1310
2018,2,9,23,4776,6187,4907,-1280
2018,2,10,0,4809,6246,4914,-1332
2018,2,10,1,4844,6130,4816,-1314
2018,2,10,2,4659,5809,4566,-1243
2018,2,10,3,4316,5449,4273,-1176
2018,2,10,4,3928,5008,3933,-1075
2018,2,10,5,3655,4541,3567,-974
2018,2,10,6,3347,4105,3172,-933
2018,2,10,7,3100,3769,2901,-868
2018,2,10,8,2919,3584,2754,-830
2018,2,10,9,2815,3468,2657,-811
2018,2,10,10,2811,3487,2668,-819
2018,2,10,11,2980,3594,2744,-850
2018,2,10,12,3218,3852,2942,-910
2018,2,10,13,3446,4194,3201,-993
2018,2,10,14,3802,4700,3608,-1092
2018,2,10,15,4064,5170,3864,-1306
2018,2,10,16,4311,5527,4019,-1508
2018,2,10,17,4592,5822,4158,-1664
2018,2,10,18,4861,6073,4363,-1710
2018,2,10,19,5004,6306,4542,-1764
2018,2,10,20,5106,6463,4674,-1789
2018,2,10,21,5177,6542,4725,-1817
2018,2,10,22,5211,6482,4691,-1791
2018,2,10,23,5172,6290,4546,-1744
2018,2,11,0,5032,6293,4536,-1757
2018,2,11,1,4874,6161,4441,-1720
2018,2,11,2,4584,5828,4258,-1570
2018,2,11,3,4348,5440,4110,-1330
2018,2,11,4,4089,5006,3765,-1241
2018,2,11,5,3774,4553,3541,-1012
2018,2,11,6,3463,4145,3255,-890
2018,2,11,7,3264,3835,3015,-820
2018,2,11,8,3130,3626,2834,-792
2018,2,11,9,3036,3506,2733,-773
2018,2,11,10,3000,3476,2709,-767
2018,2,11,11,3003,3541,2730,-811
2018,2,11,12,3094,3743,2870,-873
2018,2,11,13,3312,4025,3101,-924
2018,2,11,14,3698,4611,3575,-1036
2018,2,11,15,4140,5245,3956,-1289
2018,2,11,16,4473,5684,4165,-1519
2018,2,11,17,4778,6062,4418,-1644
2018,2,11,18,4979,6386,4673,-1713
2018,2,11,19,5126,6675,4938,-1737
2018,2,11,20,5250,6849,5131,-1718
2018,2,11,21,5302,6971,5150,-1821
2018,2,11,22,5306,7000,5164,-1836
2018,2,11,23,5244,6917,5175,-1742
2018,2,12,0,5272,6931,5209,-1722
2018,2,12,1,5176,6889,5157,-1732
2018,2,12,2,4880,6481,4872,-1609
2018,2,12,3,4514,5992,4560,-1432
2018,2,12,4,4131,5390,4109,-1281
2018,2,12,5,3705,4771,3739,-1032
2018,2,12,6,3426,4278,3326,-952
2018,2,12,7,3181,3967,3047,-920
2018,2,12,8,3055,3767,2886,-881
2018,2,12,9,2995,3660,2789,-871
2018,2,12,10,3058,3683,2794,-889
2018,2,12,11,3312,4033,3051,-982
2018,2,12,12,3821,4681,3513,-1168
2018,2,12,13,4120,5065,3966,-1099
2018,2,12,14,4372,5320,4191,-1129
2018,2,12,15,4654,5678,4326,-1352
2018,2,12,16,4919,6052,4472,-1580
2018,2,12,17,5197,6441,4748,-1693
2018,2,12,18,5414,6773,4961,-1812
2018,2,12,19,5586,7030,5328,-1702
2018,2,12,20,5677,7166,5505,-1661
2018,2,12,21,5712,7246,5667,-1579
2018,2,12,22,5626,7267,5753,-1514
2018,2,12,23,5539,7195,5601,-1594
2018,2,13,0,5624,7253,5610,-1643
2018,2,13,1,5468,7130,5478,-1652
2018,2,13,2,5110,6691,5025,-1666
2018,2,13,3,4774,6111,4585,-1526
2018,2,13,4,4326,5464,4074,-1390
2018,2,13,5,3778,4820,3659,-1161
2018,2,13,6,3422,4355,3375,-980
2018,2,13,7,3154,4039,3180,-859
2018,2,13,8,3041,3856,3058,-798
2018,2,13,9,2979,3796,2967,-829
2018,2,13,10,3012,3840,2987,-853
2018,2,13,11,3291,4171,3272,-899
2018,2,13,12,3796,4809,3776,-1033
2018,2,13,13,4100,5170,4067,-1103
2018,2,13,14,4266,5365,4207,-1158
2018,2,13,15,4521,5620,4285,-1335
2018,2,13,16,4788,5938,4401,-1537
2018,2,13,17,5103,6245,4637,-1608
2018,2,13,18,5353,6520,4769,-1751
2018,2,13,19,5546,6780,5035,-1745
2018,2,13,20,5677,6868,5099,-1769
2018,2,13,21,5750,6795,5118,-1677
2018,2,13,22,5719,6688,5017,-1671
2018,2,13,23,5613,6638,4960,-1678
2018,2,14,0,5563,6738,4942,-1796
2018,2,14,1,5429,6686,4950,-1736
2018,2,14,2,5030,6316,4733,-1583
2018,2,14,3,4708,5804,4373,-1431
2018,2,14,4,4262,5183,3717,-1466
2018,2,14,5,3741,4571,3375,-1196
2018,2,14,6,3294,4082,3088,-994
2018,2,14,7,3047,3798,3007,-791
2018,2,14,8,2934,3655,2892,-763
2018,2,14,9,2892,3586,2825,-761
2018,2,14,10,2916,3656,2864,-792
2018,2,14,11,3189,4011,3134,-877
2018,2,14,12,3671,4661,3631,-1030
2018,2,14,13,3954,5007,3968,-1039
2018,2,14,14,4106,5116,4072,-1044
2018,2,14,15,4278,5234,4040,-1194
2018,2,14,16,4455,5389,4023,-1366
2018,2,14,17,4637,5546,4098,-1448
2018,2,14,18,4782,5706,4226,-1480
2018,2,14,19,4914,5935,4410,-1525
2018,2,14,20,5063,6144,4563,-1581
2018,2,14,21,5183,6328,4695,-1633
2018,2,14,22,5169,6438,4806,-1632
2018,2,14,23,5081,6388,4743,-1645
2018,2,15,0,5066,6388,4714,-1674
2018,2,15,1,5089,6353,4712,-1641
2018,2,15,2,4766,6014,4533,-1481
2018,2,15,3,4443,5540,4180,-1360
2018,2,15,4,4002,4969,3677,-1292
2018,2,15,5,3520,4406,3326,-1080
2018,2,15,6,3156,3966,3055,-911
2018,2,15,7,2918,3723,2959,-764
2018,2,15,8,2818,3562,2835,-727
2018,2,15,9,2805,3502,2773,-729
2018,2,15,10,2835,3572,2817,-755
2018,2,15,11,3076,3893,3080,-813
2018,2,15,12,3611,4529,3659,-870
2018,2,15,13,3874,4829,4009,-820
2018,2,15,14,4023,5000,4164,-836
2018,2,15,15,4223,5139,4164,-975
2018,2,15,16,4458,5419,4214,-1205
2018,2,15,17,4754,5720,4419,-1301
2018,2,15,18,5015,6069,4669,-1400
2018,2,15,19,5239,6409,4956,-1453
2018,2,15,20,5311,6653,5157,-1496
2018,2,15,21,5368,6812,5221,-1591
2018,2,15,22,5274,6904,5354,-1550
2018,2,15,23,5186,6581,5042,-1539
2018,2,16,0,5193,6501,4957,-1544
2018,2,16,1,5162,6424,4868,-1556
2018,2,16,2,4874,6054,4619,-1435
2018,2,16,3,4511,5560,4290,-1270
2018,2,16,4,4059,4936,3748,-1188
2018,2,16,5,3528,4326,3252,-1074
2018,2,16,6,3087,4030,3112,-918
2018,2,16,7,2807,3712,2951,-761
2018,2,16,8,2763,3549,2804,-745
2018,2,16,9,2745,3465,2735,-730
2018,2,16,10,2790,3519,2762,-757
2018,2,16,11,2868,3806,2976,-830
2018,2,16,12,3333,4420,3514,-906
2018,2,16,13,3644,4777,3893,-884
2018,2,16,14,3873,5016,4138,-878
2018,2,16,15,4119,5306,4271,-1035
2018,2,16,16,4395,5621,4384,-1237
2018,2,16,17,4653,6063,4696,-1367
2018,2,16,18,4820,6300,4850,-1450
2018,2,16,19,5006,6555,5053,-1502
2018,2,16,20,5092,6716,5203,-1513
2018,2,16,21,5204,6842,5429,-1413
2018,2,16,22,5153,6821,5399,-1422
2018,2,16,23,5059,6637,5302,-1335
2018,2,17,0,4987,6430,5060,-1370
2018,2,17,1,4918,6289,4789,-1500
2018,2,17,2,4591,5892,4474,-1418
2018,2,17,3,4320,5459,4153,-1306
2018,2,17,4,3990,4968,3695,-1273
2018,2,17,5,3513,4443,3374,-1069
2018,2,17,6,3190,4025,3048,-977
2018,2,17,7,2930,3697,2884,-813
2018,2,17,8,2818,3523,2764,-759
2018,2,17,9,2760,3443,2676,-767
2018,2,17,10,2784,3451,2672,-779
2018,2,17,11,2814,3520,2712,-808
2018,2,17,12,3023,3763,2882,-881
2018,2,17,13,3226,4084,3216,-868
2018,2,17,14,3612,4578,3687,-891
2018,2,17,15,3880,4990,4047,-943
2018,2,17,16,4106,5330,4353,-977
2018,2,17,17,4310,5605,4573,-1032
2018,2,17,18,4488,5928,4809,-1119
2018,2,17,19,4646,6171,5033,-1138
2018,2,17,20,4740,6416,5124,-1292
2018,2,17,21,4846,6583,5243,-1340
2018,2,17,22,4895,6607,5334,-1273
2018,2,17,23,4723,6408,5135,-1273
2018,2,18,0,4698,6234,5030,-1204
2018,2,18,1,4728,6075,4970,-1105
2018,2,18,2,4510,5698,4671,-1027
2018,2,18,3,4172,5251,4274,-977
2018,2,18,4,3883,4761,3811,-950
2018,2,18,5,3449,4285,3361,-924
2018,2,18,6,3177,3858,3011,-847
2018,2,18,7,2949,3582,2795,-787
2018,2,18,8,2824,3398,2659,-739
2018,2,18,9,2768,3322,2560,-762
2018,2,18,10,2706,3312,2552,-760
2018,2,18,11,2663,3389,2596,-793
2018,2,18,12,2904,3602,2758,-844
2018,2,18,13,3224,3902,3059,-843
2018,2,18,14,3613,4436,3517,-919
2018,2,18,15,3869,4897,3948,-949
2018,2,18,16,4046,5212,4228,-984
2018,2,18,17,4129,5483,4450,-1033
2018,2,18,18,4236,5817,4700,-1117
2018,2,18,19,4417,6207,5007,-1200
2018,2,18,20,4601,6526,5152,-1374
2018,2,18,21,4806,6727,5155,-1572
2018,2,18,22,4812,6777,5187,-1590
2018,2,18,23,4770,6600,5025,-1575
2018,2,19,0,4772,6450,4924,-1526
2018,2,19,1,4817,6369,4874,-1495
2018,2,19,2,4533,5973,4805,-1168
2018,2,19,3,4228,5490,4474,-1016
2018,2,19,4,3837,4968,3989,-979
2018,2,19,5,3387,4427,3488,-939
2018,2,19,6,3150,4015,3118,-897
2018,2,19,7,2974,3702,2876,-826
2018,2,19,8,2923,3532,2738,-794
2018,2,19,9,2863,3470,2681,-789
2018,2,19,10,2956,3529,2719,-810
2018,2,19,11,3208,3755,2873,-882
2018,2,19,12,3673,4231,3299,-932
2018,2,19,13,3930,4603,3650,-953
2018,2,19,14,4075,5012,3955,-1057
2018,2,19,15,4384,5460,4227,-1233
2018,2,19,16,4663,5597,4187,-1410
2018,2,19,17,4888,5984,4529,-1455
2018,2,19,18,5130,6618,5081,-1537
2018,2,19,19,5284,6919,5335,-1584
2018,2,19,20,5418,7154,5464,-1690
2018,2,19,21,5489,7298,5656,-1642
2018,2,19,22,5483,7335,5699,-1636
2018,2,19,23,5424,7219,5608,-1611
2018,2,20,0,5433,7086,5511,-1575
2018,2,20,1,5356,7045,5536,-1509
2018,2,20,2,5060,6665,5159,-1506
2018,2,20,3,4652,6110,4719,-1391
2018,2,20,4,4142,5448,4122,-1326
2018,2,20,5,3701,4794,3660,-1134
2018,2,20,6,3376,4268,3237,-1031
2018,2,20,7,3116,3960,3082,-878
2018,2,20,8,3007,3771,2928,-843
2018,2,20,9,2942,3669,2847,-822
2018,2,20,10,2998,3695,2856,-839
2018,2,20,11,3262,4000,3080,-920
2018,2,20,12,3734,4640,3622,-1018
2018,2,20,13,3998,5012,4053,-959
2018,2,20,14,4168,5361,4380,-981
2018,2,20,15,4395,5748,4546,-1202
2018,2,20,16,4714,6191,4779,-1412
2018,2,20,17,5032,6630,5080,-1550
2018,2,20,18,5358,6710,4943,-1767
2018,2,20,19,5654,7002,5218,-1784
2018,2,20,20,5779,7562,5706,-1856
2018,2,20,21,5936,7737,5815,-1922
2018,2,20,22,5958,7762,5747,-2015
2018,2,20,23,5926,7617,5639,-1978
2018,2,21,0,5785,7483,5600,-1883
2018,2,21,1,5714,7442,5674,-1768
2018,2,21,2,5356,6999,5388,-1611
2018,2,21,3,4921,6400,4943,-1457
2018,2,21,4,4406,5774,4440,-1334
2018,2,21,5,3912,5115,3930,-1185
2018,2,21,6,3623,4599,3520,-1079
2018,2,21,7,3327,4270,3363,-907
2018,2,21,8,3192,4071,3211,-860
2018,2,21,9,3100,3971,3133,-838
2018,2,21,10,3118,3996,3131,-865
2018,2,21,11,3376,4291,3351,-940
2018,2,21,12,3842,4879,3906,-973
2018,2,21,13,4111,5220,4279,-941
2018,2,21,14,4349,5571,4644,-927
2018,2,21,15,4683,6054,4900,-1154
2018,2,21,16,5012,6513,5106,-1407
2018,2,21,17,5428,6898,5393,-1505
2018,2,21,18,5746,7265,5588,-1677
2018,2,21,19,6003,7582,5878,-1704
2018,2,21,20,6210,7904,6224,-1680
2018,2,21,21,6320,8073,6402,-1671
2018,2,21,22,6364,8070,6406,-1664
2018,2,21,23,6220,7861,6233,-1628
2018,2,22,0,6104,7603,6041,-1562
2018,2,22,1,5926,7478,5878,-1600
2018,2,22,2,5568,7028,5523,-1505
2018,2,22,3,5102,6435,5023,-1412
2018,2,22,4,4564,5719,4404,-1315
2018,2,22,5,3997,5040,3933,-1107
2018,2,22,6,3603,4483,3438,-1045
2018,2,22,7,3291,4130,3253,-877
2018,2,22,8,3118,3892,3071,-821
2018,2,22,9,3030,3768,2969,-799
2018,2,22,10,3025,3783,2977,-806
2018,2,22,11,3332,4079,3288,-791
2018,2,22,12,3745,4706,3774,-932
2018,2,22,13,4029,5037,4087,-950
2018,2,22,14,4213,5301,4365,-936
2018,2,22,15,4522,5708,4584,-1124
2018,2,22,16,4851,6125,4780,-1345
2018,2,22,17,5280,6553,5097,-1456
2018,2,22,18,5483,6954,5383,-1571
2018,2,22,19,5664,7335,5666,-1669
2018,2,22,20,5878,7578,5884,-1694
2018,2,22,21,5998,7693,6019,-1674
2018,2,22,22,6005,7671,5996,-1675
2018,2,22,23,5787,7482,5809,-1673
2018,2,23,0,5801,7309,5631,-1678
2018,2,23,1,5555,7246,5587,-1659
2018,2,23,2,5201,6861,5354,-1507
2018,2,23,3,4818,6303,4927,-1376
2018,2,23,4,4329,5601,4330,-1271
2018,2,23,5,3782,4918,3824,-1094
2018,2,23,6,3451,4382,3330,-1052
2018,2,23,7,3170,4016,3139,-877
2018,2,23,8,3016,3812,2976,-836
2018,2,23,9,2936,3695,2922,-773
2018,2,23,10,2959,3724,2926,-798
2018,2,23,11,3202,4011,3115,-896
2018,2,23,12,3648,4615,3620,-995
2018,2,23,13,3927,4968,3968,-1000
2018,2,23,14,4130,5279,4256,-1023
2018,2,23,15,4424,5670,4495,-1175
2018,2,23,16,4720,6124,4760,-1364
2018,2,23,17,5002,6508,5027,-1481
2018,2,23,18,5271,6839,5233,-1606
2018,2,23,19,5449,7163,5484,-1679
2018,2,23,20,5618,7409,5641,-1768
2018,2,23,21,5718,7485,5695,-1790
2018,2,23,22,5685,7497,5737,-1760
2018,2,23,23,5540,7227,5520,-1707
2018,2,24,0,5493,6948,5355,-1593
2018,2,24,1,5298,6781,5253,-1528
2018,2,24,2,4976,6345,4915,-1430
2018,2,24,3,4617,5883,4540,-1343
2018,2,24,4,4216,5377,4121,-1256
2018,2,24,5,3733,4843,3831,-1012
2018,2,24,6,3449,4353,3483,-870
2018,2,24,7,3177,4001,3231,-770
2018,2,24,8,3039,3763,3015,-748
2018,2,24,9,2929,3626,2894,-732
2018,2,24,10,2920,3570,2846,-724
2018,2,24,11,2941,3667,2884,-783
2018,2,24,12,3153,3906,3147,-759
2018,2,24,13,3368,4255,3533,-722
2018,2,24,14,3759,4839,3998,-841
2018,2,24,15,4153,5387,4323,-1064
2018,2,24,16,4536,5846,4686,-1160
2018,2,24,17,4840,6240,4940,-1300
2018,2,24,18,5129,6612,5258,-1354
2018,2,24,19,5305,6901,5474,-1427
2018,2,24,20,5464,7132,5685,-1447
2018,2,24,21,5632,7226,5732,-1494
2018,2,24,22,5636,7251,5759,-1492
2018,2,24,23,5511,7034,5630,-1404
2018,2,25,0,5413,6803,5416,-1387
2018,2,25,1,5198,6600,5258,-1342
2018,2,25,2,4925,6191,4948,-1243
2018,2,25,3,4577,5779,4681,-1098
2018,2,25,4,4210,5309,4178,-1131
2018,2,25,5,3807,4791,3789,-1002
2018,2,25,6,3559,4271,3389,-882
2018,2,25,7,3258,3954,3168,-786
2018,2,25,8,3103,3745,2961,-784
2018,2,25,9,3000,3630,2858,-772
2018,2,25,10,2962,3603,2859,-744
2018,2,25,11,2992,3662,2910,-752
2018,2,25,12,3113,3857,3160,-697
2018,2,25,13,3302,4160,3439,-721
2018,2,25,14,3774,4828,3955,-873
2018,2,25,15,4335,5460,4347,-1113
2018,2,25,16,4765,6018,4809,-1209
2018,2,25,17,5108,6517,5164,-1353
2018,2,25,18,5389,6982,5555,-1427
2018,2,25,19,5623,7300,5768,-1532
2018,2,25,20,5814,7522,5948,-1574
2018,2,25,21,5964,7676,6083,-1593
2018,2,25,22,6082,7646,6007,-1639
2018,2,25,23,5974,7420,5744,-1676
2018,2,26,0,5972,7222,5724,-1498
2018,2,26,1,5766,7158,5672,-1486
2018,2,26,2,5424,6674,5338,-1336
2018,2,26,3,4965,6122,4933,-1189
2018,2,26,4,4518,5518,4343,-1175
2018,2,26,5,4021,4862,3895,-967
2018,2,26,6,3494,4357,3503,-854
2018,2,26,7,3200,4045,3299,-746
2018,2,26,8,3036,3814,3062,-752
2018,2,26,9,3016,3755,3008,-747
2018,2,26,10,3007,3792,3028,-764
2018,2,26,11,3271,4140,3306,-834
2018,2,26,12,3721,4780,3874,-906
2018,2,26,13,4015,5128,4290,-838
2018,2,26,14,4300,5448,4539,-909
2018,2,26,15,4689,5891,4793,-1098
2018,2,26,16,5072,6439,5257,-1182
2018,2,26,17,5433,6936,5628,-1308
2018,2,26,18,5667,7380,6053,-1327
2018,2,26,19,5961,7691,6252,-1439
2018,2,26,20,6134,7929,6554,-1375
2018,2,26,21,6220,8014,6632,-1382
2018,2,26,22,6287,7969,6625,-1344
2018,2,26,23,6177,7729,6412,-1317
2018,2,27,0,6041,7596,6235,-1361
2018,2,27,1,5900,7512,6108,-1404
2018,2,27,2,5500,7077,5713,-1364
2018,2,27,3,5062,6407,5233,-1174
2018,2,27,4,4534,5701,4541,-1160
2018,2,27,5,3989,5062,4049,-1013
2018,2,27,6,3572,4686,3777,-909
2018,2,27,7,3265,4361,3575,-786
2018,2,27,8,3086,4127,3343,-784
2018,2,27,9,2996,3728,2964,-764
2018,2,27,10,3014,4028,3236,-792
2018,2,27,11,3269,4332,3435,-897
2018,2,27,12,3712,4937,4020,-917
2018,2,27,13,3997,5249,4388,-861
2018,2,27,14,4192,5434,4546,-888
2018,2,27,15,4470,5686,4670,-1016
2018,2,27,16,4728,6066,4873,-1193
2018,2,27,17,5036,6389,5103,-1286
2018,2,27,18,5190,6757,5414,-1343
2018,2,27,19,5408,7049,5707,-1342
2018,2,27,20,5526,7287,5750,-1537
2018,2,27,21,5613,7353,5768,-1585
2018,2,27,22,5653,7313,5738,-1575
2018,2,27,23,5541,7135,5671,-1464
2018,2,28,0,5416,6962,5542,-1420
2018,2,28,1,5394,6922,5542,-1380
2018,2,28,2,5121,6536,5374,-1162
2018,2,28,3,4710,5965,4836,-1129
2018,2,28,4,4207,5306,4231,-1075
2018,2,28,5,3710,4689,3760,-929
2018,2,28,6,3343,4046,3255,-791
2018,2,28,7,3060,3775,3070,-705
2018,2,28,8,2913,3617,2916,-701
2018,2,28,9,2812,3544,2852,-692
2018,2,28,10,2834,3614,2878,-736
2018,2,28,11,3113,3908,3086,-822
2018,2,28,12,3577,4506,3653,-853
2018,2,28,13,3846,4825,3986,-839
2018,2,28,14,4024,5013,4143,-870
2018,2,28,15,4260,5260,4281,-979
2018,2,28,16,4574,5619,4509,-1110
2018,2,28,17,4885,5969,4818,-1151
2018,2,28,18,5196,9148,7957,-1191
2018,2,28,19,5465,6682,5450,-1232
2018,2,28,20,5651,7036,5687,-1349
2018,2,28,21,5732,7341,5903,-1438
2018,2,28,22,5746,7469,6013,-1456
2018,2,28,23,5646,7346,5924,-1422
2018,3,1,0,5484,7138,5757,-1381
2018,3,1,1,5387,7067,5684,-1383
2018,3,1,2,5129,6677,5360,-1317
2018,3,1,3,4732,6129,4905,-1224
2018,3,1,4,4253,5449,4205,-1244
2018,3,1,5,3797,4789,3816,-973
2018,3,1,6,3400,4298,3388,-910
2018,3,1,7,3136,3970,3159,-811
2018,3,1,8,2974,3798,2984,-814
2018,3,1,9,2930,3693,2907,-786
2018,3,1,10,2948,3757,2939,-818
2018,3,1,11,3218,4056,3165,-891
2018,3,1,12,3670,4669,3758,-911
2018,3,1,13,3966,5009,4119,-890
2018,3,1,14,4186,5333,4384,-949
2018,3,1,15,4484,5695,4539,-1156
2018,3,1,16,4898,6174,4758,-1416
2018,3,1,17,5252,6574,4984,-1590
2018,3,1,18,5565,6939,5291,-1648
2018,3,1,19,5836,7244,5460,-1784
2018,3,1,20,6057,7502,5629,-1873
2018,3,1,21,6197,7663,5762,-1901
2018,3,1,22,6231,7636,5774,-1862
2018,3,1,23,6104,7479,5675,-1804
2018,3,2,0,5812,7322,5585,-1737
2018,3,2,1,5662,7331,5692,-1639
2018,3,2,2,5366,6992,5324,-1668
2018,3,2,3,4969,6465,4995,-1470
2018,3,2,4,4429,5759,4422,-1337
2018,3,2,5,3920,5141,4008,-1133
2018,3,2,6,3632,4651,3604,-1047
2018,3,2,7,3320,4306,3321,-985
2018,3,2,8,3115,4095,3168,-927
2018,3,2,9,2983,3977,3093,-884
2018,3,2,10,3015,3979,3103,-876
2018,3,2,11,3284,4211,3251,-960
2018,3,2,12,3719,4705,3737,-968
2018,3,2,13,3994,4965,4035,-930
2018,3,2,14,4166,5197,4260,-937
2018,3,2,15,4414,5432,4373,-1059
2018,3,2,16,4663,5684,4455,-1229
2018,3,2,17,4906,5908,4512,-1396
2018,3,2,18,5143,6140,4644,-1496
2018,3,2,19,5277,6389,4773,-1616
2018,3,2,20,5396,6597,4933,-1664
2018,3,2,21,5451,6729,5029,-1700
2018,3,2,22,5397,6712,5014,-1698
2018,3,2,23,5178,6528,4908,-1620
2018,3,3,0,4948,6223,4688,-1535
2018,3,3,1,4930,6064,4576,-1488
2018,3,3,2,4632,5693,4284,-1409
2018,3,3,3,4261,5280,4076,-1204
2018,3,3,4,3832,4802,3647,-1155
2018,3,3,5,3490,4322,3278,-1044
2018,3,3,6,3190,3873,3022,-851
2018,3,3,7,2974,3604,2802,-802
2018,3,3,8,2824,3467,2659,-808
2018,3,3,9,2744,3421,2621,-800
2018,3,3,10,2750,3439,2622,-817
2018,3,3,11,2880,3573,2689,-884
2018,3,3,12,3132,3896,2900,-996
2018,3,3,13,3420,4364,3238,-1126
2018,3,3,14,3642,4800,3580,-1220
2018,3,3,15,3852,5029,3898,-1131
2018,3,3,16,3912,5053,3897,-1156
2018,3,3,17,3987,4996,3868,-1128
2018,3,3,18,4031,4974,3865,-1109
2018,3,3,19,4058,4967,3884,-1083
2018,3,3,20,4083,5058,3949,-1109
2018,3,3,21,4119,5132,3993,-1139
2018,3,3,22,4140,5212,4068,-1144
2018,3,3,23,4103,5173,4109,-1064
2018,3,4,0,4087,5189,4026,-1163
2018,3,4,1,4251,5260,4073,-1187
2018,3,4,2,4096,5051,3912,-1139
2018,3,4,3,3832,4766,3680,-1086
2018,3,4,4,3526,4439,3401,-1038
2018,3,4,5,3285,4055,3095,-960
2018,3,4,6,3129,3854,2931,-923
2018,3,4,7,3004,3691,2774,-917
2018,3,4,8,2981,3648,2737,-911
2018,3,4,9,3030,3676,2734,-942
2018,3,4,10,3169,3753,2779,-974
2018,3,4,11,3429,3960,2909,-1051
2018,3,4,12,3728,4353,3271,-1082
2018,3,4,13,4101,4872,3709,-1163
2018,3,4,14,4299,5215,3933,-1282
2018,3,4,15,4339,5278,4134,-1144
2018,3,4,16,4246,5135,4037,-1098
2018,3,4,17,4157,5022,3901,-1121
2018,3,4,18,4088,4961,3811,-1150
2018,3,4,19,4040,4919,3799,-1120
2018,3,4,20,4015,4941,3824,-1117
2018,3,4,21,4014,4983,3860,-1123
2018,3,4,22,4006,5078,3953,-1125
2018,3,4,23,4042,5162,4013,-1149
2018,3,5,0,4107,5366,4151,-1215
2018,3,5,1,4280,5605,4340,-1265
2018,3,5,2,4171,5400,4197,-1203
2018,3,5,3,3891,5056,3936,-1120
2018,3,5,4,3625,4592,3569,-1023
2018,3,5,5,3368,4172,3217,-955
2018,3,5,6,3063,3922,3012,-910
2018,3,5,7,2969,3788,2884,-904
2018,3,5,8,2921,3791,2866,-925
2018,3,5,9,2955,3853,2890,-963
2018,3,5,10,3126,4049,3006,-1043
2018,3,5,11,3624,4623,3513,-1110
2018,3,5,12,4243,5509,4346,-1163
2018,3,5,13,4631,5940,4870,-1070
2018,3,5,14,4541,5785,4790,-995
2018,3,5,15,4430,5492,4463,-1029
2018,3,5,16,4340,5307,4285,-1022
2018,3,5,17,4265,5221,4154,-1067
2018,3,5,18,4212,5174,4094,-1080
2018,3,5,19,4167,5196,4032,-1164
2018,3,5,20,4137,5244,4173,-1071
2018,3,5,21,4144,5304,4038,-1266
2018,3,5,22,4171,5413,4093,-1320
2018,3,5,23,4244,5514,4075,-1439
2018,3,6,0,4319,5665,4161,-1504
2018,3,6,1,4485,5841,4384,-1457
2018,3,6,2,4394,5582,4139,-1443
2018,3,6,3,4110,5111,3824,-1287
2018,3,6,4,3688,4564,3431,-1133
2018,3,6,5,3297,4118,3182,-936
2018,3,6,6,3048,3801,2907,-894
2018,3,6,7,2922,3669,2808,-861
2018,3,6,8,2857,3638,2776,-862
2018,3,6,9,2869,3682,2771,-911
2018,3,6,10,2992,3856,2884,-972
2018,3,6,11,3348,4360,3337,-1023
2018,3,6,12,3920,5174,4090,-1084
2018,3,6,13,4212,5560,4285,-1275
2018,3,6,14,4199,5405,4208,-1197
2018,3,6,15,4196,5218,4047,-1171
2018,3,6,16,4240,5158,3883,-1275
2018,3,6,17,4306,5155,3773,-1382
2018,3,6,18,4368,5224,3809,-1415
2018,3,6,19,4442,5306,3892,-1414
2018,3,6,20,4522,5421,3980,-1441
2018,3,6,21,4612,5511,4098,-1413
2018,3,6,22,4674,5670,4255,-1415
2018,3,6,23,4639,5728,4320,-1408
2018,3,7,0,4616,5905,4458,-1447
2018,3,7,1,4803,6045,4595,-1450
2018,3,7,2,4659,5781,4390,-1391
2018,3,7,3,4278,5332,4003,-1329
2018,3,7,4,3810,4788,3547,-1241
2018,3,7,5,3369,4250,3169,-1081
2018,3,7,6,3039,3841,2886,-955
2018,3,7,7,2842,3616,2804,-812
2018,3,7,8,2750,3521,2730,-791
2018,3,7,9,2767,3521,2740,-781
2018,3,7,10,2868,3591,2786,-805
2018,3,7,11,3000,3910,3007,-903
2018,3,7,12,3514,4504,3486,-1018
2018,3,7,13,3782,4811,3770,-1041
2018,3,7,14,3787,4915,3863,-1052
2018,3,7,15,4016,5016,3807,-1209
2018,3,7,16,4179,5098,3709,-1389
2018,3,7,17,4218,5151,3673,-1478
2018,3,7,18,4259,5229,3723,-1506
2018,3,7,19,4270,5285,3772,-1513
2018,3,7,20,4244,5317,3821,-1496
2018,3,7,21,4283,5360,3853,-1507
2018,3,7,22,4319,5383,3905,-1478
2018,3,7,23,4305,5383,3939,-1444
2018,3,8,0,4329,5569,4136,-1433
2018,3,8,1,4447,5753,4276,-1477
2018,3,8,2,4374,5569,4226,-1343
2018,3,8,3,4094,5223,4034,-1189
2018,3,8,4,3737,4702,3491,-1211
2018,3,8,5,3366,4243,3225,-1018
2018,3,8,6,3093,3922,3017,-905
2018,3,8,7,2990,3774,2852,-922
2018,3,8,8,2956,3739,2800,-939
2018,3,8,9,3095,3809,2834,-975
2018,3,8,10,3186,4034,3080,-954
2018,3,8,11,3718,4541,3429,-1112
2018,3,8,12,4230,5463,4259,-1204
2018,3,8,13,4797,5866,4556,-1310
2018,3,8,14,4658,5830,4524,-1306
2018,3,8,15,4388,5651,4216,-1435
2018,3,8,16,4298,5530,4146,-1384
2018,3,8,17,4229,5415,4101,-1314
2018,3,8,18,4233,5284,3915,-1369
2018,3,8,19,4218,5140,3886,-1254
2018,3,8,20,4197,5045,3829,-1216
2018,3,8,21,4212,5028,3805,-1223
2018,3,8,22,4266,5104,3846,-1258
2018,3,8,23,4252,5312,3926,-1386
2018,3,9,0,4478,5786,4281,-1505
2018,3,9,1,4676,6189,4643,-1546
2018,3,9,2,4660,6141,4621,-1520
2018,3,9,3,4523,5877,4477,-1400
2018,3,9,4,4349,5460,4059,-1401
2018,3,9,5,3927,5026,3759,-1267
2018,3,9,6,3833,4784,3680,-1104
2018,3,9,7,3747,4696,3603,-1093
2018,3,9,8,3787,4700,3577,-1123
2018,3,9,9,3906,4818,3640,-1178
2018,3,9,10,4074,5111,3861,-1250
2018,3,9,11,4576,5748,4218,-1530
2018,3,9,12,5275,6767,4799,-1968
2018,3,9,13,5723,7213,5150,-2063
2018,3,9,14,5420,6838,4929,-1909
2018,3,9,15,5016,6334,4611,-1723
2018,3,9,16,4778,5912,4366,-1546
2018,3,9,17,4464,5570,4241,-1329
2018,3,9,18,4261,5308,4006,-1302
2018,3,9,19,4109,5144,3957,-1187
2018,3,9,20,4106,5050,3905,-1145
2018,3,9,21,4076,5032,3886,-1146
2018,3,9,22,4069,5074,3914,-1160
2018,3,9,23,4047,5119,3845,-1274
2018,3,10,0,4128,5302,3940,-1362
2018,3,10,1,4349,5523,4070,-1453
2018,3,10,2,4301,5435,3996,-1439
2018,3,10,3,4147,5293,3979,-1314
2018,3,10,4,3896,5040,3746,-1294
2018,3,10,5,3763,4767,3617,-1150
2018,3,10,6,3515,4568,3266,-1302
2018,3,10,7,3445,4532,3220,-1312
2018,3,10,8,3424,4572,3235,-1337
2018,3,10,9,3552,4694,3311,-1383
2018,3,10,10,3581,4878,3462,-1416
2018,3,10,11,3857,5204,3682,-1522
2018,3,10,12,4083,5687,3890,-1797
2018,3,10,13,4534,6162,4326,-1836
2018,3,10,14,4540,6157,4497,-1660
2018,3,10,15,4380,5865,4336,-1529
2018,3,10,16,4255,5554,4001,-1553
2018,3,10,17,4008,5306,3841,-1465
2018,3,10,18,3938,5138,3679,-1459
2018,3,10,19,3878,5037,3744,-1293
2018,3,10,20,3878,4965,3724,-1241
2018,3,10,21,3932,4937,3702,-1235
2018,3,10,22,4033,4977,3710,-1267
2018,3,10,23,3993,5074,3619,-1455
2018,3,11,0,4031,5269,3621,-1648
2018,3,11,1,4164,5290,3618,-1672
2018,3,11,2,4082,5115,3500,-1615
2018,3,11,3,3862,4840,3430,-1410
2018,3,11,4,3571,4540,3204,-1336
2018,3,11,5,3308,4163,3031,-1132
2018,3,11,6,-9999,4163,3031,-9999
2018,3,11,7,-9999,4532,3220,-9999
2018,3,11,8,-9999,4572,3235,-9999
2018,3,11,9,-9999,4694,3311,-9999
2018,3,11,10,-9999,4878,3462,-9999
2018,3,11,11,-9999,5204,3682,-9999
2018,3,11,12,-9999,5687,3890,-9999
2018,3,11,13,-9999,6162,4326,-9999
2018,3,11,14,-9999,6157,4497,-9999
2018,3,11,15,-9999,5865,4336,-9999
2018,3,11,16,-9999,5554,4001,-9999
2018,3,11,17,-9999,5306,3841,-9999
2018,3,11,18,-9999,5138,3679,-9999
2018,3,11,19,-9999,5037,3744,-9999
2018,3,11,20,-9999,4965,3724,-9999
2018,3,11,21,-9999,4937,3702,-9999
2018,3,11,22,-9999,4977,3710,-9999
2018,3,11,23,-9999,5074,3619,-9999
2018,3,12,0,-9999,5269,3621,-9999
2018,3,12,1,-9999,5290,3618,-9999
2018,3,12,2,-9999,5115,3500,-9999
2018,3,12,3,-9999,4840,3430,-9999
2018,3,12,4,-9999,4540,3204,-9999
2018,3,12,5,3051,4170,3244,-926
2018,3,12,6,2907,3856,2991,-865
2018,3,12,7,2728,3677,2853,-824
2018,3,12,8,2687,3624,2808,-816
2018,3,12,9,2781,3666,2838,-828
2018,3,12,10,3024,3977,3041,-936
2018,3,12,11,3400,4567,3503,-1064
2018,3,12,12,3722,4945,3909,-1036
2018,3,12,13,3853,5038,3968,-1070
2018,3,12,14,3978,5193,4088,-1105
2018,3,12,15,4126,5370,4229,-1141
2018,3,12,16,4218,5473,4299,-1174
2018,3,12,17,4263,5440,4272,-1168
2018,3,12,18,4288,5374,4229,-1145
2018,3,12,19,4270,5338,4205,-1133
2018,3,12,20,4166,5341,4218,-1123
2018,3,12,21,4170,5402,4258,-1144
2018,3,12,22,4075,5445,4322,-1123
2018,3,12,23,4062,5439,4334,-1105
2018,3,13,0,4212,5578,4495,-1083
2018,3,13,1,4180,5814,4682,-1132
2018,3,13,2,4048,5518,4383,-1135
2018,3,13,3,3690,5061,3956,-1105
2018,3,13,4,3330,4556,3469,-1087
2018,3,13,5,3094,4233,3241,-992
2018,3,13,6,2962,4079,3048,-1031
2018,3,13,7,2926,4061,3001,-1060
2018,3,13,8,2942,4150,3048,-1102
2018,3,13,9,3113,4378,3287,-1091
2018,3,13,10,3475,4959,3683,-1276
2018,3,13,11,4097,5903,4378,-1525
2018,3,13,12,4452,6609,4925,-1684
2018,3,13,13,4598,6746,4995,-1751
2018,3,13,14,4468,6492,4775,-1717
2018,3,13,15,4365,6101,4509,-1592
2018,3,13,16,4233,5759,4238,-1521
2018,3,13,17,4155,5426,3936,-1490
2018,3,13,18,4159,5276,3896,-1380
2018,3,13,19,4018,5134,3849,-1285
2018,3,13,20,3960,5085,3828,-1257
2018,3,13,21,3894,5151,3875,-1276
2018,3,13,22,4058,5240,3836,-1404
2018,3,13,23,4144,5341,3806,-1535
2018,3,14,0,4305,5607,4084,-1523
2018,3,14,1,4404,5938,4347,-1591
2018,3,14,2,4206,5717,4290,-1427
2018,3,14,3,3893,5354,3898,-1456
2018,3,14,4,3613,0,3898,-1328
2018,3,14,5,3355,4639,3417,-1222
2018,3,14,6,3253,4522,3279,-1243
2018,3,14,7,3234,4567,3303,-1264
2018,3,14,8,3301,4717,3429,-1288
2018,3,14,9,3488,4962,3609,-1353
2018,3,14,10,3866,5510,3876,-1634
2018,3,14,11,4500,6369,4745,-1624
2018,3,14,12,4898,6948,5382,-1566
2018,3,14,13,4957,6911,5364,-1547
2018,3,14,14,4721,6519,4973,-1546
2018,3,14,15,4488,6158,4682,-1476
2018,3,14,16,4318,5795,4338,-1457
2018,3,14,17,4216,5511,4063,-1448
2018,3,14,18,4139,5307,3994,-1313
2018,3,14,19,3984,5160,3927,-1233
2018,3,14,20,3924,5095,3850,-1245
2018,3,14,21,3892,5152,3896,-1256
2018,3,14,22,4015,5217,3871,-1346
2018,3,14,23,4106,5304,3874,-1430
2018,3,15,0,4292,5544,4068,-1476
2018,3,15,1,4406,5919,4334,-1585
2018,3,15,2,4244,5732,4286,-1446
2018,3,15,3,3965,5359,3954,-1405
2018,3,15,4,3724,4927,3620,-1307
2018,3,15,5,3566,4705,3571,-1134
2018,3,15,6,3521,4643,3531,-1112
2018,3,15,7,3520,4737,3617,-1120
2018,3,15,8,3592,4908,3727,-1181
2018,3,15,9,3778,5239,3898,-1341
2018,3,15,10,4226,5888,4269,-1619
2018,3,15,11,4980,6857,5165,-1692
2018,3,15,12,5456,7507,5850,-1657
2018,3,15,13,5546,7525,5774,-1751
2018,3,15,14,5139,6967,5244,-1723
2018,3,15,15,4804,6378,4885,-1493
2018,3,15,16,4432,5873,4505,-1368
2018,3,15,17,4192,5510,4278,-1232
2018,3,15,18,4068,5275,4214,-1061
2018,3,15,19,3961,5151,4029,-1122
2018,3,15,20,3965,5073,3935,-1138
2018,3,15,21,4038,5123,3958,-1165
2018,3,15,22,4109,5190,3897,-1293
2018,3,15,23,4138,5218,3829,-1389
2018,3,16,0,4288,5411,4004,-1407
2018,3,16,1,4386,5701,4218,-1483
2018,3,16,2,4191,5537,4179,-1358
2018,3,16,3,3893,5220,3929,-1291
2018,3,16,4,3699,4850,3686,-1164
2018,3,16,5,3435,4647,3421,-1226
2018,3,16,6,3346,4630,3389,-1241
2018,3,16,7,3368,4733,3457,-1276
2018,3,16,8,3444,4941,3613,-1328
2018,3,16,9,3622,5279,3858,-1421
2018,3,16,10,3985,5910,4239,-1671
2018,3,16,11,4657,6816,4969,-1847
2018,3,16,12,5149,7490,5669,-1821
2018,3,16,13,5185,7532,5523,-2009
2018,3,16,14,4883,6935,5101,-1834
2018,3,16,15,4506,6224,4610,-1614
2018,3,16,16,4294,5741,4324,-1417
2018,3,16,17,4063,5399,3978,-1421
2018,3,16,18,3945,5239,3999,-1240
2018,3,16,19,3917,5154,3964,-1190
2018,3,16,20,3970,5183,3973,-1210
2018,3,16,21,4001,5267,4047,-1220
2018,3,16,22,3982,5306,3934,-1372
2018,3,16,23,3903,5258,3756,-1502
2018,3,17,0,4035,5265,3825,-1440
2018,3,17,1,4078,5373,3853,-1520
2018,3,17,2,3765,5135,3755,-1380
2018,3,17,3,3677,4793,3469,-1324
2018,3,17,4,3381,4397,3296,-1101
2018,3,17,5,3054,4074,3003,-1071
2018,3,17,6,2939,3884,2841,-1043
2018,3,17,7,2926,3808,2783,-1025
2018,3,17,8,2927,3837,2778,-1059
2018,3,17,9,3018,3943,2852,-1091
2018,3,17,10,3197,4159,2976,-1183
2018,3,17,11,3447,4582,3312,-1270
2018,3,17,12,3728,5076,3811,-1265
2018,3,17,13,4084,5481,4182,-1299
2018,3,17,14,4127,5478,4233,-1245
2018,3,17,15,4057,5341,4058,-1283
2018,3,17,16,3976,5225,3816,-1409
2018,3,17,17,3916,5182,3661,-1521
2018,3,17,18,3898,5200,3671,-1529
2018,3,17,19,3871,5224,3677,-1547
2018,3,17,20,3990,5368,3829,-1539
2018,3,17,21,4162,5534,3991,-1543
2018,3,17,22,4184,5645,4077,-1568
2018,3,17,23,4152,5573,3905,-1668
2018,3,18,0,4125,5397,3865,-1532
2018,3,18,1,4125,5449,3867,-1582
2018,3,18,2,3888,5144,3692,-1452
2018,3,18,3,3622,4716,3361,-1355
2018,3,18,4,3262,4284,3168,-1116
2018,3,18,5,2993,3872,2898,-974
2018,3,18,6,2790,3585,2754,-831
2018,3,18,7,2690,3429,2604,-825
2018,3,18,8,2602,3382,2567,-815
2018,3,18,9,2575,3415,2597,-818
2018,3,18,10,2606,3516,2653,-863
2018,3,18,11,2720,3719,2804,-915
2018,3,18,12,2920,4030,3049,-981
2018,3,18,13,3269,4446,3421,-1025
2018,3,18,14,3621,4779,3628,-1151
2018,3,18,15,3850,4980,3813,-1167
2018,3,18,16,4030,5155,3841,-1314
2018,3,18,17,4154,5360,3768,-1592
2018,3,18,18,4307,5589,3960,-1629
2018,3,18,19,4523,5852,4214,-1638
2018,3,18,20,4681,6143,4446,-1697
2018,3,18,21,4782,6396,4653,-1743
2018,3,18,22,4937,6573,4768,-1805
2018,3,18,23,4818,6552,4724,-1828
2018,3,19,0,4677,6379,4639,-1740
2018,3,19,1,4706,6334,4664,-1670
2018,3,19,2,4410,5858,4248,-1610
2018,3,19,3,4001,5265,3630,-1635
2018,3,19,4,3567,4616,3394,-1222
2018,3,19,5,3194,4101,3067,-1034
2018,3,19,6,2939,3772,2893,-879
2018,3,19,7,2807,3574,2744,-830
2018,3,19,8,2760,3477,2667,-810
2018,3,19,9,2801,3498,2668,-830
2018,3,19,10,3034,3756,2852,-904
2018,3,19,11,3444,4263,3250,-1013
2018,3,19,12,3784,4645,3625,-1020
2018,3,19,13,3926,4857,3799,-1058
2018,3,19,14,4167,5085,3887,-1198
2018,3,19,15,4456,5315,3979,-1336
2018,3,19,16,4636,5488,4037,-1451
2018,3,19,17,4816,5615,4138,-1477
2018,3,19,18,5107,5774,4189,-1585
2018,3,19,19,5412,5928,4346,-1582
2018,3,19,20,5558,6122,4580,-1542
2018,3,19,21,5694,6306,4707,-1599
2018,3,19,22,5706,6440,4829,-1611
2018,3,19,23,5610,6368,4920,-1448
2018,3,20,0,5413,6244,4765,-1479
2018,3,20,1,5292,6162,4698,-1464
2018,3,20,2,4910,5742,4537,-1205
2018,3,20,3,4383,5167,3815,-1352
2018,3,20,4,3846,4578,3414,-1164
2018,3,20,5,3337,4100,3094,-1006
2018,3,20,6,3098,3798,2838,-960
2018,3,20,7,2999,3655,2731,-924
2018,3,20,8,2920,3601,2676,-925
2018,3,20,9,2964,3681,2728,-953
2018,3,20,10,3216,3998,2931,-1067
2018,3,20,11,3680,4537,3354,-1183
2018,3,20,12,3955,4944,3765,-1179
2018,3,20,13,4001,5152,3909,-1243
2018,3,20,14,4241,5448,4055,-1393
2018,3,20,15,4476,5819,4298,-1521
2018,3,20,16,4695,6050,4571,-1479
2018,3,20,17,4823,6143,4667,-1476
2018,3,20,18,5056,6176,4675,-1501
2018,3,20,19,5223,6127,4671,-1456
2018,3,20,20,5267,5851,4409,-1442
2018,3,20,21,5203,5813,4341,-1472
2018,3,20,22,5002,5887,4389,-1498
2018,3,20,23,4861,5811,4301,-1510
2018,3,21,0,4895,5723,4262,-1461
2018,3,21,1,4835,5805,4318,-1487
2018,3,21,2,4442,5403,3981,-1422
2018,3,21,3,3992,4882,3596,-1286
2018,3,21,4,3538,4298,3196,-1102
2018,3,21,5,3143,3873,2935,-938
2018,3,21,6,2906,3595,2789,-806
2018,3,21,7,2738,3453,2670,-783
2018,3,21,8,2680,3388,2626,-762
2018,3,21,9,2720,3461,2657,-804
2018,3,21,10,2970,3785,2871,-914
2018,3,21,11,3352,4383,3313,-1070
2018,3,21,12,3700,4785,3686,-1099
2018,3,21,13,3854,4912,3835,-1077
2018,3,21,14,3962,5048,3968,-1080
2018,3,21,15,4079,5181,4104,-1077
2018,3,21,16,4134,5147,4069,-1078
2018,3,21,17,4218,5087,3950,-1137
2018,3,21,18,4328,5033,3843,-1190
2018,3,21,19,4405,4984,3702,-1282
2018,3,21,20,4441,4987,3555,-1432
2018,3,21,21,4470,5039,3577,-1462
2018,3,21,22,4545,5112,3683,-1429
2018,3,21,23,4390,5133,3721,-1412
2018,3,22,0,4459,5260,3863,-1397
2018,3,22,1,4454,5529,4061,-1468
2018,3,22,2,4219,5268,3826,-1442
2018,3,22,3,3870,4850,3521,-1329
2018,3,22,4,3501,4395,3208,-1187
2018,3,22,5,3124,4050,2998,-1052
2018,3,22,6,2986,3876,2844,-1032
2018,3,22,7,2949,3800,2766,-1034
2018,3,22,8,3009,3839,2782,-1057
2018,3,22,9,3160,4003,2889,-1114
2018,3,22,10,3514,4446,3109,-1337
2018,3,22,11,4133,5198,3700,-1498
2018,3,22,12,4540,5765,4171,-1594
2018,3,22,13,4636,5859,4225,-1634
2018,3,22,14,4482,5749,4206,-1543
2018,3,22,15,4287,5601,4099,-1502
2018,3,22,16,4177,5402,3951,-1451
2018,3,22,17,4105,5183,3801,-1382
2018,3,22,18,4033,5033,3687,-1346
2018,3,22,19,3998,4951,3596,-1355
2018,3,22,20,3987,4893,3544,-1349
2018,3,22,21,4011,4940,3583,-1357
2018,3,22,22,4035,5014,3641,-1373
2018,3,22,23,4064,5059,3670,-1389
2018,3,23,0,4177,5228,3775,-1453
2018,3,23,1,4342,5527,4116,-1411
2018,3,23,2,4222,5379,4090,-1289
2018,3,23,3,3996,5006,3728,-1278
2018,3,23,4,3692,4593,3341,-1252
2018,3,23,5,3436,4329,3149,-1180
2018,3,23,6,3272,4220,3043,-1177
2018,3,23,7,3250,4216,3011,-1205
2018,3,23,8,3306,4318,3070,-1248
2018,3,23,9,3506,4572,3231,-1341
2018,3,23,10,3965,5101,3497,-1604
2018,3,23,11,4566,5943,4226,-1717
2018,3,23,12,4945,6548,4882,-1666
2018,3,23,13,4962,6591,4954,-1637
2018,3,23,14,4740,6244,4592,-1652
2018,3,23,15,4453,5865,4361,-1504
2018,3,23,16,4264,5538,4023,-1515
2018,3,23,17,4100,5263,3732,-1531
2018,3,23,18,3969,5123,3618,-1505
2018,3,23,19,3881,5002,3631,-1371
2018,3,23,20,3835,4990,3629,-1361
2018,3,23,21,3820,5051,3673,-1378
2018,3,23,22,3786,5085,3735,-1350
2018,3,23,23,3828,5025,3676,-1349
2018,3,24,0,3951,5072,3711,-1361
2018,3,24,1,4064,5272,3918,-1354
2018,3,24,2,3897,5057,3670,-1387
2018,3,24,3,3645,4742,3503,-1239
2018,3,24,4,3415,4379,3198,-1181
2018,3,24,5,3077,4060,3001,-1059
2018,3,24,6,2902,3887,2842,-1045
2018,3,24,7,2838,3845,2795,-1050
2018,3,24,8,2817,3878,2789,-1089
2018,3,24,9,2913,4017,2874,-1143
2018,3,24,10,3065,4265,3108,-1157
2018,3,24,11,3263,4683,3426,-1257
2018,3,24,12,3559,5167,3652,-1515
2018,3,24,13,3894,5520,3833,-1687
2018,3,24,14,4000,5492,3874,-1618
2018,3,24,15,4006,5321,3759,-1562
2018,3,24,16,3941,5134,3601,-1533
2018,3,24,17,3883,5021,3420,-1601
2018,3,24,18,3865,5011,3413,-1598
2018,3,24,19,3859,5032,3434,-1598
2018,3,24,20,3876,5167,3579,-1588
2018,3,24,21,3908,5335,3733,-1602
2018,3,24,22,3931,5470,3861,-1609
2018,3,24,23,3992,5414,3765,-1649
2018,3,25,0,4095,5300,3707,-1593
2018,3,25,1,4193,5362,3745,-1617
2018,3,25,2,3968,5068,3641,-1427
2018,3,25,3,3661,4659,3323,-1336
2018,3,25,4,3344,4199,3079,-1120
2018,3,25,5,2834,3845,2856,-989
2018,3,25,6,2591,3563,2730,-833
2018,3,25,7,2474,3426,2619,-807
2018,3,25,8,2455,3367,2563,-804
2018,3,25,9,2465,3412,2584,-828
2018,3,25,10,2475,3547,2661,-886
2018,3,25,11,2685,3812,2866,-946
2018,3,25,12,2853,4136,3059,-1077
2018,3,25,13,3243,4576,3349,-1227
2018,3,25,14,3574,4847,3405,-1442
2018,3,25,15,3867,5018,3451,-1567
2018,3,25,16,3983,5152,3576,-1576
2018,3,25,17,4021,5334,3748,-1586
2018,3,25,18,4163,5501,3691,-1810
2018,3,25,19,4285,5684,3788,-1896
2018,3,25,20,4570,5870,3966,-1904
2018,3,25,21,4723,6110,4227,-1883
2018,3,25,22,4789,6312,4377,-1935
2018,3,25,23,4802,6270,4319,-1951
2018,3,26,0,4525,6111,4197,-1914
2018,3,26,1,4519,6179,4229,-1950
2018,3,26,2,4238,5772,3946,-1826
2018,3,26,3,3796,5188,3656,-1532
2018,3,26,4,3282,0,3656,-1215
2018,3,26,5,3127,3984,2998,-986
2018,3,26,6,2860,3646,2803,-843
2018,3,26,7,2714,3458,2664,-794
2018,3,26,8,2649,3380,2597,-783
2018,3,26,9,2692,3431,2624,-807
2018,3,26,10,2919,3732,2840,-892
2018,3,26,11,3326,4319,3292,-1027
2018,3,26,12,3619,4710,3597,-1113
2018,3,26,13,3760,4890,3713,-1177
2018,3,26,14,3996,5143,3775,-1368
2018,3,26,15,4258,5391,3943,-1448
2018,3,26,16,4434,5590,4112,-1478
2018,3,26,17,4565,5774,4293,-1481
2018,3,26,18,4712,5883,4422,-1461
2018,3,26,19,4799,5955,4495,-1460
2018,3,26,20,4858,6062,4604,-1458
2018,3,26,21,4916,6164,4691,-1473
2018,3,26,22,4876,6226,4802,-1424
2018,3,26,23,4740,6167,4733,-1434
2018,3,27,0,4707,6089,4661,-1428
2018,3,27,1,4683,6166,4781,-1385
2018,3,27,2,4313,5789,4415,-1374
2018,3,27,3,3868,5153,3799,-1354
2018,3,27,4,3391,4535,3384,-1151
2018,3,27,5,3125,4058,3087,-971
2018,3,27,6,2869,3748,2909,-839
2018,3,27,7,2725,3561,2746,-815
2018,3,27,8,2658,3499,2708,-791
2018,3,27,9,2722,3553,2723,-830
2018,3,27,10,2948,3853,2937,-916
2018,3,27,11,3383,4443,3391,-1052
2018,3,27,12,3661,4757,3590,-1167
2018,3,27,13,3798,4871,3635,-1236
2018,3,27,14,3972,5041,3649,-1392
2018,3,27,15,4178,5264,3728,-1536
2018,3,27,16,4318,5432,3786,-1646
2018,3,27,17,4431,5601,3897,-1704
2018,3,27,18,4591,5747,4045,-1702
2018,3,27,19,4692,5945,4254,-1691
2018,3,27,20,4775,6146,4470,-1676
2018,3,27,21,4777,6328,4527,-1801
2018,3,27,22,4716,6429,4597,-1832
2018,3,27,23,4565,6333,4552,-1781
2018,3,28,0,4526,6127,4422,-1705
2018,3,28,1,4566,6143,4497,-1646
2018,3,28,2,4252,5720,4302,-1418
2018,3,28,3,3796,5079,3691,-1388
2018,3,28,4,3309,4428,3307,-1121
2018,3,28,5,3012,3897,2948,-949
2018,3,28,6,2781,3632,2822,-810
2018,3,28,7,2646,3469,2708,-761
2018,3,28,8,2593,3436,2685,-751
2018,3,28,9,2611,3502,2710,-792
2018,3,28,10,2866,3829,2931,-898
2018,3,28,11,3273,4410,3382,-1028
2018,3,28,12,3613,4777,3620,-1157
2018,3,28,13,3721,4882,3665,-1217
2018,3,28,14,3849,5019,3641,-1378
2018,3,28,15,4022,5219,3679,-1540
2018,3,28,16,4178,5330,3854,-1476
2018,3,28,17,4337,5532,3852,-1680
2018,3,28,18,4516,5734,4005,-1729
2018,3,28,19,4722,6063,4188,-1875
2018,3,28,20,4965,6406,4367,-2039
2018,3,28,21,5142,6731,4703,-2028
2018,3,28,22,5177,6895,4866,-2029
2018,3,28,23,4982,6772,4785,-1987
2018,3,29,0,4830,6463,4520,-1943
2018,3,29,1,4841,6427,4619,-1808
2018,3,29,2,4507,5996,4479,-1517
2018,3,29,3,4026,5291,3951,-1340
2018,3,29,4,3522,4584,3463,-1121
2018,3,29,5,3222,4036,3089,-947
2018,3,29,6,2957,3719,2921,-798
2018,3,29,7,2787,3548,2786,-762
2018,3,29,8,2732,3471,2735,-736
2018,3,29,9,2771,3539,2768,-771
2018,3,29,10,2976,3832,2985,-847
2018,3,29,11,3401,4425,3438,-987
2018,3,29,12,3681,4742,3645,-1097
2018,3,29,13,3822,4905,3732,-1173
2018,3,29,14,4029,5111,3761,-1350
2018,3,29,15,4296,5354,3832,-1522
2018,3,29,16,4492,5612,4083,-1529
2018,3,29,17,4743,5878,4378,-1500
2018,3,29,18,5033,6201,4743,-1458
2018,3,29,19,5293,6536,4813,-1723
2018,3,29,20,5552,6923,5085,-1838
2018,3,29,21,5800,7230,5329,-1901
2018,3,29,22,5852,7398,5450,-1948
2018,3,29,23,5688,7290,5355,-1935
2018,3,30,0,5385,6925,5065,-1860
2018,3,30,1,5279,6813,4943,-1870
2018,3,30,2,4945,6336,4696,-1640
2018,3,30,3,4437,5687,4288,-1399
2018,3,30,4,3898,4989,3791,-1198
2018,3,30,5,3507,5881,4839,-1042
2018,3,30,6,3185,4008,3125,-883
2018,3,30,7,2980,3749,2926,-823
2018,3,30,8,2879,3627,2838,-789
2018,3,30,9,2884,3623,2812,-811
2018,3,30,10,3037,3855,2974,-881
2018,3,30,11,3350,4337,3322,-1015
2018,3,30,12,3626,4644,3547,-1097
2018,3,30,13,3880,4930,3733,-1197
2018,3,30,14,4214,5347,3929,-1418
2018,3,30,15,4569,5776,4189,-1587
2018,3,30,16,4877,6182,4622,-1560
2018,3,30,17,5118,6574,4984,-1590
2018,3,30,18,5394,6919,5042,-1877
2018,3,30,19,5554,7092,5204,-1888
2018,3,30,20,5671,7111,5352,-1759
2018,3,30,21,5761,7042,5215,-1827
2018,3,30,22,5641,6828,5108,-1720
2018,3,30,23,5346,6486,4798,-1688
2018,3,31,0,5027,6297,4572,-1725
2018,3,31,1,5009,6248,4428,-1820
2018,3,31,2,4750,5929,4462,-1467
2018,3,31,3,4368,5482,4063,-1419
2018,3,31,4,3948,4957,3748,-1209
2018,3,31,5,3353,4475,3416,-1059
2018,3,31,6,3077,4102,3220,-882
2018,3,31,7,2912,3828,2999,-829
2018,3,31,8,2808,3708,2904,-804
2018,3,31,9,2765,3650,2837,-813
2018,3,31,10,2779,3687,2860,-827
2018,3,31,11,2881,3875,2958,-917
2018,3,31,12,3060,4159,3153,-1006
2018,3,31,13,3335,4553,3387,-1166
2018,3,31,14,3689,4985,3577,-1408
2018,3,31,15,3969,5236,3669,-1567
2018,3,31,16,4128,5328,3773,-1555
2018,3,31,17,4218,5349,3720,-1629
2018,3,31,18,4320,5336,3532,-1804
2018,3,31,19,4424,5368,3586,-1782
2018,3,31,20,4545,5443,3703,-1740
2018,3,31,21,4638,5526,3808,-1718
2018,3,31,22,4581,5568,3858,-1710
2018,3,31,23,4417,5504,3765,-1739
2018,4,1,0,4320,5427,3630,-1797
2018,4,1,1,4329,5595,3753,-1842
2018,4,1,2,4117,5385,3911,-1474
2018,4,1,3,3818,4990,3615,-1375
2018,4,1,4,3447,4545,3391,-1154
2018,4,1,5,3031,4087,3078,-1009
2018,4,1,6,2754,3743,2914,-829
2018,4,1,7,2600,3528,2744,-784
2018,4,1,8,2503,3421,2662,-759
2018,4,1,9,2524,3395,2616,-779
2018,4,1,10,2584,3479,2668,-811
2018,4,1,11,2696,3696,2823,-873
2018,4,1,12,2874,3989,2967,-1022
2018,4,1,13,3229,4491,3294,-1197
2018,4,1,14,3668,5006,3578,-1428
2018,4,1,15,3964,5346,3788,-1558
2018,4,1,16,4173,5717,4141,-1576
2018,4,1,17,4390,6115,4446,-1669
2018,4,1,18,4660,6465,4526,-1939
2018,4,1,19,4898,6722,4735,-1987
2018,4,1,20,5105,6958,4921,-2037
2018,4,1,21,5232,7046,4975,-2071
2018,4,1,22,5232,6934,4909,-2025
2018,4,1,23,5113,6647,4742,-1905
2018,4,2,0,4903,6336,4571,-1765
2018,4,2,1,4833,6363,4543,-1820
2018,4,2,2,4555,5980,4537,-1443
2018,4,2,3,4099,5380,3943,-1437
2018,4,2,4,3607,4696,3500,-1196
2018,4,2,5,3218,4175,3132,-1043
2018,4,2,6,2955,3832,2940,-892
2018,4,2,7,2813,3633,2799,-834
2018,4,2,8,2748,3557,2759,-798
2018,4,2,9,2779,3604,2774,-830
2018,4,2,10,3001,3917,2989,-928
2018,4,2,11,3415,4511,3445,-1066
2018,4,2,12,3703,4875,3735,-1140
2018,4,2,13,3929,5088,3882,-1206
2018,4,2,14,4171,5458,4044,-1414
2018,4,2,15,4453,5898,4280,-1618
2018,4,2,16,4744,6299,4643,-1656
2018,4,2,17,5083,6733,5088,-1645
2018,4,2,18,5373,7146,5201,-1945
2018,4,2,19,5556,7421,5276,-2145
2018,4,2,20,5703,7574,5392,-2182
2018,4,2,21,5864,7665,5448,-2217
2018,4,2,22,5853,7626,5430,-2196
2018,4,2,23,5720,7393,5223,-2170
2018,4,3,0,5434,7103,4981,-2122
2018,4,3,1,5329,7017,4919,-2098
2018,4,3,2,4991,6529,4848,-1681
2018,4,3,3,4490,5788,4287,-1501
2018,4,3,4,3960,5054,3819,-1235
2018,4,3,5,3415,4460,3419,-1041
2018,4,3,6,3135,4076,3199,-877
2018,4,3,7,2985,3850,3015,-835
2018,4,3,8,2894,3721,2914,-807
2018,4,3,9,2910,3716,2912,-804
2018,4,3,10,3130,4019,3139,-880
2018,4,3,11,3571,4621,3590,-1031
2018,4,3,12,3856,4955,3817,-1138
2018,4,3,13,4049,5161,3935,-1226
2018,4,3,14,4310,5500,4087,-1413
2018,4,3,15,4619,5922,4321,-1601
2018,4,3,16,4952,6348,4637,-1711
2018,4,3,17,5257,6788,5048,-1740
2018,4,3,18,5552,7209,5500,-1709
2018,4,3,19,5731,7575,5969,-1606
2018,4,3,20,5914,7869,6204,-1665
2018,4,3,21,6032,8099,6356,-1743
2018,4,3,22,5990,8118,6391,-1727
2018,4,3,23,5765,7893,6200,-1693
2018,4,4,0,5528,7479,5936,-1543
2018,4,4,1,5478,7318,5748,-1570
2018,4,4,2,5127,6723,5389,-1334
2018,4,4,3,4585,5940,4683,-1257
2018,4,4,4,4060,5171,4000,-1171
2018,4,4,5,3651,4628,3579,-1049
2018,4,4,6,3346,4236,3329,-907
2018,4,4,7,3158,3988,3131,-857
2018,4,4,8,3046,3886,3058,-828
2018,4,4,9,3056,3913,3056,-857
2018,4,4,10,3259,4193,3267,-926
2018,4,4,11,3639,4799,3776,-1023
2018,4,4,12,3904,5137,4062,-1075
2018,4,4,13,4083,5339,4194,-1145
2018,4,4,14,4354,5699,4363,-1336
2018,4,4,15,4671,6150,4769,-1381
2018,4,4,16,4959,6613,5336,-1277
2018,4,4,17,5104,7068,5690,-1378
2018,4,4,18,5355,7459,5958,-1501
2018,4,4,19,5527,7790,6236,-1554
2018,4,4,20,5649,8045,6459,-1586
2018,4,4,21,5653,8121,6525,-1596
2018,4,4,22,5604,8001,6419,-1582
2018,4,4,23,5414,7664,6164,-1500
2018,4,5,0,5147,7325,5958,-1367
2018,4,5,1,5157,7211,5771,-1440
2018,4,5,2,4816,6781,5419,-1362
2018,4,5,3,4284,6091,4767,-1324
2018,4,5,4,3761,5339,4113,-1226
2018,4,5,5,3351,4626,3578,-1048
2018,4,5,6,3060,4205,3343,-862
2018,4,5,7,2905,3941,3147,-794
2018,4,5,8,2816,3791,2998,-793
2018,4,5,9,2840,3780,2958,-822
2018,4,5,10,3041,4057,3168,-889
2018,4,5,11,3425,4607,3582,-1025
2018,4,5,12,3672,4874,3756,-1118
2018,4,5,13,3815,5000,3880,-1120
2018,4,5,14,4002,5187,3985,-1202
2018,4,5,15,4230,5334,4090,-1244
2018,4,5,16,4371,5474,4206,-1268
2018,4,5,17,4438,5665,4333,-1332
2018,4,5,18,4639,5950,4584,-1366
2018,4,5,19,4773,6253,4836,-1417
2018,4,5,20,4939,6521,4870,-1651
2018,4,5,21,5032,6745,5193,-1552
2018,4,5,22,5064,6781,5173,-1608
2018,4,5,23,4883,6606,5011,-1595
2018,4,6,0,4728,6379,4825,-1554
2018,4,6,1,4748,6409,4888,-1521
2018,4,6,2,4453,5980,4655,-1325
2018,4,6,3,3988,5322,4115,-1207
2018,4,6,4,3506,4645,3553,-1092
2018,4,6,5,3215,4110,3135,-975
2018,4,6,6,2936,3781,2966,-815
2018,4,6,7,2774,3587,2797,-790
2018,4,6,8,2698,3485,2714,-771
2018,4,6,9,2716,3534,2712,-822
2018,4,6,10,2903,3825,2970,-855
2018,4,6,11,3369,4457,3536,-921
2018,4,6,12,3607,4752,3833,-919
2018,4,6,13,3800,4943,3957,-986
2018,4,6,14,4073,5224,4087,-1137
2018,4,6,15,4375,5547,4210,-1337
2018,4,6,16,4622,5771,4355,-1416
2018,4,6,17,4902,6110,4412,-1698
2018,4,6,18,5203,6488,4525,-1963
2018,4,6,19,5480,6927,4932,-1995
2018,4,6,20,5732,7339,5279,-2060
2018,4,6,21,5831,7635,5544,-2091
2018,4,6,22,5798,7693,5581,-2112
2018,4,6,23,5654,7388,5322,-2066
2018,4,7,0,5305,6856,5041,-1815
2018,4,7,1,5143,6678,4954,-1724
2018,4,7,2,4877,6219,4687,-1532
2018,4,7,3,4454,5651,4292,-1359
2018,4,7,4,4003,5048,3813,-1235
2018,4,7,5,3481,4463,3374,-1089
2018,4,7,6,3196,4086,3064,-1022
2018,4,7,7,3009,3821,2850,-971
2018,4,7,8,2902,3711,2756,-955
2018,4,7,9,2875,3672,2715,-957
2018,4,7,10,2921,3783,2771,-1012
2018,4,7,11,3072,4001,2931,-1070
2018,4,7,12,3270,4287,3084,-1203
2018,4,7,13,3615,4798,3398,-1400
2018,4,7,14,4040,5374,3817,-1557
2018,4,7,15,4381,5871,4150,-1721
2018,4,7,16,4679,6292,4575,-1717
2018,4,7,17,4904,6668,4976,-1692
2018,4,7,18,5110,6972,5153,-1819
2018,4,7,19,5295,7155,5312,-1843
2018,4,7,20,5452,7257,5384,-1873
2018,4,7,21,5647,7229,5373,-1856
2018,4,7,22,5610,7051,5205,-1846
2018,4,7,23,5484,6648,4915,-1733
2018,4,8,0,5162,6247,4622,-1625
2018,4,8,1,5005,6014,4411,-1603
2018,4,8,2,4724,5695,4275,-1420
2018,4,8,3,4296,5252,3859,-1393
2018,4,8,4,3869,4780,3469,-1311
2018,4,8,5,3495,4319,3159,-1160
2018,4,8,6,3213,4001,2983,-1018
2018,4,8,7,3020,3759,2775,-984
2018,4,8,8,2913,3631,2682,-949
2018,4,8,9,2857,3580,2642,-938
2018,4,8,10,2884,3629,2681,-948
2018,4,8,11,2971,3811,2835,-976
2018,4,8,12,3151,4061,2945,-1116
2018,4,8,13,3497,4529,3157,-1372
2018,4,8,14,3938,5084,3463,-1621
2018,4,8,15,4227,5475,3750,-1725
2018,4,8,16,4410,5753,3963,-1790
2018,4,8,17,4524,6033,4208,-1825
2018,4,8,18,4627,6202,4330,-1872
2018,4,8,19,4728,6269,4372,-1897
2018,4,8,20,4834,6269,4359,-1910
2018,4,8,21,4866,6391,4444,-1947
2018,4,8,22,4907,6380,4482,-1898
2018,4,8,23,4779,6236,4365,-1871
2018,4,9,0,4672,6155,4291,-1864
2018,4,9,1,4747,6167,4310,-1857
2018,4,9,2,4503,5793,4037,-1756
2018,4,9,3,4066,5198,3689,-1509
2018,4,9,4,3620,4609,3358,-1251
2018,4,9,5,3270,4115,3013,-1102
2018,4,9,6,3028,3797,2846,-951
2018,4,9,7,2895,3641,2719,-922
2018,4,9,8,2830,3545,2645,-900
2018,4,9,9,2865,3625,2689,-936
2018,4,9,10,3123,3961,2940,-1021
2018,4,9,11,3586,4605,3425,-1180
2018,4,9,12,3880,4962,3718,-1244
2018,4,9,13,4119,5193,3786,-1407
2018,4,9,14,4448,5530,3924,-1606
2018,4,9,15,4806,5950,4146,-1804
2018,4,9,16,5086,6364,4478,-1886
2018,4,9,17,5378,6828,4866,-1962
2018,4,9,18,5638,7234,5209,-2025
2018,4,9,19,5772,7467,5363,-2104
2018,4,9,20,5894,7718,5590,-2128
2018,4,9,21,5934,7972,5786,-2186
2018,4,9,22,5900,8101,5859,-2242
2018,4,9,23,5826,7918,5713,-2205
2018,4,10,0,5621,7625,5450,-2175
2018,4,10,1,5536,7513,5385,-2128
2018,4,10,2,5199,6956,5101,-1855
2018,4,10,3,4682,6205,4509,-1696
2018,4,10,4,4189,5471,3998,-1473
2018,4,10,5,3771,4908,3661,-1247
2018,4,10,6,3462,4506,3449,-1057
2018,4,10,7,3265,4224,3243,-981
2018,4,10,8,3170,4018,3062,-956
2018,4,10,9,3166,4026,3063,-963
2018,4,10,10,3391,4291,3258,-1033
2018,4,10,11,3836,4859,3737,-1122
2018,4,10,12,4098,5170,4022,-1148
2018,4,10,13,4253,5379,4103,-1276
2018,4,10,14,4451,5663,4374,-1289
2018,4,10,15,4639,5846,4518,-1328
2018,4,10,16,4758,5797,4474,-1323
2018,4,10,17,4764,5686,4351,-1335
2018,4,10,18,4816,5610,4268,-1342
2018,4,10,19,4876,5554,4250,-1304
2018,4,10,20,4871,5507,4205,-1302
2018,4,10,21,4887,5575,4244,-1331
2018,4,10,22,4811,5691,4303,-1388
2018,4,10,23,4730,5716,4332,-1384
2018,4,11,0,4694,5768,4351,-1417
2018,4,11,1,4713,5883,4467,-1416
2018,4,11,2,4394,5544,4202,-1342
2018,4,11,3,3919,4988,3823,-1165
2018,4,11,4,3431,4429,3544,-885
2018,4,11,5,3177,4000,3181,-819
2018,4,11,6,2948,3687,2918,-769
2018,4,11,7,2799,3534,2792,-742
2018,4,11,8,2737,3446,2718,-728
2018,4,11,9,2771,3513,2756,-757
2018,4,11,10,2996,3840,2985,-855
2018,4,11,11,3302,4462,3437,-1025
2018,4,11,12,3629,4765,3781,-984
2018,4,11,13,3710,4862,3872,-990
2018,4,11,14,3881,4992,4002,-990
2018,4,11,15,4022,5115,4130,-985
2018,4,11,16,4221,5195,4216,-979
2018,4,11,17,4290,5283,4292,-991
2018,4,11,18,4479,5439,4460,-979
2018,4,11,19,4621,5608,4489,-1119
2018,4,11,20,4775,5828,4548,-1280
2018,4,11,21,4855,6076,4762,-1314
2018,4,11,22,4910,6214,5096,-1118
2018,4,11,23,4671,6123,4945,-1178
2018,4,12,0,4559,5867,4858,-1009
2018,4,12,1,4571,5900,4886,-1014
2018,4,12,2,4294,5537,4606,-931
2018,4,12,3,3837,4895,4045,-850
2018,4,12,4,3396,4265,3407,-858
2018,4,12,5,3008,3927,3131,-796
2018,4,12,6,2775,3652,2918,-734
2018,4,12,7,2631,3497,2814,-683
2018,4,12,8,2579,3459,2771,-688
2018,4,12,9,2665,3538,2805,-733
2018,4,12,10,2926,3915,3067,-848
2018,4,12,11,3410,4562,3471,-1091
2018,4,12,12,3672,4888,3639,-1249
2018,4,12,13,3797,4981,3598,-1383
2018,4,12,14,3944,5077,3584,-1493
2018,4,12,15,4095,5167,3601,-1566
2018,4,12,16,4258,5319,3717,-1602
2018,4,12,17,4403,5469,3784,-1685
2018,4,12,18,4551,5721,3958,-1763
2018,4,12,19,4755,5987,4130,-1857
2018,4,12,20,5011,6315,4413,-1902
2018,4,12,21,5176,6635,4515,-2120
2018,4,12,22,5259,6790,4557,-2233
2018,4,12,23,5189,6692,4635,-2057
2018,4,13,0,4983,6426,4458,-1968
2018,4,13,1,4904,6402,4431,-1971
2018,4,13,2,4621,6031,4275,-1756
2018,4,13,3,4127,5362,3837,-1525
2018,4,13,4,3639,4714,3410,-1304
2018,4,13,5,3127,4079,3086,-993
2018,4,13,6,2876,3759,2945,-814
2018,4,13,7,2759,3547,2783,-764
2018,4,13,8,2704,3467,2703,-764
2018,4,13,9,2750,3507,2731,-776
2018,4,13,10,2961,3814,2922,-892
2018,4,13,11,3439,4416,3310,-1106
2018,4,13,12,3680,4704,3440,-1264
2018,4,13,13,3820,4920,3592,-1328
2018,4,13,14,4052,5214,3647,-1567
2018,4,13,15,4331,5551,3780,-1771
2018,4,13,16,4548,5855,4042,-1813
2018,4,13,17,4795,6166,4256,-1910
2018,4,13,18,5093,6501,4503,-1998
2018,4,13,19,5313,6844,4637,-2207
2018,4,13,20,5534,7151,4815,-2336
2018,4,13,21,5648,7395,5081,-2314
2018,4,13,22,5682,7429,5136,-2293
2018,4,13,23,5568,7137,4848,-2289
2018,4,14,0,5203,6669,4495,-2174
2018,4,14,1,5162,6533,4539,-1994
2018,4,14,2,4888,6126,4312,-1814
2018,4,14,3,4416,5536,3949,-1587
2018,4,14,4,3964,4946,3577,-1369
2018,4,14,5,3650,4385,3201,-1184
2018,4,14,6,3328,4020,2991,-1029
2018,4,14,7,3111,3768,2786,-982
2018,4,14,8,2991,3620,2683,-937
2018,4,14,9,2931,3591,2659,-932
2018,4,14,10,2958,3649,2692,-957
2018,4,14,11,3075,3855,2832,-1023
2018,4,14,12,3258,4097,2951,-1146
2018,4,14,13,3649,4620,3251,-1369
2018,4,14,14,4197,5216,3581,-1635
2018,4,14,15,4639,5696,3858,-1838
2018,4,14,16,5092,6128,4195,-1933
2018,4,14,17,5403,6561,4327,-2234
2018,4,14,18,5708,7026,4740,-2286
2018,4,14,19,6025,7450,5163,-2287
2018,4,14,20,6219,7821,5437,-2384
2018,4,14,21,6388,8045,5617,-2428
2018,4,14,22,6403,8084,5649,-2435
2018,4,14,23,6222,7845,5538,-2307
2018,4,15,0,5881,7355,5021,-2334
2018,4,15,1,5717,7103,4852,-2251
2018,4,15,2,5365,6620,4554,-2066
2018,4,15,3,4863,6009,4320,-1689
2018,4,15,4,4359,5444,3990,-1454
2018,4,15,5,3969,4856,3599,-1257
2018,4,15,6,3622,4454,3387,-1067
2018,4,15,7,3406,4204,3199,-1005
2018,4,15,8,3289,4050,3053,-997
2018,4,15,9,3207,3995,3010,-985
2018,4,15,10,3226,4049,2957,-1092
2018,4,15,11,3365,4271,3113,-1158
2018,4,15,12,3566,4503,3131,-1372
2018,4,15,13,3989,5074,3579,-1495
2018,4,15,14,4474,5816,4159,-1657
2018,4,15,15,4900,6498,4586,-1912
2018,4,15,16,5231,6998,4970,-2028
2018,4,15,17,5439,7352,5309,-2043
2018,4,15,18,5601,7575,5525,-2050
2018,4,15,19,5735,7441,5484,-1957
2018,4,15,20,5802,6957,5127,-1830
2018,4,15,21,5768,6731,4796,-1935
2018,4,15,22,5672,6546,4658,-1888
2018,4,15,23,5453,6239,4411,-1828
2018,4,16,0,5209,5995,4130,-1865
2018,4,16,1,5174,5894,4030,-1864
2018,4,16,2,4796,5470,3813,-1657
2018,4,16,3,4277,4833,3301,-1532
2018,4,16,4,3749,4253,2940,-1313
2018,4,16,5,3107,3816,2741,-1075
2018,4,16,6,2856,3538,2608,-930
2018,4,16,7,2709,3375,2474,-901
2018,4,16,8,2642,3345,2460,-885
2018,4,16,9,2671,3436,2512,-924
2018,4,16,10,2936,3792,2757,-1035
2018,4,16,11,3398,4418,3227,-1191
2018,4,16,12,3699,4726,3436,-1290
2018,4,16,13,3799,4870,3440,-1430
2018,4,16,14,3914,4984,3304,-1680
2018,4,16,15,4027,5067,3111,-1956
2018,4,16,16,4109,5091,3109,-1982
2018,4,16,17,4170,5076,3074,-2002
2018,4,16,18,4264,5064,3075,-1989
2018,4,16,19,4357,5036,3050,-1986
2018,4,16,20,4470,5084,3088,-1996
2018,4,16,21,4557,5217,3194,-2023
2018,4,16,22,4600,5355,3333,-2022
2018,4,16,23,4587,5374,3474,-1900
2018,4,17,0,4448,5340,3556,-1784
2018,4,17,1,4497,5518,3688,-1830
2018,4,17,2,4335,5248,3619,-1629
2018,4,17,3,3817,4704,3291,-1413
2018,4,17,4,3374,4147,2937,-1210
2018,4,17,5,2970,3780,2851,-929
2018,4,17,6,2808,3575,2789,-786
2018,4,17,7,2712,3504,2730,-774
2018,4,17,8,2702,3456,2678,-778
2018,4,17,9,2777,3573,2757,-816
2018,4,17,10,3091,3951,3009,-942
2018,4,17,11,3595,4685,3645,-1040
2018,4,17,12,3877,5033,3957,-1076
2018,4,17,13,3916,5068,4082,-986
2018,4,17,14,3963,5061,3965,-1096
2018,4,17,15,4011,5040,3710,-1330
2018,4,17,16,4073,5037,3662,-1375
2018,4,17,17,4123,5052,3688,-1364
2018,4,17,18,4212,5108,3730,-1378
2018,4,17,19,4326,5245,3852,-1393
2018,4,17,20,4465,5436,4000,-1436
2018,4,17,21,4643,5748,4299,-1449
2018,4,17,22,4723,5974,4507,-1467
2018,4,17,23,4696,6037,4630,-1407
2018,4,18,0,4560,5847,4463,-1384
2018,4,18,1,4588,5892,4522,-1370
2018,4,18,2,4243,5478,4286,-1192
2018,4,18,3,3812,4828,3587,-1241
2018,4,18,4,3383,4213,3148,-1065
2018,4,18,5,2969,3763,2812,-951
2018,4,18,6,2747,3505,2700,-805
2018,4,18,7,2642,3407,2623,-784
2018,4,18,8,2612,3368,2589,-779
2018,4,18,9,2695,3458,2652,-806
2018,4,18,10,2998,3850,2943,-907
2018,4,18,11,3457,4535,3445,-1090
2018,4,18,12,3735,4863,3684,-1179
2018,4,18,13,3788,4945,3734,-1211
2018,4,18,14,3868,4988,3687,-1301
2018,4,18,15,4062,5117,3639,-1478
2018,4,18,16,4208,5259,3548,-1711
2018,4,18,17,4444,5527,3755,-1772
2018,4,18,18,4694,5852,4017,-1835
2018,4,18,19,4965,6268,4413,-1855
2018,4,18,20,5266,6729,4897,-1832
2018,4,18,21,5568,7180,5223,-1957
2018,4,18,22,5684,7421,5379,-2042
2018,4,18,23,5576,7305,5307,-1998
2018,4,19,0,5355,6880,4870,-2010
2018,4,19,1,5313,6657,4679,-1978
2018,4,19,2,5039,6137,4344,-1793
2018,4,19,3,4490,5370,3759,-1611
2018,4,19,4,3926,4612,3232,-1380
2018,4,19,5,3442,4085,2942,-1143
2018,4,19,6,3159,3755,2782,-973
2018,4,19,7,2977,3570,2645,-925
2018,4,19,8,2879,3495,2565,-930
2018,4,19,9,2884,3550,2601,-949
2018,4,19,10,3105,3838,2820,-1018
2018,4,19,11,3500,4442,3269,-1173
2018,4,19,12,3718,4744,3401,-1343
2018,4,19,13,3930,4930,3526,-1404
2018,4,19,14,4209,5163,3589,-1574
2018,4,19,15,4523,5481,3690,-1791
2018,4,19,16,4823,5770,3933,-1837
2018,4,19,17,5019,6139,4242,-1897
2018,4,19,18,5335,6576,4585,-1991
2018,4,19,19,5596,6999,5045,-1954
2018,4,19,20,5804,7353,5478,-1875
2018,4,19,21,5983,7602,5768,-1834
2018,4,19,22,5941,7660,5751,-1909
2018,4,19,23,5833,7457,5569,-1888
2018,4,20,0,5511,7047,5129,-1918
2018,4,20,1,5396,6876,4879,-1997
2018,4,20,2,5045,6310,4532,-1778
2018,4,20,3,4503,5524,3940,-1584
2018,4,20,4,3944,4842,3407,-1435
2018,4,20,5,3482,4252,3103,-1149
2018,4,20,6,3198,3889,2922,-967
2018,4,20,7,3017,3705,2765,-940
2018,4,20,8,2919,3579,2676,-903
2018,4,20,9,2923,3605,2673,-932
2018,4,20,10,3131,3873,2848,-1025
2018,4,20,11,3487,4436,3328,-1108
2018,4,20,12,3714,4743,3443,-1300
2018,4,20,13,3928,4967,3547,-1420
2018,4,20,14,4226,5220,3632,-1588
2018,4,20,15,4483,5529,4006,-1523
2018,4,20,16,4675,5850,4197,-1653
2018,4,20,17,4818,6180,4445,-1735
2018,4,20,18,5060,6579,4691,-1888
2018,4,20,19,5198,6929,4943,-1986
2018,4,20,20,5335,7163,5219,-1944
2018,4,20,21,5418,7370,5458,-1912
2018,4,20,22,5302,7330,5419,-1911
2018,4,20,23,5171,6956,5017,-1939
2018,4,21,0,4835,6521,4560,-1961
2018,4,21,1,4832,6357,4518,-1839
2018,4,21,2,4575,5949,4185,-1764
2018,4,21,3,4171,5430,3771,-1659
2018,4,21,4,3722,4864,3426,-1438
2018,4,21,5,3470,4343,3146,-1197
2018,4,21,6,3194,3978,2949,-1029
2018,4,21,7,3012,3738,2759,-979
2018,4,21,8,2908,3629,2665,-964
2018,4,21,9,2875,3604,2643,-961
2018,4,21,10,2909,3681,2701,-980
2018,4,21,11,3020,3885,2823,-1062
2018,4,21,12,3209,4161,2910,-1251
2018,4,21,13,3553,4678,3264,-1414
2018,4,21,14,3954,5294,3684,-1610
2018,4,21,15,4235,5740,3932,-1808
2018,4,21,16,4462,6149,4254,-1895
2018,4,21,17,4675,6469,4354,-2115
2018,4,21,18,4833,6789,4579,-2210
2018,4,21,19,4962,7044,4799,-2245
2018,4,21,20,5119,7217,4955,-2262
2018,4,21,21,5285,7307,5079,-2228
2018,4,21,22,5255,7224,5008,-2216
2018,4,21,23,5043,6920,4786,-2134
2018,4,22,0,4760,6528,4513,-2015
2018,4,22,1,4744,6409,4512,-1897
2018,4,22,2,4548,6072,4304,-1768
2018,4,22,3,4163,5588,3837,-1751
2018,4,22,4,3787,5091,3541,-1550
2018,4,22,5,3515,4640,3346,-1294
2018,4,22,6,3216,4272,3167,-1105
2018,4,22,7,3016,4029,2974,-1055
2018,4,22,8,2894,3895,2872,-1023
2018,4,22,9,2850,3841,2822,-1019
2018,4,22,10,2863,3872,2841,-1031
2018,4,22,11,2905,3998,2912,-1086
2018,4,22,12,3081,4213,3060,-1153
2018,4,22,13,3530,4696,3333,-1363
2018,4,22,14,4065,5338,3651,-1687
2018,4,22,15,4498,5799,3912,-1887
2018,4,22,16,4836,6189,4182,-2007
2018,4,22,17,4987,6467,4110,-2357
2018,4,22,18,5231,6727,4338,-2389
2018,4,22,19,5464,7040,4620,-2420
2018,4,22,20,5566,7330,4895,-2435
2018,4,22,21,5645,7532,5089,-2443
2018,4,22,22,5638,7577,5119,-2458
2018,4,22,23,5529,7369,4946,-2423
2018,4,23,0,5325,7010,4582,-2428
2018,4,23,1,5236,6915,4674,-2241
2018,4,23,2,4936,6455,4557,-1898
2018,4,23,3,4419,5784,4040,-1744
2018,4,23,4,3921,5137,3622,-1515
2018,4,23,5,3678,4591,3339,-1252
2018,4,23,6,3373,4230,3139,-1091
2018,4,23,7,3188,3986,2966,-1020
2018,4,23,8,3071,3890,2883,-1007
2018,4,23,9,3125,3921,2897,-1024
2018,4,23,10,3341,4274,3147,-1127
2018,4,23,11,3796,4885,3652,-1233
2018,4,23,12,4051,5205,3856,-1349
2018,4,23,13,4296,5450,4007,-1443
2018,4,23,14,4601,5763,4104,-1659
2018,4,23,15,4903,6118,4331,-1787
2018,4,23,16,5215,6509,4641,-1868
2018,4,23,17,5445,6872,4887,-1985
2018,4,23,18,5758,7254,5196,-2058
2018,4,23,19,5999,7572,5416,-2156
2018,4,23,20,6126,7671,5320,-2351
2018,4,23,21,6203,7813,5365,-2448
2018,4,23,22,6191,7978,5567,-2411
2018,4,23,23,6086,7865,5524,-2341
2018,4,24,0,5824,7492,5208,-2284
2018,4,24,1,5708,7323,5011,-2312
2018,4,24,2,5322,6819,4623,-2196
2018,4,24,3,4761,6086,4165,-1921
2018,4,24,4,4213,5366,3805,-1561
2018,4,24,5,3608,4749,3460,-1289
2018,4,24,6,3321,4347,3236,-1111
2018,4,24,7,3151,4119,3065,-1054
2018,4,24,8,3038,3995,2966,-1029
2018,4,24,9,3079,3985,2954,-1031
2018,4,24,10,3293,4268,3142,-1126
2018,4,24,11,3767,4799,3555,-1244
2018,4,24,12,4002,5052,3682,-1370
2018,4,24,13,4167,5275,3811,-1464
2018,4,24,14,4399,5594,3920,-1674
2018,4,24,15,4675,5937,4002,-1935
2018,4,24,16,4911,6260,4103,-2157
2018,4,24,17,5094,6565,4356,-2209
2018,4,24,18,5332,6885,4624,-2261
2018,4,24,19,5517,7183,4831,-2352
2018,4,24,20,5621,7409,5083,-2326
2018,4,24,21,5697,7555,5289,-2266
2018,4,24,22,5614,7483,5279,-2204
2018,4,24,23,5530,7190,5014,-2176
2018,4,25,0,5322,6730,4573,-2157
2018,4,25,1,5271,6580,4390,-2190
2018,4,25,2,4923,6177,4089,-2088
2018,4,25,3,4370,5429,3675,-1754
2018,4,25,4,3822,4716,3316,-1400
2018,4,25,5,3431,4186,3038,-1148
2018,4,25,6,3138,3859,2864,-995
2018,4,25,7,2960,3653,2714,-939
2018,4,25,8,2872,3554,2630,-924
2018,4,25,9,2886,3581,2637,-944
2018,4,25,10,3113,3899,2851,-1048
2018,4,25,11,3504,4446,3263,-1183
2018,4,25,12,3728,4726,3390,-1336
2018,4,25,13,3918,4955,3546,-1409
2018,4,25,14,4155,5235,3657,-1578
2018,4,25,15,4405,5552,3856,-1696
2018,4,25,16,4607,5778,4062,-1716
2018,4,25,17,4821,6032,4251,-1781
2018,4,25,18,5077,6284,4428,-1856
2018,4,25,19,5289,6577,4711,-1866
2018,4,25,20,5436,6875,4832,-2043
2018,4,25,21,5546,7115,5035,-2080
2018,4,25,22,5499,7234,5163,-2071
2018,4,25,23,5348,7066,5020,-2046
2018,4,26,0,5102,6672,4787,-1885
2018,4,26,1,5086,6525,4596,-1929
2018,4,26,2,4769,6090,4297,-1793
2018,4,26,3,4261,5382,3751,-1631
2018,4,26,4,3726,4643,3287,-1356
2018,4,26,5,3322,4090,2937,-1153
2018,4,26,6,3045,3759,2784,-975
2018,4,26,7,2892,3569,2631,-938
2018,4,26,8,2814,3489,2571,-918
2018,4,26,9,2845,3540,2605,-935
2018,4,26,10,3076,3844,2828,-1016
2018,4,26,11,3547,4396,3214,-1182
2018,4,26,12,3729,4640,3327,-1313
2018,4,26,13,3928,4841,3476,-1365
2018,4,26,14,4179,5105,3542,-1563
2018,4,26,15,4480,5406,3633,-1773
2018,4,26,16,4739,5688,3721,-1967
2018,4,26,17,4994,6046,3999,-2047
2018,4,26,18,5317,6404,4268,-2136
2018,4,26,19,5574,6754,4320,-2434
2018,4,26,20,5801,7102,4591,-2511
2018,4,26,21,5960,7365,4900,-2465
2018,4,26,22,5920,7392,4969,-2423
2018,4,26,23,5765,7158,4744,-2414
2018,4,27,0,5449,6790,4390,-2400
2018,4,27,1,5332,6667,4432,-2235
2018,4,27,2,5015,6272,4199,-2073
2018,4,27,3,4467,5559,3787,-1772
2018,4,27,4,3919,4842,3324,-1518
2018,4,27,5,3464,4276,2996,-1280
2018,4,27,6,3172,3927,2735,-1192
2018,4,27,7,2995,3707,2549,-1158
2018,4,27,8,2898,3582,2454,-1128
2018,4,27,9,2906,3601,2458,-1143
2018,4,27,10,3109,3875,2652,-1223
2018,4,27,11,3497,4448,3127,-1321
2018,4,27,12,3730,4760,3406,-1354
2018,4,27,13,3954,5069,3558,-1511
2018,4,27,14,4233,5457,3887,-1570
2018,4,27,15,4504,5844,4173,-1671
2018,4,27,16,4758,6228,4445,-1783
2018,4,27,17,4955,6659,4800,-1859
2018,4,27,18,5222,7050,5009,-2041
2018,4,27,19,5428,7358,5216,-2142
2018,4,27,20,5593,7618,5633,-1985
2018,4,27,21,5674,7751,5857,-1894
2018,4,27,22,5595,7700,5781,-1919
2018,4,27,23,5387,7353,5585,-1768
2018,4,28,0,5038,6799,4992,-1807
2018,4,28,1,4961,6541,4733,-1808
2018,4,28,2,4699,6113,4386,-1727
2018,4,28,3,4248,5548,4087,-1461
2018,4,28,4,3783,4922,3748,-1174
2018,4,28,5,3469,4323,3286,-1037
2018,4,28,6,3158,3946,2992,-954
2018,4,28,7,2957,3711,2766,-945
2018,4,28,8,2837,3565,2650,-915
2018,4,28,9,2785,3516,2599,-917
2018,4,28,10,2828,3583,2644,-939
2018,4,28,11,2947,3774,2769,-1005
2018,4,28,12,3091,4022,2921,-1101
2018,4,28,13,3461,4494,3283,-1211
2018,4,28,14,3889,4961,3650,-1311
2018,4,28,15,4213,5341,3885,-1456
2018,4,28,16,4501,5645,3974,-1671
2018,4,28,17,4761,5916,4199,-1717
2018,4,28,18,4984,6215,4356,-1859
2018,4,28,19,5210,6562,4648,-1914
2018,4,28,20,5460,6882,4985,-1897
2018,4,28,21,5624,7116,5143,-1973
2018,4,28,22,5597,7208,5205,-2003
2018,4,28,23,5374,6996,4988,-2008
2018,4,29,0,4984,6497,4650,-1847
2018,4,29,1,4827,6231,4426,-1805
2018,4,29,2,4584,5780,4105,-1675
2018,4,29,3,4184,5221,3765,-1456
2018,4,29,4,3765,4653,3485,-1168
2018,4,29,5,3355,4186,3096,-1090
2018,4,29,6,3045,3837,2814,-1023
2018,4,29,7,2852,3609,2646,-963
2018,4,29,8,2748,3497,2585,-912
2018,4,29,9,2703,3457,2600,-857
2018,4,29,10,2734,3489,2558,-931
2018,4,29,11,2821,3629,2662,-967
2018,4,29,12,2974,3819,2772,-1047
2018,4,29,13,3383,4324,3107,-1217
2018,4,29,14,3853,4922,3587,-1335
2018,4,29,15,4222,5440,3887,-1553
2018,4,29,16,4606,5906,4101,-1805
2018,4,29,17,4934,6404,4452,-1952
2018,4,29,18,5211,6886,4790,-2096
2018,4,29,19,5496,7292,5094,-2198
2018,4,29,20,5737,7656,5410,-2246
2018,4,29,21,5972,7904,5634,-2270
2018,4,29,22,6073,7944,5675,-2269
2018,4,29,23,5847,7711,5612,-2099
2018,4,30,0,5425,7213,5254,-1959
2018,4,30,1,5303,6898,4958,-1940
2018,4,30,2,4952,6383,4537,-1846
2018,4,30,3,4411,5570,4044,-1526
2018,4,30,4,3869,4796,3583,-1213
2018,4,30,5,3393,4216,3299,-917
2018,4,30,6,3094,3844,3024,-820
2018,4,30,7,2912,3641,2838,-803
2018,4,30,8,2828,3546,2787,-759
2018,4,30,9,2854,3568,2790,-778
2018,4,30,10,3061,3905,3048,-857
2018,4,30,11,3414,4482,3493,-989
2018,4,30,12,3683,4813,3859,-954
2018,4,30,13,3967,5060,4104,-956
2018,4,30,14,4324,5434,4399,-1035
2018,4,30,15,4625,5841,4760,-1081
2018,4,30,16,4916,6263,5181,-1082
2018,4,30,17,5155,6670,5584,-1086
2018,4,30,18,5456,7037,5571,-1466
2018,4,30,19,5668,7431,5804,-1627
2018,4,30,20,5826,7745,6044,-1701
2018,4,30,21,5943,7950,6145,-1805
2018,4,30,22,5923,7993,6086,-1907
2018,4,30,23,5801,7767,5892,-1875
2018,5,1,0,5446,7321,5736,-1585
2018,5,1,1,5312,7084,5580,-1504
2018,5,1,2,4969,6540,5158,-1382
2018,5,1,3,4413,5758,4448,-1310
2018,5,1,4,3859,4976,3781,-1195
2018,5,1,5,3578,4356,3260,-1096
2018,5,1,6,3254,3973,2938,-1035
2018,5,1,7,3056,3720,2735,-985
2018,5,1,8,2943,3612,2632,-980
2018,5,1,9,2941,3634,2634,-1000
2018,5,1,10,3144,3911,2855,-1056
2018,5,1,11,3518,4441,3307,-1134
2018,5,1,12,3754,4682,3511,-1171
2018,5,1,13,3982,4945,3716,-1229
2018,5,1,14,4239,5290,3969,-1321
2018,5,1,15,4565,5741,4306,-1435
2018,5,1,16,4849,6158,4517,-1641
2018,5,1,17,5144,6584,4981,-1603
2018,5,1,18,5496,7041,4894,-2147
2018,5,1,19,5761,7445,5208,-2237
2018,5,1,20,5987,7776,5432,-2344
2018,5,1,21,6163,8019,5581,-2438
2018,5,1,22,6130,8021,5550,-2471
2018,5,1,23,6036,7747,5318,-2429
2018,5,2,0,5686,7268,4964,-2304
2018,5,2,1,5450,7061,4986,-2075
2018,5,2,2,5126,6552,4814,-1738
2018,5,2,3,4547,5743,4235,-1508
2018,5,2,4,3985,4976,3666,-1310
2018,5,2,5,3572,4388,3252,-1136
2018,5,2,6,3258,3990,2939,-1051
2018,5,2,7,3056,3740,2742,-998
2018,5,2,8,2946,3616,2642,-974
2018,5,2,9,2942,3633,2654,-979
2018,5,2,10,3137,3945,2882,-1063
2018,5,2,11,3499,4485,3347,-1138
2018,5,2,12,3742,4751,3449,-1302
2018,5,2,13,3962,4957,3564,-1393
2018,5,2,14,4245,5317,3737,-1580
2018,5,2,15,4582,5721,3916,-1805
2018,5,2,16,4947,6151,4200,-1951
2018,5,2,17,5259,6555,4567,-1988
2018,5,2,18,5630,7011,4520,-2491
2018,5,2,19,5928,7420,4828,-2592
2018,5,2,20,6184,7802,5170,-2632
2018,5,2,21,6352,8071,5345,-2726
2018,5,2,22,6337,8156,5406,-2750
2018,5,2,23,6206,7910,5210,-2700
2018,5,3,0,5867,7412,4820,-2592
2018,5,3,1,5645,7122,4644,-2478
2018,5,3,2,5267,6621,4626,-1995
2018,5,3,3,4684,5830,4141,-1689
2018,5,3,4,4130,5063,3558,-1505
2018,5,3,5,3629,4469,3232,-1237
2018,5,3,6,3308,4083,3034,-1049
2018,5,3,7,3105,3859,2860,-999
2018,5,3,8,2996,3743,2772,-971
2018,5,3,9,3000,3773,2802,-971
2018,5,3,10,3193,4037,3007,-1030
2018,5,3,11,3582,4561,3408,-1153
2018,5,3,12,3823,4804,3586,-1218
2018,5,3,13,4064,5072,3847,-1225
2018,5,3,14,4413,5421,4124,-1297
2018,5,3,15,4832,5848,4444,-1404
2018,5,3,16,5212,6310,4718,-1592
2018,5,3,17,5607,6788,4879,-1909
2018,5,3,18,6006,7282,5195,-2087
2018,5,3,19,6333,7780,5561,-2219
2018,5,3,20,6606,8142,5868,-2274
2018,5,3,21,6779,8441,6184,-2257
2018,5,3,22,6781,8488,6252,-2236
2018,5,3,23,6558,8173,5967,-2206
2018,5,4,0,6184,7641,5417,-2224
2018,5,4,1,5938,7412,5203,-2209
2018,5,4,2,5487,6930,5183,-1747
2018,5,4,3,4877,6135,4667,-1468
2018,5,4,4,4303,5331,3972,-1359
2018,5,4,5,3787,4716,3548,-1168
2018,5,4,6,3445,4303,3395,-908
2018,5,4,7,3211,4025,3186,-839
2018,5,4,8,3072,3873,3045,-828
2018,5,4,9,3059,3868,3038,-830
2018,5,4,10,3239,4101,3223,-878
2018,5,4,11,3606,4600,3611,-989
2018,5,4,12,3857,4918,3954,-964
2018,5,4,13,4142,5269,4105,-1164
2018,5,4,14,4517,5722,4281,-1441
2018,5,4,15,4970,6211,4524,-1687
2018,5,4,16,5322,6713,5021,-1692
2018,5,4,17,5701,7230,5287,-1943
2018,5,4,18,6090,7768,5485,-2283
2018,5,4,19,6447,8228,5926,-2302
2018,5,4,20,6712,8556,6210,-2346
2018,5,4,21,6877,8766,6432,-2334
2018,5,4,22,6817,8726,6370,-2356
2018,5,4,23,6632,8290,5959,-2331
2018,5,5,0,6204,7667,5379,-2288
2018,5,5,1,5870,7300,5180,-2120
2018,5,5,2,5476,6790,4897,-1893
2018,5,5,3,4941,6156,4629,-1527
2018,5,5,4,4419,5463,4141,-1322
2018,5,5,5,3891,4844,3662,-1182
2018,5,5,6,3520,4374,3306,-1068
2018,5,5,7,3252,4043,3056,-987
2018,5,5,8,3088,3826,2872,-954
2018,5,5,9,3030,3749,2812,-937
2018,5,5,10,3018,3774,2820,-954
2018,5,5,11,3083,3943,2972,-971
2018,5,5,12,3263,4204,3034,-1170
2018,5,5,13,3739,4821,3432,-1389
2018,5,5,14,4245,5432,3776,-1656
2018,5,5,15,4741,6036,4093,-1943
2018,5,5,16,5171,6601,4550,-2051
2018,5,5,17,5523,7122,4752,-2370
2018,5,5,18,5923,7424,4797,-2627
2018,5,5,19,6223,7651,4928,-2723
2018,5,5,20,6479,7735,5049,-2686
2018,5,5,21,6664,7773,5099,-2674
2018,5,5,22,6607,7612,4995,-2617
2018,5,5,23,6435,7266,4817,-2449
2018,5,6,0,6017,6879,4533,-2346
2018,5,6,1,5716,6801,4473,-2328
2018,5,6,2,5386,6472,4349,-2123
2018,5,6,3,4905,5948,4144,-1804
2018,5,6,4,4433,5400,3756,-1644
2018,5,6,5,4080,4921,3454,-1467
2018,5,6,6,3735,4525,3246,-1279
2018,5,6,7,3495,4259,3055,-1204
2018,5,6,8,3353,4099,2918,-1181
2018,5,6,9,3271,4027,2870,-1157
2018,5,6,10,3261,4071,2884,-1187
2018,5,6,11,3295,4231,3000,-1231
2018,5,6,12,3464,4436,3100,-1336
2018,5,6,13,3948,4955,3435,-1520
2018,5,6,14,4605,5504,3796,-1708
2018,5,6,15,5112,5934,3949,-1985
2018,5,6,16,5519,6336,4261,-2075
2018,5,6,17,5766,6726,4406,-2320
2018,5,6,18,6076,7045,4600,-2445
2018,5,6,19,6303,7245,4723,-2522
2018,5,6,20,6447,7285,4719,-2566
2018,5,6,21,6510,7315,4617,-2698
2018,5,6,22,6448,7275,4546,-2729
2018,5,6,23,6300,0,4546,-2712
2018,5,7,0,5982,6912,4266,-2646
2018,5,7,1,5771,6878,4290,-2588
2018,5,7,2,5382,6550,4222,-2328
2018,5,7,3,4799,5863,4058,-1805
2018,5,7,4,4287,5132,3641,-1491
2018,5,7,5,3596,4563,3359,-1204
2018,5,7,6,3295,4216,3182,-1034
2018,5,7,7,3129,3994,3030,-964
2018,5,7,8,3025,3868,2931,-937
2018,5,7,9,3064,3881,2909,-972
2018,5,7,10,3284,4143,3114,-1029
2018,5,7,11,3681,4679,3521,-1158
2018,5,7,12,3970,5028,3821,-1207
2018,5,7,13,4285,5391,4146,-1245
2018,5,7,14,4676,5815,4472,-1343
2018,5,7,15,5094,6302,4873,-1429
2018,5,7,16,5513,6891,5286,-1605
2018,5,7,17,5975,7441,5340,-2101
2018,5,7,18,6382,7982,5661,-2321
2018,5,7,19,6719,8426,5981,-2445
2018,5,7,20,6901,8771,6234,-2537
2018,5,7,21,7022,8972,6381,-2591
2018,5,7,22,7020,8944,6337,-2607
2018,5,7,23,6797,8646,6080,-2566
2018,5,8,0,6420,7999,5715,-2284
2018,5,8,1,6111,7586,5592,-1994
2018,5,8,2,5638,6997,5188,-1809
2018,5,8,3,4986,6163,4629,-1534
2018,5,8,4,4400,5312,3940,-1372
2018,5,8,5,3889,4440,3296,-1144
2018,5,8,6,3563,3997,2959,-1038
2018,5,8,7,3318,3777,2797,-980
2018,5,8,8,3176,3633,2688,-945
2018,5,8,9,3158,3613,2665,-948
2018,5,8,10,3358,4009,3003,-1006
2018,5,8,11,3726,4507,3406,-1101
2018,5,8,12,3975,4819,3648,-1171
2018,5,8,13,4240,5158,3932,-1226
2018,5,8,14,4565,5580,4275,-1305
2018,5,8,15,4969,6094,4708,-1386
2018,5,8,16,5344,6634,5127,-1507
2018,5,8,17,5773,7185,5282,-1903
2018,5,8,18,6154,7723,5340,-2383
2018,5,8,19,6476,8162,5739,-2423
2018,5,8,20,6729,8466,5964,-2502
2018,5,8,21,6952,8691,6100,-2591
2018,5,8,22,6983,8720,6163,-2557
2018,5,8,23,6775,8473,5980,-2493
2018,5,9,0,6388,7942,5671,-2271
2018,5,9,1,6114,7548,5534,-2014
2018,5,9,2,5655,7006,5309,-1697
2018,5,9,3,5003,6176,4664,-1512
2018,5,9,4,4398,5357,3987,-1370
2018,5,9,5,3868,4700,3564,-1136
2018,5,9,6,3515,4233,3286,-947
2018,5,9,7,3278,3942,3103,-839
2018,5,9,8,3146,3799,3003,-796
2018,5,9,9,3129,3818,3040,-778
2018,5,9,10,3300,4096,3241,-855
2018,5,9,11,3636,4602,3635,-967
2018,5,9,12,3893,4894,3934,-960
2018,5,9,13,4139,5209,4159,-1050
2018,5,9,14,4485,5631,4378,-1253
2018,5,9,15,4929,6140,4767,-1373
2018,5,9,16,5342,6659,5190,-1469
2018,5,9,17,5731,7243,5657,-1586
2018,5,9,18,6164,7820,6092,-1728
2018,5,9,19,6535,8301,6433,-1868
2018,5,9,20,6782,8606,6622,-1984
2018,5,9,21,6989,8768,6715,-2053
2018,5,9,22,7008,8717,6642,-2075
2018,5,9,23,6797,8420,6356,-2064
2018,5,10,0,6364,7882,5943,-1939
2018,5,10,1,6064,7611,5727,-1884
2018,5,10,2,5649,7109,5370,-1739
2018,5,10,3,5025,6324,4768,-1556
2018,5,10,4,4420,5515,4081,-1434
2018,5,10,5,3854,4870,3682,-1188
2018,5,10,6,3510,4428,3494,-934
2018,5,10,7,3293,4114,3246,-868
2018,5,10,8,3167,3943,3112,-831
2018,5,10,9,3162,3930,3088,-842
2018,5,10,10,3359,4160,3273,-887
2018,5,10,11,3729,4656,3633,-1023
2018,5,10,12,3998,4954,3947,-1007
2018,5,10,13,4253,5315,4208,-1107
2018,5,10,14,4636,5730,4390,-1340
2018,5,10,15,5094,6271,4656,-1615
2018,5,10,16,5467,6840,4958,-1882
2018,5,10,17,5933,7420,5409,-2011
2018,5,10,18,6362,7978,5847,-2131
2018,5,10,19,6682,8349,6133,-2216
2018,5,10,20,6931,8653,6353,-2300
2018,5,10,21,7126,8783,6410,-2373
2018,5,10,22,7082,8711,6323,-2388
2018,5,10,23,6885,8408,6087,-2321
2018,5,11,0,6469,7953,5685,-2268
2018,5,11,1,6119,7643,5468,-2175
2018,5,11,2,5716,7179,5183,-1996
2018,5,11,3,5070,6356,4679,-1677
2018,5,11,4,4490,5561,4091,-1470
2018,5,11,5,4019,4919,3682,-1237
2018,5,11,6,3659,4510,3389,-1121
2018,5,11,7,3420,4231,3162,-1069
2018,5,11,8,3275,4053,3032,-1021
2018,5,11,9,3246,4028,3007,-1021
2018,5,11,10,3431,4270,3166,-1104
2018,5,11,11,3803,4734,3560,-1174
2018,5,11,12,4070,5012,3693,-1319
2018,5,11,13,4422,5361,3916,-1445
2018,5,11,14,4912,5887,4187,-1700
2018,5,11,15,5379,6496,4645,-1851
2018,5,11,16,5891,7193,5212,-1981
2018,5,11,17,6348,7847,5845,-2002
2018,5,11,18,6795,8526,6416,-2110
2018,5,11,19,7172,9076,6988,-2088
2018,5,11,20,7441,9422,7200,-2222
2018,5,11,21,7595,9503,7279,-2224
2018,5,11,22,7506,9362,7165,-2197
2018,5,11,23,7276,8918,6730,-2188
2018,5,12,0,6738,8359,6214,-2145
2018,5,12,1,6354,8014,5949,-2065
2018,5,12,2,5966,7535,5544,-1991
2018,5,12,3,5376,6839,4932,-1907
2018,5,12,4,4797,6165,4418,-1747
2018,5,12,5,4270,5535,4064,-1471
2018,5,12,6,3887,5030,3727,-1303
2018,5,12,7,3604,4684,3484,-1200
2018,5,12,8,3424,4456,3314,-1142
2018,5,12,9,3345,4307,3201,-1106
2018,5,12,10,3323,4268,3157,-1111
2018,5,12,11,3421,4359,3215,-1144
2018,5,12,12,3611,4591,3290,-1301
2018,5,12,13,4096,5069,3600,-1469
2018,5,12,14,4671,5524,3708,-1816
2018,5,12,15,5171,5868,3812,-2056
2018,5,12,16,5598,6162,4082,-2080
2018,5,12,17,5900,6362,4264,-2098
2018,5,12,18,6173,6471,4317,-2154
2018,5,12,19,6400,6676,4448,-2228
2018,5,12,20,6598,6830,4516,-2314
2018,5,12,21,6717,6861,4563,-2298
2018,5,12,22,6637,6893,4516,-2377
2018,5,12,23,6425,6780,4411,-2369
2018,5,13,0,6053,6502,4107,-2395
2018,5,13,1,5797,6425,4028,-2397
2018,5,13,2,5439,6157,3991,-2166
2018,5,13,3,4911,5642,3757,-1885
2018,5,13,4,4438,5093,3542,-1551
2018,5,13,5,4031,4639,3357,-1282
2018,5,13,6,3710,4214,3198,-1016
2018,5,13,7,3459,4004,3131,-873
2018,5,13,8,3323,3852,3019,-833
2018,5,13,9,3239,3817,2985,-832
2018,5,13,10,3217,3842,2994,-848
2018,5,13,11,3169,3987,3091,-896
2018,5,13,12,3358,4236,3352,-884
2018,5,13,13,3822,4822,3791,-1031
2018,5,13,14,4349,5475,4310,-1165
2018,5,13,15,4859,5995,4715,-1280
2018,5,13,16,5091,6441,5058,-1383
2018,5,13,17,5119,6866,5394,-1472
2018,5,13,18,5291,7185,5649,-1536
2018,5,13,19,5384,7301,5781,-1520
2018,5,13,20,5397,7244,5738,-1506
2018,5,13,21,5290,7082,5599,-1483
2018,5,13,22,5230,6913,5451,-1462
2018,5,13,23,5070,6669,5220,-1449
2018,5,14,0,4903,6454,4985,-1469
2018,5,14,1,4879,6439,4903,-1536
2018,5,14,2,4677,6152,4771,-1381
2018,5,14,3,4256,5612,4324,-1288
2018,5,14,4,3811,4999,3831,-1168
2018,5,14,5,3702,4500,3441,-1059
2018,5,14,6,3393,4193,3209,-984
2018,5,14,7,3229,3994,3042,-952
2018,5,14,8,3131,3918,3001,-917
2018,5,14,9,3157,3947,3042,-905
2018,5,14,10,3376,4272,3284,-988
2018,5,14,11,3744,4806,3711,-1095
2018,5,14,12,4020,5104,4020,-1084
2018,5,14,13,4259,5302,4220,-1082
2018,5,14,14,4520,5547,4424,-1123
2018,5,14,15,4753,5782,4620,-1162
2018,5,14,16,4893,5917,4810,-1107
2018,5,14,17,4883,5967,4825,-1142
2018,5,14,18,4969,6022,4920,-1102
2018,5,14,19,5064,6088,5005,-1083
2018,5,14,20,5160,6139,5041,-1098
2018,5,14,21,5293,6217,5112,-1105
2018,5,14,22,5329,6286,5138,-1148
2018,5,14,23,5298,6261,5093,-1168
2018,5,15,0,5157,6133,5014,-1119
2018,5,15,1,5032,6240,5100,-1140
2018,5,15,2,4792,5953,4794,-1159
2018,5,15,3,4324,5446,4339,-1107
2018,5,15,4,3885,4871,3818,-1053
2018,5,15,5,3641,4413,3481,-932
2018,5,15,6,3387,4122,3252,-870
2018,5,15,7,3245,3958,3137,-821
2018,5,15,8,3141,3871,3053,-818
2018,5,15,9,3168,3924,3049,-875
2018,5,15,10,3389,4204,3248,-956
2018,5,15,11,3809,4808,3607,-1201
2018,5,15,12,4103,5100,3743,-1357
2018,5,15,13,4370,5359,3904,-1455
2018,5,15,14,4687,5750,4072,-1678
2018,5,15,15,5024,6245,4318,-1927
2018,5,15,16,5343,6762,4723,-2039
2018,5,15,17,5481,7175,5101,-2074
2018,5,15,18,5684,7483,5397,-2086
2018,5,15,19,5856,7621,5551,-2070
2018,5,15,20,5912,7674,5596,-2078
2018,5,15,21,5939,7462,5373,-2089
2018,5,15,22,5858,7376,5229,-2147
2018,5,15,23,5844,7147,5050,-2097
2018,5,16,0,5643,6850,4798,-2052
2018,5,16,1,5458,6692,4674,-2018
2018,5,16,2,5202,6322,4493,-1829
2018,5,16,3,4711,5682,3999,-1683
2018,5,16,4,4214,5029,3566,-1463
2018,5,16,5,3930,4525,3279,-1246
2018,5,16,6,3647,4185,3152,-1033
2018,5,16,7,3453,4002,2989,-1013
2018,5,16,8,3346,3894,2906,-988
2018,5,16,9,3339,3913,2898,-1015
2018,5,16,10,3521,4190,3098,-1092
2018,5,16,11,3908,4733,3524,-1209
2018,5,16,12,4171,5035,3705,-1330
2018,5,16,13,4453,5322,3945,-1377
2018,5,16,14,4759,5646,4117,-1529
2018,5,16,15,5102,6019,4333,-1686
2018,5,16,16,5456,6457,4736,-1721
2018,5,16,17,5721,6898,5055,-1843
2018,5,16,18,6014,7298,5386,-1912
2018,5,16,19,6247,7484,5547,-1937
2018,5,16,20,6356,7768,5807,-1961
2018,5,16,21,6343,7896,5865,-2031
2018,5,16,22,6237,7879,5818,-2061
2018,5,16,23,6046,7638,5590,-2048
2018,5,17,0,5767,7243,5272,-1971
2018,5,17,1,5606,7045,5116,-1929
2018,5,17,2,5323,6715,4984,-1731
2018,5,17,3,4838,6064,4456,-1608
2018,5,17,4,4332,5421,3964,-1457
2018,5,17,5,3873,4869,3646,-1223
2018,5,17,6,3575,4522,3455,-1067
2018,5,17,7,3361,4313,3274,-1039
2018,5,17,8,3253,4241,3233,-1008
2018,5,17,9,3272,4263,3245,-1018
2018,5,17,10,3464,4534,3435,-1099
2018,5,17,11,3840,5101,3965,-1136
2018,5,17,12,4103,5420,4253,-1167
2018,5,17,13,4340,5737,4383,-1354
2018,5,17,14,4635,6155,4573,-1582
2018,5,17,15,4928,6658,4856,-1802
2018,5,17,16,5256,7171,5318,-1853
2018,5,17,17,5497,7404,5589,-1815
2018,5,17,18,5806,7317,5575,-1742
2018,5,17,19,6015,7163,5412,-1751
2018,5,17,20,6127,7076,5322,-1754
2018,5,17,21,6074,6940,5221,-1719
2018,5,17,22,5920,6787,5087,-1700
2018,5,17,23,5709,6665,4977,-1688
2018,5,18,0,5461,6513,4708,-1805
2018,5,18,1,5336,6522,4699,-1823
2018,5,18,2,5114,6301,4652,-1649
2018,5,18,3,4668,5719,4203,-1516
2018,5,18,4,4199,5070,3745,-1325
2018,5,18,5,3848,4251,3039,-1212
2018,5,18,6,3558,4224,3164,-1060
2018,5,18,7,3376,4007,3005,-1002
2018,5,18,8,3283,3890,2878,-1012
2018,5,18,9,3267,3937,2921,-1016
2018,5,18,10,3467,4193,3101,-1092
2018,5,18,11,3867,4738,3569,-1169
2018,5,18,12,4125,5079,3792,-1287
2018,5,18,13,4436,5396,4049,-1347
2018,5,18,14,4809,5883,4312,-1571
2018,5,18,15,5125,6497,4734,-1763
2018,5,18,16,5470,7037,5167,-1870
2018,5,18,17,5735,7517,5503,-2014
2018,5,18,18,5988,7912,5727,-2185
2018,5,18,19,6127,8264,5925,-2339
2018,5,18,20,6257,8580,6192,-2388
2018,5,18,21,6276,8823,6505,-2318
2018,5,18,22,6212,8674,6553,-2121
2018,5,18,23,5989,8176,6160,-2016
2018,5,19,0,5642,7603,5658,-1945
2018,5,19,1,5414,7287,5371,-1916
2018,5,19,2,5220,6832,5088,-1744
2018,5,19,3,4823,6213,4604,-1609
2018,5,19,4,4381,5610,4184,-1426
2018,5,19,5,4077,5034,3739,-1295
2018,5,19,6,3770,4598,3477,-1121
2018,5,19,7,3563,4342,3289,-1053
2018,5,19,8,3436,4161,3157,-1004
2018,5,19,9,3365,4107,3095,-1012
2018,5,19,10,3355,4140,3114,-1026
2018,5,19,11,3432,4288,3216,-1072
2018,5,19,12,3650,4542,3280,-1262
2018,5,19,13,4071,5122,3768,-1354
2018,5,19,14,4513,5816,4210,-1606
2018,5,19,15,4919,6428,4641,-1787
2018,5,19,16,5225,7052,5072,-1980
2018,5,19,17,5502,7559,5544,-2015
2018,5,19,18,5659,7780,5774,-2006
2018,5,19,19,5772,7717,5651,-2066
2018,5,19,20,5797,7437,5242,-2195
2018,5,19,21,5804,7141,5052,-2089
2018,5,19,22,5717,6776,4768,-2008
2018,5,19,23,5518,6481,4538,-1943
2018,5,20,0,5226,6228,4373,-1855
2018,5,20,1,5026,6156,4395,-1761
2018,5,20,2,4824,5964,4331,-1633
2018,5,20,3,4486,5535,3987,-1548
2018,5,20,4,4131,5040,3678,-1362
2018,5,20,5,3885,4580,3328,-1252
2018,5,20,6,3566,4266,3194,-1072
2018,5,20,7,3330,3982,2951,-1031
2018,5,20,8,3213,3854,2870,-984
2018,5,20,9,3142,3804,2850,-954
2018,5,20,10,3129,3860,2870,-990
2018,5,20,11,3151,4022,2985,-1037
2018,5,20,12,3435,4257,3152,-1105
2018,5,20,13,3879,4729,3536,-1193
2018,5,20,14,4393,5209,3770,-1439
2018,5,20,15,4787,5533,3912,-1621
2018,5,20,16,5132,5756,4081,-1675
2018,5,20,17,5371,5912,4307,-1605
2018,5,20,18,5562,5996,4376,-1620
2018,5,20,19,5625,6104,4469,-1635
2018,5,20,20,5581,6135,4484,-1651
2018,5,20,21,5460,6175,4456,-1719
2018,5,20,22,5378,6186,4397,-1789
2018,5,20,23,5226,6155,4514,-1641
2018,5,21,0,5031,6047,4355,-1692
2018,5,21,1,4937,6149,4479,-1670
2018,5,21,2,4757,5992,4381,-1611
2018,5,21,3,4407,5481,3986,-1495
2018,5,21,4,4014,4910,3559,-1351
2018,5,21,5,3586,4442,3249,-1193
2018,5,21,6,3336,4131,3098,-1033
2018,5,21,7,3175,3967,2976,-991
2018,5,21,8,3106,3912,2928,-984
2018,5,21,9,3143,3962,2967,-995
2018,5,21,10,3380,4287,3206,-1081
2018,5,21,11,3809,4851,3672,-1179
2018,5,21,12,4139,5189,3885,-1304
2018,5,21,13,4398,5449,4084,-1365
2018,5,21,14,4684,5789,4302,-1487
2018,5,21,15,5004,6197,4583,-1614
2018,5,21,16,5317,6519,4874,-1645
2018,5,21,17,5493,6813,5138,-1675
2018,5,21,18,5614,6978,5181,-1797
2018,5,21,19,5732,6949,5131,-1818
2018,5,21,20,5806,6909,5128,-1781
2018,5,21,21,5822,6950,5125,-1825
2018,5,21,22,5807,6958,5219,-1739
2018,5,21,23,5672,6814,5139,-1675
2018,5,22,0,5414,6639,4929,-1710
2018,5,22,1,5316,6596,4821,-1775
2018,5,22,2,5066,6277,4615,-1662
2018,5,22,3,4641,5710,4187,-1523
2018,5,22,4,4191,5131,3798,-1333
2018,5,22,5,3740,4617,3394,-1223
2018,5,22,6,3456,4254,3207,-1047
2018,5,22,7,3264,4071,3074,-997
2018,5,22,8,3171,3956,2971,-985
2018,5,22,9,3206,3985,3013,-972
2018,5,22,10,3414,4281,3310,-971
2018,5,22,11,3809,4834,3715,-1119
2018,5,22,12,4098,5182,4003,-1179
2018,5,22,13,4376,5526,4252,-1274
2018,5,22,14,4777,5919,4415,-1504
2018,5,22,15,5147,6359,4594,-1765
2018,5,22,16,5643,6737,4880,-1857
2018,5,22,17,5878,7033,5105,-1928
2018,5,22,18,6204,7210,5054,-2156
2018,5,22,19,6403,7381,5300,-2081
2018,5,22,20,6491,7535,5475,-2060
2018,5,22,21,6503,7483,5448,-2035
2018,5,22,22,6472,7410,5402,-2008
2018,5,22,23,6315,7172,5275,-1897
2018,5,23,0,5972,6956,5256,-1700
2018,5,23,1,5786,6864,5200,-1664
2018,5,23,2,5473,6573,5120,-1453
2018,5,23,3,4942,5932,4614,-1318
2018,5,23,4,4409,5274,4101,-1173
2018,5,23,5,3822,4848,3837,-1011
2018,5,23,6,3552,4468,3591,-877
2018,5,23,7,3392,4241,3423,-818
2018,5,23,8,3295,4097,3307,-790
2018,5,23,9,3338,4132,3332,-800
2018,5,23,10,3519,4435,3586,-849
2018,5,23,11,3934,4933,3961,-972
2018,5,23,12,4211,5293,4058,-1235
2018,5,23,13,4544,5763,4534,-1229
2018,5,23,14,4958,6295,4915,-1380
2018,5,23,15,5437,6878,5310,-1568
2018,5,23,16,5861,7504,5833,-1671
2018,5,23,17,6229,8053,6223,-1830
2018,5,23,18,6596,8635,6646,-1989
2018,5,23,19,6754,9083,6887,-2196
2018,5,23,20,6863,9398,7085,-2313
2018,5,23,21,6934,9548,7048,-2500
2018,5,23,22,6891,9531,6971,-2560
2018,5,23,23,6728,9209,6638,-2571
2018,5,24,0,6372,8728,6360,-2368
2018,5,24,1,6105,8331,6062,-2269
2018,5,24,2,5796,7815,5813,-2002
2018,5,24,3,5226,7039,5198,-1841
2018,5,24,4,4667,6224,4798,-1426
2018,5,24,5,4129,5417,4144,-1273
2018,5,24,6,3808,4966,3943,-1023
2018,5,24,7,3583,4644,3696,-948
2018,5,24,8,3465,4449,3539,-910
2018,5,24,9,3442,4429,3524,-905
2018,5,24,10,3616,4635,3674,-961
2018,5,24,11,3952,5110,4088,-1022
2018,5,24,12,4239,5461,4269,-1192
2018,5,24,13,4541,5895,4659,-1236
2018,5,24,14,5038,6440,5001,-1439
2018,5,24,15,5469,7109,5413,-1696
2018,5,24,16,5904,7843,5947,-1896
2018,5,24,17,6190,8526,6459,-2067
2018,5,24,18,6461,9084,6928,-2156
2018,5,24,19,6653,9504,7145,-2359
2018,5,24,20,6747,9721,7117,-2604
2018,5,24,21,6791,9774,7128,-2646
2018,5,24,22,6672,9701,7104,-2597
2018,5,24,23,6469,9357,6898,-2459
2018,5,25,0,6137,8719,6532,-2187
2018,5,25,1,5895,8238,6257,-1981
2018,5,25,2,5580,7698,5980,-1718
2018,5,25,3,5050,6979,5370,-1609
2018,5,25,4,4527,6194,4861,-1333
2018,5,25,5,4130,5545,4299,-1246
2018,5,25,6,3798,5085,3984,-1101
2018,5,25,7,3576,4766,3703,-1063
2018,5,25,8,3450,4559,3471,-1088
2018,5,25,9,3442,4516,3432,-1084
2018,5,25,10,3621,4724,3656,-1068
2018,5,25,11,3927,5119,4044,-1075
2018,5,25,12,4194,5526,4217,-1309
2018,5,25,13,4493,6023,4522,-1501
2018,5,25,14,4885,6637,4777,-1860
2018,5,25,15,5293,7283,5271,-2012
2018,5,25,16,5686,7881,5710,-2171
2018,5,25,17,5932,8471,6116,-2355
2018,5,25,18,6169,8946,6389,-2557
2018,5,25,19,6355,9148,6485,-2663
2018,5,25,20,6406,9024,6356,-2668
2018,5,25,21,6341,8511,5944,-2567
2018,5,25,22,6216,7940,5512,-2428
2018,5,25,23,5923,7430,5144,-2286
2018,5,26,0,5578,7074,4961,-2113
2018,5,26,1,5403,6911,4810,-2101
2018,5,26,2,5142,6710,4898,-1812
2018,5,26,3,4762,6188,4511,-1677
2018,5,26,4,4338,5649,4166,-1483
2018,5,26,5,4001,5099,3754,-1345
2018,5,26,6,3667,4698,3533,-1165
2018,5,26,7,3436,4404,3307,-1097
2018,5,26,8,3296,4241,3167,-1074
2018,5,26,9,3236,4163,3100,-1063
2018,5,26,10,3252,4187,3116,-1071
2018,5,26,11,3326,4288,3185,-1103
2018,5,26,12,3563,4550,3320,-1230
2018,5,26,13,3991,5196,3820,-1376
2018,5,26,14,4479,5913,4281,-1632
2018,5,26,15,4851,6497,4622,-1875
2018,5,26,16,5200,7009,4959,-2050
2018,5,26,17,5402,7305,5164,-2141
2018,5,26,18,5501,7449,5264,-2185
2018,5,26,19,5543,7405,5229,-2176
2018,5,26,20,5554,7277,5144,-2133
2018,5,26,21,5496,7157,4924,-2233
2018,5,26,22,5400,6954,4673,-2281
2018,5,26,23,5208,6693,4439,-2254
2018,5,27,0,5007,6415,4239,-2176
2018,5,27,1,4881,6366,4098,-2268
2018,5,27,2,4764,6088,3976,-2112
2018,5,27,3,4461,5631,3610,-2021
2018,5,27,4,4123,5183,3503,-1680
2018,5,27,5,3797,4695,3304,-1391
2018,5,27,6,3531,4348,3195,-1153
2018,5,27,7,3342,4164,3049,-1115
2018,5,27,8,3231,4049,2965,-1084
2018,5,27,9,3177,4013,2926,-1087
2018,5,27,10,3153,4076,2967,-1109
2018,5,27,11,3176,4234,3110,-1124
2018,5,27,12,3385,4457,3116,-1341
2018,5,27,13,3925,4959,3403,-1556
2018,5,27,14,4404,5529,3872,-1657
2018,5,27,15,4789,5966,4261,-1705
2018,5,27,16,5127,6256,4494,-1762
2018,5,27,17,5357,6451,4681,-1770
2018,5,27,18,5517,6603,4773,-1830
2018,5,27,19,5569,6782,4934,-1848
2018,5,27,20,5567,6865,4961,-1904
2018,5,27,21,5531,6929,4905,-2024
2018,5,27,22,5444,6951,4871,-2080
2018,5,27,23,5310,6946,4819,-2127
2018,5,28,0,5099,6814,4712,-2102
2018,5,28,1,5004,6737,4630,-2107
2018,5,28,2,4812,6591,4673,-1918
2018,5,28,3,4405,6178,4352,-1826
2018,5,28,4,4042,5706,4106,-1600
2018,5,28,5,3759,5191,3847,-1344
2018,5,28,6,3446,4835,3631,-1204
2018,5,28,7,3289,4619,3436,-1183
2018,5,28,8,3191,4512,3380,-1132
2018,5,28,9,3196,4525,3387,-1138
2018,5,28,10,3257,4600,3447,-1153
2018,5,28,11,3389,4767,3577,-1190
2018,5,28,12,3597,4965,3540,-1425
2018,5,28,13,4084,5495,3782,-1713
2018,5,28,14,4711,6215,4143,-2072
2018,5,28,15,5230,6877,4809,-2068
2018,5,28,16,5662,7404,5107,-2297
2018,5,28,17,5911,7893,5367,-2526
2018,5,28,18,6154,8118,5593,-2525
2018,5,28,19,6242,8255,5760,-2495
2018,5,28,20,6256,8269,5770,-2499
2018,5,28,21,6176,8046,5559,-2487
2018,5,28,22,6063,7877,5430,-2447
2018,5,28,23,5878,7618,5344,-2274
2018,5,29,0,5679,7273,4939,-2334
2018,5,29,1,5503,7163,4946,-2217
2018,5,29,2,5266,6889,4871,-2018
2018,5,29,3,4834,6306,4436,-1870
2018,5,29,4,4365,5698,4063,-1635
2018,5,29,5,4057,5179,3787,-1392
2018,5,29,6,3742,4770,3546,-1224
2018,5,29,7,3560,4511,3356,-1155
2018,5,29,8,3451,4375,3230,-1145
2018,5,29,9,3479,4387,3250,-1137
2018,5,29,10,3658,4602,3438,-1164
2018,5,29,11,4017,5062,3822,-1240
2018,5,29,12,4295,5425,3960,-1465
2018,5,29,13,4634,5933,4238,-1695
2018,5,29,14,5126,6467,4487,-1980
2018,5,29,15,5625,7095,4997,-2098
2018,5,29,16,6068,7679,5436,-2243
2018,5,29,17,6395,8211,5747,-2464
2018,5,29,18,6696,8596,6067,-2529
2018,5,29,19,6846,8838,6270,-2568
2018,5,29,20,6922,8776,6312,-2464
2018,5,29,21,6930,8647,6232,-2415
2018,5,29,22,6844,8317,5974,-2343
2018,5,29,23,6664,7891,5772,-2119
2018,5,30,0,6380,7552,5413,-2139
2018,5,30,1,6120,7393,5213,-2180
2018,5,30,2,5748,7027,5033,-1994
2018,5,30,3,5164,6387,4535,-1852
2018,5,30,4,4624,5735,4128,-1607
2018,5,30,5,4153,5205,3844,-1361
2018,5,30,6,3843,4786,3599,-1187
2018,5,30,7,3652,4576,3422,-1154
2018,5,30,8,3542,4449,3326,-1123
2018,5,30,9,3548,4487,3367,-1120
2018,5,30,10,3738,4722,3533,-1189
2018,5,30,11,4090,5175,3806,-1369
2018,5,30,12,4357,5486,3987,-1499
2018,5,30,13,4641,5761,3980,-1781
2018,5,30,14,5062,6092,3976,-2116
2018,5,30,15,5480,6368,4167,-2201
2018,5,30,16,5898,6584,4272,-2312
2018,5,30,17,6172,6630,4244,-2386
2018,5,30,18,6434,6538,4115,-2423
2018,5,30,19,6601,6562,4103,-2459
2018,5,30,20,6644,6710,4184,-2526
2018,5,30,21,6596,6957,4391,-2566
2018,5,30,22,6461,7153,4494,-2659
2018,5,30,23,6243,7194,4532,-2662
2018,5,31,0,5966,7028,4430,-2598
2018,5,31,1,5806,6862,4401,-2461
2018,5,31,2,5521,6650,4417,-2233
2018,5,31,3,5045,6054,3969,-2085
2018,5,31,4,4555,5415,3731,-1684
2018,5,31,5,3939,4891,3419,-1472
2018,5,31,6,3661,4549,3248,-1301
2018,5,31,7,3467,4321,3080,-1241
2018,5,31,8,3381,4211,2995,-1216
2018,5,31,9,3398,4193,2972,-1221
2018,5,31,10,3571,4468,3179,-1289
2018,5,31,11,3938,4898,3493,-1405
2018,5,31,12,4239,5251,3679,-1572
2018,5,31,13,4608,5747,3809,-1938
2018,5,31,14,5105,6387,4168,-2219
2018,5,31,15,5642,7092,4687,-2405
2018,5,31,16,6255,7708,5163,-2545
2018,5,31,17,6662,8249,5505,-2744
2018,5,31,18,7060,8655,5840,-2815
2018,5,31,19,7315,8807,5998,-2809
2018,5,31,20,7444,8692,5901,-2791
2018,5,31,21,7469,8578,5874,-2704
2018,5,31,22,7308,8427,5714,-2713
2018,5,31,23,7082,8243,5503,-2740
2018,6,1,0,6727,7903,5153,-2750
2018,6,1,1,6471,7586,4969,-2617
2018,6,1,2,6113,7237,4869,-2368
2018,6,1,3,5570,6548,4362,-2186
2018,6,1,4,4991,5857,4049,-1808
2018,6,1,5,4067,5274,3682,-1592
2018,6,1,6,3787,4854,3459,-1395
2018,6,1,7,3600,4562,3233,-1329
2018,6,1,8,3493,4409,3117,-1292
2018,6,1,9,3476,4381,3085,-1296
2018,6,1,10,3630,4561,3248,-1313
2018,6,1,11,3977,4954,3634,-1320
2018,6,1,12,4251,5261,3745,-1516
2018,6,1,13,4655,5785,3876,-1909
2018,6,1,14,5192,6484,4229,-2255
2018,6,1,15,5731,7191,4817,-2374
2018,6,1,16,6239,7883,5367,-2516
2018,6,1,17,6660,8476,5843,-2633
2018,6,1,18,6999,9028,6180,-2848
2018,6,1,19,7193,9393,6588,-2805
2018,6,1,20,7286,9481,6672,-2809
2018,6,1,21,7262,9578,6781,-2797
2018,6,1,22,7069,9519,6758,-2761
2018,6,1,23,6821,9191,6378,-2813
2018,6,2,0,6386,8630,5979,-2651
2018,6,2,1,6107,8163,5638,-2525
2018,6,2,2,5819,7754,5439,-2315
2018,6,2,3,5354,7053,4826,-2227
2018,6,2,4,4869,6391,4551,-1840
2018,6,2,5,4372,5780,4173,-1607
2018,6,2,6,4027,5271,3837,-1434
2018,6,2,7,3778,4909,3538,-1371
2018,6,2,8,3619,4691,3366,-1325
2018,6,2,9,3512,4592,3276,-1316
2018,6,2,10,3492,4606,3283,-1323
2018,6,2,11,3558,4688,3314,-1374
2018,6,2,12,3784,5000,3474,-1526
2018,6,2,13,4349,5791,3783,-2008
2018,6,2,14,5072,6597,4258,-2339
2018,6,2,15,5680,7322,4872,-2450
2018,6,2,16,6149,8088,5495,-2593
2018,6,2,17,6475,8718,5926,-2792
2018,6,2,18,6769,9201,6338,-2863
2018,6,2,19,6936,9544,6683,-2861
2018,6,2,20,7005,9762,6896,-2866
2018,6,2,21,6966,9809,6954,-2855
2018,6,2,22,6821,9636,6864,-2772
2018,6,2,23,6664,9270,6560,-2710
2018,6,3,0,6340,8710,6073,-2637
2018,6,3,1,6119,8247,5787,-2460
2018,6,3,2,5836,7827,5586,-2241
2018,6,3,3,5350,7176,5002,-2174
2018,6,3,4,4899,6542,4666,-1876
2018,6,3,5,4400,5921,4294,-1627
2018,6,3,6,4058,5468,3975,-1493
2018,6,3,7,3809,5164,3741,-1423
2018,6,3,8,3639,4932,3560,-1372
2018,6,3,9,3571,4818,3468,-1350
2018,6,3,10,3539,4835,3460,-1375
2018,6,3,11,3570,4925,3531,-1394
2018,6,3,12,3757,5224,3653,-1571
2018,6,3,13,4323,6039,4019,-2020
2018,6,3,14,5096,6860,4562,-2298
2018,6,3,15,5672,7599,5230,-2369
2018,6,3,16,6237,8178,5729,-2449
2018,6,3,17,6606,8574,6036,-2538
2018,6,3,18,6934,8657,6064,-2593
2018,6,3,19,7147,8696,6104,-2592
2018,6,3,20,7201,8681,6097,-2584
2018,6,3,21,7240,8612,5950,-2662
2018,6,3,22,7206,8526,5994,-2532
2018,6,3,23,7024,8256,5923,-2333
2018,6,4,0,6726,7970,5587,-2383
2018,6,4,1,6445,7829,5481,-2348
2018,6,4,2,6095,7567,5399,-2168
2018,6,4,3,5538,7013,4928,-2085
2018,6,4,4,4984,6440,4721,-1719
2018,6,4,5,4509,5991,4399,-1592
2018,6,4,6,4184,5615,4091,-1524
2018,6,4,7,3963,5387,3893,-1494
2018,6,4,8,3835,5246,3782,-1464
2018,6,4,9,3839,5248,3789,-1459
2018,6,4,10,3997,5458,3982,-1476
2018,6,4,11,4288,5852,4290,-1562
2018,6,4,12,4629,6216,4543,-1673
2018,6,4,13,5039,6769,4790,-1979
2018,6,4,14,5676,7465,5288,-2177
2018,6,4,15,6240,8155,5895,-2260
2018,6,4,16,6782,8861,6564,-2297
2018,6,4,17,7170,9505,6981,-2524
2018,6,4,18,7540,9969,7390,-2579
2018,6,4,19,7715,10214,7546,-2668
2018,6,4,20,7748,10386,7679,-2707
2018,6,4,21,7684,10491,7761,-2730
2018,6,4,22,7517,10470,7726,-2744
2018,6,4,23,7378,10133,7380,-2753
2018,6,5,0,7054,9612,6916,-2696
2018,6,5,1,6696,9123,6752,-2371
2018,6,5,2,6313,8639,6574,-2065
2018,6,5,3,5716,7881,5814,-2067
2018,6,5,4,5119,7077,5294,-1783
2018,6,5,5,4649,6308,4676,-1632
2018,6,5,6,4275,5835,4335,-1500
2018,6,5,7,4005,5516,3990,-1526
2018,6,5,8,3839,5328,3859,-1469
2018,6,5,9,3801,5262,3678,-1584
2018,6,5,10,3900,5402,3637,-1765
2018,6,5,11,4198,5739,4078,-1661
2018,6,5,12,4477,6060,4493,-1567
2018,6,5,13,4912,6528,4667,-1861
2018,6,5,14,5394,7191,5040,-2151
2018,6,5,15,5908,7963,5785,-2178
2018,6,5,16,6386,8594,6336,-2258
2018,6,5,17,6823,9191,6773,-2418
2018,6,5,18,7203,9636,7093,-2543
2018,6,5,19,7442,9864,7238,-2626
2018,6,5,20,7520,9962,7298,-2664
2018,6,5,21,7570,10075,7371,-2704
2018,6,5,22,7412,10059,7330,-2729
2018,6,5,23,7198,9806,7163,-2643
2018,6,6,0,6793,9249,6739,-2510
2018,6,6,1,6490,8729,6333,-2396
2018,6,6,2,6116,8203,6100,-2103
2018,6,6,3,5519,7402,5409,-1993
2018,6,6,4,4925,6597,4875,-1722
2018,6,6,5,4565,5917,4287,-1630
2018,6,6,6,4194,5466,3963,-1503
2018,6,6,7,3915,5161,3725,-1436
2018,6,6,8,3749,5023,3515,-1508
2018,6,6,9,3719,4988,3557,-1431
2018,6,6,10,3855,5164,3712,-1452
2018,6,6,11,4101,5587,4160,-1427
2018,6,6,12,4342,5882,4307,-1575
2018,6,6,13,4689,6168,4434,-1734
2018,6,6,14,5026,6583,4747,-1836
2018,6,6,15,5469,7046,5217,-1829
2018,6,6,16,5785,7441,5637,-1804
2018,6,6,17,5946,7415,5619,-1796
2018,6,6,18,6236,7135,5158,-1977
2018,6,6,19,6358,7014,4940,-2074
2018,6,6,20,6338,7035,4725,-2310
2018,6,6,21,6346,7240,4774,-2466
2018,6,6,22,6206,7400,4878,-2522
2018,6,6,23,6071,7460,4913,-2547
2018,6,7,0,5795,7290,4791,-2499
2018,6,7,1,5600,7106,4640,-2466
2018,6,7,2,5374,6818,4555,-2263
2018,6,7,3,4917,6241,4110,-2131
2018,6,7,4,4406,5623,3919,-1704
2018,6,7,5,4070,5065,3555,-1510
2018,6,7,6,3774,4648,3297,-1351
2018,6,7,7,3579,4374,3107,-1267
2018,6,7,8,3476,4229,2991,-1238
2018,6,7,9,3489,4238,2989,-1249
2018,6,7,10,3663,4454,3152,-1302
2018,6,7,11,3969,4878,3495,-1383
2018,6,7,12,4252,5196,3624,-1572
2018,6,7,13,4604,5626,3686,-1940
2018,6,7,14,5061,6242,4068,-2174
2018,6,7,15,5583,6973,4747,-2226
2018,6,7,16,6083,7227,4816,-2411
2018,6,7,17,6437,9118,6520,-2598
2018,6,7,18,6751,8866,6156,-2710
2018,6,7,19,6994,9296,6518,-2778
2018,6,7,20,7030,9612,6888,-2724
2018,6,7,21,7085,9768,7007,-2761
2018,6,7,22,6900,9545,6835,-2710
2018,6,7,23,6654,9085,6449,-2636
2018,6,8,0,6343,8383,5775,-2608
2018,6,8,1,6025,7911,5330,-2581
2018,6,8,2,5785,7487,5194,-2293
2018,6,8,3,5265,6800,4667,-2133
2018,6,8,4,4760,6037,4376,-1661
2018,6,8,5,4139,5450,4022,-1428
2018,6,8,6,3826,4995,3720,-1275
2018,6,8,7,3623,4682,3435,-1247
2018,6,8,8,3516,4539,3311,-1228
2018,6,8,9,3505,4461,3234,-1227
2018,6,8,10,3642,4599,3346,-1253
2018,6,8,11,3881,4940,3628,-1312
2018,6,8,12,4178,5250,3762,-1488
2018,6,8,13,4608,5625,3947,-1678
2018,6,8,14,5062,6254,4375,-1879
2018,6,8,15,5614,6943,4921,-2022
2018,6,8,16,6085,7630,5464,-2166
2018,6,8,17,6323,8234,5923,-2311
2018,6,8,18,6601,8691,6277,-2414
2018,6,8,19,6749,8869,6496,-2373
2018,6,8,20,6800,8640,6218,-2422
2018,6,8,21,6802,8256,6029,-2227
2018,6,8,22,6625,7849,5609,-2240
2018,6,8,23,6328,7429,5245,-2184
2018,6,9,0,5982,6826,4798,-2028
2018,6,9,1,5726,6859,4683,-2176
2018,6,9,2,5480,6647,4661,-1986
2018,6,9,3,5061,6127,4228,-1899
2018,6,9,4,4602,5571,4010,-1561
2018,6,9,5,4433,5050,3581,-1469
2018,6,9,6,4081,4632,3328,-1304
2018,6,9,7,3816,4337,3089,-1248
2018,6,9,8,3650,4134,2938,-1196
2018,6,9,9,3567,4065,2897,-1168
2018,6,9,10,3572,4077,2889,-1188
2018,6,9,11,3606,4188,2946,-1242
2018,6,9,12,3822,4517,3062,-1455
2018,6,9,13,4327,5205,3563,-1642
2018,6,9,14,5040,6037,4127,-1910
2018,6,9,15,5634,6834,4632,-2202
2018,6,9,16,6178,7577,5247,-2330
2018,6,9,17,6582,8163,5843,-2320
2018,6,9,18,6916,8559,6206,-2353
2018,6,9,19,7123,8710,6326,-2384
2018,6,9,20,7207,8751,6294,-2457
2018,6,9,21,7203,9043,6509,-2534
2018,6,9,22,7061,9078,6557,-2521
2018,6,9,23,6742,8784,6341,-2443
2018,6,10,0,6430,8312,6008,-2304
2018,6,10,1,6152,7890,5613,-2277
2018,6,10,2,5873,7496,5352,-2144
2018,6,10,3,5401,6821,4748,-2073
2018,6,10,4,4959,6159,4376,-1783
2018,6,10,5,4245,5512,3993,-1519
2018,6,10,6,3902,4990,3626,-1364
2018,6,10,7,3654,4653,3360,-1293
2018,6,10,8,3491,4408,3228,-1180
2018,6,10,9,3399,4293,3045,-1248
2018,6,10,10,3380,4278,3016,-1262
2018,6,10,11,3416,4313,3046,-1267
2018,6,10,12,3642,4630,3145,-1485
2018,6,10,13,4137,5416,3592,-1824
2018,6,10,14,4915,6297,4277,-2020
2018,6,10,15,5451,7109,4901,-2208
2018,6,10,16,6024,7834,5536,-2298
2018,6,10,17,6465,8422,6077,-2345
2018,6,10,18,6746,8829,6400,-2429
2018,6,10,19,6976,9124,6629,-2495
2018,6,10,20,7056,9360,6821,-2539
2018,6,10,21,7135,9542,6945,-2597
2018,6,10,22,7147,9619,7012,-2607
2018,6,10,23,6834,9425,6887,-2538
2018,6,11,0,6498,8873,6472,-2401
2018,6,11,1,6244,8372,6046,-2326
2018,6,11,2,5929,7918,5778,-2140
2018,6,11,3,5421,7176,5089,-2087
2018,6,11,4,4910,6400,4762,-1638
2018,6,11,5,4433,5866,4278,-1588
2018,6,11,6,4060,5365,3946,-1419
2018,6,11,7,3820,4986,3653,-1333
2018,6,11,8,3688,4781,3489,-1292
2018,6,11,9,3663,4695,3412,-1283
2018,6,11,10,3808,4879,3536,-1343
2018,6,11,11,4052,5222,3802,-1420
2018,6,11,12,4350,5645,4011,-1634
2018,6,11,13,4753,6243,4400,-1843
2018,6,11,14,5361,6962,4912,-2050
2018,6,11,15,5957,7709,5424,-2285
2018,6,11,16,6455,8420,5963,-2457
2018,6,11,17,6942,8994,6383,-2611
2018,6,11,18,7319,9509,6762,-2747
2018,6,11,19,7608,9848,7097,-2751
2018,6,11,20,7720,10051,7301,-2750
2018,6,11,21,7781,9967,7183,-2784
2018,6,11,22,7652,9702,6910,-2792
2018,6,11,23,7342,9236,6480,-2756
2018,6,12,0,6955,8687,6060,-2627
2018,6,12,1,6622,8261,5700,-2561
2018,6,12,2,6250,7805,5443,-2362
2018,6,12,3,5667,7045,4756,-2289
2018,6,12,4,5068,6320,4469,-1851
2018,6,12,5,4416,5458,3847,-1611
2018,6,12,6,4037,5013,3577,-1436
2018,6,12,7,3790,4709,3336,-1373
2018,6,12,8,3650,4523,3202,-1321
2018,6,12,9,3644,4485,3188,-1297
2018,6,12,10,3771,4645,3287,-1358
2018,6,12,11,4031,5041,3600,-1441
2018,6,12,12,4317,5375,3766,-1609
2018,6,12,13,4715,5853,4005,-1848
2018,6,12,14,5311,6509,4406,-2103
2018,6,12,15,5898,7290,4922,-2368
2018,6,12,16,6409,7924,5442,-2482
2018,6,12,17,6829,8398,5854,-2544
2018,6,12,18,7202,8793,6163,-2630
2018,6,12,19,7477,9075,6461,-2614
2018,6,12,20,7566,9279,6689,-2590
2018,6,12,21,7592,9345,6724,-2621
2018,6,12,22,7421,9160,6491,-2669
2018,6,12,23,7187,8827,6150,-2677
2018,6,13,0,6799,8420,5875,-2545
2018,6,13,1,6496,7956,5459,-2497
2018,6,13,2,6155,7563,5293,-2270
2018,6,13,3,5589,6833,4656,-2177
2018,6,13,4,4988,6099,4276,-1823
2018,6,13,5,4328,5462,3848,-1614
2018,6,13,6,3965,5017,3593,-1424
2018,6,13,7,3733,4733,3393,-1340
2018,6,13,8,3624,4554,3254,-1300
2018,6,13,9,3599,4496,3234,-1262
2018,6,13,10,3727,4680,3337,-1343
2018,6,13,11,3976,5036,3611,-1425
2018,6,13,12,4280,5433,3874,-1559
2018,6,13,13,4686,5967,4167,-1800
2018,6,13,14,5311,6693,4617,-2076
2018,6,13,15,5945,7473,5179,-2294
2018,6,13,16,6536,8246,5768,-2478
2018,6,13,17,6983,8785,6159,-2626
2018,6,13,18,7416,9282,6364,-2918
2018,6,13,19,7743,9717,6712,-3005
2018,6,13,20,7909,10024,7022,-3002
2018,6,13,21,7934,10150,7152,-2998
2018,6,13,22,7755,9860,6920,-2940
2018,6,13,23,7474,9386,6544,-2842
2018,6,14,0,7070,8839,6108,-2731
2018,6,14,1,6788,8349,5766,-2583
2018,6,14,2,6246,7844,5568,-2276
2018,6,14,3,5863,7107,4878,-2229
2018,6,14,4,5261,6316,4416,-1900
2018,6,14,5,4559,5653,3945,-1708
2018,6,14,6,4188,5165,3650,-1515
2018,6,14,7,3951,4851,3418,-1433
2018,6,14,8,3817,4666,3284,-1382
2018,6,14,9,3809,4587,3208,-1379
2018,6,14,10,3935,4737,3336,-1401
2018,6,14,11,4203,5079,3601,-1478
2018,6,14,12,4485,5483,3881,-1602
2018,6,14,13,4932,6055,4190,-1865
2018,6,14,14,5522,6766,4607,-2159
2018,6,14,15,6173,7515,5144,-2371
2018,6,14,16,6700,8289,5758,-2531
2018,6,14,17,7110,8986,6299,-2687
2018,6,14,18,7545,9485,6661,-2824
2018,6,14,19,7752,9873,6983,-2890
2018,6,14,20,7894,10062,7137,-2925
2018,6,14,21,7891,10141,7198,-2943
2018,6,14,22,7659,9884,6937,-2947
2018,6,14,23,7392,9452,6466,-2986
2018,6,15,0,7018,8913,5965,-2948
2018,6,15,1,6713,8458,5842,-2616
2018,6,15,2,6379,7986,5662,-2324
2018,6,15,3,5801,7218,4944,-2274
2018,6,15,4,5217,6452,4542,-1910
2018,6,15,5,4613,5779,4038,-1741
2018,6,15,6,4242,5297,3779,-1518
2018,6,15,7,4003,4994,3553,-1441
2018,6,15,8,3857,4801,3402,-1399
2018,6,15,9,3836,4725,3337,-1388
2018,6,15,10,3951,4841,3422,-1419
2018,6,15,11,4181,5167,3667,-1500
2018,6,15,12,4496,5569,3953,-1616
2018,6,15,13,4967,6249,4352,-1897
2018,6,15,14,5536,6992,4804,-2188
2018,6,15,15,6174,7771,5343,-2428
2018,6,15,16,6690,8511,5916,-2595
2018,6,15,17,7108,9125,6429,-2696
2018,6,15,18,7464,9523,6884,-2639
2018,6,15,19,7680,9716,7033,-2683
2018,6,15,20,7788,9626,6911,-2715
2018,6,15,21,7777,9639,6909,-2730
2018,6,15,22,7505,9458,6785,-2673
2018,6,15,23,7259,9083,6354,-2729
2018,6,16,0,6836,8511,5846,-2665
2018,6,16,1,6491,8148,5598,-2550
2018,6,16,2,6036,7767,5482,-2285
2018,6,16,3,5708,7117,4913,-2204
2018,6,16,4,5221,6459,4547,-1912
2018,6,16,5,4756,5853,4150,-1703
2018,6,16,6,4397,5379,3873,-1506
2018,6,16,7,4142,5016,3577,-1439
2018,6,16,8,3965,4786,3406,-1380
2018,6,16,9,3877,4688,3337,-1351
2018,6,16,10,3879,4696,3325,-1371
2018,6,16,11,3906,4799,3398,-1401
2018,6,16,12,4145,5093,3543,-1550
2018,6,16,13,4738,5875,3980,-1895
2018,6,16,14,5423,6788,4579,-2209
2018,6,16,15,6062,7672,5263,-2409
2018,6,16,16,6640,8404,5791,-2613
2018,6,16,17,7041,8964,6310,-2654
2018,6,16,18,7328,9368,6734,-2634
2018,6,16,19,7481,9619,6985,-2634
2018,6,16,20,7498,9534,6966,-2568
2018,6,16,21,7520,9107,6510,-2597
2018,6,16,22,7290,8869,6167,-2702
2018,6,16,23,7098,8477,5793,-2684
2018,6,17,0,6786,7987,5412,-2575
2018,6,17,1,6490,7633,5030,-2603
2018,6,17,2,6215,7300,4923,-2377
2018,6,17,3,5741,6705,4459,-2246
2018,6,17,4,5282,7701,5831,-1870
2018,6,17,5,4661,5725,4049,-1676
2018,6,17,6,4315,5273,3806,-1467
2018,6,17,7,4061,4946,3558,-1388
2018,6,17,8,3866,4720,3368,-1352
2018,6,17,9,3781,4553,3256,-1297
2018,6,17,10,3756,4547,3205,-1342
2018,6,17,11,3776,4589,3226,-1363
2018,6,17,12,4006,4877,3353,-1524
2018,6,17,13,4634,5695,3809,-1886
2018,6,17,14,5339,6653,4450,-2203
2018,6,17,15,6009,7571,5065,-2506
2018,6,17,16,6554,8413,5795,-2618
2018,6,17,17,7069,9100,6423,-2677
2018,6,17,18,7303,9579,6794,-2785
2018,6,17,19,7492,9935,7098,-2837
2018,6,17,20,7467,10177,7329,-2848
2018,6,17,21,7429,10178,7395,-2783
2018,6,17,22,7348,9836,7130,-2706
2018,6,17,23,7132,9394,6700,-2694
2018,6,18,0,6837,8906,6336,-2570
2018,6,18,1,6560,8543,6034,-2509
2018,6,18,2,6277,8168,5849,-2319
2018,6,18,3,5766,7418,5151,-2267
2018,6,18,4,5262,6658,4696,-1962
2018,6,18,5,4743,6012,4394,-1618
2018,6,18,6,4380,5533,4174,-1359
2018,6,18,7,4145,5178,3914,-1264
2018,6,18,8,4003,5011,3773,-1238
2018,6,18,9,3977,4940,3711,-1229
2018,6,18,10,4120,5144,3893,-1251
2018,6,18,11,4379,5502,4109,-1393
2018,6,18,12,4686,5917,4387,-1530
2018,6,18,13,5162,6514,4624,-1890
2018,6,18,14,5764,7250,5057,-2193
2018,6,18,15,6398,8063,5742,-2321
2018,6,18,16,6968,8835,6428,-2407
2018,6,18,17,7421,9469,6896,-2573
2018,6,18,18,7837,10014,7251,-2763
2018,6,18,19,8044,10350,7509,-2841
2018,6,18,20,8069,10573,7705,-2868
2018,6,18,21,8036,10731,7837,-2894
2018,6,18,22,7833,10475,7582,-2893
2018,6,18,23,7647,10460,7636,-2824
2018,6,19,0,7345,9930,7219,-2711
2018,6,19,1,6966,9379,6765,-2614
2018,6,19,2,6398,8732,6304,-2428
2018,6,19,3,5967,7846,5501,-2345
2018,6,19,4,5382,6996,4958,-2038
2018,6,19,5,4922,6205,4472,-1733
2018,6,19,6,4530,5705,4267,-1438
2018,6,19,7,4278,5356,3992,-1364
2018,6,19,8,4118,5101,3806,-1295
2018,6,19,9,4069,5013,3724,-1289
2018,6,19,10,4199,5138,3816,-1322
2018,6,19,11,4460,5487,4010,-1477
2018,6,19,12,4744,5842,4271,-1571
2018,6,19,13,5212,6403,4573,-1830
2018,6,19,14,5777,7173,5102,-2071
2018,6,19,15,6420,8050,5890,-2160
2018,6,19,16,7012,8926,6719,-2207
2018,6,19,17,7497,9585,7251,-2334
2018,6,19,18,7948,10263,7824,-2439
2018,6,19,19,8229,10635,8100,-2535
2018,6,19,20,8355,10495,8125,-2370
2018,6,19,21,8381,10401,8051,-2350
2018,6,19,22,8159,10155,7803,-2352
2018,6,19,23,7948,9979,7673,-2306
2018,6,20,0,7596,9558,7388,-2170
2018,6,20,1,7195,9099,7048,-2051
2018,6,20,2,6683,8592,6790,-1802
2018,6,20,3,6179,7825,6144,-1681
2018,6,20,4,5552,7048,5419,-1629
2018,6,20,5,5027,6311,4848,-1463
2018,6,20,6,4622,5800,4493,-1307
2018,6,20,7,4336,5446,4223,-1223
2018,6,20,8,4172,5229,4033,-1196
2018,6,20,9,4104,5187,3975,-1212
2018,6,20,10,4215,5354,4117,-1237
2018,6,20,11,4468,5683,4307,-1376
2018,6,20,12,4767,6023,4536,-1487
2018,6,20,13,5204,6550,4961,-1589
2018,6,20,14,5820,7219,5436,-1783
2018,6,20,15,6493,7948,6086,-1862
2018,6,20,16,7200,8704,6630,-2074
2018,6,20,17,7741,9459,7085,-2374
2018,6,20,18,8189,10021,7439,-2582
2018,6,20,19,8477,10374,7692,-2682
2018,6,20,20,8631,10558,7995,-2563
2018,6,20,21,8674,10632,7912,-2720
2018,6,20,22,8424,10449,7694,-2755
2018,6,20,23,8145,9947,7248,-2699
2018,6,21,0,7702,9342,6800,-2542
2018,6,21,1,7287,8931,6505,-2426
2018,6,21,2,6673,8492,6273,-2219
2018,6,21,3,6246,7728,5730,-1998
2018,6,21,4,5657,7011,5196,-1815
2018,6,21,5,5164,6416,4746,-1670
2018,6,21,6,4767,5943,4365,-1578
2018,6,21,7,4496,5639,4094,-1545
2018,6,21,8,4310,5481,3961,-1520
2018,6,21,9,4250,5460,3936,-1524
2018,6,21,10,4357,5659,4104,-1555
2018,6,21,11,4606,6001,4354,-1647
2018,6,21,12,4893,6386,4671,-1715
2018,6,21,13,5334,7011,5149,-1862
2018,6,21,14,5869,7718,5722,-1996
2018,6,21,15,6435,8325,6286,-2039
2018,6,21,16,7096,8628,6498,-2130
2018,6,21,17,7559,8584,6348,-2236
2018,6,21,18,8042,8505,6155,-2350
2018,6,21,19,8297,8437,5959,-2478
2018,6,21,20,8338,8499,5986,-2513
2018,6,21,21,8308,8659,6097,-2562
2018,6,21,22,8069,8761,6253,-2508
2018,6,21,23,7897,8701,6176,-2525
2018,6,22,0,7485,8472,5941,-2531
2018,6,22,1,7139,8263,5952,-2311
2018,6,22,2,6703,7953,5801,-2152
2018,6,22,3,6161,7340,5251,-2089
2018,6,22,4,5559,6689,4911,-1778
2018,6,22,5,5066,6108,4552,-1556
2018,6,22,6,4684,5701,4286,-1415
2018,6,22,7,4437,5386,3940,-1446
2018,6,22,8,4281,5222,3760,-1462
2018,6,22,9,4242,5176,3716,-1460
2018,6,22,10,4357,5330,3850,-1480
2018,6,22,11,4593,5683,4208,-1475
2018,6,22,12,4900,5988,4429,-1559
2018,6,22,13,5360,6518,4772,-1746
2018,6,22,14,5907,7238,5206,-2032
2018,6,22,15,6475,8025,5867,-2158
2018,6,22,16,7040,8776,6470,-2306
2018,6,22,17,7491,9424,7058,-2366
2018,6,22,18,7925,9937,7441,-2496
2018,6,22,19,8149,10350,7730,-2620
2018,6,22,20,8229,10625,7963,-2662
2018,6,22,21,8170,10659,7960,-2699
2018,6,22,22,7910,10282,7592,-2690
2018,6,22,23,7682,9731,7091,-2640
2018,6,23,0,7214,9162,6588,-2574
2018,6,23,1,6859,8720,6329,-2391
2018,6,23,2,6513,8308,6167,-2141
2018,6,23,3,6043,7655,5533,-2122
2018,6,23,4,5532,6993,5189,-1804
2018,6,23,5,4856,6418,4698,-1720
2018,6,23,6,4513,5915,4327,-1588
2018,6,23,7,4260,5568,3965,-1603
2018,6,23,8,4093,5312,3783,-1529
2018,6,23,9,4017,5215,3702,-1513
2018,6,23,10,4027,5183,3686,-1497
2018,6,23,11,4082,5249,3734,-1515
2018,6,23,12,4323,5608,3938,-1670
2018,6,23,13,4892,6443,4451,-1992
2018,6,23,14,5611,7389,5154,-2235
2018,6,23,15,6276,8237,5808,-2429
2018,6,23,16,6882,8981,6328,-2653
2018,6,23,17,7393,9581,6714,-2867
2018,6,23,18,7738,9961,7017,-2944
2018,6,23,19,7876,10289,7285,-3004
2018,6,23,20,7937,10475,7428,-3047
2018,6,23,21,7868,10364,7308,-3056
2018,6,23,22,7700,9945,6929,-3016
2018,6,23,23,7385,9513,6526,-2987
2018,6,24,0,7072,8975,6109,-2866
2018,6,24,1,6753,8549,5775,-2774
2018,6,24,2,6403,8177,5680,-2497
2018,6,24,3,5926,7588,5179,-2409
2018,6,24,4,5460,6929,4823,-2106
2018,6,24,5,4892,6320,4541,-1779
2018,6,24,6,4505,5845,4197,-1648
2018,6,24,7,4228,5469,3870,-1599
2018,6,24,8,4026,5236,3671,-1565
2018,6,24,9,3916,5074,3561,-1513
2018,6,24,10,3888,5029,3532,-1497
2018,6,24,11,3906,5040,3529,-1511
2018,6,24,12,4129,5330,3662,-1668
2018,6,24,13,4725,6191,4152,-2039
2018,6,24,14,5466,0,4152,-2361
2018,6,24,15,6172,8160,5577,-2583
2018,6,24,16,6766,8934,6234,-2700
2018,6,24,17,7241,9623,6910,-2713
2018,6,24,18,7581,10132,7277,-2855
2018,6,24,19,7744,10461,7565,-2896
2018,6,24,20,7743,10539,7614,-2925
2018,6,24,21,7633,10206,7326,-2880
2018,6,24,22,7483,9691,6790,-2901
2018,6,24,23,7266,9050,6273,-2777
2018,6,25,0,6969,8349,5790,-2559
2018,6,25,1,6668,7895,5489,-2406
2018,6,25,2,6337,7512,5252,-2260
2018,6,25,3,5842,6874,4644,-2230
2018,6,25,4,5317,6200,4241,-1959
2018,6,25,5,4952,5601,3803,-1798
2018,6,25,6,4543,5179,3589,-1590
2018,6,25,7,4281,4884,3383,-1501
2018,6,25,8,4112,4706,3263,-1443
2018,6,25,9,4054,4678,3250,-1428
2018,6,25,10,4183,4892,3407,-1485
2018,6,25,11,4458,5292,3703,-1589
2018,6,25,12,4789,5726,4016,-1710
2018,6,25,13,5284,6403,4402,-2001
2018,6,25,14,5897,7148,4872,-2276
2018,6,25,15,6581,7970,5474,-2496
2018,6,25,16,7202,8802,6181,-2621
2018,6,25,17,7749,9539,6875,-2664
2018,6,25,18,8126,10075,7363,-2712
2018,6,25,19,8333,10471,7739,-2732
2018,6,25,20,8445,10638,7839,-2799
2018,6,25,21,8480,10610,7839,-2771
2018,6,25,22,8239,10398,7628,-2770
2018,6,25,23,8037,9952,7265,-2687
2018,6,26,0,7602,9273,6647,-2626
2018,6,26,1,7217,8696,6167,-2529
2018,6,26,2,6813,8220,5992,-2228
2018,6,26,3,6203,7434,5390,-2044
2018,6,26,4,5592,6674,4880,-1794
2018,6,26,5,4967,5973,4409,-1564
2018,6,26,6,4562,5465,3968,-1497
2018,6,26,7,4310,5112,3638,-1474
2018,6,26,8,4124,4944,3518,-1426
2018,6,26,9,4066,4926,3515,-1411
2018,6,26,10,4179,5092,3645,-1447
2018,6,26,11,4450,5493,4028,-1465
2018,6,26,12,4761,5849,4303,-1546
2018,6,26,13,5182,6443,4668,-1775
2018,6,26,14,5794,7205,5291,-1914
2018,6,26,15,6482,7937,6055,-1882
2018,6,26,16,7059,8752,6821,-1931
2018,6,26,17,7632,9472,7380,-2092
2018,6,26,18,8060,9983,7712,-2271
2018,6,26,19,8336,10342,7926,-2416
2018,6,26,20,8440,10489,8087,-2402
2018,6,26,21,8446,10505,8071,-2434
2018,6,26,22,8314,10320,7986,-2334
2018,6,26,23,8080,9747,7438,-2309
2018,6,27,0,7667,9086,6824,-2262
2018,6,27,1,7274,8593,6613,-1980
2018,6,27,2,6740,8042,6297,-1745
2018,6,27,3,6228,7334,5635,-1699
2018,6,27,4,5627,6605,5066,-1539
2018,6,27,5,4860,5996,4498,-1498
2018,6,27,6,4482,5490,4092,-1398
2018,6,27,7,4225,5168,3843,-1325
2018,6,27,8,4071,4979,3684,-1295
2018,6,27,9,4019,4939,3648,-1291
2018,6,27,10,4132,5108,3782,-1326
2018,6,27,11,4371,5456,4074,-1382
2018,6,27,12,4645,5832,4400,-1432
2018,6,27,13,5046,6380,4719,-1661
2018,6,27,14,5708,7164,5223,-1941
2018,6,27,15,6341,7924,5819,-2105
2018,6,27,16,6907,8644,6355,-2289
2018,6,27,17,7433,9288,6864,-2424
2018,6,27,18,7907,9772,7387,-2385
2018,6,27,19,8157,10014,7537,-2477
2018,6,27,20,8248,10022,7433,-2589
2018,6,27,21,8221,9897,7315,-2582
2018,6,27,22,8091,9789,7156,-2633
2018,6,27,23,7835,9539,6945,-2594
2018,6,28,0,7426,9110,6535,-2575
2018,6,28,1,7056,8704,6288,-2416
2018,6,28,2,6622,8278,6146,-2132
2018,6,28,3,6080,7538,5476,-2062
2018,6,28,4,5517,6804,5043,-1761
2018,6,28,5,4899,6120,4608,-1512
2018,6,28,6,4519,5648,4201,-1447
2018,6,28,7,4266,5349,3886,-1463
2018,6,28,8,4118,5119,3718,-1401
2018,6,28,9,4080,5069,3682,-1387
2018,6,28,10,4203,5271,3855,-1416
2018,6,28,11,4477,5662,4169,-1493
2018,6,28,12,4755,6008,4373,-1635
2018,6,28,13,5208,6666,4748,-1918
2018,6,28,14,5787,7488,5230,-2258
2018,6,28,15,6425,8334,5903,-2431
2018,6,28,16,6997,9018,6478,-2540
2018,6,28,17,7483,9506,6928,-2578
2018,6,28,18,7897,9541,7025,-2516
2018,6,28,19,8098,9303,6827,-2476
2018,6,28,20,8147,9027,6594,-2433
2018,6,28,21,8096,8805,6294,-2511
2018,6,28,22,7849,8635,6038,-2597
2018,6,28,23,7692,8489,5893,-2596
2018,6,29,0,7233,8239,5604,-2635
2018,6,29,1,6906,7917,5282,-2635
2018,6,29,2,6543,7642,5211,-2431
2018,6,29,3,5979,7043,4792,-2251
2018,6,29,4,5437,6349,4514,-1835
2018,6,29,5,5085,5560,3901,-1659
2018,6,29,6,4715,5143,3659,-1484
2018,6,29,7,4487,4873,3470,-1403
2018,6,29,8,4313,4716,3331,-1385
2018,6,29,9,4280,4892,3520,-1372
2018,6,29,10,4398,5069,3666,-1403
2018,6,29,11,4642,5441,3955,-1486
2018,6,29,12,4954,5757,4154,-1603
2018,6,29,13,5406,6305,4438,-1867
2018,6,29,14,6011,7016,4747,-2269
2018,6,29,15,6623,7685,5340,-2345
2018,6,29,16,7220,8293,5861,-2432
2018,6,29,17,7643,8626,6143,-2483
2018,6,29,18,7972,8672,6109,-2563
2018,6,29,19,8178,8389,5836,-2553
2018,6,29,20,8248,8205,5631,-2574
2018,6,29,21,8217,8037,5465,-2572
2018,6,29,22,8079,7858,5314,-2544
2018,6,29,23,7750,7597,5108,-2489
2018,6,30,0,7299,7338,4926,-2412
2018,6,30,1,6997,7210,4848,-2362
2018,6,30,2,6712,7011,4822,-2189
2018,6,30,3,6187,6578,4358,-2220
2018,6,30,4,5676,6054,4013,-2041
2018,6,30,5,4616,5586,3883,-1703
2018,6,30,6,4283,5209,3693,-1516
2018,6,30,7,4050,4930,3501,-1429
2018,6,30,8,3857,4768,3366,-1402
2018,6,30,9,3829,4694,3315,-1379
2018,6,30,10,3809,4737,3341,-1396
2018,6,30,11,3885,4852,3419,-1433
2018,6,30,12,4200,5161,3562,-1599
2018,6,30,13,4812,5774,3766,-2008
2018,6,30,14,5393,6497,4185,-2312
2018,6,30,15,5928,7107,4521,-2586
2018,6,30,16,6321,7667,5051,-2616
2018,6,30,17,6610,7912,5280,-2632
2018,6,30,18,6777,7703,5114,-2589
2018,6,30,19,6717,7259,4760,-2499
2018,6,30,20,6567,6985,4552,-2433
2018,6,30,21,6455,6851,4447,-2404
2018,6,30,22,6269,6768,4347,-2421
2018,6,30,23,6140,6629,4158,-2471
2018,7,1,0,5984,6475,4063,-2412
2018,7,1,1,5775,6470,4151,-2319
2018,7,1,2,5620,6341,4325,-2016
2018,7,1,3,5178,5982,4052,-1930
2018,7,1,4,4793,5575,3848,-1727
2018,7,1,5,4354,5086,3521,-1565
2018,7,1,6,4407,4747,3349,-1398
2018,7,1,7,3853,4511,3267,-1244
2018,7,1,8,3728,4391,3196,-1195
2018,7,1,9,3926,4321,3147,-1174
2018,7,1,10,3653,4337,3158,-1179
2018,7,1,11,3731,4420,3202,-1218
2018,7,1,12,3976,4760,3365,-1395
2018,7,1,13,4540,5584,3752,-1832
2018,7,1,14,5269,6512,4348,-2164
2018,7,1,15,5892,7315,4918,-2397
2018,7,1,16,6492,7918,5462,-2456
2018,7,1,17,7033,8340,5685,-2655
2018,7,1,18,7322,8687,6224,-2463
2018,7,1,19,7568,9116,6487,-2629
2018,7,1,20,7581,9492,6786,-2706
2018,7,1,21,7483,9619,6939,-2680
2018,7,1,22,7380,9584,6941,-2643
2018,7,1,23,7074,9267,6723,-2544
2018,7,2,0,6761,8705,6198,-2507
2018,7,2,1,6433,8235,5704,-2531
2018,7,2,2,6187,7832,5427,-2405
2018,7,2,3,5684,7109,4768,-2341
2018,7,2,4,5228,6438,4399,-2039
2018,7,2,5,4683,5801,4101,-1700
2018,7,2,6,4318,5332,3864,-1468
2018,7,2,7,4058,4989,3584,-1405
2018,7,2,8,3923,4830,3429,-1401
2018,7,2,9,3897,4760,3368,-1392
2018,7,2,10,4036,4946,3546,-1400
2018,7,2,11,4346,5265,3777,-1488
2018,7,2,12,4667,5593,3974,-1619
2018,7,2,13,5161,6237,4184,-2053
2018,7,2,14,5855,7084,4662,-2422
2018,7,2,15,6486,7970,5419,-2551
2018,7,2,16,7127,8816,6195,-2621
2018,7,2,17,7737,9540,6847,-2693
2018,7,2,18,8136,10010,6968,-3042
2018,7,2,19,8330,10352,7223,-3129
2018,7,2,20,8397,10518,7360,-3158
2018,7,2,21,8399,10517,7316,-3201
2018,7,2,22,8256,10334,7109,-3225
2018,7,2,23,7861,9922,6811,-3111
2018,7,3,0,7449,9409,6654,-2755
2018,7,3,1,7085,8934,6311,-2623
2018,7,3,2,6665,8443,6020,-2423
2018,7,3,3,6083,7628,5258,-2370
2018,7,3,4,5504,6811,4639,-2172
2018,7,3,5,4910,6134,4256,-1878
2018,7,3,6,4504,5616,4059,-1557
2018,7,3,7,4247,5268,3804,-1464
2018,7,3,8,4079,5044,3603,-1441
2018,7,3,9,4017,4951,3524,-1427
2018,7,3,10,4132,5093,3674,-1419
2018,7,3,11,4323,5453,3971,-1482
2018,7,3,12,4575,5824,4190,-1634
2018,7,3,13,5072,6422,4391,-2031
2018,7,3,14,5731,7142,4742,-2400
2018,7,3,15,6309,7973,5473,-2500
2018,7,3,16,6848,8834,6271,-2563
2018,7,3,17,7333,9566,6908,-2658
2018,7,3,18,7657,10022,7274,-2748
2018,7,3,19,7824,9972,7075,-2897
2018,7,3,20,7835,9551,6843,-2708
2018,7,3,21,7751,9149,6565,-2584
2018,7,3,22,7474,8749,6132,-2617
2018,7,3,23,7319,8460,5905,-2555
2018,7,4,0,6805,8051,5617,-2434
2018,7,4,1,6501,7720,5377,-2343
2018,7,4,2,6174,7396,5150,-2246
2018,7,4,3,5696,6829,4592,-2237
2018,7,4,4,5203,6248,4228,-2020
2018,7,4,5,4720,5706,3908,-1798
2018,7,4,6,4339,5238,3738,-1500
2018,7,4,7,4084,4921,3506,-1415
2018,7,4,8,3904,4751,3360,-1391
2018,7,4,9,3827,4675,3297,-1378
2018,7,4,10,3845,4707,3311,-1396
2018,7,4,11,3898,4792,3387,-1405
2018,7,4,12,4100,5000,3449,-1551
2018,7,4,13,4606,5640,3663,-1977
2018,7,4,14,5287,6473,4112,-2361
2018,7,4,15,5889,7330,4796,-2534
2018,7,4,16,6481,8009,5407,-2602
2018,7,4,17,6863,8483,5827,-2656
2018,7,4,18,7050,8627,5937,-2690
2018,7,4,19,7129,8424,5734,-2690
2018,7,4,20,7143,8190,5526,-2664
2018,7,4,21,7062,7931,5317,-2614
2018,7,4,22,6816,7582,5010,-2572
2018,7,4,23,6487,7299,4716,-2583
2018,7,5,0,6106,6954,4481,-2473
2018,7,5,1,5805,6694,4324,-2370
2018,7,5,2,5504,6381,4195,-2186
2018,7,5,3,5201,6114,3971,-2143
2018,7,5,4,4877,5647,3697,-1950
2018,7,5,5,4411,5122,3371,-1751
2018,7,5,6,4088,4741,3317,-1424
2018,7,5,7,3864,4468,3131,-1337
2018,7,5,8,3726,4304,3008,-1296
2018,7,5,9,3692,4281,2980,-1301
2018,7,5,10,3850,4443,3113,-1330
2018,7,5,11,4097,4792,3390,-1402
2018,7,5,12,4398,5061,3541,-1520
2018,7,5,13,4869,5688,3800,-1888
2018,7,5,14,5498,6352,4072,-2280
2018,7,5,15,6052,7174,4674,-2500
2018,7,5,16,6669,7916,5378,-2538
2018,7,5,17,7083,8553,5937,-2616
2018,7,5,18,7436,8890,6184,-2706
2018,7,5,19,7605,8975,6250,-2725
2018,7,5,20,7697,8894,6162,-2732
2018,7,5,21,7616,8805,6101,-2704
2018,7,5,22,7346,8672,6042,-2630
2018,7,5,23,7003,8368,5860,-2508
2018,7,6,0,6630,7933,5427,-2506
2018,7,6,1,6374,7517,5080,-2437
2018,7,6,2,6096,7129,4822,-2307
2018,7,6,3,5614,6498,4272,-2226
2018,7,6,4,5122,5838,3848,-1990
2018,7,6,5,4496,5295,3541,-1754
2018,7,6,6,4168,4918,3461,-1457
2018,7,6,7,3940,4649,3275,-1374
2018,7,6,8,3803,4512,3162,-1350
2018,7,6,9,3791,4468,3143,-1325
2018,7,6,10,3934,4634,3272,-1362
2018,7,6,11,4211,4986,3552,-1434
2018,7,6,12,4474,5289,3749,-1540
2018,7,6,13,4898,5737,3954,-1783
2018,7,6,14,5490,6279,4095,-2184
2018,7,6,15,6034,6863,4596,-2267
2018,7,6,16,6682,7570,5219,-2351
2018,7,6,17,7031,8258,5749,-2509
2018,7,6,18,7378,8745,6103,-2642
2018,7,6,19,7537,9078,6233,-2845
2018,7,6,20,7572,9097,6150,-2947
2018,7,6,21,7515,8860,5999,-2861
2018,7,6,22,7276,8491,5746,-2745
2018,7,6,23,6976,8065,5463,-2602
2018,7,7,0,6536,7579,5048,-2531
2018,7,7,1,6284,7223,4690,-2533
2018,7,7,2,6005,6924,4561,-2363
2018,7,7,3,5585,6425,4194,-2231
2018,7,7,4,5158,5858,4009,-1849
2018,7,7,5,4506,5294,3698,-1596
2018,7,7,6,4178,4879,3446,-1433
2018,7,7,7,3939,4578,3197,-1381
2018,7,7,8,3793,4399,3054,-1345
2018,7,7,9,3735,4317,2987,-1330
2018,7,7,10,3723,4331,3010,-1321
2018,7,7,11,3766,4458,3105,-1353
2018,7,7,12,3992,4718,3186,-1532
2018,7,7,13,4506,5422,3591,-1831
2018,7,7,14,5132,6255,4107,-2148
2018,7,7,15,5631,7050,4689,-2361
2018,7,7,16,6218,7817,5287,-2530
2018,7,7,17,6588,8474,5838,-2636
2018,7,7,18,6762,8916,6216,-2700
2018,7,7,19,6843,9221,6454,-2767
2018,7,7,20,6892,9417,6620,-2797
2018,7,7,21,6833,9382,6609,-2773
2018,7,7,22,6680,9181,6404,-2777
2018,7,7,23,6432,8681,6054,-2627
2018,7,8,0,6175,8121,5539,-2582
2018,7,8,1,6017,7718,5169,-2549
2018,7,8,2,5743,7394,5024,-2370
2018,7,8,3,5312,6774,4624,-2150
2018,7,8,4,4926,6153,4351,-1802
2018,7,8,5,4497,5567,4070,-1497
2018,7,8,6,4171,5113,3935,-1178
2018,7,8,7,3930,4777,3716,-1061
2018,7,8,8,3784,4556,3534,-1022
2018,7,8,9,3720,4436,3450,-986
2018,7,8,10,3703,4398,3407,-991
2018,7,8,11,3738,4479,3476,-1003
2018,7,8,12,3971,4752,3514,-1238
2018,7,8,13,4520,5550,3910,-1640
2018,7,8,14,5314,6465,4512,-1953
2018,7,8,15,5990,7315,5164,-2151
2018,7,8,16,6689,8037,5691,-2346
2018,7,8,17,7120,8651,6084,-2567
2018,7,8,18,7408,9077,6279,-2798
2018,7,8,19,7605,9414,6544,-2870
2018,7,8,20,7655,9629,6744,-2885
2018,7,8,21,7642,9782,6896,-2886
2018,7,8,22,7483,9792,6891,-2901
2018,7,8,23,7292,9620,6830,-2790
2018,7,9,0,6882,9090,6400,-2690
2018,7,9,1,6619,8582,5974,-2608
2018,7,9,2,6324,8114,5761,-2353
2018,7,9,3,5775,7373,5082,-2291
2018,7,9,4,5257,6377,4434,-1943
2018,7,9,5,4565,5986,4238,-1748
2018,7,9,6,4225,5460,3916,-1544
2018,7,9,7,4006,5116,3618,-1498
2018,7,9,8,3881,4889,3456,-1433
2018,7,9,9,3868,4812,3389,-1423
2018,7,9,10,4034,4971,3548,-1423
2018,7,9,11,4305,5328,3789,-1539
2018,7,9,12,4582,5659,3978,-1681
2018,7,9,13,5034,6172,4247,-1925
2018,7,9,14,5592,6792,4425,-2367
2018,7,9,15,6178,7484,4993,-2491
2018,7,9,16,6652,8243,5624,-2619
2018,7,9,17,6910,8924,6056,-2868
2018,7,9,18,7130,9397,6476,-2921
2018,7,9,19,7241,9386,6456,-2930
2018,7,9,20,7260,9324,6477,-2847
2018,7,9,21,7232,9208,6465,-2743
2018,7,9,22,7042,9135,6416,-2719
2018,7,9,23,6815,8848,6066,-2782
2018,7,10,0,6555,8464,5928,-2536
2018,7,10,1,6346,8157,5739,-2418
2018,7,10,2,5989,7823,5611,-2212
2018,7,10,3,5502,7099,4904,-2195
2018,7,10,4,4998,6376,4527,-1849
2018,7,10,5,4558,5742,4080,-1662
2018,7,10,6,4227,5275,3797,-1478
2018,7,10,7,4001,4970,3552,-1418
2018,7,10,8,3869,4771,3394,-1377
2018,7,10,9,3834,4710,3341,-1369
2018,7,10,10,3988,4890,3465,-1425
2018,7,10,11,4293,5253,3788,-1465
2018,7,10,12,4565,5586,3981,-1605
2018,7,10,13,4997,6169,4178,-1991
2018,7,10,14,5618,6915,4781,-2134
2018,7,10,15,6166,7733,5288,-2445
2018,7,10,16,6723,8531,5995,-2536
2018,7,10,17,7179,9196,6302,-2894
2018,7,10,18,7552,9709,6624,-3085
2018,7,10,19,7763,10055,6981,-3074
2018,7,10,20,7824,10339,7214,-3125
2018,7,10,21,7878,10553,7411,-3142
2018,7,10,22,7731,10606,7268,-3338
2018,7,10,23,7538,10381,6897,-3484
2018,7,11,0,7201,9843,6622,-3221
2018,7,11,1,6916,9221,6388,-2833
2018,7,11,2,6541,8625,6126,-2499
2018,7,11,3,5984,7804,5598,-2206
2018,7,11,4,5399,7020,4961,-2059
2018,7,11,5,4696,6327,4496,-1831
2018,7,11,6,4348,5867,4243,-1624
2018,7,11,7,4083,5525,3975,-1550
2018,7,11,8,3935,5321,3829,-1492
2018,7,11,9,3894,5246,3777,-1469
2018,7,11,10,4025,5395,3887,-1508
2018,7,11,11,4306,5722,4140,-1582
2018,7,11,12,4558,5960,4324,-1636
2018,7,11,13,4996,6559,4638,-1921
2018,7,11,14,5553,7282,4998,-2284
2018,7,11,15,6228,8153,5742,-2411
2018,7,11,16,6820,8960,6074,-2886
2018,7,11,17,7308,9484,6467,-3017
2018,7,11,18,7699,9836,6478,-3358
2018,7,11,19,7960,10027,6692,-3335
2018,7,11,20,8102,10111,6635,-3476
2018,7,11,21,8158,10045,6446,-3599
2018,7,11,22,8011,9957,6333,-3624
2018,7,11,23,7781,9685,6010,-3675
2018,7,12,0,7315,9202,5689,-3513
2018,7,12,1,7022,8776,5582,-3194
2018,7,12,2,6645,8395,5705,-2690
2018,7,12,3,6067,7662,5308,-2354
2018,7,12,4,5473,6918,4978,-1940
2018,7,12,5,4910,6180,4384,-1796
2018,7,12,6,4541,5695,4071,-1624
2018,7,12,7,4236,5334,3794,-1540
2018,7,12,8,4071,5136,3629,-1507
2018,7,12,9,4031,4981,3523,-1458
2018,7,12,10,4160,5110,3601,-1509
2018,7,12,11,4442,5459,3876,-1583
2018,7,12,12,4722,5772,4114,-1658
2018,7,12,13,5165,6356,4385,-1971
2018,7,12,14,5773,7146,4702,-2444
2018,7,12,15,6533,8064,5471,-2593
2018,7,12,16,7152,8949,5897,-3052
2018,7,12,17,7590,9702,6329,-3373
2018,7,12,18,7973,10126,6361,-3765
2018,7,12,19,8211,10328,6582,-3746
2018,7,12,20,8340,10465,6700,-3765
2018,7,12,21,8396,10341,6664,-3677
2018,7,12,22,8167,10149,6515,-3634
2018,7,12,23,7981,9724,6097,-3627
2018,7,13,0,7578,9126,5599,-3527
2018,7,13,1,7223,8633,5531,-3102
2018,7,13,2,6797,8283,5561,-2722
2018,7,13,3,6202,7598,5237,-2361
2018,7,13,4,5600,6841,4972,-1869
2018,7,13,5,4997,6163,4429,-1734
2018,7,13,6,4606,5695,4156,-1539
2018,7,13,7,4357,5317,3866,-1451
2018,7,13,8,4157,5126,3680,-1446
2018,7,13,9,4103,5038,3610,-1428
2018,7,13,10,4211,5162,3693,-1469
2018,7,13,11,4472,5452,3906,-1546
2018,7,13,12,4747,5763,4136,-1627
2018,7,13,13,5230,6386,4402,-1984
2018,7,13,14,5854,7241,4924,-2317
2018,7,13,15,6578,8146,5717,-2429
2018,7,13,16,7190,8935,6072,-2863
2018,7,13,17,7641,9547,6463,-3084
2018,7,13,18,8026,10037,6882,-3155
2018,7,13,19,8240,10217,7025,-3192
2018,7,13,20,8334,10098,6921,-3177
2018,7,13,21,8327,9725,6656,-3069
2018,7,13,22,8127,9427,6266,-3161
2018,7,13,23,7845,9139,5990,-3149
2018,7,14,0,7406,8777,5732,-3045
2018,7,14,1,7023,8417,5542,-2875
2018,7,14,2,6710,8099,5598,-2501
2018,7,14,3,6209,7465,5229,-2236
2018,7,14,4,5671,6797,4727,-2070
2018,7,14,5,5008,6168,4341,-1827
2018,7,14,6,4611,5692,4074,-1618
2018,7,14,7,4365,5330,3790,-1540
2018,7,14,8,4189,5076,3592,-1484
2018,7,14,9,4079,4946,3487,-1459
2018,7,14,10,4079,4961,3490,-1471
2018,7,14,11,4148,5061,3566,-1495
2018,7,14,12,4358,5258,3770,-1488
2018,7,14,13,4946,5972,4160,-1812
2018,7,14,14,5685,6848,4490,-2358
2018,7,14,15,6327,7806,5261,-2545
2018,7,14,16,6993,8661,5988,-2673
2018,7,14,17,7526,9371,6599,-2772
2018,7,14,18,7881,9879,6990,-2889
2018,7,14,19,8110,10209,7348,-2861
2018,7,14,20,8249,10345,7476,-2869
2018,7,14,21,8234,10282,7377,-2905
2018,7,14,22,8034,10047,7153,-2894
2018,7,14,23,7714,9616,6878,-2738
2018,7,15,0,7280,9086,6449,-2637
2018,7,15,1,6923,8663,6115,-2548
2018,7,15,2,6605,8245,5829,-2416
2018,7,15,3,6103,7592,5217,-2375
2018,7,15,4,5575,6896,4789,-2107
2018,7,15,5,5000,6296,4447,-1849
2018,7,15,6,4623,5799,4201,-1598
2018,7,15,7,4358,5453,3907,-1546
2018,7,15,8,4207,5205,3722,-1483
2018,7,15,9,4061,5025,3566,-1459
2018,7,15,10,4039,4941,3484,-1457
2018,7,15,11,4071,5060,3581,-1479
2018,7,15,12,4252,5261,3777,-1484
2018,7,15,13,4813,6029,4218,-1811
2018,7,15,14,5571,6978,4577,-2401
2018,7,15,15,6289,7849,5275,-2574
2018,7,15,16,6948,8655,6020,-2635
2018,7,15,17,7510,9228,6460,-2768
2018,7,15,18,7885,9607,6615,-2992
2018,7,15,19,8089,9912,6878,-3034
2018,7,15,20,8182,9972,7037,-2935
2018,7,15,21,8095,9850,6895,-2955
2018,7,15,22,7958,9718,6809,-2909
2018,7,15,23,7709,9449,6608,-2841
2018,7,16,0,7399,9016,6390,-2626
2018,7,16,1,7009,8699,6142,-2557
2018,7,16,2,6674,8306,5829,-2477
2018,7,16,3,6107,7589,5192,-2397
2018,7,16,4,5559,6875,4780,-2095
2018,7,16,5,4806,6216,4525,-1691
2018,7,16,6,4433,5709,4240,-1469
2018,7,16,7,4174,5414,4052,-1362
2018,7,16,8,4015,5207,3896,-1311
2018,7,16,9,3973,5161,3871,-1290
2018,7,16,10,4109,5318,3972,-1346
2018,7,16,11,4385,5645,4243,-1402
2018,7,16,12,4661,5987,4546,-1441
2018,7,16,13,5123,6584,4868,-1716
2018,7,16,14,5710,7454,5189,-2265
2018,7,16,15,6405,8273,5739,-2534
2018,7,16,16,7011,9095,6465,-2630
2018,7,16,17,7476,9747,7136,-2611
2018,7,16,18,7826,10135,7498,-2637
2018,7,16,19,7974,10410,7745,-2665
2018,7,16,20,8013,10434,7800,-2634
2018,7,16,21,7929,10160,7470,-2690
2018,7,16,22,7764,9770,7128,-2642
2018,7,16,23,7562,9385,6826,-2559
2018,7,17,0,7197,8939,6337,-2602
2018,7,17,1,6866,8655,6221,-2434
2018,7,17,2,6451,8257,6109,-2148
2018,7,17,3,5898,7564,5564,-2000
2018,7,17,4,5329,6841,5131,-1710
2018,7,17,5,4881,6235,4679,-1556
2018,7,17,6,4500,5794,4409,-1385
2018,7,17,7,4243,5440,4115,-1325
2018,7,17,8,4080,5261,3914,-1347
2018,7,17,9,4031,5212,3857,-1355
2018,7,17,10,4163,5375,4013,-1362
2018,7,17,11,4443,5765,4454,-1311
2018,7,17,12,4728,6070,4803,-1267
2018,7,17,13,5172,6665,5148,-1517
2018,7,17,14,5691,7468,5488,-1980
2018,7,17,15,6357,8251,6148,-2103
2018,7,17,16,6862,8903,6623,-2280
2018,7,17,17,7298,9435,7077,-2358
2018,7,17,18,7610,9735,7343,-2392
2018,7,17,19,7726,9872,7452,-2420
2018,7,17,20,7735,9888,7405,-2483
2018,7,17,21,7651,9781,7289,-2492
2018,7,17,22,7497,9528,6990,-2538
2018,7,17,23,7365,9188,6745,-2443
2018,7,18,0,6994,8823,6534,-2289
2018,7,18,1,6687,8605,6320,-2285
2018,7,18,2,6315,8242,6027,-2215
2018,7,18,3,5779,7535,5401,-2134
2018,7,18,4,5256,6855,4942,-1913
2018,7,18,5,4667,6313,4788,-1525
2018,7,18,6,4318,5851,4548,-1303
2018,7,18,7,4096,5590,4293,-1297
2018,7,18,8,3981,5380,4111,-1269
2018,7,18,9,3968,5310,4045,-1265
2018,7,18,10,4116,5465,4162,-1303
2018,7,18,11,4393,5875,4530,-1345
2018,7,18,12,4637,6166,4897,-1269
2018,7,18,13,5038,6666,5222,-1444
2018,7,18,14,5583,7339,5405,-1934
2018,7,18,15,6130,8089,6025,-2064
2018,7,18,16,6693,8666,6419,-2247
2018,7,18,17,6961,8843,6609,-2234
2018,7,18,18,7290,8679,6368,-2311
2018,7,18,19,7407,8516,6202,-2314
2018,7,18,20,7396,8404,5994,-2410
2018,7,18,21,7252,8311,5847,-2464
2018,7,18,22,7060,8257,5746,-2511
2018,7,18,23,6893,8190,5647,-2543
2018,7,19,0,6547,8037,5549,-2488
2018,7,19,1,6341,7896,5458,-2438
2018,7,19,2,6037,7661,5362,-2299
2018,7,19,3,5533,7073,4909,-2164
2018,7,19,4,5048,6442,4611,-1831
2018,7,19,5,4699,5930,4474,-1456
2018,7,19,6,4381,5495,4201,-1294
2018,7,19,7,4166,5251,4005,-1246
2018,7,19,8,4048,5100,3852,-1248
2018,7,19,9,4014,5076,3811,-1265
2018,7,19,10,4158,5294,3997,-1297
2018,7,19,11,4479,5709,4387,-1322
2018,7,19,12,4710,6055,4789,-1266
2018,7,19,13,5103,6641,5103,-1538
2018,7,19,14,5603,7350,5468,-1882
2018,7,19,15,6156,8017,6035,-1982
2018,7,19,16,6673,8466,6354,-2112
2018,7,19,17,6902,8750,6524,-2226
2018,7,19,18,7153,8901,6583,-2318
2018,7,19,19,7228,8891,6575,-2316
2018,7,19,20,7136,8901,6531,-2370
2018,7,19,21,6966,8883,6504,-2379
2018,7,19,22,6757,8887,6414,-2473
2018,7,19,23,6612,8761,6333,-2428
2018,7,20,0,6330,8486,6107,-2379
2018,7,20,1,6237,8305,5953,-2352
2018,7,20,2,5982,7938,5689,-2249
2018,7,20,3,5510,7273,5168,-2105
2018,7,20,4,5056,6613,4767,-1846
2018,7,20,5,4753,6048,4598,-1450
2018,7,20,6,4414,5607,4381,-1226
2018,7,20,7,4203,5353,4166,-1187
2018,7,20,8,4068,5148,3917,-1231
2018,7,20,9,4058,5122,3884,-1238
2018,7,20,10,4188,5278,4034,-1244
2018,7,20,11,4494,5659,4373,-1286
2018,7,20,12,4711,5953,4753,-1200
2018,7,20,13,5125,6458,5034,-1424
2018,7,20,14,5656,7022,5146,-1876
2018,7,20,15,6222,7515,5414,-2101
2018,7,20,16,6617,7645,5565,-2080
2018,7,20,17,6802,7617,5482,-2135
2018,7,20,18,7004,7633,5487,-2146
2018,7,20,19,7073,7681,5524,-2157
2018,7,20,20,6961,7671,5523,-2148
2018,7,20,21,6785,7584,5438,-2146
2018,7,20,22,6595,7534,5360,-2174
2018,7,20,23,6451,7434,5258,-2176
2018,7,21,0,6100,7253,5120,-2133
2018,7,21,1,5910,7245,5127,-2118
2018,7,21,2,5722,7056,5029,-2027
2018,7,21,3,5364,6575,4614,-1961
2018,7,21,4,4987,6089,4344,-1745
2018,7,21,5,4619,5650,4049,-1601
2018,7,21,6,4321,5307,3933,-1374
2018,7,21,7,4099,5061,3802,-1259
2018,7,21,8,3960,4919,3677,-1242
2018,7,21,9,3903,4866,3649,-1217
2018,7,21,10,3928,4916,3670,-1246
2018,7,21,11,4042,5065,3770,-1295
2018,7,21,12,4220,5312,3944,-1368
2018,7,21,13,4713,6061,4429,-1632
2018,7,21,14,5290,6923,4890,-2033
2018,7,21,15,5789,7728,5405,-2323
2018,7,21,16,6236,8381,5952,-2429
2018,7,21,17,6553,8962,6433,-2529
2018,7,21,18,6604,9263,6576,-2687
2018,7,21,19,6509,9518,6755,-2763
2018,7,21,20,6497,9608,6875,-2733
2018,7,21,21,6460,9395,6784,-2611
2018,7,21,22,6379,8965,6429,-2536
2018,7,21,23,6199,8500,6031,-2469
2018,7,22,0,5947,8113,5608,-2505
2018,7,22,1,5782,7882,5397,-2485
2018,7,22,2,5552,7608,5240,-2368
2018,7,22,3,5190,7096,4779,-2317
2018,7,22,4,4848,6617,4610,-2007
2018,7,22,5,4735,6143,4474,-1669
2018,7,22,6,4418,5778,4404,-1374
2018,7,22,7,4188,5508,4194,-1314
2018,7,22,8,4075,5381,4077,-1304
2018,7,22,9,3985,5335,4023,-1312
2018,7,22,10,3988,5363,4058,-1305
2018,7,22,11,4081,5497,4142,-1355
2018,7,22,12,4294,5723,4339,-1384
2018,7,22,13,4800,6470,4734,-1736
2018,7,22,14,5545,7434,5227,-2207
2018,7,22,15,6195,8326,5890,-2436
2018,7,22,16,6760,9087,6409,-2678
2018,7,22,17,7186,9660,6844,-2816
2018,7,22,18,7475,10061,7158,-2903
2018,7,22,19,7622,10153,7145,-3008
2018,7,22,20,7632,9726,6754,-2972
2018,7,22,21,7561,9156,6274,-2882
2018,7,22,22,7353,8719,5931,-2788
2018,7,22,23,7071,8266,5592,-2674
2018,7,23,0,6747,7801,5329,-2472
2018,7,23,1,6459,7501,5065,-2436
2018,7,23,2,6150,7143,4856,-2287
2018,7,23,3,5645,6516,4344,-2172
2018,7,23,4,5176,5800,3949,-1851
2018,7,23,5,4723,5219,3728,-1491
2018,7,23,6,4375,4815,3545,-1270
2018,7,23,7,4131,4607,3434,-1173
2018,7,23,8,3980,4514,3367,-1147
2018,7,23,9,3977,4499,3325,-1174
2018,7,23,10,4143,4665,3469,-1196
2018,7,23,11,4494,5086,3807,-1279
2018,7,23,12,4762,5381,4078,-1303
2018,7,23,13,5140,5672,4181,-1491
2018,7,23,14,5637,6282,4378,-1904
2018,7,23,15,6178,7110,4889,-2221
2018,7,23,16,6675,7828,5501,-2327
2018,7,23,17,6945,8342,6463,-1879
2018,7,23,18,7133,8764,6843,-1921
2018,7,23,19,7223,8972,7008,-1964
2018,7,23,20,7139,9104,7089,-2015
2018,7,23,21,7112,9382,7325,-2057
2018,7,23,22,6881,9303,7274,-2029
2018,7,23,23,6698,8924,6940,-1984
2018,7,24,0,6409,8491,6477,-2014
2018,7,24,1,6239,8192,6086,-2106
2018,7,24,2,5924,7781,5612,-2169
2018,7,24,3,5448,7076,5077,-1999
2018,7,24,4,5002,6359,4493,-1866
2018,7,24,5,4446,5761,4184,-1577
2018,7,24,6,4158,5344,3985,-1359
2018,7,24,7,3960,5032,3782,-1250
2018,7,24,8,3840,4856,3655,-1201
2018,7,24,9,3851,4833,3627,-1206
2018,7,24,10,4011,5010,3751,-1259
2018,7,24,11,4350,5439,4095,-1344
2018,7,24,12,4583,5700,4343,-1357
2018,7,24,13,4901,6144,4605,-1539
2018,7,24,14,5383,6762,4807,-1955
2018,7,24,15,5885,7457,5250,-2207
2018,7,24,16,6354,8038,5708,-2330
2018,7,24,17,6628,8419,6072,-2347
2018,7,24,18,6898,8788,6263,-2525
2018,7,24,19,7030,9259,6550,-2709
2018,7,24,20,6977,9560,6740,-2820
2018,7,24,21,7005,9809,6967,-2842
2018,7,24,22,6775,9620,6779,-2841
2018,7,24,23,6603,9273,6470,-2803
2018,7,25,0,6345,8772,6098,-2674
2018,7,25,1,6197,8358,5756,-2602
2018,7,25,2,5878,7903,5393,-2510
2018,7,25,3,5386,7136,4719,-2417
2018,7,25,4,4898,6411,4410,-2001
2018,7,25,5,4471,5827,4193,-1634
2018,7,25,6,4165,5410,3998,-1412
2018,7,25,7,3959,5122,3818,-1304
2018,7,25,8,3828,4949,3709,-1240
2018,7,25,9,3824,4914,3669,-1245
2018,7,25,10,3972,5095,3761,-1334
2018,7,25,11,4264,5494,4145,-1349
2018,7,25,12,4497,5794,4421,-1373
2018,7,25,13,4841,6356,4699,-1657
2018,7,25,14,5371,7056,4941,-2115
2018,7,25,15,5869,7840,5460,-2380
2018,7,25,16,6217,8513,5969,-2544
2018,7,25,17,6433,8804,6162,-2642
2018,7,25,18,6689,9008,6268,-2740
2018,7,25,19,6812,9355,6547,-2808
2018,7,25,20,6864,9760,6874,-2886
2018,7,25,21,6804,9973,7087,-2886
2018,7,25,22,6642,9886,6975,-2911
2018,7,25,23,6456,9616,6816,-2800
2018,7,26,0,6258,9185,6445,-2740
2018,7,26,1,6088,8732,6129,-2603
2018,7,26,2,5815,8216,5679,-2537
2018,7,26,3,5351,7531,5044,-2487
2018,7,26,4,4892,6802,4703,-2099
2018,7,26,5,4548,6230,4500,-1730
2018,7,26,6,4213,5778,4303,-1475
2018,7,26,7,3990,5476,4081,-1395
2018,7,26,8,3878,5294,3924,-1370
2018,7,26,9,3881,5260,3888,-1372
2018,7,26,10,4035,5421,4002,-1419
2018,7,26,11,4391,5840,4338,-1502
2018,7,26,12,4635,6126,4666,-1460
2018,7,26,13,4991,6645,5050,-1595
2018,7,26,14,5486,7258,5267,-1991
2018,7,26,15,5983,7901,5644,-2257
2018,7,26,16,6491,8536,6089,-2447
2018,7,26,17,6773,8923,6344,-2579
2018,7,26,18,7052,9049,6464,-2585
2018,7,26,19,7261,9053,6414,-2639
2018,7,26,20,7272,8922,6307,-2615
2018,7,26,21,7210,8813,6212,-2601
2018,7,26,22,6942,8639,6004,-2635
2018,7,26,23,6688,8389,5731,-2658
2018,7,27,0,6392,8128,5509,-2619
2018,7,27,1,6245,7969,5518,-2451
2018,7,27,2,5974,7688,5275,-2413
2018,7,27,3,5488,7082,4695,-2387
2018,7,27,4,5039,6455,4403,-2052
2018,7,27,5,4724,5869,4198,-1671
2018,7,27,6,4384,5440,4023,-1417
2018,7,27,7,4157,5153,3771,-1382
2018,7,27,8,4034,4990,3631,-1359
2018,7,27,9,4004,4970,3606,-1364
2018,7,27,10,4141,5112,3715,-1397
2018,7,27,11,4438,5513,4004,-1509
2018,7,27,12,4672,5776,4347,-1429
2018,7,27,13,5138,6365,4678,-1687
2018,7,27,14,5657,7120,5119,-2001
2018,7,27,15,6295,7898,5812,-2086
2018,7,27,16,6839,8611,6204,-2407
2018,7,27,17,7171,9304,6737,-2567
2018,7,27,18,7455,9851,7237,-2614
2018,7,27,19,7672,10255,7555,-2700
2018,7,27,20,7715,10554,7632,-2922
2018,7,27,21,7610,10516,7543,-2973
2018,7,27,22,7402,10227,7237,-2990
2018,7,27,23,7024,9842,7095,-2747
2018,7,28,0,6653,9168,6619,-2549
2018,7,28,1,6422,8643,6243,-2400
2018,7,28,2,6128,8131,5764,-2367
2018,7,28,3,5687,7448,5141,-2307
2018,7,28,4,5250,6738,4658,-2080
2018,7,28,5,4797,6169,4381,-1788
2018,7,28,6,4459,5687,4189,-1498
2018,7,28,7,4230,5333,3930,-1403
2018,7,28,8,4062,5105,3766,-1339
2018,7,28,9,3995,4945,3639,-1306
2018,7,28,10,4010,4953,3648,-1305
2018,7,28,11,4096,5043,3720,-1323
2018,7,28,12,4277,5248,3872,-1376
2018,7,28,13,4819,5970,4248,-1722
2018,7,28,14,5508,6872,4777,-2095
2018,7,28,15,6062,7769,5564,-2205
2018,7,28,16,6597,8538,6043,-2495
2018,7,28,17,7049,9218,6538,-2680
2018,7,28,18,7313,9736,7057,-2679
2018,7,28,19,7445,10094,7375,-2719
2018,7,28,20,7420,10239,7551,-2688
2018,7,28,21,7358,10013,7402,-2611
2018,7,28,22,7166,9488,6821,-2667
2018,7,28,23,6894,9001,6559,-2442
2018,7,29,0,6488,8506,6211,-2295
2018,7,29,1,6287,8084,5871,-2213
2018,7,29,2,5958,7642,5501,-2141
2018,7,29,3,5532,7124,4998,-2126
2018,7,29,4,5115,6522,4509,-2013
2018,7,29,5,4576,5874,4167,-1707
2018,7,29,6,4253,5423,3975,-1448
2018,7,29,7,4018,5107,3778,-1329
2018,7,29,8,3871,4910,3639,-1271
2018,7,29,9,3777,4778,3547,-1231
2018,7,29,10,3756,4748,3509,-1239
2018,7,29,11,3820,4850,3564,-1286
2018,7,29,12,3977,5067,3758,-1309
2018,7,29,13,4503,5827,4185,-1642
2018,7,29,14,5175,6781,4724,-2057
2018,7,29,15,5843,7679,5522,-2157
2018,7,29,16,6385,8510,6087,-2423
2018,7,29,17,6786,9120,6525,-2595
2018,7,29,18,7069,9334,6776,-2558
2018,7,29,19,7209,9334,6754,-2580
2018,7,29,20,7210,9091,6579,-2512
2018,7,29,21,7119,8715,6212,-2503
2018,7,29,22,6991,8423,5954,-2469
2018,7,29,23,6783,8051,5641,-2410
2018,7,30,0,6426,7683,5498,-2185
2018,7,30,1,6175,7454,5398,-2056
2018,7,30,2,5875,7183,5185,-1998
2018,7,30,3,5418,6625,4659,-1966
2018,7,30,4,4920,6014,4151,-1863
2018,7,30,5,4449,5437,3858,-1579
2018,7,30,6,4132,5071,3722,-1349
2018,7,30,7,3927,4818,3585,-1233
2018,7,30,8,3821,4695,3495,-1200
2018,7,30,9,3838,4669,3486,-1183
2018,7,30,10,3995,4905,3653,-1252
2018,7,30,11,4339,5348,4011,-1337
2018,7,30,12,4562,5644,4287,-1357
2018,7,30,13,4908,6095,4520,-1575
2018,7,30,14,5432,6787,4795,-1992
2018,7,30,15,5946,7636,5530,-2106
2018,7,30,16,6403,8470,6130,-2340
2018,7,30,17,6643,8895,6415,-2480
2018,7,30,18,6870,9004,6499,-2505
2018,7,30,19,7026,8959,6456,-2503
2018,7,30,20,6954,8873,6523,-2350
2018,7,30,21,6851,8515,6229,-2286
2018,7,30,22,6696,8221,5940,-2281
2018,7,30,23,6558,0,5940,-2277
2018,7,31,0,6262,7675,5609,-2066
2018,7,31,1,6046,7509,5488,-2021
2018,7,31,2,5741,7164,5197,-1967
2018,7,31,3,5284,6528,4601,-1927
2018,7,31,4,4812,5920,4089,-1831
2018,7,31,5,4411,5488,3933,-1555
2018,7,31,6,4114,5071,3752,-1319
2018,7,31,7,3928,4798,3573,-1225
2018,7,31,8,3789,4649,3465,-1184
2018,7,31,9,3807,4635,3469,-1166
2018,7,31,10,3945,4831,3637,-1194
2018,7,31,11,4297,5288,3990,-1298
2018,7,31,12,4506,5581,4271,-1310
2018,7,31,13,4855,5883,4397,-1486
2018,7,31,14,5366,6380,4533,-1847
2018,7,31,15,5865,6920,4871,-2049
2018,7,31,16,6285,7394,5248,-2146
2018,7,31,17,6575,7828,5644,-2184
2018,7,31,18,6849,8272,6166,-2106
2018,7,31,19,7018,8683,6425,-2258
2018,7,31,20,6972,8896,6530,-2366
2018,7,31,21,6907,8702,6354,-2348
2018,7,31,22,6745,8334,6186,-2148
2018,7,31,23,6590,7972,5927,-2045
2018,8,1,0,6276,7640,5700,-1940
2018,8,1,1,6112,7483,5555,-1928
2018,8,1,2,5819,7123,5087,-2036
2018,8,1,3,5344,6577,4580,-1997
2018,8,1,4,4880,5917,4140,-1777
2018,8,1,5,4438,5630,4087,-1543
2018,8,1,6,4130,5249,3898,-1351
2018,8,1,7,3933,5035,3815,-1220
2018,8,1,8,3801,4922,3719,-1203
2018,8,1,9,3813,4897,3710,-1187
2018,8,1,10,3975,5085,3856,-1229
2018,8,1,11,4277,5531,4193,-1338
2018,8,1,12,4502,5809,4437,-1372
2018,8,1,13,4870,6389,4798,-1591
2018,8,1,14,5349,7097,5109,-1988
2018,8,1,15,5931,7870,5680,-2190
2018,8,1,16,6326,8551,6328,-2223
2018,8,1,17,6675,9059,6801,-2258
2018,8,1,18,6901,9276,6987,-2289
2018,8,1,19,7105,9361,7098,-2263
2018,8,1,20,7064,9472,7242,-2230
2018,8,1,21,6989,9553,7235,-2318
2018,8,1,22,6835,9388,7065,-2323
2018,8,1,23,6581,8859,6455,-2404
2018,8,2,0,6302,8369,6010,-2359
2018,8,2,1,6118,8143,5800,-2343
2018,8,2,2,5859,7713,5483,-2230
2018,8,2,3,5375,7066,4964,-2102
2018,8,2,4,4886,6361,4491,-1870
2018,8,2,5,4479,5752,4158,-1594
2018,8,2,6,4174,5355,3964,-1391
2018,8,2,7,3977,5104,3878,-1226
2018,8,2,8,3879,4949,3772,-1177
2018,8,2,9,3882,4956,3784,-1172
2018,8,2,10,4049,5159,3930,-1229
2018,8,2,11,4391,5567,4258,-1309
2018,8,2,12,4607,5889,4550,-1339
2018,8,2,13,4995,6439,4856,-1583
2018,8,2,14,5454,7200,5176,-2024
2018,8,2,15,5955,8055,5912,-2143
2018,8,2,16,6519,8801,6477,-2324
2018,8,2,17,6814,9421,7137,-2284
2018,8,2,18,7115,9799,7497,-2302
2018,8,2,19,7312,9884,7622,-2262
2018,8,2,20,7294,9898,7692,-2206
2018,8,2,21,7218,9843,7710,-2133
2018,8,2,22,6924,9707,7602,-2105
2018,8,2,23,6667,9310,7137,-2173
2018,8,3,0,6376,8829,6735,-2094
2018,8,3,1,6175,8546,6437,-2109
2018,8,3,2,5903,8047,5913,-2134
2018,8,3,3,5417,7328,5325,-2003
2018,8,3,4,4939,6561,4803,-1758
2018,8,3,5,4599,5643,4138,-1505
2018,8,3,6,4265,5206,4012,-1194
2018,8,3,7,4051,4914,3753,-1161
2018,8,3,8,3917,4768,3660,-1108
2018,8,3,9,3893,4729,3566,-1163
2018,8,3,10,4039,4893,3704,-1189
2018,8,3,11,4337,5312,4003,-1309
2018,8,3,12,4548,5547,4219,-1328
2018,8,3,13,4987,6021,4460,-1561
2018,8,3,14,5526,6701,4729,-1972
2018,8,3,15,6161,7575,5486,-2089
2018,8,3,16,6737,8352,6110,-2242
2018,8,3,17,7185,9063,6731,-2332
2018,8,3,18,7509,9652,7151,-2501
2018,8,3,19,7781,10066,7534,-2532
2018,8,3,20,7850,10265,7621,-2644
2018,8,3,21,7806,10159,7541,-2618
2018,8,3,22,7508,9940,7340,-2600
2018,8,3,23,7044,9601,7022,-2579
2018,8,4,0,6631,9107,6732,-2375
2018,8,4,1,6379,8682,6366,-2316
2018,8,4,2,6074,8186,5897,-2289
2018,8,4,3,5600,7470,5233,-2237
2018,8,4,4,5159,6799,4766,-2033
2018,8,4,5,4704,6191,4463,-1728
2018,8,4,6,4364,5711,4328,-1383
2018,8,4,7,4129,5353,4060,-1293
2018,8,4,8,3975,5116,3859,-1257
2018,8,4,9,3890,4964,3726,-1238
2018,8,4,10,3908,4949,3734,-1215
2018,8,4,11,4016,5056,3804,-1252
2018,8,4,12,4178,5277,4000,-1277
2018,8,4,13,4722,6071,4441,-1630
2018,8,4,14,5476,6976,5024,-1952
2018,8,4,15,6187,7847,5731,-2116
2018,8,4,16,6784,8624,6324,-2300
2018,8,4,17,7401,9252,6811,-2441
2018,8,4,18,7706,9732,6933,-2799
2018,8,4,19,8048,10127,7245,-2882
2018,8,4,20,8169,10299,7426,-2873
2018,8,4,21,8087,10454,7611,-2843
2018,8,4,22,7860,10404,7557,-2847
2018,8,4,23,7549,10128,7311,-2817
2018,8,5,0,7024,9567,7052,-2515
2018,8,5,1,6743,9047,6685,-2362
2018,8,5,2,6429,8526,6262,-2264
2018,8,5,3,5914,7836,5635,-2201
2018,8,5,4,5399,7145,5060,-2085
2018,8,5,5,4922,6496,4757,-1739
2018,8,5,6,4548,5932,4547,-1385
2018,8,5,7,4249,5511,4253,-1258
2018,8,5,8,4076,5245,4017,-1228
2018,8,5,9,3976,5093,3892,-1201
2018,8,5,10,3941,5058,3861,-1197
2018,8,5,11,3991,5144,3918,-1226
2018,8,5,12,4131,5314,4026,-1288
2018,8,5,13,4685,6111,4452,-1659
2018,8,5,14,5443,7072,5004,-2068
2018,8,5,15,6180,7933,5733,-2200
2018,8,5,16,6815,8770,6496,-2274
2018,8,5,17,7287,9475,7169,-2306
2018,8,5,18,7649,9966,7539,-2427
2018,8,5,19,7903,10321,7792,-2529
2018,8,5,20,7996,10489,8018,-2471
2018,8,5,21,8010,10568,8006,-2562
2018,8,5,22,7879,10434,7919,-2515
2018,8,5,23,7635,9940,7513,-2427
2018,8,6,0,7251,9283,6853,-2430
2018,8,6,1,6967,8799,6479,-2320
2018,8,6,2,6567,8270,6046,-2224
2018,8,6,3,5967,7567,5444,-2123
2018,8,6,4,5347,6784,4775,-2009
2018,8,6,5,4893,6115,4327,-1788
2018,8,6,6,4495,5628,4094,-1534
2018,8,6,7,4230,5303,3908,-1395
2018,8,6,8,4073,5069,3751,-1318
2018,8,6,9,4028,4967,3674,-1293
2018,8,6,10,4191,5147,3765,-1382
2018,8,6,11,4520,5536,4064,-1472
2018,8,6,12,4758,5801,4331,-1470
2018,8,6,13,5181,6412,4692,-1720
2018,8,6,14,5730,7189,5102,-2087
2018,8,6,15,6330,7984,5740,-2244
2018,8,6,16,6882,8760,6384,-2376
2018,8,6,17,7401,9496,7030,-2466
2018,8,6,18,7783,10064,7353,-2711
2018,8,6,19,8114,10364,7510,-2854
2018,8,6,20,8343,10528,7727,-2801
2018,8,6,21,8381,10612,7803,-2809
2018,8,6,22,8279,10521,7707,-2814
2018,8,6,23,8041,10069,7339,-2730
2018,8,7,0,7626,9506,7041,-2465
2018,8,7,1,7288,9015,6647,-2368
2018,8,7,2,6755,8483,6181,-2302
2018,8,7,3,6141,7683,5512,-2171
2018,8,7,4,5497,6900,4817,-2083
2018,8,7,5,4886,6202,4446,-1756
2018,8,7,6,4510,5693,4202,-1491
2018,8,7,7,4245,5355,3987,-1368
2018,8,7,8,4111,5137,3818,-1319
2018,8,7,9,4080,5082,3792,-1290
2018,8,7,10,4239,5243,3893,-1350
2018,8,7,11,4581,5656,4217,-1439
2018,8,7,12,4799,5911,4471,-1440
2018,8,7,13,5251,6507,4830,-1677
2018,8,7,14,5819,7280,5269,-2011
2018,8,7,15,6489,8111,5946,-2165
2018,8,7,16,7183,8977,6441,-2536
2018,8,7,17,7672,9643,6950,-2693
2018,8,7,18,8097,10221,7426,-2795
2018,8,7,19,8426,10591,7841,-2750
2018,8,7,20,8601,10669,7923,-2746
2018,8,7,21,8626,10574,7851,-2723
2018,8,7,22,8427,10524,7814,-2710
2018,8,7,23,8009,10138,7494,-2644
2018,8,8,0,7505,9572,6884,-2688
2018,8,8,1,7223,9141,6503,-2638
2018,8,8,2,6757,8640,6319,-2321
2018,8,8,3,6148,7860,5700,-2160
2018,8,8,4,5515,7060,5059,-2001
2018,8,8,5,5037,6368,4586,-1782
2018,8,8,6,4657,5845,4330,-1515
2018,8,8,7,4387,5505,4120,-1385
2018,8,8,8,4223,5271,3906,-1365
2018,8,8,9,4171,5200,3855,-1345
2018,8,8,10,4319,5376,3986,-1390
2018,8,8,11,4632,5766,4322,-1444
2018,8,8,12,4825,5964,4523,-1441
2018,8,8,13,5276,6548,4872,-1676
2018,8,8,14,5866,7357,5338,-2019
2018,8,8,15,6607,8237,6098,-2139
2018,8,8,16,7257,9107,6606,-2501
2018,8,8,17,7746,9828,7212,-2616
2018,8,8,18,8175,10380,7610,-2770
2018,8,8,19,8510,10807,7916,-2891
2018,8,8,20,8675,11029,8213,-2816
2018,8,8,21,8676,11130,8340,-2790
2018,8,8,22,8490,11081,8221,-2860
2018,8,8,23,8118,10723,7775,-2948
2018,8,9,0,7675,10136,7464,-2672
2018,8,9,1,7310,9547,6998,-2549
2018,8,9,2,6859,8838,6516,-2322
2018,8,9,3,6225,7912,5768,-2144
2018,8,9,4,5631,7093,5085,-2008
2018,8,9,5,5048,6420,4643,-1777
2018,8,9,6,4670,5951,4405,-1546
2018,8,9,7,4400,5594,4183,-1411
2018,8,9,8,4231,5372,4007,-1365
2018,8,9,9,4183,5269,3925,-1344
2018,8,9,10,4318,5432,4046,-1386
2018,8,9,11,4635,5834,4385,-1449
2018,8,9,12,4823,6037,4554,-1483
2018,8,9,13,5262,6607,4839,-1768
2018,8,9,14,5836,7423,5351,-2072
2018,8,9,15,6508,8288,6202,-2086
2018,8,9,16,7228,9186,6930,-2256
2018,8,9,17,7689,9902,7410,-2492
2018,8,9,18,8124,10398,7613,-2785
2018,8,9,19,8424,10766,7903,-2863
2018,8,9,20,8540,10917,8041,-2876
2018,8,9,21,8512,10716,7914,-2802
2018,8,9,22,8304,10099,7367,-2732
2018,8,9,23,7959,9579,6835,-2744
2018,8,10,0,7484,9084,6771,-2313
2018,8,10,1,7184,8775,6526,-2249
2018,8,10,2,6753,8311,6147,-2164
2018,8,10,3,6139,7546,5490,-2056
2018,8,10,4,5565,6772,4870,-1902
2018,8,10,5,5096,6186,4471,-1715
2018,8,10,6,4702,5730,4245,-1485
2018,8,10,7,4434,5401,4028,-1373
2018,8,10,8,4257,5224,3890,-1334
2018,8,10,9,4201,5174,3848,-1326
2018,8,10,10,4333,5411,4015,-1396
2018,8,10,11,4624,5846,4389,-1457
2018,8,10,12,4852,6113,4657,-1456
2018,8,10,13,5342,6684,4992,-1692
2018,8,10,14,5950,7484,5489,-1995
2018,8,10,15,6647,8179,6084,-2095
2018,8,10,16,7290,8702,6486,-2216
2018,8,10,17,7744,8790,6495,-2295
2018,8,10,18,8144,8761,6441,-2320
2018,8,10,19,8404,8717,6401,-2316
2018,8,10,20,8517,8713,6425,-2288
2018,8,10,21,8450,8745,6669,-2076
2018,8,10,22,8210,8912,6776,-2136
2018,8,10,23,7856,8806,6656,-2150
2018,8,11,0,7339,8455,6167,-2288
2018,8,11,1,7001,8224,6031,-2193
2018,8,11,2,6594,7866,5736,-2130
2018,8,11,3,6087,7277,5297,-1980
2018,8,11,4,5590,6729,4880,-1849
2018,8,11,5,4932,6197,4481,-1716
2018,8,11,6,4591,5744,4272,-1472
2018,8,11,7,4340,5428,4050,-1378
2018,8,11,8,4173,5231,3924,-1307
2018,8,11,9,4063,5113,3830,-1283
2018,8,11,10,4066,5150,3852,-1298
2018,8,11,11,4196,5287,3961,-1326
2018,8,11,12,4352,5520,4178,-1342
2018,8,11,13,4887,6162,4532,-1630
2018,8,11,14,5487,6812,4786,-2026
2018,8,11,15,6071,7386,5334,-2052
2018,8,11,16,6647,7872,5747,-2125
2018,8,11,17,7067,8015,5789,-2226
2018,8,11,18,7314,8014,5699,-2315
2018,8,11,19,7454,8113,5726,-2387
2018,8,11,20,7441,8272,5814,-2458
2018,8,11,21,7361,8465,6021,-2444
2018,8,11,22,7177,8580,6147,-2433
2018,8,11,23,6910,8418,6064,-2354
2018,8,12,0,6524,8064,5797,-2267
2018,8,12,1,6350,7810,5591,-2219
2018,8,12,2,6008,7397,5290,-2107
2018,8,12,3,5563,6804,4766,-2038
2018,8,12,4,5118,6239,4308,-1931
2018,8,12,5,4579,5753,4055,-1698
2018,8,12,6,4238,5327,3913,-1414
2018,8,12,7,4031,5042,3714,-1328
2018,8,12,8,3856,4867,3608,-1259
2018,8,12,9,3791,4782,3544,-1238
2018,8,12,10,3800,4769,3525,-1244
2018,8,12,11,3904,4886,3589,-1297
2018,8,12,12,4040,5055,3739,-1316
2018,8,12,13,4577,5849,4206,-1643
2018,8,12,14,5293,6813,4771,-2042
2018,8,12,15,5901,7687,5567,-2120
2018,8,12,16,6468,8383,6163,-2220
2018,8,12,17,6939,8984,6575,-2409
2018,8,12,18,7232,9432,6858,-2574
2018,8,12,19,7427,9702,7216,-2486
2018,8,12,20,7390,9842,7362,-2480
2018,8,12,21,7416,9667,7035,-2632
2018,8,12,22,7245,9275,6678,-2597
2018,8,12,23,6930,8721,6362,-2359
2018,8,13,0,6606,8338,6114,-2224
2018,8,13,1,6361,8010,5879,-2131
2018,8,13,2,6014,7536,5554,-1982
2018,8,13,3,5496,6883,4988,-1895
2018,8,13,4,4980,6211,4400,-1811
2018,8,13,5,4473,5687,4067,-1620
2018,8,13,6,4153,5280,3887,-1393
2018,8,13,7,3946,5020,3739,-1281
2018,8,13,8,3835,4853,3604,-1249
2018,8,13,9,3839,4847,3597,-1250
2018,8,13,10,4029,5151,3822,-1329
2018,8,13,11,4380,5676,4248,-1428
2018,8,13,12,4604,5902,4462,-1440
2018,8,13,13,5039,6247,4608,-1639
2018,8,13,14,5587,6826,4819,-2007
2018,8,13,15,6225,7538,5473,-2065
2018,8,13,16,6777,8255,6085,-2170
2018,8,13,17,7264,8980,6659,-2321
2018,8,13,18,7617,9531,7168,-2363
2018,8,13,19,7839,9862,7502,-2360
2018,8,13,20,7905,10058,7766,-2292
2018,8,13,21,7825,10102,7805,-2297
2018,8,13,22,7697,9735,7414,-2321
2018,8,13,23,7426,9136,6745,-2391
2018,8,14,0,7009,8640,6329,-2311
2018,8,14,1,6739,8356,6102,-2254
2018,8,14,2,6289,7779,5656,-2123
2018,8,14,3,5712,7016,5027,-1989
2018,8,14,4,5157,6321,4445,-1876
2018,8,14,5,4650,5926,4321,-1605
2018,8,14,6,4311,5530,4150,-1380
2018,8,14,7,4079,5257,3998,-1259
2018,8,14,8,3935,5107,3876,-1231
2018,8,14,9,3931,5076,3844,-1232
2018,8,14,10,4088,5315,4008,-1307
2018,8,14,11,4473,5822,4433,-1389
2018,8,14,12,4678,6044,4641,-1403
2018,8,14,13,5047,6425,4843,-1582
2018,8,14,14,5578,7025,5111,-1914
2018,8,14,15,6196,7686,5626,-2060
2018,8,14,16,6726,8290,6084,-2206
2018,8,14,17,7233,8902,6573,-2329
2018,8,14,18,7590,9521,7126,-2395
2018,8,14,19,7809,9953,7638,-2315
2018,8,14,20,7887,10142,7818,-2324
2018,8,14,21,7823,10048,7579,-2469
2018,8,14,22,7668,9867,7571,-2296
2018,8,14,23,7391,9381,7098,-2283
2018,8,15,0,6976,8776,6458,-2318
2018,8,15,1,6726,8527,6214,-2313
2018,8,15,2,6307,7960,5965,-1995
2018,8,15,3,5716,7190,5503,-1687
2018,8,15,4,5162,6474,4909,-1565
2018,8,15,5,4600,5657,4265,-1392
2018,8,15,6,4281,5223,3896,-1327
2018,8,15,7,4063,4953,3720,-1233
2018,8,15,8,3941,4802,3601,-1201
2018,8,15,9,3934,4793,3604,-1189
2018,8,15,10,4112,5056,3804,-1252
2018,8,15,11,4454,5565,4202,-1363
2018,8,15,12,4645,5795,4554,-1241
2018,8,15,13,4997,6215,4891,-1324
2018,8,15,14,5559,6954,5071,-1883
2018,8,15,15,6170,7700,5722,-1978
2018,8,15,16,6711,8204,6243,-1961
2018,8,15,17,7153,9144,6950,-2194
2018,8,15,18,7531,9763,7399,-2364
2018,8,15,19,7822,10117,7575,-2542
2018,8,15,20,7944,10367,7770,-2597
2018,8,15,21,7945,10495,7875,-2620
2018,8,15,22,7794,10331,7820,-2511
2018,8,15,23,7545,9833,7521,-2312
2018,8,16,0,7034,9213,6960,-2253
2018,8,16,1,6779,8828,6653,-2175
2018,8,16,2,6358,8216,6177,-2039
2018,8,16,3,5763,7366,5395,-1971
2018,8,16,4,5209,6599,4696,-1903
2018,8,16,5,4765,5940,4304,-1636
2018,8,16,6,4418,5556,4145,-1411
2018,8,16,7,4186,5295,3992,-1303
2018,8,16,8,4053,5107,3829,-1278
2018,8,16,9,4039,5040,3782,-1258
2018,8,16,10,4211,5248,3945,-1303
2018,8,16,11,4590,5760,4356,-1404
2018,8,16,12,4792,6014,4597,-1417
2018,8,16,13,5155,6455,4851,-1604
2018,8,16,14,5684,7224,5360,-1864
2018,8,16,15,6306,8077,6112,-1965
2018,8,16,16,6965,8915,6772,-2143
2018,8,16,17,7455,9666,7307,-2359
2018,8,16,18,7887,10185,7711,-2474
2018,8,16,19,8204,10528,8027,-2501
2018,8,16,20,8374,10690,8166,-2524
2018,8,16,21,8409,10596,8260,-2336
2018,8,16,22,8172,10282,7857,-2425
2018,8,16,23,7867,9811,7546,-2265
2018,8,17,0,7420,9353,7117,-2236
2018,8,17,1,7132,9070,6855,-2215
2018,8,17,2,6679,8426,6375,-2051
2018,8,17,3,6073,7484,5580,-1904
2018,8,17,4,5523,6636,4785,-1851
2018,8,17,5,4924,6024,4345,-1679
2018,8,17,6,4557,5596,4153,-1443
2018,8,17,7,4294,5252,3933,-1319
2018,8,17,8,4132,5090,3819,-1271
2018,8,17,9,4097,5025,3800,-1225
2018,8,17,10,4240,5246,3933,-1313
2018,8,17,11,4586,5772,4340,-1432
2018,8,17,12,4786,5992,4560,-1432
2018,8,17,13,5183,6455,4814,-1641
2018,8,17,14,5813,7200,5240,-1960
2018,8,17,15,6537,8044,5980,-2064
2018,8,17,16,7100,8852,6562,-2290
2018,8,17,17,7653,9614,7154,-2460
2018,8,17,18,8081,10177,7656,-2521
2018,8,17,19,8374,10546,8018,-2528
2018,8,17,20,8512,10725,8191,-2534
2018,8,17,21,8480,10654,8207,-2447
2018,8,17,22,8236,10399,7859,-2540
2018,8,17,23,7788,9849,7405,-2444
2018,8,18,0,7276,9211,6921,-2290
2018,8,18,1,6954,8898,6652,-2246
2018,8,18,2,6532,8312,6166,-2146
2018,8,18,3,5998,7636,5583,-2053
2018,8,18,4,5490,6985,5033,-1952
2018,8,18,5,4943,6355,4610,-1745
2018,8,18,6,4554,5843,4340,-1503
2018,8,18,7,4273,5478,4110,-1368
2018,8,18,8,4090,5239,3900,-1339
2018,8,18,9,3982,5117,3807,-1310
2018,8,18,10,3976,5056,3732,-1324
2018,8,18,11,4061,5187,3834,-1353
2018,8,18,12,4216,5370,4005,-1365
2018,8,18,13,4761,6139,4472,-1667
2018,8,18,14,5498,7106,4956,-2150
2018,8,18,15,6264,8053,5845,-2208
2018,8,18,16,6928,8916,6546,-2370
2018,8,18,17,7537,9577,7084,-2493
2018,8,18,18,7965,9799,7303,-2496
2018,8,18,19,8254,10074,7480,-2594
2018,8,18,20,8382,10446,7806,-2640
2018,8,18,21,8254,10529,7854,-2675
2018,8,18,22,8056,10473,7806,-2667
2018,8,18,23,7645,10169,7591,-2578
2018,8,19,0,7184,9580,7108,-2472
2018,8,19,1,6899,9142,6747,-2395
2018,8,19,2,6505,8472,6260,-2212
2018,8,19,3,5983,7765,5617,-2148
2018,8,19,4,5458,7077,4998,-2079
2018,8,19,5,4938,6452,4677,-1775
2018,8,19,6,4534,5945,4425,-1520
2018,8,19,7,4260,5544,4137,-1407
2018,8,19,8,4056,5278,3914,-1364
2018,8,19,9,3948,5093,3780,-1313
2018,8,19,10,3916,5048,3721,-1327
2018,8,19,11,3986,5094,3759,-1335
2018,8,19,12,4111,5256,3924,-1332
2018,8,19,13,4634,6037,4356,-1681
2018,8,19,14,5419,7052,4928,-2124
2018,8,19,15,6225,8012,5849,-2163
2018,8,19,16,6868,8754,6424,-2330
2018,8,19,17,7484,9279,6761,-2518
2018,8,19,18,7929,9848,7265,-2583
2018,8,19,19,8220,10188,7611,-2577
2018,8,19,20,8274,10452,7819,-2633
2018,8,19,21,8238,10545,7908,-2637
2018,8,19,22,8077,10430,7785,-2645
2018,8,19,23,7865,9866,7265,-2601
2018,8,20,0,7483,9059,6615,-2444
2018,8,20,1,7131,8479,6121,-2358
2018,8,20,2,6656,7788,5615,-2173
2018,8,20,3,6042,6973,4925,-2048
2018,8,20,4,5421,6213,4292,-1921
2018,8,20,5,4834,5642,3957,-1685
2018,8,20,6,4484,5184,3758,-1426
2018,8,20,7,4244,4889,3580,-1309
2018,8,20,8,4104,4721,3485,-1236
2018,8,20,9,4084,4703,3463,-1240
2018,8,20,10,4288,4982,3641,-1341
2018,8,20,11,4665,5536,4084,-1452
2018,8,20,12,4868,5742,4317,-1425
2018,8,20,13,5224,6223,4547,-1676
2018,8,20,14,5816,6894,4828,-2066
2018,8,20,15,6453,7763,5623,-2140
2018,8,20,16,7053,8570,6349,-2221
2018,8,20,17,7542,9339,6926,-2413
2018,8,20,18,7939,9938,7348,-2590
2018,8,20,19,8205,10303,7678,-2625
2018,8,20,20,8327,10489,7958,-2531
2018,8,20,21,8297,10549,8063,-2486
2018,8,20,22,8160,10433,7901,-2532
2018,8,20,23,7934,10075,7541,-2534
2018,8,21,0,7547,9512,7102,-2410
2018,8,21,1,7202,9086,6755,-2331
2018,8,21,2,6672,8359,6194,-2165
2018,8,21,3,6031,7418,5381,-2037
2018,8,21,4,5442,6655,4759,-1896
2018,8,21,5,4754,6000,4335,-1665
2018,8,21,6,4405,5523,4094,-1429
2018,8,21,7,4162,5241,3935,-1306
2018,8,21,8,4018,5029,3781,-1248
2018,8,21,9,3992,4987,3738,-1249
2018,8,21,10,4175,5212,3890,-1322
2018,8,21,11,4560,5717,4306,-1411
2018,8,21,12,4753,5941,4530,-1411
2018,8,21,13,5076,6372,4729,-1643
2018,8,21,14,5631,7089,5079,-2010
2018,8,21,15,6219,7907,5824,-2083
2018,8,21,16,6782,8774,6447,-2327
2018,8,21,17,7226,9416,7012,-2404
2018,8,21,18,7602,9834,7362,-2472
2018,8,21,19,7790,10074,7667,-2407
2018,8,21,20,7856,10291,7860,-2431
2018,8,21,21,7799,10397,7859,-2538
2018,8,21,22,7659,10278,7736,-2542
2018,8,21,23,7374,9579,7115,-2464
2018,8,22,0,7073,9187,6812,-2375
2018,8,22,1,6798,8782,6465,-2317
2018,8,22,2,6340,8171,6002,-2169
2018,8,22,3,5722,7355,5357,-1998
2018,8,22,4,5162,6605,4839,-1766
2018,8,22,5,4887,6017,4463,-1554
2018,8,22,6,4559,5606,4211,-1395
2018,8,22,7,4322,5325,3997,-1328
2018,8,22,8,4193,5176,3865,-1311
2018,8,22,9,4184,5163,3864,-1299
2018,8,22,10,4382,5412,4036,-1376
2018,8,22,11,4759,5931,4487,-1444
2018,8,22,12,4938,6113,4661,-1452
2018,8,22,13,5258,6490,4858,-1632
2018,8,22,14,5755,7098,5241,-1857
2018,8,22,15,6376,7805,5932,-1873
2018,8,22,16,6959,8434,6364,-2070
2018,8,22,17,7376,8878,6522,-2356
2018,8,22,18,7713,9176,6704,-2472
2018,8,22,19,7911,9430,6776,-2654
2018,8,22,20,7986,9577,6974,-2603
2018,8,22,21,7930,9577,7002,-2575
2018,8,22,22,7777,9517,6870,-2647
2018,8,22,23,7583,9310,6658,-2652
2018,8,23,0,7145,8949,6391,-2558
2018,8,23,1,6901,8701,6379,-2322
2018,8,23,2,6448,8172,5997,-2175
2018,8,23,3,5820,7377,5403,-1974
2018,8,23,4,5265,6643,4763,-1880
2018,8,23,5,4629,6038,4342,-1696
2018,8,23,6,4314,5629,4116,-1513
2018,8,23,7,4116,5320,3937,-1383
2018,8,23,8,3989,5143,3799,-1344
2018,8,23,9,3993,5095,3776,-1319
2018,8,23,10,4204,5322,3970,-1352
2018,8,23,11,4619,5842,4383,-1459
2018,8,23,12,4794,6015,4570,-1445
2018,8,23,13,5141,6383,4885,-1498
2018,8,23,14,5695,6991,5176,-1815
2018,8,23,15,6325,7860,5811,-2049
2018,8,23,16,6875,8693,6311,-2382
2018,8,23,17,7398,9442,6778,-2664
2018,8,23,18,7800,10029,7113,-2916
2018,8,23,19,8014,10329,7324,-3005
2018,8,23,20,8117,10296,7329,-2967
2018,8,23,21,8095,10232,7224,-3008
2018,8,23,22,7958,10026,7013,-3013
2018,8,23,23,7608,9664,6797,-2867
2018,8,24,0,7286,9105,6396,-2709
2018,8,24,1,6985,8755,6355,-2400
2018,8,24,2,6513,8193,5935,-2258
2018,8,24,3,5885,7409,5322,-2087
2018,8,24,4,5328,6603,4734,-1869
2018,8,24,5,4730,5977,4281,-1696
2018,8,24,6,4388,5554,4093,-1461
2018,8,24,7,4160,5261,3925,-1336
2018,8,24,8,4021,5111,3802,-1309
2018,8,24,9,4006,5077,3767,-1310
2018,8,24,10,4188,5333,3952,-1381
2018,8,24,11,4551,5821,4349,-1472
2018,8,24,12,4731,6048,4594,-1454
2018,8,24,13,5026,6472,4798,-1674
2018,8,24,14,5555,7187,5188,-1999
2018,8,24,15,6127,8022,5937,-2085
2018,8,24,16,6640,8832,6512,-2320
2018,8,24,17,6964,9463,6886,-2577
2018,8,24,18,7215,9670,6954,-2716
2018,8,24,19,7347,9525,6768,-2757
2018,8,24,20,7381,9416,6686,-2730
2018,8,24,21,7243,9154,6589,-2565
2018,8,24,22,7028,8785,6259,-2526
2018,8,24,23,6762,8225,5853,-2372
2018,8,25,0,6395,7769,5501,-2268
2018,8,25,1,6164,7512,5401,-2111
2018,8,25,2,5812,7104,5105,-1999
2018,8,25,3,5337,6549,4580,-1969
2018,8,25,4,4908,5998,4151,-1847
2018,8,25,5,4605,5523,3998,-1525
2018,8,25,6,4292,5140,3847,-1293
2018,8,25,7,4068,4869,3655,-1214
2018,8,25,8,3928,4709,3526,-1183
2018,8,25,9,3869,4654,3485,-1169
2018,8,25,10,3890,4719,3529,-1190
2018,8,25,11,3988,4919,3614,-1305
2018,8,25,12,4122,5139,3829,-1310
2018,8,25,13,4567,5836,4206,-1630
2018,8,25,14,5224,6726,4668,-2058
2018,8,25,15,5834,7647,5447,-2200
2018,8,25,16,6359,8416,6130,-2286
2018,8,25,17,6780,9114,6652,-2462
2018,8,25,18,7051,9675,7126,-2549
2018,8,25,19,7175,9974,7340,-2634
2018,8,25,20,7233,9914,7278,-2636
2018,8,25,21,7158,9544,6951,-2593
2018,8,25,22,6999,8893,6386,-2507
2018,8,25,23,6702,8130,5824,-2306
2018,8,26,0,6366,7690,5514,-2176
2018,8,26,1,6164,7358,5290,-2068
2018,8,26,2,5777,6913,4996,-1917
2018,8,26,3,5307,6392,4471,-1921
2018,8,26,4,4892,5873,4007,-1866
2018,8,26,5,4601,5401,3860,-1541
2018,8,26,6,4249,5020,3716,-1304
2018,8,26,7,4019,4726,3515,-1211
2018,8,26,8,3809,4553,3391,-1162
2018,8,26,9,3705,4482,3336,-1146
2018,8,26,10,3683,4466,3307,-1159
2018,8,26,11,3745,4618,3356,-1262
2018,8,26,12,3876,4794,3443,-1351
2018,8,26,13,4322,5530,3914,-1616
2018,8,26,14,5151,6461,4581,-1880
2018,8,26,15,5833,7314,5324,-1990
2018,8,26,16,6506,8114,5934,-2180
2018,8,26,17,7064,8881,6541,-2340
2018,8,26,18,7490,9433,6937,-2496
2018,8,26,19,7712,9854,7279,-2575
2018,8,26,20,7786,10128,7540,-2588
2018,8,26,21,7718,10124,7569,-2555
2018,8,26,22,7614,9810,7373,-2437
2018,8,26,23,7277,9288,6893,-2395
2018,8,27,0,6927,8776,6496,-2280
2018,8,27,1,6643,8454,6147,-2307
2018,8,27,2,6171,7854,5716,-2138
2018,8,27,3,5591,7073,5099,-1974
2018,8,27,4,5028,6341,4487,-1854
2018,8,27,5,4547,5679,4151,-1528
2018,8,27,6,4231,5235,3972,-1263
2018,8,27,7,4023,4965,3776,-1189
2018,8,27,8,3875,4815,3672,-1143
2018,8,27,9,3880,4838,3683,-1155
2018,8,27,10,4110,5135,3904,-1231
2018,8,27,11,4556,5692,4266,-1426
2018,8,27,12,4773,5938,4511,-1427
2018,8,27,13,5040,6385,4640,-1745
2018,8,27,14,5584,7114,4966,-2148
2018,8,27,15,6189,7912,5527,-2385
2018,8,27,16,6787,8692,6197,-2495
2018,8,27,17,7315,9465,6856,-2609
2018,8,27,18,7707,10020,7336,-2684
2018,8,27,19,7923,10195,7507,-2688
2018,8,27,20,7987,10073,7348,-2725
2018,8,27,21,7962,9936,7120,-2816
2018,8,27,22,7814,9697,6958,-2739
2018,8,27,23,7562,9230,6534,-2696
2018,8,28,0,7197,8749,6077,-2672
2018,8,28,1,6930,8473,5850,-2623
2018,8,28,2,6409,7860,5410,-2450
2018,8,28,3,5806,7082,4854,-2228
2018,8,28,4,5221,6381,4423,-1958
2018,8,28,5,4669,5866,4243,-1623
2018,8,28,6,4342,5484,4102,-1382
2018,8,28,7,4118,5193,3906,-1287
2018,8,28,8,3985,5044,3789,-1255
2018,8,28,9,3978,5020,3774,-1246
2018,8,28,10,4200,5299,3998,-1301
2018,8,28,11,4631,5838,4359,-1479
2018,8,28,12,4809,6052,4605,-1447
2018,8,28,13,5056,6353,4575,-1778
2018,8,28,14,5540,6946,4732,-2214
2018,8,28,15,6105,7701,5374,-2327
2018,8,28,16,6654,8488,5899,-2589
2018,8,28,17,7085,9225,6444,-2781
2018,8,28,18,7470,9781,6927,-2854
2018,8,28,19,7715,9888,7033,-2855
2018,8,28,20,7830,9489,6802,-2687
2018,8,28,21,7812,8968,6370,-2598
2018,8,28,22,7664,8267,5755,-2512
2018,8,28,23,7309,7750,5335,-2415
2018,8,29,0,6993,7443,5150,-2293
2018,8,29,1,6772,7328,5029,-2299
2018,8,29,2,6284,6894,4759,-2135
2018,8,29,3,5674,6283,4414,-1869
2018,8,29,4,5109,5674,4023,-1651
2018,8,29,5,4590,5171,3745,-1426
2018,8,29,6,4281,4831,3628,-1203
2018,8,29,7,4073,4630,3479,-1151
2018,8,29,8,3961,4545,3401,-1144
2018,8,29,9,3959,4594,3436,-1158
2018,8,29,10,4151,4920,3678,-1242
2018,8,29,11,4606,5556,4110,-1446
2018,8,29,12,4809,5807,4355,-1452
2018,8,29,13,5054,6018,4316,-1702
2018,8,29,14,5531,6532,4326,-2206
2018,8,29,15,6095,7275,5009,-2266
2018,8,29,16,6716,7967,5563,-2404
2018,8,29,17,7192,8486,5955,-2531
2018,8,29,18,7635,8743,6025,-2718
2018,8,29,19,7921,8769,6080,-2689
2018,8,29,20,8081,8556,5880,-2676
2018,8,29,21,8070,8115,5524,-2591
2018,8,29,22,7979,7731,5250,-2481
2018,8,29,23,7606,7456,5060,-2396
2018,8,30,0,7277,7214,4841,-2373
2018,8,30,1,7015,7028,4602,-2426
2018,8,30,2,6484,6536,4292,-2244
2018,8,30,3,5861,5915,3891,-2024
2018,8,30,4,5279,5332,3646,-1686
2018,8,30,5,4337,4918,3542,-1376
2018,8,30,6,4081,4625,3464,-1161
2018,8,30,7,3914,4454,3339,-1115
2018,8,30,8,3795,4332,3252,-1080
2018,8,30,9,3825,4388,3275,-1113
2018,8,30,10,4061,4727,3524,-1203
2018,8,30,11,4577,5324,3940,-1384
2018,8,30,12,4781,5593,4211,-1382
2018,8,30,13,5016,5901,4260,-1641
2018,8,30,14,5497,6463,4335,-2128
2018,8,30,15,6064,7134,4806,-2328
2018,8,30,16,6667,7728,5313,-2415
2018,8,30,17,7173,8064,5537,-2527
2018,8,30,18,7573,8173,5613,-2560
2018,8,30,19,7794,7921,5425,-2496
2018,8,30,20,7873,7821,5379,-2442
2018,8,30,21,7838,7766,5395,-2371
2018,8,30,22,7664,7690,5206,-2484
2018,8,30,23,7379,7540,5067,-2473
2018,8,31,0,7027,7410,5009,-2401
2018,8,31,1,6825,7443,5036,-2407
2018,8,31,2,6367,7014,4711,-2303
2018,8,31,3,5775,6416,4329,-2087
2018,8,31,4,5238,5799,4028,-1771
2018,8,31,5,4474,5286,3873,-1413
2018,8,31,6,4201,4953,3745,-1208
2018,8,31,7,3985,4729,3579,-1150
2018,8,31,8,3829,4639,3503,-1136
2018,8,31,9,3837,4687,3539,-1148
2018,8,31,10,4048,4967,3731,-1236
2018,8,31,11,4524,5433,3998,-1435
2018,8,31,12,4732,5691,4252,-1439
2018,8,31,13,5019,6124,4364,-1760
2018,8,31,14,5506,6969,4652,-2317
2018,8,31,15,6071,7697,5232,-2465
2018,8,31,16,6587,8376,5785,-2591
2018,8,31,17,7088,8985,6304,-2681
2018,8,31,18,7409,9495,6739,-2756
2018,8,31,19,7622,9858,7047,-2811
2018,8,31,20,7739,9862,7224,-2638
2018,8,31,21,7594,9572,7012,-2560
2018,8,31,22,7395,9100,6490,-2610
2018,8,31,23,7054,8496,5947,-2549
2018,9,1,0,6676,8009,5593,-2416
2018,9,1,1,6448,7793,5336,-2457
2018,9,1,2,6039,7318,4911,-2407
2018,9,1,3,5518,6752,4585,-2167
2018,9,1,4,5087,6191,4347,-1844
2018,9,1,5,4595,5703,4169,-1534
2018,9,1,6,4271,5303,4010,-1293
2018,9,1,7,4037,5011,3803,-1208
2018,9,1,8,3888,4805,3630,-1175
2018,9,1,9,3808,4721,3575,-1146
2018,9,1,10,3825,4741,3572,-1169
2018,9,1,11,3944,4902,3622,-1280
2018,9,1,12,4101,5138,3841,-1297
2018,9,1,13,4592,5786,4171,-1615
2018,9,1,14,5242,6613,4547,-2066
2018,9,1,15,5870,7490,5129,-2361
2018,9,1,16,6480,8290,5673,-2617
2018,9,1,17,6918,8947,6255,-2692
2018,9,1,18,7255,9362,6592,-2770
2018,9,1,19,7489,9560,6883,-2677
2018,9,1,20,7552,9574,6948,-2626
2018,9,1,21,7444,10921,8310,-2611
2018,9,1,22,7241,9393,6830,-2563
2018,9,1,23,6880,8986,6441,-2545
2018,9,2,0,6545,8437,5938,-2499
2018,9,2,1,6343,8144,5586,-2558
2018,9,2,2,5902,7541,5076,-2465
2018,9,2,3,5442,6932,4705,-2227
2018,9,2,4,4986,6315,4393,-1922
2018,9,2,5,4608,5849,4261,-1588
2018,9,2,6,4275,5431,4077,-1354
2018,9,2,7,4002,5099,3827,-1272
2018,9,2,8,3848,4891,3664,-1227
2018,9,2,9,3755,4768,3604,-1164
2018,9,2,10,3712,4734,3542,-1192
2018,9,2,11,3758,4871,3567,-1304
2018,9,2,12,3864,5052,3747,-1305
2018,9,2,13,4385,5746,4100,-1646
2018,9,2,14,5053,6607,4486,-2121
2018,9,2,15,5706,7507,5148,-2359
2018,9,2,16,6238,8264,5626,-2638
2018,9,2,17,6705,8772,6100,-2672
2018,9,2,18,7090,9093,6411,-2682
2018,9,2,19,7295,9107,6487,-2620
2018,9,2,20,7364,8610,6146,-2464
2018,9,2,21,7335,8184,5710,-2474
2018,9,2,22,7053,7786,5334,-2452
2018,9,2,23,6760,7373,4988,-2385
2018,9,3,0,6413,7102,4740,-2362
2018,9,3,1,6229,6762,4356,-2406
2018,9,3,2,5802,6686,4389,-2297
2018,9,3,3,5325,6190,4136,-2054
2018,9,3,4,4871,5707,3968,-1739
2018,9,3,5,4545,5294,3976,-1318
2018,9,3,6,4195,4945,3863,-1082
2018,9,3,7,3955,4727,3712,-1015
2018,9,3,8,3807,4578,3578,-1000
2018,9,3,9,3729,4557,3577,-980
2018,9,3,10,3768,4619,3605,-1014
2018,9,3,11,3845,4813,3694,-1119
2018,9,3,12,3931,4994,3829,-1165
2018,9,3,13,4327,5571,4007,-1564
2018,9,3,14,5031,6405,4334,-2071
2018,9,3,15,5748,7294,4987,-2307
2018,9,3,16,6146,8012,5588,-2424
2018,9,3,17,6448,8523,5941,-2582
2018,9,3,18,6714,8445,5840,-2605
2018,9,3,19,6877,7922,5416,-2506
2018,9,3,20,6830,7475,5106,-2369
2018,9,3,21,6710,7296,4995,-2301
2018,9,3,22,6671,6999,4743,-2256
2018,9,3,23,6472,6855,4626,-2229
2018,9,4,0,6161,6755,4472,-2283
2018,9,4,1,6007,6768,4434,-2334
2018,9,4,2,5593,6417,4304,-2113
2018,9,4,3,5072,5837,3904,-1933
2018,9,4,4,4602,5310,3676,-1634
2018,9,4,5,4138,5120,3701,-1419
2018,9,4,6,3884,4842,3630,-1212
2018,9,4,7,3721,4657,3490,-1167
2018,9,4,8,3635,4621,3473,-1148
2018,9,4,9,3643,4664,3496,-1168
2018,9,4,10,3890,5006,3743,-1263
2018,9,4,11,4376,5614,4212,-1402
2018,9,4,12,4602,5856,4484,-1372
2018,9,4,13,4851,6229,4577,-1652
2018,9,4,14,5297,6919,4837,-2082
2018,9,4,15,5799,7615,5465,-2150
2018,9,4,16,6239,8256,5959,-2297
2018,9,4,17,6698,8814,6313,-2501
2018,9,4,18,7037,9212,6539,-2673
2018,9,4,19,7187,9476,6664,-2812
2018,9,4,20,7188,9454,6668,-2786
2018,9,4,21,7251,9360,6621,-2739
2018,9,4,22,7055,9129,6473,-2656
2018,9,4,23,6878,8728,6129,-2599
2018,9,5,0,6636,8404,5808,-2596
2018,9,5,1,6471,8237,5641,-2596
2018,9,5,2,5961,7663,5348,-2315
2018,9,5,3,5422,6961,4887,-2074
2018,9,5,4,4899,6296,4517,-1779
2018,9,5,5,4449,5801,4274,-1527
2018,9,5,6,4138,5431,4127,-1304
2018,9,5,7,3944,5156,3912,-1244
2018,9,5,8,3834,5021,3809,-1212
2018,9,5,9,3836,5015,3806,-1209
2018,9,5,10,4043,5266,3995,-1271
2018,9,5,11,4486,6105,4722,-1383
2018,9,5,12,4682,5994,4641,-1353
2018,9,5,13,4939,6280,4669,-1611
2018,9,5,14,5446,6922,4794,-2128
2018,9,5,15,6055,7668,5332,-2336
2018,9,5,16,6603,8415,5917,-2498
2018,9,5,17,7183,9063,6376,-2687
2018,9,5,18,7680,9623,6798,-2825
2018,9,5,19,7983,10049,7030,-3019
2018,9,5,20,8100,10309,7326,-2983
2018,9,5,21,8185,10399,7425,-2974
2018,9,5,22,8010,10217,7310,-2907
2018,9,5,23,7820,9723,6875,-2848
2018,9,6,0,7428,9133,6446,-2687
2018,9,6,1,7159,8790,6186,-2604
2018,9,6,2,6611,8072,5666,-2406
2018,9,6,3,5989,7257,5112,-2145
2018,9,6,4,5401,6481,4633,-1848
2018,9,6,5,4701,5909,4399,-1510
2018,9,6,6,4373,5475,4228,-1247
2018,9,6,7,4145,5130,3967,-1163
2018,9,6,8,4022,4971,3768,-1203
2018,9,6,9,4011,4949,3812,-1137
2018,9,6,10,4220,5175,3932,-1243
2018,9,6,11,4610,5745,4355,-1390
2018,9,6,12,4797,5963,4615,-1348
2018,9,6,13,5055,6306,4682,-1624
2018,9,6,14,5575,6985,4936,-2049
2018,9,6,15,6198,7739,5511,-2228
2018,9,6,16,6737,8485,6190,-2295
2018,9,6,17,7175,9111,6592,-2519
2018,9,6,18,7577,9498,6895,-2603
2018,9,6,19,7840,9656,6997,-2659
2018,9,6,20,7905,9580,6908,-2672
2018,9,6,21,7944,9527,6848,-2679
2018,9,6,22,7794,9307,6663,-2644
2018,9,6,23,7451,8805,6272,-2533
2018,9,7,0,7071,8376,5969,-2407
2018,9,7,1,6856,8123,5926,-2197
2018,9,7,2,6340,7492,5353,-2139
2018,9,7,3,5799,6781,4820,-1961
2018,9,7,4,5242,6090,4450,-1640
2018,9,7,5,4688,5508,4218,-1290
2018,9,7,6,4360,5121,3980,-1141
2018,9,7,7,4127,4871,3669,-1202
2018,9,7,8,3990,4729,3537,-1192
2018,9,7,9,3981,4723,3535,-1188
2018,9,7,10,4172,4976,3717,-1259
2018,9,7,11,4588,5505,4149,-1356
2018,9,7,12,4755,5726,4415,-1311
2018,9,7,13,5014,6076,4501,-1575
2018,9,7,14,5527,6685,4566,-2119
2018,9,7,15,6069,7413,4993,-2420
2018,9,7,16,6555,8122,5566,-2556
2018,9,7,17,6941,8673,5929,-2744
2018,9,7,18,7270,9028,6133,-2895
2018,9,7,19,7481,9209,6330,-2879
2018,9,7,20,7544,9176,6279,-2897
2018,9,7,21,7543,8918,6055,-2863
2018,9,7,22,7282,8355,5594,-2761
2018,9,7,23,6973,7925,5189,-2736
2018,9,8,0,6592,7591,4940,-2651
2018,9,8,1,6382,7419,4884,-2535
2018,9,8,2,5938,6961,4675,-2286
2018,9,8,3,5471,6422,4358,-2064
2018,9,8,4,4994,5874,4050,-1824
2018,9,8,5,4491,5349,3872,-1477
2018,9,8,6,4180,4948,3702,-1246
2018,9,8,7,3956,4667,3509,-1158
2018,9,8,8,3801,4517,3393,-1124
2018,9,8,9,3727,4453,3366,-1087
2018,9,8,10,3740,4469,3337,-1132
2018,9,8,11,3831,4657,3390,-1267
2018,9,8,12,3947,4858,3610,-1248
2018,9,8,13,4367,5524,3964,-1560
2018,9,8,14,4993,6352,4348,-2004
2018,9,8,15,5624,7139,5009,-2130
2018,9,8,16,6202,7862,5634,-2228
2018,9,8,17,6630,8523,6184,-2339
2018,9,8,18,6983,8954,6571,-2383
2018,9,8,19,7166,9031,6634,-2397
2018,9,8,20,7226,8838,6496,-2342
2018,9,8,21,7136,8658,6192,-2466
2018,9,8,22,7029,8307,5941,-2366
2018,9,8,23,6714,7801,5496,-2305
2018,9,9,0,6399,7412,5139,-2273
2018,9,9,1,6200,7213,4992,-2221
2018,9,9,2,5763,6758,4654,-2104
2018,9,9,3,5294,6211,4215,-1996
2018,9,9,4,4858,5723,3983,-1740
2018,9,9,5,4290,5240,3917,-1323
2018,9,9,6,3986,4869,3772,-1097
2018,9,9,7,3792,4596,3582,-1014
2018,9,9,8,3646,4404,3438,-966
2018,9,9,9,3564,4304,3376,-928
2018,9,9,10,3570,4318,3364,-954
2018,9,9,11,3625,4452,3484,-968
2018,9,9,12,3746,4646,3629,-1017
2018,9,9,13,4177,5321,3918,-1403
2018,9,9,14,4764,6189,4261,-1928
2018,9,9,15,5406,6988,4859,-2129
2018,9,9,16,5886,7707,5368,-2339
2018,9,9,17,6314,8352,5777,-2575
2018,9,9,18,6647,8821,6079,-2742
2018,9,9,19,6880,9133,6398,-2735
2018,9,9,20,6927,9330,6624,-2706
2018,9,9,21,6856,9378,6645,-2733
2018,9,9,22,6718,9167,6426,-2741
2018,9,9,23,6404,8687,5960,-2727
2018,9,10,0,6213,8225,5505,-2720
2018,9,10,1,6005,7952,5337,-2615
2018,9,10,2,5552,7348,5016,-2332
2018,9,10,3,5052,6578,4546,-2032
2018,9,10,4,4589,5915,4199,-1716
2018,9,10,5,4232,5374,4076,-1298
2018,9,10,6,3945,4996,3921,-1075
2018,9,10,7,3751,4743,3764,-979
2018,9,10,8,3652,4587,3652,-935
2018,9,10,9,3665,4598,3636,-962
2018,9,10,10,3901,4872,3866,-1006
2018,9,10,11,4309,5430,4297,-1133
2018,9,10,12,4540,5668,4483,-1185
2018,9,10,13,4777,6063,4607,-1456
2018,9,10,14,5275,6770,4810,-1960
2018,9,10,15,5873,7530,5459,-2071
2018,9,10,16,6382,8269,6021,-2248
2018,9,10,17,6907,8923,6358,-2565
2018,9,10,18,7281,9352,6615,-2737
2018,9,10,19,7513,9599,6897,-2702
2018,9,10,20,7572,9639,7017,-2622
2018,9,10,21,7553,9567,6964,-2603
2018,9,10,22,7328,9437,6786,-2651
2018,9,10,23,7078,9117,6496,-2621
2018,9,11,0,6829,8680,6147,-2533
2018,9,11,1,6608,8309,5832,-2477
2018,9,11,2,6064,7600,5234,-2366
2018,9,11,3,5482,6839,4571,-2268
2018,9,11,4,4945,6129,4260,-1869
2018,9,11,5,4411,5553,4024,-1529
2018,9,11,6,4080,5162,3938,-1224
2018,9,11,7,3854,4922,3769,-1153
2018,9,11,8,3722,4773,3679,-1094
2018,9,11,9,3718,4779,3681,-1098
2018,9,11,10,3941,5072,3883,-1189
2018,9,11,11,4372,5618,4239,-1379
2018,9,11,12,4613,5842,4515,-1327
2018,9,11,13,4839,6082,4548,-1534
2018,9,11,14,5364,6611,4610,-2001
2018,9,11,15,5952,7358,5134,-2224
2018,9,11,16,6457,8101,5587,-2514
2018,9,11,17,6974,8840,6166,-2674
2018,9,11,18,7384,9454,6709,-2745
2018,9,11,19,7633,9931,7097,-2834
2018,9,11,20,7686,10198,7310,-2888
2018,9,11,21,7661,10316,7479,-2837
2018,9,11,22,7469,10235,7432,-2803
2018,9,11,23,7301,9860,7183,-2677
2018,9,12,0,7041,9358,6586,-2772
2018,9,12,1,6812,9025,6345,-2680
2018,9,12,2,6269,8299,5771,-2528
2018,9,12,3,5656,7453,4987,-2466
2018,9,12,4,5090,6657,4593,-2064
2018,9,12,5,4520,6059,4323,-1736
2018,9,12,6,4217,5653,4249,-1404
2018,9,12,7,4016,5363,4047,-1316
2018,9,12,8,3901,5200,3921,-1279
2018,9,12,9,3906,5143,3883,-1260
2018,9,12,10,4121,5388,4066,-1322
2018,9,12,11,4538,5914,4417,-1497
2018,9,12,12,4754,6134,4706,-1428
2018,9,12,13,5000,6430,4845,-1585
2018,9,12,14,5501,7046,5079,-1967
2018,9,12,15,6108,7850,5593,-2257
2018,9,12,16,6680,8612,6129,-2483
2018,9,12,17,7111,9303,6767,-2536
2018,9,12,18,7530,9864,7191,-2673
2018,9,12,19,7790,10303,7608,-2695
2018,9,12,20,7881,10507,7796,-2711
2018,9,12,21,7843,10575,7887,-2688
2018,9,12,22,7668,10394,7757,-2637
2018,9,12,23,7448,10032,7453,-2579
2018,9,13,0,7134,9493,6879,-2614
2018,9,13,1,6917,9087,6534,-2553
2018,9,13,2,6386,8364,5967,-2397
2018,9,13,3,5784,7524,5226,-2298
2018,9,13,4,5238,6703,4654,-2049
2018,9,13,5,4809,6082,4404,-1678
2018,9,13,6,4462,5617,4244,-1373
2018,9,13,7,4220,5325,4030,-1295
2018,9,13,8,4072,5171,3916,-1255
2018,9,13,9,4046,5133,3886,-1247
2018,9,13,10,4238,5359,4075,-1284
2018,9,13,11,4635,5854,4384,-1470
2018,9,13,12,4863,6073,4669,-1404
2018,9,13,13,5126,6410,4803,-1607
2018,9,13,14,5655,7100,5130,-1970
2018,9,13,15,6333,7840,5699,-2141
2018,9,13,16,6844,8598,6141,-2457
2018,9,13,17,7378,9346,6736,-2610
2018,9,13,18,7862,9981,7243,-2738
2018,9,13,19,8149,10402,7667,-2735
2018,9,13,20,8272,10665,7905,-2760
2018,9,13,21,8225,10690,8088,-2602
2018,9,13,22,8044,10358,7843,-2515
2018,9,13,23,7763,9780,7261,-2519
2018,9,14,0,7431,9221,6547,-2674
2018,9,14,1,7144,8852,6213,-2639
2018,9,14,2,6582,8148,5712,-2436
2018,9,14,3,5949,7311,5036,-2275
2018,9,14,4,5365,6606,4555,-2051
2018,9,14,5,4778,6002,4313,-1689
2018,9,14,6,4459,5566,4196,-1370
2018,9,14,7,4237,5255,3980,-1275
2018,9,14,8,4103,5076,3825,-1251
2018,9,14,9,4091,5012,3783,-1229
2018,9,14,10,4282,5248,3950,-1298
2018,9,14,11,4684,5774,4321,-1453
2018,9,14,12,4895,5990,4617,-1373
2018,9,14,13,5165,6388,4850,-1538
2018,9,14,14,5721,7028,5172,-1856
2018,9,14,15,6346,7835,5618,-2217
2018,9,14,16,6909,8623,6080,-2543
2018,9,14,17,7446,9312,6687,-2625
2018,9,14,18,7881,9930,7201,-2729
2018,9,14,19,8186,10351,7528,-2823
2018,9,14,20,8333,10679,7795,-2884
2018,9,14,21,8369,10893,8066,-2827
2018,9,14,22,8160,10771,7954,-2817
2018,9,14,23,7884,10291,7535,-2756
2018,9,15,0,7495,9697,6943,-2754
2018,9,15,1,7167,9331,6631,-2700
2018,9,15,2,6637,8686,6169,-2517
2018,9,15,3,6076,7957,5577,-2380
2018,9,15,4,5549,7306,5183,-2123
2018,9,15,5,5085,6709,4875,-1834
2018,9,15,6,4714,6205,4692,-1513
2018,9,15,7,4433,5845,4417,-1428
2018,9,15,8,4267,5651,4268,-1383
2018,9,15,9,4161,5512,4172,-1340
2018,9,15,10,4150,5502,4141,-1361
2018,9,15,11,4241,5615,4160,-1455
2018,9,15,12,4401,5794,4355,-1439
2018,9,15,13,4934,6505,4745,-1760
2018,9,15,14,5581,7486,5350,-2136
2018,9,15,15,6316,8464,6075,-2389
2018,9,15,16,6954,9253,6598,-2655
2018,9,15,17,7568,9923,7135,-2788
2018,9,15,18,8029,10360,7440,-2920
2018,9,15,19,8334,10478,7599,-2879
2018,9,15,20,8466,10549,7660,-2889
2018,9,15,21,8404,10570,7736,-2834
2018,9,15,22,8251,10363,7596,-2767
2018,9,15,23,7903,9916,7136,-2780
2018,9,16,0,7551,9421,6738,-2683
2018,9,16,1,7159,9099,6484,-2615
2018,9,16,2,6665,8518,6022,-2496
2018,9,16,3,6132,7850,5469,-2381
2018,9,16,4,5673,7212,5134,-2078
2018,9,16,5,5309,6660,4870,-1790
2018,9,16,6,4904,6204,4715,-1489
2018,9,16,7,4615,5869,4461,-1408
2018,9,16,8,4407,5654,4280,-1374
2018,9,16,9,4266,5547,4190,-1357
2018,9,16,10,4252,5500,4161,-1339
2018,9,16,11,4278,5580,4148,-1432
2018,9,16,12,4401,5715,4316,-1399
2018,9,16,13,4935,6375,4695,-1680
2018,9,16,14,5701,7308,5259,-2049
2018,9,16,15,6390,8195,5928,-2267
2018,9,16,16,7017,8981,6374,-2607
2018,9,16,17,7515,9674,7000,-2674
2018,9,16,18,7960,10204,7468,-2736
2018,9,16,19,8219,10584,7775,-2809
2018,9,16,20,8332,10775,7961,-2814
2018,9,16,21,8257,10744,7950,-2794
2018,9,16,22,8124,10541,7743,-2798
2018,9,16,23,7794,10025,7213,-2812
2018,9,17,0,7517,9490,6732,-2758
2018,9,17,1,7199,9182,6457,-2725
2018,9,17,2,6644,8460,5973,-2487
2018,9,17,3,6052,7656,5271,-2385
2018,9,17,4,5509,6912,4795,-2117
2018,9,17,5,4886,6295,4526,-1769
2018,9,17,6,4532,5851,4425,-1426
2018,9,17,7,4289,5538,4201,-1337
2018,9,17,8,4108,5350,4046,-1304
2018,9,17,9,4071,5346,4052,-1294
2018,9,17,10,4261,5613,4270,-1343
2018,9,17,11,4657,6123,4598,-1525
2018,9,17,12,4870,6350,4852,-1498
2018,9,17,13,5157,6664,4987,-1677
2018,9,17,14,5770,7399,5402,-1997
2018,9,17,15,6440,8269,6028,-2241
2018,9,17,16,7041,9101,6538,-2563
2018,9,17,17,7598,9870,7228,-2642
2018,9,17,18,8059,10383,7744,-2639
2018,9,17,19,8361,10722,8038,-2684
2018,9,17,20,8520,10905,8213,-2692
2018,9,17,21,8453,10951,8252,-2699
2018,9,17,22,8279,10804,8149,-2655
2018,9,17,23,7972,10374,7846,-2528
2018,9,18,0,7701,9876,7361,-2515
2018,9,18,1,7310,9516,6961,-2555
2018,9,18,2,6685,8740,6304,-2436
2018,9,18,3,6030,7824,5565,-2259
2018,9,18,4,5430,7044,5044,-2000
2018,9,18,5,4951,6402,4752,-1650
2018,9,18,6,4592,5958,4627,-1331
2018,9,18,7,4318,5633,4370,-1263
2018,9,18,8,4158,5443,4179,-1264
2018,9,18,9,4114,5365,4102,-1263
2018,9,18,10,4300,5592,4289,-1303
2018,9,18,11,4704,6071,4592,-1479
2018,9,18,12,4906,6286,4857,-1429
2018,9,18,13,5173,6639,5075,-1564
2018,9,18,14,5664,7336,5409,-1927
2018,9,18,15,6301,8219,6073,-2146
2018,9,18,16,6889,9059,6644,-2415
2018,9,18,17,7401,9816,7295,-2521
2018,9,18,18,7876,10258,7659,-2599
2018,9,18,19,8117,10470,7762,-2708
2018,9,18,20,8262,10715,8114,-2601
2018,9,18,21,8215,10897,8331,-2566
2018,9,18,22,8042,10664,8103,-2561
2018,9,18,23,7774,10203,7709,-2494
2018,9,19,0,7527,9663,7239,-2424
2018,9,19,1,7216,9245,6873,-2372
2018,9,19,2,6633,8469,6147,-2322
2018,9,19,3,5980,7625,5433,-2192
2018,9,19,4,5390,6827,4827,-2000
2018,9,19,5,4896,6194,4434,-1760
2018,9,19,6,4532,5780,4243,-1537
2018,9,19,7,4270,5482,4029,-1453
2018,9,19,8,4106,5274,3841,-1433
2018,9,19,9,4066,5222,3802,-1420
2018,9,19,10,4255,5445,3957,-1488
2018,9,19,11,4647,5961,4368,-1593
2018,9,19,12,4845,6160,4597,-1563
2018,9,19,13,5086,6504,4892,-1612
2018,9,19,14,5547,7214,5348,-1866
2018,9,19,15,6166,8074,6035,-2039
2018,9,19,16,6809,9005,6628,-2377
2018,9,19,17,7307,9768,7307,-2461
2018,9,19,18,7773,10306,7805,-2501
2018,9,19,19,8052,10698,8098,-2600
2018,9,19,20,8227,10939,8348,-2591
2018,9,19,21,8181,10826,8253,-2573
2018,9,19,22,8015,10503,7911,-2592
2018,9,19,23,7742,9862,7306,-2556
2018,9,20,0,7477,9389,7015,-2374
2018,9,20,1,7163,9044,6772,-2272
2018,9,20,2,6604,8313,6284,-2029
2018,9,20,3,5968,7439,5590,-1849
2018,9,20,4,5392,6648,5008,-1640
2018,9,20,5,4891,6052,4625,-1427
2018,9,20,6,4530,5620,4412,-1208
2018,9,20,7,4275,5317,4206,-1111
2018,9,20,8,4118,5151,4091,-1060
2018,9,20,9,4083,5084,4013,-1071
2018,9,20,10,4276,5315,4191,-1124
2018,9,20,11,4678,5850,4609,-1241
2018,9,20,12,4883,6050,4864,-1186
2018,9,20,13,5104,6407,5159,-1248
2018,9,20,14,5597,7090,5526,-1564
2018,9,20,15,6224,7996,6199,-1797
2018,9,20,16,6776,8903,6851,-2052
2018,9,20,17,7232,9746,7513,-2233
2018,9,20,18,7617,10350,7790,-2560
2018,9,20,19,7904,10652,7922,-2730
2018,9,20,20,8065,10776,7991,-2785
2018,9,20,21,8010,10702,7980,-2722
2018,9,20,22,7833,10390,7713,-2677
2018,9,20,23,7515,9840,7241,-2599
2018,9,21,0,7262,9348,6954,-2394
2018,9,21,1,6991,8948,6522,-2426
2018,9,21,2,6445,8198,5942,-2256
2018,9,21,3,5832,7360,5259,-2101
2018,9,21,4,5280,6587,4598,-1989
2018,9,21,5,4844,5979,4200,-1779
2018,9,21,6,4504,5542,4005,-1537
2018,9,21,7,4281,5243,3780,-1463
2018,9,21,8,4129,5099,3670,-1429
2018,9,21,9,4096,5076,3644,-1432
2018,9,21,10,4274,5326,3837,-1489
2018,9,21,11,4667,5842,4272,-1570
2018,9,21,12,4866,6087,4543,-1544
2018,9,21,13,5086,6401,4638,-1763
2018,9,21,14,5578,7078,4816,-2262
2018,9,21,15,6149,7786,5422,-2364
2018,9,21,16,6687,8413,5903,-2510
2018,9,21,17,7133,8980,6351,-2629
2018,9,21,18,7483,9425,6687,-2738
2018,9,21,19,7734,9701,6976,-2725
2018,9,21,20,7862,9581,6903,-2678
2018,9,21,21,7751,9492,6738,-2754
2018,9,21,22,7550,9346,6640,-2706
2018,9,21,23,7201,8877,6160,-2717
2018,9,22,0,6806,8415,5819,-2596
2018,9,22,1,6562,8100,5606,-2494
2018,9,22,2,6051,7573,5202,-2371
2018,9,22,3,5527,6961,4752,-2209
2018,9,22,4,5056,6324,4391,-1933
2018,9,22,5,4514,5797,4161,-1636
2018,9,22,6,4197,5323,4038,-1285
2018,9,22,7,3954,5028,3827,-1201
2018,9,22,8,3803,4851,3656,-1195
2018,9,22,9,3725,4748,3587,-1161
2018,9,22,10,3735,4793,3613,-1180
2018,9,22,11,3840,4970,3669,-1301
2018,9,22,12,4009,4893,3588,-1305
2018,9,22,13,4450,5729,4049,-1680
2018,9,22,14,5068,6533,4360,-2173
2018,9,22,15,5692,7326,5055,-2271
2018,9,22,16,6227,8036,5553,-2483
2018,9,22,17,6693,8664,5999,-2665
2018,9,22,18,7001,9194,6527,-2667
2018,9,22,19,7230,9527,6814,-2713
2018,9,22,20,7283,9725,6962,-2763
2018,9,22,21,7168,9751,7060,-2691
2018,9,22,22,6992,9570,6889,-2681
2018,9,22,23,6594,9073,6372,-2701
2018,9,23,0,6323,8545,5978,-2567
2018,9,23,1,6067,8153,5687,-2466
2018,9,23,2,5673,7567,5189,-2378
2018,9,23,3,5203,6929,4661,-2268
2018,9,23,4,4818,6324,4351,-1973
2018,9,23,5,4509,5951,4333,-1618
2018,9,23,6,4197,5639,4349,-1290
2018,9,23,7,3968,5204,4022,-1182
2018,9,23,8,3826,4988,3838,-1150
2018,9,23,9,3761,4886,3776,-1110
2018,9,23,10,3767,4906,3848,-1058
2018,9,23,11,3878,5047,3893,-1154
2018,9,23,12,3986,5208,4078,-1130
2018,9,23,13,4436,5815,4297,-1518
2018,9,23,14,5030,6736,4624,-2112
2018,9,23,15,5671,7599,5269,-2330
2018,9,23,16,6215,8371,5874,-2497
2018,9,23,17,6656,9027,6358,-2669
2018,9,23,18,7010,9521,6807,-2714
2018,9,23,19,7186,9812,7054,-2758
2018,9,23,20,7198,9961,7196,-2765
2018,9,23,21,7101,9963,7262,-2701
2018,9,23,22,6975,9868,7164,-2704
2018,9,23,23,6686,9378,6692,-2686
2018,9,24,0,6504,8933,6307,-2626
2018,9,24,1,6299,8547,6024,-2523
2018,9,24,2,5800,7886,5498,-2388
2018,9,24,3,5271,7124,4851,-2273
2018,9,24,4,4800,6425,4487,-1938
2018,9,24,5,4486,5659,4103,-1556
2018,9,24,6,4171,5256,3974,-1282
2018,9,24,7,3954,4976,3764,-1212
2018,9,24,8,3834,4839,3672,-1167
2018,9,24,9,3840,4825,3670,-1155
2018,9,24,10,4076,5083,3857,-1226
2018,9,24,11,4497,5598,4270,-1328
2018,9,24,12,4727,5826,4471,-1355
2018,9,24,13,4980,6160,4498,-1662
2018,9,24,14,5491,6879,4625,-2254
2018,9,24,15,6093,7661,5328,-2333
2018,9,24,16,6620,8475,5991,-2484
2018,9,24,17,7103,9218,6535,-2683
2018,9,24,18,7504,9752,7089,-2663
2018,9,24,19,7793,10134,7449,-2685
2018,9,24,20,7851,10265,7522,-2743
2018,9,24,21,7859,10136,7432,-2704
2018,9,24,22,7734,9877,7250,-2627
2018,9,24,23,7375,9422,6831,-2591
2018,9,25,0,7110,8888,6301,-2587
2018,9,25,1,6849,8482,5959,-2523
2018,9,25,2,6251,7756,5367,-2389
2018,9,25,3,5649,7028,4730,-2298
2018,9,25,4,5093,6319,4330,-1989
2018,9,25,5,4570,5782,4177,-1605
2018,9,25,6,4255,5376,4104,-1272
2018,9,25,7,4045,5104,3890,-1214
2018,9,25,8,3925,4955,3772,-1183
2018,9,25,9,3921,4919,3757,-1162
2018,9,25,10,4117,5172,3927,-1245
2018,9,25,11,4557,5726,4377,-1349
2018,9,25,12,4772,5964,4573,-1391
2018,9,25,13,5036,6295,4630,-1665
2018,9,25,14,5512,6939,4722,-2217
2018,9,25,15,6111,7735,5404,-2331
2018,9,25,16,6738,8531,6098,-2433
2018,9,25,17,7229,9257,6640,-2617
2018,9,25,18,7629,9787,7161,-2626
2018,9,25,19,7917,10181,7513,-2668
2018,9,25,20,8041,10454,7747,-2707
2018,9,25,21,8011,10655,7918,-2737
2018,9,25,22,7852,10509,7829,-2680
2018,9,25,23,7551,9917,7313,-2604
2018,9,26,0,7298,9110,6489,-2621
2018,9,26,1,7023,8874,6292,-2582
2018,9,26,2,6439,8176,5677,-2499
2018,9,26,3,5814,7349,5021,-2328
2018,9,26,4,5255,6578,4556,-2022
2018,9,26,5,4762,6039,4417,-1622
2018,9,26,6,4434,5609,4298,-1311
2018,9,26,7,4208,5305,4085,-1220
2018,9,26,8,4051,5132,3961,-1171
2018,9,26,9,4028,5070,3896,-1174
2018,9,26,10,4232,5333,4096,-1237
2018,9,26,11,4636,5888,4529,-1359
2018,9,26,12,4835,6081,4678,-1403
2018,9,26,13,5100,6395,4691,-1704
2018,9,26,14,5652,7075,4822,-2253
2018,9,26,15,6279,7902,5540,-2362
2018,9,26,16,6837,8781,6222,-2559
2018,9,26,17,7369,9500,6791,-2709
2018,9,26,18,7788,10156,7454,-2702
2018,9,26,19,8090,10586,7866,-2720
2018,9,26,20,8280,10768,8074,-2694
2018,9,26,21,8304,10761,8144,-2617
2018,9,26,22,8155,10476,7946,-2530
2018,9,26,23,7817,9932,7425,-2507
2018,9,27,0,7516,9479,6897,-2582
2018,9,27,1,7178,9074,6540,-2534
2018,9,27,2,6612,8360,5969,-2391
2018,9,27,3,5982,7352,5041,-2311
2018,9,27,4,5384,6808,4974,-1834
2018,9,27,5,4712,6134,4676,-1458
2018,9,27,6,4398,5699,4442,-1257
2018,9,27,7,4159,5353,4161,-1192
2018,9,27,8,4033,5174,4010,-1164
2018,9,27,9,4018,5127,3961,-1166
2018,9,27,10,4226,5384,4145,-1239
2018,9,27,11,4655,5910,4545,-1365
2018,9,27,12,4892,6114,4769,-1345
2018,9,27,13,5167,6403,4757,-1646
2018,9,27,14,5621,7098,4921,-2177
2018,9,27,15,6288,7841,5531,-2310
2018,9,27,16,6943,8656,6094,-2562
2018,9,27,17,7392,9384,6719,-2665
2018,9,27,18,7786,10034,7343,-2691
2018,9,27,19,8070,10444,7723,-2721
2018,9,27,20,8242,10718,7937,-2781
2018,9,27,21,8293,10863,8076,-2787
2018,9,27,22,8143,10749,8004,-2745
2018,9,27,23,7760,10255,7652,-2603
2018,9,28,0,7474,9750,7028,-2722
2018,9,28,1,7137,9222,6561,-2661
2018,9,28,2,6571,8443,5979,-2464
2018,9,28,3,5964,7622,5389,-2233
2018,9,28,4,5383,6856,4927,-1929
2018,9,28,5,4919,6269,4655,-1614
2018,9,28,6,4570,5822,4512,-1310
2018,9,28,7,4335,5549,4302,-1247
2018,9,28,8,4192,5348,4126,-1222
2018,9,28,9,4147,5279,4052,-1227
2018,9,28,10,4330,5470,4208,-1262
2018,9,28,11,4737,5999,4630,-1369
2018,9,28,12,4950,6195,4802,-1393
2018,9,28,13,5179,6549,4858,-1691
2018,9,28,14,5682,7241,5041,-2200
2018,9,28,15,6372,8083,5738,-2345
2018,9,28,16,7017,8894,6386,-2508
2018,9,28,17,7495,9650,6910,-2740
2018,9,28,18,7912,10257,7473,-2784
2018,9,28,19,8214,10691,7963,-2728
2018,9,28,20,8398,10891,8192,-2699
2018,9,28,21,8415,10907,8155,-2752
2018,9,28,22,8214,10601,7815,-2786
2018,9,28,23,7814,9953,7236,-2717
2018,9,29,0,7450,9392,6715,-2677
2018,9,29,1,7090,8853,6300,-2553
2018,9,29,2,6548,8245,5839,-2406
2018,9,29,3,5996,7549,5329,-2220
2018,9,29,4,5499,6868,4913,-1955
2018,9,29,5,5024,6191,4509,-1682
2018,9,29,6,4646,5686,4322,-1364
2018,9,29,7,4370,5390,4117,-1273
2018,9,29,8,4192,5184,3947,-1237
2018,9,29,9,4085,5055,3828,-1227
2018,9,29,10,4093,5034,3817,-1217
2018,9,29,11,4176,5192,3948,-1244
2018,9,29,12,4319,5388,4031,-1357
2018,9,29,13,4766,5970,4345,-1625
2018,9,29,14,5420,6847,4718,-2129
2018,9,29,15,6119,7747,5422,-2325
2018,9,29,16,6777,8550,5991,-2559
2018,9,29,17,7236,9253,6495,-2758
2018,9,29,18,7673,9798,6963,-2835
2018,9,29,19,7927,10160,7285,-2875
2018,9,29,20,8038,10367,7508,-2859
2018,9,29,21,7903,10391,7536,-2855
2018,9,29,22,7712,10189,7310,-2879
2018,9,29,23,7389,9690,6815,-2875
2018,9,30,0,7112,9169,6464,-2705
2018,9,30,1,6719,8705,6125,-2580
2018,9,30,2,6242,8067,5757,-2310
2018,9,30,3,5733,7358,5383,-1975
2018,9,30,4,5275,6728,5110,-1618
2018,9,30,5,4751,6143,4736,-1407
2018,9,30,6,4381,5614,4270,-1344
2018,9,30,7,4128,5272,3986,-1286
2018,9,30,8,3951,5023,3792,-1231
2018,9,30,9,3850,4894,3681,-1213
2018,9,30,10,3841,4864,3656,-1208
2018,9,30,11,3908,4975,3744,-1231
2018,9,30,12,4049,5116,3823,-1293
2018,9,30,13,4463,5759,4148,-1611
2018,9,30,14,5154,6693,4574,-2119
2018,9,30,15,5895,7574,5276,-2298
2018,9,30,16,6556,8379,5851,-2528
2018,9,30,17,7048,9107,6345,-2762
2018,9,30,18,7432,9624,6846,-2778
2018,9,30,19,7714,9971,7179,-2792
2018,9,30,20,7842,10174,7397,-2777
2018,9,30,21,7777,10229,7436,-2793
2018,9,30,22,7622,10084,7263,-2821
2018,9,30,23,7357,9600,6798,-2802
2018,10,1,0,7108,9182,6500,-2682
2018,10,1,1,6789,8719,6156,-2563
2018,10,1,2,6232,7998,5605,-2393
2018,10,1,3,5644,7188,4963,-2225
2018,10,1,4,5110,6452,4480,-1972
2018,10,1,5,4615,5850,4261,-1589
2018,10,1,6,4274,5427,4149,-1278
2018,10,1,7,4060,5143,3934,-1209
2018,10,1,8,3927,4978,3799,-1179
2018,10,1,9,3918,4956,3784,-1172
2018,10,1,10,4123,5250,4001,-1249
2018,10,1,11,4540,5782,4425,-1357
2018,10,1,12,4778,6050,4631,-1419
2018,10,1,13,5003,6232,4571,-1661
2018,10,1,14,5527,6718,4566,-2152
2018,10,1,15,6120,7286,5041,-2245
2018,10,1,16,6661,7929,5478,-2451
2018,10,1,17,7067,8583,5975,-2608
2018,10,1,18,7428,9084,6462,-2622
2018,10,1,19,7744,9425,6718,-2707
2018,10,1,20,7856,9601,6838,-2763
2018,10,1,21,7873,9669,6890,-2779
2018,10,1,22,7753,9509,6758,-2751
2018,10,1,23,7439,9081,6357,-2724
2018,10,2,0,7126,8811,6086,-2725
2018,10,2,1,6884,8481,5869,-2612
2018,10,2,2,6285,7841,5375,-2466
2018,10,2,3,5708,7049,4730,-2319
2018,10,2,4,5153,6370,4407,-1963
2018,10,2,5,4587,5827,4153,-1674
2018,10,2,6,4285,5397,3955,-1442
2018,10,2,7,4080,5139,3761,-1378
2018,10,2,8,3965,5000,3649,-1351
2018,10,2,9,3956,5010,3645,-1365
2018,10,2,10,4138,5254,3678,-1576
2018,10,2,11,4577,5822,4071,-1751
2018,10,2,12,4803,6010,4285,-1725
2018,10,2,13,4996,6280,4345,-1935
2018,10,2,14,5405,6865,4538,-2327
2018,10,2,15,5935,7577,5195,-2382
2018,10,2,16,6379,8161,5676,-2485
2018,10,2,17,6733,8662,6100,-2562
2018,10,2,18,7073,9024,6355,-2669
2018,10,2,19,7285,9259,6546,-2713
2018,10,2,20,7362,9359,6607,-2752
2018,10,2,21,7359,9246,6514,-2732
2018,10,2,22,7191,8970,6292,-2678
2018,10,2,23,6868,8629,6028,-2601
2018,10,3,0,6684,8463,5878,-2585
2018,10,3,1,6419,8142,5639,-2503
2018,10,3,2,5881,7521,5151,-2370
2018,10,3,3,5329,6751,4489,-2262
2018,10,3,4,4824,6035,4069,-1966
2018,10,3,5,4370,5437,3757,-1663
2018,10,3,6,4062,5018,3557,-1443
2018,10,3,7,3830,4756,3395,-1344
2018,10,3,8,3701,4613,3283,-1314
2018,10,3,9,3701,4580,3263,-1314
2018,10,3,10,3905,4852,3332,-1520
2018,10,3,11,4327,5389,3697,-1692
2018,10,3,12,4533,5620,3957,-1663
2018,10,3,13,4719,5886,4182,-1704
2018,10,3,14,5089,6477,4500,-1976
2018,10,3,15,5691,7128,4941,-2172
2018,10,3,16,6214,7758,5440,-2283
2018,10,3,17,6626,8270,5933,-2302
2018,10,3,18,7004,8792,6342,-2415
2018,10,3,19,7292,9207,6660,-2512
2018,10,3,20,7436,9436,6905,-2495
2018,10,3,21,7453,9550,7070,-2444
2018,10,3,22,7288,9394,6898,-2461
2018,10,3,23,6896,8976,6474,-2469
2018,10,4,0,6717,8646,6253,-2373
2018,10,4,1,6422,8219,5935,-2260
2018,10,4,2,5883,7562,5319,-2209
2018,10,4,3,5329,6728,4596,-2110
2018,10,4,4,4806,6009,4279,-1712
2018,10,4,5,4346,5426,4051,-1375
2018,10,4,6,4047,5002,3832,-1170
2018,10,4,7,3843,4743,3635,-1108
2018,10,4,8,3747,4578,3491,-1087
2018,10,4,9,3747,4572,3490,-1082
2018,10,4,10,3962,4836,3697,-1139
2018,10,4,11,4406,5397,4130,-1267
2018,10,4,12,4604,5624,4322,-1302
2018,10,4,13,4793,5857,4262,-1595
2018,10,4,14,5166,6454,4488,-1966
2018,10,4,15,5776,7182,5059,-2123
2018,10,4,16,6290,7930,5674,-2256
2018,10,4,17,6703,8533,6206,-2327
2018,10,4,18,7119,9016,6559,-2457
2018,10,4,19,7389,9305,6797,-2508
2018,10,4,20,7583,9414,6899,-2515
2018,10,4,21,7650,9414,6879,-2535
2018,10,4,22,7441,9204,6729,-2475
2018,10,4,23,7110,8821,6472,-2349
2018,10,5,0,6871,8572,6226,-2346
2018,10,5,1,6567,8255,5985,-2270
2018,10,5,2,6034,7588,5384,-2204
2018,10,5,3,5454,6844,4744,-2100
2018,10,5,4,4912,6126,4344,-1782
2018,10,5,5,4506,5528,4027,-1501
2018,10,5,6,4176,5109,3917,-1192
2018,10,5,7,3967,4773,3674,-1099
2018,10,5,8,3839,4607,3535,-1072
2018,10,5,9,3822,4562,3490,-1072
2018,10,5,10,4008,4803,3681,-1122
2018,10,5,11,4408,5356,4115,-1241
2018,10,5,12,4601,5610,4301,-1309
2018,10,5,13,4832,5878,4345,-1533
2018,10,5,14,5369,6512,4514,-1998
2018,10,5,15,5924,7232,5053,-2179
2018,10,5,16,6457,7965,5584,-2381
2018,10,5,17,6842,8637,6280,-2357
2018,10,5,18,7223,9208,6983,-2225
2018,10,5,19,7526,9613,7204,-2409
2018,10,5,20,7710,9880,7379,-2501
2018,10,5,21,7747,9975,7458,-2517
2018,10,5,22,7576,9749,7310,-2439
2018,10,5,23,7151,9118,6755,-2363
2018,10,6,0,6846,8650,6396,-2254
2018,10,6,1,6564,8148,5875,-2273
2018,10,6,2,6058,7544,5319,-2225
2018,10,6,3,5546,6912,4835,-2077
2018,10,6,4,5064,6241,4503,-1738
2018,10,6,5,4527,5656,4280,-1376
2018,10,6,6,4185,5178,3996,-1182
2018,10,6,7,3939,4860,3731,-1129
2018,10,6,8,3798,4682,3591,-1091
2018,10,6,9,3723,4582,3519,-1063
2018,10,6,10,3703,4598,3521,-1077
2018,10,6,11,3804,4769,3656,-1113
2018,10,6,12,3956,4953,3745,-1208
2018,10,6,13,4361,5517,4067,-1450
2018,10,6,14,4945,6316,4567,-1749
2018,10,6,15,5537,7090,5214,-1876
2018,10,6,16,6032,7774,5768,-2006
2018,10,6,17,6432,8415,6327,-2088
2018,10,6,18,6778,8925,6811,-2114
2018,10,6,19,7057,9269,7145,-2124
2018,10,6,20,7142,9448,7282,-2166
2018,10,6,21,7092,9493,7328,-2165
2018,10,6,22,6931,9171,7079,-2092
2018,10,6,23,6622,8573,6552,-2021
2018,10,7,0,6354,8144,6123,-2021
2018,10,7,1,6084,7733,5802,-1931
2018,10,7,2,5617,7178,5374,-1804
2018,10,7,3,5150,6557,4840,-1717
2018,10,7,4,4737,5978,4457,-1521
2018,10,7,5,4291,5449,4114,-1335
2018,10,7,6,3973,5006,3829,-1177
2018,10,7,7,3727,4753,3601,-1152
2018,10,7,8,3558,4566,3486,-1080
2018,10,7,9,3487,4484,3431,-1053
2018,10,7,10,3470,4457,3390,-1067
2018,10,7,11,3565,4570,3470,-1100
2018,10,7,12,3711,4754,3568,-1186
2018,10,7,13,4109,5366,3915,-1451
2018,10,7,14,4719,6232,4429,-1803
2018,10,7,15,5407,7079,5171,-1908
2018,10,7,16,5924,7797,5723,-2074
2018,10,7,17,6453,8410,6347,-2063
2018,10,7,18,6847,8855,6690,-2165
2018,10,7,19,7090,9006,6872,-2134
2018,10,7,20,7233,9026,6891,-2135
2018,10,7,21,7212,8840,6786,-2054
2018,10,7,22,7050,8612,6565,-2047
2018,10,7,23,6764,8235,6147,-2088
2018,10,8,0,6552,8088,5922,-2166
2018,10,8,1,6255,7774,5621,-2153
2018,10,8,2,5739,7163,5189,-1974
2018,10,8,3,5202,6507,4696,-1811
2018,10,8,4,4726,5848,4250,-1598
2018,10,8,5,4335,5280,3948,-1332
2018,10,8,6,4047,4891,3724,-1167
2018,10,8,7,3839,4684,3539,-1145
2018,10,8,8,3772,4548,3430,-1118
2018,10,8,9,3815,4575,3453,-1122
2018,10,8,10,4048,4915,3729,-1186
2018,10,8,11,4491,5491,4180,-1311
2018,10,8,12,4736,5785,4438,-1347
2018,10,8,13,4916,5987,4500,-1487
2018,10,8,14,5363,6438,4784,-1654
2018,10,8,15,5883,7014,5248,-1766
2018,10,8,16,6375,7540,5576,-1964
2018,10,8,17,6726,7940,5873,-2067
2018,10,8,18,7064,8179,6100,-2079
2018,10,8,19,7264,8209,6183,-2026
2018,10,8,20,7369,8051,6017,-2034
2018,10,8,21,7319,7944,5790,-2154
2018,10,8,22,7130,7800,5618,-2182
2018,10,8,23,6907,7624,5405,-2219
2018,10,9,0,6811,7701,5627,-2074
2018,10,9,1,6470,7466,5463,-2003
2018,10,9,2,5947,6977,5025,-1952
2018,10,9,3,5372,6329,4456,-1873
2018,10,9,4,4873,5771,4142,-1629
2018,10,9,5,4432,5241,3866,-1375
2018,10,9,6,4167,4923,3664,-1259
2018,10,9,7,4005,4717,3559,-1158
2018,10,9,8,3922,4627,3499,-1128
2018,10,9,9,3941,4672,3566,-1106
2018,10,9,10,4176,4990,3818,-1172
2018,10,9,11,4643,5598,4366,-1232
2018,10,9,12,4902,5897,4560,-1337
2018,10,9,13,5107,6061,4529,-1532
2018,10,9,14,5548,6593,4885,-1708
2018,10,9,15,5999,7202,5526,-1676
2018,10,9,16,6458,7759,5912,-1847
2018,10,9,17,6772,8348,6381,-1967
2018,10,9,18,7088,8841,6863,-1978
2018,10,9,19,7270,9221,7042,-2179
2018,10,9,20,7328,9403,7261,-2142
2018,10,9,21,7328,9329,7178,-2151
2018,10,9,22,7146,8978,6881,-2097
2018,10,9,23,6902,8605,6618,-1987
2018,10,10,0,6858,8509,6572,-1937
2018,10,10,1,6612,8186,6313,-1873
2018,10,10,2,6112,7676,5945,-1731
2018,10,10,3,5576,7086,5437,-1649
2018,10,10,4,5084,6450,4888,-1562
2018,10,10,5,4654,5886,4398,-1488
2018,10,10,6,4382,5551,4197,-1354
2018,10,10,7,4202,5342,4055,-1287
2018,10,10,8,4110,5257,3980,-1277
2018,10,10,9,4121,5300,4013,-1287
2018,10,10,10,4332,5582,4232,-1350
2018,10,10,11,4764,6154,4717,-1437
2018,10,10,12,5022,6497,4978,-1519
2018,10,10,13,5209,6671,4846,-1825
2018,10,10,14,5605,6999,4853,-2146
2018,10,10,15,5984,7462,5227,-2235
2018,10,10,16,6315,7808,5464,-2344
2018,10,10,17,6540,8156,5754,-2402
2018,10,10,18,6740,8419,5940,-2479
2018,10,10,19,6876,8366,5919,-2447
2018,10,10,20,6881,8164,5773,-2391
2018,10,10,21,6940,7927,5526,-2401
2018,10,10,22,6779,7860,5454,-2406
2018,10,10,23,6619,7712,5339,-2373
2018,10,11,0,6624,7771,5376,-2395
2018,10,11,1,6396,7573,5298,-2275
2018,10,11,2,5964,7187,4992,-2195
2018,10,11,3,5474,6623,4554,-2069
2018,10,11,4,5038,6083,4279,-1804
2018,10,11,5,4569,5640,4087,-1553
2018,10,11,6,4304,5341,4033,-1308
2018,10,11,7,4139,5191,3929,-1262
2018,10,11,8,4057,5126,3872,-1254
2018,10,11,9,4086,5175,3907,-1268
2018,10,11,10,4335,5467,4139,-1328
2018,10,11,11,4833,5965,4568,-1397
2018,10,11,12,5066,6206,4791,-1415
2018,10,11,13,5228,6326,4668,-1658
2018,10,11,14,5585,6847,4725,-2122
2018,10,11,15,5969,7473,5107,-2366
2018,10,11,16,6404,8012,5485,-2527
2018,10,11,17,6829,8564,6006,-2558
2018,10,11,18,7141,8986,6418,-2568
2018,10,11,19,7378,9231,6692,-2539
2018,10,11,20,7427,9388,6843,-2545
2018,10,11,21,7376,9402,6881,-2521
2018,10,11,22,7114,9270,6754,-2516
2018,10,11,23,6767,8814,6320,-2494
2018,10,12,0,6650,8514,6051,-2463
2018,10,12,1,6370,8050,5694,-2356
2018,10,12,2,5849,7412,5229,-2183
2018,10,12,3,5362,6640,4555,-2085
2018,10,12,4,4862,5963,4128,-1835
2018,10,12,5,4466,5414,3923,-1491
2018,10,12,6,4142,4988,3735,-1253
2018,10,12,7,3890,4688,3486,-1202
2018,10,12,8,3757,4508,3328,-1180
2018,10,12,9,3722,4471,3307,-1164
2018,10,12,10,3884,4667,3463,-1204
2018,10,12,11,4255,5146,3871,-1275
2018,10,12,12,4452,5379,4103,-1276
2018,10,12,13,4585,5582,4046,-1536
2018,10,12,14,4953,6117,4214,-1903
2018,10,12,15,5367,6705,4675,-2030
2018,10,12,16,5867,7286,5076,-2210
2018,10,12,17,6318,7907,5552,-2355
2018,10,12,18,6668,8420,5957,-2463
2018,10,12,19,6927,8783,6335,-2448
2018,10,12,20,7065,8987,6503,-2484
2018,10,12,21,7067,9023,6528,-2495
2018,10,12,22,6725,8762,6322,-2440
2018,10,12,23,6356,8106,5671,-2435
2018,10,13,0,6076,7606,5350,-2256
2018,10,13,1,5763,7098,4941,-2157
2018,10,13,2,5286,6492,4465,-2027
2018,10,13,3,4865,5873,3995,-1878
2018,10,13,4,4449,5267,3634,-1633
2018,10,13,5,4000,4733,3344,-1389
2018,10,13,6,3688,4308,3129,-1179
2018,10,13,7,3439,4038,2888,-1150
2018,10,13,8,3307,3855,2862,-993
2018,10,13,9,3234,3768,2789,-979
2018,10,13,10,3240,3824,2752,-1072
2018,10,13,11,3402,3962,2844,-1118
2018,10,13,12,3551,4131,3055,-1076
2018,10,13,13,3886,4516,3092,-1424
2018,10,13,14,4361,5059,3317,-1742
2018,10,13,15,4850,5537,3704,-1833
2018,10,13,16,5292,6074,4064,-2010
2018,10,13,17,5728,6599,4479,-2120
2018,10,13,18,6117,7165,5001,-2164
2018,10,13,19,6408,7643,5403,-2240
2018,10,13,20,6591,7999,5744,-2255
2018,10,13,21,6616,8149,5840,-2309
2018,10,13,22,6498,8016,5743,-2273
2018,10,13,23,6171,7466,5259,-2207
2018,10,14,0,5895,7027,4815,-2212
2018,10,14,1,5552,6587,4481,-2106
2018,10,14,2,5144,6034,4068,-1966
2018,10,14,3,4679,5498,3762,-1736
2018,10,14,4,4292,4983,3436,-1547
2018,10,14,5,3814,4518,3205,-1313
2018,10,14,6,3543,4155,3201,-954
2018,10,14,7,3310,3927,3056,-871
2018,10,14,8,3190,3800,2960,-840
2018,10,14,9,3167,3751,2888,-863
2018,10,14,10,3174,3778,2898,-880
2018,10,14,11,3313,3910,3016,-894
2018,10,14,12,3486,4104,3219,-885
2018,10,14,13,3853,4639,3624,-1015
2018,10,14,14,4410,5477,4083,-1394
2018,10,14,15,4983,6288,4423,-1865
2018,10,14,16,5519,7103,4937,-2166
2018,10,14,17,6004,7866,5506,-2360
2018,10,14,18,6423,8455,6026,-2429
2018,10,14,19,6703,8890,6218,-2672
2018,10,14,20,6920,9161,6391,-2770
2018,10,14,21,7015,9225,6439,-2786
2018,10,14,22,6944,9061,6302,-2759
2018,10,14,23,6651,8607,6105,-2502
2018,10,15,0,6497,8361,5935,-2426
2018,10,15,1,6195,7915,5591,-2324
2018,10,15,2,5703,7287,5014,-2273
2018,10,15,3,5179,6620,4456,-2164
2018,10,15,4,4676,5997,4070,-1927
2018,10,15,5,4352,5422,3875,-1547
2018,10,15,6,4041,5044,3766,-1278
2018,10,15,7,3878,4774,3601,-1173
2018,10,15,8,3765,4622,3475,-1147
2018,10,15,9,3776,4604,3465,-1139
2018,10,15,10,3986,4838,3646,-1192
2018,10,15,11,4440,5307,4023,-1284
2018,10,15,12,4689,5571,4252,-1319
2018,10,15,13,4850,5878,4392,-1486
2018,10,15,14,5369,6571,4832,-1739
2018,10,15,15,5972,7391,5253,-2138
2018,10,15,16,6435,8151,5908,-2243
2018,10,15,17,6814,8886,6441,-2445
2018,10,15,18,7180,9481,6987,-2494
2018,10,15,19,7457,9843,7383,-2460
2018,10,15,20,7588,10048,7540,-2508
2018,10,15,21,7658,10121,7593,-2528
2018,10,15,22,7509,9824,7502,-2322
2018,10,15,23,7180,9367,7213,-2154
2018,10,16,0,7060,9164,6992,-2172
2018,10,16,1,6704,8637,6461,-2176
2018,10,16,2,6104,7916,5850,-2066
2018,10,16,3,5540,7123,5103,-2020
2018,10,16,4,5025,6384,4482,-1902
2018,10,16,5,4632,5740,4020,-1720
2018,10,16,6,4319,5287,3782,-1505
2018,10,16,7,4122,4967,3532,-1435
2018,10,16,8,3992,4792,3405,-1387
2018,10,16,9,3960,4755,3353,-1402
2018,10,16,10,4173,4999,3553,-1446
2018,10,16,11,4632,5529,3989,-1540
2018,10,16,12,4853,5758,4197,-1561
2018,10,16,13,5043,6013,4271,-1742
2018,10,16,14,5552,6682,4613,-2069
2018,10,16,15,6108,7466,5225,-2241
2018,10,16,16,6692,8245,5913,-2332
2018,10,16,17,7164,9024,6549,-2475
2018,10,16,18,7572,9630,7093,-2537
2018,10,16,19,7863,10053,7361,-2692
2018,10,16,20,8056,10340,7727,-2613
2018,10,16,21,8144,10475,7842,-2633
2018,10,16,22,7971,10279,7715,-2564
2018,10,16,23,7596,9766,7189,-2577
2018,10,17,0,7449,9439,6845,-2594
2018,10,17,1,7055,8876,6472,-2404
2018,10,17,2,6483,8169,6041,-2128
2018,10,17,3,5891,7285,5166,-2119
2018,10,17,4,5334,6508,4593,-1915
2018,10,17,5,4763,5829,4127,-1702
2018,10,17,6,4430,5376,3864,-1512
2018,10,17,7,4174,5076,3629,-1447
2018,10,17,8,4037,4886,3471,-1415
2018,10,17,9,4019,4825,3415,-1410
2018,10,17,10,4216,5063,3634,-1429
2018,10,17,11,4646,5581,4037,-1544
2018,10,17,12,4855,5786,4152,-1634
2018,10,17,13,4997,6012,4213,-1799
2018,10,17,14,5482,6643,4505,-2138
2018,10,17,15,6049,7411,5081,-2330
2018,10,17,16,6630,8145,5692,-2453
2018,10,17,17,7104,8867,6366,-2501
2018,10,17,18,7512,9420,6924,-2496
2018,10,17,19,7816,9798,7245,-2553
2018,10,17,20,8042,10130,7498,-2632
2018,10,17,21,8125,10274,7598,-2676
2018,10,17,22,7943,10154,7527,-2627
2018,10,17,23,7530,9590,7133,-2457
2018,10,18,0,7353,9223,6783,-2440
2018,10,18,1,6895,8658,6199,-2459
2018,10,18,2,6352,7933,5624,-2309
2018,10,18,3,5747,7125,4843,-2282
2018,10,18,4,5184,6352,4345,-2007
2018,10,18,5,4649,5721,3974,-1747
2018,10,18,6,4274,5249,3756,-1493
2018,10,18,7,4044,4931,3507,-1424
2018,10,18,8,3912,4730,3354,-1376
2018,10,18,9,3898,4685,3320,-1365
2018,10,18,10,4092,4915,3504,-1411
2018,10,18,11,4505,5435,3903,-1532
2018,10,18,12,4707,5669,4182,-1487
2018,10,18,13,4843,5898,4235,-1663
2018,10,18,14,5199,6532,4487,-2045
2018,10,18,15,5711,7251,5046,-2205
2018,10,18,16,6139,7974,5683,-2291
2018,10,18,17,6542,8662,6328,-2334
2018,10,18,18,6845,9219,6752,-2467
2018,10,18,19,7118,9668,7148,-2520
2018,10,18,20,7313,9946,7321,-2625
2018,10,18,21,7395,10028,7419,-2609
2018,10,18,22,7240,9876,7305,-2571
2018,10,18,23,6867,9319,6875,-2444
2018,10,19,0,6720,9083,6676,-2407
2018,10,19,1,6380,8556,6210,-2346
2018,10,19,2,5894,7872,5571,-2301
2018,10,19,3,5343,7080,4860,-2220
2018,10,19,4,4840,6346,4345,-2001
2018,10,19,5,4451,5717,3963,-1754
2018,10,19,6,4165,5302,3812,-1490
2018,10,19,7,3941,4991,3588,-1403
2018,10,19,8,3814,4804,3430,-1374
2018,10,19,9,3816,4776,3418,-1358
2018,10,19,10,3987,5011,3588,-1423
2018,10,19,11,4376,5531,4004,-1527
2018,10,19,12,4580,5832,4325,-1507
2018,10,19,13,4739,6060,4375,-1685
2018,10,19,14,5077,6600,4556,-2044
2018,10,19,15,5557,7215,5038,-2177
2018,10,19,16,5922,7833,5538,-2295
2018,10,19,17,6318,8359,6006,-2353
2018,10,19,18,6661,8729,6336,-2393
2018,10,19,19,6920,8938,6384,-2554
2018,10,19,20,7102,9008,6395,-2613
2018,10,19,21,7150,8929,6329,-2600
2018,10,19,22,6889,8685,6139,-2546
2018,10,19,23,6525,8218,5881,-2337
2018,10,20,0,6356,7991,5692,-2299
2018,10,20,1,6000,7545,5348,-2197
2018,10,20,2,5583,7014,5088,-1926
2018,10,20,3,5159,6463,4788,-1675
2018,10,20,4,4740,5893,4497,-1396
2018,10,20,5,4473,5383,3908,-1475
2018,10,20,6,4140,4978,3578,-1400
2018,10,20,7,3906,4713,3369,-1344
2018,10,20,8,3766,4523,3220,-1303
2018,10,20,9,3699,4437,3153,-1284
2018,10,20,10,3696,4469,3199,-1270
2018,10,20,11,3784,4620,3336,-1284
2018,10,20,12,3954,4837,3543,-1294
2018,10,20,13,4325,5372,4065,-1307
2018,10,20,14,4898,6169,4792,-1377
2018,10,20,15,5569,6943,5411,-1532
2018,10,20,16,6053,7712,6010,-1702
2018,10,20,17,6385,8406,6601,-1805
2018,10,20,18,6728,8919,6923,-1996
2018,10,20,19,6972,9295,7149,-2146
2018,10,20,20,7070,9483,7167,-2316
2018,10,20,21,6952,9547,7226,-2321
2018,10,20,22,6773,9211,7028,-2183
2018,10,20,23,6481,8637,6828,-1809
2018,10,21,0,6307,8289,6626,-1663
2018,10,21,1,5928,7776,6154,-1622
2018,10,21,2,5493,7238,5769,-1469
2018,10,21,3,5033,6658,5333,-1325
2018,10,21,4,4625,6069,4994,-1075
2018,10,21,5,4197,5597,4657,-940
2018,10,21,6,3872,5173,4217,-956
2018,10,21,7,3606,4849,3867,-982
2018,10,21,8,3458,4696,3736,-960
2018,10,21,9,3374,4566,3626,-940
2018,10,21,10,3353,4505,3572,-933
2018,10,21,11,3493,4586,3645,-941
2018,10,21,12,3634,4733,3928,-805
2018,10,21,13,3961,5194,4358,-836
2018,10,21,14,4390,5749,4828,-921
2018,10,21,15,4754,6110,5132,-978
2018,10,21,16,5058,6370,5332,-1038
2018,10,21,17,5241,6731,5620,-1111
2018,10,21,18,5362,7110,5911,-1199
2018,10,21,19,5377,7368,5986,-1382
2018,10,21,20,5243,7539,6087,-1452
2018,10,21,21,5077,7618,6152,-1466
2018,10,21,22,4936,7415,6005,-1410
2018,10,21,23,4740,6934,5756,-1178
2018,10,22,0,4869,6777,5623,-1154
2018,10,22,1,4621,6400,5340,-1060
2018,10,22,2,4227,5891,4984,-907
2018,10,22,3,3839,5281,4474,-807
2018,10,22,4,3472,4570,3805,-765
2018,10,22,5,3301,4123,3293,-830
2018,10,22,6,3043,3799,3029,-770
2018,10,22,7,2883,3631,2883,-748
2018,10,22,8,2819,3541,2801,-740
2018,10,22,9,2863,3594,2841,-753
2018,10,22,10,3097,3872,3104,-768
2018,10,22,11,3512,4395,3680,-715
2018,10,22,12,3730,4702,4082,-620
2018,10,22,13,3813,4831,4114,-717
2018,10,22,14,4034,5153,4040,-1113
2018,10,22,15,4314,5477,4330,-1147
2018,10,22,16,4522,5842,4536,-1306
2018,10,22,17,4832,6183,4815,-1368
2018,10,22,18,5095,6604,5130,-1474
2018,10,22,19,5329,6946,5368,-1578
2018,10,22,20,5539,7209,5591,-1618
2018,10,22,21,5641,7383,5719,-1664
2018,10,22,22,5583,7399,5715,-1684
2018,10,22,23,5401,7143,5504,-1639
2018,10,23,0,5338,7128,5480,-1648
2018,10,23,1,5112,6739,5196,-1543
2018,10,23,2,4700,6186,4774,-1412
2018,10,23,3,4233,5473,4348,-1125
2018,10,23,4,3780,4851,3869,-982
2018,10,23,5,3468,4357,3478,-879
2018,10,23,6,3201,4006,3176,-830
2018,10,23,7,3059,3837,3046,-791
2018,10,23,8,2974,3737,2967,-770
2018,10,23,9,2991,3741,2964,-777
2018,10,23,10,3215,4029,3169,-860
2018,10,23,11,3645,4572,3667,-905
2018,10,23,12,3868,4885,4024,-861
2018,10,23,13,3974,5026,4072,-954
2018,10,23,14,4235,5335,4050,-1285
2018,10,23,15,4533,5710,4400,-1310
2018,10,23,16,4782,6142,4762,-1380
2018,10,23,17,4994,6634,5165,-1469
2018,10,23,18,5259,7069,5512,-1557
2018,10,23,19,5452,7341,5729,-1612
2018,10,23,20,5626,7464,5826,-1638
2018,10,23,21,5734,7405,5780,-1625
2018,10,23,22,5632,7255,5648,-1607
2018,10,23,23,5504,7124,5517,-1607
2018,10,24,0,5463,7152,5519,-1633
2018,10,24,1,5249,6809,5239,-1570
2018,10,24,2,4863,6328,4930,-1398
2018,10,24,3,4379,5704,4542,-1162
2018,10,24,4,3919,5094,4010,-1084
2018,10,24,5,3604,4657,3730,-927
2018,10,24,6,3344,4343,3470,-873
2018,10,24,7,3194,4135,3290,-845
2018,10,24,8,3107,4049,3228,-821
2018,10,24,9,3115,4070,3218,-852
2018,10,24,10,3359,4359,3447,-912
2018,10,24,11,3778,4927,3965,-962
2018,10,24,12,3990,5230,4336,-894
2018,10,24,13,4088,5277,4135,-1142
2018,10,24,14,4372,5541,4318,-1223
2018,10,24,15,4676,5875,4561,-1314
2018,10,24,16,4930,6323,4869,-1454
2018,10,24,17,5128,6787,5182,-1605
2018,10,24,18,5382,7201,5555,-1646
2018,10,24,19,5572,7588,5885,-1703
2018,10,24,20,5726,7848,6058,-1790
2018,10,24,21,5808,7960,6145,-1815
2018,10,24,22,5703,7835,6025,-1810
2018,10,24,23,5515,7462,5724,-1738
2018,10,25,0,5538,7363,5624,-1739
2018,10,25,1,5278,6932,5174,-1758
2018,10,25,2,4879,6348,4696,-1652
2018,10,25,3,4397,5641,4300,-1341
2018,10,25,4,3942,5003,3989,-1014
2018,10,25,5,3810,4505,3646,-859
2018,10,25,6,3521,4164,3352,-812
2018,10,25,7,3356,3934,3174,-760
2018,10,25,8,3272,3833,3091,-742
2018,10,25,9,3281,3878,3111,-767
2018,10,25,10,3506,4128,3289,-839
2018,10,25,11,3933,4689,3825,-864
2018,10,25,12,4210,5015,4145,-870
2018,10,25,13,4309,5178,4102,-1076
2018,10,25,14,4582,5527,4357,-1170
2018,10,25,15,4934,5952,4609,-1343
2018,10,25,16,5258,6376,4927,-1449
2018,10,25,17,5497,6746,5224,-1522
2018,10,25,18,5777,7037,5451,-1586
2018,10,25,19,5985,7285,5569,-1716
2018,10,25,20,6088,7453,5728,-1725
2018,10,25,21,6140,7477,5725,-1752
2018,10,25,22,6025,7408,5652,-1756
2018,10,25,23,5885,7216,5514,-1702
2018,10,26,0,5886,7239,5491,-1748
2018,10,26,1,5638,6960,5324,-1636
2018,10,26,2,5244,6461,4972,-1489
2018,10,26,3,4803,5874,4659,-1215
2018,10,26,4,4353,5258,4168,-1090
2018,10,26,5,4084,4787,3828,-959
2018,10,26,6,3813,4428,3502,-926
2018,10,26,7,3649,4245,3358,-887
2018,10,26,8,3562,4135,3282,-853
2018,10,26,9,3582,4172,3330,-842
2018,10,26,10,3768,4429,3483,-946
2018,10,26,11,4185,5007,3956,-1051
2018,10,26,12,4457,5365,4393,-972
2018,10,26,13,4641,5611,4541,-1070
2018,10,26,14,4968,6020,4830,-1190
2018,10,26,15,5456,6487,5068,-1419
2018,10,26,16,5879,6786,5311,-1475
2018,10,26,17,6071,6962,5433,-1529
2018,10,26,18,6380,7202,5662,-1540
2018,10,26,19,6532,7296,5715,-1581
2018,10,26,20,6561,7388,5751,-1637
2018,10,26,21,6468,7474,5797,-1677
2018,10,26,22,6181,7432,5773,-1659
2018,10,26,23,5849,7071,5506,-1565
2018,10,27,0,5804,6931,5495,-1436
2018,10,27,1,5446,6594,5274,-1320
2018,10,27,2,5071,6166,4949,-1217
2018,10,27,3,4704,5641,4681,-960
2018,10,27,4,4326,5116,4233,-883
2018,10,27,5,3867,4691,3930,-761
2018,10,27,6,3557,4299,3533,-766
2018,10,27,7,3363,4111,3313,-798
2018,10,27,8,3194,3967,3152,-815
2018,10,27,9,3144,3905,3114,-791
2018,10,27,10,3154,3926,3129,-797
2018,10,27,11,3270,4076,3289,-787
2018,10,27,12,3440,4295,3524,-771
2018,10,27,13,3759,4656,3743,-913
2018,10,27,14,4123,5111,4113,-998
2018,10,27,15,4383,5451,4337,-1114
2018,10,27,16,4590,5630,4524,-1106
2018,10,27,17,4777,5767,4663,-1104
2018,10,27,18,4864,5815,4704,-1111
2018,10,27,19,4926,5778,4687,-1091
2018,10,27,20,4887,5732,4560,-1172
2018,10,27,21,4815,5709,4464,-1245
2018,10,27,22,4642,5599,4359,-1240
2018,10,27,23,4423,5414,4193,-1221
2018,10,28,0,4482,5496,4255,-1241
2018,10,28,1,4255,5292,4077,-1215
2018,10,28,2,3961,5027,3843,-1184
2018,10,28,3,3659,4663,3664,-999
2018,10,28,4,3366,4248,3425,-823
2018,10,28,5,3075,3893,3167,-726
2018,10,28,6,2826,3652,2904,-748
2018,10,28,7,2668,3476,2757,-719
2018,10,28,8,2609,3397,2691,-706
2018,10,28,9,2610,3356,2654,-702
2018,10,28,10,2663,3405,2676,-729
2018,10,28,11,2784,3607,2856,-751
2018,10,28,12,2970,3815,3083,-732
2018,10,28,13,3280,4225,3314,-911
2018,10,28,14,3601,4615,3609,-1006
2018,10,28,15,3762,4841,3722,-1119
2018,10,28,16,3883,4957,3808,-1149
2018,10,28,17,3966,5054,3943,-1111
2018,10,28,18,4110,5144,3992,-1152
2018,10,28,19,4296,5310,4128,-1182
2018,10,28,20,4477,5477,4253,-1224
2018,10,28,21,4647,5630,4366,-1264
2018,10,28,22,4678,5656,4384,-1272
2018,10,28,23,4472,5544,4146,-1398
2018,10,29,0,4686,5666,4199,-1467
2018,10,29,1,4435,5471,4040,-1431
2018,10,29,2,4071,5025,3825,-1200
2018,10,29,3,3647,4530,3562,-968
2018,10,29,4,3246,4032,3245,-787
2018,10,29,5,2843,3645,2898,-747
2018,10,29,6,2647,3427,2693,-734
2018,10,29,7,2535,3297,2643,-654
2018,10,29,8,2524,3267,2603,-664
2018,10,29,9,2590,3363,2631,-732
2018,10,29,10,2866,3696,2866,-830
2018,10,29,11,3292,4319,3403,-916
2018,10,29,12,3606,4675,3750,-925
2018,10,29,13,3673,4773,3714,-1059
2018,10,29,14,3763,4948,3768,-1180
2018,10,29,15,4003,5121,3880,-1241
2018,10,29,16,4176,5349,4025,-1324
2018,10,29,17,4450,5614,4223,-1391
2018,10,29,18,4782,5886,4390,-1496
2018,10,29,19,5107,6218,4569,-1649
2018,10,29,20,5380,6554,4894,-1660
2018,10,29,21,5553,6848,5084,-1764
2018,10,29,22,5587,6977,5133,-1844
2018,10,29,23,5535,6750,4935,-1815
2018,10,30,0,5407,6779,4956,-1823
2018,10,30,1,5165,6242,4665,-1577
2018,10,30,2,4707,5732,4265,-1467
2018,10,30,3,4217,5147,3905,-1242
2018,10,30,4,3755,4519,3429,-1090
2018,10,30,5,3310,4081,3156,-925
2018,10,30,6,3072,3761,2941,-820
2018,10,30,7,2938,3595,2825,-770
2018,10,30,8,2868,3540,2799,-741
2018,10,30,9,2889,3612,2830,-782
2018,10,30,10,3113,3893,3045,-848
2018,10,30,11,3537,4480,3529,-951
2018,10,30,12,3784,4767,3810,-957
2018,10,30,13,3865,4861,3758,-1103
2018,10,30,14,4119,5109,3905,-1204
2018,10,30,15,4433,5395,4124,-1271
2018,10,30,16,4676,5692,4382,-1309
2018,10,30,17,4989,6030,4597,-1433
2018,10,30,18,5273,6358,4833,-1525
2018,10,30,19,5512,6669,5163,-1506
2018,10,30,20,5687,7034,5456,-1578
2018,10,30,21,5772,7174,5651,-1523
2018,10,30,22,5709,7129,5627,-1502
2018,10,30,23,5545,6765,5458,-1307
2018,10,31,0,5424,6646,5305,-1341
2018,10,31,1,5183,6238,4890,-1348
2018,10,31,2,4733,5684,4360,-1324
2018,10,31,3,4228,5055,3848,-1207
2018,10,31,4,3750,4475,3402,-1073
2018,10,31,5,3325,4036,3156,-880
2018,10,31,6,3048,3750,2943,-807
2018,10,31,7,2890,3591,2799,-792
2018,10,31,8,2819,3531,2739,-792
2018,10,31,9,2838,3588,2778,-810
2018,10,31,10,3040,3908,3019,-889
2018,10,31,11,3500,4488,3549,-939
2018,10,31,12,3702,4792,3850,-942
2018,10,31,13,3760,4892,3759,-1133
2018,10,31,14,4009,5133,3906,-1227
2018,10,31,15,4318,5446,4193,-1253
2018,10,31,16,4594,5741,4429,-1312
2018,10,31,17,4974,6085,4716,-1369
2018,10,31,18,5326,6425,4995,-1430
2018,10,31,19,5647,6863,5148,-1715
2018,10,31,20,5931,7212,5277,-1935
2018,10,31,21,6072,7454,5469,-1985
2018,10,31,22,6005,7308,5376,-1932
2018,10,31,23,5669,6759,5056,-1703
2018,11,1,0,5517,6409,4873,-1536
2018,11,1,1,5210,6158,4697,-1461
2018,11,1,2,4888,5869,4444,-1425
2018,11,1,3,4438,5305,3994,-1311
2018,11,1,4,3942,4666,3507,-1159
2018,11,1,5,3474,4183,3251,-932
2018,11,1,6,3215,3900,3035,-865
2018,11,1,7,3038,3708,2896,-812
2018,11,1,8,2968,3602,2776,-826
2018,11,1,9,3016,3664,2824,-840
2018,11,1,10,3246,3957,3047,-910
2018,11,1,11,3691,4511,3482,-1029
2018,11,1,12,3958,4782,3777,-1005
2018,11,1,13,4084,4916,3745,-1171
2018,11,1,14,4352,5206,3963,-1243
2018,11,1,15,4739,5505,4209,-1296
2018,11,1,16,5111,5909,4546,-1363
2018,11,1,17,5460,6292,4839,-1453
2018,11,1,18,5802,6621,5048,-1573
2018,11,1,19,6030,6902,5292,-1610
2018,11,1,20,6283,7189,5642,-1547
2018,11,1,21,6420,7349,5797,-1552
2018,11,1,22,6392,7343,5794,-1549
2018,11,1,23,6285,7203,5577,-1626
2018,11,2,0,6083,7246,5553,-1693
2018,11,2,1,5697,6909,5311,-1598
2018,11,2,2,5232,6400,4882,-1518
2018,11,2,3,4720,5771,4395,-1376
2018,11,2,4,4250,5159,3938,-1221
2018,11,2,5,3803,4692,3709,-983
2018,11,2,6,3531,4330,3424,-906
2018,11,2,7,3369,4104,3228,-876
2018,11,2,8,3291,3973,3091,-882
2018,11,2,9,3318,3983,3087,-896
2018,11,2,10,3521,4250,3298,-952
2018,11,2,11,3945,4812,3728,-1084
2018,11,2,12,4224,5169,4077,-1092
2018,11,2,13,4404,5371,4118,-1253
2018,11,2,14,4772,5751,4325,-1426
2018,11,2,15,5181,6140,4641,-1499
2018,11,2,16,5481,6508,5013,-1495
2018,11,2,17,5724,6799,5308,-1491
2018,11,2,18,5967,7003,5531,-1472
2018,11,2,19,6113,7004,5525,-1479
2018,11,2,20,6139,6703,5386,-1317
2018,11,2,21,5989,6480,5233,-1247
2018,11,2,22,5707,6122,4873,-1249
2018,11,2,23,5421,5989,4614,-1375
2018,11,3,0,5264,5949,4576,-1373
2018,11,3,1,4924,5713,4384,-1329
2018,11,3,2,4555,5414,4150,-1264
2018,11,3,3,4160,5032,3844,-1188
2018,11,3,4,3800,4601,3469,-1132
2018,11,3,5,3583,4233,3313,-920
2018,11,3,6,3330,3915,3077,-838
2018,11,3,7,3141,3681,2875,-806
2018,11,3,8,3025,3552,2758,-794
2018,11,3,9,2935,3518,2729,-789
2018,11,3,10,2951,3580,2739,-841
2018,11,3,11,3056,3759,2848,-911
2018,11,3,12,3224,4053,3134,-919
2018,11,3,13,3541,4394,3256,-1138
2018,11,3,14,3891,4741,3467,-1274
2018,11,3,15,4089,4925,3619,-1306
2018,11,3,16,4160,4979,3673,-1306
2018,11,3,17,4161,5031,3772,-1259
2018,11,3,18,4203,5081,3822,-1259
2018,11,3,19,4297,5137,3866,-1271
2018,11,3,20,4345,5232,3955,-1277
2018,11,3,21,4288,5290,4022,-1268
2018,11,3,22,4325,5235,3972,-1263
2018,11,3,23,4381,5147,3888,-1259
2018,11,4,0,4370,5255,3950,-1305
2018,11,4,1,4236,5022,3821,-1201
2018,11,4,2,3997,4762,3557,-1205
2018,11,4,3,3693,4465,3313,-1152
2018,11,4,4,3417,4107,3042,-1065
2018,11,4,5,3014,3787,2884,-903
2018,11,4,6,2753,3543,2701,-842
2018,11,4,7,2667,3418,2585,-833
2018,11,4,8,2598,3346,2532,-814
2018,11,4,9,2589,3345,2519,-826
2018,11,4,10,2632,3393,2556,-837
2018,11,4,11,2803,3500,2631,-869
2018,11,4,12,3027,3805,2845,-960
2018,11,4,13,3492,4218,3202,-1016
2018,11,4,14,3974,4732,3500,-1232
2018,11,4,15,4319,5186,3829,-1357
2018,11,4,16,4607,5466,4061,-1405
2018,11,4,17,4827,5707,4389,-1318
2018,11,4,18,4998,5964,4674,-1290
2018,11,4,19,5123,6194,4754,-1440
2018,11,4,20,5066,6379,5051,-1328
2018,11,4,21,5017,6457,5082,-1375
2018,11,4,22,5085,6407,5042,-1365
2018,11,4,23,5142,6498,5068,-1430
2018,11,5,0,4974,6607,5154,-1453
2018,11,5,1,4739,6353,4955,-1398
2018,11,5,2,4392,6023,4660,-1363
2018,11,5,3,4040,5562,4232,-1330
2018,11,5,4,3722,5052,3826,-1226
2018,11,5,5,-9999,4588,3473,-1115
2018,11,5,6,3269,4213,3259,-954
2018,11,5,7,3080,3952,3056,-896
2018,11,5,8,2981,3791,2927,-864
2018,11,5,9,2946,3766,2907,-859
2018,11,5,10,3024,3857,2962,-895
2018,11,5,11,3323,4262,3288,-974
2018,11,5,12,3848,4912,3792,-1120
2018,11,5,13,4124,5308,4206,-1102
2018,11,5,14,4432,5672,4361,-1311
2018,11,5,15,4848,6105,4636,-1469
2018,11,5,16,5256,6592,5136,-1456
2018,11,5,17,5542,7020,5436,-1584
2018,11,5,18,5795,7352,5660,-1692
2018,11,5,19,6014,7449,5540,-1909
2018,11,5,20,6045,7380,5459,-1921
2018,11,5,21,5984,7269,5352,-1917
2018,11,5,22,5945,7174,5244,-1930
2018,11,5,23,5909,7246,5416,-1830
2018,11,6,0,5845,7405,5540,-1865
2018,11,6,1,5564,7085,5389,-1696
2018,11,6,2,5218,6687,5020,-1667
2018,11,6,3,4798,6162,4627,-1535
2018,11,6,4,4365,5551,4167,-1384
2018,11,6,5,3971,4992,3876,-1116
2018,11,6,6,3669,4566,3719,-847
2018,11,6,7,3406,4286,3490,-796
2018,11,6,8,3263,4129,3316,-813
2018,11,6,9,3201,4019,3250,-769
2018,11,6,10,3245,4074,3280,-794
2018,11,6,11,3539,4373,3541,-832
2018,11,6,12,3994,4976,4076,-900
2018,11,6,13,4265,5267,4320,-947
2018,11,6,14,4598,5551,4382,-1169
2018,11,6,15,4998,6068,4695,-1373
2018,11,6,16,5410,6475,5000,-1475
2018,11,6,17,5735,6847,5262,-1585
2018,11,6,18,6086,7628,5916,-1712
2018,11,6,19,6353,8019,6212,-1807
2018,11,6,20,6386,8250,6357,-1893
2018,11,6,21,6380,8180,6232,-1948
2018,11,6,22,6261,8042,6318,-1724
2018,11,6,23,6110,7778,6099,-1679
2018,11,7,0,6047,7759,6172,-1587
2018,11,7,1,5751,7384,5859,-1525
2018,11,7,2,5422,6904,5483,-1421
2018,11,7,3,4989,6331,4912,-1419
2018,11,7,4,4539,5686,4361,-1325
2018,11,7,5,4085,5072,3876,-1196
2018,11,7,6,3703,4599,3742,-857
2018,11,7,7,3439,4267,3430,-837
2018,11,7,8,3295,4054,3232,-822
2018,11,7,9,3219,3956,3155,-801
2018,11,7,10,3218,3965,3160,-805
2018,11,7,11,3492,4294,3466,-828
2018,11,7,12,3955,4889,3965,-924
2018,11,7,13,4238,5232,4241,-991
2018,11,7,14,4534,5642,4379,-1263
2018,11,7,15,4961,6197,4622,-1575
2018,11,7,16,5373,6806,4904,-1902
2018,11,7,17,5755,7449,5484,-1965
2018,11,7,18,6095,7975,5935,-2040
2018,11,7,19,6314,8375,6213,-2162
2018,11,7,20,6402,8634,6358,-2276
2018,11,7,21,6362,8639,6467,-2172
2018,11,7,22,6229,8477,6486,-1991
2018,11,7,23,6103,8173,6323,-1850
2018,11,8,0,6201,8086,6221,-1865
2018,11,8,1,5899,7622,5849,-1773
2018,11,8,2,5526,7136,5424,-1712
2018,11,8,3,5100,6545,4898,-1647
2018,11,8,4,4647,5897,4442,-1455
2018,11,8,5,4184,5260,3970,-1290
2018,11,8,6,3826,4755,3691,-1064
2018,11,8,7,3548,4427,3509,-918
2018,11,8,8,3405,4224,3344,-880
2018,11,8,9,3298,4106,3237,-869
2018,11,8,10,3299,4135,3254,-881
2018,11,8,11,3569,4461,3477,-984
2018,11,8,12,4066,5044,4023,-1021
2018,11,8,13,4315,5394,4290,-1104
2018,11,8,14,4588,5812,4436,-1376
2018,11,8,15,5020,6395,4770,-1625
2018,11,8,16,5418,7008,5190,-1818
2018,11,8,17,5786,7595,5628,-1967
2018,11,8,18,6122,8090,6076,-2014
2018,11,8,19,6273,8455,6383,-2072
2018,11,8,20,6370,8626,6579,-2047
2018,11,8,21,6340,8584,6605,-1979
2018,11,8,22,6241,8266,6221,-2045
2018,11,8,23,6085,8009,6004,-2005
2018,11,9,0,6093,7956,5849,-2107
2018,11,9,1,5822,7263,5297,-1966
2018,11,9,2,5458,7090,5231,-1859
2018,11,9,3,5068,6486,4869,-1617
2018,11,9,4,4580,5864,4371,-1493
2018,11,9,5,4138,5236,3899,-1337
2018,11,9,6,3855,4731,3629,-1102
2018,11,9,7,3572,4417,3362,-1055
2018,11,9,8,3381,4193,3158,-1035
2018,11,9,9,3296,4064,3062,-1002
2018,11,9,10,3290,4092,3073,-1019
2018,11,9,11,3539,4386,3294,-1092
2018,11,9,12,3984,4940,3715,-1225
2018,11,9,13,4251,5302,4095,-1207
2018,11,9,14,4589,5808,4315,-1493
2018,11,9,15,5119,6388,4631,-1757
2018,11,9,16,5554,7013,5055,-1958
2018,11,9,17,6015,7614,5645,-1969
2018,11,9,18,6306,8097,6183,-1914
2018,11,9,19,6598,8435,6407,-2028
2018,11,9,20,6740,8663,6616,-2047
2018,11,9,21,6720,8622,6568,-2054
2018,11,9,22,6566,8360,6342,-2018
2018,11,9,23,6350,7994,5942,-2052
2018,11,10,0,6086,7766,5709,-2057
2018,11,10,1,5740,7321,5288,-2033
2018,11,10,2,5305,6922,4938,-1984
2018,11,10,3,4937,6478,4476,-2002
2018,11,10,4,4541,5958,4087,-1871
2018,11,10,5,4094,5384,3654,-1730
2018,11,10,6,3804,4923,3502,-1421
2018,11,10,7,3482,4602,3386,-1216
2018,11,10,8,3297,4358,3254,-1104
2018,11,10,9,3172,4220,3147,-1073
2018,11,10,10,3119,4165,3090,-1075
2018,11,10,11,3192,4213,3114,-1099
2018,11,10,12,3330,4391,3247,-1144
2018,11,10,13,3514,4795,3607,-1188
2018,11,10,14,3882,8344,6819,-1525
2018,11,10,15,4268,5879,4136,-1743
2018,11,10,16,4557,6181,4297,-1884
2018,11,10,17,4820,6529,4555,-1974
2018,11,10,18,5037,6842,4889,-1953
2018,11,10,19,5091,7080,5098,-1982
2018,11,10,20,5173,7188,5217,-1971
2018,11,10,21,5085,7164,5200,-1964
2018,11,10,22,4948,6943,4981,-1962
2018,11,10,23,4844,6734,4698,-2036
2018,11,11,0,4879,6682,4641,-2041
2018,11,11,1,4681,6305,4397,-1908
2018,11,11,2,4397,5942,4200,-1742
2018,11,11,3,4104,5570,4049,-1521
2018,11,11,4,3781,5113,3678,-1435
2018,11,11,5,3470,4653,3350,-1303
2018,11,11,6,3130,4278,3209,-1069
2018,11,11,7,2909,3974,2949,-1025
2018,11,11,8,2778,3770,2784,-986
2018,11,11,9,2752,3652,2671,-981
2018,11,11,10,2700,3582,2606,-976
2018,11,11,11,2676,3629,2631,-998
2018,11,11,12,2771,3823,2770,-1053
2018,11,11,13,2899,4182,3053,-1129
2018,11,11,14,3422,4758,3420,-1338
2018,11,11,15,3910,5332,3854,-1478
2018,11,11,16,4235,5753,4118,-1635
2018,11,11,17,4544,6212,4408,-1804
2018,11,11,18,4766,6654,4756,-1898
2018,11,11,19,4981,6956,4918,-2038
2018,11,11,20,5072,7119,5048,-2071
2018,11,11,21,5028,7167,5085,-2082
2018,11,11,22,4996,7053,5018,-2035
2018,11,11,23,4925,6985,4924,-2061
2018,11,12,0,5065,7039,4951,-2088
2018,11,12,1,4826,6723,4866,-1857
2018,11,12,2,4623,6349,4687,-1662
2018,11,12,3,4269,5892,4469,-1423
2018,11,12,4,3953,5328,4006,-1322
2018,11,12,5,3721,4817,3568,-1249
2018,11,12,6,3441,4412,3319,-1093
2018,11,12,7,3211,4094,3059,-1035
2018,11,12,8,3082,3913,2912,-1001
2018,11,12,9,3027,3825,2837,-988
2018,11,12,10,3065,3868,2873,-995
2018,11,12,11,3292,4141,3080,-1061
2018,11,12,12,3683,4651,3499,-1152
2018,11,12,13,3968,4992,3739,-1253
2018,11,12,14,4291,5478,3965,-1513
2018,11,12,15,4668,6136,4301,-1835
2018,11,12,16,5062,6719,4724,-1995
2018,11,12,17,5467,7155,5026,-2129
2018,11,12,18,5714,7458,5224,-2234
2018,11,12,19,5915,7696,5513,-2183
2018,11,12,20,6010,7959,5710,-2249
2018,11,12,21,5997,8132,5822,-2310
2018,11,12,22,5936,8069,5799,-2270
2018,11,12,23,5942,7923,5747,-2176
2018,11,13,0,5948,7920,5707,-2213
2018,11,13,1,5633,7518,5355,-2163
2018,11,13,2,5338,7091,5084,-2007
2018,11,13,3,4956,6541,4595,-1946
2018,11,13,4,4520,5919,4087,-1832
2018,11,13,5,4030,5308,3687,-1621
2018,11,13,6,3808,4827,3597,-1230
2018,11,13,7,3557,4483,3391,-1092
2018,11,13,8,3382,4275,3234,-1041
2018,11,13,9,3305,4160,3136,-1024
2018,11,13,10,3329,4188,3170,-1018
2018,11,13,11,3593,4494,3394,-1100
2018,11,13,12,4053,5038,3849,-1189
2018,11,13,13,4328,5372,4115,-1257
2018,11,13,14,4565,5713,4091,-1622
2018,11,13,15,4895,6229,4261,-1968
2018,11,13,16,5285,6823,4722,-2101
2018,11,13,17,5691,7396,5221,-2175
2018,11,13,18,6093,7820,5499,-2321
2018,11,13,19,6365,8157,5815,-2342
2018,11,13,20,6523,8237,5847,-2390
2018,11,13,21,6547,8157,5752,-2405
2018,11,13,22,6488,7938,5520,-2418
2018,11,13,23,6422,7884,5491,-2393
2018,11,14,0,6343,7934,5637,-2297
2018,11,14,1,6021,7637,5479,-2158
2018,11,14,2,5642,7183,5111,-2072
2018,11,14,3,5164,6611,4615,-1996
2018,11,14,4,4651,5937,4097,-1840
2018,11,14,5,4172,5320,3682,-1638
2018,11,14,6,3800,4855,3564,-1291
2018,11,14,7,3495,4534,3402,-1132
2018,11,14,8,3339,4320,3251,-1069
2018,11,14,9,3262,4220,3165,-1055
2018,11,14,10,3260,4239,3194,-1045
2018,11,14,11,3512,4542,3409,-1133
2018,11,14,12,3954,5089,3863,-1226
2018,11,14,13,4197,5385,4119,-1266
2018,11,14,14,4407,5652,4208,-1444
2018,11,14,15,4638,6068,4492,-1576
2018,11,14,16,4939,6494,4712,-1782
2018,11,14,17,5331,7007,5155,-1852
2018,11,14,18,5633,7520,5620,-1900
2018,11,14,19,5876,7890,5953,-1937
2018,11,14,20,6009,8009,6093,-1916
2018,11,14,21,5980,7987,6011,-1976
2018,11,14,22,5890,7775,5679,-2096
2018,11,14,23,5790,7657,5467,-2190
2018,11,15,0,5764,7632,5449,-2183
2018,11,15,1,5525,7299,5133,-2166
2018,11,15,2,5216,6926,4853,-2073
2018,11,15,3,4804,6480,4585,-1895
2018,11,15,4,4343,5907,4276,-1631
2018,11,15,5,3869,5293,3829,-1464
2018,11,15,6,3500,4834,3643,-1191
2018,11,15,7,3222,4495,3448,-1047
2018,11,15,8,3067,4278,3397,-881
2018,11,15,9,2997,4126,3316,-810
2018,11,15,10,3007,4120,3302,-818
2018,11,15,11,3292,4312,3434,-878
2018,11,15,12,3729,4729,3644,-1085
2018,11,15,13,3943,4920,3775,-1145
2018,11,15,14,4095,5102,3941,-1161
2018,11,15,15,4218,5268,3990,-1278
2018,11,15,16,4386,5503,4380,-1123
2018,11,15,17,4499,5594,4510,-1084
2018,11,15,18,4611,5614,4543,-1071
2018,11,15,19,4660,5494,4315,-1179
2018,11,15,20,4658,5378,4330,-1048
2018,11,15,21,4606,5306,4155,-1151
2018,11,15,22,4534,5332,4091,-1241
2018,11,15,23,4644,5518,4079,-1439
2018,11,16,0,4714,5774,4322,-1452
2018,11,16,1,4529,5671,4251,-1420
2018,11,16,2,4342,5485,4135,-1350
2018,11,16,3,4015,5119,3859,-1260
2018,11,16,4,3635,4664,3482,-1182
2018,11,16,5,3352,4225,3098,-1127
2018,11,16,6,3330,3928,2832,-1096
2018,11,16,7,3255,3749,2691,-1058
2018,11,16,8,3276,3682,2590,-1092
2018,11,16,9,3343,3686,2568,-1118
2018,11,16,10,3529,3817,2581,-1236
2018,11,16,11,3929,4260,2742,-1518
2018,11,16,12,4648,5004,3239,-1765
2018,11,16,13,5061,5417,3696,-1721
2018,11,16,14,5014,5499,3827,-1672
2018,11,16,15,4845,5476,3854,-1622
2018,11,16,16,4581,5372,3793,-1579
2018,11,16,17,4437,5227,3641,-1586
2018,11,16,18,4323,5103,3464,-1639
2018,11,16,19,4275,5031,3442,-1589
2018,11,16,20,4130,5008,3462,-1546
2018,11,16,21,4127,5011,3445,-1566
2018,11,16,22,4146,5063,3493,-1570
2018,11,16,23,4376,5285,3613,-1672
2018,11,17,0,4562,5558,3833,-1725
2018,11,17,1,4516,5516,3801,-1715
2018,11,17,2,4439,5388,3682,-1706
2018,11,17,3,4414,5220,3560,-1660
2018,11,17,4,4293,4919,3315,-1604
2018,11,17,5,3976,4625,3171,-1454
2018,11,17,6,3535,4361,2875,-1486
2018,11,17,7,3440,4230,2753,-1477
2018,11,17,8,3468,4177,2660,-1517
2018,11,17,9,3546,4197,2684,-1513
2018,11,17,10,3646,4305,2836,-1469
2018,11,17,11,3878,4546,3105,-1441
2018,11,17,12,4176,4929,3460,-1469
2018,11,17,13,4550,5406,3741,-1665
2018,11,17,14,4676,5616,3926,-1690
2018,11,17,15,4579,5517,3837,-1680
2018,11,17,16,4366,5332,3731,-1601
2018,11,17,17,4152,5126,3723,-1403
2018,11,17,18,4061,5036,3769,-1267
2018,11,17,19,4005,4957,3883,-1074
2018,11,17,20,3993,4958,3904,-1054
2018,11,17,21,3990,4977,3936,-1041
2018,11,17,22,3944,5000,3941,-1059
2018,11,17,23,4112,5144,4032,-1112
2018,11,18,0,4232,5341,4181,-1160
2018,11,18,1,4049,5181,4059,-1122
2018,11,18,2,3927,4997,3906,-1091
2018,11,18,3,3742,4786,3740,-1046
2018,11,18,4,3493,4494,3489,-1005
2018,11,18,5,3149,4159,3216,-943
2018,11,18,6,2946,3881,2960,-921
2018,11,18,7,2794,3723,2813,-910
2018,11,18,8,2771,3614,2725,-889
2018,11,18,9,2721,3563,2659,-904
2018,11,18,10,2784,3610,2684,-926
2018,11,18,11,2834,3730,2763,-967
2018,11,18,12,3012,3964,2922,-1042
2018,11,18,13,3242,4310,3208,-1102
2018,11,18,14,3611,4741,3587,-1154
2018,11,18,15,3834,4993,3859,-1134
2018,11,18,16,3984,5150,4039,-1111
2018,11,18,17,4016,5237,4127,-1110
2018,11,18,18,4081,5336,4190,-1146
2018,11,18,19,4150,5448,4121,-1327
2018,11,18,20,4149,5551,4164,-1387
2018,11,18,21,4182,5580,4209,-1371
2018,11,18,22,4191,5647,4262,-1385
2018,11,18,23,4347,5742,4356,-1386
2018,11,19,0,4540,5919,4449,-1470
2018,11,19,1,4381,5689,4292,-1397
2018,11,19,2,4141,5403,4070,-1333
2018,11,19,3,3851,5045,3979,-1066
2018,11,19,4,3498,4590,3623,-967
2018,11,19,5,3214,4124,3203,-921
2018,11,19,6,2885,3781,2942,-839
2018,11,19,7,2782,3529,2726,-803
2018,11,19,8,2643,3437,2621,-816
2018,11,19,9,2623,3414,2585,-829
2018,11,19,10,2694,3505,2657,-848
2018,11,19,11,2917,3792,2862,-930
2018,11,19,12,3333,4258,3223,-1035
2018,11,19,13,3558,4600,3576,-1024
2018,11,19,14,3842,4911,3855,-1056
2018,11,19,15,4107,5207,4121,-1086
2018,11,19,16,4329,5441,4193,-1248
2018,11,19,17,4531,5626,4198,-1428
2018,11,19,18,4647,5930,4276,-1654
2018,11,19,19,4758,6173,4512,-1661
2018,11,19,20,4844,6236,4570,-1666
2018,11,19,21,4835,6255,4561,-1694
2018,11,19,22,4748,6253,4555,-1698
2018,11,19,23,4750,6319,4593,-1726
2018,11,20,0,4977,6501,4711,-1790
2018,11,20,1,4824,6246,4510,-1736
2018,11,20,2,4546,5953,4287,-1666
2018,11,20,3,4172,5518,4099,-1419
2018,11,20,4,3747,5027,3852,-1175
2018,11,20,5,3352,4518,3558,-960
2018,11,20,6,3056,4095,3217,-878
2018,11,20,7,2830,3821,3018,-803
2018,11,20,8,2728,3655,2824,-831
2018,11,20,9,2687,3588,2754,-834
2018,11,20,10,2728,3631,2747,-884
2018,11,20,11,2962,3888,2964,-924
2018,11,20,12,3354,4307,3298,-1009
2018,11,20,13,3656,4614,3595,-1019
2018,11,20,14,3911,4967,3888,-1079
2018,11,20,15,4115,5361,4208,-1153
2018,11,20,16,4302,5595,4297,-1298
2018,11,20,17,4498,5740,4299,-1441
2018,11,20,18,4621,5860,4260,-1600
2018,11,20,19,4669,5997,4501,-1496
2018,11,20,20,4674,6130,4698,-1432
2018,11,20,21,4637,6058,4594,-1464
2018,11,20,22,4608,5949,4512,-1437
2018,11,20,23,4691,5968,4498,-1470
2018,11,21,0,4842,6109,4602,-1507
2018,11,21,1,4643,5873,4373,-1500
2018,11,21,2,4358,5556,4132,-1424
2018,11,21,3,4018,5206,3967,-1239
2018,11,21,4,3660,4746,3728,-1018
2018,11,21,5,3356,4242,3298,-944
2018,11,21,6,3016,3865,3002,-863
2018,11,21,7,2798,3639,2792,-847
2018,11,21,8,2693,3501,2666,-835
2018,11,21,9,2664,3459,2627,-832
2018,11,21,10,2715,3532,2666,-866
2018,11,21,11,2891,3781,2849,-932
2018,11,21,12,3272,4203,3178,-1025
2018,11,21,13,3559,4567,3541,-1026
2018,11,21,14,3841,4899,3775,-1124
2018,11,21,15,4056,5102,3828,-1274
2018,11,21,16,4245,5266,3787,-1479
2018,11,21,17,4360,5364,3769,-1595
2018,11,21,18,4497,5498,3882,-1616
2018,11,21,19,4593,5622,4000,-1622
2018,11,21,20,4661,5676,4088,-1588
2018,11,21,21,4641,5697,4217,-1480
2018,11,21,22,4626,5630,4102,-1528
2018,11,21,23,4682,5697,4114,-1583
2018,11,22,0,4773,5828,4274,-1554
2018,11,22,1,4525,5646,4211,-1435
2018,11,22,2,4277,5444,4100,-1344
2018,11,22,3,3979,5168,4015,-1153
2018,11,22,4,3642,4783,3705,-1078
2018,11,22,5,3300,4370,3326,-1044
2018,11,22,6,2989,4005,3070,-935
2018,11,22,7,2798,3765,2869,-896
2018,11,22,8,2703,3633,2741,-892
2018,11,22,9,2658,3587,2702,-885
2018,11,22,10,2667,3638,2719,-919
2018,11,22,11,2745,3791,2853,-938
2018,11,22,12,2936,4092,3055,-1037
2018,11,22,13,3239,4528,3432,-1096
2018,11,22,14,3671,5072,3941,-1131
2018,11,22,15,4058,5515,4444,-1071
2018,11,22,16,4311,5769,4695,-1074
2018,11,22,17,4527,5843,4795,-1048
2018,11,22,18,4583,5817,4754,-1063
2018,11,22,19,4501,5658,4586,-1072
2018,11,22,20,4361,5423,4351,-1072
2018,11,22,21,4194,5184,4129,-1055
2018,11,22,22,4034,4933,3926,-1007
2018,11,22,23,3913,4859,3840,-1019
2018,11,23,0,3875,4899,3852,-1047
2018,11,23,1,3714,4770,3741,-1029
2018,11,23,2,3577,4693,3671,-1022
2018,11,23,3,3450,4524,3537,-987
2018,11,23,4,3239,4237,3306,-931
2018,11,23,5,3061,3929,3024,-905
2018,11,23,6,2837,3681,2828,-853
2018,11,23,7,2665,3506,2668,-838
2018,11,23,8,2534,3405,2588,-817
2018,11,23,9,2495,3365,2555,-810
2018,11,23,10,2512,3393,2577,-816
2018,11,23,11,2618,3553,2684,-869
2018,11,23,12,2766,3796,2881,-915
2018,11,23,13,2993,4062,3169,-893
2018,11,23,14,3320,4466,3439,-1027
2018,11,23,15,3609,4859,3788,-1071
2018,11,23,16,3843,5080,3984,-1096
2018,11,23,17,3947,5255,4154,-1101
2018,11,23,18,4024,5424,4210,-1214
2018,11,23,19,4061,5568,4394,-1174
2018,11,23,20,4040,5692,4514,-1178
2018,11,23,21,4028,5752,4580,-1172
2018,11,23,22,4042,5693,4507,-1186
2018,11,23,23,4184,5662,4430,-1232
2018,11,24,0,4283,5745,4507,-1238
2018,11,24,1,4118,5496,4327,-1169
2018,11,24,2,3991,5256,4142,-1114
2018,11,24,3,3780,4983,3917,-1066
2018,11,24,4,3558,4612,3601,-1011
2018,11,24,5,3172,4249,3323,-926
2018,11,24,6,2952,3894,3048,-846
2018,11,24,7,2724,3650,2851,-799
2018,11,24,8,2590,3500,2730,-770
2018,11,24,9,2526,3442,2689,-753
2018,11,24,10,2508,3437,2675,-762
2018,11,24,11,2612,3506,2705,-801
2018,11,24,12,2769,3717,2861,-856
2018,11,24,13,2910,3999,3099,-900
2018,11,24,14,3387,4439,3442,-997
2018,11,24,15,3772,4992,3894,-1098
2018,11,24,16,4115,5436,4278,-1158
2018,11,24,17,4328,5787,4556,-1231
2018,11,24,18,4460,6114,4880,-1234
2018,11,24,19,4548,6316,5063,-1253
2018,11,24,20,4530,6334,5114,-1220
2018,11,24,21,4572,6197,5004,-1193
2018,11,24,22,4484,6102,4921,-1181
2018,11,24,23,4512,6132,4918,-1214
2018,11,25,0,4590,6164,4936,-1228
2018,11,25,1,4469,5902,4655,-1247
2018,11,25,2,4246,5623,4426,-1197
2018,11,25,3,3993,5304,4188,-1116
2018,11,25,4,3712,4882,3842,-1040
2018,11,25,5,3398,4442,3515,-927
2018,11,25,6,3112,4038,3191,-847
2018,11,25,7,2901,3755,2948,-807
2018,11,25,8,2780,3544,2777,-767
2018,11,25,9,2663,3425,2675,-750
2018,11,25,10,2657,3405,2647,-758
2018,11,25,11,2676,3473,2689,-784
2018,11,25,12,2787,3642,2804,-838
2018,11,25,13,2924,3915,3037,-878
2018,11,25,14,3346,4441,3430,-1011
2018,11,25,15,3808,4937,3822,-1115
2018,11,25,16,4155,5243,4095,-1148
2018,11,25,17,4383,5496,4327,-1169
2018,11,25,18,4593,5729,4528,-1201
2018,11,25,19,4744,5940,4769,-1171
2018,11,25,20,4865,6092,4915,-1177
2018,11,25,21,4876,6100,4936,-1164
2018,11,25,22,4805,5998,4866,-1132
2018,11,25,23,4778,6056,4902,-1154
2018,11,26,0,4931,6225,4997,-1228
2018,11,26,1,4800,5953,4714,-1239
2018,11,26,2,4517,5608,4464,-1144
2018,11,26,3,4175,5191,4073,-1118
2018,11,26,4,3784,4677,3675,-1002
2018,11,26,5,3429,4197,3291,-906
2018,11,26,6,3127,3811,2965,-846
2018,11,26,7,2909,3541,2731,-810
2018,11,26,8,2773,3441,2635,-806
2018,11,26,9,2739,3404,2609,-795
2018,11,26,10,2769,3516,2688,-828
2018,11,26,11,3042,3909,2988,-921
2018,11,26,12,3459,4513,3506,-1007
2018,11,26,13,3752,4835,3813,-1022
2018,11,26,14,3967,5128,4088,-1040
2018,11,26,15,4208,5482,4370,-1112
2018,11,26,16,4455,5851,4675,-1176
2018,11,26,17,4680,6170,4999,-1171
2018,11,26,18,4856,6468,5282,-1186
2018,11,26,19,4960,6598,5459,-1139
2018,11,26,20,4889,6620,5477,-1143
2018,11,26,21,4732,6508,5356,-1152
2018,11,26,22,4633,6353,5211,-1142
2018,11,26,23,4758,6457,5272,-1185
2018,11,27,0,4916,6548,5333,-1215
2018,11,27,1,4747,6272,5083,-1189
2018,11,27,2,4429,5899,4742,-1157
2018,11,27,3,4030,5454,4320,-1134
2018,11,27,4,3616,4919,3834,-1085
2018,11,27,5,3265,4357,3396,-961
2018,11,27,6,3004,3961,3130,-831
2018,11,27,7,2790,3734,2911,-823
2018,11,27,8,2638,3586,2785,-801
2018,11,27,9,2574,3563,2740,-823
2018,11,27,10,2645,3673,2797,-876
2018,11,27,11,2938,4066,3059,-1007
2018,11,27,12,3454,4753,3678,-1075
2018,11,27,13,3768,5094,3973,-1121
2018,11,27,14,3875,5261,4146,-1115
2018,11,27,15,4015,5296,4194,-1102
2018,11,27,16,4108,5277,4170,-1107
2018,11,27,17,4161,5201,4122,-1079
2018,11,27,18,4132,5129,4012,-1117
2018,11,27,19,4056,5085,3989,-1096
2018,11,27,20,4053,5041,3959,-1082
2018,11,27,21,4025,5087,3970,-1117
2018,11,27,22,4081,5224,4120,-1104
2018,11,27,23,4472,5700,4488,-1212
2018,11,28,0,4877,6229,4792,-1437
2018,11,28,1,4933,6265,4683,-1582
2018,11,28,2,4841,6144,4549,-1595
2018,11,28,3,4703,5883,4286,-1597
2018,11,28,4,4468,5438,3932,-1506
2018,11,28,5,4251,5073,3626,-1447
2018,11,28,6,4146,4863,3494,-1369
2018,11,28,7,4107,4787,3369,-1418
2018,11,28,8,4160,4838,3401,-1437
2018,11,28,9,4310,4938,3456,-1482
2018,11,28,10,4617,5223,3682,-1541
2018,11,28,11,5214,5883,4049,-1834
2018,11,28,12,5944,6835,4608,-2227
2018,11,28,13,6397,7280,5103,-2177
2018,11,28,14,6220,7167,5028,-2139
2018,11,28,15,5939,6842,4877,-1965
2018,11,28,16,5522,6248,4512,-1736
2018,11,28,17,5200,6209,4592,-1617
2018,11,28,18,4854,5979,4352,-1627
2018,11,28,19,4609,5733,4113,-1620
2018,11,28,20,4519,5613,4070,-1543
2018,11,28,21,4409,5583,4053,-1530
2018,11,28,22,4553,5835,4215,-1620
2018,11,28,23,4924,6517,4800,-1717
2018,11,29,0,5405,7113,5330,-1783
2018,11,29,1,5653,7197,5364,-1833
2018,11,29,2,5691,7127,5288,-1839
2018,11,29,3,5535,6828,5047,-1781
2018,11,29,4,5264,6367,4629,-1738
2018,11,29,5,4878,5888,4148,-1740
2018,11,29,6,4541,5608,3988,-1620
2018,11,29,7,4409,5465,3811,-1654
2018,11,29,8,4480,5425,3713,-1712
2018,11,29,9,4563,5494,3834,-1660
2018,11,29,10,4853,5753,4026,-1727
2018,11,29,11,5418,6302,4089,-2213
2018,11,29,12,6216,7141,4534,-2607
2018,11,29,13,6616,7501,4984,-2517
2018,11,29,14,6330,7327,4886,-2441
2018,11,29,15,5923,6966,4550,-2416
2018,11,29,16,5386,6520,4491,-2029
2018,11,29,17,4998,6108,4322,-1786
2018,11,29,18,4680,5826,4282,-1544
2018,11,29,19,4476,5525,4224,-1301
2018,11,29,20,4313,5358,4094,-1264
2018,11,29,21,4277,5370,4079,-1291
2018,11,29,22,4333,5577,4270,-1307
2018,11,29,23,4640,6132,4882,-1250
2018,11,30,0,4949,6635,5305,-1330
2018,11,30,1,4959,6691,5324,-1367
2018,11,30,2,4874,6551,5209,-1342
2018,11,30,3,4682,6233,4950,-1283
2018,11,30,4,4323,5752,4506,-1246
2018,11,30,5,3986,5293,4127,-1166
2018,11,30,6,3534,4950,3851,-1099
2018,11,30,7,3333,4842,3714,-1128
2018,11,30,8,3276,4795,3677,-1118
2018,11,30,9,3288,4867,3714,-1153
2018,11,30,10,3405,5074,3905,-1169
2018,11,30,11,3785,5543,4345,-1198
2018,11,30,12,4340,6292,5074,-1218
2018,11,30,13,4582,6523,5336,-1187
2018,11,30,14,4531,6260,5145,-1115
2018,11,30,15,4450,5848,4717,-1131
2018,11,30,16,4292,5530,4495,-1035
2018,11,30,17,4289,5318,4281,-1037
2018,11,30,18,4216,5224,4102,-1122
2018,11,30,19,4195,5152,4054,-1098
2018,11,30,20,4148,5115,4017,-1098
2018,11,30,21,4146,5099,3979,-1120
2018,11,30,22,4128,5210,4091,-1119
2018,11,30,23,4291,5458,4325,-1133
2018,12,1,0,4507,5632,4529,-1103
2018,12,1,1,4376,5222,4122,-1100
2018,12,1,2,4224,5217,4106,-1111
2018,12,1,3,4000,4958,3853,-1105
2018,12,1,4,3692,4607,3621,-986
2018,12,1,5,3220,4188,3285,-903
2018,12,1,6,2983,3818,2941,-877
2018,12,1,7,2767,3610,2798,-812
2018,12,1,8,2650,3477,2692,-785
2018,12,1,9,2602,3414,2649,-765
2018,12,1,10,2582,3459,2676,-783
2018,12,1,11,2862,3586,2746,-840
2018,12,1,12,3059,3858,2937,-921
2018,12,1,13,3279,4145,3196,-949
2018,12,1,14,3612,4585,3595,-990
2018,12,1,15,3925,4986,3949,-1037
2018,12,1,16,4150,5246,4126,-1120
2018,12,1,17,4339,5415,4258,-1157
2018,12,1,18,4461,5513,4182,-1331
2018,12,1,19,4541,5538,4197,-1341
2018,12,1,20,4577,5575,4282,-1293
2018,12,1,21,4636,5612,4315,-1297
2018,12,1,22,4607,5657,4345,-1312
2018,12,1,23,4714,5803,4448,-1355
2018,12,2,0,4847,5983,4578,-1405
2018,12,2,1,4687,5757,4401,-1356
2018,12,2,2,4496,5641,4322,-1319
2018,12,2,3,4275,5369,4202,-1167
2018,12,2,4,3971,5001,3896,-1105
2018,12,2,5,3775,4574,3608,-966
2018,12,2,6,3486,4180,3290,-890
2018,12,2,7,3251,3900,3037,-863
2018,12,2,8,3064,3700,2876,-824
2018,12,2,9,2952,3618,2815,-803
2018,12,2,10,2934,3607,2798,-809
2018,12,2,11,3009,3679,2851,-828
2018,12,2,12,3117,3877,2991,-886
2018,12,2,13,3369,4193,3262,-931
2018,12,2,14,3824,4823,3745,-1078
2018,12,2,15,4332,5435,4249,-1186
2018,12,2,16,4738,5959,4717,-1242
2018,12,2,17,4993,6388,5049,-1339
2018,12,2,18,5309,6705,5148,-1557
2018,12,2,19,5471,6887,5445,-1442
2018,12,2,20,5615,7036,5352,-1684
2018,12,2,21,5653,7021,5320,-1701
2018,12,2,22,5680,6929,5359,-1570
2018,12,2,23,5820,7055,5380,-1675
2018,12,3,0,5946,7224,5533,-1691
2018,12,3,1,5688,6970,5278,-1692
2018,12,3,2,5398,6637,5114,-1523
2018,12,3,3,5017,6170,4847,-1323
2018,12,3,4,4554,5604,4444,-1160
2018,12,3,5,4092,4988,3932,-1056
2018,12,3,6,3708,4510,3556,-954
2018,12,3,7,3439,4160,3264,-896
2018,12,3,8,3270,3949,3106,-843
2018,12,3,9,3211,3854,3019,-835
2018,12,3,10,3242,3915,3057,-858
2018,12,3,11,3461,4238,3296,-942
2018,12,3,12,3923,4850,3766,-1084
2018,12,3,13,4168,5207,4114,-1093
2018,12,3,14,4368,5544,4406,-1138
2018,12,3,15,4639,5947,4863,-1084
2018,12,3,16,4989,6403,5132,-1271
2018,12,3,17,5343,6802,5493,-1309
2018,12,3,18,5577,7043,5621,-1422
2018,12,3,19,5730,7172,5647,-1525
2018,12,3,20,5852,7141,5634,-1507
2018,12,3,21,5910,7116,5600,-1516
2018,12,3,22,5925,7037,5586,-1451
2018,12,3,23,5929,7064,5583,-1481
2018,12,4,0,5929,7280,5601,-1679
2018,12,4,1,5633,7070,5291,-1779
2018,12,4,2,5375,6706,4972,-1734
2018,12,4,3,4966,6238,4664,-1574
2018,12,4,4,4503,5626,4275,-1351
2018,12,4,5,3962,5027,3961,-1066
2018,12,4,6,3547,4535,3561,-974
2018,12,4,7,3272,4200,3240,-960
2018,12,4,8,3063,3974,3077,-897
2018,12,4,9,2997,3896,3016,-880
2018,12,4,10,3007,3939,3026,-913
2018,12,4,11,3301,4225,3260,-965
2018,12,4,12,3735,4814,3699,-1115
2018,12,4,13,3941,5094,3830,-1264
2018,12,4,14,4045,5205,3915,-1290
2018,12,4,15,4191,5281,3890,-1391
2018,12,4,16,4361,5393,3830,-1563
2018,12,4,17,4520,5481,3814,-1667
2018,12,4,18,4603,5654,3896,-1758
2018,12,4,19,4664,5770,4005,-1765
2018,12,4,20,4679,5892,4088,-1804
2018,12,4,21,4655,5869,4073,-1796
2018,12,4,22,4645,5769,3846,-1923
2018,12,4,23,4810,5999,3962,-2037
2018,12,5,0,4973,6214,4169,-2045
2018,12,5,1,4746,6031,4001,-2030
2018,12,5,2,4492,5730,3818,-1912
2018,12,5,3,4143,5347,3623,-1724
2018,12,5,4,3722,4810,3333,-1477
2018,12,5,5,3294,4303,3127,-1176
2018,12,5,6,3057,3943,3021,-922
2018,12,5,7,2886,3712,2834,-878
2018,12,5,8,2823,3637,2749,-888
2018,12,5,9,2831,3672,2791,-881
2018,12,5,10,2891,3822,2859,-963
2018,12,5,11,3237,4300,3387,-913
2018,12,5,12,3866,5102,4064,-1038
2018,12,5,13,4191,5604,4547,-1057
2018,12,5,14,4258,5717,4585,-1132
2018,12,5,15,4226,5669,4476,-1193
2018,12,5,16,4169,5570,4228,-1342
2018,12,5,17,4143,5442,4138,-1304
2018,12,5,18,4078,5315,4047,-1268
2018,12,5,19,4049,5218,3960,-1258
2018,12,5,20,4015,5164,3875,-1289
2018,12,5,21,4061,5171,3880,-1291
2018,12,5,22,4150,5333,3940,-1393
2018,12,5,23,4458,5836,4173,-1663
2018,12,6,0,4824,6420,4511,-1909
2018,12,6,1,4894,6545,4639,-1906
2018,12,6,2,4833,6543,4678,-1865
2018,12,6,3,4693,6384,4561,-1823
2018,12,6,4,4417,5992,4160,-1832
2018,12,6,5,4141,5624,3939,-1685
2018,12,6,6,4025,5404,3931,-1473
2018,12,6,7,3921,5373,3886,-1487
2018,12,6,8,3949,5425,3906,-1519
2018,12,6,9,4043,5589,4006,-1583
2018,12,6,10,4261,5899,4107,-1792
2018,12,6,11,4725,6548,4221,-2327
2018,12,6,12,5473,7482,4961,-2521
2018,12,6,13,5813,7873,5384,-2489
2018,12,6,14,5588,7560,5125,-2435
2018,12,6,15,5230,7091,4775,-2316
2018,12,6,16,4890,6362,4366,-1996
2018,12,6,17,4598,5839,3960,-1879
2018,12,6,18,4373,5534,3790,-1744
2018,12,6,19,4212,5299,3655,-1644
2018,12,6,20,4098,5170,3563,-1607
2018,12,6,21,4075,5148,3588,-1560
2018,12,6,22,4134,5275,3633,-1642
2018,12,6,23,4443,5674,3753,-1921
2018,12,7,0,4805,6167,4223,-1944
2018,12,7,1,4807,6200,4280,-1920
2018,12,7,2,4742,6131,4231,-1900
2018,12,7,3,4523,5891,4076,-1815
2018,12,7,4,4164,5497,3710,-1787
2018,12,7,5,3832,5047,3369,-1678
2018,12,7,6,3496,4918,3227,-1691
2018,12,7,7,3360,4811,3222,-1589
2018,12,7,8,3343,4754,3167,-1587
2018,12,7,9,3392,4811,3205,-1606
2018,12,7,10,3544,5009,3425,-1584
2018,12,7,11,3923,5501,3840,-1661
2018,12,7,12,4525,6313,4564,-1749
2018,12,7,13,4842,6630,4752,-1878
2018,12,7,14,4699,6414,4619,-1795
2018,12,7,15,4551,6048,4196,-1852
2018,12,7,16,4429,5752,4017,-1735
2018,12,7,17,4245,5550,3999,-1551
2018,12,7,18,4154,5432,4046,-1386
2018,12,7,19,4103,5377,4112,-1265
2018,12,7,20,4055,5361,4273,-1088
2018,12,7,21,4041,5365,4289,-1076
2018,12,7,22,4062,5426,4328,-1098
2018,12,7,23,4293,5646,4448,-1198
2018,12,8,0,4492,5879,4598,-1281
2018,12,8,1,4330,5761,4485,-1276
2018,12,8,2,4259,5585,4372,-1213
2018,12,8,3,4053,5339,4133,-1206
2018,12,8,4,3736,5012,3871,-1141
2018,12,8,5,3440,4613,3625,-988
2018,12,8,6,3119,4093,3137,-956
2018,12,8,7,2956,3910,2970,-940
2018,12,8,8,2859,3819,2899,-920
2018,12,8,9,2829,3797,2899,-898
2018,12,8,10,2878,3873,2936,-937
2018,12,8,11,2966,4041,3064,-977
2018,12,8,12,3143,4370,3293,-1077
2018,12,8,13,3449,4718,3661,-1057
2018,12,8,14,3670,5092,4046,-1046
2018,12,8,15,3869,5240,4265,-975
2018,12,8,16,3958,5249,4228,-1021
2018,12,8,17,3986,5275,4223,-1052
2018,12,8,18,3995,5283,4237,-1046
2018,12,8,19,4039,5292,4278,-1014
2018,12,8,20,4110,5310,4294,-1016
2018,12,8,21,4194,5382,4340,-1042
2018,12,8,22,4203,5426,4362,-1064
2018,12,8,23,4315,5527,4440,-1087
2018,12,9,0,4487,5711,4590,-1121
2018,12,9,1,4343,5521,4434,-1087
2018,12,9,2,4200,5516,4424,-1092
2018,12,9,3,4015,5084,4017,-1067
2018,12,9,4,3743,4722,3716,-1006
2018,12,9,5,3443,4307,3391,-916
2018,12,9,6,3140,3923,3104,-819
2018,12,9,7,2914,3664,2866,-798
2018,12,9,8,2760,3486,2719,-767
2018,12,9,9,2676,3426,2667,-759
2018,12,9,10,2648,3393,2635,-758
2018,12,9,11,2708,3493,2711,-782
2018,12,9,12,2866,3730,2898,-832
2018,12,9,13,3063,4051,3179,-872
2018,12,9,14,3448,4623,3605,-1018
2018,12,9,15,3843,5119,4017,-1102
2018,12,9,16,4035,5368,4205,-1163
2018,12,9,17,4137,5479,4317,-1162
2018,12,9,18,4152,5515,4345,-1170
2018,12,9,19,4184,5470,4368,-1102
2018,12,9,20,4112,5434,4369,-1065
2018,12,9,21,4045,5401,4368,-1033
2018,12,9,22,4052,5415,4364,-1051
2018,12,9,23,4219,5683,4616,-1067
2018,12,10,0,4435,5941,4828,-1113
2018,12,10,1,4338,5796,4699,-1097
2018,12,10,2,4189,5569,4530,-1039
2018,12,10,3,3858,6266,5270,-996
2018,12,10,4,3451,4867,3958,-909
2018,12,10,5,3217,4138,3234,-904
2018,12,10,6,2950,3780,2899,-881
2018,12,10,7,2717,3587,2733,-854
2018,12,10,8,2569,3512,2677,-835
2018,12,10,9,2593,3534,2686,-848
2018,12,10,10,2704,3687,2777,-910
2018,12,10,11,3046,4147,3167,-980
2018,12,10,12,3620,4887,3766,-1121
2018,12,10,13,3935,5315,4187,-1128
2018,12,10,14,4013,5491,4371,-1120
2018,12,10,15,4085,5599,4478,-1121
2018,12,10,16,4174,5680,4501,-1179
2018,12,10,17,4212,5714,4506,-1208
2018,12,10,18,4229,5677,4444,-1233
2018,12,10,19,4179,5597,4316,-1281
2018,12,10,20,4144,5532,4214,-1318
2018,12,10,21,4146,5589,4182,-1407
2018,12,10,22,4255,5846,4457,-1389
2018,12,10,23,4704,6462,4951,-1511
2018,12,11,0,5108,6994,5499,-1495
2018,12,11,1,5198,7049,5564,-1485
2018,12,11,2,5156,6911,5475,-1436
2018,12,11,3,4955,6619,5341,-1278
2018,12,11,4,4646,6112,4867,-1245
2018,12,11,5,4327,5586,4272,-1314
2018,12,11,6,4100,5351,4051,-1300
2018,12,11,7,4023,5227,3995,-1232
2018,12,11,8,3953,5199,3912,-1287
2018,12,11,9,4029,5274,3953,-1321
2018,12,11,10,4235,5510,4044,-1466
2018,12,11,11,4677,6008,4290,-1718
2018,12,11,12,5332,6895,5251,-1644
2018,12,11,13,5686,7254,5790,-1464
2018,12,11,14,5599,7119,5630,-1489
2018,12,11,15,5337,6928,5291,-1637
2018,12,11,16,5061,6677,5042,-1635
2018,12,11,17,4786,6370,4835,-1535
2018,12,11,18,4647,6091,4670,-1421
2018,12,11,19,4532,5785,4406,-1379
2018,12,11,20,4426,5566,4321,-1245
2018,12,11,21,4392,5487,4178,-1309
2018,12,11,22,4483,5733,4356,-1377
2018,12,11,23,4918,6428,4860,-1568
2018,12,12,0,5368,7218,5556,-1662
2018,12,12,1,5526,7490,5861,-1629
2018,12,12,2,5450,7495,5897,-1598
2018,12,12,3,5302,7317,5748,-1569
2018,12,12,4,5037,6937,5372,-1565
2018,12,12,5,4568,6516,4980,-1536
2018,12,12,6,4433,6273,4838,-1435
2018,12,12,7,4349,6190,4755,-1435
2018,12,12,8,4348,6255,4850,-1405
2018,12,12,9,4421,6424,4881,-1543
2018,12,12,10,4640,6743,4907,-1836
2018,12,12,11,5111,7448,5596,-1852
2018,12,12,12,5854,8461,6593,-1868
2018,12,12,13,6220,8859,6868,-1991
2018,12,12,14,5964,8417,6457,-1960
2018,12,12,15,5485,7636,5791,-1845
2018,12,12,16,5018,6892,5265,-1627
2018,12,12,17,4725,6335,4798,-1537
2018,12,12,18,4494,5881,4496,-1385
2018,12,12,19,4364,5542,4344,-1198
2018,12,12,20,4118,5361,4237,-1124
2018,12,12,21,4100,5344,4221,-1123
2018,12,12,22,4166,5521,4334,-1187
2018,12,12,23,4523,6091,4597,-1494
2018,12,13,0,4880,6642,5245,-1397
2018,12,13,1,4876,6666,5213,-1453
2018,12,13,2,4793,6550,5153,-1397
2018,12,13,3,4568,6264,4962,-1302
2018,12,13,4,4166,5798,4494,-1304
2018,12,13,5,3804,5297,4170,-1127
2018,12,13,6,3617,4911,3675,-1236
2018,12,13,7,3486,4711,3518,-1193
2018,12,13,8,3417,4621,3453,-1168
2018,12,13,9,3460,4596,3434,-1162
2018,12,13,10,3594,4694,3509,-1185
2018,12,13,11,3953,5104,3886,-1218
2018,12,13,12,4534,5772,4398,-1374
2018,12,13,13,4787,6039,4609,-1430
2018,12,13,14,4702,5903,4525,-1378
2018,12,13,15,4599,5733,4401,-1332
2018,12,13,16,4568,5566,4298,-1268
2018,12,13,17,4191,5449,4225,-1224
2018,12,13,18,4133,5311,4117,-1194
2018,12,13,19,4110,5207,4067,-1140
2018,12,13,20,4040,5165,4023,-1142
2018,12,13,21,4014,5179,4049,-1130
2018,12,13,22,4071,5276,4116,-1160
2018,12,13,23,4343,5703,4417,-1286
2018,12,14,0,4621,5944,4590,-1354
2018,12,14,1,4518,5925,4582,-1343
2018,12,14,2,4445,5779,4488,-1291
2018,12,14,3,4219,5398,4206,-1192
2018,12,14,4,3802,4918,3803,-1115
2018,12,14,5,3262,4321,3386,-935
2018,12,14,6,2897,3924,3047,-877
2018,12,14,7,2946,3715,2895,-820
2018,12,14,8,2811,3578,2785,-793
2018,12,14,9,2791,3522,2715,-807
2018,12,14,10,2875,3601,2765,-836
2018,12,14,11,3162,3932,3008,-924
2018,12,14,12,3618,4487,3426,-1061
2018,12,14,13,3869,4822,3747,-1075
2018,12,14,14,3966,5039,3929,-1110
2018,12,14,15,4068,5202,4054,-1148
2018,12,14,16,4146,5343,4143,-1200
2018,12,14,17,4236,5409,4193,-1216
2018,12,14,18,4226,5437,4166,-1271
2018,12,14,19,4185,5425,4228,-1197
2018,12,14,20,4126,5453,4258,-1195
2018,12,14,21,4133,5527,4314,-1213
2018,12,14,22,4154,5630,4362,-1268
2018,12,14,23,4390,5934,4585,-1349
2018,12,15,0,4615,5966,4638,-1328
2018,12,15,1,4498,5753,4472,-1281
2018,12,15,2,4318,5532,4310,-1222
2018,12,15,3,4082,5224,4081,-1143
2018,12,15,4,3727,4848,3806,-1042
2018,12,15,5,3334,4392,3444,-948
2018,12,15,6,3243,3954,3104,-850
2018,12,15,7,3013,3672,2874,-798
2018,12,15,8,2857,3528,2738,-790
2018,12,15,9,2796,3426,2662,-764
2018,12,15,10,2794,3437,2657,-780
2018,12,15,11,2938,3570,2727,-843
2018,12,15,12,3088,3832,2916,-916
2018,12,15,13,3274,4177,3197,-980
2018,12,15,14,3625,4670,3562,-1108
2018,12,15,15,3955,5064,3894,-1170
2018,12,15,16,4132,5288,4087,-1201
2018,12,15,17,4217,5311,4132,-1179
2018,12,15,18,4249,5276,4092,-1184
2018,12,15,19,4248,5218,3923,-1295
2018,12,15,20,4237,5161,3873,-1288
2018,12,15,21,4165,5137,3852,-1285
2018,12,15,22,4098,5169,3895,-1274
2018,12,15,23,4341,5149,3791,-1358
2018,12,16,0,4531,5523,4109,-1414
2018,12,16,1,4320,5365,3984,-1381
2018,12,16,2,4134,5240,4026,-1214
2018,12,16,3,3933,5015,3887,-1128
2018,12,16,4,3661,4715,3633,-1082
2018,12,16,5,3267,4314,3325,-989
2018,12,16,6,2998,3952,3063,-889
2018,12,16,7,2810,3697,2863,-834
2018,12,16,8,2697,3553,2741,-812
2018,12,16,9,2635,3499,2698,-801
2018,12,16,10,2680,3532,2713,-819
2018,12,16,11,2783,3639,2784,-855
2018,12,16,12,2966,3928,2997,-931
2018,12,16,13,3181,4198,3165,-1033
2018,12,16,14,3518,4665,3524,-1141
2018,12,16,15,3762,5012,3776,-1236
2018,12,16,16,3823,5160,3935,-1225
2018,12,16,17,3905,5171,3992,-1179
2018,12,16,18,3969,5165,3993,-1172
2018,12,16,19,4008,5120,3982,-1138
2018,12,16,20,3974,5091,3989,-1102
2018,12,16,21,3924,5081,3989,-1092
2018,12,16,22,3966,5135,4070,-1065
2018,12,16,23,4204,5405,4170,-1235
2018,12,17,0,4398,5784,4443,-1341
2018,12,17,1,4283,5729,4423,-1306
2018,12,17,2,4174,5575,4251,-1324
2018,12,17,3,3981,5277,4059,-1218
2018,12,17,4,3629,4857,3721,-1136
2018,12,17,5,3362,4416,3427,-989
2018,12,17,6,3078,4096,3137,-959
2018,12,17,7,2907,3936,2978,-958
2018,12,17,8,2895,3920,2959,-961
2018,12,17,9,2944,3964,2982,-982
2018,12,17,10,3083,4194,3152,-1042
2018,12,17,11,3551,4718,3534,-1184
2018,12,17,12,4172,5547,4160,-1387
2018,12,17,13,4576,5976,4525,-1451
2018,12,17,14,4521,5944,4514,-1430
2018,12,17,15,4313,5776,4425,-1351
2018,12,17,16,4291,5659,4375,-1284
2018,12,17,17,4240,5481,4260,-1221
2018,12,17,18,4065,5317,4137,-1180
2018,12,17,19,4011,5190,4039,-1151
2018,12,17,20,3990,5089,3990,-1099
2018,12,17,21,3984,5067,3957,-1110
2018,12,17,22,4057,5208,4068,-1140
2018,12,17,23,4334,5660,4374,-1286
2018,12,18,0,4627,6175,4752,-1423
2018,12,18,1,4627,6242,4798,-1444
2018,12,18,2,4505,6130,4694,-1436
2018,12,18,3,4345,5888,4490,-1398
2018,12,18,4,3988,5416,4122,-1294
2018,12,18,5,3676,4956,3786,-1170
2018,12,18,6,3497,4652,3549,-1103
2018,12,18,7,3368,4517,3422,-1095
2018,12,18,8,3361,4527,3412,-1115
2018,12,18,9,3418,4624,3458,-1166
2018,12,18,10,3613,4882,3659,-1223
2018,12,18,11,4018,5491,4171,-1320
2018,12,18,12,4702,6415,4974,-1441
2018,12,18,13,5010,6888,5405,-1483
2018,12,18,14,4907,6704,5259,-1445
2018,12,18,15,4579,6248,4856,-1392
2018,12,18,16,4428,5824,4542,-1282
2018,12,18,17,4259,5508,4297,-1211
2018,12,18,18,4089,5287,4144,-1143
2018,12,18,19,4020,5182,4082,-1100
2018,12,18,20,3973,5128,4069,-1059
2018,12,18,21,3927,5149,4071,-1078
2018,12,18,22,3995,5237,4154,-1083
2018,12,18,23,4253,5616,4372,-1244
2018,12,19,0,4549,6115,4727,-1388
2018,12,19,1,4554,6175,4776,-1399
2018,12,19,2,4464,6113,4718,-1395
2018,12,19,3,4256,5837,4494,-1343
2018,12,19,4,3919,5367,4093,-1274
2018,12,19,5,3561,4905,3768,-1137
2018,12,19,6,3303,4600,3528,-1072
2018,12,19,7,3174,4420,3379,-1041
2018,12,19,8,3134,4385,3331,-1054
2018,12,19,9,3203,4448,3382,-1066
2018,12,19,10,3340,4688,3553,-1135
2018,12,19,11,3724,5156,3716,-1440
2018,12,19,12,4346,5902,4323,-1579
2018,12,19,13,4663,6216,4597,-1619
2018,12,19,14,4588,6025,4477,-1548
2018,12,19,15,4359,5713,4432,-1281
2018,12,19,16,4295,5473,4268,-1205
2018,12,19,17,4188,5309,4091,-1218
2018,12,19,18,4090,5298,4038,-1260
2018,12,19,19,4050,5280,3958,-1322
2018,12,19,20,4006,5260,3947,-1313
2018,12,19,21,3989,5288,4037,-1251
2018,12,19,22,4035,5450,4150,-1300
2018,12,19,23,4333,5889,4597,-1292
2018,12,20,0,4573,7732,6478,-1254
2018,12,20,1,4480,6019,4801,-1218
2018,12,20,2,4368,5872,4712,-1160
2018,12,20,3,4174,5488,4338,-1150
2018,12,20,4,3824,4996,3956,-1040
2018,12,20,5,3400,4471,3486,-985
2018,12,20,6,2979,4092,3222,-870
2018,12,20,7,2808,3826,2911,-915
2018,12,20,8,2798,3703,2808,-895
2018,12,20,9,2772,3647,2804,-843
2018,12,20,10,2843,3742,2859,-883
2018,12,20,11,3106,4114,3159,-955
2018,12,20,12,3572,4701,3606,-1095
2018,12,20,13,3803,5069,3966,-1103
2018,12,20,14,3960,5229,4144,-1085
2018,12,20,15,3978,5424,4269,-1155
2018,12,20,16,4062,5576,4169,-1407
2018,12,20,17,4182,5683,4308,-1375
2018,12,20,18,4153,5655,4139,-1516
2018,12,20,19,4150,5568,3983,-1585
2018,12,20,20,4081,5479,3916,-1563
2018,12,20,21,4045,5442,4025,-1417
2018,12,20,22,4068,5531,4030,-1501
2018,12,20,23,4356,5810,4220,-1590
2018,12,21,0,4509,6025,4344,-1681
2018,12,21,1,4396,5933,4450,-1483
2018,12,21,2,4276,5738,4438,-1300
2018,12,21,3,4038,5398,4207,-1191
2018,12,21,4,3745,4929,3861,-1068
2018,12,21,5,3399,4429,3504,-925
2018,12,21,6,3040,4100,3189,-911
2018,12,21,7,2832,3871,2990,-881
2018,12,21,8,2685,3761,2897,-864
2018,12,21,9,2617,3759,2874,-885
2018,12,21,10,2687,3864,2928,-936
2018,12,21,11,3012,4257,3207,-1050
2018,12,21,12,3410,4852,3649,-1203
2018,12,21,13,3743,5314,4087,-1227
2018,12,21,14,3870,5534,4290,-1244
2018,12,21,15,4004,5673,4396,-1277
2018,12,21,16,4054,5694,4428,-1266
2018,12,21,17,4103,5675,4445,-1230
2018,12,21,18,4098,5636,4354,-1282
2018,12,21,19,4095,5562,4304,-1258
2018,12,21,20,4137,5532,4260,-1272
2018,12,21,21,4090,5527,4300,-1227
2018,12,21,22,4125,5652,4338,-1314
2018,12,21,23,4456,6066,4632,-1434
2018,12,22,0,4973,6475,4925,-1550
2018,12,22,1,4663,6510,4937,-1573
2018,12,22,2,4535,6302,4782,-1520
2018,12,22,3,4334,6114,4630,-1484
2018,12,22,4,4094,5757,4365,-1392
2018,12,22,5,4077,5390,4095,-1295
2018,12,22,6,3921,5058,3848,-1210
2018,12,22,7,3731,4868,3690,-1178
2018,12,22,8,3700,4781,3617,-1164
2018,12,22,9,3737,4805,3615,-1190
2018,12,22,10,3752,4922,3707,-1215
2018,12,22,11,3865,5172,3883,-1289
2018,12,22,12,4111,5600,4181,-1419
2018,12,22,13,4519,6098,4613,-1485
2018,12,22,14,4869,6416,4873,-1543
2018,12,22,15,4896,6400,4875,-1525
2018,12,22,16,4652,6174,4725,-1449
2018,12,22,17,4478,5822,4486,-1336
2018,12,22,18,4274,5514,4252,-1262
2018,12,22,19,4084,5266,4087,-1179
2018,12,22,20,3994,5095,3950,-1145
2018,12,22,21,3916,5022,3900,-1122
2018,12,22,22,3938,5112,3964,-1148
2018,12,22,23,4294,5488,4228,-1260
2018,12,23,0,4559,6044,4631,-1413
2018,12,23,1,4553,6187,4728,-1459
2018,12,23,2,4215,6291,4779,-1512
2018,12,23,3,4317,6347,4814,-1533
2018,12,23,4,4335,6237,4700,-1537
2018,12,23,5,4062,6034,4541,-1493
2018,12,23,6,4087,5886,4389,-1497
2018,12,23,7,3950,5821,4349,-1472
2018,12,23,8,3920,5792,4175,-1617
2018,12,23,9,3991,5882,4120,-1762
2018,12,23,10,4092,6058,4242,-1816
2018,12,23,11,4254,6360,4513,-1847
2018,12,23,12,4590,6845,4731,-2114
2018,12,23,13,4939,7420,5173,-2247
2018,12,23,14,5096,7702,5396,-2306
2018,12,23,15,4825,7253,5156,-2097
2018,12,23,16,4671,6574,4814,-1760
2018,12,23,17,4483,5963,4305,-1658
2018,12,23,18,4223,5584,4027,-1557
2018,12,23,19,4054,5326,3974,-1352
2018,12,23,20,3943,5155,3999,-1156
2018,12,23,21,3916,5043,3915,-1128
2018,12,23,22,3940,5076,3931,-1145
2018,12,23,23,4204,5464,4187,-1277
2018,12,24,0,4556,5987,4603,-1384
2018,12,24,1,4512,6044,4642,-1402
2018,12,24,2,4477,6138,4702,-1436
2018,12,24,3,4310,6093,4660,-1433
2018,12,24,4,4024,5920,4512,-1408
2018,12,24,5,3657,5672,4315,-1357
2018,12,24,6,3579,5437,4118,-1319
2018,12,24,7,3461,5308,4020,-1288
2018,12,24,8,3453,5274,3987,-1287
2018,12,24,9,3484,5320,4007,-1313
2018,12,24,10,3632,5490,4130,-1360
2018,12,24,11,3965,5835,4440,-1395
2018,12,24,12,4322,6323,4966,-1357
2018,12,24,13,4721,6770,5353,-1417
2018,12,24,14,4796,6919,5388,-1531
2018,12,24,15,4591,6643,5209,-1434
2018,12,24,16,4572,6209,4903,-1306
2018,12,24,17,4493,5756,4464,-1292
2018,12,24,18,4201,5603,4344,-1259
2018,12,24,19,4144,5325,4135,-1190
2018,12,24,20,4046,5431,4248,-1183
2018,12,24,21,3940,5323,4145,-1178
2018,12,24,22,3995,5300,4144,-1156
2018,12,24,23,4145,5443,4260,-1183
2018,12,25,0,4232,5653,4421,-1232
2018,12,25,1,4101,5472,4255,-1217
2018,12,25,2,4005,5319,4041,-1278
2018,12,25,3,3927,5221,4037,-1184
2018,12,25,4,3726,5010,3864,-1146
2018,12,25,5,3511,4754,3649,-1105
2018,12,25,6,3321,4558,3495,-1063
2018,12,25,7,3153,4423,3363,-1060
2018,12,25,8,3057,4319,3283,-1036
2018,12,25,9,3043,4308,3252,-1056
2018,12,25,10,3103,4388,3300,-1088
2018,12,25,11,3243,4580,3435,-1145
2018,12,25,12,3501,4957,3677,-1280
2018,12,25,13,3877,5420,4069,-1351
2018,12,25,14,4136,5760,4328,-1432
2018,12,25,15,4139,5744,4348,-1396
2018,12,25,16,4139,5574,4242,-1332
2018,12,25,17,4121,5436,4158,-1278
2018,12,25,18,4097,5335,4080,-1255
2018,12,25,19,3984,5197,4017,-1180
2018,12,25,20,3871,5109,3963,-1146
2018,12,25,21,3818,5015,3902,-1113
2018,12,25,22,3672,4910,3857,-1053
2018,12,25,23,3743,4975,3896,-1079
2018,12,26,0,3878,5243,4079,-1164
2018,12,26,1,3776,5162,4027,-1135
2018,12,26,2,3677,5081,3970,-1111
2018,12,26,3,3524,4909,3845,-1064
2018,12,26,4,3353,4610,3618,-992
2018,12,26,5,3213,4284,3342,-942
2018,12,26,6,2923,3996,3069,-927
2018,12,26,7,2786,3837,2774,-1063
2018,12,26,8,2709,3788,2896,-892
2018,12,26,9,2684,3817,2896,-921
2018,12,26,10,2765,3974,3007,-967
2018,12,26,11,2951,4315,3253,-1062
2018,12,26,12,3288,4754,3566,-1188
2018,12,26,13,3518,5174,3730,-1444
2018,12,26,14,3784,5385,3905,-1480
2018,12,26,15,3960,5448,4000,-1448
2018,12,26,16,3998,5425,4016,-1409
2018,12,26,17,4066,5339,3981,-1358
2018,12,26,18,4089,5253,3647,-1606
2018,12,26,19,4065,5197,3616,-1581
2018,12,26,20,4028,5185,3709,-1476
2018,12,26,21,4037,5158,3725,-1433
2018,12,26,22,4095,5178,3744,-1434
2018,12,26,23,4285,5404,3946,-1458
2018,12,27,0,4589,5787,4237,-1550
2018,12,27,1,4474,5711,4205,-1506
2018,12,27,2,4247,5482,4108,-1374
2018,12,27,3,3997,5202,4104,-1098
2018,12,27,4,3658,4785,3769,-1016
2018,12,27,5,3307,4337,3418,-919
2018,12,27,6,3143,3965,3099,-866
2018,12,27,7,2916,3739,2882,-857
2018,12,27,8,2787,3644,2804,-840
2018,12,27,9,2735,3614,2787,-827
2018,12,27,10,2748,3690,2821,-869
2018,12,27,11,2945,3910,2983,-927
2018,12,27,12,3266,4294,3268,-1026
2018,12,27,13,3548,4596,3559,-1037
2018,12,27,14,3772,4866,3780,-1086
2018,12,27,15,3985,5076,3982,-1094
2018,12,27,16,4183,5223,4105,-1118
2018,12,27,17,4359,5299,4192,-1107
2018,12,27,18,4437,5354,4228,-1126
2018,12,27,19,4494,5333,4223,-1110
2018,12,27,20,4526,5298,4254,-1044
2018,12,27,21,4497,5325,4240,-1085
2018,12,27,22,4444,5362,4282,-1080
2018,12,27,23,4570,5608,4421,-1187
2018,12,28,0,4848,5995,4704,-1291
2018,12,28,1,4742,5887,4637,-1250
2018,12,28,2,4566,5698,4505,-1193
2018,12,28,3,4279,5422,4304,-1118
2018,12,28,4,3964,5005,3977,-1028
2018,12,28,5,3611,4536,3605,-931
2018,12,28,6,3238,4129,3280,-849
2018,12,28,7,3035,3850,3045,-805
2018,12,28,8,2920,3678,2911,-767
2018,12,28,9,2865,3589,2829,-760
2018,12,28,10,2899,3619,2841,-778
2018,12,28,11,3099,3801,2976,-825
2018,12,28,12,3380,4161,3251,-910
2018,12,28,13,3645,4500,3563,-937
2018,12,28,14,4002,4883,3869,-1014
2018,12,28,15,4369,5281,3998,-1283
2018,12,28,16,4683,5629,4066,-1563
2018,12,28,17,4950,5906,4253,-1653
2018,12,28,18,5092,6131,4423,-1708
2018,12,28,19,5158,6244,4535,-1709
2018,12,28,20,5170,6281,4556,-1725
2018,12,28,21,5185,6313,4590,-1723
2018,12,28,22,5097,6275,4564,-1711
2018,12,28,23,5121,6392,4618,-1774
2018,12,29,0,5195,6580,4757,-1823
2018,12,29,1,4941,6358,4598,-1760
2018,12,29,2,4707,6223,4674,-1549
2018,12,29,3,4445,5801,4566,-1235
2018,12,29,4,4161,5375,4269,-1106
2018,12,29,5,3775,4891,3888,-1003
2018,12,29,6,3326,4432,3510,-922
2018,12,29,7,3105,4091,3207,-884
2018,12,29,8,2925,3834,3023,-811
2018,12,29,9,2787,3704,2911,-793
2018,12,29,10,2798,3671,2883,-788
2018,12,29,11,2775,3742,2919,-823
2018,12,29,12,2903,3936,3065,-871
2018,12,29,13,3144,4197,3298,-899
2018,12,29,14,3543,4687,3685,-1002
2018,12,29,15,4133,5154,3895,-1259
2018,12,29,16,4467,5514,3930,-1584
2018,12,29,17,4651,5816,4158,-1658
2018,12,29,18,4862,6044,4315,-1729
2018,12,29,19,4999,6222,4461,-1761
2018,12,29,20,5129,6372,4589,-1783
2018,12,29,21,5112,6450,4653,-1797
2018,12,29,22,5105,6412,4635,-1777
2018,12,29,23,4925,6365,4586,-1779
2018,12,30,0,5059,6500,4672,-1828
2018,12,30,1,4877,6192,4462,-1730
2018,12,30,2,4732,5905,4413,-1492
2018,12,30,3,4512,5559,4387,-1172
2018,12,30,4,4146,5106,4028,-1078
2018,12,30,5,3773,4630,3645,-985
2018,12,30,6,3477,4193,3289,-904
2018,12,30,7,3212,3884,3066,-818
2018,12,30,8,3000,3674,2892,-782
2018,12,30,9,2900,3561,2812,-749
2018,12,30,10,2852,3527,2785,-742
2018,12,30,11,2903,3599,2821,-778
2018,12,30,12,3029,3784,2972,-812
2018,12,30,13,3160,4056,3235,-821
2018,12,30,14,3585,4565,3599,-966
2018,12,30,15,4097,5056,3798,-1258
2018,12,30,16,4513,5487,3932,-1555
2018,12,30,17,4836,5873,4214,-1659
2018,12,30,18,5060,6241,4443,-1798
2018,12,30,19,5284,6528,4698,-1830
2018,12,30,20,5402,6718,4858,-1860
2018,12,30,21,5412,6805,4910,-1895
2018,12,30,22,5337,6745,4878,-1867
2018,12,30,23,5281,6578,4727,-1851
2018,12,31,0,5392,6659,4784,-1875
2018,12,31,1,5192,6353,4570,-1783
2018,12,31,2,4978,6015,4486,-1529
2018,12,31,3,4654,5661,4472,-1189
2018,12,31,4,4256,5191,4087,-1104
2018,12,31,5,3901,4667,3632,-1035
2018,12,31,6,3398,4204,3257,-933
2018,12,31,7,3110,3869,3019,-836
2018,12,31,8,2958,3663,2832,-817
2018,12,31,9,2854,3518,2716,-788
2018,12,31,10,2909,3515,2698,-803
2018,12,31,11,3051,3636,2770,-851
2018,12,31,12,3263,3945,2935,-991
2018,12,31,13,3524,4218,3113,-1090
2018,12,31,14,3898,4655,3381,-1259
2018,12,31,15,4260,5167,3565,-1574
2018,12,31,16,4516,5593,3432,-2129
2018,12,31,17,4737,5908,3630,-2247
2018,12,31,18,4872,6203,3820,-2352
2018,12,31,19,4971,6410,4015,-2363
2018,12,31,20,5149,6580,4148,-2402
2018,12,31,21,5216,6637,4186,-2420
2018,12,31,22,5236,6625,4204,-2391
2018,12,31,23,5271,6613,4176,-2407
2019,1,1,0,5316,6716,4250,-2435
2019,1,1,1,5120,6317,3980,-2305
2019,1,1,2,4671,5838,3783,-2024
2019,1,1,3,4302,5409,3737,-1641
2019,1,1,4,3953,4996,3680,-1300
2019,1,1,5,3707,4637,3517,-1105
2019,1,1,6,3401,4314,3265,-1049
2019,1,1,7,3215,4072,3067,-1005
2019,1,1,8,3004,3770,2829,-941
2019,1,1,9,2851,3571,2668,-903
2019,1,1,10,2808,3474,2606,-868
2019,1,1,11,2820,3484,2605,-879
2019,1,1,12,2892,3617,2662,-955
2019,1,1,13,2986,3715,2740,-975
2019,1,1,14,3296,4123,3028,-1095
2019,1,1,15,3749,4723,3215,-1508
2019,1,1,16,4187,5312,3479,-1833
2019,1,1,17,4626,5797,3802,-1995
2019,1,1,18,4964,6166,4045,-2121
2019,1,1,19,5103,6409,4320,-2089
2019,1,1,20,5150,6545,4444,-2101
2019,1,1,21,5197,6576,4466,-2110
2019,1,1,22,5180,6490,4398,-2092
2019,1,1,23,5127,6375,4263,-2112
2019,1,2,0,5149,6468,4330,-2138
2019,1,2,1,4996,6146,4109,-2037
2019,1,2,2,4704,5762,3988,-1774
2019,1,2,3,4408,5338,3936,-1402
2019,1,2,4,4025,4857,3571,-1286
2019,1,2,5,3675,4357,3180,-1177
2019,1,2,6,3343,3915,2929,-986
2019,1,2,7,3122,3642,2705,-937
2019,1,2,8,2952,3471,2561,-910
2019,1,2,9,2881,3399,2499,-900
2019,1,2,10,2887,3457,2550,-907
2019,1,2,11,3039,3699,2742,-957
2019,1,2,12,3394,4141,3081,-1060
2019,1,2,13,3625,4434,3314,-1120
2019,1,2,14,3887,4883,3703,-1180
2019,1,2,15,4131,5068,3550,-1518
2019,1,2,16,4464,5419,3608,-1811
2019,1,2,17,4723,5745,3885,-1860
2019,1,2,18,4951,6045,4101,-1944
2019,1,2,19,5105,6260,4249,-2011
2019,1,2,20,5216,6427,4380,-2047
2019,1,2,21,5248,6557,4483,-2074
2019,1,2,22,5227,6580,4519,-2061
2019,1,2,23,5230,6507,4446,-2061
2019,1,3,0,5281,6678,4555,-2123
2019,1,3,1,5148,6345,4311,-2034
2019,1,3,2,4897,5973,4194,-1779
2019,1,3,3,4529,5524,4092,-1432
2019,1,3,4,4132,5028,3714,-1314
2019,1,3,5,3761,4497,3309,-1188
2019,1,3,6,3421,4088,3035,-1053
2019,1,3,7,3177,3788,2787,-1001
2019,1,3,8,3019,3606,2638,-968
2019,1,3,9,2934,3524,2570,-954
2019,1,3,10,2953,3563,2594,-969
2019,1,3,11,3141,3788,2771,-1017
2019,1,3,12,3474,4227,3098,-1129
2019,1,3,13,3733,4536,3372,-1164
2019,1,3,14,4033,4849,3568,-1281
2019,1,3,15,4255,5212,3667,-1545
2019,1,3,16,4559,5605,3785,-1820
2019,1,3,17,4827,5887,4012,-1875
2019,1,3,18,5032,6151,4193,-1958
2019,1,3,19,5230,6306,4300,-2006
2019,1,3,20,5338,6467,4407,-2060
2019,1,3,21,5326,6570,4491,-2079
2019,1,3,22,5269,6567,4544,-2023
2019,1,3,23,5337,6550,4505,-2045
2019,1,4,0,5410,6732,4621,-2111
2019,1,4,1,5247,6434,4402,-2032
2019,1,4,2,5031,6081,4313,-1768
2019,1,4,3,4701,5663,4245,-1418
2019,1,4,4,4323,5166,3855,-1311
2019,1,4,5,3862,4645,3450,-1195
2019,1,4,6,3366,4220,3154,-1066
2019,1,4,7,3152,3907,2914,-993
2019,1,4,8,2999,3748,2772,-976
2019,1,4,9,2963,3673,2728,-945
2019,1,4,10,2948,3728,2771,-957
2019,1,4,11,3158,3961,2941,-1020
2019,1,4,12,3474,4406,3260,-1146
2019,1,4,13,3721,4798,3588,-1210
2019,1,4,14,4002,5103,3755,-1348
2019,1,4,15,4242,5415,3805,-1610
2019,1,4,16,4534,5768,3871,-1897
2019,1,4,17,4789,6070,4079,-1991
2019,1,4,18,4976,6302,4273,-2029
2019,1,4,19,5151,6424,4386,-2038
2019,1,4,20,5209,6439,4428,-2011
2019,1,4,21,5175,6280,4316,-1964
2019,1,4,22,5152,6094,4194,-1900
2019,1,4,23,5090,6012,4100,-1912
2019,1,5,0,5080,5971,4022,-1949
2019,1,5,1,4980,5725,3824,-1901
2019,1,5,2,4726,5483,3822,-1661
2019,1,5,3,4355,5179,3833,-1346
2019,1,5,4,3988,4805,3575,-1230
2019,1,5,5,3678,4371,3269,-1102
2019,1,5,6,3302,3980,3002,-978
2019,1,5,7,3062,3719,2893,-826
2019,1,5,8,2925,3553,2767,-786
2019,1,5,9,2813,3499,2699,-800
2019,1,5,10,2780,3492,2691,-801
2019,1,5,11,2892,3616,2781,-835
2019,1,5,12,3055,3874,2980,-894
2019,1,5,13,3327,4196,3179,-1017
2019,1,5,14,3626,4607,3482,-1125
2019,1,5,15,3926,4952,3738,-1214
2019,1,5,16,4081,5141,3946,-1195
2019,1,5,17,4238,5176,3964,-1212
2019,1,5,18,4345,5159,3947,-1212
2019,1,5,19,4433,5113,3932,-1181
2019,1,5,20,4435,5077,3926,-1151
2019,1,5,21,4380,5043,3904,-1139
2019,1,5,22,4355,5075,3918,-1157
2019,1,5,23,4397,5212,4004,-1208
2019,1,6,0,4447,5545,4243,-1302
2019,1,6,1,4277,5470,4183,-1287
2019,1,6,2,4046,5318,4053,-1265
2019,1,6,3,3808,5118,3889,-1229
2019,1,6,4,3581,4861,3659,-1202
2019,1,6,5,3425,4562,3440,-1122
2019,1,6,6,3281,4331,3249,-1082
2019,1,6,7,3128,4168,3119,-1049
2019,1,6,8,3118,4072,3003,-1069
2019,1,6,9,3132,4085,3019,-1066
2019,1,6,10,3248,4173,3064,-1109
2019,1,6,11,3457,4372,3186,-1186
2019,1,6,12,3723,4731,3452,-1279
2019,1,6,13,4058,5235,3757,-1478
2019,1,6,14,4244,5683,4099,-1584
2019,1,6,15,4304,5650,4168,-1482
2019,1,6,16,4303,5452,4093,-1359
2019,1,6,17,4198,5223,3970,-1253
2019,1,6,18,4095,5101,3896,-1205
2019,1,6,19,3991,5017,3844,-1173
2019,1,6,20,3965,4973,3835,-1138
2019,1,6,21,3961,4975,3866,-1109
2019,1,6,22,3979,5079,3946,-1133
2019,1,6,23,4117,5265,4094,-1171
2019,1,7,0,4412,5656,4271,-1385
2019,1,7,1,4385,5592,4210,-1382
2019,1,7,2,4218,5472,4072,-1400
2019,1,7,3,3955,5201,3949,-1252
2019,1,7,4,3638,4811,3675,-1136
2019,1,7,5,3239,4422,3357,-1065
2019,1,7,6,3013,4176,3149,-1027
2019,1,7,7,2851,4068,3061,-1007
2019,1,7,8,2798,4036,3014,-1022
2019,1,7,9,2770,4083,3037,-1046
2019,1,7,10,2896,4301,3175,-1126
2019,1,7,11,3232,4725,3460,-1265
2019,1,7,12,3831,5480,4009,-1471
2019,1,7,13,4168,5907,4263,-1644
2019,1,7,14,4213,5872,4339,-1533
2019,1,7,15,4125,5607,4256,-1351
2019,1,7,16,4139,5421,4177,-1244
2019,1,7,17,4174,5319,4142,-1177
2019,1,7,18,4172,5307,4073,-1234
2019,1,7,19,4190,5317,4182,-1135
2019,1,7,20,4196,5353,4227,-1126
2019,1,7,21,4215,5411,4275,-1136
2019,1,7,22,4278,5489,4339,-1150
2019,1,7,23,4450,5618,4390,-1228
2019,1,8,0,4687,5951,4528,-1423
2019,1,8,1,4557,5868,4463,-1405
2019,1,8,2,4319,5583,4251,-1332
2019,1,8,3,3979,5188,4049,-1139
2019,1,8,4,3674,4709,3667,-1042
2019,1,8,5,3279,4231,3324,-907
2019,1,8,6,2966,3868,3027,-841
2019,1,8,7,2715,3656,2840,-816
2019,1,8,8,2639,3592,2748,-844
2019,1,8,9,2592,3569,2725,-844
2019,1,8,10,2718,3763,2853,-910
2019,1,8,11,2984,4145,3113,-1032
2019,1,8,12,3530,4878,3503,-1375
2019,1,8,13,3876,5250,3645,-1605
2019,1,8,14,3944,5254,3591,-1663
2019,1,8,15,3989,5203,3563,-1640
2019,1,8,16,4097,5174,3584,-1590
2019,1,8,17,4169,5207,3626,-1581
2019,1,8,18,4235,5257,3696,-1561
2019,1,8,19,4312,5327,3775,-1552
2019,1,8,20,4342,5382,3820,-1562
2019,1,8,21,4361,5412,3847,-1565
2019,1,8,22,4424,5468,3898,-1570
2019,1,8,23,4554,5588,3952,-1636
2019,1,9,0,4815,5936,4195,-1741
2019,1,9,1,4663,5816,4089,-1727
2019,1,9,2,4404,5533,3919,-1614
2019,1,9,3,4025,5156,3817,-1339
2019,1,9,4,3673,4663,3619,-1044
2019,1,9,5,3311,4164,3234,-930
2019,1,9,6,2936,3848,3016,-832
2019,1,9,7,2723,3648,2883,-765
2019,1,9,8,2666,3583,2786,-797
2019,1,9,9,2656,3556,2758,-798
2019,1,9,10,2799,3657,2807,-850
2019,1,9,11,3102,4038,3079,-959
2019,1,9,12,3703,4726,3545,-1181
2019,1,9,13,4024,5120,3938,-1182
2019,1,9,14,4071,5208,4058,-1150
2019,1,9,15,4072,5254,4105,-1149
2019,1,9,16,4107,5224,4113,-1111
2019,1,9,17,4139,5173,4096,-1077
2019,1,9,18,4219,5173,4095,-1078
2019,1,9,19,4225,5160,4100,-1060
2019,1,9,20,4200,5136,4082,-1054
2019,1,9,21,4218,5155,4107,-1048
2019,1,9,22,4302,5234,4164,-1070
2019,1,9,23,4382,5462,4285,-1177
2019,1,10,0,4612,5920,4585,-1335
2019,1,10,1,4519,5918,4572,-1346
2019,1,10,2,4360,5792,4424,-1368
2019,1,10,3,4150,5518,4223,-1295
2019,1,10,4,3856,5144,3905,-1239
2019,1,10,5,3587,4773,3627,-1146
2019,1,10,6,3402,4613,3531,-1082
2019,1,10,7,3371,4532,3427,-1105
2019,1,10,8,3465,4586,3455,-1131
2019,1,10,9,3602,4700,3519,-1181
2019,1,10,10,3853,5003,3736,-1267
2019,1,10,11,4338,5669,4352,-1317
2019,1,10,12,5140,6701,5262,-1439
2019,1,10,13,5603,7297,5734,-1563
2019,1,10,14,5602,7255,5719,-1536
2019,1,10,15,5486,6926,5429,-1497
2019,1,10,16,5222,6489,5001,-1488
2019,1,10,17,4914,6128,4767,-1361
2019,1,10,18,4705,5803,4528,-1275
2019,1,10,19,4526,5498,4324,-1174
2019,1,10,20,4350,5322,4204,-1118
2019,1,10,21,4280,5303,4191,-1112
2019,1,10,22,4327,5455,4312,-1143
2019,1,10,23,4658,5940,4629,-1311
2019,1,11,0,5173,6680,5176,-1504
2019,1,11,1,5352,6934,5365,-1569
2019,1,11,2,5414,6941,5482,-1459
2019,1,11,3,5249,6768,5311,-1457
2019,1,11,4,5019,6388,4975,-1413
2019,1,11,5,4705,6002,4575,-1427
2019,1,11,6,4461,5787,4330,-1457
2019,1,11,7,4384,5732,4240,-1492
2019,1,11,8,4373,5774,4253,-1521
2019,1,11,9,4403,5864,4372,-1492
2019,1,11,10,4597,6135,4674,-1461
2019,1,11,11,5055,6695,5301,-1394
2019,1,11,12,5717,7507,5810,-1697
2019,1,11,13,6012,7858,5975,-1883
2019,1,11,14,5864,7599,5758,-1841
2019,1,11,15,5517,6955,5262,-1693
2019,1,11,16,5067,6340,4975,-1365
2019,1,11,17,4775,5815,4515,-1300
2019,1,11,18,4541,5445,4237,-1208
2019,1,11,19,4307,5238,4109,-1129
2019,1,11,20,4198,5100,4018,-1082
2019,1,11,21,4098,5059,4006,-1053
2019,1,11,22,4147,5111,4042,-1069
2019,1,11,23,4339,5280,4153,-1127
2019,1,12,0,4621,5625,4374,-1251
2019,1,12,1,4623,5603,4351,-1252
2019,1,12,2,4501,5457,4236,-1221
2019,1,12,3,4296,5253,4064,-1189
2019,1,12,4,3978,5444,4340,-1104
2019,1,12,5,3779,4968,3901,-1067
2019,1,12,6,3445,4394,3367,-1027
2019,1,12,7,3344,4222,3219,-1003
2019,1,12,8,3272,4125,3094,-1031
2019,1,12,9,3248,4082,3047,-1035
2019,1,12,10,3296,4136,3076,-1060
2019,1,12,11,3441,4317,3219,-1098
2019,1,12,12,3655,4632,3478,-1154
2019,1,12,13,3997,5027,3762,-1265
2019,1,12,14,4171,5322,4003,-1319
2019,1,12,15,4288,5349,4083,-1266
2019,1,12,16,4322,5281,4094,-1187
2019,1,12,17,4152,5190,4056,-1134
2019,1,12,18,4104,5155,4011,-1144
2019,1,12,19,4051,5099,3997,-1102
2019,1,12,20,4005,5093,4004,-1089
2019,1,12,21,4044,5112,4026,-1086
2019,1,12,22,4077,5155,4076,-1079
2019,1,12,23,4137,5235,4111,-1124
2019,1,13,0,4397,5516,4313,-1203
2019,1,13,1,4264,5338,4181,-1157
2019,1,13,2,4065,5111,4010,-1101
2019,1,13,3,3867,4813,3789,-1024
2019,1,13,4,3589,4471,3552,-919
2019,1,13,5,3254,4128,3246,-882
2019,1,13,6,3033,3814,3004,-810
2019,1,13,7,2824,3604,2795,-809
2019,1,13,8,2699,3500,2722,-778
2019,1,13,9,2609,3453,2671,-782
2019,1,13,10,2661,3465,2683,-782
2019,1,13,11,2781,3572,2775,-797
2019,1,13,12,2991,3796,2933,-863
2019,1,13,13,3217,4131,3187,-944
2019,1,13,14,3546,4561,3500,-1061
2019,1,13,15,3738,4868,3753,-1115
2019,1,13,16,3952,5072,3938,-1134
2019,1,13,17,4118,5222,4071,-1151
2019,1,13,18,4148,5361,4185,-1176
2019,1,13,19,4164,5450,4289,-1161
2019,1,13,20,4211,5526,4364,-1162
2019,1,13,21,4231,5481,4348,-1133
2019,1,13,22,4264,5520,4357,-1163
2019,1,13,23,4343,5600,4413,-1187
2019,1,14,0,4600,5861,4493,-1368
2019,1,14,1,4461,5740,4379,-1361
2019,1,14,2,4224,5464,4302,-1162
2019,1,14,3,3896,5077,4011,-1066
2019,1,14,4,3513,4554,3578,-976
2019,1,14,5,3267,4061,3188,-873
2019,1,14,6,2927,3685,2889,-796
2019,1,14,7,2703,3482,2726,-756
2019,1,14,8,2669,3383,2610,-773
2019,1,14,9,2668,3373,2604,-769
2019,1,14,10,2779,3516,2687,-829
2019,1,14,11,3144,3941,3014,-927
2019,1,14,12,3744,4676,3549,-1127
2019,1,14,13,4109,5084,3875,-1209
2019,1,14,14,4170,5192,3997,-1195
2019,1,14,15,4170,5282,4044,-1238
2019,1,14,16,4213,5316,4106,-1210
2019,1,14,17,4221,5298,4105,-1193
2019,1,14,18,4221,5278,4091,-1187
2019,1,14,19,4191,5206,4046,-1160
2019,1,14,20,4152,5137,4014,-1123
2019,1,14,21,4168,5152,4024,-1128
2019,1,14,22,4237,5255,4105,-1150
2019,1,14,23,4316,5558,4275,-1283
2019,1,15,0,4621,6078,4518,-1560
2019,1,15,1,4583,6137,4540,-1597
2019,1,15,2,4466,6005,4435,-1570
2019,1,15,3,4260,5703,4231,-1472
2019,1,15,4,3941,5267,3974,-1293
2019,1,15,5,3637,4824,3651,-1173
2019,1,15,6,3496,4509,3408,-1101
2019,1,15,7,3440,4378,3281,-1097
2019,1,15,8,3460,4341,3246,-1095
2019,1,15,9,3520,4362,3279,-1083
2019,1,15,10,3723,4497,3273,-1224
2019,1,15,11,4193,4961,3602,-1359
2019,1,15,12,4931,5764,4075,-1689
2019,1,15,13,5349,6193,4401,-1792
2019,1,15,14,5270,6252,4327,-1925
2019,1,15,15,5035,6242,4313,-1929
2019,1,15,16,4779,6169,4264,-1905
2019,1,15,17,4573,6018,4332,-1686
2019,1,15,18,4411,5810,4193,-1617
2019,1,15,19,4219,5597,4195,-1402
2019,1,15,20,4093,5378,4038,-1340
2019,1,15,21,4009,5278,3954,-1324
2019,1,15,22,4004,5440,4176,-1264
2019,1,15,23,4322,5960,4546,-1414
2019,1,16,0,4900,6726,5147,-1579
2019,1,16,1,4937,6963,5389,-1574
2019,1,16,2,4874,6963,5466,-1497
2019,1,16,3,4754,6752,5262,-1490
2019,1,16,4,4435,6344,4937,-1407
2019,1,16,5,4128,5974,4583,-1391
2019,1,16,6,4031,5789,4421,-1368
2019,1,16,7,3958,5750,4340,-1410
2019,1,16,8,3959,5793,4390,-1403
2019,1,16,9,4022,5929,4547,-1382
2019,1,16,10,4229,6219,4738,-1481
2019,1,16,11,4712,6801,5099,-1702
2019,1,16,12,5446,7735,5693,-2042
2019,1,16,13,5823,8122,6144,-1978
2019,1,16,14,5702,7871,5879,-1992
2019,1,16,15,5323,7337,5543,-1794
2019,1,16,16,4978,6829,5306,-1523
2019,1,16,17,4685,6461,5016,-1445
2019,1,16,18,4446,6314,4794,-1520
2019,1,16,19,4249,6177,4727,-1450
2019,1,16,20,4082,6006,4623,-1383
2019,1,16,21,4087,5813,4499,-1314
2019,1,16,22,4099,5825,4601,-1224
2019,1,16,23,4366,6278,4917,-1361
2019,1,17,0,4811,7102,5517,-1585
2019,1,17,1,4873,7390,5773,-1617
2019,1,17,2,4795,7431,5824,-1607
2019,1,17,3,4618,7271,5729,-1542
2019,1,17,4,4369,6891,5375,-1516
2019,1,17,5,4040,6526,5026,-1500
2019,1,17,6,4084,6367,4925,-1442
2019,1,17,7,4020,6388,4893,-1495
2019,1,17,8,4025,6463,4951,-1512
2019,1,17,9,4083,6647,5108,-1539
2019,1,17,10,4242,6981,5405,-1576
2019,1,17,11,4691,7596,5880,-1716
2019,1,17,12,5402,8560,6853,-1707
2019,1,17,13,5738,8974,7329,-1645
2019,1,17,14,5598,8544,7072,-1472
2019,1,17,15,5106,7605,6290,-1315
2019,1,17,16,4856,6697,5391,-1306
2019,1,17,17,4631,6027,4627,-1400
2019,1,17,18,4290,5576,4287,-1289
2019,1,17,19,4169,5277,4107,-1170
2019,1,17,20,4103,5104,3983,-1121
2019,1,17,21,4064,5038,3938,-1100
2019,1,17,22,4073,5118,3995,-1123
2019,1,17,23,4241,5341,4136,-1205
2019,1,18,0,4589,5878,4472,-1406
2019,1,18,1,4594,5955,4547,-1408
2019,1,18,2,4494,5869,4494,-1375
2019,1,18,3,4288,5634,4322,-1312
2019,1,18,4,3975,5235,3965,-1270
2019,1,18,5,3677,4850,3684,-1166
2019,1,18,6,3492,4623,3524,-1099
2019,1,18,7,3334,4644,3482,-1162
2019,1,18,8,3274,4551,3363,-1188
2019,1,18,9,3302,4652,3447,-1205
2019,1,18,10,3412,4908,3626,-1282
2019,1,18,11,3763,5464,4116,-1348
2019,1,18,12,4383,6378,4805,-1573
2019,1,18,13,4707,6858,5299,-1559
2019,1,18,14,4677,6661,5199,-1462
2019,1,18,15,4499,6122,4809,-1313
2019,1,18,16,4438,5651,4390,-1261
2019,1,18,17,4276,5337,4180,-1157
2019,1,18,18,4213,5153,3998,-1155
2019,1,18,19,4183,5056,3950,-1106
2019,1,18,20,4186,4981,3900,-1081
2019,1,18,21,4136,4975,3891,-1084
2019,1,18,22,4171,5026,3964,-1062
2019,1,18,23,4216,5167,4055,-1112
2019,1,19,0,4419,5484,4285,-1199
2019,1,19,1,4282,5418,4231,-1187
2019,1,19,2,4165,5238,4076,-1162
2019,1,19,3,3960,4997,3880,-1117
2019,1,19,4,3704,4719,3652,-1067
2019,1,19,5,3368,4421,3413,-1008
2019,1,19,6,3081,4180,3226,-954
2019,1,19,7,2939,4039,3094,-945
2019,1,19,8,2866,3983,3043,-940
2019,1,19,9,2841,4035,3076,-959
2019,1,19,10,2910,4161,3152,-1009
2019,1,19,11,3041,4361,3296,-1065
2019,1,19,12,3262,4766,3598,-1168
2019,1,19,13,3598,5231,3917,-1314
2019,1,19,14,3863,5555,4204,-1351
2019,1,19,15,4020,5544,4271,-1273
2019,1,19,16,4086,5335,4147,-1188
2019,1,19,17,4099,5126,4005,-1121
2019,1,19,18,4107,5041,3870,-1171
2019,1,19,19,4169,4995,3929,-1066
2019,1,19,20,4209,4991,3920,-1071
2019,1,19,21,4247,5035,3940,-1095
2019,1,19,22,4199,5062,3977,-1085
2019,1,19,23,4184,5136,4013,-1123
2019,1,20,0,4367,5419,4219,-1200
2019,1,20,1,4232,5300,4143,-1157
2019,1,20,2,4065,5106,4014,-1092
2019,1,20,3,3845,4832,3830,-1002
2019,1,20,4,3592,4477,3505,-972
2019,1,20,5,3252,4094,3210,-884
2019,1,20,6,3013,3783,2975,-808
2019,1,20,7,2799,3536,2774,-762
2019,1,20,8,2661,3402,2665,-737
2019,1,20,9,2575,3325,2598,-727
2019,1,20,10,2506,3344,2614,-730
2019,1,20,11,2539,3419,2658,-761
2019,1,20,12,2745,3651,2804,-847
2019,1,20,13,3045,4046,3112,-934
2019,1,20,14,3436,4567,3503,-1064
2019,1,20,15,3774,5020,3827,-1193
2019,1,20,16,3989,5270,4010,-1260
2019,1,20,17,4031,5386,4075,-1311
2019,1,20,18,4004,5462,4096,-1366
2019,1,20,19,4034,5456,4113,-1343
2019,1,20,20,4002,5478,4143,-1335
2019,1,20,21,3985,5514,4171,-1343
2019,1,20,22,4068,5642,4244,-1398
2019,1,20,23,4199,5997,4503,-1494
2019,1,21,0,4593,6564,4954,-1610
2019,1,21,1,4927,6723,5063,-1660
2019,1,21,2,5038,6693,5045,-1648
2019,1,21,3,4884,6502,4861,-1641
2019,1,21,4,4649,6331,4711,-1620
2019,1,21,5,4567,6089,4596,-1493
2019,1,21,6,4612,5969,4364,-1605
2019,1,21,7,4593,5971,4278,-1693
2019,1,21,8,4683,6093,4258,-1835
2019,1,21,9,4768,6306,4375,-1931
2019,1,21,10,4998,6688,4611,-2077
2019,1,21,11,5418,7336,4957,-2379
2019,1,21,12,5973,8168,5606,-2562
2019,1,21,13,6509,8860,6637,-2223
2019,1,21,14,6649,8971,6469,-2502
2019,1,21,15,6405,8537,5954,-2583
2019,1,21,16,5949,7913,5621,-2292
2019,1,21,17,5387,7227,5305,-1922
2019,1,21,18,5043,6601,4646,-1955
2019,1,21,19,4809,6086,4266,-1820
2019,1,21,20,4655,5737,4063,-1674
2019,1,21,21,4571,5567,3947,-1620
2019,1,21,22,4636,5645,4014,-1631
2019,1,21,23,4863,6102,4219,-1883
2019,1,22,0,5278,6886,4806,-2080
2019,1,22,1,5437,7140,5111,-2029
2019,1,22,2,5410,7132,5111,-2021
2019,1,22,3,5257,6959,4968,-1991
2019,1,22,4,4921,6604,4650,-1954
2019,1,22,5,4598,6251,4405,-1846
2019,1,22,6,4287,6020,4154,-1866
2019,1,22,7,4199,5943,4060,-1883
2019,1,22,8,4147,5982,4075,-1907
2019,1,22,9,4150,6052,4120,-1932
2019,1,22,10,4322,6253,4240,-2013
2019,1,22,11,4720,6824,4778,-2046
2019,1,22,12,5339,7613,5529,-2084
2019,1,22,13,5608,7828,5763,-2065
2019,1,22,14,5517,7404,5432,-1972
2019,1,22,15,5216,6671,4675,-1996
2019,1,22,16,4915,6065,4186,-1879
2019,1,22,17,4672,5659,3994,-1665
2019,1,22,18,4494,5384,3955,-1429
2019,1,22,19,4294,5199,3934,-1265
2019,1,22,20,4111,5051,3986,-1065
2019,1,22,21,4085,5007,3975,-1032
2019,1,22,22,4137,5079,4004,-1075
2019,1,22,23,4294,5305,4150,-1155
2019,1,23,0,4650,5772,4484,-1288
2019,1,23,1,4690,5818,4519,-1299
2019,1,23,2,4552,5595,4363,-1232
2019,1,23,3,4284,5240,4066,-1174
2019,1,23,4,3915,4777,3685,-1092
2019,1,23,5,3515,4305,3364,-941
2019,1,23,6,3250,4008,3098,-910
2019,1,23,7,3111,3836,2933,-903
2019,1,23,8,3025,3792,2866,-926
2019,1,23,9,3054,3794,2836,-958
2019,1,23,10,3166,3960,2941,-1019
2019,1,23,11,3502,4420,3311,-1109
2019,1,23,12,4120,5182,3956,-1226
2019,1,23,13,4367,5549,4215,-1334
2019,1,23,14,4357,5474,4198,-1276
2019,1,23,15,4354,5280,4106,-1174
2019,1,23,16,4273,5219,4090,-1129
2019,1,23,17,4246,5187,4073,-1114
2019,1,23,18,4187,5174,4073,-1101
2019,1,23,19,4170,5195,4095,-1100
2019,1,23,20,4163,5245,4178,-1067
2019,1,23,21,4180,5300,4184,-1116
2019,1,23,22,4247,5379,4250,-1129
2019,1,23,23,4345,5502,4316,-1186
2019,1,24,0,4631,5853,4546,-1307
2019,1,24,1,4622,5847,4535,-1312
2019,1,24,2,4421,5608,4370,-1238
2019,1,24,3,4076,5253,4140,-1113
2019,1,24,4,3694,4708,3735,-973
2019,1,24,5,3280,4245,3326,-919
2019,1,24,6,3013,3879,3017,-862
2019,1,24,7,2841,3650,2856,-794
2019,1,24,8,2724,3551,2773,-778
2019,1,24,9,2689,3503,2745,-758
2019,1,24,10,2771,3606,2806,-800
2019,1,24,11,3118,3906,3075,-831
2019,1,24,12,3637,4506,3545,-961
2019,1,24,13,4000,4844,3831,-1013
2019,1,24,14,4033,5000,3924,-1076
2019,1,24,15,4126,5151,4026,-1125
2019,1,24,16,4232,5250,4110,-1140
2019,1,24,17,4191,5248,4097,-1151
2019,1,24,18,4144,5276,4092,-1184
2019,1,24,19,4105,5259,4111,-1148
2019,1,24,20,3967,5229,4089,-1140
2019,1,24,21,3961,5235,4125,-1110
2019,1,24,22,3981,5284,4164,-1120
2019,1,24,23,4098,5394,4206,-1188
2019,1,25,0,4486,5782,4446,-1336
2019,1,25,1,4570,5810,4453,-1357
2019,1,25,2,4464,5595,4292,-1303
2019,1,25,3,4280,5281,4046,-1235
2019,1,25,4,4119,4866,3663,-1203
2019,1,25,5,3918,4469,3380,-1089
2019,1,25,6,3481,4202,3196,-1006
2019,1,25,7,3421,4086,3071,-1015
2019,1,25,8,3459,4084,3046,-1038
2019,1,25,9,3551,4168,3074,-1094
2019,1,25,10,3770,4445,3321,-1124
2019,1,25,11,4201,5025,3761,-1264
2019,1,25,12,5000,6097,4648,-1449
2019,1,25,13,5526,6857,5349,-1508
2019,1,25,14,5470,6997,5482,-1515
2019,1,25,15,5113,6746,5292,-1454
2019,1,25,16,4756,6433,5004,-1429
2019,1,25,17,4572,6063,4680,-1383
2019,1,25,18,4408,5726,4428,-1298
2019,1,25,19,4276,5441,4247,-1194
2019,1,25,20,4153,5245,4093,-1152
2019,1,25,21,4098,5158,4037,-1121
2019,1,25,22,4087,5266,4121,-1145
2019,1,25,23,4210,5585,4340,-1245
2019,1,26,0,4621,6224,4791,-1433
2019,1,26,1,4737,6351,4835,-1516
2019,1,26,2,4798,6393,4844,-1549
2019,1,26,3,4802,6355,4813,-1542
2019,1,26,4,4706,6168,4667,-1501
2019,1,26,5,4527,5866,4462,-1404
2019,1,26,6,4341,5775,4407,-1368
2019,1,26,7,4289,5656,4301,-1355
2019,1,26,8,4410,5594,4224,-1370
2019,1,26,9,4474,5641,4241,-1400
2019,1,26,10,4679,5821,4384,-1437
2019,1,26,11,4962,6151,4781,-1370
2019,1,26,12,5420,6650,5239,-1411
2019,1,26,13,5921,7255,5762,-1493
2019,1,26,14,6185,7574,6042,-1532
2019,1,26,15,6047,7285,5752,-1533
2019,1,26,16,5519,6872,5391,-1481
2019,1,26,17,4884,6341,4968,-1373
2019,1,26,18,4490,6043,4687,-1356
2019,1,26,19,4223,5823,4528,-1295
2019,1,26,20,4063,5671,4428,-1243
2019,1,26,21,4017,5648,4411,-1237
2019,1,26,22,3894,5795,4500,-1295
2019,1,26,23,4088,6080,4690,-1390
2019,1,27,0,4504,6519,5064,-1455
2019,1,27,1,4580,6605,5211,-1394
2019,1,27,2,4511,6562,5220,-1342
2019,1,27,3,4513,6389,5062,-1327
2019,1,27,4,4421,6111,4745,-1366
2019,1,27,5,4396,5802,4498,-1304
2019,1,27,6,4228,5419,4128,-1291
2019,1,27,7,4134,5001,3723,-1278
2019,1,27,8,4112,5119,3871,-1248
2019,1,27,9,4192,5045,3805,-1240
2019,1,27,10,4359,5115,3866,-1249
2019,1,27,11,4538,5331,4024,-1307
2019,1,27,12,4831,5696,4299,-1397
2019,1,27,13,5155,6147,4619,-1528
2019,1,27,14,5467,6690,4998,-1692
2019,1,27,15,5521,7086,5300,-1786
2019,1,27,16,5386,7225,5490,-1735
2019,1,27,17,5077,7264,5572,-1692
2019,1,27,18,4827,7334,5658,-1676
2019,1,27,19,4545,7331,5566,-1765
2019,1,27,20,4334,7255,5489,-1766
2019,1,27,21,4241,7246,5479,-1767
2019,1,27,22,4283,7327,5617,-1710
2019,1,27,23,4519,7574,5839,-1735
2019,1,28,0,4976,7865,6000,-1865
2019,1,28,1,5204,7826,5883,-1943
2019,1,28,2,5268,7711,5885,-1826
2019,1,28,3,5160,7375,5578,-1797
2019,1,28,4,4872,6826,5324,-1502
2019,1,28,5,4723,6313,4830,-1483
2019,1,28,6,4624,6025,4624,-1401
2019,1,28,7,4492,5918,4505,-1413
2019,1,28,8,4435,5918,4471,-1447
2019,1,28,9,4495,6019,4556,-1463
2019,1,28,10,4733,6302,4684,-1618
2019,1,28,11,5231,6997,5216,-1781
2019,1,28,12,5964,7968,5829,-2139
2019,1,28,13,6339,8501,6297,-2204
2019,1,28,14,6221,8388,6248,-2140
2019,1,28,15,5744,7973,5927,-2046
2019,1,28,16,5283,7440,5616,-1824
2019,1,28,17,4958,6885,5202,-1683
2019,1,28,18,4716,6521,4946,-1575
2019,1,28,19,4539,6198,4735,-1463
2019,1,28,20,4349,5892,4511,-1381
2019,1,28,21,4309,5651,4389,-1262
2019,1,28,22,4363,5724,4553,-1171
2019,1,28,23,4560,6161,4853,-1308
2019,1,29,0,5062,7049,5463,-1586
2019,1,29,1,5231,7460,5859,-1601
2019,1,29,2,5170,7559,5939,-1620
2019,1,29,3,4994,7401,5790,-1611
2019,1,29,4,4733,7014,5486,-1528
2019,1,29,5,4408,6609,5094,-1515
2019,1,29,6,4436,6347,4854,-1493
2019,1,29,7,4358,6254,4714,-1540
2019,1,29,8,4345,6343,4673,-1670
2019,1,29,9,4451,6541,4794,-1747
2019,1,29,10,4670,6916,5138,-1778
2019,1,29,11,5163,7710,5693,-2017
2019,1,29,12,5953,8709,6294,-2415
2019,1,29,13,6301,9135,6653,-2482
2019,1,29,14,6057,8617,6451,-2166
2019,1,29,15,5551,7679,5796,-1883
2019,1,29,16,5033,6835,5191,-1644
2019,1,29,17,4730,6225,4640,-1585
2019,1,29,18,4558,5822,4432,-1390
2019,1,29,19,4351,5566,4254,-1312
2019,1,29,20,4183,5413,4135,-1278
2019,1,29,21,3958,5464,4231,-1233
2019,1,29,22,4006,5630,4361,-1269
2019,1,29,23,4289,5976,4597,-1379
2019,1,30,0,4754,6526,4969,-1557
2019,1,30,1,4908,6671,5139,-1532
2019,1,30,2,4831,6527,5039,-1488
2019,1,30,3,4692,6204,4768,-1436
2019,1,30,4,4476,6020,4678,-1342
2019,1,30,5,4306,5264,3988,-1276
2019,1,30,6,3729,4988,3785,-1203
2019,1,30,7,3666,4885,3697,-1188
2019,1,30,8,3657,4880,3686,-1194
2019,1,30,9,3757,4995,3801,-1194
2019,1,30,10,3960,5252,4130,-1122
2019,1,30,11,4402,5880,4680,-1200
2019,1,30,12,5122,6729,5327,-1402
2019,1,30,13,5504,7154,5790,-1364
2019,1,30,14,5492,7182,5718,-1464
2019,1,30,15,5228,7090,5633,-1457
2019,1,30,16,5034,6896,5384,-1512
2019,1,30,17,4823,6606,5098,-1508
2019,1,30,18,4710,6299,4786,-1513
2019,1,30,19,4558,6123,4785,-1338
2019,1,30,20,4401,6025,4746,-1279
2019,1,30,21,4327,6049,4741,-1308
2019,1,30,22,4362,6414,4971,-1443
2019,1,30,23,4655,7034,5319,-1715
2019,1,31,0,5197,7843,6110,-1733
2019,1,31,1,5490,8245,6505,-1740
2019,1,31,2,5521,8226,6428,-1798
2019,1,31,3,5382,8135,6362,-1773
2019,1,31,4,5121,7717,5907,-1810
2019,1,31,5,4809,7345,5523,-1822
2019,1,31,6,4823,7147,5214,-1933
2019,1,31,7,4760,7111,5098,-2013
2019,1,31,8,4764,7166,5151,-2015
2019,1,31,9,4797,7275,5273,-2002
2019,1,31,10,5006,7477,5466,-2011
2019,1,31,11,5483,8129,6301,-1828
2019,1,31,12,6214,8847,6728,-2119
2019,1,31,13,6508,9092,7008,-2084
2019,1,31,14,6297,8768,6716,-2052
2019,1,31,15,5951,8271,6513,-1758
2019,1,31,16,5585,7707,5946,-1761
2019,1,31,17,5133,7143,5308,-1835
2019,1,31,18,4941,6621,4919,-1702
2019,1,31,19,4754,6194,4660,-1534
2019,1,31,20,4584,5816,4482,-1334
2019,1,31,21,4495,5678,4372,-1306
2019,1,31,22,4509,5832,4505,-1327
2019,1,31,23,4762,6111,4589,-1522
2019,2,1,0,5198,6704,4966,-1738
2019,2,1,1,5246,6869,5117,-1752
2019,2,1,2,5129,6723,4984,-1739
2019,2,1,3,4883,6389,4725,-1664
2019,2,1,4,4491,5928,4361,-1567
2019,2,1,5,4081,5483,4101,-1382
2019,2,1,6,4042,5209,3792,-1417
2019,2,1,7,3890,5036,3548,-1488
2019,2,1,8,3764,4960,3486,-1474
2019,2,1,9,3752,4935,3460,-1475
2019,2,1,10,3853,5044,3518,-1526
2019,2,1,11,4202,5474,3696,-1778
2019,2,1,12,4772,6201,4019,-2182
2019,2,1,13,5045,6519,4376,-2143
2019,2,1,14,4971,6355,4303,-2052
2019,2,1,15,4774,6022,4033,-1989
2019,2,1,16,4550,5760,4038,-1722
2019,2,1,17,4481,5554,4084,-1470
2019,2,1,18,4212,5394,4009,-1385
2019,2,1,19,4141,5313,3954,-1359
2019,2,1,20,4035,5257,3940,-1317
2019,2,1,21,4023,5209,3891,-1318
2019,2,1,22,4056,5222,3892,-1330
2019,2,1,23,4119,5338,3954,-1384
2019,2,2,0,4331,5662,4188,-1474
2019,2,2,1,4343,5602,4154,-1448
2019,2,2,2,4218,5392,4003,-1389
2019,2,2,3,4042,4910,3594,-1316
2019,2,2,4,3787,4693,3469,-1224
2019,2,2,5,3570,4280,3179,-1101
2019,2,2,6,3172,3938,3078,-860
2019,2,2,7,2984,3690,2860,-830
2019,2,2,8,2893,3541,2748,-793
2019,2,2,9,2850,3498,2711,-787
2019,2,2,10,2883,3542,2737,-805
2019,2,2,11,2948,3676,2833,-843
2019,2,2,12,3224,3989,3163,-826
2019,2,2,13,3405,4369,3485,-884
2019,2,2,14,3756,4806,3718,-1088
2019,2,2,15,3985,5131,3982,-1149
2019,2,2,16,4168,5270,4106,-1164
2019,2,2,17,4202,5331,4176,-1155
2019,2,2,18,4180,5343,4193,-1150
2019,2,2,19,4150,5307,4181,-1126
2019,2,2,20,4145,5287,4178,-1109
2019,2,2,21,4143,5285,4171,-1114
2019,2,2,22,4096,5281,4187,-1094
2019,2,2,23,4100,5286,4168,-1118
2019,2,3,0,4279,5506,4357,-1149
2019,2,3,1,4281,5463,4333,-1130
2019,2,3,2,4088,5242,4143,-1099
2019,2,3,3,3818,4954,3926,-1028
2019,2,3,4,3576,4578,3623,-955
2019,2,3,5,3256,4167,3275,-892
2019,2,3,6,3052,3826,3018,-808
2019,2,3,7,2853,3544,2801,-743
2019,2,3,8,2757,3393,2676,-717
2019,2,3,9,2713,3326,2610,-716
2019,2,3,10,2726,3351,2608,-743
2019,2,3,11,2804,3460,2697,-763
2019,2,3,12,2979,3686,2860,-826
2019,2,3,13,3214,4036,3140,-896
2019,2,3,14,3569,4537,3504,-1033
2019,2,3,15,3831,4987,3872,-1115
2019,2,3,16,3961,5166,4018,-1148
2019,2,3,17,4048,5268,4121,-1147
2019,2,3,18,4130,5329,4158,-1171
2019,2,3,19,4153,5350,4178,-1172
2019,2,3,20,4233,5330,4165,-1165
2019,2,3,21,4302,5320,4149,-1171
2019,2,3,22,4316,5383,4190,-1193
2019,2,3,23,4250,5506,4289,-1217
2019,2,4,0,4324,5677,4406,-1271
2019,2,4,1,4225,5517,4291,-1226
2019,2,4,2,4055,5268,4103,-1165
2019,2,4,3,3848,4943,3872,-1071
2019,2,4,4,3541,4623,3591,-1032
2019,2,4,5,3160,4137,3247,-890
2019,2,4,6,2913,3728,2915,-813
2019,2,4,7,2764,3468,2728,-740
2019,2,4,8,2687,3381,2621,-760
2019,2,4,9,2708,3368,2611,-757
2019,2,4,10,2822,3480,2677,-803
2019,2,4,11,3177,3855,2970,-885
2019,2,4,12,3785,4532,3469,-1063
2019,2,4,13,4128,4924,3867,-1057
2019,2,4,14,4161,5048,3952,-1096
2019,2,4,15,4138,5160,4074,-1086
2019,2,4,16,4135,5255,4001,-1254
2019,2,4,17,4168,5260,4129,-1131
2019,2,4,18,4207,5248,4064,-1184
2019,2,4,19,4202,5150,4109,-1041
2019,2,4,20,4187,5110,4071,-1039
2019,2,4,21,4220,5099,4038,-1061
2019,2,4,22,4238,5192,4174,-1018
2019,2,4,23,4299,5369,4288,-1081
2019,2,5,0,4569,5776,4589,-1187
2019,2,5,1,4590,5831,4631,-1200
2019,2,5,2,4389,5583,4423,-1160
2019,2,5,3,4054,5141,4084,-1057
2019,2,5,4,3651,4634,3645,-989
2019,2,5,5,3280,4177,3282,-895
2019,2,5,6,2971,3883,3040,-843
2019,2,5,7,2784,3713,2919,-794
2019,2,5,8,2708,3662,2865,-797
2019,2,5,9,2739,3669,2871,-798
2019,2,5,10,2855,3857,2994,-863
2019,2,5,11,3182,4332,3327,-1005
2019,2,5,12,3775,5168,3982,-1186
2019,2,5,13,4094,5606,4405,-1201
2019,2,5,14,4115,5504,4316,-1188
2019,2,5,15,4097,5294,4160,-1134
2019,2,5,16,4146,5122,4047,-1075
2019,2,5,17,4154,5096,4041,-1055
2019,2,5,18,4171,5130,4087,-1043
2019,2,5,19,4164,5224,4159,-1065
2019,2,5,20,4216,5292,4208,-1084
2019,2,5,21,4292,5388,4263,-1125
2019,2,5,22,4357,5518,4430,-1088
2019,2,5,23,4351,5616,4450,-1166
2019,2,6,0,4649,5863,4697,-1166
2019,2,6,1,4690,5910,4744,-1166
2019,2,6,2,4443,5618,4478,-1140
2019,2,6,3,4120,5155,4131,-1024
2019,2,6,4,3714,4622,3650,-972
2019,2,6,5,3345,4103,3205,-898
2019,2,6,6,2971,3724,2924,-800
2019,2,6,7,2808,3530,2763,-767
2019,2,6,8,2779,3477,2726,-751
2019,2,6,9,2802,3505,2728,-777
2019,2,6,10,2899,3663,2841,-822
2019,2,6,11,3246,4127,3183,-944
2019,2,6,12,3844,4889,3728,-1161
2019,2,6,13,4142,5327,4151,-1176
2019,2,6,14,4135,5246,4099,-1147
2019,2,6,15,4105,5107,4024,-1083
2019,2,6,16,4164,5106,4038,-1068
2019,2,6,17,4183,5159,4113,-1046
2019,2,6,18,4191,5281,4192,-1089
2019,2,6,19,4179,5392,4277,-1115
2019,2,6,20,4228,5562,4378,-1184
2019,2,6,21,4276,5715,4516,-1199
2019,2,6,22,4335,5799,4593,-1206
2019,2,6,23,4340,5842,4609,-1233
2019,2,7,0,4624,6023,4737,-1286
2019,2,7,1,4676,5997,4740,-1257
2019,2,7,2,4449,5683,4501,-1182
2019,2,7,3,4134,5236,4175,-1061
2019,2,7,4,3723,4637,3686,-951
2019,2,7,5,3339,4125,3251,-874
2019,2,7,6,3048,3731,2956,-775
2019,2,7,7,2845,3501,2757,-744
2019,2,7,8,2742,3365,2640,-725
2019,2,7,9,2674,3358,2635,-723
2019,2,7,10,2744,3479,2715,-764
2019,2,7,11,3055,3881,3010,-871
2019,2,7,12,3640,4594,3538,-1056
2019,2,7,13,3973,4982,3838,-1144
2019,2,7,14,4031,5038,3973,-1065
2019,2,7,15,4032,5044,3937,-1107
2019,2,7,16,4120,5171,4091,-1080
2019,2,7,17,4202,5316,4195,-1121
2019,2,7,18,4255,5501,4302,-1199
2019,2,7,19,4333,5697,4444,-1253
2019,2,7,20,4471,5849,4586,-1263
2019,2,7,21,4575,6018,4727,-1291
2019,2,7,22,4619,6110,4815,-1295
2019,2,7,23,4565,6099,4775,-1324
2019,2,8,0,4709,6169,4826,-1343
2019,2,8,1,4786,6121,4808,-1313
2019,2,8,2,4544,5783,4559,-1224
2019,2,8,3,4207,5341,4210,-1131
2019,2,8,4,3797,4743,3703,-1040
2019,2,8,5,3380,4189,3288,-901
2019,2,8,6,3081,3824,2998,-826
2019,2,8,7,2874,3567,2775,-792
2019,2,8,8,2734,3453,2680,-773
2019,2,8,9,2670,3401,2645,-756
2019,2,8,10,2755,3519,2712,-807
2019,2,8,11,3069,3892,3016,-876
2019,2,8,12,3597,4556,3511,-1045
2019,2,8,13,3951,4908,3791,-1117
2019,2,8,14,4037,5042,3897,-1145
2019,2,8,15,4034,5128,4013,-1115
2019,2,8,16,4073,5255,4098,-1157
2019,2,8,17,4178,5381,4200,-1181
2019,2,8,18,4267,5596,4425,-1171
2019,2,8,19,4328,5821,4697,-1124
2019,2,8,20,4392,6021,4850,-1171
2019,2,8,21,4479,6167,5001,-1166
2019,2,8,22,4505,6253,5079,-1174
2019,2,8,23,4405,6158,5081,-1077
2019,2,9,0,4547,6085,5019,-1066
2019,2,9,1,4492,5933,4923,-1010
2019,2,9,2,4314,5589,4562,-1027
2019,2,9,3,4021,5206,4232,-974
2019,2,9,4,3698,4760,3753,-1007
2019,2,9,5,3413,4303,3362,-941
2019,2,9,6,3141,4008,3176,-832
2019,2,9,7,2940,3747,2982,-765
2019,2,9,8,2846,3587,2842,-745
2019,2,9,9,2796,3502,2761,-741
2019,2,9,10,2804,3530,2772,-758
2019,2,9,11,2915,3638,2836,-802
2019,2,9,12,3132,3886,3005,-881
2019,2,9,13,3420,4276,3290,-986
2019,2,9,14,3773,4740,3654,-1086
2019,2,9,15,3981,5068,3907,-1161
2019,2,9,16,4068,5223,4047,-1176
2019,2,9,17,4119,5270,4129,-1141
2019,2,9,18,4119,5329,4156,-1173
2019,2,9,19,4188,5394,4238,-1156
2019,2,9,20,4162,5468,4312,-1156
2019,2,9,21,4098,5379,4291,-1088
2019,2,9,22,4086,5322,4249,-1073
2019,2,9,23,4085,5322,4232,-1090
2019,2,10,0,4178,5523,4434,-1089
2019,2,10,1,4150,5462,4370,-1092
2019,2,10,2,4012,5246,4161,-1085
2019,2,10,3,3825,4989,3910,-1079
2019,2,10,4,3564,4654,3628,-1026
2019,2,10,5,3269,4295,3361,-934
2019,2,10,6,3057,3889,3038,-851
2019,2,10,7,2877,3626,2826,-800
2019,2,10,8,2778,3509,2715,-794
2019,2,10,9,2745,3434,2661,-773
2019,2,10,10,2756,3434,2648,-786
2019,2,10,11,2855,3524,2722,-802
2019,2,10,12,3045,3723,2860,-863
2019,2,10,13,3278,4024,3079,-945
2019,2,10,14,3576,4523,3459,-1064
2019,2,10,15,3810,4943,3824,-1119
2019,2,10,16,3981,5166,4015,-1151
2019,2,10,17,4087,5299,4144,-1155
2019,2,10,18,4230,5401,4255,-1146
2019,2,10,19,4301,5428,4168,-1260
2019,2,10,20,4385,5467,4219,-1248
2019,2,10,21,4479,5482,4226,-1256
2019,2,10,22,4396,5554,4299,-1255
2019,2,10,23,4354,5623,4370,-1253
2019,2,11,0,4540,5861,4626,-1235
2019,2,11,1,4555,5889,4613,-1276
2019,2,11,2,4343,5594,4335,-1259
2019,2,11,3,3989,5209,4092,-1117
2019,2,11,4,3611,4669,3680,-989
2019,2,11,5,3256,4167,3274,-893
2019,2,11,6,3026,3790,2991,-799
2019,2,11,7,2823,3509,2766,-743
2019,2,11,8,2718,3389,2658,-731
2019,2,11,9,2682,3354,2620,-734
2019,2,11,10,2759,3438,2673,-765
2019,2,11,11,3047,3808,2931,-877
2019,2,11,12,3565,4463,3421,-1042
2019,2,11,13,3876,4812,3813,-999
2019,2,11,14,3981,4927,3857,-1070
2019,2,11,15,4131,5148,4033,-1115
2019,2,11,16,4334,5408,4248,-1160
2019,2,11,17,4557,5667,4490,-1177
2019,2,11,18,4774,5915,4656,-1259
2019,2,11,19,4973,6102,4865,-1237
2019,2,11,20,5062,6241,5075,-1166
2019,2,11,21,5116,6384,5137,-1247
2019,2,11,22,5147,6520,5303,-1217
2019,2,11,23,5081,6506,5255,-1251
2019,2,12,0,5156,6616,5324,-1292
2019,2,12,1,5089,6571,5297,-1274
2019,2,12,2,4848,6190,4993,-1197
2019,2,12,3,4468,5672,4632,-1040
2019,2,12,4,4038,5081,4047,-1034
2019,2,12,5,3627,4512,3584,-928
2019,2,12,6,3249,4067,3222,-845
2019,2,12,7,3008,3805,3000,-805
2019,2,12,8,2887,3645,2878,-767
2019,2,12,9,2822,3568,2789,-779
2019,2,12,10,2850,3640,2826,-814
2019,2,12,11,3090,3970,3070,-900
2019,2,12,12,3586,4634,3614,-1020
2019,2,12,13,3884,5015,3950,-1065
2019,2,12,14,4017,5171,4104,-1067
2019,2,12,15,4173,5397,4293,-1104
2019,2,12,16,4407,5723,4541,-1182
2019,2,12,17,4662,6032,4789,-1243
2019,2,12,18,4834,6333,5063,-1270
2019,2,12,19,4994,6579,5177,-1402
2019,2,12,20,5121,6749,5289,-1460
2019,2,12,21,5213,6771,5330,-1441
2019,2,12,22,5193,6592,5128,-1464
2019,2,12,23,5135,6498,5052,-1446
2019,2,13,0,5061,6617,5207,-1410
2019,2,13,1,5099,6563,5189,-1374
2019,2,13,2,4860,6233,5087,-1146
2019,2,13,3,4417,5778,4616,-1162
2019,2,13,4,3953,5190,4147,-1043
2019,2,13,5,3502,4572,3631,-941
2019,2,13,6,3219,4091,3257,-834
2019,2,13,7,3004,3760,3016,-744
2019,2,13,8,2842,3525,2797,-728
2019,2,13,9,2776,3470,2760,-710
2019,2,13,10,2806,3464,2717,-747
2019,2,13,11,3058,3778,2951,-827
2019,2,13,12,3555,4392,3437,-955
2019,2,13,13,3860,4797,3755,-1042
2019,2,13,14,3932,4957,3887,-1070
2019,2,13,15,4058,5108,3995,-1113
2019,2,13,16,4211,5209,4087,-1122
2019,2,13,17,4289,5260,4126,-1134
2019,2,13,18,4282,5257,4145,-1112
2019,2,13,19,4243,5172,4093,-1079
2019,2,13,20,4037,5149,4072,-1077
2019,2,13,21,4062,5144,4084,-1060
2019,2,13,22,4099,5311,4207,-1104
2019,2,13,23,4107,5484,4283,-1201
2019,2,14,0,4507,5965,4711,-1254
2019,2,14,1,4605,6153,4845,-1308
2019,2,14,2,4449,6106,4892,-1214
2019,2,14,3,4231,5929,4787,-1142
2019,2,14,4,3918,5577,4406,-1171
2019,2,14,5,3683,5156,3971,-1185
2019,2,14,6,3605,4909,3759,-1150
2019,2,14,7,3538,4801,3658,-1143
2019,2,14,8,3533,4867,3680,-1187
2019,2,14,9,3596,5007,3753,-1254
2019,2,14,10,3758,5328,4084,-1244
2019,2,14,11,4169,6046,4726,-1320
2019,2,14,12,4898,7017,5560,-1457
2019,2,14,13,5259,7473,6042,-1431
2019,2,14,14,5064,7065,5822,-1243
2019,2,14,15,4716,6372,5116,-1256
2019,2,14,16,4550,5735,4574,-1161
2019,2,14,17,4427,5300,4224,-1076
2019,2,14,18,4230,5050,4012,-1038
2019,2,14,19,4115,4950,3970,-980
2019,2,14,20,4100,4917,3984,-933
2019,2,14,21,4100,4921,3973,-948
2019,2,14,22,4100,5032,4040,-992
2019,2,14,23,4116,5145,4099,-1046
2019,2,15,0,4320,5502,4332,-1170
2019,2,15,1,4380,5610,4405,-1205
2019,2,15,2,4298,5405,4226,-1179
2019,2,15,3,4017,5087,3993,-1094
2019,2,15,4,3637,4637,3638,-999
2019,2,15,5,3309,4204,3253,-951
2019,2,15,6,3021,3916,3032,-884
2019,2,15,7,2874,3745,2874,-871
2019,2,15,8,2840,3682,2835,-847
2019,2,15,9,2854,3720,2843,-877
2019,2,15,10,2952,3888,2947,-941
2019,2,15,11,3261,4375,3270,-1105
2019,2,15,12,3823,5127,3886,-1241
2019,2,15,13,4141,5552,4240,-1312
2019,2,15,14,4186,5523,4281,-1242
2019,2,15,15,4157,5338,4157,-1181
2019,2,15,16,4163,5261,4128,-1133
2019,2,15,17,4200,5229,4147,-1082
2019,2,15,18,4164,5274,4193,-1081
2019,2,15,19,4130,5323,4259,-1064
2019,2,15,20,4123,5355,4311,-1044
2019,2,15,21,4143,5411,4348,-1063
2019,2,15,22,4223,5451,4392,-1059
2019,2,15,23,4201,5415,4318,-1097
2019,2,16,0,4325,5555,4423,-1132
2019,2,16,1,4302,5553,4413,-1140
2019,2,16,2,4094,5284,4198,-1086
2019,2,16,3,3845,4955,3933,-1022
2019,2,16,4,3528,4542,3590,-952
2019,2,16,5,3217,4145,3278,-867
2019,2,16,6,2957,3799,3005,-794
2019,2,16,7,2758,3596,2805,-791
2019,2,16,8,2669,3504,2745,-759
2019,2,16,9,2648,3477,2713,-764
2019,2,16,10,2693,3539,2754,-785
2019,2,16,11,2793,3702,2870,-832
2019,2,16,12,3049,4044,3150,-894
2019,2,16,13,3341,4369,3373,-996
2019,2,16,14,3670,4738,3671,-1067
2019,2,16,15,3860,4928,3860,-1068
2019,2,16,16,3958,5064,3981,-1083
2019,2,16,17,4025,5183,4095,-1088
2019,2,16,18,4070,5285,4174,-1111
2019,2,16,19,4094,5338,4222,-1116
2019,2,16,20,4176,5404,4285,-1119
2019,2,16,21,4274,5456,4216,-1240
2019,2,16,22,4333,5490,4436,-1054
2019,2,16,23,4265,5447,4372,-1075
2019,2,17,0,4375,5559,4459,-1100
2019,2,17,1,4402,5560,4443,-1117
2019,2,17,2,4154,5297,4209,-1088
2019,2,17,3,3886,4982,3946,-1036
2019,2,17,4,3563,4609,3631,-978
2019,2,17,5,3197,4188,3332,-856
2019,2,17,6,3020,3859,3080,-779
2019,2,17,7,2789,3567,2836,-731
2019,2,17,8,2670,3417,2706,-711
2019,2,17,9,2626,3341,2660,-681
2019,2,17,10,2655,3325,2627,-698
2019,2,17,11,2729,3406,2688,-718
2019,2,17,12,2867,3650,2876,-774
2019,2,17,13,3100,3962,3098,-864
2019,2,17,14,3462,4468,3503,-965
2019,2,17,15,3824,4939,3878,-1061
2019,2,17,16,4074,5282,4144,-1138
2019,2,17,17,4309,5589,4429,-1160
2019,2,17,18,4530,5897,4705,-1192
2019,2,17,19,4691,6229,5081,-1148
2019,2,17,20,4892,6424,5322,-1102
2019,2,17,21,5023,6599,5459,-1140
2019,2,17,22,5033,6642,5516,-1126
2019,2,17,23,4918,6616,5469,-1147
2019,2,18,0,4982,6563,5401,-1162
2019,2,18,1,4960,6498,5377,-1121
2019,2,18,2,4704,6137,4986,-1151
2019,2,18,3,4388,5651,4520,-1131
2019,2,18,4,3969,5093,4051,-1042
2019,2,18,5,3512,4511,3606,-905
2019,2,18,6,3252,4052,3250,-802
2019,2,18,7,3020,3740,2994,-746
2019,2,18,8,2887,3564,2865,-699
2019,2,18,9,2829,3488,2786,-702
2019,2,18,10,2902,3546,2828,-718
2019,2,18,11,3115,3806,3038,-768
2019,2,18,12,3481,4260,3390,-870
2019,2,18,13,3785,4683,3708,-975
2019,2,18,14,4040,5075,4063,-1012
2019,2,18,15,4414,5482,4272,-1210
2019,2,18,16,4694,5855,4439,-1416
2019,2,18,17,5002,6258,4696,-1562
2019,2,18,18,5224,6623,4949,-1674
2019,2,18,19,5358,6969,5316,-1653
2019,2,18,20,5503,7278,5622,-1656
2019,2,18,21,5628,7393,5543,-1850
2019,2,18,22,5594,7472,5560,-1912
2019,2,18,23,5432,7417,5544,-1873
2019,2,19,0,5450,7355,5505,-1850
2019,2,19,1,5374,7231,5509,-1722
2019,2,19,2,5074,6683,5117,-1566
2019,2,19,3,4665,6069,4771,-1298
2019,2,19,4,4183,5333,4177,-1156
2019,2,19,5,3669,4655,3716,-939
2019,2,19,6,3314,4174,3313,-861
2019,2,19,7,3062,3863,3074,-789
2019,2,19,8,2917,3653,2899,-754
2019,2,19,9,2853,3559,2844,-715
2019,2,19,10,2890,3600,2851,-749
2019,2,19,11,3131,3920,3090,-830
2019,2,19,12,3594,4543,3586,-957
2019,2,19,13,3856,4879,3928,-951
2019,2,19,14,4000,5057,4021,-1036
2019,2,19,15,4162,5277,4197,-1080
2019,2,19,16,4396,5643,4461,-1182
2019,2,19,17,4620,6022,4691,-1331
2019,2,19,18,4890,6479,4931,-1548
2019,2,19,19,5096,6893,5255,-1638
2019,2,19,20,5248,7196,5536,-1660
2019,2,19,21,5252,7449,5774,-1675
2019,2,19,22,5277,7527,5946,-1581
2019,2,19,23,5251,7373,5823,-1550
2019,2,20,0,5086,7333,5764,-1569
2019,2,20,1,5109,7180,5648,-1532
2019,2,20,2,4839,6742,5309,-1433
2019,2,20,3,4443,6160,4803,-1357
2019,2,20,4,3994,5502,4289,-1213
2019,2,20,5,3609,4869,3830,-1039
2019,2,20,6,3369,4379,3494,-885
2019,2,20,7,3119,4057,3236,-821
2019,2,20,8,2971,3859,3073,-786
2019,2,20,9,2912,3773,2998,-775
2019,2,20,10,2936,3815,3009,-806
2019,2,20,11,3178,4141,3258,-883
2019,2,20,12,3635,4748,3738,-1010
2019,2,20,13,3911,5088,4083,-1005
2019,2,20,14,4068,5352,4297,-1055
2019,2,20,15,4283,5686,4572,-1114
2019,2,20,16,4559,6094,4797,-1297
2019,2,20,17,4849,6457,5031,-1426
2019,2,20,18,5055,6764,5069,-1695
2019,2,20,19,5355,7033,5319,-1714
2019,2,20,20,5516,7253,5509,-1744
2019,2,20,21,5574,7400,5591,-1809
2019,2,20,22,5634,7466,5647,-1819
2019,2,20,23,5584,7323,5511,-1812
2019,2,21,0,5418,7316,5530,-1786
2019,2,21,1,5318,7237,5446,-1791
2019,2,21,2,5038,6810,5118,-1692
2019,2,21,3,4635,6248,4906,-1342
2019,2,21,4,4196,5586,4373,-1213
2019,2,21,5,3786,4940,3896,-1044
2019,2,21,6,3489,4437,3528,-909
2019,2,21,7,3228,4093,3260,-833
2019,2,21,8,3073,3873,3086,-787
2019,2,21,9,2983,3764,3003,-761
2019,2,21,10,3017,3791,3002,-789
2019,2,21,11,3250,4060,3210,-850
2019,2,21,12,3705,4661,3660,-1001
2019,2,21,13,3968,4958,3885,-1073
2019,2,21,14,4153,5283,4143,-1140
2019,2,21,15,4410,5650,4349,-1301
2019,2,21,16,4713,6070,4618,-1452
2019,2,21,17,5001,6452,4750,-1702
2019,2,21,18,5322,6826,4987,-1839
2019,2,21,19,5618,6958,4967,-1991
2019,2,21,20,5837,7104,5079,-2025
2019,2,21,21,5917,7338,5457,-1881
2019,2,21,22,5939,7473,5392,-2081
2019,2,21,23,5776,7416,5277,-2139
2019,2,22,0,5614,7292,5150,-2142
2019,2,22,1,5494,7189,4973,-2216
2019,2,22,2,5176,6724,4708,-2016
2019,2,22,3,4776,6239,4541,-1698
2019,2,22,4,4311,5628,4097,-1531
2019,2,22,5,3845,4940,3670,-1270
2019,2,22,6,3542,4392,3314,-1078
2019,2,22,7,3271,4096,3058,-1038
2019,2,22,8,3103,3891,2897,-994
2019,2,22,9,3025,3786,2817,-969
2019,2,22,10,3046,3839,2849,-990
2019,2,22,11,3273,4110,3032,-1078
2019,2,22,12,3720,4678,3466,-1212
2019,2,22,13,3992,5009,3777,-1232
2019,2,22,14,4212,5359,4054,-1305
2019,2,22,15,4499,5819,4356,-1463
2019,2,22,16,4841,6350,4774,-1576
2019,2,22,17,5134,6770,4848,-1922
2019,2,22,18,5427,7245,5112,-2133
2019,2,22,19,5648,7628,5350,-2278
2019,2,22,20,5861,7908,5635,-2273
2019,2,22,21,5926,8087,5921,-2166
2019,2,22,22,5969,8075,5869,-2206
2019,2,22,23,5737,7828,5663,-2165
2019,2,23,0,5596,7476,5339,-2137
2019,2,23,1,5287,7208,5105,-2103
2019,2,23,2,5007,6761,4779,-1982
2019,2,23,3,4675,6266,4631,-1635
2019,2,23,4,4317,5737,4171,-1566
2019,2,23,5,3936,5156,3829,-1327
2019,2,23,6,3654,4694,3554,-1140
2019,2,23,7,3375,4338,3267,-1071
2019,2,23,8,3180,4103,3086,-1017
2019,2,23,9,3077,3972,2991,-981
2019,2,23,10,3030,3948,2952,-996
2019,2,23,11,3075,4019,2996,-1023
2019,2,23,12,3252,4262,3211,-1051
2019,2,23,13,3489,4586,3490,-1096
2019,2,23,14,3920,5232,4082,-1150
2019,2,23,15,4386,5897,4411,-1486
2019,2,23,16,4766,6512,4948,-1564
2019,2,23,17,5089,7049,5450,-1599
2019,2,23,18,5364,7511,5601,-1910
2019,2,23,19,5567,7795,5552,-2243
2019,2,23,20,5762,8049,5610,-2439
2019,2,23,21,5865,8159,5697,-2462
2019,2,23,22,5812,8127,5752,-2375
2019,2,23,23,5603,7885,5543,-2342
2019,2,24,0,5483,7508,5354,-2154
2019,2,24,1,5293,7258,5079,-2179
2019,2,24,2,5024,6814,4891,-1923
2019,2,24,3,4688,6348,4797,-1551
2019,2,24,4,4352,5827,4270,-1557
2019,2,24,5,3954,5288,3964,-1324
2019,2,24,6,3559,4632,3469,-1163
2019,2,24,7,3271,4409,3324,-1085
2019,2,24,8,3121,4167,3136,-1031
2019,2,24,9,3014,4007,3017,-990
2019,2,24,10,2972,3930,2946,-984
2019,2,24,11,3028,3966,2966,-1000
2019,2,24,12,3135,4148,3095,-1053
2019,2,24,13,3332,4487,3339,-1148
2019,2,24,14,3810,5107,3778,-1329
2019,2,24,15,4297,5703,4116,-1587
2019,2,24,16,4713,6251,4438,-1813
2019,2,24,17,5109,6791,4743,-2048
2019,2,24,18,5364,7195,5020,-2175
2019,2,24,19,5571,7456,5189,-2267
2019,2,24,20,5748,7601,5115,-2486
2019,2,24,21,5820,7689,5189,-2500
2019,2,24,22,5727,7610,5135,-2475
2019,2,24,23,5509,7372,5039,-2333
2019,2,25,0,5486,7172,4833,-2339
2019,2,25,1,5395,7003,4655,-2348
2019,2,25,2,5042,6497,4455,-2042
2019,2,25,3,4597,5968,4400,-1568
2019,2,25,4,4129,5326,3902,-1424
2019,2,25,5,3547,4693,3488,-1205
2019,2,25,6,3193,4165,3134,-1031
2019,2,25,7,2982,3820,3030,-790
2019,2,25,8,2753,3617,2869,-748
2019,2,25,9,2707,3481,2756,-725
2019,2,25,10,2728,3480,2735,-745
2019,2,25,11,2981,3819,2972,-847
2019,2,25,12,3448,4395,3416,-979
2019,2,25,13,3809,4730,3729,-1001
2019,2,25,14,3937,4858,3849,-1009
2019,2,25,15,4167,4972,3936,-1036
2019,2,25,16,4122,5046,4002,-1044
2019,2,25,17,4199,5122,4072,-1050
2019,2,25,18,4272,5226,4173,-1053
2019,2,25,19,4341,5377,4313,-1064
2019,2,25,20,4395,5540,4444,-1096
2019,2,25,21,4376,5706,4577,-1129
2019,2,25,22,4406,5812,4671,-1141
2019,2,25,23,4355,5848,4694,-1154
2019,2,26,0,4502,5977,4719,-1258
2019,2,26,1,4557,6094,4845,-1249
2019,2,26,2,4282,5761,4596,-1165
2019,2,26,3,4158,5280,4211,-1069
2019,2,26,4,3683,4703,3762,-941
2019,2,26,5,3236,4153,3287,-866
2019,2,26,6,2887,3753,2951,-802
2019,2,26,7,2662,3536,2768,-768
2019,2,26,8,2528,3404,2671,-733
2019,2,26,9,2563,3382,2639,-743
2019,2,26,10,2621,3492,2719,-773
2019,2,26,11,2896,3859,3173,-686
2019,2,26,12,3504,4503,3692,-811
2019,2,26,13,3782,4846,4030,-816
2019,2,26,14,3899,4956,3946,-1010
2019,2,26,15,4001,5110,4058,-1052
2019,2,26,16,4088,5259,4175,-1084
2019,2,26,17,4120,5341,4267,-1074
2019,2,26,18,4159,5370,4268,-1102
2019,2,26,19,4148,5326,4272,-1054
2019,2,26,20,4153,5253,4188,-1065
2019,2,26,21,4087,5261,4192,-1069
2019,2,26,22,4153,5355,4252,-1103
2019,2,26,23,4206,5519,4344,-1175
2019,2,27,0,4293,5785,4531,-1254
2019,2,27,1,4328,5795,4538,-1257
2019,2,27,2,4204,5537,4348,-1189
2019,2,27,3,3892,5138,4108,-1030
2019,2,27,4,3608,4635,3709,-926
2019,2,27,5,3196,4141,3332,-809
2019,2,27,6,2974,3781,2968,-813
2019,2,27,7,2787,3571,2845,-726
2019,2,27,8,2687,3455,2719,-736
2019,2,27,9,2665,3431,2696,-735
2019,2,27,10,2758,3520,2749,-771
2019,2,27,11,2986,3879,2970,-909
2019,2,27,12,3483,4501,3425,-1076
2019,2,27,13,3779,4821,3701,-1120
2019,2,27,14,3901,4925,3756,-1169
2019,2,27,15,4013,5115,3825,-1290
2019,2,27,16,4143,5327,4050,-1277
2019,2,27,17,4238,5590,4270,-1320
2019,2,27,18,4321,5897,4366,-1531
2019,2,27,19,4395,6044,4293,-1751
2019,2,27,20,4450,6139,4432,-1707
2019,2,27,21,4516,6132,4416,-1716
2019,2,27,22,4581,6000,4402,-1598
2019,2,27,23,4577,5936,4322,-1614
2019,2,28,0,4689,6006,4352,-1654
2019,2,28,1,4781,6081,4400,-1681
2019,2,28,2,4560,5815,4201,-1614
2019,2,28,3,4235,5394,3748,-1646
2019,2,28,4,3826,4858,3231,-1627
2019,2,28,5,3389,4285,2992,-1293
2019,2,28,6,3114,3882,2869,-1013
2019,2,28,7,2907,3628,2664,-964
2019,2,28,8,2810,3483,2560,-923
2019,2,28,9,2767,3434,2526,-908
2019,2,28,10,2819,3488,2504,-984
2019,2,28,11,3050,3826,2735,-1091
2019,2,28,12,3516,4424,3176,-1248
2019,2,28,13,3803,4750,3531,-1219
2019,2,28,14,3958,4925,3643,-1282
2019,2,28,15,4101,5052,3749,-1303
2019,2,28,16,4317,5214,3865,-1349
2019,2,28,17,4480,5405,4017,-1388
2019,2,28,18,4621,5669,4213,-1456
2019,2,28,19,4745,6006,4523,-1483
2019,2,28,20,4866,6238,4720,-1518
2019,2,28,21,4982,6413,4981,-1432
2019,2,28,22,5039,6485,5121,-1364
2019,2,28,23,4960,6410,4889,-1521
2019,3,1,0,4919,6317,4780,-1537
2019,3,1,1,5016,6321,4870,-1451
2019,3,1,2,4774,6206,4888,-1318
2019,3,1,3,4421,5534,4241,-1293
2019,3,1,4,4004,4948,3653,-1295
2019,3,1,5,3567,4357,3206,-1151
2019,3,1,6,3125,3932,2922,-1010
2019,3,1,7,2889,3653,2697,-956
2019,3,1,8,2757,3481,2549,-932
2019,3,1,9,2723,3415,2491,-924
2019,3,1,10,2772,3481,2506,-975
2019,3,1,11,2989,3809,2772,-1037
2019,3,1,12,3436,4440,3250,-1190
2019,3,1,13,3707,4803,3559,-1244
2019,3,1,14,3887,4974,3686,-1288
2019,3,1,15,4037,5153,3838,-1315
2019,3,1,16,4256,5378,3670,-1708
2019,3,1,17,4478,5692,3889,-1803
2019,3,1,18,4717,6100,4082,-2018
2019,3,1,19,4888,6480,4269,-2211
2019,3,1,20,5045,6784,4511,-2273
2019,3,1,21,5158,6975,4713,-2262
2019,3,1,22,5170,6875,4688,-2187
2019,3,1,23,5076,6619,4436,-2183
2019,3,2,0,4761,6506,4435,-2071
2019,3,2,1,4791,6392,4405,-1987
2019,3,2,2,4592,5961,4117,-1844
2019,3,2,3,4307,5537,4036,-1501
2019,3,2,4,3942,5033,3717,-1316
2019,3,2,5,3546,4508,3359,-1149
2019,3,2,6,3147,4063,3048,-1015
2019,3,2,7,2900,3750,2785,-965
2019,3,2,8,2798,3531,2621,-910
2019,3,2,9,2738,3443,2547,-896
2019,3,2,10,2732,3421,2513,-908
2019,3,2,11,2771,3510,2570,-940
2019,3,2,12,2960,3757,2752,-1005
2019,3,2,13,3162,4128,3061,-1067
2019,3,2,14,3589,4647,3411,-1236
2019,3,2,15,4003,5141,3795,-1346
2019,3,2,16,4246,5532,3740,-1792
2019,3,2,17,4499,5935,4106,-1829
2019,3,2,18,4606,6360,4479,-1881
2019,3,2,19,4739,6664,4604,-2060
2019,3,2,20,4813,6846,4693,-2153
2019,3,2,21,4934,6942,4841,-2101
2019,3,2,22,4939,6979,4889,-2090
2019,3,2,23,4883,6836,4771,-2065
2019,3,3,0,4768,6587,4564,-2023
2019,3,3,1,4709,6411,4466,-1945
2019,3,3,2,4512,6002,4189,-1813
2019,3,3,3,4194,5553,4032,-1521
2019,3,3,4,3858,5073,3791,-1282
2019,3,3,5,3441,4528,3300,-1228
2019,3,3,6,3178,4085,3058,-1027
2019,3,3,7,2926,3787,2830,-957
2019,3,3,8,2749,3609,2684,-925
2019,3,3,9,2678,3474,2577,-897
2019,3,3,10,2639,3458,2554,-904
2019,3,3,11,2684,3505,2572,-933
2019,3,3,12,2808,3681,2699,-982
2019,3,3,13,3069,4003,2955,-1048
2019,3,3,14,3541,4611,3343,-1268
2019,3,3,15,3966,5177,3844,-1333
2019,3,3,16,4268,5620,3875,-1745
2019,3,3,17,4544,6046,3954,-2092
2019,3,3,18,4796,6549,4164,-2385
2019,3,3,19,5035,6889,4476,-2413
2019,3,3,20,5208,7153,4655,-2498
2019,3,3,21,5247,7324,4819,-2505
2019,3,3,22,5177,7375,5412,-1963
2019,3,3,23,5074,7206,5424,-1782
2019,3,4,0,5075,6972,5177,-1795
2019,3,4,1,5082,6878,5110,-1768
2019,3,4,2,4854,6432,4735,-1697
2019,3,4,3,4462,5906,4388,-1518
2019,3,4,4,3934,5279,3941,-1338
2019,3,4,5,3557,4630,3421,-1209
2019,3,4,6,3276,4197,3127,-1070
2019,3,4,7,3033,3906,2914,-992
2019,3,4,8,2888,3783,2830,-953
2019,3,4,9,2838,3742,2782,-960
2019,3,4,10,2860,3779,2808,-971
2019,3,4,11,3117,4118,3043,-1075
2019,3,4,12,3571,4732,3594,-1138
2019,3,4,13,3884,5047,3890,-1157
2019,3,4,14,4068,5353,4042,-1311
2019,3,4,15,4328,5721,4084,-1637
2019,3,4,16,4517,6146,4466,-1680
2019,3,4,17,4675,6441,5003,-1438
2019,3,4,18,4810,6655,5316,-1339
2019,3,4,19,4909,6729,5420,-1309
2019,3,4,20,4967,6792,5479,-1313
2019,3,4,21,4982,6836,5545,-1291
2019,3,4,22,4910,6786,5545,-1241
2019,3,4,23,4840,6669,5403,-1266
2019,3,5,0,4881,6588,5265,-1323
2019,3,5,1,4942,6538,5196,-1342
2019,3,5,2,4634,6124,4747,-1377
2019,3,5,3,4200,5573,4257,-1316
2019,3,5,4,3862,4982,3782,-1200
2019,3,5,5,3333,4394,3286,-1108
2019,3,5,6,2987,4004,3130,-874
2019,3,5,7,2745,3753,2930,-823
2019,3,5,8,2560,3629,2829,-800
2019,3,5,9,2571,3584,2786,-798
2019,3,5,10,2582,3670,2832,-838
2019,3,5,11,2938,4027,3081,-946
2019,3,5,12,3476,4663,3586,-1077
2019,3,5,13,3814,5018,4029,-989
2019,3,5,14,3814,5239,4270,-969
2019,3,5,15,3864,5416,4366,-1050
2019,3,5,16,3975,5551,4481,-1070
2019,3,5,17,4019,5468,4492,-976
2019,3,5,18,4079,5443,4452,-991
2019,3,5,19,4043,5368,4417,-951
2019,3,5,20,4058,5273,4420,-853
2019,3,5,21,4158,5206,4277,-929
2019,3,5,22,4193,5240,4306,-934
2019,3,5,23,4335,5445,4511,-934
2019,3,6,0,4517,5917,4842,-1075
2019,3,6,1,4589,6262,5082,-1180
2019,3,6,2,4510,6137,5017,-1120
2019,3,6,3,4366,5844,4840,-1004
2019,3,6,4,4056,5419,4541,-878
2019,3,6,5,3864,4973,3992,-981
2019,3,6,6,3716,4731,3802,-929
2019,3,6,7,3650,4653,3664,-989
2019,3,6,8,3705,4707,3729,-978
2019,3,6,9,3822,4849,3819,-1030
2019,3,6,10,3962,5156,4034,-1122
2019,3,6,11,4487,5848,4598,-1250
2019,3,6,12,5308,6906,5496,-1410
2019,3,6,13,5762,7476,6077,-1399
2019,3,6,14,5489,7264,5925,-1339
2019,3,6,15,5286,6876,5503,-1373
2019,3,6,16,4910,6443,5216,-1227
2019,3,6,17,4567,6009,4918,-1091
2019,3,6,18,4441,5637,4541,-1096
2019,3,6,19,4345,5340,4240,-1100
2019,3,6,20,4321,5111,4032,-1079
2019,3,6,21,4337,5037,3971,-1066
2019,3,6,22,4363,5110,4024,-1086
2019,3,6,23,4477,5371,4348,-1023
2019,3,7,0,4789,5907,4855,-1052
2019,3,7,1,5090,6428,5263,-1165
2019,3,7,2,5119,6484,5367,-1117
2019,3,7,3,4987,6385,5203,-1182
2019,3,7,4,4713,6052,4879,-1173
2019,3,7,5,4341,5706,4577,-1129
2019,3,7,6,4132,5561,4405,-1156
2019,3,7,7,4062,5566,4389,-1177
2019,3,7,8,4089,5681,4417,-1264
2019,3,7,9,4136,5829,4506,-1323
2019,3,7,10,4317,6147,4756,-1391
2019,3,7,11,4822,6818,5282,-1536
2019,3,7,12,5517,7697,6164,-1533
2019,3,7,13,5778,7884,6333,-1551
2019,3,7,14,5400,7250,5814,-1436
2019,3,7,15,5030,6488,5254,-1234
2019,3,7,16,4741,5864,4808,-1056
2019,3,7,17,4588,5431,4336,-1095
2019,3,7,18,4260,5181,4108,-1073
2019,3,7,19,4135,5021,3971,-1050
2019,3,7,20,4096,4969,3929,-1040
2019,3,7,21,4098,5001,3924,-1077
2019,3,7,22,4144,5109,3926,-1183
2019,3,7,23,4219,5213,3840,-1373
2019,3,8,0,4304,5446,4079,-1367
2019,3,8,1,4473,5696,4358,-1338
2019,3,8,2,4438,5542,4251,-1291
2019,3,8,3,4158,5211,3960,-1251
2019,3,8,4,3804,4789,3533,-1256
2019,3,8,5,3464,4355,3157,-1198
2019,3,8,6,3222,4088,2939,-1149
2019,3,8,7,3085,3976,2926,-1050
2019,3,8,8,3043,3975,2907,-1068
2019,3,8,9,3050,4044,2936,-1108
2019,3,8,10,3177,4245,3076,-1169
2019,3,8,11,3522,4712,3472,-1240
2019,3,8,12,4091,5502,3953,-1549
2019,3,8,13,4369,5822,4232,-1590
2019,3,8,14,4301,5594,4122,-1472
2019,3,8,15,4212,5308,3871,-1437
2019,3,8,16,4181,5177,3726,-1451
2019,3,8,17,4139,5128,3641,-1487
2019,3,8,18,4124,5179,3685,-1494
2019,3,8,19,4169,5237,3750,-1487
2019,3,8,20,4195,5327,3808,-1519
2019,3,8,21,4290,5485,3934,-1551
2019,3,8,22,4321,5601,4053,-1548
2019,3,8,23,4253,5552,4028,-1524
2019,3,9,0,4294,5565,3998,-1567
2019,3,9,1,4346,5592,4029,-1563
2019,3,9,2,4162,5326,3804,-1522
2019,3,9,3,3926,5004,3658,-1346
2019,3,9,4,3637,4603,3507,-1096
2019,3,9,5,3178,4177,3303,-874
2019,3,9,6,2871,3824,3034,-790
2019,3,9,7,2671,3575,2814,-761
2019,3,9,8,2528,3451,2706,-745
2019,3,9,9,2521,3408,2663,-745
2019,3,9,10,2547,3449,2679,-770
2019,3,9,11,2642,3620,2792,-828
2019,3,9,12,2887,3911,2990,-921
2019,3,9,13,3157,4313,3305,-1008
2019,3,9,14,3570,4717,3638,-1079
2019,3,9,15,3895,4985,3700,-1285
2019,3,9,16,4049,5210,3827,-1383
2019,3,9,17,4168,5424,3918,-1506
2019,3,9,18,4284,5657,4126,-1531
2019,3,9,19,4409,5861,4367,-1494
2019,3,9,20,4572,6068,4559,-1509
2019,3,9,21,4698,6202,4671,-1531
2019,3,9,22,4792,6301,4787,-1514
2019,3,9,23,4789,6169,4660,-1509
2019,3,10,0,4677,6082,4595,-1487
2019,3,10,1,4665,6084,4562,-1522
2019,3,10,2,4513,5765,4218,-1547
2019,3,10,3,4217,5434,3984,-1450
2019,3,10,4,3846,4979,3809,-1170
2019,3,10,5,3555,4502,3602,-900
2019,3,10,6,-9999,4502,3602,-9999
2019,3,10,7,-9999,3575,2814,-9999
2019,3,10,8,-9999,3451,2706,-9999
2019,3,10,9,-9999,3408,2663,-9999
2019,3,10,10,-9999,3449,2679,-9999
2019,3,10,11,-9999,3620,2792,-9999
2019,3,10,12,-9999,3911,2990,-9999
2019,3,10,13,-9999,4313,3305,-9999
2019,3,10,14,-9999,4717,3638,-9999
2019,3,10,15,-9999,4985,3700,-9999
2019,3,10,16,-9999,5210,3827,-9999
2019,3,10,17,-9999,5424,3918,-9999
2019,3,10,18,-9999,5657,4126,-9999
2019,3,10,19,-9999,5861,4367,-9999
2019,3,10,20,-9999,6068,4559,-9999
2019,3,10,21,-9999,6202,4671,-9999
2019,3,10,22,-9999,6301,4787,-9999
2019,3,10,23,-9999,6169,4660,-9999
2019,3,11,0,-9999,6082,4595,-9999
2019,3,11,1,-9999,6084,4562,-9999
2019,3,11,2,-9999,5765,4218,-9999
2019,3,11,3,-9999,5434,3984,-9999
2019,3,11,4,-9999,4979,3809,-9999
2019,3,11,5,3401,4412,3505,-907
2019,3,11,6,3100,3992,3168,-824
2019,3,11,7,2927,3732,2973,-759
2019,3,11,8,2853,3616,2865,-751
2019,3,11,9,2891,3631,2870,-761
2019,3,11,10,3121,3926,3088,-838
2019,3,11,11,3547,4434,3493,-941
2019,3,11,12,3843,4810,3870,-940
2019,3,11,13,3953,4940,3967,-973
2019,3,11,14,4222,5151,4137,-1014
2019,3,11,15,4549,5517,4254,-1263
2019,3,11,16,4808,5958,4444,-1514
2019,3,11,17,5083,6445,4927,-1518
2019,3,11,18,5341,6872,5358,-1514
2019,3,11,19,5534,7224,5687,-1537
2019,3,11,20,5717,7546,5924,-1622
2019,3,11,21,5788,7812,6269,-1543
2019,3,11,22,5827,7891,6346,-1545
2019,3,11,23,5789,7642,6145,-1497
2019,3,12,0,5628,7354,5908,-1446
2019,3,12,1,5434,7168,5700,-1468
2019,3,12,2,5028,6556,5032,-1524
2019,3,12,3,4507,5781,4320,-1461
2019,3,12,4,3961,5006,3800,-1206
2019,3,12,5,3496,4372,3448,-924
2019,3,12,6,3170,3954,3088,-866
2019,3,12,7,2918,3716,2915,-801
2019,3,12,8,2931,3605,2807,-798
2019,3,12,9,2960,3631,2804,-827
2019,3,12,10,3184,3880,2978,-902
2019,3,12,11,3607,4420,3391,-1029
2019,3,12,12,3895,4816,3799,-1017
2019,3,12,13,3988,4956,3965,-991
2019,3,12,14,4155,5134,3986,-1148
2019,3,12,15,4397,5309,3966,-1343
2019,3,12,16,4542,5452,4080,-1372
2019,3,12,17,4682,5611,4211,-1400
2019,3,12,18,4781,5721,4286,-1435
2019,3,12,19,4894,5807,4361,-1446
2019,3,12,20,5024,5907,4416,-1491
2019,3,12,21,5068,6075,4532,-1543
2019,3,12,22,5075,6185,4658,-1527
2019,3,12,23,4967,6130,4608,-1522
2019,3,13,0,4975,6127,4609,-1518
2019,3,13,1,4928,6113,4601,-1512
2019,3,13,2,4540,5665,4211,-1454
2019,3,13,3,4084,5099,3905,-1194
2019,3,13,4,3576,4470,3492,-978
2019,3,13,5,3238,3939,3091,-848
2019,3,13,6,2984,3620,2832,-788
2019,3,13,7,2841,3439,2684,-755
2019,3,13,8,2786,3384,2629,-755
2019,3,13,9,2813,3420,2651,-769
2019,3,13,10,3056,3736,2894,-842
2019,3,13,11,3480,4327,3430,-897
2019,3,13,12,3770,4699,3810,-889
2019,3,13,13,3862,4791,3909,-882
2019,3,13,14,4020,4905,3735,-1170
2019,3,13,15,4244,5119,3812,-1307
2019,3,13,16,4430,5276,3935,-1341
2019,3,13,17,4552,5446,4068,-1378
2019,3,13,18,4700,5711,4267,-1444
2019,3,13,19,4852,5973,4484,-1489
2019,3,13,20,5016,6245,4665,-1580
2019,3,13,21,5076,6483,4871,-1612
2019,3,13,22,5118,6654,5042,-1612
2019,3,13,23,4917,6565,5011,-1554
2019,3,14,0,4934,6388,4897,-1491
2019,3,14,1,4914,6379,4870,-1509
2019,3,14,2,4542,5925,4433,-1492
2019,3,14,3,4092,5288,4042,-1246
2019,3,14,4,3606,4618,3605,-1013
2019,3,14,5,3225,4146,3303,-843
2019,3,14,6,2963,3818,3045,-773
2019,3,14,7,2833,3641,2891,-750
2019,3,14,8,2774,3546,2804,-742
2019,3,14,9,2818,3584,2831,-753
2019,3,14,10,3049,3861,3041,-820
2019,3,14,11,3513,4417,3459,-958
2019,3,14,12,3808,4787,3792,-995
2019,3,14,13,3887,4911,3906,-1005
2019,3,14,14,4072,5137,3922,-1215
2019,3,14,15,4320,5445,4076,-1369
2019,3,14,16,4531,5727,4290,-1437
2019,3,14,17,4773,6040,4632,-1408
2019,3,14,18,5009,6356,4909,-1447
2019,3,14,19,5214,6689,5269,-1420
2019,3,14,20,5422,7029,5518,-1511
2019,3,14,21,5529,7334,5760,-1574
2019,3,14,22,5582,7497,5869,-1628
2019,3,14,23,5514,7310,5728,-1582
2019,3,15,0,5395,6966,5459,-1507
2019,3,15,1,5262,6802,5301,-1501
2019,3,15,2,4887,6276,4806,-1470
2019,3,15,3,4415,5628,4309,-1319
2019,3,15,4,3900,4918,3882,-1036
2019,3,15,5,3508,4284,3394,-890
2019,3,15,6,3202,3888,3048,-840
2019,3,15,7,3031,3653,2871,-782
2019,3,15,8,2933,3547,2770,-777
2019,3,15,9,2952,3579,2802,-777
2019,3,15,10,3152,3821,2983,-838
2019,3,15,11,3561,4295,3335,-960
2019,3,15,12,3858,4658,3671,-987
2019,3,15,13,3977,4876,3840,-1036
2019,3,15,14,4192,5187,3902,-1285
2019,3,15,15,4480,5610,4151,-1459
2019,3,15,16,4679,6049,4521,-1528
2019,3,15,17,5056,6469,4927,-1542
2019,3,15,18,5328,6943,5280,-1663
2019,3,15,19,5565,7317,5431,-1886
2019,3,15,20,5776,7659,5773,-1886
2019,3,15,21,5933,7939,6051,-1888
2019,3,15,22,5930,7965,6073,-1892
2019,3,15,23,5701,7675,5868,-1807
2019,3,16,0,5450,7193,5575,-1618
2019,3,16,1,5289,6943,5329,-1614
2019,3,16,2,4921,6407,4806,-1601
2019,3,16,3,4504,5893,4518,-1375
2019,3,16,4,4074,5249,4132,-1117
2019,3,16,5,3640,4687,3716,-971
2019,3,16,6,3315,4238,3351,-887
2019,3,16,7,3136,3967,3139,-828
2019,3,16,8,3010,3812,3002,-810
2019,3,16,9,2970,3770,2951,-819
2019,3,16,10,2986,3829,2994,-835
2019,3,16,11,3106,4040,3158,-882
2019,3,16,12,3310,4301,3345,-956
2019,3,16,13,3622,4677,3642,-1035
2019,3,16,14,3962,5129,3980,-1149
2019,3,16,15,4206,5490,4317,-1173
2019,3,16,16,4364,5742,4584,-1158
2019,3,16,17,4545,5994,4780,-1214
2019,3,16,18,4636,6182,5055,-1127
2019,3,16,19,4689,6401,5228,-1173
2019,3,16,20,4727,6553,5378,-1175
2019,3,16,21,4742,6579,5452,-1127
2019,3,16,22,4663,6413,5353,-1060
2019,3,16,23,4496,6109,5117,-992
2019,3,17,0,4362,5891,4833,-1058
2019,3,17,1,4382,5779,4655,-1124
2019,3,17,2,4158,5407,4275,-1132
2019,3,17,3,3853,4971,3896,-1075
2019,3,17,4,3492,4474,3515,-959
2019,3,17,5,3123,4061,3184,-877
2019,3,17,6,2869,3724,2923,-801
2019,3,17,7,2706,3535,2771,-764
2019,3,17,8,2628,3437,2687,-750
2019,3,17,9,2605,3395,2658,-737
2019,3,17,10,2648,3461,2701,-760
2019,3,17,11,2857,3639,2821,-818
2019,3,17,12,3059,3939,3012,-927
2019,3,17,13,3396,4321,3301,-1020
2019,3,17,14,3778,4750,3609,-1141
2019,3,17,15,3975,5036,3871,-1165
2019,3,17,16,4065,5194,4015,-1179
2019,3,17,17,4244,5293,4075,-1218
2019,3,17,18,4225,5317,4127,-1190
2019,3,17,19,4182,5306,4142,-1164
2019,3,17,20,4175,5306,4192,-1114
2019,3,17,21,4212,5300,4241,-1059
2019,3,17,22,4111,5252,4194,-1058
2019,3,17,23,4128,5267,4226,-1041
2019,3,18,0,4147,5383,4326,-1057
2019,3,18,1,4194,5380,4309,-1071
2019,3,18,2,3964,5049,3997,-1052
2019,3,18,3,3646,4612,3562,-1050
2019,3,18,4,3316,4106,3163,-943
2019,3,18,5,2826,3726,2867,-859
2019,3,18,6,2617,3496,2689,-807
2019,3,18,7,2514,3368,2573,-795
2019,3,18,8,2531,3339,2546,-793
2019,3,18,9,2603,3433,2608,-825
2019,3,18,10,2902,3741,2862,-879
2019,3,18,11,3468,4285,3269,-1016
2019,3,18,12,3830,4722,3586,-1136
2019,3,18,13,3922,4908,3768,-1140
2019,3,18,14,4017,5046,3915,-1131
2019,3,18,15,4114,5143,4005,-1138
2019,3,18,16,4202,5162,4034,-1128
2019,3,18,17,4233,5185,4062,-1123
2019,3,18,18,4144,5178,4069,-1109
2019,3,18,19,4089,5198,4054,-1144
2019,3,18,20,4097,5210,4049,-1161
2019,3,18,21,4144,5275,4169,-1106
2019,3,18,22,4235,5312,4214,-1098
2019,3,18,23,4183,5386,4302,-1084
2019,3,19,0,4269,5514,4435,-1079
2019,3,19,1,4409,5510,4445,-1065
2019,3,19,2,4117,5172,4109,-1063
2019,3,19,3,3723,4683,3662,-1021
2019,3,19,4,3345,4187,3273,-914
2019,3,19,5,3016,3818,2995,-823
2019,3,19,6,2840,3584,2791,-793
2019,3,19,7,2735,3475,2702,-773
2019,3,19,8,2736,3441,2674,-767
2019,3,19,9,2820,3549,2738,-811
2019,3,19,10,3102,3872,2979,-893
2019,3,19,11,3717,4453,3440,-1013
2019,3,19,12,4095,4905,3813,-1092
2019,3,19,13,4139,5137,4004,-1133
2019,3,19,14,4176,5374,4167,-1207
2019,3,19,15,4212,5517,4284,-1233
2019,3,19,16,4198,5563,4324,-1239
2019,3,19,17,4237,5531,4297,-1234
2019,3,19,18,4146,5399,4243,-1156
2019,3,19,19,4057,5284,4167,-1117
2019,3,19,20,4051,5236,4130,-1106
2019,3,19,21,4071,5250,4152,-1098
2019,3,19,22,4197,5359,4198,-1161
2019,3,19,23,4114,5418,4223,-1195
2019,3,20,0,4220,5534,4317,-1217
2019,3,20,1,4403,5577,4375,-1202
2019,3,20,2,4190,5303,4154,-1149
2019,3,20,3,3790,4851,3822,-1029
2019,3,20,4,3427,4370,3433,-937
2019,3,20,5,3043,3997,3125,-872
2019,3,20,6,2889,3800,2961,-839
2019,3,20,7,2740,3711,2881,-830
2019,3,20,8,2758,3664,2838,-826
2019,3,20,9,2849,3782,2922,-860
2019,3,20,10,3099,4132,3192,-940
2019,3,20,11,3649,4695,3619,-1076
2019,3,20,12,3967,5100,3999,-1101
2019,3,20,13,4006,5197,4075,-1122
2019,3,20,14,4066,5215,4086,-1129
2019,3,20,15,4165,5196,4101,-1095
2019,3,20,16,4073,5133,4070,-1063
2019,3,20,17,4109,5127,4042,-1085
2019,3,20,18,4116,5124,4070,-1054
2019,3,20,19,4116,5131,4077,-1054
2019,3,20,20,4158,5129,4055,-1074
2019,3,20,21,4233,5234,4129,-1105
2019,3,20,22,4277,5339,4203,-1136
2019,3,20,23,4249,5350,4204,-1146
2019,3,21,0,4311,5443,4268,-1175
2019,3,21,1,4439,5545,4351,-1194
2019,3,21,2,4138,5267,4159,-1108
2019,3,21,3,3740,4792,3770,-1022
2019,3,21,4,3320,4250,3349,-901
2019,3,21,5,2994,3853,3026,-827
2019,3,21,6,2778,3581,2794,-787
2019,3,21,7,2679,3484,2704,-780
2019,3,21,8,2683,3481,2700,-781
2019,3,21,9,2724,3610,2768,-842
2019,3,21,10,3043,3952,3022,-930
2019,3,21,11,3471,4546,3473,-1073
2019,3,21,12,3827,4980,3869,-1111
2019,3,21,13,3938,5132,3978,-1154
2019,3,21,14,3978,5146,4020,-1126
2019,3,21,15,4069,5144,4058,-1086
2019,3,21,16,4092,5118,4080,-1038
2019,3,21,17,4161,5098,4084,-1014
2019,3,21,18,4180,5109,4086,-1023
2019,3,21,19,4204,5125,4107,-1018
2019,3,21,20,4276,5192,4177,-1015
2019,3,21,21,4404,5313,4336,-977
2019,3,21,22,4420,5410,4415,-995
2019,3,21,23,4344,5406,4464,-942
2019,3,22,0,4379,5409,4492,-917
2019,3,22,1,4513,5529,4579,-950
2019,3,22,2,4201,5215,4258,-957
2019,3,22,3,3799,4732,3772,-960
2019,3,22,4,3378,4239,3297,-942
2019,3,22,5,3040,3836,2958,-878
2019,3,22,6,2876,3611,2751,-860
2019,3,22,7,2805,3513,2662,-851
2019,3,22,8,2815,3506,2650,-856
2019,3,22,9,2921,3648,2743,-905
2019,3,22,10,3215,4015,2993,-1022
2019,3,22,11,3684,4634,3531,-1103
2019,3,22,12,4072,5157,3979,-1178
2019,3,22,13,4234,5370,4223,-1147
2019,3,22,14,4247,5275,4166,-1109
2019,3,22,15,4203,5178,4115,-1063
2019,3,22,16,4179,5088,4066,-1022
2019,3,22,17,4113,5031,3984,-1047
2019,3,22,18,4094,5040,3995,-1045
2019,3,22,19,4074,5072,4032,-1040
2019,3,22,20,4109,5166,4101,-1065
2019,3,22,21,4193,5306,4292,-1014
2019,3,22,22,4191,5391,4354,-1037
2019,3,22,23,4100,5314,4305,-1009
2019,3,23,0,4109,5232,4225,-1007
2019,3,23,1,4253,5281,4227,-1054
2019,3,23,2,3996,5014,4025,-989
2019,3,23,3,3704,4635,3689,-946
2019,3,23,4,3372,4211,3310,-901
2019,3,23,5,2963,3892,2995,-897
2019,3,23,6,2815,3692,2820,-872
2019,3,23,7,2734,3614,2764,-850
2019,3,23,8,2740,3626,2732,-894
2019,3,23,9,2810,3726,2799,-927
2019,3,23,10,2942,3975,2955,-1020
2019,3,23,11,3202,4367,3237,-1130
2019,3,23,12,3511,4843,3611,-1232
2019,3,23,13,3820,5289,4070,-1219
2019,3,23,14,3989,5334,4106,-1228
2019,3,23,15,3987,5179,4042,-1137
2019,3,23,16,3925,5010,3952,-1058
2019,3,23,17,3848,4955,3897,-1058
2019,3,23,18,3850,4925,3883,-1042
2019,3,23,19,3897,4992,3923,-1069
2019,3,23,20,4030,5159,4051,-1108
2019,3,23,21,4145,5387,4240,-1147
2019,3,23,22,4166,5566,4370,-1196
2019,3,23,23,4136,5534,4364,-1170
2019,3,24,0,4143,5377,4243,-1134
2019,3,24,1,4204,5369,4242,-1127
2019,3,24,2,3965,5054,4014,-1040
2019,3,24,3,3640,4639,3681,-958
2019,3,24,4,3307,4201,3277,-924
2019,3,24,5,2950,3802,2961,-841
2019,3,24,6,2704,3532,2727,-805
2019,3,24,7,2628,3409,2622,-787
2019,3,24,8,2608,3349,2577,-772
2019,3,24,9,2656,3381,2580,-801
2019,3,24,10,2741,3489,2657,-832
2019,3,24,11,2886,3740,2819,-921
2019,3,24,12,3137,4075,3108,-967
2019,3,24,13,3438,4527,3430,-1097
2019,3,24,14,3722,4847,3681,-1166
2019,3,24,15,3833,4945,3815,-1130
2019,3,24,16,3945,5019,3902,-1117
2019,3,24,17,4019,5153,4005,-1148
2019,3,24,18,4084,5334,4183,-1151
2019,3,24,19,4199,5528,4326,-1202
2019,3,24,20,4377,5818,4496,-1322
2019,3,24,21,4588,6065,4713,-1352
2019,3,24,22,4706,6272,4893,-1379
2019,3,24,23,4602,6249,4903,-1346
2019,3,25,0,4575,6070,4771,-1299
2019,3,25,1,4613,6090,4765,-1325
2019,3,25,2,4305,5657,4495,-1162
2019,3,25,3,3868,5011,3989,-1022
2019,3,25,4,3402,4355,3443,-912
2019,3,25,5,3038,3953,3124,-829
2019,3,25,6,2773,3644,2869,-775
2019,3,25,7,2619,3512,2765,-747
2019,3,25,8,2554,3457,2718,-739
2019,3,25,9,2603,3507,2712,-795
2019,3,25,10,2835,3851,2956,-895
2019,3,25,11,3230,4433,3441,-992
2019,3,25,12,3580,4834,3808,-1026
2019,3,25,13,3728,4993,3958,-1035
2019,3,25,14,3912,5203,4119,-1084
2019,3,25,15,4114,5443,4182,-1261
2019,3,25,16,4310,5673,4211,-1462
2019,3,25,17,4526,5946,4344,-1602
2019,3,25,18,4780,6282,4543,-1739
2019,3,25,19,5048,6566,4797,-1769
2019,3,25,20,5267,6886,5383,-1503
2019,3,25,21,5457,7154,5783,-1371
2019,3,25,22,5540,7278,5891,-1387
2019,3,25,23,5472,7140,5859,-1281
2019,3,26,0,5216,6870,5652,-1218
2019,3,26,1,5106,6778,5538,-1240
2019,3,26,2,4692,6234,4911,-1323
2019,3,26,3,4196,5534,4302,-1232
2019,3,26,4,3673,4843,3735,-1108
2019,3,26,5,3310,4168,3291,-877
2019,3,26,6,3008,3810,3028,-782
2019,3,26,7,2826,3619,2873,-746
2019,3,26,8,2745,3561,2821,-740
2019,3,26,9,2763,3608,2854,-754
2019,3,26,10,2946,3921,3079,-842
2019,3,26,11,3346,4501,3534,-967
2019,3,26,12,3617,4851,3864,-987
2019,3,26,13,3753,4997,4013,-984
2019,3,26,14,4022,5197,4176,-1021
2019,3,26,15,4260,5444,4239,-1205
2019,3,26,16,4417,5701,4299,-1402
2019,3,26,17,4613,5998,4461,-1537
2019,3,26,18,4862,6287,4641,-1646
2019,3,26,19,5107,6585,4962,-1623
2019,3,26,20,5285,6795,5153,-1642
2019,3,26,21,5432,6988,5402,-1586
2019,3,26,22,5392,7010,5478,-1532
2019,3,26,23,5289,6805,5301,-1504
2019,3,27,0,5096,6479,4969,-1510
2019,3,27,1,5022,6392,4800,-1592
2019,3,27,2,4627,5876,4293,-1583
2019,3,27,3,4157,5196,3875,-1321
2019,3,27,4,3661,4501,3409,-1092
2019,3,27,5,3270,3976,3135,-841
2019,3,27,6,2996,3669,2933,-736
2019,3,27,7,2829,3499,2783,-716
2019,3,27,8,2751,3413,2724,-689
2019,3,27,9,2769,3489,2761,-728
2019,3,27,10,2971,3819,2998,-821
2019,3,27,11,3343,4381,3427,-954
2019,3,27,12,3653,4796,3759,-1037
2019,3,27,13,3775,4921,3857,-1064
2019,3,27,14,3960,5052,3958,-1094
2019,3,27,15,4108,5117,4024,-1093
2019,3,27,16,4082,5134,4027,-1107
2019,3,27,17,4128,5136,4044,-1092
2019,3,27,18,4208,5158,4079,-1079
2019,3,27,19,4265,5191,4119,-1072
2019,3,27,20,4359,5275,4254,-1021
2019,3,27,21,4457,5374,4368,-1006
2019,3,27,22,4460,5446,4429,-1017
2019,3,27,23,4415,5424,4422,-1002
2019,3,28,0,4455,5439,4447,-992
2019,3,28,1,4489,5556,4518,-1038
2019,3,28,2,4179,5225,4199,-1026
2019,3,28,3,3774,4721,3709,-1012
2019,3,28,4,3364,4155,3269,-886
2019,3,28,5,3012,3790,2955,-835
2019,3,28,6,2835,3555,2768,-787
2019,3,28,7,2751,3461,2678,-783
2019,3,28,8,2737,3436,2643,-793
2019,3,28,9,2808,3558,2728,-830
2019,3,28,10,3100,3914,2981,-933
2019,3,28,11,3521,4583,3485,-1098
2019,3,28,12,3843,5006,3988,-1018
2019,3,28,13,3916,5030,4102,-928
2019,3,28,14,4027,5024,4118,-906
2019,3,28,15,4078,5075,4119,-956
2019,3,28,16,4127,5107,4068,-1039
2019,3,28,17,4192,5189,4096,-1093
2019,3,28,18,4273,5250,4149,-1101
2019,3,28,19,4341,5362,4241,-1121
2019,3,28,20,4481,5466,4312,-1154
2019,3,28,21,4615,5664,4463,-1201
2019,3,28,22,4676,5793,4558,-1235
2019,3,28,23,4571,5781,4537,-1244
2019,3,29,0,4599,5694,4482,-1212
2019,3,29,1,4541,5817,4568,-1249
2019,3,29,2,4239,5460,4302,-1158
2019,3,29,3,3812,4852,3840,-1012
2019,3,29,4,3424,4287,3363,-924
2019,3,29,5,3062,3820,2988,-832
2019,3,29,6,2814,3551,2772,-779
2019,3,29,7,2664,3413,2648,-765
2019,3,29,8,2613,3353,2596,-757
2019,3,29,9,2678,3458,2677,-781
2019,3,29,10,2902,3788,2882,-906
2019,3,29,11,3278,4417,3369,-1048
2019,3,29,12,3617,4823,3731,-1092
2019,3,29,13,3782,4937,3818,-1119
2019,3,29,14,3940,4988,3865,-1123
2019,3,29,15,4072,5121,4020,-1101
2019,3,29,16,4134,5275,4163,-1112
2019,3,29,17,4217,5415,4221,-1194
2019,3,29,18,4325,5568,4401,-1167
2019,3,29,19,4473,5731,4531,-1200
2019,3,29,20,4636,5916,4642,-1274
2019,3,29,21,4773,6092,4825,-1267
2019,3,29,22,4779,6095,4779,-1316
2019,3,29,23,4658,5970,4704,-1266
2019,3,30,0,4511,5761,4529,-1232
2019,3,30,1,4489,5770,4566,-1204
2019,3,30,2,4209,5454,4390,-1064
2019,3,30,3,3871,5036,4142,-894
2019,3,30,4,3467,4492,3559,-933
2019,3,30,5,3150,4022,3199,-823
2019,3,30,6,2878,3716,2945,-771
2019,3,30,7,2693,3507,2794,-713
2019,3,30,8,2604,3417,2705,-712
2019,3,30,9,2595,3428,2715,-713
2019,3,30,10,2653,3535,2786,-749
2019,3,30,11,2816,3759,2946,-813
2019,3,30,12,3057,4045,3185,-860
2019,3,30,13,3386,4443,3497,-946
2019,3,30,14,3685,4854,3826,-1028
2019,3,30,15,3926,5113,4038,-1075
2019,3,30,16,4066,5320,4222,-1098
2019,3,30,17,4216,5507,4370,-1137
2019,3,30,18,4397,5719,4368,-1351
2019,3,30,19,4643,5984,4532,-1452
2019,3,30,20,4933,6301,4764,-1537
2019,3,30,21,5156,6544,4998,-1546
2019,3,30,22,5251,6761,5233,-1528
2019,3,30,23,5108,6654,5144,-1510
2019,3,31,0,4813,6095,4807,-1288
2019,3,31,1,4755,6019,4767,-1252
2019,3,31,2,4483,5624,4497,-1127
2019,3,31,3,4089,5108,4099,-1009
2019,3,31,4,3690,4551,3576,-975
2019,3,31,5,3352,4068,3220,-848
2019,3,31,6,3047,3718,2936,-782
2019,3,31,7,2854,3502,2753,-749
2019,3,31,8,2737,3379,2656,-723
2019,3,31,9,2689,3347,2619,-728
2019,3,31,10,2713,3420,2681,-739
2019,3,31,11,2800,3607,2807,-800
2019,3,31,12,2973,3861,3037,-824
2019,3,31,13,3279,4342,3415,-927
2019,3,31,14,3750,4818,3800,-1018
2019,3,31,15,4080,5197,3966,-1231
2019,3,31,16,4343,5548,4078,-1470
2019,3,31,17,4601,5914,4239,-1675
2019,3,31,18,4838,6270,4509,-1761
2019,3,31,19,5104,6598,4839,-1759
2019,3,31,20,5311,6893,5164,-1729
2019,3,31,21,5443,7119,5372,-1747
2019,3,31,22,5411,7092,5395,-1697
2019,3,31,23,5319,6592,4926,-1666
2019,4,1,0,5145,6600,4938,-1662
2019,4,1,1,5059,6558,4846,-1712
2019,4,1,2,4733,6084,4446,-1638
2019,4,1,3,4257,5445,4019,-1426
2019,4,1,4,3767,4760,3628,-1132
2019,4,1,5,3223,4209,3351,-858
2019,4,1,6,2949,3850,3073,-777
2019,4,1,7,2797,3660,2913,-747
2019,4,1,8,2722,3545,2821,-724
2019,4,1,9,2760,3612,2862,-750
2019,4,1,10,2989,3892,3067,-825
2019,4,1,11,3406,4480,3519,-961
2019,4,1,12,3674,4871,3878,-993
2019,4,1,13,3838,4994,3977,-1017
2019,4,1,14,4016,5171,4107,-1064
2019,4,1,15,4218,5335,4241,-1094
2019,4,1,16,4342,5437,4316,-1121
2019,4,1,17,4331,5493,4387,-1106
2019,4,1,18,4401,5477,4367,-1110
2019,4,1,19,4439,5390,4352,-1038
2019,4,1,20,4450,5309,4267,-1042
2019,4,1,21,4480,5338,4253,-1085
2019,4,1,22,4532,5504,4393,-1111
2019,4,1,23,4505,5573,4420,-1153
2019,4,2,0,4459,5654,4489,-1165
2019,4,2,1,4394,5768,4583,-1185
2019,4,2,2,4153,5426,4345,-1081
2019,4,2,3,3738,4868,3879,-989
2019,4,2,4,3298,4285,3411,-874
2019,4,2,5,3031,3854,3072,-782
2019,4,2,6,2813,3602,2876,-726
2019,4,2,7,2708,3478,2766,-712
2019,4,2,8,2672,3433,2724,-709
2019,4,2,9,2716,3502,2758,-744
2019,4,2,10,2947,3696,2867,-829
2019,4,2,11,3406,4457,3458,-999
2019,4,2,12,3691,4803,3838,-965
2019,4,2,13,3852,4955,4007,-948
2019,4,2,14,3979,5092,4074,-1018
2019,4,2,15,4179,5284,4277,-1007
2019,4,2,16,4296,5320,4332,-988
2019,4,2,17,4335,5280,4317,-963
2019,4,2,18,4482,5263,4279,-984
2019,4,2,19,4605,5190,4180,-1010
2019,4,2,20,4665,5432,4406,-1026
2019,4,2,21,4742,5667,4642,-1025
2019,4,2,22,4765,5843,4825,-1018
2019,4,2,23,4679,5874,4873,-1001
2019,4,3,0,4583,5779,4795,-984
2019,4,3,1,4512,5853,5032,-821
2019,4,3,2,4167,5454,4673,-781
2019,4,3,3,3794,4853,4156,-697
2019,4,3,4,3349,4199,3385,-814
2019,4,3,5,3019,3756,2968,-788
2019,4,3,6,2798,3535,2771,-764
2019,4,3,7,2669,3450,2698,-752
2019,4,3,8,2612,3435,2676,-759
2019,4,3,9,2677,3559,2755,-804
2019,4,3,10,2937,3921,3001,-920
2019,4,3,11,3379,4632,3537,-1095
2019,4,3,12,3694,5006,3758,-1248
2019,4,3,13,3801,5032,3884,-1148
2019,4,3,14,3880,5000,3890,-1110
2019,4,3,15,3987,5028,3967,-1061
2019,4,3,16,4109,5047,4011,-1036
2019,4,3,17,4161,5071,4056,-1015
2019,4,3,18,4272,5160,4119,-1041
2019,4,3,19,4450,5345,4291,-1054
2019,4,3,20,4662,5558,4531,-1027
2019,4,3,21,4860,5868,4849,-1019
2019,4,3,22,4904,6057,5032,-1025
2019,4,3,23,4831,6074,5068,-1006
2019,4,4,0,4750,5958,4974,-984
2019,4,4,1,4691,6021,4993,-1028
2019,4,4,2,4349,5627,4628,-999
2019,4,4,3,3884,5018,4028,-990
2019,4,4,4,3432,4353,3476,-877
2019,4,4,5,3037,3850,3081,-769
2019,4,4,6,2807,3592,2872,-720
2019,4,4,7,2671,3467,2766,-701
2019,4,4,8,2623,3417,2713,-704
2019,4,4,9,2704,3496,2764,-732
2019,4,4,10,2954,3828,3018,-810
2019,4,4,11,3426,4489,3504,-985
2019,4,4,12,3726,4810,3774,-1036
2019,4,4,13,3833,4907,3852,-1055
2019,4,4,14,3872,5034,3977,-1057
2019,4,4,15,4079,5215,4151,-1064
2019,4,4,16,4230,5371,4284,-1087
2019,4,4,17,4257,5597,4431,-1166
2019,4,4,18,4456,5874,4682,-1192
2019,4,4,19,4690,6167,4992,-1175
2019,4,4,20,4945,6449,5326,-1123
2019,4,4,21,5197,6706,5566,-1140
2019,4,4,22,5253,6874,5689,-1185
2019,4,4,23,5231,6797,5608,-1189
2019,4,5,0,5066,6620,5468,-1152
2019,4,5,1,5032,6608,5483,-1125
2019,4,5,2,4707,6184,5105,-1079
2019,4,5,3,4200,5510,4396,-1114
2019,4,5,4,3690,4777,3805,-972
2019,4,5,5,3461,4257,3377,-880
2019,4,5,6,3152,3909,3103,-806
2019,4,5,7,2974,3706,2936,-770
2019,4,5,8,2885,3586,2847,-739
2019,4,5,9,2902,3617,2853,-764
2019,4,5,10,3096,3897,3065,-832
2019,4,5,11,3534,4429,3474,-955
2019,4,5,12,3808,4804,3829,-975
2019,4,5,13,4018,5011,4020,-991
2019,4,5,14,4256,5235,4216,-1019
2019,4,5,15,4603,5461,4409,-1052
2019,4,5,16,4849,5759,4636,-1123
2019,4,5,17,5086,6036,4854,-1182
2019,4,5,18,5375,6376,5071,-1305
2019,4,5,19,5610,6699,5421,-1278
2019,4,5,20,5810,7075,5902,-1173
2019,4,5,21,5976,7261,6126,-1135
2019,4,5,22,5985,7315,6186,-1129
2019,4,5,23,5818,7096,5972,-1124
2019,4,6,0,5505,6740,5575,-1165
2019,4,6,1,5373,6580,5320,-1260
2019,4,6,2,5055,6173,4958,-1215
2019,4,6,3,4603,5649,4523,-1126
2019,4,6,4,4131,5050,4017,-1033
2019,4,6,5,3689,4503,3559,-944
2019,4,6,6,3355,4114,3203,-911
2019,4,6,7,3151,3824,2984,-840
2019,4,6,8,3009,3694,2895,-799
2019,4,6,9,2958,3642,2874,-768
2019,4,6,10,2988,3680,2891,-789
2019,4,6,11,3134,3885,3034,-851
2019,4,6,12,3313,4149,3309,-840
2019,4,6,13,3712,4675,3708,-967
2019,4,6,14,4233,5277,4189,-1088
2019,4,6,15,4644,5807,4610,-1197
2019,4,6,16,5053,6336,5040,-1296
2019,4,6,17,5510,6856,5499,-1357
2019,4,6,18,5872,7330,5965,-1365
2019,4,6,19,6197,7748,6243,-1505
2019,4,6,20,6432,8048,6567,-1481
2019,4,6,21,6536,8145,6643,-1502
2019,4,6,22,6489,8091,6597,-1494
2019,4,6,23,6311,7802,6319,-1483
2019,4,7,0,5975,7340,6012,-1328
2019,4,7,1,5753,7029,5690,-1339
2019,4,7,2,5368,6421,5149,-1272
2019,4,7,3,4872,5829,4568,-1261
2019,4,7,4,4410,5229,4082,-1147
2019,4,7,5,3923,4640,3612,-1028
2019,4,7,6,3544,4214,3251,-963
2019,4,7,7,3284,3913,3044,-869
2019,4,7,8,3135,3743,2903,-840
2019,4,7,9,3058,3645,2823,-822
2019,4,7,10,3066,3666,2824,-842
2019,4,7,11,3183,3828,2966,-862
2019,4,7,12,3357,4039,3169,-870
2019,4,7,13,3766,4581,3599,-982
2019,4,7,14,4296,5212,4068,-1144
2019,4,7,15,4828,5841,4549,-1292
2019,4,7,16,5298,6436,5076,-1360
2019,4,7,17,5735,7060,5706,-1354
2019,4,7,18,6129,7569,6291,-1278
2019,4,7,19,6407,7996,6492,-1504
2019,4,7,20,6636,8291,6762,-1529
2019,4,7,21,6710,8351,6865,-1486
2019,4,7,22,6747,8185,6737,-1448
2019,4,7,23,6591,7855,6482,-1373
2019,4,8,0,6239,7531,6274,-1257
2019,4,8,1,6038,7366,6125,-1241
2019,4,8,2,5578,6795,5514,-1281
2019,4,8,3,4987,6041,4815,-1226
2019,4,8,4,4414,5232,4095,-1137
2019,4,8,5,3777,4626,3607,-1019
2019,4,8,6,3443,4221,3300,-921
2019,4,8,7,3245,3985,3131,-854
2019,4,8,8,3119,3849,3001,-848
2019,4,8,9,3135,3869,2997,-872
2019,4,8,10,3369,4146,3219,-927
2019,4,8,11,3829,4726,3655,-1071
2019,4,8,12,4107,5100,4054,-1046
2019,4,8,13,4302,5365,4305,-1060
2019,4,8,14,4585,5780,4627,-1153
2019,4,8,15,4982,6332,5066,-1266
2019,4,8,16,5386,6854,5554,-1300
2019,4,8,17,5720,7399,6195,-1204
2019,4,8,18,6084,7916,6766,-1150
2019,4,8,19,6360,8246,7135,-1111
2019,4,8,20,6452,8485,7292,-1193
2019,4,8,21,6607,8539,7368,-1171
2019,4,8,22,6583,8274,7171,-1103
2019,4,8,23,6379,7885,6830,-1055
2019,4,9,0,6087,7401,6356,-1045
2019,4,9,1,5934,7082,6090,-992
2019,4,9,2,5492,6542,5492,-1050
2019,4,9,3,4921,5828,4717,-1111
2019,4,9,4,4345,5091,3991,-1100
2019,4,9,5,3922,4564,3600,-964
2019,4,9,6,3577,4229,3358,-871
2019,4,9,7,3368,3999,3191,-808
2019,4,9,8,3261,3906,3104,-802
2019,4,9,9,3240,3943,3115,-828
2019,4,9,10,3441,4269,3383,-886
2019,4,9,11,3923,4919,3875,-1044
2019,4,9,12,4194,5283,4217,-1066
2019,4,9,13,4366,5460,4383,-1077
2019,4,9,14,4577,5725,4351,-1374
2019,4,9,15,4826,6150,4640,-1510
2019,4,9,16,5042,6558,4968,-1590
2019,4,9,17,5116,7049,5419,-1630
2019,4,9,18,5227,7448,5911,-1537
2019,4,9,19,5219,7551,6055,-1496
2019,4,9,20,5120,7430,5966,-1464
2019,4,9,21,5098,6951,5510,-1441
2019,4,9,22,5099,7156,5736,-1420
2019,4,9,23,5015,6952,5533,-1419
2019,4,10,0,4944,6791,5490,-1301
2019,4,10,1,4976,6660,5367,-1293
2019,4,10,2,4681,6242,4911,-1331
2019,4,10,3,4212,5571,4333,-1238
2019,4,10,4,3745,4885,3782,-1103
2019,4,10,5,3497,4374,3347,-1027
2019,4,10,6,3215,4034,3078,-956
2019,4,10,7,3061,3844,2938,-906
2019,4,10,8,2989,3743,2862,-881
2019,4,10,9,3024,3773,2895,-878
2019,4,10,10,3244,4051,3082,-969
2019,4,10,11,3700,4617,3491,-1126
2019,4,10,12,3944,4913,3816,-1097
2019,4,10,13,4100,5088,4040,-1048
2019,4,10,14,4305,5320,4307,-1013
2019,4,10,15,4584,5663,4640,-1023
2019,4,10,16,4861,5994,4936,-1058
2019,4,10,17,5054,6320,5194,-1126
2019,4,10,18,5322,6659,5478,-1181
2019,4,10,19,5531,6964,5679,-1285
2019,4,10,20,5655,7260,6031,-1229
2019,4,10,21,5763,7506,6232,-1274
2019,4,10,22,5731,7589,6282,-1307
2019,4,10,23,5616,7430,6129,-1301
2019,4,11,0,5450,7089,5803,-1286
2019,4,11,1,5345,6967,5698,-1269
2019,4,11,2,4996,6451,5276,-1175
2019,4,11,3,4447,5692,4506,-1186
2019,4,11,4,3919,4907,3749,-1158
2019,4,11,5,3550,4334,3295,-1039
2019,4,11,6,3256,3940,3011,-929
2019,4,11,7,3081,3729,2855,-874
2019,4,11,8,2983,3611,2758,-853
2019,4,11,9,3007,3642,2757,-885
2019,4,11,10,3220,3929,2966,-963
2019,4,11,11,3667,4496,3424,-1072
2019,4,11,12,3909,4798,3703,-1095
2019,4,11,13,4103,4956,3852,-1104
2019,4,11,14,4325,5282,4110,-1172
2019,4,11,15,4623,5721,4429,-1292
2019,4,11,16,4917,6195,4702,-1493
2019,4,11,17,5283,6668,5089,-1579
2019,4,11,18,5592,7177,5605,-1572
2019,4,11,19,5887,7618,6021,-1597
2019,4,11,20,6104,7981,6582,-1399
2019,4,11,21,6252,8201,6819,-1382
2019,4,11,22,6318,8231,6792,-1439
2019,4,11,23,6048,8040,6674,-1366
2019,4,12,0,5800,7579,6349,-1230
2019,4,12,1,5680,7399,6121,-1278
2019,4,12,2,5308,6848,5527,-1321
2019,4,12,3,4749,6057,4729,-1328
2019,4,12,4,4208,5302,4134,-1168
2019,4,12,5,3740,4657,3619,-1038
2019,4,12,6,3424,4250,3337,-913
2019,4,12,7,3234,4008,3166,-842
2019,4,12,8,3128,3851,3099,-752
2019,4,12,9,3138,3846,3112,-734
2019,4,12,10,3336,4103,3174,-929
2019,4,12,11,3784,4668,3621,-1047
2019,4,12,12,4041,4974,3973,-1001
2019,4,12,13,4262,5311,4240,-1071
2019,4,12,14,4584,5737,4455,-1282
2019,4,12,15,5026,6320,4879,-1441
2019,4,12,16,5421,6862,5232,-1630
2019,4,12,17,5720,7397,5766,-1631
2019,4,12,18,6063,7901,6189,-1712
2019,4,12,19,6311,8331,6707,-1624
2019,4,12,20,6512,8614,6745,-1869
2019,4,12,21,6582,8828,7160,-1668
2019,4,12,22,6566,8802,7079,-1723
2019,4,12,23,6238,8454,6769,-1685
2019,4,13,0,5915,7901,6077,-1824
2019,4,13,1,5716,7561,5692,-1869
2019,4,13,2,5370,7015,5286,-1729
2019,4,13,3,4851,6366,5059,-1307
2019,4,13,4,4355,5652,4463,-1189
2019,4,13,5,4033,5074,4002,-1072
2019,4,13,6,3665,4636,3687,-949
2019,4,13,7,3395,4301,3409,-892
2019,4,13,8,3237,4151,3268,-883
2019,4,13,9,3160,4071,3198,-873
2019,4,13,10,3197,4127,3224,-903
2019,4,13,11,3355,4310,3367,-943
2019,4,13,12,3545,4618,3589,-1029
2019,4,13,13,3984,5199,4096,-1103
2019,4,13,14,4456,5882,4618,-1264
2019,4,13,15,4926,6541,5012,-1529
2019,4,13,16,5378,7128,5461,-1667
2019,4,13,17,5891,7698,5897,-1801
2019,4,13,18,6227,8181,6398,-1783
2019,4,13,19,6511,8567,6858,-1709
2019,4,13,20,6681,8791,7122,-1669
2019,4,13,21,6825,8834,7172,-1662
2019,4,13,22,6798,8705,7083,-1622
2019,4,13,23,6575,8424,6786,-1638
2019,4,14,0,6188,7969,6304,-1665
2019,4,14,1,6003,7689,5939,-1750
2019,4,14,2,5565,7155,5502,-1653
2019,4,14,3,5014,6560,5053,-1507
2019,4,14,4,4513,5932,4505,-1427
2019,4,14,5,4173,5412,4226,-1186
2019,4,14,6,3823,4992,3925,-1067
2019,4,14,7,3560,4690,3707,-983
2019,4,14,8,3413,4506,3565,-941
2019,4,14,9,3319,4390,3464,-926
2019,4,14,10,3314,4407,3486,-921
2019,4,14,11,3413,4527,3575,-952
2019,4,14,12,3567,4769,3764,-1005
2019,4,14,13,3985,5335,4175,-1160
2019,4,14,14,4532,5997,4689,-1308
2019,4,14,15,5125,6602,5088,-1514
2019,4,14,16,5528,7177,5530,-1647
2019,4,14,17,5878,7679,5911,-1768
2019,4,14,18,6178,7997,6394,-1603
2019,4,14,19,6401,10280,8694,-1586
2019,4,14,20,6536,8344,6826,-1518
2019,4,14,21,6564,8277,6804,-1473
2019,4,14,22,6536,8209,6749,-1460
2019,4,14,23,6298,7955,6512,-1443
2019,4,15,0,5938,7712,6229,-1483
2019,4,15,1,5759,7427,5743,-1684
2019,4,15,2,5370,6796,5246,-1550
2019,4,15,3,4818,6091,4692,-1399
2019,4,15,4,4248,5295,4045,-1250
2019,4,15,5,3721,4713,3705,-1008
2019,4,15,6,3357,4311,3402,-909
2019,4,15,7,3125,4091,3225,-866
2019,4,15,8,2986,3943,3101,-842
2019,4,15,9,3000,3916,3085,-831
2019,4,15,10,3230,4147,3254,-893
2019,4,15,11,3595,4619,3615,-1004
2019,4,15,12,3830,4854,3818,-1036
2019,4,15,13,3972,5013,3949,-1064
2019,4,15,14,4149,5258,4152,-1106
2019,4,15,15,4400,5429,4167,-1262
2019,4,15,16,4621,5608,4304,-1304
2019,4,15,17,4887,5787,4435,-1352
2019,4,15,18,5126,5981,4521,-1460
2019,4,15,19,5329,6211,4695,-1516
2019,4,15,20,5530,6461,4809,-1652
2019,4,15,21,5652,6690,4902,-1788
2019,4,15,22,5645,6829,4987,-1842
2019,4,15,23,5418,6748,4938,-1810
2019,4,16,0,5104,6406,4668,-1738
2019,4,16,1,5039,6249,4523,-1726
2019,4,16,2,4654,5778,4164,-1614
2019,4,16,3,4144,5085,3614,-1471
2019,4,16,4,3610,4410,3044,-1366
2019,4,16,5,3109,3939,2949,-990
2019,4,16,6,2856,3607,2677,-930
2019,4,16,7,2706,3422,2530,-892
2019,4,16,8,2649,3333,2470,-863
2019,4,16,9,2689,3428,2517,-911
2019,4,16,10,2953,3722,2657,-1065
2019,4,16,11,3447,4324,3065,-1259
2019,4,16,12,3710,4630,3331,-1299
2019,4,16,13,3788,4736,3442,-1294
2019,4,16,14,3869,4852,3537,-1315
2019,4,16,15,4078,5022,3703,-1319
2019,4,16,16,4240,5184,3908,-1276
2019,4,16,17,4425,5410,4175,-1235
2019,4,16,18,4694,5721,4353,-1368
2019,4,16,19,4975,6143,4705,-1438
2019,4,16,20,5291,6624,4828,-1796
2019,4,16,21,5556,7082,5078,-2004
2019,4,16,22,5687,7351,5330,-2021
2019,4,16,23,5673,7305,5215,-2090
2019,4,17,0,5341,6901,4916,-1985
2019,4,17,1,5260,6718,4858,-1860
2019,4,17,2,4897,6201,4423,-1778
2019,4,17,3,4351,5465,3862,-1603
2019,4,17,4,3812,4682,3312,-1370
2019,4,17,5,3363,4158,3019,-1139
2019,4,17,6,3066,3819,2849,-970
2019,4,17,7,2897,3605,2688,-917
2019,4,17,8,2816,3527,2618,-909
2019,4,17,9,2831,3548,2617,-931
2019,4,17,10,3057,3842,2752,-1090
2019,4,17,11,3532,4394,3050,-1344
2019,4,17,12,3724,4678,3215,-1463
2019,4,17,13,3925,4849,3317,-1532
2019,4,17,14,4137,5116,3526,-1590
2019,4,17,15,4420,5430,3777,-1653
2019,4,17,16,4711,5749,3996,-1753
2019,4,17,17,5088,6124,4300,-1824
2019,4,17,18,5455,6579,4649,-1930
2019,4,17,19,5794,6974,5007,-1967
2019,4,17,20,6126,7312,5383,-1929
2019,4,17,21,6388,7613,5771,-1842
2019,4,17,22,6454,7720,5967,-1753
2019,4,17,23,6330,7555,5831,-1724
2019,4,18,0,5957,7175,5439,-1736
2019,4,18,1,5823,7012,5263,-1749
2019,4,18,2,5386,6509,4877,-1632
2019,4,18,3,4802,5769,4202,-1567
2019,4,18,4,4237,5019,3709,-1310
2019,4,18,5,3601,4419,3327,-1092
2019,4,18,6,3283,4013,3015,-998
2019,4,18,7,3101,3797,2861,-936
2019,4,18,8,3000,3694,2758,-936
2019,4,18,9,3010,3717,2774,-943
2019,4,18,10,3210,3983,2960,-1023
2019,4,18,11,3657,4523,3321,-1202
2019,4,18,12,3881,4807,3607,-1200
2019,4,18,13,4108,5061,3815,-1246
2019,4,18,14,4425,5408,4080,-1328
2019,4,18,15,4863,5816,4312,-1504
2019,4,18,16,5258,6281,4634,-1647
2019,4,18,17,5692,6799,4911,-1888
2019,4,18,18,6113,7380,5246,-2134
2019,4,18,19,6482,7907,5648,-2259
2019,4,18,20,6797,8373,6095,-2278
2019,4,18,21,6996,8737,6474,-2263
2019,4,18,22,6969,8910,6791,-2119
2019,4,18,23,6773,8710,6625,-2085
2019,4,19,0,6426,8226,6182,-2044
2019,4,19,1,6225,8000,5918,-2082
2019,4,19,2,5760,7495,5386,-2109
2019,4,19,3,5171,6749,4837,-1912
2019,4,19,4,4539,5983,4256,-1727
2019,4,19,5,4100,5344,3885,-1459
2019,4,19,6,3743,4897,3670,-1227
2019,4,19,7,3529,4601,3501,-1100
2019,4,19,8,3405,4434,3371,-1063
2019,4,19,9,3403,4444,3377,-1067
2019,4,19,10,3573,4698,3556,-1142
2019,4,19,11,3936,5205,3943,-1262
2019,4,19,12,4167,5547,4213,-1334
2019,4,19,13,4430,5931,4351,-1580
2019,4,19,14,4833,6451,4813,-1638
2019,4,19,15,5214,6918,5212,-1706
2019,4,19,16,5507,7210,5379,-1831
2019,4,19,17,5559,7294,5527,-1767
2019,4,19,18,5730,6968,5331,-1637
2019,4,19,19,5781,6613,4952,-1661
2019,4,19,20,5724,6311,4564,-1747
2019,4,19,21,5482,6101,4335,-1766
2019,4,19,22,5178,5980,4219,-1761
2019,4,19,23,4985,5762,4046,-1716
2019,4,20,0,4809,5490,3898,-1592
2019,4,20,1,4766,5440,3959,-1481
2019,4,20,2,4476,5215,3903,-1312
2019,4,20,3,4121,4802,3660,-1142
2019,4,20,4,3720,4340,3434,-906
2019,4,20,5,3426,3913,3101,-812
2019,4,20,6,3160,3620,2872,-748
2019,4,20,7,2902,3433,2711,-722
2019,4,20,8,2802,3352,2638,-714
2019,4,20,9,2764,3342,2632,-710
2019,4,20,10,2796,3424,2706,-718
2019,4,20,11,2946,3654,2859,-795
2019,4,20,12,3109,3955,3081,-874
2019,4,20,13,3483,4414,3373,-1041
2019,4,20,14,3788,4778,3583,-1195
2019,4,20,15,3997,4988,3680,-1308
2019,4,20,16,4111,5033,3724,-1309
2019,4,20,17,4160,5055,3744,-1311
2019,4,20,18,4286,5066,3760,-1306
2019,4,20,19,4372,5087,3794,-1293
2019,4,20,20,4391,5157,3850,-1307
2019,4,20,21,4378,5260,3921,-1339
2019,4,20,22,4336,5305,3959,-1346
2019,4,20,23,4307,5259,3926,-1333
2019,4,21,0,4098,5116,3825,-1291
2019,4,21,1,4142,5224,3888,-1336
2019,4,21,2,3958,5039,3752,-1287
2019,4,21,3,3648,4671,3537,-1134
2019,4,21,4,3320,4230,3316,-914
2019,4,21,5,3024,3827,3019,-808
2019,4,21,6,2772,3569,2797,-772
2019,4,21,7,2664,3385,2645,-740
2019,4,21,8,2624,3282,2553,-729
2019,4,21,9,2652,3295,2554,-741
2019,4,21,10,2732,3399,2628,-771
2019,4,21,11,2907,3618,2769,-849
2019,4,21,12,3092,3912,2990,-922
2019,4,21,13,3416,4382,3306,-1076
2019,4,21,14,3730,4705,3569,-1136
2019,4,21,15,3877,4880,3783,-1097
2019,4,21,16,3990,4989,3872,-1117
2019,4,21,17,4036,5071,3993,-1078
2019,4,21,18,4133,5211,4055,-1156
2019,4,21,19,4249,5305,4154,-1151
2019,4,21,20,4334,5476,4336,-1140
2019,4,21,21,4394,5631,4535,-1096
2019,4,21,22,4464,5798,4655,-1143
2019,4,21,23,4400,5730,4640,-1090
2019,4,22,0,4306,5547,4460,-1087
2019,4,22,1,4385,5551,4441,-1110
2019,4,22,2,4139,5223,4153,-1070
2019,4,22,3,3726,4654,3687,-967
2019,4,22,4,3298,4056,3178,-878
2019,4,22,5,2916,3649,2837,-812
2019,4,22,6,2668,3375,2606,-769
2019,4,22,7,2542,3258,2527,-731
2019,4,22,8,2498,3224,2485,-739
2019,4,22,9,2591,3344,2561,-783
2019,4,22,10,2891,3687,2811,-876
2019,4,22,11,3356,4288,3248,-1040
2019,4,22,12,3636,4650,3505,-1145
2019,4,22,13,3725,4761,3545,-1216
2019,4,22,14,3810,4858,3586,-1272
2019,4,22,15,4021,5013,3711,-1302
2019,4,22,16,4175,5171,3838,-1333
2019,4,22,17,4246,5355,3979,-1376
2019,4,22,18,4477,5609,4188,-1421
2019,4,22,19,4736,5921,4418,-1503
2019,4,22,20,5015,6316,4792,-1524
2019,4,22,21,5281,6694,5181,-1513
2019,4,22,22,5405,6934,5435,-1499
2019,4,22,23,5407,6903,5402,-1501
2019,4,23,0,5104,6604,5118,-1486
2019,4,23,1,5034,6428,4961,-1467
2019,4,23,2,4675,5933,4548,-1385
2019,4,23,3,4144,5174,3986,-1188
2019,4,23,4,3607,4458,3527,-931
2019,4,23,5,3119,3932,3102,-830
2019,4,23,6,2852,3620,2870,-750
2019,4,23,7,2723,3464,2735,-729
2019,4,23,8,2655,3400,2679,-721
2019,4,23,9,2694,3465,2722,-743
2019,4,23,10,2934,3766,2950,-816
2019,4,23,11,3381,4358,3371,-987
2019,4,23,12,3623,4663,3611,-1052
2019,4,23,13,3767,4814,3670,-1144
2019,4,23,14,3975,4965,3721,-1244
2019,4,23,15,4214,5203,3915,-1288
2019,4,23,16,4427,5469,3995,-1474
2019,4,23,17,4680,5823,4191,-1632
2019,4,23,18,5015,6168,4445,-1723
2019,4,23,19,5363,6649,4868,-1781
2019,4,23,20,5656,7095,5234,-1861
2019,4,23,21,5921,7496,5588,-1908
2019,4,23,22,6016,9265,7377,-1888
2019,4,23,23,6011,7485,5648,-1837
2019,4,24,0,5666,7101,5301,-1800
2019,4,24,1,5497,6867,5223,-1644
2019,4,24,2,5102,6330,4770,-1560
2019,4,24,3,4540,5556,4239,-1317
2019,4,24,4,3970,4796,3545,-1251
2019,4,24,5,3522,4182,3092,-1090
2019,4,24,6,3184,3831,2792,-1039
2019,4,24,7,2996,3616,2614,-1002
2019,4,24,8,2893,3527,2539,-988
2019,4,24,9,2897,3564,2560,-1004
2019,4,24,10,3104,3846,2784,-1062
2019,4,24,11,3549,4393,3164,-1229
2019,4,24,12,3729,4674,3453,-1221
2019,4,24,13,3938,4886,3653,-1233
2019,4,24,14,4210,5162,3866,-1296
2019,4,24,15,4521,5462,4140,-1322
2019,4,24,16,4906,5843,4356,-1487
2019,4,24,17,5246,6311,4673,-1638
2019,4,24,18,5613,6805,5015,-1790
2019,4,24,19,5978,7315,5398,-1917
2019,4,24,20,6269,7765,5733,-2032
2019,4,24,21,6499,8099,6090,-2009
2019,4,24,22,6552,8199,6238,-1961
2019,4,24,23,6452,7977,6054,-1923
2019,4,25,0,6012,7446,5528,-1918
2019,4,25,1,5814,7190,5292,-1898
2019,4,25,2,5361,6643,4845,-1798
2019,4,25,3,4771,5844,4335,-1509
2019,4,25,4,4184,5096,3799,-1297
2019,4,25,5,3580,4502,3410,-1092
2019,4,25,6,3234,4055,3037,-1018
2019,4,25,7,3039,3808,2833,-975
2019,4,25,8,2933,3684,2728,-956
2019,4,25,9,2939,3694,2739,-955
2019,4,25,10,3147,3963,2924,-1039
2019,4,25,11,3553,4501,3276,-1225
2019,4,25,12,3794,4763,3544,-1219
2019,4,25,13,4012,4987,3736,-1251
2019,4,25,14,4314,5319,4103,-1216
2019,4,25,15,4657,5741,4148,-1593
2019,4,25,16,5022,6152,4289,-1863
2019,4,25,17,5406,6603,4617,-1986
2019,4,25,18,5789,7081,5062,-2019
2019,4,25,19,6107,7469,5298,-2171
2019,4,25,20,6397,7779,5581,-2198
2019,4,25,21,6608,7983,5793,-2190
2019,4,25,22,6717,8085,5859,-2226
2019,4,25,23,6447,7881,5536,-2345
2019,4,26,0,6092,7479,5222,-2257
2019,4,26,1,5936,7303,5019,-2284
2019,4,26,2,5526,6736,4660,-2076
2019,4,26,3,4921,5977,4243,-1734
2019,4,26,4,4329,5273,3825,-1448
2019,4,26,5,3826,4687,3543,-1144
2019,4,26,6,3480,4285,3210,-1075
2019,4,26,7,3242,4054,3022,-1032
2019,4,26,8,3118,3937,2938,-999
2019,4,26,9,3118,3930,2919,-1011
2019,4,26,10,3308,4217,3126,-1091
2019,4,26,11,3697,4745,3472,-1273
2019,4,26,12,3952,5069,3796,-1273
2019,4,26,13,4176,5356,4049,-1307
2019,4,26,14,4567,5614,4287,-1327
2019,4,26,15,4945,5799,4188,-1611
2019,4,26,16,5201,5992,4028,-1964
2019,4,26,17,5359,6395,4160,-2235
2019,4,26,18,5619,6805,4532,-2273
2019,4,26,19,5795,7164,4927,-2237
2019,4,26,20,5856,7454,5233,-2221
2019,4,26,21,5847,7638,5479,-2159
2019,4,26,22,5695,7648,5506,-2142
2019,4,26,23,5408,7368,5272,-2096
2019,4,27,0,5104,6893,4773,-2120
2019,4,27,1,5059,6634,4588,-2046
2019,4,27,2,4767,6225,4325,-1900
2019,4,27,3,4344,5642,3980,-1662
2019,4,27,4,3904,5004,3596,-1408
2019,4,27,5,3402,4472,3351,-1121
2019,4,27,6,3118,4060,3051,-1009
2019,4,27,7,2940,3780,2827,-953
2019,4,27,8,2823,3598,2681,-917
2019,4,27,9,2781,3502,2594,-908
2019,4,27,10,2803,3553,2612,-941
2019,4,27,11,2909,3696,2640,-1056
2019,4,27,12,3045,3962,2866,-1096
2019,4,27,13,3432,4411,3216,-1195
2019,4,27,14,3842,4839,3557,-1282
2019,4,27,15,4152,5199,3601,-1598
2019,4,27,16,4403,5482,3570,-1912
2019,4,27,17,4705,5824,3630,-2194
2019,4,27,18,4975,6249,3944,-2305
2019,4,27,19,5201,6709,4295,-2414
2019,4,27,20,5412,7162,4688,-2474
2019,4,27,21,5582,7542,4961,-2581
2019,4,27,22,5574,7637,5021,-2616
2019,4,27,23,5428,7432,4922,-2510
2019,4,28,0,5041,6827,4458,-2369
2019,4,28,1,4875,6453,4192,-2261
2019,4,28,2,4619,5964,3958,-2006
2019,4,28,3,4190,5369,3729,-1640
2019,4,28,4,3765,4772,3367,-1405
2019,4,28,5,3386,4233,3156,-1077
2019,4,28,6,3081,3845,2873,-972
2019,4,28,7,2876,3595,2658,-937
2019,4,28,8,2765,3467,2552,-915
2019,4,28,9,2712,3409,2509,-900
2019,4,28,10,2712,3449,2527,-922
2019,4,28,11,2824,3582,2554,-1028
2019,4,28,12,3005,3839,2734,-1105
2019,4,28,13,3417,4375,3147,-1228
2019,4,28,14,3900,4983,3643,-1340
2019,4,28,15,4321,5484,3796,-1688
2019,4,28,16,4732,6040,3951,-2089
2019,4,28,17,5121,6616,4197,-2419
2019,4,28,18,5437,7129,4593,-2536
2019,4,28,19,5712,7601,4955,-2646
2019,4,28,20,5990,8015,5369,-2646
2019,4,28,21,6188,8291,5735,-2556
2019,4,28,22,6303,8347,5792,-2555
2019,4,28,23,6032,8093,5609,-2484
2019,4,29,0,5769,7571,5051,-2520
2019,4,29,1,5605,7206,4736,-2470
2019,4,29,2,5193,6642,4472,-2170
2019,4,29,3,4646,5884,4136,-1748
2019,4,29,4,4093,5150,3673,-1477
2019,4,29,5,3589,4505,3327,-1178
2019,4,29,6,3271,4086,3000,-1086
2019,4,29,7,3083,3823,2811,-1012
2019,4,29,8,2988,3666,2723,-943
2019,4,29,9,3003,3663,2709,-954
2019,4,29,10,3232,3942,2894,-1048
2019,4,29,11,3642,4479,3232,-1247
2019,4,29,12,3903,4777,3546,-1231
2019,4,29,13,4169,5118,3820,-1298
2019,4,29,14,4532,5527,4131,-1396
2019,4,29,15,4953,6041,4313,-1728
2019,4,29,16,5379,6568,4430,-2138
2019,4,29,17,5761,7091,4673,-2418
2019,4,29,18,6132,7598,5049,-2549
2019,4,29,19,6461,8054,5408,-2646
2019,4,29,20,6669,8466,5808,-2658
2019,4,29,21,6843,8787,6111,-2676
2019,4,29,22,6834,8859,6168,-2691
2019,4,29,23,6667,8700,6058,-2642
2019,4,30,0,6288,8131,5543,-2588
2019,4,30,1,6093,7768,5205,-2563
2019,4,30,2,5614,7144,4807,-2337
2019,4,30,3,5002,6270,4274,-1996
2019,4,30,4,4401,5455,3750,-1705
2019,4,30,5,3854,4821,3423,-1398
2019,4,30,6,3507,4398,3090,-1308
2019,4,30,7,3287,4128,2896,-1232
2019,4,30,8,3175,3974,2771,-1203
2019,4,30,9,3168,3975,2767,-1208
2019,4,30,10,3384,4220,2953,-1267
2019,4,30,11,3814,4776,3408,-1368
2019,4,30,12,4071,5080,3684,-1396
2019,4,30,13,4331,5430,3953,-1477
2019,4,30,14,4708,5933,4414,-1519
2019,4,30,15,5197,6518,4697,-1821
2019,4,30,16,5596,7112,4852,-2260
2019,4,30,17,5986,7676,5112,-2564
2019,4,30,18,6383,8097,5468,-2629
2019,4,30,19,6714,8569,5903,-2666
2019,4,30,20,6958,8949,6284,-2665
2019,4,30,21,7106,9197,6559,-2638
2019,4,30,22,7060,9176,6537,-2639
2019,4,30,23,6857,8864,6314,-2550
2019,5,1,0,6463,8363,5690,-2673
2019,5,1,1,6246,8064,5354,-2710
2019,5,1,2,5779,7505,4906,-2599
2019,5,1,3,5133,6658,4474,-2184
2019,5,1,4,4524,5828,4028,-1800
2019,5,1,5,4044,5149,3634,-1515
2019,5,1,6,3706,4691,3310,-1381
2019,5,1,7,3482,4412,3093,-1319
2019,5,1,8,3341,4243,2955,-1288
2019,5,1,9,3324,4231,2938,-1293
2019,5,1,10,3513,4465,3116,-1349
2019,5,1,11,3895,4994,3508,-1486
2019,5,1,12,4130,5253,3808,-1445
2019,5,1,13,4415,5604,4098,-1506
2019,5,1,14,4799,6063,4289,-1774
2019,5,1,15,5246,6568,4514,-2054
2019,5,1,16,5649,7057,4743,-2314
2019,5,1,17,5976,7543,5202,-2341
2019,5,1,18,6348,8029,5657,-2372
2019,5,1,19,6652,8455,6099,-2356
2019,5,1,20,6883,8713,6355,-2358
2019,5,1,21,7036,8912,6401,-2511
2019,5,1,22,6978,8881,6375,-2506
2019,5,1,23,6773,8641,6184,-2457
2019,5,2,0,6470,8104,5606,-2498
2019,5,2,1,6190,7829,5332,-2497
2019,5,2,2,5780,7319,4868,-2451
2019,5,2,3,5124,6536,4349,-2187
2019,5,2,4,4533,5673,3864,-1809
2019,5,2,5,4082,5056,3543,-1513
2019,5,2,6,3754,4633,3224,-1409
2019,5,2,7,3525,4387,3043,-1344
2019,5,2,8,3402,4251,2950,-1301
2019,5,2,9,3385,4267,2954,-1313
2019,5,2,10,3575,4483,3142,-1341
2019,5,2,11,3948,5049,3603,-1446
2019,5,2,12,4202,5304,3857,-1447
2019,5,2,13,4473,5658,4105,-1553
2019,5,2,14,4805,6130,4447,-1683
2019,5,2,15,5165,6563,4548,-2015
2019,5,2,16,5520,6975,4668,-2307
2019,5,2,17,5714,7453,5001,-2452
2019,5,2,18,5998,7869,5198,-2671
2019,5,2,19,6195,8181,5447,-2734
2019,5,2,20,6306,8327,5564,-2763
2019,5,2,21,6323,8283,5476,-2807
2019,5,2,22,6226,8091,5315,-2776
2019,5,2,23,6036,7699,5033,-2666
2019,5,3,0,5765,7257,4694,-2563
2019,5,3,1,5644,7110,4590,-2520
2019,5,3,2,5338,6707,4438,-2269
2019,5,3,3,4805,6042,4106,-1936
2019,5,3,4,4304,5398,3789,-1609
2019,5,3,5,4025,4944,3622,-1322
2019,5,3,6,3717,4581,3426,-1155
2019,5,3,7,3520,4355,3257,-1098
2019,5,3,8,3399,4230,3127,-1103
2019,5,3,9,3401,4264,3153,-1111
2019,5,3,10,3563,4535,3371,-1164
2019,5,3,11,3971,5087,3810,-1277
2019,5,3,12,4214,5388,4036,-1352
2019,5,3,13,4479,5717,4263,-1454
2019,5,3,14,4876,6143,4597,-1546
2019,5,3,15,5316,6630,4834,-1796
2019,5,3,16,5636,7121,5036,-2085
2019,5,3,17,5869,7572,5245,-2327
2019,5,3,18,6182,8012,5626,-2386
2019,5,3,19,6368,8375,6012,-2363
2019,5,3,20,6443,8579,6346,-2233
2019,5,3,21,6405,8704,6610,-2094
2019,5,3,22,6349,8663,6614,-2049
2019,5,3,23,6120,8391,6340,-2051
2019,5,4,0,5772,7936,5904,-2032
2019,5,4,1,5575,7591,5274,-2317
2019,5,4,2,5306,7148,4878,-2270
2019,5,4,3,4822,6476,4493,-1983
2019,5,4,4,4380,5758,4116,-1642
2019,5,4,5,4021,5159,3756,-1403
2019,5,4,6,3687,4691,3506,-1185
2019,5,4,7,3464,4389,3271,-1118
2019,5,4,8,3312,4182,3106,-1076
2019,5,4,9,3242,4090,3045,-1045
2019,5,4,10,3259,4123,3067,-1056
2019,5,4,11,3357,4268,3153,-1115
2019,5,4,12,3558,4544,3325,-1219
2019,5,4,13,4073,5253,3885,-1368
2019,5,4,14,4651,6007,4445,-1562
2019,5,4,15,5226,6800,4948,-1852
2019,5,4,16,5684,7519,5307,-2212
2019,5,4,17,6036,8171,5800,-2371
2019,5,4,18,6363,8567,6176,-2391
2019,5,4,19,6632,8764,6428,-2336
2019,5,4,20,6812,8479,6201,-2278
2019,5,4,21,6848,8222,5849,-2373
2019,5,4,22,6762,8221,5802,-2419
2019,5,4,23,6668,8035,5624,-2411
2019,5,5,0,6317,7615,5171,-2444
2019,5,5,1,6054,7423,4964,-2459
2019,5,5,2,5656,6980,4602,-2378
2019,5,5,3,5171,6401,4187,-2214
2019,5,5,4,4668,5800,3924,-1876
2019,5,5,5,4278,5272,3723,-1549
2019,5,5,6,3939,4866,3604,-1262
2019,5,5,7,3706,4566,3389,-1177
2019,5,5,8,3557,4408,3274,-1134
2019,5,5,9,3465,4326,3209,-1117
2019,5,5,10,3429,4334,3216,-1118
2019,5,5,11,3480,4479,3307,-1172
2019,5,5,12,3650,4757,3482,-1275
2019,5,5,13,4156,5471,4026,-1445
2019,5,5,14,4829,6190,4591,-1599
2019,5,5,15,5384,6775,5104,-1671
2019,5,5,16,5845,7167,5282,-1885
2019,5,5,17,6160,7401,5286,-2115
2019,5,5,18,6481,7125,4867,-2258
2019,5,5,19,6721,6612,4483,-2129
2019,5,5,20,6821,6421,4213,-2208
2019,5,5,21,6854,6608,4267,-2341
2019,5,5,22,6835,6868,4467,-2401
2019,5,5,23,6768,6844,4471,-2373
2019,5,6,0,6471,6705,4334,-2371
2019,5,6,1,6192,6720,4352,-2368
2019,5,6,2,5794,6376,4125,-2251
2019,5,6,3,5213,5814,3782,-2032
2019,5,6,4,4643,5219,3512,-1707
2019,5,6,5,3870,4614,3310,-1304
2019,5,6,6,3569,4255,3122,-1133
2019,5,6,7,3383,4034,2959,-1075
2019,5,6,8,3264,3899,2858,-1041
2019,5,6,9,3282,3913,2856,-1057
2019,5,6,10,3497,4200,3094,-1106
2019,5,6,11,3901,4788,3554,-1234
2019,5,6,12,4191,5089,3794,-1295
2019,5,6,13,4499,5454,4085,-1369
2019,5,6,14,4958,5953,4454,-1499
2019,5,6,15,5429,6511,4794,-1717
2019,5,6,16,5877,7055,4891,-2164
2019,5,6,17,6262,7610,5129,-2481
2019,5,6,18,6598,8114,5463,-2651
2019,5,6,19,6879,8466,5823,-2643
2019,5,6,20,7059,8761,6165,-2596
2019,5,6,21,7113,8937,6380,-2557
2019,5,6,22,7069,8984,6456,-2528
2019,5,6,23,6851,8757,6258,-2499
2019,5,7,0,6510,8251,5692,-2559
2019,5,7,1,6234,7850,5328,-2522
2019,5,7,2,5781,7271,4864,-2407
2019,5,7,3,5121,6405,4289,-2116
2019,5,7,4,4536,5580,3864,-1716
2019,5,7,5,3923,5036,3743,-1293
2019,5,7,6,3560,4551,3438,-1113
2019,5,7,7,3351,4271,3224,-1047
2019,5,7,8,3221,4106,3142,-964
2019,5,7,9,3207,4081,3123,-958
2019,5,7,10,3415,4311,3245,-1066
2019,5,7,11,3797,4837,3638,-1199
2019,5,7,12,4055,5161,3900,-1261
2019,5,7,13,4301,5525,4206,-1319
2019,5,7,14,4649,6077,4603,-1474
2019,5,7,15,5057,6659,4921,-1738
2019,5,7,16,5489,7356,5168,-2188
2019,5,7,17,5922,8004,5587,-2417
2019,5,7,18,6316,8601,6085,-2516
2019,5,7,19,6629,9084,6533,-2551
2019,5,7,20,6844,9420,6818,-2602
2019,5,7,21,6981,9609,6964,-2645
2019,5,7,22,7003,9502,6850,-2652
2019,5,7,23,6777,9174,6582,-2592
2019,5,8,0,6416,8633,6047,-2586
2019,5,8,1,6161,8212,5657,-2555
2019,5,8,2,5766,7639,5098,-2541
2019,5,8,3,5134,6810,4610,-2200
2019,5,8,4,4548,5986,4161,-1825
2019,5,8,5,4071,5287,3918,-1369
2019,5,8,6,3755,4803,3601,-1202
2019,5,8,7,3511,4509,3366,-1143
2019,5,8,8,3357,4350,3295,-1055
2019,5,8,9,3334,4304,3222,-1082
2019,5,8,10,3512,4556,3397,-1159
2019,5,8,11,3869,5044,3787,-1257
2019,5,8,12,4115,5339,4033,-1306
2019,5,8,13,4364,5721,4312,-1409
2019,5,8,14,4694,6233,4716,-1517
2019,5,8,15,5125,6832,5068,-1764
2019,5,8,16,5506,7419,5215,-2204
2019,5,8,17,5874,7982,5358,-2624
2019,5,8,18,6241,8451,5778,-2673
2019,5,8,19,6536,8872,6189,-2683
2019,5,8,20,6766,9147,6532,-2615
2019,5,8,21,6890,9290,6671,-2619
2019,5,8,22,6909,9225,6587,-2638
2019,5,8,23,6643,8843,6284,-2559
2019,5,9,0,6290,8308,5752,-2556
2019,5,9,1,6043,7934,5351,-2583
2019,5,9,2,5641,7358,4832,-2526
2019,5,9,3,5034,6544,4393,-2151
2019,5,9,4,4455,5690,3917,-1773
2019,5,9,5,4144,5074,3702,-1372
2019,5,9,6,3802,4617,3390,-1227
2019,5,9,7,3571,4381,3239,-1142
2019,5,9,8,3441,4234,3175,-1059
2019,5,9,9,3445,4221,3099,-1122
2019,5,9,10,3623,4470,3288,-1182
2019,5,9,11,3997,5032,3728,-1304
2019,5,9,12,4250,5297,3895,-1402
2019,5,9,13,4535,5623,4245,-1378
2019,5,9,14,4876,6161,4631,-1530
2019,5,9,15,5344,6784,5032,-1752
2019,5,9,16,5717,7371,5338,-2033
2019,5,9,17,6057,7950,5652,-2298
2019,5,9,18,6441,8458,6058,-2400
2019,5,9,19,6732,8726,6397,-2329
2019,5,9,20,6889,8845,6489,-2356
2019,5,9,21,6924,8915,6513,-2402
2019,5,9,22,6833,8758,6515,-2243
2019,5,9,23,6626,8450,6203,-2247
2019,5,10,0,6298,8097,5867,-2230
2019,5,10,1,6076,7853,5686,-2167
2019,5,10,2,5724,7389,5210,-2179
2019,5,10,3,5133,6631,4618,-2013
2019,5,10,4,4572,5899,4057,-1842
2019,5,10,5,4163,5290,3864,-1426
2019,5,10,6,3836,4873,3645,-1228
2019,5,10,7,3629,4619,3452,-1167
2019,5,10,8,3506,4419,3302,-1117
2019,5,10,9,3466,4395,3269,-1126
2019,5,10,10,3651,4608,3418,-1190
2019,5,10,11,4035,5069,3814,-1255
2019,5,10,12,4295,5365,3976,-1389
2019,5,10,13,4620,5863,4370,-1493
2019,5,10,14,5107,6438,4826,-1612
2019,5,10,15,5639,7036,5254,-1782
2019,5,10,16,6071,7642,5523,-2119
2019,5,10,17,6452,8255,6004,-2251
2019,5,10,18,6815,8818,6373,-2445
2019,5,10,19,7111,9169,6708,-2461
2019,5,10,20,7288,9360,6939,-2421
2019,5,10,21,7386,9314,6940,-2374
2019,5,10,22,7290,9115,6794,-2321
2019,5,10,23,7039,8722,6405,-2317
2019,5,11,0,6567,8188,5907,-2281
2019,5,11,1,6256,7858,5428,-2430
2019,5,11,2,5919,7421,5094,-2327
2019,5,11,3,5356,6689,4558,-2131
2019,5,11,4,4839,5959,4181,-1778
2019,5,11,5,4408,5380,3947,-1433
2019,5,11,6,4030,4929,3664,-1265
2019,5,11,7,3774,4584,3413,-1171
2019,5,11,8,3612,4384,3248,-1136
2019,5,11,9,3493,4268,3168,-1100
2019,5,11,10,3483,4302,3183,-1119
2019,5,11,11,3565,4409,3269,-1140
2019,5,11,12,3782,4723,3480,-1243
2019,5,11,13,4315,5466,4043,-1423
2019,5,11,14,5023,6241,4785,-1456
2019,5,11,15,5603,6944,5329,-1615
2019,5,11,16,6099,7645,5552,-2093
2019,5,11,17,6527,8248,5976,-2272
2019,5,11,18,6862,8770,6434,-2336
2019,5,11,19,7089,9191,6730,-2461
2019,5,11,20,7285,9518,6935,-2583
2019,5,11,21,7339,9647,7072,-2575
2019,5,11,22,7261,9522,7020,-2502
2019,5,11,23,7076,9105,6729,-2376
2019,5,12,0,6655,8508,6242,-2266
2019,5,12,1,6405,8109,5813,-2296
2019,5,12,2,6051,7560,5390,-2170
2019,5,12,3,5500,6826,4930,-1896
2019,5,12,4,4997,6018,4445,-1573
2019,5,12,5,4382,5511,4062,-1449
2019,5,12,6,4019,5040,3768,-1272
2019,5,12,7,3787,4694,3502,-1192
2019,5,12,8,3628,4494,3331,-1163
2019,5,12,9,3535,4368,3249,-1119
2019,5,12,10,3508,4370,3243,-1127
2019,5,12,11,3563,4468,3293,-1175
2019,5,12,12,3753,4744,3470,-1274
2019,5,12,13,4373,5509,4035,-1474
2019,5,12,14,5110,6393,4867,-1526
2019,5,12,15,5680,7124,5415,-1709
2019,5,12,16,6187,7759,5587,-2172
2019,5,12,17,6598,8341,6026,-2315
2019,5,12,18,6945,8669,6382,-2287
2019,5,12,19,7204,8803,6422,-2381
2019,5,12,20,7361,8933,6560,-2373
2019,5,12,21,7412,8906,6567,-2339
2019,5,12,22,7388,8727,6437,-2290
2019,5,12,23,7247,8444,6141,-2303
2019,5,13,0,6885,8059,5641,-2418
2019,5,13,1,6699,7887,5314,-2573
2019,5,13,2,6285,7408,4956,-2452
2019,5,13,3,5664,6683,4546,-2137
2019,5,13,4,5048,6009,4127,-1882
2019,5,13,5,4482,5590,4127,-1463
2019,5,13,6,4091,5191,3911,-1280
2019,5,13,7,3862,4896,3706,-1190
2019,5,13,8,3729,4768,3608,-1160
2019,5,13,9,3724,4777,3617,-1160
2019,5,13,10,3900,5056,3831,-1225
2019,5,13,11,4285,5633,4256,-1377
2019,5,13,12,4553,5957,4500,-1457
2019,5,13,13,4912,6400,4840,-1560
2019,5,13,14,5404,6959,5324,-1635
2019,5,13,15,5955,7478,5691,-1787
2019,5,13,16,6390,7578,5697,-1881
2019,5,13,17,6659,7416,5365,-2051
2019,5,13,18,6971,7071,5011,-2060
2019,5,13,19,7165,6762,4834,-1928
2019,5,13,20,7146,6582,4625,-1957
2019,5,13,21,7081,6598,4621,-1977
2019,5,13,22,6900,6860,4829,-2031
2019,5,13,23,6613,7000,4838,-2162
2019,5,14,0,6320,6964,4738,-2226
2019,5,14,1,6094,6829,4455,-2374
2019,5,14,2,5727,6513,4184,-2329
2019,5,14,3,5148,5902,3888,-2014
2019,5,14,4,4597,5217,3584,-1633
2019,5,14,5,4050,4568,3326,-1242
2019,5,14,6,3765,4211,3157,-1054
2019,5,14,7,3555,4008,2985,-1023
2019,5,14,8,3455,3885,2900,-985
2019,5,14,9,3439,3934,2932,-1002
2019,5,14,10,3653,4231,3165,-1066
2019,5,14,11,4034,4808,3605,-1203
2019,5,14,12,4279,5105,3851,-1254
2019,5,14,13,4530,5377,4060,-1317
2019,5,14,14,4811,5728,4339,-1389
2019,5,14,15,5146,6177,4602,-1575
2019,5,14,16,5471,6493,4535,-1958
2019,5,14,17,5615,6778,4478,-2300
2019,5,14,18,5859,6860,4430,-2430
2019,5,14,19,6046,6922,4530,-2392
2019,5,14,20,6104,7075,4631,-2444
2019,5,14,21,6150,7225,4829,-2396
2019,5,14,22,6067,7213,4865,-2348
2019,5,14,23,5956,7041,4673,-2368
2019,5,15,0,5741,6824,4454,-2370
2019,5,15,1,5534,6745,4352,-2393
2019,5,15,2,5273,6372,4044,-2328
2019,5,15,3,4720,5741,3742,-1999
2019,5,15,4,4206,5060,3415,-1645
2019,5,15,5,3668,4537,3312,-1225
2019,5,15,6,3366,4201,3143,-1058
2019,5,15,7,3185,3986,2985,-1001
2019,5,15,8,3088,3867,2885,-982
2019,5,15,9,3096,3906,2916,-990
2019,5,15,10,3319,4178,3099,-1079
2019,5,15,11,3685,4724,3474,-1250
2019,5,15,12,3938,4960,3672,-1288
2019,5,15,13,4197,5195,3893,-1302
2019,5,15,14,4553,5522,4156,-1366
2019,5,15,15,4961,5991,4385,-1606
2019,5,15,16,5341,6499,4487,-2012
2019,5,15,17,5633,6998,4566,-2432
2019,5,15,18,5972,7490,4953,-2537
2019,5,15,19,6225,7878,5316,-2562
2019,5,15,20,6429,8220,5653,-2567
2019,5,15,21,6545,8451,5896,-2555
2019,5,15,22,6509,8450,5935,-2515
2019,5,15,23,6289,8224,5787,-2437
2019,5,16,0,5969,7671,5239,-2432
2019,5,16,1,5770,7334,4868,-2466
2019,5,16,2,5420,6876,4435,-2441
2019,5,16,3,4855,6107,3943,-2164
2019,5,16,4,4302,5319,3602,-1717
2019,5,16,5,3750,4724,3445,-1279
2019,5,16,6,3437,4292,3187,-1105
2019,5,16,7,3240,4040,3001,-1039
2019,5,16,8,3137,3884,2885,-999
2019,5,16,9,3147,3894,2893,-1001
2019,5,16,10,3342,4139,3074,-1065
2019,5,16,11,3731,4616,3433,-1183
2019,5,16,12,3987,4923,3668,-1255
2019,5,16,13,4272,5284,3916,-1368
2019,5,16,14,4626,5762,4257,-1505
2019,5,16,15,5056,6363,4622,-1741
2019,5,16,16,5430,6924,4886,-2038
2019,5,16,17,5778,7474,5205,-2269
2019,5,16,18,6144,7951,5517,-2434
2019,5,16,19,6431,8336,5703,-2633
2019,5,16,20,6656,8662,5993,-2669
2019,5,16,21,6786,8868,6151,-2717
2019,5,16,22,6756,8887,6133,-2754
2019,5,16,23,6570,8663,5921,-2742
2019,5,17,0,6184,8162,5585,-2577
2019,5,17,1,5979,7752,5212,-2540
2019,5,17,2,5608,7259,4906,-2353
2019,5,17,3,5024,6418,4412,-2006
2019,5,17,4,4456,5641,3923,-1718
2019,5,17,5,3957,4935,3618,-1317
2019,5,17,6,3595,4454,3305,-1149
2019,5,17,7,3373,4133,3054,-1079
2019,5,17,8,3246,3932,2902,-1030
2019,5,17,9,3231,3925,2882,-1043
2019,5,17,10,3417,4129,3053,-1076
2019,5,17,11,3764,4593,3400,-1193
2019,5,17,12,4033,4917,3655,-1262
2019,5,17,13,4378,5318,3984,-1334
2019,5,17,14,4815,5796,4459,-1337
2019,5,17,15,5317,6411,4919,-1492
2019,5,17,16,5740,6980,5104,-1876
2019,5,17,17,6090,7609,5350,-2259
2019,5,17,18,6456,8167,5654,-2513
2019,5,17,19,6730,8551,5964,-2587
2019,5,17,20,6918,8847,6221,-2626
2019,5,17,21,7004,9081,6396,-2685
2019,5,17,22,6912,9066,6382,-2684
2019,5,17,23,6669,8753,6154,-2599
2019,5,18,0,6190,8153,5679,-2474
2019,5,18,1,5948,7650,5161,-2489
2019,5,18,2,5616,7141,4855,-2286
2019,5,18,3,5095,6469,4385,-2084
2019,5,18,4,4593,5736,3952,-1784
2019,5,18,5,3993,5224,3867,-1357
2019,5,18,6,3638,4727,3553,-1174
2019,5,18,7,3380,4366,3292,-1074
2019,5,18,8,3220,4156,3125,-1031
2019,5,18,9,3128,4057,3050,-1007
2019,5,18,10,3132,4070,3048,-1022
2019,5,18,11,3206,4160,3113,-1047
2019,5,18,12,3417,4432,3302,-1130
2019,5,18,13,3936,5077,3802,-1275
2019,5,18,14,4493,5776,4214,-1562
2019,5,18,15,5022,6422,4511,-1911
2019,5,18,16,5488,7085,4966,-2119
2019,5,18,17,5914,7710,5157,-2553
2019,5,18,18,6273,8247,5584,-2663
2019,5,18,19,6559,8658,5938,-2720
2019,5,18,20,6795,8893,6125,-2768
2019,5,18,21,6915,9041,6237,-2804
2019,5,18,22,6825,9062,6245,-2817
2019,5,18,23,6634,8793,6037,-2756
2019,5,19,0,6251,8240,5616,-2624
2019,5,19,1,5937,7674,5281,-2393
2019,5,19,2,5555,7350,5053,-2297
2019,5,19,3,5005,6472,4437,-2035
2019,5,19,4,4515,5750,4002,-1748
2019,5,19,5,4052,4993,3662,-1331
2019,5,19,6,3700,4478,3355,-1123
2019,5,19,7,3431,4167,3100,-1067
2019,5,19,8,3263,3962,3041,-921
2019,5,19,9,3162,3869,3017,-852
2019,5,19,10,3147,3852,3014,-838
2019,5,19,11,3213,3903,3016,-887
2019,5,19,12,3400,4181,3101,-1080
2019,5,19,13,3934,4893,3632,-1261
2019,5,19,14,4558,5677,4103,-1574
2019,5,19,15,5121,6433,4518,-1915
2019,5,19,16,5679,7166,4862,-2304
2019,5,19,17,6063,7884,5185,-2699
2019,5,19,18,6441,8449,5713,-2736
2019,5,19,19,6634,8903,6128,-2775
2019,5,19,20,6870,9233,6398,-2835
2019,5,19,21,7002,9451,6541,-2910
2019,5,19,22,6977,9481,6586,-2895
2019,5,19,23,6781,9266,6370,-2896
2019,5,20,0,6451,8716,5965,-2751
2019,5,20,1,6164,8230,5711,-2519
2019,5,20,2,5762,7627,5249,-2378
2019,5,20,3,5128,6746,4639,-2107
2019,5,20,4,4536,5973,4143,-1830
2019,5,20,5,4107,5420,4014,-1406
2019,5,20,6,3728,4946,3751,-1195
2019,5,20,7,3482,4642,3537,-1105
2019,5,20,8,3349,4467,3384,-1083
2019,5,20,9,3344,4444,3367,-1077
2019,5,20,10,3532,4701,3557,-1144
2019,5,20,11,3887,5144,3904,-1240
2019,5,20,12,4209,5511,4223,-1288
2019,5,20,13,4571,5978,4553,-1425
2019,5,20,14,5093,6625,4935,-1690
2019,5,20,15,5727,7366,5367,-1999
2019,5,20,16,6235,8115,5789,-2326
2019,5,20,17,6699,8737,6194,-2543
2019,5,20,18,7117,9253,6679,-2574
2019,5,20,19,7470,9699,7032,-2667
2019,5,20,20,7687,10024,7259,-2765
2019,5,20,21,7801,10231,7463,-2768
2019,5,20,22,7797,10246,7504,-2742
2019,5,20,23,7580,9966,7245,-2721
2019,5,21,0,7175,9404,6819,-2585
2019,5,21,1,6772,8908,6426,-2482
2019,5,21,2,6275,8316,5881,-2435
2019,5,21,3,5605,7374,5270,-2104
2019,5,21,4,4962,6483,4648,-1835
2019,5,21,5,4366,5650,4051,-1599
2019,5,21,6,3984,5160,3641,-1519
2019,5,21,7,3729,4823,3375,-1448
2019,5,21,8,3584,4638,3203,-1435
2019,5,21,9,3552,4573,3168,-1405
2019,5,21,10,3725,4779,3315,-1464
2019,5,21,11,4103,5203,3560,-1643
2019,5,21,12,4393,5554,3889,-1665
2019,5,21,13,4775,6017,4264,-1753
2019,5,21,14,5344,6657,4558,-2099
2019,5,21,15,5922,7383,5040,-2343
2019,5,21,16,6441,8178,5637,-2541
2019,5,21,17,6907,8855,6328,-2527
2019,5,21,18,7317,9416,6744,-2672
2019,5,21,19,7659,9836,7149,-2687
2019,5,21,20,7851,10158,7390,-2768
2019,5,21,21,7975,10383,7574,-2809
2019,5,21,22,7891,10428,7693,-2735
2019,5,21,23,7617,10180,7485,-2695
2019,5,22,0,7187,9643,7005,-2638
2019,5,22,1,6846,9132,6531,-2601
2019,5,22,2,6375,8483,6032,-2451
2019,5,22,3,5694,7493,5205,-2288
2019,5,22,4,5030,6627,4722,-1905
2019,5,22,5,4590,5926,4212,-1714
2019,5,22,6,4158,5426,3855,-1571
2019,5,22,7,3875,5083,3577,-1506
2019,5,22,8,3704,4846,3392,-1454
2019,5,22,9,3661,4784,3360,-1424
2019,5,22,10,3831,4918,3472,-1446
2019,5,22,11,4178,5291,3654,-1637
2019,5,22,12,4455,5620,4008,-1612
2019,5,22,13,4840,6101,4363,-1738
2019,5,22,14,5410,6693,4786,-1907
2019,5,22,15,6003,7429,5286,-2143
2019,5,22,16,6603,8158,5747,-2411
2019,5,22,17,6906,8887,6265,-2622
2019,5,22,18,7361,9406,6766,-2640
2019,5,22,19,7638,9804,7188,-2616
2019,5,22,20,7823,10146,7460,-2686
2019,5,22,21,7953,10295,7573,-2722
2019,5,22,22,7876,10237,7523,-2714
2019,5,22,23,7582,9863,7219,-2644
2019,5,23,0,7158,9280,6721,-2559
2019,5,23,1,6796,8707,6220,-2487
2019,5,23,2,6356,8086,5746,-2340
2019,5,23,3,5681,7169,5117,-2052
2019,5,23,4,5017,6258,4570,-1688
2019,5,23,5,4438,5533,4099,-1434
2019,5,23,6,4036,5028,3784,-1244
2019,5,23,7,3760,4683,3528,-1155
2019,5,23,8,3609,4447,3344,-1103
2019,5,23,9,3558,4405,3322,-1083
2019,5,23,10,3695,4600,3471,-1129
2019,5,23,11,4027,5007,3775,-1232
2019,5,23,12,4301,5318,3985,-1333
2019,5,23,13,4614,5848,4388,-1460
2019,5,23,14,5018,6480,4714,-1766
2019,5,23,15,5498,7208,5129,-2079
2019,5,23,16,5935,7843,5550,-2293
2019,5,23,17,6337,8525,5961,-2564
2019,5,23,18,6737,9105,6352,-2753
2019,5,23,19,7087,9566,6829,-2737
2019,5,23,20,7328,9838,7073,-2765
2019,5,23,21,7451,9961,7055,-2906
2019,5,23,22,7364,9875,7021,-2854
2019,5,23,23,7063,9469,6856,-2613
2019,5,24,0,6691,8884,6302,-2582
2019,5,24,1,6340,8380,5917,-2463
2019,5,24,2,5947,7827,5502,-2325
2019,5,24,3,5311,6987,4937,-2050
2019,5,24,4,4715,6149,4553,-1596
2019,5,24,5,4286,5451,4058,-1393
2019,5,24,6,3877,4900,3669,-1231
2019,5,24,7,3599,4537,3395,-1142
2019,5,24,8,3440,4296,3201,-1095
2019,5,24,9,3398,4206,3141,-1065
2019,5,24,10,3542,4390,3261,-1129
2019,5,24,11,3874,4780,3580,-1200
2019,5,24,12,4170,5121,3989,-1132
2019,5,24,13,4523,5591,4437,-1154
2019,5,24,14,4995,6149,4798,-1351
2019,5,24,15,5597,6783,5002,-1781
2019,5,24,16,6138,7431,5283,-2148
2019,5,24,17,6612,8113,5677,-2436
2019,5,24,18,7090,8771,6147,-2624
2019,5,24,19,7415,9357,6555,-2802
2019,5,24,20,7649,9773,6917,-2856
2019,5,24,21,7811,10006,7114,-2892
2019,5,24,22,7670,10008,7081,-2927
2019,5,24,23,7253,9679,6812,-2867
2019,5,25,0,6785,9027,6432,-2595
2019,5,25,1,6366,8414,5980,-2434
2019,5,25,2,6011,7853,5496,-2357
2019,5,25,3,5455,7026,4975,-2051
2019,5,25,4,4899,6271,4549,-1722
2019,5,25,5,4440,5584,4144,-1440
2019,5,25,6,4017,5052,3792,-1260
2019,5,25,7,3712,4678,3508,-1170
2019,5,25,8,3528,4430,3327,-1103
2019,5,25,9,3438,4281,3234,-1047
2019,5,25,10,3424,4241,3200,-1041
2019,5,25,11,3457,4333,3225,-1108
2019,5,25,12,3665,4595,3391,-1204
2019,5,25,13,4231,5342,4045,-1297
2019,5,25,14,4915,6159,4677,-1482
2019,5,25,15,5623,6953,4988,-1965
2019,5,25,16,6178,7786,5343,-2443
2019,5,25,17,6654,8572,5923,-2649
2019,5,25,18,7148,9239,6407,-2832
2019,5,25,19,7612,9728,6778,-2950
2019,5,25,20,7854,10027,7093,-2934
2019,5,25,21,8018,10199,7174,-3025
2019,5,25,22,8006,10158,7155,-3003
2019,5,25,23,7760,9871,6922,-2949
2019,5,26,0,7158,9296,6402,-2894
2019,5,26,1,6843,8776,6051,-2725
2019,5,26,2,6456,8209,5643,-2566
2019,5,26,3,5883,7408,5196,-2212
2019,5,26,4,5296,6659,4841,-1818
2019,5,26,5,4582,5961,4503,-1458
2019,5,26,6,4199,5394,4056,-1338
2019,5,26,7,3881,4978,3728,-1250
2019,5,26,8,3689,4683,3535,-1148
2019,5,26,9,3555,4521,3435,-1086
2019,5,26,10,3494,4458,3433,-1025
2019,5,26,11,3519,4461,3438,-1023
2019,5,26,12,3705,4732,3605,-1127
2019,5,26,13,4329,5503,4240,-1263
2019,5,26,14,5196,6381,4815,-1566
2019,5,26,15,5873,7198,5178,-2020
2019,5,26,16,6462,8036,5539,-2497
2019,5,26,17,7031,8857,6131,-2726
2019,5,26,18,7470,9536,6781,-2755
2019,5,26,19,7710,10053,7219,-2834
2019,5,26,20,7896,10344,7559,-2785
2019,5,26,21,7997,10532,7693,-2839
2019,5,26,22,7912,10503,7671,-2832
2019,5,26,23,7600,10211,7395,-2816
2019,5,27,0,7206,9633,6950,-2683
2019,5,27,1,6862,9037,6456,-2581
2019,5,27,2,6461,8451,5866,-2585
2019,5,27,3,5887,7613,5360,-2253
2019,5,27,4,5287,6836,4987,-1849
2019,5,27,5,4717,6146,4655,-1491
2019,5,27,6,4306,5599,4218,-1381
2019,5,27,7,3983,5180,3879,-1301
2019,5,27,8,3772,4884,3675,-1209
2019,5,27,9,3690,4723,3531,-1192
2019,5,27,10,3672,4697,3513,-1184
2019,5,27,11,3756,4729,3545,-1184
2019,5,27,12,3919,4944,3771,-1173
2019,5,27,13,4566,5716,4486,-1230
2019,5,27,14,5453,6676,5118,-1558
2019,5,27,15,6222,7659,5589,-2070
2019,5,27,16,7003,8576,5968,-2608
2019,5,27,17,7547,9366,6585,-2781
2019,5,27,18,7987,9934,7087,-2847
2019,5,27,19,8348,10400,7453,-2947
2019,5,27,20,8598,10720,7709,-3011
2019,5,27,21,8780,10900,7860,-3040
2019,5,27,22,8713,10830,7821,-3009
2019,5,27,23,8193,10452,7561,-2891
2019,5,28,0,7678,9888,7063,-2825
2019,5,28,1,7364,9427,6628,-2799
2019,5,28,2,6909,8866,6259,-2607
2019,5,28,3,6238,7966,5737,-2229
2019,5,28,4,5535,7112,5287,-1825
2019,5,28,5,4916,6390,4809,-1581
2019,5,28,6,4482,5867,4398,-1469
2019,5,28,7,4148,5478,4095,-1383
2019,5,28,8,3947,5227,3899,-1328
2019,5,28,9,3891,5130,3824,-1306
2019,5,28,10,4036,5298,3950,-1348
2019,5,28,11,4379,5651,4245,-1406
2019,5,28,12,4661,5970,4612,-1358
2019,5,28,13,5157,6499,5144,-1355
2019,5,28,14,5817,7245,5622,-1623
2019,5,28,15,6532,8127,6109,-2018
2019,5,28,16,7205,8982,6504,-2478
2019,5,28,17,7761,9795,6990,-2805
2019,5,28,18,8322,10473,7638,-2835
2019,5,28,19,8712,10918,8018,-2900
2019,5,28,20,8922,11212,8261,-2951
2019,5,28,21,9082,11292,8338,-2954
2019,5,28,22,8931,11181,8234,-2947
2019,5,28,23,8507,10802,7952,-2850
2019,5,29,0,8048,10336,7411,-2925
2019,5,29,1,7634,9781,6948,-2833
2019,5,29,2,7075,9093,6445,-2648
2019,5,29,3,6290,8194,5942,-2252
2019,5,29,4,5573,7266,5387,-1879
2019,5,29,5,5005,6498,4870,-1628
2019,5,29,6,4509,5872,4426,-1446
2019,5,29,7,4168,5468,4114,-1354
2019,5,29,8,3968,5135,3871,-1264
2019,5,29,9,3891,5004,3761,-1243
2019,5,29,10,4010,5117,3847,-1270
2019,5,29,11,4340,5413,4097,-1316
2019,5,29,12,4610,5727,4317,-1410
2019,5,29,13,4985,6241,4760,-1481
2019,5,29,14,5616,6893,5205,-1688
2019,5,29,15,6250,7625,5660,-1965
2019,5,29,16,6872,8422,6102,-2320
2019,5,29,17,7451,9218,6712,-2506
2019,5,29,18,7988,9913,7236,-2677
2019,5,29,19,8416,10416,7644,-2772
2019,5,29,20,8690,10785,7875,-2910
2019,5,29,21,8860,11003,8033,-2970
2019,5,29,22,8726,10968,8009,-2959
2019,5,29,23,8402,10696,7786,-2910
2019,5,30,0,7839,10052,7269,-2783
2019,5,30,1,7405,9343,6739,-2604
2019,5,30,2,6943,8707,6234,-2473
2019,5,30,3,6198,7767,5596,-2171
2019,5,30,4,5497,6827,4878,-1949
2019,5,30,5,4885,6093,4524,-1569
2019,5,30,6,4418,5554,4202,-1352
2019,5,30,7,4113,5210,3937,-1273
2019,5,30,8,3911,4969,3753,-1216
2019,5,30,9,3852,4892,3711,-1181
2019,5,30,10,4010,5054,3828,-1226
2019,5,30,11,4346,5399,4104,-1295
2019,5,30,12,4626,5736,4331,-1405
2019,5,30,13,5000,6340,4798,-1542
2019,5,30,14,5602,7182,5399,-1783
2019,5,30,15,6198,8073,5881,-2192
2019,5,30,16,6751,8902,6269,-2633
2019,5,30,17,7229,9681,6939,-2742
2019,5,30,18,7708,10302,7488,-2814
2019,5,30,19,8105,10747,7826,-2921
2019,5,30,20,8396,11057,8048,-3009
2019,5,30,21,8531,11226,8293,-2933
2019,5,30,22,8448,11156,8256,-2900
2019,5,30,23,8209,10867,7936,-2931
2019,5,31,0,7697,10241,7387,-2854
2019,5,31,1,7342,9738,6925,-2813
2019,5,31,2,6869,9160,6501,-2659
2019,5,31,3,6191,8265,5941,-2324
2019,5,31,4,5509,7352,5317,-2035
2019,5,31,5,5071,6582,4889,-1693
2019,5,31,6,4608,6000,4512,-1488
2019,5,31,7,4287,5607,4216,-1391
2019,5,31,8,4097,5342,3999,-1343
2019,5,31,9,4017,5244,3923,-1321
2019,5,31,10,4157,5385,4026,-1359
2019,5,31,11,4438,5685,4270,-1415
2019,5,31,12,4735,6027,4550,-1477
2019,5,31,13,5223,6602,4968,-1634
2019,5,31,14,5830,7538,5659,-1879
2019,5,31,15,6453,8377,6164,-2213
2019,5,31,16,7028,9089,6461,-2628
2019,5,31,17,7479,9770,7253,-2517
2019,5,31,18,7914,10347,7731,-2616
2019,5,31,19,8220,10719,8145,-2574
2019,5,31,20,8412,10941,8391,-2550
2019,5,31,21,8461,11012,8480,-2532
2019,5,31,22,8292,10729,8223,-2506
2019,5,31,23,8018,10249,7672,-2577
2019,6,1,0,7541,9701,7060,-2641
2019,6,1,1,7076,9200,6462,-2738
2019,6,1,2,6697,8675,6122,-2553
2019,6,1,3,6102,7953,5734,-2219
2019,6,1,4,5525,7180,5185,-1995
2019,6,1,5,5133,6500,4828,-1672
2019,6,1,6,4669,5966,4494,-1472
2019,6,1,7,4342,5598,4202,-1396
2019,6,1,8,4122,5303,3977,-1326
2019,6,1,9,3981,5194,3886,-1308
2019,6,1,10,3940,5190,3896,-1294
2019,6,1,11,3926,5246,3939,-1307
2019,6,1,12,4125,5588,4307,-1281
2019,6,1,13,4731,6391,5005,-1386
2019,6,1,14,5383,7233,5699,-1534
2019,6,1,15,6060,8009,6355,-1654
2019,6,1,16,6630,8774,6765,-2009
2019,6,1,17,7195,9479,7320,-2159
2019,6,1,18,7625,9979,7376,-2603
2019,6,1,19,7907,10269,8020,-2249
2019,6,1,20,8049,10445,8206,-2239
2019,6,1,21,8022,10356,8233,-2123
2019,6,1,22,7915,10068,7782,-2286
2019,6,1,23,7604,9602,7364,-2238
2019,6,2,0,7209,9047,6879,-2168
2019,6,2,1,6819,8607,6670,-1937
2019,6,2,2,6484,8147,6319,-1828
2019,6,2,3,5938,7415,5709,-1706
2019,6,2,4,5405,6738,5046,-1692
2019,6,2,5,4918,6134,4599,-1535
2019,6,2,6,4468,5628,4194,-1434
2019,6,2,7,4152,5261,3921,-1340
2019,6,2,8,3920,5014,3701,-1313
2019,6,2,9,3790,4855,3589,-1266
2019,6,2,10,3713,4831,3579,-1252
2019,6,2,11,3688,4842,3587,-1255
2019,6,2,12,3875,5168,3962,-1206
2019,6,2,13,4518,6033,4605,-1428
2019,6,2,14,5290,6987,5206,-1781
2019,6,2,15,5965,7856,5958,-1898
2019,6,2,16,6629,8551,6538,-2013
2019,6,2,17,7171,9180,7139,-2041
2019,6,2,18,7606,9632,7431,-2201
2019,6,2,19,7923,9952,7653,-2299
2019,6,2,20,8107,10202,7955,-2247
2019,6,2,21,8192,10434,8201,-2233
2019,6,2,22,8099,10481,8258,-2223
2019,6,2,23,7906,10233,8034,-2199
2019,6,3,0,7459,9747,7481,-2266
2019,6,3,1,7084,9206,7082,-2124
2019,6,3,2,6686,8697,6708,-1989
2019,6,3,3,6021,7846,6090,-1756
2019,6,3,4,5359,7010,5221,-1789
2019,6,3,5,4851,6295,4740,-1555
2019,6,3,6,4425,5764,4342,-1422
2019,6,3,7,4149,5389,4047,-1342
2019,6,3,8,3987,5170,3874,-1296
2019,6,3,9,3957,5105,3825,-1280
2019,6,3,10,4121,5285,3971,-1314
2019,6,3,11,4447,5641,4273,-1368
2019,6,3,12,4762,6018,4697,-1321
2019,6,3,13,5211,6699,5225,-1474
2019,6,3,14,5960,7515,5746,-1769
2019,6,3,15,6587,8314,6442,-1872
2019,6,3,16,7221,9074,7200,-1874
2019,6,3,17,7799,9718,7707,-2011
2019,6,3,18,8280,9890,7848,-2042
2019,6,3,19,8596,10092,8035,-2057
2019,6,3,20,8796,10348,8285,-2063
2019,6,3,21,8835,10476,8317,-2159
2019,6,3,22,8699,10469,8364,-2105
2019,6,3,23,8449,10340,8286,-2054
2019,6,4,0,7997,9907,7777,-2130
2019,6,4,1,7532,9393,7281,-2112
2019,6,4,2,7058,8847,6875,-1972
2019,6,4,3,6358,7981,6203,-1778
2019,6,4,4,5680,7091,5303,-1788
2019,6,4,5,5186,6346,4794,-1552
2019,6,4,6,4731,5823,4368,-1455
2019,6,4,7,4427,5441,4069,-1372
2019,6,4,8,4248,5178,3871,-1307
2019,6,4,9,4172,5119,3821,-1298
2019,6,4,10,4311,5265,3941,-1324
2019,6,4,11,4620,5588,4227,-1361
2019,6,4,12,4912,5943,4615,-1328
2019,6,4,13,5355,6623,5152,-1471
2019,6,4,14,6004,7488,5760,-1728
2019,6,4,15,6587,8411,6508,-1903
2019,6,4,16,7168,9335,7374,-1961
2019,6,4,17,7727,10044,7919,-2125
2019,6,4,18,8207,10488,8331,-2157
2019,6,4,19,8514,10799,8574,-2225
2019,6,4,20,8712,10910,8837,-2073
2019,6,4,21,8823,10793,8760,-2033
2019,6,4,22,8678,10660,8593,-2067
2019,6,4,23,8466,10272,8230,-2042
2019,6,5,0,7991,9684,7607,-2077
2019,6,5,1,7536,9138,7073,-2065
2019,6,5,2,7099,8601,6647,-1954
2019,6,5,3,6428,7808,6015,-1793
2019,6,5,4,5738,6942,5215,-1727
2019,6,5,5,5085,6237,4706,-1531
2019,6,5,6,4636,5738,4334,-1404
2019,6,5,7,4329,5374,4049,-1325
2019,6,5,8,4152,5141,3867,-1274
2019,6,5,9,4102,5078,3837,-1241
2019,6,5,10,4234,5221,3951,-1270
2019,6,5,11,4519,5530,4204,-1326
2019,6,5,12,4807,5894,4620,-1274
2019,6,5,13,5313,6494,5093,-1401
2019,6,5,14,5951,7264,5571,-1693
2019,6,5,15,6547,8115,6133,-1982
2019,6,5,16,7145,8910,6851,-2059
2019,6,5,17,7696,9611,7618,-1993
2019,6,5,18,8132,10170,8061,-2109
2019,6,5,19,8457,10504,8388,-2116
2019,6,5,20,8693,10556,8465,-2091
2019,6,5,21,8780,10524,8480,-2044
2019,6,5,22,8630,10422,8388,-2034
2019,6,5,23,8438,9996,8032,-1964
2019,6,6,0,8014,9424,7541,-1883
2019,6,6,1,7558,8866,6992,-1874
2019,6,6,2,7140,8264,6436,-1828
2019,6,6,3,6484,7503,5859,-1644
2019,6,6,4,5839,6735,5061,-1674
2019,6,6,5,5069,6108,4605,-1503
2019,6,6,6,4636,5648,4263,-1385
2019,6,6,7,4363,5303,3988,-1315
2019,6,6,8,4178,5085,3806,-1279
2019,6,6,9,4126,5040,3773,-1267
2019,6,6,10,4254,5210,3883,-1327
2019,6,6,11,4549,5540,4184,-1356
2019,6,6,12,4835,5914,4600,-1314
2019,6,6,13,5337,6507,5076,-1431
2019,6,6,14,5926,7251,5501,-1750
2019,6,6,15,6609,8099,6144,-1955
2019,6,6,16,7195,8854,6694,-2160
2019,6,6,17,7649,9455,7238,-2217
2019,6,6,18,8068,9884,7883,-2001
2019,6,6,19,8349,10117,8189,-1928
2019,6,6,20,8507,9982,8056,-1926
2019,6,6,21,8504,9577,7698,-1879
2019,6,6,22,8317,9145,7302,-1843
2019,6,6,23,8050,8758,6900,-1858
2019,6,7,0,7630,8389,6543,-1846
2019,6,7,1,7241,8176,6459,-1717
2019,6,7,2,6844,7827,5934,-1893
2019,6,7,3,6222,7180,5319,-1861
2019,6,7,4,5597,6498,4707,-1791
2019,6,7,5,5120,5969,4443,-1526
2019,6,7,6,4736,5563,4143,-1420
2019,6,7,7,4429,5297,3940,-1357
2019,6,7,8,4251,5161,3837,-1324
2019,6,7,9,4191,5155,3825,-1330
2019,6,7,10,4317,5313,3954,-1359
2019,6,7,11,4586,5700,4273,-1427
2019,6,7,12,4881,5984,4647,-1337
2019,6,7,13,5381,6354,4960,-1394
2019,6,7,14,5932,6935,5241,-1694
2019,6,7,15,6542,7739,5914,-1825
2019,6,7,16,7071,8487,6545,-1942
2019,6,7,17,7553,9060,7085,-1975
2019,6,7,18,7935,9364,7297,-2067
2019,6,7,19,8172,9612,7508,-2104
2019,6,7,20,8289,9734,7728,-2006
2019,6,7,21,8221,9624,7693,-1931
2019,6,7,22,7982,9245,7387,-1858
2019,6,7,23,7705,8747,6996,-1751
2019,6,8,0,7236,8330,6559,-1771
2019,6,8,1,6894,8046,6233,-1813
2019,6,8,2,6551,7728,5977,-1751
2019,6,8,3,6063,7179,5543,-1636
2019,6,8,4,5551,6560,4826,-1734
2019,6,8,5,4836,6114,4632,-1482
2019,6,8,6,4498,5724,4322,-1402
2019,6,8,7,4263,5432,4105,-1327
2019,6,8,8,4111,5272,3969,-1303
2019,6,8,9,4021,5176,3897,-1279
2019,6,8,10,4018,5228,3939,-1289
2019,6,8,11,4032,5347,4052,-1295
2019,6,8,12,4280,5585,4373,-1212
2019,6,8,13,4813,5979,4709,-1270
2019,6,8,14,5372,6383,4853,-1530
2019,6,8,15,5956,6699,4980,-1719
2019,6,8,16,6422,7044,5437,-1607
2019,6,8,17,6752,7359,5866,-1493
2019,6,8,18,6974,7655,6115,-1540
2019,6,8,19,7035,8026,6197,-1829
2019,6,8,20,7018,8586,6663,-1923
2019,6,8,21,6949,8854,6878,-1976
2019,6,8,22,6768,8874,6953,-1921
2019,6,8,23,6491,8481,6625,-1856
2019,6,9,0,6222,7998,6118,-1880
2019,6,9,1,5997,7616,5652,-1964
2019,6,9,2,5765,7086,5146,-1940
2019,6,9,3,5372,6490,4759,-1731
2019,6,9,4,4959,5951,4330,-1621
2019,6,9,5,4481,5415,4058,-1357
2019,6,9,6,4205,5080,3798,-1282
2019,6,9,7,3991,4808,3564,-1244
2019,6,9,8,3860,4664,3448,-1216
2019,6,9,9,3777,4613,3409,-1204
2019,6,9,10,3767,4656,3454,-1202
2019,6,9,11,3783,4753,3544,-1209
2019,6,9,12,4037,5077,3916,-1161
2019,6,9,13,4576,5717,4404,-1313
2019,6,9,14,5239,6364,4751,-1613
2019,6,9,15,5797,7062,5249,-1813
2019,6,9,16,6299,7687,5971,-1716
2019,6,9,17,6632,8180,6569,-1611
2019,6,9,18,6849,8500,6829,-1671
2019,6,9,19,6918,8448,6792,-1656
2019,6,9,20,6854,8084,6501,-1583
2019,6,9,21,6776,7848,6284,-1564
2019,6,9,22,6739,7674,6136,-1538
2019,6,9,23,6556,7343,5839,-1504
2019,6,10,0,6296,6944,5302,-1642
2019,6,10,1,6070,6661,4761,-1900
2019,6,10,2,5788,6409,4489,-1920
2019,6,10,3,5367,5929,4284,-1645
2019,6,10,4,4929,5359,3857,-1502
2019,6,10,5,4243,4905,3642,-1263
2019,6,10,6,3924,4572,3385,-1187
2019,6,10,7,3744,4377,3251,-1126
2019,6,10,8,3618,4296,3150,-1146
2019,6,10,9,3643,4320,3142,-1178
2019,6,10,10,3816,4540,3366,-1174
2019,6,10,11,4101,4941,3697,-1244
2019,6,10,12,4446,5324,4138,-1186
2019,6,10,13,4842,5715,4451,-1264
2019,6,10,14,5334,6257,4687,-1570
2019,6,10,15,5807,6746,4887,-1859
2019,6,10,16,6273,7258,5317,-1941
2019,6,10,17,6595,7716,5940,-1776
2019,6,10,18,6832,8140,6454,-1686
2019,6,10,19,6922,8294,6613,-1681
2019,6,10,20,6866,8054,6379,-1675
2019,6,10,21,6732,8071,6363,-1708
2019,6,10,22,6552,8125,6395,-1730
2019,6,10,23,6406,8139,6404,-1735
2019,6,11,0,6214,7898,6192,-1706
2019,6,11,1,5996,7611,5710,-1901
2019,6,11,2,5691,7286,5325,-1961
2019,6,11,3,5283,6608,4807,-1801
2019,6,11,4,4802,5905,4288,-1617
2019,6,11,5,4398,5401,4045,-1356
2019,6,11,6,4086,5001,3715,-1286
2019,6,11,7,3884,4731,3511,-1220
2019,6,11,8,3765,4609,3399,-1210
2019,6,11,9,3767,4588,3404,-1184
2019,6,11,10,3915,4785,3557,-1228
2019,6,11,11,4210,5154,3859,-1295
2019,6,11,12,4525,5540,4303,-1237
2019,6,11,13,4939,6076,4735,-1341
2019,6,11,14,5484,6749,5051,-1698
2019,6,11,15,5995,7468,5511,-1957
2019,6,11,16,6484,8124,6129,-1995
2019,6,11,17,6867,8507,6758,-1749
2019,6,11,18,7170,8644,6854,-1790
2019,6,11,19,7308,8722,7012,-1710
2019,6,11,20,7353,8809,7079,-1730
2019,6,11,21,7292,8993,7249,-1744
2019,6,11,22,7117,9058,7264,-1794
2019,6,11,23,6955,8886,7069,-1817
2019,6,12,0,6673,8437,6641,-1796
2019,6,12,1,6397,7976,6028,-1948
2019,6,12,2,6052,7560,5800,-1760
2019,6,12,3,5580,6893,5388,-1505
2019,6,12,4,5063,6157,4690,-1467
2019,6,12,5,4537,5574,4216,-1358
2019,6,12,6,4209,5170,3905,-1265
2019,6,12,7,3998,4810,3615,-1195
2019,6,12,8,3873,4681,3513,-1168
2019,6,12,9,3871,4705,3520,-1185
2019,6,12,10,4022,4975,3746,-1229
2019,6,12,11,4273,5326,4104,-1222
2019,6,12,12,4587,5754,4623,-1131
2019,6,12,13,4972,6305,5200,-1105
2019,6,12,14,5549,6984,5706,-1278
2019,6,12,15,6069,7656,6331,-1325
2019,6,12,16,6538,8218,6606,-1612
2019,6,12,17,6747,8446,6849,-1597
2019,6,12,18,6941,8120,6654,-1466
2019,6,12,19,7016,7753,6210,-1543
2019,6,12,20,6979,7822,6076,-1746
2019,6,12,21,6889,8239,6433,-1806
2019,6,12,22,6778,8612,6837,-1775
2019,6,12,23,6685,8617,6950,-1667
2019,6,13,0,6353,8323,6731,-1592
2019,6,13,1,6149,8003,6363,-1640
2019,6,13,2,5851,7739,6113,-1626
2019,6,13,3,5394,7098,5759,-1339
2019,6,13,4,4885,6387,5117,-1270
2019,6,13,5,4548,5811,4568,-1243
2019,6,13,6,4184,5405,4132,-1273
2019,6,13,7,3948,5162,3911,-1251
2019,6,13,8,3813,4992,3789,-1203
2019,6,13,9,3807,4993,3789,-1204
2019,6,13,10,3936,5188,3956,-1232
2019,6,13,11,4175,5558,4249,-1309
2019,6,13,12,4447,5898,4717,-1181
2019,6,13,13,4797,6279,5158,-1121
2019,6,13,14,5184,6846,5619,-1227
2019,6,13,15,5658,7272,5877,-1395
2019,6,13,16,6082,7728,6099,-1629
2019,6,13,17,6314,8084,6472,-1612
2019,6,13,18,6561,8004,6516,-1488
2019,6,13,19,6708,7687,6159,-1528
2019,6,13,20,6681,7380,5848,-1532
2019,6,13,21,6625,7185,5678,-1507
2019,6,13,22,6530,7102,5580,-1522
2019,6,13,23,6346,7011,5494,-1517
2019,6,14,0,6131,6861,5380,-1481
2019,6,14,1,5913,6797,5313,-1484
2019,6,14,2,5604,6603,5180,-1423
2019,6,14,3,5176,6125,4878,-1247
2019,6,14,4,4675,5519,4235,-1284
2019,6,14,5,4368,5211,4085,-1126
2019,6,14,6,4067,4818,3690,-1128
2019,6,14,7,3849,4585,3479,-1106
2019,6,14,8,3703,4437,3377,-1060
2019,6,14,9,3709,4430,3355,-1075
2019,6,14,10,3843,4600,3480,-1120
2019,6,14,11,4087,4932,3751,-1181
2019,6,14,12,4339,5320,4189,-1131
2019,6,14,13,4740,5817,4638,-1179
2019,6,14,14,5164,6408,5038,-1370
2019,6,14,15,5655,7050,5586,-1464
2019,6,14,16,6117,7591,6053,-1538
2019,6,14,17,6343,8012,6413,-1599
2019,6,14,18,6575,8281,6677,-1604
2019,6,14,19,6642,8442,6779,-1663
2019,6,14,20,6589,8523,6902,-1621
2019,6,14,21,6506,8494,6894,-1600
2019,6,14,22,6307,8372,6750,-1622
2019,6,14,23,6268,8132,6468,-1664
2019,6,15,0,5921,7769,6153,-1616
2019,6,15,1,5676,7500,5869,-1631
2019,6,15,2,5429,7224,5628,-1596
2019,6,15,3,5097,6684,5125,-1559
2019,6,15,4,4652,6074,4467,-1607
2019,6,15,5,4229,5328,4031,-1297
2019,6,15,6,3916,4886,3689,-1197
2019,6,15,7,3682,4575,3464,-1111
2019,6,15,8,3531,4410,3316,-1094
2019,6,15,9,3472,4335,3242,-1093
2019,6,15,10,3467,4363,3270,-1093
2019,6,15,11,3537,4465,3350,-1115
2019,6,15,12,3770,4820,3719,-1101
2019,6,15,13,4223,5582,4349,-1233
2019,6,15,14,4802,6422,4849,-1573
2019,6,15,15,5389,7227,5342,-1885
2019,6,15,16,5910,7929,5767,-2162
2019,6,15,17,6292,8504,6281,-2223
2019,6,15,18,6611,8777,6591,-2186
2019,6,15,19,6799,9014,6857,-2157
2019,6,15,20,6839,9169,7047,-2122
2019,6,15,21,6852,9267,7143,-2124
2019,6,15,22,6674,9180,7064,-2116
2019,6,15,23,6457,8888,6765,-2123
2019,6,16,0,6130,8412,6279,-2133
2019,6,16,1,5839,8010,5995,-2015
2019,6,16,2,5557,7605,5608,-1997
2019,6,16,3,5113,6990,5144,-1846
2019,6,16,4,4671,6329,4655,-1674
2019,6,16,5,4338,5749,4308,-1441
2019,6,16,6,4010,5299,3983,-1316
2019,6,16,7,3769,4978,3726,-1252
2019,6,16,8,3624,4741,3545,-1196
2019,6,16,9,3531,4623,3458,-1165
2019,6,16,10,3530,4593,3437,-1156
2019,6,16,11,3505,4626,3470,-1156
2019,6,16,12,3754,4960,3814,-1146
2019,6,16,13,4356,5812,4441,-1371
2019,6,16,14,4988,6692,4948,-1744
2019,6,16,15,5647,7391,5306,-2085
2019,6,16,16,6120,8012,5666,-2346
2019,6,16,17,6468,8551,6169,-2382
2019,6,16,18,6752,8919,6505,-2414
2019,6,16,19,6925,8839,6558,-2281
2019,6,16,20,6925,8274,6082,-2192
2019,6,16,21,6884,7646,5518,-2128
2019,6,16,22,6710,7367,5296,-2071
2019,6,16,23,6599,6999,4840,-2159
2019,6,17,0,6265,6756,4726,-2030
2019,6,17,1,6032,6662,4616,-2046
2019,6,17,2,5762,6543,4556,-1987
2019,6,17,3,5271,6076,4368,-1708
2019,6,17,4,4784,5468,3937,-1531
2019,6,17,5,4123,4982,3709,-1273
2019,6,17,6,3792,4642,3460,-1182
2019,6,17,7,3575,4429,3297,-1132
2019,6,17,8,3460,4297,3200,-1097
2019,6,17,9,3454,4322,3205,-1117
2019,6,17,10,3612,4544,3378,-1166
2019,6,17,11,3848,4926,3701,-1225
2019,6,17,12,4170,5317,4124,-1193
2019,6,17,13,4580,5853,4511,-1342
2019,6,17,14,5102,6494,4842,-1652
2019,6,17,15,5675,7250,5302,-1948
2019,6,17,16,6227,7924,5794,-2130
2019,6,17,17,6636,8395,6294,-2101
2019,6,17,18,6907,8671,6595,-2076
2019,6,17,19,7054,8761,6695,-2066
2019,6,17,20,7135,8666,6628,-2038
2019,6,17,21,7096,8457,6532,-1925
2019,6,17,22,6981,8185,6337,-1848
2019,6,17,23,6773,7878,6071,-1807
2019,6,18,0,6484,7559,5715,-1844
2019,6,18,1,6189,7266,5257,-2009
2019,6,18,2,5817,7014,4994,-2020
2019,6,18,3,5349,6452,4712,-1740
2019,6,18,4,4806,5801,4272,-1529
2019,6,18,5,4198,5268,3983,-1285
2019,6,18,6,3892,4952,3733,-1219
2019,6,18,7,3692,4731,3563,-1168
2019,6,18,8,3555,4626,3470,-1156
2019,6,18,9,3562,4632,3486,-1146
2019,6,18,10,3707,4859,3672,-1187
2019,6,18,11,3963,5253,3987,-1266
2019,6,18,12,4252,5631,4404,-1227
2019,6,18,13,4619,6144,4831,-1313
2019,6,18,14,5107,6783,5256,-1527
2019,6,18,15,5547,7532,5834,-1698
2019,6,18,16,6024,8116,6282,-1834
2019,6,18,17,6249,8585,6705,-1880
2019,6,18,18,6457,8698,6829,-1869
2019,6,18,19,6498,8472,6606,-1866
2019,6,18,20,6426,8623,6663,-1960
2019,6,18,21,6364,8928,6926,-2002
2019,6,18,22,6235,8404,6436,-1968
2019,6,18,23,6136,8197,6259,-1938
2019,6,19,0,5919,7782,5851,-1931
2019,6,19,1,5748,7415,5590,-1825
2019,6,19,2,5497,7084,5315,-1769
2019,6,19,3,5109,6486,4908,-1578
2019,6,19,4,4634,5879,4385,-1494
2019,6,19,5,4388,5661,4265,-1396
2019,6,19,6,4057,5250,3944,-1306
2019,6,19,7,3845,4923,3681,-1242
2019,6,19,8,3738,4740,3522,-1218
2019,6,19,9,3725,4733,3490,-1243
2019,6,19,10,3861,4909,3632,-1277
2019,6,19,11,4096,5306,3939,-1367
2019,6,19,12,4406,5608,4320,-1288
2019,6,19,13,4792,5987,4662,-1325
2019,6,19,14,5341,6516,4919,-1597
2019,6,19,15,5840,7053,5145,-1908
2019,6,19,16,6419,7708,5493,-2215
2019,6,19,17,6759,8331,5998,-2333
2019,6,19,18,7073,8870,6535,-2335
2019,6,19,19,7134,8989,6644,-2345
2019,6,19,20,7072,8695,6380,-2315
2019,6,19,21,7001,8138,6024,-2114
2019,6,19,22,6822,7790,5729,-2061
2019,6,19,23,6697,7533,5470,-2063
2019,6,20,0,6345,7336,5401,-1935
2019,6,20,1,6130,7182,5168,-2014
2019,6,20,2,5872,6986,4980,-2006
2019,6,20,3,5424,6577,4842,-1735
2019,6,20,4,4922,5868,4279,-1589
2019,6,20,5,4367,5358,4017,-1341
2019,6,20,6,4064,5020,3756,-1264
2019,6,20,7,3862,4799,3558,-1241
2019,6,20,8,3756,4679,3470,-1209
2019,6,20,9,3761,4729,3502,-1227
2019,6,20,10,3901,4949,3676,-1273
2019,6,20,11,4172,5397,4024,-1373
2019,6,20,12,4472,5778,4465,-1313
2019,6,20,13,4887,6380,4965,-1415
2019,6,20,14,5426,7111,5355,-1756
2019,6,20,15,6025,7907,5839,-2068
2019,6,20,16,6626,8564,6426,-2138
2019,6,20,17,6971,9182,7130,-2052
2019,6,20,18,7235,9667,7611,-2056
2019,6,20,19,7384,10042,7927,-2115
2019,6,20,20,7466,10345,8153,-2192
2019,6,20,21,7423,10550,8320,-2230
2019,6,20,22,7225,10563,8418,-2145
2019,6,20,23,7044,10339,8247,-2092
2019,6,21,0,6709,9862,7760,-2102
2019,6,21,1,6433,9336,7135,-2201
2019,6,21,2,6121,8898,6667,-2231
2019,6,21,3,5634,8064,6026,-2038
2019,6,21,4,5083,7229,5413,-1816
2019,6,21,5,4819,6553,5009,-1544
2019,6,21,6,4407,5999,4518,-1481
2019,6,21,7,4150,5671,4263,-1408
2019,6,21,8,3994,5467,4104,-1363
2019,6,21,9,3944,5434,4077,-1357
2019,6,21,10,4048,5550,4145,-1405
2019,6,21,11,4287,5835,4391,-1444
2019,6,21,12,4573,6201,4815,-1386
2019,6,21,13,5014,6851,5307,-1544
2019,6,21,14,5590,7615,5738,-1877
2019,6,21,15,6253,8458,6280,-2178
2019,6,21,16,6881,9194,6960,-2234
2019,6,21,17,7386,9833,7778,-2055
2019,6,21,18,7821,10330,8392,-1938
2019,6,21,19,8051,10687,8698,-1989
2019,6,21,20,8093,10944,8969,-1975
2019,6,21,21,8011,11064,9144,-1920
2019,6,21,22,7737,10992,9052,-1940
2019,6,21,23,7508,10698,8886,-1812
2019,6,22,0,7060,10160,8243,-1917
2019,6,22,1,6712,9575,7458,-2117
2019,6,22,2,6417,9104,6933,-2171
2019,6,22,3,5940,8309,6296,-2013
2019,6,22,4,5420,7509,5552,-1957
2019,6,22,5,5161,6804,5132,-1672
2019,6,22,6,4752,6243,4694,-1549
2019,6,22,7,4449,5820,4387,-1433
2019,6,22,8,4241,5530,4154,-1376
2019,6,22,9,4120,5371,4025,-1346
2019,6,22,10,4079,5331,3985,-1346
2019,6,22,11,4079,5333,3999,-1334
2019,6,22,12,4334,5634,4310,-1324
2019,6,22,13,4919,6469,4972,-1497
2019,6,22,14,5658,7315,5468,-1847
2019,6,22,15,6366,8117,6201,-1916
2019,6,22,16,7054,8835,6986,-1849
2019,6,22,17,7605,9352,7522,-1830
2019,6,22,18,8023,9605,7626,-1979
2019,6,22,19,8317,9943,7967,-1976
2019,6,22,20,8428,10288,8268,-2020
2019,6,22,21,8437,10570,8494,-2076
2019,6,22,22,8240,10560,8528,-2032
2019,6,22,23,7931,10219,8244,-1975
2019,6,23,0,7424,9665,7681,-1984
2019,6,23,1,7040,9171,7119,-2052
2019,6,23,2,6707,8674,6587,-2087
2019,6,23,3,6194,7941,5893,-2048
2019,6,23,4,5688,7177,5303,-1874
2019,6,23,5,5154,6562,4983,-1579
2019,6,23,6,4711,6054,4589,-1465
2019,6,23,7,4405,5645,4289,-1356
2019,6,23,8,4181,5331,4039,-1292
2019,6,23,9,4056,5171,3911,-1260
2019,6,23,10,3993,5142,3892,-1250
2019,6,23,11,3965,5141,3903,-1238
2019,6,23,12,4173,5429,4216,-1213
2019,6,23,13,4761,6295,4883,-1412
2019,6,23,14,5489,7276,5470,-1806
2019,6,23,15,6171,8189,6214,-1975
2019,6,23,16,6875,9021,7070,-1951
2019,6,23,17,7336,9747,7753,-1994
2019,6,23,18,7740,10239,8250,-1989
2019,6,23,19,8037,10586,8515,-2071
2019,6,23,20,8128,10717,8610,-2107
2019,6,23,21,8228,10725,8583,-2142
2019,6,23,22,8194,10658,8493,-2165
2019,6,23,23,8009,10378,8283,-2095
2019,6,24,0,7652,9948,7828,-2120
2019,6,24,1,7235,9405,7331,-2074
2019,6,24,2,6857,8892,6700,-2192
2019,6,24,3,6260,8042,6083,-1959
2019,6,24,4,5609,7148,5240,-1908
2019,6,24,5,5013,6374,4800,-1574
2019,6,24,6,4557,5817,4393,-1424
2019,6,24,7,4270,5424,4090,-1334
2019,6,24,8,4079,5160,3886,-1274
2019,6,24,9,4024,5070,3812,-1258
2019,6,24,10,4121,5226,3935,-1291
2019,6,24,11,4364,5563,4220,-1343
2019,6,24,12,4666,5920,4612,-1308
2019,6,24,13,5172,6618,5208,-1410
2019,6,24,14,5710,7449,5681,-1768
2019,6,24,15,6446,8328,6207,-2121
2019,6,24,16,7117,9198,7113,-2085
2019,6,24,17,7563,9971,8087,-1884
2019,6,24,18,8023,10560,8572,-1988
2019,6,24,19,8233,10998,9010,-1988
2019,6,24,20,8464,11284,9314,-1970
2019,6,24,21,8588,11449,9473,-1976
2019,6,24,22,8484,11385,9399,-1986
2019,6,24,23,8355,11097,9118,-1979
2019,6,25,0,7922,10546,8657,-1889
2019,6,25,1,7459,9933,7935,-1998
2019,6,25,2,7008,9347,7255,-2092
2019,6,25,3,6341,8433,6456,-1977
2019,6,25,4,5649,7479,5589,-1890
2019,6,25,5,5141,6707,5136,-1571
2019,6,25,6,4721,6167,4701,-1466
2019,6,25,7,4445,5785,4408,-1377
2019,6,25,8,4271,5540,4209,-1331
2019,6,25,9,4194,5464,4137,-1327
2019,6,25,10,4305,5588,4246,-1342
2019,6,25,11,4553,5904,4499,-1405
2019,6,25,12,4854,6238,4853,-1385
2019,6,25,13,5316,6884,5418,-1466
2019,6,25,14,5936,7775,5883,-1892
2019,6,25,15,6673,8737,6534,-2203
2019,6,25,16,7269,9655,7449,-2206
2019,6,25,17,7810,10411,8395,-2016
2019,6,25,18,8245,11029,8946,-2083
2019,6,25,19,8528,11431,9407,-2024
2019,6,25,20,8715,11689,9593,-2096
2019,6,25,21,8758,11850,9723,-2127
2019,6,25,22,8606,11737,9632,-2105
2019,6,25,23,8323,11305,9266,-2039
2019,6,26,0,7858,10431,8441,-1990
2019,6,26,1,7434,9783,7745,-2038
2019,6,26,2,7019,9188,7248,-1940
2019,6,26,3,6382,8325,6548,-1777
2019,6,26,4,5755,7433,5663,-1770
2019,6,26,5,5290,6723,5010,-1713
2019,6,26,6,4888,6164,4578,-1586
2019,6,26,7,4608,5779,4280,-1499
2019,6,26,8,4378,5541,4091,-1450
2019,6,26,9,4316,5449,4036,-1413
2019,6,26,10,4407,5588,4156,-1432
2019,6,26,11,4669,5904,4439,-1465
2019,6,26,12,4963,6245,4843,-1402
2019,6,26,13,5492,6862,5339,-1523
2019,6,26,14,6097,7727,5828,-1899
2019,6,26,15,6833,8700,6466,-2234
2019,6,26,16,7467,9611,7399,-2212
2019,6,26,17,8021,10302,8199,-2103
2019,6,26,18,8471,10816,8626,-2190
2019,6,26,19,8831,11190,8996,-2194
2019,6,26,20,9075,11452,9212,-2240
2019,6,26,21,9152,11574,9287,-2287
2019,6,26,22,9000,11434,9147,-2287
2019,6,26,23,8795,11175,8937,-2238
2019,6,27,0,8281,10675,8446,-2229
2019,6,27,1,7819,10103,7868,-2235
2019,6,27,2,7388,9535,7272,-2263
2019,6,27,3,6692,8621,6584,-2037
2019,6,27,4,5993,7595,5636,-1959
2019,6,27,5,5296,6701,5076,-1625
2019,6,27,6,4877,6013,4553,-1460
2019,6,27,7,4554,5563,4181,-1382
2019,6,27,8,4342,5293,3979,-1314
2019,6,27,9,4259,5183,3883,-1300
2019,6,27,10,4362,5307,3965,-1342
2019,6,27,11,4591,5606,4250,-1356
2019,6,27,12,4835,5914,4632,-1282
2019,6,27,13,5241,6458,5072,-1386
2019,6,27,14,5773,7255,5477,-1778
2019,6,27,15,6392,8149,6071,-2078
2019,6,27,16,6971,8971,6817,-2154
2019,6,27,17,7398,9721,7560,-2161
2019,6,27,18,7800,10278,8241,-2037
2019,6,27,19,8079,10615,8644,-1971
2019,6,27,20,8210,10788,8841,-1947
2019,6,27,21,8258,10854,8895,-1959
2019,6,27,22,8116,10775,8810,-1965
2019,6,27,23,7830,10413,8503,-1910
2019,6,28,0,7384,9944,8000,-1944
2019,6,28,1,6977,9411,7414,-1997
2019,6,28,2,6586,8861,6631,-2230
2019,6,28,3,6008,8032,5937,-2095
2019,6,28,4,5409,7225,5320,-1905
2019,6,28,5,4892,6516,4903,-1613
2019,6,28,6,4498,5935,4483,-1452
2019,6,28,7,4215,5520,4166,-1354
2019,6,28,8,4002,5257,3959,-1298
2019,6,28,9,3978,5176,3895,-1281
2019,6,28,10,4073,5301,4006,-1295
2019,6,28,11,4305,5546,4221,-1325
2019,6,28,12,4576,5904,4620,-1284
2019,6,28,13,5072,6595,5114,-1481
2019,6,28,14,5645,7402,5529,-1873
2019,6,28,15,6267,8258,6030,-2228
2019,6,28,16,6829,9014,6794,-2220
2019,6,28,17,7198,9703,7519,-2184
2019,6,28,18,7543,10193,8083,-2110
2019,6,28,19,7732,10534,8466,-2068
2019,6,28,20,7785,10539,8463,-2076
2019,6,28,21,7812,10413,8365,-2048
2019,6,28,22,7626,9853,7852,-2001
2019,6,28,23,7419,9079,7167,-1912
2019,6,29,0,6983,8494,6569,-1925
2019,6,29,1,6629,8056,5919,-2137
2019,6,29,2,6378,7590,5585,-2005
2019,6,29,3,5896,6961,5087,-1874
2019,6,29,4,5390,6329,4631,-1698
2019,6,29,5,4760,5771,4329,-1442
2019,6,29,6,4407,5352,4030,-1322
2019,6,29,7,4160,5055,3765,-1290
2019,6,29,8,3995,4849,3623,-1226
2019,6,29,9,3916,4760,3569,-1191
2019,6,29,10,3916,4793,3582,-1211
2019,6,29,11,3896,4877,3671,-1206
2019,6,29,12,4105,5125,3953,-1172
2019,6,29,13,4595,5782,4436,-1346
2019,6,29,14,5162,6526,4876,-1650
2019,6,29,15,5687,7251,5284,-1967
2019,6,29,16,6212,7978,5852,-2126
2019,6,29,17,6486,8601,6460,-2141
2019,6,29,18,6677,8962,6836,-2126
2019,6,29,19,6744,9184,7127,-2057
2019,6,29,20,6708,9003,6971,-2032
2019,6,29,21,6638,8604,6672,-1932
2019,6,29,22,6471,8211,6321,-1890
2019,6,29,23,6147,7765,5901,-1864
2019,6,30,0,5903,7329,5510,-1819
2019,6,30,1,5678,7110,5306,-1804
2019,6,30,2,5487,6898,5066,-1832
2019,6,30,3,5129,6411,4720,-1691
2019,6,30,4,4768,5888,4325,-1563
2019,6,30,5,4370,5425,4110,-1315
2019,6,30,6,4056,5029,3807,-1222
2019,6,30,7,3832,4781,3632,-1149
2019,6,30,8,3684,4611,3495,-1116
2019,6,30,9,3603,4535,3426,-1109
2019,6,30,10,3614,4524,3413,-1111
2019,6,30,11,3659,4580,3453,-1127
2019,6,30,12,3870,4857,3759,-1098
2019,6,30,13,4457,5648,4371,-1277
2019,6,30,14,5133,6482,4943,-1539
2019,6,30,15,5677,7329,5585,-1744
2019,6,30,16,6331,8033,6009,-2024
2019,6,30,17,6744,8719,6722,-1997
2019,6,30,18,7095,9191,7179,-2012
2019,6,30,19,7307,9568,7519,-2049
2019,6,30,20,7203,9852,7761,-2091
2019,6,30,21,7156,10092,7991,-2101
2019,6,30,22,7055,9600,7519,-2081
2019,6,30,23,6898,9444,7453,-1991
2019,7,1,0,6554,9633,8017,-1616
2019,7,1,1,6238,9007,7403,-1604
2019,7,1,2,5993,8452,6841,-1611
2019,7,1,3,5504,7652,6147,-1505
2019,7,1,4,5043,6854,5441,-1413
2019,7,1,5,4654,6147,4633,-1514
2019,7,1,6,4292,5630,4194,-1436
2019,7,1,7,4064,5291,3948,-1343
2019,7,1,8,3933,5115,3795,-1320
2019,7,1,9,3908,5068,3779,-1289
2019,7,1,10,4048,5243,3924,-1319
2019,7,1,11,4322,5565,4163,-1402
2019,7,1,12,4613,5968,4590,-1378
2019,7,1,13,5127,6652,5231,-1421
2019,7,1,14,5783,7458,5951,-1507
2019,7,1,15,6510,8285,6632,-1653
2019,7,1,16,7084,9083,7339,-1744
2019,7,1,17,7627,9799,7913,-1886
2019,7,1,18,8043,10385,8324,-2061
2019,7,1,19,8345,10788,8647,-2141
2019,7,1,20,8464,11047,8942,-2105
2019,7,1,21,8481,11149,8982,-2167
2019,7,1,22,8342,11035,8905,-2130
2019,7,1,23,8007,10668,8592,-2076
2019,7,2,0,7692,10170,8181,-1989
2019,7,2,1,7282,9653,7733,-1920
2019,7,2,2,6886,9178,7362,-1816
2019,7,2,3,6268,8347,6712,-1635
2019,7,2,4,5693,7518,5814,-1704
2019,7,2,5,5116,6802,5419,-1383
2019,7,2,6,4717,6240,4879,-1361
2019,7,2,7,4424,5896,4526,-1370
2019,7,2,8,4287,5668,4229,-1439
2019,7,2,9,4236,5586,4167,-1419
2019,7,2,10,4346,5710,4262,-1448
2019,7,2,11,4604,5718,4226,-1492
2019,7,2,12,4853,6337,4962,-1375
2019,7,2,13,5340,6979,5622,-1357
2019,7,2,14,5964,7789,6214,-1575
2019,7,2,15,6697,8671,6907,-1764
2019,7,2,16,7325,9527,7641,-1886
2019,7,2,17,7808,10224,8192,-2032
2019,7,2,18,8230,10758,8642,-2116
2019,7,2,19,8464,11152,8992,-2160
2019,7,2,20,8554,11305,9145,-2160
2019,7,2,21,8537,11217,9106,-2111
2019,7,2,22,8408,10896,8734,-2162
2019,7,2,23,8236,10453,8287,-2166
2019,7,3,0,7783,9962,7797,-2165
2019,7,3,1,7407,9522,7328,-2194
2019,7,3,2,7022,9061,7008,-2053
2019,7,3,3,6403,8290,6556,-1734
2019,7,3,4,5804,7488,5765,-1723
2019,7,3,5,5333,6849,5189,-1660
2019,7,3,6,4937,6351,4749,-1602
2019,7,3,7,4633,5996,4481,-1515
2019,7,3,8,4456,5784,4324,-1460
2019,7,3,9,4384,5739,4302,-1437
2019,7,3,10,4468,5922,4450,-1472
2019,7,3,11,4664,6184,4672,-1512
2019,7,3,12,4913,6481,5143,-1338
2019,7,3,13,5440,7111,5794,-1317
2019,7,3,14,6136,7876,6378,-1498
2019,7,3,15,6847,8782,7066,-1716
2019,7,3,16,7488,9612,7567,-2045
2019,7,3,17,7985,10320,8197,-2123
2019,7,3,18,8378,10657,8506,-2151
2019,7,3,19,8604,10724,8634,-2090
2019,7,3,20,8592,10669,8597,-2072
2019,7,3,21,8567,10709,8670,-2039
2019,7,3,22,8374,10414,8390,-2024
2019,7,3,23,8279,9825,7620,-2205
2019,7,4,0,7758,9255,6979,-2276
2019,7,4,1,7349,8737,6391,-2346
2019,7,4,2,7001,8298,6047,-2251
2019,7,4,3,6438,7670,5565,-2105
2019,7,4,4,5895,7043,5094,-1949
2019,7,4,5,5541,6522,4895,-1627
2019,7,4,6,5081,6054,4542,-1512
2019,7,4,7,4798,5691,4259,-1432
2019,7,4,8,4591,5447,4062,-1385
2019,7,4,9,4466,5348,3996,-1352
2019,7,4,10,4449,5336,3991,-1345
2019,7,4,11,4448,5372,4031,-1341
2019,7,4,12,4668,5585,4239,-1346
2019,7,4,13,5200,6317,4820,-1497
2019,7,4,14,6117,7142,5346,-1796
2019,7,4,15,6882,8200,6255,-1945
2019,7,4,16,7603,9213,7117,-2096
2019,7,4,17,8130,9954,7716,-2238
2019,7,4,18,8519,10444,8185,-2259
2019,7,4,19,8729,10666,8421,-2245
2019,7,4,20,8798,10245,8060,-2185
2019,7,4,21,8746,9537,7634,-1903
2019,7,4,22,8420,8859,6935,-1924
2019,7,4,23,8090,8279,6422,-1857
2019,7,5,0,7680,7744,5788,-1956
2019,7,5,1,7217,7428,5426,-2002
2019,7,5,2,6796,7134,5050,-2084
2019,7,5,3,6420,6832,4947,-1885
2019,7,5,4,5988,6382,4679,-1703
2019,7,5,5,5158,5926,4461,-1465
2019,7,5,6,4795,5513,4137,-1376
2019,7,5,7,4506,5205,3899,-1306
2019,7,5,8,4299,5065,3788,-1277
2019,7,5,9,4208,4998,3745,-1253
2019,7,5,10,4264,5081,3807,-1274
2019,7,5,11,4394,5363,4045,-1318
2019,7,5,12,4655,5662,4353,-1309
2019,7,5,13,5184,6318,4883,-1435
2019,7,5,14,5922,7115,5325,-1790
2019,7,5,15,6579,8022,5947,-2075
2019,7,5,16,7248,8849,6788,-2061
2019,7,5,17,7690,9626,7575,-2051
2019,7,5,18,7992,10212,8115,-2097
2019,7,5,19,8232,10461,8416,-2045
2019,7,5,20,8278,10339,8477,-1862
2019,7,5,21,8163,9877,7876,-2001
2019,7,5,22,7926,9315,7570,-1745
2019,7,5,23,7711,8619,6864,-1755
2019,7,6,0,7157,8026,6171,-1855
2019,7,6,1,6757,7748,5708,-2040
2019,7,6,2,6437,7454,5417,-2037
2019,7,6,3,6016,6930,5084,-1846
2019,7,6,4,5583,6352,4687,-1665
2019,7,6,5,5035,5849,4468,-1381
2019,7,6,6,4676,5387,4079,-1308
2019,7,6,7,4414,5052,3779,-1273
2019,7,6,8,4234,4876,3640,-1236
2019,7,6,9,4131,4799,3585,-1214
2019,7,6,10,4116,4849,3650,-1199
2019,7,6,11,4123,4946,3726,-1220
2019,7,6,12,4357,5279,4009,-1270
2019,7,6,13,4927,6003,4582,-1421
2019,7,6,14,5646,6927,5140,-1787
2019,7,6,15,6232,7852,5706,-2146
2019,7,6,16,6887,8572,6351,-2221
2019,7,6,17,7272,9075,6997,-2078
2019,7,6,18,7522,9306,7305,-2001
2019,7,6,19,7651,9246,7360,-1886
2019,7,6,20,7604,8964,7213,-1751
2019,7,6,21,7510,8613,6797,-1816
2019,7,6,22,7366,8089,6219,-1870
2019,7,6,23,7126,7647,5663,-1984
2019,7,7,0,6770,7294,5241,-2053
2019,7,7,1,6480,7066,4921,-2145
2019,7,7,2,6159,6804,4737,-2067
2019,7,7,3,5733,6347,4542,-1805
2019,7,7,4,5298,5864,4239,-1625
2019,7,7,5,4736,5448,4049,-1399
2019,7,7,6,4386,5090,3802,-1288
2019,7,7,7,4141,4840,3568,-1272
2019,7,7,8,3971,4646,3442,-1204
2019,7,7,9,3872,4566,3359,-1207
2019,7,7,10,3854,4576,3385,-1191
2019,7,7,11,3832,4666,3450,-1216
2019,7,7,12,4067,4918,3717,-1201
2019,7,7,13,4607,5631,4278,-1353
2019,7,7,14,5402,6494,4741,-1753
2019,7,7,15,5996,7244,5158,-2086
2019,7,7,16,6674,7828,5501,-2327
2019,7,7,17,7052,8302,6069,-2233
2019,7,7,18,7414,8654,6428,-2226
2019,7,7,19,7596,8788,6588,-2200
2019,7,7,20,7597,8658,6515,-2143
2019,7,7,21,7510,8401,6233,-2168
2019,7,7,22,7374,8235,6054,-2181
2019,7,7,23,7195,8055,5881,-2174
2019,7,8,0,6867,7753,5546,-2207
2019,7,8,1,6572,7463,5189,-2274
2019,7,8,2,6235,7209,5039,-2170
2019,7,8,3,5742,6641,4734,-1907
2019,7,8,4,5245,6012,4389,-1623
2019,7,8,5,4732,5490,4108,-1382
2019,7,8,6,4358,5124,3827,-1297
2019,7,8,7,4132,4876,3626,-1250
2019,7,8,8,3991,4726,3504,-1222
2019,7,8,9,3963,4728,3509,-1219
2019,7,8,10,4110,4919,3670,-1249
2019,7,8,11,4364,5300,3975,-1325
2019,7,8,12,4674,5649,4347,-1302
2019,7,8,13,5125,6089,4702,-1387
2019,7,8,14,5772,6638,4933,-1705
2019,7,8,15,6414,7273,5262,-2011
2019,7,8,16,7098,7865,5678,-2187
2019,7,8,17,7497,8396,6344,-2052
2019,7,8,18,7848,8932,6870,-2062
2019,7,8,19,8033,9405,7322,-2083
2019,7,8,20,8067,9705,7533,-2172
2019,7,8,21,8012,9814,7653,-2161
2019,7,8,22,7817,9632,7507,-2125
2019,7,8,23,7617,9234,7113,-2121
2019,7,9,0,7238,8761,6673,-2088
2019,7,9,1,6903,8391,6091,-2300
2019,7,9,2,6541,7961,5654,-2307
2019,7,9,3,6000,7255,5218,-2037
2019,7,9,4,5430,6272,4500,-1772
2019,7,9,5,4495,5939,4427,-1512
2019,7,9,6,4175,5514,4102,-1412
2019,7,9,7,3970,5237,3896,-1341
2019,7,9,8,3848,5052,3743,-1309
2019,7,9,9,3839,5027,3718,-1309
2019,7,9,10,3989,5199,3849,-1350
2019,7,9,11,4277,5563,4123,-1440
2019,7,9,12,4550,5883,4501,-1382
2019,7,9,13,4913,6332,4867,-1465
2019,7,9,14,5428,7083,5239,-1844
2019,7,9,15,5909,7826,5669,-2157
2019,7,9,16,6418,8369,5930,-2439
2019,7,9,17,6624,8740,6440,-2300
2019,7,9,18,6800,8906,6769,-2137
2019,7,9,19,6794,8964,6878,-2086
2019,7,9,20,6657,8785,6756,-2029
2019,7,9,21,6522,8576,6568,-2008
2019,7,9,22,6217,8264,6182,-2082
2019,7,9,23,6210,7961,5889,-2072
2019,7,10,0,5936,7652,5576,-2076
2019,7,10,1,5808,7491,5282,-2209
2019,7,10,2,5599,7202,5054,-2148
2019,7,10,3,5198,6644,4719,-1925
2019,7,10,4,4765,6015,4353,-1662
2019,7,10,5,4617,5543,4083,-1460
2019,7,10,6,4296,5188,3805,-1383
2019,7,10,7,4078,4965,3633,-1332
2019,7,10,8,3922,4826,3545,-1281
2019,7,10,9,3909,4840,3546,-1294
2019,7,10,10,4053,5016,3672,-1344
2019,7,10,11,4332,5374,3966,-1408
2019,7,10,12,4573,5721,4342,-1379
2019,7,10,13,4939,6156,4721,-1435
2019,7,10,14,5445,6805,5060,-1745
2019,7,10,15,6018,7566,5574,-1992
2019,7,10,16,6587,8129,6080,-2049
2019,7,10,17,6880,8604,6608,-1996
2019,7,10,18,7160,8964,7007,-1957
2019,7,10,19,7362,9134,7162,-1972
2019,7,10,20,7424,9280,7448,-1832
2019,7,10,21,7360,9366,7431,-1935
2019,7,10,22,7155,9351,7349,-2002
2019,7,10,23,6962,9079,7068,-2011
2019,7,11,0,6649,8671,6763,-1908
2019,7,11,1,6434,8312,6219,-2093
2019,7,11,2,6142,7908,5855,-2053
2019,7,11,3,5633,7170,5278,-1892
2019,7,11,4,5097,6410,4640,-1770
2019,7,11,5,4561,5816,4328,-1488
2019,7,11,6,4233,5407,4014,-1393
2019,7,11,7,4014,5117,3789,-1328
2019,7,11,8,3886,4943,3670,-1273
2019,7,11,9,3859,4893,3643,-1250
2019,7,11,10,3999,5051,3768,-1283
2019,7,11,11,4284,5410,4050,-1360
2019,7,11,12,4553,5745,4331,-1414
2019,7,11,13,4979,6296,4707,-1589
2019,7,11,14,5542,7003,5078,-1925
2019,7,11,15,6121,7749,5799,-1950
2019,7,11,16,6666,8434,6595,-1839
2019,7,11,17,6960,8993,7432,-1561
2019,7,11,18,7261,9362,7854,-1508
2019,7,11,19,7441,9342,7845,-1497
2019,7,11,20,7433,8927,7584,-1343
2019,7,11,21,7359,8677,7368,-1309
2019,7,11,22,7109,8565,7270,-1295
2019,7,11,23,6848,8285,6991,-1294
2019,7,12,0,6554,7842,6505,-1337
2019,7,12,1,6353,7551,5749,-1802
2019,7,12,2,6085,7307,5314,-1993
2019,7,12,3,5587,6705,4844,-1861
2019,7,12,4,5074,6061,4398,-1663
2019,7,12,5,4657,5526,4152,-1374
2019,7,12,6,4284,5174,3894,-1280
2019,7,12,7,4037,4934,3710,-1224
2019,7,12,8,3861,4786,3600,-1186
2019,7,12,9,3834,4752,3561,-1191
2019,7,12,10,3948,4902,3686,-1216
2019,7,12,11,4190,5206,3915,-1291
2019,7,12,12,4465,5542,4259,-1283
2019,7,12,13,4914,6061,4665,-1396
2019,7,12,14,5464,6692,5030,-1662
2019,7,12,15,6107,7366,5341,-2025
2019,7,12,16,6603,8092,5901,-2191
2019,7,12,17,6943,8636,6339,-2297
2019,7,12,18,7248,9039,6870,-2169
2019,7,12,19,7422,9300,7150,-2150
2019,7,12,20,7444,9379,7308,-2071
2019,7,12,21,7352,9390,7387,-2003
2019,7,12,22,7115,9062,7113,-1949
2019,7,12,23,6785,8398,6343,-2055
2019,7,13,0,6408,7756,5795,-1961
2019,7,13,1,6155,7103,5159,-1944
2019,7,13,2,5914,6835,4941,-1894
2019,7,13,3,5508,6309,4576,-1733
2019,7,13,4,5070,5758,4204,-1554
2019,7,13,5,4413,5280,3968,-1312
2019,7,13,6,4100,4873,3641,-1232
2019,7,13,7,3907,4635,3469,-1166
2019,7,13,8,3748,4491,3350,-1141
2019,7,13,9,3673,4443,3320,-1123
2019,7,13,10,3684,4483,3324,-1159
2019,7,13,11,3742,4632,3523,-1109
2019,7,13,12,3963,4881,3707,-1174
2019,7,13,13,4512,5392,4136,-1256
2019,7,13,14,5382,6032,4428,-1604
2019,7,13,15,6027,6657,4758,-1899
2019,7,13,16,6703,7302,5375,-1927
2019,7,13,17,7223,7986,6042,-1944
2019,7,13,18,7584,8589,6623,-1966
2019,7,13,19,7861,9045,7004,-2041
2019,7,13,20,7967,9376,7293,-2083
2019,7,13,21,7931,9576,7443,-2133
2019,7,13,22,7689,9669,7499,-2170
2019,7,13,23,7368,9606,7436,-2170
2019,7,14,0,7057,9252,7097,-2155
2019,7,14,1,6768,8761,6498,-2263
2019,7,14,2,6498,8272,5988,-2284
2019,7,14,3,6027,7596,5534,-2062
2019,7,14,4,5500,6912,5088,-1824
2019,7,14,5,4770,6318,4763,-1555
2019,7,14,6,4413,5853,4407,-1446
2019,7,14,7,4205,5497,4143,-1354
2019,7,14,8,4076,5231,3923,-1308
2019,7,14,9,3962,5077,3796,-1281
2019,7,14,10,3947,5019,3759,-1260
2019,7,14,11,3971,5041,3784,-1257
2019,7,14,12,4151,5241,4004,-1237
2019,7,14,13,4726,5970,4564,-1406
2019,7,14,14,5531,6931,5088,-1843
2019,7,14,15,6317,7896,5709,-2187
2019,7,14,16,6958,8789,6526,-2263
2019,7,14,17,7419,9600,7382,-2218
2019,7,14,18,7811,10160,7986,-2174
2019,7,14,19,8037,10542,8782,-1760
2019,7,14,20,8128,10812,9055,-1757
2019,7,14,21,8149,10942,9154,-1788
2019,7,14,22,8047,10801,9080,-1721
2019,7,14,23,7890,10486,8779,-1707
2019,7,15,0,7516,10008,7893,-2115
2019,7,15,1,7191,9472,7235,-2237
2019,7,15,2,6799,8946,6604,-2342
2019,7,15,3,6203,8094,5902,-2192
2019,7,15,4,5586,7257,5329,-1928
2019,7,15,5,4998,6536,4945,-1591
2019,7,15,6,4593,6013,4546,-1467
2019,7,15,7,4313,5615,4254,-1361
2019,7,15,8,4137,5372,4074,-1298
2019,7,15,9,4072,5272,4005,-1267
2019,7,15,10,4198,5380,4096,-1284
2019,7,15,11,4467,5681,4333,-1348
2019,7,15,12,4768,5971,4650,-1321
2019,7,15,13,5249,6562,5105,-1457
2019,7,15,14,5883,7367,5591,-1776
2019,7,15,15,6551,8284,6294,-1990
2019,7,15,16,7229,9215,7127,-2088
2019,7,15,17,7646,10008,7938,-2070
2019,7,15,18,8047,10602,8480,-2122
2019,7,15,19,8323,10917,8933,-1984
2019,7,15,20,8456,10979,9046,-1933
2019,7,15,21,8553,10542,8470,-2072
2019,7,15,22,8471,10026,7978,-2048
2019,7,15,23,8262,9643,7709,-1934
2019,7,16,0,7847,9086,7145,-1941
2019,7,16,1,7466,8660,6615,-2045
2019,7,16,2,7052,8193,6062,-2131
2019,7,16,3,6409,7444,5467,-1977
2019,7,16,4,5756,6708,4928,-1780
2019,7,16,5,5205,6134,4638,-1496
2019,7,16,6,4788,5656,4287,-1369
2019,7,16,7,4491,5371,4070,-1301
2019,7,16,8,4315,5179,3930,-1249
2019,7,16,9,4244,5151,3905,-1246
2019,7,16,10,4360,5304,4024,-1280
2019,7,16,11,4642,5643,4305,-1338
2019,7,16,12,4929,6008,4674,-1334
2019,7,16,13,5374,6586,5132,-1454
2019,7,16,14,5981,7326,5655,-1671
2019,7,16,15,6623,8225,6281,-1944
2019,7,16,16,7241,9056,6959,-2097
2019,7,16,17,7725,9884,7744,-2140
2019,7,16,18,8105,10556,8370,-2186
2019,7,16,19,8385,10982,8924,-2058
2019,7,16,20,8526,11226,9201,-2025
2019,7,16,21,8623,11338,9389,-1949
2019,7,16,22,8484,11200,9247,-1953
2019,7,16,23,8199,10855,8713,-2142
2019,7,17,0,7723,10252,8103,-2149
2019,7,17,1,7385,9661,7436,-2225
2019,7,17,2,6986,8949,6705,-2244
2019,7,17,3,6344,8057,6012,-2045
2019,7,17,4,5694,7189,5379,-1810
2019,7,17,5,5123,6514,4981,-1533
2019,7,17,6,4746,5989,4580,-1409
2019,7,17,7,4474,5605,4276,-1329
2019,7,17,8,4320,5376,4087,-1289
2019,7,17,9,4264,5296,4037,-1259
2019,7,17,10,4381,5421,4129,-1292
2019,7,17,11,4655,5722,4386,-1336
2019,7,17,12,4920,6055,4736,-1319
2019,7,17,13,5355,6655,5223,-1432
2019,7,17,14,5950,7460,5669,-1791
2019,7,17,15,6651,8403,6309,-2094
2019,7,17,16,7289,9264,6939,-2325
2019,7,17,17,7650,10038,7747,-2291
2019,7,17,18,8016,10512,8259,-2253
2019,7,17,19,8269,10830,8566,-2264
2019,7,17,20,8356,10925,8570,-2355
2019,7,17,21,8298,10713,8342,-2371
2019,7,17,22,8078,10141,7929,-2212
2019,7,17,23,7781,9306,7241,-2065
2019,7,18,0,7371,8653,6644,-2009
2019,7,18,1,7060,8224,6199,-2025
2019,7,18,2,6698,7644,5672,-1972
2019,7,18,3,6108,6954,5075,-1879
2019,7,18,4,5524,6258,4625,-1633
2019,7,18,5,5031,5680,4320,-1360
2019,7,18,6,4656,5254,3993,-1261
2019,7,18,7,4392,4957,3765,-1192
2019,7,18,8,4237,4805,3616,-1189
2019,7,18,9,4188,4781,3606,-1175
2019,7,18,10,4301,4937,3729,-1208
2019,7,18,11,4578,5284,4030,-1254
2019,7,18,12,4837,5627,4382,-1245
2019,7,18,13,5267,6161,4803,-1358
2019,7,18,14,5847,6880,5173,-1707
2019,7,18,15,6522,7662,5830,-1832
2019,7,18,16,7016,8556,6703,-1853
2019,7,18,17,7451,9357,7338,-2019
2019,7,18,18,7783,9947,7945,-2002
2019,7,18,19,8017,10290,8242,-2048
2019,7,18,20,8111,10368,8249,-2119
2019,7,18,21,8061,10055,7910,-2145
2019,7,18,22,7820,9701,7601,-2100
2019,7,18,23,7532,9325,7197,-2128
2019,7,19,0,7119,8893,6774,-2119
2019,7,19,1,6838,8457,6229,-2228
2019,7,19,2,6475,8042,5839,-2203
2019,7,19,3,5905,7330,5317,-2013
2019,7,19,4,5378,6605,4833,-1772
2019,7,19,5,4963,5974,4509,-1465
2019,7,19,6,4567,5488,4115,-1373
2019,7,19,7,4296,5168,3878,-1290
2019,7,19,8,4129,4956,3717,-1239
2019,7,19,9,4080,4926,3693,-1233
2019,7,19,10,4186,5069,3810,-1259
2019,7,19,11,4439,5349,4055,-1294
2019,7,19,12,4695,5682,4390,-1292
2019,7,19,13,5145,6282,4722,-1560
2019,7,19,14,5743,7064,5117,-1947
2019,7,19,15,6415,7954,5694,-2260
2019,7,19,16,6960,8820,6691,-2129
2019,7,19,17,7373,9552,7475,-2077
2019,7,19,18,7714,9971,7883,-2088
2019,7,19,19,7933,10214,8056,-2158
2019,7,19,20,7992,10285,8117,-2168
2019,7,19,21,7899,10252,8082,-2170
2019,7,19,22,7615,10030,7813,-2217
2019,7,19,23,7285,9457,7324,-2133
2019,7,20,0,6822,8775,6665,-2110
2019,7,20,1,6526,8288,6071,-2217
2019,7,20,2,6201,7712,5474,-2238
2019,7,20,3,5737,7025,4979,-2046
2019,7,20,4,5267,6365,4509,-1856
2019,7,20,5,4956,5825,4213,-1612
2019,7,20,6,4618,5389,4006,-1383
2019,7,20,7,4351,5064,3804,-1260
2019,7,20,8,4184,4886,3638,-1248
2019,7,20,9,4077,4795,3565,-1230
2019,7,20,10,4069,4783,3575,-1208
2019,7,20,11,4132,4892,3672,-1220
2019,7,20,12,4317,5195,3987,-1208
2019,7,20,13,4879,5916,4407,-1509
2019,7,20,14,5598,6795,4893,-1902
2019,7,20,15,6298,7686,5467,-2219
2019,7,20,16,6948,8531,6341,-2190
2019,7,20,17,7457,9272,7088,-2184
2019,7,20,18,7768,9845,7676,-2169
2019,7,20,19,8045,10165,8057,-2108
2019,7,20,20,8039,10127,7989,-2138
2019,7,20,21,7911,9797,7703,-2094
2019,7,20,22,7715,9253,7268,-1985
2019,7,20,23,7467,8625,6793,-1832
2019,7,21,0,7042,7999,6130,-1869
2019,7,21,1,6730,7661,5613,-2048
2019,7,21,2,6403,7258,5154,-2104
2019,7,21,3,5912,6753,4901,-1852
2019,7,21,4,5405,6182,4528,-1654
2019,7,21,5,4716,5702,4317,-1385
2019,7,21,6,4406,5308,4013,-1295
2019,7,21,7,4197,5004,3774,-1230
2019,7,21,8,4034,4806,3617,-1189
2019,7,21,9,3937,4688,3513,-1175
2019,7,21,10,3946,4661,3494,-1167
2019,7,21,11,3981,4750,3553,-1197
2019,7,21,12,4164,5011,3837,-1174
2019,7,21,13,4784,5778,4277,-1501
2019,7,21,14,5561,6727,4786,-1941
2019,7,21,15,6291,7630,5359,-2271
2019,7,21,16,6905,8479,6282,-2197
2019,7,21,17,7413,9219,7174,-2045
2019,7,21,18,7794,9674,7600,-2074
2019,7,21,19,8046,9672,7620,-2052
2019,7,21,20,8075,9124,7089,-2035
2019,7,21,21,8184,8727,6945,-1782
2019,7,21,22,8019,8168,6456,-1712
2019,7,21,23,7758,7641,6001,-1640
2019,7,22,0,7370,7258,5716,-1542
2019,7,22,1,7017,6999,5386,-1613
2019,7,22,2,6668,6751,5022,-1729
2019,7,22,3,6079,6219,4575,-1644
2019,7,22,4,5485,5610,4057,-1553
2019,7,22,5,4522,5097,3801,-1296
2019,7,22,6,4193,4738,3529,-1209
2019,7,22,7,3991,4502,3348,-1154
2019,7,22,8,3865,4367,3238,-1129
2019,7,22,9,3866,4375,3238,-1137
2019,7,22,10,4020,4592,3436,-1156
2019,7,22,11,4340,4984,3780,-1204
2019,7,22,12,4598,5357,4186,-1171
2019,7,22,13,5076,5944,4515,-1429
2019,7,22,14,5675,6652,4842,-1810
2019,7,22,15,6334,7457,5431,-2026
2019,7,22,16,6901,8294,6352,-1942
2019,7,22,17,7289,9043,7153,-1890
2019,7,22,18,7585,9644,7718,-1926
2019,7,22,19,7800,10035,7996,-2039
2019,7,22,20,7800,10216,8112,-2104
2019,7,22,21,7616,10250,8079,-2171
2019,7,22,22,7325,10110,7951,-2159
2019,7,22,23,6989,9787,7726,-2061
2019,7,23,0,6607,9330,7379,-1951
2019,7,23,1,6344,8769,6846,-1923
2019,7,23,2,5992,8091,6215,-1876
2019,7,23,3,5478,7263,5478,-1785
2019,7,23,4,4998,6469,4774,-1695
2019,7,23,5,4577,5794,4407,-1387
2019,7,23,6,4248,5320,4026,-1294
2019,7,23,7,4030,5012,3763,-1249
2019,7,23,8,3889,4817,3601,-1216
2019,7,23,9,3882,4761,3548,-1213
2019,7,23,10,4027,4950,3729,-1221
2019,7,23,11,4339,5324,4029,-1295
2019,7,23,12,4584,5616,4373,-1243
2019,7,23,13,4997,6142,4631,-1511
2019,7,23,14,5486,6805,4936,-1869
2019,7,23,15,6093,7558,5373,-2185
2019,7,23,16,6585,8299,6077,-2222
2019,7,23,17,6948,8900,6698,-2202
2019,7,23,18,7225,9293,7056,-2237
2019,7,23,19,7408,9502,7277,-2225
2019,7,23,20,7398,9608,7442,-2166
2019,7,23,21,7329,9337,7191,-2146
2019,7,23,22,7131,9160,6926,-2234
2019,7,23,23,6975,8980,6684,-2296
2019,7,24,0,6675,8703,6477,-2226
2019,7,24,1,6418,8375,6177,-2198
2019,7,24,2,6050,7985,5833,-2152
2019,7,24,3,5525,7299,5377,-1922
2019,7,24,4,5024,6582,4836,-1746
2019,7,24,5,4554,6033,4558,-1475
2019,7,24,6,4235,5539,4161,-1378
2019,7,24,7,4017,5215,3911,-1304
2019,7,24,8,3883,5028,3766,-1262
2019,7,24,9,3881,5032,3766,-1266
2019,7,24,10,4028,5208,3918,-1290
2019,7,24,11,4306,5565,4185,-1380
2019,7,24,12,4535,5897,4554,-1343
2019,7,24,13,4892,6367,4795,-1572
2019,7,24,14,5394,6958,5180,-1778
2019,7,24,15,5912,7478,5633,-1845
2019,7,24,16,6299,7668,5782,-1886
2019,7,24,17,6522,7560,5757,-1803
2019,7,24,18,6760,7356,5520,-1836
2019,7,24,19,6906,7390,5558,-1832
2019,7,24,20,6864,7544,5709,-1835
2019,7,24,21,6874,7650,5818,-1832
2019,7,24,22,6692,7597,5737,-1860
2019,7,24,23,6448,7489,5652,-1837
2019,7,25,0,6187,7286,5489,-1797
2019,7,25,1,5943,7081,5368,-1713
2019,7,25,2,5648,6846,5190,-1656
2019,7,25,3,5185,6298,4793,-1505
2019,7,25,4,4675,5702,4220,-1482
2019,7,25,5,4325,5212,3932,-1280
2019,7,25,6,4024,4895,3681,-1214
2019,7,25,7,3831,4697,3531,-1166
2019,7,25,8,3725,4579,3441,-1138
2019,7,25,9,3729,4579,3443,-1136
2019,7,25,10,3889,4780,3573,-1207
2019,7,25,11,4137,5127,3842,-1285
2019,7,25,12,4399,5418,4187,-1231
2019,7,25,13,4737,5720,4295,-1425
2019,7,25,14,5216,6085,4384,-1701
2019,7,25,15,5714,6357,4443,-1914
2019,7,25,16,6091,6524,4479,-2045
2019,7,25,17,6231,6627,4567,-2060
2019,7,25,18,6400,6723,4637,-2086
2019,7,25,19,6468,6863,4749,-2114
2019,7,25,20,6381,7124,4968,-2156
2019,7,25,21,6386,7525,5277,-2248
2019,7,25,22,6407,7795,5467,-2328
2019,7,25,23,6238,7775,5435,-2340
2019,7,26,0,6011,7508,5229,-2279
2019,7,26,1,5842,7250,5075,-2175
2019,7,26,2,5598,6949,4867,-2082
2019,7,26,3,5177,6365,4578,-1787
2019,7,26,4,4699,5726,4108,-1618
2019,7,26,5,4148,5199,3829,-1370
2019,7,26,6,3875,4811,3543,-1268
2019,7,26,7,3715,4574,3361,-1213
2019,7,26,8,3620,4443,3270,-1173
2019,7,26,9,3630,4406,3244,-1162
2019,7,26,10,3790,4561,3341,-1220
2019,7,26,11,4085,4884,3624,-1260
2019,7,26,12,4333,5207,4020,-1187
2019,7,26,13,4699,5666,4262,-1404
2019,7,26,14,5147,6202,4481,-1721
2019,7,26,15,5650,6811,4859,-1952
2019,7,26,16,6092,7334,5241,-2093
2019,7,26,17,6292,7712,5546,-2166
2019,7,26,18,6527,7804,5713,-2091
2019,7,26,19,6677,7537,5378,-2159
2019,7,26,20,6628,7506,5306,-2200
2019,7,26,21,6472,7478,5225,-2253
2019,7,26,22,6237,7540,5217,-2323
2019,7,26,23,5997,7506,5151,-2355
2019,7,27,0,5639,7361,5083,-2278
2019,7,27,1,5453,7120,4961,-2159
2019,7,27,2,5269,6877,4817,-2060
2019,7,27,3,4966,6395,4605,-1790
2019,7,27,4,4592,5796,4183,-1613
2019,7,27,5,4258,5278,3930,-1348
2019,7,27,6,3960,4849,3606,-1243
2019,7,27,7,3752,4548,3384,-1164
2019,7,27,8,3614,4359,3230,-1129
2019,7,27,9,3551,4306,3184,-1122
2019,7,27,10,3557,4338,3205,-1133
2019,7,27,11,3633,4462,3270,-1192
2019,7,27,12,3843,4734,3591,-1143
2019,7,27,13,4301,5322,3930,-1392
2019,7,27,14,4970,6075,4287,-1788
2019,7,27,15,5567,6825,4734,-2091
2019,7,27,16,5987,7467,5205,-2262
2019,7,27,17,6473,8040,5754,-2286
2019,7,27,18,6719,8514,6215,-2299
2019,7,27,19,6886,8895,6605,-2290
2019,7,27,20,6911,9168,6777,-2391
2019,7,27,21,6829,9376,6941,-2435
2019,7,27,22,6653,9450,6999,-2451
2019,7,27,23,6449,9311,6869,-2442
2019,7,28,0,6082,8832,6452,-2380
2019,7,28,1,5883,8333,6078,-2255
2019,7,28,2,5547,7834,5533,-2301
2019,7,28,3,5136,7161,5163,-1998
2019,7,28,4,4716,6495,4717,-1778
2019,7,28,5,4454,5882,4403,-1479
2019,7,28,6,4164,5389,4035,-1354
2019,7,28,7,3938,5059,3772,-1287
2019,7,28,8,3790,4826,3588,-1238
2019,7,28,9,3703,4718,3505,-1213
2019,7,28,10,3678,4695,3479,-1216
2019,7,28,11,3730,4797,3505,-1292
2019,7,28,12,3891,4980,3761,-1219
2019,7,28,13,4452,5709,4185,-1524
2019,7,28,14,5154,6602,4663,-1939
2019,7,28,15,5842,7483,5216,-2267
2019,7,28,16,6421,8306,5961,-2345
2019,7,28,17,6858,8951,6457,-2494
2019,7,28,18,7190,9435,6981,-2454
2019,7,28,19,7371,9801,7288,-2513
2019,7,28,20,7444,10068,7507,-2561
2019,7,28,21,7352,10221,7646,-2575
2019,7,28,22,7205,10103,7580,-2523
2019,7,28,23,6975,9686,7300,-2386
2019,7,29,0,6591,8996,6787,-2209
2019,7,29,1,6338,8371,6528,-1843
2019,7,29,2,6032,7909,6101,-1808
2019,7,29,3,5537,7236,5623,-1613
2019,7,29,4,5018,6475,4912,-1563
2019,7,29,5,4623,5799,4381,-1418
2019,7,29,6,4269,5342,4035,-1307
2019,7,29,7,4041,5020,3787,-1233
2019,7,29,8,3906,4851,3643,-1208
2019,7,29,9,3883,4808,3607,-1201
2019,7,29,10,4031,5000,3752,-1248
2019,7,29,11,4332,5345,4015,-1330
2019,7,29,12,4580,5656,4366,-1290
2019,7,29,13,5012,6161,4659,-1502
2019,7,29,14,5583,6863,5232,-1631
2019,7,29,15,6231,7664,5895,-1769
2019,7,29,16,6837,8461,6736,-1725
2019,7,29,17,7286,9205,7304,-1901
2019,7,29,18,7640,9798,7808,-1990
2019,7,29,19,7832,10208,8111,-2097
2019,7,29,20,7908,10497,8275,-2222
2019,7,29,21,7819,10616,8312,-2304
2019,7,29,22,7747,10412,8185,-2227
2019,7,29,23,7483,9933,7794,-2139
2019,7,30,0,7084,9354,7347,-2007
2019,7,30,1,6759,8874,7025,-1849
2019,7,30,2,6346,8359,6444,-1915
2019,7,30,3,5784,7592,5904,-1688
2019,7,30,4,5213,6791,5157,-1634
2019,7,30,5,4884,6113,4619,-1494
2019,7,30,6,4487,5622,4253,-1369
2019,7,30,7,4209,5315,4016,-1299
2019,7,30,8,4051,5098,3851,-1247
2019,7,30,9,3994,5036,3802,-1234
2019,7,30,10,4112,5186,3911,-1275
2019,7,30,11,4411,5509,4192,-1317
2019,7,30,12,4640,5789,4500,-1289
2019,7,30,13,5052,6281,4769,-1512
2019,7,30,14,5551,6973,5259,-1714
2019,7,30,15,6180,7837,5999,-1838
2019,7,30,16,6751,8704,6760,-1944
2019,7,30,17,7283,9466,7347,-2119
2019,7,30,18,7705,10048,7861,-2187
2019,7,30,19,8001,10377,8204,-2173
2019,7,30,20,8215,10425,8252,-2173
2019,7,30,21,8249,10302,8214,-2088
2019,7,30,22,8142,10118,8026,-2092
2019,7,30,23,7842,9807,7645,-2162
2019,7,31,0,7438,9433,7321,-2112
2019,7,31,1,7055,8960,6982,-1978
2019,7,31,2,6632,8501,6639,-1862
2019,7,31,3,6032,7698,6063,-1635
2019,7,31,4,5439,6897,5428,-1469
2019,7,31,5,4982,6278,4983,-1295
2019,7,31,6,4611,5829,4633,-1196
2019,7,31,7,4333,5510,4393,-1117
2019,7,31,8,4188,5287,4211,-1076
2019,7,31,9,4129,5209,4135,-1074
2019,7,31,10,4249,5330,4223,-1107
2019,7,31,11,4532,5671,4481,-1190
2019,7,31,12,4757,5943,4757,-1186
2019,7,31,13,5170,6476,5154,-1322
2019,7,31,14,5667,7256,5645,-1611
2019,7,31,15,6234,8193,6166,-2027
2019,7,31,16,6821,9148,6935,-2213
2019,7,31,17,7296,9944,7524,-2420
2019,7,31,18,7710,10536,8061,-2475
2019,7,31,19,7997,10833,8471,-2362
2019,7,31,20,8171,10849,8498,-2351
2019,7,31,21,8215,10373,8076,-2297
2019,7,31,22,8062,9725,7488,-2237
2019,7,31,23,7800,9067,6859,-2208
2019,8,1,0,7378,8279,6108,-2171
2019,8,1,1,7046,7824,5657,-2167
2019,8,1,2,6663,7314,5125,-2189
2019,8,1,3,6108,6676,4810,-1866
2019,8,1,4,5530,6019,4377,-1642
2019,8,1,5,5056,5512,4081,-1431
2019,8,1,6,4674,5125,3771,-1354
2019,8,1,7,4433,4840,3531,-1309
2019,8,1,8,4239,4671,3410,-1261
2019,8,1,9,4175,4656,3408,-1248
2019,8,1,10,4297,4813,3547,-1266
2019,8,1,11,4562,5162,3836,-1326
2019,8,1,12,4774,5462,4226,-1236
2019,8,1,13,5198,5959,4627,-1332
2019,8,1,14,5685,6580,4901,-1679
2019,8,1,15,6340,7339,5329,-2010
2019,8,1,16,6906,8166,6058,-2108
2019,8,1,17,7325,8958,6713,-2245
2019,8,1,18,7641,9496,7407,-2089
2019,8,1,19,7853,9745,7680,-2065
2019,8,1,20,7947,9568,7516,-2052
2019,8,1,21,7843,8888,6871,-2017
2019,8,1,22,7594,8264,6295,-1969
2019,8,1,23,7246,7821,5911,-1910
2019,8,2,0,6859,7479,5493,-1986
2019,8,2,1,6563,7258,5131,-2127
2019,8,2,2,6204,6962,4899,-2063
2019,8,2,3,5646,6401,4627,-1774
2019,8,2,4,5091,5824,4205,-1619
2019,8,2,5,4649,5322,3995,-1327
2019,8,2,6,4294,4943,3701,-1242
2019,8,2,7,4057,4711,3501,-1210
2019,8,2,8,3911,4587,3408,-1179
2019,8,2,9,3883,4608,3423,-1185
2019,8,2,10,4018,4819,3597,-1222
2019,8,2,11,4237,5227,3938,-1289
2019,8,2,12,4462,5526,4253,-1273
2019,8,2,13,4840,5925,4579,-1346
2019,8,2,14,5278,6411,4727,-1684
2019,8,2,15,5699,7012,5008,-2004
2019,8,2,16,6060,7689,5413,-2276
2019,8,2,17,6154,8403,5910,-2493
2019,8,2,18,6269,8913,6489,-2424
2019,8,2,19,6200,9072,6495,-2577
2019,8,2,20,6067,8844,6362,-2482
2019,8,2,21,6004,8384,6043,-2341
2019,8,2,22,5769,7903,5585,-2318
2019,8,2,23,5692,7482,5191,-2291
2019,8,3,0,5453,7166,4913,-2253
2019,8,3,1,5311,7032,4852,-2180
2019,8,3,2,5156,6807,4720,-2087
2019,8,3,3,4837,6419,4598,-1821
2019,8,3,4,4463,5932,4320,-1612
2019,8,3,5,4306,5469,4110,-1359
2019,8,3,6,4022,5093,3832,-1261
2019,8,3,7,3837,4846,3637,-1209
2019,8,3,8,3722,4680,3481,-1199
2019,8,3,9,3675,4608,3421,-1187
2019,8,3,10,3709,4649,3446,-1203
2019,8,3,11,3808,4813,3575,-1238
2019,8,3,12,4028,5051,3841,-1210
2019,8,3,13,4499,5625,4291,-1334
2019,8,3,14,4968,6237,4538,-1699
2019,8,3,15,5396,6785,4768,-2017
2019,8,3,16,5911,7173,4813,-2360
2019,8,3,17,6298,7609,5185,-2424
2019,8,3,18,6457,8237,5757,-2480
2019,8,3,19,6581,8862,6353,-2509
2019,8,3,20,6608,9255,6812,-2443
2019,8,3,21,6632,9469,7049,-2420
2019,8,3,22,6488,9503,7153,-2350
2019,8,3,23,6255,9333,7003,-2330
2019,8,4,0,5982,8958,6617,-2341
2019,8,4,1,5788,8488,6150,-2338
2019,8,4,2,5503,8013,5688,-2325
2019,8,4,3,5139,7427,5346,-2081
2019,8,4,4,4769,6803,4927,-1876
2019,8,4,5,4360,6177,4580,-1597
2019,8,4,6,4089,5666,4231,-1435
2019,8,4,7,3896,5318,3936,-1382
2019,8,4,8,3719,5072,3765,-1307
2019,8,4,9,3648,4922,3654,-1268
2019,8,4,10,3649,4908,3630,-1278
2019,8,4,11,3723,4981,3662,-1319
2019,8,4,12,3869,5201,3910,-1291
2019,8,4,13,4397,5922,4455,-1467
2019,8,4,14,5078,6860,4972,-1888
2019,8,4,15,5754,7714,5483,-2231
2019,8,4,16,6324,8551,6068,-2483
2019,8,4,17,6806,9263,6831,-2432
2019,8,4,18,7183,9775,7505,-2270
2019,8,4,19,7422,10092,7740,-2352
2019,8,4,20,7363,10224,7780,-2444
2019,8,4,21,7261,10307,7875,-2432
2019,8,4,22,7018,10156,7699,-2457
2019,8,4,23,6755,9934,7530,-2404
2019,8,5,0,6468,9428,7065,-2363
2019,8,5,1,6210,9008,6669,-2339
2019,8,5,2,5866,8512,6186,-2326
2019,8,5,3,5380,7740,5558,-2182
2019,8,5,4,4869,6682,4787,-1895
2019,8,5,5,4548,6325,4712,-1613
2019,8,5,6,4210,5829,4344,-1485
2019,8,5,7,4002,5470,4083,-1387
2019,8,5,8,3880,5264,3915,-1349
2019,8,5,9,3887,5203,3878,-1325
2019,8,5,10,4058,5375,4014,-1361
2019,8,5,11,4380,5736,4286,-1450
2019,8,5,12,4620,6037,4637,-1400
2019,8,5,13,5061,6505,5016,-1489
2019,8,5,14,5546,7044,5242,-1802
2019,8,5,15,6190,7761,5623,-2138
2019,8,5,16,6819,8491,6258,-2233
2019,8,5,17,7258,9149,6881,-2268
2019,8,5,18,7572,9651,7433,-2218
2019,8,5,19,7758,9935,7731,-2204
2019,8,5,20,7742,10018,7813,-2205
2019,8,5,21,7658,9884,7665,-2219
2019,8,5,22,7481,9564,7357,-2207
2019,8,5,23,7132,9116,7023,-2093
2019,8,6,0,6781,8696,6560,-2136
2019,8,6,1,6487,8310,6042,-2268
2019,8,6,2,6101,7862,5582,-2280
2019,8,6,3,5540,7129,5122,-2007
2019,8,6,4,5001,6399,4636,-1763
2019,8,6,5,4460,5822,4318,-1504
2019,8,6,6,4132,5413,4017,-1396
2019,8,6,7,3941,5150,3815,-1335
2019,8,6,8,3818,4986,3693,-1293
2019,8,6,9,3811,4953,3654,-1299
2019,8,6,10,3973,5111,3776,-1335
2019,8,6,11,4292,5488,4076,-1412
2019,8,6,12,4513,5795,4434,-1361
2019,8,6,13,4921,6283,4852,-1431
2019,8,6,14,5370,7062,5221,-1841
2019,8,6,15,5898,7739,5637,-2102
2019,8,6,16,6443,8460,6250,-2210
2019,8,6,17,6830,9027,6948,-2079
2019,8,6,18,7143,9369,7370,-1999
2019,8,6,19,7281,9570,7502,-2068
2019,8,6,20,7267,9661,7485,-2176
2019,8,6,21,7195,9644,7504,-2140
2019,8,6,22,7008,9571,7421,-2150
2019,8,6,23,6718,9349,7144,-2205
2019,8,7,0,6446,8904,6733,-2171
2019,8,7,1,6191,8519,6238,-2281
2019,8,7,2,5886,8063,5792,-2271
2019,8,7,3,5378,7339,5354,-1985
2019,8,7,4,4881,6609,4778,-1831
2019,8,7,5,4481,6032,4492,-1540
2019,8,7,6,4161,5615,4177,-1438
2019,8,7,7,3959,5306,3940,-1366
2019,8,7,8,3840,5152,3819,-1333
2019,8,7,9,3837,5142,3805,-1337
2019,8,7,10,3998,5348,3969,-1379
2019,8,7,11,4290,5758,4299,-1459
2019,8,7,12,4498,6031,4631,-1400
2019,8,7,13,4846,6398,4947,-1451
2019,8,7,14,5227,6871,5238,-1633
2019,8,7,15,5643,7448,5504,-1944
2019,8,7,16,6052,7950,5954,-1996
2019,8,7,17,6169,8605,6440,-2165
2019,8,7,18,6381,9184,7008,-2176
2019,8,7,19,6457,9560,7453,-2107
2019,8,7,20,6586,9488,7473,-2015
2019,8,7,21,6629,9062,7076,-1986
2019,8,7,22,6709,8738,6738,-2000
2019,8,7,23,6653,8459,6361,-2098
2019,8,8,0,6373,8142,6061,-2081
2019,8,8,1,6201,7889,5658,-2231
2019,8,8,2,5897,7535,5319,-2216
2019,8,8,3,5401,6901,4996,-1905
2019,8,8,4,4914,6225,4504,-1721
2019,8,8,5,4508,5696,4269,-1427
2019,8,8,6,4211,5339,4017,-1322
2019,8,8,7,4030,5096,3811,-1285
2019,8,8,8,3918,4944,3703,-1241
2019,8,8,9,3922,4959,3703,-1256
2019,8,8,10,4076,5183,3852,-1331
2019,8,8,11,4421,5593,4159,-1434
2019,8,8,12,4669,5880,4499,-1381
2019,8,8,13,5105,6442,4969,-1473
2019,8,8,14,5599,7218,5375,-1843
2019,8,8,15,6282,8074,5999,-2075
2019,8,8,16,6896,8818,6771,-2047
2019,8,8,17,7409,9458,7397,-2061
2019,8,8,18,7813,9941,7671,-2270
2019,8,8,19,8061,10313,8008,-2305
2019,8,8,20,8162,10493,8253,-2240
2019,8,8,21,8117,10579,8247,-2332
2019,8,8,22,7962,10394,8073,-2321
2019,8,8,23,7594,9897,7807,-2090
2019,8,9,0,7204,9359,7318,-2041
2019,8,9,1,6929,8978,6832,-2146
2019,8,9,2,6547,8464,6351,-2113
2019,8,9,3,5986,7709,5607,-2102
2019,8,9,4,5435,6974,5130,-1844
2019,8,9,5,4917,6349,4798,-1551
2019,8,9,6,4563,5894,4453,-1441
2019,8,9,7,4333,5575,4208,-1367
2019,8,9,8,4178,5385,4052,-1333
2019,8,9,9,4148,5333,4011,-1322
2019,8,9,10,4279,5506,4133,-1373
2019,8,9,11,4612,5861,4431,-1430
2019,8,9,12,4840,6186,4764,-1422
2019,8,9,13,5264,6788,5245,-1543
2019,8,9,14,5789,7576,5629,-1947
2019,8,9,15,6456,8419,6194,-2225
2019,8,9,16,7162,9191,6837,-2354
2019,8,9,17,7685,9979,7580,-2399
2019,8,9,18,8136,10492,8159,-2333
2019,8,9,19,8454,10671,8450,-2221
2019,8,9,20,8586,10761,8548,-2213
2019,8,9,21,8521,10634,8408,-2226
2019,8,9,22,8206,10122,7847,-2275
2019,8,9,23,7911,9565,7288,-2277
2019,8,10,0,7411,9120,6841,-2279
2019,8,10,1,7085,8794,6589,-2205
2019,8,10,2,6723,8419,6259,-2160
2019,8,10,3,6212,7833,5791,-2042
2019,8,10,4,5697,7180,5286,-1894
2019,8,10,5,5128,6613,4901,-1712
2019,8,10,6,4751,6123,4517,-1606
2019,8,10,7,4478,5787,4277,-1510
2019,8,10,8,4301,5562,4105,-1457
2019,8,10,9,4191,5441,4016,-1425
2019,8,10,10,4186,5449,4028,-1421
2019,8,10,11,4277,5564,4115,-1449
2019,8,10,12,4505,5803,4412,-1391
2019,8,10,13,5092,6581,5016,-1565
2019,8,10,14,5783,7498,5529,-1969
2019,8,10,15,6425,8337,6188,-2149
2019,8,10,16,7064,9137,7319,-1818
2019,8,10,17,7544,9805,7797,-2008
2019,8,10,18,7832,10224,7871,-2353
2019,8,10,19,8007,10443,7933,-2510
2019,8,10,20,8073,10360,7789,-2571
2019,8,10,21,8054,10170,7628,-2542
2019,8,10,22,7853,9861,7281,-2580
2019,8,10,23,7558,9513,7123,-2390
2019,8,11,0,7154,9064,6898,-2166
2019,8,11,1,6831,8833,6726,-2107
2019,8,11,2,6433,8422,6309,-2113
2019,8,11,3,5949,7820,5835,-1985
2019,8,11,4,5479,7210,5276,-1934
2019,8,11,5,5191,6650,4906,-1744
2019,8,11,6,4808,6180,4571,-1609
2019,8,11,7,4551,5847,4300,-1547
2019,8,11,8,4364,5645,4134,-1511
2019,8,11,9,4261,5539,4067,-1472
2019,8,11,10,4265,5538,4062,-1476
2019,8,11,11,4290,5611,4118,-1493
2019,8,11,12,4439,5823,4399,-1424
2019,8,11,13,5059,6556,5000,-1556
2019,8,11,14,5825,7474,5599,-1875
2019,8,11,15,6589,8356,6314,-2042
2019,8,11,16,7301,9132,6923,-2209
2019,8,11,17,7790,9800,7453,-2347
2019,8,11,18,8174,10263,7799,-2464
2019,8,11,19,8419,10598,8027,-2571
2019,8,11,20,8519,10718,8147,-2571
2019,8,11,21,8549,10740,8247,-2493
2019,8,11,22,8315,10642,8247,-2395
2019,8,11,23,7996,10178,7929,-2249
2019,8,12,0,7526,9538,7287,-2251
2019,8,12,1,7214,9213,7060,-2153
2019,8,12,2,6796,8657,6395,-2262
2019,8,12,3,6236,7906,5873,-2033
2019,8,12,4,5677,7149,5307,-1842
2019,8,12,5,4899,6590,4919,-1671
2019,8,12,6,4565,6121,4514,-1607
2019,8,12,7,4349,5831,4313,-1518
2019,8,12,8,4218,5664,4200,-1464
2019,8,12,9,4186,5623,4165,-1458
2019,8,12,10,4358,5881,4375,-1506
2019,8,12,11,4745,6362,4754,-1608
2019,8,12,12,4972,6617,5175,-1442
2019,8,12,13,5431,7025,5478,-1547
2019,8,12,14,6046,7695,5881,-1814
2019,8,12,15,6778,8438,6407,-2031
2019,8,12,16,7450,9171,6956,-2215
2019,8,12,17,7957,9728,7231,-2497
2019,8,12,18,8359,10152,7367,-2785
2019,8,12,19,8602,10301,7458,-2843
2019,8,12,20,8661,10223,7365,-2858
2019,8,12,21,8566,10001,7200,-2801
2019,8,12,22,8053,9701,6855,-2846
2019,8,12,23,7627,9208,6587,-2621
2019,8,13,0,7267,8746,6355,-2391
2019,8,13,1,6984,8454,6391,-2063
2019,8,13,2,6573,7939,6030,-1909
2019,8,13,3,5990,7248,5580,-1668
2019,8,13,4,5435,6532,4884,-1648
2019,8,13,5,5163,5995,4508,-1487
2019,8,13,6,4798,5611,4218,-1393
2019,8,13,7,4558,5404,4049,-1355
2019,8,13,8,4397,5237,3935,-1302
2019,8,13,9,4338,5248,3934,-1314
2019,8,13,10,4483,5501,4123,-1378
2019,8,13,11,4829,5992,4495,-1497
2019,8,13,12,5034,6234,4729,-1505
2019,8,13,13,5477,6504,5009,-1495
2019,8,13,14,6062,7024,5357,-1667
2019,8,13,15,6748,7707,5869,-1838
2019,8,13,16,7425,8368,5967,-2401
2019,8,13,17,7869,8856,6283,-2573
2019,8,13,18,8253,9200,6488,-2712
2019,8,13,19,8449,9424,6664,-2760
2019,8,13,20,8425,9636,6805,-2831
2019,8,13,21,8359,9778,6966,-2812
2019,8,13,22,8069,9736,6916,-2820
2019,8,13,23,7763,9532,6741,-2791
2019,8,14,0,7391,9068,6370,-2698
2019,8,14,1,7139,8830,6482,-2348
2019,8,14,2,6723,8312,6163,-2149
2019,8,14,3,6130,7569,5728,-1841
2019,8,14,4,5547,6829,5196,-1633
2019,8,14,5,4765,6292,4672,-1620
2019,8,14,6,4468,5890,4329,-1561
2019,8,14,7,4270,5610,4134,-1476
2019,8,14,8,4159,5507,4044,-1463
2019,8,14,9,4131,5491,4038,-1453
2019,8,14,10,4296,5844,4323,-1521
2019,8,14,11,4625,6216,4644,-1572
2019,8,14,12,4865,6424,4982,-1442
2019,8,14,13,5286,6710,5234,-1476
2019,8,14,14,5830,7294,5659,-1635
2019,8,14,15,6396,7960,6269,-1691
2019,8,14,16,6923,8506,6719,-1787
2019,8,14,17,7295,8916,6909,-2007
2019,8,14,18,7623,9287,7165,-2122
2019,8,14,19,7752,9451,7395,-2056
2019,8,14,20,7787,9258,7209,-2049
2019,8,14,21,7714,9077,7051,-2026
2019,8,14,22,7522,8871,6784,-2087
2019,8,14,23,7274,8700,6608,-2092
2019,8,15,0,6840,8496,6554,-1942
2019,8,15,1,6624,8396,6363,-2033
2019,8,15,2,6254,7926,6028,-1898
2019,8,15,3,5697,7196,5566,-1630
2019,8,15,4,5162,6451,4772,-1679
2019,8,15,5,4942,5898,4471,-1427
2019,8,15,6,4616,5503,4182,-1321
2019,8,15,7,4404,5218,3936,-1282
2019,8,15,8,4255,5051,3808,-1243
2019,8,15,9,4264,5047,3783,-1264
2019,8,15,10,4400,5338,4021,-1317
2019,8,15,11,4727,5823,4392,-1431
2019,8,15,12,4927,6078,4710,-1368
2019,8,15,13,5239,6366,4976,-1390
2019,8,15,14,5593,6910,5325,-1585
2019,8,15,15,6085,7539,5891,-1648
2019,8,15,16,6553,12606,10919,-1687
2019,8,15,17,6831,8795,7164,-1631
2019,8,15,18,7090,9068,7504,-1564
2019,8,15,19,7184,8827,7295,-1532
2019,8,15,20,7129,8318,6667,-1651
2019,8,15,21,6931,8238,6538,-1700
2019,8,15,22,6568,8236,6527,-1709
2019,8,15,23,6467,8110,6368,-1742
2019,8,16,0,6166,7910,6095,-1815
2019,8,16,1,6025,7849,5788,-2061
2019,8,16,2,5735,7478,5364,-2114
2019,8,16,3,5276,6797,4988,-1809
2019,8,16,4,4810,6145,4540,-1605
2019,8,16,5,4398,5631,4254,-1377
2019,8,16,6,4084,5280,3978,-1302
2019,8,16,7,3906,5059,3800,-1259
2019,8,16,8,3818,4917,3692,-1225
2019,8,16,9,3838,4906,3670,-1236
2019,8,16,10,4020,5165,3828,-1337
2019,8,16,11,4287,5628,4236,-1392
2019,8,16,12,4512,5879,4574,-1305
2019,8,16,13,4853,6097,4747,-1350
2019,8,16,14,5259,6399,4730,-1669
2019,8,16,15,5643,6807,4899,-1908
2019,8,16,16,5978,7269,5306,-1963
2019,8,16,17,6131,7638,5672,-1966
2019,8,16,18,6341,7796,5868,-1928
2019,8,16,19,6359,7730,5797,-1933
2019,8,16,20,6271,7718,5716,-2002
2019,8,16,21,6102,7635,5627,-2008
2019,8,16,22,5862,7477,5480,-1997
2019,8,16,23,5734,7306,5281,-2025
2019,8,17,0,5458,7113,5092,-2021
2019,8,17,1,5434,7069,4964,-2105
2019,8,17,2,5240,6840,4840,-2000
2019,8,17,3,4924,6368,4636,-1732
2019,8,17,4,4567,5843,4259,-1584
2019,8,17,5,4449,5423,4070,-1353
2019,8,17,6,4156,5076,3764,-1312
2019,8,17,7,3953,4824,3600,-1224
2019,8,17,8,3802,4701,3502,-1199
2019,8,17,9,3750,4648,3460,-1188
2019,8,17,10,3769,4721,3503,-1218
2019,8,17,11,3858,4818,3559,-1259
2019,8,17,12,4025,5006,3791,-1215
2019,8,17,13,4497,5526,4205,-1321
2019,8,17,14,5225,6168,4555,-1613
2019,8,17,15,5876,6710,4846,-1864
2019,8,17,16,6358,7082,5109,-1973
2019,8,17,17,6789,7453,5428,-2025
2019,8,17,18,7077,7448,5518,-1930
2019,8,17,19,7248,7367,5392,-1975
2019,8,17,20,7285,7570,5560,-2010
2019,8,17,21,7226,7661,5664,-1997
2019,8,17,22,7095,7619,5624,-1995
2019,8,17,23,6871,7475,5446,-2029
2019,8,18,0,6494,7228,5229,-1999
2019,8,18,1,6311,7152,5079,-2073
2019,8,18,2,5932,6839,4833,-2006
2019,8,18,3,5493,6364,4636,-1728
2019,8,18,4,5041,5846,4271,-1575
2019,8,18,5,4297,5382,4038,-1344
2019,8,18,6,3999,5045,3781,-1264
2019,8,18,7,3800,4766,3561,-1205
2019,8,18,8,3664,4612,3410,-1202
2019,8,18,9,3601,4516,3311,-1205
2019,8,18,10,3627,4518,3298,-1220
2019,8,18,11,3720,4623,3397,-1226
2019,8,18,12,3873,4833,3632,-1201
2019,8,18,13,4372,5391,4083,-1308
2019,8,18,14,5041,6093,4440,-1653
2019,8,18,15,5607,6747,4876,-1871
2019,8,18,16,6133,7311,5327,-1984
2019,8,18,17,6660,7883,5814,-2069
2019,8,18,18,7053,8326,6320,-2006
2019,8,18,19,7290,8747,6641,-2106
2019,8,18,20,7382,9112,6999,-2113
2019,8,18,21,7403,9340,7200,-2140
2019,8,18,22,7272,9302,7200,-2102
2019,8,18,23,7038,9028,7116,-1912
2019,8,19,0,6690,8562,6611,-1951
2019,8,19,1,6446,8248,6119,-2129
2019,8,19,2,6045,7654,5521,-2133
2019,8,19,3,5514,6892,5087,-1805
2019,8,19,4,4981,6114,4518,-1596
2019,8,19,5,4305,5440,4100,-1340
2019,8,19,6,3986,5119,3862,-1257
2019,8,19,7,3803,4863,3663,-1200
2019,8,19,8,3691,4734,3546,-1188
2019,8,19,9,3681,4754,3547,-1207
2019,8,19,10,3886,5020,3750,-1270
2019,8,19,11,4264,5517,4153,-1364
2019,8,19,12,4502,5748,4458,-1290
2019,8,19,13,4819,6056,4707,-1349
2019,8,19,14,5358,6574,4932,-1642
2019,8,19,15,6034,7292,5317,-1975
2019,8,19,16,6733,8034,5754,-2280
2019,8,19,17,7103,8754,6356,-2398
2019,8,19,18,7512,9316,6921,-2395
2019,8,19,19,7699,9761,7384,-2377
2019,8,19,20,7817,10003,7669,-2334
2019,8,19,21,7806,9876,7596,-2280
2019,8,19,22,7657,9565,7299,-2266
2019,8,19,23,7368,9189,7018,-2171
2019,8,20,0,7002,8743,6682,-2061
2019,8,20,1,6764,8399,6350,-2049
2019,8,20,2,6317,7942,5815,-2127
2019,8,20,3,5723,7171,5271,-1900
2019,8,20,4,5143,6422,4742,-1680
2019,8,20,5,4823,5837,4394,-1443
2019,8,20,6,4446,5401,4053,-1348
2019,8,20,7,4210,5127,3835,-1292
2019,8,20,8,4069,4949,3683,-1266
2019,8,20,9,4037,4927,3649,-1278
2019,8,20,10,4221,5135,3822,-1313
2019,8,20,11,4583,5621,4209,-1412
2019,8,20,12,4797,5878,4552,-1326
2019,8,20,13,5115,6281,4868,-1413
2019,8,20,14,5604,6893,5140,-1753
2019,8,20,15,6137,7586,5618,-1968
2019,8,20,16,6680,8345,6080,-2265
2019,8,20,17,7071,9061,6857,-2204
2019,8,20,18,7407,9618,7395,-2223
2019,8,20,19,7602,9973,7616,-2357
2019,8,20,20,7681,9975,7676,-2299
2019,8,20,21,7667,9818,7490,-2328
2019,8,20,22,7490,9456,7115,-2341
2019,8,20,23,7255,9074,6926,-2148
2019,8,21,0,6850,8654,6465,-2189
2019,8,21,1,6640,8444,6206,-2238
2019,8,21,2,6216,7940,5773,-2167
2019,8,21,3,5626,7206,5262,-1944
2019,8,21,4,5047,6448,4691,-1757
2019,8,21,5,4650,5879,4431,-1448
2019,8,21,6,4334,5460,4098,-1362
2019,8,21,7,4129,5196,3885,-1311
2019,8,21,8,4016,5014,3744,-1270
2019,8,21,9,4003,4991,3739,-1252
2019,8,21,10,4200,5216,3904,-1312
2019,8,21,11,4577,5659,4264,-1395
2019,8,21,12,4769,5933,4580,-1353
2019,8,21,13,5085,6399,4964,-1435
2019,8,21,14,5625,7051,5261,-1790
2019,8,21,15,6247,7791,5665,-2126
2019,8,21,16,6818,8567,6257,-2310
2019,8,21,17,7260,9244,6946,-2298
2019,8,21,18,7639,9850,7515,-2335
2019,8,21,19,7837,10290,7862,-2428
2019,8,21,20,7898,10643,8230,-2413
2019,8,21,21,7867,10876,8373,-2503
2019,8,21,22,7700,10857,8413,-2444
2019,8,21,23,7441,10460,8184,-2276
2019,8,22,0,7103,9831,7755,-2076
2019,8,22,1,6816,9384,7283,-2101
2019,8,22,2,6391,8667,6503,-2164
2019,8,22,3,5790,7723,5782,-1941
2019,8,22,4,5206,6881,5096,-1785
2019,8,22,5,4740,6234,4675,-1559
2019,8,22,6,4405,5763,4297,-1466
2019,8,22,7,4182,5443,4052,-1391
2019,8,22,8,4058,5233,3898,-1335
2019,8,22,9,4047,5169,3850,-1319
2019,8,22,10,4234,5381,4000,-1381
2019,8,22,11,4615,5813,4353,-1460
2019,8,22,12,4813,6057,4694,-1363
2019,8,22,13,5125,6497,5039,-1458
2019,8,22,14,5672,7179,5344,-1835
2019,8,22,15,6300,7984,5800,-2184
2019,8,22,16,6916,8787,6464,-2323
2019,8,22,17,7372,9476,7145,-2331
2019,8,22,18,7739,10030,7605,-2425
2019,8,22,19,7940,10417,7834,-2583
2019,8,22,20,7990,10640,8056,-2584
2019,8,22,21,7934,10777,8201,-2576
2019,8,22,22,7770,10723,8123,-2600
2019,8,22,23,7580,10350,7876,-2474
2019,8,23,0,7160,9824,7473,-2351
2019,8,23,1,6878,9488,7158,-2330
2019,8,23,2,6460,8811,6526,-2285
2019,8,23,3,5852,7913,5795,-2118
2019,8,23,4,5289,7041,5125,-1916
2019,8,23,5,4924,6338,4749,-1589
2019,8,23,6,4565,5820,4350,-1470
2019,8,23,7,4308,5487,4094,-1393
2019,8,23,8,4142,5254,3912,-1342
2019,8,23,9,4105,5212,3875,-1337
2019,8,23,10,4264,5406,4042,-1364
2019,8,23,11,4586,5858,4402,-1456
2019,8,23,12,4784,6106,4736,-1370
2019,8,23,13,5117,6559,5092,-1467
2019,8,23,14,5686,7261,5415,-1846
2019,8,23,15,6314,8057,6086,-1971
2019,8,23,16,6841,8738,6524,-2214
2019,8,23,17,7223,9186,6974,-2212
2019,8,23,18,7556,9367,7124,-2243
2019,8,23,19,7715,9612,7282,-2330
2019,8,23,20,7746,9838,7459,-2379
2019,8,23,21,7639,9954,7633,-2321
2019,8,23,22,7455,9905,7595,-2310
2019,8,23,23,7161,9711,7444,-2267
2019,8,24,0,6753,9218,7002,-2216
2019,8,24,1,6532,8880,6687,-2193
2019,8,24,2,6174,8296,6158,-2138
2019,8,24,3,5670,7588,5684,-1904
2019,8,24,4,5200,6884,5003,-1881
2019,8,24,5,4730,6304,4703,-1601
2019,8,24,6,4412,5825,4328,-1497
2019,8,24,7,4172,5482,4056,-1426
2019,8,24,8,4031,5244,3870,-1374
2019,8,24,9,3964,5124,3786,-1338
2019,8,24,10,3990,5138,3800,-1338
2019,8,24,11,4074,5272,3914,-1358
2019,8,24,12,4240,5448,4147,-1301
2019,8,24,13,4744,6058,4605,-1453
2019,8,24,14,5335,6979,5077,-1902
2019,8,24,15,5936,7898,5689,-2209
2019,8,24,16,6440,8747,6528,-2219
2019,8,24,17,6911,9426,7278,-2148
2019,8,24,18,7235,9956,7739,-2217
2019,8,24,19,7430,10315,7855,-2460
2019,8,24,20,7535,10572,8032,-2540
2019,8,24,21,7532,10674,8130,-2544
2019,8,24,22,7387,10616,8064,-2552
2019,8,24,23,7261,10328,7860,-2468
2019,8,25,0,6877,9734,7404,-2330
2019,8,25,1,6613,9287,6880,-2407
2019,8,25,2,6170,8678,6254,-2424
2019,8,25,3,5684,7917,5722,-2195
2019,8,25,4,5229,7220,5213,-2007
2019,8,25,5,5102,6767,5051,-1716
2019,8,25,6,4721,6213,4628,-1585
2019,8,25,7,4455,5860,4382,-1478
2019,8,25,8,4255,5603,4118,-1485
2019,8,25,9,4149,5423,4040,-1383
2019,8,25,10,4122,5357,3988,-1369
2019,8,25,11,4129,5404,4012,-1392
2019,8,25,12,4267,5578,4274,-1304
2019,8,25,13,4809,6260,4784,-1476
2019,8,25,14,5515,7162,5288,-1874
2019,8,25,15,6220,8016,5875,-2141
2019,8,25,16,6785,8833,6684,-2149
2019,8,25,17,7149,9610,7500,-2110
2019,8,25,18,7495,10212,8045,-2167
2019,8,25,19,7682,10649,8269,-2380
2019,8,25,20,7747,10930,8459,-2471
2019,8,25,21,7631,11067,8636,-2431
2019,8,25,22,7512,10993,8573,-2420
2019,8,25,23,7462,10719,8405,-2314
2019,8,26,0,7037,10164,7934,-2230
2019,8,26,1,6805,9794,7365,-2429
2019,8,26,2,6344,9085,6683,-2402
2019,8,26,3,5790,8230,6096,-2134
2019,8,26,4,5249,7381,5446,-1935
2019,8,26,5,4973,6520,4896,-1624
2019,8,26,6,4609,6053,4551,-1502
2019,8,26,7,4371,5697,4343,-1354
2019,8,26,8,4227,5489,4128,-1361
2019,8,26,9,4197,5457,4107,-1350
2019,8,26,10,4410,5701,4299,-1402
2019,8,26,11,4807,6137,4648,-1489
2019,8,26,12,5037,6368,4955,-1413
2019,8,26,13,5364,6733,5244,-1489
2019,8,26,14,5920,7420,5576,-1844
2019,8,26,15,6568,8221,6125,-2096
2019,8,26,16,7196,9044,6751,-2293
2019,8,26,17,7555,9779,7538,-2241
2019,8,26,18,7897,10309,8045,-2264
2019,8,26,19,8081,10571,8235,-2336
2019,8,26,20,8128,10671,8331,-2340
2019,8,26,21,8030,10598,8363,-2235
2019,8,26,22,7912,10196,8101,-2095
2019,8,26,23,7694,9519,7516,-2003
2019,8,27,0,7336,8867,6792,-2075
2019,8,27,1,7047,8423,6294,-2129
2019,8,27,2,6579,7789,5660,-2129
2019,8,27,3,5920,7056,5165,-1891
2019,8,27,4,5327,6338,4650,-1688
2019,8,27,5,4801,5811,4371,-1440
2019,8,27,6,4480,5430,4078,-1352
2019,8,27,7,4284,5164,3861,-1303
2019,8,27,8,4149,4997,3725,-1272
2019,8,27,9,4144,4952,3674,-1278
2019,8,27,10,4348,5213,3879,-1334
2019,8,27,11,4747,5677,4250,-1427
2019,8,27,12,4945,5948,4594,-1354
2019,8,27,13,5186,6346,4938,-1408
2019,8,27,14,5630,7001,5248,-1753
2019,8,27,15,6131,7765,5651,-2114
2019,8,27,16,6656,8454,6129,-2325
2019,8,27,17,6996,9011,6784,-2227
2019,8,27,18,7296,9386,7282,-2104
2019,8,27,19,7494,9384,7334,-2050
2019,8,27,20,7560,9169,7189,-1980
2019,8,27,21,7466,9087,7021,-2066
2019,8,27,22,7256,8955,6782,-2173
2019,8,27,23,7139,8753,6581,-2172
2019,8,28,0,6795,8532,6289,-2243
2019,8,28,1,6625,8400,6160,-2240
2019,8,28,2,6219,7871,5641,-2230
2019,8,28,3,5623,7176,5238,-1938
2019,8,28,4,5062,6460,4749,-1711
2019,8,28,5,4818,5924,4497,-1427
2019,8,28,6,4501,5551,4204,-1347
2019,8,28,7,4301,5291,3998,-1293
2019,8,28,8,4172,5128,3866,-1262
2019,8,28,9,4158,5122,3856,-1266
2019,8,28,10,4367,5381,4047,-1334
2019,8,28,11,4786,5857,4430,-1427
2019,8,28,12,4965,6072,4722,-1350
2019,8,28,13,5206,6445,5032,-1413
2019,8,28,14,5642,7003,5277,-1726
2019,8,28,15,6214,7614,5651,-1963
2019,8,28,16,6765,8034,5877,-2157
2019,8,28,17,7111,8575,6378,-2197
2019,8,28,18,7455,9074,6886,-2188
2019,8,28,19,7579,9599,7312,-2287
2019,8,28,20,7733,10068,7667,-2401
2019,8,28,21,7776,10346,7871,-2475
2019,8,28,22,7617,10266,7912,-2354
2019,8,28,23,7395,9947,7674,-2273
2019,8,29,0,7039,9425,7217,-2208
2019,8,29,1,6790,9086,6864,-2222
2019,8,29,2,6321,8481,6276,-2205
2019,8,29,3,5734,7675,5698,-1977
2019,8,29,4,5171,6846,5007,-1839
2019,8,29,5,4850,6269,4683,-1586
2019,8,29,6,4540,5810,4329,-1481
2019,8,29,7,4334,5484,4077,-1407
2019,8,29,8,4186,5282,3910,-1372
2019,8,29,9,4184,5218,3869,-1349
2019,8,29,10,4367,5395,3993,-1402
2019,8,29,11,4792,5900,4405,-1495
2019,8,29,12,4996,6163,4754,-1409
2019,8,29,13,5276,6553,5071,-1482
2019,8,29,14,5760,7194,5399,-1795
2019,8,29,15,6374,8028,5917,-2111
2019,8,29,16,7055,8832,6728,-2104
2019,8,29,17,7510,9583,7241,-2342
2019,8,29,18,7898,10171,7610,-2561
2019,8,29,19,8132,10620,7934,-2686
2019,8,29,20,8344,10838,8056,-2782
2019,8,29,21,8413,10948,8085,-2863
2019,8,29,22,8286,10834,7985,-2849
2019,8,29,23,7980,10528,7775,-2753
2019,8,30,0,7613,10004,7605,-2399
2019,8,30,1,7327,9631,7360,-2271
2019,8,30,2,6819,8895,6638,-2257
2019,8,30,3,6156,8023,5979,-2044
2019,8,30,4,5536,7176,5292,-1884
2019,8,30,5,5038,6465,4876,-1589
2019,8,30,6,4675,5955,4467,-1488
2019,8,30,7,4391,5632,4215,-1417
2019,8,30,8,4209,5418,4054,-1364
2019,8,30,9,4144,5386,4020,-1366
2019,8,30,10,4307,5590,4180,-1410
2019,8,30,11,4606,6041,4534,-1507
2019,8,30,12,4782,6286,4877,-1409
2019,8,30,13,5062,6674,5200,-1474
2019,8,30,14,5567,7319,5516,-1803
2019,8,30,15,6064,8088,5947,-2141
2019,8,30,16,6521,8809,6358,-2451
2019,8,30,17,6803,9310,6901,-2409
2019,8,30,18,7088,9649,7370,-2279
2019,8,30,19,7245,9773,7540,-2233
2019,8,30,20,7308,9509,7394,-2115
2019,8,30,21,7227,9079,6999,-2080
2019,8,30,22,6971,8633,6506,-2127
2019,8,30,23,6795,8225,6056,-2169
2019,8,31,0,6386,7902,5652,-2250
2019,8,31,1,6207,7766,5504,-2262
2019,8,31,2,5809,7403,5219,-2184
2019,8,31,3,5358,6918,5010,-1908
2019,8,31,4,4926,6371,4604,-1767
2019,8,31,5,4708,5892,4416,-1476
2019,8,31,6,4408,5469,4097,-1372
2019,8,31,7,4199,5174,3871,-1303
2019,8,31,8,4038,5010,3717,-1293
2019,8,31,9,3968,4939,3649,-1290
2019,8,31,10,3993,4964,3688,-1276
2019,8,31,11,4112,5138,3819,-1319
2019,8,31,12,4258,5377,4073,-1304
2019,8,31,13,4735,6053,4606,-1447
2019,8,31,14,5469,6950,5132,-1818
2019,8,31,15,6030,7724,5546,-2178
2019,8,31,16,6539,8350,5974,-2376
2019,8,31,17,6919,8856,6574,-2282
2019,8,31,18,7159,9265,6925,-2340
2019,8,31,19,7249,9600,7277,-2323
2019,8,31,20,7339,9668,7406,-2262
2019,8,31,21,7279,9600,7364,-2236
2019,8,31,22,7072,9325,7057,-2268
2019,8,31,23,6832,8904,6528,-2376
2019,9,1,0,6513,8433,6090,-2343
2019,9,1,1,6322,8190,5872,-2318
2019,9,1,2,5892,7697,5393,-2304
2019,9,1,3,5379,7107,5100,-2007
2019,9,1,4,4951,6490,4711,-1779
2019,9,1,5,4648,5976,4450,-1526
2019,9,1,6,4309,5571,4149,-1422
2019,9,1,7,4046,5281,3929,-1352
2019,9,1,8,3891,5091,3773,-1318
2019,9,1,9,3799,4998,3700,-1298
2019,9,1,10,3772,4981,3683,-1298
2019,9,1,11,3793,5090,3767,-1323
2019,9,1,12,3926,5257,3965,-1292
2019,9,1,13,4443,5937,4483,-1454
2019,9,1,14,5067,6888,5052,-1836
2019,9,1,15,5700,7731,5519,-2212
2019,9,1,16,6246,8475,6136,-2339
2019,9,1,17,6627,9045,6818,-2227
2019,9,1,18,6972,9393,7117,-2276
2019,9,1,19,7133,9503,7225,-2278
2019,9,1,20,7150,9317,6986,-2331
2019,9,1,21,7114,9068,6702,-2366
2019,9,1,22,6914,8790,6402,-2388
2019,9,1,23,6696,8395,6001,-2394
2019,9,2,0,6293,7965,5565,-2400
2019,9,2,1,6142,7750,5268,-2482
2019,9,2,2,5730,7350,5117,-2233
2019,9,2,3,5276,6804,4985,-1819
2019,9,2,4,4834,6265,4618,-1647
2019,9,2,5,4745,5811,4340,-1471
2019,9,2,6,4399,5448,4079,-1369
2019,9,2,7,4167,5183,3868,-1315
2019,9,2,8,3978,5032,3752,-1280
2019,9,2,9,3913,4963,3688,-1275
2019,9,2,10,3943,5013,3731,-1282
2019,9,2,11,4034,5165,3847,-1318
2019,9,2,12,4141,5346,4036,-1310
2019,9,2,13,4574,5893,4539,-1354
2019,9,2,14,5270,6741,5342,-1399
2019,9,2,15,6004,7614,6241,-1373
2019,9,2,16,6513,8341,6882,-1459
2019,9,2,17,6781,8786,7197,-1589
2019,9,2,18,6969,8961,7225,-1736
2019,9,2,19,7093,8854,6992,-1862
2019,9,2,20,7098,8648,6627,-2021
2019,9,2,21,6956,8621,6562,-2059
2019,9,2,22,6921,8744,6647,-2097
2019,9,2,23,6793,8654,6533,-2121
2019,9,3,0,6521,8251,6293,-1958
2019,9,3,1,6450,8072,6348,-1724
2019,9,3,2,5969,7583,6045,-1538
2019,9,3,3,5461,6966,5486,-1480
2019,9,3,4,4991,6333,4753,-1580
2019,9,3,5,4566,5734,4216,-1518
2019,9,3,6,4263,5318,3976,-1342
2019,9,3,7,4049,5061,3778,-1283
2019,9,3,8,3913,4914,3666,-1248
2019,9,3,9,3908,4891,3644,-1247
2019,9,3,10,4115,5039,3755,-1284
2019,9,3,11,4475,5286,3941,-1345
2019,9,3,12,4672,5486,4165,-1321
2019,9,3,13,4910,5882,4468,-1414
2019,9,3,14,5330,6471,4997,-1474
2019,9,3,15,5816,7200,5727,-1473
2019,9,3,16,6205,7805,6373,-1432
2019,9,3,17,6478,8139,6727,-1412
2019,9,3,18,6759,8446,6990,-1456
2019,9,3,19,6869,8651,7135,-1516
2019,9,3,20,6908,8716,7060,-1656
2019,9,3,21,6876,8778,7328,-1450
2019,9,3,22,6751,8629,7140,-1489
2019,9,3,23,6565,8466,6976,-1490
2019,9,4,0,6276,8137,6732,-1405
2019,9,4,1,6142,7883,6595,-1288
2019,9,4,2,5693,7313,6170,-1143
2019,9,4,3,5171,6658,5721,-937
2019,9,4,4,4676,6052,5078,-974
2019,9,4,5,4556,5560,4477,-1083
2019,9,4,6,4241,5213,4065,-1148
2019,9,4,7,4014,4999,3823,-1176
2019,9,4,8,3886,4867,3674,-1193
2019,9,4,9,3873,4894,3707,-1187
2019,9,4,10,4054,5086,3925,-1161
2019,9,4,11,4397,5439,4310,-1129
2019,9,4,12,4564,5675,4591,-1084
2019,9,4,13,4799,5913,4803,-1110
2019,9,4,14,5164,6368,5065,-1303
2019,9,4,15,5593,6916,5461,-1455
2019,9,4,16,5959,7342,5540,-1802
2019,9,4,17,6334,7828,5823,-2005
2019,9,4,18,6706,8413,6317,-2096
2019,9,4,19,6961,8877,6901,-1976
2019,9,4,20,7135,9128,7302,-1826
2019,9,4,21,7193,9238,7432,-1806
2019,9,4,22,7045,9270,7402,-1868
2019,9,4,23,6815,9096,7254,-1842
2019,9,5,0,6515,8807,7051,-1756
2019,9,5,1,6371,8633,6802,-1831
2019,9,5,2,5918,8133,6441,-1692
2019,9,5,3,5385,7466,5953,-1513
2019,9,5,4,4887,6792,5518,-1274
2019,9,5,5,4587,6261,5063,-1198
2019,9,5,6,4287,5926,4713,-1213
2019,9,5,7,4106,5720,4467,-1253
2019,9,5,8,3996,5609,4345,-1264
2019,9,5,9,4006,5629,4353,-1276
2019,9,5,10,4195,5885,4630,-1255
2019,9,5,11,4628,6383,5183,-1200
2019,9,5,12,4866,6660,5508,-1152
2019,9,5,13,5266,6985,5880,-1105
2019,9,5,14,5846,7639,6262,-1377
2019,9,5,15,6566,8365,6771,-1594
2019,9,5,16,7171,9120,7338,-1782
2019,9,5,17,7759,9819,7878,-1941
2019,9,5,18,8167,10400,8290,-2110
2019,9,5,19,8489,10769,8660,-2109
2019,9,5,20,8645,10974,8890,-2084
2019,9,5,21,8776,11000,9008,-1992
2019,9,5,22,8612,10830,8871,-1959
2019,9,5,23,8191,10388,8350,-2038
2019,9,6,0,7806,9888,7874,-2014
2019,9,6,1,7502,9574,7529,-2045
2019,9,6,2,6960,8878,7003,-1875
2019,9,6,3,6324,8045,6415,-1630
2019,9,6,4,5706,7316,5920,-1396
2019,9,6,5,5332,6727,5503,-1224
2019,9,6,6,4916,6298,5051,-1247
2019,9,6,7,4604,6017,4746,-1271
2019,9,6,8,4391,5818,4522,-1296
2019,9,6,9,4329,5805,4495,-1310
2019,9,6,10,4447,6054,4717,-1337
2019,9,6,11,4725,6532,5202,-1330
2019,9,6,12,4910,6758,5492,-1266
2019,9,6,13,5274,7038,5734,-1304
2019,9,6,14,5839,7722,6221,-1501
2019,9,6,15,6434,8490,6718,-1772
2019,9,6,16,6991,9286,7312,-1974
2019,9,6,17,7635,9934,7884,-2050
2019,9,6,18,8094,10440,8388,-2052
2019,9,6,19,8412,10745,8692,-2053
2019,9,6,20,8564,10909,8867,-2042
2019,9,6,21,8585,10895,8897,-1998
2019,9,6,22,8369,10707,8681,-2026
2019,9,6,23,7960,10167,8151,-2016
2019,9,7,0,7522,9424,7421,-2003
2019,9,7,1,7175,8917,6929,-1988
2019,9,7,2,6709,8222,6418,-1804
2019,9,7,3,6150,7405,5939,-1466
2019,9,7,4,5586,6640,5444,-1196
2019,9,7,5,4947,5985,4902,-1083
2019,9,7,6,4530,5421,4197,-1224
2019,9,7,7,4220,5025,3826,-1199
2019,9,7,8,4002,4746,3618,-1128
2019,9,7,9,3880,4609,3548,-1061
2019,9,7,10,3829,4569,3441,-1128
2019,9,7,11,3861,4667,3508,-1159
2019,9,7,12,3959,4788,3654,-1134
2019,9,7,13,4406,5418,4256,-1162
2019,9,7,14,5107,6248,4797,-1451
2019,9,7,15,5868,7101,5372,-1729
2019,9,7,16,6697,7983,6079,-1904
2019,9,7,17,7290,8820,6809,-2011
2019,9,7,18,7786,9495,7496,-1999
2019,9,7,19,8160,9984,7871,-2113
2019,9,7,20,8367,10310,8125,-2185
2019,9,7,21,8414,10480,8286,-2194
2019,9,7,22,8280,10445,8257,-2188
2019,9,7,23,8061,10098,7998,-2100
2019,9,8,0,7538,9397,7301,-2096
2019,9,8,1,7202,8833,6739,-2094
2019,9,8,2,6684,8102,6109,-1993
2019,9,8,3,6102,7315,5526,-1789
2019,9,8,4,5562,6642,4923,-1719
2019,9,8,5,4939,6058,4574,-1484
2019,9,8,6,4510,5555,4194,-1361
2019,9,8,7,4189,5189,3902,-1287
2019,9,8,8,3954,4942,3698,-1244
2019,9,8,9,3837,4805,3648,-1157
2019,9,8,10,3816,4743,3545,-1198
2019,9,8,11,3800,4796,3577,-1219
2019,9,8,12,3926,4922,3732,-1190
2019,9,8,13,4488,5550,4225,-1325
2019,9,8,14,5290,6496,4764,-1732
2019,9,8,15,6086,7490,5373,-2117
2019,9,8,16,6642,8434,6135,-2299
2019,9,8,17,7226,9289,7006,-2283
2019,9,8,18,7655,9910,7732,-2178
2019,9,8,19,7964,10344,8132,-2212
2019,9,8,20,8175,10655,8430,-2225
2019,9,8,21,8275,10842,8592,-2250
2019,9,8,22,8194,10769,8548,-2221
2019,9,8,23,8012,10420,8274,-2146
2019,9,9,0,7706,9840,7758,-2082
2019,9,9,1,7314,9375,7099,-2276
2019,9,9,2,6761,8563,6431,-2132
2019,9,9,3,6096,7675,5695,-1980
2019,9,9,4,5460,6866,5058,-1808
2019,9,9,5,4821,6233,4714,-1519
2019,9,9,6,4426,5749,4349,-1400
2019,9,9,7,4157,5455,4137,-1318
2019,9,9,8,3974,5257,3987,-1270
2019,9,9,9,3934,5231,3983,-1248
2019,9,9,10,4121,5471,4161,-1310
2019,9,9,11,4446,5922,4517,-1405
2019,9,9,12,4656,6127,4789,-1338
2019,9,9,13,4997,6507,5107,-1400
2019,9,9,14,5550,7241,5484,-1757
2019,9,9,15,6203,8141,6026,-2115
2019,9,9,16,6844,9112,6918,-2194
2019,9,9,17,7315,9913,7645,-2268
2019,9,9,18,7753,10485,8120,-2365
2019,9,9,19,8049,10868,8583,-2285
2019,9,9,20,8196,11142,8854,-2288
2019,9,9,21,8239,11283,8990,-2293
2019,9,9,22,8133,11087,8799,-2288
2019,9,9,23,7816,10634,8382,-2252
2019,9,10,0,7517,10063,7637,-2426
2019,9,10,1,7204,9647,7022,-2625
2019,9,10,2,6649,8808,6374,-2434
2019,9,10,3,6000,7938,5812,-2126
2019,9,10,4,5399,7081,5256,-1825
2019,9,10,5,4996,6422,4890,-1532
2019,9,10,6,4589,5950,4524,-1426
2019,9,10,7,4306,5589,4252,-1337
2019,9,10,8,4133,5321,4026,-1295
2019,9,10,9,4083,5267,3980,-1287
2019,9,10,10,4239,5457,4126,-1331
2019,9,10,11,4547,5898,4494,-1404
2019,9,10,12,4730,6099,4794,-1305
2019,9,10,13,4976,6447,5057,-1390
2019,9,10,14,5434,7136,5403,-1733
2019,9,10,15,6033,7912,5887,-2025
2019,9,10,16,6546,8698,6558,-2140
2019,9,10,17,6991,9417,7320,-2097
2019,9,10,18,7419,9984,7872,-2112
2019,9,10,19,7680,10435,8294,-2141
2019,9,10,20,7772,10705,8495,-2210
2019,9,10,21,7805,10834,8625,-2209
2019,9,10,22,7674,10679,8563,-2116
2019,9,10,23,7362,10276,8200,-2076
2019,9,11,0,7081,9715,7767,-1948
2019,9,11,1,6816,9338,7402,-1936
2019,9,11,2,6307,8605,6860,-1745
2019,9,11,3,5705,7721,6196,-1525
2019,9,11,4,5140,6879,5453,-1426
2019,9,11,5,4761,6150,4812,-1338
2019,9,11,6,4396,5673,4287,-1386
2019,9,11,7,4139,5303,3984,-1319
2019,9,11,8,3991,5110,3830,-1280
2019,9,11,9,3950,5083,3806,-1277
2019,9,11,10,4123,5308,3989,-1319
2019,9,11,11,4454,5785,4420,-1365
2019,9,11,12,4624,5998,4876,-1122
2019,9,11,13,4848,6290,5148,-1142
2019,9,11,14,5243,6915,5569,-1346
2019,9,11,15,5835,7712,6146,-1566
2019,9,11,16,6413,8456,6657,-1799
2019,9,11,17,6858,9123,7281,-1842
2019,9,11,18,7251,9644,7687,-1957
2019,9,11,19,7512,10036,7944,-2092
2019,9,11,20,7648,10310,7992,-2318
2019,9,11,21,7637,10447,8149,-2298
2019,9,11,22,7444,10339,7968,-2371
2019,9,11,23,7202,9952,7501,-2451
2019,9,12,0,6877,9391,6944,-2447
2019,9,12,1,6644,9019,6487,-2532
2019,9,12,2,6139,8295,5941,-2354
2019,9,12,3,5555,7418,5432,-1986
2019,9,12,4,4989,6629,4857,-1772
2019,9,12,5,4693,6086,4606,-1480
2019,9,12,6,4332,5628,4242,-1386
2019,9,12,7,4075,5327,4004,-1323
2019,9,12,8,3925,5172,3882,-1290
2019,9,12,9,3906,5135,3861,-1274
2019,9,12,10,4072,5355,4032,-1323
2019,9,12,11,4440,5841,4420,-1421
2019,9,12,12,4621,6057,4714,-1343
2019,9,12,13,4845,6377,4981,-1396
2019,9,12,14,5315,7018,5290,-1728
2019,9,12,15,5907,7772,5756,-2016
2019,9,12,16,6422,8484,6165,-2319
2019,9,12,17,6885,9174,6905,-2269
2019,9,12,18,7261,9666,7655,-2011
2019,9,12,19,7515,9988,7858,-2130
2019,9,12,20,7642,10047,7949,-2098
2019,9,12,21,7638,10148,8025,-2123
2019,9,12,22,7463,10033,7908,-2125
2019,9,12,23,7207,9634,7499,-2135
2019,9,13,0,6876,9162,6885,-2277
2019,9,13,1,6648,8874,6580,-2294
2019,9,13,2,6144,8223,5968,-2255
2019,9,13,3,5550,7472,5437,-2035
2019,9,13,4,5044,6760,4954,-1806
2019,9,13,5,4821,6183,4618,-1565
2019,9,13,6,4457,5771,4278,-1493
2019,9,13,7,4190,5485,4058,-1427
2019,9,13,8,4033,5317,3931,-1386
2019,9,13,9,3989,5284,3900,-1384
2019,9,13,10,4146,5519,4085,-1434
2019,9,13,11,4473,5981,4473,-1508
2019,9,13,12,4664,6206,4811,-1395
2019,9,13,13,4912,6437,5016,-1421
2019,9,13,14,5392,6983,5215,-1768
2019,9,13,15,5904,7742,5671,-2071
2019,9,13,16,6404,8353,6088,-2265
2019,9,13,17,6826,8869,6607,-2262
2019,9,13,18,7169,9250,6997,-2253
2019,9,13,19,7411,9352,7111,-2241
2019,9,13,20,7513,9351,7081,-2270
2019,9,13,21,7514,9354,7092,-2262
2019,9,13,22,7291,9168,6963,-2205
2019,9,13,23,6963,8743,6535,-2208
2019,9,14,0,6572,8323,6034,-2289
2019,9,14,1,6340,8107,5826,-2281
2019,9,14,2,5890,7640,5476,-2164
2019,9,14,3,5386,7052,5090,-1962
2019,9,14,4,4919,6419,4654,-1765
2019,9,14,5,4540,5889,4411,-1478
2019,9,14,6,4217,5479,4100,-1379
2019,9,14,7,3987,5171,3868,-1303
2019,9,14,8,3865,4980,3716,-1264
2019,9,14,9,3811,4912,3661,-1251
2019,9,14,10,3823,4953,3680,-1273
2019,9,14,11,3908,5121,3847,-1274
2019,9,14,12,4053,5325,4086,-1239
2019,9,14,13,4403,5956,4585,-1371
2019,9,14,14,4992,6768,4959,-1809
2019,9,14,15,5488,7607,5573,-2034
2019,9,14,16,5982,8193,5974,-2219
2019,9,14,17,6367,8686,6488,-2198
2019,9,14,18,6571,9077,6877,-2200
2019,9,14,19,6665,9195,7093,-2102
2019,9,14,20,6692,9394,7211,-2183
2019,9,14,21,6682,9338,7181,-2157
2019,9,14,22,6588,9088,6872,-2216
2019,9,14,23,6302,8616,6420,-2196
2019,9,15,0,6035,8186,5942,-2244
2019,9,15,1,5830,7938,5728,-2210
2019,9,15,2,5428,7474,5354,-2120
2019,9,15,3,5017,6923,4996,-1927
2019,9,15,4,4655,6379,4606,-1773
2019,9,15,5,4624,5862,4360,-1502
2019,9,15,6,4310,5477,4097,-1380
2019,9,15,7,4095,5200,3901,-1299
2019,9,15,8,3974,5023,3733,-1290
2019,9,15,9,3907,4931,3666,-1265
2019,9,15,10,3917,4933,3682,-1251
2019,9,15,11,3939,5048,3789,-1259
2019,9,15,12,4059,5236,4023,-1213
2019,9,15,13,4515,5798,4426,-1372
2019,9,15,14,5206,6577,4812,-1765
2019,9,15,15,5855,7341,5320,-2021
2019,9,15,16,6395,8057,5742,-2315
2019,9,15,17,6948,8748,6426,-2322
2019,9,15,18,7342,9199,6973,-2226
2019,9,15,19,7568,9443,7214,-2229
2019,9,15,20,7671,9510,7262,-2248
2019,9,15,21,7651,9480,7301,-2179
2019,9,15,22,7546,9218,7051,-2167
2019,9,15,23,7172,8736,6525,-2211
2019,9,16,0,6874,8389,6157,-2232
2019,9,16,1,6633,8127,5952,-2175
2019,9,16,2,6131,7592,5421,-2171
2019,9,16,3,5595,6887,5009,-1878
2019,9,16,4,5111,6205,4521,-1684
2019,9,16,5,4787,5684,4228,-1456
2019,9,16,6,4452,5311,3942,-1369
2019,9,16,7,4221,5054,3720,-1334
2019,9,16,8,4083,4906,3574,-1332
2019,9,16,9,4051,4946,3655,-1291
2019,9,16,10,4229,5234,3915,-1319
2019,9,16,11,4594,5746,4314,-1432
2019,9,16,12,4793,5980,4642,-1338
2019,9,16,13,5056,6269,4869,-1400
2019,9,16,14,5638,6871,5136,-1735
2019,9,16,15,6267,7611,5565,-2046
2019,9,16,16,6867,8411,6126,-2285
2019,9,16,17,7416,9178,6947,-2231
2019,9,16,18,7888,9715,7535,-2180
2019,9,16,19,8205,10120,7863,-2257
2019,9,16,20,8376,10444,8131,-2313
2019,9,16,21,8425,10638,8337,-2301
2019,9,16,22,8201,10524,8303,-2221
2019,9,16,23,7939,10112,7854,-2258
2019,9,17,0,7560,9571,7345,-2226
2019,9,17,1,7236,9138,6998,-2140
2019,9,17,2,6649,8315,6197,-2118
2019,9,17,3,6020,7417,5528,-1889
2019,9,17,4,5423,6523,4738,-1785
2019,9,17,5,4890,5838,4351,-1487
2019,9,17,6,4542,5355,3992,-1363
2019,9,17,7,4299,5054,3784,-1270
2019,9,17,8,4111,4857,3649,-1208
2019,9,17,9,4078,4823,3602,-1221
2019,9,17,10,4249,5061,3770,-1291
2019,9,17,11,4636,5544,4175,-1369
2019,9,17,12,4836,5750,4448,-1302
2019,9,17,13,5095,6055,4716,-1339
2019,9,17,14,5673,6721,5015,-1706
2019,9,17,15,6193,7574,5497,-2077
2019,9,17,16,6826,8423,6415,-2008
2019,9,17,17,7397,9207,7203,-2004
2019,9,17,18,7842,9854,7723,-2131
2019,9,17,19,8140,10291,8190,-2101
2019,9,17,20,8356,10598,8549,-2049
2019,9,17,21,8437,10783,8826,-1957
2019,9,17,22,8220,10687,8696,-1991
2019,9,17,23,7949,10234,8403,-1831
2019,9,18,0,7656,9631,7543,-2088
2019,9,18,1,7303,9109,7020,-2089
2019,9,18,2,6703,8254,6195,-2059
2019,9,18,3,6033,7344,5406,-1938
2019,9,18,4,5413,6483,4760,-1723
2019,9,18,5,4787,5858,4416,-1442
2019,9,18,6,4422,5349,4007,-1342
2019,9,18,7,4169,5040,3762,-1278
2019,9,18,8,4015,4828,3577,-1251
2019,9,18,9,3976,4792,3550,-1242
2019,9,18,10,4176,5035,3742,-1293
2019,9,18,11,4534,5513,4143,-1370
2019,9,18,12,4717,5750,4446,-1304
2019,9,18,13,5010,5966,4625,-1341
2019,9,18,14,5482,6510,4837,-1673
2019,9,18,15,6107,7245,5212,-2033
2019,9,18,16,6756,8017,5874,-2143
2019,9,18,17,7194,8827,6573,-2254
2019,9,18,18,7671,9518,7406,-2112
2019,9,18,19,7966,9935,7827,-2108
2019,9,18,20,8149,10052,7901,-2151
2019,9,18,21,8160,9832,7770,-2062
2019,9,18,22,7913,9528,7447,-2081
2019,9,18,23,7578,9154,7125,-2029
2019,9,19,0,7305,8726,6735,-1991
2019,9,19,1,6972,8133,6118,-2015
2019,9,19,2,6403,7484,5485,-1999
2019,9,19,3,5747,6757,4938,-1819
2019,9,19,4,5121,6024,4387,-1637
2019,9,19,5,4495,5723,4320,-1403
2019,9,19,6,4118,5328,4021,-1307
2019,9,19,7,3856,5053,3826,-1227
2019,9,19,8,3704,4839,3666,-1173
2019,9,19,9,3672,4792,3609,-1183
2019,9,19,10,3830,4975,3694,-1281
2019,9,19,11,4170,5433,4058,-1375
2019,9,19,12,4360,5647,4349,-1298
2019,9,19,13,4544,5828,4534,-1294
2019,9,19,14,4859,6235,4790,-1445
2019,9,19,15,5353,6769,5153,-1616
2019,9,19,16,5804,7335,5713,-1622
2019,9,19,17,6073,7841,6295,-1546
2019,9,19,18,6368,8191,6723,-1468
2019,9,19,19,6547,8437,6971,-1466
2019,9,19,20,6661,8670,7220,-1450
2019,9,19,21,6645,8796,7287,-1509
2019,9,19,22,6501,8635,7175,-1460
2019,9,19,23,6192,8236,6780,-1456
2019,9,20,0,5998,7860,6370,-1490
2019,9,20,1,5808,7633,6049,-1584
2019,9,20,2,5361,7040,5458,-1582
2019,9,20,3,4863,6338,4918,-1420
2019,9,20,4,4376,5604,4191,-1413
2019,9,20,5,4000,5125,3815,-1310
2019,9,20,6,3676,4734,3525,-1209
2019,9,20,7,3472,4496,3345,-1151
2019,9,20,8,3354,4343,3213,-1130
2019,9,20,9,3356,4347,3224,-1123
2019,9,20,10,3547,4601,3407,-1194
2019,9,20,11,3934,5116,3830,-1286
2019,9,20,12,4160,5393,4202,-1191
2019,9,20,13,4376,5631,4407,-1224
2019,9,20,14,4695,6092,4559,-1533
2019,9,20,15,5173,6556,4839,-1717
2019,9,20,16,5607,7018,5024,-1994
2019,9,20,17,6011,7414,5395,-2019
2019,9,20,18,6397,7747,5700,-2047
2019,9,20,19,6638,8001,5975,-2026
2019,9,20,20,6830,8219,6217,-2002
2019,9,20,21,6865,8368,6374,-1994
2019,9,20,22,6706,8299,6283,-2016
2019,9,20,23,6341,7936,5961,-1975
2019,9,21,0,6097,7494,5379,-2115
2019,9,21,1,5845,7237,5165,-2072
2019,9,21,2,5422,6742,4733,-2009
2019,9,21,3,5000,6141,4445,-1696
2019,9,21,4,4548,5566,4032,-1534
2019,9,21,5,4029,5089,3829,-1260
2019,9,21,6,3714,4680,3531,-1149
2019,9,21,7,3505,4417,3327,-1090
2019,9,21,8,3378,4255,3210,-1045
2019,9,21,9,3313,4173,3132,-1041
2019,9,21,10,3325,4223,3178,-1045
2019,9,21,11,3458,4360,3278,-1082
2019,9,21,12,3606,4511,3449,-1062
2019,9,21,13,3987,5040,3856,-1184
2019,9,21,14,4447,5729,4219,-1510
2019,9,21,15,4990,6443,4589,-1854
2019,9,21,16,5428,7060,4904,-2156
2019,9,21,17,5877,7608,5467,-2141
2019,9,21,18,6197,8011,5835,-2176
2019,9,21,19,6439,8316,6197,-2119
2019,9,21,20,6586,8505,6437,-2068
2019,9,21,21,6637,8537,6454,-2083
2019,9,21,22,6552,8435,6346,-2089
2019,9,21,23,6248,7979,5844,-2135
2019,9,22,0,5928,7561,5373,-2188
2019,9,22,1,5653,7312,5176,-2136
2019,9,22,2,5182,6792,4761,-2031
2019,9,22,3,4738,6224,4514,-1710
2019,9,22,4,4310,5635,4129,-1506
2019,9,22,5,3893,5123,3859,-1264
2019,9,22,6,3605,4695,3554,-1141
2019,9,22,7,3385,4438,3353,-1085
2019,9,22,8,3227,4272,3220,-1052
2019,9,22,9,3168,4164,3148,-1016
2019,9,22,10,3166,4157,3124,-1033
2019,9,22,11,3229,4239,3190,-1049
2019,9,22,12,3378,4393,3362,-1031
2019,9,22,13,3759,4939,3782,-1157
2019,9,22,14,4262,5677,4145,-1532
2019,9,22,15,4800,6401,4542,-1859
2019,9,22,16,5324,7015,4828,-2187
2019,9,22,17,5850,7638,5352,-2286
2019,9,22,18,6263,8162,5839,-2323
2019,9,22,19,6588,8548,6272,-2276
2019,9,22,20,6805,8854,6579,-2275
2019,9,22,21,6908,8999,6711,-2288
2019,9,22,22,6840,8958,6724,-2234
2019,9,22,23,6523,8555,6308,-2247
2019,9,23,0,6204,8053,5789,-2264
2019,9,23,1,5895,7697,5476,-2221
2019,9,23,2,5345,6976,4929,-2047
2019,9,23,3,4807,6206,4478,-1728
2019,9,23,4,4287,5450,3992,-1458
2019,9,23,5,3873,4902,3719,-1183
2019,9,23,6,3558,4503,3409,-1094
2019,9,23,7,3364,4249,3218,-1031
2019,9,23,8,3251,4106,3099,-1007
2019,9,23,9,3248,4094,3096,-998
2019,9,23,10,3475,4375,3298,-1077
2019,9,23,11,3888,4855,3709,-1146
2019,9,23,12,4124,5080,3968,-1112
2019,9,23,13,4337,5332,4155,-1177
2019,9,23,14,4661,5763,4272,-1491
2019,9,23,15,5195,6341,4583,-1758
2019,9,23,16,5661,6929,4933,-1996
2019,9,23,17,6160,7549,5507,-2042
2019,9,23,18,6557,8099,6058,-2041
2019,9,23,19,6855,8515,6539,-1976
2019,9,23,20,7040,8866,6844,-2022
2019,9,23,21,7111,9103,7070,-2033
2019,9,23,22,6995,9052,7060,-1992
2019,9,23,23,6689,8741,6766,-1975
2019,9,24,0,6441,8262,6349,-1913
2019,9,24,1,6082,7864,5862,-2002
2019,9,24,2,5507,7069,5156,-1913
2019,9,24,3,4928,6285,4558,-1727
2019,9,24,4,4401,5522,4026,-1496
2019,9,24,5,3917,5059,3855,-1204
2019,9,24,6,3595,4612,3501,-1111
2019,9,24,7,3392,4335,3277,-1058
2019,9,24,8,3267,4147,3134,-1013
2019,9,24,9,3251,4095,3093,-1002
2019,9,24,10,3458,4340,3269,-1071
2019,9,24,11,3859,4776,3628,-1148
2019,9,24,12,4081,5011,3867,-1144
2019,9,24,13,4260,5241,4049,-1192
2019,9,24,14,4553,5723,4267,-1456
2019,9,24,15,5038,6325,4544,-1781
2019,9,24,16,5505,7020,4986,-2034
2019,9,24,17,5945,7768,5515,-2253
2019,9,24,18,6367,8380,6132,-2248
2019,9,24,19,6633,8896,6692,-2204
2019,9,24,20,6865,9384,7228,-2156
2019,9,24,21,7005,9690,7554,-2136
2019,9,24,22,6926,9689,7563,-2126
2019,9,24,23,6719,9290,7159,-2131
2019,9,25,0,6454,8734,6691,-2043
2019,9,25,1,6167,8227,6178,-2049
2019,9,25,2,5647,7458,5473,-1985
2019,9,25,3,5085,6552,4627,-1925
2019,9,25,4,4530,5742,4152,-1590
2019,9,25,5,4098,5156,3843,-1313
2019,9,25,6,3767,4737,3498,-1239
2019,9,25,7,3547,4465,3303,-1162
2019,9,25,8,3425,4297,3164,-1133
2019,9,25,9,3408,4307,3162,-1145
2019,9,25,10,3610,4578,3380,-1198
2019,9,25,11,4010,5063,3771,-1292
2019,9,25,12,4234,5276,4052,-1224
2019,9,25,13,4461,5513,4271,-1242
2019,9,25,14,4878,6045,4485,-1560
2019,9,25,15,5485,6754,4858,-1896
2019,9,25,16,5975,7505,5300,-2205
2019,9,25,17,6509,8301,6062,-2239
2019,9,25,18,6973,8998,6838,-2160
2019,9,25,19,7300,9524,7321,-2203
2019,9,25,20,7562,9935,7697,-2238
2019,9,25,21,7687,10192,7982,-2210
2019,9,25,22,7590,10142,7993,-2149
2019,9,25,23,7395,9769,7692,-2077
2019,9,26,0,7133,9240,7159,-2081
2019,9,26,1,6811,8748,6709,-2039
2019,9,26,2,6186,7961,5872,-2089
2019,9,26,3,5534,7120,5194,-1926
2019,9,26,4,4908,6287,4552,-1735
2019,9,26,5,4412,5631,4249,-1382
2019,9,26,6,4063,5181,3895,-1286
2019,9,26,7,3824,4815,3616,-1199
2019,9,26,8,3678,4633,3476,-1157
2019,9,26,9,3654,4609,3465,-1144
2019,9,26,10,3832,4866,3641,-1225
2019,9,26,11,4205,5346,4029,-1317
2019,9,26,12,4422,5584,4323,-1261
2019,9,26,13,4651,5823,4511,-1312
2019,9,26,14,5081,6312,4692,-1620
2019,9,26,15,5708,6951,4995,-1956
2019,9,26,16,6208,7749,5558,-2191
2019,9,26,17,6746,8512,6258,-2254
2019,9,26,18,7211,9169,6948,-2221
2019,9,26,19,7515,9653,7339,-2314
2019,9,26,20,7749,10006,7670,-2336
2019,9,26,21,7832,10218,7884,-2334
2019,9,26,22,7702,10161,7885,-2276
2019,9,26,23,7433,9729,7255,-2474
2019,9,27,0,7071,9277,6756,-2521
2019,9,27,1,6777,8820,6300,-2520
2019,9,27,2,6182,8101,5781,-2320
2019,9,27,3,5545,7249,5267,-1982
2019,9,27,4,4950,6439,4726,-1713
2019,9,27,5,4485,5855,4401,-1454
2019,9,27,6,4136,5386,4059,-1327
2019,9,27,7,3896,5077,3818,-1259
2019,9,27,8,3742,4861,3639,-1222
2019,9,27,9,3721,4820,3596,-1224
2019,9,27,10,3892,5033,3765,-1268
2019,9,27,11,4243,5445,4090,-1355
2019,9,27,12,4446,5656,4341,-1315
2019,9,27,13,4665,5874,4535,-1339
2019,9,27,14,5099,6441,4768,-1673
2019,9,27,15,5631,7170,5140,-2030
2019,9,27,16,6250,7912,5739,-2173
2019,9,27,17,6637,8643,6459,-2184
2019,9,27,18,7076,9263,7157,-2106
2019,9,27,19,7313,9698,7573,-2125
2019,9,27,20,7510,10002,7850,-2152
2019,9,27,21,7554,10114,7988,-2126
2019,9,27,22,7311,9960,7780,-2180
2019,9,27,23,6892,9431,7321,-2110
2019,9,28,0,6625,8819,6699,-2120
2019,9,28,1,6336,8325,6118,-2207
2019,9,28,2,5851,7699,5529,-2170
2019,9,28,3,5337,7027,5014,-2013
2019,9,28,4,4836,6402,4646,-1756
2019,9,28,5,4442,5843,4428,-1415
2019,9,28,6,4092,5336,4048,-1288
2019,9,28,7,3838,5029,3823,-1206
2019,9,28,8,3697,4796,3624,-1172
2019,9,28,9,3628,4707,3553,-1154
2019,9,28,10,3643,4713,3573,-1140
2019,9,28,11,3715,4838,3668,-1170
2019,9,28,12,3861,5020,3865,-1155
2019,9,28,13,4243,5611,4346,-1265
2019,9,28,14,4847,6439,4781,-1658
2019,9,28,15,5440,7233,5223,-2010
2019,9,28,16,6011,8017,5791,-2226
2019,9,28,17,6412,8676,6394,-2282
2019,9,28,18,6823,9177,6989,-2188
2019,9,28,19,7106,9516,7408,-2108
2019,9,28,20,7318,9689,7538,-2151
2019,9,28,21,7344,9702,7540,-2162
2019,9,28,22,7229,9529,7399,-2130
2019,9,28,23,6834,9022,6928,-2094
2019,9,29,0,6534,8575,6447,-2128
2019,9,29,1,6238,8179,5882,-2297
2019,9,29,2,5737,7607,5425,-2182
2019,9,29,3,5227,6956,5081,-1875
2019,9,29,4,4752,6309,4650,-1659
2019,9,29,5,4508,5744,4361,-1383
2019,9,29,6,4133,5250,3986,-1264
2019,9,29,7,3897,4932,3732,-1200
2019,9,29,8,3709,4682,3545,-1137
2019,9,29,9,3631,4577,3464,-1113
2019,9,29,10,3612,4531,3423,-1108
2019,9,29,11,3659,4643,3514,-1129
2019,9,29,12,3789,4784,3681,-1103
2019,9,29,13,4188,5378,4140,-1238
2019,9,29,14,4805,6164,4563,-1601
2019,9,29,15,5418,8400,6417,-1983
2019,9,29,16,6082,7715,5561,-2154
2019,9,29,17,6559,8366,6126,-2240
2019,9,29,18,7008,8920,6753,-2167
2019,9,29,19,7290,9358,7276,-2082
2019,9,29,20,7472,9678,7411,-2267
2019,9,29,21,7497,9836,7494,-2342
2019,9,29,22,7422,9783,7455,-2328
2019,9,29,23,7027,9390,7217,-2173
2019,9,30,0,6808,8992,6790,-2202
2019,9,30,1,6513,8594,6236,-2358
2019,9,30,2,5968,7909,5689,-2220
2019,9,30,3,5393,7100,5210,-1890
2019,9,30,4,4854,6324,4667,-1657
2019,9,30,5,4430,5744,4377,-1367
2019,9,30,6,4102,5288,4002,-1286
2019,9,30,7,3904,4997,3778,-1219
2019,9,30,8,3764,4838,3656,-1182
2019,9,30,9,3769,4827,3648,-1179
2019,9,30,10,3966,5069,3838,-1231
2019,9,30,11,4345,5565,4230,-1335
2019,9,30,12,4576,5798,4502,-1296
2019,9,30,13,4817,6095,4748,-1347
2019,9,30,14,5223,6706,5036,-1670
2019,9,30,15,5793,7447,5590,-1857
2019,9,30,16,6328,8175,6325,-1850
2019,9,30,17,6780,8860,6998,-1862
2019,9,30,18,7194,9387,7528,-1859
2019,9,30,19,7470,9819,7843,-1976
2019,9,30,20,7619,10111,8060,-2051
2019,9,30,21,7679,10156,8192,-1964
2019,9,30,22,7536,10045,8122,-1923
2019,9,30,23,7221,9605,7724,-1881
2019,10,1,0,6966,9157,7235,-1922
2019,10,1,1,6653,8718,6788,-1930
2019,10,1,2,6083,7945,5983,-1962
2019,10,1,3,5475,7141,5296,-1845
2019,10,1,4,4899,6374,4677,-1697
2019,10,1,5,4443,5778,4380,-1398
2019,10,1,6,4120,5394,4069,-1325
2019,10,1,7,3893,5130,3858,-1272
2019,10,1,8,3760,4957,3722,-1235
2019,10,1,9,3747,4938,3693,-1245
2019,10,1,10,3931,5195,3887,-1308
2019,10,1,11,4323,5677,4281,-1396
2019,10,1,12,4516,5904,4552,-1352
2019,10,1,13,4703,6115,4749,-1366
2019,10,1,14,5152,6659,4964,-1695
2019,10,1,15,5704,7330,5384,-1946
2019,10,1,16,6188,7897,6057,-1840
2019,10,1,17,6586,8320,6632,-1688
2019,10,1,18,6944,8794,7111,-1683
2019,10,1,19,7194,9047,7402,-1645
2019,10,1,20,7291,9266,7442,-1824
2019,10,1,21,7366,9452,7650,-1802
2019,10,1,22,7232,9364,7557,-1807
2019,10,1,23,6943,8965,7231,-1734
2019,10,2,0,6691,8608,6937,-1671
2019,10,2,1,6436,8256,6516,-1740
2019,10,2,2,5919,7605,5886,-1719
2019,10,2,3,5339,6816,5105,-1711
2019,10,2,4,4778,6050,4437,-1613
2019,10,2,5,4433,5498,4157,-1341
2019,10,2,6,4107,5070,3807,-1263
2019,10,2,7,3907,4819,3602,-1217
2019,10,2,8,3773,4635,3467,-1168
2019,10,2,9,3773,4647,3471,-1176
2019,10,2,10,3946,4902,3662,-1240
2019,10,2,11,4312,5400,4053,-1347
2019,10,2,12,4519,5639,4344,-1295
2019,10,2,13,4715,5881,4524,-1357
2019,10,2,14,5202,6444,4792,-1652
2019,10,2,15,5749,7141,5278,-1863
2019,10,2,16,6272,7792,6044,-1748
2019,10,2,17,6664,8438,6722,-1716
2019,10,2,18,7108,8985,7192,-1793
2019,10,2,19,7391,9407,7473,-1934
2019,10,2,20,7562,9681,7682,-1999
2019,10,2,21,7635,9865,7821,-2044
2019,10,2,22,7479,9680,7643,-2037
2019,10,2,23,7020,9310,7380,-1930
2019,10,3,0,6850,8977,7139,-1838
2019,10,3,1,6501,8496,6693,-1803
2019,10,3,2,5981,7767,6147,-1620
2019,10,3,3,5407,6927,5530,-1397
2019,10,3,4,4850,6135,4908,-1227
2019,10,3,5,4498,5544,4375,-1169
2019,10,3,6,4147,5083,3847,-1236
2019,10,3,7,3884,4785,3523,-1262
2019,10,3,8,3749,4604,3388,-1216
2019,10,3,9,3740,4575,3338,-1237
2019,10,3,10,3924,4802,3530,-1272
2019,10,3,11,4325,5292,3919,-1373
2019,10,3,12,4537,5510,4137,-1373
2019,10,3,13,4763,5751,4371,-1380
2019,10,3,14,5206,6308,4746,-1562
2019,10,3,15,5838,6995,5263,-1732
2019,10,3,16,6428,7681,5704,-1977
2019,10,3,17,6918,8329,6215,-2114
2019,10,3,18,7351,8900,6557,-2343
2019,10,3,19,7653,9327,6967,-2360
2019,10,3,20,7875,9655,7208,-2447
2019,10,3,21,7958,9830,7346,-2484
2019,10,3,22,7814,9754,7272,-2482
2019,10,3,23,7426,9312,6952,-2360
2019,10,4,0,7145,8865,6643,-2222
2019,10,4,1,6759,8372,6194,-2178
2019,10,4,2,6195,7627,5640,-1987
2019,10,4,3,5577,6832,5173,-1659
2019,10,4,4,4959,6022,4607,-1415
2019,10,4,5,4403,5381,4089,-1292
2019,10,4,6,4041,4926,3664,-1262
2019,10,4,7,3827,4599,3393,-1206
2019,10,4,8,3665,4393,3238,-1155
2019,10,4,9,3651,4358,3211,-1147
2019,10,4,10,3826,4602,3390,-1212
2019,10,4,11,4239,5045,3764,-1281
2019,10,4,12,4446,5268,4069,-1199
2019,10,4,13,4638,5536,4308,-1228
2019,10,4,14,5100,6112,4562,-1550
2019,10,4,15,5761,6821,4996,-1825
2019,10,4,16,6239,7592,5638,-1954
2019,10,4,17,6744,8314,6293,-2021
2019,10,4,18,7179,9020,6897,-2123
2019,10,4,19,7527,9504,7292,-2212
2019,10,4,20,7790,9887,7666,-2221
2019,10,4,21,7822,10061,7796,-2265
2019,10,4,22,7584,9937,7700,-2237
2019,10,4,23,7180,9366,7303,-2063
2019,10,5,0,6913,8895,6862,-2033
2019,10,5,1,6573,8388,6449,-1939
2019,10,5,2,6055,7830,5944,-1886
2019,10,5,3,5533,7148,5357,-1791
2019,10,5,4,5003,6508,4866,-1642
2019,10,5,5,4415,5820,4458,-1362
2019,10,5,6,4071,5299,3966,-1333
2019,10,5,7,3833,5025,3689,-1336
2019,10,5,8,3689,4780,3529,-1251
2019,10,5,9,3625,4670,3429,-1241
2019,10,5,10,3630,4684,3442,-1242
2019,10,5,11,3686,4822,3553,-1269
2019,10,5,12,3833,4997,3804,-1193
2019,10,5,13,4240,5547,4289,-1258
2019,10,5,14,4832,6320,4765,-1555
2019,10,5,15,5477,7071,5396,-1675
2019,10,5,16,6018,7742,5786,-1956
2019,10,5,17,6409,8391,6301,-2090
2019,10,5,18,6812,8918,6719,-2199
2019,10,5,19,7183,9329,7028,-2301
2019,10,5,20,7318,9544,7189,-2355
2019,10,5,21,7277,9529,7144,-2385
2019,10,5,22,7116,9246,6840,-2406
2019,10,5,23,6679,8696,6286,-2410
2019,10,6,0,6476,8275,5924,-2351
2019,10,6,1,6193,7855,5780,-2075
2019,10,6,2,5746,7285,5307,-1978
2019,10,6,3,5285,6667,4975,-1692
2019,10,6,4,4814,6057,4400,-1657
2019,10,6,5,4379,5564,4092,-1472
2019,10,6,6,4074,5155,3784,-1371
2019,10,6,7,3833,4870,3567,-1303
2019,10,6,8,3685,4673,3412,-1261
2019,10,6,9,3614,4569,3328,-1241
2019,10,6,10,3577,4572,3328,-1244
2019,10,6,11,3611,4701,3441,-1260
2019,10,6,12,3762,4888,3679,-1209
2019,10,6,13,4171,5427,4107,-1320
2019,10,6,14,4803,6167,4497,-1670
2019,10,6,15,5470,6873,4912,-1961
2019,10,6,16,5967,7473,5448,-2025
2019,10,6,17,6420,8051,6020,-2031
2019,10,6,18,6824,8372,6268,-2104
2019,10,6,19,7060,8475,6414,-2061
2019,10,6,20,7188,8675,6560,-2115
2019,10,6,21,7133,8746,6631,-2115
2019,10,6,22,7017,8692,6535,-2157
2019,10,6,23,6816,8378,6331,-2047
2019,10,7,0,6507,8208,6130,-2078
2019,10,7,1,6240,7874,5871,-2003
2019,10,7,2,5707,7292,5391,-1901
2019,10,7,3,5196,6562,4895,-1667
2019,10,7,4,4696,5890,4286,-1604
2019,10,7,5,4235,5438,4039,-1399
2019,10,7,6,3931,5062,3744,-1318
2019,10,7,7,3739,4827,3571,-1256
2019,10,7,8,3594,4719,3484,-1235
2019,10,7,9,3614,4779,3536,-1243
2019,10,7,10,3822,5065,3754,-1311
2019,10,7,11,4194,5592,4165,-1427
2019,10,7,12,4429,5808,4442,-1366
2019,10,7,13,4597,6013,4639,-1374
2019,10,7,14,4980,6296,4736,-1560
2019,10,7,15,5560,6678,4913,-1765
2019,10,7,16,6026,6980,4992,-1988
2019,10,7,17,6377,7288,5346,-1942
2019,10,7,18,6712,7601,5583,-2018
2019,10,7,19,6930,7765,5698,-2067
2019,10,7,20,7069,7870,6023,-1847
2019,10,7,21,7046,7893,6160,-1733
2019,10,7,22,6904,7776,5960,-1816
2019,10,7,23,6623,7572,5467,-2105
2019,10,8,0,6451,7543,5409,-2134
2019,10,8,1,6136,7271,5277,-1994
2019,10,8,2,5643,6756,4762,-1994
2019,10,8,3,5090,6191,4514,-1677
2019,10,8,4,4587,5586,4105,-1481
2019,10,8,5,4201,5142,3898,-1244
2019,10,8,6,3930,4791,3615,-1176
2019,10,8,7,3734,4577,3450,-1127
2019,10,8,8,3636,4500,3373,-1127
2019,10,8,9,3637,4533,3405,-1128
2019,10,8,10,3863,4840,3625,-1215
2019,10,8,11,4278,5369,4050,-1319
2019,10,8,12,4492,5689,4400,-1289
2019,10,8,13,4665,5835,4547,-1288
2019,10,8,14,5044,6197,4657,-1540
2019,10,8,15,5567,6663,4817,-1846
2019,10,8,16,6015,7154,5152,-2002
2019,10,8,17,6365,7691,5702,-1989
2019,10,8,18,6756,8008,6050,-1958
2019,10,8,19,6997,8194,6137,-2057
2019,10,8,20,7145,8237,6161,-2076
2019,10,8,21,7144,8217,6121,-2096
2019,10,8,22,7005,7986,5958,-2028
2019,10,8,23,6685,7704,5832,-1872
2019,10,9,0,6596,7614,5694,-1920
2019,10,9,1,6288,7354,5511,-1843
2019,10,9,2,5805,6812,4995,-1817
2019,10,9,3,5246,6212,4464,-1748
2019,10,9,4,4737,5604,4074,-1530
2019,10,9,5,4194,5152,3857,-1295
2019,10,9,6,3918,4831,3628,-1203
2019,10,9,7,3745,4616,3467,-1149
2019,10,9,8,3650,4536,3408,-1128
2019,10,9,9,3682,4573,3434,-1139
2019,10,9,10,3902,4853,3658,-1195
2019,10,9,11,4271,5387,4069,-1318
2019,10,9,12,4473,5688,4444,-1244
2019,10,9,13,4587,5839,4523,-1316
2019,10,9,14,4827,6130,4584,-1546
2019,10,9,15,5206,6421,4634,-1787
2019,10,9,16,5581,6726,4766,-1960
2019,10,9,17,5861,7010,5032,-1978
2019,10,9,18,6122,7123,5178,-1945
2019,10,9,19,6305,7143,5249,-1894
2019,10,9,20,6385,7127,5224,-1903
2019,10,9,21,6358,7158,5267,-1891
2019,10,9,22,6286,7126,5242,-1884
2019,10,9,23,6014,7034,5129,-1905
2019,10,10,0,5950,7092,5152,-1940
2019,10,10,1,5697,6852,4941,-1911
2019,10,10,2,5282,6420,4531,-1889
2019,10,10,3,4802,5841,4163,-1678
2019,10,10,4,4325,5240,3772,-1468
2019,10,10,5,3897,4802,3597,-1205
2019,10,10,6,3658,4484,3334,-1150
2019,10,10,7,3487,4292,3190,-1102
2019,10,10,8,3416,4180,3110,-1070
2019,10,10,9,3445,4209,3142,-1067
2019,10,10,10,3655,4503,3370,-1133
2019,10,10,11,4041,5034,3801,-1233
2019,10,10,12,4259,5334,4117,-1217
2019,10,10,13,4406,5524,4265,-1259
2019,10,10,14,4721,5974,4449,-1525
2019,10,10,15,5103,6562,4728,-1834
2019,10,10,16,5461,7156,5080,-2076
2019,10,10,17,5788,7595,5528,-2067
2019,10,10,18,6134,8079,6037,-2042
2019,10,10,19,6336,8364,6220,-2144
2019,10,10,20,6457,8543,6436,-2107
2019,10,10,21,6449,8648,6511,-2137
2019,10,10,22,6307,8490,6409,-2081
2019,10,10,23,5994,8130,6310,-1820
2019,10,11,0,6011,7917,6092,-1825
2019,10,11,1,5737,7556,5774,-1782
2019,10,11,2,5314,6982,5227,-1755
2019,10,11,3,4825,6311,4621,-1690
2019,10,11,4,4348,5604,4110,-1494
2019,10,11,5,3964,5070,3837,-1233
2019,10,11,6,3657,4673,3524,-1149
2019,10,11,7,3442,4420,3330,-1090
2019,10,11,8,3335,4250,3196,-1054
2019,10,11,9,3318,4232,3179,-1053
2019,10,11,10,3509,4488,3385,-1103
2019,10,11,11,3898,4944,3710,-1234
2019,10,11,12,4134,5206,4007,-1199
2019,10,11,13,4275,5428,4217,-1211
2019,10,11,14,4616,5878,4374,-1504
2019,10,11,15,5101,6459,4671,-1788
2019,10,11,16,5480,7004,4984,-2020
2019,10,11,17,5956,7554,5517,-2037
2019,10,11,18,6307,8075,6008,-2067
2019,10,11,19,6527,8469,6226,-2243
2019,10,11,20,6718,8735,6450,-2285
2019,10,11,21,6762,8811,6544,-2267
2019,10,11,22,6582,8619,6374,-2245
2019,10,11,23,6114,8060,6054,-2006
2019,10,12,0,5919,7630,5617,-2013
2019,10,12,1,5562,7167,5226,-1941
2019,10,12,2,5134,6595,4720,-1875
2019,10,12,3,4714,6005,4350,-1655
2019,10,12,4,4275,5401,3973,-1428
2019,10,12,5,3843,4908,3718,-1190
2019,10,12,6,3515,4483,3406,-1077
2019,10,12,7,3299,4239,3199,-1040
2019,10,12,8,3173,4065,3060,-1005
2019,10,12,9,3121,3996,3000,-996
2019,10,12,10,3146,4027,3038,-989
2019,10,12,11,3262,4190,3158,-1032
2019,10,12,12,3403,4375,3361,-1014
2019,10,12,13,3692,4845,3734,-1111
2019,10,12,14,4097,5429,4019,-1410
2019,10,12,15,4477,6029,4302,-1727
2019,10,12,16,4888,6622,4641,-1981
2019,10,12,17,5340,7173,5225,-1948
2019,10,12,18,5697,7627,5674,-1953
2019,10,12,19,6006,8002,5986,-2016
2019,10,12,20,6194,8234,6150,-2084
2019,10,12,21,6297,8357,6229,-2128
2019,10,12,22,6185,8232,6123,-2109
2019,10,12,23,5812,7769,5867,-1902
2019,10,13,0,5583,7413,5500,-1913
2019,10,13,1,5226,6969,5112,-1857
2019,10,13,2,4820,6459,4594,-1865
2019,10,13,3,4415,5899,4238,-1661
2019,10,13,4,4028,5347,3897,-1450
2019,10,13,5,3785,4862,3689,-1173
2019,10,13,6,3473,4483,3371,-1112
2019,10,13,7,3273,4220,3174,-1046
2019,10,13,8,3139,4046,3038,-1008
2019,10,13,9,3074,3948,2950,-998
2019,10,13,10,3072,3951,2957,-994
2019,10,13,11,3172,4065,3047,-1018
2019,10,13,12,3335,4233,3218,-1015
2019,10,13,13,3689,5993,4868,-1125
2019,10,13,14,4179,5444,3984,-1460
2019,10,13,15,4620,6112,4304,-1808
2019,10,13,16,5133,6757,4743,-2014
2019,10,13,17,5685,7349,5334,-2015
2019,10,13,18,6134,7912,5849,-2063
2019,10,13,19,6489,8339,6238,-2101
2019,10,13,20,6711,8645,6520,-2125
2019,10,13,21,6811,8760,6609,-2151
2019,10,13,22,6659,8723,6637,-2086
2019,10,13,23,6403,8282,6356,-1926
2019,10,14,0,6220,7993,6044,-1949
2019,10,14,1,5835,7511,5612,-1899
2019,10,14,2,5301,6876,5061,-1815
2019,10,14,3,4777,6168,4420,-1748
2019,10,14,4,4277,5477,3958,-1519
2019,10,14,5,3821,4914,3691,-1223
2019,10,14,6,3500,4559,3414,-1145
2019,10,14,7,3287,4294,3218,-1076
2019,10,14,8,3185,4174,3128,-1046
2019,10,14,9,3205,4195,3134,-1061
2019,10,14,10,3427,4434,3324,-1110
2019,10,14,11,3830,4852,3658,-1194
2019,10,14,12,4096,5123,3934,-1189
2019,10,14,13,4226,5418,4198,-1220
2019,10,14,14,4597,6001,4466,-1535
2019,10,14,15,5021,6702,4844,-1858
2019,10,14,16,5549,7417,5465,-1952
2019,10,14,17,5966,8082,6154,-1928
2019,10,14,18,6385,8619,6723,-1896
2019,10,14,19,6656,9022,7034,-1988
2019,10,14,20,6888,9355,7288,-2067
2019,10,14,21,6990,9474,7430,-2044
2019,10,14,22,6852,9360,7408,-1952
2019,10,14,23,6479,8903,7013,-1890
2019,10,15,0,6339,8584,6702,-1882
2019,10,15,1,5981,8055,6246,-1809
2019,10,15,2,5478,7353,5616,-1737
2019,10,15,3,4952,6527,4810,-1717
2019,10,15,4,4421,5758,4209,-1549
2019,10,15,5,4001,5198,3894,-1304
2019,10,15,6,3659,4810,3584,-1226
2019,10,15,7,3447,4553,3381,-1172
2019,10,15,8,3337,4396,3264,-1132
2019,10,15,9,3333,4409,3265,-1144
2019,10,15,10,3539,4684,3474,-1210
2019,10,15,11,3955,5170,3845,-1325
2019,10,15,12,4205,5437,4234,-1203
2019,10,15,13,4318,5653,4448,-1205
2019,10,15,14,4649,6133,4683,-1450
2019,10,15,15,5119,6698,4869,-1829
2019,10,15,16,5572,7301,5467,-1834
2019,10,15,17,5986,7901,6092,-1809
2019,10,15,18,6358,8430,6497,-1933
2019,10,15,19,6604,8838,6698,-2140
2019,10,15,20,6826,9051,6958,-2093
2019,10,15,21,6944,9182,6991,-2191
2019,10,15,22,6863,9000,6831,-2169
2019,10,15,23,6559,8561,6673,-1888
2019,10,16,0,6429,8401,6540,-1861
2019,10,16,1,6080,7922,6230,-1692
2019,10,16,2,5601,7334,5625,-1709
2019,10,16,3,5070,6627,4931,-1696
2019,10,16,4,4542,5947,4361,-1586
2019,10,16,5,4252,5436,4068,-1368
2019,10,16,6,3953,5069,3772,-1297
2019,10,16,7,3781,4831,3579,-1252
2019,10,16,8,3675,4682,3463,-1219
2019,10,16,9,3696,4693,3464,-1229
2019,10,16,10,3905,4984,3674,-1310
2019,10,16,11,4283,5479,4049,-1430
2019,10,16,12,4483,5775,4495,-1280
2019,10,16,13,4647,5955,4597,-1358
2019,10,16,14,5023,6538,4817,-1721
2019,10,16,15,5545,7259,5366,-1893
2019,10,16,16,6045,7857,5946,-1911
2019,10,16,17,6269,8348,6598,-1750
2019,10,16,18,6575,8768,7121,-1647
2019,10,16,19,6735,8902,7145,-1757
2019,10,16,20,6831,9008,7190,-1818
2019,10,16,21,6878,8825,7055,-1770
2019,10,16,22,6719,8550,6718,-1832
2019,10,16,23,6420,8175,6445,-1730
2019,10,17,0,6332,8055,6241,-1814
2019,10,17,1,6017,7716,6092,-1624
2019,10,17,2,5563,7219,5597,-1622
2019,10,17,3,5018,6534,4961,-1573
2019,10,17,4,4515,5848,4280,-1568
2019,10,17,5,4228,5336,4008,-1328
2019,10,17,6,3920,4967,3707,-1260
2019,10,17,7,3701,4718,3524,-1194
2019,10,17,8,3569,4585,3400,-1185
2019,10,17,9,3572,4548,3399,-1149
2019,10,17,10,3762,4777,3559,-1218
2019,10,17,11,4124,5264,3940,-1324
2019,10,17,12,4335,5510,4313,-1197
2019,10,17,13,4466,5611,4375,-1236
2019,10,17,14,4767,5915,4434,-1481
2019,10,17,15,5216,6296,4559,-1737
2019,10,17,16,5681,6702,4728,-1974
2019,10,17,17,6030,7152,5011,-2141
2019,10,17,18,6345,7686,5489,-2197
2019,10,17,19,6535,8022,5723,-2299
2019,10,17,20,6645,8246,5962,-2284
2019,10,17,21,6619,8289,6056,-2233
2019,10,17,22,6440,8046,5847,-2199
2019,10,17,23,6081,7655,5416,-2239
2019,10,18,0,5961,7524,5251,-2273
2019,10,18,1,5629,7092,5086,-2006
2019,10,18,2,5197,6541,4691,-1850
2019,10,18,3,4688,5897,4342,-1555
2019,10,18,4,4200,5211,3833,-1378
2019,10,18,5,3854,4711,3549,-1162
2019,10,18,6,3515,4344,3245,-1099
2019,10,18,7,3326,4103,3040,-1063
2019,10,18,8,3212,3966,2923,-1043
2019,10,18,9,3208,3992,2939,-1053
2019,10,18,10,3400,4220,3106,-1114
2019,10,18,11,3725,4716,3448,-1268
2019,10,18,12,3943,5006,3830,-1176
2019,10,18,13,4058,5139,3987,-1152
2019,10,18,14,4301,5335,4148,-1187
2019,10,18,15,4516,5526,4344,-1182
2019,10,18,16,4684,5706,4534,-1172
2019,10,18,17,4758,5883,4662,-1221
2019,10,18,18,4898,6032,4673,-1359
2019,10,18,19,5033,6143,4926,-1217
2019,10,18,20,5195,6185,5018,-1167
2019,10,18,21,5279,6188,4851,-1337
2019,10,18,22,5202,6183,4776,-1407
2019,10,18,23,5038,6157,4727,-1430
2019,10,19,0,5095,6239,4793,-1446
2019,10,19,1,4964,6035,4705,-1330
2019,10,19,2,4696,5812,4541,-1271
2019,10,19,3,4387,5477,4236,-1241
2019,10,19,4,4037,5059,3843,-1216
2019,10,19,5,3532,4739,3599,-1140
2019,10,19,6,3295,4511,3451,-1060
2019,10,19,7,3171,4368,3328,-1040
2019,10,19,8,3128,4286,3253,-1033
2019,10,19,9,3105,4258,3241,-1017
2019,10,19,10,3181,4367,3292,-1075
2019,10,19,11,3327,4567,3440,-1127
2019,10,19,12,3559,4818,3661,-1157
2019,10,19,13,3923,5231,4072,-1159
2019,10,19,14,4298,5722,4440,-1282
2019,10,19,15,4575,6087,4693,-1394
2019,10,19,16,4897,6373,4858,-1515
2019,10,19,17,5083,6529,4784,-1745
2019,10,19,18,5306,6702,4765,-1937
2019,10,19,19,5415,7052,4995,-2057
2019,10,19,20,5528,7359,5254,-2105
2019,10,19,21,5603,7540,5383,-2157
2019,10,19,22,5548,7503,5345,-2158
2019,10,19,23,5418,7259,5144,-2115
2019,10,20,0,5358,7202,5090,-2112
2019,10,20,1,5161,6943,4930,-2013
2019,10,20,2,4817,6601,4711,-1890
2019,10,20,3,4508,6204,4535,-1669
2019,10,20,4,4217,5747,4269,-1478
2019,10,20,5,4085,5308,4055,-1253
2019,10,20,6,3832,4961,3806,-1155
2019,10,20,7,3688,4677,3575,-1102
2019,10,20,8,3596,4535,3450,-1085
2019,10,20,9,3529,4437,3363,-1074
2019,10,20,10,3537,4443,3370,-1073
2019,10,20,11,3626,4559,3444,-1115
2019,10,20,12,3782,4747,3606,-1141
2019,10,20,13,4128,5252,3960,-1292
2019,10,20,14,4729,6009,4472,-1537
2019,10,20,15,5233,6595,4808,-1787
2019,10,20,16,5661,7136,5111,-2025
2019,10,20,17,6007,7667,5612,-2055
2019,10,20,18,6272,8109,6081,-2028
2019,10,20,19,6430,8457,6423,-2034
2019,10,20,20,6560,8686,6683,-2003
2019,10,20,21,6557,8780,6771,-2009
2019,10,20,22,6386,8666,6630,-2036
2019,10,20,23,6171,8201,6156,-2045
2019,10,21,0,6077,7866,5831,-2035
2019,10,21,1,5802,7345,5406,-1939
2019,10,21,2,5352,6670,4859,-1811
2019,10,21,3,4872,5944,4405,-1539
2019,10,21,4,4394,5272,3948,-1324
2019,10,21,5,3901,4742,3659,-1083
2019,10,21,6,3635,4400,3392,-1008
2019,10,21,7,3428,4191,3229,-962
2019,10,21,8,3330,4109,3157,-952
2019,10,21,9,3342,4150,3188,-962
2019,10,21,10,3563,4487,3442,-1045
2019,10,21,11,3981,5059,3846,-1213
2019,10,21,12,4246,5363,4199,-1164
2019,10,21,13,4414,5540,4370,-1170
2019,10,21,14,4779,5847,4461,-1386
2019,10,21,15,5230,6204,4620,-1584
2019,10,21,16,5662,6679,4974,-1705
2019,10,21,17,6132,7298,5534,-1764
2019,10,21,18,6517,7798,6127,-1671
2019,10,21,19,6809,7831,6245,-1586
2019,10,21,20,7041,7810,6196,-1614
2019,10,21,21,7156,7973,6292,-1681
2019,10,21,22,7059,8105,6408,-1697
2019,10,21,23,6725,7980,6186,-1794
2019,10,22,0,6598,7985,6166,-1819
2019,10,22,1,6207,7590,5819,-1771
2019,10,22,2,5730,7074,5414,-1660
2019,10,22,3,5186,6421,4826,-1595
2019,10,22,4,4680,5758,4312,-1446
2019,10,22,5,4457,5267,3996,-1271
2019,10,22,6,4167,4910,3709,-1201
2019,10,22,7,3964,4687,3531,-1156
2019,10,22,8,3863,4609,3493,-1116
2019,10,22,9,3879,4661,3523,-1138
2019,10,22,10,4088,4982,3709,-1273
2019,10,22,11,4486,5568,4166,-1402
2019,10,22,12,4707,5910,4598,-1312
2019,10,22,13,4902,6081,4814,-1267
2019,10,22,14,5334,6497,4904,-1593
2019,10,22,15,5750,7058,5174,-1884
2019,10,22,16,6122,7787,5769,-2018
2019,10,22,17,6535,8439,6506,-1933
2019,10,22,18,6821,8988,7197,-1791
2019,10,22,19,6996,9300,7551,-1749
2019,10,22,20,7147,9490,7754,-1736
2019,10,22,21,7197,9545,7718,-1827
2019,10,22,22,7019,9353,7562,-1791
2019,10,22,23,6642,8853,7090,-1763
2019,10,23,0,6490,8575,6802,-1773
2019,10,23,1,6107,8043,6165,-1878
2019,10,23,2,5634,7304,5499,-1805
2019,10,23,3,5042,6599,4939,-1660
2019,10,23,4,4502,5850,4313,-1537
2019,10,23,5,3961,5269,3976,-1293
2019,10,23,6,3631,4878,3664,-1214
2019,10,23,7,3418,4587,3456,-1131
2019,10,23,8,3305,4352,3262,-1090
2019,10,23,9,3305,4259,3182,-1077
2019,10,23,10,3495,4470,3330,-1140
2019,10,23,11,3854,4873,3623,-1250
2019,10,23,12,4062,5067,3899,-1168
2019,10,23,13,4148,5089,3971,-1118
2019,10,23,14,4322,5256,4052,-1204
2019,10,23,15,4544,5552,4299,-1253
2019,10,23,16,4701,5858,4468,-1390
2019,10,23,17,4903,6220,4768,-1452
2019,10,23,18,5117,6628,5106,-1522
2019,10,23,19,5317,7083,5473,-1610
2019,10,23,20,5502,7452,5747,-1705
2019,10,23,21,5677,7680,5908,-1772
2019,10,23,22,5631,7613,5838,-1775
2019,10,23,23,5291,7301,5591,-1710
2019,10,24,0,5274,7213,5515,-1698
2019,10,24,1,5073,6847,5294,-1553
2019,10,24,2,4691,6315,4886,-1429
2019,10,24,3,4233,5653,4392,-1261
2019,10,24,4,3782,4943,3684,-1259
2019,10,24,5,3474,4488,3341,-1147
2019,10,24,6,3215,4175,3053,-1122
2019,10,24,7,3062,3973,2929,-1044
2019,10,24,8,2983,3890,2861,-1029
2019,10,24,9,3006,3934,2896,-1038
2019,10,24,10,3222,4247,3129,-1118
2019,10,24,11,3642,4831,3575,-1256
2019,10,24,12,3896,5198,4021,-1177
2019,10,24,13,4013,5321,4158,-1163
2019,10,24,14,4287,5783,4317,-1466
2019,10,24,15,4584,6405,4695,-1710
2019,10,24,16,5004,7008,5218,-1790
2019,10,24,17,5290,7559,5409,-2150
2019,10,24,18,5639,8053,5890,-2163
2019,10,24,19,5842,8444,6385,-2059
2019,10,24,20,6004,8730,6619,-2111
2019,10,24,21,6063,8837,6689,-2148
2019,10,24,22,5985,8679,6632,-2047
2019,10,24,23,5949,8289,6303,-1986
2019,10,25,0,5943,8171,6166,-2005
2019,10,25,1,5639,7775,5929,-1846
2019,10,25,2,5244,7247,5403,-1844
2019,10,25,3,4770,6568,4797,-1771
2019,10,25,4,4296,5927,4323,-1604
2019,10,25,5,4404,5440,4111,-1329
2019,10,25,6,4068,5031,3819,-1212
2019,10,25,7,3892,4780,3592,-1188
2019,10,25,8,3777,4661,3491,-1170
2019,10,25,9,3780,4644,3467,-1177
2019,10,25,10,3971,4895,3645,-1250
2019,10,25,11,4317,5426,4075,-1351
2019,10,25,12,4538,5750,4453,-1297
2019,10,25,13,4706,5942,4681,-1261
2019,10,25,14,5151,6481,4855,-1626
2019,10,25,15,5645,7053,5115,-1938
2019,10,25,16,6112,7561,5634,-1927
2019,10,25,17,6460,7948,6036,-1912
2019,10,25,18,6780,8215,6334,-1881
2019,10,25,19,6964,8359,6493,-1866
2019,10,25,20,7068,8304,6466,-1838
2019,10,25,21,7014,8211,6377,-1834
2019,10,25,22,6786,7976,6184,-1792
2019,10,25,23,6465,7591,5838,-1753
2019,10,26,0,6263,7375,5551,-1824
2019,10,26,1,5930,7073,5307,-1766
2019,10,26,2,5503,6721,4910,-1811
2019,10,26,3,5071,6266,4486,-1780
2019,10,26,4,4625,5761,4209,-1552
2019,10,26,5,4448,5311,3964,-1347
2019,10,26,6,4145,4950,3645,-1305
2019,10,26,7,3964,4722,3475,-1247
2019,10,26,8,3834,4562,3361,-1201
2019,10,26,9,3782,4504,3311,-1193
2019,10,26,10,3797,4550,3353,-1197
2019,10,26,11,3855,4754,3498,-1256
2019,10,26,12,4054,5025,3816,-1209
2019,10,26,13,4410,5499,4227,-1272
2019,10,26,14,4939,6225,4617,-1608
2019,10,26,15,5531,6905,5073,-1832
2019,10,26,16,5995,7473,5556,-1917
2019,10,26,17,6264,7899,6006,-1893
2019,10,26,18,6425,8251,6082,-2169
2019,10,26,19,6617,8325,6111,-2214
2019,10,26,20,6623,8235,6036,-2199
2019,10,26,21,6576,8211,6069,-2142
2019,10,26,22,6461,7994,5876,-2118
2019,10,26,23,6280,7641,5493,-2148
2019,10,27,0,6136,7482,5396,-2086
2019,10,27,1,5865,7093,5140,-1953
2019,10,27,2,5463,6667,4813,-1854
2019,10,27,3,5094,6199,4462,-1737
2019,10,27,4,4680,5731,4114,-1617
2019,10,27,5,4368,5310,3940,-1370
2019,10,27,6,4045,4976,3704,-1272
2019,10,27,7,3857,4717,3484,-1233
2019,10,27,8,3695,4562,3363,-1199
2019,10,27,9,3595,4510,3309,-1201
2019,10,27,10,3585,4552,3338,-1214
2019,10,27,11,3659,4678,3422,-1256
2019,10,27,12,3823,4919,3749,-1170
2019,10,27,13,4191,5393,4100,-1293
2019,10,27,14,4827,6147,4533,-1614
2019,10,27,15,5425,6877,4873,-2004
2019,10,27,16,6034,7501,5178,-2323
2019,10,27,17,6448,8074,5572,-2502
2019,10,27,18,6782,8485,6079,-2406
2019,10,27,19,7030,8794,6373,-2421
2019,10,27,20,7125,8877,6472,-2405
2019,10,27,21,7114,8869,6448,-2421
2019,10,27,22,6915,8770,6323,-2447
2019,10,27,23,6731,8438,6195,-2243
2019,10,28,0,6568,8260,6275,-1985
2019,10,28,1,6223,7775,6028,-1747
2019,10,28,2,5749,7177,5594,-1583
2019,10,28,3,5253,6485,5131,-1354
2019,10,28,4,4760,5823,4574,-1249
2019,10,28,5,4273,5281,4207,-1074
2019,10,28,6,3977,4902,3816,-1086
2019,10,28,7,3761,4646,3539,-1107
2019,10,28,8,3663,4531,3362,-1169
2019,10,28,9,3674,4522,3348,-1174
2019,10,28,10,3890,4815,3576,-1239
2019,10,28,11,4313,5352,4096,-1256
2019,10,28,12,4563,5701,4516,-1185
2019,10,28,13,4726,5837,4663,-1174
2019,10,28,14,5156,6375,4923,-1452
2019,10,28,15,5665,7020,5410,-1610
2019,10,28,16,6234,7772,5937,-1835
2019,10,28,17,6619,8471,6581,-1890
2019,10,28,18,6945,9026,7108,-1918
2019,10,28,19,7151,9396,7256,-2140
2019,10,28,20,7235,9693,7334,-2359
2019,10,28,21,7169,9803,7312,-2491
2019,10,28,22,7029,9678,7323,-2355
2019,10,28,23,6838,9283,7161,-2122
2019,10,29,0,6738,9036,7052,-1984
2019,10,29,1,6365,8451,6629,-1822
2019,10,29,2,5859,7717,6013,-1704
2019,10,29,3,5314,7003,5374,-1629
2019,10,29,4,4779,6275,4774,-1501
2019,10,29,5,4414,5708,4495,-1213
2019,10,29,6,4060,5317,4051,-1266
2019,10,29,7,3875,5037,3776,-1261
2019,10,29,8,3766,4886,3650,-1236
2019,10,29,9,3742,4884,3633,-1251
2019,10,29,10,3933,5136,3820,-1316
2019,10,29,11,4350,5687,4252,-1435
2019,10,29,12,4555,5989,4616,-1373
2019,10,29,13,4684,6120,4700,-1420
2019,10,29,14,5029,6585,4859,-1726
2019,10,29,15,5534,7245,5274,-1971
2019,10,29,16,5908,7899,5754,-2145
2019,10,29,17,6307,8546,6416,-2130
2019,10,29,18,6682,9024,7003,-2021
2019,10,29,19,6885,9425,7333,-2092
2019,10,29,20,6976,9663,7462,-2201
2019,10,29,21,7003,9751,7483,-2268
2019,10,29,22,6882,9522,7187,-2335
2019,10,29,23,6632,8986,6550,-2436
2019,10,30,0,6513,8734,6540,-2194
2019,10,30,1,6170,8202,6292,-1910
2019,10,30,2,5667,7564,5733,-1831
2019,10,30,3,5132,6846,5116,-1730
2019,10,30,4,4609,6134,4611,-1523
2019,10,30,5,4510,5573,4415,-1158
2019,10,30,6,4184,5187,4077,-1110
2019,10,30,7,3981,4960,3832,-1128
2019,10,30,8,3874,4834,3641,-1193
2019,10,30,9,3837,4833,3639,-1194
2019,10,30,10,4036,5055,3790,-1265
2019,10,30,11,4438,5554,4192,-1362
2019,10,30,12,4657,5779,4450,-1329
2019,10,30,13,4794,5924,4579,-1345
2019,10,30,14,5183,6414,4772,-1642
2019,10,30,15,5790,6981,5230,-1751
2019,10,30,16,6198,7479,5636,-1843
2019,10,30,17,6608,8016,6136,-1880
2019,10,30,18,7004,8973,7016,-1957
2019,10,30,19,7230,8650,6582,-2068
2019,10,30,20,7378,8961,6915,-2046
2019,10,30,21,7462,9053,7011,-2042
2019,10,30,22,7377,8806,6725,-2081
2019,10,30,23,7109,8351,6296,-2055
2019,10,31,0,6983,8109,6072,-2037
2019,10,31,1,6592,7540,5682,-1858
2019,10,31,2,6101,6917,5189,-1728
2019,10,31,3,5558,6251,4624,-1627
2019,10,31,4,5027,5640,4159,-1481
2019,10,31,5,4519,5643,4441,-1202
2019,10,31,6,4200,5214,4003,-1211
2019,10,31,7,4015,4935,3728,-1207
2019,10,31,8,3884,4776,3530,-1246
2019,10,31,9,3888,4765,3504,-1261
2019,10,31,10,4095,5027,3700,-1327
2019,10,31,11,4535,5522,4210,-1312
2019,10,31,12,4747,5824,4580,-1244
2019,10,31,13,4931,5972,4683,-1289
2019,10,31,14,5411,6502,4998,-1504
2019,10,31,15,5955,7157,5443,-1714
2019,10,31,16,6414,7880,6068,-1812
2019,10,31,17,6823,8472,6606,-1866
2019,10,31,18,7217,9018,7140,-1878
2019,10,31,19,7469,9365,7478,-1887
2019,10,31,20,7604,9585,7666,-1919
2019,10,31,21,7600,9726,7756,-1970
2019,10,31,22,7378,9486,7566,-1920
2019,10,31,23,6876,8813,7005,-1808
2019,11,1,0,6641,8308,6515,-1793
2019,11,1,1,6249,7859,6209,-1650
2019,11,1,2,5845,7489,5885,-1604
2019,11,1,3,5302,6828,5260,-1568
2019,11,1,4,4718,6069,4666,-1403
2019,11,1,5,4248,5636,4471,-1165
2019,11,1,6,3892,5224,4045,-1179
2019,11,1,7,3652,4945,3787,-1158
2019,11,1,8,3520,4764,3640,-1124
2019,11,1,9,3509,4692,3580,-1112
2019,11,1,10,3659,4843,3679,-1164
2019,11,1,11,3998,5212,4077,-1135
2019,11,1,12,4231,5431,4372,-1059
2019,11,1,13,4378,5424,4170,-1254
2019,11,1,14,4614,5604,4291,-1313
2019,11,1,15,4882,5887,4504,-1383
2019,11,1,16,5058,6167,4748,-1419
2019,11,1,17,5270,6461,4993,-1468
2019,11,1,18,5412,6849,5345,-1504
2019,11,1,19,5508,7167,5572,-1595
2019,11,1,20,5518,7358,5815,-1543
2019,11,1,21,5428,7364,5851,-1513
2019,11,1,22,5274,7152,5662,-1490
2019,11,1,23,5122,6835,5429,-1406
2019,11,2,0,5020,6710,5294,-1416
2019,11,2,1,4789,6387,5129,-1258
2019,11,2,2,4479,6007,4761,-1246
2019,11,2,3,4133,5562,4262,-1300
2019,11,2,4,3787,5068,3850,-1218
2019,11,2,5,3283,4485,3342,-1143
2019,11,2,6,3049,4146,3090,-1056
2019,11,2,7,2899,3951,2921,-1030
2019,11,2,8,2825,3844,2832,-1012
2019,11,2,9,2803,3834,2807,-1027
2019,11,2,10,2850,3922,2865,-1057
2019,11,2,11,2986,4132,3028,-1104
2019,11,2,12,3205,4407,3272,-1135
2019,11,2,13,3540,4761,3489,-1272
2019,11,2,14,3880,5216,3764,-1452
2019,11,2,15,4120,5379,3928,-1451
2019,11,2,16,4307,6096,4621,-1475
2019,11,2,17,4519,6602,5102,-1500
2019,11,2,18,4697,6990,5490,-1500
2019,11,2,19,4853,7220,5752,-1468
2019,11,2,20,4942,7258,5821,-1437
2019,11,2,21,4970,7177,5792,-1385
2019,11,2,22,4895,6947,5590,-1357
2019,11,2,23,4675,6623,5263,-1360
2019,11,3,0,4594,6480,5002,-1478
2019,11,3,1,4322,6119,4650,-1469
2019,11,3,2,3987,5718,4250,-1468
2019,11,3,3,3678,5266,3813,-1453
2019,11,3,4,3390,4778,3431,-1347
2019,11,3,5,3450,4384,3284,-1100
2019,11,3,6,3117,4063,3018,-1045
2019,11,3,7,2954,3855,2841,-1014
2019,11,3,8,2712,3712,2724,-988
2019,11,3,9,2671,3630,2652,-978
2019,11,3,10,2674,3601,2611,-990
2019,11,3,11,2787,3673,2632,-1041
2019,11,3,12,3005,3864,2774,-1090
2019,11,3,13,3426,4266,3057,-1209
2019,11,3,14,3887,4785,3461,-1324
2019,11,3,15,4202,5170,3573,-1597
2019,11,3,16,4386,5456,3740,-1716
2019,11,3,17,4585,5715,3995,-1720
2019,11,3,18,4741,6061,4295,-1766
2019,11,3,19,4896,6242,4461,-1781
2019,11,3,20,4983,6293,4536,-1757
2019,11,3,21,4932,6279,4572,-1707
2019,11,3,22,4979,6243,4574,-1669
2019,11,3,23,4922,6308,4588,-1720
2019,11,4,0,4711,6463,4681,-1782
2019,11,4,1,4419,6215,4435,-1780
2019,11,4,2,4078,5854,4111,-1743
2019,11,4,3,3658,5383,3648,-1735
2019,11,4,4,3338,4847,3150,-1697
2019,11,4,5,-9999,4335,2730,-1605
2019,11,4,6,3196,3996,2612,-1384
2019,11,4,7,2978,3781,2452,-1329
2019,11,4,8,2858,3675,2417,-1258
2019,11,4,9,2805,3642,2431,-1211
2019,11,4,10,2856,3740,2506,-1234
2019,11,4,11,3134,4105,2721,-1384
2019,11,4,12,3598,4680,3135,-1545
2019,11,4,13,3886,5020,3474,-1546
2019,11,4,14,4140,5315,3728,-1587
2019,11,4,15,4529,5692,4047,-1645
2019,11,4,16,4912,6141,4546,-1595
2019,11,4,17,5298,6539,4900,-1639
2019,11,4,18,5652,6887,5271,-1616
2019,11,4,19,5868,7125,5569,-1556
2019,11,4,20,5996,7214,5685,-1529
2019,11,4,21,6035,7220,5607,-1613
2019,11,4,22,6006,7165,5568,-1597
2019,11,4,23,5984,7251,5584,-1667
2019,11,5,0,5879,7391,5673,-1718
2019,11,5,1,5663,7147,5553,-1594
2019,11,5,2,5296,6772,5146,-1626
2019,11,5,3,4871,6258,4605,-1653
2019,11,5,4,4392,5664,4021,-1643
2019,11,5,5,4030,5087,3479,-1608
2019,11,5,6,3688,4663,3177,-1486
2019,11,5,7,3430,4380,2925,-1455
2019,11,5,8,3271,4194,2821,-1373
2019,11,5,9,3205,4097,2746,-1351
2019,11,5,10,3229,4125,2764,-1361
2019,11,5,11,3484,4430,2934,-1496
2019,11,5,12,3929,4959,3278,-1681
2019,11,5,13,4230,5331,3584,-1747
2019,11,5,14,4530,5767,3983,-1784
2019,11,5,15,4946,6386,4460,-1926
2019,11,5,16,5411,6926,5028,-1898
2019,11,5,17,5830,7379,5561,-1818
2019,11,5,18,6229,7700,5968,-1732
2019,11,5,19,6513,7743,6018,-1725
2019,11,5,20,6647,7695,5939,-1756
2019,11,5,21,6620,7602,5729,-1873
2019,11,5,22,6552,7477,5648,-1829
2019,11,5,23,6382,7568,5629,-1939
2019,11,6,0,6307,7660,5743,-1917
2019,11,6,1,5929,7362,5591,-1771
2019,11,6,2,5554,6936,5253,-1683
2019,11,6,3,5083,6414,4661,-1753
2019,11,6,4,4600,5771,3963,-1808
2019,11,6,5,4179,5163,3456,-1707
2019,11,6,6,3951,4692,3081,-1611
2019,11,6,7,3667,4410,2935,-1475
2019,11,6,8,3501,4264,2840,-1424
2019,11,6,9,3430,4190,2779,-1411
2019,11,6,10,3448,4237,2780,-1457
2019,11,6,11,3669,4580,3015,-1565
2019,11,6,12,4079,5171,3379,-1792
2019,11,6,13,4365,5492,3677,-1815
2019,11,6,14,4669,5745,3973,-1772
2019,11,6,15,5109,6061,4259,-1802
2019,11,6,16,5545,6455,4666,-1789
2019,11,6,17,6011,6869,5130,-1739
2019,11,6,18,6310,7235,5519,-1716
2019,11,6,19,6596,7545,5806,-1739
2019,11,6,20,6687,7788,6018,-1770
2019,11,6,21,6672,7866,6178,-1688
2019,11,6,22,6552,7778,6072,-1706
2019,11,6,23,6399,7614,5981,-1633
2019,11,7,0,6244,7571,5883,-1688
2019,11,7,1,5919,7204,5545,-1659
2019,11,7,2,5627,6798,5128,-1670
2019,11,7,3,5183,6304,4557,-1747
2019,11,7,4,4682,5657,3836,-1821
2019,11,7,5,4211,5084,3362,-1722
2019,11,7,6,3802,4181,2575,-1606
2019,11,7,7,3542,3902,2411,-1491
2019,11,7,8,3378,3719,2311,-1408
2019,11,7,9,3285,3624,2234,-1390
2019,11,7,10,3286,3678,2259,-1419
2019,11,7,11,3516,3982,2426,-1556
2019,11,7,12,3951,4534,2780,-1754
2019,11,7,13,4222,4906,3165,-1741
2019,11,7,14,4490,5267,3433,-1834
2019,11,7,15,4879,5854,3935,-1919
2019,11,7,16,5293,6458,4581,-1877
2019,11,7,17,5811,6975,5434,-1541
2019,11,7,18,6226,7552,6008,-1544
2019,11,7,19,6545,7914,6339,-1575
2019,11,7,20,6722,8117,6501,-1616
2019,11,7,21,6764,8154,6503,-1651
2019,11,7,22,6645,7995,6402,-1593
2019,11,7,23,6472,7724,6114,-1610
2019,11,8,0,6347,7586,5684,-1902
2019,11,8,1,6019,6859,5070,-1789
2019,11,8,2,5641,6681,4949,-1732
2019,11,8,3,5188,6118,4710,-1408
2019,11,8,4,4698,5450,3761,-1689
2019,11,8,5,4266,4820,2958,-1862
2019,11,8,6,4021,4806,3173,-1633
2019,11,8,7,3746,4464,2980,-1484
2019,11,8,8,3571,4290,2893,-1397
2019,11,8,9,3465,4178,2792,-1386
2019,11,8,10,3479,4200,2789,-1411
2019,11,8,11,3668,4479,2969,-1510
2019,11,8,12,4050,4999,3293,-1706
2019,11,8,13,4336,5358,3546,-1812
2019,11,8,14,4635,5714,3723,-1991
2019,11,8,15,5084,6160,4075,-2085
2019,11,8,16,5437,6586,4434,-2152
2019,11,8,17,5708,6930,4695,-2235
2019,11,8,18,5959,6946,4794,-2152
2019,11,8,19,6079,6844,4783,-2061
2019,11,8,20,6038,6639,4436,-2203
2019,11,8,21,5953,6455,4255,-2200
2019,11,8,22,5729,6327,4073,-2254
2019,11,8,23,5439,6339,4056,-2283
2019,11,9,0,5292,6293,4039,-2254
2019,11,9,1,4980,5991,3740,-2251
2019,11,9,2,4673,5703,3448,-2255
2019,11,9,3,4315,5389,3290,-2099
2019,11,9,4,3938,4952,3096,-1856
2019,11,9,5,3630,4517,3072,-1445
2019,11,9,6,3310,4152,2818,-1334
2019,11,9,7,3064,3894,2654,-1240
2019,11,9,8,2895,3725,2565,-1160
2019,11,9,9,2746,3616,2460,-1156
2019,11,9,10,2707,3618,2432,-1186
2019,11,9,11,2721,3704,2458,-1246
2019,11,9,12,2907,3935,2553,-1382
2019,11,9,13,3181,4281,2847,-1434
2019,11,9,14,3541,4732,3205,-1527
2019,11,9,15,3934,5058,3322,-1736
2019,11,9,16,4233,5270,3425,-1845
2019,11,9,17,4387,5443,3455,-1988
2019,11,9,18,4555,5599,3453,-2146
2019,11,9,19,4725,5725,3563,-2162
2019,11,9,20,4661,5781,3559,-2222
2019,11,9,21,4540,5725,3505,-2220
2019,11,9,22,4322,5628,3434,-2194
2019,11,9,23,4232,5540,3347,-2193
2019,11,10,0,4208,5615,3435,-2180
2019,11,10,1,3950,5348,3467,-1881
2019,11,10,2,3917,5067,3267,-1800
2019,11,10,3,3672,4774,3075,-1699
2019,11,10,4,3425,4419,2926,-1493
2019,11,10,5,3052,4057,2681,-1376
2019,11,10,6,2930,3764,2421,-1343
2019,11,10,7,2757,3561,2324,-1237
2019,11,10,8,2582,3453,2260,-1193
2019,11,10,9,2523,3410,2220,-1190
2019,11,10,10,2513,3416,2197,-1219
2019,11,10,11,2578,3505,2209,-1296
2019,11,10,12,2682,3712,2254,-1458
2019,11,10,13,2960,4086,2578,-1508
2019,11,10,14,3294,4576,2962,-1614
2019,11,10,15,3646,4880,3123,-1757
2019,11,10,16,3906,5049,3243,-1806
2019,11,10,17,4084,5184,3302,-1882
2019,11,10,18,4234,5418,3261,-2157
2019,11,10,19,4374,5627,3429,-2198
2019,11,10,20,4507,5823,3627,-2196
2019,11,10,21,4622,5941,3798,-2143
2019,11,10,22,4560,5952,3867,-2085
2019,11,10,23,4562,5913,3820,-2093
2019,11,11,0,4649,6009,3855,-2154
2019,11,11,1,4427,5734,3694,-2040
2019,11,11,2,4184,5413,3625,-1788
2019,11,11,3,3840,5012,3344,-1668
2019,11,11,4,3482,4552,3061,-1491
2019,11,11,5,3190,4076,2685,-1391
2019,11,11,6,2955,3735,2392,-1343
2019,11,11,7,2768,3515,2291,-1224
2019,11,11,8,2687,3414,2244,-1170
2019,11,11,9,2628,3399,2229,-1170
2019,11,11,10,2690,3494,2261,-1233
2019,11,11,11,2884,3792,2438,-1354
2019,11,11,12,3233,4290,2739,-1551
2019,11,11,13,3501,4636,3152,-1484
2019,11,11,14,3807,4914,3371,-1543
2019,11,11,15,4137,5152,3449,-1703
2019,11,11,16,4425,5444,3673,-1771
2019,11,11,17,4693,5744,3843,-1901
2019,11,11,18,4890,6051,3917,-2134
2019,11,11,19,5101,6323,4020,-2303
2019,11,11,20,5204,6558,4304,-2254
2019,11,11,21,5152,6673,4349,-2324
2019,11,11,22,5056,6656,4384,-2272
2019,11,11,23,4996,6612,4472,-2140
2019,11,12,0,5125,6702,4529,-2173
2019,11,12,1,4958,6407,4422,-1985
2019,11,12,2,4703,5995,4156,-1839
2019,11,12,3,4350,5520,3865,-1655
2019,11,12,4,3914,4943,3475,-1468
2019,11,12,5,3509,4391,2957,-1434
2019,11,12,6,3238,3977,2616,-1361
2019,11,12,7,3010,3720,2466,-1254
2019,11,12,8,2879,3572,2387,-1185
2019,11,12,9,2822,3528,2357,-1171
2019,11,12,10,2856,3610,2392,-1218
2019,11,12,11,3100,3904,2573,-1331
2019,11,12,12,3510,4447,2889,-1558
2019,11,12,13,3746,4747,3241,-1506
2019,11,12,14,3952,5013,3478,-1535
2019,11,12,15,4213,5360,3742,-1618
2019,11,12,16,4530,5750,4135,-1615
2019,11,12,17,4821,6181,4554,-1627
2019,11,12,18,5035,6552,4880,-1672
2019,11,12,19,5194,6873,5241,-1632
2019,11,12,20,5305,7035,5428,-1607
2019,11,12,21,5322,7081,5506,-1575
2019,11,12,22,5138,7007,5465,-1542
2019,11,12,23,5041,6902,5361,-1541
2019,11,13,0,5177,6931,5394,-1537
2019,11,13,1,5026,6604,5082,-1522
2019,11,13,2,4750,6248,4697,-1551
2019,11,13,3,4335,5763,4238,-1525
2019,11,13,4,3834,5182,3621,-1561
2019,11,13,5,3393,4556,3042,-1514
2019,11,13,6,3196,4094,2832,-1262
2019,11,13,7,2958,3798,2617,-1181
2019,11,13,8,2801,3629,2536,-1093
2019,11,13,9,2719,3591,2508,-1083
2019,11,13,10,2746,3703,2603,-1100
2019,11,13,11,2970,4084,2884,-1200
2019,11,13,12,3402,4699,3487,-1212
2019,11,13,13,3701,4997,3748,-1249
2019,11,13,14,3783,5090,3836,-1254
2019,11,13,15,3963,5151,3927,-1224
2019,11,13,16,4119,5162,3955,-1207
2019,11,13,17,4031,5166,3965,-1201
2019,11,13,18,4098,5189,3823,-1366
2019,11,13,19,4115,5201,3818,-1383
2019,11,13,20,4120,5158,3778,-1380
2019,11,13,21,4142,5182,3809,-1373
2019,11,13,22,4206,5284,3920,-1364
2019,11,13,23,4331,5581,4176,-1405
2019,11,14,0,4440,5817,4450,-1367
2019,11,14,1,4303,5696,4403,-1293
2019,11,14,2,4174,5484,4239,-1245
2019,11,14,3,3902,5139,3891,-1248
2019,11,14,4,3472,4685,3335,-1350
2019,11,14,5,3145,4212,2891,-1321
2019,11,14,6,2995,3882,2476,-1406
2019,11,14,7,2816,3702,2375,-1327
2019,11,14,8,2721,3619,2352,-1267
2019,11,14,9,2668,3603,2333,-1270
2019,11,14,10,2741,3703,2396,-1307
2019,11,14,11,2966,4061,2805,-1256
2019,11,14,12,3357,4659,3300,-1359
2019,11,14,13,3604,4930,3561,-1369
2019,11,14,14,3783,5065,3705,-1360
2019,11,14,15,3924,5167,3684,-1483
2019,11,14,16,4047,5306,3833,-1473
2019,11,14,17,4231,5387,3949,-1438
2019,11,14,18,4390,5482,4036,-1446
2019,11,14,19,4502,5498,3980,-1518
2019,11,14,20,4490,5537,4021,-1516
2019,11,14,21,4490,5553,4054,-1499
2019,11,14,22,4447,5692,4172,-1520
2019,11,14,23,4556,6031,4445,-1586
2019,11,15,0,4685,6224,4634,-1590
2019,11,15,1,4590,6098,4582,-1516
2019,11,15,2,4412,5873,4334,-1539
2019,11,15,3,4126,5494,3917,-1577
2019,11,15,4,3741,5009,3431,-1578
2019,11,15,5,3455,4519,3070,-1449
2019,11,15,6,3159,4156,2773,-1383
2019,11,15,7,2949,3919,2630,-1289
2019,11,15,8,2835,3810,2564,-1246
2019,11,15,9,2785,3784,2547,-1237
2019,11,15,10,2844,3854,2581,-1273
2019,11,15,11,3095,4188,2801,-1387
2019,11,15,12,3484,4760,3291,-1469
2019,11,15,13,3773,5090,3545,-1545
2019,11,15,14,4004,5273,3715,-1558
2019,11,15,15,4252,5397,3804,-1593
2019,11,15,16,4369,5542,3963,-1579
2019,11,15,17,4401,5603,4011,-1592
2019,11,15,18,4414,5606,4033,-1573
2019,11,15,19,4384,5553,3995,-1558
2019,11,15,20,4297,5484,3935,-1549
2019,11,15,21,4199,5452,3874,-1578
2019,11,15,22,4189,5490,3898,-1592
2019,11,15,23,4297,5651,4080,-1571
2019,11,16,0,4333,5706,4153,-1553
2019,11,16,1,4131,5463,3946,-1517
2019,11,16,2,3929,5242,3706,-1536
2019,11,16,3,3749,4956,3418,-1538
2019,11,16,4,3456,4604,3028,-1576
2019,11,16,5,3110,4211,2749,-1462
2019,11,16,6,2937,3910,2537,-1373
2019,11,16,7,2722,3702,2448,-1254
2019,11,16,8,2566,3578,2383,-1195
2019,11,16,9,2479,3525,2328,-1197
2019,11,16,10,2456,3524,2307,-1217
2019,11,16,11,2514,3673,2362,-1311
2019,11,16,12,2659,3954,2501,-1453
2019,11,16,13,2903,4336,2800,-1536
2019,11,16,14,3332,4805,3173,-1632
2019,11,16,15,3688,5129,3446,-1683
2019,11,16,16,3836,5231,3539,-1692
2019,11,16,17,3936,5252,3540,-1712
2019,11,16,18,3939,5261,3493,-1768
2019,11,16,19,3835,5179,3420,-1759
2019,11,16,20,3749,5182,3399,-1783
2019,11,16,21,3709,5230,3439,-1791
2019,11,16,22,3725,5311,3529,-1782
2019,11,16,23,3982,5546,3754,-1792
2019,11,17,0,4108,5663,4033,-1630
2019,11,17,1,4022,5512,3882,-1630
2019,11,17,2,3879,5375,3711,-1664
2019,11,17,3,3678,5139,3463,-1676
2019,11,17,4,3459,4836,3168,-1668
2019,11,17,5,3138,4499,2939,-1560
2019,11,17,6,3197,4250,2735,-1515
2019,11,17,7,3035,4044,2635,-1409
2019,11,17,8,2969,3939,2598,-1341
2019,11,17,9,2973,3919,2575,-1344
2019,11,17,10,3071,3980,2614,-1366
2019,11,17,11,3187,4105,2668,-1437
2019,11,17,12,3339,4420,2813,-1607
2019,11,17,13,3663,4870,3213,-1657
2019,11,17,14,3850,5421,3733,-1688
2019,11,17,15,4054,5734,4044,-1690
2019,11,17,16,4029,5783,4086,-1697
2019,11,17,17,3974,5752,4172,-1580
2019,11,17,18,3833,5714,4102,-1612
2019,11,17,19,3794,5626,3988,-1638
2019,11,17,20,3792,5590,3930,-1660
2019,11,17,21,3794,5596,3880,-1716
2019,11,17,22,3781,5712,3961,-1751
2019,11,17,23,3926,6016,4110,-1906
2019,11,18,0,4255,6218,4333,-1885
2019,11,18,1,4167,6105,4237,-1868
2019,11,18,2,4051,5905,4034,-1871
2019,11,18,3,3819,5549,3752,-1797
2019,11,18,4,3494,5116,3292,-1824
2019,11,18,5,3184,4666,3066,-1600
2019,11,18,6,3052,4374,2837,-1537
2019,11,18,7,2900,4188,2787,-1401
2019,11,18,8,2833,4121,2746,-1375
2019,11,18,9,2810,4107,2734,-1373
2019,11,18,10,2920,4254,2879,-1375
2019,11,18,11,3250,4701,3287,-1414
2019,11,18,12,3744,5425,3935,-1490
2019,11,18,13,4019,5766,4279,-1487
2019,11,18,14,4078,5682,4131,-1551
2019,11,18,15,4092,5480,3878,-1602
2019,11,18,16,4124,5255,3636,-1619
2019,11,18,17,4112,5146,3483,-1663
2019,11,18,18,4120,5074,3432,-1642
2019,11,18,19,4137,5059,3431,-1628
2019,11,18,20,4097,5033,3417,-1616
2019,11,18,21,4155,5068,3442,-1626
2019,11,18,22,4177,5163,3583,-1580
2019,11,18,23,4333,5433,3811,-1622
2019,11,19,0,4491,5762,4067,-1695
2019,11,19,1,4350,5684,4005,-1679
2019,11,19,2,4132,5436,3788,-1648
2019,11,19,3,3829,5094,3420,-1674
2019,11,19,4,3440,4649,3017,-1632
2019,11,19,5,3105,4214,2776,-1438
2019,11,19,6,2897,3943,2514,-1429
2019,11,19,7,2756,3795,2464,-1331
2019,11,19,8,2693,3752,2449,-1303
2019,11,19,9,2690,3782,2443,-1339
2019,11,19,10,2780,3973,2659,-1314
2019,11,19,11,3063,4448,3146,-1302
2019,11,19,12,3555,5192,3841,-1351
2019,11,19,13,3830,5524,4159,-1365
2019,11,19,14,3885,5433,4066,-1367
2019,11,19,15,3957,5281,3847,-1434
2019,11,19,16,4067,5192,3685,-1507
2019,11,19,17,4036,5114,3573,-1541
2019,11,19,18,4051,5044,3507,-1537
2019,11,19,19,4017,4991,3463,-1528
2019,11,19,20,4022,4973,3453,-1520
2019,11,19,21,4054,5021,3520,-1501
2019,11,19,22,4115,5118,3593,-1525
2019,11,19,23,4281,5423,3901,-1522
2019,11,20,0,4497,5796,4212,-1584
2019,11,20,1,4311,5714,4169,-1545
2019,11,20,2,4126,5540,4062,-1478
2019,11,20,3,3849,5244,3611,-1633
2019,11,20,4,3507,4855,3157,-1698
2019,11,20,5,3236,4456,2886,-1570
2019,11,20,6,2910,4242,2845,-1397
2019,11,20,7,2812,4158,2822,-1336
2019,11,20,8,2744,4140,2699,-1441
2019,11,20,9,2773,4208,2726,-1482
2019,11,20,10,2930,4415,3026,-1389
2019,11,20,11,3260,4958,3624,-1334
2019,11,20,12,3855,5724,4236,-1488
2019,11,20,13,4096,6070,4640,-1430
2019,11,20,14,4038,5826,4477,-1349
2019,11,20,15,4071,5449,4123,-1326
2019,11,20,16,4100,5226,3849,-1377
2019,11,20,17,4071,5089,3678,-1411
2019,11,20,18,4047,5030,3546,-1484
2019,11,20,19,4055,5011,3487,-1524
2019,11,20,20,4089,5007,3441,-1566
2019,11,20,21,4139,5094,3516,-1578
2019,11,20,22,4160,5201,3595,-1606
2019,11,20,23,4268,5453,3733,-1720
2019,11,21,0,4442,5477,3699,-1778
2019,11,21,1,4341,5711,3971,-1740
2019,11,21,2,4144,5465,3699,-1766
2019,11,21,3,3853,5165,3494,-1671
2019,11,21,4,3487,4756,3147,-1609
2019,11,21,5,3121,4340,2773,-1567
2019,11,21,6,2908,4091,2595,-1496
2019,11,21,7,2824,3995,2558,-1437
2019,11,21,8,2761,4006,2598,-1408
2019,11,21,9,2773,4085,2644,-1441
2019,11,21,10,2897,4288,2784,-1504
2019,11,21,11,3215,4802,3289,-1513
2019,11,21,12,3806,5551,3969,-1582
2019,11,21,13,4038,5878,4287,-1591
2019,11,21,14,4026,5684,4094,-1590
2019,11,21,15,4042,5396,3779,-1617
2019,11,21,16,4115,5200,3547,-1653
2019,11,21,17,4119,5129,3509,-1620
2019,11,21,18,4109,5139,3538,-1601
2019,11,21,19,4129,5140,3674,-1466
2019,11,21,20,4171,5214,3726,-1488
2019,11,21,21,4212,5248,3767,-1481
2019,11,21,22,4237,5333,3916,-1417
2019,11,21,23,4332,5527,4168,-1359
2019,11,22,0,4475,5757,4412,-1345
2019,11,22,1,4364,5633,4328,-1305
2019,11,22,2,4165,5429,4069,-1360
2019,11,22,3,3856,5089,3728,-1361
2019,11,22,4,3476,4616,3262,-1354
2019,11,22,5,3121,4145,2787,-1358
2019,11,22,6,2876,3881,2468,-1413
2019,11,22,7,2754,3729,2424,-1305
2019,11,22,8,2668,3663,2399,-1264
2019,11,22,9,2666,3690,2404,-1286
2019,11,22,10,2751,3813,2490,-1323
2019,11,22,11,3037,4207,2768,-1439
2019,11,22,12,3540,4867,3247,-1620
2019,11,22,13,3808,5205,3604,-1601
2019,11,22,14,3869,5194,3564,-1630
2019,11,22,15,3948,5136,3506,-1630
2019,11,22,16,3997,5161,3559,-1602
2019,11,22,17,4067,5217,3576,-1641
2019,11,22,18,4111,5346,3656,-1690
2019,11,22,19,4232,5460,3776,-1684
2019,11,22,20,4302,5544,3807,-1737
2019,11,22,21,4351,5581,3790,-1791
2019,11,22,22,4334,5597,3902,-1695
2019,11,22,23,4360,5648,3922,-1726
2019,11,23,0,4433,5714,3940,-1774
2019,11,23,1,4316,5467,3747,-1720
2019,11,23,2,4113,5234,3507,-1727
2019,11,23,3,3867,4954,3321,-1633
2019,11,23,4,3574,4575,3024,-1551
2019,11,23,5,3120,4181,2779,-1402
2019,11,23,6,2828,3896,2649,-1247
2019,11,23,7,2702,3697,2572,-1125
2019,11,23,8,2592,3586,2498,-1088
2019,11,23,9,2537,3564,2438,-1126
2019,11,23,10,2550,3615,2458,-1157
2019,11,23,11,2615,3781,2598,-1183
2019,11,23,12,2791,4051,2777,-1274
2019,11,23,13,3021,4380,2897,-1483
2019,11,23,14,3406,4767,3088,-1679
2019,11,23,15,3784,4994,3288,-1706
2019,11,23,16,4046,5130,3229,-1901
2019,11,23,17,4144,5284,3325,-1959
2019,11,23,18,4320,5440,3427,-2013
2019,11,23,19,4486,5565,3577,-1988
2019,11,23,20,4627,5656,3646,-2010
2019,11,23,21,4740,5694,3696,-1998
2019,11,23,22,4747,5609,3625,-1984
2019,11,23,23,4681,5645,3642,-2003
2019,11,24,0,4677,5692,3731,-1961
2019,11,24,1,4505,5453,3501,-1952
2019,11,24,2,4259,5176,3261,-1915
2019,11,24,3,3992,4925,3027,-1898
2019,11,24,4,3652,4606,3091,-1515
2019,11,24,5,3285,4264,3017,-1247
2019,11,24,6,2954,3986,2834,-1152
2019,11,24,7,2771,3762,2698,-1064
2019,11,24,8,2650,3615,2586,-1029
2019,11,24,9,2593,3533,2501,-1032
2019,11,24,10,2552,3487,2518,-969
2019,11,24,11,2590,3542,2499,-1043
2019,11,24,12,2719,3759,2596,-1163
2019,11,24,13,2918,4032,2797,-1235
2019,11,24,14,3329,4548,3185,-1363
2019,11,24,15,3708,4914,3489,-1425
2019,11,24,16,3950,5073,3629,-1444
2019,11,24,17,4068,5142,3584,-1558
2019,11,24,18,4151,5221,3524,-1697
2019,11,24,19,4200,5220,3527,-1693
2019,11,24,20,4164,5214,3519,-1695
2019,11,24,21,4148,5215,3565,-1650
2019,11,24,22,4070,5206,3561,-1645
2019,11,24,23,4068,5382,3662,-1720
2019,11,25,0,4115,5616,3884,-1732
2019,11,25,1,4075,5450,3717,-1733
2019,11,25,2,3907,5276,3610,-1666
2019,11,25,3,3677,4995,3302,-1693
2019,11,25,4,3320,4651,3126,-1525
2019,11,25,5,2952,4307,2936,-1371
2019,11,25,6,2731,4064,2783,-1281
2019,11,25,7,2601,3936,2689,-1247
2019,11,25,8,2570,3906,2649,-1257
2019,11,25,9,2615,3962,2689,-1273
2019,11,25,10,2731,4150,2782,-1368
2019,11,25,11,3065,4638,3283,-1355
2019,11,25,12,3617,5264,3742,-1522
2019,11,25,13,3981,5799,4424,-1375
2019,11,25,14,3925,5821,4371,-1450
2019,11,25,15,3988,5637,4137,-1500
2019,11,25,16,4045,5429,3986,-1443
2019,11,25,17,3963,5249,3779,-1470
2019,11,25,18,3992,5157,3727,-1430
2019,11,25,19,3997,5060,3677,-1383
2019,11,25,20,3954,5052,3686,-1366
2019,11,25,21,3945,5069,3708,-1361
2019,11,25,22,3940,5157,3771,-1386
2019,11,25,23,4114,5453,3973,-1480
2019,11,26,0,4247,5778,4199,-1579
2019,11,26,1,4210,5704,4121,-1583
2019,11,26,2,3994,5522,3949,-1573
2019,11,26,3,3772,5333,3781,-1552
2019,11,26,4,3473,5023,3572,-1451
2019,11,26,5,3222,4664,3269,-1395
2019,11,26,6,2982,4438,3118,-1320
2019,11,26,7,2840,4335,3015,-1320
2019,11,26,8,2772,4319,2979,-1340
2019,11,26,9,2798,4385,3015,-1370
2019,11,26,10,2960,4548,3120,-1428
2019,11,26,11,3282,4997,3437,-1560
2019,11,26,12,3838,5615,3791,-1824
2019,11,26,13,4154,6010,3980,-2030
2019,11,26,14,4049,5939,4014,-1925
2019,11,26,15,4042,5625,3848,-1777
2019,11,26,16,4092,5340,3731,-1609
2019,11,26,17,4070,5146,3562,-1584
2019,11,26,18,4059,5076,3333,-1743
2019,11,26,19,4038,5040,3258,-1782
2019,11,26,20,4024,5057,3281,-1776
2019,11,26,21,4000,5084,3295,-1789
2019,11,26,22,4046,5146,3328,-1818
2019,11,26,23,4157,5420,3514,-1906
2019,11,27,0,4341,5709,3712,-1997
2019,11,27,1,4308,5620,3662,-1958
2019,11,27,2,4142,5431,3582,-1849
2019,11,27,3,3837,5157,3524,-1633
2019,11,27,4,3521,4779,3419,-1360
2019,11,27,5,3188,4407,3128,-1279
2019,11,27,6,2880,4118,2921,-1197
2019,11,27,7,2737,3990,2779,-1211
2019,11,27,8,2645,3951,2729,-1222
2019,11,27,9,2662,3990,2755,-1235
2019,11,27,10,2737,4165,2903,-1262
2019,11,27,11,2958,4511,3118,-1393
2019,11,27,12,3342,5024,3490,-1534
2019,11,27,13,3662,5422,3819,-1603
2019,11,27,14,3838,5484,3908,-1576
2019,11,27,15,3961,5385,3689,-1696
2019,11,27,16,4073,5339,3466,-1873
2019,11,27,17,4145,5333,3489,-1844
2019,11,27,18,4282,5386,3521,-1865
2019,11,27,19,4455,5476,3622,-1854
2019,11,27,20,4556,5616,3738,-1878
2019,11,27,21,4625,5714,3809,-1905
2019,11,27,22,4714,5748,3838,-1910
2019,11,27,23,4746,5852,3895,-1957
2019,11,28,0,4699,5976,3966,-2010
2019,11,28,1,4631,5725,3779,-1946
2019,11,28,2,4433,5471,3606,-1865
2019,11,28,3,4138,5164,3572,-1592
2019,11,28,4,3789,4778,3479,-1299
2019,11,28,5,3381,4310,3114,-1196
2019,11,28,6,3034,3919,2994,-925
2019,11,28,7,2786,3653,2821,-832
2019,11,28,8,2667,3480,2681,-799
2019,11,28,9,2597,3419,2644,-775
2019,11,28,10,2590,3445,2661,-784
2019,11,28,11,2726,3571,2739,-832
2019,11,28,12,2876,3816,2938,-878
2019,11,28,13,3125,4218,3208,-1010
2019,11,28,14,3561,4820,3406,-1414
2019,11,28,15,4002,5431,3890,-1541
2019,11,28,16,4412,5853,4217,-1636
2019,11,28,17,4662,6167,4693,-1474
2019,11,28,18,4819,6386,4921,-1465
2019,11,28,19,4867,6397,5027,-1370
2019,11,28,20,4863,6323,5010,-1313
2019,11,28,21,4761,6151,4902,-1249
2019,11,28,22,4538,5818,4656,-1162
2019,11,28,23,4279,5333,4196,-1137
2019,11,29,0,4143,5186,3928,-1258
2019,11,29,1,3964,4903,3638,-1265
2019,11,29,2,3752,4672,3330,-1342
2019,11,29,3,3562,4507,3294,-1213
2019,11,29,4,3275,4279,3287,-992
2019,11,29,5,3155,3969,3084,-885
2019,11,29,6,2933,3709,2897,-812
2019,11,29,7,2748,3511,2721,-790
2019,11,29,8,2617,3422,2641,-781
2019,11,29,9,2549,3414,2621,-793
2019,11,29,10,2561,3493,2650,-843
2019,11,29,11,2652,3696,2791,-905
2019,11,29,12,2821,4037,3035,-1002
2019,11,29,13,3022,4352,3235,-1117
2019,11,29,14,3279,4663,3469,-1194
2019,11,29,15,3543,4831,3646,-1185
2019,11,29,16,3762,4917,3743,-1174
2019,11,29,17,3909,5008,3828,-1180
2019,11,29,18,4023,5080,3924,-1156
2019,11,29,19,4158,5188,4012,-1176
2019,11,29,20,4211,5290,4098,-1192
2019,11,29,21,4280,5371,4144,-1227
2019,11,29,22,4230,5372,4155,-1217
2019,11,29,23,4268,5419,4193,-1226
2019,11,30,0,4321,5513,4255,-1258
2019,11,30,1,4151,5299,4100,-1199
2019,11,30,2,3974,5060,3886,-1174
2019,11,30,3,3787,4808,3694,-1114
2019,11,30,4,3523,4485,3421,-1064
2019,11,30,5,3233,4136,3184,-952
2019,11,30,6,2941,3826,2955,-871
2019,11,30,7,2790,3618,2769,-849
2019,11,30,8,2654,3503,2645,-858
2019,11,30,9,2583,3480,2623,-857
2019,11,30,10,2562,3528,2637,-891
2019,11,30,11,2615,3672,2741,-931
2019,11,30,12,2737,3924,2918,-1006
2019,11,30,13,2937,4226,3135,-1091
2019,11,30,14,3354,4639,3457,-1182
2019,11,30,15,3558,4903,3695,-1208
2019,11,30,16,3905,5069,3858,-1211
2019,11,30,17,4078,5212,3977,-1235
2019,11,30,18,4224,5336,4082,-1254
2019,11,30,19,4331,5512,4231,-1281
2019,11,30,20,4436,5667,4367,-1300
2019,11,30,21,4529,5811,4483,-1328
2019,11,30,22,4535,5762,4473,-1289
2019,11,30,23,4554,5707,4426,-1281
2019,12,1,0,4611,5757,4455,-1302
2019,12,1,1,4402,5449,4215,-1234
2019,12,1,2,4157,5171,3967,-1204
2019,12,1,3,3905,4916,3797,-1119
2019,12,1,4,3605,4563,3526,-1037
2019,12,1,5,3334,4189,3253,-936
2019,12,1,6,3006,3866,2992,-874
2019,12,1,7,2826,3614,2787,-827
2019,12,1,8,2692,3467,2655,-812
2019,12,1,9,2677,3425,2627,-798
2019,12,1,10,2595,3444,2655,-789
2019,12,1,11,2675,3531,2697,-834
2019,12,1,12,2813,3722,2832,-890
2019,12,1,13,3008,3975,3011,-964
2019,12,1,14,3427,4426,3080,-1346
2019,12,1,15,3854,4837,3408,-1429
2019,12,1,16,4152,5166,3545,-1621
2019,12,1,17,4377,5446,3751,-1695
2019,12,1,18,4653,5741,3973,-1768
2019,12,1,19,4828,5916,4195,-1721
2019,12,1,20,4963,6065,4353,-1712
2019,12,1,21,4979,6142,4464,-1678
2019,12,1,22,4943,6156,4482,-1674
2019,12,1,23,4966,6307,4580,-1727
2019,12,2,0,4994,6512,4736,-1776
2019,12,2,1,4849,6320,4692,-1628
2019,12,2,2,4722,5990,4415,-1575
2019,12,2,3,4316,5656,4210,-1446
2019,12,2,4,3839,5163,4017,-1146
2019,12,2,5,3313,4645,3637,-1008
2019,12,2,6,3012,4248,3319,-929
2019,12,2,7,2836,3975,3101,-874
2019,12,2,8,2747,3796,2955,-841
2019,12,2,9,2768,3682,2862,-820
2019,12,2,10,2781,3693,2847,-846
2019,12,2,11,3089,3965,3038,-927
2019,12,2,12,3528,4500,3437,-1063
2019,12,2,13,3780,4803,3685,-1118
2019,12,2,14,3779,4963,3810,-1153
2019,12,2,15,3862,5044,3862,-1182
2019,12,2,16,4048,5118,3931,-1187
2019,12,2,17,4052,5122,3930,-1192
2019,12,2,18,4015,5105,3931,-1174
2019,12,2,19,3856,5075,3923,-1152
2019,12,2,20,3812,5051,3908,-1143
2019,12,2,21,3827,5072,3926,-1146
2019,12,2,22,4002,5207,4024,-1183
2019,12,2,23,4161,5677,4411,-1266
2019,12,3,0,4448,6159,4761,-1398
2019,12,3,1,4505,6180,4845,-1335
2019,12,3,2,4373,6071,4740,-1331
2019,12,3,3,4215,5809,4483,-1326
2019,12,3,4,3946,5415,4124,-1291
2019,12,3,5,3873,5037,3731,-1306
2019,12,3,6,3675,4812,3504,-1308
2019,12,3,7,3596,4750,3423,-1327
2019,12,3,8,3644,4793,3468,-1325
2019,12,3,9,3731,4938,3575,-1363
2019,12,3,10,3970,5252,3860,-1392
2019,12,3,11,4502,5883,4448,-1435
2019,12,3,12,5323,6843,5368,-1475
2019,12,3,13,5715,7298,5879,-1419
2019,12,3,14,5365,7079,5613,-1466
2019,12,3,15,5008,6648,5220,-1428
2019,12,3,16,4526,6225,4713,-1512
2019,12,3,17,4365,5838,4330,-1508
2019,12,3,18,4205,5556,4059,-1497
2019,12,3,19,4084,5371,3926,-1445
2019,12,3,20,4058,5275,3863,-1412
2019,12,3,21,4065,5290,3867,-1423
2019,12,3,22,4092,5519,4030,-1489
2019,12,3,23,4432,6141,4537,-1604
2019,12,4,0,4796,6721,5191,-1530
2019,12,4,1,4873,6840,5424,-1416
2019,12,4,2,4801,6743,5255,-1488
2019,12,4,3,4609,6462,4987,-1475
2019,12,4,4,4260,5986,4586,-1400
2019,12,4,5,3929,5505,4252,-1253
2019,12,4,6,3677,5189,3895,-1294
2019,12,4,7,3556,5027,3754,-1273
2019,12,4,8,3496,4973,3684,-1289
2019,12,4,9,3520,4998,3737,-1261
2019,12,4,10,3626,5175,3911,-1264
2019,12,4,11,3961,5649,4458,-1191
2019,12,4,12,4523,6419,5249,-1170
2019,12,4,13,4785,6710,5490,-1220
2019,12,4,14,4637,6470,5219,-1251
2019,12,4,15,4520,6059,4794,-1265
2019,12,4,16,4412,5738,4407,-1331
2019,12,4,17,4295,5468,4183,-1285
2019,12,4,18,4052,5248,4038,-1210
2019,12,4,19,3957,5119,3971,-1148
2019,12,4,20,3889,5001,3896,-1105
2019,12,4,21,3953,5033,3920,-1113
2019,12,4,22,4039,5201,4036,-1165
2019,12,4,23,4265,5699,4378,-1321
2019,12,5,0,4534,6231,4817,-1414
2019,12,5,1,4512,6326,4956,-1370
2019,12,5,2,4431,6268,4886,-1382
2019,12,5,3,4232,6079,4712,-1367
2019,12,5,4,3927,5679,4291,-1388
2019,12,5,5,3633,5284,3980,-1304
2019,12,5,6,3570,5049,3755,-1294
2019,12,5,7,3454,4947,3641,-1306
2019,12,5,8,3488,4944,3627,-1317
2019,12,5,9,3554,5028,3678,-1350
2019,12,5,10,3683,5278,3889,-1389
2019,12,5,11,4092,5847,4436,-1411
2019,12,5,12,4731,6711,5386,-1325
2019,12,5,13,5056,7027,5784,-1243
2019,12,5,14,4921,6731,5501,-1230
2019,12,5,15,4620,6175,4853,-1322
2019,12,5,16,4456,5764,4434,-1330
2019,12,5,17,4366,5435,4149,-1286
2019,12,5,18,4124,5265,4043,-1222
2019,12,5,19,4030,5150,3988,-1162
2019,12,5,20,3961,5069,3943,-1126
2019,12,5,21,3988,5044,3922,-1122
2019,12,5,22,4041,5162,4010,-1152
2019,12,5,23,4264,5593,4297,-1296
2019,12,6,0,4569,6078,4698,-1380
2019,12,6,1,4551,6180,4820,-1360
2019,12,6,2,4478,6128,4781,-1347
2019,12,6,3,4279,5945,4547,-1398
2019,12,6,4,3942,5551,4181,-1370
2019,12,6,5,3621,5155,3867,-1288
2019,12,6,6,3226,4911,3658,-1253
2019,12,6,7,3062,4822,3571,-1251
2019,12,6,8,2996,4843,3557,-1286
2019,12,6,9,3007,4920,3600,-1320
2019,12,6,10,3067,5170,3825,-1345
2019,12,6,11,3430,5693,4356,-1337
2019,12,6,12,4026,6530,5280,-1250
2019,12,6,13,4302,6881,5678,-1203
2019,12,6,14,4205,6566,5388,-1178
2019,12,6,15,4153,5990,4816,-1174
2019,12,6,16,4158,5551,4378,-1173
2019,12,6,17,4104,5291,4101,-1190
2019,12,6,18,4065,5154,4011,-1143
2019,12,6,19,4046,5071,3975,-1096
2019,12,6,20,4039,5058,3939,-1119
2019,12,6,21,4047,5086,3950,-1136
2019,12,6,22,4069,5196,4093,-1103
2019,12,6,23,4225,5451,4304,-1147
2019,12,7,0,4365,5691,4585,-1106
2019,12,7,1,4247,5567,4501,-1066
2019,12,7,2,4106,5450,4374,-1076
2019,12,7,3,3847,5280,4167,-1113
2019,12,7,4,3570,5021,3928,-1093
2019,12,7,5,3212,4696,3541,-1155
2019,12,7,6,3034,4443,3330,-1113
2019,12,7,7,2883,4315,3297,-1018
2019,12,7,8,2812,4288,3274,-1014
2019,12,7,9,2804,4327,3298,-1029
2019,12,7,10,2837,4455,3392,-1063
2019,12,7,11,3010,4687,3674,-1013
2019,12,7,12,3260,5108,4085,-1023
2019,12,7,13,3571,5517,4468,-1049
2019,12,7,14,3814,5737,4554,-1183
2019,12,7,15,3965,5583,4512,-1071
2019,12,7,16,3946,5343,4279,-1064
2019,12,7,17,3991,5146,4081,-1065
2019,12,7,18,3986,5059,3955,-1104
2019,12,7,19,3939,5022,3936,-1086
2019,12,7,20,3994,5048,3971,-1077
2019,12,7,21,4021,5089,4009,-1080
2019,12,7,22,4044,5187,4098,-1089
2019,12,7,23,4123,5353,4228,-1125
2019,12,8,0,4260,5508,4370,-1138
2019,12,8,1,4099,5355,4232,-1123
2019,12,8,2,3941,5178,4076,-1102
2019,12,8,3,3746,4963,3839,-1124
2019,12,8,4,3520,4664,3610,-1054
2019,12,8,5,3206,4272,3310,-962
2019,12,8,6,2956,3958,3060,-898
2019,12,8,7,2766,3736,2879,-857
2019,12,8,8,2645,3625,2788,-837
2019,12,8,9,2624,3577,2764,-813
2019,12,8,10,2592,3586,2758,-828
2019,12,8,11,2726,3717,2821,-896
2019,12,8,12,2890,3974,3032,-942
2019,12,8,13,3068,4281,3263,-1018
2019,12,8,14,3402,4691,3568,-1123
2019,12,8,15,3702,4940,3794,-1146
2019,12,8,16,3850,5100,3977,-1123
2019,12,8,17,3996,5208,4118,-1090
2019,12,8,18,4120,5357,4193,-1164
2019,12,8,19,4164,5468,4286,-1182
2019,12,8,20,4292,5575,4417,-1158
2019,12,8,21,4427,5679,4552,-1127
2019,12,8,22,4421,5742,4643,-1099
2019,12,8,23,4478,5887,4741,-1146
2019,12,9,0,4712,6130,4938,-1192
2019,12,9,1,4566,5942,4939,-1003
2019,12,9,2,4371,5668,4595,-1073
2019,12,9,3,4044,5241,4170,-1071
2019,12,9,4,3667,4756,3697,-1059
2019,12,9,5,3261,4205,3268,-937
2019,12,9,6,2965,3804,2962,-842
2019,12,9,7,2759,3553,2755,-798
2019,12,9,8,2658,3437,2668,-769
2019,12,9,9,2630,3400,2626,-774
2019,12,9,10,2702,3523,2715,-808
2019,12,9,11,2988,3898,2983,-915
2019,12,9,12,3444,4542,3465,-1077
2019,12,9,13,3687,4871,3874,-997
2019,12,9,14,3809,4969,4046,-923
2019,12,9,15,4002,5062,4150,-912
2019,12,9,16,4190,5195,4211,-984
2019,12,9,17,4371,5368,4347,-1021
2019,12,9,18,4582,5561,4395,-1166
2019,12,9,19,4745,5747,4649,-1098
2019,12,9,20,4865,5873,4834,-1039
2019,12,9,21,4980,5974,4933,-1041
2019,12,9,22,5022,6031,4997,-1034
2019,12,9,23,5044,6194,5056,-1138
2019,12,10,0,5152,6476,5324,-1152
2019,12,10,1,5054,6298,5157,-1141
2019,12,10,2,4810,5963,4825,-1138
2019,12,10,3,4461,5517,4352,-1165
2019,12,10,4,3994,4931,3841,-1090
2019,12,10,5,3535,4303,3368,-935
2019,12,10,6,3165,3898,3039,-859
2019,12,10,7,2930,3608,2808,-800
2019,12,10,8,2799,3496,2724,-772
2019,12,10,9,2752,3440,2709,-731
2019,12,10,10,2798,3526,2727,-799
2019,12,10,11,3072,3860,2968,-892
2019,12,10,12,3535,4470,3421,-1049
2019,12,10,13,3778,4731,3723,-1008
2019,12,10,14,3893,4856,3848,-1008
2019,12,10,15,4082,5065,4078,-987
2019,12,10,16,4314,5362,4282,-1080
2019,12,10,17,4658,5640,4542,-1098
2019,12,10,18,4959,5941,4829,-1112
2019,12,10,19,5176,6214,5089,-1125
2019,12,10,20,5314,6392,5328,-1064
2019,12,10,21,5436,6508,5479,-1029
2019,12,10,22,5461,6557,5510,-1047
2019,12,10,23,5475,6662,5607,-1055
2019,12,11,0,5521,6909,5790,-1119
2019,12,11,1,5256,6694,5584,-1110
2019,12,11,2,5009,6362,5238,-1124
2019,12,11,3,4677,5914,4795,-1119
2019,12,11,4,4217,5329,4227,-1102
2019,12,11,5,3761,4693,3707,-986
2019,12,11,6,3454,4230,3367,-863
2019,12,11,7,3177,3938,3124,-814
2019,12,11,8,3044,3767,2981,-786
2019,12,11,9,2977,3714,2931,-783
2019,12,11,10,3019,3763,2944,-819
2019,12,11,11,3259,4077,3158,-919
2019,12,11,12,3697,4649,3574,-1075
2019,12,11,13,3938,4988,4021,-967
2019,12,11,14,4075,5178,4376,-802
2019,12,11,15,4243,5414,4551,-863
2019,12,11,16,4430,5620,4876,-744
2019,12,11,17,4551,5802,5090,-712
2019,12,11,18,4645,5967,5182,-785
2019,12,11,19,4749,6074,5371,-703
2019,12,11,20,4841,6150,5407,-743
2019,12,11,21,4870,6066,5383,-683
2019,12,11,22,4815,6002,5285,-717
2019,12,11,23,4905,6175,5421,-754
2019,12,12,0,5137,6353,5611,-742
2019,12,12,1,4976,6116,5467,-649
2019,12,12,2,4708,5838,5099,-739
2019,12,12,3,4386,5449,4699,-750
2019,12,12,4,3959,4906,4089,-817
2019,12,12,5,3479,4332,3492,-840
2019,12,12,6,3046,3941,3081,-860
2019,12,12,7,2843,3719,2894,-825
2019,12,12,8,2730,3621,2796,-825
2019,12,12,9,2702,3592,2776,-816
2019,12,12,10,2786,3696,2845,-851
2019,12,12,11,3029,4050,3098,-952
2019,12,12,12,3493,4688,3547,-1141
2019,12,12,13,3749,5036,3892,-1144
2019,12,12,14,3847,5159,4038,-1121
2019,12,12,15,3933,5290,4118,-1172
2019,12,12,16,3979,5406,4137,-1269
2019,12,12,17,4129,5510,4341,-1169
2019,12,12,18,4184,5552,4300,-1252
2019,12,12,19,4275,5592,4321,-1271
2019,12,12,20,4325,5624,4269,-1355
2019,12,12,21,4333,5634,4247,-1387
2019,12,12,22,4337,5688,4226,-1462
2019,12,12,23,4562,6027,4496,-1531
2019,12,13,0,4733,6331,4764,-1567
2019,12,13,1,4609,6157,4770,-1387
2019,12,13,2,4467,5959,4581,-1378
2019,12,13,3,4224,5576,4282,-1294
2019,12,13,4,3856,5093,3992,-1101
2019,12,13,5,3418,4524,3567,-957
2019,12,13,6,3123,4112,3239,-873
2019,12,13,7,2914,3854,3023,-831
2019,12,13,8,2794,3700,2893,-807
2019,12,13,9,2738,3654,2857,-797
2019,12,13,10,2796,3717,2873,-844
2019,12,13,11,3056,4022,3100,-922
2019,12,13,12,3527,4625,3572,-1053
2019,12,13,13,3792,5023,3902,-1121
2019,12,13,14,3926,5213,4075,-1138
2019,12,13,15,4076,5384,4192,-1192
2019,12,13,16,4197,5527,4209,-1318
2019,12,13,17,4349,5616,4278,-1338
2019,12,13,18,4465,5614,4287,-1327
2019,12,13,19,4565,5595,4321,-1274
2019,12,13,20,4629,5539,4266,-1273
2019,12,13,21,4627,5515,4238,-1277
2019,12,13,22,4573,5585,4285,-1300
2019,12,13,23,4657,5824,4456,-1368
2019,12,14,0,4774,5970,4511,-1459
2019,12,14,1,4617,5785,4278,-1507
2019,12,14,2,4436,5588,4206,-1382
2019,12,14,3,4195,5315,3999,-1316
2019,12,14,4,3907,4953,3822,-1131
2019,12,14,5,3615,4525,3497,-1028
2019,12,14,6,3298,4142,3205,-937
2019,12,14,7,3053,3908,3049,-859
2019,12,14,8,2924,3748,2913,-835
2019,12,14,9,2851,3705,2891,-814
2019,12,14,10,2811,3724,2884,-840
2019,12,14,11,2901,3822,2942,-880
2019,12,14,12,3102,4057,3118,-939
2019,12,14,13,3313,4355,3477,-878
2019,12,14,14,3706,4750,3937,-813
2019,12,14,15,3943,5139,4151,-988
2019,12,14,16,4135,5388,4192,-1196
2019,12,14,17,4233,5517,4306,-1211
2019,12,14,18,4328,5564,4387,-1177
2019,12,14,19,4370,5575,4325,-1250
2019,12,14,20,4342,5550,4318,-1232
2019,12,14,21,4278,5521,4287,-1234
2019,12,14,22,4221,5441,4206,-1235
2019,12,14,23,4265,5438,4104,-1334
2019,12,15,0,4427,5565,4070,-1495
2019,12,15,1,4191,5382,3919,-1463
2019,12,15,2,4104,5201,3768,-1433
2019,12,15,3,3871,4999,3635,-1364
2019,12,15,4,3638,4702,3562,-1140
2019,12,15,5,3318,4360,3303,-1057
2019,12,15,6,3099,4059,3082,-977
2019,12,15,7,2836,3887,2920,-967
2019,12,15,8,2735,3818,2853,-965
2019,12,15,9,2636,3804,2828,-976
2019,12,15,10,2665,3904,2884,-1020
2019,12,15,11,2767,4101,3016,-1085
2019,12,15,12,2971,4416,3212,-1204
2019,12,15,13,3279,4877,3532,-1345
2019,12,15,14,3530,5294,3858,-1436
2019,12,15,15,3746,5350,3944,-1406
2019,12,15,16,3755,5249,3957,-1292
2019,12,15,17,3853,5159,3933,-1226
2019,12,15,18,4000,5110,3897,-1213
2019,12,15,19,4018,5114,3936,-1178
2019,12,15,20,4100,5164,3978,-1186
2019,12,15,21,4103,5231,4046,-1185
2019,12,15,22,4112,5294,4097,-1197
2019,12,15,23,4292,5494,4239,-1255
2019,12,16,0,4497,5818,4464,-1354
2019,12,16,1,4329,5709,4401,-1308
2019,12,16,2,4131,5517,4248,-1269
2019,12,16,3,3889,5212,4011,-1201
2019,12,16,4,3553,4734,3645,-1089
2019,12,16,5,3209,4289,3283,-1006
2019,12,16,6,2872,3934,2997,-937
2019,12,16,7,2719,3737,2835,-902
2019,12,16,8,2595,3658,2783,-875
2019,12,16,9,2600,3684,2763,-921
2019,12,16,10,2679,3826,2864,-962
2019,12,16,11,2949,4238,3178,-1060
2019,12,16,12,3475,4920,3695,-1225
2019,12,16,13,3763,5256,3998,-1258
2019,12,16,14,3894,5275,4051,-1224
2019,12,16,15,3992,5234,4056,-1178
2019,12,16,16,4075,5306,3970,-1336
2019,12,16,17,4250,5431,4041,-1390
2019,12,16,18,4381,5585,4005,-1580
2019,12,16,19,4550,5780,4165,-1615
2019,12,16,20,4685,5918,4272,-1646
2019,12,16,21,4837,6057,4384,-1673
2019,12,16,22,4819,6134,4426,-1708
2019,12,16,23,4955,6303,4529,-1774
2019,12,17,0,5125,6487,4608,-1879
2019,12,17,1,5021,6442,4619,-1823
2019,12,17,2,4829,6147,4416,-1731
2019,12,17,3,4487,5692,4286,-1406
2019,12,17,4,4045,5154,4019,-1135
2019,12,17,5,3610,4556,3599,-957
2019,12,17,6,3259,4087,3188,-899
2019,12,17,7,3040,3774,2934,-840
2019,12,17,8,2894,3648,2825,-823
2019,12,17,9,2815,3597,2791,-806
2019,12,17,10,2883,3698,2857,-841
2019,12,17,11,3127,4033,3107,-926
2019,12,17,12,3589,4639,3573,-1066
2019,12,17,13,3830,4992,3899,-1093
2019,12,17,14,3972,5218,4118,-1100
2019,12,17,15,4156,5468,4296,-1172
2019,12,17,16,4350,5764,4299,-1465
2019,12,17,17,4580,6015,4403,-1612
2019,12,17,18,4802,6255,4384,-1871
2019,12,17,19,5001,6411,4449,-1962
2019,12,17,20,5131,6515,4546,-1969
2019,12,17,21,5139,6444,4518,-1926
2019,12,17,22,5097,6381,4460,-1921
2019,12,17,23,5032,6614,4640,-1974
2019,12,18,0,5222,6783,4882,-1901
2019,12,18,1,5144,6529,4694,-1835
2019,12,18,2,4907,6098,4235,-1863
2019,12,18,3,4521,5691,4010,-1681
2019,12,18,4,4027,5164,3787,-1377
2019,12,18,5,3534,4579,3333,-1246
2019,12,18,6,3282,4117,3079,-1038
2019,12,18,7,3058,3880,2881,-999
2019,12,18,8,2917,3732,2759,-973
2019,12,18,9,2851,3690,2731,-959
2019,12,18,10,2862,3759,2740,-1019
2019,12,18,11,3070,4141,2994,-1147
2019,12,18,12,3473,4764,3429,-1335
2019,12,18,13,3648,5174,3740,-1434
2019,12,18,14,3672,5322,3850,-1472
2019,12,18,15,3741,5470,3967,-1503
2019,12,18,16,3830,5563,4063,-1500
2019,12,18,17,3938,5470,4072,-1398
2019,12,18,18,3966,5323,3946,-1377
2019,12,18,19,3957,5204,3831,-1373
2019,12,18,20,3982,5123,3783,-1340
2019,12,18,21,3985,5169,3796,-1373
2019,12,18,22,4073,5351,3908,-1443
2019,12,18,23,4442,5850,4076,-1774
2019,12,19,0,4992,6394,4396,-1998
2019,12,19,1,5128,6512,4525,-1987
2019,12,19,2,5128,6473,4494,-1979
2019,12,19,3,5023,6271,4277,-1994
2019,12,19,4,4697,5915,3907,-2008
2019,12,19,5,4488,5562,3825,-1737
2019,12,19,6,4052,5344,3623,-1721
2019,12,19,7,3922,5283,3565,-1718
2019,12,19,8,3924,5305,3566,-1739
2019,12,19,9,3916,5439,3631,-1808
2019,12,19,10,4131,5692,3771,-1921
2019,12,19,11,4607,6296,4098,-2198
2019,12,19,12,5409,7117,4909,-2208
2019,12,19,13,5727,7527,5292,-2235
2019,12,19,14,5611,7394,5170,-2224
2019,12,19,15,5277,6928,4690,-2238
2019,12,19,16,4905,6395,4466,-1929
2019,12,19,17,4541,5921,4309,-1612
2019,12,19,18,4350,5582,4279,-1303
2019,12,19,19,4174,5366,4148,-1218
2019,12,19,20,4114,5255,4082,-1173
2019,12,19,21,4062,5241,4055,-1186
2019,12,19,22,4071,5367,4146,-1221
2019,12,19,23,4415,5801,4433,-1368
2019,12,20,0,4802,6268,4788,-1480
2019,12,20,1,4812,6240,4752,-1488
2019,12,20,2,4735,6112,4627,-1485
2019,12,20,3,4584,5870,4451,-1419
2019,12,20,4,4214,5475,4141,-1334
2019,12,20,5,3809,5058,3830,-1228
2019,12,20,6,3381,4771,3605,-1166
2019,12,20,7,3199,4588,3447,-1141
2019,12,20,8,3114,4519,3389,-1130
2019,12,20,9,3113,4541,3388,-1153
2019,12,20,10,3221,4652,3451,-1201
2019,12,20,11,3542,5041,3731,-1310
2019,12,20,12,3987,5694,4237,-1457
2019,12,20,13,4279,6026,4540,-1486
2019,12,20,14,4288,6019,4547,-1472
2019,12,20,15,4226,5767,4368,-1399
2019,12,20,16,4167,5543,4252,-1291
2019,12,20,17,4053,5404,4181,-1223
2019,12,20,18,3978,5315,4127,-1188
2019,12,20,19,3949,5230,4083,-1147
2019,12,20,20,3908,5184,4063,-1121
2019,12,20,21,3897,5186,4057,-1129
2019,12,20,22,3978,5248,4105,-1143
2019,12,20,23,4160,5549,4326,-1223
2019,12,21,0,4393,5766,4453,-1313
2019,12,21,1,4284,5635,4349,-1286
2019,12,21,2,4184,5461,4206,-1255
2019,12,21,3,4021,5241,4042,-1199
2019,12,21,4,3762,4896,3782,-1114
2019,12,21,5,3481,4512,3481,-1031
2019,12,21,6,3175,4118,3156,-962
2019,12,21,7,2909,3891,2975,-916
2019,12,21,8,2792,3735,2842,-893
2019,12,21,9,2746,3679,2788,-891
2019,12,21,10,2771,3737,2820,-917
2019,12,21,11,2826,3868,2902,-966
2019,12,21,12,3022,4150,3110,-1040
2019,12,21,13,3288,4459,3362,-1097
2019,12,21,14,3638,4885,3745,-1140
2019,12,21,15,3925,5185,3996,-1189
2019,12,21,16,4005,5316,4097,-1219
2019,12,21,17,4063,5282,4097,-1185
2019,12,21,18,3970,5271,3997,-1274
2019,12,21,19,3945,5212,3923,-1289
2019,12,21,20,3863,5222,3923,-1299
2019,12,21,21,3868,5194,3894,-1300
2019,12,21,22,3837,5294,3992,-1302
2019,12,21,23,3966,5553,4173,-1380
2019,12,22,0,4216,5678,4309,-1369
2019,12,22,1,4112,5544,4213,-1331
2019,12,22,2,4013,5373,4081,-1292
2019,12,22,3,3833,5129,3992,-1137
2019,12,22,4,3556,4818,3748,-1070
2019,12,22,5,3247,4375,3361,-1014
2019,12,22,6,3104,4024,3117,-907
2019,12,22,7,2878,3762,2909,-853
2019,12,22,8,2746,3603,2774,-829
2019,12,22,9,2666,3507,2688,-819
2019,12,22,10,2645,3532,2698,-834
2019,12,22,11,2683,3637,2781,-856
2019,12,22,12,2798,3864,2949,-915
2019,12,22,13,2993,4200,3199,-1001
2019,12,22,14,3333,4690,3575,-1115
2019,12,22,15,3732,5097,3900,-1197
2019,12,22,16,3869,5310,4089,-1221
2019,12,22,17,3995,5404,4179,-1225
2019,12,22,18,3989,5436,4144,-1292
2019,12,22,19,3971,5414,4193,-1221
2019,12,22,20,3902,5375,4085,-1290
2019,12,22,21,3882,5361,4060,-1301
2019,12,22,22,3865,5426,4119,-1307
2019,12,22,23,4059,5662,4308,-1354
2019,12,23,0,4266,5791,4351,-1440
2019,12,23,1,4207,5667,4221,-1446
2019,12,23,2,4097,5497,4174,-1323
2019,12,23,3,3901,5230,4123,-1107
2019,12,23,4,3594,4827,3765,-1062
2019,12,23,5,3232,4397,3386,-1011
2019,12,23,6,2985,4012,3122,-890
2019,12,23,7,2753,3734,2895,-839
2019,12,23,8,2636,3633,2805,-828
2019,12,23,9,2592,3569,2752,-817
2019,12,23,10,2618,3642,2805,-837
2019,12,23,11,2799,3869,2962,-907
2019,12,23,12,3094,4252,3231,-1021
2019,12,23,13,3391,4629,3630,-999
2019,12,23,14,3700,4920,3896,-1024
2019,12,23,15,3880,5139,3972,-1167
2019,12,23,16,3912,5263,4003,-1260
2019,12,23,17,3970,5328,4072,-1256
2019,12,23,18,4006,5387,4016,-1371
2019,12,23,19,4044,5423,4052,-1371
2019,12,23,20,3971,5458,4084,-1374
2019,12,23,21,3844,5426,4057,-1369
2019,12,23,22,3834,5385,4083,-1302
2019,12,23,23,4088,5579,4256,-1323
2019,12,24,0,4381,5814,4470,-1344
2019,12,24,1,4224,5730,4415,-1315
2019,12,24,2,4060,5601,4330,-1271
2019,12,24,3,3873,5352,4194,-1158
2019,12,24,4,3642,5011,3877,-1134
2019,12,24,5,3417,4559,3502,-1057
2019,12,24,6,3151,4195,3216,-979
2019,12,24,7,2927,3963,3024,-939
2019,12,24,8,2784,3812,2899,-913
2019,12,24,9,2722,3757,2840,-917
2019,12,24,10,2772,3851,2900,-951
2019,12,24,11,2935,4058,3067,-991
2019,12,24,12,3152,4467,3368,-1099
2019,12,24,13,3465,4870,3656,-1214
2019,12,24,14,3810,5297,4017,-1280
2019,12,24,15,4059,5640,4278,-1362
2019,12,24,16,4053,5768,4380,-1388
2019,12,24,17,4063,5736,4370,-1366
2019,12,24,18,3976,5642,4141,-1501
2019,12,24,19,3966,5593,4222,-1371
2019,12,24,20,3963,5501,4129,-1372
2019,12,24,21,3971,5477,4083,-1394
2019,12,24,22,3978,5508,4173,-1335
2019,12,24,23,4094,5663,4332,-1331
2019,12,25,0,4168,5747,4469,-1278
2019,12,25,1,3984,5515,4233,-1282
2019,12,25,2,3812,5350,4046,-1304
2019,12,25,3,3693,5136,3970,-1166
2019,12,25,4,3500,4863,3702,-1161
2019,12,25,5,3275,4505,3463,-1042
2019,12,25,6,3127,4159,3199,-960
2019,12,25,7,2915,3876,2980,-896
2019,12,25,8,2756,3717,2833,-884
2019,12,25,9,2657,3623,2768,-855
2019,12,25,10,2675,3588,2721,-867
2019,12,25,11,2826,3720,2807,-913
2019,12,25,12,3001,3972,2989,-983
2019,12,25,13,3228,4333,3214,-1119
2019,12,25,14,3541,4774,3523,-1251
2019,12,25,15,3683,5091,3783,-1308
2019,12,25,16,3762,5259,3963,-1296
2019,12,25,17,3871,5461,4128,-1333
2019,12,25,18,3918,5615,4166,-1449
2019,12,25,19,3860,5698,4345,-1353
2019,12,25,20,3921,5666,4332,-1334
2019,12,25,21,3882,5589,4288,-1301
2019,12,25,22,3816,5462,4227,-1235
2019,12,25,23,3749,5429,4233,-1196
2019,12,26,0,3909,5531,4326,-1205
2019,12,26,1,3794,5377,4165,-1212
2019,12,26,2,3675,5223,4036,-1187
2019,12,26,3,3485,5013,3889,-1124
2019,12,26,4,3267,4604,3535,-1069
2019,12,26,5,3043,4191,3244,-947
2019,12,26,6,2829,3824,2961,-863
2019,12,26,7,2640,3582,2770,-812
2019,12,26,8,2534,3423,2638,-785
2019,12,26,9,2480,3395,2605,-790
2019,12,26,10,2551,3453,2638,-815
2019,12,26,11,2658,3679,2793,-886
2019,12,26,12,2838,4028,3056,-972
2019,12,26,13,3103,4354,3316,-1038
2019,12,26,14,3442,4695,3593,-1102
2019,12,26,15,3786,5012,3849,-1163
2019,12,26,16,3916,5190,3869,-1321
2019,12,26,17,4108,5389,3867,-1522
2019,12,26,18,4193,5586,3897,-1689
2019,12,26,19,4250,5689,4007,-1682
2019,12,26,20,4280,5711,4037,-1674
2019,12,26,21,4365,5680,3993,-1687
2019,12,26,22,4362,5687,4039,-1648
2019,12,26,23,4394,5855,4190,-1665
2019,12,27,0,4728,6158,4497,-1661
2019,12,27,1,4627,6024,4405,-1619
2019,12,27,2,4398,5763,4139,-1624
2019,12,27,3,4131,5437,3860,-1577
2019,12,27,4,3783,4977,3587,-1390
2019,12,27,5,3308,4535,3401,-1134
2019,12,27,6,2983,4113,3205,-908
2019,12,27,7,2773,3799,2961,-838
2019,12,27,8,2644,3607,2794,-813
2019,12,27,9,2597,3519,2728,-791
2019,12,27,10,2625,3507,2697,-810
2019,12,27,11,2791,3692,2827,-865
2019,12,27,12,3019,4061,3120,-941
2019,12,27,13,3261,4394,3439,-955
2019,12,27,14,3510,4736,3709,-1027
2019,12,27,15,3830,5100,3992,-1108
2019,12,27,16,4070,5403,4090,-1313
2019,12,27,17,4280,5597,4100,-1497
2019,12,27,18,4385,5715,4081,-1634
2019,12,27,19,4583,5736,4126,-1610
2019,12,27,20,4678,5752,4160,-1592
2019,12,27,21,4684,5780,4177,-1603
2019,12,27,22,4617,5763,4161,-1602
2019,12,27,23,4574,5902,4240,-1662
2019,12,28,0,4724,6102,4379,-1723
2019,12,28,1,4568,5949,4255,-1694
2019,12,28,2,4384,5738,4052,-1686
2019,12,28,3,4126,5472,3868,-1604
2019,12,28,4,3825,5089,3694,-1395
2019,12,28,5,3606,4646,3495,-1151
2019,12,28,6,3335,4216,3282,-934
2019,12,28,7,3058,3939,3069,-870
2019,12,28,8,2868,3751,2912,-839
2019,12,28,9,2765,3659,2842,-817
2019,12,28,10,2750,3641,2824,-817
2019,12,28,11,2802,3732,2884,-848
2019,12,28,12,2940,3910,3014,-896
2019,12,28,13,3065,4193,3246,-947
2019,12,28,14,3469,4650,3585,-1065
2019,12,28,15,3940,5139,3946,-1193
2019,12,28,16,4276,5478,4071,-1407
2019,12,28,17,4551,5710,4134,-1576
2019,12,28,18,4763,5823,4076,-1747
2019,12,28,19,4829,5859,4125,-1734
2019,12,28,20,4933,5882,4153,-1729
2019,12,28,21,4960,5909,4170,-1739
2019,12,28,22,4912,5903,4188,-1715
2019,12,28,23,4921,6009,4275,-1734
2019,12,29,0,5055,6214,4417,-1797
2019,12,29,1,4785,6065,4334,-1731
2019,12,29,2,4610,5835,4119,-1716
2019,12,29,3,4340,5553,3918,-1635
2019,12,29,4,4023,5202,3764,-1438
2019,12,29,5,3812,4774,3561,-1213
2019,12,29,6,3350,4410,3416,-994
2019,12,29,7,3110,4088,3185,-903
2019,12,29,8,2965,3864,2996,-868
2019,12,29,9,2885,3747,2865,-882
2019,12,29,10,2880,3725,2839,-886
2019,12,29,11,2944,3802,2899,-903
2019,12,29,12,3073,3988,3043,-945
2019,12,29,13,3257,4243,3253,-990
2019,12,29,14,3661,4727,3591,-1136
2019,12,29,15,4111,5265,4025,-1240
2019,12,29,16,4410,5601,4147,-1454
2019,12,29,17,4672,5879,4200,-1679
2019,12,29,18,4882,6125,4235,-1890
2019,12,29,19,4969,6293,4429,-1864
2019,12,29,20,5041,6383,4410,-1973
2019,12,29,21,4976,6421,4440,-1981
2019,12,29,22,4903,6411,4458,-1953
2019,12,29,23,4965,6465,4560,-1905
2019,12,30,0,5136,6670,4733,-1937
2019,12,30,1,5017,6408,4573,-1835
2019,12,30,2,4793,6112,4342,-1770
2019,12,30,3,4478,5794,4070,-1724
2019,12,30,4,4073,5325,3808,-1517
2019,12,30,5,3630,4867,3643,-1224
2019,12,30,6,3378,4462,3464,-998
2019,12,30,7,3115,4148,3221,-927
2019,12,30,8,2963,3954,3070,-884
2019,12,30,9,2883,3875,3007,-868
2019,12,30,10,2896,3909,3018,-891
2019,12,30,11,3030,4100,3166,-934
2019,12,30,12,3272,4454,3408,-1046
2019,12,30,13,3573,4749,3686,-1063
2019,12,30,14,3892,5095,3971,-1124
2019,12,30,15,4303,5481,4257,-1224
2019,12,30,16,4691,5796,4405,-1391
2019,12,30,17,4826,6021,4479,-1542
2019,12,30,18,5016,6166,4489,-1677
2019,12,30,19,5046,6231,4607,-1624
2019,12,30,20,5066,6235,4622,-1613
2019,12,30,21,5063,6202,4606,-1596
2019,12,30,22,4898,6211,4632,-1579
2019,12,30,23,4872,6412,4794,-1618
2019,12,31,0,5205,6629,4995,-1634
2019,12,31,1,5038,6416,4791,-1625
2019,12,31,2,4705,6078,4445,-1633
2019,12,31,3,4344,5666,4034,-1632
2019,12,31,4,3918,5181,3735,-1446
2019,12,31,5,3539,4647,3465,-1182
2019,12,31,6,3313,4168,3245,-923
2019,12,31,7,3072,3819,2968,-851
2019,12,31,8,2930,3620,2793,-827
2019,12,31,9,2628,3541,2716,-825
2019,12,31,10,2561,3576,2719,-857
2019,12,31,11,2631,3787,2868,-919
2019,12,31,12,2823,4181,3149,-1032
2019,12,31,13,3115,4554,3421,-1133
2019,12,31,14,3483,4909,3690,-1219
2019,12,31,15,3811,5179,3912,-1267
2019,12,31,16,4049,5276,3860,-1416
2019,12,31,17,4101,5256,3725,-1531
2019,12,31,18,4155,5231,3602,-1629
2019,12,31,19,4233,5178,3581,-1597
2019,12,31,20,4257,5165,3584,-1581
2019,12,31,21,4278,5156,3581,-1575
2019,12,31,22,4321,5258,3693,-1565
2019,12,31,23,4435,5524,3885,-1639
2020,1,1,0,4661,5902,4171,-1731
2020,1,1,1,4383,5728,4040,-1688
2020,1,1,2,4017,5444,3745,-1699
2020,1,1,3,3735,5150,3498,-1652
2020,1,1,4,3457,4898,3397,-1501
2020,1,1,5,3213,4681,3363,-1318
2020,1,1,6,3200,4497,3348,-1149
2020,1,1,7,3055,4387,3253,-1134
2020,1,1,8,2945,4245,3110,-1135
2020,1,1,9,2890,4194,3070,-1124
2020,1,1,10,2954,4175,3050,-1125
2020,1,1,11,3110,4308,3125,-1183
2020,1,1,12,3331,4559,3285,-1274
2020,1,1,13,3550,4872,3594,-1278
2020,1,1,14,3827,5160,3903,-1257
2020,1,1,15,3964,5352,4042,-1310
2020,1,1,16,4077,5374,4004,-1370
2020,1,1,17,4004,5302,3979,-1323
2020,1,1,18,3927,5152,3893,-1259
2020,1,1,19,3795,5051,3847,-1204
2020,1,1,20,3718,4996,3824,-1172
2020,1,1,21,3707,4992,3822,-1170
2020,1,1,22,3807,5070,3897,-1173
2020,1,1,23,3830,5284,4053,-1231
2020,1,2,0,4235,5633,4377,-1256
2020,1,2,1,4221,5543,4256,-1287
2020,1,2,2,4067,5366,4067,-1299
2020,1,2,3,3860,5116,3895,-1221
2020,1,2,4,3548,4760,3606,-1154
2020,1,2,5,3490,4407,3318,-1089
2020,1,2,6,3092,4140,3118,-1022
2020,1,2,7,2920,3976,2953,-1023
2020,1,2,8,2829,3916,2920,-996
2020,1,2,9,2802,3942,2927,-1015
2020,1,2,10,2929,4069,3011,-1058
2020,1,2,11,3180,4393,3257,-1136
2020,1,2,12,3551,4915,3674,-1241
2020,1,2,13,3857,5291,3978,-1313
2020,1,2,14,4067,5425,4144,-1281
2020,1,2,15,4153,5341,4111,-1230
2020,1,2,16,4236,5268,3969,-1299
2020,1,2,17,4177,5261,3842,-1419
2020,1,2,18,4109,5314,3760,-1554
2020,1,2,19,4096,5397,3826,-1571
2020,1,2,20,4171,5516,3922,-1594
2020,1,2,21,4254,5645,4026,-1619
2020,1,2,22,4305,5757,4107,-1650
2020,1,2,23,4343,5895,4173,-1722
2020,1,3,0,4530,6181,4383,-1798
2020,1,3,1,4381,6024,4295,-1729
2020,1,3,2,4207,5767,4122,-1645
2020,1,3,3,3983,5426,3878,-1548
2020,1,3,4,3627,4951,3611,-1340
2020,1,3,5,3407,4459,3346,-1113
2020,1,3,6,3207,4056,3154,-902
2020,1,3,7,3027,3782,2943,-839
2020,1,3,8,2874,3630,2825,-805
2020,1,3,9,2813,3548,2755,-793
2020,1,3,10,2862,3603,2786,-817
2020,1,3,11,3036,3854,2960,-894
2020,1,3,12,3364,4284,3308,-976
2020,1,3,13,3696,4653,3645,-1008
2020,1,3,14,3993,5015,3802,-1213
2020,1,3,15,4277,5330,3908,-1422
2020,1,3,16,4482,5630,4023,-1607
2020,1,3,17,4718,5869,4201,-1668
2020,1,3,18,4971,6154,4429,-1725
2020,1,3,19,5202,6434,4639,-1795
2020,1,3,20,5353,6692,4875,-1817
2020,1,3,21,5418,6812,5031,-1781
2020,1,3,22,5409,6823,5065,-1758
2020,1,3,23,5407,6771,5079,-1692
2020,1,4,0,5418,6844,5203,-1641
2020,1,4,1,4973,6580,4880,-1700
2020,1,4,2,4720,6247,4521,-1726
2020,1,4,3,4494,5866,4181,-1685
2020,1,4,4,4223,5392,3915,-1477
2020,1,4,5,3976,4928,3678,-1250
2020,1,4,6,3549,4527,3527,-1000
2020,1,4,7,3386,4213,3297,-916
2020,1,4,8,3119,3990,3125,-865
2020,1,4,9,3072,3894,3042,-852
2020,1,4,10,3015,3894,3039,-855
2020,1,4,11,3038,3978,3105,-873
2020,1,4,12,3178,4168,3253,-915
2020,1,4,13,3383,4443,3499,-944
2020,1,4,14,3920,4963,3894,-1069
2020,1,4,15,4289,5487,4296,-1191
2020,1,4,16,4594,5884,4654,-1230
2020,1,4,17,4794,6031,4787,-1244
2020,1,4,18,4841,5939,4696,-1243
2020,1,4,19,4785,5728,4522,-1206
2020,1,4,20,4589,5566,4385,-1181
2020,1,4,21,4409,5406,4247,-1159
2020,1,4,22,4313,5287,4170,-1117
2020,1,4,23,4402,5320,4153,-1167
2020,1,5,0,4489,5531,4296,-1235
2020,1,5,1,4241,5356,4176,-1180
2020,1,5,2,4067,5178,4028,-1150
2020,1,5,3,3877,4943,3855,-1088
2020,1,5,4,3649,4639,3611,-1028
2020,1,5,5,3318,4306,3303,-1003
2020,1,5,6,2976,4002,3062,-940
2020,1,5,7,2910,3828,2922,-906
2020,1,5,8,2859,3761,2852,-909
2020,1,5,9,2939,3796,2851,-945
2020,1,5,10,3042,3905,2908,-997
2020,1,5,11,3147,4167,3082,-1085
2020,1,5,12,3426,4595,3372,-1223
2020,1,5,13,3842,5175,3817,-1358
2020,1,5,14,4249,5748,4224,-1524
2020,1,5,15,4290,5884,4371,-1513
2020,1,5,16,4339,5782,4343,-1439
2020,1,5,17,4155,5522,4198,-1324
2020,1,5,18,4005,5351,4090,-1261
2020,1,5,19,3948,5149,3951,-1198
2020,1,5,20,4007,5011,3857,-1154
2020,1,5,21,3980,4968,3817,-1151
2020,1,5,22,3971,5073,3852,-1221
2020,1,5,23,4215,5435,4057,-1378
2020,1,6,0,4532,5981,4448,-1533
2020,1,6,1,4486,6050,4430,-1620
2020,1,6,2,4558,6043,4397,-1646
2020,1,6,3,4373,5861,4285,-1576
2020,1,6,4,4135,5576,4039,-1537
2020,1,6,5,4059,5277,3742,-1535
2020,1,6,6,3926,5090,3520,-1570
2020,1,6,7,3821,5004,3427,-1577
2020,1,6,8,3848,5067,3411,-1656
2020,1,6,9,3876,5205,3567,-1638
2020,1,6,10,4083,5492,3804,-1688
2020,1,6,11,4499,6106,4346,-1760
2020,1,6,12,5275,6956,5038,-1918
2020,1,6,13,5680,7554,5344,-2210
2020,1,6,14,5613,7505,5347,-2158
2020,1,6,15,5211,6937,5100,-1837
2020,1,6,16,4792,6381,4739,-1642
2020,1,6,17,4541,5910,4303,-1607
2020,1,6,18,4343,5589,4076,-1513
2020,1,6,19,4192,5338,3894,-1444
2020,1,6,20,4105,5191,3851,-1340
2020,1,6,21,4061,5125,3791,-1334
2020,1,6,22,4112,5207,3838,-1369
2020,1,6,23,4396,5551,4078,-1473
2020,1,7,0,4730,6184,4572,-1612
2020,1,7,1,4780,6347,4805,-1542
2020,1,7,2,4664,6321,4823,-1498
2020,1,7,3,4402,6104,4642,-1462
2020,1,7,4,4071,5783,4270,-1513
2020,1,7,5,3692,5398,3906,-1492
2020,1,7,6,3506,5227,3766,-1461
2020,1,7,7,3415,5180,3694,-1486
2020,1,7,8,3427,5234,3718,-1516
2020,1,7,9,3457,5348,3780,-1568
2020,1,7,10,3626,5611,3990,-1621
2020,1,7,11,4032,6222,4428,-1794
2020,1,7,12,4713,7112,5022,-2090
2020,1,7,13,5071,7506,5362,-2144
2020,1,7,14,4988,7223,5110,-2113
2020,1,7,15,4649,6668,4867,-1801
2020,1,7,16,4459,5838,4213,-1625
2020,1,7,17,4338,5482,4050,-1432
2020,1,7,18,4132,5271,3963,-1308
2020,1,7,19,4026,5138,3845,-1293
2020,1,7,20,3965,5054,3777,-1277
2020,1,7,21,3935,5073,3796,-1277
2020,1,7,22,4040,5165,3805,-1360
2020,1,7,23,4230,5454,4030,-1424
2020,1,8,0,4538,5939,4322,-1617
2020,1,8,1,4481,5913,4302,-1611
2020,1,8,2,4367,5712,4152,-1560
2020,1,8,3,4173,5426,3961,-1465
2020,1,8,4,3840,4998,3622,-1376
2020,1,8,5,3564,4543,3262,-1281
2020,1,8,6,3461,4311,3054,-1257
2020,1,8,7,3404,4221,2956,-1265
2020,1,8,8,3434,4294,2968,-1326
2020,1,8,9,3515,4452,3061,-1391
2020,1,8,10,3706,4752,3191,-1561
2020,1,8,11,4144,5393,3617,-1776
2020,1,8,12,4871,6341,4435,-1906
2020,1,8,13,5295,6925,5042,-1883
2020,1,8,14,5244,6863,4965,-1898
2020,1,8,15,4860,6404,4555,-1849
2020,1,8,16,4559,5980,4213,-1767
2020,1,8,17,4373,5620,4098,-1522
2020,1,8,18,4223,5386,3986,-1400
2020,1,8,19,4162,5192,4012,-1180
2020,1,8,20,3992,5067,3951,-1116
2020,1,8,21,3974,5048,3935,-1113
2020,1,8,22,4057,5236,4036,-1200
2020,1,8,23,4325,5620,4312,-1308
2020,1,9,0,4670,6221,4792,-1429
2020,1,9,1,4733,6323,4896,-1427
2020,1,9,2,4616,6267,4896,-1371
2020,1,9,3,4400,6071,4671,-1400
2020,1,9,4,4052,5688,4344,-1344
2020,1,9,5,3745,5339,3965,-1374
2020,1,9,6,3414,5146,3787,-1359
2020,1,9,7,3288,5062,3707,-1355
2020,1,9,8,3270,5070,3681,-1389
2020,1,9,9,3310,5153,3790,-1363
2020,1,9,10,3418,5339,3977,-1362
2020,1,9,11,3752,5819,4409,-1410
2020,1,9,12,4308,6558,5115,-1443
2020,1,9,13,4582,6811,5307,-1504
2020,1,9,14,4522,6591,5011,-1580
2020,1,9,15,4367,6116,4754,-1362
2020,1,9,16,4329,5683,4314,-1369
2020,1,9,17,4181,5371,4104,-1267
2020,1,9,18,4084,5245,4051,-1194
2020,1,9,19,4031,5154,4011,-1143
2020,1,9,20,4020,5131,4009,-1122
2020,1,9,21,4008,5166,4013,-1153
2020,1,9,22,4067,5282,4139,-1143
2020,1,9,23,4216,5461,4253,-1208
2020,1,10,0,4486,5862,4540,-1322
2020,1,10,1,4405,5791,4485,-1306
2020,1,10,2,4260,5557,4318,-1239
2020,1,10,3,3991,5175,4020,-1155
2020,1,10,4,3610,4702,3645,-1057
2020,1,10,5,3223,4223,3286,-937
2020,1,10,6,2975,3898,3009,-889
2020,1,10,7,2799,3706,2842,-864
2020,1,10,8,2725,3619,2767,-852
2020,1,10,9,2679,3618,2749,-869
2020,1,10,10,2766,3703,2808,-895
2020,1,10,11,3032,4076,3083,-993
2020,1,10,12,3508,4728,3594,-1134
2020,1,10,13,3817,5095,3930,-1165
2020,1,10,14,3945,5162,4020,-1142
2020,1,10,15,4007,5156,4034,-1122
2020,1,10,16,4108,5239,4126,-1113
2020,1,10,17,4313,5354,4234,-1120
2020,1,10,18,4543,5501,4330,-1171
2020,1,10,19,4767,5577,4429,-1148
2020,1,10,20,4894,5649,4584,-1065
2020,1,10,21,5023,5727,4683,-1044
2020,1,10,22,5119,5774,4730,-1044
2020,1,10,23,5062,5834,4761,-1073
2020,1,11,0,5076,6012,4948,-1064
2020,1,11,1,4773,5840,4798,-1042
2020,1,11,2,4549,5593,4520,-1073
2020,1,11,3,4324,5277,4191,-1086
2020,1,11,4,4015,4906,3860,-1046
2020,1,11,5,3713,4463,3487,-976
2020,1,11,6,3318,4057,3146,-911
2020,1,11,7,3102,3829,2959,-870
2020,1,11,8,2982,3678,2804,-874
2020,1,11,9,2921,3598,2786,-812
2020,1,11,10,2921,3606,2777,-829
2020,1,11,11,3034,3728,2878,-850
2020,1,11,12,3206,3975,3078,-897
2020,1,11,13,3485,4290,3299,-991
2020,1,11,14,3907,4821,3666,-1155
2020,1,11,15,4291,5279,3796,-1483
2020,1,11,16,4615,5663,4017,-1646
2020,1,11,17,4982,5890,3998,-1892
2020,1,11,18,5102,6076,4119,-1957
2020,1,11,19,5276,6247,4164,-2083
2020,1,11,20,5500,6392,4296,-2096
2020,1,11,21,5540,6478,4362,-2116
2020,1,11,22,5605,6468,4360,-2108
2020,1,11,23,5522,6354,4263,-2091
2020,1,12,0,5495,6447,4331,-2116
2020,1,12,1,5275,6184,4140,-2044
2020,1,12,2,4976,5869,4035,-1834
2020,1,12,3,4680,5542,4008,-1534
2020,1,12,4,4318,5131,3838,-1293
2020,1,12,5,3980,4659,3455,-1204
2020,1,12,6,3569,4238,3140,-1098
2020,1,12,7,3343,3922,2902,-1020
2020,1,12,8,3175,3712,2721,-991
2020,1,12,9,3062,3630,2651,-979
2020,1,12,10,3077,3602,2611,-991
2020,1,12,11,3108,3693,2677,-1016
2020,1,12,12,3229,3864,2805,-1059
2020,1,12,13,3427,4153,3024,-1129
2020,1,12,14,3792,4663,3409,-1254
2020,1,12,15,4281,5246,3659,-1587
2020,1,12,16,4708,5703,3858,-1845
2020,1,12,17,5081,6067,3897,-2170
2020,1,12,18,5334,6413,3996,-2417
2020,1,12,19,5513,6694,4226,-2468
2020,1,12,20,5657,6914,4470,-2444
2020,1,12,21,5710,6988,4558,-2430
2020,1,12,22,5638,6904,4510,-2394
2020,1,12,23,5562,6823,4363,-2460
2020,1,13,0,5604,6969,4512,-2457
2020,1,13,1,5315,6721,4462,-2259
2020,1,13,2,5054,6332,4273,-2059
2020,1,13,3,4687,5842,3932,-1910
2020,1,13,4,4250,5253,3665,-1588
2020,1,13,5,3803,4655,3371,-1284
2020,1,13,6,3452,4189,3089,-1100
2020,1,13,7,3193,3908,2874,-1034
2020,1,13,8,3073,3721,2742,-979
2020,1,13,9,2977,3654,2673,-981
2020,1,13,10,3008,3736,2717,-1019
2020,1,13,11,3314,4089,2991,-1098
2020,1,13,12,3826,4666,3372,-1294
2020,1,13,13,4106,4987,3661,-1326
2020,1,13,14,4233,5187,3835,-1352
2020,1,13,15,4495,5476,3906,-1570
2020,1,13,16,4809,5798,3998,-1800
2020,1,13,17,5177,6104,3993,-2111
2020,1,13,18,5411,6452,4091,-2361
2020,1,13,19,5598,6736,4284,-2452
2020,1,13,20,5703,6950,4520,-2430
2020,1,13,21,5788,7075,4648,-2427
2020,1,13,22,5715,7095,4668,-2427
2020,1,13,23,5686,6940,4549,-2391
2020,1,14,0,5797,7013,4658,-2355
2020,1,14,1,5489,6695,4447,-2248
2020,1,14,2,5194,6197,4197,-2000
2020,1,14,3,4752,5708,3949,-1759
2020,1,14,4,4277,5144,3641,-1503
2020,1,14,5,3789,4561,3339,-1222
2020,1,14,6,3411,4130,3046,-1084
2020,1,14,7,3142,3820,2807,-1013
2020,1,14,8,3020,3658,2667,-991
2020,1,14,9,2932,3548,2603,-945
2020,1,14,10,2948,3617,2614,-1003
2020,1,14,11,3214,3911,2825,-1086
2020,1,14,12,3743,4468,3189,-1279
2020,1,14,13,3996,4842,3538,-1304
2020,1,14,14,4065,5003,3684,-1319
2020,1,14,15,4207,5230,3865,-1365
2020,1,14,16,4514,5542,3973,-1569
2020,1,14,17,4798,5838,4061,-1777
2020,1,14,18,5120,6086,4139,-1947
2020,1,14,19,5377,6320,4335,-1985
2020,1,14,20,5546,6493,4503,-1990
2020,1,14,21,5617,6654,4626,-2028
2020,1,14,22,5546,6763,4723,-2040
2020,1,14,23,5436,6699,4704,-1995
2020,1,15,0,5496,6874,4869,-2005
2020,1,15,1,5308,6635,4586,-2049
2020,1,15,2,5046,6249,4316,-1933
2020,1,15,3,4647,5755,4070,-1685
2020,1,15,4,4190,5169,3767,-1402
2020,1,15,5,3723,4571,3363,-1208
2020,1,15,6,3406,4117,3053,-1064
2020,1,15,7,3145,3846,2818,-1028
2020,1,15,8,3028,3680,2682,-998
2020,1,15,9,2947,3623,2627,-996
2020,1,15,10,2967,3692,2686,-1006
2020,1,15,11,3225,3992,2917,-1075
2020,1,15,12,3735,4581,3310,-1271
2020,1,15,13,3983,4915,3578,-1337
2020,1,15,14,4078,5042,3711,-1331
2020,1,15,15,4237,5269,3886,-1383
2020,1,15,16,4561,5569,3973,-1596
2020,1,15,17,4883,5908,4073,-1835
2020,1,15,18,5139,6279,4202,-2077
2020,1,15,19,5324,6618,4492,-2126
2020,1,15,20,5471,6872,4754,-2118
2020,1,15,21,5598,7043,4902,-2141
2020,1,15,22,5616,7019,4974,-2045
2020,1,15,23,5497,6868,4834,-2034
2020,1,16,0,5473,6930,4902,-2028
2020,1,16,1,5332,6638,4618,-2020
2020,1,16,2,5078,6276,4369,-1907
2020,1,16,3,4676,5815,4153,-1662
2020,1,16,4,4223,5207,3806,-1401
2020,1,16,5,3751,4601,3380,-1221
2020,1,16,6,3434,4161,3197,-964
2020,1,16,7,3179,3844,2957,-887
2020,1,16,8,3056,3665,2778,-887
2020,1,16,9,2993,3595,2761,-834
2020,1,16,10,3004,3648,2779,-869
2020,1,16,11,3273,3969,3028,-941
2020,1,16,12,3770,4523,3474,-1049
2020,1,16,13,4025,4881,3801,-1080
2020,1,16,14,4128,5034,3913,-1121
2020,1,16,15,4299,5262,4087,-1175
2020,1,16,16,4619,5570,4207,-1363
2020,1,16,17,4911,5859,4323,-1536
2020,1,16,18,5148,6207,4444,-1763
2020,1,16,19,5328,6454,4640,-1814
2020,1,16,20,5448,6652,4825,-1827
2020,1,16,21,5509,6784,4962,-1822
2020,1,16,22,5434,6710,4963,-1747
2020,1,16,23,5348,6605,4867,-1738
2020,1,17,0,5383,6737,4946,-1791
2020,1,17,1,5222,6523,4767,-1756
2020,1,17,2,4963,6162,4550,-1612
2020,1,17,3,4588,5721,4313,-1408
2020,1,17,4,4147,5168,4029,-1139
2020,1,17,5,3701,4609,3544,-1065
2020,1,17,6,3334,4185,3230,-955
2020,1,17,7,3088,3906,3007,-899
2020,1,17,8,2980,3710,2842,-868
2020,1,17,9,2933,3630,2774,-856
2020,1,17,10,2944,3674,2786,-888
2020,1,17,11,3179,3996,3046,-950
2020,1,17,12,3623,4570,3482,-1088
2020,1,17,13,3883,4898,3810,-1088
2020,1,17,14,4000,5055,3945,-1110
2020,1,17,15,4059,5236,4082,-1154
2020,1,17,16,4194,5411,4243,-1168
2020,1,17,17,4344,5554,4352,-1202
2020,1,17,18,4415,5708,4450,-1258
2020,1,17,19,4448,5829,4582,-1247
2020,1,17,20,4455,5871,4632,-1239
2020,1,17,21,4453,5872,4629,-1243
2020,1,17,22,4395,5833,4603,-1230
2020,1,17,23,4358,5759,4515,-1244
2020,1,18,0,4542,5907,4638,-1269
2020,1,18,1,4394,5681,4435,-1246
2020,1,18,2,4209,5451,4262,-1189
2020,1,18,3,4000,5169,4039,-1130
2020,1,18,4,3696,4823,3764,-1059
2020,1,18,5,3412,4409,3416,-993
2020,1,18,6,3077,4052,3165,-887
2020,1,18,7,2889,3787,2934,-853
2020,1,18,8,2752,3618,2789,-829
2020,1,18,9,2722,3559,2729,-830
2020,1,18,10,2696,3586,2742,-844
2020,1,18,11,2802,3718,2832,-886
2020,1,18,12,2981,3984,3025,-959
2020,1,18,13,3261,4343,3284,-1059
2020,1,18,14,3601,4751,3594,-1157
2020,1,18,15,3872,5029,3809,-1220
2020,1,18,16,4093,5172,3969,-1203
2020,1,18,17,4200,5273,4079,-1194
2020,1,18,18,4215,5349,4121,-1228
2020,1,18,19,4225,5441,4232,-1209
2020,1,18,20,4293,5568,4225,-1343
2020,1,18,21,4330,5663,4251,-1412
2020,1,18,22,4326,5695,4276,-1419
2020,1,18,23,4330,5682,4295,-1387
2020,1,19,0,4464,5815,4425,-1390
2020,1,19,1,4299,5658,4380,-1278
2020,1,19,2,4094,5370,4210,-1160
2020,1,19,3,3809,5072,3991,-1081
2020,1,19,4,3520,4719,3679,-1040
2020,1,19,5,3277,4322,3378,-944
2020,1,19,6,3079,3964,3093,-871
2020,1,19,7,2866,3714,2901,-813
2020,1,19,8,2723,3538,2740,-798
2020,1,19,9,2664,3484,2698,-786
2020,1,19,10,2665,3497,2711,-786
2020,1,19,11,2707,3595,2779,-816
2020,1,19,12,2849,3803,2943,-860
2020,1,19,13,3087,4088,3174,-914
2020,1,19,14,3449,4526,3499,-1027
2020,1,19,15,3817,4927,3794,-1133
2020,1,19,16,4033,5188,4024,-1164
2020,1,19,17,4191,5361,4162,-1199
2020,1,19,18,4240,5480,4133,-1347
2020,1,19,19,4311,5537,4228,-1309
2020,1,19,20,4345,5573,4228,-1345
2020,1,19,21,4329,5622,4312,-1310
2020,1,19,22,4265,5659,4424,-1235
2020,1,19,23,4296,5794,4506,-1288
2020,1,20,0,4389,6076,4712,-1364
2020,1,20,1,4261,5923,4620,-1303
2020,1,20,2,4103,5653,4408,-1245
2020,1,20,3,3822,5322,4138,-1184
2020,1,20,4,3491,4874,3776,-1098
2020,1,20,5,3226,4394,3384,-1010
2020,1,20,6,2941,4004,3063,-941
2020,1,20,7,2811,3745,2828,-917
2020,1,20,8,2723,3650,2712,-938
2020,1,20,9,2687,3673,2707,-966
2020,1,20,10,2739,3832,2810,-1022
2020,1,20,11,3046,4222,3191,-1031
2020,1,20,12,3459,4874,3720,-1154
2020,1,20,13,3898,5584,4212,-1372
2020,1,20,14,4307,6045,4549,-1496
2020,1,20,15,4323,6173,4756,-1417
2020,1,20,16,4466,6105,4674,-1431
2020,1,20,17,4482,5867,4423,-1444
2020,1,20,18,4429,5630,4406,-1224
2020,1,20,19,4254,5458,4304,-1154
2020,1,20,20,4210,5340,4223,-1117
2020,1,20,21,4166,5301,4210,-1091
2020,1,20,22,4192,5442,4292,-1150
2020,1,20,23,4405,5849,4537,-1312
2020,1,21,0,4987,6473,5033,-1440
2020,1,21,1,5253,6602,4988,-1614
2020,1,21,2,5285,6526,4849,-1677
2020,1,21,3,5149,6297,4616,-1681
2020,1,21,4,4824,5937,4288,-1649
2020,1,21,5,4623,5613,3903,-1710
2020,1,21,6,4261,5417,3760,-1657
2020,1,21,7,4205,5373,3692,-1681
2020,1,21,8,4339,5491,3764,-1727
2020,1,21,9,4531,5671,3874,-1797
2020,1,21,10,4829,6029,4021,-2008
2020,1,21,11,5450,6724,4454,-2270
2020,1,21,12,6378,7732,5254,-2478
2020,1,21,13,6792,8321,5767,-2554
2020,1,21,14,6688,8152,5665,-2487
2020,1,21,15,6305,7668,5148,-2520
2020,1,21,16,5953,7205,4840,-2365
2020,1,21,17,5517,6762,4726,-2036
2020,1,21,18,5211,6443,4561,-1882
2020,1,21,19,4964,6207,4418,-1789
2020,1,21,20,4749,6050,4315,-1735
2020,1,21,21,4656,6058,4295,-1763
2020,1,21,22,4813,6381,4485,-1896
2020,1,21,23,5070,7114,4870,-2244
2020,1,22,0,5941,8116,5433,-2683
2020,1,22,1,6252,8508,5850,-2658
2020,1,22,2,6429,8611,6009,-2602
2020,1,22,3,6453,8477,5904,-2573
2020,1,22,4,6238,8127,5550,-2577
2020,1,22,5,6114,7823,5282,-2541
2020,1,22,6,6021,7651,5260,-2391
2020,1,22,7,6073,7695,5270,-2425
2020,1,22,8,6362,7800,5353,-2447
2020,1,22,9,6508,8020,5549,-2471
2020,1,22,10,6884,8363,5916,-2447
2020,1,22,11,7544,9060,6373,-2687
2020,1,22,12,8218,10051,7156,-2895
2020,1,22,13,8483,10475,7423,-3052
2020,1,22,14,8196,10142,7192,-2950
2020,1,22,15,7419,9384,6465,-2919
2020,1,22,16,6725,8661,5866,-2795
2020,1,22,17,5932,8054,5675,-2379
2020,1,22,18,5351,7511,5491,-2020
2020,1,22,19,5106,7108,5406,-1702
2020,1,22,20,4843,6825,5234,-1591
2020,1,22,21,4809,6673,5126,-1547
2020,1,22,22,4922,6851,5264,-1587
2020,1,22,23,5230,7308,5500,-1808
2020,1,23,0,5774,7767,5990,-1777
2020,1,23,1,5974,7708,6041,-1667
2020,1,23,2,5950,7440,5765,-1675
2020,1,23,3,5740,6989,5270,-1719
2020,1,23,4,5411,6396,4810,-1586
2020,1,23,5,4966,5845,4351,-1494
2020,1,23,6,4263,5521,4035,-1486
2020,1,23,7,4110,5330,3859,-1471
2020,1,23,8,4003,5229,3763,-1466
2020,1,23,9,3997,5209,3740,-1469
2020,1,23,10,4132,5361,3844,-1517
2020,1,23,11,4435,5799,4173,-1626
2020,1,23,12,4962,6500,4724,-1776
2020,1,23,13,5182,6783,4996,-1787
2020,1,23,14,5059,6634,4907,-1727
2020,1,23,15,4804,6303,4672,-1631
2020,1,23,16,4573,5891,4332,-1559
2020,1,23,17,4571,5596,4128,-1468
2020,1,23,18,4195,5445,4068,-1377
2020,1,23,19,4065,5308,4140,-1168
2020,1,23,20,3934,5276,4130,-1146
2020,1,23,21,3912,5255,4122,-1133
2020,1,23,22,3956,5327,4160,-1167
2020,1,23,23,4126,5560,4334,-1226
2020,1,24,0,4448,5962,4601,-1361
2020,1,24,1,4499,5924,4598,-1326
2020,1,24,2,4402,5731,4459,-1272
2020,1,24,3,4150,5364,4191,-1173
2020,1,24,4,3759,4863,3806,-1057
2020,1,24,5,3298,4393,3396,-997
2020,1,24,6,3025,4071,3103,-968
2020,1,24,7,2845,3898,2962,-936
2020,1,24,8,2749,3826,2891,-935
2020,1,24,9,2743,3805,2877,-928
2020,1,24,10,2833,3927,2955,-972
2020,1,24,11,3100,4312,3244,-1068
2020,1,24,12,3619,4998,3778,-1220
2020,1,24,13,3918,5360,4121,-1239
2020,1,24,14,3959,5371,4153,-1218
2020,1,24,15,4103,5326,4125,-1201
2020,1,24,16,4085,5249,4100,-1149
2020,1,24,17,4073,5238,4079,-1159
2020,1,24,18,4080,5279,4089,-1190
2020,1,24,19,4121,5274,4111,-1163
2020,1,24,20,4130,5278,4107,-1171
2020,1,24,21,4141,5288,4111,-1177
2020,1,24,22,4141,5307,4160,-1147
2020,1,24,23,4219,5384,4195,-1189
2020,1,25,0,4404,5640,4375,-1265
2020,1,25,1,4294,5557,4347,-1210
2020,1,25,2,4050,5365,4182,-1183
2020,1,25,3,3759,5060,3946,-1114
2020,1,25,4,3499,4721,3661,-1060
2020,1,25,5,3242,4304,3279,-1025
2020,1,25,6,2972,3955,3015,-940
2020,1,25,7,2807,3746,2829,-917
2020,1,25,8,2704,3641,2741,-900
2020,1,25,9,2634,3612,2694,-918
2020,1,25,10,2624,3665,2708,-957
2020,1,25,11,2788,3828,2828,-1000
2020,1,25,12,2974,4231,3111,-1120
2020,1,25,13,3323,4720,3497,-1223
2020,1,25,14,3698,5195,3857,-1338
2020,1,25,15,3995,5348,3992,-1356
2020,1,25,16,4058,5307,4002,-1305
2020,1,25,17,4061,5197,3943,-1254
2020,1,25,18,3896,5112,3900,-1212
2020,1,25,19,3891,5008,3866,-1142
2020,1,25,20,3862,4956,3810,-1146
2020,1,25,21,3802,4928,3801,-1127
2020,1,25,22,3805,4985,3838,-1147
2020,1,25,23,3788,5134,3934,-1200
2020,1,26,0,4158,5489,4131,-1358
2020,1,26,1,4168,5531,4174,-1357
2020,1,26,2,4062,5466,4107,-1359
2020,1,26,3,3841,5372,4031,-1341
2020,1,26,4,3678,5170,3848,-1322
2020,1,26,5,3366,4934,3623,-1311
2020,1,26,6,3324,4744,3500,-1244
2020,1,26,7,3261,4663,3427,-1236
2020,1,26,8,3312,4679,3515,-1164
2020,1,26,9,3355,4724,3467,-1257
2020,1,26,10,3482,4910,3554,-1356
2020,1,26,11,3709,5169,3714,-1455
2020,1,26,12,4043,5580,4001,-1579
2020,1,26,13,4524,6155,4439,-1716
2020,1,26,14,4845,6592,4784,-1808
2020,1,26,15,4732,6423,4708,-1715
2020,1,26,16,4507,6001,4449,-1552
2020,1,26,17,4257,5616,4195,-1421
2020,1,26,18,4024,5369,4035,-1334
2020,1,26,19,3835,5174,3919,-1255
2020,1,26,20,3708,5019,3798,-1221
2020,1,26,21,3700,4995,3771,-1224
2020,1,26,22,3737,5100,3871,-1229
2020,1,26,23,3838,5392,4077,-1315
2020,1,27,0,4252,5862,4405,-1457
2020,1,27,1,4312,5907,4471,-1436
2020,1,27,2,4261,5684,4310,-1374
2020,1,27,3,3977,5384,4074,-1310
2020,1,27,4,3713,4930,3739,-1191
2020,1,27,5,3449,4447,3364,-1083
2020,1,27,6,3271,4222,3156,-1066
2020,1,27,7,3146,4026,2999,-1027
2020,1,27,8,3092,3997,2961,-1036
2020,1,27,9,3139,4005,2960,-1045
2020,1,27,10,3292,4187,3075,-1112
2020,1,27,11,3700,4653,3425,-1228
2020,1,27,12,4310,5386,4018,-1368
2020,1,27,13,4667,5813,4386,-1427
2020,1,27,14,4635,5873,4445,-1428
2020,1,27,15,4535,5836,4441,-1395
2020,1,27,16,4400,5762,4407,-1355
2020,1,27,17,4330,5546,4276,-1270
2020,1,27,18,4149,5415,4169,-1246
2020,1,27,19,4068,5263,4075,-1188
2020,1,27,20,3951,5177,4020,-1157
2020,1,27,21,3924,5168,3990,-1178
2020,1,27,22,4009,5293,4086,-1207
2020,1,27,23,4217,5570,4251,-1319
2020,1,28,0,4534,5981,4550,-1431
2020,1,28,1,4529,5969,4550,-1419
2020,1,28,2,4407,5737,4400,-1337
2020,1,28,3,4205,5351,4109,-1242
2020,1,28,4,3839,4838,3703,-1135
2020,1,28,5,3529,4360,3299,-1061
2020,1,28,6,3144,4047,3058,-989
2020,1,28,7,2991,3922,2931,-991
2020,1,28,8,2913,3890,2896,-994
2020,1,28,9,2916,3943,2912,-1031
2020,1,28,10,3045,4165,3061,-1104
2020,1,28,11,3379,4710,3465,-1245
2020,1,28,12,3970,5486,4048,-1438
2020,1,28,13,4305,5953,4484,-1469
2020,1,28,14,4314,5950,4504,-1446
2020,1,28,15,4265,5693,4351,-1342
2020,1,28,16,4227,5469,4204,-1265
2020,1,28,17,4242,5272,4083,-1189
2020,1,28,18,4115,5157,4008,-1149
2020,1,28,19,4036,5051,3943,-1108
2020,1,28,20,3991,5011,3918,-1093
2020,1,28,21,3980,5029,3928,-1101
2020,1,28,22,4047,5160,4021,-1139
2020,1,28,23,4174,5389,4175,-1214
2020,1,29,0,4480,5867,4513,-1354
2020,1,29,1,4500,5987,4607,-1380
2020,1,29,2,4328,5857,4486,-1371
2020,1,29,3,4068,5604,4293,-1311
2020,1,29,4,3701,5205,3950,-1255
2020,1,29,5,3406,4836,3638,-1198
2020,1,29,6,3197,4672,3478,-1194
2020,1,29,7,3104,4660,3445,-1215
2020,1,29,8,3100,4742,3492,-1250
2020,1,29,9,3192,4862,3565,-1297
2020,1,29,10,3375,5175,3814,-1361
2020,1,29,11,3778,5768,4441,-1327
2020,1,29,12,4415,6664,4819,-1845
2020,1,29,13,4712,7093,5242,-1851
2020,1,29,14,4635,6871,5085,-1786
2020,1,29,15,4493,6367,4976,-1391
2020,1,29,16,4386,5995,4640,-1355
2020,1,29,17,4249,5732,4352,-1380
2020,1,29,18,4160,5565,4221,-1344
2020,1,29,19,4058,5487,4209,-1278
2020,1,29,20,4009,5460,4193,-1267
2020,1,29,21,4008,5479,4201,-1278
2020,1,29,22,4058,5586,4265,-1321
2020,1,29,23,4175,5839,4481,-1358
2020,1,30,0,4427,6190,4850,-1340
2020,1,30,1,4410,6178,4926,-1252
2020,1,30,2,4248,5963,4772,-1191
2020,1,30,3,3949,5622,4465,-1157
2020,1,30,4,3597,5143,4006,-1137
2020,1,30,5,3269,4653,3490,-1163
2020,1,30,6,3138,4383,3273,-1110
2020,1,30,7,3017,4219,3156,-1063
2020,1,30,8,2985,4165,3087,-1078
2020,1,30,9,3005,4179,3104,-1075
2020,1,30,10,3117,4382,3239,-1143
2020,1,30,11,3449,4856,3601,-1255
2020,1,30,12,4005,5543,4143,-1400
2020,1,30,13,4302,5937,4450,-1487
2020,1,30,14,4313,5981,4564,-1417
2020,1,30,15,4249,5982,4568,-1414
2020,1,30,16,4278,5934,4537,-1397
2020,1,30,17,4191,5795,4458,-1337
2020,1,30,18,4164,5582,4304,-1278
2020,1,30,19,4118,5395,4182,-1213
2020,1,30,20,4084,5266,4102,-1164
2020,1,30,21,4081,5219,4083,-1136
2020,1,30,22,4158,5316,4138,-1178
2020,1,30,23,4296,5543,4248,-1295
2020,1,31,0,4496,5975,4543,-1432
2020,1,31,1,4448,5995,4579,-1416
2020,1,31,2,4260,5798,4448,-1350
2020,1,31,3,3961,5458,4207,-1251
2020,1,31,4,3593,4962,3823,-1139
2020,1,31,5,3231,4501,3458,-1043
2020,1,31,6,3120,4172,3207,-965
2020,1,31,7,2967,3998,3053,-945
2020,1,31,8,2898,3940,3012,-928
2020,1,31,9,2896,3924,2993,-931
2020,1,31,10,3019,4088,3098,-990
2020,1,31,11,3327,4494,3404,-1090
2020,1,31,12,3870,5209,3896,-1313
2020,1,31,13,4153,5579,4296,-1283
2020,1,31,14,4174,5683,4453,-1230
2020,1,31,15,4127,5685,4469,-1216
2020,1,31,16,4144,5584,4428,-1156
2020,1,31,17,4113,5470,4310,-1160
2020,1,31,18,4124,5373,4201,-1172
2020,1,31,19,4077,5291,4161,-1130
2020,1,31,20,4042,5309,4143,-1166
2020,1,31,21,4042,5329,4158,-1171
2020,1,31,22,4082,5459,4258,-1201
2020,1,31,23,4159,5578,4260,-1318
2020,2,1,0,4343,5786,4414,-1372
2020,2,1,1,4228,5707,4396,-1311
2020,2,1,2,4024,5521,4209,-1312
2020,2,1,3,3803,5230,3998,-1232
2020,2,1,4,3541,4857,3690,-1167
2020,2,1,5,3259,4473,3426,-1047
2020,2,1,6,3035,4193,3197,-996
2020,2,1,7,2863,3948,2992,-956
2020,2,1,8,2794,3857,2922,-935
2020,2,1,9,2758,3796,2870,-926
2020,2,1,10,2762,3845,2897,-948
2020,2,1,11,2871,3981,2980,-1001
2020,2,1,12,3122,4241,3173,-1068
2020,2,1,13,3389,4655,3509,-1146
2020,2,1,14,3736,5138,3897,-1241
2020,2,1,15,3999,5530,4190,-1340
2020,2,1,16,4098,5746,4381,-1365
2020,2,1,17,4084,5747,4412,-1335
2020,2,1,18,4003,5710,4393,-1317
2020,2,1,19,3858,5609,4324,-1285
2020,2,1,20,3700,5526,4281,-1245
2020,2,1,21,3675,5437,4193,-1244
2020,2,1,22,3729,5464,4216,-1248
2020,2,1,23,3791,5523,4244,-1279
2020,2,2,0,4140,5851,4482,-1369
2020,2,2,1,4143,5884,4497,-1387
2020,2,2,2,4021,5745,4381,-1364
2020,2,2,3,3808,5585,4257,-1328
2020,2,2,4,3603,5352,4065,-1287
2020,2,2,5,3249,5051,3801,-1250
2020,2,2,6,3096,4862,3629,-1233
2020,2,2,7,2959,4767,3551,-1216
2020,2,2,8,2914,4799,3557,-1242
2020,2,2,9,2951,4850,3583,-1267
2020,2,2,10,3064,4986,3658,-1328
2020,2,2,11,3287,5232,3823,-1409
2020,2,2,12,3617,5703,4233,-1470
2020,2,2,13,4053,6329,4691,-1638
2020,2,2,14,4391,6709,4901,-1808
2020,2,2,15,4420,6568,4746,-1822
2020,2,2,16,4343,6252,4605,-1647
2020,2,2,17,4164,5904,4542,-1362
2020,2,2,18,4013,5643,4334,-1309
2020,2,2,19,3866,5420,4190,-1230
2020,2,2,20,3751,5187,3992,-1195
2020,2,2,21,3629,5124,3946,-1178
2020,2,2,22,3641,5203,4013,-1190
2020,2,2,23,3964,5504,4224,-1280
2020,2,3,0,4180,5919,4518,-1401
2020,2,3,1,4192,5973,4560,-1413
2020,2,3,2,4140,5934,4518,-1416
2020,2,3,3,4003,5846,4450,-1396
2020,2,3,4,3851,5674,4234,-1440
2020,2,3,5,3677,5415,4050,-1365
2020,2,3,6,3688,5149,3823,-1326
2020,2,3,7,3648,5075,3744,-1331
2020,2,3,8,3679,5121,3778,-1343
2020,2,3,9,3766,5259,3714,-1545
2020,2,3,10,3954,5560,3819,-1741
2020,2,3,11,4418,6209,4292,-1917
2020,2,3,12,5131,7128,4989,-2139
2020,2,3,13,5559,7661,5544,-2117
2020,2,3,14,5423,7330,5171,-2159
2020,2,3,15,4899,6550,4674,-1876
2020,2,3,16,4657,5911,4423,-1488
2020,2,3,17,4395,5495,4174,-1321
2020,2,3,18,4215,5231,3972,-1259
2020,2,3,19,4112,5089,3878,-1211
2020,2,3,20,4068,5040,3847,-1193
2020,2,3,21,4046,5021,3926,-1095
2020,2,3,22,4010,5093,3988,-1105
2020,2,3,23,4067,5310,4136,-1174
2020,2,4,0,4395,5707,4414,-1293
2020,2,4,1,4471,5818,4511,-1307
2020,2,4,2,4300,5626,4358,-1268
2020,2,4,3,4020,5296,4104,-1192
2020,2,4,4,3677,4854,3746,-1108
2020,2,4,5,3404,4464,3401,-1063
2020,2,4,6,3095,4241,3189,-1052
2020,2,4,7,3002,4198,3123,-1075
2020,2,4,8,3014,4247,3147,-1100
2020,2,4,9,3079,4387,3176,-1211
2020,2,4,10,3272,4615,3281,-1334
2020,2,4,11,3695,5215,3656,-1559
2020,2,4,12,4360,6135,4395,-1740
2020,2,4,13,4715,6557,4678,-1879
2020,2,4,14,4607,6341,4443,-1898
2020,2,4,15,4387,5928,4322,-1606
2020,2,4,16,4322,5561,4084,-1477
2020,2,4,17,4223,5233,3819,-1414
2020,2,4,18,4144,5118,3746,-1372
2020,2,4,19,4088,5080,3727,-1353
2020,2,4,20,4052,5072,3709,-1363
2020,2,4,21,4066,5136,3720,-1416
2020,2,4,22,4120,5262,3910,-1352
2020,2,4,23,4220,5436,4005,-1431
2020,2,5,0,4516,5780,4253,-1527
2020,2,5,1,4548,5810,4287,-1523
2020,2,5,2,4368,5580,4103,-1477
2020,2,5,3,4082,5145,3781,-1364
2020,2,5,4,3661,4657,3445,-1212
2020,2,5,5,3281,4180,3045,-1135
2020,2,5,6,2993,3827,2769,-1058
2020,2,5,7,2811,3646,2619,-1027
2020,2,5,8,2728,3579,2557,-1022
2020,2,5,9,2695,3578,2548,-1030
2020,2,5,10,2767,3734,2665,-1069
2020,2,5,11,3061,4161,2961,-1200
2020,2,5,12,3613,4846,3426,-1420
2020,2,5,13,3924,5219,3760,-1459
2020,2,5,14,3977,5264,3832,-1432
2020,2,5,15,4051,5198,3777,-1421
2020,2,5,16,4099,5178,3787,-1391
2020,2,5,17,4198,5214,3833,-1381
2020,2,5,18,4301,5328,3896,-1432
2020,2,5,19,4399,5362,3944,-1418
2020,2,5,20,4502,5441,3745,-1696
2020,2,5,21,4611,5568,3795,-1773
2020,2,5,22,4682,5664,3912,-1752
2020,2,5,23,4757,5794,3963,-1831
2020,2,6,0,4820,6124,4200,-1924
2020,2,6,1,4778,6163,4261,-1902
2020,2,6,2,4574,5902,4313,-1589
2020,2,6,3,4299,5528,4105,-1423
2020,2,6,4,3924,4992,3745,-1247
2020,2,6,5,3591,4439,3279,-1160
2020,2,6,6,3310,4046,2966,-1080
2020,2,6,7,3104,3770,2747,-1023
2020,2,6,8,2991,3604,2625,-979
2020,2,6,9,2944,3575,2621,-954
2020,2,6,10,3008,3661,2649,-1012
2020,2,6,11,3289,4009,2908,-1101
2020,2,6,12,3811,4661,3399,-1262
2020,2,6,13,4116,5062,3731,-1331
2020,2,6,14,4268,5280,3905,-1375
2020,2,6,15,4474,5492,3918,-1574
2020,2,6,16,4667,5710,3930,-1780
2020,2,6,17,4894,5939,4056,-1883
2020,2,6,18,5134,6075,4151,-1924
2020,2,6,19,5287,6289,4309,-1980
2020,2,6,20,5381,6459,4346,-2113
2020,2,6,21,5406,6542,4397,-2145
2020,2,6,22,5463,6608,4440,-2168
2020,2,6,23,5454,6707,4495,-2212
2020,2,7,0,5421,6915,4645,-2270
2020,2,7,1,5220,6926,4665,-2261
2020,2,7,2,4956,6625,4668,-1957
2020,2,7,3,4647,6215,4604,-1611
2020,2,7,4,4243,5602,4257,-1345
2020,2,7,5,3770,4832,3823,-1009
2020,2,7,6,3252,4242,3342,-900
2020,2,7,7,3029,3824,2992,-832
2020,2,7,8,2882,3624,2827,-797
2020,2,7,9,2820,3530,2741,-789
2020,2,7,10,2869,3577,2760,-817
2020,2,7,11,3101,3904,2987,-917
2020,2,7,12,3552,4542,3456,-1086
2020,2,7,13,3887,4962,3829,-1133
2020,2,7,14,4019,5130,3963,-1167
2020,2,7,15,4123,5219,4039,-1180
2020,2,7,16,4210,5283,4082,-1201
2020,2,7,17,4196,5191,4036,-1155
2020,2,7,18,4158,5182,4001,-1181
2020,2,7,19,4056,5099,3990,-1109
2020,2,7,20,4050,5010,3917,-1093
2020,2,7,21,4023,5004,3906,-1098
2020,2,7,22,4109,5094,3972,-1122
2020,2,7,23,4119,5298,4091,-1207
2020,2,8,0,4297,5746,4377,-1369
2020,2,8,1,4217,5898,4485,-1413
2020,2,8,2,4089,5861,4443,-1418
2020,2,8,3,4038,5756,4337,-1419
2020,2,8,4,3887,5518,4134,-1384
2020,2,8,5,3541,5255,3865,-1390
2020,2,8,6,3502,5168,3812,-1356
2020,2,8,7,3442,5094,3728,-1366
2020,2,8,8,3489,5138,3741,-1397
2020,2,8,9,3514,5234,3788,-1446
2020,2,8,10,3645,5468,3976,-1492
2020,2,8,11,3886,5810,4321,-1489
2020,2,8,12,4350,6351,4798,-1553
2020,2,8,13,4754,7025,5178,-1847
2020,2,8,14,4990,7238,5375,-1863
2020,2,8,15,4757,6887,5397,-1490
2020,2,8,16,4527,6379,5069,-1310
2020,2,8,17,4294,5851,4557,-1294
2020,2,8,18,4043,5445,4191,-1254
2020,2,8,19,3849,5148,3997,-1151
2020,2,8,20,3785,4972,3885,-1087
2020,2,8,21,3718,4942,3862,-1080
2020,2,8,22,3757,5013,3913,-1100
2020,2,8,23,3812,5119,3989,-1130
2020,2,9,0,3918,5398,4172,-1226
2020,2,9,1,4140,5531,4268,-1263
2020,2,9,2,4029,5432,4189,-1243
2020,2,9,3,3846,5299,4071,-1228
2020,2,9,4,3656,5077,3879,-1198
2020,2,9,5,3520,4843,3654,-1189
2020,2,9,6,3255,4560,3401,-1159
2020,2,9,7,3106,4454,3279,-1175
2020,2,9,8,3068,4428,3234,-1194
2020,2,9,9,3083,4478,3260,-1218
2020,2,9,10,3140,4597,3347,-1250
2020,2,9,11,3287,4814,3520,-1294
2020,2,9,12,3544,5176,3875,-1301
2020,2,9,13,3896,5639,4371,-1268
2020,2,9,14,4155,5886,4719,-1167
2020,2,9,15,4181,5674,4438,-1236
2020,2,9,16,4071,5442,4167,-1275
2020,2,9,17,3975,5255,4015,-1240
2020,2,9,18,3941,5155,3966,-1189
2020,2,9,19,3925,5063,3917,-1146
2020,2,9,20,3919,5078,3932,-1146
2020,2,9,21,4008,5126,3971,-1155
2020,2,9,22,3993,5210,4056,-1154
2020,2,9,23,4078,5342,4143,-1199
2020,2,10,0,4258,5610,4345,-1265
2020,2,10,1,4302,5708,4429,-1279
2020,2,10,2,4113,5441,4248,-1193
2020,2,10,3,3783,5063,3957,-1106
2020,2,10,4,3455,4597,3565,-1032
2020,2,10,5,3134,4124,3185,-939
2020,2,10,6,2882,3806,2929,-877
2020,2,10,7,2677,3624,2753,-871
2020,2,10,8,2569,3580,2710,-870
2020,2,10,9,2537,3609,2728,-881
2020,2,10,10,2647,3762,2819,-943
2020,2,10,11,2998,4218,3154,-1064
2020,2,10,12,3571,4947,3718,-1229
2020,2,10,13,3903,5381,4097,-1284
2020,2,10,14,3959,5334,4104,-1230
2020,2,10,15,4035,5230,4055,-1175
2020,2,10,16,4095,5280,4141,-1139
2020,2,10,17,4201,5370,4243,-1127
2020,2,10,18,4276,5544,4406,-1138
2020,2,10,19,4443,5679,4090,-1589
2020,2,10,20,4550,5902,4670,-1232
2020,2,10,21,4693,6059,4394,-1665
2020,2,10,22,4692,6251,4390,-1861
2020,2,10,23,4744,6303,4601,-1702
2020,2,11,0,4870,6521,4799,-1722
2020,2,11,1,4885,6487,4721,-1766
2020,2,11,2,4651,6126,4618,-1508
2020,2,11,3,4302,5662,4468,-1194
2020,2,11,4,3851,5081,4017,-1064
2020,2,11,5,3455,4499,3538,-961
2020,2,11,6,3269,4057,3171,-886
2020,2,11,7,3029,3777,2935,-842
2020,2,11,8,2919,3606,2784,-822
2020,2,11,9,2857,3543,2732,-811
2020,2,11,10,2913,3610,2766,-844
2020,2,11,11,3165,3955,3023,-932
2020,2,11,12,3656,4585,3483,-1102
2020,2,11,13,3944,4933,3816,-1117
2020,2,11,14,4113,5093,3968,-1125
2020,2,11,15,4299,5311,4005,-1306
2020,2,11,16,4570,5624,4092,-1532
2020,2,11,17,4925,5983,4236,-1747
2020,2,11,18,5221,6275,4474,-1801
2020,2,11,19,5510,6503,4653,-1850
2020,2,11,20,5676,6719,4845,-1874
2020,2,11,21,5739,6911,5011,-1900
2020,2,11,22,5787,6995,4948,-2047
2020,2,11,23,5781,6914,4881,-2033
2020,2,12,0,5747,7007,5012,-1995
2020,2,12,1,5534,6955,5072,-1883
2020,2,12,2,5148,6539,4689,-1850
2020,2,12,3,4769,5992,4404,-1588
2020,2,12,4,4317,5386,4067,-1319
2020,2,12,5,3867,4700,3698,-1002
2020,2,12,6,3454,4227,3325,-902
2020,2,12,7,3195,3923,3107,-816
2020,2,12,8,3048,3731,2959,-772
2020,2,12,9,2982,3667,2873,-794
2020,2,12,10,3025,3709,2895,-814
2020,2,12,11,3276,4031,3137,-894
2020,2,12,12,3739,4637,3595,-1042
2020,2,12,13,4029,5022,3953,-1069
2020,2,12,14,4184,5223,4114,-1109
2020,2,12,15,4402,5490,4202,-1288
2020,2,12,16,4728,5868,4341,-1527
2020,2,12,17,5097,6305,4572,-1733
2020,2,12,18,5395,6617,4782,-1835
2020,2,12,19,5701,6931,5046,-1885
2020,2,12,20,5892,7184,5079,-2105
2020,2,12,21,5952,7382,5224,-2158
2020,2,12,22,6017,7487,5375,-2112
2020,2,12,23,5995,7377,5263,-2114
2020,2,13,0,5948,7306,5234,-2072
2020,2,13,1,5650,7187,5308,-1879
2020,2,13,2,5247,6791,4919,-1872
2020,2,13,3,4868,6293,4675,-1618
2020,2,13,4,4411,5650,4319,-1331
2020,2,13,5,3954,5011,3949,-1062
2020,2,13,6,3601,4515,3581,-934
2020,2,13,7,3327,4179,3306,-873
2020,2,13,8,3159,3982,3159,-823
2020,2,13,9,3074,3878,3062,-816
2020,2,13,10,3100,3938,3094,-844
2020,2,13,11,3343,4251,3324,-927
2020,2,13,12,3812,4881,3804,-1077
2020,2,13,13,4083,5260,4161,-1099
2020,2,13,14,4267,5496,4376,-1120
2020,2,13,15,4490,5718,4390,-1328
2020,2,13,16,4847,6036,4507,-1529
2020,2,13,17,5171,6411,4724,-1687
2020,2,13,18,5496,6790,4642,-2148
2020,2,13,19,5719,7064,4939,-2125
2020,2,13,20,5907,7384,5183,-2201
2020,2,13,21,5957,7610,5480,-2130
2020,2,13,22,5997,7726,5681,-2045
2020,2,13,23,5922,7547,5510,-2037
2020,2,14,0,5811,7467,5507,-1960
2020,2,14,1,5575,7252,5506,-1746
2020,2,14,2,5208,6887,5210,-1677
2020,2,14,3,4827,6380,4760,-1620
2020,2,14,4,4354,5740,4380,-1360
2020,2,14,5,3812,5095,3997,-1098
2020,2,14,6,3452,4590,3605,-985
2020,2,14,7,3151,4237,3318,-919
2020,2,14,8,3003,4051,3163,-888
2020,2,14,9,2899,3936,3064,-872
2020,2,14,10,2917,3991,3091,-900
2020,2,14,11,3146,4310,3324,-986
2020,2,14,12,3630,4894,3786,-1108
2020,2,14,13,3943,5277,4056,-1221
2020,2,14,14,4097,5476,4245,-1231
2020,2,14,15,4256,5612,4288,-1324
2020,2,14,16,4366,5674,4208,-1466
2020,2,14,17,4450,5695,4162,-1533
2020,2,14,18,4539,5768,4161,-1607
2020,2,14,19,4621,5848,4189,-1659
2020,2,14,20,4615,5860,4328,-1532
2020,2,14,21,4547,5841,4255,-1586
2020,2,14,22,4500,5752,4209,-1543
2020,2,14,23,4358,5729,4178,-1551
2020,2,15,0,4339,5826,4232,-1594
2020,2,15,1,4196,5700,4221,-1479
2020,2,15,2,4252,5439,4113,-1326
2020,2,15,3,3967,5148,4011,-1137
2020,2,15,4,3636,4781,3714,-1067
2020,2,15,5,3466,4432,3384,-1048
2020,2,15,6,3176,4176,3229,-947
2020,2,15,7,2959,3943,3022,-921
2020,2,15,8,2843,3812,2907,-905
2020,2,15,9,2790,3724,2792,-932
2020,2,15,10,2796,3773,2822,-951
2020,2,15,11,2878,3960,3043,-917
2020,2,15,12,3089,4332,3419,-913
2020,2,15,13,3432,4829,3837,-992
2020,2,15,14,3649,5241,4188,-1053
2020,2,15,15,3879,5365,4363,-1002
2020,2,15,16,3962,5329,4380,-949
2020,2,15,17,3921,5271,4302,-969
2020,2,15,18,3946,5208,4280,-928
2020,2,15,19,3952,5243,4269,-974
2020,2,15,20,4007,5365,4355,-1010
2020,2,15,21,4058,5449,4429,-1020
2020,2,15,22,4119,5572,4607,-965
2020,2,15,23,4061,5579,4657,-922
2020,2,16,0,4069,5662,4701,-961
2020,2,16,1,4079,5645,4676,-969
2020,2,16,2,3980,5412,4386,-1026
2020,2,16,3,3775,5104,4063,-1041
2020,2,16,4,3526,4719,3675,-1044
2020,2,16,5,3197,4327,3344,-983
2020,2,16,6,3016,3986,3071,-915
2020,2,16,7,2859,3726,2855,-871
2020,2,16,8,2731,3591,2734,-857
2020,2,16,9,2668,3502,2670,-832
2020,2,16,10,2630,3525,2669,-856
2020,2,16,11,2732,3636,2758,-878
2020,2,16,12,2872,3868,2924,-944
2020,2,16,13,3127,4204,3187,-1017
2020,2,16,14,3521,4674,3531,-1143
2020,2,16,15,3794,5026,3913,-1113
2020,2,16,16,3915,5280,4126,-1154
2020,2,16,17,4076,5528,4358,-1170
2020,2,16,18,4212,5768,4570,-1198
2020,2,16,19,4358,6001,4901,-1100
2020,2,16,20,4460,6221,4915,-1306
2020,2,16,21,4593,6354,5011,-1343
2020,2,16,22,4625,6356,5079,-1277
2020,2,16,23,4636,6297,5024,-1273
2020,2,17,0,4716,6385,5093,-1292
2020,2,17,1,4741,6207,4929,-1278
2020,2,17,2,4484,5829,4689,-1140
2020,2,17,3,4182,5421,4239,-1182
2020,2,17,4,3788,4938,3839,-1099
2020,2,17,5,3422,4419,3424,-995
2020,2,17,6,3161,4019,3098,-921
2020,2,17,7,2991,3736,2867,-869
2020,2,17,8,2870,3592,2766,-826
2020,2,17,9,2784,3522,2712,-810
2020,2,17,10,2829,3593,2760,-833
2020,2,17,11,3012,3888,2987,-901
2020,2,17,12,3401,4344,3347,-997
2020,2,17,13,3695,4709,3659,-1050
2020,2,17,14,3889,5038,3934,-1104
2020,2,17,15,4186,5340,4167,-1173
2020,2,17,16,4441,5657,4314,-1343
2020,2,17,17,4682,5953,4455,-1498
2020,2,17,18,4947,6272,4594,-1678
2020,2,17,19,5143,6539,4693,-1846
2020,2,17,20,5341,6783,4848,-1935
2020,2,17,21,5468,6990,5069,-1921
2020,2,17,22,5486,7083,5208,-1875
2020,2,17,23,5358,7013,5165,-1848
2020,2,18,0,5380,6970,5123,-1847
2020,2,18,1,5272,6785,5001,-1784
2020,2,18,2,4959,6370,4853,-1517
2020,2,18,3,4559,5857,4496,-1361
2020,2,18,4,4081,5263,4149,-1114
2020,2,18,5,3634,4658,3646,-1012
2020,2,18,6,3308,4165,3234,-931
2020,2,18,7,3053,3893,3029,-864
2020,2,18,8,2915,3763,2907,-856
2020,2,18,9,2834,3656,2814,-842
2020,2,18,10,2868,3715,2851,-864
2020,2,18,11,3106,4014,3038,-976
2020,2,18,12,3569,4635,3557,-1078
2020,2,18,13,3861,4980,3954,-1026
2020,2,18,14,4048,5208,4147,-1061
2020,2,18,15,4239,5469,4367,-1102
2020,2,18,16,4544,5907,4597,-1310
2020,2,18,17,4868,6315,4764,-1551
2020,2,18,18,5164,6731,4977,-1754
2020,2,18,19,5390,7063,5231,-1832
2020,2,18,20,5608,7309,5525,-1784
2020,2,18,21,5749,7452,5753,-1699
2020,2,18,22,5812,7474,5757,-1717
2020,2,18,23,5719,7358,5643,-1715
2020,2,19,0,5738,7340,5632,-1708
2020,2,19,1,5536,7184,5495,-1689
2020,2,19,2,5173,6751,5135,-1616
2020,2,19,3,4784,6193,4766,-1427
2020,2,19,4,4317,5523,4355,-1168
2020,2,19,5,3831,4872,3834,-1038
2020,2,19,6,3596,4390,3436,-954
2020,2,19,7,3328,4099,3160,-939
2020,2,19,8,3158,3922,3002,-920
2020,2,19,9,3067,3835,2953,-882
2020,2,19,10,3084,3921,2992,-929
2020,2,19,11,3314,4240,3222,-1018
2020,2,19,12,3771,4831,3689,-1142
2020,2,19,13,4058,5191,4035,-1156
2020,2,19,14,4251,5404,4252,-1152
2020,2,19,15,4462,5619,4450,-1169
2020,2,19,16,4794,5879,4533,-1346
2020,2,19,17,5128,6152,4594,-1558
2020,2,19,18,5378,6479,4733,-1746
2020,2,19,19,5681,6764,5072,-1692
2020,2,19,20,5860,6953,5183,-1770
2020,2,19,21,5961,7129,5313,-1816
2020,2,19,22,6032,7176,5351,-1825
2020,2,19,23,5944,7111,5272,-1839
2020,2,20,0,5825,7112,5299,-1813
2020,2,20,1,5614,7021,5212,-1809
2020,2,20,2,5329,6626,4932,-1694
2020,2,20,3,4922,6078,4641,-1437
2020,2,20,4,4413,5497,4309,-1188
2020,2,20,5,3859,4863,3803,-1060
2020,2,20,6,3492,4384,3442,-942
2020,2,20,7,3239,4038,3143,-895
2020,2,20,8,3068,3878,3010,-868
2020,2,20,9,2982,3809,2960,-849
2020,2,20,10,3009,3845,2978,-867
2020,2,20,11,3254,4163,3217,-946
2020,2,20,12,3723,4790,3766,-1024
2020,2,20,13,3997,5156,4081,-1075
2020,2,20,14,4200,5325,4343,-982
2020,2,20,15,4401,5484,4456,-1028
2020,2,20,16,4734,5703,4557,-1146
2020,2,20,17,4883,5957,4584,-1373
2020,2,20,18,5172,6318,4626,-1692
2020,2,20,19,5383,6639,4883,-1756
2020,2,20,20,5521,6929,5117,-1812
2020,2,20,21,5559,7164,5325,-1839
2020,2,20,22,5624,7237,5418,-1819
2020,2,20,23,5439,7197,5398,-1799
2020,2,21,0,5290,7118,5328,-1790
2020,2,21,1,5249,7009,5212,-1797
2020,2,21,2,4892,6615,4980,-1635
2020,2,21,3,4467,6133,4712,-1421
2020,2,21,4,3988,5526,4377,-1149
2020,2,21,5,3492,4834,3784,-1050
2020,2,21,6,3242,4308,3397,-911
2020,2,21,7,2970,3994,3106,-888
2020,2,21,8,2718,3828,3102,-726
2020,2,21,9,2543,3715,3008,-707
2020,2,21,10,2463,3773,3028,-745
2020,2,21,11,2632,4060,3198,-862
2020,2,21,12,3160,4724,3671,-1053
2020,2,21,13,3604,5193,4193,-1000
2020,2,21,14,3867,5492,4429,-1063
2020,2,21,15,4147,5700,4434,-1266
2020,2,21,16,4379,5808,4407,-1401
2020,2,21,17,4398,5812,4417,-1395
2020,2,21,18,4528,5770,4384,-1386
2020,2,21,19,4460,5734,4358,-1376
2020,2,21,20,4293,5734,4353,-1381
2020,2,21,21,4226,5820,4464,-1356
2020,2,21,22,4343,6083,4612,-1471
2020,2,21,23,4427,6483,5000,-1483
2020,2,22,0,4957,6941,5434,-1507
2020,2,22,1,5129,7109,5731,-1378
2020,2,22,2,5044,7090,5822,-1268
2020,2,22,3,4922,6933,5503,-1430
2020,2,22,4,4762,6629,5169,-1460
2020,2,22,5,4101,6297,4887,-1410
2020,2,22,6,3975,6095,4666,-1429
2020,2,22,7,3843,6000,4577,-1423
2020,2,22,8,3848,6041,4691,-1350
2020,2,22,9,3924,6155,4786,-1369
2020,2,22,10,4009,6333,4810,-1523
2020,2,22,11,4326,6655,5003,-1652
2020,2,22,12,4709,7142,5644,-1498
2020,2,22,13,5115,7692,6260,-1432
2020,2,22,14,5380,7714,6323,-1391
2020,2,22,15,5248,7258,5755,-1503
2020,2,22,16,4855,6567,5133,-1434
2020,2,22,17,4645,5971,4538,-1433
2020,2,22,18,4411,5507,4211,-1296
2020,2,22,19,4257,5196,4014,-1182
2020,2,22,20,4102,5000,3873,-1127
2020,2,22,21,4055,4934,3829,-1105
2020,2,22,22,4155,4963,3869,-1094
2020,2,22,23,4172,5091,3942,-1149
2020,2,23,0,4363,5394,4153,-1241
2020,2,23,1,4446,5601,4307,-1294
2020,2,23,2,4346,5500,4218,-1282
2020,2,23,3,4152,5359,4103,-1256
2020,2,23,4,3896,5125,3907,-1218
2020,2,23,5,3624,4854,3657,-1197
2020,2,23,6,3249,4649,3493,-1156
2020,2,23,7,3103,4551,3417,-1134
2020,2,23,8,3107,4562,3387,-1175
2020,2,23,9,3132,4589,3353,-1236
2020,2,23,10,3208,4716,3422,-1294
2020,2,23,11,3354,4922,3544,-1378
2020,2,23,12,3567,5280,3787,-1493
2020,2,23,13,3872,5710,4151,-1559
2020,2,23,14,4093,5886,4312,-1574
2020,2,23,15,4181,5680,4217,-1463
2020,2,23,16,4056,5373,4057,-1316
2020,2,23,17,3970,5154,3942,-1212
2020,2,23,18,3954,5096,3908,-1188
2020,2,23,19,3905,5069,3911,-1158
2020,2,23,20,3916,5095,3945,-1150
2020,2,23,21,3985,5127,3982,-1145
2020,2,23,22,4010,5272,4091,-1181
2020,2,23,23,4075,5365,4161,-1204
2020,2,24,0,4179,5609,4327,-1282
2020,2,24,1,4278,5718,4479,-1239
2020,2,24,2,4095,5462,4391,-1071
2020,2,24,3,3842,5081,3969,-1112
2020,2,24,4,3486,4604,3567,-1037
2020,2,24,5,3109,4089,3148,-941
2020,2,24,6,2841,3863,2972,-891
2020,2,24,7,2714,3699,2867,-832
2020,2,24,8,2669,3652,2796,-856
2020,2,24,9,2688,3692,2810,-882
2020,2,24,10,2812,3852,2918,-934
2020,2,24,11,3117,4306,3248,-1058
2020,2,24,12,3667,5037,3796,-1241
2020,2,24,13,3981,5435,4183,-1252
2020,2,24,14,4015,5375,4175,-1200
2020,2,24,15,3987,5296,4132,-1164
2020,2,24,16,4149,5228,4080,-1148
2020,2,24,17,4113,5291,4164,-1127
2020,2,24,18,4142,5351,4202,-1149
2020,2,24,19,4222,5466,4299,-1167
2020,2,24,20,4322,5565,4398,-1167
2020,2,24,21,4368,5647,4449,-1198
2020,2,24,22,4433,5758,4576,-1182
2020,2,24,23,4427,5904,4646,-1258
2020,2,25,0,4650,6097,4745,-1352
2020,2,25,1,4726,6224,4924,-1300
2020,2,25,2,4488,5928,4689,-1239
2020,2,25,3,4165,5477,4368,-1109
2020,2,25,4,3723,4936,3949,-987
2020,2,25,5,3278,4374,3461,-913
2020,2,25,6,3008,3983,3137,-846
2020,2,25,7,2800,3712,2928,-784
2020,2,25,8,2704,3583,2876,-707
2020,2,25,9,2679,3554,2769,-785
2020,2,25,10,2737,3640,2833,-807
2020,2,25,11,2996,4002,3117,-885
2020,2,25,12,3483,4602,3564,-1038
2020,2,25,13,3779,4933,3899,-1034
2020,2,25,14,3927,5087,4048,-1039
2020,2,25,15,4067,5286,4205,-1081
2020,2,25,16,4254,5523,4407,-1116
2020,2,25,17,4479,5724,4504,-1220
2020,2,25,18,4756,5912,4490,-1422
2020,2,25,19,4951,6043,4886,-1157
2020,2,25,20,5100,6110,4914,-1196
2020,2,25,21,5234,6205,5004,-1201
2020,2,25,22,5260,6286,5083,-1203
2020,2,25,23,5246,6364,5093,-1271
2020,2,26,0,5257,6555,5246,-1309
2020,2,26,1,5223,6457,5201,-1256
2020,2,26,2,4960,6079,4873,-1206
2020,2,26,3,4589,5621,4479,-1142
2020,2,26,4,4147,5079,4050,-1029
2020,2,26,5,3693,4531,3568,-963
2020,2,26,6,3390,4029,3168,-861
2020,2,26,7,3154,3757,2973,-784
2020,2,26,8,3018,3629,2856,-773
2020,2,26,9,2972,3549,2793,-756
2020,2,26,10,3010,3619,2812,-807
2020,2,26,11,3274,3917,3029,-888
2020,2,26,12,3723,4485,3436,-1049
2020,2,26,13,3999,4855,3800,-1055
2020,2,26,14,4177,5024,3975,-1049
2020,2,26,15,4391,5268,4186,-1082
2020,2,26,16,4601,5525,4443,-1082
2020,2,26,17,4703,5689,4564,-1125
2020,2,26,18,4871,5804,4663,-1141
2020,2,26,19,5051,5824,4687,-1137
2020,2,26,20,5124,5741,4613,-1128
2020,2,26,21,5179,5660,4544,-1116
2020,2,26,22,5131,5617,4486,-1131
2020,2,26,23,5025,5679,4479,-1200
2020,2,27,0,5046,5845,4577,-1268
2020,2,27,1,5057,5840,4589,-1251
2020,2,27,2,4721,5640,4432,-1208
2020,2,27,3,4417,5265,4147,-1118
2020,2,27,4,3940,4781,3765,-1016
2020,2,27,5,3351,4302,3338,-964
2020,2,27,6,2996,3986,3072,-914
2020,2,27,7,2788,3813,2920,-893
2020,2,27,8,2688,3753,2864,-889
2020,2,27,9,2710,3822,2877,-945
2020,2,27,10,2795,4011,2999,-1012
2020,2,27,11,3119,4529,3354,-1175
2020,2,27,12,3718,5396,4014,-1382
2020,2,27,13,4083,5962,4580,-1382
2020,2,27,14,4111,5984,4645,-1339
2020,2,27,15,4076,5848,4538,-1310
2020,2,27,16,4076,5714,4392,-1322
2020,2,27,17,4114,5514,4269,-1245
2020,2,27,18,4135,5338,4091,-1247
2020,2,27,19,4099,5187,3999,-1188
2020,2,27,20,4068,5106,3951,-1155
2020,2,27,21,4129,5076,3928,-1148
2020,2,27,22,4139,5202,4054,-1148
2020,2,27,23,4235,5469,4207,-1262
2020,2,28,0,4504,6038,4596,-1442
2020,2,28,1,4708,6497,5094,-1403
2020,2,28,2,4679,6545,5152,-1393
2020,2,28,3,4489,6391,4852,-1539
2020,2,28,4,4196,6034,4506,-1528
2020,2,28,5,3940,5676,4259,-1417
2020,2,28,6,3732,5432,3899,-1533
2020,2,28,7,3688,5354,3813,-1541
2020,2,28,8,3690,5409,3826,-1583
2020,2,28,9,3737,5546,3909,-1637
2020,2,28,10,3956,5853,4169,-1684
2020,2,28,11,4430,6501,4832,-1669
2020,2,28,12,5246,7443,5887,-1556
2020,2,28,13,5687,7941,6447,-1494
2020,2,28,14,5510,7535,6047,-1488
2020,2,28,15,5113,6866,5330,-1536
2020,2,28,16,4653,6288,4815,-1473
2020,2,28,17,4401,5818,4381,-1437
2020,2,28,18,4230,5496,4252,-1244
2020,2,28,19,4084,5252,4080,-1172
2020,2,28,20,4026,5068,3958,-1110
2020,2,28,21,4052,5023,3934,-1089
2020,2,28,22,4081,5103,3989,-1114
2020,2,28,23,4125,5317,4124,-1193
2020,2,29,0,4311,5763,4420,-1343
2020,2,29,1,4552,6107,4642,-1465
2020,2,29,2,4459,6164,4685,-1479
2020,2,29,3,4360,6105,4622,-1483
2020,2,29,4,4173,5860,4395,-1465
2020,2,29,5,4097,5601,4144,-1457
2020,2,29,6,3874,5378,3982,-1396
2020,2,29,7,3860,5254,3784,-1470
2020,2,29,8,3856,5153,3691,-1462
2020,2,29,9,3961,5163,3637,-1526
2020,2,29,10,4084,5212,3530,-1682
2020,2,29,11,4311,5425,3600,-1825
2020,2,29,12,4545,5810,4056,-1754
2020,2,29,13,4919,6304,4577,-1727
2020,2,29,14,5201,6417,4762,-1655
2020,2,29,15,4917,6164,4534,-1630
2020,2,29,16,4773,5840,4309,-1531
2020,2,29,17,4405,5504,4107,-1397
2020,2,29,18,4149,5251,3930,-1321
2020,2,29,19,3956,5017,3859,-1158
2020,2,29,20,3821,4868,3737,-1131
2020,2,29,21,3792,4813,3700,-1113
2020,2,29,22,3836,4869,3735,-1134
2020,2,29,23,3874,5000,3828,-1172
2020,3,1,0,4140,5357,4066,-1291
2020,3,1,1,4239,5625,4277,-1348
2020,3,1,2,4143,5610,4257,-1353
2020,3,1,3,3997,5533,4177,-1356
2020,3,1,4,3843,5394,4009,-1385
2020,3,1,5,3730,5219,3870,-1349
2020,3,1,6,3707,4926,3573,-1353
2020,3,1,7,3646,5105,3649,-1456
2020,3,1,8,3597,5195,3706,-1489
2020,3,1,9,3672,5327,3729,-1598
2020,3,1,10,3791,5537,3723,-1814
2020,3,1,11,4021,5891,3967,-1924
2020,3,1,12,4423,6411,4231,-2180
2020,3,1,13,4836,7018,4804,-2214
2020,3,1,14,4972,6867,4822,-2045
2020,3,1,15,4714,6335,4435,-1900
2020,3,1,16,4532,5756,4141,-1615
2020,3,1,17,4259,5371,3965,-1406
2020,3,1,18,4035,5126,3838,-1288
2020,3,1,19,3794,4950,3818,-1132
2020,3,1,20,3744,4871,3777,-1094
2020,3,1,21,3792,4891,3792,-1099
2020,3,1,22,3857,5003,3909,-1094
2020,3,1,23,3917,5062,3908,-1154
2020,3,2,0,4149,5426,4179,-1247
2020,3,2,1,4345,5634,4328,-1306
2020,3,2,2,4241,5494,4211,-1283
2020,3,2,3,3999,5168,3959,-1209
2020,3,2,4,3653,4799,3632,-1167
2020,3,2,5,3371,4422,3334,-1088
2020,3,2,6,3087,4193,3151,-1042
2020,3,2,7,2947,4095,3052,-1043
2020,3,2,8,2900,4068,3020,-1048
2020,3,2,9,2913,4090,3028,-1062
2020,3,2,10,3030,4263,3197,-1066
2020,3,2,11,3355,4760,3543,-1217
2020,3,2,12,3913,5540,4159,-1381
2020,3,2,13,4273,5866,4532,-1334
2020,3,2,14,4260,5664,4437,-1227
2020,3,2,15,4131,5393,4257,-1136
2020,3,2,16,4079,5236,4084,-1152
2020,3,2,17,4055,5151,4048,-1103
2020,3,2,18,4048,5171,4043,-1128
2020,3,2,19,3980,5176,4077,-1099
2020,3,2,20,3972,5211,4112,-1099
2020,3,2,21,4009,5277,4160,-1117
2020,3,2,22,4081,5396,4297,-1099
2020,3,2,23,4196,5614,4413,-1201
2020,3,3,0,4358,5890,4600,-1290
2020,3,3,1,4450,5993,4703,-1290
2020,3,3,2,4327,5734,4505,-1229
2020,3,3,3,4057,5333,4196,-1137
2020,3,3,4,3659,4769,3718,-1051
2020,3,3,5,3267,4204,3270,-934
2020,3,3,6,2949,3781,2905,-876
2020,3,3,7,2736,3559,2711,-848
2020,3,3,8,2669,3425,2613,-812
2020,3,3,9,2650,3416,2603,-813
2020,3,3,10,2674,3492,2636,-856
2020,3,3,11,2930,3855,2910,-945
2020,3,3,12,3399,4506,3446,-1060
2020,3,3,13,3720,4839,3723,-1116
2020,3,3,14,3771,4900,3792,-1108
2020,3,3,15,3887,4976,3853,-1123
2020,3,3,16,3967,5126,4017,-1109
2020,3,3,17,4132,5318,4155,-1163
2020,3,3,18,4383,5510,4108,-1402
2020,3,3,19,4589,5728,4281,-1447
2020,3,3,20,4744,5928,4429,-1499
2020,3,3,21,4868,6114,4395,-1719
2020,3,3,22,4966,6234,4537,-1697
2020,3,3,23,4940,6350,4786,-1564
2020,3,4,0,4949,6447,4955,-1492
2020,3,4,1,4978,6534,5053,-1481
2020,3,4,2,4788,6197,4898,-1299
2020,3,4,3,4456,5717,4491,-1226
2020,3,4,4,4030,5096,3942,-1154
2020,3,4,5,3569,4474,3456,-1018
2020,3,4,6,3324,4010,3101,-909
2020,3,4,7,3086,3728,2867,-861
2020,3,4,8,2959,3570,2750,-820
2020,3,4,9,2917,3484,2684,-800
2020,3,4,10,2949,3569,2742,-827
2020,3,4,11,3228,3907,3008,-899
2020,3,4,12,3695,4491,3510,-981
2020,3,4,13,4001,4834,3785,-1049
2020,3,4,14,4157,5073,3998,-1075
2020,3,4,15,4318,5294,4055,-1239
2020,3,4,16,4573,5665,4201,-1464
2020,3,4,17,4985,6085,4502,-1583
2020,3,4,18,5391,6519,4866,-1653
2020,3,4,19,5597,6882,5283,-1599
2020,3,4,20,5809,7141,5409,-1732
2020,3,4,21,5963,7366,5676,-1690
2020,3,4,22,6042,7522,5799,-1723
2020,3,4,23,6016,7499,5654,-1845
2020,3,5,0,5904,7354,5533,-1821
2020,3,5,1,5795,7253,5628,-1625
2020,3,5,2,5441,6815,5193,-1622
2020,3,5,3,5037,6254,4662,-1592
2020,3,5,4,4528,5604,4275,-1329
2020,3,5,5,4067,4882,3870,-1012
2020,3,5,6,3635,4360,3418,-942
2020,3,5,7,3369,4045,3153,-892
2020,3,5,8,3186,3864,3032,-832
2020,3,5,9,3104,3809,2959,-850
2020,3,5,10,3134,3892,3021,-871
2020,3,5,11,3400,4219,3263,-956
2020,3,5,12,3865,4810,3757,-1053
2020,3,5,13,4139,5146,4039,-1107
2020,3,5,14,4357,5439,4276,-1163
2020,3,5,15,4609,5837,4426,-1411
2020,3,5,16,4922,6376,4739,-1637
2020,3,5,17,5373,6898,5231,-1667
2020,3,5,18,5669,7352,5712,-1640
2020,3,5,19,5851,7611,6130,-1481
2020,3,5,20,6054,7773,6065,-1708
2020,3,5,21,6153,7887,6164,-1723
2020,3,5,22,6167,7888,6158,-1730
2020,3,5,23,6004,7742,5998,-1744
2020,3,6,0,5881,7656,6108,-1548
2020,3,6,1,5753,7618,6060,-1558
2020,3,6,2,5469,7271,5608,-1663
2020,3,6,3,5070,6773,5130,-1643
2020,3,6,4,4575,6082,4641,-1441
2020,3,6,5,4058,5343,4235,-1108
2020,3,6,6,3618,4779,3791,-988
2020,3,6,7,3340,4337,3422,-915
2020,3,6,8,3117,4039,3182,-857
2020,3,6,9,3007,3873,3033,-840
2020,3,6,10,3014,3839,2970,-869
2020,3,6,11,3223,4075,3145,-930
2020,3,6,12,3638,4627,3628,-999
2020,3,6,13,3846,4919,3850,-1069
2020,3,6,14,3967,5055,3961,-1094
2020,3,6,15,4201,5147,4047,-1100
2020,3,6,16,4098,5211,4094,-1117
2020,3,6,17,4266,5253,4163,-1090
2020,3,6,18,4405,5313,4180,-1133
2020,3,6,19,4485,5378,4222,-1156
2020,3,6,20,4494,5412,4236,-1176
2020,3,6,21,4494,5516,4315,-1201
2020,3,6,22,4473,5543,4390,-1153
2020,3,6,23,4319,5507,4348,-1159
2020,3,7,0,4291,5492,4320,-1172
2020,3,7,1,4428,5540,4357,-1183
2020,3,7,2,4275,5281,4106,-1175
2020,3,7,3,3959,5006,3896,-1110
2020,3,7,4,3606,4633,3545,-1088
2020,3,7,5,3383,4233,3231,-1002
2020,3,7,6,3196,4045,3208,-837
2020,3,7,7,3108,3875,3083,-792
2020,3,7,8,3131,3844,3028,-816
2020,3,7,9,3164,3868,3001,-867
2020,3,7,10,3229,4027,3142,-885
2020,3,7,11,3477,4310,3345,-965
2020,3,7,12,3760,4810,3720,-1090
2020,3,7,13,4298,5410,4045,-1365
2020,3,7,14,4412,5734,4403,-1331
2020,3,7,15,4304,5779,4471,-1308
2020,3,7,16,4280,5598,4291,-1307
2020,3,7,17,4173,5336,4099,-1237
2020,3,7,18,4003,5106,3941,-1165
2020,3,7,19,3939,4934,3827,-1107
2020,3,7,20,3589,4840,3762,-1078
2020,3,7,21,3560,4823,3761,-1062
2020,3,7,22,3667,4912,3827,-1085
2020,3,7,23,3919,5022,3908,-1114
2020,3,8,0,4046,5307,4116,-1191
2020,3,8,1,4238,5555,4300,-1255
2020,3,8,2,4152,5501,4255,-1246
2020,3,8,3,3977,5371,4154,-1217
2020,3,8,4,3815,5167,3873,-1294
2020,3,8,5,3545,4932,3811,-1121
2020,3,8,6,3288,4698,3658,-1040
2020,3,8,7,3063,4595,3557,-1038
2020,3,8,8,3070,4593,3529,-1064
2020,3,8,9,3089,4646,3549,-1097
2020,3,8,10,3228,4784,3657,-1127
2020,3,8,11,3475,5052,3867,-1185
2020,3,8,12,3783,5409,3993,-1416
2020,3,8,13,4038,5788,4438,-1350
2020,3,8,14,4108,5951,4556,-1395
2020,3,8,15,4110,5792,4558,-1234
2020,3,8,16,4028,5465,4273,-1192
2020,3,8,17,3971,5198,3992,-1206
2020,3,8,18,3877,5065,3893,-1172
2020,3,8,19,3841,4980,3830,-1150
2020,3,8,20,3827,4956,3817,-1139
2020,3,8,21,3842,5026,3889,-1137
2020,3,8,22,3889,5097,3946,-1151
2020,3,8,23,4003,5163,3998,-1165
2020,3,9,0,4112,5322,4124,-1198
2020,3,9,1,4218,5505,4266,-1239
2020,3,9,2,3931,5222,4050,-1172
2020,3,9,3,3547,4763,3650,-1113
2020,3,9,4,3221,4240,3401,-839
2020,3,9,5,3016,3831,2967,-864
2020,3,9,6,2856,3633,2778,-855
2020,3,9,7,2789,3563,2724,-839
2020,3,9,8,2787,3579,2726,-853
2020,3,9,9,2889,3720,2805,-915
2020,3,9,10,3202,4138,3109,-1029
2020,3,9,11,3659,4840,3672,-1168
2020,3,9,12,3992,5319,4067,-1252
2020,3,9,13,4061,5382,4128,-1254
2020,3,9,14,4053,5356,4150,-1206
2020,3,9,15,4102,5267,4108,-1159
2020,3,9,16,4036,5194,4073,-1121
2020,3,9,17,4054,5202,4039,-1163
2020,3,9,18,3998,5197,4097,-1100
2020,3,9,19,4080,5174,4074,-1100
2020,3,9,20,4108,5237,4106,-1131
2020,3,9,21,4195,5412,4262,-1150
2020,3,9,22,4316,5538,4331,-1207
2020,3,9,23,4380,5605,4400,-1205
2020,3,10,0,4477,5740,4510,-1230
2020,3,10,1,4437,5839,4586,-1253
2020,3,10,2,4147,5446,4288,-1158
2020,3,10,3,3789,4927,3829,-1098
2020,3,10,4,3376,4340,3380,-960
2020,3,10,5,3049,3922,3049,-873
2020,3,10,6,2813,3648,2824,-824
2020,3,10,7,2720,3491,2699,-792
2020,3,10,8,2701,3441,2659,-782
2020,3,10,9,2759,3530,2721,-809
2020,3,10,10,3037,3888,2998,-890
2020,3,10,11,3491,4473,3478,-995
2020,3,10,12,3810,4876,3811,-1065
2020,3,10,13,3880,4946,3866,-1080
2020,3,10,14,3927,5013,3945,-1068
2020,3,10,15,3961,5099,4063,-1036
2020,3,10,16,4072,5292,4175,-1117
2020,3,10,17,4112,5463,4255,-1208
2020,3,10,18,4160,5626,4416,-1210
2020,3,10,19,4259,5728,4511,-1217
2020,3,10,20,4380,5790,4573,-1217
2020,3,10,21,4545,5916,4633,-1283
2020,3,10,22,4645,6052,4754,-1298
2020,3,10,23,4670,6069,4789,-1280
2020,3,11,0,4668,6114,4896,-1218
2020,3,11,1,4653,6128,4887,-1241
2020,3,11,2,4354,5702,4452,-1250
2020,3,11,3,3903,5128,3990,-1138
2020,3,11,4,3432,4501,3505,-996
2020,3,11,5,3210,4035,3169,-866
2020,3,11,6,2960,3718,2905,-813
2020,3,11,7,2814,3564,2774,-790
2020,3,11,8,2763,3487,2715,-772
2020,3,11,9,2805,3517,2730,-787
2020,3,11,10,3031,3840,2968,-872
2020,3,11,11,3430,4432,3462,-970
2020,3,11,12,3736,4832,3794,-1038
2020,3,11,13,3813,4921,3882,-1039
2020,3,11,14,3952,5036,3969,-1067
2020,3,11,15,4169,5196,4098,-1098
2020,3,11,16,4358,5418,4094,-1324
2020,3,11,17,4509,5650,4160,-1490
2020,3,11,18,4735,5918,4373,-1545
2020,3,11,19,4884,6205,4664,-1541
2020,3,11,20,5086,6478,4911,-1567
2020,3,11,21,5238,6677,5153,-1524
2020,3,11,22,5297,6801,5299,-1502
2020,3,11,23,5283,6711,5229,-1482
2020,3,12,0,5146,6540,5132,-1408
2020,3,12,1,5039,6472,5049,-1423
2020,3,12,2,4701,5984,4548,-1436
2020,3,12,3,4228,5353,4072,-1281
2020,3,12,4,3721,4688,3701,-987
2020,3,12,5,3305,4162,3288,-874
2020,3,12,6,3041,3827,3011,-816
2020,3,12,7,2889,3633,2850,-783
2020,3,12,8,2817,3503,2738,-765
2020,3,12,9,2846,3571,2763,-808
2020,3,12,10,3059,3859,2990,-869
2020,3,12,11,3490,4433,3470,-963
2020,3,12,12,3770,4845,3796,-1049
2020,3,12,13,3904,4923,3876,-1047
2020,3,12,14,4098,5046,3981,-1065
2020,3,12,15,4337,5240,4128,-1112
2020,3,12,16,4599,5463,4112,-1351
2020,3,12,17,4935,5750,4241,-1509
2020,3,12,18,5196,6161,4572,-1589
2020,3,12,19,5399,6520,4827,-1693
2020,3,12,20,5638,6899,5246,-1653
2020,3,12,21,5801,7209,5555,-1654
2020,3,12,22,5785,7371,5773,-1598
2020,3,12,23,5647,7202,5632,-1570
2020,3,13,0,5423,6905,5399,-1506
2020,3,13,1,5279,6744,5251,-1493
2020,3,13,2,4922,6171,4643,-1528
2020,3,13,3,4443,5521,4134,-1387
2020,3,13,4,3902,4847,3810,-1037
2020,3,13,5,3386,4295,3375,-920
2020,3,13,6,3107,3887,3040,-847
2020,3,13,7,2942,3684,2872,-812
2020,3,13,8,2854,3565,2774,-791
2020,3,13,9,2866,3586,2758,-828
2020,3,13,10,3052,3819,2932,-887
2020,3,13,11,3472,4299,3354,-945
2020,3,13,12,3766,4662,3638,-1024
2020,3,13,13,3964,4855,3793,-1062
2020,3,13,14,4177,5111,4006,-1105
2020,3,13,15,4444,5409,4256,-1153
2020,3,13,16,4695,5740,4339,-1401
2020,3,13,17,5140,6174,4651,-1523
2020,3,13,18,5419,6670,5248,-1422
2020,3,13,19,5669,7110,5672,-1438
2020,3,13,20,5888,7415,5967,-1448
2020,3,13,21,6069,7648,6180,-1468
2020,3,13,22,6018,7642,6206,-1436
2020,3,13,23,5750,7369,5958,-1411
2020,3,14,0,5470,6950,5622,-1328
2020,3,14,1,5235,6720,5329,-1391
2020,3,14,2,4899,6177,4764,-1413
2020,3,14,3,4525,5582,4181,-1401
2020,3,14,4,4024,4979,3893,-1086
2020,3,14,5,3542,4460,3509,-951
2020,3,14,6,3250,4037,3166,-871
2020,3,14,7,3048,3778,2958,-820
2020,3,14,8,2924,3632,2841,-791
2020,3,14,9,2897,3569,2790,-779
2020,3,14,10,2920,3596,2790,-806
2020,3,14,11,3044,3816,2983,-833
2020,3,14,12,3257,4108,3207,-901
2020,3,14,13,3620,4499,3489,-1010
2020,3,14,14,4004,4967,3882,-1085
2020,3,14,15,4305,5421,4323,-1098
2020,3,14,16,4626,5847,4581,-1266
2020,3,14,17,4941,6334,4976,-1358
2020,3,14,18,5212,6828,5500,-1328
2020,3,14,19,5435,7261,5829,-1432
2020,3,14,20,5659,7610,5990,-1620
2020,3,14,21,5787,7788,6117,-1671
2020,3,14,22,5765,7865,6117,-1748
2020,3,14,23,5568,7627,5969,-1658
2020,3,15,0,5333,7137,5747,-1390
2020,3,15,1,5196,6873,5447,-1426
2020,3,15,2,4865,6335,4978,-1357
2020,3,15,3,4428,5707,4351,-1356
2020,3,15,4,3987,5075,3962,-1113
2020,3,15,5,3611,4473,3495,-978
2020,3,15,6,3356,4054,3154,-900
2020,3,15,7,3159,3783,2945,-838
2020,3,15,8,3037,3622,2808,-814
2020,3,15,9,3004,3546,2751,-795
2020,3,15,10,3020,3616,2812,-804
2020,3,15,11,3112,3754,2949,-805
2020,3,15,12,3315,3990,3118,-872
2020,3,15,13,3671,4377,3410,-967
2020,3,15,14,4054,4960,3878,-1082
2020,3,15,15,4376,5526,4423,-1103
2020,3,15,16,4760,6065,4777,-1288
2020,3,15,17,5133,6663,5255,-1408
2020,3,15,18,5429,7164,5735,-1429
2020,3,15,19,5674,7561,5834,-1727
2020,3,15,20,5918,7858,6064,-1794
2020,3,15,21,6023,8136,6200,-1936
2020,3,15,22,6038,8199,6325,-1874
2020,3,15,23,5919,7953,6159,-1794
2020,3,16,0,5685,7502,6032,-1470
2020,3,16,1,5512,7255,5773,-1482
2020,3,16,2,5064,6639,5270,-1369
2020,3,16,3,4590,5894,4563,-1331
2020,3,16,4,4048,5180,4046,-1134
2020,3,16,5,3626,4534,3551,-983
2020,3,16,6,3325,4100,3200,-900
2020,3,16,7,3130,3845,2998,-847
2020,3,16,8,3016,3693,2880,-813
2020,3,16,9,3023,3679,2852,-827
2020,3,16,10,3236,3868,2994,-874
2020,3,16,11,3622,4260,3336,-924
2020,3,16,12,3937,4583,3595,-988
2020,3,16,13,4101,4853,3833,-1020
2020,3,16,14,4324,5251,4139,-1112
2020,3,16,15,4633,5707,4495,-1212
2020,3,16,16,5034,6121,4748,-1373
2020,3,16,17,5391,6530,5057,-1473
2020,3,16,18,5692,6890,5451,-1439
2020,3,16,19,5930,7154,5655,-1499
2020,3,16,20,6181,7351,5715,-1636
2020,3,16,21,6369,7487,5860,-1627
2020,3,16,22,6423,7495,5804,-1691
2020,3,16,23,6252,7326,5620,-1706
2020,3,17,0,6003,7114,5536,-1578
2020,3,17,1,5765,6967,5495,-1472
2020,3,17,2,5301,6432,4935,-1497
2020,3,17,3,4780,5823,4324,-1499
2020,3,17,4,4215,5155,3765,-1390
2020,3,17,5,3694,4580,3343,-1237
2020,3,17,6,3369,4161,3194,-967
2020,3,17,7,3155,3888,2999,-889
2020,3,17,8,3037,3764,2884,-880
2020,3,17,9,3031,3750,2879,-871
2020,3,17,10,3189,3912,3000,-912
2020,3,17,11,3549,4264,3301,-963
2020,3,17,12,3850,4565,3548,-1017
2020,3,17,13,4028,4805,3750,-1055
2020,3,17,14,4248,5214,4061,-1153
2020,3,17,15,4547,5674,4380,-1294
2020,3,17,16,4955,6175,4685,-1490
2020,3,17,17,5276,6691,5132,-1559
2020,3,17,18,5577,7159,5624,-1535
2020,3,17,19,5761,7499,5833,-1666
2020,3,17,20,6041,7761,5999,-1762
2020,3,17,21,6182,7892,6068,-1824
2020,3,17,22,6160,7962,6108,-1854
2020,3,17,23,5946,7811,6096,-1715
2020,3,18,0,5816,7443,5885,-1558
2020,3,18,1,5635,7199,5766,-1433
2020,3,18,2,5214,6563,5142,-1421
2020,3,18,3,4701,5867,4520,-1347
2020,3,18,4,4150,5176,3994,-1182
2020,3,18,5,3668,4593,3551,-1042
2020,3,18,6,3351,4209,3250,-959
2020,3,18,7,3149,3977,3074,-903
2020,3,18,8,3050,3838,2966,-872
2020,3,18,9,3038,3830,2942,-888
2020,3,18,10,3196,3998,3086,-912
2020,3,18,11,3528,4335,3375,-960
2020,3,18,12,3831,4601,3585,-1016
2020,3,18,13,4001,4820,3749,-1071
2020,3,18,14,4263,5167,3995,-1172
2020,3,18,15,4643,5663,4357,-1306
2020,3,18,16,4994,6207,4654,-1553
2020,3,18,17,5380,6768,5109,-1659
2020,3,18,18,5729,7308,5621,-1687
2020,3,18,19,5952,7767,6115,-1652
2020,3,18,20,6185,8063,6112,-1951
2020,3,18,21,6379,8339,6313,-2026
2020,3,18,22,6412,8394,6345,-2049
2020,3,18,23,6223,8154,6215,-1939
2020,3,19,0,5960,7658,5829,-1829
2020,3,19,1,5734,7339,5707,-1632
2020,3,19,2,5310,6638,4985,-1653
2020,3,19,3,4819,5937,4405,-1532
2020,3,19,4,4277,5246,4012,-1234
2020,3,19,5,3756,4668,3617,-1051
2020,3,19,6,3428,4251,3288,-963
2020,3,19,7,3199,3963,3059,-904
2020,3,19,8,3089,3803,2922,-881
2020,3,19,9,3068,3764,2889,-875
2020,3,19,10,3211,3917,3032,-885
2020,3,19,11,3549,4216,3323,-893
2020,3,19,12,3848,4497,3536,-961
2020,3,19,13,4048,4745,3770,-975
2020,3,19,14,4338,5177,4057,-1120
2020,3,19,15,4713,5730,4447,-1283
2020,3,19,16,5131,6270,4730,-1540
2020,3,19,17,5600,6849,5121,-1728
2020,3,19,18,5987,7392,5695,-1697
2020,3,19,19,6233,7878,5785,-2093
2020,3,19,20,6518,8102,6098,-2004
2020,3,19,21,6716,8272,6221,-2051
2020,3,19,22,6746,8368,6273,-2095
2020,3,19,23,6516,8197,6126,-2071
2020,3,20,0,6170,7673,5693,-1980
2020,3,20,1,5954,7374,5692,-1682
2020,3,20,2,5485,6725,5072,-1653
2020,3,20,3,4949,5986,4494,-1492
2020,3,20,4,4396,5294,4074,-1220
2020,3,20,5,3764,4718,3632,-1086
2020,3,20,6,3438,4310,3320,-990
2020,3,20,7,3215,4038,3100,-938
2020,3,20,8,3107,3843,2947,-896
2020,3,20,9,3089,3797,2911,-886
2020,3,20,10,3198,3920,2991,-929
2020,3,20,11,3485,4205,3254,-951
2020,3,20,12,3753,4496,3521,-975
2020,3,20,13,4024,4776,3740,-1036
2020,3,20,14,4339,5233,4096,-1137
2020,3,20,15,4706,5787,4508,-1279
2020,3,20,16,5087,6318,4775,-1543
2020,3,20,17,5565,6864,5127,-1737
2020,3,20,18,5962,7385,5548,-1837
2020,3,20,19,6226,7791,5658,-2133
2020,3,20,20,6449,8093,5850,-2243
2020,3,20,21,6592,8458,6184,-2274
2020,3,20,22,6559,8555,6254,-2301
2020,3,20,23,6235,8335,6133,-2202
2020,3,21,0,5921,7773,5646,-2127
2020,3,21,1,5632,7438,5541,-1897
2020,3,21,2,5207,6801,5074,-1727
2020,3,21,3,4774,6097,4578,-1519
2020,3,21,4,4299,5451,4249,-1202
2020,3,21,5,3877,4726,3666,-1060
2020,3,21,6,3539,4312,3350,-962
2020,3,21,7,3295,4021,3131,-890
2020,3,21,8,3147,3862,3011,-851
2020,3,21,9,3096,3773,2940,-833
2020,3,21,10,3104,3787,2941,-846
2020,3,21,11,3214,3890,3037,-853
2020,3,21,12,3387,4075,3209,-866
2020,3,21,13,3793,4397,3450,-947
2020,3,21,14,4230,4966,3874,-1092
2020,3,21,15,4661,5626,4386,-1240
2020,3,21,16,5172,6237,4775,-1462
2020,3,21,17,5562,6830,5313,-1517
2020,3,21,18,5916,7281,5762,-1519
2020,3,21,19,6207,7677,5803,-1874
2020,3,21,20,6424,8006,5892,-2114
2020,3,21,21,6568,8392,6238,-2154
2020,3,21,22,6568,8456,6432,-2024
2020,3,21,23,6310,8198,6134,-2064
2020,3,22,0,5953,7690,5872,-1818
2020,3,22,1,5728,7364,5816,-1548
2020,3,22,2,5329,6749,5198,-1551
2020,3,22,3,4836,6066,4553,-1513
2020,3,22,4,4355,5432,4188,-1244
2020,3,22,5,3851,4759,3649,-1110
2020,3,22,6,3551,4328,3324,-1004
2020,3,22,7,3330,4023,3073,-950
2020,3,22,8,3191,3824,2922,-902
2020,3,22,9,3132,3710,2824,-886
2020,3,22,10,3142,3702,2827,-875
2020,3,22,11,3211,3764,2912,-852
2020,3,22,12,3420,3868,3039,-829
2020,3,22,13,3805,4239,3315,-924
2020,3,22,14,4274,4889,3797,-1092
2020,3,22,15,4692,5568,4313,-1255
2020,3,22,16,5128,6243,4697,-1546
2020,3,22,17,5586,6975,5359,-1616
2020,3,22,18,5935,7504,5915,-1589
2020,3,22,19,6209,7884,5848,-2036
2020,3,22,20,6422,8111,5864,-2247
2020,3,22,21,6605,8239,5940,-2299
2020,3,22,22,6617,8369,6059,-2310
2020,3,22,23,6358,8125,5882,-2243
2020,3,23,0,6104,7654,5660,-1994
2020,3,23,1,5910,7369,5614,-1755
2020,3,23,2,5433,6706,5114,-1592
2020,3,23,3,4901,5993,4483,-1510
2020,3,23,4,4381,5336,4122,-1214
2020,3,23,5,3661,4628,3571,-1057
2020,3,23,6,3338,4254,3281,-973
2020,3,23,7,3146,3986,3077,-909
2020,3,23,8,3044,3830,2949,-881
2020,3,23,9,3039,3817,2913,-904
2020,3,23,10,3205,3974,3045,-929
2020,3,23,11,3506,4304,3342,-962
2020,3,23,12,3794,4581,3609,-972
2020,3,23,13,4041,4868,3843,-1025
2020,3,23,14,4413,5344,4211,-1133
2020,3,23,15,4814,5938,4655,-1283
2020,3,23,16,5216,6563,5034,-1529
2020,3,23,17,5670,7208,5593,-1615
2020,3,23,18,6042,7635,6082,-1553
2020,3,23,19,6346,7972,6143,-1829
2020,3,23,20,6570,8241,6306,-1935
2020,3,23,21,6736,8428,6454,-1974
2020,3,23,22,6754,8525,6568,-1957
2020,3,23,23,6553,8300,6381,-1919
2020,3,24,0,6224,7776,5990,-1786
2020,3,24,1,6009,7441,5747,-1694
2020,3,24,2,5467,6743,5220,-1523
2020,3,24,3,4883,6003,4545,-1458
2020,3,24,4,4327,5324,4103,-1221
2020,3,24,5,3786,4719,3659,-1060
2020,3,24,6,3441,4264,3322,-942
2020,3,24,7,3219,3969,3074,-895
2020,3,24,8,3101,3818,2951,-867
2020,3,24,9,3082,3806,2930,-876
2020,3,24,10,3235,3938,3024,-914
2020,3,24,11,3529,4239,3289,-950
2020,3,24,12,3796,4477,3534,-943
2020,3,24,13,4024,4764,3754,-1010
2020,3,24,14,4333,5223,4105,-1118
2020,3,24,15,4686,5768,4493,-1275
2020,3,24,16,5005,6341,4743,-1598
2020,3,24,17,5523,6992,5272,-1720
2020,3,24,18,5844,7469,5845,-1624
2020,3,24,19,6158,7831,5942,-1889
2020,3,24,20,6383,8087,6203,-1884
2020,3,24,21,6582,8337,6424,-1913
2020,3,24,22,6616,8398,6501,-1897
2020,3,24,23,6463,8163,6273,-1890
2020,3,25,0,6156,7685,5996,-1689
2020,3,25,1,5911,7382,5935,-1447
2020,3,25,2,5394,6698,5249,-1449
2020,3,25,3,4823,5970,4553,-1417
2020,3,25,4,4271,5254,4096,-1158
2020,3,25,5,3756,4718,3655,-1063
2020,3,25,6,3429,4324,3352,-972
2020,3,25,7,3213,4066,3152,-914
2020,3,25,8,3114,3951,3041,-910
2020,3,25,9,3109,3937,3028,-909
2020,3,25,10,3260,4125,3166,-959
2020,3,25,11,3556,4443,3454,-989
2020,3,25,12,3818,4730,3709,-1021
2020,3,25,13,4056,5039,3972,-1067
2020,3,25,14,4393,5483,4302,-1181
2020,3,25,15,4741,6075,4735,-1340
2020,3,25,16,5119,6651,5143,-1508
2020,3,25,17,5430,7223,5581,-1642
2020,3,25,18,5767,7634,6056,-1578
2020,3,25,19,6044,7934,6051,-1883
2020,3,25,20,6293,8167,6216,-1951
2020,3,25,21,6444,8332,6359,-1973
2020,3,25,22,6425,8375,6380,-1995
2020,3,25,23,6268,8098,6279,-1819
2020,3,26,0,6026,7617,6068,-1549
2020,3,26,1,5809,7383,5923,-1460
2020,3,26,2,5337,6817,5286,-1531
2020,3,26,3,4791,6131,4732,-1399
2020,3,26,4,4247,5496,4245,-1251
2020,3,26,5,3827,4943,3825,-1118
2020,3,26,6,3486,4522,3497,-1025
2020,3,26,7,3274,4248,3281,-967
2020,3,26,8,3164,4109,3175,-934
2020,3,26,9,3145,4066,3141,-925
2020,3,26,10,3294,4190,3223,-967
2020,3,26,11,3600,4465,3476,-989
2020,3,26,12,3858,4694,3699,-995
2020,3,26,13,4100,4992,3932,-1060
2020,3,26,14,4427,5422,4296,-1126
2020,3,26,15,4812,5882,4746,-1136
2020,3,26,16,5181,6400,5101,-1299
2020,3,26,17,5648,7031,5566,-1465
2020,3,26,18,5984,7600,5810,-1790
2020,3,26,19,6302,8081,6208,-1873
2020,3,26,20,6552,8431,6524,-1907
2020,3,26,21,6762,8656,6673,-1983
2020,3,26,22,6808,8751,6801,-1950
2020,3,26,23,6583,8461,6538,-1923
2020,3,27,0,6308,7906,6221,-1685
2020,3,27,1,6062,7569,5988,-1581
2020,3,27,2,5538,6879,5404,-1475
2020,3,27,3,4936,6160,4735,-1425
2020,3,27,4,4384,5466,4258,-1208
2020,3,27,5,3861,4909,3808,-1101
2020,3,27,6,3529,4466,3474,-992
2020,3,27,7,3316,4184,3255,-929
2020,3,27,8,3198,4013,3141,-872
2020,3,27,9,3156,3932,3117,-815
2020,3,27,10,3303,4033,3147,-886
2020,3,27,11,3596,4293,3335,-958
2020,3,27,12,3874,4510,3560,-950
2020,3,27,13,4148,4838,3826,-1012
2020,3,27,14,4530,5321,4194,-1127
2020,3,27,15,4988,5864,4607,-1257
2020,3,27,16,5455,6524,5081,-1443
2020,3,27,17,6012,7291,5612,-1679
2020,3,27,18,6440,7944,6134,-1810
2020,3,27,19,6769,8476,6500,-1976
2020,3,27,20,6999,8859,6683,-2176
2020,3,27,21,7185,9106,6873,-2233
2020,3,27,22,7193,9185,6955,-2230
2020,3,27,23,6920,8914,6843,-2071
2020,3,28,0,6425,8283,6430,-1853
2020,3,28,1,6124,7839,5976,-1863
2020,3,28,2,5609,7068,5344,-1724
2020,3,28,3,5070,6345,4866,-1479
2020,3,28,4,4532,5606,4427,-1179
2020,3,28,5,4075,5015,3921,-1094
2020,3,28,6,3702,4529,3545,-984
2020,3,28,7,3446,4226,3303,-923
2020,3,28,8,3292,4034,3151,-883
2020,3,28,9,3214,3919,3095,-824
2020,3,28,10,3218,3892,3047,-845
2020,3,28,11,3323,3968,3082,-886
2020,3,28,12,3511,4063,3279,-784
2020,3,28,13,3904,4449,3529,-920
2020,3,28,14,4414,5084,3941,-1143
2020,3,28,15,4944,5791,4578,-1213
2020,3,28,16,5490,6579,5126,-1453
2020,3,28,17,6117,7371,5817,-1554
2020,3,28,18,6637,8071,6387,-1684
2020,3,28,19,7083,8595,6693,-1902
2020,3,28,20,7428,8946,6928,-2018
2020,3,28,21,7580,9173,7152,-2021
2020,3,28,22,7501,9249,7233,-2016
2020,3,28,23,7173,8947,6996,-1951
2020,3,29,0,6782,8246,6524,-1722
2020,3,29,1,6430,7792,6199,-1593
2020,3,29,2,5905,7046,5406,-1640
2020,3,29,3,5334,6295,4694,-1601
2020,3,29,4,4800,5574,4258,-1316
2020,3,29,5,3921,4975,3853,-1122
2020,3,29,6,3584,4517,3508,-1009
2020,3,29,7,3338,4195,3248,-947
2020,3,29,8,3182,4008,3096,-912
2020,3,29,9,3089,3904,3022,-882
2020,3,29,10,3106,3878,2985,-893
2020,3,29,11,3194,3911,2997,-914
2020,3,29,12,3374,4002,3066,-936
2020,3,29,13,3698,4398,3367,-1031
2020,3,29,14,4209,5079,3877,-1202
2020,3,29,15,4625,5792,4477,-1315
2020,3,29,16,5060,6526,5065,-1461
2020,3,29,17,5766,7280,5696,-1584
2020,3,29,18,6140,7969,6329,-1640
2020,3,29,19,6522,8500,6738,-1762
2020,3,29,20,6826,8922,7042,-1880
2020,3,29,21,7086,9243,7367,-1876
2020,3,29,22,7173,9370,7537,-1833
2020,3,29,23,6806,9088,7376,-1712
2020,3,30,0,6522,8488,6867,-1621
2020,3,30,1,6295,8020,6409,-1611
2020,3,30,2,5750,7197,5558,-1639
2020,3,30,3,5132,6407,4831,-1576
2020,3,30,4,4571,5644,4397,-1247
2020,3,30,5,3827,4980,3884,-1096
2020,3,30,6,3474,4500,3501,-999
2020,3,30,7,3244,4190,3254,-936
2020,3,30,8,3116,4027,3126,-901
2020,3,30,9,3065,3944,3049,-895
2020,3,30,10,3225,4041,3118,-923
2020,3,30,11,3496,4329,3331,-998
2020,3,30,12,3738,4592,3585,-1007
2020,3,30,13,3973,4936,3868,-1068
2020,3,30,14,4359,5443,4248,-1195
2020,3,30,15,4742,6060,4718,-1342
2020,3,30,16,5256,6745,5317,-1428
2020,3,30,17,5967,7497,5963,-1534
2020,3,30,18,6319,8093,6457,-1636
2020,3,30,19,6714,8604,6889,-1715
2020,3,30,20,6973,9011,7246,-1765
2020,3,30,21,7178,9350,7549,-1801
2020,3,30,22,7250,9440,7632,-1808
2020,3,30,23,6998,9063,7386,-1677
2020,3,31,0,6574,8437,6776,-1661
2020,3,31,1,6325,8054,6477,-1577
2020,3,31,2,5767,7269,5726,-1543
2020,3,31,3,5112,6431,4928,-1503
2020,3,31,4,4501,5671,4430,-1241
2020,3,31,5,4004,5057,3996,-1061
2020,3,31,6,3653,4624,3658,-966
2020,3,31,7,3425,4303,3406,-897
2020,3,31,8,3292,4131,3275,-856
2020,3,31,9,3243,4072,3210,-862
2020,3,31,10,3374,4198,3289,-909
2020,3,31,11,3656,4448,3512,-936
2020,3,31,12,3879,4716,3747,-969
2020,3,31,13,4127,5040,4021,-1019
2020,3,31,14,4463,5472,4340,-1132
2020,3,31,15,4865,6059,4804,-1255
2020,3,31,16,5297,6701,5198,-1503
2020,3,31,17,5831,7302,5739,-1563
2020,3,31,18,6229,7803,6151,-1652
2020,3,31,19,6580,8117,6491,-1626
2020,3,31,20,6807,8352,6606,-1746
2020,3,31,21,6970,8455,6715,-1740
2020,3,31,22,6945,8386,6660,-1726
2020,3,31,23,6647,8081,6573,-1508
2020,4,1,0,6244,7700,6149,-1551
2020,4,1,1,6032,7600,5990,-1610
2020,4,1,2,5480,7073,5444,-1629
2020,4,1,3,4878,6391,4878,-1513
2020,4,1,4,4296,5685,4488,-1197
2020,4,1,5,3780,5098,3987,-1111
2020,4,1,6,3449,4647,3642,-1005
2020,4,1,7,3246,4333,3404,-929
2020,4,1,8,3140,4094,3211,-883
2020,4,1,9,3133,3950,3096,-854
2020,4,1,10,3288,3954,3079,-875
2020,4,1,11,3552,4117,3189,-928
2020,4,1,12,3737,4293,3391,-902
2020,4,1,13,3846,4488,3553,-935
2020,4,1,14,4057,4684,3683,-1001
2020,4,1,15,4293,4840,3799,-1041
2020,4,1,16,4391,5017,3933,-1084
2020,4,1,17,4468,5193,4071,-1122
2020,4,1,18,4600,5386,4209,-1177
2020,4,1,19,4765,5537,4380,-1157
2020,4,1,20,4888,5735,4533,-1202
2020,4,1,21,5065,5985,4707,-1278
2020,4,1,22,5138,6181,4892,-1289
2020,4,1,23,4922,6142,4822,-1320
2020,4,2,0,4763,5826,4598,-1228
2020,4,2,1,4709,5706,4497,-1209
2020,4,2,2,4348,5255,4113,-1142
2020,4,2,3,3936,4722,3701,-1021
2020,4,2,4,3475,4191,3228,-963
2020,4,2,5,3069,3794,2909,-885
2020,4,2,6,2853,3515,2688,-827
2020,4,2,7,2747,3377,2570,-807
2020,4,2,8,2723,3316,2522,-794
2020,4,2,9,2772,3382,2547,-835
2020,4,2,10,2987,3581,2694,-887
2020,4,2,11,3287,3921,2938,-983
2020,4,2,12,3511,4198,3214,-984
2020,4,2,13,3646,4455,3393,-1062
2020,4,2,14,3819,4576,3504,-1072
2020,4,2,15,3928,4690,3579,-1111
2020,4,2,16,4044,4829,3723,-1106
2020,4,2,17,4117,5018,3888,-1130
2020,4,2,18,4270,5225,4038,-1187
2020,4,2,19,4436,5480,4411,-1069
2020,4,2,20,4601,5746,4612,-1134
2020,4,2,21,4795,6068,4859,-1209
2020,4,2,22,4881,6351,5073,-1278
2020,4,2,23,4797,6306,5137,-1169
2020,4,3,0,4658,5979,4839,-1140
2020,4,3,1,4611,5848,4685,-1163
2020,4,3,2,4282,5348,4180,-1168
2020,4,3,3,3850,4790,3711,-1079
2020,4,3,4,3411,4221,3243,-978
2020,4,3,5,3059,3780,2895,-885
2020,4,3,6,2826,3497,2682,-815
2020,4,3,7,2678,3362,2575,-787
2020,4,3,8,2612,3290,2520,-770
2020,4,3,9,2633,3343,2538,-805
2020,4,3,10,2808,3515,2659,-856
2020,4,3,11,3126,3851,2905,-946
2020,4,3,12,3382,4118,3168,-950
2020,4,3,13,3569,4378,3367,-1011
2020,4,3,14,3741,4569,3534,-1035
2020,4,3,15,3956,4747,3684,-1063
2020,4,3,16,4112,4965,3865,-1100
2020,4,3,17,4273,5267,4105,-1162
2020,4,3,18,4531,5609,4366,-1243
2020,4,3,19,4798,6023,4722,-1301
2020,4,3,20,5013,6418,5145,-1273
2020,4,3,21,5246,6790,5538,-1252
2020,4,3,22,5346,7028,5822,-1206
2020,4,3,23,5302,6822,5634,-1188
2020,4,4,0,4903,6384,5147,-1237
2020,4,4,1,4793,6178,4935,-1243
2020,4,4,2,4473,5649,4406,-1243
2020,4,4,3,4041,5084,3975,-1109
2020,4,4,4,3603,4637,3613,-1024
2020,4,4,5,3320,4106,3196,-910
2020,4,4,6,3044,3757,2921,-836
2020,4,4,7,2855,3524,2731,-793
2020,4,4,8,2814,3412,2667,-745
2020,4,4,9,2762,3354,2656,-698
2020,4,4,10,2803,3400,2660,-740
2020,4,4,11,2982,3542,2716,-826
2020,4,4,12,3135,3690,2891,-799
2020,4,4,13,3504,4005,3211,-794
2020,4,4,14,3876,4401,3531,-870
2020,4,4,15,4164,4823,3862,-961
2020,4,4,16,4390,5273,4196,-1077
2020,4,4,17,4653,5796,4595,-1201
2020,4,4,18,4925,6322,5006,-1316
2020,4,4,19,5237,6793,5310,-1483
2020,4,4,20,5519,7203,5500,-1703
2020,4,4,21,5739,7472,5682,-1790
2020,4,4,22,5869,7555,5722,-1833
2020,4,4,23,5736,7286,5557,-1729
2020,4,5,0,5387,6838,5238,-1600
2020,4,5,1,5230,6593,5252,-1341
2020,4,5,2,4873,5996,4825,-1171
2020,4,5,3,4412,5367,4325,-1042
2020,4,5,4,3949,4765,3701,-1064
2020,4,5,5,3416,4273,3321,-952
2020,4,5,6,3176,3909,3042,-867
2020,4,5,7,2979,3714,2888,-826
2020,4,5,8,2857,3583,2782,-801
2020,4,5,9,2804,3528,2738,-790
2020,4,5,10,2836,3522,2713,-809
2020,4,5,11,2940,3608,2764,-844
2020,4,5,12,3098,3738,2940,-798
2020,4,5,13,3430,4038,3241,-797
2020,4,5,14,3854,4512,3597,-915
2020,4,5,15,4156,4893,3905,-988
2020,4,5,16,4371,5150,4113,-1037
2020,4,5,17,4652,5295,4217,-1078
2020,4,5,18,4757,5307,4222,-1085
2020,4,5,19,4843,5224,4174,-1050
2020,4,5,20,5022,5182,4110,-1072
2020,4,5,21,5011,5195,4109,-1086
2020,4,5,22,4938,5226,4116,-1110
2020,4,5,23,4858,5192,4085,-1107
2020,4,6,0,4718,5133,4058,-1075
2020,4,6,1,4722,5139,4073,-1066
2020,4,6,2,4368,4829,3857,-972
2020,4,6,3,3926,4469,3570,-899
2020,4,6,4,3448,4000,3075,-925
2020,4,6,5,2992,3673,2802,-871
2020,4,6,6,2775,3443,2635,-808
2020,4,6,7,2663,3336,2550,-786
2020,4,6,8,2624,3284,2514,-770
2020,4,6,9,2670,3333,2542,-791
2020,4,6,10,2898,3512,2679,-833
2020,4,6,11,3289,3833,2923,-910
2020,4,6,12,3549,4108,3241,-867
2020,4,6,13,3754,4393,3549,-844
2020,4,6,14,3996,4646,3728,-918
2020,4,6,15,4276,4963,3963,-1000
2020,4,6,16,4542,5330,4241,-1089
2020,4,6,17,4692,5708,4527,-1181
2020,4,6,18,4900,6002,4745,-1257
2020,4,6,19,5105,6238,4919,-1319
2020,4,6,20,5304,6435,5025,-1410
2020,4,6,21,5441,6621,5153,-1468
2020,4,6,22,5535,6777,5259,-1518
2020,4,6,23,5539,6667,5176,-1491
2020,4,7,0,5291,6432,5015,-1417
2020,4,7,1,5203,6302,4968,-1334
2020,4,7,2,4840,5817,4617,-1200
2020,4,7,3,4332,5199,4127,-1072
2020,4,7,4,3809,4631,3569,-1062
2020,4,7,5,3342,4134,3195,-939
2020,4,7,6,3063,3791,2919,-872
2020,4,7,7,2909,3580,2753,-827
2020,4,7,8,2825,3467,2669,-798
2020,4,7,9,2847,3472,2676,-796
2020,4,7,10,3038,3602,2777,-825
2020,4,7,11,3436,3862,2971,-891
2020,4,7,12,3676,4102,3246,-856
2020,4,7,13,3905,4423,3581,-842
2020,4,7,14,4191,4825,3888,-937
2020,4,7,15,4508,5315,4254,-1061
2020,4,7,16,4849,5824,4632,-1192
2020,4,7,17,5297,6425,5075,-1350
2020,4,7,18,5601,6969,5484,-1485
2020,4,7,19,5936,7442,5771,-1671
2020,4,7,20,6235,7835,6213,-1622
2020,4,7,21,6436,8181,6623,-1558
2020,4,7,22,6454,8360,6750,-1610
2020,4,7,23,6328,8125,6523,-1602
2020,4,8,0,5981,7587,6072,-1515
2020,4,8,1,5841,7287,6011,-1276
2020,4,8,2,5372,6625,5417,-1208
2020,4,8,3,4800,5858,4690,-1168
2020,4,8,4,4243,5190,4036,-1154
2020,4,8,5,3744,4662,3637,-1025
2020,4,8,6,3437,4252,3298,-954
2020,4,8,7,3254,3982,3101,-881
2020,4,8,8,3148,3821,2952,-869
2020,4,8,9,3161,3772,2908,-864
2020,4,8,10,3328,3894,3007,-887
2020,4,8,11,3715,4147,3189,-958
2020,4,8,12,3965,4333,3336,-997
2020,4,8,13,4227,4708,3681,-1027
2020,4,8,14,4543,5202,4058,-1144
2020,4,8,15,4990,5723,4295,-1428
2020,4,8,16,5419,6260,4493,-1767
2020,4,8,17,5710,9283,7373,-1910
2020,4,8,18,6065,7656,5894,-1762
2020,4,8,19,6372,8087,6452,-1635
2020,4,8,20,6628,8424,6710,-1714
2020,4,8,21,6810,8730,7065,-1665
2020,4,8,22,6816,8818,7164,-1654
2020,4,8,23,6629,8585,7014,-1571
2020,4,9,0,6356,8008,6502,-1506
2020,4,9,1,6119,7674,6175,-1499
2020,4,9,2,5639,7033,5659,-1374
2020,4,9,3,5043,6341,5005,-1336
2020,4,9,4,4470,5667,4383,-1284
2020,4,9,5,3967,5127,3963,-1164
2020,4,9,6,3658,4752,3656,-1096
2020,4,9,7,3462,4526,3479,-1047
2020,4,9,8,3350,4399,3368,-1031
2020,4,9,9,3346,4394,3384,-1010
2020,4,9,10,3490,4528,3617,-911
2020,4,9,11,3824,4804,3684,-1120
2020,4,9,12,4058,5030,3881,-1149
2020,4,9,13,4334,5349,4218,-1131
2020,4,9,14,4638,5793,4510,-1283
2020,4,9,15,5090,6312,4770,-1542
2020,4,9,16,5466,6842,4998,-1844
2020,4,9,17,5810,7377,5404,-1973
2020,4,9,18,6140,7875,5984,-1891
2020,4,9,19,6440,8308,6468,-1840
2020,4,9,20,6658,8617,6820,-1797
2020,4,9,21,6814,8868,7108,-1760
2020,4,9,22,6786,8979,7209,-1770
2020,4,9,23,6551,8705,7019,-1686
2020,4,10,0,6256,8081,6472,-1609
2020,4,10,1,6018,7748,6065,-1683
2020,4,10,2,5554,7104,5362,-1742
2020,4,10,3,4960,6406,4872,-1534
2020,4,10,4,4387,5749,4442,-1307
2020,4,10,5,4025,5207,4051,-1156
2020,4,10,6,3672,4786,3714,-1072
2020,4,10,7,3407,4528,3508,-1020
2020,4,10,8,3275,4412,3442,-970
2020,4,10,9,3238,4395,3425,-970
2020,4,10,10,3360,4488,3477,-1011
2020,4,10,11,3628,4721,3647,-1074
2020,4,10,12,3846,4937,3848,-1089
2020,4,10,13,4126,5253,4085,-1168
2020,4,10,14,4394,5690,4416,-1274
2020,4,10,15,4666,6116,4721,-1395
2020,4,10,16,4844,6600,5108,-1492
2020,4,10,17,5235,7008,5456,-1552
2020,4,10,18,5043,7144,5700,-1444
2020,4,10,19,5056,7005,5553,-1452
2020,4,10,20,4942,7160,5632,-1528
2020,4,10,21,4909,7310,5741,-1569
2020,4,10,22,4796,7353,5752,-1601
2020,4,10,23,4601,7132,5616,-1516
2020,4,11,0,4412,6601,5089,-1512
2020,4,11,1,4334,6380,4915,-1465
2020,4,11,2,4117,5853,4497,-1356
2020,4,11,3,3793,5275,4052,-1223
2020,4,11,4,3427,4735,3684,-1051
2020,4,11,5,3390,4250,3295,-955
2020,4,11,6,3101,3862,2970,-892
2020,4,11,7,2918,3612,2770,-842
2020,4,11,8,2806,3482,2697,-785
2020,4,11,9,2756,3433,2634,-799
2020,4,11,10,2767,3474,2648,-826
2020,4,11,11,2893,3587,2707,-880
2020,4,11,12,3010,3707,2803,-904
2020,4,11,13,3312,3981,2992,-989
2020,4,11,14,3671,4367,3287,-1080
2020,4,11,15,3949,4763,3607,-1156
2020,4,11,16,4189,5142,3963,-1179
2020,4,11,17,4483,5620,4308,-1312
2020,4,11,18,4827,6119,4724,-1395
2020,4,11,19,5184,6552,5084,-1468
2020,4,11,20,5425,6790,5300,-1490
2020,4,11,21,5593,6833,5330,-1503
2020,4,11,22,5598,6879,5378,-1501
2020,4,11,23,5427,6751,5275,-1476
2020,4,12,0,5134,6519,5084,-1435
2020,4,12,1,5033,6440,5012,-1428
2020,4,12,2,4720,6021,4706,-1315
2020,4,12,3,4316,5508,4261,-1247
2020,4,12,4,3906,5026,3880,-1146
2020,4,12,5,3526,4600,3564,-1036
2020,4,12,6,3285,4262,3286,-976
2020,4,12,7,3135,4048,3127,-921
2020,4,12,8,3035,3917,3015,-902
2020,4,12,9,3009,3851,2958,-893
2020,4,12,10,3048,3889,2983,-906
2020,4,12,11,3161,3996,3060,-936
2020,4,12,12,3319,4135,3242,-893
2020,4,12,13,3714,4620,3738,-882
2020,4,12,14,4242,5395,4283,-1112
2020,4,12,15,4801,6111,4869,-1242
2020,4,12,16,5269,6919,5482,-1437
2020,4,12,17,5826,7709,5957,-1752
2020,4,12,18,6247,8318,6379,-1939
2020,4,12,19,6628,8770,6746,-2024
2020,4,12,20,6945,9131,7161,-1970
2020,4,12,21,7172,9374,7465,-1909
2020,4,12,22,7312,9404,7542,-1862
2020,4,12,23,7170,9090,7264,-1826
2020,4,13,0,6796,8463,6866,-1597
2020,4,13,1,6531,8207,6561,-1646
2020,4,13,2,6016,7640,6152,-1488
2020,4,13,3,5418,6962,5565,-1397
2020,4,13,4,4844,6381,4926,-1455
2020,4,13,5,4256,5851,4509,-1342
2020,4,13,6,3926,5445,4177,-1268
2020,4,13,7,3693,5218,4009,-1209
2020,4,13,8,3563,5079,3901,-1178
2020,4,13,9,3549,5075,3907,-1168
2020,4,13,10,3688,5220,4010,-1210
2020,4,13,11,3997,5419,4172,-1247
2020,4,13,12,4212,5633,4447,-1186
2020,4,13,13,4519,5981,4870,-1111
2020,4,13,14,4975,6589,5364,-1225
2020,4,13,15,5572,7248,5970,-1278
2020,4,13,16,6024,7937,6728,-1209
2020,4,13,17,6432,8585,7345,-1240
2020,4,13,18,6769,9099,7655,-1444
2020,4,13,19,7100,9428,7606,-1822
2020,4,13,20,7295,9575,7781,-1794
2020,4,13,21,7431,9615,7863,-1752
2020,4,13,22,7433,9569,7898,-1671
2020,4,13,23,7154,9234,7570,-1664
2020,4,14,0,6773,8691,6990,-1701
2020,4,14,1,6515,8310,6889,-1421
2020,4,14,2,5940,7687,6459,-1228
2020,4,14,3,5300,6905,5629,-1276
2020,4,14,4,4671,6165,4792,-1373
2020,4,14,5,4484,5673,4443,-1230
2020,4,14,6,4096,5228,4079,-1149
2020,4,14,7,3835,4929,3849,-1080
2020,4,14,8,3658,4737,3684,-1053
2020,4,14,9,3616,4662,3630,-1032
2020,4,14,10,3727,4732,3667,-1065
2020,4,14,11,4042,4981,3851,-1130
2020,4,14,12,4232,5204,4127,-1077
2020,4,14,13,4525,5470,4465,-1005
2020,4,14,14,4993,5925,4915,-1010
2020,4,14,15,5505,6350,5289,-1061
2020,4,14,16,5954,6906,5735,-1171
2020,4,14,17,6460,7586,6415,-1171
2020,4,14,18,6850,8036,6895,-1141
2020,4,14,19,7215,8434,7019,-1415
2020,4,14,20,7449,8701,7217,-1484
2020,4,14,21,7613,8953,7435,-1518
2020,4,14,22,7603,9189,7615,-1574
2020,4,14,23,7342,9021,7587,-1434
2020,4,15,0,6868,8513,7172,-1341
2020,4,15,1,6607,8124,6934,-1190
2020,4,15,2,6052,7400,6213,-1187
2020,4,15,3,5408,6717,5472,-1245
2020,4,15,4,4772,6038,4728,-1310
2020,4,15,5,4327,5700,4501,-1199
2020,4,15,6,3964,5293,4195,-1098
2020,4,15,7,3742,5027,3986,-1041
2020,4,15,8,3587,4855,3851,-1004
2020,4,15,9,3580,4822,3829,-993
2020,4,15,10,3709,4957,3914,-1043
2020,4,15,11,4016,5211,4097,-1114
2020,4,15,12,4202,5459,4322,-1137
2020,4,15,13,4464,5832,4676,-1156
2020,4,15,14,4806,6355,5059,-1296
2020,4,15,15,5178,6987,5398,-1589
2020,4,15,16,5554,7611,5856,-1755
2020,4,15,17,5901,8118,6393,-1725
2020,4,15,18,6201,8279,6599,-1680
2020,4,15,19,6467,8180,6560,-1620
2020,4,15,20,6614,8023,6391,-1632
2020,4,15,21,6683,7725,6060,-1665
2020,4,15,22,6691,7059,5289,-1770
2020,4,15,23,6341,6697,4876,-1821
2020,4,16,0,5995,6366,4500,-1866
2020,4,16,1,5823,6161,4290,-1871
2020,4,16,2,5326,5818,4056,-1762
2020,4,16,3,4771,5332,3816,-1516
2020,4,16,4,4194,4809,3479,-1330
2020,4,16,5,4005,4497,3405,-1092
2020,4,16,6,3627,4143,3085,-1058
2020,4,16,7,3376,3922,2946,-976
2020,4,16,8,3233,3769,2831,-938
2020,4,16,9,3188,3751,2828,-923
2020,4,16,10,3297,3843,2849,-994
2020,4,16,11,3539,4074,3008,-1066
2020,4,16,12,3754,4284,3283,-1001
2020,4,16,13,3874,4528,3558,-970
2020,4,16,14,4023,4739,3679,-1060
2020,4,16,15,4175,4921,3821,-1100
2020,4,16,16,4328,5023,3763,-1260
2020,4,16,17,4375,5076,3676,-1400
2020,4,16,18,4382,5045,3639,-1406
2020,4,16,19,4293,5030,3625,-1405
2020,4,16,20,4294,4994,3588,-1406
2020,4,16,21,4333,5108,3635,-1473
2020,4,16,22,4447,5210,3688,-1522
2020,4,16,23,4373,5201,3809,-1392
2020,4,17,0,4284,5132,3902,-1230
2020,4,17,1,4305,5223,4000,-1223
2020,4,17,2,4075,4946,3836,-1110
2020,4,17,3,3717,4553,3556,-997
2020,4,17,4,3321,4114,3023,-1091
2020,4,17,5,2920,3862,2866,-996
2020,4,17,6,2707,3640,2707,-933
2020,4,17,7,2613,3493,2571,-922
2020,4,17,8,2563,3441,2558,-883
2020,4,17,9,2620,3447,2559,-888
2020,4,17,10,2769,3614,2661,-953
2020,4,17,11,3109,3908,2890,-1018
2020,4,17,12,3257,4152,3162,-990
2020,4,17,13,3494,4426,3465,-961
2020,4,17,14,3751,4736,3694,-1042
2020,4,17,15,3959,5045,3938,-1107
2020,4,17,16,4174,5417,4221,-1196
2020,4,17,17,4375,5870,4566,-1304
2020,4,17,18,4636,6278,4877,-1401
2020,4,17,19,4890,6592,5090,-1502
2020,4,17,20,5095,6954,5442,-1512
2020,4,17,21,5276,7204,5711,-1493
2020,4,17,22,5440,7353,5968,-1385
2020,4,17,23,5314,7214,5904,-1310
2020,4,18,0,5046,6850,5510,-1340
2020,4,18,1,4954,6709,5274,-1435
2020,4,18,2,4695,6282,4867,-1415
2020,4,18,3,4388,5776,4480,-1296
2020,4,18,4,4022,5235,3903,-1332
2020,4,18,5,3697,4653,3434,-1219
2020,4,18,6,3427,4301,3201,-1100
2020,4,18,7,3244,4062,3013,-1049
2020,4,18,8,3142,3874,2872,-1002
2020,4,18,9,3100,3817,2826,-991
2020,4,18,10,3138,3816,2822,-994
2020,4,18,11,3205,3933,2886,-1047
2020,4,18,12,3314,4054,3009,-1045
2020,4,18,13,3628,4450,3417,-1033
2020,4,18,14,4058,5063,3882,-1181
2020,4,18,15,4450,5483,4081,-1402
2020,4,18,16,4801,5635,4063,-1572
2020,4,18,17,5033,5644,3881,-1763
2020,4,18,18,5241,5695,3860,-1835
2020,4,18,19,5447,5912,3986,-1926
2020,4,18,20,5592,6196,4171,-2025
2020,4,18,21,5697,6648,4621,-2027
2020,4,18,22,5762,6914,4865,-2049
2020,4,18,23,5647,6847,4852,-1995
2020,4,19,0,5348,6542,4541,-2001
2020,4,19,1,5246,6442,4478,-1964
2020,4,19,2,4891,6058,4351,-1707
2020,4,19,3,4496,5548,4102,-1446
2020,4,19,4,4101,5057,3720,-1337
2020,4,19,5,3605,4624,3434,-1190
2020,4,19,6,3332,4257,3157,-1100
2020,4,19,7,3162,3981,2974,-1007
2020,4,19,8,3061,3817,2912,-905
2020,4,19,9,2979,3747,2880,-867
2020,4,19,10,2993,3761,2814,-947
2020,4,19,11,3036,3807,2798,-1009
2020,4,19,12,3165,3900,2858,-1042
2020,4,19,13,3545,4346,3331,-1015
2020,4,19,14,4097,5047,3829,-1218
2020,4,19,15,4655,5829,4254,-1575
2020,4,19,16,5094,6645,4723,-1922
2020,4,19,17,5533,7378,5224,-2154
2020,4,19,18,5970,7995,5914,-2081
2020,4,19,19,6304,8437,6208,-2229
2020,4,19,20,6554,8708,6457,-2251
2020,4,19,21,6713,8861,6591,-2270
2020,4,19,22,6706,8856,6612,-2244
2020,4,19,23,6637,8530,6328,-2202
2020,4,20,0,6248,8013,5929,-2084
2020,4,20,1,5988,7761,5639,-2122
2020,4,20,2,5555,7164,5220,-1944
2020,4,20,3,4997,6484,4808,-1676
2020,4,20,4,4463,5846,4290,-1556
2020,4,20,5,4060,5362,3969,-1393
2020,4,20,6,3738,5008,3715,-1293
2020,4,20,7,3528,4809,3553,-1256
2020,4,20,8,3383,4745,3486,-1259
2020,4,20,9,3382,4739,3498,-1241
2020,4,20,10,3528,4889,3603,-1286
2020,4,20,11,3770,5124,3789,-1335
2020,4,20,12,4041,5436,4092,-1344
2020,4,20,13,4269,5763,4475,-1288
2020,4,20,14,4694,6150,4780,-1370
2020,4,20,15,5132,6406,5022,-1384
2020,4,20,16,5471,6614,5181,-1433
2020,4,20,17,5770,6862,5308,-1554
2020,4,20,18,6082,7080,5575,-1505
2020,4,20,19,6302,7239,5731,-1508
2020,4,20,20,6395,7471,6019,-1452
2020,4,20,21,6490,7730,6329,-1401
2020,4,20,22,6501,7891,6500,-1391
2020,4,20,23,6364,7711,6338,-1373
2020,4,21,0,5998,7188,5840,-1348
2020,4,21,1,5814,6835,5524,-1311
2020,4,21,2,5325,6248,4867,-1381
2020,4,21,3,4775,5579,4364,-1215
2020,4,21,4,4215,4889,3647,-1242
2020,4,21,5,3685,4359,3245,-1114
2020,4,21,6,3352,4001,2965,-1036
2020,4,21,7,3131,3780,2788,-992
2020,4,21,8,3024,3668,2726,-942
2020,4,21,9,3010,3630,2667,-963
2020,4,21,10,3126,3722,2747,-975
2020,4,21,11,3408,3943,2911,-1032
2020,4,21,12,3568,4169,3137,-1032
2020,4,21,13,3820,4529,3586,-943
2020,4,21,14,4123,4901,3799,-1102
2020,4,21,15,4465,5210,3871,-1339
2020,4,21,16,4898,5845,4189,-1656
2020,4,21,17,5331,6476,4578,-1898
2020,4,21,18,5662,6976,4945,-2031
2020,4,21,19,5930,7348,5209,-2139
2020,4,21,20,6164,7712,5471,-2241
2020,4,21,21,6319,8011,5782,-2229
2020,4,21,22,6391,8177,5982,-2195
2020,4,21,23,6222,7912,5764,-2148
2020,4,22,0,5784,7296,5305,-1991
2020,4,22,1,5579,6932,4967,-1965
2020,4,22,2,5130,6335,4654,-1681
2020,4,22,3,4572,5615,4227,-1388
2020,4,22,4,4031,4922,3678,-1244
2020,4,22,5,3529,4387,3280,-1107
2020,4,22,6,3199,4012,3002,-1010
2020,4,22,7,2981,3756,2792,-964
2020,4,22,8,2878,3620,2695,-925
2020,4,22,9,2867,3588,2677,-911
2020,4,22,10,3001,3699,2754,-945
2020,4,22,11,3268,3929,2916,-1013
2020,4,22,12,3448,4136,3106,-1030
2020,4,22,13,3669,4428,3488,-940
2020,4,22,14,3941,4753,3710,-1043
2020,4,22,15,4194,5088,3823,-1265
2020,4,22,16,4558,5517,4028,-1489
2020,4,22,17,4975,6039,4391,-1648
2020,4,22,18,5363,6549,4846,-1703
2020,4,22,19,5712,7033,5357,-1676
2020,4,22,20,6024,7432,5737,-1695
2020,4,22,21,6264,7728,6037,-1691
2020,4,22,22,6398,7801,6090,-1711
2020,4,22,23,6234,7494,5799,-1695
2020,4,23,0,5781,6925,5256,-1669
2020,4,23,1,5595,6645,4907,-1738
2020,4,23,2,5146,6087,4464,-1623
2020,4,23,3,4614,5472,4110,-1362
2020,4,23,4,4083,4827,3574,-1253
2020,4,23,5,3591,4348,3250,-1098
2020,4,23,6,3275,4018,2993,-1025
2020,4,23,7,3075,3792,2702,-1090
2020,4,23,8,2978,3687,2693,-994
2020,4,23,9,2977,3663,2697,-966
2020,4,23,10,3108,3793,2793,-1000
2020,4,23,11,3405,4076,3013,-1063
2020,4,23,12,3584,4331,3267,-1064
2020,4,23,13,3885,4753,3652,-1101
2020,4,23,14,4242,5280,4066,-1214
2020,4,23,15,4675,5942,4359,-1583
2020,4,23,16,5133,6644,4683,-1961
2020,4,23,17,5676,7336,5052,-2284
2020,4,23,18,6131,7981,5529,-2452
2020,4,23,19,6477,8517,6031,-2486
2020,4,23,20,6789,8842,6418,-2424
2020,4,23,21,7024,9002,6572,-2430
2020,4,23,22,7124,9141,6742,-2399
2020,4,23,23,6919,8895,6560,-2335
2020,4,24,0,6522,8405,6080,-2325
2020,4,24,1,6243,8130,5915,-2215
2020,4,24,2,5732,7581,5550,-2031
2020,4,24,3,5140,6825,5156,-1669
2020,4,24,4,4573,6165,4720,-1445
2020,4,24,5,4346,5631,4396,-1235
2020,4,24,6,3991,5236,4093,-1143
2020,4,24,7,3756,4979,3890,-1089
2020,4,24,8,3599,4846,3781,-1065
2020,4,24,9,3557,4838,3755,-1083
2020,4,24,10,3645,4906,3855,-1051
2020,4,24,11,3800,4889,3843,-1046
2020,4,24,12,4031,4857,3762,-1095
2020,4,24,13,4228,5022,3942,-1080
2020,4,24,14,4472,5286,4113,-1173
2020,4,24,15,4664,5532,4280,-1252
2020,4,24,16,4840,5743,4443,-1300
2020,4,24,17,4818,5882,4552,-1330
2020,4,24,18,4931,5873,4548,-1325
2020,4,24,19,4972,5757,4607,-1150
2020,4,24,20,5034,5656,4508,-1148
2020,4,24,21,5201,5639,4475,-1164
2020,4,24,22,5391,5685,4519,-1166
2020,4,24,23,5400,5602,4437,-1165
2020,4,25,0,5142,5524,4165,-1359
2020,4,25,1,5097,5435,4093,-1342
2020,4,25,2,4850,5193,3902,-1291
2020,4,25,3,4540,4834,3648,-1186
2020,4,25,4,4164,4467,3340,-1127
2020,4,25,5,3583,4147,3053,-1094
2020,4,25,6,3329,3867,2846,-1021
2020,4,25,7,3160,3710,2737,-973
2020,4,25,8,3051,3656,2696,-960
2020,4,25,9,3020,3613,2683,-930
2020,4,25,10,3048,3644,2685,-959
2020,4,25,11,3119,3736,2746,-990
2020,4,25,12,3285,3853,2905,-948
2020,4,25,13,3657,4257,3215,-1042
2020,4,25,14,4183,4767,3584,-1183
2020,4,25,15,4787,5186,3736,-1450
2020,4,25,16,5210,5612,3924,-1688
2020,4,25,17,5527,6157,4243,-1914
2020,4,25,18,5948,6773,4632,-2141
2020,4,25,19,6276,7368,5258,-2110
2020,4,25,20,6440,7804,5582,-2222
2020,4,25,21,6555,8151,5610,-2541
2020,4,25,22,6582,8272,5706,-2566
2020,4,25,23,6377,8093,5669,-2424
2020,4,26,0,6006,7707,5562,-2145
2020,4,26,1,5795,7480,5378,-2102
2020,4,26,2,5395,6973,5122,-1851
2020,4,26,3,4924,6389,4833,-1556
2020,4,26,4,4474,5858,4383,-1475
2020,4,26,5,3815,5358,4002,-1356
2020,4,26,6,3545,4952,3691,-1261
2020,4,26,7,3361,4684,3491,-1193
2020,4,26,8,3231,4534,3379,-1155
2020,4,26,9,3149,4412,3286,-1126
2020,4,26,10,3115,4355,3249,-1106
2020,4,26,11,3100,4346,3232,-1114
2020,4,26,12,3222,4403,3333,-1070
2020,4,26,13,3632,4855,3662,-1193
2020,4,26,14,4101,5506,4124,-1382
2020,4,26,15,4541,6158,4510,-1648
2020,4,26,16,4952,6844,4974,-1870
2020,4,26,17,5375,7444,5302,-2142
2020,4,26,18,5711,7951,5876,-2075
2020,4,26,19,5947,8253,6005,-2248
2020,4,26,20,6158,8317,5767,-2550
2020,4,26,21,6293,8156,5488,-2668
2020,4,26,22,6331,7912,5247,-2665
2020,4,26,23,6114,7383,4876,-2507
2020,4,27,0,5617,6860,4546,-2314
2020,4,27,1,5360,6569,4407,-2162
2020,4,27,2,4972,6031,4180,-1851
2020,4,27,3,4428,5354,3921,-1433
2020,4,27,4,3905,4719,3488,-1231
2020,4,27,5,3563,4227,3126,-1101
2020,4,27,6,3216,3890,2858,-1032
2020,4,27,7,2978,3681,2706,-975
2020,4,27,8,2854,3566,2624,-942
2020,4,27,9,2830,3542,2616,-926
2020,4,27,10,2954,3650,2677,-973
2020,4,27,11,3163,3857,2836,-1021
2020,4,27,12,3363,4049,3053,-996
2020,4,27,13,3514,4297,3248,-1049
2020,4,27,14,3699,4547,3429,-1118
2020,4,27,15,3880,4782,3613,-1169
2020,4,27,16,4084,5018,3804,-1214
2020,4,27,17,4292,5278,3888,-1390
2020,4,27,18,4541,5519,3935,-1584
2020,4,27,19,4719,5805,4228,-1577
2020,4,27,20,4922,6137,4530,-1607
2020,4,27,21,5118,6442,4877,-1565
2020,4,27,22,5217,6713,5104,-1609
2020,4,27,23,5035,6705,5092,-1613
2020,4,28,0,4780,6303,4658,-1645
2020,4,28,1,4710,6050,4423,-1627
2020,4,28,2,4340,5617,4145,-1472
2020,4,28,3,3848,5036,3821,-1215
2020,4,28,4,3390,4436,3284,-1152
2020,4,28,5,3079,3987,2938,-1049
2020,4,28,6,2822,3669,2712,-957
2020,4,28,7,2660,3474,2550,-924
2020,4,28,8,2589,3396,2496,-900
2020,4,28,9,2605,3383,2476,-907
2020,4,28,10,2771,3540,2560,-980
2020,4,28,11,3080,3784,2726,-1058
2020,4,28,12,3269,4031,3038,-993
2020,4,28,13,3406,4315,3289,-1026
2020,4,28,14,3577,4604,3514,-1090
2020,4,28,15,3784,4870,3598,-1272
2020,4,28,16,4019,5188,3701,-1487
2020,4,28,17,4361,5561,3810,-1751
2020,4,28,18,4757,6033,4027,-2006
2020,4,28,19,5111,6437,4259,-2178
2020,4,28,20,5462,6971,4800,-2171
2020,4,28,21,5742,7358,5260,-2098
2020,4,28,22,5854,7579,5509,-2070
2020,4,28,23,5767,7443,5338,-2105
2020,4,29,0,5360,7028,4941,-2087
2020,4,29,1,5201,6619,4581,-2038
2020,4,29,2,4853,6124,4300,-1824
2020,4,29,3,4335,5500,4062,-1438
2020,4,29,4,3825,4862,3595,-1267
2020,4,29,5,3354,4324,3182,-1142
2020,4,29,6,3059,3959,2892,-1067
2020,4,29,7,2867,3714,2703,-1011
2020,4,29,8,2785,3583,2590,-993
2020,4,29,9,2786,3574,2591,-983
2020,4,29,10,2926,3711,2700,-1011
2020,4,29,11,3220,3936,2867,-1069
2020,4,29,12,3408,4167,3161,-1006
2020,4,29,13,3643,4504,3459,-1045
2020,4,29,14,3941,4916,3768,-1148
2020,4,29,15,4224,5359,3972,-1387
2020,4,29,16,4617,5858,4173,-1685
2020,4,29,17,5045,6403,4329,-2074
2020,4,29,18,5491,6888,4710,-2178
2020,4,29,19,5826,7363,4983,-2380
2020,4,29,20,6192,7749,5457,-2292
2020,4,29,21,6429,8109,5783,-2326
2020,4,29,22,6518,8234,5879,-2355
2020,4,29,23,6384,8150,5813,-2337
2020,4,30,0,5956,7733,5423,-2310
2020,4,30,1,5765,7415,5403,-2012
2020,4,30,2,5305,6923,5127,-1796
2020,4,30,3,4746,6338,4782,-1556
2020,4,30,4,4214,5701,4305,-1396
2020,4,30,5,3873,5220,3930,-1290
2020,4,30,6,3577,4783,3597,-1186
2020,4,30,7,3396,4440,3329,-1111
2020,4,30,8,3300,4188,3096,-1092
2020,4,30,9,3277,4039,2955,-1084
2020,4,30,10,3392,4114,3018,-1096
2020,4,30,11,3565,4315,3186,-1129
2020,4,30,12,3775,4530,3434,-1096
2020,4,30,13,3930,4804,3661,-1143
2020,4,30,14,4092,5066,3862,-1204
2020,4,30,15,4239,5351,3938,-1413
2020,4,30,16,4407,5617,3997,-1620
2020,4,30,17,4472,5923,4091,-1832
2020,4,30,18,4604,6180,4257,-1923
2020,4,30,19,4739,6409,4355,-2054
2020,4,30,20,5001,6637,4498,-2139
2020,4,30,21,5242,6783,4609,-2174
2020,4,30,22,5366,6795,4671,-2124
2020,4,30,23,5239,6612,4501,-2111
2020,5,1,0,4917,6157,4078,-2079
2020,5,1,1,4874,5878,3866,-2012
2020,5,1,2,4571,5501,3776,-1725
2020,5,1,3,4112,4946,3600,-1346
2020,5,1,4,3649,4369,3225,-1144
2020,5,1,5,3275,3922,2896,-1026
2020,5,1,6,3000,3631,2663,-968
2020,5,1,7,2822,3432,2505,-927
2020,5,1,8,2706,3350,2444,-906
2020,5,1,9,2709,3340,2460,-880
2020,5,1,10,2833,3505,2541,-964
2020,5,1,11,3080,3748,2721,-1027
2020,5,1,12,3284,4001,2998,-1003
2020,5,1,13,3478,4296,3241,-1055
2020,5,1,14,3739,4573,3544,-1029
2020,5,1,15,4008,4840,3597,-1243
2020,5,1,16,4245,5095,3638,-1457
2020,5,1,17,4596,5362,3707,-1655
2020,5,1,18,4934,5656,3884,-1772
2020,5,1,19,5252,5944,4069,-1875
2020,5,1,20,5503,6277,4350,-1927
2020,5,1,21,5660,6637,4719,-1918
2020,5,1,22,5657,6737,4899,-1838
2020,5,1,23,5350,6663,4783,-1880
2020,5,2,0,4971,6237,4329,-1908
2020,5,2,1,4818,5950,4143,-1807
2020,5,2,2,4541,5528,3868,-1660
2020,5,2,3,4101,4965,3626,-1339
2020,5,2,4,3656,4422,3253,-1169
2020,5,2,5,3289,3972,2909,-1063
2020,5,2,6,3004,3653,2699,-954
2020,5,2,7,2789,3420,2499,-921
2020,5,2,8,2676,3361,2450,-911
2020,5,2,9,2631,3326,2417,-909
2020,5,2,10,2632,3372,2417,-955
2020,5,2,11,2636,3490,2500,-990
2020,5,2,12,2788,3650,2702,-948
2020,5,2,13,3202,3991,2966,-1025
2020,5,2,14,3568,4368,3323,-1045
2020,5,2,15,3838,4787,3521,-1266
2020,5,2,16,4128,5163,3692,-1471
2020,5,2,17,4536,5574,3888,-1686
2020,5,2,18,4971,6083,4368,-1715
2020,5,2,19,5310,6608,4757,-1851
2020,5,2,20,5601,7085,5130,-1955
2020,5,2,21,5800,7478,5473,-2005
2020,5,2,22,5857,7696,5677,-2019
2020,5,2,23,5649,7547,5696,-1851
2020,5,3,0,5244,6981,5283,-1698
2020,5,3,1,5038,6559,4918,-1641
2020,5,3,2,4714,6050,4461,-1589
2020,5,3,3,4269,5419,4017,-1402
2020,5,3,4,3823,4850,3603,-1247
2020,5,3,5,3359,4354,3227,-1127
2020,5,3,6,3048,3967,2964,-1003
2020,5,3,7,2827,3701,2769,-932
2020,5,3,8,2697,3546,2609,-937
2020,5,3,9,2617,3454,2577,-877
2020,5,3,10,2616,3445,2599,-846
2020,5,3,11,2665,3481,2610,-871
2020,5,3,12,2776,3593,2666,-927
2020,5,3,13,3170,4036,2996,-1040
2020,5,3,14,3626,4637,3541,-1096
2020,5,3,15,4022,5229,3835,-1394
2020,5,3,16,4581,5838,3994,-1844
2020,5,3,17,5095,6487,4329,-2158
2020,5,3,18,5564,7060,4768,-2292
2020,5,3,19,5914,7530,5044,-2486
2020,5,3,20,6226,7958,5503,-2455
2020,5,3,21,6423,8295,5876,-2419
2020,5,3,22,6514,8459,5978,-2481
2020,5,3,23,6297,8251,5802,-2449
2020,5,4,0,5919,7674,5246,-2428
2020,5,4,1,5638,7156,4903,-2253
2020,5,4,2,5148,6620,4649,-1971
2020,5,4,3,4601,5862,4239,-1623
2020,5,4,4,4081,5144,3815,-1329
2020,5,4,5,3622,4565,3369,-1196
2020,5,4,6,3301,4152,3055,-1097
2020,5,4,7,3077,3876,2848,-1028
2020,5,4,8,2967,3729,2787,-942
2020,5,4,9,2946,3693,2798,-895
2020,5,4,10,3069,3830,2814,-1016
2020,5,4,11,3272,4056,2969,-1087
2020,5,4,12,3486,4343,3283,-1060
2020,5,4,13,3807,4780,3653,-1127
2020,5,4,14,4142,5301,4139,-1162
2020,5,4,15,4524,5856,4410,-1446
2020,5,4,16,5002,6466,4580,-1886
2020,5,4,17,5549,7065,4888,-2177
2020,5,4,18,5985,7742,5489,-2253
2020,5,4,19,6341,8309,5871,-2438
2020,5,4,20,6634,8664,6296,-2368
2020,5,4,21,6822,8903,6495,-2408
2020,5,4,22,6863,9017,6612,-2405
2020,5,4,23,6676,8787,6428,-2359
2020,5,5,0,6276,8178,5786,-2392
2020,5,5,1,5872,7633,5469,-2164
2020,5,5,2,5419,6979,5010,-1969
2020,5,5,3,4823,6194,4582,-1612
2020,5,5,4,4276,5473,4104,-1369
2020,5,5,5,3899,4820,3615,-1205
2020,5,5,6,3551,4347,3239,-1108
2020,5,5,7,3308,4030,2980,-1050
2020,5,5,8,3166,3847,2840,-1007
2020,5,5,9,3122,3792,2825,-967
2020,5,5,10,3231,3914,2881,-1033
2020,5,5,11,3451,4111,3026,-1085
2020,5,5,12,3655,4371,3304,-1067
2020,5,5,13,3955,4854,3711,-1143
2020,5,5,14,4291,5372,4180,-1192
2020,5,5,15,4712,5982,4437,-1545
2020,5,5,16,5193,6656,4689,-1967
2020,5,5,17,5767,7369,5159,-2210
2020,5,5,18,6212,8011,5772,-2239
2020,5,5,19,6530,8465,6257,-2208
2020,5,5,20,6821,8847,6653,-2194
2020,5,5,21,7049,9061,6855,-2206
2020,5,5,22,7090,9086,6867,-2219
2020,5,5,23,6884,8806,6576,-2230
2020,5,6,0,6477,8196,5958,-2238
2020,5,6,1,6151,7665,5502,-2163
2020,5,6,2,5684,7063,5057,-2006
2020,5,6,3,5059,6261,4606,-1655
2020,5,6,4,4493,5493,4112,-1381
2020,5,6,5,4021,4907,3651,-1256
2020,5,6,6,3677,4440,3300,-1140
2020,5,6,7,3444,4171,3090,-1081
2020,5,6,8,3301,4006,2958,-1048
2020,5,6,9,3256,3966,2911,-1055
2020,5,6,10,3370,4112,3003,-1109
2020,5,6,11,3597,4339,3187,-1152
2020,5,6,12,3811,4635,3506,-1129
2020,5,6,13,4113,5084,3882,-1202
2020,5,6,14,4501,5605,4358,-1247
2020,5,6,15,4955,6190,4631,-1559
2020,5,6,16,5432,6821,4827,-1994
2020,5,6,17,5751,7422,5163,-2259
2020,5,6,18,6112,7901,5598,-2303
2020,5,6,19,6393,8253,5930,-2323
2020,5,6,20,6621,8502,6172,-2330
2020,5,6,21,6768,8654,6311,-2343
2020,5,6,22,6765,8584,6271,-2313
2020,5,6,23,6475,8321,6035,-2286
2020,5,7,0,6063,7749,5498,-2251
2020,5,7,1,5707,7379,5260,-2119
2020,5,7,2,5274,6823,4919,-1904
2020,5,7,3,4713,6077,4490,-1587
2020,5,7,4,4153,5341,3983,-1358
2020,5,7,5,3641,4776,3566,-1210
2020,5,7,6,3314,4324,3214,-1110
2020,5,7,7,3102,4021,2976,-1045
2020,5,7,8,2971,3821,2827,-994
2020,5,7,9,2939,3710,2707,-1003
2020,5,7,10,3043,3768,2740,-1028
2020,5,7,11,3280,3901,2815,-1086
2020,5,7,12,3434,4089,3041,-1048
2020,5,7,13,3596,4376,3293,-1083
2020,5,7,14,3719,4651,3572,-1079
2020,5,7,15,3916,4869,3591,-1278
2020,5,7,16,4107,5109,3499,-1610
2020,5,7,17,4293,5343,3537,-1806
2020,5,7,18,4583,5527,3637,-1890
2020,5,7,19,4784,5739,3774,-1965
2020,5,7,20,5008,5946,3920,-2026
2020,5,7,21,5218,6198,4084,-2114
2020,5,7,22,5283,6400,4217,-2183
2020,5,7,23,4988,6321,4178,-2143
2020,5,8,0,4757,5980,3939,-2041
2020,5,8,1,4659,5796,3875,-1921
2020,5,8,2,4334,5429,3766,-1663
2020,5,8,3,3847,4858,3506,-1352
2020,5,8,4,3408,4306,3152,-1154
2020,5,8,5,3007,3851,2801,-1050
2020,5,8,6,2772,3564,2577,-987
2020,5,8,7,2627,3390,2418,-972
2020,5,8,8,2554,3324,2363,-961
2020,5,8,9,2589,3366,2370,-996
2020,5,8,10,2768,3446,2409,-1037
2020,5,8,11,3016,3799,2691,-1108
2020,5,8,12,3230,4050,2961,-1089
2020,5,8,13,3360,4292,3181,-1111
2020,5,8,14,3493,4551,3467,-1084
2020,5,8,15,3769,4731,3485,-1246
2020,5,8,16,4019,4981,3393,-1588
2020,5,8,17,4379,5273,3499,-1774
2020,5,8,18,4792,5639,3742,-1897
2020,5,8,19,5209,6070,4029,-2041
2020,5,8,20,5566,6527,4390,-2137
2020,5,8,21,5835,6899,4650,-2249
2020,5,8,22,5903,7181,4892,-2289
2020,5,8,23,5751,7130,4886,-2244
2020,5,9,0,5358,6712,4592,-2120
2020,5,9,1,5116,6414,4407,-2007
2020,5,9,2,4787,6041,4273,-1768
2020,5,9,3,4365,5452,4002,-1450
2020,5,9,4,3930,4923,3617,-1306
2020,5,9,5,3415,4460,3250,-1210
2020,5,9,6,3143,4095,2959,-1136
2020,5,9,7,2952,3866,2776,-1090
2020,5,9,8,2845,3711,2664,-1047
2020,5,9,9,2805,3660,2619,-1041
2020,5,9,10,2833,3663,2615,-1048
2020,5,9,11,2871,3720,2655,-1065
2020,5,9,12,3032,3860,2859,-1001
2020,5,9,13,3400,4358,3233,-1125
2020,5,9,14,3820,4962,3742,-1220
2020,5,9,15,4255,5510,4027,-1483
2020,5,9,16,4656,6033,4172,-1861
2020,5,9,17,5010,6513,4464,-2049
2020,5,9,18,5363,6981,4812,-2169
2020,5,9,19,5615,7213,4981,-2232
2020,5,9,20,5847,7367,5025,-2342
2020,5,9,21,6012,7373,5056,-2317
2020,5,9,22,6076,7160,4892,-2268
2020,5,9,23,5919,6740,4569,-2171
2020,5,10,0,5551,6323,4253,-2070
2020,5,10,1,5268,6153,4178,-1975
2020,5,10,2,4952,5818,4030,-1788
2020,5,10,3,4499,5279,3778,-1501
2020,5,10,4,4073,4751,3412,-1339
2020,5,10,5,3643,4606,3415,-1191
2020,5,10,6,3342,4251,3136,-1115
2020,5,10,7,3118,4020,2953,-1067
2020,5,10,8,2997,3890,2865,-1025
2020,5,10,9,2916,3815,2792,-1023
2020,5,10,10,2895,3804,2766,-1038
2020,5,10,11,2853,3854,2799,-1055
2020,5,10,12,2982,3976,2956,-1020
2020,5,10,13,3399,4363,3265,-1098
2020,5,10,14,3901,4862,3741,-1121
2020,5,10,15,4262,5240,4039,-1201
2020,5,10,16,4624,5496,4089,-1407
2020,5,10,17,4847,5764,4272,-1492
2020,5,10,18,5054,6051,4505,-1546
2020,5,10,19,5206,6429,4821,-1608
2020,5,10,20,5291,6698,5054,-1644
2020,5,10,21,5316,6882,5245,-1637
2020,5,10,22,5301,6929,5362,-1567
2020,5,10,23,5225,6743,5187,-1556
2020,5,11,0,4958,6402,4843,-1559
2020,5,11,1,4835,6230,4718,-1512
2020,5,11,2,4539,5959,4449,-1510
2020,5,11,3,4106,5425,4086,-1339
2020,5,11,4,3677,4845,3566,-1279
2020,5,11,5,3064,4232,3103,-1129
2020,5,11,6,2839,3854,2812,-1042
2020,5,11,7,2712,3650,2634,-1016
2020,5,11,8,2657,3546,2552,-994
2020,5,11,9,2672,3532,2538,-994
2020,5,11,10,2840,3685,2651,-1034
2020,5,11,11,3105,3980,2869,-1111
2020,5,11,12,3359,4260,3196,-1064
2020,5,11,13,3662,4660,3526,-1134
2020,5,11,14,3961,5126,3944,-1182
2020,5,11,15,4272,5620,4173,-1447
2020,5,11,16,4710,6079,4251,-1828
2020,5,11,17,5125,6574,4503,-2071
2020,5,11,18,5470,7036,4823,-2213
2020,5,11,19,5787,7438,5161,-2277
2020,5,11,20,6044,7792,5499,-2293
2020,5,11,21,6242,8064,5746,-2318
2020,5,11,22,6275,8190,5817,-2373
2020,5,11,23,6058,8066,5665,-2401
2020,5,12,0,5676,7474,5164,-2310
2020,5,12,1,5383,6981,4817,-2164
2020,5,12,2,5024,6392,4512,-1880
2020,5,12,3,4478,5650,4082,-1568
2020,5,12,4,3925,4949,3636,-1313
2020,5,12,5,3581,4380,3224,-1156
2020,5,12,6,3246,3982,2911,-1071
2020,5,12,7,3008,3731,2718,-1013
2020,5,12,8,2885,3606,2618,-988
2020,5,12,9,2856,3575,2588,-987
2020,5,12,10,2963,3719,2694,-1025
2020,5,12,11,3222,3960,2859,-1101
2020,5,12,12,3427,4194,3137,-1057
2020,5,12,13,3664,4556,3453,-1103
2020,5,12,14,3940,4927,3825,-1102
2020,5,12,15,4199,5342,4137,-1205
2020,5,12,16,4535,5831,4381,-1450
2020,5,12,17,4941,6314,4740,-1574
2020,5,12,18,5363,6878,5144,-1734
2020,5,12,19,5728,7372,5537,-1835
2020,5,12,20,5995,7780,5823,-1957
2020,5,12,21,6244,8060,6098,-1962
2020,5,12,22,6350,8182,6186,-1996
2020,5,12,23,6150,7944,5911,-2033
2020,5,13,0,5759,7367,5498,-1869
2020,5,13,1,5477,6896,5147,-1749
2020,5,13,2,5112,6430,4854,-1576
2020,5,13,3,4551,5723,4333,-1390
2020,5,13,4,4007,5015,3714,-1301
2020,5,13,5,3584,4444,3284,-1160
2020,5,13,6,3266,4049,2978,-1071
2020,5,13,7,3053,3793,2773,-1020
2020,5,13,8,2953,3655,2698,-957
2020,5,13,9,2920,3638,2760,-878
2020,5,13,10,3032,3796,2773,-1023
2020,5,13,11,3224,3997,2918,-1079
2020,5,13,12,3442,4255,3132,-1123
2020,5,13,13,3729,4691,3547,-1144
2020,5,13,14,4031,5174,3927,-1247
2020,5,13,15,4359,5685,4245,-1440
2020,5,13,16,4735,6251,4549,-1702
2020,5,13,17,5082,6880,4867,-2013
2020,5,13,18,5551,7391,5305,-2086
2020,5,13,19,5867,7738,5675,-2063
2020,5,13,20,6107,8024,5951,-2073
2020,5,13,21,6293,8209,6083,-2126
2020,5,13,22,6380,8276,6141,-2135
2020,5,13,23,6220,8080,5976,-2104
2020,5,14,0,5848,7492,5442,-2050
2020,5,14,1,5553,7098,5070,-2028
2020,5,14,2,5192,6642,4900,-1742
2020,5,14,3,4660,5915,4250,-1665
2020,5,14,4,4143,5226,3884,-1342
2020,5,14,5,3624,4638,3400,-1238
2020,5,14,6,3311,4244,3084,-1160
2020,5,14,7,3095,4001,2955,-1046
2020,5,14,8,2997,3860,2853,-1007
2020,5,14,9,2981,3819,2840,-979
2020,5,14,10,3103,3933,2852,-1081
2020,5,14,11,3321,4137,3002,-1135
2020,5,14,12,3551,4420,3251,-1169
2020,5,14,13,3854,4884,3676,-1208
2020,5,14,14,4180,5374,4049,-1325
2020,5,14,15,4533,5866,4351,-1515
2020,5,14,16,4926,6365,4538,-1827
2020,5,14,17,5290,6914,4885,-2029
2020,5,14,18,5645,7376,5359,-2017
2020,5,14,19,5909,7757,5692,-2065
2020,5,14,20,6149,8024,5948,-2076
2020,5,14,21,6357,8198,5943,-2255
2020,5,14,22,6397,8239,5967,-2272
2020,5,14,23,6262,8038,5742,-2296
2020,5,15,0,5892,7513,5197,-2316
2020,5,15,1,5608,7144,4816,-2328
2020,5,15,2,5232,6734,4665,-2069
2020,5,15,3,4717,6054,4368,-1686
2020,5,15,4,4208,5367,4017,-1350
2020,5,15,5,3798,4766,3506,-1260
2020,5,15,6,3487,4353,3186,-1167
2020,5,15,7,3265,4081,2995,-1086
2020,5,15,8,3144,3910,2864,-1046
2020,5,15,9,3118,3874,2812,-1062
2020,5,15,10,3232,3981,2879,-1102
2020,5,15,11,3436,4180,3024,-1156
2020,5,15,12,3686,4465,3276,-1189
2020,5,15,13,4028,5006,3776,-1230
2020,5,15,14,4397,5607,4233,-1374
2020,5,15,15,4796,6251,4631,-1620
2020,5,15,16,5183,6877,4971,-1906
2020,5,15,17,5459,7461,5210,-2251
2020,5,15,18,5801,7912,5556,-2356
2020,5,15,19,6057,8275,5853,-2422
2020,5,15,20,6192,8580,6172,-2408
2020,5,15,21,6294,8678,6274,-2404
2020,5,15,22,6257,8659,6236,-2423
2020,5,15,23,6090,8292,5855,-2437
2020,5,16,0,5678,7738,5374,-2364
2020,5,16,1,5389,7374,5070,-2304
2020,5,16,2,5110,6917,4670,-2247
2020,5,16,3,4678,6358,4616,-1742
2020,5,16,4,4249,5740,4288,-1452
2020,5,16,5,4022,5223,3848,-1375
2020,5,16,6,3711,4784,3513,-1271
2020,5,16,7,3484,4502,3291,-1211
2020,5,16,8,3349,4316,3141,-1175
2020,5,16,9,3291,4238,3078,-1160
2020,5,16,10,3298,4254,3068,-1186
2020,5,16,11,3312,4321,3116,-1205
2020,5,16,12,3493,4499,3285,-1214
2020,5,16,13,3920,5056,3754,-1302
2020,5,16,14,4412,5752,4297,-1455
2020,5,16,15,4858,6458,4722,-1736
2020,5,16,16,5206,7070,5062,-2008
2020,5,16,17,5547,7621,5439,-2182
2020,5,16,18,5848,7972,5794,-2178
2020,5,16,19,6093,8323,6026,-2297
2020,5,16,20,6213,8537,6207,-2330
2020,5,16,21,6304,8617,6274,-2343
2020,5,16,22,6285,8647,6255,-2392
2020,5,16,23,6108,8453,6035,-2418
2020,5,17,0,5811,7985,5511,-2474
2020,5,17,1,5562,7574,5322,-2252
2020,5,17,2,5251,7125,4952,-2173
2020,5,17,3,4815,6464,4628,-1836
2020,5,17,4,4376,5839,4334,-1505
2020,5,17,5,4053,5291,3877,-1414
2020,5,17,6,3749,4839,3539,-1300
2020,5,17,7,3522,4486,3266,-1220
2020,5,17,8,3382,4280,3121,-1159
2020,5,17,9,3277,4151,3011,-1140
2020,5,17,10,3252,4113,2975,-1138
2020,5,17,11,3212,4118,2971,-1147
2020,5,17,12,3359,4295,3116,-1179
2020,5,17,13,3863,4854,3583,-1271
2020,5,17,14,4469,5555,4098,-1457
2020,5,17,15,5035,6315,4608,-1707
2020,5,17,16,5617,7116,5032,-2084
2020,5,17,17,6130,7878,5570,-2308
2020,5,17,18,6591,8521,6214,-2307
2020,5,17,19,6926,9002,6536,-2466
2020,5,17,20,7180,9315,6892,-2423
2020,5,17,21,7345,9607,7214,-2393
2020,5,17,22,7418,9632,7279,-2353
2020,5,17,23,7181,9314,7016,-2298
2020,5,18,0,6763,8586,6318,-2268
2020,5,18,1,6381,8078,5932,-2146
2020,5,18,2,5933,7531,5349,-2182
2020,5,18,3,5292,6765,4934,-1831
2020,5,18,4,4721,6041,4534,-1507
2020,5,18,5,4184,5362,3950,-1412
2020,5,18,6,3871,4886,3570,-1316
2020,5,18,7,3647,4574,3351,-1223
2020,5,18,8,3517,4390,3209,-1181
2020,5,18,9,3485,4343,3203,-1140
2020,5,18,10,3648,4462,3235,-1227
2020,5,18,11,3924,4700,3412,-1288
2020,5,18,12,4208,5026,3720,-1306
2020,5,18,13,4554,5499,4144,-1355
2020,5,18,14,4996,5898,4449,-1449
2020,5,18,15,5535,6252,4694,-1558
2020,5,18,16,6096,6276,4626,-1650
2020,5,18,17,6592,6229,4339,-1890
2020,5,18,18,7027,6468,4457,-2011
2020,5,18,19,7345,6904,4566,-2338
2020,5,18,20,7595,7075,4689,-2386
2020,5,18,21,7727,7190,4764,-2426
2020,5,18,22,7761,7308,4821,-2487
2020,5,18,23,7555,7201,4723,-2478
2020,5,19,0,7119,6932,4587,-2345
2020,5,19,1,6714,6747,4596,-2151
2020,5,19,2,6236,6448,4529,-1919
2020,5,19,3,5532,5876,4214,-1662
2020,5,19,4,4915,5276,3934,-1342
2020,5,19,5,3845,4776,3476,-1300
2020,5,19,6,3583,4390,3184,-1206
2020,5,19,7,3410,4151,3002,-1149
2020,5,19,8,3317,4027,2903,-1124
2020,5,19,9,3288,4011,2842,-1169
2020,5,19,10,3461,4161,2840,-1321
2020,5,19,11,3763,4420,2881,-1539
2020,5,19,12,4027,4753,3105,-1648
2020,5,19,13,4305,5249,3570,-1679
2020,5,19,14,4686,5841,4088,-1753
2020,5,19,15,5043,6477,4500,-1977
2020,5,19,16,5452,7148,5016,-2132
2020,5,19,17,5788,7750,5478,-2272
2020,5,19,18,6116,8232,5912,-2320
2020,5,19,19,6366,8527,6306,-2221
2020,5,19,20,6569,8788,6415,-2373
2020,5,19,21,6697,8979,6538,-2441
2020,5,19,22,6700,9062,6652,-2410
2020,5,19,23,6567,8840,6406,-2434
2020,5,20,0,6212,8282,6022,-2260
2020,5,20,1,5868,7706,5565,-2141
2020,5,20,2,5484,7218,5066,-2152
2020,5,20,3,4920,6406,4613,-1793
2020,5,20,4,4387,5659,4224,-1435
2020,5,20,5,4007,5078,3759,-1319
2020,5,20,6,3663,4637,3410,-1227
2020,5,20,7,3425,4316,3154,-1162
2020,5,20,8,3300,4100,2957,-1143
2020,5,20,9,3248,4014,2821,-1193
2020,5,20,10,3395,4123,2789,-1334
2020,5,20,11,3656,4373,2823,-1550
2020,5,20,12,3898,4704,3068,-1636
2020,5,20,13,4217,5234,3547,-1687
2020,5,20,14,4611,5845,4069,-1776
2020,5,20,15,5147,6482,4500,-1982
2020,5,20,16,5601,7145,5031,-2114
2020,5,20,17,6039,7743,5519,-2224
2020,5,20,18,6470,8287,6049,-2238
2020,5,20,19,6779,8895,6599,-2296
2020,5,20,20,7043,9074,6936,-2138
2020,5,20,21,7194,9338,7195,-2143
2020,5,20,22,7184,9350,7219,-2131
2020,5,20,23,6952,9130,6984,-2146
2020,5,21,0,6563,8585,6352,-2233
2020,5,21,1,6204,8104,5957,-2147
2020,5,21,2,5791,7549,5456,-2093
2020,5,21,3,5183,6728,4985,-1743
2020,5,21,4,4608,5952,4548,-1404
2020,5,21,5,4238,5314,3974,-1340
2020,5,21,6,3882,4840,3600,-1240
2020,5,21,7,3638,4551,3355,-1196
2020,5,21,8,3494,4381,3198,-1183
2020,5,21,9,3464,4308,3144,-1164
2020,5,21,10,3588,4388,3195,-1193
2020,5,21,11,3840,4585,3342,-1243
2020,5,21,12,4088,4912,3660,-1252
2020,5,21,13,4434,5523,4204,-1319
2020,5,21,14,4878,6374,4868,-1506
2020,5,21,15,5371,7071,5419,-1652
2020,5,21,16,5906,7934,5955,-1979
2020,5,21,17,6441,8585,6505,-2080
2020,5,21,18,6872,9208,7061,-2147
2020,5,21,19,7184,9646,7486,-2160
2020,5,21,20,7462,9952,7806,-2146
2020,5,21,21,7600,10206,7971,-2235
2020,5,21,22,7583,10145,7941,-2204
2020,5,21,23,7311,9656,7473,-2183
2020,5,22,0,6896,8909,6686,-2223
2020,5,22,1,6536,8202,5919,-2283
2020,5,22,2,6113,7536,5342,-2194
2020,5,22,3,5493,6722,4869,-1853
2020,5,22,4,4917,5944,4468,-1476
2020,5,22,5,4477,5293,3887,-1406
2020,5,22,6,4087,4802,3510,-1292
2020,5,22,7,3816,4482,3265,-1217
2020,5,22,8,3648,4289,3110,-1179
2020,5,22,9,3585,4218,3069,-1149
2020,5,22,10,3670,4286,3115,-1171
2020,5,22,11,3908,4513,3279,-1234
2020,5,22,12,4172,4820,3571,-1249
2020,5,22,13,4557,5444,4110,-1334
2020,5,22,14,5049,6224,4703,-1521
2020,5,22,15,5646,7083,5279,-1804
2020,5,22,16,6187,8001,5925,-2076
2020,5,22,17,6691,8861,6704,-2157
2020,5,22,18,7140,9572,7396,-2176
2020,5,22,19,7491,10099,7860,-2239
2020,5,22,20,7696,10376,8159,-2217
2020,5,22,21,7781,10436,8192,-2244
2020,5,22,22,7692,10169,7958,-2211
2020,5,22,23,7351,9527,7424,-2103
2020,5,23,0,6887,8781,6659,-2122
2020,5,23,1,6494,8125,5909,-2216
2020,5,23,2,6120,7575,5337,-2238
2020,5,23,3,5556,6888,4985,-1903
2020,5,23,4,5034,6203,4664,-1539
2020,5,23,5,4563,5631,4164,-1467
2020,5,23,6,4172,5143,3802,-1341
2020,5,23,7,3889,4771,3535,-1236
2020,5,23,8,3717,4548,3359,-1189
2020,5,23,9,3608,4402,3244,-1158
2020,5,23,10,3581,4354,3202,-1152
2020,5,23,11,3561,4374,3200,-1174
2020,5,23,12,3728,4631,3419,-1212
2020,5,23,13,4226,5290,3967,-1323
2020,5,23,14,4873,6108,4563,-1545
2020,5,23,15,5492,6949,5128,-1821
2020,5,23,16,6094,7794,5695,-2099
2020,5,23,17,6635,8510,6318,-2192
2020,5,23,18,7104,9167,7119,-2048
2020,5,23,19,7437,9491,7295,-2196
2020,5,23,20,7621,9754,7481,-2273
2020,5,23,21,7695,9910,7621,-2289
2020,5,23,22,7637,9874,7632,-2242
2020,5,23,23,7383,9442,7325,-2117
2020,5,24,0,6908,8807,6614,-2193
2020,5,24,1,6511,8259,5875,-2384
2020,5,24,2,6087,7683,5506,-2177
2020,5,24,3,5523,7006,5122,-1884
2020,5,24,4,5021,6353,4783,-1570
2020,5,24,5,4521,5811,4325,-1486
2020,5,24,6,4137,5366,3963,-1403
2020,5,24,7,3863,5013,3705,-1308
2020,5,24,8,3695,4818,3552,-1266
2020,5,24,9,3584,4647,3414,-1233
2020,5,24,10,3511,4584,3374,-1210
2020,5,24,11,3413,4585,3377,-1208
2020,5,24,12,3546,4731,3506,-1225
2020,5,24,13,4038,5237,3916,-1321
2020,5,24,14,4684,5978,4461,-1517
2020,5,24,15,5341,6668,5062,-1606
2020,5,24,16,5863,7201,5520,-1681
2020,5,24,17,6269,7597,5975,-1622
2020,5,24,18,6660,7920,6386,-1534
2020,5,24,19,6945,8230,6577,-1653
2020,5,24,20,7166,8433,6718,-1715
2020,5,24,21,7269,8357,6645,-1712
2020,5,24,22,7297,8132,6418,-1714
2020,5,24,23,7027,7782,6117,-1665
2020,5,25,0,6602,7404,5596,-1808
2020,5,25,1,6256,7250,5518,-1732
2020,5,25,2,5814,6920,5087,-1833
2020,5,25,3,5282,6448,4753,-1695
2020,5,25,4,4757,5945,4394,-1551
2020,5,25,5,4124,5482,3990,-1492
2020,5,25,6,3784,4958,3667,-1291
2020,5,25,7,3550,4766,3443,-1323
2020,5,25,8,3425,4580,3303,-1277
2020,5,25,9,3342,4513,3259,-1254
2020,5,25,10,3320,4537,3285,-1252
2020,5,25,11,3258,4645,3379,-1266
2020,5,25,12,3392,4756,3348,-1408
2020,5,25,13,3830,5106,3813,-1293
2020,5,25,14,4273,5575,4152,-1423
2020,5,25,15,4623,6010,4556,-1454
2020,5,25,16,4905,6385,4883,-1502
2020,5,25,17,5036,6635,5308,-1327
2020,5,25,18,5153,6837,5604,-1233
2020,5,25,19,5269,6899,5536,-1363
2020,5,25,20,5296,6908,5470,-1438
2020,5,25,21,5278,6823,5343,-1480
2020,5,25,22,5387,6664,5265,-1399
2020,5,25,23,5398,6451,5073,-1378
2020,5,26,0,5221,6207,4763,-1444
2020,5,26,1,5127,6147,4501,-1646
2020,5,26,2,4927,5976,4044,-1932
2020,5,26,3,4589,5606,3694,-1912
2020,5,26,4,4209,5133,3485,-1648
2020,5,26,5,3671,4733,3108,-1625
2020,5,26,6,3416,4430,2998,-1432
2020,5,26,7,3279,4244,2895,-1349
2020,5,26,8,3205,4162,2854,-1308
2020,5,26,9,3228,4193,2851,-1342
2020,5,26,10,3407,4345,2961,-1384
2020,5,26,11,3686,4660,3169,-1491
2020,5,26,12,3965,4990,3380,-1610
2020,5,26,13,4312,5419,3718,-1701
2020,5,26,14,4736,6030,4216,-1814
2020,5,26,15,5225,6623,4656,-1967
2020,5,26,16,5681,7246,5158,-2088
2020,5,26,17,6005,7930,5609,-2321
2020,5,26,18,6346,8396,5954,-2442
2020,5,26,19,6576,8784,6409,-2375
2020,5,26,20,6736,9002,6698,-2304
2020,5,26,21,6818,9074,6739,-2335
2020,5,26,22,6819,9201,6798,-2403
2020,5,26,23,6715,9053,6747,-2306
2020,5,27,0,6379,8509,6299,-2210
2020,5,27,1,6088,8077,5967,-2110
2020,5,27,2,5711,7544,5361,-2183
2020,5,27,3,5173,6867,4826,-2041
2020,5,27,4,4636,6177,4399,-1778
2020,5,27,5,4259,5615,3971,-1644
2020,5,27,6,3946,5173,3662,-1511
2020,5,27,7,3736,4874,3442,-1432
2020,5,27,8,3606,4716,3315,-1401
2020,5,27,9,3568,4682,3268,-1414
2020,5,27,10,3686,4768,3328,-1440
2020,5,27,11,3927,4991,3474,-1517
2020,5,27,12,4187,5328,3668,-1660
2020,5,27,13,4539,5906,4074,-1832
2020,5,27,14,5037,6544,4661,-1883
2020,5,27,15,5563,7235,5147,-2088
2020,5,27,16,6062,7844,5683,-2161
2020,5,27,17,6519,8168,6158,-2010
2020,5,27,18,6941,8382,6408,-1974
2020,5,27,19,7191,8727,6789,-1938
2020,5,27,20,7391,9033,7002,-2031
2020,5,27,21,7439,9245,7169,-2076
2020,5,27,22,7438,9236,7193,-2043
2020,5,27,23,7205,9027,7035,-1992
2020,5,28,0,6826,8530,6530,-2000
2020,5,28,1,6490,8064,5934,-2130
2020,5,28,2,6073,7607,5426,-2181
2020,5,28,3,5486,6906,4859,-2047
2020,5,28,4,4919,6216,4421,-1795
2020,5,28,5,4437,5582,3940,-1642
2020,5,28,6,4111,5150,3731,-1419
2020,5,28,7,3884,4875,3595,-1280
2020,5,28,8,3746,4704,3467,-1237
2020,5,28,9,3709,4648,3419,-1229
2020,5,28,10,3842,4763,3491,-1272
2020,5,28,11,4083,4983,3661,-1322
2020,5,28,12,4345,5291,4002,-1289
2020,5,28,13,4707,5861,4494,-1367
2020,5,28,14,5260,6585,5050,-1535
2020,5,28,15,5775,7402,5672,-1730
2020,5,28,16,6310,8279,6222,-2057
2020,5,28,17,6761,9018,6665,-2353
2020,5,28,18,7127,9517,7350,-2167
2020,5,28,19,7385,9799,7752,-2047
2020,5,28,20,7526,9789,7853,-1936
2020,5,28,21,7549,9357,7346,-2011
2020,5,28,22,7465,8813,6699,-2114
2020,5,28,23,7260,8090,5897,-2193
2020,5,29,0,6867,7524,5350,-2174
2020,5,29,1,6553,7163,5096,-2067
2020,5,29,2,6165,6731,4845,-1886
2020,5,29,3,5592,6160,4525,-1635
2020,5,29,4,5034,5508,4153,-1355
2020,5,29,5,4431,5026,3719,-1307
2020,5,29,6,4083,4636,3433,-1203
2020,5,29,7,3834,4382,3250,-1132
2020,5,29,8,3690,4215,3137,-1078
2020,5,29,9,3619,4207,3094,-1113
2020,5,29,10,3728,4299,3154,-1145
2020,5,29,11,3940,4556,3350,-1206
2020,5,29,12,4187,4906,3666,-1240
2020,5,29,13,4538,5487,4184,-1303
2020,5,29,14,5019,6183,4712,-1471
2020,5,29,15,5539,6965,5203,-1762
2020,5,29,16,6042,7799,5797,-2002
2020,5,29,17,6400,8572,6285,-2287
2020,5,29,18,6767,9121,6874,-2247
2020,5,29,19,6979,9558,7325,-2233
2020,5,29,20,7107,9594,7403,-2191
2020,5,29,21,7086,9494,7354,-2140
2020,5,29,22,6978,9212,7135,-2077
2020,5,29,23,6741,8807,6701,-2106
2020,5,30,0,6321,8205,6083,-2122
2020,5,30,1,6008,7706,5459,-2247
2020,5,30,2,5672,7204,5178,-2026
2020,5,30,3,5216,6651,4904,-1747
2020,5,30,4,4747,5993,4562,-1431
2020,5,30,5,4305,5440,4079,-1361
2020,5,30,6,3982,4988,3741,-1247
2020,5,30,7,3745,4686,3509,-1177
2020,5,30,8,3591,4495,3350,-1145
2020,5,30,9,3510,4353,3244,-1109
2020,5,30,10,3493,4336,3219,-1117
2020,5,30,11,3507,4378,3241,-1137
2020,5,30,12,3697,4618,3439,-1179
2020,5,30,13,4156,5262,3992,-1270
2020,5,30,14,4769,6107,4625,-1482
2020,5,30,15,5297,6975,5215,-1760
2020,5,30,16,5793,7822,5784,-2038
2020,5,30,17,6164,8546,6339,-2207
2020,5,30,18,6520,9059,6947,-2112
2020,5,30,19,6727,9443,7212,-2231
2020,5,30,20,6802,9723,7480,-2243
2020,5,30,21,6821,9920,7694,-2226
2020,5,30,22,6764,9796,7615,-2181
2020,5,30,23,6542,9341,7199,-2142
2020,5,31,0,6182,8608,6473,-2135
2020,5,31,1,5861,7943,5775,-2168
2020,5,31,2,5555,7380,5278,-2102
2020,5,31,3,5106,6705,4837,-1868
2020,5,31,4,4685,6033,4476,-1557
2020,5,31,5,4352,5494,4022,-1472
2020,5,31,6,4012,5048,3685,-1363
2020,5,31,7,3750,4725,3431,-1294
2020,5,31,8,3569,4489,3253,-1236
2020,5,31,9,3459,4345,3169,-1176
2020,5,31,10,3410,4304,3158,-1146
2020,5,31,11,3366,4308,3145,-1163
2020,5,31,12,3536,4538,3329,-1209
2020,5,31,13,4070,5233,3983,-1250
2020,5,31,14,4717,6118,4635,-1483
2020,5,31,15,5394,7033,5251,-1782
2020,5,31,16,5936,7943,5941,-2002
2020,5,31,17,6413,8744,6858,-1886
2020,5,31,18,6849,9334,7413,-1921
2020,5,31,19,7138,9726,7532,-2194
2020,5,31,20,7266,9916,7714,-2202
2020,5,31,21,7346,10021,7801,-2220
2020,5,31,22,7257,10004,7800,-2204
2020,5,31,23,7083,9725,7552,-2173
2020,6,1,0,6669,9178,7249,-1929
2020,6,1,1,6324,8693,6565,-2128
2020,6,1,2,5939,8180,6039,-2141
2020,6,1,3,5348,7411,5482,-1929
2020,6,1,4,4777,6631,5062,-1569
2020,6,1,5,4495,5990,4407,-1583
2020,6,1,6,4123,5501,4042,-1459
2020,6,1,7,3867,5186,3807,-1379
2020,6,1,8,3726,4930,3616,-1314
2020,6,1,9,3665,4834,3535,-1299
2020,6,1,10,3796,4947,3618,-1329
2020,6,1,11,4029,5181,3806,-1375
2020,6,1,12,4331,5477,4214,-1263
2020,6,1,13,4715,5969,4605,-1364
2020,6,1,14,5226,6659,5186,-1473
2020,6,1,15,5791,7424,5605,-1819
2020,6,1,16,6346,8204,6291,-1913
2020,6,1,17,6807,8932,6915,-2017
2020,6,1,18,7162,9421,7405,-2016
2020,6,1,19,7390,9714,7676,-2038
2020,6,1,20,7540,9860,7707,-2153
2020,6,1,21,7584,9898,7791,-2107
2020,6,1,22,7498,9814,7722,-2092
2020,6,1,23,7209,9463,7411,-2052
2020,6,2,0,6820,8868,6828,-2040
2020,6,2,1,6411,8399,6196,-2203
2020,6,2,2,5995,7957,5716,-2241
2020,6,2,3,5408,7244,5254,-1990
2020,6,2,4,4820,6496,4742,-1754
2020,6,2,5,4490,5902,4356,-1546
2020,6,2,6,4117,5405,3973,-1432
2020,6,2,7,3857,5112,3751,-1361
2020,6,2,8,3713,4915,3600,-1315
2020,6,2,9,3645,4825,3535,-1290
2020,6,2,10,3756,4925,3602,-1323
2020,6,2,11,3982,5144,3788,-1356
2020,6,2,12,4233,5460,4150,-1310
2020,6,2,13,4528,5974,4557,-1417
2020,6,2,14,4948,6544,5007,-1537
2020,6,2,15,5379,7165,5294,-1871
2020,6,2,16,5852,7731,5730,-2001
2020,6,2,17,6180,8236,6105,-2131
2020,6,2,18,6525,8630,6456,-2174
2020,6,2,19,6687,8859,6686,-2173
2020,6,2,20,6870,9033,6811,-2222
2020,6,2,21,6935,9131,6978,-2153
2020,6,2,22,6875,8999,6970,-2029
2020,6,2,23,6742,8653,6636,-2017
2020,6,3,0,6386,8128,6132,-1996
2020,6,3,1,6028,7829,5623,-2206
2020,6,3,2,5646,7391,5166,-2225
2020,6,3,3,5125,6742,4847,-1895
2020,6,3,4,4581,6091,4357,-1734
2020,6,3,5,4272,5564,4061,-1503
2020,6,3,6,3959,5145,3771,-1374
2020,6,3,7,3752,4861,3551,-1310
2020,6,3,8,3631,4698,3432,-1266
2020,6,3,9,3618,4632,3371,-1261
2020,6,3,10,3746,4721,3440,-1281
2020,6,3,11,3934,5005,3675,-1330
2020,6,3,12,4198,5239,4001,-1238
2020,6,3,13,4489,5615,4329,-1286
2020,6,3,14,4858,6048,4639,-1409
2020,6,3,15,5266,6540,4846,-1694
2020,6,3,16,5703,7093,5151,-1942
2020,6,3,17,5861,7639,5380,-2259
2020,6,3,18,6150,7920,5596,-2324
2020,6,3,19,6319,7992,5704,-2288
2020,6,3,20,6431,7896,5686,-2210
2020,6,3,21,6494,7744,5569,-2175
2020,6,3,22,6431,7619,5414,-2205
2020,6,3,23,6372,7363,5146,-2217
2020,6,4,0,6038,7060,4841,-2219
2020,6,4,1,5784,6872,4745,-2127
2020,6,4,2,5476,6601,4708,-1893
2020,6,4,3,5033,6115,4401,-1714
2020,6,4,4,4537,5572,4022,-1550
2020,6,4,5,3998,5121,3754,-1367
2020,6,4,6,3708,4809,3516,-1293
2020,6,4,7,3517,4570,3328,-1242
2020,6,4,8,3416,4437,3230,-1207
2020,6,4,9,3380,4438,3219,-1219
2020,6,4,10,3506,4546,3298,-1248
2020,6,4,11,3665,4838,3523,-1315
2020,6,4,12,3957,5159,3936,-1223
2020,6,4,13,4231,5513,4239,-1274
2020,6,4,14,4545,5933,4574,-1359
2020,6,4,15,4838,6282,4696,-1586
2020,6,4,16,5100,6521,4723,-1798
2020,6,4,17,5166,6671,4642,-2029
2020,6,4,18,5322,6776,4658,-2118
2020,6,4,19,5407,6960,4721,-2239
2020,6,4,20,5456,7056,4822,-2234
2020,6,4,21,5437,7104,4865,-2239
2020,6,4,22,5452,7076,4874,-2202
2020,6,4,23,5378,6896,4723,-2173
2020,6,5,0,5161,6607,4447,-2160
2020,6,5,1,5080,6508,4389,-2119
2020,6,5,2,4889,6327,4382,-1945
2020,6,5,3,4571,5852,4131,-1721
2020,6,5,4,4173,5305,3651,-1654
2020,6,5,5,3850,4860,3328,-1532
2020,6,5,6,3609,4490,3053,-1437
2020,6,5,7,3447,4280,2893,-1387
2020,6,5,8,3363,4191,2824,-1367
2020,6,5,9,3347,4162,2796,-1366
2020,6,5,10,3459,4309,2911,-1398
2020,6,5,11,3685,4563,3113,-1450
2020,6,5,12,3979,4848,3483,-1365
2020,6,5,13,4336,5258,3890,-1368
2020,6,5,14,4710,5807,4312,-1495
2020,6,5,15,5159,6321,4807,-1514
2020,6,5,16,5510,6915,5133,-1782
2020,6,5,17,5799,7577,5396,-2181
2020,6,5,18,6073,8184,5793,-2391
2020,6,5,19,6223,8572,6091,-2481
2020,6,5,20,6378,8756,6260,-2496
2020,6,5,21,6455,8658,6148,-2510
2020,6,5,22,6413,8293,5763,-2530
2020,6,5,23,6232,7730,5297,-2433
2020,6,6,0,5857,7166,4858,-2308
2020,6,6,1,5567,6811,4685,-2126
2020,6,6,2,5355,6510,4567,-1943
2020,6,6,3,4979,6032,4273,-1759
2020,6,6,4,4551,5533,3824,-1709
2020,6,6,5,4070,5107,3525,-1582
2020,6,6,6,3791,4780,3282,-1498
2020,6,6,7,3582,4544,3106,-1438
2020,6,6,8,3452,4364,2988,-1376
2020,6,6,9,3382,4318,2925,-1393
2020,6,6,10,3399,4325,2909,-1416
2020,6,6,11,3432,4424,2999,-1425
2020,6,6,12,3622,4617,3300,-1317
2020,6,6,13,3961,5038,3741,-1297
2020,6,6,14,4331,5538,4180,-1358
2020,6,6,15,4683,5996,4659,-1337
2020,6,6,16,4945,6278,4908,-1370
2020,6,6,17,5106,6512,5049,-1463
2020,6,6,18,5177,6632,5036,-1596
2020,6,6,19,5228,6637,5009,-1628
2020,6,6,20,5313,6659,5068,-1591
2020,6,6,21,5385,6637,4992,-1645
2020,6,6,22,5415,6651,4982,-1669
2020,6,6,23,5364,6505,4844,-1661
2020,6,7,0,5192,6325,4730,-1595
2020,6,7,1,5038,6230,4692,-1538
2020,6,7,2,4845,5934,4524,-1410
2020,6,7,3,4541,5575,4149,-1426
2020,6,7,4,4194,5182,3735,-1447
2020,6,7,5,3995,4826,3531,-1295
2020,6,7,6,3727,4533,3313,-1220
2020,6,7,7,3519,4371,3190,-1181
2020,6,7,8,3414,4256,3092,-1164
2020,6,7,9,3337,4227,3070,-1157
2020,6,7,10,3352,4296,3115,-1181
2020,6,7,11,3337,4422,3216,-1206
2020,6,7,12,3529,4648,3511,-1137
2020,6,7,13,3928,5200,3998,-1202
2020,6,7,14,4454,5859,4562,-1297
2020,6,7,15,4917,6360,4972,-1388
2020,6,7,16,5305,6729,5260,-1469
2020,6,7,17,5450,7113,5453,-1660
2020,6,7,18,5653,7239,5505,-1734
2020,6,7,19,5819,7538,5663,-1875
2020,6,7,20,5878,7785,5876,-1909
2020,6,7,21,5924,7894,5951,-1943
2020,6,7,22,5973,7898,5938,-1960
2020,6,7,23,5931,7670,5745,-1925
2020,6,8,0,5684,7327,5488,-1839
2020,6,8,1,5483,7109,5313,-1796
2020,6,8,2,5260,6896,5167,-1729
2020,6,8,3,4889,6354,4729,-1625
2020,6,8,4,4496,5819,4109,-1710
2020,6,8,5,4186,5329,3726,-1603
2020,6,8,6,3910,4984,3470,-1514
2020,6,8,7,3724,4769,3301,-1468
2020,6,8,8,3621,4677,3229,-1448
2020,6,8,9,3590,4677,3237,-1440
2020,6,8,10,3733,4872,3387,-1485
2020,6,8,11,3932,5185,3642,-1543
2020,6,8,12,4241,5519,4067,-1452
2020,6,8,13,4660,6081,4612,-1469
2020,6,8,14,5248,6833,5153,-1680
2020,6,8,15,5739,7587,5811,-1776
2020,6,8,16,6278,8252,6142,-2110
2020,6,8,17,6644,8764,6550,-2214
2020,6,8,18,6956,8992,6871,-2121
2020,6,8,19,7152,9027,6792,-2235
2020,6,8,20,7254,8901,6620,-2281
2020,6,8,21,7315,8972,6615,-2357
2020,6,8,22,7221,9137,6804,-2333
2020,6,8,23,6986,9182,6821,-2361
2020,6,9,0,6656,8832,6489,-2343
2020,6,9,1,6359,8436,6149,-2287
2020,6,9,2,5995,8013,5812,-2201
2020,6,9,3,5491,7257,5270,-1987
2020,6,9,4,4985,6484,4746,-1738
2020,6,9,5,4634,5882,4400,-1482
2020,6,9,6,4311,5408,4006,-1402
2020,6,9,7,4098,5076,3777,-1299
2020,6,9,8,3944,4868,3581,-1287
2020,6,9,9,3903,4802,3526,-1276
2020,6,9,10,4008,4894,3593,-1301
2020,6,9,11,4216,5149,3810,-1339
2020,6,9,12,4509,5533,4239,-1294
2020,6,9,13,4934,6036,4630,-1406
2020,6,9,14,5482,6654,5042,-1612
2020,6,9,15,6008,7379,5573,-1806
2020,6,9,16,6627,8055,5973,-2082
2020,6,9,17,7048,8631,6280,-2351
2020,6,9,18,7390,9084,6850,-2234
2020,6,9,19,7597,9538,7261,-2277
2020,6,9,20,7732,9850,7566,-2284
2020,6,9,21,7760,9899,7700,-2199
2020,6,9,22,7643,9893,7746,-2147
2020,6,9,23,7464,9626,7597,-2029
2020,6,10,0,7073,9044,6868,-2176
2020,6,10,1,6718,8475,6176,-2299
2020,6,10,2,6343,7978,5803,-2175
2020,6,10,3,5803,7257,5265,-1992
2020,6,10,4,5234,6501,4749,-1752
2020,6,10,5,4818,5836,4318,-1518
2020,6,10,6,4472,5367,3967,-1400
2020,6,10,7,4221,5083,3750,-1333
2020,6,10,8,4076,4889,3612,-1277
2020,6,10,9,4027,4802,3560,-1242
2020,6,10,10,4119,4892,3613,-1279
2020,6,10,11,4298,5134,3809,-1325
2020,6,10,12,4568,5484,4253,-1231
2020,6,10,13,4972,6112,4615,-1497
2020,6,10,14,5480,6983,5088,-1895
2020,6,10,15,5996,7860,5717,-2143
2020,6,10,16,6542,8746,6677,-2069
2020,6,10,17,7016,9547,7471,-2076
2020,6,10,18,7417,10062,8113,-1949
2020,6,10,19,7641,10326,8457,-1869
2020,6,10,20,7808,10341,8401,-1940
2020,6,10,21,7881,9974,8166,-1808
2020,6,10,22,7781,9329,7445,-1884
2020,6,10,23,7563,8747,6881,-1866
2020,6,11,0,7161,8284,6212,-2072
2020,6,11,1,6797,7937,5723,-2214
2020,6,11,2,6423,7597,5373,-2224
2020,6,11,3,5873,6936,4905,-2031
2020,6,11,4,5291,6193,4390,-1803
2020,6,11,5,4875,5617,4149,-1468
2020,6,11,6,4517,5162,3802,-1360
2020,6,11,7,4249,4863,3555,-1308
2020,6,11,8,4103,4658,3392,-1266
2020,6,11,9,4045,4588,3357,-1231
2020,6,11,10,4125,4691,3436,-1255
2020,6,11,11,4312,4949,3671,-1278
2020,6,11,12,4565,5336,4151,-1185
2020,6,11,13,4968,5972,4504,-1468
2020,6,11,14,5473,6746,4902,-1844
2020,6,11,15,5989,7626,5540,-2086
2020,6,11,16,6610,8402,6067,-2335
2020,6,11,17,7019,9098,6785,-2313
2020,6,11,18,7381,9637,7318,-2319
2020,6,11,19,7583,9956,7705,-2251
2020,6,11,20,7693,9959,7661,-2298
2020,6,11,21,7670,9879,7631,-2248
2020,6,11,22,7563,9667,7409,-2258
2020,6,11,23,7359,9355,7089,-2266
2020,6,12,0,6955,8696,6382,-2314
2020,6,12,1,6592,8160,5865,-2295
2020,6,12,2,6240,7679,5442,-2237
2020,6,12,3,5682,6998,4956,-2042
2020,6,12,4,5100,6255,4430,-1825
2020,6,12,5,4639,5697,4205,-1492
2020,6,12,6,4259,5252,3874,-1378
2020,6,12,7,3985,4947,3632,-1315
2020,6,12,8,3823,4723,3433,-1290
2020,6,12,9,3764,4623,3356,-1267
2020,6,12,10,3811,4669,3400,-1269
2020,6,12,11,3998,4836,3551,-1285
2020,6,12,12,4269,5155,3874,-1281
2020,6,12,13,4672,5706,4182,-1524
2020,6,12,14,5198,6380,4542,-1838
2020,6,12,15,5861,7110,5054,-2056
2020,6,12,16,6427,7863,5593,-2270
2020,6,12,17,6894,8563,6088,-2475
2020,6,12,18,7267,9150,6751,-2399
2020,6,12,19,7545,9523,7172,-2351
2020,6,12,20,7704,9809,7493,-2316
2020,6,12,21,7701,9953,7623,-2330
2020,6,12,22,7533,9904,7558,-2346
2020,6,12,23,7187,9584,7249,-2335
2020,6,13,0,6724,8985,6673,-2312
2020,6,13,1,6349,8428,6079,-2349
2020,6,13,2,6034,7953,5633,-2320
2020,6,13,3,5552,7203,5054,-2149
2020,6,13,4,5034,6523,4626,-1897
2020,6,13,5,4614,5931,4397,-1534
2020,6,13,6,4263,5464,4047,-1417
2020,6,13,7,3985,5116,3777,-1339
2020,6,13,8,3809,4886,3605,-1281
2020,6,13,9,3722,4761,3498,-1263
2020,6,13,10,3701,4758,3490,-1268
2020,6,13,11,3707,4776,3522,-1254
2020,6,13,12,3899,4889,3689,-1200
2020,6,13,13,4326,5399,3961,-1438
2020,6,13,14,4814,5975,4226,-1749
2020,6,13,15,5418,6596,4647,-1949
2020,6,13,16,5931,7195,4963,-2232
2020,6,13,17,6301,7848,5410,-2438
2020,6,13,18,6605,8319,5829,-2490
2020,6,13,19,6831,8663,6211,-2452
2020,6,13,20,6973,8839,6437,-2402
2020,6,13,21,7023,8799,6424,-2375
2020,6,13,22,6943,8637,6286,-2351
2020,6,13,23,6688,8217,5894,-2323
2020,6,14,0,6315,7701,5339,-2362
2020,6,14,1,6003,7293,5015,-2278
2020,6,14,2,5700,6984,4776,-2208
2020,6,14,3,5248,6396,4383,-2013
2020,6,14,4,4800,5791,4034,-1757
2020,6,14,5,4239,5304,3883,-1421
2020,6,14,6,3947,4884,3572,-1312
2020,6,14,7,3723,4589,3362,-1227
2020,6,14,8,3563,4393,3210,-1183
2020,6,14,9,3481,4269,3145,-1124
2020,6,14,10,3472,4242,3150,-1092
2020,6,14,11,3440,4237,3148,-1089
2020,6,14,12,3655,4488,3347,-1141
2020,6,14,13,4149,5194,3760,-1434
2020,6,14,14,4705,6014,4191,-1823
2020,6,14,15,5313,6829,4775,-2054
2020,6,14,16,5852,7559,5176,-2383
2020,6,14,17,6199,8201,5708,-2493
2020,6,14,18,6546,8679,6197,-2482
2020,6,14,19,6763,9011,6513,-2498
2020,6,14,20,6802,9230,6773,-2457
2020,6,14,21,6844,9289,6820,-2469
2020,6,14,22,6788,9107,6628,-2479
2020,6,14,23,6569,8759,6234,-2525
2020,6,15,0,6231,8171,5722,-2449
2020,6,15,1,5899,7711,5307,-2404
2020,6,15,2,5610,7378,5091,-2287
2020,6,15,3,5146,6693,4638,-2055
2020,6,15,4,4653,5956,4181,-1775
2020,6,15,5,4241,5353,3924,-1429
2020,6,15,6,3890,4913,3605,-1308
2020,6,15,7,3659,4637,3402,-1235
2020,6,15,8,3523,4463,3259,-1204
2020,6,15,9,3490,4418,3211,-1207
2020,6,15,10,3595,4525,3311,-1214
2020,6,15,11,3792,4775,3541,-1234
2020,6,15,12,4118,5157,3935,-1222
2020,6,15,13,4509,5710,4233,-1477
2020,6,15,14,5012,6335,4525,-1810
2020,6,15,15,5584,7064,5030,-2034
2020,6,15,16,6146,7745,5499,-2246
2020,6,15,17,6643,8381,6049,-2332
2020,6,15,18,7036,8886,6565,-2321
2020,6,15,19,7312,9264,6894,-2370
2020,6,15,20,7514,9551,7233,-2318
2020,6,15,21,7572,9724,7416,-2308
2020,6,15,22,7473,9744,7469,-2275
2020,6,15,23,7132,9525,7231,-2294
2020,6,16,0,6733,8942,6618,-2324
2020,6,16,1,6354,8254,5927,-2327
2020,6,16,2,5964,7740,5406,-2334
2020,6,16,3,5431,6898,4798,-2100
2020,6,16,4,4825,6113,4311,-1802
2020,6,16,5,4510,5484,4050,-1434
2020,6,16,6,4135,4973,3664,-1309
2020,6,16,7,3876,4619,3394,-1225
2020,6,16,8,3727,4381,3221,-1160
2020,6,16,9,3680,4298,3191,-1107
2020,6,16,10,3759,4384,3211,-1173
2020,6,16,11,3997,4558,3349,-1209
2020,6,16,12,4268,4935,3753,-1182
2020,6,16,13,4630,5372,3993,-1379
2020,6,16,14,5053,5897,4220,-1677
2020,6,16,15,5588,6429,4597,-1832
2020,6,16,16,6120,7041,4934,-2107
2020,6,16,17,6641,7695,5404,-2291
2020,6,16,18,7066,8306,5928,-2378
2020,6,16,19,7320,8792,6405,-2387
2020,6,16,20,7547,9173,6865,-2308
2020,6,16,21,7628,9321,7058,-2263
2020,6,16,22,7538,9285,7093,-2192
2020,6,16,23,7241,8977,6744,-2233
2020,6,17,0,6800,8460,6073,-2387
2020,6,17,1,6426,7943,5633,-2310
2020,6,17,2,6024,7493,5247,-2246
2020,6,17,3,5479,6752,4715,-2037
2020,6,17,4,4886,6008,4230,-1778
2020,6,17,5,4176,5394,3975,-1419
2020,6,17,6,3842,4913,3637,-1276
2020,6,17,7,3614,4607,3432,-1175
2020,6,17,8,3478,4393,3228,-1165
2020,6,17,9,3442,4333,3182,-1151
2020,6,17,10,3536,4431,3249,-1182
2020,6,17,11,3775,4645,3416,-1229
2020,6,17,12,4053,4993,3775,-1218
2020,6,17,13,4428,5497,4062,-1435
2020,6,17,14,4855,6118,4350,-1768
2020,6,17,15,5407,6838,4867,-1971
2020,6,17,16,6021,7623,5276,-2347
2020,6,17,17,6492,8360,5709,-2651
2020,6,17,18,6968,8888,6376,-2512
2020,6,17,19,7237,9234,6847,-2387
2020,6,17,20,7528,9507,7071,-2436
2020,6,17,21,7670,9658,7279,-2379
2020,6,17,22,7588,9580,7171,-2409
2020,6,17,23,7263,9269,6823,-2446
2020,6,18,0,6879,8712,6204,-2508
2020,6,18,1,6501,8140,5726,-2414
2020,6,18,2,6132,7654,5362,-2292
2020,6,18,3,5583,6924,4833,-2091
2020,6,18,4,4997,6181,4374,-1807
2020,6,18,5,4353,5568,4121,-1447
2020,6,18,6,4013,5115,3807,-1308
2020,6,18,7,3780,4760,3519,-1241
2020,6,18,8,3647,4553,3376,-1177
2020,6,18,9,3632,4472,3283,-1189
2020,6,18,10,3722,4574,3378,-1196
2020,6,18,11,3922,4773,3527,-1246
2020,6,18,12,4189,5148,3913,-1235
2020,6,18,13,4554,5721,4216,-1505
2020,6,18,14,5013,6454,4571,-1883
2020,6,18,15,5475,7252,5110,-2142
2020,6,18,16,5998,8049,5738,-2311
2020,6,18,17,6311,8706,6239,-2467
2020,6,18,18,6689,9274,6838,-2436
2020,6,18,19,6890,9602,7115,-2487
2020,6,18,20,7012,9843,7288,-2555
2020,6,18,21,7030,9886,7327,-2559
2020,6,18,22,6931,9657,7165,-2492
2020,6,18,23,6737,9238,6816,-2422
2020,6,19,0,6420,8663,6231,-2432
2020,6,19,1,6111,8155,5795,-2360
2020,6,19,2,5800,7727,5332,-2395
2020,6,19,3,5309,6992,4826,-2166
2020,6,19,4,4787,6290,4415,-1875
2020,6,19,5,4287,5646,4158,-1488
2020,6,19,6,3963,5201,3835,-1366
2020,6,19,7,3730,4945,3642,-1303
2020,6,19,8,3597,4745,3499,-1246
2020,6,19,9,3557,4709,3466,-1243
2020,6,19,10,3639,4793,3531,-1262
2020,6,19,11,3783,4983,3675,-1308
2020,6,19,12,4059,5267,3986,-1281
2020,6,19,13,4451,5744,4206,-1538
2020,6,19,14,4932,6390,4500,-1890
2020,6,19,15,5472,7111,4975,-2136
2020,6,19,16,5934,7775,5377,-2398
2020,6,19,17,6228,8518,5978,-2540
2020,6,19,18,6589,9162,6588,-2574
2020,6,19,19,6723,9579,7122,-2457
2020,6,19,20,6779,9749,7243,-2506
2020,6,19,21,6728,9629,7120,-2509
2020,6,19,22,6561,9183,6815,-2368
2020,6,19,23,6360,8863,6343,-2520
2020,6,20,0,5954,8284,5790,-2494
2020,6,20,1,5643,7847,5454,-2393
2020,6,20,2,5388,7497,5220,-2277
2020,6,20,3,5026,6891,4787,-2104
2020,6,20,4,4597,6282,4491,-1791
2020,6,20,5,4361,5688,4188,-1500
2020,6,20,6,4031,5218,3840,-1378
2020,6,20,7,3786,4886,3595,-1291
2020,6,20,8,3633,4662,3418,-1244
2020,6,20,9,3546,4542,3267,-1275
2020,6,20,10,3533,4520,3224,-1296
2020,6,20,11,3561,4579,3309,-1270
2020,6,20,12,3749,4781,3667,-1114
2020,6,20,13,4108,5408,4028,-1380
2020,6,20,14,4629,6233,4465,-1768
2020,6,20,15,5204,7088,5074,-2014
2020,6,20,16,5612,7911,5743,-2168
2020,6,20,17,5931,8640,6370,-2270
2020,6,20,18,6201,9225,7028,-2197
2020,6,20,19,6372,9646,7477,-2169
2020,6,20,20,6456,9939,7714,-2225
2020,6,20,21,6472,10193,7879,-2314
2020,6,20,22,6403,10288,7922,-2366
2020,6,20,23,6216,10086,7810,-2276
2020,6,21,0,5870,9652,7375,-2277
2020,6,21,1,5595,8961,6627,-2334
2020,6,21,2,5332,8357,6106,-2251
2020,6,21,3,4939,7528,5366,-2162
2020,6,21,4,4524,6742,4786,-1956
2020,6,21,5,4553,6079,4500,-1579
2020,6,21,6,4204,5543,4105,-1438
2020,6,21,7,3938,5156,3794,-1362
2020,6,21,8,3743,4889,3596,-1293
2020,6,21,9,3644,4710,3463,-1247
2020,6,21,10,3626,4641,3394,-1247
2020,6,21,11,3593,4602,3391,-1211
2020,6,21,12,3785,4818,3683,-1135
2020,6,21,13,4299,5581,4264,-1317
2020,6,21,14,4997,6524,4920,-1604
2020,6,21,15,5704,7410,5682,-1728
2020,6,21,16,6273,8306,6488,-1818
2020,6,21,17,6739,9136,7224,-1912
2020,6,21,18,7128,9585,7710,-1875
2020,6,21,19,7414,9982,8069,-1913
2020,6,21,20,7596,10230,8282,-1948
2020,6,21,21,7594,10345,8376,-1969
2020,6,21,22,7462,10369,8406,-1963
2020,6,21,23,7274,10171,8267,-1904
2020,6,22,0,6864,9703,7785,-1918
2020,6,22,1,6504,9106,7167,-1939
2020,6,22,2,6131,8567,6623,-1944
2020,6,22,3,5586,7698,5839,-1859
2020,6,22,4,5022,6819,5030,-1789
2020,6,22,5,4555,6111,4588,-1523
2020,6,22,6,4179,5541,4134,-1407
2020,6,22,7,3920,5168,3818,-1350
2020,6,22,8,3760,4923,3699,-1224
2020,6,22,9,3726,4817,3621,-1196
2020,6,22,10,3847,4876,3627,-1249
2020,6,22,11,4061,5090,3763,-1327
2020,6,22,12,4369,5468,4272,-1196
2020,6,22,13,4767,6099,4782,-1317
2020,6,22,14,5340,6914,5342,-1572
2020,6,22,15,6014,7756,6079,-1677
2020,6,22,16,6635,8655,6925,-1730
2020,6,22,17,7199,9540,7657,-1883
2020,6,22,18,7672,10214,8355,-1859
2020,6,22,19,7969,10607,8738,-1869
2020,6,22,20,8179,10980,9126,-1854
2020,6,22,21,8210,11172,9376,-1796
2020,6,22,22,8096,11147,9358,-1789
2020,6,22,23,7702,10878,9137,-1741
2020,6,23,0,7275,10152,8317,-1835
2020,6,23,1,6887,9482,7621,-1861
2020,6,23,2,6455,8789,6911,-1878
2020,6,23,3,5874,7897,5932,-1965
2020,6,23,4,5258,6996,5121,-1875
2020,6,23,5,4932,6267,4622,-1645
2020,6,23,6,4521,5728,4228,-1500
2020,6,23,7,4244,5337,3925,-1412
2020,6,23,8,4053,5126,3763,-1363
2020,6,23,9,3990,5044,3692,-1352
2020,6,23,10,4062,5138,3763,-1375
2020,6,23,11,4276,5346,3935,-1411
2020,6,23,12,4557,5654,4262,-1392
2020,6,23,13,5009,6268,4660,-1608
2020,6,23,14,5589,7102,5150,-1952
2020,6,23,15,6241,7989,5940,-2049
2020,6,23,16,6855,8846,6691,-2155
2020,6,23,17,7343,9636,7482,-2154
2020,6,23,18,7781,10146,8094,-2052
2020,6,23,19,8055,10421,8448,-1973
2020,6,23,20,8258,10297,8396,-1901
2020,6,23,21,8338,10136,8172,-1964
2020,6,23,22,8238,10093,8084,-2009
2020,6,23,23,7979,9854,7840,-2014
2020,6,24,0,7493,9432,7391,-2041
2020,6,24,1,7079,8973,6758,-2215
2020,6,24,2,6659,8523,6286,-2237
2020,6,24,3,6052,7747,5640,-2107
2020,6,24,4,5448,6954,5040,-1914
2020,6,24,5,4720,6298,4698,-1600
2020,6,24,6,4363,5834,4359,-1475
2020,6,24,7,4131,5489,4095,-1394
2020,6,24,8,3978,5272,3909,-1363
2020,6,24,9,3930,5196,3858,-1338
2020,6,24,10,4015,5280,3916,-1364
2020,6,24,11,4227,5507,4096,-1411
2020,6,24,12,4503,5884,4511,-1373
2020,6,24,13,4930,6586,4983,-1603
2020,6,24,14,5523,7424,5536,-1888
2020,6,24,15,6184,8339,6408,-1931
2020,6,24,16,6808,9240,7226,-2014
2020,6,24,17,7383,10048,8102,-1946
2020,6,24,18,7866,10667,8679,-1988
2020,6,24,19,8163,11044,9016,-2028
2020,6,24,20,8386,11224,9246,-1978
2020,6,24,21,8471,11343,9352,-1991
2020,6,24,22,8322,11374,9341,-2033
2020,6,24,23,8040,11157,9175,-1982
2020,6,25,0,7606,10606,8621,-1985
2020,6,25,1,7183,9874,7840,-2034
2020,6,25,2,6751,9110,7083,-2027
2020,6,25,3,6147,8224,6117,-2107
2020,6,25,4,5575,7341,5324,-2017
2020,6,25,5,5180,6654,4970,-1684
2020,6,25,6,4764,6095,4563,-1532
2020,6,25,7,4489,5717,4279,-1438
2020,6,25,8,4290,5425,4052,-1373
2020,6,25,9,4207,5313,3976,-1337
2020,6,25,10,4272,5349,3983,-1366
2020,6,25,11,4468,5547,4145,-1402
2020,6,25,12,4740,5918,4532,-1386
2020,6,25,13,5197,6525,4939,-1586
2020,6,25,14,5777,7362,5423,-1939
2020,6,25,15,6476,8327,6352,-1975
2020,6,25,16,7140,9323,7335,-1988
2020,6,25,17,7764,10193,8195,-1998
2020,6,25,18,8280,10789,8655,-2134
2020,6,25,19,8591,11175,9096,-2079
2020,6,25,20,8828,11419,9291,-2128
2020,6,25,21,8963,11533,9407,-2126
2020,6,25,22,8889,11351,9250,-2101
2020,6,25,23,8569,10884,8780,-2104
2020,6,26,0,8081,10251,8124,-2127
2020,6,26,1,7588,9668,7506,-2162
2020,6,26,2,7128,9065,6874,-2191
2020,6,26,3,6479,8162,5957,-2205
2020,6,26,4,5845,7302,5391,-1911
2020,6,26,5,5303,6624,5046,-1578
2020,6,26,6,4894,6047,4600,-1447
2020,6,26,7,4580,5679,4286,-1393
2020,6,26,8,4371,5424,4092,-1332
2020,6,26,9,4264,5281,3971,-1310
2020,6,26,10,4308,5337,4018,-1319
2020,6,26,11,4482,5500,4119,-1381
2020,6,26,12,4744,5806,4434,-1372
2020,6,26,13,5231,6426,4837,-1589
2020,6,26,14,5888,7247,5304,-1943
2020,6,26,15,6614,8271,6145,-2126
2020,6,26,16,7292,9289,7137,-2152
2020,6,26,17,7935,10156,8004,-2152
2020,6,26,18,8463,10848,8740,-2108
2020,6,26,19,8786,11270,9059,-2211
2020,6,26,20,9023,11527,9293,-2234
2020,6,26,21,9117,11555,9320,-2235
2020,6,26,22,9006,11238,9070,-2168
2020,6,26,23,8697,10848,8609,-2239
2020,6,27,0,8160,10283,8173,-2110
2020,6,27,1,7611,9612,7323,-2289
2020,6,27,2,7208,9129,6736,-2393
2020,6,27,3,6612,8379,5986,-2393
2020,6,27,4,5999,7624,5465,-2159
2020,6,27,5,5496,6972,5173,-1799
2020,6,27,6,5048,6434,4776,-1658
2020,6,27,7,4703,6018,4481,-1537
2020,6,27,8,4443,5742,4283,-1459
2020,6,27,9,4287,5561,4094,-1467
2020,6,27,10,4214,5482,4069,-1413
2020,6,27,11,4177,5457,4057,-1400
2020,6,27,12,4334,5677,4268,-1409
2020,6,27,13,4893,6257,4650,-1607
2020,6,27,14,5512,7068,5050,-2018
2020,6,27,15,6233,7969,5725,-2244
2020,6,27,16,6961,8890,6676,-2214
2020,6,27,17,7620,9729,7457,-2272
2020,6,27,18,8125,10327,7981,-2346
2020,6,27,19,8505,10626,8211,-2415
2020,6,27,20,8782,10767,8415,-2352
2020,6,27,21,8853,10816,8349,-2467
2020,6,27,22,8784,10581,8193,-2388
2020,6,27,23,8492,10211,8009,-2202
2020,6,28,0,8032,9784,7664,-2120
2020,6,28,1,7544,9327,6992,-2335
2020,6,28,2,7125,8852,6498,-2354
2020,6,28,3,6515,8165,5868,-2297
2020,6,28,4,5926,7435,5391,-2044
2020,6,28,5,5334,6870,5144,-1726
2020,6,28,6,4959,6342,4772,-1570
2020,6,28,7,4639,5912,4435,-1477
2020,6,28,8,4417,5646,4214,-1432
2020,6,28,9,4274,5455,4065,-1390
2020,6,28,10,4194,5372,3995,-1377
2020,6,28,11,4143,5308,3993,-1315
2020,6,28,12,4330,5508,4170,-1338
2020,6,28,13,4926,6145,4597,-1548
2020,6,28,14,5626,7009,5034,-1975
2020,6,28,15,6416,7915,5683,-2232
2020,6,28,16,7120,8851,6582,-2269
2020,6,28,17,7675,9731,7424,-2307
2020,6,28,18,8083,10417,8029,-2388
2020,6,28,19,8402,10859,8437,-2422
2020,6,28,20,8602,11072,8714,-2358
2020,6,28,21,8632,11171,8838,-2333
2020,6,28,22,8559,11096,8784,-2312
2020,6,28,23,8446,10782,8444,-2338
2020,6,29,0,7911,10293,7938,-2355
2020,6,29,1,7425,9736,7301,-2435
2020,6,29,2,7050,9195,6604,-2591
2020,6,29,3,6470,8334,5933,-2401
2020,6,29,4,5860,7519,5418,-2101
2020,6,29,5,5247,6757,5006,-1751
2020,6,29,6,4812,6208,4617,-1591
2020,6,29,7,4498,5851,4353,-1498
2020,6,29,8,4288,5608,4170,-1438
2020,6,29,9,4203,5463,4061,-1402
2020,6,29,10,4276,5525,4116,-1409
2020,6,29,11,4454,5704,4264,-1440
2020,6,29,12,4730,6067,4650,-1417
2020,6,29,13,5238,6767,5093,-1674
2020,6,29,14,5868,7678,5551,-2127
2020,6,29,15,6566,8615,6354,-2261
2020,6,29,16,7329,9526,7259,-2267
2020,6,29,17,7999,10298,8106,-2192
2020,6,29,18,8580,10870,8661,-2209
2020,6,29,19,8950,11258,8979,-2279
2020,6,29,20,9149,11398,9109,-2289
2020,6,29,21,9251,11476,9264,-2212
2020,6,29,22,9150,11449,9119,-2330
2020,6,29,23,8910,11154,8822,-2332
2020,6,30,0,8436,10549,8240,-2309
2020,6,30,1,7915,9887,7405,-2482
2020,6,30,2,7416,9375,6930,-2445
2020,6,30,3,6681,8543,6220,-2323
2020,6,30,4,6030,7729,5600,-2129
2020,6,30,5,5479,7085,5270,-1815
2020,6,30,6,5033,6535,4878,-1657
2020,6,30,7,4727,6120,4581,-1539
2020,6,30,8,4517,5849,4361,-1488
2020,6,30,9,4436,5677,4258,-1419
2020,6,30,10,4474,5703,4259,-1444
2020,6,30,11,4626,5875,4393,-1482
2020,6,30,12,4907,6208,4745,-1463
2020,6,30,13,5404,6894,5279,-1615
2020,6,30,14,6029,7799,5747,-2052
2020,6,30,15,6749,8656,6427,-2229
2020,6,30,16,7412,9491,7460,-2031
2020,6,30,17,7993,10271,8266,-2005
2020,6,30,18,8506,10850,8743,-2107
2020,6,30,19,8813,11211,9000,-2211
2020,6,30,20,8950,11401,9163,-2238
2020,6,30,21,9029,11401,9155,-2246
2020,6,30,22,8900,11258,8840,-2418
2020,6,30,23,8701,10813,8625,-2188
2020,7,1,0,8230,10164,7997,-2167
2020,7,1,1,7720,9616,7378,-2238
2020,7,1,2,7237,9049,6826,-2223
2020,7,1,3,6549,8260,5970,-2290
2020,7,1,4,5921,7480,5495,-1985
2020,7,1,5,5559,6854,5099,-1755
2020,7,1,6,5124,6333,4754,-1579
2020,7,1,7,4807,5967,4453,-1514
2020,7,1,8,4589,5712,4252,-1460
2020,7,1,9,4458,5618,4170,-1448
2020,7,1,10,4480,5689,4230,-1459
2020,7,1,11,4613,5883,4397,-1486
2020,7,1,12,4859,6182,4723,-1459
2020,7,1,13,5334,6674,5120,-1554
2020,7,1,14,5947,7462,5502,-1960
2020,7,1,15,6594,8353,6163,-2190
2020,7,1,16,7264,9104,7019,-2085
2020,7,1,17,7818,9682,7644,-2038
2020,7,1,18,8318,10054,8090,-1964
2020,7,1,19,8617,10050,8156,-1894
2020,7,1,20,8811,9664,7761,-1903
2020,7,1,21,8883,9376,7485,-1891
2020,7,1,22,8738,9217,7347,-1870
2020,7,1,23,8584,8974,7144,-1830
2020,7,2,0,8127,8638,6812,-1826
2020,7,2,1,7661,8365,6398,-1967
2020,7,2,2,7280,8093,5991,-2102
2020,7,2,3,6626,7481,5465,-2016
2020,7,2,4,6010,6779,5015,-1764
2020,7,2,5,5210,6181,4632,-1549
2020,7,2,6,4828,5744,4280,-1464
2020,7,2,7,4535,5435,4042,-1393
2020,7,2,8,4343,5230,3889,-1341
2020,7,2,9,4238,5165,3835,-1330
2020,7,2,10,4288,5228,3878,-1350
2020,7,2,11,4428,5438,4034,-1404
2020,7,2,12,4655,5815,4458,-1357
2020,7,2,13,5165,6466,4839,-1627
2020,7,2,14,5855,7309,5299,-2010
2020,7,2,15,6488,8214,6026,-2188
2020,7,2,16,7162,8961,6562,-2399
2020,7,2,17,7699,9574,7365,-2209
2020,7,2,18,8184,9852,7956,-1896
2020,7,2,19,8407,9870,7978,-1892
2020,7,2,20,8476,9741,7863,-1878
2020,7,2,21,8402,9856,7888,-1968
2020,7,2,22,8212,10005,7871,-2134
2020,7,2,23,7986,9868,7637,-2231
2020,7,3,0,7553,9450,7204,-2246
2020,7,3,1,7130,9057,6776,-2281
2020,7,3,2,6748,8708,6333,-2375
2020,7,3,3,6190,7996,5744,-2252
2020,7,3,4,5634,7200,5154,-2046
2020,7,3,5,5126,6596,4919,-1677
2020,7,3,6,4782,6062,4531,-1531
2020,7,3,7,4451,5678,4241,-1437
2020,7,3,8,4242,5418,4030,-1388
2020,7,3,9,4093,5315,3962,-1353
2020,7,3,10,4041,5323,3969,-1354
2020,7,3,11,3997,5407,4016,-1391
2020,7,3,12,4128,5630,4273,-1357
2020,7,3,13,4693,6241,4630,-1611
2020,7,3,14,5427,7093,5112,-1981
2020,7,3,15,6126,7936,5791,-2145
2020,7,3,16,6807,8575,6329,-2246
2020,7,3,17,7304,9061,6920,-2141
2020,7,3,18,7725,9089,6908,-2181
2020,7,3,19,7891,9163,6891,-2272
2020,7,3,20,7837,9406,7050,-2356
2020,7,3,21,7669,9609,7287,-2322
2020,7,3,22,7382,9609,7314,-2295
2020,7,3,23,7131,9383,7119,-2264
2020,7,4,0,6737,8889,6691,-2198
2020,7,4,1,6375,8409,6181,-2228
2020,7,4,2,6090,7941,5699,-2242
2020,7,4,3,5722,7354,5256,-2098
2020,7,4,4,5267,6786,4899,-1887
2020,7,4,5,4842,6225,4652,-1573
2020,7,4,6,4564,5756,4300,-1456
2020,7,4,7,4288,5395,4011,-1384
2020,7,4,8,4100,5157,3834,-1323
2020,7,4,9,3972,5011,3741,-1270
2020,7,4,10,3906,4944,3668,-1276
2020,7,4,11,3823,4950,3662,-1288
2020,7,4,12,3934,5115,3860,-1255
2020,7,4,13,4541,5835,4273,-1562
2020,7,4,14,5246,6846,5019,-1827
2020,7,4,15,5887,7864,5912,-1952
2020,7,4,16,6574,8755,6658,-2097
2020,7,4,17,7074,9415,7234,-2181
2020,7,4,18,7475,9738,7548,-2190
2020,7,4,19,7681,9764,7634,-2130
2020,7,4,20,7592,9291,7364,-1927
2020,7,4,21,7417,8763,7052,-1711
2020,7,4,22,7196,8469,6765,-1704
2020,7,4,23,6879,8049,6315,-1734
2020,7,5,0,6535,7671,5905,-1766
2020,7,5,1,6218,7342,5546,-1796
2020,7,5,2,5970,7055,5253,-1802
2020,7,5,3,5573,6730,4844,-1886
2020,7,5,4,5124,6272,4462,-1810
2020,7,5,5,4827,5784,4251,-1533
2020,7,5,6,4524,5346,3937,-1409
2020,7,5,7,4233,5047,3718,-1329
2020,7,5,8,4046,4858,3573,-1285
2020,7,5,9,3905,4744,3476,-1268
2020,7,5,10,3841,4703,3438,-1265
2020,7,5,11,3758,4708,3442,-1266
2020,7,5,12,3874,4856,3636,-1220
2020,7,5,13,4462,5437,4008,-1429
2020,7,5,14,5158,6298,4550,-1748
2020,7,5,15,5804,7219,5228,-1991
2020,7,5,16,6433,8038,5723,-2315
2020,7,5,17,6837,8784,6259,-2525
2020,7,5,18,7198,9172,6864,-2308
2020,7,5,19,7339,9026,6909,-2117
2020,7,5,20,7348,8464,6453,-2011
2020,7,5,21,7199,8296,6102,-2194
2020,7,5,22,7062,8330,5983,-2347
2020,7,5,23,6882,8227,5827,-2400
2020,7,6,0,6562,7929,5602,-2327
2020,7,6,1,6233,7605,5334,-2271
2020,7,6,2,5941,7266,5171,-2095
2020,7,6,3,5463,6628,4660,-1968
2020,7,6,4,4991,5991,4249,-1742
2020,7,6,5,4574,5476,4040,-1436
2020,7,6,6,4257,5046,3702,-1344
2020,7,6,7,4044,4809,3523,-1286
2020,7,6,8,3912,4672,3412,-1260
2020,7,6,9,3859,4659,3403,-1256
2020,7,6,10,3990,4818,3547,-1271
2020,7,6,11,4200,5091,3773,-1318
2020,7,6,12,4440,5471,4147,-1324
2020,7,6,13,4912,6090,4570,-1520
2020,7,6,14,5517,6898,4988,-1910
2020,7,6,15,6055,7785,5601,-2184
2020,7,6,16,6759,8513,6286,-2227
2020,7,6,17,7176,9053,6954,-2099
2020,7,6,18,7510,9375,7334,-2041
2020,7,6,19,7671,9443,7315,-2128
2020,7,6,20,7618,9143,6970,-2173
2020,7,6,21,7516,8964,6751,-2213
2020,7,6,22,7357,8774,6562,-2212
2020,7,6,23,7180,8384,6269,-2115
2020,7,7,0,6853,7976,5909,-2067
2020,7,7,1,6578,7608,5557,-2051
2020,7,7,2,6239,7253,5186,-2067
2020,7,7,3,5750,6681,4759,-1922
2020,7,7,4,5248,6075,4379,-1696
2020,7,7,5,4614,5582,4181,-1401
2020,7,7,6,4278,5233,3941,-1292
2020,7,7,7,4045,4964,3730,-1234
2020,7,7,8,3909,4792,3586,-1206
2020,7,7,9,3858,4768,3555,-1213
2020,7,7,10,3959,4920,3676,-1244
2020,7,7,11,4181,5172,3879,-1293
2020,7,7,12,4412,5541,4230,-1311
2020,7,7,13,4872,6153,4599,-1554
2020,7,7,14,5455,6944,5003,-1941
2020,7,7,15,6043,7782,5612,-2170
2020,7,7,16,6690,8452,6149,-2303
2020,7,7,17,7121,9072,6826,-2246
2020,7,7,18,7465,9227,7144,-2083
2020,7,7,19,7611,9074,6929,-2145
2020,7,7,20,7666,9153,6968,-2185
2020,7,7,21,7535,9294,7067,-2227
2020,7,7,22,7301,9358,7082,-2276
2020,7,7,23,7090,9150,6932,-2218
2020,7,8,0,6772,8722,6586,-2136
2020,7,8,1,6497,8312,6216,-2096
2020,7,8,2,6203,7903,5735,-2168
2020,7,8,3,5717,7245,5173,-2072
2020,7,8,4,5172,6574,4724,-1850
2020,7,8,5,4669,6034,4538,-1496
2020,7,8,6,4339,5620,4245,-1375
2020,7,8,7,4120,5358,4040,-1318
2020,7,8,8,3990,5183,3934,-1249
2020,7,8,9,3962,5135,3884,-1251
2020,7,8,10,4066,5265,3936,-1329
2020,7,8,11,4273,5538,4141,-1397
2020,7,8,12,4516,5840,4454,-1386
2020,7,8,13,4949,6416,4793,-1623
2020,7,8,14,5499,7034,5115,-1919
2020,7,8,15,6090,7627,5591,-2036
2020,7,8,16,6650,8067,6019,-2048
2020,7,8,17,6881,8225,6121,-2104
2020,7,8,18,7067,8387,6287,-2100
2020,7,8,19,7202,8581,6466,-2115
2020,7,8,20,7250,8916,6670,-2246
2020,7,8,21,7313,9357,7041,-2316
2020,7,8,22,7252,9573,7231,-2342
2020,7,8,23,7152,9440,7144,-2296
2020,7,9,0,6706,9052,6792,-2260
2020,7,9,1,6445,8603,6419,-2184
2020,7,9,2,6175,8202,6048,-2154
2020,7,9,3,5711,7509,5384,-2125
2020,7,9,4,5185,6818,4887,-1931
2020,7,9,5,4919,6271,4609,-1662
2020,7,9,6,4581,5870,4358,-1512
2020,7,9,7,4336,5587,4140,-1447
2020,7,9,8,4184,5401,4016,-1385
2020,7,9,9,4135,5336,3967,-1369
2020,7,9,10,4228,5451,4031,-1420
2020,7,9,11,4433,5721,4233,-1488
2020,7,9,12,4696,6031,4720,-1311
2020,7,9,13,5150,6670,5028,-1642
2020,7,9,14,5752,7432,5416,-2016
2020,7,9,15,6455,8249,6001,-2248
2020,7,9,16,7128,8998,6815,-2183
2020,7,9,17,7608,9728,7649,-2079
2020,7,9,18,7975,10139,8061,-2078
2020,7,9,19,8182,10474,8353,-2121
2020,7,9,20,8285,10749,8598,-2151
2020,7,9,21,8337,10938,8724,-2214
2020,7,9,22,8153,10939,8793,-2146
2020,7,9,23,7897,10685,8589,-2096
2020,7,10,0,7521,10164,8077,-2087
2020,7,10,1,7172,9607,7404,-2203
2020,7,10,2,6836,9136,6905,-2231
2020,7,10,3,6277,8386,6191,-2195
2020,7,10,4,5686,7600,5354,-2246
2020,7,10,5,5123,7007,5034,-1973
2020,7,10,6,4745,6549,4731,-1818
2020,7,10,7,4468,6187,4472,-1715
2020,7,10,8,4301,5973,4278,-1695
2020,7,10,9,4250,5853,4190,-1663
2020,7,10,10,4304,5887,4210,-1677
2020,7,10,11,4468,6045,4320,-1725
2020,7,10,12,4736,6233,4601,-1632
2020,7,10,13,5211,6610,4815,-1795
2020,7,10,14,5800,7099,5080,-2019
2020,7,10,15,6450,7703,5538,-2165
2020,7,10,16,7031,8228,5966,-2262
2020,7,10,17,7338,8898,6615,-2283
2020,7,10,18,7622,9590,7140,-2450
2020,7,10,19,7697,10065,7762,-2303
2020,7,10,20,7640,10375,8048,-2327
2020,7,10,21,7582,10592,8316,-2276
2020,7,10,22,7395,10523,8388,-2135
2020,7,10,23,7221,10274,8128,-2146
2020,7,11,0,6850,9570,7396,-2174
2020,7,11,1,6557,9108,7008,-2100
2020,7,11,2,6297,8704,6505,-2199
2020,7,11,3,5878,7970,5810,-2160
2020,7,11,4,5395,7239,5057,-2182
2020,7,11,5,4996,6665,4728,-1937
2020,7,11,6,4676,6153,4399,-1754
2020,7,11,7,4431,5833,4154,-1679
2020,7,11,8,4273,5618,3990,-1628
2020,7,11,9,4182,5511,3895,-1616
2020,7,11,10,4168,5516,3904,-1612
2020,7,11,11,4213,5606,3984,-1622
2020,7,11,12,4390,5879,4292,-1587
2020,7,11,13,4881,6501,4699,-1802
2020,7,11,14,5420,7303,5215,-2088
2020,7,11,15,6005,8182,6082,-2100
2020,7,11,16,6566,9053,6970,-2083
2020,7,11,17,7039,9551,7485,-2066
2020,7,11,18,7369,9740,7713,-2027
2020,7,11,19,7605,9626,7643,-1983
2020,7,11,20,7756,9755,7769,-1986
2020,7,11,21,7780,9796,7763,-2033
2020,7,11,22,7691,9651,7648,-2003
2020,7,11,23,7506,9185,7232,-1953
2020,7,12,0,7144,8598,6572,-2026
2020,7,12,1,6807,8166,5996,-2170
2020,7,12,2,6474,7806,5699,-2107
2020,7,12,3,6003,7195,5058,-2137
2020,7,12,4,5513,6565,4658,-1907
2020,7,12,5,5150,6095,4526,-1569
2020,7,12,6,4831,5694,4238,-1456
2020,7,12,7,4561,5405,4015,-1390
2020,7,12,8,4352,5238,3909,-1329
2020,7,12,9,4203,5108,3808,-1300
2020,7,12,10,4146,5080,3782,-1298
2020,7,12,11,4078,5093,3801,-1292
2020,7,12,12,4216,5326,4077,-1249
2020,7,12,13,4786,6053,4501,-1552
2020,7,12,14,5501,7067,5099,-1968
2020,7,12,15,6271,8044,6040,-2004
2020,7,12,16,6953,8976,6967,-2009
2020,7,12,17,7535,9752,7596,-2156
2020,7,12,18,7965,10327,8135,-2192
2020,7,12,19,8239,10671,8330,-2341
2020,7,12,20,8379,10875,8525,-2350
2020,7,12,21,8319,11005,8634,-2371
2020,7,12,22,8171,10979,8606,-2373
2020,7,12,23,7951,10639,8284,-2355
2020,7,13,0,7594,10102,7747,-2355
2020,7,13,1,7201,9450,7133,-2317
2020,7,13,2,6841,8893,6624,-2269
2020,7,13,3,6240,8050,5824,-2226
2020,7,13,4,5621,7212,5088,-2124
2020,7,13,5,4979,6508,4704,-1804
2020,7,13,6,4596,5956,4295,-1661
2020,7,13,7,4346,5550,3983,-1567
2020,7,13,8,4177,5302,3795,-1507
2020,7,13,9,4101,5233,3739,-1494
2020,7,13,10,4193,5317,3801,-1516
2020,7,13,11,4372,5515,3973,-1542
2020,7,13,12,4640,5867,4365,-1502
2020,7,13,13,5114,6574,4844,-1730
2020,7,13,14,5684,7430,5385,-2045
2020,7,13,15,6419,8320,6247,-2073
2020,7,13,16,7092,9157,7084,-2073
2020,7,13,17,7618,9959,7763,-2196
2020,7,13,18,8027,10517,8358,-2159
2020,7,13,19,8255,10878,8538,-2340
2020,7,13,20,8384,10829,8572,-2257
2020,7,13,21,8401,10646,8426,-2220
2020,7,13,22,8291,10554,8258,-2296
2020,7,13,23,8082,10352,8052,-2300
2020,7,14,0,7636,9991,7733,-2258
2020,7,14,1,7234,9489,7259,-2230
2020,7,14,2,6811,9033,6776,-2257
2020,7,14,3,6211,8256,6044,-2212
2020,7,14,4,5600,7453,5296,-2157
2020,7,14,5,5246,6812,4945,-1867
2020,7,14,6,4881,6279,4557,-1722
2020,7,14,7,4607,5935,4275,-1660
2020,7,14,8,4418,5709,4101,-1608
2020,7,14,9,4364,5636,4044,-1592
2020,7,14,10,4429,5730,4115,-1615
2020,7,14,11,4590,5921,4251,-1670
2020,7,14,12,4847,6207,4563,-1644
2020,7,14,13,5307,6728,4935,-1793
2020,7,14,14,5886,7495,5400,-2095
2020,7,14,15,6598,8276,6323,-1953
2020,7,14,16,7235,8823,6887,-1936
2020,7,14,17,7705,9859,7844,-2015
2020,7,14,18,8077,10402,8378,-2024
2020,7,14,19,8313,10799,8662,-2137
2020,7,14,20,8400,11125,8786,-2339
2020,7,14,21,8452,11233,8866,-2367
2020,7,14,22,8275,11227,8837,-2390
2020,7,14,23,8092,10878,8670,-2208
2020,7,15,0,7649,10265,8102,-2163
2020,7,15,1,7226,9641,7374,-2267
2020,7,15,2,6823,9049,6833,-2216
2020,7,15,3,6216,8235,6062,-2173
2020,7,15,4,5614,7422,5246,-2176
2020,7,15,5,5281,6767,4844,-1923
2020,7,15,6,4896,6264,4554,-1710
2020,7,15,7,4624,5885,4263,-1622
2020,7,15,8,4429,5609,4049,-1560
2020,7,15,9,4368,5514,3975,-1539
2020,7,15,10,4452,5604,4041,-1563
2020,7,15,11,4585,5776,4182,-1594
2020,7,15,12,4837,6039,4400,-1639
2020,7,15,13,5292,6675,4882,-1793
2020,7,15,14,5850,7560,5509,-2051
2020,7,15,15,6546,8490,6393,-2097
2020,7,15,16,7213,9384,7360,-2024
2020,7,15,17,7660,10001,7919,-2082
2020,7,15,18,8070,10235,8134,-2101
2020,7,15,19,8336,10394,8366,-2028
2020,7,15,20,8393,10533,8470,-2063
2020,7,15,21,8387,10567,8463,-2104
2020,7,15,22,8250,10168,8072,-2096
2020,7,15,23,7999,9572,7482,-2090
2020,7,16,0,7572,8732,6755,-1977
2020,7,16,1,7204,8175,6180,-1995
2020,7,16,2,6820,7670,5668,-2002
2020,7,16,3,6228,7014,5009,-2005
2020,7,16,4,5616,6320,4605,-1715
2020,7,16,5,4968,5796,4336,-1460
2020,7,16,6,4601,5371,4027,-1344
2020,7,16,7,4322,5061,3796,-1265
2020,7,16,8,4129,4873,3654,-1219
2020,7,16,9,4066,4793,3606,-1187
2020,7,16,10,4158,4886,3649,-1237
2020,7,16,11,4372,5154,3858,-1296
2020,7,16,12,4583,5466,4181,-1285
2020,7,16,13,5038,6024,4539,-1485
2020,7,16,14,5614,6751,4892,-1859
2020,7,16,15,6276,7643,5701,-1942
2020,7,16,16,6954,8585,6705,-1880
2020,7,16,17,7509,9479,7410,-2069
2020,7,16,18,7936,10115,7877,-2238
2020,7,16,19,8256,10492,8236,-2256
2020,7,16,20,8444,10642,8419,-2223
2020,7,16,21,8513,10880,8564,-2316
2020,7,16,22,8342,10847,8583,-2264
2020,7,16,23,8034,10363,8222,-2141
2020,7,17,0,7605,9541,7458,-2083
2020,7,17,1,7234,9011,6807,-2204
2020,7,17,2,6826,8405,6243,-2162
2020,7,17,3,6213,7645,5554,-2091
2020,7,17,4,5584,6918,5007,-1911
2020,7,17,5,5031,6329,4743,-1586
2020,7,17,6,4645,5810,4371,-1439
2020,7,17,7,4335,5480,4103,-1377
2020,7,17,8,4141,5254,3939,-1315
2020,7,17,9,4051,5155,3864,-1291
2020,7,17,10,4112,5211,3900,-1311
2020,7,17,11,4298,5408,4059,-1349
2020,7,17,12,4503,5724,4414,-1310
2020,7,17,13,4938,6373,4782,-1591
2020,7,17,14,5498,7217,5245,-1972
2020,7,17,15,6169,8053,5991,-2062
2020,7,17,16,6779,8855,6881,-1974
2020,7,17,17,7334,9611,7518,-2093
2020,7,17,18,7744,10173,8110,-2063
2020,7,17,19,8085,10533,8475,-2058
2020,7,17,20,8258,10727,8645,-2082
2020,7,17,21,8245,10722,8665,-2057
2020,7,17,22,8052,10166,8252,-1914
2020,7,17,23,7679,9533,7661,-1872
2020,7,18,0,7204,8906,6961,-1945
2020,7,18,1,6846,8431,6394,-2037
2020,7,18,2,6512,8028,5970,-2058
2020,7,18,3,6022,7374,5292,-2082
2020,7,18,4,5510,6730,4833,-1897
2020,7,18,5,5124,6154,4578,-1576
2020,7,18,6,4737,5698,4228,-1470
2020,7,18,7,4472,5370,3994,-1376
2020,7,18,8,4294,5155,3830,-1325
2020,7,18,9,4178,5040,3734,-1306
2020,7,18,10,4155,5070,3770,-1300
2020,7,18,11,4144,5113,3795,-1318
2020,7,18,12,4292,5330,4051,-1279
2020,7,18,13,4775,6001,4474,-1527
2020,7,18,14,5399,6920,4952,-1968
2020,7,18,15,6009,7791,5699,-2092
2020,7,18,16,6594,8612,6502,-2110
2020,7,18,17,7004,9289,7076,-2213
2020,7,18,18,7310,9745,7486,-2259
2020,7,18,19,7480,9824,7610,-2214
2020,7,18,20,7549,9580,7470,-2110
2020,7,18,21,7527,9097,7097,-2000
2020,7,18,22,7437,8772,6835,-1937
2020,7,18,23,7218,8535,6567,-1968
2020,7,19,0,6818,8262,6227,-2035
2020,7,19,1,6459,7987,5874,-2113
2020,7,19,2,6136,7704,5577,-2127
2020,7,19,3,5638,7135,5095,-2040
2020,7,19,4,5162,6564,4705,-1859
2020,7,19,5,4734,6062,4519,-1543
2020,7,19,6,4420,5603,4157,-1446
2020,7,19,7,4179,5277,3906,-1371
2020,7,19,8,4017,5060,3737,-1323
2020,7,19,9,3906,4959,3659,-1300
2020,7,19,10,3873,4934,3642,-1292
2020,7,19,11,3859,4968,3671,-1297
2020,7,19,12,3964,5176,3901,-1275
2020,7,19,13,4523,5948,4391,-1557
2020,7,19,14,5247,6914,4947,-1967
2020,7,19,15,5923,7865,5790,-2075
2020,7,19,16,6514,8686,6574,-2112
2020,7,19,17,7135,9433,7190,-2243
2020,7,19,18,7553,9892,7570,-2322
2020,7,19,19,7841,10193,7878,-2315
2020,7,19,20,7979,10211,7923,-2288
2020,7,19,21,8037,10272,7963,-2309
2020,7,19,22,7976,10293,7981,-2312
2020,7,19,23,7797,10084,7834,-2250
2020,7,20,0,7356,9578,7326,-2252
2020,7,20,1,6899,9034,6891,-2143
2020,7,20,2,6491,8530,6448,-2082
2020,7,20,3,5919,7707,5596,-2111
2020,7,20,4,5384,6910,4980,-1930
2020,7,20,5,4919,6258,4645,-1613
2020,7,20,6,4568,5776,4282,-1494
2020,7,20,7,4310,5418,4006,-1412
2020,7,20,8,4144,5247,3874,-1373
2020,7,20,9,4081,5159,3824,-1335
2020,7,20,10,4185,5234,3867,-1367
2020,7,20,11,4398,5461,4061,-1400
2020,7,20,12,4625,5802,4437,-1365
2020,7,20,13,5059,6464,4881,-1583
2020,7,20,14,5606,7309,5357,-1952
2020,7,20,15,6269,8222,6210,-2012
2020,7,20,16,6897,9101,7023,-2078
2020,7,20,17,7444,9789,7503,-2286
2020,7,20,18,7838,10037,7836,-2201
2020,7,20,19,8115,10256,8063,-2193
2020,7,20,20,8297,10523,8271,-2252
2020,7,20,21,8359,10693,8454,-2239
2020,7,20,22,8178,10762,8400,-2362
2020,7,20,23,7912,10536,8329,-2207
2020,7,21,0,7421,9950,7664,-2286
2020,7,21,1,7048,9280,7054,-2226
2020,7,21,2,6618,8719,6593,-2126
2020,7,21,3,5999,7857,5660,-2197
2020,7,21,4,5413,7024,5025,-1999
2020,7,21,5,5149,6403,4865,-1538
2020,7,21,6,4756,5856,4468,-1388
2020,7,21,7,4473,5547,4243,-1304
2020,7,21,8,4326,5331,4082,-1249
2020,7,21,9,4242,5271,4040,-1231
2020,7,21,10,4330,5410,4168,-1242
2020,7,21,11,4507,5628,4332,-1296
2020,7,21,12,4721,5958,4570,-1388
2020,7,21,13,5123,6581,4952,-1629
2020,7,21,14,5634,7411,5403,-2008
2020,7,21,15,6217,8227,6133,-2094
2020,7,21,16,6784,9090,7020,-2070
2020,7,21,17,7232,9690,7662,-2028
2020,7,21,18,7636,9863,7795,-2068
2020,7,21,19,7888,9328,7462,-1866
2020,7,21,20,8001,8996,7138,-1858
2020,7,21,21,8009,9241,7322,-1919
2020,7,21,22,7815,9409,7492,-1917
2020,7,21,23,7533,9290,7322,-1968
2020,7,22,0,7173,8794,6873,-1921
2020,7,22,1,6821,8319,6304,-2015
2020,7,22,2,6445,7919,5838,-2081
2020,7,22,3,5840,7248,5214,-2034
2020,7,22,4,5327,6566,4877,-1689
2020,7,22,5,5002,6054,4545,-1509
2020,7,22,6,4653,5644,4235,-1409
2020,7,22,7,4405,5419,4066,-1353
2020,7,22,8,4258,5266,3944,-1322
2020,7,22,9,4194,5274,3953,-1321
2020,7,22,10,4296,5382,4031,-1351
2020,7,22,11,4492,5622,4216,-1406
2020,7,22,12,4697,5891,4518,-1373
2020,7,22,13,5110,6315,4770,-1545
2020,7,22,14,5573,6943,5049,-1894
2020,7,22,15,6222,7679,5537,-2142
2020,7,22,16,6725,8393,6232,-2161
2020,7,22,17,7072,9020,6896,-2124
2020,7,22,18,7398,8835,6781,-2054
2020,7,22,19,7553,8278,6367,-1911
2020,7,22,20,7525,7933,6110,-1823
2020,7,22,21,7430,7840,5985,-1855
2020,7,22,22,7170,7891,6025,-1866
2020,7,22,23,6901,7961,6080,-1881
2020,7,23,0,6534,7827,5979,-1848
2020,7,23,1,6244,7688,5807,-1881
2020,7,23,2,5977,7431,5482,-1949
2020,7,23,3,5478,6861,4944,-1917
2020,7,23,4,5022,6230,4487,-1743
2020,7,23,5,4834,5745,4265,-1480
2020,7,23,6,4525,5386,3987,-1399
2020,7,23,7,4312,5187,3828,-1359
2020,7,23,8,4171,5064,3725,-1339
2020,7,23,9,4129,5059,3718,-1341
2020,7,23,10,4248,5212,3843,-1369
2020,7,23,11,4466,5579,4128,-1451
2020,7,23,12,4691,5871,4497,-1374
2020,7,23,13,5102,6271,4720,-1551
2020,7,23,14,5565,6917,5026,-1891
2020,7,23,15,6134,7652,5428,-2224
2020,7,23,16,6670,8056,5823,-2233
2020,7,23,17,7049,8191,6173,-2018
2020,7,23,18,7353,7855,6016,-1839
2020,7,23,19,7542,7441,5686,-1755
2020,7,23,20,7540,7352,5624,-1728
2020,7,23,21,7546,7360,5627,-1733
2020,7,23,22,7314,7469,5717,-1752
2020,7,23,23,7087,7496,5734,-1762
2020,7,24,0,6826,7319,5426,-1893
2020,7,24,1,6534,7115,5131,-1984
2020,7,24,2,6212,6837,4801,-2036
2020,7,24,3,5669,6280,4405,-1875
2020,7,24,4,5105,5682,4031,-1651
2020,7,24,5,4585,5215,3877,-1338
2020,7,24,6,4279,4841,3600,-1241
2020,7,24,7,4057,4612,3468,-1144
2020,7,24,8,3918,4466,3300,-1166
2020,7,24,9,3894,4415,3261,-1154
2020,7,24,10,3999,4556,3323,-1233
2020,7,24,11,4237,4854,3610,-1244
2020,7,24,12,4493,5202,3962,-1240
2020,7,24,13,4917,5851,4390,-1461
2020,7,24,14,5501,6670,4812,-1858
2020,7,24,15,6133,7472,5270,-2202
2020,7,24,16,6679,8312,6078,-2234
2020,7,24,17,7217,9096,6891,-2205
2020,7,24,18,7661,9714,7479,-2235
2020,7,24,19,7878,10101,7791,-2310
2020,7,24,20,7931,10347,8017,-2330
2020,7,24,21,7922,10405,8061,-2344
2020,7,24,22,7726,10313,8027,-2286
2020,7,24,23,7341,9849,7573,-2276
2020,7,25,0,6966,9082,6857,-2225
2020,7,25,1,6653,8564,6261,-2303
2020,7,25,2,6347,8095,5779,-2316
2020,7,25,3,5870,7409,5249,-2160
2020,7,25,4,5356,6721,4847,-1874
2020,7,25,5,4807,6134,4550,-1584
2020,7,25,6,4456,5620,4186,-1434
2020,7,25,7,4179,5292,3931,-1361
2020,7,25,8,4006,5062,3760,-1302
2020,7,25,9,3900,4956,3670,-1286
2020,7,25,10,3898,4934,3661,-1273
2020,7,25,11,3909,5001,3702,-1299
2020,7,25,12,4068,5171,3928,-1243
2020,7,25,13,4576,5820,4313,-1507
2020,7,25,14,5229,6587,4687,-1900
2020,7,25,15,5885,7434,5435,-1999
2020,7,25,16,6511,8227,6092,-2135
2020,7,25,17,6970,8881,6689,-2192
2020,7,25,18,7362,9382,7182,-2200
2020,7,25,19,7560,9779,7571,-2208
2020,7,25,20,7640,10025,7754,-2271
2020,7,25,21,7617,10051,7812,-2239
2020,7,25,22,7524,9876,7684,-2192
2020,7,25,23,7313,9503,7304,-2199
2020,7,26,0,6906,8933,6838,-2095
2020,7,26,1,6545,8417,6290,-2127
2020,7,26,2,6210,7940,5891,-2049
2020,7,26,3,5702,7219,5145,-2074
2020,7,26,4,5203,6568,4703,-1865
2020,7,26,5,4850,6021,4452,-1569
2020,7,26,6,4479,5575,4123,-1452
2020,7,26,7,4195,5229,3871,-1358
2020,7,26,8,4019,5033,3746,-1287
2020,7,26,9,3895,4927,3670,-1257
2020,7,26,10,3850,4921,3674,-1247
2020,7,26,11,3822,4950,3687,-1263
2020,7,26,12,3965,5093,3839,-1254
2020,7,26,13,4509,5823,4286,-1537
2020,7,26,14,5176,6729,4811,-1918
2020,7,26,15,5876,7632,5496,-2136
2020,7,26,16,6445,0,5496,-96
2020,7,26,17,7000,9226,7052,-2174
2020,7,26,18,7410,9823,7598,-2225
2020,7,26,19,7682,10219,7903,-2316
2020,7,26,20,7865,10322,7975,-2347
2020,7,26,21,7968,10139,7818,-2321
2020,7,26,22,7815,9849,7616,-2233
2020,7,26,23,7543,9455,7270,-2185
2020,7,27,0,7110,8928,6697,-2231
2020,7,27,1,6679,8490,6252,-2238
2020,7,27,2,6325,8016,5845,-2171
2020,7,27,3,5793,7278,5199,-2079
2020,7,27,4,5236,6517,4756,-1761
2020,7,27,5,4794,5876,4418,-1458
2020,7,27,6,4437,5424,4080,-1344
2020,7,27,7,4201,5113,3840,-1273
2020,7,27,8,4046,4972,3715,-1257
2020,7,27,9,4002,4928,3680,-1248
2020,7,27,10,4127,5060,3794,-1266
2020,7,27,11,4348,5278,3980,-1298
2020,7,27,12,4604,5596,4297,-1299
2020,7,27,13,5040,6170,4644,-1526
2020,7,27,14,5601,6976,5074,-1902
2020,7,27,15,6225,7871,5609,-2262
2020,7,27,16,6814,8803,6465,-2338
2020,7,27,17,7297,9584,7297,-2287
2020,7,27,18,7665,10124,7862,-2262
2020,7,27,19,7843,10322,8096,-2226
2020,7,27,20,7932,10278,8089,-2189
2020,7,27,21,7942,9780,7674,-2106
2020,7,27,22,7826,9350,7271,-2079
2020,7,27,23,7564,9022,6930,-2092
2020,7,28,0,7171,8561,6468,-2093
2020,7,28,1,6841,8199,5964,-2235
2020,7,28,2,6456,7719,5587,-2132
2020,7,28,3,5908,7011,4966,-2045
2020,7,28,4,5310,6269,4516,-1753
2020,7,28,5,4882,5700,4299,-1401
2020,7,28,6,4520,5302,3994,-1308
2020,7,28,7,4274,5056,3804,-1252
2020,7,28,8,4112,4902,3706,-1196
2020,7,28,9,4061,4867,3668,-1199
2020,7,28,10,4170,4996,3754,-1242
2020,7,28,11,4396,5290,3990,-1300
2020,7,28,12,4632,5541,4400,-1141
2020,7,28,13,5046,5944,4593,-1351
2020,7,28,14,5575,6578,4839,-1739
2020,7,28,15,6186,7312,5272,-2040
2020,7,28,16,6759,8137,6166,-1971
2020,7,28,17,7296,8889,6985,-1904
2020,7,28,18,7683,9304,7447,-1857
2020,7,28,19,7868,9170,7374,-1796
2020,7,28,20,7962,8839,7078,-1761
2020,7,28,21,7987,8591,6878,-1713
2020,7,28,22,7838,8363,6719,-1644
2020,7,28,23,7581,8004,6411,-1593
2020,7,29,0,7189,7618,6006,-1612
2020,7,29,1,6865,7418,5669,-1749
2020,7,29,2,6492,7089,5245,-1844
2020,7,29,3,5940,6546,4761,-1785
2020,7,29,4,5305,5945,4296,-1649
2020,7,29,5,4573,5469,4098,-1371
2020,7,29,6,4254,5133,3848,-1285
2020,7,29,7,4028,4891,3663,-1228
2020,7,29,8,3893,4774,3550,-1224
2020,7,29,9,3867,4762,3547,-1215
2020,7,29,10,3992,4925,3669,-1256
2020,7,29,11,4227,5218,3907,-1311
2020,7,29,12,4460,5483,4235,-1248
2020,7,29,13,4895,5815,4396,-1419
2020,7,29,14,5435,6245,4518,-1727
2020,7,29,15,6071,6816,4797,-2019
2020,7,29,16,6660,7682,5451,-2231
2020,7,29,17,7166,8655,6303,-2352
2020,7,29,18,7613,9360,6955,-2405
2020,7,29,19,7878,9947,7469,-2478
2020,7,29,20,8024,10172,7797,-2375
2020,7,29,21,8045,10140,7872,-2268
2020,7,29,22,7814,9727,7585,-2142
2020,7,29,23,7526,9090,6937,-2153
2020,7,30,0,7131,8537,6329,-2208
2020,7,30,1,6805,8147,5832,-2315
2020,7,30,2,6428,7714,5516,-2198
2020,7,30,3,5876,7035,5024,-2011
2020,7,30,4,5265,6407,4613,-1794
2020,7,30,5,4689,5876,4405,-1471
2020,7,30,6,4373,5441,4065,-1376
2020,7,30,7,4149,5169,3860,-1309
2020,7,30,8,4023,4971,3702,-1269
2020,7,30,9,3988,4955,3681,-1274
2020,7,30,10,4120,5110,3798,-1312
2020,7,30,11,4365,5381,4024,-1357
2020,7,30,12,4605,5697,4399,-1298
2020,7,30,13,5035,6214,4686,-1528
2020,7,30,14,5635,6959,5044,-1915
2020,7,30,15,6280,7819,5591,-2228
2020,7,30,16,6892,8728,6411,-2317
2020,7,30,17,7448,9504,7173,-2331
2020,7,30,18,7857,10120,7789,-2331
2020,7,30,19,8097,10519,8192,-2327
2020,7,30,20,8244,10770,8373,-2397
2020,7,30,21,8244,10936,8470,-2466
2020,7,30,22,8073,10822,8453,-2369
2020,7,30,23,7701,10452,8185,-2267
2020,7,31,0,7240,9876,7552,-2324
2020,7,31,1,6914,9360,7159,-2201
2020,7,31,2,6525,8796,6646,-2150
2020,7,31,3,5971,7975,5875,-2100
2020,7,31,4,5399,7149,5112,-2037
2020,7,31,5,5007,6490,4870,-1620
2020,7,31,6,4647,5965,4489,-1476
2020,7,31,7,4373,5613,4230,-1383
2020,7,31,8,4215,5402,4063,-1339
2020,7,31,9,4149,5301,3997,-1304
2020,7,31,10,4237,5342,4041,-1301
2020,7,31,11,4465,5543,4200,-1343
2020,7,31,12,4687,5818,4505,-1313
2020,7,31,13,5156,6292,4775,-1517
2020,7,31,14,5781,6968,5085,-1883
2020,7,31,15,6460,7857,5636,-2221
2020,7,31,16,7072,8845,6541,-2304
2020,7,31,17,7655,9643,7342,-2301
2020,7,31,18,8143,10243,7866,-2377
2020,7,31,19,8420,10677,8326,-2351
2020,7,31,20,8542,10962,8583,-2379
2020,7,31,21,8479,11129,8714,-2415
2020,7,31,22,8224,11151,8820,-2331
2020,7,31,23,7813,10873,8624,-2249
2020,8,1,0,7325,10226,7885,-2341
2020,8,1,1,6961,9726,7433,-2293
2020,8,1,2,6637,9178,6820,-2358
2020,8,1,3,6143,8387,6102,-2285
2020,8,1,4,5597,7598,5611,-1987
2020,8,1,5,5269,6959,5258,-1701
2020,8,1,6,4872,6383,4775,-1608
2020,8,1,7,4573,5960,4466,-1494
2020,8,1,8,4373,5647,4220,-1427
2020,8,1,9,4244,5484,4097,-1387
2020,8,1,10,4228,5422,4048,-1374
2020,8,1,11,4239,5465,4084,-1381
2020,8,1,12,4367,5609,4299,-1310
2020,8,1,13,4910,6248,4669,-1579
2020,8,1,14,5552,7134,5135,-1999
2020,8,1,15,6251,8017,5734,-2283
2020,8,1,16,6890,8948,6649,-2299
2020,8,1,17,7406,9779,7549,-2230
2020,8,1,18,7810,10335,8035,-2300
2020,8,1,19,8032,10734,8330,-2404
2020,8,1,20,8159,10967,8571,-2396
2020,8,1,21,8149,11126,8674,-2452
2020,8,1,22,8048,11045,8566,-2479
2020,8,1,23,7761,10738,8337,-2401
2020,8,2,0,7323,10168,7846,-2322
2020,8,2,1,6966,9660,7295,-2365
2020,8,2,2,6567,9124,6847,-2277
2020,8,2,3,6061,8341,6161,-2180
2020,8,2,4,5519,7527,5476,-2051
2020,8,2,5,5348,7083,5362,-1721
2020,8,2,6,4917,6536,4994,-1542
2020,8,2,7,4574,6147,4676,-1471
2020,8,2,8,4372,5885,4470,-1415
2020,8,2,9,4231,5717,4351,-1366
2020,8,2,10,4213,5638,4294,-1344
2020,8,2,11,4193,5644,4283,-1361
2020,8,2,12,4326,5775,4463,-1312
2020,8,2,13,4865,6471,4882,-1589
2020,8,2,14,5463,7339,5362,-1977
2020,8,2,15,6101,8035,5905,-2130
2020,8,2,16,6620,8657,6608,-2049
2020,8,2,17,6855,9025,7199,-1826
2020,8,2,18,7151,9071,7192,-1879
2020,8,2,19,7265,9178,7104,-2074
2020,8,2,20,7254,9545,7543,-2002
2020,8,2,21,7165,9787,7817,-1970
2020,8,2,22,7099,9911,7763,-2148
2020,8,2,23,7022,9791,7672,-2119
2020,8,3,0,6672,9365,7233,-2132
2020,8,3,1,6394,8867,6706,-2161
2020,8,3,2,6108,8369,6205,-2164
2020,8,3,3,5632,7608,5496,-2112
2020,8,3,4,5132,6876,4977,-1899
2020,8,3,5,4693,6078,4490,-1588
2020,8,3,6,4375,5646,4178,-1468
2020,8,3,7,4174,5351,3945,-1406
2020,8,3,8,4046,5169,3796,-1373
2020,8,3,9,4018,5119,3758,-1361
2020,8,3,10,4142,5289,3895,-1394
2020,8,3,11,4426,5529,4104,-1425
2020,8,3,12,4677,5815,4508,-1307
2020,8,3,13,5116,6308,4761,-1547
2020,8,3,14,5716,7023,5117,-1906
2020,8,3,15,6376,7831,5541,-2290
2020,8,3,16,7060,8741,6360,-2381
2020,8,3,17,7572,9541,7258,-2283
2020,8,3,18,8034,10210,7988,-2222
2020,8,3,19,8292,10614,8283,-2331
2020,8,3,20,8392,10922,8567,-2355
2020,8,3,21,8383,11147,8743,-2404
2020,8,3,22,8253,11226,8795,-2431
2020,8,3,23,7964,11006,8557,-2449
2020,8,4,0,7533,10461,8227,-2234
2020,8,4,1,7194,9899,7776,-2123
2020,8,4,2,6756,9305,7149,-2156
2020,8,4,3,6164,8443,6258,-2185
2020,8,4,4,5578,7607,5401,-2206
2020,8,4,5,5159,6977,5095,-1882
2020,8,4,6,4797,6373,4716,-1657
2020,8,4,7,4526,5960,4366,-1594
2020,8,4,8,4374,5713,4184,-1529
2020,8,4,9,4324,5599,4097,-1502
2020,8,4,10,4434,5708,4182,-1526
2020,8,4,11,4674,5946,4380,-1566
2020,8,4,12,4881,6179,4660,-1519
2020,8,4,13,5328,6765,5074,-1691
2020,8,4,14,5902,7651,5685,-1966
2020,8,4,15,6601,8618,6410,-2208
2020,8,4,16,7241,9543,7222,-2321
2020,8,4,17,7770,10263,8006,-2257
2020,8,4,18,8231,10772,8497,-2275
2020,8,4,19,8496,11072,8725,-2347
2020,8,4,20,8603,11277,8810,-2467
2020,8,4,21,8544,11160,8674,-2486
2020,8,4,22,8368,10686,8217,-2469
2020,8,4,23,8028,10119,7855,-2264
2020,8,5,0,7569,9502,7233,-2269
2020,8,5,1,7209,8996,6728,-2268
2020,8,5,2,6790,8442,6190,-2252
2020,8,5,3,6189,7641,5433,-2208
2020,8,5,4,5537,6871,4967,-1904
2020,8,5,5,5217,6463,4911,-1552
2020,8,5,6,4848,5987,4561,-1426
2020,8,5,7,4564,5647,4296,-1351
2020,8,5,8,4409,5422,4127,-1295
2020,8,5,9,4364,5361,4090,-1271
2020,8,5,10,4473,5497,4208,-1289
2020,8,5,11,4687,5782,4439,-1343
2020,8,5,12,4880,6087,4705,-1382
2020,8,5,13,5321,6628,5054,-1574
2020,8,5,14,5887,7450,5537,-1913
2020,8,5,15,6584,8333,6030,-2303
2020,8,5,16,7144,9303,7007,-2296
2020,8,5,17,7584,10060,7887,-2173
2020,8,5,18,8008,10665,8436,-2229
2020,8,5,19,8268,10804,8557,-2247
2020,8,5,20,8313,10406,8184,-2222
2020,8,5,21,8276,9942,7827,-2115
2020,8,5,22,8097,9637,7621,-2016
2020,8,5,23,7794,9406,7281,-2125
2020,8,6,0,7358,9061,6898,-2163
2020,8,6,1,7021,8730,6650,-2080
2020,8,6,2,6637,8301,5999,-2302
2020,8,6,3,6046,7616,5418,-2198
2020,8,6,4,5442,6931,5022,-1909
2020,8,6,5,5047,6128,4504,-1624
2020,8,6,6,4687,5707,4237,-1470
2020,8,6,7,4416,5372,3978,-1394
2020,8,6,8,4266,5160,3789,-1371
2020,8,6,9,4214,5083,3758,-1325
2020,8,6,10,4327,5179,3831,-1348
2020,8,6,11,4561,5437,4043,-1394
2020,8,6,12,4760,5706,4397,-1309
2020,8,6,13,5192,6264,4721,-1543
2020,8,6,14,5729,7026,5224,-1802
2020,8,6,15,6391,7868,5820,-2048
2020,8,6,16,7022,8695,6676,-2019
2020,8,6,17,7529,9414,7314,-2100
2020,8,6,18,7955,9991,7778,-2213
2020,8,6,19,8246,10444,8152,-2292
2020,8,6,20,8368,10707,8482,-2225
2020,8,6,21,8354,10726,8549,-2177
2020,8,6,22,8038,10495,8385,-2110
2020,8,6,23,7687,10037,7870,-2167
2020,8,7,0,7255,9370,7318,-2052
2020,8,7,1,6931,8756,6691,-2065
2020,8,7,2,6545,8226,6074,-2152
2020,8,7,3,5944,7507,5400,-2107
2020,8,7,4,5390,6765,4840,-1925
2020,8,7,5,4808,6154,4609,-1545
2020,8,7,6,4471,5705,4280,-1425
2020,8,7,7,4237,5379,4049,-1330
2020,8,7,8,4093,5174,3871,-1303
2020,8,7,9,4052,5111,3830,-1281
2020,8,7,10,4162,5212,3921,-1291
2020,8,7,11,4398,5474,4108,-1366
2020,8,7,12,4614,5760,4358,-1402
2020,8,7,13,5053,6348,4804,-1544
2020,8,7,14,5600,7192,5284,-1908
2020,8,7,15,6239,8171,6120,-2051
2020,8,7,16,6830,9091,7093,-1998
2020,8,7,17,7390,9861,7836,-2025
2020,8,7,18,7826,10358,8418,-1940
2020,8,7,19,8059,10551,8732,-1819
2020,8,7,20,8135,10489,8765,-1724
2020,8,7,21,8063,10310,8701,-1609
2020,8,7,22,7840,9728,8102,-1626
2020,8,7,23,7485,9292,7588,-1704
2020,8,8,0,7048,8849,7029,-1820
2020,8,8,1,6737,8406,6418,-1988
2020,8,8,2,6412,7952,5899,-2053
2020,8,8,3,5946,7300,5261,-2039
2020,8,8,4,5448,6652,4814,-1838
2020,8,8,5,5187,6106,4569,-1537
2020,8,8,6,4824,5632,4202,-1430
2020,8,8,7,4535,5310,3955,-1355
2020,8,8,8,4354,5065,3764,-1301
2020,8,8,9,4258,4959,3718,-1241
2020,8,8,10,4239,4924,3645,-1279
2020,8,8,11,4273,4955,3676,-1279
2020,8,8,12,4395,5129,3890,-1239
2020,8,8,13,4939,5799,4494,-1305
2020,8,8,14,5586,6673,5102,-1571
2020,8,8,15,6280,7635,5951,-1684
2020,8,8,16,6893,8610,6924,-1686
2020,8,8,17,7387,9478,7594,-1884
2020,8,8,18,7765,10101,7948,-2153
2020,8,8,19,7988,10491,8295,-2196
2020,8,8,20,8090,10711,8499,-2212
2020,8,8,21,8157,10819,8613,-2206
2020,8,8,22,8089,10825,8628,-2197
2020,8,8,23,7840,10511,8293,-2218
2020,8,9,0,7420,9916,7662,-2254
2020,8,9,1,7052,9366,7108,-2258
2020,8,9,2,6624,8793,6452,-2341
2020,8,9,3,6108,8046,5838,-2208
2020,8,9,4,5606,7358,5350,-2008
2020,8,9,5,5117,6723,5005,-1718
2020,8,9,6,4734,6180,4578,-1602
2020,8,9,7,4457,5793,4308,-1485
2020,8,9,8,4273,5520,4099,-1421
2020,8,9,9,4151,5347,3960,-1387
2020,8,9,10,4111,5248,3889,-1359
2020,8,9,11,4093,5223,3863,-1360
2020,8,9,12,4213,5368,4069,-1299
2020,8,9,13,4785,6072,4514,-1558
2020,8,9,14,5523,7043,5030,-2013
2020,8,9,15,6284,8062,5829,-2233
2020,8,9,16,6918,9036,6766,-2270
2020,8,9,17,7548,9883,7557,-2326
2020,8,9,18,8035,10386,8159,-2227
2020,8,9,19,8365,10572,8311,-2261
2020,8,9,20,8528,10688,8382,-2306
2020,8,9,21,8549,10637,8369,-2268
2020,8,9,22,8435,10114,7951,-2163
2020,8,9,23,8141,9342,7292,-2050
2020,8,10,0,7671,8660,6553,-2107
2020,8,10,1,7312,8188,5988,-2200
2020,8,10,2,6913,7682,5405,-2277
2020,8,10,3,6319,7021,4913,-2108
2020,8,10,4,5729,6366,4487,-1879
2020,8,10,5,5208,5845,4266,-1579
2020,8,10,6,4819,5428,3956,-1472
2020,8,10,7,4536,5158,3775,-1383
2020,8,10,8,4373,4977,3624,-1353
2020,8,10,9,4300,4948,3595,-1353
2020,8,10,10,4423,5048,3708,-1340
2020,8,10,11,4648,5368,3970,-1398
2020,8,10,12,4866,5667,4331,-1336
2020,8,10,13,5357,6277,4698,-1579
2020,8,10,14,5949,7049,5115,-1934
2020,8,10,15,6647,7968,5820,-2148
2020,8,10,16,7397,8965,6679,-2286
2020,8,10,17,8012,9861,7522,-2339
2020,8,10,18,8504,10467,8121,-2346
2020,8,10,19,8823,10859,8559,-2300
2020,8,10,20,8948,11027,8737,-2290
2020,8,10,21,8925,11036,8757,-2279
2020,8,10,22,8664,10823,8588,-2235
2020,8,10,23,8332,10486,8275,-2211
2020,8,11,0,7874,9890,7669,-2221
2020,8,11,1,7465,9341,7101,-2240
2020,8,11,2,7016,8650,6352,-2298
2020,8,11,3,6377,7832,5605,-2227
2020,8,11,4,5726,7055,5077,-1978
2020,8,11,5,5143,6401,4884,-1517
2020,8,11,6,4751,5861,4475,-1386
2020,8,11,7,4486,5533,4234,-1299
2020,8,11,8,4328,5337,4073,-1264
2020,8,11,9,4256,5274,4013,-1261
2020,8,11,10,4365,5370,4094,-1276
2020,8,11,11,4604,5661,4323,-1338
2020,8,11,12,4805,5881,4503,-1378
2020,8,11,13,5227,6419,4830,-1589
2020,8,11,14,5757,7178,5230,-1948
2020,8,11,15,6470,8044,5981,-2063
2020,8,11,16,7116,8832,6813,-2019
2020,8,11,17,7666,9367,7447,-1920
2020,8,11,18,8137,9838,7806,-2032
2020,8,11,19,8398,10106,8028,-2078
2020,8,11,20,8475,10133,8155,-1978
2020,8,11,21,8378,9856,7892,-1964
2020,8,11,22,8084,9465,7445,-2020
2020,8,11,23,7726,9093,7038,-2055
2020,8,12,0,7300,8585,6615,-1970
2020,8,12,1,6979,8288,6182,-2106
2020,8,12,2,6562,7787,5782,-2005
2020,8,12,3,5952,7042,5035,-2007
2020,8,12,4,5385,6368,4695,-1673
2020,8,12,5,5078,5805,4409,-1396
2020,8,12,6,4706,5386,4110,-1276
2020,8,12,7,4457,5108,3902,-1206
2020,8,12,8,4290,4931,3769,-1162
2020,8,12,9,4237,4895,3747,-1148
2020,8,12,10,4353,5030,3832,-1198
2020,8,12,11,4574,5328,4075,-1253
2020,8,12,12,4766,5591,4312,-1279
2020,8,12,13,5185,6078,4602,-1476
2020,8,12,14,5710,6742,4945,-1797
2020,8,12,15,6356,7552,5493,-2059
2020,8,12,16,7050,8363,6284,-2079
2020,8,12,17,7503,9109,6994,-2115
2020,8,12,18,7956,9658,7456,-2202
2020,8,12,19,8212,10052,7780,-2272
2020,8,12,20,8343,10226,7896,-2330
2020,8,12,21,8341,10065,7776,-2289
2020,8,12,22,8152,9860,7597,-2263
2020,8,12,23,7863,9474,7367,-2107
2020,8,13,0,7383,8946,6819,-2127
2020,8,13,1,7048,8567,6356,-2211
2020,8,13,2,6629,8034,5774,-2260
2020,8,13,3,6046,7344,5217,-2127
2020,8,13,4,5456,6649,4848,-1801
2020,8,13,5,4951,6121,4613,-1508
2020,8,13,6,4592,5665,4317,-1348
2020,8,13,7,4353,5368,4046,-1322
2020,8,13,8,4197,5192,3938,-1254
2020,8,13,9,4147,5170,3920,-1250
2020,8,13,10,4264,5299,4031,-1268
2020,8,13,11,4508,5635,4297,-1338
2020,8,13,12,4715,5924,4578,-1346
2020,8,13,13,5132,6426,4888,-1538
2020,8,13,14,5719,7244,5312,-1932
2020,8,13,15,6363,8136,5927,-2209
2020,8,13,16,7067,8994,6711,-2283
2020,8,13,17,7625,9666,7394,-2272
2020,8,13,18,8082,9942,7720,-2222
2020,8,13,19,8378,10187,7991,-2196
2020,8,13,20,8540,10271,8120,-2151
2020,8,13,21,8549,10124,7992,-2132
2020,8,13,22,8345,9740,7631,-2109
2020,8,13,23,7980,9377,7329,-2048
2020,8,14,0,7550,8893,6713,-2180
2020,8,14,1,7184,8586,6419,-2167
2020,8,14,2,6769,8102,5930,-2172
2020,8,14,3,6177,7352,5221,-2131
2020,8,14,4,5594,6633,4882,-1751
2020,8,14,5,5039,6285,4826,-1459
2020,8,14,6,4675,5878,4534,-1344
2020,8,14,7,4430,5611,4344,-1267
2020,8,14,8,4252,5444,4207,-1237
2020,8,14,9,4192,5387,4164,-1223
2020,8,14,10,4296,5517,4259,-1258
2020,8,14,11,4558,5798,4489,-1309
2020,8,14,12,4752,6075,4723,-1352
2020,8,14,13,5196,6697,5128,-1569
2020,8,14,14,5892,7543,5581,-1962
2020,8,14,15,6578,8466,6251,-2215
2020,8,14,16,7233,9357,7119,-2238
2020,8,14,17,7790,10031,7762,-2269
2020,8,14,18,8255,10282,8130,-2152
2020,8,14,19,8565,10425,8184,-2241
2020,8,14,20,8729,10574,8200,-2374
2020,8,14,21,8684,10651,8254,-2397
2020,8,14,22,8429,10403,8031,-2372
2020,8,14,23,8022,9907,7613,-2294
2020,8,15,0,7477,9360,7099,-2261
2020,8,15,1,7106,8916,6726,-2190
2020,8,15,2,6740,8372,6163,-2209
2020,8,15,3,6198,7714,5544,-2170
2020,8,15,4,5677,7093,5246,-1847
2020,8,15,5,5159,6366,4882,-1484
2020,8,15,6,4772,5957,4574,-1383
2020,8,15,7,4508,5618,4312,-1306
2020,8,15,8,4328,5369,4135,-1234
2020,8,15,9,4212,5243,4022,-1221
2020,8,15,10,4197,5196,4014,-1182
2020,8,15,11,4247,5267,4050,-1217
2020,8,15,12,4372,5444,4196,-1248
2020,8,15,13,4865,6129,4631,-1498
2020,8,15,14,5537,7049,5142,-1907
2020,8,15,15,6229,7963,5885,-2078
2020,8,15,16,6853,8838,6817,-2021
2020,8,15,17,7358,9465,7403,-2062
2020,8,15,18,7747,9815,7635,-2180
2020,8,15,19,7988,9982,7849,-2133
2020,8,15,20,8074,10018,7898,-2120
2020,8,15,21,8153,9930,7820,-2110
2020,8,15,22,8045,9681,7589,-2092
2020,8,15,23,7710,9306,7281,-2025
2020,8,16,0,7266,8887,6844,-2043
2020,8,16,1,6952,8553,6324,-2229
2020,8,16,2,6558,8060,5827,-2233
2020,8,16,3,6069,7458,5339,-2119
2020,8,16,4,5590,6840,5053,-1787
2020,8,16,5,5021,6315,4834,-1481
2020,8,16,6,4643,5937,4543,-1394
2020,8,16,7,4375,5630,4320,-1310
2020,8,16,8,4194,5408,4124,-1284
2020,8,16,9,4075,5252,4004,-1248
2020,8,16,10,4047,5227,3994,-1233
2020,8,16,11,4053,5267,4024,-1243
2020,8,16,12,4174,5411,4102,-1309
2020,8,16,13,4730,6068,4503,-1565
2020,8,16,14,5379,6981,5071,-1910
2020,8,16,15,6110,7928,5753,-2175
2020,8,16,16,6647,8744,6668,-2076
2020,8,16,17,7121,9436,7382,-2054
2020,8,16,18,7466,9803,7796,-2007
2020,8,16,19,7758,9956,7906,-2050
2020,8,16,20,7955,9931,7805,-2126
2020,8,16,21,7946,9825,7643,-2182
2020,8,16,22,7746,9657,7542,-2115
2020,8,16,23,7452,9323,7206,-2117
2020,8,17,0,7122,8899,6735,-2164
2020,8,17,1,6871,8558,6272,-2286
2020,8,17,2,6467,8064,5801,-2263
2020,8,17,3,5939,7365,5173,-2192
2020,8,17,4,5388,6691,4889,-1802
2020,8,17,5,4821,6147,4644,-1503
2020,8,17,6,4482,5714,4325,-1389
2020,8,17,7,4246,5446,4117,-1329
2020,8,17,8,4117,5279,3995,-1284
2020,8,17,9,4094,5230,3957,-1273
2020,8,17,10,4244,5375,4088,-1287
2020,8,17,11,4558,5713,4373,-1340
2020,8,17,12,4771,5997,4618,-1379
2020,8,17,13,5213,6548,4979,-1569
2020,8,17,14,5712,7336,5371,-1965
2020,8,17,15,6360,8130,5963,-2167
2020,8,17,16,6967,8659,6660,-1999
2020,8,17,17,7398,8947,7050,-1897
2020,8,17,18,7750,9056,7342,-1714
2020,8,17,19,7992,8554,6843,-1711
2020,8,17,20,8098,8239,6489,-1750
2020,8,17,21,8035,8156,6397,-1759
2020,8,17,22,7700,8247,6425,-1822
2020,8,17,23,7310,8151,6352,-1799
2020,8,18,0,6953,7899,6133,-1766
2020,8,18,1,6694,7780,5866,-1914
2020,8,18,2,6286,7410,5498,-1912
2020,8,18,3,5702,6782,4879,-1903
2020,8,18,4,5118,6165,4567,-1598
2020,8,18,5,4834,5714,4407,-1307
2020,8,18,6,4487,5329,4110,-1219
2020,8,18,7,4259,5052,3890,-1162
2020,8,18,8,4123,4916,3778,-1138
2020,8,18,9,4088,4891,3766,-1125
2020,8,18,10,4221,5057,3881,-1176
2020,8,18,11,4523,5421,4173,-1248
2020,8,18,12,4724,5679,4367,-1312
2020,8,18,13,5102,6178,4674,-1504
2020,8,18,14,5657,6908,5042,-1866
2020,8,18,15,6337,7821,5624,-2197
2020,8,18,16,6948,8696,6578,-2118
2020,8,18,17,7502,9264,7180,-2084
2020,8,18,18,7943,9658,7547,-2111
2020,8,18,19,8228,9589,7580,-2009
2020,8,18,20,8342,9038,7241,-1797
2020,8,18,21,8328,8682,6770,-1912
2020,8,18,22,8127,8592,6695,-1897
2020,8,18,23,7784,8365,6446,-1919
2020,8,19,0,7355,8005,6018,-1987
2020,8,19,1,7023,7718,5603,-2115
2020,8,19,2,6601,7285,5173,-2112
2020,8,19,3,6002,6664,4722,-1942
2020,8,19,4,5393,6049,4476,-1573
2020,8,19,5,4722,5576,4162,-1414
2020,8,19,6,4390,5151,3835,-1316
2020,8,19,7,4152,4882,3631,-1251
2020,8,19,8,4010,4762,3525,-1237
2020,8,19,9,3973,4767,3539,-1228
2020,8,19,10,4079,4918,3661,-1257
2020,8,19,11,4277,5273,3938,-1335
2020,8,19,12,4478,5561,4271,-1290
2020,8,19,13,4824,5904,4490,-1414
2020,8,19,14,5372,6334,4628,-1706
2020,8,19,15,5964,6761,4805,-1956
2020,8,19,16,6538,7257,5065,-2192
2020,8,19,17,7094,7939,5688,-2251
2020,8,19,18,7517,8528,6110,-2418
2020,8,19,19,7731,8824,6489,-2335
2020,8,19,20,7797,8899,6748,-2151
2020,8,19,21,7704,8987,6836,-2151
2020,8,19,22,7506,9048,6728,-2320
2020,8,19,23,7280,9019,6670,-2349
2020,8,20,0,6938,8623,6259,-2364
2020,8,20,1,6666,8231,5976,-2255
2020,8,20,2,6280,7617,5463,-2154
2020,8,20,3,5746,6905,4967,-1938
2020,8,20,4,5144,6145,4444,-1701
2020,8,20,5,4583,5597,4186,-1411
2020,8,20,6,4279,5218,3890,-1328
2020,8,20,7,4068,5000,3721,-1279
2020,8,20,8,3941,4814,3558,-1256
2020,8,20,9,3916,4795,3557,-1238
2020,8,20,10,4032,4959,3677,-1282
2020,8,20,11,4235,5304,3965,-1339
2020,8,20,12,4436,5580,4304,-1276
2020,8,20,13,4790,6055,4586,-1469
2020,8,20,14,5342,6657,4868,-1789
2020,8,20,15,5937,7457,5351,-2106
2020,8,20,16,6507,8226,5933,-2293
2020,8,20,17,6906,8871,6540,-2331
2020,8,20,18,7287,9216,6906,-2310
2020,8,20,19,7467,9415,7190,-2225
2020,8,20,20,7530,9328,7084,-2244
2020,8,20,21,7464,9450,7145,-2305
2020,8,20,22,7287,9265,7143,-2122
2020,8,20,23,7041,8493,6384,-2109
2020,8,21,0,6708,7902,5756,-2146
2020,8,21,1,6404,7595,5349,-2246
2020,8,21,2,6026,7106,5004,-2102
2020,8,21,3,5457,6439,4545,-1894
2020,8,21,4,4937,5891,4238,-1653
2020,8,21,5,4582,5398,4001,-1397
2020,8,21,6,4260,5014,3695,-1319
2020,8,21,7,4032,4827,3532,-1295
2020,8,21,8,3898,4685,3422,-1263
2020,8,21,9,3864,4655,3390,-1265
2020,8,21,10,3976,4826,3535,-1291
2020,8,21,11,4141,5243,3860,-1383
2020,8,21,12,4332,5511,4227,-1284
2020,8,21,13,4679,5825,4408,-1417
2020,8,21,14,5135,6306,4571,-1735
2020,8,21,15,5614,6966,4930,-2036
2020,8,21,16,6086,7700,5551,-2149
2020,8,21,17,6404,8395,6229,-2166
2020,8,21,18,6710,8785,6696,-2089
2020,8,21,19,6933,8902,6914,-1988
2020,8,21,20,6990,8692,6879,-1813
2020,8,21,21,6890,8117,6369,-1748
2020,8,21,22,6678,7781,5847,-1934
2020,8,21,23,6521,7415,5449,-1966
2020,8,22,0,6181,7061,5025,-2036
2020,8,22,1,5916,6940,4893,-2047
2020,8,22,2,5620,6682,4711,-1971
2020,8,22,3,5179,6274,4466,-1808
2020,8,22,4,4781,5849,4216,-1633
2020,8,22,5,4511,5433,4058,-1375
2020,8,22,6,4227,5079,3765,-1314
2020,8,22,7,4000,4839,3575,-1264
2020,8,22,8,3855,4675,3457,-1218
2020,8,22,9,3785,4622,3406,-1216
2020,8,22,10,3787,4661,3438,-1223
2020,8,22,11,3831,4821,3554,-1267
2020,8,22,12,3951,4995,3786,-1209
2020,8,22,13,4381,5422,4049,-1373
2020,8,22,14,5122,6031,4320,-1711
2020,8,22,15,5775,6616,4650,-1966
2020,8,22,16,6361,7175,5090,-2085
2020,8,22,17,6799,7780,5762,-2018
2020,8,22,18,7202,8413,6389,-2024
2020,8,22,19,7471,8734,6535,-2199
2020,8,22,20,7609,8650,6453,-2197
2020,8,22,21,7646,8378,6267,-2111
2020,8,22,22,7549,8041,5998,-2043
2020,8,22,23,7305,7626,5625,-2001
2020,8,23,0,6926,7292,5286,-2006
2020,8,23,1,6640,7100,5006,-2094
2020,8,23,2,6208,6661,4706,-1955
2020,8,23,3,5765,6176,4381,-1795
2020,8,23,4,5313,5722,4086,-1636
2020,8,23,5,4390,5387,4000,-1387
2020,8,23,6,4118,5074,3742,-1332
2020,8,23,7,3922,4789,3529,-1260
2020,8,23,8,3785,4633,3390,-1243
2020,8,23,9,3723,4575,3341,-1234
2020,8,23,10,3696,4620,3389,-1231
2020,8,23,11,3732,4714,3459,-1255
2020,8,23,12,3834,4937,3734,-1203
2020,8,23,13,4275,5595,4162,-1433
2020,8,23,14,4942,6487,4675,-1812
2020,8,23,15,5583,7446,5228,-2218
2020,8,23,16,6150,8329,6056,-2273
2020,8,23,17,6754,9125,6999,-2126
2020,8,23,18,7101,9741,7651,-2090
2020,8,23,19,7397,10108,7968,-2140
2020,8,23,20,7525,10169,8037,-2132
2020,8,23,21,7491,10165,8034,-2131
2020,8,23,22,7200,9917,7798,-2119
2020,8,23,23,6844,9420,7369,-2051
2020,8,24,0,6590,8957,6866,-2091
2020,8,24,1,6382,8740,6461,-2279
2020,8,24,2,5968,8249,5945,-2304
2020,8,24,3,5524,7582,5374,-2208
2020,8,24,4,5096,6969,5003,-1966
2020,8,24,5,4881,6443,4739,-1704
2020,8,24,6,4583,6069,4475,-1594
2020,8,24,7,4381,5810,4278,-1532
2020,8,24,8,4263,5635,4134,-1501
2020,8,24,9,4253,5609,4115,-1494
2020,8,24,10,4423,5743,4230,-1513
2020,8,24,11,4726,6073,4485,-1588
2020,8,24,12,4945,6321,4808,-1513
2020,8,24,13,5327,6863,5155,-1708
2020,8,24,14,5918,7670,5590,-2080
2020,8,24,15,6630,8468,6291,-2177
2020,8,24,16,7214,9211,7056,-2155
2020,8,24,17,7612,9873,7710,-2163
2020,8,24,18,7909,10241,8068,-2173
2020,8,24,19,8031,10331,8340,-1991
2020,8,24,20,7970,10386,8472,-1914
2020,8,24,21,7852,10247,8363,-1884
2020,8,24,22,7626,9911,8161,-1750
2020,8,24,23,7418,9451,7647,-1804
2020,8,25,0,7081,8992,7161,-1831
2020,8,25,1,6806,8730,6726,-2004
2020,8,25,2,6397,8180,6172,-2008
2020,8,25,3,5854,7469,5485,-1984
2020,8,25,4,5397,6781,4982,-1799
2020,8,25,5,5059,6316,4851,-1465
2020,8,25,6,4734,5974,4587,-1387
2020,8,25,7,4511,5784,4420,-1364
2020,8,25,8,4381,5670,4329,-1341
2020,8,25,9,4331,5668,4307,-1361
2020,8,25,10,4463,5851,4452,-1399
2020,8,25,11,4735,6195,4732,-1463
2020,8,25,12,4914,6436,4939,-1497
2020,8,25,13,5264,6874,5233,-1641
2020,8,25,14,5844,7548,5518,-2030
2020,8,25,15,6493,8356,6149,-2207
2020,8,25,16,7287,9193,7123,-2070
2020,8,25,17,7813,9928,7969,-1959
2020,8,25,18,8209,10544,8514,-2030
2020,8,25,19,8457,10979,8917,-2062
2020,8,25,20,8551,11246,9294,-1952
2020,8,25,21,8507,11415,9112,-2303
2020,8,25,22,8353,11368,9362,-2006
2020,8,25,23,8097,10925,9073,-1852
2020,8,26,0,7611,10223,8334,-1889
2020,8,26,1,7256,9764,7616,-2148
2020,8,26,2,6820,9033,6847,-2186
2020,8,26,3,6168,8250,6173,-2077
2020,8,26,4,5597,7486,5591,-1895
2020,8,26,5,5392,6876,5140,-1736
2020,8,26,6,5000,6400,4778,-1622
2020,8,26,7,4716,6047,4504,-1543
2020,8,26,8,4527,5784,4318,-1466
2020,8,26,9,4457,5718,4261,-1457
2020,8,26,10,4550,5852,4348,-1504
2020,8,26,11,4745,6189,4616,-1573
2020,8,26,12,4925,6431,4920,-1511
2020,8,26,13,5252,6929,5266,-1663
2020,8,26,14,5903,7660,5616,-2044
2020,8,26,15,6534,8462,6243,-2219
2020,8,26,16,7303,9328,7194,-2134
2020,8,26,17,7889,10094,8086,-2008
2020,8,26,18,8337,10578,8492,-2086
2020,8,26,19,8613,10969,8712,-2257
2020,8,26,20,8772,11284,9125,-2159
2020,8,26,21,8769,11277,9129,-2148
2020,8,26,22,8598,11088,8895,-2193
2020,8,26,23,8236,10659,8493,-2166
2020,8,27,0,7796,10059,7987,-2072
2020,8,27,1,7443,9631,7529,-2102
2020,8,27,2,7030,8952,6799,-2153
2020,8,27,3,6309,8095,6010,-2085
2020,8,27,4,5720,7293,5255,-2038
2020,8,27,5,5221,6726,5010,-1716
2020,8,27,6,4859,6253,4671,-1582
2020,8,27,7,4596,5937,4438,-1499
2020,8,27,8,4413,5769,4308,-1461
2020,8,27,9,4353,5740,4291,-1449
2020,8,27,10,4467,5867,4397,-1470
2020,8,27,11,4694,6183,4630,-1553
2020,8,27,12,4850,6389,4883,-1506
2020,8,27,13,5190,6835,5153,-1682
2020,8,27,14,5774,7602,5535,-2067
2020,8,27,15,6385,8443,6288,-2155
2020,8,27,16,7059,9233,7241,-1992
2020,8,27,17,7616,9945,7913,-2032
2020,8,27,18,8085,10359,8338,-2021
2020,8,27,19,8334,10555,8438,-2117
2020,8,27,20,8454,10578,8507,-2071
2020,8,27,21,8410,10451,8258,-2193
2020,8,27,22,8243,10291,8150,-2141
2020,8,27,23,7948,9945,7915,-2030
2020,8,28,0,7527,9442,7449,-1993
2020,8,28,1,7150,9158,7018,-2140
2020,8,28,2,6677,8512,6347,-2165
2020,8,28,3,6086,7724,5614,-2110
2020,8,28,4,5521,7008,5119,-1889
2020,8,28,5,5140,6435,4815,-1620
2020,8,28,6,4765,6000,4477,-1523
2020,8,28,7,4503,5676,4222,-1454
2020,8,28,8,4335,5488,4082,-1406
2020,8,28,9,4274,5431,4033,-1398
2020,8,28,10,4352,5594,4158,-1436
2020,8,28,11,4555,5920,4431,-1489
2020,8,28,12,4736,6170,4726,-1444
2020,8,28,13,5096,6561,4978,-1583
2020,8,28,14,5713,7321,5343,-1978
2020,8,28,15,6333,8237,6012,-2225
2020,8,28,16,6949,9115,6829,-2286
2020,8,28,17,7515,9876,7720,-2156
2020,8,28,18,7920,10440,8279,-2161
2020,8,28,19,8256,10794,8657,-2137
2020,8,28,20,8381,11002,8761,-2241
2020,8,28,21,8287,11019,8887,-2132
2020,8,28,22,8076,10825,8682,-2143
2020,8,28,23,7711,10268,8061,-2207
2020,8,29,0,7274,9688,7415,-2273
2020,8,29,1,6951,9310,7088,-2222
2020,8,29,2,6573,8703,6471,-2232
2020,8,29,3,6043,8026,5857,-2169
2020,8,29,4,5561,7309,5362,-1947
2020,8,29,5,5099,6791,5086,-1705
2020,8,29,6,4742,6330,4763,-1567
2020,8,29,7,4496,5998,4506,-1492
2020,8,29,8,4318,5744,4314,-1430
2020,8,29,9,4213,5645,4233,-1412
2020,8,29,10,4199,5633,4206,-1427
2020,8,29,11,4268,5719,4277,-1442
2020,8,29,12,4374,5873,4495,-1378
2020,8,29,13,4836,6451,4839,-1612
2020,8,29,14,5446,7266,5268,-1998
2020,8,29,15,6135,8123,5803,-2320
2020,8,29,16,6832,8825,6536,-2289
2020,8,29,17,7274,9326,7053,-2273
2020,8,29,18,7659,9746,7432,-2314
2020,8,29,19,7866,10035,7752,-2283
2020,8,29,20,7941,10236,7987,-2249
2020,8,29,21,7920,9813,7681,-2132
2020,8,29,22,7746,9276,7181,-2095
2020,8,29,23,7468,8824,6665,-2159
2020,8,30,0,7109,8440,6190,-2250
2020,8,30,1,6811,8098,5830,-2268
2020,8,30,2,6352,7568,5424,-2144
2020,8,30,3,5886,7006,5003,-2003
2020,8,30,4,5436,6465,4659,-1806
2020,8,30,5,4960,6029,4509,-1520
2020,8,30,6,4612,5614,4169,-1445
2020,8,30,7,4392,5325,3952,-1373
2020,8,30,8,4207,5115,3780,-1335
2020,8,30,9,4097,5042,3695,-1347
2020,8,30,10,4018,5010,3675,-1335
2020,8,30,11,3992,5085,3741,-1344
2020,8,30,12,4039,5216,3957,-1259
2020,8,30,13,4430,5669,4221,-1448
2020,8,30,14,4950,6230,4434,-1796
2020,8,30,15,5560,6812,4853,-1959
2020,8,30,16,6108,7338,5107,-2231
2020,8,30,17,6593,7882,5545,-2337
2020,8,30,18,6903,8139,5758,-2381
2020,8,30,19,7125,8176,5946,-2230
2020,8,30,20,7264,7963,5767,-2196
2020,8,30,21,7214,7809,5645,-2164
2020,8,30,22,7024,7537,5401,-2136
2020,8,30,23,6662,7299,5102,-2197
2020,8,31,0,6375,7058,4834,-2224
2020,8,31,1,6180,7000,4789,-2211
2020,8,31,2,5753,6632,4558,-2074
2020,8,31,3,5300,6085,4235,-1850
2020,8,31,4,4889,5582,3933,-1649
2020,8,31,5,4387,5157,3780,-1377
2020,8,31,6,4125,4877,3565,-1312
2020,8,31,7,3924,4680,3414,-1266
2020,8,31,8,3791,4596,3352,-1244
2020,8,31,9,3783,4682,3416,-1266
2020,8,31,10,3951,4968,3659,-1309
2020,8,31,11,4212,5434,4023,-1411
2020,8,31,12,4425,5734,4373,-1361
2020,8,31,13,4766,6165,4632,-1533
2020,8,31,14,5322,6796,4968,-1828
2020,8,31,15,5855,7576,5518,-2058
2020,8,31,16,6445,8174,6028,-2146
2020,8,31,17,6944,8384,6350,-2034
2020,8,31,18,7306,8287,6365,-1922
2020,8,31,19,7557,8125,6146,-1979
2020,8,31,20,7656,7934,5847,-2087
2020,8,31,21,7599,7817,5750,-2067
2020,8,31,22,7473,7793,5715,-2078
2020,8,31,23,7248,7602,5554,-2048
2020,9,1,0,6894,7363,5172,-2191
2020,9,1,1,6626,7265,5117,-2148
2020,9,1,2,6142,6859,4812,-2047
2020,9,1,3,5623,6295,4387,-1908
2020,9,1,4,5072,5748,4065,-1683
2020,9,1,5,4320,5333,3908,-1425
2020,9,1,6,4035,5059,3697,-1362
2020,9,1,7,3900,4861,3539,-1322
2020,9,1,8,3786,4746,3451,-1295
2020,9,1,9,3763,4788,3482,-1306
2020,9,1,10,3918,4971,3623,-1348
2020,9,1,11,4220,5392,3973,-1419
2020,9,1,12,4424,5708,4334,-1374
2020,9,1,13,4744,6132,4603,-1529
2020,9,1,14,5246,6809,4954,-1855
2020,9,1,15,5847,7596,5417,-2179
2020,9,1,16,6501,8313,6027,-2286
2020,9,1,17,7046,8909,6732,-2177
2020,9,1,18,7421,9433,7308,-2125
2020,9,1,19,7685,9734,7561,-2173
2020,9,1,20,7826,9897,7755,-2142
2020,9,1,21,7785,10031,7812,-2219
2020,9,1,22,7672,10084,7772,-2312
2020,9,1,23,7393,9860,7503,-2357
2020,9,2,0,7035,9361,7210,-2151
2020,9,2,1,6793,8961,6784,-2177
2020,9,2,2,6311,8272,6056,-2216
2020,9,2,3,5782,7450,5339,-2111
2020,9,2,4,5252,6709,4806,-1903
2020,9,2,5,4708,6101,4530,-1571
2020,9,2,6,4392,5664,4202,-1462
2020,9,2,7,4197,5385,3988,-1397
2020,9,2,8,4041,5236,3896,-1340
2020,9,2,9,4001,5185,3829,-1356
2020,9,2,10,4142,5366,3975,-1391
2020,9,2,11,4490,5720,4257,-1463
2020,9,2,12,4698,5958,4543,-1415
2020,9,2,13,5009,6435,4884,-1551
2020,9,2,14,5534,7156,5240,-1916
2020,9,2,15,6160,8047,5735,-2312
2020,9,2,16,6726,9035,6794,-2241
2020,9,2,17,7327,9887,7653,-2234
2020,9,2,18,7721,10469,8286,-2183
2020,9,2,19,7970,10787,8581,-2206
2020,9,2,20,8168,10724,8509,-2215
2020,9,2,21,8211,10533,8323,-2210
2020,9,2,22,8042,10265,8114,-2151
2020,9,2,23,7705,9848,7722,-2126
2020,9,3,0,7318,9315,7206,-2109
2020,9,3,1,7079,8977,6701,-2276
2020,9,3,2,6588,8328,6004,-2324
2020,9,3,3,6004,7566,5360,-2206
2020,9,3,4,5425,6866,4886,-1980
2020,9,3,5,5069,6250,4591,-1659
2020,9,3,6,4692,5826,4279,-1547
2020,9,3,7,4433,5497,4032,-1465
2020,9,3,8,4257,5299,3901,-1398
2020,9,3,9,4179,5229,3852,-1377
2020,9,3,10,4277,5355,3965,-1390
2020,9,3,11,4544,5703,4218,-1485
2020,9,3,12,4748,5900,4480,-1420
2020,9,3,13,5080,6374,4922,-1452
2020,9,3,14,5593,7140,5331,-1809
2020,9,3,15,6339,8064,5896,-2168
2020,9,3,16,7000,9000,7029,-1971
2020,9,3,17,7607,9795,7909,-1886
2020,9,3,18,8010,10430,8357,-2073
2020,9,3,19,8282,10893,8867,-2026
2020,9,3,20,8472,11234,9131,-2103
2020,9,3,21,8519,11431,9154,-2277
2020,9,3,22,8365,11394,9116,-2278
2020,9,3,23,8038,11034,8944,-2090
2020,9,4,0,7637,10449,8372,-2077
2020,9,4,1,7356,10007,7793,-2214
2020,9,4,2,6838,9250,7135,-2115
2020,9,4,3,6200,8358,6331,-2027
2020,9,4,4,5620,7514,5625,-1889
2020,9,4,5,5180,6897,5156,-1741
2020,9,4,6,4812,6394,4787,-1607
2020,9,4,7,4571,6046,4519,-1527
2020,9,4,8,4386,5839,4365,-1474
2020,9,4,9,4289,5725,4288,-1437
2020,9,4,10,4383,5839,4383,-1456
2020,9,4,11,4591,6148,4612,-1536
2020,9,4,12,4781,6366,4897,-1469
2020,9,4,13,5175,6828,5167,-1661
2020,9,4,14,5756,7615,5561,-2054
2020,9,4,15,6416,8568,6313,-2255
2020,9,4,16,7053,9559,7424,-2135
2020,9,4,17,7687,10416,8110,-2306
2020,9,4,18,8115,10990,8648,-2342
2020,9,4,19,8407,11306,8912,-2394
2020,9,4,20,8516,11310,8937,-2373
2020,9,4,21,8498,11022,8697,-2325
2020,9,4,22,8348,10547,8161,-2386
2020,9,4,23,7970,9937,7686,-2251
2020,9,5,0,7461,9276,7018,-2258
2020,9,5,1,7143,8852,6628,-2224
2020,9,5,2,6713,8220,5972,-2248
2020,9,5,3,6161,7597,5395,-2202
2020,9,5,4,5660,6986,5000,-1986
2020,9,5,5,5288,6430,4761,-1669
2020,9,5,6,4913,6003,4424,-1579
2020,9,5,7,4654,5722,4216,-1506
2020,9,5,8,4428,5540,4086,-1454
2020,9,5,9,4294,5427,4008,-1419
2020,9,5,10,4255,5403,3979,-1424
2020,9,5,11,4312,5455,4046,-1409
2020,9,5,12,4360,5549,4249,-1300
2020,9,5,13,4842,6153,4579,-1574
2020,9,5,14,5526,7090,5077,-2013
2020,9,5,15,6145,8045,5706,-2339
2020,9,5,16,6766,8973,6662,-2311
2020,9,5,17,7276,9786,7487,-2299
2020,9,5,18,7696,10362,8031,-2331
2020,9,5,19,7948,10724,8310,-2414
2020,9,5,20,8000,10942,8485,-2457
2020,9,5,21,8015,10998,8519,-2479
2020,9,5,22,7876,10926,8420,-2506
2020,9,5,23,7562,10464,7993,-2471
2020,9,6,0,7166,9774,7461,-2313
2020,9,6,1,6875,9288,6931,-2357
2020,9,6,2,6404,8543,6215,-2328
2020,9,6,3,5901,7822,5543,-2279
2020,9,6,4,5431,7112,5043,-2069
2020,9,6,5,4934,6524,4806,-1718
2020,9,6,6,4581,6023,4456,-1567
2020,9,6,7,4301,5640,4156,-1484
2020,9,6,8,4109,5379,3981,-1398
2020,9,6,9,3976,5227,3827,-1400
2020,9,6,10,3900,5152,3786,-1366
2020,9,6,11,3868,5157,3792,-1365
2020,9,6,12,3911,5236,3957,-1279
2020,9,6,13,4344,5867,4313,-1554
2020,9,6,14,4999,6795,4830,-1965
2020,9,6,15,5714,7740,5563,-2177
2020,9,6,16,6352,8664,6500,-2164
2020,9,6,17,6952,9405,7085,-2320
2020,9,6,18,7442,9908,7589,-2319
2020,9,6,19,7694,10265,7854,-2411
2020,9,6,20,7779,10415,7893,-2522
2020,9,6,21,7867,10428,7866,-2562
2020,9,6,22,7757,10164,7740,-2424
2020,9,6,23,7449,9351,7087,-2264
2020,9,7,0,7048,8512,6101,-2411
2020,9,7,1,6696,7988,5573,-2415
2020,9,7,2,6232,7394,5141,-2253
2020,9,7,3,5721,6810,4745,-2065
2020,9,7,4,5219,6208,4332,-1876
2020,9,7,5,4670,5727,4164,-1563
2020,9,7,6,4334,5320,3860,-1460
2020,9,7,7,4074,5078,3673,-1405
2020,9,7,8,3930,4908,3538,-1370
2020,9,7,9,3841,4831,3484,-1347
2020,9,7,10,3830,4895,3569,-1326
2020,9,7,11,3848,5038,3680,-1358
2020,9,7,12,3879,5164,3917,-1247
2020,9,7,13,4240,5670,4173,-1497
2020,9,7,14,4842,6499,4621,-1878
2020,9,7,15,5543,7347,5080,-2267
2020,9,7,16,6080,8208,5812,-2396
2020,9,7,17,6612,8973,6620,-2353
2020,9,7,18,6958,9546,7205,-2341
2020,9,7,19,7191,9787,7418,-2369
2020,9,7,20,7344,9670,7392,-2278
2020,9,7,21,7260,9191,7010,-2181
2020,9,7,22,7191,8650,6508,-2142
2020,9,7,23,6848,8151,5916,-2235
2020,9,8,0,6549,7794,5513,-2281
2020,9,8,1,6378,7586,5298,-2288
2020,9,8,2,5895,7097,4955,-2142
2020,9,8,3,5376,6464,4519,-1945
2020,9,8,4,4887,5824,4080,-1744
2020,9,8,5,4385,5352,3940,-1412
2020,9,8,6,4092,4989,3643,-1346
2020,9,8,7,3884,4756,3459,-1297
2020,9,8,8,3760,4663,3407,-1256
2020,9,8,9,3718,4677,3416,-1261
2020,9,8,10,3853,4903,3614,-1289
2020,9,8,11,4076,5288,3923,-1365
2020,9,8,12,4256,5584,4289,-1295
2020,9,8,13,4519,6021,4508,-1513
2020,9,8,14,5012,6609,4763,-1846
2020,9,8,15,5601,7290,5115,-2175
2020,9,8,16,6291,8071,5671,-2400
2020,9,8,17,6702,8821,6403,-2418
2020,9,8,18,7194,9446,6987,-2459
2020,9,8,19,7441,9912,7469,-2443
2020,9,8,20,7576,10066,7702,-2364
2020,9,8,21,7602,9824,7447,-2377
2020,9,8,22,7546,9608,7266,-2342
2020,9,8,23,7341,9119,6844,-2275
2020,9,9,0,7012,8493,6207,-2286
2020,9,9,1,6745,8142,5868,-2274
2020,9,9,2,6217,7536,5326,-2210
2020,9,9,3,5676,6867,4863,-2004
2020,9,9,4,5084,6213,4391,-1822
2020,9,9,5,4601,5715,4190,-1525
2020,9,9,6,4281,5342,3917,-1425
2020,9,9,7,4060,5089,3725,-1364
2020,9,9,8,3919,4961,3628,-1333
2020,9,9,9,3880,4963,3617,-1346
2020,9,9,10,4002,5175,3811,-1364
2020,9,9,11,4245,5597,4122,-1475
2020,9,9,12,4396,5840,4434,-1406
2020,9,9,13,4617,6210,4612,-1598
2020,9,9,14,5095,6726,4799,-1927
2020,9,9,15,5680,7413,5224,-2189
2020,9,9,16,6190,8172,5918,-2254
2020,9,9,17,6801,8935,6739,-2196
2020,9,9,18,7309,9497,7382,-2115
2020,9,9,19,7626,9804,7541,-2263
2020,9,9,20,7770,9898,7606,-2292
2020,9,9,21,7771,9679,7423,-2256
2020,9,9,22,7589,9227,7058,-2169
2020,9,9,23,7278,8607,6660,-1947
2020,9,10,0,7014,8128,6275,-1853
2020,9,10,1,6760,7758,5928,-1830
2020,9,10,2,6234,7274,5464,-1810
2020,9,10,3,5718,6641,4872,-1769
2020,9,10,4,5167,6017,4398,-1619
2020,9,10,5,4652,5565,4210,-1355
2020,9,10,6,4334,5236,3835,-1401
2020,9,10,7,4104,4995,3646,-1349
2020,9,10,8,3967,4855,3542,-1313
2020,9,10,9,3923,4848,3531,-1317
2020,9,10,10,4035,5045,3701,-1344
2020,9,10,11,4264,5421,3998,-1423
2020,9,10,12,4417,5701,4326,-1375
2020,9,10,13,4677,6110,4580,-1530
2020,9,10,14,5195,6803,5016,-1787
2020,9,10,15,5829,7669,5774,-1895
2020,9,10,16,6405,8433,6466,-1967
2020,9,10,17,6899,9099,6952,-2147
2020,9,10,18,7385,9430,7377,-2053
2020,9,10,19,7646,9496,7405,-2091
2020,9,10,20,7736,9388,7348,-2040
2020,9,10,21,7725,9154,7163,-1991
2020,9,10,22,7584,8697,6663,-2034
2020,9,10,23,7334,8276,6292,-1984
2020,9,11,0,6968,7981,6071,-1910
2020,9,11,1,6714,7731,5837,-1894
2020,9,11,2,6190,7254,5482,-1772
2020,9,11,3,5665,6672,4978,-1694
2020,9,11,4,5157,6081,4553,-1528
2020,9,11,5,4583,5582,4270,-1312
2020,9,11,6,4284,5233,3956,-1277
2020,9,11,7,4076,4968,3792,-1176
2020,9,11,8,3939,4847,3744,-1103
2020,9,11,9,3903,4867,3761,-1106
2020,9,11,10,4028,5118,3996,-1122
2020,9,11,11,4264,5576,4305,-1271
2020,9,11,12,4430,5880,4663,-1217
2020,9,11,13,4711,6289,5009,-1280
2020,9,11,14,5227,6904,5402,-1502
2020,9,11,15,5846,7698,6083,-1615
2020,9,11,16,6400,8340,6613,-1727
2020,9,11,17,6919,8914,7014,-1900
2020,9,11,18,7331,9407,7289,-2118
2020,9,11,19,7610,9666,7543,-2123
2020,9,11,20,7722,9464,7398,-2066
2020,9,11,21,7641,9120,7162,-1958
2020,9,11,22,7442,8714,6666,-2048
2020,9,11,23,7162,8233,6165,-2068
2020,9,12,0,6778,7973,5780,-2193
2020,9,12,1,6491,7810,5718,-2092
2020,9,12,2,6036,7392,5408,-1984
2020,9,12,3,5589,6884,5049,-1835
2020,9,12,4,5143,6384,4699,-1685
2020,9,12,5,4621,5950,4426,-1524
2020,9,12,6,4331,5604,4164,-1440
2020,9,12,7,4101,5390,3987,-1403
2020,9,12,8,3948,5227,3863,-1364
2020,9,12,9,3876,5148,3798,-1350
2020,9,12,10,3903,5164,3796,-1368
2020,9,12,11,3985,5238,3847,-1391
2020,9,12,12,4081,5367,4047,-1320
2020,9,12,13,4494,5984,4436,-1548
2020,9,12,14,5041,6749,4816,-1933
2020,9,12,15,5563,7458,5350,-2108
2020,9,12,16,6060,8045,5960,-2085
2020,9,12,17,6360,8256,6269,-1987
2020,9,12,18,6676,8223,6223,-2000
2020,9,12,19,6802,8082,6136,-1946
2020,9,12,20,6833,7806,5901,-1905
2020,9,12,21,6735,7569,5662,-1907
2020,9,12,22,6575,7443,5434,-2009
2020,9,12,23,6297,7207,5116,-2091
2020,9,13,0,6046,7056,4867,-2189
2020,9,13,1,5869,6930,4784,-2146
2020,9,13,2,5488,6649,4747,-1902
2020,9,13,3,5084,6301,4572,-1729
2020,9,13,4,4733,5899,4374,-1525
2020,9,13,5,4606,5562,4302,-1260
2020,9,13,6,4302,5241,4060,-1181
2020,9,13,7,4091,4967,3813,-1154
2020,9,13,8,3926,4817,3682,-1135
2020,9,13,9,3859,4750,3629,-1121
2020,9,13,10,3846,4754,3610,-1144
2020,9,13,11,3854,4871,3582,-1289
2020,9,13,12,3945,5022,3767,-1255
2020,9,13,13,4256,5465,4009,-1456
2020,9,13,14,4774,6074,4266,-1808
2020,9,13,15,5319,6624,4614,-2010
2020,9,13,16,5776,7094,5137,-1957
2020,9,13,17,6119,7406,5475,-1931
2020,9,13,18,6485,7667,5616,-2051
2020,9,13,19,6661,7818,5842,-1976
2020,9,13,20,6708,7686,5763,-1923
2020,9,13,21,6688,7511,5484,-2027
2020,9,13,22,6585,7325,5246,-2079
2020,9,13,23,6340,7140,5057,-2083
2020,9,14,0,6068,7075,4920,-2155
2020,9,14,1,5906,7027,4943,-2084
2020,9,14,2,5518,6636,4686,-1950
2020,9,14,3,5062,6153,4463,-1690
2020,9,14,4,4646,5692,4218,-1474
2020,9,14,5,4194,5308,4101,-1207
2020,9,14,6,3931,5019,3868,-1151
2020,9,14,7,3760,4878,3729,-1149
2020,9,14,8,3659,4845,3682,-1163
2020,9,14,9,3660,4904,3698,-1206
2020,9,14,10,3845,5159,3893,-1266
2020,9,14,11,4133,5601,4102,-1499
2020,9,14,12,4325,5911,4500,-1411
2020,9,14,13,4626,6256,4681,-1575
2020,9,14,14,5085,6764,4888,-1876
2020,9,14,15,5653,7315,5167,-2148
2020,9,14,16,6220,7785,5674,-2111
2020,9,14,17,6617,8185,6173,-2012
2020,9,14,18,7033,8314,6277,-2037
2020,9,14,19,7251,8223,6223,-2000
2020,9,14,20,7296,8082,5992,-2090
2020,9,14,21,7307,8049,5905,-2144
2020,9,14,22,7231,8029,5867,-2162
2020,9,14,23,6973,7855,5731,-2124
2020,9,15,0,6645,7704,5436,-2268
2020,9,15,1,6402,7441,5217,-2224
2020,9,15,2,5922,6951,4874,-2077
2020,9,15,3,5380,6431,4538,-1893
2020,9,15,4,4936,5875,4175,-1700
2020,9,15,5,4561,5447,4022,-1425
2020,9,15,6,4268,5158,3759,-1399
2020,9,15,7,4060,4933,3579,-1354
2020,9,15,8,3931,4821,3483,-1338
2020,9,15,9,3890,4877,3548,-1329
2020,9,15,10,4040,5100,3735,-1365
2020,9,15,11,4308,5551,4081,-1470
2020,9,15,12,4474,5865,4462,-1403
2020,9,15,13,4762,6153,4575,-1578
2020,9,15,14,5292,6509,4659,-1850
2020,9,15,15,5812,6928,4845,-2083
2020,9,15,16,6379,7362,5247,-2115
2020,9,15,17,6889,7723,5637,-2086
2020,9,15,18,7331,8055,6066,-1989
2020,9,15,19,7609,8403,6391,-2012
2020,9,15,20,7756,8650,6582,-2068
2020,9,15,21,7724,8878,6835,-2043
2020,9,15,22,7589,8871,6866,-2005
2020,9,15,23,7378,8550,6481,-2069
2020,9,16,0,7024,8272,6169,-2103
2020,9,16,1,6743,7957,5873,-2084
2020,9,16,2,6218,7382,5295,-2087
2020,9,16,3,5702,6717,4735,-1982
2020,9,16,4,5158,6040,4293,-1747
2020,9,16,5,4739,5699,4279,-1420
2020,9,16,6,4411,5305,3974,-1331
2020,9,16,7,4170,5074,3808,-1266
2020,9,16,8,4020,4959,3701,-1258
2020,9,16,9,3968,5005,3727,-1278
2020,9,16,10,4101,5231,3905,-1326
2020,9,16,11,4291,5644,4239,-1405
2020,9,16,12,4447,5966,4586,-1380
2020,9,16,13,4723,6264,4739,-1525
2020,9,16,14,5231,6707,4912,-1795
2020,9,16,15,5897,7365,5342,-2023
2020,9,16,16,6478,8119,6024,-2095
2020,9,16,17,6973,8834,6734,-2100
2020,9,16,18,7430,9398,7395,-2003
2020,9,16,19,7735,9698,7646,-2052
2020,9,16,20,7901,9905,7841,-2064
2020,9,16,21,7943,9931,7912,-2019
2020,9,16,22,7743,9654,7671,-1983
2020,9,16,23,7525,9192,7223,-1969
2020,9,17,0,7181,8872,6836,-2036
2020,9,17,1,6863,8519,6392,-2127
2020,9,17,2,6329,7819,5604,-2215
2020,9,17,3,5800,7142,5068,-2074
2020,9,17,4,5246,6539,4697,-1842
2020,9,17,5,4720,5906,4397,-1509
2020,9,17,6,4417,5556,4100,-1456
2020,9,17,7,4176,5317,3923,-1394
2020,9,17,8,4057,5231,3847,-1384
2020,9,17,9,4022,5238,3837,-1401
2020,9,17,10,4142,5441,4007,-1434
2020,9,17,11,4402,5878,4352,-1526
2020,9,17,12,4581,6161,4713,-1448
2020,9,17,13,4865,6527,4865,-1662
2020,9,17,14,5351,7107,5206,-1901
2020,9,17,15,5987,7854,5792,-2062
2020,9,17,16,6552,8520,6548,-1972
2020,9,17,17,6980,8932,7035,-1897
2020,9,17,18,7392,9139,7395,-1744
2020,9,17,19,7570,8982,7304,-1678
2020,9,17,20,7580,8638,6831,-1807
2020,9,17,21,7516,8497,6438,-2059
2020,9,17,22,7367,8323,6123,-2200
2020,9,17,23,7094,8076,5780,-2296
2020,9,18,0,6796,7894,5625,-2269
2020,9,18,1,6566,7747,5536,-2211
2020,9,18,2,6089,7310,5216,-2094
2020,9,18,3,5588,6758,4770,-1988
2020,9,18,4,5091,6157,4398,-1759
2020,9,18,5,4689,5732,4274,-1458
2020,9,18,6,4357,5379,4020,-1359
2020,9,18,7,4114,5184,3863,-1321
2020,9,18,8,3969,5042,3741,-1301
2020,9,18,9,3908,5033,3750,-1283
2020,9,18,10,4037,5269,3943,-1326
2020,9,18,11,4266,5652,4257,-1395
2020,9,18,12,4455,5935,4575,-1360
2020,9,18,13,4724,6269,4726,-1543
2020,9,18,14,5171,6861,4977,-1884
2020,9,18,15,5764,7516,5367,-2149
2020,9,18,16,6458,8135,5864,-2271
2020,9,18,17,6890,8738,6316,-2422
2020,9,18,18,7331,9266,7039,-2227
2020,9,18,19,7584,9673,7607,-2066
2020,9,18,20,7672,9919,7839,-2080
2020,9,18,21,7619,9996,8124,-1872
2020,9,18,22,7399,9946,8057,-1889
2020,9,18,23,7078,9450,7627,-1823
2020,9,19,0,6745,8881,6930,-1951
2020,9,19,1,6453,8456,6578,-1878
2020,9,19,2,5985,7820,5966,-1854
2020,9,19,3,5554,7168,5301,-1867
2020,9,19,4,5038,6528,4821,-1707
2020,9,19,5,4710,5948,4538,-1410
2020,9,19,6,4381,5481,4129,-1352
2020,9,19,7,4121,5121,3835,-1286
2020,9,19,8,3952,4872,3626,-1246
2020,9,19,9,3869,4730,3543,-1187
2020,9,19,10,3856,4696,3482,-1214
2020,9,19,11,3888,4769,3543,-1226
2020,9,19,12,3986,4899,3724,-1175
2020,9,19,13,4348,5444,4163,-1281
2020,9,19,14,4917,6163,4677,-1486
2020,9,19,15,5522,6964,5365,-1599
2020,9,19,16,6064,7775,6190,-1585
2020,9,19,17,6482,8493,6902,-1591
2020,9,19,18,6833,8988,7330,-1658
2020,9,19,19,7044,9326,7637,-1689
2020,9,19,20,7161,9499,7774,-1725
2020,9,19,21,7121,9483,7797,-1686
2020,9,19,22,6968,9211,7565,-1646
2020,9,19,23,6691,8681,7162,-1519
2020,9,20,0,6442,8269,6774,-1495
2020,9,20,1,6189,7878,6398,-1480
2020,9,20,2,5755,7324,5857,-1467
2020,9,20,3,5341,6766,5255,-1511
2020,9,20,4,4910,6229,4790,-1439
2020,9,20,5,4509,5787,4527,-1260
2020,9,20,6,4215,5421,4216,-1205
2020,9,20,7,3988,5205,3976,-1229
2020,9,20,8,3836,5071,3829,-1242
2020,9,20,9,3759,5001,3744,-1257
2020,9,20,10,3740,5022,3766,-1256
2020,9,20,11,3777,5132,3850,-1282
2020,9,20,12,3878,5274,4023,-1251
2020,9,20,13,4206,5627,4340,-1287
2020,9,20,14,4664,6199,4673,-1526
2020,9,20,15,5132,6582,5060,-1522
2020,9,20,16,5582,7015,5457,-1558
2020,9,20,17,5967,7359,5786,-1573
2020,9,20,18,6315,7543,5937,-1606
2020,9,20,19,6506,7645,6104,-1541
2020,9,20,20,6608,7700,6187,-1513
2020,9,20,21,6547,7699,6266,-1433
2020,9,20,22,6372,7686,6126,-1560
2020,9,20,23,6128,7469,5808,-1661
2020,9,21,0,5889,7376,5598,-1778
2020,9,21,1,5687,7288,5507,-1781
2020,9,21,2,5262,6830,5188,-1642
2020,9,21,3,4822,6289,4697,-1592
2020,9,21,4,4387,5737,4225,-1512
2020,9,21,5,3956,5263,3925,-1338
2020,9,21,6,3666,4962,3684,-1278
2020,9,21,7,3482,4749,3520,-1229
2020,9,21,8,3385,4673,3469,-1204
2020,9,21,9,3361,4689,3480,-1209
2020,9,21,10,3543,4876,3612,-1264
2020,9,21,11,3803,5310,3947,-1363
2020,9,21,12,4021,5583,4298,-1285
2020,9,21,13,4251,5899,4568,-1331
2020,9,21,14,4588,6400,4914,-1486
2020,9,21,15,5020,6968,5337,-1631
2020,9,21,16,5441,7481,5874,-1607
2020,9,21,17,5704,7876,6112,-1764
2020,9,21,18,5998,8217,6293,-1924
2020,9,21,19,6227,8419,6545,-1874
2020,9,21,20,6317,8528,6657,-1871
2020,9,21,21,6394,8560,6694,-1866
2020,9,21,22,6310,8466,6648,-1818
2020,9,21,23,6098,8092,6346,-1746
2020,9,22,0,5877,7768,6006,-1762
2020,9,22,1,5641,7467,5681,-1786
2020,9,22,2,5183,6894,5251,-1643
2020,9,22,3,4694,6218,4653,-1565
2020,9,22,4,4211,5549,4114,-1435
2020,9,22,5,3902,5021,3752,-1269
2020,9,22,6,3605,4661,3467,-1194
2020,9,22,7,3381,4436,3274,-1162
2020,9,22,8,3271,4314,3174,-1140
2020,9,22,9,3254,4319,3168,-1151
2020,9,22,10,3398,4525,3336,-1189
2020,9,22,11,3650,4930,3652,-1278
2020,9,22,12,3856,5178,3943,-1235
2020,9,22,13,4051,5441,4169,-1272
2020,9,22,14,4349,5839,4442,-1397
2020,9,22,15,4636,6344,4818,-1526
2020,9,22,16,4978,6883,5199,-1684
2020,9,22,17,5326,7318,5543,-1775
2020,9,22,18,5662,7621,5801,-1820
2020,9,22,19,5912,7838,5963,-1875
2020,9,22,20,6143,7961,6040,-1921
2020,9,22,21,6279,8137,6166,-1971
2020,9,22,22,6214,8147,6172,-1975
2020,9,22,23,5910,7894,6029,-1865
2020,9,23,0,5661,7581,5754,-1827
2020,9,23,1,5455,7337,5564,-1773
2020,9,23,2,5014,6721,5129,-1592
2020,9,23,3,4540,6031,4517,-1514
2020,9,23,4,4049,5345,3896,-1449
2020,9,23,5,3808,4813,3571,-1242
2020,9,23,6,3521,4470,3298,-1172
2020,9,23,7,3329,4230,3108,-1122
2020,9,23,8,3233,4087,2998,-1089
2020,9,23,9,3227,4108,3016,-1092
2020,9,23,10,3391,4323,3172,-1151
2020,9,23,11,3643,4728,3505,-1223
2020,9,23,12,3839,4988,3813,-1175
2020,9,23,13,4064,5249,4045,-1204
2020,9,23,14,4412,5650,4330,-1320
2020,9,23,15,4883,6245,4801,-1444
2020,9,23,16,5316,6839,5181,-1658
2020,9,23,17,5767,7389,5633,-1756
2020,9,23,18,6177,7887,6023,-1864
2020,9,23,19,6469,8314,6428,-1886
2020,9,23,20,6691,8638,6654,-1984
2020,9,23,21,6774,8847,6847,-2000
2020,9,23,22,6712,8888,7022,-1866
2020,9,23,23,6392,8492,6654,-1838
2020,9,24,0,6098,8095,6243,-1852
2020,9,24,1,5828,7676,5867,-1809
2020,9,24,2,5350,7045,5361,-1684
2020,9,24,3,4843,6347,4735,-1612
2020,9,24,4,4352,5695,4185,-1510
2020,9,24,5,4020,5174,3847,-1327
2020,9,24,6,3721,4793,3550,-1243
2020,9,24,7,3540,4534,3351,-1183
2020,9,24,8,3423,4411,3255,-1156
2020,9,24,9,3400,4429,3264,-1165
2020,9,24,10,3539,4605,3400,-1205
2020,9,24,11,3836,5022,3727,-1295
2020,9,24,12,4053,5286,4043,-1243
2020,9,24,13,4324,5579,4296,-1283
2020,9,24,14,4705,6072,4639,-1433
2020,9,24,15,5280,6727,5075,-1652
2020,9,24,16,5834,7462,5610,-1852
2020,9,24,17,6320,8100,6233,-1867
2020,9,24,18,6726,8671,6793,-1878
2020,9,24,19,7055,9148,7341,-1807
2020,9,24,20,7308,9475,7647,-1828
2020,9,24,21,7406,9636,7761,-1875
2020,9,24,22,7364,9534,7682,-1852
2020,9,24,23,7024,9148,7337,-1811
2020,9,25,0,6752,8780,6978,-1802
2020,9,25,1,6474,8374,6516,-1858
2020,9,25,2,5958,7688,5907,-1781
2020,9,25,3,5377,6959,5190,-1769
2020,9,25,4,4857,6268,4604,-1664
2020,9,25,5,4433,5744,4272,-1472
2020,9,25,6,4138,5336,3941,-1395
2020,9,25,7,3933,5010,3682,-1328
2020,9,25,8,3780,4834,3542,-1292
2020,9,25,9,3769,4784,3512,-1272
2020,9,25,10,3931,4976,3668,-1308
2020,9,25,11,4157,5349,3973,-1376
2020,9,25,12,4359,5615,4289,-1326
2020,9,25,13,4644,6003,4607,-1396
2020,9,25,14,5172,6697,5049,-1648
2020,9,25,15,5737,7519,5713,-1806
2020,9,25,16,6164,8383,6529,-1854
2020,9,25,17,6533,9160,7239,-1921
2020,9,25,18,6870,9786,7863,-1923
2020,9,25,19,7103,10191,8149,-2042
2020,9,25,20,7200,10470,8463,-2007
2020,9,25,21,7119,10547,8639,-1908
2020,9,25,22,6895,10439,8602,-1837
2020,9,25,23,6608,9936,8174,-1762
2020,9,26,0,6341,9343,7563,-1780
2020,9,26,1,6065,8832,7016,-1816
2020,9,26,2,5647,8142,6307,-1835
2020,9,26,3,5208,7437,5608,-1829
2020,9,26,4,4787,6775,4997,-1778
2020,9,26,5,4835,6126,4498,-1628
2020,9,26,6,4494,5674,4165,-1509
2020,9,26,7,4272,5296,3847,-1449
2020,9,26,8,4091,5076,3667,-1409
2020,9,26,9,3999,4956,3561,-1395
2020,9,26,10,3990,4971,3640,-1331
2020,9,26,11,4003,5069,3739,-1330
2020,9,26,12,4114,5199,3939,-1260
2020,9,26,13,4550,5737,4372,-1365
2020,9,26,14,5135,6566,4907,-1659
2020,9,26,15,5741,7404,5519,-1885
2020,9,26,16,6427,8227,6215,-2012
2020,9,26,17,6875,8925,6974,-1951
2020,9,26,18,7268,9386,7511,-1875
2020,9,26,19,7526,9796,7917,-1879
2020,9,26,20,7670,10126,8167,-1959
2020,9,26,21,7669,10247,8333,-1914
2020,9,26,22,7506,10098,8227,-1871
2020,9,26,23,7174,9629,7808,-1821
2020,9,27,0,6895,9063,7233,-1830
2020,9,27,1,6590,8528,6769,-1759
2020,9,27,2,6117,7827,5980,-1847
2020,9,27,3,5685,7178,5382,-1796
2020,9,27,4,5226,6570,4837,-1733
2020,9,27,5,4763,6058,4520,-1538
2020,9,27,6,4414,5619,4187,-1432
2020,9,27,7,4161,5306,3951,-1355
2020,9,27,8,3980,5057,3754,-1303
2020,9,27,9,3879,4906,3626,-1280
2020,9,27,10,3820,4831,3543,-1288
2020,9,27,11,3840,4910,3597,-1313
2020,9,27,12,3924,5035,3791,-1244
2020,9,27,13,4281,5583,4224,-1359
2020,9,27,14,4854,6393,4805,-1588
2020,9,27,15,5536,7186,5356,-1830
2020,9,27,16,6173,8006,6043,-1963
2020,9,27,17,6761,8845,6980,-1865
2020,9,27,18,7193,9348,7506,-1842
2020,9,27,19,7457,9663,7792,-1871
2020,9,27,20,7638,9750,7880,-1870
2020,9,27,21,7617,9635,7850,-1785
2020,9,27,22,7467,9259,7520,-1739
2020,9,27,23,7118,8829,7078,-1751
2020,9,28,0,6880,8466,6621,-1845
2020,9,28,1,6586,7899,6100,-1799
2020,9,28,2,6080,7201,5390,-1811
2020,9,28,3,5556,6568,4951,-1617
2020,9,28,4,5044,5924,4357,-1567
2020,9,28,5,4590,5447,4058,-1389
2020,9,28,6,4277,5100,3770,-1330
2020,9,28,7,4055,4852,3587,-1265
2020,9,28,8,3929,4719,3486,-1233
2020,9,28,9,3875,4741,3491,-1250
2020,9,28,10,4029,4989,3676,-1313
2020,9,28,11,4278,5414,4002,-1412
2020,9,28,12,4503,5730,4402,-1328
2020,9,28,13,4762,5969,4617,-1352
2020,9,28,14,5186,6396,4899,-1497
2020,9,28,15,5661,6895,5235,-1660
2020,9,28,16,6166,7592,5712,-1880
2020,9,28,17,6491,8359,6336,-2023
2020,9,28,18,6791,8853,6842,-2011
2020,9,28,19,7009,8855,7090,-1765
2020,9,28,20,7055,8853,7190,-1663
2020,9,28,21,7018,8653,6933,-1720
2020,9,28,22,7009,8425,6570,-1855
2020,9,28,23,6814,8149,6274,-1875
2020,9,29,0,6596,7962,6001,-1961
2020,9,29,1,6300,7634,5800,-1834
2020,9,29,2,5785,7089,5422,-1667
2020,9,29,3,5230,6415,4799,-1616
2020,9,29,4,4707,5823,4290,-1533
2020,9,29,5,4380,5294,3972,-1322
2020,9,29,6,4112,4964,3725,-1239
2020,9,29,7,3919,4757,3587,-1170
2020,9,29,8,3810,4660,3496,-1164
2020,9,29,9,3768,4676,3507,-1169
2020,9,29,10,3927,4907,3675,-1232
2020,9,29,11,4227,5392,4035,-1357
2020,9,29,12,4447,5703,4409,-1294
2020,9,29,13,4676,5943,4624,-1319
2020,9,29,14,5135,6455,4941,-1514
2020,9,29,15,5613,7135,5396,-1739
2020,9,29,16,6215,7947,6011,-1936
2020,9,29,17,6679,8662,6651,-2011
2020,9,29,18,7026,9102,7117,-1985
2020,9,29,19,7277,9274,7473,-1801
2020,9,29,20,7422,8805,7111,-1694
2020,9,29,21,7381,8284,6537,-1747
2020,9,29,22,7185,8054,6250,-1804
2020,9,29,23,6916,7742,5913,-1829
2020,9,30,0,6594,7558,5714,-1844
2020,9,30,1,6266,7248,5506,-1742
2020,9,30,2,5687,6576,5017,-1559
2020,9,30,3,5086,5970,4551,-1419
2020,9,30,4,4520,5408,4030,-1378
2020,9,30,5,3992,4825,3650,-1175
2020,9,30,6,3685,4380,3382,-998
2020,9,30,7,3481,4094,3097,-997
2020,9,30,8,3359,3929,2940,-989
2020,9,30,9,3319,3887,2933,-954
2020,9,30,10,3436,4045,2957,-1088
2020,9,30,11,3627,4400,3236,-1164
2020,9,30,12,3799,4627,3484,-1143
2020,9,30,13,3936,4778,3635,-1143
2020,9,30,14,4193,4944,3742,-1202
2020,9,30,15,4449,5161,3892,-1269
2020,9,30,16,4690,5412,4103,-1309
2020,9,30,17,4900,5664,4306,-1358
2020,9,30,18,5246,5930,4505,-1425
2020,9,30,19,5461,6245,4733,-1512
2020,9,30,20,5698,6447,4846,-1601
2020,9,30,21,5812,6730,5036,-1694
2020,9,30,22,5695,6787,5079,-1708
2020,9,30,23,5445,6526,4882,-1644
2020,10,1,0,5292,6441,4795,-1646
2020,10,1,1,5106,6236,4689,-1547
2020,10,1,2,4657,5714,4328,-1386
2020,10,1,3,4170,5091,3777,-1314
2020,10,1,4,3671,4534,3288,-1246
2020,10,1,5,3339,4122,3044,-1078
2020,10,1,6,3099,3826,2803,-1023
2020,10,1,7,2949,3668,2682,-986
2020,10,1,8,2885,3623,2648,-975
2020,10,1,9,2895,3691,2704,-987
2020,10,1,10,3053,3919,2876,-1043
2020,10,1,11,3376,4320,3185,-1135
2020,10,1,12,3579,4613,3500,-1113
2020,10,1,13,3757,4790,3681,-1109
2020,10,1,14,4090,5057,3852,-1205
2020,10,1,15,4395,5358,4075,-1283
2020,10,1,16,4728,5785,4408,-1377
2020,10,1,17,5163,6254,4773,-1481
2020,10,1,18,5560,6643,5079,-1564
2020,10,1,19,5890,7011,5546,-1465
2020,10,1,20,6051,7336,5899,-1437
2020,10,1,21,6113,7455,6036,-1419
2020,10,1,22,6077,7390,5991,-1399
2020,10,1,23,5723,7167,5727,-1440
2020,10,2,0,5575,7034,5530,-1504
2020,10,2,1,5340,6716,5171,-1545
2020,10,2,2,4911,6182,4672,-1510
2020,10,2,3,4419,5552,4100,-1452
2020,10,2,4,3925,4939,3591,-1348
2020,10,2,5,3601,4483,3284,-1199
2020,10,2,6,3298,4146,3034,-1112
2020,10,2,7,3078,3917,2850,-1067
2020,10,2,8,2980,3793,2740,-1053
2020,10,2,9,2964,3768,2700,-1068
2020,10,2,10,3102,3941,2856,-1085
2020,10,2,11,3353,4326,3161,-1165
2020,10,2,12,3553,4587,3468,-1119
2020,10,2,13,3747,4809,3673,-1136
2020,10,2,14,4046,5114,3882,-1232
2020,10,2,15,4384,5396,4103,-1293
2020,10,2,16,4724,5675,4313,-1362
2020,10,2,17,5086,6058,4665,-1393
2020,10,2,18,5429,6482,5040,-1442
2020,10,2,19,5698,6904,5445,-1459
2020,10,2,20,5930,7145,5718,-1427
2020,10,2,21,6037,7263,5819,-1444
2020,10,2,22,5912,7154,5726,-1428
2020,10,2,23,5485,6840,5421,-1419
2020,10,3,0,5285,6685,5210,-1475
2020,10,3,1,5073,6366,4896,-1470
2020,10,3,2,4690,5926,4519,-1407
2020,10,3,3,4293,5449,4066,-1383
2020,10,3,4,3875,4904,3584,-1320
2020,10,3,5,3709,4519,3380,-1139
2020,10,3,6,3432,4211,3120,-1091
2020,10,3,7,3264,3981,2941,-1040
2020,10,3,8,3157,3839,2834,-1005
2020,10,3,9,3124,3761,2754,-1007
2020,10,3,10,3155,3819,2807,-1012
2020,10,3,11,3272,3951,2905,-1046
2020,10,3,12,3415,4125,3098,-1027
2020,10,3,13,3670,4490,3387,-1103
2020,10,3,14,4075,4978,3752,-1226
2020,10,3,15,4371,5429,4080,-1349
2020,10,3,16,4616,5853,4384,-1469
2020,10,3,17,4813,6205,4703,-1502
2020,10,3,18,4982,6502,4978,-1524
2020,10,3,19,5131,6663,5150,-1513
2020,10,3,20,5267,6771,5247,-1524
2020,10,3,21,5290,6786,5299,-1487
2020,10,3,22,5225,6684,5236,-1448
2020,10,3,23,5039,6521,5087,-1434
2020,10,4,0,4971,6483,4994,-1489
2020,10,4,1,4810,6252,4744,-1508
2020,10,4,2,4518,5871,4417,-1454
2020,10,4,3,4239,5453,4012,-1441
2020,10,4,4,3921,5010,3645,-1365
2020,10,4,5,3617,4621,3428,-1193
2020,10,4,6,3357,4337,3209,-1128
2020,10,4,7,3207,4141,3065,-1076
2020,10,4,8,3113,4035,2985,-1050
2020,10,4,9,3074,3982,2940,-1042
2020,10,4,10,3095,4036,2991,-1045
2020,10,4,11,3190,4124,3042,-1082
2020,10,4,12,3331,4322,3255,-1067
2020,10,4,13,3655,4686,3534,-1152
2020,10,4,14,4073,5175,3867,-1308
2020,10,4,15,4381,5557,4149,-1408
2020,10,4,16,4573,5782,4354,-1428
2020,10,4,17,4802,5984,4551,-1433
2020,10,4,18,4828,6089,4664,-1425
2020,10,4,19,4976,6184,4773,-1411
2020,10,4,20,5032,6250,4856,-1394
2020,10,4,21,4943,6311,4933,-1378
2020,10,4,22,4846,6313,4888,-1425
2020,10,4,23,4735,6261,4742,-1519
2020,10,5,0,4792,6342,4801,-1541
2020,10,5,1,4711,6135,4632,-1503
2020,10,5,2,4432,5791,4398,-1393
2020,10,5,3,4106,5337,3978,-1359
2020,10,5,4,3756,4825,3547,-1278
2020,10,5,5,3486,4396,3266,-1130
2020,10,5,6,3269,4123,3052,-1071
2020,10,5,7,3149,4000,2949,-1051
2020,10,5,8,3077,3968,2926,-1042
2020,10,5,9,3116,4046,2986,-1060
2020,10,5,10,3307,4343,3213,-1130
2020,10,5,11,3627,4810,3577,-1233
2020,10,5,12,3938,5204,3973,-1231
2020,10,5,13,4152,5438,4211,-1227
2020,10,5,14,4516,5741,4407,-1334
2020,10,5,15,4880,6024,4596,-1428
2020,10,5,16,5279,6453,5029,-1424
2020,10,5,17,5547,6906,5492,-1414
2020,10,5,18,5817,7270,5863,-1407
2020,10,5,19,6029,7548,6179,-1369
2020,10,5,20,6131,7797,6425,-1372
2020,10,5,21,6116,8078,6697,-1381
2020,10,5,22,6060,8118,6738,-1380
2020,10,5,23,5904,7896,6533,-1363
2020,10,6,0,5874,7838,6386,-1452
2020,10,6,1,5650,7536,6126,-1410
2020,10,6,2,5218,6993,5442,-1551
2020,10,6,3,4756,6386,4683,-1703
2020,10,6,4,4330,5769,4080,-1689
2020,10,6,5,4138,5265,3704,-1561
2020,10,6,6,3875,4913,3447,-1466
2020,10,6,7,3715,4714,3325,-1389
2020,10,6,8,3603,4640,3262,-1378
2020,10,6,9,3608,4674,3274,-1400
2020,10,6,10,3778,4890,3439,-1451
2020,10,6,11,4105,5267,3710,-1557
2020,10,6,12,4348,5634,4086,-1548
2020,10,6,13,4559,5939,4411,-1528
2020,10,6,14,4992,6424,4858,-1566
2020,10,6,15,5585,7187,5671,-1516
2020,10,6,16,6090,7945,6432,-1513
2020,10,6,17,6608,8772,7241,-1531
2020,10,6,18,6978,9340,7782,-1558
2020,10,6,19,7241,9753,8085,-1668
2020,10,6,20,7421,10067,8445,-1622
2020,10,6,21,7395,10187,8548,-1639
2020,10,6,22,7285,10028,8377,-1651
2020,10,6,23,7067,9489,7895,-1594
2020,10,7,0,6897,9148,7557,-1591
2020,10,7,1,6567,8616,7020,-1596
2020,10,7,2,6045,7968,6319,-1649
2020,10,7,3,5522,7251,5457,-1794
2020,10,7,4,5016,6553,4737,-1816
2020,10,7,5,4658,6008,4344,-1664
2020,10,7,6,4336,5582,3963,-1619
2020,10,7,7,4087,5306,3764,-1542
2020,10,7,8,3954,5156,3640,-1516
2020,10,7,9,3928,5117,3610,-1507
2020,10,7,10,4060,5320,3741,-1579
2020,10,7,11,4330,5706,4038,-1668
2020,10,7,12,4556,5996,4361,-1635
2020,10,7,13,4770,6252,4651,-1601
2020,10,7,14,5218,6793,5122,-1671
2020,10,7,15,5886,7494,5976,-1518
2020,10,7,16,6424,8254,6756,-1498
2020,10,7,17,6939,8948,7400,-1548
2020,10,7,18,7324,9502,7799,-1703
2020,10,7,19,7600,9912,8131,-1781
2020,10,7,20,7846,10178,8348,-1830
2020,10,7,21,7880,10232,8353,-1879
2020,10,7,22,7682,10039,8103,-1936
2020,10,7,23,7278,9502,7565,-1937
2020,10,8,0,7122,9154,7172,-1982
2020,10,8,1,6727,8645,6636,-2009
2020,10,8,2,6189,7975,5894,-2081
2020,10,8,3,5645,7267,5345,-1922
2020,10,8,4,5103,6632,4750,-1882
2020,10,8,5,4655,6028,4278,-1750
2020,10,8,6,4313,5580,3919,-1661
2020,10,8,7,4085,5305,3711,-1594
2020,10,8,8,3948,5113,3574,-1539
2020,10,8,9,3907,5088,3528,-1560
2020,10,8,10,4023,5252,3642,-1610
2020,10,8,11,4296,5668,3975,-1693
2020,10,8,12,4518,5887,4301,-1586
2020,10,8,13,4727,6183,4646,-1537
2020,10,8,14,5148,6771,5084,-1687
2020,10,8,15,5686,7509,5602,-1907
2020,10,8,16,6332,8274,6152,-2122
2020,10,8,17,6866,8964,6972,-1992
2020,10,8,18,7305,9520,7539,-1981
2020,10,8,19,7620,9909,7977,-1932
2020,10,8,20,7834,10053,8115,-1938
2020,10,8,21,7897,10129,8184,-1945
2020,10,8,22,7757,9945,8038,-1907
2020,10,8,23,7381,9491,7603,-1888
2020,10,9,0,7183,9168,7112,-2056
2020,10,9,1,6788,8641,6594,-2047
2020,10,9,2,6225,7944,5872,-2072
2020,10,9,3,5645,7247,5449,-1798
2020,10,9,4,5061,6594,4756,-1838
2020,10,9,5,4713,5985,4235,-1750
2020,10,9,6,4377,5546,3890,-1656
2020,10,9,7,4140,5238,3643,-1595
2020,10,9,8,3997,5036,3489,-1547
2020,10,9,9,3963,5003,3452,-1551
2020,10,9,10,4059,5168,3567,-1601
2020,10,9,11,4308,5536,3861,-1675
2020,10,9,12,4535,5754,4177,-1577
2020,10,9,13,4777,6130,4527,-1603
2020,10,9,14,5270,6766,5040,-1726
2020,10,9,15,5816,7490,5539,-1951
2020,10,9,16,6362,8159,6128,-2031
2020,10,9,17,6841,8714,6817,-1897
2020,10,9,18,7286,9204,7375,-1829
2020,10,9,19,7533,9511,7575,-1936
2020,10,9,20,7688,9683,7686,-1997
2020,10,9,21,7685,9711,7694,-2017
2020,10,9,22,7498,9459,7474,-1985
2020,10,9,23,7090,8878,6996,-1882
2020,10,10,0,6882,8400,6500,-1900
2020,10,10,1,6499,7924,5945,-1979
2020,10,10,2,6033,7369,5406,-1963
2020,10,10,3,5571,6831,5078,-1753
2020,10,10,4,5104,6242,4465,-1777
2020,10,10,5,4681,5755,4081,-1674
2020,10,10,6,4366,5402,3810,-1592
2020,10,10,7,4129,5126,3606,-1520
2020,10,10,8,3976,4957,3475,-1482
2020,10,10,9,3892,4883,3403,-1480
2020,10,10,10,3896,4868,3381,-1487
2020,10,10,11,3939,4969,3442,-1527
2020,10,10,12,4087,5097,3652,-1445
2020,10,10,13,4428,5563,4138,-1425
2020,10,10,14,5012,6314,4653,-1661
2020,10,10,15,5651,7080,5276,-1804
2020,10,10,16,6170,7798,5884,-1914
2020,10,10,17,6512,8313,6455,-1858
2020,10,10,18,6824,8684,7069,-1615
2020,10,10,19,7071,9078,7414,-1664
2020,10,10,20,7172,9332,7476,-1856
2020,10,10,21,7136,9472,7638,-1834
2020,10,10,22,6976,9325,7538,-1787
2020,10,10,23,6668,8884,7120,-1764
2020,10,11,0,6495,8520,6777,-1743
2020,10,11,1,6159,8044,6244,-1800
2020,10,11,2,5758,7476,5612,-1864
2020,10,11,3,5356,6903,5217,-1686
2020,10,11,4,4956,6328,4489,-1839
2020,10,11,5,4537,5823,4079,-1744
2020,10,11,6,4242,5431,3796,-1635
2020,10,11,7,4036,5151,3563,-1588
2020,10,11,8,3898,4982,3430,-1552
2020,10,11,9,3807,4900,3356,-1544
2020,10,11,10,3792,4877,3347,-1530
2020,10,11,11,3859,4965,3401,-1564
2020,10,11,12,3985,5143,3640,-1503
2020,10,11,13,4339,5649,4120,-1529
2020,10,11,14,4944,6444,4626,-1818
2020,10,11,15,5555,7253,5507,-1746
2020,10,11,16,6080,7828,5922,-1906
2020,10,11,17,6572,8302,6412,-1890
2020,10,11,18,6888,8411,6726,-1685
2020,10,11,19,7082,8514,6919,-1595
2020,10,11,20,7173,8713,7005,-1708
2020,10,11,21,7036,8721,7011,-1710
2020,10,11,22,6806,8740,7045,-1695
2020,10,11,23,6524,8445,6764,-1681
2020,10,12,0,6464,8169,6327,-1842
2020,10,12,1,6171,7720,5907,-1813
2020,10,12,2,5748,7108,5313,-1795
2020,10,12,3,5296,6427,4853,-1574
2020,10,12,4,4846,5774,4136,-1638
2020,10,12,5,4340,5260,3725,-1535
2020,10,12,6,4043,4847,3414,-1433
2020,10,12,7,3786,4593,3203,-1390
2020,10,12,8,3668,4416,3065,-1351
2020,10,12,9,3651,4383,2991,-1392
2020,10,12,10,3756,4580,3177,-1403
2020,10,12,11,4000,4970,3479,-1491
2020,10,12,12,4233,5219,3794,-1425
2020,10,12,13,4490,5565,4203,-1362
2020,10,12,14,4885,6151,4630,-1521
2020,10,12,15,5377,6719,5128,-1591
2020,10,12,16,5932,7331,5571,-1760
2020,10,12,17,6501,7947,6160,-1787
2020,10,12,18,6969,8445,6843,-1602
2020,10,12,19,7278,8811,7305,-1506
2020,10,12,20,7584,9085,7544,-1541
2020,10,12,21,7525,9244,7652,-1592
2020,10,12,22,7368,9187,7594,-1593
2020,10,12,23,7042,8751,7083,-1668
2020,10,13,0,6906,8414,6434,-1980
2020,10,13,1,6502,7891,6045,-1846
2020,10,13,2,5957,7206,5416,-1790
2020,10,13,3,5343,6482,4883,-1599
2020,10,13,4,4770,5768,4291,-1477
2020,10,13,5,4205,5216,3896,-1320
2020,10,13,6,3878,4815,3573,-1242
2020,10,13,7,3638,4525,3326,-1199
2020,10,13,8,3514,4387,3218,-1169
2020,10,13,9,3500,4368,3203,-1165
2020,10,13,10,3637,4589,3357,-1232
2020,10,13,11,3947,5066,3731,-1335
2020,10,13,12,4188,5373,4124,-1249
2020,10,13,13,4375,5650,4393,-1257
2020,10,13,14,4728,6131,4726,-1405
2020,10,13,15,5233,6708,5132,-1576
2020,10,13,16,5664,7294,5541,-1753
2020,10,13,17,6183,7895,6063,-1832
2020,10,13,18,6598,8398,6598,-1800
2020,10,13,19,6880,8761,7014,-1747
2020,10,13,20,7142,9067,7363,-1704
2020,10,13,21,7293,9266,7555,-1711
2020,10,13,22,7163,9253,7516,-1737
2020,10,13,23,6819,8783,7072,-1711
2020,10,14,0,6625,8369,6633,-1736
2020,10,14,1,6236,7808,5991,-1817
2020,10,14,2,5738,7158,5332,-1826
2020,10,14,3,5204,6417,4782,-1635
2020,10,14,4,4684,5703,4159,-1544
2020,10,14,5,4219,5180,3785,-1395
2020,10,14,6,3910,4740,3456,-1284
2020,10,14,7,3699,4495,3264,-1231
2020,10,14,8,3580,4340,3138,-1202
2020,10,14,9,3561,4359,3156,-1203
2020,10,14,10,3699,4576,3324,-1252
2020,10,14,11,3999,4997,3651,-1346
2020,10,14,12,4216,5250,3958,-1292
2020,10,14,13,4392,5534,4237,-1297
2020,10,14,14,4768,6017,4587,-1430
2020,10,14,15,5260,6658,5075,-1583
2020,10,14,16,5650,7422,5673,-1749
2020,10,14,17,6165,8138,6376,-1762
2020,10,14,18,6522,8713,7035,-1678
2020,10,14,19,6793,9151,7528,-1623
2020,10,14,20,7049,9460,7818,-1642
2020,10,14,21,7164,9585,7961,-1624
2020,10,14,22,7072,9452,7843,-1609
2020,10,14,23,6757,8966,7387,-1579
2020,10,15,0,6552,8628,7001,-1627
2020,10,15,1,6169,8082,6258,-1824
2020,10,15,2,5645,7392,5521,-1871
2020,10,15,3,5097,6631,4961,-1670
2020,10,15,4,4594,5894,4293,-1601
2020,10,15,5,4138,5359,3960,-1399
2020,10,15,6,3838,4929,3640,-1289
2020,10,15,7,3630,4653,3424,-1229
2020,10,15,8,3518,4471,3278,-1193
2020,10,15,9,3477,4433,3239,-1194
2020,10,15,10,3620,4597,3370,-1227
2020,10,15,11,3928,5030,3699,-1331
2020,10,15,12,4156,5269,4011,-1258
2020,10,15,13,4365,5547,4291,-1256
2020,10,15,14,4770,6110,4773,-1337
2020,10,15,15,5249,6790,5229,-1561
2020,10,15,16,5752,7476,5889,-1587
2020,10,15,17,6298,8187,6486,-1701
2020,10,15,18,6686,8723,7112,-1611
2020,10,15,19,6979,9162,7564,-1598
2020,10,15,20,7218,9487,7818,-1669
2020,10,15,21,7340,9675,7993,-1682
2020,10,15,22,7263,9487,7831,-1656
2020,10,15,23,6922,9025,7346,-1679
2020,10,16,0,6710,8662,6996,-1666
2020,10,16,1,6287,8096,6255,-1841
2020,10,16,2,5778,7416,5581,-1835
2020,10,16,3,5225,6659,5016,-1643
2020,10,16,4,4696,5930,4385,-1545
2020,10,16,5,4345,5407,4026,-1381
2020,10,16,6,4026,4982,3706,-1276
2020,10,16,7,3779,4703,3489,-1214
2020,10,16,8,3647,4525,3345,-1180
2020,10,16,9,3630,4507,3327,-1180
2020,10,16,10,3785,4669,3445,-1224
2020,10,16,11,4059,5069,3750,-1319
2020,10,16,12,4279,5337,4146,-1191
2020,10,16,13,4500,5592,4346,-1246
2020,10,16,14,4888,6135,4724,-1411
2020,10,16,15,5425,6813,5214,-1599
2020,10,16,16,5939,7515,5737,-1778
2020,10,16,17,6428,8204,6361,-1843
2020,10,16,18,6832,8809,7007,-1802
2020,10,16,19,7137,9115,7413,-1702
2020,10,16,20,7305,9243,7490,-1753
2020,10,16,21,7360,9295,7540,-1755
2020,10,16,22,7183,9127,7408,-1719
2020,10,16,23,6698,8542,6842,-1700
2020,10,17,0,6414,8140,6365,-1775
2020,10,17,1,5979,7606,5816,-1790
2020,10,17,2,5495,7003,5240,-1763
2020,10,17,3,5012,6437,4901,-1536
2020,10,17,4,4553,5836,4328,-1508
2020,10,17,5,4154,5319,3988,-1331
2020,10,17,6,3832,4918,3680,-1238
2020,10,17,7,3608,4629,3439,-1190
2020,10,17,8,3467,4444,3306,-1138
2020,10,17,9,3399,4354,3225,-1129
2020,10,17,10,3414,4331,3174,-1157
2020,10,17,11,3477,4389,3223,-1166
2020,10,17,12,3599,4522,3372,-1150
2020,10,17,13,3895,4834,3636,-1198
2020,10,17,14,4313,5334,4005,-1329
2020,10,17,15,4729,5837,4399,-1438
2020,10,17,16,5222,6408,4819,-1589
2020,10,17,17,5556,7028,5286,-1742
2020,10,17,18,5878,7566,5800,-1766
2020,10,17,19,6163,7987,6232,-1755
2020,10,17,20,6338,8246,6485,-1761
2020,10,17,21,6430,8349,6649,-1700
2020,10,17,22,6364,8222,6558,-1664
2020,10,17,23,6080,7748,6085,-1663
2020,10,18,0,5879,7429,5716,-1713
2020,10,18,1,5509,7011,5356,-1655
2020,10,18,2,5089,6511,4827,-1684
2020,10,18,3,4671,5991,4460,-1531
2020,10,18,4,4264,5473,4011,-1462
2020,10,18,5,3915,5085,3760,-1325
2020,10,18,6,3667,4733,3499,-1234
2020,10,18,7,3472,4482,3285,-1197
2020,10,18,8,3350,4324,3189,-1135
2020,10,18,9,3291,4226,3106,-1120
2020,10,18,10,3283,4189,3075,-1114
2020,10,18,11,3341,4274,3124,-1150
2020,10,18,12,3469,4411,3271,-1140
2020,10,18,13,3781,4851,3609,-1242
2020,10,18,14,4303,5571,4163,-1408
2020,10,18,15,4805,6311,4683,-1628
2020,10,18,16,5293,7007,5200,-1807
2020,10,18,17,5694,7603,5706,-1897
2020,10,18,18,5997,7997,6133,-1864
2020,10,18,19,6305,8242,6432,-1810
2020,10,18,20,6515,8252,6541,-1711
2020,10,18,21,6596,8033,6416,-1617
2020,10,18,22,6404,7804,6073,-1731
2020,10,18,23,6207,7441,5666,-1775
2020,10,19,0,6024,7369,5560,-1809
2020,10,19,1,5665,7035,5290,-1745
2020,10,19,2,5238,6568,4830,-1738
2020,10,19,3,4771,6000,4423,-1577
2020,10,19,4,4311,5448,3948,-1500
2020,10,19,5,4063,5038,3725,-1313
2020,10,19,6,3769,4730,3512,-1218
2020,10,19,7,3568,4533,3349,-1184
2020,10,19,8,3461,4421,3230,-1191
2020,10,19,9,3428,4410,3213,-1197
2020,10,19,10,3575,4581,3370,-1211
2020,10,19,11,3873,4958,3626,-1332
2020,10,19,12,4130,5210,3966,-1244
2020,10,19,13,4321,5492,4227,-1265
2020,10,19,14,4726,6008,4588,-1420
2020,10,19,15,5216,6637,5064,-1573
2020,10,19,16,5700,7249,5600,-1649
2020,10,19,17,6123,7725,5921,-1804
2020,10,19,18,6515,8038,6250,-1788
2020,10,19,19,6742,8065,6312,-1753
2020,10,19,20,6940,7854,5920,-1934
2020,10,19,21,6980,7475,5624,-1851
2020,10,19,22,6911,7282,5369,-1913
2020,10,19,23,6676,7102,5126,-1976
2020,10,20,0,6487,7144,5352,-1792
2020,10,20,1,6084,6884,5194,-1690
2020,10,20,2,5544,6461,4806,-1655
2020,10,20,3,5004,5932,4433,-1499
2020,10,20,4,4501,5401,3957,-1444
2020,10,20,5,4198,4983,3661,-1322
2020,10,20,6,3902,4698,3464,-1234
2020,10,20,7,3673,4546,3353,-1193
2020,10,20,8,3561,4463,3285,-1178
2020,10,20,9,3559,4507,3310,-1197
2020,10,20,10,3713,4759,3514,-1245
2020,10,20,11,3995,5246,3874,-1372
2020,10,20,12,4225,5554,4383,-1171
2020,10,20,13,4412,5756,4647,-1109
2020,10,20,14,4795,6087,4864,-1223
2020,10,20,15,5216,6498,5138,-1360
2020,10,20,16,5721,6950,5503,-1447
2020,10,20,17,6099,7510,6070,-1440
2020,10,20,18,6443,7872,6480,-1392
2020,10,20,19,6690,8001,6632,-1369
2020,10,20,20,6822,7934,6629,-1305
2020,10,20,21,6912,7915,6508,-1407
2020,10,20,22,6830,7888,6482,-1406
2020,10,20,23,6579,7780,6363,-1417
2020,10,21,0,6454,7722,6236,-1486
2020,10,21,1,6097,7289,5804,-1485
2020,10,21,2,5598,6771,5198,-1573
2020,10,21,3,5064,6187,4626,-1561
2020,10,21,4,4555,5601,4103,-1498
2020,10,21,5,4105,5114,3758,-1356
2020,10,21,6,3816,4783,3505,-1278
2020,10,21,7,3640,4620,3373,-1247
2020,10,21,8,3545,4517,3296,-1221
2020,10,21,9,3541,4550,3327,-1223
2020,10,21,10,3713,4769,3483,-1286
2020,10,21,11,3985,5234,3862,-1372
2020,10,21,12,4207,5520,4188,-1332
2020,10,21,13,4429,5657,4354,-1303
2020,10,21,14,4750,5867,4479,-1388
2020,10,21,15,5159,6228,4759,-1469
2020,10,21,16,5559,6606,4994,-1612
2020,10,21,17,5874,7016,5401,-1615
2020,10,21,18,6193,7391,5741,-1650
2020,10,21,19,6358,7614,5964,-1650
2020,10,21,20,6435,7758,6106,-1652
2020,10,21,21,6431,7863,6229,-1634
2020,10,21,22,6307,7784,6177,-1607
2020,10,21,23,6107,7550,5957,-1593
2020,10,22,0,6052,7572,5912,-1660
2020,10,22,1,5715,7189,5519,-1670
2020,10,22,2,5283,6711,5027,-1684
2020,10,22,3,4827,6096,4583,-1513
2020,10,22,4,4376,5473,4020,-1453
2020,10,22,5,3894,4977,3682,-1295
2020,10,22,6,3662,4621,3400,-1221
2020,10,22,7,3504,4431,3274,-1157
2020,10,22,8,3422,4361,3208,-1153
2020,10,22,9,3439,4405,3240,-1165
2020,10,22,10,3589,4643,3408,-1235
2020,10,22,11,3890,5079,3721,-1358
2020,10,22,12,4140,5394,4085,-1309
2020,10,22,13,4319,5601,4307,-1294
2020,10,22,14,4644,6080,4666,-1414
2020,10,22,15,5181,6661,5065,-1596
2020,10,22,16,5591,7235,5578,-1657
2020,10,22,17,5873,7833,6188,-1645
2020,10,22,18,6140,8194,6586,-1608
2020,10,22,19,6316,8372,6722,-1650
2020,10,22,20,6388,8456,6821,-1635
2020,10,22,21,6449,8347,6757,-1590
2020,10,22,22,6342,8052,6524,-1528
2020,10,22,23,6121,7765,6215,-1550
2020,10,23,0,6009,7674,6087,-1587
2020,10,23,1,5662,7282,5627,-1655
2020,10,23,2,5228,6676,4978,-1698
2020,10,23,3,4760,6124,4558,-1566
2020,10,23,4,4303,5620,4105,-1515
2020,10,23,5,4106,5072,3752,-1320
2020,10,23,6,3821,4729,3489,-1240
2020,10,23,7,3637,4507,3327,-1180
2020,10,23,8,3507,4369,3232,-1137
2020,10,23,9,3492,4383,3229,-1154
2020,10,23,10,3633,4601,3399,-1202
2020,10,23,11,3915,5029,3731,-1298
2020,10,23,12,4158,5347,4064,-1283
2020,10,23,13,4340,5594,4328,-1266
2020,10,23,14,4694,6094,4661,-1433
2020,10,23,15,5174,6675,5112,-1563
2020,10,23,16,5643,7204,5604,-1600
2020,10,23,17,5987,7736,6182,-1554
2020,10,23,18,6336,8022,6450,-1572
2020,10,23,19,6578,8152,6614,-1538
2020,10,23,20,6696,8153,6492,-1661
2020,10,23,21,6690,8031,6497,-1534
2020,10,23,22,6539,7836,6255,-1581
2020,10,23,23,6229,7538,5930,-1608
2020,10,24,0,6135,7443,5823,-1620
2020,10,24,1,5752,7041,5432,-1609
2020,10,24,2,5319,6610,5015,-1595
2020,10,24,3,4887,6098,4575,-1523
2020,10,24,4,4467,5638,4200,-1438
2020,10,24,5,4105,5066,3792,-1274
2020,10,24,6,3822,4675,3458,-1217
2020,10,24,7,3632,4430,3257,-1173
2020,10,24,8,3508,4273,3176,-1097
2020,10,24,9,3452,4208,3088,-1120
2020,10,24,10,3458,4235,3101,-1134
2020,10,24,11,3540,4401,3220,-1181
2020,10,24,12,3685,4606,3448,-1158
2020,10,24,13,3936,4990,3802,-1188
2020,10,24,14,4353,5596,4221,-1375
2020,10,24,15,4857,6214,4637,-1577
2020,10,24,16,5299,6858,5121,-1737
2020,10,24,17,5508,7456,5638,-1818
2020,10,24,18,5803,7956,6179,-1777
2020,10,24,19,6015,8225,6462,-1763
2020,10,24,20,6134,8433,6645,-1788
2020,10,24,21,6101,8480,6704,-1776
2020,10,24,22,5968,8361,6627,-1734
2020,10,24,23,5747,7899,6168,-1731
2020,10,25,0,5613,7655,5907,-1748
2020,10,25,1,5297,7195,5522,-1673
2020,10,25,2,4939,6686,4999,-1687
2020,10,25,3,4583,6187,4642,-1545
2020,10,25,4,4235,5680,4192,-1488
2020,10,25,5,3907,5207,3862,-1345
2020,10,25,6,3632,4800,3520,-1280
2020,10,25,7,3428,4535,3295,-1240
2020,10,25,8,3326,4380,3204,-1176
2020,10,25,9,3252,4297,3135,-1162
2020,10,25,10,3234,4298,3138,-1160
2020,10,25,11,3296,4375,3193,-1182
2020,10,25,12,3436,4542,3393,-1149
2020,10,25,13,3750,4932,3725,-1207
2020,10,25,14,4262,5667,4270,-1397
2020,10,25,15,4813,6463,4873,-1590
2020,10,25,16,5306,7290,5491,-1799
2020,10,25,17,5693,8070,6104,-1966
2020,10,25,18,5953,8608,6501,-2107
2020,10,25,19,6236,8883,6727,-2156
2020,10,25,20,6375,9029,6883,-2146
2020,10,25,21,6370,9067,7020,-2047
2020,10,25,22,6250,8939,6856,-2083
2020,10,25,23,6015,8491,6423,-2068
2020,10,26,0,5868,8279,6285,-1994
2020,10,26,1,5547,7784,5963,-1821
2020,10,26,2,5139,7197,5383,-1814
2020,10,26,3,4671,6540,4891,-1649
2020,10,26,4,4225,5861,4397,-1464
2020,10,26,5,4138,5336,4006,-1330
2020,10,26,6,3851,4946,3702,-1244
2020,10,26,7,3658,4665,3476,-1189
2020,10,26,8,3540,4511,3339,-1172
2020,10,26,9,3497,4500,3328,-1172
2020,10,26,10,3678,4672,3445,-1227
2020,10,26,11,3975,5102,3840,-1262
2020,10,26,12,4252,5449,4197,-1252
2020,10,26,13,4435,5752,4509,-1243
2020,10,26,14,4804,6215,4836,-1379
2020,10,26,15,5437,6839,5332,-1507
2020,10,26,16,5893,7492,6076,-1416
2020,10,26,17,6232,8213,6547,-1666
2020,10,26,18,6540,8726,7096,-1630
2020,10,26,19,6748,9103,7487,-1616
2020,10,26,20,6886,9333,7698,-1635
2020,10,26,21,6950,9412,7788,-1624
2020,10,26,22,6887,9231,7574,-1657
2020,10,26,23,6649,8859,7284,-1575
2020,10,27,0,6526,8685,7112,-1573
2020,10,27,1,6172,8188,6528,-1660
2020,10,27,2,5675,7540,5730,-1810
2020,10,27,3,5185,6905,5217,-1688
2020,10,27,4,4700,6253,4669,-1584
2020,10,27,5,4356,5748,4282,-1466
2020,10,27,6,4057,5352,3992,-1360
2020,10,27,7,3833,5062,3782,-1280
2020,10,27,8,3728,4916,3639,-1277
2020,10,27,9,3726,4885,3599,-1286
2020,10,27,10,3880,5091,3744,-1347
2020,10,27,11,4185,5542,4114,-1428
2020,10,27,12,4433,5877,4500,-1377
2020,10,27,13,4594,6128,4747,-1381
2020,10,27,14,5023,6672,5154,-1518
2020,10,27,15,5521,7325,5744,-1581
2020,10,27,16,5979,7917,6493,-1424
2020,10,27,17,6396,8499,7114,-1385
2020,10,27,18,6785,8969,7363,-1606
2020,10,27,19,7017,9193,7548,-1645
2020,10,27,20,7143,9307,7642,-1665
2020,10,27,21,7198,9271,7600,-1671
2020,10,27,22,7082,9058,7410,-1648
2020,10,27,23,6796,8728,7101,-1627
2020,10,28,0,6618,8556,7153,-1403
2020,10,28,1,6218,8058,6504,-1554
2020,10,28,2,5729,7490,5705,-1785
2020,10,28,3,5215,6829,5149,-1680
2020,10,28,4,4720,6186,4595,-1591
2020,10,28,5,4457,5669,4236,-1433
2020,10,28,6,4102,5261,3908,-1353
2020,10,28,7,3894,5006,3697,-1309
2020,10,28,8,3783,4864,3599,-1265
2020,10,28,9,3766,4889,3589,-1300
2020,10,28,10,3878,5086,3743,-1343
2020,10,28,11,4194,5531,4103,-1428
2020,10,28,12,4429,5848,4284,-1564
2020,10,28,13,4606,6079,4510,-1569
2020,10,28,14,5034,6604,4863,-1741
2020,10,28,15,5544,7251,5495,-1756
2020,10,28,16,5988,7935,6259,-1676
2020,10,28,17,6481,8580,6927,-1653
2020,10,28,18,6897,9117,7454,-1663
2020,10,28,19,7175,9531,7801,-1730
2020,10,28,20,7397,9725,7924,-1801
2020,10,28,21,7467,9703,7831,-1872
2020,10,28,22,7332,9581,7728,-1853
2020,10,28,23,7009,9167,7426,-1741
2020,10,29,0,6835,8856,7199,-1657
2020,10,29,1,6463,8280,6435,-1845
2020,10,29,2,5932,7621,5689,-1932
2020,10,29,3,5441,6958,5016,-1942
2020,10,29,4,4940,6301,4612,-1689
2020,10,29,5,4477,5808,4337,-1471
2020,10,29,6,4172,5474,4083,-1391
2020,10,29,7,3963,5194,3862,-1332
2020,10,29,8,3843,5034,3733,-1301
2020,10,29,9,3802,5013,3708,-1305
2020,10,29,10,3965,5206,3853,-1353
2020,10,29,11,4341,5656,4221,-1435
2020,10,29,12,4578,5988,4564,-1424
2020,10,29,13,4783,6260,4845,-1415
2020,10,29,14,5157,6762,5197,-1565
2020,10,29,15,5701,7378,5729,-1649
2020,10,29,16,6158,7992,6557,-1435
2020,10,29,17,6647,8530,7199,-1331
2020,10,29,18,7031,9000,7670,-1330
2020,10,29,19,7303,9334,7926,-1408
2020,10,29,20,7486,9493,8053,-1440
2020,10,29,21,7529,9558,8055,-1503
2020,10,29,22,7384,9374,7961,-1413
2020,10,29,23,6994,8857,7491,-1366
2020,10,30,0,6677,8545,7172,-1373
2020,10,30,1,6251,8036,6467,-1569
2020,10,30,2,5729,7454,5668,-1786
2020,10,30,3,5166,6759,5130,-1629
2020,10,30,4,4635,6135,4644,-1491
2020,10,30,5,4036,5602,4289,-1313
2020,10,30,6,3682,5164,3941,-1223
2020,10,30,7,3423,4844,3694,-1150
2020,10,30,8,3268,4586,3477,-1109
2020,10,30,9,3227,4468,3390,-1078
2020,10,30,10,3329,4554,3443,-1111
2020,10,30,11,3555,4852,3659,-1193
2020,10,30,12,3780,5013,3862,-1151
2020,10,30,13,3891,5091,3990,-1101
2020,10,30,14,4159,5306,4121,-1185
2020,10,30,15,4417,5528,4254,-1274
2020,10,30,16,4605,5726,4391,-1335
2020,10,30,17,4859,5911,4654,-1257
2020,10,30,18,5154,6137,4916,-1221
2020,10,30,19,5349,6407,5206,-1201
2020,10,30,20,5506,6645,5356,-1289
2020,10,30,21,5492,6773,5537,-1236
2020,10,30,22,5364,6671,5377,-1294
2020,10,30,23,5050,6300,5122,-1178
2020,10,31,0,5028,6078,4905,-1173
2020,10,31,1,4725,5686,4406,-1280
2020,10,31,2,4366,5310,3934,-1376
2020,10,31,3,3995,4898,3643,-1255
2020,10,31,4,3621,4435,3266,-1169
2020,10,31,5,3265,4096,3053,-1043
2020,10,31,6,3007,3798,2810,-988
2020,10,31,7,2837,3608,2663,-945
2020,10,31,8,2757,3525,2590,-935
2020,10,31,9,2719,3491,2546,-945
2020,10,31,10,2741,3551,2595,-956
2020,10,31,11,2834,3739,2729,-1010
2020,10,31,12,2988,3971,2946,-1025
2020,10,31,13,3197,4312,3259,-1053
2020,10,31,14,3614,4740,3558,-1182
2020,10,31,15,3996,5149,3877,-1272
2020,10,31,16,4254,5556,4191,-1365
2020,10,31,17,4743,6007,4603,-1404
2020,10,31,18,5177,6446,4819,-1627
2020,10,31,19,5517,6886,5246,-1640
2020,10,31,20,5767,7228,5552,-1676
2020,10,31,21,5905,7399,5781,-1618
2020,10,31,22,5813,7318,5734,-1584
2020,10,31,23,5481,6905,5376,-1529
2020,11,1,0,5249,6627,5121,-1506
2020,11,1,1,4921,6292,4708,-1584
2020,11,1,2,4601,5935,4437,-1498
2020,11,1,3,4304,5543,4156,-1387
2020,11,1,4,3931,5080,3821,-1259
2020,11,1,5,3702,4865,3805,-1060
2020,11,1,6,3390,4588,3586,-1002
2020,11,1,7,3241,4412,3448,-964
2020,11,1,8,3057,4313,3372,-941
2020,11,1,9,3012,4226,3280,-946
2020,11,1,10,3047,4203,3253,-950
2020,11,1,11,3107,4266,3302,-964
2020,11,1,12,3326,4448,3428,-1020
2020,11,1,13,3798,4823,3749,-1074
2020,11,1,14,4280,5516,4278,-1238
2020,11,1,15,4703,6209,4650,-1559
2020,11,1,16,5150,6833,4897,-1936
2020,11,1,17,5560,7346,5363,-1983
2020,11,1,18,5828,7729,5796,-1933
2020,11,1,19,5972,7860,6033,-1827
2020,11,1,20,6120,7956,6124,-1832
2020,11,1,21,6127,7937,6083,-1854
2020,11,1,22,6006,7772,5942,-1830
2020,11,1,23,5976,7603,5664,-1939
2020,11,2,0,5645,7532,5651,-1881
2020,11,2,1,5280,7122,5242,-1880
2020,11,2,2,4813,6680,4879,-1801
2020,11,2,3,4358,6127,4533,-1594
2020,11,2,4,3823,5524,4172,-1352
2020,11,2,5,-9999,4985,3748,-1237
2020,11,2,6,3565,4413,3362,-1051
2020,11,2,7,3333,4141,3107,-1034
2020,11,2,8,3185,3909,2948,-961
2020,11,2,9,3094,3721,2791,-930
2020,11,2,10,3099,3709,2741,-968
2020,11,2,11,3318,3891,2861,-1030
2020,11,2,12,3638,4244,3124,-1120
2020,11,2,13,3847,4516,3404,-1112
2020,11,2,14,4013,4709,3592,-1117
2020,11,2,15,4257,4867,3687,-1180
2020,11,2,16,4321,4994,3699,-1295
2020,11,2,17,4460,5135,3763,-1372
2020,11,2,18,4559,5276,3861,-1415
2020,11,2,19,4599,5359,3922,-1437
2020,11,2,20,4650,5436,3992,-1444
2020,11,2,21,4570,5515,4055,-1460
2020,11,2,22,4560,5535,4105,-1430
2020,11,2,23,4601,5611,4135,-1476
2020,11,3,0,4735,5833,4325,-1508
2020,11,3,1,4531,5596,4122,-1474
2020,11,3,2,4293,5244,3874,-1370
2020,11,3,3,3936,4851,3519,-1332
2020,11,3,4,3515,4379,3172,-1207
2020,11,3,5,3233,3978,2817,-1161
2020,11,3,6,2974,3708,2671,-1037
2020,11,3,7,2825,3532,2506,-1026
2020,11,3,8,2759,3414,2406,-1008
2020,11,3,9,2743,3427,2410,-1017
2020,11,3,10,2800,3541,2472,-1069
2020,11,3,11,2958,3877,2742,-1135
2020,11,3,12,3411,4425,3129,-1296
2020,11,3,13,3722,4771,3479,-1292
2020,11,3,14,3808,4858,3612,-1246
2020,11,3,15,3847,4859,3680,-1179
2020,11,3,16,3924,4919,3623,-1296
2020,11,3,17,4084,4995,3570,-1425
2020,11,3,18,4213,5163,3685,-1478
2020,11,3,19,4334,5305,3811,-1494
2020,11,3,20,4470,5479,3953,-1526
2020,11,3,21,4579,5602,4029,-1573
2020,11,3,22,4610,5697,4157,-1540
2020,11,3,23,4622,5784,4237,-1547
2020,11,4,0,4724,5976,4443,-1533
2020,11,4,1,4594,5711,4226,-1485
2020,11,4,2,4295,5366,3945,-1421
2020,11,4,3,3919,4985,3636,-1349
2020,11,4,4,3553,4523,3317,-1206
2020,11,4,5,3211,4087,2953,-1134
2020,11,4,6,2939,3810,2786,-1024
2020,11,4,7,2776,3603,2614,-989
2020,11,4,8,2664,3494,2512,-982
2020,11,4,9,2631,3469,2499,-970
2020,11,4,10,2686,3582,2564,-1018
2020,11,4,11,2897,3841,2749,-1092
2020,11,4,12,3264,4374,3161,-1213
2020,11,4,13,3536,4620,3462,-1158
2020,11,4,14,3659,4769,3606,-1163
2020,11,4,15,3856,4954,3667,-1287
2020,11,4,16,4029,5128,3739,-1389
2020,11,4,17,4212,5352,3900,-1452
2020,11,4,18,4491,5598,4122,-1476
2020,11,4,19,4718,5805,4323,-1482
2020,11,4,20,4899,5997,4603,-1394
2020,11,4,21,5039,6095,4664,-1431
2020,11,4,22,5070,6130,4666,-1464
2020,11,4,23,5008,6175,4769,-1406
2020,11,5,0,5110,6339,4869,-1470
2020,11,5,1,4983,6071,4634,-1437
2020,11,5,2,4684,5689,4211,-1478
2020,11,5,3,4313,5250,3810,-1440
2020,11,5,4,3870,4717,3521,-1196
2020,11,5,5,3496,4242,3105,-1137
2020,11,5,6,3186,3890,2831,-1059
2020,11,5,7,2973,3692,2658,-1034
2020,11,5,8,2834,3580,2573,-1007
2020,11,5,9,2779,3543,2535,-1008
2020,11,5,10,2796,3609,2598,-1011
2020,11,5,11,2977,3886,2796,-1090
2020,11,5,12,3358,4337,3121,-1216
2020,11,5,13,3628,4673,3531,-1142
2020,11,5,14,3886,5029,3875,-1154
2020,11,5,15,4203,5372,4082,-1290
2020,11,5,16,4535,5810,4316,-1494
2020,11,5,17,4929,6244,4767,-1477
2020,11,5,18,5260,6676,5087,-1589
2020,11,5,19,5480,6996,5519,-1477
2020,11,5,20,5660,7206,5687,-1519
2020,11,5,21,5758,7285,5732,-1553
2020,11,5,22,5749,7223,5780,-1443
2020,11,5,23,5746,7094,5665,-1429
2020,11,6,0,5637,7123,5649,-1474
2020,11,6,1,5437,6757,5333,-1424
2020,11,6,2,5126,6331,4885,-1446
2020,11,6,3,4746,5860,4419,-1441
2020,11,6,4,4292,5299,4011,-1288
2020,11,6,5,3932,4709,3455,-1254
2020,11,6,6,3582,4295,3198,-1097
2020,11,6,7,3339,4020,2954,-1066
2020,11,6,8,3176,3835,2812,-1023
2020,11,6,9,3097,3769,2753,-1016
2020,11,6,10,3092,3807,2780,-1027
2020,11,6,11,3236,4044,2978,-1066
2020,11,6,12,3625,4489,3320,-1169
2020,11,6,13,3902,4836,3683,-1153
2020,11,6,14,4253,5235,4036,-1199
2020,11,6,15,4545,5683,4304,-1379
2020,11,6,16,4937,6169,4523,-1646
2020,11,6,17,5297,6565,4950,-1615
2020,11,6,18,5580,6952,5282,-1670
2020,11,6,19,5780,7153,5477,-1676
2020,11,6,20,5899,7325,5579,-1746
2020,11,6,21,5935,7352,5649,-1703
2020,11,6,22,5858,7265,5598,-1667
2020,11,6,23,5785,7096,5403,-1693
2020,11,7,0,5682,7048,5356,-1692
2020,11,7,1,5357,6679,5004,-1675
2020,11,7,2,5072,6270,4629,-1641
2020,11,7,3,4751,5859,4260,-1599
2020,11,7,4,4391,5403,4001,-1402
2020,11,7,5,4076,4959,3640,-1319
2020,11,7,6,3675,4563,3415,-1148
2020,11,7,7,3411,4304,3197,-1107
2020,11,7,8,3239,4125,3050,-1075
2020,11,7,9,3132,4044,3001,-1043
2020,11,7,10,3081,4012,2968,-1044
2020,11,7,11,3098,4096,3026,-1070
2020,11,7,12,3209,4293,3173,-1120
2020,11,7,13,3463,4614,3468,-1146
2020,11,7,14,3910,5286,3998,-1288
2020,11,7,15,4360,5980,4500,-1480
2020,11,7,16,4814,6549,4997,-1552
2020,11,7,17,5131,6976,5305,-1671
2020,11,7,18,5441,7284,5325,-1959
2020,11,7,19,5630,7377,5451,-1926
2020,11,7,20,5734,7309,5429,-1880
2020,11,7,21,5722,7103,5237,-1866
2020,11,7,22,5629,6920,5024,-1896
2020,11,7,23,5552,6896,5074,-1822
2020,11,8,0,5503,6902,5007,-1895
2020,11,8,1,5219,6630,4856,-1774
2020,11,8,2,4902,6260,4523,-1737
2020,11,8,3,4587,5966,4349,-1617
2020,11,8,4,4243,5558,4143,-1415
2020,11,8,5,3936,5130,3796,-1334
2020,11,8,6,3665,4762,3595,-1167
2020,11,8,7,3394,4508,3384,-1124
2020,11,8,8,3167,4288,3229,-1059
2020,11,8,9,3077,4186,3137,-1049
2020,11,8,10,3027,4123,3079,-1044
2020,11,8,11,3008,4162,3105,-1057
2020,11,8,12,3081,4323,3213,-1110
2020,11,8,13,3314,4565,3432,-1133
2020,11,8,14,3829,5135,3874,-1261
2020,11,8,15,4347,5724,4213,-1511
2020,11,8,16,4775,6185,4434,-1751
2020,11,8,17,5088,6590,4725,-1865
2020,11,8,18,5379,6830,5042,-1788
2020,11,8,19,5590,6914,5119,-1795
2020,11,8,20,5681,6877,5078,-1799
2020,11,8,21,5677,6765,4962,-1803
2020,11,8,22,5617,6742,4929,-1813
2020,11,8,23,5639,6853,4914,-1939
2020,11,9,0,5580,6990,5010,-1980
2020,11,9,1,5367,6763,4850,-1913
2020,11,9,2,5070,6448,4629,-1819
2020,11,9,3,4713,6092,4372,-1720
2020,11,9,4,4309,5668,4170,-1498
2020,11,9,5,3960,5219,3840,-1379
2020,11,9,6,3798,4866,3630,-1236
2020,11,9,7,3537,4650,3441,-1209
2020,11,9,8,3384,4520,3346,-1174
2020,11,9,9,3327,4471,3305,-1166
2020,11,9,10,3354,4556,3378,-1178
2020,11,9,11,3514,4841,3590,-1251
2020,11,9,12,3901,5358,4021,-1337
2020,11,9,13,4161,5746,4403,-1343
2020,11,9,14,4459,6040,4652,-1388
2020,11,9,15,4724,6361,4800,-1561
2020,11,9,16,4988,6645,4864,-1781
2020,11,9,17,5152,6938,5065,-1873
2020,11,9,18,5302,7115,5191,-1924
2020,11,9,19,5415,7171,5251,-1920
2020,11,9,20,5508,7110,5249,-1861
2020,11,9,21,5627,6998,5141,-1857
2020,11,9,22,5710,7004,5128,-1876
2020,11,9,23,5808,7221,5285,-1936
2020,11,10,0,5912,7419,5404,-2015
2020,11,10,1,5646,7205,5347,-1858
2020,11,10,2,5371,6862,5070,-1792
2020,11,10,3,4992,6453,4717,-1736
2020,11,10,4,4575,6007,4472,-1535
2020,11,10,5,4208,5551,4000,-1551
2020,11,10,6,3963,5148,3649,-1499
2020,11,10,7,3712,4887,3441,-1446
2020,11,10,8,3570,4739,3331,-1408
2020,11,10,9,3494,4690,3317,-1373
2020,11,10,10,3516,4695,3286,-1409
2020,11,10,11,3701,4932,3455,-1477
2020,11,10,12,4073,5402,3913,-1489
2020,11,10,13,4306,5789,4356,-1433
2020,11,10,14,4618,6196,4786,-1410
2020,11,10,15,4967,6658,5195,-1463
2020,11,10,16,5312,7174,5426,-1748
2020,11,10,17,5675,7647,5824,-1823
2020,11,10,18,5949,7833,6027,-1806
2020,11,10,19,6162,7882,6149,-1733
2020,11,10,20,6322,7898,6203,-1695
2020,11,10,21,6396,7980,6238,-1742
2020,11,10,22,6374,7968,6238,-1730
2020,11,10,23,6369,7923,6111,-1812
2020,11,11,0,6378,7953,6124,-1829
2020,11,11,1,6068,7585,5782,-1803
2020,11,11,2,5692,7176,5407,-1769
2020,11,11,3,5275,6792,5080,-1712
2020,11,11,4,4791,6258,4684,-1574
2020,11,11,5,4401,5692,4131,-1561
2020,11,11,6,4231,5278,3743,-1535
2020,11,11,7,3972,5011,3567,-1444
2020,11,11,8,3789,4884,3456,-1428
2020,11,11,9,3701,4844,3432,-1412
2020,11,11,10,3703,4903,3478,-1425
2020,11,11,11,3877,5110,3634,-1476
2020,11,11,12,4208,5546,3960,-1586
2020,11,11,13,4459,5823,4288,-1535
2020,11,11,14,4778,6083,4576,-1507
2020,11,11,15,5220,6421,4897,-1524
2020,11,11,16,5664,6693,4997,-1696
2020,11,11,17,5950,6910,5213,-1697
2020,11,11,18,6236,7000,5232,-1768
2020,11,11,19,6524,7090,5458,-1632
2020,11,11,20,6644,7062,5402,-1660
2020,11,11,21,6638,7075,5368,-1707
2020,11,11,22,6542,7034,5164,-1870
2020,11,11,23,6502,7107,5317,-1790
2020,11,12,0,6558,7236,5377,-1859
2020,11,12,1,6189,6996,5261,-1735
2020,11,12,2,5811,6611,4896,-1715
2020,11,12,3,5393,6267,4633,-1634
2020,11,12,4,4922,5860,4344,-1516
2020,11,12,5,4468,5383,3802,-1581
2020,11,12,6,3945,4993,3512,-1481
2020,11,12,7,3705,4739,3338,-1401
2020,11,12,8,3554,4580,3188,-1392
2020,11,12,9,3484,4514,3121,-1393
2020,11,12,10,3503,4557,3167,-1390
2020,11,12,11,3708,4751,3307,-1444
2020,11,12,12,4052,5098,3581,-1517
2020,11,12,13,4275,5464,3980,-1484
2020,11,12,14,4527,5847,4426,-1421
2020,11,12,15,4798,6237,4794,-1443
2020,11,12,16,4989,6563,4961,-1602
2020,11,12,17,5244,6902,5248,-1654
2020,11,12,18,5322,7254,5548,-1706
2020,11,12,19,5388,7492,5768,-1724
2020,11,12,20,5389,7575,5818,-1757
2020,11,12,21,5505,7587,5772,-1815
2020,11,12,22,5519,7520,5694,-1826
2020,11,12,23,5578,7441,5592,-1849
2020,11,13,0,5660,7489,5573,-1916
2020,11,13,1,5430,7120,5221,-1899
2020,11,13,2,5176,6678,4955,-1723
2020,11,13,3,4844,6234,4675,-1559
2020,11,13,4,4448,5718,4331,-1387
2020,11,13,5,4072,5204,3711,-1493
2020,11,13,6,3677,4726,3373,-1353
2020,11,13,7,3416,4417,3116,-1301
2020,11,13,8,3253,4237,2962,-1275
2020,11,13,9,3167,4139,2877,-1262
2020,11,13,10,3155,4161,2883,-1278
2020,11,13,11,3308,4358,3028,-1330
2020,11,13,12,3656,4777,3360,-1417
2020,11,13,13,3905,5112,3721,-1391
2020,11,13,14,4270,5457,4096,-1361
2020,11,13,15,4646,5796,4441,-1355
2020,11,13,16,5006,6140,4580,-1560
2020,11,13,17,5435,6474,4830,-1644
2020,11,13,18,5729,6811,5120,-1691
2020,11,13,19,5967,7061,5329,-1732
2020,11,13,20,6166,7206,5500,-1706
2020,11,13,21,6198,7229,5587,-1642
2020,11,13,22,6115,7086,5444,-1642
2020,11,13,23,5954,6904,5286,-1618
2020,11,14,0,5827,6835,5172,-1663
2020,11,14,1,5457,6433,4825,-1608
2020,11,14,2,5125,6062,4523,-1539
2020,11,14,3,4787,5695,4232,-1463
2020,11,14,4,4382,5263,3896,-1367
2020,11,14,5,3931,4804,3545,-1259
2020,11,14,6,3545,4438,3352,-1086
2020,11,14,7,3287,4119,3117,-1002
2020,11,14,8,3091,3930,2960,-970
2020,11,14,9,2994,3806,2860,-946
2020,11,14,10,2940,3783,2818,-965
2020,11,14,11,2953,3859,2877,-982
2020,11,14,12,3010,4056,2998,-1058
2020,11,14,13,3182,4286,3226,-1060
2020,11,14,14,3598,4805,3635,-1170
2020,11,14,15,4077,5379,4053,-1326
2020,11,14,16,4406,5837,4341,-1496
2020,11,14,17,4823,6317,4809,-1508
2020,11,14,18,5174,6815,5365,-1450
2020,11,14,19,5407,7136,5773,-1363
2020,11,14,20,5536,7340,5799,-1541
2020,11,14,21,5534,7396,5912,-1484
2020,11,14,22,5490,7272,5815,-1457
2020,11,14,23,5430,7062,5620,-1442
2020,11,15,0,5358,6969,5662,-1307
2020,11,15,1,5082,6557,5256,-1301
2020,11,15,2,4773,6185,4771,-1414
2020,11,15,3,4457,5803,4421,-1382
2020,11,15,4,4128,5377,4030,-1347
2020,11,15,5,3829,4924,3633,-1291
2020,11,15,6,3472,4519,3386,-1133
2020,11,15,7,3213,4197,3143,-1054
2020,11,15,8,3024,4032,3019,-1013
2020,11,15,9,2938,3923,2930,-993
2020,11,15,10,2876,3891,2907,-984
2020,11,15,11,2876,3948,2934,-1014
2020,11,15,12,2920,4136,3088,-1048
2020,11,15,13,3121,4371,3321,-1050
2020,11,15,14,3650,4971,3763,-1208
2020,11,15,15,4203,5729,4343,-1386
2020,11,15,16,4790,6401,4881,-1520
2020,11,15,17,5131,7066,5614,-1452
2020,11,15,18,5458,7616,6180,-1436
2020,11,15,19,5700,7918,6542,-1376
2020,11,15,20,5875,8134,6706,-1428
2020,11,15,21,5895,8175,6741,-1434
2020,11,15,22,5826,8026,6658,-1368
2020,11,15,23,5765,7816,6511,-1305
2020,11,16,0,5681,7659,6317,-1342
2020,11,16,1,5385,7150,5991,-1159
2020,11,16,2,5044,6706,5486,-1220
2020,11,16,3,4646,6227,4809,-1418
2020,11,16,4,4184,5674,4243,-1431
2020,11,16,5,3757,5099,3782,-1317
2020,11,16,6,3657,4690,3529,-1161
2020,11,16,7,3375,4417,3290,-1127
2020,11,16,8,3183,4220,3126,-1094
2020,11,16,9,3101,4120,3039,-1081
2020,11,16,10,3103,4171,3074,-1097
2020,11,16,11,3239,4414,3259,-1155
2020,11,16,12,3596,4846,3622,-1224
2020,11,16,13,3858,5203,4031,-1172
2020,11,16,14,4135,5484,4302,-1182
2020,11,16,15,4452,5826,4534,-1292
2020,11,16,16,4692,6159,4740,-1419
2020,11,16,17,5001,6499,5025,-1474
2020,11,16,18,5207,6807,5388,-1419
2020,11,16,19,5338,7093,5917,-1176
2020,11,16,20,5362,7322,6183,-1139
2020,11,16,21,5350,7407,6307,-1100
2020,11,16,22,5288,7314,6183,-1131
2020,11,16,23,5229,7138,6017,-1121
2020,11,17,0,5358,7165,5987,-1178
2020,11,17,1,5149,6715,5575,-1140
2020,11,17,2,4791,6239,4973,-1266
2020,11,17,3,4386,5684,4298,-1386
2020,11,17,4,3913,5118,3862,-1256
2020,11,17,5,3513,4546,3338,-1208
2020,11,17,6,3297,4107,3047,-1060
2020,11,17,7,3058,3829,2813,-1016
2020,11,17,8,2903,3639,2656,-983
2020,11,17,9,2830,3568,2604,-964
2020,11,17,10,2854,3616,2615,-1001
2020,11,17,11,3033,3868,2809,-1059
2020,11,17,12,3436,4313,3121,-1192
2020,11,17,13,3716,4602,3440,-1162
2020,11,17,14,3839,4793,3633,-1160
2020,11,17,15,3947,4894,3609,-1285
2020,11,17,16,4057,4995,3575,-1420
2020,11,17,17,4203,5112,3670,-1442
2020,11,17,18,4323,5278,3808,-1470
2020,11,17,19,4436,5429,3952,-1477
2020,11,17,20,4510,5597,4086,-1511
2020,11,17,21,4629,5724,4177,-1547
2020,11,17,22,4664,5749,4199,-1550
2020,11,17,23,4615,5772,4270,-1502
2020,11,18,0,4758,5952,4442,-1510
2020,11,18,1,4586,5669,4201,-1468
2020,11,18,2,4302,5359,3872,-1487
2020,11,18,3,3986,4965,3539,-1426
2020,11,18,4,3637,4507,3299,-1208
2020,11,18,5,3272,4064,2883,-1181
2020,11,18,6,2986,3791,2747,-1044
2020,11,18,7,2845,3621,2600,-1021
2020,11,18,8,2787,3541,2533,-1008
2020,11,18,9,2783,3539,2504,-1035
2020,11,18,10,2855,3648,2580,-1068
2020,11,18,11,3041,3969,2800,-1169
2020,11,18,12,3490,4492,3178,-1314
2020,11,18,13,3813,4820,3535,-1285
2020,11,18,14,3926,4941,3662,-1279
2020,11,18,15,3920,4935,3583,-1352
2020,11,18,16,3920,4973,3538,-1435
2020,11,18,17,3970,5051,3606,-1445
2020,11,18,18,4015,5150,3695,-1455
2020,11,18,19,4075,5229,3778,-1451
2020,11,18,20,4121,5275,3853,-1422
2020,11,18,21,4203,5303,3879,-1424
2020,11,18,22,4273,5366,3914,-1452
2020,11,18,23,4386,5577,4072,-1505
2020,11,19,0,4509,5838,4323,-1515
2020,11,19,1,4340,5656,4157,-1499
2020,11,19,2,4122,5383,3919,-1464
2020,11,19,3,3855,5034,3616,-1418
2020,11,19,4,3476,4585,3383,-1202
2020,11,19,5,3186,4162,2990,-1172
2020,11,19,6,2956,3864,2803,-1061
2020,11,19,7,2819,3673,2643,-1030
2020,11,19,8,2749,3582,2573,-1009
2020,11,19,9,2726,3560,2560,-1000
2020,11,19,10,2788,3666,2602,-1064
2020,11,19,11,2978,3987,2840,-1147
2020,11,19,12,3367,4521,3237,-1284
2020,11,19,13,3635,4835,3535,-1300
2020,11,19,14,3754,4965,3714,-1251
2020,11,19,15,3848,5026,3657,-1369
2020,11,19,16,3961,5141,3752,-1389
2020,11,19,17,4043,5214,3856,-1358
2020,11,19,18,4112,5292,3885,-1407
2020,11,19,19,4236,5320,3899,-1421
2020,11,19,20,4340,5333,3957,-1376
2020,11,19,21,4415,5379,4022,-1357
2020,11,19,22,4442,5464,4092,-1372
2020,11,19,23,4539,5710,4319,-1391
2020,11,20,0,4645,5913,4485,-1428
2020,11,20,1,4475,5765,4374,-1391
2020,11,20,2,4195,5511,4097,-1414
2020,11,20,3,3876,5119,3731,-1388
2020,11,20,4,3497,4650,3396,-1254
2020,11,20,5,3211,4182,3014,-1168
2020,11,20,6,2958,3856,2827,-1029
2020,11,20,7,2776,3642,2657,-985
2020,11,20,8,2671,3512,2560,-952
2020,11,20,9,2630,3491,2538,-953
2020,11,20,10,2670,3581,2596,-985
2020,11,20,11,2852,3858,2805,-1053
2020,11,20,12,3222,4298,3151,-1147
2020,11,20,13,3494,4638,3500,-1138
2020,11,20,14,3652,4895,3749,-1146
2020,11,20,15,3890,5106,3810,-1296
2020,11,20,16,4083,5345,3883,-1462
2020,11,20,17,4200,5561,4060,-1501
2020,11,20,18,4424,5722,4133,-1589
2020,11,20,19,4611,5882,4372,-1510
2020,11,20,20,4766,5973,4508,-1465
2020,11,20,21,4831,6026,4516,-1510
2020,11,20,22,4793,6097,4628,-1469
2020,11,20,23,4751,6032,4600,-1432
2020,11,21,0,4826,6128,4712,-1416
2020,11,21,1,4632,5877,4354,-1523
2020,11,21,2,4371,5574,4026,-1548
2020,11,21,3,4106,5230,3788,-1442
2020,11,21,4,3768,4844,3579,-1265
2020,11,21,5,3381,4375,3212,-1163
2020,11,21,6,3181,4072,3015,-1057
2020,11,21,7,2954,3834,2818,-1016
2020,11,21,8,2793,3674,2694,-980
2020,11,21,9,2746,3595,2620,-975
2020,11,21,10,2718,3587,2612,-975
2020,11,21,11,2764,3685,2687,-998
2020,11,21,12,2839,3872,2828,-1044
2020,11,21,13,3028,4151,3089,-1062
2020,11,21,14,3421,4602,3464,-1138
2020,11,21,15,3846,5040,3679,-1361
2020,11,21,16,4140,5372,3821,-1551
2020,11,21,17,4426,5631,3990,-1641
2020,11,21,18,4647,5790,4100,-1690
2020,11,21,19,4767,5873,4235,-1638
2020,11,21,20,4856,5861,4254,-1607
2020,11,21,21,4879,5806,4243,-1563
2020,11,21,22,4847,5798,4175,-1623
2020,11,21,23,4849,5863,4220,-1643
2020,11,22,0,4850,5974,4307,-1667
2020,11,22,1,4619,5734,4083,-1651
2020,11,22,2,4327,5464,3868,-1596
2020,11,22,3,4080,5157,3696,-1461
2020,11,22,4,3792,4779,3504,-1275
2020,11,22,5,3488,4398,3181,-1217
2020,11,22,6,3130,4032,2960,-1072
2020,11,22,7,2921,3756,2740,-1016
2020,11,22,8,2766,3599,2620,-979
2020,11,22,9,2715,3499,2534,-965
2020,11,22,10,2677,3489,2522,-967
2020,11,22,11,2637,3553,2567,-986
2020,11,22,12,2722,3760,2719,-1041
2020,11,22,13,2900,4046,3021,-1025
2020,11,22,14,3333,4509,3396,-1113
2020,11,22,15,3788,4979,3633,-1346
2020,11,22,16,4091,5318,3783,-1535
2020,11,22,17,4399,5606,4020,-1586
2020,11,22,18,4689,5878,4218,-1660
2020,11,22,19,4847,6015,4411,-1604
2020,11,22,20,5004,6103,4485,-1618
2020,11,22,21,5036,6179,4599,-1580
2020,11,22,22,5009,6213,4636,-1577
2020,11,22,23,5040,6273,4649,-1624
2020,11,23,0,5033,6367,4715,-1652
2020,11,23,1,4860,6062,4437,-1625
2020,11,23,2,4627,5743,4114,-1629
2020,11,23,3,4301,5331,3824,-1507
2020,11,23,4,3909,4906,3608,-1298
2020,11,23,5,3536,4446,3240,-1206
2020,11,23,6,3137,4093,3018,-1075
2020,11,23,7,2919,3867,2872,-995
2020,11,23,8,2786,3714,2746,-968
2020,11,23,9,2751,3630,2660,-970
2020,11,23,10,2757,3677,2687,-990
2020,11,23,11,2905,3889,2844,-1045
2020,11,23,12,3218,4217,3095,-1122
2020,11,23,13,3486,4514,3413,-1101
2020,11,23,14,3793,4836,3689,-1147
2020,11,23,15,4074,5184,3842,-1342
2020,11,23,16,4361,5467,3984,-1483
2020,11,23,17,4715,5720,4154,-1566
2020,11,23,18,5011,5933,4290,-1643
2020,11,23,19,5198,6108,4436,-1672
2020,11,23,20,5277,6246,4574,-1672
2020,11,23,21,5272,6328,4620,-1708
2020,11,23,22,5245,6281,4560,-1721
2020,11,23,23,5098,6239,4519,-1720
2020,11,24,0,5245,6329,4569,-1760
2020,11,24,1,5012,5999,4327,-1672
2020,11,24,2,4770,5631,4044,-1587
2020,11,24,3,4417,5221,3743,-1478
2020,11,24,4,3975,4730,3487,-1243
2020,11,24,5,3457,4287,3098,-1189
2020,11,24,6,3053,3937,2887,-1050
2020,11,24,7,2830,3672,2665,-1007
2020,11,24,8,2684,3543,2559,-984
2020,11,24,9,2636,3521,2518,-1003
2020,11,24,10,2651,3580,2556,-1024
2020,11,24,11,2816,3812,2721,-1091
2020,11,24,12,3135,4218,3012,-1206
2020,11,24,13,3386,4532,3340,-1192
2020,11,24,14,3582,4801,3586,-1215
2020,11,24,15,3751,5004,3649,-1355
2020,11,24,16,3985,5182,3706,-1476
2020,11,24,17,4185,5415,3868,-1547
2020,11,24,18,4328,5640,4108,-1532
2020,11,24,19,4502,5846,4205,-1641
2020,11,24,20,4656,6033,4349,-1684
2020,11,24,21,4705,6127,4435,-1692
2020,11,24,22,4675,6123,4504,-1619
2020,11,24,23,4673,6206,4517,-1689
2020,11,25,0,4819,6319,4598,-1721
2020,11,25,1,4636,6023,4363,-1660
2020,11,25,2,4422,5658,4056,-1602
2020,11,25,3,4098,5305,3796,-1509
2020,11,25,4,3700,4853,3577,-1276
2020,11,25,5,3283,4403,3202,-1201
2020,11,25,6,3058,4037,2988,-1049
2020,11,25,7,2853,3787,2792,-995
2020,11,25,8,2735,3650,2667,-983
2020,11,25,9,2696,3570,2600,-970
2020,11,25,10,2716,3609,2620,-989
2020,11,25,11,2861,3790,2744,-1046
2020,11,25,12,3094,4136,3011,-1125
2020,11,25,13,3376,4477,3363,-1114
2020,11,25,14,3695,4870,3699,-1171
2020,11,25,15,3929,5209,3862,-1347
2020,11,25,16,4202,5550,3988,-1562
2020,11,25,17,4396,5903,4225,-1678
2020,11,25,18,4624,6318,4519,-1799
2020,11,25,19,4827,6636,4818,-1818
2020,11,25,20,5044,6854,5042,-1812
2020,11,25,21,5105,6914,5164,-1750
2020,11,25,22,5039,6832,5137,-1695
2020,11,25,23,4991,6775,5075,-1700
2020,11,26,0,5011,6836,5154,-1682
2020,11,26,1,4816,6508,4830,-1678
2020,11,26,2,4554,6172,4452,-1720
2020,11,26,3,4288,5779,4175,-1604
2020,11,26,4,3931,5300,3921,-1379
2020,11,26,5,3604,4740,3455,-1285
2020,11,26,6,3324,4258,3125,-1133
2020,11,26,7,3081,3929,2868,-1061
2020,11,26,8,2867,3706,2690,-1016
2020,11,26,9,2804,3574,2576,-998
2020,11,26,10,2788,3559,2565,-994
2020,11,26,11,2826,3639,2622,-1017
2020,11,26,12,2929,3821,2759,-1062
2020,11,26,13,3173,4174,3093,-1081
2020,11,26,14,3610,4832,3603,-1229
2020,11,26,15,4204,5602,4061,-1541
2020,11,26,16,4668,6355,4512,-1843
2020,11,26,17,5118,6993,5039,-1954
2020,11,26,18,5361,7446,5456,-1990
2020,11,26,19,5408,7678,5881,-1797
2020,11,26,20,5415,7704,5910,-1794
2020,11,26,21,5298,7550,5797,-1753
2020,11,26,22,5021,7151,5532,-1619
2020,11,26,23,4703,6579,5149,-1430
2020,11,27,0,4539,6256,4772,-1484
2020,11,27,1,4319,5845,4203,-1642
2020,11,27,2,4136,5490,3915,-1575
2020,11,27,3,3931,5196,3711,-1485
2020,11,27,4,3690,4816,3496,-1320
2020,11,27,5,3341,4376,3160,-1216
2020,11,27,6,3196,4025,2966,-1059
2020,11,27,7,2991,3762,2767,-995
2020,11,27,8,2844,3593,2632,-961
2020,11,27,9,2793,3509,2596,-913
2020,11,27,10,2788,3508,2595,-913
2020,11,27,11,2858,3620,2611,-1009
2020,11,27,12,2997,3814,2756,-1058
2020,11,27,13,3173,4043,3036,-1007
2020,11,27,14,3513,4498,3413,-1085
2020,11,27,15,3926,5007,3703,-1304
2020,11,27,16,4286,5476,3919,-1557
2020,11,27,17,4637,5926,4239,-1687
2020,11,27,18,4840,6374,4607,-1767
2020,11,27,19,4990,6692,4826,-1866
2020,11,27,20,5054,6905,5007,-1898
2020,11,27,21,5126,6936,5085,-1851
2020,11,27,22,5060,6836,5040,-1796
2020,11,27,23,4995,6637,4818,-1819
2020,11,28,0,4875,6572,4754,-1818
2020,11,28,1,4660,6200,4479,-1721
2020,11,28,2,4423,5822,4189,-1633
2020,11,28,3,4189,5434,3925,-1509
2020,11,28,4,3879,5035,3718,-1317
2020,11,28,5,3528,4593,3323,-1270
2020,11,28,6,3295,4201,3081,-1120
2020,11,28,7,3046,3907,2848,-1059
2020,11,28,8,2889,3667,2676,-991
2020,11,28,9,2832,3585,2600,-985
2020,11,28,10,2798,3548,2568,-980
2020,11,28,11,2795,3602,2601,-1001
2020,11,28,12,2899,3762,2718,-1044
2020,11,28,13,3074,4000,2988,-1012
2020,11,28,14,3511,4452,3359,-1093
2020,11,28,15,3986,4956,3618,-1338
2020,11,28,16,4293,5377,3814,-1563
2020,11,28,17,4685,5799,4129,-1670
2020,11,28,18,4909,6228,4451,-1777
2020,11,28,19,5100,6562,4776,-1786
2020,11,28,20,5208,6690,4817,-1873
2020,11,28,21,5228,6645,4784,-1861
2020,11,28,22,5112,6457,4626,-1831
2020,11,28,23,5036,6411,4590,-1821
2020,11,29,0,4951,6399,4727,-1672
2020,11,29,1,4737,6112,4399,-1713
2020,11,29,2,4497,5774,4142,-1632
2020,11,29,3,4197,5441,3904,-1537
2020,11,29,4,3886,5012,3678,-1334
2020,11,29,5,3585,4590,3296,-1294
2020,11,29,6,3247,4227,3092,-1135
2020,11,29,7,3024,3934,2886,-1048
2020,11,29,8,2840,3735,2725,-1010
2020,11,29,9,2767,3633,2631,-1002
2020,11,29,10,2695,3588,2589,-999
2020,11,29,11,2731,3635,2634,-1001
2020,11,29,12,2810,3739,2689,-1050
2020,11,29,13,2965,3944,2922,-1022
2020,11,29,14,3399,4422,3307,-1115
2020,11,29,15,3909,4979,3621,-1358
2020,11,29,16,4262,5430,3862,-1568
2020,11,29,17,4637,5870,4171,-1699
2020,11,29,18,4866,6256,4527,-1729
2020,11,29,19,5026,6571,4730,-1841
2020,11,29,20,5165,6805,4959,-1846
2020,11,29,21,5182,6866,5014,-1852
2020,11,29,22,5113,6810,5016,-1794
2020,11,29,23,5044,6703,4972,-1731
2020,11,30,0,5129,6764,4974,-1790
2020,11,30,1,4906,6398,4761,-1637
2020,11,30,2,4628,6032,4405,-1627
2020,11,30,3,4286,5580,4049,-1531
2020,11,30,4,3897,5087,3775,-1312
2020,11,30,5,3444,4584,3343,-1241
2020,11,30,6,3193,4217,3143,-1074
2020,11,30,7,2977,3966,2970,-996
2020,11,30,8,2836,3879,2886,-993
2020,11,30,9,2797,3845,2860,-985
2020,11,30,10,2830,3962,2933,-1029
2020,11,30,11,3060,4271,3179,-1092
2020,11,30,12,3434,4765,3569,-1196
2020,11,30,13,3717,5093,3864,-1229
2020,11,30,14,3902,5275,4083,-1192
2020,11,30,15,4094,5380,4024,-1356
2020,11,30,16,4220,5453,3939,-1514
2020,11,30,17,4338,5565,4011,-1554
2020,11,30,18,4452,5644,4075,-1569
2020,11,30,19,4447,5688,4107,-1581
2020,11,30,20,4406,5661,4102,-1559
2020,11,30,21,4334,5584,4050,-1534
2020,11,30,22,4303,5563,3994,-1569
2020,11,30,23,4416,5771,4133,-1638
2020,12,1,0,4564,6036,4425,-1611
2020,12,1,1,4416,5864,4280,-1584
2020,12,1,2,4112,5567,3989,-1578
2020,12,1,3,3758,5189,3635,-1554
2020,12,1,4,3406,4715,3378,-1337
2020,12,1,5,3246,4269,3054,-1215
2020,12,1,6,3095,3968,3036,-932
2020,12,1,7,2981,3816,2950,-866
2020,12,1,8,2946,3760,2802,-958
2020,12,1,9,3023,3824,2789,-1035
2020,12,1,10,3192,4002,3049,-953
2020,12,1,11,3617,4413,3419,-994
2020,12,1,12,4187,5191,4120,-1071
2020,12,1,13,4576,5640,4502,-1138
2020,12,1,14,4701,5830,4489,-1341
2020,12,1,15,4720,5796,4487,-1309
2020,12,1,16,4628,5688,4194,-1494
2020,12,1,17,4641,5603,4067,-1536
2020,12,1,18,4475,5463,3981,-1482
2020,12,1,19,4358,5334,3913,-1421
2020,12,1,20,4268,5223,3864,-1359
2020,12,1,21,4250,5307,3912,-1395
2020,12,1,22,4340,5547,4106,-1441
2020,12,1,23,4793,6152,4697,-1455
2020,12,2,0,5279,6785,5404,-1381
2020,12,2,1,5463,6893,5486,-1407
2020,12,2,2,5419,6848,5394,-1454
2020,12,2,3,5241,6677,5001,-1676
2020,12,2,4,4963,6330,4710,-1620
2020,12,2,5,4721,5971,4351,-1620
2020,12,2,6,4530,5875,4056,-1819
2020,12,2,7,4477,5864,3979,-1885
2020,12,2,8,4500,5947,4122,-1825
2020,12,2,9,4671,6099,4267,-1832
2020,12,2,10,4943,6344,4590,-1754
2020,12,2,11,5322,6943,5269,-1674
2020,12,2,12,6013,7792,6011,-1781
2020,12,2,13,6354,8368,6543,-1825
2020,12,2,14,6021,8187,6524,-1663
2020,12,2,15,5620,7695,6116,-1579
2020,12,2,16,5070,7118,5613,-1505
2020,12,2,17,4719,6612,5095,-1517
2020,12,2,18,4495,6259,4712,-1547
2020,12,2,19,4365,5945,4400,-1545
2020,12,2,20,4299,5706,4216,-1490
2020,12,2,21,4307,5749,4254,-1495
2020,12,2,22,4311,5966,4416,-1550
2020,12,2,23,4655,6613,4924,-1689
2020,12,3,0,5119,7243,5430,-1813
2020,12,3,1,5217,7329,5604,-1725
2020,12,3,2,5149,7290,5593,-1697
2020,12,3,3,4881,7074,5482,-1592
2020,12,3,4,4557,6684,4992,-1692
2020,12,3,5,4112,6348,4462,-1886
2020,12,3,6,4224,6043,4392,-1651
2020,12,3,7,4162,5982,4364,-1618
2020,12,3,8,4126,5946,4328,-1618
2020,12,3,9,4204,6031,4434,-1597
2020,12,3,10,4335,6211,4586,-1625
2020,12,3,11,4675,6656,5057,-1599
2020,12,3,12,5298,7320,5538,-1782
2020,12,3,13,5488,7573,5899,-1674
2020,12,3,14,5145,7218,5730,-1488
2020,12,3,15,4794,6564,5205,-1359
2020,12,3,16,4588,5921,4555,-1366
2020,12,3,17,4408,5534,4036,-1498
2020,12,3,18,4236,5324,3915,-1409
2020,12,3,19,4192,5196,3823,-1373
2020,12,3,20,4174,5142,3776,-1366
2020,12,3,21,4163,5196,3833,-1363
2020,12,3,22,4189,5296,3931,-1365
2020,12,3,23,4392,5722,4201,-1521
2020,12,4,0,4657,6019,4503,-1516
2020,12,4,1,4638,5900,4404,-1496
2020,12,4,2,4511,5669,4234,-1435
2020,12,4,3,4232,5329,3975,-1354
2020,12,4,4,3827,4844,3642,-1202
2020,12,4,5,3392,4402,3195,-1207
2020,12,4,6,3082,4091,2961,-1130
2020,12,4,7,2919,3884,2764,-1120
2020,12,4,8,2842,3790,2688,-1102
2020,12,4,9,2854,3761,2643,-1118
2020,12,4,10,2919,3831,2694,-1137
2020,12,4,11,3169,4114,2903,-1211
2020,12,4,12,3600,4657,3301,-1356
2020,12,4,13,3856,4982,3594,-1388
2020,12,4,14,3905,5144,3780,-1364
2020,12,4,15,4032,5195,3835,-1360
2020,12,4,16,4047,5245,3830,-1415
2020,12,4,17,4068,5220,3818,-1402
2020,12,4,18,4081,5241,3691,-1550
2020,12,4,19,4109,5251,3600,-1651
2020,12,4,20,4148,5243,3646,-1597
2020,12,4,21,4226,5247,3782,-1465
2020,12,4,22,4229,5366,3870,-1496
2020,12,4,23,4334,5651,4022,-1629
2020,12,5,0,4486,5792,4204,-1588
2020,12,5,1,4338,5615,4097,-1518
2020,12,5,2,4155,5396,3944,-1452
2020,12,5,3,3947,5098,3666,-1432
2020,12,5,4,3651,4715,3270,-1445
2020,12,5,5,3352,4293,3012,-1281
2020,12,5,6,2946,4048,2954,-1094
2020,12,5,7,2830,3815,2804,-1011
2020,12,5,8,2759,3699,2681,-1018
2020,12,5,9,2669,3629,2601,-1028
2020,12,5,10,2671,3630,2600,-1030
2020,12,5,11,2761,3773,2700,-1073
2020,12,5,12,2923,4026,2878,-1148
2020,12,5,13,3121,4367,3214,-1153
2020,12,5,14,3517,4747,3516,-1231
2020,12,5,15,3778,5087,3769,-1318
2020,12,5,16,4017,5223,3938,-1285
2020,12,5,17,4127,5256,4001,-1255
2020,12,5,18,4204,5249,3935,-1314
2020,12,5,19,4221,5258,3950,-1308
2020,12,5,20,4223,5264,3981,-1283
2020,12,5,21,4154,5264,4016,-1248
2020,12,5,22,4110,5304,3977,-1327
2020,12,5,23,4191,5514,4097,-1417
2020,12,6,0,4270,5741,4323,-1418
2020,12,6,1,4133,5588,4197,-1391
2020,12,6,2,4029,5419,4068,-1351
2020,12,6,3,3842,5214,3903,-1311
2020,12,6,4,3605,4920,3540,-1380
2020,12,6,5,3343,4592,3172,-1420
2020,12,6,6,3166,4287,3119,-1168
2020,12,6,7,3036,4111,3054,-1057
2020,12,6,8,3037,4049,2994,-1055
2020,12,6,9,3079,4077,3012,-1065
2020,12,6,10,3141,4122,3031,-1091
2020,12,6,11,3393,4288,3273,-1015
2020,12,6,12,3642,4605,3504,-1101
2020,12,6,13,3981,4971,3828,-1143
2020,12,6,14,4216,5366,4151,-1215
2020,12,6,15,4332,5499,4177,-1322
2020,12,6,16,4217,5334,4034,-1300
2020,12,6,17,4128,5193,3911,-1282
2020,12,6,18,4105,5103,3848,-1255
2020,12,6,19,4054,5032,3792,-1240
2020,12,6,20,4041,5038,3737,-1301
2020,12,6,21,4071,5115,3792,-1323
2020,12,6,22,4076,5305,4056,-1249
2020,12,6,23,4217,5675,4301,-1374
2020,12,7,0,4387,5904,4459,-1445
2020,12,7,1,4396,5757,4413,-1344
2020,12,7,2,4294,5528,4265,-1263
2020,12,7,3,4029,5175,4005,-1170
2020,12,7,4,3706,4726,3635,-1091
2020,12,7,5,3279,4263,3232,-1031
2020,12,7,6,3042,3945,3008,-937
2020,12,7,7,2913,3787,2861,-926
2020,12,7,8,2849,3739,2815,-924
2020,12,7,9,2873,3750,2818,-932
2020,12,7,10,3005,3857,2889,-968
2020,12,7,11,3316,4196,3129,-1067
2020,12,7,12,3852,4736,3561,-1175
2020,12,7,13,4166,5137,3908,-1229
2020,12,7,14,4176,5340,4062,-1278
2020,12,7,15,4110,5462,4167,-1295
2020,12,7,16,4106,5550,4264,-1286
2020,12,7,17,4109,5533,4283,-1250
2020,12,7,18,4003,5555,4244,-1311
2020,12,7,19,3904,5480,4246,-1234
2020,12,7,20,3842,5251,4068,-1183
2020,12,7,21,3823,5209,3993,-1216
2020,12,7,22,3944,5357,4105,-1252
2020,12,7,23,4311,5920,4520,-1400
2020,12,8,0,4467,6430,4873,-1557
2020,12,8,1,4545,6431,4906,-1525
2020,12,8,2,4462,6200,4723,-1477
2020,12,8,3,4248,5870,4473,-1397
2020,12,8,4,3978,5414,4100,-1314
2020,12,8,5,3757,5065,3835,-1230
2020,12,8,6,3711,4843,3672,-1171
2020,12,8,7,3655,4749,3552,-1197
2020,12,8,8,3698,4789,3570,-1219
2020,12,8,9,3866,4961,3694,-1267
2020,12,8,10,4132,5277,3921,-1356
2020,12,8,11,4520,5898,4546,-1352
2020,12,8,12,5246,6777,5193,-1584
2020,12,8,13,5748,7417,5658,-1759
2020,12,8,14,5571,7415,5757,-1658
2020,12,8,15,4992,7051,5396,-1655
2020,12,8,16,4741,6647,5066,-1581
2020,12,8,17,4498,6258,4784,-1474
2020,12,8,18,4284,5923,4534,-1389
2020,12,8,19,4134,5686,4364,-1322
2020,12,8,20,4009,5505,4240,-1265
2020,12,8,21,3984,5525,4256,-1269
2020,12,8,22,4063,5851,4464,-1387
2020,12,8,23,4580,6590,5331,-1259
2020,12,9,0,4993,7264,5942,-1322
2020,12,9,1,5138,7423,6041,-1382
2020,12,9,2,5140,7365,6002,-1363
2020,12,9,3,4936,7140,5976,-1164
2020,12,9,4,4724,6752,5526,-1226
2020,12,9,5,4499,6407,5150,-1257
2020,12,9,6,4477,6223,4901,-1322
2020,12,9,7,4439,6206,4813,-1393
2020,12,9,8,4492,6277,4869,-1408
2020,12,9,9,4604,6494,4997,-1497
2020,12,9,10,4840,6795,5337,-1458
2020,12,9,11,5282,7411,5804,-1607
2020,12,9,12,6016,8249,6451,-1798
2020,12,9,13,6392,8738,6969,-1769
2020,12,9,14,6090,8433,6776,-1657
2020,12,9,15,5508,7617,6243,-1374
2020,12,9,16,5049,6905,5639,-1266
2020,12,9,17,4744,6322,5046,-1276
2020,12,9,18,4451,5915,4624,-1291
2020,12,9,19,4310,5582,4318,-1264
2020,12,9,20,4228,5425,4226,-1199
2020,12,9,21,4180,5405,4198,-1207
2020,12,9,22,4222,5609,4320,-1289
2020,12,9,23,4559,6215,4864,-1351
2020,12,10,0,4933,6851,5401,-1450
2020,12,10,1,5059,6853,5466,-1387
2020,12,10,2,4869,6843,5429,-1414
2020,12,10,3,4759,7342,5937,-1405
2020,12,10,4,4474,6258,4927,-1331
2020,12,10,5,4100,5874,4630,-1244
2020,12,10,6,3811,5684,4353,-1331
2020,12,10,7,3650,5599,4257,-1342
2020,12,10,8,3611,5599,4271,-1328
2020,12,10,9,3669,5690,4351,-1339
2020,12,10,10,3845,5917,4609,-1308
2020,12,10,11,4215,6400,4763,-1637
2020,12,10,12,4858,7090,5470,-1620
2020,12,10,13,5175,7453,5783,-1670
2020,12,10,14,4948,7217,5822,-1395
2020,12,10,15,4700,6583,5169,-1414
2020,12,10,16,4391,5987,4695,-1292
2020,12,10,17,4197,5551,4280,-1271
2020,12,10,18,4105,5322,4106,-1216
2020,12,10,19,4032,5142,3997,-1145
2020,12,10,20,4016,5060,3930,-1130
2020,12,10,21,4016,5107,3958,-1149
2020,12,10,22,4110,5272,4088,-1184
2020,12,10,23,4328,5643,4364,-1279
2020,12,11,0,4599,6121,4691,-1430
2020,12,11,1,4522,6082,4662,-1420
2020,12,11,2,4404,5955,4657,-1298
2020,12,11,3,4146,5671,4353,-1318
2020,12,11,4,3818,5304,4046,-1258
2020,12,11,5,3480,4945,3728,-1217
2020,12,11,6,3482,4744,3566,-1178
2020,12,11,7,3364,4664,3471,-1193
2020,12,11,8,3348,4707,3484,-1223
2020,12,11,9,3396,4822,3563,-1259
2020,12,11,10,3535,5059,3801,-1258
2020,12,11,11,3948,5566,4035,-1531
2020,12,11,12,4519,6313,4831,-1482
2020,12,11,13,4856,6776,5388,-1388
2020,12,11,14,4767,6671,5215,-1456
2020,12,11,15,4619,6150,4727,-1423
2020,12,11,16,4317,5699,4524,-1175
2020,12,11,17,4131,5413,4294,-1119
2020,12,11,18,4077,5271,4122,-1149
2020,12,11,19,4012,5144,4018,-1126
2020,12,11,20,3985,5155,3996,-1159
2020,12,11,21,4008,5147,4021,-1126
2020,12,11,22,4044,5290,4144,-1146
2020,12,11,23,4247,5572,4335,-1237
2020,12,12,0,4439,5895,4587,-1308
2020,12,12,1,4350,5765,4501,-1264
2020,12,12,2,4191,5612,4331,-1281
2020,12,12,3,4065,5381,4144,-1237
2020,12,12,4,3725,5071,3897,-1174
2020,12,12,5,3451,4737,3578,-1159
2020,12,12,6,3324,4471,3370,-1101
2020,12,12,7,3226,4306,3251,-1055
2020,12,12,8,3143,4186,3124,-1062
2020,12,12,9,3173,4136,3075,-1061
2020,12,12,10,3207,4149,3081,-1068
2020,12,12,11,3264,4259,3151,-1108
2020,12,12,12,3468,4497,3336,-1161
2020,12,12,13,3716,4782,3558,-1224
2020,12,12,14,3954,5136,3830,-1306
2020,12,12,15,4015,5345,4059,-1286
2020,12,12,16,3935,5350,4102,-1248
2020,12,12,17,3981,5299,4090,-1209
2020,12,12,18,3937,5234,4042,-1192
2020,12,12,19,3937,5212,4050,-1162
2020,12,12,20,4015,5205,4096,-1109
2020,12,12,21,3998,5192,4047,-1145
2020,12,12,22,4025,5282,4116,-1166
2020,12,12,23,4172,5494,4252,-1242
2020,12,13,0,4399,5719,4429,-1290
2020,12,13,1,4286,5541,4289,-1252
2020,12,13,2,4051,5330,4146,-1184
2020,12,13,3,3883,5087,3946,-1141
2020,12,13,4,3614,4715,3709,-1006
2020,12,13,5,3302,4340,3382,-958
2020,12,13,6,3159,3949,3034,-915
2020,12,13,7,2922,3718,2854,-864
2020,12,13,8,2770,3593,2744,-849
2020,12,13,9,2714,3565,2708,-857
2020,12,13,10,2687,3576,2723,-853
2020,12,13,11,2721,3718,2794,-924
2020,12,13,12,2843,3875,2961,-914
2020,12,13,13,3000,4164,3150,-1014
2020,12,13,14,3277,4547,3414,-1133
2020,12,13,15,3647,4868,3680,-1188
2020,12,13,16,3867,5047,3845,-1202
2020,12,13,17,4041,5176,3898,-1278
2020,12,13,18,4219,5391,4028,-1363
2020,12,13,19,4343,5557,4125,-1432
2020,12,13,20,4462,5666,4153,-1513
2020,12,13,21,4543,5770,4232,-1538
2020,12,13,22,4607,5850,4287,-1563
2020,12,13,23,4679,6020,4391,-1629
2020,12,14,0,4880,6283,4591,-1692
2020,12,14,1,4746,6042,4462,-1580
2020,12,14,2,4545,5769,4221,-1548
2020,12,14,3,4253,5008,3583,-1425
2020,12,14,4,3863,5025,3783,-1242
2020,12,14,5,3426,4320,3220,-1100
2020,12,14,6,3021,3922,2888,-1034
2020,12,14,7,2805,3674,2684,-990
2020,12,14,8,2696,3533,2579,-954
2020,12,14,9,2666,3508,2548,-960
2020,12,14,10,2734,3620,2621,-999
2020,12,14,11,3013,3902,2835,-1067
2020,12,14,12,3420,4416,3202,-1214
2020,12,14,13,3698,4736,3503,-1233
2020,12,14,14,3837,5004,3810,-1194
2020,12,14,15,3985,5263,3974,-1289
2020,12,14,16,4159,5475,4148,-1327
2020,12,14,17,4276,5582,4225,-1357
2020,12,14,18,4356,5688,4232,-1456
2020,12,14,19,4399,5769,4260,-1509
2020,12,14,20,4410,5865,4292,-1573
2020,12,14,21,4456,5913,4345,-1568
2020,12,14,22,4513,5992,4456,-1536
2020,12,14,23,4737,6233,4617,-1616
2020,12,15,0,4973,6554,4831,-1723
2020,12,15,1,4885,6294,4664,-1630
2020,12,15,2,4647,5936,4477,-1459
2020,12,15,3,4281,5534,4217,-1317
2020,12,15,4,3863,4986,3678,-1308
2020,12,15,5,3456,4432,3230,-1202
2020,12,15,6,3108,3990,2945,-1045
2020,12,15,7,2882,3716,2701,-1015
2020,12,15,8,2777,3607,2599,-1008
2020,12,15,9,2714,3569,2572,-997
2020,12,15,10,2785,3670,2634,-1036
2020,12,15,11,3023,4001,2844,-1157
2020,12,15,12,3484,4557,3260,-1297
2020,12,15,13,3746,4948,3569,-1379
2020,12,15,14,3834,5142,3695,-1447
2020,12,15,15,3853,5178,3707,-1471
2020,12,15,16,3974,5231,3918,-1313
2020,12,15,17,4079,5257,3978,-1279
2020,12,15,18,4145,5335,4040,-1295
2020,12,15,19,4212,5381,4128,-1253
2020,12,15,20,4257,5444,4172,-1272
2020,12,15,21,4283,5498,4225,-1273
2020,12,15,22,4326,5585,4263,-1322
2020,12,15,23,4521,5833,4408,-1425
2020,12,16,0,4742,6199,4646,-1553
2020,12,16,1,4647,6039,4514,-1525
2020,12,16,2,4436,5743,4280,-1463
2020,12,16,3,4136,5360,3868,-1492
2020,12,16,4,3748,4890,3552,-1338
2020,12,16,5,3374,4378,3128,-1250
2020,12,16,6,3021,4037,2913,-1124
2020,12,16,7,2840,3807,2730,-1077
2020,12,16,8,2753,3716,2661,-1055
2020,12,16,9,2758,3716,2650,-1066
2020,12,16,10,2843,3813,2702,-1111
2020,12,16,11,3055,4120,2932,-1188
2020,12,16,12,3502,4639,3334,-1305
2020,12,16,13,3791,4989,3627,-1362
2020,12,16,14,3845,5129,3711,-1418
2020,12,16,15,3873,5231,3747,-1484
2020,12,16,16,3928,5320,3904,-1416
2020,12,16,17,4050,5397,3989,-1408
2020,12,16,18,4114,5543,4107,-1436
2020,12,16,19,4168,5637,4288,-1349
2020,12,16,20,4217,5681,4289,-1392
2020,12,16,21,4262,5762,4360,-1402
2020,12,16,22,4314,5809,4330,-1479
2020,12,16,23,4566,6060,4470,-1590
2020,12,17,0,4807,6228,4579,-1649
2020,12,17,1,4699,6056,4503,-1553
2020,12,17,2,4451,5809,4317,-1492
2020,12,17,3,4150,5461,3924,-1537
2020,12,17,4,3769,4963,3589,-1374
2020,12,17,5,3381,4383,3152,-1231
2020,12,17,6,2956,4060,2983,-1077
2020,12,17,7,2789,3836,2808,-1028
2020,12,17,8,2696,3737,2702,-1035
2020,12,17,9,2685,3715,2724,-991
2020,12,17,10,2769,3802,2772,-1030
2020,12,17,11,3001,4091,2954,-1137
2020,12,17,12,3432,4636,3365,-1271
2020,12,17,13,3739,5067,3707,-1360
2020,12,17,14,3870,5283,3951,-1332
2020,12,17,15,3904,5440,4057,-1383
2020,12,17,16,4000,5438,4032,-1406
2020,12,17,17,4018,5486,4086,-1400
2020,12,17,18,4005,5383,4158,-1225
2020,12,17,19,3992,5310,4153,-1157
2020,12,17,20,3958,5233,4192,-1041
2020,12,17,21,3993,5278,4230,-1048
2020,12,17,22,4125,5484,4362,-1122
2020,12,17,23,4381,5930,4686,-1244
2020,12,18,0,4801,6424,5190,-1234
2020,12,18,1,4830,6416,5170,-1246
2020,12,18,2,4684,6343,5135,-1208
2020,12,18,3,4505,6148,4804,-1344
2020,12,18,4,4224,5764,4077,-1687
2020,12,18,5,3947,5394,3680,-1714
2020,12,18,6,3873,5188,3636,-1552
2020,12,18,7,3786,5111,3548,-1563
2020,12,18,8,3869,5173,3569,-1604
2020,12,18,9,4015,5299,3653,-1646
2020,12,18,10,4193,5590,3962,-1628
2020,12,18,11,4642,6261,4653,-1608
2020,12,18,12,5350,7137,5533,-1604
2020,12,18,13,5807,7842,6212,-1630
2020,12,18,14,5733,7979,6298,-1681
2020,12,18,15,5178,7668,6092,-1576
2020,12,18,16,4824,7159,5488,-1671
2020,12,18,17,4501,6597,5012,-1585
2020,12,18,18,4250,6135,4639,-1496
2020,12,18,19,4113,5780,4316,-1464
2020,12,18,20,3989,5568,4173,-1395
2020,12,18,21,4004,5538,4224,-1314
2020,12,18,22,4035,5704,4336,-1368
2020,12,18,23,4289,6239,4647,-1592
2020,12,19,0,4648,6867,5237,-1630
2020,12,19,1,4708,6991,5335,-1656
2020,12,19,2,4564,6985,5190,-1795
2020,12,19,3,4472,6921,5128,-1793
2020,12,19,4,4321,6639,4812,-1827
2020,12,19,5,4067,6329,4613,-1716
2020,12,19,6,4011,6063,4291,-1772
2020,12,19,7,3890,5917,4191,-1726
2020,12,19,8,3809,5879,4145,-1734
2020,12,19,9,3836,5881,4144,-1737
2020,12,19,10,3938,5972,4200,-1772
2020,12,19,11,4076,6191,4432,-1759
2020,12,19,12,4359,6524,4827,-1697
2020,12,19,13,4690,6944,5297,-1647
2020,12,19,14,4840,7033,5439,-1594
2020,12,19,15,4732,6663,4983,-1680
2020,12,19,16,4529,6184,4477,-1707
2020,12,19,17,4358,5671,4146,-1525
2020,12,19,18,4193,5336,3923,-1413
2020,12,19,19,4002,5113,3764,-1349
2020,12,19,20,3964,5046,3723,-1323
2020,12,19,21,3875,5022,3711,-1311
2020,12,19,22,3858,5119,3788,-1331
2020,12,19,23,4115,5392,3977,-1415
2020,12,20,0,4346,5695,4182,-1513
2020,12,20,1,4244,5591,4108,-1483
2020,12,20,2,4145,5462,4001,-1461
2020,12,20,3,4012,5283,3797,-1486
2020,12,20,4,3754,5000,3587,-1413
2020,12,20,5,3486,4690,3298,-1392
2020,12,20,6,3251,4428,3150,-1278
2020,12,20,7,3087,4247,3010,-1237
2020,12,20,8,2968,4160,2947,-1213
2020,12,20,9,2944,4173,2945,-1228
2020,12,20,10,2959,4235,2992,-1243
2020,12,20,11,3056,4409,3104,-1305
2020,12,20,12,3205,4680,3305,-1375
2020,12,20,13,3400,4980,3592,-1388
2020,12,20,14,3700,5326,3868,-1458
2020,12,20,15,3796,5495,3977,-1518
2020,12,20,16,3840,5600,4046,-1554
2020,12,20,17,3811,5602,4072,-1530
2020,12,20,18,3856,5626,4105,-1521
2020,12,20,19,3852,5472,4019,-1453
2020,12,20,20,3859,5348,3940,-1408
2020,12,20,21,3846,5260,3864,-1396
2020,12,20,22,3906,5401,4002,-1399
2020,12,20,23,4126,5704,4223,-1481
2020,12,21,0,4395,5877,4352,-1525
2020,12,21,1,4286,5732,4249,-1483
2020,12,21,2,4145,5512,4077,-1435
2020,12,21,3,3878,5189,3760,-1429
2020,12,21,4,3580,4779,3468,-1311
2020,12,21,5,3258,4326,3115,-1211
2020,12,21,6,3127,4044,2957,-1087
2020,12,21,7,2954,3814,2800,-1014
2020,12,21,8,2888,3683,2718,-965
2020,12,21,9,2890,3654,2681,-973
2020,12,21,10,2969,3702,2696,-1006
2020,12,21,11,3201,3969,2853,-1116
2020,12,21,12,3545,4370,3157,-1213
2020,12,21,13,3892,4768,3530,-1238
2020,12,21,14,4101,5052,3840,-1212
2020,12,21,15,4130,5206,3976,-1230
2020,12,21,16,4145,5287,4047,-1240
2020,12,21,17,4114,5303,4058,-1245
2020,12,21,18,4089,5279,4047,-1232
2020,12,21,19,4090,5222,4028,-1194
2020,12,21,20,4073,5215,4013,-1202
2020,12,21,21,4053,5235,4044,-1191
2020,12,21,22,4102,5343,4131,-1212
2020,12,21,23,4357,5678,4312,-1366
2020,12,22,0,4693,6103,4660,-1443
2020,12,22,1,4670,6079,4639,-1440
2020,12,22,2,4573,5941,4522,-1419
2020,12,22,3,4368,5739,4388,-1351
2020,12,22,4,4050,5359,3986,-1373
2020,12,22,5,3667,4944,3518,-1426
2020,12,22,6,3306,4564,3208,-1356
2020,12,22,7,3163,4423,3083,-1340
2020,12,22,8,3106,4395,3066,-1329
2020,12,22,9,3115,4461,3069,-1392
2020,12,22,10,3249,4698,3215,-1483
2020,12,22,11,3547,5134,3586,-1548
2020,12,22,12,4028,5735,4048,-1687
2020,12,22,13,4436,6250,4625,-1625
2020,12,22,14,4568,6386,4753,-1633
2020,12,22,15,4539,6102,4454,-1648
2020,12,22,16,4272,5779,4209,-1570
2020,12,22,17,4135,5466,4022,-1444
2020,12,22,18,4024,5262,3890,-1372
2020,12,22,19,3973,5142,3813,-1329
2020,12,22,20,3942,5093,3788,-1305
2020,12,22,21,3985,5128,3810,-1318
2020,12,22,22,3998,5260,3923,-1337
2020,12,22,23,4251,5602,4133,-1469
2020,12,23,0,4539,6085,4478,-1607
2020,12,23,1,4481,6078,4464,-1614
2020,12,23,2,4418,5984,4393,-1591
2020,12,23,3,4239,5821,4162,-1659
2020,12,23,4,3953,5522,3955,-1567
2020,12,23,5,3629,5197,3632,-1565
2020,12,23,6,3360,4980,3509,-1471
2020,12,23,7,3189,4916,3430,-1486
2020,12,23,8,3098,4965,3460,-1505
2020,12,23,9,3108,5088,3533,-1555
2020,12,23,10,3237,5347,3688,-1659
2020,12,23,11,3551,5791,4127,-1664
2020,12,23,12,3966,6403,4818,-1585
2020,12,23,13,4307,6832,5292,-1540
2020,12,23,14,4433,7026,5425,-1601
2020,12,23,15,4418,6463,4819,-1644
2020,12,23,16,4143,5941,4357,-1584
2020,12,23,17,3968,5550,4082,-1468
2020,12,23,18,3935,5313,3923,-1390
2020,12,23,19,3890,5222,3892,-1330
2020,12,23,20,3911,5175,3866,-1309
2020,12,23,21,3933,5235,3898,-1337
2020,12,23,22,3964,5325,3969,-1356
2020,12,23,23,4185,5540,4120,-1420
2020,12,24,0,4450,5885,4353,-1532
2020,12,24,1,4408,5772,4256,-1516
2020,12,24,2,4319,5604,4105,-1499
2020,12,24,3,4125,5399,3906,-1493
2020,12,24,4,3824,5052,3673,-1379
2020,12,24,5,3539,4641,3340,-1301
2020,12,24,6,3298,4300,3159,-1141
2020,12,24,7,3096,4074,2914,-1160
2020,12,24,8,2945,3950,2810,-1140
2020,12,24,9,2885,3904,2756,-1148
2020,12,24,10,2932,3965,2782,-1183
2020,12,24,11,3057,4123,2887,-1236
2020,12,24,12,3202,4423,3107,-1316
2020,12,24,13,3436,4769,3420,-1349
2020,12,24,14,3761,5084,3706,-1378
2020,12,24,15,4071,5252,3810,-1442
2020,12,24,16,4299,5421,3959,-1462
2020,12,24,17,4359,5556,4089,-1467
2020,12,24,18,4470,5634,4137,-1497
2020,12,24,19,4524,5756,4246,-1510
2020,12,24,20,4515,5859,4344,-1515
2020,12,24,21,4493,5929,4393,-1536
2020,12,24,22,4420,6008,4479,-1529
2020,12,24,23,4500,6157,4573,-1584
2020,12,25,0,4529,6215,4653,-1562
2020,12,25,1,4338,5861,4363,-1498
2020,12,25,2,4142,5483,4066,-1417
2020,12,25,3,3987,5136,3697,-1439
2020,12,25,4,3809,4860,3422,-1438
2020,12,25,5,3447,4567,3175,-1392
2020,12,25,6,3249,4336,3064,-1272
2020,12,25,7,3003,4274,2970,-1304
2020,12,25,8,2864,4342,2978,-1364
2020,12,25,9,2818,4532,3090,-1442
2020,12,25,10,2986,4827,3293,-1534
2020,12,25,11,3348,5245,3576,-1669
2020,12,25,12,3614,5944,4071,-1873
2020,12,25,13,4012,6805,4972,-1833
2020,12,25,14,4505,7467,5750,-1717
2020,12,25,15,4713,7551,5777,-1774
2020,12,25,16,4833,7269,5477,-1792
2020,12,25,17,4767,6900,5086,-1814
2020,12,25,18,4686,6532,4769,-1763
2020,12,25,19,4547,6144,4448,-1696
2020,12,25,20,4389,5856,4233,-1623
2020,12,25,21,4385,5696,4127,-1569
2020,12,25,22,4443,5749,4149,-1600
2020,12,25,23,4577,6160,4482,-1678
2020,12,26,0,4922,6654,4893,-1761
2020,12,26,1,5081,6761,4920,-1841
2020,12,26,2,5116,6888,5015,-1873
2020,12,26,3,5064,6915,4891,-2024
2020,12,26,4,5012,6855,4855,-2000
2020,12,26,5,5100,6776,4678,-2098
2020,12,26,6,5268,6726,4700,-2026
2020,12,26,7,5229,6769,4699,-2070
2020,12,26,8,5390,6957,4902,-2055
2020,12,26,9,5573,7195,5053,-2142
2020,12,26,10,5737,7524,5296,-2228
2020,12,26,11,6168,7927,5644,-2283
2020,12,26,12,6482,8439,6214,-2225
2020,12,26,13,6835,8982,6820,-2162
2020,12,26,14,7012,9235,7157,-2078
2020,12,26,15,7001,9030,6863,-2167
2020,12,26,16,6531,8592,6489,-2103
2020,12,26,17,5914,7970,6067,-1903
2020,12,26,18,5437,7391,5525,-1866
2020,12,26,19,5158,6833,4990,-1843
2020,12,26,20,4954,6478,4669,-1809
2020,12,26,21,4955,6322,4657,-1665
2020,12,26,22,4987,6544,4936,-1608
2020,12,26,23,5451,7224,5359,-1865
2020,12,27,0,5960,8028,6080,-1948
2020,12,27,1,6208,8310,6147,-2163
2020,12,27,2,6294,8501,6242,-2259
2020,12,27,3,6255,8531,6267,-2264
2020,12,27,4,6106,8407,6203,-2204
2020,12,27,5,5833,8271,6254,-2017
2020,12,27,6,5819,8172,6140,-2032
2020,12,27,7,5774,8159,6125,-2034
2020,12,27,8,5883,8216,6090,-2126
2020,12,27,9,5973,8364,6013,-2351
2020,12,27,10,6135,8497,5977,-2520
2020,12,27,11,6297,8712,6293,-2419
2020,12,27,12,6516,9001,6698,-2303
2020,12,27,13,6819,9321,7069,-2252
2020,12,27,14,6888,9372,7153,-2219
2020,12,27,15,6459,8733,6628,-2105
2020,12,27,16,5692,7802,5774,-2028
2020,12,27,17,5222,6945,5171,-1774
2020,12,27,18,4842,6240,4498,-1742
2020,12,27,19,4599,5719,4202,-1517
2020,12,27,20,4289,5416,4003,-1413
2020,12,27,21,4118,5289,4007,-1282
2020,12,27,22,4264,5379,4101,-1278
2020,12,27,23,4570,5747,4333,-1414
2020,12,28,0,4966,6267,4721,-1546
2020,12,28,1,5048,6268,4721,-1547
2020,12,28,2,5004,6182,4514,-1668
2020,12,28,3,4846,6005,4271,-1734
2020,12,28,4,4595,5699,4041,-1658
2020,12,28,5,4231,5355,3899,-1456
2020,12,28,6,3974,5162,3657,-1505
2020,12,28,7,3864,5036,3534,-1502
2020,12,28,8,3786,5013,3495,-1518
2020,12,28,9,3823,5109,3555,-1554
2020,12,28,10,3967,5342,3745,-1597
2020,12,28,11,4297,5731,4014,-1717
2020,12,28,12,4700,6263,4394,-1869
2020,12,28,13,4996,6716,4833,-1883
2020,12,28,14,4995,6688,4862,-1826
2020,12,28,15,4767,6291,4561,-1730
2020,12,28,16,4492,5855,4291,-1564
2020,12,28,17,4230,5566,4106,-1460
2020,12,28,18,4130,5324,3955,-1369
2020,12,28,19,3994,5251,3910,-1341
2020,12,28,20,3930,5207,3877,-1330
2020,12,28,21,3938,5198,3886,-1312
2020,12,28,22,3928,5235,3915,-1320
2020,12,28,23,4217,5551,4109,-1442
2020,12,29,0,4600,6002,4438,-1564
2020,12,29,1,4512,5899,4337,-1562
2020,12,29,2,4444,5699,4174,-1525
2020,12,29,3,4216,5373,3873,-1500
2020,12,29,4,3865,4996,3594,-1402
2020,12,29,5,3590,4625,3239,-1386
2020,12,29,6,3265,4346,3092,-1254
2020,12,29,7,3135,4205,2974,-1231
2020,12,29,8,3066,4193,2924,-1269
2020,12,29,9,3091,4229,2939,-1290
2020,12,29,10,3175,4440,3061,-1379
2020,12,29,11,3419,4815,3355,-1460
2020,12,29,12,3797,5357,3763,-1594
2020,12,29,13,4104,5796,4342,-1454
2020,12,29,14,4220,5945,4523,-1422
2020,12,29,15,4135,5714,4238,-1476
2020,12,29,16,4127,5461,4069,-1392
2020,12,29,17,4077,5270,3903,-1367
2020,12,29,18,4055,5201,3869,-1332
2020,12,29,19,3990,5163,3852,-1311
2020,12,29,20,3943,5110,3807,-1303
2020,12,29,21,3941,5159,3831,-1328
2020,12,29,22,4001,5251,3907,-1344
2020,12,29,23,4222,5508,4072,-1436
2020,12,30,0,4526,5927,4380,-1547
2020,12,30,1,4453,5807,4289,-1518
2020,12,30,2,4304,5585,4111,-1474
2020,12,30,3,4068,5299,3817,-1482
2020,12,30,4,3731,4872,3521,-1351
2020,12,30,5,3402,4509,3192,-1317
2020,12,30,6,3120,4167,3004,-1163
2020,12,30,7,2963,3956,2841,-1115
2020,12,30,8,2872,3884,2761,-1123
2020,12,30,9,2838,3912,2762,-1150
2020,12,30,10,2889,4026,2832,-1194
2020,12,30,11,3048,4298,3031,-1267
2020,12,30,12,3352,4727,3372,-1355
2020,12,30,13,3589,5122,3764,-1358
2020,12,30,14,3739,5327,4000,-1327
2020,12,30,15,3831,5377,4035,-1342
2020,12,30,16,3891,5247,3920,-1327
2020,12,30,17,3996,5209,3921,-1288
2020,12,30,18,4024,5238,3933,-1305
2020,12,30,19,4018,5245,3976,-1269
2020,12,30,20,4035,5290,4052,-1238
2020,12,30,21,4071,5276,4010,-1266
2020,12,30,22,4122,5354,4086,-1268
2020,12,30,23,4314,5584,4252,-1332
2020,12,31,0,4578,5898,4452,-1446
2020,12,31,1,4525,5807,4385,-1422
2020,12,31,2,4295,5548,4154,-1394
2020,12,31,3,4030,5234,3850,-1384
2020,12,31,4,3708,4848,3605,-1243
2020,12,31,5,3423,4399,3227,-1172
2020,12,31,6,3139,4039,3004,-1035
2020,12,31,7,2929,3784,2812,-972
2020,12,31,8,2749,3606,2678,-928
2020,12,31,9,2664,3520,2595,-925
2020,12,31,10,2697,3547,2628,-919
2020,12,31,11,2767,3715,2698,-1017
2020,12,31,12,2960,4029,2919,-1110
2020,12,31,13,3147,4301,3161,-1140
2020,12,31,14,3444,4688,3492,-1196
2020,12,31,15,3818,5070,3771,-1299
2020,12,31,16,4047,5362,3998,-1364
2020,12,31,17,4230,5596,4367,-1229
2020,12,31,18,4407,5777,4499,-1278
2020,12,31,19,4514,5916,4601,-1315
2020,12,31,20,4604,6048,4781,-1267
2020,12,31,21,4687,6126,4809,-1317
2020,12,31,22,4673,6219,4895,-1324
2020,12,31,23,4780,6346,4982,-1364
2021,1,1,0,4989,6545,5095,-1450
2021,1,1,1,4767,6223,4837,-1386
2021,1,1,2,4355,5807,4402,-1405
2021,1,1,3,4075,5394,3964,-1430
2021,1,1,4,3799,5007,3675,-1332
2021,1,1,5,3620,4645,3369,-1276
2021,1,1,6,3326,4350,3206,-1144
2021,1,1,7,3121,4121,3032,-1089
2021,1,1,8,2803,3863,2833,-1030
2021,1,1,9,2678,3697,2706,-991
2021,1,1,10,2723,3619,2696,-923
2021,1,1,11,2829,3638,2692,-946
2021,1,1,12,3017,3785,2752,-1033
2021,1,1,13,3154,3930,2890,-1040
2021,1,1,14,3563,4303,3194,-1109
2021,1,1,15,3889,4812,3557,-1255
2021,1,1,16,4207,5330,3930,-1400
2021,1,1,17,4504,5821,4470,-1351
2021,1,1,18,4757,6169,4719,-1450
2021,1,1,19,4894,6384,4962,-1422
2021,1,1,20,5005,6502,5075,-1427
2021,1,1,21,5019,6572,5125,-1447
2021,1,1,22,4913,6598,5170,-1428
2021,1,1,23,4907,6511,5069,-1442
2021,1,2,0,5033,6550,5114,-1436
2021,1,2,1,4805,6212,4816,-1396
2021,1,2,2,4555,5862,4443,-1419
2021,1,2,3,4236,5504,4099,-1405
2021,1,2,4,4013,5112,3765,-1347
2021,1,2,5,3711,4666,3384,-1282
2021,1,2,6,3471,4257,3140,-1117
2021,1,2,7,3277,3926,2932,-994
2021,1,2,8,3122,3726,2740,-986
2021,1,2,9,3093,3603,2645,-958
2021,1,2,10,3066,3572,2637,-935
2021,1,2,11,3045,3656,2656,-1000
2021,1,2,12,3133,3845,2788,-1057
2021,1,2,13,3318,4112,3052,-1060
2021,1,2,14,3592,4540,3392,-1148
2021,1,2,15,3923,5033,3734,-1299
2021,1,2,16,4261,5396,4012,-1384
2021,1,2,17,4527,5664,4387,-1277
2021,1,2,18,4675,5940,4560,-1380
2021,1,2,19,4817,6128,4710,-1418
2021,1,2,20,4935,6224,4800,-1424
2021,1,2,21,4857,6265,4833,-1432
2021,1,2,22,4750,6209,4795,-1414
2021,1,2,23,4797,6244,4825,-1419
2021,1,3,0,4823,6354,4902,-1452
2021,1,3,1,4648,6057,4675,-1382
2021,1,3,2,4439,5783,4340,-1443
2021,1,3,3,4231,5453,4032,-1421
2021,1,3,4,3957,5080,3704,-1376
2021,1,3,5,3604,4693,3414,-1279
2021,1,3,6,3258,4339,3193,-1146
2021,1,3,7,3020,4016,2942,-1074
2021,1,3,8,2783,3795,2799,-996
2021,1,3,9,2662,3682,2683,-999
2021,1,3,10,2682,3652,2645,-1007
2021,1,3,11,2707,3664,2653,-1011
2021,1,3,12,2823,3796,2737,-1059
2021,1,3,13,2978,3996,2949,-1047
2021,1,3,14,3356,4378,3237,-1141
2021,1,3,15,3578,4857,3564,-1293
2021,1,3,16,3891,5111,3789,-1322
2021,1,3,17,3964,5231,3876,-1355
2021,1,3,18,4091,5293,3900,-1393
2021,1,3,19,4058,5220,3856,-1364
2021,1,3,20,4112,5153,3807,-1346
2021,1,3,21,4016,5100,3759,-1341
2021,1,3,22,3960,5161,3799,-1362
2021,1,3,23,4084,5390,3956,-1434
2021,1,4,0,4103,5706,4170,-1536
2021,1,4,1,4002,5607,4118,-1489
2021,1,4,2,3827,5392,3938,-1454
2021,1,4,3,3586,5107,3628,-1479
2021,1,4,4,3395,4690,3328,-1362
2021,1,4,5,3184,4298,3000,-1298
2021,1,4,6,3020,3987,2799,-1188
2021,1,4,7,2875,3845,2692,-1153
2021,1,4,8,2814,3818,2646,-1172
2021,1,4,9,2807,3882,2661,-1221
2021,1,4,10,2951,4078,2798,-1280
2021,1,4,11,3262,4553,3131,-1422
2021,1,4,12,3817,5274,3625,-1649
2021,1,4,13,4267,5916,4154,-1762
2021,1,4,14,4372,6118,4386,-1732
2021,1,4,15,4363,5955,4305,-1650
2021,1,4,16,4153,5745,4156,-1589
2021,1,4,17,4066,5494,4021,-1473
2021,1,4,18,4004,5335,3948,-1387
2021,1,4,19,3924,5201,3850,-1351
2021,1,4,20,3895,5096,3767,-1329
2021,1,4,21,3867,5080,3761,-1319
2021,1,4,22,3931,5224,3797,-1427
2021,1,4,23,4064,5630,4088,-1542
2021,1,5,0,4414,6218,4603,-1615
2021,1,5,1,4436,6276,4628,-1648
2021,1,5,2,4310,6157,4509,-1648
2021,1,5,3,4124,5907,4329,-1578
2021,1,5,4,3809,5606,4073,-1533
2021,1,5,5,3470,5305,3793,-1512
2021,1,5,6,3373,5122,3624,-1498
2021,1,5,7,3304,5055,3538,-1517
2021,1,5,8,3291,5057,3530,-1527
2021,1,5,9,3342,5168,3584,-1584
2021,1,5,10,3476,5412,3749,-1663
2021,1,5,11,3899,5972,4135,-1837
2021,1,5,12,4537,6812,4756,-2056
2021,1,5,13,4929,7376,5230,-2146
2021,1,5,14,4861,7219,5111,-2108
2021,1,5,15,4634,6618,4838,-1780
2021,1,5,16,4493,6026,4429,-1597
2021,1,5,17,4258,5602,4152,-1450
2021,1,5,18,4070,5315,3932,-1383
2021,1,5,19,3976,5152,3825,-1327
2021,1,5,20,3822,5016,3701,-1315
2021,1,5,21,3803,5075,3719,-1356
2021,1,5,22,3878,5207,3858,-1349
2021,1,5,23,4094,5537,3950,-1587
2021,1,6,0,4529,6047,4293,-1754
2021,1,6,1,4560,6031,4272,-1759
2021,1,6,2,4523,5888,4141,-1747
2021,1,6,3,4263,5650,4099,-1551
2021,1,6,4,3994,5305,3844,-1461
2021,1,6,5,3715,4982,3514,-1468
2021,1,6,6,3499,4848,3385,-1463
2021,1,6,7,3472,4831,3349,-1482
2021,1,6,8,3525,4907,3359,-1548
2021,1,6,9,3603,5098,3482,-1616
2021,1,6,10,3839,5460,3743,-1717
2021,1,6,11,4271,6069,4308,-1761
2021,1,6,12,4954,6958,4863,-2095
2021,1,6,13,5366,7548,5495,-2053
2021,1,6,14,5208,7461,5536,-1925
2021,1,6,15,4869,6813,4985,-1828
2021,1,6,16,4609,5924,4397,-1527
2021,1,6,17,4375,5700,4319,-1381
2021,1,6,18,4183,5424,4124,-1300
2021,1,6,19,4007,5202,4005,-1197
2021,1,6,20,3902,5079,3941,-1138
2021,1,6,21,3900,5082,3916,-1166
2021,1,6,22,3987,5274,4055,-1219
2021,1,6,23,4206,5671,4339,-1332
2021,1,7,0,4635,6196,4707,-1489
2021,1,7,1,4656,6210,4703,-1507
2021,1,7,2,4614,6064,4586,-1478
2021,1,7,3,4391,5839,4385,-1454
2021,1,7,4,4070,5444,4003,-1441
2021,1,7,5,3749,5059,3564,-1495
2021,1,7,6,3533,4805,3402,-1403
2021,1,7,7,3440,4669,3281,-1388
2021,1,7,8,3395,4645,3258,-1387
2021,1,7,9,3412,4686,3289,-1397
2021,1,7,10,3542,4890,3422,-1468
2021,1,7,11,3892,5305,3653,-1652
2021,1,7,12,4440,5965,4149,-1816
2021,1,7,13,4725,6360,4313,-2047
2021,1,7,14,4628,6370,4319,-2051
2021,1,7,15,4501,6100,4319,-1781
2021,1,7,16,4277,5769,4189,-1580
2021,1,7,17,4109,5498,4067,-1431
2021,1,7,18,4050,5354,3939,-1415
2021,1,7,19,3981,5248,3862,-1386
2021,1,7,20,3965,5151,3791,-1360
2021,1,7,21,3954,5138,3784,-1354
2021,1,7,22,3996,5282,3890,-1392
2021,1,7,23,4188,5610,4138,-1472
2021,1,8,0,4477,5957,4399,-1558
2021,1,8,1,4402,5836,4309,-1527
2021,1,8,2,4261,5575,4113,-1462
2021,1,8,3,4009,5208,3746,-1462
2021,1,8,4,3656,4789,3442,-1347
2021,1,8,5,3306,4291,3019,-1272
2021,1,8,6,3063,3883,2729,-1154
2021,1,8,7,2936,3682,2571,-1111
2021,1,8,8,2864,3621,2488,-1133
2021,1,8,9,2853,3639,2490,-1149
2021,1,8,10,2973,3768,2567,-1201
2021,1,8,11,3213,4166,2866,-1300
2021,1,8,12,3662,4772,3245,-1527
2021,1,8,13,3968,5241,3619,-1622
2021,1,8,14,4071,5345,3703,-1642
2021,1,8,15,4060,5330,3785,-1545
2021,1,8,16,4055,5310,3875,-1435
2021,1,8,17,4023,5274,3852,-1422
2021,1,8,18,3926,5271,3823,-1448
2021,1,8,19,3858,5211,3800,-1411
2021,1,8,20,3805,5146,3731,-1415
2021,1,8,21,3788,5112,3682,-1430
2021,1,8,22,3851,5293,3784,-1509
2021,1,8,23,4009,5658,4024,-1634
2021,1,9,0,4296,6032,4325,-1707
2021,1,9,1,4297,5962,4271,-1691
2021,1,9,2,4235,5840,4176,-1664
2021,1,9,3,4109,5671,3885,-1786
2021,1,9,4,3904,5418,3784,-1634
2021,1,9,5,3695,5090,3500,-1590
2021,1,9,6,3553,5010,3538,-1472
2021,1,9,7,3395,4864,3414,-1450
2021,1,9,8,3398,4816,3363,-1453
2021,1,9,9,3459,4856,3397,-1459
2021,1,9,10,3556,4969,3479,-1490
2021,1,9,11,3855,5201,3637,-1564
2021,1,9,12,4205,5591,3781,-1810
2021,1,9,13,4542,6082,4299,-1783
2021,1,9,14,4848,6575,4729,-1846
2021,1,9,15,4866,6882,5252,-1630
2021,1,9,16,4684,6837,5237,-1600
2021,1,9,17,4451,6534,4911,-1623
2021,1,9,18,4275,6172,4596,-1576
2021,1,9,19,4134,5927,4406,-1521
2021,1,9,20,4000,5763,4294,-1469
2021,1,9,21,4025,5755,4147,-1608
2021,1,9,22,4113,5956,4286,-1670
2021,1,9,23,4370,6428,4659,-1769
2021,1,10,0,4877,6969,5081,-1888
2021,1,10,1,4904,7053,5186,-1867
2021,1,10,2,4825,7020,5282,-1738
2021,1,10,3,4800,6855,5134,-1721
2021,1,10,4,4703,6626,4962,-1664
2021,1,10,5,4452,6392,4600,-1792
2021,1,10,6,4470,6255,4404,-1851
2021,1,10,7,4422,6217,4339,-1878
2021,1,10,8,4414,6313,4421,-1892
2021,1,10,9,4529,6419,4528,-1891
2021,1,10,10,4677,6601,4761,-1840
2021,1,10,11,4903,6927,5169,-1758
2021,1,10,12,5214,7379,5586,-1793
2021,1,10,13,5567,7939,6087,-1852
2021,1,10,14,5787,8264,6310,-1954
2021,1,10,15,5655,8090,6187,-1903
2021,1,10,16,5208,7594,5727,-1867
2021,1,10,17,4858,6909,5107,-1802
2021,1,10,18,4585,6361,4648,-1713
2021,1,10,19,4337,5964,4378,-1586
2021,1,10,20,4181,5695,4176,-1519
2021,1,10,21,4131,5707,4135,-1572
2021,1,10,22,4145,5953,4355,-1598
2021,1,10,23,4341,6436,4805,-1631
2021,1,11,0,4834,6992,5260,-1732
2021,1,11,1,4874,7042,5343,-1699
2021,1,11,2,4755,6931,5210,-1721
2021,1,11,3,4626,6629,4847,-1782
2021,1,11,4,4381,6158,4472,-1686
2021,1,11,5,4076,5767,3975,-1792
2021,1,11,6,4039,5489,3718,-1771
2021,1,11,7,3952,5338,3595,-1743
2021,1,11,8,3992,5262,3538,-1724
2021,1,11,9,4114,5262,3515,-1747
2021,1,11,10,4345,5435,3744,-1691
2021,1,11,11,4747,5937,4286,-1651
2021,1,11,12,5311,6666,4862,-1804
2021,1,11,13,5586,7151,5367,-1784
2021,1,11,14,5444,7043,5313,-1730
2021,1,11,15,5093,6526,4900,-1626
2021,1,11,16,4825,6028,4581,-1447
2021,1,11,17,4481,5619,4170,-1449
2021,1,11,18,4261,5413,3996,-1417
2021,1,11,19,4088,5306,3933,-1373
2021,1,11,20,3985,5220,3888,-1332
2021,1,11,21,3979,5196,3886,-1310
2021,1,11,22,4017,5335,3985,-1350
2021,1,11,23,4217,5607,4161,-1446
2021,1,12,0,4624,5991,4432,-1559
2021,1,12,1,4547,5860,4351,-1509
2021,1,12,2,4409,5572,4128,-1444
2021,1,12,3,4125,5177,3766,-1411
2021,1,12,4,3789,4732,3423,-1309
2021,1,12,5,3438,4282,3058,-1224
2021,1,12,6,3140,3956,2861,-1095
2021,1,12,7,3008,3750,2702,-1048
2021,1,12,8,2951,3625,2602,-1023
2021,1,12,9,2958,3596,2569,-1027
2021,1,12,10,3049,3758,2689,-1069
2021,1,12,11,3316,4115,2961,-1154
2021,1,12,12,3751,4635,3277,-1358
2021,1,12,13,4051,5070,3557,-1513
2021,1,12,14,4082,5259,3684,-1575
2021,1,12,15,4044,5451,3886,-1565
2021,1,12,16,4059,5624,4143,-1481
2021,1,12,17,4039,5644,4177,-1467
2021,1,12,18,4023,5628,4143,-1485
2021,1,12,19,4009,5528,4087,-1441
2021,1,12,20,4009,5421,3973,-1448
2021,1,12,21,4037,5389,3958,-1431
2021,1,12,22,4097,5603,4077,-1526
2021,1,12,23,4252,6065,4401,-1664
2021,1,13,0,4567,6505,4739,-1766
2021,1,13,1,4533,6406,4682,-1724
2021,1,13,2,4337,6158,4510,-1648
2021,1,13,3,4127,5782,4147,-1635
2021,1,13,4,3840,5306,3811,-1495
2021,1,13,5,3542,4874,3417,-1457
2021,1,13,6,3534,4590,3278,-1312
2021,1,13,7,3407,4444,3146,-1298
2021,1,13,8,3373,4390,3106,-1284
2021,1,13,9,3382,4455,3131,-1324
2021,1,13,10,3525,4638,3250,-1388
2021,1,13,11,3875,5089,3627,-1462
2021,1,13,12,4440,5755,4102,-1653
2021,1,13,13,4836,6246,4497,-1749
2021,1,13,14,4846,6398,4616,-1782
2021,1,13,15,4715,6431,4617,-1814
2021,1,13,16,4557,6402,4728,-1674
2021,1,13,17,4332,6312,4686,-1626
2021,1,13,18,4166,6232,4611,-1621
2021,1,13,19,4078,6204,4598,-1606
2021,1,13,20,3942,6244,4625,-1619
2021,1,13,21,3909,6384,4699,-1685
2021,1,13,22,4048,6561,4804,-1757
2021,1,13,23,4282,6899,4896,-2003
2021,1,14,0,4651,7255,5187,-2068
2021,1,14,1,4744,7129,5091,-2038
2021,1,14,2,4637,6853,4959,-1894
2021,1,14,3,4452,6503,4773,-1730
2021,1,14,4,4164,5986,4318,-1668
2021,1,14,5,3860,5556,3915,-1641
2021,1,14,6,3994,5244,3729,-1515
2021,1,14,7,3867,5103,3607,-1496
2021,1,14,8,3800,5078,3534,-1544
2021,1,14,9,3822,5218,3616,-1602
2021,1,14,10,3979,5495,3811,-1684
2021,1,14,11,4337,6025,4330,-1695
2021,1,14,12,4956,6817,4851,-1966
2021,1,14,13,5329,7442,5310,-2132
2021,1,14,14,5279,7400,5366,-2034
2021,1,14,15,5009,6926,5159,-1767
2021,1,14,16,4776,6375,4721,-1654
2021,1,14,17,4512,5911,4424,-1487
2021,1,14,18,4293,5558,4167,-1391
2021,1,14,19,4116,5285,3991,-1294
2021,1,14,20,4013,5144,3869,-1275
2021,1,14,21,3965,5125,3854,-1271
2021,1,14,22,4068,5301,3989,-1312
2021,1,14,23,4286,5786,4305,-1481
2021,1,15,0,4673,6354,4692,-1662
2021,1,15,1,4734,6465,4745,-1720
2021,1,15,2,4669,6455,4722,-1733
2021,1,15,3,4438,6272,4518,-1754
2021,1,15,4,4136,5975,4232,-1743
2021,1,15,5,3826,5658,3924,-1734
2021,1,15,6,3599,5652,3945,-1707
2021,1,15,7,3473,5628,3971,-1657
2021,1,15,8,3457,5697,3997,-1700
2021,1,15,9,3501,5804,4090,-1714
2021,1,15,10,3654,6093,4368,-1725
2021,1,15,11,4069,6563,4915,-1648
2021,1,15,12,4669,7269,5183,-2086
2021,1,15,13,5046,7750,5461,-2289
2021,1,15,14,5094,7592,5357,-2235
2021,1,15,15,4790,7011,5017,-1994
2021,1,15,16,4562,6421,4789,-1632
2021,1,15,17,4346,5902,4472,-1430
2021,1,15,18,4202,5561,4213,-1348
2021,1,15,19,4056,5375,4072,-1303
2021,1,15,20,3969,5247,3985,-1262
2021,1,15,21,3921,5245,3970,-1275
2021,1,15,22,3929,5506,4105,-1401
2021,1,15,23,4068,5739,4290,-1449
2021,1,16,0,4299,5938,4408,-1530
2021,1,16,1,4229,5853,4336,-1517
2021,1,16,2,4053,5643,4167,-1476
2021,1,16,3,3870,5419,3945,-1474
2021,1,16,4,3720,5156,3705,-1451
2021,1,16,5,3479,4901,3463,-1438
2021,1,16,6,3465,4604,3247,-1357
2021,1,16,7,3386,4504,3126,-1378
2021,1,16,8,3391,4516,3114,-1402
2021,1,16,9,3388,4606,3138,-1468
2021,1,16,10,3463,4773,3252,-1521
2021,1,16,11,3691,5085,3473,-1612
2021,1,16,12,4010,5553,3804,-1749
2021,1,16,13,4335,6173,4394,-1779
2021,1,16,14,4672,6614,4740,-1874
2021,1,16,15,4712,6567,4755,-1812
2021,1,16,16,4607,6281,4565,-1716
2021,1,16,17,4407,5944,4342,-1602
2021,1,16,18,4227,5651,4140,-1511
2021,1,16,19,4075,5377,3945,-1432
2021,1,16,20,3944,5185,3817,-1368
2021,1,16,21,3902,5133,3752,-1381
2021,1,16,22,3920,5269,3866,-1403
2021,1,16,23,4154,5684,4146,-1538
2021,1,17,0,4536,6214,4497,-1717
2021,1,17,1,4661,6289,4535,-1754
2021,1,17,2,4534,6251,4544,-1707
2021,1,17,3,4467,6171,4388,-1783
2021,1,17,4,4411,5974,4251,-1723
2021,1,17,5,4324,5780,4062,-1718
2021,1,17,6,4052,5587,4052,-1535
2021,1,17,7,4008,5520,3996,-1524
2021,1,17,8,4026,5541,3946,-1595
2021,1,17,9,4070,5646,4013,-1633
2021,1,17,10,4223,5831,4191,-1640
2021,1,17,11,4433,6125,4456,-1669
2021,1,17,12,4756,6560,4762,-1798
2021,1,17,13,5093,7088,5252,-1836
2021,1,17,14,5342,7409,5517,-1892
2021,1,17,15,5191,7201,5315,-1886
2021,1,17,16,4949,6801,4989,-1812
2021,1,17,17,4598,6317,4607,-1710
2021,1,17,18,4347,5974,4391,-1583
2021,1,17,19,4208,5774,4250,-1524
2021,1,17,20,4074,5682,4192,-1490
2021,1,17,21,4008,5620,4165,-1455
2021,1,17,22,4087,5666,4189,-1477
2021,1,17,23,4447,5963,4387,-1576
2021,1,18,0,4730,6396,4662,-1734
2021,1,18,1,4765,6351,4598,-1753
2021,1,18,2,4698,6242,4503,-1739
2021,1,18,3,4595,5981,4229,-1752
2021,1,18,4,4357,5744,3948,-1796
2021,1,18,5,4191,5393,3680,-1713
2021,1,18,6,3788,5174,3406,-1768
2021,1,18,7,3702,5095,3310,-1785
2021,1,18,8,3645,5125,3313,-1812
2021,1,18,9,3692,5226,3368,-1858
2021,1,18,10,3866,5500,3548,-1952
2021,1,18,11,4241,5995,3894,-2101
2021,1,18,12,4724,6725,4700,-2025
2021,1,18,13,5046,7353,5417,-1936
2021,1,18,14,5068,7428,5468,-1960
2021,1,18,15,4966,6877,5026,-1851
2021,1,18,16,4706,6305,4614,-1691
2021,1,18,17,4468,5871,4352,-1519
2021,1,18,18,4316,5571,4140,-1431
2021,1,18,19,4186,5330,3977,-1353
2021,1,18,20,4039,5207,3893,-1314
2021,1,18,21,4046,5171,3890,-1281
2021,1,18,22,4127,5346,4013,-1333
2021,1,18,23,4384,5704,4223,-1481
2021,1,19,0,4767,6287,4603,-1684
2021,1,19,1,4789,6401,4660,-1741
2021,1,19,2,4635,6370,4605,-1765
2021,1,19,3,4399,6208,4394,-1814
2021,1,19,4,4149,5998,4137,-1861
2021,1,19,5,3924,5818,3855,-1963
2021,1,19,6,3709,5795,3825,-1970
2021,1,19,7,3650,5906,3861,-2045
2021,1,19,8,3744,6107,3984,-2123
2021,1,19,9,3879,6360,4152,-2208
2021,1,19,10,4126,6766,4462,-2304
2021,1,19,11,4575,7477,5151,-2326
2021,1,19,12,5303,8389,5679,-2710
2021,1,19,13,5730,9029,6202,-2827
2021,1,19,14,5561,8808,6306,-2502
2021,1,19,15,5078,7810,5978,-1832
2021,1,19,16,4855,6890,5297,-1593
2021,1,19,17,4538,6165,4571,-1594
2021,1,19,18,4354,5683,4226,-1457
2021,1,19,19,4177,5343,3983,-1360
2021,1,19,20,4038,5163,3878,-1285
2021,1,19,21,3952,5121,3864,-1257
2021,1,19,22,4020,5226,3948,-1278
2021,1,19,23,4270,5596,4191,-1405
2021,1,20,0,4642,6170,4561,-1609
2021,1,20,1,4757,6303,4638,-1665
2021,1,20,2,4702,6198,4532,-1666
2021,1,20,3,4452,6001,4307,-1694
2021,1,20,4,4164,5688,4043,-1645
2021,1,20,5,3872,5355,3705,-1650
2021,1,20,6,3637,5236,3628,-1608
2021,1,20,7,3575,5266,3625,-1641
2021,1,20,8,3652,5393,3703,-1690
2021,1,20,9,3759,5614,3843,-1771
2021,1,20,10,3984,5911,4096,-1815
2021,1,20,11,4409,6558,4630,-1928
2021,1,20,12,5059,7382,5165,-2217
2021,1,20,13,5441,7962,5605,-2357
2021,1,20,14,5291,7696,5656,-2040
2021,1,20,15,4982,6906,5114,-1792
2021,1,20,16,4541,6117,4573,-1544
2021,1,20,17,4328,5553,4110,-1443
2021,1,20,18,4167,5243,3878,-1365
2021,1,20,19,4041,5134,3819,-1315
2021,1,20,20,3953,5012,3743,-1269
2021,1,20,21,3991,5026,3762,-1264
2021,1,20,22,4052,5159,3849,-1310
2021,1,20,23,4198,5435,4034,-1401
2021,1,21,0,4488,5884,4328,-1556
2021,1,21,1,4515,5920,4345,-1575
2021,1,21,2,4363,5781,4250,-1531
2021,1,21,3,4164,5485,3939,-1546
2021,1,21,4,3895,5134,3665,-1469
2021,1,21,5,3620,4800,3360,-1440
2021,1,21,6,3382,4641,3294,-1347
2021,1,21,7,3329,4601,3247,-1354
2021,1,21,8,3322,4644,3273,-1371
2021,1,21,9,3366,4771,3360,-1411
2021,1,21,10,3540,5013,3574,-1439
2021,1,21,11,3941,5543,3941,-1602
2021,1,21,12,4530,6330,4448,-1882
2021,1,21,13,4913,6851,4825,-2026
2021,1,21,14,4913,6711,4788,-1923
2021,1,21,15,4708,6083,4357,-1726
2021,1,21,16,4444,5575,4089,-1486
2021,1,21,17,4286,5236,3894,-1342
2021,1,21,18,4197,5113,3830,-1283
2021,1,21,19,4165,5020,3828,-1192
2021,1,21,20,4147,4986,3789,-1197
2021,1,21,21,4168,5056,3850,-1206
2021,1,21,22,4225,5207,4034,-1173
2021,1,21,23,4341,5432,4275,-1157
2021,1,22,0,4589,5815,4628,-1187
2021,1,22,1,4545,5767,4529,-1238
2021,1,22,2,4358,5519,4308,-1211
2021,1,22,3,4084,5158,3908,-1250
2021,1,22,4,3731,4696,3446,-1250
2021,1,22,5,3357,4253,3017,-1236
2021,1,22,6,3128,3988,2877,-1111
2021,1,22,7,3036,3825,2735,-1090
2021,1,22,8,2992,3735,2669,-1066
2021,1,22,9,3002,3732,2665,-1067
2021,1,22,10,3105,3861,2761,-1100
2021,1,22,11,3408,4253,3044,-1209
2021,1,22,12,3887,4862,3447,-1415
2021,1,22,13,4243,5313,3753,-1560
2021,1,22,14,4324,5354,3808,-1546
2021,1,22,15,4266,5238,3819,-1419
2021,1,22,16,4200,5165,3881,-1284
2021,1,22,17,4134,5170,3901,-1269
2021,1,22,18,4089,5213,3917,-1296
2021,1,22,19,4080,5212,3933,-1279
2021,1,22,20,4075,5210,3959,-1251
2021,1,22,21,4099,5289,4008,-1281
2021,1,22,22,4137,5402,4094,-1308
2021,1,22,23,4196,5499,4163,-1336
2021,1,23,0,4365,5717,4407,-1310
2021,1,23,1,4316,5586,4287,-1299
2021,1,23,2,4118,5294,4038,-1256
2021,1,23,3,3904,4970,3710,-1260
2021,1,23,4,3637,4636,3376,-1260
2021,1,23,5,3334,4231,3042,-1189
2021,1,23,6,3147,3929,2926,-1003
2021,1,23,7,2976,3652,2713,-939
2021,1,23,8,2907,3558,2655,-903
2021,1,23,9,2876,3478,2589,-889
2021,1,23,10,2910,3510,2596,-914
2021,1,23,11,2998,3607,2633,-974
2021,1,23,12,3201,3837,2755,-1082
2021,1,23,13,3501,4161,3048,-1113
2021,1,23,14,3801,4614,3351,-1263
2021,1,23,15,4028,5008,3663,-1345
2021,1,23,16,4090,5221,3930,-1291
2021,1,23,17,4115,5323,4033,-1290
2021,1,23,18,4040,5356,4077,-1279
2021,1,23,19,4021,5284,4158,-1126
2021,1,23,20,3978,5238,4055,-1183
2021,1,23,21,3940,5220,4038,-1182
2021,1,23,22,3949,5248,4026,-1222
2021,1,23,23,4005,5338,4056,-1282
2021,1,24,0,4219,5576,4289,-1287
2021,1,24,1,4117,5462,4218,-1244
2021,1,24,2,4004,5229,3989,-1240
2021,1,24,3,3827,4960,3712,-1248
2021,1,24,4,3629,4623,3409,-1214
2021,1,24,5,3378,4268,3095,-1173
2021,1,24,6,3080,3956,2958,-998
2021,1,24,7,2925,3743,2798,-945
2021,1,24,8,2829,3621,2683,-938
2021,1,24,9,2745,3557,2642,-915
2021,1,24,10,2752,3619,2674,-945
2021,1,24,11,2806,3676,2710,-966
2021,1,24,12,2951,3864,2764,-1100
2021,1,24,13,3121,4184,3089,-1095
2021,1,24,14,3418,4585,3351,-1234
2021,1,24,15,3622,4872,3580,-1292
2021,1,24,16,3767,5022,3830,-1192
2021,1,24,17,3836,5191,4013,-1178
2021,1,24,18,3874,5331,4134,-1197
2021,1,24,19,3907,5427,4274,-1153
2021,1,24,20,3987,5535,4341,-1194
2021,1,24,21,4010,5625,4435,-1190
2021,1,24,22,4061,5638,4399,-1239
2021,1,24,23,4120,5667,4386,-1281
2021,1,25,0,4349,5863,4490,-1373
2021,1,25,1,4312,5828,4500,-1328
2021,1,25,2,4090,5521,4268,-1253
2021,1,25,3,3801,5099,3902,-1197
2021,1,25,4,3430,4633,3553,-1080
2021,1,25,5,3148,4146,3083,-1063
2021,1,25,6,2980,3788,2796,-992
2021,1,25,7,2822,3567,2592,-975
2021,1,25,8,2728,3450,2514,-936
2021,1,25,9,2711,3417,2458,-959
2021,1,25,10,2809,3513,2529,-984
2021,1,25,11,3096,3834,2782,-1052
2021,1,25,12,3533,4375,3127,-1248
2021,1,25,13,3886,4750,3452,-1298
2021,1,25,14,4035,4925,3570,-1355
2021,1,25,15,4134,5099,3739,-1360
2021,1,25,16,4252,5248,3996,-1252
2021,1,25,17,4311,5412,4114,-1298
2021,1,25,18,4435,5596,4212,-1384
2021,1,25,19,4576,5730,4367,-1363
2021,1,25,20,4698,5855,4490,-1365
2021,1,25,21,4785,5995,4578,-1417
2021,1,25,22,4861,6080,4688,-1392
2021,1,25,23,4909,6219,4811,-1408
2021,1,26,0,5076,6460,5049,-1411
2021,1,26,1,4984,6284,4868,-1416
2021,1,26,2,4723,5887,4473,-1414
2021,1,26,3,4375,5407,4006,-1401
2021,1,26,4,3925,4890,3581,-1309
2021,1,26,5,3489,4346,3179,-1167
2021,1,26,6,3219,3947,2894,-1053
2021,1,26,7,3019,3603,2607,-996
2021,1,26,8,2914,3500,2524,-976
2021,1,26,9,2852,3421,2463,-958
2021,1,26,10,2917,3529,2547,-982
2021,1,26,11,3159,3837,2767,-1070
2021,1,26,12,3550,4357,3096,-1261
2021,1,26,13,3852,4676,3402,-1274
2021,1,26,14,3982,4861,3533,-1328
2021,1,26,15,4152,5050,3707,-1343
2021,1,26,16,4303,5206,3917,-1289
2021,1,26,17,4431,5346,4042,-1304
2021,1,26,18,4614,5531,4177,-1354
2021,1,26,19,4800,5648,4252,-1396
2021,1,26,20,4951,5759,4384,-1375
2021,1,26,21,5063,5901,4510,-1391
2021,1,26,22,5140,6043,4611,-1432
2021,1,26,23,5134,6177,4740,-1437
2021,1,27,0,5226,6425,5005,-1420
2021,1,27,1,5066,6284,4848,-1436
2021,1,27,2,4823,5869,4457,-1412
2021,1,27,3,4476,5408,4022,-1386
2021,1,27,4,4021,4847,3572,-1275
2021,1,27,5,3559,4294,3116,-1178
2021,1,27,6,3177,3943,2892,-1051
2021,1,27,7,2982,3700,2708,-992
2021,1,27,8,2866,3563,2606,-957
2021,1,27,9,2829,3483,2531,-952
2021,1,27,10,2862,3579,2579,-1000
2021,1,27,11,3087,3848,2771,-1077
2021,1,27,12,3485,4373,3122,-1251
2021,1,27,13,3752,4781,3510,-1271
2021,1,27,14,3891,4992,3658,-1334
2021,1,27,15,4030,5135,3782,-1353
2021,1,27,16,4206,5229,3954,-1275
2021,1,27,17,4360,5344,4022,-1322
2021,1,27,18,4570,5531,4168,-1363
2021,1,27,19,4776,5725,4344,-1381
2021,1,27,20,4961,5927,4399,-1528
2021,1,27,21,5114,6203,4680,-1523
2021,1,27,22,5168,6224,4666,-1558
2021,1,27,23,5082,6307,4760,-1547
2021,1,28,0,5133,6532,5102,-1430
2021,1,28,1,4967,6367,5037,-1330
2021,1,28,2,4692,5981,4617,-1364
2021,1,28,3,4302,5528,4133,-1395
2021,1,28,4,3846,4999,3708,-1291
2021,1,28,5,3448,4470,3255,-1215
2021,1,28,6,3145,4098,3004,-1094
2021,1,28,7,2915,3819,2773,-1046
2021,1,28,8,2756,3626,2647,-979
2021,1,28,9,2727,3529,2557,-972
2021,1,28,10,2799,3579,2571,-1008
2021,1,28,11,3052,3846,2731,-1115
2021,1,28,12,3529,4444,3102,-1342
2021,1,28,13,3896,4885,3608,-1277
2021,1,28,14,4048,5115,3725,-1390
2021,1,28,15,4181,5175,3764,-1411
2021,1,28,16,4134,5199,3891,-1308
2021,1,28,17,4069,5155,3888,-1267
2021,1,28,18,4029,5144,3927,-1217
2021,1,28,19,3996,5033,3832,-1201
2021,1,28,20,3981,4987,3806,-1181
2021,1,28,21,3925,5067,3882,-1185
2021,1,28,22,4046,5232,3962,-1270
2021,1,28,23,4168,5506,4226,-1280
2021,1,29,0,4597,6033,4758,-1275
2021,1,29,1,4691,6138,4843,-1295
2021,1,29,2,4582,6045,4726,-1319
2021,1,29,3,4383,5821,4441,-1380
2021,1,29,4,4131,5505,3966,-1539
2021,1,29,5,3890,5181,3627,-1554
2021,1,29,6,3888,4995,3359,-1636
2021,1,29,7,3843,4943,3225,-1718
2021,1,29,8,3916,5048,3237,-1811
2021,1,29,9,3973,5267,3378,-1889
2021,1,29,10,4186,5621,3750,-1871
2021,1,29,11,4613,6290,4531,-1759
2021,1,29,12,5289,7221,5219,-2002
2021,1,29,13,5755,7919,5895,-2024
2021,1,29,14,5647,7860,6015,-1845
2021,1,29,15,5290,7260,5413,-1847
2021,1,29,16,4863,6604,4947,-1657
2021,1,29,17,4523,5988,4439,-1549
2021,1,29,18,4292,5561,4147,-1414
2021,1,29,19,4128,5250,3943,-1307
2021,1,29,20,4005,5050,3796,-1254
2021,1,29,21,3912,4972,3739,-1233
2021,1,29,22,3896,5103,3844,-1259
2021,1,29,23,4116,5371,4028,-1343
2021,1,30,0,4389,5832,4370,-1462
2021,1,30,1,4495,5962,4430,-1532
2021,1,30,2,4443,5875,4317,-1558
2021,1,30,3,4315,5795,4146,-1649
2021,1,30,4,4138,5614,4002,-1612
2021,1,30,5,3940,5410,3778,-1632
2021,1,30,6,3739,5304,3868,-1436
2021,1,30,7,3625,5263,3813,-1450
2021,1,30,8,3654,5311,3827,-1484
2021,1,30,9,3710,5382,3901,-1481
2021,1,30,10,3828,5549,4072,-1477
2021,1,30,11,4024,5894,4412,-1482
2021,1,30,12,4312,6379,4859,-1520
2021,1,30,13,4645,6855,5295,-1560
2021,1,30,14,4865,6957,5384,-1573
2021,1,30,15,4780,6489,5105,-1384
2021,1,30,16,4594,5920,4648,-1272
2021,1,30,17,4315,5441,4169,-1272
2021,1,30,18,4111,5161,3834,-1327
2021,1,30,19,3914,4981,3716,-1265
2021,1,30,20,3803,4882,3648,-1234
2021,1,30,21,3784,4878,3628,-1250
2021,1,30,22,3811,4972,3670,-1302
2021,1,30,23,3962,5116,3817,-1299
2021,1,31,0,4155,5402,4081,-1321
2021,1,31,1,4189,5359,4024,-1335
2021,1,31,2,4054,5156,3810,-1346
2021,1,31,3,3853,4928,3542,-1386
2021,1,31,4,3631,4659,3336,-1323
2021,1,31,5,3428,4356,3192,-1164
2021,1,31,6,3221,4140,2971,-1169
2021,1,31,7,3134,4014,2858,-1156
2021,1,31,8,3046,3941,2780,-1161
2021,1,31,9,3046,3949,2777,-1172
2021,1,31,10,3088,4027,2819,-1208
2021,1,31,11,3237,4195,2944,-1251
2021,1,31,12,3415,4489,3141,-1348
2021,1,31,13,3605,4869,3532,-1337
2021,1,31,14,3877,5197,3817,-1380
2021,1,31,15,3980,5276,3907,-1369
2021,1,31,16,3964,5181,3880,-1301
2021,1,31,17,3949,5007,3769,-1238
2021,1,31,18,3947,5022,3691,-1331
2021,1,31,19,3969,5081,3766,-1315
2021,1,31,20,3993,5101,3674,-1427
2021,1,31,21,4057,5161,3847,-1314
2021,1,31,22,4147,5295,3960,-1335
2021,1,31,23,4265,5448,4135,-1313
2021,2,1,0,4525,5755,4436,-1319
2021,2,1,1,4425,5716,4403,-1313
2021,2,1,2,4172,5439,4188,-1251
2021,2,1,3,3918,5093,3898,-1195
2021,2,1,4,3554,4612,3507,-1105
2021,2,1,5,3226,4106,3033,-1073
2021,2,1,6,2854,3762,2924,-838
2021,2,1,7,2668,3549,2770,-779
2021,2,1,8,2599,3448,2679,-769
2021,2,1,9,2608,3418,2654,-764
2021,2,1,10,2724,3523,2726,-797
2021,2,1,11,3003,3841,2939,-902
2021,2,1,12,3475,4403,3369,-1034
2021,2,1,13,3851,4826,3703,-1123
2021,2,1,14,3976,5024,3846,-1178
2021,2,1,15,4099,5165,3923,-1242
2021,2,1,16,4084,5305,4021,-1284
2021,2,1,17,4095,5492,4155,-1337
2021,2,1,18,4049,5635,4323,-1312
2021,2,1,19,3988,5730,4533,-1197
2021,2,1,20,3949,5822,4678,-1144
2021,2,1,21,3909,6089,4873,-1216
2021,2,1,22,4021,6467,5177,-1290
2021,2,1,23,4198,7057,5772,-1285
2021,2,2,0,4713,7557,6141,-1416
2021,2,2,1,4856,7583,6171,-1412
2021,2,2,2,4755,7427,6020,-1407
2021,2,2,3,4529,7107,5785,-1322
2021,2,2,4,4347,6681,5426,-1255
2021,2,2,5,4169,6305,5187,-1118
2021,2,2,6,4350,6078,4649,-1429
2021,2,2,7,4278,5985,4557,-1428
2021,2,2,8,4381,6027,4648,-1379
2021,2,2,9,4473,6131,4634,-1497
2021,2,2,10,4696,6374,4555,-1819
2021,2,2,11,5229,6958,4948,-2010
2021,2,2,12,5968,7771,5349,-2422
2021,2,2,13,6431,8344,5997,-2347
2021,2,2,14,6329,8451,6308,-2143
2021,2,2,15,6093,8152,6022,-2130
2021,2,2,16,5739,7728,5642,-2086
2021,2,2,17,5351,7293,5368,-1925
2021,2,2,18,5053,6777,4966,-1811
2021,2,2,19,4800,6467,4831,-1636
2021,2,2,20,4645,6141,4605,-1536
2021,2,2,21,4548,6041,4522,-1519
2021,2,2,22,4684,6200,4581,-1619
2021,2,2,23,5003,6778,4837,-1941
2021,2,3,0,5587,7663,5409,-2254
2021,2,3,1,5847,7949,5743,-2206
2021,2,3,2,5867,7881,5613,-2268
2021,2,3,3,5764,7564,5380,-2184
2021,2,3,4,5576,7106,5105,-2001
2021,2,3,5,5278,6703,4706,-1997
2021,2,3,6,5037,6520,4714,-1806
2021,2,3,7,4994,6513,4686,-1827
2021,2,3,8,5115,6583,4715,-1868
2021,2,3,9,5242,6739,4822,-1917
2021,2,3,10,5466,7080,5054,-2026
2021,2,3,11,6014,7744,5556,-2188
2021,2,3,12,6811,8643,6434,-2209
2021,2,3,13,7293,9222,6890,-2332
2021,2,3,14,6979,8982,6740,-2242
2021,2,3,15,6444,8294,6122,-2172
2021,2,3,16,5709,7604,5590,-2014
2021,2,3,17,5330,6952,5149,-1803
2021,2,3,18,4922,6418,4807,-1611
2021,2,3,19,4603,5998,4611,-1387
2021,2,3,20,4399,5679,4419,-1260
2021,2,3,21,4364,5599,4331,-1268
2021,2,3,22,4459,5750,4426,-1324
2021,2,3,23,4707,6202,4743,-1459
2021,2,4,0,5212,7050,5354,-1696
2021,2,4,1,5378,7442,5618,-1824
2021,2,4,2,5342,7593,5709,-1884
2021,2,4,3,5180,7537,5666,-1871
2021,2,4,4,5007,7334,5480,-1854
2021,2,4,5,4812,7121,5289,-1832
2021,2,4,6,5258,-9999,-9999,-9999
2021,2,4,7,5161,-9999,-9999,-9999
2021,2,4,8,5213,-9999,-9999,-9999
2021,2,4,9,5314,-9999,-9999,-9999
2021,2,4,10,5518,-9999,-9999,-9999
2021,2,4,11,5992,-9999,-9999,-9999
2021,2,4,12,6718,-9999,-9999,-9999
2021,2,4,13,7186,-9999,-9999,-9999
2021,2,4,14,6811,-9999,-9999,-9999
2021,2,4,15,6082,-9999,-9999,-9999
2021,2,4,16,5420,-9999,-9999,-9999
2021,2,4,17,4980,-9999,-9999,-9999
2021,2,4,18,4626,-9999,-9999,-9999
2021,2,4,19,4434,-9999,-9999,-9999
2021,2,4,20,4242,-9999,-9999,-9999
2021,2,4,21,4083,-9999,-9999,-9999
2021,2,4,22,4157,-9999,-9999,-9999
2021,2,4,23,4455,-9999,-9999,-9999
2021,2,5,0,4757,-9999,-9999,-9999
2021,2,5,1,4913,-9999,-9999,-9999
2021,2,5,2,4858,-9999,-9999,-9999
2021,2,5,3,4649,-9999,-9999,-9999
2021,2,5,4,4328,-9999,-9999,-9999
2021,2,5,5,4092,-9999,-9999,-9999
