Year,Month,Day,Hour,Forecast_Demand_MWh,Adjusted_Demand_MWh,Adjusted_Generation_MWh,Adjusted_Interchange_MWh
2015,7,1,8,2753,2848,1554,-1294
2015,7,1,9,2606,2701,1362,-1339
2015,7,1,10,2516,2603,1304,-1299
2015,7,1,11,2456,2513,1237,-1276
2015,7,1,12,2475,2458,1164,-1294
2015,7,1,13,2574,2456,1117,-1339
2015,7,1,14,2766,2511,1118,-1393
2015,7,1,15,2897,2683,1159,-1524
2015,7,1,16,3019,2853,1199,-1654
2015,7,1,17,3171,3008,1341,-1667
2015,7,1,18,3337,3142,1460,-1682
2015,7,1,19,3481,3281,1597,-1684
2015,7,1,20,3596,3398,1717,-1681
2015,7,1,21,3670,3516,1832,-1684
2015,7,1,22,3690,3592,1900,-1692
2015,7,1,23,3677,3648,1947,-1701
2015,7,2,0,3650,3679,1987,-1692
2015,7,2,1,3645,3697,1993,-1704
2015,7,2,2,3595,3700,2023,-1677
2015,7,2,3,3568,3648,1991,-1657
2015,7,2,4,3441,3536,1887,-1649
2015,7,2,5,3232,3447,1828,-1619
2015,7,2,6,2924,3297,1684,-1613
2015,7,2,7,2868,3038,1633,-1405
2015,7,2,8,2674,2823,1498,-1325
2015,7,2,9,2590,2665,1466,-1199
2015,7,2,10,2508,2548,1448,-1100
2015,7,2,11,2450,2465,1402,-1063
2015,7,2,12,2431,2402,1394,-1008
2015,7,2,13,2503,2396,1372,-1024
2015,7,2,14,2701,2444,1320,-1124
2015,7,2,15,2881,2608,1315,-1293
2015,7,2,16,3028,2767,1368,-1399
2015,7,2,17,3189,2911,1382,-1529
2015,7,2,18,3350,3041,1449,-1592
2015,7,2,19,3484,3197,1610,-1587
2015,7,2,20,3605,3321,1722,-1599
2015,7,2,21,3690,3442,1822,-1620
2015,7,2,22,3729,3439,1835,-1604
2015,7,2,23,3739,3450,1830,-1620
2015,7,3,0,3723,3433,1812,-1621
2015,7,3,1,3726,3350,1783,-1567
2015,7,3,2,3685,3368,1800,-1568
2015,7,3,3,3614,3383,1838,-1545
2015,7,3,4,3464,3374,1867,-1507
2015,7,3,5,3265,3352,1790,-1562
2015,7,3,6,2928,3226,1720,-1506
2015,7,3,7,2878,2989,1668,-1321
2015,7,3,8,2676,2782,1483,-1299
2015,7,3,9,2564,2624,1375,-1249
2015,7,3,10,2471,2498,1272,-1226
2015,7,3,11,2421,2413,1281,-1132
2015,7,3,12,2415,2347,1216,-1131
2015,7,3,13,2486,2321,1182,-1139
2015,7,3,14,2683,2332,1217,-1115
2015,7,3,15,2863,2455,1213,-1242
2015,7,3,16,3013,2627,1265,-1362
2015,7,3,17,3153,2796,1275,-1521
2015,7,3,18,3298,2957,1273,-1684
2015,7,3,19,3422,3091,1410,-1681
2015,7,3,20,3528,3218,1544,-1674
2015,7,3,21,3563,3312,1624,-1688
2015,7,3,22,3551,3404,1708,-1696
2015,7,3,23,3511,3466,1778,-1688
2015,7,4,0,3450,3503,1812,-1691
2015,7,4,1,3442,3502,1817,-1685
2015,7,4,2,3408,3491,1825,-1666
2015,7,4,3,3324,3465,1841,-1624
2015,7,4,4,3241,3362,1758,-1604
2015,7,4,5,3125,3254,1804,-1450
2015,7,4,6,2891,3123,1777,-1346
2015,7,4,7,2863,2909,1756,-1153
2015,7,4,8,2675,2720,1512,-1208
2015,7,4,9,2486,2564,1488,-1076
2015,7,4,10,2401,2449,1273,-1176
2015,7,4,11,2348,2351,1195,-1156
2015,7,4,12,2298,2287,1182,-1105
2015,7,4,13,2258,2243,1181,-1062
2015,7,4,14,2364,2238,1252,-986
2015,7,4,15,2574,2341,1267,-1074
2015,7,4,16,2739,2508,1274,-1234
2015,7,4,17,2866,2662,1251,-1411
2015,7,4,18,2977,2801,1316,-1485
2015,7,4,19,3069,2933,1432,-1501
2015,7,4,20,3141,3058,1532,-1526
2015,7,4,21,3176,3158,1624,-1534
2015,7,4,22,3208,3246,1688,-1558
2015,7,4,23,3232,3262,1750,-1512
2015,7,5,0,3217,3277,1785,-1492
2015,7,5,1,3220,3259,1760,-1499
2015,7,5,2,3183,3227,1717,-1510
2015,7,5,3,3094,3138,1777,-1361
2015,7,5,4,3004,3028,1711,-1317
2015,7,5,5,2879,2925,1605,-1320
2015,7,5,6,2659,2803,1612,-1191
2015,7,5,7,2684,2691,1669,-1022
2015,7,5,8,2528,2579,1605,-974
2015,7,5,9,2395,2446,1475,-971
2015,7,5,10,2324,2343,1345,-998
2015,7,5,11,2269,2270,1301,-969
2015,7,5,12,2229,2216,1207,-1009
2015,7,5,13,2180,2196,1237,-959
2015,7,5,14,2266,2186,1238,-948
2015,7,5,15,2406,2237,1287,-950
2015,7,5,16,2514,2332,1394,-938
2015,7,5,17,2583,2433,1422,-1011
2015,7,5,18,2646,2511,1431,-1080
2015,7,5,19,2704,2555,1338,-1217
2015,7,5,20,2758,2605,1338,-1267
2015,7,5,21,2800,2629,1328,-1301
2015,7,5,22,2817,2647,1340,-1307
2015,7,5,23,2832,2646,1483,-1163
2015,7,6,0,2824,2631,1476,-1155
2015,7,6,1,2815,2622,1572,-1050
2015,7,6,2,2731,2621,1618,-1003
2015,7,6,3,2646,2655,1648,-1007
2015,7,6,4,2570,2608,1561,-1047
2015,7,6,5,2458,2582,1486,-1096
2015,7,6,6,2305,2517,1391,-1126
2015,7,6,7,2319,2346,1253,-1093
2015,7,6,8,2206,2214,1181,-1033
2015,7,6,9,2072,2121,1180,-941
2015,7,6,10,2028,2083,1164,-919
2015,7,6,11,2015,2035,1087,-948
2015,7,6,12,2054,2050,1083,-967
2015,7,6,13,2159,2112,1169,-943
2015,7,6,14,2322,2198,1218,-980
2015,7,6,15,2511,2349,1218,-1131
2015,7,6,16,2616,2498,1239,-1259
2015,7,6,17,2725,2658,1311,-1347
2015,7,6,18,2826,2789,1420,-1369
2015,7,6,19,2904,2907,1457,-1450
2015,7,6,20,2979,3022,1593,-1429
2015,7,6,21,3017,3120,1598,-1522
2015,7,6,22,3044,3202,1659,-1543
2015,7,6,23,3049,3278,1757,-1521
2015,7,7,0,3048,3294,1780,-1514
2015,7,7,1,3046,3295,1786,-1509
2015,7,7,2,3026,3285,1838,-1447
2015,7,7,3,2977,3265,1806,-1459
2015,7,7,4,2879,3184,1696,-1488
2015,7,7,5,2742,3085,1630,-1455
2015,7,7,6,2526,2935,1592,-1343
2015,7,7,7,2432,2699,1500,-1199
2015,7,7,8,2362,2403,1246,-1157
2015,7,7,9,2334,2318,1138,-1180
2015,7,7,10,2262,2254,1140,-1114
2015,7,7,11,2223,2226,1136,-1090
2015,7,7,12,2227,2235,1203,-1032
2015,7,7,13,2299,2312,1263,-1049
2015,7,7,14,2467,2463,1305,-1158
2015,7,7,15,2580,2611,1400,-1211
2015,7,7,16,2715,2715,1485,-1230
2015,7,7,17,2840,2837,1615,-1222
2015,7,7,18,2971,2962,1712,-1250
2015,7,7,19,3084,3058,1791,-1267
2015,7,7,20,3196,3152,1907,-1245
2015,7,7,21,3279,3252,1994,-1258
2015,7,7,22,3314,3327,2156,-1171
2015,7,7,23,3318,3365,2139,-1226
2015,7,8,0,3294,3363,2113,-1250
2015,7,8,1,3275,3356,2133,-1223
2015,7,8,2,3233,3307,1969,-1338
2015,7,8,3,3133,3175,1786,-1389
2015,7,8,4,3001,3091,1857,-1234
2015,7,8,5,2841,2928,1714,-1214
2015,7,8,6,2584,2702,1536,-1166
2015,7,8,7,2500,2499,1304,-1195
2015,7,8,8,2366,2372,1243,-1129
2015,7,8,9,2301,2282,1185,-1097
2015,7,8,10,2210,2210,1056,-1154
2015,7,8,11,2191,2179,1140,-1039
2015,7,8,12,2163,2201,1175,-1026
2015,7,8,13,2268,2272,1225,-1047
2015,7,8,14,2456,2391,1269,-1122
2015,7,8,15,2567,2536,1366,-1170
2015,7,8,16,2657,2633,1618,-1015
2015,7,8,17,2773,2739,1705,-1034
2015,7,8,18,2854,2827,1549,-1278
2015,7,8,19,2946,2900,1553,-1347
2015,7,8,20,3001,2950,1608,-1342
2015,7,8,21,3024,2992,1639,-1353
2015,7,8,22,3031,3043,1682,-1361
2015,7,8,23,3014,3077,1727,-1350
2015,7,9,0,2987,3049,1738,-1311
2015,7,9,1,2959,2885,1595,-1290
2015,7,9,2,2924,2746,1574,-1172
2015,7,9,3,2844,2677,1669,-1008
2015,7,9,4,2749,2640,1613,-1027
2015,7,9,5,2664,2553,1525,-1028
2015,7,9,6,2465,2389,1271,-1118
2015,7,9,7,2308,2258,1262,-996
2015,7,9,8,2185,2161,1287,-874
2015,7,9,9,2078,2114,1299,-815
2015,7,9,10,2020,2067,1237,-830
2015,7,9,11,2002,2061,1166,-895
2015,7,9,12,2026,2077,1158,-919
2015,7,9,13,2106,2162,1175,-987
2015,7,9,14,2275,2298,1149,-1149
2015,7,9,15,2404,2410,1226,-1184
2015,7,9,16,2503,2458,1283,-1175
2015,7,9,17,2586,2544,1324,-1220
2015,7,9,18,2674,2632,1461,-1171
2015,7,9,19,2756,2713,1492,-1221
2015,7,9,20,2860,2810,1552,-1258
2015,7,9,21,2966,2903,1624,-1279
2015,7,9,22,3024,2975,1713,-1262
2015,7,9,23,3040,3025,1726,-1299
2015,7,10,0,3027,3056,1681,-1375
2015,7,10,1,3019,3026,1663,-1363
2015,7,10,2,2928,2982,1611,-1371
2015,7,10,3,2835,2876,1548,-1328
2015,7,10,4,2739,2809,1536,-1273
2015,7,10,5,2619,2689,1455,-1234
2015,7,10,6,2408,2488,1351,-1137
2015,7,10,7,2330,2309,1189,-1120
2015,7,10,8,2266,2203,1314,-889
2015,7,10,9,2142,2120,1276,-844
2015,7,10,10,2063,2075,1245,-830
2015,7,10,11,2033,2052,1198,-854
2015,7,10,12,2054,2062,1165,-897
2015,7,10,13,2136,2141,1214,-927
2015,7,10,14,2299,2267,1197,-1070
2015,7,10,15,2414,2351,1238,-1113
2015,7,10,16,2497,2427,1356,-1071
2015,7,10,17,2578,2497,1400,-1097
2015,7,10,18,2653,2563,1444,-1119
2015,7,10,19,2697,2624,1488,-1136
2015,7,10,20,2733,2706,1598,-1108
2015,7,10,21,2780,2766,1585,-1181
2015,7,10,22,2816,2796,1549,-1247
2015,7,10,23,2825,2719,1459,-1260
2015,7,11,0,2750,2640,1479,-1161
2015,7,11,1,2685,2599,1462,-1137
2015,7,11,2,2628,2538,1411,-1127
2015,7,11,3,2541,2482,1378,-1104
2015,7,11,4,2456,2493,1410,-1083
2015,7,11,5,2391,2416,1354,-1062
2015,7,11,6,2231,2253,1252,-1001
2015,7,11,7,2224,2138,1175,-963
2015,7,11,8,2132,2050,1238,-812
2015,7,11,9,1982,2002,1221,-781
2015,7,11,10,1926,1946,1242,-704
2015,7,11,11,1895,1927,1247,-680
2015,7,11,12,1882,1932,1240,-692
2015,7,11,13,1883,1935,1216,-719
2015,7,11,14,1988,2001,1229,-772
2015,7,11,15,2150,2131,1343,-788
2015,7,11,16,2299,2241,1352,-889
2015,7,11,17,2405,2350,1407,-943
2015,7,11,18,2499,2411,1397,-1014
2015,7,11,19,2566,2453,1448,-1005
2015,7,11,20,2615,2489,1437,-1052
2015,7,11,21,2654,2534,1454,-1080
2015,7,11,22,2664,2578,1406,-1172
2015,7,11,23,2687,2576,1346,-1230
2015,7,12,0,2677,2473,1259,-1214
2015,7,12,1,2649,2368,1220,-1148
2015,7,12,2,2580,2307,1231,-1076
2015,7,12,3,2489,2269,1257,-1012
2015,7,12,4,2412,2275,1325,-950
2015,7,12,5,2304,2243,1342,-901
2015,7,12,6,2168,2108,1224,-884
2015,7,12,7,2180,1985,1160,-825
2015,7,12,8,2037,1916,1038,-878
2015,7,12,9,1864,1859,1020,-839
2015,7,12,10,1801,1831,1067,-764
2015,7,12,11,1769,1798,1067,-731
2015,7,12,12,1774,1816,1128,-688
2015,7,12,13,1764,1799,1140,-659
2015,7,12,14,1826,1854,1128,-726
2015,7,12,15,1970,1967,1219,-748
2015,7,12,16,2095,2080,1150,-930
2015,7,12,17,2189,2158,1222,-936
2015,7,12,18,2272,2245,1294,-951
2015,7,12,19,2352,2325,1317,-1008
2015,7,12,20,2415,2393,1390,-1003
2015,7,12,21,2476,2450,1460,-990
2015,7,12,22,2547,2527,1495,-1032
2015,7,12,23,2586,2573,1424,-1149
2015,7,13,0,2604,2598,1446,-1152
2015,7,13,1,2598,2542,1340,-1202
2015,7,13,2,2547,2451,1261,-1190
2015,7,13,3,2502,2311,1241,-1070
2015,7,13,4,2442,2275,1355,-920
2015,7,13,5,2344,2174,1379,-795
2015,7,13,6,2170,2011,1247,-764
2015,7,13,7,2128,1891,1202,-689
2015,7,13,8,2016,1821,1186,-635
2015,7,13,9,1783,1766,1144,-622
2015,7,13,10,1740,1744,1189,-555
2015,7,13,11,1733,1753,1180,-573
2015,7,13,12,1792,1803,1201,-602
2015,7,13,13,1900,1901,1272,-629
2015,7,13,14,2055,2055,1192,-863
2015,7,13,15,2232,2182,1148,-1034
2015,7,13,16,2340,2266,1179,-1087
2015,7,13,17,2427,2318,1222,-1096
2015,7,13,18,2538,2360,1323,-1037
2015,7,13,19,2617,2383,1409,-974
2015,7,13,20,2700,2434,1565,-869
2015,7,13,21,2808,2468,1708,-760
2015,7,13,22,2886,2512,1752,-760
2015,7,13,23,2899,2568,1713,-855
2015,7,14,0,2860,2596,1507,-1089
2015,7,14,1,2826,2629,1567,-1062
2015,7,14,2,2755,2606,1466,-1140
2015,7,14,3,2678,2533,1392,-1141
2015,7,14,4,2590,2494,1421,-1073
2015,7,14,5,2444,2378,1354,-1024
2015,7,14,6,2215,2179,1216,-963
2015,7,14,7,2264,2027,1016,-1011
2015,7,14,8,2093,1949,1009,-940
2015,7,14,9,1881,1888,997,-891
2015,7,14,10,1822,1850,996,-854
2015,7,14,11,1804,1831,979,-852
2015,7,14,12,1848,1879,986,-893
2015,7,14,13,1939,1953,1011,-942
2015,7,14,14,2090,2081,1087,-994
2015,7,14,15,2187,2193,1023,-1170
2015,7,14,16,2261,2271,1011,-1260
2015,7,14,17,2332,2345,1076,-1269
2015,7,14,18,2439,2422,1156,-1266
2015,7,14,19,2533,2490,1228,-1262
2015,7,14,20,2636,2587,1329,-1258
2015,7,14,21,2726,2649,1466,-1183
2015,7,14,22,2818,2690,1515,-1175
2015,7,14,23,2825,2700,1588,-1112
2015,7,15,0,2806,2722,1665,-1057
2015,7,15,1,2763,2692,1656,-1036
2015,7,15,2,2704,2630,1562,-1068
2015,7,15,3,2619,2543,1501,-1042
2015,7,15,4,2530,2511,1351,-1160
2015,7,15,5,2388,2381,1262,-1119
2015,7,15,6,2172,2200,1204,-996
2015,7,15,7,2237,2033,1216,-817
2015,7,15,8,2102,1950,1259,-691
2015,7,15,9,1923,1881,1150,-731
2015,7,15,10,1884,1859,1070,-789
2015,7,15,11,1875,1833,1090,-743
2015,7,15,12,1926,1860,1083,-777
2015,7,15,13,2014,1931,1129,-802
2015,7,15,14,2158,2041,1085,-956
2015,7,15,15,2261,2163,1086,-1077
2015,7,15,16,2351,2244,1192,-1052
2015,7,15,17,2421,2337,1299,-1038
2015,7,15,18,2499,2419,1381,-1038
2015,7,15,19,2553,2505,1344,-1161
2015,7,15,20,2640,2594,1356,-1238
2015,7,15,21,2706,2680,1441,-1239
2015,7,15,22,2765,2743,1538,-1205
2015,7,15,23,2831,2787,1529,-1258
2015,7,16,0,2866,2823,1578,-1245
2015,7,16,1,2888,2819,1575,-1244
2015,7,16,2,2830,2796,1601,-1195
2015,7,16,3,2740,2815,1642,-1173
2015,7,16,4,2619,2645,1568,-1077
2015,7,16,5,2454,2487,1447,-1040
2015,7,16,6,2228,2259,1357,-902
2015,7,16,7,2286,2102,1237,-865
2015,7,16,8,2114,1977,1107,-870
2015,7,16,9,1956,1905,1171,-734
2015,7,16,10,1888,1859,1120,-739
2015,7,16,11,1851,1844,1112,-732
2015,7,16,12,1894,1868,1142,-726
2015,7,16,13,1982,1946,1202,-744
2015,7,16,14,2109,2082,1264,-818
2015,7,16,15,2234,2213,1200,-1013
2015,7,16,16,2300,2291,1237,-1054
2015,7,16,17,2388,2374,1320,-1054
2015,7,16,18,2486,2447,1372,-1075
2015,7,16,19,2563,2512,1390,-1122
2015,7,16,20,2645,2581,1445,-1136
2015,7,16,21,2717,2660,1513,-1147
2015,7,16,22,2780,2708,1595,-1113
2015,7,16,23,2812,2760,1678,-1082
2015,7,17,0,2837,2777,1688,-1089
2015,7,17,1,2839,2774,1728,-1046
2015,7,17,2,2789,2736,1829,-907
2015,7,17,3,2700,2634,1754,-880
2015,7,17,4,2592,2561,1707,-854
2015,7,17,5,2462,2448,1682,-766
2015,7,17,6,2241,2239,1574,-665
2015,7,17,7,2138,2079,1557,-522
2015,7,17,8,1956,1975,1608,-367
2015,7,17,9,1936,1906,1588,-318
2015,7,17,10,1897,1874,1515,-359
2015,7,17,11,1870,1846,1513,-333
2015,7,17,12,1905,1875,1525,-350
2015,7,17,13,1966,1946,1629,-317
2015,7,17,14,2079,2055,1585,-470
2015,7,17,15,2184,2169,1748,-421
2015,7,17,16,2247,2256,1844,-412
2015,7,17,17,2312,2328,1852,-476
2015,7,17,18,2377,2373,1900,-473
2015,7,17,19,2441,2384,1919,-465
2015,7,17,20,2490,2414,1809,-605
2015,7,17,21,2533,2451,1914,-537
2015,7,17,22,2573,2450,1967,-483
2015,7,17,23,2593,2445,2042,-403
2015,7,18,0,2563,2415,1987,-428
2015,7,18,1,2554,2382,1795,-587
2015,7,18,2,2502,2356,1681,-675
2015,7,18,3,2416,2329,1648,-681
2015,7,18,4,2385,2327,1615,-712
2015,7,18,5,2336,2273,1601,-672
2015,7,18,6,2190,2134,1503,-631
2015,7,18,7,2021,2012,1411,-601
2015,7,18,8,1920,1923,1315,-608
2015,7,18,9,1891,1875,1224,-651
2015,7,18,10,1856,1836,1211,-625
2015,7,18,11,1822,1816,1181,-635
2015,7,18,12,1814,1821,1220,-601
2015,7,18,13,1811,1844,1242,-602
2015,7,18,14,1887,1915,1215,-700
2015,7,18,15,2029,2019,1303,-716
2015,7,18,16,2136,2121,1455,-666
2015,7,18,17,2216,2201,1543,-658
2015,7,18,18,2274,2254,1499,-755
2015,7,18,19,2305,2323,1547,-776
2015,7,18,20,2345,2370,1577,-793
2015,7,18,21,2372,2446,1508,-938
2015,7,18,22,2398,2498,1584,-914
2015,7,18,23,2434,2552,1620,-932
2015,7,19,0,2440,2581,1634,-947
2015,7,19,1,2441,2595,1610,-985
2015,7,19,2,2410,2551,1603,-948
2015,7,19,3,2342,2477,1558,-919
2015,7,19,4,2270,2403,1485,-918
2015,7,19,5,2166,2303,1402,-901
2015,7,19,6,2014,2173,1339,-834
2015,7,19,7,1922,2020,1252,-768
2015,7,19,8,1888,1920,1119,-801
2015,7,19,9,1909,1861,1112,-749
2015,7,19,10,1868,1809,1115,-694
2015,7,19,11,1848,1787,1090,-697
2015,7,19,12,1842,1783,1090,-693
2015,7,19,13,1840,1773,1089,-684
2015,7,19,14,1899,1831,1065,-766
2015,7,19,15,2054,1931,1148,-783
2015,7,19,16,2185,2046,1345,-701
2015,7,19,17,2276,2144,1443,-701
2015,7,19,18,2342,2231,1504,-727
2015,7,19,19,2405,2327,1566,-761
2015,7,19,20,2475,2425,1521,-904
2015,7,19,21,2555,2513,1587,-926
2015,7,19,22,2638,2615,1574,-1041
2015,7,19,23,2729,2700,1605,-1095
2015,7,20,0,2791,2766,1632,-1134
2015,7,20,1,2808,2788,1645,-1143
2015,7,20,2,2783,2774,1653,-1121
2015,7,20,3,2711,2699,1588,-1111
2015,7,20,4,2610,2581,1445,-1136
2015,7,20,5,2465,2429,1363,-1066
2015,7,20,6,2239,2209,1263,-946
2015,7,20,7,2073,2038,1182,-856
2015,7,20,8,1998,1924,1081,-843
2015,7,20,9,1913,1870,1080,-790
2015,7,20,10,1886,1817,1093,-724
2015,7,20,11,1868,1814,1081,-733
2015,7,20,12,1887,1864,1099,-765
2015,7,20,13,2000,1955,1156,-799
2015,7,20,14,2133,2091,1165,-926
2015,7,20,15,2319,2249,1189,-1060
2015,7,20,16,2412,2366,1293,-1073
2015,7,20,17,2502,2502,1429,-1073
2015,7,20,18,2602,2613,1536,-1077
2015,7,20,19,2693,2725,1633,-1092
2015,7,20,20,2790,2841,1694,-1147
2015,7,20,21,2928,2950,1717,-1233
2015,7,20,22,3031,3038,1822,-1216
2015,7,20,23,3130,3102,1848,-1254
2015,7,21,0,3176,3139,1870,-1269
2015,7,21,1,3179,3162,1928,-1234
2015,7,21,2,3148,3126,1926,-1200
2015,7,21,3,3071,3026,1841,-1185
2015,7,21,4,2938,2910,1744,-1166
2015,7,21,5,2777,2736,1611,-1125
2015,7,21,6,2507,2497,1523,-974
2015,7,21,7,2283,2289,1370,-919
2015,7,21,8,2181,2169,1256,-913
2015,7,21,9,2141,2087,1199,-888
2015,7,21,10,2093,2020,1163,-857
2015,7,21,11,2064,1986,1222,-764
2015,7,21,12,2095,2007,1226,-781
2015,7,21,13,2162,2081,1141,-940
2015,7,21,14,2299,2220,1188,-1032
2015,7,21,15,2410,2354,1303,-1051
2015,7,21,16,2500,2469,1389,-1080
2015,7,21,17,2587,2581,1465,-1116
2015,7,21,18,2654,2694,1575,-1119
2015,7,21,19,2740,2791,1669,-1122
2015,7,21,20,2838,2893,1747,-1146
2015,7,21,21,2936,2998,1865,-1133
2015,7,21,22,3000,3067,1907,-1160
2015,7,21,23,3041,3092,1912,-1180
2015,7,22,0,3071,3118,1908,-1210
2015,7,22,1,3069,3135,1934,-1201
2015,7,22,2,3024,3100,1861,-1239
2015,7,22,3,2882,2994,1838,-1156
2015,7,22,4,2721,2898,1849,-1049
2015,7,22,5,2526,2702,1689,-1013
2015,7,22,6,2247,2464,1553,-911
2015,7,22,7,2223,2295,1516,-779
2015,7,22,8,2125,2174,1531,-643
2015,7,22,9,2118,2099,1442,-657
2015,7,22,10,2068,2045,1397,-648
2015,7,22,11,2047,2012,1370,-642
2015,7,22,12,2079,2039,1359,-680
2015,7,22,13,2160,2140,1336,-804
2015,7,22,14,2300,2273,1437,-836
2015,7,22,15,2403,2425,1671,-754
2015,7,22,16,2448,2524,1781,-743
2015,7,22,17,2483,2611,1861,-750
2015,7,22,18,2531,2742,1921,-821
2015,7,22,19,2590,2837,2055,-782
2015,7,22,20,2649,2914,1994,-920
2015,7,22,21,2662,2958,1783,-1175
2015,7,22,22,2665,2982,1907,-1075
2015,7,22,23,2663,2938,1890,-1048
2015,7,23,0,2605,2857,1843,-1014
2015,7,23,1,2556,2767,1754,-1013
2015,7,23,2,2490,2653,1676,-977
2015,7,23,3,2382,2579,1544,-1035
2015,7,23,4,2285,2518,1512,-1006
2015,7,23,5,2161,2400,1461,-939
2015,7,23,6,1968,2228,1363,-865
2015,7,23,7,1964,2100,1262,-838
2015,7,23,8,1933,2020,1211,-809
2015,7,23,9,2008,1966,1152,-814
2015,7,23,10,1969,1919,1101,-818
2015,7,23,11,1960,1899,1072,-827
2015,7,23,12,1996,1940,1114,-826
2015,7,23,13,2083,2029,1267,-762
2015,7,23,14,2224,2153,1240,-913
2015,7,23,15,2340,2278,1344,-934
2015,7,23,16,2412,2388,1478,-910
2015,7,23,17,2495,2491,1587,-904
2015,7,23,18,2573,2594,1676,-918
2015,7,23,19,2650,2691,1777,-914
2015,7,23,20,2715,2767,1672,-1095
2015,7,23,21,2761,2845,1672,-1173
2015,7,23,22,2809,2882,1707,-1175
2015,7,23,23,2803,2893,1846,-1047
2015,7,24,0,2769,2898,1687,-1211
2015,7,24,1,2728,2894,1684,-1210
2015,7,24,2,2652,2857,1728,-1129
2015,7,24,3,2564,2765,1675,-1090
2015,7,24,4,2491,2677,1579,-1098
2015,7,24,5,2352,2533,1541,-992
2015,7,24,6,2142,2322,1548,-774
2015,7,24,7,2077,2152,1437,-715
2015,7,24,8,2089,2053,1258,-795
2015,7,24,9,2028,1960,1180,-780
2015,7,24,10,1987,1910,1229,-681
2015,7,24,11,1959,1894,1326,-568
2015,7,24,12,1993,1910,1326,-584
2015,7,24,13,2060,1996,1303,-693
2015,7,24,14,2192,2102,1311,-791
2015,7,24,15,2329,2229,1376,-853
2015,7,24,16,2429,2330,1328,-1002
2015,7,24,17,2523,2418,1374,-1044
2015,7,24,18,2614,2533,1484,-1049
2015,7,24,19,2697,2616,1580,-1036
2015,7,24,20,2785,2697,1658,-1039
2015,7,24,21,2891,2768,1710,-1058
2015,7,24,22,2966,2830,1791,-1039
2015,7,24,23,3003,2846,1788,-1058
2015,7,25,0,2953,2858,1826,-1032
2015,7,25,1,2931,2821,1789,-1032
2015,7,25,2,2875,2764,1789,-975
2015,7,25,3,2797,2658,1628,-1030
2015,7,25,4,2710,2577,1532,-1045
2015,7,25,5,2576,2438,1411,-1027
2015,7,25,6,2368,2265,1376,-889
2015,7,25,7,2299,2102,1256,-846
2015,7,25,8,2155,1993,1284,-709
2015,7,25,9,1956,1911,1323,-588
2015,7,25,10,1890,1863,1355,-508
2015,7,25,11,1835,1816,1334,-482
2015,7,25,12,1830,1820,1301,-519
2015,7,25,13,1823,1833,1307,-526
2015,7,25,14,1898,1902,1260,-642
2015,7,25,15,2064,1997,1166,-831
2015,7,25,16,2198,2142,1172,-970
2015,7,25,17,2309,2239,1281,-958
2015,7,25,18,2401,2355,1415,-940
2015,7,25,19,2482,2421,1494,-927
2015,7,25,20,2553,2516,1560,-956
2015,7,25,21,2632,2588,1646,-942
2015,7,25,22,2703,2678,1752,-926
2015,7,25,23,2784,2732,1737,-995
2015,7,26,0,2840,2780,1743,-1037
2015,7,26,1,2864,2780,1727,-1053
2015,7,26,2,2821,2741,1690,-1051
2015,7,26,3,2736,2613,1563,-1050
2015,7,26,4,2608,2528,1563,-965
2015,7,26,5,2444,2394,1499,-895
2015,7,26,6,2240,2198,1400,-798
2015,7,26,7,2229,2034,1266,-768
2015,7,26,8,2034,1935,1246,-689
2015,7,26,9,1870,1853,1309,-544
2015,7,26,10,1819,1794,1293,-501
2015,7,26,11,1776,1771,1314,-457
2015,7,26,12,1776,1763,1413,-350
2015,7,26,13,1749,1752,1332,-420
2015,7,26,14,1780,1804,1369,-435
2015,7,26,15,1893,1905,1367,-538
2015,7,26,16,1985,2006,1467,-539
2015,7,26,17,2059,2105,1555,-550
2015,7,26,18,2121,2168,1630,-538
2015,7,26,19,2187,2240,1659,-581
2015,7,26,20,2237,2295,1634,-661
2015,7,26,21,2304,2374,1632,-742
2015,7,26,22,2389,2463,1722,-741
2015,7,26,23,2447,2526,1700,-826
2015,7,27,0,2514,2578,1745,-833
2015,7,27,1,2517,2567,1739,-828
2015,7,27,2,2480,2500,1695,-805
2015,7,27,3,2378,2415,1677,-738
2015,7,27,4,2270,2354,1646,-708
2015,7,27,5,2132,2224,1680,-544
2015,7,27,6,1927,2033,1680,-353
2015,7,27,7,1951,1896,1631,-265
2015,7,27,8,1793,1821,1618,-203
2015,7,27,9,1750,1764,1622,-142
2015,7,27,10,1716,1738,1593,-145
2015,7,27,11,1706,1733,1578,-155
2015,7,27,12,1754,1776,1629,-147
2015,7,27,13,1840,1880,1809,-71
2015,7,27,14,1968,1993,1931,-62
2015,7,27,15,2089,2098,1913,-185
2015,7,27,16,2144,2160,1887,-273
2015,7,27,17,2203,2212,1828,-384
2015,7,27,18,2258,2252,1861,-391
2015,7,27,19,2305,2256,1767,-489
2015,7,27,20,2347,2265,1659,-606
2015,7,27,21,2409,2289,1663,-626
2015,7,27,22,2448,2317,1782,-535
2015,7,27,23,2461,2322,1783,-539
2015,7,28,0,2495,2347,1834,-513
2015,7,28,1,2478,2349,1849,-500
2015,7,28,2,2435,2315,1727,-588
2015,7,28,3,2341,2287,1675,-612
2015,7,28,4,2250,2262,1624,-638
2015,7,28,5,2114,2176,1578,-598
2015,7,28,6,1906,2001,1355,-646
2015,7,28,7,1848,1871,1220,-651
2015,7,28,8,1757,1812,1166,-646
2015,7,28,9,1755,1758,1178,-580
2015,7,28,10,1711,1738,1136,-602
2015,7,28,11,1697,1737,1135,-602
2015,7,28,12,1739,1779,1186,-593
2015,7,28,13,1820,1877,1252,-625
2015,7,28,14,1942,1996,1188,-808
2015,7,28,15,2053,2088,1190,-898
2015,7,28,16,2138,2152,1221,-931
2015,7,28,17,2221,2208,1273,-935
2015,7,28,18,2287,2264,1260,-1004
2015,7,28,19,2336,2293,1296,-997
2015,7,28,20,2375,2334,1281,-1053
2015,7,28,21,2430,2382,1292,-1090
2015,7,28,22,2477,2426,1362,-1064
2015,7,28,23,2504,2473,1365,-1108
2015,7,29,0,2561,2528,1418,-1110
2015,7,29,1,2574,2576,1620,-956
2015,7,29,2,2556,2562,1630,-932
2015,7,29,3,2488,2505,1566,-939
2015,7,29,4,2391,2448,1507,-941
2015,7,29,5,2244,2327,1415,-912
2015,7,29,6,2023,2148,1300,-848
2015,7,29,7,1919,2001,1177,-824
2015,7,29,8,1868,1907,1122,-785
2015,7,29,9,1887,1861,1129,-732
2015,7,29,10,1842,1812,1124,-688
2015,7,29,11,1833,1811,1139,-672
2015,7,29,12,1870,1851,1171,-680
2015,7,29,13,1957,1939,1274,-665
2015,7,29,14,2082,2043,1200,-843
2015,7,29,15,2203,2152,1239,-913
2015,7,29,16,2296,2235,1251,-984
2015,7,29,17,2395,2276,1228,-1048
2015,7,29,18,2496,2352,1222,-1130
2015,7,29,19,2579,2410,1266,-1144
2015,7,29,20,2657,2502,1398,-1104
2015,7,29,21,2740,2589,1418,-1171
2015,7,29,22,2810,2666,1535,-1131
2015,7,29,23,2871,2733,1615,-1118
2015,7,30,0,2935,2794,1656,-1138
2015,7,30,1,2983,2829,1828,-1001
2015,7,30,2,2974,2815,1807,-1008
2015,7,30,3,2889,2742,1746,-996
2015,7,30,4,2736,2657,1619,-1038
2015,7,30,5,2535,2473,1451,-1022
2015,7,30,6,2258,2260,1353,-907
2015,7,30,7,2119,2081,1196,-885
2015,7,30,8,2045,1988,1062,-926
2015,7,30,9,1952,1924,1034,-890
2015,7,30,10,1901,1885,1012,-873
2015,7,30,11,1881,1865,1004,-861
2015,7,30,12,1926,1902,1023,-879
2015,7,30,13,2011,1983,1098,-885
2015,7,30,14,2135,2094,1208,-886
2015,7,30,15,2266,2218,1336,-882
2015,7,30,16,2368,2325,1371,-954
2015,7,30,17,2474,2406,1389,-1017
2015,7,30,18,2583,2507,1457,-1050
2015,7,30,19,2671,2598,1628,-970
2015,7,30,20,2774,2729,1719,-1010
2015,7,30,21,2886,2838,1830,-1008
2015,7,30,22,2976,2938,1919,-1019
2015,7,30,23,3046,3009,1977,-1032
2015,7,31,0,3096,3065,2036,-1029
2015,7,31,1,3135,3089,1932,-1157
2015,7,31,2,3111,3054,1903,-1151
2015,7,31,3,2998,2959,1783,-1176
2015,7,31,4,2814,2827,1707,-1120
2015,7,31,5,2583,2657,1627,-1030
2015,7,31,6,2292,2413,1422,-991
2015,7,31,7,2287,2233,1171,-1062
2015,7,31,8,2154,2068,1189,-879
2015,7,31,9,2080,1945,1092,-853
2015,7,31,10,2027,1887,1113,-774
2015,7,31,11,2006,1860,1102,-758
2015,7,31,12,2046,1905,1206,-699
2015,7,31,13,2123,2000,1468,-532
2015,7,31,14,2235,2107,1429,-678
2015,7,31,15,2378,2250,1552,-698
2015,7,31,16,2504,2378,1556,-822
2015,7,31,17,2607,2489,1539,-950
2015,7,31,18,2708,2593,1549,-1044
2015,7,31,19,2787,2715,1598,-1117
2015,7,31,20,2878,2831,1636,-1195
2015,7,31,21,2979,2964,1715,-1249
2015,7,31,22,3075,3071,1793,-1278
2015,7,31,23,3149,3115,1849,-1266
2015,8,1,0,3157,3153,1887,-1266
2015,8,1,1,3192,3135,1885,-1250
2015,8,1,2,3165,3121,1859,-1262
2015,8,1,3,3030,3005,1754,-1251
2015,8,1,4,2834,2878,1673,-1205
2015,8,1,5,2642,2706,1590,-1116
2015,8,1,6,2389,2474,1413,-1061
2015,8,1,7,2365,2300,1266,-1034
2015,8,1,8,2226,2166,1262,-904
2015,8,1,9,2115,2079,1331,-748
2015,8,1,10,2060,2002,1282,-720
2015,8,1,11,2008,1955,1263,-692
2015,8,1,12,2000,1953,1267,-686
2015,8,1,13,2002,1959,1321,-638
2015,8,1,14,2070,2018,1352,-666
2015,8,1,15,2239,2161,1472,-689
2015,8,1,16,2388,2287,1562,-725
2015,8,1,17,2495,2446,1553,-893
2015,8,1,18,2596,2586,1636,-950
2015,8,1,19,2675,2709,1647,-1062
2015,8,1,20,2773,2854,1795,-1059
2015,8,1,21,2865,2978,1914,-1064
2015,8,1,22,2960,3078,1976,-1102
2015,8,1,23,3043,3150,1921,-1229
2015,8,2,0,3103,3190,1857,-1333
2015,8,2,1,3118,3183,1841,-1342
2015,8,2,2,3083,3130,1797,-1333
2015,8,2,3,2934,3009,1839,-1170
2015,8,2,4,2778,2893,1785,-1108
2015,8,2,5,2613,2730,1697,-1033
2015,8,2,6,2404,2502,1526,-976
2015,8,2,7,2376,2320,1383,-937
2015,8,2,8,2230,2178,1239,-939
2015,8,2,9,2142,2079,1167,-912
2015,8,2,10,2066,2003,1044,-959
2015,8,2,11,2015,1953,1026,-927
2015,8,2,12,2011,1936,1144,-792
2015,8,2,13,2005,1923,1224,-699
2015,8,2,14,2056,1949,1230,-719
2015,8,2,15,2204,2090,1353,-737
2015,8,2,16,2335,2237,1386,-851
2015,8,2,17,2436,2390,1423,-967
2015,8,2,18,2536,2530,1523,-1007
2015,8,2,19,2622,2672,1650,-1022
2015,8,2,20,2710,2814,1656,-1158
2015,8,2,21,2807,2932,1678,-1254
2015,8,2,22,2908,3023,1664,-1359
2015,8,2,23,2988,3104,1738,-1366
2015,8,3,0,3043,3155,1795,-1360
2015,8,3,1,3042,3111,1766,-1345
2015,8,3,2,2976,3029,1739,-1290
2015,8,3,3,2816,2937,1717,-1220
2015,8,3,4,2705,2869,1806,-1063
2015,8,3,5,2557,2696,1691,-1005
2015,8,3,6,2332,2457,1497,-960
2015,8,3,7,2313,2286,1478,-808
2015,8,3,8,2200,2189,1423,-766
2015,8,3,9,2141,2125,1503,-622
2015,8,3,10,2101,2063,1656,-407
2015,8,3,11,2079,2046,1613,-433
2015,8,3,12,2125,2091,1611,-480
2015,8,3,13,2252,2188,1577,-611
2015,8,3,14,2408,2299,1684,-615
2015,8,3,15,2578,2438,1667,-771
2015,8,3,16,2657,2534,1751,-783
2015,8,3,17,2710,2633,1768,-865
2015,8,3,18,2766,2749,1834,-915
2015,8,3,19,2803,2816,1798,-1018
2015,8,3,20,2837,2855,1877,-978
2015,8,3,21,2874,2922,1846,-1076
2015,8,3,22,2873,2997,1902,-1095
2015,8,3,23,2868,3029,1880,-1149
2015,8,4,0,2877,3049,1956,-1093
2015,8,4,1,2848,3067,1986,-1081
2015,8,4,2,2778,3052,1989,-1063
2015,8,4,3,2656,2967,1925,-1042
2015,8,4,4,2581,2888,1826,-1062
2015,8,4,5,2445,2693,1645,-1048
2015,8,4,6,2245,2456,1473,-983
2015,8,4,7,2198,2280,1303,-977
2015,8,4,8,2091,2179,1209,-970
2015,8,4,9,2112,2087,1182,-905
2015,8,4,10,2044,2052,1218,-834
2015,8,4,11,2010,2021,1152,-869
2015,8,4,12,2037,2057,1193,-864
2015,8,4,13,2116,2129,1221,-908
2015,8,4,14,2219,2222,1337,-885
2015,8,4,15,2326,2356,1430,-926
2015,8,4,16,2442,2483,1513,-970
2015,8,4,17,2548,2615,1653,-962
2015,8,4,18,2653,2740,1738,-1002
2015,8,4,19,2739,2842,1740,-1102
2015,8,4,20,2829,2945,1834,-1111
2015,8,4,21,2954,3051,1969,-1082
2015,8,4,22,3058,3134,1969,-1165
2015,8,4,23,3101,3155,1957,-1198
2015,8,5,0,3152,3140,1920,-1220
2015,8,5,1,3152,3121,1910,-1211
2015,8,5,2,3104,3049,1865,-1184
2015,8,5,3,3009,2947,1781,-1166
2015,8,5,4,2890,2862,1757,-1105
2015,8,5,5,2724,2676,1673,-1003
2015,8,5,6,2496,2451,1568,-883
2015,8,5,7,2353,2301,1426,-875
2015,8,5,8,2228,2210,1332,-878
2015,8,5,9,2141,2113,1327,-786
2015,8,5,10,2100,2041,1293,-748
2015,8,5,11,2059,2005,1114,-891
2015,8,5,12,2072,2033,1091,-942
2015,8,5,13,2148,2133,1177,-956
2015,8,5,14,2259,2250,1337,-913
2015,8,5,15,2376,2363,1414,-949
2015,8,5,16,2489,2469,1455,-1014
2015,8,5,17,2586,2528,1449,-1079
2015,8,5,18,2674,2572,1510,-1062
2015,8,5,19,2739,2644,1537,-1107
2015,8,5,20,2774,2718,1649,-1069
2015,8,5,21,2830,2779,1744,-1035
2015,8,5,22,2864,2767,1730,-1037
2015,8,5,23,2858,2776,1778,-998
2015,8,6,0,2857,2798,1841,-957
2015,8,6,1,2847,2799,1813,-986
2015,8,6,2,2800,2753,1801,-952
2015,8,6,3,2699,2666,1754,-912
2015,8,6,4,2582,2629,1731,-898
2015,8,6,5,2383,2471,1600,-871
2015,8,6,6,2151,2275,1389,-886
2015,8,6,7,2138,2116,1215,-901
2015,8,6,8,2029,2019,1217,-802
2015,8,6,9,1978,1959,1173,-786
2015,8,6,10,1931,1905,1117,-788
2015,8,6,11,1904,1888,1100,-788
2015,8,6,12,1924,1928,1148,-780
2015,8,6,13,1997,2014,1191,-823
2015,8,6,14,2098,2106,1239,-867
2015,8,6,15,2224,2204,1263,-941
2015,8,6,16,2337,2276,1247,-1029
2015,8,6,17,2428,2353,1320,-1033
2015,8,6,18,2517,2436,1394,-1042
2015,8,6,19,2618,2487,1496,-991
2015,8,6,20,2708,2563,1533,-1030
2015,8,6,21,2800,2631,1578,-1053
2015,8,6,22,2869,2702,1639,-1063
2015,8,6,23,2912,2748,1695,-1053
2015,8,7,0,2959,2786,1743,-1043
2015,8,7,1,2956,2787,1786,-1001
2015,8,7,2,2908,2728,1710,-1018
2015,8,7,3,2802,2651,1587,-1064
2015,8,7,4,2668,2601,1532,-1069
2015,8,7,5,2478,2452,1464,-988
2015,8,7,6,2248,2260,1310,-950
2015,8,7,7,2156,2093,1164,-929
2015,8,7,8,2071,2004,1027,-977
2015,8,7,9,1950,1942,1008,-934
2015,8,7,10,1915,1909,973,-936
2015,8,7,11,1896,1884,957,-927
2015,8,7,12,1934,1934,983,-951
2015,8,7,13,2034,2023,1069,-954
2015,8,7,14,2136,2114,1121,-993
2015,8,7,15,2246,2212,1178,-1034
2015,8,7,16,2334,2291,1261,-1030
2015,8,7,17,2399,2356,1359,-997
2015,8,7,18,2469,2405,1395,-1010
2015,8,7,19,2534,2415,1387,-1028
2015,8,7,20,2604,2460,1428,-1032
2015,8,7,21,2688,2495,1464,-1031
2015,8,7,22,2739,2543,1607,-936
2015,8,7,23,2776,2551,1637,-914
2015,8,8,0,2708,2533,1519,-1014
2015,8,8,1,2688,2481,1529,-952
2015,8,8,2,2622,2428,1365,-1063
2015,8,8,3,2495,2398,1347,-1051
2015,8,8,4,2412,2393,1327,-1066
2015,8,8,5,2268,2306,1215,-1091
2015,8,8,6,2096,2165,1110,-1055
2015,8,8,7,2104,2038,1050,-988
2015,8,8,8,1966,1972,1054,-918
2015,8,8,9,1947,1900,1072,-828
2015,8,8,10,1918,1875,1048,-827
2015,8,8,11,1895,1839,1032,-807
2015,8,8,12,1904,1855,999,-856
2015,8,8,13,1935,1879,1014,-865
2015,8,8,14,1987,1910,1012,-898
2015,8,8,15,2105,2003,1069,-934
2015,8,8,16,2189,2090,1097,-993
2015,8,8,17,2246,2171,1093,-1078
2015,8,8,18,2305,2244,1167,-1077
2015,8,8,19,2342,2292,1215,-1077
2015,8,8,20,2392,2322,1248,-1074
2015,8,8,21,2451,2381,1309,-1072
2015,8,8,22,2515,2457,1382,-1075
2015,8,8,23,2567,2517,1429,-1088
2015,8,9,0,2624,2572,1490,-1082
2015,8,9,1,2624,2569,1490,-1079
2015,8,9,2,2580,2527,1465,-1062
2015,8,9,3,2494,2441,1343,-1098
2015,8,9,4,2420,2400,1349,-1051
2015,8,9,5,2303,2275,1176,-1099
2015,8,9,6,2158,2109,1111,-998
2015,8,9,7,2053,1974,992,-982
2015,8,9,8,1942,1886,1131,-755
2015,8,9,9,1897,1823,1198,-625
2015,8,9,10,1873,1792,1184,-601
2015,8,9,11,1850,1749,1148,-601
2015,8,9,12,1855,1752,1198,-554
2015,8,9,13,1873,1756,1151,-605
2015,8,9,14,1898,1787,1136,-651
2015,8,9,15,2065,1904,1221,-683
2015,8,9,16,2195,2006,1277,-729
2015,8,9,17,2302,2115,1252,-863
2015,8,9,18,2397,2219,1241,-978
2015,8,9,19,2476,2328,1329,-999
2015,8,9,20,2546,2419,1456,-963
2015,8,9,21,2638,2515,1560,-955
2015,8,9,22,2726,2588,1622,-966
2015,8,9,23,2794,2619,1638,-981
2015,8,10,0,2861,2686,1598,-1088
2015,8,10,1,2851,2689,1573,-1116
2015,8,10,2,2796,2636,1507,-1129
2015,8,10,3,2721,2546,1494,-1052
2015,8,10,4,2657,2492,1517,-975
2015,8,10,5,2514,2335,1368,-967
2015,8,10,6,2311,2151,1279,-872
2015,8,10,7,2147,1995,1242,-753
2015,8,10,8,2046,1914,1228,-686
2015,8,10,9,1991,1868,1153,-715
2015,8,10,10,1963,1840,1164,-676
2015,8,10,11,1952,1841,1149,-692
2015,8,10,12,1998,1894,1179,-715
2015,8,10,13,2101,2011,1263,-748
2015,8,10,14,2210,2130,1240,-890
2015,8,10,15,2436,2239,1247,-992
2015,8,10,16,2568,2366,1358,-1008
2015,8,10,17,2698,2480,1410,-1070
2015,8,10,18,2846,2607,1553,-1054
2015,8,10,19,2974,2739,1678,-1061
2015,8,10,20,3096,2847,1770,-1077
2015,8,10,21,3204,2924,1856,-1068
2015,8,10,22,3282,2926,1867,-1059
2015,8,10,23,3337,2876,1814,-1062
2015,8,11,0,3401,2880,1809,-1071
2015,8,11,1,3388,2896,1848,-1048
2015,8,11,2,3321,2857,1760,-1097
2015,8,11,3,3207,2756,1717,-1039
2015,8,11,4,3086,2694,1710,-984
2015,8,11,5,2892,2501,1516,-985
2015,8,11,6,2613,2290,1438,-852
2015,8,11,7,2401,2120,1309,-811
2015,8,11,8,2226,2024,1198,-826
2015,8,11,9,1986,1938,1228,-710
2015,8,11,10,1943,1889,1240,-649
2015,8,11,11,1927,1880,1282,-598
2015,8,11,12,1972,1909,1335,-574
2015,8,11,13,2072,2021,1349,-672
2015,8,11,14,2191,2117,1255,-862
2015,8,11,15,2326,2239,1210,-1029
2015,8,11,16,2482,2378,1333,-1045
2015,8,11,17,2653,2500,1439,-1061
2015,8,11,18,2850,2665,1618,-1047
2015,8,11,19,2993,2803,1728,-1075
2015,8,11,20,3089,2955,1794,-1161
2015,8,11,21,3141,3026,1866,-1160
2015,8,11,22,3200,3051,1917,-1134
2015,8,11,23,3219,3028,1927,-1101
2015,8,12,0,3272,2942,1798,-1144
2015,8,12,1,3255,2913,1692,-1221
2015,8,12,2,3183,2877,1704,-1173
2015,8,12,3,3050,2827,1631,-1196
2015,8,12,4,2913,2834,1656,-1178
2015,8,12,5,2690,2647,1559,-1088
2015,8,12,6,2440,2413,1461,-952
2015,8,12,7,2485,2250,1380,-870
2015,8,12,8,2292,2137,1369,-768
2015,8,12,9,2136,2056,1364,-692
2015,8,12,10,2096,2002,1310,-692
2015,8,12,11,2100,1983,1270,-713
2015,8,12,12,2164,2032,1316,-716
2015,8,12,13,2283,2126,1389,-737
2015,8,12,14,2416,2243,1356,-887
2015,8,12,15,2555,2402,1410,-992
2015,8,12,16,2691,2620,1496,-1124
2015,8,12,17,2808,2735,1547,-1188
2015,8,12,18,2927,2921,1628,-1293
2015,8,12,19,2982,3017,1688,-1329
2015,8,12,20,3018,3119,1769,-1350
2015,8,12,21,3031,3188,1826,-1362
2015,8,12,22,3060,3262,1811,-1451
2015,8,12,23,3057,3298,1866,-1432
2015,8,13,0,3065,3303,2051,-1252
2015,8,13,1,3039,3270,1922,-1348
2015,8,13,2,2989,3188,1699,-1489
2015,8,13,3,2905,3068,1605,-1463
2015,8,13,4,2824,2964,1652,-1312
2015,8,13,5,2600,2744,1539,-1205
2015,8,13,6,2336,2503,1585,-918
2015,8,13,7,2358,2324,1435,-889
2015,8,13,8,2179,2181,1288,-893
2015,8,13,9,2164,2090,1182,-908
2015,8,13,10,2118,2038,1130,-908
2015,8,13,11,2108,2015,1115,-900
2015,8,13,12,2139,2039,1177,-862
2015,8,13,13,2226,2138,1270,-868
2015,8,13,14,2341,2241,1143,-1098
2015,8,13,15,2494,2398,1245,-1153
2015,8,13,16,2647,2568,1366,-1202
2015,8,13,17,2810,2720,1383,-1337
2015,8,13,18,2965,2909,1493,-1416
2015,8,13,19,3068,3036,1538,-1498
2015,8,13,20,3135,3179,1739,-1440
2015,8,13,21,3190,3286,1782,-1504
2015,8,13,22,3244,3353,1818,-1535
2015,8,13,23,3278,3362,1862,-1500
2015,8,14,0,3293,3368,1830,-1538
2015,8,14,1,3286,3343,1804,-1539
2015,8,14,2,3229,3272,1746,-1526
2015,8,14,3,3111,3158,1544,-1614
2015,8,14,4,2993,3064,1534,-1530
2015,8,14,5,2755,2836,1528,-1308
2015,8,14,6,2482,2599,1629,-970
2015,8,14,7,2392,2436,1476,-960
2015,8,14,8,2287,2332,1393,-939
2015,8,14,9,2244,2260,1281,-979
2015,8,14,10,2183,2223,1169,-1054
2015,8,14,11,2157,2185,1082,-1103
2015,8,14,12,2193,2198,1064,-1134
2015,8,14,13,2294,2274,1122,-1152
2015,8,14,14,2414,2382,1212,-1170
2015,8,14,15,2560,2542,1441,-1101
2015,8,14,16,2700,2720,1616,-1104
2015,8,14,17,2826,2888,1671,-1217
2015,8,14,18,2942,3015,1652,-1363
2015,8,14,19,3002,3126,1668,-1458
2015,8,14,20,3071,3174,1702,-1472
2015,8,14,21,3132,3242,1806,-1436
2015,8,14,22,3183,3315,1955,-1360
2015,8,14,23,3185,3295,1959,-1336
2015,8,15,0,3098,3242,1945,-1297
2015,8,15,1,3067,3152,1820,-1332
2015,8,15,2,2970,3075,1761,-1314
2015,8,15,3,2824,2932,1786,-1146
2015,8,15,4,2688,2830,1869,-961
2015,8,15,5,2461,2642,1783,-859
2015,8,15,6,2222,2406,1717,-689
2015,8,15,7,2150,2240,1730,-510
2015,8,15,8,2047,2103,1702,-401
2015,8,15,9,2035,2014,1491,-523
2015,8,15,10,1966,1946,1404,-542
2015,8,15,11,1909,1893,1410,-483
2015,8,15,12,1877,1891,1409,-482
2015,8,15,13,1881,1912,1425,-487
2015,8,15,14,1929,1944,1302,-642
2015,8,15,15,2056,2060,1271,-789
2015,8,15,16,2168,2169,1289,-880
2015,8,15,17,2257,2253,1311,-942
2015,8,15,18,2328,2320,1249,-1071
2015,8,15,19,2363,2387,1279,-1108
2015,8,15,20,2413,2456,1349,-1107
2015,8,15,21,2468,2514,1382,-1132
2015,8,15,22,2541,2591,1463,-1128
2015,8,15,23,2587,2646,1535,-1111
2015,8,16,0,2624,2665,1548,-1117
2015,8,16,1,2614,2650,1542,-1108
2015,8,16,2,2555,2583,1504,-1079
2015,8,16,3,2427,2483,1482,-1001
2015,8,16,4,2333,2431,1555,-876
2015,8,16,5,2171,2292,1492,-800
2015,8,16,6,1996,2125,1370,-755
2015,8,16,7,1955,1991,1247,-744
2015,8,16,8,1871,1901,1134,-767
2015,8,16,9,1862,1839,1076,-763
2015,8,16,10,1814,1809,1079,-730
2015,8,16,11,1781,1786,1126,-660
2015,8,16,12,1769,1793,1061,-732
2015,8,16,13,1780,1811,1046,-765
2015,8,16,14,1816,1821,943,-878
2015,8,16,15,1965,1908,1004,-904
2015,8,16,16,2094,1993,1014,-979
2015,8,16,17,2189,2079,1043,-1036
2015,8,16,18,2264,2127,1030,-1097
2015,8,16,19,2339,2202,1065,-1137
2015,8,16,20,2414,2279,1123,-1156
2015,8,16,21,2507,2367,1223,-1144
2015,8,16,22,2604,2464,1283,-1181
2015,8,16,23,2676,2553,1351,-1202
2015,8,17,0,2714,2614,1496,-1118
2015,8,17,1,2703,2628,1519,-1109
2015,8,17,2,2645,2559,1524,-1035
2015,8,17,3,2518,2466,1440,-1026
2015,8,17,4,2428,2385,1422,-963
2015,8,17,5,2262,2221,1327,-894
2015,8,17,6,2048,2018,1354,-664
2015,8,17,7,1931,1881,1198,-683
2015,8,17,8,1849,1797,1060,-737
2015,8,17,9,1769,1777,1004,-773
2015,8,17,10,1741,1735,990,-745
2015,8,17,11,1731,1746,1029,-717
2015,8,17,12,1779,1795,1083,-712
2015,8,17,13,1893,1896,1147,-749
2015,8,17,14,2011,2010,1134,-876
2015,8,17,15,2206,2131,1195,-936
2015,8,17,16,2316,2228,1207,-1021
2015,8,17,17,2405,2324,1333,-991
2015,8,17,18,2497,2396,1444,-952
2015,8,17,19,2584,2470,1505,-965
2015,8,17,20,2660,2536,1552,-984
2015,8,17,21,2737,2617,1713,-904
2015,8,17,22,2808,2686,1794,-892
2015,8,17,23,2836,2733,1849,-884
2015,8,18,0,2863,2762,1896,-866
2015,8,18,1,2852,2780,1917,-863
2015,8,18,2,2790,2746,1830,-916
2015,8,18,3,2668,2645,1783,-862
2015,8,18,4,2576,2601,1743,-858
2015,8,18,5,2390,2401,1564,-837
2015,8,18,6,2148,2203,1527,-676
2015,8,18,7,2097,2054,1347,-707
2015,8,18,8,1861,1975,1226,-749
2015,8,18,9,1923,1906,1095,-811
2015,8,18,10,1876,1862,989,-873
2015,8,18,11,1856,1854,954,-900
2015,8,18,12,1893,1907,999,-908
2015,8,18,13,1991,1995,1090,-905
2015,8,18,14,2094,2101,1144,-957
2015,8,18,15,2106,2199,1271,-928
2015,8,18,16,2198,2274,1328,-946
2015,8,18,17,2280,2358,1416,-942
2015,8,18,18,2366,2417,1410,-1007
2015,8,18,19,2446,2476,1431,-1045
2015,8,18,20,2536,2547,1499,-1048
2015,8,18,21,2626,2629,1588,-1041
2015,8,18,22,2710,2697,1712,-985
2015,8,18,23,2756,2748,1807,-941
2015,8,19,0,2795,2781,1865,-916
2015,8,19,1,2808,2787,1886,-901
2015,8,19,2,2759,2744,1837,-907
2015,8,19,3,2632,2688,1783,-905
2015,8,19,4,2536,2620,1776,-844
2015,8,19,5,2338,2434,1604,-830
2015,8,19,6,2095,2219,1430,-789
2015,8,19,7,1978,2077,1357,-720
2015,8,19,8,2039,1991,1298,-693
2015,8,19,9,1990,1928,1132,-796
2015,8,19,10,1960,1883,1092,-791
2015,8,19,11,1963,1874,1119,-755
2015,8,19,12,2028,1928,1130,-798
2015,8,19,13,2152,2018,1175,-843
2015,8,19,14,2284,2122,1187,-935
2015,8,19,15,2381,2233,1220,-1013
2015,8,19,16,2462,2314,1307,-1007
2015,8,19,17,2537,2386,1320,-1066
2015,8,19,18,2612,2448,1328,-1120
2015,8,19,19,2686,2532,1400,-1132
2015,8,19,20,2776,2621,1475,-1146
2015,8,19,21,2871,2704,1421,-1283
2015,8,19,22,2969,2772,1473,-1299
2015,8,19,23,3047,2817,1518,-1299
2015,8,20,0,3106,2821,1639,-1182
2015,8,20,1,3128,2814,1647,-1167
2015,8,20,2,3073,2749,1604,-1145
2015,8,20,3,2944,2686,1558,-1128
2015,8,20,4,2831,2632,1537,-1095
2015,8,20,5,2596,2452,1412,-1040
2015,8,20,6,2342,2234,1356,-878
2015,8,20,7,2138,2099,1270,-829
2015,8,20,8,2064,2006,1096,-910
2015,8,20,9,1994,1950,1123,-827
2015,8,20,10,1953,1908,1080,-828
2015,8,20,11,1941,1902,1058,-844
2015,8,20,12,1988,1939,1093,-846
2015,8,20,13,2099,2063,1130,-933
2015,8,20,14,2212,2153,1064,-1089
2015,8,20,15,2334,2255,1140,-1115
2015,8,20,16,2444,2343,1184,-1159
2015,8,20,17,2544,2424,1268,-1156
2015,8,20,18,2634,2511,1313,-1198
2015,8,20,19,2710,2587,1379,-1208
2015,8,20,20,2797,2588,1412,-1176
2015,8,20,21,2879,2799,1432,-1367
2015,8,20,22,2963,2893,1348,-1545
2015,8,20,23,3000,2965,1430,-1535
2015,8,21,0,3018,3005,1520,-1485
2015,8,21,1,3024,3003,1540,-1463
2015,8,21,2,2969,2953,1483,-1470
2015,8,21,3,2853,2847,1443,-1404
2015,8,21,4,2733,2745,1390,-1355
2015,8,21,5,2486,2533,1269,-1264
2015,8,21,6,2230,2315,1263,-1052
2015,8,21,7,2196,2155,1183,-972
2015,8,21,8,2107,2048,1157,-891
2015,8,21,9,2014,1981,1133,-848
2015,8,21,10,1965,1935,1036,-899
2015,8,21,11,1946,1918,939,-979
2015,8,21,12,1992,1946,955,-991
2015,8,21,13,2101,2041,1021,-1020
2015,8,21,14,2200,2141,1067,-1074
2015,8,21,15,2314,2247,1218,-1029
2015,8,21,16,2410,2332,1295,-1037
2015,8,21,17,2487,2431,1344,-1087
2015,8,21,18,2551,2493,1364,-1129
2015,8,21,19,2602,2545,1511,-1034
2015,8,21,20,2674,2628,1598,-1030
2015,8,21,21,2733,2704,1674,-1030
2015,8,21,22,2791,2772,1744,-1028
2015,8,21,23,2824,2818,1769,-1049
2015,8,22,0,2797,2845,1818,-1027
2015,8,22,1,2763,2833,1797,-1036
2015,8,22,2,2700,2757,1689,-1068
2015,8,22,3,2568,2667,1609,-1058
2015,8,22,4,2465,2607,1530,-1077
2015,8,22,5,2273,2449,1434,-1015
2015,8,22,6,2086,2263,1455,-808
2015,8,22,7,2090,2111,1427,-684
2015,8,22,8,2004,2001,1432,-569
2015,8,22,9,1966,1933,1407,-526
2015,8,22,10,1901,1889,1360,-529
2015,8,22,11,1871,1862,1393,-469
2015,8,22,12,1870,1857,1333,-524
2015,8,22,13,1908,1877,1376,-501
2015,8,22,14,1951,1898,1336,-562
2015,8,22,15,2060,2017,1367,-650
2015,8,22,16,2144,2108,1274,-834
2015,8,22,17,2196,2179,1049,-1130
2015,8,22,18,2237,2239,1060,-1179
2015,8,22,19,2273,2283,1094,-1189
2015,8,22,20,2334,2325,1121,-1204
2015,8,22,21,2399,2378,1153,-1225
2015,8,22,22,2468,2446,1244,-1202
2015,8,22,23,2538,2496,1291,-1205
2015,8,23,0,2586,2533,1340,-1193
2015,8,23,1,2594,2550,1312,-1238
2015,8,23,2,2532,2491,1286,-1205
2015,8,23,3,2403,2412,1210,-1202
2015,8,23,4,2320,2366,1221,-1145
2015,8,23,5,2169,2219,1146,-1073
2015,8,23,6,2008,2063,999,-1064
2015,8,23,7,1975,1948,908,-1040
2015,8,23,8,1871,1874,909,-965
2015,8,23,9,1841,1822,961,-861
2015,8,23,10,1806,1791,898,-893
2015,8,23,11,1795,1772,923,-849
2015,8,23,12,1803,1771,999,-772
2015,8,23,13,1837,1786,1062,-724
2015,8,23,14,1861,1808,1035,-773
2015,8,23,15,1984,1907,1157,-750
2015,8,23,16,2087,1995,1227,-768
2015,8,23,17,2169,2052,1166,-886
2015,8,23,18,2242,2106,1042,-1064
2015,8,23,19,2320,2166,991,-1175
2015,8,23,20,2414,2227,952,-1275
2015,8,23,21,2530,2328,1038,-1290
2015,8,23,22,2645,2426,1099,-1327
2015,8,23,23,2749,2537,1218,-1319
2015,8,24,0,2826,2635,1312,-1323
2015,8,24,1,2845,2655,1345,-1310
2015,8,24,2,2793,2598,1292,-1306
2015,8,24,3,2652,2551,1238,-1313
2015,8,24,4,2560,2468,1161,-1307
2015,8,24,5,2359,2284,1090,-1194
2015,8,24,6,2147,2083,998,-1085
2015,8,24,7,2061,1945,895,-1050
2015,8,24,8,1974,1852,926,-926
2015,8,24,9,1873,1798,991,-807
2015,8,24,10,1854,1781,1072,-709
2015,8,24,11,1855,1769,1088,-681
2015,8,24,12,1912,1851,1190,-661
2015,8,24,13,2026,2010,1275,-735
2015,8,24,14,2143,2111,1030,-1081
2015,8,24,15,2331,2206,1026,-1180
2015,8,24,16,2450,2298,1011,-1287
2015,8,24,17,2568,2404,1101,-1303
2015,8,24,18,2672,2488,1145,-1343
2015,8,24,19,2755,2588,1265,-1323
2015,8,24,20,2845,2693,1227,-1466
2015,8,24,21,2931,2816,1313,-1503
2015,8,24,22,3010,2940,1429,-1511
2015,8,24,23,3067,3012,1498,-1514
2015,8,25,0,3116,3070,1575,-1495
2015,8,25,1,3118,3078,1588,-1490
2015,8,25,2,3067,3035,1562,-1473
2015,8,25,3,2938,2941,1452,-1489
2015,8,25,4,2820,2830,1445,-1385
2015,8,25,5,2593,2568,1249,-1319
2015,8,25,6,2343,2325,1291,-1034
2015,8,25,7,2288,2151,1134,-1017
2015,8,25,8,2150,2052,1042,-1010
2015,8,25,9,2040,1981,996,-985
2015,8,25,10,2003,1927,924,-1003
2015,8,25,11,1988,1910,912,-998
2015,8,25,12,2026,1943,958,-985
2015,8,25,13,2132,2083,1033,-1050
2015,8,25,14,2227,2179,944,-1235
2015,8,25,15,2328,2261,1014,-1247
2015,8,25,16,2442,2347,1079,-1268
2015,8,25,17,2542,2454,1163,-1291
2015,8,25,18,2646,2484,1284,-1200
2015,8,25,19,2730,2487,1207,-1280
2015,8,25,20,2816,2789,1251,-1538
2015,8,25,21,2904,2907,1259,-1648
2015,8,25,22,2999,2992,1328,-1664
2015,8,25,23,3066,3081,1440,-1641
2015,8,26,0,3101,3099,1452,-1647
2015,8,26,1,3092,3127,1499,-1628
2015,8,26,2,3033,3068,1443,-1625
2015,8,26,3,2888,2960,1354,-1606
2015,8,26,4,2756,2832,1352,-1480
2015,8,26,5,2503,2592,1178,-1414
2015,8,26,6,2250,2337,1157,-1180
2015,8,26,7,2302,2184,1126,-1058
2015,8,26,8,2145,2088,1058,-1030
2015,8,26,9,2041,2013,999,-1014
2015,8,26,10,1992,1965,924,-1041
2015,8,26,11,1977,1968,896,-1072
2015,8,26,12,2034,1990,906,-1084
2015,8,26,13,2158,2130,1015,-1115
2015,8,26,14,2264,2241,1069,-1172
2015,8,26,15,2366,2324,1083,-1241
2015,8,26,16,2479,2429,1166,-1263
2015,8,26,17,2579,2510,1240,-1270
2015,8,26,18,2682,2599,1339,-1260
2015,8,26,19,2764,2714,1452,-1262
2015,8,26,20,2844,2841,1575,-1266
2015,8,26,21,2927,2938,1657,-1281
2015,8,26,22,2999,3023,1762,-1261
2015,8,26,23,3056,3060,1843,-1217
2015,8,27,0,3077,3052,1736,-1316
2015,8,27,1,3056,3027,1689,-1338
2015,8,27,2,2984,2959,1603,-1356
2015,8,27,3,2847,2882,1617,-1265
2015,8,27,4,2729,2802,1575,-1227
2015,8,27,5,2478,2584,1378,-1206
2015,8,27,6,2225,2399,1286,-1113
2015,8,27,7,2264,2276,1203,-1073
2015,8,27,8,2124,2173,1123,-1050
2015,8,27,9,2134,2106,1174,-932
2015,8,27,10,2072,2065,1126,-939
2015,8,27,11,2043,2033,1091,-942
2015,8,27,12,2090,2073,1062,-1011
2015,8,27,13,2222,2211,1131,-1080
2015,8,27,14,2333,2319,1067,-1252
2015,8,27,15,2426,2393,1123,-1270
2015,8,27,16,2526,2491,1215,-1276
2015,8,27,17,2602,2586,1286,-1300
2015,8,27,18,2684,2676,1345,-1331
2015,8,27,19,2768,2808,1509,-1299
2015,8,27,20,2857,2899,1516,-1383
2015,8,27,21,2953,2993,1588,-1405
2015,8,27,22,3041,3071,1516,-1555
2015,8,27,23,3101,3109,1543,-1566
2015,8,28,0,3132,3145,1549,-1596
2015,8,28,1,3129,3097,1497,-1600
2015,8,28,2,3048,3033,1438,-1595
2015,8,28,3,2891,2936,1386,-1550
2015,8,28,4,2769,2813,1394,-1419
2015,8,28,5,2524,2586,1298,-1288
2015,8,28,6,2292,2350,1283,-1067
2015,8,28,7,2228,2179,1139,-1040
2015,8,28,8,2139,2082,1038,-1044
2015,8,28,9,2067,2015,987,-1028
2015,8,28,10,2025,1971,955,-1016
2015,8,28,11,2006,1968,936,-1032
2015,8,28,12,2059,2014,940,-1074
2015,8,28,13,2196,2141,1090,-1051
2015,8,28,14,2309,2233,1095,-1138
2015,8,28,15,2416,2320,1144,-1176
2015,8,28,16,2533,2414,1184,-1230
2015,8,28,17,2629,2520,1255,-1265
2015,8,28,18,2736,2630,1349,-1281
2015,8,28,19,2856,2723,1594,-1129
2015,8,28,20,2981,2837,1735,-1102
2015,8,28,21,3090,2872,1552,-1320
2015,8,28,22,3178,2911,1418,-1493
2015,8,28,23,3234,2880,1361,-1519
2015,8,29,0,3197,2847,1343,-1504
2015,8,29,1,3154,2813,1335,-1478
2015,8,29,2,3067,2737,1453,-1284
2015,8,29,3,2922,2704,1501,-1203
2015,8,29,4,2817,2631,1610,-1021
2015,8,29,5,2598,2501,1338,-1163
2015,8,29,6,2381,2347,1276,-1071
2015,8,29,7,2375,2208,1170,-1038
2015,8,29,8,2263,2124,1123,-1001
2015,8,29,9,2116,2047,1144,-903
2015,8,29,10,2085,2003,1178,-825
2015,8,29,11,2070,1983,1166,-817
2015,8,29,12,2089,1978,1198,-780
2015,8,29,13,2140,2019,1184,-835
2015,8,29,14,2194,2077,1287,-790
2015,8,29,15,2313,2164,1353,-811
2015,8,29,16,2429,2255,1385,-870
2015,8,29,17,2533,2334,1334,-1000
2015,8,29,18,2619,2410,1263,-1147
2015,8,29,19,2665,2473,1275,-1198
2015,8,29,20,2705,2555,1245,-1310
2015,8,29,21,2754,2635,1256,-1379
2015,8,29,22,2819,2676,1318,-1358
2015,8,29,23,2842,2670,1352,-1318
2015,8,30,0,2854,2613,1283,-1330
2015,8,30,1,2808,2558,1272,-1286
2015,8,30,2,2692,2498,1220,-1278
2015,8,30,3,2568,2467,1198,-1269
2015,8,30,4,2494,2431,1250,-1181
2015,8,30,5,2323,2302,1129,-1173
2015,8,30,6,2159,2124,1116,-1008
2015,8,30,7,2142,1996,1190,-806
2015,8,30,8,2013,1907,1297,-610
2015,8,30,9,1875,1849,1219,-630
2015,8,30,10,1829,1799,1174,-625
2015,8,30,11,1796,1766,1141,-625
2015,8,30,12,1787,1759,1114,-645
2015,8,30,13,1810,1772,1106,-666
2015,8,30,14,1830,1799,1123,-676
2015,8,30,15,1910,1884,1184,-700
2015,8,30,16,1983,1980,1142,-838
2015,8,30,17,2043,2088,1209,-879
2015,8,30,18,2071,2149,1167,-982
2015,8,30,19,2104,2223,1223,-1000
2015,8,30,20,2125,2275,1257,-1018
2015,8,30,21,2168,2323,1297,-1026
2015,8,30,22,2214,2370,1264,-1106
2015,8,30,23,2249,2423,1329,-1094
2015,8,31,0,2278,2461,1348,-1113
2015,8,31,1,2264,2458,1344,-1114
2015,8,31,2,2203,2398,1302,-1096
2015,8,31,3,2120,2344,1218,-1126
2015,8,31,4,2082,2272,1202,-1070
2015,8,31,5,1930,2086,1072,-1014
2015,8,31,6,1774,1923,1036,-887
2015,8,31,7,1810,1796,1118,-678
2015,8,31,8,1713,1724,1166,-558
2015,8,31,9,1723,1697,1128,-569
2015,8,31,10,1706,1680,1107,-573
2015,8,31,11,1713,1685,1029,-656
2015,8,31,12,1780,1760,978,-782
2015,8,31,13,1916,1922,1018,-904
2015,8,31,14,2032,2031,1051,-980
2015,8,31,15,2168,2099,1102,-997
2015,8,31,16,2232,2171,1123,-1048
2015,8,31,17,2294,2230,1202,-1028
2015,8,31,18,2337,2268,1246,-1022
2015,8,31,19,2380,2324,1280,-1044
2015,8,31,20,2436,2383,1310,-1073
2015,8,31,21,2496,2445,1365,-1080
2015,8,31,22,2555,2504,1420,-1084
2015,8,31,23,2591,2584,1451,-1133
2015,9,1,0,2646,2607,1477,-1130
2015,9,1,1,2656,2614,1355,-1259
2015,9,1,2,2608,2576,1329,-1247
2015,9,1,3,2524,2544,1416,-1128
2015,9,1,4,2446,2460,1382,-1078
2015,9,1,5,2271,2263,1220,-1043
2015,9,1,6,2078,2073,1048,-1025
2015,9,1,7,1975,1937,947,-990
2015,9,1,8,1907,1868,930,-938
2015,9,1,9,1847,1822,920,-902
2015,9,1,10,1820,1792,939,-853
2015,9,1,11,1820,1785,931,-854
2015,9,1,12,1875,1844,974,-870
2015,9,1,13,1996,1990,1045,-945
2015,9,1,14,2097,2099,990,-1109
2015,9,1,15,2157,2174,1019,-1155
2015,9,1,16,2248,2240,1098,-1142
2015,9,1,17,2333,2311,1126,-1185
2015,9,1,18,2401,2363,1216,-1147
2015,9,1,19,2483,2410,1259,-1151
2015,9,1,20,2575,2489,1344,-1145
2015,9,1,21,2671,2565,1397,-1168
2015,9,1,22,2749,2623,1437,-1186
2015,9,1,23,2810,2670,1400,-1270
2015,9,2,0,2852,2690,1400,-1290
2015,9,2,1,2859,2740,1544,-1196
2015,9,2,2,2799,2719,1499,-1220
2015,9,2,3,2682,2667,1439,-1228
2015,9,2,4,2552,2576,1391,-1185
2015,9,2,5,2336,2349,1196,-1153
2015,9,2,6,2120,2154,1153,-1001
2015,9,2,7,2096,2008,1107,-901
2015,9,2,8,2010,1930,1082,-848
2015,9,2,9,1930,1883,1060,-823
2015,9,2,10,1901,1852,1024,-828
2015,9,2,11,1898,1843,1012,-831
2015,9,2,12,1949,1902,1052,-850
2015,9,2,13,2075,2040,1168,-872
2015,9,2,14,2179,2155,1169,-986
2015,9,2,15,2255,2218,1190,-1028
2015,9,2,16,2326,2290,1269,-1021
2015,9,2,17,2385,2356,1340,-1016
2015,9,2,18,2418,2400,1403,-997
2015,9,2,19,2448,2417,1377,-1040
2015,9,2,20,2484,2476,1407,-1069
2015,9,2,21,2529,2544,1459,-1085
2015,9,2,22,2564,2605,1525,-1080
2015,9,2,23,2588,2663,1575,-1088
2015,9,3,0,2612,2670,1619,-1051
2015,9,3,1,2619,2632,1574,-1058
2015,9,3,2,2560,2596,1532,-1064
2015,9,3,3,2474,2576,1509,-1067
2015,9,3,4,2365,2483,1439,-1044
2015,9,3,5,2143,2299,1257,-1042
2015,9,3,6,1940,2100,1165,-935
2015,9,3,7,1962,1970,1122,-848
2015,9,3,8,1886,1893,1242,-651
2015,9,3,9,1863,1847,1239,-608
2015,9,3,10,1826,1816,1238,-578
2015,9,3,11,1818,1808,1329,-479
2015,9,3,12,1867,1862,1449,-413
2015,9,3,13,2005,1994,1562,-432
2015,9,3,14,2113,2110,1404,-706
2015,9,3,15,2173,2153,1390,-763
2015,9,3,16,2210,2201,1386,-815
2015,9,3,17,2240,2235,1426,-809
2015,9,3,18,2244,2258,1435,-823
2015,9,3,19,2243,2240,1443,-797
2015,9,3,20,2269,2242,1437,-805
2015,9,3,21,2299,2250,1440,-810
2015,9,3,22,2326,2259,1461,-798
2015,9,3,23,2344,2273,1494,-779
2015,9,4,0,2341,2263,1579,-684
2015,9,4,1,2343,2266,1639,-627
2015,9,4,2,2295,2244,1654,-590
2015,9,4,3,2251,2278,1764,-514
2015,9,4,4,2185,2256,1728,-528
2015,9,4,5,2010,2113,1529,-584
2015,9,4,6,1842,1953,1615,-338
2015,9,4,7,1868,1857,1476,-381
2015,9,4,8,1802,1794,1360,-434
2015,9,4,9,1796,1768,1333,-435
2015,9,4,10,1774,1747,1218,-529
2015,9,4,11,1781,1763,1205,-558
2015,9,4,12,1839,1811,1160,-651
2015,9,4,13,1982,1943,1229,-714
2015,9,4,14,2095,2044,990,-1054
2015,9,4,15,2152,2097,961,-1136
2015,9,4,16,2193,2143,1083,-1060
2015,9,4,17,2224,2174,1112,-1062
2015,9,4,18,2229,2199,1167,-1032
2015,9,4,19,2231,2186,1175,-1011
2015,9,4,20,2254,2206,1183,-1023
2015,9,4,21,2299,2233,1221,-1012
2015,9,4,22,2341,2249,1225,-1024
2015,9,4,23,2367,2246,1236,-1010
2015,9,5,0,2336,2222,1206,-1016
2015,9,5,1,2327,2198,1168,-1030
2015,9,5,2,2290,2140,1154,-986
2015,9,5,3,2263,2134,1324,-810
2015,9,5,4,2194,2081,1396,-685
2015,9,5,5,2056,1999,1412,-587
2015,9,5,6,1922,1887,1599,-288
2015,9,5,7,1840,1805,1545,-260
2015,9,5,8,1771,1725,1366,-359
2015,9,5,9,1753,1698,1368,-330
2015,9,5,10,1741,1658,1322,-336
2015,9,5,11,1743,1650,1327,-323
2015,9,5,12,1768,1668,1374,-294
2015,9,5,13,1832,1693,1394,-299
2015,9,5,14,1885,1743,1442,-301
2015,9,5,15,1953,1831,1394,-437
2015,9,5,16,2008,1908,1229,-679
2015,9,5,17,2041,1931,1276,-655
2015,9,5,18,2037,1941,1315,-626
2015,9,5,19,2015,1924,1401,-523
2015,9,5,20,2012,1901,1424,-477
2015,9,5,21,2018,1877,1389,-488
2015,9,5,22,2018,1869,1406,-463
2015,9,5,23,2012,1867,1431,-436
2015,9,6,0,2013,1868,1431,-437
2015,9,6,1,2004,1870,1382,-488
2015,9,6,2,1961,1848,1355,-493
2015,9,6,3,1961,1891,1302,-589
2015,9,6,4,1944,1887,1301,-586
2015,9,6,5,1866,1814,1147,-667
2015,9,6,6,1774,1707,1038,-669
2015,9,6,7,1753,1633,979,-654
2015,9,6,8,1662,1585,929,-656
2015,9,6,9,1584,1551,940,-611
2015,9,6,10,1570,1532,968,-564
2015,9,6,11,1570,1538,990,-548
2015,9,6,12,1589,1540,935,-605
2015,9,6,13,1627,1584,976,-608
2015,9,6,14,1665,1627,916,-711
2015,9,6,15,1747,1690,923,-767
2015,9,6,16,1820,1761,984,-777
2015,9,6,17,1869,1778,1026,-752
2015,9,6,18,1884,1776,1049,-727
2015,9,6,19,1894,1771,1028,-743
2015,9,6,20,1904,1765,1087,-678
2015,9,6,21,1926,1772,1099,-673
2015,9,6,22,1951,1761,1062,-699
2015,9,6,23,1983,1788,1073,-715
2015,9,7,0,2009,1805,1107,-698
2015,9,7,1,2010,1801,1101,-700
2015,9,7,2,1985,1786,1043,-743
2015,9,7,3,1978,1819,1045,-774
2015,9,7,4,1944,1799,1034,-765
2015,9,7,5,1820,1706,960,-746
2015,9,7,6,1691,1608,1032,-576
2015,9,7,7,1660,1535,1058,-477
2015,9,7,8,1583,1480,980,-500
2015,9,7,9,1501,1455,965,-490
2015,9,7,10,1502,1447,962,-485
2015,9,7,11,1524,1452,1020,-432
2015,9,7,12,1591,1493,1064,-429
2015,9,7,13,1728,1550,1116,-434
2015,9,7,14,1845,1596,1052,-544
2015,9,7,15,1975,1692,1068,-624
2015,9,7,16,2039,1792,1166,-626
2015,9,7,17,2082,1849,1140,-709
2015,9,7,18,2108,1884,1164,-720
2015,9,7,19,2117,1893,1199,-694
2015,9,7,20,2140,1902,1191,-711
2015,9,7,21,2158,1904,1163,-741
2015,9,7,22,2177,1945,1200,-745
2015,9,7,23,2186,1983,1235,-748
2015,9,8,0,2207,2025,1278,-747
2015,9,8,1,2205,2040,1296,-744
2015,9,8,2,2184,2034,1315,-719
2015,9,8,3,2165,2069,1390,-679
2015,9,8,4,2099,2020,1341,-679
2015,9,8,5,1958,1867,1120,-747
2015,9,8,6,1804,1720,1107,-613
2015,9,8,7,1792,1629,1145,-484
2015,9,8,8,1685,1575,1118,-457
2015,9,8,9,1568,1548,1108,-440
2015,9,8,10,1552,1538,1091,-447
2015,9,8,11,1559,1553,1020,-533
2015,9,8,12,1602,1614,1091,-523
2015,9,8,13,1695,1799,1139,-660
2015,9,8,14,1783,1895,1194,-701
2015,9,8,15,1831,1941,1177,-764
2015,9,8,16,1913,1982,1219,-763
2015,9,8,17,1962,2025,1255,-770
2015,9,8,18,1989,2055,1241,-814
2015,9,8,19,2001,2073,1231,-842
2015,9,8,20,2021,2116,1274,-842
2015,9,8,21,2042,2143,1319,-824
2015,9,8,22,2072,2176,1326,-850
2015,9,8,23,2102,2228,1395,-833
2015,9,9,0,2140,2254,1377,-877
2015,9,9,1,2159,2272,1423,-849
2015,9,9,2,2152,2245,1411,-834
2015,9,9,3,2125,2245,1481,-764
2015,9,9,4,2032,2178,1394,-784
2015,9,9,5,1867,1993,1166,-827
2015,9,9,6,1702,1828,1061,-767
2015,9,9,7,1784,1726,1022,-704
2015,9,9,8,1659,1680,1096,-584
2015,9,9,9,1668,1653,1058,-595
2015,9,9,10,1650,1639,1044,-595
2015,9,9,11,1656,1635,1048,-587
2015,9,9,12,1705,1710,1099,-611
2015,9,9,13,1830,1859,1128,-731
2015,9,9,14,1925,1980,1124,-856
2015,9,9,15,1968,2010,1134,-876
2015,9,9,16,2046,2067,1182,-885
2015,9,9,17,2106,2104,1196,-908
2015,9,9,18,2156,2113,1174,-939
2015,9,9,19,2197,2146,1191,-955
2015,9,9,20,2252,2218,1250,-968
2015,9,9,21,2307,2277,1274,-1003
2015,9,9,22,2365,2351,1348,-1003
2015,9,9,23,2425,2421,1432,-989
2015,9,10,0,2474,2465,1534,-931
2015,9,10,1,2489,2489,1578,-911
2015,9,10,2,2460,2444,1555,-889
2015,9,10,3,2376,2416,1516,-900
2015,9,10,4,2245,2321,1449,-872
2015,9,10,5,2032,2114,1225,-889
2015,9,10,6,1832,1923,1118,-805
2015,9,10,7,1808,1805,1014,-791
2015,9,10,8,1754,1736,998,-738
2015,9,10,9,1727,1703,961,-742
2015,9,10,10,1701,1669,941,-728
2015,9,10,11,1702,1669,1124,-545
2015,9,10,12,1756,1727,1154,-573
2015,9,10,13,1895,1889,1228,-661
2015,9,10,14,1995,1987,1271,-716
2015,9,10,15,2040,2026,1167,-859
2015,9,10,16,2124,2071,1158,-913
2015,9,10,17,2182,2134,1181,-953
2015,9,10,18,2221,2178,1218,-960
2015,9,10,19,2251,2224,1280,-944
2015,9,10,20,2295,2299,1365,-934
2015,9,10,21,2346,2374,1428,-946
2015,9,10,22,2392,2477,1556,-921
2015,9,10,23,2439,2553,1619,-934
2015,9,11,0,2481,2602,1698,-904
2015,9,11,1,2494,2592,1690,-902
2015,9,11,2,2442,2533,1601,-932
2015,9,11,3,2353,2494,1589,-905
2015,9,11,4,2217,2358,1520,-838
2015,9,11,5,1995,2149,1308,-841
2015,9,11,6,1792,1952,1189,-763
2015,9,11,7,1850,1822,1253,-569
2015,9,11,8,1765,1731,1223,-508
2015,9,11,9,1720,1688,1146,-542
2015,9,11,10,1701,1674,1130,-544
2015,9,11,11,1702,1670,1124,-546
2015,9,11,12,1758,1733,1154,-579
2015,9,11,13,1902,1872,1146,-726
2015,9,11,14,2003,1970,1141,-829
2015,9,11,15,2049,2024,1140,-884
2015,9,11,16,2132,2079,1216,-863
2015,9,11,17,2191,2140,1247,-893
2015,9,11,18,2240,2196,1215,-981
2015,9,11,19,2272,2248,1297,-951
2015,9,11,20,2321,2315,1323,-992
2015,9,11,21,2369,2416,1406,-1010
2015,9,11,22,2415,2512,1415,-1097
2015,9,11,23,2473,2593,1542,-1051
2015,9,12,0,2504,2637,1584,-1053
2015,9,12,1,2482,2617,1585,-1032
2015,9,12,2,2420,2505,1509,-996
2015,9,12,3,2307,2449,1501,-948
2015,9,12,4,2173,2319,1532,-787
2015,9,12,5,2002,2151,1393,-758
2015,9,12,6,1830,1980,1314,-666
2015,9,12,7,1865,1840,1190,-650
2015,9,12,8,1765,1757,1100,-657
2015,9,12,9,1739,1709,1055,-654
2015,9,12,10,1710,1665,1007,-658
2015,9,12,11,1699,1653,986,-667
2015,9,12,12,1722,1658,987,-671
2015,9,12,13,1786,1709,1043,-666
2015,9,12,14,1833,1764,1032,-732
2015,9,12,15,1910,1837,1061,-776
2015,9,12,16,2008,1914,1122,-792
2015,9,12,17,2076,1999,1220,-779
2015,9,12,18,2132,2055,1261,-794
2015,9,12,19,2169,2122,1309,-813
2015,9,12,20,2228,2207,1404,-803
2015,9,12,21,2298,2295,1414,-881
2015,9,12,22,2360,2410,1467,-943
2015,9,12,23,2432,2495,1495,-1000
2015,9,13,0,2483,2553,1518,-1035
2015,9,13,1,2494,2542,1441,-1101
2015,9,13,2,2402,2429,1357,-1072
2015,9,13,3,2281,2394,1414,-980
2015,9,13,4,2163,2272,1453,-819
2015,9,13,5,2008,2122,1356,-766
2015,9,13,6,1859,1966,1275,-691
2015,9,13,7,1872,1842,1177,-665
2015,9,13,8,1791,1752,1093,-659
2015,9,13,9,1743,1686,1025,-661
2015,9,13,10,1708,1647,1012,-635
2015,9,13,11,1699,1616,978,-638
2015,9,13,12,1710,1623,979,-644
2015,9,13,13,1748,1633,987,-646
2015,9,13,14,1784,1680,1026,-654
2015,9,13,15,1865,1744,1073,-671
2015,9,13,16,1952,1837,1173,-664
2015,9,13,17,2006,1930,1254,-676
2015,9,13,18,2042,2005,1379,-626
2015,9,13,19,2072,2076,1473,-603
2015,9,13,20,2120,2158,1568,-590
2015,9,13,21,2177,2251,1619,-632
2015,9,13,22,2239,2338,1653,-685
2015,9,13,23,2316,2416,1724,-692
2015,9,14,0,2360,2460,1735,-725
2015,9,14,1,2338,2453,1599,-854
2015,9,14,2,2244,2391,1588,-803
2015,9,14,3,2147,2331,1538,-793
2015,9,14,4,2060,2205,1464,-741
2015,9,14,5,1891,2000,1274,-726
2015,9,14,6,1723,1811,1089,-722
2015,9,14,7,1727,1705,982,-723
2015,9,14,8,1616,1615,905,-710
2015,9,14,9,1596,1582,916,-666
2015,9,14,10,1580,1547,908,-639
2015,9,14,11,1590,1561,950,-611
2015,9,14,12,1659,1626,990,-636
2015,9,14,13,1788,1787,1132,-655
2015,9,14,14,1900,1921,1167,-754
2015,9,14,15,2054,1959,1163,-796
2015,9,14,16,2113,2019,1224,-795
2015,9,14,17,2140,2039,1245,-794
2015,9,14,18,2152,2070,1312,-758
2015,9,14,19,2154,2065,1315,-750
2015,9,14,20,2169,2077,1293,-784
2015,9,14,21,2189,2081,1286,-795
2015,9,14,22,2201,2073,1254,-819
2015,9,14,23,2189,2068,1232,-836
2015,9,15,0,2166,2062,1214,-848
2015,9,15,1,2127,2078,1162,-916
2015,9,15,2,2046,2083,1138,-945
2015,9,15,3,2040,2104,1322,-782
2015,9,15,4,1988,2012,1339,-673
2015,9,15,5,1852,1886,1131,-755
2015,9,15,6,1710,1745,978,-767
2015,9,15,7,1707,1658,920,-738
2015,9,15,8,1640,1595,980,-615
2015,9,15,9,1591,1563,959,-604
2015,9,15,10,1574,1546,1015,-531
2015,9,15,11,1586,1554,1168,-386
2015,9,15,12,1658,1612,1214,-398
2015,9,15,13,1804,1771,1289,-482
2015,9,15,14,1928,1891,1213,-678
2015,9,15,15,1935,1918,1154,-764
2015,9,15,16,1970,1917,1123,-794
2015,9,15,17,1976,1915,1148,-767
2015,9,15,18,1973,1914,1085,-829
2015,9,15,19,1956,1904,1106,-798
2015,9,15,20,1958,1891,1035,-856
2015,9,15,21,1962,1884,973,-911
2015,9,15,22,1956,1884,971,-913
2015,9,15,23,1952,1879,974,-905
2015,9,16,0,1972,1876,981,-895
2015,9,16,1,1972,1873,1039,-834
2015,9,16,2,1944,1893,1059,-834
2015,9,16,3,1969,1929,1110,-819
2015,9,16,4,1922,1865,1143,-722
2015,9,16,5,1798,1728,1071,-657
2015,9,16,6,1674,1609,1215,-394
2015,9,16,7,1665,1528,1321,-207
2015,9,16,8,1594,1483,1335,-148
2015,9,16,9,1487,1452,1254,-198
2015,9,16,10,1481,1443,1245,-198
2015,9,16,11,1500,1460,1224,-236
2015,9,16,12,1573,1541,1227,-314
2015,9,16,13,1720,1698,1231,-467
2015,9,16,14,1846,1813,1260,-553
2015,9,16,15,1866,1818,1209,-609
2015,9,16,16,1891,1809,1201,-608
2015,9,16,17,1892,1821,1225,-596
2015,9,16,18,1894,1819,1228,-591
2015,9,16,19,1878,1593,994,-599
2015,9,16,20,1875,2041,1426,-615
2015,9,16,21,1873,1838,1221,-617
2015,9,16,22,1863,1796,1169,-627
2015,9,16,23,1865,1808,1159,-649
2015,9,17,0,1872,1797,1158,-639
2015,9,17,1,1870,1798,1154,-644
2015,9,17,2,1868,1828,1182,-646
2015,9,17,3,1912,1859,1198,-661
2015,9,17,4,1854,1808,1163,-645
2015,9,17,5,1728,1671,1029,-642
2015,9,17,6,1610,1544,955,-589
2015,9,17,7,1610,1465,960,-505
2015,9,17,8,1505,1416,922,-494
2015,9,17,9,1435,1396,915,-481
2015,9,17,10,1433,1383,933,-450
2015,9,17,11,1452,1404,936,-468
2015,9,17,12,1528,1466,995,-471
2015,9,17,13,1681,1629,1140,-489
2015,9,17,14,1798,1764,1139,-625
2015,9,17,15,1814,1783,1102,-681
2015,9,17,16,1835,1794,1124,-670
2015,9,17,17,1847,1787,1112,-675
2015,9,17,18,1855,1798,1162,-636
2015,9,17,19,1851,1765,1172,-593
2015,9,17,20,1853,1765,1122,-643
2015,9,17,21,1843,1763,1177,-586
2015,9,17,22,1829,1561,1045,-516
2015,9,17,23,1825,1931,1513,-418
2015,9,18,0,1822,1737,1251,-486
2015,9,18,1,1810,1726,1246,-480
2015,9,18,2,1818,1743,1224,-519
2015,9,18,3,1860,1802,1410,-392
2015,9,18,4,1788,1748,1396,-352
2015,9,18,5,1654,1625,1128,-497
2015,9,18,6,1530,1487,1127,-360
2015,9,18,7,1531,1410,1064,-346
2015,9,18,8,1489,1373,953,-420
2015,9,18,9,1372,1353,976,-377
2015,9,18,10,1362,1335,1004,-331
2015,9,18,11,1379,1361,1011,-350
2015,9,18,12,1452,1442,1089,-353
2015,9,18,13,1603,1603,1177,-426
2015,9,18,14,1722,1715,1113,-602
2015,9,18,15,1740,1736,1131,-605
2015,9,18,16,1761,1738,1131,-607
2015,9,18,17,1772,1739,1122,-617
2015,9,18,18,1785,1718,1138,-580
2015,9,18,19,1789,1714,1195,-519
2015,9,18,20,1803,1717,1188,-529
2015,9,18,21,1815,1718,1218,-500
2015,9,18,22,1817,1716,1234,-482
2015,9,18,23,1849,1722,1250,-472
2015,9,19,0,1861,1717,1270,-447
2015,9,19,1,1846,1702,1276,-426
2015,9,19,2,1839,1684,1225,-459
2015,9,19,3,1864,1721,1284,-437
2015,9,19,4,1783,1675,1259,-416
2015,9,19,5,1664,1582,1219,-363
2015,9,19,6,1549,1474,1144,-330
2015,9,19,7,1506,1385,1090,-295
2015,9,19,8,1437,1339,1014,-325
2015,9,19,9,1341,1320,959,-361
2015,9,19,10,1335,1301,904,-397
2015,9,19,11,1346,1312,914,-398
2015,9,19,12,1387,1340,948,-392
2015,9,19,13,1462,1409,1018,-391
2015,9,19,14,1523,1459,1025,-434
2015,9,19,15,1575,1537,1046,-491
2015,9,19,16,1622,1583,1085,-498
2015,9,19,17,1653,1594,1148,-446
2015,9,19,18,1678,1602,1160,-442
2015,9,19,19,1698,1591,1111,-480
2015,9,19,20,1730,1593,1052,-541
2015,9,19,21,1767,1605,939,-666
2015,9,19,22,1787,1633,969,-664
2015,9,19,23,1821,1668,985,-683
2015,9,20,0,1862,1699,1044,-655
2015,9,20,1,1863,1707,1190,-517
2015,9,20,2,1830,1683,1257,-426
2015,9,20,3,1824,1717,1270,-447
2015,9,20,4,1740,1649,1265,-384
2015,9,20,5,1619,1555,1213,-342
2015,9,20,6,1494,1438,1140,-298
2015,9,20,7,1487,1360,1059,-301
2015,9,20,8,1393,1303,979,-324
2015,9,20,9,1301,1271,914,-357
2015,9,20,10,1290,1263,941,-322
2015,9,20,11,1300,1253,963,-290
2015,9,20,12,1343,1275,942,-333
2015,9,20,13,1404,1321,982,-339
2015,9,20,14,1457,1368,1028,-340
2015,9,20,15,1519,1435,1119,-316
2015,9,20,16,1579,1511,1258,-253
2015,9,20,17,1620,1537,1262,-275
2015,9,20,18,1653,1562,1254,-308
2015,9,20,19,1698,1591,1194,-397
2015,9,20,20,1751,1615,1150,-465
2015,9,20,21,1796,1669,1108,-561
2015,9,20,22,1838,1723,1160,-563
2015,9,20,23,1908,1796,1211,-585
2015,9,21,0,1964,1848,1219,-629
2015,9,21,1,1970,1878,1260,-618
2015,9,21,2,1912,1856,1244,-612
2015,9,21,3,1865,1872,1257,-615
2015,9,21,4,1749,1766,1168,-598
2015,9,21,5,1593,1599,1023,-576
2015,9,21,6,1440,1439,1005,-434
2015,9,21,7,1468,1339,1044,-295
2015,9,21,8,1389,1293,1045,-248
2015,9,21,9,1305,1265,1036,-229
2015,9,21,10,1298,1254,1016,-238
2015,9,21,11,1317,1266,1027,-239
2015,9,21,12,1389,1338,1082,-256
2015,9,21,13,1526,1509,1227,-282
2015,9,21,14,1632,1643,1192,-451
2015,9,21,15,1760,1684,1167,-517
2015,9,21,16,1812,1738,1244,-494
2015,9,21,17,1838,1787,1264,-523
2015,9,21,18,1862,1826,1298,-528
2015,9,21,19,1874,1858,1284,-574
2015,9,21,20,1899,1914,1311,-603
2015,9,21,21,1921,1968,1438,-530
2015,9,21,22,1937,2014,1501,-513
2015,9,21,23,1954,2068,1544,-524
2015,9,22,0,1986,2094,1541,-553
2015,9,22,1,1983,2094,1545,-549
2015,9,22,2,1950,2050,1436,-614
2015,9,22,3,1946,2047,1384,-663
2015,9,22,4,1836,1924,1278,-646
2015,9,22,5,1664,1746,1208,-538
2015,9,22,6,1494,1576,1196,-380
2015,9,22,7,1528,1472,1085,-387
2015,9,22,8,1428,1405,1040,-365
2015,9,22,9,1407,1381,950,-431
2015,9,22,10,1390,1363,1026,-337
2015,9,22,11,1400,1363,974,-389
2015,9,22,12,1470,1447,1103,-344
2015,9,22,13,1626,1616,1172,-444
2015,9,22,14,1744,1733,1224,-509
2015,9,22,15,1754,1760,1250,-510
2015,9,22,16,1809,1785,1267,-518
2015,9,22,17,1840,1847,1301,-546
2015,9,22,18,1878,1880,1293,-587
2015,9,22,19,1908,1911,1294,-617
2015,9,22,20,1964,1980,1336,-644
2015,9,22,21,2013,2037,1361,-676
2015,9,22,22,2047,2093,1389,-704
2015,9,22,23,2091,2158,1420,-738
2015,9,23,0,2121,2191,1401,-790
2015,9,23,1,2119,2193,1370,-823
2015,9,23,2,2053,2153,1318,-835
2015,9,23,3,2013,2141,1344,-797
2015,9,23,4,1870,2006,1255,-751
2015,9,23,5,1680,1818,1160,-658
2015,9,23,6,1499,1639,1149,-490
2015,9,23,7,1550,1523,992,-531
2015,9,23,8,1458,1457,972,-485
2015,9,23,9,1465,1429,945,-484
2015,9,23,10,1448,1406,940,-466
2015,9,23,11,1455,1416,952,-464
2015,9,23,12,1524,1478,975,-503
2015,9,23,13,1681,1641,1113,-528
2015,9,23,14,1799,1765,1073,-692
2015,9,23,15,1810,1796,1064,-732
2015,9,23,16,1866,1843,1109,-734
2015,9,23,17,1924,1870,1168,-702
2015,9,23,18,1950,1904,1215,-689
2015,9,23,19,1960,1943,1233,-710
2015,9,23,20,1976,1989,1292,-697
2015,9,23,21,1995,2048,1350,-698
2015,9,23,22,1999,2092,1390,-702
2015,9,23,23,2020,2158,1385,-773
2015,9,24,0,2031,2174,1392,-782
2015,9,24,1,2010,2175,1400,-775
2015,9,24,2,1943,2132,1349,-783
2015,9,24,3,1907,2115,1339,-776
2015,9,24,4,1766,2000,1260,-740
2015,9,24,5,1596,1809,1146,-663
2015,9,24,6,1439,1632,1107,-525
2015,9,24,7,1483,1527,1094,-433
2015,9,24,8,1416,1476,1110,-366
2015,9,24,9,1462,1435,1072,-363
2015,9,24,10,1447,1418,1073,-345
2015,9,24,11,1452,1429,1093,-336
2015,9,24,12,1522,1503,1104,-399
2015,9,24,13,1685,1675,1225,-450
2015,9,24,14,1812,1791,1154,-637
2015,9,24,15,1827,1812,1134,-678
2015,9,24,16,1868,1840,1264,-576
2015,9,24,17,1901,1876,1300,-576
2015,9,24,18,1930,1907,1297,-610
2015,9,24,19,1962,1925,1275,-650
2015,9,24,20,2025,1970,1304,-666
2015,9,24,21,2070,2018,1331,-687
2015,9,24,22,2116,2072,1406,-666
2015,9,24,23,2202,2092,1337,-755
2015,9,25,0,2263,2105,1361,-744
2015,9,25,1,2261,2118,1391,-727
2015,9,25,2,2160,2099,1422,-677
2015,9,25,3,2108,2109,1453,-656
2015,9,25,4,1974,1977,1344,-633
2015,9,25,5,1784,1812,1182,-630
2015,9,25,6,1596,1646,1200,-446
2015,9,25,7,1542,1539,1228,-311
2015,9,25,8,1501,1489,1169,-320
2015,9,25,9,1472,1449,1213,-236
2015,9,25,10,1446,1435,1214,-221
2015,9,25,11,1450,1437,1216,-221
2015,9,25,12,1520,1511,1165,-346
2015,9,25,13,1684,1650,1151,-499
2015,9,25,14,1808,1786,1236,-550
2015,9,25,15,1832,1809,1250,-559
2015,9,25,16,1886,1843,1212,-631
2015,9,25,17,1941,1892,1254,-638
2015,9,25,18,1983,1926,1274,-652
2015,9,25,19,2023,1974,1317,-657
2015,9,25,20,2087,2058,1459,-599
2015,9,25,21,2135,2146,1517,-629
2015,9,25,22,2178,2230,1572,-658
2015,9,25,23,2219,2310,1612,-698
2015,9,26,0,2210,2328,1657,-671
2015,9,26,1,2168,2254,1630,-624
2015,9,26,2,2047,2200,1611,-589
2015,9,26,3,1997,2164,1584,-580
2015,9,26,4,1882,2047,1553,-494
2015,9,26,5,1742,1913,1405,-508
2015,9,26,6,1596,1738,1321,-417
2015,9,26,7,1602,1622,1194,-428
2015,9,26,8,1577,1534,1091,-443
2015,9,26,9,1536,1490,1042,-448
2015,9,26,10,1519,1464,1055,-409
2015,9,26,11,1525,1454,1099,-355
2015,9,26,12,1556,1471,1127,-344
2015,9,26,13,1632,1530,1175,-355
2015,9,26,14,1700,1604,1136,-468
2015,9,26,15,1765,1657,1173,-484
2015,9,26,16,1834,1732,1209,-523
2015,9,26,17,1881,1790,1186,-604
2015,9,26,18,1885,1858,1255,-603
2015,9,26,19,1856,1902,1239,-663
2015,9,26,20,1843,1967,1292,-675
2015,9,26,21,1839,2025,1329,-696
2015,9,26,22,1837,2099,1406,-693
2015,9,26,23,1847,2150,1426,-724
2015,9,27,0,1870,2188,1426,-762
2015,9,27,1,1850,2161,1343,-818
2015,9,27,2,1768,2085,1312,-773
2015,9,27,3,1757,2043,1346,-697
2015,9,27,4,1690,1925,1271,-654
2015,9,27,5,1578,1793,1267,-526
2015,9,27,6,1450,1643,1215,-428
2015,9,27,7,1486,1523,1110,-413
2015,9,27,8,1406,1452,1112,-340
2015,9,27,9,1430,1414,1145,-269
2015,9,27,10,1403,1381,1242,-139
2015,9,27,11,1391,1381,1255,-126
2015,9,27,12,1411,1395,1266,-129
2015,9,27,13,1457,1420,1282,-138
2015,9,27,14,1511,1477,1243,-234
2015,9,27,15,1570,1548,1216,-332
2015,9,27,16,1616,1626,1156,-470
2015,9,27,17,1629,1666,1185,-481
2015,9,27,18,1620,1687,1188,-499
2015,9,27,19,1609,1716,1191,-525
2015,9,27,20,1618,1740,1230,-510
2015,9,27,21,1641,1775,1277,-498
2015,9,27,22,1679,1817,1308,-509
2015,9,27,23,1719,1886,1369,-517
2015,9,28,0,1760,1924,1246,-678
2015,9,28,1,1754,1920,1241,-679
2015,9,28,2,1710,1904,1251,-653
2015,9,28,3,1709,1887,1264,-623
2015,9,28,4,1639,1792,1288,-504
2015,9,28,5,1515,1653,1307,-346
2015,9,28,6,1368,1507,1116,-391
2015,9,28,7,1346,1412,1024,-388
2015,9,28,8,1216,1370,986,-384
2015,9,28,9,1353,1348,992,-356
2015,9,28,10,1344,1337,1016,-321
2015,9,28,11,1356,1369,1029,-340
2015,9,28,12,1423,1441,1053,-388
2015,9,28,13,1562,1610,1096,-514
2015,9,28,14,1679,1758,1059,-699
2015,9,28,15,1795,1774,1027,-747
2015,9,28,16,1833,1821,1082,-739
2015,9,28,17,1857,1848,1106,-742
2015,9,28,18,1869,1878,1142,-736
2015,9,28,19,1862,1903,1144,-759
2015,9,28,20,1874,2960,2143,-817
2015,9,28,21,1896,1992,1260,-732
2015,9,28,22,1918,2031,1292,-739
2015,9,28,23,1946,2078,1337,-741
2015,9,29,0,1985,2106,1317,-789
2015,9,29,1,1980,2112,1337,-775
2015,9,29,2,1944,2090,1349,-741
2015,9,29,3,1944,2086,1343,-743
2015,9,29,4,1866,1952,1214,-738
2015,9,29,5,1720,1783,1058,-725
2015,9,29,6,1556,1615,869,-746
2015,9,29,7,1421,1516,720,-796
2015,9,29,8,1459,1460,554,-906
2015,9,29,9,1474,1447,565,-882
2015,9,29,10,1469,1427,588,-839
2015,9,29,11,1490,1445,595,-850
2015,9,29,12,1566,1517,625,-892
2015,9,29,13,1725,1674,726,-948
2015,9,29,14,1858,1804,967,-837
2015,9,29,15,1856,1812,1042,-770
2015,9,29,16,1891,1834,1011,-823
2015,9,29,17,1923,1862,1009,-853
2015,9,29,18,1958,1884,1014,-870
2015,9,29,19,1994,1914,1050,-864
2015,9,29,20,2050,1953,1108,-845
2015,9,29,21,2125,2011,1092,-919
2015,9,29,22,2194,2066,1118,-948
2015,9,29,23,2254,2119,1129,-990
2015,9,30,0,2308,2146,1182,-964
2015,9,30,1,2304,2138,1194,-944
2015,9,30,2,2233,2121,1180,-941
2015,9,30,3,2173,2111,1148,-963
2015,9,30,4,2028,1973,1079,-894
2015,9,30,5,1837,1801,921,-880
2015,9,30,6,1657,1639,805,-834
2015,9,30,7,1503,1525,729,-796
2015,9,30,8,1504,1478,686,-792
2015,9,30,9,1491,1446,653,-793
2015,9,30,10,1484,1419,619,-800
2015,9,30,11,1505,1438,639,-799
2015,9,30,12,1582,1508,702,-806
2015,9,30,13,1741,1662,820,-842
2015,9,30,14,1874,1789,917,-872
2015,9,30,15,1881,1807,936,-871
2015,9,30,16,1920,1826,871,-955
2015,9,30,17,1962,1860,916,-944
2015,9,30,18,2003,1888,923,-965
2015,9,30,19,2038,1898,973,-925
2015,9,30,20,2085,1923,1001,-922
2015,9,30,21,2148,1934,947,-987
2015,9,30,22,2188,1941,922,-1019
2015,9,30,23,2230,1943,963,-980
2015,10,1,0,2252,1946,1020,-926
2015,10,1,1,2226,1936,1017,-919
2015,10,1,2,2182,1981,1074,-907
2015,10,1,3,2157,1974,1083,-891
2015,10,1,4,2035,1892,981,-911
2015,10,1,5,1869,1754,844,-910
2015,10,1,6,1698,1607,822,-785
2015,10,1,7,1561,1517,650,-867
2015,10,1,8,1508,1460,758,-702
2015,10,1,9,1478,1424,751,-673
2015,10,1,10,1473,1411,699,-712
2015,10,1,11,1497,1422,673,-749
2015,10,1,12,1576,1490,698,-792
2015,10,1,13,1738,1624,811,-813
2015,10,1,14,1872,1740,991,-749
2015,10,1,15,1876,1790,1052,-738
2015,10,1,16,1905,1831,1063,-768
2015,10,1,17,1930,1862,1116,-746
2015,10,1,18,1950,1881,1094,-787
2015,10,1,19,1950,1898,1078,-820
2015,10,1,20,1965,1931,1070,-861
2015,10,1,21,1985,1946,1132,-814
2015,10,1,22,1990,1949,1117,-832
2015,10,1,23,1994,1952,1146,-806
2015,10,2,0,1984,1921,1207,-714
2015,10,2,1,1952,1897,1200,-697
2015,10,2,2,1948,1900,1172,-728
2015,10,2,3,1952,1904,1202,-702
2015,10,2,4,1864,1816,1162,-654
2015,10,2,5,1726,1691,1163,-528
2015,10,2,6,1585,1566,1160,-406
2015,10,2,7,1470,1474,1126,-348
2015,10,2,8,1396,1425,1058,-367
2015,10,2,9,1395,1392,959,-433
2015,10,2,10,1388,1375,902,-473
2015,10,2,11,1405,1374,900,-474
2015,10,2,12,1478,1437,906,-531
2015,10,2,13,1624,1557,946,-611
2015,10,2,14,1751,1679,953,-726
2015,10,2,15,1767,1731,1021,-710
2015,10,2,16,1792,1753,1019,-734
2015,10,2,17,1806,1773,1059,-714
2015,10,2,18,1817,1769,1061,-708
2015,10,2,19,1811,1783,1086,-697
2015,10,2,20,1829,1799,1037,-762
2015,10,2,21,1847,1812,1057,-755
2015,10,2,22,1859,1827,1101,-726
2015,10,2,23,1870,1839,1125,-714
2015,10,3,0,1816,1808,1112,-696
2015,10,3,1,1785,1765,1079,-686
2015,10,3,2,1783,1771,1044,-727
2015,10,3,3,1803,1764,1086,-678
2015,10,3,4,1735,1695,990,-705
2015,10,3,5,1637,1600,932,-668
2015,10,3,6,1525,1483,741,-742
2015,10,3,7,1440,1397,720,-677
2015,10,3,8,1402,1340,706,-634
2015,10,3,9,1353,1304,712,-592
2015,10,3,10,1342,1291,732,-559
2015,10,3,11,1348,1296,757,-539
2015,10,3,12,1382,1327,773,-554
2015,10,3,13,1438,1390,877,-513
2015,10,3,14,1512,1446,979,-467
2015,10,3,15,1583,1518,993,-525
2015,10,3,16,1632,1572,1025,-547
2015,10,3,17,1645,1595,1004,-591
2015,10,3,18,1645,1598,1029,-569
2015,10,3,19,1636,1595,1047,-548
2015,10,3,20,1638,1595,1106,-489
2015,10,3,21,1644,1596,1115,-481
2015,10,3,22,1661,1611,1155,-456
2015,10,3,23,1678,1614,1147,-467
2015,10,4,0,1693,1631,1161,-470
2015,10,4,1,1675,1623,1157,-466
2015,10,4,2,1660,1665,1195,-470
2015,10,4,3,1634,1664,1261,-403
2015,10,4,4,1559,1600,1180,-420
2015,10,4,5,1466,1527,1136,-391
2015,10,4,6,1362,1435,1126,-309
2015,10,4,7,1331,1357,1063,-294
2015,10,4,8,1266,1296,892,-404
2015,10,4,9,1306,1273,845,-428
2015,10,4,10,1288,1268,849,-419
2015,10,4,11,1302,1266,851,-415
2015,10,4,12,1336,1287,840,-447
2015,10,4,13,1382,1331,883,-448
2015,10,4,14,1442,1396,849,-547
2015,10,4,15,1505,1453,816,-637
2015,10,4,16,1556,1531,800,-731
2015,10,4,17,1576,1566,822,-744
2015,10,4,18,1575,1558,813,-745
2015,10,4,19,1579,1573,843,-730
2015,10,4,20,1582,1581,849,-732
2015,10,4,21,1594,1583,848,-735
2015,10,4,22,1615,1592,862,-730
2015,10,4,23,1644,1631,905,-726
2015,10,5,0,1672,1664,936,-728
2015,10,5,1,1670,1669,945,-724
2015,10,5,2,1682,1702,957,-745
2015,10,5,3,1665,1719,995,-724
2015,10,5,4,1584,1623,890,-733
2015,10,5,5,1471,1492,774,-718
2015,10,5,6,1350,1377,747,-630
2015,10,5,7,1263,1295,678,-617
2015,10,5,8,1238,1264,722,-542
2015,10,5,9,1236,1254,715,-539
2015,10,5,10,1231,1248,709,-539
2015,10,5,11,1261,1272,734,-538
2015,10,5,12,1337,1357,808,-549
2015,10,5,13,1482,1526,907,-619
2015,10,5,14,1609,1669,932,-737
2015,10,5,15,1711,1680,854,-826
2015,10,5,16,1746,1684,840,-844
2015,10,5,17,1763,1715,866,-849
2015,10,5,18,1771,1714,865,-849
2015,10,5,19,1774,1712,873,-839
2015,10,5,20,1795,1724,877,-847
2015,10,5,21,1817,1746,892,-854
2015,10,5,22,1836,1776,999,-777
2015,10,5,23,1858,1804,1054,-750
2015,10,6,0,1887,1813,1047,-766
2015,10,6,1,1891,1818,1044,-774
2015,10,6,2,1903,1845,1002,-843
2015,10,6,3,1884,1846,1021,-825
2015,10,6,4,1786,1742,883,-859
2015,10,6,5,1642,1590,779,-811
2015,10,6,6,1495,1449,711,-738
2015,10,6,7,1434,1354,723,-631
2015,10,6,8,1378,1314,720,-594
2015,10,6,9,1332,1289,726,-563
2015,10,6,10,1324,1281,718,-563
2015,10,6,11,1347,1298,726,-572
2015,10,6,12,1417,1372,657,-715
2015,10,6,13,1561,1541,843,-698
2015,10,6,14,1688,1693,919,-774
2015,10,6,15,1694,1696,857,-839
2015,10,6,16,1728,1706,877,-829
2015,10,6,17,1756,1721,918,-803
2015,10,6,18,1773,1727,925,-802
2015,10,6,19,1780,1740,939,-801
2015,10,6,20,1797,1769,946,-823
2015,10,6,21,1811,1791,987,-804
2015,10,6,22,1827,1812,1010,-802
2015,10,6,23,1846,1844,1039,-805
2015,10,7,0,1860,1850,1045,-805
2015,10,7,1,1860,1848,1058,-790
2015,10,7,2,1860,1874,1063,-811
2015,10,7,3,1838,1853,1056,-797
2015,10,7,4,1728,1746,990,-756
2015,10,7,5,1576,1599,815,-784
2015,10,7,6,1433,1477,749,-728
2015,10,7,7,1447,1383,667,-716
2015,10,7,8,1365,1312,652,-660
2015,10,7,9,1331,1284,676,-608
2015,10,7,10,1322,1279,700,-579
2015,10,7,11,1342,1294,716,-578
2015,10,7,12,1417,1368,698,-670
2015,10,7,13,1570,1530,824,-706
2015,10,7,14,1702,1680,985,-695
2015,10,7,15,1706,1673,997,-676
2015,10,7,16,1733,1702,1021,-681
2015,10,7,17,1760,1706,1011,-695
2015,10,7,18,1779,1727,1024,-703
2015,10,7,19,1784,1736,1035,-701
2015,10,7,20,1803,1752,1070,-682
2015,10,7,21,1814,1764,1076,-688
2015,10,7,22,1823,1768,1095,-673
2015,10,7,23,1833,1775,1113,-662
2015,10,8,0,1825,1771,1230,-541
2015,10,8,1,1803,1774,1336,-438
2015,10,8,2,1803,1839,1432,-407
2015,10,8,3,1787,1822,1419,-403
2015,10,8,4,1680,1740,1374,-366
2015,10,8,5,1532,1592,1262,-330
2015,10,8,6,1393,1455,1179,-276
2015,10,8,7,1418,1364,1197,-167
2015,10,8,8,1364,1306,1338,32
2015,10,8,9,1325,1282,1312,30
2015,10,8,10,1313,1273,1172,-101
2015,10,8,11,1331,1296,1201,-95
2015,10,8,12,1405,1362,1203,-159
2015,10,8,13,1565,1532,1296,-236
2015,10,8,14,1702,1665,1171,-494
2015,10,8,15,1703,1679,1128,-551
2015,10,8,16,1726,1705,1049,-656
2015,10,8,17,1747,1737,978,-759
2015,10,8,18,1755,1758,963,-795
2015,10,8,19,1747,1756,969,-787
2015,10,8,20,1755,1772,986,-786
2015,10,8,21,1771,1796,1017,-779
2015,10,8,22,1779,1812,1047,-765
2015,10,8,23,1794,1814,1077,-737
2015,10,9,0,1796,1813,1026,-787
2015,10,9,1,1792,1809,1023,-786
2015,10,9,2,1803,1861,1183,-678
2015,10,9,3,1779,1845,1190,-655
2015,10,9,4,1675,1749,1133,-616
2015,10,9,5,1532,1603,1009,-594
2015,10,9,6,1399,1457,1111,-346
2015,10,9,7,1402,1367,1042,-325
2015,10,9,8,1307,1319,1026,-293
2015,10,9,9,1308,1286,1013,-273
2015,10,9,10,1300,1284,1015,-269
2015,10,9,11,1319,1301,1016,-285
2015,10,9,12,1396,1361,1074,-287
2015,10,9,13,1557,1521,1166,-355
2015,10,9,14,1697,1648,1159,-489
2015,10,9,15,1702,1678,1171,-507
2015,10,9,16,1726,1687,1286,-401
2015,10,9,17,1760,1709,1210,-499
2015,10,9,18,1787,1707,1261,-446
2015,10,9,19,1823,1715,1344,-371
2015,10,9,20,1887,1766,1393,-373
2015,10,9,21,1959,1813,1265,-548
2015,10,9,22,2008,1868,1307,-561
2015,10,9,23,2044,1952,1235,-717
2015,10,10,0,2019,1933,1237,-696
2015,10,10,1,1985,1905,1222,-683
2015,10,10,2,1930,1884,1185,-699
2015,10,10,3,1867,1839,1168,-671
2015,10,10,4,1744,1753,1129,-624
2015,10,10,5,1611,1627,1113,-514
2015,10,10,6,1478,1497,1297,-200
2015,10,10,7,1442,1404,1240,-164
2015,10,10,8,1404,1345,1190,-155
2015,10,10,9,1365,1303,1141,-162
2015,10,10,10,1353,1284,1149,-135
2015,10,10,11,1361,1287,1240,-47
2015,10,10,12,1398,1309,1221,-88
2015,10,10,13,1469,1363,1248,-115
2015,10,10,14,1547,1434,1079,-355
2015,10,10,15,1597,1510,1136,-374
2015,10,10,16,1657,1566,1280,-286
2015,10,10,17,1713,1613,1328,-285
2015,10,10,18,1756,1650,1361,-289
2015,10,10,19,1789,1692,1321,-371
2015,10,10,20,1825,1738,1340,-398
2015,10,10,21,1871,1810,1359,-451
2015,10,10,22,1901,1890,1430,-460
2015,10,10,23,1939,1966,1517,-449
2015,10,11,0,1974,1969,1532,-437
2015,10,11,1,1918,1938,1467,-471
2015,10,11,2,1834,1913,1476,-437
2015,10,11,3,1757,1868,1506,-362
2015,10,11,4,1642,1782,1595,-187
2015,10,11,5,1521,1662,1505,-157
2015,10,11,6,1398,1548,1571,23
2015,10,11,7,1384,1445,1524,79
2015,10,11,8,1341,1376,1419,43
2015,10,11,9,1341,1340,1470,130
2015,10,11,10,1307,1291,1393,102
2015,10,11,11,1294,1287,1404,117
2015,10,11,12,1315,1293,1395,102
2015,10,11,13,1361,1310,1405,95
2015,10,11,14,1426,1388,1462,74
2015,10,11,15,1473,1434,1500,66
2015,10,11,16,1519,1508,1575,67
2015,10,11,17,1540,1562,1642,80
2015,10,11,18,1526,1566,1571,5
2015,10,11,19,1505,1585,1565,-20
2015,10,11,20,1476,1593,1545,-48
2015,10,11,21,1468,1600,1548,-52
2015,10,11,22,1468,1625,1470,-155
2015,10,11,23,1474,1661,1441,-220
2015,10,12,0,1490,1681,1421,-260
2015,10,12,1,1472,1672,1273,-399
2015,10,12,2,1481,1708,1246,-462
2015,10,12,3,1478,1682,1228,-454
2015,10,12,4,1419,1615,1159,-456
2015,10,12,5,1317,1486,1066,-420
2015,10,12,6,1206,1368,977,-391
2015,10,12,7,1220,1285,886,-399
2015,10,12,8,1192,1252,806,-446
2015,10,12,9,1210,1238,797,-441
2015,10,12,10,1209,1233,816,-417
2015,10,12,11,1236,1263,811,-452
2015,10,12,12,1317,1347,861,-486
2015,10,12,13,1473,1515,1005,-510
2015,10,12,14,1617,1675,1017,-658
2015,10,12,15,1701,1693,1125,-568
2015,10,12,16,1719,1709,1192,-517
2015,10,12,17,1731,1720,1223,-497
2015,10,12,18,1728,1720,1232,-488
2015,10,12,19,1719,1727,1167,-560
2015,10,12,20,1732,1721,1067,-654
2015,10,12,21,1766,1743,1079,-664
2015,10,12,22,1790,1760,1030,-730
2015,10,12,23,1805,1785,1038,-747
2015,10,13,0,1832,1812,1064,-748
2015,10,13,1,1812,1807,1078,-729
2015,10,13,2,1815,1855,1109,-746
2015,10,13,3,1798,1824,1057,-767
2015,10,13,4,1717,1727,1032,-695
2015,10,13,5,1576,1579,988,-591
2015,10,13,6,1434,1448,1102,-346
2015,10,13,7,1351,1367,1033,-334
2015,10,13,8,1327,1326,984,-342
2015,10,13,9,1302,1301,975,-326
2015,10,13,10,1295,1299,856,-443
2015,10,13,11,1315,1312,823,-489
2015,10,13,12,1388,1404,859,-545
2015,10,13,13,1542,1573,920,-653
2015,10,13,14,1681,1730,1004,-726
2015,10,13,15,1681,1743,1013,-730
2015,10,13,16,1703,1732,996,-736
2015,10,13,17,1727,1749,1015,-734
2015,10,13,18,1739,1742,1013,-729
2015,10,13,19,1741,1754,1028,-726
2015,10,13,20,1749,1786,1049,-737
2015,10,13,21,1770,1797,1084,-713
2015,10,13,22,1777,1825,1114,-711
2015,10,13,23,1794,1837,1127,-710
2015,10,14,0,1813,1852,1148,-704
2015,10,14,1,1799,1842,1140,-702
2015,10,14,2,1803,1882,1153,-729
2015,10,14,3,1770,1853,1141,-712
2015,10,14,4,1667,1753,1040,-713
2015,10,14,5,1518,1601,925,-676
2015,10,14,6,1377,1448,960,-488
2015,10,14,7,1377,1363,901,-462
2015,10,14,8,1334,1307,860,-447
2015,10,14,9,1304,1295,833,-462
2015,10,14,10,1298,1283,782,-501
2015,10,14,11,1319,1308,817,-491
2015,10,14,12,1395,1383,817,-566
2015,10,14,13,1556,1566,964,-602
2015,10,14,14,1699,1740,1024,-716
2015,10,14,15,1701,1738,991,-747
2015,10,14,16,1718,1751,1000,-751
2015,10,14,17,1741,1751,1001,-750
2015,10,14,18,1751,1753,1007,-746
2015,10,14,19,1755,1761,1017,-744
2015,10,14,20,1768,1775,1043,-732
2015,10,14,21,1783,1805,1051,-754
2015,10,14,22,1793,1809,1077,-732
2015,10,14,23,1806,1843,1097,-746
2015,10,15,0,1811,1862,1117,-745
2015,10,15,1,1790,1851,1117,-734
2015,10,15,2,1799,1890,1152,-738
2015,10,15,3,1763,1853,1128,-725
2015,10,15,4,1662,1742,1037,-705
2015,10,15,5,1513,1608,876,-732
2015,10,15,6,1363,1450,783,-667
2015,10,15,7,1386,1374,776,-598
2015,10,15,8,1327,1326,741,-585
2015,10,15,9,1306,1303,759,-544
2015,10,15,10,1297,1295,759,-536
2015,10,15,11,1319,1310,792,-518
2015,10,15,12,1398,1396,862,-534
2015,10,15,13,1565,1568,1007,-561
2015,10,15,14,1722,1721,1066,-655
2015,10,15,15,1722,1726,1040,-686
2015,10,15,16,1730,1727,1119,-608
2015,10,15,17,1745,1739,1132,-607
2015,10,15,18,1746,1731,1143,-588
2015,10,15,19,1743,1729,1158,-571
2015,10,15,20,1756,1732,1146,-586
2015,10,15,21,1775,1753,1164,-589
2015,10,15,22,1790,1790,1176,-614
2015,10,15,23,1811,1820,1194,-626
2015,10,16,0,1818,1830,1207,-623
2015,10,16,1,1796,1806,1118,-688
2015,10,16,2,1806,1855,1134,-721
2015,10,16,3,1765,1829,1121,-708
2015,10,16,4,1658,1733,1002,-731
2015,10,16,5,1508,1585,875,-710
2015,10,16,6,1355,1460,819,-641
2015,10,16,7,1368,1364,800,-564
2015,10,16,8,1327,1319,903,-416
2015,10,16,9,1313,1288,941,-347
2015,10,16,10,1302,1293,1007,-286
2015,10,16,11,1323,1303,991,-312
2015,10,16,12,1405,1381,1025,-356
2015,10,16,13,1577,1536,1148,-388
2015,10,16,14,1730,1679,1140,-539
2015,10,16,15,1731,1701,1066,-635
2015,10,16,16,1737,1702,1056,-646
2015,10,16,17,1750,1715,1055,-660
2015,10,16,18,1752,1707,1050,-657
2015,10,16,19,1747,1695,1044,-651
2015,10,16,20,1767,1712,1082,-630
2015,10,16,21,1786,1731,1105,-626
2015,10,16,22,1805,1740,1112,-628
2015,10,16,23,1831,1759,1124,-635
2015,10,17,0,1783,1747,1052,-695
2015,10,17,1,1728,1724,1021,-703
2015,10,17,2,1728,1735,1014,-721
2015,10,17,3,1706,1698,990,-708
2015,10,17,4,1618,1629,985,-644
2015,10,17,5,1511,1521,922,-599
2015,10,17,6,1387,1414,1012,-402
2015,10,17,7,1374,1324,943,-381
2015,10,17,8,1322,1281,913,-368
2015,10,17,9,1291,1248,949,-299
2015,10,17,10,1278,1235,928,-307
2015,10,17,11,1290,1238,966,-272
2015,10,17,12,1328,1274,1000,-274
2015,10,17,13,1404,1338,1118,-220
2015,10,17,14,1495,1429,1228,-201
2015,10,17,15,1547,1496,1244,-252
2015,10,17,16,1585,1532,1268,-264
2015,10,17,17,1610,1560,1299,-261
2015,10,17,18,1616,1552,1177,-375
2015,10,17,19,1606,1541,1206,-335
2015,10,17,20,1604,1533,1194,-339
2015,10,17,21,1610,1532,1167,-365
2015,10,17,22,1611,1530,1159,-371
2015,10,17,23,1602,1542,1169,-373
2015,10,18,0,1593,1562,1118,-444
2015,10,18,1,1546,1602,1200,-402
2015,10,18,2,1561,1643,1111,-532
2015,10,18,3,1542,1600,1066,-534
2015,10,18,4,1477,1542,1008,-534
2015,10,18,5,1389,1450,942,-508
2015,10,18,6,1292,1351,1021,-330
2015,10,18,7,1292,1275,945,-330
2015,10,18,8,1270,1219,861,-358
2015,10,18,9,1255,1200,863,-337
2015,10,18,10,1248,1176,894,-282
2015,10,18,11,1253,1180,960,-220
2015,10,18,12,1281,1192,860,-332
2015,10,18,13,1339,1233,841,-392
2015,10,18,14,1416,1309,899,-410
2015,10,18,15,1472,1373,958,-415
2015,10,18,16,1520,1438,1010,-428
2015,10,18,17,1548,1477,1085,-392
2015,10,18,18,1543,1491,1089,-402
2015,10,18,19,1531,1500,1112,-388
2015,10,18,20,1508,1491,1008,-483
2015,10,18,21,1483,1494,1019,-475
2015,10,18,22,1465,1502,969,-533
2015,10,18,23,1469,1508,972,-536
2015,10,19,0,1490,1541,957,-584
2015,10,19,1,1498,1590,986,-604
2015,10,19,2,1552,1638,1041,-597
2015,10,19,3,1547,1608,1018,-590
2015,10,19,4,1500,1522,1013,-509
2015,10,19,5,1407,1406,975,-431
2015,10,19,6,1300,1295,928,-367
2015,10,19,7,1266,1215,955,-260
2015,10,19,8,1223,1178,1097,-81
2015,10,19,9,1189,1158,1088,-70
2015,10,19,10,1187,1163,1113,-50
2015,10,19,11,1208,1173,1100,-73
2015,10,19,12,1284,1271,1142,-129
2015,10,19,13,1442,1434,1217,-217
2015,10,19,14,1585,1579,1326,-253
2015,10,19,15,1664,1606,1295,-311
2015,10,19,16,1681,1616,1287,-329
2015,10,19,17,1692,1626,1211,-415
2015,10,19,18,1684,1631,1175,-456
2015,10,19,19,1651,1609,1048,-561
2015,10,19,20,1618,1608,1073,-535
2015,10,19,21,1585,1583,1067,-516
2015,10,19,22,1550,1580,1128,-452
2015,10,19,23,1534,1593,1168,-425
2015,10,20,0,1546,1614,1064,-550
2015,10,20,1,1566,1656,1047,-609
2015,10,20,2,1644,1688,1070,-618
2015,10,20,3,1658,1646,1057,-589
2015,10,20,4,1613,1567,1019,-548
2015,10,20,5,1510,1425,975,-450
2015,10,20,6,1398,1307,913,-394
2015,10,20,7,1345,1236,917,-319
2015,10,20,8,1287,1212,965,-247
2015,10,20,9,1233,1176,931,-245
2015,10,20,10,1232,1170,938,-232
2015,10,20,11,1255,1199,957,-242
2015,10,20,12,1330,1273,976,-297
2015,10,20,13,1489,1452,1113,-339
2015,10,20,14,1636,1619,1071,-548
2015,10,20,15,1641,1620,1080,-540
2015,10,20,16,1655,1610,1039,-571
2015,10,20,17,1667,1598,972,-626
2015,10,20,18,1657,1602,1010,-592
2015,10,20,19,1631,1582,1025,-557
2015,10,20,20,1612,1587,1048,-539
2015,10,20,21,1598,1576,1045,-531
2015,10,20,22,1588,1559,1041,-518
2015,10,20,23,1600,1567,1007,-560
2015,10,21,0,1628,1579,990,-589
2015,10,21,1,1657,1595,995,-600
2015,10,21,2,1703,1667,1058,-609
2015,10,21,3,1682,1648,1043,-605
2015,10,21,4,1609,1572,982,-590
2015,10,21,5,1488,1436,870,-566
2015,10,21,6,1370,1311,968,-343
2015,10,21,7,1332,1240,911,-329
2015,10,21,8,1240,1203,870,-333
2015,10,21,9,1208,1193,907,-286
2015,10,21,10,1206,1191,894,-297
2015,10,21,11,1228,1212,918,-294
2015,10,21,12,1308,1314,826,-488
2015,10,21,13,1478,1490,887,-603
2015,10,21,14,1633,1666,1023,-643
2015,10,21,15,1638,1664,1042,-622
2015,10,21,16,1636,1633,1013,-620
2015,10,21,17,1633,1608,989,-619
2015,10,21,18,1624,1586,982,-604
2015,10,21,19,1607,1551,950,-601
2015,10,21,20,1601,1540,948,-592
2015,10,21,21,1595,1527,937,-590
2015,10,21,22,1593,1516,917,-599
2015,10,21,23,1606,1525,930,-595
2015,10,22,0,1629,1524,929,-595
2015,10,22,1,1657,1548,934,-614
2015,10,22,2,1701,1630,995,-635
2015,10,22,3,1665,1609,989,-620
2015,10,22,4,1577,1532,935,-597
2015,10,22,5,1444,1411,920,-491
2015,10,22,6,1323,1298,894,-404
2015,10,22,7,1283,1226,991,-235
2015,10,22,8,1220,1199,982,-217
2015,10,22,9,1196,1180,883,-297
2015,10,22,10,1195,1183,886,-297
2015,10,22,11,1220,1218,905,-313
2015,10,22,12,1303,1297,955,-342
2015,10,22,13,1477,1489,1023,-466
2015,10,22,14,1631,1671,1049,-622
2015,10,22,15,1628,1661,1038,-623
2015,10,22,16,1617,1645,1025,-620
2015,10,22,17,1612,1637,1029,-608
2015,10,22,18,1603,1599,997,-602
2015,10,22,19,1585,1568,998,-570
2015,10,22,20,1588,1556,1063,-493
2015,10,22,21,1564,1527,1101,-426
2015,10,22,22,1556,1511,1182,-329
2015,10,22,23,1562,1521,1292,-229
2015,10,23,0,1572,1533,1425,-108
2015,10,23,1,1592,1568,1452,-116
2015,10,23,2,1653,1637,1526,-111
2015,10,23,3,1628,1618,1523,-95
2015,10,23,4,1546,1550,1285,-265
2015,10,23,5,1416,1434,1264,-170
2015,10,23,6,1296,1312,1282,-30
2015,10,23,7,1261,1242,1206,-36
2015,10,23,8,1216,1198,1028,-170
2015,10,23,9,1204,1204,997,-207
2015,10,23,10,1202,1192,932,-260
2015,10,23,11,1229,1228,953,-275
2015,10,23,12,1316,1312,1026,-286
2015,10,23,13,1499,1492,1082,-410
2015,10,23,14,1660,1656,1146,-510
2015,10,23,15,1656,1674,1070,-604
2015,10,23,16,1642,1663,1040,-623
2015,10,23,17,1625,1643,1026,-617
2015,10,23,18,1603,1618,1008,-610
2015,10,23,19,1578,1565,974,-591
2015,10,23,20,1575,1552,981,-571
2015,10,23,21,1556,1540,981,-559
2015,10,23,22,1544,1525,963,-562
2015,10,23,23,1552,1511,948,-563
2015,10,24,0,1506,1511,948,-563
2015,10,24,1,1505,1544,958,-586
2015,10,24,2,1544,1593,1010,-583
2015,10,24,3,1521,1567,1000,-567
2015,10,24,4,1468,1513,956,-557
2015,10,24,5,1385,1434,947,-487
2015,10,24,6,1289,1338,1024,-314
2015,10,24,7,1242,1262,967,-295
2015,10,24,8,1208,1207,892,-315
2015,10,24,9,1211,1196,877,-319
2015,10,24,10,1203,1192,877,-315
2015,10,24,11,1219,1199,877,-322
2015,10,24,12,1265,1240,921,-319
2015,10,24,13,1354,1318,1021,-297
2015,10,24,14,1454,1407,1069,-338
2015,10,24,15,1499,1499,1153,-346
2015,10,24,16,1516,1544,1196,-348
2015,10,24,17,1514,1542,1229,-313
2015,10,24,18,1503,1512,1221,-291
2015,10,24,19,1486,1476,1178,-298
2015,10,24,20,1483,1464,1161,-303
2015,10,24,21,1482,1430,1108,-322
2015,10,24,22,1488,1435,1124,-311
2015,10,24,23,1500,1445,1140,-305
2015,10,25,0,1531,1470,1136,-334
2015,10,25,1,1551,1511,1164,-347
2015,10,25,2,1574,1561,1214,-347
2015,10,25,3,1522,1520,1187,-333
2015,10,25,4,1450,1479,1163,-316
2015,10,25,5,1363,1400,1105,-295
2015,10,25,6,1266,1308,1106,-202
2015,10,25,7,1202,1239,1032,-207
2015,10,25,8,1191,1191,1025,-166
2015,10,25,9,1198,1182,1049,-133
2015,10,25,10,1193,1168,1097,-71
2015,10,25,11,1199,1176,1101,-75
2015,10,25,12,1235,1205,1137,-68
2015,10,25,13,1300,1262,1085,-177
2015,10,25,14,1385,1361,1169,-192
2015,10,25,15,1442,1434,1230,-204
2015,10,25,16,1480,1479,1240,-239
2015,10,25,17,1495,1505,1210,-295
2015,10,25,18,1490,1497,1201,-296
2015,10,25,19,1495,1483,1183,-300
2015,10,25,20,1500,1456,1173,-283
2015,10,25,21,1511,1446,1132,-314
2015,10,25,22,1524,1431,1156,-275
2015,10,25,23,1551,1452,1171,-281
2015,10,26,0,1597,1475,1181,-294
2015,10,26,1,1627,1529,1209,-320
2015,10,26,2,1646,1614,1257,-357
2015,10,26,3,1587,1592,1252,-340
2015,10,26,4,1503,1509,1267,-242
2015,10,26,5,1392,1383,1164,-219
2015,10,26,6,1276,1262,1087,-175
2015,10,26,7,1210,1185,1039,-146
2015,10,26,8,1183,1153,1066,-87
2015,10,26,9,1158,1139,1168,29
2015,10,26,10,1159,1149,1161,12
2015,10,26,11,1184,1178,1218,40
2015,10,26,12,1268,1286,1311,25
2015,10,26,13,1437,1483,1164,-319
2015,10,26,14,1586,1659,1151,-508
2015,10,26,15,1674,1675,1151,-524
2015,10,26,16,1677,1661,1069,-592
2015,10,26,17,1672,1647,1049,-598
2015,10,26,18,1648,1633,975,-658
2015,10,26,19,1608,1599,966,-633
2015,10,26,20,1586,1584,951,-633
2015,10,26,21,1554,1584,934,-650
2015,10,26,22,1525,1562,917,-645
2015,10,26,23,1511,1562,919,-643
2015,10,27,0,1522,1566,966,-600
2015,10,27,1,1552,1617,1014,-603
2015,10,27,2,1618,1691,1010,-681
2015,10,27,3,1601,1664,819,-845
2015,10,27,4,1538,1591,762,-829
2015,10,27,5,1430,1449,669,-780
2015,10,27,6,1315,1343,772,-571
2015,10,27,7,1288,1269,755,-514
2015,10,27,8,1249,1235,740,-495
2015,10,27,9,1245,1218,791,-427
2015,10,27,10,1251,1234,726,-508
2015,10,27,11,1282,1271,662,-609
2015,10,27,12,1375,1380,789,-591
2015,10,27,13,1556,1577,872,-705
2015,10,27,14,1723,1751,926,-825
2015,10,27,15,1728,1751,939,-812
2015,10,27,16,1720,1717,915,-802
2015,10,27,17,1696,1695,795,-900
2015,10,27,18,1657,1660,893,-767
2015,10,27,19,1611,1614,923,-691
2015,10,27,20,1583,1587,903,-684
2015,10,27,21,1554,1556,891,-665
2015,10,27,22,1525,1537,781,-756
2015,10,27,23,1516,1544,815,-729
2015,10,28,0,1532,1561,785,-776
2015,10,28,1,1574,1618,818,-800
2015,10,28,2,1641,1707,897,-810
2015,10,28,3,1621,1681,901,-780
2015,10,28,4,1556,1609,885,-724
2015,10,28,5,1442,1475,760,-715
2015,10,28,6,1330,1359,709,-650
2015,10,28,7,1281,1296,620,-676
2015,10,28,8,1250,1274,640,-634
2015,10,28,9,1253,1269,637,-632
2015,10,28,10,1255,1276,641,-635
2015,10,28,11,1284,1309,653,-656
2015,10,28,12,1377,1405,739,-666
2015,10,28,13,1560,1590,860,-730
2015,10,28,14,1724,1741,935,-806
2015,10,28,15,1721,1745,997,-748
2015,10,28,16,1701,1734,1064,-670
2015,10,28,17,1685,1712,1064,-648
2015,10,28,18,1656,1679,1021,-658
2015,10,28,19,1620,1646,1015,-631
2015,10,28,20,1594,1635,1017,-618
2015,10,28,21,1569,1601,1009,-592
2015,10,28,22,1543,1601,938,-663
2015,10,28,23,1536,1607,931,-676
2015,10,29,0,1548,1625,905,-720
2015,10,29,1,1594,1686,925,-761
2015,10,29,2,1676,1720,973,-747
2015,10,29,3,1655,1694,969,-725
2015,10,29,4,1588,1616,828,-788
2015,10,29,5,1465,1477,782,-695
2015,10,29,6,1347,1356,769,-587
2015,10,29,7,1284,1272,743,-529
2015,10,29,8,1270,1242,751,-491
2015,10,29,9,1255,1236,783,-453
2015,10,29,10,1262,1228,782,-446
2015,10,29,11,1293,1252,828,-424
2015,10,29,12,1387,1347,917,-430
2015,10,29,13,1575,1534,1088,-446
2015,10,29,14,1734,1691,1192,-499
2015,10,29,15,1736,1704,1241,-463
2015,10,29,16,1716,1687,1213,-474
2015,10,29,17,1706,1653,1198,-455
2015,10,29,18,1675,1636,1229,-407
2015,10,29,19,1642,1609,1206,-403
2015,10,29,20,1616,1587,1218,-369
2015,10,29,21,1588,1562,1213,-349
2015,10,29,22,1567,1543,1193,-350
2015,10,29,23,1565,1537,1180,-357
2015,10,30,0,1580,1562,1189,-373
2015,10,30,1,1632,1594,1153,-441
2015,10,30,2,1701,1671,1161,-510
2015,10,30,3,1682,1660,1146,-514
2015,10,30,4,1610,1593,1103,-490
2015,10,30,5,1487,1475,1017,-458
2015,10,30,6,1370,1363,915,-448
2015,10,30,7,1312,1288,832,-456
2015,10,30,8,1270,1269,780,-489
2015,10,30,9,1267,1249,719,-530
2015,10,30,10,1272,1276,731,-545
2015,10,30,11,1304,1305,731,-574
2015,10,30,12,1402,1394,782,-612
2015,10,30,13,1597,1563,944,-619
2015,10,30,14,1760,1723,885,-838
2015,10,30,15,1769,1748,907,-841
2015,10,30,16,1739,1727,829,-898
2015,10,30,17,1707,1717,822,-895
2015,10,30,18,1667,1700,822,-878
2015,10,30,19,1632,1682,799,-883
2015,10,30,20,1610,1661,789,-872
2015,10,30,21,1587,1576,761,-815
2015,10,30,22,1568,1611,746,-865
2015,10,30,23,1568,1620,735,-885
2015,10,31,0,1519,1637,734,-903
2015,10,31,1,1544,1656,728,-928
2015,10,31,2,1598,1664,750,-914
2015,10,31,3,1588,1619,695,-924
2015,10,31,4,1541,1557,673,-884
2015,10,31,5,1456,1459,650,-809
2015,10,31,6,1361,1359,671,-688
2015,10,31,7,1289,1287,641,-646
2015,10,31,8,1258,1242,639,-603
2015,10,31,9,1245,1218,654,-564
2015,10,31,10,1240,1196,640,-556
2015,10,31,11,1259,1206,654,-552
2015,10,31,12,1306,1237,668,-569
2015,10,31,13,1393,1315,721,-594
2015,10,31,14,1488,1398,663,-735
2015,10,31,15,1551,1487,782,-705
2015,10,31,16,1567,1534,842,-692
2015,10,31,17,1571,1559,897,-662
2015,10,31,18,1563,1542,891,-651
2015,10,31,19,1551,1496,838,-658
2015,10,31,20,1547,1479,842,-637
2015,10,31,21,1544,1441,780,-661
2015,10,31,22,1556,1422,763,-659
2015,10,31,23,1577,1426,785,-641
2015,11,1,0,1612,1425,870,-555
2015,11,1,1,1647,1437,886,-551
2015,11,1,2,1656,1447,900,-547
2015,11,1,3,1604,1427,866,-561
2015,11,1,4,1532,1395,871,-524
2015,11,1,5,1437,1347,725,-622
2015,11,1,6,1337,1274,813,-461
2015,11,1,7,1259,1198,812,-386
2015,11,1,8,1215,1140,734,-406
2015,11,1,9,1193,1117,696,-421
2015,11,1,10,1172,1112,719,-393
2015,11,1,11,1172,1112,719,-393
2015,11,1,12,1204,1136,707,-429
2015,11,1,13,1240,1166,800,-366
2015,11,1,14,1305,1241,893,-348
2015,11,1,15,1387,1328,979,-349
2015,11,1,16,1460,1415,1061,-354
2015,11,1,17,1503,1457,1012,-445
2015,11,1,18,1531,1475,917,-558
2015,11,1,19,1528,1464,805,-659
2015,11,1,20,1527,1459,748,-711
2015,11,1,21,1515,1444,742,-702
2015,11,1,22,1496,1449,725,-724
2015,11,1,23,-9999,1449,725,-9999
2015,11,2,0,1495,1486,770,-716
2015,11,2,1,1507,1572,823,-749
2015,11,2,2,1530,1633,862,-771
2015,11,2,3,1550,1592,770,-822
2015,11,2,4,1517,1543,730,-813
2015,11,2,5,1453,1449,711,-738
2015,11,2,6,1356,1337,643,-694
2015,11,2,7,1251,1248,625,-623
2015,11,2,8,1215,1184,582,-602
2015,11,2,9,1186,1160,617,-543
2015,11,2,10,1170,1156,559,-597
2015,11,2,11,1176,1167,552,-615
2015,11,2,12,1206,1211,562,-649
2015,11,2,13,1296,1320,628,-692
2015,11,2,14,1474,1513,685,-828
2015,11,2,15,1627,1659,729,-930
2015,11,2,16,1706,1671,735,-936
2015,11,2,17,1699,1669,739,-930
2015,11,2,18,1699,1672,799,-873
2015,11,2,19,1684,1657,827,-830
2015,11,2,20,1655,1646,829,-817
2015,11,2,21,1630,1621,807,-814
2015,11,2,22,1595,1621,784,-837
2015,11,2,23,1565,1639,804,-835
2015,11,3,0,1554,1674,827,-847
2015,11,3,1,1560,1748,817,-931
2015,11,3,2,1595,1794,832,-962
2015,11,3,3,1649,1760,776,-984
2015,11,3,4,1645,1700,744,-956
2015,11,3,5,1594,1615,766,-849
2015,11,3,6,1488,1484,685,-799
2015,11,3,7,1377,1368,713,-655
2015,11,3,8,1327,1304,650,-654
2015,11,3,9,1300,1289,727,-562
2015,11,3,10,1290,1283,721,-562
2015,11,3,11,1296,1291,734,-557
2015,11,3,12,1328,1329,760,-569
2015,11,3,13,1425,1443,764,-679
2015,11,3,14,1616,1640,927,-713
2015,11,3,15,1776,1770,1064,-706
2015,11,3,16,1775,1773,1095,-678
2015,11,3,17,1766,1766,1187,-579
2015,11,3,18,1755,1753,1176,-577
2015,11,3,19,1732,1727,1250,-477
2015,11,3,20,1692,1704,1219,-485
2015,11,3,21,1662,1705,1220,-485
2015,11,3,22,1632,1712,1248,-464
2015,11,3,23,1615,1712,1242,-470
2015,11,4,0,1622,1740,1277,-463
2015,11,4,1,1659,1828,1333,-495
2015,11,4,2,1707,1893,1354,-539
2015,11,4,3,1729,1865,1303,-562
2015,11,4,4,1714,1821,1242,-579
2015,11,4,5,1656,1726,1237,-489
2015,11,4,6,1545,1592,1282,-310
2015,11,4,7,1438,1482,1253,-229
2015,11,4,8,1381,1414,1212,-202
2015,11,4,9,1400,1391,1141,-250
2015,11,4,10,1405,1370,1124,-246
2015,11,4,11,1412,1387,1035,-352
2015,11,4,12,1456,1421,913,-508
2015,11,4,13,1566,1544,897,-647
2015,11,4,14,1771,1747,942,-805
2015,11,4,15,1933,1868,1081,-787
2015,11,4,16,1933,1841,984,-857
2015,11,4,17,1907,1816,1006,-810
2015,11,4,18,1870,1761,957,-804
2015,11,4,19,1820,1737,942,-795
2015,11,4,20,1765,1685,901,-784
2015,11,4,21,1724,1692,915,-777
2015,11,4,22,1696,1658,864,-794
2015,11,4,23,1680,1657,879,-778
2015,11,5,0,1691,1679,878,-801
2015,11,5,1,1747,1775,917,-858
2015,11,5,2,1813,1868,998,-870
2015,11,5,3,1819,1849,985,-864
2015,11,5,4,1798,1806,953,-853
2015,11,5,5,1732,1727,938,-789
2015,11,5,6,1621,1595,852,-743
2015,11,5,7,1518,1487,877,-610
2015,11,5,8,1427,1428,787,-641
2015,11,5,9,1450,765,670,-95
2015,11,5,10,1434,785,656,-129
2015,11,5,11,1446,844,670,-174
2015,11,5,12,1496,740,724,-16
2015,11,5,13,1611,909,789,-120
2015,11,5,14,1818,1223,987,-236
2015,11,5,15,1960,1312,1124,-188
2015,11,5,16,1938,1122,1126,4
2015,11,5,17,1896,1083,1100,17
2015,11,5,18,1848,923,1062,139
2015,11,5,19,1797,921,1004,83
2015,11,5,20,1750,944,991,47
2015,11,5,21,1717,928,900,-28
2015,11,5,22,1694,966,892,-74
2015,11,5,23,1680,967,869,-98
2015,11,6,0,1697,1025,919,-106
2015,11,6,1,1775,1319,1066,-253
2015,11,6,2,1851,1421,1092,-329
2015,11,6,3,1846,1449,1054,-395
2015,11,6,4,1817,1452,1059,-393
2015,11,6,5,1737,1250,967,-283
2015,11,6,6,1620,1095,900,-195
2015,11,6,7,1517,1034,936,-98
2015,11,6,8,1417,913,905,-8
2015,11,6,9,1382,1389,909,-480
2015,11,6,10,1388,1381,894,-487
2015,11,6,11,1400,1392,962,-430
2015,11,6,12,1441,1430,1009,-421
2015,11,6,13,1557,1529,947,-582
2015,11,6,14,1770,1724,1032,-692
2015,11,6,15,1913,1837,1089,-748
2015,11,6,16,1893,1827,1025,-802
2015,11,6,17,1850,1783,1011,-772
2015,11,6,18,1807,1721,952,-769
2015,11,6,19,1768,1673,866,-807
2015,11,6,20,1726,1630,887,-743
2015,11,6,21,1694,1608,878,-730
2015,11,6,22,1675,1581,870,-711
2015,11,6,23,1666,1569,871,-698
2015,11,7,0,1690,1595,881,-714
2015,11,7,1,1712,1686,954,-732
2015,11,7,2,1762,1767,1020,-747
2015,11,7,3,1742,1756,968,-788
2015,11,7,4,1723,1720,939,-781
2015,11,7,5,1677,1670,903,-767
2015,11,7,6,1603,1597,819,-778
2015,11,7,7,1516,1514,891,-623
2015,11,7,8,1424,1453,819,-634
2015,11,7,9,1400,1432,706,-726
2015,11,7,10,1413,1424,694,-730
2015,11,7,11,1413,1427,748,-679
2015,11,7,12,1441,1458,768,-690
2015,11,7,13,1492,1521,826,-695
2015,11,7,14,1578,1614,894,-720
2015,11,7,15,1640,1717,1018,-699
2015,11,7,16,1679,1746,1049,-697
2015,11,7,17,1665,1737,1043,-694
2015,11,7,18,1624,1694,1068,-626
2015,11,7,19,1581,1648,1034,-614
2015,11,7,20,1534,1584,991,-593
2015,11,7,21,1497,1533,907,-626
2015,11,7,22,1479,1492,883,-609
2015,11,7,23,1477,1491,886,-605
2015,11,8,0,1505,1520,873,-647
2015,11,8,1,1606,1641,1002,-639
2015,11,8,2,1678,1721,1172,-549
2015,11,8,3,1657,1698,1157,-541
2015,11,8,4,1626,1682,1154,-528
2015,11,8,5,1573,1634,1164,-470
2015,11,8,6,1504,1550,1103,-447
2015,11,8,7,1428,1479,1120,-359
2015,11,8,8,1338,1431,1077,-354
2015,11,8,9,1337,1397,1051,-346
2015,11,8,10,1374,1391,1002,-389
2015,11,8,11,1376,1398,1023,-375
2015,11,8,12,1396,1417,1019,-398
2015,11,8,13,1436,1469,1052,-417
2015,11,8,14,1498,1540,1111,-429
2015,11,8,15,1543,1628,1205,-423
2015,11,8,16,1570,1683,1231,-452
2015,11,8,17,1572,1679,1228,-451
2015,11,8,18,1557,1648,1239,-409
2015,11,8,19,1534,1603,1200,-403
2015,11,8,20,1527,1573,1163,-410
2015,11,8,21,1514,1539,1131,-408
2015,11,8,22,1505,1519,1058,-461
2015,11,8,23,1508,1521,969,-552
2015,11,9,0,1545,1566,970,-596
2015,11,9,1,1652,1686,1019,-667
2015,11,9,2,1720,1739,1115,-624
2015,11,9,3,1698,1717,1070,-647
2015,11,9,4,1661,1665,1049,-616
2015,11,9,5,1590,1593,1029,-564
2015,11,9,6,1488,1471,932,-539
2015,11,9,7,1390,1357,822,-535
2015,11,9,8,1282,1312,804,-508
2015,11,9,9,1274,1277,775,-502
2015,11,9,10,1287,1277,802,-475
2015,11,9,11,1296,1283,847,-436
2015,11,9,12,1328,1322,830,-492
2015,11,9,13,1425,1433,812,-621
2015,11,9,14,1607,1630,979,-651
2015,11,9,15,1740,1774,1028,-746
2015,11,9,16,1778,1777,1030,-747
2015,11,9,17,1758,1774,1009,-765
2015,11,9,18,1752,1774,972,-802
2015,11,9,19,1749,1754,975,-779
2015,11,9,20,1740,1757,990,-767
2015,11,9,21,1728,1737,957,-780
2015,11,9,22,1710,1741,978,-763
2015,11,9,23,1701,1758,986,-772
2015,11,10,0,1724,1802,1035,-767
2015,11,10,1,1837,1890,1111,-779
2015,11,10,2,1910,1937,1136,-801
2015,11,10,3,1902,1889,1038,-851
2015,11,10,4,1876,1837,968,-869
2015,11,10,5,1804,1741,956,-785
2015,11,10,6,1682,1604,1021,-583
2015,11,10,7,1570,1493,1071,-422
2015,11,10,8,1497,1436,1071,-365
2015,11,10,9,1475,1422,1037,-385
2015,11,10,10,1453,1421,1006,-415
2015,11,10,11,1466,1434,1022,-412
2015,11,10,12,1510,1478,954,-524
2015,11,10,13,1626,1598,913,-685
2015,11,10,14,1829,1773,993,-780
2015,11,10,15,1979,1911,1024,-887
2015,11,10,16,1957,1898,1021,-877
2015,11,10,17,1926,1871,1035,-836
2015,11,10,18,1899,1832,1045,-787
2015,11,10,19,1864,1804,998,-806
2015,11,10,20,1828,1760,970,-790
2015,11,10,21,1792,1755,1048,-707
2015,11,10,22,1759,1701,1050,-651
2015,11,10,23,1748,1708,986,-722
2015,11,11,0,1774,1734,948,-786
2015,11,11,1,1880,1862,1132,-730
2015,11,11,2,1942,1935,1208,-727
2015,11,11,3,1924,1913,1189,-724
2015,11,11,4,1896,1859,1164,-695
2015,11,11,5,1822,1803,1171,-632
2015,11,11,6,1706,1675,1055,-620
2015,11,11,7,1607,1558,981,-577
2015,11,11,8,1550,1510,995,-515
2015,11,11,9,1497,1489,1057,-432
2015,11,11,10,1497,1498,1088,-410
2015,11,11,11,1509,1510,1104,-406
2015,11,11,12,1552,1545,1018,-527
2015,11,11,13,1664,1656,908,-748
2015,11,11,14,1864,1847,1005,-842
2015,11,11,15,2009,1960,1077,-883
2015,11,11,16,1987,1924,1020,-904
2015,11,11,17,1937,1894,1028,-866
2015,11,11,18,1877,1852,1008,-844
2015,11,11,19,1827,1804,944,-860
2015,11,11,20,1789,1765,912,-853
2015,11,11,21,1768,1726,903,-823
2015,11,11,22,1743,1681,831,-850
2015,11,11,23,1731,1713,807,-906
2015,11,12,0,1767,1756,809,-947
2015,11,12,1,1879,1871,844,-1027
2015,11,12,2,1952,1925,879,-1046
2015,11,12,3,1927,1884,832,-1052
2015,11,12,4,1891,1839,894,-945
2015,11,12,5,1823,1756,821,-935
2015,11,12,6,1702,1602,707,-895
2015,11,12,7,1604,1499,814,-685
2015,11,12,8,1514,1428,772,-656
2015,11,12,9,1470,1399,747,-652
2015,11,12,10,1448,1377,705,-672
2015,11,12,11,1466,1405,739,-666
2015,11,12,12,1514,1449,771,-678
2015,11,12,13,1630,1567,774,-793
2015,11,12,14,1832,1774,920,-854
2015,11,12,15,1984,1916,987,-929
2015,11,12,16,1967,1874,938,-936
2015,11,12,17,1928,1818,892,-926
2015,11,12,18,1886,1794,876,-918
2015,11,12,19,1840,1721,829,-892
2015,11,12,20,1806,1665,833,-832
2015,11,12,21,1774,1636,855,-781
2015,11,12,22,1747,1699,949,-750
2015,11,12,23,1741,1621,893,-728
2015,11,13,0,1782,1663,914,-749
2015,11,13,1,1901,1786,948,-838
2015,11,13,2,1972,1884,1016,-868
2015,11,13,3,1955,1873,1013,-860
2015,11,13,4,1922,1843,1052,-791
2015,11,13,5,1842,1774,989,-785
2015,11,13,6,1708,1641,828,-813
2015,11,13,7,1597,1535,899,-636
2015,11,13,8,1522,1480,839,-641
2015,11,13,9,1479,1450,813,-637
2015,11,13,10,1465,1439,814,-625
2015,11,13,11,1472,1462,828,-634
2015,11,13,12,1514,1491,842,-649
2015,11,13,13,1624,1603,954,-649
2015,11,13,14,1812,1782,1041,-741
2015,11,13,15,1947,1918,1086,-832
2015,11,13,16,1917,1887,1058,-829
2015,11,13,17,1851,1852,1019,-833
2015,11,13,18,1801,1800,991,-809
2015,11,13,19,1747,1731,943,-788
2015,11,13,20,1711,1665,886,-779
2015,11,13,21,1684,1629,839,-790
2015,11,13,22,1668,1596,812,-784
2015,11,13,23,1669,1586,819,-767
2015,11,14,0,1712,1614,847,-767
2015,11,14,1,1758,1728,946,-782
2015,11,14,2,1816,1780,953,-827
2015,11,14,3,1789,1755,956,-799
2015,11,14,4,1763,1709,942,-767
2015,11,14,5,1709,1665,923,-742
2015,11,14,6,1624,1578,883,-695
2015,11,14,7,1540,1490,965,-525
2015,11,14,8,1450,1427,957,-470
2015,11,14,9,1434,1404,960,-444
2015,11,14,10,1418,1407,1008,-399
2015,11,14,11,1420,1398,993,-405
2015,11,14,12,1448,1437,1025,-412
2015,11,14,13,1511,1495,1037,-458
2015,11,14,14,1596,1588,1069,-519
2015,11,14,15,1672,1696,1129,-567
2015,11,14,16,1709,1736,1152,-584
2015,11,14,17,1691,1722,1264,-458
2015,11,14,18,1649,1680,1234,-446
2015,11,14,19,1593,1630,1198,-432
2015,11,14,20,1543,1565,1158,-407
2015,11,14,21,1504,1522,1141,-381
2015,11,14,22,1485,1484,1085,-399
2015,11,14,23,1491,1487,1093,-394
2015,11,15,0,1533,1498,1117,-381
2015,11,15,1,1658,1618,1134,-484
2015,11,15,2,1719,1690,1195,-495
2015,11,15,3,1683,1657,1172,-485
2015,11,15,4,1644,1630,1139,-491
2015,11,15,5,1585,1588,1196,-392
2015,11,15,6,1507,1518,1058,-460
2015,11,15,7,1424,1451,1096,-355
2015,11,15,8,1363,1394,1083,-311
2015,11,15,9,1377,1360,1182,-178
2015,11,15,10,1384,1356,1158,-198
2015,11,15,11,1387,1358,1118,-240
2015,11,15,12,1404,1374,1123,-251
2015,11,15,13,1452,1425,1071,-354
2015,11,15,14,1523,1491,1074,-417
2015,11,15,15,1593,1576,1069,-507
2015,11,15,16,1630,1646,1124,-522
2015,11,15,17,1634,1649,1130,-519
2015,11,15,18,1612,1650,1156,-494
2015,11,15,19,1578,1613,1113,-500
2015,11,15,20,1556,1575,1082,-493
2015,11,15,21,1529,1552,1229,-323
2015,11,15,22,1515,1546,1220,-326
2015,11,15,23,1518,1546,1241,-305
2015,11,16,0,1562,1608,1281,-327
2015,11,16,1,1696,1742,1324,-418
2015,11,16,2,1765,1787,1298,-489
2015,11,16,3,1751,1774,1317,-457
2015,11,16,4,1731,1743,1361,-382
2015,11,16,5,1683,1680,1405,-275
2015,11,16,6,1597,1575,1390,-185
2015,11,16,7,1508,1485,1306,-179
2015,11,16,8,1439,1427,1322,-105
2015,11,16,9,1327,1411,1375,-36
2015,11,16,10,1402,1423,1390,-33
2015,11,16,11,1413,1435,1394,-41
2015,11,16,12,1452,1509,1466,-43
2015,11,16,13,1562,1625,1529,-96
2015,11,16,14,1761,1835,1559,-276
2015,11,16,15,1913,1992,1576,-416
2015,11,16,16,1946,1975,1553,-422
2015,11,16,17,1912,1929,1519,-410
2015,11,16,18,1880,2215,1534,-681
2015,11,16,19,1846,2063,1463,-600
2015,11,16,20,1806,1920,1340,-580
2015,11,16,21,1775,1865,1253,-612
2015,11,16,22,1754,1797,1197,-600
2015,11,16,23,1740,1784,1187,-597
2015,11,17,0,1770,1839,1240,-599
2015,11,17,1,1898,1986,1368,-618
2015,11,17,2,1962,2051,1513,-538
2015,11,17,3,1947,2018,1538,-480
2015,11,17,4,1917,1984,1604,-380
2015,11,17,5,1845,1880,1603,-277
2015,11,17,6,1718,1747,1537,-210
2015,11,17,7,1603,1620,1535,-85
2015,11,17,8,1455,1562,1426,-136
2015,11,17,9,1431,1531,1368,-163
2015,11,17,10,1548,1526,1351,-175
2015,11,17,11,1561,1540,1394,-146
2015,11,17,12,1605,1577,1323,-254
2015,11,17,13,1719,1681,1347,-334
2015,11,17,14,1927,1892,1374,-518
2015,11,17,15,2079,1998,1321,-677
2015,11,17,16,2060,1968,1166,-802
2015,11,17,17,2018,1924,1125,-799
2015,11,17,18,1981,1893,1117,-776
2015,11,17,19,1941,1846,1139,-707
2015,11,17,20,1896,1798,1112,-686
2015,11,17,21,1865,1816,1089,-727
2015,11,17,22,1842,1764,1056,-708
2015,11,17,23,1829,1745,1058,-687
2015,11,18,0,1864,1812,1127,-685
2015,11,18,1,2000,1938,1137,-801
2015,11,18,2,2065,1953,1196,-757
2015,11,18,3,2048,1917,1245,-672
2015,11,18,4,2014,1868,1282,-586
2015,11,18,5,1936,1771,1342,-429
2015,11,18,6,1803,1639,1237,-402
2015,11,18,7,1684,1513,1233,-280
2015,11,18,8,1423,1435,1169,-266
2015,11,18,9,1399,1390,1098,-292
2015,11,18,10,1429,1379,1219,-160
2015,11,18,11,1440,1372,1268,-104
2015,11,18,12,1482,1429,1356,-73
2015,11,18,13,1590,1533,1382,-151
2015,11,18,14,1788,1736,1420,-316
2015,11,18,15,1935,1893,1662,-231
2015,11,18,16,1924,1861,1681,-180
2015,11,18,17,1890,1792,1518,-274
2015,11,18,18,1857,1769,1476,-293
2015,11,18,19,1823,1739,1455,-284
2015,11,18,20,1786,1714,1437,-277
2015,11,18,21,1761,1699,1426,-273
2015,11,18,22,1745,1667,1504,-163
2015,11,18,23,1738,1680,1454,-226
2015,11,19,0,1776,1719,1382,-337
2015,11,19,1,1906,1872,1535,-337
2015,11,19,2,1969,1940,1430,-510
2015,11,19,3,1956,1927,1291,-636
2015,11,19,4,1926,1895,1296,-599
2015,11,19,5,1853,1821,1281,-540
2015,11,19,6,1728,1681,1186,-495
2015,11,19,7,1617,1559,1070,-489
2015,11,19,8,1453,1495,1033,-462
2015,11,19,9,1426,1475,911,-564
2015,11,19,10,1494,1466,897,-569
2015,11,19,11,1504,1473,909,-564
2015,11,19,12,1545,1500,875,-625
2015,11,19,13,1654,1610,1000,-610
2015,11,19,14,1854,1804,1117,-687
2015,11,19,15,2002,1947,1148,-799
2015,11,19,16,1985,1935,1138,-797
2015,11,19,17,1944,1927,1124,-803
2015,11,19,18,1909,1932,1135,-797
2015,11,19,19,1872,1909,1153,-756
2015,11,19,20,1831,1871,1118,-753
2015,11,19,21,1802,1857,1101,-756
2015,11,19,22,1784,1842,1086,-756
2015,11,19,23,1777,1839,1082,-757
2015,11,20,0,1814,1873,1128,-745
2015,11,20,1,1944,1956,1184,-772
2015,11,20,2,2003,1970,1197,-773
2015,11,20,3,1983,1922,1152,-770
2015,11,20,4,1948,1871,1166,-705
2015,11,20,5,1870,1778,1193,-585
2015,11,20,6,1742,1664,1258,-406
2015,11,20,7,1630,1542,1349,-193
2015,11,20,8,1430,1477,1429,-48
2015,11,20,9,1412,1467,1434,-33
2015,11,20,10,1488,1460,1423,-37
2015,11,20,11,1503,1478,1438,-40
2015,11,20,12,1549,1530,1486,-44
2015,11,20,13,1663,1647,1457,-190
2015,11,20,14,1868,1830,1594,-236
2015,11,20,15,2020,1994,1590,-404
2015,11,20,16,2007,1954,1500,-454
2015,11,20,17,1969,1905,1441,-464
2015,11,20,18,1932,1852,1336,-516
2015,11,20,19,1894,1802,1374,-428
2015,11,20,20,1851,1745,1419,-326
2015,11,20,21,1821,1708,1449,-259
2015,11,20,22,1802,1682,1416,-266
2015,11,20,23,1795,1690,1424,-266
2015,11,21,0,1834,1733,1448,-285
2015,11,21,1,1910,1892,1458,-434
2015,11,21,2,1961,1938,1385,-553
2015,11,21,3,1933,1926,1294,-632
2015,11,21,4,1902,1895,1207,-688
2015,11,21,5,1848,1868,1196,-672
2015,11,21,6,1760,1783,1132,-651
2015,11,21,7,1666,1703,1080,-623
2015,11,21,8,1459,1629,985,-644
2015,11,21,9,1430,1610,944,-666
2015,11,21,10,1626,1599,936,-663
2015,11,21,11,1635,1620,912,-708
2015,11,21,12,1669,1647,880,-767
2015,11,21,13,1746,1711,948,-763
2015,11,21,14,1864,1817,971,-846
2015,11,21,15,1976,1925,1207,-718
2015,11,21,16,2020,1974,1288,-686
2015,11,21,17,2007,1952,1270,-682
2015,11,21,18,1971,1887,1232,-655
2015,11,21,19,1922,1835,1199,-636
2015,11,21,20,1864,1764,1152,-612
2015,11,21,21,1813,1693,1019,-674
2015,11,21,22,1784,1646,961,-685
2015,11,21,23,1780,1625,934,-691
2015,11,22,0,1829,1679,970,-709
2015,11,22,1,1981,1856,1085,-771
2015,11,22,2,2057,1931,1107,-824
2015,11,22,3,2030,1928,1108,-820
2015,11,22,4,1993,1896,1100,-796
2015,11,22,5,1932,1847,1049,-798
2015,11,22,6,1843,1779,1035,-744
2015,11,22,7,1747,1699,988,-711
2015,11,22,8,1369,1652,939,-713
2015,11,22,9,1361,1624,666,-958
2015,11,22,10,1660,1623,682,-941
2015,11,22,11,1673,1637,678,-959
2015,11,22,12,1706,1659,805,-854
2015,11,22,13,1780,1716,1022,-694
2015,11,22,14,1888,1796,1116,-680
2015,11,22,15,1994,1906,1267,-639
2015,11,22,16,2044,1958,1351,-607
2015,11,22,17,2043,1923,1365,-558
2015,11,22,18,2015,1864,1308,-556
2015,11,22,19,1971,1809,1257,-552
2015,11,22,20,1935,1748,1205,-543
2015,11,22,21,1893,1701,1169,-532
2015,11,22,22,1872,1657,1135,-522
2015,11,22,23,1877,1644,1121,-523
2015,11,23,0,1941,1727,1190,-537
2015,11,23,1,2115,1892,1324,-568
2015,11,23,2,2191,1968,1384,-584
2015,11,23,3,2168,1946,1428,-518
2015,11,23,4,2129,1910,1318,-592
2015,11,23,5,2051,1845,1137,-708
2015,11,23,6,1927,1731,1064,-667
2015,11,23,7,1808,1641,1111,-530
2015,11,23,8,1364,1584,1099,-485
2015,11,23,9,1348,1572,1084,-488
2015,11,23,10,1592,1573,1081,-492
2015,11,23,11,1610,1589,1113,-476
2015,11,23,12,1661,1645,1085,-560
2015,11,23,13,1789,1778,1097,-681
2015,11,23,14,2016,1963,1202,-761
2015,11,23,15,2189,2097,1459,-638
2015,11,23,16,2228,2095,1431,-664
2015,11,23,17,2181,2057,1476,-581
2015,11,23,18,2137,1979,1440,-539
2015,11,23,19,2090,1902,1385,-517
2015,11,23,20,2040,1839,1337,-502
2015,11,23,21,2001,1786,1230,-556
2015,11,23,22,1975,1748,1198,-550
2015,11,23,23,1964,1730,1186,-544
2015,11,24,0,2008,1761,1170,-591
2015,11,24,1,2159,1915,1242,-673
2015,11,24,2,2232,1994,1334,-660
2015,11,24,3,2216,1966,1312,-654
2015,11,24,4,2181,1942,1294,-648
2015,11,24,5,2097,1870,1322,-548
2015,11,24,6,1957,1750,1261,-489
2015,11,24,7,1832,1630,1178,-452
2015,11,24,8,1448,1561,1068,-493
2015,11,24,9,1432,1526,1169,-357
2015,11,24,10,1553,1524,1184,-340
2015,11,24,11,1565,1514,1167,-347
2015,11,24,12,1608,1556,1072,-484
2015,11,24,13,1720,1668,1006,-662
2015,11,24,14,1924,1829,1134,-695
2015,11,24,15,2073,1970,1234,-736
2015,11,24,16,2056,1968,1269,-699
2015,11,24,17,2013,1965,1351,-614
2015,11,24,18,1970,1955,1309,-646
2015,11,24,19,1927,1920,1229,-691
2015,11,24,20,1882,1888,1158,-730
2015,11,24,21,1851,1839,1021,-818
2015,11,24,22,1831,1815,1002,-813
2015,11,24,23,1824,1808,1024,-784
2015,11,25,0,1866,1851,1053,-798
2015,11,25,1,2005,1954,1220,-734
2015,11,25,2,2072,1958,1258,-700
2015,11,25,3,2058,1917,1322,-595
2015,11,25,4,2026,1880,1308,-572
2015,11,25,5,1951,1804,1221,-583
2015,11,25,6,1822,1688,1075,-613
2015,11,25,7,1705,1567,1109,-458
2015,11,25,8,1445,1496,1087,-409
2015,11,25,9,1420,1471,1079,-392
2015,11,25,10,1494,1455,1153,-302
2015,11,25,11,1506,1456,1125,-331
2015,11,25,12,1551,1492,1100,-392
2015,11,25,13,1662,1581,1119,-462
2015,11,25,14,1863,1749,1141,-608
2015,11,25,15,2012,1866,1122,-744
2015,11,25,16,1998,1915,1169,-746
2015,11,25,17,1962,1953,1203,-750
2015,11,25,18,1927,1959,1235,-724
2015,11,25,19,1892,1961,1240,-721
2015,11,25,20,1853,1938,1218,-720
2015,11,25,21,1828,1925,1211,-714
2015,11,25,22,1811,1911,1177,-734
2015,11,25,23,1805,1911,1131,-780
2015,11,26,0,1844,1942,1150,-792
2015,11,26,1,1978,2039,1121,-918
2015,11,26,2,2039,2063,1110,-953
2015,11,26,3,2023,2013,1068,-945
2015,11,26,4,1989,1968,1125,-843
2015,11,26,5,1911,1897,1086,-811
2015,11,26,6,1782,1802,1093,-709
2015,11,26,7,1667,1682,1077,-605
2015,11,26,8,1457,1607,1055,-552
2015,11,26,9,1536,1560,1011,-549
2015,11,26,10,1614,1535,1034,-501
2015,11,26,11,1619,1540,1100,-440
2015,11,26,12,1660,1566,1117,-449
2015,11,26,13,1769,1625,1109,-516
2015,11,26,14,1952,1720,1165,-555
2015,11,26,15,2094,1819,1187,-632
2015,11,26,16,2114,1905,1234,-671
2015,11,26,17,2112,1936,1233,-703
2015,11,26,18,2099,1929,1229,-700
2015,11,26,19,2072,1896,1234,-662
2015,11,26,20,2041,1830,1170,-660
2015,11,26,21,2010,1736,1068,-668
2015,11,26,22,1990,1649,1049,-600
2015,11,26,23,1984,1608,1056,-552
2015,11,27,0,2024,1610,1059,-551
2015,11,27,1,2141,1711,1148,-563
2015,11,27,2,2176,1766,1191,-575
2015,11,27,3,2146,1788,1191,-597
2015,11,27,4,2100,1799,1173,-626
2015,11,27,5,2024,1783,1098,-685
2015,11,27,6,1905,1744,1069,-675
2015,11,27,7,1784,1683,1011,-672
2015,11,27,8,1546,1640,965,-675
2015,11,27,9,1587,1645,970,-675
2015,11,27,10,1638,1658,965,-693
2015,11,27,11,1639,1678,931,-747
2015,11,27,12,1674,1724,948,-776
2015,11,27,13,1765,1812,1067,-745
2015,11,27,14,1911,1916,1155,-761
2015,11,27,15,2041,2021,1195,-826
2015,11,27,16,2089,2057,1196,-861
2015,11,27,17,2098,2049,1185,-864
2015,11,27,18,2081,2021,1143,-878
2015,11,27,19,2043,1967,1121,-846
2015,11,27,20,1991,1887,1151,-736
2015,11,27,21,1933,1841,1153,-688
2015,11,27,22,1888,1783,1111,-672
2015,11,27,23,1865,1781,1095,-686
2015,11,28,0,1892,1845,1041,-804
2015,11,28,1,1930,2009,1131,-878
2015,11,28,2,1962,2080,1085,-995
2015,11,28,3,1942,2079,1073,-1006
2015,11,28,4,1924,2073,1085,-988
2015,11,28,5,1896,2026,1075,-951
2015,11,28,6,1844,1956,1047,-909
2015,11,28,7,1770,1868,1017,-851
2015,11,28,8,1592,1808,959,-849
2015,11,28,9,1655,1780,875,-905
2015,11,28,10,1775,1781,851,-930
2015,11,28,11,1778,1779,772,-1007
2015,11,28,12,1803,1818,795,-1023
2015,11,28,13,1845,1867,826,-1041
2015,11,28,14,1883,1943,930,-1013
2015,11,28,15,1958,2034,998,-1036
2015,11,28,16,2062,2107,1056,-1051
2015,11,28,17,2094,2145,1045,-1100
2015,11,28,18,2075,2125,1058,-1067
2015,11,28,19,2022,2074,1026,-1048
2015,11,28,20,1948,2014,1000,-1014
2015,11,28,21,1872,1950,966,-984
2015,11,28,22,1814,1904,940,-964
2015,11,28,23,1794,1895,933,-962
2015,11,29,0,1836,1955,961,-994
2015,11,29,1,1993,2117,953,-1164
2015,11,29,2,2059,2160,998,-1162
2015,11,29,3,2047,2158,994,-1164
2015,11,29,4,2029,2119,963,-1156
2015,11,29,5,1994,2059,922,-1137
2015,11,29,6,1939,1964,888,-1076
2015,11,29,7,1864,1873,838,-1035
2015,11,29,8,1567,1821,796,-1025
2015,11,29,9,1673,1784,922,-862
2015,11,29,10,1812,1788,931,-857
2015,11,29,11,1826,1800,948,-852
2015,11,29,12,1855,1827,968,-859
2015,11,29,13,1900,1875,930,-945
2015,11,29,14,1943,1946,928,-1018
2015,11,29,15,2015,2053,954,-1099
2015,11,29,16,2113,2127,967,-1160
2015,11,29,17,2152,2148,974,-1174
2015,11,29,18,2133,2127,928,-1199
2015,11,29,19,2078,2095,933,-1162
2015,11,29,20,2030,2066,930,-1136
2015,11,29,21,1967,2014,899,-1115
2015,11,29,22,1920,1984,900,-1084
2015,11,29,23,1913,1998,913,-1085
2015,11,30,0,1977,2071,939,-1132
2015,11,30,1,2150,2216,964,-1252
2015,11,30,2,2216,2276,1002,-1274
2015,11,30,3,2216,2248,972,-1276
2015,11,30,4,2200,2214,933,-1281
2015,11,30,5,2139,2136,846,-1290
2015,11,30,6,2033,1995,784,-1211
2015,11,30,7,1927,1879,849,-1030
2015,11,30,8,1677,1825,812,-1013
2015,11,30,9,1756,1806,858,-948
2015,11,30,10,1812,1808,860,-948
2015,11,30,11,1830,1837,934,-903
2015,11,30,12,1879,1876,952,-924
2015,11,30,13,1997,1999,924,-1075
2015,11,30,14,2197,2200,837,-1363
2015,11,30,15,2357,2351,904,-1447
2015,11,30,16,2440,2348,1002,-1346
2015,11,30,17,2408,2320,1003,-1317
2015,11,30,18,2355,2278,993,-1285
2015,11,30,19,2288,2237,1040,-1197
2015,11,30,20,2218,2190,1017,-1173
2015,11,30,21,2152,2150,993,-1157
2015,11,30,22,2103,2123,1000,-1123
2015,11,30,23,2078,2133,959,-1174
2015,12,1,0,2135,2208,943,-1265
2015,12,1,1,2294,2352,994,-1358
2015,12,1,2,2356,2401,1034,-1367
2015,12,1,3,2359,2382,1039,-1343
2015,12,1,4,2344,2341,1040,-1301
2015,12,1,5,2273,2248,1058,-1190
2015,12,1,6,2142,2103,1010,-1093
2015,12,1,7,2025,1974,1025,-949
2015,12,1,8,1900,1916,1001,-915
2015,12,1,9,1954,1904,1023,-881
2015,12,1,10,1922,1911,967,-944
2015,12,1,11,1936,1936,840,-1096
2015,12,1,12,1980,1985,798,-1187
2015,12,1,13,2084,2103,816,-1287
2015,12,1,14,2269,2305,846,-1459
2015,12,1,15,2419,2449,842,-1607
2015,12,1,16,2426,2426,830,-1596
2015,12,1,17,2393,2369,862,-1507
2015,12,1,18,2336,2299,894,-1405
2015,12,1,19,2266,2240,949,-1291
2015,12,1,20,2192,2179,993,-1186
2015,12,1,21,2128,2118,967,-1151
2015,12,1,22,2081,2079,986,-1093
2015,12,1,23,2068,2082,996,-1086
2015,12,2,0,2123,2150,946,-1204
2015,12,2,1,2293,2341,877,-1464
2015,12,2,2,2362,2402,1005,-1397
2015,12,2,3,2354,2405,1033,-1372
2015,12,2,4,2328,2374,1172,-1202
2015,12,2,5,2248,2289,1092,-1197
2015,12,2,6,2108,2141,1131,-1010
2015,12,2,7,1988,2021,1242,-779
2015,12,2,8,1938,1957,1220,-737
2015,12,2,9,1945,1936,1355,-581
2015,12,2,10,1952,1921,1374,-547
2015,12,2,11,1960,1931,1372,-559
2015,12,2,12,1996,1967,1437,-530
2015,12,2,13,2097,2072,1496,-576
2015,12,2,14,2277,2253,1531,-722
2015,12,2,15,2405,2376,1465,-911
2015,12,2,16,2376,2353,1438,-915
2015,12,2,17,2334,2249,1425,-824
2015,12,2,18,2285,2199,1433,-766
2015,12,2,19,2224,2148,1433,-715
2015,12,2,20,2149,2180,1341,-839
2015,12,2,21,2078,2148,1320,-828
2015,12,2,22,2014,2142,1282,-860
2015,12,2,23,1991,2107,1287,-820
2015,12,3,0,2051,2273,1261,-1012
2015,12,3,1,2230,2273,1173,-1100
2015,12,3,2,2308,2298,1191,-1107
2015,12,3,3,2306,2245,1199,-1046
2015,12,3,4,2279,2197,1177,-1020
2015,12,3,5,2190,2102,1240,-862
2015,12,3,6,2055,1961,1294,-667
2015,12,3,7,1931,1805,1330,-475
2015,12,3,8,1841,1733,1398,-335
2015,12,3,9,1871,1713,1457,-256
2015,12,3,10,1858,1706,1467,-239
2015,12,3,11,1865,1727,1445,-282
2015,12,3,12,1901,1782,1461,-321
2015,12,3,13,2003,1892,1337,-555
2015,12,3,14,2177,2087,1390,-697
2015,12,3,15,2297,2219,1464,-755
2015,12,3,16,2266,2187,1445,-742
2015,12,3,17,2291,2143,1427,-716
2015,12,3,18,2128,2096,1423,-673
2015,12,3,19,2056,2041,1427,-614
2015,12,3,20,1986,2015,1399,-616
2015,12,3,21,1931,1974,1373,-601
2015,12,3,22,1901,1974,1374,-600
2015,12,3,23,1905,1965,1390,-575
2015,12,4,0,1974,1999,1368,-631
2015,12,4,1,2120,2122,1389,-733
2015,12,4,2,2156,2142,1431,-711
2015,12,4,3,2128,2106,1462,-644
2015,12,4,4,2091,2054,1550,-504
2015,12,4,5,2003,1976,1548,-428
2015,12,4,6,1866,1822,1431,-391
2015,12,4,7,1742,1688,1379,-309
2015,12,4,8,1698,1612,1272,-340
2015,12,4,9,1695,1558,1179,-379
2015,12,4,10,1618,1547,1152,-395
2015,12,4,11,1628,1553,1139,-414
2015,12,4,12,1657,1585,1142,-443
2015,12,4,13,1746,1682,1147,-535
2015,12,4,14,1904,1866,1192,-674
2015,12,4,15,2021,2007,1215,-792
2015,12,4,16,1999,2011,1211,-800
2015,12,4,17,2023,1980,1205,-775
2015,12,4,18,1942,1958,1173,-785
2015,12,4,19,1916,1917,1197,-720
2015,12,4,20,1919,1851,1045,-806
2015,12,4,21,1857,1828,1028,-800
2015,12,4,22,1847,1795,1024,-771
2015,12,4,23,1855,1787,1036,-751
2015,12,5,0,1914,1854,1096,-758
2015,12,5,1,1980,1965,1185,-780
2015,12,5,2,2023,1997,1194,-803
2015,12,5,3,1997,1969,1177,-792
2015,12,5,4,1974,1947,1084,-863
2015,12,5,5,1924,1886,1115,-771
2015,12,5,6,1844,1794,1103,-691
2015,12,5,7,1748,1699,1102,-597
2015,12,5,8,1785,1626,1037,-589
2015,12,5,9,1725,1598,947,-651
2015,12,5,10,1645,1591,938,-653
2015,12,5,11,1647,1603,945,-658
2015,12,5,12,1665,1651,972,-679
2015,12,5,13,1713,1706,1023,-683
2015,12,5,14,1778,1791,1078,-713
2015,12,5,15,1853,1914,1212,-702
2015,12,5,16,1901,1962,1289,-673
2015,12,5,17,1921,1956,1314,-642
2015,12,5,18,1872,1923,1286,-637
2015,12,5,19,1822,1858,1195,-663
2015,12,5,20,1783,1797,1188,-609
2015,12,5,21,1708,1742,1257,-485
2015,12,5,22,1673,1714,1302,-412
2015,12,5,23,1674,1742,1378,-364
2015,12,6,0,1737,1820,1459,-361
2015,12,6,1,1891,1967,1582,-385
2015,12,6,2,1939,1982,1605,-377
2015,12,6,3,1913,1957,1591,-366
2015,12,6,4,1881,1926,1600,-326
2015,12,6,5,1827,1876,1567,-309
2015,12,6,6,1748,1782,1483,-299
2015,12,6,7,1655,1683,1520,-163
2015,12,6,8,1640,1602,1442,-160
2015,12,6,9,1590,1575,1453,-122
2015,12,6,10,1610,1547,1436,-111
2015,12,6,11,1618,1555,1425,-130
2015,12,6,12,1638,1562,1453,-109
2015,12,6,13,1684,1603,1474,-129
2015,12,6,14,1742,1656,1398,-258
2015,12,6,15,1818,1759,1456,-303
2015,12,6,16,1869,1822,1455,-367
2015,12,6,17,1890,1881,1463,-418
2015,12,6,18,1866,1890,1355,-535
2015,12,6,19,1833,1858,1199,-659
2015,12,6,20,1822,1816,1086,-730
2015,12,6,21,1782,1758,1023,-735
2015,12,6,22,1771,1709,979,-730
2015,12,6,23,1792,1704,984,-720
2015,12,7,0,1870,1761,1036,-725
2015,12,7,1,2025,1929,1106,-823
2015,12,7,2,2062,1970,1179,-791
2015,12,7,3,2039,1949,1261,-688
2015,12,7,4,2010,1917,1270,-647
2015,12,7,5,1940,1831,1273,-558
2015,12,7,6,1822,1706,1264,-442
2015,12,7,7,1699,1568,1136,-432
2015,12,7,8,1591,1496,1106,-390
2015,12,7,9,1568,1458,1192,-266
2015,12,7,10,1496,1460,1306,-154
2015,12,7,11,1502,1458,1282,-176
2015,12,7,12,1535,1503,1309,-194
2015,12,7,13,1637,1603,1179,-424
2015,12,7,14,1820,1798,1088,-710
2015,12,7,15,1970,1940,1072,-868
2015,12,7,16,2008,1957,1115,-842
2015,12,7,17,1994,1936,1225,-711
2015,12,7,18,1954,1935,1236,-699
2015,12,7,19,1916,1928,1239,-689
2015,12,7,20,1882,1930,1211,-719
2015,12,7,21,1837,1912,1161,-751
2015,12,7,22,1816,1897,1132,-765
2015,12,7,23,1822,1916,1113,-803
2015,12,8,0,1882,1958,1078,-880
2015,12,8,1,2020,2028,1064,-964
2015,12,8,2,2046,2050,1110,-940
2015,12,8,3,2019,1998,1071,-927
2015,12,8,4,1984,1935,1051,-884
2015,12,8,5,1901,1835,1027,-808
2015,12,8,6,1768,1690,1017,-673
2015,12,8,7,1640,1551,1118,-433
2015,12,8,8,1641,1467,1125,-342
2015,12,8,9,1606,1417,1134,-283
2015,12,8,10,1472,1408,1085,-323
2015,12,8,11,1471,1400,1021,-379
2015,12,8,12,1502,1429,956,-473
2015,12,8,13,1590,1536,1050,-486
2015,12,8,14,1752,1724,1158,-566
2015,12,8,15,1878,1851,1127,-724
2015,12,8,16,1864,1849,1098,-751
2015,12,8,17,1853,1823,1104,-719
2015,12,8,18,1832,1797,1083,-714
2015,12,8,19,1807,1761,1017,-744
2015,12,8,20,1778,1716,1003,-713
2015,12,8,21,1742,1703,990,-713
2015,12,8,22,1718,1687,976,-711
2015,12,8,23,1719,1679,944,-735
2015,12,9,0,1772,1741,961,-780
2015,12,9,1,1896,1879,1028,-851
2015,12,9,2,1916,1898,1077,-821
2015,12,9,3,1884,1864,1105,-759
2015,12,9,4,1846,1822,1088,-734
2015,12,9,5,1764,1752,1096,-656
2015,12,9,6,1638,1614,1067,-547
2015,12,9,7,1512,1485,1084,-401
2015,12,9,8,1622,1405,1102,-303
2015,12,9,9,1522,1364,1072,-292
2015,12,9,10,1404,1355,1026,-329
2015,12,9,11,1405,1344,998,-346
2015,12,9,12,1434,1386,1034,-352
2015,12,9,13,1525,1486,1105,-381
2015,12,9,14,1691,1677,1210,-467
2015,12,9,15,1812,1823,1255,-568
2015,12,9,16,1805,1827,1219,-608
2015,12,9,17,1781,1804,1182,-622
2015,12,9,18,1752,1779,1138,-641
2015,12,9,19,1736,1746,1056,-690
2015,12,9,20,1718,1720,1145,-575
2015,12,9,21,1702,1735,1254,-481
2015,12,9,22,1696,1713,1255,-458
2015,12,9,23,1712,1734,1286,-448
2015,12,10,0,1778,1782,1309,-473
2015,12,10,1,1905,1913,1318,-595
2015,12,10,2,1932,1954,1199,-755
2015,12,10,3,1912,1936,1107,-829
2015,12,10,4,1887,1911,1085,-826
2015,12,10,5,1817,1851,1056,-795
2015,12,10,6,1697,1721,968,-753
2015,12,10,7,1571,1589,900,-689
2015,12,10,8,1630,1497,937,-560
2015,12,10,9,1549,1465,1042,-423
2015,12,10,10,1484,1451,1115,-336
2015,12,10,11,1482,1458,1280,-178
2015,12,10,12,1512,1507,1333,-174
2015,12,10,13,1605,1626,1475,-151
2015,12,10,14,1787,1821,1431,-390
2015,12,10,15,1916,1952,1528,-424
2015,12,10,16,1916,1960,1509,-451
2015,12,10,17,1891,1932,1348,-584
2015,12,10,18,1864,1896,1207,-689
2015,12,10,19,1847,1738,1047,-691
2015,12,10,20,1829,1915,1127,-788
2015,12,10,21,1811,1806,969,-837
2015,12,10,22,1792,1796,936,-860
2015,12,10,23,1793,1783,988,-795
2015,12,11,0,1846,1801,1097,-704
2015,12,11,1,1980,1947,1402,-545
2015,12,11,2,2022,1990,1416,-574
2015,12,11,3,2008,1970,1422,-548
2015,12,11,4,1989,1949,1372,-577
2015,12,11,5,1919,1881,1322,-559
2015,12,11,6,1794,1753,1123,-630
2015,12,11,7,1666,1625,1003,-622
2015,12,11,8,1622,1542,952,-590
2015,12,11,9,1571,1501,933,-568
2015,12,11,10,1540,1490,914,-576
2015,12,11,11,1543,1492,915,-577
2015,12,11,12,1584,1526,902,-624
2015,12,11,13,1692,1633,992,-641
2015,12,11,14,1892,1816,1079,-737
2015,12,11,15,2051,1972,1167,-805
2015,12,11,16,2066,1980,1179,-801
2015,12,11,17,2045,1962,1188,-774
2015,12,11,18,2012,1932,1129,-803
2015,12,11,19,1972,1860,1088,-772
2015,12,11,20,1932,1799,1075,-724
2015,12,11,21,1908,1765,1049,-716
2015,12,11,22,1880,1738,1075,-663
2015,12,11,23,1870,1735,1108,-627
2015,12,12,0,1912,1783,1093,-690
2015,12,12,1,1981,1937,1140,-797
2015,12,12,2,2017,1982,1131,-851
2015,12,12,3,1988,1949,1147,-802
2015,12,12,4,1969,1907,1141,-766
2015,12,12,5,1919,1870,1132,-738
2015,12,12,6,1830,1769,1090,-679
2015,12,12,7,1718,1644,1051,-593
2015,12,12,8,1632,1568,1062,-506
2015,12,12,9,1601,1519,1012,-507
2015,12,12,10,1543,1503,992,-511
2015,12,12,11,1552,1508,975,-533
2015,12,12,12,1582,1540,985,-555
2015,12,12,13,1646,1590,1040,-550
2015,12,12,14,1740,1677,1069,-608
2015,12,12,15,1842,1779,1102,-677
2015,12,12,16,1917,1862,1154,-708
2015,12,12,17,1926,1890,1144,-746
2015,12,12,18,1899,1873,1121,-752
2015,12,12,19,1839,1842,1109,-733
2015,12,12,20,1766,1804,1051,-753
2015,12,12,21,1719,1790,1009,-781
2015,12,12,22,1684,1770,1029,-741
2015,12,12,23,1681,1795,1090,-705
2015,12,13,0,1736,1849,1177,-672
2015,12,13,1,1893,1977,1199,-778
2015,12,13,2,1932,1966,1197,-769
2015,12,13,3,1907,1939,1171,-768
2015,12,13,4,1879,1924,1155,-769
2015,12,13,5,1823,1863,1194,-669
2015,12,13,6,1737,1774,1258,-516
2015,12,13,7,1629,1664,1301,-363
2015,12,13,8,1549,1579,1232,-347
2015,12,13,9,1495,1525,1249,-276
2015,12,13,10,1544,1506,1224,-282
2015,12,13,11,1547,1494,1168,-326
2015,12,13,12,1566,1511,1180,-331
2015,12,13,13,1615,1546,1205,-341
2015,12,13,14,1688,1621,1260,-361
2015,12,13,15,1776,1722,1328,-394
2015,12,13,16,1855,1794,1404,-390
2015,12,13,17,1882,1827,1401,-426
2015,12,13,18,1878,1848,1377,-471
2015,12,13,19,1844,1844,1396,-448
2015,12,13,20,1816,1824,1426,-398
2015,12,13,21,1792,1804,1412,-392
2015,12,13,22,1778,1782,1434,-348
2015,12,13,23,1787,1828,1466,-362
2015,12,14,0,1855,1894,1496,-398
2015,12,14,1,2016,2030,1442,-588
2015,12,14,2,2043,2051,1437,-614
2015,12,14,3,2024,2028,1536,-492
2015,12,14,4,1997,2001,1509,-492
2015,12,14,5,1936,1921,1489,-432
2015,12,14,6,1818,1766,1468,-298
2015,12,14,7,1695,1652,1436,-216
2015,12,14,8,1529,1581,1453,-128
2015,12,14,9,1539,1557,1458,-99
2015,12,14,10,1572,1559,1439,-120
2015,12,14,11,1586,1559,1398,-161
2015,12,14,12,1637,1620,1392,-228
2015,12,14,13,1759,1735,1411,-324
2015,12,14,14,1979,1946,1443,-503
2015,12,14,15,2155,2104,1527,-577
2015,12,14,16,2214,2102,1545,-557
2015,12,14,17,2209,2094,1558,-536
2015,12,14,18,2183,2070,1546,-524
2015,12,14,19,2149,2046,1562,-484
2015,12,14,20,2104,1998,1520,-478
2015,12,14,21,2070,1955,1540,-415
2015,12,14,22,2050,1934,1544,-390
2015,12,14,23,2050,1942,1544,-398
2015,12,15,0,2103,1999,1559,-440
2015,12,15,1,2242,2145,1638,-507
2015,12,15,2,2273,2219,1673,-546
2015,12,15,3,2254,2177,1606,-571
2015,12,15,4,2225,2132,1598,-534
2015,12,15,5,2143,2052,1594,-458
2015,12,15,6,1996,1912,1570,-342
2015,12,15,7,1854,1764,1548,-216
2015,12,15,8,1699,1693,1550,-143
2015,12,15,9,1690,1654,1546,-108
2015,12,15,10,1678,1639,1539,-100
2015,12,15,11,1686,1647,1556,-91
2015,12,15,12,1731,1697,1553,-144
2015,12,15,13,1844,1800,1562,-238
2015,12,15,14,2047,2014,1597,-417
2015,12,15,15,2203,2174,1607,-567
2015,12,15,16,2210,2146,1576,-570
2015,12,15,17,2196,2083,1529,-554
2015,12,15,18,2169,2023,1490,-533
2015,12,15,19,2131,1975,1498,-477
2015,12,15,20,2076,1919,1426,-493
2015,12,15,21,2030,1877,1441,-436
2015,12,15,22,2003,1853,1498,-355
2015,12,15,23,2000,1870,1602,-268
2015,12,16,0,2055,1943,1603,-340
2015,12,16,1,2217,2139,1651,-488
2015,12,16,2,2266,2201,1639,-562
2015,12,16,3,2243,2183,1634,-549
2015,12,16,4,2208,2168,1639,-529
2015,12,16,5,2125,2094,1626,-468
2015,12,16,6,1979,1950,1552,-398
2015,12,16,7,1839,1809,1540,-269
2015,12,16,8,1751,1728,1524,-204
2015,12,16,9,1715,1686,1481,-205
2015,12,16,10,1713,1672,1484,-188
2015,12,16,11,1720,1684,1478,-206
2015,12,16,12,1763,1714,1459,-255
2015,12,16,13,1875,1829,1451,-378
2015,12,16,14,2079,2022,1401,-621
2015,12,16,15,2233,2180,1405,-775
2015,12,16,16,2224,2170,1352,-818
2015,12,16,17,2181,2143,1312,-831
2015,12,16,18,2132,2108,1278,-830
2015,12,16,19,2081,2054,1195,-859
2015,12,16,20,2024,2017,1176,-841
2015,12,16,21,1977,1963,1132,-831
2015,12,16,22,1953,1994,1181,-813
2015,12,16,23,1958,1998,1253,-745
2015,12,17,0,2024,2066,1486,-580
2015,12,17,1,2196,2205,1626,-579
2015,12,17,2,2249,2237,1626,-611
2015,12,17,3,2224,2234,1663,-571
2015,12,17,4,2190,2186,1587,-599
2015,12,17,5,2105,2115,1516,-599
2015,12,17,6,1959,1984,1474,-510
2015,12,17,7,1823,1851,1388,-463
2015,12,17,8,1722,1785,1325,-460
2015,12,17,9,1736,1743,1241,-502
2015,12,17,10,1761,1739,1186,-553
2015,12,17,11,1769,1749,1104,-645
2015,12,17,12,1814,1796,1045,-751
2015,12,17,13,1929,1909,1154,-755
2015,12,17,14,2142,2109,1334,-775
2015,12,17,15,2298,2259,1482,-777
2015,12,17,16,2288,2247,1555,-692
2015,12,17,17,2244,2202,1473,-729
2015,12,17,18,2202,2177,1471,-706
2015,12,17,19,2156,2178,1462,-716
2015,12,17,20,2109,2135,1428,-707
2015,12,17,21,2073,2116,1461,-655
2015,12,17,22,2057,2104,1485,-619
2015,12,17,23,2059,2119,1543,-576
2015,12,18,0,2122,2169,1596,-573
2015,12,18,1,2276,2297,1620,-677
2015,12,18,2,2317,2331,1649,-682
2015,12,18,3,2284,2271,1595,-676
2015,12,18,4,2237,2218,1545,-673
2015,12,18,5,2147,2128,1499,-629
2015,12,18,6,1993,1969,1437,-532
2015,12,18,7,1850,1835,1393,-442
2015,12,18,8,1704,1740,1368,-372
2015,12,18,9,1669,1705,1355,-350
2015,12,18,10,1707,1673,1414,-259
2015,12,18,11,1708,1656,1386,-270
2015,12,18,12,1742,1688,1370,-318
2015,12,18,13,1846,1790,1436,-354
2015,12,18,14,2047,1961,1472,-489
2015,12,18,15,2188,2097,1502,-595
2015,12,18,16,2182,2094,1462,-632
2015,12,18,17,2142,2071,1464,-607
2015,12,18,18,2108,2035,1423,-612
2015,12,18,19,2070,1984,1439,-545
2015,12,18,20,2032,1941,1421,-520
2015,12,18,21,2009,1921,1384,-537
2015,12,18,22,1987,1905,1344,-561
2015,12,18,23,2003,1909,1334,-575
2015,12,19,0,2073,1977,1365,-612
2015,12,19,1,2137,2084,1415,-669
2015,12,19,2,2157,2091,1499,-592
2015,12,19,3,2109,2039,1494,-545
2015,12,19,4,2066,2001,1484,-517
2015,12,19,5,2003,1931,1459,-472
2015,12,19,6,1902,1826,1417,-409
2015,12,19,7,1793,1713,1414,-299
2015,12,19,8,1664,1625,1371,-254
2015,12,19,9,1630,1565,1345,-220
2015,12,19,10,1604,1548,1313,-235
2015,12,19,11,1594,1536,1350,-186
2015,12,19,12,1618,1552,1312,-240
2015,12,19,13,1666,1602,1278,-324
2015,12,19,14,1742,1688,1280,-408
2015,12,19,15,1827,1782,1227,-555
2015,12,19,16,1897,1886,1219,-667
2015,12,19,17,1904,1911,1210,-701
2015,12,19,18,1891,1921,1168,-753
2015,12,19,19,1855,1881,1184,-697
2015,12,19,20,1816,1847,1149,-698
2015,12,19,21,1795,1810,1106,-704
2015,12,19,22,1775,1792,1111,-681
2015,12,19,23,1798,1787,1086,-701
2015,12,20,0,1872,1832,1064,-768
2015,12,20,1,2019,1961,1096,-865
2015,12,20,2,2049,1979,1141,-838
2015,12,20,3,2025,1943,1119,-824
2015,12,20,4,2000,1906,1094,-812
2015,12,20,5,1948,1869,1138,-731
2015,12,20,6,1863,1785,1141,-644
2015,12,20,7,1762,1671,1150,-521
2015,12,20,8,1715,1593,1148,-445
2015,12,20,9,1638,1551,1103,-448
2015,12,20,10,1594,1538,1164,-374
2015,12,20,11,1594,1532,1159,-373
2015,12,20,12,1618,1553,1175,-378
2015,12,20,13,1671,1615,1190,-425
2015,12,20,14,1738,1694,1185,-509
2015,12,20,15,1821,1809,1212,-597
2015,12,20,16,1910,1914,1221,-693
2015,12,20,17,1944,1948,1198,-750
2015,12,20,18,1947,1945,1214,-731
2015,12,20,19,1917,1857,1214,-643
2015,12,20,20,1888,1809,1158,-651
2015,12,20,21,1857,1766,1123,-643
2015,12,20,22,1841,1762,1107,-655
2015,12,20,23,1848,1819,1118,-701
2015,12,21,0,1918,1909,1144,-765
2015,12,21,1,2062,2047,1197,-850
2015,12,21,2,2088,2084,1175,-909
2015,12,21,3,2049,2042,1144,-898
2015,12,21,4,2008,1999,1139,-860
2015,12,21,5,1926,1933,1153,-780
2015,12,21,6,1793,1818,1184,-634
2015,12,21,7,1667,1701,1193,-508
2015,12,21,8,1626,1620,1129,-491
2015,12,21,9,1578,1581,1120,-461
2015,12,21,10,1600,1575,1123,-452
2015,12,21,11,1604,1583,1123,-460
2015,12,21,12,1648,1624,1196,-428
2015,12,21,13,1765,1716,1260,-456
2015,12,21,14,1976,1871,1333,-538
2015,12,21,15,2132,2011,1394,-617
2015,12,21,16,2171,2067,1407,-660
2015,12,21,17,2147,2092,1437,-655
2015,12,21,18,2113,2121,1492,-629
2015,12,21,19,2064,2122,1453,-669
2015,12,21,20,2026,2116,1440,-676
2015,12,21,21,2005,2100,1396,-704
2015,12,21,22,1990,2005,1349,-656
2015,12,21,23,1999,1985,1293,-692
2015,12,22,0,2048,1982,1284,-698
2015,12,22,1,2174,2058,1350,-708
2015,12,22,2,2199,2097,1495,-602
2015,12,22,3,2162,2093,1551,-542
2015,12,22,4,2124,2032,1523,-509
2015,12,22,5,2048,1950,1551,-399
2015,12,22,6,1917,1813,1440,-373
2015,12,22,7,1784,1696,1455,-241
2015,12,22,8,1666,1613,1402,-211
2015,12,22,9,1648,1556,1323,-233
2015,12,22,10,1602,1544,1328,-216
2015,12,22,11,1611,1539,1273,-266
2015,12,22,12,1655,1582,1305,-277
2015,12,22,13,1764,1678,1294,-384
2015,12,22,14,1948,1834,1164,-670
2015,12,22,15,2095,1954,1135,-819
2015,12,22,16,2123,2027,1173,-854
2015,12,22,17,2126,2026,1191,-835
2015,12,22,18,2111,2015,1200,-815
2015,12,22,19,2079,1978,1213,-765
2015,12,22,20,2051,1930,1237,-693
2015,12,22,21,2024,1920,1255,-665
2015,12,22,22,1976,1895,1307,-588
2015,12,22,23,1980,1895,1341,-554
2015,12,23,0,2025,1943,1363,-580
2015,12,23,1,2162,2067,1425,-642
2015,12,23,2,2208,2113,1404,-709
2015,12,23,3,2194,2089,1371,-718
2015,12,23,4,2145,2048,1346,-702
2015,12,23,5,2062,1983,1295,-688
2015,12,23,6,1924,1881,1230,-651
2015,12,23,7,1789,1754,1180,-574
2015,12,23,8,1751,1699,1118,-581
2015,12,23,9,1682,1651,1059,-592
2015,12,23,10,1657,1635,1080,-555
2015,12,23,11,1658,1634,1106,-528
2015,12,23,12,1701,1657,1279,-378
2015,12,23,13,1814,1747,1380,-367
2015,12,23,14,1990,1890,1420,-470
2015,12,23,15,2136,2021,1476,-545
2015,12,23,16,2174,2074,1482,-592
2015,12,23,17,2175,2068,1472,-596
2015,12,23,18,2156,2021,1403,-618
2015,12,23,19,2119,1983,1396,-587
2015,12,23,20,2084,1913,1362,-551
2015,12,23,21,2058,1915,1385,-530
2015,12,23,22,2020,1901,1446,-455
2015,12,23,23,2024,1905,1371,-534
2015,12,24,0,2072,1937,1340,-597
2015,12,24,1,2204,2081,1364,-717
2015,12,24,2,2253,2124,1400,-724
2015,12,24,3,2237,2085,1366,-719
2015,12,24,4,2193,2045,1367,-678
2015,12,24,5,2115,1992,1286,-706
2015,12,24,6,1985,1879,1206,-673
2015,12,24,7,1845,1756,1160,-596
2015,12,24,8,1747,1669,1083,-586
2015,12,24,9,1699,1612,998,-614
2015,12,24,10,1653,1596,959,-637
2015,12,24,11,1654,1591,939,-652
2015,12,24,12,1680,1630,963,-667
2015,12,24,13,1776,1709,1042,-667
2015,12,24,14,1927,1834,1152,-682
2015,12,24,15,2051,1949,1193,-756
2015,12,24,16,2096,2025,1225,-800
2015,12,24,17,2087,2055,1272,-783
2015,12,24,18,2061,2076,1315,-761
2015,12,24,19,2021,2041,1347,-694
2015,12,24,20,1986,1994,1328,-666
2015,12,24,21,1971,1932,1301,-631
2015,12,24,22,1949,1892,1278,-614
2015,12,24,23,1954,1866,1259,-607
2015,12,25,0,2003,1898,1244,-654
2015,12,25,1,2137,2010,1305,-705
2015,12,25,2,2192,2016,1327,-689
2015,12,25,3,2170,1972,1306,-666
2015,12,25,4,2128,1948,1292,-656
2015,12,25,5,2062,1918,1218,-700
2015,12,25,6,1946,1860,1150,-710
2015,12,25,7,1822,1786,1125,-661
2015,12,25,8,1786,1713,1068,-645
2015,12,25,9,1697,1676,1029,-647
2015,12,25,10,1692,1663,1005,-658
2015,12,25,11,1697,1665,1018,-647
2015,12,25,12,1732,1698,1010,-688
2015,12,25,13,1825,1756,1084,-672
2015,12,25,14,1970,1843,1062,-781
2015,12,25,15,2096,1952,1192,-760
2015,12,25,16,2154,2009,1255,-754
2015,12,25,17,2162,2046,1238,-808
2015,12,25,18,2146,2015,1247,-768
2015,12,25,19,2104,1983,1243,-740
2015,12,25,20,2058,1936,1253,-683
2015,12,25,21,2020,1878,1190,-688
2015,12,25,22,1982,1849,1100,-749
2015,12,25,23,1974,1833,1068,-765
2015,12,26,0,2014,1868,1075,-793
2015,12,26,1,2085,1988,1098,-890
2015,12,26,2,2109,2045,1146,-899
2015,12,26,3,2067,2049,1119,-930
2015,12,26,4,2041,2043,1126,-917
2015,12,26,5,2008,2024,1187,-837
2015,12,26,6,1956,1943,1123,-820
2015,12,26,7,1873,1855,961,-894
2015,12,26,8,1797,1793,913,-880
2015,12,26,9,1702,1795,908,-887
2015,12,26,10,1766,1782,915,-867
2015,12,26,11,1768,1786,920,-866
2015,12,26,12,1789,1821,936,-885
2015,12,26,13,1824,1886,982,-904
2015,12,26,14,1857,1973,1041,-932
2015,12,26,15,1937,2075,1053,-1022
2015,12,26,16,2070,2148,1067,-1081
2015,12,26,17,2122,2193,1087,-1106
2015,12,26,18,2113,2184,1079,-1105
2015,12,26,19,2063,2129,1056,-1073
2015,12,26,20,2003,2065,1023,-1042
2015,12,26,21,1944,2012,971,-1041
2015,12,26,22,1906,1972,948,-1024
2015,12,26,23,1900,1976,971,-1005
2015,12,27,0,1946,2036,1069,-967
2015,12,27,1,2106,2209,1154,-1055
2015,12,27,2,2150,2282,1179,-1103
2015,12,27,3,2127,2277,1184,-1093
2015,12,27,4,2103,2261,1212,-1049
2015,12,27,5,2071,2208,1156,-1052
2015,12,27,6,2010,2109,1087,-1022
2015,12,27,7,1925,2018,1157,-861
2015,12,27,8,1720,1940,1094,-846
2015,12,27,9,1774,1920,1060,-860
2015,12,27,10,1904,1907,1081,-826
2015,12,27,11,1904,1921,1106,-815
2015,12,27,12,1924,1948,1128,-820
2015,12,27,13,1965,1985,1192,-793
2015,12,27,14,2014,2063,1291,-772
2015,12,27,15,2097,2180,1283,-897
2015,12,27,16,2217,2248,1350,-898
2015,12,27,17,2273,2271,1379,-892
2015,12,27,18,2274,2278,1470,-808
2015,12,27,19,2216,2243,1516,-727
2015,12,27,20,2171,2226,1543,-683
2015,12,27,21,2111,2174,1502,-672
2015,12,27,22,2079,2148,1520,-628
2015,12,27,23,2086,2141,1530,-611
2015,12,28,0,2153,2189,1582,-607
2015,12,28,1,2314,2322,1590,-732
2015,12,28,2,2366,2372,1504,-868
2015,12,28,3,2345,2336,1388,-948
2015,12,28,4,2313,2299,1442,-857
2015,12,28,5,2244,2220,1383,-837
2015,12,28,6,2120,2081,1196,-885
2015,12,28,7,2001,1973,1084,-889
2015,12,28,8,1745,1896,1037,-859
2015,12,28,9,1723,1860,1051,-809
2015,12,28,10,1717,1859,1053,-806
2015,12,28,11,1726,1864,1013,-851
2015,12,28,12,1767,1888,1013,-875
2015,12,28,13,1869,1975,1043,-932
2015,12,28,14,2036,2110,1160,-950
2015,12,28,15,2172,2235,1130,-1105
2015,12,28,16,2228,2284,1131,-1153
2015,12,28,17,2234,2294,1184,-1110
2015,12,28,18,2209,2272,1217,-1055
2015,12,28,19,2161,2209,1176,-1033
2015,12,28,20,2110,2136,1116,-1020
2015,12,28,21,2059,2102,1084,-1018
2015,12,28,22,2022,2091,1071,-1020
2015,12,28,23,2008,2094,1156,-938
2015,12,29,0,2050,2169,1138,-1031
2015,12,29,1,2218,2300,1181,-1119
2015,12,29,2,2278,2351,1217,-1134
2015,12,29,3,2264,2311,1168,-1143
2015,12,29,4,2241,2270,1128,-1142
2015,12,29,5,2178,2183,1066,-1117
2015,12,29,6,2061,2060,965,-1095
2015,12,29,7,1944,1946,939,-1007
2015,12,29,8,1836,1881,953,-928
2015,12,29,9,1909,1845,953,-892
2015,12,29,10,1865,1850,960,-890
2015,12,29,11,1870,1858,957,-901
2015,12,29,12,1908,1892,1020,-872
2015,12,29,13,1998,1984,1131,-853
2015,12,29,14,2149,2129,1215,-914
2015,12,29,15,2276,2233,1243,-990
2015,12,29,16,2306,2287,1286,-1001
2015,12,29,17,2298,2290,1380,-910
2015,12,29,18,2262,2271,1387,-884
2015,12,29,19,2204,2223,1349,-874
2015,12,29,20,2140,2173,1308,-865
2015,12,29,21,2089,2135,1275,-860
2015,12,29,22,2057,2108,1315,-793
2015,12,29,23,2046,2107,1340,-767
2015,12,30,0,2090,2154,1295,-859
2015,12,30,1,2244,2276,1299,-977
2015,12,30,2,2316,2311,1319,-992
2015,12,30,3,2295,2266,1287,-979
2015,12,30,4,2260,2214,1239,-975
2015,12,30,5,2188,2134,1178,-956
2015,12,30,6,2072,1988,1113,-875
2015,12,30,7,1959,1873,1038,-835
2015,12,30,8,1934,1780,948,-832
2015,12,30,9,1879,1758,961,-797
2015,12,30,10,1805,1741,967,-774
2015,12,30,11,1812,1754,986,-768
2015,12,30,12,1846,1791,1001,-790
2015,12,30,13,1933,1887,1052,-835
2015,12,30,14,2070,2027,1160,-867
2015,12,30,15,2191,2162,1315,-847
2015,12,30,16,2231,2229,1376,-853
2015,12,30,17,2236,2217,1359,-858
2015,12,30,18,2212,2190,1341,-849
2015,12,30,19,2157,2108,1213,-895
2015,12,30,20,2099,2075,1156,-919
2015,12,30,21,2057,2047,1149,-898
2015,12,30,22,2032,2033,1119,-914
2015,12,30,23,2023,2042,1135,-907
2015,12,31,0,2071,2096,1196,-900
2015,12,31,1,2221,2236,1322,-914
2015,12,31,2,2288,2289,1369,-920
2015,12,31,3,2266,2256,1352,-904
2015,12,31,4,2234,2229,1321,-908
2015,12,31,5,2163,2154,1239,-915
2015,12,31,6,2049,2030,1130,-900
2015,12,31,7,1935,1921,1031,-890
2015,12,31,8,1968,1844,954,-890
2015,12,31,9,1916,1811,930,-881
2015,12,31,10,1853,1804,946,-858
2015,12,31,11,1862,1807,951,-856
2015,12,31,12,1903,1847,989,-858
2015,12,31,13,1998,1949,1076,-873
2015,12,31,14,2148,2074,1161,-913
2015,12,31,15,2275,2201,1257,-944
2015,12,31,16,2328,2272,1332,-940
2015,12,31,17,2323,2286,1377,-909
2015,12,31,18,2287,2242,1335,-907
2015,12,31,19,2222,2188,1289,-899
2015,12,31,20,2160,2114,1213,-901
2015,12,31,21,2120,2058,1159,-899
2015,12,31,22,2091,2001,1096,-905
2015,12,31,23,2084,2014,1096,-918
2016,1,1,0,2131,2063,1153,-910
2016,1,1,1,2285,2248,1334,-914
2016,1,1,2,2365,2328,1406,-922
2016,1,1,3,2353,2289,1394,-895
2016,1,1,4,2321,2249,1346,-903
2016,1,1,5,2251,2203,1291,-912
2016,1,1,6,2131,2130,1224,-906
2016,1,1,7,2013,2073,1166,-907
2016,1,1,8,1993,2040,1137,-903
2016,1,1,9,1950,2021,1046,-975
2016,1,1,10,2017,2007,1027,-980
2016,1,1,11,2029,2004,1025,-979
2016,1,1,12,2073,2041,1068,-973
2016,1,1,13,2169,2087,1101,-986
2016,1,1,14,2324,2163,1158,-1005
2016,1,1,15,2461,2243,1241,-1002
2016,1,1,16,2526,2282,1287,-995
2016,1,1,17,2521,2292,1298,-994
2016,1,1,18,2470,2266,1279,-987
2016,1,1,19,2390,2194,1230,-964
2016,1,1,20,2310,2138,1173,-965
2016,1,1,21,2242,2053,1113,-940
2016,1,1,22,2194,2004,1158,-846
2016,1,1,23,2174,1984,1135,-849
2016,1,2,0,2230,2046,1177,-869
2016,1,2,1,2330,2227,1320,-907
2016,1,2,2,2403,2339,1404,-935
2016,1,2,3,2384,2329,1414,-915
2016,1,2,4,2362,2321,1411,-910
2016,1,2,5,2322,2269,1405,-864
2016,1,2,6,2260,2184,1348,-836
2016,1,2,7,2182,2085,1213,-872
2016,1,2,8,1986,2043,1142,-901
2016,1,2,9,1964,2030,1065,-965
2016,1,2,10,2021,2034,1070,-964
2016,1,2,11,2029,2049,1054,-995
2016,1,2,12,2045,2077,1102,-975
2016,1,2,13,2069,2140,1148,-992
2016,1,2,14,2088,2212,1220,-992
2016,1,2,15,2190,2318,1345,-973
2016,1,2,16,2386,2374,1427,-947
2016,1,2,17,2353,2390,1465,-925
2016,1,2,18,2271,2344,1416,-928
2016,1,2,19,2193,2266,1410,-856
2016,1,2,20,2108,2173,1342,-831
2016,1,2,21,2029,2111,1425,-686
2016,1,2,22,1973,2077,1425,-652
2016,1,2,23,1958,2067,1528,-539
2016,1,3,0,2018,2124,1546,-578
2016,1,3,1,2229,2289,1610,-679
2016,1,3,2,2314,2355,1545,-810
2016,1,3,3,2295,2333,1683,-650
2016,1,3,4,2273,2297,1658,-639
2016,1,3,5,2226,2226,1621,-605
2016,1,3,6,2152,2119,1593,-526
2016,1,3,7,2066,2004,1604,-400
2016,1,3,8,1896,1926,1500,-426
2016,1,3,9,1890,1885,1493,-392
2016,1,3,10,1917,1867,1484,-383
2016,1,3,11,1916,1851,1475,-376
2016,1,3,12,1930,1869,1476,-393
2016,1,3,13,1951,1906,1541,-365
2016,1,3,14,1972,1958,1533,-425
2016,1,3,15,2059,2042,1553,-489
2016,1,3,16,2205,2098,1584,-514
2016,1,3,17,2187,2123,1629,-494
2016,1,3,18,2139,2118,1708,-410
2016,1,3,19,2065,2072,1705,-367
2016,1,3,20,2002,2026,1677,-349
2016,1,3,21,1930,1975,1639,-336
2016,1,3,22,1892,1959,1644,-315
2016,1,3,23,1895,1950,1673,-277
2016,1,4,0,1972,2009,1700,-309
2016,1,4,1,2162,2157,1700,-457
2016,1,4,2,2239,2198,1673,-525
2016,1,4,3,2216,2174,1652,-522
2016,1,4,4,2172,2129,1674,-455
2016,1,4,5,2093,2033,1683,-350
2016,1,4,6,1977,1892,1581,-311
2016,1,4,7,1875,1769,1545,-224
2016,1,4,8,1776,1711,1600,-111
2016,1,4,9,1741,1673,1581,-92
2016,1,4,10,1729,1682,1577,-105
2016,1,4,11,1742,1688,1506,-182
2016,1,4,12,1785,1740,1527,-213
2016,1,4,13,1867,1846,1538,-308
2016,1,4,14,2013,2037,1696,-341
2016,1,4,15,2143,2184,1851,-333
2016,1,4,16,2216,2173,1847,-326
2016,1,4,17,2163,2141,1840,-301
2016,1,4,18,2100,2125,1817,-308
2016,1,4,19,2039,2068,1799,-269
2016,1,4,20,1980,2003,1767,-236
2016,1,4,21,1931,1956,1722,-234
2016,1,4,22,1896,1930,1678,-252
2016,1,4,23,1887,1923,1648,-275
2016,1,5,0,1936,1967,1681,-286
2016,1,5,1,2099,2106,1622,-484
2016,1,5,2,2171,2173,1686,-487
2016,1,5,3,2144,2138,1730,-408
2016,1,5,4,2100,2086,1732,-354
2016,1,5,5,2018,1997,1661,-336
2016,1,5,6,1892,1847,1683,-164
2016,1,5,7,1778,1716,1595,-121
2016,1,5,8,1779,1648,1555,-93
2016,1,5,9,1740,1616,1623,7
2016,1,5,10,1658,1605,1602,-3
2016,1,5,11,1661,1600,1626,26
2016,1,5,12,1690,1632,1547,-85
2016,1,5,13,1762,1752,1590,-162
2016,1,5,14,1894,1934,1633,-301
2016,1,5,15,2013,2095,1719,-376
2016,1,5,16,2056,2079,1752,-327
2016,1,5,17,2024,2050,1744,-306
2016,1,5,18,1981,2006,1695,-311
2016,1,5,19,1932,1954,1675,-279
2016,1,5,20,1880,1899,1639,-260
2016,1,5,21,1844,1863,1739,-124
2016,1,5,22,1817,1853,1760,-93
2016,1,5,23,1813,1852,1758,-94
2016,1,6,0,1870,1911,1685,-226
2016,1,6,1,2017,2016,1703,-313
2016,1,6,2,2092,2081,1756,-325
2016,1,6,3,2067,2046,1696,-350
2016,1,6,4,2020,2005,1715,-290
2016,1,6,5,1936,1908,1580,-328
2016,1,6,6,1812,1765,1602,-163
2016,1,6,7,1700,1637,1488,-149
2016,1,6,8,1742,1563,1414,-149
2016,1,6,9,1671,1523,1391,-132
2016,1,6,10,1569,1515,1325,-190
2016,1,6,11,1571,1517,1309,-208
2016,1,6,12,1606,1555,1348,-207
2016,1,6,13,1694,1667,1363,-304
2016,1,6,14,1844,1854,1376,-478
2016,1,6,15,1964,1992,1401,-591
2016,1,6,16,1988,2007,1418,-589
2016,1,6,17,1951,1728,1044,-684
2016,1,6,18,1920,2343,1826,-517
2016,1,6,19,1877,1912,1439,-473
2016,1,6,20,1832,1892,1497,-362
2016,1,6,21,1804,1816,1450,-366
2016,1,6,22,1784,1799,1385,-414
2016,1,6,23,1788,1796,1339,-457
2016,1,7,0,1844,1857,1335,-522
2016,1,7,1,1985,1969,1376,-593
2016,1,7,2,2058,2023,1356,-667
2016,1,7,3,2038,1994,1318,-676
2016,1,7,4,2000,1952,1354,-598
2016,1,7,5,1917,1870,1364,-506
2016,1,7,6,1792,1728,1299,-429
2016,1,7,7,1676,1606,1208,-398
2016,1,7,8,1734,1536,1127,-409
2016,1,7,9,1659,1504,1116,-388
2016,1,7,10,1559,1511,1109,-402
2016,1,7,11,1564,1504,1065,-439
2016,1,7,12,1600,1546,1099,-447
2016,1,7,13,1690,1661,1121,-540
2016,1,7,14,1860,1851,1183,-668
2016,1,7,15,1988,2001,1216,-785
2016,1,7,16,2005,2008,1263,-745
2016,1,7,17,1974,1990,1357,-633
2016,1,7,18,1952,1965,1393,-572
2016,1,7,19,1918,1956,1381,-575
2016,1,7,20,1877,1923,1296,-627
2016,1,7,21,1839,1896,1238,-658
2016,1,7,22,1818,1889,1212,-677
2016,1,7,23,1820,1874,1217,-657
2016,1,8,0,1873,1915,1282,-633
2016,1,8,1,1997,2011,1375,-636
2016,1,8,2,2056,2073,1442,-631
2016,1,8,3,2027,2038,1440,-598
2016,1,8,4,1986,1998,1414,-584
2016,1,8,5,1907,1914,1431,-483
2016,1,8,6,1781,1779,1315,-464
2016,1,8,7,1664,1664,1247,-417
2016,1,8,8,1700,1584,1184,-400
2016,1,8,9,1624,1565,1181,-384
2016,1,8,10,1593,1566,1182,-384
2016,1,8,11,1599,1581,1177,-404
2016,1,8,12,1640,1624,1272,-352
2016,1,8,13,1746,1743,1328,-415
2016,1,8,14,1939,1931,1373,-558
2016,1,8,15,2080,2084,1404,-680
2016,1,8,16,2098,2105,1430,-675
2016,1,8,17,2069,2082,1405,-677
2016,1,8,18,2041,2034,1442,-592
2016,1,8,19,2003,1979,1433,-546
2016,1,8,20,1954,1918,1344,-574
2016,1,8,21,1917,1878,1318,-560
2016,1,8,22,1888,1829,1302,-527
2016,1,8,23,1885,1806,1299,-507
2016,1,9,0,1932,1838,1174,-664
2016,1,9,1,1979,1961,1254,-707
2016,1,9,2,2050,2030,1330,-700
2016,1,9,3,2029,2006,1314,-692
2016,1,9,4,2002,1970,1343,-627
2016,1,9,5,1946,1929,1356,-573
2016,1,9,6,1857,1840,1335,-505
2016,1,9,7,1761,1741,1262,-479
2016,1,9,8,1717,1667,1196,-471
2016,1,9,9,1683,1646,1245,-401
2016,1,9,10,1673,1633,1260,-373
2016,1,9,11,1678,1642,1274,-368
2016,1,9,12,1709,1663,1257,-406
2016,1,9,13,1772,1714,1198,-516
2016,1,9,14,1873,1809,1204,-605
2016,1,9,15,1977,1923,1268,-655
2016,1,9,16,2032,1997,1352,-645
2016,1,9,17,2041,2029,1387,-642
2016,1,9,18,2015,2007,1366,-641
2016,1,9,19,1951,1974,1299,-675
2016,1,9,20,1886,1892,1216,-676
2016,1,9,21,1834,1827,1159,-668
2016,1,9,22,1798,1771,1126,-645
2016,1,9,23,1790,1749,1087,-662
2016,1,10,0,1841,1785,1170,-615
2016,1,10,1,2004,1929,1282,-647
2016,1,10,2,2082,2029,1332,-697
2016,1,10,3,2069,2012,1322,-690
2016,1,10,4,2046,1982,1306,-676
2016,1,10,5,1989,1935,1267,-668
2016,1,10,6,1898,1853,1197,-656
2016,1,10,7,1800,1761,1104,-657
2016,1,10,8,1701,1713,1087,-626
2016,1,10,9,1688,1678,974,-704
2016,1,10,10,1703,1670,963,-707
2016,1,10,11,1702,1682,967,-715
2016,1,10,12,1724,1707,983,-724
2016,1,10,13,1776,1758,1041,-717
2016,1,10,14,1863,1837,1106,-731
2016,1,10,15,1972,1955,1213,-742
2016,1,10,16,2046,2029,1287,-742
2016,1,10,17,2070,2056,1311,-745
2016,1,10,18,2065,2048,1279,-769
2016,1,10,19,2018,2005,1288,-717
2016,1,10,20,1974,1976,1271,-705
2016,1,10,21,1923,1927,1183,-744
2016,1,10,22,1894,1886,1154,-732
2016,1,10,23,1894,1867,1124,-743
2016,1,11,0,1949,1896,1141,-755
2016,1,11,1,2099,2045,1233,-812
2016,1,11,2,2186,2145,1329,-816
2016,1,11,3,2170,2121,1335,-786
2016,1,11,4,2133,2099,1317,-782
2016,1,11,5,2053,2014,1241,-773
2016,1,11,6,1931,1880,1124,-756
2016,1,11,7,1812,1775,1018,-757
2016,1,11,8,1683,1704,1068,-636
2016,1,11,9,1689,1679,1076,-603
2016,1,11,10,1709,1678,1101,-577
2016,1,11,11,1722,1697,1127,-570
2016,1,11,12,1771,1758,1155,-603
2016,1,11,13,1889,1877,1271,-606
2016,1,11,14,2101,2094,1388,-706
2016,1,11,15,2272,2254,1459,-795
2016,1,11,16,2300,2259,1444,-815
2016,1,11,17,2278,2230,1414,-816
2016,1,11,18,2235,2188,1390,-798
2016,1,11,19,2181,2148,1405,-743
2016,1,11,20,2120,2077,1352,-725
2016,1,11,21,2066,2028,1265,-763
2016,1,11,22,2016,1994,1320,-674
2016,1,11,23,1986,1967,1339,-628
2016,1,12,0,2017,2014,1364,-650
2016,1,12,1,2184,2156,1401,-755
2016,1,12,2,2276,2228,1555,-673
2016,1,12,3,2262,2197,1547,-650
2016,1,12,4,2226,2151,1512,-639
2016,1,12,5,2141,2064,1429,-635
2016,1,12,6,2005,1923,1306,-617
2016,1,12,7,1882,1805,1170,-635
2016,1,12,8,1749,1737,1107,-630
2016,1,12,9,1745,1706,1250,-456
2016,1,12,10,1735,1704,1229,-475
2016,1,12,11,1739,1717,1240,-477
2016,1,12,12,1781,1761,1322,-439
2016,1,12,13,1892,1877,1392,-485
2016,1,12,14,2083,2083,1422,-661
2016,1,12,15,2235,2247,1543,-704
2016,1,12,16,2268,2218,1529,-689
2016,1,12,17,2238,2201,1579,-622
2016,1,12,18,2203,2160,1580,-580
2016,1,12,19,2154,2097,1575,-522
2016,1,12,20,2096,2018,1584,-434
2016,1,12,21,2043,1956,1633,-323
2016,1,12,22,1996,1925,1637,-288
2016,1,12,23,1967,1897,1643,-254
2016,1,13,0,2010,1951,1698,-253
2016,1,13,1,2164,2095,1823,-272
2016,1,13,2,2246,2187,1835,-352
2016,1,13,3,2224,2168,1815,-353
2016,1,13,4,2186,2144,1786,-358
2016,1,13,5,2097,2053,1682,-371
2016,1,13,6,1960,1912,1546,-366
2016,1,13,7,1840,1786,1469,-317
2016,1,13,8,1738,1717,1382,-335
2016,1,13,9,1715,1680,1330,-350
2016,1,13,10,1717,1681,1407,-274
2016,1,13,11,1728,1682,1409,-273
2016,1,13,12,1771,1727,1437,-290
2016,1,13,13,1880,1838,1555,-283
2016,1,13,14,2073,2033,1670,-363
2016,1,13,15,2218,2182,1739,-443
2016,1,13,16,2225,2190,1779,-411
2016,1,13,17,2188,2153,1784,-369
2016,1,13,18,2151,2130,1747,-383
2016,1,13,19,2093,2076,1635,-441
2016,1,13,20,2027,2026,1611,-415
2016,1,13,21,1973,1985,1524,-461
2016,1,13,22,1940,1946,1503,-443
2016,1,13,23,1926,1940,1454,-486
2016,1,14,0,1975,1994,1462,-532
2016,1,14,1,2112,2079,1518,-561
2016,1,14,2,2195,2124,1592,-532
2016,1,14,3,2165,2091,1546,-545
2016,1,14,4,2128,2050,1523,-527
2016,1,14,5,2042,1953,1447,-506
2016,1,14,6,1910,1798,1287,-511
2016,1,14,7,1789,1679,1197,-482
2016,1,14,8,1661,1608,1142,-466
2016,1,14,9,1642,1581,1153,-428
2016,1,14,10,1620,1568,1150,-418
2016,1,14,11,1629,1572,1300,-272
2016,1,14,12,1676,1621,1299,-322
2016,1,14,13,1792,1743,1408,-335
2016,1,14,14,1996,1953,1606,-347
2016,1,14,15,2151,2117,1650,-467
2016,1,14,16,2166,2117,1663,-454
2016,1,14,17,2141,2068,1598,-470
2016,1,14,18,2107,1992,1546,-446
2016,1,14,19,2054,1942,1573,-369
2016,1,14,20,2009,1886,1572,-314
2016,1,14,21,1958,1863,1506,-357
2016,1,14,22,1931,1834,1461,-373
2016,1,14,23,1927,1838,1455,-383
2016,1,15,0,1983,1894,1455,-439
2016,1,15,1,2116,2027,1487,-540
2016,1,15,2,2193,2095,1562,-533
2016,1,15,3,2158,2050,1426,-624
2016,1,15,4,2113,2016,1349,-667
2016,1,15,5,2017,1950,1375,-575
2016,1,15,6,1871,1831,1294,-537
2016,1,15,7,1740,1710,1294,-416
2016,1,15,8,1686,1641,1237,-404
2016,1,15,9,1656,1611,1242,-369
2016,1,15,10,1629,1604,1250,-354
2016,1,15,11,1632,1599,1249,-350
2016,1,15,12,1674,1636,1217,-419
2016,1,15,13,1782,1739,1225,-514
2016,1,15,14,1985,1931,1390,-541
2016,1,15,15,2130,2078,1484,-594
2016,1,15,16,2136,2088,1526,-562
2016,1,15,17,2103,2058,1497,-561
2016,1,15,18,2061,2029,1474,-555
2016,1,15,19,2022,1995,1447,-548
2016,1,15,20,1982,1920,1369,-551
2016,1,15,21,1943,1889,1331,-558
2016,1,15,22,1916,1845,1279,-566
2016,1,15,23,1911,1864,1329,-535
2016,1,16,0,1964,1884,1326,-558
2016,1,16,1,2008,1972,1276,-696
2016,1,16,2,2090,2051,1323,-728
2016,1,16,3,2067,2023,1312,-711
2016,1,16,4,2044,1978,1293,-685
2016,1,16,5,1997,1935,1394,-541
2016,1,16,6,1907,1839,1302,-537
2016,1,16,7,1804,1735,1290,-445
2016,1,16,8,1750,1678,1249,-429
2016,1,16,9,1709,1636,1149,-487
2016,1,16,10,1665,1621,1139,-482
2016,1,16,11,1663,1611,1112,-499
2016,1,16,12,1684,1627,1121,-506
2016,1,16,13,1739,1684,1153,-531
2016,1,16,14,1830,1759,1266,-493
2016,1,16,15,1922,1868,1379,-489
2016,1,16,16,1968,1954,1459,-495
2016,1,16,17,1975,2003,1489,-514
2016,1,16,18,1944,2015,1390,-625
2016,1,16,19,1892,2001,1382,-619
2016,1,16,20,1833,1947,1386,-561
2016,1,16,21,1786,1906,1468,-438
2016,1,16,22,1759,1882,1497,-385
2016,1,16,23,1758,1859,1482,-377
2016,1,17,0,1808,1868,1381,-487
2016,1,17,1,1948,1946,1324,-622
2016,1,17,2,2018,2019,1387,-632
2016,1,17,3,1989,1970,1358,-612
2016,1,17,4,1958,1925,1431,-494
2016,1,17,5,1902,1871,1389,-482
2016,1,17,6,1811,1787,1308,-479
2016,1,17,7,1712,1682,1240,-442
2016,1,17,8,1667,1604,1221,-383
2016,1,17,9,1629,1578,1238,-340
2016,1,17,10,1609,1565,1203,-362
2016,1,17,11,1606,1563,1200,-363
2016,1,17,12,1622,1570,1155,-415
2016,1,17,13,1671,1636,1118,-518
2016,1,17,14,1752,1692,1139,-553
2016,1,17,15,1848,1805,1159,-646
2016,1,17,16,1920,1876,1217,-659
2016,1,17,17,1942,1904,1256,-648
2016,1,17,18,1932,1915,1285,-630
2016,1,17,19,1891,1881,1290,-591
2016,1,17,20,1854,1818,1288,-530
2016,1,17,21,1813,1789,1422,-367
2016,1,17,22,1797,1774,1426,-348
2016,1,17,23,1801,1795,1489,-306
2016,1,18,0,1845,1835,1550,-285
2016,1,18,1,1964,1919,1570,-349
2016,1,18,2,2026,1958,1527,-431
2016,1,18,3,1988,1916,1496,-420
2016,1,18,4,1943,1864,1451,-413
2016,1,18,5,1864,1786,1374,-412
2016,1,18,6,1744,1677,1298,-379
2016,1,18,7,1633,1571,1180,-391
2016,1,18,8,1568,1503,1176,-327
2016,1,18,9,1522,1463,1186,-277
2016,1,18,10,1500,1460,1300,-160
2016,1,18,11,1507,1460,1291,-169
2016,1,18,12,1543,1495,1200,-295
2016,1,18,13,1650,1581,1284,-297
2016,1,18,14,1838,1733,1304,-429
2016,1,18,15,1985,1867,1436,-431
2016,1,18,16,2008,1921,1472,-449
2016,1,18,17,1993,1944,1483,-461
2016,1,18,18,1980,1924,1391,-533
2016,1,18,19,1948,1888,1398,-490
2016,1,18,20,1911,1826,1336,-490
2016,1,18,21,1881,1808,1327,-481
2016,1,18,22,1864,1757,1292,-465
2016,1,18,23,1861,1743,1266,-477
2016,1,19,0,1893,1772,1277,-495
2016,1,19,1,2017,1878,1321,-557
2016,1,19,2,2089,1997,1442,-555
2016,1,19,3,2065,1981,1416,-565
2016,1,19,4,2028,1951,1393,-558
2016,1,19,5,1954,1874,1363,-511
2016,1,19,6,1832,1736,1283,-453
2016,1,19,7,1715,1627,1128,-499
2016,1,19,8,1658,1559,1162,-397
2016,1,19,9,1623,1533,1175,-358
2016,1,19,10,1559,1528,1219,-309
2016,1,19,11,1561,1536,1288,-248
2016,1,19,12,1593,1581,1332,-249
2016,1,19,13,1689,1693,1387,-306
2016,1,19,14,1848,1887,1522,-365
2016,1,19,15,1982,2052,1680,-372
2016,1,19,16,2008,2032,1690,-342
2016,1,19,17,1990,1983,1736,-247
2016,1,19,18,1956,1950,1669,-281
2016,1,19,19,1909,1925,1669,-256
2016,1,19,20,1863,1901,1709,-192
2016,1,19,21,1827,1873,1703,-170
2016,1,19,22,1807,1878,1691,-187
2016,1,19,23,1801,1896,1714,-182
2016,1,20,0,1833,1974,1784,-190
2016,1,20,1,1943,2073,1723,-350
2016,1,20,2,2020,2102,1701,-401
2016,1,20,3,1993,2061,1656,-405
2016,1,20,4,1948,1984,1565,-419
2016,1,20,5,1868,1885,1436,-449
2016,1,20,6,1743,1726,1267,-459
2016,1,20,7,1636,1613,1135,-478
2016,1,20,8,1601,1529,1248,-281
2016,1,20,9,1564,1514,1333,-181
2016,1,20,10,1559,1522,1316,-206
2016,1,20,11,1576,1513,1308,-205
2016,1,20,12,1625,1550,1361,-189
2016,1,20,13,1733,1661,1404,-257
2016,1,20,14,1919,1856,1466,-390
2016,1,20,15,2074,2016,1659,-357
2016,1,20,16,2094,2007,1665,-342
2016,1,20,17,2071,1961,1618,-343
2016,1,20,18,2042,1924,1593,-331
2016,1,20,19,2012,1865,1566,-299
2016,1,20,20,1969,1813,1558,-255
2016,1,20,21,1937,1772,1588,-184
2016,1,20,22,1916,1742,1547,-195
2016,1,20,23,1917,1719,1468,-251
2016,1,21,0,1962,1743,1442,-301
2016,1,21,1,2076,1867,1532,-335
2016,1,21,2,2156,1984,1491,-493
2016,1,21,3,2127,1982,1436,-546
2016,1,21,4,2084,1955,1482,-473
2016,1,21,5,1994,1880,1445,-435
2016,1,21,6,1857,1753,1355,-398
2016,1,21,7,1733,1633,1145,-488
2016,1,21,8,1665,1565,1085,-480
2016,1,21,9,1642,1536,1139,-397
2016,1,21,10,1590,1524,1261,-263
2016,1,21,11,1595,1536,1383,-153
2016,1,21,12,1631,1567,1427,-140
2016,1,21,13,1741,1692,1450,-242
2016,1,21,14,1933,1878,1572,-306
2016,1,21,15,2084,2051,1738,-313
2016,1,21,16,2089,2037,1742,-295
2016,1,21,17,2045,1979,1760,-219
2016,1,21,18,2001,1959,1817,-142
2016,1,21,19,1948,1907,1786,-121
2016,1,21,20,1890,1857,1742,-115
2016,1,21,21,1845,1820,1669,-151
2016,1,21,22,1813,1796,1701,-95
2016,1,21,23,1801,1785,1663,-122
2016,1,22,0,1838,1841,1790,-51
2016,1,22,1,1960,1960,1824,-136
2016,1,22,2,2068,2032,1854,-178
2016,1,22,3,2057,2022,1788,-234
2016,1,22,4,2028,1973,1845,-128
2016,1,22,5,1956,1908,1819,-89
2016,1,22,6,1828,1779,1686,-93
2016,1,22,7,1709,1654,1374,-280
2016,1,22,8,1666,1594,1325,-269
2016,1,22,9,1622,1565,1416,-149
2016,1,22,10,1596,1564,1404,-160
2016,1,22,11,1596,1559,1403,-156
2016,1,22,12,1628,1604,1441,-163
2016,1,22,13,1733,1705,1553,-152
2016,1,22,14,1920,1893,1723,-170
2016,1,22,15,2073,2038,1799,-239
2016,1,22,16,2066,2055,1777,-278
2016,1,22,17,2018,2014,1730,-284
2016,1,22,18,1976,1993,1706,-287
2016,1,22,19,1932,1938,1732,-206
2016,1,22,20,1886,1926,1729,-197
2016,1,22,21,1851,1860,1749,-111
2016,1,22,22,1829,1829,1722,-107
2016,1,22,23,1824,1824,1731,-93
2016,1,23,0,1867,1850,1739,-111
2016,1,23,1,1898,1928,1785,-143
2016,1,23,2,1984,1976,1706,-270
2016,1,23,3,1960,1930,1621,-309
2016,1,23,4,1930,1892,1665,-227
2016,1,23,5,1875,1811,1639,-172
2016,1,23,6,1782,1728,1660,-68
2016,1,23,7,1694,1620,1621,1
2016,1,23,8,1622,1547,1551,4
2016,1,23,9,1606,1499,1508,9
2016,1,23,10,1548,1483,1492,9
2016,1,23,11,1552,1473,1508,35
2016,1,23,12,1573,1497,1489,-8
2016,1,23,13,1629,1549,1510,-39
2016,1,23,14,1718,1620,1570,-50
2016,1,23,15,1819,1734,1659,-75
2016,1,23,16,1874,1823,1743,-80
2016,1,23,17,1887,1873,1778,-95
2016,1,23,18,1872,1903,1804,-99
2016,1,23,19,1834,1883,1814,-69
2016,1,23,20,1780,1829,1765,-64
2016,1,23,21,1740,1766,1704,-62
2016,1,23,22,1716,1722,1653,-69
2016,1,23,23,1708,1719,1617,-102
2016,1,24,0,1736,1746,1592,-154
2016,1,24,1,1849,1831,1667,-164
2016,1,24,2,1919,1908,1753,-155
2016,1,24,3,1893,1870,1667,-203
2016,1,24,4,1863,1833,1615,-218
2016,1,24,5,1802,1784,1609,-175
2016,1,24,6,1712,1689,1542,-147
2016,1,24,7,1618,1602,1490,-112
2016,1,24,8,1595,1525,1437,-88
2016,1,24,9,1552,1497,1424,-73
2016,1,24,10,1520,1482,1451,-31
2016,1,24,11,1524,1477,1462,-15
2016,1,24,12,1536,1490,1442,-48
2016,1,24,13,1582,1536,1452,-84
2016,1,24,14,1661,1609,1457,-152
2016,1,24,15,1763,1709,1501,-208
2016,1,24,16,1841,1792,1528,-264
2016,1,24,17,1869,1821,1563,-258
2016,1,24,18,1878,1811,1598,-213
2016,1,24,19,1853,1756,1577,-179
2016,1,24,20,1823,1721,1630,-91
2016,1,24,21,1778,1689,1602,-87
2016,1,24,22,1767,1658,1543,-115
2016,1,24,23,1776,1644,1560,-84
2016,1,25,0,1821,1660,1583,-77
2016,1,25,1,1923,1792,1780,-12
2016,1,25,2,2001,1912,1891,-21
2016,1,25,3,1985,1931,1922,-9
2016,1,25,4,1949,1908,1830,-78
2016,1,25,5,1878,1834,1751,-83
2016,1,25,6,1769,1720,1710,-10
2016,1,25,7,1664,1625,1645,20
2016,1,25,8,1606,1569,1492,-77
2016,1,25,9,1584,1556,1469,-87
2016,1,25,10,1578,1561,1450,-111
2016,1,25,11,1594,1586,1490,-96
2016,1,25,12,1631,1645,1582,-63
2016,1,25,13,1742,1784,1555,-229
2016,1,25,14,1930,1995,1525,-470
2016,1,25,15,2090,2167,1572,-595
2016,1,25,16,2126,2157,1542,-615
2016,1,25,17,2099,2106,1414,-692
2016,1,25,18,2053,2029,1378,-651
2016,1,25,19,2006,1946,1304,-642
2016,1,25,20,1954,1864,1249,-615
2016,1,25,21,1904,1803,1310,-493
2016,1,25,22,1869,1778,1339,-439
2016,1,25,23,1853,1758,1332,-426
2016,1,26,0,1880,1792,1364,-428
2016,1,26,1,2008,1898,1450,-448
2016,1,26,2,2116,2037,1580,-457
2016,1,26,3,2114,2018,1570,-448
2016,1,26,4,2082,1990,1503,-487
2016,1,26,5,2006,1908,1454,-454
2016,1,26,6,1880,1783,1369,-414
2016,1,26,7,1760,1681,1314,-367
2016,1,26,8,1660,1621,1260,-361
2016,1,26,9,1667,1614,1250,-364
2016,1,26,10,1628,1611,1301,-310
2016,1,26,11,1636,1622,1299,-323
2016,1,26,12,1677,1670,1321,-349
2016,1,26,13,1791,1793,1431,-362
2016,1,26,14,1992,2003,1516,-487
2016,1,26,15,2151,2170,1612,-558
2016,1,26,16,2186,2136,1511,-625
2016,1,26,17,2143,2082,1435,-647
2016,1,26,18,2073,2026,1460,-566
2016,1,26,19,2003,1950,1411,-539
2016,1,26,20,1930,1881,1486,-395
2016,1,26,21,1872,1827,1444,-383
2016,1,26,22,1830,1777,1438,-339
2016,1,26,23,1809,1750,1426,-324
2016,1,27,0,1835,1778,1450,-328
2016,1,27,1,1958,1882,1489,-393
2016,1,27,2,2082,2022,1603,-419
2016,1,27,3,2084,2018,1591,-427
2016,1,27,4,2054,1999,1637,-362
2016,1,27,5,1980,1927,1637,-290
2016,1,27,6,1857,1792,1525,-267
2016,1,27,7,1744,1686,1436,-250
2016,1,27,8,1687,1622,1375,-247
2016,1,27,9,1697,1590,1334,-256
2016,1,27,10,1644,1591,1330,-261
2016,1,27,11,1657,1598,1318,-280
2016,1,27,12,1705,1662,1386,-276
2016,1,27,13,1823,1781,1517,-264
2016,1,27,14,2036,1994,1615,-379
2016,1,27,15,2194,2155,1730,-425
2016,1,27,16,2202,2139,1759,-380
2016,1,27,17,2146,2051,1642,-409
2016,1,27,18,2072,1986,1654,-332
2016,1,27,19,1990,1914,1608,-306
2016,1,27,20,1913,1852,1631,-221
2016,1,27,21,1850,1805,1593,-212
2016,1,27,22,1804,1767,1568,-199
2016,1,27,23,1781,1749,1547,-202
2016,1,28,0,1806,1775,1566,-209
2016,1,28,1,1924,1872,1646,-226
2016,1,28,2,2056,2016,1835,-181
2016,1,28,3,2061,2016,1842,-174
2016,1,28,4,2040,1991,1785,-206
2016,1,28,5,1971,1914,1687,-227
2016,1,28,6,1847,1787,1569,-218
2016,1,28,7,1731,1665,1412,-253
2016,1,28,8,1713,1599,1385,-214
2016,1,28,9,1648,1577,1414,-163
2016,1,28,10,1602,1579,1429,-150
2016,1,28,11,1606,1604,1431,-173
2016,1,28,12,1653,1659,1535,-124
2016,1,28,13,1775,1790,1627,-163
2016,1,28,14,1986,2002,1755,-247
2016,1,28,15,2140,2181,1833,-348
2016,1,28,16,2129,2137,1815,-322
2016,1,28,17,2057,2061,1833,-228
2016,1,28,18,1992,1977,1760,-217
2016,1,28,19,1921,1941,1809,-132
2016,1,28,20,1858,1871,1719,-152
2016,1,28,21,1807,1847,1759,-88
2016,1,28,22,1770,1835,1714,-121
2016,1,28,23,1750,1853,1729,-124
2016,1,29,0,1781,1924,1801,-123
2016,1,29,1,1900,2014,1740,-274
2016,1,29,2,2036,2081,1675,-406
2016,1,29,3,2024,2055,1636,-419
2016,1,29,4,1979,2018,1583,-435
2016,1,29,5,1894,1938,1553,-385
2016,1,29,6,1759,1791,1413,-378
2016,1,29,7,1638,1663,1328,-335
2016,1,29,8,1584,1582,1249,-333
2016,1,29,9,1554,1540,1212,-328
2016,1,29,10,1571,1539,1193,-346
2016,1,29,11,1580,1536,1255,-281
2016,1,29,12,1624,1579,1256,-323
2016,1,29,13,1740,1692,1315,-377
2016,1,29,14,1940,1876,1471,-405
2016,1,29,15,2086,2019,1572,-447
2016,1,29,16,2057,2024,1578,-446
2016,1,29,17,1986,2001,1539,-462
2016,1,29,18,1933,1998,1561,-437
2016,1,29,19,1884,1966,1528,-438
2016,1,29,20,1849,1941,1553,-388
2016,1,29,21,1827,1915,1585,-330
2016,1,29,22,1810,1903,1519,-384
2016,1,29,23,1810,1884,1507,-377
2016,1,30,0,1850,1908,1552,-356
2016,1,30,1,1880,1975,1603,-372
2016,1,30,2,1958,2013,1688,-325
2016,1,30,3,1933,1954,1781,-173
2016,1,30,4,1903,1913,1846,-67
2016,1,30,5,1848,1852,1796,-56
2016,1,30,6,1762,1744,1681,-63
2016,1,30,7,1670,1650,1560,-90
2016,1,30,8,1569,1580,1499,-81
2016,1,30,9,1587,1544,1361,-183
2016,1,30,10,1582,1530,1332,-198
2016,1,30,11,1596,1531,1320,-211
2016,1,30,12,1623,1551,1341,-210
2016,1,30,13,1692,1619,1402,-217
2016,1,30,14,1792,1701,1465,-236
2016,1,30,15,1898,1828,1589,-239
2016,1,30,16,1963,1898,1665,-233
2016,1,30,17,1980,1913,1662,-251
2016,1,30,18,1984,1887,1653,-234
2016,1,30,19,1951,1824,1585,-239
2016,1,30,20,1904,1773,1597,-176
2016,1,30,21,1868,1736,1546,-190
2016,1,30,22,1845,1706,1535,-171
2016,1,30,23,1839,1714,1504,-210
2016,1,31,0,1877,1744,1499,-245
2016,1,31,1,1986,1834,1596,-238
2016,1,31,2,2074,1959,1693,-266
2016,1,31,3,2048,1954,1618,-336
2016,1,31,4,2020,1920,1538,-382
2016,1,31,5,1962,1856,1421,-435
2016,1,31,6,1869,1774,1356,-418
2016,1,31,7,1767,1678,1240,-438
2016,1,31,8,1679,1608,1198,-410
2016,1,31,9,1635,1588,1167,-421
2016,1,31,10,1610,1586,1154,-432
2016,1,31,11,1612,1602,1176,-426
2016,1,31,12,1630,1639,1206,-433
2016,1,31,13,1682,1689,1252,-437
2016,1,31,14,1766,1764,1319,-445
2016,1,31,15,1872,1885,1459,-426
2016,1,31,16,1939,1963,1483,-480
2016,1,31,17,1942,1973,1478,-495
2016,1,31,18,1931,1969,1531,-438
2016,1,31,19,1885,1939,1561,-378
2016,1,31,20,1862,1894,1540,-354
2016,1,31,21,1827,1864,1560,-304
2016,1,31,22,1812,1840,1509,-331
2016,1,31,23,1811,1837,1482,-355
2016,2,1,0,1854,1860,1510,-350
2016,2,1,1,1964,1954,1563,-391
2016,2,1,2,2086,2068,1585,-483
2016,2,1,3,2080,2075,1592,-483
2016,2,1,4,2059,2042,1520,-522
2016,2,1,5,1990,1973,1466,-507
2016,2,1,6,1872,1852,1415,-437
2016,2,1,7,1766,1740,1358,-382
2016,2,1,8,1701,1691,1298,-393
2016,2,1,9,1675,1670,1267,-403
2016,2,1,10,1672,1690,1314,-376
2016,2,1,11,1678,1703,1332,-371
2016,2,1,12,1722,1764,1395,-369
2016,2,1,13,1839,1887,1433,-454
2016,2,1,14,2040,2102,1371,-731
2016,2,1,15,2199,2266,1363,-903
2016,2,1,16,2204,2251,1335,-916
2016,2,1,17,2150,2189,1337,-852
2016,2,1,18,2102,2131,1334,-797
2016,2,1,19,2052,2051,1352,-699
2016,2,1,20,2002,1984,1406,-578
2016,2,1,21,1954,1921,1430,-491
2016,2,1,22,1921,1873,1469,-404
2016,2,1,23,1906,1856,1517,-339
2016,2,2,0,1940,1875,1533,-342
2016,2,2,1,2045,1973,1558,-415
2016,2,2,2,2161,2122,1661,-461
2016,2,2,3,2156,2123,1609,-514
2016,2,2,4,2127,2081,1589,-492
2016,2,2,5,2055,2010,1530,-480
2016,2,2,6,1917,1885,1417,-468
2016,2,2,7,1798,1756,1409,-347
2016,2,2,8,1699,1707,1378,-329
2016,2,2,9,1694,1699,1401,-298
2016,2,2,10,1703,1701,1359,-342
2016,2,2,11,1710,1726,1327,-399
2016,2,2,12,1758,1787,1353,-434
2016,2,2,13,1880,1919,1312,-607
2016,2,2,14,2091,2130,1291,-839
2016,2,2,15,2253,2291,1297,-994
2016,2,2,16,2254,2260,1269,-991
2016,2,2,17,2194,2179,1248,-931
2016,2,2,18,2139,2095,1270,-825
2016,2,2,19,2089,2013,1216,-797
2016,2,2,20,2036,1940,1226,-714
2016,2,2,21,1991,1886,1241,-645
2016,2,2,22,1951,1836,1258,-578
2016,2,2,23,1936,1834,1287,-547
2016,2,3,0,1968,1836,1230,-606
2016,2,3,1,2072,1931,1238,-693
2016,2,3,2,2218,2089,1253,-836
2016,2,3,3,2229,2102,1218,-884
2016,2,3,4,2200,2094,1262,-832
2016,2,3,5,2126,2021,1275,-746
2016,2,3,6,1987,1889,1266,-623
2016,2,3,7,1862,1789,1300,-489
2016,2,3,8,1732,1735,1269,-466
2016,2,3,9,1731,1717,1237,-480
2016,2,3,10,1749,1729,1237,-492
2016,2,3,11,1758,1746,1251,-495
2016,2,3,12,1810,1797,1227,-570
2016,2,3,13,1936,1915,1207,-708
2016,2,3,14,2150,2130,1192,-938
2016,2,3,15,2313,2283,1505,-778
2016,2,3,16,2298,2258,1455,-803
2016,2,3,17,2222,2177,1395,-782
2016,2,3,18,2146,2080,1366,-714
2016,2,3,19,2075,1999,1310,-689
2016,2,3,20,2010,1931,1251,-680
2016,2,3,21,1955,1877,1156,-721
2016,2,3,22,1915,1842,1166,-676
2016,2,3,23,1896,1828,1167,-661
2016,2,4,0,1926,1854,1177,-677
2016,2,4,1,2038,1987,1297,-690
2016,2,4,2,2200,2102,1392,-710
2016,2,4,3,2208,2116,1412,-704
2016,2,4,4,2170,2077,1377,-700
2016,2,4,5,2093,1999,1323,-676
2016,2,4,6,1952,1848,1179,-669
2016,2,4,7,1832,1751,1069,-682
2016,2,4,8,1686,1680,1058,-622
2016,2,4,9,1689,1666,1045,-621
2016,2,4,10,1693,1654,1040,-614
2016,2,4,11,1692,1663,1042,-621
2016,2,4,12,1731,1706,1102,-604
2016,2,4,13,1841,1814,1137,-677
2016,2,4,14,2031,2017,1293,-724
2016,2,4,15,2178,2144,1350,-794
2016,2,4,16,2152,2123,1344,-779
2016,2,4,17,2081,2085,1314,-771
2016,2,4,18,2018,2048,1371,-677
2016,2,4,19,1960,1992,1225,-767
2016,2,4,20,1914,1941,1172,-769
2016,2,4,21,1880,1930,1208,-722
2016,2,4,22,1856,1903,1155,-748
2016,2,4,23,1837,1892,1134,-758
2016,2,5,0,1872,1907,1143,-764
2016,2,5,1,1978,1978,1132,-846
2016,2,5,2,2125,2069,1201,-868
2016,2,5,3,2135,2056,1204,-852
2016,2,5,4,2112,2004,1172,-832
2016,2,5,5,2037,1924,1236,-688
2016,2,5,6,1897,1785,1105,-680
2016,2,5,7,1779,1667,1010,-657
2016,2,5,8,1674,1598,1024,-574
2016,2,5,9,1652,1577,1014,-563
2016,2,5,10,1626,1577,1024,-553
2016,2,5,11,1639,1581,1042,-539
2016,2,5,12,1683,1622,1076,-546
2016,2,5,13,1798,1732,1178,-554
2016,2,5,14,2000,1931,1301,-630
2016,2,5,15,2147,2082,1262,-820
2016,2,5,16,2121,2081,1239,-842
2016,2,5,17,2047,2052,1190,-862
2016,2,5,18,1975,2016,1229,-787
2016,2,5,19,1918,1959,1180,-779
2016,2,5,20,1873,1885,1111,-774
2016,2,5,21,1841,1820,1076,-744
2016,2,5,22,1819,1781,1043,-738
2016,2,5,23,1810,1755,1037,-718
2016,2,6,0,1840,1778,1047,-731
2016,2,6,1,1901,1851,1085,-766
2016,2,6,2,1998,1963,1178,-785
2016,2,6,3,1991,1957,1245,-712
2016,2,6,4,1961,1932,1381,-551
2016,2,6,5,1904,1881,1471,-410
2016,2,6,6,1812,1784,1371,-413
2016,2,6,7,1719,1693,1319,-374
2016,2,6,8,1675,1642,1297,-345
2016,2,6,9,1651,1603,1303,-300
2016,2,6,10,1631,1597,1350,-247
2016,2,6,11,1636,1596,1354,-242
2016,2,6,12,1657,1617,1380,-237
2016,2,6,13,1709,1675,1403,-272
2016,2,6,14,1798,1763,1351,-412
2016,2,6,15,1892,1876,1369,-507
2016,2,6,16,1944,1939,1324,-615
2016,2,6,17,1944,1954,1305,-649
2016,2,6,18,1911,1929,1309,-620
2016,2,6,19,1854,1856,1283,-573
2016,2,6,20,1792,1788,1205,-583
2016,2,6,21,1747,1724,1180,-544
2016,2,6,22,1721,1687,1144,-543
2016,2,6,23,1710,1670,1129,-541
2016,2,7,0,1736,1680,1138,-542
2016,2,7,1,1838,1762,1172,-590
2016,2,7,2,1961,1874,1223,-651
2016,2,7,3,1963,1866,1202,-664
2016,2,7,4,1951,1842,1264,-578
2016,2,7,5,1909,1798,1237,-561
2016,2,7,6,1828,1707,1149,-558
2016,2,7,7,1742,1627,1078,-549
2016,2,7,8,1671,1571,1010,-561
2016,2,7,9,1594,1550,975,-575
2016,2,7,10,1566,1540,953,-587
2016,2,7,11,1565,1548,956,-592
2016,2,7,12,1583,1580,971,-609
2016,2,7,13,1631,1636,960,-676
2016,2,7,14,1713,1705,991,-714
2016,2,7,15,1812,1811,999,-812
2016,2,7,16,1872,1892,1068,-824
2016,2,7,17,1882,1898,1086,-812
2016,2,7,18,1858,1832,1064,-768
2016,2,7,19,1807,1777,1025,-752
2016,2,7,20,1770,1714,970,-744
2016,2,7,21,1728,1660,918,-742
2016,2,7,22,1703,1629,887,-742
2016,2,7,23,1698,1605,890,-715
2016,2,8,0,1733,1568,842,-726
2016,2,8,1,1827,1578,796,-782
2016,2,8,2,1950,1705,823,-882
2016,2,8,3,1959,1739,851,-888
2016,2,8,4,1941,1755,890,-865
2016,2,8,5,1880,1783,1077,-706
2016,2,8,6,1768,1673,1032,-641
2016,2,8,7,1673,1577,1020,-557
2016,2,8,8,1620,1527,954,-573
2016,2,8,9,1588,1517,1007,-510
2016,2,8,10,1546,1526,1077,-449
2016,2,8,11,1558,1552,1082,-470
2016,2,8,12,1603,1610,1146,-464
2016,2,8,13,1714,1734,1134,-600
2016,2,8,14,1907,1940,1198,-742
2016,2,8,15,2061,2104,1193,-911
2016,2,8,16,2052,2079,1185,-894
2016,2,8,17,1997,2023,1138,-885
2016,2,8,18,1937,1965,1097,-868
2016,2,8,19,1878,1902,1082,-820
2016,2,8,20,1816,1849,1089,-760
2016,2,8,21,1769,1798,1057,-741
2016,2,8,22,1733,1760,1031,-729
2016,2,8,23,1708,1712,801,-911
2016,2,9,0,1717,1738,809,-929
2016,2,9,1,1792,1801,851,-950
2016,2,9,2,1929,1944,983,-961
2016,2,9,3,1958,1969,1026,-943
2016,2,9,4,1951,1938,1049,-889
2016,2,9,5,1908,1872,1067,-805
2016,2,9,6,1785,1728,1169,-559
2016,2,9,7,1680,1621,1100,-521
2016,2,9,8,1645,1570,1061,-509
2016,2,9,9,1630,1575,1066,-509
2016,2,9,10,1597,1567,1062,-505
2016,2,9,11,1606,1582,1075,-507
2016,2,9,12,1648,1641,1085,-556
2016,2,9,13,1766,1765,1152,-613
2016,2,9,14,1967,1972,1243,-729
2016,2,9,15,2116,2124,1270,-854
2016,2,9,16,2109,2108,1241,-867
2016,2,9,17,2043,2060,1190,-870
2016,2,9,18,1968,2026,1297,-729
2016,2,9,19,1902,1974,1279,-695
2016,2,9,20,1828,1890,1220,-670
2016,2,9,21,1770,1840,1183,-657
2016,2,9,22,1720,1769,1139,-630
2016,2,9,23,1689,1581,948,-633
2016,2,10,0,1694,1893,1218,-675
2016,2,10,1,1767,1803,1110,-693
2016,2,10,2,1924,1947,1219,-728
2016,2,10,3,1961,1976,1259,-717
2016,2,10,4,1953,1959,1249,-710
2016,2,10,5,1906,1894,1387,-507
2016,2,10,6,1786,1771,1302,-469
2016,2,10,7,1678,1653,1192,-461
2016,2,10,8,1628,1601,1114,-487
2016,2,10,9,1635,1572,1081,-491
2016,2,10,10,1623,1582,1056,-526
2016,2,10,11,1632,1590,936,-654
2016,2,10,12,1677,1649,912,-737
2016,2,10,13,1794,1771,1050,-721
2016,2,10,14,1999,1973,1204,-769
2016,2,10,15,2144,2125,1309,-816
2016,2,10,16,2129,2097,1234,-863
2016,2,10,17,2062,2060,1192,-868
2016,2,10,18,1996,2005,1143,-862
2016,2,10,19,1930,1929,1051,-878
2016,2,10,20,1853,1851,1004,-847
2016,2,10,21,1787,1784,939,-845
2016,2,10,22,1733,1742,935,-807
2016,2,10,23,1694,1704,902,-802
2016,2,11,0,1699,1719,884,-835
2016,2,11,1,1771,1790,934,-856
2016,2,11,2,1938,1943,1046,-897
2016,2,11,3,1982,1946,1091,-855
2016,2,11,4,1978,1938,1088,-850
2016,2,11,5,1925,1876,1035,-841
2016,2,11,6,1802,1751,949,-802
2016,2,11,7,1696,1652,1004,-648
2016,2,11,8,1615,1561,960,-601
2016,2,11,9,1604,1560,968,-592
2016,2,11,10,1597,1564,942,-622
2016,2,11,11,1611,1570,951,-619
2016,2,11,12,1648,1615,1006,-609
2016,2,11,13,1767,1722,1058,-664
2016,2,11,14,1972,1932,1102,-830
2016,2,11,15,2112,2073,1232,-841
2016,2,11,16,2094,2046,1232,-814
2016,2,11,17,2032,1980,1165,-815
2016,2,11,18,1975,1916,1123,-793
2016,2,11,19,1906,1840,1050,-790
2016,2,11,20,1811,1784,1045,-739
2016,2,11,21,1735,1737,1099,-638
2016,2,11,22,1679,1704,1138,-566
2016,2,11,23,1676,1696,1162,-534
2016,2,12,0,1704,1725,1201,-524
2016,2,12,1,1787,1774,1235,-539
2016,2,12,2,1949,1898,1340,-558
2016,2,12,3,1988,1916,1348,-568
2016,2,12,4,1977,1886,1325,-561
2016,2,12,5,1918,1825,1277,-548
2016,2,12,6,1796,1713,1181,-532
2016,2,12,7,1687,1613,1239,-374
2016,2,12,8,1597,1557,1226,-331
2016,2,12,9,1570,1527,1209,-318
2016,2,12,10,1564,1528,1220,-308
2016,2,12,11,1576,1544,1221,-323
2016,2,12,12,1616,1582,1249,-333
2016,2,12,13,1734,1700,1271,-429
2016,2,12,14,1940,1881,1258,-623
2016,2,12,15,2078,2026,1303,-723
2016,2,12,16,2045,2015,1250,-765
2016,2,12,17,1977,1972,1224,-748
2016,2,12,18,1916,1906,1166,-740
2016,2,12,19,1854,1829,1137,-692
2016,2,12,20,1780,1745,1104,-641
2016,2,12,21,1720,1709,1133,-576
2016,2,12,22,1677,1663,1105,-558
2016,2,12,23,1672,1633,1129,-504
2016,2,13,0,1700,1671,1157,-514
2016,2,13,1,1742,1708,1184,-524
2016,2,13,2,1856,1823,1252,-571
2016,2,13,3,1873,1825,1204,-621
2016,2,13,4,1858,1797,1162,-635
2016,2,13,5,1817,1742,1130,-612
2016,2,13,6,1739,1670,1256,-414
2016,2,13,7,1653,1576,1210,-366
2016,2,13,8,1560,1500,1121,-379
2016,2,13,9,1530,1483,1119,-364
2016,2,13,10,1507,1461,1103,-358
2016,2,13,11,1515,1477,1098,-379
2016,2,13,12,1530,1507,1088,-419
2016,2,13,13,1589,1561,1141,-420
2016,2,13,14,1685,1650,1196,-454
2016,2,13,15,1785,1768,1253,-515
2016,2,13,16,1845,1827,1255,-572
2016,2,13,17,1845,1829,1252,-577
2016,2,13,18,1812,1774,1233,-541
2016,2,13,19,1749,1721,1375,-346
2016,2,13,20,1674,1651,1328,-323
2016,2,13,21,1617,1587,1216,-371
2016,2,13,22,1581,1548,1223,-325
2016,2,13,23,1576,1530,1196,-334
2016,2,14,0,1598,1533,1196,-337
2016,2,14,1,1674,1605,1263,-342
2016,2,14,2,1800,1731,1310,-421
2016,2,14,3,1815,1739,1281,-458
2016,2,14,4,1800,1717,1255,-462
2016,2,14,5,1757,1664,1211,-453
2016,2,14,6,1682,1587,1143,-444
2016,2,14,7,1596,1497,1056,-441
2016,2,14,8,1519,1432,1000,-432
2016,2,14,9,1464,1397,926,-471
2016,2,14,10,1424,1383,942,-441
2016,2,14,11,1425,1387,945,-442
2016,2,14,12,1440,1404,971,-433
2016,2,14,13,1487,1448,1056,-392
2016,2,14,14,1559,1514,1056,-458
2016,2,14,15,1645,1617,1136,-481
2016,2,14,16,1690,1701,1195,-506
2016,2,14,17,1687,1730,1210,-520
2016,2,14,18,1660,1731,1232,-499
2016,2,14,19,1627,1698,1241,-457
2016,2,14,20,1601,1668,1250,-418
2016,2,14,21,1565,1633,1218,-415
2016,2,14,22,1544,1609,1156,-453
2016,2,14,23,1537,1593,1117,-476
2016,2,15,0,1552,1618,1127,-491
2016,2,15,1,1612,1681,1215,-466
2016,2,15,2,1731,1759,1295,-464
2016,2,15,3,1745,1748,1282,-466
2016,2,15,4,1720,1695,1261,-434
2016,2,15,5,1670,1639,1346,-293
2016,2,15,6,1567,1525,1228,-297
2016,2,15,7,1474,1444,1205,-239
2016,2,15,8,1427,1365,1158,0
2016,2,15,9,1396,1351,1156,-195
2016,2,15,10,1384,1333,1187,-146
2016,2,15,11,1396,1338,1189,-149
2016,2,15,12,1435,1364,1279,-85
2016,2,15,13,1538,1458,1340,-118
2016,2,15,14,1723,1573,1400,-173
2016,2,15,15,1858,1706,1478,-228
2016,2,15,16,1847,1747,1467,-280
2016,2,15,17,1797,1765,1518,-247
2016,2,15,18,1735,1749,1537,-212
2016,2,15,19,1679,1721,1510,-211
2016,2,15,20,1621,1674,1481,-193
2016,2,15,21,1575,1639,1445,-194
2016,2,15,22,1535,1616,1416,-200
2016,2,15,23,1519,1587,1396,-191
2016,2,16,0,1541,1604,1408,-196
2016,2,16,1,1618,1648,1440,-208
2016,2,16,2,1732,1760,1430,-330
2016,2,16,3,1749,1772,1403,-369
2016,2,16,4,1726,1740,1411,-329
2016,2,16,5,1668,1660,1361,-299
2016,2,16,6,1572,1531,1250,-281
2016,2,16,7,1482,1412,1173,-239
2016,2,16,8,1439,1363,1156,-207
2016,2,16,9,1413,1321,1140,-181
2016,2,16,10,1364,1324,1126,-198
2016,2,16,11,1370,1330,1125,-205
2016,2,16,12,1403,1374,1091,-283
2016,2,16,13,1496,1492,1149,-343
2016,2,16,14,1656,1704,1287,-417
2016,2,16,15,1776,1848,1310,-538
2016,2,16,16,1788,1838,1362,-476
2016,2,16,17,1762,1778,1336,-442
2016,2,16,18,1728,1715,1327,-388
2016,2,16,19,1692,1665,1317,-348
2016,2,16,20,1648,1604,1291,-313
2016,2,16,21,1614,1600,1283,-317
2016,2,16,22,1581,1562,1265,-297
2016,2,16,23,1565,1543,1315,-228
2016,2,17,0,1583,1575,1348,-227
2016,2,17,1,1645,1619,1270,-349
2016,2,17,2,1751,1729,1392,-337
2016,2,17,3,1756,1738,1412,-326
2016,2,17,4,1716,1721,1461,-260
2016,2,17,5,1642,1632,1431,-201
2016,2,17,6,1531,1548,1475,-73
2016,2,17,7,1428,1411,1522,111
2016,2,17,8,1407,1350,1475,125
2016,2,17,9,1372,1327,1581,254
2016,2,17,10,1353,1328,1617,289
2016,2,17,11,1361,1338,1600,262
2016,2,17,12,1400,1381,1648,267
2016,2,17,13,1506,1495,1758,263
2016,2,17,14,1694,1714,1811,97
2016,2,17,15,1833,1851,1798,-53
2016,2,17,16,1830,1843,1734,-109
2016,2,17,17,1799,1827,1831,4
2016,2,17,18,1768,1809,1861,52
2016,2,17,19,1729,1783,1817,34
2016,2,17,20,1682,1749,1789,40
2016,2,17,21,1645,1721,1817,96
2016,2,17,22,1610,1703,1770,67
2016,2,17,23,1594,1670,1715,45
2016,2,18,0,1614,1689,1746,57
2016,2,18,1,1675,1731,1713,-18
2016,2,18,2,1785,1812,1725,-87
2016,2,18,3,1795,1822,1748,-74
2016,2,18,4,1750,1774,1804,30
2016,2,18,5,1667,1704,1831,127
2016,2,18,6,1548,1561,1852,291
2016,2,18,7,1436,1451,1809,358
2016,2,18,8,1369,1378,1708,330
2016,2,18,9,1336,1353,1636,283
2016,2,18,10,1374,1320,1680,360
2016,2,18,11,1379,1312,1653,341
2016,2,18,12,1418,1342,1513,171
2016,2,18,13,1523,1442,1425,-17
2016,2,18,14,1718,1641,1552,-89
2016,2,18,15,1860,1793,1573,-220
2016,2,18,16,1862,1799,1525,-274
2016,2,18,17,1854,1810,1547,-263
2016,2,18,18,1843,1777,1511,-266
2016,2,18,19,1826,1742,1455,-287
2016,2,18,20,1807,1717,1544,-173
2016,2,18,21,1787,1698,1640,-58
2016,2,18,22,1756,1679,1628,-51
2016,2,18,23,1738,1671,1638,-33
2016,2,19,0,1762,1711,1677,-34
2016,2,19,1,1822,1755,1692,-63
2016,2,19,2,1934,1840,1701,-139
2016,2,19,3,1945,1848,1685,-163
2016,2,19,4,1906,1814,1679,-135
2016,2,19,5,1826,1734,1697,-37
2016,2,19,6,1695,1616,1597,-19
2016,2,19,7,1575,1488,1623,135
2016,2,19,8,1442,1423,1544,121
2016,2,19,9,1431,1392,1518,126
2016,2,19,10,1408,1377,1510,133
2016,2,19,11,1408,1393,1517,124
2016,2,19,12,1445,1422,1443,21
2016,2,19,13,1553,1525,1358,-167
2016,2,19,14,1748,1724,1392,-332
2016,2,19,15,1889,1859,1565,-294
2016,2,19,16,1882,1841,1594,-247
2016,2,19,17,1848,1814,1623,-191
2016,2,19,18,1808,1791,1625,-166
2016,2,19,19,1764,1733,1631,-102
2016,2,19,20,1733,1683,1647,-36
2016,2,19,21,1706,1635,1602,-33
2016,2,19,22,1676,1605,1595,-10
2016,2,19,23,1660,1613,1533,-80
2016,2,20,0,1686,1643,1541,-102
2016,2,20,1,1704,1696,1594,-102
2016,2,20,2,1783,1768,1603,-165
2016,2,20,3,1788,1770,1734,-36
2016,2,20,4,1760,1748,1814,66
2016,2,20,5,1706,1707,1894,187
2016,2,20,6,1629,1622,1886,264
2016,2,20,7,1536,1523,1705,182
2016,2,20,8,1470,1458,1650,192
2016,2,20,9,1464,1426,1602,176
2016,2,20,10,1460,1425,1587,162
2016,2,20,11,1469,1409,1601,192
2016,2,20,12,1496,1440,1508,68
2016,2,20,13,1564,1505,1445,-60
2016,2,20,14,1671,1585,1461,-124
2016,2,20,15,1782,1706,1615,-91
2016,2,20,16,1845,1756,1660,-96
2016,2,20,17,1860,1752,1695,-57
2016,2,20,18,1840,1711,1746,35
2016,2,20,19,1795,1667,1728,61
2016,2,20,20,1742,1605,1676,71
2016,2,20,21,1696,1557,1643,86
2016,2,20,22,1664,1510,1637,127
2016,2,20,23,1655,1490,1541,51
2016,2,21,0,1673,1506,1488,-18
2016,2,21,1,1736,1581,1504,-77
2016,2,21,2,1835,1706,1519,-187
2016,2,21,3,1854,1744,1526,-218
2016,2,21,4,1843,1744,1522,-222
2016,2,21,5,1805,1698,1452,-246
2016,2,21,6,1727,1623,1410,-213
2016,2,21,7,1636,1541,1335,-206
2016,2,21,8,1542,1490,1380,-110
2016,2,21,9,1502,1464,1277,-187
2016,2,21,10,1488,1478,1454,-24
2016,2,21,11,1487,1479,1467,-12
2016,2,21,12,1504,1499,1422,-77
2016,2,21,13,1555,1558,1417,-141
2016,2,21,14,1650,1636,1435,-201
2016,2,21,15,1759,1747,1432,-315
2016,2,21,16,1815,1787,1422,-365
2016,2,21,17,1824,1761,1412,-349
2016,2,21,18,1797,1705,1441,-264
2016,2,21,19,1740,1643,1482,-161
2016,2,21,20,1701,1597,1439,-158
2016,2,21,21,1655,1550,1415,-135
2016,2,21,22,1625,1510,1366,-144
2016,2,21,23,1618,1509,1364,-145
2016,2,22,0,1635,1533,1341,-192
2016,2,22,1,1688,1623,1265,-358
2016,2,22,2,1783,1743,1349,-394
2016,2,22,3,1803,1786,1361,-425
2016,2,22,4,1793,1750,1336,-414
2016,2,22,5,1747,1684,1367,-317
2016,2,22,6,1640,1572,1356,-216
2016,2,22,7,1536,1457,1279,-178
2016,2,22,8,1475,1407,1311,-96
2016,2,22,9,1443,1397,1486,89
2016,2,22,10,1433,1396,1506,110
2016,2,22,11,1445,1415,1536,121
2016,2,22,12,1487,1470,1567,97
2016,2,22,13,1600,1593,1657,64
2016,2,22,14,1799,1816,1776,-40
2016,2,22,15,1948,1967,1907,-60
2016,2,22,16,1942,1939,1894,-45
2016,2,22,17,1904,1879,1792,-87
2016,2,22,18,1868,1837,1868,31
2016,2,22,19,1820,1802,1867,65
2016,2,22,20,1776,1740,1860,120
2016,2,22,21,1739,1718,1855,137
2016,2,22,22,1708,1687,1846,159
2016,2,22,23,1702,1669,1838,169
2016,2,23,0,1729,1683,1771,88
2016,2,23,1,1796,1727,1750,23
2016,2,23,2,1902,1855,1840,-15
2016,2,23,3,1923,1906,1909,3
2016,2,23,4,1908,1885,1893,8
2016,2,23,5,1847,1824,1793,-31
2016,2,23,6,1730,1699,1688,-11
2016,2,23,7,1622,1600,1440,-160
2016,2,23,8,1564,1534,1466,-68
2016,2,23,9,1544,1530,1447,-83
2016,2,23,10,1557,1534,1429,-105
2016,2,23,11,1569,1546,1457,-89
2016,2,23,12,1614,1597,1313,-284
2016,2,23,13,1740,1730,1330,-400
2016,2,23,14,1962,1954,1558,-396
2016,2,23,15,2113,2096,1675,-421
2016,2,23,16,2072,2036,1666,-370
2016,2,23,17,1994,1933,1650,-283
2016,2,23,18,1932,1866,1701,-165
2016,2,23,19,1880,1812,1775,-37
2016,2,23,20,1823,1739,1611,-128
2016,2,23,21,1777,1698,1588,-110
2016,2,23,22,1736,1663,1632,-31
2016,2,23,23,1718,1646,1622,-24
2016,2,24,0,1738,1645,1680,35
2016,2,24,1,1803,1692,1730,38
2016,2,24,2,1944,1822,1821,-1
2016,2,24,3,2006,1885,1738,-147
2016,2,24,4,1994,1876,1827,-49
2016,2,24,5,1930,1817,1845,28
2016,2,24,6,1803,1701,1811,110
2016,2,24,7,1686,1596,1782,186
2016,2,24,8,1547,1543,1778,235
2016,2,24,9,1515,1520,1772,252
2016,2,24,10,1525,1528,1757,229
2016,2,24,11,1531,1542,1712,170
2016,2,24,12,1574,1594,1720,126
2016,2,24,13,1700,1710,1630,-80
2016,2,24,14,1915,1918,1639,-279
2016,2,24,15,2055,2065,1605,-460
2016,2,24,16,2005,2010,1614,-396
2016,2,24,17,1935,1935,1601,-334
2016,2,24,18,1881,1847,1610,-237
2016,2,24,19,1837,1785,1615,-170
2016,2,24,20,1788,1709,1560,-149
2016,2,24,21,1743,1666,1487,-179
2016,2,24,22,1703,1626,1451,-175
2016,2,24,23,1680,1612,1449,-163
2016,2,25,0,1698,1625,1453,-172
2016,2,25,1,1748,1665,1455,-210
2016,2,25,2,1882,1773,1301,-472
2016,2,25,3,1947,1842,1393,-449
2016,2,25,4,1938,1826,1374,-452
2016,2,25,5,1874,1767,1330,-437
2016,2,25,6,1760,1639,1220,-419
2016,2,25,7,1656,1546,1258,-288
2016,2,25,8,1519,1491,1357,-134
2016,2,25,9,1507,1471,1283,-188
2016,2,25,10,1509,1483,1282,-201
2016,2,25,11,1524,1499,1296,-203
2016,2,25,12,1565,1554,1327,-227
2016,2,25,13,1678,1677,1438,-239
2016,2,25,14,1888,1907,1580,-327
2016,2,25,15,2023,2035,1609,-426
2016,2,25,16,1964,1970,1581,-389
2016,2,25,17,1884,1885,1543,-342
2016,2,25,18,1817,1810,1516,-294
2016,2,25,19,1773,1733,1492,-241
2016,2,25,20,1720,1690,1486,-204
2016,2,25,21,1680,1638,1442,-196
2016,2,25,22,1650,1588,1416,-172
2016,2,25,23,1632,1577,1412,-165
2016,2,26,0,1645,1574,1403,-171
2016,2,26,1,1693,1590,1414,-176
2016,2,26,2,1813,1701,1486,-215
2016,2,26,3,1879,1782,1567,-215
2016,2,26,4,1864,1769,1587,-182
2016,2,26,5,1801,1711,1532,-179
2016,2,26,6,1683,1591,1428,-163
2016,2,26,7,1583,1499,1399,-100
2016,2,26,8,1492,1438,1338,-100
2016,2,26,9,1460,1433,1451,18
2016,2,26,10,1466,1446,1499,53
2016,2,26,11,1482,1452,1492,40
2016,2,26,12,1528,1513,1557,44
2016,2,26,13,1646,1634,1692,58
2016,2,26,14,1861,1842,1796,-46
2016,2,26,15,1988,1971,1842,-129
2016,2,26,16,1920,1932,1843,-89
2016,2,26,17,1831,1856,1777,-79
2016,2,26,18,1767,1787,1788,1
2016,2,26,19,1716,1713,1758,45
2016,2,26,20,1665,1651,1761,110
2016,2,26,21,1626,1610,1733,123
2016,2,26,22,1602,1586,1740,154
2016,2,26,23,1592,1562,1783,221
2016,2,27,0,1606,1651,1784,133
2016,2,27,1,1632,1596,1779,183
2016,2,27,2,1718,1675,1911,236
2016,2,27,3,1761,1704,1951,247
2016,2,27,4,1742,1677,1933,256
2016,2,27,5,1692,1614,1892,278
2016,2,27,6,1608,1525,1764,239
2016,2,27,7,1517,1432,1620,188
2016,2,27,8,1426,1355,1533,178
2016,2,27,9,1394,1328,1439,111
2016,2,27,10,1369,1313,1369,56
2016,2,27,11,1375,1315,1361,46
2016,2,27,12,1396,1336,1375,39
2016,2,27,13,1455,1409,1447,38
2016,2,27,14,1547,1495,1550,55
2016,2,27,15,1617,1594,1723,129
2016,2,27,16,1634,1675,1785,110
2016,2,27,17,1626,1713,1854,141
2016,2,27,18,1609,1701,1908,207
2016,2,27,19,1586,1683,1974,291
2016,2,27,20,1548,1620,1919,299
2016,2,27,21,1518,1581,1869,288
2016,2,27,22,1501,1541,1792,251
2016,2,27,23,1490,1513,1718,205
2016,2,28,0,1499,1515,1696,181
2016,2,28,1,1554,1542,1673,131
2016,2,28,2,1660,1632,1713,81
2016,2,28,3,1707,1697,1786,89
2016,2,28,4,1689,1673,1744,71
2016,2,28,5,1639,1634,1713,79
2016,2,28,6,1557,1556,1657,101
2016,2,28,7,1475,1467,1534,67
2016,2,28,8,1430,1400,1433,33
2016,2,28,9,1406,1382,1406,24
2016,2,28,10,1405,1377,1354,-23
2016,2,28,11,1408,1389,1311,-78
2016,2,28,12,1426,1398,1252,-146
2016,2,28,13,1484,1458,1256,-202
2016,2,28,14,1573,1543,1334,-209
2016,2,28,15,1657,1626,1462,-164
2016,2,28,16,1690,1686,1510,-176
2016,2,28,17,1672,1657,1525,-132
2016,2,28,18,1644,1638,1570,-68
2016,2,28,19,1612,1577,1567,-10
2016,2,28,20,1585,1541,1558,17
2016,2,28,21,1555,1537,1563,26
2016,2,28,22,1536,1489,1495,6
2016,2,28,23,1523,1469,1498,29
2016,2,29,0,1538,1533,1544,11
2016,2,29,1,1582,1582,1567,-15
2016,2,29,2,1685,1665,1607,-58
2016,2,29,3,1739,1713,1674,-39
2016,2,29,4,1715,1674,1679,5
2016,2,29,5,1655,1603,1632,29
2016,2,29,6,1550,1485,1534,49
2016,2,29,7,1451,1366,1490,124
2016,2,29,8,1361,1312,1492,180
2016,2,29,9,1348,1280,1437,157
2016,2,29,10,1333,1286,1430,144
2016,2,29,11,1350,1310,1436,126
2016,2,29,12,1397,1369,1483,114
2016,2,29,13,1523,1511,1581,70
2016,2,29,14,1730,1746,1794,48
2016,2,29,15,1873,1898,1995,97
2016,2,29,16,1858,1849,1932,83
2016,2,29,17,1816,1806,1882,76
2016,2,29,18,1782,1754,1783,29
2016,2,29,19,1748,1695,1533,-162
2016,2,29,20,1713,1635,1437,-198
2016,2,29,21,1681,1622,1377,-245
2016,2,29,22,1649,1588,1296,-292
2016,2,29,23,1630,1560,1255,-305
2016,3,1,0,1647,1554,1282,-272
2016,3,1,1,1700,1598,1360,-238
2016,3,1,2,1803,1715,1444,-271
2016,3,1,3,1869,1803,1481,-322
2016,3,1,4,1850,1780,1449,-331
2016,3,1,5,1783,1708,1411,-297
2016,3,1,6,1670,1576,1349,-227
2016,3,1,7,1555,1451,1195,-256
2016,3,1,8,1497,1395,1137,-258
2016,3,1,9,1430,1365,1130,-235
2016,3,1,10,1393,1350,1131,-219
2016,3,1,11,1398,1364,1148,-216
2016,3,1,12,1431,1393,1174,-219
2016,3,1,13,1536,1506,1279,-227
2016,3,1,14,1733,1707,1459,-248
2016,3,1,15,1846,1847,1640,-207
2016,3,1,16,1804,1818,1537,-281
2016,3,1,17,1748,1770,1501,-269
2016,3,1,18,1706,1733,1481,-252
2016,3,1,19,1661,1698,1380,-318
2016,3,1,20,1617,1643,1315,-328
2016,3,1,21,1593,1606,1279,-327
2016,3,1,22,1568,1590,1330,-260
2016,3,1,23,1554,1567,1368,-199
2016,3,2,0,1567,1597,1397,-200
2016,3,2,1,1607,1655,1454,-201
2016,3,2,2,1714,1738,1519,-219
2016,3,2,3,1776,1774,1548,-226
2016,3,2,4,1747,1736,1522,-214
2016,3,2,5,1673,1663,1453,-210
2016,3,2,6,1552,1539,1359,-180
2016,3,2,7,1439,1397,1061,-336
2016,3,2,8,1378,1354,996,-358
2016,3,2,9,1350,1309,1075,-234
2016,3,2,10,1354,1308,1121,-187
2016,3,2,11,1370,1320,1187,-133
2016,3,2,12,1418,1358,1258,-100
2016,3,2,13,1531,1478,1335,-143
2016,3,2,14,1746,1698,1542,-156
2016,3,2,15,1878,1836,1627,-209
2016,3,2,16,1836,1798,1575,-223
2016,3,2,17,1780,1714,1485,-229
2016,3,2,18,1738,1670,1492,-178
2016,3,2,19,1697,1622,1453,-169
2016,3,2,20,1654,1570,1433,-137
2016,3,2,21,1632,1572,1427,-145
2016,3,2,22,1613,1573,1388,-185
2016,3,2,23,1597,1530,1311,-219
2016,3,3,0,1616,1532,1239,-293
2016,3,3,1,1668,1561,1277,-284
2016,3,3,2,1764,1658,1352,-306
2016,3,3,3,1814,1730,1416,-314
2016,3,3,4,1777,1714,1416,-298
2016,3,3,5,1696,1644,1358,-286
2016,3,3,6,1566,1520,1368,-152
2016,3,3,7,1445,1408,1283,-125
2016,3,3,8,1362,1345,1248,-97
2016,3,3,9,1339,1314,1186,-128
2016,3,3,10,1345,1307,1166,-141
2016,3,3,11,1354,1319,1176,-143
2016,3,3,12,1396,1351,1223,-128
2016,3,3,13,1500,1480,1323,-157
2016,3,3,14,1706,1696,1490,-206
2016,3,3,15,1812,1816,1452,-364
2016,3,3,16,1754,1799,1454,-345
2016,3,3,17,1710,1765,1366,-399
2016,3,3,18,1688,1737,1346,-391
2016,3,3,19,1657,1698,1289,-409
2016,3,3,20,1622,1622,1296,-326
2016,3,3,21,1601,1604,1309,-295
2016,3,3,22,1588,1588,1309,-9999
2016,3,3,23,1574,1574,1311,-9999
2016,3,4,0,1590,1590,1239,-9999
2016,3,4,1,1632,1632,1277,-9999
2016,3,4,2,1730,1730,1352,-9999
2016,3,4,3,1794,1794,1416,-9999
2016,3,4,4,1769,1769,1416,-9999
2016,3,4,5,1693,1693,1358,-9999
2016,3,4,6,1570,1570,1368,-9999
2016,3,4,7,1453,1453,1283,-9999
2016,3,4,8,1369,1369,1248,-9999
2016,3,4,9,1354,1352,1184,-168
2016,3,4,10,1373,1341,1149,-192
2016,3,4,11,1386,1363,1181,-182
2016,3,4,12,1434,1412,1192,-220
2016,3,4,13,1556,1533,1297,-236
2016,3,4,14,1782,1740,1479,-261
2016,3,4,15,1909,1851,1505,-346
2016,3,4,16,1859,1820,1471,-349
2016,3,4,17,1808,1747,1483,-264
2016,3,4,18,1769,1688,1526,-162
2016,3,4,19,1721,1647,1625,-22
2016,3,4,20,1657,1588,1648,60
2016,3,4,21,1638,1558,1593,35
2016,3,4,22,1615,1536,1554,18
2016,3,4,23,1599,1514,1505,-9
2016,3,5,0,1615,1509,1531,22
2016,3,5,1,1643,1502,1486,-16
2016,3,5,2,1697,1575,1532,-43
2016,3,5,3,1732,1618,1605,-13
2016,3,5,4,1705,1585,1563,-22
2016,3,5,5,1647,1532,1546,14
2016,3,5,6,1561,1444,1521,77
2016,3,5,7,1468,1357,1540,183
2016,3,5,8,1352,1292,1504,212
2016,3,5,9,1316,1247,1467,220
2016,3,5,10,1283,1243,1390,147
2016,3,5,11,1286,1242,1430,188
2016,3,5,12,1307,1249,1397,148
2016,3,5,13,1366,1313,1352,39
2016,3,5,14,1471,1391,1404,13
2016,3,5,15,1544,1485,1362,-123
2016,3,5,16,1581,1550,1364,-186
2016,3,5,17,1607,1577,1362,-215
2016,3,5,18,1597,1573,1348,-225
2016,3,5,19,1575,1563,1353,-210
2016,3,5,20,1524,1531,1357,-174
2016,3,5,21,1493,1492,1336,-156
2016,3,5,22,1465,1455,1329,-126
2016,3,5,23,1440,1452,1329,-123
2016,3,6,0,1440,1456,1354,-102
2016,3,6,1,1479,1487,1454,-33
2016,3,6,2,1559,1546,1548,2
2016,3,6,3,1614,1593,1595,2
2016,3,6,4,1590,1560,1652,92
2016,3,6,5,1536,1517,1799,282
2016,3,6,6,1454,1419,1806,387
2016,3,6,7,1367,1340,1773,433
2016,3,6,8,1317,1267,1711,444
2016,3,6,9,1271,1236,1687,451
2016,3,6,10,1257,1203,1615,412
2016,3,6,11,1256,1198,1523,325
2016,3,6,12,1274,1209,1493,284
2016,3,6,13,1319,1249,1514,265
2016,3,6,14,1403,1336,1463,127
2016,3,6,15,1475,1428,1515,87
2016,3,6,16,1522,1477,1531,54
2016,3,6,17,1553,1557,1533,-24
2016,3,6,18,1568,1587,1501,-86
2016,3,6,19,1563,1585,1528,-57
2016,3,6,20,1552,1568,1548,-20
2016,3,6,21,1533,1548,1531,-17
2016,3,6,22,1517,1545,1574,29
2016,3,6,23,1509,1522,1579,57
2016,3,7,0,1528,1543,1570,27
2016,3,7,1,1578,1603,1606,3
2016,3,7,2,1662,1679,1555,-124
2016,3,7,3,1726,1737,1558,-179
2016,3,7,4,1708,1721,1536,-185
2016,3,7,5,1655,1638,1448,-190
2016,3,7,6,1553,1547,1359,-188
2016,3,7,7,1460,1440,1349,-91
2016,3,7,8,1404,1395,1302,-93
2016,3,7,9,1382,1380,1336,-44
2016,3,7,10,1390,1379,1354,-25
2016,3,7,11,1408,1388,1413,25
2016,3,7,12,1453,1431,1439,8
2016,3,7,13,1568,1547,1439,-108
2016,3,7,14,1774,1765,1439,-326
2016,3,7,15,1908,1884,1475,-409
2016,3,7,16,1864,1843,1483,-360
2016,3,7,17,1827,1796,1448,-348
2016,3,7,18,1796,1749,1427,-322
2016,3,7,19,1763,1695,1394,-301
2016,3,7,20,1710,1648,1366,-282
2016,3,7,21,1679,1629,1378,-251
2016,3,7,22,1647,1593,1359,-234
2016,3,7,23,1620,1574,1346,-228
2016,3,8,0,1631,1576,1374,-202
2016,3,8,1,1678,1611,1428,-183
2016,3,8,2,1764,1702,1489,-213
2016,3,8,3,1834,1770,1520,-250
2016,3,8,4,1814,1758,1578,-180
2016,3,8,5,1742,1676,1537,-139
2016,3,8,6,1627,1558,1558,0
2016,3,8,7,1524,1445,1502,57
2016,3,8,8,1429,1393,1473,80
2016,3,8,9,1390,1357,1464,107
2016,3,8,10,1395,1360,1425,65
2016,3,8,11,1408,1371,1456,85
2016,3,8,12,1450,1420,1537,117
2016,3,8,13,1563,1546,1535,-11
2016,3,8,14,1778,1748,1553,-195
2016,3,8,15,1902,1861,1536,-325
2016,3,8,16,1867,1822,1473,-349
2016,3,8,17,1839,1766,1428,-338
2016,3,8,18,1810,1722,1448,-274
2016,3,8,19,1766,1679,1471,-208
2016,3,8,20,1714,1640,1536,-104
2016,3,8,21,1677,1613,1529,-84
2016,3,8,22,1642,1592,1499,-93
2016,3,8,23,1610,1582,1455,-127
2016,3,9,0,1618,1600,1415,-185
2016,3,9,1,1656,1630,1358,-272
2016,3,9,2,1742,1737,1347,-390
2016,3,9,3,1819,1786,1426,-360
2016,3,9,4,1802,1753,1391,-362
2016,3,9,5,1727,1683,1409,-274
2016,3,9,6,1608,1559,1399,-160
2016,3,9,7,1503,1446,1413,-33
2016,3,9,8,1418,1382,1405,23
2016,3,9,9,1400,1366,1433,67
2016,3,9,10,1397,1359,1454,95
2016,3,9,11,1412,1365,1453,88
2016,3,9,12,1457,1403,1458,55
2016,3,9,13,1568,1523,1485,-38
2016,3,9,14,1784,1741,1522,-219
2016,3,9,15,1908,1837,1560,-277
2016,3,9,16,1867,1805,1363,-442
2016,3,9,17,1825,1793,1300,-493
2016,3,9,18,1788,1736,1288,-448
2016,3,9,19,1742,1687,1282,-405
2016,3,9,20,1686,1644,1371,-273
2016,3,9,21,1646,1615,1390,-225
2016,3,9,22,1610,1623,1484,-139
2016,3,9,23,1578,1612,1499,-113
2016,3,10,0,1585,1641,1523,-118
2016,3,10,1,1623,1685,1503,-182
2016,3,10,2,1706,1770,1578,-192
2016,3,10,3,1771,1814,1649,-165
2016,3,10,4,1736,1772,1562,-210
2016,3,10,5,1647,1697,1640,-57
2016,3,10,6,1523,1540,1558,18
2016,3,10,7,1406,1417,1520,103
2016,3,10,8,1346,1346,1466,120
2016,3,10,9,1312,1319,1467,148
2016,3,10,10,1327,1303,1542,239
2016,3,10,11,1329,1315,1579,264
2016,3,10,12,1366,1336,1479,143
2016,3,10,13,1470,1446,1510,64
2016,3,10,14,1667,1636,1611,-25
2016,3,10,15,1763,1735,1622,-113
2016,3,10,16,1721,1716,1591,-125
2016,3,10,17,1692,1712,1661,-51
2016,3,10,18,1675,1700,1683,-17
2016,3,10,19,1648,1685,1687,2
2016,3,10,20,1620,1643,1649,6
2016,3,10,21,1605,1628,1631,3
2016,3,10,22,1600,1599,1601,2
2016,3,10,23,1594,1593,1526,-67
2016,3,11,0,1615,1611,1489,-122
2016,3,11,1,1660,1626,1483,-143
2016,3,11,2,1749,1695,1467,-228
2016,3,11,3,1797,1710,1431,-279
2016,3,11,4,1766,1686,1478,-208
2016,3,11,5,1683,1597,1421,-176
2016,3,11,6,1551,1487,1356,-131
2016,3,11,7,1436,1378,1325,-53
2016,3,11,8,1326,1312,1257,-55
2016,3,11,9,1319,1274,1184,-90
2016,3,11,10,1309,1266,1175,-91
2016,3,11,11,1319,1271,1162,-109
2016,3,11,12,1359,1313,1175,-138
2016,3,11,13,1468,1404,1270,-134
2016,3,11,14,1674,1584,1381,-203
2016,3,11,15,1780,1711,1539,-172
2016,3,11,16,1746,1719,1614,-105
2016,3,11,17,1724,1700,1646,-54
2016,3,11,18,1706,1692,1709,17
2016,3,11,19,1679,1669,1789,120
2016,3,11,20,1642,1633,1781,148
2016,3,11,21,1617,1611,1763,152
2016,3,11,22,1604,1578,1742,164
2016,3,11,23,1594,1558,1746,188
2016,3,12,0,1611,1562,1751,189
2016,3,12,1,1617,1583,1724,141
2016,3,12,2,1668,1622,1720,98
2016,3,12,3,1690,1655,1708,53
2016,3,12,4,1656,1608,1645,37
2016,3,12,5,1596,1558,1619,61
2016,3,12,6,1510,1467,1563,96
2016,3,12,7,1419,1380,1530,150
2016,3,12,8,1348,1291,1330,39
2016,3,12,9,1312,1260,1364,104
2016,3,12,10,1282,1236,1358,122
2016,3,12,11,1293,1253,1373,120
2016,3,12,12,1315,1268,1391,123
2016,3,12,13,1376,1328,1465,137
2016,3,12,14,1479,1409,1455,46
2016,3,12,15,1570,1509,1542,33
2016,3,12,16,1634,1565,1520,-45
2016,3,12,17,1664,1582,1505,-77
2016,3,12,18,1662,1577,1528,-49
2016,3,12,19,1641,1553,1431,-122
2016,3,12,20,1595,1514,1493,-21
2016,3,12,21,1552,1479,1456,-23
2016,3,12,22,1526,1458,1406,-52
2016,3,12,23,1509,1451,1443,-8
2016,3,13,0,1515,1463,1422,-41
2016,3,13,1,1553,1509,1320,-189
2016,3,13,2,1620,1578,1409,-169
2016,3,13,3,1663,1624,1544,-80
2016,3,13,4,1632,1583,1538,-45
2016,3,13,5,1581,1549,1431,-118
2016,3,13,6,1500,1466,1398,-68
2016,3,13,7,1413,1378,1329,-49
2016,3,13,8,1358,1316,1261,-55
2016,3,13,9,1320,1270,1141,-129
2016,3,13,10,1305,1264,1283,19
2016,3,13,11,1321,1281,1336,55
2016,3,13,12,1368,1300,1328,28
2016,3,13,13,1458,1361,1368,7
2016,3,13,14,1543,1447,1434,-13
2016,3,13,15,1601,1538,1507,-31
2016,3,13,16,1635,1596,1500,-96
2016,3,13,17,1640,1629,1517,-112
2016,3,13,18,1622,1634,1470,-164
2016,3,13,19,1598,1624,1453,-171
2016,3,13,20,1568,1596,1480,-116
2016,3,13,21,1555,1567,1457,-110
2016,3,13,22,1546,1565,1467,-98
2016,3,13,23,1565,1573,1431,-142
2016,3,14,0,1608,1597,1521,-76
2016,3,14,1,1676,1624,1397,-227
2016,3,14,2,1717,1661,1423,-238
2016,3,14,3,1686,1697,1435,-262
2016,3,14,4,1619,1650,1277,-373
2016,3,14,5,1510,1544,1178,-366
2016,3,14,6,1406,1427,1253,-174
2016,3,14,7,1335,1335,1244,-91
2016,3,14,8,1310,1339,1199,-140
2016,3,14,9,1340,1312,1220,-92
2016,3,14,10,1360,1319,1233,-86
2016,3,14,11,1407,1350,1268,-82
2016,3,14,12,1526,1476,1380,-96
2016,3,14,13,1743,1691,1504,-187
2016,3,14,14,1881,1877,1691,-186
2016,3,14,15,1877,1865,1781,-84
2016,3,14,16,1859,1860,1826,-34
2016,3,14,17,1837,1816,1796,-20
2016,3,14,18,1812,1790,1823,33
2016,3,14,19,1773,1749,1777,28
2016,3,14,20,1748,1720,1755,35
2016,3,14,21,1719,1693,1740,47
2016,3,14,22,1703,1677,1765,88
2016,3,14,23,1723,1691,1763,72
2016,3,15,0,1774,1705,1747,42
2016,3,15,1,1858,1735,1631,-104
2016,3,15,2,1904,1801,1622,-179
2016,3,15,3,1878,1851,1606,-245
2016,3,15,4,1804,1794,1488,-306
2016,3,15,5,1679,1677,1381,-296
2016,3,15,6,1560,1542,1315,-227
2016,3,15,7,1466,1460,1288,-172
2016,3,15,8,1457,1427,1135,-292
2016,3,15,9,1467,1425,1107,-318
2016,3,15,10,1476,1439,1136,-303
2016,3,15,11,1517,1458,1147,-311
2016,3,15,12,1628,1578,1162,-416
2016,3,15,13,1847,1773,1285,-488
2016,3,15,14,1989,1953,1425,-528
2016,3,15,15,1986,1943,1510,-433
2016,3,15,16,1951,1912,1515,-397
2016,3,15,17,1912,1882,1544,-338
2016,3,15,18,1872,1846,1636,-210
2016,3,15,19,1821,1823,1609,-214
2016,3,15,20,1779,1761,1562,-199
2016,3,15,21,1750,1737,1671,-66
2016,3,15,22,1728,1720,1688,-32
2016,3,15,23,1733,1733,1653,-80
2016,3,16,0,1759,1746,1613,-133
2016,3,16,1,1822,1772,1619,-153
2016,3,16,2,1877,1816,1558,-258
2016,3,16,3,1891,1889,1600,-289
2016,3,16,4,1837,1840,1584,-256
2016,3,16,5,1720,1722,1512,-210
2016,3,16,6,1598,1566,1449,-117
2016,3,16,7,1485,1476,1355,-121
2016,3,16,8,1470,1456,1355,-101
2016,3,16,9,1477,1437,1375,-62
2016,3,16,10,1494,1438,1365,-73
2016,3,16,11,1543,1476,1287,-189
2016,3,16,12,1658,1581,1263,-318
2016,3,16,13,1888,1799,1400,-399
2016,3,16,14,2053,1960,1458,-502
2016,3,16,15,2046,1946,1463,-483
2016,3,16,16,1995,1893,1421,-472
2016,3,16,17,1940,1839,1417,-422
2016,3,16,18,1884,1790,1472,-318
2016,3,16,19,1824,1749,1486,-263
2016,3,16,20,1771,1702,1544,-158
2016,3,16,21,1735,1676,1604,-72
2016,3,16,22,1701,1663,1582,-81
2016,3,16,23,1704,1642,1618,-24
2016,3,17,0,1716,1631,1642,11
2016,3,17,1,1749,1674,1667,-7
2016,3,17,2,1800,1706,1689,-17
2016,3,17,3,1843,1788,1712,-76
2016,3,17,4,1794,1744,1683,-61
2016,3,17,5,1681,1625,1586,-39
2016,3,17,6,1559,1489,1556,67
2016,3,17,7,1453,1422,1553,131
2016,3,17,8,1409,1388,1577,189
2016,3,17,9,1423,1390,1605,215
2016,3,17,10,1435,1399,1614,215
2016,3,17,11,1481,1437,1640,203
2016,3,17,12,1599,1547,1702,155
2016,3,17,13,1826,1759,1745,-14
2016,3,17,14,1998,1929,1755,-174
2016,3,17,15,1996,1904,1753,-151
2016,3,17,16,1948,1850,1696,-154
2016,3,17,17,1897,1793,1694,-99
2016,3,17,18,1840,1751,1727,-24
2016,3,17,19,1784,1688,1701,13
2016,3,17,20,1732,1668,1806,138
2016,3,17,21,1701,1658,1794,136
2016,3,17,22,1680,1619,1736,117
2016,3,17,23,1681,1607,1699,92
2016,3,18,0,1687,1606,1733,127
2016,3,18,1,1721,1612,1716,104
2016,3,18,2,1774,1662,1770,108
2016,3,18,3,1838,1761,1757,-4
2016,3,18,4,1796,1742,1735,-7
2016,3,18,5,1683,1646,1674,28
2016,3,18,6,1566,1536,1617,81
2016,3,18,7,1467,1483,1564,81
2016,3,18,8,1458,1457,1514,57
2016,3,18,9,1498,1458,1533,75
2016,3,18,10,1519,1473,1545,72
2016,3,18,11,1564,1520,1554,34
2016,3,18,12,1685,1646,1596,-50
2016,3,18,13,1916,1850,1750,-100
2016,3,18,14,2090,2012,1854,-158
2016,3,18,15,2072,1992,1875,-117
2016,3,18,16,1998,1918,1921,3
2016,3,18,17,1930,1861,1943,82
2016,3,18,18,1862,1794,1899,105
2016,3,18,19,1789,1732,1894,162
2016,3,18,20,1740,1686,1804,118
2016,3,18,21,1706,1634,1732,98
2016,3,18,22,1676,1601,1688,87
2016,3,18,23,1670,1568,1668,100
2016,3,19,0,1647,1564,1678,114
2016,3,19,1,1652,1559,1726,167
2016,3,19,2,1688,1615,1742,127
2016,3,19,3,1759,1705,1809,104
2016,3,19,4,1745,1683,1874,191
2016,3,19,5,1675,1618,1846,228
2016,3,19,6,1581,1532,1716,184
2016,3,19,7,1444,1463,1705,242
2016,3,19,8,1449,1432,1740,308
2016,3,19,9,1448,1439,1792,353
2016,3,19,10,1463,1445,1813,368
2016,3,19,11,1492,1471,1785,314
2016,3,19,12,1560,1526,1769,243
2016,3,19,13,1660,1618,1804,186
2016,3,19,14,1797,1745,1858,113
2016,3,19,15,1868,1795,1921,126
2016,3,19,16,1846,1798,1896,98
2016,3,19,17,1798,1764,1929,165
2016,3,19,18,1735,1697,2007,310
2016,3,19,19,1659,1626,1981,355
2016,3,19,20,1593,1568,1973,405
2016,3,19,21,1546,1514,1966,452
2016,3,19,22,1514,1482,1950,468
2016,3,19,23,1502,1470,1952,482
2016,3,20,0,1520,1475,1951,476
2016,3,20,1,1545,1490,1945,455
2016,3,20,2,1591,1522,1954,432
2016,3,20,3,1664,1613,1994,381
2016,3,20,4,1648,1601,1989,388
2016,3,20,5,1584,1524,1943,419
2016,3,20,6,1500,1437,1844,407
2016,3,20,7,1401,1381,1839,458
2016,3,20,8,1387,1360,1854,494
2016,3,20,9,1383,1354,1876,522
2016,3,20,10,1391,1356,1899,543
2016,3,20,11,1410,1369,1890,521
2016,3,20,12,1457,1417,1941,524
2016,3,20,13,1532,1497,1965,468
2016,3,20,14,1647,1607,1955,348
2016,3,20,15,1703,1661,1986,325
2016,3,20,16,1690,1643,1967,324
2016,3,20,17,1652,1606,2040,434
2016,3,20,18,1592,1555,2073,518
2016,3,20,19,1549,1503,2008,505
2016,3,20,20,1510,1452,1976,524
2016,3,20,21,1492,1421,1907,486
2016,3,20,22,1485,1408,1845,437
2016,3,20,23,1499,1414,1795,381
2016,3,21,0,1531,1429,1795,366
2016,3,21,1,1561,1457,1820,363
2016,3,21,2,1600,1494,1764,270
2016,3,21,3,1663,1576,1778,202
2016,3,21,4,1619,1539,1731,192
2016,3,21,5,1520,1445,1757,312
2016,3,21,6,1419,1323,1839,516
2016,3,21,7,1334,1266,1788,522
2016,3,21,8,1300,1226,1646,420
2016,3,21,9,1262,1209,1510,301
2016,3,21,10,1272,1220,1617,397
2016,3,21,11,1311,1255,1530,275
2016,3,21,12,1406,1351,1525,174
2016,3,21,13,1586,1512,1520,8
2016,3,21,14,1731,1661,1622,-39
2016,3,21,15,1707,1698,1655,-43
2016,3,21,16,1653,1700,1573,-127
2016,3,21,17,1618,1707,1578,-129
2016,3,21,18,1593,1674,1610,-64
2016,3,21,19,1565,1632,1591,-41
2016,3,21,20,1546,1615,1610,-5
2016,3,21,21,1532,1577,1610,33
2016,3,21,22,1519,1573,1618,45
2016,3,21,23,1520,1584,1593,9
2016,3,22,0,1538,1575,1560,-15
2016,3,22,1,1571,1587,1602,15
2016,3,22,2,1626,1610,1580,-30
2016,3,22,3,1703,1669,1635,-34
2016,3,22,4,1660,1620,1624,4
2016,3,22,5,1551,1532,1519,-13
2016,3,22,6,1436,1411,1654,243
2016,3,22,7,1389,1344,1553,209
2016,3,22,8,1352,1323,1379,56
2016,3,22,9,1340,1319,1397,78
2016,3,22,10,1350,1312,1422,110
2016,3,22,11,1387,1341,1366,25
2016,3,22,12,1489,1435,1431,-4
2016,3,22,13,1676,1608,1547,-61
2016,3,22,14,1822,1771,1599,-172
2016,3,22,15,1820,1793,1613,-180
2016,3,22,16,1800,1794,1610,-184
2016,3,22,17,1784,1789,1599,-190
2016,3,22,18,1756,1742,1595,-147
2016,3,22,19,1714,1719,1654,-65
2016,3,22,20,1680,1699,1667,-32
2016,3,22,21,1651,1666,1699,33
2016,3,22,22,1634,1647,1689,42
2016,3,22,23,1635,1629,1668,39
2016,3,23,0,1646,1643,1672,29
2016,3,23,1,1672,1642,1636,-6
2016,3,23,2,1722,1668,1623,-45
2016,3,23,3,1796,1757,1709,-48
2016,3,23,4,1756,1731,1698,-33
2016,3,23,5,1650,1614,1650,36
2016,3,23,6,1529,1513,1563,50
2016,3,23,7,1444,1433,1499,66
2016,3,23,8,1401,1406,1462,56
2016,3,23,9,1414,1394,1464,70
2016,3,23,10,1426,1408,1456,48
2016,3,23,11,1461,1440,1463,23
2016,3,23,12,1565,1535,1472,-63
2016,3,23,13,1757,1704,1489,-215
2016,3,23,14,1912,1859,1575,-284
2016,3,23,15,1916,1836,1505,-331
2016,3,23,16,1888,1807,1500,-307
2016,3,23,17,1846,1763,1484,-279
2016,3,23,18,1803,1704,1420,-284
2016,3,23,19,1755,1660,1387,-273
2016,3,23,20,1709,1653,1353,-300
2016,3,23,21,1674,1578,1354,-224
2016,3,23,22,1652,1553,1330,-223
2016,3,23,23,1645,1547,1453,-94
2016,3,24,0,1647,1535,1455,-80
2016,3,24,1,1659,1551,1476,-75
2016,3,24,2,1696,1572,1383,-189
2016,3,24,3,1783,1647,1234,-413
2016,3,24,4,1745,1640,1232,-408
2016,3,24,5,1646,1548,1180,-368
2016,3,24,6,1538,1433,1124,-309
2016,3,24,7,1417,1373,1206,-167
2016,3,24,8,1393,1347,1153,-194
2016,3,24,9,1380,1322,1116,-206
2016,3,24,10,1388,1321,1106,-215
2016,3,24,11,1415,1359,1123,-236
2016,3,24,12,1507,1435,1215,-220
2016,3,24,13,1685,1598,1334,-264
2016,3,24,14,1825,1737,1401,-336
2016,3,24,15,1822,1743,1397,-346
2016,3,24,16,1785,1767,1474,-293
2016,3,24,17,1742,1750,1466,-284
2016,3,24,18,1707,1704,1436,-268
2016,3,24,19,1668,1658,1406,-252
2016,3,24,20,1630,1633,1487,-146
2016,3,24,21,1605,1602,1507,-95
2016,3,24,22,1585,1568,1649,81
2016,3,24,23,1582,1575,1670,95
2016,3,25,0,1586,1553,1651,98
2016,3,25,1,1599,1574,1568,-6
2016,3,25,2,1638,1594,1570,-24
2016,3,25,3,1720,1707,1644,-63
2016,3,25,4,1679,1676,1597,-79
2016,3,25,5,1577,1579,1566,-13
2016,3,25,6,1470,1469,1523,54
2016,3,25,7,1404,1403,1541,138
2016,3,25,8,1391,1386,1524,138
2016,3,25,9,1394,1372,1517,145
2016,3,25,10,1405,1376,1461,85
2016,3,25,11,1447,1417,1419,2
2016,3,25,12,1552,1518,1452,-66
2016,3,25,13,1734,1652,1448,-204
2016,3,25,14,1885,1787,1467,-320
2016,3,25,15,1903,1802,1443,-359
2016,3,25,16,1882,1789,1477,-312
2016,3,25,17,1856,1747,1446,-301
2016,3,25,18,1815,1697,1451,-246
2016,3,25,19,1764,1659,1561,-98
2016,3,25,20,1731,1617,1547,-70
2016,3,25,21,1688,1591,1535,-56
2016,3,25,22,1660,1564,1498,-66
2016,3,25,23,1653,1552,1511,-41
2016,3,26,0,1628,1566,1538,-28
2016,3,26,1,1626,1601,1579,-22
2016,3,26,2,1658,1617,1527,-90
2016,3,26,3,1740,1704,1545,-159
2016,3,26,4,1736,1692,1518,-174
2016,3,26,5,1675,1621,1453,-168
2016,3,26,6,1586,1529,1367,-162
2016,3,26,7,1475,1463,1235,-228
2016,3,26,8,1434,1435,1124,-311
2016,3,26,9,1424,1424,1067,-357
2016,3,26,10,1434,1432,1078,-354
2016,3,26,11,1460,1462,1118,-344
2016,3,26,12,1517,1525,1158,-367
2016,3,26,13,1591,1633,1188,-445
2016,3,26,14,1705,1733,1050,-683
2016,3,26,15,1793,1774,1101,-673
2016,3,26,16,1805,1758,1162,-596
2016,3,26,17,1772,1704,1109,-595
2016,3,26,18,1721,1632,1129,-503
2016,3,26,19,1653,1563,1080,-483
2016,3,26,20,1590,1502,1085,-417
2016,3,26,21,1537,1458,1115,-343
2016,3,26,22,1501,1438,1164,-274
2016,3,26,23,1483,1429,1145,-284
2016,3,27,0,1502,1440,1140,-300
2016,3,27,1,1519,1468,1164,-304
2016,3,27,2,1544,1502,1187,-315
2016,3,27,3,1625,1607,1206,-401
2016,3,27,4,1628,1592,1241,-351
2016,3,27,5,1570,1515,1232,-283
2016,3,27,6,1485,1425,1279,-146
2016,3,27,7,1398,1358,1304,-54
2016,3,27,8,1366,1314,1260,-54
2016,3,27,9,1342,1299,1295,-4
2016,3,27,10,1334,1299,1289,-10
2016,3,27,11,1340,1300,1285,-15
2016,3,27,12,1368,1347,1328,-19
2016,3,27,13,1406,1410,1329,-81
2016,3,27,14,1494,1520,1388,-132
2016,3,27,15,1569,1590,1433,-157
2016,3,27,16,1600,1616,1356,-260
2016,3,27,17,1596,1595,1270,-325
2016,3,27,18,1566,1558,1156,-402
2016,3,27,19,1542,1533,1125,-408
2016,3,27,20,1505,1494,1199,-295
2016,3,27,21,1478,1456,1172,-284
2016,3,27,22,1459,1429,1197,-232
2016,3,27,23,1464,1399,1223,-176
2016,3,28,0,1497,1406,1161,-245
2016,3,28,1,1529,1452,1312,-140
2016,3,28,2,1568,1505,1282,-223
2016,3,28,3,1649,1607,1187,-420
2016,3,28,4,1630,1605,1194,-411
2016,3,28,5,1544,1504,1185,-319
2016,3,28,6,1446,1407,1162,-245
2016,3,28,7,1364,1342,1129,-213
2016,3,28,8,1342,1328,1104,-224
2016,3,28,9,1331,1321,1115,-206
2016,3,28,10,1342,1337,1204,-133
2016,3,28,11,1386,1393,1169,-224
2016,3,28,12,1492,1523,1219,-304
2016,3,28,13,1672,1741,1288,-453
2016,3,28,14,1830,1920,1385,-535
2016,3,28,15,1856,1894,1330,-564
2016,3,28,16,1849,1840,1316,-524
2016,3,28,17,1823,1794,1294,-500
2016,3,28,18,1786,1727,1297,-430
2016,3,28,19,1733,1685,1333,-352
2016,3,28,20,1689,1644,1308,-336
2016,3,28,21,1649,1607,1274,-333
2016,3,28,22,1620,1594,1264,-330
2016,3,28,23,1612,1585,1340,-245
2016,3,29,0,1629,1591,1349,-242
2016,3,29,1,1648,1613,1354,-259
2016,3,29,2,1684,1649,1367,-282
2016,3,29,3,1772,1735,1488,-247
2016,3,29,4,1747,1714,1514,-200
2016,3,29,5,1642,1591,1431,-160
2016,3,29,6,1529,1476,1398,-78
2016,3,29,7,1435,1410,1400,-10
2016,3,29,8,1365,1388,1334,-54
2016,3,29,9,1390,1390,1410,20
2016,3,29,10,1402,1397,1292,-105
2016,3,29,11,1446,1436,1205,-231
2016,3,29,12,1553,1550,1201,-349
2016,3,29,13,1750,1754,1290,-464
2016,3,29,14,1892,1928,1416,-512
2016,3,29,15,1879,1905,1455,-450
2016,3,29,16,1839,1862,1423,-439
2016,3,29,17,1796,1810,1368,-442
2016,3,29,18,1751,1760,1301,-459
2016,3,29,19,1705,1728,1270,-458
2016,3,29,20,1668,1697,1256,-441
2016,3,29,21,1630,1656,1235,-421
2016,3,29,22,1599,1634,1218,-416
2016,3,29,23,1589,1652,1212,-440
2016,3,30,0,1603,1664,1231,-433
2016,3,30,1,1629,1690,1260,-430
2016,3,30,2,1671,1706,1181,-525
2016,3,30,3,1764,1766,1244,-522
2016,3,30,4,1738,1728,1212,-516
2016,3,30,5,1620,1617,1259,-358
2016,3,30,6,1506,1476,1250,-226
2016,3,30,7,1364,1411,1227,-184
2016,3,30,8,1377,1374,1229,-145
2016,3,30,9,1394,1366,1156,-210
2016,3,30,10,1410,1364,1090,-274
2016,3,30,11,1451,1394,1061,-333
2016,3,30,12,1564,1514,1069,-445
2016,3,30,13,1770,1731,1195,-536
2016,3,30,14,1930,1880,1438,-442
2016,3,30,15,1918,1834,1424,-410
2016,3,30,16,1854,1797,1419,-378
2016,3,30,17,1790,1712,1350,-362
2016,3,30,18,1732,1675,1354,-321
2016,3,30,19,1684,1598,1151,-447
2016,3,30,20,1638,1565,1127,-438
2016,3,30,21,1594,1548,1063,-485
2016,3,30,22,1563,1523,1108,-415
2016,3,30,23,1560,1522,1171,-351
2016,3,31,0,1571,1523,1176,-347
2016,3,31,1,1585,1532,1210,-322
2016,3,31,2,1613,1550,1245,-305
2016,3,31,3,1704,1639,1291,-348
2016,3,31,4,1688,1628,1350,-278
2016,3,31,5,1583,1521,1320,-201
2016,3,31,6,1476,1390,1304,-86
2016,3,31,7,1363,1324,1239,-85
2016,3,31,8,1328,1281,1204,-77
2016,3,31,9,1314,1272,1175,-97
2016,3,31,10,1326,1292,1188,-104
2016,3,31,11,1364,1325,1211,-114
2016,3,31,12,1468,1446,1156,-290
2016,3,31,13,1674,1649,1245,-404
2016,3,31,14,1821,1800,1292,-508
2016,3,31,15,1794,1783,1280,-503
2016,3,31,16,1730,1747,1259,-488
2016,3,31,17,1678,1684,1191,-493
2016,3,31,18,1627,1639,1119,-520
2016,3,31,19,1578,1589,1084,-505
2016,3,31,20,1542,1556,1070,-486
2016,3,31,21,1511,1544,1086,-458
2016,3,31,22,1494,1523,1076,-447
2016,3,31,23,1496,1521,1099,-422
2016,4,1,0,1504,1506,1105,-401
2016,4,1,1,1517,1508,1187,-321
2016,4,1,2,1544,1531,1258,-273
2016,4,1,3,1640,1617,1274,-343
2016,4,1,4,1626,1606,1274,-332
2016,4,1,5,1520,1482,1196,-286
2016,4,1,6,1411,1357,1140,-217
2016,4,1,7,1342,1285,1096,-189
2016,4,1,8,1306,1251,1219,-32
2016,4,1,9,1282,1236,1238,2
2016,4,1,10,1295,1243,1246,3
2016,4,1,11,1334,1284,1269,-15
2016,4,1,12,1443,1397,1334,-63
2016,4,1,13,1652,1598,1386,-212
2016,4,1,14,1805,1747,1408,-339
2016,4,1,15,1774,1717,1295,-422
2016,4,1,16,1707,1679,1239,-440
2016,4,1,17,1648,1639,1213,-426
2016,4,1,18,1596,1601,1233,-368
2016,4,1,19,1557,1573,1186,-387
2016,4,1,20,1535,1548,1144,-404
2016,4,1,21,1514,1539,1133,-406
2016,4,1,22,1502,1514,1127,-387
2016,4,1,23,1498,1508,1127,-381
2016,4,2,0,1466,1493,1123,-370
2016,4,2,1,1463,1481,1146,-335
2016,4,2,2,1477,1486,1074,-412
2016,4,2,3,1560,1541,1076,-465
2016,4,2,4,1560,1560,1091,-469
2016,4,2,5,1485,1470,1073,-397
2016,4,2,6,1386,1366,1031,-335
2016,4,2,7,1322,1283,1017,-266
2016,4,2,8,1270,1239,1036,-203
2016,4,2,9,1241,1239,1057,-182
2016,4,2,10,1242,1241,1038,-203
2016,4,2,11,1259,1271,1087,-184
2016,4,2,12,1315,1317,1126,-191
2016,4,2,13,1412,1422,1211,-211
2016,4,2,14,1517,1538,1281,-257
2016,4,2,15,1551,1578,1297,-281
2016,4,2,16,1541,1572,1265,-307
2016,4,2,17,1518,1547,1169,-378
2016,4,2,18,1485,1507,1110,-397
2016,4,2,19,1448,1462,1063,-399
2016,4,2,20,1420,1438,1022,-416
2016,4,2,21,1404,1419,1066,-353
2016,4,2,22,1396,1417,1077,-340
2016,4,2,23,1393,1439,1129,-310
2016,4,3,0,1412,1441,1136,-305
2016,4,3,1,1425,1456,1150,-306
2016,4,3,2,1445,1437,1096,-341
2016,4,3,3,1519,1510,1163,-347
2016,4,3,4,1519,1501,1154,-347
2016,4,3,5,1438,1414,1149,-265
2016,4,3,6,1337,1307,1122,-185
2016,4,3,7,1266,1231,1040,-191
2016,4,3,8,1218,1191,1031,-160
2016,4,3,9,1194,1168,1026,-142
2016,4,3,10,1196,1167,1035,-132
2016,4,3,11,1215,1168,1028,-140
2016,4,3,12,1260,1207,1106,-101
2016,4,3,13,1347,1279,1116,-163
2016,4,3,14,1447,1358,1134,-224
2016,4,3,15,1485,1421,1063,-358
2016,4,3,16,1485,1477,1081,-396
2016,4,3,17,1470,1479,1135,-344
2016,4,3,18,1447,1464,1112,-352
2016,4,3,19,1445,1453,1081,-372
2016,4,3,20,1431,1438,1053,-385
2016,4,3,21,1424,1423,1055,-368
2016,4,3,22,1419,1418,991,-427
2016,4,3,23,1428,1445,1009,-436
2016,4,4,0,1452,1474,1027,-447
2016,4,4,1,1473,1487,1110,-377
2016,4,4,2,1490,1498,1079,-419
2016,4,4,3,1554,1560,1095,-465
2016,4,4,4,1527,1555,1111,-444
2016,4,4,5,1414,1422,1092,-330
2016,4,4,6,1294,1284,1063,-221
2016,4,4,7,1226,1209,1065,-144
2016,4,4,8,1188,1169,1050,-119
2016,4,4,9,1166,1152,1023,-129
2016,4,4,10,1171,1158,1029,-129
2016,4,4,11,1207,1184,1044,-140
2016,4,4,12,1299,1283,1135,-148
2016,4,4,13,1485,1502,1200,-302
2016,4,4,14,1615,1632,1184,-448
2016,4,4,15,1596,1649,1172,-477
2016,4,4,16,1574,1675,1194,-481
2016,4,4,17,1562,1686,1207,-479
2016,4,4,18,1551,1682,1239,-443
2016,4,4,19,1545,1668,1196,-472
2016,4,4,20,1543,1653,1147,-506
2016,4,4,21,1533,1607,1142,-465
2016,4,4,22,1526,1588,1249,-339
2016,4,4,23,1535,1568,1219,-349
2016,4,5,0,1555,1581,1254,-327
2016,4,5,1,1568,1594,1417,-177
2016,4,5,2,1583,1605,1453,-152
2016,4,5,3,1659,1670,1517,-153
2016,4,5,4,1640,1674,1519,-155
2016,4,5,5,1520,1560,1404,-156
2016,4,5,6,1393,1419,1175,-244
2016,4,5,7,1325,1337,1047,-290
2016,4,5,8,1308,1310,998,-312
2016,4,5,9,1318,1301,840,-461
2016,4,5,10,1331,1305,851,-454
2016,4,5,11,1372,1349,934,-415
2016,4,5,12,1482,1454,1016,-438
2016,4,5,13,1690,1675,1141,-534
2016,4,5,14,1836,1808,1269,-539
2016,4,5,15,1828,1790,1210,-580
2016,4,5,16,1810,1753,1223,-530
2016,4,5,17,1794,1716,1264,-452
2016,4,5,18,1765,1689,1305,-384
2016,4,5,19,1732,1654,1391,-263
2016,4,5,20,1699,1614,1382,-232
2016,4,5,21,1664,1593,1339,-254
2016,4,5,22,1634,1569,1354,-215
2016,4,5,23,1628,1573,1348,-225
2016,4,6,0,1634,1567,1310,-257
2016,4,6,1,1642,1574,1333,-241
2016,4,6,2,1649,1612,1497,-115
2016,4,6,3,1729,1705,1602,-103
2016,4,6,4,1720,1702,1625,-77
2016,4,6,5,1601,1582,1517,-65
2016,4,6,6,1466,1463,1516,53
2016,4,6,7,1335,1375,1329,-46
2016,4,6,8,1303,1349,1145,-204
2016,4,6,9,1334,1345,1057,-288
2016,4,6,10,1342,1345,1054,-291
2016,4,6,11,1384,1384,1090,-294
2016,4,6,12,1495,1495,956,-539
2016,4,6,13,1708,1731,1118,-613
2016,4,6,14,1851,1888,1251,-637
2016,4,6,15,1828,1836,1165,-671
2016,4,6,16,1786,1775,1147,-628
2016,4,6,17,1756,1707,1122,-585
2016,4,6,18,1721,1676,1035,-641
2016,4,6,19,1683,1630,1030,-600
2016,4,6,20,1650,1607,1043,-564
2016,4,6,21,1622,1598,1043,-555
2016,4,6,22,1599,1580,1079,-501
2016,4,6,23,1600,1590,1148,-442
2016,4,7,0,1608,1582,1226,-356
2016,4,7,1,1618,1604,1277,-327
2016,4,7,2,1633,1600,1227,-373
2016,4,7,3,1714,1674,1291,-383
2016,4,7,4,1704,1662,1297,-365
2016,4,7,5,1585,1520,1199,-321
2016,4,7,6,1454,1385,1127,-258
2016,4,7,7,1286,1311,1054,-257
2016,4,7,8,1284,1260,1018,-242
2016,4,7,9,1272,1242,976,-266
2016,4,7,10,1277,1259,1006,-253
2016,4,7,11,1318,1292,1025,-267
2016,4,7,12,1424,1406,1121,-285
2016,4,7,13,1640,1618,1194,-424
2016,4,7,14,1786,1762,1235,-527
2016,4,7,15,1753,1738,1233,-505
2016,4,7,16,1700,1704,1182,-522
2016,4,7,17,1670,1678,1191,-487
2016,4,7,18,1642,1540,1063,-477
2016,4,7,19,1616,1529,1063,-466
2016,4,7,20,1601,1632,1164,-468
2016,4,7,21,1594,1630,1123,-507
2016,4,7,22,1585,1631,1126,-505
2016,4,7,23,1594,1651,1135,-516
2016,4,8,0,1605,1655,1157,-498
2016,4,8,1,1619,1642,1147,-495
2016,4,8,2,1627,1640,1140,-500
2016,4,8,3,1686,1689,1171,-518
2016,4,8,4,1666,1667,1186,-481
2016,4,8,5,1530,1538,1172,-366
2016,4,8,6,1393,1394,1075,-319
2016,4,8,7,1292,1298,974,-324
2016,4,8,8,1251,1248,983,-265
2016,4,8,9,1249,1225,950,-275
2016,4,8,10,1253,1227,930,-297
2016,4,8,11,1290,1258,957,-301
2016,4,8,12,1395,1341,1046,-295
2016,4,8,13,1608,1526,1197,-329
2016,4,8,14,1740,1680,1329,-351
2016,4,8,15,1714,1669,1335,-334
2016,4,8,16,1686,1662,1321,-341
2016,4,8,17,1672,1670,1313,-357
2016,4,8,18,1658,1646,1256,-390
2016,4,8,19,1648,1628,1252,-376
2016,4,8,20,1651,1631,1206,-425
2016,4,8,21,1659,1633,1210,-423
2016,4,8,22,1665,1636,1182,-454
2016,4,8,23,1685,1643,1137,-506
2016,4,9,0,1656,1642,1116,-526
2016,4,9,1,1659,1636,1133,-503
2016,4,9,2,1649,1609,1116,-493
2016,4,9,3,1677,1649,1151,-498
2016,4,9,4,1652,1641,1282,-359
2016,4,9,5,1533,1531,1181,-350
2016,4,9,6,1403,1412,1090,-322
2016,4,9,7,1289,1312,1066,-246
2016,4,9,8,1243,1250,1001,-249
2016,4,9,9,1240,1229,989,-240
2016,4,9,10,1235,1207,982,-225
2016,4,9,11,1247,1216,1035,-181
2016,4,9,12,1294,1261,1066,-195
2016,4,9,13,1399,1341,1134,-207
2016,4,9,14,1489,1421,1190,-231
2016,4,9,15,1536,1515,1296,-219
2016,4,9,16,1565,1558,1326,-232
2016,4,9,17,1581,1581,1294,-287
2016,4,9,18,1585,1571,1302,-269
2016,4,9,19,1579,1562,1316,-246
2016,4,9,20,1577,1563,1257,-306
2016,4,9,21,1583,1580,1305,-275
2016,4,9,22,1588,1586,1322,-264
2016,4,9,23,1598,1619,1329,-290
2016,4,10,0,1616,1644,1341,-303
2016,4,10,1,1622,1648,1360,-288
2016,4,10,2,1615,1627,1305,-322
2016,4,10,3,1650,1640,1297,-343
2016,4,10,4,1634,1646,1453,-193
2016,4,10,5,1524,1539,1336,-203
2016,4,10,6,1398,1410,1223,-187
2016,4,10,7,1292,1320,1082,-238
2016,4,10,8,1257,1245,919,-326
2016,4,10,9,1247,1227,884,-343
2016,4,10,10,1236,1205,875,-330
2016,4,10,11,1242,1207,875,-332
2016,4,10,12,1275,1233,923,-310
2016,4,10,13,1353,1269,993,-276
2016,4,10,14,1437,1345,1100,-245
2016,4,10,15,1507,1427,1105,-322
2016,4,10,16,1556,1493,1131,-362
2016,4,10,17,1575,1517,1138,-379
2016,4,10,18,1577,1527,1133,-394
2016,4,10,19,1583,1549,1162,-387
2016,4,10,20,1580,1546,1183,-363
2016,4,10,21,1585,1563,1194,-369
2016,4,10,22,1588,1577,1198,-379
2016,4,10,23,1606,1615,1228,-387
2016,4,11,0,1632,1641,1265,-376
2016,4,11,1,1647,1649,1232,-417
2016,4,11,2,1646,1645,1224,-421
2016,4,11,3,1674,1672,1295,-377
2016,4,11,4,1648,1667,1349,-318
2016,4,11,5,1512,1502,1228,-274
2016,4,11,6,1372,1359,1130,-229
2016,4,11,7,1284,1268,1047,-221
2016,4,11,8,1244,1228,1009,-219
2016,4,11,9,1223,1199,969,-230
2016,4,11,10,1220,1204,976,-228
2016,4,11,11,1251,1233,1025,-208
2016,4,11,12,1343,1323,984,-339
2016,4,11,13,1531,1518,1096,-422
2016,4,11,14,1653,1649,1132,-517
2016,4,11,15,1655,1660,1136,-524
2016,4,11,16,1652,1678,1181,-497
2016,4,11,17,1655,1692,1215,-477
2016,4,11,18,1656,1703,1219,-484
2016,4,11,19,1653,1708,1184,-524
2016,4,11,20,1661,1707,1143,-564
2016,4,11,21,1676,1721,1134,-587
2016,4,11,22,1687,1740,1154,-586
2016,4,11,23,1709,1756,1273,-483
2016,4,12,0,1729,1765,1287,-478
2016,4,12,1,1733,1766,1236,-530
2016,4,12,2,1725,1736,1211,-525
2016,4,12,3,1752,1760,1286,-474
2016,4,12,4,1717,1766,1370,-396
2016,4,12,5,1562,1606,1247,-359
2016,4,12,6,1407,1435,1121,-314
2016,4,12,7,1328,1335,1025,-310
2016,4,12,8,1281,1297,914,-383
2016,4,12,9,1276,1269,883,-386
2016,4,12,10,1267,1266,874,-392
2016,4,12,11,1291,1297,903,-394
2016,4,12,12,1375,1379,968,-411
2016,4,12,13,1554,1562,1082,-480
2016,4,12,14,1666,1669,1186,-483
2016,4,12,15,1667,1691,1212,-479
2016,4,12,16,1678,1694,1260,-434
2016,4,12,17,1698,1715,1288,-427
2016,4,12,18,1713,1751,1274,-477
2016,4,12,19,1714,1741,1257,-484
2016,4,12,20,1718,1728,1131,-597
2016,4,12,21,1721,1712,1267,-445
2016,4,12,22,1717,1716,1397,-319
2016,4,12,23,1718,1702,1296,-406
2016,4,13,0,1720,1694,1381,-313
2016,4,13,1,1712,1690,1430,-260
2016,4,13,2,1694,1682,1409,-273
2016,4,13,3,1730,1748,1478,-270
2016,4,13,4,1718,1734,1489,-245
2016,4,13,5,1572,1609,1432,-177
2016,4,13,6,1419,1453,1397,-56
2016,4,13,7,1333,1374,1315,-59
2016,4,13,8,1310,1334,1374,40
2016,4,13,9,1316,1315,1391,76
2016,4,13,10,1311,1315,1395,80
2016,4,13,11,1337,1327,1435,108
2016,4,13,12,1427,1405,1394,-11
2016,4,13,13,1614,1622,1491,-131
2016,4,13,14,1727,1748,1474,-274
2016,4,13,15,1738,1748,1441,-307
2016,4,13,16,1750,1749,1509,-240
2016,4,13,17,1767,1742,1476,-266
2016,4,13,18,1774,1722,1375,-347
2016,4,13,19,1759,1713,1340,-373
2016,4,13,20,1743,1687,1307,-380
2016,4,13,21,1733,1677,1298,-379
2016,4,13,22,1734,1679,1312,-367
2016,4,13,23,1736,1671,1264,-407
2016,4,14,0,1739,1671,1292,-379
2016,4,14,1,1738,1678,1305,-373
2016,4,14,2,1724,1675,1286,-389
2016,4,14,3,1777,1747,1341,-406
2016,4,14,4,1773,1738,1383,-355
2016,4,14,5,1632,1592,1309,-283
2016,4,14,6,1482,1451,1416,-35
2016,4,14,7,1354,1373,1413,40
2016,4,14,8,1334,1331,1387,56
2016,4,14,9,1321,1316,1345,29
2016,4,14,10,1316,1305,1334,29
2016,4,14,11,1337,1338,1386,48
2016,4,14,12,1423,1435,1417,-18
2016,4,14,13,1625,1629,1530,-99
2016,4,14,14,1741,1769,1569,-200
2016,4,14,15,1750,1775,1563,-212
2016,4,14,16,1757,1767,1520,-247
2016,4,14,17,1766,1762,1536,-226
2016,4,14,18,1768,1751,1586,-165
2016,4,14,19,1753,1729,1550,-179
2016,4,14,20,1736,1713,1620,-93
2016,4,14,21,1724,1697,1585,-112
2016,4,14,22,1721,1680,1612,-68
2016,4,14,23,1718,1688,1624,-64
2016,4,15,0,1714,1687,1635,-52
2016,4,15,1,1717,1712,1653,-59
2016,4,15,2,1714,1707,1638,-69
2016,4,15,3,1781,1791,1755,-36
2016,4,15,4,1787,1779,1728,-51
2016,4,15,5,1657,1658,1598,-60
2016,4,15,6,1515,1536,1593,57
2016,4,15,7,1422,1453,1624,171
2016,4,15,8,1398,1419,1358,-61
2016,4,15,9,1418,1408,1455,47
2016,4,15,10,1421,1406,1449,43
2016,4,15,11,1450,1439,1471,32
2016,4,15,12,1555,1539,1538,-1
2016,4,15,13,1770,1748,1687,-61
2016,4,15,14,1902,1869,1802,-67
2016,4,15,15,1901,1873,1851,-22
2016,4,15,16,1886,1867,1948,81
2016,4,15,17,1867,1847,2022,175
2016,4,15,18,1848,1839,2025,186
2016,4,15,19,1813,1777,1973,196
2016,4,15,20,1784,1756,1949,193
2016,4,15,21,1760,1757,1955,198
2016,4,15,22,1749,1691,1897,206
2016,4,15,23,1748,1681,1888,207
2016,4,16,0,1701,1670,1866,196
2016,4,16,1,1694,1654,1848,194
2016,4,16,2,1684,1640,1816,176
2016,4,16,3,1742,1691,1813,122
2016,4,16,4,1752,1729,1826,97
2016,4,16,5,1662,1640,1722,82
2016,4,16,6,1545,1543,1669,126
2016,4,16,7,1401,1482,1587,105
2016,4,16,8,1384,1448,1555,107
2016,4,16,9,1431,1431,1544,113
2016,4,16,10,1433,1433,1526,93
2016,4,16,11,1454,1454,1517,63
2016,4,16,12,1514,1517,1526,9
2016,4,16,13,1630,1613,1526,-87
2016,4,16,14,1731,1675,1484,-191
2016,4,16,15,1792,1726,1493,-233
2016,4,16,16,1806,1729,1490,-239
2016,4,16,17,1790,1715,1474,-241
2016,4,16,18,1767,1677,1452,-225
2016,4,16,19,1722,1639,1463,-176
2016,4,16,20,1683,1608,1493,-115
2016,4,16,21,1659,1590,1486,-104
2016,4,16,22,1655,1567,1510,-57
2016,4,16,23,1657,1585,1618,33
2016,4,17,0,1679,1590,1671,81
2016,4,17,1,1689,1602,1740,138
2016,4,17,2,1684,1593,1710,117
2016,4,17,3,1736,1648,1737,89
2016,4,17,4,1748,1668,1727,59
2016,4,17,5,1653,1597,1656,59
2016,4,17,6,1548,1493,1623,130
2016,4,17,7,1392,1413,1447,34
2016,4,17,8,1387,1373,1456,83
2016,4,17,9,1380,1366,1486,120
2016,4,17,10,1376,1365,1583,218
2016,4,17,11,1389,1389,1579,190
2016,4,17,12,1429,1433,1548,115
2016,4,17,13,1506,1508,1522,14
2016,4,17,14,1578,1580,1519,-61
2016,4,17,15,1632,1639,1568,-71
2016,4,17,16,1657,1656,1594,-62
2016,4,17,17,1657,1658,1594,-64
2016,4,17,18,1646,1644,1616,-28
2016,4,17,19,1641,1625,1575,-50
2016,4,17,20,1623,1606,1563,-43
2016,4,17,21,1612,1586,1536,-50
2016,4,17,22,1611,1602,1532,-70
2016,4,17,23,1624,1633,1585,-48
2016,4,18,0,1652,1646,1537,-109
2016,4,18,1,1667,1653,1472,-181
2016,4,18,2,1668,1659,1486,-173
2016,4,18,3,1717,1704,1574,-130
2016,4,18,4,1711,1719,1609,-110
2016,4,18,5,1587,1592,1562,-30
2016,4,18,6,1467,1462,1497,35
2016,4,18,7,1382,1390,1519,129
2016,4,18,8,1357,1360,1510,150
2016,4,18,9,1360,1349,1590,241
2016,4,18,10,1363,1362,1640,278
2016,4,18,11,1401,1407,1608,201
2016,4,18,12,1504,1530,1556,26
2016,4,18,13,1715,1731,1549,-182
2016,4,18,14,1837,1851,1539,-312
2016,4,18,15,1826,1840,1481,-359
2016,4,18,16,1797,1828,1535,-293
2016,4,18,17,1786,1836,1549,-287
2016,4,18,18,1775,1827,1540,-287
2016,4,18,19,1755,1816,1538,-278
2016,4,18,20,1742,1817,1521,-296
2016,4,18,21,1730,1816,1521,-295
2016,4,18,22,1731,1833,1534,-299
2016,4,18,23,1741,1839,1578,-261
2016,4,19,0,1754,1841,1570,-271
2016,4,19,1,1761,1850,1571,-279
2016,4,19,2,1761,1850,1582,-268
2016,4,19,3,1806,1886,1608,-278
2016,4,19,4,1796,1888,1641,-247
2016,4,19,5,1659,1746,1538,-208
2016,4,19,6,1522,1596,1491,-105
2016,4,19,7,1426,1511,1439,-72
2016,4,19,8,1405,1465,1422,-43
2016,4,19,9,1452,1441,1395,-46
2016,4,19,10,1454,1428,1385,-43
2016,4,19,11,1490,1459,1403,-56
2016,4,19,12,1597,1554,1379,-175
2016,4,19,13,1803,1742,1301,-441
2016,4,19,14,1916,1867,1332,-535
2016,4,19,15,1896,1884,1339,-545
2016,4,19,16,1878,1859,1337,-522
2016,4,19,17,1874,1842,1334,-508
2016,4,19,18,1871,1860,1349,-511
2016,4,19,19,1862,1855,1361,-494
2016,4,19,20,1862,1865,1415,-450
2016,4,19,21,1865,1885,1467,-418
2016,4,19,22,1880,1897,1482,-415
2016,4,19,23,1899,1920,1500,-420
2016,4,20,0,1918,1944,1510,-434
2016,4,20,1,1928,1949,1513,-436
2016,4,20,2,1926,1954,1526,-428
2016,4,20,3,1957,1977,1556,-421
2016,4,20,4,1938,1980,1558,-422
2016,4,20,5,1776,1809,1449,-360
2016,4,20,6,1623,1648,1514,-134
2016,4,20,7,1442,1561,1516,-45
2016,4,20,8,1442,1493,1424,-69
2016,4,20,9,1475,1475,1399,-76
2016,4,20,10,1465,1466,1389,-77
2016,4,20,11,1493,1481,1426,-55
2016,4,20,12,1592,1573,1433,-140
2016,4,20,13,1787,1770,1524,-246
2016,4,20,14,1894,1895,1561,-334
2016,4,20,15,1895,1903,1536,-367
2016,4,20,16,1893,1924,1546,-378
2016,4,20,17,1901,1925,1557,-368
2016,4,20,18,1924,1943,1554,-389
2016,4,20,19,1940,1957,1516,-441
2016,4,20,20,1972,1976,1494,-482
2016,4,20,21,1997,1996,1405,-591
2016,4,20,22,2025,2037,1377,-660
2016,4,20,23,2057,2072,1448,-624
2016,4,21,0,2086,2085,1479,-606
2016,4,21,1,2101,2099,1499,-600
2016,4,21,2,2090,2082,1527,-555
2016,4,21,3,2096,2090,1445,-645
2016,4,21,4,2043,2057,1410,-647
2016,4,21,5,1846,1900,1375,-525
2016,4,21,6,1672,1719,1370,-349
2016,4,21,7,1510,1619,1392,-227
2016,4,21,8,1504,1570,1423,-147
2016,4,21,9,1526,1526,1476,-50
2016,4,21,10,1510,1522,1507,-15
2016,4,21,11,1527,1528,1479,-49
2016,4,21,12,1616,1608,1525,-83
2016,4,21,13,1812,1784,1582,-202
2016,4,21,14,1919,1898,1575,-323
2016,4,21,15,1927,1924,1584,-340
2016,4,21,16,1948,1951,1600,-351
2016,4,21,17,1976,1972,1603,-369
2016,4,21,18,2019,1988,1629,-359
2016,4,21,19,2064,2017,1662,-355
2016,4,21,20,2124,2049,1634,-415
2016,4,21,21,2174,2102,1690,-412
2016,4,21,22,2220,2123,1745,-378
2016,4,21,23,2262,2161,1855,-306
2016,4,22,0,2284,2164,1942,-222
2016,4,22,1,2296,2150,1890,-260
2016,4,22,2,2270,2114,1786,-328
2016,4,22,3,2236,2120,1790,-330
2016,4,22,4,2152,2108,1860,-248
2016,4,22,5,1943,1940,1713,-227
2016,4,22,6,1747,1787,1804,17
2016,4,22,7,1608,1657,1624,-33
2016,4,22,8,1604,1596,1489,-107
2016,4,22,9,1560,1549,1404,-145
2016,4,22,10,1539,1537,1361,-176
2016,4,22,11,1546,1549,1329,-220
2016,4,22,12,1626,1611,1305,-306
2016,4,22,13,1809,1782,1412,-370
2016,4,22,14,1913,1912,1437,-475
2016,4,22,15,1930,1965,1559,-406
2016,4,22,16,1962,1980,1572,-408
2016,4,22,17,1992,1993,1578,-415
2016,4,22,18,2019,2016,1632,-384
2016,4,22,19,2037,2007,1588,-419
2016,4,22,20,2057,2025,1623,-402
2016,4,22,21,2062,2023,1617,-406
2016,4,22,22,2055,2015,1590,-425
2016,4,22,23,2061,1987,1564,-423
2016,4,23,0,1965,1948,1569,-379
2016,4,23,1,1907,1906,1592,-314
2016,4,23,2,1851,1908,1705,-203
2016,4,23,3,1845,1944,1843,-101
2016,4,23,4,1845,1937,1856,-81
2016,4,23,5,1735,1838,1764,-74
2016,4,23,6,1609,1713,1761,48
2016,4,23,7,1578,1608,1584,-24
2016,4,23,8,1527,1574,1678,104
2016,4,23,9,1522,1533,1668,135
2016,4,23,10,1506,1526,1666,140
2016,4,23,11,1503,1530,1678,148
2016,4,23,12,1534,1554,1655,101
2016,4,23,13,1620,1624,1712,88
2016,4,23,14,1704,1710,1829,119
2016,4,23,15,1798,1812,1945,133
2016,4,23,16,1851,1881,1962,81
2016,4,23,17,1868,1920,2004,84
2016,4,23,18,1864,1920,2036,116
2016,4,23,19,1838,1879,2050,171
2016,4,23,20,1810,1833,2018,185
2016,4,23,21,1791,1809,2034,225
2016,4,23,22,1767,1780,2021,241
2016,4,23,23,1760,1768,2014,246
2016,4,24,0,1777,1749,2017,268
2016,4,24,1,1778,1764,2065,301
2016,4,24,2,1770,1742,2003,261
2016,4,24,3,1813,1773,1957,184
2016,4,24,4,1835,1779,1958,179
2016,4,24,5,1755,1707,1877,170
2016,4,24,6,1645,1590,1719,129
2016,4,24,7,1564,1500,1679,179
2016,4,24,8,1544,1437,1477,40
2016,4,24,9,1458,1411,1432,21
2016,4,24,10,1447,1404,1382,-22
2016,4,24,11,1449,1392,1354,-38
2016,4,24,12,1473,1441,1477,36
2016,4,24,13,1531,1493,1563,70
2016,4,24,14,1610,1562,1595,33
2016,4,24,15,1702,1649,1819,170
2016,4,24,16,1767,1677,1859,182
2016,4,24,17,1791,1680,1886,206
2016,4,24,18,1785,1675,1923,248
2016,4,24,19,1778,1659,1908,249
2016,4,24,20,1759,1632,1884,252
2016,4,24,21,1746,1620,1811,191
2016,4,24,22,1731,1604,1778,174
2016,4,24,23,1734,1629,1832,203
2016,4,25,0,1745,1646,1806,160
2016,4,25,1,1749,1646,1764,118
2016,4,25,2,1755,1652,1681,29
2016,4,25,3,1790,1702,1745,43
2016,4,25,4,1798,1716,1671,-45
2016,4,25,5,1684,1593,1567,-26
2016,4,25,6,1556,1485,1471,-14
2016,4,25,7,1565,1404,1376,-28
2016,4,25,8,1486,1377,1344,-33
2016,4,25,9,1372,1369,1300,-69
2016,4,25,10,1372,1378,1265,-113
2016,4,25,11,1401,1413,1288,-125
2016,4,25,12,1495,1511,1286,-225
2016,4,25,13,1687,1739,1379,-360
2016,4,25,14,1806,1872,1512,-360
2016,4,25,15,1837,1904,1579,-325
2016,4,25,16,1842,1894,1637,-257
2016,4,25,17,1846,1909,1720,-189
2016,4,25,18,1839,1889,1751,-138
2016,4,25,19,1813,1859,1759,-100
2016,4,25,20,1794,1843,1832,-11
2016,4,25,21,1774,1800,1852,52
2016,4,25,22,1752,1787,1850,63
2016,4,25,23,1741,1761,1833,72
2016,4,26,0,1733,1767,1875,108
2016,4,26,1,1726,1787,1930,143
2016,4,26,2,1726,1789,1882,93
2016,4,26,3,1775,1801,1787,-14
2016,4,26,4,1786,1825,1750,-75
2016,4,26,5,1674,1681,1568,-113
2016,4,26,6,1545,1548,1624,76
2016,4,26,7,1592,1475,1562,87
2016,4,26,8,1512,1437,1537,100
2016,4,26,9,1442,1437,1600,163
2016,4,26,10,1439,1422,1582,160
2016,4,26,11,1467,1462,1613,151
2016,4,26,12,1561,1546,1579,33
2016,4,26,13,1761,1750,1613,-137
2016,4,26,14,1891,1873,1730,-143
2016,4,26,15,1894,1861,1758,-103
2016,4,26,16,1889,1841,1763,-78
2016,4,26,17,1880,1829,1777,-52
2016,4,26,18,1864,1792,1764,-28
2016,4,26,19,1836,1775,1784,9
2016,4,26,20,1824,1760,1841,81
2016,4,26,21,1808,1743,1857,114
2016,4,26,22,1795,1728,1857,129
2016,4,26,23,1791,1732,1878,146
2016,4,27,0,1793,1725,1836,111
2016,4,27,1,1796,1730,1856,126
2016,4,27,2,1796,1745,1779,34
2016,4,27,3,1826,1819,1777,-42
2016,4,27,4,1828,1817,1633,-184
2016,4,27,5,1697,1678,1537,-141
2016,4,27,6,1560,1534,1542,8
2016,4,27,7,1546,1468,1535,67
2016,4,27,8,1482,1430,1476,46
2016,4,27,9,1437,1417,1456,39
2016,4,27,10,1432,1394,1446,52
2016,4,27,11,1462,1420,1405,-15
2016,4,27,12,1554,1510,1387,-123
2016,4,27,13,1754,1697,1440,-257
2016,4,27,14,1872,1833,1555,-278
2016,4,27,15,1865,1860,1579,-281
2016,4,27,16,1854,1859,1508,-351
2016,4,27,17,1846,1846,1416,-430
2016,4,27,18,1833,1831,1438,-393
2016,4,27,19,1815,1826,1443,-383
2016,4,27,20,1808,1810,1462,-348
2016,4,27,21,1794,1796,1500,-296
2016,4,27,22,1783,1790,1590,-200
2016,4,27,23,1780,1791,1623,-168
2016,4,28,0,1777,1572,1422,-150
2016,4,28,1,1781,1982,1860,-122
2016,4,28,2,1787,1782,1681,-101
2016,4,28,3,1828,1840,1723,-117
2016,4,28,4,1832,1855,1735,-120
2016,4,28,5,1694,1751,1661,-90
2016,4,28,6,1552,1602,1624,22
2016,4,28,7,1517,1511,1602,91
2016,4,28,8,1468,1488,1575,87
2016,4,28,9,1471,1462,1585,123
2016,4,28,10,1466,1462,1603,141
2016,4,28,11,1494,1493,1631,138
2016,4,28,12,1585,1574,1576,2
2016,4,28,13,1787,1758,1530,-228
2016,4,28,14,1914,1889,1553,-336
2016,4,28,15,1922,1912,1580,-332
2016,4,28,16,1913,1906,1584,-322
2016,4,28,17,1899,1886,1610,-276
2016,4,28,18,1882,1880,1616,-264
2016,4,28,19,1869,1869,1695,-174
2016,4,28,20,1866,1862,1701,-161
2016,4,28,21,1863,1853,1728,-125
2016,4,28,22,1864,1852,1712,-140
2016,4,28,23,1875,1847,1734,-113
2016,4,29,0,1877,1834,1750,-84
2016,4,29,1,1883,1825,1756,-69
2016,4,29,2,1882,1841,1799,-42
2016,4,29,3,1920,1887,1817,-70
2016,4,29,4,1919,1919,1749,-170
2016,4,29,5,1777,1812,1682,-130
2016,4,29,6,1625,1659,1601,-58
2016,4,29,7,1508,1572,1554,-18
2016,4,29,8,1486,1533,1538,5
2016,4,29,9,1520,1501,1489,-12
2016,4,29,10,1516,1502,1509,7
2016,4,29,11,1545,1514,1468,-46
2016,4,29,12,1632,1607,1531,-76
2016,4,29,13,1825,1775,1570,-205
2016,4,29,14,1951,1912,1563,-349
2016,4,29,15,1968,1959,1607,-352
2016,4,29,16,1960,1967,1627,-340
2016,4,29,17,1950,1959,1657,-302
2016,4,29,18,1937,1942,1667,-275
2016,4,29,19,1925,1928,1701,-227
2016,4,29,20,1918,1886,1654,-232
2016,4,29,21,1906,1863,1676,-187
2016,4,29,22,1895,1851,1696,-155
2016,4,29,23,1893,1842,1729,-113
2016,4,30,0,1843,1824,1776,-48
2016,4,30,1,1824,1801,1745,-56
2016,4,30,2,1820,1791,1738,-53
2016,4,30,3,1858,1877,1741,-136
2016,4,30,4,1884,1861,1808,-53
2016,4,30,5,1799,1785,1764,-21
2016,4,30,6,1676,1665,1688,23
2016,4,30,7,1526,1572,1601,29
2016,4,30,8,1517,1512,1484,-28
2016,4,30,9,1517,1496,1403,-93
2016,4,30,10,1506,1490,1319,-171
2016,4,30,11,1513,1505,1305,-200
2016,4,30,12,1550,1548,1356,-192
2016,4,30,13,1629,1620,1518,-102
2016,4,30,14,1716,1732,1580,-152
2016,4,30,15,1815,1810,1631,-179
2016,4,30,16,1859,1854,1642,-212
2016,4,30,17,1863,1850,1616,-234
2016,4,30,18,1849,1817,1601,-216
2016,4,30,19,1826,1785,1606,-179
2016,4,30,20,1797,1758,1569,-189
2016,4,30,21,1783,1755,1541,-214
2016,4,30,22,1779,1734,1504,-230
2016,4,30,23,1784,1723,1394,-329
2016,5,1,0,1801,1717,1353,-364
2016,5,1,1,1806,1718,1217,-501
2016,5,1,2,1807,1715,1321,-394
2016,5,1,3,1834,1732,1373,-359
2016,5,1,4,1857,1758,1354,-404
2016,5,1,5,1771,1693,1312,-381
2016,5,1,6,1647,1569,1306,-263
2016,5,1,7,1534,1497,1265,-232
2016,5,1,8,1487,1450,963,-487
2016,5,1,9,1446,1428,1040,-388
2016,5,1,10,1436,1414,1025,-389
2016,5,1,11,1442,1430,1034,-396
2016,5,1,12,1474,1467,1056,-411
2016,5,1,13,1537,1526,1095,-431
2016,5,1,14,1615,1587,1154,-433
2016,5,1,15,1701,1656,1263,-393
2016,5,1,16,1748,1687,1298,-389
2016,5,1,17,1758,1679,1400,-279
2016,5,1,18,1753,1670,1458,-212
2016,5,1,19,1756,1656,1440,-216
2016,5,1,20,1742,1636,1485,-151
2016,5,1,21,1737,1645,1530,-115
2016,5,1,22,1741,1650,1624,-26
2016,5,1,23,1754,1692,1670,-22
2016,5,2,0,1777,1716,1680,-36
2016,5,2,1,1792,1747,1706,-41
2016,5,2,2,1804,1754,1686,-68
2016,5,2,3,1833,1783,1633,-150
2016,5,2,4,1829,1819,1662,-157
2016,5,2,5,1700,1708,1583,-125
2016,5,2,6,1554,1543,1417,-126
2016,5,2,7,1507,1446,1231,-215
2016,5,2,8,1450,1411,1194,-217
2016,5,2,9,1407,1399,1188,-211
2016,5,2,10,1408,1393,1145,-248
2016,5,2,11,1443,1424,1100,-324
2016,5,2,12,1542,1519,1217,-302
2016,5,2,13,1742,1717,1412,-305
2016,5,2,14,1868,1863,1619,-244
2016,5,2,15,1888,1900,1632,-268
2016,5,2,16,1883,1926,1665,-261
2016,5,2,17,1875,1943,1671,-272
2016,5,2,18,1872,1937,1644,-293
2016,5,2,19,1867,1928,1458,-470
2016,5,2,20,1870,1924,1355,-569
2016,5,2,21,1874,1941,1332,-609
2016,5,2,22,1883,1933,1292,-641
2016,5,2,23,1896,1963,1307,-656
2016,5,3,0,1911,1982,1369,-613
2016,5,3,1,1923,1999,1368,-631
2016,5,3,2,1928,2014,1383,-631
2016,5,3,3,1950,2021,1440,-581
2016,5,3,4,1935,2040,1473,-567
2016,5,3,5,1787,1897,1368,-529
2016,5,3,6,1619,1696,1180,-516
2016,5,3,7,1569,1579,1070,-509
2016,5,3,8,1513,1522,849,-673
2016,5,3,9,1522,1502,820,-682
2016,5,3,10,1513,1494,847,-647
2016,5,3,11,1532,1516,875,-641
2016,5,3,12,1619,1601,986,-615
2016,5,3,13,1798,1767,1208,-559
2016,5,3,14,1925,1914,1323,-591
2016,5,3,15,1951,1946,1336,-610
2016,5,3,16,1973,1958,1271,-687
2016,5,3,17,1990,1972,1309,-663
2016,5,3,18,2008,1998,1359,-639
2016,5,3,19,2016,2015,1385,-630
2016,5,3,20,2037,2031,1402,-629
2016,5,3,21,2056,2063,1439,-624
2016,5,3,22,2071,2094,1474,-620
2016,5,3,23,2095,2130,1514,-616
2016,5,4,0,2122,2159,1544,-615
2016,5,4,1,2136,2194,1573,-621
2016,5,4,2,2134,2183,1597,-586
2016,5,4,3,2134,2191,1603,-588
2016,5,4,4,2102,2182,1621,-561
2016,5,4,5,1926,2014,1427,-587
2016,5,4,6,1732,1826,1246,-580
2016,5,4,7,1603,1719,1168,-551
2016,5,4,8,1576,1654,1177,-477
2016,5,4,9,1622,1622,1203,-419
2016,5,4,10,1606,1591,1238,-353
2016,5,4,11,1621,1607,1225,-382
2016,5,4,12,1705,1673,1255,-418
2016,5,4,13,1878,1850,1400,-450
2016,5,4,14,2014,1988,1526,-462
2016,5,4,15,2060,2015,1490,-525
2016,5,4,16,2094,2060,1474,-586
2016,5,4,17,2129,2080,1463,-617
2016,5,4,18,2172,2111,1456,-655
2016,5,4,19,2202,2140,1464,-676
2016,5,4,20,2232,2177,1519,-658
2016,5,4,21,2270,2216,1580,-636
2016,5,4,22,2295,2238,1592,-646
2016,5,4,23,2324,2251,1609,-642
2016,5,5,0,2344,2258,1700,-558
2016,5,5,1,2359,2250,1713,-537
2016,5,5,2,2336,2243,1645,-598
2016,5,5,3,2304,2255,1672,-583
2016,5,5,4,2254,2241,1549,-692
2016,5,5,5,2064,2078,1436,-642
2016,5,5,6,1857,1903,1306,-597
2016,5,5,7,1674,1800,1295,-505
2016,5,5,8,1697,1697,1246,-451
2016,5,5,9,1677,1667,1214,-453
2016,5,5,10,1644,1632,1221,-411
2016,5,5,11,1650,1643,1161,-482
2016,5,5,12,1719,1729,1224,-505
2016,5,5,13,1885,1881,1259,-622
2016,5,5,14,2014,1990,1380,-610
2016,5,5,15,2061,2052,1410,-642
2016,5,5,16,2101,2089,1495,-594
2016,5,5,17,2129,2106,1585,-521
2016,5,5,18,2157,2123,1497,-626
2016,5,5,19,2178,2132,1519,-613
2016,5,5,20,2203,2170,1553,-617
2016,5,5,21,2241,2199,1588,-611
2016,5,5,22,2270,2238,1713,-525
2016,5,5,23,2300,2233,1672,-561
2016,5,6,0,2324,2211,1600,-611
2016,5,6,1,2347,1743,1204,-539
2016,5,6,2,2337,2648,2078,-570
2016,5,6,3,2309,2181,1648,-533
2016,5,6,4,2257,2197,1696,-501
2016,5,6,5,2071,2028,1575,-453
2016,5,6,6,1864,1860,1573,-287
2016,5,6,7,1745,1756,1464,-292
2016,5,6,8,1697,1706,1614,-92
2016,5,6,9,1500,1670,1455,-215
2016,5,6,10,1473,1649,1441,-208
2016,5,6,11,1486,1639,1427,-212
2016,5,6,12,1562,1701,1466,-235
2016,5,6,13,1726,1867,1621,-246
2016,5,6,14,1845,1987,1464,-523
2016,5,6,15,1891,2050,1450,-600
2016,5,6,16,1927,2058,1463,-595
2016,5,6,17,1965,2093,1495,-598
2016,5,6,18,1994,2098,1507,-591
2016,5,6,19,2024,2091,1540,-551
2016,5,6,20,2057,2098,1618,-480
2016,5,6,21,2077,2090,1612,-478
2016,5,6,22,2051,2066,1582,-484
2016,5,6,23,2025,2060,1687,-373
2016,5,7,0,1908,2057,1720,-337
2016,5,7,1,1853,2045,1727,-318
2016,5,7,2,1815,2023,1746,-277
2016,5,7,3,1800,2008,1680,-328
2016,5,7,4,1818,1995,1651,-344
2016,5,7,5,1719,1896,1569,-327
2016,5,7,6,1586,1758,1525,-233
2016,5,7,7,1713,1661,1444,-217
2016,5,7,8,1558,1608,1354,-254
2016,5,7,9,1348,1574,1312,-262
2016,5,7,10,1326,1554,1288,-266
2016,5,7,11,1319,1549,1297,-252
2016,5,7,12,1338,1574,1310,-264
2016,5,7,13,1378,1627,1354,-273
2016,5,7,14,1424,1698,1376,-322
2016,5,7,15,1538,1778,1442,-336
2016,5,7,16,1610,1839,1499,-340
2016,5,7,17,1651,1870,1518,-352
2016,5,7,18,1673,1870,1559,-311
2016,5,7,19,1673,1859,1563,-296
2016,5,7,20,1676,1855,1571,-284
2016,5,7,21,1674,1864,1537,-327
2016,5,7,22,1670,1857,1495,-362
2016,5,7,23,1668,1866,1508,-358
2016,5,8,0,1680,1882,1505,-377
2016,5,8,1,1694,1897,1493,-404
2016,5,8,2,1680,1876,1479,-397
2016,5,8,3,1666,1860,1487,-373
2016,5,8,4,1659,1867,1483,-384
2016,5,8,5,1557,1763,1415,-348
2016,5,8,6,1424,1647,1304,-343
2016,5,8,7,1606,1542,1250,-292
2016,5,8,8,1430,1489,1337,-152
2016,5,8,9,1261,1449,1259,-190
2016,5,8,10,1238,1440,1247,-193
2016,5,8,11,1231,1424,1250,-174
2016,5,8,12,1244,1456,1333,-123
2016,5,8,13,1274,1470,1357,-113
2016,5,8,14,1316,1531,1381,-150
2016,5,8,15,1414,1624,1447,-177
2016,5,8,16,1483,1691,1557,-134
2016,5,8,17,1526,1723,1589,-134
2016,5,8,18,1546,1717,1656,-61
2016,5,8,19,1573,1734,1771,37
2016,5,8,20,1596,1735,1761,26
2016,5,8,21,1628,1733,1736,3
2016,5,8,22,1656,1743,1653,-90
2016,5,8,23,1710,1784,1689,-95
2016,5,9,0,1759,1809,1723,-86
2016,5,9,1,1773,1840,1753,-87
2016,5,9,2,1756,1854,1756,-98
2016,5,9,3,1734,1857,1886,29
2016,5,9,4,1691,1883,1895,12
2016,5,9,5,1530,1762,1851,89
2016,5,9,6,1359,1581,1669,88
2016,5,9,7,1467,1471,1669,198
2016,5,9,8,1324,1410,1493,83
2016,5,9,9,1225,1371,1507,136
2016,5,9,10,1213,1365,1357,-8
2016,5,9,11,1236,1381,1358,-23
2016,5,9,12,1324,1469,1441,-28
2016,5,9,13,1497,1635,1719,84
2016,5,9,14,1610,1755,1752,-3
2016,5,9,15,1660,1830,1844,14
2016,5,9,16,1670,1859,1989,130
2016,5,9,17,1677,1880,1994,114
2016,5,9,18,1664,1898,2015,117
2016,5,9,19,1649,1881,2035,154
2016,5,9,20,1671,1878,2106,228
2016,5,9,21,1660,1868,2106,238
2016,5,9,22,1642,1855,2093,238
2016,5,9,23,1633,1829,2068,239
2016,5,10,0,1636,1835,2009,174
2016,5,10,1,1629,1837,1993,156
2016,5,10,2,1625,1831,1906,75
2016,5,10,3,1634,1855,1885,30
2016,5,10,4,1640,1877,1775,-102
2016,5,10,5,1525,1771,1583,-188
2016,5,10,6,1383,1596,1331,-265
2016,5,10,7,1441,1514,1298,-216
2016,5,10,8,1355,1486,1382,-104
2016,5,10,9,1224,1473,1380,-93
2016,5,10,10,1226,1462,1315,-147
2016,5,10,11,1252,1498,1401,-97
2016,5,10,12,1339,1580,1423,-157
2016,5,10,13,1507,1776,1576,-200
2016,5,10,14,1611,1893,1569,-324
2016,5,10,15,1606,1918,1607,-311
2016,5,10,16,1601,1932,1620,-312
2016,5,10,17,1600,1935,1576,-359
2016,5,10,18,1586,1930,1473,-457
2016,5,10,19,1571,1920,1443,-477
2016,5,10,20,1594,1910,1425,-485
2016,5,10,21,1590,1900,1379,-521
2016,5,10,22,1580,1889,1415,-474
2016,5,10,23,1578,1902,1523,-379
2016,5,11,0,1587,1916,1511,-405
2016,5,11,1,1591,1934,1543,-391
2016,5,11,2,1593,1948,1535,-413
2016,5,11,3,1602,1968,1548,-420
2016,5,11,4,1597,2002,1526,-476
2016,5,11,5,1448,1873,1455,-418
2016,5,11,6,1298,1703,1345,-358
2016,5,11,7,1388,1609,1302,-307
2016,5,11,8,1253,1570,1178,-392
2016,5,11,9,1275,1558,1165,-393
2016,5,11,10,1271,1555,1178,-377
2016,5,11,11,1296,1573,1233,-340
2016,5,11,12,1380,1681,1248,-433
2016,5,11,13,1549,1842,1301,-541
2016,5,11,14,1665,1980,1376,-604
2016,5,11,15,1684,2002,1363,-639
2016,5,11,16,1701,2025,1511,-514
2016,5,11,17,1721,2015,1513,-502
2016,5,11,18,1734,2027,1537,-490
2016,5,11,19,1742,2024,1495,-529
2016,5,11,20,1764,2016,1479,-537
2016,5,11,21,1774,2016,1562,-454
2016,5,11,22,1780,1757,1327,-430
2016,5,11,23,1796,2038,1539,-499
2016,5,12,0,1819,2058,1534,-524
2016,5,12,1,1838,2078,1617,-461
2016,5,12,2,1845,2121,1667,-454
2016,5,12,3,1856,2132,1650,-482
2016,5,12,4,1830,2141,1597,-544
2016,5,12,5,1654,2003,1506,-497
2016,5,12,6,1468,1829,1519,-310
2016,5,12,7,1333,1735,1443,-292
2016,5,12,8,1304,1675,1680,5
2016,5,12,9,1616,1617,1649,32
2016,5,12,10,1606,1618,1652,34
2016,5,12,11,1628,1633,1631,-2
2016,5,12,12,1717,1735,1591,-144
2016,5,12,13,1890,1879,1561,-318
2016,5,12,14,2031,2006,1558,-448
2016,5,12,15,2098,2063,1666,-397
2016,5,12,16,2158,2088,1772,-316
2016,5,12,17,2204,2095,1807,-288
2016,5,12,18,2241,2109,1785,-324
2016,5,12,19,2273,2129,1772,-357
2016,5,12,20,2301,2170,1756,-414
2016,5,12,21,2335,2195,1780,-415
2016,5,12,22,2378,2217,1826,-391
2016,5,12,23,2477,2247,1922,-325
2016,5,13,0,2520,2264,1909,-355
2016,5,13,1,2549,2297,1934,-363
2016,5,13,2,2555,2287,1932,-355
2016,5,13,3,2539,2292,1926,-366
2016,5,13,4,2463,2282,1908,-374
2016,5,13,5,2243,2116,1742,-374
2016,5,13,6,2013,1919,1560,-359
2016,5,13,7,1472,1803,1329,-474
2016,5,13,8,1582,1726,1220,-506
2016,5,13,9,1673,1679,1218,-461
2016,5,13,10,1646,1643,1226,-417
2016,5,13,11,1660,1648,1209,-439
2016,5,13,12,1742,1719,1275,-444
2016,5,13,13,1901,1866,1526,-340
2016,5,13,14,2024,2028,1630,-398
2016,5,13,15,2092,2086,1628,-458
2016,5,13,16,2157,2163,1650,-513
2016,5,13,17,2204,2204,1631,-573
2016,5,13,18,2243,2250,1662,-588
2016,5,13,19,2273,2289,1689,-600
2016,5,13,20,2332,2311,1705,-606
2016,5,13,21,2367,2367,1717,-650
2016,5,13,22,2404,2408,1713,-695
2016,5,13,23,2476,2456,1807,-649
2016,5,14,0,2403,2470,1854,-616
2016,5,14,1,2409,2469,1859,-610
2016,5,14,2,2401,2441,1788,-653
2016,5,14,3,2358,2392,1748,-644
2016,5,14,4,2271,2399,1895,-504
2016,5,14,5,2085,2258,1755,-503
2016,5,14,6,1881,2077,1676,-401
2016,5,14,7,1692,1915,1530,-385
2016,5,14,8,1712,1828,1443,-385
2016,5,14,9,1761,1766,1412,-354
2016,5,14,10,1704,1708,1496,-212
2016,5,14,11,1683,1699,1533,-166
2016,5,14,12,1701,1711,1524,-187
2016,5,14,13,1742,1748,1601,-147
2016,5,14,14,1840,1847,1639,-208
2016,5,14,15,1979,1976,1814,-162
2016,5,14,16,2090,2054,1877,-177
2016,5,14,17,2146,2097,1908,-189
2016,5,14,18,2190,2127,1884,-243
2016,5,14,19,2228,2151,1804,-347
2016,5,14,20,2264,2184,1798,-386
2016,5,14,21,2303,2188,1828,-360
2016,5,14,22,2323,2182,1895,-287
2016,5,14,23,2325,2207,1964,-243
2016,5,15,0,2324,2259,1928,-331
2016,5,15,1,2308,2279,1900,-379
2016,5,15,2,2268,2275,1869,-406
2016,5,15,3,2196,2223,1804,-419
2016,5,15,4,2147,2204,1772,-432
2016,5,15,5,2006,2056,1636,-420
2016,5,15,6,1816,1909,1502,-407
2016,5,15,7,1685,1761,1414,-347
2016,5,15,8,1697,1690,1423,-267
2016,5,15,9,1645,1641,1362,-279
2016,5,15,10,1605,1635,1378,-257
2016,5,15,11,1584,1621,1379,-242
2016,5,15,12,1594,1647,1406,-241
2016,5,15,13,1613,1646,1421,-225
2016,5,15,14,1682,1698,1441,-257
2016,5,15,15,1800,1765,1564,-201
2016,5,15,16,1887,1828,1668,-160
2016,5,15,17,1921,1849,1679,-170
2016,5,15,18,1935,1871,1713,-158
2016,5,15,19,1960,1877,1721,-156
2016,5,15,20,1997,1863,1678,-185
2016,5,15,21,2017,1834,1673,-161
2016,5,15,22,2042,1834,1718,-116
2016,5,15,23,2086,1835,1764,-71
2016,5,16,0,2119,1859,1765,-94
2016,5,16,1,2132,1880,1768,-112
2016,5,16,2,2113,1877,1730,-147
2016,5,16,3,2052,1892,1768,-124
2016,5,16,4,2019,1920,1782,-138
2016,5,16,5,1874,1813,1774,-39
2016,5,16,6,1703,1662,1694,32
2016,5,16,7,1612,1573,1625,52
2016,5,16,8,1581,1530,1570,40
2016,5,16,9,1492,1521,1546,25
2016,5,16,10,1478,1514,1553,39
2016,5,16,11,1493,1536,1554,18
2016,5,16,12,1577,1620,1617,-3
2016,5,16,13,1738,1793,1631,-162
2016,5,16,14,1865,1959,1769,-190
2016,5,16,15,1957,2017,1740,-277
2016,5,16,16,1991,2045,1753,-292
2016,5,16,17,2015,2075,1711,-364
2016,5,16,18,2040,2074,1611,-463
2016,5,16,19,2045,2061,1500,-561
2016,5,16,20,2062,2053,1447,-606
2016,5,16,21,2079,2053,1396,-657
2016,5,16,22,2094,2048,1315,-733
2016,5,16,23,2127,2044,1286,-758
2016,5,17,0,2136,2054,1304,-750
2016,5,17,1,2145,2037,1293,-744
2016,5,17,2,2148,2036,1294,-742
2016,5,17,3,2150,2051,1323,-728
2016,5,17,4,2146,2072,1400,-672
2016,5,17,5,1997,1967,1324,-643
2016,5,17,6,1830,1800,1252,-548
2016,5,17,7,1779,1687,1157,-530
2016,5,17,8,1721,1629,995,-634
2016,5,17,9,1616,1605,998,-607
2016,5,17,10,1599,1596,1022,-574
2016,5,17,11,1607,1600,1027,-573
2016,5,17,12,1682,1680,1102,-578
2016,5,17,13,1835,1844,1242,-602
2016,5,17,14,1967,1983,1373,-610
2016,5,17,15,2001,2031,1449,-582
2016,5,17,16,2043,2046,1480,-566
2016,5,17,17,2077,2069,1494,-575
2016,5,17,18,2107,2085,1447,-638
2016,5,17,19,2124,2080,1410,-670
2016,5,17,20,2148,2098,1376,-722
2016,5,17,21,2167,2097,1372,-725
2016,5,17,22,2191,2122,1404,-718
2016,5,17,23,2227,2150,1477,-673
2016,5,18,0,2242,2166,1521,-645
2016,5,18,1,2256,2187,1545,-642
2016,5,18,2,2256,2189,1590,-599
2016,5,18,3,2259,2187,1626,-561
2016,5,18,4,2242,2205,1708,-497
2016,5,18,5,2088,2070,1677,-393
2016,5,18,6,1893,1891,1586,-305
2016,5,18,7,1856,1770,1483,-287
2016,5,18,8,1786,1705,1565,-140
2016,5,18,9,1674,1670,1639,-31
2016,5,18,10,1651,1640,1631,-9
2016,5,18,11,1653,1667,1644,-23
2016,5,18,12,1723,1724,1539,-185
2016,5,18,13,1886,1868,1619,-249
2016,5,18,14,2033,2014,1579,-435
2016,5,18,15,2082,2074,1628,-446
2016,5,18,16,2124,2099,1653,-446
2016,5,18,17,2159,2151,1695,-456
2016,5,18,18,2194,2158,1675,-483
2016,5,18,19,2212,2197,1665,-532
2016,5,18,20,2233,2233,1698,-535
2016,5,18,21,2249,2254,1727,-527
2016,5,18,22,2270,2298,1753,-545
2016,5,18,23,2305,2344,1828,-516
2016,5,19,0,2318,2375,1865,-510
2016,5,19,1,2330,2394,1842,-552
2016,5,19,2,2337,2378,1786,-592
2016,5,19,3,2332,2345,1712,-633
2016,5,19,4,2301,2343,1698,-645
2016,5,19,5,2130,2195,1573,-622
2016,5,19,6,1920,1986,1381,-605
2016,5,19,7,1914,1845,1325,-520
2016,5,19,8,1833,1778,1274,-504
2016,5,19,9,1907,1707,1292,-415
2016,5,19,10,1881,1678,1317,-361
2016,5,19,11,1887,1684,1316,-368
2016,5,19,12,1961,1747,1370,-377
2016,5,19,13,2120,1906,1522,-384
2016,5,19,14,2261,2022,1547,-475
2016,5,19,15,2297,2078,1661,-417
2016,5,19,16,2295,2107,1808,-299
2016,5,19,17,2287,2102,1778,-324
2016,5,19,18,2289,2111,1795,-316
2016,5,19,19,2241,2116,1709,-407
2016,5,19,20,2228,2110,1680,-430
2016,5,19,21,2207,2103,1686,-417
2016,5,19,22,2185,2074,1634,-440
2016,5,19,23,2166,2056,1584,-472
2016,5,20,0,2158,2034,1525,-509
2016,5,20,1,2154,1999,1533,-466
2016,5,20,2,2138,1957,1510,-447
2016,5,20,3,2112,1939,1493,-446
2016,5,20,4,2135,1951,1466,-485
2016,5,20,5,2028,1836,1430,-406
2016,5,20,6,1885,1701,1285,-416
2016,5,20,7,1733,1600,1245,-355
2016,5,20,8,1683,1556,1239,-317
2016,5,20,9,1480,1538,1210,-328
2016,5,20,10,1451,1518,1221,-297
2016,5,20,11,1456,1536,1196,-340
2016,5,20,12,1525,1608,1282,-326
2016,5,20,13,1677,1764,1412,-352
2016,5,20,14,1804,1876,1490,-386
2016,5,20,15,1849,1906,1535,-371
2016,5,20,16,1870,1909,1478,-431
2016,5,20,17,1888,1917,1521,-396
2016,5,20,18,1915,1902,1466,-436
2016,5,20,19,1907,1870,1469,-401
2016,5,20,20,1926,1854,1455,-399
2016,5,20,21,1945,1822,1479,-343
2016,5,20,22,1964,1794,1410,-384
2016,5,20,23,1997,1777,1453,-324
2016,5,21,0,1932,1738,1468,-270
2016,5,21,1,1903,1735,1464,-271
2016,5,21,2,1868,1704,1462,-242
2016,5,21,3,1845,1702,1406,-296
2016,5,21,4,1872,1727,1447,-280
2016,5,21,5,1813,1673,1426,-247
2016,5,21,6,1696,1566,1354,-212
2016,5,21,7,1791,1476,1307,-169
2016,5,21,8,1611,1434,1181,-253
2016,5,21,9,1400,1435,1219,-216
2016,5,21,10,1375,1421,1232,-189
2016,5,21,11,1368,1418,1236,-182
2016,5,21,12,1393,1437,1248,-189
2016,5,21,13,1437,1485,1305,-180
2016,5,21,14,1518,1544,1342,-202
2016,5,21,15,1631,1596,1327,-269
2016,5,21,16,1696,1648,1372,-276
2016,5,21,17,1737,1646,1443,-203
2016,5,21,18,1758,1637,1468,-169
2016,5,21,19,1738,1615,1429,-186
2016,5,21,20,1720,1600,1384,-216
2016,5,21,21,1705,1565,1342,-223
2016,5,21,22,1699,1552,1386,-166
2016,5,21,23,1717,1569,1531,-38
2016,5,22,0,1739,1600,1459,-141
2016,5,22,1,1736,1598,1467,-131
2016,5,22,2,1709,1583,1344,-239
2016,5,22,3,1692,1598,1335,-263
2016,5,22,4,1706,1653,1335,-318
2016,5,22,5,1633,1591,1321,-270
2016,5,22,6,1534,1513,1322,-191
2016,5,22,7,1639,1422,1261,-161
2016,5,22,8,1471,1369,1168,-201
2016,5,22,9,1352,1362,1126,-236
2016,5,22,10,1334,1339,1080,-259
2016,5,22,11,1323,1341,1090,-251
2016,5,22,12,1336,1368,1122,-246
2016,5,22,13,1357,1411,1155,-256
2016,5,22,14,1412,1453,1183,-270
2016,5,22,15,1506,1527,1276,-251
2016,5,22,16,1570,1554,1299,-255
2016,5,22,17,1606,1551,1316,-235
2016,5,22,18,1620,1553,1318,-235
2016,5,22,19,1630,1553,1308,-245
2016,5,22,20,1643,1523,1332,-191
2016,5,22,21,1646,1523,1255,-268
2016,5,22,22,1649,1521,1307,-214
2016,5,22,23,1686,1513,1335,-178
2016,5,23,0,1716,1576,1332,-244
2016,5,23,1,1732,1570,1364,-206
2016,5,23,2,1726,1587,1357,-230
2016,5,23,3,1734,1607,1348,-259
2016,5,23,4,1749,1644,1403,-241
2016,5,23,5,1650,1571,1352,-219
2016,5,23,6,1508,1435,1208,-227
2016,5,23,7,1536,1345,1144,-201
2016,5,23,8,1427,1311,1108,-203
2016,5,23,9,1310,1294,1086,-208
2016,5,23,10,1303,1308,1078,-230
2016,5,23,11,1318,1331,1110,-221
2016,5,23,12,1400,1435,1214,-221
2016,5,23,13,1562,1595,1348,-247
2016,5,23,14,1684,1742,1519,-223
2016,5,23,15,1754,1750,1540,-210
2016,5,23,16,1773,1767,1569,-198
2016,5,23,17,1791,1762,1568,-194
2016,5,23,18,1805,1766,1568,-198
2016,5,23,19,1818,1758,1575,-183
2016,5,23,20,1827,1763,1567,-196
2016,5,23,21,1836,1756,1592,-164
2016,5,23,22,1851,1754,1581,-173
2016,5,23,23,1883,1769,1593,-176
2016,5,24,0,1915,1769,1596,-173
2016,5,24,1,1927,1757,1604,-153
2016,5,24,2,1923,1762,1586,-176
2016,5,24,3,1926,1753,1557,-196
2016,5,24,4,1925,1771,1584,-187
2016,5,24,5,1798,1685,1585,-100
2016,5,24,6,1628,1518,1489,-29
2016,5,24,7,1658,1432,1513,81
2016,5,24,8,1532,1393,1541,148
2016,5,24,9,1376,1376,1531,155
2016,5,24,10,1365,1366,1530,164
2016,5,24,11,1378,1394,1540,146
2016,5,24,12,1455,1472,1463,-9
2016,5,24,13,1610,1613,1455,-158
2016,5,24,14,1728,1749,1517,-232
2016,5,24,15,1726,1776,1608,-168
2016,5,24,16,1730,1786,1647,-139
2016,5,24,17,1733,1801,1673,-128
2016,5,24,18,1740,1795,1673,-122
2016,5,24,19,1749,1796,1631,-165
2016,5,24,20,1758,1805,1649,-156
2016,5,24,21,1764,1805,1656,-149
2016,5,24,22,1770,1822,1723,-99
2016,5,24,23,1804,1826,1626,-200
2016,5,25,0,1817,1879,1655,-224
2016,5,25,1,1820,1842,1728,-114
2016,5,25,2,1816,1814,1790,-24
2016,5,25,3,1819,1808,1790,-18
2016,5,25,4,1814,1819,1807,-12
2016,5,25,5,1694,1747,1780,33
2016,5,25,6,1521,1589,1701,112
2016,5,25,7,1628,1494,1683,189
2016,5,25,8,1487,1442,1652,210
2016,5,25,9,1431,1425,1659,234
2016,5,25,10,1423,1418,1647,229
2016,5,25,11,1442,1431,1694,263
2016,5,25,12,1525,1504,1650,146
2016,5,25,13,1679,1647,1652,5
2016,5,25,14,1802,1782,1692,-90
2016,5,25,15,1820,1808,1723,-85
2016,5,25,16,1831,1829,1715,-114
2016,5,25,17,1833,1851,1728,-123
2016,5,25,18,1832,1880,1794,-86
2016,5,25,19,1834,1873,1805,-68
2016,5,25,20,1839,1894,1776,-118
2016,5,25,21,1842,1906,1745,-161
2016,5,25,22,1853,1932,1766,-166
2016,5,25,23,1878,1911,1770,-141
2016,5,26,0,1886,1918,1712,-206
2016,5,26,1,1882,1913,1738,-175
2016,5,26,2,1860,1919,1733,-186
2016,5,26,3,1843,1918,1748,-170
2016,5,26,4,1844,1927,1711,-216
2016,5,26,5,1739,1855,1688,-167
2016,5,26,6,1571,1698,1594,-104
2016,5,26,7,1566,1586,1529,-57
2016,5,26,8,1486,1534,1596,62
2016,5,26,9,1510,1507,1597,90
2016,5,26,10,1496,1496,1607,111
2016,5,26,11,1508,1515,1632,117
2016,5,26,12,1583,1588,1688,100
2016,5,26,13,1730,1733,1731,-2
2016,5,26,14,1860,1872,1702,-170
2016,5,26,15,1889,1917,1709,-208
2016,5,26,16,1903,1951,1745,-206
2016,5,26,17,1924,1980,1750,-230
2016,5,26,18,1931,1980,1715,-265
2016,5,26,19,1936,1989,1706,-283
2016,5,26,20,1952,1999,1562,-437
2016,5,26,21,1964,2022,1537,-485
2016,5,26,22,1978,2033,1568,-465
2016,5,26,23,1987,2056,1619,-437
2016,5,27,0,2003,2062,1711,-351
2016,5,27,1,2019,2060,1710,-350
2016,5,27,2,2012,2041,1753,-288
2016,5,27,3,1992,2017,1675,-342
2016,5,27,4,1980,2041,1770,-271
2016,5,27,5,1870,1966,1802,-164
2016,5,27,6,1687,1791,1745,-46
2016,5,27,7,1552,1686,1646,-40
2016,5,27,8,1535,1627,1580,-47
2016,5,27,9,1583,1588,1583,-5
2016,5,27,10,1565,1561,1552,-9
2016,5,27,11,1572,1565,1512,-53
2016,5,27,12,1643,1615,1471,-144
2016,5,27,13,1786,1743,1580,-163
2016,5,27,14,1918,1876,1691,-185
2016,5,27,15,1955,1950,1759,-191
2016,5,27,16,1962,1968,1689,-279
2016,5,27,17,1966,1982,1645,-337
2016,5,27,18,1959,1997,1664,-333
2016,5,27,19,1946,1974,1727,-247
2016,5,27,20,1945,1977,1740,-237
2016,5,27,21,1945,1985,1770,-215
2016,5,27,22,1948,1979,1806,-173
2016,5,27,23,1947,1985,1810,-175
2016,5,28,0,1908,1978,1800,-178
2016,5,28,1,1892,1974,1839,-135
2016,5,28,2,1869,1961,1817,-144
2016,5,28,3,1846,1945,1827,-118
2016,5,28,4,1856,2012,1859,-153
2016,5,28,5,1806,1919,1802,-117
2016,5,28,6,1670,1803,1749,-54
2016,5,28,7,1530,1692,1661,-31
2016,5,28,8,1526,1635,1548,-87
2016,5,28,9,1603,1608,1544,-64
2016,5,28,10,1578,1604,1599,-5
2016,5,28,11,1566,1590,1560,-30
2016,5,28,12,1590,1618,1529,-89
2016,5,28,13,1621,1653,1553,-100
2016,5,28,14,1709,1740,1572,-168
2016,5,28,15,1826,1829,1600,-229
2016,5,28,16,1880,1878,1587,-291
2016,5,28,17,1896,1907,1625,-282
2016,5,28,18,1896,1912,1639,-273
2016,5,28,19,1872,1896,1610,-286
2016,5,28,20,1861,1878,1604,-274
2016,5,28,21,1860,1877,1582,-295
2016,5,28,22,1853,1883,1597,-286
2016,5,28,23,1859,1894,1614,-280
2016,5,29,0,1899,1929,1631,-298
2016,5,29,1,1922,1940,1642,-298
2016,5,29,2,1920,1947,1653,-294
2016,5,29,3,1910,1932,1665,-267
2016,5,29,4,1922,1957,1684,-273
2016,5,29,5,1858,1916,1625,-291
2016,5,29,6,1734,1789,1511,-278
2016,5,29,7,1558,1678,1399,-279
2016,5,29,8,1540,1625,1318,-307
2016,5,29,9,1594,1595,1276,-319
2016,5,29,10,1577,1580,1270,-310
2016,5,29,11,1572,1582,1273,-309
2016,5,29,12,1591,1589,1288,-301
2016,5,29,13,1610,1598,1277,-321
2016,5,29,14,1686,1654,1250,-404
2016,5,29,15,1804,1745,1393,-352
2016,5,29,16,1886,1796,1426,-370
2016,5,29,17,1932,1829,1453,-376
2016,5,29,18,1960,1846,1454,-392
2016,5,29,19,1984,1867,1472,-395
2016,5,29,20,2011,1882,1467,-415
2016,5,29,21,2030,1902,1454,-448
2016,5,29,22,2053,1918,1479,-439
2016,5,29,23,2069,1921,1534,-387
2016,5,30,0,2110,1948,1574,-374
2016,5,30,1,2136,1995,1657,-338
2016,5,30,2,2148,1979,1646,-333
2016,5,30,3,2141,1973,1702,-271
2016,5,30,4,2136,1963,1640,-323
2016,5,30,5,2020,1899,1648,-251
2016,5,30,6,1828,1762,1595,-167
2016,5,30,7,1668,1657,1533,-124
2016,5,30,8,1625,1568,1459,-109
2016,5,30,9,1595,1528,1499,-29
2016,5,30,10,1577,1498,1554,56
2016,5,30,11,1591,1499,1598,99
2016,5,30,12,1670,1524,1586,62
2016,5,30,13,1827,1552,1596,44
2016,5,30,14,1962,1660,1620,-40
2016,5,30,15,2036,1776,1709,-67
2016,5,30,16,2051,1874,1815,-59
2016,5,30,17,2065,1943,1882,-61
2016,5,30,18,2068,1984,1900,-84
2016,5,30,19,2063,2002,1925,-77
2016,5,30,20,2070,2018,1883,-135
2016,5,30,21,2077,2020,1888,-132
2016,5,30,22,2082,2055,1919,-136
2016,5,30,23,2090,2080,1884,-196
2016,5,31,0,2099,2124,1939,-185
2016,5,31,1,2114,2157,1953,-204
2016,5,31,2,2111,2169,1986,-183
2016,5,31,3,2087,2143,1965,-178
2016,5,31,4,2083,2145,1932,-213
2016,5,31,5,1993,2058,1853,-205
2016,5,31,6,1822,1881,1767,-114
2016,5,31,7,1768,1765,1732,-33
2016,5,31,8,1687,1705,1679,-26
2016,5,31,9,1675,1655,1585,-70
2016,5,31,10,1642,1635,1541,-94
2016,5,31,11,1637,1652,1555,-97
2016,5,31,12,1684,1720,1555,-165
2016,5,31,13,1780,1854,1663,-191
2016,5,31,14,1901,2017,1671,-346
2016,5,31,15,1947,2100,1714,-386
2016,5,31,16,2012,2159,1753,-406
2016,5,31,17,2062,2215,1813,-402
2016,5,31,18,2091,2245,1846,-399
2016,5,31,19,2106,2278,1840,-438
2016,5,31,20,2116,2306,1815,-491
2016,5,31,21,2134,2346,1750,-596
2016,5,31,22,2158,2400,1786,-614
2016,5,31,23,2183,2438,1843,-595
2016,6,1,0,2214,2456,1898,-558
2016,6,1,1,2241,2489,1914,-575
2016,6,1,2,2250,2476,1968,-508
2016,6,1,3,2228,2454,1978,-476
2016,6,1,4,2193,2425,1959,-466
2016,6,1,5,2078,2312,1767,-545
2016,6,1,6,1886,2109,1668,-441
2016,6,1,7,1802,1977,1692,-285
2016,6,1,8,1746,1887,1483,-404
2016,6,1,9,1830,1844,1439,-405
2016,6,1,10,1807,1820,1316,-504
2016,6,1,11,1817,1814,1284,-530
2016,6,1,12,1868,1873,1348,-525
2016,6,1,13,1980,1990,1438,-552
2016,6,1,14,2132,2130,1529,-601
2016,6,1,15,2236,2242,1606,-636
2016,6,1,16,2341,2301,1677,-624
2016,6,1,17,2420,2365,1656,-709
2016,6,1,18,2485,2391,1644,-747
2016,6,1,19,2536,2511,1700,-811
2016,6,1,20,2589,2548,1717,-831
2016,6,1,21,2646,2692,1818,-874
2016,6,1,22,2704,2706,1824,-882
2016,6,1,23,2741,2780,1860,-920
2016,6,2,0,2777,2832,1933,-899
2016,6,2,1,2797,2816,1875,-941
2016,6,2,2,2793,2780,1873,-907
2016,6,2,3,2746,2698,1791,-907
2016,6,2,4,2673,2718,1818,-900
2016,6,2,5,2491,2549,1728,-821
2016,6,2,6,2247,2299,1601,-698
2016,6,2,7,2024,2134,1531,-603
2016,6,2,8,2034,2049,1508,-541
2016,6,2,9,2005,1983,1459,-524
2016,6,2,10,1972,1951,1440,-511
2016,6,2,11,1962,1883,1376,-507
2016,6,2,12,2017,2016,1459,-557
2016,6,2,13,2134,2022,1479,-543
2016,6,2,14,2275,2189,1731,-458
2016,6,2,15,2355,2326,1664,-662
2016,6,2,16,2428,2400,1748,-652
2016,6,2,17,2483,2412,1766,-646
2016,6,2,18,2538,2515,1929,-586
2016,6,2,19,2575,2589,1973,-616
2016,6,2,20,2611,2618,1981,-637
2016,6,2,21,2658,2640,1946,-694
2016,6,2,22,2705,2647,1915,-732
2016,6,2,23,2743,2657,1838,-819
2016,6,3,0,2766,2665,1800,-865
2016,6,3,1,2765,2662,1783,-879
2016,6,3,2,2743,2645,1702,-943
2016,6,3,3,2672,2617,1665,-952
2016,6,3,4,2567,2618,1729,-889
2016,6,3,5,2388,2487,1650,-837
2016,6,3,6,2141,2284,1545,-739
2016,6,3,7,2081,2133,1410,-723
2016,6,3,8,1988,2031,1397,-634
2016,6,3,9,1980,1965,1376,-589
2016,6,3,10,1934,1938,1298,-640
2016,6,3,11,1919,1922,1297,-625
2016,6,3,12,1960,1947,1312,-635
2016,6,3,13,2071,2040,1372,-668
2016,6,3,14,2236,2205,1435,-770
2016,6,3,15,2338,2337,1540,-797
2016,6,3,16,2422,2423,1671,-752
2016,6,3,17,2487,2478,1717,-761
2016,6,3,18,2568,2551,1831,-720
2016,6,3,19,2614,2601,1875,-726
2016,6,3,20,2663,2661,1909,-752
2016,6,3,21,2720,2717,1936,-781
2016,6,3,22,2783,2779,2028,-751
2016,6,3,23,2832,2817,2027,-790
2016,6,4,0,2797,2843,2056,-787
2016,6,4,1,2794,2853,2090,-763
2016,6,4,2,2774,2855,2093,-762
2016,6,4,3,2731,2782,2057,-725
2016,6,4,4,2675,2718,1976,-742
2016,6,4,5,2540,2596,1842,-754
2016,6,4,6,2314,2383,1695,-688
2016,6,4,7,2191,2209,1581,-628
2016,6,4,8,2109,2114,1464,-650
2016,6,4,9,2050,2023,1389,-634
2016,6,4,10,2001,1971,1321,-650
2016,6,4,11,1960,1939,1307,-632
2016,6,4,12,1936,1946,1298,-648
2016,6,4,13,1927,1981,1326,-655
2016,6,4,14,2044,2096,1358,-738
2016,6,4,15,2253,2243,1456,-787
2016,6,4,16,2408,2352,1562,-790
2016,6,4,17,2500,2468,1675,-793
2016,6,4,18,2593,2562,1784,-778
2016,6,4,19,2647,2659,1762,-897
2016,6,4,20,2696,2739,1783,-956
2016,6,4,21,2752,2815,1854,-961
2016,6,4,22,2782,2892,1879,-1013
2016,6,4,23,2811,2945,1877,-1068
2016,6,5,0,2863,2994,1916,-1078
2016,6,5,1,2904,3019,1963,-1056
2016,6,5,2,2900,3002,2017,-985
2016,6,5,3,2856,2942,2078,-864
2016,6,5,4,2797,2827,1828,-999
2016,6,5,5,2665,2667,1676,-991
2016,6,5,6,2421,2447,1622,-825
2016,6,5,7,2336,2267,1508,-759
2016,6,5,8,2182,2134,1343,-791
2016,6,5,9,2079,2042,1356,-686
2016,6,5,10,2016,1993,1310,-683
2016,6,5,11,1970,1940,1289,-651
2016,6,5,12,1950,1928,1311,-617
2016,6,5,13,1932,1926,1335,-591
2016,6,5,14,2038,2015,1372,-643
2016,6,5,15,2239,2171,1483,-688
2016,6,5,16,2387,2293,1648,-645
2016,6,5,17,2501,2429,1861,-568
2016,6,5,18,2597,2523,1872,-651
2016,6,5,19,2698,2657,1952,-705
2016,6,5,20,2749,2761,2043,-718
2016,6,5,21,2808,2871,2109,-762
2016,6,5,22,2870,2940,2104,-836
2016,6,5,23,2924,2992,2109,-883
2016,6,6,0,2986,3024,2124,-900
2016,6,6,1,3022,2981,2019,-962
2016,6,6,2,3012,2921,1932,-989
2016,6,6,3,2962,2838,1866,-972
2016,6,6,4,2876,2772,1901,-871
2016,6,6,5,2674,2634,1852,-782
2016,6,6,6,2402,2419,1680,-739
2016,6,6,7,2404,2231,1572,-659
2016,6,6,8,2214,2128,1513,-615
2016,6,6,9,2073,2040,1470,-570
2016,6,6,10,2013,2008,1487,-521
2016,6,6,11,1999,1988,1462,-526
2016,6,6,12,2056,2031,1471,-560
2016,6,6,13,2205,2145,1585,-560
2016,6,6,14,2398,2350,1626,-724
2016,6,6,15,2625,2494,1621,-873
2016,6,6,16,2711,2622,1677,-945
2016,6,6,17,2803,2734,1640,-1094
2016,6,6,18,2895,2831,1740,-1091
2016,6,6,19,3002,2929,1802,-1127
2016,6,6,20,3095,3047,1894,-1153
2016,6,6,21,3183,3137,1986,-1151
2016,6,6,22,3247,3208,2040,-1168
2016,6,6,23,3265,3231,2028,-1203
2016,6,7,0,3236,3256,2077,-1179
2016,6,7,1,3193,3290,2137,-1153
2016,6,7,2,3104,3262,2147,-1115
2016,6,7,3,2975,3178,2050,-1128
2016,6,7,4,2868,3064,1899,-1165
2016,6,7,5,2694,2838,1743,-1095
2016,6,7,6,2432,2602,1862,-740
2016,6,7,7,2452,2376,1692,-684
2016,6,7,8,2307,2260,1473,-787
2016,6,7,9,2195,2162,1438,-724
2016,6,7,10,2136,2099,1321,-778
2016,6,7,11,2112,2062,1311,-751
2016,6,7,12,2161,2090,1378,-712
2016,6,7,13,2300,2200,1533,-667
2016,6,7,14,2500,2391,1555,-836
2016,6,7,15,2625,2537,1591,-946
2016,6,7,16,2749,2648,1536,-1112
2016,6,7,17,2864,2736,1634,-1102
2016,6,7,18,2958,2810,1664,-1146
2016,6,7,19,3060,2876,1693,-1183
2016,6,7,20,3144,2986,1737,-1249
2016,6,7,21,3224,3111,1818,-1293
2016,6,7,22,3296,3206,1926,-1280
2016,6,7,23,3329,3269,2000,-1269
2016,6,8,0,3359,3282,1999,-1283
2016,6,8,1,3359,3312,1993,-1319
2016,6,8,2,3332,3260,1963,-1297
2016,6,8,3,3238,3169,1913,-1256
2016,6,8,4,3083,3088,1857,-1231
2016,6,8,5,2830,2904,1734,-1170
2016,6,8,6,2532,2655,1832,-823
2016,6,8,7,2535,2457,1668,-789
2016,6,8,8,2350,2324,1434,-890
2016,6,8,9,2244,2225,1412,-813
2016,6,8,10,2183,2167,1455,-712
2016,6,8,11,2154,2133,1439,-694
2016,6,8,12,2195,2161,1462,-699
2016,6,8,13,2318,2269,1531,-738
2016,6,8,14,2536,2444,1603,-841
2016,6,8,15,2689,2597,1615,-982
2016,6,8,16,2830,2757,1625,-1132
2016,6,8,17,2951,2904,1773,-1131
2016,6,8,18,3073,3025,1901,-1124
2016,6,8,19,3198,3143,1919,-1224
2016,6,8,20,3306,3278,2047,-1231
2016,6,8,21,3395,3384,2171,-1213
2016,6,8,22,3470,3430,2241,-1189
2016,6,8,23,3508,3463,2147,-1316
2016,6,9,0,3529,3486,2253,-1233
2016,6,9,1,3542,3471,2115,-1356
2016,6,9,2,3506,3396,2197,-1199
2016,6,9,3,3390,3276,2199,-1077
2016,6,9,4,3233,3152,2123,-1029
2016,6,9,5,2991,2951,2022,-929
2016,6,9,6,2648,2670,1868,-802
2016,6,9,7,2556,2464,1831,-633
2016,6,9,8,2354,2321,1918,-403
2016,6,9,9,2239,2229,1842,-387
2016,6,9,10,2169,2160,1774,-386
2016,6,9,11,2128,2120,1741,-379
2016,6,9,12,2152,2147,1749,-398
2016,6,9,13,2252,2248,1842,-406
2016,6,9,14,2417,2406,1831,-575
2016,6,9,15,2497,2531,1837,-694
2016,6,9,16,2571,2596,1768,-828
2016,6,9,17,2620,2667,1758,-909
2016,6,9,18,2694,2738,1795,-943
2016,6,9,19,2759,2793,1878,-915
2016,6,9,20,2835,2870,1864,-1006
2016,6,9,21,2888,2931,1956,-975
2016,6,9,22,2945,2988,2011,-977
2016,6,9,23,2976,3027,2046,-981
2016,6,10,0,2990,3035,2055,-980
2016,6,10,1,2995,3075,2086,-989
2016,6,10,2,2968,3085,2100,-985
2016,6,10,3,2868,3004,2075,-929
2016,6,10,4,2725,2922,2017,-905
2016,6,10,5,2534,2767,1881,-886
2016,6,10,6,2294,2545,1748,-797
2016,6,10,7,2318,2341,1590,-751
2016,6,10,8,2181,2204,1486,-718
2016,6,10,9,2157,2142,1412,-730
2016,6,10,10,2098,2084,1375,-709
2016,6,10,11,2064,2069,1405,-664
2016,6,10,12,2100,2098,1448,-650
2016,6,10,13,2200,2174,1504,-670
2016,6,10,14,2385,2342,1494,-848
2016,6,10,15,2523,2486,1599,-887
2016,6,10,16,2612,2566,1744,-822
2016,6,10,17,2687,2660,1761,-899
2016,6,10,18,2762,2718,1824,-894
2016,6,10,19,2838,2783,1859,-924
2016,6,10,20,2934,2861,2007,-854
2016,6,10,21,3031,2932,2043,-889
2016,6,10,22,3114,2936,2025,-911
2016,6,10,23,3161,2946,2018,-928
2016,6,11,0,3117,2899,1990,-909
2016,6,11,1,3097,2842,1938,-904
2016,6,11,2,3022,2761,1962,-799
2016,6,11,3,2881,2684,2069,-615
2016,6,11,4,2756,2643,2130,-513
2016,6,11,5,2621,2556,2017,-539
2016,6,11,6,2393,2385,1945,-440
2016,6,11,7,2227,2227,1836,-391
2016,6,11,8,2090,2141,1793,-348
2016,6,11,9,2033,2078,1741,-337
2016,6,11,10,1965,2029,1718,-311
2016,6,11,11,1910,2009,1709,-300
2016,6,11,12,1872,1993,1641,-352
2016,6,11,13,1846,2025,1699,-326
2016,6,11,14,1934,2114,1706,-408
2016,6,11,15,2072,2199,1789,-410
2016,6,11,16,2127,2271,1825,-446
2016,6,11,17,2159,2303,1835,-468
2016,6,11,18,2194,2306,1812,-494
2016,6,11,19,2221,2303,1720,-583
2016,6,11,20,2260,2310,1700,-610
2016,6,11,21,2287,2295,1620,-675
2016,6,11,22,2300,2313,1612,-701
2016,6,11,23,2317,2304,1621,-683
2016,6,12,0,2348,2324,1553,-771
2016,6,12,1,2360,2338,1569,-769
2016,6,12,2,2323,2327,1572,-755
2016,6,12,3,2250,2312,1579,-733
2016,6,12,4,2205,2314,1589,-725
2016,6,12,5,2146,2270,1525,-745
2016,6,12,6,2008,2152,1544,-608
2016,6,12,7,1976,2038,1518,-520
2016,6,12,8,1944,1973,1520,-453
2016,6,12,9,1935,1919,1481,-438
2016,6,12,10,1895,1892,1380,-512
2016,6,12,11,1868,1867,1353,-514
2016,6,12,12,1852,1887,1291,-596
2016,6,12,13,1835,1870,1242,-628
2016,6,12,14,1919,1949,1218,-731
2016,6,12,15,2048,2047,1274,-773
2016,6,12,16,2127,2103,1162,-941
2016,6,12,17,2175,2143,1208,-935
2016,6,12,18,2204,2161,1233,-928
2016,6,12,19,2239,2172,1236,-936
2016,6,12,20,2272,2192,1234,-958
2016,6,12,21,2317,2219,1270,-949
2016,6,12,22,2353,2255,1319,-936
2016,6,12,23,2384,2293,1309,-984
2016,6,13,0,2430,2369,1339,-1030
2016,6,13,1,2449,2392,1451,-941
2016,6,13,2,2450,2401,1473,-928
2016,6,13,3,2433,2364,1415,-949
2016,6,13,4,2410,2336,1362,-974
2016,6,13,5,2301,2254,1406,-848
2016,6,13,6,2108,2092,1399,-693
2016,6,13,7,1976,1962,1333,-629
2016,6,13,8,1924,1887,1347,-540
2016,6,13,9,1874,1860,1391,-469
2016,6,13,10,1861,1844,1457,-387
2016,6,13,11,1865,1845,1466,-379
2016,6,13,12,1926,1904,1509,-395
2016,6,13,13,2061,2026,1582,-444
2016,6,13,14,2241,2195,1558,-637
2016,6,13,15,2468,2317,1637,-680
2016,6,13,16,2559,2392,1730,-662
2016,6,13,17,2637,2470,1673,-797
2016,6,13,18,2698,2518,1663,-855
2016,6,13,19,2749,2563,1692,-871
2016,6,13,20,2803,2592,1719,-873
2016,6,13,21,2829,2643,1795,-848
2016,6,13,22,2863,2704,1941,-763
2016,6,13,23,2899,2751,2012,-739
2016,6,14,0,2931,2798,2019,-779
2016,6,14,1,2952,2822,1983,-839
2016,6,14,2,2939,2825,1966,-859
2016,6,14,3,2882,2732,1877,-855
2016,6,14,4,2798,2678,1794,-884
2016,6,14,5,2644,2563,1795,-768
2016,6,14,6,2402,2351,1654,-697
2016,6,14,7,2325,2200,1547,-653
2016,6,14,8,2223,2087,1613,-474
2016,6,14,9,2074,2041,1657,-384
2016,6,14,10,2034,1994,1694,-300
2016,6,14,11,2030,1984,1746,-238
2016,6,14,12,2068,2011,1782,-229
2016,6,14,13,2191,2110,1823,-287
2016,6,14,14,2343,2259,1813,-446
2016,6,14,15,2377,2348,1826,-522
2016,6,14,16,2404,2389,1936,-453
2016,6,14,17,2401,2423,1912,-511
2016,6,14,18,2395,2438,1914,-524
2016,6,14,19,2374,2426,1918,-508
2016,6,14,20,2373,2428,1907,-521
2016,6,14,21,2396,2436,1945,-491
2016,6,14,22,2432,2430,1960,-470
2016,6,14,23,2472,2421,1938,-483
2016,6,15,0,2474,2414,1974,-440
2016,6,15,1,2481,2428,1864,-564
2016,6,15,2,2457,2432,1836,-596
2016,6,15,3,2369,2412,1740,-672
2016,6,15,4,2298,2406,1723,-683
2016,6,15,5,2194,2353,1712,-641
2016,6,15,6,2004,2196,1640,-556
2016,6,15,7,2096,2077,1549,-528
2016,6,15,8,1984,1999,1395,-604
2016,6,15,9,1981,1959,1353,-606
2016,6,15,10,1945,1919,1381,-538
2016,6,15,11,1950,1921,1410,-511
2016,6,15,12,1995,1958,1393,-565
2016,6,15,13,2099,2061,1465,-596
2016,6,15,14,2247,2208,1581,-627
2016,6,15,15,2314,2299,1542,-757
2016,6,15,16,2365,2344,1545,-799
2016,6,15,17,2397,2366,1537,-829
2016,6,15,18,2424,2377,1532,-845
2016,6,15,19,2433,2389,1535,-854
2016,6,15,20,2445,2389,1552,-837
2016,6,15,21,2470,2377,1555,-822
2016,6,15,22,2499,2367,1584,-783
2016,6,15,23,2524,2338,1624,-714
2016,6,16,0,2548,2337,1612,-725
2016,6,16,1,2577,2361,1660,-701
2016,6,16,2,2576,2378,1833,-545
2016,6,16,3,2525,2378,1926,-452
2016,6,16,4,2490,2368,1974,-394
2016,6,16,5,2407,2267,1995,-272
2016,6,16,6,2224,2143,1994,-149
2016,6,16,7,2085,2040,1955,-85
2016,6,16,8,2021,1981,1732,-249
2016,6,16,9,1942,1942,1586,-356
2016,6,16,10,1914,1919,1518,-401
2016,6,16,11,1910,1915,1514,-401
2016,6,16,12,1957,1955,1486,-469
2016,6,16,13,2069,2068,1451,-617
2016,6,16,14,2222,2221,1489,-732
2016,6,16,15,2308,2315,1566,-749
2016,6,16,16,2359,2354,1552,-802
2016,6,16,17,2393,2373,1510,-863
2016,6,16,18,2415,2387,1563,-824
2016,6,16,19,2419,2384,1552,-832
2016,6,16,20,2425,2376,1528,-848
2016,6,16,21,2446,2373,1606,-767
2016,6,16,22,2466,2345,1603,-742
2016,6,16,23,2495,2327,1602,-725
2016,6,17,0,2522,2328,1591,-737
2016,6,17,1,2571,2342,1604,-738
2016,6,17,2,2585,2377,1604,-773
2016,6,17,3,2553,2366,1611,-755
2016,6,17,4,2507,2387,1617,-770
2016,6,17,5,2400,2350,1609,-741
2016,6,17,6,2215,2198,1568,-630
2016,6,17,7,2155,2080,1437,-643
2016,6,17,8,2081,2008,1395,-613
2016,6,17,9,1998,1965,1396,-569
2016,6,17,10,1964,1937,1373,-564
2016,6,17,11,1957,1929,1371,-558
2016,6,17,12,2002,1961,1356,-605
2016,6,17,13,2116,2065,1447,-618
2016,6,17,14,2272,2209,1514,-695
2016,6,17,15,2364,2299,1614,-685
2016,6,17,16,2425,2345,1643,-702
2016,6,17,17,2479,2381,1512,-869
2016,6,17,18,2533,2400,1537,-863
2016,6,17,19,2580,2419,1534,-885
2016,6,17,20,2624,2452,1558,-894
2016,6,17,21,2679,2486,1579,-907
2016,6,17,22,2727,2496,1613,-883
2016,6,17,23,2762,2531,1628,-903
2016,6,18,0,2748,2570,1624,-946
2016,6,18,1,2769,2617,1665,-952
2016,6,18,2,2784,2625,1675,-950
2016,6,18,3,2766,2611,1707,-904
2016,6,18,4,2715,2576,1713,-863
2016,6,18,5,2613,2523,1658,-865
2016,6,18,6,2414,2350,1525,-825
2016,6,18,7,2336,2197,1384,-813
2016,6,18,8,2257,2090,1410,-680
2016,6,18,9,2185,2012,1547,-465
2016,6,18,10,2125,1971,1573,-398
2016,6,18,11,2096,1934,1570,-364
2016,6,18,12,2093,1937,1541,-396
2016,6,18,13,2101,1969,1624,-345
2016,6,18,14,2213,2090,1660,-430
2016,6,18,15,2388,2210,1634,-576
2016,6,18,16,2504,2316,1615,-701
2016,6,18,17,2582,2397,1670,-727
2016,6,18,18,2625,2453,1617,-836
2016,6,18,19,2646,2478,1628,-850
2016,6,18,20,2645,2479,1666,-813
2016,6,18,21,2630,2475,1764,-711
2016,6,18,22,2628,2512,2036,-476
2016,6,18,23,2622,2495,2017,-478
2016,6,19,0,2633,2516,2005,-511
2016,6,19,1,2654,2485,2030,-455
2016,6,19,2,2643,2477,2027,-450
2016,6,19,3,2593,2424,1972,-452
2016,6,19,4,2554,2391,1970,-421
2016,6,19,5,2498,2337,1934,-403
2016,6,19,6,2350,2199,1946,-253
2016,6,19,7,2221,2082,1877,-205
2016,6,19,8,2059,1990,1838,-152
2016,6,19,9,1966,1952,1779,-173
2016,6,19,10,1923,1911,1763,-148
2016,6,19,11,1887,1889,1725,-164
2016,6,19,12,1876,1875,1694,-181
2016,6,19,13,1864,1883,1676,-207
2016,6,19,14,1938,1975,1611,-364
2016,6,19,15,2055,2066,1663,-403
2016,6,19,16,2129,2125,1552,-573
2016,6,19,17,2168,2162,1503,-659
2016,6,19,18,2174,2186,1471,-715
2016,6,19,19,2184,2201,1421,-780
2016,6,19,20,2212,2226,1441,-785
2016,6,19,21,2235,2264,1478,-786
2016,6,19,22,2265,2301,1509,-792
2016,6,19,23,2291,2362,1575,-787
2016,6,20,0,2367,2426,1630,-796
2016,6,20,1,2414,2475,1682,-793
2016,6,20,2,2447,2509,1711,-798
2016,6,20,3,2432,2481,1687,-794
2016,6,20,4,2380,2448,1639,-809
2016,6,20,5,2271,2388,1606,-782
2016,6,20,6,2079,2204,1492,-712
2016,6,20,7,2064,2042,1409,-633
2016,6,20,8,1974,1953,1394,-559
2016,6,20,9,1953,1915,1382,-533
2016,6,20,10,1926,1898,1413,-485
2016,6,20,11,1926,1904,1415,-489
2016,6,20,12,1986,1960,1464,-496
2016,6,20,13,2124,2067,1534,-533
2016,6,20,14,2296,2254,1538,-716
2016,6,20,15,2503,2391,1634,-757
2016,6,20,16,2600,2493,1585,-908
2016,6,20,17,2696,2578,1651,-927
2016,6,20,18,2791,2650,1664,-986
2016,6,20,19,2881,2726,1688,-1038
2016,6,20,20,2997,2827,1761,-1066
2016,6,20,21,3096,2948,1825,-1123
2016,6,20,22,3184,3068,1971,-1097
2016,6,20,23,3238,3143,2034,-1109
2016,6,21,0,3312,3196,2130,-1066
2016,6,21,1,3358,3287,2272,-1015
2016,6,21,2,3386,3291,2211,-1080
2016,6,21,3,3335,3223,2161,-1062
2016,6,21,4,3210,3095,2037,-1058
2016,6,21,5,2990,2934,1872,-1062
2016,6,21,6,2684,2679,1821,-858
2016,6,21,7,2509,2458,1653,-805
2016,6,21,8,2349,2309,1578,-731
2016,6,21,9,2271,2234,1583,-651
2016,6,21,10,2212,2180,1597,-583
2016,6,21,11,2188,2150,1646,-504
2016,6,21,12,2222,2166,1691,-475
2016,6,21,13,2330,2243,1772,-471
2016,6,21,14,2497,2438,1887,-551
2016,6,21,15,2570,2576,1956,-620
2016,6,21,16,2630,2659,2059,-600
2016,6,21,17,2673,2710,2074,-636
2016,6,21,18,2706,2770,1996,-774
2016,6,21,19,2730,2803,2030,-773
2016,6,21,20,2776,2852,1992,-860
2016,6,21,21,2813,2891,1934,-957
2016,6,21,22,2831,2928,1985,-943
2016,6,21,23,2829,2965,2022,-943
2016,6,22,0,2845,2980,2049,-931
2016,6,22,1,2864,3012,2063,-949
2016,6,22,2,2868,3006,2002,-1004
2016,6,22,3,2793,2940,1903,-1037
2016,6,22,4,2674,2855,1853,-1002
2016,6,22,5,2534,2712,1767,-945
2016,6,22,6,2300,2502,1659,-843
2016,6,22,7,2313,2332,1607,-725
2016,6,22,8,2210,2232,1531,-701
2016,6,22,9,2188,2174,1465,-709
2016,6,22,10,2126,2131,1436,-695
2016,6,22,11,2100,2114,1421,-693
2016,6,22,12,2129,2139,1413,-726
2016,6,22,13,2233,2233,1441,-792
2016,6,22,14,2413,2391,1493,-898
2016,6,22,15,2545,2516,1490,-1026
2016,6,22,16,2640,2600,1512,-1088
2016,6,22,17,2721,2695,1496,-1199
2016,6,22,18,2791,2780,1581,-1199
2016,6,22,19,2862,2839,1688,-1151
2016,6,22,20,2955,2923,1746,-1177
2016,6,22,21,3056,3035,1843,-1192
2016,6,22,22,3130,3142,1964,-1178
2016,6,22,23,3186,3226,1997,-1229
2016,6,23,0,3234,3290,2044,-1246
2016,6,23,1,3278,3333,2061,-1272
2016,6,23,2,3281,3333,2058,-1275
2016,6,23,3,3211,3275,2035,-1240
2016,6,23,4,3070,3168,1954,-1214
2016,6,23,5,2888,3005,1875,-1130
2016,6,23,6,2612,2746,1750,-996
2016,6,23,7,2520,2535,1580,-955
2016,6,23,8,2344,2380,1351,-1029
2016,6,23,9,2268,2303,1334,-969
2016,6,23,10,2201,2230,1290,-940
2016,6,23,11,2170,2191,1304,-887
2016,6,23,12,2209,2206,1317,-889
2016,6,23,13,2318,2299,1371,-928
2016,6,23,14,2503,2467,1464,-1003
2016,6,23,15,2622,2617,1609,-1008
2016,6,23,16,2708,2738,1735,-1003
2016,6,23,17,2780,2844,1860,-984
2016,6,23,18,2843,2917,1739,-1178
2016,6,23,19,2898,2985,1676,-1309
2016,6,23,20,2975,3068,1623,-1445
2016,6,23,21,3040,3159,1764,-1395
2016,6,23,22,3098,3211,1812,-1399
2016,6,23,23,3146,3255,1759,-1496
2016,6,24,0,3181,3270,1771,-1499
2016,6,24,1,3218,3299,1798,-1501
2016,6,24,2,3212,3295,1799,-1496
2016,6,24,3,3141,3214,1745,-1469
2016,6,24,4,2993,3106,1784,-1322
2016,6,24,5,2812,2961,1746,-1215
2016,6,24,6,2541,2678,1595,-1083
2016,6,24,7,2454,2483,1546,-937
2016,6,24,8,2236,2369,1630,-739
2016,6,24,9,2261,2284,1567,-717
2016,6,24,10,2174,2211,1532,-679
2016,6,24,11,2126,2181,1508,-673
2016,6,24,12,2125,2194,1533,-661
2016,6,24,13,2203,2263,1604,-659
2016,6,24,14,2352,2402,1703,-699
2016,6,24,15,2510,2509,1790,-719
2016,6,24,16,2582,2572,1918,-654
2016,6,24,17,2620,2626,1994,-632
2016,6,24,18,2639,2646,1950,-696
2016,6,24,19,2616,2647,1926,-721
2016,6,24,20,2657,2646,1810,-836
2016,6,24,21,2718,2656,1802,-854
2016,6,24,22,2729,2665,1818,-847
2016,6,24,23,2720,2671,1860,-811
2016,6,25,0,2623,2649,1786,-863
2016,6,25,1,2596,2654,1746,-908
2016,6,25,2,2565,2618,1700,-918
2016,6,25,3,2492,2560,1628,-932
2016,6,25,4,2408,2535,1579,-956
2016,6,25,5,2330,2491,1596,-895
2016,6,25,6,2152,2340,1551,-789
2016,6,25,7,2119,2214,1549,-665
2016,6,25,8,2064,2138,1443,-695
2016,6,25,9,2071,2082,1358,-724
2016,6,25,10,2014,2045,1379,-666
2016,6,25,11,1966,2009,1376,-633
2016,6,25,12,1960,2011,1328,-683
2016,6,25,13,1951,2045,1279,-766
2016,6,25,14,2056,2170,1371,-799
2016,6,25,15,2227,2294,1397,-897
2016,6,25,16,2326,2384,1425,-959
2016,6,25,17,2384,2442,1411,-1031
2016,6,25,18,2407,2476,1424,-1052
2016,6,25,19,2391,2505,1396,-1109
2016,6,25,20,2428,2524,1383,-1141
2016,6,25,21,2485,2569,1386,-1183
2016,6,25,22,2528,2606,1316,-1290
2016,6,25,23,2574,2645,1329,-1316
2016,6,26,0,2648,2717,1366,-1351
2016,6,26,1,2682,2779,1461,-1318
2016,6,26,2,2695,2795,1564,-1231
2016,6,26,3,2663,2762,1569,-1193
2016,6,26,4,2590,2689,1569,-1120
2016,6,26,5,2516,2602,1572,-1030
2016,6,26,6,2351,2445,1460,-985
2016,6,26,7,2240,2300,1339,-961
2016,6,26,8,2128,2195,1088,-1107
2016,6,26,9,2135,2135,1057,-1078
2016,6,26,10,2075,2073,1049,-1024
2016,6,26,11,2033,2045,1039,-1006
2016,6,26,12,2014,2033,1034,-999
2016,6,26,13,1996,2039,1114,-925
2016,6,26,14,2086,2112,1163,-949
2016,6,26,15,2256,2234,1311,-923
2016,6,26,16,2374,2321,1324,-997
2016,6,26,17,2462,2405,1322,-1083
2016,6,26,18,2518,2461,1340,-1121
2016,6,26,19,2577,2548,1407,-1141
2016,6,26,20,2647,2625,1389,-1236
2016,6,26,21,2733,2713,1429,-1284
2016,6,26,22,2804,2810,1542,-1268
2016,6,26,23,2880,2914,1593,-1321
2016,6,27,0,2966,3013,1677,-1336
2016,6,27,1,3016,3078,1745,-1333
2016,6,27,2,3029,3093,1754,-1339
2016,6,27,3,2978,3023,1705,-1318
2016,6,27,4,2862,2900,1581,-1319
2016,6,27,5,2713,2765,1477,-1288
2016,6,27,6,2464,2513,1415,-1098
2016,6,27,7,2317,2327,1383,-944
2016,6,27,8,2205,2207,1365,-842
2016,6,27,9,2146,2132,1294,-838
2016,6,27,10,2094,2075,1206,-869
2016,6,27,11,2064,2057,1219,-838
2016,6,27,12,2109,2100,1290,-810
2016,6,27,13,2223,2200,1356,-844
2016,6,27,14,2414,2378,1477,-901
2016,6,27,15,2652,2536,1625,-911
2016,6,27,16,2780,2675,1675,-1000
2016,6,27,17,2906,2808,1696,-1112
2016,6,27,18,3029,2941,1830,-1111
2016,6,27,19,3140,3066,1843,-1223
2016,6,27,20,3276,3201,1925,-1276
2016,6,27,21,3409,3329,1981,-1348
2016,6,27,22,3500,3418,1994,-1424
2016,6,27,23,3570,3493,2039,-1454
2016,6,28,0,3636,3537,2078,-1459
2016,6,28,1,3677,3562,2150,-1412
2016,6,28,2,3669,3562,2162,-1400
2016,6,28,3,3589,3478,2097,-1381
2016,6,28,4,3450,3342,2022,-1320
2016,6,28,5,3288,3148,1930,-1218
2016,6,28,6,2991,2871,1703,-1168
2016,6,28,7,2736,2660,1609,-1051
2016,6,28,8,2542,2499,1597,-902
2016,6,28,9,2409,2404,1510,-894
2016,6,28,10,2320,2316,1398,-918
2016,6,28,11,2264,2264,1383,-881
2016,6,28,12,2282,2264,1348,-916
2016,6,28,13,2387,2339,1377,-962
2016,6,28,14,2565,2512,1447,-1065
2016,6,28,15,2721,2694,1564,-1130
2016,6,28,16,2844,2817,1550,-1267
2016,6,28,17,2967,2953,1683,-1270
2016,6,28,18,3078,3084,1776,-1308
2016,6,28,19,3191,3210,1935,-1275
2016,6,28,20,3312,3348,2045,-1303
2016,6,28,21,3431,3470,2037,-1433
2016,6,28,22,3534,3553,2011,-1542
2016,6,28,23,3594,3602,2031,-1571
2016,6,29,0,3631,3616,2088,-1528
2016,6,29,1,3665,3633,2104,-1529
2016,6,29,2,3645,3615,2100,-1515
2016,6,29,3,3528,3539,2146,-1393
2016,6,29,4,3330,3371,2033,-1338
2016,6,29,5,3113,3201,1897,-1304
2016,6,29,6,2792,2931,1884,-1047
2016,6,29,7,2780,2707,1716,-991
2016,6,29,8,2676,2550,1542,-1008
2016,6,29,9,2471,2443,1500,-943
2016,6,29,10,2377,2362,1504,-858
2016,6,29,11,2300,2304,1434,-870
2016,6,29,12,2297,2305,1431,-874
2016,6,29,13,2376,2376,1414,-962
2016,6,29,14,2553,2562,1436,-1126
2016,6,29,15,2755,2720,1467,-1253
2016,6,29,16,2933,2865,1626,-1239
2016,6,29,17,3110,3004,1780,-1224
2016,6,29,18,3282,3135,1810,-1325
2016,6,29,19,3448,3255,1846,-1409
2016,6,29,20,3618,3374,1940,-1434
2016,6,29,21,3767,3406,1989,-1417
2016,6,29,22,3887,3426,2021,-1405
2016,6,29,23,3959,3407,2017,-1390
2016,6,30,0,4009,3366,1982,-1384
2016,6,30,1,4044,3401,1971,-1430
2016,6,30,2,4018,3425,2006,-1419
2016,6,30,3,3903,3378,2065,-1313
2016,6,30,4,3724,3348,2080,-1268
2016,6,30,5,3514,3199,2010,-1189
2016,6,30,6,3179,2971,1871,-1100
2016,6,30,7,2879,2779,1851,-928
2016,6,30,8,2843,2653,1729,-924
2016,6,30,9,2527,2558,1656,-902
2016,6,30,10,2440,2455,1603,-852
2016,6,30,11,2391,2383,1658,-725
2016,6,30,12,2401,2369,1646,-723
2016,6,30,13,2475,2437,1622,-815
2016,6,30,14,2660,2599,1579,-1020
2016,6,30,15,2876,2754,1684,-1070
2016,6,30,16,3077,2883,1702,-1181
2016,6,30,17,3270,3002,1802,-1200
2016,6,30,18,3458,3118,1863,-1255
2016,6,30,19,3660,3249,1932,-1317
2016,6,30,20,3859,3382,1960,-1422
2016,6,30,21,4006,3473,2019,-1454
2016,6,30,22,4116,3527,2028,-1499
2016,6,30,23,4172,3506,2063,-1443
2016,7,1,0,4157,3479,2022,-1457
2016,7,1,1,4165,3460,2156,-1304
2016,7,1,2,4137,3459,2231,-1228
2016,7,1,3,4014,3355,2185,-1170
2016,7,1,4,3845,3243,2107,-1136
2016,7,1,5,3607,3058,1965,-1093
2016,7,1,6,3257,2840,1937,-903
2016,7,1,7,2955,2634,1747,-887
2016,7,1,8,2636,2487,1660,-827
2016,7,1,9,2438,2381,1618,-763
2016,7,1,10,2350,2305,1641,-664
2016,7,1,11,2303,2252,1622,-630
2016,7,1,12,2316,2247,1662,-585
2016,7,1,13,2395,2318,1628,-690
2016,7,1,14,2572,2494,1596,-898
2016,7,1,15,2773,2657,1654,-1003
2016,7,1,16,2944,2794,1746,-1048
2016,7,1,17,3105,2906,1859,-1047
2016,7,1,18,3265,3025,2032,-993
2016,7,1,19,3408,3141,2058,-1083
2016,7,1,20,3562,3216,2017,-1199
2016,7,1,21,3669,3300,1936,-1364
2016,7,1,22,3746,3357,1931,-1426
2016,7,1,23,3755,3385,1970,-1415
2016,7,2,0,3587,3402,2031,-1371
2016,7,2,1,3581,3396,2048,-1348
2016,7,2,2,3566,3364,1952,-1412
2016,7,2,3,3490,3235,1831,-1404
2016,7,2,4,3404,3093,1781,-1312
2016,7,2,5,3272,2957,1671,-1286
2016,7,2,6,3056,2736,1722,-1014
2016,7,2,7,2811,2545,1630,-915
2016,7,2,8,2753,2406,1496,-910
2016,7,2,9,2351,2296,1357,-939
2016,7,2,10,2259,2227,1351,-876
2016,7,2,11,2186,2162,1346,-816
2016,7,2,12,2139,2139,1387,-752
2016,7,2,13,2099,2152,1476,-676
2016,7,2,14,2214,2255,1304,-951
2016,7,2,15,2496,2406,1411,-995
2016,7,2,16,2730,2555,1584,-971
2016,7,2,17,2930,2665,1641,-1024
2016,7,2,18,3096,2770,1687,-1083
2016,7,2,19,3231,2878,1682,-1196
2016,7,2,20,3356,2975,1674,-1301
2016,7,2,21,3434,3077,1685,-1392
2016,7,2,22,3507,3132,1729,-1403
2016,7,2,23,3543,3174,1704,-1470
2016,7,3,0,3528,3155,1695,-1460
2016,7,3,1,3541,3123,1629,-1494
2016,7,3,2,3531,3076,1579,-1497
2016,7,3,3,3438,3011,1538,-1473
2016,7,3,4,3320,2939,1554,-1385
2016,7,3,5,3200,2843,1507,-1336
2016,7,3,6,2995,2665,1607,-1058
2016,7,3,7,2883,2479,1482,-997
2016,7,3,8,2714,2345,1354,-991
2016,7,3,9,2271,2267,1355,-912
2016,7,3,10,2178,2215,1327,-888
2016,7,3,11,2096,2148,1234,-914
2016,7,3,12,2030,2132,1229,-903
2016,7,3,13,1963,2119,1296,-823
2016,7,3,14,2030,2195,1329,-866
2016,7,3,15,2282,2344,1477,-867
2016,7,3,16,2486,2491,1630,-861
2016,7,3,17,2670,2616,1726,-890
2016,7,3,18,2814,2727,1713,-1014
2016,7,3,19,2966,2806,1782,-1024
2016,7,3,20,3072,2906,1746,-1160
2016,7,3,21,3161,2962,1774,-1188
2016,7,3,22,3243,3028,1818,-1210
2016,7,3,23,3290,3069,1771,-1298
2016,7,4,0,3298,3094,1803,-1291
2016,7,4,1,3309,3106,1824,-1282
2016,7,4,2,3285,3081,1794,-1287
2016,7,4,3,3203,2981,1745,-1236
2016,7,4,4,3097,2871,1699,-1172
2016,7,4,5,2940,2754,1640,-1114
2016,7,4,6,2679,2573,1546,-1027
2016,7,4,7,2586,2369,1413,-956
2016,7,4,8,2426,2226,1329,-897
2016,7,4,9,2178,2110,1317,-793
2016,7,4,10,2099,2045,1334,-711
2016,7,4,11,2058,2007,1333,-674
2016,7,4,12,2079,1980,1305,-675
2016,7,4,13,2181,1990,1305,-685
2016,7,4,14,2362,2076,1342,-734
2016,7,4,15,2605,2232,1498,-734
2016,7,4,16,2792,2334,1635,-699
2016,7,4,17,2974,2431,1680,-751
2016,7,4,18,3157,2517,1728,-789
2016,7,4,19,3310,2585,1717,-868
2016,7,4,20,3459,2656,1605,-1051
2016,7,4,21,3582,2720,1584,-1136
2016,7,4,22,3672,2784,1591,-1193
2016,7,4,23,3694,2838,1582,-1256
2016,7,5,0,3647,2841,1617,-1224
2016,7,5,1,3643,2825,1678,-1147
2016,7,5,2,3616,2790,1634,-1156
2016,7,5,3,3527,2691,1557,-1134
2016,7,5,4,3405,2587,1562,-1025
2016,7,5,5,3190,2468,1517,-951
2016,7,5,6,2894,2364,1468,-896
2016,7,5,7,2691,2235,1464,-771
2016,7,5,8,2519,2110,1455,-655
2016,7,5,9,2004,2050,1443,-607
2016,7,5,10,1907,1994,1363,-631
2016,7,5,11,1839,1976,1363,-613
2016,7,5,12,1830,1990,1337,-653
2016,7,5,13,1900,2072,1406,-666
2016,7,5,14,2046,2228,1453,-775
2016,7,5,15,2191,2367,1571,-796
2016,7,5,16,2341,2457,1518,-939
2016,7,5,17,2496,2541,1509,-1032
2016,7,5,18,2654,2614,1485,-1129
2016,7,5,19,2791,2674,1479,-1195
2016,7,5,20,2933,2734,1471,-1263
2016,7,5,21,3056,2806,1501,-1305
2016,7,5,22,3139,2859,1509,-1350
2016,7,5,23,3177,2874,1463,-1411
2016,7,6,0,3155,2862,1383,-1479
2016,7,6,1,3158,2877,1359,-1518
2016,7,6,2,3141,2878,1371,-1507
2016,7,6,3,3072,2840,1394,-1446
2016,7,6,4,2952,2769,1526,-1243
2016,7,6,5,2764,2656,1549,-1107
2016,7,6,6,2496,2441,1399,-1042
2016,7,6,7,2675,2286,1372,-914
2016,7,6,8,2500,2185,1449,-736
2016,7,6,9,2039,2132,1556,-576
2016,7,6,10,1944,2080,1528,-552
2016,7,6,11,1877,2054,1532,-522
2016,7,6,12,1874,2082,1527,-555
2016,7,6,13,1938,2155,1595,-560
2016,7,6,14,2077,2305,1671,-634
2016,7,6,15,2244,2416,1626,-790
2016,7,6,16,2409,2473,1603,-870
2016,7,6,17,2584,2537,1592,-945
2016,7,6,18,2755,2585,1603,-982
2016,7,6,19,2906,2627,1650,-977
2016,7,6,20,3054,2677,1660,-1017
2016,7,6,21,3176,2711,1705,-1006
2016,7,6,22,3263,2725,1725,-1000
2016,7,6,23,3283,2724,1746,-978
2016,7,7,0,3244,2712,1719,-993
2016,7,7,1,3239,2736,1712,-1024
2016,7,7,2,3272,2734,1680,-1054
2016,7,7,3,3225,2707,1610,-1097
2016,7,7,4,3134,2669,1584,-1085
2016,7,7,5,2974,2563,1541,-1022
2016,7,7,6,2729,2374,1393,-981
2016,7,7,7,2862,2220,1239,-981
2016,7,7,8,2115,2120,1177,-943
2016,7,7,9,2032,2075,1154,-921
2016,7,7,10,1971,2018,1108,-910
2016,7,7,11,1932,2000,1105,-895
2016,7,7,12,1946,2028,1148,-880
2016,7,7,13,2023,2106,1197,-909
2016,7,7,14,2193,2258,1195,-1063
2016,7,7,15,2329,2368,1267,-1101
2016,7,7,16,2465,2466,1243,-1223
2016,7,7,17,2586,2546,1279,-1267
2016,7,7,18,2694,2619,1286,-1333
2016,7,7,19,2814,2683,1261,-1422
2016,7,7,20,2932,2778,1339,-1439
2016,7,7,21,3042,2876,1415,-1461
2016,7,7,22,3127,2967,1468,-1499
2016,7,7,23,3184,3020,1525,-1495
2016,7,8,0,3194,3070,1622,-1448
2016,7,8,1,3226,3087,1641,-1446
2016,7,8,2,3227,3056,1635,-1421
2016,7,8,3,3170,2990,1601,-1389
2016,7,8,4,3068,2918,1515,-1403
2016,7,8,5,2884,2776,1368,-1408
2016,7,8,6,2634,2552,1289,-1263
2016,7,8,7,2419,2380,1292,-1088
2016,7,8,8,2329,2250,1263,-987
2016,7,8,9,2240,2178,1227,-951
2016,7,8,10,2191,2124,1170,-954
2016,7,8,11,2160,2091,1180,-911
2016,7,8,12,2175,2103,1231,-872
2016,7,8,13,2251,2175,1201,-974
2016,7,8,14,2411,2313,1164,-1149
2016,7,8,15,2520,2430,1176,-1254
2016,7,8,16,2608,2524,1289,-1235
2016,7,8,17,2697,2625,1399,-1226
2016,7,8,18,2781,2724,1443,-1281
2016,7,8,19,2894,2807,1481,-1326
2016,7,8,20,3014,2864,1523,-1341
2016,7,8,21,3130,2937,1603,-1334
2016,7,8,22,3222,3009,1694,-1315
2016,7,8,23,3265,3043,1610,-1433
2016,7,9,0,3361,3042,1565,-1477
2016,7,9,1,3376,3049,1637,-1412
2016,7,9,2,3342,2956,1601,-1355
2016,7,9,3,3256,2855,1485,-1370
2016,7,9,4,3139,2794,1392,-1402
2016,7,9,5,2967,2688,1317,-1371
2016,7,9,6,2721,2514,1370,-1144
2016,7,9,7,2471,2352,1308,-1044
2016,7,9,8,2322,2255,1210,-1045
2016,7,9,9,2170,2178,1180,-998
2016,7,9,10,2107,2118,1157,-961
2016,7,9,11,2064,2068,1150,-918
2016,7,9,12,2026,2054,1160,-894
2016,7,9,13,2016,2065,1160,-905
2016,7,9,14,2128,2164,1116,-1048
2016,7,9,15,2316,2277,1158,-1119
2016,7,9,16,2454,2364,1188,-1176
2016,7,9,17,2556,2451,1260,-1191
2016,7,9,18,2638,2541,1325,-1216
2016,7,9,19,2734,2601,1328,-1273
2016,7,9,20,2835,2639,1353,-1286
2016,7,9,21,2948,2675,1396,-1279
2016,7,9,22,3053,2747,1455,-1292
2016,7,9,23,3122,2796,1496,-1300
2016,7,10,0,3123,2822,1450,-1372
2016,7,10,1,3147,2810,1384,-1426
2016,7,10,2,3102,2750,1467,-1283
2016,7,10,3,3007,2658,1409,-1249
2016,7,10,4,2899,2617,1358,-1259
2016,7,10,5,2754,2519,1318,-1201
2016,7,10,6,2555,2347,1292,-1055
2016,7,10,7,2380,2215,1453,-762
2016,7,10,8,2232,2115,1420,-695
2016,7,10,9,2038,2056,1397,-659
2016,7,10,10,1979,1994,1364,-630
2016,7,10,11,1933,1966,1304,-662
2016,7,10,12,1890,1946,1320,-626
2016,7,10,13,1848,1929,1299,-630
2016,7,10,14,1892,1973,1313,-660
2016,7,10,15,2009,2042,1484,-558
2016,7,10,16,2088,2100,1500,-600
2016,7,10,17,2154,2124,1590,-534
2016,7,10,18,2195,1973,1507,-466
2016,7,10,19,2240,2309,1865,-444
2016,7,10,20,2275,2142,1642,-500
2016,7,10,21,2308,2119,1588,-531
2016,7,10,22,2367,2096,1607,-489
2016,7,10,23,2420,2081,1532,-549
2016,7,11,0,2443,2072,1662,-410
2016,7,11,1,2449,2067,1701,-366
2016,7,11,2,2393,2043,1775,-268
2016,7,11,3,2300,2042,1696,-346
2016,7,11,4,2233,2049,1587,-462
2016,7,11,5,2132,2022,1544,-478
2016,7,11,6,1968,1902,1376,-526
2016,7,11,7,1869,1808,1330,-478
2016,7,11,8,1770,1758,1325,-433
2016,7,11,9,1712,1729,1268,-461
2016,7,11,10,1697,1729,1235,-494
2016,7,11,11,1704,1742,1205,-537
2016,7,11,12,1750,1802,1225,-577
2016,7,11,13,1851,1901,1319,-582
2016,7,11,14,1980,2051,1353,-698
2016,7,11,15,2145,2163,1324,-839
2016,7,11,16,2192,2217,1297,-920
2016,7,11,17,2234,2264,1234,-1030
2016,7,11,18,2281,2285,1210,-1075
2016,7,11,19,2326,2302,1127,-1175
2016,7,11,20,2371,2322,1119,-1203
2016,7,11,21,2421,2343,1140,-1203
2016,7,11,22,2476,2357,1154,-1203
2016,7,11,23,2504,2379,1194,-1185
2016,7,12,0,2496,2402,1210,-1192
2016,7,12,1,2517,2449,1279,-1170
2016,7,12,2,2505,2465,1294,-1171
2016,7,12,3,2458,2438,1354,-1084
2016,7,12,4,2411,2424,1326,-1098
2016,7,12,5,2294,2344,1281,-1063
2016,7,12,6,2115,2168,1166,-1002
2016,7,12,7,2062,2029,1097,-932
2016,7,12,8,2007,1952,1055,-897
2016,7,12,9,1930,1906,1058,-848
2016,7,12,10,1901,1876,1059,-817
2016,7,12,11,1891,1858,1088,-770
2016,7,12,12,1932,1901,1114,-787
2016,7,12,13,2030,1984,1123,-861
2016,7,12,14,2186,2113,1081,-1032
2016,7,12,15,2299,2219,1080,-1139
2016,7,12,16,2406,2283,1088,-1195
2016,7,12,17,2493,2356,1135,-1221
2016,7,12,18,2572,2402,1189,-1213
2016,7,12,19,2628,2451,1235,-1216
2016,7,12,20,2682,2518,1317,-1201
2016,7,12,21,2744,2576,1392,-1184
2016,7,12,22,2802,2653,1488,-1165
2016,7,12,23,2839,2671,1507,-1164
2016,7,13,0,2844,2693,1453,-1240
2016,7,13,1,2872,2680,1447,-1233
2016,7,13,2,2868,2657,1490,-1167
2016,7,13,3,2805,2600,1527,-1073
2016,7,13,4,2712,2542,1520,-1022
2016,7,13,5,2558,2443,1478,-965
2016,7,13,6,2332,2250,1402,-848
2016,7,13,7,2263,2110,1418,-692
2016,7,13,8,2124,2021,1371,-650
2016,7,13,9,1989,1974,1299,-675
2016,7,13,10,1949,1923,1270,-653
2016,7,13,11,1923,1906,1253,-653
2016,7,13,12,1950,1937,1290,-647
2016,7,13,13,2039,2026,1354,-672
2016,7,13,14,2183,2149,1322,-827
2016,7,13,15,2275,2266,1278,-988
2016,7,13,16,2333,2327,1195,-1132
2016,7,13,17,2388,2391,1287,-1104
2016,7,13,18,2436,2451,1327,-1124
2016,7,13,19,2474,2497,1344,-1153
2016,7,13,20,2514,2557,1412,-1145
2016,7,13,21,2551,2606,1463,-1143
2016,7,13,22,2602,2670,1491,-1179
2016,7,13,23,2646,2721,1510,-1211
2016,7,14,0,2659,2754,1532,-1222
2016,7,14,1,2684,2800,1567,-1233
2016,7,14,2,2681,2790,1556,-1234
2016,7,14,3,2626,2730,1540,-1190
2016,7,14,4,2535,2633,1453,-1180
2016,7,14,5,2413,2523,1403,-1120
2016,7,14,6,2208,2309,1306,-1003
2016,7,14,7,2231,2139,1259,-880
2016,7,14,8,2089,2047,1247,-800
2016,7,14,9,2028,1989,1217,-772
2016,7,14,10,1998,1955,1188,-767
2016,7,14,11,1980,1921,1121,-800
2016,7,14,12,2012,1947,1122,-825
2016,7,14,13,2099,2037,1207,-830
2016,7,14,14,2247,2171,1249,-922
2016,7,14,15,2354,2295,1224,-1071
2016,7,14,16,2430,2377,1187,-1190
2016,7,14,17,2494,2463,1158,-1305
2016,7,14,18,2556,2544,1196,-1348
2016,7,14,19,2608,2637,1257,-1380
2016,7,14,20,2669,2744,1371,-1373
2016,7,14,21,2729,2856,1529,-1327
2016,7,14,22,2799,2949,1585,-1364
2016,7,14,23,2844,3020,1658,-1362
2016,7,15,0,2859,3071,1703,-1368
2016,7,15,1,2877,3103,1725,-1378
2016,7,15,2,2876,3082,1636,-1446
2016,7,15,3,2818,3003,1583,-1420
2016,7,15,4,2730,2877,1490,-1387
2016,7,15,5,2565,2722,1377,-1345
2016,7,15,6,2325,2495,1275,-1220
2016,7,15,7,2282,2305,1197,-1108
2016,7,15,8,2180,2183,1158,-1025
2016,7,15,9,2154,2111,1179,-932
2016,7,15,10,2104,2048,1144,-904
2016,7,15,11,2078,2015,1139,-876
2016,7,15,12,2097,2033,1144,-889
2016,7,15,13,2175,2112,1165,-947
2016,7,15,14,2323,2251,1203,-1048
2016,7,15,15,2428,2364,1146,-1218
2016,7,15,16,2490,2461,1235,-1226
2016,7,15,17,2557,2556,1317,-1239
2016,7,15,18,2634,2647,1371,-1276
2016,7,15,19,2701,2714,1437,-1277
2016,7,15,20,2783,2820,1511,-1309
2016,7,15,21,2857,2909,1589,-1320
2016,7,15,22,2917,2972,1676,-1296
2016,7,15,23,2949,3017,1773,-1244
2016,7,16,0,3075,3036,1844,-1192
2016,7,16,1,3066,3049,1902,-1147
2016,7,16,2,3015,3019,1899,-1120
2016,7,16,3,2915,2918,1808,-1110
2016,7,16,4,2805,2800,1681,-1119
2016,7,16,5,2662,2677,1619,-1058
2016,7,16,6,2410,2467,1566,-901
2016,7,16,7,2306,2280,1458,-822
2016,7,16,8,2188,2168,1392,-776
2016,7,16,9,2097,2088,1478,-610
2016,7,16,10,2034,2030,1566,-464
2016,7,16,11,1981,2000,1578,-422
2016,7,16,12,1954,1979,1498,-481
2016,7,16,13,1938,1988,1449,-539
2016,7,16,14,2020,2062,1435,-627
2016,7,16,15,2140,2176,1434,-742
2016,7,16,16,2230,2278,1526,-752
2016,7,16,17,2314,2350,1607,-743
2016,7,16,18,2392,2412,1581,-831
2016,7,16,19,2451,2455,1543,-912
2016,7,16,20,2520,2507,1437,-1070
2016,7,16,21,2583,2556,1396,-1160
2016,7,16,22,2650,2626,1414,-1212
2016,7,16,23,2720,2677,1506,-1171
2016,7,17,0,2755,2734,1600,-1134
2016,7,17,1,2771,2751,1651,-1100
2016,7,17,2,2751,2739,1676,-1063
2016,7,17,3,2666,2658,1557,-1101
2016,7,17,4,2548,2582,1451,-1131
2016,7,17,5,2441,2472,1422,-1050
2016,7,17,6,2255,2294,1261,-1033
2016,7,17,7,2197,2142,1158,-984
2016,7,17,8,2035,2049,1124,-925
2016,7,17,9,1983,1981,1092,-889
2016,7,17,10,1936,1937,1091,-846
2016,7,17,11,1903,1906,1101,-805
2016,7,17,12,1889,1887,1053,-834
2016,7,17,13,1870,1883,1049,-834
2016,7,17,14,1933,1947,1026,-921
2016,7,17,15,2064,2035,1023,-1012
2016,7,17,16,2183,2144,1046,-1098
2016,7,17,17,2282,2223,1031,-1192
2016,7,17,18,2371,2308,1081,-1227
2016,7,17,19,2460,2404,1159,-1245
2016,7,17,20,2542,2496,1182,-1314
2016,7,17,21,2642,2619,1275,-1344
2016,7,17,22,2728,2745,1360,-1385
2016,7,17,23,2807,2862,1473,-1389
2016,7,18,0,2879,2947,1568,-1379
2016,7,18,1,2919,2971,1612,-1359
2016,7,18,2,2920,2946,1573,-1373
2016,7,18,3,2837,2864,1517,-1347
2016,7,18,4,2719,2769,1505,-1264
2016,7,18,5,2591,2606,1425,-1181
2016,7,18,6,2350,2379,1200,-1179
2016,7,18,7,2207,2179,1101,-1078
2016,7,18,8,2076,2076,1130,-946
2016,7,18,9,2034,2000,1168,-832
2016,7,18,10,2000,1944,1159,-785
2016,7,18,11,1992,1940,1149,-791
2016,7,18,12,2038,1986,1187,-799
2016,7,18,13,2139,2078,1253,-825
2016,7,18,14,2284,2227,1260,-967
2016,7,18,15,2477,2372,1204,-1168
2016,7,18,16,2579,2507,1267,-1240
2016,7,18,17,2667,2629,1427,-1202
2016,7,18,18,2752,2750,1534,-1216
2016,7,18,19,2808,2864,1632,-1232
2016,7,18,20,2880,2976,1616,-1360
2016,7,18,21,2946,3082,1626,-1456
2016,7,18,22,3008,3165,1698,-1467
2016,7,18,23,3056,3208,1737,-1471
2016,7,19,0,3057,3261,1794,-1467
2016,7,19,1,3077,3276,1838,-1438
2016,7,19,2,3055,3244,1743,-1501
2016,7,19,3,2965,3149,1661,-1488
2016,7,19,4,2840,3007,1665,-1342
2016,7,19,5,2677,2820,1609,-1211
2016,7,19,6,2429,2566,1450,-1116
2016,7,19,7,2314,2369,1373,-996
2016,7,19,8,2183,2228,1305,-923
2016,7,19,9,2170,2142,1370,-772
2016,7,19,10,2107,2078,1420,-658
2016,7,19,11,2084,2048,1430,-618
2016,7,19,12,2104,2079,1429,-650
2016,7,19,13,2194,2145,1306,-839
2016,7,19,14,2342,2284,1241,-1043
2016,7,19,15,2417,2409,1238,-1171
2016,7,19,16,2495,2514,1261,-1253
2016,7,19,17,2563,2606,1359,-1247
2016,7,19,18,2645,2715,1427,-1288
2016,7,19,19,2713,2808,1478,-1330
2016,7,19,20,2796,2918,1521,-1397
2016,7,19,21,2903,3037,1594,-1443
2016,7,19,22,2999,3118,1671,-1447
2016,7,19,23,3059,3200,1759,-1441
2016,7,20,0,3094,3237,1811,-1426
2016,7,20,1,3131,3234,1739,-1495
2016,7,20,2,3104,3190,1718,-1472
2016,7,20,3,3007,3081,1624,-1457
2016,7,20,4,2856,2957,1542,-1415
2016,7,20,5,2659,2771,1386,-1385
2016,7,20,6,2395,2526,1303,-1223
2016,7,20,7,2311,2338,1253,-1085
2016,7,20,8,2211,2223,1309,-914
2016,7,20,9,2146,2144,1307,-837
2016,7,20,10,2076,2086,1330,-756
2016,7,20,11,2039,2053,1349,-704
2016,7,20,12,2067,2102,1398,-704
2016,7,20,13,2158,2166,1414,-752
2016,7,20,14,2313,2308,1407,-901
2016,7,20,15,2415,2444,1407,-1037
2016,7,20,16,2498,2544,1402,-1142
2016,7,20,17,2583,2639,1399,-1240
2016,7,20,18,2682,2714,1399,-1315
2016,7,20,19,2766,2816,1441,-1375
2016,7,20,20,2865,2923,1457,-1466
2016,7,20,21,2978,3022,1519,-1503
2016,7,20,22,3070,3128,1635,-1493
2016,7,20,23,3130,3189,1710,-1479
2016,7,21,0,3162,3227,1761,-1466
2016,7,21,1,3185,3263,1835,-1428
2016,7,21,2,3152,3226,1826,-1400
2016,7,21,3,3043,3139,1725,-1414
2016,7,21,4,2888,3017,1653,-1364
2016,7,21,5,2682,2835,1484,-1351
2016,7,21,6,2413,2576,1374,-1202
2016,7,21,7,2358,2379,1251,-1128
2016,7,21,8,2240,2243,1132,-1111
2016,7,21,9,2199,2168,1101,-1067
2016,7,21,10,2140,2109,1096,-1013
2016,7,21,11,2113,2076,1035,-1041
2016,7,21,12,2138,2099,1033,-1066
2016,7,21,13,2222,2176,1090,-1086
2016,7,21,14,2372,2317,1099,-1218
2016,7,21,15,2509,2449,1206,-1243
2016,7,21,16,2616,2543,1309,-1234
2016,7,21,17,2726,2675,1262,-1413
2016,7,21,18,2874,2793,1312,-1481
2016,7,21,19,3003,2917,1346,-1571
2016,7,21,20,3129,3075,1450,-1625
2016,7,21,21,3246,3208,1558,-1650
2016,7,21,22,3344,3326,1689,-1637
2016,7,21,23,3405,3418,1800,-1618
2016,7,22,0,3441,3424,1856,-1568
2016,7,22,1,3459,3450,1852,-1598
2016,7,22,2,3415,3413,1817,-1596
2016,7,22,3,3291,3310,1680,-1630
2016,7,22,4,3124,3180,1603,-1577
2016,7,22,5,2897,2983,1491,-1492
2016,7,22,6,2628,2706,1475,-1231
2016,7,22,7,2518,2507,1388,-1119
2016,7,22,8,2391,2353,1311,-1042
2016,7,22,9,2306,2271,1331,-940
2016,7,22,10,2236,2200,1392,-808
2016,7,22,11,2208,2165,1529,-636
2016,7,22,12,2228,2179,1537,-642
2016,7,22,13,2308,2245,1557,-688
2016,7,22,14,2443,2379,1598,-781
2016,7,22,15,2551,2540,1606,-934
2016,7,22,16,2621,2661,1621,-1040
2016,7,22,17,2684,2758,1598,-1160
2016,7,22,18,2757,2860,1559,-1301
2016,7,22,19,2829,2936,1554,-1382
2016,7,22,20,2912,3037,1601,-1436
2016,7,22,21,3006,3107,1702,-1405
2016,7,22,22,3091,3170,1733,-1437
2016,7,22,23,3136,3198,1769,-1429
2016,7,23,0,3193,3200,1816,-1384
2016,7,23,1,3175,3179,1842,-1337
2016,7,23,2,3108,3112,1786,-1326
2016,7,23,3,2980,2998,1658,-1340
2016,7,23,4,2811,2877,1550,-1327
2016,7,23,5,2644,2745,1425,-1320
2016,7,23,6,2397,2538,1290,-1248
2016,7,23,7,2340,2232,1271,-961
2016,7,23,8,2188,2234,1361,-873
2016,7,23,9,2168,2152,1468,-684
2016,7,23,10,2094,2089,1439,-650
2016,7,23,11,2030,2031,1469,-562
2016,7,23,12,2000,2020,1476,-544
2016,7,23,13,1984,2018,1473,-545
2016,7,23,14,2052,2110,1462,-648
2016,7,23,15,2180,2237,1442,-795
2016,7,23,16,2289,2337,1472,-865
2016,7,23,17,2385,2436,1469,-967
2016,7,23,18,2474,2495,1443,-1052
2016,7,23,19,2567,2551,1378,-1173
2016,7,23,20,2661,2606,1352,-1254
2016,7,23,21,2752,2669,1398,-1271
2016,7,23,22,2854,2729,1422,-1307
2016,7,23,23,2936,2806,1500,-1306
2016,7,24,0,2978,2843,1574,-1269
2016,7,24,1,2980,2860,1721,-1139
2016,7,24,2,2938,2830,1785,-1045
2016,7,24,3,2826,2746,1757,-989
2016,7,24,4,2668,2666,1769,-897
2016,7,24,5,2536,2526,1596,-930
2016,7,24,6,2339,2358,1577,-781
2016,7,24,7,2232,2201,1423,-778
2016,7,24,8,2111,2094,1381,-713
2016,7,24,9,2038,2031,1314,-717
2016,7,24,10,1984,1983,1245,-738
2016,7,24,11,1942,1951,1222,-729
2016,7,24,12,1924,1946,1209,-737
2016,7,24,13,1903,1930,1207,-723
2016,7,24,14,1966,1996,1195,-801
2016,7,24,15,2102,2116,1169,-947
2016,7,24,16,2219,2213,1159,-1054
2016,7,24,17,2321,2317,1113,-1204
2016,7,24,18,2408,2396,1111,-1285
2016,7,24,19,2504,2488,1224,-1264
2016,7,24,20,2597,2582,1275,-1307
2016,7,24,21,2706,2690,1327,-1363
2016,7,24,22,2809,2806,1476,-1330
2016,7,24,23,2906,2899,1607,-1292
2016,7,25,0,2972,2990,1695,-1295
2016,7,25,1,3003,3021,1730,-1291
2016,7,25,2,2984,3011,1737,-1274
2016,7,25,3,2890,2905,1605,-1300
2016,7,25,4,2738,2777,1461,-1316
2016,7,25,5,2553,2607,1296,-1311
2016,7,25,6,2306,2369,1131,-1238
2016,7,25,7,2173,2178,1021,-1157
2016,7,25,8,2040,2058,973,-1085
2016,7,25,9,2020,2002,977,-1025
2016,7,25,10,1977,1953,975,-978
2016,7,25,11,1973,1953,990,-963
2016,7,25,12,2030,1992,974,-1018
2016,7,25,13,2138,2077,1048,-1029
2016,7,25,14,2280,2230,1065,-1165
2016,7,25,15,2480,2374,1058,-1316
2016,7,25,16,2594,2500,1121,-1379
2016,7,25,17,2711,2631,1088,-1543
2016,7,25,18,2818,2746,1180,-1566
2016,7,25,19,2927,2867,1278,-1589
2016,7,25,20,3055,3010,1443,-1567
2016,7,25,21,3172,3153,1632,-1521
2016,7,25,22,3275,3272,1774,-1498
2016,7,25,23,3340,3358,1878,-1480
2016,7,26,0,3368,3402,1926,-1476
2016,7,26,1,3384,3444,1953,-1491
2016,7,26,2,3353,3401,1945,-1456
2016,7,26,3,3240,3292,1830,-1462
2016,7,26,4,3062,3163,1683,-1480
2016,7,26,5,2857,2947,1592,-1355
2016,7,26,6,2594,2666,1441,-1225
2016,7,26,7,2464,2469,1268,-1201
2016,7,26,8,2327,2334,1141,-1193
2016,7,26,9,2266,2231,1060,-1171
2016,7,26,10,2188,2165,1002,-1163
2016,7,26,11,2151,2130,1005,-1125
2016,7,26,12,2173,2136,997,-1139
2016,7,26,13,2255,2212,1026,-1186
2016,7,26,14,2397,2339,1045,-1294
2016,7,26,15,2518,2475,1051,-1424
2016,7,26,16,2640,2605,1106,-1499
2016,7,26,17,2755,2737,1250,-1487
2016,7,26,18,2879,2866,1377,-1489
2016,7,26,19,3007,3006,1508,-1498
2016,7,26,20,3130,3147,1643,-1504
2016,7,26,21,3252,3282,1797,-1485
2016,7,26,22,3366,3385,1903,-1482
2016,7,26,23,3431,3358,1888,-1470
2016,7,27,0,3457,3409,1966,-1443
2016,7,27,1,3463,3419,1960,-1459
2016,7,27,2,3420,3403,1953,-1450
2016,7,27,3,3285,3318,1852,-1466
2016,7,27,4,3087,3200,1698,-1502
2016,7,27,5,2859,2979,1525,-1454
2016,7,27,6,2567,2731,1356,-1375
2016,7,27,7,2505,2528,1250,-1278
2016,7,27,8,2357,2378,1088,-1290
2016,7,27,9,2305,2288,1092,-1196
2016,7,27,10,2218,2205,1044,-1161
2016,7,27,11,2166,2162,1028,-1134
2016,7,27,12,2184,2173,1020,-1153
2016,7,27,13,2269,2258,1063,-1195
2016,7,27,14,2399,2370,1047,-1323
2016,7,27,15,2513,2510,1059,-1451
2016,7,27,16,2628,2648,1155,-1493
2016,7,27,17,2733,2787,1310,-1477
2016,7,27,18,2858,2931,1396,-1535
2016,7,27,19,2999,3070,1536,-1534
2016,7,27,20,3136,3198,1636,-1562
2016,7,27,21,3271,3265,1739,-1526
2016,7,27,22,3376,3307,1855,-1452
2016,7,27,23,3422,3319,1820,-1499
2016,7,28,0,3456,3280,1755,-1525
2016,7,28,1,3466,3294,1749,-1545
2016,7,28,2,3438,3300,1814,-1486
2016,7,28,3,3305,3257,1787,-1470
2016,7,28,4,3132,3210,1698,-1512
2016,7,28,5,2907,3014,1563,-1451
2016,7,28,6,2621,2761,1406,-1355
2016,7,28,7,2549,2541,1286,-1255
2016,7,28,8,2413,2394,1170,-1224
2016,7,28,9,2335,2303,1130,-1173
2016,7,28,10,2251,2217,1183,-1034
2016,7,28,11,2212,2171,1149,-1022
2016,7,28,12,2220,2187,1132,-1055
2016,7,28,13,2302,2252,1127,-1125
2016,7,28,14,2430,2379,1119,-1260
2016,7,28,15,2555,2542,1122,-1420
2016,7,28,16,2674,2673,1198,-1475
2016,7,28,17,2780,2823,1357,-1466
2016,7,28,18,2912,2957,1407,-1550
2016,7,28,19,3042,3086,1533,-1553
2016,7,28,20,3184,3226,1658,-1568
2016,7,28,21,3297,3338,1813,-1525
2016,7,28,22,3358,3427,1942,-1485
2016,7,28,23,3368,3435,1948,-1487
2016,7,29,0,3355,3443,1937,-1506
2016,7,29,1,3363,3438,1925,-1513
2016,7,29,2,3344,3423,1909,-1514
2016,7,29,3,3238,3331,1787,-1544
2016,7,29,4,3094,3202,1670,-1532
2016,7,29,5,2884,3014,1574,-1440
2016,7,29,6,2596,2756,1431,-1325
2016,7,29,7,2526,2534,1288,-1246
2016,7,29,8,2378,2390,1175,-1215
2016,7,29,9,2331,2289,1126,-1163
2016,7,29,10,2251,2219,1083,-1136
2016,7,29,11,2201,2162,1041,-1121
2016,7,29,12,2208,2194,1041,-1153
2016,7,29,13,2289,2252,1070,-1182
2016,7,29,14,2421,2375,1086,-1289
2016,7,29,15,2566,2514,1098,-1416
2016,7,29,16,2702,2667,1112,-1555
2016,7,29,17,2829,2801,1201,-1600
2016,7,29,18,2974,2949,1436,-1513
2016,7,29,19,3102,3056,1503,-1553
2016,7,29,20,3239,3200,1627,-1573
2016,7,29,21,3352,3263,1727,-1536
2016,7,29,22,3430,3269,1770,-1499
2016,7,29,23,3436,3262,1806,-1456
2016,7,30,0,3470,3220,1790,-1430
2016,7,30,1,3457,3234,1742,-1492
2016,7,30,2,3414,3233,1680,-1553
2016,7,30,3,3300,3188,1671,-1517
2016,7,30,4,3142,3126,1696,-1430
2016,7,30,5,2948,2959,1611,-1348
2016,7,30,6,2670,2738,1420,-1318
2016,7,30,7,2558,2541,1224,-1317
2016,7,30,8,2408,2384,1075,-1309
2016,7,30,9,2321,2286,1063,-1223
2016,7,30,10,2263,2212,1039,-1173
2016,7,30,11,2206,2146,1030,-1116
2016,7,30,12,2179,2134,998,-1136
2016,7,30,13,2186,2136,984,-1152
2016,7,30,14,2261,2223,956,-1267
2016,7,30,15,2446,2373,1022,-1351
2016,7,30,16,2614,2532,1160,-1372
2016,7,30,17,2772,2696,1248,-1448
2016,7,30,18,2900,2821,1339,-1482
2016,7,30,19,3012,2947,1389,-1558
2016,7,30,20,3123,3086,1430,-1656
2016,7,30,21,3207,3194,1558,-1636
2016,7,30,22,3251,3280,1625,-1655
2016,7,30,23,3281,3335,1712,-1623
2016,7,31,0,3287,3352,1886,-1466
2016,7,31,1,3288,3340,1902,-1438
2016,7,31,2,3259,3292,1827,-1465
2016,7,31,3,3162,3188,1784,-1404
2016,7,31,4,3057,3048,1724,-1324
2016,7,31,5,2890,2885,1556,-1329
2016,7,31,6,2659,2666,1480,-1186
2016,7,31,7,2563,2477,1262,-1215
2016,7,31,8,2368,2331,1144,-1187
2016,7,31,9,2274,2227,1049,-1178
2016,7,31,10,2196,2144,1014,-1130
2016,7,31,11,2137,2080,1116,-964
2016,7,31,12,2093,2056,1165,-891
2016,7,31,13,2060,2045,1200,-845
2016,7,31,14,2097,2080,1126,-954
2016,7,31,15,2224,2213,1148,-1065
2016,7,31,16,2346,2341,1216,-1125
2016,7,31,17,2468,2464,1360,-1104
2016,7,31,18,2582,2547,1422,-1125
2016,7,31,19,2675,2631,1491,-1140
2016,7,31,20,2773,2726,1488,-1238
2016,7,31,21,2857,2815,1424,-1391
2016,7,31,22,2920,2891,1392,-1499
2016,7,31,23,2969,2983,1448,-1535
2016,8,1,0,3018,3054,1534,-1520
2016,8,1,1,3046,3064,1615,-1449
2016,8,1,2,3025,3023,1574,-1449
2016,8,1,3,2918,2912,1444,-1468
2016,8,1,4,2790,2807,1327,-1480
2016,8,1,5,2602,2617,1269,-1348
2016,8,1,6,2345,2386,1239,-1147
2016,8,1,7,2220,2205,1211,-994
2016,8,1,8,2076,2090,1201,-889
2016,8,1,9,2025,2035,1158,-877
2016,8,1,10,1960,1982,1130,-852
2016,8,1,11,1939,1978,1153,-825
2016,8,1,12,1980,2021,1142,-879
2016,8,1,13,2074,2104,1199,-905
2016,8,1,14,2194,2229,1079,-1150
2016,8,1,15,2372,2345,1032,-1313
2016,8,1,16,2482,2470,1137,-1333
2016,8,1,17,2583,2566,1213,-1353
2016,8,1,18,2711,2665,1310,-1355
2016,8,1,19,2828,2754,1351,-1403
2016,8,1,20,2960,2870,1354,-1516
2016,8,1,21,3076,2982,1475,-1507
2016,8,1,22,3159,3091,1560,-1531
2016,8,1,23,3206,3206,1648,-1558
2016,8,2,0,3230,3240,1633,-1607
2016,8,2,1,3245,3263,1632,-1631
2016,8,2,2,3232,3243,1661,-1582
2016,8,2,3,3121,3112,1584,-1528
2016,8,2,4,2975,2984,1460,-1524
2016,8,2,5,2746,2789,1254,-1535
2016,8,2,6,2479,2533,1232,-1301
2016,8,2,7,2364,2348,1127,-1221
2016,8,2,8,2228,2226,1092,-1134
2016,8,2,9,2187,2150,1054,-1096
2016,8,2,10,2123,2095,1010,-1085
2016,8,2,11,2090,2072,1005,-1067
2016,8,2,12,2116,2098,1053,-1045
2016,8,2,13,2205,2179,1239,-940
2016,8,2,14,2340,2286,1139,-1147
2016,8,2,15,2482,2409,1224,-1185
2016,8,2,16,2624,2525,1172,-1353
2016,8,2,17,2751,2658,1314,-1344
2016,8,2,18,2891,2776,1369,-1407
2016,8,2,19,3003,2901,1452,-1449
2016,8,2,20,3121,3020,1536,-1484
2016,8,2,21,3218,3162,1676,-1486
2016,8,2,22,3286,3244,1707,-1537
2016,8,2,23,3330,3322,1797,-1525
2016,8,3,0,3352,3339,1768,-1571
2016,8,3,1,3350,3344,1728,-1616
2016,8,3,2,3305,3296,1694,-1602
2016,8,3,3,3142,3165,1587,-1578
2016,8,3,4,2958,3017,1483,-1534
2016,8,3,5,2688,2813,1382,-1431
2016,8,3,6,2397,2554,1478,-1076
2016,8,3,7,2331,2363,1515,-848
2016,8,3,8,2220,2238,1613,-625
2016,8,3,9,2144,2145,1528,-617
2016,8,3,10,2056,2083,1460,-623
2016,8,3,11,2008,2055,1457,-598
2016,8,3,12,2010,2075,1471,-604
2016,8,3,13,2073,768,101,-667
2016,8,3,14,2184,2250,1531,-719
2016,8,3,15,2273,2330,1509,-821
2016,8,3,16,2331,2407,1532,-875
2016,8,3,17,2393,2461,1553,-908
2016,8,3,18,2472,2519,1583,-936
2016,8,3,19,2538,2552,1579,-973
2016,8,3,20,2637,2607,1663,-944
2016,8,3,21,2772,2652,1657,-995
2016,8,3,22,2896,2697,1675,-1022
2016,8,3,23,2993,2753,1707,-1046
2016,8,4,0,3054,2793,1744,-1049
2016,8,4,1,3082,2815,1774,-1041
2016,8,4,2,3042,2792,1769,-1023
2016,8,4,3,2904,2713,1677,-1036
2016,8,4,4,2758,2659,1611,-1048
2016,8,4,5,2547,2522,1580,-942
2016,8,4,6,2285,2329,1521,-808
2016,8,4,7,2180,2175,1435,-740
2016,8,4,8,1938,2085,1321,-764
2016,8,4,9,1987,2031,1287,-744
2016,8,4,10,1922,1997,1271,-726
2016,8,4,11,1893,1962,1169,-793
2016,8,4,12,1911,2005,1126,-879
2016,8,4,13,1980,2094,1170,-924
2016,8,4,14,2084,2209,1163,-1046
2016,8,4,15,2184,2306,1163,-1143
2016,8,4,16,2268,2393,1338,-1055
2016,8,4,17,2347,2473,1347,-1126
2016,8,4,18,2432,2550,1497,-1053
2016,8,4,19,2514,2626,1500,-1126
2016,8,4,20,2623,2708,1530,-1178
2016,8,4,21,2768,2795,1563,-1232
2016,8,4,22,2913,2897,1578,-1319
2016,8,4,23,3026,2977,1681,-1296
2016,8,5,0,3106,3034,1828,-1206
2016,8,5,1,3151,3046,1866,-1180
2016,8,5,2,3124,3028,1855,-1173
2016,8,5,3,2980,2924,1757,-1167
2016,8,5,4,2805,2820,1679,-1141
2016,8,5,5,2570,2643,1568,-1075
2016,8,5,6,2302,2426,1429,-997
2016,8,5,7,2161,2257,1323,-934
2016,8,5,8,1895,2166,1229,-937
2016,8,5,9,2057,2092,1168,-924
2016,8,5,10,1991,2049,1087,-962
2016,8,5,11,1961,2029,1079,-950
2016,8,5,12,1982,2050,1093,-957
2016,8,5,13,2059,2142,1158,-984
2016,8,5,14,2166,2237,1106,-1131
2016,8,5,15,2255,2341,1100,-1241
2016,8,5,16,2334,2428,1037,-1391
2016,8,5,17,2428,2518,1098,-1420
2016,8,5,18,2556,2614,1236,-1378
2016,8,5,19,2685,2720,1330,-1390
2016,8,5,20,2831,2835,1388,-1447
2016,8,5,21,2994,2967,1477,-1490
2016,8,5,22,3124,3066,1497,-1569
2016,8,5,23,3212,3092,1499,-1593
2016,8,6,0,3206,2992,1399,-1593
2016,8,6,1,3183,2913,1321,-1592
2016,8,6,2,3123,2842,1344,-1498
2016,8,6,3,2979,2763,1213,-1550
2016,8,6,4,2849,2754,1237,-1517
2016,8,6,5,2664,2633,1228,-1405
2016,8,6,6,2422,2452,1356,-1096
2016,8,6,7,2146,2303,1249,-1054
2016,8,6,8,2263,2200,1223,-977
2016,8,6,9,2161,2126,1279,-847
2016,8,6,10,2103,2076,1300,-776
2016,8,6,11,2063,2044,1303,-741
2016,8,6,12,2052,2029,1285,-744
2016,8,6,13,2055,2049,1330,-719
2016,8,6,14,2093,2122,1174,-948
2016,8,6,15,2237,2237,1224,-1013
2016,8,6,16,2358,2372,1205,-1167
2016,8,6,17,2482,2503,1175,-1328
2016,8,6,18,2600,2631,1281,-1350
2016,8,6,19,2711,2749,1297,-1452
2016,8,6,20,2800,2869,1340,-1529
2016,8,6,21,2888,2963,1420,-1543
2016,8,6,22,2972,3018,1415,-1603
2016,8,6,23,3047,3063,1421,-1642
2016,8,7,0,3091,3085,1431,-1654
2016,8,7,1,3103,3086,1430,-1656
2016,8,7,2,3064,3023,1401,-1622
2016,8,7,3,2956,2920,1341,-1579
2016,8,7,4,2831,2812,1297,-1515
2016,8,7,5,2655,2645,1238,-1407
2016,8,7,6,2439,2443,1305,-1138
2016,8,7,7,2299,2268,1260,-1008
2016,8,7,8,2180,2152,1148,-1004
2016,8,7,9,2102,2064,1109,-955
2016,8,7,10,2024,2006,1068,-938
2016,8,7,11,1973,1956,1034,-922
2016,8,7,12,1970,1955,1126,-829
2016,8,7,13,1966,1965,1266,-699
2016,8,7,14,1993,2003,1264,-739
2016,8,7,15,2118,2103,1209,-894
2016,8,7,16,2243,2209,1333,-876
2016,8,7,17,2358,2328,1447,-881
2016,8,7,18,2470,2408,1500,-908
2016,8,7,19,2568,2516,1545,-971
2016,8,7,20,2653,2609,1490,-1119
2016,8,7,21,2759,2690,1494,-1196
2016,8,7,22,2858,2770,1448,-1322
2016,8,7,23,2945,2847,1406,-1441
2016,8,8,0,3017,2907,1400,-1507
2016,8,8,1,3017,2908,1400,-1508
2016,8,8,2,2968,2858,1363,-1495
2016,8,8,3,2844,2763,1192,-1571
2016,8,8,4,2734,2673,1245,-1428
2016,8,8,5,2551,2486,1216,-1270
2016,8,8,6,2315,2271,1140,-1131
2016,8,8,7,2129,2107,1091,-1016
2016,8,8,8,1982,1995,1070,-925
2016,8,8,9,1960,1947,1048,-899
2016,8,8,10,1914,1898,1016,-882
2016,8,8,11,1913,1902,1025,-877
2016,8,8,12,1959,1935,1070,-865
2016,8,8,13,2067,2048,1130,-918
2016,8,8,14,2179,2169,1126,-1043
2016,8,8,15,2285,2306,1227,-1079
2016,8,8,16,2353,2418,1313,-1105
2016,8,8,17,2433,2487,1339,-1148
2016,8,8,18,2521,2541,1246,-1295
2016,8,8,19,2613,2614,1368,-1246
2016,8,8,20,2703,2675,1400,-1275
2016,8,8,21,2808,2747,1327,-1420
2016,8,8,22,2905,2810,1302,-1508
2016,8,8,23,2969,2874,1338,-1536
2016,8,9,0,3005,2903,1398,-1505
2016,8,9,1,3016,2915,1451,-1464
2016,8,9,2,2985,2883,1600,-1283
2016,8,9,3,2868,2780,1530,-1250
2016,8,9,4,2776,2707,1419,-1288
2016,8,9,5,2595,2543,1382,-1161
2016,8,9,6,2370,2332,1339,-993
2016,8,9,7,2188,2183,1223,-960
2016,8,9,8,2083,2083,1305,-778
2016,8,9,9,2016,2041,1416,-625
2016,8,9,10,1967,1983,1355,-628
2016,8,9,11,1945,1973,1343,-630
2016,8,9,12,1967,2006,1342,-664
2016,8,9,13,2053,2098,1429,-669
2016,8,9,14,2153,2199,1416,-783
2016,8,9,15,2249,2285,1451,-834
2016,8,9,16,2319,2358,1515,-843
2016,8,9,17,2374,2428,1528,-900
2016,8,9,18,2438,2467,1478,-989
2016,8,9,19,2499,2504,1438,-1066
2016,8,9,20,2558,2530,1406,-1124
2016,8,9,21,2624,2577,1363,-1214
2016,8,9,22,2683,2606,1420,-1186
2016,8,9,23,2727,2643,1477,-1166
2016,8,10,0,2748,2658,1491,-1167
2016,8,10,1,2746,2666,1487,-1179
2016,8,10,2,2705,2629,1454,-1175
2016,8,10,3,2605,2570,1347,-1223
2016,8,10,4,2553,2531,1391,-1140
2016,8,10,5,2413,2404,1301,-1103
2016,8,10,6,2220,2218,1288,-930
2016,8,10,7,2090,2078,1209,-869
2016,8,10,8,1994,2009,1110,-899
2016,8,10,9,1957,1952,1088,-864
2016,8,10,10,1916,1931,1002,-929
2016,8,10,11,1903,1919,1021,-898
2016,8,10,12,1940,1959,1024,-935
2016,8,10,13,2035,2063,1094,-969
2016,8,10,14,2139,2178,1050,-1128
2016,8,10,15,2244,2272,1037,-1235
2016,8,10,16,2330,2336,1189,-1147
2016,8,10,17,2394,2390,1186,-1204
2016,8,10,18,2460,2440,1214,-1226
2016,8,10,19,2516,2471,1266,-1205
2016,8,10,20,2570,2519,1331,-1188
2016,8,10,21,2633,2583,1400,-1183
2016,8,10,22,2698,2613,1431,-1182
2016,8,10,23,2759,2658,1475,-1183
2016,8,11,0,2789,2694,1503,-1191
2016,8,11,1,2810,2729,1597,-1132
2016,8,11,2,2778,2703,1464,-1239
2016,8,11,3,2682,2640,1424,-1216
2016,8,11,4,2632,2600,1396,-1204
2016,8,11,5,2484,2452,1247,-1205
2016,8,11,6,2284,2272,1326,-946
2016,8,11,7,2134,2142,1263,-879
2016,8,11,8,2051,2053,1235,-818
2016,8,11,9,2019,2007,1195,-812
2016,8,11,10,1982,1973,1174,-799
2016,8,11,11,1967,1962,1138,-824
2016,8,11,12,2003,2003,1145,-858
2016,8,11,13,2103,2110,1078,-1032
2016,8,11,14,2210,2207,1147,-1060
2016,8,11,15,2321,2305,1179,-1126
2016,8,11,16,2410,2386,1378,-1008
2016,8,11,17,2481,2459,1392,-1067
2016,8,11,18,2560,2516,1436,-1080
2016,8,11,19,2624,2575,1513,-1062
2016,8,11,20,2691,2660,1640,-1020
2016,8,11,21,2773,2750,1684,-1066
2016,8,11,22,2846,2807,1686,-1121
2016,8,11,23,2900,2873,1826,-1047
2016,8,12,0,2941,2914,1798,-1116
2016,8,12,1,2964,2930,1856,-1074
2016,8,12,2,2938,2900,1806,-1094
2016,8,12,3,2835,2799,1695,-1104
2016,8,12,4,2757,2735,1645,-1090
2016,8,12,5,2589,2570,1500,-1070
2016,8,12,6,2366,2369,1340,-1029
2016,8,12,7,2202,2211,1202,-1009
2016,8,12,8,2115,2106,1117,-989
2016,8,12,9,2082,2044,1103,-941
2016,8,12,10,2040,2002,1066,-936
2016,8,12,11,2020,1989,1051,-938
2016,8,12,12,2053,2025,1078,-947
2016,8,12,13,2151,2108,1146,-962
2016,8,12,14,2254,2194,1144,-1050
2016,8,12,15,2365,2316,1145,-1171
2016,8,12,16,2456,2409,1237,-1172
2016,8,12,17,2535,2505,1293,-1212
2016,8,12,18,2618,2593,1321,-1272
2016,8,12,19,2686,2671,1388,-1283
2016,8,12,20,2769,2782,1425,-1357
2016,8,12,21,2860,2882,1473,-1409
2016,8,12,22,2944,2971,1520,-1451
2016,8,12,23,3016,3031,1613,-1418
2016,8,13,0,3015,3050,1623,-1427
2016,8,13,1,3015,3053,1646,-1407
2016,8,13,2,2987,3000,1605,-1395
2016,8,13,3,2885,2872,1447,-1425
2016,8,13,4,2802,2778,1493,-1285
2016,8,13,5,2645,2595,1402,-1193
2016,8,13,6,2450,2406,1311,-1095
2016,8,13,7,2271,2243,1206,-1037
2016,8,13,8,2169,2132,1131,-1001
2016,8,13,9,2088,2058,1071,-987
2016,8,13,10,2037,2009,1003,-1006
2016,8,13,11,2003,1971,953,-1018
2016,8,13,12,1999,1961,934,-1027
2016,8,13,13,2018,1997,1047,-950
2016,8,13,14,2065,2046,995,-1051
2016,8,13,15,2203,2162,1060,-1102
2016,8,13,16,2334,2288,1101,-1187
2016,8,13,17,2454,2405,1166,-1239
2016,8,13,18,2567,2488,1243,-1245
2016,8,13,19,2662,2596,1326,-1270
2016,8,13,20,2765,2704,1378,-1326
2016,8,13,21,2856,2836,1413,-1423
2016,8,13,22,2954,2936,1463,-1473
2016,8,13,23,3028,3003,1486,-1517
2016,8,14,0,3087,3029,1506,-1523
2016,8,14,1,3097,3024,1521,-1503
2016,8,14,2,3042,2930,1527,-1403
2016,8,14,3,2893,2810,1511,-1299
2016,8,14,4,2794,2740,1513,-1227
2016,8,14,5,2643,2576,1364,-1212
2016,8,14,6,2454,2381,1235,-1146
2016,8,14,7,2304,2230,1109,-1121
2016,8,14,8,2174,2099,994,-1105
2016,8,14,9,2065,2021,1045,-976
2016,8,14,10,2016,1959,1049,-910
2016,8,14,11,1984,1931,1024,-907
2016,8,14,12,1983,1913,1007,-906
2016,8,14,13,1988,1922,1056,-866
2016,8,14,14,2017,1951,1130,-821
2016,8,14,15,2144,2053,1215,-838
2016,8,14,16,2260,2172,1269,-903
2016,8,14,17,2364,2301,1309,-992
2016,8,14,18,2467,2430,1308,-1122
2016,8,14,19,2578,2557,1319,-1238
2016,8,14,20,2686,2695,1367,-1328
2016,8,14,21,2790,2813,1477,-1336
2016,8,14,22,2890,2880,1490,-1390
2016,8,14,23,2986,2941,1544,-1397
2016,8,15,0,3060,2964,1596,-1368
2016,8,15,1,3072,2923,1506,-1417
2016,8,15,2,3012,2863,1536,-1327
2016,8,15,3,2875,2788,1499,-1289
2016,8,15,4,2790,2699,1441,-1258
2016,8,15,5,2617,2529,1315,-1214
2016,8,15,6,2396,2299,1127,-1172
2016,8,15,7,2247,2150,994,-1156
2016,8,15,8,2080,2036,946,-1090
2016,8,15,9,1989,1976,988,-988
2016,8,15,10,1946,1927,956,-971
2016,8,15,11,1938,1915,940,-975
2016,8,15,12,1991,1981,995,-986
2016,8,15,13,2106,2082,1084,-998
2016,8,15,14,2223,2203,1089,-1114
2016,8,15,15,2370,2347,1130,-1217
2016,8,15,16,2470,2466,1278,-1188
2016,8,15,17,2563,2594,1360,-1234
2016,8,15,18,2680,2727,1406,-1321
2016,8,15,19,2782,2846,1469,-1377
2016,8,15,20,2897,2994,1597,-1397
2016,8,15,21,3017,3127,1720,-1407
2016,8,15,22,3107,3218,1871,-1347
2016,8,15,23,3176,3270,1921,-1349
2016,8,16,0,3208,3301,1943,-1358
2016,8,16,1,3209,3305,1955,-1350
2016,8,16,2,3163,3245,1895,-1350
2016,8,16,3,3048,3128,1779,-1349
2016,8,16,4,2955,3005,1702,-1303
2016,8,16,5,2767,2767,1532,-1235
2016,8,16,6,2516,2512,1307,-1205
2016,8,16,7,2362,2327,1161,-1166
2016,8,16,8,2229,2209,1157,-1052
2016,8,16,9,2133,2114,1095,-1019
2016,8,16,10,2064,2052,1052,-1000
2016,8,16,11,2030,2026,1038,-988
2016,8,16,12,2053,2065,1088,-977
2016,8,16,13,2143,2161,1083,-1078
2016,8,16,14,2241,2254,1095,-1159
2016,8,16,15,2366,2348,1185,-1163
2016,8,16,16,2487,2458,1276,-1182
2016,8,16,17,2605,2562,1367,-1195
2016,8,16,18,2742,2674,1441,-1233
2016,8,16,19,2864,2798,1490,-1308
2016,8,16,20,2996,2938,1577,-1361
2016,8,16,21,3120,3051,1692,-1359
2016,8,16,22,3208,3169,1828,-1341
2016,8,16,23,3271,3264,1920,-1344
2016,8,17,0,3299,3309,1946,-1363
2016,8,17,1,3301,3318,1934,-1384
2016,8,17,2,3243,3283,1920,-1363
2016,8,17,3,3120,3174,1843,-1331
2016,8,17,4,3013,3054,1736,-1318
2016,8,17,5,2789,2814,1508,-1306
2016,8,17,6,2532,2562,1286,-1276
2016,8,17,7,2370,2380,1148,-1232
2016,8,17,8,2231,2266,1074,-1192
2016,8,17,9,2190,2172,1039,-1133
2016,8,17,10,2119,2119,1037,-1082
2016,8,17,11,2091,2079,1029,-1050
2016,8,17,12,2114,2121,1026,-1095
2016,8,17,13,2214,2231,1139,-1092
2016,8,17,14,2309,2337,1176,-1161
2016,8,17,15,2420,2438,1194,-1244
2016,8,17,16,2524,2514,1286,-1228
2016,8,17,17,2628,2613,1411,-1202
2016,8,17,18,2753,2692,1422,-1270
2016,8,17,19,2885,2809,1454,-1355
2016,8,17,20,3015,2884,1503,-1381
2016,8,17,21,3142,2971,1585,-1386
2016,8,17,22,3235,3064,1659,-1405
2016,8,17,23,3300,3147,1725,-1422
2016,8,18,0,3331,3178,1805,-1373
2016,8,18,1,3327,3181,1832,-1349
2016,8,18,2,3263,3119,1804,-1315
2016,8,18,3,3136,3026,1658,-1368
2016,8,18,4,3060,2943,1609,-1334
2016,8,18,5,2842,2709,1511,-1198
2016,8,18,6,2591,2501,1486,-1015
2016,8,18,7,2376,2326,1328,-998
2016,8,18,8,2253,2214,1133,-1081
2016,8,18,9,2144,2124,1076,-1048
2016,8,18,10,2069,2082,1053,-1029
2016,8,18,11,2039,2045,1010,-1035
2016,8,18,12,2064,2092,1052,-1040
2016,8,18,13,2169,2212,1139,-1073
2016,8,18,14,2262,2308,1138,-1170
2016,8,18,15,2374,2404,1251,-1153
2016,8,18,16,2476,2475,1347,-1128
2016,8,18,17,2579,2576,1391,-1185
2016,8,18,18,2693,2681,1457,-1224
2016,8,18,19,2825,2807,1552,-1255
2016,8,18,20,2958,2937,1585,-1352
2016,8,18,21,3095,3074,1655,-1419
2016,8,18,22,3201,3157,1722,-1435
2016,8,18,23,3260,3215,1830,-1385
2016,8,19,0,3281,3235,2008,-1227
2016,8,19,1,3280,3226,1811,-1415
2016,8,19,2,3215,3180,1785,-1395
2016,8,19,3,3105,3080,1842,-1238
2016,8,19,4,3040,2956,1814,-1142
2016,8,19,5,2782,2737,1611,-1126
2016,8,19,6,2515,2506,1466,-1040
2016,8,19,7,2389,2330,1366,-964
2016,8,19,8,2230,2207,1399,-808
2016,8,19,9,2107,2113,1304,-809
2016,8,19,10,2035,2063,1244,-819
2016,8,19,11,1996,2027,1205,-822
2016,8,19,12,2028,2052,1180,-872
2016,8,19,13,2133,2159,1285,-874
2016,8,19,14,2222,2241,1247,-994
2016,8,19,15,2333,2342,1280,-1062
2016,8,19,16,2428,2444,1287,-1157
2016,8,19,17,2515,2541,1343,-1198
2016,8,19,18,2620,2651,1433,-1218
2016,8,19,19,2727,2744,1486,-1258
2016,8,19,20,2829,2863,1603,-1260
2016,8,19,21,2922,2952,1706,-1246
2016,8,19,22,3007,3023,1709,-1314
2016,8,19,23,3071,3043,1683,-1360
2016,8,20,0,3030,3062,1732,-1330
2016,8,20,1,3003,3050,1741,-1309
2016,8,20,2,2940,2992,1699,-1293
2016,8,20,3,2849,2885,1612,-1273
2016,8,20,4,2784,2794,1444,-1350
2016,8,20,5,2608,2612,1353,-1259
2016,8,20,6,2410,2404,1262,-1142
2016,8,20,7,2257,2247,1164,-1083
2016,8,20,8,2114,2133,1134,-999
2016,8,20,9,2032,2049,1087,-962
2016,8,20,10,1968,1986,1088,-898
2016,8,20,11,1925,1959,1118,-841
2016,8,20,12,1926,1952,1105,-847
2016,8,20,13,1967,1973,1104,-869
2016,8,20,14,2021,2020,1151,-869
2016,8,20,15,2148,2112,1266,-846
2016,8,20,16,2269,2226,1410,-816
2016,8,20,17,2389,2325,1477,-848
2016,8,20,18,2500,2424,1541,-883
2016,8,20,19,2605,2523,1413,-1110
2016,8,20,20,2719,2624,1327,-1297
2016,8,20,21,2800,2700,1404,-1296
2016,8,20,22,2886,2791,1544,-1247
2016,8,20,23,2962,2866,1716,-1150
2016,8,21,0,3006,2908,1789,-1119
2016,8,21,1,3004,2912,1789,-1123
2016,8,21,2,2931,2859,1714,-1145
2016,8,21,3,2820,2756,1620,-1136
2016,8,21,4,2722,2650,1530,-1120
2016,8,21,5,2547,2471,1380,-1091
2016,8,21,6,2362,2282,1215,-1067
2016,8,21,7,2195,2127,1093,-1034
2016,8,21,8,2057,2020,1053,-967
2016,8,21,9,1968,1969,1007,-962
2016,8,21,10,1925,1901,978,-923
2016,8,21,11,1902,1885,977,-908
2016,8,21,12,1906,1874,992,-882
2016,8,21,13,1920,1880,984,-896
2016,8,21,14,1940,1908,938,-970
2016,8,21,15,2043,1982,964,-1018
2016,8,21,16,2165,2079,1032,-1047
2016,8,21,17,2289,2194,1146,-1048
2016,8,21,18,2412,2282,1198,-1084
2016,8,21,19,2535,2410,1317,-1093
2016,8,21,20,2645,2523,1504,-1019
2016,8,21,21,2750,2656,1504,-1152
2016,8,21,22,2842,2771,1531,-1240
2016,8,21,23,2932,2866,1608,-1258
2016,8,22,0,3004,2924,1614,-1310
2016,8,22,1,3006,2929,1640,-1289
2016,8,22,2,2957,2869,1612,-1257
2016,8,22,3,2836,2787,1569,-1218
2016,8,22,4,2756,2669,1506,-1163
2016,8,22,5,2557,2440,1436,-1004
2016,8,22,6,2333,2218,1218,-1000
2016,8,22,7,2174,2049,1084,-965
2016,8,22,8,2031,1954,1102,-852
2016,8,22,9,1896,1900,1092,-808
2016,8,22,10,1856,1874,1104,-770
2016,8,22,11,1858,1855,1224,-631
2016,8,22,12,1911,1912,1297,-615
2016,8,22,13,2022,2058,1394,-664
2016,8,22,14,2135,2166,1416,-750
2016,8,22,15,2254,2257,1412,-845
2016,8,22,16,2328,2338,1432,-906
2016,8,22,17,2400,2424,1467,-957
2016,8,22,18,2480,2494,1473,-1021
2016,8,22,19,2564,2538,1499,-1039
2016,8,22,20,2651,2613,1465,-1148
2016,8,22,21,2734,2667,1530,-1137
2016,8,22,22,2813,2737,1532,-1205
2016,8,22,23,2870,2781,1533,-1248
2016,8,23,0,2907,2838,1610,-1228
2016,8,23,1,2909,2833,1561,-1272
2016,8,23,2,2847,2790,1532,-1258
2016,8,23,3,2732,2724,1433,-1291
2016,8,23,4,2646,2640,1333,-1307
2016,8,23,5,2461,2450,1180,-1270
2016,8,23,6,2263,2244,1155,-1089
2016,8,23,7,2168,2098,1149,-949
2016,8,23,8,2003,2012,1140,-872
2016,8,23,9,1950,1957,1113,-844
2016,8,23,10,1903,1919,1177,-742
2016,8,23,11,1881,1910,1208,-702
2016,8,23,12,1924,1973,1226,-747
2016,8,23,13,2034,2095,1296,-799
2016,8,23,14,2138,2190,1309,-881
2016,8,23,15,2209,2252,1277,-975
2016,8,23,16,2267,2301,1237,-1064
2016,8,23,17,2326,2347,1258,-1089
2016,8,23,18,2394,2392,1288,-1104
2016,8,23,19,2456,2430,1342,-1088
2016,8,23,20,2524,2474,1361,-1113
2016,8,23,21,2605,2523,1414,-1109
2016,8,23,22,2674,2574,1467,-1107
2016,8,23,23,2727,2628,1498,-1130
2016,8,24,0,2760,2662,1525,-1137
2016,8,24,1,2760,2681,1516,-1165
2016,8,24,2,2719,2669,1488,-1181
2016,8,24,3,2636,2627,1500,-1127
2016,8,24,4,2583,2571,1513,-1058
2016,8,24,5,2404,2382,1421,-961
2016,8,24,6,2209,2193,1364,-829
2016,8,24,7,2070,2065,1317,-748
2016,8,24,8,1982,1985,1290,-695
2016,8,24,9,1942,1956,1233,-723
2016,8,24,10,1908,1916,1252,-664
2016,8,24,11,1900,1913,1202,-711
2016,8,24,12,1953,1962,1203,-759
2016,8,24,13,2072,2087,1269,-818
2016,8,24,14,2173,2182,1206,-976
2016,8,24,15,2236,2228,1154,-1074
2016,8,24,16,2289,2267,1126,-1141
2016,8,24,17,2335,2323,1164,-1159
2016,8,24,18,2387,2373,1218,-1155
2016,8,24,19,2436,2401,1253,-1148
2016,8,24,20,2501,2458,1290,-1168
2016,8,24,21,2576,2512,1302,-1210
2016,8,24,22,2632,2558,1270,-1288
2016,8,24,23,2694,2603,1298,-1305
2016,8,25,0,2738,2642,1332,-1310
2016,8,25,1,2756,2658,1404,-1254
2016,8,25,2,2722,2644,1386,-1258
2016,8,25,3,2644,2593,1308,-1285
2016,8,25,4,2590,2545,1255,-1290
2016,8,25,5,2403,2352,1161,-1191
2016,8,25,6,2212,2167,1158,-1009
2016,8,25,7,2068,2047,1085,-962
2016,8,25,8,1982,1971,1037,-934
2016,8,25,9,1935,1928,1129,-799
2016,8,25,10,1906,1892,1180,-712
2016,8,25,11,1901,1887,1267,-620
2016,8,25,12,1950,1938,1379,-559
2016,8,25,13,2077,2070,1414,-656
2016,8,25,14,2176,2158,1410,-748
2016,8,25,15,2234,2217,1402,-815
2016,8,25,16,2291,2286,1309,-977
2016,8,25,17,2346,2334,1249,-1085
2016,8,25,18,2402,2398,1094,-1304
2016,8,25,19,2441,2433,1057,-1376
2016,8,25,20,2498,2500,1045,-1455
2016,8,25,21,2556,2557,1103,-1454
2016,8,25,22,2610,2613,1246,-1367
2016,8,25,23,2677,2694,1341,-1353
2016,8,26,0,2715,2743,1431,-1312
2016,8,26,1,2734,2760,1323,-1437
2016,8,26,2,2710,2725,1290,-1435
2016,8,26,3,2628,2669,1264,-1405
2016,8,26,4,2584,2596,1372,-1224
2016,8,26,5,2395,2388,1338,-1050
2016,8,26,6,2197,2192,1274,-918
2016,8,26,7,2075,2060,1240,-820
2016,8,26,8,1982,1985,1110,-875
2016,8,26,9,1958,1944,1043,-901
2016,8,26,10,1933,1913,1032,-881
2016,8,26,11,1925,1908,1035,-873
2016,8,26,12,1966,1954,1003,-951
2016,8,26,13,2095,2074,1070,-1004
2016,8,26,14,2189,2189,1067,-1122
2016,8,26,15,2246,2238,1039,-1199
2016,8,26,16,2309,2280,1039,-1241
2016,8,26,17,2369,2342,1054,-1288
2016,8,26,18,2428,2400,1048,-1352
2016,8,26,19,2471,2443,1051,-1392
2016,8,26,20,2532,2502,1081,-1421
2016,8,26,21,2601,2574,1146,-1428
2016,8,26,22,2655,2638,1221,-1417
2016,8,26,23,2726,2688,1296,-1392
2016,8,27,0,2750,2709,1353,-1356
2016,8,27,1,2743,2705,1366,-1339
2016,8,27,2,2709,2669,1338,-1331
2016,8,27,3,2615,2584,1309,-1275
2016,8,27,4,2576,2503,1282,-1221
2016,8,27,5,2426,2357,1137,-1220
2016,8,27,6,2251,2191,1125,-1066
2016,8,27,7,2094,2065,1057,-1008
2016,8,27,8,2011,1984,1035,-949
2016,8,27,9,1966,1934,1009,-925
2016,8,27,10,1937,1902,1018,-884
2016,8,27,11,1916,1861,1018,-843
2016,8,27,12,1927,1878,1034,-844
2016,8,27,13,1976,1906,1035,-871
2016,8,27,14,2027,1952,1025,-927
2016,8,27,15,2114,2040,1029,-1011
2016,8,27,16,2203,2122,1014,-1108
2016,8,27,17,2293,2207,1073,-1134
2016,8,27,18,2378,2278,1100,-1178
2016,8,27,19,2452,2340,1121,-1219
2016,8,27,20,2529,2424,1159,-1265
2016,8,27,21,2609,2499,1251,-1248
2016,8,27,22,2689,2590,1238,-1352
2016,8,27,23,2761,2681,1220,-1461
2016,8,28,0,2831,2732,1294,-1438
2016,8,28,1,2834,2748,1336,-1412
2016,8,28,2,2771,2703,1290,-1413
2016,8,28,3,2665,2619,1145,-1474
2016,8,28,4,2591,2542,1107,-1435
2016,8,28,5,2434,2360,1040,-1320
2016,8,28,6,2262,2186,1094,-1092
2016,8,28,7,2127,2035,1037,-998
2016,8,28,8,2006,1950,1023,-927
2016,8,28,9,1916,1891,1034,-857
2016,8,28,10,1880,1841,1016,-825
2016,8,28,11,1850,1818,1041,-777
2016,8,28,12,1848,1811,1023,-788
2016,8,28,13,1873,1825,1047,-778
2016,8,28,14,1893,1864,1070,-794
2016,8,28,15,1964,1936,1093,-843
2016,8,28,16,2051,2029,1082,-947
2016,8,28,17,2122,2115,1079,-1036
2016,8,28,18,2186,2210,1143,-1067
2016,8,28,19,2260,2303,1297,-1006
2016,8,28,20,2333,2396,1337,-1059
2016,8,28,21,2429,2499,1343,-1156
2016,8,28,22,2524,2608,1351,-1257
2016,8,28,23,2630,2692,1430,-1262
2016,8,29,0,2716,2777,1507,-1270
2016,8,29,1,2737,2772,1525,-1247
2016,8,29,2,2704,2735,1474,-1261
2016,8,29,3,2607,2661,1413,-1248
2016,8,29,4,2546,2541,1299,-1242
2016,8,29,5,2370,2339,1108,-1231
2016,8,29,6,2157,2129,982,-1147
2016,8,29,7,2030,1979,1021,-958
2016,8,29,8,1894,1884,945,-939
2016,8,29,9,1877,1847,912,-935
2016,8,29,10,1852,1821,926,-895
2016,8,29,11,1861,1816,1028,-788
2016,8,29,12,1920,1875,1108,-767
2016,8,29,13,2052,2017,1165,-852
2016,8,29,14,2179,2143,1232,-911
2016,8,29,15,2298,2220,1203,-1017
2016,8,29,16,2395,2302,1145,-1157
2016,8,29,17,2493,2417,1206,-1211
2016,8,29,18,2603,2490,1187,-1303
2016,8,29,19,2723,2605,1235,-1370
2016,8,29,20,2853,2702,1327,-1375
2016,8,29,21,2985,2772,1368,-1404
2016,8,29,22,3077,2898,1405,-1493
2016,8,29,23,3145,2950,1483,-1467
2016,8,30,0,3193,2968,1538,-1430
2016,8,30,1,3201,2950,1514,-1436
2016,8,30,2,3158,2880,1505,-1375
2016,8,30,3,3029,2837,1510,-1327
2016,8,30,4,2939,2739,1282,-1457
2016,8,30,5,2721,2497,1146,-1351
2016,8,30,6,2477,2281,1106,-1175
2016,8,30,7,2282,2145,1060,-1085
2016,8,30,8,2182,2027,1034,-993
2016,8,30,9,1990,1976,1083,-893
2016,8,30,10,1936,1929,1103,-826
2016,8,30,11,1905,1909,1091,-818
2016,8,30,12,1932,1966,1145,-821
2016,8,30,13,2052,2108,1206,-902
2016,8,30,14,2145,2231,1237,-994
2016,8,30,15,2217,2282,1203,-1079
2016,8,30,16,2324,2336,1180,-1156
2016,8,30,17,2425,2416,1221,-1195
2016,8,30,18,2539,2474,1234,-1240
2016,8,30,19,2682,2524,1294,-1230
2016,8,30,20,2854,2588,1244,-1344
2016,8,30,21,3003,2659,1259,-1400
2016,8,30,22,3132,2718,1306,-1412
2016,8,30,23,3219,2771,1303,-1468
2016,8,31,0,3276,2837,1374,-1463
2016,8,31,1,3287,2874,1412,-1462
2016,8,31,2,3233,2879,1447,-1432
2016,8,31,3,3113,2829,1376,-1453
2016,8,31,4,2992,2717,1345,-1372
2016,8,31,5,2735,2477,1303,-1174
2016,8,31,6,2468,2269,1266,-1003
2016,8,31,7,2320,2104,1168,-936
2016,8,31,8,2116,2020,1111,-909
2016,8,31,9,2000,1975,1067,-908
2016,8,31,10,1945,1937,1116,-821
2016,8,31,11,1923,1928,1110,-818
2016,8,31,12,1978,1980,1147,-833
2016,8,31,13,2113,2125,1263,-862
2016,8,31,14,2227,2243,1186,-1057
2016,8,31,15,2288,2293,1118,-1175
2016,8,31,16,2378,2352,1162,-1190
2016,8,31,17,2486,2396,1230,-1166
2016,8,31,18,2576,2440,1233,-1207
2016,8,31,19,2649,2494,1204,-1290
2016,8,31,20,2721,2557,1265,-1292
2016,8,31,21,2804,2653,1337,-1316
2016,8,31,22,2866,2729,1372,-1357
2016,8,31,23,2944,2845,1409,-1436
2016,9,1,0,2993,2898,1440,-1458
2016,9,1,1,3000,2915,1487,-1428
2016,9,1,2,2965,2884,1480,-1404
2016,9,1,3,2912,2810,1342,-1468
2016,9,1,4,2807,2706,1264,-1442
2016,9,1,5,2573,2471,1119,-1352
2016,9,1,6,2338,2264,1151,-1113
2016,9,1,7,2224,2121,1109,-1012
2016,9,1,8,2087,2037,1119,-918
2016,9,1,9,1989,1970,1085,-885
2016,9,1,10,1933,1941,1076,-865
2016,9,1,11,1919,1930,1075,-855
2016,9,1,12,1973,1977,1098,-879
2016,9,1,13,2114,2120,1156,-964
2016,9,1,14,2222,2231,1198,-1033
2016,9,1,15,2272,2270,1202,-1068
2016,9,1,16,2323,2315,1261,-1054
2016,9,1,17,2383,2360,1278,-1082
2016,9,1,18,2432,2433,1347,-1086
2016,9,1,19,2465,2482,1390,-1092
2016,9,1,20,2508,2567,1415,-1152
2016,9,1,21,2563,2642,1485,-1157
2016,9,1,22,2624,2709,1492,-1217
2016,9,1,23,2690,2741,1496,-1245
2016,9,2,0,2737,2787,1456,-1331
2016,9,2,1,2744,2789,1456,-1333
2016,9,2,2,2686,2761,1410,-1351
2016,9,2,3,2634,2700,1347,-1353
2016,9,2,4,2541,2597,1383,-1214
2016,9,2,5,2358,2406,1277,-1129
2016,9,2,6,2163,2207,1240,-967
2016,9,2,7,2064,2071,1218,-853
2016,9,2,8,1975,1894,1298,-596
2016,9,2,9,1943,1821,1264,-557
2016,9,2,10,1905,1793,1273,-520
2016,9,2,11,1901,1767,1278,-489
2016,9,2,12,1954,1817,1200,-617
2016,9,2,13,2102,1929,1175,-754
2016,9,2,14,2212,2031,1242,-789
2016,9,2,15,2268,2201,1286,-915
2016,9,2,16,2308,2261,1352,-909
2016,9,2,17,2354,2281,1395,-886
2016,9,2,18,2384,2290,1414,-876
2016,9,2,19,2398,2296,1398,-898
2016,9,2,20,2415,2294,1385,-909
2016,9,2,21,2442,2282,1384,-898
2016,9,2,22,2466,2282,1485,-797
2016,9,2,23,2496,2274,1488,-786
2016,9,3,0,2483,2252,1386,-866
2016,9,3,1,2464,2231,1297,-934
2016,9,3,2,2395,2198,1272,-926
2016,9,3,3,2369,2228,1299,-929
2016,9,3,4,2332,2201,1356,-845
2016,9,3,5,2215,2109,1387,-722
2016,9,3,6,2084,1990,1354,-636
2016,9,3,7,1968,1891,1297,-594
2016,9,3,8,1884,1827,1358,-469
2016,9,3,9,1800,1791,1236,-555
2016,9,3,10,1783,1763,1192,-571
2016,9,3,11,1780,1757,1138,-619
2016,9,3,12,1804,1757,1115,-642
2016,9,3,13,1870,1803,1145,-658
2016,9,3,14,1934,1851,995,-856
2016,9,3,15,2023,1936,1053,-883
2016,9,3,16,2088,2004,1098,-906
2016,9,3,17,2130,1997,1101,-896
2016,9,3,18,2147,2006,1073,-933
2016,9,3,19,2162,2015,1060,-955
2016,9,3,20,2190,2018,1068,-950
2016,9,3,21,2213,2038,1080,-958
2016,9,3,22,2251,2044,1118,-926
2016,9,3,23,2289,2048,1175,-873
2016,9,4,0,2324,2057,1153,-904
2016,9,4,1,2321,2066,1162,-904
2016,9,4,2,2262,2053,1146,-907
2016,9,4,3,2243,2074,1182,-892
2016,9,4,4,2210,2055,1211,-844
2016,9,4,5,2104,1961,1181,-780
2016,9,4,6,1974,1835,1193,-642
2016,9,4,7,1899,1765,1078,-687
2016,9,4,8,1772,1708,1072,-636
2016,9,4,9,1668,1674,1044,-630
2016,9,4,10,1648,1653,997,-656
2016,9,4,11,1646,1641,1011,-630
2016,9,4,12,1665,1657,1026,-631
2016,9,4,13,1704,1671,1027,-644
2016,9,4,14,1742,1718,1036,-682
2016,9,4,15,1818,1777,1126,-651
2016,9,4,16,1880,1817,1134,-683
2016,9,4,17,1914,1827,1162,-665
2016,9,4,18,1925,1829,1166,-663
2016,9,4,19,1941,1834,1170,-664
2016,9,4,20,1950,1826,1198,-628
2016,9,4,21,1977,1816,1155,-661
2016,9,4,22,2004,1816,1190,-626
2016,9,4,23,2042,1832,1173,-659
2016,9,5,0,2079,1824,1189,-635
2016,9,5,1,2081,1800,1153,-647
2016,9,5,2,2050,1800,1134,-666
2016,9,5,3,2060,1816,1147,-669
2016,9,5,4,2038,1797,1166,-631
2016,9,5,5,1921,1722,1204,-518
2016,9,5,6,1784,1645,1195,-450
2016,9,5,7,1726,1557,1096,-461
2016,9,5,8,1565,1505,996,-517
2016,9,5,9,1501,1490,1008,-490
2016,9,5,10,1493,1471,1012,-459
2016,9,5,11,1508,1474,1014,-469
2016,9,5,12,1568,1504,1018,-493
2016,9,5,13,1692,1556,1066,-496
2016,9,5,14,1804,1611,1125,-486
2016,9,5,15,1910,1671,1139,-532
2016,9,5,16,1967,1738,1102,-636
2016,9,5,17,2016,1796,1163,-633
2016,9,5,18,2052,1819,1196,-623
2016,9,5,19,2075,1824,1158,-666
2016,9,5,20,2098,1818,1106,-712
2016,9,5,21,2120,1828,1090,-738
2016,9,5,22,2143,1840,1164,-676
2016,9,5,23,2167,1874,1131,-743
2016,9,6,0,2197,1925,1143,-782
2016,9,6,1,2201,1944,1166,-778
2016,9,6,2,2174,1959,1183,-776
2016,9,6,3,2157,2008,1197,-811
2016,9,6,4,2098,1958,1228,-730
2016,9,6,5,1962,1813,1064,-749
2016,9,6,6,1819,1668,924,-744
2016,9,6,7,1751,1573,874,-699
2016,9,6,8,1616,1531,941,-590
2016,9,6,9,1505,1512,1022,-490
2016,9,6,10,1489,1498,1032,-466
2016,9,6,11,1486,1516,1057,-459
2016,9,6,12,1522,1584,1094,-490
2016,9,6,13,1608,1763,1191,-572
2016,9,6,14,1682,1875,1197,-678
2016,9,6,15,1753,1885,1119,-766
2016,9,6,16,1857,1891,1057,-834
2016,9,6,17,1940,1913,1050,-863
2016,9,6,18,1996,1945,1119,-826
2016,9,6,19,2031,1965,1152,-813
2016,9,6,20,2068,1975,1152,-823
2016,9,6,21,2100,1989,1181,-808
2016,9,6,22,2133,1991,1186,-805
2016,9,6,23,2160,2015,1102,-913
2016,9,7,0,2192,2024,1005,-1019
2016,9,7,1,2193,2037,976,-1061
2016,9,7,2,2156,2035,981,-1054
2016,9,7,3,2160,2071,1095,-976
2016,9,7,4,2104,2010,1137,-873
2016,9,7,5,1955,1872,1134,-738
2016,9,7,6,1809,1733,1144,-589
2016,9,7,7,1774,1648,1218,-430
2016,9,7,8,1665,1604,1313,-291
2016,9,7,9,1570,1574,1305,-269
2016,9,7,10,1552,1560,1317,-243
2016,9,7,11,1554,1568,1221,-347
2016,9,7,12,1603,1624,1329,-295
2016,9,7,13,1720,1787,1412,-375
2016,9,7,14,1807,1902,1377,-525
2016,9,7,15,1857,1912,1237,-675
2016,9,7,16,1902,1935,1222,-713
2016,9,7,17,1936,1957,1234,-723
2016,9,7,18,1953,1976,1250,-726
2016,9,7,19,1948,2002,1250,-752
2016,9,7,20,1956,2022,1282,-740
2016,9,7,21,1968,2049,1297,-752
2016,9,7,22,1989,2080,1338,-742
2016,9,7,23,2024,2107,1355,-752
2016,9,8,0,2060,2111,1355,-756
2016,9,8,1,2084,2108,1295,-813
2016,9,8,2,2080,2112,1249,-863
2016,9,8,3,2095,2143,1293,-850
2016,9,8,4,2022,2092,1267,-825
2016,9,8,5,1885,1935,1169,-766
2016,9,8,6,1745,1796,1076,-720
2016,9,8,7,1718,1703,988,-715
2016,9,8,8,1629,1632,981,-651
2016,9,8,9,1638,1598,1060,-538
2016,9,8,10,1629,1578,1056,-522
2016,9,8,11,1634,1596,1043,-553
2016,9,8,12,1694,1646,1063,-583
2016,9,8,13,1834,1809,1130,-679
2016,9,8,14,1936,1911,1255,-656
2016,9,8,15,1980,1933,1323,-610
2016,9,8,16,2018,1949,1361,-588
2016,9,8,17,2049,1974,1441,-533
2016,9,8,18,2060,2005,1463,-542
2016,9,8,19,2060,2022,1455,-567
2016,9,8,20,2068,2055,1461,-594
2016,9,8,21,2084,2081,1502,-579
2016,9,8,22,2100,2096,1522,-574
2016,9,8,23,2126,2116,1572,-544
2016,9,9,0,2136,2136,1527,-609
2016,9,9,1,2142,2133,1402,-731
2016,9,9,2,2122,2140,1354,-786
2016,9,9,3,2110,2158,1344,-814
2016,9,9,4,2030,2077,1311,-766
2016,9,9,5,1866,1946,1248,-698
2016,9,9,6,1705,1799,1313,-486
2016,9,9,7,1674,1698,1341,-357
2016,9,9,8,1620,1638,1331,-307
2016,9,9,9,1621,1601,1298,-303
2016,9,9,10,1598,1582,1320,-262
2016,9,9,11,1600,1584,1315,-269
2016,9,9,12,1651,1647,1345,-302
2016,9,9,13,1795,1790,1362,-428
2016,9,9,14,1896,1900,1178,-722
2016,9,9,15,1932,1924,1195,-729
2016,9,9,16,1957,1924,1200,-724
2016,9,9,17,1963,1962,1188,-774
2016,9,9,18,1972,1963,1198,-765
2016,9,9,19,1971,1985,1158,-827
2016,9,9,20,2009,1987,1141,-846
2016,9,9,21,2058,2030,1170,-860
2016,9,9,22,2108,2043,1197,-846
2016,9,9,23,2155,2054,1218,-836
2016,9,10,0,2195,2069,1227,-842
2016,9,10,1,2207,2074,1236,-838
2016,9,10,2,2193,2056,1194,-862
2016,9,10,3,2144,2059,1197,-862
2016,9,10,4,2049,2006,1116,-890
2016,9,10,5,1909,1897,1059,-838
2016,9,10,6,1771,1759,1008,-751
2016,9,10,7,1666,1675,961,-714
2016,9,10,8,1600,1611,925,-686
2016,9,10,9,1610,1583,924,-659
2016,9,10,10,1593,1558,926,-632
2016,9,10,11,1587,1547,916,-631
2016,9,10,12,1608,1569,909,-660
2016,9,10,13,1683,1626,937,-689
2016,9,10,14,1749,1693,979,-714
2016,9,10,15,1814,1756,1111,-645
2016,9,10,16,1862,1796,1137,-659
2016,9,10,17,1898,1835,1158,-677
2016,9,10,18,1926,1857,1178,-679
2016,9,10,19,1952,1879,1198,-681
2016,9,10,20,1996,1897,1195,-702
2016,9,10,21,2045,1919,1140,-779
2016,9,10,22,2099,1967,1152,-815
2016,9,10,23,2150,2022,1116,-906
2016,9,11,0,2208,2058,1141,-917
2016,9,11,1,2219,2091,1165,-926
2016,9,11,2,2187,2062,1169,-893
2016,9,11,3,2142,2040,1196,-844
2016,9,11,4,2073,1975,1151,-824
2016,9,11,5,1953,1860,1052,-808
2016,9,11,6,1819,1729,1012,-717
2016,9,11,7,1671,1642,946,-696
2016,9,11,8,1623,1580,966,-614
2016,9,11,9,1562,1538,983,-555
2016,9,11,10,1544,1516,987,-529
2016,9,11,11,1540,1492,1046,-446
2016,9,11,12,1557,1508,1060,-448
2016,9,11,13,1609,1548,1072,-476
2016,9,11,14,1651,1590,1085,-505
2016,9,11,15,1719,1634,1117,-517
2016,9,11,16,1799,1691,1185,-506
2016,9,11,17,1869,1747,1246,-501
2016,9,11,18,1921,1765,1289,-476
2016,9,11,19,1970,1808,1360,-448
2016,9,11,20,2018,1837,1364,-473
2016,9,11,21,2080,1883,1411,-472
2016,9,11,22,2139,1931,1416,-515
2016,9,11,23,2199,1998,1476,-522
2016,9,12,0,2245,2058,1523,-535
2016,9,12,1,2228,2048,1474,-574
2016,9,12,2,2168,2026,1402,-624
2016,9,12,3,2124,2040,1362,-678
2016,9,12,4,2038,1960,1338,-622
2016,9,12,5,1892,1805,1317,-488
2016,9,12,6,1734,1658,1298,-360
2016,9,12,7,1607,1553,1410,-143
2016,9,12,8,1842,1492,1359,-133
2016,9,12,9,1819,1469,1315,-154
2016,9,12,10,1801,1452,1300,-152
2016,9,12,11,1816,1471,1305,-166
2016,9,12,12,1885,1534,1385,-149
2016,9,12,13,2047,1699,1347,-352
2016,9,12,14,2176,1828,1346,-482
2016,9,12,15,2278,1866,1218,-648
2016,9,12,16,2339,1900,1191,-709
2016,9,12,17,2404,1919,1214,-705
2016,9,12,18,2466,1921,1200,-721
2016,9,12,19,2524,1925,1208,-717
2016,9,12,20,2599,1945,1212,-733
2016,9,12,21,2682,1953,1230,-723
2016,9,12,22,2758,1972,1262,-710
2016,9,12,23,2819,1975,1266,-709
2016,9,13,0,2866,1995,1280,-715
2016,9,13,1,2874,2013,1295,-718
2016,9,13,2,2822,2016,1326,-690
2016,9,13,3,2766,2040,1312,-728
2016,9,13,4,2656,1967,1327,-640
2016,9,13,5,2437,1822,1208,-614
2016,9,13,6,2233,1679,1238,-441
2016,9,13,7,2096,1583,1161,-422
2016,9,13,8,1549,1553,1165,-388
2016,9,13,9,1552,1532,1174,-358
2016,9,13,10,1547,1500,1138,-362
2016,9,13,11,1562,1526,1144,-382
2016,9,13,12,1630,1592,1149,-443
2016,9,13,13,1782,1761,1173,-588
2016,9,13,14,1897,1889,1145,-744
2016,9,13,15,1912,1889,1141,-748
2016,9,13,16,1941,1891,1206,-685
2016,9,13,17,1957,1898,1209,-689
2016,9,13,18,1959,1903,1231,-672
2016,9,13,19,1951,1908,1248,-660
2016,9,13,20,1961,1917,1234,-683
2016,9,13,21,1991,1918,1242,-676
2016,9,13,22,2021,1931,1252,-679
2016,9,13,23,2064,1933,1286,-647
2016,9,14,0,2103,1948,1310,-638
2016,9,14,1,2114,1947,1339,-608
2016,9,14,2,2092,1959,1418,-541
2016,9,14,3,2112,2004,1450,-554
2016,9,14,4,2048,1938,1291,-647
2016,9,14,5,1894,1793,1281,-512
2016,9,14,6,1742,1656,1195,-461
2016,9,14,7,1631,1570,1177,-393
2016,9,14,8,1581,1535,1066,-469
2016,9,14,9,1538,1505,1037,-468
2016,9,14,10,1527,1506,951,-555
2016,9,14,11,1541,1521,950,-571
2016,9,14,12,1611,1579,981,-598
2016,9,14,13,1770,1749,1107,-642
2016,9,14,14,1886,1862,1155,-707
2016,9,14,15,1904,1876,1274,-602
2016,9,14,16,1933,1886,1362,-524
2016,9,14,17,1950,1887,1391,-496
2016,9,14,18,1952,1883,1383,-500
2016,9,14,19,1941,1860,1365,-495
2016,9,14,20,1945,1860,1360,-500
2016,9,14,21,1958,1843,1311,-532
2016,9,14,22,1975,1852,1321,-531
2016,9,14,23,2001,1848,1294,-554
2016,9,15,0,2032,1843,1237,-606
2016,9,15,1,2050,1835,1246,-589
2016,9,15,2,2042,1853,1268,-585
2016,9,15,3,2058,1905,1358,-547
2016,9,15,4,1973,1857,1309,-548
2016,9,15,5,1809,1714,1154,-560
2016,9,15,6,1663,1583,1049,-534
2016,9,15,7,1629,1504,983,-521
2016,9,15,8,1540,1476,965,-511
2016,9,15,9,1499,1450,951,-499
2016,9,15,10,1490,1443,946,-497
2016,9,15,11,1504,1470,954,-516
2016,9,15,12,1574,1544,999,-545
2016,9,15,13,1733,1720,1132,-588
2016,9,15,14,1852,1828,1187,-641
2016,9,15,15,1875,1818,1138,-680
2016,9,15,16,1900,1801,1101,-700
2016,9,15,17,1917,1804,1058,-746
2016,9,15,18,1928,1806,1043,-763
2016,9,15,19,1937,1796,1023,-773
2016,9,15,20,1960,1807,1031,-776
2016,9,15,21,1992,1820,1071,-749
2016,9,15,22,2017,1821,1072,-749
2016,9,15,23,2047,1843,1080,-763
2016,9,16,0,2084,1847,1070,-777
2016,9,16,1,2105,1857,1096,-761
2016,9,16,2,2109,1871,1095,-776
2016,9,16,3,2112,1920,1133,-787
2016,9,16,4,2014,1855,1095,-760
2016,9,16,5,1840,1717,983,-734
2016,9,16,6,1684,1589,960,-629
2016,9,16,7,1612,1500,922,-578
2016,9,16,8,1523,1443,929,-514
2016,9,16,9,1484,1422,931,-491
2016,9,16,10,1480,1409,914,-495
2016,9,16,11,1495,1427,901,-526
2016,9,16,12,1569,1490,1077,-413
2016,9,16,13,1734,1645,1231,-414
2016,9,16,14,1849,1756,1242,-514
2016,9,16,15,1867,1767,1209,-558
2016,9,16,16,1892,1761,1145,-616
2016,9,16,17,1920,1776,1146,-630
2016,9,16,18,1940,1780,1154,-626
2016,9,16,19,1955,1786,1174,-612
2016,9,16,20,1982,1816,1115,-701
2016,9,16,21,2020,1842,1065,-777
2016,9,16,22,2046,1859,1111,-748
2016,9,16,23,2084,1876,1116,-760
2016,9,17,0,2109,1867,1120,-747
2016,9,17,1,2110,1872,1069,-803
2016,9,17,2,2083,1858,1050,-808
2016,9,17,3,2073,1871,1092,-779
2016,9,17,4,2000,1800,1040,-760
2016,9,17,5,1871,1693,1007,-686
2016,9,17,6,1737,1575,1001,-574
2016,9,17,7,1637,1494,1009,-485
2016,9,17,8,1532,1434,980,-454
2016,9,17,9,1449,1403,959,-444
2016,9,17,10,1437,1387,968,-419
2016,9,17,11,1436,1386,993,-393
2016,9,17,12,1470,1411,978,-433
2016,9,17,13,1551,1477,1041,-436
2016,9,17,14,1615,1537,1071,-466
2016,9,17,15,1676,1598,1085,-513
2016,9,17,16,1741,1665,1087,-578
2016,9,17,17,1799,1658,1065,-593
2016,9,17,18,1846,1689,1091,-598
2016,9,17,19,1895,1695,1068,-627
2016,9,17,20,1952,1719,1139,-580
2016,9,17,21,2004,1737,1146,-591
2016,9,17,22,2053,1764,1171,-593
2016,9,17,23,2113,1784,1217,-567
2016,9,18,0,2170,1799,1251,-548
2016,9,18,1,2176,1797,1167,-630
2016,9,18,2,2112,1795,1134,-661
2016,9,18,3,2080,1825,1200,-625
2016,9,18,4,1992,1775,1190,-585
2016,9,18,5,1872,1680,1115,-565
2016,9,18,6,1736,1562,1063,-499
2016,9,18,7,1670,1482,1074,-408
2016,9,18,8,1546,1410,1115,-295
2016,9,18,9,1426,1378,1133,-245
2016,9,18,10,1408,1370,1156,-214
2016,9,18,11,1404,1362,1149,-213
2016,9,18,12,1428,1376,1100,-276
2016,9,18,13,1484,1410,1132,-278
2016,9,18,14,1529,1454,1152,-302
2016,9,18,15,1587,1530,1126,-404
2016,9,18,16,1649,1600,1117,-483
2016,9,18,17,1686,1657,1174,-483
2016,9,18,18,1688,1674,1226,-448
2016,9,18,19,1677,1690,1252,-438
2016,9,18,20,1662,1723,1201,-522
2016,9,18,21,1667,1781,1248,-533
2016,9,18,22,1680,1837,1271,-566
2016,9,18,23,1728,1897,1313,-584
2016,9,19,0,1782,1956,1323,-633
2016,9,19,1,1790,1975,1349,-626
2016,9,19,2,1778,1956,1376,-580
2016,9,19,3,1818,1982,1343,-639
2016,9,19,4,1767,1888,1271,-617
2016,9,19,5,1654,1716,1177,-539
2016,9,19,6,1517,1558,1037,-521
2016,9,19,7,1489,1459,970,-489
2016,9,19,8,1383,1407,927,-480
2016,9,19,9,1405,1397,944,-453
2016,9,19,10,1395,1363,936,-427
2016,9,19,11,1412,1377,959,-418
2016,9,19,12,1479,1459,1011,-448
2016,9,19,13,1616,1608,1080,-528
2016,9,19,14,1733,1743,1071,-672
2016,9,19,15,1844,1773,1099,-674
2016,9,19,16,1873,1821,1156,-665
2016,9,19,17,1892,1845,1176,-669
2016,9,19,18,1895,1904,1214,-690
2016,9,19,19,1892,1938,1239,-699
2016,9,19,20,1904,1995,1242,-753
2016,9,19,21,1928,2042,1188,-854
2016,9,19,22,1960,2092,1162,-930
2016,9,19,23,1997,2140,1191,-949
2016,9,20,0,2050,2173,1169,-1004
2016,9,20,1,2066,2194,1192,-1002
2016,9,20,2,2050,2156,1216,-940
2016,9,20,3,2077,2143,1223,-920
2016,9,20,4,2007,2015,1176,-839
2016,9,20,5,1846,1821,1060,-761
2016,9,20,6,1693,1642,1089,-553
2016,9,20,7,1558,1545,1031,-514
2016,9,20,8,1510,1479,986,-493
2016,9,20,9,1490,1454,970,-484
2016,9,20,10,1472,1418,1000,-418
2016,9,20,11,1480,1422,1016,-406
2016,9,20,12,1542,1496,1060,-436
2016,9,20,13,1695,1642,1239,-403
2016,9,20,14,1811,1811,1239,-9999
2016,9,20,15,1822,1822,1099,-9999
2016,9,20,16,1864,1864,1156,-9999
2016,9,20,17,1895,1895,1176,-9999
2016,9,20,18,1909,1909,1214,-9999
2016,9,20,19,1918,1918,1239,-9999
2016,9,20,20,1948,1948,1242,-9999
2016,9,20,21,1982,1982,1188,-9999
2016,9,20,22,2022,2022,1162,-9999
2016,9,20,23,2064,2064,1191,-9999
2016,9,21,0,2098,2098,1169,-9999
2016,9,21,1,2096,2096,1192,-9999
2016,9,21,2,2047,2047,1216,-9999
2016,9,21,3,2066,2066,1223,-9999
2016,9,21,4,1978,1978,1176,-9999
2016,9,21,5,1819,1819,1060,-9999
2016,9,21,6,1658,1658,1089,-9999
2016,9,21,7,1549,1549,1031,-9999
2016,9,21,8,1479,1443,1109,-334
2016,9,21,9,1434,1405,1106,-299
2016,9,21,10,1421,1402,1039,-363
2016,9,21,11,1435,1421,1097,-324
2016,9,21,12,1505,1484,1150,-334
2016,9,21,13,1663,1639,1223,-416
2016,9,21,14,1782,1757,1243,-514
2016,9,21,15,1799,1761,1211,-550
2016,9,21,16,1831,1745,1180,-565
2016,9,21,17,1855,1774,1171,-603
2016,9,21,18,1865,1787,1236,-551
2016,9,21,19,1871,1764,1223,-541
2016,9,21,20,1876,1776,1322,-454
2016,9,21,21,1884,1770,1375,-395
2016,9,21,22,1902,1785,1443,-342
2016,9,21,23,1929,1791,1631,-160
2016,9,22,0,1929,1789,1526,-263
2016,9,22,1,1913,1779,1611,-168
2016,9,22,2,1874,1800,1614,-186
2016,9,22,3,1898,1794,1539,-255
2016,9,22,4,1806,1719,1386,-333
2016,9,22,5,1657,1594,1278,-316
2016,9,22,6,1514,1454,1345,-109
2016,9,22,7,1515,1368,1292,-76
2016,9,22,8,1442,1331,1294,-37
2016,9,22,9,1367,1309,1380,71
2016,9,22,10,1368,1290,1410,120
2016,9,22,11,1385,1307,1340,33
2016,9,22,12,1456,1395,1256,-139
2016,9,22,13,1621,1557,1255,-302
2016,9,22,14,1740,1699,1287,-412
2016,9,22,15,1757,1706,1295,-411
2016,9,22,16,1783,1712,1297,-415
2016,9,22,17,1801,1713,1311,-402
2016,9,22,18,1800,1686,1291,-395
2016,9,22,19,1784,1671,1309,-362
2016,9,22,20,1765,1636,1295,-341
2016,9,22,21,1752,1627,1282,-345
2016,9,22,22,1738,1624,1279,-345
2016,9,22,23,1730,1598,1242,-356
2016,9,23,0,1730,1616,1241,-375
2016,9,23,1,1728,1603,1300,-303
2016,9,23,2,1737,1650,1352,-298
2016,9,23,3,1786,1649,1390,-259
2016,9,23,4,1724,1564,1436,-128
2016,9,23,5,1604,1467,1306,-161
2016,9,23,6,1482,1332,1465,133
2016,9,23,7,1459,1268,1459,191
2016,9,23,8,1369,1235,1410,175
2016,9,23,9,1282,1224,1372,148
2016,9,23,10,1286,1215,1326,111
2016,9,23,11,1305,1236,1381,145
2016,9,23,12,1383,1308,1387,79
2016,9,23,13,1553,1475,1390,-85
2016,9,23,14,1679,1606,1425,-181
2016,9,23,15,1699,1606,1419,-187
2016,9,23,16,1714,1584,1441,-143
2016,9,23,17,1724,1589,1464,-125
2016,9,23,18,1720,1569,1517,-52
2016,9,23,19,1701,1563,1524,-39
2016,9,23,20,1685,1557,1505,-52
2016,9,23,21,1678,1556,1480,-76
2016,9,23,22,1676,1555,1474,-81
2016,9,23,23,1678,1543,1501,-42
2016,9,24,0,1653,1539,1455,-84
2016,9,24,1,1654,1553,1517,-36
2016,9,24,2,1662,1574,1581,7
2016,9,24,3,1688,1596,1613,17
2016,9,24,4,1638,1567,1574,7
2016,9,24,5,1555,1472,1554,82
2016,9,24,6,1453,1376,1423,47
2016,9,24,7,1428,1282,1324,42
2016,9,24,8,1323,1262,1295,33
2016,9,24,9,1259,1235,1444,209
2016,9,24,10,1249,1201,1432,231
2016,9,24,11,1252,1216,1470,254
2016,9,24,12,1289,1254,1499,245
2016,9,24,13,1371,1320,1561,241
2016,9,24,14,1453,1396,1507,111
2016,9,24,15,1505,1461,1461,0
2016,9,24,16,1542,1479,1412,-67
2016,9,24,17,1562,1486,1420,-66
2016,9,24,18,1566,1495,1431,-64
2016,9,24,19,1568,1478,1455,-23
2016,9,24,20,1568,1464,1456,-8
2016,9,24,21,1577,1454,1454,0
2016,9,24,22,1597,1447,1416,-31
2016,9,24,23,1621,1472,1427,-45
2016,9,25,0,1662,1481,1425,-56
2016,9,25,1,1682,1492,1503,11
2016,9,25,2,1674,1515,1530,15
2016,9,25,3,1668,1554,1452,-102
2016,9,25,4,1584,1518,1308,-210
2016,9,25,5,1479,1437,1207,-230
2016,9,25,6,1363,1344,1200,-144
2016,9,25,7,1305,1268,1120,-148
2016,9,25,8,1224,1222,992,-230
2016,9,25,9,1230,1206,934,-272
2016,9,25,10,1222,1200,915,-285
2016,9,25,11,1228,1203,915,-288
2016,9,25,12,1261,1231,933,-298
2016,9,25,13,1326,1290,987,-303
2016,9,25,14,1386,1361,1045,-316
2016,9,25,15,1431,1419,1120,-299
2016,9,25,16,1462,1429,1099,-330
2016,9,25,17,1479,1444,1122,-322
2016,9,25,18,1484,1449,1104,-345
2016,9,25,19,1504,1453,1102,-351
2016,9,25,20,1518,1460,1112,-348
2016,9,25,21,1544,1457,1099,-358
2016,9,25,22,1584,1482,1095,-387
2016,9,25,23,1622,1504,1086,-418
2016,9,26,0,1676,1542,1099,-443
2016,9,26,1,1703,1565,1123,-442
2016,9,26,2,1695,1601,1145,-456
2016,9,26,3,1701,1633,1184,-449
2016,9,26,4,1616,1555,1134,-421
2016,9,26,5,1484,1422,1058,-364
2016,9,26,6,1350,1296,947,-349
2016,9,26,7,1233,1212,880,-332
2016,9,26,8,1197,1188,851,-337
2016,9,26,9,1206,1173,815,-358
2016,9,26,10,1207,1173,802,-371
2016,9,26,11,1232,1198,816,-382
2016,9,26,12,1306,1278,926,-352
2016,9,26,13,1453,1456,1075,-381
2016,9,26,14,1580,1597,1167,-430
2016,9,26,15,1666,1592,1046,-546
2016,9,26,16,1694,1591,1066,-525
2016,9,26,17,1729,1596,1096,-500
2016,9,26,18,1759,1614,1119,-495
2016,9,26,19,1798,1633,1122,-511
2016,9,26,20,1841,1658,1129,-529
2016,9,26,21,1890,1691,1165,-526
2016,9,26,22,1950,1720,1189,-531
2016,9,26,23,1994,1777,1254,-523
2016,9,27,0,2057,1797,1265,-532
2016,9,27,1,2080,1835,1217,-618
2016,9,27,2,2028,1820,1194,-626
2016,9,27,3,1987,1808,1202,-606
2016,9,27,4,1863,1715,1121,-594
2016,9,27,5,1689,1551,1098,-453
2016,9,27,6,1534,1400,1027,-373
2016,9,27,7,1412,1311,1012,-299
2016,9,27,8,1351,1266,1044,-222
2016,9,27,9,1287,1234,1042,-192
2016,9,27,10,1277,1217,980,-237
2016,9,27,11,1288,1243,955,-288
2016,9,27,12,1355,1313,1044,-269
2016,9,27,13,1512,1485,1242,-243
2016,9,27,14,1631,1607,1258,-349
2016,9,27,15,1629,1602,1225,-377
2016,9,27,16,1658,1595,1198,-397
2016,9,27,17,1687,1639,1203,-436
2016,9,27,18,1713,1703,1207,-496
2016,9,27,19,1736,1706,1103,-603
2016,9,27,20,1773,1707,999,-708
2016,9,27,21,1817,1756,1039,-717
2016,9,27,22,1864,1809,1101,-708
2016,9,27,23,1914,1847,1137,-710
2016,9,28,0,1967,1895,1184,-711
2016,9,28,1,1995,1907,1212,-695
2016,9,28,2,1952,1891,1217,-674
2016,9,28,3,1938,1881,1242,-639
2016,9,28,4,1835,1751,1032,-719
2016,9,28,5,1661,1597,1015,-582
2016,9,28,6,1505,1426,980,-446
2016,9,28,7,1432,1338,899,-439
2016,9,28,8,1329,1270,989,-281
2016,9,28,9,1295,1252,996,-256
2016,9,28,10,1281,1238,994,-244
2016,9,28,11,1293,1253,1053,-200
2016,9,28,12,1365,1332,1116,-216
2016,9,28,13,1530,1491,1195,-296
2016,9,28,14,1655,1624,1243,-381
2016,9,28,15,1652,1622,1201,-421
2016,9,28,16,1682,1607,1175,-432
2016,9,28,17,1734,1644,1218,-426
2016,9,28,18,1780,1664,1268,-396
2016,9,28,19,1785,1698,1268,-430
2016,9,28,20,1824,1767,1332,-435
2016,9,28,21,1885,1828,1394,-434
2016,9,28,22,1947,1919,1395,-524
2016,9,28,23,2009,1972,1352,-620
2016,9,29,0,2049,2009,1420,-589
2016,9,29,1,2081,2009,1434,-575
2016,9,29,2,1990,1994,1432,-562
2016,9,29,3,1996,1947,1454,-493
2016,9,29,4,1900,1819,1313,-506
2016,9,29,5,1731,1644,1277,-367
2016,9,29,6,1563,1478,1310,-168
2016,9,29,7,1472,1373,1353,-20
2016,9,29,8,1408,1333,1358,25
2016,9,29,9,1344,1292,1307,15
2016,9,29,10,1338,1280,1317,37
2016,9,29,11,1359,1299,1405,106
2016,9,29,12,1436,1363,1451,88
2016,9,29,13,1603,1521,1499,-22
2016,9,29,14,1736,1653,1430,-223
2016,9,29,15,1741,1660,1421,-239
2016,9,29,16,1778,1670,1392,-278
2016,9,29,17,1828,1715,1458,-257
2016,9,29,18,1869,1796,1462,-334
2016,9,29,19,1874,1826,1404,-422
2016,9,29,20,1889,1879,1460,-419
2016,9,29,21,1894,1950,1487,-463
2016,9,29,22,1903,2018,1427,-591
2016,9,29,23,1930,2056,1457,-599
2016,9,30,0,1918,2042,1571,-471
2016,9,30,1,1903,2011,1593,-418
2016,9,30,2,1890,2009,1500,-509
2016,9,30,3,1926,1971,1452,-519
2016,9,30,4,1843,1863,1473,-390
2016,9,30,5,1682,1695,1332,-363
2016,9,30,6,1520,1550,1266,-284
2016,9,30,7,1456,1446,1265,-181
2016,9,30,8,1351,1362,1310,-52
2016,9,30,9,1363,1346,1264,-82
2016,9,30,10,1335,1321,1306,-15
2016,9,30,11,1345,1311,1257,-54
2016,9,30,12,1408,1375,1274,-101
2016,9,30,13,1571,1532,1376,-156
2016,9,30,14,1696,1671,1345,-326
2016,9,30,15,1699,1669,1256,-413
2016,9,30,16,1742,1680,1262,-418
2016,9,30,17,1798,1744,1258,-486
2016,9,30,18,1838,1793,1233,-560
2016,9,30,19,1848,1843,1196,-647
2016,9,30,20,1865,1906,1224,-682
2016,9,30,21,1887,1975,1246,-729
2016,9,30,22,1914,2002,1242,-760
2016,9,30,23,1942,2039,1306,-733
2016,10,1,0,1892,2021,1314,-707
2016,10,1,1,1861,1935,1314,-621
2016,10,1,2,1835,1886,1276,-610
2016,10,1,3,1850,1857,1327,-530
2016,10,1,4,1791,1759,1381,-378
2016,10,1,5,1681,1637,1411,-226
2016,10,1,6,1547,1514,1350,-164
2016,10,1,7,1390,1418,1240,-178
2016,10,1,8,1331,1346,1133,-213
2016,10,1,9,1297,1312,972,-340
2016,10,1,10,1271,1291,903,-388
2016,10,1,11,1270,1273,917,-356
2016,10,1,12,1300,1295,887,-408
2016,10,1,13,1378,1362,918,-444
2016,10,1,14,1456,1430,919,-511
2016,10,1,15,1501,1496,992,-504
2016,10,1,16,1561,1528,1006,-522
2016,10,1,17,1598,1562,1012,-550
2016,10,1,18,1607,1586,1041,-545
2016,10,1,19,1581,1599,1058,-541
2016,10,1,20,1565,1615,1061,-554
2016,10,1,21,1562,1622,1097,-525
2016,10,1,22,1579,1634,1118,-516
2016,10,1,23,1606,1630,1129,-501
2016,10,2,0,1584,1648,1151,-497
2016,10,2,1,1558,1636,1146,-490
2016,10,2,2,1556,1630,1094,-536
2016,10,2,3,1584,1622,1035,-587
2016,10,2,4,1540,1540,970,-570
2016,10,2,5,1451,1466,943,-523
2016,10,2,6,1342,1369,917,-452
2016,10,2,7,1232,1292,823,-469
2016,10,2,8,1186,1246,755,-491
2016,10,2,9,1166,1214,749,-465
2016,10,2,10,1161,1210,754,-456
2016,10,2,11,1174,1214,753,-461
2016,10,2,12,1213,1233,755,-478
2016,10,2,13,1294,1286,832,-454
2016,10,2,14,1370,1350,871,-479
2016,10,2,15,1416,1418,913,-505
2016,10,2,16,1456,1487,984,-503
2016,10,2,17,1472,1487,1042,-445
2016,10,2,18,1460,1478,1036,-442
2016,10,2,19,1442,1479,1024,-455
2016,10,2,20,1432,1483,1026,-457
2016,10,2,21,1440,1482,1035,-447
2016,10,2,22,1468,1488,1059,-429
2016,10,2,23,1508,1491,1095,-396
2016,10,3,0,1499,1543,1219,-324
2016,10,3,1,1485,1567,1262,-305
2016,10,3,2,1493,1623,1278,-345
2016,10,3,3,1549,1638,1249,-389
2016,10,3,4,1510,1547,1184,-363
2016,10,3,5,1404,1430,1157,-273
2016,10,3,6,1282,1316,1238,-78
2016,10,3,7,1176,1244,1226,-18
2016,10,3,8,1182,1212,1206,-6
2016,10,3,9,1210,1205,1226,21
2016,10,3,10,1210,1196,1234,38
2016,10,3,11,1241,1233,1237,4
2016,10,3,12,1316,1320,1242,-78
2016,10,3,13,1472,1496,1357,-139
2016,10,3,14,1603,1657,1511,-146
2016,10,3,15,1685,1663,1549,-114
2016,10,3,16,1717,1655,1546,-109
2016,10,3,17,1730,1650,1543,-107
2016,10,3,18,1719,1644,1516,-128
2016,10,3,19,1690,1651,1496,-155
2016,10,3,20,1665,1641,1527,-114
2016,10,3,21,1640,1620,1529,-91
2016,10,3,22,1623,1603,1523,-80
2016,10,3,23,1614,1602,1501,-101
2016,10,4,0,1610,1619,1503,-116
2016,10,4,1,1598,1654,1507,-147
2016,10,4,2,1634,1704,1284,-420
2016,10,4,3,1678,1726,1284,-442
2016,10,4,4,1630,1653,1135,-518
2016,10,4,5,1523,1530,1107,-423
2016,10,4,6,1415,1399,908,-491
2016,10,4,7,1316,1334,881,-453
2016,10,4,8,1304,1299,935,-364
2016,10,4,9,1307,1289,912,-377
2016,10,4,10,1305,1284,870,-414
2016,10,4,11,1332,1307,894,-413
2016,10,4,12,1413,1415,969,-446
2016,10,4,13,1584,1586,1007,-579
2016,10,4,14,1719,1749,1099,-650
2016,10,4,15,1732,1746,1123,-623
2016,10,4,16,1737,1743,1139,-604
2016,10,4,17,1737,1783,1254,-529
2016,10,4,18,1724,1709,1253,-456
2016,10,4,19,1696,1764,1205,-559
2016,10,4,20,1673,1649,1251,-398
2016,10,4,21,1654,1635,1245,-390
2016,10,4,22,1638,1614,1316,-298
2016,10,4,23,1633,1621,1290,-331
2016,10,5,0,1636,1618,1227,-391
2016,10,5,1,1632,1667,1167,-500
2016,10,5,2,1674,1725,1050,-675
2016,10,5,3,1709,1757,1079,-678
2016,10,5,4,1651,1681,1047,-634
2016,10,5,5,1535,1556,972,-584
2016,10,5,6,1420,1425,898,-527
2016,10,5,7,1340,1366,865,-501
2016,10,5,8,1319,1332,838,-494
2016,10,5,9,1333,1319,788,-531
2016,10,5,10,1330,1316,775,-541
2016,10,5,11,1358,1349,795,-554
2016,10,5,12,1446,1440,853,-587
2016,10,5,13,1624,1623,895,-728
2016,10,5,14,1768,1763,971,-792
2016,10,5,15,1771,1751,949,-802
2016,10,5,16,1771,1723,929,-794
2016,10,5,17,1768,1682,989,-693
2016,10,5,18,1754,1656,1033,-623
2016,10,5,19,1716,1635,1019,-616
2016,10,5,20,1698,1623,1000,-623
2016,10,5,21,1677,1619,988,-631
2016,10,5,22,1662,1627,1010,-617
2016,10,5,23,1661,1624,1013,-611
2016,10,6,0,1672,1647,972,-675
2016,10,6,1,1678,1673,967,-706
2016,10,6,2,1726,1729,991,-738
2016,10,6,3,1753,1743,1009,-734
2016,10,6,4,1684,1674,942,-732
2016,10,6,5,1561,1557,885,-672
2016,10,6,6,1441,1430,803,-627
2016,10,6,7,1349,1363,830,-533
2016,10,6,8,1335,1315,750,-565
2016,10,6,9,1340,1308,770,-538
2016,10,6,10,1338,1309,791,-518
2016,10,6,11,1367,1324,797,-527
2016,10,6,12,1456,1409,788,-621
2016,10,6,13,1639,1579,849,-730
2016,10,6,14,1782,1712,933,-779
2016,10,6,15,1780,1740,1023,-717
2016,10,6,16,1771,1742,994,-748
2016,10,6,17,1759,1727,937,-790
2016,10,6,18,1743,1709,964,-745
2016,10,6,19,1713,1664,931,-733
2016,10,6,20,1697,1671,933,-738
2016,10,6,21,1684,1650,938,-712
2016,10,6,22,1674,1640,916,-724
2016,10,6,23,1675,1623,884,-739
2016,10,7,0,1686,1626,890,-736
2016,10,7,1,1702,1657,919,-738
2016,10,7,2,1753,1712,961,-751
2016,10,7,3,1769,1737,1000,-737
2016,10,7,4,1697,1662,952,-710
2016,10,7,5,1574,1552,886,-666
2016,10,7,6,1452,1431,832,-599
2016,10,7,7,1365,1368,828,-540
2016,10,7,8,1342,1321,872,-449
2016,10,7,9,1340,1316,937,-379
2016,10,7,10,1336,1311,908,-403
2016,10,7,11,1359,1331,927,-404
2016,10,7,12,1444,1408,996,-412
2016,10,7,13,1614,1535,1093,-442
2016,10,7,14,1749,1672,1080,-592
2016,10,7,15,1758,1700,1082,-618
2016,10,7,16,1756,1685,1062,-623
2016,10,7,17,1754,1679,1062,-617
2016,10,7,18,1750,1652,1025,-627
2016,10,7,19,1738,1627,1043,-584
2016,10,7,20,1746,1624,1033,-591
2016,10,7,21,1755,1621,1010,-611
2016,10,7,22,1761,1611,990,-621
2016,10,7,23,1776,1608,987,-621
2016,10,8,0,1761,1619,1011,-608
2016,10,8,1,1755,1627,1012,-615
2016,10,8,2,1764,1669,1058,-611
2016,10,8,3,1748,1654,1078,-576
2016,10,8,4,1674,1588,1064,-524
2016,10,8,5,1583,1515,1021,-494
2016,10,8,6,1478,1409,985,-424
2016,10,8,7,1383,1325,960,-365
2016,10,8,8,1332,1292,922,-370
2016,10,8,9,1292,1265,894,-371
2016,10,8,10,1288,1267,962,-305
2016,10,8,11,1298,1265,976,-289
2016,10,8,12,1344,1313,1013,-300
2016,10,8,13,1414,1389,1096,-293
2016,10,8,14,1499,1479,1153,-326
2016,10,8,15,1563,1546,1168,-378
2016,10,8,16,1600,1545,1168,-377
2016,10,8,17,1612,1544,1135,-409
2016,10,8,18,1618,1536,1118,-418
2016,10,8,19,1620,1516,1143,-373
2016,10,8,20,1641,1529,1121,-408
2016,10,8,21,1668,1525,1111,-414
2016,10,8,22,1706,1546,1092,-454
2016,10,8,23,1740,1574,1096,-478
2016,10,9,0,1784,1587,1125,-462
2016,10,9,1,1787,1607,1186,-421
2016,10,9,2,1776,1643,1208,-435
2016,10,9,3,1748,1638,1158,-480
2016,10,9,4,1664,1578,1147,-431
2016,10,9,5,1560,1478,1073,-405
2016,10,9,6,1445,1388,990,-398
2016,10,9,7,1368,1304,994,-310
2016,10,9,8,1300,1267,984,-283
2016,10,9,9,1264,1240,960,-280
2016,10,9,10,1257,1235,963,-272
2016,10,9,11,1263,1235,954,-281
2016,10,9,12,1298,1256,982,-274
2016,10,9,13,1355,1319,1034,-285
2016,10,9,14,1423,1405,1101,-304
2016,10,9,15,1477,1459,1101,-358
2016,10,9,16,1521,1473,1089,-384
2016,10,9,17,1544,1490,1120,-370
2016,10,9,18,1554,1494,1087,-407
2016,10,9,19,1578,1497,1077,-420
2016,10,9,20,1596,1514,1111,-403
2016,10,9,21,1608,1537,1130,-407
2016,10,9,22,1629,1566,1140,-426
2016,10,9,23,1653,1598,1141,-457
2016,10,10,0,1689,1655,1206,-449
2016,10,10,1,1697,1685,1224,-461
2016,10,10,2,1705,1704,1218,-486
2016,10,10,3,1718,1685,1228,-457
2016,10,10,4,1644,1612,1168,-444
2016,10,10,5,1521,1493,1030,-463
2016,10,10,6,1397,1362,939,-423
2016,10,10,7,1321,1280,867,-413
2016,10,10,8,1275,1236,833,-403
2016,10,10,9,1258,1223,787,-436
2016,10,10,10,1258,1210,796,-414
2016,10,10,11,1284,1243,793,-450
2016,10,10,12,1360,1310,862,-448
2016,10,10,13,1513,1491,879,-612
2016,10,10,14,1652,1626,839,-787
2016,10,10,15,1721,1658,846,-812
2016,10,10,16,1738,1666,829,-837
2016,10,10,17,1749,1683,828,-855
2016,10,10,18,1744,1674,851,-823
2016,10,10,19,1721,1659,875,-784
2016,10,10,20,1711,1660,852,-808
2016,10,10,21,1699,1652,805,-847
2016,10,10,22,1688,1663,819,-844
2016,10,10,23,1684,1678,867,-811
2016,10,11,0,1692,1737,890,-847
2016,10,11,1,1683,1701,926,-775
2016,10,11,2,1739,1761,978,-783
2016,10,11,3,1738,1743,1028,-715
2016,10,11,4,1664,1650,1100,-550
2016,10,11,5,1534,1520,1084,-436
2016,10,11,6,1408,1397,1087,-310
2016,10,11,7,1370,1311,1075,-236
2016,10,11,8,1329,1266,1018,-248
2016,10,11,9,1287,1248,1102,-146
2016,10,11,10,1286,1244,1052,-192
2016,10,11,11,1308,1274,1075,-199
2016,10,11,12,1386,1348,1125,-223
2016,10,11,13,1550,1541,1164,-377
2016,10,11,14,1690,1685,1262,-423
2016,10,11,15,1707,1686,1221,-465
2016,10,11,16,1721,1660,1192,-468
2016,10,11,17,1721,1665,1198,-467
2016,10,11,18,1698,1631,1211,-420
2016,10,11,19,1659,1607,1275,-332
2016,10,11,20,1637,1612,1291,-321
2016,10,11,21,1614,1589,1342,-247
2016,10,11,22,1602,1586,1360,-226
2016,10,11,23,1595,1584,1328,-256
2016,10,12,0,1597,1599,1365,-234
2016,10,12,1,1604,1623,1295,-328
2016,10,12,2,1679,1702,1306,-396
2016,10,12,3,1702,1725,1313,-412
2016,10,12,4,1650,1641,1254,-387
2016,10,12,5,1538,1524,1115,-409
2016,10,12,6,1428,1399,1009,-390
2016,10,12,7,1387,1335,972,-363
2016,10,12,8,1359,1303,973,-330
2016,10,12,9,1338,1293,971,-322
2016,10,12,10,1346,1310,960,-350
2016,10,12,11,1379,1351,993,-358
2016,10,12,12,1473,1457,1014,-443
2016,10,12,13,1661,1656,1076,-580
2016,10,12,14,1818,1838,1051,-787
2016,10,12,15,1835,1809,1024,-785
2016,10,12,16,1811,1748,973,-775
2016,10,12,17,1774,1627,930,-697
2016,10,12,18,1728,1588,913,-675
2016,10,12,19,1679,1548,936,-612
2016,10,12,20,1655,1526,904,-622
2016,10,12,21,1635,1506,888,-618
2016,10,12,22,1629,1487,897,-590
2016,10,12,23,1634,1497,913,-584
2016,10,13,0,1645,1503,930,-573
2016,10,13,1,1656,1551,947,-604
2016,10,13,2,1723,1632,959,-673
2016,10,13,3,1731,1664,985,-679
2016,10,13,4,1661,1587,899,-688
2016,10,13,5,1532,1481,865,-616
2016,10,13,6,1411,1422,895,-527
2016,10,13,7,1354,1406,915,-491
2016,10,13,8,1306,1308,937,-371
2016,10,13,9,1309,1256,942,-314
2016,10,13,10,1304,1267,949,-318
2016,10,13,11,1330,1297,991,-306
2016,10,13,12,1419,1400,1031,-369
2016,10,13,13,1597,1611,1052,-559
2016,10,13,14,1743,1779,1026,-753
2016,10,13,15,1738,1802,1058,-744
2016,10,13,16,1728,1849,1020,-829
2016,10,13,17,1715,1825,958,-867
2016,10,13,18,1704,1737,912,-825
2016,10,13,19,1696,1650,884,-766
2016,10,13,20,1704,1652,820,-832
2016,10,13,21,1703,1640,852,-788
2016,10,13,22,1709,1657,902,-755
2016,10,13,23,1720,1701,864,-837
2016,10,14,0,1730,1662,885,-777
2016,10,14,1,1735,1676,928,-748
2016,10,14,2,1806,1739,1038,-701
2016,10,14,3,1806,1764,1090,-674
2016,10,14,4,1729,1757,1081,-676
2016,10,14,5,1592,1629,1073,-556
2016,10,14,6,1460,1457,1114,-343
2016,10,14,7,1375,1382,1116,-266
2016,10,14,8,1334,1364,1137,-227
2016,10,14,9,1303,1364,1166,-198
2016,10,14,10,1301,1328,1085,-243
2016,10,14,11,1330,1304,1016,-288
2016,10,14,12,1422,1328,957,-371
2016,10,14,13,1601,1488,895,-593
2016,10,14,14,1739,1620,912,-708
2016,10,14,15,1728,1640,957,-683
2016,10,14,16,1729,1751,1223,-528
2016,10,14,17,1733,1755,1339,-416
2016,10,14,18,1729,1745,1269,-476
2016,10,14,19,1710,1721,1334,-387
2016,10,14,20,1692,1699,1361,-338
2016,10,14,21,1672,1616,1283,-333
2016,10,14,22,1662,1532,1176,-356
2016,10,14,23,1667,1562,1057,-505
2016,10,15,0,1633,1516,971,-545
2016,10,15,1,1622,1591,1023,-568
2016,10,15,2,1672,1696,1061,-635
2016,10,15,3,1663,1652,1015,-637
2016,10,15,4,1609,1565,1021,-544
2016,10,15,5,1524,1510,882,-628
2016,10,15,6,1424,1410,830,-580
2016,10,15,7,1353,1384,849,-535
2016,10,15,8,1300,1259,789,-470
2016,10,15,9,1265,1234,765,-469
2016,10,15,10,1248,1216,748,-468
2016,10,15,11,1254,1225,712,-513
2016,10,15,12,1293,1257,710,-547
2016,10,15,13,1372,1337,736,-601
2016,10,15,14,1460,1425,827,-598
2016,10,15,15,1523,1501,928,-573
2016,10,15,16,1565,1560,957,-603
2016,10,15,17,1583,1576,974,-602
2016,10,15,18,1586,1561,984,-577
2016,10,15,19,1577,1546,966,-580
2016,10,15,20,1572,1519,993,-526
2016,10,15,21,1563,1502,1048,-454
2016,10,15,22,1564,1502,1120,-382
2016,10,15,23,1574,1513,1099,-414
2016,10,16,0,1598,1539,1140,-399
2016,10,16,1,1608,1557,1229,-328
2016,10,16,2,1650,1587,1170,-417
2016,10,16,3,1640,1552,1118,-434
2016,10,16,4,1579,1505,1056,-449
2016,10,16,5,1487,1412,904,-508
2016,10,16,6,1386,1335,984,-351
2016,10,16,7,1312,1262,982,-280
2016,10,16,8,1266,1215,991,-224
2016,10,16,9,1220,1205,1045,-160
2016,10,16,10,1202,1185,1129,-56
2016,10,16,11,1207,1188,1045,-143
2016,10,16,12,1239,1211,973,-238
2016,10,16,13,1301,1268,1036,-232
2016,10,16,14,1378,1362,951,-411
2016,10,16,15,1443,1430,845,-585
2016,10,16,16,1494,1460,844,-616
2016,10,16,17,1510,1475,842,-633
2016,10,16,18,1501,1472,853,-619
2016,10,16,19,1490,1480,849,-631
2016,10,16,20,1471,1467,829,-638
2016,10,16,21,1455,1459,870,-589
2016,10,16,22,1448,1461,940,-521
2016,10,16,23,1458,1471,959,-512
2016,10,17,0,1485,1527,1055,-472
2016,10,17,1,1510,1583,1116,-467
2016,10,17,2,1564,1636,1104,-532
2016,10,17,3,1561,1628,1043,-585
2016,10,17,4,1510,1549,917,-632
2016,10,17,5,1408,1443,856,-587
2016,10,17,6,1302,1324,926,-398
2016,10,17,7,1249,1243,874,-369
2016,10,17,8,1212,1222,822,-400
2016,10,17,9,1231,1202,835,-367
2016,10,17,10,1228,1211,848,-363
2016,10,17,11,1253,1232,841,-391
2016,10,17,12,1332,1349,834,-515
2016,10,17,13,1494,1539,1014,-525
2016,10,17,14,1644,1707,1182,-525
2016,10,17,15,1718,1712,1251,-461
2016,10,17,16,1736,1714,1145,-569
2016,10,17,17,1745,1711,1091,-620
2016,10,17,18,1738,1702,1135,-567
2016,10,17,19,1712,1672,1227,-445
2016,10,17,20,1692,1638,1295,-343
2016,10,17,21,1671,1615,1299,-316
2016,10,17,22,1651,1600,1202,-398
2016,10,17,23,1652,1613,1137,-476
2016,10,18,0,1670,1663,1058,-605
2016,10,18,1,1696,1697,1141,-556
2016,10,18,2,1752,1783,1230,-553
2016,10,18,3,1736,1759,1200,-559
2016,10,18,4,1670,1672,1044,-628
2016,10,18,5,1553,1550,899,-651
2016,10,18,6,1438,1503,778,-725
2016,10,18,7,1344,1399,773,-626
2016,10,18,8,1323,1356,705,-651
2016,10,18,9,1359,1343,690,-653
2016,10,18,10,1349,1341,692,-649
2016,10,18,11,1370,1374,712,-662
2016,10,18,12,1454,1440,776,-664
2016,10,18,13,1629,1643,965,-678
2016,10,18,14,1776,1785,1113,-672
2016,10,18,15,1778,1806,1146,-660
2016,10,18,16,1780,1796,1185,-611
2016,10,18,17,1781,1796,1163,-633
2016,10,18,18,1767,1761,1063,-698
2016,10,18,19,1740,1708,1055,-653
2016,10,18,20,1715,1695,1023,-672
2016,10,18,21,1689,1669,1017,-652
2016,10,18,22,1666,1650,1010,-640
2016,10,18,23,1669,1688,1019,-669
2016,10,19,0,1694,1687,995,-692
2016,10,19,1,1726,1723,1014,-709
2016,10,19,2,1801,1771,1072,-699
2016,10,19,3,1782,1752,1057,-695
2016,10,19,4,1708,1672,1136,-536
2016,10,19,5,1587,1561,1031,-530
2016,10,19,6,1480,1616,1065,-551
2016,10,19,7,1369,1548,1150,-398
2016,10,19,8,1381,1327,1062,-265
2016,10,19,9,1362,1323,1062,-261
2016,10,19,10,1363,1353,1096,-257
2016,10,19,11,1394,1371,1097,-274
2016,10,19,12,1483,1495,1199,-296
2016,10,19,13,1683,1700,1327,-373
2016,10,19,14,1844,1862,1117,-745
2016,10,19,15,1864,1848,1063,-785
2016,10,19,16,1850,1784,1008,-776
2016,10,19,17,1828,1693,959,-734
2016,10,19,18,1796,1630,904,-726
2016,10,19,19,1750,1582,876,-706
2016,10,19,20,1715,1556,859,-697
2016,10,19,21,1682,1538,795,-743
2016,10,19,22,1661,1536,798,-738
2016,10,19,23,1673,1515,964,-551
2016,10,20,0,1687,1526,1009,-517
2016,10,20,1,1721,1597,1062,-535
2016,10,20,2,1785,1680,1027,-653
2016,10,20,3,1764,1665,1015,-650
2016,10,20,4,1690,1619,1053,-566
2016,10,20,5,1574,1492,1017,-475
2016,10,20,6,1468,1367,1036,-331
2016,10,20,7,1405,1410,1116,-294
2016,10,20,8,1371,1253,1082,-171
2016,10,20,9,1299,1258,1146,-112
2016,10,20,10,1309,1273,1211,-62
2016,10,20,11,1343,1313,1234,-79
2016,10,20,12,1440,1405,1295,-110
2016,10,20,13,1632,1606,1341,-265
2016,10,20,14,1790,1750,1301,-449
2016,10,20,15,1791,1747,1220,-527
2016,10,20,16,1767,1733,1184,-549
2016,10,20,17,1742,1703,1188,-515
2016,10,20,18,1715,1607,1199,-408
2016,10,20,19,1670,1566,1162,-404
2016,10,20,20,1652,1547,1139,-408
2016,10,20,21,1636,1517,1108,-409
2016,10,20,22,1616,1486,1060,-426
2016,10,20,23,1635,1490,1069,-421
2016,10,21,0,1648,1509,1060,-449
2016,10,21,1,1681,1528,1058,-470
2016,10,21,2,1739,1606,1114,-492
2016,10,21,3,1709,1570,1131,-439
2016,10,21,4,1628,1510,1049,-461
2016,10,21,5,1503,1506,1056,-450
2016,10,21,6,1388,1387,1013,-374
2016,10,21,7,1369,1336,1026,-310
2016,10,21,8,1294,1205,944,-261
2016,10,21,9,1246,1213,909,-304
2016,10,21,10,1258,1239,966,-273
2016,10,21,11,1300,1278,999,-279
2016,10,21,12,1398,1384,1058,-326
2016,10,21,13,1594,1544,1185,-359
2016,10,21,14,1745,1709,1133,-576
2016,10,21,15,1748,1727,1181,-546
2016,10,21,16,1728,1678,1127,-551
2016,10,21,17,1710,1634,1077,-557
2016,10,21,18,1660,1601,1026,-575
2016,10,21,19,1630,1552,1038,-514
2016,10,21,20,1634,1518,1014,-504
2016,10,21,21,1635,1462,996,-466
2016,10,21,22,1632,1431,981,-450
2016,10,21,23,1660,1418,958,-460
2016,10,22,0,1639,1442,1001,-441
2016,10,22,1,1635,1464,989,-475
2016,10,22,2,1653,1516,1014,-502
2016,10,22,3,1605,1490,1006,-484
2016,10,22,4,1540,1438,974,-464
2016,10,22,5,1459,1359,894,-465
2016,10,22,6,1366,1282,959,-323
2016,10,22,7,1322,1204,923,-281
2016,10,22,8,1248,1204,983,-221
2016,10,22,9,1185,1215,1025,-190
2016,10,22,10,1194,1175,976,-199
2016,10,22,11,1221,1198,944,-254
2016,10,22,12,1277,1240,973,-267
2016,10,22,13,1362,1289,1062,-227
2016,10,22,14,1460,1419,1133,-286
2016,10,22,15,1514,1512,1180,-332
2016,10,22,16,1542,1510,1083,-427
2016,10,22,17,1543,1526,1013,-513
2016,10,22,18,1520,1510,972,-538
2016,10,22,19,1490,1476,941,-535
2016,10,22,20,1473,1450,916,-534
2016,10,22,21,1445,1423,887,-536
2016,10,22,22,1375,1402,862,-540
2016,10,22,23,1422,1423,878,-545
2016,10,23,0,1441,1456,899,-557
2016,10,23,1,1463,1517,931,-586
2016,10,23,2,1518,1577,999,-578
2016,10,23,3,1500,1537,1001,-536
2016,10,23,4,1449,1498,982,-516
2016,10,23,5,1371,1416,908,-508
2016,10,23,6,1283,1334,814,-520
2016,10,23,7,1247,1273,674,-599
2016,10,23,8,1196,1233,667,-566
2016,10,23,9,1251,1216,688,-528
2016,10,23,10,1237,1216,703,-513
2016,10,23,11,1256,1229,685,-544
2016,10,23,12,1294,1264,636,-628
2016,10,23,13,1355,1333,684,-649
2016,10,23,14,1443,1416,782,-634
2016,10,23,15,1498,1493,792,-701
2016,10,23,16,1519,1517,776,-741
2016,10,23,17,1526,1489,714,-775
2016,10,23,18,1505,1460,684,-776
2016,10,23,19,1492,1455,707,-748
2016,10,23,20,1493,1423,744,-679
2016,10,23,21,1496,1410,700,-710
2016,10,23,22,1476,1418,678,-740
2016,10,23,23,1528,1448,679,-769
2016,10,24,0,1568,1478,775,-703
2016,10,24,1,1594,1525,860,-665
2016,10,24,2,1639,1606,899,-707
2016,10,24,3,1611,1576,921,-655
2016,10,24,4,1541,1493,895,-598
2016,10,24,5,1423,1388,862,-526
2016,10,24,6,1317,1280,924,-356
2016,10,24,7,1193,1219,878,-341
2016,10,24,8,1182,1179,917,-262
2016,10,24,9,1208,1168,905,-263
2016,10,24,10,1210,1166,912,-254
2016,10,24,11,1248,1198,926,-272
2016,10,24,12,1335,1285,922,-363
2016,10,24,13,1498,1470,1109,-361
2016,10,24,14,1647,1659,1193,-466
2016,10,24,15,1705,1646,1114,-532
2016,10,24,16,1703,1658,1059,-599
2016,10,24,17,1716,1651,1037,-614
2016,10,24,18,1712,1652,978,-674
2016,10,24,19,1696,1625,950,-675
2016,10,24,20,1695,1621,960,-661
2016,10,24,21,1685,1588,929,-659
2016,10,24,22,1652,1564,890,-674
2016,10,24,23,1666,1579,980,-599
2016,10,25,0,1679,1604,950,-654
2016,10,25,1,1698,1684,955,-729
2016,10,25,2,1760,1700,903,-797
2016,10,25,3,1729,1666,853,-813
2016,10,25,4,1649,1591,794,-797
2016,10,25,5,1522,1450,749,-701
2016,10,25,6,1401,1352,832,-520
2016,10,25,7,1301,1257,954,-303
2016,10,25,8,1273,1243,974,-269
2016,10,25,9,1256,1210,908,-302
2016,10,25,10,1251,1223,797,-426
2016,10,25,11,1281,1241,634,-607
2016,10,25,12,1361,1324,655,-669
2016,10,25,13,1524,1510,821,-689
2016,10,25,14,1666,1660,777,-883
2016,10,25,15,1671,1690,805,-885
2016,10,25,16,1670,1664,756,-908
2016,10,25,17,1675,1614,708,-906
2016,10,25,18,1668,1565,759,-806
2016,10,25,19,1645,1580,892,-688
2016,10,25,20,1632,1576,856,-720
2016,10,25,21,1614,1564,826,-738
2016,10,25,22,1580,1556,860,-696
2016,10,25,23,1592,1562,764,-798
2016,10,26,0,1609,1588,776,-812
2016,10,26,1,1658,1529,871,-658
2016,10,26,2,1709,1681,891,-790
2016,10,26,3,1681,1661,823,-838
2016,10,26,4,1602,1580,766,-814
2016,10,26,5,1480,1452,686,-766
2016,10,26,6,1366,1333,873,-460
2016,10,26,7,1301,1261,870,-391
2016,10,26,8,1257,1226,802,-424
2016,10,26,9,1236,1207,832,-375
2016,10,26,10,1236,1205,801,-404
2016,10,26,11,1264,1228,793,-435
2016,10,26,12,1348,1303,872,-431
2016,10,26,13,1519,1482,939,-543
2016,10,26,14,1667,1659,847,-812
2016,10,26,15,1681,1663,899,-764
2016,10,26,16,1672,1501,936,-565
2016,10,26,17,1649,1481,982,-499
2016,10,26,18,1640,1313,1014,-299
2016,10,26,19,1654,1304,1002,-302
2016,10,26,20,1676,1554,1008,-546
2016,10,26,21,1699,1532,973,-559
2016,10,26,22,1698,1531,933,-598
2016,10,26,23,1726,1521,897,-624
2016,10,27,0,1748,1552,853,-699
2016,10,27,1,1782,1592,812,-780
2016,10,27,2,1812,1658,948,-710
2016,10,27,3,1766,1624,1021,-603
2016,10,27,4,1668,1554,968,-586
2016,10,27,5,1525,1424,901,-523
2016,10,27,6,1395,1311,1046,-265
2016,10,27,7,1318,1227,1015,-212
2016,10,27,8,1252,1190,971,-219
2016,10,27,9,1200,1172,929,-243
2016,10,27,10,1198,1175,880,-295
2016,10,27,11,1226,1206,880,-326
2016,10,27,12,1309,1289,936,-353
2016,10,27,13,1483,1466,1085,-381
2016,10,27,14,1636,1611,940,-671
2016,10,27,15,1655,1626,909,-717
2016,10,27,16,1642,1589,892,-697
2016,10,27,17,1629,1596,926,-670
2016,10,27,18,1616,1597,919,-678
2016,10,27,19,1608,1578,912,-666
2016,10,27,20,1598,1577,936,-641
2016,10,27,21,1578,1575,926,-649
2016,10,27,22,1556,1570,882,-688
2016,10,27,23,1554,1578,802,-776
2016,10,28,0,1555,1586,911,-675
2016,10,28,1,1590,1607,989,-618
2016,10,28,2,1657,1652,959,-693
2016,10,28,3,1631,1617,932,-685
2016,10,28,4,1556,1546,828,-718
2016,10,28,5,1437,1431,729,-702
2016,10,28,6,1322,1311,702,-609
2016,10,28,7,1282,1248,594,-654
2016,10,28,8,1224,1197,534,-663
2016,10,28,9,1217,1191,475,-716
2016,10,28,10,1216,1170,463,-707
2016,10,28,11,1242,1208,455,-753
2016,10,28,12,1326,1281,483,-798
2016,10,28,13,1507,1431,636,-795
2016,10,28,14,1661,1584,770,-814
2016,10,28,15,1680,1623,845,-778
2016,10,28,16,1667,1628,839,-789
2016,10,28,17,1654,1623,814,-809
2016,10,28,18,1637,1615,794,-821
2016,10,28,19,1618,1571,795,-776
2016,10,28,20,1588,1546,967,-579
2016,10,28,21,1561,1532,833,-699
2016,10,28,22,1531,1543,756,-787
2016,10,28,23,1522,1535,698,-837
2016,10,29,0,1475,1556,747,-809
2016,10,29,1,1504,1588,780,-808
2016,10,29,2,1554,1603,797,-806
2016,10,29,3,1534,1566,746,-820
2016,10,29,4,1492,1518,696,-822
2016,10,29,5,1422,1432,706,-726
2016,10,29,6,1337,1336,679,-657
2016,10,29,7,1259,1268,571,-697
2016,10,29,8,1225,1230,565,-665
2016,10,29,9,1232,1206,630,-576
2016,10,29,10,1218,1195,648,-547
2016,10,29,11,1228,1204,640,-564
2016,10,29,12,1271,1251,598,-653
2016,10,29,13,1355,1327,551,-776
2016,10,29,14,1464,1437,598,-839
2016,10,29,15,1545,1495,656,-839
2016,10,29,16,1569,1519,714,-805
2016,10,29,17,1564,1526,728,-798
2016,10,29,18,1549,1514,801,-713
2016,10,29,19,1526,1470,838,-632
2016,10,29,20,1499,1442,824,-618
2016,10,29,21,1484,1409,808,-601
2016,10,29,22,1485,1410,788,-622
2016,10,29,23,1493,1409,871,-538
2016,10,30,0,1524,1439,910,-529
2016,10,30,1,1558,1477,984,-493
2016,10,30,2,1583,1520,1006,-514
2016,10,30,3,1550,1489,968,-521
2016,10,30,4,1494,1442,916,-526
2016,10,30,5,1413,1364,892,-472
2016,10,30,6,1322,1284,832,-452
2016,10,30,7,1233,1213,757,-456
2016,10,30,8,1196,1181,693,-488
2016,10,30,9,1184,1180,594,-586
2016,10,30,10,1180,1182,606,-576
2016,10,30,11,1188,1182,627,-555
2016,10,30,12,1222,1216,616,-600
2016,10,30,13,1291,1267,656,-611
2016,10,30,14,1378,1364,664,-700
2016,10,30,15,1445,1438,749,-689
2016,10,30,16,1479,1491,771,-720
2016,10,30,17,1488,1522,859,-663
2016,10,30,18,1473,1529,895,-634
2016,10,30,19,1460,1532,901,-631
2016,10,30,20,1436,1531,909,-622
2016,10,30,21,1428,1518,858,-660
2016,10,30,22,1430,1517,843,-674
2016,10,30,23,1437,1530,844,-686
2016,10,31,0,1462,1573,859,-714
2016,10,31,1,1500,1607,890,-717
2016,10,31,2,1552,1642,913,-729
2016,10,31,3,1537,1604,923,-681
2016,10,31,4,1479,1520,802,-718
2016,10,31,5,1374,1414,776,-638
2016,10,31,6,1270,1296,801,-495
2016,10,31,7,1197,1226,765,-461
2016,10,31,8,1176,1198,719,-479
2016,10,31,9,1203,1172,729,-443
2016,10,31,10,1210,1200,737,-463
2016,10,31,11,1239,1227,694,-533
2016,10,31,12,1324,1321,740,-581
2016,10,31,13,1500,1524,833,-691
2016,10,31,14,1657,1684,777,-907
2016,10,31,15,1725,1709,743,-966
2016,10,31,16,1727,1669,629,-1040
2016,10,31,17,1726,1629,590,-1039
2016,10,31,18,1712,1624,620,-1004
2016,10,31,19,1686,1583,591,-992
2016,10,31,20,1660,1571,525,-1046
2016,10,31,21,1636,1553,535,-1018
2016,10,31,22,1614,1540,585,-955
2016,10,31,23,1611,1545,576,-969
2016,11,1,0,1627,1548,611,-937
2016,11,1,1,1673,1580,643,-937
2016,11,1,2,1718,1599,685,-914
2016,11,1,3,1694,1596,673,-923
2016,11,1,4,1625,1566,755,-811
2016,11,1,5,1510,1473,700,-773
2016,11,1,6,1396,1353,712,-641
2016,11,1,7,1299,1284,702,-582
2016,11,1,8,1286,1258,609,-649
2016,11,1,9,1258,1241,554,-687
2016,11,1,10,1261,1244,526,-718
2016,11,1,11,1287,1284,563,-721
2016,11,1,12,1371,1372,604,-768
2016,11,1,13,1550,1555,717,-838
2016,11,1,14,1704,1723,716,-1007
2016,11,1,15,1720,1735,704,-1031
2016,11,1,16,1715,1707,737,-970
2016,11,1,17,1711,1678,730,-948
2016,11,1,18,1693,1630,629,-1001
2016,11,1,19,1660,1590,592,-998
2016,11,1,20,1629,1561,554,-1007
2016,11,1,21,1602,1535,554,-981
2016,11,1,22,1578,1529,568,-961
2016,11,1,23,1578,1531,621,-910
2016,11,2,0,1587,1567,629,-938
2016,11,2,1,1626,1662,726,-936
2016,11,2,2,1662,1731,803,-928
2016,11,2,3,1647,1720,812,-908
2016,11,2,4,1604,1654,758,-896
2016,11,2,5,1503,1530,736,-794
2016,11,2,6,1393,1401,814,-587
2016,11,2,7,1346,1344,686,-658
2016,11,2,8,1306,1329,590,-739
2016,11,2,9,1323,1321,595,-726
2016,11,2,10,1326,1328,595,-733
2016,11,2,11,1358,1370,616,-754
2016,11,2,12,1453,1473,665,-808
2016,11,2,13,1644,1676,853,-823
2016,11,2,14,1803,1838,1013,-825
2016,11,2,15,1821,1847,1064,-783
2016,11,2,16,1802,1767,1021,-746
2016,11,2,17,1761,1684,996,-688
2016,11,2,18,1722,1638,974,-664
2016,11,2,19,1675,1578,948,-630
2016,11,2,20,1638,1552,993,-559
2016,11,2,21,1614,1535,876,-659
2016,11,2,22,1601,1503,803,-700
2016,11,2,23,1604,1504,804,-700
2016,11,3,0,1621,1556,852,-704
2016,11,3,1,1673,1627,959,-668
2016,11,3,2,1719,1695,1042,-653
2016,11,3,3,1693,1648,991,-657
2016,11,3,4,1631,1596,942,-654
2016,11,3,5,1514,1498,879,-619
2016,11,3,6,1400,1387,807,-580
2016,11,3,7,1310,1319,918,-401
2016,11,3,8,1312,1283,931,-352
2016,11,3,9,1305,1274,962,-312
2016,11,3,10,1309,1288,881,-407
2016,11,3,11,1346,1321,861,-460
2016,11,3,12,1445,1435,928,-507
2016,11,3,13,1648,1631,1055,-576
2016,11,3,14,1815,1801,1055,-746
2016,11,3,15,1831,1814,1096,-718
2016,11,3,16,1794,1741,1021,-720
2016,11,3,17,1750,1665,931,-734
2016,11,3,18,1707,1613,820,-793
2016,11,3,19,1655,1564,859,-705
2016,11,3,20,1619,1539,818,-721
2016,11,3,21,1596,1509,791,-718
2016,11,3,22,1584,1480,752,-728
2016,11,3,23,1595,1476,710,-766
2016,11,4,0,1619,1515,759,-756
2016,11,4,1,1670,1612,851,-761
2016,11,4,2,1717,1689,906,-783
2016,11,4,3,1678,1653,902,-751
2016,11,4,4,1615,1591,908,-683
2016,11,4,5,1504,1483,793,-690
2016,11,4,6,1391,1381,690,-691
2016,11,4,7,1330,1320,686,-634
2016,11,4,8,1305,1298,744,-554
2016,11,4,9,1309,1301,739,-562
2016,11,4,10,1318,1304,730,-574
2016,11,4,11,1353,1348,744,-604
2016,11,4,12,1454,1448,799,-649
2016,11,4,13,1646,1640,881,-759
2016,11,4,14,1804,1805,946,-859
2016,11,4,15,1814,1842,974,-868
2016,11,4,16,1761,1776,932,-844
2016,11,4,17,1709,1698,862,-836
2016,11,4,18,1670,1632,783,-849
2016,11,4,19,1627,1586,665,-921
2016,11,4,20,1601,1543,642,-901
2016,11,4,21,1584,1514,678,-836
2016,11,4,22,1578,1474,648,-826
2016,11,4,23,1588,1467,664,-803
2016,11,5,0,1571,1495,636,-859
2016,11,5,1,1606,1561,694,-867
2016,11,5,2,1640,1615,770,-845
2016,11,5,3,1601,1587,814,-773
2016,11,5,4,1552,1545,797,-748
2016,11,5,5,1480,1475,770,-705
2016,11,5,6,1388,1400,762,-638
2016,11,5,7,1313,1330,642,-688
2016,11,5,8,1293,1318,612,-706
2016,11,5,9,1310,1298,600,-698
2016,11,5,10,1302,1313,599,-714
2016,11,5,11,1318,1327,628,-699
2016,11,5,12,1372,1386,664,-722
2016,11,5,13,1464,1478,781,-697
2016,11,5,14,1566,1596,873,-723
2016,11,5,15,1633,1685,911,-774
2016,11,5,16,1635,1678,874,-804
2016,11,5,17,1612,1625,783,-842
2016,11,5,18,1579,1572,721,-851
2016,11,5,19,1538,1517,690,-827
2016,11,5,20,1506,1468,660,-808
2016,11,5,21,1480,1427,605,-822
2016,11,5,22,1479,1403,598,-805
2016,11,5,23,1485,1404,656,-748
2016,11,6,0,1516,1455,742,-713
2016,11,6,1,1570,1525,822,-703
2016,11,6,2,1614,1584,864,-720
2016,11,6,3,1582,1539,923,-616
2016,11,6,4,1532,1504,924,-580
2016,11,6,5,1453,1427,828,-599
2016,11,6,6,1363,1347,842,-505
2016,11,6,7,1270,1283,780,-503
2016,11,6,8,1240,1236,642,-595
2016,11,6,9,1260,1236,642,-594
2016,11,6,10,1268,1229,601,-628
2016,11,6,11,1309,1236,625,-611
2016,11,6,12,1382,1247,634,-613
2016,11,6,13,1464,1309,690,-619
2016,11,6,14,1527,1383,784,-599
2016,11,6,15,1516,1482,820,-662
2016,11,6,16,1496,1534,755,-779
2016,11,6,17,1482,1528,714,-814
2016,11,6,18,1481,1505,705,-800
2016,11,6,19,1468,1460,661,-799
2016,11,6,20,1456,1431,571,-860
2016,11,6,21,1452,1412,545,-867
2016,11,6,22,1451,1396,548,-848
2016,11,6,23,1483,1395,533,-862
2016,11,7,0,1555,1448,589,-859
2016,11,7,1,1622,1572,671,-901
2016,11,7,2,1606,1642,745,-897
2016,11,7,3,1547,1604,724,-880
2016,11,7,4,1450,1561,697,-864
2016,11,7,5,1347,1490,624,-866
2016,11,7,6,1264,1386,507,-879
2016,11,7,7,1232,1294,544,-750
2016,11,7,8,1232,1258,537,-721
2016,11,7,9,1232,1239,546,-693
2016,11,7,10,1239,1252,540,-712
2016,11,7,11,1249,1267,570,-697
2016,11,7,12,1280,1321,623,-698
2016,11,7,13,1381,1432,725,-707
2016,11,7,14,1569,1646,942,-704
2016,11,7,15,1728,1788,999,-789
2016,11,7,16,1777,1739,908,-831
2016,11,7,17,1716,1704,876,-828
2016,11,7,18,1671,1672,874,-798
2016,11,7,19,1644,1630,704,-926
2016,11,7,20,1619,1568,689,-879
2016,11,7,21,1604,1548,653,-895
2016,11,7,22,1592,1525,650,-875
2016,11,7,23,1582,1501,618,-883
2016,11,8,0,1580,1545,791,-754
2016,11,8,1,1592,1658,737,-921
2016,11,8,2,1654,1741,790,-951
2016,11,8,3,1719,1701,800,-901
2016,11,8,4,1693,1656,738,-918
2016,11,8,5,1626,1573,673,-900
2016,11,8,6,1516,1454,652,-802
2016,11,8,7,1407,1353,605,-748
2016,11,8,8,1325,1300,572,-728
2016,11,8,9,1308,1282,731,-551
2016,11,8,10,1291,1279,739,-540
2016,11,8,11,1299,1289,705,-584
2016,11,8,12,1336,1340,779,-561
2016,11,8,13,1435,1440,895,-545
2016,11,8,14,1617,1648,1093,-555
2016,11,8,15,1751,1768,1192,-576
2016,11,8,16,1741,1692,1168,-524
2016,11,8,17,1694,1616,1091,-525
2016,11,8,18,1662,1569,1034,-535
2016,11,8,19,1638,1527,1016,-511
2016,11,8,20,1611,1503,987,-516
2016,11,8,21,1605,1479,962,-517
2016,11,8,22,1607,1462,920,-542
2016,11,8,23,1614,1460,914,-546
2016,11,9,0,1627,1497,953,-544
2016,11,9,1,1666,1592,944,-648
2016,11,9,2,1721,1663,969,-694
2016,11,9,3,1734,1633,961,-672
2016,11,9,4,1688,1585,917,-668
2016,11,9,5,1602,1512,889,-623
2016,11,9,6,1480,1418,831,-587
2016,11,9,7,1372,1315,920,-395
2016,11,9,8,1317,1264,887,-377
2016,11,9,9,1285,1243,812,-431
2016,11,9,10,1265,1229,783,-446
2016,11,9,11,1276,1247,791,-456
2016,11,9,12,1319,1294,831,-463
2016,11,9,13,1428,1399,922,-477
2016,11,9,14,1624,1594,1027,-567
2016,11,9,15,1750,1718,944,-774
2016,11,9,16,1722,1674,851,-823
2016,11,9,17,1670,1591,788,-803
2016,11,9,18,1640,1562,750,-812
2016,11,9,19,1614,1526,757,-769
2016,11,9,20,1587,1503,809,-694
2016,11,9,21,1570,1473,831,-642
2016,11,9,22,1561,1465,853,-612
2016,11,9,23,1562,1458,853,-605
2016,11,10,0,1576,1509,864,-645
2016,11,10,1,1634,1605,831,-774
2016,11,10,2,1696,1685,886,-799
2016,11,10,3,1689,1652,883,-769
2016,11,10,4,1646,1611,874,-737
2016,11,10,5,1567,1534,869,-665
2016,11,10,6,1460,1421,819,-602
2016,11,10,7,1365,1323,800,-523
2016,11,10,8,1313,1270,675,-595
2016,11,10,9,1292,1261,671,-590
2016,11,10,10,1259,1254,682,-572
2016,11,10,11,1267,1263,678,-585
2016,11,10,12,1307,1312,712,-600
2016,11,10,13,1410,1420,720,-700
2016,11,10,14,1609,1625,830,-795
2016,11,10,15,1733,1759,966,-793
2016,11,10,16,1704,1711,970,-741
2016,11,10,17,1649,1654,876,-778
2016,11,10,18,1619,1605,841,-764
2016,11,10,19,1594,1568,778,-790
2016,11,10,20,1565,1529,771,-758
2016,11,10,21,1555,1516,773,-743
2016,11,10,22,1540,1500,762,-738
2016,11,10,23,1539,1329,588,-741
2016,11,11,0,1548,1531,820,-711
2016,11,11,1,1612,1620,844,-776
2016,11,11,2,1686,1684,910,-774
2016,11,11,3,1674,1657,861,-796
2016,11,11,4,1629,1610,845,-765
2016,11,11,5,1546,1540,934,-606
2016,11,11,6,1437,1436,867,-569
2016,11,11,7,1344,1337,688,-649
2016,11,11,8,1308,1298,542,-756
2016,11,11,9,1281,1283,507,-776
2016,11,11,10,1278,1270,556,-714
2016,11,11,11,1286,1282,591,-691
2016,11,11,12,1323,1324,616,-708
2016,11,11,13,1434,1411,626,-785
2016,11,11,14,1628,1600,802,-798
2016,11,11,15,1744,1703,925,-778
2016,11,11,16,1712,1693,888,-805
2016,11,11,17,1660,1626,820,-806
2016,11,11,18,1638,1598,812,-786
2016,11,11,19,1610,1554,740,-814
2016,11,11,20,1583,1513,693,-820
2016,11,11,21,1578,1483,681,-802
2016,11,11,22,1572,1466,695,-771
2016,11,11,23,1577,1450,696,-754
2016,11,12,0,1585,1502,713,-789
2016,11,12,1,1598,1589,753,-836
2016,11,12,2,1641,1636,855,-781
2016,11,12,3,1614,1595,890,-705
2016,11,12,4,1568,1546,849,-697
2016,11,12,5,1505,1497,886,-611
2016,11,12,6,1430,1423,831,-592
2016,11,12,7,1354,1341,813,-528
2016,11,12,8,1287,1285,836,-449
2016,11,12,9,1269,1255,821,-434
2016,11,12,10,1258,1234,798,-436
2016,11,12,11,1250,1244,809,-435
2016,11,12,12,1265,1272,833,-439
2016,11,12,13,1319,1328,864,-464
2016,11,12,14,1402,1415,920,-495
2016,11,12,15,1469,1513,895,-618
2016,11,12,16,1508,1578,917,-661
2016,11,12,17,1514,1598,932,-666
2016,11,12,18,1519,1572,832,-740
2016,11,12,19,1510,1527,752,-775
2016,11,12,20,1494,1495,723,-772
2016,11,12,21,1477,1450,709,-741
2016,11,12,22,1458,1415,683,-732
2016,11,12,23,1451,1401,666,-735
2016,11,13,0,1456,1456,753,-703
2016,11,13,1,1531,1564,794,-770
2016,11,13,2,1591,1605,844,-761
2016,11,13,3,1570,1562,889,-673
2016,11,13,4,1532,1530,873,-657
2016,11,13,5,1477,1487,756,-731
2016,11,13,6,1406,1411,683,-728
2016,11,13,7,1334,1335,694,-641
2016,11,13,8,1273,1282,649,-633
2016,11,13,9,1252,1264,559,-705
2016,11,13,10,1264,1257,542,-715
2016,11,13,11,1271,1256,541,-715
2016,11,13,12,1291,1283,537,-746
2016,11,13,13,1338,1330,593,-737
2016,11,13,14,1413,1409,615,-794
2016,11,13,15,1480,1503,678,-825
2016,11,13,16,1531,1547,712,-835
2016,11,13,17,1542,1512,689,-823
2016,11,13,18,1529,1484,628,-856
2016,11,13,19,1496,1459,631,-828
2016,11,13,20,1474,1447,635,-812
2016,11,13,21,1449,1432,590,-842
2016,11,13,22,1430,1431,552,-879
2016,11,13,23,1425,1451,644,-807
2016,11,14,0,1445,1504,701,-803
2016,11,14,1,1540,1615,824,-791
2016,11,14,2,1602,1669,855,-814
2016,11,14,3,1589,1633,833,-800
2016,11,14,4,1567,1595,790,-805
2016,11,14,5,1506,1515,683,-832
2016,11,14,6,1409,1421,712,-709
2016,11,14,7,1313,1317,661,-656
2016,11,14,8,1234,1267,594,-673
2016,11,14,9,1231,1235,579,-656
2016,11,14,10,1244,1221,606,-615
2016,11,14,11,1257,1249,659,-590
2016,11,14,12,1297,1277,683,-594
2016,11,14,13,1398,1391,752,-639
2016,11,14,14,1582,1594,778,-816
2016,11,14,15,1718,1732,885,-847
2016,11,14,16,1731,1722,871,-851
2016,11,14,17,1696,1681,825,-856
2016,11,14,18,1674,1670,810,-860
2016,11,14,19,1657,1642,764,-878
2016,11,14,20,1636,1606,741,-865
2016,11,14,21,1621,1601,739,-862
2016,11,14,22,1607,1576,730,-846
2016,11,14,23,1598,1586,747,-839
2016,11,15,0,1619,1624,841,-783
2016,11,15,1,1702,1734,902,-832
2016,11,15,2,1760,1769,952,-817
2016,11,15,3,1729,1719,899,-820
2016,11,15,4,1683,1677,887,-790
2016,11,15,5,1602,1590,773,-817
2016,11,15,6,1487,1459,650,-809
2016,11,15,7,1384,1366,753,-613
2016,11,15,8,1308,1292,758,-534
2016,11,15,9,1299,1273,733,-540
2016,11,15,10,1272,1260,732,-528
2016,11,15,11,1278,1267,744,-523
2016,11,15,12,1314,1298,673,-625
2016,11,15,13,1411,1403,712,-691
2016,11,15,14,1591,1597,816,-781
2016,11,15,15,1723,1715,815,-900
2016,11,15,16,1715,1695,810,-885
2016,11,15,17,1687,1667,859,-808
2016,11,15,18,1673,1636,910,-726
2016,11,15,19,1654,1617,896,-721
2016,11,15,20,1629,1601,919,-682
2016,11,15,21,1610,1572,830,-742
2016,11,15,22,1593,1571,784,-787
2016,11,15,23,1583,1568,872,-696
2016,11,16,0,1610,1608,879,-729
2016,11,16,1,1709,1718,868,-850
2016,11,16,2,1761,1749,970,-779
2016,11,16,3,1728,1725,963,-762
2016,11,16,4,1683,1671,913,-758
2016,11,16,5,1600,1585,1024,-561
2016,11,16,6,1480,1462,1033,-429
2016,11,16,7,1376,1350,1037,-313
2016,11,16,8,1336,1296,973,-323
2016,11,16,9,1303,1270,1030,-240
2016,11,16,10,1290,1266,1005,-261
2016,11,16,11,1302,1273,999,-274
2016,11,16,12,1350,1307,988,-319
2016,11,16,13,1464,1435,1057,-378
2016,11,16,14,1668,1636,1061,-575
2016,11,16,15,1815,1781,1096,-685
2016,11,16,16,1824,1758,1073,-685
2016,11,16,17,1807,1704,997,-707
2016,11,16,18,1790,1648,953,-695
2016,11,16,19,1760,1621,936,-685
2016,11,16,20,1717,1645,978,-667
2016,11,16,21,1678,1635,1030,-605
2016,11,16,22,1645,1626,1022,-604
2016,11,16,23,1629,1614,1035,-579
2016,11,17,0,1662,1700,1090,-610
2016,11,17,1,1781,1834,1195,-639
2016,11,17,2,1848,1912,1218,-694
2016,11,17,3,1830,1890,1144,-746
2016,11,17,4,1796,1861,1136,-725
2016,11,17,5,1716,1778,1081,-697
2016,11,17,6,1596,1645,1041,-604
2016,11,17,7,1492,1535,998,-537
2016,11,17,8,1444,1474,977,-497
2016,11,17,9,1457,1453,962,-491
2016,11,17,10,1490,1453,935,-518
2016,11,17,11,1504,1475,932,-543
2016,11,17,12,1554,1517,968,-549
2016,11,17,13,1680,1638,1007,-631
2016,11,17,14,1904,1848,1062,-786
2016,11,17,15,2064,1986,1112,-874
2016,11,17,16,2051,1936,1026,-910
2016,11,17,17,1997,1840,950,-890
2016,11,17,18,1937,1790,962,-828
2016,11,17,19,1868,1700,873,-827
2016,11,17,20,1809,1686,875,-811
2016,11,17,21,1757,1650,870,-780
2016,11,17,22,1713,1629,902,-727
2016,11,17,23,1698,1623,886,-737
2016,11,18,0,1736,1692,938,-754
2016,11,18,1,1870,1844,1088,-756
2016,11,18,2,1954,1920,1149,-771
2016,11,18,3,1947,1913,1102,-811
2016,11,18,4,1922,1880,1031,-849
2016,11,18,5,1855,1823,935,-888
2016,11,18,6,1742,1692,830,-862
2016,11,18,7,1639,1606,629,-977
2016,11,18,8,1543,1547,626,-921
2016,11,18,9,1527,1534,646,-888
2016,11,18,10,1542,1526,718,-808
2016,11,18,11,1543,1556,694,-862
2016,11,18,12,1573,1603,709,-894
2016,11,18,13,1691,1722,780,-942
2016,11,18,14,1901,1903,857,-1046
2016,11,18,15,2045,2025,1151,-874
2016,11,18,16,2014,2010,1213,-797
2016,11,18,17,1910,1972,1213,-759
2016,11,18,18,1837,1918,1217,-701
2016,11,18,19,1786,1823,1168,-655
2016,11,18,20,1737,1754,1145,-609
2016,11,18,21,1698,1713,1203,-510
2016,11,18,22,1666,1710,1279,-431
2016,11,18,23,1659,1727,1252,-475
2016,11,19,0,1702,1790,1224,-566
2016,11,19,1,1766,1890,1198,-692
2016,11,19,2,1811,1892,1216,-676
2016,11,19,3,1771,1846,1187,-659
2016,11,19,4,1718,1788,1267,-521
2016,11,19,5,1650,1727,1243,-484
2016,11,19,6,1567,1638,1239,-399
2016,11,19,7,1491,1540,1258,-282
2016,11,19,8,1424,1472,1235,-237
2016,11,19,9,1428,1433,1175,-258
2016,11,19,10,1481,1416,1091,-325
2016,11,19,11,1477,1415,1065,-350
2016,11,19,12,1492,1444,1062,-382
2016,11,19,13,1555,1497,1065,-432
2016,11,19,14,1634,1579,1112,-467
2016,11,19,15,1716,1680,1171,-509
2016,11,19,16,1756,1741,1240,-501
2016,11,19,17,1738,1768,1269,-499
2016,11,19,18,1699,1767,1291,-476
2016,11,19,19,1670,1714,1287,-427
2016,11,19,20,1640,1673,1240,-433
2016,11,19,21,1609,1643,1227,-416
2016,11,19,22,1589,1608,1184,-424
2016,11,19,23,1601,1605,1166,-439
2016,11,20,0,1643,1626,1154,-472
2016,11,20,1,1757,1735,1208,-527
2016,11,20,2,1790,1773,1162,-611
2016,11,20,3,1752,1726,1028,-698
2016,11,20,4,1697,1684,989,-695
2016,11,20,5,1627,1629,910,-719
2016,11,20,6,1543,1538,804,-734
2016,11,20,7,1466,1447,706,-741
2016,11,20,8,1353,1384,682,-702
2016,11,20,9,1380,1351,652,-699
2016,11,20,10,1370,1340,634,-706
2016,11,20,11,1368,1337,654,-683
2016,11,20,12,1382,1354,714,-640
2016,11,20,13,1425,1405,800,-605
2016,11,20,14,1489,1465,831,-634
2016,11,20,15,1558,1555,1006,-549
2016,11,20,16,1598,1613,1004,-609
2016,11,20,17,1616,1653,1039,-614
2016,11,20,18,1611,1650,1045,-605
2016,11,20,19,1598,1621,976,-645
2016,11,20,20,1596,1593,954,-639
2016,11,20,21,1581,1563,949,-614
2016,11,20,22,1578,1547,882,-665
2016,11,20,23,1589,1557,791,-766
2016,11,21,0,1639,1617,799,-818
2016,11,21,1,1755,1725,876,-849
2016,11,21,2,1785,1755,807,-948
2016,11,21,3,1752,1713,731,-982
2016,11,21,4,1717,1677,694,-983
2016,11,21,5,1642,1603,786,-817
2016,11,21,6,1527,1497,876,-621
2016,11,21,7,1423,1386,931,-455
2016,11,21,8,1357,1339,865,-474
2016,11,21,9,1350,1322,812,-510
2016,11,21,10,1360,1305,784,-521
2016,11,21,11,1369,1329,746,-583
2016,11,21,12,1410,1374,717,-657
2016,11,21,13,1523,1480,743,-737
2016,11,21,14,1725,1663,793,-870
2016,11,21,15,1878,1789,794,-995
2016,11,21,16,1900,1809,780,-1029
2016,11,21,17,1864,1780,797,-983
2016,11,21,18,1856,1751,817,-934
2016,11,21,19,1836,1739,794,-945
2016,11,21,20,1804,1701,794,-907
2016,11,21,21,1776,1670,817,-853
2016,11,21,22,1754,1642,883,-759
2016,11,21,23,1746,1652,923,-729
2016,11,22,0,1783,1683,913,-770
2016,11,22,1,1893,1822,1033,-789
2016,11,22,2,1932,1912,1138,-774
2016,11,22,3,1906,1867,1118,-749
2016,11,22,4,1866,1839,1100,-739
2016,11,22,5,1787,1773,1122,-651
2016,11,22,6,1666,1668,1109,-559
2016,11,22,7,1560,1547,1079,-468
2016,11,22,8,1502,1491,984,-507
2016,11,22,9,1484,1467,929,-538
2016,11,22,10,1495,1461,852,-609
2016,11,22,11,1500,1473,853,-620
2016,11,22,12,1534,1513,859,-654
2016,11,22,13,1641,1629,755,-874
2016,11,22,14,1833,1786,841,-945
2016,11,22,15,1972,1939,871,-1068
2016,11,22,16,1969,1922,850,-1072
2016,11,22,17,1922,1864,845,-1019
2016,11,22,18,1885,1817,884,-933
2016,11,22,19,1851,1748,904,-844
2016,11,22,20,1813,1697,874,-823
2016,11,22,21,1776,1663,835,-828
2016,11,22,22,1749,1649,822,-827
2016,11,22,23,1745,1652,867,-785
2016,11,23,0,1776,1710,907,-803
2016,11,23,1,1898,1836,996,-840
2016,11,23,2,1951,1882,1069,-813
2016,11,23,3,1919,1857,1081,-776
2016,11,23,4,1873,1817,1093,-724
2016,11,23,5,1786,1740,1024,-716
2016,11,23,6,1663,1630,1020,-610
2016,11,23,7,1552,1525,1146,-379
2016,11,23,8,1472,1446,1165,-281
2016,11,23,9,1428,1402,1062,-340
2016,11,23,10,1425,1393,1009,-384
2016,11,23,11,1418,1386,993,-393
2016,11,23,12,1448,1408,943,-465
2016,11,23,13,1546,1488,963,-525
2016,11,23,14,1715,1643,959,-684
2016,11,23,15,1840,1762,877,-885
2016,11,23,16,1839,1802,820,-982
2016,11,23,17,1819,1812,877,-935
2016,11,23,18,1806,1808,839,-969
2016,11,23,19,1804,1755,781,-974
2016,11,23,20,1795,1730,761,-969
2016,11,23,21,1778,1707,754,-953
2016,11,23,22,1768,1685,773,-912
2016,11,23,23,1775,1654,835,-819
2016,11,24,0,1818,1711,906,-805
2016,11,24,1,1943,1830,1005,-825
2016,11,24,2,1993,1879,1023,-856
2016,11,24,3,1962,1847,1003,-844
2016,11,24,4,1928,1813,966,-847
2016,11,24,5,1853,1759,968,-791
2016,11,24,6,1742,1662,915,-747
2016,11,24,7,1635,1568,921,-647
2016,11,24,8,1554,1496,884,-612
2016,11,24,9,1533,1450,770,-680
2016,11,24,10,1507,1444,744,-700
2016,11,24,11,1512,1453,689,-764
2016,11,24,12,1548,1468,674,-794
2016,11,24,13,1650,1542,633,-909
2016,11,24,14,1811,1620,673,-947
2016,11,24,15,1932,1731,780,-951
2016,11,24,16,1939,1791,855,-936
2016,11,24,17,1903,1834,942,-892
2016,11,24,18,1870,1846,967,-879
2016,11,24,19,1825,1811,979,-832
2016,11,24,20,1783,1738,959,-779
2016,11,24,21,1740,1636,1017,-619
2016,11,24,22,1710,1580,1062,-518
2016,11,24,23,1702,1532,1039,-493
2016,11,25,0,1740,1534,1139,-395
2016,11,25,1,1863,1593,1150,-443
2016,11,25,2,1902,1620,1166,-454
2016,11,25,3,1863,1622,1170,-452
2016,11,25,4,1815,1617,1288,-329
2016,11,25,5,1733,1590,1305,-285
2016,11,25,6,1624,1526,1290,-236
2016,11,25,7,1524,1466,1251,-215
2016,11,25,8,1465,1413,1242,-171
2016,11,25,9,1430,1392,1091,-301
2016,11,25,10,1403,1376,1057,-319
2016,11,25,11,1402,1394,1055,-339
2016,11,25,12,1431,1416,1063,-353
2016,11,25,13,1508,1485,1082,-403
2016,11,25,14,1624,1570,1092,-478
2016,11,25,15,1730,1656,1149,-507
2016,11,25,16,1768,1700,1207,-493
2016,11,25,17,1786,1732,1250,-482
2016,11,25,18,1787,1709,1151,-558
2016,11,25,19,1768,1666,1023,-643
2016,11,25,20,1728,1631,1009,-622
2016,11,25,21,1676,1572,939,-633
2016,11,25,22,1633,1551,924,-627
2016,11,25,23,1609,1562,960,-602
2016,11,26,0,1630,1602,1037,-565
2016,11,26,1,1697,1725,1083,-642
2016,11,26,2,1709,1737,1088,-649
2016,11,26,3,1677,1705,1028,-677
2016,11,26,4,1647,1672,994,-678
2016,11,26,5,1610,1619,996,-623
2016,11,26,6,1563,1543,936,-607
2016,11,26,7,1494,1459,900,-559
2016,11,26,8,1437,1398,918,-480
2016,11,26,9,1421,1369,979,-390
2016,11,26,10,1386,1358,998,-360
2016,11,26,11,1376,1379,1026,-353
2016,11,26,12,1391,1409,1048,-361
2016,11,26,13,1418,1466,1111,-355
2016,11,26,14,1426,1545,1163,-382
2016,11,26,15,1487,1658,1103,-555
2016,11,26,16,1594,1724,1103,-621
2016,11,26,17,1659,1748,1111,-637
2016,11,26,18,1664,1723,1170,-553
2016,11,26,19,1634,1668,1140,-528
2016,11,26,20,1591,1615,1160,-455
2016,11,26,21,1532,1550,1225,-325
2016,11,26,22,1491,1546,1216,-330
2016,11,26,23,1481,1545,1242,-303
2016,11,27,0,1512,1610,1265,-345
2016,11,27,1,1620,1725,1174,-551
2016,11,27,2,1646,1742,1130,-612
2016,11,27,3,1628,1709,1052,-657
2016,11,27,4,1610,1685,1022,-663
2016,11,27,5,1575,1634,1016,-618
2016,11,27,6,1522,1546,947,-599
2016,11,27,7,1454,1454,931,-523
2016,11,27,8,1414,1379,881,-498
2016,11,27,9,1371,1349,784,-565
2016,11,27,10,1380,1331,748,-583
2016,11,27,11,1379,1337,755,-582
2016,11,27,12,1392,1350,800,-550
2016,11,27,13,1425,1397,818,-579
2016,11,27,14,1452,1473,949,-524
2016,11,27,15,1519,1574,1027,-547
2016,11,27,16,1610,1633,1184,-449
2016,11,27,17,1676,1659,1264,-395
2016,11,27,18,1698,1679,1287,-392
2016,11,27,19,1679,1658,1261,-397
2016,11,27,20,1660,1642,1240,-402
2016,11,27,21,1617,1597,1140,-457
2016,11,27,22,1591,1600,1072,-528
2016,11,27,23,1594,1635,1061,-574
2016,11,28,0,1643,1723,1108,-615
2016,11,28,1,1764,1862,1078,-784
2016,11,28,2,1794,1894,1077,-817
2016,11,28,3,1779,1866,1015,-851
2016,11,28,4,1765,1829,997,-832
2016,11,28,5,1710,1740,971,-769
2016,11,28,6,1617,1619,870,-749
2016,11,28,7,1517,1519,848,-671
2016,11,28,8,1437,1460,799,-661
2016,11,28,9,1415,1431,781,-650
2016,11,28,10,1447,1428,805,-623
2016,11,28,11,1456,1440,787,-653
2016,11,28,12,1489,1491,784,-707
2016,11,28,13,1587,1595,782,-813
2016,11,28,14,1759,1797,986,-811
2016,11,28,15,1891,1952,1051,-901
2016,11,28,16,1920,1947,1138,-809
2016,11,28,17,1924,1877,1242,-635
2016,11,28,18,1918,1855,1186,-669
2016,11,28,19,1896,1836,1115,-721
2016,11,28,20,1860,1831,1132,-699
2016,11,28,21,1820,1805,1139,-666
2016,11,28,22,1789,1793,1125,-668
2016,11,28,23,1788,1773,1100,-673
2016,11,29,0,1839,1899,1209,-690
2016,11,29,1,1961,1987,1172,-815
2016,11,29,2,2001,2052,1206,-846
2016,11,29,3,1980,2017,1163,-854
2016,11,29,4,1949,1975,1118,-857
2016,11,29,5,1874,1879,1069,-810
2016,11,29,6,1755,1744,983,-761
2016,11,29,7,1643,1621,914,-707
2016,11,29,8,1550,1551,892,-659
2016,11,29,9,1516,1517,842,-675
2016,11,29,10,1500,1501,797,-704
2016,11,29,11,1508,1508,798,-710
2016,11,29,12,1543,1550,761,-789
2016,11,29,13,1643,1662,838,-824
2016,11,29,14,1807,1862,958,-904
2016,11,29,15,1940,1992,985,-1007
2016,11,29,16,1965,1966,949,-1017
2016,11,29,17,1967,1877,873,-1004
2016,11,29,18,1944,1817,804,-1013
2016,11,29,19,1906,1780,771,-1009
2016,11,29,20,1858,1739,749,-990
2016,11,29,21,1810,1695,723,-972
2016,11,29,22,1775,1137,344,-793
2016,11,29,23,1770,1672,895,-777
2016,11,30,0,1819,1750,976,-774
2016,11,30,1,1947,1916,1110,-806
2016,11,30,2,1994,2001,1092,-909
2016,11,30,3,1983,1976,1063,-913
2016,11,30,4,1959,1944,1028,-916
2016,11,30,5,1886,1862,900,-962
2016,11,30,6,1771,1750,749,-1001
2016,11,30,7,1654,1622,687,-935
2016,11,30,8,1569,1501,653,-848
2016,11,30,9,1587,1532,614,-918
2016,11,30,10,1549,1524,590,-934
2016,11,30,11,1556,1523,641,-882
2016,11,30,12,1593,1555,673,-882
2016,11,30,13,1704,1669,738,-931
2016,11,30,14,1887,1876,792,-1084
2016,11,30,15,2020,2013,757,-1256
2016,11,30,16,2025,1989,760,-1229
2016,11,30,17,1982,1974,819,-1155
2016,11,30,18,1938,1934,813,-1121
2016,11,30,19,1885,1903,825,-1078
2016,11,30,20,1841,1856,822,-1034
2016,11,30,21,1796,1849,758,-1091
2016,11,30,22,1761,1832,717,-1115
2016,11,30,23,1778,1839,789,-1050
2016,12,1,0,1837,1925,768,-1157
2016,12,1,1,1998,2037,794,-1243
2016,12,1,2,2055,2065,806,-1259
2016,12,1,3,2027,2032,792,-1240
2016,12,1,4,1986,1984,814,-1170
2016,12,1,5,1899,1900,941,-959
2016,12,1,6,1770,1770,934,-836
2016,12,1,7,1657,1614,1063,-551
2016,12,1,8,1597,1549,1043,-506
2016,12,1,9,1587,1512,1014,-498
2016,12,1,10,1568,1499,1005,-494
2016,12,1,11,1583,1516,957,-559
2016,12,1,12,1625,1558,886,-672
2016,12,1,13,1748,1677,802,-875
2016,12,1,14,1945,1874,865,-1009
2016,12,1,15,2089,2018,964,-1054
2016,12,1,16,2086,2001,886,-1115
2016,12,1,17,2056,1947,869,-1078
2016,12,1,18,2030,1904,846,-1058
2016,12,1,19,1986,1866,879,-987
2016,12,1,20,1938,1818,894,-924
2016,12,1,21,1894,1783,960,-823
2016,12,1,22,1857,1770,960,-810
2016,12,1,23,1861,1716,951,-765
2016,12,2,0,1927,1861,1003,-858
2016,12,2,1,2084,2015,1032,-983
2016,12,2,2,2147,2067,1075,-992
2016,12,2,3,2126,2041,976,-1065
2016,12,2,4,2089,2018,971,-1047
2016,12,2,5,2000,1945,921,-1024
2016,12,2,6,1866,1817,882,-935
2016,12,2,7,1742,1693,794,-899
2016,12,2,8,1675,1631,811,-820
2016,12,2,9,1654,1616,667,-949
2016,12,2,10,1635,1612,652,-960
2016,12,2,11,1644,1626,529,-1097
2016,12,2,12,1688,1690,555,-1135
2016,12,2,13,1810,1792,601,-1191
2016,12,2,14,2015,2004,748,-1256
2016,12,2,15,2168,2141,893,-1248
2016,12,2,16,2157,2131,857,-1274
2016,12,2,17,2119,1991,790,-1201
2016,12,2,18,2081,1966,766,-1200
2016,12,2,19,2042,1885,685,-1200
2016,12,2,20,1989,1861,673,-1188
2016,12,2,21,1932,1698,678,-1020
2016,12,2,22,1889,1609,708,-901
2016,12,2,23,1862,1597,771,-826
2016,12,3,0,1953,1782,846,-936
2016,12,3,1,2068,2016,879,-1137
2016,12,3,2,2115,2021,910,-1111
2016,12,3,3,2090,1989,919,-1070
2016,12,3,4,2039,1959,904,-1055
2016,12,3,5,1963,1904,873,-1031
2016,12,3,6,1869,1814,836,-978
2016,12,3,7,1763,1683,857,-826
2016,12,3,8,1685,1605,758,-847
2016,12,3,9,1628,1556,662,-894
2016,12,3,10,1604,1544,643,-901
2016,12,3,11,1597,1544,623,-921
2016,12,3,12,1614,1549,621,-928
2016,12,3,13,1673,1613,620,-993
2016,12,3,14,1754,1696,646,-1050
2016,12,3,15,1852,1801,649,-1152
2016,12,3,16,1907,1871,630,-1241
2016,12,3,17,1895,1881,662,-1219
2016,12,3,18,1875,1785,609,-1176
2016,12,3,19,1812,1817,662,-1155
2016,12,3,20,1774,1772,663,-1109
2016,12,3,21,1684,1720,623,-1097
2016,12,3,22,1646,1509,609,-900
2016,12,3,23,1682,1548,679,-869
2016,12,4,0,1767,1715,791,-924
2016,12,4,1,1917,1883,829,-1054
2016,12,4,2,1950,1916,826,-1090
2016,12,4,3,1924,1895,787,-1108
2016,12,4,4,1890,1879,780,-1099
2016,12,4,5,1829,1813,797,-1016
2016,12,4,6,1741,1744,722,-1022
2016,12,4,7,1638,1639,704,-935
2016,12,4,8,1567,1567,671,-896
2016,12,4,9,1548,1528,629,-899
2016,12,4,10,1553,1507,588,-919
2016,12,4,11,1546,1494,577,-917
2016,12,4,12,1557,1502,599,-903
2016,12,4,13,1595,1554,622,-932
2016,12,4,14,1664,1613,648,-965
2016,12,4,15,1741,1696,758,-938
2016,12,4,16,1781,1776,782,-994
2016,12,4,17,1768,1811,780,-1031
2016,12,4,18,1756,1813,789,-1024
2016,12,4,19,1738,1812,779,-1033
2016,12,4,20,1721,1776,745,-1031
2016,12,4,21,1662,1784,687,-1097
2016,12,4,22,1641,1787,668,-1119
2016,12,4,23,1679,1799,714,-1085
2016,12,5,0,1771,1875,796,-1079
2016,12,5,1,1910,1966,1066,-900
2016,12,5,2,1930,1987,1124,-863
2016,12,5,3,1901,1962,1143,-819
2016,12,5,4,1873,1941,1155,-786
2016,12,5,5,1806,1889,1148,-741
2016,12,5,6,1709,1769,1179,-590
2016,12,5,7,1609,1650,1156,-494
2016,12,5,8,1541,1595,1161,-434
2016,12,5,9,1569,1579,1192,-387
2016,12,5,10,1625,1599,1155,-444
2016,12,5,11,1650,1618,1109,-509
2016,12,5,12,1704,1693,1021,-672
2016,12,5,13,1835,1830,999,-831
2016,12,5,14,2064,2056,1065,-991
2016,12,5,15,2239,2225,910,-1315
2016,12,5,16,2251,2203,773,-1430
2016,12,5,17,2206,2077,741,-1336
2016,12,5,18,2170,2010,704,-1306
2016,12,5,19,2138,1943,715,-1228
2016,12,5,20,2097,1829,681,-1148
2016,12,5,21,2044,1823,641,-1182
2016,12,5,22,2020,1801,632,-1169
2016,12,5,23,2036,1808,658,-1150
2016,12,6,0,2104,1902,724,-1178
2016,12,6,1,2258,2115,876,-1239
2016,12,6,2,2313,2207,969,-1238
2016,12,6,3,2290,2207,982,-1225
2016,12,6,4,2237,2174,949,-1225
2016,12,6,5,2140,2120,738,-1382
2016,12,6,6,1986,1986,671,-1315
2016,12,6,7,1858,1852,716,-1136
2016,12,6,8,1736,1787,783,-1004
2016,12,6,9,1761,1755,853,-902
2016,12,6,10,1765,1746,877,-869
2016,12,6,11,1766,1756,786,-970
2016,12,6,12,1797,1825,652,-1173
2016,12,6,13,1907,1941,718,-1223
2016,12,6,14,2111,2149,803,-1346
2016,12,6,15,2261,2286,851,-1435
2016,12,6,16,2254,2259,765,-1494
2016,12,6,17,2188,2226,718,-1508
2016,12,6,18,2145,2164,724,-1440
2016,12,6,19,2111,2147,677,-1470
2016,12,6,20,2063,2094,647,-1447
2016,12,6,21,2031,2069,651,-1418
2016,12,6,22,2006,2048,636,-1412
2016,12,6,23,2022,2038,655,-1383
2016,12,7,0,2102,2093,866,-1227
2016,12,7,1,2276,2262,931,-1331
2016,12,7,2,2328,2330,1005,-1325
2016,12,7,3,2298,2291,979,-1312
2016,12,7,4,2251,2277,920,-1357
2016,12,7,5,2162,2199,875,-1324
2016,12,7,6,2015,2042,820,-1222
2016,12,7,7,1886,1918,889,-1029
2016,12,7,8,1803,1834,929,-905
2016,12,7,9,1826,1815,914,-901
2016,12,7,10,1842,1820,795,-1025
2016,12,7,11,1849,1849,591,-1258
2016,12,7,12,1893,1909,625,-1284
2016,12,7,13,2019,2029,721,-1308
2016,12,7,14,2237,2239,838,-1401
2016,12,7,15,2394,2376,867,-1509
2016,12,7,16,2399,2351,845,-1506
2016,12,7,17,2337,2275,832,-1443
2016,12,7,18,2278,2183,812,-1371
2016,12,7,19,2236,2094,924,-1170
2016,12,7,20,2175,2031,909,-1122
2016,12,7,21,2135,2013,867,-1146
2016,12,7,22,2095,1934,905,-1029
2016,12,7,23,2098,1926,901,-1025
2016,12,8,0,2177,2077,988,-1089
2016,12,8,1,2364,2283,1079,-1204
2016,12,8,2,2440,2356,1191,-1165
2016,12,8,3,2417,2345,1199,-1146
2016,12,8,4,2370,2333,1215,-1118
2016,12,8,5,2267,2256,1087,-1169
2016,12,8,6,2111,2117,1017,-1100
2016,12,8,7,1976,1994,1062,-932
2016,12,8,8,1886,1926,1013,-913
2016,12,8,9,1928,1916,1078,-838
2016,12,8,10,1932,1925,1011,-914
2016,12,8,11,1939,1942,1061,-881
2016,12,8,12,1984,1980,1082,-898
2016,12,8,13,2105,2095,1173,-922
2016,12,8,14,2314,2296,1259,-1037
2016,12,8,15,2451,2438,1351,-1087
2016,12,8,16,2428,2417,1359,-1058
2016,12,8,17,2342,2380,1390,-990
2016,12,8,18,2268,2347,1377,-970
2016,12,8,19,2205,2313,1376,-937
2016,12,8,20,2134,2291,1357,-934
2016,12,8,21,2083,2266,1306,-960
2016,12,8,22,2036,2255,1314,-941
2016,12,8,23,2034,2259,1303,-956
2016,12,9,0,2123,2310,1379,-931
2016,12,9,1,2270,2434,1459,-975
2016,12,9,2,2302,2461,1485,-976
2016,12,9,3,2249,2415,1467,-948
2016,12,9,4,2180,2339,1357,-982
2016,12,9,5,2071,2224,1284,-940
2016,12,9,6,1907,2056,1149,-907
2016,12,9,7,1779,1912,1104,-808
2016,12,9,8,1704,1813,1010,-803
2016,12,9,9,1766,1776,870,-906
2016,12,9,10,1812,1749,816,-933
2016,12,9,11,1824,1760,779,-981
2016,12,9,12,1863,1783,713,-1070
2016,12,9,13,1958,1887,783,-1104
2016,12,9,14,2130,2059,978,-1081
2016,12,9,15,2236,2183,1134,-1049
2016,12,9,16,2195,2180,1138,-1042
2016,12,9,17,2110,2159,1042,-1117
2016,12,9,18,2041,2151,1042,-1109
2016,12,9,19,1992,2113,1004,-1109
2016,12,9,20,1946,2069,999,-1070
2016,12,9,21,1919,2055,963,-1092
2016,12,9,22,1897,2044,980,-1064
2016,12,9,23,1908,2053,931,-1122
2016,12,10,0,1986,2119,877,-1242
2016,12,10,1,2079,2214,1006,-1208
2016,12,10,2,2081,2174,1004,-1170
2016,12,10,3,2033,2139,973,-1166
2016,12,10,4,1980,2081,916,-1165
2016,12,10,5,1912,1997,847,-1150
2016,12,10,6,1816,1886,733,-1153
2016,12,10,7,1714,1780,736,-1044
2016,12,10,8,1618,1700,663,-1037
2016,12,10,9,1621,1656,640,-1016
2016,12,10,10,1662,1643,611,-1032
2016,12,10,11,1655,1626,594,-1032
2016,12,10,12,1669,1642,631,-1011
2016,12,10,13,1713,1688,712,-976
2016,12,10,14,1786,1769,746,-1023
2016,12,10,15,1871,1877,729,-1148
2016,12,10,16,1943,1951,754,-1197
2016,12,10,17,1968,1992,825,-1167
2016,12,10,18,1956,1993,848,-1145
2016,12,10,19,1942,1955,821,-1134
2016,12,10,20,1912,1920,779,-1141
2016,12,10,21,1892,1883,717,-1166
2016,12,10,22,1880,1868,725,-1143
2016,12,10,23,1891,1869,691,-1178
2016,12,11,0,1970,1930,734,-1196
2016,12,11,1,2110,2045,845,-1200
2016,12,11,2,2135,2060,873,-1187
2016,12,11,3,2110,2016,850,-1166
2016,12,11,4,2069,1981,827,-1154
2016,12,11,5,2013,1924,849,-1075
2016,12,11,6,1923,1840,845,-995
2016,12,11,7,1836,1724,860,-864
2016,12,11,8,1729,1654,813,-841
2016,12,11,9,1718,1626,819,-807
2016,12,11,10,1672,1601,863,-738
2016,12,11,11,1677,1611,894,-717
2016,12,11,12,1704,1638,821,-817
2016,12,11,13,1743,1697,798,-899
2016,12,11,14,1806,1782,747,-1035
2016,12,11,15,1885,1904,815,-1089
2016,12,11,16,1964,1985,862,-1123
2016,12,11,17,1992,1983,868,-1115
2016,12,11,18,1995,1910,752,-1158
2016,12,11,19,1956,1850,710,-1140
2016,12,11,20,1921,1787,637,-1150
2016,12,11,21,1888,1737,621,-1116
2016,12,11,22,1866,1698,603,-1095
2016,12,11,23,1877,1763,672,-1091
2016,12,12,0,1964,1880,783,-1097
2016,12,12,1,2112,2057,837,-1220
2016,12,12,2,2145,2108,903,-1205
2016,12,12,3,2126,2093,931,-1162
2016,12,12,4,2097,2059,893,-1166
2016,12,12,5,2020,1989,828,-1161
2016,12,12,6,1899,1861,771,-1090
2016,12,12,7,1773,1732,668,-1064
2016,12,12,8,-9999,1644,574,-1070
2016,12,12,9,1717,1623,548,-1075
2016,12,12,10,1684,1623,551,-1072
2016,12,12,11,1705,1631,556,-1075
2016,12,12,12,1767,1684,597,-1087
2016,12,12,13,1895,1818,712,-1106
2016,12,12,14,2117,2019,868,-1151
2016,12,12,15,2277,2173,962,-1211
2016,12,12,16,2281,2164,927,-1237
2016,12,12,17,2240,2116,897,-1219
2016,12,12,18,2184,2058,863,-1195
2016,12,12,19,2122,1977,924,-1053
2016,12,12,20,2061,1898,931,-967
2016,12,12,21,2013,1838,1064,-774
2016,12,12,22,1982,1819,1131,-688
2016,12,12,23,1990,1824,1122,-702
2016,12,13,0,2078,1944,1259,-685
2016,12,13,1,2253,2124,1315,-809
2016,12,13,2,2330,2198,1264,-934
2016,12,13,3,2331,2183,1151,-1032
2016,12,13,4,2305,2171,1136,-1035
2016,12,13,5,2219,2094,1060,-1034
2016,12,13,6,2082,1944,933,-1011
2016,12,13,7,1956,1827,851,-976
2016,12,13,8,1876,1772,762,-1010
2016,12,13,9,1840,1749,578,-1171
2016,12,13,10,1799,1758,519,-1239
2016,12,13,11,1810,1781,514,-1267
2016,12,13,12,1860,1838,557,-1281
2016,12,13,13,1977,1951,663,-1288
2016,12,13,14,2179,2160,837,-1323
2016,12,13,15,2334,2320,922,-1398
2016,12,13,16,2345,2308,944,-1364
2016,12,13,17,2304,2195,906,-1289
2016,12,13,18,2261,2112,881,-1231
2016,12,13,19,2200,2011,839,-1172
2016,12,13,20,2140,1958,829,-1129
2016,12,13,21,2084,1925,843,-1082
2016,12,13,22,2056,1896,839,-1057
2016,12,13,23,2063,1891,853,-1038
2016,12,14,0,2145,2026,929,-1097
2016,12,14,1,2330,2232,993,-1239
2016,12,14,2,2396,2291,908,-1383
2016,12,14,3,2389,2257,904,-1353
2016,12,14,4,2352,2234,902,-1332
2016,12,14,5,2256,2143,867,-1276
2016,12,14,6,2106,2007,746,-1261
2016,12,14,7,1980,1862,590,-1272
2016,12,14,8,1916,1794,535,-1259
2016,12,14,9,1839,1760,637,-1123
2016,12,14,10,1800,1752,645,-1107
2016,12,14,11,1804,1756,644,-1112
2016,12,14,12,1841,1802,663,-1139
2016,12,14,13,1948,1923,695,-1228
2016,12,14,14,2140,2111,741,-1370
2016,12,14,15,2276,2240,919,-1321
2016,12,14,16,2264,2237,1008,-1229
2016,12,14,17,2197,2222,1091,-1131
2016,12,14,18,2154,2201,1115,-1086
2016,12,14,19,2100,2174,1110,-1064
2016,12,14,20,2063,2137,1130,-1007
2016,12,14,21,2024,2122,1073,-1049
2016,12,14,22,2004,2119,1102,-1017
2016,12,14,23,2009,2135,1103,-1032
2016,12,15,0,2099,2185,1169,-1016
2016,12,15,1,2256,2320,1306,-1014
2016,12,15,2,2280,2349,1342,-1007
2016,12,15,3,2231,2288,1280,-1008
2016,12,15,4,2171,2242,1211,-1031
2016,12,15,5,2063,2142,1217,-925
2016,12,15,6,1903,1974,1044,-930
2016,12,15,7,1766,1836,869,-967
2016,12,15,8,1700,1745,828,-917
2016,12,15,9,1707,1699,888,-811
2016,12,15,10,1718,1690,884,-806
2016,12,15,11,1716,1681,885,-796
2016,12,15,12,1746,1723,888,-835
2016,12,15,13,1835,1809,951,-858
2016,12,15,14,1995,1990,1007,-983
2016,12,15,15,2103,2112,997,-1115
2016,12,15,16,2088,2107,1025,-1082
2016,12,15,17,2036,2078,1011,-1067
2016,12,15,18,2002,2036,1078,-958
2016,12,15,19,1959,1987,1031,-956
2016,12,15,20,1924,1947,984,-963
2016,12,15,21,1907,1946,947,-999
2016,12,15,22,1897,1949,919,-1030
2016,12,15,23,1914,1967,925,-1042
2016,12,16,0,2004,2038,968,-1070
2016,12,16,1,2171,2149,1064,-1085
2016,12,16,2,2219,2167,1121,-1046
2016,12,16,3,2194,2126,1080,-1046
2016,12,16,4,2155,2088,1046,-1042
2016,12,16,5,2066,1990,959,-1031
2016,12,16,6,1926,1854,831,-1023
2016,12,16,7,1800,1716,697,-1019
2016,12,16,8,1713,1658,611,-1047
2016,12,16,9,1700,1618,670,-948
2016,12,16,10,1672,1618,685,-933
2016,12,16,11,1689,1614,707,-907
2016,12,16,12,1739,1672,816,-856
2016,12,16,13,1840,1786,953,-833
2016,12,16,14,2067,1981,1116,-865
2016,12,16,15,2223,2128,1275,-853
2016,12,16,16,2248,2190,1324,-866
2016,12,16,17,2236,2180,1325,-855
2016,12,16,18,2236,2170,1330,-840
2016,12,16,19,2214,2129,1309,-820
2016,12,16,20,2192,2088,1254,-834
2016,12,16,21,2189,2064,1246,-818
2016,12,16,22,2183,2073,1261,-812
2016,12,16,23,2202,2099,1323,-776
2016,12,17,0,2289,2179,1392,-787
2016,12,17,1,2423,2358,1546,-812
2016,12,17,2,2434,2382,1448,-934
2016,12,17,3,2416,2344,1412,-932
2016,12,17,4,2399,2338,1423,-915
2016,12,17,5,2348,2285,1379,-906
2016,12,17,6,2253,2205,1303,-902
2016,12,17,7,2142,2101,1162,-939
2016,12,17,8,2084,2031,1109,-922
2016,12,17,9,2038,2003,1173,-830
2016,12,17,10,2039,1997,1146,-851
2016,12,17,11,2044,2023,1142,-881
2016,12,17,12,2071,2046,1154,-892
2016,12,17,13,2140,2108,1149,-959
2016,12,17,14,2269,2219,1197,-1022
2016,12,17,15,2403,2361,1040,-1321
2016,12,17,16,2523,2429,1113,-1316
2016,12,17,17,2571,2413,1029,-1384
2016,12,17,18,2544,2348,1010,-1338
2016,12,17,19,2476,2274,934,-1340
2016,12,17,20,2402,2197,975,-1222
2016,12,17,21,2341,2112,800,-1312
2016,12,17,22,2294,2083,775,-1308
2016,12,17,23,2276,2069,744,-1325
2016,12,18,0,2331,2197,848,-1349
2016,12,18,1,2496,2369,1043,-1326
2016,12,18,2,2542,2425,1093,-1332
2016,12,18,3,2521,2421,1095,-1326
2016,12,18,4,2494,2395,1045,-1350
2016,12,18,5,2433,2356,1108,-1248
2016,12,18,6,2321,2275,1221,-1054
2016,12,18,7,2204,2182,1184,-998
2016,12,18,8,2092,2137,1087,-1050
2016,12,18,9,2066,2114,881,-1233
2016,12,18,10,2109,2138,780,-1358
2016,12,18,11,2106,2137,687,-1450
2016,12,18,12,2129,2181,698,-1483
2016,12,18,13,2178,2236,734,-1502
2016,12,18,14,2288,2330,776,-1554
2016,12,18,15,2406,2450,880,-1570
2016,12,18,16,2501,2522,928,-1594
2016,12,18,17,2511,2435,925,-1510
2016,12,18,18,2486,2322,871,-1451
2016,12,18,19,2421,2255,898,-1357
2016,12,18,20,2355,2196,878,-1318
2016,12,18,21,2304,2138,861,-1277
2016,12,18,22,2285,2091,828,-1263
2016,12,18,23,2278,2105,827,-1278
2016,12,19,0,2360,2225,907,-1318
2016,12,19,1,2549,2459,963,-1496
2016,12,19,2,2590,2547,1122,-1425
2016,12,19,3,2578,2543,1168,-1375
2016,12,19,4,2547,2537,1150,-1387
2016,12,19,5,2453,2457,1143,-1314
2016,12,19,6,2301,2341,1081,-1260
2016,12,19,7,2163,2219,1038,-1181
2016,12,19,8,2057,2164,986,-1178
2016,12,19,9,2080,2144,1037,-1107
2016,12,19,10,2154,2145,1040,-1105
2016,12,19,11,2162,2169,1064,-1105
2016,12,19,12,2203,2222,1113,-1109
2016,12,19,13,2337,2341,1210,-1131
2016,12,19,14,2586,2508,1264,-1244
2016,12,19,15,2749,2624,1472,-1152
2016,12,19,16,2766,2626,1487,-1139
2016,12,19,17,2674,2575,1548,-1027
2016,12,19,18,2594,2510,1496,-1014
2016,12,19,19,2519,2446,1376,-1070
2016,12,19,20,2444,2378,1253,-1125
2016,12,19,21,2387,2338,1134,-1204
2016,12,19,22,2299,2327,1110,-1217
2016,12,19,23,2254,2331,1110,-1221
2016,12,20,0,2304,2402,1155,-1247
2016,12,20,1,2494,2513,1331,-1182
2016,12,20,2,2539,2537,1329,-1208
2016,12,20,3,2494,2490,1279,-1211
2016,12,20,4,2435,2446,1262,-1184
2016,12,20,5,2334,2346,1202,-1144
2016,12,20,6,2177,2197,1115,-1082
2016,12,20,7,2045,2035,1083,-952
2016,12,20,8,1931,1963,1077,-886
2016,12,20,9,2014,1921,1080,-841
2016,12,20,10,1989,1901,1144,-757
2016,12,20,11,1982,1911,1162,-749
2016,12,20,12,2005,1950,1173,-777
2016,12,20,13,2086,2050,1242,-808
2016,12,20,14,2242,2213,1386,-827
2016,12,20,15,2351,2328,1457,-871
2016,12,20,16,2338,2343,1436,-907
2016,12,20,17,2273,2317,1328,-989
2016,12,20,18,2208,2291,1316,-975
2016,12,20,19,2141,2266,1216,-1050
2016,12,20,20,2080,2227,1144,-1083
2016,12,20,21,2045,2185,1143,-1042
2016,12,20,22,2024,2176,1145,-1031
2016,12,20,23,2012,2194,1129,-1065
2016,12,21,0,2072,2254,1201,-1053
2016,12,21,1,2224,2373,1325,-1048
2016,12,21,2,2260,2379,1327,-1052
2016,12,21,3,2240,2314,1301,-1013
2016,12,21,4,2213,2265,1316,-949
2016,12,21,5,2138,2187,1298,-889
2016,12,21,6,2014,2059,1227,-832
2016,12,21,7,1907,1945,1240,-705
2016,12,21,8,1860,1880,1202,-678
2016,12,21,9,1888,1865,1339,-526
2016,12,21,10,1928,1866,1346,-520
2016,12,21,11,1951,1886,1364,-522
2016,12,21,12,1995,1935,1323,-612
2016,12,21,13,2104,2067,1284,-783
2016,12,21,14,2301,2240,1225,-1015
2016,12,21,15,2460,2385,1249,-1136
2016,12,21,16,2498,2422,1246,-1176
2016,12,21,17,2459,2377,1227,-1150
2016,12,21,18,2404,2356,1186,-1170
2016,12,21,19,2339,2205,1082,-1123
2016,12,21,20,2266,2118,1051,-1067
2016,12,21,21,2227,2058,1047,-1011
2016,12,21,22,2206,2000,1024,-976
2016,12,21,23,2213,2007,1037,-970
2016,12,22,0,2302,2113,1002,-1111
2016,12,22,1,2502,2307,1130,-1177
2016,12,22,2,2575,2392,1239,-1153
2016,12,22,3,2568,2383,1250,-1133
2016,12,22,4,2542,2388,1238,-1150
2016,12,22,5,2461,2317,1350,-967
2016,12,22,6,2331,2205,1275,-930
2016,12,22,7,2197,2086,1239,-847
2016,12,22,8,2061,2038,1166,-872
2016,12,22,9,2114,2001,1158,-843
2016,12,22,10,2057,1994,1173,-821
2016,12,22,11,2078,2024,1188,-836
2016,12,22,12,2135,2076,1238,-838
2016,12,22,13,2264,2166,1270,-896
2016,12,22,14,2466,2325,1406,-919
2016,12,22,15,2611,2471,1427,-1044
2016,12,22,16,2633,2517,1477,-1040
2016,12,22,17,2593,2468,1479,-989
2016,12,22,18,2525,2396,1397,-999
2016,12,22,19,2456,2303,1333,-970
2016,12,22,20,2360,2208,1317,-891
2016,12,22,21,2294,2160,1281,-879
2016,12,22,22,2242,2140,1086,-1054
2016,12,22,23,2228,2142,1026,-1116
2016,12,23,0,2314,2210,1062,-1148
2016,12,23,1,2525,2375,1226,-1149
2016,12,23,2,2606,2450,1312,-1138
2016,12,23,3,2598,2429,1278,-1151
2016,12,23,4,2583,2395,1269,-1126
2016,12,23,5,2516,2339,1227,-1112
2016,12,23,6,2372,2222,1130,-1092
2016,12,23,7,2231,2098,1097,-1001
2016,12,23,8,2141,2029,1062,-967
2016,12,23,9,2136,1972,1028,-944
2016,12,23,10,2049,1981,1035,-946
2016,12,23,11,2070,1986,1110,-876
2016,12,23,12,2127,2027,1178,-849
2016,12,23,13,2242,2101,1207,-894
2016,12,23,14,2415,2237,1221,-1016
2016,12,23,15,2528,2337,1398,-939
2016,12,23,16,2540,2377,1544,-833
2016,12,23,17,2491,2380,1565,-815
2016,12,23,18,2403,2370,1594,-776
2016,12,23,19,2296,2301,1607,-694
2016,12,23,20,2195,2255,1591,-664
2016,12,23,21,2122,2228,1480,-748
2016,12,23,22,2061,2179,1506,-673
2016,12,23,23,2052,2172,1117,-1055
2016,12,24,0,2108,2206,1141,-1065
2016,12,24,1,2226,2299,1275,-1024
2016,12,24,2,2228,2303,1263,-1040
2016,12,24,3,2162,2248,1196,-1052
2016,12,24,4,2112,2194,1176,-1018
2016,12,24,5,2045,2120,1130,-990
2016,12,24,6,1954,2000,1033,-967
2016,12,24,7,1861,1884,1175,-709
2016,12,24,8,1837,1793,991,-802
2016,12,24,9,1785,1740,884,-856
2016,12,24,10,1777,1726,888,-838
2016,12,24,11,1776,1716,909,-807
2016,12,24,12,1788,1722,936,-786
2016,12,24,13,1817,1778,933,-845
2016,12,24,14,1834,1854,971,-883
2016,12,24,15,1906,1940,1055,-885
2016,12,24,16,2010,2024,1154,-870
2016,12,24,17,2050,2072,1283,-789
2016,12,24,18,2041,2087,1335,-752
2016,12,24,19,2021,2068,1439,-629
2016,12,24,20,1985,2017,1479,-538
2016,12,24,21,1951,1968,1438,-530
2016,12,24,22,1931,1961,1420,-541
2016,12,24,23,1942,1971,1397,-574
2016,12,25,0,2020,2002,1447,-555
2016,12,25,1,2169,2108,1548,-560
2016,12,25,2,2213,2112,1652,-460
2016,12,25,3,2199,2066,1627,-439
2016,12,25,4,2171,2034,1594,-440
2016,12,25,5,2131,2010,1562,-448
2016,12,25,6,2057,1944,1479,-465
2016,12,25,7,1968,1871,1366,-505
2016,12,25,8,1928,1801,1303,-498
2016,12,25,9,1951,1777,1321,-456
2016,12,25,10,1847,1764,1329,-435
2016,12,25,11,1859,1777,1350,-427
2016,12,25,12,1893,1804,1374,-430
2016,12,25,13,1943,1858,1401,-457
2016,12,25,14,1981,1938,1423,-515
2016,12,25,15,2068,2057,1520,-537
2016,12,25,16,2176,2142,1605,-537
2016,12,25,17,2226,2095,1518,-577
2016,12,25,18,2217,2000,1505,-495
2016,12,25,19,2162,1939,1564,-375
2016,12,25,20,2118,1907,1454,-453
2016,12,25,21,2056,1843,1405,-438
2016,12,25,22,2018,1825,1361,-464
2016,12,25,23,2030,1807,1362,-445
2016,12,26,0,2109,1865,1423,-442
2016,12,26,1,2298,2034,1497,-537
2016,12,26,2,2385,2112,1531,-581
2016,12,26,3,2399,2116,1550,-566
2016,12,26,4,2391,2125,1512,-613
2016,12,26,5,2346,2087,1385,-702
2016,12,26,6,2230,2028,1345,-683
2016,12,26,7,2113,1926,1218,-708
2016,12,26,8,2072,1888,1103,-785
2016,12,26,9,2045,1860,1082,-778
2016,12,26,10,1936,1874,1041,-833
2016,12,26,11,1949,1891,1009,-882
2016,12,26,12,1997,1942,1010,-932
2016,12,26,13,2125,2021,1064,-957
2016,12,26,14,2327,2116,1151,-965
2016,12,26,15,2491,2212,1237,-975
2016,12,26,16,2523,2291,1293,-998
2016,12,26,17,2490,2240,1124,-1116
2016,12,26,18,2414,2168,1004,-1164
2016,12,26,19,2327,2092,958,-1134
2016,12,26,20,2256,2022,893,-1129
2016,12,26,21,2185,1954,822,-1132
2016,12,26,22,2140,1915,822,-1093
2016,12,26,23,2121,1922,880,-1042
2016,12,27,0,2191,2048,942,-1106
2016,12,27,1,2400,2282,1137,-1145
2016,12,27,2,2502,2378,1186,-1192
2016,12,27,3,2490,2374,1153,-1221
2016,12,27,4,2468,2339,1152,-1187
2016,12,27,5,2404,2279,1135,-1144
2016,12,27,6,2266,2161,1166,-995
2016,12,27,7,2152,2038,1131,-907
2016,12,27,8,2134,1972,1123,-849
2016,12,27,9,2058,1941,1065,-876
2016,12,27,10,1966,1920,1067,-853
2016,12,27,11,1962,1928,1070,-858
2016,12,27,12,1988,1958,1082,-876
2016,12,27,13,2058,2053,1194,-859
2016,12,27,14,2187,2193,1069,-1124
2016,12,27,15,2283,2295,1122,-1173
2016,12,27,16,2271,2332,1160,-1172
2016,12,27,17,2214,2348,1258,-1090
2016,12,27,18,2136,2338,1268,-1070
2016,12,27,19,2074,2303,1216,-1087
2016,12,27,20,2004,2244,1204,-1040
2016,12,27,21,1940,2189,1140,-1049
2016,12,27,22,1903,2164,1119,-1045
2016,12,27,23,1897,2160,952,-1208
2016,12,28,0,1967,2206,964,-1242
2016,12,28,1,2128,2336,1061,-1275
2016,12,28,2,2170,2370,1094,-1276
2016,12,28,3,2124,2339,1083,-1256
2016,12,28,4,2071,2286,1033,-1253
2016,12,28,5,1999,2204,975,-1229
2016,12,28,6,1908,2090,869,-1221
2016,12,28,7,1817,1965,885,-1080
2016,12,28,8,1797,1890,823,-1067
2016,12,28,9,1825,1856,826,-1030
2016,12,28,10,1882,1833,834,-999
2016,12,28,11,1892,1845,845,-1000
2016,12,28,12,1934,1889,898,-991
2016,12,28,13,2022,1994,972,-1022
2016,12,28,14,2179,2127,974,-1153
2016,12,28,15,2308,2241,1061,-1180
2016,12,28,16,2349,2283,1098,-1185
2016,12,28,17,2335,2271,1087,-1184
2016,12,28,18,2288,2199,1113,-1086
2016,12,28,19,2224,2078,1022,-1056
2016,12,28,20,2163,2019,910,-1109
2016,12,28,21,2118,1970,756,-1214
2016,12,28,22,2092,1941,707,-1234
2016,12,28,23,2094,1934,699,-1235
2016,12,29,0,2175,2041,790,-1251
2016,12,29,1,2385,2243,903,-1340
2016,12,29,2,2470,2355,980,-1375
2016,12,29,3,2466,2343,969,-1374
2016,12,29,4,2424,2316,966,-1350
2016,12,29,5,2339,2247,888,-1359
2016,12,29,6,2212,2142,809,-1333
2016,12,29,7,2094,2039,812,-1227
2016,12,29,8,1985,1975,861,-1114
2016,12,29,9,1994,1970,921,-1049
2016,12,29,10,2015,1971,1001,-970
2016,12,29,11,2038,1982,1017,-965
2016,12,29,12,2095,2043,1062,-981
2016,12,29,13,2196,2123,1152,-971
2016,12,29,14,2353,2272,1197,-1075
2016,12,29,15,2486,2386,1313,-1073
2016,12,29,16,2522,2450,1391,-1059
2016,12,29,17,2494,2381,1339,-1042
2016,12,29,18,2422,2281,1296,-985
2016,12,29,19,2337,2206,1352,-854
2016,12,29,20,2264,2131,1318,-813
2016,12,29,21,2199,2077,1254,-823
2016,12,29,22,2151,2023,1195,-828
2016,12,29,23,2138,2003,1178,-825
2016,12,30,0,2216,2128,1299,-829
2016,12,30,1,2432,2326,1457,-869
2016,12,30,2,2525,2403,1513,-890
2016,12,30,3,2509,2377,1492,-885
2016,12,30,4,2450,2342,1446,-896
2016,12,30,5,2377,2275,1378,-897
2016,12,30,6,2273,2168,1343,-825
2016,12,30,7,2163,2058,1302,-756
2016,12,30,8,2066,2006,1268,-738
2016,12,30,9,2058,1969,1181,-788
2016,12,30,10,2011,1984,1182,-802
2016,12,30,11,2030,1992,1180,-812
2016,12,30,12,2082,2032,1187,-845
2016,12,30,13,2177,2121,1269,-852
2016,12,30,14,2327,2249,1315,-934
2016,12,30,15,2456,2381,1340,-1041
2016,12,30,16,2497,2424,1335,-1089
2016,12,30,17,2464,2401,1306,-1095
2016,12,30,18,2372,2333,1266,-1067
2016,12,30,19,2274,2258,1207,-1051
2016,12,30,20,2190,2186,1144,-1042
2016,12,30,21,2111,2145,1105,-1040
2016,12,30,22,2053,2109,1100,-1009
2016,12,30,23,2039,2118,1133,-985
2016,12,31,0,2124,2194,1187,-1007
2016,12,31,1,2305,2343,1248,-1095
2016,12,31,2,2364,2413,1296,-1117
2016,12,31,3,2345,2382,1245,-1137
2016,12,31,4,2318,2339,1157,-1182
2016,12,31,5,2279,2271,1090,-1181
2016,12,31,6,2214,2181,1024,-1157
2016,12,31,7,2128,2074,987,-1087
2016,12,31,8,2074,2023,951,-1072
2016,12,31,9,2058,1990,925,-1065
2016,12,31,10,2007,1987,974,-1013
2016,12,31,11,2001,2000,983,-1017
2016,12,31,12,2013,2026,1007,-1019
2016,12,31,13,2047,2088,1037,-1051
2016,12,31,14,2081,2162,1113,-1049
2016,12,31,15,2169,2250,1080,-1170
2016,12,31,16,2313,2332,1054,-1278
2016,12,31,17,2357,2358,1090,-1268
2016,12,31,18,2299,2335,1046,-1289
2016,12,31,19,2225,2271,1009,-1262
2016,12,31,20,2135,2206,961,-1245
2016,12,31,21,2057,2147,937,-1210
2016,12,31,22,2001,2110,901,-1209
2016,12,31,23,1982,2113,883,-1230
2017,1,1,0,2055,2164,907,-1257
2017,1,1,1,2255,2329,1025,-1304
2017,1,1,2,2340,2381,1119,-1262
2017,1,1,3,2325,2324,1142,-1182
2017,1,1,4,2294,2281,1219,-1062
2017,1,1,5,2253,2219,1218,-1001
2017,1,1,6,2187,2151,1188,-963
2017,1,1,7,2113,2100,1158,-942
2017,1,1,8,2082,2054,1138,-916
2017,1,1,9,2082,2021,1206,-815
2017,1,1,10,2067,2003,1241,-762
2017,1,1,11,2081,1994,1284,-710
2017,1,1,12,2106,2016,1258,-758
2017,1,1,13,2144,2046,1170,-876
2017,1,1,14,2194,2097,1173,-924
2017,1,1,15,2293,2182,1160,-1022
2017,1,1,16,2396,2235,1143,-1092
2017,1,1,17,2388,2243,1082,-1161
2017,1,1,18,2312,2185,1071,-1114
2017,1,1,19,2232,2115,1008,-1107
2017,1,1,20,2163,2085,976,-1109
2017,1,1,21,2094,2083,973,-1110
2017,1,1,22,2038,2072,961,-1111
2017,1,1,23,2020,2063,954,-1109
2017,1,2,0,2088,2120,999,-1121
2017,1,2,1,2258,2255,1114,-1141
2017,1,2,2,2333,2306,1179,-1127
2017,1,2,3,2312,2285,1145,-1140
2017,1,2,4,2284,2239,1120,-1119
2017,1,2,5,2218,2177,1058,-1119
2017,1,2,6,2120,2081,1042,-1039
2017,1,2,7,2029,1964,1079,-885
2017,1,2,8,1945,1911,1071,-840
2017,1,2,9,1974,1873,1066,-807
2017,1,2,10,1955,1877,1074,-803
2017,1,2,11,1976,1883,1055,-828
2017,1,2,12,2022,1934,1071,-863
2017,1,2,13,2114,1992,1046,-946
2017,1,2,14,2270,2100,1045,-1055
2017,1,2,15,2400,2183,1085,-1098
2017,1,2,16,2467,2232,1119,-1113
2017,1,2,17,2448,2261,1189,-1072
2017,1,2,18,2390,2266,1219,-1047
2017,1,2,19,2314,2211,1197,-1014
2017,1,2,20,2244,2175,1147,-1028
2017,1,2,21,2195,2109,1090,-1019
2017,1,2,22,2143,2103,1060,-1043
2017,1,2,23,2133,2087,1054,-1033
2017,1,3,0,2206,2174,1107,-1067
2017,1,3,1,2396,2354,1277,-1077
2017,1,3,2,2490,2404,1334,-1070
2017,1,3,3,2471,2361,1287,-1074
2017,1,3,4,2446,2316,1252,-1064
2017,1,3,5,2355,2217,1144,-1073
2017,1,3,6,2225,2088,1098,-990
2017,1,3,7,2129,1978,1080,-898
2017,1,3,8,2084,1896,1142,-754
2017,1,3,9,2024,1875,1130,-745
2017,1,3,10,1942,1880,1182,-698
2017,1,3,11,1954,1895,1147,-748
2017,1,3,12,1995,1938,1126,-812
2017,1,3,13,2080,2044,1175,-869
2017,1,3,14,2221,2233,1227,-1006
2017,1,3,15,2358,2364,1325,-1039
2017,1,3,16,2383,2380,1362,-1018
2017,1,3,17,2396,2350,1337,-1013
2017,1,3,18,2358,2309,1312,-997
2017,1,3,19,2292,2278,1283,-995
2017,1,3,20,2232,2237,1246,-991
2017,1,3,21,2176,2199,1218,-981
2017,1,3,22,2133,2193,1215,-978
2017,1,3,23,2120,2210,1229,-981
2017,1,4,0,2189,2253,1234,-1019
2017,1,4,1,2364,2376,1359,-1017
2017,1,4,2,2452,2428,1432,-996
2017,1,4,3,2432,2410,1392,-1018
2017,1,4,4,2392,2344,1333,-1011
2017,1,4,5,2287,2232,1229,-1003
2017,1,4,6,2144,2090,1121,-969
2017,1,4,7,2024,1951,1140,-811
2017,1,4,8,2003,1890,1200,-690
2017,1,4,9,1924,1853,1279,-574
2017,1,4,10,1903,1855,1284,-571
2017,1,4,11,1904,1865,1299,-566
2017,1,4,12,1937,1898,1332,-566
2017,1,4,13,2015,2005,1420,-585
2017,1,4,14,2156,2163,1454,-709
2017,1,4,15,2270,2259,1397,-862
2017,1,4,16,2280,2281,1396,-885
2017,1,4,17,2273,2211,1304,-907
2017,1,4,18,2253,2221,1344,-877
2017,1,4,19,2211,2239,1314,-925
2017,1,4,20,2173,2219,1295,-924
2017,1,4,21,2140,2229,1316,-913
2017,1,4,22,2125,2234,1378,-856
2017,1,4,23,2131,2245,1405,-840
2017,1,5,0,2195,2271,1413,-858
2017,1,5,1,2334,2386,1467,-919
2017,1,5,2,2403,2437,1539,-898
2017,1,5,3,2384,2383,1521,-862
2017,1,5,4,2348,2325,1456,-869
2017,1,5,5,2261,2221,1375,-846
2017,1,5,6,2138,2096,1226,-870
2017,1,5,7,2031,1977,1112,-865
2017,1,5,8,1977,1926,1039,-887
2017,1,5,9,2060,1891,1016,-875
2017,1,5,10,1997,1900,944,-956
2017,1,5,11,2028,1922,940,-982
2017,1,5,12,2093,1996,1046,-950
2017,1,5,13,2216,2118,1165,-953
2017,1,5,14,2399,2271,1315,-956
2017,1,5,15,2565,2433,1432,-1001
2017,1,5,16,2619,2489,1526,-963
2017,1,5,17,2550,2478,1540,-938
2017,1,5,18,2589,2422,1446,-976
2017,1,5,19,2510,2378,1317,-1061
2017,1,5,20,2443,2325,1343,-982
2017,1,5,21,2398,2269,1271,-998
2017,1,5,22,2371,2213,1353,-860
2017,1,5,23,2365,2221,1283,-938
2017,1,6,0,2443,2274,1287,-987
2017,1,6,1,2658,2471,1461,-1010
2017,1,6,2,2796,2616,1591,-1025
2017,1,6,3,2372,2613,1575,-1038
2017,1,6,4,2774,2585,1501,-1084
2017,1,6,5,2673,2531,1443,-1088
2017,1,6,6,2524,2411,1329,-1082
2017,1,6,7,2403,2318,1291,-1027
2017,1,6,8,2342,2275,1201,-1074
2017,1,6,9,2255,2270,1185,-1085
2017,1,6,10,2316,2243,1145,-1098
2017,1,6,11,2329,2274,1170,-1104
2017,1,6,12,2382,2349,1226,-1123
2017,1,6,13,2496,2447,1356,-1091
2017,1,6,14,2664,2596,1506,-1090
2017,1,6,15,2790,2723,1532,-1191
2017,1,6,16,2801,2771,1582,-1189
2017,1,6,17,2775,2745,1562,-1183
2017,1,6,18,2713,2706,1681,-1025
2017,1,6,19,2652,2628,1699,-929
2017,1,6,20,2582,2539,1752,-787
2017,1,6,21,2522,2470,1708,-762
2017,1,6,22,2479,2417,1676,-741
2017,1,6,23,2453,2399,1682,-717
2017,1,7,0,2504,2459,1713,-746
2017,1,7,1,2659,2634,1881,-753
2017,1,7,2,2738,2737,1783,-954
2017,1,7,3,2723,2718,1735,-983
2017,1,7,4,2788,2690,1724,-966
2017,1,7,5,2649,2626,1710,-916
2017,1,7,6,2559,2545,1608,-937
2017,1,7,7,2461,2438,1545,-893
2017,1,7,8,2361,2357,1458,-899
2017,1,7,9,2393,2351,1368,-983
2017,1,7,10,2393,2339,1357,-982
2017,1,7,11,2398,2361,1362,-999
2017,1,7,12,2421,2394,1410,-984
2017,1,7,13,2453,2442,1438,-1004
2017,1,7,14,2488,2522,1519,-1003
2017,1,7,15,2555,2611,1562,-1049
2017,1,7,16,2639,2653,1613,-1040
2017,1,7,17,2653,2696,1659,-1037
2017,1,7,18,2608,2675,1662,-1013
2017,1,7,19,2516,2622,1737,-885
2017,1,7,20,2403,2586,1769,-817
2017,1,7,21,2298,2563,1771,-792
2017,1,7,22,2410,2552,1863,-689
2017,1,7,23,2160,2550,1852,-698
2017,1,8,0,2168,2571,1709,-862
2017,1,8,1,2275,2638,1621,-1017
2017,1,8,2,2460,2659,1609,-1050
2017,1,8,3,2225,2553,1617,-936
2017,1,8,4,2228,2468,1646,-822
2017,1,8,5,2111,2357,1559,-798
2017,1,8,6,2040,2235,1564,-671
2017,1,8,7,1975,2110,1366,-744
2017,1,8,8,1919,2037,1287,-750
2017,1,8,9,1979,1982,1328,-654
2017,1,8,10,2034,1972,1300,-672
2017,1,8,11,2017,1956,1249,-707
2017,1,8,12,2012,1960,1257,-703
2017,1,8,13,2025,1992,1287,-705
2017,1,8,14,2050,2045,1325,-720
2017,1,8,15,2083,2115,1394,-721
2017,1,8,16,2116,2164,1464,-700
2017,1,8,17,2101,2215,1502,-713
2017,1,8,18,2062,2232,1577,-655
2017,1,8,19,2004,2240,1576,-664
2017,1,8,20,1980,2225,1661,-564
2017,1,8,21,1950,2190,1651,-539
2017,1,8,22,2093,2159,1611,-548
2017,1,8,23,1927,2147,1641,-506
2017,1,9,0,1962,2138,1585,-553
2017,1,9,1,2073,2274,1678,-596
2017,1,9,2,2252,2282,1685,-597
2017,1,9,3,2063,2217,1615,-602
2017,1,9,4,2033,2147,1570,-577
2017,1,9,5,1941,2062,1474,-588
2017,1,9,6,1844,1912,1241,-671
2017,1,9,7,1753,1810,1195,-615
2017,1,9,8,1666,1755,1192,-563
2017,1,9,9,1765,1720,1161,-559
2017,1,9,10,1795,1698,1148,-550
2017,1,9,11,1816,1706,1165,-541
2017,1,9,12,1856,1739,1187,-552
2017,1,9,13,1939,1819,1257,-562
2017,1,9,14,2063,1963,1376,-587
2017,1,9,15,2158,2080,1485,-595
2017,1,9,16,2224,2100,1513,-587
2017,1,9,17,2226,2098,1535,-563
2017,1,9,18,2228,2100,1533,-567
2017,1,9,19,2209,2069,1503,-566
2017,1,9,20,2185,2058,1568,-490
2017,1,9,21,2181,2013,1541,-472
2017,1,9,22,2281,1980,1501,-479
2017,1,9,23,2199,1986,1520,-466
2017,1,10,0,2241,2037,1528,-509
2017,1,10,1,2398,2189,1599,-590
2017,1,10,2,2552,2276,1624,-652
2017,1,10,3,2445,2199,1611,-588
2017,1,10,4,2412,2175,1502,-673
2017,1,10,5,2279,2101,1396,-705
2017,1,10,6,2132,1973,1355,-618
2017,1,10,7,2014,1844,1281,-563
2017,1,10,8,1928,1779,1197,-582
2017,1,10,9,1908,1759,1157,-602
2017,1,10,10,1797,1751,1183,-568
2017,1,10,11,1810,1764,1216,-548
2017,1,10,12,1849,1798,1231,-567
2017,1,10,13,1938,1787,1164,-623
2017,1,10,14,2076,2059,1392,-667
2017,1,10,15,2182,2150,1521,-629
2017,1,10,16,2186,2154,1532,-622
2017,1,10,17,2197,2117,1545,-572
2017,1,10,18,2199,2111,1535,-576
2017,1,10,19,2189,2086,1506,-580
2017,1,10,20,2174,2069,1556,-513
2017,1,10,21,2144,2044,1562,-482
2017,1,10,22,2150,2080,1550,-530
2017,1,10,23,2140,2087,1526,-561
2017,1,11,0,2182,2138,1583,-555
2017,1,11,1,2320,2223,1508,-715
2017,1,11,2,2387,2257,1522,-735
2017,1,11,3,2334,2199,1508,-691
2017,1,11,4,2322,2140,1424,-716
2017,1,11,5,2184,2040,1515,-525
2017,1,11,6,2043,1901,1447,-454
2017,1,11,7,1925,1781,1309,-472
2017,1,11,8,1910,1708,1232,-476
2017,1,11,9,1838,1673,1135,-538
2017,1,11,10,1753,1666,1103,-563
2017,1,11,11,1774,1651,1106,-545
2017,1,11,12,1812,1692,1138,-554
2017,1,11,13,1909,1792,1197,-595
2017,1,11,14,2070,1974,1276,-698
2017,1,11,15,2182,2101,1487,-614
2017,1,11,16,2202,2113,1490,-623
2017,1,11,17,2198,2042,1457,-585
2017,1,11,18,2193,2024,1449,-575
2017,1,11,19,2184,1973,1423,-550
2017,1,11,20,2168,1923,1446,-477
2017,1,11,21,2145,1874,1489,-385
2017,1,11,22,2143,1838,1411,-427
2017,1,11,23,2161,1828,1435,-393
2017,1,12,0,2206,1888,1407,-481
2017,1,12,1,2331,2055,1335,-720
2017,1,12,2,2391,2179,1447,-732
2017,1,12,3,2371,2159,1422,-737
2017,1,12,4,2354,2135,1483,-652
2017,1,12,5,2234,2059,1407,-652
2017,1,12,6,2102,1940,1227,-713
2017,1,12,7,1987,1845,1005,-840
2017,1,12,8,1993,1790,958,-832
2017,1,12,9,1952,1761,962,-799
2017,1,12,10,1883,1761,943,-818
2017,1,12,11,1899,1784,974,-810
2017,1,12,12,1950,1842,1026,-816
2017,1,12,13,2070,1960,1140,-820
2017,1,12,14,2262,2157,1225,-932
2017,1,12,15,2395,2300,1438,-862
2017,1,12,16,2420,2301,1449,-852
2017,1,12,17,2392,2212,1431,-781
2017,1,12,18,2368,2090,1381,-709
2017,1,12,19,2316,2003,1375,-628
2017,1,12,20,2261,1955,1286,-669
2017,1,12,21,2198,1911,1322,-589
2017,1,12,22,2158,1861,1335,-526
2017,1,12,23,2159,1860,1299,-561
2017,1,13,0,2213,1955,1195,-760
2017,1,13,1,2381,2147,1387,-760
2017,1,13,2,2490,2279,1320,-959
2017,1,13,3,2482,2286,1338,-948
2017,1,13,4,2464,2275,1361,-914
2017,1,13,5,2360,2200,1407,-793
2017,1,13,6,2226,2092,1312,-780
2017,1,13,7,2111,1992,1012,-980
2017,1,13,8,2077,1954,956,-998
2017,1,13,9,2041,1944,947,-997
2017,1,13,10,2009,1951,959,-992
2017,1,13,11,2031,1975,965,-1010
2017,1,13,12,2083,2039,1029,-1010
2017,1,13,13,2200,2157,1115,-1042
2017,1,13,14,2394,2347,1281,-1066
2017,1,13,15,2536,2473,1511,-962
2017,1,13,16,2548,2484,1534,-950
2017,1,13,17,2487,2442,1506,-936
2017,1,13,18,2411,2379,1446,-933
2017,1,13,19,2336,2301,1377,-924
2017,1,13,20,2270,2191,1270,-921
2017,1,13,21,2209,2137,1219,-918
2017,1,13,22,2167,2101,1184,-917
2017,1,13,23,2153,2110,1176,-934
2017,1,14,0,2223,2173,1232,-941
2017,1,14,1,2381,2302,1344,-958
2017,1,14,2,2598,2398,1433,-965
2017,1,14,3,2468,2375,1428,-947
2017,1,14,4,2432,2343,1387,-956
2017,1,14,5,2386,2286,1359,-927
2017,1,14,6,2291,2195,1305,-890
2017,1,14,7,2201,2099,1086,-1013
2017,1,14,8,2146,2058,1084,-974
2017,1,14,9,2157,2038,1003,-1035
2017,1,14,10,2109,2041,988,-1053
2017,1,14,11,2127,2051,1008,-1043
2017,1,14,12,2156,2083,1024,-1059
2017,1,14,13,2214,2140,1095,-1045
2017,1,14,14,2301,2227,1136,-1091
2017,1,14,15,2414,2336,1285,-1051
2017,1,14,16,2508,2408,1360,-1048
2017,1,14,17,2511,2421,1380,-1041
2017,1,14,18,2466,2400,1381,-1019
2017,1,14,19,2409,2334,1329,-1005
2017,1,14,20,2333,2269,1257,-1012
2017,1,14,21,2262,2184,1184,-1000
2017,1,14,22,2190,2128,1100,-1028
2017,1,14,23,2201,2114,1106,-1008
2017,1,15,0,2248,2172,1151,-1021
2017,1,15,1,2407,2315,1247,-1068
2017,1,15,2,2464,2410,1351,-1059
2017,1,15,3,2496,2388,1325,-1063
2017,1,15,4,2465,2367,1292,-1075
2017,1,15,5,2404,2312,1267,-1045
2017,1,15,6,2310,2222,1189,-1033
2017,1,15,7,2224,2127,1050,-1077
2017,1,15,8,2183,2064,973,-1091
2017,1,15,9,2200,2045,956,-1089
2017,1,15,10,2103,2052,954,-1098
2017,1,15,11,2109,2055,973,-1082
2017,1,15,12,2130,2080,984,-1096
2017,1,15,13,2175,2143,1026,-1117
2017,1,15,14,2251,2210,1095,-1115
2017,1,15,15,2355,2319,1189,-1130
2017,1,15,16,2185,2392,1259,-1133
2017,1,15,17,2433,2402,1285,-1117
2017,1,15,18,2375,2336,1226,-1110
2017,1,15,19,2307,2238,1151,-1087
2017,1,15,20,2257,2190,1089,-1101
2017,1,15,21,2194,2136,1038,-1098
2017,1,15,22,2109,2097,1008,-1089
2017,1,15,23,2144,2067,974,-1093
2017,1,16,0,2206,2163,1047,-1116
2017,1,16,1,2387,2327,1198,-1129
2017,1,16,2,2466,2474,1332,-1142
2017,1,16,3,2519,2482,1322,-1160
2017,1,16,4,2503,2444,1281,-1163
2017,1,16,5,2422,2383,1246,-1137
2017,1,16,6,2286,2269,1199,-1070
2017,1,16,7,2168,2189,1145,-1044
2017,1,16,8,2133,2145,1100,-1045
2017,1,16,9,2178,2141,1117,-1024
2017,1,16,10,2181,2143,1126,-1017
2017,1,16,11,2201,2182,1174,-1008
2017,1,16,12,2044,2227,1254,-973
2017,1,16,13,1939,2324,1285,-1039
2017,1,16,14,2090,2465,1347,-1118
2017,1,16,15,2168,2607,1358,-1249
2017,1,16,16,2240,2642,1397,-1245
2017,1,16,17,2708,2595,1364,-1231
2017,1,16,18,2612,2518,1408,-1110
2017,1,16,19,2505,2418,1437,-981
2017,1,16,20,2405,2312,1360,-952
2017,1,16,21,2320,2238,1291,-947
2017,1,16,22,2275,2194,1251,-943
2017,1,16,23,2227,2170,1223,-947
2017,1,17,0,2290,2277,1308,-969
2017,1,17,1,2463,2466,1384,-1082
2017,1,17,2,2609,2614,1496,-1118
2017,1,17,3,2625,2608,1499,-1109
2017,1,17,4,2613,2575,1503,-1072
2017,1,17,5,2518,2485,1421,-1064
2017,1,17,6,2384,2341,1307,-1034
2017,1,17,7,2272,2230,1256,-974
2017,1,17,8,2163,2171,1211,-960
2017,1,17,9,2291,2180,1127,-1053
2017,1,17,10,2018,2174,1115,-1059
2017,1,17,11,1936,2201,1081,-1120
2017,1,17,12,1936,2243,1131,-1112
2017,1,17,13,2013,2376,1205,-1171
2017,1,17,14,2131,2575,1294,-1281
2017,1,17,15,2238,2720,1499,-1221
2017,1,17,16,2271,2696,1503,-1193
2017,1,17,17,2749,2600,1472,-1128
2017,1,17,18,2653,2474,1409,-1065
2017,1,17,19,2533,2350,1376,-974
2017,1,17,20,2410,2278,1313,-965
2017,1,17,21,2306,2215,1236,-979
2017,1,17,22,2228,2148,1183,-965
2017,1,17,23,2192,2161,1162,-999
2017,1,18,0,2258,2285,1298,-987
2017,1,18,1,2436,2438,1518,-920
2017,1,18,2,2560,2565,1513,-1052
2017,1,18,3,2587,2533,1605,-928
2017,1,18,4,2572,2500,1597,-903
2017,1,18,5,2480,2398,1485,-913
2017,1,18,6,2354,2246,1438,-808
2017,1,18,7,2248,2144,1396,-748
2017,1,18,8,2189,2081,1364,-717
2017,1,18,9,2185,2056,1404,-652
2017,1,18,10,2128,2039,1406,-633
2017,1,18,11,2138,2059,1379,-680
2017,1,18,12,2178,2094,1437,-657
2017,1,18,13,2287,2205,1449,-756
2017,1,18,14,2462,2386,1603,-783
2017,1,18,15,2579,2511,1679,-832
2017,1,18,16,2554,2471,1668,-803
2017,1,18,17,2465,2437,1598,-839
2017,1,18,18,2351,2363,1594,-769
2017,1,18,19,2242,2309,1561,-748
2017,1,18,20,2149,2210,1482,-728
2017,1,18,21,2061,2187,1441,-746
2017,1,18,22,1981,2194,1442,-752
2017,1,18,23,1985,2210,1527,-683
2017,1,19,0,2065,2243,1538,-705
2017,1,19,1,2192,2312,1561,-751
2017,1,19,2,2277,2365,1673,-692
2017,1,19,3,2262,2338,1630,-708
2017,1,19,4,2222,2268,1561,-707
2017,1,19,5,2111,2144,1533,-611
2017,1,19,6,1979,1993,1429,-564
2017,1,19,7,1883,1868,1409,-459
2017,1,19,8,1862,1801,1396,-405
2017,1,19,9,1854,1764,1363,-401
2017,1,19,10,1833,1731,1327,-404
2017,1,19,11,1843,1741,1328,-413
2017,1,19,12,1876,1774,1335,-439
2017,1,19,13,1973,1858,1454,-404
2017,1,19,14,2131,1992,1350,-642
2017,1,19,15,2250,2113,1293,-820
2017,1,19,16,2232,2121,1256,-865
2017,1,19,17,2198,2118,1252,-866
2017,1,19,18,2145,2068,1210,-858
2017,1,19,19,2103,2031,1182,-849
2017,1,19,20,2046,1969,1172,-797
2017,1,19,21,2021,1914,1140,-774
2017,1,19,22,2012,1901,1110,-791
2017,1,19,23,2033,1895,1079,-816
2017,1,20,0,2102,1941,1086,-855
2017,1,20,1,2233,2056,1201,-855
2017,1,20,2,2333,2164,1299,-865
2017,1,20,3,2320,2142,1278,-864
2017,1,20,4,2281,2108,1240,-868
2017,1,20,5,2182,2020,1185,-835
2017,1,20,6,2048,1885,1113,-772
2017,1,20,7,1942,1780,1094,-686
2017,1,20,8,1894,1708,1015,-693
2017,1,20,9,1865,1680,961,-719
2017,1,20,10,1763,1664,943,-721
2017,1,20,11,1783,1680,1031,-649
2017,1,20,12,1838,1712,1063,-649
2017,1,20,13,1951,1804,1172,-632
2017,1,20,14,2124,1989,1390,-599
2017,1,20,15,2260,2115,1651,-464
2017,1,20,16,2280,2122,1734,-388
2017,1,20,17,2249,2058,1717,-341
2017,1,20,18,2183,1971,1671,-300
2017,1,20,19,2122,1933,1639,-294
2017,1,20,20,2051,1881,1601,-280
2017,1,20,21,2001,1820,1542,-278
2017,1,20,22,1948,1789,1503,-286
2017,1,20,23,1987,1820,1503,-317
2017,1,21,0,2040,1898,1559,-339
2017,1,21,1,2132,2000,1650,-350
2017,1,21,2,2255,2064,1748,-316
2017,1,21,3,2184,2024,1693,-331
2017,1,21,4,2141,1994,1665,-329
2017,1,21,5,2072,1936,1629,-307
2017,1,21,6,1976,1841,1542,-299
2017,1,21,7,1897,1753,1384,-369
2017,1,21,8,1913,1690,1283,-407
2017,1,21,9,1892,1664,1243,-421
2017,1,21,10,1884,1642,1206,-436
2017,1,21,11,1890,1649,1234,-415
2017,1,21,12,1913,1664,1221,-443
2017,1,21,13,1954,1716,1221,-495
2017,1,21,14,2027,1781,1188,-593
2017,1,21,15,2129,1880,1230,-650
2017,1,21,16,2209,1948,1218,-730
2017,1,21,17,2244,1985,1235,-750
2017,1,21,18,2214,1969,1261,-708
2017,1,21,19,2166,1903,1180,-723
2017,1,21,20,2096,1829,1107,-722
2017,1,21,21,2038,1760,1054,-706
2017,1,21,22,1993,1704,994,-710
2017,1,21,23,2006,1699,981,-718
2017,1,22,0,2049,1806,1048,-758
2017,1,22,1,2158,1928,1172,-756
2017,1,22,2,2249,2016,1261,-755
2017,1,22,3,2236,1999,1251,-748
2017,1,22,4,2184,1947,1220,-727
2017,1,22,5,2124,1902,1200,-702
2017,1,22,6,2037,1820,1113,-707
2017,1,22,7,1960,1726,1028,-698
2017,1,22,8,1933,1658,990,-668
2017,1,22,9,1908,1619,1009,-610
2017,1,22,10,1892,1599,1022,-577
2017,1,22,11,1885,1596,1083,-513
2017,1,22,12,1892,1617,1147,-470
2017,1,22,13,1922,1663,1318,-345
2017,1,22,14,1973,1726,1443,-283
2017,1,22,15,2050,1820,1531,-289
2017,1,22,16,2103,1887,1591,-296
2017,1,22,17,2110,1924,1606,-318
2017,1,22,18,2073,1921,1605,-316
2017,1,22,19,2025,1878,1630,-248
2017,1,22,20,1980,1866,1614,-252
2017,1,22,21,1940,1868,1613,-255
2017,1,22,22,1906,1856,1576,-280
2017,1,22,23,1923,1866,1571,-295
2017,1,23,0,1971,1902,1617,-285
2017,1,23,1,2092,1987,1633,-354
2017,1,23,2,2187,2097,1542,-555
2017,1,23,3,2179,2067,1482,-585
2017,1,23,4,2135,2038,1453,-585
2017,1,23,5,2076,1958,1400,-558
2017,1,23,6,1970,1850,1361,-489
2017,1,23,7,1883,1750,1368,-382
2017,1,23,8,1853,1685,1332,-353
2017,1,23,9,1750,1666,1272,-394
2017,1,23,10,1693,1663,1299,-364
2017,1,23,11,1707,1671,1301,-370
2017,1,23,12,1745,1726,1306,-420
2017,1,23,13,1844,1842,1345,-497
2017,1,23,14,2005,2047,1450,-597
2017,1,23,15,2148,2181,1396,-785
2017,1,23,16,2221,2181,1371,-810
2017,1,23,17,2202,2165,1340,-825
2017,1,23,18,2163,2128,1330,-798
2017,1,23,19,2115,2086,1486,-600
2017,1,23,20,2054,2014,1584,-430
2017,1,23,21,2010,1980,1581,-399
2017,1,23,22,1980,1978,1558,-420
2017,1,23,23,1989,1981,1563,-418
2017,1,24,0,2051,2020,1606,-414
2017,1,24,1,2179,2105,1671,-434
2017,1,24,2,2275,2213,1824,-389
2017,1,24,3,2280,2185,1841,-344
2017,1,24,4,2258,2140,1813,-327
2017,1,24,5,2158,2053,1735,-318
2017,1,24,6,2035,1906,1606,-300
2017,1,24,7,1925,1770,1485,-285
2017,1,24,8,1872,1720,1431,-289
2017,1,24,9,1831,1696,1330,-366
2017,1,24,10,1780,1706,1336,-370
2017,1,24,11,1801,1713,1324,-389
2017,1,24,12,1855,1756,1373,-383
2017,1,24,13,1978,1869,1428,-441
2017,1,24,14,2182,2052,1500,-552
2017,1,24,15,2337,2211,1622,-589
2017,1,24,16,2348,2226,1622,-604
2017,1,24,17,2319,2170,1594,-576
2017,1,24,18,2269,2078,1503,-575
2017,1,24,19,2205,1991,1434,-557
2017,1,24,20,2123,1932,1357,-575
2017,1,24,21,2064,1891,1323,-568
2017,1,24,22,2019,1863,1282,-581
2017,1,24,23,2023,1851,1281,-570
2017,1,25,0,2075,1914,1328,-586
2017,1,25,1,2209,2075,1392,-683
2017,1,25,2,2340,2225,1487,-738
2017,1,25,3,2357,2229,1499,-730
2017,1,25,4,2337,2191,1508,-683
2017,1,25,5,2240,2130,1501,-629
2017,1,25,6,2103,1998,1385,-613
2017,1,25,7,1989,1882,1134,-748
2017,1,25,8,1948,1817,1033,-784
2017,1,25,9,1927,1819,913,-906
2017,1,25,10,1890,1823,911,-912
2017,1,25,11,1911,1831,921,-910
2017,1,25,12,1961,1882,974,-908
2017,1,25,13,2088,1995,1071,-924
2017,1,25,14,2304,2181,1198,-983
2017,1,25,15,2465,2333,1360,-973
2017,1,25,16,2476,2306,1363,-943
2017,1,25,17,2421,2260,1317,-943
2017,1,25,18,2337,2199,1391,-808
2017,1,25,19,2243,2137,1258,-879
2017,1,25,20,2163,2060,1188,-872
2017,1,25,21,2104,2008,1191,-817
2017,1,25,22,2066,1990,1190,-800
2017,1,25,23,2068,1998,1193,-805
2017,1,26,0,2122,2048,1311,-737
2017,1,26,1,2290,2147,1394,-753
2017,1,26,2,2452,2255,1482,-773
2017,1,26,3,2466,2231,1429,-802
2017,1,26,4,2436,2182,1370,-812
2017,1,26,5,2330,2103,1309,-794
2017,1,26,6,2189,1961,1157,-804
2017,1,26,7,2074,1864,987,-877
2017,1,26,8,2024,1802,975,-827
2017,1,26,9,1959,1775,933,-842
2017,1,26,10,1862,1776,931,-845
2017,1,26,11,1878,1773,918,-855
2017,1,26,12,1919,1828,942,-886
2017,1,26,13,2048,1935,1045,-890
2017,1,26,14,2268,2129,1156,-973
2017,1,26,15,2430,2276,1299,-977
2017,1,26,16,2443,2257,1326,-931
2017,1,26,17,2398,2216,1293,-923
2017,1,26,18,2336,2165,1280,-885
2017,1,26,19,2265,2082,1257,-825
2017,1,26,20,2198,2022,1201,-821
2017,1,26,21,2141,1991,1094,-897
2017,1,26,22,2097,1979,1003,-976
2017,1,26,23,2114,1954,1012,-942
2017,1,27,0,2164,2018,1093,-925
2017,1,27,1,2314,2119,1177,-942
2017,1,27,2,2467,2259,1298,-961
2017,1,27,3,2492,2258,1317,-941
2017,1,27,4,2469,2247,1293,-954
2017,1,27,5,2359,2173,1252,-921
2017,1,27,6,2212,2044,1145,-899
2017,1,27,7,2088,1934,1034,-900
2017,1,27,8,2070,1884,961,-923
2017,1,27,9,2006,1865,922,-943
2017,1,27,10,1951,1862,920,-942
2017,1,27,11,1973,1886,927,-959
2017,1,27,12,2024,1926,977,-949
2017,1,27,13,2159,2036,1094,-942
2017,1,27,14,2376,2226,1245,-981
2017,1,27,15,2534,2383,1279,-1104
2017,1,27,16,2544,2388,1298,-1090
2017,1,27,17,2481,2360,1256,-1104
2017,1,27,18,2390,2308,1230,-1078
2017,1,27,19,2300,2235,1201,-1034
2017,1,27,20,2227,2143,1143,-1000
2017,1,27,21,2165,2055,1101,-954
2017,1,27,22,2115,2002,1003,-999
2017,1,27,23,2111,2031,1021,-1010
2017,1,28,0,2147,2091,1093,-998
2017,1,28,1,2253,2180,1128,-1052
2017,1,28,2,2442,2308,1244,-1064
2017,1,28,3,2383,2276,1222,-1054
2017,1,28,4,2353,2238,1204,-1034
2017,1,28,5,2303,2175,1188,-987
2017,1,28,6,2203,2077,1114,-963
2017,1,28,7,2114,1978,997,-981
2017,1,28,8,2072,1912,1001,-911
2017,1,28,9,2100,1887,979,-908
2017,1,28,10,2002,1893,1035,-858
2017,1,28,11,2024,1897,1030,-867
2017,1,28,12,2053,1920,1046,-874
2017,1,28,13,2132,1970,1003,-967
2017,1,28,14,2256,2060,1077,-983
2017,1,28,15,2382,2169,1138,-1031
2017,1,28,16,2477,2238,1275,-963
2017,1,28,17,2489,2271,1320,-951
2017,1,28,18,2438,2238,1117,-1121
2017,1,28,19,2350,2187,1131,-1056
2017,1,28,20,2256,2099,1193,-906
2017,1,28,21,2169,2048,1188,-860
2017,1,28,22,2076,2014,1136,-878
2017,1,28,23,2088,2015,1122,-893
2017,1,29,0,2131,2062,1166,-896
2017,1,29,1,2251,2169,1266,-903
2017,1,29,2,2344,2282,1405,-877
2017,1,29,3,2396,2276,1411,-865
2017,1,29,4,2378,2234,1364,-870
2017,1,29,5,2318,2168,1303,-865
2017,1,29,6,2230,2083,1217,-866
2017,1,29,7,2134,1997,1083,-914
2017,1,29,8,2122,1928,1021,-907
2017,1,29,9,2060,1911,953,-958
2017,1,29,10,1994,1915,1018,-897
2017,1,29,11,2003,1918,1055,-863
2017,1,29,12,2024,1953,1080,-873
2017,1,29,13,2088,2015,1158,-857
2017,1,29,14,2194,2089,1270,-819
2017,1,29,15,2314,2221,1393,-828
2017,1,29,16,2400,2265,1465,-800
2017,1,29,17,2393,2226,1443,-783
2017,1,29,18,2342,2132,1330,-802
2017,1,29,19,2248,2044,1257,-787
2017,1,29,20,2177,1994,1211,-783
2017,1,29,21,2110,1924,1157,-767
2017,1,29,22,2037,1875,1142,-733
2017,1,29,23,2040,1900,1185,-715
2017,1,30,0,2074,2014,1295,-719
2017,1,30,1,2211,2179,1449,-730
2017,1,30,2,2338,2312,1466,-846
2017,1,30,3,2380,2323,1467,-856
2017,1,30,4,2355,2313,1451,-862
2017,1,30,5,2287,2235,1366,-869
2017,1,30,6,2170,2108,1245,-863
2017,1,30,7,2070,2015,1130,-885
2017,1,30,8,2042,1973,1097,-876
2017,1,30,9,2017,1965,1185,-780
2017,1,30,10,2016,1979,1090,-889
2017,1,30,11,2035,2001,1011,-990
2017,1,30,12,2081,2054,1064,-990
2017,1,30,13,2197,2170,1181,-989
2017,1,30,14,2393,2377,1319,-1058
2017,1,30,15,2543,2508,1428,-1080
2017,1,30,16,2587,2484,1413,-1071
2017,1,30,17,2516,2408,1383,-1025
2017,1,30,18,2422,2341,1303,-1038
2017,1,30,19,2322,2215,1261,-954
2017,1,30,20,2222,2097,1167,-930
2017,1,30,21,2138,2048,1124,-924
2017,1,30,22,2090,2050,1110,-940
2017,1,30,23,2071,2056,1103,-953
2017,1,31,0,2114,2121,1204,-917
2017,1,31,1,2249,2218,1276,-942
2017,1,31,2,2385,2351,1404,-947
2017,1,31,3,2395,2345,1388,-957
2017,1,31,4,2371,2307,1346,-961
2017,1,31,5,2279,2210,1225,-985
2017,1,31,6,2146,2063,1076,-987
2017,1,31,7,2038,1947,971,-976
2017,1,31,8,1987,1887,942,-945
2017,1,31,9,2009,1866,983,-883
2017,1,31,10,1959,1869,975,-894
2017,1,31,11,1965,1884,982,-902
2017,1,31,12,2016,1935,1029,-906
2017,1,31,13,2134,2038,1114,-924
2017,1,31,14,2324,2259,1313,-946
2017,1,31,15,2465,2381,1369,-1012
2017,1,31,16,2438,2355,1304,-1051
2017,1,31,17,2366,2287,1248,-1039
2017,1,31,18,2286,2228,1230,-998
2017,1,31,19,2185,2153,1237,-916
2017,1,31,20,2093,2109,1202,-907
2017,1,31,21,2018,2083,1186,-897
2017,1,31,22,1973,2075,1183,-892
2017,1,31,23,1980,2076,1181,-895
2017,2,1,0,2020,2124,1222,-902
2017,2,1,1,2115,2210,1285,-925
2017,2,1,2,2210,2291,1356,-935
2017,2,1,3,2214,2274,1349,-925
2017,2,1,4,2173,2232,1335,-897
2017,2,1,5,2077,2137,1319,-818
2017,2,1,6,1950,1980,1233,-747
2017,2,1,7,1839,1854,1065,-789
2017,2,1,8,1808,1783,941,-842
2017,2,1,9,1800,1758,1048,-710
2017,2,1,10,1823,1755,1032,-723
2017,2,1,11,1828,1766,1048,-718
2017,2,1,12,1866,1808,1084,-724
2017,2,1,13,1962,1923,1182,-741
2017,2,1,14,2148,2129,1338,-791
2017,2,1,15,2272,2257,1411,-846
2017,2,1,16,2247,2242,1372,-870
2017,2,1,17,2210,2204,1420,-784
2017,2,1,18,2178,2161,1329,-832
2017,2,1,19,2133,2077,1263,-814
2017,2,1,20,2080,2015,1195,-820
2017,2,1,21,2049,1978,1164,-814
2017,2,1,22,2048,1987,1161,-826
2017,2,1,23,2050,1990,1171,-819
2017,2,2,0,2093,2047,1225,-822
2017,2,2,1,2194,2144,1204,-940
2017,2,2,2,2317,2241,1232,-1009
2017,2,2,3,2309,2232,1210,-1022
2017,2,2,4,2275,2196,1397,-799
2017,2,2,5,2188,2101,1338,-763
2017,2,2,6,2050,1962,1247,-715
2017,2,2,7,1936,1849,1056,-793
2017,2,2,8,1847,1773,1044,-729
2017,2,2,9,1868,1775,988,-787
2017,2,2,10,1823,1761,1025,-736
2017,2,2,11,1835,1756,1037,-719
2017,2,2,12,1876,1794,1088,-706
2017,2,2,13,1992,1919,1220,-699
2017,2,2,14,2209,2113,1334,-779
2017,2,2,15,2362,2253,1381,-872
2017,2,2,16,2349,2234,1363,-871
2017,2,2,17,2295,2191,1357,-834
2017,2,2,18,2251,2123,1343,-780
2017,2,2,19,2188,2060,1275,-785
2017,2,2,20,2120,1999,1173,-826
2017,2,2,21,2068,1955,1095,-860
2017,2,2,22,2036,1942,1112,-830
2017,2,2,23,2038,1921,1082,-839
2017,2,3,0,2072,2018,1140,-878
2017,2,3,1,2161,2110,1310,-800
2017,2,3,2,2270,2231,1370,-861
2017,2,3,3,2267,2214,1402,-812
2017,2,3,4,2227,2164,1414,-750
2017,2,3,5,2131,2059,1235,-824
2017,2,3,6,1991,1897,1212,-685
2017,2,3,7,1879,1795,1242,-553
2017,2,3,8,1842,1739,1265,-474
2017,2,3,9,1837,1722,1346,-376
2017,2,3,10,1782,1727,1415,-312
2017,2,3,11,1790,1736,1368,-368
2017,2,3,12,1825,1775,1403,-372
2017,2,3,13,1924,1877,1478,-399
2017,2,3,14,2115,2054,1625,-429
2017,2,3,15,2242,2192,1718,-474
2017,2,3,16,2223,2188,1740,-448
2017,2,3,17,2174,2135,1660,-475
2017,2,3,18,2131,2105,1638,-467
2017,2,3,19,2072,2062,1607,-455
2017,2,3,20,2007,1988,1539,-449
2017,2,3,21,1959,1916,1501,-415
2017,2,3,22,1920,1881,1466,-415
2017,2,3,23,1923,1886,1451,-435
2017,2,4,0,1965,1939,1507,-432
2017,2,4,1,2010,1989,1535,-454
2017,2,4,2,2111,2089,1591,-498
2017,2,4,3,2046,2041,1508,-533
2017,2,4,4,2004,2000,1461,-539
2017,2,4,5,1939,1925,1461,-464
2017,2,4,6,1838,1826,1354,-472
2017,2,4,7,1745,1715,1265,-450
2017,2,4,8,1714,1645,1183,-462
2017,2,4,9,1684,1610,1130,-480
2017,2,4,10,1675,1579,1111,-468
2017,2,4,11,1679,1575,1133,-442
2017,2,4,12,1698,1587,1209,-378
2017,2,4,13,1749,1631,1225,-406
2017,2,4,14,1844,1714,1325,-389
2017,2,4,15,1944,1810,1439,-371
2017,2,4,16,2000,1880,1518,-362
2017,2,4,17,2020,1900,1530,-370
2017,2,4,18,2022,1871,1484,-387
2017,2,4,19,1992,1838,1466,-372
2017,2,4,20,1945,1785,1431,-354
2017,2,4,21,1903,1755,1419,-336
2017,2,4,22,1862,1743,1413,-330
2017,2,4,23,1869,1753,1419,-334
2017,2,5,0,1913,1801,1457,-344
2017,2,5,1,1988,1863,1474,-389
2017,2,5,2,2059,1944,1491,-453
2017,2,5,3,2051,1923,1454,-469
2017,2,5,4,2007,1892,1413,-479
2017,2,5,5,1945,1826,1354,-472
2017,2,5,6,1855,1732,1325,-407
2017,2,5,7,1768,1643,1303,-340
2017,2,5,8,1707,1562,1245,-317
2017,2,5,9,1650,1521,1313,-208
2017,2,5,10,1581,1516,1332,-184
2017,2,5,11,1574,1505,1313,-192
2017,2,5,12,1588,1526,1344,-182
2017,2,5,13,1632,1561,1390,-171
2017,2,5,14,1713,1627,1433,-194
2017,2,5,15,1802,1725,1458,-267
2017,2,5,16,1868,1787,1406,-381
2017,2,5,17,1874,1817,1510,-307
2017,2,5,18,1858,1824,1611,-213
2017,2,5,19,1826,1784,1616,-168
2017,2,5,20,1802,1757,1596,-161
2017,2,5,21,1783,1741,1566,-175
2017,2,5,22,1755,1728,1533,-195
2017,2,5,23,1776,1712,1507,-205
2017,2,6,0,1823,1719,1491,-228
2017,2,6,1,1908,1745,1520,-225
2017,2,6,2,1984,1816,1618,-198
2017,2,6,3,1989,1808,1515,-293
2017,2,6,4,1953,1795,1424,-371
2017,2,6,5,1872,1786,1414,-372
2017,2,6,6,1752,1665,1414,-251
2017,2,6,7,1650,1549,1310,-239
2017,2,6,8,1621,1487,1248,-239
2017,2,6,9,1546,1449,1179,-270
2017,2,6,10,1499,1455,1197,-258
2017,2,6,11,1511,1467,1206,-261
2017,2,6,12,1544,1503,1206,-297
2017,2,6,13,1634,1621,1299,-322
2017,2,6,14,1802,1809,1430,-379
2017,2,6,15,1928,1946,1545,-401
2017,2,6,16,1964,1938,1444,-494
2017,2,6,17,1947,1912,1405,-507
2017,2,6,18,1930,1885,1380,-505
2017,2,6,19,1903,1842,1419,-423
2017,2,6,20,1863,1799,1369,-430
2017,2,6,21,1838,1790,1373,-417
2017,2,6,22,1823,1747,1431,-316
2017,2,6,23,1828,1718,1452,-266
2017,2,7,0,1860,1783,1541,-242
2017,2,7,1,1931,1895,1444,-451
2017,2,7,2,2023,1991,1450,-541
2017,2,7,3,2048,1978,1438,-540
2017,2,7,4,2032,1917,1435,-482
2017,2,7,5,1966,1824,1476,-348
2017,2,7,6,1849,1680,1428,-252
2017,2,7,7,1748,1593,1327,-266
2017,2,7,8,1710,1564,1352,-212
2017,2,7,9,1656,1548,1213,-335
2017,2,7,10,1605,1540,1193,-347
2017,2,7,11,1614,1574,1223,-351
2017,2,7,12,1660,1615,1197,-418
2017,2,7,13,1773,1737,1259,-478
2017,2,7,14,1969,1944,1235,-709
2017,2,7,15,2109,2080,1378,-702
2017,2,7,16,2104,2098,1396,-702
2017,2,7,17,2078,2088,1540,-548
2017,2,7,18,2058,2078,1703,-375
2017,2,7,19,2037,1962,1695,-267
2017,2,7,20,1995,1890,1692,-198
2017,2,7,21,1954,1830,1580,-250
2017,2,7,22,1900,1778,1568,-210
2017,2,7,23,1872,1785,1581,-204
2017,2,8,0,1895,1836,1585,-251
2017,2,8,1,1962,1912,1502,-410
2017,2,8,2,2036,2036,1486,-550
2017,2,8,3,2048,2016,1546,-470
2017,2,8,4,2003,1983,1568,-415
2017,2,8,5,1920,1893,1579,-314
2017,2,8,6,1780,1761,1558,-203
2017,2,8,7,1677,1645,1568,-77
2017,2,8,8,1660,1609,1553,-56
2017,2,8,9,1623,1597,1529,-68
2017,2,8,10,1629,1594,1515,-79
2017,2,8,11,1646,1610,1482,-128
2017,2,8,12,1694,1646,1441,-205
2017,2,8,13,1811,1746,1413,-333
2017,2,8,14,2009,1941,1503,-438
2017,2,8,15,2144,2076,1622,-454
2017,2,8,16,2136,2031,1558,-473
2017,2,8,17,2093,1942,1515,-427
2017,2,8,18,2047,1889,1475,-414
2017,2,8,19,1978,1800,1444,-356
2017,2,8,20,1916,1767,1498,-269
2017,2,8,21,1863,1754,1581,-173
2017,2,8,22,1817,1774,1630,-144
2017,2,8,23,1802,1812,1681,-131
2017,2,9,0,1838,1857,1691,-166
2017,2,9,1,1903,1933,1691,-242
2017,2,9,2,2010,2010,1665,-345
2017,2,9,3,1998,1987,1568,-419
2017,2,9,4,1945,1946,1519,-427
2017,2,9,5,1857,1849,1475,-374
2017,2,9,6,1716,1714,1376,-338
2017,2,9,7,1608,1582,1494,-88
2017,2,9,8,1549,1517,1551,34
2017,2,9,9,1526,1484,1572,88
2017,2,9,10,1540,1462,1526,64
2017,2,9,11,1544,1463,1520,57
2017,2,9,12,1573,1493,1533,40
2017,2,9,13,1668,1595,1642,47
2017,2,9,14,1839,1773,1625,-148
2017,2,9,15,1959,1911,1781,-130
2017,2,9,16,1934,1906,1793,-113
2017,2,9,17,1898,1871,1831,-40
2017,2,9,18,1863,1847,1835,-12
2017,2,9,19,1825,1816,1792,-24
2017,2,9,20,1782,1783,1843,60
2017,2,9,21,1757,1771,1854,83
2017,2,9,22,1744,1763,1818,55
2017,2,9,23,1746,1779,1827,48
2017,2,10,0,1780,1809,1825,16
2017,2,10,1,1841,1880,1842,-38
2017,2,10,2,1938,1929,1787,-142
2017,2,10,3,1929,1910,1689,-221
2017,2,10,4,1888,1866,1609,-257
2017,2,10,5,1809,1787,1558,-229
2017,2,10,6,1686,1657,1463,-194
2017,2,10,7,1583,1545,1417,-128
2017,2,10,8,1516,1467,1361,-106
2017,2,10,9,1526,1428,1350,-78
2017,2,10,10,1499,1408,1396,-12
2017,2,10,11,1515,1418,1454,36
2017,2,10,12,1560,1464,1459,-5
2017,2,10,13,1676,1551,1449,-102
2017,2,10,14,1877,1727,1571,-156
2017,2,10,15,2026,1888,1685,-203
2017,2,10,16,2015,1898,1679,-219
2017,2,10,17,1986,1884,1715,-169
2017,2,10,18,1956,1826,1679,-147
2017,2,10,19,1920,1765,1664,-101
2017,2,10,20,1879,1696,1663,-33
2017,2,10,21,1851,1657,1631,-26
2017,2,10,22,1828,1647,1635,-12
2017,2,10,23,1837,1610,1570,-40
2017,2,11,0,1879,1659,1631,-28
2017,2,11,1,1915,1741,1581,-160
2017,2,11,2,2020,1840,1540,-300
2017,2,11,3,1980,1837,1559,-278
2017,2,11,4,1955,1807,1520,-287
2017,2,11,5,1906,1756,1483,-273
2017,2,11,6,1820,1680,1513,-167
2017,2,11,7,1726,1593,1387,-206
2017,2,11,8,1679,1529,1309,-220
2017,2,11,9,1639,1504,1348,-156
2017,2,11,10,1559,1486,1387,-99
2017,2,11,11,1571,1502,1523,21
2017,2,11,12,1606,1523,1528,5
2017,2,11,13,1676,1595,1624,29
2017,2,11,14,1795,1689,1775,86
2017,2,11,15,1932,1813,1819,6
2017,2,11,16,2015,1840,1823,-17
2017,2,11,17,2039,1773,1825,52
2017,2,11,18,2026,1707,1827,120
2017,2,11,19,1990,1656,1869,213
2017,2,11,20,1934,1612,1918,306
2017,2,11,21,1881,1563,1955,392
2017,2,11,22,1817,1528,1934,406
2017,2,11,23,1824,1513,1972,459
2017,2,12,0,1862,1567,1956,389
2017,2,12,1,1933,1698,1974,276
2017,2,12,2,2002,1869,1958,89
2017,2,12,3,2032,1912,1829,-83
2017,2,12,4,2007,1920,1784,-136
2017,2,12,5,1951,1885,1722,-163
2017,2,12,6,1868,1828,1679,-149
2017,2,12,7,1781,1759,1561,-198
2017,2,12,8,1764,1683,1526,-157
2017,2,12,9,1689,1654,1508,-146
2017,2,12,10,1687,1683,1513,-170
2017,2,12,11,1684,1689,1504,-185
2017,2,12,12,1708,1730,1544,-186
2017,2,12,13,1758,1779,1560,-219
2017,2,12,14,1852,1870,1689,-181
2017,2,12,15,1966,1975,1739,-236
2017,2,12,16,2024,2005,1737,-268
2017,2,12,17,2014,1915,1706,-209
2017,2,12,18,1966,1831,1736,-95
2017,2,12,19,1918,1750,1736,-14
2017,2,12,20,1876,1706,1710,4
2017,2,12,21,1838,1667,1727,60
2017,2,12,22,1795,1639,1719,80
2017,2,12,23,1778,1629,1676,47
2017,2,13,0,1800,1677,1668,-9
2017,2,13,1,1878,1819,1669,-150
2017,2,13,2,2000,1961,1655,-306
2017,2,13,3,2041,2005,1646,-359
2017,2,13,4,2032,1989,1654,-335
2017,2,13,5,1984,1915,1653,-262
2017,2,13,6,1871,1805,1648,-157
2017,2,13,7,1776,1712,1642,-70
2017,2,13,8,1689,1661,1637,-24
2017,2,13,9,1646,1667,1646,-21
2017,2,13,10,1574,1685,1644,-41
2017,2,13,11,1593,1698,1637,-61
2017,2,13,12,1640,1753,1644,-109
2017,2,13,13,1750,1887,1626,-261
2017,2,13,14,1944,2096,1626,-470
2017,2,13,15,2098,2256,1646,-610
2017,2,13,16,2114,2198,1642,-556
2017,2,13,17,2044,2073,1604,-469
2017,2,13,18,1974,1956,1580,-376
2017,2,13,19,1910,1900,1611,-289
2017,2,13,20,1843,1868,1619,-249
2017,2,13,21,1788,1806,1626,-180
2017,2,13,22,1732,1679,1607,-72
2017,2,13,23,1718,1652,1618,-34
2017,2,14,0,1740,1710,1625,-85
2017,2,14,1,1818,1825,1613,-212
2017,2,14,2,1925,2015,1645,-370
2017,2,14,3,1981,2055,1647,-408
2017,2,14,4,1977,2042,1623,-419
2017,2,14,5,1897,1983,1616,-367
2017,2,14,6,1779,1867,1614,-253
2017,2,14,7,1676,1771,1620,-151
2017,2,14,8,1695,1725,1599,-126
2017,2,14,9,1673,1704,1587,-117
2017,2,14,10,1648,1720,1592,-128
2017,2,14,11,1658,1737,1591,-146
2017,2,14,12,1700,1794,1634,-160
2017,2,14,13,1847,1911,1642,-269
2017,2,14,14,2057,2128,1652,-476
2017,2,14,15,2199,2275,1652,-623
2017,2,14,16,2170,2197,1642,-555
2017,2,14,17,2085,2033,1661,-372
2017,2,14,18,2008,1903,1642,-261
2017,2,14,19,1960,1817,1660,-157
2017,2,14,20,1906,1742,1642,-100
2017,2,14,21,1855,1690,1661,-29
2017,2,14,22,1801,1631,1683,52
2017,2,14,23,1754,1605,1660,55
2017,2,15,0,1779,1652,1664,12
2017,2,15,1,1853,1788,1710,-78
2017,2,15,2,1972,1959,1638,-321
2017,2,15,3,1991,2010,1661,-349
2017,2,15,4,1958,1988,1740,-248
2017,2,15,5,1877,1927,1807,-120
2017,2,15,6,1745,1828,1815,-13
2017,2,15,7,1650,1738,1841,103
2017,2,15,8,1629,1683,1891,208
2017,2,15,9,1612,1673,1893,220
2017,2,15,10,1699,1681,1891,210
2017,2,15,11,1719,1707,1891,184
2017,2,15,12,1772,1748,1950,202
2017,2,15,13,1878,1871,1941,70
2017,2,15,14,2067,2081,1854,-227
2017,2,15,15,2200,2201,1926,-275
2017,2,15,16,2154,2104,1853,-251
2017,2,15,17,2066,2025,1752,-273
2017,2,15,18,2000,1916,1722,-194
2017,2,15,19,1949,1822,1698,-124
2017,2,15,20,1888,1738,1768,30
2017,2,15,21,1840,1720,1834,114
2017,2,15,22,1815,1727,1839,112
2017,2,15,23,1768,1720,1822,102
2017,2,16,0,1789,1783,1886,103
2017,2,16,1,1874,1868,1865,-3
2017,2,16,2,2005,1994,1889,-105
2017,2,16,3,2008,2005,1897,-108
2017,2,16,4,1956,1966,1912,-54
2017,2,16,5,1872,1879,1881,2
2017,2,16,6,1742,1744,1861,117
2017,2,16,7,1642,1613,1901,288
2017,2,16,8,1506,1540,1935,395
2017,2,16,9,1554,1519,1951,432
2017,2,16,10,1566,1499,1892,393
2017,2,16,11,1582,1520,1864,344
2017,2,16,12,1617,1550,1874,324
2017,2,16,13,1718,1659,1810,151
2017,2,16,14,1896,1840,1834,-6
2017,2,16,15,2000,1962,1846,-116
2017,2,16,16,1947,1943,1894,-49
2017,2,16,17,1902,1920,1972,52
2017,2,16,18,1864,1890,1888,-2
2017,2,16,19,1847,1837,1920,83
2017,2,16,20,1815,1801,1887,86
2017,2,16,21,1790,1706,1775,69
2017,2,16,22,1775,1704,1745,41
2017,2,16,23,1760,1740,1660,-80
2017,2,17,0,1792,1534,1440,-94
2017,2,17,1,1867,1956,1822,-134
2017,2,17,2,1987,1921,1603,-318
2017,2,17,3,1988,1924,1566,-358
2017,2,17,4,1938,1902,1576,-326
2017,2,17,5,1855,1831,1598,-233
2017,2,17,6,1720,1730,1582,-148
2017,2,17,7,1611,1607,1572,-35
2017,2,17,8,1529,1546,1579,33
2017,2,17,9,1544,1520,1521,1
2017,2,17,10,1572,1526,1486,-40
2017,2,17,11,1595,1538,1464,-74
2017,2,17,12,1640,1585,1475,-110
2017,2,17,13,1762,1681,1461,-220
2017,2,17,14,1956,1853,1410,-443
2017,2,17,15,2074,1978,1478,-500
2017,2,17,16,2045,1947,1500,-447
2017,2,17,17,1997,1863,1585,-278
2017,2,17,18,1952,1818,1616,-202
2017,2,17,19,1918,1746,1679,-67
2017,2,17,20,1873,1740,1681,-59
2017,2,17,21,1839,1740,1863,123
2017,2,17,22,1818,1705,1830,125
2017,2,17,23,1810,1720,1810,90
2017,2,18,0,1824,1768,1830,62
2017,2,18,1,1849,1828,1851,23
2017,2,18,2,1977,1902,1936,34
2017,2,18,3,1946,1880,1941,61
2017,2,18,4,1908,1845,1949,104
2017,2,18,5,1855,1784,1979,195
2017,2,18,6,1763,1678,1994,316
2017,2,18,7,1666,1591,1992,401
2017,2,18,8,1562,1514,1906,392
2017,2,18,9,1558,1480,1798,318
2017,2,18,10,1535,1463,1809,346
2017,2,18,11,1538,1445,1731,286
2017,2,18,12,1559,1466,1828,362
2017,2,18,13,1619,1509,1837,328
2017,2,18,14,1699,1589,1835,246
2017,2,18,15,1782,1688,1887,199
2017,2,18,16,1834,1759,1921,162
2017,2,18,17,1847,1807,1880,73
2017,2,18,18,1845,1815,1835,20
2017,2,18,19,1828,1791,1888,97
2017,2,18,20,1790,1759,1895,136
2017,2,18,21,1755,1708,1826,118
2017,2,18,22,1719,1702,1818,116
2017,2,18,23,1717,1687,1770,83
2017,2,19,0,1736,1693,1843,150
2017,2,19,1,1799,1761,1796,35
2017,2,19,2,1877,1825,1670,-155
2017,2,19,3,1889,1815,1676,-139
2017,2,19,4,1850,1780,1687,-93
2017,2,19,5,1797,1731,1660,-71
2017,2,19,6,1712,1635,1628,-7
2017,2,19,7,1624,1554,1610,56
2017,2,19,8,1566,1484,1605,121
2017,2,19,9,1540,1444,1581,137
2017,2,19,10,1522,1444,1593,149
2017,2,19,11,1532,1436,1601,165
2017,2,19,12,1553,1440,1593,153
2017,2,19,13,1610,1483,1630,147
2017,2,19,14,1684,1561,1628,67
2017,2,19,15,1773,1653,1653,0
2017,2,19,16,1827,1708,1632,-76
2017,2,19,17,1842,1707,1625,-82
2017,2,19,18,1831,1684,1621,-63
2017,2,19,19,1801,1675,1616,-59
2017,2,19,20,1780,1628,1592,-36
2017,2,19,21,1754,1537,1662,125
2017,2,19,22,1732,1524,1658,134
2017,2,19,23,1733,1515,1779,264
2017,2,20,0,1748,1564,1800,236
2017,2,20,1,1812,1671,1622,-49
2017,2,20,2,1894,1771,1469,-302
2017,2,20,3,1916,1790,1475,-315
2017,2,20,4,1887,1763,1564,-199
2017,2,20,5,1825,1719,1555,-164
2017,2,20,6,1708,1612,1608,-4
2017,2,20,7,1610,1528,1649,121
2017,2,20,8,1548,1477,1681,204
2017,2,20,9,1519,1455,1646,191
2017,2,20,10,1511,1444,1696,252
2017,2,20,11,1514,1447,1752,305
2017,2,20,12,1543,1483,1740,257
2017,2,20,13,1655,1558,1803,245
2017,2,20,14,1821,1682,1812,130
2017,2,20,15,1934,1808,1832,24
2017,2,20,16,1931,1841,1778,-63
2017,2,20,17,1902,1860,1693,-167
2017,2,20,18,1884,1852,1662,-190
2017,2,20,19,1866,1834,1631,-203
2017,2,20,20,1831,1792,1612,-180
2017,2,20,21,1794,1754,1621,-133
2017,2,20,22,1774,1722,1591,-131
2017,2,20,23,1761,1733,1611,-122
2017,2,21,0,1780,1761,1573,-188
2017,2,21,1,1850,1814,1542,-272
2017,2,21,2,1938,1873,1681,-192
2017,2,21,3,1939,1869,1768,-101
2017,2,21,4,1896,1817,1714,-103
2017,2,21,5,1812,1737,1663,-74
2017,2,21,6,1691,1621,1544,-77
2017,2,21,7,1587,1510,1664,154
2017,2,21,8,1525,1438,1698,260
2017,2,21,9,1504,1387,1717,330
2017,2,21,10,1476,1379,1724,345
2017,2,21,11,1488,1376,1653,277
2017,2,21,12,1526,1417,1705,288
2017,2,21,13,1619,1520,1795,275
2017,2,21,14,1779,1698,1801,103
2017,2,21,15,1898,1839,1833,-6
2017,2,21,16,1905,1783,1861,78
2017,2,21,17,1900,1698,1864,166
2017,2,21,18,1891,1663,1893,230
2017,2,21,19,1874,1623,1879,256
2017,2,21,20,1843,1598,1946,348
2017,2,21,21,1810,1588,1914,326
2017,2,21,22,1782,1535,1918,383
2017,2,21,23,1774,1540,1994,454
2017,2,22,0,1794,1574,1971,397
2017,2,22,1,1851,1711,2043,332
2017,2,22,2,1929,1817,2016,199
2017,2,22,3,1936,1841,1941,100
2017,2,22,4,1902,1809,1886,77
2017,2,22,5,1823,1736,1844,108
2017,2,22,6,1704,1622,1764,142
2017,2,22,7,1602,1517,1752,235
2017,2,22,8,1565,1465,1699,234
2017,2,22,9,1542,1438,1616,178
2017,2,22,10,1558,1447,1590,143
2017,2,22,11,1567,1463,1588,125
2017,2,22,12,1614,1520,1601,81
2017,2,22,13,1713,1646,1666,20
2017,2,22,14,1900,1835,1751,-84
2017,2,22,15,2036,1983,1759,-224
2017,2,22,16,2033,1942,1711,-231
2017,2,22,17,2005,1877,1723,-154
2017,2,22,18,1976,1834,1717,-117
2017,2,22,19,1944,1791,1696,-95
2017,2,22,20,1903,1794,1717,-77
2017,2,22,21,1865,1876,1810,-66
2017,2,22,22,1836,1799,1748,-51
2017,2,22,23,1828,1818,1777,-41
2017,2,23,0,1856,1855,1867,12
2017,2,23,1,1921,1933,1864,-69
2017,2,23,2,2017,2038,1927,-111
2017,2,23,3,2038,2051,2038,-13
2017,2,23,4,2008,2012,2049,37
2017,2,23,5,1936,1944,2014,70
2017,2,23,6,1819,1811,1919,108
2017,2,23,7,1711,1707,1910,203
2017,2,23,8,1623,1651,1881,230
2017,2,23,9,1615,1641,1826,185
2017,2,23,10,1651,1635,1928,293
2017,2,23,11,1658,1661,1970,309
2017,2,23,12,1699,1696,1969,273
2017,2,23,13,1804,1762,1952,190
2017,2,23,14,2000,1971,1957,-14
2017,2,23,15,2129,2095,2057,-38
2017,2,23,16,2106,2075,2062,-13
2017,2,23,17,2079,2044,2084,40
2017,2,23,18,2050,2030,2101,71
2017,2,23,19,2012,1986,2106,120
2017,2,23,20,1977,1985,2105,120
2017,2,23,21,1940,1976,2134,158
2017,2,23,22,1908,1934,2105,171
2017,2,23,23,1898,1952,2129,177
2017,2,24,0,1933,2015,2130,115
2017,2,24,1,2010,2053,2135,82
2017,2,24,2,2110,2114,2123,9
2017,2,24,3,2132,2127,2075,-52
2017,2,24,4,2107,2083,2006,-77
2017,2,24,5,2032,2001,2060,59
2017,2,24,6,1913,1850,2045,195
2017,2,24,7,1806,1753,2027,274
2017,2,24,8,1698,1709,2035,326
2017,2,24,9,1720,1712,2042,330
2017,2,24,10,1756,1712,2036,324
2017,2,24,11,1771,1721,2017,296
2017,2,24,12,1809,1779,2044,265
2017,2,24,13,1913,1881,2002,121
2017,2,24,14,2118,2056,1987,-69
2017,2,24,15,2258,2183,1989,-194
2017,2,24,16,2237,2141,1952,-189
2017,2,24,17,2210,2006,1989,-17
2017,2,24,18,2172,1922,1803,-119
2017,2,24,19,2130,1877,1876,-1
2017,2,24,20,2102,1826,1875,49
2017,2,24,21,2060,1781,1954,173
2017,2,24,22,2024,1730,1925,195
2017,2,24,23,2012,1748,1859,111
2017,2,25,0,2039,1761,1824,63
2017,2,25,1,2068,1858,1758,-100
2017,2,25,2,2190,2014,1766,-248
2017,2,25,3,2195,2047,1768,-279
2017,2,25,4,2179,2028,1740,-288
2017,2,25,5,2130,1979,1743,-236
2017,2,25,6,2037,1895,1725,-170
2017,2,25,7,1942,1808,1722,-86
2017,2,25,8,1828,1739,1712,-27
2017,2,25,9,1814,1750,1595,-155
2017,2,25,10,1788,1749,1569,-180
2017,2,25,11,1785,1769,1573,-196
2017,2,25,12,1807,1794,1545,-249
2017,2,25,13,1867,1870,1573,-297
2017,2,25,14,1968,1964,1562,-402
2017,2,25,15,2072,2070,1571,-499
2017,2,25,16,2126,2048,1564,-484
2017,2,25,17,2128,1943,1558,-385
2017,2,25,18,2096,1872,1560,-312
2017,2,25,19,2053,1786,1548,-238
2017,2,25,20,2014,1699,1555,-144
2017,2,25,21,1951,1617,1530,-87
2017,2,25,22,1900,1559,1489,-70
2017,2,25,23,1886,1517,1506,-11
2017,2,26,0,1903,1580,1490,-90
2017,2,26,1,1972,1726,1604,-122
2017,2,26,2,2074,1887,1622,-265
2017,2,26,3,2128,1970,1584,-386
2017,2,26,4,2110,1966,1574,-392
2017,2,26,5,2059,1940,1573,-367
2017,2,26,6,1968,1871,1582,-289
2017,2,26,7,1881,1786,1605,-181
2017,2,26,8,1831,1725,1552,-173
2017,2,26,9,1762,1697,1586,-111
2017,2,26,10,1743,1698,1605,-93
2017,2,26,11,1744,1702,1599,-103
2017,2,26,12,1757,1717,1603,-114
2017,2,26,13,1804,1765,1638,-127
2017,2,26,14,1886,1831,1685,-146
2017,2,26,15,1970,1937,1732,-205
2017,2,26,16,2000,1965,1749,-216
2017,2,26,17,1975,1937,1735,-202
2017,2,26,18,1923,1879,1673,-206
2017,2,26,19,1871,1834,1685,-149
2017,2,26,20,1842,1802,1800,-2
2017,2,26,21,1802,1753,1781,28
2017,2,26,22,1762,1723,1796,73
2017,2,26,23,1756,1772,1795,23
2017,2,27,0,1783,1818,1792,-26
2017,2,27,1,1865,1917,1763,-154
2017,2,27,2,1977,2002,1808,-194
2017,2,27,3,2032,2032,1816,-216
2017,2,27,4,2006,2012,1788,-224
2017,2,27,5,1946,1928,1717,-211
2017,2,27,6,1826,1818,1645,-173
2017,2,27,7,1739,1707,1590,-117
2017,2,27,8,1689,1655,1561,-94
2017,2,27,9,1669,1635,1604,-31
2017,2,27,10,1696,1632,1612,-20
2017,2,27,11,1704,1650,1619,-31
2017,2,27,12,1741,1701,1598,-103
2017,2,27,13,1857,1823,1564,-259
2017,2,27,14,2035,2030,1648,-382
2017,2,27,15,2156,2172,1724,-448
2017,2,27,16,2152,2111,1762,-349
2017,2,27,17,2099,2004,1798,-206
2017,2,27,18,2051,1982,1788,-194
2017,2,27,19,2020,1923,1889,-34
2017,2,27,20,1988,1876,1921,45
2017,2,27,21,1953,1835,1898,63
2017,2,27,22,1928,1793,1881,88
2017,2,27,23,1918,1798,1853,55
2017,2,28,0,1949,1802,1806,4
2017,2,28,1,2037,1920,1805,-115
2017,2,28,2,2138,2060,1780,-280
2017,2,28,3,2189,2120,1747,-373
2017,2,28,4,2162,2088,1759,-329
2017,2,28,5,2081,2015,1760,-255
2017,2,28,6,1945,1878,1744,-134
2017,2,28,7,1825,1754,1574,-180
2017,2,28,8,1744,1705,1561,-144
2017,2,28,9,1742,1685,1601,-84
2017,2,28,10,1732,1685,1615,-70
2017,2,28,11,1743,1688,1677,-11
2017,2,28,12,1781,1732,1689,-43
2017,2,28,13,1884,1845,1644,-201
2017,2,28,14,2080,2042,1659,-383
2017,2,28,15,2208,2160,1690,-470
2017,2,28,16,2163,2096,1745,-351
2017,2,28,17,2097,1984,1711,-273
2017,2,28,18,2057,1896,1718,-178
2017,2,28,19,2016,1852,1802,-50
2017,2,28,20,1970,1822,1836,14
2017,2,28,21,1936,1741,1807,66
2017,2,28,22,1900,1724,1811,87
2017,2,28,23,1895,1707,1798,91
2017,3,1,0,1917,1712,1698,-14
2017,3,1,1,1992,1836,1852,16
2017,3,1,2,2098,1995,1825,-170
2017,3,1,3,2154,2063,1864,-199
2017,3,1,4,2130,2045,1858,-187
2017,3,1,5,2057,1970,1791,-179
2017,3,1,6,1930,1834,1741,-93
2017,3,1,7,1817,1728,1720,-8
2017,3,1,8,1765,1668,1728,60
2017,3,1,9,1734,1658,1664,6
2017,3,1,10,1719,1656,1680,24
2017,3,1,11,1731,1668,1667,-1
2017,3,1,12,1776,1712,1681,-31
2017,3,1,13,1889,1832,1694,-138
2017,3,1,14,2085,2028,1712,-316
2017,3,1,15,2210,2147,1733,-414
2017,3,1,16,2151,2047,1646,-401
2017,3,1,17,2069,1890,1639,-251
2017,3,1,18,2008,1798,1674,-124
2017,3,1,19,1967,1733,1703,-30
2017,3,1,20,1918,1647,1629,-18
2017,3,1,21,1878,1618,1632,14
2017,3,1,22,1840,1540,1599,59
2017,3,1,23,1824,1533,1630,97
2017,3,2,0,1841,1607,1642,35
2017,3,2,1,1903,1738,1644,-94
2017,3,2,2,2032,1889,1639,-250
2017,3,2,3,2106,1963,1649,-314
2017,3,2,4,2094,1944,1629,-315
2017,3,2,5,2024,1901,1633,-268
2017,3,2,6,1892,1778,1646,-132
2017,3,2,7,1784,1690,1678,-12
2017,3,2,8,1725,1636,1697,61
2017,3,2,9,1713,1630,1707,77
2017,3,2,10,1683,1631,1700,69
2017,3,2,11,1698,1650,1718,68
2017,3,2,12,1746,1711,1729,18
2017,3,2,13,1863,1822,1648,-174
2017,3,2,14,2064,2036,1766,-270
2017,3,2,15,2186,2146,2040,-106
2017,3,2,16,2119,2009,1998,-11
2017,3,2,17,2025,1846,1929,83
2017,3,2,18,1969,1751,1881,130
2017,3,2,19,1919,1678,1896,218
2017,3,2,20,1862,1623,1900,277
2017,3,2,21,1818,1609,1865,256
2017,3,2,22,1772,1586,1860,274
2017,3,2,23,1753,1606,1837,231
2017,3,3,0,1772,1648,1826,178
2017,3,3,1,1833,1728,1865,137
2017,3,3,2,1964,1865,1913,48
2017,3,3,3,2036,1928,1917,-11
2017,3,3,4,2018,1920,1946,26
2017,3,3,5,1945,1857,1975,118
2017,3,3,6,1821,1757,1956,199
2017,3,3,7,1723,1646,1950,304
2017,3,3,8,1686,1596,1940,344
2017,3,3,9,1669,1566,1947,381
2017,3,3,10,1650,1584,1913,329
2017,3,3,11,1664,1577,1887,310
2017,3,3,12,1719,1617,1881,264
2017,3,3,13,1842,1727,1864,137
2017,3,3,14,2039,1920,1882,-38
2017,3,3,15,2144,2034,1888,-146
2017,3,3,16,2067,1938,1860,-78
2017,3,3,17,1971,1789,1853,64
2017,3,3,18,1912,1693,1821,128
2017,3,3,19,1865,1637,1911,274
2017,3,3,20,1808,1566,1853,287
2017,3,3,21,1768,1557,1989,432
2017,3,3,22,1728,1542,1995,453
2017,3,3,23,1717,1604,2065,461
2017,3,4,0,1739,1647,2105,458
2017,3,4,1,1767,1712,2028,316
2017,3,4,2,1892,1783,2074,291
2017,3,4,3,1919,1815,2066,251
2017,3,4,4,1892,1792,2015,223
2017,3,4,5,1836,1727,1938,211
2017,3,4,6,1745,1655,1938,283
2017,3,4,7,1662,1556,1961,405
2017,3,4,8,1615,1503,1950,447
2017,3,4,9,1590,1463,1884,421
2017,3,4,10,1536,1451,1842,391
2017,3,4,11,1539,1444,1839,395
2017,3,4,12,1565,1466,1822,356
2017,3,4,13,1637,1515,1786,271
2017,3,4,14,1738,1604,1772,168
2017,3,4,15,1824,1694,1830,136
2017,3,4,16,1842,1750,1824,74
2017,3,4,17,1811,1799,1817,18
2017,3,4,18,1786,1755,1811,56
2017,3,4,19,1749,1658,1783,125
2017,3,4,20,1694,1590,1780,190
2017,3,4,21,1651,1497,1818,321
2017,3,4,22,1609,1461,1841,380
2017,3,4,23,1604,1501,1964,463
2017,3,5,0,1626,1528,2031,503
2017,3,5,1,1682,1588,1987,399
2017,3,5,2,1769,1685,1993,308
2017,3,5,3,1838,1759,1957,198
2017,3,5,4,1822,1735,1858,123
2017,3,5,5,1776,1684,1794,110
2017,3,5,6,1705,1616,1810,194
2017,3,5,7,1633,1534,1799,265
2017,3,5,8,1610,1479,1761,282
2017,3,5,9,1563,1457,1758,301
2017,3,5,10,1517,1445,1797,352
2017,3,5,11,1521,1445,1812,367
2017,3,5,12,1541,1461,1802,341
2017,3,5,13,1601,1506,1860,354
2017,3,5,14,1693,1578,1803,225
2017,3,5,15,1784,1674,1801,127
2017,3,5,16,1825,1742,1899,157
2017,3,5,17,1826,1765,1989,224
2017,3,5,18,1802,1732,1949,217
2017,3,5,19,1775,1694,1949,255
2017,3,5,20,1745,1670,1990,320
2017,3,5,21,1707,1661,1924,263
2017,3,5,22,1676,1657,1967,310
2017,3,5,23,1683,1647,1922,275
2017,3,6,0,1717,1664,1860,196
2017,3,6,1,1799,1792,1827,35
2017,3,6,2,1893,1880,1875,-5
2017,3,6,3,1973,1955,1940,-15
2017,3,6,4,1972,1950,2001,51
2017,3,6,5,1923,1877,1992,115
2017,3,6,6,1819,1764,1948,184
2017,3,6,7,1722,1665,1956,291
2017,3,6,8,1691,1616,1902,286
2017,3,6,9,1668,1589,1891,302
2017,3,6,10,1664,1601,1931,330
2017,3,6,11,1675,1613,1931,318
2017,3,6,12,1719,1671,1864,193
2017,3,6,13,1847,1807,1865,58
2017,3,6,14,2038,2005,1933,-72
2017,3,6,15,2175,2125,1933,-192
2017,3,6,16,2159,2037,1856,-181
2017,3,6,17,2089,1969,1892,-77
2017,3,6,18,2040,1861,1898,37
2017,3,6,19,1994,1858,1929,71
2017,3,6,20,1947,1843,1868,25
2017,3,6,21,1895,1867,1843,-24
2017,3,6,22,1863,1855,1803,-52
2017,3,6,23,1859,1863,1752,-111
2017,3,7,0,1888,1899,1752,-147
2017,3,7,1,1952,1961,1710,-251
2017,3,7,2,2048,2056,1701,-355
2017,3,7,3,2112,2099,1720,-379
2017,3,7,4,2088,2066,1777,-289
2017,3,7,5,2001,1980,1764,-216
2017,3,7,6,1864,1848,1784,-64
2017,3,7,7,1754,1718,1814,96
2017,3,7,8,1694,1668,1851,183
2017,3,7,9,1691,1635,1832,197
2017,3,7,10,1692,1626,1826,200
2017,3,7,11,1706,1633,1761,128
2017,3,7,12,1752,1674,1724,50
2017,3,7,13,1867,1792,1829,37
2017,3,7,14,2070,1977,1894,-83
2017,3,7,15,2190,2068,1877,-191
2017,3,7,16,2138,2062,1898,-164
2017,3,7,17,2060,1949,1913,-36
2017,3,7,18,1997,1858,1946,88
2017,3,7,19,1952,1774,1892,118
2017,3,7,20,1904,1775,1863,88
2017,3,7,21,1873,1719,1772,53
2017,3,7,22,1849,1745,1826,81
2017,3,7,23,1844,1792,1858,66
2017,3,8,0,1875,1814,1849,35
2017,3,8,1,1925,1882,1878,-4
2017,3,8,2,1998,1966,1928,-38
2017,3,8,3,2050,1997,1952,-45
2017,3,8,4,2003,1955,1959,4
2017,3,8,5,1911,1866,1927,61
2017,3,8,6,1777,1733,1847,114
2017,3,8,7,1663,1614,1771,157
2017,3,8,8,1590,1548,1708,160
2017,3,8,9,1576,1509,1721,212
2017,3,8,10,1565,1498,1780,282
2017,3,8,11,1579,1495,1759,264
2017,3,8,12,1622,1530,1729,199
2017,3,8,13,1727,1630,1828,198
2017,3,8,14,1919,1826,1853,27
2017,3,8,15,2024,1801,1829,28
2017,3,8,16,1983,1874,1811,-63
2017,3,8,17,1928,1809,1834,25
2017,3,8,18,1874,1729,1717,-12
2017,3,8,19,1830,1682,1708,26
2017,3,8,20,1788,1607,1803,196
2017,3,8,21,1742,1548,1800,252
2017,3,8,22,1727,1539,1847,308
2017,3,8,23,1734,1539,1826,287
2017,3,9,0,1757,1599,1831,232
2017,3,9,1,1805,1658,1845,187
2017,3,9,2,1880,1770,1825,55
2017,3,9,3,1943,1805,1830,25
2017,3,9,4,1922,1769,1835,66
2017,3,9,5,1851,1701,1868,167
2017,3,9,6,1732,1580,1824,244
2017,3,9,7,1620,1461,1753,292
2017,3,9,8,1564,1385,1762,377
2017,3,9,9,1532,1372,1670,298
2017,3,9,10,1443,1366,1630,264
2017,3,9,11,1466,1374,1611,237
2017,3,9,12,1510,1407,1628,221
2017,3,9,13,1631,1521,1643,122
2017,3,9,14,1830,1702,1625,-77
2017,3,9,15,1935,1809,1652,-157
2017,3,9,16,1901,1737,1598,-139
2017,3,9,17,1850,1681,1645,-36
2017,3,9,18,1814,1646,1640,-6
2017,3,9,19,1781,1558,1645,87
2017,3,9,20,1744,1518,1665,147
2017,3,9,21,1698,1503,1691,188
2017,3,9,22,1674,1526,1694,168
2017,3,9,23,1673,1542,1679,137
2017,3,10,0,1696,1575,1667,92
2017,3,10,1,1728,1636,1665,29
2017,3,10,2,1799,1707,1698,-9
2017,3,10,3,1850,1755,1731,-24
2017,3,10,4,1823,1729,1822,93
2017,3,10,5,1742,1648,1846,198
2017,3,10,6,1622,1538,1785,247
2017,3,10,7,1511,1429,1807,378
2017,3,10,8,1513,1368,1816,448
2017,3,10,9,1440,1342,1789,447
2017,3,10,10,1411,1312,1748,436
2017,3,10,11,1419,1312,1695,383
2017,3,10,12,1463,1347,1719,372
2017,3,10,13,1578,1451,1746,295
2017,3,10,14,1775,1636,1734,98
2017,3,10,15,1882,1749,1761,12
2017,3,10,16,1856,1743,1871,128
2017,3,10,17,1811,1713,1859,146
2017,3,10,18,1776,1673,1840,167
2017,3,10,19,1736,1610,1876,266
2017,3,10,20,1702,1545,1745,200
2017,3,10,21,1671,1519,1731,212
2017,3,10,22,1651,1486,1776,290
2017,3,10,23,1642,1438,1797,359
2017,3,11,0,1653,1397,1763,366
2017,3,11,1,1652,1479,1722,243
2017,3,11,2,1728,1581,1695,114
2017,3,11,3,1758,1678,1782,104
2017,3,11,4,1748,1660,1774,114
2017,3,11,5,1712,1624,1775,151
2017,3,11,6,1646,1546,1763,217
2017,3,11,7,1573,1470,1735,265
2017,3,11,8,1539,1414,1718,304
2017,3,11,9,1503,1399,1712,313
2017,3,11,10,1458,1390,1714,324
2017,3,11,11,1472,1403,1717,314
2017,3,11,12,1503,1428,1695,267
2017,3,11,13,1578,1499,1686,187
2017,3,11,14,1693,1589,1718,129
2017,3,11,15,1797,1654,1738,84
2017,3,11,16,1836,1597,1765,168
2017,3,11,17,1831,1571,1785,214
2017,3,11,18,1794,1591,1790,199
2017,3,11,19,1744,1533,1761,228
2017,3,11,20,1674,1399,1763,364
2017,3,11,21,1607,1369,1774,405
2017,3,11,22,1556,1398,1844,446
2017,3,11,23,1529,1433,1886,453
2017,3,12,0,1532,1483,1879,396
2017,3,12,1,1563,1556,1889,333
2017,3,12,2,1617,1626,1776,150
2017,3,12,3,1690,1671,1746,75
2017,3,12,4,1670,1648,1739,91
2017,3,12,5,1618,1599,1781,182
2017,3,12,6,1545,1522,1794,272
2017,3,12,7,1475,1431,1820,389
2017,3,12,8,1448,1375,1802,427
2017,3,12,9,-9999,1337,1891,554
2017,3,12,10,-9999,1344,1922,578
2017,3,12,11,-9999,1345,1963,618
2017,3,12,12,-9999,1388,1986,598
2017,3,12,13,-9999,1467,2001,534
2017,3,12,14,-9999,1565,1969,404
2017,3,12,15,-9999,1620,1949,329
2017,3,12,16,-9999,1609,1928,319
2017,3,12,17,-9999,1505,1895,390
2017,3,12,18,-9999,1432,1917,485
2017,3,12,19,-9999,1381,1823,442
2017,3,12,20,-9999,1339,1739,400
2017,3,12,21,-9999,1291,1715,424
2017,3,12,22,-9999,1250,1694,444
2017,3,12,23,-9999,1231,1714,483
2017,3,13,0,-9999,1278,1689,411
2017,3,13,1,-9999,1400,1649,249
2017,3,13,2,-9999,1545,1751,206
2017,3,13,3,-9999,1660,1699,39
2017,3,13,4,-9999,1627,1699,72
2017,3,13,5,-9999,1521,1705,184
2017,3,13,6,1440,1406,1677,271
2017,3,13,7,1420,1342,1725,383
2017,3,13,8,1412,1322,1717,395
2017,3,13,9,1390,1320,1714,394
2017,3,13,10,1406,1341,1721,380
2017,3,13,11,1453,1384,1705,321
2017,3,13,12,1575,1511,1675,164
2017,3,13,13,1774,1723,1868,145
2017,3,13,14,1896,1902,2051,149
2017,3,13,15,1887,1877,2033,156
2017,3,13,16,1840,1780,1986,206
2017,3,13,17,1783,1632,1847,215
2017,3,13,18,1726,1553,1705,152
2017,3,13,19,1661,1476,1691,215
2017,3,13,20,1615,1441,1718,277
2017,3,13,21,1583,1395,1717,322
2017,3,13,22,1565,1363,1719,356
2017,3,13,23,1574,1380,1693,313
2017,3,14,0,1609,1428,1679,251
2017,3,14,1,1663,1511,1804,293
2017,3,14,2,1710,1606,1872,266
2017,3,14,3,1688,1677,1889,212
2017,3,14,4,1620,1620,1864,244
2017,3,14,5,1512,1496,1780,284
2017,3,14,6,1416,1372,1780,408
2017,3,14,7,1403,1294,1685,391
2017,3,14,8,1368,1275,1711,436
2017,3,14,9,1340,1256,1689,433
2017,3,14,10,1361,1261,1586,325
2017,3,14,11,1410,1300,1660,360
2017,3,14,12,1526,1398,1770,372
2017,3,14,13,1734,1599,1854,255
2017,3,14,14,1870,1774,1839,65
2017,3,14,15,1866,1754,1862,108
2017,3,14,16,1816,1654,1850,196
2017,3,14,17,1758,1584,1745,161
2017,3,14,18,1694,1500,1695,195
2017,3,14,19,1631,1443,1717,274
2017,3,14,20,1585,1426,1722,296
2017,3,14,21,1554,1378,1687,309
2017,3,14,22,1531,1409,1697,288
2017,3,14,23,1534,1408,1682,274
2017,3,15,0,1551,1448,1679,231
2017,3,15,1,1593,1514,1678,164
2017,3,15,2,1646,1576,1765,189
2017,3,15,3,1666,1664,1815,151
2017,3,15,4,1600,1607,1789,182
2017,3,15,5,1490,1476,1742,266
2017,3,15,6,1395,1350,1782,432
2017,3,15,7,1364,1278,1818,540
2017,3,15,8,1314,1236,1799,563
2017,3,15,9,1299,1230,1830,600
2017,3,15,10,1307,1254,1836,582
2017,3,15,11,1348,1285,1814,529
2017,3,15,12,1458,1391,1849,458
2017,3,15,13,1653,1585,1856,271
2017,3,15,14,1796,1756,1836,80
2017,3,15,15,1793,1715,1804,89
2017,3,15,16,1757,1608,1768,160
2017,3,15,17,1716,1584,1724,140
2017,3,15,18,1673,1535,1710,175
2017,3,15,19,1623,1492,1696,204
2017,3,15,20,1591,1453,1705,252
2017,3,15,21,1562,1463,1719,256
2017,3,15,22,1546,1463,1733,270
2017,3,15,23,1550,1472,1697,225
2017,3,16,0,1566,1539,1723,184
2017,3,16,1,1602,1569,1702,133
2017,3,16,2,1651,1609,1667,58
2017,3,16,3,1694,1643,1693,50
2017,3,16,4,1627,1581,1768,187
2017,3,16,5,1503,1462,1717,255
2017,3,16,6,1389,1348,1760,412
2017,3,16,7,1338,1278,1704,426
2017,3,16,8,1286,1236,1516,280
2017,3,16,9,1292,1221,1495,274
2017,3,16,10,1301,1225,1518,293
2017,3,16,11,1339,1240,1508,268
2017,3,16,12,1439,1338,1480,142
2017,3,16,13,1632,1522,1616,94
2017,3,16,14,1789,1682,1897,215
2017,3,16,15,1785,1673,1940,267
2017,3,16,16,1753,1604,1900,296
2017,3,16,17,1729,1524,1916,392
2017,3,16,18,1712,1454,1832,378
2017,3,16,19,1678,1430,1741,311
2017,3,16,20,1655,1380,1809,429
2017,3,16,21,1632,1371,1786,415
2017,3,16,22,1616,1370,1714,344
2017,3,16,23,1613,1325,1665,340
2017,3,17,0,1627,1350,1614,264
2017,3,17,1,1659,1418,1574,156
2017,3,17,2,1701,1552,1636,84
2017,3,17,3,1746,1643,1669,26
2017,3,17,4,1688,1604,1655,51
2017,3,17,5,1566,1486,1612,126
2017,3,17,6,1461,1369,1614,245
2017,3,17,7,1390,1308,1609,301
2017,3,17,8,1352,1268,1617,349
2017,3,17,9,1335,1258,1621,363
2017,3,17,10,1350,1268,1635,367
2017,3,17,11,1385,1295,1648,353
2017,3,17,12,1496,1389,1657,268
2017,3,17,13,1705,1557,1668,111
2017,3,17,14,1866,1711,1694,-17
2017,3,17,15,1863,1714,1710,-4
2017,3,17,16,1817,1589,1782,193
2017,3,17,17,1766,1488,1800,312
2017,3,17,18,1718,1426,1770,344
2017,3,17,19,1660,1379,1756,377
2017,3,17,20,1612,1375,1751,376
2017,3,17,21,1578,1360,1728,368
2017,3,17,22,1549,1352,1734,382
2017,3,17,23,1539,1365,1734,369
2017,3,18,0,1509,1390,1767,377
2017,3,18,1,1532,1445,1780,335
2017,3,18,2,1554,1489,1818,329
2017,3,18,3,1598,1566,1897,331
2017,3,18,4,1552,1527,1862,335
2017,3,18,5,1467,1441,1892,451
2017,3,18,6,1374,1331,1920,589
2017,3,18,7,1312,1240,1873,633
2017,3,18,8,1265,1203,1806,603
2017,3,18,9,1247,1180,1807,627
2017,3,18,10,1250,1175,1799,624
2017,3,18,11,1264,1203,1861,658
2017,3,18,12,1312,1243,1918,675
2017,3,18,13,1408,1338,1909,571
2017,3,18,14,1529,1443,1940,497
2017,3,18,15,1584,1492,1950,458
2017,3,18,16,1602,1525,1904,379
2017,3,18,17,1592,1533,1869,336
2017,3,18,18,1562,1505,1845,340
2017,3,18,19,1520,1464,1879,415
2017,3,18,20,1486,1435,1867,432
2017,3,18,21,1461,1421,1791,370
2017,3,18,22,1443,1400,1727,327
2017,3,18,23,1442,1400,1678,278
2017,3,19,0,1455,1439,1678,239
2017,3,19,1,1468,1460,1700,240
2017,3,19,2,1508,1486,1764,278
2017,3,19,3,1562,1527,1662,135
2017,3,19,4,1530,1486,1659,173
2017,3,19,5,1451,1405,1698,293
2017,3,19,6,1367,1325,1710,385
2017,3,19,7,1314,1245,1640,395
2017,3,19,8,1266,1195,1561,366
2017,3,19,9,1251,1174,1494,320
2017,3,19,10,1253,1181,1480,299
2017,3,19,11,1267,1194,1548,354
2017,3,19,12,1309,1221,1598,377
2017,3,19,13,1392,1295,1749,454
2017,3,19,14,1514,1371,1759,388
2017,3,19,15,1584,1429,1764,335
2017,3,19,16,1617,1460,1771,311
2017,3,19,17,1617,1429,1765,336
2017,3,19,18,1603,1341,1685,344
2017,3,19,19,1586,1417,1776,359
2017,3,19,20,1564,1357,1726,369
2017,3,19,21,1546,1374,1714,340
2017,3,19,22,1527,1403,1768,365
2017,3,19,23,1524,1182,1588,406
2017,3,20,0,1548,1674,1955,281
2017,3,20,1,1557,1460,1667,207
2017,3,20,2,1583,1503,1673,170
2017,3,20,3,1627,1583,1681,98
2017,3,20,4,1583,1543,1671,128
2017,3,20,5,1478,1436,1661,225
2017,3,20,6,1377,1311,1642,331
2017,3,20,7,1295,1257,1628,371
2017,3,20,8,1251,1230,1687,457
2017,3,20,9,1252,1231,1700,469
2017,3,20,10,1260,1235,1749,514
2017,3,20,11,1293,1256,1757,501
2017,3,20,12,1389,1359,1781,422
2017,3,20,13,1556,1544,1728,184
2017,3,20,14,1696,1682,1686,4
2017,3,20,15,1688,1708,1690,-18
2017,3,20,16,1683,1682,1761,79
2017,3,20,17,1673,1674,1774,100
2017,3,20,18,1656,1631,1698,67
2017,3,20,19,1629,1586,1678,92
2017,3,20,20,1608,1547,1742,195
2017,3,20,21,1591,1503,1731,228
2017,3,20,22,1571,1422,1704,282
2017,3,20,23,1566,1314,1724,410
2017,3,21,0,1583,1321,1749,428
2017,3,21,1,1593,1399,1791,392
2017,3,21,2,1612,1526,1821,295
2017,3,21,3,1668,1617,1895,278
2017,3,21,4,1609,1562,1902,340
2017,3,21,5,1489,1449,1868,419
2017,3,21,6,1369,1335,1846,511
2017,3,21,7,1295,1251,1870,619
2017,3,21,8,1259,1192,1740,548
2017,3,21,9,1262,1192,1693,501
2017,3,21,10,1268,1195,1717,522
2017,3,21,11,1300,1239,1789,550
2017,3,21,12,1390,1337,1845,508
2017,3,21,13,1566,1497,1910,413
2017,3,21,14,1707,1637,1855,218
2017,3,21,15,1716,1631,1833,202
2017,3,21,16,1702,1621,1805,184
2017,3,21,17,1687,1569,1761,192
2017,3,21,18,1665,1501,1727,226
2017,3,21,19,1630,1410,1775,365
2017,3,21,20,1613,1407,1730,323
2017,3,21,21,1594,1428,1761,333
2017,3,21,22,1577,1414,1787,373
2017,3,21,23,1571,1443,1785,342
2017,3,22,0,1578,1524,1815,291
2017,3,22,1,1586,1514,1901,387
2017,3,22,2,1607,1571,1893,322
2017,3,22,3,1678,1615,1914,299
2017,3,22,4,1625,1557,1950,393
2017,3,22,5,1509,1443,1861,418
2017,3,22,6,1387,1347,1764,417
2017,3,22,7,1308,1290,1740,450
2017,3,22,8,1282,1271,1697,426
2017,3,22,9,1277,1258,1625,367
2017,3,22,10,1289,1262,1643,381
2017,3,22,11,1322,1303,1641,338
2017,3,22,12,1420,1400,1700,300
2017,3,22,13,1592,1578,1725,147
2017,3,22,14,1741,1697,1709,12
2017,3,22,15,1758,1667,1699,32
2017,3,22,16,1745,1556,1678,122
2017,3,22,17,1730,1518,1696,178
2017,3,22,18,1711,1478,1632,154
2017,3,22,19,1673,1418,1706,288
2017,3,22,20,1648,1336,1612,276
2017,3,22,21,1626,1327,1650,323
2017,3,22,22,1607,1349,1668,319
2017,3,22,23,1594,1420,1681,261
2017,3,23,0,1599,1460,1752,292
2017,3,23,1,1598,1451,1649,198
2017,3,23,2,1625,1590,1752,162
2017,3,23,3,1687,1622,1770,148
2017,3,23,4,1624,1588,1734,146
2017,3,23,5,1512,1437,1651,214
2017,3,23,6,1403,1328,1621,293
2017,3,23,7,1342,1243,1548,305
2017,3,23,8,1311,1256,1614,358
2017,3,23,9,1264,1214,1608,394
2017,3,23,10,1285,1231,1611,380
2017,3,23,11,1333,1273,1690,417
2017,3,23,12,1459,1387,1865,478
2017,3,23,13,1660,1587,2032,445
2017,3,23,14,1832,1744,2162,418
2017,3,23,15,1853,1643,2167,524
2017,3,23,16,1827,1593,2191,598
2017,3,23,17,1808,1471,2066,595
2017,3,23,18,1768,1420,2044,624
2017,3,23,19,1710,1357,2036,679
2017,3,23,20,1662,1377,2025,648
2017,3,23,21,1625,1337,2033,696
2017,3,23,22,1602,1309,2044,735
2017,3,23,23,1587,1294,2001,707
2017,3,24,0,1584,1268,1970,702
2017,3,24,1,1583,1342,1968,626
2017,3,24,2,1606,1505,1939,434
2017,3,24,3,1673,1638,1948,310
2017,3,24,4,1628,1619,1883,264
2017,3,24,5,1522,1534,1831,297
2017,3,24,6,1419,1421,1758,337
2017,3,24,7,1392,1368,1747,379
2017,3,24,8,1332,1377,1735,358
2017,3,24,9,1373,1362,1692,330
2017,3,24,10,1379,1376,1784,408
2017,3,24,11,1411,1387,1804,417
2017,3,24,12,1506,1496,1843,347
2017,3,24,13,1681,1660,1914,254
2017,3,24,14,1826,1792,2014,222
2017,3,24,15,1808,1760,2103,343
2017,3,24,16,1747,1722,2089,367
2017,3,24,17,1710,1671,2075,404
2017,3,24,18,1675,1642,2036,394
2017,3,24,19,1644,1553,1868,315
2017,3,24,20,1630,1605,1865,260
2017,3,24,21,1609,1530,1773,243
2017,3,24,22,1594,1548,1765,217
2017,3,24,23,1582,1584,1833,249
2017,3,25,0,1561,1628,1848,220
2017,3,25,1,1567,1636,1816,180
2017,3,25,2,1570,1676,1760,84
2017,3,25,3,1630,1680,1748,68
2017,3,25,4,1599,1640,1728,88
2017,3,25,5,1518,1551,1715,164
2017,3,25,6,1419,1455,1693,238
2017,3,25,7,1306,1402,1676,274
2017,3,25,8,1318,1358,1681,323
2017,3,25,9,1383,1352,1704,352
2017,3,25,10,1378,1339,1696,357
2017,3,25,11,1398,1352,1700,348
2017,3,25,12,1452,1411,1724,313
2017,3,25,13,1540,1504,1771,267
2017,3,25,14,1649,1598,1786,188
2017,3,25,15,1721,1634,1784,150
2017,3,25,16,1764,1608,1788,180
2017,3,25,17,1762,1472,1791,319
2017,3,25,18,1740,1409,1794,385
2017,3,25,19,1690,1339,1808,469
2017,3,25,20,1630,1299,1730,431
2017,3,25,21,1584,1278,1727,449
2017,3,25,22,1563,1255,1750,495
2017,3,25,23,1560,1241,1722,481
2017,3,26,0,1583,1304,1764,460
2017,3,26,1,1588,1290,1744,454
2017,3,26,2,1620,1442,1867,425
2017,3,26,3,1658,1555,1880,325
2017,3,26,4,1636,1550,1808,258
2017,3,26,5,1571,1486,1630,144
2017,3,26,6,1500,1407,1718,311
2017,3,26,7,1409,1362,1706,344
2017,3,26,8,1406,1343,1688,345
2017,3,26,9,1392,1334,1677,343
2017,3,26,10,1400,1349,1685,336
2017,3,26,11,1419,1372,1684,312
2017,3,26,12,1472,1424,1710,286
2017,3,26,13,1552,1500,1734,234
2017,3,26,14,1660,1583,1774,191
2017,3,26,15,1729,1553,1813,260
2017,3,26,16,1716,1437,1769,332
2017,3,26,17,1689,1348,1727,379
2017,3,26,18,1651,1342,1789,447
2017,3,26,19,1617,1314,1827,513
2017,3,26,20,1576,1384,1849,465
2017,3,26,21,1537,1428,1842,414
2017,3,26,22,1523,1428,1991,563
2017,3,26,23,1524,1411,1988,577
2017,3,27,0,1546,1405,1907,502
2017,3,27,1,1554,1467,1769,302
2017,3,27,2,1584,1549,1762,213
2017,3,27,3,1645,1615,1741,126
2017,3,27,4,1614,1601,1716,115
2017,3,27,5,1506,1498,1696,198
2017,3,27,6,1412,1381,1680,299
2017,3,27,7,1352,1328,1703,375
2017,3,27,8,1337,1323,1696,373
2017,3,27,9,1360,1298,1670,372
2017,3,27,10,1364,1332,1702,370
2017,3,27,11,1395,1337,1686,349
2017,3,27,12,1500,1439,1675,236
2017,3,27,13,1669,1591,1677,86
2017,3,27,14,1802,1717,1789,72
2017,3,27,15,1787,1695,1774,79
2017,3,27,16,1775,1669,1825,156
2017,3,27,17,1766,1634,1984,350
2017,3,27,18,1750,1645,2127,482
2017,3,27,19,1718,1650,2188,538
2017,3,27,20,1683,1631,2154,523
2017,3,27,21,1665,1585,2163,578
2017,3,27,22,1645,1554,2134,580
2017,3,27,23,1635,1433,1994,561
2017,3,28,0,1642,1501,2107,606
2017,3,28,1,1655,1564,2136,572
2017,3,28,2,1688,1675,2148,473
2017,3,28,3,1752,1772,2184,412
2017,3,28,4,1714,1756,2210,454
2017,3,28,5,1605,1647,2025,378
2017,3,28,6,1504,1542,1992,450
2017,3,28,7,1433,1467,1943,476
2017,3,28,8,1422,1385,1883,498
2017,3,28,9,1445,1379,1906,527
2017,3,28,10,1459,1414,1895,481
2017,3,28,11,1505,1440,1878,438
2017,3,28,12,1618,1554,1919,365
2017,3,28,13,1808,1751,2008,257
2017,3,28,14,1951,1879,2025,146
2017,3,28,15,1953,1787,1944,157
2017,3,28,16,1917,1629,1951,322
2017,3,28,17,1876,1530,1971,441
2017,3,28,18,1834,1489,1995,506
2017,3,28,19,1773,1451,2073,622
2017,3,28,20,1716,1445,2077,632
2017,3,28,21,1678,1401,2084,683
2017,3,28,22,1648,1368,1961,593
2017,3,28,23,1635,1371,1852,481
2017,3,29,0,1636,1398,1971,573
2017,3,29,1,1646,1456,1965,509
2017,3,29,2,1677,1542,1957,415
2017,3,29,3,1746,1659,1983,324
2017,3,29,4,1716,1618,1836,218
2017,3,29,5,1607,1522,1819,297
2017,3,29,6,1511,1419,1802,383
2017,3,29,7,1437,1363,1714,351
2017,3,29,8,1424,1348,1655,307
2017,3,29,9,1393,1345,1622,277
2017,3,29,10,1406,1350,1621,271
2017,3,29,11,1444,1391,1616,225
2017,3,29,12,1556,1478,1605,127
2017,3,29,13,1738,1637,1633,-4
2017,3,29,14,1854,1772,1712,-60
2017,3,29,15,1828,1727,1757,30
2017,3,29,16,1771,1673,1814,141
2017,3,29,17,1723,1599,1818,219
2017,3,29,18,1698,1555,1818,263
2017,3,29,19,1659,1532,1804,272
2017,3,29,20,1626,1487,1804,317
2017,3,29,21,1598,1511,1824,313
2017,3,29,22,1576,1518,1791,273
2017,3,29,23,1566,1533,1787,254
2017,3,30,0,1564,1586,1768,182
2017,3,30,1,1573,1607,1732,125
2017,3,30,2,1596,1645,1708,63
2017,3,30,3,1670,1701,1746,45
2017,3,30,4,1634,1640,1771,131
2017,3,30,5,1518,1538,1758,220
2017,3,30,6,1406,1439,1782,343
2017,3,30,7,1357,1330,1712,382
2017,3,30,8,1326,1322,1733,411
2017,3,30,9,1326,1300,1726,426
2017,3,30,10,1329,1299,1754,455
2017,3,30,11,1364,1319,1761,442
2017,3,30,12,1450,1426,1741,315
2017,3,30,13,1608,1597,1721,124
2017,3,30,14,1731,1732,1872,140
2017,3,30,15,1737,1798,1967,169
2017,3,30,16,1743,1834,2016,182
2017,3,30,17,1748,1825,2103,278
2017,3,30,18,1766,1842,2261,419
2017,3,30,19,1765,1824,2351,527
2017,3,30,20,1737,1870,2476,606
2017,3,30,21,1713,1857,2397,540
2017,3,30,22,1694,1834,2334,500
2017,3,30,23,1690,1838,2330,492
2017,3,31,0,1702,1848,2339,491
2017,3,31,1,1720,1854,2286,432
2017,3,31,2,1750,1845,2275,430
2017,3,31,3,1820,1883,2268,385
2017,3,31,4,1780,1810,2140,330
2017,3,31,5,1667,1689,2114,425
2017,3,31,6,1553,1594,2112,518
2017,3,31,7,1471,1508,2050,542
2017,3,31,8,1480,1469,2030,561
2017,3,31,9,1506,1461,2082,621
2017,3,31,10,1510,1469,2129,660
2017,3,31,11,1544,1489,2172,683
2017,3,31,12,1642,1597,2200,603
2017,3,31,13,1819,1741,2202,461
2017,3,31,14,1959,1857,2212,355
2017,3,31,15,1983,1828,2226,398
2017,3,31,16,1963,1749,2207,458
2017,3,31,17,1923,1645,2122,477
2017,3,31,18,1886,1578,2139,561
2017,3,31,19,1828,1519,2096,577
2017,3,31,20,1776,1464,2103,639
2017,3,31,21,1730,1398,2032,634
2017,3,31,22,1694,1361,2012,651
2017,3,31,23,1672,1363,2034,671
2017,4,1,0,1658,1350,2038,688
2017,4,1,1,1658,1373,2033,660
2017,4,1,2,1653,1476,2087,611
2017,4,1,3,1690,1567,2138,571
2017,4,1,4,1664,1574,2140,566
2017,4,1,5,1600,1500,2060,560
2017,4,1,6,1527,1414,2037,623
2017,4,1,7,1442,1348,1979,631
2017,4,1,8,1441,1336,1963,627
2017,4,1,9,1396,1318,1890,572
2017,4,1,10,1415,1328,1911,583
2017,4,1,11,1450,1352,1882,530
2017,4,1,12,1513,1430,1870,440
2017,4,1,13,1611,1524,1840,316
2017,4,1,14,1733,1590,1711,121
2017,4,1,15,1795,1554,1738,184
2017,4,1,16,1798,1419,1603,184
2017,4,1,17,1760,1361,1689,328
2017,4,1,18,1718,1318,1731,413
2017,4,1,19,1655,1267,1773,506
2017,4,1,20,1599,1226,1765,539
2017,4,1,21,1542,1190,1660,470
2017,4,1,22,1509,1173,1618,445
2017,4,1,23,1490,1175,1639,464
2017,4,2,0,1492,1211,1706,495
2017,4,2,1,1489,1317,1770,453
2017,4,2,2,1512,1439,1869,430
2017,4,2,3,1573,1518,1950,432
2017,4,2,4,1560,1485,1940,455
2017,4,2,5,1498,1388,1876,488
2017,4,2,6,1429,1329,1905,576
2017,4,2,7,1410,1247,1860,613
2017,4,2,8,1375,1207,1830,623
2017,4,2,9,1286,1185,1774,589
2017,4,2,10,1298,1180,1758,578
2017,4,2,11,1326,1201,1777,576
2017,4,2,12,1379,1248,1972,724
2017,4,2,13,1454,1330,2009,679
2017,4,2,14,1549,1394,2037,643
2017,4,2,15,1615,1398,1959,561
2017,4,2,16,1630,1304,1864,560
2017,4,2,17,1624,1305,2009,704
2017,4,2,18,1606,1279,2052,773
2017,4,2,19,1598,1282,2075,793
2017,4,2,20,1577,1267,2088,821
2017,4,2,21,1544,1229,2097,868
2017,4,2,22,1527,1187,2058,871
2017,4,2,23,1525,1206,2043,837
2017,4,3,0,1539,1232,2075,843
2017,4,3,1,1550,1291,2153,862
2017,4,3,2,1577,1445,2211,766
2017,4,3,3,1653,1569,2144,575
2017,4,3,4,1632,1558,2071,513
2017,4,3,5,1548,1465,2037,572
2017,4,3,6,1471,1339,2000,661
2017,4,3,7,1465,1281,1936,655
2017,4,3,8,1404,1282,1972,690
2017,4,3,9,1348,1296,1885,589
2017,4,3,10,1391,1325,1897,572
2017,4,3,11,1469,1367,1950,583
2017,4,3,12,1606,1507,1999,492
2017,4,3,13,1819,1721,1938,217
2017,4,3,14,1970,1856,2166,310
2017,4,3,15,1954,1704,2086,382
2017,4,3,16,1910,1545,2033,488
2017,4,3,17,1874,1497,2051,554
2017,4,3,18,1820,1448,2109,661
2017,4,3,19,1777,1432,2188,756
2017,4,3,20,1734,1404,2194,790
2017,4,3,21,1680,1404,2194,790
2017,4,3,22,1634,1381,2195,814
2017,4,3,23,1624,1303,2102,799
2017,4,4,0,1629,1345,2117,772
2017,4,4,1,1649,1396,2158,762
2017,4,4,2,1685,1551,2159,608
2017,4,4,3,1765,1687,2186,499
2017,4,4,4,1726,1695,2144,449
2017,4,4,5,1619,1585,2043,458
2017,4,4,6,1508,1472,1931,459
2017,4,4,7,1501,1417,1798,381
2017,4,4,8,1452,1392,1800,408
2017,4,4,9,1457,1411,1761,350
2017,4,4,10,1476,1439,1734,295
2017,4,4,11,1522,1497,1702,205
2017,4,4,12,1635,1637,1720,83
2017,4,4,13,1830,1838,1875,37
2017,4,4,14,1957,1952,1884,-68
2017,4,4,15,1910,1800,1758,-42
2017,4,4,16,1857,1643,1611,-32
2017,4,4,17,1804,1544,1507,-37
2017,4,4,18,1766,1492,1547,55
2017,4,4,19,1725,1422,1557,135
2017,4,4,20,1692,1383,1603,220
2017,4,4,21,1659,1343,1606,263
2017,4,4,22,1621,1317,1619,302
2017,4,4,23,1600,1297,1612,315
2017,4,5,0,1603,1320,1617,297
2017,4,5,1,1615,1423,1599,176
2017,4,5,2,1642,1554,1606,52
2017,4,5,3,1718,1662,1691,29
2017,4,5,4,1698,1645,1841,196
2017,4,5,5,1586,1538,1851,313
2017,4,5,6,1460,1407,1816,409
2017,4,5,7,1396,1339,1839,500
2017,4,5,8,1354,1323,1918,595
2017,4,5,9,1349,1324,1963,639
2017,4,5,10,1358,1336,1952,616
2017,4,5,11,1391,1363,1968,605
2017,4,5,12,1489,1469,2051,582
2017,4,5,13,1664,1655,2087,432
2017,4,5,14,1765,1176,1504,328
2017,4,5,15,1711,1099,1420,321
2017,4,5,16,1671,952,1372,420
2017,4,5,17,1640,1491,1973,482
2017,4,5,18,1611,1420,1913,493
2017,4,5,19,1560,1395,1927,532
2017,4,5,20,1526,1344,1928,584
2017,4,5,21,1496,1307,1899,592
2017,4,5,22,1468,1308,1916,608
2017,4,5,23,1457,1323,1941,618
2017,4,6,0,1459,1383,1922,539
2017,4,6,1,1472,1446,1979,533
2017,4,6,2,1500,1518,1942,424
2017,4,6,3,1578,1624,2055,431
2017,4,6,4,1560,1593,2162,569
2017,4,6,5,1454,1480,2192,712
2017,4,6,6,1332,1348,2150,802
2017,4,6,7,1297,1277,2125,848
2017,4,6,8,1270,1259,2147,888
2017,4,6,9,1282,1250,2116,866
2017,4,6,10,1290,1244,2117,873
2017,4,6,11,1323,1266,2086,820
2017,4,6,12,1418,1329,2041,712
2017,4,6,13,1585,1516,2140,624
2017,4,6,14,1693,1656,2254,598
2017,4,6,15,1658,1637,2217,580
2017,4,6,16,1630,1609,2172,563
2017,4,6,17,1615,1581,2174,593
2017,4,6,18,1598,1523,2170,647
2017,4,6,19,1577,1524,2126,602
2017,4,6,20,1566,1492,2011,519
2017,4,6,21,1556,1500,1946,446
2017,4,6,22,1548,1483,1834,351
2017,4,6,23,1548,1481,1864,383
2017,4,7,0,1554,1473,1897,424
2017,4,7,1,1567,1487,1919,432
2017,4,7,2,1589,1539,1925,386
2017,4,7,3,1662,1630,1865,235
2017,4,7,4,1630,1619,1853,234
2017,4,7,5,1513,1507,1804,297
2017,4,7,6,1383,1383,1844,461
2017,4,7,7,1294,1293,1940,647
2017,4,7,8,1301,1248,1783,535
2017,4,7,9,1298,1235,1675,440
2017,4,7,10,1301,1229,1676,447
2017,4,7,11,1326,1254,1627,373
2017,4,7,12,1415,1334,1695,361
2017,4,7,13,1585,1498,1954,456
2017,4,7,14,1705,1624,1959,335
2017,4,7,15,1675,1619,1982,363
2017,4,7,16,1655,1587,2120,533
2017,4,7,17,1643,1530,2060,530
2017,4,7,18,1635,1536,1925,389
2017,4,7,19,1618,1474,2004,530
2017,4,7,20,1605,1446,1941,495
2017,4,7,21,1594,1446,1921,475
2017,4,7,22,1584,1429,1946,517
2017,4,7,23,1585,1438,1990,552
2017,4,8,0,1569,1481,1920,439
2017,4,8,1,1574,1529,1914,385
2017,4,8,2,1579,1534,1781,247
2017,4,8,3,1636,1589,1711,122
2017,4,8,4,1624,1588,1746,158
2017,4,8,5,1544,1499,1735,236
2017,4,8,6,1442,1415,1792,377
2017,4,8,7,1365,1330,1804,474
2017,4,8,8,1340,1310,1794,484
2017,4,8,9,1332,1294,1818,524
2017,4,8,10,1336,1297,1767,470
2017,4,8,11,1358,1321,1780,459
2017,4,8,12,1412,1368,1807,439
2017,4,8,13,1507,1453,1896,443
2017,4,8,14,1610,1533,1745,212
2017,4,8,15,1655,1601,1832,231
2017,4,8,16,1691,1647,1876,229
2017,4,8,17,1690,1634,1911,277
2017,4,8,18,1663,1614,1957,343
2017,4,8,19,1619,1576,1951,375
2017,4,8,20,1579,1522,1971,449
2017,4,8,21,1554,1503,1844,341
2017,4,8,22,1541,1480,1801,321
2017,4,8,23,1549,1514,1824,310
2017,4,9,0,1570,1527,1794,267
2017,4,9,1,1577,1505,1916,411
2017,4,9,2,1602,1611,1986,375
2017,4,9,3,1677,1691,2075,384
2017,4,9,4,1678,1700,2164,464
2017,4,9,5,1607,1622,2162,540
2017,4,9,6,1520,1538,2161,623
2017,4,9,7,1462,1473,2113,640
2017,4,9,8,1455,1471,2164,693
2017,4,9,9,1487,1449,2137,688
2017,4,9,10,1499,1461,2123,662
2017,4,9,11,1517,1481,2078,597
2017,4,9,12,1567,1522,2112,590
2017,4,9,13,1648,1605,2108,503
2017,4,9,14,1744,1676,2133,457
2017,4,9,15,1805,1581,2029,448
2017,4,9,16,1830,1470,1955,485
2017,4,9,17,1813,1427,1941,514
2017,4,9,18,1777,1362,1920,558
2017,4,9,19,1734,1330,1891,561
2017,4,9,20,1685,1294,1884,590
2017,4,9,21,1645,1241,1837,596
2017,4,9,22,1614,1231,1785,554
2017,4,9,23,1609,1239,1760,521
2017,4,10,0,1627,1332,1841,509
2017,4,10,1,1630,1378,1806,428
2017,4,10,2,1645,1512,1808,296
2017,4,10,3,1701,1630,1832,202
2017,4,10,4,1692,1639,1845,206
2017,4,10,5,1592,1520,1828,308
2017,4,10,6,1488,1431,1866,435
2017,4,10,7,1388,1385,1933,548
2017,4,10,8,1391,1363,2047,684
2017,4,10,9,1415,1378,2097,719
2017,4,10,10,1423,1385,2133,748
2017,4,10,11,1449,1432,2119,687
2017,4,10,12,1544,1533,2055,522
2017,4,10,13,1712,1737,2017,280
2017,4,10,14,1829,1847,1897,50
2017,4,10,15,1819,1788,1809,21
2017,4,10,16,1787,1691,1774,83
2017,4,10,17,1756,1612,1733,121
2017,4,10,18,1724,1547,1712,165
2017,4,10,19,1684,1465,1709,244
2017,4,10,20,1652,1438,1697,259
2017,4,10,21,1628,1365,1680,315
2017,4,10,22,1607,1348,1656,308
2017,4,10,23,1604,1355,1661,306
2017,4,11,0,1618,1362,1632,270
2017,4,11,1,1630,1436,1691,255
2017,4,11,2,1655,1542,1687,145
2017,4,11,3,1728,1647,1676,29
2017,4,11,4,1710,1653,1683,30
2017,4,11,5,1598,1531,1656,125
2017,4,11,6,1485,1425,1663,238
2017,4,11,7,1416,1364,1678,314
2017,4,11,8,1426,1358,1732,374
2017,4,11,9,1396,1366,1741,375
2017,4,11,10,1415,1379,1744,365
2017,4,11,11,1467,1424,1740,316
2017,4,11,12,1581,1544,1747,203
2017,4,11,13,1781,1754,1755,1
2017,4,11,14,1920,1842,1733,-109
2017,4,11,15,1888,1772,1710,-62
2017,4,11,16,1840,1715,1750,35
2017,4,11,17,1798,1667,1747,80
2017,4,11,18,1747,1597,1725,128
2017,4,11,19,1694,1545,1752,207
2017,4,11,20,1654,1467,1685,218
2017,4,11,21,1619,1583,1823,240
2017,4,11,22,1586,1540,1750,210
2017,4,11,23,1574,1606,1779,173
2017,4,12,0,1574,1621,1876,255
2017,4,12,1,1581,1652,1858,206
2017,4,12,2,1600,1664,1813,149
2017,4,12,3,1674,1723,1770,47
2017,4,12,4,1659,1678,1780,102
2017,4,12,5,1535,1564,1766,202
2017,4,12,6,1412,1437,1804,367
2017,4,12,7,1378,1363,1847,484
2017,4,12,8,1358,1345,1850,505
2017,4,12,9,1368,1336,1887,551
2017,4,12,10,1379,1347,1913,566
2017,4,12,11,1410,1385,1879,494
2017,4,12,12,1498,1472,1864,392
2017,4,12,13,1677,1675,1855,180
2017,4,12,14,1790,1766,1852,86
2017,4,12,15,1775,1676,1826,150
2017,4,12,16,1742,1560,1757,197
2017,4,12,17,1708,1590,1851,261
2017,4,12,18,1680,1339,1661,322
2017,4,12,19,1643,1424,1821,397
2017,4,12,20,1625,1266,1727,461
2017,4,12,21,1608,1348,1848,500
2017,4,12,22,1594,1283,1820,537
2017,4,12,23,1598,1276,1833,557
2017,4,13,0,1612,1290,1895,605
2017,4,13,1,1616,1393,1984,591
2017,4,13,2,1625,1477,1889,412
2017,4,13,3,1679,1572,1967,395
2017,4,13,4,1648,1587,2055,468
2017,4,13,5,1520,1458,2084,626
2017,4,13,6,1396,1326,2095,769
2017,4,13,7,1323,1247,2001,754
2017,4,13,8,1293,1215,1931,716
2017,4,13,9,1270,1204,1970,766
2017,4,13,10,1281,1194,1982,788
2017,4,13,11,1314,1221,1938,717
2017,4,13,12,1412,1310,1856,546
2017,4,13,13,1602,1495,1966,471
2017,4,13,14,1711,1613,1945,332
2017,4,13,15,1702,1613,2037,424
2017,4,13,16,1694,1602,2138,536
2017,4,13,17,1686,1536,2064,528
2017,4,13,18,1672,1514,1974,460
2017,4,13,19,1654,1493,1903,410
2017,4,13,20,1643,1674,1991,317
2017,4,13,21,1629,1522,1841,319
2017,4,13,22,1616,1525,1830,305
2017,4,13,23,1613,1566,1850,284
2017,4,14,0,1620,1591,1892,301
2017,4,14,1,1633,1611,1876,265
2017,4,14,2,1643,1618,1797,179
2017,4,14,3,1712,1690,1778,88
2017,4,14,4,1700,1680,1766,86
2017,4,14,5,1578,1584,1786,202
2017,4,14,6,1457,1466,1822,356
2017,4,14,7,1406,1412,1826,414
2017,4,14,8,1383,1370,1695,325
2017,4,14,9,1410,1358,1704,346
2017,4,14,10,1412,1351,1682,331
2017,4,14,11,1447,1404,1765,361
2017,4,14,12,1547,1499,1794,295
2017,4,14,13,1744,1690,1769,79
2017,4,14,14,1873,1797,1767,-30
2017,4,14,15,1874,1813,1878,65
2017,4,14,16,1867,1806,1888,82
2017,4,14,17,1848,1772,1999,227
2017,4,14,18,1818,1697,1950,253
2017,4,14,19,1779,1630,2086,456
2017,4,14,20,1739,1589,2087,498
2017,4,14,21,1709,1550,2020,470
2017,4,14,22,1684,1542,1885,343
2017,4,14,23,1690,1498,1806,308
2017,4,15,0,1683,1522,1844,322
2017,4,15,1,1688,1473,1852,379
2017,4,15,2,1675,1577,1907,330
2017,4,15,3,1716,1699,2013,314
2017,4,15,4,1725,1751,2021,270
2017,4,15,5,1654,1693,1953,260
2017,4,15,6,1565,1614,1912,298
2017,4,15,7,1474,1551,1899,348
2017,4,15,8,1478,1507,1875,368
2017,4,15,9,1531,1506,1877,371
2017,4,15,10,1533,1518,1834,316
2017,4,15,11,1558,1539,1788,249
2017,4,15,12,1605,1611,1782,171
2017,4,15,13,1694,1697,1773,76
2017,4,15,14,1788,1751,1747,-4
2017,4,15,15,1841,1614,1732,118
2017,4,15,16,1855,1529,1677,148
2017,4,15,17,1829,1471,1664,193
2017,4,15,18,1778,1404,1678,274
2017,4,15,19,1710,1346,1704,358
2017,4,15,20,1632,1292,1702,410
2017,4,15,21,1574,1250,1723,473
2017,4,15,22,1537,1229,1718,489
2017,4,15,23,1523,1218,1695,477
2017,4,16,0,1542,1251,1760,509
2017,4,16,1,1538,1282,1725,443
2017,4,16,2,1555,1439,1773,334
2017,4,16,3,1608,1571,1787,216
2017,4,16,4,1627,1611,1836,225
2017,4,16,5,1563,1546,1845,299
2017,4,16,6,1490,1455,1820,365
2017,4,16,7,1405,1385,1803,418
2017,4,16,8,1403,1361,1801,440
2017,4,16,9,1348,1365,1815,450
2017,4,16,10,1356,1369,1804,435
2017,4,16,11,1377,1389,1810,421
2017,4,16,12,1428,1444,1823,379
2017,4,16,13,1514,1538,1848,310
2017,4,16,14,1588,1590,1886,296
2017,4,16,15,1623,1500,1768,268
2017,4,16,16,1620,1394,1713,319
2017,4,16,17,1595,1370,1834,464
2017,4,16,18,1550,1313,1875,562
2017,4,16,19,1521,1289,1932,643
2017,4,16,20,1484,1245,2010,765
2017,4,16,21,1454,1201,2007,806
2017,4,16,22,1438,1165,1955,790
2017,4,16,23,1446,1225,2015,790
2017,4,17,0,1475,1324,2106,782
2017,4,17,1,1486,1391,2074,683
2017,4,17,2,1503,1475,2107,632
2017,4,17,3,1560,1558,2103,545
2017,4,17,4,1559,1538,2075,537
2017,4,17,5,1460,1447,1985,538
2017,4,17,6,1348,1320,1938,618
2017,4,17,7,1314,1262,1930,668
2017,4,17,8,1256,1223,1955,732
2017,4,17,9,1252,1213,1882,669
2017,4,17,10,1266,1221,1871,650
2017,4,17,11,1308,1267,1821,554
2017,4,17,12,1415,1362,1840,478
2017,4,17,13,1600,1554,1829,275
2017,4,17,14,1708,1666,1810,144
2017,4,17,15,1702,1537,1671,134
2017,4,17,16,1681,1477,1667,190
2017,4,17,17,1666,1471,1747,276
2017,4,17,18,1640,1441,1726,285
2017,4,17,19,1608,1428,1710,282
2017,4,17,20,1583,1406,1665,259
2017,4,17,21,1560,1396,1667,271
2017,4,17,22,1543,1394,1655,261
2017,4,17,23,1542,1436,1656,220
2017,4,18,0,1555,1516,1669,153
2017,4,18,1,1568,2075,2208,133
2017,4,18,2,1589,1550,1611,61
2017,4,18,3,1655,1629,1677,48
2017,4,18,4,1643,1611,1709,98
2017,4,18,5,1537,1480,1720,240
2017,4,18,6,1411,1304,1704,400
2017,4,18,7,1347,1334,1824,490
2017,4,18,8,1302,1302,1815,513
2017,4,18,9,1269,1252,1757,505
2017,4,18,10,1279,1251,1769,518
2017,4,18,11,1315,1294,1746,452
2017,4,18,12,1408,1387,1693,306
2017,4,18,13,1589,1586,1716,130
2017,4,18,14,1701,1692,1624,-68
2017,4,18,15,1687,1697,1591,-106
2017,4,18,16,1676,1669,1588,-81
2017,4,18,17,1673,1552,1533,-19
2017,4,18,18,1658,1627,1641,14
2017,4,18,19,1629,1472,1524,52
2017,4,18,20,1600,1421,1455,34
2017,4,18,21,1575,1564,1636,72
2017,4,18,22,1555,1464,1632,168
2017,4,18,23,1550,1508,1652,144
2017,4,19,0,1557,1480,1692,212
2017,4,19,1,1566,1524,1705,181
2017,4,19,2,1584,1576,1747,171
2017,4,19,3,1650,1656,1801,145
2017,4,19,4,1637,1645,1772,127
2017,4,19,5,1523,1527,1791,264
2017,4,19,6,1397,1416,1745,329
2017,4,19,7,1351,1334,1749,415
2017,4,19,8,1339,1308,1732,424
2017,4,19,9,1343,1319,1764,445
2017,4,19,10,1355,1317,1750,433
2017,4,19,11,1399,1368,1734,366
2017,4,19,12,1499,1480,1723,243
2017,4,19,13,1690,1670,1669,-1
2017,4,19,14,1820,1753,1629,-124
2017,4,19,15,1804,1609,1589,-20
2017,4,19,16,1768,1478,1566,88
2017,4,19,17,1743,1434,1560,126
2017,4,19,18,1716,1387,1614,227
2017,4,19,19,1670,1346,1645,299
2017,4,19,20,1623,1335,1671,336
2017,4,19,21,1593,1337,1697,360
2017,4,19,22,1581,1410,1756,346
2017,4,19,23,1582,1334,1754,420
2017,4,20,0,1588,1359,1792,433
2017,4,20,1,1594,1375,1715,340
2017,4,20,2,1606,1454,1633,179
2017,4,20,3,1656,1578,1711,133
2017,4,20,4,1642,1756,1968,212
2017,4,20,5,1522,1513,1852,339
2017,4,20,6,1396,1402,1944,542
2017,4,20,7,1324,1332,1942,610
2017,4,20,8,1316,1302,1870,568
2017,4,20,9,1326,1293,1851,558
2017,4,20,10,1330,1300,1798,498
2017,4,20,11,1370,1312,1742,430
2017,4,20,12,1459,1446,1793,347
2017,4,20,13,1640,1619,1759,140
2017,4,20,14,1748,1747,1738,-9
2017,4,20,15,1736,1717,1726,9
2017,4,20,16,1724,1667,1890,223
2017,4,20,17,1721,1618,2066,448
2017,4,20,18,1710,1513,1997,484
2017,4,20,19,1685,1666,2191,525
2017,4,20,20,1659,1473,2055,582
2017,4,20,21,1645,1523,2091,568
2017,4,20,22,1634,1460,2074,614
2017,4,20,23,1630,1531,2078,547
2017,4,21,0,1639,1461,2120,659
2017,4,21,1,1645,1483,2098,615
2017,4,21,2,1662,1581,2091,510
2017,4,21,3,1719,1699,2046,347
2017,4,21,4,1716,1731,2111,380
2017,4,21,5,1594,1634,2002,368
2017,4,21,6,1470,1527,2102,575
2017,4,21,7,1389,1447,2002,555
2017,4,21,8,1398,1419,1907,488
2017,4,21,9,1448,1421,1892,471
2017,4,21,10,1457,1422,1954,532
2017,4,21,11,1497,1478,2071,593
2017,4,21,12,1607,1580,2041,461
2017,4,21,13,1807,1767,1975,208
2017,4,21,14,1928,1800,1967,167
2017,4,21,15,1909,1638,1848,210
2017,4,21,16,1865,1517,1789,272
2017,4,21,17,1834,1479,1796,317
2017,4,21,18,1789,1441,1777,336
2017,4,21,19,1740,1396,1742,346
2017,4,21,20,1698,1378,1746,368
2017,4,21,21,1674,1289,1699,410
2017,4,21,22,1640,1291,1698,407
2017,4,21,23,1634,1260,1677,417
2017,4,22,0,1599,1237,1735,498
2017,4,22,1,1595,1252,1755,503
2017,4,22,2,1587,1716,1994,278
2017,4,22,3,1631,1570,1815,245
2017,4,22,4,1661,1626,1807,181
2017,4,22,5,1592,1560,1729,169
2017,4,22,6,1506,1473,1702,229
2017,4,22,7,1402,1398,1664,266
2017,4,22,8,1405,1368,1678,310
2017,4,22,9,1394,1364,1745,381
2017,4,22,10,1399,1368,1771,403
2017,4,22,11,1422,1394,1837,443
2017,4,22,12,1484,1455,1869,414
2017,4,22,13,1574,1568,1976,408
2017,4,22,14,1633,1571,2002,431
2017,4,22,15,1650,1469,1880,411
2017,4,22,16,1653,1401,1901,500
2017,4,22,17,1635,1370,1968,598
2017,4,22,18,1595,1340,2010,670
2017,4,22,19,1544,1274,1976,702
2017,4,22,20,1505,1337,2058,721
2017,4,22,21,1483,1303,2043,740
2017,4,22,22,1457,1281,2005,724
2017,4,22,23,1454,1430,2096,666
2017,4,23,0,1458,1411,2125,714
2017,4,23,1,1461,1445,2156,711
2017,4,23,2,1478,1477,2133,656
2017,4,23,3,1521,1557,2106,549
2017,4,23,4,1555,1547,2067,520
2017,4,23,5,1481,1482,1992,510
2017,4,23,6,1392,1380,1896,516
2017,4,23,7,1340,1331,1895,564
2017,4,23,8,1294,1280,1753,473
2017,4,23,9,1320,1280,1664,384
2017,4,23,10,1324,1261,1698,437
2017,4,23,11,1340,1273,1736,463
2017,4,23,12,1385,1323,1836,513
2017,4,23,13,1459,1379,1740,361
2017,4,23,14,1522,1394,1664,270
2017,4,23,15,1558,1362,1670,308
2017,4,23,16,1570,1354,1673,319
2017,4,23,17,1582,1301,1617,316
2017,4,23,18,1570,1247,1552,305
2017,4,23,19,1560,1250,1553,303
2017,4,23,20,1546,1236,1563,327
2017,4,23,21,1540,1254,1613,359
2017,4,23,22,1527,1265,1635,370
2017,4,23,23,1536,1274,1668,394
2017,4,24,0,1554,1347,1736,389
2017,4,24,1,1568,1414,1878,464
2017,4,24,2,1578,1495,1946,451
2017,4,24,3,1628,1577,1917,340
2017,4,24,4,1630,1563,1753,190
2017,4,24,5,1530,1469,1711,242
2017,4,24,6,1424,1346,1710,364
2017,4,24,7,1337,1281,1694,413
2017,4,24,8,1325,1262,1746,484
2017,4,24,9,1300,1257,1719,462
2017,4,24,10,1310,1257,1694,437
2017,4,24,11,1348,1294,1686,392
2017,4,24,12,1460,1397,1683,286
2017,4,24,13,1636,1571,1685,114
2017,4,24,14,1736,1684,1623,-61
2017,4,24,15,1737,1713,1741,28
2017,4,24,16,1724,1712,1770,58
2017,4,24,17,1736,1723,1773,50
2017,4,24,18,1724,1675,1745,70
2017,4,24,19,1705,1552,1728,176
2017,4,24,20,1692,1508,1816,308
2017,4,24,21,1681,1496,1863,367
2017,4,24,22,1661,1471,1956,485
2017,4,24,23,1656,1550,2110,560
2017,4,25,0,1660,1588,2165,577
2017,4,25,1,1669,1654,2119,465
2017,4,25,2,1672,1670,2045,375
2017,4,25,3,1722,1710,1995,285
2017,4,25,4,1717,1703,1848,145
2017,4,25,5,1602,1589,1922,333
2017,4,25,6,1477,1477,1960,483
2017,4,25,7,1424,1414,2026,612
2017,4,25,8,1396,1383,1781,398
2017,4,25,9,1410,1359,1764,405
2017,4,25,10,1415,1382,1805,423
2017,4,25,11,1450,1419,1799,380
2017,4,25,12,1551,1520,1895,375
2017,4,25,13,1728,1724,2074,350
2017,4,25,14,1839,1778,2136,358
2017,4,25,15,1841,1604,2039,435
2017,4,25,16,1821,1540,2020,480
2017,4,25,17,1814,1531,2120,589
2017,4,25,18,1779,1483,2039,556
2017,4,25,19,1736,1437,2004,567
2017,4,25,20,1705,1403,1993,590
2017,4,25,21,1682,1386,2014,628
2017,4,25,22,1660,1345,1924,579
2017,4,25,23,1659,1326,1972,646
2017,4,26,0,1667,1260,1886,626
2017,4,26,1,1678,1308,1902,594
2017,4,26,2,1667,1456,1874,418
2017,4,26,3,1704,1526,1775,249
2017,4,26,4,1694,1524,1713,189
2017,4,26,5,1582,1439,1663,224
2017,4,26,6,1468,1333,1644,311
2017,4,26,7,1391,1242,1587,345
2017,4,26,8,1379,1251,1517,266
2017,4,26,9,1365,1262,1479,217
2017,4,26,10,1372,1223,1494,271
2017,4,26,11,1407,1311,1605,294
2017,4,26,12,1508,1392,1629,237
2017,4,26,13,1690,1537,1603,66
2017,4,26,14,1787,1625,1587,-38
2017,4,26,15,1774,1565,1546,-19
2017,4,26,16,1758,1484,1501,17
2017,4,26,17,1756,1556,1512,-44
2017,4,26,18,1740,1606,1565,-41
2017,4,26,19,1713,1602,1601,-1
2017,4,26,20,1696,1553,1536,-17
2017,4,26,21,1683,1553,1484,-69
2017,4,26,22,1665,1533,1593,60
2017,4,26,23,1665,1506,1539,33
2017,4,27,0,1665,1538,1635,97
2017,4,27,1,1670,1618,1722,104
2017,4,27,2,1662,1638,1827,189
2017,4,27,3,1706,1679,1826,147
2017,4,27,4,1702,1681,1880,199
2017,4,27,5,1596,1553,1818,265
2017,4,27,6,1482,1439,1799,360
2017,4,27,7,1421,1405,1778,373
2017,4,27,8,1417,1366,1933,567
2017,4,27,9,1466,1377,1973,596
2017,4,27,10,1478,1383,2000,617
2017,4,27,11,1518,1437,2084,647
2017,4,27,12,1628,1537,2001,464
2017,4,27,13,1815,1731,2031,300
2017,4,27,14,1922,1774,2070,296
2017,4,27,15,1911,1699,2120,421
2017,4,27,16,1889,1657,2216,559
2017,4,27,17,1875,1561,2145,584
2017,4,27,18,1862,1523,2124,601
2017,4,27,19,1826,1489,2123,634
2017,4,27,20,1788,1448,2087,639
2017,4,27,21,1772,1447,2083,636
2017,4,27,22,1748,1403,2010,607
2017,4,27,23,1739,1415,1994,579
2017,4,28,0,1743,1439,2016,577
2017,4,28,1,1760,1429,2023,594
2017,4,28,2,1753,1513,1963,450
2017,4,28,3,1789,1645,1940,295
2017,4,28,4,1793,1677,1887,210
2017,4,28,5,1683,1579,1883,304
2017,4,28,6,1567,1477,1888,411
2017,4,28,7,1479,1416,1753,337
2017,4,28,8,1491,1404,1998,594
2017,4,28,9,1498,1388,2069,681
2017,4,28,10,1511,1413,2077,664
2017,4,28,11,1554,1457,2115,658
2017,4,28,12,1670,1548,1956,408
2017,4,28,13,1871,1739,2090,351
2017,4,28,14,1960,1759,2049,290
2017,4,28,15,1933,1600,1955,355
2017,4,28,16,1904,1535,1930,395
2017,4,28,17,1880,1513,2025,512
2017,4,28,18,1846,1468,1978,510
2017,4,28,19,1801,1414,1851,437
2017,4,28,20,1758,1391,1865,474
2017,4,28,21,1732,1378,1995,617
2017,4,28,22,1702,1347,1981,634
2017,4,28,23,1694,1336,1974,638
2017,4,29,0,1666,1348,1965,617
2017,4,29,1,1659,1368,1980,612
2017,4,29,2,1637,1441,1910,469
2017,4,29,3,1665,1543,1902,359
2017,4,29,4,1695,1589,1900,311
2017,4,29,5,1630,1519,1892,373
2017,4,29,6,1544,1451,1974,523
2017,4,29,7,1488,1381,1954,573
2017,4,29,8,1459,1361,1893,532
2017,4,29,9,1455,1373,1961,588
2017,4,29,10,1471,1378,1957,579
2017,4,29,11,1503,1399,1842,443
2017,4,29,12,1564,1466,1799,333
2017,4,29,13,1662,1558,1775,217
2017,4,29,14,1707,1509,1612,103
2017,4,29,15,1737,1417,1660,243
2017,4,29,16,1759,1345,1514,169
2017,4,29,17,1750,1319,1529,210
2017,4,29,18,1711,1276,1605,329
2017,4,29,19,1652,1230,1604,374
2017,4,29,20,1597,1198,1586,388
2017,4,29,21,1564,1170,1576,406
2017,4,29,22,1536,1173,1574,401
2017,4,29,23,1528,1235,1705,470
2017,4,30,0,1543,1277,1704,427
2017,4,30,1,1548,1367,1699,332
2017,4,30,2,1552,1442,1621,179
2017,4,30,3,1581,1498,1651,153
2017,4,30,4,1609,1537,1702,165
2017,4,30,5,1543,1480,1648,168
2017,4,30,6,1469,1417,1686,269
2017,4,30,7,1425,1356,1634,278
2017,4,30,8,1399,1310,1605,295
2017,4,30,9,1412,1327,1644,317
2017,4,30,10,1412,1320,1636,316
2017,4,30,11,1424,1345,1656,311
2017,4,30,12,1460,1361,1626,265
2017,4,30,13,1522,1435,1621,186
2017,4,30,14,1553,1448,1548,100
2017,4,30,15,1584,1477,1616,139
2017,4,30,16,1599,1502,1657,155
2017,4,30,17,1598,1368,1593,225
2017,4,30,18,1581,1285,1671,386
2017,4,30,19,1568,1318,1615,297
2017,4,30,20,1546,1340,1633,293
2017,4,30,21,1534,1308,1620,312
2017,4,30,22,1523,1307,1683,376
2017,4,30,23,1533,1300,1655,355
2017,5,1,0,1564,1331,1673,342
2017,5,1,1,1579,1325,1684,359
2017,5,1,2,1587,1440,1868,428
2017,5,1,3,1620,1547,1924,377
2017,5,1,4,1636,1572,2082,510
2017,5,1,5,1543,1468,1997,529
2017,5,1,6,1447,1354,1899,545
2017,5,1,7,1387,1283,1791,508
2017,5,1,8,1366,1198,1749,551
2017,5,1,9,1379,1205,1754,549
2017,5,1,10,1401,1228,1710,482
2017,5,1,11,1453,1282,1892,610
2017,5,1,12,1564,1383,1903,520
2017,5,1,13,1755,1596,1965,369
2017,5,1,14,1863,1599,1965,366
2017,5,1,15,1862,1497,1910,413
2017,5,1,16,1843,1461,1889,428
2017,5,1,17,1819,1441,1895,454
2017,5,1,18,1786,1420,1918,498
2017,5,1,19,1752,1393,1917,524
2017,5,1,20,1722,1417,1924,507
2017,5,1,21,1708,1418,1851,433
2017,5,1,22,1688,1455,1917,462
2017,5,1,23,1682,1495,1944,449
2017,5,2,0,1688,1542,1930,388
2017,5,2,1,1695,1645,1907,262
2017,5,2,2,1690,1668,1862,194
2017,5,2,3,1715,1712,1824,112
2017,5,2,4,1723,1733,1776,43
2017,5,2,5,1612,1612,1782,170
2017,5,2,6,1498,1489,1780,291
2017,5,2,7,1426,1412,1797,385
2017,5,2,8,1386,1375,1787,412
2017,5,2,9,1386,1371,1779,408
2017,5,2,10,1396,1366,1801,435
2017,5,2,11,1434,1393,1773,380
2017,5,2,12,1532,1487,1777,290
2017,5,2,13,1715,1681,1851,170
2017,5,2,14,1794,1742,1934,192
2017,5,2,15,1763,1609,1860,251
2017,5,2,16,1745,1567,1902,335
2017,5,2,17,1731,1445,1979,534
2017,5,2,18,1713,1489,1988,499
2017,5,2,19,1696,1476,1957,481
2017,5,2,20,1694,1461,1988,527
2017,5,2,21,1687,1449,1986,537
2017,5,2,22,1675,1439,1887,448
2017,5,2,23,1683,1438,1895,457
2017,5,3,0,1690,1445,1903,458
2017,5,3,1,1696,1459,1895,436
2017,5,3,2,1688,1577,1916,339
2017,5,3,3,1711,1730,1962,232
2017,5,3,4,1725,1756,1979,223
2017,5,3,5,1611,1650,1860,210
2017,5,3,6,1494,1504,1793,289
2017,5,3,7,1420,1419,1839,420
2017,5,3,8,1392,1407,1862,455
2017,5,3,9,1398,1407,1818,411
2017,5,3,10,1405,1417,1818,401
2017,5,3,11,1441,1451,1737,286
2017,5,3,12,1543,1542,1639,97
2017,5,3,13,1731,1744,1674,-70
2017,5,3,14,1815,1734,1602,-132
2017,5,3,15,1782,1572,1538,-34
2017,5,3,16,1758,1523,1507,-16
2017,5,3,17,1746,1545,1584,39
2017,5,3,18,1732,1536,1614,78
2017,5,3,19,1718,1512,1572,60
2017,5,3,20,1719,1532,1581,49
2017,5,3,21,1714,1529,1597,68
2017,5,3,22,1712,1531,1585,54
2017,5,3,23,1725,1534,1581,47
2017,5,4,0,1731,1561,1593,32
2017,5,4,1,1738,1558,1595,37
2017,5,4,2,1734,1669,1570,-99
2017,5,4,3,1752,1825,1610,-215
2017,5,4,4,1761,1862,1601,-261
2017,5,4,5,1639,1753,1565,-188
2017,5,4,6,1504,1611,1562,-49
2017,5,4,7,1415,1503,1533,30
2017,5,4,8,1402,1467,1542,75
2017,5,4,9,1467,1451,1542,91
2017,5,4,10,1467,1433,1560,127
2017,5,4,11,1494,1467,1579,112
2017,5,4,12,1579,1539,1561,22
2017,5,4,13,1744,1707,1695,-12
2017,5,4,14,1803,1705,1599,-106
2017,5,4,15,1782,1599,1527,-72
2017,5,4,16,1785,1602,1711,109
2017,5,4,17,1794,1609,1747,138
2017,5,4,18,1819,1613,1810,197
2017,5,4,19,1840,1621,1784,163
2017,5,4,20,1878,1651,1779,128
2017,5,4,21,1914,1685,1804,119
2017,5,4,22,1946,1715,1766,51
2017,5,4,23,1980,1747,1758,11
2017,5,5,0,2010,1783,1754,-29
2017,5,5,1,2018,1815,1776,-39
2017,5,5,2,2007,1961,1811,-150
2017,5,5,3,1990,2083,1922,-161
2017,5,5,4,1973,2089,1981,-108
2017,5,5,5,1816,1952,1931,-21
2017,5,5,6,1650,1769,1860,91
2017,5,5,7,1492,1648,1753,105
2017,5,5,8,1522,1569,1792,223
2017,5,5,9,1563,1533,1766,233
2017,5,5,10,1540,1521,1769,248
2017,5,5,11,1551,1544,1798,254
2017,5,5,12,1619,1599,1793,194
2017,5,5,13,1767,1738,1846,108
2017,5,5,14,1832,1793,1832,39
2017,5,5,15,1854,1786,1886,100
2017,5,5,16,1886,1779,1815,36
2017,5,5,17,1922,1816,1753,-63
2017,5,5,18,1968,1870,1815,-55
2017,5,5,19,2004,1853,1817,-36
2017,5,5,20,2050,1845,1797,-48
2017,5,5,21,2077,1895,1781,-114
2017,5,5,22,2102,1920,1777,-143
2017,5,5,23,2115,1992,1787,-205
2017,5,6,0,2069,2024,1841,-183
2017,5,6,1,2022,1985,1876,-109
2017,5,6,2,1952,1945,1864,-81
2017,5,6,3,1905,1954,1885,-69
2017,5,6,4,1937,1971,1880,-91
2017,5,6,5,1849,1892,1795,-97
2017,5,6,6,1715,1765,1741,-24
2017,5,6,7,1538,1660,1592,-68
2017,5,6,8,1524,1587,1500,-87
2017,5,6,9,1546,1542,1461,-81
2017,5,6,10,1526,1521,1534,13
2017,5,6,11,1524,1519,1633,114
2017,5,6,12,1550,1560,1614,54
2017,5,6,13,1601,1607,1689,82
2017,5,6,14,1643,1665,1764,99
2017,5,6,15,1728,1720,1864,144
2017,5,6,16,1796,1710,1842,132
2017,5,6,17,1815,1706,1918,212
2017,5,6,18,1801,1699,1938,239
2017,5,6,19,1766,1644,1951,307
2017,5,6,20,1755,1620,1938,318
2017,5,6,21,1730,1610,1924,314
2017,5,6,22,1718,1655,2023,368
2017,5,6,23,1716,1764,2142,378
2017,5,7,0,1726,1769,2134,365
2017,5,7,1,1721,1777,2096,319
2017,5,7,2,1738,1792,2064,272
2017,5,7,3,1768,1849,2114,265
2017,5,7,4,1816,1831,2072,241
2017,5,7,5,1760,1765,2016,251
2017,5,7,6,1661,1656,1958,302
2017,5,7,7,1527,1584,1838,254
2017,5,7,8,1522,1540,1755,215
2017,5,7,9,1527,1533,1753,220
2017,5,7,10,1519,1522,1778,256
2017,5,7,11,1520,1530,1790,260
2017,5,7,12,1544,1565,1762,197
2017,5,7,13,1585,1634,1805,171
2017,5,7,14,1647,1683,1820,137
2017,5,7,15,1738,1712,1869,157
2017,5,7,16,1797,1775,1881,106
2017,5,7,17,1810,1755,1854,99
2017,5,7,18,1798,1641,1848,207
2017,5,7,19,1792,1583,1797,214
2017,5,7,20,1791,1531,1776,245
2017,5,7,21,1781,1497,1802,305
2017,5,7,22,1782,1481,1793,312
2017,5,7,23,1798,1500,1827,327
2017,5,8,0,1833,1502,1817,315
2017,5,8,1,1844,1518,1853,335
2017,5,8,2,1868,1617,1898,281
2017,5,8,3,1901,1761,1967,206
2017,5,8,4,1899,1821,2014,193
2017,5,8,5,1787,1716,2008,292
2017,5,8,6,1648,1596,1996,400
2017,5,8,7,1542,1521,1989,468
2017,5,8,8,1509,1492,1959,467
2017,5,8,9,1492,1482,1888,406
2017,5,8,10,1496,1487,1820,333
2017,5,8,11,1527,1523,1808,285
2017,5,8,12,1629,1643,1737,94
2017,5,8,13,1805,1802,1728,-74
2017,5,8,14,1917,1835,1716,-119
2017,5,8,15,1963,1705,1653,-52
2017,5,8,16,1971,1687,1627,-60
2017,5,8,17,1970,1664,1629,-35
2017,5,8,18,1957,1649,1599,-50
2017,5,8,19,1938,1615,1578,-37
2017,5,8,20,1934,1601,1587,-14
2017,5,8,21,1926,1596,1586,-10
2017,5,8,22,1930,1612,1594,-18
2017,5,8,23,1944,1616,1600,-16
2017,5,9,0,1959,1633,1611,-22
2017,5,9,1,1968,1645,1628,-17
2017,5,9,2,1971,1758,1668,-90
2017,5,9,3,1983,1903,1654,-249
2017,5,9,4,1990,1952,1689,-263
2017,5,9,5,1862,1830,1581,-249
2017,5,9,6,1709,1673,1603,-70
2017,5,9,7,1623,1589,1578,-11
2017,5,9,8,1574,1524,1473,-51
2017,5,9,9,1543,1500,1411,-89
2017,5,9,10,1540,1490,1388,-102
2017,5,9,11,1567,1526,1459,-67
2017,5,9,12,1658,1615,1498,-117
2017,5,9,13,1827,1775,1520,-255
2017,5,9,14,1928,1808,1563,-245
2017,5,9,15,1936,1683,1533,-150
2017,5,9,16,1950,1659,1573,-86
2017,5,9,17,1958,1609,1567,-42
2017,5,9,18,1963,1616,1635,19
2017,5,9,19,1961,1623,1698,75
2017,5,9,20,1970,1824,1959,135
2017,5,9,21,1980,1700,1849,149
2017,5,9,22,1995,1976,2042,66
2017,5,9,23,2013,1719,1759,40
2017,5,10,0,2030,1730,1842,112
2017,5,10,1,2038,1748,1733,-15
2017,5,10,2,2040,1866,1729,-137
2017,5,10,3,2038,2001,1839,-162
2017,5,10,4,2041,2024,1898,-126
2017,5,10,5,1904,1890,1861,-29
2017,5,10,6,1741,1739,1781,42
2017,5,10,7,1640,1636,1640,4
2017,5,10,8,1591,1590,1595,5
2017,5,10,9,1587,1569,1538,-31
2017,5,10,10,1577,1572,1538,-34
2017,5,10,11,1599,1585,1603,18
2017,5,10,12,1685,1674,1604,-70
2017,5,10,13,1840,1820,1610,-210
2017,5,10,14,1945,1832,1582,-250
2017,5,10,15,1970,1744,1555,-189
2017,5,10,16,1995,1950,1821,-129
2017,5,10,17,2011,1790,1629,-161
2017,5,10,18,2023,1790,1636,-154
2017,5,10,19,2032,1807,1628,-179
2017,5,10,20,2051,1825,1588,-237
2017,5,10,21,2068,1846,1589,-257
2017,5,10,22,2085,1890,1619,-271
2017,5,10,23,2109,1941,1645,-296
2017,5,11,0,2136,1967,1615,-352
2017,5,11,1,2151,2075,1721,-354
2017,5,11,2,2168,2115,1715,-400
2017,5,11,3,2159,2196,1690,-506
2017,5,11,4,2153,2206,1680,-526
2017,5,11,5,2002,2051,1640,-411
2017,5,11,6,1832,1879,1671,-208
2017,5,11,7,1686,1766,1652,-114
2017,5,11,8,1660,1704,1674,-30
2017,5,11,9,1682,1663,1694,31
2017,5,11,10,1670,1649,1717,68
2017,5,11,11,1681,1657,1773,116
2017,5,11,12,1759,1732,1822,90
2017,5,11,13,1900,1852,1830,-22
2017,5,11,14,2014,1862,1699,-163
2017,5,11,15,2068,1787,1619,-168
2017,5,11,16,2120,1753,1610,-143
2017,5,11,17,2159,1919,1805,-114
2017,5,11,18,2200,1902,1772,-130
2017,5,11,19,2233,1967,1756,-211
2017,5,11,20,2265,2016,1742,-274
2017,5,11,21,2296,2057,1711,-346
2017,5,11,22,2326,2135,1744,-391
2017,5,11,23,2358,2180,1754,-426
2017,5,12,0,2374,2210,1736,-474
2017,5,12,1,2396,2238,1773,-465
2017,5,12,2,2394,2246,1816,-430
2017,5,12,3,2343,2271,1885,-386
2017,5,12,4,2342,2266,1871,-395
2017,5,12,5,2181,2139,1844,-295
2017,5,12,6,1998,1955,1858,-97
2017,5,12,7,1802,1831,1822,-9
2017,5,12,8,1767,1735,1730,-5
2017,5,12,9,1703,1690,1787,97
2017,5,12,10,1674,1654,1860,206
2017,5,12,11,1675,1660,1819,159
2017,5,12,12,1742,1720,1837,117
2017,5,12,13,1882,1841,1908,67
2017,5,12,14,1984,1921,1906,-15
2017,5,12,15,2020,1907,1851,-56
2017,5,12,16,2048,1929,1803,-126
2017,5,12,17,2066,1949,1877,-72
2017,5,12,18,2070,1938,2052,114
2017,5,12,19,2067,1919,2050,131
2017,5,12,20,2052,1937,2097,160
2017,5,12,21,2037,1953,2071,118
2017,5,12,22,2024,1955,2039,84
2017,5,12,23,2006,1920,2070,150
2017,5,13,0,1930,1888,1924,36
2017,5,13,1,1911,1894,1928,34
2017,5,13,2,1908,1904,2008,104
2017,5,13,3,1894,1917,1929,12
2017,5,13,4,1955,1974,1909,-65
2017,5,13,5,1901,1900,1871,-29
2017,5,13,6,1787,1790,1857,67
2017,5,13,7,1702,1729,1863,134
2017,5,13,8,1650,1680,1843,163
2017,5,13,9,1658,1674,1818,144
2017,5,13,10,1649,1675,1847,172
2017,5,13,11,1651,1706,1896,190
2017,5,13,12,1678,1741,1905,164
2017,5,13,13,1717,1807,1950,143
2017,5,13,14,1792,1811,1956,145
2017,5,13,15,1901,1731,1817,86
2017,5,13,16,1965,1743,1867,124
2017,5,13,17,1984,1731,1851,120
2017,5,13,18,1975,1726,1927,201
2017,5,13,19,1953,1762,1956,194
2017,5,13,20,1928,1730,1863,133
2017,5,13,21,1906,1656,1829,173
2017,5,13,22,1906,1618,1717,99
2017,5,13,23,1894,1647,1749,102
2017,5,14,0,1891,1673,1804,131
2017,5,14,1,1890,1696,1768,72
2017,5,14,2,1896,1757,1780,23
2017,5,14,3,1898,1912,1797,-115
2017,5,14,4,1936,1965,1781,-184
2017,5,14,5,1873,1898,1778,-120
2017,5,14,6,1773,1791,1755,-36
2017,5,14,7,1671,1717,1741,24
2017,5,14,8,1682,1675,1675,0
2017,5,14,9,1689,1652,1670,18
2017,5,14,10,1689,1645,1675,30
2017,5,14,11,1702,1648,1652,4
2017,5,14,12,1738,1688,1681,-7
2017,5,14,13,1783,1737,1735,-2
2017,5,14,14,1860,1664,1639,-25
2017,5,14,15,1948,1588,1620,32
2017,5,14,16,1980,1607,1620,13
2017,5,14,17,1972,1595,1674,79
2017,5,14,18,1943,1572,1701,129
2017,5,14,19,1936,1542,1680,138
2017,5,14,20,1919,1526,1657,131
2017,5,14,21,1908,1490,1647,157
2017,5,14,22,1901,1462,1654,192
2017,5,14,23,1900,1511,1716,205
2017,5,15,0,1922,1605,1785,180
2017,5,15,1,1938,1602,1792,190
2017,5,15,2,1955,1641,1775,134
2017,5,15,3,1966,1772,1837,65
2017,5,15,4,1988,1837,1882,45
2017,5,15,5,1886,1757,1850,93
2017,5,15,6,1754,1648,1832,184
2017,5,15,7,1668,1579,1759,180
2017,5,15,8,1619,1544,1633,89
2017,5,15,9,1564,1544,1581,37
2017,5,15,10,1571,1547,1606,59
2017,5,15,11,1614,1576,1599,23
2017,5,15,12,1728,1681,1677,-4
2017,5,15,13,1915,1863,1848,-15
2017,5,15,14,2034,1903,1928,25
2017,5,15,15,2073,1805,1903,98
2017,5,15,16,2061,1785,1888,103
2017,5,15,17,2037,1765,1907,142
2017,5,15,18,2016,1745,1879,134
2017,5,15,19,1996,1726,1877,151
2017,5,15,20,1989,1722,1883,161
2017,5,15,21,1982,1712,1883,171
2017,5,15,22,1976,1710,1899,189
2017,5,15,23,1978,1731,1944,213
2017,5,16,0,1978,1738,1929,191
2017,5,16,1,1983,1731,1936,205
2017,5,16,2,1986,1831,1890,59
2017,5,16,3,1985,1968,1973,5
2017,5,16,4,2004,2034,1935,-99
2017,5,16,5,1893,1928,1856,-72
2017,5,16,6,1752,1786,1795,9
2017,5,16,7,1727,1690,1754,64
2017,5,16,8,1667,1669,1757,88
2017,5,16,9,1656,1647,1743,96
2017,5,16,10,1655,1645,1760,115
2017,5,16,11,1682,1667,1745,78
2017,5,16,12,1772,1767,1762,-5
2017,5,16,13,1933,1922,1773,-149
2017,5,16,14,2043,2016,1799,-217
2017,5,16,15,2057,2038,1761,-277
2017,5,16,16,2068,2014,1803,-211
2017,5,16,17,2064,1983,1895,-88
2017,5,16,18,2052,1935,2008,73
2017,5,16,19,2038,1943,1992,49
2017,5,16,20,2026,1957,2003,46
2017,5,16,21,2011,1946,1948,2
2017,5,16,22,1997,1929,1855,-74
2017,5,16,23,1986,1979,1881,-98
2017,5,17,0,1982,2050,1809,-241
2017,5,17,1,1980,2067,1814,-253
2017,5,17,2,1977,2054,1868,-186
2017,5,17,3,1984,2035,2114,79
2017,5,17,4,2023,2015,2147,132
2017,5,17,5,1928,1893,2074,181
2017,5,17,6,1799,1754,2026,272
2017,5,17,7,1722,1689,1908,219
2017,5,17,8,1721,1658,1991,333
2017,5,17,9,1681,1656,2020,364
2017,5,17,10,1688,1655,2149,494
2017,5,17,11,1727,1688,2143,455
2017,5,17,12,1833,1790,2106,316
2017,5,17,13,2019,1958,2198,240
2017,5,17,14,2145,2005,2225,220
2017,5,17,15,2161,1896,2224,328
2017,5,17,16,2156,1865,2219,354
2017,5,17,17,2137,1848,2218,370
2017,5,17,18,2110,1827,2198,371
2017,5,17,19,2084,1805,2179,374
2017,5,17,20,2064,1781,2157,376
2017,5,17,21,2040,1791,2166,375
2017,5,17,22,2022,1817,2181,364
2017,5,17,23,2018,1842,2167,325
2017,5,18,0,2029,1858,2186,328
2017,5,18,1,2027,1862,2192,330
2017,5,18,2,2020,1847,2184,337
2017,5,18,3,2017,1869,2103,234
2017,5,18,4,2034,1901,2030,129
2017,5,18,5,1929,1784,1922,138
2017,5,18,6,1798,1667,1826,159
2017,5,18,7,1738,1594,1846,252
2017,5,18,8,1691,1561,1833,272
2017,5,18,9,1589,1548,1829,281
2017,5,18,10,1590,1547,1786,239
2017,5,18,11,1626,1586,1780,194
2017,5,18,12,1735,1671,1795,124
2017,5,18,13,1917,1846,1788,-58
2017,5,18,14,2016,1839,1765,-74
2017,5,18,15,2006,1710,1589,-121
2017,5,18,16,2002,1624,1594,-30
2017,5,18,17,1991,1582,1611,29
2017,5,18,18,1976,1564,1609,45
2017,5,18,19,1966,1527,1617,90
2017,5,18,20,1966,1510,1594,84
2017,5,18,21,1961,1530,1632,102
2017,5,18,22,1960,1546,1683,137
2017,5,18,23,1982,1570,1664,94
2017,5,19,0,1999,1579,1679,100
2017,5,19,1,2006,1582,1628,46
2017,5,19,2,1994,1623,1686,63
2017,5,19,3,1979,1755,1833,78
2017,5,19,4,1970,1817,1951,134
2017,5,19,5,1848,1737,1925,188
2017,5,19,6,1708,1589,1849,260
2017,5,19,7,1708,1510,1797,287
2017,5,19,8,1609,1477,1790,313
2017,5,19,9,1488,1452,1760,308
2017,5,19,10,1483,1458,1775,317
2017,5,19,11,1519,1479,1791,312
2017,5,19,12,1617,1569,1802,233
2017,5,19,13,1793,1703,1736,33
2017,5,19,14,1874,1711,1643,-68
2017,5,19,15,1856,1627,1648,21
2017,5,19,16,1849,1627,1618,-9
2017,5,19,17,1854,1613,1522,-91
2017,5,19,18,1855,1587,1588,1
2017,5,19,19,1856,1602,1619,17
2017,5,19,20,1875,1589,1643,54
2017,5,19,21,1895,1584,1660,76
2017,5,19,22,1912,1551,1665,114
2017,5,19,23,1945,1572,1592,20
2017,5,20,0,1928,1624,1699,75
2017,5,20,1,1930,1647,1747,100
2017,5,20,2,1916,1716,1757,41
2017,5,20,3,1912,1865,1781,-84
2017,5,20,4,1906,1927,1811,-116
2017,5,20,5,1819,1880,1726,-154
2017,5,20,6,1689,1763,1707,-56
2017,5,20,7,1699,1660,1693,33
2017,5,20,8,1585,1631,1714,83
2017,5,20,9,1606,1598,1713,115
2017,5,20,10,1600,1582,1718,136
2017,5,20,11,1608,1608,1705,97
2017,5,20,12,1643,1648,1737,89
2017,5,20,13,1689,1679,1741,62
2017,5,20,14,1741,1656,1671,15
2017,5,20,15,1824,1593,1648,55
2017,5,20,16,1870,1588,1677,89
2017,5,20,17,1887,1616,1651,35
2017,5,20,18,1882,1603,1631,28
2017,5,20,19,1869,1619,1691,72
2017,5,20,20,1862,1665,1698,33
2017,5,20,21,1861,1693,1670,-23
2017,5,20,22,1869,1752,1700,-52
2017,5,20,23,1900,1835,1713,-122
2017,5,21,0,1952,1853,1683,-170
2017,5,21,1,1974,1857,1646,-211
2017,5,21,2,1975,1932,1685,-247
2017,5,21,3,1964,1954,1761,-193
2017,5,21,4,1946,1983,1867,-116
2017,5,21,5,1853,1925,1807,-118
2017,5,21,6,1729,1826,1730,-96
2017,5,21,7,1618,1719,1658,-61
2017,5,21,8,1586,1663,1674,11
2017,5,21,9,1656,1645,1758,113
2017,5,21,10,1635,1617,1765,148
2017,5,21,11,1637,1621,1712,91
2017,5,21,12,1664,1630,1670,40
2017,5,21,13,1676,1640,1662,22
2017,5,21,14,1733,1571,1603,32
2017,5,21,15,1815,1474,1472,-2
2017,5,21,16,1864,1533,1579,46
2017,5,21,17,1886,1552,1620,68
2017,5,21,18,1875,1547,1621,74
2017,5,21,19,1887,1578,1613,35
2017,5,21,20,1907,1594,1573,-21
2017,5,21,21,1917,1618,1491,-127
2017,5,21,22,1941,1633,1515,-118
2017,5,21,23,1981,1663,1528,-135
2017,5,22,0,2035,1713,1520,-193
2017,5,22,1,2064,1749,1546,-203
2017,5,22,2,2079,1863,1674,-189
2017,5,22,3,2085,1988,1717,-271
2017,5,22,4,2066,2024,1767,-257
2017,5,22,5,1947,1934,1789,-145
2017,5,22,6,1794,1779,1722,-57
2017,5,22,7,1606,1665,1713,48
2017,5,22,8,1588,1600,1716,116
2017,5,22,9,1609,1565,1681,116
2017,5,22,10,1596,1550,1639,89
2017,5,22,11,1620,1584,1645,61
2017,5,22,12,1709,1663,1622,-41
2017,5,22,13,1853,1807,1646,-161
2017,5,22,14,1959,1785,1622,-163
2017,5,22,15,1981,1736,1609,-127
2017,5,22,16,2009,1768,1600,-168
2017,5,22,17,2034,1796,1596,-200
2017,5,22,18,2048,1833,1581,-252
2017,5,22,19,2072,1909,1624,-285
2017,5,22,20,2109,1935,1642,-293
2017,5,22,21,2138,1984,1708,-276
2017,5,22,22,2163,2010,1732,-278
2017,5,22,23,2200,2050,1754,-296
2017,5,23,0,2239,2080,1786,-294
2017,5,23,1,2264,2093,1738,-355
2017,5,23,2,2267,2163,1747,-416
2017,5,23,3,2244,2291,1815,-476
2017,5,23,4,2192,2284,1892,-392
2017,5,23,5,2043,2155,1794,-361
2017,5,23,6,1855,1962,1756,-206
2017,5,23,7,1730,1834,1750,-84
2017,5,23,8,1690,1795,1684,-111
2017,5,23,9,1735,1750,1614,-136
2017,5,23,10,1709,1725,1607,-118
2017,5,23,11,1720,1755,1604,-151
2017,5,23,12,1796,1813,1634,-179
2017,5,23,13,1924,1921,1701,-220
2017,5,23,14,2036,1918,1646,-272
2017,5,23,15,2077,1882,1620,-262
2017,5,23,16,2129,1914,1633,-281
2017,5,23,17,2173,1953,1682,-271
2017,5,23,18,2209,1991,1673,-318
2017,5,23,19,2271,2025,1664,-361
2017,5,23,20,2314,2089,1669,-420
2017,5,23,21,2353,2161,1748,-413
2017,5,23,22,2390,2215,1750,-465
2017,5,23,23,2423,2295,1772,-523
2017,5,24,0,2453,2346,1788,-558
2017,5,24,1,2475,2374,1793,-581
2017,5,24,2,2480,2467,1814,-653
2017,5,24,3,2431,2574,1824,-750
2017,5,24,4,2343,2564,1772,-792
2017,5,24,5,2166,2410,1635,-775
2017,5,24,6,1955,2221,1692,-529
2017,5,24,7,1817,2079,1668,-411
2017,5,24,8,1842,1987,1668,-319
2017,5,24,9,1986,1929,1716,-213
2017,5,24,10,1952,1887,1728,-159
2017,5,24,11,1957,1889,1774,-115
2017,5,24,12,2007,1943,1864,-79
2017,5,24,13,2097,2053,1970,-83
2017,5,24,14,2220,2065,1994,-71
2017,5,24,15,2274,2024,1987,-37
2017,5,24,16,2310,2038,2114,76
2017,5,24,17,2322,2063,2156,93
2017,5,24,18,2317,2085,2145,60
2017,5,24,19,2336,2077,2147,70
2017,5,24,20,2353,2076,2146,70
2017,5,24,21,2359,2117,2161,44
2017,5,24,22,2359,2116,2167,51
2017,5,24,23,2368,2150,2146,-4
2017,5,25,0,2352,2166,2151,-15
2017,5,25,1,2341,2148,2137,-11
2017,5,25,2,2319,2166,2050,-116
2017,5,25,3,2288,2255,2112,-143
2017,5,25,4,2263,2277,2172,-105
2017,5,25,5,2208,2184,2118,-66
2017,5,25,6,2071,2028,2069,41
2017,5,25,7,1740,1920,1948,28
2017,5,25,8,1808,1868,1938,70
2017,5,25,9,1830,1823,1902,79
2017,5,25,10,1797,1821,1897,76
2017,5,25,11,1803,1838,1861,23
2017,5,25,12,1864,1910,1842,-68
2017,5,25,13,1987,2031,1940,-91
2017,5,25,14,2116,2045,1750,-295
2017,5,25,15,2169,1987,1698,-289
2017,5,25,16,2192,2001,1691,-310
2017,5,25,17,2198,2017,1717,-300
2017,5,25,18,2190,2017,1687,-330
2017,5,25,19,2185,1994,1674,-320
2017,5,25,20,2180,2015,1655,-360
2017,5,25,21,2190,2032,1587,-445
2017,5,25,22,2202,2059,1570,-489
2017,5,25,23,2233,2093,1600,-493
2017,5,26,0,2243,2166,1724,-442
2017,5,26,1,2249,2237,1710,-527
2017,5,26,2,2255,2259,1657,-602
2017,5,26,3,2247,2284,1657,-627
2017,5,26,4,2238,2311,1696,-615
2017,5,26,5,2170,2229,1690,-539
2017,5,26,6,2032,2085,1791,-294
2017,5,26,7,1860,2006,1819,-187
2017,5,26,8,1872,1915,1793,-122
2017,5,26,9,1922,1891,1735,-156
2017,5,26,10,1897,1883,1748,-135
2017,5,26,11,1903,1890,1720,-170
2017,5,26,12,1962,1951,1721,-230
2017,5,26,13,2084,2045,1704,-341
2017,5,26,14,2221,2123,1639,-484
2017,5,26,15,2284,2122,1646,-476
2017,5,26,16,2313,2050,1608,-442
2017,5,26,17,2326,2035,1706,-329
2017,5,26,18,2322,2041,1787,-254
2017,5,26,19,2309,1997,1764,-233
2017,5,26,20,2310,2002,1708,-294
2017,5,26,21,2324,2029,1745,-284
2017,5,26,22,2347,2001,1651,-350
2017,5,26,23,2372,2007,1689,-318
2017,5,27,0,2320,2019,1677,-342
2017,5,27,1,2320,2016,1723,-293
2017,5,27,2,2318,2063,1642,-421
2017,5,27,3,2313,2153,1665,-488
2017,5,27,4,2332,2187,1677,-510
2017,5,27,5,2287,2127,1636,-491
2017,5,27,6,2162,2026,1649,-377
2017,5,27,7,1972,1921,1642,-279
2017,5,27,8,1937,1849,1582,-267
2017,5,27,9,1844,1800,1554,-246
2017,5,27,10,1826,1765,1546,-219
2017,5,27,11,1830,1744,1554,-190
2017,5,27,12,1846,1779,1584,-195
2017,5,27,13,1869,1785,1552,-233
2017,5,27,14,1949,1721,1350,-371
2017,5,27,15,2064,1637,1341,-296
2017,5,27,16,2137,1674,1474,-200
2017,5,27,17,2183,1684,1509,-175
2017,5,27,18,2192,1700,1484,-216
2017,5,27,19,2187,1702,1556,-146
2017,5,27,20,2200,1717,1564,-153
2017,5,27,21,2210,1731,1516,-215
2017,5,27,22,2232,1756,1583,-173
2017,5,27,23,2259,1778,1604,-174
2017,5,28,0,2297,1809,1577,-232
2017,5,28,1,2318,1833,1570,-263
2017,5,28,2,2320,1906,1492,-414
2017,5,28,3,2317,2010,1558,-452
2017,5,28,4,2300,2057,1660,-397
2017,5,28,5,2225,1967,1624,-343
2017,5,28,6,2103,1826,1613,-213
2017,5,28,7,2053,1718,1523,-195
2017,5,28,8,1923,1651,1562,-89
2017,5,28,9,1642,1614,1576,-38
2017,5,28,10,1616,1584,1539,-45
2017,5,28,11,1618,1574,1534,-40
2017,5,28,12,1642,1586,1552,-34
2017,5,28,13,1671,1581,1489,-92
2017,5,28,14,1726,1501,1428,-73
2017,5,28,15,1825,1475,1493,18
2017,5,28,16,1897,1539,1554,15
2017,5,28,17,1949,1576,1620,44
2017,5,28,18,1974,1612,1644,32
2017,5,28,19,2027,1652,1626,-26
2017,5,28,20,2047,1692,1619,-73
2017,5,28,21,2066,1730,1622,-108
2017,5,28,22,2085,1790,1615,-175
2017,5,28,23,2125,1834,1611,-223
2017,5,29,0,2175,1897,1622,-275
2017,5,29,1,2212,1912,1629,-283
2017,5,29,2,2219,1966,1635,-331
2017,5,29,3,2192,2061,1667,-394
2017,5,29,4,2150,2068,1687,-381
2017,5,29,5,2020,1967,1684,-283
2017,5,29,6,1838,1803,1571,-232
2017,5,29,7,1995,1670,1479,-191
2017,5,29,8,1798,1596,1573,-23
2017,5,29,9,1597,1565,1581,16
2017,5,29,10,1580,1538,1578,40
2017,5,29,11,1605,1542,1589,47
2017,5,29,12,1696,1553,1606,53
2017,5,29,13,1850,1567,1473,-94
2017,5,29,14,1973,1535,1253,-282
2017,5,29,15,2049,1547,1345,-202
2017,5,29,16,2081,1655,1418,-237
2017,5,29,17,2128,1752,1479,-273
2017,5,29,18,2160,1819,1459,-360
2017,5,29,19,2196,1870,1433,-437
2017,5,29,20,2230,1950,1485,-465
2017,5,29,21,2268,2018,1532,-486
2017,5,29,22,2310,2106,1539,-567
2017,5,29,23,2349,2192,1527,-665
2017,5,30,0,2378,2242,1526,-716
2017,5,30,1,2395,2291,1544,-747
2017,5,30,2,2375,2349,1577,-772
2017,5,30,3,2331,2453,1601,-852
2017,5,30,4,2289,2425,1601,-824
2017,5,30,5,2173,2255,1502,-753
2017,5,30,6,1990,2041,1526,-515
2017,5,30,7,2026,1876,1484,-392
2017,5,30,8,1867,1788,1518,-270
2017,5,30,9,1788,1744,1528,-216
2017,5,30,10,1755,1704,1526,-178
2017,5,30,11,1752,1707,1518,-189
2017,5,30,12,1801,1754,1494,-260
2017,5,30,13,1895,1849,1482,-367
2017,5,30,14,2012,1900,1485,-415
2017,5,30,15,2051,1938,1478,-460
2017,5,30,16,2130,2031,1532,-499
2017,5,30,17,2209,2030,1508,-522
2017,5,30,18,2267,2035,1483,-552
2017,5,30,19,2321,2148,1586,-562
2017,5,30,20,2379,2238,1648,-590
2017,5,30,21,2438,2339,1746,-593
2017,5,30,22,2519,2572,1959,-613
2017,5,30,23,2603,2528,1809,-719
2017,5,31,0,2663,2585,1783,-802
2017,5,31,1,2685,2686,1777,-909
2017,5,31,2,2672,2640,1775,-865
2017,5,31,3,2611,2628,1871,-757
2017,5,31,4,2486,2540,1887,-653
2017,5,31,5,2349,2369,1851,-518
2017,5,31,6,2158,2192,1907,-285
2017,5,31,7,2037,2106,1806,-300
2017,5,31,8,1961,2034,1995,-39
2017,5,31,9,1908,1973,2015,42
2017,5,31,10,1876,1913,1910,-3
2017,5,31,11,1869,1902,1904,2
2017,5,31,12,1911,1956,1920,-36
2017,5,31,13,1998,2023,1926,-97
2017,5,31,14,2107,2081,1750,-331
2017,5,31,15,2140,2139,1794,-345
2017,5,31,16,2217,2213,1808,-405
2017,5,31,17,2294,2257,1770,-487
2017,5,31,18,2341,2334,1729,-605
2017,5,31,19,2376,1996,1426,-570
2017,5,31,20,2420,2469,1800,-669
2017,5,31,21,2471,2595,1912,-683
2017,5,31,22,2544,2665,1917,-748
2017,5,31,23,2606,2705,1979,-726
2017,6,1,0,2576,2665,1930,-735
2017,6,1,1,2560,2618,1891,-727
2017,6,1,2,2521,2669,1979,-690
2017,6,1,3,2457,2646,2012,-634
2017,6,1,4,2401,2610,1979,-631
2017,6,1,5,2286,2457,1883,-574
2017,6,1,6,2101,2206,1987,-219
2017,6,1,7,1967,2110,2073,-37
2017,6,1,8,1996,1999,1857,-142
2017,6,1,9,1965,1943,1805,-138
2017,6,1,10,1911,1918,1797,-121
2017,6,1,11,1893,1926,1773,-153
2017,6,1,12,1940,1978,1891,-87
2017,6,1,13,2035,2097,1854,-243
2017,6,1,14,2169,2208,1744,-464
2017,6,1,15,2241,2266,1665,-601
2017,6,1,16,2303,2281,1673,-608
2017,6,1,17,2340,2259,1784,-475
2017,6,1,18,2361,2247,1776,-471
2017,6,1,19,2386,2211,1778,-433
2017,6,1,20,2417,2255,1846,-409
2017,6,1,21,2464,2241,1820,-421
2017,6,1,22,2502,2284,1908,-376
2017,6,1,23,2500,2283,1702,-581
2017,6,2,0,2504,2268,1704,-564
2017,6,2,1,2485,2195,1731,-464
2017,6,2,2,2475,2230,1739,-491
2017,6,2,3,2448,2318,1826,-492
2017,6,2,4,2428,2351,1809,-542
2017,6,2,5,2326,2274,1733,-541
2017,6,2,6,2124,2117,1681,-436
2017,6,2,7,1966,2003,1602,-401
2017,6,2,8,1911,1921,1507,-414
2017,6,2,9,1918,1880,1475,-405
2017,6,2,10,1885,1851,1471,-380
2017,6,2,11,1880,1850,1443,-407
2017,6,2,12,1932,1905,1467,-438
2017,6,2,13,2037,1994,1570,-424
2017,6,2,14,2183,2000,1403,-597
2017,6,2,15,2282,1974,1330,-644
2017,6,2,16,2357,2010,1344,-666
2017,6,2,17,2420,2084,1401,-683
2017,6,2,18,2476,2119,1478,-641
2017,6,2,19,2522,2133,1471,-662
2017,6,2,20,2579,2174,1488,-686
2017,6,2,21,2630,2213,1478,-735
2017,6,2,22,2667,2263,1464,-799
2017,6,2,23,2684,2304,1449,-855
2017,6,3,0,2622,2361,1449,-912
2017,6,3,1,2633,2347,1483,-864
2017,6,3,2,2641,2406,1497,-909
2017,6,3,3,2610,2499,1627,-872
2017,6,3,4,2574,2492,1628,-864
2017,6,3,5,2490,2384,1605,-779
2017,6,3,6,2308,2214,1582,-632
2017,6,3,7,2116,2078,1592,-486
2017,6,3,8,2035,1985,1609,-376
2017,6,3,9,1972,1920,1604,-316
2017,6,3,10,1938,1870,1566,-304
2017,6,3,11,1920,1842,1563,-279
2017,6,3,12,1923,1849,1594,-255
2017,6,3,13,1936,1870,1605,-265
2017,6,3,14,2035,1894,1483,-411
2017,6,3,15,2215,1973,1541,-432
2017,6,3,16,2334,1989,1462,-527
2017,6,3,17,2426,2046,1571,-475
2017,6,3,18,2499,2109,1586,-523
2017,6,3,19,2552,2178,1715,-463
2017,6,3,20,2601,2237,1536,-701
2017,6,3,21,2644,2318,1533,-785
2017,6,3,22,2709,2419,1622,-797
2017,6,3,23,2751,2499,1637,-862
2017,6,4,0,2796,2592,1696,-896
2017,6,4,1,2827,2638,1699,-939
2017,6,4,2,2831,2597,1748,-849
2017,6,4,3,2770,2564,1774,-790
2017,6,4,4,2695,2543,1783,-760
2017,6,4,5,2570,2441,1716,-725
2017,6,4,6,2382,2270,1767,-503
2017,6,4,7,2238,2140,1758,-382
2017,6,4,8,2122,2045,1723,-322
2017,6,4,9,2017,1980,1728,-252
2017,6,4,10,1956,1922,1701,-221
2017,6,4,11,1906,1881,1664,-217
2017,6,4,12,1882,1881,1645,-236
2017,6,4,13,1866,1860,1673,-187
2017,6,4,14,1950,1832,1373,-459
2017,6,4,15,2092,1829,1366,-463
2017,6,4,16,2199,1903,1403,-500
2017,6,4,17,2288,2005,1501,-504
2017,6,4,18,2357,2079,1552,-527
2017,6,4,19,2442,2191,1657,-534
2017,6,4,20,2509,2234,1698,-536
2017,6,4,21,2585,2327,1725,-602
2017,6,4,22,2660,2407,1768,-639
2017,6,4,23,2748,2419,1773,-646
2017,6,5,0,2820,2438,1765,-673
2017,6,5,1,2811,2340,1768,-572
2017,6,5,2,2745,2177,1608,-569
2017,6,5,3,2647,2100,1600,-500
2017,6,5,4,2567,2083,1611,-472
2017,6,5,5,2422,2003,1545,-458
2017,6,5,6,2206,1861,1624,-237
2017,6,5,7,2039,1776,1609,-167
2017,6,5,8,1859,1714,1706,-8
2017,6,5,9,1715,1684,1639,-45
2017,6,5,10,1683,1661,1652,-9
2017,6,5,11,1687,1684,1672,-12
2017,6,5,12,1746,1775,1754,-21
2017,6,5,13,1861,1872,1961,89
2017,6,5,14,1982,1898,1740,-158
2017,6,5,15,2136,1941,1641,-300
2017,6,5,16,2191,1997,1686,-311
2017,6,5,17,2252,2025,1643,-382
2017,6,5,18,2313,2050,1658,-392
2017,6,5,19,2368,2058,1604,-454
2017,6,5,20,2431,2091,1677,-414
2017,6,5,21,2496,2143,1604,-539
2017,6,5,22,2547,2174,1629,-545
2017,6,5,23,2580,2190,1600,-590
2017,6,6,0,2592,2228,1586,-642
2017,6,6,1,2575,2293,1649,-644
2017,6,6,2,2557,2367,1742,-625
2017,6,6,3,2533,2471,1826,-645
2017,6,6,4,2484,2457,1835,-622
2017,6,6,5,2353,2358,1830,-528
2017,6,6,6,2160,2182,1921,-261
2017,6,6,7,2108,2043,1831,-212
2017,6,6,8,1990,1953,1868,-85
2017,6,6,9,1943,1919,1847,-72
2017,6,6,10,1901,1888,1804,-84
2017,6,6,11,1899,1887,1833,-54
2017,6,6,12,1959,1944,1821,-123
2017,6,6,13,2080,2032,1803,-229
2017,6,6,14,2226,2075,1643,-432
2017,6,6,15,2286,2076,1610,-466
2017,6,6,16,2373,2128,1699,-429
2017,6,6,17,2446,2149,1715,-434
2017,6,6,18,2511,2157,1723,-434
2017,6,6,19,2565,2181,1689,-492
2017,6,6,20,2654,2292,1762,-530
2017,6,6,21,2745,2313,1746,-567
2017,6,6,22,2821,2419,1854,-565
2017,6,6,23,2888,2471,1872,-599
2017,6,7,0,2946,2549,1899,-650
2017,6,7,1,2992,2587,1854,-733
2017,6,7,2,2998,2669,1921,-748
2017,6,7,3,2951,2723,1886,-837
2017,6,7,4,2839,2730,1921,-809
2017,6,7,5,2659,2566,1835,-731
2017,6,7,6,2413,2353,1906,-447
2017,6,7,7,2207,2186,1837,-349
2017,6,7,8,2135,2095,1794,-301
2017,6,7,9,2067,2032,1785,-247
2017,6,7,10,2018,1990,1721,-269
2017,6,7,11,2009,1973,1657,-316
2017,6,7,12,2060,2020,1672,-348
2017,6,7,13,2171,2110,1759,-351
2017,6,7,14,2326,2134,1582,-552
2017,6,7,15,2414,2141,1571,-570
2017,6,7,16,2531,2189,1558,-631
2017,6,7,17,2613,2296,1704,-592
2017,6,7,18,2690,2383,1765,-618
2017,6,7,19,2780,2484,1803,-681
2017,6,7,20,2881,2614,1857,-757
2017,6,7,21,2989,2730,1931,-799
2017,6,7,22,3077,2864,1981,-883
2017,6,7,23,3138,2932,1972,-960
2017,6,8,0,3179,2933,1889,-1044
2017,6,8,1,3194,2976,1868,-1108
2017,6,8,2,3180,3030,1925,-1105
2017,6,8,3,3085,3007,1912,-1095
2017,6,8,4,2950,2948,1880,-1068
2017,6,8,5,2736,2786,1921,-865
2017,6,8,6,2456,2540,1935,-605
2017,6,8,7,2373,2360,1924,-436
2017,6,8,8,2277,2246,1925,-321
2017,6,8,9,2206,2168,1869,-299
2017,6,8,10,2152,2109,1861,-248
2017,6,8,11,2141,2100,1866,-234
2017,6,8,12,2189,2134,1784,-350
2017,6,8,13,2296,2215,1762,-453
2017,6,8,14,2445,2317,1746,-571
2017,6,8,15,2547,2423,1795,-628
2017,6,8,16,2629,2466,1859,-607
2017,6,8,17,2675,2513,1921,-592
2017,6,8,18,2701,2502,1942,-560
2017,6,8,19,2737,2497,1935,-562
2017,6,8,20,2780,2529,1996,-533
2017,6,8,21,2808,2479,1979,-500
2017,6,8,22,2835,2436,1962,-474
2017,6,8,23,2816,2448,1998,-450
2017,6,9,0,2823,2447,2175,-267
2017,6,9,1,2820,2433,2148,-285
2017,6,9,2,2779,2445,1989,-456
2017,6,9,3,2679,2473,2021,-452
2017,6,9,4,2559,2494,1907,-587
2017,6,9,5,2413,2421,1816,-605
2017,6,9,6,2199,2269,1725,-544
2017,6,9,7,2187,2150,1674,-476
2017,6,9,8,2058,2086,1675,-411
2017,6,9,9,2050,2033,1696,-337
2017,6,9,10,2020,1987,1693,-294
2017,6,9,11,1998,1973,1653,-320
2017,6,9,12,2031,2025,1679,-346
2017,6,9,13,2107,2113,1753,-360
2017,6,9,14,2239,2141,1877,-264
2017,6,9,15,2321,2166,1871,-295
2017,6,9,16,2382,2190,1763,-427
2017,6,9,17,2409,2208,1765,-443
2017,6,9,18,2420,2246,1743,-503
2017,6,9,19,2445,2245,1765,-480
2017,6,9,20,2480,2268,1746,-522
2017,6,9,21,2500,2290,1777,-513
2017,6,9,22,2522,2279,1771,-508
2017,6,9,23,2521,2278,1790,-488
2017,6,10,0,2489,2307,1737,-570
2017,6,10,1,2499,2397,1748,-649
2017,6,10,2,2497,2363,1790,-573
2017,6,10,3,2470,2341,1784,-557
2017,6,10,4,2463,2310,1848,-462
2017,6,10,5,2428,2237,1927,-310
2017,6,10,6,2290,2108,1901,-207
2017,6,10,7,2126,2015,1810,-205
2017,6,10,8,2038,1962,1755,-207
2017,6,10,9,1930,1912,1708,-204
2017,6,10,10,1890,1897,1739,-158
2017,6,10,11,1867,1890,1696,-194
2017,6,10,12,1866,1907,1685,-222
2017,6,10,13,1860,1929,1702,-227
2017,6,10,14,1941,1975,1654,-321
2017,6,10,15,2075,2063,1805,-258
2017,6,10,16,2160,2096,1819,-277
2017,6,10,17,2195,2063,1842,-221
2017,6,10,18,2201,1986,1756,-230
2017,6,10,19,2208,1953,1691,-262
2017,6,10,20,2216,1929,1764,-165
2017,6,10,21,2222,1902,1750,-152
2017,6,10,22,2246,1892,1747,-145
2017,6,10,23,2269,1890,1750,-140
2017,6,11,0,2300,1923,1740,-183
2017,6,11,1,2306,1937,1780,-157
2017,6,11,2,2288,2021,1808,-213
2017,6,11,3,2268,2115,1832,-283
2017,6,11,4,2251,2170,1940,-230
2017,6,11,5,2210,2121,1955,-166
2017,6,11,6,2090,2007,1872,-135
2017,6,11,7,2032,1905,1766,-139
2017,6,11,8,1937,1856,1811,-45
2017,6,11,9,1860,1821,1765,-56
2017,6,11,10,1827,1806,1730,-76
2017,6,11,11,1807,1793,1713,-80
2017,6,11,12,1806,1811,1776,-35
2017,6,11,13,1800,1811,1811,0
2017,6,11,14,1864,1732,1709,-23
2017,6,11,15,1982,1755,1769,14
2017,6,11,16,2069,1775,1749,-26
2017,6,11,17,2113,1805,1844,39
2017,6,11,18,2130,1791,1860,69
2017,6,11,19,2178,1802,1879,77
2017,6,11,20,2210,1875,2036,161
2017,6,11,21,2245,1892,2099,207
2017,6,11,22,2270,1887,2100,213
2017,6,11,23,2302,1918,2123,205
2017,6,12,0,2314,1983,2277,294
2017,6,12,1,2317,1994,2292,298
2017,6,12,2,2291,1974,2268,294
2017,6,12,3,2239,1960,2311,351
2017,6,12,4,2211,1972,2302,330
2017,6,12,5,2150,1897,2257,360
2017,6,12,6,2001,1789,2165,376
2017,6,12,7,1947,1724,2093,369
2017,6,12,8,1840,1690,1983,293
2017,6,12,9,1694,1667,1706,39
2017,6,12,10,1693,1683,1628,-55
2017,6,12,11,1716,1698,1676,-22
2017,6,12,12,1795,1777,1714,-63
2017,6,12,13,1923,1895,1893,-2
2017,6,12,14,2051,2026,1931,-95
2017,6,12,15,2197,2110,1958,-152
2017,6,12,16,2244,2112,1985,-127
2017,6,12,17,2275,2151,1993,-158
2017,6,12,18,2277,2163,2052,-111
2017,6,12,19,2286,2125,2100,-25
2017,6,12,20,2284,2087,2109,22
2017,6,12,21,2289,2066,2069,3
2017,6,12,22,2274,2027,1978,-49
2017,6,12,23,2275,2036,2012,-24
2017,6,13,0,2277,2077,2019,-58
2017,6,13,1,2299,2152,2056,-96
2017,6,13,2,2284,2166,2029,-137
2017,6,13,3,2255,2172,2018,-154
2017,6,13,4,2241,2175,2023,-152
2017,6,13,5,2183,2070,1983,-87
2017,6,13,6,2050,1916,1812,-104
2017,6,13,7,2058,1791,1612,-179
2017,6,13,8,1937,1766,1916,150
2017,6,13,9,1772,1729,1878,149
2017,6,13,10,1766,1729,1870,141
2017,6,13,11,1786,1736,1934,198
2017,6,13,12,1851,1815,2103,288
2017,6,13,13,1982,1892,2095,203
2017,6,13,14,2106,1913,2082,169
2017,6,13,15,2101,1824,2049,225
2017,6,13,16,2144,1835,2054,219
2017,6,13,17,2174,1797,2012,215
2017,6,13,18,2196,1788,1879,91
2017,6,13,19,2212,1722,1829,107
2017,6,13,20,2223,1676,1806,130
2017,6,13,21,2249,1689,1888,199
2017,6,13,22,2262,1682,1897,215
2017,6,13,23,2288,1648,1892,244
2017,6,14,0,2318,1652,1841,189
2017,6,14,1,2370,1655,1796,141
2017,6,14,2,2382,1662,1602,-60
2017,6,14,3,2362,1792,1653,-139
2017,6,14,4,2333,1879,1866,-13
2017,6,14,5,2226,1842,1884,42
2017,6,14,6,2054,1696,1777,81
2017,6,14,7,2052,1580,1568,-12
2017,6,14,8,1886,1529,1346,-183
2017,6,14,9,1560,1510,1300,-210
2017,6,14,10,1553,1498,1302,-196
2017,6,14,11,1578,1512,1306,-206
2017,6,14,12,1644,1590,1424,-166
2017,6,14,13,1764,1674,1538,-136
2017,6,14,14,1848,1646,1392,-254
2017,6,14,15,1825,1631,1562,-69
2017,6,14,16,1864,1635,1613,-22
2017,6,14,17,1914,1670,1773,103
2017,6,14,18,1951,1675,1786,111
2017,6,14,19,1983,1688,1805,117
2017,6,14,20,2007,1833,1928,95
2017,6,14,21,2044,1711,1814,103
2017,6,14,22,2072,1816,1901,85
2017,6,14,23,2115,1827,1834,7
2017,6,15,0,2133,1823,1866,43
2017,6,15,1,2161,1839,1899,60
2017,6,15,2,2143,1885,1802,-83
2017,6,15,3,2115,1958,1660,-298
2017,6,15,4,2098,2006,1656,-350
2017,6,15,5,2000,1933,1689,-244
2017,6,15,6,1839,1786,1649,-137
2017,6,15,7,2015,1690,1593,-97
2017,6,15,8,1778,1643,1596,-47
2017,6,15,9,1631,1601,1599,-2
2017,6,15,10,1614,1587,1603,16
2017,6,15,11,1631,1593,1597,4
2017,6,15,12,1696,1657,1600,-57
2017,6,15,13,1806,1758,1649,-109
2017,6,15,14,1910,1843,1631,-212
2017,6,15,15,1963,1921,1837,-84
2017,6,15,16,2017,1882,1794,-88
2017,6,15,17,2073,1889,1758,-131
2017,6,15,18,2126,1876,1655,-221
2017,6,15,19,2168,1871,1644,-227
2017,6,15,20,2201,1910,1553,-357
2017,6,15,21,2256,1957,1652,-305
2017,6,15,22,2300,1998,1716,-282
2017,6,15,23,2338,2064,1774,-290
2017,6,16,0,2361,2108,1873,-235
2017,6,16,1,2371,2129,1902,-227
2017,6,16,2,2356,2162,1856,-306
2017,6,16,3,2298,2233,1908,-325
2017,6,16,4,2245,2259,1839,-420
2017,6,16,5,2141,2171,1828,-343
2017,6,16,6,1967,2017,1829,-188
2017,6,16,7,1950,1895,1836,-59
2017,6,16,8,1774,1843,1876,33
2017,6,16,9,1822,1780,1782,2
2017,6,16,10,1796,1748,1715,-33
2017,6,16,11,1796,1734,1789,55
2017,6,16,12,1852,1775,1898,123
2017,6,16,13,1960,1872,1948,76
2017,6,16,14,2079,2000,1943,-57
2017,6,16,15,2149,2062,1985,-77
2017,6,16,16,2183,2051,1991,-60
2017,6,16,17,2208,2098,2015,-83
2017,6,16,18,2215,2104,2056,-48
2017,6,16,19,2212,2122,1994,-128
2017,6,16,20,2221,2186,2035,-151
2017,6,16,21,2239,2250,2057,-193
2017,6,16,22,2243,2227,2063,-164
2017,6,16,23,2243,2214,2110,-104
2017,6,17,0,2290,2191,2019,-172
2017,6,17,1,2269,2216,2021,-195
2017,6,17,2,2232,2217,2077,-140
2017,6,17,3,2182,2206,2097,-109
2017,6,17,4,2158,2222,2019,-203
2017,6,17,5,2118,2171,2085,-86
2017,6,17,6,2004,2060,2061,1
2017,6,17,7,1814,1944,1966,22
2017,6,17,8,1784,1854,1833,-21
2017,6,17,9,1862,1799,1898,99
2017,6,17,10,1831,1765,1836,71
2017,6,17,11,1812,1745,1817,72
2017,6,17,12,1819,1757,1819,62
2017,6,17,13,1822,1783,1814,31
2017,6,17,14,1906,1798,1847,49
2017,6,17,15,2028,1793,1806,13
2017,6,17,16,2093,1859,1912,53
2017,6,17,17,2128,1930,2059,129
2017,6,17,18,2137,1961,2135,174
2017,6,17,19,2131,1992,2251,259
2017,6,17,20,2139,1986,2263,277
2017,6,17,21,2145,2002,2143,141
2017,6,17,22,2150,2031,2087,56
2017,6,17,23,2151,2057,1924,-133
2017,6,18,0,2194,2090,1949,-141
2017,6,18,1,2229,2107,2025,-82
2017,6,18,2,2229,2154,2006,-148
2017,6,18,3,2225,2264,2061,-203
2017,6,18,4,2210,2308,2098,-210
2017,6,18,5,2150,2249,2023,-226
2017,6,18,6,2032,2110,1898,-212
2017,6,18,7,1794,1997,1794,-203
2017,6,18,8,1767,1887,1593,-294
2017,6,18,9,1727,1834,1496,-338
2017,6,18,10,1694,1817,1504,-313
2017,6,18,11,1676,1786,1494,-292
2017,6,18,12,1680,1797,1555,-242
2017,6,18,13,1679,1791,1567,-224
2017,6,18,14,1755,1728,1576,-152
2017,6,18,15,1886,1745,1524,-221
2017,6,18,16,1978,1814,1586,-228
2017,6,18,17,2049,1883,1679,-204
2017,6,18,18,2094,1912,1688,-224
2017,6,18,19,2153,1973,1747,-226
2017,6,18,20,2204,2001,1767,-234
2017,6,18,21,2245,2061,1839,-222
2017,6,18,22,2287,2123,1885,-238
2017,6,18,23,2327,2188,1929,-259
2017,6,19,0,2375,2242,1962,-280
2017,6,19,1,2412,2282,1996,-286
2017,6,19,2,2410,2338,2029,-309
2017,6,19,3,2377,2443,2142,-301
2017,6,19,4,2323,2454,2141,-313
2017,6,19,5,2211,2356,2080,-276
2017,6,19,6,2037,2192,1944,-248
2017,6,19,7,1845,2040,1889,-151
2017,6,19,8,1825,1927,1673,-254
2017,6,19,9,1888,1879,1588,-291
2017,6,19,10,1851,1849,1535,-314
2017,6,19,11,1851,1852,1611,-241
2017,6,19,12,1910,1899,1674,-225
2017,6,19,13,2026,1999,1758,-241
2017,6,19,14,2189,2074,1781,-293
2017,6,19,15,2374,2130,1815,-315
2017,6,19,16,2458,2272,1869,-403
2017,6,19,17,2542,2356,1892,-464
2017,6,19,18,2619,2475,1981,-494
2017,6,19,19,2686,2547,1970,-577
2017,6,19,20,2762,2659,2045,-614
2017,6,19,21,2849,2775,2013,-762
2017,6,19,22,2921,2861,1939,-922
2017,6,19,23,2979,2947,1994,-953
2017,6,20,0,3030,3003,2013,-990
2017,6,20,1,3073,3046,2085,-961
2017,6,20,2,3083,3133,2133,-1000
2017,6,20,3,3047,3220,2164,-1056
2017,6,20,4,2967,3157,2122,-1035
2017,6,20,5,2792,2989,2054,-935
2017,6,20,6,2521,2724,2003,-721
2017,6,20,7,2252,2532,1968,-564
2017,6,20,8,2246,2402,1995,-407
2017,6,20,9,2156,2309,2067,-242
2017,6,20,10,2101,2260,2097,-163
2017,6,20,11,2083,2237,2090,-147
2017,6,20,12,2126,2247,2080,-167
2017,6,20,13,2226,2335,2080,-255
2017,6,20,14,2392,2412,2080,-332
2017,6,20,15,2536,2494,2111,-383
2017,6,20,16,2685,2594,2007,-587
2017,6,20,17,2818,2714,2018,-696
2017,6,20,18,2952,2822,2007,-815
2017,6,20,19,3064,2924,2060,-864
2017,6,20,20,3150,3023,2038,-985
2017,6,20,21,3220,3061,2158,-903
2017,6,20,22,3270,3036,2221,-815
2017,6,20,23,3306,3047,2355,-692
2017,6,21,0,3315,3006,2408,-598
2017,6,21,1,3321,3057,2425,-632
2017,6,21,2,3286,3172,2463,-709
2017,6,21,3,3191,3287,2458,-829
2017,6,21,4,3075,3299,2458,-841
2017,6,21,5,2916,3106,2232,-874
2017,6,21,6,2642,2843,2162,-681
2017,6,21,7,2328,2629,2203,-426
2017,6,21,8,2358,2487,2310,-177
2017,6,21,9,2358,2386,2251,-135
2017,6,21,10,2260,2303,2206,-97
2017,6,21,11,2190,2246,2163,-83
2017,6,21,12,2198,2271,2247,-24
2017,6,21,13,2299,2342,2236,-106
2017,6,21,14,2471,2384,2184,-200
2017,6,21,15,2582,2389,2104,-285
2017,6,21,16,2664,2441,2074,-367
2017,6,21,17,2720,2533,2163,-370
2017,6,21,18,2782,2602,2199,-403
2017,6,21,19,2858,2668,2248,-420
2017,6,21,20,2952,2728,2272,-456
2017,6,21,21,3017,2778,2286,-492
2017,6,21,22,3041,2814,2304,-510
2017,6,21,23,3085,2821,2298,-523
2017,6,22,0,3080,2846,2305,-541
2017,6,22,1,3101,2846,2310,-536
2017,6,22,2,3094,2861,2320,-541
2017,6,22,3,3035,2944,2385,-559
2017,6,22,4,2928,2906,2372,-534
2017,6,22,5,2783,2786,2333,-453
2017,6,22,6,2549,2564,2352,-212
2017,6,22,7,2259,2387,2258,-129
2017,6,22,8,2240,2264,2150,-114
2017,6,22,9,2203,2181,2110,-71
2017,6,22,10,2131,2136,2093,-43
2017,6,22,11,2084,2135,2159,24
2017,6,22,12,2106,2153,2179,26
2017,6,22,13,2205,2248,2252,4
2017,6,22,14,2375,2224,2020,-204
2017,6,22,15,2489,2243,2001,-242
2017,6,22,16,2573,2312,2047,-265
2017,6,22,17,2635,2376,2126,-250
2017,6,22,18,2688,2420,2141,-279
2017,6,22,19,2751,2448,2141,-307
2017,6,22,20,2817,2484,2189,-295
2017,6,22,21,2869,2531,2233,-298
2017,6,22,22,2885,2583,2316,-267
2017,6,22,23,2906,2615,2300,-315
2017,6,23,0,2913,2629,2279,-350
2017,6,23,1,2921,2651,2263,-388
2017,6,23,2,2912,2695,2278,-417
2017,6,23,3,2869,2798,2454,-344
2017,6,23,4,2792,2804,2426,-378
2017,6,23,5,2679,2705,2350,-355
2017,6,23,6,2473,2512,2320,-192
2017,6,23,7,2262,2362,2241,-121
2017,6,23,8,2210,2233,1973,-260
2017,6,23,9,2200,2174,2026,-148
2017,6,23,10,2134,2133,1987,-146
2017,6,23,11,2104,2127,1969,-158
2017,6,23,12,2133,2153,1950,-203
2017,6,23,13,2223,2229,1972,-257
2017,6,23,14,2392,2200,1699,-501
2017,6,23,15,2517,2217,1667,-550
2017,6,23,16,2609,2305,1835,-470
2017,6,23,17,2665,2373,1873,-500
2017,6,23,18,2709,2408,1900,-508
2017,6,23,19,2763,2448,1761,-687
2017,6,23,20,2832,2479,1737,-742
2017,6,23,21,2882,2530,1772,-758
2017,6,23,22,2915,2592,1907,-685
2017,6,23,23,2954,2635,1949,-686
2017,6,24,0,2968,2672,1999,-673
2017,6,24,1,2993,2693,1971,-722
2017,6,24,2,3009,2730,1978,-752
2017,6,24,3,2968,2820,2055,-765
2017,6,24,4,2887,2794,2100,-694
2017,6,24,5,2804,2687,2055,-632
2017,6,24,6,2612,2519,2175,-344
2017,6,24,7,2382,2348,2081,-267
2017,6,24,8,2281,2249,1984,-265
2017,6,24,9,2193,2175,1885,-290
2017,6,24,10,2141,2155,1977,-178
2017,6,24,11,2117,2126,1946,-180
2017,6,24,12,2110,2119,1907,-212
2017,6,24,13,2120,2133,1909,-224
2017,6,24,14,2231,2094,1869,-225
2017,6,24,15,2410,2123,1794,-329
2017,6,24,16,2543,2219,1764,-455
2017,6,24,17,2636,2283,1759,-524
2017,6,24,18,2699,2356,1835,-521
2017,6,24,19,2748,2401,1868,-533
2017,6,24,20,2803,2470,1911,-559
2017,6,24,21,2849,2551,1939,-612
2017,6,24,22,2905,2620,1957,-663
2017,6,24,23,2964,2703,2014,-689
2017,6,25,0,3012,2769,2058,-711
2017,6,25,1,3030,2825,2097,-728
2017,6,25,2,3035,2861,2088,-773
2017,6,25,3,2998,2941,2090,-851
2017,6,25,4,2914,2879,2094,-785
2017,6,25,5,2802,2764,2021,-743
2017,6,25,6,2612,2563,2083,-480
2017,6,25,7,2457,2400,2017,-383
2017,6,25,8,2288,2285,1913,-372
2017,6,25,9,2252,2202,1846,-356
2017,6,25,10,2206,2149,1859,-290
2017,6,25,11,2172,2106,1845,-261
2017,6,25,12,2152,2091,1823,-268
2017,6,25,13,2138,2066,1799,-267
2017,6,25,14,2231,2005,1761,-244
2017,6,25,15,2421,2033,1736,-297
2017,6,25,16,2573,2150,1842,-308
2017,6,25,17,2675,2262,1957,-305
2017,6,25,18,2749,2371,2063,-308
2017,6,25,19,2846,2472,2088,-384
2017,6,25,20,2924,2559,2077,-482
2017,6,25,21,3002,2681,2152,-529
2017,6,25,22,3061,2789,2238,-551
2017,6,25,23,3129,2897,2293,-604
2017,6,26,0,3180,2981,2409,-572
2017,6,26,1,3215,3012,2415,-597
2017,6,26,2,3216,3046,2361,-685
2017,6,26,3,3165,3113,2328,-785
2017,6,26,4,3040,3068,2354,-714
2017,6,26,5,2888,2897,2236,-661
2017,6,26,6,2632,2630,2061,-569
2017,6,26,7,2452,2426,2003,-423
2017,6,26,8,2328,2301,1975,-326
2017,6,26,9,2302,2208,1929,-279
2017,6,26,10,2263,2157,1996,-161
2017,6,26,11,2258,2146,1991,-155
2017,6,26,12,2299,2195,2075,-120
2017,6,26,13,2407,2278,2112,-166
2017,6,26,14,2598,2360,2095,-265
2017,6,26,15,2838,2419,2088,-331
2017,6,26,16,2979,2541,2050,-491
2017,6,26,17,3118,2674,2108,-566
2017,6,26,18,3251,2812,2108,-704
2017,6,26,19,3397,2936,2176,-760
2017,6,26,20,3517,3072,2218,-854
2017,6,26,21,3606,3215,2229,-986
2017,6,26,22,3667,3283,2353,-930
2017,6,26,23,3699,3278,2362,-916
2017,6,27,0,3675,3338,2425,-913
2017,6,27,1,3662,3199,2410,-789
2017,6,27,2,3555,3155,2291,-864
2017,6,27,3,3452,3125,2210,-915
2017,6,27,4,3337,3086,2313,-773
2017,6,27,5,3221,2959,2243,-716
2017,6,27,6,2981,2729,2204,-525
2017,6,27,7,2741,2571,2195,-376
2017,6,27,8,2514,2450,2212,-238
2017,6,27,9,2398,2362,2196,-166
2017,6,27,10,2341,2286,2090,-196
2017,6,27,11,2318,2259,2145,-114
2017,6,27,12,2356,2265,2135,-130
2017,6,27,13,2474,2342,2219,-123
2017,6,27,14,2636,2356,1877,-479
2017,6,27,15,2712,2410,2079,-331
2017,6,27,16,2810,2528,2248,-280
2017,6,27,17,2874,2656,2367,-289
2017,6,27,18,2920,2716,2343,-373
2017,6,27,19,2960,2782,2395,-387
2017,6,27,20,3015,2761,2459,-302
2017,6,27,21,3085,2934,2505,-429
2017,6,27,22,3130,2991,2490,-501
2017,6,27,23,3154,3033,2434,-599
2017,6,28,0,3158,3086,2414,-672
2017,6,28,1,3154,3104,2444,-660
2017,6,28,2,3173,3153,2435,-718
2017,6,28,3,3139,3211,2388,-823
2017,6,28,4,3038,3148,2331,-817
2017,6,28,5,2913,3024,2311,-713
2017,6,28,6,2688,2778,2279,-499
2017,6,28,7,2532,2618,2368,-250
2017,6,28,8,2461,2482,2192,-290
2017,6,28,9,2406,2398,2126,-272
2017,6,28,10,2327,2334,2215,-119
2017,6,28,11,2289,2299,2194,-105
2017,6,28,12,2320,2335,2174,-161
2017,6,28,13,2426,2395,2205,-190
2017,6,28,14,2591,2449,2243,-206
2017,6,28,15,2715,2464,2259,-205
2017,6,28,16,2823,2517,2133,-384
2017,6,28,17,2891,2611,2179,-432
2017,6,28,18,2952,2675,2239,-436
2017,6,28,19,3008,2724,2218,-506
2017,6,28,20,3068,2777,2255,-522
2017,6,28,21,3124,2837,2349,-488
2017,6,28,22,3160,2857,2392,-465
2017,6,28,23,3177,2892,2426,-466
2017,6,29,0,3190,2895,2520,-375
2017,6,29,1,3194,2911,2434,-477
2017,6,29,2,3193,2942,2443,-499
2017,6,29,3,3133,3037,2498,-539
2017,6,29,4,3023,2999,2457,-542
2017,6,29,5,2916,2858,2342,-516
2017,6,29,6,2693,2655,2253,-402
2017,6,29,7,2472,2483,2084,-399
2017,6,29,8,2394,2375,2059,-316
2017,6,29,9,2302,2290,2039,-251
2017,6,29,10,2230,2241,2019,-222
2017,6,29,11,2195,2230,2033,-197
2017,6,29,12,2206,2251,2072,-179
2017,6,29,13,2281,2316,2127,-189
2017,6,29,14,2446,2333,2239,-94
2017,6,29,15,2584,2328,2183,-145
2017,6,29,16,2694,2390,2162,-228
2017,6,29,17,2786,2431,2164,-267
2017,6,29,18,2856,2481,2199,-282
2017,6,29,19,2920,2547,2288,-259
2017,6,29,20,2983,2623,2404,-219
2017,6,29,21,3048,2685,2538,-147
2017,6,29,22,3080,2737,2577,-160
2017,6,29,23,3110,2780,2576,-204
2017,6,30,0,3140,2808,2513,-295
2017,6,30,1,3164,2844,2552,-292
2017,6,30,2,3169,2883,2402,-481
2017,6,30,3,3120,2994,2500,-494
2017,6,30,4,3015,2955,2518,-437
2017,6,30,5,2910,2842,2534,-308
2017,6,30,6,2715,2651,2463,-188
2017,6,30,7,2552,2471,2346,-125
2017,6,30,8,2426,2361,2228,-133
2017,6,30,9,2333,2299,2248,-51
2017,6,30,10,2266,2248,2293,45
2017,6,30,11,2248,2226,2294,68
2017,6,30,12,2274,2250,2291,41
2017,6,30,13,2353,2314,2270,-44
2017,6,30,14,2540,2337,2164,-173
2017,6,30,15,2683,2378,2210,-168
2017,6,30,16,2804,2445,2247,-198
2017,6,30,17,2893,2530,2165,-365
2017,6,30,18,2977,2614,2300,-314
2017,6,30,19,3048,2692,2263,-429
2017,6,30,20,3111,2777,2224,-553
2017,6,30,21,3182,2844,2179,-665
2017,6,30,22,3222,2876,2129,-747
2017,6,30,23,3270,2897,2137,-760
2017,7,1,0,3267,2936,2170,-766
2017,7,1,1,3291,2972,2191,-781
2017,7,1,2,3271,3016,2218,-798
2017,7,1,3,3211,3096,2280,-816
2017,7,1,4,3104,3061,2265,-796
2017,7,1,5,3011,2927,2188,-739
2017,7,1,6,2839,2717,2036,-681
2017,7,1,7,2684,2533,2016,-517
2017,7,1,8,2536,2414,2005,-409
2017,7,1,9,2382,2321,1949,-372
2017,7,1,10,2332,2259,1923,-336
2017,7,1,11,2307,2216,1958,-258
2017,7,1,12,2298,2202,2031,-171
2017,7,1,13,2295,2205,2046,-159
2017,7,1,14,2402,2175,1891,-284
2017,7,1,15,2570,2205,1799,-406
2017,7,1,16,2696,2295,1863,-432
2017,7,1,17,2803,2428,2008,-420
2017,7,1,18,2902,2543,2111,-432
2017,7,1,19,2972,2683,2135,-548
2017,7,1,20,3018,2802,2125,-677
2017,7,1,21,3091,2928,2155,-773
2017,7,1,22,3161,2999,2168,-831
2017,7,1,23,3223,3072,2109,-963
2017,7,2,0,3294,3102,1985,-1117
2017,7,2,1,3332,3145,2008,-1137
2017,7,2,2,3320,3111,1988,-1123
2017,7,2,3,3254,3127,2083,-1044
2017,7,2,4,3157,3070,2141,-929
2017,7,2,5,3070,2955,2156,-799
2017,7,2,6,2884,2777,2149,-628
2017,7,2,7,2769,2591,2113,-478
2017,7,2,8,2592,2468,2090,-378
2017,7,2,9,2411,2386,2026,-360
2017,7,2,10,2321,2314,1976,-338
2017,7,2,11,2275,2253,1908,-345
2017,7,2,12,2243,2215,1881,-334
2017,7,2,13,2217,2202,1829,-373
2017,7,2,14,2279,2164,1646,-518
2017,7,2,15,2400,2185,1646,-539
2017,7,2,16,2506,2306,1714,-592
2017,7,2,17,2594,2421,1822,-599
2017,7,2,18,2700,2549,1946,-603
2017,7,2,19,2812,2673,2016,-657
2017,7,2,20,2890,2782,2008,-774
2017,7,2,21,3010,2871,2067,-804
2017,7,2,22,3126,2953,1984,-969
2017,7,2,23,3224,3047,2119,-928
2017,7,3,0,3292,3078,2195,-883
2017,7,3,1,3304,3097,2254,-843
2017,7,3,2,3287,3132,2260,-872
2017,7,3,3,3231,3196,2306,-890
2017,7,3,4,3130,3124,2304,-820
2017,7,3,5,2981,2988,2191,-797
2017,7,3,6,2726,2767,2095,-672
2017,7,3,7,2654,2576,2074,-502
2017,7,3,8,2464,2436,2026,-410
2017,7,3,9,2444,2341,2018,-323
2017,7,3,10,2383,2279,1975,-304
2017,7,3,11,2356,2247,1923,-324
2017,7,3,12,2400,2252,1897,-355
2017,7,3,13,2515,2284,1898,-386
2017,7,3,14,2692,2326,1952,-374
2017,7,3,15,2897,2365,1868,-497
2017,7,3,16,2993,2502,1931,-571
2017,7,3,17,3084,2643,2085,-558
2017,7,3,18,3177,2762,2143,-619
2017,7,3,19,3286,2886,2161,-725
2017,7,3,20,3386,2976,2153,-823
2017,7,3,21,3484,3083,2171,-912
2017,7,3,22,3557,3163,2238,-925
2017,7,3,23,3606,3210,2293,-917
2017,7,4,0,3644,3218,2282,-936
2017,7,4,1,3676,3222,2180,-1042
2017,7,4,2,3679,3265,2207,-1058
2017,7,4,3,3634,3341,2269,-1072
2017,7,4,4,3532,3271,2247,-1024
2017,7,4,5,3368,3106,2194,-912
2017,7,4,6,3097,2876,2064,-812
2017,7,4,7,2838,2669,1911,-758
2017,7,4,8,2723,2490,1707,-783
2017,7,4,9,2541,2389,1740,-649
2017,7,4,10,2459,2304,1681,-623
2017,7,4,11,2420,2240,1597,-643
2017,7,4,12,2437,2196,1524,-672
2017,7,4,13,2512,2209,1621,-588
2017,7,4,14,2654,2183,1444,-739
2017,7,4,15,2742,2217,1503,-714
2017,7,4,16,2903,2335,1556,-779
2017,7,4,17,3076,2484,1673,-811
2017,7,4,18,3239,2612,1805,-807
2017,7,4,19,3408,2751,1910,-841
2017,7,4,20,3546,2883,2044,-839
2017,7,4,21,3681,2994,2178,-816
2017,7,4,22,3782,3091,2197,-894
2017,7,4,23,3842,3154,2223,-931
2017,7,5,0,3898,3222,2193,-1029
2017,7,5,1,3931,3224,2167,-1057
2017,7,5,2,3930,3224,2042,-1182
2017,7,5,3,3864,3185,2013,-1172
2017,7,5,4,3734,3120,1922,-1198
2017,7,5,5,3542,2994,1925,-1069
2017,7,5,6,3265,2860,1921,-939
2017,7,5,7,3002,2680,1846,-834
2017,7,5,8,2892,2522,1839,-683
2017,7,5,9,2532,2413,1774,-639
2017,7,5,10,2442,2317,1713,-604
2017,7,5,11,2383,2269,1699,-570
2017,7,5,12,2377,2263,1687,-576
2017,7,5,13,2430,2325,1684,-641
2017,7,5,14,2554,2383,1650,-733
2017,7,5,15,2662,2444,1707,-737
2017,7,5,16,2834,2580,1862,-718
2017,7,5,17,3023,2742,1969,-773
2017,7,5,18,3204,2886,1976,-910
2017,7,5,19,3368,3019,1985,-1034
2017,7,5,20,3507,3161,2014,-1147
2017,7,5,21,3636,3263,2073,-1190
2017,7,5,22,3747,3353,2136,-1217
2017,7,5,23,3816,3362,2159,-1203
2017,7,6,0,3878,3383,2089,-1294
2017,7,6,1,3886,3417,2104,-1313
2017,7,6,2,3862,3499,2162,-1337
2017,7,6,3,3760,3507,2085,-1422
2017,7,6,4,3613,3426,2044,-1382
2017,7,6,5,3417,3254,1959,-1295
2017,7,6,6,3170,2993,1933,-1060
2017,7,6,7,3067,2762,1888,-874
2017,7,6,8,2701,2614,1831,-783
2017,7,6,9,2567,2492,1767,-725
2017,7,6,10,2468,2385,1658,-727
2017,7,6,11,2422,2341,1640,-701
2017,7,6,12,2426,2344,1647,-697
2017,7,6,13,2484,2405,1642,-763
2017,7,6,14,2628,2455,1647,-808
2017,7,6,15,2780,2507,1644,-863
2017,7,6,16,2942,2640,1639,-1001
2017,7,6,17,3102,2810,1738,-1072
2017,7,6,18,3254,2951,1832,-1119
2017,7,6,19,3387,3087,1980,-1107
2017,7,6,20,3525,3207,1964,-1243
2017,7,6,21,3649,3225,1966,-1259
2017,7,6,22,3744,3217,1896,-1321
2017,7,6,23,3790,3214,1936,-1278
2017,7,7,0,3840,3182,1959,-1223
2017,7,7,1,3860,3234,1972,-1262
2017,7,7,2,3855,3328,1960,-1368
2017,7,7,3,3764,3437,2037,-1400
2017,7,7,4,3616,3428,2131,-1297
2017,7,7,5,3414,3261,2018,-1243
2017,7,7,6,3158,3005,1963,-1042
2017,7,7,7,2938,2786,1905,-881
2017,7,7,8,2739,2650,1895,-755
2017,7,7,9,2600,2531,1814,-717
2017,7,7,10,2508,2442,1703,-739
2017,7,7,11,2454,2380,1630,-750
2017,7,7,12,2462,2378,1613,-765
2017,7,7,13,2527,2444,1554,-890
2017,7,7,14,2683,2513,1555,-958
2017,7,7,15,2840,2585,1589,-996
2017,7,7,16,2976,2699,1573,-1126
2017,7,7,17,3134,2879,1625,-1254
2017,7,7,18,3288,3048,1688,-1360
2017,7,7,19,3424,3193,1827,-1366
2017,7,7,20,3556,3332,1984,-1348
2017,7,7,21,3647,3425,2044,-1381
2017,7,7,22,3701,3490,2050,-1440
2017,7,7,23,3721,3519,2137,-1382
2017,7,8,0,3633,3497,2061,-1436
2017,7,8,1,3660,3524,2058,-1466
2017,7,8,2,3668,3542,2052,-1490
2017,7,8,3,3613,3576,2085,-1491
2017,7,8,4,3531,3524,2027,-1497
2017,7,8,5,3397,3368,1939,-1429
2017,7,8,6,3187,3135,1957,-1178
2017,7,8,7,3006,2927,1988,-939
2017,7,8,8,2782,2751,1912,-839
2017,7,8,9,2676,2608,1710,-898
2017,7,8,10,2565,2508,1610,-898
2017,7,8,11,2491,2420,1534,-886
2017,7,8,12,2435,2369,1541,-828
2017,7,8,13,2406,2356,1551,-805
2017,7,8,14,2504,2383,1586,-797
2017,7,8,15,2694,2431,1531,-900
2017,7,8,16,2840,2567,1501,-1066
2017,7,8,17,3001,2749,1579,-1170
2017,7,8,18,3158,2885,1539,-1346
2017,7,8,19,3302,3032,1575,-1457
2017,7,8,20,3413,3145,1737,-1408
2017,7,8,21,3494,3261,1801,-1460
2017,7,8,22,3565,3345,1860,-1485
2017,7,8,23,3594,3419,1957,-1462
2017,7,9,0,3608,3472,2110,-1362
2017,7,9,1,3636,3489,2115,-1374
2017,7,9,2,3624,3550,2151,-1399
2017,7,9,3,3532,3558,2139,-1419
2017,7,9,4,3466,3446,2063,-1383
2017,7,9,5,3356,3303,2069,-1234
2017,7,9,6,3157,3086,2030,-1056
2017,7,9,7,2929,2920,2010,-910
2017,7,9,8,2762,2785,1840,-945
2017,7,9,9,2691,2687,1734,-953
2017,7,9,10,2587,2571,1636,-935
2017,7,9,11,2510,2477,1541,-936
2017,7,9,12,2470,2412,1508,-904
2017,7,9,13,2432,2371,1515,-856
2017,7,9,14,2517,2360,1518,-842
2017,7,9,15,2684,2410,1533,-877
2017,7,9,16,2820,2544,1564,-980
2017,7,9,17,2964,2695,1521,-1174
2017,7,9,18,3090,2834,1511,-1323
2017,7,9,19,3236,2967,1522,-1445
2017,7,9,20,3334,3082,1619,-1463
2017,7,9,21,3422,3177,1701,-1476
2017,7,9,22,3498,3295,1844,-1451
2017,7,9,23,3551,3290,1922,-1368
2017,7,10,0,3589,3300,1914,-1386
2017,7,10,1,3601,3310,1964,-1346
2017,7,10,2,3574,3309,1962,-1347
2017,7,10,3,3491,3296,1998,-1298
2017,7,10,4,3373,3236,2017,-1219
2017,7,10,5,3228,3114,2069,-1045
2017,7,10,6,2985,2901,1979,-922
2017,7,10,7,2765,2716,1917,-799
2017,7,10,8,2576,2568,1751,-817
2017,7,10,9,2484,2452,1634,-818
2017,7,10,10,2400,2356,1533,-823
2017,7,10,11,2356,2326,1530,-796
2017,7,10,12,2382,2334,1589,-745
2017,7,10,13,2477,2428,1614,-814
2017,7,10,14,2655,2523,1702,-821
2017,7,10,15,2887,2601,1819,-782
2017,7,10,16,2990,2717,1839,-878
2017,7,10,17,3118,2543,1600,-943
2017,7,10,18,3247,2968,1918,-1050
2017,7,10,19,3377,3054,1900,-1154
2017,7,10,20,3513,3177,1996,-1181
2017,7,10,21,3613,3254,1989,-1265
2017,7,10,22,3686,3344,2038,-1306
2017,7,10,23,3708,3373,2039,-1334
2017,7,11,0,3733,3376,2062,-1314
2017,7,11,1,3766,3416,2206,-1210
2017,7,11,2,3766,3437,2180,-1257
2017,7,11,3,3677,3467,2136,-1331
2017,7,11,4,3529,3394,2100,-1294
2017,7,11,5,3321,3209,1934,-1275
2017,7,11,6,3060,2953,1760,-1193
2017,7,11,7,2827,2720,1616,-1104
2017,7,11,8,2625,2584,1535,-1049
2017,7,11,9,2520,2461,1493,-968
2017,7,11,10,2419,2368,1516,-852
2017,7,11,11,2355,2327,1556,-771
2017,7,11,12,2354,2321,1604,-717
2017,7,11,13,2442,2382,1588,-794
2017,7,11,14,2601,2428,1629,-799
2017,7,11,15,2698,2457,1652,-805
2017,7,11,16,2829,2539,1707,-832
2017,7,11,17,2956,2614,1757,-857
2017,7,11,18,3090,2685,1734,-951
2017,7,11,19,3217,2786,1753,-1033
2017,7,11,20,3330,2874,1810,-1064
2017,7,11,21,3429,2962,1823,-1139
2017,7,11,22,3509,3034,1935,-1099
2017,7,11,23,3536,3082,2007,-1075
2017,7,12,0,3554,3089,1942,-1147
2017,7,12,1,3587,3122,1994,-1128
2017,7,12,2,3582,3160,1972,-1188
2017,7,12,3,3523,3224,1973,-1251
2017,7,12,4,3397,3170,1962,-1208
2017,7,12,5,3242,2987,1837,-1150
2017,7,12,6,2950,2733,1780,-953
2017,7,12,7,2747,2547,1704,-843
2017,7,12,8,2598,2441,1596,-845
2017,7,12,9,2347,2342,1478,-864
2017,7,12,10,2277,2288,1421,-867
2017,7,12,11,2254,2253,1382,-871
2017,7,12,12,2287,2250,1358,-892
2017,7,12,13,2380,2318,1350,-968
2017,7,12,14,2547,2362,1314,-1048
2017,7,12,15,2694,2380,1297,-1083
2017,7,12,16,2845,2481,1432,-1049
2017,7,12,17,3003,2600,1466,-1134
2017,7,12,18,3156,2688,1505,-1183
2017,7,12,19,3313,2816,1641,-1175
2017,7,12,20,3476,2951,1768,-1183
2017,7,12,21,3625,3072,1813,-1259
2017,7,12,22,3762,3168,1906,-1262
2017,7,12,23,3840,3236,1967,-1269
2017,7,13,0,3881,3269,2047,-1222
2017,7,13,1,3932,3319,2063,-1256
2017,7,13,2,3924,3368,2038,-1330
2017,7,13,3,3838,3412,2069,-1343
2017,7,13,4,3661,3336,1889,-1447
2017,7,13,5,3421,3144,1761,-1383
2017,7,13,6,3095,2869,1643,-1226
2017,7,13,7,2898,2662,1571,-1091
2017,7,13,8,2616,2525,1561,-964
2017,7,13,9,2476,2454,1578,-876
2017,7,13,10,2413,2366,1498,-868
2017,7,13,11,2373,2307,1524,-783
2017,7,13,12,2392,2327,1518,-809
2017,7,13,13,2473,2388,1504,-884
2017,7,13,14,2651,2438,1607,-831
2017,7,13,15,2820,2472,1608,-864
2017,7,13,16,2944,2579,1629,-950
2017,7,13,17,3066,2721,1715,-1006
2017,7,13,18,3202,2873,1742,-1131
2017,7,13,19,3345,3008,1758,-1250
2017,7,13,20,3469,3093,1823,-1270
2017,7,13,21,3602,3232,1965,-1267
2017,7,13,22,3670,3306,2001,-1305
2017,7,13,23,3697,3346,1983,-1363
2017,7,14,0,3695,3358,1995,-1363
2017,7,14,1,3714,3405,2039,-1366
2017,7,14,2,3706,3421,2072,-1349
2017,7,14,3,3610,3409,2057,-1352
2017,7,14,4,3493,3849,2610,-1239
2017,7,14,5,3345,3241,2115,-1126
2017,7,14,6,3110,2971,1941,-1030
2017,7,14,7,2934,2760,1743,-1017
2017,7,14,8,2724,2624,1662,-962
2017,7,14,9,2552,2519,1611,-908
2017,7,14,10,2461,2430,1573,-857
2017,7,14,11,2414,2381,1570,-811
2017,7,14,12,2417,2375,1560,-815
2017,7,14,13,2496,2428,1591,-837
2017,7,14,14,2657,2515,1578,-937
2017,7,14,15,2802,2586,1606,-980
2017,7,14,16,2916,2643,1677,-966
2017,7,14,17,3023,2750,1775,-975
2017,7,14,18,3147,2840,1872,-968
2017,7,14,19,3282,2969,1913,-1056
2017,7,14,20,3411,3126,1914,-1212
2017,7,14,21,3555,3194,1916,-1278
2017,7,14,22,3660,3273,2028,-1245
2017,7,14,23,3720,3293,2076,-1217
2017,7,15,0,3733,3325,2088,-1237
2017,7,15,1,3738,3352,2060,-1292
2017,7,15,2,3710,3437,2096,-1341
2017,7,15,3,3595,3429,2107,-1322
2017,7,15,4,3500,3448,2142,-1306
2017,7,15,5,3358,3185,1899,-1286
2017,7,15,6,3125,2951,1907,-1044
2017,7,15,7,3017,2741,1782,-959
2017,7,15,8,2726,2781,1949,-832
2017,7,15,9,2580,2524,1715,-809
2017,7,15,10,2492,2427,1622,-805
2017,7,15,11,2419,2355,1584,-771
2017,7,15,12,2400,2323,1666,-657
2017,7,15,13,2396,2320,1688,-632
2017,7,15,14,2511,2330,1695,-635
2017,7,15,15,2691,2391,1726,-665
2017,7,15,16,2833,2554,1828,-726
2017,7,15,17,3013,2765,1961,-804
2017,7,15,18,3177,2900,2022,-878
2017,7,15,19,3332,2982,2017,-965
2017,7,15,20,3440,3046,1982,-1064
2017,7,15,21,3538,3044,1969,-1075
2017,7,15,22,3620,3044,1995,-1049
2017,7,15,23,3633,3002,2039,-963
2017,7,16,0,3648,3015,2082,-933
2017,7,16,1,3632,3110,2186,-924
2017,7,16,2,3615,3212,2123,-1089
2017,7,16,3,3503,3249,2128,-1121
2017,7,16,4,3376,3185,2074,-1111
2017,7,16,5,3223,3061,2052,-1009
2017,7,16,6,2992,2821,1841,-980
2017,7,16,7,2808,2629,1781,-848
2017,7,16,8,2570,2474,1942,-532
2017,7,16,9,2405,2374,1860,-514
2017,7,16,10,2317,2281,1776,-505
2017,7,16,11,2227,2224,1785,-439
2017,7,16,12,2177,2205,1819,-386
2017,7,16,13,2152,2167,1819,-348
2017,7,16,14,2220,2151,1775,-376
2017,7,16,15,2361,2144,1782,-362
2017,7,16,16,2481,2230,1818,-412
2017,7,16,17,2605,2321,1824,-497
2017,7,16,18,2705,2427,1895,-532
2017,7,16,19,2809,2535,1977,-558
2017,7,16,20,2892,2624,2048,-576
2017,7,16,21,2978,2709,2048,-661
2017,7,16,22,3075,2784,2133,-651
2017,7,16,23,3094,2856,2237,-619
2017,7,17,0,3150,2890,2281,-609
2017,7,17,1,3175,2915,2321,-594
2017,7,17,2,3154,2945,2320,-625
2017,7,17,3,3071,2986,2411,-575
2017,7,17,4,2963,2928,2401,-527
2017,7,17,5,2839,2752,2251,-501
2017,7,17,6,2619,2512,1996,-516
2017,7,17,7,2484,2315,1849,-466
2017,7,17,8,2315,2195,1711,-484
2017,7,17,9,2131,2130,1622,-508
2017,7,17,10,2056,2092,1595,-497
2017,7,17,11,2030,2087,1600,-487
2017,7,17,12,2072,2128,1705,-423
2017,7,17,13,2159,2221,1779,-442
2017,7,17,14,2324,2295,1757,-538
2017,7,17,15,2529,2303,1762,-541
2017,7,17,16,2624,2360,1725,-635
2017,7,17,17,2750,2431,1703,-728
2017,7,17,18,2865,2528,1766,-762
2017,7,17,19,2987,2606,1818,-788
2017,7,17,20,3096,2720,1827,-893
2017,7,17,21,3200,2819,1929,-890
2017,7,17,22,3293,2896,1916,-980
2017,7,17,23,3321,2974,1794,-1180
2017,7,18,0,3352,3008,1826,-1182
2017,7,18,1,3370,3063,1854,-1209
2017,7,18,2,3371,3120,1966,-1154
2017,7,18,3,3292,3170,1976,-1194
2017,7,18,4,3164,3080,1898,-1182
2017,7,18,5,2999,2911,1797,-1114
2017,7,18,6,2740,2663,1724,-939
2017,7,18,7,2607,2473,1659,-814
2017,7,18,8,2402,2356,1615,-741
2017,7,18,9,2286,2262,1509,-753
2017,7,18,10,2212,2202,1451,-751
2017,7,18,11,2181,2163,1584,-579
2017,7,18,12,2212,2185,1623,-562
2017,7,18,13,2299,2257,1685,-572
2017,7,18,14,2439,2303,1729,-574
2017,7,18,15,2554,2298,1698,-600
2017,7,18,16,2678,2383,1785,-598
2017,7,18,17,2816,2489,1889,-600
2017,7,18,18,2955,672,1940,-575
2017,7,18,19,3069,2720,1973,-747
2017,7,18,20,3193,2838,1994,-844
2017,7,18,21,3308,2953,1982,-971
2017,7,18,22,3397,3057,2024,-1033
2017,7,18,23,3451,3124,2137,-987
2017,7,19,0,3495,3165,2168,-997
2017,7,19,1,3521,3190,2056,-1134
2017,7,19,2,3519,3228,2085,-1143
2017,7,19,3,3422,3263,2136,-1127
2017,7,19,4,3299,3183,2108,-1075
2017,7,19,5,3127,2995,2028,-967
2017,7,19,6,2869,2723,1848,-875
2017,7,19,7,2670,2511,1736,-775
2017,7,19,8,2487,2372,1692,-680
2017,7,19,9,2352,2289,1624,-665
2017,7,19,10,2277,2215,1556,-659
2017,7,19,11,2245,2170,1531,-639
2017,7,19,12,2265,2186,1637,-549
2017,7,19,13,2349,2263,1705,-558
2017,7,19,14,2501,2305,1777,-528
2017,7,19,15,2618,2300,1747,-553
2017,7,19,16,2726,2377,1753,-624
2017,7,19,17,2847,2487,1851,-636
2017,7,19,18,2953,2591,1938,-653
2017,7,19,19,3060,2749,1980,-769
2017,7,19,20,3170,2857,2025,-832
2017,7,19,21,3269,2952,1933,-1019
2017,7,19,22,3362,3062,2014,-1048
2017,7,19,23,3410,3104,2041,-1063
2017,7,20,0,3438,3124,2059,-1065
2017,7,20,1,3458,3157,2074,-1083
2017,7,20,2,3442,3205,2104,-1101
2017,7,20,3,3331,3253,2146,-1107
2017,7,20,4,3219,3168,2043,-1125
2017,7,20,5,3042,2986,1990,-996
2017,7,20,6,2784,2707,1835,-872
2017,7,20,7,2634,2510,1772,-738
2017,7,20,8,2425,2374,1688,-686
2017,7,20,9,2337,2276,1612,-664
2017,7,20,10,2274,2199,1626,-573
2017,7,20,11,2243,2165,1648,-517
2017,7,20,12,2256,2187,1703,-484
2017,7,20,13,2330,2266,1747,-519
2017,7,20,14,2485,2325,1816,-509
2017,7,20,15,2611,2336,1819,-517
2017,7,20,16,2706,2412,1837,-575
2017,7,20,17,2798,2483,1896,-587
2017,7,20,18,2898,2573,1974,-599
2017,7,20,19,3009,2689,2075,-614
2017,7,20,20,3111,2780,2148,-632
2017,7,20,21,3196,2873,2241,-632
2017,7,20,22,3294,2969,2241,-728
2017,7,20,23,3340,3003,2225,-778
2017,7,21,0,3362,3041,2272,-769
2017,7,21,1,3368,3060,2311,-749
2017,7,21,2,3349,3088,2306,-782
2017,7,21,3,3232,3128,2202,-926
2017,7,21,4,3127,3048,2127,-921
2017,7,21,5,2981,2875,2045,-830
2017,7,21,6,2737,2617,1893,-724
2017,7,21,7,2537,2437,1750,-687
2017,7,21,8,2342,2310,1747,-563
2017,7,21,9,2225,2227,1707,-520
2017,7,21,10,2145,2167,1660,-507
2017,7,21,11,2104,2131,1644,-487
2017,7,21,12,2128,2146,1622,-524
2017,7,21,13,2207,2209,1651,-558
2017,7,21,14,2354,2251,1726,-525
2017,7,21,15,2469,2234,1660,-574
2017,7,21,16,2563,2312,1649,-663
2017,7,21,17,2660,2409,1647,-762
2017,7,21,18,2763,2279,1635,-644
2017,7,21,19,2889,2580,1587,-993
2017,7,21,20,3025,2691,1625,-1066
2017,7,21,21,3138,2808,1695,-1113
2017,7,21,22,3240,2908,1744,-1164
2017,7,21,23,3291,2973,1816,-1157
2017,7,22,0,3318,3001,1863,-1138
2017,7,22,1,3319,3015,1916,-1099
2017,7,22,2,3276,3040,2002,-1038
2017,7,22,3,3182,3072,1978,-1094
2017,7,22,4,3067,2979,1962,-1017
2017,7,22,5,2941,2834,1918,-916
2017,7,22,6,2735,2610,1830,-780
2017,7,22,7,2554,2427,1793,-634
2017,7,22,8,2386,2299,1729,-570
2017,7,22,9,2214,2211,1646,-565
2017,7,22,10,2128,2149,1594,-555
2017,7,22,11,2072,2092,1621,-471
2017,7,22,12,2055,2073,1636,-437
2017,7,22,13,2067,2081,1602,-479
2017,7,22,14,2184,2064,1646,-418
2017,7,22,15,2353,2048,1617,-431
2017,7,22,16,2476,2133,1684,-449
2017,7,22,17,2596,2235,1588,-647
2017,7,22,18,2710,2340,1630,-710
2017,7,22,19,2808,2434,1635,-799
2017,7,22,20,2906,2558,1661,-897
2017,7,22,21,3004,2677,1775,-902
2017,7,22,22,3105,2777,1862,-915
2017,7,22,23,3160,2859,1914,-945
2017,7,23,0,3208,2905,1956,-949
2017,7,23,1,3225,2922,1974,-948
2017,7,23,2,3209,2978,2019,-959
2017,7,23,3,3108,3002,2086,-916
2017,7,23,4,2991,2914,2071,-843
2017,7,23,5,2830,2761,1999,-762
2017,7,23,6,2607,2545,1886,-659
2017,7,23,7,2455,2360,1757,-603
2017,7,23,8,2293,2211,1585,-626
2017,7,23,9,2196,2132,1546,-586
2017,7,23,10,2138,2067,1523,-544
2017,7,23,11,2087,2024,1487,-537
2017,7,23,12,2050,2015,1460,-555
2017,7,23,13,2035,2002,1424,-578
2017,7,23,14,2118,1971,1405,-566
2017,7,23,15,2276,1970,1381,-589
2017,7,23,16,2416,2074,1471,-603
2017,7,23,17,2538,2172,1563,-609
2017,7,23,18,2653,2299,1623,-676
2017,7,23,19,2778,2431,1607,-824
2017,7,23,20,2902,2593,1675,-918
2017,7,23,21,3023,2709,1749,-960
2017,7,23,22,3150,2847,1860,-987
2017,7,23,23,3252,2928,1947,-981
2017,7,24,0,3332,3003,2025,-978
2017,7,24,1,3357,3041,2055,-986
2017,7,24,2,3311,3063,2099,-964
2017,7,24,3,3195,3108,2124,-984
2017,7,24,4,3054,3022,2049,-973
2017,7,24,5,2881,2825,1858,-967
2017,7,24,6,2631,2583,1786,-797
2017,7,24,7,2436,2365,1689,-676
2017,7,24,8,2294,2235,1594,-641
2017,7,24,9,2220,2220,1594,-9999
2017,7,24,10,2156,2156,1523,-9999
2017,7,24,11,2139,2139,1487,-9999
2017,7,24,12,2165,2165,1460,-9999
2017,7,24,13,2288,2288,1424,-9999
2017,7,24,14,2451,2451,1405,-9999
2017,7,24,15,2648,2648,1381,-9999
2017,7,24,16,2755,2755,1471,-9999
2017,7,24,17,2780,2780,1563,-9999
2017,7,24,18,2856,2856,1623,-9999
2017,7,24,19,2958,2958,1607,-9999
2017,7,24,20,3084,3084,1675,-9999
2017,7,24,21,3240,3240,1749,-9999
2017,7,24,22,3347,3347,1860,-9999
2017,7,24,23,3407,3407,1947,-9999
2017,7,25,0,3472,3472,2025,-9999
2017,7,25,1,3470,3470,2055,-9999
2017,7,25,2,3411,3411,2099,-9999
2017,7,25,3,3260,3260,2124,-9999
2017,7,25,4,3172,3172,2049,-9999
2017,7,25,5,3000,3000,1858,-9999
2017,7,25,6,2760,2760,1786,-9999
2017,7,25,7,2646,2646,1689,-9999
2017,7,25,8,2496,2398,1680,-718
2017,7,25,9,2348,2325,1659,-666
2017,7,25,10,2276,2253,1677,-576
2017,7,25,11,2242,2223,1652,-571
2017,7,25,12,2273,2257,1650,-607
2017,7,25,13,2374,2333,1705,-628
2017,7,25,14,2528,2444,1782,-662
2017,7,25,15,2599,2507,1842,-665
2017,7,25,16,2660,2501,1750,-751
2017,7,25,17,2724,2522,1719,-803
2017,7,25,18,2818,2543,1724,-819
2017,7,25,19,2931,2616,1782,-834
2017,7,25,20,3050,2732,1774,-958
2017,7,25,21,3163,2840,1764,-1076
2017,7,25,22,3249,2947,1764,-1183
2017,7,25,23,3306,2993,1807,-1186
2017,7,26,0,3316,3054,1859,-1195
2017,7,26,1,3327,3140,1921,-1219
2017,7,26,2,3310,3177,2009,-1168
2017,7,26,3,3211,3158,1987,-1171
2017,7,26,4,3116,3063,1987,-1076
2017,7,26,5,2926,2876,2062,-814
2017,7,26,6,2679,2641,2017,-624
2017,7,26,7,2547,2461,1867,-594
2017,7,26,8,2338,2354,1809,-545
2017,7,26,9,2291,2282,1697,-585
2017,7,26,10,2228,2206,1631,-575
2017,7,26,11,2201,2178,1647,-531
2017,7,26,12,2222,2199,1651,-548
2017,7,26,13,2294,2299,1731,-568
2017,7,26,14,2434,2383,1643,-740
2017,7,26,15,2531,2463,1726,-737
2017,7,26,16,2632,2451,1578,-873
2017,7,26,17,2710,2464,1491,-973
2017,7,26,18,2824,2582,1597,-985
2017,7,26,19,2948,2689,1663,-1026
2017,7,26,20,3080,2811,1677,-1134
2017,7,26,21,3205,2935,1745,-1190
2017,7,26,22,3293,3095,1901,-1194
2017,7,26,23,3374,3169,1962,-1207
2017,7,27,0,3392,3112,2006,-1106
2017,7,27,1,3399,3032,2054,-978
2017,7,27,2,3372,2932,1963,-969
2017,7,27,3,3270,2929,1908,-1021
2017,7,27,4,3139,2883,1871,-1012
2017,7,27,5,2941,2731,1791,-940
2017,7,27,6,2706,2512,1694,-818
2017,7,27,7,2478,2355,1757,-598
2017,7,27,8,2323,2251,1635,-616
2017,7,27,9,2232,2164,1577,-587
2017,7,27,10,2172,2108,1569,-539
2017,7,27,11,2144,2079,1497,-582
2017,7,27,12,2167,2102,1532,-570
2017,7,27,13,2253,2193,1581,-612
2017,7,27,14,2386,2259,1552,-707
2017,7,27,15,2490,2269,1521,-748
2017,7,27,16,2594,2298,1460,-838
2017,7,27,17,2695,2421,1582,-839
2017,7,27,18,2812,2562,1634,-928
2017,7,27,19,2918,2675,1627,-1048
2017,7,27,20,3031,2763,1642,-1121
2017,7,27,21,3144,2881,1683,-1198
2017,7,27,22,3249,2957,1819,-1138
2017,7,27,23,3304,3008,1889,-1119
2017,7,28,0,3306,3013,1892,-1121
2017,7,28,1,3301,3034,1893,-1141
2017,7,28,2,3271,3071,1907,-1164
2017,7,28,3,3213,3095,1908,-1187
2017,7,28,4,3119,3021,1866,-1155
2017,7,28,5,2924,2829,1766,-1063
2017,7,28,6,2671,2596,1706,-890
2017,7,28,7,2496,2393,1707,-686
2017,7,28,8,2317,2288,1767,-521
2017,7,28,9,2235,2184,1625,-559
2017,7,28,10,2173,2136,1625,-511
2017,7,28,11,2139,2095,1584,-511
2017,7,28,12,2151,2123,1713,-410
2017,7,28,13,2226,2200,1812,-388
2017,7,28,14,2343,2233,1714,-519
2017,7,28,15,2494,2302,1711,-591
2017,7,28,16,2640,2357,1675,-682
2017,7,28,17,2787,2400,1609,-791
2017,7,28,18,2952,2482,1629,-853
2017,7,28,19,3100,2610,1742,-868
2017,7,28,20,3247,2773,1780,-993
2017,7,28,21,3356,2914,1772,-1142
2017,7,28,22,3460,3013,1745,-1268
2017,7,28,23,3525,3067,1814,-1253
2017,7,29,0,3502,3096,1961,-1135
2017,7,29,1,3477,3113,1986,-1127
2017,7,29,2,3436,3136,1949,-1187
2017,7,29,3,3348,3071,1898,-1173
2017,7,29,4,3244,2989,1847,-1142
2017,7,29,5,3068,2816,1746,-1070
2017,7,29,6,2826,2600,1695,-905
2017,7,29,7,2620,2423,1698,-725
2017,7,29,8,2432,2282,1743,-539
2017,7,29,9,2274,2182,1687,-495
2017,7,29,10,2204,2110,1570,-540
2017,7,29,11,2129,2073,1583,-490
2017,7,29,12,2104,2055,1681,-374
2017,7,29,13,2112,2061,1704,-357
2017,7,29,14,2196,2066,1685,-381
2017,7,29,15,2378,2063,1533,-530
2017,7,29,16,2542,2156,1531,-625
2017,7,29,17,2689,2276,1623,-653
2017,7,29,18,2847,2419,1755,-664
2017,7,29,19,2987,2584,1923,-661
2017,7,29,20,3096,2716,1917,-799
2017,7,29,21,3202,2846,1793,-1053
2017,7,29,22,3327,2943,1844,-1099
2017,7,29,23,3397,3030,1902,-1128
2017,7,30,0,3427,3100,1974,-1126
2017,7,30,1,3419,3184,1957,-1227
2017,7,30,2,3374,3166,1942,-1224
2017,7,30,3,3264,3134,1930,-1204
2017,7,30,4,3141,3026,1900,-1126
2017,7,30,5,2980,2863,1872,-991
2017,7,30,6,2764,2638,1811,-827
2017,7,30,7,2628,2459,1699,-760
2017,7,30,8,2418,2328,1710,-618
2017,7,30,9,2269,2219,1672,-547
2017,7,30,10,2193,2135,1635,-500
2017,7,30,11,2122,2070,1644,-426
2017,7,30,12,2077,2046,1690,-356
2017,7,30,13,2052,2029,1686,-343
2017,7,30,14,2095,2014,1676,-338
2017,7,30,15,2264,1988,1658,-330
2017,7,30,16,2427,2069,1631,-438
2017,7,30,17,2569,2227,1699,-528
2017,7,30,18,2706,2360,1680,-680
2017,7,30,19,2858,2495,1646,-849
2017,7,30,20,2990,2638,1640,-998
2017,7,30,21,3115,2775,1702,-1073
2017,7,30,22,3232,2891,1800,-1091
2017,7,30,23,3335,2979,1884,-1095
2017,7,31,0,3405,3041,1931,-1110
2017,7,31,1,3396,3036,2007,-1029
2017,7,31,2,3344,3057,2059,-998
2017,7,31,3,3228,3071,2095,-976
2017,7,31,4,3119,2983,2058,-925
2017,7,31,5,2931,2792,1994,-798
2017,7,31,6,2661,2541,1840,-701
2017,7,31,7,2483,2341,1660,-681
2017,7,31,8,2258,2211,1653,-558
2017,7,31,9,2155,2118,1636,-482
2017,7,31,10,2091,2056,1573,-483
2017,7,31,11,2078,2033,1567,-466
2017,7,31,12,2122,2060,1582,-478
2017,7,31,13,2212,2153,1615,-538
2017,7,31,14,2337,2225,1730,-495
2017,7,31,15,2529,2229,1721,-508
2017,7,31,16,2665,2309,1726,-583
2017,7,31,17,2802,2450,1737,-713
2017,7,31,18,2957,2587,1749,-838
2017,7,31,19,3115,2725,1762,-963
2017,7,31,20,3274,2880,1856,-1024
2017,7,31,21,3414,3016,1892,-1124
2017,7,31,22,3527,3127,1943,-1184
2017,7,31,23,3594,3190,2071,-1119
2017,8,1,0,3618,3211,2080,-1131
2017,8,1,1,3614,3249,2271,-978
2017,8,1,2,3584,3292,2419,-873
2017,8,1,3,3484,3296,2419,-877
2017,8,1,4,3356,3178,2229,-949
2017,8,1,5,3154,2950,2061,-889
2017,8,1,6,2876,2683,1795,-888
2017,8,1,7,2653,2469,1630,-839
2017,8,1,8,2450,2358,1633,-725
2017,8,1,9,2313,2266,1632,-634
2017,8,1,10,2242,2186,1591,-595
2017,8,1,11,2185,2154,1571,-583
2017,8,1,12,2194,2169,1593,-576
2017,8,1,13,2276,2256,1649,-607
2017,8,1,14,2402,2303,1678,-625
2017,8,1,15,2539,2319,1672,-647
2017,8,1,16,2687,2385,1709,-676
2017,8,1,17,2831,2506,1831,-675
2017,8,1,18,2790,2635,1923,-712
2017,8,1,19,2938,2799,1970,-829
2017,8,1,20,3098,2912,1900,-1012
2017,8,1,21,3239,2981,2033,-948
2017,8,1,22,3358,3068,2102,-966
2017,8,1,23,3416,3116,2194,-922
2017,8,2,0,3424,3142,2209,-933
2017,8,2,1,3409,3173,2229,-944
2017,8,2,2,3366,3261,2279,-982
2017,8,2,3,3244,3240,2233,-1007
2017,8,2,4,3128,3152,2126,-1026
2017,8,2,5,2932,2932,1977,-955
2017,8,2,6,2859,2672,1592,-1080
2017,8,2,7,2649,2486,1643,-843
2017,8,2,8,2430,2330,1612,-718
2017,8,2,9,2319,2229,1617,-612
2017,8,2,10,2232,2171,1606,-565
2017,8,2,11,2184,2133,1587,-546
2017,8,2,12,2204,2159,1594,-565
2017,8,2,13,2288,2237,1649,-588
2017,8,2,14,2421,2281,1745,-536
2017,8,2,15,2563,2278,1715,-563
2017,8,2,16,2718,2364,1691,-673
2017,8,2,17,2865,2473,1682,-791
2017,8,2,18,3039,2616,1750,-866
2017,8,2,19,3175,2766,1824,-942
2017,8,2,20,3311,2934,1961,-973
2017,8,2,21,3418,3064,2114,-950
2017,8,2,22,3528,3160,2093,-1067
2017,8,2,23,3580,3207,2062,-1145
2017,8,3,0,3595,3220,2081,-1139
2017,8,3,1,3596,3243,2075,-1168
2017,8,3,2,3552,3289,2063,-1226
2017,8,3,3,3430,3328,2198,-1130
2017,8,3,4,3330,3236,2135,-1101
2017,8,3,5,3142,3023,1988,-1035
2017,8,3,6,2867,2758,1754,-1004
2017,8,3,7,2627,2541,1673,-868
2017,8,3,8,2448,2398,1654,-744
2017,8,3,9,2324,2281,1628,-653
2017,8,3,10,2211,2208,1622,-586
2017,8,3,11,2156,2156,1565,-591
2017,8,3,12,2159,2165,1564,-601
2017,8,3,13,2239,2243,1583,-660
2017,8,3,14,2380,2308,1672,-636
2017,8,3,15,2530,2323,1708,-615
2017,8,3,16,2673,2372,1724,-648
2017,8,3,17,2830,2463,1763,-700
2017,8,3,18,2982,2574,1887,-687
2017,8,3,19,3107,2716,1936,-780
2017,8,3,20,3243,2836,1899,-937
2017,8,3,21,3364,2903,1953,-950
2017,8,3,22,3467,2921,2045,-876
2017,8,3,23,3516,2938,2121,-817
2017,8,4,0,3522,2946,2230,-716
2017,8,4,1,3534,2972,2191,-781
2017,8,4,2,3488,3061,2199,-862
2017,8,4,3,3387,3101,2253,-848
2017,8,4,4,3278,3056,2308,-748
2017,8,4,5,3090,2843,2048,-795
2017,8,4,6,2812,2596,1712,-884
2017,8,4,7,2603,2403,1635,-768
2017,8,4,8,2403,2270,1609,-661
2017,8,4,9,2217,2169,1549,-620
2017,8,4,10,2138,2097,1544,-553
2017,8,4,11,2097,2072,1550,-522
2017,8,4,12,2136,2088,1559,-529
2017,8,4,13,2228,2171,1614,-557
2017,8,4,14,2350,2215,1620,-595
2017,8,4,15,2494,2239,1601,-638
2017,8,4,16,2615,2308,1611,-697
2017,8,4,17,2734,2414,1604,-810
2017,8,4,18,2884,2559,1740,-819
2017,8,4,19,3016,2676,1854,-822
2017,8,4,20,3146,2813,1916,-897
2017,8,4,21,3237,2932,2007,-925
2017,8,4,22,3306,3015,2060,-955
2017,8,4,23,3342,3067,2112,-955
2017,8,5,0,3336,3086,2159,-927
2017,8,5,1,3327,3107,2108,-999
2017,8,5,2,3255,3132,2106,-1026
2017,8,5,3,3150,3111,1947,-1164
2017,8,5,4,3062,3012,1971,-1041
2017,8,5,5,2924,2832,1938,-894
2017,8,5,6,2693,2604,1721,-883
2017,8,5,7,2567,2425,1557,-868
2017,8,5,8,2357,2296,1443,-853
2017,8,5,9,2219,2185,1371,-814
2017,8,5,10,2132,2110,1324,-786
2017,8,5,11,2054,2059,1375,-684
2017,8,5,12,2042,2041,1484,-557
2017,8,5,13,2064,2065,1560,-505
2017,8,5,14,2150,2079,1694,-385
2017,8,5,15,2325,2080,1655,-425
2017,8,5,16,2460,2132,1726,-406
2017,8,5,17,2577,2226,1826,-400
2017,8,5,18,2697,2328,1859,-469
2017,8,5,19,2800,2425,1876,-549
2017,8,5,20,2899,2535,1849,-686
2017,8,5,21,2994,2639,1879,-760
2017,8,5,22,3061,2732,1912,-820
2017,8,5,23,3092,2798,1914,-884
2017,8,6,0,3118,2844,1929,-915
2017,8,6,1,3118,2857,1920,-937
2017,8,6,2,3085,2901,1965,-936
2017,8,6,3,2962,2842,1938,-904
2017,8,6,4,2851,2775,1877,-898
2017,8,6,5,2666,2607,1733,-874
2017,8,6,6,2425,2421,1465,-956
2017,8,6,7,2369,2263,1451,-812
2017,8,6,8,2156,2139,1383,-756
2017,8,6,9,2085,2072,1346,-726
2017,8,6,10,2018,2018,1290,-728
2017,8,6,11,1944,1978,1183,-795
2017,8,6,12,1933,1970,1208,-762
2017,8,6,13,1941,1972,1240,-732
2017,8,6,14,1990,1989,1229,-760
2017,8,6,15,2136,2051,1245,-806
2017,8,6,16,2263,2120,1263,-857
2017,8,6,17,2379,2175,1250,-925
2017,8,6,18,2512,2252,1282,-970
2017,8,6,19,2634,2305,1318,-987
2017,8,6,20,2748,2374,1237,-1137
2017,8,6,21,2861,2493,1251,-1242
2017,8,6,22,2954,2627,1408,-1219
2017,8,6,23,3016,2695,1544,-1151
2017,8,7,0,3056,2770,1629,-1141
2017,8,7,1,3054,2762,1620,-1142
2017,8,7,2,3007,2733,1567,-1166
2017,8,7,3,2897,2685,1515,-1170
2017,8,7,4,2807,2646,1534,-1112
2017,8,7,5,2650,2502,1454,-1048
2017,8,7,6,2430,2313,1428,-885
2017,8,7,7,2234,2172,1374,-798
2017,8,7,8,2076,2066,1300,-766
2017,8,7,9,2018,2015,1192,-823
2017,8,7,10,1971,1982,1198,-784
2017,8,7,11,1961,1971,1123,-848
2017,8,7,12,2024,2025,1166,-859
2017,8,7,13,2140,2147,1314,-833
2017,8,7,14,2283,2276,1449,-827
2017,8,7,15,2462,2365,1460,-905
2017,8,7,16,2584,2431,1593,-838
2017,8,7,17,2693,2509,1650,-859
2017,8,7,18,2815,2592,1606,-986
2017,8,7,19,2922,2581,1528,-1053
2017,8,7,20,3031,2616,1555,-1061
2017,8,7,21,3133,2706,1641,-1065
2017,8,7,22,3214,2806,1713,-1093
2017,8,7,23,3245,2823,1826,-997
2017,8,8,0,3243,2869,1869,-1000
2017,8,8,1,3242,2978,1894,-1084
2017,8,8,2,3195,3008,1939,-1069
2017,8,8,3,3124,2944,1872,-1072
2017,8,8,4,3054,2867,1892,-975
2017,8,8,5,2862,2678,1670,-1008
2017,8,8,6,2625,2451,1428,-1023
2017,8,8,7,2419,2292,1322,-970
2017,8,8,8,2218,2194,1251,-943
2017,8,8,9,2136,2118,1168,-950
2017,8,8,10,2071,2067,1126,-941
2017,8,8,11,2051,2043,1184,-859
2017,8,8,12,2095,2079,1115,-964
2017,8,8,13,2201,2170,1177,-993
2017,8,8,14,2327,2258,1196,-1062
2017,8,8,15,2440,2289,1190,-1099
2017,8,8,16,2564,2299,1213,-1086
2017,8,8,17,2677,2377,1251,-1126
2017,8,8,18,2787,2474,1377,-1097
2017,8,8,19,2893,2598,1512,-1086
2017,8,8,20,3002,2713,1608,-1105
2017,8,8,21,3106,2830,1681,-1149
2017,8,8,22,3186,2930,1776,-1154
2017,8,8,23,3231,3023,1819,-1204
2017,8,9,0,3233,3014,1826,-1188
2017,8,9,1,3237,3061,1856,-1205
2017,8,9,2,3181,3038,1794,-1244
2017,8,9,3,3104,2951,1709,-1242
2017,8,9,4,3020,2846,1660,-1186
2017,8,9,5,2816,2656,1545,-1111
2017,8,9,6,2574,2438,1528,-910
2017,8,9,7,2366,2297,1478,-819
2017,8,9,8,2228,2179,1351,-828
2017,8,9,9,2161,2098,1286,-812
2017,8,9,10,2096,2048,1230,-818
2017,8,9,11,2070,2010,1229,-781
2017,8,9,12,2106,2048,1225,-823
2017,8,9,13,2199,2135,1352,-783
2017,8,9,14,2310,2202,1524,-678
2017,8,9,15,2439,2257,1556,-701
2017,8,9,16,2566,2320,1650,-670
2017,8,9,17,2693,2347,1551,-796
2017,8,9,18,2825,2445,1553,-892
2017,8,9,19,2949,2535,1590,-945
2017,8,9,20,3085,2664,1540,-1124
2017,8,9,21,3190,2780,1622,-1158
2017,8,9,22,3266,2849,1687,-1162
2017,8,9,23,3282,2947,1795,-1152
2017,8,10,0,3276,2961,1802,-1159
2017,8,10,1,3281,2966,1803,-1163
2017,8,10,2,3206,2964,1816,-1148
2017,8,10,3,3128,2922,1748,-1174
2017,8,10,4,3043,2840,1735,-1105
2017,8,10,5,2837,2666,1576,-1090
2017,8,10,6,2608,2442,1277,-1165
2017,8,10,7,2423,2270,1323,-947
2017,8,10,8,2236,2155,1381,-774
2017,8,10,9,2132,2078,1331,-747
2017,8,10,10,2071,2022,1294,-728
2017,8,10,11,2051,2006,1266,-740
2017,8,10,12,2086,2029,1320,-709
2017,8,10,13,2190,2124,1348,-776
2017,8,10,14,2293,2193,1470,-723
2017,8,10,15,2440,2205,1383,-822
2017,8,10,16,2581,2239,1352,-887
2017,8,10,17,2704,2301,1507,-794
2017,8,10,18,2833,2405,1570,-835
2017,8,10,19,2962,2517,1630,-887
2017,8,10,20,3088,2644,1586,-1058
2017,8,10,21,3194,2767,1535,-1232
2017,8,10,22,3273,2854,1585,-1269
2017,8,10,23,3307,2921,1635,-1286
2017,8,11,0,3325,2968,1678,-1290
2017,8,11,1,3322,2987,1694,-1293
2017,8,11,2,3260,2973,1694,-1279
2017,8,11,3,3162,2890,1651,-1239
2017,8,11,4,3067,2831,1645,-1186
2017,8,11,5,2859,2652,1601,-1051
2017,8,11,6,2632,2440,1440,-1000
2017,8,11,7,2450,2283,1350,-933
2017,8,11,8,2265,2178,1276,-902
2017,8,11,9,2160,2091,1177,-914
2017,8,11,10,2112,2036,1160,-876
2017,8,11,11,2086,2014,1190,-824
2017,8,11,12,2130,2033,1214,-819
2017,8,11,13,2248,2122,1289,-833
2017,8,11,14,2350,2179,1360,-819
2017,8,11,15,2498,2168,1275,-893
2017,8,11,16,2632,2222,1300,-922
2017,8,11,17,2757,2343,1409,-934
2017,8,11,18,2884,2443,1475,-968
2017,8,11,19,3011,2570,1444,-1126
2017,8,11,20,3129,2745,1490,-1255
2017,8,11,21,3234,2863,1574,-1289
2017,8,11,22,3326,2911,1560,-1351
2017,8,11,23,3371,2948,1615,-1333
2017,8,12,0,3369,3003,1634,-1369
2017,8,12,1,3334,3063,1706,-1357
2017,8,12,2,3248,3060,1829,-1231
2017,8,12,3,3126,2978,1744,-1234
2017,8,12,4,3027,2889,1699,-1190
2017,8,12,5,2840,2710,1592,-1118
2017,8,12,6,2616,2502,1449,-1053
2017,8,12,7,2456,2332,1428,-904
2017,8,12,8,2314,2203,1379,-824
2017,8,12,9,2198,2117,1278,-839
2017,8,12,10,2126,2047,1210,-837
2017,8,12,11,2072,2007,1185,-822
2017,8,12,12,2065,1981,1120,-861
2017,8,12,13,2094,1999,1314,-685
2017,8,12,14,2155,2016,1337,-679
2017,8,12,15,2323,2011,1288,-723
2017,8,12,16,2476,2085,1311,-774
2017,8,12,17,2619,2222,1416,-806
2017,8,12,18,2752,2348,1364,-984
2017,8,12,19,2860,2496,1375,-1121
2017,8,12,20,2960,2623,1491,-1132
2017,8,12,21,3059,2754,1570,-1184
2017,8,12,22,3135,2843,1608,-1235
2017,8,12,23,3196,2878,1646,-1232
2017,8,13,0,3236,2957,1708,-1249
2017,8,13,1,3226,3025,1753,-1272
2017,8,13,2,3165,2962,1777,-1185
2017,8,13,3,3035,2888,1713,-1175
2017,8,13,4,2945,2823,1696,-1127
2017,8,13,5,2756,2654,1568,-1086
2017,8,13,6,2541,2449,1538,-911
2017,8,13,7,2402,2292,1565,-727
2017,8,13,8,2221,2158,1588,-570
2017,8,13,9,2122,2083,1525,-558
2017,8,13,10,2066,2012,1534,-478
2017,8,13,11,2030,1975,1522,-453
2017,8,13,12,2021,1948,1537,-411
2017,8,13,13,2026,1963,1528,-435
2017,8,13,14,2050,1955,1455,-500
2017,8,13,15,2183,1961,1446,-515
2017,8,13,16,2306,2016,1512,-504
2017,8,13,17,2400,2103,1569,-534
2017,8,13,18,2491,2200,1623,-577
2017,8,13,19,2580,2253,1605,-648
2017,8,13,20,2674,2317,1643,-674
2017,8,13,21,2747,2396,1711,-685
2017,8,13,22,2805,2475,1790,-685
2017,8,13,23,2837,2489,1823,-666
2017,8,14,0,2856,2497,1811,-686
2017,8,14,1,2824,2474,1712,-762
2017,8,14,2,2722,2415,1683,-732
2017,8,14,3,2650,2380,1730,-650
2017,8,14,4,2578,2343,1713,-630
2017,8,14,5,2428,2216,1638,-578
2017,8,14,6,2220,2059,1601,-458
2017,8,14,7,2092,1962,1601,-361
2017,8,14,8,1947,1879,1572,-307
2017,8,14,9,1900,1840,1477,-363
2017,8,14,10,1864,1805,1454,-351
2017,8,14,11,1871,1813,1357,-456
2017,8,14,12,1931,1869,1324,-545
2017,8,14,13,2038,1991,1401,-590
2017,8,14,14,2152,2104,1431,-673
2017,8,14,15,2295,2189,1405,-784
2017,8,14,16,2363,2228,1375,-853
2017,8,14,17,2411,2247,1354,-893
2017,8,14,18,2446,2231,1385,-846
2017,8,14,19,2497,2251,1372,-879
2017,8,14,20,2563,2262,1375,-887
2017,8,14,21,2635,2298,1417,-881
2017,8,14,22,2684,2360,1414,-946
2017,8,14,23,2715,2384,1417,-967
2017,8,15,0,2737,2425,1404,-1021
2017,8,15,1,2727,2473,1378,-1095
2017,8,15,2,2666,2537,1387,-1150
2017,8,15,3,2618,2538,1390,-1148
2017,8,15,4,2583,2494,1382,-1112
2017,8,15,5,2454,2324,1363,-961
2017,8,15,6,2270,2147,1353,-794
2017,8,15,7,2124,2010,1350,-660
2017,8,15,8,2028,1939,1325,-614
2017,8,15,9,1945,1897,1270,-627
2017,8,15,10,1896,1855,1233,-622
2017,8,15,11,1881,1857,1236,-621
2017,8,15,12,1924,1911,1267,-644
2017,8,15,13,2025,2018,1303,-715
2017,8,15,14,2119,2065,1321,-744
2017,8,15,15,2216,2016,1287,-729
2017,8,15,16,2322,2009,1234,-775
2017,8,15,17,2419,2074,1235,-839
2017,8,15,18,2504,2142,1211,-931
2017,8,15,19,2595,2251,1309,-942
2017,8,15,20,2693,2325,1373,-952
2017,8,15,21,2782,2418,1355,-1063
2017,8,15,22,2851,2488,1368,-1120
2017,8,15,23,2898,2557,1470,-1087
2017,8,16,0,2932,2588,1536,-1052
2017,8,16,1,2937,2633,1522,-1111
2017,8,16,2,2892,2712,1538,-1174
2017,8,16,3,2814,2717,1550,-1167
2017,8,16,4,2720,2647,1512,-1135
2017,8,16,5,2529,2454,1427,-1027
2017,8,16,6,2319,2243,1349,-894
2017,8,16,7,2191,2093,1361,-732
2017,8,16,8,2093,1995,1326,-669
2017,8,16,9,1994,1937,1298,-639
2017,8,16,10,1942,1906,1302,-604
2017,8,16,11,1936,1892,1279,-613
2017,8,16,12,1979,1939,1292,-647
2017,8,16,13,2086,2055,1377,-678
2017,8,16,14,2183,2102,1293,-809
2017,8,16,15,2289,2069,1210,-859
2017,8,16,16,2383,2073,1200,-873
2017,8,16,17,2463,2139,1281,-858
2017,8,16,18,2552,2202,1356,-846
2017,8,16,19,2639,2289,1325,-964
2017,8,16,20,2738,2368,1348,-1020
2017,8,16,21,2842,2448,1310,-1138
2017,8,16,22,2937,2529,1371,-1158
2017,8,16,23,3005,2607,1459,-1148
2017,8,17,0,3032,2645,1494,-1151
2017,8,17,1,3026,2689,1571,-1118
2017,8,17,2,2971,2760,1584,-1176
2017,8,17,3,2868,2784,1646,-1138
2017,8,17,4,2790,2693,1666,-1027
2017,8,17,5,2602,2503,1624,-879
2017,8,17,6,2377,2273,1575,-698
2017,8,17,7,2245,2134,1496,-638
2017,8,17,8,2431,2026,1440,-586
2017,8,17,9,2319,1960,1367,-593
2017,8,17,10,2172,1921,1415,-506
2017,8,17,11,2131,1894,1355,-539
2017,8,17,12,2145,1959,1396,-563
2017,8,17,13,2248,2057,1447,-610
2017,8,17,14,2386,2119,1519,-600
2017,8,17,15,2538,2067,1448,-619
2017,8,17,16,2664,2093,1427,-666
2017,8,17,17,2807,2180,1443,-737
2017,8,17,18,2956,2260,1472,-788
2017,8,17,19,3092,2345,1529,-816
2017,8,17,20,3237,2424,1471,-953
2017,8,17,21,3354,2525,1542,-983
2017,8,17,22,3472,2589,1504,-1085
2017,8,17,23,3538,2652,1553,-1099
2017,8,18,0,3555,2690,1581,-1109
2017,8,18,1,3561,2717,1600,-1117
2017,8,18,2,3521,2789,1646,-1143
2017,8,18,3,3393,2789,1686,-1103
2017,8,18,4,3287,2708,1662,-1046
2017,8,18,5,3084,2501,1625,-876
2017,8,18,6,2811,2290,1613,-677
2017,8,18,7,2589,2131,1527,-604
2017,8,18,8,2071,2040,1376,-664
2017,8,18,9,2019,1975,1304,-671
2017,8,18,10,1966,1926,1215,-711
2017,8,18,11,1958,1905,1187,-718
2017,8,18,12,2009,1958,1312,-646
2017,8,18,13,2120,2046,1354,-692
2017,8,18,14,2225,2106,1391,-715
2017,8,18,15,2342,2050,1334,-716
2017,8,18,16,2440,2081,1324,-757
2017,8,18,17,2515,2171,1368,-803
2017,8,18,18,2601,2244,1398,-846
2017,8,18,19,2680,2340,1497,-843
2017,8,18,20,2771,2451,1553,-898
2017,8,18,21,2878,2568,1597,-971
2017,8,18,22,2962,2645,1634,-1011
2017,8,18,23,3047,2708,1682,-1026
2017,8,19,0,3068,2741,1700,-1041
2017,8,19,1,3071,2783,1729,-1054
2017,8,19,2,3001,2822,1655,-1167
2017,8,19,3,2863,2809,1655,-1154
2017,8,19,4,2758,2700,1548,-1152
2017,8,19,5,2570,2510,1348,-1162
2017,8,19,6,2385,2311,1416,-895
2017,8,19,7,2223,2145,1484,-661
2017,8,19,8,2143,2037,1405,-632
2017,8,19,9,2039,1969,1349,-620
2017,8,19,10,1994,1920,1291,-629
2017,8,19,11,1981,1899,1293,-606
2017,8,19,12,2001,1887,1276,-611
2017,8,19,13,2050,1922,1290,-632
2017,8,19,14,2120,1947,1302,-645
2017,8,19,15,2253,1930,1262,-668
2017,8,19,16,2362,1956,1233,-723
2017,8,19,17,2460,2016,1256,-760
2017,8,19,18,2561,2075,1275,-800
2017,8,19,19,2664,2148,1379,-769
2017,8,19,20,2790,2235,1438,-797
2017,8,19,21,2939,2318,1466,-852
2017,8,19,22,3068,2390,1520,-870
2017,8,19,23,3173,2452,1546,-906
2017,8,20,0,3199,2522,1621,-901
2017,8,20,1,3201,2560,1649,-911
2017,8,20,2,3128,2622,1795,-827
2017,8,20,3,2964,2598,1790,-808
2017,8,20,4,2826,2527,1691,-836
2017,8,20,5,2616,2353,1623,-730
2017,8,20,6,2392,2185,1544,-641
2017,8,20,7,2192,2037,1409,-628
2017,8,20,8,2113,1941,1402,-539
2017,8,20,9,1921,1872,1339,-533
2017,8,20,10,1881,1833,1331,-502
2017,8,20,11,1868,1804,1329,-475
2017,8,20,12,1882,1810,1320,-490
2017,8,20,13,1906,1821,1316,-505
2017,8,20,14,1946,1810,1327,-483
2017,8,20,15,2056,1768,1275,-493
2017,8,20,16,2143,1783,1195,-588
2017,8,20,17,2227,1852,1223,-629
2017,8,20,18,2313,1940,1256,-684
2017,8,20,19,2428,2023,1295,-728
2017,8,20,20,2553,2099,1306,-793
2017,8,20,21,2697,2165,1334,-831
2017,8,20,22,2833,2247,1406,-841
2017,8,20,23,2958,2334,1477,-857
2017,8,21,0,3013,2385,1517,-868
2017,8,21,1,3024,2447,1580,-867
2017,8,21,2,2953,2478,1623,-855
2017,8,21,3,2812,2450,1687,-763
2017,8,21,4,2674,2398,1660,-738
2017,8,21,5,2459,2236,1531,-705
2017,8,21,6,2237,2049,1485,-564
2017,8,21,7,2118,1930,1424,-506
2017,8,21,8,2017,1857,1323,-534
2017,8,21,9,1836,1803,1293,-510
2017,8,21,10,1808,1780,1279,-501
2017,8,21,11,1830,1791,1145,-646
2017,8,21,12,1908,1833,1211,-622
2017,8,21,13,2036,1944,1394,-550
2017,8,21,14,2168,2017,1275,-742
2017,8,21,15,2317,1999,1220,-779
2017,8,21,16,2394,2041,1194,-847
2017,8,21,17,2468,2099,1249,-850
2017,8,21,18,2571,2197,1379,-818
2017,8,21,19,2693,2127,1419,-708
2017,8,21,20,2855,2181,1485,-696
2017,8,21,21,3043,2306,1604,-702
2017,8,21,22,3208,2401,1671,-730
2017,8,21,23,3340,2501,1685,-816
2017,8,22,0,3350,2587,1715,-872
2017,8,22,1,3366,2675,1648,-1027
2017,8,22,2,3309,2784,1629,-1155
2017,8,22,3,3122,2770,1662,-1108
2017,8,22,4,2956,2679,1681,-998
2017,8,22,5,2681,2461,1420,-1041
2017,8,22,6,2408,2235,1378,-857
2017,8,22,7,2285,2096,1245,-851
2017,8,22,8,2158,1992,1010,-982
2017,8,22,9,1980,1931,927,-1004
2017,8,22,10,1941,1898,965,-933
2017,8,22,11,1936,1883,966,-917
2017,8,22,12,1994,1948,1070,-878
2017,8,22,13,2106,2057,1158,-899
2017,8,22,14,2207,2121,1248,-873
2017,8,22,15,2288,2089,1232,-857
2017,8,22,16,2415,2101,1198,-903
2017,8,22,17,2529,2171,1250,-921
2017,8,22,18,2635,2236,1315,-921
2017,8,22,19,2823,2329,1441,-888
2017,8,22,20,3039,2441,1530,-911
2017,8,22,21,3256,2568,1605,-963
2017,8,22,22,3437,2677,1681,-996
2017,8,22,23,3586,2773,1708,-1065
2017,8,23,0,3640,2844,1756,-1088
2017,8,23,1,3681,2905,1778,-1127
2017,8,23,2,3619,2973,1823,-1150
2017,8,23,3,3418,2935,1806,-1129
2017,8,23,4,3227,2831,1858,-973
2017,8,23,5,2926,2590,1528,-1062
2017,8,23,6,2602,2354,1335,-1019
2017,8,23,7,2427,2204,1372,-832
2017,8,23,8,2175,2100,1341,-759
2017,8,23,9,2089,2036,1295,-741
2017,8,23,10,2038,1992,1231,-761
2017,8,23,11,2030,1972,1230,-742
2017,8,23,12,2079,2032,1258,-774
2017,8,23,13,2200,2174,1333,-841
2017,8,23,14,2292,2290,1349,-941
2017,8,23,15,2403,2345,1368,-977
2017,8,23,16,2504,2352,1397,-955
2017,8,23,17,2563,2367,1373,-994
2017,8,23,18,2596,2400,1358,-1042
2017,8,23,19,2689,2464,1427,-1037
2017,8,23,20,2776,2551,1510,-1041
2017,8,23,21,2865,2658,1594,-1064
2017,8,23,22,2928,2713,1644,-1069
2017,8,23,23,2972,2821,1682,-1139
2017,8,24,0,2990,2862,1731,-1131
2017,8,24,1,3003,2829,1673,-1156
2017,8,24,2,2940,2811,1651,-1160
2017,8,24,3,2842,2765,1653,-1112
2017,8,24,4,2756,2697,1627,-1070
2017,8,24,5,2561,2517,1451,-1066
2017,8,24,6,2342,2316,1213,-1103
2017,8,24,7,2213,2171,1236,-935
2017,8,24,8,2073,2065,1138,-927
2017,8,24,9,2051,1993,1132,-861
2017,8,24,10,2002,1956,1120,-836
2017,8,24,11,1980,1942,1090,-852
2017,8,24,12,2032,2005,1106,-899
2017,8,24,13,2158,2132,1128,-1004
2017,8,24,14,2255,2229,1176,-1053
2017,8,24,15,2359,2218,1204,-1014
2017,8,24,16,2451,2208,1284,-924
2017,8,24,17,2544,2274,1310,-964
2017,8,24,18,2617,2373,1435,-938
2017,8,24,19,2711,2473,1508,-965
2017,8,24,20,2795,2590,1561,-1029
2017,8,24,21,2886,2693,1617,-1076
2017,8,24,22,2994,2771,1646,-1125
2017,8,24,23,3086,2844,1598,-1246
2017,8,25,0,3140,2910,1637,-1273
2017,8,25,1,3151,2969,1669,-1300
2017,8,25,2,3090,2940,1673,-1267
2017,8,25,3,2982,2834,1564,-1270
2017,8,25,4,2862,2727,1446,-1281
2017,8,25,5,2655,2518,1336,-1182
2017,8,25,6,2429,2310,1199,-1111
2017,8,25,7,2212,2162,1165,-997
2017,8,25,8,2074,2062,1175,-887
2017,8,25,9,2025,1991,1177,-814
2017,8,25,10,1969,1938,1210,-728
2017,8,25,11,1945,1930,1199,-731
2017,8,25,12,1988,1974,1217,-757
2017,8,25,13,2122,2101,1319,-782
2017,8,25,14,2226,2170,1561,-609
2017,8,25,15,2314,2141,1409,-732
2017,8,25,16,2398,2142,1375,-767
2017,8,25,17,2483,2206,1329,-877
2017,8,25,18,2574,2277,1326,-951
2017,8,25,19,2682,2371,1364,-1007
2017,8,25,20,2803,2482,1545,-937
2017,8,25,21,2926,2594,1655,-939
2017,8,25,22,3044,2678,1734,-944
2017,8,25,23,3139,2750,1757,-993
2017,8,26,0,3159,2813,1759,-1054
2017,8,26,1,3155,2855,1794,-1061
2017,8,26,2,3053,2890,1792,-1098
2017,8,26,3,2921,2832,1788,-1044
2017,8,26,4,2831,2729,1735,-994
2017,8,26,5,2641,2545,1616,-929
2017,8,26,6,2447,2346,1453,-893
2017,8,26,7,2244,2180,1328,-852
2017,8,26,8,2127,2071,1330,-741
2017,8,26,9,2023,1989,1367,-622
2017,8,26,10,1961,1935,1317,-618
2017,8,26,11,1922,1904,1269,-635
2017,8,26,12,1932,1901,1225,-676
2017,8,26,13,1989,1932,1270,-662
2017,8,26,14,2043,1952,1289,-663
2017,8,26,15,2157,1942,1258,-684
2017,8,26,16,2272,1959,1282,-677
2017,8,26,17,2381,2031,1275,-756
2017,8,26,18,2473,2134,1263,-871
2017,8,26,19,2586,2239,1219,-1020
2017,8,26,20,2705,2348,1233,-1115
2017,8,26,21,2819,2471,1341,-1130
2017,8,26,22,2923,2582,1497,-1085
2017,8,26,23,2989,2691,1606,-1085
2017,8,27,0,3037,2748,1649,-1099
2017,8,27,1,3030,2792,1693,-1099
2017,8,27,2,2947,2822,1720,-1102
2017,8,27,3,2839,2758,1721,-1037
2017,8,27,4,2754,2629,1701,-928
2017,8,27,5,2577,2422,1539,-883
2017,8,27,6,2355,2243,1241,-1002
2017,8,27,7,2214,2096,1222,-874
2017,8,27,8,2066,1985,1171,-814
2017,8,27,9,1969,1900,1112,-788
2017,8,27,10,1917,1856,1057,-799
2017,8,27,11,1882,1825,1029,-796
2017,8,27,12,1884,1807,1016,-791
2017,8,27,13,1904,1834,1125,-709
2017,8,27,14,1925,1820,1125,-695
2017,8,27,15,2040,1809,1076,-733
2017,8,27,16,2176,1817,1054,-763
2017,8,27,17,2310,1907,1156,-751
2017,8,27,18,2430,2014,1221,-793
2017,8,27,19,2571,2154,1222,-932
2017,8,27,20,2693,2288,1252,-1036
2017,8,27,21,2797,2425,1323,-1102
2017,8,27,22,2884,2550,1506,-1044
2017,8,27,23,2967,2679,1537,-1142
2017,8,28,0,3028,2779,1577,-1202
2017,8,28,1,3014,2851,1609,-1242
2017,8,28,2,2928,2894,1633,-1261
2017,8,28,3,2826,2857,1805,-1052
2017,8,28,4,2750,2709,1802,-907
2017,8,28,5,2564,2459,1611,-848
2017,8,28,6,2332,2212,1369,-843
2017,8,28,7,2197,2059,1259,-800
2017,8,28,8,2058,1944,1156,-788
2017,8,28,9,1949,1881,1213,-668
2017,8,28,10,1917,1833,1271,-562
2017,8,28,11,1923,1831,1272,-559
2017,8,28,12,1978,1888,1330,-558
2017,8,28,13,2094,2047,1478,-569
2017,8,28,14,2202,2150,1576,-574
2017,8,28,15,2384,2135,1496,-639
2017,8,28,16,2514,2173,1472,-701
2017,8,28,17,2646,2296,1498,-798
2017,8,28,18,2788,2371,1517,-854
2017,8,28,19,2940,2535,1525,-1010
2017,8,28,20,3090,2553,1529,-1024
2017,8,28,21,3180,2658,1595,-1063
2017,8,28,22,3252,2762,1786,-976
2017,8,28,23,3311,2928,1937,-991
2017,8,29,0,3343,2985,1935,-1050
2017,8,29,1,3337,2956,1895,-1061
2017,8,29,2,3240,3016,1942,-1074
2017,8,29,3,3142,2988,1987,-1001
2017,8,29,4,3064,2858,1891,-967
2017,8,29,5,2862,2607,1675,-932
2017,8,29,6,2645,2390,1408,-982
2017,8,29,7,2485,2237,1252,-985
2017,8,29,8,2238,2139,1074,-1065
2017,8,29,9,2148,2068,992,-1076
2017,8,29,10,2100,2008,998,-1010
2017,8,29,11,2074,1986,969,-1017
2017,8,29,12,2106,2022,1011,-1011
2017,8,29,13,2226,2176,1164,-1012
2017,8,29,14,2339,2252,1246,-1006
2017,8,29,15,2416,2252,1344,-908
2017,8,29,16,2552,2252,1275,-977
2017,8,29,17,2672,2349,1287,-1062
2017,8,29,18,2817,2486,1303,-1183
2017,8,29,19,2962,2622,1450,-1172
2017,8,29,20,3063,2797,1693,-1104
2017,8,29,21,3151,2939,1763,-1176
2017,8,29,22,3217,3021,1827,-1194
2017,8,29,23,3281,3076,1883,-1193
2017,8,30,0,3293,3112,1893,-1219
2017,8,30,1,3269,3162,1968,-1194
2017,8,30,2,3191,3185,2012,-1173
2017,8,30,3,3104,3128,1984,-1144
2017,8,30,4,3043,2961,1825,-1136
2017,8,30,5,2834,2667,1570,-1097
2017,8,30,6,2599,2440,1429,-1011
2017,8,30,7,2428,2277,1284,-993
2017,8,30,8,2278,2166,1080,-1086
2017,8,30,9,2158,2099,1018,-1081
2017,8,30,10,2112,2053,994,-1059
2017,8,30,11,2101,2036,1054,-982
2017,8,30,12,2158,2081,1077,-1004
2017,8,30,13,2290,2233,1214,-1019
2017,8,30,14,2406,2342,1246,-1096
2017,8,30,15,2489,2370,1212,-1158
2017,8,30,16,2589,2349,1186,-1163
2017,8,30,17,2678,2431,1277,-1154
2017,8,30,18,2782,2566,1399,-1167
2017,8,30,19,2886,2725,1521,-1204
2017,8,30,20,2985,2825,1664,-1161
2017,8,30,21,3082,2969,1846,-1123
2017,8,30,22,3148,3046,1907,-1139
2017,8,30,23,3228,3031,1938,-1093
2017,8,31,0,3217,2934,1853,-1081
2017,8,31,1,3170,2942,1732,-1210
2017,8,31,2,3045,2926,1752,-1174
2017,8,31,3,2957,2934,1782,-1152
2017,8,31,4,2860,2823,1745,-1078
2017,8,31,5,2646,2612,1640,-972
2017,8,31,6,2442,2409,1495,-914
2017,8,31,7,2326,2263,1332,-931
2017,8,31,8,2140,2184,1503,-681
2017,8,31,9,2135,2108,1443,-665
2017,8,31,10,2070,2041,1328,-713
2017,8,31,11,2045,2021,1313,-708
2017,8,31,12,2084,2054,1321,-733
2017,8,31,13,2215,2209,1422,-787
2017,8,31,14,2317,2295,1566,-729
2017,8,31,15,2388,2274,1522,-752
2017,8,31,16,2485,2263,1458,-805
2017,8,31,17,2580,2326,1449,-877
2017,8,31,18,2680,2378,1441,-937
2017,8,31,19,2775,2449,1448,-1001
2017,8,31,20,2867,2551,1559,-992
2017,8,31,21,2951,2660,1768,-892
2017,8,31,22,3001,2714,1871,-843
2017,8,31,23,3057,2771,1865,-906
2017,9,1,0,3075,2792,1893,-899
2017,9,1,1,3102,2844,1884,-960
2017,9,1,2,3039,2875,1940,-935
2017,9,1,3,2995,2825,1946,-879
2017,9,1,4,2890,2691,1934,-757
2017,9,1,5,2657,2480,1743,-737
2017,9,1,6,2406,2262,1490,-772
2017,9,1,7,2189,2106,1473,-633
2017,9,1,8,2058,2007,1451,-556
2017,9,1,9,1969,1957,1483,-474
2017,9,1,10,1921,1907,1434,-473
2017,9,1,11,1912,1896,1366,-530
2017,9,1,12,1957,1934,1349,-585
2017,9,1,13,2100,2068,1446,-622
2017,9,1,14,2201,2150,1438,-712
2017,9,1,15,2280,2097,1215,-882
2017,9,1,16,2373,2079,1082,-997
2017,9,1,17,2472,2149,1071,-1078
2017,9,1,18,2567,2233,1148,-1085
2017,9,1,19,2671,2291,1206,-1085
2017,9,1,20,2783,2407,1323,-1084
2017,9,1,21,2890,2514,1424,-1090
2017,9,1,22,2979,2612,1491,-1121
2017,9,1,23,3046,2701,1712,-989
2017,9,2,0,3061,2752,1687,-1065
2017,9,2,1,3056,2772,1689,-1083
2017,9,2,2,2983,2808,1693,-1115
2017,9,2,3,2859,2747,1646,-1101
2017,9,2,4,2715,2613,1587,-1026
2017,9,2,5,2510,2445,1395,-1050
2017,9,2,6,2309,2264,1274,-990
2017,9,2,7,2164,2108,1275,-833
2017,9,2,8,2062,2002,1251,-751
2017,9,2,9,1968,1937,1239,-698
2017,9,2,10,1928,1888,1231,-657
2017,9,2,11,1914,1864,1205,-659
2017,9,2,12,1928,1858,1277,-581
2017,9,2,13,1991,1892,1294,-598
2017,9,2,14,2059,1915,1395,-520
2017,9,2,15,2178,1917,1384,-533
2017,9,2,16,2317,1925,1279,-646
2017,9,2,17,2446,1977,1257,-720
2017,9,2,18,2555,2076,1157,-919
2017,9,2,19,2655,2187,1242,-945
2017,9,2,20,2767,2323,1332,-991
2017,9,2,21,2831,2453,1358,-1095
2017,9,2,22,2898,2572,1444,-1128
2017,9,2,23,2973,2670,1526,-1144
2017,9,3,0,3016,2735,1602,-1133
2017,9,3,1,3016,2796,1633,-1163
2017,9,3,2,2938,2839,1637,-1202
2017,9,3,3,2804,2754,1629,-1125
2017,9,3,4,2655,2621,1537,-1084
2017,9,3,5,2423,2416,1324,-1092
2017,9,3,6,2232,2209,1072,-1137
2017,9,3,7,2196,2046,1028,-1018
2017,9,3,8,2068,1946,1001,-945
2017,9,3,9,1958,1874,971,-903
2017,9,3,10,1915,1809,954,-855
2017,9,3,11,1895,1794,967,-827
2017,9,3,12,1893,1774,969,-805
2017,9,3,13,1916,1793,979,-814
2017,9,3,14,1945,1782,1023,-759
2017,9,3,15,2062,1768,1023,-745
2017,9,3,16,2190,1760,1012,-748
2017,9,3,17,2316,1841,1012,-829
2017,9,3,18,2427,1958,1080,-878
2017,9,3,19,2542,2098,1117,-981
2017,9,3,20,2673,2243,1294,-949
2017,9,3,21,2792,2389,1404,-985
2017,9,3,22,2904,2513,1467,-1046
2017,9,3,23,3014,2611,1495,-1116
2017,9,4,0,3086,2682,1532,-1150
2017,9,4,1,3100,2731,1585,-1146
2017,9,4,2,3021,2765,1637,-1128
2017,9,4,3,2904,2672,1647,-1025
2017,9,4,4,2782,2539,1546,-993
2017,9,4,5,2557,2324,1341,-983
2017,9,4,6,2324,2136,1214,-922
2017,9,4,7,2179,1975,1211,-764
2017,9,4,8,2026,1867,1143,-724
2017,9,4,9,1905,1801,1096,-705
2017,9,4,10,1869,1734,1048,-686
2017,9,4,11,1875,1728,1057,-671
2017,9,4,12,1934,1730,1061,-669
2017,9,4,13,2061,1767,1143,-624
2017,9,4,14,2178,1817,1190,-627
2017,9,4,15,2339,1853,1197,-656
2017,9,4,16,2461,1907,1173,-734
2017,9,4,17,2574,2003,1193,-810
2017,9,4,18,2693,2113,1173,-940
2017,9,4,19,2814,2248,1262,-986
2017,9,4,20,2948,2381,1363,-1018
2017,9,4,21,3075,2524,1485,-1039
2017,9,4,22,3168,2638,1591,-1047
2017,9,4,23,3241,2751,1730,-1021
2017,9,5,0,3285,2830,1776,-1054
2017,9,5,1,3299,2887,1793,-1094
2017,9,5,2,3238,2889,1871,-1018
2017,9,5,3,3108,2839,1859,-980
2017,9,5,4,2975,2675,1693,-982
2017,9,5,5,2745,2435,1462,-973
2017,9,5,6,2505,2201,1314,-887
2017,9,5,7,2350,2051,1304,-747
2017,9,5,8,2102,1950,1293,-657
2017,9,5,9,1953,1874,1427,-447
2017,9,5,10,1912,1823,1421,-402
2017,9,5,11,1895,1814,1418,-396
2017,9,5,12,1931,1870,1401,-469
2017,9,5,13,2032,2010,1464,-546
2017,9,5,14,2109,2135,1504,-631
2017,9,5,15,2157,2149,1482,-667
2017,9,5,16,2278,2161,1424,-737
2017,9,5,17,2377,2191,1399,-792
2017,9,5,18,2485,2230,1449,-781
2017,9,5,19,2602,2293,1402,-891
2017,9,5,20,2721,2390,1394,-996
2017,9,5,21,2845,2506,1498,-1008
2017,9,5,22,2954,2585,1526,-1059
2017,9,5,23,3046,2668,1647,-1021
2017,9,6,0,3110,2742,1730,-1012
2017,9,6,1,3126,2776,1743,-1033
2017,9,6,2,3071,2743,1747,-996
2017,9,6,3,2966,2695,1706,-989
2017,9,6,4,2830,2543,1575,-968
2017,9,6,5,2606,2331,1459,-872
2017,9,6,6,2362,2137,1241,-896
2017,9,6,7,2231,1994,1073,-921
2017,9,6,8,1995,1920,1056,-864
2017,9,6,9,1939,1867,1051,-816
2017,9,6,10,1898,1823,1045,-778
2017,9,6,11,1870,1829,1062,-767
2017,9,6,12,1908,1881,1117,-764
2017,9,6,13,2018,2016,1224,-792
2017,9,6,14,2110,2146,1386,-760
2017,9,6,15,2182,2145,1381,-764
2017,9,6,16,2315,2150,1305,-845
2017,9,6,17,2423,2007,1325,-682
2017,9,6,18,2548,2158,1268,-890
2017,9,6,19,2675,2152,1179,-973
2017,9,6,20,2819,2317,1337,-980
2017,9,6,21,2937,2372,1422,-950
2017,9,6,22,3039,2472,1515,-957
2017,9,6,23,3107,2581,1607,-974
2017,9,7,0,3158,2647,1678,-969
2017,9,7,1,3170,2714,1739,-975
2017,9,7,2,3117,2685,1668,-1017
2017,9,7,3,3033,2658,1691,-967
2017,9,7,4,2880,2528,1582,-946
2017,9,7,5,2657,2301,1356,-945
2017,9,7,6,2422,2112,1182,-930
2017,9,7,7,2241,1974,1161,-813
2017,9,7,8,2003,1890,1179,-711
2017,9,7,9,1921,1849,1140,-709
2017,9,7,10,1889,1819,1098,-721
2017,9,7,11,1870,1811,1081,-730
2017,9,7,12,1931,1866,1129,-737
2017,9,7,13,2069,2002,1264,-738
2017,9,7,14,2178,2122,1420,-702
2017,9,7,15,2256,2126,1406,-720
2017,9,7,16,2371,2128,1305,-823
2017,9,7,17,2469,2123,1330,-793
2017,9,7,18,2560,2141,1332,-809
2017,9,7,19,2646,2196,1395,-801
2017,9,7,20,2747,2300,1540,-760
2017,9,7,21,2850,2398,1613,-785
2017,9,7,22,2934,2495,1651,-844
2017,9,7,23,2994,2597,1703,-894
2017,9,8,0,3040,2715,1765,-950
2017,9,8,1,3064,2766,1804,-962
2017,9,8,2,3003,2694,1623,-1071
2017,9,8,3,2971,2684,1635,-1049
2017,9,8,4,2851,2586,1526,-1060
2017,9,8,5,2630,2381,1334,-1047
2017,9,8,6,2395,2204,1223,-981
2017,9,8,7,2243,2066,1270,-796
2017,9,8,8,2082,1979,1294,-685
2017,9,8,9,1953,1912,1235,-677
2017,9,8,10,1914,1874,1244,-630
2017,9,8,11,1912,1859,1274,-585
2017,9,8,12,1976,1891,1249,-642
2017,9,8,13,2118,2035,1243,-792
2017,9,8,14,2228,2147,1289,-858
2017,9,8,15,2296,2150,1272,-878
2017,9,8,16,2387,2112,1208,-904
2017,9,8,17,2456,2147,1277,-870
2017,9,8,18,2522,2248,1380,-868
2017,9,8,19,2597,2305,1422,-883
2017,9,8,20,2683,2419,1548,-871
2017,9,8,21,2771,2520,1571,-949
2017,9,8,22,2838,2612,1575,-1037
2017,9,8,23,2902,2644,1565,-1079
2017,9,9,0,2945,2660,1595,-1065
2017,9,9,1,2922,2661,1555,-1106
2017,9,9,2,2860,2640,1610,-1030
2017,9,9,3,2773,2581,1647,-934
2017,9,9,4,2677,2479,1646,-833
2017,9,9,5,2519,2316,1607,-709
2017,9,9,6,2329,2148,1442,-706
2017,9,9,7,2199,2036,1313,-723
2017,9,9,8,2014,1937,1233,-704
2017,9,9,9,1913,1878,1247,-631
2017,9,9,10,1877,1821,1255,-566
2017,9,9,11,1852,1800,1247,-553
2017,9,9,12,1879,1819,1292,-527
2017,9,9,13,1937,1849,1287,-562
2017,9,9,14,1999,1901,1371,-530
2017,9,9,15,2101,1942,1404,-538
2017,9,9,16,2176,1959,1380,-579
2017,9,9,17,2239,2001,1364,-637
2017,9,9,18,2295,2108,1357,-751
2017,9,9,19,2369,2227,1301,-926
2017,9,9,20,2437,2304,1353,-951
2017,9,9,21,2517,2417,1415,-1002
2017,9,9,22,2588,2482,1371,-1111
2017,9,9,23,2651,2560,1425,-1135
2017,9,10,0,2666,2579,1460,-1119
2017,9,10,1,2632,2575,1520,-1055
2017,9,10,2,2587,2580,1652,-928
2017,9,10,3,2531,2526,1614,-912
2017,9,10,4,2441,2403,1642,-761
2017,9,10,5,2288,2251,1536,-715
2017,9,10,6,2128,2072,1332,-740
2017,9,10,7,2015,1946,1270,-676
2017,9,10,8,1880,1839,1205,-634
2017,9,10,9,1819,1773,1181,-592
2017,9,10,10,1779,1723,1147,-576
2017,9,10,11,1748,1684,1118,-566
2017,9,10,12,1748,1673,1166,-507
2017,9,10,13,1771,1706,1238,-468
2017,9,10,14,1798,1709,1236,-473
2017,9,10,15,1878,1716,1223,-493
2017,9,10,16,1952,1684,1190,-494
2017,9,10,17,2014,1747,1223,-524
2017,9,10,18,2075,1821,1296,-525
2017,9,10,19,2173,1942,1377,-565
2017,9,10,20,2276,2048,1373,-675
2017,9,10,21,2398,2155,1415,-740
2017,9,10,22,2486,2251,1530,-721
2017,9,10,23,2568,2326,1597,-729
2017,9,11,0,2608,2396,1641,-755
2017,9,11,1,2594,2459,1707,-752
2017,9,11,2,2530,2489,1735,-754
2017,9,11,3,2452,2445,1704,-741
2017,9,11,4,2346,2298,1586,-712
2017,9,11,5,2173,2091,1455,-636
2017,9,11,6,1987,1885,1389,-496
2017,9,11,7,1860,1771,1368,-403
2017,9,11,8,1762,1679,1467,-212
2017,9,11,9,1671,1645,1289,-356
2017,9,11,10,1645,1609,1171,-438
2017,9,11,11,1643,1611,1139,-472
2017,9,11,12,1693,1684,1155,-529
2017,9,11,13,1804,1844,1264,-580
2017,9,11,14,1914,1960,1338,-622
2017,9,11,15,2096,1907,1298,-609
2017,9,11,16,2180,1864,1257,-607
2017,9,11,17,2266,1929,1235,-694
2017,9,11,18,2347,2016,1287,-729
2017,9,11,19,2456,2126,1339,-787
2017,9,11,20,2571,2218,1367,-851
2017,9,11,21,2680,2354,1420,-934
2017,9,11,22,2767,2431,1377,-1054
2017,9,11,23,2843,2525,1404,-1121
2017,9,12,0,2874,2578,1453,-1125
2017,9,12,1,2882,2664,1560,-1104
2017,9,12,2,2842,2711,1516,-1195
2017,9,12,3,2765,2662,1468,-1194
2017,9,12,4,2596,2483,1324,-1159
2017,9,12,5,2363,2251,1227,-1024
2017,9,12,6,2151,2040,1156,-884
2017,9,12,7,2028,1903,1112,-791
2017,9,12,8,1889,1801,1042,-759
2017,9,12,9,1808,1755,1108,-647
2017,9,12,10,1782,1716,1102,-614
2017,9,12,11,1779,1705,1085,-620
2017,9,12,12,1842,1756,1129,-627
2017,9,12,13,1993,1909,1231,-678
2017,9,12,14,2104,2009,1233,-776
2017,9,12,15,2122,2000,1197,-803
2017,9,12,16,2220,1994,1166,-828
2017,9,12,17,2318,1967,1174,-793
2017,9,12,18,2404,2039,1165,-874
2017,9,12,19,2514,2171,1208,-963
2017,9,12,20,2627,2257,1303,-954
2017,9,12,21,2739,2382,1446,-936
2017,9,12,22,2804,2452,1479,-973
2017,9,12,23,2846,2516,1464,-1052
2017,9,13,0,2861,2559,1515,-1044
2017,9,13,1,2838,2554,1515,-1039
2017,9,13,2,2762,2526,1468,-1058
2017,9,13,3,2734,2539,1454,-1085
2017,9,13,4,2593,2426,1366,-1060
2017,9,13,5,2394,2223,1233,-990
2017,9,13,6,2180,2019,1133,-886
2017,9,13,7,2058,1898,1158,-740
2017,9,13,8,1917,1835,1153,-682
2017,9,13,9,1812,1781,1177,-604
2017,9,13,10,1783,1750,1221,-529
2017,9,13,11,1780,1737,1253,-484
2017,9,13,12,1852,1803,1284,-519
2017,9,13,13,2016,1951,1310,-641
2017,9,13,14,2127,2054,1328,-726
2017,9,13,15,2143,2010,1223,-787
2017,9,13,16,2199,1970,1175,-795
2017,9,13,17,2258,2007,1207,-800
2017,9,13,18,2304,2092,1252,-840
2017,9,13,19,2364,2161,1273,-888
2017,9,13,20,2430,2267,1419,-848
2017,9,13,21,2505,2377,1501,-876
2017,9,13,22,2541,2479,1548,-931
2017,9,13,23,2572,2498,1607,-891
2017,9,14,0,2579,2519,1626,-893
2017,9,14,1,2565,2566,1582,-984
2017,9,14,2,2505,2569,1560,-1009
2017,9,14,3,2493,2532,1607,-925
2017,9,14,4,2361,2374,1460,-914
2017,9,14,5,2175,2170,1269,-901
2017,9,14,6,1992,1989,1305,-684
2017,9,14,7,1927,1870,1231,-639
2017,9,14,8,1837,1799,1216,-583
2017,9,14,9,1766,1731,1198,-533
2017,9,14,10,1729,1691,1204,-487
2017,9,14,11,1728,1679,1198,-481
2017,9,14,12,1782,1729,1220,-509
2017,9,14,13,1928,1880,1312,-568
2017,9,14,14,2035,1991,1377,-614
2017,9,14,15,2065,1967,1362,-605
2017,9,14,16,2111,1957,1362,-595
2017,9,14,17,2152,1985,1420,-565
2017,9,14,18,2190,2003,1453,-550
2017,9,14,19,2225,2007,1507,-500
2017,9,14,20,2272,1979,1599,-380
2017,9,14,21,2317,1967,1577,-390
2017,9,14,22,2342,1948,1540,-408
2017,9,14,23,2345,1962,1565,-397
2017,9,15,0,2334,1944,1506,-438
2017,9,15,1,2292,1953,1547,-406
2017,9,15,2,2239,2012,1628,-384
2017,9,15,3,2254,2017,1658,-359
2017,9,15,4,2152,1945,1664,-281
2017,9,15,5,1997,1822,1728,-94
2017,9,15,6,1834,1679,1527,-152
2017,9,15,7,1745,1588,1523,-65
2017,9,15,8,1614,1543,1537,-6
2017,9,15,9,1521,1515,1513,-2
2017,9,15,10,1499,1493,1513,20
2017,9,15,11,1528,1517,1497,-20
2017,9,15,12,1603,1584,1546,-38
2017,9,15,13,1750,1715,1671,-44
2017,9,15,14,1864,1828,1728,-100
2017,9,15,15,1879,1799,1819,20
2017,9,15,16,1909,1694,1759,65
2017,9,15,17,1932,1667,1762,95
2017,9,15,18,1944,1655,1806,151
2017,9,15,19,1954,1663,1916,253
2017,9,15,20,1969,1672,1981,309
2017,9,15,21,1975,1675,1991,316
2017,9,15,22,1991,1672,1950,278
2017,9,15,23,1981,1690,1861,171
2017,9,16,0,1967,1698,1849,151
2017,9,16,1,1892,1749,1892,143
2017,9,16,2,1821,1798,1897,99
2017,9,16,3,1825,1837,1913,76
2017,9,16,4,1796,1804,1871,67
2017,9,16,5,1735,1719,1809,90
2017,9,16,6,1633,1605,1686,81
2017,9,16,7,1608,1526,1533,7
2017,9,16,8,1424,1482,1411,-71
2017,9,16,9,1445,1453,1365,-88
2017,9,16,10,1417,1434,1338,-96
2017,9,16,11,1411,1431,1350,-81
2017,9,16,12,1434,1465,1316,-149
2017,9,16,13,1488,1522,1377,-145
2017,9,16,14,1535,1590,1448,-142
2017,9,16,15,1594,1590,1451,-139
2017,9,16,16,1655,1527,1361,-166
2017,9,16,17,1712,1517,1290,-227
2017,9,16,18,1747,1483,1260,-223
2017,9,16,19,1769,1470,1257,-213
2017,9,16,20,1802,1483,1298,-185
2017,9,16,21,1836,1515,1343,-172
2017,9,16,22,1872,1499,1346,-153
2017,9,16,23,1884,1559,1367,-192
2017,9,17,0,1916,1613,1315,-298
2017,9,17,1,1916,1655,1375,-280
2017,9,17,2,1882,1729,1428,-301
2017,9,17,3,1874,1766,1474,-292
2017,9,17,4,1796,1731,1444,-287
2017,9,17,5,1691,1646,1356,-290
2017,9,17,6,1583,1545,1361,-184
2017,9,17,7,1446,1478,1299,-179
2017,9,17,8,1420,1439,1172,-267
2017,9,17,9,1437,1405,1205,-200
2017,9,17,10,1428,1388,1188,-200
2017,9,17,11,1431,1370,1162,-208
2017,9,17,12,1452,1398,1175,-223
2017,9,17,13,1494,1450,1230,-220
2017,9,17,14,1529,1505,1286,-219
2017,9,17,15,1596,1487,1292,-195
2017,9,17,16,1673,1451,1215,-236
2017,9,17,17,1736,1411,1210,-201
2017,9,17,18,1780,1440,1242,-198
2017,9,17,19,1834,1448,1193,-255
2017,9,17,20,1884,1459,1200,-259
2017,9,17,21,1949,1461,1209,-252
2017,9,17,22,2016,1464,1212,-252
2017,9,17,23,2059,1519,1305,-214
2017,9,18,0,2110,1649,1435,-214
2017,9,18,1,2115,1726,1506,-220
2017,9,18,2,2064,1806,1560,-246
2017,9,18,3,2036,1861,1627,-234
2017,9,18,4,1953,1770,1552,-218
2017,9,18,5,1821,1646,1429,-217
2017,9,18,6,1675,1514,1306,-208
2017,9,18,7,1551,1428,1204,-224
2017,9,18,8,1506,1380,1166,-214
2017,9,18,9,1418,1362,1150,-212
2017,9,18,10,1415,1356,1142,-214
2017,9,18,11,1442,1374,1159,-215
2017,9,18,12,1513,1449,1220,-229
2017,9,18,13,1648,1621,1380,-241
2017,9,18,14,1770,1760,1345,-415
2017,9,18,15,1902,1796,1364,-432
2017,9,18,16,1943,1803,1368,-435
2017,9,18,17,1958,1796,1363,-433
2017,9,18,18,1956,1799,1408,-391
2017,9,18,19,1959,1787,1398,-389
2017,9,18,20,1954,1778,1393,-385
2017,9,18,21,1951,1765,1361,-404
2017,9,18,22,1941,1758,1348,-410
2017,9,18,23,1930,1813,1392,-421
2017,9,19,0,1911,1825,1452,-373
2017,9,19,1,1884,1838,1547,-291
2017,9,19,2,1871,1862,1582,-280
2017,9,19,3,1898,1882,1573,-309
2017,9,19,4,1824,1793,1564,-229
2017,9,19,5,1704,1653,1472,-181
2017,9,19,6,1574,1526,1394,-132
2017,9,19,7,1542,1467,1321,-146
2017,9,19,8,1448,1433,1485,52
2017,9,19,9,1424,1427,1516,89
2017,9,19,10,1410,1401,1436,35
2017,9,19,11,1421,1428,1456,28
2017,9,19,12,1486,1504,1507,3
2017,9,19,13,1630,1670,1589,-81
2017,9,19,14,1740,1787,1576,-211
2017,9,19,15,1744,1780,1560,-220
2017,9,19,16,1767,1744,1521,-223
2017,9,19,17,1764,1754,1547,-207
2017,9,19,18,1740,1704,1577,-127
2017,9,19,19,1715,1610,1504,-106
2017,9,19,20,1695,1625,1572,-53
2017,9,19,21,1686,1585,1571,-14
2017,9,19,22,1678,1595,1554,-41
2017,9,19,23,1685,1600,1580,-20
2017,9,20,0,1708,1647,1627,-20
2017,9,20,1,1732,1699,1692,-7
2017,9,20,2,1762,1782,1696,-86
2017,9,20,3,1784,1845,1724,-121
2017,9,20,4,1712,1776,1664,-112
2017,9,20,5,1603,1636,1598,-38
2017,9,20,6,1488,1521,1472,-49
2017,9,20,7,1444,1443,1425,-18
2017,9,20,8,1416,1413,1263,-150
2017,9,20,9,1441,1380,1216,-164
2017,9,20,10,1435,1376,1200,-176
2017,9,20,11,1453,1397,1241,-156
2017,9,20,12,1524,1477,1277,-200
2017,9,20,13,1679,1664,1422,-242
2017,9,20,14,1802,1798,1715,-83
2017,9,20,15,1824,1756,1598,-158
2017,9,20,16,1855,1663,1528,-135
2017,9,20,17,1876,1694,1548,-146
2017,9,20,18,1867,1677,1519,-158
2017,9,20,19,1856,1691,1553,-138
2017,9,20,20,1869,1697,1512,-185
2017,9,20,21,1874,1648,1493,-155
2017,9,20,22,1863,1657,1534,-123
2017,9,20,23,1867,1678,1646,-32
2017,9,21,0,1865,1684,1655,-29
2017,9,21,1,1852,1741,1654,-87
2017,9,21,2,1863,1773,1580,-193
2017,9,21,3,1887,1797,1626,-171
2017,9,21,4,1811,1739,1564,-175
2017,9,21,5,1681,1618,1476,-142
2017,9,21,6,1552,1495,1099,-396
2017,9,21,7,1460,1422,1104,-318
2017,9,21,8,1429,1374,1147,-227
2017,9,21,9,1402,1366,1142,-224
2017,9,21,10,1391,1356,1135,-221
2017,9,21,11,1407,1372,1175,-197
2017,9,21,12,1482,1459,1213,-246
2017,9,21,13,1641,1632,1367,-265
2017,9,21,14,1761,1766,1578,-188
2017,9,21,15,1763,1751,1545,-206
2017,9,21,16,1765,1699,1535,-164
2017,9,21,17,1752,1646,1519,-127
2017,9,21,18,1718,1581,1479,-102
2017,9,21,19,1687,1533,1412,-121
2017,9,21,20,1681,1505,1399,-106
2017,9,21,21,1680,1524,1377,-147
2017,9,21,22,1674,1536,1444,-92
2017,9,21,23,1684,1556,1527,-29
2017,9,22,0,1695,1573,1510,-63
2017,9,22,1,1726,1619,1560,-59
2017,9,22,2,1770,1697,1615,-82
2017,9,22,3,1813,1741,1678,-63
2017,9,22,4,1754,1670,1618,-52
2017,9,22,5,1631,1562,1515,-47
2017,9,22,6,1513,1448,1398,-50
2017,9,22,7,1453,1364,1361,-3
2017,9,22,8,1392,1352,1395,43
2017,9,22,9,1362,1338,1397,59
2017,9,22,10,1356,1332,1408,76
2017,9,22,11,1374,1354,1462,108
2017,9,22,12,1455,1428,1422,-6
2017,9,22,13,1619,1603,1481,-122
2017,9,22,14,1744,1747,1826,79
2017,9,22,15,1740,1744,1815,71
2017,9,22,16,1733,1724,1699,-25
2017,9,22,17,1719,1654,1636,-18
2017,9,22,18,1688,1657,1613,-44
2017,9,22,19,1669,1616,1649,33
2017,9,22,20,1663,1578,1664,86
2017,9,22,21,1658,1524,1620,96
2017,9,22,22,1656,1490,1625,135
2017,9,22,23,1665,1500,1609,109
2017,9,23,0,1673,1516,1653,137
2017,9,23,1,1683,1522,1667,145
2017,9,23,2,1702,1613,1610,-3
2017,9,23,3,1716,1660,1565,-95
2017,9,23,4,1670,1628,1518,-110
2017,9,23,5,1584,1543,1424,-119
2017,9,23,6,1494,1449,1345,-104
2017,9,23,7,1435,1391,1336,-55
2017,9,23,8,1378,1357,1236,-121
2017,9,23,9,1376,1344,1198,-146
2017,9,23,10,1371,1343,1214,-129
2017,9,23,11,1374,1361,1294,-67
2017,9,23,12,1427,1402,1334,-68
2017,9,23,13,1522,1488,1334,-154
2017,9,23,14,1607,1569,1416,-153
2017,9,23,15,1646,1546,1460,-86
2017,9,23,16,1661,1424,1375,-49
2017,9,23,17,1674,1393,1399,6
2017,9,23,18,1655,1377,1380,3
2017,9,23,19,1622,1346,1461,115
2017,9,23,20,1594,1288,1434,146
2017,9,23,21,1582,1276,1428,152
2017,9,23,22,1564,1246,1460,214
2017,9,23,23,1568,1243,1446,203
2017,9,24,0,1580,1287,1488,201
2017,9,24,1,1583,1406,1556,150
2017,9,24,2,1593,1536,1608,72
2017,9,24,3,1612,1581,1658,77
2017,9,24,4,1575,1549,1636,87
2017,9,24,5,1503,1468,1584,116
2017,9,24,6,1411,1387,1506,119
2017,9,24,7,1381,1314,1434,120
2017,9,24,8,1335,1297,1407,110
2017,9,24,9,1303,1286,1349,63
2017,9,24,10,1297,1289,1354,65
2017,9,24,11,1304,1300,1373,73
2017,9,24,12,1342,1332,1408,76
2017,9,24,13,1413,1400,1390,-10
2017,9,24,14,1478,1485,1634,149
2017,9,24,15,1523,1470,1657,187
2017,9,24,16,1545,1342,1523,181
2017,9,24,17,1552,1295,1474,179
2017,9,24,18,1545,1264,1526,262
2017,9,24,19,1554,1243,1491,248
2017,9,24,20,1561,1238,1527,289
2017,9,24,21,1580,1222,1533,311
2017,9,24,22,1602,1226,1537,311
2017,9,24,23,1634,1264,1580,316
2017,9,25,0,1662,1318,1596,278
2017,9,25,1,1666,1450,1625,175
2017,9,25,2,1672,1575,1648,73
2017,9,25,3,1701,1636,1660,24
2017,9,25,4,1635,1555,1555,0
2017,9,25,5,1520,1448,1496,48
2017,9,25,6,1398,1336,1413,77
2017,9,25,7,1335,1274,1354,80
2017,9,25,8,1274,1252,1258,6
2017,9,25,9,1267,1240,1209,-31
2017,9,25,10,1268,1252,1190,-62
2017,9,25,11,1298,1287,1239,-48
2017,9,25,12,1373,1396,1355,-41
2017,9,25,13,1517,1590,1532,-58
2017,9,25,14,1651,1752,1604,-148
2017,9,25,15,1762,1645,1560,-85
2017,9,25,16,1766,1479,1391,-88
2017,9,25,17,1764,1450,1381,-69
2017,9,25,18,1750,1433,1394,-39
2017,9,25,19,1741,1414,1481,67
2017,9,25,20,1744,1415,1496,81
2017,9,25,21,1752,1406,1434,28
2017,9,25,22,1763,1421,1418,-3
2017,9,25,23,1784,1442,1419,-23
2017,9,26,0,1816,1444,1438,-6
2017,9,26,1,1842,1573,1459,-114
2017,9,26,2,1865,1691,1379,-312
2017,9,26,3,1884,1728,1403,-325
2017,9,26,4,1799,1646,1404,-242
2017,9,26,5,1664,1536,1353,-183
2017,9,26,6,1532,1403,1407,4
2017,9,26,7,1448,1335,1431,96
2017,9,26,8,1397,1301,1359,58
2017,9,26,9,1340,1280,1335,55
2017,9,26,10,1342,1285,1317,32
2017,9,26,11,1370,1300,1358,58
2017,9,26,12,1456,1394,1333,-61
2017,9,26,13,1628,1578,1400,-178
2017,9,26,14,1758,1710,1515,-195
2017,9,26,15,1732,1622,1498,-124
2017,9,26,16,1734,1479,1374,-105
2017,9,26,17,1740,1433,1426,-7
2017,9,26,18,1737,1437,1438,1
2017,9,26,19,1741,1430,1447,17
2017,9,26,20,1749,1440,1511,71
2017,9,26,21,1768,1443,1523,80
2017,9,26,22,1785,1438,1472,34
2017,9,26,23,1819,1436,1417,-19
2017,9,27,0,1847,1460,1375,-85
2017,9,27,1,1882,1605,1385,-220
2017,9,27,2,1896,1719,1399,-320
2017,9,27,3,1909,1758,1439,-319
2017,9,27,4,1808,1672,1438,-234
2017,9,27,5,1657,1542,1443,-99
2017,9,27,6,1518,1403,1437,34
2017,9,27,7,1467,1342,1416,74
2017,9,27,8,1372,1303,1365,62
2017,9,27,9,1324,1293,1372,79
2017,9,27,10,1322,1285,1329,44
2017,9,27,11,1348,1307,1368,61
2017,9,27,12,1437,1394,1416,22
2017,9,27,13,1615,1586,1460,-126
2017,9,27,14,1746,1722,1542,-180
2017,9,27,15,1726,1624,1521,-103
2017,9,27,16,1722,1477,1366,-111
2017,9,27,17,1730,1454,1352,-102
2017,9,27,18,1735,1437,1416,-21
2017,9,27,19,1746,1446,1468,22
2017,9,27,20,1772,1466,1538,72
2017,9,27,21,1805,1472,1619,147
2017,9,27,22,1834,1471,1658,187
2017,9,27,23,1866,1486,1657,171
2017,9,28,0,1891,1526,1647,121
2017,9,28,1,1914,1658,1683,25
2017,9,28,2,1894,1761,1654,-107
2017,9,28,3,1913,1794,1655,-139
2017,9,28,4,1809,1711,1653,-58
2017,9,28,5,1652,1565,1573,8
2017,9,28,6,1510,1434,1579,145
2017,9,28,7,1449,1361,1536,175
2017,9,28,8,1355,1327,1548,221
2017,9,28,9,1320,1305,1525,220
2017,9,28,10,1311,1297,1505,208
2017,9,28,11,1341,1319,1584,265
2017,9,28,12,1430,1405,1564,159
2017,9,28,13,1610,1597,1613,16
2017,9,28,14,1731,1732,1862,130
2017,9,28,15,1726,1650,1838,188
2017,9,28,16,1722,1482,1625,143
2017,9,28,17,1725,1451,1610,159
2017,9,28,18,1716,1451,1643,192
2017,9,28,19,1718,1458,1663,205
2017,9,28,20,1729,1489,1705,216
2017,9,28,21,1755,1497,1712,215
2017,9,28,22,1781,1489,1710,221
2017,9,28,23,1811,1507,1787,280
2017,9,29,0,1797,1527,1727,200
2017,9,29,1,1827,1678,1760,82
2017,9,29,2,1803,1775,1650,-125
2017,9,29,3,1834,1794,1546,-248
2017,9,29,4,1738,1705,1434,-271
2017,9,29,5,1572,1576,1392,-184
2017,9,29,6,1449,1445,1432,-13
2017,9,29,7,1430,1371,1443,72
2017,9,29,8,1358,1318,1355,37
2017,9,29,9,1331,1309,1363,54
2017,9,29,10,1326,1294,1366,72
2017,9,29,11,1345,1315,1374,59
2017,9,29,12,1429,1399,1405,6
2017,9,29,13,1609,1571,1585,14
2017,9,29,14,1741,1716,1744,28
2017,9,29,15,1729,1668,1747,79
2017,9,29,16,1736,1492,1668,176
2017,9,29,17,1754,1470,1659,189
2017,9,29,18,1766,1462,1638,176
2017,9,29,19,1789,1466,1665,199
2017,9,29,20,1817,1490,1586,96
2017,9,29,21,1840,1527,1538,11
2017,9,29,22,1864,1530,1559,29
2017,9,29,23,1882,1546,1555,9
2017,9,30,0,1924,1598,1665,67
2017,9,30,1,1914,1729,1792,63
2017,9,30,2,1856,1768,1813,45
2017,9,30,3,1862,1763,1809,46
2017,9,30,4,1791,1681,1753,72
2017,9,30,5,1681,1584,1689,105
2017,9,30,6,1574,1470,1529,59
2017,9,30,7,1499,1395,1546,151
2017,9,30,8,1416,1352,1559,207
2017,9,30,9,1365,1318,1539,221
2017,9,30,10,1356,1302,1482,180
2017,9,30,11,1365,1294,1495,201
2017,9,30,12,1407,1317,1410,93
2017,9,30,13,1500,1386,1390,4
2017,9,30,14,1579,1466,1424,-42
2017,9,30,15,1607,1530,1486,-44
2017,9,30,16,1622,1538,1494,-44
2017,9,30,17,1621,1517,1480,-37
2017,9,30,18,1592,1451,1468,17
2017,9,30,19,1544,1457,1520,63
2017,9,30,20,1493,1403,1508,105
2017,9,30,21,1439,1380,1540,160
2017,9,30,22,1388,1368,1545,177
2017,9,30,23,1366,1371,1667,296
2017,10,1,0,1368,1404,1668,264
2017,10,1,1,1361,1522,1751,229
2017,10,1,2,1390,1634,1798,164
2017,10,1,3,1485,1645,1870,225
2017,10,1,4,1477,1597,1828,231
2017,10,1,5,1417,1504,1706,202
2017,10,1,6,1344,1418,1620,202
2017,10,1,7,1300,1408,1571,163
2017,10,1,8,1249,1332,1574,242
2017,10,1,9,1299,1315,1579,264
2017,10,1,10,1327,1312,1545,233
2017,10,1,11,1333,1321,1549,228
2017,10,1,12,1376,1351,1634,283
2017,10,1,13,1453,1406,1682,276
2017,10,1,14,1532,1474,1717,243
2017,10,1,15,1555,1522,1729,207
2017,10,1,16,1565,1507,1735,228
2017,10,1,17,1567,1455,1764,309
2017,10,1,18,1551,1434,1804,370
2017,10,1,19,1519,1424,1783,359
2017,10,1,20,1490,1414,1713,299
2017,10,1,21,1501,1410,1705,295
2017,10,1,22,1515,1419,1684,265
2017,10,1,23,1529,1402,1703,301
2017,10,2,0,1566,1519,1776,257
2017,10,2,1,1580,1617,1761,144
2017,10,2,2,1611,1709,1805,96
2017,10,2,3,1681,1731,1860,129
2017,10,2,4,1669,1670,1865,195
2017,10,2,5,1562,1550,1786,236
2017,10,2,6,1448,1447,1684,237
2017,10,2,7,1236,1374,1620,246
2017,10,2,8,1270,1328,1596,268
2017,10,2,9,1348,1314,1581,267
2017,10,2,10,1353,1332,1538,206
2017,10,2,11,1392,1364,1568,204
2017,10,2,12,1480,1469,1534,65
2017,10,2,13,1643,1685,1582,-103
2017,10,2,14,1794,1836,1530,-306
2017,10,2,15,1912,1781,1435,-346
2017,10,2,16,1911,1622,1284,-338
2017,10,2,17,1873,1552,1281,-271
2017,10,2,18,1812,1546,1356,-190
2017,10,2,19,1745,1506,1398,-108
2017,10,2,20,1687,1505,1426,-79
2017,10,2,21,1641,1480,1436,-44
2017,10,2,22,1606,1477,1401,-76
2017,10,2,23,1594,1436,1400,-36
2017,10,3,0,1609,1501,1419,-82
2017,10,3,1,1626,1680,1580,-100
2017,10,3,2,1678,1791,1635,-156
2017,10,3,3,1742,1799,1585,-214
2017,10,3,4,1704,1724,1561,-163
2017,10,3,5,1602,1593,1439,-154
2017,10,3,6,1492,1485,1419,-66
2017,10,3,7,1373,1427,1383,-44
2017,10,3,8,1384,1395,1316,-79
2017,10,3,9,1386,1394,1382,-12
2017,10,3,10,1390,1401,1397,-4
2017,10,3,11,1427,1438,1426,-12
2017,10,3,12,1531,1544,1397,-147
2017,10,3,13,1735,1752,1467,-285
2017,10,3,14,1887,1904,1453,-451
2017,10,3,15,1868,1826,1412,-414
2017,10,3,16,1818,1657,1334,-323
2017,10,3,17,1774,1568,1292,-276
2017,10,3,18,1716,1531,1341,-190
2017,10,3,19,1654,1497,1412,-85
2017,10,3,20,1605,1481,1370,-111
2017,10,3,21,1560,1462,1416,-46
2017,10,3,22,1530,1435,1512,77
2017,10,3,23,1513,1441,1577,136
2017,10,4,0,1524,1476,1595,119
2017,10,4,1,1552,1618,1601,-17
2017,10,4,2,1597,1739,1607,-132
2017,10,4,3,1671,1778,1605,-173
2017,10,4,4,1628,1713,1568,-145
2017,10,4,5,1520,1578,1460,-118
2017,10,4,6,1415,1458,1327,-131
2017,10,4,7,1393,1392,1373,-19
2017,10,4,8,1343,1372,1359,-13
2017,10,4,9,1370,1353,1367,14
2017,10,4,10,1374,1369,1384,15
2017,10,4,11,1401,1391,1389,-2
2017,10,4,12,1486,1490,1272,-218
2017,10,4,13,1674,1679,1351,-328
2017,10,4,14,1814,1829,1424,-405
2017,10,4,15,1791,1840,1438,-402
2017,10,4,16,1759,1815,1435,-380
2017,10,4,17,1742,1780,1441,-339
2017,10,4,18,1718,1760,1380,-380
2017,10,4,19,1690,1720,1347,-373
2017,10,4,20,1671,1666,1290,-376
2017,10,4,21,1646,1621,1304,-317
2017,10,4,22,1629,1657,1368,-289
2017,10,4,23,1622,1630,1328,-302
2017,10,5,0,1632,1646,1351,-295
2017,10,5,1,1657,1714,1415,-299
2017,10,5,2,1708,1800,1476,-324
2017,10,5,3,1764,1806,1539,-267
2017,10,5,4,1701,1736,1531,-205
2017,10,5,5,1576,1614,1472,-142
2017,10,5,6,1451,1485,1319,-166
2017,10,5,7,1373,1418,1213,-205
2017,10,5,8,1373,1369,1079,-290
2017,10,5,9,1384,1354,1073,-281
2017,10,5,10,1383,1360,1051,-309
2017,10,5,11,1412,1405,1116,-289
2017,10,5,12,1504,1490,1185,-305
2017,10,5,13,1696,1671,1342,-329
2017,10,5,14,1845,1821,1537,-284
2017,10,5,15,1846,1770,1528,-242
2017,10,5,16,1815,1629,1397,-232
2017,10,5,17,1787,1553,1279,-274
2017,10,5,18,1764,1522,1267,-255
2017,10,5,19,1739,1511,1288,-223
2017,10,5,20,1728,1477,1233,-244
2017,10,5,21,1718,1464,1229,-235
2017,10,5,22,1721,1424,1169,-255
2017,10,5,23,1726,1428,1162,-266
2017,10,6,0,1740,1462,1190,-272
2017,10,6,1,1764,1591,1311,-280
2017,10,6,2,1804,1695,1396,-299
2017,10,6,3,1825,1728,1412,-316
2017,10,6,4,1746,1665,1371,-294
2017,10,6,5,1611,1568,1337,-231
2017,10,6,6,1480,1446,1220,-226
2017,10,6,7,1400,1379,1147,-232
2017,10,6,8,1378,1344,1162,-182
2017,10,6,9,1357,1344,1146,-198
2017,10,6,10,1359,1348,1105,-243
2017,10,6,11,1388,1377,1117,-260
2017,10,6,12,1474,1473,1126,-347
2017,10,6,13,1654,1648,1238,-410
2017,10,6,14,1793,1792,1317,-475
2017,10,6,15,1774,1751,1295,-456
2017,10,6,16,1748,1596,1168,-428
2017,10,6,17,1730,1521,1125,-396
2017,10,6,18,1726,1485,1104,-381
2017,10,6,19,1718,1469,1132,-337
2017,10,6,20,1722,1418,1108,-310
2017,10,6,21,1730,1394,1094,-300
2017,10,6,22,1744,1399,1085,-314
2017,10,6,23,1761,1415,1134,-281
2017,10,7,0,1739,1422,1159,-263
2017,10,7,1,1744,1557,1279,-278
2017,10,7,2,1774,1659,1279,-380
2017,10,7,3,1774,1666,1182,-484
2017,10,7,4,1712,1606,1124,-482
2017,10,7,5,1613,1525,1074,-451
2017,10,7,6,1504,1422,994,-428
2017,10,7,7,1462,1353,1002,-351
2017,10,7,8,1397,1313,1044,-269
2017,10,7,9,1333,1299,1052,-247
2017,10,7,10,1326,1300,1049,-251
2017,10,7,11,1337,1313,1057,-256
2017,10,7,12,1382,1361,1091,-270
2017,10,7,13,1466,1439,1143,-296
2017,10,7,14,1546,1538,1192,-346
2017,10,7,15,1587,1545,1241,-304
2017,10,7,16,1606,1404,1123,-281
2017,10,7,17,1622,1357,1105,-252
2017,10,7,18,1629,1051,914,-137
2017,10,7,19,1618,1314,1250,-64
2017,10,7,20,1609,1317,1318,1
2017,10,7,21,1601,1295,1281,-14
2017,10,7,22,1597,1283,1303,20
2017,10,7,23,1595,1277,1344,67
2017,10,8,0,1613,1345,1383,38
2017,10,8,1,1606,1498,1400,-98
2017,10,8,2,1623,1607,1494,-113
2017,10,8,3,1629,1608,1493,-115
2017,10,8,4,1575,1550,1487,-63
2017,10,8,5,1489,1462,1396,-66
2017,10,8,6,1406,1384,1312,-72
2017,10,8,7,1368,1307,1230,-77
2017,10,8,8,1303,1286,1263,-23
2017,10,8,9,1296,1258,1238,-20
2017,10,8,10,1303,1270,1257,-13
2017,10,8,11,1322,1280,1259,-21
2017,10,8,12,1368,1315,1326,11
2017,10,8,13,1448,1379,1362,-17
2017,10,8,14,1534,1478,1440,-38
2017,10,8,15,1586,1510,1479,-31
2017,10,8,16,1606,1507,1473,-34
2017,10,8,17,1600,1469,1452,-17
2017,10,8,18,1565,1399,1392,-7
2017,10,8,19,1517,1376,1368,-8
2017,10,8,20,1463,1369,1367,-2
2017,10,8,21,1426,1342,1332,-10
2017,10,8,22,1400,1334,1341,7
2017,10,8,23,1391,1343,1325,-18
2017,10,9,0,1407,1379,1337,-42
2017,10,9,1,1417,1547,1471,-76
2017,10,9,2,1487,1676,1600,-76
2017,10,9,3,1538,1716,1614,-102
2017,10,9,4,1516,1639,1560,-79
2017,10,9,5,1441,1534,1498,-36
2017,10,9,6,1354,1440,1376,-64
2017,10,9,7,1311,1378,1273,-105
2017,10,9,8,1300,1350,959,-391
2017,10,9,9,1376,1364,936,-428
2017,10,9,10,1392,1375,937,-438
2017,10,9,11,1444,1417,976,-441
2017,10,9,12,1551,1534,1092,-442
2017,10,9,13,1740,1756,1246,-510
2017,10,9,14,1921,1905,1101,-804
2017,10,9,15,2023,1845,1043,-802
2017,10,9,16,1980,1634,822,-812
2017,10,9,17,1916,1549,741,-808
2017,10,9,18,1845,1501,707,-794
2017,10,9,19,1773,1471,689,-782
2017,10,9,20,1721,1438,663,-775
2017,10,9,21,1684,1411,630,-781
2017,10,9,22,1662,1402,615,-787
2017,10,9,23,1648,1410,633,-777
2017,10,10,0,1671,1502,691,-811
2017,10,10,1,1701,1640,760,-880
2017,10,10,2,1780,1756,843,-913
2017,10,10,3,1812,1806,875,-931
2017,10,10,4,1751,1642,818,-824
2017,10,10,5,1634,1558,696,-862
2017,10,10,6,1516,1460,848,-612
2017,10,10,7,1394,1391,923,-468
2017,10,10,8,1407,1374,973,-401
2017,10,10,9,1372,1368,974,-394
2017,10,10,10,1369,1374,987,-387
2017,10,10,11,1389,1410,1014,-396
2017,10,10,12,1472,1506,1088,-418
2017,10,10,13,1638,1711,1271,-440
2017,10,10,14,1776,1849,1331,-518
2017,10,10,15,1741,1816,1333,-483
2017,10,10,16,1717,1652,1208,-444
2017,10,10,17,1697,1561,1136,-425
2017,10,10,18,1698,1497,1068,-429
2017,10,10,19,1699,1456,1028,-428
2017,10,10,20,1712,1444,1018,-426
2017,10,10,21,1729,1440,1024,-416
2017,10,10,22,1749,1446,1036,-410
2017,10,10,23,1774,1517,1095,-422
2017,10,11,0,1807,1549,1079,-470
2017,10,11,1,1827,1639,1142,-497
2017,10,11,2,1877,1723,1178,-545
2017,10,11,3,1884,1739,1152,-587
2017,10,11,4,1790,1671,1124,-547
2017,10,11,5,1639,1542,980,-562
2017,10,11,6,1503,1433,940,-493
2017,10,11,7,1442,1355,954,-401
2017,10,11,8,1358,1332,1005,-327
2017,10,11,9,1350,1320,1048,-272
2017,10,11,10,1349,1317,1007,-310
2017,10,11,11,1374,1352,966,-386
2017,10,11,12,1460,1450,966,-484
2017,10,11,13,1619,1649,1146,-503
2017,10,11,14,1743,1796,1132,-664
2017,10,11,15,1719,1793,1042,-751
2017,10,11,16,1713,1738,850,-888
2017,10,11,17,1711,1641,722,-919
2017,10,11,18,1721,1573,807,-766
2017,10,11,19,1700,1529,875,-654
2017,10,11,20,1671,1496,964,-532
2017,10,11,21,1637,1468,1104,-364
2017,10,11,22,1609,1449,1100,-349
2017,10,11,23,1592,1450,1095,-355
2017,10,12,0,1592,1516,1185,-331
2017,10,12,1,1622,1667,1175,-492
2017,10,12,2,1716,1759,1108,-651
2017,10,12,3,1752,1761,1113,-648
2017,10,12,4,1698,1696,1055,-641
2017,10,12,5,1595,1577,1013,-564
2017,10,12,6,1493,1483,982,-501
2017,10,12,7,1436,1406,984,-422
2017,10,12,8,1411,1386,976,-410
2017,10,12,9,1439,1372,977,-395
2017,10,12,10,1454,1389,929,-460
2017,10,12,11,1498,1419,966,-453
2017,10,12,12,1607,1538,1047,-491
2017,10,12,13,1809,1757,1104,-653
2017,10,12,14,1979,1907,1084,-823
2017,10,12,15,1989,1874,958,-916
2017,10,12,16,1933,1667,788,-879
2017,10,12,17,1868,1570,755,-815
2017,10,12,18,1816,1535,777,-758
2017,10,12,19,1755,1525,807,-718
2017,10,12,20,1701,1499,804,-695
2017,10,12,21,1664,1483,811,-672
2017,10,12,22,1655,1464,807,-657
2017,10,12,23,1663,1472,819,-653
2017,10,13,0,1685,1532,850,-682
2017,10,13,1,1740,1697,859,-838
2017,10,13,2,1852,1803,878,-925
2017,10,13,3,1864,1816,881,-935
2017,10,13,4,1793,1732,830,-902
2017,10,13,5,1677,1615,754,-861
2017,10,13,6,1560,1505,732,-773
2017,10,13,7,1464,1436,827,-609
2017,10,13,8,1446,1406,688,-718
2017,10,13,9,1432,1396,661,-735
2017,10,13,10,1433,1397,654,-743
2017,10,13,11,1458,1437,651,-786
2017,10,13,12,1553,1523,745,-778
2017,10,13,13,1737,1705,836,-869
2017,10,13,14,1869,1864,957,-907
2017,10,13,15,1851,1843,897,-946
2017,10,13,16,1814,1785,836,-949
2017,10,13,17,1804,1735,793,-942
2017,10,13,18,1789,1665,745,-920
2017,10,13,19,1753,1579,819,-760
2017,10,13,20,1726,1593,927,-666
2017,10,13,21,1697,1578,901,-677
2017,10,13,22,1670,1615,874,-741
2017,10,13,23,1663,1657,910,-747
2017,10,14,0,1611,1719,945,-774
2017,10,14,1,1624,1741,1082,-659
2017,10,14,2,1723,1797,1051,-746
2017,10,14,3,1754,1782,1079,-703
2017,10,14,4,1727,1738,1118,-620
2017,10,14,5,1666,1646,1211,-435
2017,10,14,6,1594,1563,1151,-412
2017,10,14,7,1556,1495,1189,-306
2017,10,14,8,1557,1468,1199,-269
2017,10,14,9,1520,1469,1195,-274
2017,10,14,10,1538,1468,1190,-278
2017,10,14,11,1571,1498,1156,-342
2017,10,14,12,1644,1548,1146,-402
2017,10,14,13,1757,1646,1113,-533
2017,10,14,14,1873,1750,1220,-530
2017,10,14,15,1947,1797,1271,-526
2017,10,14,16,1954,1634,1037,-597
2017,10,14,17,1917,1538,935,-603
2017,10,14,18,1837,1496,905,-591
2017,10,14,19,1743,1448,930,-518
2017,10,14,20,1673,1390,822,-568
2017,10,14,21,1624,1345,811,-534
2017,10,14,22,1597,1297,783,-514
2017,10,14,23,1599,1286,697,-589
2017,10,15,0,1613,1382,698,-684
2017,10,15,1,1631,1563,700,-863
2017,10,15,2,1692,1693,795,-898
2017,10,15,3,1700,1707,804,-903
2017,10,15,4,1662,1669,785,-884
2017,10,15,5,1604,1604,756,-848
2017,10,15,6,1545,1533,656,-877
2017,10,15,7,1516,1472,605,-867
2017,10,15,8,1481,1439,592,-847
2017,10,15,9,1472,1437,586,-851
2017,10,15,10,1472,1440,612,-828
2017,10,15,11,1483,1461,655,-806
2017,10,15,12,1528,1509,753,-756
2017,10,15,13,1609,1590,851,-739
2017,10,15,14,1692,1680,986,-694
2017,10,15,15,1752,1714,1014,-700
2017,10,15,16,1727,1559,888,-671
2017,10,15,17,1685,1459,820,-639
2017,10,15,18,1628,1411,839,-572
2017,10,15,19,1588,1373,906,-467
2017,10,15,20,1558,1349,934,-415
2017,10,15,21,1548,1295,907,-388
2017,10,15,22,1558,1265,910,-355
2017,10,15,23,1586,1298,911,-387
2017,10,16,0,1626,1386,944,-442
2017,10,16,1,1652,1564,956,-608
2017,10,16,2,1694,1675,992,-683
2017,10,16,3,1672,1686,949,-737
2017,10,16,4,1596,1616,917,-699
2017,10,16,5,1488,1514,936,-578
2017,10,16,6,1392,1423,952,-471
2017,10,16,7,1346,1370,899,-471
2017,10,16,8,1323,1357,829,-528
2017,10,16,9,1363,1364,822,-542
2017,10,16,10,1365,1387,816,-571
2017,10,16,11,1400,1439,824,-615
2017,10,16,12,1496,1555,811,-744
2017,10,16,13,1676,1776,851,-925
2017,10,16,14,1830,1928,953,-975
2017,10,16,15,1906,1890,936,-954
2017,10,16,16,1861,1682,830,-852
2017,10,16,17,1823,1574,825,-749
2017,10,16,18,1788,1550,877,-673
2017,10,16,19,1760,1496,850,-646
2017,10,16,20,1753,1467,864,-603
2017,10,16,21,1755,1449,866,-583
2017,10,16,22,1774,1404,856,-548
2017,10,16,23,1806,1402,863,-539
2017,10,17,0,1849,1459,892,-567
2017,10,17,1,1883,1651,951,-700
2017,10,17,2,1922,1756,986,-770
2017,10,17,3,1889,1759,887,-872
2017,10,17,4,1778,1678,812,-866
2017,10,17,5,1634,1551,754,-797
2017,10,17,6,1511,1436,781,-655
2017,10,17,7,1407,1377,756,-621
2017,10,17,8,1410,1358,698,-660
2017,10,17,9,1376,1354,681,-673
2017,10,17,10,1380,1366,694,-672
2017,10,17,11,1412,1412,762,-650
2017,10,17,12,1507,1528,892,-636
2017,10,17,13,1692,1734,929,-805
2017,10,17,14,1829,1906,938,-968
2017,10,17,15,1800,1873,962,-911
2017,10,17,16,1766,1751,949,-802
2017,10,17,17,1745,1631,890,-741
2017,10,17,18,1728,1575,801,-774
2017,10,17,19,1720,1534,724,-810
2017,10,17,20,1733,1508,685,-823
2017,10,17,21,1758,1481,652,-829
2017,10,17,22,1790,1473,643,-830
2017,10,17,23,1823,1478,615,-863
2017,10,18,0,1847,1529,721,-808
2017,10,18,1,1858,1638,788,-850
2017,10,18,2,1906,1757,918,-839
2017,10,18,3,1878,1735,939,-796
2017,10,18,4,1759,1666,928,-738
2017,10,18,5,1609,1535,830,-705
2017,10,18,6,1482,1427,781,-646
2017,10,18,7,1427,1378,744,-634
2017,10,18,8,1374,1351,696,-655
2017,10,18,9,1360,1355,626,-729
2017,10,18,10,1362,1362,597,-765
2017,10,18,11,1398,1406,628,-778
2017,10,18,12,1491,1507,683,-824
2017,10,18,13,1678,1716,802,-914
2017,10,18,14,1822,1875,836,-1039
2017,10,18,15,1798,1831,830,-1001
2017,10,18,16,1765,1651,785,-866
2017,10,18,17,1745,1520,674,-846
2017,10,18,18,1748,1493,659,-834
2017,10,18,19,1758,1466,665,-801
2017,10,18,20,1779,1450,733,-717
2017,10,18,21,1799,1426,668,-758
2017,10,18,22,1819,1413,628,-785
2017,10,18,23,1845,1411,635,-776
2017,10,19,0,1859,1502,844,-658
2017,10,19,1,1866,1630,956,-674
2017,10,19,2,1918,1707,998,-709
2017,10,19,3,1880,1697,996,-701
2017,10,19,4,1772,1617,1004,-613
2017,10,19,5,1624,1487,987,-500
2017,10,19,6,1494,1381,1005,-376
2017,10,19,7,1422,1310,968,-342
2017,10,19,8,1380,1278,918,-360
2017,10,19,9,1335,1259,973,-286
2017,10,19,10,1338,1264,998,-266
2017,10,19,11,1377,1310,993,-317
2017,10,19,12,1469,1406,940,-466
2017,10,19,13,1655,1604,957,-647
2017,10,19,14,1796,1775,927,-848
2017,10,19,15,1782,1746,916,-830
2017,10,19,16,1741,1571,872,-699
2017,10,19,17,1729,1477,836,-641
2017,10,19,18,1732,1769,1220,-549
2017,10,19,19,1733,1453,924,-529
2017,10,19,20,1738,1447,983,-464
2017,10,19,21,1733,1447,1007,-440
2017,10,19,22,1733,1558,1085,-473
2017,10,19,23,1744,1426,947,-479
2017,10,20,0,1744,1507,1014,-493
2017,10,20,1,1747,1631,944,-687
2017,10,20,2,1815,1709,913,-796
2017,10,20,3,1811,1693,895,-798
2017,10,20,4,1723,1610,872,-738
2017,10,20,5,1590,1493,888,-605
2017,10,20,6,1465,1382,857,-525
2017,10,20,7,1415,1298,900,-398
2017,10,20,8,1353,1267,944,-323
2017,10,20,9,1317,1244,935,-309
2017,10,20,10,1322,1248,899,-349
2017,10,20,11,1361,1274,911,-363
2017,10,20,12,1460,1337,926,-411
2017,10,20,13,1654,1510,1079,-431
2017,10,20,14,1806,1674,1089,-585
2017,10,20,15,1800,1741,1132,-609
2017,10,20,16,1766,1760,1201,-559
2017,10,20,17,1752,1720,1205,-515
2017,10,20,18,1734,1653,1118,-535
2017,10,20,19,1683,1624,1193,-431
2017,10,20,20,1623,1560,1239,-321
2017,10,20,21,1577,1508,1227,-281
2017,10,20,22,1520,1492,1211,-281
2017,10,20,23,1484,1487,1221,-266
2017,10,21,0,1472,1553,1174,-379
2017,10,21,1,1495,1671,1135,-536
2017,10,21,2,1603,1724,1107,-617
2017,10,21,3,1651,1711,1100,-611
2017,10,21,4,1627,1647,1006,-641
2017,10,21,5,1562,1570,971,-599
2017,10,21,6,1490,1470,935,-535
2017,10,21,7,1472,1420,892,-528
2017,10,21,8,1435,1378,825,-553
2017,10,21,9,1439,1388,841,-547
2017,10,21,10,1445,1379,836,-543
2017,10,21,11,1472,1406,830,-576
2017,10,21,12,1535,1452,769,-683
2017,10,21,13,1648,1546,796,-750
2017,10,21,14,1768,1647,796,-851
2017,10,21,15,1839,1728,775,-953
2017,10,21,16,1822,1730,822,-908
2017,10,21,17,1777,1700,791,-909
2017,10,21,18,1712,1642,783,-859
2017,10,21,19,1646,1567,766,-801
2017,10,21,20,1586,1539,778,-761
2017,10,21,21,1552,1559,875,-684
2017,10,21,22,1522,1582,929,-653
2017,10,21,23,1508,1631,973,-658
2017,10,22,0,1527,1668,946,-722
2017,10,22,1,1568,1722,872,-850
2017,10,22,2,1637,1747,863,-884
2017,10,22,3,1635,1699,838,-861
2017,10,22,4,1588,1645,816,-829
2017,10,22,5,1513,1562,843,-719
2017,10,22,6,1427,1489,914,-575
2017,10,22,7,1347,1381,916,-465
2017,10,22,8,1323,1351,913,-438
2017,10,22,9,1359,1323,902,-421
2017,10,22,10,1350,1311,896,-415
2017,10,22,11,1353,1315,868,-447
2017,10,22,12,1387,1339,875,-464
2017,10,22,13,1453,1400,914,-486
2017,10,22,14,1534,1478,868,-610
2017,10,22,15,1589,1550,806,-744
2017,10,22,16,1611,1586,818,-768
2017,10,22,17,1619,1563,816,-747
2017,10,22,18,1607,1504,770,-734
2017,10,22,19,1597,1473,763,-710
2017,10,22,20,1576,1414,812,-602
2017,10,22,21,1578,1417,908,-509
2017,10,22,22,1583,1415,921,-494
2017,10,22,23,1595,1474,964,-510
2017,10,23,0,1623,1529,944,-585
2017,10,23,1,1658,1597,1055,-542
2017,10,23,2,1704,1642,1099,-543
2017,10,23,3,1676,1612,1087,-525
2017,10,23,4,1614,1547,1124,-423
2017,10,23,5,1510,1426,1104,-322
2017,10,23,6,1399,1324,1073,-251
2017,10,23,7,1297,1271,1062,-209
2017,10,23,8,1287,1250,1064,-186
2017,10,23,9,1249,1256,1016,-240
2017,10,23,10,1253,1259,965,-294
2017,10,23,11,1291,1298,934,-364
2017,10,23,12,1385,1408,898,-510
2017,10,23,13,1564,1610,940,-670
2017,10,23,14,1716,1771,855,-916
2017,10,23,15,1810,1775,797,-978
2017,10,23,16,1806,1650,748,-902
2017,10,23,17,1792,1514,721,-793
2017,10,23,18,1755,1522,774,-748
2017,10,23,19,1711,1465,794,-671
2017,10,23,20,1668,941,293,-648
2017,10,23,21,1651,1408,810,-598
2017,10,23,22,1637,1365,835,-530
2017,10,23,23,1633,1359,866,-493
2017,10,24,0,1648,1450,942,-508
2017,10,24,1,1696,1627,1101,-526
2017,10,24,2,1759,1717,1150,-567
2017,10,24,3,1757,1705,1118,-587
2017,10,24,4,1687,1631,1087,-544
2017,10,24,5,1575,1510,901,-609
2017,10,24,6,1469,1407,796,-611
2017,10,24,7,1416,1352,714,-638
2017,10,24,8,1395,1332,651,-681
2017,10,24,9,1351,1333,592,-741
2017,10,24,10,1363,1340,582,-758
2017,10,24,11,1404,1388,641,-747
2017,10,24,12,1507,1497,659,-838
2017,10,24,13,1702,1709,692,-1017
2017,10,24,14,1862,1875,699,-1176
2017,10,24,15,1861,1861,684,-1177
2017,10,24,16,1826,1663,639,-1024
2017,10,24,17,1779,1531,638,-893
2017,10,24,18,1725,1492,621,-871
2017,10,24,19,1676,1452,632,-820
2017,10,24,20,1638,1428,655,-773
2017,10,24,21,1621,1400,697,-703
2017,10,24,22,1606,1365,690,-675
2017,10,24,23,1611,1350,668,-682
2017,10,25,0,1633,1451,774,-677
2017,10,25,1,1685,1623,776,-847
2017,10,25,2,1747,1715,698,-1017
2017,10,25,3,1736,1703,694,-1009
2017,10,25,4,1660,1624,664,-960
2017,10,25,5,1546,1502,662,-840
2017,10,25,6,1441,1402,702,-700
2017,10,25,7,1406,1351,712,-639
2017,10,25,8,1369,1331,692,-639
2017,10,25,9,1343,1322,680,-642
2017,10,25,10,1351,1341,726,-615
2017,10,25,11,1389,1385,753,-632
2017,10,25,12,1492,1493,817,-676
2017,10,25,13,1694,1706,916,-790
2017,10,25,14,1864,1893,953,-940
2017,10,25,15,1864,1851,925,-926
2017,10,25,16,1808,1652,847,-805
2017,10,25,17,1759,1522,729,-793
2017,10,25,18,1705,1495,779,-716
2017,10,25,19,1659,1440,751,-689
2017,10,25,20,1633,1420,703,-717
2017,10,25,21,1624,1379,658,-721
2017,10,25,22,1622,1364,692,-672
2017,10,25,23,1629,1367,768,-599
2017,10,26,0,1647,629,35,-594
2017,10,26,1,1692,1617,1004,-613
2017,10,26,2,1757,1693,1073,-620
2017,10,26,3,1736,1680,1092,-588
2017,10,26,4,1650,1601,1086,-515
2017,10,26,5,1526,1507,970,-537
2017,10,26,6,1414,1373,1046,-327
2017,10,26,7,1367,1308,991,-317
2017,10,26,8,1321,1280,986,-294
2017,10,26,9,1302,1269,959,-310
2017,10,26,10,1307,1267,929,-338
2017,10,26,11,1346,1302,967,-335
2017,10,26,12,1446,1405,948,-457
2017,10,26,13,1643,1594,1077,-517
2017,10,26,14,1794,1744,1101,-643
2017,10,26,15,1786,1737,1097,-640
2017,10,26,16,1729,1579,1029,-550
2017,10,26,17,1702,1462,864,-598
2017,10,26,18,1667,1433,887,-546
2017,10,26,19,1636,1406,858,-548
2017,10,26,20,1619,1411,828,-583
2017,10,26,21,1603,1376,771,-605
2017,10,26,22,1585,1362,739,-623
2017,10,26,23,1587,1363,703,-660
2017,10,27,0,1604,1453,694,-759
2017,10,27,1,1656,1597,778,-819
2017,10,27,2,1730,1670,801,-869
2017,10,27,3,1712,1661,782,-879
2017,10,27,4,1637,1595,756,-839
2017,10,27,5,1522,1494,693,-801
2017,10,27,6,1413,1385,682,-703
2017,10,27,7,1360,1325,666,-659
2017,10,27,8,1321,1297,637,-660
2017,10,27,9,1335,1287,647,-640
2017,10,27,10,1341,1300,652,-648
2017,10,27,11,1382,1346,682,-664
2017,10,27,12,1484,1445,701,-744
2017,10,27,13,1683,1634,799,-835
2017,10,27,14,1840,1786,786,-1000
2017,10,27,15,1833,1810,817,-993
2017,10,27,16,1769,1989,1021,-968
2017,10,27,17,1726,1549,777,-772
2017,10,27,18,1681,1495,720,-775
2017,10,27,19,1643,1401,660,-741
2017,10,27,20,1630,1374,641,-733
2017,10,27,21,1614,1387,725,-662
2017,10,27,22,1603,1343,780,-563
2017,10,27,23,1604,1330,777,-553
2017,10,28,0,1619,1326,775,-551
2017,10,28,1,1635,1384,844,-540
2017,10,28,2,1683,1429,890,-539
2017,10,28,3,1653,1419,923,-496
2017,10,28,4,1598,1381,878,-503
2017,10,28,5,1516,1302,876,-426
2017,10,28,6,1428,1215,853,-362
2017,10,28,7,1367,1159,813,-346
2017,10,28,8,1352,1121,779,-342
2017,10,28,9,1342,1114,856,-258
2017,10,28,10,1342,1123,841,-282
2017,10,28,11,1356,1150,858,-292
2017,10,28,12,1408,1191,880,-311
2017,10,28,13,1499,1284,821,-463
2017,10,28,14,1602,1394,846,-548
2017,10,28,15,1669,1460,916,-544
2017,10,28,16,1655,1346,853,-493
2017,10,28,17,1630,1220,815,-405
2017,10,28,18,1595,1188,820,-368
2017,10,28,19,1565,1151,825,-326
2017,10,28,20,1553,1120,841,-279
2017,10,28,21,1553,1083,830,-253
2017,10,28,22,1556,1052,811,-241
2017,10,28,23,1574,1055,807,-248
2017,10,29,0,1596,1167,882,-285
2017,10,29,1,1623,1314,925,-389
2017,10,29,2,1652,1375,922,-453
2017,10,29,3,1614,1343,862,-481
2017,10,29,4,1556,1313,837,-476
2017,10,29,5,1477,1241,768,-473
2017,10,29,6,1394,1168,808,-360
2017,10,29,7,1327,1127,771,-356
2017,10,29,8,1294,1080,872,-208
2017,10,29,9,1293,1070,894,-176
2017,10,29,10,1294,1086,908,-178
2017,10,29,11,1313,1075,891,-184
2017,10,29,12,1355,1119,921,-198
2017,10,29,13,1429,1190,966,-224
2017,10,29,14,1518,1291,984,-307
2017,10,29,15,1585,1355,1032,-323
2017,10,29,16,1587,1258,925,-333
2017,10,29,17,1568,1142,812,-330
2017,10,29,18,1539,1124,784,-340
2017,10,29,19,1520,1102,782,-320
2017,10,29,20,1500,1081,796,-285
2017,10,29,21,1497,1057,815,-242
2017,10,29,22,1498,1041,849,-192
2017,10,29,23,1507,1031,913,-118
2017,10,30,0,1527,1175,1085,-90
2017,10,30,1,1551,1338,1214,-124
2017,10,30,2,1602,1410,1312,-98
2017,10,30,3,1582,1391,1191,-200
2017,10,30,4,1519,1320,1105,-215
2017,10,30,5,1424,1225,1032,-193
2017,10,30,6,1326,1137,1050,-87
2017,10,30,7,1267,1074,997,-77
2017,10,30,8,1242,1091,1137,46
2017,10,30,9,1254,1088,1133,45
2017,10,30,10,1259,1095,1279,184
2017,10,30,11,1295,1107,1263,156
2017,10,30,12,1393,1266,1380,114
2017,10,30,13,1585,1440,1397,-43
2017,10,30,14,1754,1606,1450,-156
2017,10,30,15,1836,1618,1452,-166
2017,10,30,16,1821,1540,1384,-156
2017,10,30,17,1797,1400,1264,-136
2017,10,30,18,1767,1339,1205,-134
2017,10,30,19,1710,1280,1114,-166
2017,10,30,20,1664,1258,1097,-161
2017,10,30,21,1616,1205,1035,-170
2017,10,30,22,1577,1176,988,-188
2017,10,30,23,1557,1175,1009,-166
2017,10,31,0,1555,1290,1096,-194
2017,10,31,1,1605,1447,1209,-238
2017,10,31,2,1714,1535,1250,-285
2017,10,31,3,1734,1510,1204,-306
2017,10,31,4,1687,1444,1087,-357
2017,10,31,5,1592,1330,1078,-252
2017,10,31,6,1503,1249,977,-272
2017,10,31,7,1437,1169,891,-278
2017,10,31,8,1434,1146,827,-319
2017,10,31,9,1419,1147,781,-366
2017,10,31,10,1443,1160,778,-382
2017,10,31,11,1502,1213,838,-375
2017,10,31,12,1621,1328,861,-467
2017,10,31,13,1842,1528,1030,-498
2017,10,31,14,2022,1705,1118,-587
2017,10,31,15,2025,1693,1104,-589
2017,10,31,16,1969,1544,983,-561
2017,10,31,17,1887,1410,918,-492
2017,10,31,18,1800,1190,808,-382
2017,10,31,19,1716,1413,1053,-360
2017,10,31,20,1655,1251,941,-310
2017,10,31,21,1605,1250,944,-306
2017,10,31,22,1570,1216,979,-237
2017,10,31,23,1557,1236,1030,-206
2017,11,1,0,1558,1325,1041,-284
2017,11,1,1,1618,1416,1112,-304
2017,11,1,2,1716,1437,1107,-330
2017,11,1,3,1722,1433,1064,-369
2017,11,1,4,1667,1424,1135,-289
2017,11,1,5,1563,1335,1097,-238
2017,11,1,6,1456,1226,1098,-128
2017,11,1,7,1408,1169,1035,-134
2017,11,1,8,1344,1157,1030,-127
2017,11,1,9,1363,1145,973,-172
2017,11,1,10,1364,1155,951,-204
2017,11,1,11,1388,1183,877,-306
2017,11,1,12,1479,1271,871,-400
2017,11,1,13,1665,1463,1035,-428
2017,11,1,14,1808,1592,1275,-317
2017,11,1,15,1788,1612,1276,-336
2017,11,1,16,1746,1572,1263,-309
2017,11,1,17,1725,1470,1228,-242
2017,11,1,18,1701,1411,1206,-205
2017,11,1,19,1674,1356,1241,-115
2017,11,1,20,1655,1301,1250,-51
2017,11,1,21,1640,1291,1318,27
2017,11,1,22,1634,1299,1277,-22
2017,11,1,23,1633,1265,1264,-1
2017,11,2,0,1629,1371,1281,-90
2017,11,2,1,1662,1490,1237,-253
2017,11,2,2,1723,1519,1203,-316
2017,11,2,3,1711,1496,1207,-289
2017,11,2,4,1658,1408,1115,-293
2017,11,2,5,1551,1298,1105,-193
2017,11,2,6,1438,1221,1102,-119
2017,11,2,7,1355,1180,1117,-63
2017,11,2,8,1341,1136,1056,-80
2017,11,2,9,1338,1124,1010,-114
2017,11,2,10,1348,1117,956,-161
2017,11,2,11,1385,1162,900,-262
2017,11,2,12,1486,1223,907,-316
2017,11,2,13,1680,1383,895,-488
2017,11,2,14,1842,1521,810,-711
2017,11,2,15,1839,1554,754,-800
2017,11,2,16,1805,1516,741,-775
2017,11,2,17,1774,1484,750,-734
2017,11,2,18,1737,1435,766,-669
2017,11,2,19,1693,1382,764,-618
2017,11,2,20,1657,1350,762,-588
2017,11,2,21,1623,1325,726,-599
2017,11,2,22,1600,1322,762,-560
2017,11,2,23,1594,1353,839,-514
2017,11,3,0,1616,1414,868,-546
2017,11,3,1,1670,1496,833,-663
2017,11,3,2,1730,1526,846,-680
2017,11,3,3,1718,1493,846,-647
2017,11,3,4,1656,1418,802,-616
2017,11,3,5,1546,1307,786,-521
2017,11,3,6,1434,1199,832,-367
2017,11,3,7,1369,1130,826,-304
2017,11,3,8,1331,1290,1015,-275
2017,11,3,9,1309,1264,1031,-233
2017,11,3,10,1310,1267,1022,-245
2017,11,3,11,1343,1284,986,-298
2017,11,3,12,1435,1374,1025,-349
2017,11,3,13,1616,1546,1135,-411
2017,11,3,14,1764,1679,1102,-577
2017,11,3,15,1770,1721,1107,-614
2017,11,3,16,1744,1713,1089,-624
2017,11,3,17,1740,1720,1115,-605
2017,11,3,18,1731,1702,1108,-594
2017,11,3,19,1702,1669,1104,-565
2017,11,3,20,1672,1654,1074,-580
2017,11,3,21,1644,1632,1096,-536
2017,11,3,22,1626,1619,1091,-528
2017,11,3,23,1621,1649,1098,-551
2017,11,4,0,1635,1682,1202,-480
2017,11,4,1,1667,1734,1308,-426
2017,11,4,2,1699,1730,1331,-399
2017,11,4,3,1672,1683,1344,-339
2017,11,4,4,1619,1623,1438,-185
2017,11,4,5,1545,1539,1424,-115
2017,11,4,6,1458,1455,1392,-63
2017,11,4,7,1414,1393,1338,-55
2017,11,4,8,1392,1358,1287,-71
2017,11,4,9,1398,1347,1260,-87
2017,11,4,10,1392,1355,1214,-141
2017,11,4,11,1409,1365,1207,-158
2017,11,4,12,1467,1413,1186,-227
2017,11,4,13,1559,1502,1191,-311
2017,11,4,14,1667,1616,1152,-464
2017,11,4,15,1758,1719,1178,-541
2017,11,4,16,1806,1750,1162,-588
2017,11,4,17,1822,1692,1106,-586
2017,11,4,18,1804,1633,1064,-569
2017,11,4,19,1764,1594,1011,-583
2017,11,4,20,1720,1542,990,-552
2017,11,4,21,1691,1517,996,-521
2017,11,4,22,1673,1563,1051,-512
2017,11,4,23,1673,1559,1066,-493
2017,11,5,0,1696,1634,1020,-614
2017,11,5,1,1751,1734,1080,-654
2017,11,5,2,1777,1760,1062,-698
2017,11,5,3,1743,1723,1046,-677
2017,11,5,4,1702,1691,1083,-608
2017,11,5,5,1629,1614,1027,-587
2017,11,5,6,1550,1536,1005,-531
2017,11,5,7,1471,1481,1031,-450
2017,11,5,8,-9999,1481,1031,-9999
2017,11,5,9,-9999,1347,1260,-9999
2017,11,5,10,-9999,1355,1214,-9999
2017,11,5,11,-9999,1365,1207,-9999
2017,11,5,12,-9999,1413,1186,-9999
2017,11,5,13,-9999,1502,1191,-9999
2017,11,5,14,-9999,1616,1152,-9999
2017,11,5,15,-9999,1719,1178,-9999
2017,11,5,16,-9999,1750,1162,-9999
2017,11,5,17,-9999,1692,1106,-9999
2017,11,5,18,-9999,1633,1064,-9999
2017,11,5,19,-9999,1594,1011,-9999
2017,11,5,20,-9999,1542,990,-9999
2017,11,5,21,-9999,1517,996,-9999
2017,11,5,22,-9999,1563,1051,-9999
2017,11,5,23,-9999,1559,1066,-9999
2017,11,6,0,-9999,1634,1020,-9999
2017,11,6,1,-9999,1734,1080,-9999
2017,11,6,2,-9999,1760,1062,-9999
2017,11,6,3,-9999,1723,1046,-9999
2017,11,6,4,-9999,1691,1083,-9999
2017,11,6,5,-9999,1614,1027,-9999
2017,11,6,6,-9999,1536,1005,-9999
2017,11,6,7,-9999,1481,1031,-9999
2017,11,6,8,-9999,-9999,-9999,-9999
2017,11,6,9,1360,1386,983,-403
2017,11,6,10,1417,1391,955,-436
2017,11,6,11,1420,1403,1054,-349
2017,11,6,12,1458,1456,973,-483
2017,11,6,13,1568,1578,993,-585
2017,11,6,14,1772,1788,1052,-736
2017,11,6,15,1941,1900,1036,-864
2017,11,6,16,2014,1910,1062,-848
2017,11,6,17,1998,1866,1088,-778
2017,11,6,18,1965,1804,1146,-658
2017,11,6,19,1922,1717,1178,-539
2017,11,6,20,1869,1652,1131,-521
2017,11,6,21,1822,1625,1029,-596
2017,11,6,22,1784,1578,1069,-509
2017,11,6,23,1764,1545,1095,-450
2017,11,7,0,1762,1671,1067,-604
2017,11,7,1,1788,1852,1193,-659
2017,11,7,2,1883,1956,1189,-767
2017,11,7,3,1951,1940,1128,-812
2017,11,7,4,1947,1903,1187,-716
2017,11,7,5,1888,1831,1204,-627
2017,11,7,6,1786,1697,1134,-563
2017,11,7,7,1677,1617,1063,-554
2017,11,7,8,1589,1559,960,-599
2017,11,7,9,1615,1566,946,-620
2017,11,7,10,1616,1571,938,-633
2017,11,7,11,1617,1591,930,-661
2017,11,7,12,1651,1649,936,-713
2017,11,7,13,1759,1775,971,-804
2017,11,7,14,1962,1985,1041,-944
2017,11,7,15,2114,2090,1094,-996
2017,11,7,16,2120,1963,1062,-901
2017,11,7,17,2117,1795,1025,-770
2017,11,7,18,2025,1729,1104,-625
2017,11,7,19,1944,1681,1215,-466
2017,11,7,20,1873,1617,1221,-396
2017,11,7,21,1821,1555,1210,-345
2017,11,7,22,1771,1547,1190,-357
2017,11,7,23,1745,1567,1193,-374
2017,11,8,0,1749,1714,1178,-536
2017,11,8,1,1817,1901,1235,-666
2017,11,8,2,1922,1981,1322,-659
2017,11,8,3,1960,1957,1467,-490
2017,11,8,4,1954,1922,1532,-390
2017,11,8,5,1891,1828,1500,-328
2017,11,8,6,1775,1705,1441,-264
2017,11,8,7,1667,1609,1438,-171
2017,11,8,8,1613,1545,1380,-165
2017,11,8,9,1550,1520,1406,-114
2017,11,8,10,1563,1516,1399,-117
2017,11,8,11,1576,1532,1394,-138
2017,11,8,12,1624,1576,1415,-161
2017,11,8,13,1749,1683,1520,-163
2017,11,8,14,1950,1881,1495,-386
2017,11,8,15,2084,2006,1449,-557
2017,11,8,16,2048,1965,1440,-525
2017,11,8,17,1974,1915,1464,-451
2017,11,8,18,1890,1767,1354,-413
2017,11,8,19,1833,1669,1388,-281
2017,11,8,20,1769,1643,1345,-298
2017,11,8,21,1732,1643,1403,-240
2017,11,8,22,1703,1626,1427,-199
2017,11,8,23,1691,1668,1530,-138
2017,11,9,0,1720,1745,1628,-117
2017,11,9,1,1811,1853,1628,-225
2017,11,9,2,1880,1883,1687,-196
2017,11,9,3,1870,1854,1612,-242
2017,11,9,4,1823,1794,1615,-179
2017,11,9,5,1738,1702,1557,-145
2017,11,9,6,1617,1631,1521,-110
2017,11,9,7,1522,1542,1469,-73
2017,11,9,8,1464,1470,1417,-53
2017,11,9,9,1457,1450,1428,-22
2017,11,9,10,1488,1437,1435,-2
2017,11,9,11,1500,1444,1440,-4
2017,11,9,12,1545,1483,1430,-53
2017,11,9,13,1655,1583,1463,-120
2017,11,9,14,1835,1757,1519,-238
2017,11,9,15,1942,1787,1331,-456
2017,11,9,16,1911,1755,1377,-378
2017,11,9,17,1863,1654,1440,-214
2017,11,9,18,1808,1523,1370,-153
2017,11,9,19,1765,1476,1334,-142
2017,11,9,20,1737,1418,1267,-151
2017,11,9,21,1731,1533,1342,-191
2017,11,9,22,1723,1604,1359,-245
2017,11,9,23,1731,1562,1206,-356
2017,11,10,0,1775,1571,1131,-440
2017,11,10,1,1870,1673,1121,-552
2017,11,10,2,1919,1726,1149,-577
2017,11,10,3,1891,1697,1118,-579
2017,11,10,4,1833,1649,1144,-505
2017,11,10,5,1739,1586,1132,-454
2017,11,10,6,1613,1467,1118,-349
2017,11,10,7,1507,1369,1173,-196
2017,11,10,8,1423,1291,1114,-177
2017,11,10,9,1435,1381,1038,-343
2017,11,10,10,1432,1371,961,-410
2017,11,10,11,1442,1382,885,-497
2017,11,10,12,1486,1412,888,-524
2017,11,10,13,1592,1515,924,-591
2017,11,10,14,1778,1679,947,-732
2017,11,10,15,1887,1807,1026,-781
2017,11,10,16,1872,1750,1043,-707
2017,11,10,17,1831,1671,1030,-641
2017,11,10,18,1790,1657,1147,-510
2017,11,10,19,1762,1594,1110,-484
2017,11,10,20,1738,1578,1106,-472
2017,11,10,21,1729,1582,1101,-481
2017,11,10,22,1712,1581,1076,-505
2017,11,10,23,1720,1601,1065,-536
2017,11,11,0,1767,1658,1073,-585
2017,11,11,1,1830,1760,1111,-649
2017,11,11,2,1852,1784,1083,-701
2017,11,11,3,1820,1732,1116,-616
2017,11,11,4,1771,1696,1327,-369
2017,11,11,5,1705,1640,1288,-352
2017,11,11,6,1625,1565,1311,-254
2017,11,11,7,1542,1475,1314,-161
2017,11,11,8,1490,1414,1143,-271
2017,11,11,9,1467,1391,1034,-357
2017,11,11,10,1433,1370,1026,-344
2017,11,11,11,1432,1377,1046,-331
2017,11,11,12,1454,1388,1080,-308
2017,11,11,13,1508,1445,1074,-371
2017,11,11,14,1587,1532,1079,-453
2017,11,11,15,1652,1638,1078,-560
2017,11,11,16,1722,1682,1015,-667
2017,11,11,17,1740,1622,982,-640
2017,11,11,18,1721,1558,946,-612
2017,11,11,19,1688,1498,934,-564
2017,11,11,20,1658,1429,930,-499
2017,11,11,21,1636,1386,947,-439
2017,11,11,22,1618,1388,954,-434
2017,11,11,23,1625,1397,995,-402
2017,11,12,0,1665,1497,1020,-477
2017,11,12,1,1744,1641,1132,-509
2017,11,12,2,1784,1703,1226,-477
2017,11,12,3,1756,1687,1249,-438
2017,11,12,4,1719,1670,1298,-372
2017,11,12,5,1662,1623,1325,-298
2017,11,12,6,1592,1549,1232,-317
2017,11,12,7,1521,1492,1204,-288
2017,11,12,8,1469,1432,1226,-206
2017,11,12,9,1423,1410,1291,-119
2017,11,12,10,1431,1405,1283,-122
2017,11,12,11,1432,1403,1328,-75
2017,11,12,12,1442,1429,1362,-67
2017,11,12,13,1484,1476,1260,-216
2017,11,12,14,1549,1549,1261,-288
2017,11,12,15,1618,1641,1242,-399
2017,11,12,16,1686,1621,1247,-374
2017,11,12,17,1701,1575,1247,-328
2017,11,12,18,1674,1571,1255,-316
2017,11,12,19,1627,1483,1242,-241
2017,11,12,20,1592,1467,1242,-225
2017,11,12,21,1563,1477,1223,-254
2017,11,12,22,1548,1489,1207,-282
2017,11,12,23,1551,1513,1205,-308
2017,11,13,0,1584,1595,1253,-342
2017,11,13,1,1668,1717,1374,-343
2017,11,13,2,1706,1754,1391,-363
2017,11,13,3,1691,1735,1376,-359
2017,11,13,4,1667,1693,1365,-328
2017,11,13,5,1605,1618,1273,-345
2017,11,13,6,1513,1517,1193,-324
2017,11,13,7,1425,1428,1149,-279
2017,11,13,8,1365,1382,1162,-220
2017,11,13,9,1369,1370,1182,-188
2017,11,13,10,1398,1384,1199,-185
2017,11,13,11,1404,1399,1163,-236
2017,11,13,12,1441,1465,1188,-277
2017,11,13,13,1547,1585,1235,-350
2017,11,13,14,1736,1787,1327,-460
2017,11,13,15,1864,1929,1348,-581
2017,11,13,16,1877,1829,1269,-560
2017,11,13,17,1845,1660,1178,-482
2017,11,13,18,1802,1593,1216,-377
2017,11,13,19,1760,1573,1146,-427
2017,11,13,20,1729,1539,1105,-434
2017,11,13,21,1716,1575,1066,-509
2017,11,13,22,1704,1588,1081,-507
2017,11,13,23,1713,1603,1091,-512
2017,11,14,0,1748,1654,1077,-577
2017,11,14,1,1835,1771,1101,-670
2017,11,14,2,1874,1821,1115,-706
2017,11,14,3,1846,1780,1102,-678
2017,11,14,4,1802,1745,1035,-710
2017,11,14,5,1713,1650,1015,-635
2017,11,14,6,1595,1536,1029,-507
2017,11,14,7,1494,1414,1033,-381
2017,11,14,8,1410,1356,1018,-338
2017,11,14,9,1411,1324,1004,-320
2017,11,14,10,1395,1317,1017,-300
2017,11,14,11,1407,1328,1074,-254
2017,11,14,12,1449,1360,1029,-331
2017,11,14,13,1562,1483,1179,-304
2017,11,14,14,1748,1678,1285,-393
2017,11,14,15,1882,1811,1323,-488
2017,11,14,16,1878,1738,1314,-424
2017,11,14,17,1856,1573,1299,-274
2017,11,14,18,1836,1511,1239,-272
2017,11,14,19,1803,1499,1198,-301
2017,11,14,20,1768,1467,1204,-263
2017,11,14,21,1745,1430,1155,-275
2017,11,14,22,1724,1395,1109,-286
2017,11,14,23,1719,1387,1075,-312
2017,11,15,0,1751,1557,1126,-431
2017,11,15,1,1854,1752,1246,-506
2017,11,15,2,1910,1833,1304,-529
2017,11,15,3,1896,1832,1242,-590
2017,11,15,4,1866,1813,1228,-585
2017,11,15,5,1787,1739,1244,-495
2017,11,15,6,1670,1624,1157,-467
2017,11,15,7,1562,1532,1269,-263
2017,11,15,8,1510,1471,1271,-200
2017,11,15,9,1488,1444,1372,-72
2017,11,15,10,1493,1448,1407,-41
2017,11,15,11,1498,1468,1438,-30
2017,11,15,12,1526,1509,1425,-84
2017,11,15,13,1627,1622,1387,-235
2017,11,15,14,1813,1826,1404,-422
2017,11,15,15,1936,1951,1413,-538
2017,11,15,16,1900,1920,1403,-517
2017,11,15,17,1836,2209,1693,-516
2017,11,15,18,1783,1933,1370,-563
2017,11,15,19,1741,1802,1194,-608
2017,11,15,20,1708,1771,1127,-644
2017,11,15,21,1687,1724,1064,-660
2017,11,15,22,1671,1734,1069,-665
2017,11,15,23,1671,1736,1073,-663
2017,11,16,0,1714,1790,1098,-692
2017,11,16,1,1830,1887,1065,-822
2017,11,16,2,1886,1912,1168,-744
2017,11,16,3,1852,1876,1253,-623
2017,11,16,4,1799,1818,1326,-492
2017,11,16,5,1705,1733,1316,-417
2017,11,16,6,1583,1597,1268,-329
2017,11,16,7,1475,1461,1271,-190
2017,11,16,8,1406,1396,1281,-115
2017,11,16,9,1386,1367,1136,-231
2017,11,16,10,1406,1333,1260,-73
2017,11,16,11,1415,1327,1256,-71
2017,11,16,12,1448,1366,1203,-163
2017,11,16,13,1548,1471,1143,-328
2017,11,16,14,1725,1640,1093,-547
2017,11,16,15,1837,1765,1132,-633
2017,11,16,16,1808,1762,1155,-607
2017,11,16,17,1787,1739,1141,-598
2017,11,16,18,1822,1714,1228,-486
2017,11,16,19,1757,1652,1131,-521
2017,11,16,20,1738,1588,1041,-547
2017,11,16,21,1730,1584,1040,-544
2017,11,16,22,1719,1578,1068,-510
2017,11,16,23,1728,1622,1063,-559
2017,11,17,0,1778,1709,1160,-549
2017,11,17,1,1892,1814,1195,-619
2017,11,17,2,1938,1835,1256,-579
2017,11,17,3,1909,1804,1227,-577
2017,11,17,4,1862,1770,1227,-543
2017,11,17,5,1771,1687,1148,-539
2017,11,17,6,1651,1563,1104,-459
2017,11,17,7,1537,1463,1090,-373
2017,11,17,8,1466,1404,1099,-305
2017,11,17,9,1436,1368,1120,-248
2017,11,17,10,1425,1357,1241,-116
2017,11,17,11,1440,1368,1195,-173
2017,11,17,12,1493,1405,1180,-225
2017,11,17,13,1611,1517,1182,-335
2017,11,17,14,1812,1706,1232,-474
2017,11,17,15,1946,1848,1263,-585
2017,11,17,16,1941,1835,1304,-531
2017,11,17,17,1914,1696,1250,-446
2017,11,17,18,1921,1649,1413,-236
2017,11,17,19,1852,1643,1519,-124
2017,11,17,20,1815,1625,1591,-34
2017,11,17,21,1791,1600,1578,-22
2017,11,17,22,1768,1606,1566,-40
2017,11,17,23,1769,1603,1550,-53
2017,11,18,0,1810,1700,1543,-157
2017,11,18,1,1898,1848,1508,-340
2017,11,18,2,1911,1890,1415,-475
2017,11,18,3,1888,1871,1334,-537
2017,11,18,4,1851,1850,1293,-557
2017,11,18,5,1793,1803,1265,-538
2017,11,18,6,1725,1717,1240,-477
2017,11,18,7,1646,1643,1189,-454
2017,11,18,8,1596,1580,1141,-439
2017,11,18,9,1571,1561,1102,-459
2017,11,18,10,1588,1549,1091,-458
2017,11,18,11,1587,1566,987,-579
2017,11,18,12,1609,1593,988,-605
2017,11,18,13,1671,1648,1013,-635
2017,11,18,14,1764,1759,1032,-727
2017,11,18,15,1858,1851,1043,-808
2017,11,18,16,1910,1835,1040,-795
2017,11,18,17,1898,1710,1011,-699
2017,11,18,18,1877,1647,1058,-589
2017,11,18,19,1803,1585,1147,-438
2017,11,18,20,1744,1520,1161,-359
2017,11,18,21,1700,1462,1117,-345
2017,11,18,22,1673,1420,1151,-269
2017,11,18,23,1670,1443,1215,-228
2017,11,19,0,1712,1618,1298,-320
2017,11,19,1,1831,1797,1392,-405
2017,11,19,2,1883,1855,1451,-404
2017,11,19,3,1853,1832,1501,-331
2017,11,19,4,1816,1808,1486,-322
2017,11,19,5,1755,1750,1458,-292
2017,11,19,6,1684,1694,1391,-303
2017,11,19,7,1616,1615,1320,-295
2017,11,19,8,1534,1546,1315,-231
2017,11,19,9,1524,1523,1309,-214
2017,11,19,10,1544,1531,1307,-224
2017,11,19,11,1547,1529,1319,-210
2017,11,19,12,1571,1558,1346,-212
2017,11,19,13,1625,1613,1334,-279
2017,11,19,14,1698,1693,1353,-340
2017,11,19,15,1783,1792,1407,-385
2017,11,19,16,1833,1779,1432,-347
2017,11,19,17,1828,1683,1400,-283
2017,11,19,18,1790,1594,1371,-223
2017,11,19,19,1722,1558,1335,-223
2017,11,19,20,1671,1508,1313,-195
2017,11,19,21,1618,1479,1280,-199
2017,11,19,22,1592,1504,1267,-237
2017,11,19,23,1586,1544,1259,-285
2017,11,20,0,1634,1670,1268,-402
2017,11,20,1,1759,1821,1360,-461
2017,11,20,2,1793,1862,1335,-527
2017,11,20,3,1777,1849,1300,-549
2017,11,20,4,1745,1816,1336,-480
2017,11,20,5,1678,1747,1295,-452
2017,11,20,6,1581,1638,1268,-370
2017,11,20,7,1483,1532,1234,-298
2017,11,20,8,1416,1479,1275,-204
2017,11,20,9,1421,1439,1173,-266
2017,11,20,10,1480,1430,1186,-244
2017,11,20,11,1486,1419,1192,-227
2017,11,20,12,1525,1457,1167,-290
2017,11,20,13,1633,1559,1237,-322
2017,11,20,14,1819,1728,1260,-468
2017,11,20,15,1948,1851,1292,-559
2017,11,20,16,1934,1874,1339,-535
2017,11,20,17,1893,1869,1324,-545
2017,11,20,18,1859,1875,1330,-545
2017,11,20,19,1826,1863,1232,-631
2017,11,20,20,1796,1826,1196,-630
2017,11,20,21,1778,1817,1076,-741
2017,11,20,22,1759,1830,1084,-746
2017,11,20,23,1758,1811,1084,-727
2017,11,21,0,1810,1841,1063,-778
2017,11,21,1,1922,1916,1147,-769
2017,11,21,2,1954,1900,1121,-779
2017,11,21,3,1917,1840,1148,-692
2017,11,21,4,1868,1786,1121,-665
2017,11,21,5,1776,1684,1083,-601
2017,11,21,6,1653,1577,1076,-501
2017,11,21,7,1535,1460,1068,-392
2017,11,21,8,1433,1381,1014,-367
2017,11,21,9,1432,1348,948,-400
2017,11,21,10,1399,1343,929,-414
2017,11,21,11,1409,1333,907,-426
2017,11,21,12,1454,1356,944,-412
2017,11,21,13,1560,1453,1027,-426
2017,11,21,14,1731,1608,1109,-499
2017,11,21,15,1861,1730,1100,-630
2017,11,21,16,1859,1710,1089,-621
2017,11,21,17,1836,1702,1093,-609
2017,11,21,18,1816,1686,1084,-602
2017,11,21,19,1787,1599,1044,-555
2017,11,21,20,1760,1590,1045,-545
2017,11,21,21,1745,1604,1046,-558
2017,11,21,22,1731,1615,1045,-570
2017,11,21,23,1726,1654,1124,-530
2017,11,22,0,1768,1684,1114,-570
2017,11,22,1,1865,1775,1098,-677
2017,11,22,2,1878,1788,1131,-657
2017,11,22,3,1837,1727,1055,-672
2017,11,22,4,1793,1683,1082,-601
2017,11,22,5,1709,1608,1123,-485
2017,11,22,6,1597,1512,1070,-442
2017,11,22,7,1489,1411,1095,-316
2017,11,22,8,1429,1339,1143,-196
2017,11,22,9,1386,1302,1042,-260
2017,11,22,10,1355,1283,1149,-134
2017,11,22,11,1359,1273,1157,-116
2017,11,22,12,1397,1287,1173,-114
2017,11,22,13,1494,1362,1196,-166
2017,11,22,14,1656,1486,1224,-262
2017,11,22,15,1772,1622,1310,-312
2017,11,22,16,1789,1635,1325,-310
2017,11,22,17,1778,1619,1327,-292
2017,11,22,18,1765,1571,1321,-250
2017,11,22,19,1745,1528,1242,-286
2017,11,22,20,1722,1485,1199,-286
2017,11,22,21,1715,1461,1164,-297
2017,11,22,22,1705,1480,1146,-334
2017,11,22,23,1710,1503,1059,-444
2017,11,23,0,1747,1543,1098,-445
2017,11,23,1,1832,1647,1176,-471
2017,11,23,2,1839,1660,1196,-464
2017,11,23,3,1795,1626,1154,-472
2017,11,23,4,1751,1589,1112,-477
2017,11,23,5,1673,1524,1110,-414
2017,11,23,6,1567,1442,1180,-262
2017,11,23,7,1464,1353,1134,-219
2017,11,23,8,1410,1277,1100,-177
2017,11,23,9,1348,1230,1146,-84
2017,11,23,10,1298,1206,1188,-18
2017,11,23,11,1299,1193,1174,-19
2017,11,23,12,1327,1214,1200,-14
2017,11,23,13,1416,1264,1256,-8
2017,11,23,14,1560,1329,1286,-43
2017,11,23,15,1678,1418,1319,-99
2017,11,23,16,1705,1494,1312,-182
2017,11,23,17,1697,1542,1320,-222
2017,11,23,18,1686,1567,1296,-271
2017,11,23,19,1658,1560,1284,-276
2017,11,23,20,1629,1507,1232,-275
2017,11,23,21,1614,1432,1220,-212
2017,11,23,22,1597,1354,1207,-147
2017,11,23,23,1601,1323,1158,-165
2017,11,24,0,1629,1336,1091,-245
2017,11,24,1,1719,1377,1069,-308
2017,11,24,2,1728,1389,1068,-321
2017,11,24,3,1689,1385,1131,-254
2017,11,24,4,1655,1382,1251,-131
2017,11,24,5,1595,1351,1289,-62
2017,11,24,6,1500,1296,1308,12
2017,11,24,7,1412,1238,1277,39
2017,11,24,8,1370,1178,1260,82
2017,11,24,9,1269,1169,1271,102
2017,11,24,10,1207,1143,1302,159
2017,11,24,11,1214,1145,1354,209
2017,11,24,12,1245,1171,1314,143
2017,11,24,13,1324,1230,1293,63
2017,11,24,14,1443,1329,1200,-129
2017,11,24,15,1567,1421,1104,-317
2017,11,24,16,1648,1448,1185,-263
2017,11,24,17,1689,1371,1176,-195
2017,11,24,18,1722,1342,1131,-211
2017,11,24,19,1712,1340,1227,-113
2017,11,24,20,1672,1309,1218,-91
2017,11,24,21,1622,1293,1292,-1
2017,11,24,22,1574,1277,1289,12
2017,11,24,23,1552,1270,1288,18
2017,11,25,0,1565,1426,1394,-32
2017,11,25,1,1633,1566,1138,-428
2017,11,25,2,1641,1617,1083,-534
2017,11,25,3,1626,1601,1082,-519
2017,11,25,4,1612,1601,1105,-496
2017,11,25,5,1590,1562,1083,-479
2017,11,25,6,1549,1501,1047,-454
2017,11,25,7,1491,1421,940,-481
2017,11,25,8,1464,1372,921,-451
2017,11,25,9,1411,1346,888,-458
2017,11,25,10,1371,1345,894,-451
2017,11,25,11,1366,1347,914,-433
2017,11,25,12,1372,1364,944,-420
2017,11,25,13,1393,1413,980,-433
2017,11,25,14,1403,1495,1117,-378
2017,11,25,15,1472,1589,1273,-316
2017,11,25,16,1568,1610,1310,-300
2017,11,25,17,1611,1574,1393,-181
2017,11,25,18,1598,1582,1337,-245
2017,11,25,19,1546,1580,1338,-242
2017,11,25,20,1485,1561,1228,-333
2017,11,25,21,1420,1569,1142,-427
2017,11,25,22,1377,1553,1114,-439
2017,11,25,23,1360,1559,1165,-394
2017,11,26,0,1393,1593,1237,-356
2017,11,26,1,1500,1672,1349,-323
2017,11,26,2,1537,1702,1455,-247
2017,11,26,3,1511,1664,1491,-173
2017,11,26,4,1488,1640,1549,-91
2017,11,26,5,1454,1603,1563,-40
2017,11,26,6,1405,1534,1522,-12
2017,11,26,7,1350,1437,1367,-70
2017,11,26,8,1302,1383,1261,-122
2017,11,26,9,1302,1351,1287,-64
2017,11,26,10,1358,1330,1285,-45
2017,11,26,11,1343,1320,1284,-36
2017,11,26,12,1340,1333,1256,-77
2017,11,26,13,1357,1369,1269,-100
2017,11,26,14,1374,1421,1354,-67
2017,11,26,15,1421,1517,1451,-66
2017,11,26,16,1470,1582,1515,-67
2017,11,26,17,1516,1580,1535,-45
2017,11,26,18,1519,1498,1465,-33
2017,11,26,19,1508,1571,1476,-95
2017,11,26,20,1490,1539,1411,-128
2017,11,26,21,1463,1553,1421,-132
2017,11,26,22,1446,1548,1382,-166
2017,11,26,23,1447,1562,1382,-180
2017,11,27,0,1475,1621,1345,-276
2017,11,27,1,1569,1718,1336,-382
2017,11,27,2,1579,1710,1317,-393
2017,11,27,3,1559,1678,1314,-364
2017,11,27,4,1534,1638,1271,-367
2017,11,27,5,1479,1546,1116,-430
2017,11,27,6,1402,1417,1018,-399
2017,11,27,7,1324,1313,969,-344
2017,11,27,8,1232,1251,995,-256
2017,11,27,9,1225,1217,997,-220
2017,11,27,10,1268,1213,1060,-153
2017,11,27,11,1281,1208,1068,-140
2017,11,27,12,1325,1267,1169,-98
2017,11,27,13,1437,1374,1196,-178
2017,11,27,14,1614,1588,1347,-241
2017,11,27,15,1757,1757,1636,-121
2017,11,27,16,1776,1762,1650,-112
2017,11,27,17,1816,1713,1631,-82
2017,11,27,18,1833,1627,1633,6
2017,11,27,19,1823,1581,1628,47
2017,11,27,20,1801,1581,1646,65
2017,11,27,21,1784,1564,1624,60
2017,11,27,22,1764,1537,1590,53
2017,11,27,23,1758,1563,1574,11
2017,11,28,0,1783,1688,1630,-58
2017,11,28,1,1888,1872,1695,-177
2017,11,28,2,1922,1934,1628,-306
2017,11,28,3,1914,1918,1555,-363
2017,11,28,4,1896,1890,1492,-398
2017,11,28,5,1828,1815,1463,-352
2017,11,28,6,1724,1699,1385,-314
2017,11,28,7,1619,1582,1252,-330
2017,11,28,8,1514,1515,1192,-323
2017,11,28,9,1494,1501,1133,-368
2017,11,28,10,1535,1513,1092,-421
2017,11,28,11,1540,1519,1031,-488
2017,11,28,12,1574,1576,1026,-550
2017,11,28,13,1676,1690,1059,-631
2017,11,28,14,1851,1915,1116,-799
2017,11,28,15,1990,2060,1125,-935
2017,11,28,16,2027,1969,1155,-814
2017,11,28,17,1995,1766,1106,-660
2017,11,28,18,1946,1676,1201,-475
2017,11,28,19,1891,1635,1349,-286
2017,11,28,20,1842,1600,1365,-235
2017,11,28,21,1811,1548,1374,-174
2017,11,28,22,1780,1530,1390,-140
2017,11,28,23,1765,1558,1353,-205
2017,11,29,0,1792,1764,1439,-325
2017,11,29,1,1922,1932,1472,-460
2017,11,29,2,1970,1977,1533,-444
2017,11,29,3,1954,1956,1508,-448
2017,11,29,4,1916,1902,1402,-500
2017,11,29,5,1827,1819,1252,-567
2017,11,29,6,1707,1699,1153,-546
2017,11,29,7,1602,1572,1100,-472
2017,11,29,8,1483,1485,1029,-456
2017,11,29,9,1453,1451,1140,-311
2017,11,29,10,1483,1462,1197,-265
2017,11,29,11,1495,1477,1225,-252
2017,11,29,12,1544,1525,1236,-289
2017,11,29,13,1661,1640,1400,-240
2017,11,29,14,1858,1864,1562,-302
2017,11,29,15,2008,2018,1666,-352
2017,11,29,16,2014,1959,1603,-356
2017,11,29,17,1982,1866,1513,-353
2017,11,29,18,1944,1827,1466,-361
2017,11,29,19,1912,1783,1439,-344
2017,11,29,20,1868,1730,1230,-500
2017,11,29,21,1846,1729,1175,-554
2017,11,29,22,1822,1750,1138,-612
2017,11,29,23,1826,1728,1102,-626
2017,11,30,0,1872,1812,1028,-784
2017,11,30,1,2020,1985,1085,-900
2017,11,30,2,2071,2033,1102,-931
2017,11,30,3,2057,2015,1040,-975
2017,11,30,4,2019,1989,1026,-963
2017,11,30,5,1941,1920,1083,-837
2017,11,30,6,1828,1815,1046,-769
2017,11,30,7,1714,1695,965,-730
2017,11,30,8,1598,1625,932,-693
2017,11,30,9,1620,1602,927,-675
2017,11,30,10,1623,1612,934,-678
2017,11,30,11,1625,1629,923,-706
2017,11,30,12,1664,1668,956,-712
2017,11,30,13,1774,1785,1064,-721
2017,11,30,14,1973,1995,1100,-895
2017,11,30,15,2109,2141,1210,-931
2017,11,30,16,2085,2098,1210,-888
2017,11,30,17,2031,1999,1132,-867
2017,11,30,18,1992,1896,1117,-779
2017,11,30,19,1952,1818,1034,-784
2017,11,30,20,1903,1760,1066,-694
2017,11,30,21,1871,1717,1033,-684
2017,11,30,22,1847,1755,1059,-696
2017,11,30,23,1840,1789,1057,-732
2017,12,1,0,1885,1897,1095,-802
2017,12,1,1,2034,2021,1120,-901
2017,12,1,2,2081,2054,1078,-976
2017,12,1,3,2053,2015,1080,-935
2017,12,1,4,1999,1972,1065,-907
2017,12,1,5,1901,1889,1046,-843
2017,12,1,6,1781,1764,1035,-729
2017,12,1,7,1674,1649,1019,-630
2017,12,1,8,1603,1582,1008,-574
2017,12,1,9,1592,1551,1014,-537
2017,12,1,10,1608,1549,1012,-537
2017,12,1,11,1620,1545,986,-559
2017,12,1,12,1665,1586,1000,-586
2017,12,1,13,1785,1701,1039,-662
2017,12,1,14,1986,1886,1022,-864
2017,12,1,15,2132,2028,1051,-977
2017,12,1,16,2112,2001,1056,-945
2017,12,1,17,2052,1901,1016,-885
2017,12,1,18,1978,1858,1001,-857
2017,12,1,19,1920,1775,1011,-764
2017,12,1,20,1864,1706,1026,-680
2017,12,1,21,1820,1655,1036,-619
2017,12,1,22,1798,1647,1061,-586
2017,12,1,23,1800,1660,1077,-583
2017,12,2,0,1850,1771,1100,-671
2017,12,2,1,1956,1895,1157,-738
2017,12,2,2,1990,1901,1206,-695
2017,12,2,3,1964,1870,1254,-616
2017,12,2,4,1919,1834,1284,-550
2017,12,2,5,1848,1789,1310,-479
2017,12,2,6,1764,1709,1295,-414
2017,12,2,7,1677,1615,1193,-422
2017,12,2,8,1600,1563,1151,-412
2017,12,2,9,1579,1523,1106,-417
2017,12,2,10,1573,1521,1098,-423
2017,12,2,11,1572,1537,1065,-472
2017,12,2,12,1595,1559,1072,-487
2017,12,2,13,1654,1617,1117,-500
2017,12,2,14,1743,1712,1136,-576
2017,12,2,15,1837,1818,1202,-616
2017,12,2,16,1878,1871,1269,-602
2017,12,2,17,1869,1865,1297,-568
2017,12,2,18,1818,1827,1340,-487
2017,12,2,19,1764,1765,1289,-476
2017,12,2,20,1707,1715,1211,-504
2017,12,2,21,1663,1692,1208,-484
2017,12,2,22,1644,1701,1238,-463
2017,12,2,23,1647,1725,1202,-523
2017,12,3,0,1708,1763,1138,-625
2017,12,3,1,1837,1878,1255,-623
2017,12,3,2,1856,1873,1328,-545
2017,12,3,3,1811,1846,1331,-515
2017,12,3,4,1759,1814,1308,-506
2017,12,3,5,1688,1769,1285,-484
2017,12,3,6,1616,1696,1229,-467
2017,12,3,7,1531,1588,1189,-399
2017,12,3,8,1473,1516,1078,-438
2017,12,3,9,1453,1473,891,-582
2017,12,3,10,1497,1452,844,-608
2017,12,3,11,1495,1445,862,-583
2017,12,3,12,1509,1466,889,-577
2017,12,3,13,1562,1485,991,-494
2017,12,3,14,1648,1555,1065,-490
2017,12,3,15,1738,1637,1331,-306
2017,12,3,16,1779,1721,1449,-272
2017,12,3,17,1806,1773,1622,-151
2017,12,3,18,1808,1798,1714,-84
2017,12,3,19,1797,1775,1684,-91
2017,12,3,20,1788,1749,1597,-152
2017,12,3,21,1776,1751,1550,-201
2017,12,3,22,1782,1737,1474,-263
2017,12,3,23,1806,1776,1453,-323
2017,12,4,0,1882,1891,1678,-213
2017,12,4,1,2020,2026,1800,-226
2017,12,4,2,2040,2057,1774,-283
2017,12,4,3,2022,2032,1768,-264
2017,12,4,4,1991,1997,1743,-254
2017,12,4,5,1926,1914,1697,-217
2017,12,4,6,1822,1788,1675,-113
2017,12,4,7,1710,1666,1616,-50
2017,12,4,8,1610,1603,1586,-17
2017,12,4,9,1606,1567,1501,-66
2017,12,4,10,1617,1555,1474,-81
2017,12,4,11,1635,1587,1501,-86
2017,12,4,12,1688,1620,1481,-139
2017,12,4,13,1818,1746,1493,-253
2017,12,4,14,2048,1947,1468,-479
2017,12,4,15,2212,2083,1510,-573
2017,12,4,16,2195,2061,1506,-555
2017,12,4,17,2169,1962,1485,-477
2017,12,4,18,2139,1828,1502,-326
2017,12,4,19,2087,1775,1460,-315
2017,12,4,20,2035,1726,1461,-265
2017,12,4,21,1993,1688,1460,-228
2017,12,4,22,1970,1663,1430,-233
2017,12,4,23,1966,1657,1423,-234
2017,12,5,0,2024,1848,1547,-301
2017,12,5,1,2179,2052,1648,-404
2017,12,5,2,2223,2135,1565,-570
2017,12,5,3,2215,2115,1511,-604
2017,12,5,4,2184,2078,1458,-620
2017,12,5,5,2095,2011,1402,-609
2017,12,5,6,1961,1890,1329,-561
2017,12,5,7,1833,1764,1296,-468
2017,12,5,8,1735,1697,1303,-394
2017,12,5,9,1707,1674,1212,-462
2017,12,5,10,1713,1675,1124,-551
2017,12,5,11,1717,1699,1036,-663
2017,12,5,12,1758,1742,1052,-690
2017,12,5,13,1867,1854,1097,-757
2017,12,5,14,2063,2069,1103,-966
2017,12,5,15,2206,2216,1090,-1126
2017,12,5,16,2217,2159,1071,-1088
2017,12,5,17,2165,1981,1099,-882
2017,12,5,18,2117,1870,1097,-773
2017,12,5,19,2064,1818,1111,-707
2017,12,5,20,2010,1786,1134,-652
2017,12,5,21,1963,1716,1109,-607
2017,12,5,22,1928,1661,1051,-610
2017,12,5,23,1920,1677,1053,-624
2017,12,6,0,1947,1865,1058,-807
2017,12,6,1,2074,2083,1095,-988
2017,12,6,2,2143,2152,1070,-1082
2017,12,6,3,2176,2153,1075,-1078
2017,12,6,4,2189,2131,1062,-1069
2017,12,6,5,2100,2065,999,-1066
2017,12,6,6,1967,1940,962,-978
2017,12,6,7,1848,1825,1031,-794
2017,12,6,8,1762,1757,969,-788
2017,12,6,9,1757,1740,991,-749
2017,12,6,10,1761,1732,1032,-700
2017,12,6,11,1770,1758,1054,-704
2017,12,6,12,1813,1806,1065,-741
2017,12,6,13,1929,1928,1101,-827
2017,12,6,14,2130,2126,1102,-1024
2017,12,6,15,2276,2271,1162,-1109
2017,12,6,16,2262,2237,1133,-1104
2017,12,6,17,2195,2108,1088,-1020
2017,12,6,18,2134,1972,1082,-890
2017,12,6,19,2074,1853,1046,-807
2017,12,6,20,2015,1745,1068,-677
2017,12,6,21,1966,1740,1087,-653
2017,12,6,22,1926,1686,1068,-618
2017,12,6,23,1914,1685,1035,-650
2017,12,7,0,1962,1825,1074,-751
2017,12,7,1,2118,2012,1156,-856
2017,12,7,2,2206,2182,1187,-995
2017,12,7,3,2229,2181,1168,-1013
2017,12,7,4,2221,2169,1166,-1003
2017,12,7,5,2132,2088,1122,-966
2017,12,7,6,2000,1953,1012,-941
2017,12,7,7,1882,1839,1032,-807
2017,12,7,8,1798,1774,1050,-724
2017,12,7,9,1772,1764,1241,-523
2017,12,7,10,1786,1765,1264,-501
2017,12,7,11,1794,1788,1260,-528
2017,12,7,12,1836,1848,1258,-590
2017,12,7,13,1955,1964,1330,-634
2017,12,7,14,2154,2165,1445,-720
2017,12,7,15,2300,2318,1503,-815
2017,12,7,16,2292,2305,1514,-791
2017,12,7,17,2219,2182,1475,-707
2017,12,7,18,2148,2074,1442,-632
2017,12,7,19,2082,1985,1454,-531
2017,12,7,20,2019,1906,1399,-507
2017,12,7,21,1979,1862,1357,-505
2017,12,7,22,1931,1795,1363,-432
2017,12,7,23,1924,1779,1352,-427
2017,12,8,0,1981,1924,1384,-540
2017,12,8,1,2155,2123,1485,-638
2017,12,8,2,2228,2189,1487,-702
2017,12,8,3,2234,2177,1498,-679
2017,12,8,4,2216,2168,1517,-651
2017,12,8,5,2126,2087,1483,-604
2017,12,8,6,1986,1969,1435,-534
2017,12,8,7,1866,1839,1325,-514
2017,12,8,8,1791,1782,1280,-502
2017,12,8,9,1786,1767,1323,-444
2017,12,8,10,1794,1762,1351,-411
2017,12,8,11,1809,1773,1331,-442
2017,12,8,12,1851,1824,1371,-453
2017,12,8,13,1974,1931,1452,-479
2017,12,8,14,2177,2130,1648,-482
2017,12,8,15,2319,2276,1817,-459
2017,12,8,16,2301,2266,1807,-459
2017,12,8,17,2222,2220,1757,-463
2017,12,8,18,2134,2180,1737,-443
2017,12,8,19,2059,2100,1714,-386
2017,12,8,20,1986,2028,1544,-484
2017,12,8,21,1937,1992,1506,-486
2017,12,8,22,1890,1960,1504,-456
2017,12,8,23,1882,1981,1518,-463
2017,12,9,0,1952,2080,1618,-462
2017,12,9,1,2113,2213,1652,-561
2017,12,9,2,2165,2202,1642,-560
2017,12,9,3,2147,2167,1616,-551
2017,12,9,4,2118,2120,1564,-556
2017,12,9,5,2062,2063,1532,-531
2017,12,9,6,1967,1963,1440,-523
2017,12,9,7,1874,1837,1305,-532
2017,12,9,8,1811,1752,1318,-434
2017,12,9,9,1774,1715,1307,-408
2017,12,9,10,1772,1700,1310,-390
2017,12,9,11,1785,1703,1349,-354
2017,12,9,12,1812,1729,1363,-366
2017,12,9,13,1877,1780,1383,-397
2017,12,9,14,1960,1875,1452,-423
2017,12,9,15,2061,1980,1550,-430
2017,12,9,16,2124,2069,1575,-494
2017,12,9,17,2139,2115,1555,-560
2017,12,9,18,2103,2121,1594,-527
2017,12,9,19,2044,2071,1562,-509
2017,12,9,20,1968,2016,1497,-519
2017,12,9,21,1906,1979,1466,-513
2017,12,9,22,1865,1959,1406,-553
2017,12,9,23,1860,1973,1407,-566
2017,12,10,0,1928,2026,1472,-554
2017,12,10,1,2090,2147,1578,-569
2017,12,10,2,2128,2167,1611,-556
2017,12,10,3,2104,2143,1582,-561
2017,12,10,4,2088,2122,1563,-559
2017,12,10,5,2050,2073,1574,-499
2017,12,10,6,1973,1970,1587,-383
2017,12,10,7,1868,1873,1503,-370
2017,12,10,8,1799,1809,1437,-372
2017,12,10,9,1806,1761,1393,-368
2017,12,10,10,1806,1761,1367,-394
2017,12,10,11,1812,1753,1380,-373
2017,12,10,12,1822,1773,1299,-474
2017,12,10,13,1869,1818,1330,-488
2017,12,10,14,1947,1901,1405,-496
2017,12,10,15,2040,1998,1376,-622
2017,12,10,16,2116,2086,1428,-658
2017,12,10,17,2134,2102,1459,-643
2017,12,10,18,2095,2083,1463,-620
2017,12,10,19,2034,2038,1359,-679
2017,12,10,20,1965,1993,1323,-670
2017,12,10,21,1903,1956,1274,-682
2017,12,10,22,1864,1921,1251,-670
2017,12,10,23,1854,1920,1248,-672
2017,12,11,0,1924,2015,1298,-717
2017,12,11,1,2099,2173,1441,-732
2017,12,11,2,2149,2224,1497,-727
2017,12,11,3,2150,2198,1476,-722
2017,12,11,4,2141,2175,1507,-668
2017,12,11,5,2086,2089,1443,-646
2017,12,11,6,1968,1953,1482,-471
2017,12,11,7,1852,1832,1339,-493
2017,12,11,8,1785,1763,1333,-430
2017,12,11,9,1784,1735,1313,-422
2017,12,11,10,1785,1739,1295,-444
2017,12,11,11,1805,1754,1311,-443
2017,12,11,12,1859,1817,1359,-458
2017,12,11,13,1997,1935,1460,-475
2017,12,11,14,2231,2160,1706,-454
2017,12,11,15,2395,2306,1782,-524
2017,12,11,16,2375,2307,1841,-466
2017,12,11,17,2327,2262,1821,-441
2017,12,11,18,2261,2207,1754,-453
2017,12,11,19,2182,2168,1662,-506
2017,12,11,20,2095,2116,1667,-449
2017,12,11,21,2026,2076,1602,-474
2017,12,11,22,1966,2045,1544,-501
2017,12,11,23,1943,2049,1538,-511
2017,12,12,0,2002,2128,1638,-490
2017,12,12,1,2160,2287,1744,-543
2017,12,12,2,2227,2316,1742,-574
2017,12,12,3,2230,2287,1731,-556
2017,12,12,4,2220,2246,1649,-597
2017,12,12,5,2150,2160,1578,-582
2017,12,12,6,2019,2011,1535,-476
2017,12,12,7,1895,1869,1456,-413
2017,12,12,8,1824,1806,1418,-388
2017,12,12,9,1834,1774,1324,-450
2017,12,12,10,1804,1780,1281,-499
2017,12,12,11,1821,1786,1308,-478
2017,12,12,12,1867,1842,1349,-493
2017,12,12,13,1981,1962,1451,-511
2017,12,12,14,2180,2167,1712,-455
2017,12,12,15,2333,2317,1797,-520
2017,12,12,16,2347,2327,1811,-516
2017,12,12,17,2309,2283,1759,-524
2017,12,12,18,2251,2247,1676,-571
2017,12,12,19,2188,2203,1616,-587
2017,12,12,20,2118,2156,1564,-592
2017,12,12,21,2062,2133,1537,-596
2017,12,12,22,2012,2124,1540,-584
2017,12,12,23,2000,2131,1517,-614
2017,12,13,0,2067,2218,1649,-569
2017,12,13,1,2232,2368,1771,-597
2017,12,13,2,2286,2373,1739,-634
2017,12,13,3,2268,2337,1680,-657
2017,12,13,4,2241,2287,1632,-655
2017,12,13,5,2163,2197,1560,-637
2017,12,13,6,2032,2047,1523,-524
2017,12,13,7,1905,1906,1450,-456
2017,12,13,8,1853,1837,1367,-470
2017,12,13,9,1842,1793,1366,-427
2017,12,13,10,1826,1793,1385,-408
2017,12,13,11,1837,1798,1372,-426
2017,12,13,12,1881,1851,1409,-442
2017,12,13,13,1997,1962,1477,-485
2017,12,13,14,2199,2166,1601,-565
2017,12,13,15,2342,2309,1804,-505
2017,12,13,16,2345,2308,1812,-496
2017,12,13,17,2298,2283,1792,-491
2017,12,13,18,2242,2247,1757,-490
2017,12,13,19,2188,2209,1740,-469
2017,12,13,20,2125,2171,1715,-456
2017,12,13,21,2085,2139,1670,-469
2017,12,13,22,2042,2106,1644,-462
2017,12,13,23,2038,2110,1705,-405
2017,12,14,0,2111,2194,1766,-428
2017,12,14,1,2270,2326,1916,-410
2017,12,14,2,2306,2366,1964,-402
2017,12,14,3,2275,2333,1944,-389
2017,12,14,4,2237,2288,1907,-381
2017,12,14,5,2150,2190,1815,-375
2017,12,14,6,2020,2042,1651,-391
2017,12,14,7,1890,1912,1523,-389
2017,12,14,8,1819,1834,1418,-416
2017,12,14,9,1809,1804,1357,-447
2017,12,14,10,1827,1805,1349,-456
2017,12,14,11,1835,1811,1353,-458
2017,12,14,12,1879,1855,1407,-448
2017,12,14,13,1991,1974,1486,-488
2017,12,14,14,2193,2163,1650,-513
2017,12,14,15,2333,2313,1764,-549
2017,12,14,16,2334,2311,1801,-510
2017,12,14,17,2267,2290,1792,-498
2017,12,14,18,2204,2254,1686,-568
2017,12,14,19,2187,2201,1622,-579
2017,12,14,20,2135,2142,1554,-588
2017,12,14,21,2102,2117,1616,-501
2017,12,14,22,2063,2104,1585,-519
2017,12,14,23,2059,2118,1606,-512
2017,12,15,0,2133,2173,1676,-497
2017,12,15,1,2292,2306,1690,-616
2017,12,15,2,2336,2306,1583,-723
2017,12,15,3,2306,2267,1624,-643
2017,12,15,4,2260,2239,1727,-512
2017,12,15,5,2173,2158,1658,-500
2017,12,15,6,2030,2024,1598,-426
2017,12,15,7,1904,1899,1546,-353
2017,12,15,8,1803,1822,1480,-342
2017,12,15,9,1822,1776,1579,-197
2017,12,15,10,1830,1773,1588,-185
2017,12,15,11,1843,1789,1609,-180
2017,12,15,12,1888,1830,1649,-181
2017,12,15,13,2004,1936,1712,-224
2017,12,15,14,2206,2129,1878,-251
2017,12,15,15,2356,2266,1871,-395
2017,12,15,16,2358,2284,1785,-499
2017,12,15,17,2298,2253,1693,-560
2017,12,15,18,2223,2204,1643,-561
2017,12,15,19,2164,2160,1626,-534
2017,12,15,20,2084,2105,1583,-522
2017,12,15,21,2032,2067,1544,-523
2017,12,15,22,1989,2056,1522,-534
2017,12,15,23,1977,2059,1530,-529
2017,12,16,0,2045,2123,1587,-536
2017,12,16,1,2158,2225,1654,-571
2017,12,16,2,2162,2220,1660,-560
2017,12,16,3,2117,2179,1632,-547
2017,12,16,4,2082,2142,1595,-547
2017,12,16,5,2033,2069,1575,-494
2017,12,16,6,1946,1978,1497,-481
2017,12,16,7,1850,1870,1524,-346
2017,12,16,8,1766,1791,1578,-213
2017,12,16,9,1785,1747,1659,-88
2017,12,16,10,1771,1731,1659,-72
2017,12,16,11,1766,1751,1688,-63
2017,12,16,12,1787,1779,1724,-55
2017,12,16,13,1840,1838,1769,-69
2017,12,16,14,1925,1909,1848,-61
2017,12,16,15,2032,2030,1939,-91
2017,12,16,16,2112,2095,2004,-91
2017,12,16,17,2137,2098,2044,-54
2017,12,16,18,2105,2055,2065,10
2017,12,16,19,2064,2013,2026,13
2017,12,16,20,1990,1945,1988,43
2017,12,16,21,1933,1853,1902,49
2017,12,16,22,1903,1792,1821,29
2017,12,16,23,1907,1790,1784,-6
2017,12,17,0,1973,1931,1925,-6
2017,12,17,1,2117,2105,2010,-95
2017,12,17,2,2150,2141,2015,-126
2017,12,17,3,2138,2123,1960,-163
2017,12,17,4,2127,2100,1915,-185
2017,12,17,5,2085,2054,1909,-145
2017,12,17,6,2007,1968,1872,-96
2017,12,17,7,1914,1867,1791,-76
2017,12,17,8,1852,1800,1690,-110
2017,12,17,9,1804,1775,1494,-281
2017,12,17,10,1810,1773,1440,-333
2017,12,17,11,1820,1776,1412,-364
2017,12,17,12,1833,1802,1399,-403
2017,12,17,13,1884,1862,1439,-423
2017,12,17,14,1966,1948,1520,-428
2017,12,17,15,2062,2044,1613,-431
2017,12,17,16,2137,2105,1693,-412
2017,12,17,17,2151,2039,1657,-382
2017,12,17,18,2108,1928,1552,-376
2017,12,17,19,2052,1854,1455,-399
2017,12,17,20,1999,1823,1419,-404
2017,12,17,21,1956,1811,1423,-388
2017,12,17,22,1929,1814,1424,-390
2017,12,17,23,1929,1854,1471,-383
2017,12,18,0,1998,1945,1547,-398
2017,12,18,1,2177,2108,1664,-444
2017,12,18,2,2214,2137,1637,-500
2017,12,18,3,2210,2100,1626,-474
2017,12,18,4,2192,2073,1657,-416
2017,12,18,5,2118,1994,1614,-380
2017,12,18,6,1987,1871,1574,-297
2017,12,18,7,1859,1725,1404,-321
2017,12,18,8,1758,1655,1366,-289
2017,12,18,9,1712,1627,1358,-269
2017,12,18,10,1673,1613,1339,-274
2017,12,18,11,1686,1631,1347,-284
2017,12,18,12,1738,1676,1384,-292
2017,12,18,13,1862,1784,1479,-305
2017,12,18,14,2066,1982,1604,-378
2017,12,18,15,2213,2139,1793,-346
2017,12,18,16,2197,2149,1786,-363
2017,12,18,17,2137,2086,1778,-308
2017,12,18,18,2071,1999,1786,-213
2017,12,18,19,2014,1904,1781,-123
2017,12,18,20,1954,1866,1752,-114
2017,12,18,21,1921,1823,1735,-88
2017,12,18,22,1883,1767,1674,-93
2017,12,18,23,1880,1779,1646,-133
2017,12,19,0,1953,1897,1731,-166
2017,12,19,1,2116,2097,1860,-237
2017,12,19,2,2167,2141,1834,-307
2017,12,19,3,2159,2136,1838,-298
2017,12,19,4,2148,2108,1838,-270
2017,12,19,5,2070,2025,1787,-238
2017,12,19,6,1950,1906,1761,-145
2017,12,19,7,1826,1778,1701,-77
2017,12,19,8,1766,1701,1626,-75
2017,12,19,9,1737,1669,1691,22
2017,12,19,10,1692,1659,1688,29
2017,12,19,11,1694,1668,1705,37
2017,12,19,12,1728,1721,1704,-17
2017,12,19,13,1821,1824,1825,1
2017,12,19,14,1994,2019,1969,-50
2017,12,19,15,2133,2152,2040,-112
2017,12,19,16,2145,2157,2052,-105
2017,12,19,17,2088,1947,1903,-44
2017,12,19,18,2023,2232,2154,-78
2017,12,19,19,1955,2018,2027,9
2017,12,19,20,1901,1979,1949,-30
2017,12,19,21,1868,1932,1918,-14
2017,12,19,22,1839,1932,1986,54
2017,12,19,23,1849,1942,1962,20
2017,12,20,0,1922,2006,2070,64
2017,12,20,1,2067,2116,2055,-61
2017,12,20,2,2088,2121,1951,-170
2017,12,20,3,2046,2073,1935,-138
2017,12,20,4,2007,2032,2011,-21
2017,12,20,5,1911,1944,1941,-3
2017,12,20,6,1787,1806,2014,208
2017,12,20,7,1669,1671,1858,187
2017,12,20,8,1609,1598,1774,176
2017,12,20,9,1616,1556,1686,130
2017,12,20,10,1608,1532,1767,235
2017,12,20,11,1626,1547,1788,241
2017,12,20,12,1678,1607,1766,159
2017,12,20,13,1786,1721,1825,104
2017,12,20,14,2001,1919,1972,53
2017,12,20,15,2173,2079,2068,-11
2017,12,20,16,2204,2114,2092,-22
2017,12,20,17,2192,2090,2102,12
2017,12,20,18,2180,2022,2127,105
2017,12,20,19,2162,1928,2055,127
2017,12,20,20,2139,1889,2012,123
2017,12,20,21,2123,1829,1927,98
2017,12,20,22,2106,1817,1893,76
2017,12,20,23,2120,1854,1945,91
2017,12,21,0,2186,1982,2153,171
2017,12,21,1,2338,2155,2236,81
2017,12,21,2,2370,2212,2267,55
2017,12,21,3,2356,2196,2224,28
2017,12,21,4,2317,2169,2222,53
2017,12,21,5,2218,2111,2176,65
2017,12,21,6,2075,1984,2056,72
2017,12,21,7,1939,1861,1985,124
2017,12,21,8,1848,1787,1921,134
2017,12,21,9,1831,1758,1768,10
2017,12,21,10,1790,1746,1716,-30
2017,12,21,11,1795,1773,1720,-53
2017,12,21,12,1834,1829,1750,-79
2017,12,21,13,1942,1926,1863,-63
2017,12,21,14,2157,2135,2047,-88
2017,12,21,15,2320,2279,2151,-128
2017,12,21,16,2341,2297,2162,-135
2017,12,21,17,2313,2127,2038,-89
2017,12,21,18,2276,2012,2039,27
2017,12,21,19,2232,1964,2071,107
2017,12,21,20,2183,1909,2129,220
2017,12,21,21,2145,1864,2147,283
2017,12,21,22,2118,1803,1819,16
2017,12,21,23,2126,1802,1821,19
2017,12,22,0,2189,1981,2181,200
2017,12,22,1,2345,2165,2121,-44
2017,12,22,2,2382,2223,2093,-130
2017,12,22,3,2352,2204,2084,-120
2017,12,22,4,2318,2178,2072,-106
2017,12,22,5,2233,2106,1992,-114
2017,12,22,6,2092,1984,1899,-85
2017,12,22,7,1954,1858,1723,-135
2017,12,22,8,1866,1777,1638,-139
2017,12,22,9,1800,1738,1582,-156
2017,12,22,10,1754,1730,1544,-186
2017,12,22,11,1752,1741,1548,-193
2017,12,22,12,1788,1755,1536,-219
2017,12,22,13,1881,1849,1593,-256
2017,12,22,14,2064,1994,1659,-335
2017,12,22,15,2206,2121,1766,-355
2017,12,22,16,2218,2183,1790,-393
2017,12,22,17,2170,2177,1894,-283
2017,12,22,18,2101,2156,1893,-263
2017,12,22,19,2056,2087,1818,-269
2017,12,22,20,2009,2033,1811,-222
2017,12,22,21,1976,1998,1784,-214
2017,12,22,22,1954,1985,1782,-203
2017,12,22,23,1974,1998,1789,-209
2017,12,23,0,2053,2044,1804,-240
2017,12,23,1,2170,2146,1853,-293
2017,12,23,2,2172,2152,1870,-282
2017,12,23,3,2129,2115,1820,-295
2017,12,23,4,2088,2080,1917,-163
2017,12,23,5,2039,2021,1931,-90
2017,12,23,6,1953,1920,1791,-129
2017,12,23,7,1849,1812,1671,-141
2017,12,23,8,1782,1721,1580,-141
2017,12,23,9,1734,1668,1484,-184
2017,12,23,10,1690,1642,1506,-136
2017,12,23,11,1684,1633,1489,-144
2017,12,23,12,1701,1656,1573,-83
2017,12,23,13,1741,1691,1682,-9
2017,12,23,14,1804,1770,1718,-52
2017,12,23,15,1904,1866,1818,-48
2017,12,23,16,2006,1957,1961,4
2017,12,23,17,2055,2007,1966,-41
2017,12,23,18,2061,2005,2079,74
2017,12,23,19,2057,1958,2114,156
2017,12,23,20,2028,1861,2014,153
2017,12,23,21,1992,1780,2043,263
2017,12,23,22,1979,1723,2102,379
2017,12,23,23,1995,1704,2080,376
2017,12,24,0,2067,1868,2136,268
2017,12,24,1,2216,2058,2181,123
2017,12,24,2,2251,2139,2138,-1
2017,12,24,3,2239,2139,2188,49
2017,12,24,4,2219,2137,2162,25
2017,12,24,5,2176,2105,2166,61
2017,12,24,6,2095,2042,2135,93
2017,12,24,7,1998,1958,1908,-50
2017,12,24,8,1928,1881,1765,-116
2017,12,24,9,1886,1862,1740,-122
2017,12,24,10,1844,1872,1737,-135
2017,12,24,11,1834,1884,1778,-106
2017,12,24,12,1844,1927,1827,-100
2017,12,24,13,1874,1983,1868,-115
2017,12,24,14,1932,2075,1882,-193
2017,12,24,15,2017,2191,1848,-343
2017,12,24,16,2112,2293,1865,-428
2017,12,24,17,2148,2297,1940,-357
2017,12,24,18,2133,2255,1899,-356
2017,12,24,19,2096,2184,1870,-314
2017,12,24,20,2062,2125,1855,-270
2017,12,24,21,2026,2098,1833,-265
2017,12,24,22,2013,2092,1808,-284
2017,12,24,23,2025,2096,1810,-286
2017,12,25,0,2093,2126,1827,-299
2017,12,25,1,2235,2204,1930,-274
2017,12,25,2,2258,2181,1951,-230
2017,12,25,3,2233,2137,1900,-237
2017,12,25,4,2189,2111,1875,-236
2017,12,25,5,2105,2075,1837,-238
2017,12,25,6,1976,1998,1779,-219
2017,12,25,7,1861,1896,1666,-230
2017,12,25,8,1796,1811,1617,-194
2017,12,25,9,1783,1772,1548,-224
2017,12,25,10,1790,1761,1540,-221
2017,12,25,11,1793,1757,1534,-223
2017,12,25,12,1836,1770,1547,-223
2017,12,25,13,1945,1817,1598,-219
2017,12,25,14,2146,1885,1652,-233
2017,12,25,15,2291,1979,1825,-154
2017,12,25,16,2282,2030,1824,-206
2017,12,25,17,2253,2047,1831,-216
2017,12,25,18,2203,2015,1836,-179
2017,12,25,19,2155,1941,1844,-97
2017,12,25,20,2098,1877,1789,-88
2017,12,25,21,2050,1839,1782,-57
2017,12,25,22,2018,1779,1762,-17
2017,12,25,23,2012,1782,1747,-35
2017,12,26,0,2056,1859,1817,-42
2017,12,26,1,2174,1981,1911,-70
2017,12,26,2,2210,2029,1963,-66
2017,12,26,3,2189,2016,1971,-45
2017,12,26,4,2161,2001,1996,-5
2017,12,26,5,2093,1972,1990,18
2017,12,26,6,1986,1890,1886,-4
2017,12,26,7,1876,1801,1615,-186
2017,12,26,8,1801,1752,1545,-207
2017,12,26,9,1794,1733,1539,-194
2017,12,26,10,1765,1730,1532,-198
2017,12,26,11,1771,1750,1554,-196
2017,12,26,12,1810,1787,1593,-194
2017,12,26,13,1896,1861,1653,-208
2017,12,26,14,2037,1989,1755,-234
2017,12,26,15,2169,2085,1765,-320
2017,12,26,16,2177,2178,1823,-355
2017,12,26,17,2164,2196,1854,-342
2017,12,26,18,2125,2179,1847,-332
2017,12,26,19,2079,2133,1825,-308
2017,12,26,20,2019,2045,1796,-249
2017,12,26,21,1971,1970,1700,-270
2017,12,26,22,1934,1936,1695,-241
2017,12,26,23,1928,1927,1678,-249
2017,12,27,0,1974,2046,1742,-304
2017,12,27,1,2112,2229,1912,-317
2017,12,27,2,2167,2301,1999,-302
2017,12,27,3,2158,2265,1999,-266
2017,12,27,4,2136,2235,1962,-273
2017,12,27,5,2072,2150,1887,-263
2017,12,27,6,1973,2034,1773,-261
2017,12,27,7,1876,1902,1644,-258
2017,12,27,8,1812,1843,1606,-237
2017,12,27,9,1820,1801,1653,-148
2017,12,27,10,1822,1785,1661,-124
2017,12,27,11,1826,1787,1662,-125
2017,12,27,12,1852,1824,1676,-148
2017,12,27,13,1923,1908,1726,-182
2017,12,27,14,2052,2039,1828,-211
2017,12,27,15,2169,2160,1891,-269
2017,12,27,16,2193,2214,1923,-291
2017,12,27,17,2190,2209,1935,-274
2017,12,27,18,2149,2164,1963,-201
2017,12,27,19,2088,2092,1961,-131
2017,12,27,20,2016,2012,1892,-120
2017,12,27,21,1961,1965,1841,-124
2017,12,27,22,1919,1949,1795,-154
2017,12,27,23,1904,1979,1784,-195
2017,12,28,0,1952,2059,1817,-242
2017,12,28,1,2083,2193,1906,-287
2017,12,28,2,2125,2240,1967,-273
2017,12,28,3,2103,2200,1981,-219
2017,12,28,4,2076,2162,1959,-203
2017,12,28,5,2015,2084,1880,-204
2017,12,28,6,1918,1966,1761,-205
2017,12,28,7,1815,1861,1721,-140
2017,12,28,8,1740,1793,1708,-85
2017,12,28,9,1755,1759,1650,-109
2017,12,28,10,1791,1758,1629,-129
2017,12,28,11,1804,1774,1638,-136
2017,12,28,12,1836,1848,1721,-127
2017,12,28,13,1920,1936,1783,-153
2017,12,28,14,2041,2067,1834,-233
2017,12,28,15,2164,2204,1883,-321
2017,12,28,16,2209,2236,1886,-350
2017,12,28,17,2215,2205,1890,-315
2017,12,28,18,2167,2153,1924,-229
2017,12,28,19,2093,2056,1885,-171
2017,12,28,20,2032,1962,1893,-69
2017,12,28,21,1982,1892,1872,-20
2017,12,28,22,1951,1894,1862,-32
2017,12,28,23,1947,1919,1834,-85
2017,12,29,0,2007,2011,1955,-56
2017,12,29,1,2145,2169,2038,-131
2017,12,29,2,2189,2215,2036,-179
2017,12,29,3,2158,2175,2047,-128
2017,12,29,4,2122,2136,2021,-115
2017,12,29,5,2043,2044,1941,-103
2017,12,29,6,1931,1921,1828,-93
2017,12,29,7,1816,1791,1742,-49
2017,12,29,8,1705,1720,1652,-68
2017,12,29,9,1721,1668,1589,-79
2017,12,29,10,1690,1656,1570,-86
2017,12,29,11,1690,1645,1560,-85
2017,12,29,12,1719,1683,1600,-83
2017,12,29,13,1797,1770,1657,-113
2017,12,29,14,1908,1899,1777,-122
2017,12,29,15,2023,2027,1957,-70
2017,12,29,16,2073,2079,2014,-65
2017,12,29,17,2077,2042,1996,-46
2017,12,29,18,2046,1934,1920,-14
2017,12,29,19,1993,1880,1858,-22
2017,12,29,20,1936,1830,1823,-7
2017,12,29,21,1879,1797,1782,-15
2017,12,29,22,1856,1787,1764,-23
2017,12,29,23,1859,1818,1817,-1
2017,12,30,0,1922,1901,1854,-47
2017,12,30,1,2042,2055,1912,-143
2017,12,30,2,2056,2085,1946,-139
2017,12,30,3,2011,2063,1968,-95
2017,12,30,4,1983,2013,1931,-82
2017,12,30,5,1937,1948,1888,-60
2017,12,30,6,1863,1858,1816,-42
2017,12,30,7,1776,1732,1675,-57
2017,12,30,8,1701,1669,1600,-69
2017,12,30,9,1657,1614,1487,-127
2017,12,30,10,1621,1586,1446,-140
2017,12,30,11,1616,1578,1418,-160
2017,12,30,12,1629,1579,1441,-138
2017,12,30,13,1663,1619,1441,-178
2017,12,30,14,1691,1694,1528,-166
2017,12,30,15,1765,1794,1859,65
2017,12,30,16,1866,1867,2011,144
2017,12,30,17,1919,1865,2069,204
2017,12,30,18,1913,1805,2104,299
2017,12,30,19,1880,1738,2057,319
2017,12,30,20,1840,1683,2047,364
2017,12,30,21,1800,1637,2037,400
2017,12,30,22,1777,1582,1998,416
2017,12,30,23,1789,1604,1995,391
2017,12,31,0,1856,1715,2010,295
2017,12,31,1,2006,1930,2150,220
2017,12,31,2,2059,2007,2292,285
2017,12,31,3,2046,2002,2272,270
2017,12,31,4,2034,1979,2259,280
2017,12,31,5,1992,1945,2240,295
2017,12,31,6,1929,1870,2150,280
2017,12,31,7,1846,1783,1809,26
2017,12,31,8,1796,1727,1744,17
2017,12,31,9,1755,1696,1560,-136
2017,12,31,10,1735,1700,1514,-186
2017,12,31,11,1740,1726,1524,-202
2017,12,31,12,1755,1758,1563,-195
2017,12,31,13,1792,1815,1615,-200
2017,12,31,14,1833,1907,1743,-164
2017,12,31,15,1923,2004,1814,-190
2017,12,31,16,2031,2084,1867,-217
2017,12,31,17,2066,1988,1809,-179
2017,12,31,18,2031,1859,1663,-196
2017,12,31,19,1966,1808,1627,-181
2017,12,31,20,1926,1754,1575,-179
2017,12,31,21,1892,1672,1524,-148
2017,12,31,22,1875,1617,1455,-162
2017,12,31,23,1884,1614,1494,-120
2018,1,1,0,1946,1793,1674,-119
2018,1,1,1,2105,2017,1821,-196
2018,1,1,2,2165,2069,1839,-230
2018,1,1,3,2151,2033,1762,-271
2018,1,1,4,2131,2003,1907,-96
2018,1,1,5,2070,1958,1805,-153
2018,1,1,6,1962,1899,1758,-141
2018,1,1,7,1862,1856,1675,-181
2018,1,1,8,1796,1819,1646,-173
2018,1,1,9,1771,1791,1610,-181
2018,1,1,10,1803,1774,1579,-195
2018,1,1,11,1812,1773,1580,-193
2018,1,1,12,1858,1783,1603,-180
2018,1,1,13,1964,1829,1644,-185
2018,1,1,14,2140,1900,1705,-195
2018,1,1,15,2290,1950,1741,-209
2018,1,1,16,2341,1995,1782,-213
2018,1,1,17,2300,1975,1841,-134
2018,1,1,18,2231,1871,1753,-118
2018,1,1,19,2165,1828,1648,-180
2018,1,1,20,2103,1784,1599,-185
2018,1,1,21,2045,1695,1518,-177
2018,1,1,22,1998,1623,1452,-171
2018,1,1,23,1989,1598,1422,-176
2018,1,2,0,2055,1766,1558,-208
2018,1,2,1,2232,2003,1896,-107
2018,1,2,2,2324,2096,1928,-168
2018,1,2,3,2297,2092,1937,-155
2018,1,2,4,2256,2089,1920,-169
2018,1,2,5,2171,2027,1783,-244
2018,1,2,6,2057,1936,1695,-241
2018,1,2,7,1950,1829,1584,-245
2018,1,2,8,1860,1785,1541,-244
2018,1,2,9,1838,1765,1567,-198
2018,1,2,10,1789,1773,1588,-185
2018,1,2,11,1795,1803,1618,-185
2018,1,2,12,1833,1864,1684,-180
2018,1,2,13,1914,1978,1794,-184
2018,1,2,14,2052,2147,1934,-213
2018,1,2,15,2178,2284,2026,-258
2018,1,2,16,2182,2312,2108,-204
2018,1,2,17,2174,2179,2002,-177
2018,1,2,18,2130,2039,1971,-68
2018,1,2,19,2078,1973,1917,-56
2018,1,2,20,2014,1920,1872,-48
2018,1,2,21,1949,1857,1826,-31
2018,1,2,22,1901,1774,1746,-28
2018,1,2,23,1889,1765,1731,-34
2018,1,3,0,1953,1921,1785,-136
2018,1,3,1,2130,2140,1909,-231
2018,1,3,2,2216,2237,1912,-325
2018,1,3,3,2200,2210,1903,-307
2018,1,3,4,2176,2185,1956,-229
2018,1,3,5,2098,2115,1942,-173
2018,1,3,6,1991,2003,1894,-109
2018,1,3,7,1898,1897,1877,-20
2018,1,3,8,1863,1836,1848,12
2018,1,3,9,1826,1815,1875,60
2018,1,3,10,1834,1809,1864,55
2018,1,3,11,1846,1826,1870,44
2018,1,3,12,1884,1858,1913,55
2018,1,3,13,1975,1958,2000,42
2018,1,3,14,2124,2138,2112,-26
2018,1,3,15,2258,2288,2084,-204
2018,1,3,16,2274,2285,2029,-256
2018,1,3,17,2242,2156,1941,-215
2018,1,3,18,2177,2014,1804,-210
2018,1,3,19,2106,1978,1732,-246
2018,1,3,20,2029,1899,1635,-264
2018,1,3,21,1963,1856,1635,-221
2018,1,3,22,1916,1832,1619,-213
2018,1,3,23,1908,1815,1623,-192
2018,1,4,0,1976,1924,1679,-245
2018,1,4,1,2168,2130,1774,-356
2018,1,4,2,2251,2225,1799,-426
2018,1,4,3,2235,2210,1840,-370
2018,1,4,4,2202,2197,1889,-308
2018,1,4,5,2119,2108,1893,-215
2018,1,4,6,2004,1993,1905,-88
2018,1,4,7,1903,1888,1886,-2
2018,1,4,8,1830,1831,1823,-8
2018,1,4,9,1846,1810,1834,24
2018,1,4,10,1841,1822,1881,59
2018,1,4,11,1858,1834,1911,77
2018,1,4,12,1898,1888,1924,36
2018,1,4,13,1997,1998,2019,21
2018,1,4,14,2154,2181,2096,-85
2018,1,4,15,2280,2321,2135,-186
2018,1,4,16,2281,2329,2082,-247
2018,1,4,17,2224,2210,1968,-242
2018,1,4,18,2156,2128,1920,-208
2018,1,4,19,2091,2061,1890,-171
2018,1,4,20,2019,2005,1839,-166
2018,1,4,21,1961,1968,1825,-143
2018,1,4,22,1931,1923,1815,-108
2018,1,4,23,1925,1950,1763,-187
2018,1,5,0,1983,2007,1826,-181
2018,1,5,1,2149,2150,1848,-302
2018,1,5,2,2201,2091,1769,-322
2018,1,5,3,2176,2271,1993,-278
2018,1,5,4,2133,2122,1880,-242
2018,1,5,5,2049,2033,1825,-208
2018,1,5,6,1932,1906,1776,-130
2018,1,5,7,1838,1800,1744,-56
2018,1,5,8,1772,1733,1715,-18
2018,1,5,9,1791,1699,1710,11
2018,1,5,10,1761,1697,1762,65
2018,1,5,11,1782,1689,1790,101
2018,1,5,12,1823,1742,1823,81
2018,1,5,13,1921,1825,1911,86
2018,1,5,14,2081,2004,2070,66
2018,1,5,15,2204,2142,2158,16
2018,1,5,16,2217,2162,2165,3
2018,1,5,17,2167,2111,2113,2
2018,1,5,18,2102,2043,2098,55
2018,1,5,19,2052,1950,2000,50
2018,1,5,20,1994,1875,1945,70
2018,1,5,21,1960,1717,1797,80
2018,1,5,22,1932,1859,1938,79
2018,1,5,23,1931,1859,1970,111
2018,1,6,0,1978,1858,1997,139
2018,1,6,1,2109,2009,2138,129
2018,1,6,2,2133,2067,2254,187
2018,1,6,3,2082,2017,2212,195
2018,1,6,4,2031,1987,2162,175
2018,1,6,5,1962,1937,2117,180
2018,1,6,6,1870,1836,2009,173
2018,1,6,7,1775,1725,1858,133
2018,1,6,8,1716,1655,1791,136
2018,1,6,9,1688,1616,1781,165
2018,1,6,10,1646,1608,1800,192
2018,1,6,11,1652,1602,1784,182
2018,1,6,12,1674,1614,1750,136
2018,1,6,13,1725,1668,1774,106
2018,1,6,14,1794,1753,1848,95
2018,1,6,15,1892,1846,1996,150
2018,1,6,16,1981,1953,2083,130
2018,1,6,17,2008,1996,2114,118
2018,1,6,18,1985,1990,2093,103
2018,1,6,19,1937,1960,2097,137
2018,1,6,20,1880,1901,2084,183
2018,1,6,21,1845,1827,2017,190
2018,1,6,22,1815,1725,1923,198
2018,1,6,23,1824,1707,1892,185
2018,1,7,0,1880,1828,1997,169
2018,1,7,1,2026,1977,2120,143
2018,1,7,2,2080,2052,2217,165
2018,1,7,3,2050,2019,2164,145
2018,1,7,4,2015,1994,2122,128
2018,1,7,5,1956,1923,2069,146
2018,1,7,6,1880,1839,1994,155
2018,1,7,7,1794,1753,1918,165
2018,1,7,8,1732,1680,1829,149
2018,1,7,9,1688,1659,1742,83
2018,1,7,10,1669,1636,1700,64
2018,1,7,11,1673,1640,1770,130
2018,1,7,12,1692,1678,1837,159
2018,1,7,13,1734,1711,1836,125
2018,1,7,14,1793,1792,1906,114
2018,1,7,15,1883,1890,1978,88
2018,1,7,16,1972,1954,2039,85
2018,1,7,17,1986,1916,2014,98
2018,1,7,18,1962,1833,1931,98
2018,1,7,19,1917,1773,1880,107
2018,1,7,20,1882,1745,1880,135
2018,1,7,21,1845,1689,1824,135
2018,1,7,22,1814,1647,1758,111
2018,1,7,23,1820,1672,1781,109
2018,1,8,0,1882,1785,1902,117
2018,1,8,1,2024,1976,2099,123
2018,1,8,2,2083,2057,2169,112
2018,1,8,3,2054,2047,2180,133
2018,1,8,4,2022,2006,2095,89
2018,1,8,5,1963,1925,2016,91
2018,1,8,6,1870,1807,1929,122
2018,1,8,7,1780,1701,1792,91
2018,1,8,8,1711,1636,1778,142
2018,1,8,9,1676,1605,1726,121
2018,1,8,10,1644,1609,1776,167
2018,1,8,11,1655,1612,1763,151
2018,1,8,12,1696,1649,1775,126
2018,1,8,13,1789,1774,1848,74
2018,1,8,14,1943,1974,2043,69
2018,1,8,15,2065,2129,2221,92
2018,1,8,16,2166,2137,2230,93
2018,1,8,17,2132,2090,2256,166
2018,1,8,18,2096,2008,2233,225
2018,1,8,19,2052,1937,2187,250
2018,1,8,20,1995,1850,2124,274
2018,1,8,21,1946,1834,2078,244
2018,1,8,22,1900,1814,2078,264
2018,1,8,23,1897,1852,2054,202
2018,1,9,0,1945,1929,2108,179
2018,1,9,1,2073,2051,2228,177
2018,1,9,2,2143,2080,2285,205
2018,1,9,3,2113,2041,2284,243
2018,1,9,4,2064,1986,2210,224
2018,1,9,5,1969,1901,2141,240
2018,1,9,6,1835,1767,1995,228
2018,1,9,7,1719,1656,1903,247
2018,1,9,8,1671,1577,1934,357
2018,1,9,9,1627,1548,1835,287
2018,1,9,10,1586,1531,1799,268
2018,1,9,11,1607,1536,1765,229
2018,1,9,12,1647,1569,1818,249
2018,1,9,13,1754,1687,1894,207
2018,1,9,14,1937,1868,2001,133
2018,1,9,15,2074,2019,2092,73
2018,1,9,16,2055,1933,2043,110
2018,1,9,17,2022,2003,2011,8
2018,1,9,18,1987,1967,1988,21
2018,1,9,19,1944,1955,1984,29
2018,1,9,20,1899,1918,1937,19
2018,1,9,21,1866,1871,1854,-17
2018,1,9,22,1838,1850,1810,-40
2018,1,9,23,1843,1893,1770,-123
2018,1,10,0,1898,1936,1745,-191
2018,1,10,1,2014,2030,1740,-290
2018,1,10,2,2058,2058,1764,-294
2018,1,10,3,2019,2014,1760,-254
2018,1,10,4,1972,1959,1777,-182
2018,1,10,5,1896,1862,1713,-149
2018,1,10,6,1780,1746,1727,-19
2018,1,10,7,1674,1618,1733,115
2018,1,10,8,1642,1543,1771,228
2018,1,10,9,1605,1524,1907,383
2018,1,10,10,1568,1508,1951,443
2018,1,10,11,1599,1515,2004,489
2018,1,10,12,1660,1562,2003,441
2018,1,10,13,1786,1684,2064,380
2018,1,10,14,2003,1888,2070,182
2018,1,10,15,2157,2053,2199,146
2018,1,10,16,2168,2066,2221,155
2018,1,10,17,2143,1983,2153,170
2018,1,10,18,2112,1905,2081,176
2018,1,10,19,2075,1847,2099,252
2018,1,10,20,2034,1785,2093,308
2018,1,10,21,1999,1714,2038,324
2018,1,10,22,1969,1691,1993,302
2018,1,10,23,1968,1747,2002,255
2018,1,11,0,2017,1859,1984,125
2018,1,11,1,2132,2010,2045,35
2018,1,11,2,2180,2080,2054,-26
2018,1,11,3,2148,2073,2026,-47
2018,1,11,4,2097,2027,1987,-40
2018,1,11,5,2010,1946,1812,-134
2018,1,11,6,1880,1824,1704,-120
2018,1,11,7,1762,1697,1614,-83
2018,1,11,8,1705,1624,1556,-68
2018,1,11,9,1651,1602,1525,-77
2018,1,11,10,1624,1591,1539,-52
2018,1,11,11,1633,1588,1579,-9
2018,1,11,12,1673,1635,1592,-43
2018,1,11,13,1784,1748,1680,-68
2018,1,11,14,1982,1951,1864,-87
2018,1,11,15,2126,2074,1904,-170
2018,1,11,16,2126,2081,1919,-162
2018,1,11,17,2075,2063,1950,-113
2018,1,11,18,2030,2035,1930,-105
2018,1,11,19,1989,2008,1916,-92
2018,1,11,20,1950,1965,1893,-72
2018,1,11,21,1908,1955,1893,-62
2018,1,11,22,1877,1913,1862,-51
2018,1,11,23,1874,1916,1840,-76
2018,1,12,0,1921,1953,1839,-114
2018,1,12,1,2032,2059,1884,-175
2018,1,12,2,2074,2078,1865,-213
2018,1,12,3,2035,2036,1836,-200
2018,1,12,4,1981,1996,1811,-185
2018,1,12,5,1895,1895,1726,-169
2018,1,12,6,1768,1765,1790,25
2018,1,12,7,1656,1638,1783,145
2018,1,12,8,1586,1574,1827,253
2018,1,12,9,1577,1534,1787,253
2018,1,12,10,1575,1538,1778,240
2018,1,12,11,1590,1523,1780,257
2018,1,12,12,1634,1563,1762,199
2018,1,12,13,1750,1662,1781,119
2018,1,12,14,1952,1845,1854,9
2018,1,12,15,2099,1992,1917,-75
2018,1,12,16,2109,1995,1888,-107
2018,1,12,17,2075,1924,1832,-92
2018,1,12,18,2047,1847,1817,-30
2018,1,12,19,2013,1777,1839,62
2018,1,12,20,1976,1711,1828,117
2018,1,12,21,1947,1660,1774,114
2018,1,12,22,1923,1618,1669,51
2018,1,12,23,1923,1611,1718,107
2018,1,13,0,1969,1675,1777,102
2018,1,13,1,2064,1843,1781,-62
2018,1,13,2,2087,1921,1717,-204
2018,1,13,3,2053,1901,1679,-222
2018,1,13,4,2019,1875,1662,-213
2018,1,13,5,1957,1830,1649,-181
2018,1,13,6,1860,1752,1550,-202
2018,1,13,7,1760,1676,1504,-172
2018,1,13,8,1684,1616,1524,-92
2018,1,13,9,1627,1585,1537,-48
2018,1,13,10,1598,1589,1534,-55
2018,1,13,11,1601,1587,1537,-50
2018,1,13,12,1623,1612,1561,-51
2018,1,13,13,1687,1659,1528,-131
2018,1,13,14,1795,1743,1572,-171
2018,1,13,15,1911,1849,1612,-237
2018,1,13,16,1995,1919,1665,-254
2018,1,13,17,2012,1840,1644,-196
2018,1,13,18,1992,1717,1583,-134
2018,1,13,19,1942,1692,1616,-76
2018,1,13,20,1881,1631,1628,-3
2018,1,13,21,1827,1567,1559,-8
2018,1,13,22,1785,1498,1534,36
2018,1,13,23,1773,1465,1454,-11
2018,1,14,0,1804,1585,1516,-69
2018,1,14,1,1934,1775,1635,-140
2018,1,14,2,1998,1881,1676,-205
2018,1,14,3,1977,1868,1650,-218
2018,1,14,4,1950,1863,1617,-246
2018,1,14,5,1899,1819,1621,-198
2018,1,14,6,1825,1750,1594,-156
2018,1,14,7,1741,1674,1593,-81
2018,1,14,8,1677,1616,1600,-16
2018,1,14,9,1638,1598,1611,13
2018,1,14,10,1608,1599,1646,47
2018,1,14,11,1610,1616,1623,7
2018,1,14,12,1632,1628,1607,-21
2018,1,14,13,1688,1690,1617,-73
2018,1,14,14,1781,1754,1695,-59
2018,1,14,15,1884,1869,1790,-79
2018,1,14,16,1958,1920,1858,-62
2018,1,14,17,1954,1815,1779,-36
2018,1,14,18,1916,1710,1761,51
2018,1,14,19,1867,1672,1811,139
2018,1,14,20,1826,1619,1800,181
2018,1,14,21,1782,1573,1762,189
2018,1,14,22,1750,1502,1711,209
2018,1,14,23,1734,1493,1660,167
2018,1,15,0,1772,1636,1680,44
2018,1,15,1,1894,1844,1740,-104
2018,1,15,2,1956,1937,1809,-128
2018,1,15,3,1935,1931,1779,-152
2018,1,15,4,1907,1911,1810,-101
2018,1,15,5,1853,1851,1792,-59
2018,1,15,6,1761,1774,1737,-37
2018,1,15,7,1683,1680,1738,58
2018,1,15,8,1642,1626,1795,169
2018,1,15,9,1611,1609,1789,180
2018,1,15,10,1634,1604,1706,102
2018,1,15,11,1641,1624,1784,160
2018,1,15,12,1679,1672,1912,240
2018,1,15,13,1781,1786,1954,168
2018,1,15,14,1954,1941,1929,-12
2018,1,15,15,2090,2078,1921,-157
2018,1,15,16,2163,2104,1976,-128
2018,1,15,17,2118,1983,1942,-41
2018,1,15,18,2062,1855,1818,-37
2018,1,15,19,2008,1825,1792,-33
2018,1,15,20,1942,1768,1807,39
2018,1,15,21,1885,1726,1798,72
2018,1,15,22,1840,1722,1853,131
2018,1,15,23,1819,1755,1931,176
2018,1,16,0,1855,1826,2002,176
2018,1,16,1,1991,1986,2052,66
2018,1,16,2,2073,2068,2082,14
2018,1,16,3,2056,2048,2013,-35
2018,1,16,4,2021,2017,1979,-38
2018,1,16,5,1941,1923,1912,-11
2018,1,16,6,1825,1801,1885,84
2018,1,16,7,1722,1693,1800,107
2018,1,16,8,1649,1630,1855,225
2018,1,16,9,1644,1606,1923,317
2018,1,16,10,1646,1608,1934,326
2018,1,16,11,1658,1622,1928,306
2018,1,16,12,1703,1675,1944,269
2018,1,16,13,1809,1794,2018,224
2018,1,16,14,1990,1993,2005,12
2018,1,16,15,2134,2146,2052,-94
2018,1,16,16,2123,2129,2040,-89
2018,1,16,17,2083,2046,1924,-122
2018,1,16,18,2032,1997,1870,-127
2018,1,16,19,1980,1990,1761,-229
2018,1,16,20,1928,1904,1671,-233
2018,1,16,21,1886,1795,1655,-140
2018,1,16,22,1858,1710,1615,-95
2018,1,16,23,1852,1718,1664,-54
2018,1,17,0,1888,1840,1683,-157
2018,1,17,1,2015,2003,1714,-289
2018,1,17,2,2087,2053,1675,-378
2018,1,17,3,2064,2010,1626,-384
2018,1,17,4,2028,1978,1605,-373
2018,1,17,5,1946,1904,1713,-191
2018,1,17,6,1830,1790,1693,-97
2018,1,17,7,1729,1674,1633,-41
2018,1,17,8,1661,1624,1591,-33
2018,1,17,9,1642,1580,1624,44
2018,1,17,10,1623,1590,1633,43
2018,1,17,11,1638,1603,1635,32
2018,1,17,12,1683,1645,1646,1
2018,1,17,13,1792,1768,1682,-86
2018,1,17,14,1985,1967,1729,-238
2018,1,17,15,2130,2114,1899,-215
2018,1,17,16,2118,2111,1965,-146
2018,1,17,17,2072,1986,1946,-40
2018,1,17,18,2022,1938,1951,13
2018,1,17,19,1973,1878,2005,127
2018,1,17,20,1904,1838,1990,152
2018,1,17,21,1834,1795,2010,215
2018,1,17,22,1792,1736,1948,212
2018,1,17,23,1781,1748,2029,281
2018,1,18,0,1816,1845,2098,253
2018,1,18,1,1938,1984,2153,169
2018,1,18,2,2005,2067,2151,84
2018,1,18,3,1986,2036,2138,102
2018,1,18,4,1944,1993,2098,105
2018,1,18,5,1865,1913,2114,201
2018,1,18,6,1747,1795,2114,319
2018,1,18,7,1646,1675,2059,384
2018,1,18,8,1586,1593,1981,388
2018,1,18,9,1571,1572,1934,362
2018,1,18,10,1579,1545,1952,407
2018,1,18,11,1579,1550,1956,406
2018,1,18,12,1619,1595,2003,408
2018,1,18,13,1715,1699,2100,401
2018,1,18,14,1889,1901,2184,283
2018,1,18,15,2018,2044,2268,224
2018,1,18,16,1999,2034,2210,176
2018,1,18,17,1952,1988,2155,167
2018,1,18,18,1912,1932,2134,202
2018,1,18,19,1868,1899,2130,231
2018,1,18,20,1814,1833,2080,247
2018,1,18,21,1768,1816,2037,221
2018,1,18,22,1741,1792,2026,234
2018,1,18,23,1744,1822,1943,121
2018,1,19,0,1790,1885,1966,81
2018,1,19,1,1914,1974,1986,12
2018,1,19,2,1991,2016,1952,-64
2018,1,19,3,1970,1981,2027,46
2018,1,19,4,1927,1928,2125,197
2018,1,19,5,1848,1860,2157,297
2018,1,19,6,1733,1721,2099,378
2018,1,19,7,1634,1621,2043,422
2018,1,19,8,1564,1554,1887,333
2018,1,19,9,1564,1507,1615,108
2018,1,19,10,1552,1508,1689,181
2018,1,19,11,1565,1516,1685,169
2018,1,19,12,1611,1552,1669,117
2018,1,19,13,1724,1666,1653,-13
2018,1,19,14,1923,1842,1648,-194
2018,1,19,15,2076,1987,1745,-242
2018,1,19,16,2074,2010,1820,-190
2018,1,19,17,2055,1969,1903,-66
2018,1,19,18,2031,1922,1876,-46
2018,1,19,19,2001,1882,1839,-43
2018,1,19,20,1967,1822,1836,14
2018,1,19,21,1938,1743,1889,146
2018,1,19,22,1923,1695,1854,159
2018,1,19,23,1922,1683,1881,198
2018,1,20,0,1965,1762,1886,124
2018,1,20,1,2038,1921,1940,19
2018,1,20,2,2076,2010,1957,-53
2018,1,20,3,2043,1999,1922,-77
2018,1,20,4,2004,1973,1966,-7
2018,1,20,5,1946,1925,1936,11
2018,1,20,6,1853,1848,1893,45
2018,1,20,7,1760,1764,1916,152
2018,1,20,8,1695,1702,1895,193
2018,1,20,9,1657,1673,1799,126
2018,1,20,10,1667,1669,1817,148
2018,1,20,11,1667,1670,1826,156
2018,1,20,12,1689,1678,1824,146
2018,1,20,13,1747,1730,1750,20
2018,1,20,14,1841,1812,1762,-50
2018,1,20,15,1958,1924,1830,-94
2018,1,20,16,2038,1989,1836,-153
2018,1,20,17,2068,1925,1803,-122
2018,1,20,18,2050,1804,1792,-12
2018,1,20,19,2005,1767,1803,36
2018,1,20,20,1945,1697,1754,57
2018,1,20,21,1892,1625,1693,68
2018,1,20,22,1850,1579,1673,94
2018,1,20,23,1834,1546,1733,187
2018,1,21,0,1860,1679,1866,187
2018,1,21,1,1989,1889,2045,156
2018,1,21,2,2072,2000,2097,97
2018,1,21,3,2058,1967,2020,53
2018,1,21,4,2029,1951,2003,52
2018,1,21,5,1973,1901,1953,52
2018,1,21,6,1884,1828,1860,32
2018,1,21,7,1790,1741,1787,46
2018,1,21,8,1702,1687,1711,24
2018,1,21,9,1675,1648,1671,23
2018,1,21,10,1674,1661,1753,92
2018,1,21,11,1674,1678,1864,186
2018,1,21,12,1689,1704,1856,152
2018,1,21,13,1740,1764,1851,87
2018,1,21,14,1820,1836,1863,27
2018,1,21,15,1924,1952,1880,-72
2018,1,21,16,1996,2021,1990,-31
2018,1,21,17,1997,1887,1876,-11
2018,1,21,18,1956,1780,1833,53
2018,1,21,19,1900,1735,1827,92
2018,1,21,20,1861,1689,1861,172
2018,1,21,21,1821,1643,1816,173
2018,1,21,22,1800,1637,1783,146
2018,1,21,23,1790,1658,1794,136
2018,1,22,0,1832,1768,1820,52
2018,1,22,1,1957,1956,1815,-141
2018,1,22,2,2031,2036,1785,-251
2018,1,22,3,2000,2015,1747,-268
2018,1,22,4,1965,1969,1721,-248
2018,1,22,5,1900,1903,1770,-133
2018,1,22,6,1797,1780,1805,25
2018,1,22,7,1704,1681,1723,42
2018,1,22,8,1632,1628,1759,131
2018,1,22,9,1610,1600,1752,152
2018,1,22,10,1618,1604,1767,163
2018,1,22,11,1622,1607,1765,158
2018,1,22,12,1653,1646,1710,64
2018,1,22,13,1747,1777,1805,28
2018,1,22,14,1907,1979,1844,-135
2018,1,22,15,2034,2122,1807,-315
2018,1,22,16,2105,2136,1756,-380
2018,1,22,17,2070,2085,1635,-450
2018,1,22,18,2027,1996,1607,-389
2018,1,22,19,1988,1915,1646,-269
2018,1,22,20,1939,1850,1614,-236
2018,1,22,21,1901,1820,1609,-211
2018,1,22,22,1882,1781,1608,-173
2018,1,22,23,1881,1730,1585,-145
2018,1,23,0,1922,1827,1544,-283
2018,1,23,1,2044,2000,1618,-382
2018,1,23,2,2121,2102,1641,-461
2018,1,23,3,2105,2086,1630,-456
2018,1,23,4,2070,2057,1610,-447
2018,1,23,5,1996,1971,1588,-383
2018,1,23,6,1878,1854,1594,-260
2018,1,23,7,1765,1746,1591,-155
2018,1,23,8,1693,1689,1598,-91
2018,1,23,9,1689,1680,1592,-88
2018,1,23,10,1686,1685,1576,-109
2018,1,23,11,1698,1713,1570,-143
2018,1,23,12,1742,1754,1567,-187
2018,1,23,13,1861,1882,1628,-254
2018,1,23,14,2064,2100,1845,-255
2018,1,23,15,2220,2236,1955,-281
2018,1,23,16,2214,2220,1967,-253
2018,1,23,17,2163,2127,2005,-122
2018,1,23,18,2106,2038,1982,-56
2018,1,23,19,2047,1947,1842,-105
2018,1,23,20,1983,1828,1828,0
2018,1,23,21,1936,1805,1835,30
2018,1,23,22,1901,1817,1811,-6
2018,1,23,23,1888,1844,1879,35
2018,1,24,0,1923,1897,1946,49
2018,1,24,1,2044,2021,1977,-44
2018,1,24,2,2130,2118,2031,-87
2018,1,24,3,2104,2097,2000,-97
2018,1,24,4,2057,2054,2024,-30
2018,1,24,5,1959,1969,2022,53
2018,1,24,6,1832,1845,1979,134
2018,1,24,7,1714,1730,2009,279
2018,1,24,8,1647,1652,2003,351
2018,1,24,9,1621,1634,1990,356
2018,1,24,10,1646,1622,1978,356
2018,1,24,11,1648,1633,1975,342
2018,1,24,12,1685,1668,1961,293
2018,1,24,13,1797,1779,1979,200
2018,1,24,14,1978,1978,2029,51
2018,1,24,15,2112,2125,1951,-174
2018,1,24,16,2086,2103,1856,-247
2018,1,24,17,2044,2040,1797,-243
2018,1,24,18,2003,2009,1805,-204
2018,1,24,19,1956,1968,1842,-126
2018,1,24,20,1902,1915,1911,-4
2018,1,24,21,1858,1897,1979,82
2018,1,24,22,1844,1893,2016,123
2018,1,24,23,1848,1894,2063,169
2018,1,25,0,1887,1933,1962,29
2018,1,25,1,1994,2014,1993,-21
2018,1,25,2,2076,2088,2011,-77
2018,1,25,3,2046,2047,1950,-97
2018,1,25,4,2001,2008,1918,-90
2018,1,25,5,1913,1907,1908,1
2018,1,25,6,1797,1773,1886,113
2018,1,25,7,1682,1649,1811,162
2018,1,25,8,1602,1574,1798,224
2018,1,25,9,1600,1539,1636,97
2018,1,25,10,1579,1545,1666,121
2018,1,25,11,1594,1534,1631,97
2018,1,25,12,1642,1574,1629,55
2018,1,25,13,1760,1668,1509,-159
2018,1,25,14,1971,1867,1560,-307
2018,1,25,15,2125,2010,1522,-488
2018,1,25,16,2122,2016,1548,-468
2018,1,25,17,2092,1953,1494,-459
2018,1,25,18,2068,1838,1539,-299
2018,1,25,19,2036,1729,1455,-274
2018,1,25,20,2002,1723,1465,-258
2018,1,25,21,1976,1715,1564,-151
2018,1,25,22,1954,1692,1563,-129
2018,1,25,23,1953,1744,1747,3
2018,1,26,0,1989,1806,1707,-99
2018,1,26,1,2096,1937,1592,-345
2018,1,26,2,2181,2054,1635,-419
2018,1,26,3,2156,2051,1612,-439
2018,1,26,4,2121,2025,1586,-439
2018,1,26,5,2035,1949,1537,-412
2018,1,26,6,1907,1829,1451,-378
2018,1,26,7,1785,1722,1478,-244
2018,1,26,8,1730,1667,1494,-173
2018,1,26,9,1701,1647,1549,-98
2018,1,26,10,1675,1646,1550,-96
2018,1,26,11,1684,1653,1537,-116
2018,1,26,12,1721,1694,1571,-123
2018,1,26,13,1839,1805,1691,-114
2018,1,26,14,2042,1999,1754,-245
2018,1,26,15,2189,2147,1762,-385
2018,1,26,16,2180,2141,1783,-358
2018,1,26,17,2126,2053,1732,-321
2018,1,26,18,2077,1982,1670,-312
2018,1,26,19,2020,1938,1640,-298
2018,1,26,20,1978,1840,1638,-202
2018,1,26,21,1953,1809,1646,-163
2018,1,26,22,1929,1801,1641,-160
2018,1,26,23,1926,1828,1657,-171
2018,1,27,0,1958,1886,1701,-185
2018,1,27,1,2017,1979,1695,-284
2018,1,27,2,2099,2057,1675,-382
2018,1,27,3,2076,2037,1681,-356
2018,1,27,4,2048,2004,1688,-316
2018,1,27,5,1988,1944,1687,-257
2018,1,27,6,1897,1837,1663,-174
2018,1,27,7,1798,1744,1667,-77
2018,1,27,8,1740,1665,1645,-20
2018,1,27,9,1690,1637,1642,5
2018,1,27,10,1661,1615,1672,57
2018,1,27,11,1662,1612,1664,52
2018,1,27,12,1674,1625,1677,52
2018,1,27,13,1728,1689,1679,-10
2018,1,27,14,1822,1771,1695,-76
2018,1,27,15,1931,1864,1731,-133
2018,1,27,16,2007,1941,1780,-161
2018,1,27,17,2026,1991,1815,-176
2018,1,27,18,2009,2009,1808,-201
2018,1,27,19,1973,1979,1766,-213
2018,1,27,20,1919,1932,1736,-196
2018,1,27,21,1873,1885,1741,-144
2018,1,27,22,1833,1884,1739,-145
2018,1,27,23,1822,1889,1739,-150
2018,1,28,0,1849,1907,1663,-244
2018,1,28,1,1951,1984,1669,-315
2018,1,28,2,2034,2019,1699,-320
2018,1,28,3,1999,1982,1680,-302
2018,1,28,4,1963,1929,1688,-241
2018,1,28,5,1896,1860,1702,-158
2018,1,28,6,1808,1763,1679,-84
2018,1,28,7,1715,1661,1673,12
2018,1,28,8,1648,1585,1624,39
2018,1,28,9,1614,1561,1579,18
2018,1,28,10,1585,1531,1592,61
2018,1,28,11,1584,1533,1596,63
2018,1,28,12,1604,1554,1621,67
2018,1,28,13,1657,1600,1671,71
2018,1,28,14,1739,1666,1716,50
2018,1,28,15,1839,1761,1690,-71
2018,1,28,16,1904,1824,1758,-66
2018,1,28,17,1907,1783,1743,-40
2018,1,28,18,1881,1714,1704,-10
2018,1,28,19,1833,1648,1652,4
2018,1,28,20,1801,1613,1609,-4
2018,1,28,21,1772,1569,1572,3
2018,1,28,22,1763,1537,1524,-13
2018,1,28,23,1762,1546,1547,1
2018,1,29,0,1799,1588,1564,-24
2018,1,29,1,1892,1782,1698,-84
2018,1,29,2,1960,1892,1708,-184
2018,1,29,3,1929,1904,1728,-176
2018,1,29,4,1893,1858,1697,-161
2018,1,29,5,1832,1787,1629,-158
2018,1,29,6,1733,1667,1582,-85
2018,1,29,7,1642,1573,1600,27
2018,1,29,8,1599,1496,1567,71
2018,1,29,9,1582,1484,1566,82
2018,1,29,10,1537,1480,1550,70
2018,1,29,11,1546,1493,1616,123
2018,1,29,12,1585,1541,1632,91
2018,1,29,13,1696,1664,1702,38
2018,1,29,14,1878,1871,1804,-67
2018,1,29,15,2021,2012,1817,-195
2018,1,29,16,2077,2024,1820,-204
2018,1,29,17,2059,1977,1753,-224
2018,1,29,18,2033,1931,1774,-157
2018,1,29,19,1982,1867,1726,-141
2018,1,29,20,1920,1828,1722,-106
2018,1,29,21,1874,1808,1722,-86
2018,1,29,22,1840,1822,1715,-107
2018,1,29,23,1828,1793,1691,-102
2018,1,30,0,1846,1819,1679,-140
2018,1,30,1,1941,1924,1765,-159
2018,1,30,2,2015,1993,1795,-198
2018,1,30,3,1995,1975,1824,-151
2018,1,30,4,1959,1925,1885,-40
2018,1,30,5,1872,1830,1865,35
2018,1,30,6,1743,1702,1802,100
2018,1,30,7,1632,1590,1776,186
2018,1,30,8,1593,1519,1740,221
2018,1,30,9,1536,1522,1701,179
2018,1,30,10,1515,1475,1640,165
2018,1,30,11,1515,1481,1575,94
2018,1,30,12,1554,1506,1559,53
2018,1,30,13,1665,1610,1586,-24
2018,1,30,14,1858,1802,1649,-153
2018,1,30,15,1991,1942,1653,-289
2018,1,30,16,1968,1957,1638,-319
2018,1,30,17,1946,1921,1648,-273
2018,1,30,18,1926,1896,1711,-185
2018,1,30,19,1895,1833,1697,-136
2018,1,30,20,1856,1739,1678,-61
2018,1,30,21,1836,1615,1749,134
2018,1,30,22,1824,1583,1751,168
2018,1,30,23,1829,1594,1861,267
2018,1,31,0,1862,1696,1940,244
2018,1,31,1,1967,1836,1943,107
2018,1,31,2,2058,1935,1925,-10
2018,1,31,3,2045,1918,1956,38
2018,1,31,4,2017,1891,1961,70
2018,1,31,5,1935,1818,1951,133
2018,1,31,6,1813,1702,1927,225
2018,1,31,7,1706,1606,1874,268
2018,1,31,8,1650,1538,1846,308
2018,1,31,9,1622,1518,1764,246
2018,1,31,10,1592,1529,1722,193
2018,1,31,11,1604,1524,1706,182
2018,1,31,12,1655,1578,1686,108
2018,1,31,13,1778,1700,1692,-8
2018,1,31,14,1989,1893,1738,-155
2018,1,31,15,2143,2048,1827,-221
2018,1,31,16,2135,2016,1813,-203
2018,1,31,17,2101,1936,1741,-195
2018,1,31,18,2081,1834,1608,-226
2018,1,31,19,2043,1746,1327,-419
2018,1,31,20,1987,1678,1408,-270
2018,1,31,21,1951,1635,1562,-73
2018,1,31,22,1913,1665,1582,-83
2018,1,31,23,1900,1729,1634,-95
2018,2,1,0,1925,1795,1614,-181
2018,2,1,1,2019,1906,1563,-343
2018,2,1,2,2108,1981,1507,-474
2018,2,1,3,2088,1968,1479,-489
2018,2,1,4,2052,1926,1538,-388
2018,2,1,5,1965,1845,1562,-283
2018,2,1,6,1835,1722,1545,-177
2018,2,1,7,1729,1599,1476,-123
2018,2,1,8,1676,1499,1453,-46
2018,2,1,9,1629,1519,1468,-51
2018,2,1,10,1578,1516,1504,-12
2018,2,1,11,1582,1530,1453,-77
2018,2,1,12,1627,1574,1425,-149
2018,2,1,13,1748,1683,1415,-268
2018,2,1,14,1946,1885,1372,-513
2018,2,1,15,2085,2032,1466,-566
2018,2,1,16,2062,2034,1479,-555
2018,2,1,17,2020,1955,1440,-515
2018,2,1,18,1993,1889,1436,-453
2018,2,1,19,1951,1672,1278,-394
2018,2,1,20,1898,1674,1389,-285
2018,2,1,21,1865,1637,1387,-250
2018,2,1,22,1841,1627,1412,-215
2018,2,1,23,1836,1651,1486,-165
2018,2,2,0,1868,1703,1490,-213
2018,2,2,1,1945,1811,1411,-400
2018,2,2,2,2015,1900,1471,-429
2018,2,2,3,1988,1893,1477,-416
2018,2,2,4,1949,1854,1494,-360
2018,2,2,5,1865,1777,1469,-308
2018,2,2,6,1738,1657,1473,-184
2018,2,2,7,1628,1545,1459,-86
2018,2,2,8,1581,1484,1528,44
2018,2,2,9,1530,1456,1513,57
2018,2,2,10,1506,1443,1487,44
2018,2,2,11,1511,1447,1459,12
2018,2,2,12,1547,1483,1523,40
2018,2,2,13,1656,1567,1519,-48
2018,2,2,14,1839,1749,1523,-226
2018,2,2,15,1979,1887,1550,-337
2018,2,2,16,1964,1881,1539,-342
2018,2,2,17,1924,1823,1621,-202
2018,2,2,18,1897,1738,1632,-106
2018,2,2,19,1855,1643,1674,31
2018,2,2,20,1802,1553,1737,184
2018,2,2,21,1765,1519,1758,239
2018,2,2,22,1743,1501,1773,272
2018,2,2,23,1741,1534,1824,290
2018,2,3,0,1772,1623,1777,154
2018,2,3,1,1818,1706,1760,54
2018,2,3,2,1879,1767,1794,27
2018,2,3,3,1854,1734,1669,-65
2018,2,3,4,1822,1690,1638,-52
2018,2,3,5,1768,1654,1784,130
2018,2,3,6,1678,1569,1714,145
2018,2,3,7,1590,1491,1769,278
2018,2,3,8,1530,1435,1781,346
2018,2,3,9,1473,1403,1806,403
2018,2,3,10,1453,1410,1811,401
2018,2,3,11,1462,1416,1837,421
2018,2,3,12,1490,1439,1826,387
2018,2,3,13,1552,1488,1828,340
2018,2,3,14,1650,1561,1770,209
2018,2,3,15,1766,1668,1825,157
2018,2,3,16,1838,1711,1900,189
2018,2,3,17,1866,1686,1897,211
2018,2,3,18,1846,1613,1895,282
2018,2,3,19,1798,1514,1898,384
2018,2,3,20,1722,1467,1914,447
2018,2,3,21,1662,1448,1929,481
2018,2,3,22,1622,1403,1894,491
2018,2,3,23,1607,1450,1923,473
2018,2,4,0,1631,1508,1943,435
2018,2,4,1,1716,1633,1993,360
2018,2,4,2,1791,1718,1948,230
2018,2,4,3,1769,1713,1927,214
2018,2,4,4,1744,1666,1914,248
2018,2,4,5,1700,1623,1939,316
2018,2,4,6,1630,1542,1931,389
2018,2,4,7,1554,1470,1909,439
2018,2,4,8,1506,1406,1937,531
2018,2,4,9,1464,1374,1797,423
2018,2,4,10,1436,1354,1748,394
2018,2,4,11,1440,1351,1714,363
2018,2,4,12,1462,1361,1751,390
2018,2,4,13,1508,1401,1822,421
2018,2,4,14,1585,1464,1814,350
2018,2,4,15,1680,1551,1788,237
2018,2,4,16,1732,1621,1750,129
2018,2,4,17,1730,1629,1786,157
2018,2,4,18,1705,1586,1794,208
2018,2,4,19,1664,1550,1782,232
2018,2,4,20,1628,1522,1787,265
2018,2,4,21,1596,1472,1727,255
2018,2,4,22,1582,1515,1676,161
2018,2,4,23,1580,1580,1731,151
2018,2,5,0,1621,1568,1680,112
2018,2,5,1,1715,1581,1612,31
2018,2,5,2,1791,1647,1614,-33
2018,2,5,3,1766,1653,1586,-67
2018,2,5,4,1730,1634,1586,-48
2018,2,5,5,1665,1624,1760,136
2018,2,5,6,1563,1518,1802,284
2018,2,5,7,1481,1406,1749,343
2018,2,5,8,1429,1348,1808,460
2018,2,5,9,1385,1320,1665,345
2018,2,5,10,1382,1328,1632,304
2018,2,5,11,1393,1334,1648,314
2018,2,5,12,1440,1384,1762,378
2018,2,5,13,1550,1497,1819,322
2018,2,5,14,1739,1714,1848,134
2018,2,5,15,1887,1858,1878,20
2018,2,5,16,1944,1842,1837,-5
2018,2,5,17,1920,1709,1732,23
2018,2,5,18,1889,1609,1692,83
2018,2,5,19,1847,1619,1759,140
2018,2,5,20,1793,1618,1803,185
2018,2,5,21,1757,1591,1846,255
2018,2,5,22,1736,1562,1830,268
2018,2,5,23,1731,1562,1840,278
2018,2,6,0,1747,1609,1794,185
2018,2,6,1,1803,1736,1755,19
2018,2,6,2,1886,1864,1762,-102
2018,2,6,3,1886,1870,1762,-108
2018,2,6,4,1871,1843,1722,-121
2018,2,6,5,1819,1771,1692,-79
2018,2,6,6,1705,1658,1688,30
2018,2,6,7,1602,1556,1613,57
2018,2,6,8,1536,1518,1650,132
2018,2,6,9,1517,1498,1650,152
2018,2,6,10,1530,1503,1690,187
2018,2,6,11,1542,1510,1709,199
2018,2,6,12,1589,1554,1749,195
2018,2,6,13,1702,1677,1663,-14
2018,2,6,14,1910,1857,1760,-97
2018,2,6,15,2064,2006,1836,-170
2018,2,6,16,2048,1936,1787,-149
2018,2,6,17,2010,1797,1699,-98
2018,2,6,18,1972,1627,1633,6
2018,2,6,19,1933,1585,1637,52
2018,2,6,20,1882,1547,1734,187
2018,2,6,21,1840,1520,1732,212
2018,2,6,22,1810,1487,1728,241
2018,2,6,23,1794,1457,1691,234
2018,2,7,0,1804,1506,1668,162
2018,2,7,1,1864,1692,1734,42
2018,2,7,2,1959,1852,1735,-117
2018,2,7,3,1954,1885,1591,-294
2018,2,7,4,1931,1852,1576,-276
2018,2,7,5,1868,1782,1544,-238
2018,2,7,6,1749,1681,1566,-115
2018,2,7,7,1647,1581,1498,-83
2018,2,7,8,1574,1526,1467,-59
2018,2,7,9,1530,1497,1372,-125
2018,2,7,10,1537,1485,1325,-160
2018,2,7,11,1542,1504,1328,-176
2018,2,7,12,1583,1534,1314,-220
2018,2,7,13,1691,1650,1310,-340
2018,2,7,14,1889,1850,1327,-523
2018,2,7,15,2029,1986,1379,-607
2018,2,7,16,1994,1939,1378,-561
2018,2,7,17,1935,1754,1335,-419
2018,2,7,18,1882,1642,1341,-301
2018,2,7,19,1839,1601,1392,-209
2018,2,7,20,1792,1536,1471,-65
2018,2,7,21,1752,1489,1485,-4
2018,2,7,22,1721,1433,1546,113
2018,2,7,23,1702,1392,1537,145
2018,2,8,0,1711,1463,1466,3
2018,2,8,1,1765,1641,1501,-140
2018,2,8,2,1868,1778,1450,-328
2018,2,8,3,1871,1790,1374,-416
2018,2,8,4,1848,1766,1344,-422
2018,2,8,5,1769,1703,1300,-403
2018,2,8,6,1654,1574,1286,-288
2018,2,8,7,1558,1476,1312,-164
2018,2,8,8,1496,1419,1318,-101
2018,2,8,9,1451,1413,1330,-83
2018,2,8,10,1442,1405,1321,-84
2018,2,8,11,1449,1435,1361,-74
2018,2,8,12,1485,1471,1393,-78
2018,2,8,13,1586,1591,1405,-186
2018,2,8,14,1772,1786,1424,-362
2018,2,8,15,1909,1921,1442,-479
2018,2,8,16,1879,1896,1437,-459
2018,2,8,17,1821,1837,1424,-413
2018,2,8,18,1778,1779,1423,-356
2018,2,8,19,1736,1655,1415,-240
2018,2,8,20,1691,1605,1450,-155
2018,2,8,21,1656,1577,1477,-100
2018,2,8,22,1632,1570,1500,-70
2018,2,8,23,1616,1570,1483,-87
2018,2,9,0,1628,1621,1460,-161
2018,2,9,1,1681,1704,1454,-250
2018,2,9,2,1792,1791,1461,-330
2018,2,9,3,1790,1785,1459,-326
2018,2,9,4,1759,1755,1534,-221
2018,2,9,5,1682,1673,1539,-134
2018,2,9,6,1574,1561,1517,-44
2018,2,9,7,1482,1469,1661,192
2018,2,9,8,1433,1414,1707,293
2018,2,9,9,1415,1396,1723,327
2018,2,9,10,1430,1389,1736,347
2018,2,9,11,1446,1406,1802,396
2018,2,9,12,1497,1447,1869,422
2018,2,9,13,1619,1559,1820,261
2018,2,9,14,1826,1748,1806,58
2018,2,9,15,1974,1887,1807,-80
2018,2,9,16,1961,1862,1905,43
2018,2,9,17,1922,1730,1769,39
2018,2,9,18,1890,1623,1780,157
2018,2,9,19,1857,1559,1807,248
2018,2,9,20,1819,1499,1809,310
2018,2,9,21,1791,1516,1846,330
2018,2,9,22,1766,1519,1864,345
2018,2,9,23,1758,1549,1849,300
2018,2,10,0,1780,1591,1832,241
2018,2,10,1,1816,1711,1862,151
2018,2,10,2,1903,1781,1826,45
2018,2,10,3,1896,1795,1751,-44
2018,2,10,4,1865,1766,1745,-21
2018,2,10,5,1815,1728,1708,-20
2018,2,10,6,1734,1650,1673,23
2018,2,10,7,1660,1559,1647,88
2018,2,10,8,1597,1518,1684,166
2018,2,10,9,1559,1499,1668,169
2018,2,10,10,1540,1493,1650,157
2018,2,10,11,1552,1495,1686,191
2018,2,10,12,1590,1532,1678,146
2018,2,10,13,1664,1591,1697,106
2018,2,10,14,1791,1687,1799,112
2018,2,10,15,1912,1798,1797,-1
2018,2,10,16,1980,1817,1738,-79
2018,2,10,17,1995,1676,1622,-54
2018,2,10,18,1973,1583,1569,-14
2018,2,10,19,1935,1556,1637,81
2018,2,10,20,1879,1546,1699,153
2018,2,10,21,1825,1493,1727,234
2018,2,10,22,1782,1415,1727,312
2018,2,10,23,1758,1384,1700,316
2018,2,11,0,1764,1434,1650,216
2018,2,11,1,1839,1652,1719,67
2018,2,11,2,1943,1841,1826,-15
2018,2,11,3,1939,1857,1852,-5
2018,2,11,4,1916,1852,1812,-40
2018,2,11,5,1870,1815,1750,-65
2018,2,11,6,1792,1754,1751,-3
2018,2,11,7,1714,1677,1686,9
2018,2,11,8,1654,1620,1561,-59
2018,2,11,9,1600,1599,1549,-50
2018,2,11,10,1625,1601,1507,-94
2018,2,11,11,1616,1610,1403,-207
2018,2,11,12,1624,1626,1338,-288
2018,2,11,13,1669,1674,1299,-375
2018,2,11,14,1745,1739,1320,-419
2018,2,11,15,1836,1834,1368,-466
2018,2,11,16,1882,1872,1429,-443
2018,2,11,17,1865,1881,1473,-408
2018,2,11,18,1830,1840,1603,-237
2018,2,11,19,1790,1787,1597,-190
2018,2,11,20,1762,1762,1690,-72
2018,2,11,21,1729,1734,1712,-22
2018,2,11,22,1703,1740,1657,-83
2018,2,11,23,1692,1758,1515,-243
2018,2,12,0,1711,1809,1396,-413
2018,2,12,1,1785,1892,1396,-496
2018,2,12,2,1889,1960,1408,-552
2018,2,12,3,1885,1957,1451,-506
2018,2,12,4,1852,1916,1430,-486
2018,2,12,5,1798,1818,1357,-461
2018,2,12,6,1695,1709,1300,-409
2018,2,12,7,1613,1600,1326,-274
2018,2,12,8,1538,1539,1341,-198
2018,2,12,9,1536,1550,1385,-165
2018,2,12,10,1578,1555,1396,-159
2018,2,12,11,1586,1587,1396,-191
2018,2,12,12,1625,1615,1422,-193
2018,2,12,13,1740,1741,1490,-251
2018,2,12,14,1935,1939,1582,-357
2018,2,12,15,2077,2083,1579,-504
2018,2,12,16,2106,2058,1564,-494
2018,2,12,17,2074,1901,1460,-441
2018,2,12,18,2049,1833,1427,-406
2018,2,12,19,2017,1781,1422,-359
2018,2,12,20,1978,1714,1394,-320
2018,2,12,21,1940,1680,1377,-303
2018,2,12,22,1901,1642,1360,-282
2018,2,12,23,1881,1563,1291,-272
2018,2,13,0,1896,1600,1325,-275
2018,2,13,1,1969,1801,1445,-356
2018,2,13,2,2069,1984,1527,-457
2018,2,13,3,2070,2005,1473,-532
2018,2,13,4,2038,1994,1465,-529
2018,2,13,5,1953,1916,1458,-458
2018,2,13,6,1826,1785,1438,-347
2018,2,13,7,1720,1685,1418,-267
2018,2,13,8,1644,1626,1380,-246
2018,2,13,9,1642,1650,1358,-292
2018,2,13,10,1663,1660,1308,-352
2018,2,13,11,1671,1691,1305,-386
2018,2,13,12,1714,1749,1297,-452
2018,2,13,13,1832,1888,1371,-517
2018,2,13,14,2039,2101,1380,-721
2018,2,13,15,2183,2256,1360,-896
2018,2,13,16,2149,2141,1272,-869
2018,2,13,17,2092,1893,1239,-654
2018,2,13,18,2049,1773,1243,-530
2018,2,13,19,2003,1708,1262,-446
2018,2,13,20,1955,1655,1281,-374
2018,2,13,21,1915,1582,1285,-297
2018,2,13,22,1875,1523,1269,-254
2018,2,13,23,1851,1459,1272,-187
2018,2,14,0,1862,1499,1282,-217
2018,2,14,1,1930,1697,1285,-412
2018,2,14,2,2050,1903,1352,-551
2018,2,14,3,2069,1966,1411,-555
2018,2,14,4,2045,1955,1467,-488
2018,2,14,5,1954,1894,1481,-413
2018,2,14,6,1815,1767,1514,-253
2018,2,14,7,1702,1686,1551,-135
2018,2,14,8,1617,1620,1594,-26
2018,2,14,9,1597,1627,1633,6
2018,2,14,10,1630,1633,1665,32
2018,2,14,11,1626,1634,1640,6
2018,2,14,12,1657,1675,1657,-18
2018,2,14,13,1762,1800,1670,-130
2018,2,14,14,1937,1986,1678,-308
2018,2,14,15,2057,2108,1661,-447
2018,2,14,16,2008,2040,1616,-424
2018,2,14,17,1942,1930,1520,-410
2018,2,14,18,1893,1914,1442,-472
2018,2,14,19,1850,1891,1402,-489
2018,2,14,20,1813,1848,1465,-383
2018,2,14,21,1796,1837,1576,-261
2018,2,14,22,1775,1829,1669,-160
2018,2,14,23,1769,1868,1612,-256
2018,2,15,0,1796,1899,1436,-463
2018,2,15,1,1874,1949,1456,-493
2018,2,15,2,2002,2031,1451,-580
2018,2,15,3,2023,2014,1500,-514
2018,2,15,4,1990,1960,1528,-432
2018,2,15,5,1904,1890,1590,-300
2018,2,15,6,1783,1761,1613,-148
2018,2,15,7,1680,1662,1681,19
2018,2,15,8,1607,1626,1720,94
2018,2,15,9,1604,1534,1697,163
2018,2,15,10,1621,1627,1794,167
2018,2,15,11,1637,1598,1747,149
2018,2,15,12,1680,1643,1772,129
2018,2,15,13,1815,1754,1775,21
2018,2,15,14,2020,1955,1793,-162
2018,2,15,15,2155,2091,1793,-298
2018,2,15,16,2115,2042,1824,-218
2018,2,15,17,2056,1900,1832,-68
2018,2,15,18,2008,1751,1701,-50
2018,2,15,19,1956,1711,1819,108
2018,2,15,20,1906,1688,1865,177
2018,2,15,21,1870,1692,1855,163
2018,2,15,22,1837,1653,1809,156
2018,2,15,23,1825,1668,1834,166
2018,2,16,0,1845,1705,1775,70
2018,2,16,1,1900,1801,1726,-75
2018,2,16,2,2018,2034,1736,-298
2018,2,16,3,2034,1976,1632,-344
2018,2,16,4,2016,2035,1712,-323
2018,2,16,5,1948,1876,1618,-258
2018,2,16,6,1830,1859,1638,-221
2018,2,16,7,1726,1699,1446,-253
2018,2,16,8,1663,1632,1388,-244
2018,2,16,9,1632,1646,1375,-271
2018,2,16,10,1657,1647,1338,-309
2018,2,16,11,1668,1677,1351,-326
2018,2,16,12,1705,1710,1368,-342
2018,2,16,13,1832,1826,1407,-419
2018,2,16,14,2032,2018,1398,-620
2018,2,16,15,2169,2129,1412,-717
2018,2,16,16,2131,2097,1416,-681
2018,2,16,17,2068,2013,1358,-655
2018,2,16,18,2013,1977,1339,-638
2018,2,16,19,1968,1917,1372,-545
2018,2,16,20,1924,1785,1266,-519
2018,2,16,21,1886,1748,1283,-465
2018,2,16,22,1854,1706,1332,-374
2018,2,16,23,1838,1681,1351,-330
2018,2,17,0,1854,1707,1394,-313
2018,2,17,1,1882,1765,1362,-403
2018,2,17,2,1968,1971,1450,-521
2018,2,17,3,1970,1897,1407,-490
2018,2,17,4,1935,1923,1456,-467
2018,2,17,5,1876,1796,1441,-355
2018,2,17,6,1782,1783,1484,-299
2018,2,17,7,1689,1607,1400,-207
2018,2,17,8,1606,1626,1505,-121
2018,2,17,9,1591,1535,1438,-97
2018,2,17,10,1596,1612,1462,-150
2018,2,17,11,1602,1576,1395,-181
2018,2,17,12,1616,1586,1345,-241
2018,2,17,13,1679,1646,1378,-268
2018,2,17,14,1758,1728,1427,-301
2018,2,17,15,1850,1828,1439,-389
2018,2,17,16,1907,1840,1413,-427
2018,2,17,17,1916,1809,1435,-374
2018,2,17,18,1898,1720,1511,-209
2018,2,17,19,1858,1653,1464,-189
2018,2,17,20,1795,1654,1460,-194
2018,2,17,21,1743,1647,1530,-117
2018,2,17,22,1696,1652,1565,-87
2018,2,17,23,1675,1676,1582,-94
2018,2,18,0,1686,1698,1550,-148
2018,2,18,1,1751,1747,1441,-306
2018,2,18,2,1849,1810,1439,-371
2018,2,18,3,1840,1805,1468,-337
2018,2,18,4,1805,1756,1588,-168
2018,2,18,5,1739,1693,1599,-94
2018,2,18,6,1660,1581,1482,-99
2018,2,18,7,1574,1437,1559,122
2018,2,18,8,1505,1464,1690,226
2018,2,18,9,1484,1381,1631,250
2018,2,18,10,1471,1452,1743,291
2018,2,18,11,1486,1432,1676,244
2018,2,18,12,1517,1448,1706,258
2018,2,18,13,1576,1515,1761,246
2018,2,18,14,1661,1584,1766,182
2018,2,18,15,1759,1681,1699,18
2018,2,18,16,1826,1678,1680,2
2018,2,18,17,1849,1583,1655,72
2018,2,18,18,1863,1554,1615,61
2018,2,18,19,1847,1586,1632,46
2018,2,18,20,1845,1610,1710,100
2018,2,18,21,1828,1625,1670,45
2018,2,18,22,1819,1628,1709,81
2018,2,18,23,1817,1588,1663,75
2018,2,19,0,1854,1662,1643,-19
2018,2,19,1,1923,1779,1627,-152
2018,2,19,2,2016,1911,1568,-343
2018,2,19,3,2022,1929,1507,-422
2018,2,19,4,1993,1916,1452,-464
2018,2,19,5,1938,1854,1426,-428
2018,2,19,6,1833,1770,1450,-320
2018,2,19,7,1729,1683,1464,-219
2018,2,19,8,1668,1648,1437,-211
2018,2,19,9,1639,1629,1441,-188
2018,2,19,10,1635,1632,1503,-129
2018,2,19,11,1644,1670,1588,-82
2018,2,19,12,1689,1707,1570,-137
2018,2,19,13,1807,1815,1608,-207
2018,2,19,14,2004,1965,1733,-232
2018,2,19,15,2147,2080,1766,-314
2018,2,19,16,2166,2079,1756,-323
2018,2,19,17,2128,2009,1791,-218
2018,2,19,18,2100,1957,1865,-92
2018,2,19,19,2083,1883,1862,-21
2018,2,19,20,2057,1827,1838,11
2018,2,19,21,2021,1793,1851,58
2018,2,19,22,1986,1769,1867,98
2018,2,19,23,1979,1776,1887,111
2018,2,20,0,2010,1805,1909,104
2018,2,20,1,2093,1974,1844,-130
2018,2,20,2,2206,2271,1946,-325
2018,2,20,3,2224,2242,1919,-323
2018,2,20,4,2195,2285,1980,-305
2018,2,20,5,2111,2136,1882,-254
2018,2,20,6,1992,2086,1915,-171
2018,2,20,7,1877,1900,1828,-72
2018,2,20,8,1819,1937,1911,-26
2018,2,20,9,1804,1884,1824,-60
2018,2,20,10,1878,1897,1846,-51
2018,2,20,11,1877,1924,1835,-89
2018,2,20,12,1917,1980,1760,-220
2018,2,20,13,2032,2108,1793,-315
2018,2,20,14,2228,2319,1783,-536
2018,2,20,15,2372,2438,1770,-668
2018,2,20,16,2346,2305,1617,-688
2018,2,20,17,2326,2074,1578,-496
2018,2,20,18,2297,1807,1472,-335
2018,2,20,19,2268,2067,1731,-336
2018,2,20,20,2229,1676,1327,-349
2018,2,20,21,2181,1904,1609,-295
2018,2,20,22,2137,1661,1449,-212
2018,2,20,23,2123,1625,1409,-216
2018,2,21,0,2144,1643,1335,-308
2018,2,21,1,2215,1760,1321,-439
2018,2,21,2,2326,1978,1374,-604
2018,2,21,3,2339,1972,1387,-585
2018,2,21,4,2289,1916,1376,-540
2018,2,21,5,2180,1839,1354,-485
2018,2,21,6,2041,1690,1333,-357
2018,2,21,7,1921,1522,1308,-214
2018,2,21,8,1798,1623,1474,-149
2018,2,21,9,1823,1561,1461,-100
2018,2,21,10,1819,1662,1512,-150
2018,2,21,11,1821,1623,1504,-119
2018,2,21,12,1853,1599,1470,-129
2018,2,21,13,1960,1689,1450,-239
2018,2,21,14,2146,1891,1482,-409
2018,2,21,15,2271,2011,1525,-486
2018,2,21,16,2223,1929,1472,-457
2018,2,21,17,2163,1774,1460,-314
2018,2,21,18,2114,1672,1371,-301
2018,2,21,19,2072,1609,1375,-234
2018,2,21,20,2022,1529,1416,-113
2018,2,21,21,1975,1468,1373,-95
2018,2,21,22,1936,1443,1336,-107
2018,2,21,23,1921,1372,1234,-138
2018,2,22,0,1938,1451,1219,-232
2018,2,22,1,1998,1656,1200,-456
2018,2,22,2,2131,1787,1301,-486
2018,2,22,3,2175,1822,1351,-471
2018,2,22,4,2145,1789,1390,-399
2018,2,22,5,2058,1713,1418,-295
2018,2,22,6,1934,1662,1412,-250
2018,2,22,7,1828,1574,1434,-140
2018,2,22,8,1769,1513,1407,-106
2018,2,22,9,1748,1471,1375,-96
2018,2,22,10,1739,1542,1487,-55
2018,2,22,11,1750,1509,1476,-33
2018,2,22,12,1791,1551,1492,-59
2018,2,22,13,1902,1661,1541,-120
2018,2,22,14,2092,1859,1601,-258
2018,2,22,15,2212,1916,1646,-270
2018,2,22,16,2172,1885,1644,-241
2018,2,22,17,2131,1897,1703,-194
2018,2,22,18,2089,1695,1552,-143
2018,2,22,19,2053,1604,1492,-112
2018,2,22,20,2010,1509,1489,-20
2018,2,22,21,1972,1541,1555,14
2018,2,22,22,1931,1528,1561,33
2018,2,22,23,1915,1529,1677,148
2018,2,23,0,1944,1580,1669,89
2018,2,23,1,2021,1688,1613,-75
2018,2,23,2,2149,1823,1599,-224
2018,2,23,3,2180,1874,1546,-328
2018,2,23,4,2154,1862,1521,-341
2018,2,23,5,2079,1795,1498,-297
2018,2,23,6,1963,1684,1523,-161
2018,2,23,7,1864,1555,1457,-98
2018,2,23,8,1824,1583,1487,-96
2018,2,23,9,1818,1548,1514,-34
2018,2,23,10,1842,1561,1610,49
2018,2,23,11,1859,1584,1680,96
2018,2,23,12,1906,1647,1717,70
2018,2,23,13,2024,1770,1741,-29
2018,2,23,14,2230,1975,1780,-195
2018,2,23,15,2357,2109,1753,-356
2018,2,23,16,2318,1999,1682,-317
2018,2,23,17,2271,1804,1624,-180
2018,2,23,18,2212,1713,1593,-120
2018,2,23,19,2158,1694,1520,-174
2018,2,23,20,2101,1641,1498,-143
2018,2,23,21,2056,1585,1565,-20
2018,2,23,22,2012,1523,1610,87
2018,2,23,23,1983,1480,1591,111
2018,2,24,0,2006,1509,1593,84
2018,2,24,1,2051,1719,1653,-66
2018,2,24,2,2141,1825,1591,-234
2018,2,24,3,2155,1834,1480,-354
2018,2,24,4,2116,1803,1439,-364
2018,2,24,5,2059,1734,1415,-319
2018,2,24,6,1967,1645,1377,-268
2018,2,24,7,1883,1496,1313,-183
2018,2,24,8,1818,1515,1407,-108
2018,2,24,9,1807,1764,1683,-81
2018,2,24,10,1794,1759,1687,-72
2018,2,24,11,1791,1758,1679,-79
2018,2,24,12,1806,1772,1681,-91
2018,2,24,13,1848,1827,1672,-155
2018,2,24,14,1922,1914,1704,-210
2018,2,24,15,2002,2002,1690,-312
2018,2,24,16,2046,2054,1698,-356
2018,2,24,17,2056,2091,1751,-340
2018,2,24,18,2029,2086,1759,-327
2018,2,24,19,1971,2046,1793,-253
2018,2,24,20,1912,1964,1798,-166
2018,2,24,21,1857,1844,1650,-194
2018,2,24,22,1813,1816,1677,-139
2018,2,24,23,1794,1864,1719,-145
2018,2,25,0,1820,1812,1745,-67
2018,2,25,1,1906,1913,1826,-87
2018,2,25,2,2014,2012,1957,-55
2018,2,25,3,2034,2064,2030,-34
2018,2,25,4,2009,2035,2013,-22
2018,2,25,5,1956,1987,2032,45
2018,2,25,6,1893,1900,2064,164
2018,2,25,7,1818,1816,1995,179
2018,2,25,8,1769,1479,1702,223
2018,2,25,9,1778,1760,1952,192
2018,2,25,10,1791,1773,1877,104
2018,2,25,11,1793,1790,1821,31
2018,2,25,12,1815,1797,1737,-60
2018,2,25,13,1861,1845,1758,-87
2018,2,25,14,1930,1916,1779,-137
2018,2,25,15,2008,1987,1784,-203
2018,2,25,16,2047,2017,1812,-205
2018,2,25,17,2040,1980,1773,-207
2018,2,25,18,2006,1912,1745,-167
2018,2,25,19,1956,1878,1746,-132
2018,2,25,20,1925,1883,1747,-136
2018,2,25,21,1872,1852,1732,-120
2018,2,25,22,1839,1828,1724,-104
2018,2,25,23,1824,1831,1745,-86
2018,2,26,0,1839,1894,1790,-104
2018,2,26,1,1912,1983,1781,-202
2018,2,26,2,1995,2074,1732,-342
2018,2,26,3,2009,2094,1702,-392
2018,2,26,4,1968,2051,1672,-379
2018,2,26,5,1895,1936,1647,-289
2018,2,26,6,1783,1823,1690,-133
2018,2,26,7,1700,1706,1652,-54
2018,2,26,8,1638,1628,1646,18
2018,2,26,9,1626,1266,1327,61
2018,2,26,10,1663,1360,1433,73
2018,2,26,11,1676,1331,1385,54
2018,2,26,12,1714,1373,1412,39
2018,2,26,13,1822,1494,1399,-95
2018,2,26,14,2008,1687,1412,-275
2018,2,26,15,2129,1807,1394,-413
2018,2,26,16,2166,1795,1414,-381
2018,2,26,17,2136,1734,1486,-248
2018,2,26,18,2098,1723,1582,-141
2018,2,26,19,2067,1598,1584,-14
2018,2,26,20,2026,1532,1578,46
2018,2,26,21,1998,1530,1640,110
2018,2,26,22,1968,1464,1653,189
2018,2,26,23,1957,1441,1678,237
2018,2,27,0,1984,1508,1685,177
2018,2,27,1,2072,1628,1650,22
2018,2,27,2,2198,1891,1793,-98
2018,2,27,3,2248,1903,1752,-151
2018,2,27,4,2231,1871,1721,-150
2018,2,27,5,2147,1743,1627,-116
2018,2,27,6,2020,1722,1663,-59
2018,2,27,7,1915,1576,1513,-63
2018,2,27,8,1842,1527,1399,-128
2018,2,27,9,1840,1714,1549,-165
2018,2,27,10,1786,1793,1620,-173
2018,2,27,11,1813,1793,1572,-221
2018,2,27,12,1874,1837,1550,-287
2018,2,27,13,2012,1983,1583,-400
2018,2,27,14,2233,2186,1538,-648
2018,2,27,15,2380,2308,1535,-773
2018,2,27,16,2333,2145,1529,-616
2018,2,27,17,2288,1861,1412,-449
2018,2,27,18,2229,1825,1404,-421
2018,2,27,19,2164,1780,1419,-361
2018,2,27,20,2100,1721,1431,-290
2018,2,27,21,2059,1696,1412,-284
2018,2,27,22,2012,1665,1414,-251
2018,2,27,23,1986,1650,1430,-220
2018,2,28,0,1997,1670,1447,-223
2018,2,28,1,2062,1778,1410,-368
2018,2,28,2,2178,2085,1552,-533
2018,2,28,3,2235,2066,1531,-535
2018,2,28,4,2211,2150,1623,-527
2018,2,28,5,2131,1979,1503,-476
2018,2,28,6,2001,1955,1555,-400
2018,2,28,7,1896,1603,1276,-327
2018,2,28,8,1851,1540,1272,-268
2018,2,28,9,1818,1711,1429,-282
2018,2,28,10,1794,1794,1490,-304
2018,2,28,11,1814,1777,1445,-332
2018,2,28,12,1864,1825,1426,-399
2018,2,28,13,1979,1936,1501,-435
2018,2,28,14,2171,2134,1468,-666
2018,2,28,15,2292,2253,1561,-692
2018,2,28,16,2235,2152,1494,-658
2018,2,28,17,2165,1998,1471,-527
2018,2,28,18,2096,1896,1555,-341
2018,2,28,19,2031,1790,1600,-190
2018,2,28,20,1974,1717,1601,-116
2018,2,28,21,1939,1681,1631,-50
2018,2,28,22,1901,1660,1611,-49
2018,2,28,23,1887,1678,1629,-49
2018,3,1,0,1900,1778,1731,-47
2018,3,1,1,1964,1670,1538,-132
2018,3,1,2,2090,2208,1943,-265
2018,3,1,3,2143,2033,1756,-277
2018,3,1,4,2101,2100,1887,-213
2018,3,1,5,2004,1928,1808,-120
2018,3,1,6,1865,1890,1729,-161
2018,3,1,7,1763,1670,1584,-86
2018,3,1,8,1715,1684,1699,15
2018,3,1,9,1672,1635,1711,76
2018,3,1,10,1678,1629,1646,17
2018,3,1,11,1691,1647,1575,-72
2018,3,1,12,1730,1682,1632,-50
2018,3,1,13,1828,1804,1696,-108
2018,3,1,14,2006,1990,1750,-240
2018,3,1,15,2103,2120,1736,-384
2018,3,1,16,2046,2100,1697,-403
2018,3,1,17,1976,2072,1733,-339
2018,3,1,18,1913,2020,1757,-263
2018,3,1,19,1854,1901,1814,-87
2018,3,1,20,1797,1813,1814,1
2018,3,1,21,1754,1848,1814,-34
2018,3,1,22,1719,1845,1876,31
2018,3,1,23,1704,1720,1846,126
2018,3,2,0,1724,1825,1874,49
2018,3,2,1,1771,1924,1859,-65
2018,3,2,2,1880,1984,1827,-157
2018,3,2,3,1938,2007,1867,-140
2018,3,2,4,1910,1971,1842,-129
2018,3,2,5,1834,1881,1715,-166
2018,3,2,6,1718,1768,1618,-150
2018,3,2,7,1622,1575,1553,-22
2018,3,2,8,1625,1598,1516,-82
2018,3,2,9,1605,1492,1387,-105
2018,3,2,10,1612,1566,1509,-57
2018,3,2,11,1638,1525,1428,-97
2018,3,2,12,1694,1567,1466,-101
2018,3,2,13,1803,1664,1495,-169
2018,3,2,14,1992,1870,1576,-294
2018,3,2,15,2115,1974,1572,-402
2018,3,2,16,2097,1951,1464,-487
2018,3,2,17,2072,1915,1534,-381
2018,3,2,18,2041,1795,1536,-259
2018,3,2,19,1998,1681,1337,-344
2018,3,2,20,1959,1608,1287,-321
2018,3,2,21,1940,1566,1259,-307
2018,3,2,22,1923,1532,1286,-246
2018,3,2,23,1902,1553,1263,-290
2018,3,3,0,1931,1630,1308,-322
2018,3,3,1,1966,1689,1257,-432
2018,3,3,2,2048,1907,1438,-469
2018,3,3,3,2092,1870,1418,-452
2018,3,3,4,2067,1942,1547,-395
2018,3,3,5,2012,1833,1445,-388
2018,3,3,6,1918,1742,1406,-336
2018,3,3,7,1822,1607,1363,-244
2018,3,3,8,1746,1657,1468,-189
2018,3,3,9,1701,1556,1325,-231
2018,3,3,10,1643,1648,1509,-139
2018,3,3,11,1653,1619,1478,-141
2018,3,3,12,1677,1649,1550,-99
2018,3,3,13,1728,1701,1480,-221
2018,3,3,14,1814,1795,1474,-321
2018,3,3,15,1908,1873,1466,-407
2018,3,3,16,1982,1907,1398,-509
2018,3,3,17,2018,1920,1449,-471
2018,3,3,18,2003,1887,1506,-381
2018,3,3,19,1964,1816,1474,-342
2018,3,3,20,1907,1708,1384,-324
2018,3,3,21,1858,1661,1349,-312
2018,3,3,22,1823,1616,1296,-320
2018,3,3,23,1796,1592,1209,-383
2018,3,4,0,1808,1570,1209,-361
2018,3,4,1,1885,1636,1179,-457
2018,3,4,2,1979,1873,1392,-481
2018,3,4,3,2017,1866,1333,-533
2018,3,4,4,2000,1943,1420,-523
2018,3,4,5,1953,1816,1329,-487
2018,3,4,6,1867,1826,1362,-464
2018,3,4,7,1778,1693,1242,-451
2018,3,4,8,1739,1626,1241,-385
2018,3,4,9,1685,1578,1241,-337
2018,3,4,10,1658,1669,1390,-279
2018,3,4,11,1671,1644,1517,-127
2018,3,4,12,1697,1672,1560,-112
2018,3,4,13,1740,1725,1587,-138
2018,3,4,14,1814,1804,1652,-152
2018,3,4,15,1901,1883,1649,-234
2018,3,4,16,1965,1880,1611,-269
2018,3,4,17,1973,1811,1612,-199
2018,3,4,18,1944,1692,1581,-111
2018,3,4,19,1904,1583,1486,-97
2018,3,4,20,1872,1588,1465,-123
2018,3,4,21,1830,1531,1491,-40
2018,3,4,22,1796,1512,1495,-17
2018,3,4,23,1767,1477,1493,16
2018,3,5,0,1784,1512,1514,2
2018,3,5,1,1846,1647,1473,-174
2018,3,5,2,1938,1824,1497,-327
2018,3,5,3,1992,1887,1574,-313
2018,3,5,4,1969,1978,1612,-366
2018,3,5,5,1913,1835,1489,-346
2018,3,5,6,1806,1816,1554,-262
2018,3,5,7,1721,1635,1410,-225
2018,3,5,8,1686,1653,1464,-189
2018,3,5,9,1649,1593,1331,-262
2018,3,5,10,1658,1603,1278,-325
2018,3,5,11,1678,1623,1331,-292
2018,3,5,12,1726,1675,1236,-439
2018,3,5,13,1831,1804,1156,-648
2018,3,5,14,2017,2021,1354,-667
2018,3,5,15,2134,2139,1370,-769
2018,3,5,16,2146,2002,1251,-751
2018,3,5,17,2084,1794,1170,-624
2018,3,5,18,2020,1685,1231,-454
2018,3,5,19,1952,1626,1280,-346
2018,3,5,20,1890,1575,1335,-240
2018,3,5,21,1854,1538,1367,-171
2018,3,5,22,1813,1473,1339,-134
2018,3,5,23,1788,1462,1303,-159
2018,3,6,0,1804,1470,1307,-163
2018,3,6,1,1869,1628,1297,-331
2018,3,6,2,1981,1837,1323,-514
2018,3,6,3,2060,1950,1359,-591
2018,3,6,4,2050,1940,1340,-600
2018,3,6,5,1975,1879,1324,-555
2018,3,6,6,1851,1778,1281,-497
2018,3,6,7,1748,1669,1271,-398
2018,3,6,8,1692,1627,1278,-349
2018,3,6,9,1660,1620,1294,-326
2018,3,6,10,1654,1624,1319,-305
2018,3,6,11,1672,1650,1318,-332
2018,3,6,12,1725,1702,1306,-396
2018,3,6,13,1844,1834,1400,-434
2018,3,6,14,2048,2057,1549,-508
2018,3,6,15,2176,2155,1597,-558
2018,3,6,16,2116,1910,1431,-479
2018,3,6,17,2046,1723,1422,-301
2018,3,6,18,1978,1648,1423,-225
2018,3,6,19,1911,1579,1591,12
2018,3,6,20,1846,1529,1661,132
2018,3,6,21,1801,1484,1643,159
2018,3,6,22,1753,1437,1652,215
2018,3,6,23,1729,1382,1547,165
2018,3,7,0,1733,1401,1549,148
2018,3,7,1,1790,1572,1572,0
2018,3,7,2,1901,1802,1595,-207
2018,3,7,3,2001,1918,1704,-214
2018,3,7,4,1992,1914,1684,-230
2018,3,7,5,1921,1855,1641,-214
2018,3,7,6,1800,1741,1561,-180
2018,3,7,7,1707,1655,1587,-68
2018,3,7,8,1663,1569,1510,-59
2018,3,7,9,1645,1595,1570,-25
2018,3,7,10,1650,1612,1622,10
2018,3,7,11,1673,1640,1602,-38
2018,3,7,12,1727,1691,1635,-56
2018,3,7,13,1852,1814,1701,-113
2018,3,7,14,2060,2043,1773,-270
2018,3,7,15,2182,2136,1710,-426
2018,3,7,16,2113,1920,1575,-345
2018,3,7,17,2038,1767,1575,-192
2018,3,7,18,1966,1631,1571,-60
2018,3,7,19,1891,1587,1612,25
2018,3,7,20,1828,1540,1569,29
2018,3,7,21,1782,1495,1618,123
2018,3,7,22,1730,1462,1649,187
2018,3,7,23,1702,1513,1759,246
2018,3,8,0,1708,1633,1778,145
2018,3,8,1,1765,1717,1745,28
2018,3,8,2,1882,1826,1644,-182
2018,3,8,3,1990,1903,1679,-224
2018,3,8,4,1974,1885,1693,-192
2018,3,8,5,1902,1819,1627,-192
2018,3,8,6,1794,1695,1582,-113
2018,3,8,7,1700,1585,1547,-38
2018,3,8,8,1638,1542,1535,-7
2018,3,8,9,1610,1518,1555,37
2018,3,8,10,1575,1532,1655,123
2018,3,8,11,1589,1529,1641,112
2018,3,8,12,1634,1582,1613,31
2018,3,8,13,1749,1688,1692,4
2018,3,8,14,1939,1890,1782,-108
2018,3,8,15,2037,2001,1739,-262
2018,3,8,16,1966,1959,1745,-214
2018,3,8,17,1890,1910,1758,-152
2018,3,8,18,1828,1835,1786,-49
2018,3,8,19,1769,1710,1664,-46
2018,3,8,20,1715,1617,1597,-20
2018,3,8,21,1677,1534,1517,-17
2018,3,8,22,1647,1447,1359,-88
2018,3,8,23,1643,1476,1335,-141
2018,3,9,0,1654,1524,1327,-197
2018,3,9,1,1702,1702,1505,-197
2018,3,9,2,1790,1756,1415,-341
2018,3,9,3,1874,1806,1436,-370
2018,3,9,4,1843,1791,1442,-349
2018,3,9,5,1778,1706,1385,-321
2018,3,9,6,1652,1602,1353,-249
2018,3,9,7,1561,1497,1306,-191
2018,3,9,8,1523,1433,1320,-113
2018,3,9,9,1498,1413,1343,-70
2018,3,9,10,1474,1403,1315,-88
2018,3,9,11,1486,1409,1301,-108
2018,3,9,12,1532,1453,1357,-96
2018,3,9,13,1645,1557,1439,-118
2018,3,9,14,1838,1740,1398,-342
2018,3,9,15,1949,1868,1467,-401
2018,3,9,16,1906,1848,1449,-399
2018,3,9,17,1860,1808,1439,-369
2018,3,9,18,1830,1746,1451,-295
2018,3,9,19,1784,1673,1453,-220
2018,3,9,20,1748,1547,1355,-192
2018,3,9,21,1718,1458,1242,-216
2018,3,9,22,1688,1442,1226,-216
2018,3,9,23,1681,1483,1287,-196
2018,3,10,0,1695,1535,1421,-114
2018,3,10,1,1713,1579,1453,-126
2018,3,10,2,1776,1671,1471,-200
2018,3,10,3,1832,1741,1516,-225
2018,3,10,4,1801,1716,1448,-268
2018,3,10,5,1756,1669,1418,-251
2018,3,10,6,1681,1608,1437,-171
2018,3,10,7,1601,1529,1460,-69
2018,3,10,8,1547,1479,1416,-63
2018,3,10,9,1519,1450,1344,-106
2018,3,10,10,1503,1457,1335,-122
2018,3,10,11,1513,1464,1326,-138
2018,3,10,12,1547,1500,1316,-184
2018,3,10,13,1611,1577,1362,-215
2018,3,10,14,1713,1684,1400,-284
2018,3,10,15,1807,1738,1425,-313
2018,3,10,16,1862,1592,1386,-206
2018,3,10,17,1883,1504,1359,-145
2018,3,10,18,1871,1401,1271,-130
2018,3,10,19,1821,1444,1376,-68
2018,3,10,20,1753,1293,1285,-8
2018,3,10,21,1688,1330,1413,83
2018,3,10,22,1640,1187,1294,107
2018,3,10,23,1623,1274,1441,167
2018,3,11,0,1619,1256,1422,166
2018,3,11,1,1662,1535,1649,114
2018,3,11,2,1736,1552,1622,70
2018,3,11,3,1801,1716,1665,-51
2018,3,11,4,1786,1650,1621,-29
2018,3,11,5,1745,1613,1588,-25
2018,3,11,6,1677,1542,1499,-43
2018,3,11,7,1604,1466,1501,35
2018,3,11,8,1551,1411,1467,56
2018,3,11,9,1512,1401,1469,68
2018,3,11,10,1513,1384,1461,77
2018,3,11,11,1540,1399,1501,102
2018,3,11,12,1596,1432,1501,69
2018,3,11,13,1680,1495,1513,18
2018,3,11,14,1764,1586,1538,-48
2018,3,11,15,1824,1651,1517,-134
2018,3,11,16,1823,1608,1439,-169
2018,3,11,17,1793,1535,1339,-196
2018,3,11,18,1740,1427,1287,-140
2018,3,11,19,1700,1347,1237,-110
2018,3,11,20,1648,1389,1333,-56
2018,3,11,21,1608,1257,1219,-38
2018,3,11,22,1592,1300,1292,-8
2018,3,11,23,1591,1262,1317,55
2018,3,12,0,1625,1309,1372,63
2018,3,12,1,1681,1377,1316,-61
2018,3,12,2,1728,1638,1442,-196
2018,3,12,3,1713,1696,1391,-305
2018,3,12,4,1667,1665,1388,-277
2018,3,12,5,1589,1582,1386,-196
2018,3,12,6,1514,1463,1382,-81
2018,3,12,7,-9999,1377,1385,8
2018,3,12,8,1466,1377,1385,8
2018,3,12,9,1448,1387,1378,-9
2018,3,12,10,1474,1415,1378,-37
2018,3,12,11,1528,1465,1432,-33
2018,3,12,12,1645,1584,1530,-54
2018,3,12,13,1839,1816,1593,-223
2018,3,12,14,1964,1991,1588,-403
2018,3,12,15,1973,1948,1529,-419
2018,3,12,16,1922,1712,1433,-279
2018,3,12,17,1863,1584,1430,-154
2018,3,12,18,1792,1498,1461,-37
2018,3,12,19,1722,1448,1437,-11
2018,3,12,20,1664,1405,1462,57
2018,3,12,21,1613,1317,1488,171
2018,3,12,22,1592,1378,1606,228
2018,3,12,23,1586,1305,1576,271
2018,3,13,0,1615,1310,1619,309
2018,3,13,1,1680,1434,1671,237
2018,3,13,2,1743,1637,1771,134
2018,3,13,3,1730,1727,1820,93
2018,3,13,4,1674,1690,1798,108
2018,3,13,5,1577,1582,1750,168
2018,3,13,6,1496,1468,1690,222
2018,3,13,7,1473,1389,1642,253
2018,3,13,8,1430,1377,1541,164
2018,3,13,9,1444,1375,1531,156
2018,3,13,10,1466,1389,1593,204
2018,3,13,11,1514,1440,1658,218
2018,3,13,12,1632,1545,1704,159
2018,3,13,13,1834,1776,1802,26
2018,3,13,14,1968,1947,1866,-81
2018,3,13,15,1937,1705,1704,-1
2018,3,13,16,1879,1864,1905,41
2018,3,13,17,1824,1331,1467,136
2018,3,13,18,1761,1930,2196,266
2018,3,13,19,1678,1464,1816,352
2018,3,13,20,1620,1357,1671,314
2018,3,13,21,1574,1411,1805,394
2018,3,13,22,1556,1399,1841,442
2018,3,13,23,1546,1420,1850,430
2018,3,14,0,1568,1496,1871,375
2018,3,14,1,1624,1550,1838,288
2018,3,14,2,1689,1638,1860,222
2018,3,14,3,1702,1706,1889,183
2018,3,14,4,1643,1649,1864,215
2018,3,14,5,1540,1524,1821,297
2018,3,14,6,1440,1391,1668,277
2018,3,14,7,1378,1322,1578,256
2018,3,14,8,1325,1277,1518,241
2018,3,14,9,1327,1264,1515,251
2018,3,14,10,1345,1265,1402,137
2018,3,14,11,1390,1312,1375,63
2018,3,14,12,1496,1401,1436,35
2018,3,14,13,1687,1600,1565,-35
2018,3,14,14,1821,1748,1577,-171
2018,3,14,15,1794,1782,1597,-185
2018,3,14,16,1760,1799,1571,-228
2018,3,14,17,1744,1760,1550,-210
2018,3,14,18,1734,1728,1448,-280
2018,3,14,19,1711,1678,1440,-238
2018,3,14,20,1702,1651,1483,-168
2018,3,14,21,1686,1612,1497,-115
2018,3,14,22,1686,1613,1458,-155
2018,3,14,23,1692,1658,1501,-157
2018,3,15,0,1721,1701,1535,-166
2018,3,15,1,1770,1736,1545,-191
2018,3,15,2,1827,1797,1588,-209
2018,3,15,3,1853,1837,1589,-248
2018,3,15,4,1789,1783,1564,-219
2018,3,15,5,1663,1653,1598,-55
2018,3,15,6,1539,1530,1620,90
2018,3,15,7,1463,1454,1562,108
2018,3,15,8,1436,1429,1622,193
2018,3,15,9,1434,1415,1638,223
2018,3,15,10,1445,1425,1693,268
2018,3,15,11,1488,1454,1658,204
2018,3,15,12,1596,1544,1560,16
2018,3,15,13,1808,1743,1549,-194
2018,3,15,14,1966,1894,1685,-209
2018,3,15,15,1949,1894,1697,-197
2018,3,15,16,1914,1803,1628,-175
2018,3,15,17,1888,1719,1627,-92
2018,3,15,18,1860,1630,1631,1
2018,3,15,19,1812,1587,1566,-21
2018,3,15,20,1785,1576,1658,82
2018,3,15,21,1756,1484,1667,183
2018,3,15,22,1737,1459,1642,183
2018,3,15,23,1738,1473,1619,146
2018,3,16,0,1760,1511,1567,56
2018,3,16,1,1811,1548,1537,-11
2018,3,16,2,1865,1689,1482,-207
2018,3,16,3,1902,1805,1471,-334
2018,3,16,4,1847,1760,1568,-192
2018,3,16,5,1720,1672,1531,-141
2018,3,16,6,1597,1558,1501,-57
2018,3,16,7,1522,1494,1511,17
2018,3,16,8,1482,1474,1549,75
2018,3,16,9,1482,1464,1556,92
2018,3,16,10,1487,1480,1586,106
2018,3,16,11,1522,1501,1644,143
2018,3,16,12,1625,1600,1667,67
2018,3,16,13,1827,1795,1724,-71
2018,3,16,14,1974,1942,1753,-189
2018,3,16,15,1955,1959,1771,-188
2018,3,16,16,1912,1897,1724,-173
2018,3,16,17,1869,1826,1810,-16
2018,3,16,18,1827,1766,1814,48
2018,3,16,19,1768,1669,1763,94
2018,3,16,20,1734,1645,1719,74
2018,3,16,21,1695,1581,1702,121
2018,3,16,22,1670,1495,1651,156
2018,3,16,23,1675,1465,1559,94
2018,3,17,0,1662,1556,1571,15
2018,3,17,1,1689,1652,1630,-22
2018,3,17,2,1734,1722,1576,-146
2018,3,17,3,1776,1760,1575,-185
2018,3,17,4,1744,1730,1608,-122
2018,3,17,5,1664,1658,1569,-89
2018,3,17,6,1567,1553,1594,41
2018,3,17,7,1489,1488,1535,47
2018,3,17,8,1459,1456,1591,135
2018,3,17,9,1486,1447,1616,169
2018,3,17,10,1492,1443,1593,150
2018,3,17,11,1510,1459,1633,174
2018,3,17,12,1566,1508,1648,140
2018,3,17,13,1665,1602,1693,91
2018,3,17,14,1779,1710,1740,30
2018,3,17,15,1852,1787,1730,-57
2018,3,17,16,1887,1840,1732,-108
2018,3,17,17,1880,1839,1755,-84
2018,3,17,18,1849,1776,1718,-58
2018,3,17,19,1796,1674,1614,-60
2018,3,17,20,1749,1558,1574,16
2018,3,17,21,1707,1517,1532,15
2018,3,17,22,1671,1497,1534,37
2018,3,17,23,1655,1495,1502,7
2018,3,18,0,1693,1504,1513,9
2018,3,18,1,1727,1623,1559,-64
2018,3,18,2,1773,1717,1552,-165
2018,3,18,3,1817,1778,1527,-251
2018,3,18,4,1777,1755,1521,-234
2018,3,18,5,1704,1680,1488,-192
2018,3,18,6,1609,1596,1480,-116
2018,3,18,7,1533,1522,1483,-39
2018,3,18,8,1527,1503,1510,7
2018,3,18,9,1496,1481,1499,18
2018,3,18,10,1493,1485,1462,-23
2018,3,18,11,1509,1496,1450,-46
2018,3,18,12,1553,1530,1435,-95
2018,3,18,13,1630,1606,1430,-176
2018,3,18,14,1742,1702,1455,-247
2018,3,18,15,1822,1771,1552,-219
2018,3,18,16,1841,1737,1525,-212
2018,3,18,17,1817,1670,1532,-138
2018,3,18,18,1790,1562,1545,-17
2018,3,18,19,1770,1539,1570,31
2018,3,18,20,1726,1474,1581,107
2018,3,18,21,1684,1435,1681,246
2018,3,18,22,1650,1372,1723,351
2018,3,18,23,1644,1402,1734,332
2018,3,19,0,1672,1422,1719,297
2018,3,19,1,1696,1511,1650,139
2018,3,19,2,1738,1632,1609,-23
2018,3,19,3,1784,1757,1612,-145
2018,3,19,4,1746,1730,1558,-172
2018,3,19,5,1656,1636,1510,-126
2018,3,19,6,1564,1525,1500,-25
2018,3,19,7,1498,1478,1533,55
2018,3,19,8,1482,1464,1469,5
2018,3,19,9,1485,1476,1486,10
2018,3,19,10,1500,1495,1471,-24
2018,3,19,11,1544,1538,1449,-89
2018,3,19,12,1656,1655,1456,-199
2018,3,19,13,1850,1861,1483,-378
2018,3,19,14,1998,2018,1503,-515
2018,3,19,15,2022,1951,1409,-542
2018,3,19,16,1973,1792,1350,-442
2018,3,19,17,1919,1658,1346,-312
2018,3,19,18,1858,1535,1344,-191
2018,3,19,19,1792,1496,1428,-68
2018,3,19,20,1747,1484,1451,-33
2018,3,19,21,1703,1481,1441,-40
2018,3,19,22,1670,1443,1449,6
2018,3,19,23,1661,1454,1440,-14
2018,3,20,0,1684,1430,1437,7
2018,3,20,1,1709,1517,1406,-111
2018,3,20,2,1764,1662,1483,-179
2018,3,20,3,1840,1748,1488,-260
2018,3,20,4,1794,1700,1400,-300
2018,3,20,5,1682,1583,1346,-237
2018,3,20,6,1570,1469,1293,-176
2018,3,20,7,1504,1401,1305,-96
2018,3,20,8,1462,1383,1306,-77
2018,3,20,9,1431,1377,1330,-47
2018,3,20,10,1451,1391,1301,-90
2018,3,20,11,1495,1426,1315,-111
2018,3,20,12,1599,1526,1333,-193
2018,3,20,13,1788,1717,1226,-491
2018,3,20,14,1938,1869,1429,-440
2018,3,20,15,1921,1879,1450,-429
2018,3,20,16,1871,1831,1405,-426
2018,3,20,17,1824,1793,1375,-418
2018,3,20,18,1786,1608,1316,-292
2018,3,20,19,1737,1530,1282,-248
2018,3,20,20,1698,1465,1246,-219
2018,3,20,21,1665,1443,1341,-102
2018,3,20,22,1637,1420,1378,-42
2018,3,20,23,1628,1440,1471,31
2018,3,21,0,1637,1481,1384,-97
2018,3,21,1,1658,1571,1432,-139
2018,3,21,2,1711,1666,1530,-136
2018,3,21,3,1794,1735,1545,-190
2018,3,21,4,1745,1693,1564,-129
2018,3,21,5,1626,1583,1586,3
2018,3,21,6,1504,1465,1599,134
2018,3,21,7,1463,1392,1609,217
2018,3,21,8,1416,1367,1644,277
2018,3,21,9,1416,1353,1679,326
2018,3,21,10,1431,1367,1703,336
2018,3,21,11,1468,1409,1698,289
2018,3,21,12,1568,1509,1716,207
2018,3,21,13,1744,1686,1654,-32
2018,3,21,14,1879,1832,1606,-226
2018,3,21,15,1866,1807,1637,-170
2018,3,21,16,1833,1748,1645,-103
2018,3,21,17,1795,1612,1693,81
2018,3,21,18,1743,1493,1510,17
2018,3,21,19,1688,1479,1605,126
2018,3,21,20,1648,1434,1703,269
2018,3,21,21,1610,1416,1616,200
2018,3,21,22,1587,1420,1725,305
2018,3,21,23,1588,1456,1690,234
2018,3,22,0,1585,1549,1755,206
2018,3,22,1,1604,1613,1752,139
2018,3,22,2,1653,1658,1798,140
2018,3,22,3,1729,1703,1905,202
2018,3,22,4,1673,1649,1853,204
2018,3,22,5,1553,1541,1830,289
2018,3,22,6,1432,1432,1768,336
2018,3,22,7,1363,1356,1789,433
2018,3,22,8,1330,1314,1816,502
2018,3,22,9,1345,1297,1758,461
2018,3,22,10,1347,1296,1729,433
2018,3,22,11,1375,1329,1803,474
2018,3,22,12,1467,1402,1705,303
2018,3,22,13,1635,1874,2071,197
2018,3,22,14,1765,1730,1862,132
2018,3,22,15,1756,1750,1910,160
2018,3,22,16,1731,1743,1995,252
2018,3,22,17,1708,1736,2049,313
2018,3,22,18,1688,1649,2011,362
2018,3,22,19,1660,1638,1998,360
2018,3,22,20,1632,1628,1912,284
2018,3,22,21,1604,1590,1798,208
2018,3,22,22,1592,1611,1760,149
2018,3,22,23,1601,1642,1746,104
2018,3,23,0,1614,1662,1711,49
2018,3,23,1,1643,1685,1827,142
2018,3,23,2,1684,1698,1827,129
2018,3,23,3,1739,1725,1825,100
2018,3,23,4,1686,1671,1818,147
2018,3,23,5,1573,1576,1811,235
2018,3,23,6,1461,1448,1821,373
2018,3,23,7,1384,1384,1795,411
2018,3,23,8,1379,1362,1799,437
2018,3,23,9,1378,1348,1762,414
2018,3,23,10,1391,1378,1728,350
2018,3,23,11,1434,1412,1668,256
2018,3,23,12,1549,1510,1620,110
2018,3,23,13,1748,1690,1574,-116
2018,3,23,14,1908,1849,1553,-296
2018,3,23,15,1926,1847,1602,-245
2018,3,23,16,1895,1742,1621,-121
2018,3,23,17,1868,1612,1596,-16
2018,3,23,18,1813,1485,1507,22
2018,3,23,19,1780,1490,1613,123
2018,3,23,20,1741,1464,1677,213
2018,3,23,21,1703,1451,1663,212
2018,3,23,22,1683,1377,1641,264
2018,3,23,23,1681,1387,1599,212
2018,3,24,0,1645,1390,1658,268
2018,3,24,1,1653,1429,1722,293
2018,3,24,2,1673,1526,1705,179
2018,3,24,3,1703,1634,1774,140
2018,3,24,4,1676,1620,1793,173
2018,3,24,5,1604,1553,1744,191
2018,3,24,6,1515,1448,1717,269
2018,3,24,7,1446,1389,1697,308
2018,3,24,8,1401,1369,1694,325
2018,3,24,9,1381,1364,1723,359
2018,3,24,10,1384,1349,1716,367
2018,3,24,11,1402,1382,1694,312
2018,3,24,12,1457,1422,1709,287
2018,3,24,13,1548,1522,1715,193
2018,3,24,14,1662,1636,1745,109
2018,3,24,15,1743,1682,1801,119
2018,3,24,16,1780,1582,1814,232
2018,3,24,17,1785,1510,1775,265
2018,3,24,18,1749,1409,1798,389
2018,3,24,19,1721,1340,1762,422
2018,3,24,20,1680,1274,1735,461
2018,3,24,21,1647,1230,1651,421
2018,3,24,22,1622,1216,1666,450
2018,3,24,23,1619,1254,1680,426
2018,3,25,0,1642,1291,1662,371
2018,3,25,1,1664,1409,1712,303
2018,3,25,2,1692,1527,1673,146
2018,3,25,3,1744,1622,1656,34
2018,3,25,4,1719,1616,1623,7
2018,3,25,5,1652,1552,1630,78
2018,3,25,6,1562,1478,1617,139
2018,3,25,7,1508,1404,1588,184
2018,3,25,8,1450,1377,1555,178
2018,3,25,9,1422,1370,1514,144
2018,3,25,10,1433,1379,1593,214
2018,3,25,11,1458,1388,1596,208
2018,3,25,12,1512,1447,1627,180
2018,3,25,13,1600,1517,1511,-6
2018,3,25,14,1715,1632,1596,-36
2018,3,25,15,1793,1707,1615,-92
2018,3,25,16,1787,1696,1612,-84
2018,3,25,17,1765,1588,1547,-41
2018,3,25,18,1726,1540,1552,12
2018,3,25,19,1708,1495,1552,57
2018,3,25,20,1670,1430,1645,215
2018,3,25,21,1644,1394,1628,234
2018,3,25,22,1612,1365,1693,328
2018,3,25,23,1614,1405,1660,255
2018,3,26,0,1645,1402,1780,378
2018,3,26,1,1672,1515,1874,359
2018,3,26,2,1706,1616,1830,214
2018,3,26,3,1781,1733,1893,160
2018,3,26,4,1751,1711,1864,153
2018,3,26,5,1656,1615,1934,319
2018,3,26,6,1556,1524,1861,337
2018,3,26,7,1492,1492,1861,-9999
2018,3,26,8,1449,1453,1874,421
2018,3,26,9,1486,1453,1876,423
2018,3,26,10,1505,1491,1954,463
2018,3,26,11,1552,1537,1872,335
2018,3,26,12,1673,1643,1904,261
2018,3,26,13,1883,1830,1945,115
2018,3,26,14,2040,1983,1942,-41
2018,3,26,15,2051,1908,1872,-36
2018,3,26,16,1985,1734,1838,104
2018,3,26,17,1916,1626,1861,235
2018,3,26,18,1841,1587,1970,383
2018,3,26,19,1773,1534,1994,460
2018,3,26,20,1716,1476,1970,494
2018,3,26,21,1671,1420,1948,528
2018,3,26,22,1637,1373,1945,572
2018,3,26,23,1630,1361,1926,565
2018,3,27,0,1652,1348,1921,573
2018,3,27,1,1688,1436,2069,633
2018,3,27,2,1726,1639,1972,333
2018,3,27,3,1798,1774,1966,192
2018,3,27,4,1756,1757,1980,223
2018,3,27,5,1655,1662,1942,280
2018,3,27,6,1550,1555,1819,264
2018,3,27,7,1476,1494,1619,125
2018,3,27,8,1486,1486,1635,149
2018,3,27,9,1506,1484,1631,147
2018,3,27,10,1517,1503,1656,153
2018,3,27,11,1557,1533,1687,154
2018,3,27,12,1665,1643,1707,64
2018,3,27,13,1853,1827,1853,26
2018,3,27,14,1997,1948,1890,-58
2018,3,27,15,1966,1846,1768,-78
2018,3,27,16,1894,1730,1772,48
2018,3,27,17,1835,1545,1785,240
2018,3,27,18,1778,1487,1827,340
2018,3,27,19,1720,1423,1922,499
2018,3,27,20,1670,1380,1976,596
2018,3,27,21,1625,1361,2024,663
2018,3,27,22,1589,1375,2076,701
2018,3,27,23,1576,1377,2074,697
2018,3,28,0,1586,1463,2065,602
2018,3,28,1,1615,1555,2011,456
2018,3,28,2,1654,1624,1997,373
2018,3,28,3,1731,1690,2000,310
2018,3,28,4,1692,1654,1913,259
2018,3,28,5,1585,1546,1864,318
2018,3,28,6,1485,1444,1894,450
2018,3,28,7,1393,1375,1966,591
2018,3,28,8,1370,1348,1977,629
2018,3,28,9,1387,1339,1991,652
2018,3,28,10,1399,1350,2001,651
2018,3,28,11,1427,1377,2056,679
2018,3,28,12,1529,1472,1993,521
2018,3,28,13,1701,1649,1951,302
2018,3,28,14,1829,1766,1928,162
2018,3,28,15,1818,1687,1947,260
2018,3,28,16,1787,1518,1980,462
2018,3,28,17,1756,1466,2022,556
2018,3,28,18,1718,1415,2073,658
2018,3,28,19,1679,1362,2068,706
2018,3,28,20,1639,1312,2000,688
2018,3,28,21,1609,1298,2024,726
2018,3,28,22,1583,1296,2048,752
2018,3,28,23,1573,1309,2088,779
2018,3,29,0,1582,1353,2064,711
2018,3,29,1,1612,1431,2125,694
2018,3,29,2,1652,1594,2173,579
2018,3,29,3,1728,1666,2034,368
2018,3,29,4,1690,1637,1978,341
2018,3,29,5,1588,1538,2035,497
2018,3,29,6,1486,1430,2049,619
2018,3,29,7,1414,1370,2084,714
2018,3,29,8,1391,1351,2082,731
2018,3,29,9,1391,1355,2068,713
2018,3,29,10,1409,1361,2107,746
2018,3,29,11,1449,1406,2104,698
2018,3,29,12,1557,1521,2107,586
2018,3,29,13,1745,1687,2100,413
2018,3,29,14,1884,1815,2125,310
2018,3,29,15,1875,1750,2030,280
2018,3,29,16,1829,1527,1900,373
2018,3,29,17,1787,1462,1994,532
2018,3,29,18,1739,1419,2065,646
2018,3,29,19,1686,1366,2033,667
2018,3,29,20,1625,1332,2002,670
2018,3,29,21,1605,1295,1987,692
2018,3,29,22,1580,1275,2023,748
2018,3,29,23,1565,1250,1992,742
2018,3,30,0,1565,1259,1964,705
2018,3,30,1,1591,1381,2027,646
2018,3,30,2,1637,1502,1954,452
2018,3,30,3,1713,1610,1946,336
2018,3,30,4,1680,1590,1812,222
2018,3,30,5,1584,1505,1783,278
2018,3,30,6,1479,1402,1755,353
2018,3,30,7,1421,1340,1752,412
2018,3,30,8,1386,1314,1586,272
2018,3,30,9,1353,1331,1689,358
2018,3,30,10,1366,1335,1680,345
2018,3,30,11,1407,1384,1670,286
2018,3,30,12,1500,1472,1650,178
2018,3,30,13,1663,1658,1625,-33
2018,3,30,14,1796,1785,1633,-152
2018,3,30,15,1787,1688,1583,-105
2018,3,30,16,1726,1477,1583,106
2018,3,30,17,1683,1420,1613,193
2018,3,30,18,1638,1388,1643,255
2018,3,30,19,1589,1387,1695,308
2018,3,30,20,1544,1316,1744,428
2018,3,30,21,1524,1296,1788,492
2018,3,30,22,1504,1289,1794,505
2018,3,30,23,1495,1299,1820,521
2018,3,31,0,1458,1393,1816,423
2018,3,31,1,1468,1449,1862,413
2018,3,31,2,1496,1483,1817,334
2018,3,31,3,1565,1544,1765,221
2018,3,31,4,1553,1513,1741,228
2018,3,31,5,1492,1442,1773,331
2018,3,31,6,1408,1344,1788,444
2018,3,31,7,1366,1282,1814,532
2018,3,31,8,1310,1238,1782,544
2018,3,31,9,1277,1229,1827,598
2018,3,31,10,1285,1219,1808,589
2018,3,31,11,1318,1231,1776,545
2018,3,31,12,1368,1286,1796,510
2018,3,31,13,1450,1357,1758,401
2018,3,31,14,1537,1459,1792,333
2018,3,31,15,1603,1510,1800,290
2018,3,31,16,1627,1495,1755,260
2018,3,31,17,1630,1455,1748,293
2018,3,31,18,1609,1362,1665,303
2018,3,31,19,1559,1284,1658,374
2018,3,31,20,1507,1206,1662,456
2018,3,31,21,1471,1194,1712,518
2018,3,31,22,1445,1220,1792,572
2018,3,31,23,1431,1218,1785,567
2018,4,1,0,1449,1283,1768,485
2018,4,1,1,1464,1353,1796,443
2018,4,1,2,1492,1444,1825,381
2018,4,1,3,1556,1521,1895,374
2018,4,1,4,1542,1484,1874,390
2018,4,1,5,1472,1409,1880,471
2018,4,1,6,1382,1331,1840,509
2018,4,1,7,1346,1260,1817,557
2018,4,1,8,1308,1247,1852,605
2018,4,1,9,1269,1239,1818,579
2018,4,1,10,1282,1262,1817,555
2018,4,1,11,1313,1291,1815,524
2018,4,1,12,1364,1342,1829,487
2018,4,1,13,1438,1442,1808,366
2018,4,1,14,1535,1532,1786,254
2018,4,1,15,1606,1489,1726,237
2018,4,1,16,1602,1484,1734,250
2018,4,1,17,1570,1460,1744,284
2018,4,1,18,1530,1371,1745,374
2018,4,1,19,1498,1317,1708,391
2018,4,1,20,1457,1262,1683,421
2018,4,1,21,1437,1219,1711,492
2018,4,1,22,1422,1180,1680,500
2018,4,1,23,1421,1180,1754,574
2018,4,2,0,1444,1254,1782,528
2018,4,2,1,1462,1329,1773,444
2018,4,2,2,1485,1444,1749,305
2018,4,2,3,1559,1545,1743,198
2018,4,2,4,1528,1536,1738,202
2018,4,2,5,1442,1435,1728,293
2018,4,2,6,1344,1316,1725,409
2018,4,2,7,1295,1259,1766,507
2018,4,2,8,1261,1219,1822,603
2018,4,2,9,1264,1217,1865,648
2018,4,2,10,1283,1233,1942,709
2018,4,2,11,1326,1275,1937,662
2018,4,2,12,1433,1379,1986,607
2018,4,2,13,1626,1608,2149,541
2018,4,2,14,1767,1785,2172,387
2018,4,2,15,1802,1777,2178,401
2018,4,2,16,1814,1683,2170,487
2018,4,2,17,1820,1587,2088,501
2018,4,2,18,1796,1601,2112,511
2018,4,2,19,1760,1612,2089,477
2018,4,2,20,1726,1588,2062,474
2018,4,2,21,1692,1581,2056,475
2018,4,2,22,1661,1552,2019,467
2018,4,2,23,1655,1513,1963,450
2018,4,3,0,1671,1528,1989,461
2018,4,3,1,1701,1577,2025,448
2018,4,3,2,1750,1732,2043,311
2018,4,3,3,1828,1846,1921,75
2018,4,3,4,1799,1828,1832,4
2018,4,3,5,1691,1714,1708,-6
2018,4,3,6,1578,1596,1582,-14
2018,4,3,7,1512,1539,1583,44
2018,4,3,8,1512,1537,1588,51
2018,4,3,9,1543,1543,1581,38
2018,4,3,10,1559,1559,1591,32
2018,4,3,11,1598,1601,1606,5
2018,4,3,12,1702,1730,1641,-89
2018,4,3,13,1910,1951,1672,-279
2018,4,3,14,2050,1416,1047,-369
2018,4,3,15,2019,1898,1633,-265
2018,4,3,16,1954,2334,2282,-52
2018,4,3,17,1895,1587,1700,113
2018,4,3,18,1826,1519,1705,186
2018,4,3,19,1765,1463,1688,225
2018,4,3,20,1707,1410,1697,287
2018,4,3,21,1666,1387,1703,316
2018,4,3,22,1621,1382,1692,310
2018,4,3,23,1612,1482,1744,262
2018,4,4,0,1612,1550,1755,205
2018,4,4,1,1620,1566,1807,241
2018,4,4,2,1645,1647,1816,169
2018,4,4,3,1719,1756,1834,78
2018,4,4,4,1691,1725,1771,46
2018,4,4,5,1586,1600,1750,150
2018,4,4,6,1475,1477,1724,247
2018,4,4,7,1365,1412,1671,259
2018,4,4,8,1346,1386,1659,273
2018,4,4,9,1391,1386,1704,318
2018,4,4,10,1391,1399,1618,219
2018,4,4,11,1425,1422,1695,273
2018,4,4,12,1524,1530,1787,257
2018,4,4,13,1708,1716,1821,105
2018,4,4,14,1816,1851,1775,-76
2018,4,4,15,1791,1805,1675,-130
2018,4,4,16,1746,1758,1692,-66
2018,4,4,17,1715,1696,1774,78
2018,4,4,18,1680,1588,1859,271
2018,4,4,19,1652,1484,1893,409
2018,4,4,20,1622,1445,1849,404
2018,4,4,21,1604,1436,1788,352
2018,4,4,22,1577,1393,1807,414
2018,4,4,23,1580,1388,1913,525
2018,4,5,0,1592,1442,1820,378
2018,4,5,1,1607,1445,1728,283
2018,4,5,2,1624,1565,1745,180
2018,4,5,3,1692,1660,1747,87
2018,4,5,4,1651,1644,1717,73
2018,4,5,5,1539,1514,1699,185
2018,4,5,6,1428,1408,1766,358
2018,4,5,7,1330,1319,1780,461
2018,4,5,8,1354,1296,1790,494
2018,4,5,9,1407,1275,1786,511
2018,4,5,10,1390,1290,1817,527
2018,4,5,11,1419,1310,1792,482
2018,4,5,12,1555,1404,1754,350
2018,4,5,13,1742,1605,1767,162
2018,4,5,14,1830,1736,1774,38
2018,4,5,15,1792,1722,1824,102
2018,4,5,16,1746,1640,1774,134
2018,4,5,17,1716,1595,1766,171
2018,4,5,18,1728,1524,1729,205
2018,4,5,19,1761,1511,1685,174
2018,4,5,20,1682,1495,1748,253
2018,4,5,21,1626,1503,1704,201
2018,4,5,22,1620,1483,1700,217
2018,4,5,23,1675,1458,1716,258
2018,4,6,0,1673,1542,1746,204
2018,4,6,1,1643,1577,1716,139
2018,4,6,2,1639,1599,1720,121
2018,4,6,3,1695,1671,1750,79
2018,4,6,4,1690,1632,1749,117
2018,4,6,5,1563,1527,1718,191
2018,4,6,6,1442,1397,1722,325
2018,4,6,7,1362,1321,1761,440
2018,4,6,8,1372,1301,1745,444
2018,4,6,9,1341,1279,1739,460
2018,4,6,10,1345,1285,1834,549
2018,4,6,11,1386,1301,1778,477
2018,4,6,12,1483,1386,1810,424
2018,4,6,13,1656,1552,1807,255
2018,4,6,14,1782,1691,1795,104
2018,4,6,15,1757,1694,1776,82
2018,4,6,16,1744,1647,1771,124
2018,4,6,17,1731,1595,1747,152
2018,4,6,18,1737,1550,1736,186
2018,4,6,19,1707,1501,1777,276
2018,4,6,20,1666,1481,1772,291
2018,4,6,21,1624,1457,1790,333
2018,4,6,22,1608,1467,1751,284
2018,4,6,23,1628,1465,1787,322
2018,4,7,0,1553,1465,1810,345
2018,4,7,1,1537,1451,1776,325
2018,4,7,2,1531,1525,1746,221
2018,4,7,3,1597,1590,1742,152
2018,4,7,4,1607,1566,1732,166
2018,4,7,5,1540,1495,1747,252
2018,4,7,6,1396,1390,1742,352
2018,4,7,7,1360,1318,1749,431
2018,4,7,8,1342,1283,1757,474
2018,4,7,9,1419,1262,1779,517
2018,4,7,10,1420,1273,1795,522
2018,4,7,11,1434,1266,1784,518
2018,4,7,12,1460,1293,1789,496
2018,4,7,13,1525,1390,1797,407
2018,4,7,14,1599,1505,1883,378
2018,4,7,15,1666,1587,1876,289
2018,4,7,16,1728,1643,1865,222
2018,4,7,17,1735,1647,2074,427
2018,4,7,18,1692,1593,2058,465
2018,4,7,19,1666,1430,1997,567
2018,4,7,20,1610,1412,1931,519
2018,4,7,21,1620,1401,1883,482
2018,4,7,22,1618,1365,1884,519
2018,4,7,23,1580,1395,2104,709
2018,4,8,0,1556,1388,2201,813
2018,4,8,1,1552,1378,2203,825
2018,4,8,2,1533,1472,2160,688
2018,4,8,3,1576,1566,2131,565
2018,4,8,4,1630,1567,2133,566
2018,4,8,5,1570,1507,2092,585
2018,4,8,6,1432,1416,2053,637
2018,4,8,7,1364,1357,2127,770
2018,4,8,8,1383,1300,2069,769
2018,4,8,9,1518,1289,2081,792
2018,4,8,10,1402,1281,2110,829
2018,4,8,11,1397,1296,2132,836
2018,4,8,12,1464,1331,2065,734
2018,4,8,13,1515,1402,2064,662
2018,4,8,14,1582,1482,2065,583
2018,4,8,15,1659,1541,1929,388
2018,4,8,16,1710,1524,1949,425
2018,4,8,17,1765,1495,2117,622
2018,4,8,18,1777,1487,2136,649
2018,4,8,19,1744,1438,2069,631
2018,4,8,20,1647,1441,2088,647
2018,4,8,21,1612,1439,2021,582
2018,4,8,22,1599,1446,2065,619
2018,4,8,23,1649,1430,2129,699
2018,4,9,0,1735,1456,2178,722
2018,4,9,1,1753,1449,2118,669
2018,4,9,2,1691,1546,2062,516
2018,4,9,3,1654,1639,2058,419
2018,4,9,4,1711,1644,2005,361
2018,4,9,5,1660,1538,1951,413
2018,4,9,6,1485,1425,2026,601
2018,4,9,7,1429,1368,2093,725
2018,4,9,8,1466,1359,1979,620
2018,4,9,9,1491,1358,1889,531
2018,4,9,10,1470,1387,1818,431
2018,4,9,11,1516,1428,1770,342
2018,4,9,12,1612,1551,1807,256
2018,4,9,13,1788,1784,1782,-2
2018,4,9,14,1922,1879,1743,-136
2018,4,9,15,1920,1707,1719,12
2018,4,9,16,1850,1534,1707,173
2018,4,9,17,1911,1476,1722,246
2018,4,9,18,1856,1434,1755,321
2018,4,9,19,1780,1381,1782,401
2018,4,9,20,1707,1374,1779,405
2018,4,9,21,1646,1398,1778,380
2018,4,9,22,1626,1410,1786,376
2018,4,9,23,1649,1372,1785,413
2018,4,10,0,1686,1353,1783,430
2018,4,10,1,1734,1379,1770,391
2018,4,10,2,1701,1516,1765,249
2018,4,10,3,1720,1655,1762,107
2018,4,10,4,1758,1654,1777,123
2018,4,10,5,1638,1538,1832,294
2018,4,10,6,1485,1408,1825,417
2018,4,10,7,1475,1344,1913,569
2018,4,10,8,1457,1321,1987,666
2018,4,10,9,1375,1319,2040,721
2018,4,10,10,1350,1347,2129,782
2018,4,10,11,1380,1374,2118,744
2018,4,10,12,1474,1487,2177,690
2018,4,10,13,1646,1687,2191,504
2018,4,10,14,1762,1809,2190,381
2018,4,10,15,1763,1793,2136,343
2018,4,10,16,1791,1763,2091,328
2018,4,10,17,1804,1702,2129,427
2018,4,10,18,1725,1655,2152,497
2018,4,10,19,1704,1601,2145,544
2018,4,10,20,1665,1544,2073,529
2018,4,10,21,1654,1522,2038,516
2018,4,10,22,1621,1483,2013,530
2018,4,10,23,1647,1552,1987,435
2018,4,11,0,1662,1598,1942,344
2018,4,11,1,1703,1617,1937,320
2018,4,11,2,1682,1644,1949,305
2018,4,11,3,1689,1700,2057,357
2018,4,11,4,1695,1647,2150,503
2018,4,11,5,1601,1523,2163,640
2018,4,11,6,1450,1398,2142,744
2018,4,11,7,1468,1341,2007,666
2018,4,11,8,1502,1301,1952,651
2018,4,11,9,1453,1299,1889,590
2018,4,11,10,1433,1288,2002,714
2018,4,11,11,1445,1326,2171,845
2018,4,11,12,1533,1443,2223,780
2018,4,11,13,1762,1626,2151,525
2018,4,11,14,1896,1739,2023,284
2018,4,11,15,1911,1658,1939,281
2018,4,11,16,1901,1559,1802,243
2018,4,11,17,1899,1525,1772,247
2018,4,11,18,1834,1476,1774,298
2018,4,11,19,1850,1472,1784,312
2018,4,11,20,1784,1393,1772,379
2018,4,11,21,1774,1401,1812,411
2018,4,11,22,1759,1435,1883,448
2018,4,11,23,1719,1504,1895,391
2018,4,12,0,1704,1508,1867,359
2018,4,12,1,1681,1524,1836,312
2018,4,12,2,1658,1578,1854,276
2018,4,12,3,1755,1668,1885,217
2018,4,12,4,1842,1652,1909,257
2018,4,12,5,1773,1532,1942,410
2018,4,12,6,1566,1402,1926,524
2018,4,12,7,1495,1330,1836,506
2018,4,12,8,1442,1309,1946,637
2018,4,12,9,1297,1308,1993,685
2018,4,12,10,1367,1319,2141,822
2018,4,12,11,1552,1362,2367,1005
2018,4,12,12,1639,1467,2355,888
2018,4,12,13,1851,1682,2290,608
2018,4,12,14,2075,1833,2313,480
2018,4,12,15,2054,1838,2330,492
2018,4,12,16,1968,1830,2336,506
2018,4,12,17,1875,1812,2329,517
2018,4,12,18,1789,1757,2324,567
2018,4,12,19,1802,1697,2285,588
2018,4,12,20,1779,1650,2281,631
2018,4,12,21,1844,1589,2258,669
2018,4,12,22,1851,1565,2283,718
2018,4,12,23,1771,1556,2273,717
2018,4,13,0,1667,1563,2269,706
2018,4,13,1,1672,1650,2265,615
2018,4,13,2,1708,1777,2318,541
2018,4,13,3,1847,1831,2330,499
2018,4,13,4,1882,1822,2264,442
2018,4,13,5,1852,1695,2275,580
2018,4,13,6,1621,1584,2254,670
2018,4,13,7,1580,1514,2264,750
2018,4,13,8,1466,1500,2289,789
2018,4,13,9,1530,1491,2288,797
2018,4,13,10,1522,1502,2241,739
2018,4,13,11,1686,1540,2226,686
2018,4,13,12,1787,1647,2211,564
2018,4,13,13,1902,1856,2232,376
2018,4,13,14,2060,1951,2206,255
2018,4,13,15,2044,1762,2182,420
2018,4,13,16,1961,1623,2202,579
2018,4,13,17,1926,1584,2213,629
2018,4,13,18,1879,1529,2177,648
2018,4,13,19,1860,1479,2112,633
2018,4,13,20,1804,1446,2098,652
2018,4,13,21,1778,1406,2090,684
2018,4,13,22,1766,1390,2089,699
2018,4,13,23,1761,1393,2121,728
2018,4,14,0,1687,1462,2149,687
2018,4,14,1,1685,1539,2131,592
2018,4,14,2,1645,1608,2065,457
2018,4,14,3,1676,1702,2011,309
2018,4,14,4,1736,1685,1949,264
2018,4,14,5,1705,1623,1890,267
2018,4,14,6,1587,1522,1847,325
2018,4,14,7,1468,1470,1853,383
2018,4,14,8,1484,1415,1818,403
2018,4,14,9,1490,1407,1812,405
2018,4,14,10,1451,1424,1776,352
2018,4,14,11,1547,1420,1724,304
2018,4,14,12,1594,1474,1735,261
2018,4,14,13,1558,1570,1754,184
2018,4,14,14,1623,1640,1766,126
2018,4,14,15,1730,1688,1739,51
2018,4,14,16,1762,1694,1723,29
2018,4,14,17,1770,1630,1737,107
2018,4,14,18,1764,1521,1767,246
2018,4,14,19,1711,1436,1776,340
2018,4,14,20,1630,1354,1799,445
2018,4,14,21,1611,1324,1794,470
2018,4,14,22,1594,1334,1808,474
2018,4,14,23,1591,1334,1814,480
2018,4,15,0,1638,1347,1799,452
2018,4,15,1,1613,1411,1824,413
2018,4,15,2,1599,1516,1823,307
2018,4,15,3,1583,1588,1819,231
2018,4,15,4,1624,1600,1853,253
2018,4,15,5,1579,1529,1895,366
2018,4,15,6,1484,1436,1930,494
2018,4,15,7,1437,1360,1975,615
2018,4,15,8,1406,1339,2036,697
2018,4,15,9,1371,1325,2082,757
2018,4,15,10,1376,1316,2134,818
2018,4,15,11,1421,1331,2093,762
2018,4,15,12,1420,1348,2004,656
2018,4,15,13,1420,1427,1962,535
2018,4,15,14,1519,1485,1874,389
2018,4,15,15,1619,1507,1821,314
2018,4,15,16,1637,1479,1807,328
2018,4,15,17,1626,1386,1824,438
2018,4,15,18,1590,1325,1676,351
2018,4,15,19,1586,1268,1779,511
2018,4,15,20,1542,1294,1828,534
2018,4,15,21,1542,1339,1889,550
2018,4,15,22,1535,1366,1970,604
2018,4,15,23,1528,1410,2020,610
2018,4,16,0,1553,1468,2036,568
2018,4,16,1,1556,1509,2046,537
2018,4,16,2,1557,1549,2114,565
2018,4,16,3,1584,1606,2245,639
2018,4,16,4,1562,1586,2263,677
2018,4,16,5,1494,1469,2044,575
2018,4,16,6,1418,1351,1965,614
2018,4,16,7,1363,1289,1951,662
2018,4,16,8,1362,1254,2101,847
2018,4,16,9,1350,1256,2233,977
2018,4,16,10,1381,1281,2213,932
2018,4,16,11,1432,1305,2212,907
2018,4,16,12,1526,1407,2203,796
2018,4,16,13,1640,1623,2210,587
2018,4,16,14,1749,1746,2093,347
2018,4,16,15,1821,1728,2018,290
2018,4,16,16,1816,1712,1955,243
2018,4,16,17,1820,1713,1928,215
2018,4,16,18,1757,1641,1910,269
2018,4,16,19,1762,1631,1892,261
2018,4,16,20,1759,1587,1927,340
2018,4,16,21,1748,1592,1973,381
2018,4,16,22,1734,1615,2005,390
2018,4,16,23,1752,1590,2092,502
2018,4,17,0,1760,1631,2080,449
2018,4,17,1,1724,1685,2130,445
2018,4,17,2,1732,1744,2108,364
2018,4,17,3,1794,1826,1946,120
2018,4,17,4,1782,1791,1949,158
2018,4,17,5,1708,1670,1967,297
2018,4,17,6,1576,1531,2001,470
2018,4,17,7,1488,1495,2144,649
2018,4,17,8,1543,1462,2206,744
2018,4,17,9,1701,1463,2225,762
2018,4,17,10,1682,1481,2217,736
2018,4,17,11,1667,1534,2242,708
2018,4,17,12,1802,1663,2258,595
2018,4,17,13,1926,1897,2260,363
2018,4,17,14,2048,1956,2240,284
2018,4,17,15,2010,1797,2172,375
2018,4,17,16,1994,1758,2147,389
2018,4,17,17,1946,1714,2191,477
2018,4,17,18,1890,1695,2235,540
2018,4,17,19,1867,1640,2220,580
2018,4,17,20,1790,1597,2176,579
2018,4,17,21,1755,1582,2178,596
2018,4,17,22,1683,1529,2035,506
2018,4,17,23,1757,1494,1989,495
2018,4,18,0,1810,1483,2018,535
2018,4,18,1,1780,1507,2018,511
2018,4,18,2,1800,1650,1958,308
2018,4,18,3,1770,1772,1842,70
2018,4,18,4,1821,1784,1778,-6
2018,4,18,5,1785,1664,1743,79
2018,4,18,6,1618,1545,1727,182
2018,4,18,7,1498,1498,1730,232
2018,4,18,8,1679,1501,1740,239
2018,4,18,9,1686,1501,1747,246
2018,4,18,10,1708,1527,1781,254
2018,4,18,11,1788,1556,1801,245
2018,4,18,12,1878,1678,1857,179
2018,4,18,13,1916,1873,1907,34
2018,4,18,14,2047,1956,1925,-31
2018,4,18,15,2006,1838,1931,93
2018,4,18,16,1904,1761,1913,152
2018,4,18,17,1783,1664,1959,295
2018,4,18,18,1730,1559,1969,410
2018,4,18,19,1730,1482,1920,438
2018,4,18,20,1681,1479,2013,534
2018,4,18,21,1702,1484,1996,512
2018,4,18,22,1647,1496,1982,486
2018,4,18,23,1660,1547,1979,432
2018,4,19,0,1707,1610,1989,379
2018,4,19,1,1692,1686,2023,337
2018,4,19,2,1688,1724,2074,350
2018,4,19,3,1646,1781,2028,247
2018,4,19,4,1671,1769,1967,198
2018,4,19,5,1606,1639,1965,326
2018,4,19,6,1516,1511,1967,456
2018,4,19,7,1481,1438,1985,547
2018,4,19,8,1471,1423,2042,619
2018,4,19,9,1561,1420,2121,701
2018,4,19,10,1564,1428,2029,601
2018,4,19,11,1574,1464,1978,514
2018,4,19,12,1635,1560,1979,419
2018,4,19,13,1762,1774,1953,179
2018,4,19,14,1869,1884,1928,44
2018,4,19,15,1903,1871,1906,35
2018,4,19,16,1888,1811,1859,48
2018,4,19,17,1809,1728,1919,191
2018,4,19,18,1818,1630,1970,340
2018,4,19,19,1812,1539,1980,441
2018,4,19,20,1701,1512,1935,423
2018,4,19,21,1690,1505,1913,408
2018,4,19,22,1612,1493,1869,376
2018,4,19,23,1624,1507,1929,422
2018,4,20,0,1665,1563,2039,476
2018,4,20,1,1708,1619,2069,450
2018,4,20,2,1729,1643,2119,476
2018,4,20,3,1665,1765,2108,343
2018,4,20,4,1681,1764,2034,270
2018,4,20,5,1604,1657,2006,349
2018,4,20,6,1478,1540,2000,460
2018,4,20,7,1412,1455,2058,603
2018,4,20,8,1488,1436,2091,655
2018,4,20,9,1615,1430,2193,763
2018,4,20,10,1634,1446,2231,785
2018,4,20,11,1588,1473,2257,784
2018,4,20,12,1670,1576,2253,677
2018,4,20,13,1810,1771,2211,440
2018,4,20,14,1896,1831,2172,341
2018,4,20,15,1948,1631,2112,481
2018,4,20,16,1875,1596,2135,539
2018,4,20,17,1841,1585,2142,557
2018,4,20,18,1876,1522,2141,619
2018,4,20,19,1888,1484,2167,683
2018,4,20,20,1794,1470,2201,731
2018,4,20,21,1778,1467,2220,753
2018,4,20,22,1710,1433,2211,778
2018,4,20,23,1732,1447,2230,783
2018,4,21,0,1744,1422,2240,818
2018,4,21,1,1749,1442,2244,802
2018,4,21,2,1760,1571,2241,670
2018,4,21,3,1731,1697,2195,498
2018,4,21,4,1731,1731,2155,424
2018,4,21,5,1632,1663,2102,439
2018,4,21,6,1500,1550,2046,496
2018,4,21,7,1452,1489,2005,516
2018,4,21,8,1499,1457,1963,506
2018,4,21,9,1609,1439,1846,407
2018,4,21,10,1593,1441,1786,345
2018,4,21,11,1548,1460,1776,316
2018,4,21,12,1600,1506,1823,317
2018,4,21,13,1593,1591,1829,238
2018,4,21,14,1638,1637,1807,170
2018,4,21,15,1740,1547,1805,258
2018,4,21,16,1782,1515,1840,325
2018,4,21,17,1797,1495,1875,380
2018,4,21,18,1793,1463,1988,525
2018,4,21,19,1758,1448,2117,669
2018,4,21,20,1679,1428,2151,723
2018,4,21,21,1707,1420,2160,740
2018,4,21,22,1659,1423,2195,772
2018,4,21,23,1723,1422,2147,725
2018,4,22,0,1793,1434,2130,696
2018,4,22,1,1813,1480,2125,645
2018,4,22,2,1804,1603,2020,417
2018,4,22,3,1706,1729,1947,218
2018,4,22,4,1665,1753,1934,181
2018,4,22,5,1606,1666,1910,244
2018,4,22,6,1526,1557,1887,330
2018,4,22,7,1503,1485,1898,413
2018,4,22,8,1542,1428,1908,480
2018,4,22,9,1517,1421,1891,470
2018,4,22,10,1528,1419,1902,483
2018,4,22,11,1525,1433,1891,458
2018,4,22,12,1558,1463,1855,392
2018,4,22,13,1585,1529,1845,316
2018,4,22,14,1635,1571,1827,256
2018,4,22,15,1751,1479,1812,333
2018,4,22,16,1732,1467,1804,337
2018,4,22,17,1738,1459,1791,332
2018,4,22,18,1719,1449,1809,360
2018,4,22,19,1751,1429,1820,391
2018,4,22,20,1693,1436,1840,404
2018,4,22,21,1699,1420,1940,520
2018,4,22,22,1703,1399,2024,625
2018,4,22,23,1761,1445,2139,694
2018,4,23,0,1789,1496,2223,727
2018,4,23,1,1811,1546,2297,751
2018,4,23,2,1819,1639,2361,722
2018,4,23,3,1812,1738,2332,594
2018,4,23,4,1784,1761,2269,508
2018,4,23,5,1678,1641,2299,658
2018,4,23,6,1555,1518,2318,800
2018,4,23,7,1510,1453,2272,819
2018,4,23,8,1515,1417,2240,823
2018,4,23,9,1592,1416,2288,872
2018,4,23,10,1573,1418,2286,868
2018,4,23,11,1573,1468,2295,827
2018,4,23,12,1673,1575,2321,746
2018,4,23,13,1830,1796,2310,514
2018,4,23,14,1948,1865,2284,419
2018,4,23,15,2030,1701,2224,523
2018,4,23,16,2007,1736,2356,620
2018,4,23,17,1944,1645,2286,641
2018,4,23,18,1948,1630,2269,639
2018,4,23,19,1962,1600,2243,643
2018,4,23,20,1878,1581,2225,644
2018,4,23,21,1944,1575,2207,632
2018,4,23,22,1954,1564,2191,627
2018,4,23,23,2014,1557,2205,648
2018,4,24,0,2043,1569,2157,588
2018,4,24,1,2079,1600,2051,451
2018,4,24,2,2026,1746,1981,235
2018,4,24,3,1976,1888,1957,69
2018,4,24,4,1924,1887,1955,68
2018,4,24,5,1807,1759,2008,249
2018,4,24,6,1667,1620,1986,366
2018,4,24,7,1563,1543,1965,422
2018,4,24,8,1597,1516,1975,459
2018,4,24,9,1638,1502,1952,450
2018,4,24,10,1674,1515,1951,436
2018,4,24,11,1734,1556,1974,418
2018,4,24,12,1823,1652,2028,376
2018,4,24,13,1922,1851,2039,188
2018,4,24,14,1992,1903,2032,129
2018,4,24,15,2073,1756,1991,235
2018,4,24,16,2088,1692,2040,348
2018,4,24,17,2005,1677,2087,410
2018,4,24,18,2002,1632,2012,380
2018,4,24,19,1957,1606,1936,330
2018,4,24,20,1942,1601,1936,335
2018,4,24,21,1961,1606,1956,350
2018,4,24,22,1979,1594,1955,361
2018,4,24,23,2057,1595,1918,323
2018,4,25,0,2088,1581,1930,349
2018,4,25,1,2114,1613,1946,333
2018,4,25,2,2023,1764,1928,164
2018,4,25,3,1906,1891,1905,14
2018,4,25,4,1900,1913,1959,46
2018,4,25,5,1803,1778,2006,228
2018,4,25,6,1699,1650,1955,305
2018,4,25,7,1603,1569,1878,309
2018,4,25,8,1586,1530,1893,363
2018,4,25,9,1542,1526,1918,392
2018,4,25,10,1561,1520,1870,350
2018,4,25,11,1615,1552,1890,338
2018,4,25,12,1706,1652,1886,234
2018,4,25,13,1826,1846,1897,51
2018,4,25,14,1952,1902,1904,2
2018,4,25,15,2040,1762,1812,50
2018,4,25,16,2040,1678,1766,88
2018,4,25,17,2017,1669,1789,120
2018,4,25,18,2000,1653,1771,118
2018,4,25,19,1936,1665,1730,65
2018,4,25,20,1940,1670,1700,30
2018,4,25,21,1963,1679,1719,40
2018,4,25,22,1998,1686,1821,135
2018,4,25,23,2067,1708,2025,317
2018,4,26,0,2073,1696,2104,408
2018,4,26,1,2125,1748,2215,467
2018,4,26,2,2079,1864,2198,334
2018,4,26,3,1950,1970,2166,196
2018,4,26,4,1934,1978,2122,144
2018,4,26,5,1880,1860,2030,170
2018,4,26,6,1715,1697,1944,247
2018,4,26,7,1644,1603,1794,191
2018,4,26,8,1633,1572,1740,168
2018,4,26,9,1648,1542,1699,157
2018,4,26,10,1642,1551,1690,139
2018,4,26,11,1653,1572,1696,124
2018,4,26,12,1714,1663,1776,113
2018,4,26,13,1813,1856,1910,54
2018,4,26,14,1937,1899,1904,5
2018,4,26,15,2020,1749,1866,117
2018,4,26,16,2039,1716,1822,106
2018,4,26,17,2045,1715,1835,120
2018,4,26,18,2047,1708,1926,218
2018,4,26,19,2015,1721,1980,259
2018,4,26,20,2005,1732,1859,127
2018,4,26,21,2023,1747,1790,43
2018,4,26,22,2042,1767,1779,12
2018,4,26,23,2091,1784,1791,7
2018,4,27,0,2110,1797,1818,21
2018,4,27,1,2149,1843,1832,-11
2018,4,27,2,2110,1974,1828,-146
2018,4,27,3,2013,2096,1897,-199
2018,4,27,4,1996,2092,1937,-155
2018,4,27,5,1907,1944,1877,-67
2018,4,27,6,1740,1769,1795,26
2018,4,27,7,1634,1666,1752,86
2018,4,27,8,1650,1605,1802,197
2018,4,27,9,1654,1579,1709,130
2018,4,27,10,1644,1571,1728,157
2018,4,27,11,1653,1593,1726,133
2018,4,27,12,1720,1667,1811,144
2018,4,27,13,1850,1829,1910,81
2018,4,27,14,1956,1863,1954,91
2018,4,27,15,2026,1765,1898,133
2018,4,27,16,2060,1734,1772,38
2018,4,27,17,2080,1731,1798,67
2018,4,27,18,2106,1748,1881,133
2018,4,27,19,2115,1765,1923,158
2018,4,27,20,2135,1786,1915,129
2018,4,27,21,2165,1838,1992,154
2018,4,27,22,2203,1881,1976,95
2018,4,27,23,2257,1945,1962,17
2018,4,28,0,2271,2039,1928,-111
2018,4,28,1,2270,2043,1881,-162
2018,4,28,2,2242,2078,1878,-200
2018,4,28,3,2128,2111,1982,-129
2018,4,28,4,2110,2076,1898,-178
2018,4,28,5,2005,1981,1914,-67
2018,4,28,6,1862,1840,1981,141
2018,4,28,7,1727,1737,2136,399
2018,4,28,8,1686,1676,2109,433
2018,4,28,9,1641,1633,2031,398
2018,4,28,10,1576,1602,1971,369
2018,4,28,11,1541,1589,1903,314
2018,4,28,12,1561,1598,1902,304
2018,4,28,13,1634,1651,1889,238
2018,4,28,14,1720,1665,1851,186
2018,4,28,15,1871,1630,1809,179
2018,4,28,16,1949,1641,1846,205
2018,4,28,17,1970,1671,1735,64
2018,4,28,18,1981,1661,1616,-45
2018,4,28,19,1971,1658,1617,-41
2018,4,28,20,1909,1652,1678,26
2018,4,28,21,1869,1651,1646,-5
2018,4,28,22,1858,1680,1646,-34
2018,4,28,23,1859,1712,1604,-108
2018,4,29,0,1869,1831,1685,-146
2018,4,29,1,1889,1892,1848,-44
2018,4,29,2,1864,1919,1905,-14
2018,4,29,3,1835,1958,2079,121
2018,4,29,4,1847,1944,2049,105
2018,4,29,5,1810,1866,1928,62
2018,4,29,6,1679,1759,1853,94
2018,4,29,7,1632,1681,1898,217
2018,4,29,8,1634,1628,1692,64
2018,4,29,9,1611,1592,1591,-1
2018,4,29,10,1627,1587,1590,3
2018,4,29,11,1618,1593,1614,21
2018,4,29,12,1626,1615,1669,54
2018,4,29,13,1657,1668,1751,83
2018,4,29,14,1695,1689,1819,130
2018,4,29,15,1814,1732,1833,101
2018,4,29,16,1863,1739,1850,111
2018,4,29,17,1916,1702,1778,76
2018,4,29,18,1883,1681,1701,20
2018,4,29,19,1855,1661,1666,5
2018,4,29,20,1843,1645,1716,71
2018,4,29,21,1823,1633,1761,128
2018,4,29,22,1820,1637,1819,182
2018,4,29,23,1863,1628,1844,216
2018,4,30,0,1880,1665,1929,264
2018,4,30,1,1915,1735,1974,239
2018,4,30,2,1894,1801,1996,195
2018,4,30,3,1950,1903,1999,96
2018,4,30,4,1951,1934,2072,138
2018,4,30,5,1831,1831,2104,273
2018,4,30,6,1701,1720,2077,357
2018,4,30,7,1621,1653,1970,317
2018,4,30,8,1604,1618,1966,348
2018,4,30,9,1631,1618,1944,326
2018,4,30,10,1630,1624,1891,267
2018,4,30,11,1668,1668,1946,278
2018,4,30,12,1782,1775,2039,264
2018,4,30,13,1912,1960,2099,139
2018,4,30,14,2034,2017,2138,121
2018,4,30,15,2071,1877,2134,257
2018,4,30,16,2078,1850,2160,310
2018,4,30,17,2056,1840,2197,357
2018,4,30,18,2046,1822,2207,385
2018,4,30,19,2009,1805,2226,421
2018,4,30,20,1984,1781,2204,423
2018,4,30,21,1978,1769,2175,406
2018,4,30,22,1960,1802,2153,351
2018,4,30,23,1954,1776,2117,341
2018,5,1,0,1952,1777,2034,257
2018,5,1,1,1962,1805,2045,240
2018,5,1,2,1969,1873,1992,119
2018,5,1,3,1968,1989,1945,-44
2018,5,1,4,1989,2024,1875,-149
2018,5,1,5,1900,1916,1850,-66
2018,5,1,6,1761,1785,1844,59
2018,5,1,7,1686,1710,1770,60
2018,5,1,8,1673,1684,1605,-79
2018,5,1,9,1677,1707,1764,57
2018,5,1,10,1681,1706,1675,-31
2018,5,1,11,1712,1737,1610,-127
2018,5,1,12,1794,1838,1652,-186
2018,5,1,13,1958,1999,1616,-383
2018,5,1,14,2066,2051,1499,-552
2018,5,1,15,2107,2001,1670,-331
2018,5,1,16,2121,1906,1660,-246
2018,5,1,17,2109,1807,1660,-147
2018,5,1,18,2099,1751,1620,-131
2018,5,1,19,2064,1708,1606,-102
2018,5,1,20,2033,1682,1619,-63
2018,5,1,21,2019,1685,1569,-116
2018,5,1,22,2000,1681,1588,-93
2018,5,1,23,2002,1703,1645,-58
2018,5,2,0,2009,1732,1794,62
2018,5,2,1,2016,1759,1906,147
2018,5,2,2,2016,1846,1957,111
2018,5,2,3,2020,1987,1841,-146
2018,5,2,4,2037,2011,1792,-219
2018,5,2,5,1935,1888,1750,-138
2018,5,2,6,1794,1775,1739,-36
2018,5,2,7,1701,1699,1653,-46
2018,5,2,8,1702,1643,1483,-160
2018,5,2,9,1702,1632,1471,-161
2018,5,2,10,1706,1630,1398,-232
2018,5,2,11,1743,1665,1417,-248
2018,5,2,12,1833,1789,1509,-280
2018,5,2,13,1999,1964,1641,-323
2018,5,2,14,2100,1995,1631,-364
2018,5,2,15,2119,1820,1590,-230
2018,5,2,16,2111,1781,1607,-174
2018,5,2,17,2091,1748,1585,-163
2018,5,2,18,2072,1728,1609,-119
2018,5,2,19,2042,1713,1620,-93
2018,5,2,20,2032,1716,1634,-82
2018,5,2,21,2029,1709,1709,0
2018,5,2,22,2026,1700,1715,15
2018,5,2,23,2034,1714,1858,144
2018,5,3,0,2037,1726,1935,209
2018,5,3,1,2049,1749,1828,79
2018,5,3,2,2057,1885,2004,119
2018,5,3,3,2070,2037,2076,39
2018,5,3,4,2076,2069,2156,87
2018,5,3,5,1960,1960,2072,112
2018,5,3,6,1821,1810,1960,150
2018,5,3,7,1734,1719,1652,-67
2018,5,3,8,1697,1695,1677,-18
2018,5,3,9,1684,1678,1743,65
2018,5,3,10,1688,1854,1961,107
2018,5,3,11,1723,1696,1671,-25
2018,5,3,12,1817,1789,1682,-107
2018,5,3,13,1990,1913,1589,-324
2018,5,3,14,2091,2034,1703,-331
2018,5,3,15,2103,1826,1627,-199
2018,5,3,16,2094,1797,1622,-175
2018,5,3,17,2086,1793,1681,-112
2018,5,3,18,2075,1778,1627,-151
2018,5,3,19,2059,1761,1622,-139
2018,5,3,20,2054,1783,1627,-156
2018,5,3,21,2056,1795,1612,-183
2018,5,3,22,2059,1803,1638,-165
2018,5,3,23,2082,1828,1660,-168
2018,5,4,0,2097,1863,1707,-156
2018,5,4,1,2111,1926,1796,-130
2018,5,4,2,2122,2065,1829,-236
2018,5,4,3,2132,2161,1732,-429
2018,5,4,4,2132,2159,1780,-379
2018,5,4,5,2003,2040,1777,-263
2018,5,4,6,1850,1886,1582,-304
2018,5,4,7,1754,1780,1439,-341
2018,5,4,8,1731,1744,1511,-233
2018,5,4,9,1729,1711,1276,-435
2018,5,4,10,1722,1709,1406,-303
2018,5,4,11,1743,1737,1603,-134
2018,5,4,12,1837,1809,1602,-207
2018,5,4,13,2003,1965,1679,-286
2018,5,4,14,2095,2008,1686,-322
2018,5,4,15,2120,1907,1660,-247
2018,5,4,16,2138,1870,1619,-251
2018,5,4,17,2152,1876,1584,-292
2018,5,4,18,2160,1887,1580,-307
2018,5,4,19,2158,1904,1598,-306
2018,5,4,20,2159,1939,1632,-307
2018,5,4,21,2171,1987,1627,-360
2018,5,4,22,2177,2041,1647,-394
2018,5,4,23,2203,2095,1695,-400
2018,5,5,0,2180,2124,1738,-386
2018,5,5,1,2179,2155,1743,-412
2018,5,5,2,2191,2171,1784,-387
2018,5,5,3,2153,2201,1870,-331
2018,5,5,4,2140,2218,1771,-447
2018,5,5,5,2021,2101,1702,-399
2018,5,5,6,1893,1960,1680,-280
2018,5,5,7,1815,1822,1621,-201
2018,5,5,8,1790,1782,1595,-187
2018,5,5,9,1763,1751,1585,-166
2018,5,5,10,1704,1728,1608,-120
2018,5,5,11,1678,1719,1638,-81
2018,5,5,12,1707,1739,1726,-13
2018,5,5,13,1792,1789,1711,-78
2018,5,5,14,1864,1842,1712,-130
2018,5,5,15,1991,1880,1636,-244
2018,5,5,16,2075,1887,1573,-314
2018,5,5,17,2113,1887,1573,-314
2018,5,5,18,2143,1895,1559,-336
2018,5,5,19,2165,1884,1529,-355
2018,5,5,20,2137,1866,1508,-358
2018,5,5,21,2139,1903,1571,-332
2018,5,5,22,2163,1989,1627,-362
2018,5,5,23,2193,2052,1719,-333
2018,5,6,0,2243,2132,1714,-418
2018,5,6,1,2252,2119,1732,-387
2018,5,6,2,2232,2133,1758,-375
2018,5,6,3,2198,2138,1733,-405
2018,5,6,4,2189,2136,1727,-409
2018,5,6,5,2107,2039,1767,-272
2018,5,6,6,1952,1913,1743,-170
2018,5,6,7,1864,1812,1581,-231
2018,5,6,8,1836,1733,1599,-134
2018,5,6,9,1738,1700,1661,-39
2018,5,6,10,1736,1675,1718,43
2018,5,6,11,1733,1672,1711,39
2018,5,6,12,1739,1680,1659,-21
2018,5,6,13,1774,1712,1654,-58
2018,5,6,14,1825,1661,1610,-51
2018,5,6,15,1914,1642,1622,-20
2018,5,6,16,1967,1677,1644,-33
2018,5,6,17,2045,1714,1636,-78
2018,5,6,18,2051,1745,1604,-141
2018,5,6,19,2097,1786,1591,-195
2018,5,6,20,2169,1839,1585,-254
2018,5,6,21,2196,1861,1604,-257
2018,5,6,22,2231,1936,1786,-150
2018,5,6,23,2287,2023,1914,-109
2018,5,7,0,2312,2014,1981,-33
2018,5,7,1,2334,2045,2074,29
2018,5,7,2,2305,2130,1942,-188
2018,5,7,3,2348,2160,1980,-180
2018,5,7,4,2303,2166,2089,-77
2018,5,7,5,2129,2037,2170,133
2018,5,7,6,1966,1866,2124,258
2018,5,7,7,1853,1766,2118,352
2018,5,7,8,1747,1685,1939,254
2018,5,7,9,1729,1661,1837,176
2018,5,7,10,1710,1645,1769,124
2018,5,7,11,1746,1649,1683,34
2018,5,7,12,1857,1760,1770,10
2018,5,7,13,1989,1901,1782,-119
2018,5,7,14,2106,1978,1865,-113
2018,5,7,15,2115,1905,1827,-78
2018,5,7,16,2133,1896,1850,-46
2018,5,7,17,2134,1951,1883,-68
2018,5,7,18,2146,1940,1808,-132
2018,5,7,19,2156,1962,1756,-206
2018,5,7,20,2193,1977,1774,-203
2018,5,7,21,2226,1997,1812,-185
2018,5,7,22,2240,2038,1990,-48
2018,5,7,23,2244,2054,1875,-179
2018,5,8,0,2241,2070,1872,-198
2018,5,8,1,2257,2117,2014,-103
2018,5,8,2,2260,2214,2102,-112
2018,5,8,3,2235,2318,1997,-321
2018,5,8,4,2232,2330,1988,-342
2018,5,8,5,2109,2159,1807,-352
2018,5,8,6,1940,1988,1673,-315
2018,5,8,7,1844,1859,1488,-371
2018,5,8,8,1778,1782,1267,-515
2018,5,8,9,1766,1753,1207,-546
2018,5,8,10,1751,1742,1136,-606
2018,5,8,11,1770,1748,1073,-675
2018,5,8,12,1845,1807,1108,-699
2018,5,8,13,1999,1953,1177,-776
2018,5,8,14,2114,2000,1363,-637
2018,5,8,15,2171,1907,1253,-654
2018,5,8,16,2218,1920,1267,-653
2018,5,8,17,2247,1950,1261,-689
2018,5,8,18,2271,1983,1275,-708
2018,5,8,19,2283,2018,1286,-732
2018,5,8,20,2303,2070,1321,-749
2018,5,8,21,2341,2098,1392,-706
2018,5,8,22,2372,2160,1541,-619
2018,5,8,23,2392,2239,1672,-567
2018,5,9,0,2418,2332,1729,-603
2018,5,9,1,2446,2366,1749,-617
2018,5,9,2,2446,2476,1723,-753
2018,5,9,3,2403,2556,1704,-852
2018,5,9,4,2380,2522,1718,-804
2018,5,9,5,2229,2341,1637,-704
2018,5,9,6,2047,2136,1478,-658
2018,5,9,7,1912,1976,1322,-654
2018,5,9,8,1877,1912,1331,-581
2018,5,9,9,1866,1845,1309,-536
2018,5,9,10,1847,1820,1260,-560
2018,5,9,11,1861,1814,1290,-524
2018,5,9,12,1934,1876,1407,-469
2018,5,9,13,2081,2014,1547,-467
2018,5,9,14,2200,2059,1393,-666
2018,5,9,15,2259,2028,1375,-653
2018,5,9,16,2303,2089,1362,-727
2018,5,9,17,2333,2141,1481,-660
2018,5,9,18,2361,2143,1508,-635
2018,5,9,19,2380,2207,1535,-672
2018,5,9,20,2407,2282,1581,-701
2018,5,9,21,2436,2271,1731,-540
2018,5,9,22,2458,2264,1834,-430
2018,5,9,23,2474,2274,1781,-493
2018,5,10,0,2478,2300,1799,-501
2018,5,10,1,2486,2338,1832,-506
2018,5,10,2,2464,2405,1883,-522
2018,5,10,3,2405,2415,1949,-466
2018,5,10,4,2386,2406,1878,-528
2018,5,10,5,2244,2257,1731,-526
2018,5,10,6,2052,2067,1689,-378
2018,5,10,7,1889,1956,1704,-252
2018,5,10,8,1830,1887,1698,-189
2018,5,10,9,1821,1845,1690,-155
2018,5,10,10,1797,1820,1703,-117
2018,5,10,11,1797,1822,1648,-174
2018,5,10,12,1866,1873,1704,-169
2018,5,10,13,2004,2017,1650,-367
2018,5,10,14,2124,2094,1731,-363
2018,5,10,15,2187,2047,1779,-268
2018,5,10,16,2219,2010,1737,-273
2018,5,10,17,2241,2052,1684,-368
2018,5,10,18,2263,2084,1669,-415
2018,5,10,19,2284,2074,1702,-372
2018,5,10,20,2305,2102,1745,-357
2018,5,10,21,2317,2099,1803,-296
2018,5,10,22,2336,2122,1899,-223
2018,5,10,23,2371,2134,1949,-185
2018,5,11,0,2397,2112,1964,-148
2018,5,11,1,2414,2084,1899,-185
2018,5,11,2,2390,2154,1932,-222
2018,5,11,3,2313,2255,1899,-356
2018,5,11,4,2310,2243,1973,-270
2018,5,11,5,2182,2128,1904,-224
2018,5,11,6,2002,1977,1870,-107
2018,5,11,7,1845,1866,1861,-5
2018,5,11,8,1805,1828,1821,-7
2018,5,11,9,1789,1808,1775,-33
2018,5,11,10,1767,1790,1851,61
2018,5,11,11,1771,1809,1838,29
2018,5,11,12,1837,1868,1652,-216
2018,5,11,13,1974,1981,1592,-389
2018,5,11,14,2095,2041,1752,-289
2018,5,11,15,2136,1962,1705,-257
2018,5,11,16,2161,1952,1701,-251
2018,5,11,17,2179,2010,1690,-320
2018,5,11,18,2206,2019,1744,-275
2018,5,11,19,2212,2017,1726,-291
2018,5,11,20,2226,1962,1729,-233
2018,5,11,21,2221,1928,1774,-154
2018,5,11,22,2238,1941,1840,-101
2018,5,11,23,2263,1957,1929,-28
2018,5,12,0,2211,1969,1939,-30
2018,5,12,1,2201,1914,1984,70
2018,5,12,2,2210,1939,1908,-31
2018,5,12,3,2178,2064,1901,-163
2018,5,12,4,2175,2093,1830,-263
2018,5,12,5,2091,1996,1609,-387
2018,5,12,6,1975,1876,1591,-285
2018,5,12,7,1868,1782,1512,-270
2018,5,12,8,1814,1716,1473,-243
2018,5,12,9,1741,1684,1427,-257
2018,5,12,10,1690,1668,1388,-280
2018,5,12,11,1679,1681,1378,-303
2018,5,12,12,1693,1716,1363,-353
2018,5,12,13,1756,1750,1353,-397
2018,5,12,14,1859,1785,1379,-406
2018,5,12,15,1964,1803,1318,-485
2018,5,12,16,2028,1792,1311,-481
2018,5,12,17,2062,1775,1424,-351
2018,5,12,18,2080,1736,1445,-291
2018,5,12,19,2092,1726,1504,-222
2018,5,12,20,2080,1674,1466,-208
2018,5,12,21,2053,1655,1573,-82
2018,5,12,22,2072,1634,1641,7
2018,5,12,23,2083,1652,1620,-32
2018,5,13,0,2108,1732,1998,266
2018,5,13,1,2109,1714,1816,102
2018,5,13,2,2112,1750,1853,103
2018,5,13,3,2119,1774,1902,128
2018,5,13,4,2106,1729,1732,3
2018,5,13,5,2031,1668,1688,20
2018,5,13,6,1900,1553,1524,-29
2018,5,13,7,1850,1471,1485,14
2018,5,13,8,1762,1434,1429,-5
2018,5,13,9,1577,1744,1644,-100
2018,5,13,10,1592,1451,1327,-124
2018,5,13,11,1624,1453,1332,-121
2018,5,13,12,1627,1473,1351,-122
2018,5,13,13,1644,1506,1390,-116
2018,5,13,14,1712,1536,1339,-197
2018,5,13,15,1767,1531,1259,-272
2018,5,13,16,1787,1515,1152,-363
2018,5,13,17,1834,1521,1360,-161
2018,5,13,18,1809,1473,1384,-89
2018,5,13,19,1837,1471,1310,-161
2018,5,13,20,1931,1390,1345,-45
2018,5,13,21,1944,1376,1346,-30
2018,5,13,22,1974,1382,1398,16
2018,5,13,23,2017,1394,1465,71
2018,5,14,0,2019,1357,1458,101
2018,5,14,1,2048,1434,1540,106
2018,5,14,2,2063,1518,1663,145
2018,5,14,3,2136,1618,1640,22
2018,5,14,4,2110,1666,1592,-74
2018,5,14,5,1969,1582,1490,-92
2018,5,14,6,1839,1450,1426,-24
2018,5,14,7,1827,2045,2069,24
2018,5,14,8,1609,1384,1221,-163
2018,5,14,9,1473,1376,1139,-237
2018,5,14,10,1466,1384,1184,-200
2018,5,14,11,1524,1414,1187,-227
2018,5,14,12,1641,1512,1216,-296
2018,5,14,13,1774,1678,1389,-289
2018,5,14,14,1909,1706,1448,-258
2018,5,14,15,1887,1592,1426,-166
2018,5,14,16,1869,1578,1426,-152
2018,5,14,17,1859,1581,1473,-108
2018,5,14,18,1860,1582,1448,-134
2018,5,14,19,1879,1587,1439,-148
2018,5,14,20,1944,1596,1429,-167
2018,5,14,21,1985,1622,1434,-188
2018,5,14,22,2019,1639,1491,-148
2018,5,14,23,2040,1662,1497,-165
2018,5,15,0,2025,1693,1564,-129
2018,5,15,1,2068,1720,1623,-97
2018,5,15,2,2113,1835,1646,-189
2018,5,15,3,2103,1947,1657,-290
2018,5,15,4,2082,1963,1770,-193
2018,5,15,5,1958,1841,1698,-143
2018,5,15,6,1788,1663,1659,-4
2018,5,15,7,1816,1553,1666,113
2018,5,15,8,1644,1483,1541,58
2018,5,15,9,1530,1454,1486,32
2018,5,15,10,1521,1439,1484,45
2018,5,15,11,1554,1462,1630,168
2018,5,15,12,1631,1537,1652,115
2018,5,15,13,1783,1657,1662,5
2018,5,15,14,1889,1685,1662,-23
2018,5,15,15,1862,1606,1639,33
2018,5,15,16,1873,1625,1602,-23
2018,5,15,17,1893,1665,1604,-61
2018,5,15,18,1910,1655,1614,-41
2018,5,15,19,1924,1700,1632,-68
2018,5,15,20,1962,1761,1628,-133
2018,5,15,21,1976,1771,1684,-87
2018,5,15,22,1979,1763,1724,-39
2018,5,15,23,1987,1817,1762,-55
2018,5,16,0,1963,1839,1863,24
2018,5,16,1,1976,1849,1811,-38
2018,5,16,2,2005,1897,1773,-124
2018,5,16,3,1991,1914,1763,-151
2018,5,16,4,1990,1933,1899,-34
2018,5,16,5,1872,1829,1918,89
2018,5,16,6,1712,1674,1834,160
2018,5,16,7,1701,1575,1526,-49
2018,5,16,8,1561,1559,1736,177
2018,5,16,9,1533,1533,1744,211
2018,5,16,10,1518,1522,1714,192
2018,5,16,11,1539,1545,1727,182
2018,5,16,12,1607,1622,1682,60
2018,5,16,13,1750,1762,1685,-77
2018,5,16,14,1855,1809,1669,-140
2018,5,16,15,1875,1732,1638,-94
2018,5,16,16,1908,1777,1732,-45
2018,5,16,17,1933,1733,1713,-20
2018,5,16,18,1947,1733,1746,13
2018,5,16,19,1965,1766,1757,-9
2018,5,16,20,1981,1800,1753,-47
2018,5,16,21,1994,1857,1798,-59
2018,5,16,22,1999,1888,1884,-4
2018,5,16,23,2041,1937,1912,-25
2018,5,17,0,2060,2019,2058,39
2018,5,17,1,2079,2065,2153,88
2018,5,17,2,2088,2055,1988,-67
2018,5,17,3,2061,2031,1896,-135
2018,5,17,4,2053,2016,1915,-101
2018,5,17,5,1910,1888,1889,1
2018,5,17,6,1744,1761,1888,127
2018,5,17,7,1617,1668,1898,230
2018,5,17,8,1590,1628,1928,300
2018,5,17,9,1613,1586,1793,207
2018,5,17,10,1599,1571,1746,175
2018,5,17,11,1617,1593,1955,362
2018,5,17,12,1694,1684,2028,344
2018,5,17,13,1843,1829,1951,122
2018,5,17,14,1946,1891,1942,51
2018,5,17,15,1976,1834,1854,20
2018,5,17,16,2005,1829,1947,118
2018,5,17,17,2024,1854,1947,93
2018,5,17,18,2049,1809,1958,149
2018,5,17,19,2048,1802,1985,183
2018,5,17,20,2045,1806,2025,219
2018,5,17,21,2052,1891,2149,258
2018,5,17,22,2064,1928,2181,253
2018,5,17,23,2079,1964,2153,189
2018,5,18,0,2100,1935,2204,269
2018,5,18,1,2096,1984,2236,252
2018,5,18,2,2095,1983,2234,251
2018,5,18,3,2064,1993,2163,170
2018,5,18,4,2065,1990,2164,174
2018,5,18,5,1957,1909,2170,261
2018,5,18,6,1800,1761,2096,335
2018,5,18,7,1614,1686,2052,366
2018,5,18,8,1626,1646,1986,340
2018,5,18,9,1608,1620,1950,330
2018,5,18,10,1590,1616,1930,314
2018,5,18,11,1610,1630,1937,307
2018,5,18,12,1690,1708,1963,255
2018,5,18,13,1839,1825,2002,177
2018,5,18,14,1946,1902,1991,89
2018,5,18,15,1972,1907,1971,64
2018,5,18,16,1995,1894,1953,59
2018,5,18,17,2011,1865,1967,102
2018,5,18,18,2033,1808,1907,99
2018,5,18,19,2040,1788,1891,103
2018,5,18,20,2056,1813,1906,93
2018,5,18,21,2080,1826,1930,104
2018,5,18,22,2114,1835,1983,148
2018,5,18,23,2149,1854,2060,206
2018,5,19,0,2130,1879,2128,249
2018,5,19,1,2134,1886,2142,256
2018,5,19,2,2134,1930,2067,137
2018,5,19,3,2087,2013,1979,-34
2018,5,19,4,2059,2024,1953,-71
2018,5,19,5,1953,1951,1943,-8
2018,5,19,6,1822,1810,1921,111
2018,5,19,7,1697,1709,1899,190
2018,5,19,8,1639,1658,1910,252
2018,5,19,9,1604,1640,1961,321
2018,5,19,10,1548,1615,1951,336
2018,5,19,11,1530,1620,1966,346
2018,5,19,12,1551,1639,1988,349
2018,5,19,13,1614,1673,1997,324
2018,5,19,14,1705,1646,1958,312
2018,5,19,15,1829,1594,1797,203
2018,5,19,16,1914,1619,1706,87
2018,5,19,17,1961,1640,1684,44
2018,5,19,18,2000,1669,1841,172
2018,5,19,19,2034,1714,1831,117
2018,5,19,20,2028,1751,1853,102
2018,5,19,21,2039,1798,1819,21
2018,5,19,22,2077,1854,1841,-13
2018,5,19,23,2117,1950,1838,-112
2018,5,20,0,2162,2019,1855,-164
2018,5,20,1,2185,2048,1948,-100
2018,5,20,2,2172,2028,1985,-43
2018,5,20,3,2133,2036,1972,-64
2018,5,20,4,2096,2051,1998,-53
2018,5,20,5,2015,1967,1924,-43
2018,5,20,6,1858,1833,1958,125
2018,5,20,7,1716,1739,1980,241
2018,5,20,8,1661,1673,1932,259
2018,5,20,9,1644,1643,1989,346
2018,5,20,10,1638,1639,2017,378
2018,5,20,11,1627,1631,2076,445
2018,5,20,12,1638,1658,2090,432
2018,5,20,13,1659,1676,2079,403
2018,5,20,14,1708,1688,2004,316
2018,5,20,15,1803,1744,1962,218
2018,5,20,16,1858,1770,1899,129
2018,5,20,17,1920,1780,1855,75
2018,5,20,18,1922,1763,1867,104
2018,5,20,19,1950,1743,1852,109
2018,5,20,20,1987,1760,1850,90
2018,5,20,21,2008,1848,1992,144
2018,5,20,22,2041,1872,2109,237
2018,5,20,23,2088,1767,1928,161
2018,5,21,0,2103,1851,1918,67
2018,5,21,1,2124,1885,1928,43
2018,5,21,2,2086,1986,1929,-57
2018,5,21,3,2075,2002,2012,10
2018,5,21,4,2072,1974,2154,180
2018,5,21,5,1957,1881,2032,151
2018,5,21,6,1811,1736,1945,209
2018,5,21,7,1656,1654,1956,302
2018,5,21,8,1598,1620,1922,302
2018,5,21,9,1605,1601,1929,328
2018,5,21,10,1602,1590,1934,344
2018,5,21,11,1634,1612,1936,324
2018,5,21,12,1743,1701,1930,229
2018,5,21,13,1872,1826,1948,122
2018,5,21,14,1988,1870,1938,68
2018,5,21,15,2030,1784,1937,153
2018,5,21,16,2061,1795,1922,127
2018,5,21,17,2087,1820,1760,-60
2018,5,21,18,2119,1876,1659,-217
2018,5,21,19,2138,1877,1555,-322
2018,5,21,20,2177,1896,1330,-566
2018,5,21,21,2218,1905,1265,-640
2018,5,21,22,2247,1937,1267,-670
2018,5,21,23,2284,1991,1507,-484
2018,5,22,0,2309,2055,1620,-435
2018,5,22,1,2321,2080,1688,-392
2018,5,22,2,2318,2112,1769,-343
2018,5,22,3,2276,2198,1892,-306
2018,5,22,4,2242,2187,1850,-337
2018,5,22,5,2117,2067,1867,-200
2018,5,22,6,1939,1861,1819,-42
2018,5,22,7,1805,1748,1808,60
2018,5,22,8,1760,1671,1671,0
2018,5,22,9,1680,1636,1625,-11
2018,5,22,10,1667,1605,1634,29
2018,5,22,11,1688,1616,1631,15
2018,5,22,12,1760,1687,1639,-48
2018,5,22,13,1891,1806,1661,-145
2018,5,22,14,1999,1874,1621,-253
2018,5,22,15,2029,1876,1611,-265
2018,5,22,16,2064,1874,1568,-306
2018,5,22,17,2091,1905,1560,-345
2018,5,22,18,2125,1910,1567,-343
2018,5,22,19,2154,1921,1575,-346
2018,5,22,20,2194,1984,1521,-463
2018,5,22,21,2222,2093,1649,-444
2018,5,22,22,2252,2100,1697,-403
2018,5,22,23,2270,2127,1806,-321
2018,5,23,0,2280,2127,1906,-221
2018,5,23,1,2264,2205,2017,-188
2018,5,23,2,2233,2189,1919,-270
2018,5,23,3,2191,2225,1950,-275
2018,5,23,4,2169,2187,1790,-397
2018,5,23,5,2045,2057,1764,-293
2018,5,23,6,1865,1890,1633,-257
2018,5,23,7,1795,1762,1578,-184
2018,5,23,8,1704,1686,1563,-123
2018,5,23,9,1693,1638,1541,-97
2018,5,23,10,1679,1622,1472,-150
2018,5,23,11,1694,1617,1474,-143
2018,5,23,12,1767,1684,1502,-182
2018,5,23,13,1899,1802,1562,-240
2018,5,23,14,2014,1889,1661,-228
2018,5,23,15,2079,1924,1649,-275
2018,5,23,16,2127,1925,1650,-275
2018,5,23,17,2167,1919,1652,-267
2018,5,23,18,2205,1888,1650,-238
2018,5,23,19,2239,1911,1588,-323
2018,5,23,20,2275,1991,1585,-406
2018,5,23,21,2319,2003,1584,-419
2018,5,23,22,2343,2076,1624,-452
2018,5,23,23,2378,2195,1611,-584
2018,5,24,0,2415,2242,1668,-574
2018,5,24,1,2427,2202,1745,-457
2018,5,24,2,2386,2184,1707,-477
2018,5,24,3,2308,2161,1724,-437
2018,5,24,4,2263,2181,1670,-511
2018,5,24,5,2138,2074,1672,-402
2018,5,24,6,1953,1910,1730,-180
2018,5,24,7,1801,1782,1543,-239
2018,5,24,8,1728,1719,1619,-100
2018,5,24,9,1709,1675,1616,-59
2018,5,24,10,1684,1644,1487,-157
2018,5,24,11,1695,1655,1501,-154
2018,5,24,12,1759,1724,1497,-227
2018,5,24,13,1880,1840,1581,-259
2018,5,24,14,2010,1883,1566,-317
2018,5,24,15,2088,1890,1600,-290
2018,5,24,16,2149,1901,1595,-306
2018,5,24,17,2198,1897,1594,-303
2018,5,24,18,2240,1950,1595,-355
2018,5,24,19,2288,1989,1587,-402
2018,5,24,20,2342,2037,1397,-640
2018,5,24,21,2397,2124,1613,-511
2018,5,24,22,2438,2216,1685,-531
2018,5,24,23,2474,2261,1672,-589
2018,5,25,0,2483,2285,1676,-609
2018,5,25,1,2477,2301,1826,-475
2018,5,25,2,2442,2398,2020,-378
2018,5,25,3,2409,2441,2064,-377
2018,5,25,4,2372,2427,2059,-368
2018,5,25,5,2235,2280,2013,-267
2018,5,25,6,2039,2076,1952,-124
2018,5,25,7,1864,1941,1949,8
2018,5,25,8,1788,1854,1930,76
2018,5,25,9,1800,1815,2002,187
2018,5,25,10,1766,1762,2040,278
2018,5,25,11,1760,1766,2059,293
2018,5,25,12,1820,1810,2099,289
2018,5,25,13,1942,1884,2072,188
2018,5,25,14,2074,1910,1988,78
2018,5,25,15,2165,1861,1973,112
2018,5,25,16,2248,1925,1968,43
2018,5,25,17,2320,1988,1979,-9
2018,5,25,18,2397,2047,1915,-132
2018,5,25,19,2470,2105,1872,-233
2018,5,25,20,2546,2211,1967,-244
2018,5,25,21,2635,2269,1991,-278
2018,5,25,22,2690,2316,2026,-290
2018,5,25,23,2754,2359,2076,-283
2018,5,26,0,2750,2389,2120,-269
2018,5,26,1,2739,2427,2209,-218
2018,5,26,2,2672,2415,2162,-253
2018,5,26,3,2512,2307,2324,17
2018,5,26,4,2416,2247,2416,169
2018,5,26,5,2288,2141,2392,251
2018,5,26,6,2119,2004,2510,514
2018,5,26,7,1887,1888,2533,645
2018,5,26,8,1792,1801,2457,656
2018,5,26,9,1749,1746,2329,583
2018,5,26,10,1686,1717,2352,635
2018,5,26,11,1656,1689,2295,606
2018,5,26,12,1661,1690,2231,541
2018,5,26,13,1692,1708,2164,456
2018,5,26,14,1790,1694,2208,514
2018,5,26,15,1942,1676,2285,609
2018,5,26,16,2038,1755,2315,560
2018,5,26,17,2077,1776,2363,587
2018,5,26,18,2111,1812,2361,549
2018,5,26,19,2150,1844,2366,522
2018,5,26,20,2149,1859,2384,525
2018,5,26,21,2173,1879,2446,567
2018,5,26,22,2200,1879,2440,561
2018,5,26,23,2217,1942,2464,522
2018,5,27,0,2208,1905,2438,533
2018,5,27,1,2180,1943,2318,375
2018,5,27,2,2129,1940,2301,361
2018,5,27,3,2072,1949,2257,308
2018,5,27,4,2073,1951,2195,244
2018,5,27,5,2016,1898,2085,187
2018,5,27,6,1884,1786,2031,245
2018,5,27,7,1756,1698,2034,336
2018,5,27,8,1694,1641,2094,453
2018,5,27,9,1660,1631,2047,416
2018,5,27,10,1656,1620,2056,436
2018,5,27,11,1648,1610,2072,462
2018,5,27,12,1653,1609,2102,493
2018,5,27,13,1654,1610,2141,531
2018,5,27,14,1713,1539,2113,574
2018,5,27,15,1821,1473,1931,458
2018,5,27,16,1889,1486,1893,407
2018,5,27,17,1954,1548,2095,547
2018,5,27,18,1971,1520,2068,548
2018,5,27,19,2012,1570,2060,490
2018,5,27,20,2056,1595,2031,436
2018,5,27,21,2090,1637,2083,446
2018,5,27,22,2130,1656,2080,424
2018,5,27,23,2175,1704,2048,344
2018,5,28,0,2171,1774,2183,409
2018,5,28,1,2188,1834,2158,324
2018,5,28,2,2164,1923,2194,271
2018,5,28,3,2147,1940,2081,141
2018,5,28,4,2134,1933,1983,50
2018,5,28,5,2024,1859,1997,138
2018,5,28,6,1879,1722,1984,262
2018,5,28,7,1754,1618,2003,385
2018,5,28,8,1699,1546,1992,446
2018,5,28,9,1626,1515,1972,457
2018,5,28,10,1609,1515,1980,465
2018,5,28,11,1642,1535,2007,472
2018,5,28,12,1738,1558,2013,455
2018,5,28,13,1861,1595,2008,413
2018,5,28,14,1992,1618,2014,396
2018,5,28,15,2034,1638,1970,332
2018,5,28,16,2063,1703,1955,252
2018,5,28,17,2087,1769,1970,201
2018,5,28,18,2115,1787,1933,146
2018,5,28,19,2143,1803,2015,212
2018,5,28,20,2190,1789,2024,235
2018,5,28,21,2236,1814,2054,240
2018,5,28,22,2274,1859,2107,248
2018,5,28,23,2304,1919,2253,334
2018,5,29,0,2341,1995,2344,349
2018,5,29,1,2361,2037,2225,188
2018,5,29,2,2346,2120,2065,-55
2018,5,29,3,2298,2200,2018,-182
2018,5,29,4,2276,2198,1973,-225
2018,5,29,5,2152,2091,1997,-94
2018,5,29,6,1982,1877,1986,109
2018,5,29,7,1930,1741,1966,225
2018,5,29,8,1791,1659,1996,337
2018,5,29,9,1693,1625,2115,490
2018,5,29,10,1666,1600,2153,553
2018,5,29,11,1677,1593,2116,523
2018,5,29,12,1717,1655,2079,424
2018,5,29,13,1804,1761,2044,283
2018,5,29,14,1903,1796,1883,87
2018,5,29,15,1927,1827,2005,178
2018,5,29,16,1981,1845,1979,134
2018,5,29,17,2033,1890,1965,75
2018,5,29,18,2075,1929,1950,21
2018,5,29,19,2118,1996,1997,1
2018,5,29,20,2160,2638,2580,-58
2018,5,29,21,2205,2114,1966,-148
2018,5,29,22,2245,2180,1944,-236
2018,5,29,23,2293,2231,1957,-274
2018,5,30,0,2326,2290,1963,-327
2018,5,30,1,2354,2358,2022,-336
2018,5,30,2,2348,2453,2037,-416
2018,5,30,3,2314,2506,2048,-458
2018,5,30,4,2254,2484,2085,-399
2018,5,30,5,2126,2320,2140,-180
2018,5,30,6,1938,2127,2198,71
2018,5,30,7,1872,1965,2207,242
2018,5,30,8,1774,1884,2254,370
2018,5,30,9,1824,1838,2214,376
2018,5,30,10,1803,1789,2183,394
2018,5,30,11,1796,1793,2311,518
2018,5,30,12,1839,1852,2252,400
2018,5,30,13,1927,1936,2257,321
2018,5,30,14,2048,1987,2163,176
2018,5,30,15,2126,1959,2075,116
2018,5,30,16,2185,1998,2088,90
2018,5,30,17,2232,2036,2069,33
2018,5,30,18,2274,2060,2013,-47
2018,5,30,19,2298,2141,2110,-31
2018,5,30,20,2311,2133,2091,-42
2018,5,30,21,2327,2177,2053,-124
2018,5,30,22,2344,2264,2129,-135
2018,5,30,23,2393,2236,2177,-59
2018,5,31,0,2439,2305,2161,-144
2018,5,31,1,2451,2342,2240,-102
2018,5,31,2,2403,2327,2361,34
2018,5,31,3,2307,2289,2408,119
2018,5,31,4,2298,2263,2319,56
2018,5,31,5,2214,2150,2408,258
2018,5,31,6,2041,1989,2445,456
2018,5,31,7,1795,1871,2457,586
2018,5,31,8,1794,1784,2430,646
2018,5,31,9,1793,1751,2363,612
2018,5,31,10,1770,1727,2301,574
2018,5,31,11,1770,1743,2284,541
2018,5,31,12,1825,1805,2241,436
2018,5,31,13,1927,1908,2197,289
2018,5,31,14,2069,1986,2163,177
2018,5,31,15,2159,2025,2105,80
2018,5,31,16,2226,3073,3057,-16
2018,5,31,17,2275,2116,2076,-40
2018,5,31,18,2306,2108,2045,-63
2018,5,31,19,2331,3254,3151,-103
2018,5,31,20,2335,2048,1855,-193
2018,5,31,21,2343,2042,2047,5
2018,5,31,22,2338,2000,2119,119
2018,5,31,23,2338,1969,2032,63
2018,6,1,0,2325,2021,1856,-165
2018,6,1,1,2302,2073,2056,-17
2018,6,1,2,2249,2062,2092,30
2018,6,1,3,2193,2077,2091,14
2018,6,1,4,2176,2058,2166,108
2018,6,1,5,2090,1989,2271,282
2018,6,1,6,1936,1860,2301,441
2018,6,1,7,1782,1744,2150,406
2018,6,1,8,1733,1703,2174,471
2018,6,1,9,1662,1681,2096,415
2018,6,1,10,1638,1661,2167,506
2018,6,1,11,1655,1660,2138,478
2018,6,1,12,1712,1727,2137,410
2018,6,1,13,1814,1813,2139,326
2018,6,1,14,1946,1797,2177,380
2018,6,1,15,2025,1728,2117,389
2018,6,1,16,2071,1733,2052,319
2018,6,1,17,2112,1739,2266,527
2018,6,1,18,2133,1728,2201,473
2018,6,1,19,2142,1714,2325,611
2018,6,1,20,2147,1702,2203,501
2018,6,1,21,2172,1692,2229,537
2018,6,1,22,2182,1689,2213,524
2018,6,1,23,2199,1701,2228,527
2018,6,2,0,2153,1703,2226,523
2018,6,2,1,2140,1731,2218,487
2018,6,2,2,2123,1788,2185,397
2018,6,2,3,2081,1902,2071,169
2018,6,2,4,2074,1942,2025,83
2018,6,2,5,2006,1898,2023,125
2018,6,2,6,1882,1778,2010,232
2018,6,2,7,1834,1685,1981,296
2018,6,2,8,1754,1622,1958,336
2018,6,2,9,1617,1607,1962,355
2018,6,2,10,1573,1601,1959,358
2018,6,2,11,1567,1582,1954,372
2018,6,2,12,1582,1595,1957,362
2018,6,2,13,1613,1611,1971,360
2018,6,2,14,1720,1603,1991,388
2018,6,2,15,1872,1581,1776,195
2018,6,2,16,1958,1623,1878,255
2018,6,2,17,2018,1671,1974,303
2018,6,2,18,2048,1654,1978,324
2018,6,2,19,2084,1676,1972,296
2018,6,2,20,2083,1700,1978,278
2018,6,2,21,2114,1722,1971,249
2018,6,2,22,2155,1775,1972,197
2018,6,2,23,2189,1837,1992,155
2018,6,3,0,2245,1891,1978,87
2018,6,3,1,2283,1964,1985,21
2018,6,3,2,2292,2026,1981,-45
2018,6,3,3,2258,2127,1989,-138
2018,6,3,4,2196,2134,1992,-142
2018,6,3,5,2102,2046,1988,-58
2018,6,3,6,1934,1892,1984,92
2018,6,3,7,1893,1743,1957,214
2018,6,3,8,1782,1658,1944,286
2018,6,3,9,1652,1618,1969,351
2018,6,3,10,1641,1592,1985,393
2018,6,3,11,1632,1588,2028,440
2018,6,3,12,1625,1586,2058,472
2018,6,3,13,1617,1575,2068,493
2018,6,3,14,1679,1518,1984,466
2018,6,3,15,1792,1492,1764,272
2018,6,3,16,1880,1553,1865,312
2018,6,3,17,1988,1635,2055,420
2018,6,3,18,2034,1674,2045,371
2018,6,3,19,2103,1758,2055,297
2018,6,3,20,2185,1818,2065,247
2018,6,3,21,2263,1898,2036,138
2018,6,3,22,2344,1991,2035,44
2018,6,3,23,2459,2100,2030,-70
2018,6,4,0,2575,2217,2026,-191
2018,6,4,1,2645,2299,2101,-198
2018,6,4,2,2645,2333,2159,-174
2018,6,4,3,2596,2334,2130,-204
2018,6,4,4,2463,2310,2187,-123
2018,6,4,5,2282,2203,2249,46
2018,6,4,6,2071,2028,2318,290
2018,6,4,7,1936,1873,2206,333
2018,6,4,8,1857,1796,2201,405
2018,6,4,9,1771,1731,2176,445
2018,6,4,10,1738,1695,2215,520
2018,6,4,11,1748,1697,2170,473
2018,6,4,12,1815,1754,2161,407
2018,6,4,13,1911,1863,2120,257
2018,6,4,14,2028,1931,2063,132
2018,6,4,15,2145,1963,2050,87
2018,6,4,16,2198,2040,2042,2
2018,6,4,17,2258,2145,2035,-110
2018,6,4,18,2315,2231,2072,-159
2018,6,4,19,2371,2323,2131,-192
2018,6,4,20,2439,2404,2092,-312
2018,6,4,21,2523,2503,2104,-399
2018,6,4,22,2595,2553,2139,-414
2018,6,4,23,2674,2620,2217,-403
2018,6,5,0,2741,2646,2286,-360
2018,6,5,1,2778,2694,2240,-454
2018,6,5,2,2768,2722,2220,-502
2018,6,5,3,2698,2739,2375,-364
2018,6,5,4,2597,2667,2494,-173
2018,6,5,5,2430,2495,2488,-7
2018,6,5,6,2190,2262,2517,255
2018,6,5,7,1967,2090,2366,276
2018,6,5,8,1864,1991,2324,333
2018,6,5,9,1882,1933,2357,424
2018,6,5,10,1825,1885,2293,408
2018,6,5,11,1810,1870,2220,350
2018,6,5,12,1857,1926,2194,268
2018,6,5,13,1969,1999,2138,139
2018,6,5,14,2128,2021,2079,58
2018,6,5,15,2201,2014,2065,51
2018,6,5,16,2275,2055,2044,-11
2018,6,5,17,2347,2136,2046,-90
2018,6,5,18,2412,2184,2016,-168
2018,6,5,19,2467,2246,1991,-255
2018,6,5,20,2517,2323,2007,-316
2018,6,5,21,2589,2356,1979,-377
2018,6,5,22,2660,2411,1983,-428
2018,6,5,23,2696,2481,1981,-500
2018,6,6,0,2720,2564,1998,-566
2018,6,6,1,2742,2620,1998,-622
2018,6,6,2,2713,2683,1997,-686
2018,6,6,3,2646,2691,2005,-686
2018,6,6,4,2538,2655,2040,-615
2018,6,6,5,2423,2517,2016,-501
2018,6,6,6,2219,2306,2012,-294
2018,6,6,7,1934,2151,2011,-140
2018,6,6,8,1938,2076,2038,-38
2018,6,6,9,1986,2018,2034,16
2018,6,6,10,1928,1980,2015,35
2018,6,6,11,1913,1968,2013,45
2018,6,6,12,1959,2012,2000,-12
2018,6,6,13,2055,2097,1988,-109
2018,6,6,14,2218,2125,1974,-151
2018,6,6,15,2332,2153,1932,-221
2018,6,6,16,2418,2245,1961,-284
2018,6,6,17,2509,2248,1941,-307
2018,6,6,18,2588,2327,1941,-386
2018,6,6,19,2666,2396,1932,-464
2018,6,6,20,2750,2565,2027,-538
2018,6,6,21,2836,2570,2053,-517
2018,6,6,22,2907,2662,2062,-600
2018,6,6,23,2980,2739,2075,-664
2018,6,7,0,3046,2798,2067,-731
2018,6,7,1,3078,2921,2067,-854
2018,6,7,2,3054,2964,2072,-892
2018,6,7,3,2956,2918,2187,-731
2018,6,7,4,2867,2840,2344,-496
2018,6,7,5,2702,2679,2323,-356
2018,6,7,6,2483,2460,2226,-234
2018,6,7,7,2176,2307,2059,-248
2018,6,7,8,2145,2205,1965,-240
2018,6,7,9,2153,2151,1945,-206
2018,6,7,10,2091,2106,2022,-84
2018,6,7,11,2056,2070,2022,-48
2018,6,7,12,2116,2124,2035,-89
2018,6,7,13,2214,2227,2060,-167
2018,6,7,14,2379,2320,1992,-328
2018,6,7,15,2491,2347,1818,-529
2018,6,7,16,2593,2340,1782,-558
2018,6,7,17,2670,2369,1786,-583
2018,6,7,18,2740,2464,1799,-665
2018,6,7,19,2813,2559,1927,-632
2018,6,7,20,2885,2639,1991,-648
2018,6,7,21,2956,2747,1930,-817
2018,6,7,22,3016,2820,1942,-878
2018,6,7,23,3049,2791,2116,-675
2018,6,8,0,3062,2818,2145,-673
2018,6,8,1,2999,2735,2101,-634
2018,6,8,2,2902,2651,2355,-296
2018,6,8,3,2808,2672,2097,-575
2018,6,8,4,2750,2650,1918,-732
2018,6,8,5,2626,2546,1812,-734
2018,6,8,6,2418,2390,1827,-563
2018,6,8,7,2154,2256,1828,-428
2018,6,8,8,2090,2159,1729,-430
2018,6,8,9,2117,2085,1677,-408
2018,6,8,10,2062,2045,1653,-392
2018,6,8,11,2030,2039,1669,-370
2018,6,8,12,2067,2054,1716,-338
2018,6,8,13,2172,2132,1707,-425
2018,6,8,14,2326,2150,1793,-357
2018,6,8,15,2453,2137,1734,-403
2018,6,8,16,2550,2182,1841,-341
2018,6,8,17,2633,2230,1832,-398
2018,6,8,18,2735,2273,1860,-413
2018,6,8,19,2802,2300,1859,-441
2018,6,8,20,2858,2362,1854,-508
2018,6,8,21,2944,2397,1872,-525
2018,6,8,22,2992,2459,1904,-555
2018,6,8,23,3048,2472,1915,-557
2018,6,9,0,2970,2548,1976,-572
2018,6,9,1,2961,2579,1963,-616
2018,6,9,2,2963,2630,1948,-682
2018,6,9,3,2912,2676,1977,-699
2018,6,9,4,2868,2639,1888,-751
2018,6,9,5,2743,2498,1920,-578
2018,6,9,6,2586,2296,1911,-385
2018,6,9,7,2331,2135,1922,-213
2018,6,9,8,2263,1994,1809,-185
2018,6,9,9,2218,1894,1764,-130
2018,6,9,10,2136,1832,1770,-62
2018,6,9,11,2069,1804,1914,110
2018,6,9,12,2045,1838,1933,95
2018,6,9,13,2050,1835,1933,98
2018,6,9,14,2168,1835,1921,86
2018,6,9,15,2339,1872,1643,-229
2018,6,9,16,2455,1961,1767,-194
2018,6,9,17,2511,2051,1723,-328
2018,6,9,18,2576,2119,1701,-418
2018,6,9,19,2626,2147,1731,-416
2018,6,9,20,2651,2119,1781,-338
2018,6,9,21,2681,2107,1977,-130
2018,6,9,22,2697,2208,2048,-160
2018,6,9,23,2690,2352,1997,-355
2018,6,10,0,2703,2364,1993,-371
2018,6,10,1,2662,2380,2105,-275
2018,6,10,2,2604,2407,2179,-228
2018,6,10,3,2503,2386,2164,-222
2018,6,10,4,2396,2365,2139,-226
2018,6,10,5,2297,2279,2047,-232
2018,6,10,6,2146,2153,2134,-19
2018,6,10,7,1998,2037,2103,66
2018,6,10,8,1904,1978,2093,115
2018,6,10,9,1908,1922,2070,148
2018,6,10,10,1866,1882,2043,161
2018,6,10,11,1811,1850,1905,55
2018,6,10,12,1787,1859,1782,-77
2018,6,10,13,1770,1855,1726,-129
2018,6,10,14,1819,1831,1770,-61
2018,6,10,15,1918,1845,1720,-125
2018,6,10,16,1984,1846,1633,-213
2018,6,10,17,2042,1848,1564,-284
2018,6,10,18,2069,1846,1531,-315
2018,6,10,19,2086,1871,1743,-128
2018,6,10,20,2101,1844,1843,-1
2018,6,10,21,2120,1817,1798,-19
2018,6,10,22,2135,1809,1640,-169
2018,6,10,23,2159,1856,1785,-71
2018,6,11,0,2218,1898,1846,-52
2018,6,11,1,2235,1942,1813,-129
2018,6,11,2,2234,2003,1899,-104
2018,6,11,3,2250,2090,1872,-218
2018,6,11,4,2238,2141,1768,-373
2018,6,11,5,2154,2093,1739,-354
2018,6,11,6,2047,1985,1755,-230
2018,6,11,7,1875,1885,1688,-197
2018,6,11,8,1929,1839,1541,-298
2018,6,11,9,1844,1831,1521,-310
2018,6,11,10,1819,1820,1530,-290
2018,6,11,11,1835,1829,1554,-275
2018,6,11,12,1912,1904,1566,-338
2018,6,11,13,2022,2013,1540,-473
2018,6,11,14,2173,2109,1538,-571
2018,6,11,15,2296,2091,1543,-548
2018,6,11,16,2335,2099,1650,-449
2018,6,11,17,2367,2155,1834,-321
2018,6,11,18,2406,2131,2020,-111
2018,6,11,19,2421,2148,2115,-33
2018,6,11,20,2447,2154,2174,20
2018,6,11,21,2476,2156,2197,41
2018,6,11,22,2492,2137,2261,124
2018,6,11,23,2501,2118,2276,158
2018,6,12,0,2514,2146,2353,207
2018,6,12,1,2522,2180,2396,216
2018,6,12,2,2528,2231,2305,74
2018,6,12,3,2500,2349,2198,-151
2018,6,12,4,2462,2410,2023,-387
2018,6,12,5,2369,2333,1933,-400
2018,6,12,6,2217,2181,1890,-291
2018,6,12,7,2160,2076,1850,-226
2018,6,12,8,2058,2005,1715,-290
2018,6,12,9,1994,1954,1619,-335
2018,6,12,10,1968,1930,1651,-279
2018,6,12,11,1967,1926,1592,-334
2018,6,12,12,2024,1982,1598,-384
2018,6,12,13,2145,2052,1591,-461
2018,6,12,14,2281,2071,1602,-469
2018,6,12,15,2323,2052,1617,-435
2018,6,12,16,2374,2098,1615,-483
2018,6,12,17,2415,2124,1614,-510
2018,6,12,18,2461,2162,1621,-541
2018,6,12,19,2501,2190,1639,-551
2018,6,12,20,2551,2222,1690,-532
2018,6,12,21,2595,2264,1729,-535
2018,6,12,22,2634,2298,1780,-518
2018,6,12,23,2667,2327,1780,-547
2018,6,13,0,2718,2395,1792,-603
2018,6,13,1,2770,2478,1810,-668
2018,6,13,2,2799,2573,1807,-766
2018,6,13,3,2777,2676,1762,-914
2018,6,13,4,2714,2675,1748,-927
2018,6,13,5,2578,2548,1734,-814
2018,6,13,6,2381,2339,1678,-661
2018,6,13,7,2252,2187,1598,-589
2018,6,13,8,2178,2068,1472,-596
2018,6,13,9,2100,1955,1486,-469
2018,6,13,10,2064,1898,1439,-459
2018,6,13,11,2055,1903,1461,-442
2018,6,13,12,2105,1943,1504,-439
2018,6,13,13,2209,2024,1538,-486
2018,6,13,14,2359,2045,1560,-485
2018,6,13,15,2457,2102,1530,-572
2018,6,13,16,2547,2168,1497,-671
2018,6,13,17,2636,2245,1505,-740
2018,6,13,18,2739,2331,1452,-879
2018,6,13,19,2842,2419,1541,-878
2018,6,13,20,2936,2515,1572,-943
2018,6,13,21,3017,2608,1631,-977
2018,6,13,22,3051,2689,1652,-1037
2018,6,13,23,3068,2768,1761,-1007
2018,6,14,0,3092,2841,1765,-1076
2018,6,14,1,3121,2921,1763,-1158
2018,6,14,2,3130,3013,1746,-1267
2018,6,14,3,3066,3097,1822,-1275
2018,6,14,4,2992,3038,1711,-1327
2018,6,14,5,2823,2880,1778,-1102
2018,6,14,6,2587,2642,1859,-783
2018,6,14,7,2396,2456,1867,-589
2018,6,14,8,2274,2339,2008,-331
2018,6,14,9,2212,2236,2082,-154
2018,6,14,10,2142,2161,1984,-177
2018,6,14,11,2106,2130,2065,-65
2018,6,14,12,2134,2155,2026,-129
2018,6,14,13,2223,2211,1986,-225
2018,6,14,14,2354,2213,1979,-234
2018,6,14,15,2439,2213,1984,-229
2018,6,14,16,2489,2244,1940,-304
2018,6,14,17,2510,2270,1929,-341
2018,6,14,18,2529,2292,1868,-424
2018,6,14,19,2538,2383,1885,-498
2018,6,14,20,2540,2349,1779,-570
2018,6,14,21,2548,2371,1762,-609
2018,6,14,22,2558,2392,1736,-656
2018,6,14,23,2583,2421,1844,-577
2018,6,15,0,2624,2443,1867,-576
2018,6,15,1,2663,2537,1976,-561
2018,6,15,2,2683,2590,1883,-707
2018,6,15,3,2637,2596,1956,-640
2018,6,15,4,2551,2581,1920,-661
2018,6,15,5,2432,2502,1932,-570
2018,6,15,6,2252,2317,1980,-337
2018,6,15,7,2232,2164,1897,-267
2018,6,15,8,2195,2128,1815,-313
2018,6,15,9,2157,2071,1634,-437
2018,6,15,10,2107,2028,1729,-299
2018,6,15,11,2096,2062,1759,-303
2018,6,15,12,2134,2104,1690,-414
2018,6,15,13,2228,2200,1647,-553
2018,6,15,14,2370,2267,1674,-593
2018,6,15,15,2475,2308,1626,-682
2018,6,15,16,2529,2349,1535,-814
2018,6,15,17,2570,2395,1625,-770
2018,6,15,18,2609,2366,1536,-830
2018,6,15,19,2634,2379,1496,-883
2018,6,15,20,2677,2395,1556,-839
2018,6,15,21,2705,2458,1605,-853
2018,6,15,22,2726,2501,1618,-883
2018,6,15,23,2752,2552,1690,-862
2018,6,16,0,2724,2597,1780,-817
2018,6,16,1,2721,2626,1940,-686
2018,6,16,2,2700,2646,2047,-599
2018,6,16,3,2628,2625,1884,-741
2018,6,16,4,2595,2616,1880,-736
2018,6,16,5,2530,2533,1952,-581
2018,6,16,6,2408,2387,1779,-608
2018,6,16,7,2256,2257,1513,-744
2018,6,16,8,2155,2178,1538,-640
2018,6,16,9,2079,2108,1384,-724
2018,6,16,10,2013,2066,1376,-690
2018,6,16,11,1971,2019,1375,-644
2018,6,16,12,1951,2037,1387,-650
2018,6,16,13,1961,2022,1367,-655
2018,6,16,14,2079,1993,1404,-589
2018,6,16,15,2249,1983,1355,-628
2018,6,16,16,2334,2052,1385,-667
2018,6,16,17,2393,2107,1427,-680
2018,6,16,18,2449,2144,1394,-750
2018,6,16,19,2487,2211,1474,-737
2018,6,16,20,2497,2285,1433,-852
2018,6,16,21,2518,2357,1399,-958
2018,6,16,22,2546,2431,1511,-920
2018,6,16,23,2578,2428,1633,-795
2018,6,17,0,2635,2400,1704,-696
2018,6,17,1,2670,2435,1708,-727
2018,6,17,2,2676,2458,1806,-652
2018,6,17,3,2637,2447,1725,-722
2018,6,17,4,2587,2437,1738,-699
2018,6,17,5,2489,2367,1694,-673
2018,6,17,6,2335,2237,1667,-570
2018,6,17,7,2276,2113,1527,-586
2018,6,17,8,2204,2013,1443,-570
2018,6,17,9,1997,1972,1522,-450
2018,6,17,10,1953,1919,1516,-403
2018,6,17,11,1924,1892,1448,-444
2018,6,17,12,1901,1892,1412,-480
2018,6,17,13,1881,1892,1443,-449
2018,6,17,14,1928,1941,1376,-565
2018,6,17,15,2046,2014,1365,-649
2018,6,17,16,2113,2055,1383,-672
2018,6,17,17,2181,2071,1417,-654
2018,6,17,18,2195,2083,1375,-708
2018,6,17,19,2230,2082,1397,-685
2018,6,17,20,2293,2052,1431,-621
2018,6,17,21,2334,1988,1502,-486
2018,6,17,22,2372,2012,1556,-456
2018,6,17,23,2412,1986,1583,-403
2018,6,18,0,2454,1934,1619,-315
2018,6,18,1,2485,2006,1546,-460
2018,6,18,2,2453,2036,1504,-532
2018,6,18,3,2435,2065,1522,-543
2018,6,18,4,2383,2088,1456,-632
2018,6,18,5,2279,2024,1347,-677
2018,6,18,6,2118,1912,1364,-548
2018,6,18,7,2142,1836,1264,-572
2018,6,18,8,1976,1796,1265,-531
2018,6,18,9,1770,1775,1281,-494
2018,6,18,10,1749,1760,1228,-532
2018,6,18,11,1776,1781,1221,-560
2018,6,18,12,1854,1845,1256,-589
2018,6,18,13,1968,1947,1377,-570
2018,6,18,14,2124,2042,1364,-678
2018,6,18,15,2273,2110,1309,-801
2018,6,18,16,2326,2067,1329,-738
2018,6,18,17,2364,2091,1392,-699
2018,6,18,18,2407,2105,1377,-728
2018,6,18,19,2437,2121,1350,-771
2018,6,18,20,2497,2120,1394,-726
2018,6,18,21,2534,2122,1344,-778
2018,6,18,22,2557,2107,1370,-737
2018,6,18,23,2540,2119,1390,-729
2018,6,19,0,2521,2161,1419,-742
2018,6,19,1,2541,2240,1457,-783
2018,6,19,2,2542,2286,1480,-806
2018,6,19,3,2505,2314,1576,-738
2018,6,19,4,2458,2328,1565,-763
2018,6,19,5,2336,2262,1544,-718
2018,6,19,6,2172,2099,1490,-609
2018,6,19,7,2205,1979,1390,-589
2018,6,19,8,2088,1911,1407,-504
2018,6,19,9,1927,1845,1391,-454
2018,6,19,10,1906,1830,1389,-441
2018,6,19,11,1914,1813,1392,-421
2018,6,19,12,1968,1856,1385,-471
2018,6,19,13,2079,1940,1387,-553
2018,6,19,14,2214,2051,1368,-683
2018,6,19,15,2248,2023,1355,-668
2018,6,19,16,2312,2057,1417,-640
2018,6,19,17,2355,2026,1398,-628
2018,6,19,18,2395,2051,1501,-550
2018,6,19,19,2444,2096,1505,-591
2018,6,19,20,2506,2135,1503,-632
2018,6,19,21,2559,2203,1580,-623
2018,6,19,22,2598,2217,1732,-485
2018,6,19,23,2599,2232,1783,-449
2018,6,20,0,2601,2262,1656,-606
2018,6,20,1,2654,2277,1512,-765
2018,6,20,2,2687,2333,1545,-788
2018,6,20,3,2680,3039,2150,-889
2018,6,20,4,2627,2510,1603,-907
2018,6,20,5,2501,2402,1554,-848
2018,6,20,6,2294,2225,1523,-702
2018,6,20,7,2267,2090,1413,-677
2018,6,20,8,2102,1986,1383,-603
2018,6,20,9,1961,1931,1343,-588
2018,6,20,10,1922,1884,1344,-540
2018,6,20,11,1915,1879,1364,-515
2018,6,20,12,1958,1912,1375,-537
2018,6,20,13,2056,1984,1420,-564
2018,6,20,14,2201,2024,1416,-608
2018,6,20,15,2285,2029,1390,-639
2018,6,20,16,2384,2119,1619,-500
2018,6,20,17,2450,2182,1658,-524
2018,6,20,18,2518,2249,1756,-493
2018,6,20,19,2587,2312,1783,-529
2018,6,20,20,2646,2408,1863,-545
2018,6,20,21,2708,2473,1814,-659
2018,6,20,22,2750,2544,1823,-721
2018,6,20,23,2770,2592,1818,-774
2018,6,21,0,2791,2647,1861,-786
2018,6,21,1,2856,2718,1921,-797
2018,6,21,2,2893,2818,1899,-919
2018,6,21,3,2887,2867,1852,-1015
2018,6,21,4,2804,2817,1939,-878
2018,6,21,5,2658,2683,1841,-842
2018,6,21,6,2433,2468,1837,-631
2018,6,21,7,2353,2308,1695,-613
2018,6,21,8,2200,2195,1691,-504
2018,6,21,9,2142,2114,1625,-489
2018,6,21,10,2088,2037,1683,-354
2018,6,21,11,2068,2007,1599,-408
2018,6,21,12,2086,2048,1591,-457
2018,6,21,13,2169,2126,1584,-542
2018,6,21,14,2325,2182,1608,-574
2018,6,21,15,2419,2187,1477,-710
2018,6,21,16,2507,2273,1654,-619
2018,6,21,17,2576,2356,1717,-639
2018,6,21,18,2650,2430,1920,-510
2018,6,21,19,2719,2504,2029,-475
2018,6,21,20,2782,2558,2019,-539
2018,6,21,21,2842,2629,2002,-627
2018,6,21,22,2880,2617,2010,-607
2018,6,21,23,2898,2635,2217,-418
2018,6,22,0,2916,2656,2199,-457
2018,6,22,1,2942,2689,2284,-405
2018,6,22,2,2936,2753,2249,-504
2018,6,22,3,2877,2816,2253,-563
2018,6,22,4,2800,2773,2037,-736
2018,6,22,5,2663,2677,1882,-795
2018,6,22,6,2454,2493,2016,-477
2018,6,22,7,2263,2328,1855,-473
2018,6,22,8,2172,2219,1614,-605
2018,6,22,9,2160,2147,1648,-499
2018,6,22,10,2088,2102,1643,-459
2018,6,22,11,2053,2068,1647,-421
2018,6,22,12,2088,2106,1640,-466
2018,6,22,13,2184,2177,1614,-563
2018,6,22,14,2349,2230,1585,-645
2018,6,22,15,2477,2262,1486,-776
2018,6,22,16,2533,2331,1553,-778
2018,6,22,17,2596,2439,1675,-764
2018,6,22,18,2681,2523,1674,-849
2018,6,22,19,2782,2588,1781,-807
2018,6,22,20,2852,2662,1895,-767
2018,6,22,21,2911,2725,1953,-772
2018,6,22,22,2968,2795,2159,-636
2018,6,22,23,3011,2860,2181,-679
2018,6,23,0,3018,2920,2133,-787
2018,6,23,1,3021,2944,2185,-759
2018,6,23,2,3006,2990,2208,-782
2018,6,23,3,2912,3032,2115,-917
2018,6,23,4,2793,2984,2136,-848
2018,6,23,5,2641,2870,2172,-698
2018,6,23,6,2447,2688,2237,-451
2018,6,23,7,2316,2522,2433,-89
2018,6,23,8,2276,2402,2381,-21
2018,6,23,9,2303,2329,2487,158
2018,6,23,10,2204,2255,2478,223
2018,6,23,11,2130,2204,2413,209
2018,6,23,12,2094,2199,2425,226
2018,6,23,13,2086,2208,2335,127
2018,6,23,14,2187,2182,2292,110
2018,6,23,15,2340,2166,2287,121
2018,6,23,16,2412,2221,2176,-45
2018,6,23,17,2473,2310,2195,-115
2018,6,23,18,2530,2352,2260,-92
2018,6,23,19,2585,2385,2224,-161
2018,6,23,20,2607,2410,2284,-126
2018,6,23,21,2634,2421,2325,-96
2018,6,23,22,2686,2428,2399,-29
2018,6,23,23,2732,2454,2345,-109
2018,6,24,0,2770,2504,2361,-143
2018,6,24,1,2807,2506,2310,-196
2018,6,24,2,2811,2537,2294,-243
2018,6,24,3,2754,2624,2176,-448
2018,6,24,4,2671,2620,2058,-562
2018,6,24,5,2561,2568,2192,-376
2018,6,24,6,2366,2419,2177,-242
2018,6,24,7,2198,2272,2136,-136
2018,6,24,8,2178,2167,2041,-126
2018,6,24,9,2115,2118,1973,-145
2018,6,24,10,2048,2075,1930,-145
2018,6,24,11,1995,2060,1920,-140
2018,6,24,12,1966,2050,1890,-160
2018,6,24,13,1943,2029,1862,-167
2018,6,24,14,2018,1986,1806,-180
2018,6,24,15,2140,1963,1603,-360
2018,6,24,16,2225,2038,1703,-335
2018,6,24,17,2328,2114,1643,-471
2018,6,24,18,2376,2163,1729,-434
2018,6,24,19,2465,2235,1749,-486
2018,6,24,20,2530,2276,1582,-694
2018,6,24,21,2577,2367,1611,-756
2018,6,24,22,2628,2442,1749,-693
2018,6,24,23,2713,2527,1749,-778
2018,6,25,0,2785,2612,1826,-786
2018,6,25,1,2834,2668,1923,-745
2018,6,25,2,2841,2727,1948,-779
2018,6,25,3,2824,2812,1950,-862
2018,6,25,4,2742,2795,1982,-813
2018,6,25,5,2614,2650,1967,-683
2018,6,25,6,2427,2426,1855,-571
2018,6,25,7,2265,2279,1803,-476
2018,6,25,8,2192,2184,1840,-344
2018,6,25,9,2168,2114,1800,-314
2018,6,25,10,2135,2101,1785,-316
2018,6,25,11,2153,2094,1766,-328
2018,6,25,12,2231,2141,1740,-401
2018,6,25,13,2351,2235,1834,-401
2018,6,25,14,2544,2289,1782,-507
2018,6,25,15,2772,2334,1823,-511
2018,6,25,16,2890,2457,1816,-641
2018,6,25,17,3004,2581,1945,-636
2018,6,25,18,3103,2717,1891,-826
2018,6,25,19,3199,2838,1848,-990
2018,6,25,20,3252,2958,1882,-1076
2018,6,25,21,3292,3067,1998,-1069
2018,6,25,22,3330,3110,1987,-1123
2018,6,25,23,3367,3171,2005,-1166
2018,6,26,0,3380,3226,2003,-1223
2018,6,26,1,3399,3234,2035,-1199
2018,6,26,2,3389,3272,2086,-1186
2018,6,26,3,3295,3284,2209,-1075
2018,6,26,4,3182,3199,2363,-836
2018,6,26,5,3049,3035,2444,-591
2018,6,26,6,2794,2804,2404,-400
2018,6,26,7,2576,2612,2401,-211
2018,6,26,8,2470,2464,2352,-112
2018,6,26,9,2380,2362,2196,-166
2018,6,26,10,2298,2287,2172,-115
2018,6,26,11,2255,2257,2125,-132
2018,6,26,12,2270,2270,2093,-177
2018,6,26,13,2353,2317,2093,-224
2018,6,26,14,2489,2346,2022,-324
2018,6,26,15,2534,2335,2036,-299
2018,6,26,16,2601,2383,2064,-319
2018,6,26,17,2673,2448,2019,-429
2018,6,26,18,2748,2495,2045,-450
2018,6,26,19,2816,2530,2032,-498
2018,6,26,20,2883,2586,2087,-499
2018,6,26,21,2970,2650,2092,-558
2018,6,26,22,3035,2689,2135,-554
2018,6,26,23,3094,2729,2223,-506
2018,6,27,0,3138,2777,2290,-487
2018,6,27,1,3178,2827,2276,-551
2018,6,27,2,3173,2891,2243,-648
2018,6,27,3,3087,2979,2122,-857
2018,6,27,4,2952,2968,2164,-804
2018,6,27,5,2804,2863,2237,-626
2018,6,27,6,2603,2666,2157,-509
2018,6,27,7,2424,2493,1995,-498
2018,6,27,8,2341,2381,1860,-521
2018,6,27,9,2310,2293,1757,-536
2018,6,27,10,2247,2256,1715,-541
2018,6,27,11,2214,2225,1592,-633
2018,6,27,12,2243,2223,1587,-636
2018,6,27,13,2327,2286,1555,-731
2018,6,27,14,2499,2316,1561,-755
2018,6,27,15,2636,2328,1524,-804
2018,6,27,16,2753,2390,1517,-873
2018,6,27,17,2861,2457,1603,-854
2018,6,27,18,2962,2532,1543,-989
2018,6,27,19,3048,2618,1643,-975
2018,6,27,20,3161,2721,1719,-1002
2018,6,27,21,3270,2841,1769,-1072
2018,6,27,22,3354,2963,1893,-1070
2018,6,27,23,3408,3077,1973,-1104
2018,6,28,0,3467,3116,2115,-1001
2018,6,28,1,3510,3191,2077,-1114
2018,6,28,2,3510,3237,2071,-1166
2018,6,28,3,3431,3300,2084,-1216
2018,6,28,4,3301,3247,2067,-1180
2018,6,28,5,3169,3095,2000,-1095
2018,6,28,6,2921,2844,1893,-951
2018,6,28,7,2641,2643,1817,-826
2018,6,28,8,2570,2468,1719,-749
2018,6,28,9,2440,2287,1620,-667
2018,6,28,10,2378,2272,1792,-480
2018,6,28,11,2339,2222,1687,-535
2018,6,28,12,2351,2232,1722,-510
2018,6,28,13,2432,2316,1803,-513
2018,6,28,14,2585,2478,1932,-546
2018,6,28,15,2657,2560,2030,-530
2018,6,28,16,2695,2675,2115,-560
2018,6,28,17,2744,2741,2298,-443
2018,6,28,18,2802,2757,2289,-468
2018,6,28,19,2840,2784,2317,-467
2018,6,28,20,2893,2801,2292,-509
2018,6,28,21,2946,2860,2329,-531
2018,6,28,22,2990,2898,2367,-531
2018,6,28,23,3035,2911,2394,-517
2018,6,29,0,3068,2928,2322,-606
2018,6,29,1,3085,2961,2338,-623
2018,6,29,2,3071,2907,2233,-674
2018,6,29,3,2975,2842,2080,-762
2018,6,29,4,2824,2786,2098,-688
2018,6,29,5,2663,2697,2084,-613
2018,6,29,6,2440,2481,2083,-398
2018,6,29,7,2425,2328,1943,-385
2018,6,29,8,2300,2288,1796,-492
2018,6,29,9,2242,2183,1764,-419
2018,6,29,10,2190,2153,1745,-408
2018,6,29,11,2169,2108,1732,-376
2018,6,29,12,2182,2201,1681,-520
2018,6,29,13,2248,2167,1594,-573
2018,6,29,14,2406,2347,1793,-554
2018,6,29,15,2506,2522,1942,-580
2018,6,29,16,2565,2528,1931,-597
2018,6,29,17,2621,2565,1920,-645
2018,6,29,18,2670,2583,1875,-708
2018,6,29,19,2700,2568,1812,-756
2018,6,29,20,2743,2581,1825,-756
2018,6,29,21,2812,2661,1912,-749
2018,6,29,22,2852,2699,1958,-741
2018,6,29,23,2899,2721,2028,-693
2018,6,30,0,2936,2744,2038,-706
2018,6,30,1,2941,2771,2044,-727
2018,6,30,2,2909,2754,1894,-860
2018,6,30,3,2812,2710,1683,-1027
2018,6,30,4,2715,2660,1506,-1154
2018,6,30,5,2615,2577,1554,-1023
2018,6,30,6,2449,2431,1584,-847
2018,6,30,7,2294,2305,1470,-835
2018,6,30,8,2237,2198,1482,-716
2018,6,30,9,2255,2131,1488,-643
2018,6,30,10,2182,2092,1455,-637
2018,6,30,11,2137,2133,1419,-714
2018,6,30,12,2114,2040,1345,-695
2018,6,30,13,2122,2084,1342,-742
2018,6,30,14,2237,2117,1307,-810
2018,6,30,15,2410,2273,1379,-894
2018,6,30,16,2517,2393,1409,-984
2018,6,30,17,2575,2441,1392,-1049
2018,6,30,18,2618,2492,1404,-1088
2018,6,30,19,2644,2543,1490,-1053
2018,6,30,20,2654,2593,1606,-987
2018,6,30,21,2687,2652,1646,-1006
2018,6,30,22,2737,2683,1709,-974
2018,6,30,23,2766,2730,1766,-964
2018,7,1,0,2820,2800,1835,-965
2018,7,1,1,2872,2761,1832,-929
2018,7,1,2,2876,2795,1959,-836
2018,7,1,3,2832,2768,1948,-820
2018,7,1,4,2745,2680,1797,-883
2018,7,1,5,2659,2585,1699,-886
2018,7,1,6,2485,2416,1538,-878
2018,7,1,7,2362,2331,1434,-897
2018,7,1,8,2310,2185,1185,-1000
2018,7,1,9,2246,2114,1167,-947
2018,7,1,10,2211,2069,1154,-915
2018,7,1,11,2186,2029,1162,-867
2018,7,1,12,2125,2016,1161,-855
2018,7,1,13,2102,1997,1199,-798
2018,7,1,14,2189,2087,1308,-779
2018,7,1,15,2327,2200,1457,-743
2018,7,1,16,2414,2297,1547,-750
2018,7,1,17,2475,2333,1530,-803
2018,7,1,18,2516,2435,1653,-782
2018,7,1,19,2558,2503,1657,-846
2018,7,1,20,2605,2559,1625,-934
2018,7,1,21,2712,2615,1626,-989
2018,7,1,22,2789,2694,1653,-1041
2018,7,1,23,2873,2753,1709,-1044
2018,7,2,0,2916,2823,1794,-1029
2018,7,2,1,2963,2861,1944,-917
2018,7,2,2,2956,2824,1917,-907
2018,7,2,3,2929,2832,1792,-1040
2018,7,2,4,2843,2716,1602,-1114
2018,7,2,5,2708,2592,1502,-1090
2018,7,2,6,2523,2374,1303,-1071
2018,7,2,7,2419,2199,1299,-900
2018,7,2,8,2324,2114,1324,-790
2018,7,2,9,2171,2072,1282,-790
2018,7,2,10,2123,2010,1271,-739
2018,7,2,11,2131,2016,1305,-711
2018,7,2,12,2143,2051,1347,-704
2018,7,2,13,2245,2136,1398,-738
2018,7,2,14,2406,2325,1496,-829
2018,7,2,15,2582,2440,1686,-754
2018,7,2,16,2663,2524,1813,-711
2018,7,2,17,2686,2592,1863,-729
2018,7,2,18,2755,2657,1860,-797
2018,7,2,19,2813,2693,1793,-900
2018,7,2,20,2828,2754,1814,-940
2018,7,2,21,2905,2799,1848,-951
2018,7,2,22,2951,2848,1918,-930
2018,7,2,23,2992,2870,1984,-886
2018,7,3,0,2993,2917,2049,-868
2018,7,3,1,3026,2977,2086,-891
2018,7,3,2,3040,2973,2007,-966
2018,7,3,3,2987,2888,1806,-1082
2018,7,3,4,2852,2769,1741,-1028
2018,7,3,5,2758,2685,1780,-905
2018,7,3,6,2560,2483,1733,-750
2018,7,3,7,2417,2334,1728,-606
2018,7,3,8,2302,2224,1758,-466
2018,7,3,9,2244,2158,1753,-405
2018,7,3,10,2190,2116,1777,-339
2018,7,3,11,2162,2092,1803,-289
2018,7,3,12,2190,2111,1780,-331
2018,7,3,13,2288,2184,1760,-424
2018,7,3,14,2442,2291,1841,-450
2018,7,3,15,2502,2412,1975,-437
2018,7,3,16,2544,2462,2016,-446
2018,7,3,17,2625,2495,2008,-487
2018,7,3,18,2681,2527,2011,-516
2018,7,3,19,2716,2525,1994,-531
2018,7,3,20,2730,2533,1951,-582
2018,7,3,21,2750,2529,1874,-655
2018,7,3,22,2748,2556,1859,-697
2018,7,3,23,2728,2556,1892,-664
2018,7,4,0,2754,2588,1921,-667
2018,7,4,1,2785,2656,2024,-632
2018,7,4,2,2783,2678,1930,-748
2018,7,4,3,2753,2659,1828,-831
2018,7,4,4,2676,2568,1780,-788
2018,7,4,5,2617,2505,1813,-692
2018,7,4,6,2456,2354,1610,-744
2018,7,4,7,2333,2230,1467,-763
2018,7,4,8,2259,2133,1335,-798
2018,7,4,9,2224,2071,1240,-831
2018,7,4,10,2176,2020,1239,-781
2018,7,4,11,2158,1989,1240,-749
2018,7,4,12,2171,1977,1321,-656
2018,7,4,13,2240,2000,1376,-624
2018,7,4,14,2393,2094,1486,-608
2018,7,4,15,2431,2215,1553,-662
2018,7,4,16,2477,2319,1570,-749
2018,7,4,17,2551,2373,1594,-779
2018,7,4,18,2619,2409,1634,-775
2018,7,4,19,2707,2458,1671,-787
2018,7,4,20,2746,2536,1660,-876
2018,7,4,21,2827,2622,1625,-997
2018,7,4,22,2887,2712,1692,-1020
2018,7,4,23,2936,2805,1792,-1013
2018,7,5,0,3083,2883,1904,-979
2018,7,5,1,3185,2949,2031,-918
2018,7,5,2,3192,2956,2100,-856
2018,7,5,3,3132,2866,1956,-910
2018,7,5,4,3015,2734,1988,-746
2018,7,5,5,2924,2580,1847,-733
2018,7,5,6,2670,2465,1800,-665
2018,7,5,7,2766,2320,1711,-609
2018,7,5,8,2624,2186,1742,-444
2018,7,5,9,2344,2093,1627,-466
2018,7,5,10,2226,2027,1623,-404
2018,7,5,11,2198,1993,1697,-296
2018,7,5,12,2159,2018,1656,-362
2018,7,5,13,2222,2082,1548,-534
2018,7,5,14,2435,2252,1716,-536
2018,7,5,15,2570,2417,1764,-653
2018,7,5,16,2696,2564,1795,-769
2018,7,5,17,2801,2709,1709,-1000
2018,7,5,18,2884,2859,1683,-1176
2018,7,5,19,2984,2999,1773,-1226
2018,7,5,20,3107,3144,1946,-1198
2018,7,5,21,3245,3256,2117,-1139
2018,7,5,22,3359,3365,2211,-1154
2018,7,5,23,3461,3418,2280,-1138
2018,7,6,0,3537,3441,2245,-1196
2018,7,6,1,3602,3489,2150,-1339
2018,7,6,2,3575,3452,2198,-1254
2018,7,6,3,3475,3359,1949,-1410
2018,7,6,4,3340,3225,1881,-1344
2018,7,6,5,3190,3040,1830,-1210
2018,7,6,6,2998,2783,1763,-1020
2018,7,6,7,2814,2582,1754,-828
2018,7,6,8,2595,2436,1603,-833
2018,7,6,9,2476,2332,1591,-741
2018,7,6,10,2350,2260,1548,-712
2018,7,6,11,2316,2197,1531,-666
2018,7,6,12,2331,2213,1592,-621
2018,7,6,13,2388,2261,1571,-690
2018,7,6,14,2562,2409,1637,-772
2018,7,6,15,2725,2565,1729,-836
2018,7,6,16,2822,2681,1829,-852
2018,7,6,17,2907,2789,1863,-926
2018,7,6,18,2971,2894,1893,-1001
2018,7,6,19,3043,3007,1946,-1061
2018,7,6,20,3119,3107,2143,-964
2018,7,6,21,3246,3207,2308,-899
2018,7,6,22,3343,3258,2444,-814
2018,7,6,23,3383,3288,2362,-926
2018,7,7,0,3463,3301,2399,-902
2018,7,7,1,3450,3266,2366,-900
2018,7,7,2,3376,3227,2561,-666
2018,7,7,3,3218,3116,2415,-701
2018,7,7,4,3126,3002,2100,-902
2018,7,7,5,3002,2881,1821,-1060
2018,7,7,6,2851,2680,1804,-876
2018,7,7,7,2573,2492,1608,-884
2018,7,7,8,2423,2377,1524,-853
2018,7,7,9,2403,2289,1501,-788
2018,7,7,10,2318,2212,1332,-880
2018,7,7,11,2264,2161,1314,-847
2018,7,7,12,2277,2147,1276,-871
2018,7,7,13,2245,2158,1266,-892
2018,7,7,14,2327,2270,1386,-884
2018,7,7,15,2519,2417,1523,-894
2018,7,7,16,2631,2568,1611,-957
2018,7,7,17,2713,2699,1601,-1098
2018,7,7,18,2827,2821,1753,-1068
2018,7,7,19,2961,2916,1746,-1170
2018,7,7,20,3024,3021,1756,-1265
2018,7,7,21,3143,3111,1849,-1262
2018,7,7,22,3292,3205,2013,-1192
2018,7,7,23,3347,3264,2146,-1118
2018,7,8,0,3352,3329,2328,-1001
2018,7,8,1,3406,3369,2338,-1031
2018,7,8,2,3422,3352,2255,-1097
2018,7,8,3,3363,3279,2093,-1186
2018,7,8,4,3242,3145,1997,-1148
2018,7,8,5,3061,2982,1944,-1038
2018,7,8,6,2820,2742,1804,-938
2018,7,8,7,2562,2542,1620,-922
2018,7,8,8,2462,2407,1468,-939
2018,7,8,9,2413,2300,1387,-913
2018,7,8,10,2345,2231,1374,-857
2018,7,8,11,2271,2165,1350,-815
2018,7,8,12,2198,2132,1387,-745
2018,7,8,13,2173,2118,1356,-762
2018,7,8,14,2257,2185,1432,-753
2018,7,8,15,2416,2285,1546,-739
2018,7,8,16,2496,2380,1595,-785
2018,7,8,17,2594,2520,1627,-893
2018,7,8,18,2698,2658,1621,-1037
2018,7,8,19,2841,2794,1623,-1171
2018,7,8,20,3005,2932,1874,-1058
2018,7,8,21,3145,3063,1957,-1106
2018,7,8,22,3302,3185,2043,-1142
2018,7,8,23,3410,3263,2099,-1164
2018,7,9,0,3464,3325,2118,-1207
2018,7,9,1,3502,3332,2110,-1222
2018,7,9,2,3448,3302,2066,-1236
2018,7,9,3,3363,3220,1975,-1245
2018,7,9,4,3258,3088,1904,-1184
2018,7,9,5,3056,2902,1776,-1126
2018,7,9,6,2809,2633,1767,-866
2018,7,9,7,2634,2445,1660,-785
2018,7,9,8,2503,2297,1591,-706
2018,7,9,9,2370,2210,1507,-703
2018,7,9,10,2280,2151,1469,-682
2018,7,9,11,2237,2130,1542,-588
2018,7,9,12,2258,2166,1540,-626
2018,7,9,13,2356,2255,1538,-717
2018,7,9,14,2537,2438,1665,-773
2018,7,9,15,2753,2594,1757,-837
2018,7,9,16,2906,2744,1768,-976
2018,7,9,17,3013,2869,1748,-1121
2018,7,9,18,3151,3005,1755,-1250
2018,7,9,19,3280,3158,1882,-1276
2018,7,9,20,3384,3300,1951,-1349
2018,7,9,21,3496,3436,2069,-1367
2018,7,9,22,3601,3546,2146,-1400
2018,7,9,23,3671,3586,2226,-1360
2018,7,10,0,3703,3645,2316,-1329
2018,7,10,1,3752,3666,2267,-1399
2018,7,10,2,3761,3650,2232,-1418
2018,7,10,3,3669,3553,2117,-1436
2018,7,10,4,3561,3401,1958,-1443
2018,7,10,5,3391,3203,1922,-1281
2018,7,10,6,3083,2919,1776,-1143
2018,7,10,7,2874,2719,1751,-968
2018,7,10,8,2704,2550,1544,-1006
2018,7,10,9,2584,2451,1561,-890
2018,7,10,10,2484,2345,1475,-870
2018,7,10,11,2407,2280,1484,-796
2018,7,10,12,2381,2291,1666,-625
2018,7,10,13,2457,2338,1805,-533
2018,7,10,14,2618,2510,1986,-524
2018,7,10,15,2698,2664,2092,-572
2018,7,10,16,2784,2751,2194,-557
2018,7,10,17,2944,2845,2180,-665
2018,7,10,18,3054,2935,2191,-744
2018,7,10,19,3155,3020,2190,-830
2018,7,10,20,3256,3104,2172,-932
2018,7,10,21,3350,3180,2245,-935
2018,7,10,22,3393,3200,2263,-937
2018,7,10,23,3401,3287,2354,-933
2018,7,11,0,3405,3305,2371,-934
2018,7,11,1,3402,3344,2392,-952
2018,7,11,2,3387,3325,2332,-993
2018,7,11,3,3331,3218,2163,-1055
2018,7,11,4,3194,3093,2076,-1017
2018,7,11,5,3032,2919,1938,-981
2018,7,11,6,2820,2666,1799,-867
2018,7,11,7,2605,2476,1701,-775
2018,7,11,8,2470,2351,1654,-697
2018,7,11,9,2332,2255,1601,-654
2018,7,11,10,2265,2182,1597,-585
2018,7,11,11,2216,2145,1578,-567
2018,7,11,12,2232,2167,1495,-672
2018,7,11,13,2326,2244,1428,-816
2018,7,11,14,2504,2410,1610,-800
2018,7,11,15,2638,2540,1717,-823
2018,7,11,16,2737,2636,1730,-906
2018,7,11,17,2845,2718,1714,-1004
2018,7,11,18,2958,2816,1741,-1075
2018,7,11,19,3051,2909,1852,-1057
2018,7,11,20,3156,3020,1895,-1125
2018,7,11,21,3276,3101,1924,-1177
2018,7,11,22,3362,3201,2146,-1055
2018,7,11,23,3380,3256,2240,-1016
2018,7,12,0,3413,3305,2350,-955
2018,7,12,1,3436,3332,2463,-869
2018,7,12,2,3433,3309,2359,-950
2018,7,12,3,3353,3237,2255,-982
2018,7,12,4,3199,3104,2118,-986
2018,7,12,5,3032,2909,1947,-962
2018,7,12,6,2813,2668,1957,-711
2018,7,12,7,2654,2484,1812,-672
2018,7,12,8,2513,2253,1649,-604
2018,7,12,9,2344,2288,1658,-630
2018,7,12,10,2271,2186,1603,-583
2018,7,12,11,2236,2152,1562,-590
2018,7,12,12,2261,2165,1518,-647
2018,7,12,13,2345,2238,1491,-747
2018,7,12,14,2522,2388,1679,-709
2018,7,12,15,2675,2513,1851,-662
2018,7,12,16,2767,2624,1857,-767
2018,7,12,17,2856,2735,1885,-850
2018,7,12,18,2958,2840,1884,-956
2018,7,12,19,3058,2802,1860,-942
2018,7,12,20,3162,3184,2260,-924
2018,7,12,21,3275,3150,2189,-961
2018,7,12,22,3374,3238,2254,-984
2018,7,12,23,3415,3304,2290,-1014
2018,7,13,0,3441,3333,2415,-918
2018,7,13,1,3481,3375,2423,-952
2018,7,13,2,3482,3369,2335,-1034
2018,7,13,3,3402,3273,2122,-1151
2018,7,13,4,3243,3126,2175,-951
2018,7,13,5,3055,2948,2123,-825
2018,7,13,6,2810,2687,2045,-642
2018,7,13,7,2667,2495,1813,-682
2018,7,13,8,2522,2352,1572,-780
2018,7,13,9,2386,2255,1479,-776
2018,7,13,10,2279,2187,1399,-788
2018,7,13,11,2236,2149,1378,-771
2018,7,13,12,2259,2152,1360,-792
2018,7,13,13,2345,2230,1364,-866
2018,7,13,14,2525,2384,1450,-934
2018,7,13,15,2702,2524,1713,-811
2018,7,13,16,2808,2647,1682,-965
2018,7,13,17,2907,2770,1658,-1112
2018,7,13,18,3038,2905,1825,-1080
2018,7,13,19,3150,3049,1882,-1167
2018,7,13,20,3250,3173,1987,-1186
2018,7,13,21,3380,3226,2013,-1213
2018,7,13,22,3498,3214,2028,-1186
2018,7,13,23,3469,3206,2099,-1107
2018,7,14,0,3452,3159,2068,-1091
2018,7,14,1,3408,3202,2113,-1089
2018,7,14,2,3306,3189,2018,-1171
2018,7,14,3,3236,3126,1893,-1233
2018,7,14,4,3108,3067,1856,-1211
2018,7,14,5,2996,2931,1783,-1148
2018,7,14,6,2827,2708,1824,-884
2018,7,14,7,2714,2525,1691,-834
2018,7,14,8,2563,2376,1532,-844
2018,7,14,9,2420,2275,1404,-871
2018,7,14,10,2315,2194,1365,-829
2018,7,14,11,2244,2141,1358,-783
2018,7,14,12,2227,2117,1389,-728
2018,7,14,13,2234,2118,1392,-726
2018,7,14,14,2351,2224,1472,-752
2018,7,14,15,2547,2390,1527,-863
2018,7,14,16,2677,2542,1671,-871
2018,7,14,17,2769,2686,1862,-824
2018,7,14,18,2944,2815,1856,-959
2018,7,14,19,3099,2952,1871,-1081
2018,7,14,20,3189,3091,1988,-1103
2018,7,14,21,3252,3202,2027,-1175
2018,7,14,22,3344,3291,2091,-1200
2018,7,14,23,3416,3315,2258,-1057
2018,7,15,0,3467,3341,2393,-948
2018,7,15,1,3487,3352,2365,-987
2018,7,15,2,3448,3322,2313,-1009
2018,7,15,3,3348,3221,2072,-1149
2018,7,15,4,3236,3094,2037,-1057
2018,7,15,5,3093,2925,1842,-1083
2018,7,15,6,2842,2686,1770,-916
2018,7,15,7,2730,2523,1604,-919
2018,7,15,8,2604,2359,1551,-808
2018,7,15,9,2369,2258,1574,-684
2018,7,15,10,2270,2180,1551,-629
2018,7,15,11,2232,2131,1500,-631
2018,7,15,12,2160,2117,1457,-660
2018,7,15,13,2152,2074,1404,-670
2018,7,15,14,2240,2105,1370,-735
2018,7,15,15,2407,2258,1259,-999
2018,7,15,16,2528,2444,1401,-1043
2018,7,15,17,2677,2573,1519,-1054
2018,7,15,18,2813,2702,1551,-1151
2018,7,15,19,2957,2884,1583,-1301
2018,7,15,20,3119,2992,1699,-1293
2018,7,15,21,3224,3135,1695,-1440
2018,7,15,22,3288,3187,1775,-1412
2018,7,15,23,3359,3158,2030,-1128
2018,7,16,0,3405,3161,2168,-993
2018,7,16,1,3350,3154,2208,-946
2018,7,16,2,3263,3101,2086,-1015
2018,7,16,3,3165,3029,1881,-1148
2018,7,16,4,3050,2917,1785,-1132
2018,7,16,5,2923,2756,1638,-1118
2018,7,16,6,2683,2522,1570,-952
2018,7,16,7,2622,2364,1523,-841
2018,7,16,8,2470,2240,1597,-643
2018,7,16,9,2334,2178,1616,-562
2018,7,16,10,2243,2138,1503,-635
2018,7,16,11,2226,2100,1400,-700
2018,7,16,12,2257,2177,1448,-729
2018,7,16,13,2350,2239,1350,-889
2018,7,16,14,2546,2422,1365,-1057
2018,7,16,15,2762,2604,1462,-1142
2018,7,16,16,2855,2773,1581,-1192
2018,7,16,17,2956,2912,1755,-1157
2018,7,16,18,3115,3036,1847,-1189
2018,7,16,19,3255,3164,2097,-1067
2018,7,16,20,3376,3294,2091,-1203
2018,7,16,21,3509,3394,2141,-1253
2018,7,16,22,3544,3435,2202,-1233
2018,7,16,23,3530,3487,2245,-1242
2018,7,17,0,3589,3472,2212,-1260
2018,7,17,1,3598,3477,2190,-1287
2018,7,17,2,3531,3395,2146,-1249
2018,7,17,3,3442,3206,2128,-1078
2018,7,17,4,3265,3076,2069,-1007
2018,7,17,5,3062,2907,1862,-1045
2018,7,17,6,2838,2670,1677,-993
2018,7,17,7,2672,2476,1510,-966
2018,7,17,8,2463,2348,1462,-886
2018,7,17,9,2415,2240,1418,-822
2018,7,17,10,2306,2175,1433,-742
2018,7,17,11,2229,2125,1384,-741
2018,7,17,12,2298,2145,1355,-790
2018,7,17,13,2370,2222,1375,-847
2018,7,17,14,2532,2354,1449,-905
2018,7,17,15,2680,2523,1567,-956
2018,7,17,16,2787,2641,1576,-1065
2018,7,17,17,2925,2793,1711,-1082
2018,7,17,18,3059,2938,1890,-1048
2018,7,17,19,3193,3065,1900,-1165
2018,7,17,20,3330,3201,1953,-1248
2018,7,17,21,3441,3240,1979,-1261
2018,7,17,22,3485,3252,2113,-1139
2018,7,17,23,3444,3256,2123,-1133
2018,7,18,0,3462,3242,2122,-1120
2018,7,18,1,3454,3281,2093,-1188
2018,7,18,2,3400,3303,2016,-1287
2018,7,18,3,3324,3267,1841,-1426
2018,7,18,4,3251,3170,1784,-1386
2018,7,18,5,3130,2991,1723,-1268
2018,7,18,6,2896,2722,1680,-1042
2018,7,18,7,2698,2508,1574,-934
2018,7,18,8,2600,2363,1550,-813
2018,7,18,9,2427,2263,1539,-724
2018,7,18,10,2300,2183,1551,-632
2018,7,18,11,2247,2141,1626,-515
2018,7,18,12,2251,2165,1631,-534
2018,7,18,13,2349,2223,1609,-614
2018,7,18,14,2525,2368,1715,-653
2018,7,18,15,2691,2521,1828,-693
2018,7,18,16,2830,2638,1819,-819
2018,7,18,17,2955,2800,1886,-914
2018,7,18,18,3095,2945,1988,-957
2018,7,18,19,3234,3084,1981,-1103
2018,7,18,20,3359,3206,2076,-1130
2018,7,18,21,3436,3314,2146,-1168
2018,7,18,22,3454,3405,2295,-1110
2018,7,18,23,3479,3461,2433,-1028
2018,7,19,0,3536,3498,2568,-930
2018,7,19,1,3605,3499,2625,-874
2018,7,19,2,3600,3451,2533,-918
2018,7,19,3,3488,3345,2287,-1058
2018,7,19,4,3358,3181,2033,-1148
2018,7,19,5,3188,2980,1774,-1206
2018,7,19,6,2895,2717,1640,-1077
2018,7,19,7,2749,2500,1550,-950
2018,7,19,8,2550,2357,1462,-895
2018,7,19,9,2351,2244,1437,-807
2018,7,19,10,2244,2172,1474,-698
2018,7,19,11,2195,2120,1482,-638
2018,7,19,12,2194,2147,1502,-645
2018,7,19,13,2307,2201,1520,-681
2018,7,19,14,2478,2349,1640,-709
2018,7,19,15,2614,2490,1774,-716
2018,7,19,16,2710,2615,1834,-781
2018,7,19,17,2846,2726,1796,-930
2018,7,19,18,2997,2841,1789,-1052
2018,7,19,19,3100,2973,1785,-1188
2018,7,19,20,3211,3112,1845,-1267
2018,7,19,21,3327,3236,2046,-1190
2018,7,19,22,3409,3327,2006,-1321
2018,7,19,23,3466,3392,2051,-1341
2018,7,20,0,3491,3409,2165,-1244
2018,7,20,1,3514,3445,2208,-1237
2018,7,20,2,3501,3407,2230,-1177
2018,7,20,3,3419,3291,1953,-1338
2018,7,20,4,3275,3132,1848,-1284
2018,7,20,5,3102,2942,1761,-1181
2018,7,20,6,2833,2675,1476,-1199
2018,7,20,7,2659,2470,1396,-1074
2018,7,20,8,2474,2320,1415,-905
2018,7,20,9,2353,2232,1431,-801
2018,7,20,10,2247,2148,1453,-695
2018,7,20,11,2212,2106,1444,-662
2018,7,20,12,2236,2115,1407,-708
2018,7,20,13,2308,2183,1313,-870
2018,7,20,14,2451,2295,1430,-865
2018,7,20,15,2582,2447,1615,-832
2018,7,20,16,2668,2567,1693,-874
2018,7,20,17,2802,2678,1699,-979
2018,7,20,18,2943,2791,1742,-1049
2018,7,20,19,3063,2917,1732,-1185
2018,7,20,20,3166,3045,1756,-1289
2018,7,20,21,3304,3169,1939,-1230
2018,7,20,22,3386,3255,1955,-1300
2018,7,20,23,3440,3318,2007,-1311
2018,7,21,0,3402,3319,2085,-1234
2018,7,21,1,3431,3329,2109,-1220
2018,7,21,2,3460,3283,2086,-1197
2018,7,21,3,3309,3152,1845,-1307
2018,7,21,4,3208,3017,1704,-1313
2018,7,21,5,3063,2857,1597,-1260
2018,7,21,6,2825,2626,1400,-1226
2018,7,21,7,2629,2435,1364,-1071
2018,7,21,8,2463,2291,1273,-1018
2018,7,21,9,2306,2189,1285,-904
2018,7,21,10,2207,2120,1300,-820
2018,7,21,11,2158,2062,1384,-678
2018,7,21,12,2137,2046,1258,-788
2018,7,21,13,2148,2046,1240,-806
2018,7,21,14,2258,2145,1351,-794
2018,7,21,15,2424,2251,1579,-672
2018,7,21,16,2518,2355,1726,-629
2018,7,21,17,2599,2461,1727,-734
2018,7,21,18,2717,2580,1726,-854
2018,7,21,19,2838,2677,1648,-1029
2018,7,21,20,2953,2768,1651,-1117
2018,7,21,21,3017,2891,1715,-1176
2018,7,21,22,3112,3003,1878,-1125
2018,7,21,23,3185,3090,2055,-1035
2018,7,22,0,3305,3143,2149,-994
2018,7,22,1,3329,3172,2095,-1077
2018,7,22,2,3251,3141,1966,-1175
2018,7,22,3,3131,3037,1750,-1287
2018,7,22,4,3008,2931,1657,-1274
2018,7,22,5,2875,2768,1521,-1247
2018,7,22,6,2675,2555,1451,-1104
2018,7,22,7,2531,2375,1474,-901
2018,7,22,8,2384,2217,1556,-661
2018,7,22,9,2244,2128,1614,-514
2018,7,22,10,2152,2046,1598,-448
2018,7,22,11,2108,1993,1574,-419
2018,7,22,12,2039,1968,1409,-559
2018,7,22,13,2034,1959,1475,-484
2018,7,22,14,2114,2009,1476,-533
2018,7,22,15,2248,2119,1538,-581
2018,7,22,16,2337,2225,1532,-693
2018,7,22,17,2456,2320,1541,-779
2018,7,22,18,2581,2410,1636,-774
2018,7,22,19,2692,2514,1677,-837
2018,7,22,20,2792,2606,1787,-819
2018,7,22,21,2898,2720,1831,-889
2018,7,22,22,2981,2824,1886,-938
2018,7,22,23,3036,2924,1895,-1029
2018,7,23,0,3103,3009,1857,-1152
2018,7,23,1,3141,3023,1893,-1130
2018,7,23,2,3107,2995,1882,-1113
2018,7,23,3,3019,2869,1759,-1110
2018,7,23,4,2882,2766,1723,-1043
2018,7,23,5,2704,2607,1752,-855
2018,7,23,6,2505,2370,1509,-861
2018,7,23,7,2367,2199,1357,-842
2018,7,23,8,2238,2077,1344,-733
2018,7,23,9,2128,2001,1306,-695
2018,7,23,10,2068,1959,1282,-677
2018,7,23,11,2052,1938,1257,-681
2018,7,23,12,2095,1983,1242,-741
2018,7,23,13,2206,2066,1237,-829
2018,7,23,14,2374,2220,1431,-789
2018,7,23,15,2580,2364,1532,-832
2018,7,23,16,2717,2468,1599,-869
2018,7,23,17,2785,2600,1648,-952
2018,7,23,18,2889,2719,1725,-994
2018,7,23,19,2995,2854,1914,-940
2018,7,23,20,3090,3004,2047,-957
2018,7,23,21,3236,3158,2114,-1044
2018,7,23,22,3343,3287,2151,-1136
2018,7,23,23,3442,3365,2177,-1188
2018,7,24,0,3546,3421,2220,-1201
2018,7,24,1,3573,3460,2216,-1244
2018,7,24,2,3540,3438,2122,-1316
2018,7,24,3,3434,3342,2014,-1328
2018,7,24,4,3300,3198,1923,-1275
2018,7,24,5,3133,2986,1793,-1193
2018,7,24,6,2890,2718,1585,-1133
2018,7,24,7,2674,2515,1536,-979
2018,7,24,8,2542,2379,1534,-845
2018,7,24,9,2426,2283,1501,-782
2018,7,24,10,2347,2208,1512,-696
2018,7,24,11,2304,2167,1421,-746
2018,7,24,12,2288,2165,1382,-783
2018,7,24,13,2375,2226,1436,-790
2018,7,24,14,2540,2370,1587,-783
2018,7,24,15,2671,2509,1652,-857
2018,7,24,16,2798,2657,1752,-905
2018,7,24,17,2940,2793,1834,-959
2018,7,24,18,3101,2965,1953,-1012
2018,7,24,19,3235,3122,1972,-1150
2018,7,24,20,3340,3281,2204,-1077
2018,7,24,21,3478,3377,2250,-1127
2018,7,24,22,3591,3474,2406,-1068
2018,7,24,23,3614,3511,2488,-1023
2018,7,25,0,3672,3532,2487,-1045
2018,7,25,1,3696,3535,2573,-962
2018,7,25,2,3659,3443,2478,-965
2018,7,25,3,3501,3338,2253,-1085
2018,7,25,4,3332,3239,2166,-1073
2018,7,25,5,3152,3049,1987,-1062
2018,7,25,6,2961,2797,1850,-947
2018,7,25,7,2776,2603,1740,-863
2018,7,25,8,2630,2460,1757,-703
2018,7,25,9,2470,2356,1631,-725
2018,7,25,10,2395,2259,1588,-671
2018,7,25,11,2353,2209,1598,-611
2018,7,25,12,2295,2213,1678,-535
2018,7,25,13,2399,2263,1672,-591
2018,7,25,14,2556,2391,1671,-720
2018,7,25,15,2666,2530,1783,-747
2018,7,25,16,2742,2667,1864,-803
2018,7,25,17,2881,2810,1902,-908
2018,7,25,18,3041,2968,1997,-971
2018,7,25,19,3197,3161,2142,-1019
2018,7,25,20,3388,3259,2296,-963
2018,7,25,21,3511,3367,2356,-1011
2018,7,25,22,3577,3447,2403,-1044
2018,7,25,23,3640,3468,2504,-964
2018,7,26,0,3664,3502,2605,-897
2018,7,26,1,3614,3497,2618,-879
2018,7,26,2,3555,3491,2549,-942
2018,7,26,3,3445,3377,2424,-953
2018,7,26,4,3370,3261,2292,-969
2018,7,26,5,3185,3033,2216,-817
2018,7,26,6,2913,2772,2156,-616
2018,7,26,7,2708,2554,1991,-563
2018,7,26,8,2508,2398,1599,-799
2018,7,26,9,2378,2274,1583,-691
2018,7,26,10,2280,2204,1496,-708
2018,7,26,11,2230,2136,1472,-664
2018,7,26,12,2207,2148,1473,-675
2018,7,26,13,2315,2206,1441,-765
2018,7,26,14,2463,2326,1481,-845
2018,7,26,15,2605,2464,1592,-872
2018,7,26,16,2712,2591,1654,-937
2018,7,26,17,2856,2730,1743,-987
2018,7,26,18,3002,2877,1896,-981
2018,7,26,19,3138,3011,1959,-1052
2018,7,26,20,3288,3165,2009,-1156
2018,7,26,21,3421,3290,2210,-1080
2018,7,26,22,3504,3391,2299,-1092
2018,7,26,23,3550,3438,2412,-1026
2018,7,27,0,3597,3453,2491,-962
2018,7,27,1,3604,3478,2613,-865
2018,7,27,2,3548,3428,2576,-852
2018,7,27,3,3432,3324,2364,-960
2018,7,27,4,3317,3155,2162,-993
2018,7,27,5,3118,2949,2061,-888
2018,7,27,6,2847,2685,1837,-848
2018,7,27,7,2640,2477,1675,-802
2018,7,27,8,2486,2340,1597,-743
2018,7,27,9,2343,2248,1588,-660
2018,7,27,10,2249,2164,1567,-597
2018,7,27,11,2203,2115,1542,-573
2018,7,27,12,2200,2141,1580,-561
2018,7,27,13,2304,2195,1598,-597
2018,7,27,14,2446,2308,1634,-674
2018,7,27,15,2596,2430,1760,-670
2018,7,27,16,2709,2554,1774,-780
2018,7,27,17,2815,2690,1799,-891
2018,7,27,18,2966,2825,2000,-825
2018,7,27,19,3102,2954,1998,-956
2018,7,27,20,3243,3107,2121,-986
2018,7,27,21,3373,3245,2246,-999
2018,7,27,22,3449,3326,2262,-1064
2018,7,27,23,3501,3370,2334,-1036
2018,7,28,0,3458,3374,2383,-991
2018,7,28,1,3455,3367,2436,-931
2018,7,28,2,3446,3326,2341,-985
2018,7,28,3,3326,3204,2197,-1007
2018,7,28,4,3224,3062,2152,-910
2018,7,28,5,3018,2877,1955,-922
2018,7,28,6,2776,2629,1749,-880
2018,7,28,7,2563,2445,1691,-754
2018,7,28,8,2413,2302,1563,-739
2018,7,28,9,2320,2191,1475,-716
2018,7,28,10,2207,2125,1507,-618
2018,7,28,11,2136,2074,1540,-534
2018,7,28,12,2095,2050,1567,-483
2018,7,28,13,2136,2052,1527,-525
2018,7,28,14,2229,2122,1658,-464
2018,7,28,15,2407,2240,1744,-496
2018,7,28,16,2534,2390,1827,-563
2018,7,28,17,2647,2515,1836,-679
2018,7,28,18,2805,2655,1836,-819
2018,7,28,19,2944,2772,1867,-905
2018,7,28,20,3046,2914,1989,-925
2018,7,28,21,3141,3031,2023,-1008
2018,7,28,22,3243,3134,2127,-1007
2018,7,28,23,3333,3206,2264,-942
2018,7,29,0,3416,3234,2324,-910
2018,7,29,1,3395,3264,2429,-835
2018,7,29,2,3345,3211,2337,-874
2018,7,29,3,3237,3097,2190,-907
2018,7,29,4,3071,2946,2132,-814
2018,7,29,5,2876,2766,1900,-866
2018,7,29,6,2637,2546,1555,-991
2018,7,29,7,2464,2365,1516,-849
2018,7,29,8,2339,2222,1468,-754
2018,7,29,9,2244,2119,1450,-669
2018,7,29,10,2160,2053,1397,-656
2018,7,29,11,2103,1993,1403,-590
2018,7,29,12,2061,1969,1394,-575
2018,7,29,13,2046,1954,1358,-596
2018,7,29,14,2115,1999,1474,-525
2018,7,29,15,2286,2117,1574,-543
2018,7,29,16,2441,2249,1625,-624
2018,7,29,17,2559,2371,1616,-755
2018,7,29,18,2663,2503,1623,-880
2018,7,29,19,2786,2661,1606,-1055
2018,7,29,20,2908,2787,1659,-1128
2018,7,29,21,3025,2937,1809,-1128
2018,7,29,22,3131,3045,2102,-943
2018,7,29,23,3230,3123,2126,-997
2018,7,30,0,3278,3179,2209,-970
2018,7,30,1,3300,3191,2268,-923
2018,7,30,2,3254,3159,2194,-965
2018,7,30,3,3152,3045,2055,-990
2018,7,30,4,3004,2908,1881,-1027
2018,7,30,5,2816,2723,1747,-976
2018,7,30,6,2590,2472,1374,-1098
2018,7,30,7,2398,2280,1285,-995
2018,7,30,8,2281,2151,1270,-881
2018,7,30,9,2182,2053,1341,-712
2018,7,30,10,2097,1996,1382,-614
2018,7,30,11,2061,1979,1485,-494
2018,7,30,12,2096,2019,1535,-484
2018,7,30,13,2233,2113,1525,-588
2018,7,30,14,2392,2251,1568,-683
2018,7,30,15,2580,2374,1637,-737
2018,7,30,16,2679,2515,1646,-869
2018,7,30,17,2759,2647,1593,-1054
2018,7,30,18,2920,2794,1711,-1083
2018,7,30,19,3078,2957,1877,-1080
2018,7,30,20,3261,3094,2124,-970
2018,7,30,21,3394,3246,2213,-1033
2018,7,30,22,3465,3345,2217,-1128
2018,7,30,23,3537,3414,2219,-1195
2018,7,31,0,3595,3435,2223,-1212
2018,7,31,1,3608,3452,2188,-1264
2018,7,31,2,3566,3380,2150,-1230
2018,7,31,3,3438,3275,2082,-1193
2018,7,31,4,3268,3164,2017,-1147
2018,7,31,5,3033,2934,1960,-974
2018,7,31,6,2821,2678,1671,-1007
2018,7,31,7,2654,2506,1418,-1088
2018,7,31,8,2490,2376,1290,-1086
2018,7,31,9,2439,2263,1290,-973
2018,7,31,10,2345,2196,1311,-885
2018,7,31,11,2306,2147,1312,-835
2018,7,31,12,2317,2171,1467,-704
2018,7,31,13,2387,2234,1526,-708
2018,7,31,14,2497,2360,1567,-793
2018,7,31,15,2634,2455,1599,-856
2018,7,31,16,2810,2547,1640,-907
2018,7,31,17,2941,2661,1829,-832
2018,7,31,18,3058,2743,1840,-903
2018,7,31,19,3175,2893,2019,-874
2018,7,31,20,3307,3030,2085,-945
2018,7,31,21,3392,3157,2199,-958
2018,7,31,22,3476,3210,2173,-1037
2018,7,31,23,3454,3203,2130,-1073
2018,8,1,0,3596,3197,2097,-1100
2018,8,1,1,3499,3205,2045,-1160
2018,8,1,2,3377,3215,2012,-1203
2018,8,1,3,3226,3156,2003,-1153
2018,8,1,4,3288,3075,2022,-1053
2018,8,1,5,3149,2873,2039,-834
2018,8,1,6,2912,2643,1917,-726
2018,8,1,7,2819,2495,1772,-723
2018,8,1,8,2643,2329,1547,-782
2018,8,1,9,2381,2248,1624,-624
2018,8,1,10,2236,2174,1681,-493
2018,8,1,11,2205,2133,1640,-493
2018,8,1,12,2240,2169,1559,-610
2018,8,1,13,2342,2249,1562,-687
2018,8,1,14,2516,2367,1588,-779
2018,8,1,15,2669,2456,1587,-869
2018,8,1,16,2780,2563,1645,-918
2018,8,1,17,2874,2738,1803,-935
2018,8,1,18,2992,2858,1808,-1050
2018,8,1,19,3149,3019,1823,-1196
2018,8,1,20,3284,3169,1830,-1339
2018,8,1,21,3390,3242,2024,-1218
2018,8,1,22,3474,3259,2106,-1153
2018,8,1,23,3466,3261,2202,-1059
2018,8,2,0,3465,3236,2266,-970
2018,8,2,1,3460,3250,2233,-1017
2018,8,2,2,3405,3230,2179,-1051
2018,8,2,3,3302,3027,1944,-1083
2018,8,2,4,3262,2944,1902,-1042
2018,8,2,5,3057,2872,1890,-982
2018,8,2,6,2813,2623,1734,-889
2018,8,2,7,2714,2442,1498,-944
2018,8,2,8,2427,2297,1449,-848
2018,8,2,9,2309,2191,1375,-816
2018,8,2,10,2221,2120,1458,-662
2018,8,2,11,2221,2079,1505,-574
2018,8,2,12,2186,2112,1460,-652
2018,8,2,13,2281,2186,1482,-704
2018,8,2,14,2418,2289,1562,-727
2018,8,2,15,2536,2398,1578,-820
2018,8,2,16,2571,2517,1639,-878
2018,8,2,17,2641,2630,1753,-877
2018,8,2,18,2806,2758,1850,-908
2018,8,2,19,2951,2869,1933,-936
2018,8,2,20,3081,2978,1970,-1008
2018,8,2,21,3158,3085,2028,-1057
2018,8,2,22,3186,3170,2009,-1161
2018,8,2,23,3184,3216,2164,-1052
2018,8,3,0,3197,3246,2303,-943
2018,8,3,1,3251,3246,2335,-911
2018,8,3,2,3270,3187,2266,-921
2018,8,3,3,3182,3078,2123,-955
2018,8,3,4,3117,2953,2118,-835
2018,8,3,5,2871,2757,2048,-709
2018,8,3,6,2593,2510,1784,-726
2018,8,3,7,2493,2329,1614,-715
2018,8,3,8,2296,2211,1453,-758
2018,8,3,9,2164,2128,1376,-752
2018,8,3,10,2110,2053,1330,-723
2018,8,3,11,2083,2027,1350,-677
2018,8,3,12,2161,2035,1413,-622
2018,8,3,13,2272,2116,1502,-614
2018,8,3,14,2311,2224,1750,-474
2018,8,3,15,2384,2333,1870,-463
2018,8,3,16,2514,2431,2005,-426
2018,8,3,17,2660,2519,2126,-393
2018,8,3,18,2770,2606,2205,-401
2018,8,3,19,2845,2680,2086,-594
2018,8,3,20,2877,2741,2049,-692
2018,8,3,21,2904,2826,2043,-783
2018,8,3,22,2900,2918,2156,-762
2018,8,3,23,2948,2965,2189,-776
2018,8,4,0,2956,2984,2189,-795
2018,8,4,1,2940,2991,2202,-789
2018,8,4,2,2920,2968,2319,-649
2018,8,4,3,2845,2853,2094,-759
2018,8,4,4,2783,2751,1988,-763
2018,8,4,5,2642,2573,1802,-771
2018,8,4,6,2446,2380,1612,-768
2018,8,4,7,2272,2205,1439,-766
2018,8,4,8,2141,2111,1379,-732
2018,8,4,9,2112,2024,1311,-713
2018,8,4,10,2024,1967,1327,-640
2018,8,4,11,2003,1933,1395,-538
2018,8,4,12,2032,1929,1369,-560
2018,8,4,13,2054,1940,1329,-611
2018,8,4,14,2145,2004,1306,-698
2018,8,4,15,2256,2104,1411,-693
2018,8,4,16,2291,2202,1331,-871
2018,8,4,17,2323,2287,1344,-943
2018,8,4,18,2399,2370,1453,-917
2018,8,4,19,2532,2450,1547,-903
2018,8,4,20,2612,2536,1565,-971
2018,8,4,21,2719,2615,1607,-1008
2018,8,4,22,2834,2688,1636,-1052
2018,8,4,23,2886,2774,1806,-968
2018,8,5,0,2917,2647,1771,-876
2018,8,5,1,2950,2670,1731,-939
2018,8,5,2,2912,2467,1701,-766
2018,8,5,3,2783,2400,1682,-718
2018,8,5,4,2655,2279,1601,-678
2018,8,5,5,2523,2212,1556,-656
2018,8,5,6,2391,1973,1323,-650
2018,8,5,7,2209,2057,1368,-689
2018,8,5,8,2102,2023,1423,-600
2018,8,5,9,2055,1950,1380,-570
2018,8,5,10,2071,1908,1411,-497
2018,8,5,11,2037,1873,1396,-477
2018,8,5,12,1965,1863,1447,-416
2018,8,5,13,1978,1853,1382,-471
2018,8,5,14,2020,1857,1219,-638
2018,8,5,15,2103,1834,1197,-637
2018,8,5,16,2205,2135,1451,-684
2018,8,5,17,2361,2224,1487,-737
2018,8,5,18,2433,2311,1464,-847
2018,8,5,19,2506,2417,1498,-919
2018,8,5,20,2616,2525,1712,-813
2018,8,5,21,2734,2625,1669,-956
2018,8,5,22,2832,2713,1727,-986
2018,8,5,23,2903,2805,1791,-1014
2018,8,6,0,2962,2865,1967,-898
2018,8,6,1,2989,2867,1976,-891
2018,8,6,2,2923,2837,2108,-729
2018,8,6,3,2803,2744,1892,-852
2018,8,6,4,2700,2633,1833,-800
2018,8,6,5,2546,2448,1752,-696
2018,8,6,6,2370,2232,1445,-787
2018,8,6,7,2160,2069,1178,-891
2018,8,6,8,2044,2057,1283,-774
2018,8,6,9,2024,2002,1230,-772
2018,8,6,10,2014,1967,1143,-824
2018,8,6,11,1984,1959,1139,-820
2018,8,6,12,2013,2017,1142,-875
2018,8,6,13,2108,2100,1202,-898
2018,8,6,14,2242,2129,1267,-862
2018,8,6,15,2377,2268,1371,-897
2018,8,6,16,2508,2387,1506,-881
2018,8,6,17,2644,2495,1597,-898
2018,8,6,18,2743,2612,1695,-917
2018,8,6,19,2822,2715,1707,-1008
2018,8,6,20,2923,2849,1849,-1000
2018,8,6,21,3041,2970,2044,-926
2018,8,6,22,3156,3070,2059,-1011
2018,8,6,23,3230,3127,2091,-1036
2018,8,7,0,3262,3159,2118,-1041
2018,8,7,1,3295,3168,2109,-1059
2018,8,7,2,3251,3148,2075,-1073
2018,8,7,3,3127,3036,1963,-1073
2018,8,7,4,3028,2911,1943,-968
2018,8,7,5,2833,2692,1704,-988
2018,8,7,6,2598,2440,1528,-912
2018,8,7,7,2372,2261,1342,-919
2018,8,7,8,2260,2153,1365,-788
2018,8,7,9,2173,2065,1320,-745
2018,8,7,10,2147,2009,1291,-718
2018,8,7,11,2115,1982,1230,-752
2018,8,7,12,2104,2023,1187,-836
2018,8,7,13,2195,2099,1217,-882
2018,8,7,14,2315,2196,1227,-969
2018,8,7,15,2440,2317,1360,-957
2018,8,7,16,2566,2423,1402,-1021
2018,8,7,17,2695,2539,1498,-1041
2018,8,7,18,2798,2642,1561,-1081
2018,8,7,19,2895,2768,1671,-1097
2018,8,7,20,3022,2896,1846,-1050
2018,8,7,21,3145,3031,1989,-1042
2018,8,7,22,3252,3143,2012,-1131
2018,8,7,23,3343,3220,2067,-1153
2018,8,8,0,3386,3269,2081,-1188
2018,8,8,1,3420,3272,2063,-1209
2018,8,8,2,3383,3218,2009,-1209
2018,8,8,3,3240,3087,1866,-1221
2018,8,8,4,3133,2973,1906,-1067
2018,8,8,5,2920,2751,1712,-1039
2018,8,8,6,2663,2511,1551,-960
2018,8,8,7,2491,2313,1388,-925
2018,8,8,8,2336,2191,1274,-917
2018,8,8,9,2232,2232,1274,-9999
2018,8,8,10,2189,2189,1291,-9999
2018,8,8,11,2152,2152,1230,-9999
2018,8,8,12,2143,2143,1187,-9999
2018,8,8,13,2221,2221,1217,-9999
2018,8,8,14,2339,2339,1227,-9999
2018,8,8,15,2486,2486,1360,-9999
2018,8,8,16,2639,2639,1402,-9999
2018,8,8,17,2781,2781,1498,-9999
2018,8,8,18,2908,2908,1561,-9999
2018,8,8,19,3030,3030,1671,-9999
2018,8,8,20,3162,3162,1846,-9999
2018,8,8,21,3301,3301,1989,-9999
2018,8,8,22,3430,3430,2012,-9999
2018,8,8,23,3533,3533,2067,-9999
2018,8,9,0,3569,3569,2081,-9999
2018,8,9,1,3583,3583,2063,-9999
2018,8,9,2,3545,3545,2009,-9999
2018,8,9,3,3374,3374,1866,-9999
2018,8,9,4,3252,3252,1906,-9999
2018,8,9,5,3035,3035,1712,-9999
2018,8,9,6,2766,2766,1551,-9999
2018,8,9,7,2599,2599,1388,-9999
2018,8,9,8,2425,2288,1257,-1031
2018,8,9,9,2366,2177,1181,-996
2018,8,9,10,2295,2106,1191,-915
2018,8,9,11,2244,2069,1213,-856
2018,8,9,12,2273,2094,1244,-850
2018,8,9,13,2308,2186,1293,-893
2018,8,9,14,2405,2294,1274,-1020
2018,8,9,15,2571,2422,1400,-1022
2018,8,9,16,2742,2536,1445,-1091
2018,8,9,17,2862,2673,1503,-1170
2018,8,9,18,3006,2827,1588,-1239
2018,8,9,19,3158,2999,1655,-1344
2018,8,9,20,3363,3167,1848,-1319
2018,8,9,21,3487,3358,1993,-1365
2018,8,9,22,3587,3480,2080,-1400
2018,8,9,23,3681,3544,2149,-1395
2018,8,10,0,3751,3561,2267,-1294
2018,8,10,1,3744,3559,2265,-1294
2018,8,10,2,3669,3495,2273,-1222
2018,8,10,3,3485,3381,2110,-1271
2018,8,10,4,3370,3240,2077,-1163
2018,8,10,5,3187,3013,1911,-1102
2018,8,10,6,2920,2726,1808,-918
2018,8,10,7,2702,2528,1728,-800
2018,8,10,8,2514,2385,1600,-785
2018,8,10,9,2423,2267,1515,-752
2018,8,10,10,2338,2191,1504,-687
2018,8,10,11,2290,2146,1454,-692
2018,8,10,12,2317,2158,1447,-711
2018,8,10,13,2395,2242,1510,-732
2018,8,10,14,2488,2340,1542,-798
2018,8,10,15,2625,2466,1694,-772
2018,8,10,16,2789,2599,1697,-902
2018,8,10,17,2945,2746,1724,-1022
2018,8,10,18,3101,2928,1904,-1024
2018,8,10,19,3269,3121,2007,-1114
2018,8,10,20,3482,3311,2157,-1154
2018,8,10,21,3632,3452,2194,-1258
2018,8,10,22,3731,3576,2256,-1320
2018,8,10,23,3772,3608,2229,-1379
2018,8,11,0,3708,3632,2228,-1404
2018,8,11,1,3693,3597,2235,-1362
2018,8,11,2,3686,3518,2138,-1380
2018,8,11,3,3485,3384,2033,-1351
2018,8,11,4,3400,3259,2019,-1240
2018,8,11,5,3222,3022,1909,-1113
2018,8,11,6,2976,2777,1756,-1021
2018,8,11,7,2799,2566,1671,-895
2018,8,11,8,2662,2421,1581,-840
2018,8,11,9,2423,2304,1546,-758
2018,8,11,10,2342,2210,1515,-695
2018,8,11,11,2276,2145,1476,-669
2018,8,11,12,2208,2114,1461,-653
2018,8,11,13,2254,2120,1458,-662
2018,8,11,14,2291,2185,1502,-683
2018,8,11,15,2423,2306,1557,-749
2018,8,11,16,2610,2450,1547,-903
2018,8,11,17,2772,2575,1620,-955
2018,8,11,18,2883,2716,1664,-1052
2018,8,11,19,2982,2873,1732,-1141
2018,8,11,20,3098,3010,1725,-1285
2018,8,11,21,3240,3129,1814,-1315
2018,8,11,22,3381,3243,1951,-1292
2018,8,11,23,3447,3330,2106,-1224
2018,8,12,0,3515,3371,2057,-1314
2018,8,12,1,3502,3339,2034,-1305
2018,8,12,2,3424,3266,2000,-1266
2018,8,12,3,3272,3142,1840,-1302
2018,8,12,4,3184,3026,1814,-1212
2018,8,12,5,2990,2818,1665,-1153
2018,8,12,6,2733,2594,1616,-978
2018,8,12,7,2566,2405,1467,-938
2018,8,12,8,2405,2254,1558,-696
2018,8,12,9,2240,2153,1648,-505
2018,8,12,10,2147,2068,1659,-409
2018,8,12,11,2103,2025,1665,-360
2018,8,12,12,2085,1990,1647,-343
2018,8,12,13,2092,1996,1636,-360
2018,8,12,14,2115,2008,1614,-394
2018,8,12,15,2226,2105,1654,-451
2018,8,12,16,2297,2185,1780,-405
2018,8,12,17,2381,2264,1867,-397
2018,8,12,18,2475,2348,1825,-523
2018,8,12,19,2590,2428,1757,-671
2018,8,12,20,2709,2506,1726,-780
2018,8,12,21,2779,2598,1658,-940
2018,8,12,22,2837,2688,1583,-1105
2018,8,12,23,2918,2762,1583,-1179
2018,8,13,0,3056,2834,1567,-1267
2018,8,13,1,3016,2845,1542,-1303
2018,8,13,2,2933,2785,1624,-1161
2018,8,13,3,2835,2689,1612,-1077
2018,8,13,4,2809,2595,1615,-980
2018,8,13,5,2635,2410,1508,-902
2018,8,13,6,2409,2201,1488,-713
2018,8,13,7,2328,2048,1364,-684
2018,8,13,8,2150,1946,1302,-644
2018,8,13,9,1980,1900,1232,-668
2018,8,13,10,1931,1869,1197,-672
2018,8,13,11,1940,1865,1212,-653
2018,8,13,12,2030,1924,1228,-696
2018,8,13,13,2141,2028,1227,-801
2018,8,13,14,2255,2126,1347,-779
2018,8,13,15,2410,2245,1451,-794
2018,8,13,16,2520,2343,1524,-819
2018,8,13,17,2614,2405,1519,-886
2018,8,13,18,2727,2509,1690,-819
2018,8,13,19,2814,2612,1730,-882
2018,8,13,20,2906,2751,1871,-880
2018,8,13,21,3024,2875,1989,-886
2018,8,13,22,3144,2988,2151,-837
2018,8,13,23,3216,3079,2157,-922
2018,8,14,0,3292,3133,2299,-834
2018,8,14,1,3277,3158,2324,-834
2018,8,14,2,3235,3106,2272,-834
2018,8,14,3,3120,2991,2142,-849
2018,8,14,4,3065,2858,2082,-776
2018,8,14,5,2862,2642,1917,-725
2018,8,14,6,2608,2403,1782,-621
2018,8,14,7,2501,2238,1639,-599
2018,8,14,8,2338,2120,1493,-627
2018,8,14,9,2126,2037,1522,-515
2018,8,14,10,2055,1992,1543,-449
2018,8,14,11,2040,1965,1530,-435
2018,8,14,12,2093,2002,1548,-454
2018,8,14,13,2194,2082,1513,-569
2018,8,14,14,2286,2172,1474,-698
2018,8,14,15,2409,2292,1573,-719
2018,8,14,16,2512,2383,1662,-721
2018,8,14,17,2627,2476,1748,-728
2018,8,14,18,2748,2575,1821,-754
2018,8,14,19,2900,2681,1825,-856
2018,8,14,20,3008,2809,1929,-880
2018,8,14,21,3093,2937,2088,-849
2018,8,14,22,3214,3058,2261,-797
2018,8,14,23,3287,3118,2314,-804
2018,8,15,0,3329,3157,2330,-827
2018,8,15,1,3306,3190,2298,-892
2018,8,15,2,3248,3101,2185,-916
2018,8,15,3,3121,2987,2137,-850
2018,8,15,4,3047,2872,2122,-750
2018,8,15,5,2821,2640,1983,-657
2018,8,15,6,2556,2400,1861,-539
2018,8,15,7,2481,2236,1663,-573
2018,8,15,8,2306,2097,1462,-635
2018,8,15,9,2157,2036,1456,-580
2018,8,15,10,2100,1971,1388,-583
2018,8,15,11,2069,1959,1379,-580
2018,8,15,12,2055,2001,1378,-623
2018,8,15,13,2178,2092,1381,-711
2018,8,15,14,2283,2187,1407,-780
2018,8,15,15,2443,2297,1540,-757
2018,8,15,16,2580,2403,1619,-784
2018,8,15,17,2678,2486,1651,-835
2018,8,15,18,2798,2606,1748,-858
2018,8,15,19,2935,2733,1747,-986
2018,8,15,20,3064,2873,1826,-1047
2018,8,15,21,3152,3021,2021,-1000
2018,8,15,22,3269,3155,2138,-1017
2018,8,15,23,3344,3235,2206,-1029
2018,8,16,0,3394,3276,2156,-1120
2018,8,16,1,3392,3257,2233,-1024
2018,8,16,2,3329,3199,2215,-984
2018,8,16,3,3184,3071,2032,-1039
2018,8,16,4,3165,2953,1901,-1052
2018,8,16,5,2965,2724,1831,-893
2018,8,16,6,2665,2486,1650,-836
2018,8,16,7,2601,2338,1733,-605
2018,8,16,8,2420,2214,1545,-669
2018,8,16,9,2299,2129,1474,-655
2018,8,16,10,2205,2161,1522,-639
2018,8,16,11,2162,2141,1494,-647
2018,8,16,12,2234,2225,1469,-756
2018,8,16,13,2329,2280,1503,-777
2018,8,16,14,2419,2275,1510,-765
2018,8,16,15,2565,2384,1617,-767
2018,8,16,16,2654,2492,1631,-861
2018,8,16,17,2748,2611,1589,-1022
2018,8,16,18,2874,2739,1666,-1073
2018,8,16,19,3005,2867,1705,-1162
2018,8,16,20,3138,3004,1792,-1212
2018,8,16,21,3251,3130,2009,-1121
2018,8,16,22,3355,3217,2175,-1042
2018,8,16,23,3410,3264,2197,-1067
2018,8,17,0,3472,3294,2137,-1157
2018,8,17,1,3424,3251,1983,-1268
2018,8,17,2,3325,3157,1920,-1237
2018,8,17,3,3186,3064,1940,-1124
2018,8,17,4,3122,2960,1863,-1097
2018,8,17,5,2899,2758,1702,-1056
2018,8,17,6,2654,2523,1577,-946
2018,8,17,7,2505,2344,1451,-893
2018,8,17,8,2358,2233,1321,-912
2018,8,17,9,2303,2142,1376,-766
2018,8,17,10,2216,2080,1308,-772
2018,8,17,11,2167,2042,1263,-779
2018,8,17,12,2225,2079,1368,-711
2018,8,17,13,2305,2171,1455,-716
2018,8,17,14,2398,2253,1499,-754
2018,8,17,15,2533,2382,1590,-792
2018,8,17,16,2673,2463,1468,-995
2018,8,17,17,2765,2569,1411,-1158
2018,8,17,18,2885,2713,1537,-1176
2018,8,17,19,2999,2834,1598,-1236
2018,8,17,20,3120,2936,1666,-1270
2018,8,17,21,3198,3033,1719,-1314
2018,8,17,22,3253,3077,1890,-1187
2018,8,17,23,3250,3099,1916,-1183
2018,8,18,0,3183,3088,1883,-1205
2018,8,18,1,3153,3053,1818,-1235
2018,8,18,2,3072,2978,1840,-1138
2018,8,18,3,2984,2845,1757,-1088
2018,8,18,4,2973,2744,1698,-1046
2018,8,18,5,2761,2562,1510,-1052
2018,8,18,6,2529,2393,1382,-1011
2018,8,18,7,2327,2226,1228,-998
2018,8,18,8,2198,2117,1329,-788
2018,8,18,9,2145,2035,1306,-729
2018,8,18,10,2071,1971,1254,-717
2018,8,18,11,2006,1929,1262,-667
2018,8,18,12,2030,1919,1258,-661
2018,8,18,13,2078,1933,1260,-673
2018,8,18,14,2091,1970,1265,-705
2018,8,18,15,2190,2080,1351,-729
2018,8,18,16,2303,2179,1427,-752
2018,8,18,17,2412,2265,1500,-765
2018,8,18,18,2519,2363,1504,-859
2018,8,18,19,2622,2464,1606,-858
2018,8,18,20,2730,2563,1742,-821
2018,8,18,21,2838,2656,1830,-826
2018,8,18,22,2950,2763,1914,-849
2018,8,18,23,3031,2842,1885,-957
2018,8,19,0,3059,2873,1834,-1039
2018,8,19,1,3018,2849,1751,-1098
2018,8,19,2,2922,2793,1672,-1121
2018,8,19,3,2824,2676,1585,-1091
2018,8,19,4,2734,2579,1572,-1007
2018,8,19,5,2527,2406,1368,-1038
2018,8,19,6,2355,2225,1314,-911
2018,8,19,7,2275,2073,1241,-832
2018,8,19,8,2139,1970,1163,-807
2018,8,19,9,2012,1905,1189,-716
2018,8,19,10,1981,1853,1192,-661
2018,8,19,11,1958,1825,1223,-602
2018,8,19,12,1966,1820,1268,-552
2018,8,19,13,1955,1826,1291,-535
2018,8,19,14,1968,1840,1347,-493
2018,8,19,15,2093,1941,1417,-524
2018,8,19,16,2213,2049,1451,-598
2018,8,19,17,2318,2147,1534,-613
2018,8,19,18,2453,2242,1509,-733
2018,8,19,19,2573,2361,1492,-869
2018,8,19,20,2675,2473,1460,-1013
2018,8,19,21,2793,2585,1435,-1150
2018,8,19,22,2906,2714,1444,-1270
2018,8,19,23,2957,2817,1491,-1326
2018,8,20,0,3071,2910,1517,-1393
2018,8,20,1,3060,2921,1647,-1274
2018,8,20,2,2980,2854,1614,-1240
2018,8,20,3,2847,2723,1484,-1239
2018,8,20,4,2765,2609,1422,-1187
2018,8,20,5,2571,2389,1406,-983
2018,8,20,6,2342,2166,1437,-729
2018,8,20,7,2286,2006,1392,-614
2018,8,20,8,2180,1909,1420,-489
2018,8,20,9,2057,1847,1406,-441
2018,8,20,10,1995,1810,1301,-509
2018,8,20,11,1978,1812,1365,-447
2018,8,20,12,1998,1866,1319,-547
2018,8,20,13,2103,2000,1318,-682
2018,8,20,14,2226,2117,1278,-839
2018,8,20,15,2391,2220,1260,-960
2018,8,20,16,2487,2300,1278,-1022
2018,8,20,17,2540,2400,1426,-974
2018,8,20,18,2653,2487,1456,-1031
2018,8,20,19,2739,2593,1563,-1030
2018,8,20,20,2842,2674,1617,-1057
2018,8,20,21,2936,2784,1740,-1044
2018,8,20,22,3042,2810,1836,-974
2018,8,20,23,3054,2833,1946,-887
2018,8,21,0,3044,2842,2027,-815
2018,8,21,1,2992,2832,2005,-827
2018,8,21,2,2895,2780,1922,-858
2018,8,21,3,2800,2696,1772,-924
2018,8,21,4,2764,2618,1729,-889
2018,8,21,5,2574,2424,1561,-863
2018,8,21,6,2350,2227,1489,-738
2018,8,21,7,2245,2076,1425,-651
2018,8,21,8,2095,1977,1369,-608
2018,8,21,9,1955,1918,1355,-563
2018,8,21,10,1909,1888,1304,-584
2018,8,21,11,1895,1876,1268,-608
2018,8,21,12,1935,1931,1317,-614
2018,8,21,13,2061,2040,1325,-715
2018,8,21,14,2175,2143,1341,-802
2018,8,21,15,2285,2222,1342,-880
2018,8,21,16,2379,2259,1314,-945
2018,8,21,17,2450,2323,1377,-946
2018,8,21,18,2516,2381,1440,-941
2018,8,21,19,2578,2443,1553,-890
2018,8,21,20,2696,2501,1638,-863
2018,8,21,21,2750,2578,1648,-930
2018,8,21,22,2791,2644,1656,-988
2018,8,21,23,2831,2684,1677,-1007
2018,8,22,0,2852,2704,1683,-1021
2018,8,22,1,2870,2697,1659,-1038
2018,8,22,2,2793,2652,1670,-982
2018,8,22,3,2711,2612,1734,-878
2018,8,22,4,2700,2535,1660,-875
2018,8,22,5,2521,2348,1515,-833
2018,8,22,6,2290,2156,1415,-741
2018,8,22,7,2214,2030,1346,-684
2018,8,22,8,2082,1955,1283,-672
2018,8,22,9,2005,1889,1247,-642
2018,8,22,10,1952,1809,1227,-582
2018,8,22,11,1944,1796,1216,-580
2018,8,22,12,1950,1873,1232,-641
2018,8,22,13,2056,2011,1258,-753
2018,8,22,14,2181,2121,1377,-744
2018,8,22,15,2303,2193,1359,-834
2018,8,22,16,2394,2239,1420,-819
2018,8,22,17,2479,2280,1374,-906
2018,8,22,18,2551,2335,1450,-885
2018,8,22,19,2606,2403,1520,-883
2018,8,22,20,2662,2457,1525,-932
2018,8,22,21,2698,2533,1486,-1047
2018,8,22,22,2756,2616,1628,-988
2018,8,22,23,2784,2677,1712,-965
2018,8,23,0,2892,2719,1800,-919
2018,8,23,1,2878,2729,1748,-981
2018,8,23,2,2819,2675,1675,-1000
2018,8,23,3,2731,2614,1633,-981
2018,8,23,4,2655,2537,1553,-984
2018,8,23,5,2461,2348,1366,-982
2018,8,23,6,2262,2148,1197,-951
2018,8,23,7,2188,2005,1203,-802
2018,8,23,8,2068,1926,1248,-678
2018,8,23,9,1972,1871,1242,-629
2018,8,23,10,1900,1834,1249,-585
2018,8,23,11,1884,1841,1282,-559
2018,8,23,12,1953,1890,1241,-649
2018,8,23,13,2091,2024,1246,-778
2018,8,23,14,2202,2111,1306,-805
2018,8,23,15,2311,2184,1518,-666
2018,8,23,16,2385,2240,1533,-707
2018,8,23,17,2449,2313,1553,-760
2018,8,23,18,2530,2382,1543,-839
2018,8,23,19,2605,2440,1557,-883
2018,8,23,20,2669,2541,1647,-894
2018,8,23,21,2732,2638,1794,-844
2018,8,23,22,2821,2716,1839,-877
2018,8,23,23,2918,2809,1831,-978
2018,8,24,0,2964,2813,1860,-953
2018,8,24,1,2962,2829,1846,-983
2018,8,24,2,2890,2765,1750,-1015
2018,8,24,3,2799,2684,1689,-995
2018,8,24,4,2708,2578,1661,-917
2018,8,24,5,2511,2376,1560,-816
2018,8,24,6,2292,2176,1369,-807
2018,8,24,7,2219,2051,1308,-743
2018,8,24,8,2102,1950,1213,-737
2018,8,24,9,2001,1901,1231,-670
2018,8,24,10,1932,1858,1218,-640
2018,8,24,11,1915,1857,1229,-628
2018,8,24,12,1952,1892,1223,-669
2018,8,24,13,2096,2006,1208,-798
2018,8,24,14,2192,2110,1259,-851
2018,8,24,15,2279,2193,1328,-865
2018,8,24,16,2351,2228,1351,-877
2018,8,24,17,2396,2292,1449,-843
2018,8,24,18,2448,2336,1571,-765
2018,8,24,19,2516,2379,1693,-686
2018,8,24,20,2574,2448,1811,-637
2018,8,24,21,2641,2475,1837,-638
2018,8,24,22,2707,2568,1870,-698
2018,8,24,23,2759,2623,1832,-791
2018,8,25,0,2801,2650,1873,-777
2018,8,25,1,2765,2631,1848,-783
2018,8,25,2,2660,2547,1695,-852
2018,8,25,3,2583,2469,1594,-875
2018,8,25,4,2532,2402,1471,-931
2018,8,25,5,2351,2249,1407,-842
2018,8,25,6,2186,2096,1387,-709
2018,8,25,7,2120,1976,1305,-671
2018,8,25,8,1980,1885,1195,-690
2018,8,25,9,1874,1825,1198,-627
2018,8,25,10,1856,1794,1189,-605
2018,8,25,11,1836,1766,1178,-588
2018,8,25,12,1848,1776,1167,-609
2018,8,25,13,1918,1811,1178,-633
2018,8,25,14,1953,1847,1165,-682
2018,8,25,15,2038,1955,1283,-672
2018,8,25,16,2105,2018,1249,-769
2018,8,25,17,2170,2095,1372,-723
2018,8,25,18,2223,2139,1380,-759
2018,8,25,19,2282,2184,1347,-837
2018,8,25,20,2322,2244,1352,-892
2018,8,25,21,2408,2313,1353,-960
2018,8,25,22,2510,2387,1373,-1014
2018,8,25,23,2602,2465,1428,-1037
2018,8,26,0,2666,2521,1510,-1011
2018,8,26,1,2652,2501,1565,-936
2018,8,26,2,2575,2426,1555,-871
2018,8,26,3,2470,2381,1537,-844
2018,8,26,4,2448,2318,1470,-848
2018,8,26,5,2314,2190,1374,-816
2018,8,26,6,2137,2038,1473,-565
2018,8,26,7,2065,1916,1514,-402
2018,8,26,8,1960,1832,1352,-480
2018,8,26,9,1868,1777,1383,-394
2018,8,26,10,1829,1734,1511,-223
2018,8,26,11,1808,1704,1463,-241
2018,8,26,12,1752,1688,1484,-204
2018,8,26,13,1806,1717,1496,-221
2018,8,26,14,1845,1737,1483,-254
2018,8,26,15,1933,1821,1418,-403
2018,8,26,16,1989,1915,1405,-510
2018,8,26,17,2037,1969,1371,-598
2018,8,26,18,2072,2023,1371,-652
2018,8,26,19,2110,2065,1360,-705
2018,8,26,20,2157,2082,1284,-798
2018,8,26,21,2240,2109,1435,-674
2018,8,26,22,2301,2107,1433,-674
2018,8,26,23,2334,2119,1396,-723
2018,8,27,0,2316,2136,1460,-676
2018,8,27,1,2253,2130,1474,-656
2018,8,27,2,2170,2117,1606,-511
2018,8,27,3,2169,2134,1561,-573
2018,8,27,4,2170,2100,1583,-517
2018,8,27,5,2064,1970,1517,-453
2018,8,27,6,1902,1828,1427,-401
2018,8,27,7,1857,1737,1408,-329
2018,8,27,8,1755,1687,1409,-278
2018,8,27,9,1717,1662,1441,-221
2018,8,27,10,1705,1663,1462,-201
2018,8,27,11,1728,1662,1417,-245
2018,8,27,12,1816,1741,1434,-307
2018,8,27,13,1945,1882,1406,-476
2018,8,27,14,2071,2022,1406,-616
2018,8,27,15,2201,2098,1367,-731
2018,8,27,16,2228,2142,1518,-624
2018,8,27,17,2212,2168,1605,-563
2018,8,27,18,2216,2192,1682,-510
2018,8,27,19,2237,2203,1720,-483
2018,8,27,20,2280,2229,1786,-443
2018,8,27,21,2330,2240,1828,-412
2018,8,27,22,2344,2251,1816,-435
2018,8,27,23,2361,2264,1877,-387
2018,8,28,0,2387,2287,1918,-369
2018,8,28,1,2382,2300,1981,-319
2018,8,28,2,2341,2277,1819,-458
2018,8,28,3,2330,2270,1620,-650
2018,8,28,4,2303,2228,1531,-697
2018,8,28,5,2176,2076,1370,-706
2018,8,28,6,1998,1921,1332,-589
2018,8,28,7,1849,1822,1241,-581
2018,8,28,8,1783,1772,1143,-629
2018,8,28,9,1795,1740,1083,-657
2018,8,28,10,1778,1706,1057,-649
2018,8,28,11,1796,1714,1055,-659
2018,8,28,12,1860,1780,1111,-669
2018,8,28,13,1978,1937,1139,-798
2018,8,28,14,2093,2042,1147,-895
2018,8,28,15,2166,2101,1262,-839
2018,8,28,16,2208,2137,1342,-795
2018,8,28,17,2238,2170,1360,-810
2018,8,28,18,2264,2185,1395,-790
2018,8,28,19,2299,2209,1396,-813
2018,8,28,20,2327,2240,1491,-749
2018,8,28,21,2393,2277,1519,-758
2018,8,28,22,2431,2314,1522,-792
2018,8,28,23,2453,2361,1588,-773
2018,8,29,0,2499,2409,1618,-791
2018,8,29,1,2535,2453,1582,-871
2018,8,29,2,2504,2423,1384,-1039
2018,8,29,3,2458,2400,1312,-1088
2018,8,29,4,2393,2336,1315,-1021
2018,8,29,5,2239,2161,1261,-900
2018,8,29,6,2066,1983,1139,-844
2018,8,29,7,1896,1874,1140,-734
2018,8,29,8,1864,1814,1003,-811
2018,8,29,9,1862,1771,978,-793
2018,8,29,10,1830,1746,958,-788
2018,8,29,11,1826,1747,985,-762
2018,8,29,12,1900,1801,1023,-778
2018,8,29,13,2025,1947,1083,-864
2018,8,29,14,2128,2049,1164,-885
2018,8,29,15,2196,2130,1474,-656
2018,8,29,16,2262,2155,1512,-643
2018,8,29,17,2330,2200,1488,-712
2018,8,29,18,2381,2238,1517,-721
2018,8,29,19,2438,2280,1514,-766
2018,8,29,20,2494,2344,1590,-754
2018,8,29,21,2562,2415,1597,-818
2018,8,29,22,2625,2493,1608,-885
2018,8,29,23,2691,2566,1621,-945
2018,8,30,0,2751,2631,1615,-1016
2018,8,30,1,2768,2670,1566,-1104
2018,8,30,2,2757,2641,1425,-1216
2018,8,30,3,2667,2580,1341,-1239
2018,8,30,4,2571,2484,1382,-1102
2018,8,30,5,2405,2275,1414,-861
2018,8,30,6,2213,2099,1424,-675
2018,8,30,7,2101,1969,1353,-616
2018,8,30,8,2052,1901,1314,-587
2018,8,30,9,1957,1851,1388,-463
2018,8,30,10,1902,1812,1347,-465
2018,8,30,11,1881,1814,1378,-436
2018,8,30,12,1921,1850,1428,-422
2018,8,30,13,2055,2003,1559,-444
2018,8,30,14,2165,2100,1543,-557
2018,8,30,15,2249,2178,1556,-622
2018,8,30,16,2316,2224,1594,-630
2018,8,30,17,2385,2266,1626,-640
2018,8,30,18,2432,2321,1606,-715
2018,8,30,19,2473,2367,1690,-677
2018,8,30,20,2498,2451,1817,-634
2018,8,30,21,2570,2535,1888,-647
2018,8,30,22,2662,2597,1856,-741
2018,8,30,23,2741,2693,1864,-829
2018,8,31,0,2783,2721,1923,-798
2018,8,31,1,2841,2713,1875,-838
2018,8,31,2,2779,2677,1720,-957
2018,8,31,3,2681,2610,1609,-1001
2018,8,31,4,2608,2510,1595,-915
2018,8,31,5,2432,2323,1556,-767
2018,8,31,6,2211,2117,1556,-561
2018,8,31,7,2099,1991,1536,-455
2018,8,31,8,1991,1904,1510,-394
2018,8,31,9,1923,1851,1607,-244
2018,8,31,10,1884,1810,1650,-160
2018,8,31,11,1876,1806,1703,-103
2018,8,31,12,1910,1855,1742,-113
2018,8,31,13,2084,1982,1736,-246
2018,8,31,14,2189,2087,1737,-350
2018,8,31,15,2231,2157,1773,-384
2018,8,31,16,2259,2205,1873,-332
2018,8,31,17,2294,2252,1946,-306
2018,8,31,18,2334,2290,1898,-392
2018,8,31,19,2393,2315,1816,-499
2018,8,31,20,2423,2367,1766,-601
2018,8,31,21,2469,2411,1726,-685
2018,8,31,22,2523,2459,1760,-699
2018,8,31,23,2584,2499,1898,-601
2018,9,1,0,2605,2517,1921,-596
2018,9,1,1,2584,2496,1893,-603
2018,9,1,2,2511,2423,1725,-698
2018,9,1,3,2424,2356,1577,-779
2018,9,1,4,2377,2279,1496,-783
2018,9,1,5,2250,2164,1447,-717
2018,9,1,6,2105,2006,1302,-704
2018,9,1,7,1978,1957,1397,-560
2018,9,1,8,1889,1811,1377,-434
2018,9,1,9,1839,1761,1330,-431
2018,9,1,10,1826,1739,1283,-456
2018,9,1,11,1808,1710,1242,-468
2018,9,1,12,1802,1713,1256,-457
2018,9,1,13,1875,1749,1261,-488
2018,9,1,14,1923,1808,1251,-557
2018,9,1,15,1992,1888,1353,-535
2018,9,1,16,2047,1974,1460,-514
2018,9,1,17,2104,2026,1535,-491
2018,9,1,18,2144,2049,1566,-483
2018,9,1,19,2171,2075,1639,-436
2018,9,1,20,2200,2113,1665,-448
2018,9,1,21,2247,2175,1728,-447
2018,9,1,22,2316,2232,1777,-455
2018,9,1,23,2386,2283,1805,-478
2018,9,2,0,2401,2322,1835,-487
2018,9,2,1,2398,2339,1868,-471
2018,9,2,2,2359,2288,1721,-567
2018,9,2,3,2299,2219,1669,-550
2018,9,2,4,2216,2154,1582,-572
2018,9,2,5,2121,2012,1390,-622
2018,9,2,6,1974,1875,1301,-574
2018,9,2,7,1900,1767,1255,-512
2018,9,2,8,1830,1697,1250,-447
2018,9,2,9,1745,1660,1265,-395
2018,9,2,10,1722,1646,1192,-454
2018,9,2,11,1712,1625,1170,-455
2018,9,2,12,1704,1628,1161,-467
2018,9,2,13,1752,1661,1142,-519
2018,9,2,14,1795,1676,1141,-535
2018,9,2,15,1873,1756,1255,-501
2018,9,2,16,1929,1827,1321,-506
2018,9,2,17,1982,1869,1326,-543
2018,9,2,18,2022,1910,1325,-585
2018,9,2,19,2060,1945,1329,-616
2018,9,2,20,2076,1988,1347,-641
2018,9,2,21,2136,2077,1511,-566
2018,9,2,22,2220,2140,1589,-551
2018,9,2,23,2301,2220,1605,-615
2018,9,3,0,2343,2280,1686,-594
2018,9,3,1,2371,2294,1719,-575
2018,9,3,2,2341,2234,1521,-713
2018,9,3,3,2249,2159,1483,-676
2018,9,3,4,2147,2063,1503,-560
2018,9,3,5,2007,1923,1308,-615
2018,9,3,6,1856,1784,1211,-573
2018,9,3,7,1833,1685,1161,-524
2018,9,3,8,1752,1629,1150,-479
2018,9,3,9,1683,1572,1086,-486
2018,9,3,10,1654,1568,1056,-512
2018,9,3,11,1665,1543,1042,-501
2018,9,3,12,1725,1569,1068,-501
2018,9,3,13,1837,1609,1070,-539
2018,9,3,14,1921,1672,1088,-584
2018,9,3,15,1981,1789,1259,-530
2018,9,3,16,1992,1897,1365,-532
2018,9,3,17,2049,1994,1382,-612
2018,9,3,18,2126,2047,1363,-684
2018,9,3,19,2202,2107,1341,-766
2018,9,3,20,2258,2163,1354,-809
2018,9,3,21,2328,2255,1400,-855
2018,9,3,22,2415,2352,1542,-810
2018,9,3,23,2501,2446,1708,-738
2018,9,4,0,2536,2529,1850,-679
2018,9,4,1,2568,2559,1850,-709
2018,9,4,2,2556,2504,1658,-846
2018,9,4,3,2466,2451,1635,-816
2018,9,4,4,2386,2349,1567,-782
2018,9,4,5,2272,2146,1408,-738
2018,9,4,6,2100,1946,1396,-550
2018,9,4,7,1987,1828,1316,-512
2018,9,4,8,1880,1738,1213,-525
2018,9,4,9,1760,1706,1202,-504
2018,9,4,10,1738,1676,1209,-467
2018,9,4,11,1745,1669,1195,-474
2018,9,4,12,1766,1733,1175,-558
2018,9,4,13,1871,1877,1160,-717
2018,9,4,14,1976,1985,1168,-817
2018,9,4,15,2071,2049,1309,-740
2018,9,4,16,2164,2127,1421,-706
2018,9,4,17,2231,2185,1414,-771
2018,9,4,18,2263,2249,1420,-829
2018,9,4,19,2334,2309,1475,-834
2018,9,4,20,2420,2382,1521,-861
2018,9,4,21,2547,2479,1588,-891
2018,9,4,22,2634,2567,1641,-926
2018,9,4,23,2708,2656,1656,-1000
2018,9,5,0,2788,2708,1643,-1065
2018,9,5,1,2823,2725,1632,-1093
2018,9,5,2,2754,2687,1533,-1154
2018,9,5,3,2603,2601,1541,-1060
2018,9,5,4,2490,2472,1527,-945
2018,9,5,5,2343,2237,1413,-824
2018,9,5,6,2150,2044,1225,-819
2018,9,5,7,1979,1918,1175,-743
2018,9,5,8,1847,1837,1110,-727
2018,9,5,9,1867,1776,1080,-696
2018,9,5,10,1822,1741,1066,-675
2018,9,5,11,1808,1743,1052,-691
2018,9,5,12,1850,1787,1045,-742
2018,9,5,13,1970,1939,1183,-756
2018,9,5,14,2073,2037,1262,-775
2018,9,5,15,2152,2090,1324,-766
2018,9,5,16,2236,2158,1497,-661
2018,9,5,17,2324,2232,1495,-737
2018,9,5,18,2401,2276,1433,-843
2018,9,5,19,2488,2332,1470,-862
2018,9,5,20,2586,2448,1530,-918
2018,9,5,21,2704,2584,1586,-998
2018,9,5,22,2818,2713,1627,-1086
2018,9,5,23,2895,2818,1653,-1165
2018,9,6,0,2960,2851,1719,-1132
2018,9,6,1,2978,2838,1661,-1177
2018,9,6,2,2861,2776,1560,-1216
2018,9,6,3,2729,2716,1455,-1261
2018,9,6,4,2655,2566,1446,-1120
2018,9,6,5,2478,2359,1382,-977
2018,9,6,6,2251,2142,1307,-835
2018,9,6,7,2093,2001,1152,-849
2018,9,6,8,2028,1925,1187,-738
2018,9,6,9,1975,1860,1253,-607
2018,9,6,10,1918,1823,1251,-572
2018,9,6,11,1909,1798,1171,-627
2018,9,6,12,1950,1859,1221,-638
2018,9,6,13,2067,1985,1285,-700
2018,9,6,14,2149,2077,1367,-710
2018,9,6,15,2226,2142,1355,-787
2018,9,6,16,2340,2212,1363,-849
2018,9,6,17,2442,2296,1446,-850
2018,9,6,18,2514,2399,1542,-857
2018,9,6,19,2593,2503,1674,-829
2018,9,6,20,2656,2599,1708,-891
2018,9,6,21,2745,2719,1705,-1014
2018,9,6,22,2833,2824,1780,-1044
2018,9,6,23,2900,2895,1985,-910
2018,9,7,0,2930,2921,2099,-822
2018,9,7,1,2969,2868,1954,-914
2018,9,7,2,2911,2807,1853,-954
2018,9,7,3,2846,2762,1798,-964
2018,9,7,4,2731,2636,1795,-841
2018,9,7,5,2514,2399,1515,-884
2018,9,7,6,2285,2204,1447,-757
2018,9,7,7,2128,2058,1332,-726
2018,9,7,8,2052,1967,1216,-751
2018,9,7,9,1974,1878,1270,-608
2018,9,7,10,1939,1830,1303,-527
2018,9,7,11,1896,1800,1319,-481
2018,9,7,12,1950,1838,1250,-588
2018,9,7,13,2053,1975,1252,-723
2018,9,7,14,2123,2069,1281,-788
2018,9,7,15,2196,2129,1352,-777
2018,9,7,16,2288,2220,1432,-788
2018,9,7,17,2310,2301,1437,-864
2018,9,7,18,2355,2393,1554,-839
2018,9,7,19,2492,2473,1606,-867
2018,9,7,20,2573,2601,1623,-978
2018,9,7,21,2701,2702,1672,-1030
2018,9,7,22,2853,2791,1682,-1109
2018,9,7,23,2939,2849,1657,-1192
2018,9,8,0,2949,2818,1592,-1226
2018,9,8,1,2918,2763,1619,-1144
2018,9,8,2,2766,2673,1555,-1118
2018,9,8,3,2659,2602,1496,-1106
2018,9,8,4,2576,2477,1447,-1030
2018,9,8,5,2414,2307,1278,-1029
2018,9,8,6,2229,2136,1201,-935
2018,9,8,7,2131,2007,1133,-874
2018,9,8,8,2001,1932,1197,-735
2018,9,8,9,1962,1868,1211,-657
2018,9,8,10,1946,1817,1183,-634
2018,9,8,11,1908,1785,1154,-631
2018,9,8,12,1864,1783,1121,-662
2018,9,8,13,1914,1805,1152,-653
2018,9,8,14,1936,1851,1297,-554
2018,9,8,15,1979,1940,1506,-434
2018,9,8,16,2032,2018,1670,-348
2018,9,8,17,2175,2107,1832,-275
2018,9,8,18,2250,2172,1846,-326
2018,9,8,19,2288,2241,1845,-396
2018,9,8,20,2345,2316,1807,-509
2018,9,8,21,2452,2380,1706,-674
2018,9,8,22,2533,2461,1625,-836
2018,9,8,23,2576,2512,1602,-910
2018,9,9,0,2575,2531,1706,-825
2018,9,9,1,2542,2487,1690,-797
2018,9,9,2,2474,2397,1577,-820
2018,9,9,3,2398,2322,1559,-763
2018,9,9,4,2303,2208,1505,-703
2018,9,9,5,2153,2075,1318,-757
2018,9,9,6,1982,1916,1266,-650
2018,9,9,7,1860,1803,1231,-572
2018,9,9,8,1792,1716,1185,-531
2018,9,9,9,1750,1671,1165,-506
2018,9,9,10,1703,1637,1133,-504
2018,9,9,11,1692,1622,1084,-538
2018,9,9,12,1678,1628,1087,-541
2018,9,9,13,1726,1640,1103,-537
2018,9,9,14,1761,1672,1093,-579
2018,9,9,15,1821,1765,1137,-628
2018,9,9,16,1876,1836,1220,-616
2018,9,9,17,1971,1902,1235,-667
2018,9,9,18,2027,1946,1189,-757
2018,9,9,19,2062,2026,1189,-837
2018,9,9,20,2123,2099,1181,-918
2018,9,9,21,2229,2170,1230,-940
2018,9,9,22,2324,2256,1356,-900
2018,9,9,23,2402,2320,1352,-968
2018,9,10,0,2436,2383,1488,-895
2018,9,10,1,2422,2395,1466,-929
2018,9,10,2,2383,2328,1345,-983
2018,9,10,3,2326,2285,1323,-962
2018,9,10,4,2240,2163,1247,-916
2018,9,10,5,2086,1973,1135,-838
2018,9,10,6,1901,1795,1018,-777
2018,9,10,7,1788,1688,1003,-685
2018,9,10,8,1725,1627,1011,-616
2018,9,10,9,1668,1581,1014,-567
2018,9,10,10,1647,1564,1062,-502
2018,9,10,11,1649,1571,1087,-484
2018,9,10,12,1714,1649,1117,-532
2018,9,10,13,1825,1802,1217,-585
2018,9,10,14,1946,1935,1256,-679
2018,9,10,15,2133,1980,1266,-714
2018,9,10,16,2182,2031,1291,-740
2018,9,10,17,2191,2084,1328,-756
2018,9,10,18,2249,2123,1260,-863
2018,9,10,19,2289,2155,1323,-832
2018,9,10,20,2337,2201,1357,-844
2018,9,10,21,2390,2240,1469,-771
2018,9,10,22,2441,2283,1683,-600
2018,9,10,23,2447,2336,1860,-476
2018,9,11,0,2457,2405,1945,-460
2018,9,11,1,2454,2409,1872,-537
2018,9,11,2,2408,2370,1671,-699
2018,9,11,3,2390,2357,1525,-832
2018,9,11,4,2330,2237,1390,-847
2018,9,11,5,2169,2040,1224,-816
2018,9,11,6,1987,1874,1153,-721
2018,9,11,7,1902,1767,1096,-671
2018,9,11,8,1825,1711,1120,-591
2018,9,11,9,1734,1665,1098,-567
2018,9,11,10,1715,1638,1075,-563
2018,9,11,11,1726,1647,1166,-481
2018,9,11,12,1783,1702,1205,-497
2018,9,11,13,1927,1846,1264,-582
2018,9,11,14,2040,1953,1253,-700
2018,9,11,15,2050,1992,1324,-668
2018,9,11,16,2088,2032,1529,-503
2018,9,11,17,2144,2049,1582,-467
2018,9,11,18,2155,2081,1620,-461
2018,9,11,19,2159,2101,1583,-518
2018,9,11,20,2193,2129,1624,-505
2018,9,11,21,2227,2156,1625,-531
2018,9,11,22,2266,2176,1658,-518
2018,9,11,23,2304,2189,1650,-539
2018,9,12,0,2323,2177,1536,-641
2018,9,12,1,2305,2173,1672,-501
2018,9,12,2,2240,2158,1679,-479
2018,9,12,3,2231,2188,1679,-509
2018,9,12,4,2178,2115,1672,-443
2018,9,12,5,2049,1961,1598,-363
2018,9,12,6,1906,1830,1684,-146
2018,9,12,7,1835,1732,1614,-118
2018,9,12,8,1757,1676,1520,-156
2018,9,12,9,1725,1647,1543,-104
2018,9,12,10,1706,1633,1534,-99
2018,9,12,11,1720,1636,1481,-155
2018,9,12,12,1788,1695,1437,-258
2018,9,12,13,1935,1842,1382,-460
2018,9,12,14,2042,1959,1342,-617
2018,9,12,15,2064,2004,1306,-698
2018,9,12,16,2095,2018,1422,-596
2018,9,12,17,2129,2021,1477,-544
2018,9,12,18,2138,2028,1466,-562
2018,9,12,19,2138,2036,1654,-382
2018,9,12,20,2154,2046,1667,-379
2018,9,12,21,2184,2062,1664,-398
2018,9,12,22,2205,2079,1650,-429
2018,9,12,23,2218,2091,1654,-437
2018,9,13,0,2223,2093,1615,-478
2018,9,13,1,2209,2085,1624,-461
2018,9,13,2,2174,2090,1575,-515
2018,9,13,3,2193,2133,1547,-586
2018,9,13,4,2151,2052,1453,-599
2018,9,13,5,2017,1926,1390,-536
2018,9,13,6,1877,1775,1247,-528
2018,9,13,7,1813,1693,1184,-509
2018,9,13,8,1753,1642,1101,-541
2018,9,13,9,1687,1613,1088,-525
2018,9,13,10,1673,1591,1086,-505
2018,9,13,11,1686,1603,1142,-461
2018,9,13,12,1744,1669,1251,-418
2018,9,13,13,1892,1825,1370,-455
2018,9,13,14,2012,1948,1376,-572
2018,9,13,15,2048,1994,1408,-586
2018,9,13,16,2089,2017,1408,-609
2018,9,13,17,2133,2023,1429,-594
2018,9,13,18,2149,2038,1436,-602
2018,9,13,19,2154,2049,1447,-602
2018,9,13,20,2161,2069,1450,-619
2018,9,13,21,2168,2074,1443,-631
2018,9,13,22,2180,2079,1460,-619
2018,9,13,23,2201,2103,1502,-601
2018,9,14,0,2213,2109,1480,-629
2018,9,14,1,2199,2114,1434,-680
2018,9,14,2,2186,2085,1352,-733
2018,9,14,3,2202,2103,1253,-850
2018,9,14,4,2133,2041,1269,-772
2018,9,14,5,1978,1897,1253,-644
2018,9,14,6,1848,1750,1108,-642
2018,9,14,7,1796,1674,1064,-610
2018,9,14,8,1712,1617,1081,-536
2018,9,14,9,1674,1588,1082,-506
2018,9,14,10,1661,1570,1060,-510
2018,9,14,11,1670,1585,1080,-505
2018,9,14,12,1738,1645,1090,-555
2018,9,14,13,1890,1786,1123,-663
2018,9,14,14,2007,1905,1135,-770
2018,9,14,15,2027,1948,1164,-784
2018,9,14,16,2053,1940,1234,-706
2018,9,14,17,2082,1988,1327,-661
2018,9,14,18,2108,1976,1319,-657
2018,9,14,19,2125,1976,1312,-664
2018,9,14,20,2141,2012,1319,-693
2018,9,14,21,2186,2036,1376,-660
2018,9,14,22,2224,2076,1451,-625
2018,9,14,23,2251,2111,1548,-563
2018,9,15,0,2259,2132,1657,-475
2018,9,15,1,2255,2124,1529,-595
2018,9,15,2,2193,2092,1424,-668
2018,9,15,3,2134,2077,1393,-684
2018,9,15,4,2041,1996,1362,-634
2018,9,15,5,1952,1899,1332,-567
2018,9,15,6,1862,1765,1170,-595
2018,9,15,7,1818,1670,1104,-566
2018,9,15,8,1743,1611,1085,-526
2018,9,15,9,1651,1567,1065,-502
2018,9,15,10,1636,1541,1053,-488
2018,9,15,11,1629,1537,1009,-528
2018,9,15,12,1628,1547,1003,-544
2018,9,15,13,1704,1601,999,-602
2018,9,15,14,1767,1659,1013,-646
2018,9,15,15,1839,1737,1033,-704
2018,9,15,16,1898,1803,1183,-620
2018,9,15,17,1962,1842,1233,-609
2018,9,15,18,2015,1854,1261,-593
2018,9,15,19,2030,1865,1260,-605
2018,9,15,20,2036,1873,1264,-609
2018,9,15,21,2070,1853,1324,-529
2018,9,15,22,2065,1866,1723,-143
2018,9,15,23,2036,1862,1840,-22
2018,9,16,0,2138,1887,1739,-148
2018,9,16,1,2076,1899,1591,-308
2018,9,16,2,2001,1874,1404,-470
2018,9,16,3,1978,1899,1313,-586
2018,9,16,4,1955,1845,1243,-602
2018,9,16,5,1868,1754,1163,-591
2018,9,16,6,1742,1657,1157,-500
2018,9,16,7,1726,1571,1148,-423
2018,9,16,8,1630,1519,1123,-396
2018,9,16,9,1585,1481,1139,-342
2018,9,16,10,1568,1467,1115,-352
2018,9,16,11,1563,1462,1095,-367
2018,9,16,12,1572,1479,1087,-392
2018,9,16,13,1613,1515,1070,-445
2018,9,16,14,1669,1564,1016,-548
2018,9,16,15,1737,1657,1110,-547
2018,9,16,16,1786,1704,1288,-416
2018,9,16,17,1822,1751,1299,-452
2018,9,16,18,1856,1780,1417,-363
2018,9,16,19,1884,1797,1363,-434
2018,9,16,20,1889,1803,1388,-415
2018,9,16,21,1913,1835,1581,-254
2018,9,16,22,1942,1871,1584,-287
2018,9,16,23,1981,1938,1590,-348
2018,9,17,0,2032,1984,1589,-395
2018,9,17,1,2050,1970,1541,-429
2018,9,17,2,2024,1972,1394,-578
2018,9,17,3,2010,1967,1372,-595
2018,9,17,4,1935,1877,1415,-462
2018,9,17,5,1848,1735,1373,-362
2018,9,17,6,1703,1592,1193,-399
2018,9,17,7,1606,1497,1104,-393
2018,9,17,8,1553,1465,1068,-397
2018,9,17,9,1526,1449,1040,-409
2018,9,17,10,1517,1435,1028,-407
2018,9,17,11,1542,1442,1014,-428
2018,9,17,12,1618,1515,1058,-457
2018,9,17,13,1746,1679,1147,-532
2018,9,17,14,1881,1814,1190,-624
2018,9,17,15,2034,1842,1286,-556
2018,9,17,16,2042,1866,1375,-491
2018,9,17,17,1979,1885,1370,-515
2018,9,17,18,1976,1895,1351,-544
2018,9,17,19,1981,1914,1353,-561
2018,9,17,20,1992,1940,1341,-599
2018,9,17,21,2052,1967,1422,-545
2018,9,17,22,2108,1995,1448,-547
2018,9,17,23,2152,2036,1542,-494
2018,9,18,0,2177,2078,1533,-545
2018,9,18,1,2190,2093,1518,-575
2018,9,18,2,2143,2065,1434,-631
2018,9,18,3,2143,2075,1500,-575
2018,9,18,4,2072,1957,1509,-448
2018,9,18,5,1939,1801,1389,-412
2018,9,18,6,1777,1654,1343,-311
2018,9,18,7,1722,1561,1230,-331
2018,9,18,8,1664,1512,1180,-332
2018,9,18,9,1574,1479,1124,-355
2018,9,18,10,1554,1477,1055,-422
2018,9,18,11,1566,1485,1086,-399
2018,9,18,12,1633,1551,1093,-458
2018,9,18,13,1788,1714,1131,-583
2018,9,18,14,1914,1834,1217,-617
2018,9,18,15,1927,1872,1305,-567
2018,9,18,16,1958,1888,1429,-459
2018,9,18,17,1993,1919,1467,-452
2018,9,18,18,1998,1933,1484,-449
2018,9,18,19,2010,1940,1499,-441
2018,9,18,20,2019,1949,1483,-466
2018,9,18,21,2074,1998,1622,-376
2018,9,18,22,2113,2023,1640,-383
2018,9,18,23,2156,2054,1672,-382
2018,9,19,0,2175,2077,1722,-355
2018,9,19,1,2188,2093,1666,-427
2018,9,19,2,2137,2071,1584,-487
2018,9,19,3,2144,2089,1685,-404
2018,9,19,4,2087,1976,1565,-411
2018,9,19,5,1942,1824,1447,-377
2018,9,19,6,1779,1679,1404,-275
2018,9,19,7,1729,1584,1381,-203
2018,9,19,8,1625,1538,1275,-263
2018,9,19,9,1570,1508,1246,-262
2018,9,19,10,1563,1494,1239,-255
2018,9,19,11,1579,1507,1221,-286
2018,9,19,12,1646,1581,1231,-350
2018,9,19,13,1806,1742,1331,-411
2018,9,19,14,1942,1858,1375,-483
2018,9,19,15,1954,1893,1534,-359
2018,9,19,16,1975,1914,1647,-267
2018,9,19,17,2007,1925,1649,-276
2018,9,19,18,2008,1944,1624,-320
2018,9,19,19,2014,1944,1625,-319
2018,9,19,20,2021,1968,1595,-373
2018,9,19,21,2071,1979,1607,-372
2018,9,19,22,2080,1997,1696,-301
2018,9,19,23,2074,2023,1776,-247
2018,9,20,0,2094,2031,1930,-101
2018,9,20,1,2098,2019,1868,-151
2018,9,20,2,2059,2015,1861,-154
2018,9,20,3,2109,2047,1846,-201
2018,9,20,4,2045,1954,1748,-206
2018,9,20,5,1892,1809,1619,-190
2018,9,20,6,1742,1667,1603,-64
2018,9,20,7,1663,1576,1562,-14
2018,9,20,8,1595,1541,1529,-12
2018,9,20,9,1579,1502,1567,65
2018,9,20,10,1569,1489,1545,56
2018,9,20,11,1585,1507,1577,70
2018,9,20,12,1658,1568,1574,6
2018,9,20,13,1822,1746,1580,-166
2018,9,20,14,1952,1868,1679,-189
2018,9,20,15,1968,1889,1686,-203
2018,9,20,16,1978,1914,1787,-127
2018,9,20,17,1989,1910,1751,-159
2018,9,20,18,1981,1912,1737,-175
2018,9,20,19,1963,1920,1652,-268
2018,9,20,20,1956,1927,1644,-283
2018,9,20,21,1978,1948,1618,-330
2018,9,20,22,2001,1968,1676,-292
2018,9,20,23,2008,1999,1629,-370
2018,9,21,0,2016,2002,1729,-273
2018,9,21,1,2034,1993,1645,-348
2018,9,21,2,2027,1992,1494,-498
2018,9,21,3,2068,2018,1443,-575
2018,9,21,4,1990,1929,1402,-527
2018,9,21,5,1862,1808,1381,-427
2018,9,21,6,1730,1673,1296,-377
2018,9,21,7,1624,1582,1206,-376
2018,9,21,8,1579,1533,1195,-338
2018,9,21,9,1586,1518,1188,-330
2018,9,21,10,1574,1504,1197,-307
2018,9,21,11,1586,1507,1187,-320
2018,9,21,12,1668,1587,1190,-397
2018,9,21,13,1824,1733,1208,-525
2018,9,21,14,1942,1870,1236,-634
2018,9,21,15,1946,1891,1246,-645
2018,9,21,16,1950,1922,1371,-551
2018,9,21,17,1980,1924,1349,-575
2018,9,21,18,2017,1923,1319,-604
2018,9,21,19,2048,1919,1339,-580
2018,9,21,20,2052,1958,1448,-510
2018,9,21,21,2115,1979,1450,-529
2018,9,21,22,2148,2010,1482,-528
2018,9,21,23,2162,2036,1559,-477
2018,9,22,0,2145,2026,1469,-557
2018,9,22,1,2129,2007,1481,-526
2018,9,22,2,2027,1972,1447,-525
2018,9,22,3,1993,1973,1469,-504
2018,9,22,4,1941,1910,1420,-490
2018,9,22,5,1859,1802,1388,-414
2018,9,22,6,1760,1687,1318,-369
2018,9,22,7,1697,1591,1173,-418
2018,9,22,8,1653,1536,1137,-399
2018,9,22,9,1585,1498,1185,-313
2018,9,22,10,1563,1472,1149,-323
2018,9,22,11,1544,1473,1141,-332
2018,9,22,12,1569,1492,1132,-360
2018,9,22,13,1637,1548,1136,-412
2018,9,22,14,1690,1609,1138,-471
2018,9,22,15,1747,1695,1181,-514
2018,9,22,16,1837,1754,1229,-525
2018,9,22,17,1929,1793,1317,-476
2018,9,22,18,1975,1805,1293,-512
2018,9,22,19,1979,1835,1321,-514
2018,9,22,20,1969,1857,1428,-429
2018,9,22,21,1987,1910,1466,-444
2018,9,22,22,2009,1937,1443,-494
2018,9,22,23,2025,1970,1507,-463
2018,9,23,0,2036,1983,1528,-455
2018,9,23,1,2033,1969,1494,-475
2018,9,23,2,1948,1957,1433,-524
2018,9,23,3,1968,1933,1426,-507
2018,9,23,4,1917,1857,1461,-396
2018,9,23,5,1836,1740,1427,-313
2018,9,23,6,1702,1622,1252,-370
2018,9,23,7,1638,1527,1274,-253
2018,9,23,8,1551,1470,1339,-131
2018,9,23,9,1518,1444,1337,-107
2018,9,23,10,1500,1415,1330,-85
2018,9,23,11,1497,1405,1320,-85
2018,9,23,12,1516,1433,1320,-113
2018,9,23,13,1562,1461,1251,-210
2018,9,23,14,1605,1520,1250,-270
2018,9,23,15,1660,1589,1229,-360
2018,9,23,16,1723,1651,1278,-373
2018,9,23,17,1757,1687,1408,-279
2018,9,23,18,1747,1709,1601,-108
2018,9,23,19,1742,1721,1710,-11
2018,9,23,20,1747,1741,1707,-34
2018,9,23,21,1780,1746,1701,-45
2018,9,23,22,1804,1767,1721,-46
2018,9,23,23,1823,1802,1853,51
2018,9,24,0,1863,1840,1995,155
2018,9,24,1,1870,1828,1884,56
2018,9,24,2,1861,1822,1779,-43
2018,9,24,3,1918,1836,1775,-61
2018,9,24,4,1870,1761,1759,-2
2018,9,24,5,1741,1616,1679,63
2018,9,24,6,1595,1504,1531,27
2018,9,24,7,1501,1432,1540,108
2018,9,24,8,1475,1390,1487,97
2018,9,24,9,1466,1379,1524,145
2018,9,24,10,1468,1375,1443,68
2018,9,24,11,1489,1405,1387,-18
2018,9,24,12,1569,1486,1346,-140
2018,9,24,13,1723,1666,1372,-294
2018,9,24,14,1874,1802,1397,-405
2018,9,24,15,2014,1843,1467,-376
2018,9,24,16,2011,1857,1643,-214
2018,9,24,17,1933,1862,1792,-70
2018,9,24,18,1907,1870,1841,-29
2018,9,24,19,1874,1858,1906,48
2018,9,24,20,1868,1865,1921,56
2018,9,24,21,1897,1863,2067,204
2018,9,24,22,1916,1870,2089,219
2018,9,24,23,1922,1872,2082,210
2018,9,25,0,1956,1886,2067,181
2018,9,25,1,1956,1897,2036,139
2018,9,25,2,1938,1907,1899,-8
2018,9,25,3,2004,1941,1915,-26
2018,9,25,4,1951,1847,1888,41
2018,9,25,5,1826,1718,1793,75
2018,9,25,6,1685,1579,1567,-12
2018,9,25,7,1609,1506,1312,-194
2018,9,25,8,1565,1476,1162,-314
2018,9,25,9,1527,1440,1141,-299
2018,9,25,10,1543,1431,1119,-312
2018,9,25,11,1560,1456,1120,-336
2018,9,25,12,1638,1543,1127,-416
2018,9,25,13,1793,1710,1161,-549
2018,9,25,14,1931,1828,1166,-662
2018,9,25,15,1921,1853,1300,-553
2018,9,25,16,1917,1853,1373,-480
2018,9,25,17,1924,1842,1367,-475
2018,9,25,18,1915,1854,1384,-470
2018,9,25,19,1917,1853,1431,-422
2018,9,25,20,1912,1863,1418,-445
2018,9,25,21,1920,1868,1508,-360
2018,9,25,22,1935,1860,1489,-371
2018,9,25,23,1948,1883,1512,-371
2018,9,26,0,1962,1898,1517,-381
2018,9,26,1,1969,1899,1508,-391
2018,9,26,2,1956,1914,1433,-481
2018,9,26,3,2001,1937,1495,-442
2018,9,26,4,1940,1846,1442,-404
2018,9,26,5,1804,1709,1306,-403
2018,9,26,6,1666,1585,1290,-295
2018,9,26,7,1600,1510,1153,-357
2018,9,26,8,1547,1461,1037,-424
2018,9,26,9,1530,1449,1031,-418
2018,9,26,10,1515,1455,1043,-412
2018,9,26,11,1534,1461,1038,-423
2018,9,26,12,1619,1552,1067,-485
2018,9,26,13,1777,1734,1182,-552
2018,9,26,14,1904,1883,1320,-563
2018,9,26,15,1922,1894,1391,-503
2018,9,26,16,1946,1897,1416,-481
2018,9,26,17,1974,1899,1431,-468
2018,9,26,18,1971,1877,1382,-495
2018,9,26,19,1973,1865,1364,-501
2018,9,26,20,1959,1881,1397,-484
2018,9,26,21,1973,1902,1470,-432
2018,9,26,22,1985,1905,1561,-344
2018,9,26,23,1998,1913,1610,-303
2018,9,27,0,2010,1932,1613,-319
2018,9,27,1,2020,1931,1602,-329
2018,9,27,2,1992,1935,1531,-404
2018,9,27,3,2022,1953,1538,-415
2018,9,27,4,1947,1865,1430,-435
2018,9,27,5,1801,1717,1387,-330
2018,9,27,6,1664,1602,1347,-255
2018,9,27,7,1584,1516,1185,-331
2018,9,27,8,1550,1469,1079,-390
2018,9,27,9,1529,1447,1050,-397
2018,9,27,10,1492,1438,1035,-403
2018,9,27,11,1510,1456,1014,-442
2018,9,27,12,1596,1541,951,-590
2018,9,27,13,1758,1710,1026,-684
2018,9,27,14,1883,1840,1155,-685
2018,9,27,15,1896,1860,1217,-643
2018,9,27,16,1926,1855,1375,-480
2018,9,27,17,1973,1853,1421,-432
2018,9,27,18,1991,1848,1388,-460
2018,9,27,19,1983,1860,1396,-464
2018,9,27,20,1979,1874,1447,-427
2018,9,27,21,1992,1887,1530,-357
2018,9,27,22,2004,1916,1656,-260
2018,9,27,23,2031,1934,1751,-183
2018,9,28,0,2026,1971,1796,-175
2018,9,28,1,2052,1967,1708,-259
2018,9,28,2,1993,1960,1577,-383
2018,9,28,3,2017,1969,1607,-362
2018,9,28,4,1930,1875,1523,-352
2018,9,28,5,1800,1724,1424,-300
2018,9,28,6,1660,1578,1242,-336
2018,9,28,7,1628,1493,1195,-298
2018,9,28,8,1569,1452,1110,-342
2018,9,28,9,1476,1417,1082,-335
2018,9,28,10,1468,1412,1059,-353
2018,9,28,11,1486,1425,1029,-396
2018,9,28,12,1559,1502,1031,-471
2018,9,28,13,1729,1656,1094,-562
2018,9,28,14,1850,1780,1145,-635
2018,9,28,15,1853,1820,1369,-451
2018,9,28,16,1884,1851,1505,-346
2018,9,28,17,1929,1867,1495,-372
2018,9,28,18,1954,1874,1455,-419
2018,9,28,19,1967,1885,1399,-486
2018,9,28,20,1961,1913,1406,-507
2018,9,28,21,2006,1901,1405,-496
2018,9,28,22,2024,1953,1426,-527
2018,9,28,23,2024,1968,1407,-561
2018,9,29,0,2015,1951,1416,-535
2018,9,29,1,1989,1910,1400,-510
2018,9,29,2,1930,1908,1355,-553
2018,9,29,3,1939,1888,1402,-486
2018,9,29,4,1915,1816,1329,-487
2018,9,29,5,1793,1718,1267,-451
2018,9,29,6,1671,1611,1133,-478
2018,9,29,7,1633,1512,1020,-492
2018,9,29,8,1541,1456,1075,-381
2018,9,29,9,1487,1421,1067,-354
2018,9,29,10,1474,1403,1024,-379
2018,9,29,11,1477,1387,986,-401
2018,9,29,12,1504,1420,1012,-408
2018,9,29,13,1575,1491,1019,-472
2018,9,29,14,1640,1566,1060,-506
2018,9,29,15,1694,1660,1112,-548
2018,9,29,16,1759,1727,1118,-609
2018,9,29,17,1815,1752,1123,-629
2018,9,29,18,1844,1756,1174,-582
2018,9,29,19,1849,1749,1162,-587
2018,9,29,20,1839,1755,1324,-431
2018,9,29,21,1844,1775,1347,-428
2018,9,29,22,1865,1808,1312,-496
2018,9,29,23,1902,1824,1341,-483
2018,9,30,0,1952,1843,1414,-429
2018,9,30,1,1921,1823,1424,-399
2018,9,30,2,1864,1834,1412,-422
2018,9,30,3,1882,1819,1384,-435
2018,9,30,4,1832,1762,1394,-368
2018,9,30,5,1744,1639,1253,-386
2018,9,30,6,1632,1543,1144,-399
2018,9,30,7,1539,1448,895,-553
2018,9,30,8,1483,1405,902,-503
2018,9,30,9,1471,1360,826,-534
2018,9,30,10,1445,1353,874,-479
2018,9,30,11,1436,1343,804,-539
2018,9,30,12,1454,1357,867,-490
2018,9,30,13,1513,1404,851,-553
2018,9,30,14,1554,1463,769,-694
2018,9,30,15,1622,1529,812,-717
2018,9,30,16,1687,1601,921,-680
2018,9,30,17,1733,1646,1016,-630
2018,9,30,18,1736,1665,1015,-650
2018,9,30,19,1732,1667,993,-674
2018,9,30,20,1724,1704,1023,-681
2018,9,30,21,1729,1703,1029,-674
2018,9,30,22,1767,1718,1002,-716
2018,9,30,23,1795,1747,1037,-710
2018,10,1,0,1843,1758,1101,-657
2018,10,1,1,1826,1763,1085,-678
2018,10,1,2,1797,1770,993,-777
2018,10,1,3,1823,1776,985,-791
2018,10,1,4,1765,1687,939,-748
2018,10,1,5,1648,1569,778,-791
2018,10,1,6,1539,1442,721,-721
2018,10,1,7,1428,1452,766,-686
2018,10,1,8,1406,1337,686,-651
2018,10,1,9,1391,1322,694,-628
2018,10,1,10,1384,1331,726,-605
2018,10,1,11,1414,1347,707,-640
2018,10,1,12,1486,1437,729,-708
2018,10,1,13,1632,1619,864,-755
2018,10,1,14,1786,1761,882,-879
2018,10,1,15,1921,1802,922,-880
2018,10,1,16,1932,1818,1060,-758
2018,10,1,17,1894,1816,1083,-733
2018,10,1,18,1892,1828,1081,-747
2018,10,1,19,1880,1803,1129,-674
2018,10,1,20,1897,1815,1138,-677
2018,10,1,21,1918,1807,1158,-649
2018,10,1,22,1917,1806,1127,-679
2018,10,1,23,1906,1807,1112,-695
2018,10,2,0,1937,1807,1122,-685
2018,10,2,1,1912,1824,1098,-726
2018,10,2,2,1893,1862,1049,-813
2018,10,2,3,1946,1859,1031,-828
2018,10,2,4,1914,1774,1048,-726
2018,10,2,5,1768,1645,970,-675
2018,10,2,6,1636,1523,941,-582
2018,10,2,7,1576,1437,812,-625
2018,10,2,8,1527,1395,684,-711
2018,10,2,9,1457,1362,621,-741
2018,10,2,10,1442,1357,648,-709
2018,10,2,11,1457,1366,657,-709
2018,10,2,12,1521,1445,669,-776
2018,10,2,13,1677,1607,707,-900
2018,10,2,14,1810,1741,907,-834
2018,10,2,15,1827,1778,1052,-726
2018,10,2,16,1871,1794,1157,-637
2018,10,2,17,1913,1802,1098,-704
2018,10,2,18,1920,1803,1017,-786
2018,10,2,19,1913,1807,888,-919
2018,10,2,20,1906,1808,859,-949
2018,10,2,21,1912,1801,928,-873
2018,10,2,22,1878,1798,1029,-769
2018,10,2,23,1847,1780,1072,-708
2018,10,3,0,1861,1800,1121,-679
2018,10,3,1,1848,1802,1054,-748
2018,10,3,2,1884,1845,1046,-799
2018,10,3,3,1939,1863,993,-870
2018,10,3,4,1872,1772,1025,-747
2018,10,3,5,1742,1645,1023,-622
2018,10,3,6,1606,1508,956,-552
2018,10,3,7,1571,1418,1115,-303
2018,10,3,8,1500,1371,1022,-349
2018,10,3,9,1424,1350,1027,-323
2018,10,3,10,1405,1331,1129,-202
2018,10,3,11,1421,1342,1181,-161
2018,10,3,12,1489,1426,1106,-320
2018,10,3,13,1657,1585,1077,-508
2018,10,3,14,1792,1708,996,-712
2018,10,3,15,1821,1737,945,-792
2018,10,3,16,1829,1755,901,-854
2018,10,3,17,1847,1765,934,-831
2018,10,3,18,1828,1752,987,-765
2018,10,3,19,1791,1747,930,-817
2018,10,3,20,1774,1783,1021,-762
2018,10,3,21,1802,1789,1065,-724
2018,10,3,22,1827,1811,1106,-705
2018,10,3,23,1851,1835,1088,-747
2018,10,4,0,1880,1816,1121,-695
2018,10,4,1,1906,1816,1085,-731
2018,10,4,2,1916,1848,1071,-777
2018,10,4,3,1926,1843,1068,-775
2018,10,4,4,1833,1761,1043,-718
2018,10,4,5,1705,1638,1020,-618
2018,10,4,6,1582,1509,1028,-481
2018,10,4,7,1523,1439,918,-521
2018,10,4,8,1436,1390,888,-502
2018,10,4,9,1434,1359,934,-425
2018,10,4,10,1414,1358,1047,-311
2018,10,4,11,1434,1358,968,-390
2018,10,4,12,1509,1432,971,-461
2018,10,4,13,1669,1578,1032,-546
2018,10,4,14,1798,1700,1039,-661
2018,10,4,15,1801,1738,1140,-598
2018,10,4,16,1820,1759,1149,-610
2018,10,4,17,1836,1765,1081,-684
2018,10,4,18,1816,1770,1084,-686
2018,10,4,19,1787,1750,1227,-523
2018,10,4,20,1775,1764,1296,-468
2018,10,4,21,1775,1762,1307,-455
2018,10,4,22,1781,1750,1323,-427
2018,10,4,23,1785,1732,1292,-440
2018,10,5,0,1765,1748,1312,-436
2018,10,5,1,1770,1748,1320,-428
2018,10,5,2,1849,1761,1386,-375
2018,10,5,3,1894,1773,1272,-501
2018,10,5,4,1796,1697,1276,-421
2018,10,5,5,1674,1578,1220,-358
2018,10,5,6,1562,1475,1141,-334
2018,10,5,7,1502,1386,1109,-277
2018,10,5,8,1474,1356,1098,-258
2018,10,5,9,1419,1336,1080,-256
2018,10,5,10,1442,1332,1061,-271
2018,10,5,11,1470,1350,989,-361
2018,10,5,12,1545,1436,931,-505
2018,10,5,13,1719,1597,976,-621
2018,10,5,14,1854,1728,1005,-723
2018,10,5,15,1899,1773,1080,-693
2018,10,5,16,1872,1776,1154,-622
2018,10,5,17,1830,1748,1192,-556
2018,10,5,18,1798,1732,1121,-611
2018,10,5,19,1754,1703,1131,-572
2018,10,5,20,1720,1686,1055,-631
2018,10,5,21,1724,1672,1045,-627
2018,10,5,22,1718,1659,1043,-616
2018,10,5,23,1716,1645,956,-689
2018,10,6,0,1666,1655,895,-760
2018,10,6,1,1651,1640,833,-807
2018,10,6,2,1725,1677,847,-830
2018,10,6,3,1755,1660,930,-730
2018,10,6,4,1711,1609,949,-660
2018,10,6,5,1619,1543,953,-590
2018,10,6,6,1533,1452,895,-557
2018,10,6,7,1472,1376,875,-501
2018,10,6,8,1395,1347,862,-485
2018,10,6,9,1393,1314,832,-482
2018,10,6,10,1385,1307,802,-505
2018,10,6,11,1381,1321,772,-549
2018,10,6,12,1423,1363,755,-608
2018,10,6,13,1506,1422,766,-656
2018,10,6,14,1589,1488,867,-621
2018,10,6,15,1651,1586,889,-697
2018,10,6,16,1694,1626,916,-710
2018,10,6,17,1699,1647,963,-684
2018,10,6,18,1696,1631,900,-731
2018,10,6,19,1681,1589,991,-598
2018,10,6,20,1660,1557,1024,-533
2018,10,6,21,1638,1535,990,-545
2018,10,6,22,1621,1504,1063,-441
2018,10,6,23,1597,1509,1194,-315
2018,10,7,0,1602,1527,1312,-215
2018,10,7,1,1604,1531,1253,-278
2018,10,7,2,1638,1598,1188,-410
2018,10,7,3,1658,1601,1178,-423
2018,10,7,4,1621,1554,1136,-418
2018,10,7,5,1558,1489,1087,-402
2018,10,7,6,1495,1400,974,-426
2018,10,7,7,1401,1342,996,-346
2018,10,7,8,1372,1317,952,-365
2018,10,7,9,1373,1287,936,-351
2018,10,7,10,1369,1275,1000,-275
2018,10,7,11,1376,1278,997,-281
2018,10,7,12,1405,1314,1017,-297
2018,10,7,13,1459,1372,1092,-280
2018,10,7,14,1529,1444,1140,-304
2018,10,7,15,1613,1520,1155,-365
2018,10,7,16,1658,1574,1310,-264
2018,10,7,17,1650,1565,1229,-336
2018,10,7,18,1628,1528,1201,-327
2018,10,7,19,1608,1526,1184,-342
2018,10,7,20,1586,1502,1197,-305
2018,10,7,21,1603,1481,1322,-159
2018,10,7,22,1597,1475,1443,-32
2018,10,7,23,1602,1498,1464,-34
2018,10,8,0,1632,1526,1479,-47
2018,10,8,1,1640,1536,1374,-162
2018,10,8,2,1646,1634,1324,-310
2018,10,8,3,1667,1636,1260,-376
2018,10,8,4,1630,1572,1272,-300
2018,10,8,5,1533,1457,1190,-267
2018,10,8,6,1429,1356,1089,-267
2018,10,8,7,1345,1305,990,-315
2018,10,8,8,1327,1281,825,-456
2018,10,8,9,1338,1264,808,-456
2018,10,8,10,1336,1277,779,-498
2018,10,8,11,1376,1306,778,-528
2018,10,8,12,1480,1416,869,-547
2018,10,8,13,1644,1594,894,-700
2018,10,8,14,1799,1744,871,-873
2018,10,8,15,1913,1756,903,-853
2018,10,8,16,1902,1717,930,-787
2018,10,8,17,1817,1716,883,-833
2018,10,8,18,1766,1694,909,-785
2018,10,8,19,1748,1659,878,-781
2018,10,8,20,1718,1631,894,-737
2018,10,8,21,1692,1610,923,-687
2018,10,8,22,1677,1591,883,-708
2018,10,8,23,1675,1591,889,-702
2018,10,9,0,1690,1597,953,-644
2018,10,9,1,1712,1632,799,-833
2018,10,9,2,1754,1689,748,-941
2018,10,9,3,1792,1690,716,-974
2018,10,9,4,1726,1605,739,-866
2018,10,9,5,1604,1485,767,-718
2018,10,9,6,1484,1364,742,-622
2018,10,9,7,1430,1294,704,-590
2018,10,9,8,1408,1270,611,-659
2018,10,9,9,1340,1258,596,-662
2018,10,9,10,1335,1251,583,-668
2018,10,9,11,1363,1281,569,-712
2018,10,9,12,1438,1362,676,-686
2018,10,9,13,1599,1540,818,-722
2018,10,9,14,1725,1691,936,-755
2018,10,9,15,1749,1740,938,-802
2018,10,9,16,1775,1736,981,-755
2018,10,9,17,1816,1748,1063,-685
2018,10,9,18,1816,1726,1144,-582
2018,10,9,19,1796,1701,1149,-552
2018,10,9,20,1767,1691,1144,-547
2018,10,9,21,1727,1672,1090,-582
2018,10,9,22,1716,1672,1040,-632
2018,10,9,23,1715,1703,1036,-667
2018,10,10,0,1743,1708,1044,-664
2018,10,10,1,1792,1723,1012,-711
2018,10,10,2,1846,1758,1010,-748
2018,10,10,3,1844,1724,992,-732
2018,10,10,4,1749,1643,1020,-623
2018,10,10,5,1614,1514,957,-557
2018,10,10,6,1493,1407,817,-590
2018,10,10,7,1447,1338,797,-541
2018,10,10,8,1390,1319,792,-527
2018,10,10,9,1379,1297,829,-468
2018,10,10,10,1374,1303,800,-503
2018,10,10,11,1404,1335,787,-548
2018,10,10,12,1492,1424,812,-612
2018,10,10,13,1664,1602,886,-716
2018,10,10,14,1816,1738,853,-885
2018,10,10,15,1830,1732,836,-896
2018,10,10,16,1834,1720,883,-837
2018,10,10,17,1820,1689,902,-787
2018,10,10,18,1780,1651,907,-744
2018,10,10,19,1727,1627,872,-755
2018,10,10,20,1681,1629,840,-789
2018,10,10,21,1665,1593,810,-783
2018,10,10,22,1664,1580,798,-782
2018,10,10,23,1675,1597,832,-765
2018,10,11,0,1689,1602,769,-833
2018,10,11,1,1707,1638,757,-881
2018,10,11,2,1753,1692,705,-987
2018,10,11,3,1771,1686,720,-966
2018,10,11,4,1702,1606,714,-892
2018,10,11,5,1576,1485,729,-756
2018,10,11,6,1464,1379,709,-670
2018,10,11,7,1410,1312,708,-604
2018,10,11,8,1374,1292,669,-623
2018,10,11,9,1360,1275,655,-620
2018,10,11,10,1360,1291,629,-662
2018,10,11,11,1389,1321,615,-706
2018,10,11,12,1493,1428,638,-790
2018,10,11,13,1662,1611,788,-823
2018,10,11,14,1817,1739,867,-872
2018,10,11,15,1826,1752,861,-891
2018,10,11,16,1780,1723,980,-743
2018,10,11,17,1775,1684,842,-842
2018,10,11,18,1697,1663,744,-919
2018,10,11,19,1672,1616,743,-873
2018,10,11,20,1693,1588,892,-696
2018,10,11,21,1662,1560,892,-668
2018,10,11,22,1642,1535,1081,-454
2018,10,11,23,1637,1539,1106,-433
2018,10,12,0,1652,1538,1142,-396
2018,10,12,1,1681,1556,1015,-541
2018,10,12,2,1716,1633,1018,-615
2018,10,12,3,1710,1657,899,-758
2018,10,12,4,1652,1604,882,-722
2018,10,12,5,1550,1503,769,-734
2018,10,12,6,1458,1390,733,-657
2018,10,12,7,1404,1339,672,-667
2018,10,12,8,1365,1320,624,-696
2018,10,12,9,1383,1335,587,-748
2018,10,12,10,1396,1337,572,-765
2018,10,12,11,1433,1373,597,-776
2018,10,12,12,1537,1476,607,-869
2018,10,12,13,1713,1646,770,-876
2018,10,12,14,1833,1793,865,-928
2018,10,12,15,1839,1801,973,-828
2018,10,12,16,1804,1756,1114,-642
2018,10,12,17,1790,1713,1126,-587
2018,10,12,18,1787,1663,1052,-611
2018,10,12,19,1764,1604,1019,-585
2018,10,12,20,1706,1564,916,-648
2018,10,12,21,1658,1540,934,-606
2018,10,12,22,1637,1508,933,-575
2018,10,12,23,1638,1522,986,-536
2018,10,13,0,1584,1509,916,-593
2018,10,13,1,1584,1527,769,-758
2018,10,13,2,1649,1565,603,-962
2018,10,13,3,1651,1573,620,-953
2018,10,13,4,1609,1520,604,-916
2018,10,13,5,1527,1458,623,-835
2018,10,13,6,1446,1370,652,-718
2018,10,13,7,1399,1318,656,-662
2018,10,13,8,1380,1284,630,-654
2018,10,13,9,1351,1280,703,-577
2018,10,13,10,1355,1284,721,-563
2018,10,13,11,1374,1311,712,-599
2018,10,13,12,1434,1356,755,-601
2018,10,13,13,1529,1435,853,-582
2018,10,13,14,1595,1542,1024,-518
2018,10,13,15,1656,1611,1225,-386
2018,10,13,16,1666,1629,1496,-133
2018,10,13,17,1669,1615,1586,-29
2018,10,13,18,1650,1586,1564,-22
2018,10,13,19,1609,1555,1532,-23
2018,10,13,20,1586,1511,1452,-59
2018,10,13,21,1586,1492,1479,-13
2018,10,13,22,1567,1480,1546,66
2018,10,13,23,1564,1494,1602,108
2018,10,14,0,1583,1502,1551,49
2018,10,14,1,1596,1540,1468,-72
2018,10,14,2,1636,1611,1365,-246
2018,10,14,3,1642,1607,1117,-490
2018,10,14,4,1610,1566,1087,-479
2018,10,14,5,1542,1500,1140,-360
2018,10,14,6,1475,1436,1070,-366
2018,10,14,7,1382,1389,941,-448
2018,10,14,8,1363,1350,816,-534
2018,10,14,9,1434,1336,742,-594
2018,10,14,10,1431,1343,706,-637
2018,10,14,11,1454,1355,656,-699
2018,10,14,12,1511,1409,652,-757
2018,10,14,13,1578,1482,722,-760
2018,10,14,14,1658,1583,839,-744
2018,10,14,15,1728,1666,862,-804
2018,10,14,16,1721,1694,993,-701
2018,10,14,17,1694,1659,1054,-605
2018,10,14,18,1657,1605,1022,-583
2018,10,14,19,1613,1563,1000,-563
2018,10,14,20,1566,1521,933,-588
2018,10,14,21,1545,1497,927,-570
2018,10,14,22,1545,1481,947,-534
2018,10,14,23,1576,1487,931,-556
2018,10,15,0,1606,1521,1013,-508
2018,10,15,1,1626,1565,871,-694
2018,10,15,2,1681,1656,732,-924
2018,10,15,3,1698,1682,671,-1011
2018,10,15,4,1664,1629,614,-1015
2018,10,15,5,1580,1522,596,-926
2018,10,15,6,1493,1457,625,-832
2018,10,15,7,1362,1385,614,-771
2018,10,15,8,1387,1385,602,-783
2018,10,15,9,1425,1396,567,-829
2018,10,15,10,1452,1413,565,-848
2018,10,15,11,1504,1467,577,-890
2018,10,15,12,1614,1578,582,-996
2018,10,15,13,1793,1786,681,-1105
2018,10,15,14,1960,1939,681,-1258
2018,10,15,15,2038,1938,730,-1208
2018,10,15,16,1970,1884,870,-1014
2018,10,15,17,1874,1807,957,-850
2018,10,15,18,1818,1748,922,-826
2018,10,15,19,1762,1704,900,-804
2018,10,15,20,1714,1655,846,-809
2018,10,15,21,1687,1628,891,-737
2018,10,15,22,1668,1609,918,-691
2018,10,15,23,1669,1599,936,-663
2018,10,16,0,1700,1610,877,-733
2018,10,16,1,1725,1640,719,-921
2018,10,16,2,1772,1731,690,-1041
2018,10,16,3,1786,1740,628,-1112
2018,10,16,4,1733,1669,571,-1098
2018,10,16,5,1628,1551,557,-994
2018,10,16,6,1524,1450,599,-851
2018,10,16,7,1441,1399,604,-795
2018,10,16,8,1453,1391,626,-765
2018,10,16,9,1441,1376,613,-763
2018,10,16,10,1462,1404,663,-741
2018,10,16,11,1496,1438,652,-786
2018,10,16,12,1602,1561,699,-862
2018,10,16,13,1787,1751,878,-873
2018,10,16,14,1937,1895,1045,-850
2018,10,16,15,1933,1901,1018,-883
2018,10,16,16,1890,1848,1097,-751
2018,10,16,17,1842,1785,1117,-668
2018,10,16,18,1791,1734,1091,-643
2018,10,16,19,1758,1678,1062,-616
2018,10,16,20,1716,1636,1045,-591
2018,10,16,21,1685,1613,1063,-550
2018,10,16,22,1671,1598,1062,-536
2018,10,16,23,1675,1594,1033,-561
2018,10,17,0,1693,1605,988,-617
2018,10,17,1,1723,1624,839,-785
2018,10,17,2,1776,1705,859,-846
2018,10,17,3,1774,1692,824,-868
2018,10,17,4,1690,1628,825,-803
2018,10,17,5,1572,1523,652,-871
2018,10,17,6,1468,1427,505,-922
2018,10,17,7,1440,1375,474,-901
2018,10,17,8,1417,1362,467,-895
2018,10,17,9,1410,1369,467,-902
2018,10,17,10,1432,1378,470,-908
2018,10,17,11,1472,1422,469,-953
2018,10,17,12,1575,1527,531,-996
2018,10,17,13,1762,1727,705,-1022
2018,10,17,14,1901,1868,782,-1086
2018,10,17,15,1891,1886,844,-1042
2018,10,17,16,1846,1845,972,-873
2018,10,17,17,1828,1762,908,-854
2018,10,17,18,1786,1705,839,-866
2018,10,17,19,1749,1656,819,-837
2018,10,17,20,1705,1649,837,-812
2018,10,17,21,1685,1629,816,-813
2018,10,17,22,1686,1601,823,-778
2018,10,17,23,1697,1595,862,-733
2018,10,18,0,1709,1599,798,-801
2018,10,18,1,1726,1610,689,-921
2018,10,18,2,1769,1676,706,-970
2018,10,18,3,1754,1676,766,-910
2018,10,18,4,1672,1603,691,-912
2018,10,18,5,1552,1500,623,-877
2018,10,18,6,1444,1388,568,-820
2018,10,18,7,1424,1325,561,-764
2018,10,18,8,1397,1298,592,-706
2018,10,18,9,1363,1296,572,-724
2018,10,18,10,1362,1312,561,-751
2018,10,18,11,1407,1360,560,-800
2018,10,18,12,1511,1470,690,-780
2018,10,18,13,1699,1663,833,-830
2018,10,18,14,1838,1810,899,-911
2018,10,18,15,1846,1825,896,-929
2018,10,18,16,1809,1782,957,-825
2018,10,18,17,1790,1738,1011,-727
2018,10,18,18,1768,1672,995,-677
2018,10,18,19,1739,1639,959,-680
2018,10,18,20,1698,1632,932,-700
2018,10,18,21,1677,1614,965,-649
2018,10,18,22,1675,1606,993,-613
2018,10,18,23,1680,1589,1016,-573
2018,10,19,0,1688,1606,1005,-601
2018,10,19,1,1699,1585,943,-642
2018,10,19,2,1760,1654,922,-732
2018,10,19,3,1745,1644,905,-739
2018,10,19,4,1665,1587,780,-807
2018,10,19,5,1538,1481,715,-766
2018,10,19,6,1428,1380,659,-721
2018,10,19,7,1416,1340,635,-705
2018,10,19,8,1364,1316,519,-797
2018,10,19,9,1356,1312,517,-795
2018,10,19,10,1379,1334,522,-812
2018,10,19,11,1418,1361,568,-793
2018,10,19,12,1526,1450,664,-786
2018,10,19,13,1698,1620,859,-761
2018,10,19,14,1829,1758,889,-869
2018,10,19,15,1818,1790,928,-862
2018,10,19,16,1779,1772,969,-803
2018,10,19,17,1758,1727,873,-854
2018,10,19,18,1749,1664,841,-823
2018,10,19,19,1729,1624,807,-817
2018,10,19,20,1691,1604,799,-805
2018,10,19,21,1662,1594,778,-816
2018,10,19,22,1648,1579,795,-784
2018,10,19,23,1652,1575,802,-773
2018,10,20,0,1589,1556,725,-831
2018,10,20,1,1573,1553,666,-887
2018,10,20,2,1662,1596,627,-969
2018,10,20,3,1672,1567,602,-965
2018,10,20,4,1617,1514,562,-952
2018,10,20,5,1518,1455,493,-962
2018,10,20,6,1426,1388,452,-936
2018,10,20,7,1400,1334,472,-862
2018,10,20,8,1369,1316,453,-863
2018,10,20,9,1356,1310,464,-846
2018,10,20,10,1370,1320,506,-814
2018,10,20,11,1390,1338,561,-777
2018,10,20,12,1447,1393,627,-766
2018,10,20,13,1540,1475,662,-813
2018,10,20,14,1631,1573,732,-841
2018,10,20,15,1692,1655,789,-866
2018,10,20,16,1695,1679,885,-794
2018,10,20,17,1671,1637,981,-656
2018,10,20,18,1641,1581,946,-635
2018,10,20,19,1600,1538,926,-612
2018,10,20,20,1571,1477,917,-560
2018,10,20,21,1570,1508,1005,-503
2018,10,20,22,1571,1488,996,-492
2018,10,20,23,1592,1495,1004,-491
2018,10,21,0,1607,1506,888,-618
2018,10,21,1,1597,1505,765,-740
2018,10,21,2,1632,1561,761,-800
2018,10,21,3,1623,1529,747,-782
2018,10,21,4,1556,1492,680,-812
2018,10,21,5,1482,1424,668,-756
2018,10,21,6,1408,1349,640,-709
2018,10,21,7,1372,1311,632,-679
2018,10,21,8,1336,1282,697,-585
2018,10,21,9,1327,1268,695,-573
2018,10,21,10,1332,1282,698,-584
2018,10,21,11,1355,1292,695,-597
2018,10,21,12,1389,1345,696,-649
2018,10,21,13,1463,1417,702,-715
2018,10,21,14,1549,1505,763,-742
2018,10,21,15,1602,1597,776,-821
2018,10,21,16,1627,1631,890,-741
2018,10,21,17,1625,1589,911,-678
2018,10,21,18,1595,1540,885,-655
2018,10,21,19,1582,1506,856,-650
2018,10,21,20,1567,1481,804,-677
2018,10,21,21,1567,1473,811,-662
2018,10,21,22,1560,1476,841,-635
2018,10,21,23,1578,1500,849,-651
2018,10,22,0,1607,1542,780,-762
2018,10,22,1,1613,1543,637,-906
2018,10,22,2,1667,1613,704,-909
2018,10,22,3,1665,1602,733,-869
2018,10,22,4,1593,1525,745,-780
2018,10,22,5,1483,1419,736,-683
2018,10,22,6,1375,1327,738,-589
2018,10,22,7,1321,1257,677,-580
2018,10,22,8,1302,1251,675,-576
2018,10,22,9,1304,1250,691,-559
2018,10,22,10,1315,1248,644,-604
2018,10,22,11,1349,1284,641,-643
2018,10,22,12,1442,1385,712,-673
2018,10,22,13,1607,1573,806,-767
2018,10,22,14,1753,1705,787,-918
2018,10,22,15,1829,1731,837,-894
2018,10,22,16,1814,1722,962,-760
2018,10,22,17,1763,1686,986,-700
2018,10,22,18,1735,1651,1013,-638
2018,10,22,19,1701,1610,979,-631
2018,10,22,20,1671,1627,992,-635
2018,10,22,21,1664,1634,999,-635
2018,10,22,22,1655,1637,999,-638
2018,10,22,23,1654,1620,955,-665
2018,10,23,0,1692,1635,958,-677
2018,10,23,1,1714,1648,999,-649
2018,10,23,2,1770,1697,915,-782
2018,10,23,3,1773,1666,871,-795
2018,10,23,4,1701,1567,805,-762
2018,10,23,5,1560,1456,773,-683
2018,10,23,6,1440,1354,750,-604
2018,10,23,7,1396,1281,712,-569
2018,10,23,8,1369,1256,672,-584
2018,10,23,9,1322,1244,711,-533
2018,10,23,10,1319,1248,734,-514
2018,10,23,11,1346,1265,713,-552
2018,10,23,12,1432,1350,765,-585
2018,10,23,13,1589,1510,816,-694
2018,10,23,14,1714,1649,812,-837
2018,10,23,15,1752,1684,830,-854
2018,10,23,16,1748,1685,880,-805
2018,10,23,17,1732,1694,971,-723
2018,10,23,18,1718,1670,973,-697
2018,10,23,19,1705,1662,948,-714
2018,10,23,20,1681,1640,942,-698
2018,10,23,21,1672,1632,940,-692
2018,10,23,22,1662,1632,843,-789
2018,10,23,23,1666,1620,833,-787
2018,10,24,0,1699,1621,793,-828
2018,10,24,1,1725,1632,771,-861
2018,10,24,2,1772,1673,777,-896
2018,10,24,3,1748,1648,743,-905
2018,10,24,4,1664,1570,677,-893
2018,10,24,5,1535,1452,679,-773
2018,10,24,6,1424,1353,679,-674
2018,10,24,7,1389,1277,787,-490
2018,10,24,8,1341,1251,784,-467
2018,10,24,9,1316,1240,735,-505
2018,10,24,10,1312,1229,748,-481
2018,10,24,11,1337,1274,752,-522
2018,10,24,12,1425,1364,734,-630
2018,10,24,13,1608,1541,756,-785
2018,10,24,14,1750,1691,828,-863
2018,10,24,15,1783,1714,819,-895
2018,10,24,16,1771,1721,883,-838
2018,10,24,17,1743,1673,874,-799
2018,10,24,18,1717,1643,845,-798
2018,10,24,19,1684,1623,837,-786
2018,10,24,20,1654,1609,768,-841
2018,10,24,21,1648,1608,768,-840
2018,10,24,22,1637,1602,764,-838
2018,10,24,23,1637,1598,685,-913
2018,10,25,0,1659,1584,670,-914
2018,10,25,1,1687,1626,687,-939
2018,10,25,2,1742,1676,739,-937
2018,10,25,3,1751,1629,929,-700
2018,10,25,4,1660,1560,1045,-515
2018,10,25,5,1527,1453,1020,-433
2018,10,25,6,1411,1356,953,-403
2018,10,25,7,1366,1289,933,-356
2018,10,25,8,1324,1253,855,-398
2018,10,25,9,1314,1235,883,-352
2018,10,25,10,1311,1249,903,-346
2018,10,25,11,1342,1270,881,-389
2018,10,25,12,1442,1382,870,-512
2018,10,25,13,1622,1556,938,-618
2018,10,25,14,1769,1696,992,-704
2018,10,25,15,1796,1728,1013,-715
2018,10,25,16,1775,1726,1081,-645
2018,10,25,17,1758,1681,1094,-587
2018,10,25,18,1733,1639,1105,-534
2018,10,25,19,1685,1615,1114,-501
2018,10,25,20,1649,1600,1035,-565
2018,10,25,21,1631,1593,998,-595
2018,10,25,22,1632,1570,900,-670
2018,10,25,23,1641,1572,785,-787
2018,10,26,0,1638,1570,748,-822
2018,10,26,1,1673,1604,708,-896
2018,10,26,2,1733,1660,677,-983
2018,10,26,3,1715,1631,676,-955
2018,10,26,4,1635,1565,683,-882
2018,10,26,5,1524,1465,690,-775
2018,10,26,6,1429,1369,720,-649
2018,10,26,7,1354,1301,715,-586
2018,10,26,8,1319,1272,733,-539
2018,10,26,9,1324,1260,757,-503
2018,10,26,10,1326,1260,738,-522
2018,10,26,11,1352,1288,705,-583
2018,10,26,12,1438,1365,716,-649
2018,10,26,13,1613,1514,726,-788
2018,10,26,14,1740,1641,717,-924
2018,10,26,15,1744,1685,730,-955
2018,10,26,16,1734,1678,822,-856
2018,10,26,17,1726,1646,859,-787
2018,10,26,18,1714,1618,849,-769
2018,10,26,19,1691,1602,792,-810
2018,10,26,20,1676,1577,767,-810
2018,10,26,21,1660,1579,813,-766
2018,10,26,22,1636,1577,825,-752
2018,10,26,23,1648,1562,839,-723
2018,10,27,0,1574,1552,812,-740
2018,10,27,1,1578,1567,844,-723
2018,10,27,2,1666,1597,875,-722
2018,10,27,3,1649,1557,846,-711
2018,10,27,4,1593,1497,849,-648
2018,10,27,5,1505,1425,836,-589
2018,10,27,6,1420,1337,748,-589
2018,10,27,7,1361,1279,664,-615
2018,10,27,8,1328,1234,629,-605
2018,10,27,9,1292,1229,690,-539
2018,10,27,10,1292,1215,730,-485
2018,10,27,11,1300,1230,732,-498
2018,10,27,12,1338,1268,737,-531
2018,10,27,13,1417,1342,752,-590
2018,10,27,14,1505,1433,889,-544
2018,10,27,15,1593,1532,945,-587
2018,10,27,16,1625,1583,1006,-577
2018,10,27,17,1609,1576,818,-758
2018,10,27,18,1591,1564,829,-735
2018,10,27,19,1573,1538,881,-657
2018,10,27,20,1569,1505,875,-630
2018,10,27,21,1569,1492,925,-567
2018,10,27,22,1561,1487,875,-612
2018,10,27,23,1560,1482,840,-642
2018,10,28,0,1600,1490,849,-641
2018,10,28,1,1608,1507,793,-714
2018,10,28,2,1632,1545,791,-754
2018,10,28,3,1598,1508,777,-731
2018,10,28,4,1536,1471,716,-755
2018,10,28,5,1458,1401,710,-691
2018,10,28,6,1391,1326,682,-644
2018,10,28,7,1340,1271,708,-563
2018,10,28,8,1291,1240,735,-505
2018,10,28,9,1271,1231,769,-462
2018,10,28,10,1276,1223,803,-420
2018,10,28,11,1292,1226,798,-428
2018,10,28,12,1328,1263,808,-455
2018,10,28,13,1388,1328,826,-502
2018,10,28,14,1460,1393,955,-438
2018,10,28,15,1532,1474,924,-550
2018,10,28,16,1564,1528,894,-634
2018,10,28,17,1566,1526,783,-743
2018,10,28,18,1568,1520,716,-804
2018,10,28,19,1562,1510,698,-812
2018,10,28,20,1558,1494,709,-785
2018,10,28,21,1570,1490,751,-739
2018,10,28,22,1571,1502,833,-669
2018,10,28,23,1579,1506,826,-680
2018,10,29,0,1617,1534,831,-703
2018,10,29,1,1620,1582,774,-808
2018,10,29,2,1647,1611,769,-842
2018,10,29,3,1637,1594,784,-810
2018,10,29,4,1567,1524,954,-570
2018,10,29,5,1458,1448,974,-474
2018,10,29,6,1363,1335,996,-339
2018,10,29,7,1282,1261,1016,-245
2018,10,29,8,1265,1238,999,-239
2018,10,29,9,1291,1219,1008,-211
2018,10,29,10,1290,1223,914,-309
2018,10,29,11,1318,1272,919,-353
2018,10,29,12,1410,1388,901,-487
2018,10,29,13,1590,1588,888,-700
2018,10,29,14,1751,1720,1028,-692
2018,10,29,15,1829,1748,1015,-733
2018,10,29,16,1821,1753,1079,-674
2018,10,29,17,1787,1725,1160,-565
2018,10,29,18,1758,1688,1233,-455
2018,10,29,19,1707,1646,1267,-379
2018,10,29,20,1657,1627,1275,-352
2018,10,29,21,1637,1627,1310,-317
2018,10,29,22,1631,1610,1337,-273
2018,10,29,23,1641,1621,1349,-272
2018,10,30,0,1670,1646,1304,-342
2018,10,30,1,1723,1695,1160,-535
2018,10,30,2,1786,1746,1028,-718
2018,10,30,3,1775,1719,1112,-607
2018,10,30,4,1722,1652,1007,-645
2018,10,30,5,1624,1539,872,-667
2018,10,30,6,1522,1444,787,-657
2018,10,30,7,1420,1394,789,-605
2018,10,30,8,1418,1372,798,-574
2018,10,30,9,1427,1365,757,-608
2018,10,30,10,1447,1362,770,-592
2018,10,30,11,1490,1396,780,-616
2018,10,30,12,1593,1514,886,-628
2018,10,30,13,1777,1699,860,-839
2018,10,30,14,1924,1844,1065,-779
2018,10,30,15,1968,1854,988,-866
2018,10,30,16,1961,1827,1014,-813
2018,10,30,17,1883,1770,1088,-682
2018,10,30,18,1805,1724,997,-727
2018,10,30,19,1724,1679,986,-693
2018,10,30,20,1659,1639,963,-676
2018,10,30,21,1634,1622,1007,-615
2018,10,30,22,1633,1588,1054,-534
2018,10,30,23,1628,1595,1065,-530
2018,10,31,0,1660,1623,1059,-564
2018,10,31,1,1715,1676,911,-765
2018,10,31,2,1779,1752,1051,-701
2018,10,31,3,1783,1734,1076,-658
2018,10,31,4,1732,1682,1025,-657
2018,10,31,5,1637,1586,864,-722
2018,10,31,6,1543,1489,768,-721
2018,10,31,7,1461,1428,629,-799
2018,10,31,8,1450,1411,564,-847
2018,10,31,9,1446,1402,541,-861
2018,10,31,10,1452,1424,525,-899
2018,10,31,11,1490,1453,501,-952
2018,10,31,12,1592,1555,527,-1028
2018,10,31,13,1780,1735,648,-1087
2018,10,31,14,1911,1858,824,-1034
2018,10,31,15,1902,1874,849,-1025
2018,10,31,16,1877,1868,838,-1030
2018,10,31,17,1841,1820,776,-1044
2018,10,31,18,1791,1793,746,-1047
2018,10,31,19,1765,1746,734,-1012
2018,10,31,20,1759,1734,717,-1017
2018,10,31,21,1760,1731,795,-936
2018,10,31,22,1752,1726,760,-966
2018,10,31,23,1764,1729,809,-920
2018,11,1,0,1788,1722,824,-898
2018,11,1,1,1847,1725,844,-881
2018,11,1,2,1876,1698,801,-897
2018,11,1,3,1796,1674,800,-874
2018,11,1,4,1680,1639,780,-859
2018,11,1,5,1567,1542,718,-824
2018,11,1,6,1477,1449,674,-775
2018,11,1,7,1393,1428,751,-677
2018,11,1,8,1381,1326,677,-649
2018,11,1,9,1387,1300,739,-561
2018,11,1,10,1371,1305,796,-509
2018,11,1,11,1398,1328,849,-479
2018,11,1,12,1502,1438,911,-527
2018,11,1,13,1675,1616,948,-668
2018,11,1,14,1800,1754,1090,-664
2018,11,1,15,1811,1780,1024,-756
2018,11,1,16,1810,1767,1024,-743
2018,11,1,17,1810,1756,975,-781
2018,11,1,18,1784,1725,949,-776
2018,11,1,19,1761,1679,970,-709
2018,11,1,20,1726,1651,970,-681
2018,11,1,21,1719,1633,1032,-601
2018,11,1,22,1691,1610,1092,-518
2018,11,1,23,1684,1607,1058,-549
2018,11,2,0,1695,1634,997,-637
2018,11,2,1,1718,1689,1043,-646
2018,11,2,2,1744,1712,1041,-671
2018,11,2,3,1738,1686,1022,-664
2018,11,2,4,1683,1606,948,-658
2018,11,2,5,1576,1495,928,-567
2018,11,2,6,1465,1396,969,-427
2018,11,2,7,1386,1328,1015,-313
2018,11,2,8,1370,1304,1033,-271
2018,11,2,9,1343,1286,961,-325
2018,11,2,10,1343,1298,948,-350
2018,11,2,11,1382,1336,941,-395
2018,11,2,12,1486,1432,968,-464
2018,11,2,13,1674,1608,1049,-559
2018,11,2,14,1801,1746,1044,-702
2018,11,2,15,1811,1776,1092,-684
2018,11,2,16,1802,1758,1113,-645
2018,11,2,17,1791,1733,1061,-672
2018,11,2,18,1760,1698,1131,-567
2018,11,2,19,1739,1656,1354,-302
2018,11,2,20,1722,1624,1533,-91
2018,11,2,21,1692,1587,1494,-93
2018,11,2,22,1665,1571,1540,-31
2018,11,2,23,1644,1571,1526,-45
2018,11,3,0,1573,1566,1484,-82
2018,11,3,1,1595,1615,1355,-260
2018,11,3,2,1668,1657,1309,-348
2018,11,3,3,1667,1627,1228,-399
2018,11,3,4,1644,1580,1272,-308
2018,11,3,5,1569,1501,1334,-167
2018,11,3,6,1487,1432,1406,-26
2018,11,3,7,1415,1360,1373,13
2018,11,3,8,1385,1336,1350,14
2018,11,3,9,1386,1327,1312,-15
2018,11,3,10,1387,1323,1263,-60
2018,11,3,11,1418,1343,1266,-77
2018,11,3,12,1482,1396,1257,-139
2018,11,3,13,1574,1477,1238,-239
2018,11,3,14,1665,1586,1278,-308
2018,11,3,15,1747,1675,1303,-372
2018,11,3,16,1771,1703,1340,-363
2018,11,3,17,1748,1690,1429,-261
2018,11,3,18,1712,1661,1400,-261
2018,11,3,19,1649,1608,1432,-176
2018,11,3,20,1604,1563,1415,-148
2018,11,3,21,1575,1522,1417,-105
2018,11,3,22,1558,1500,1479,-21
2018,11,3,23,1551,1502,1458,-44
2018,11,4,0,1585,1535,1384,-151
2018,11,4,1,1634,1604,1278,-326
2018,11,4,2,1673,1645,1240,-405
2018,11,4,3,1662,1617,1160,-457
2018,11,4,4,1626,1563,1132,-431
2018,11,4,5,1560,1505,1109,-396
2018,11,4,6,1488,1424,1084,-340
2018,11,4,7,1402,1350,966,-384
2018,11,4,8,-9999,1350,966,-9999
2018,11,4,9,-9999,1327,1312,-9999
2018,11,4,10,-9999,1323,1263,-9999
2018,11,4,11,-9999,1343,1266,-9999
2018,11,4,12,-9999,1396,1257,-9999
2018,11,4,13,-9999,1477,1238,-9999
2018,11,4,14,-9999,1586,1278,-9999
2018,11,4,15,-9999,1675,1303,-9999
2018,11,4,16,-9999,1703,1340,-9999
2018,11,4,17,-9999,1690,1429,-9999
2018,11,4,18,-9999,1661,1400,-9999
2018,11,4,19,-9999,1608,1432,-9999
2018,11,4,20,-9999,1563,1415,-9999
2018,11,4,21,-9999,1522,1417,-9999
2018,11,4,22,-9999,1500,1479,-9999
2018,11,4,23,-9999,1502,1458,-9999
2018,11,5,0,-9999,1535,1384,-9999
2018,11,5,1,-9999,1604,1278,-9999
2018,11,5,2,-9999,1645,1240,-9999
2018,11,5,3,-9999,1617,1160,-9999
2018,11,5,4,-9999,1563,1132,-9999
2018,11,5,5,-9999,1505,1109,-9999
2018,11,5,6,-9999,1424,1084,-9999
2018,11,5,7,1461,1461,966,-9999
2018,11,5,8,-9999,-9999,-9999,-9999
2018,11,5,9,1376,1341,1349,8
2018,11,5,10,1398,1341,1364,23
2018,11,5,11,1415,1362,1382,20
2018,11,5,12,1466,1417,1383,-34
2018,11,5,13,1587,1538,1395,-143
2018,11,5,14,1782,1751,1425,-326
2018,11,5,15,1950,1879,1421,-458
2018,11,5,16,1993,1867,1411,-456
2018,11,5,17,1928,1805,1368,-437
2018,11,5,18,1843,1756,1434,-322
2018,11,5,19,1802,1712,1461,-251
2018,11,5,20,1746,1671,1460,-211
2018,11,5,21,1693,1668,1502,-166
2018,11,5,22,1665,1641,1437,-204
2018,11,5,23,1663,1645,1338,-307
2018,11,6,0,1674,1737,1561,-176
2018,11,6,1,1753,1788,1258,-530
2018,11,6,2,1845,1854,1202,-652
2018,11,6,3,1931,1837,1125,-712
2018,11,6,4,1904,1791,1084,-707
2018,11,6,5,1799,1708,1120,-588
2018,11,6,6,1678,1580,1057,-523
2018,11,6,7,1558,1491,1032,-459
2018,11,6,8,1498,1444,1012,-432
2018,11,6,9,1500,1424,1053,-371
2018,11,6,10,1474,1420,1116,-304
2018,11,6,11,1485,1429,1075,-354
2018,11,6,12,1535,1475,1046,-429
2018,11,6,13,1638,1593,1090,-503
2018,11,6,14,1829,1789,1156,-633
2018,11,6,15,1974,1914,1125,-789
2018,11,6,16,1972,1889,1133,-756
2018,11,6,17,1900,1822,1185,-637
2018,11,6,18,1848,1787,1302,-485
2018,11,6,19,1820,1736,1386,-350
2018,11,6,20,1768,1705,1405,-300
2018,11,6,21,1727,1682,1376,-306
2018,11,6,22,1691,1657,1465,-192
2018,11,6,23,1683,1653,1518,-135
2018,11,7,0,1710,1682,1411,-271
2018,11,7,1,1793,1780,1259,-521
2018,11,7,2,1878,1875,1200,-675
2018,11,7,3,1923,1867,1126,-741
2018,11,7,4,1903,1832,1072,-760
2018,11,7,5,1820,1763,1050,-713
2018,11,7,6,1711,1649,1032,-617
2018,11,7,7,1612,1563,981,-582
2018,11,7,8,1560,1521,936,-585
2018,11,7,9,1544,1509,918,-591
2018,11,7,10,1542,1511,900,-611
2018,11,7,11,1566,1520,899,-621
2018,11,7,12,1626,1575,896,-679
2018,11,7,13,1753,1695,944,-751
2018,11,7,14,1961,1894,1035,-859
2018,11,7,15,2099,2011,1069,-942
2018,11,7,16,2065,1985,1050,-935
2018,11,7,17,1973,1927,1026,-901
2018,11,7,18,1913,1877,1078,-799
2018,11,7,19,1880,1809,1109,-700
2018,11,7,20,1820,1739,1170,-569
2018,11,7,21,1767,1703,1246,-457
2018,11,7,22,1702,1676,1367,-309
2018,11,7,23,1691,1682,1495,-187
2018,11,8,0,1733,1725,1432,-293
2018,11,8,1,1841,1845,1403,-442
2018,11,8,2,1936,1919,1377,-542
2018,11,8,3,1972,1909,1315,-594
2018,11,8,4,1926,1885,1330,-555
2018,11,8,5,1833,1805,1289,-516
2018,11,8,6,1730,1695,1255,-440
2018,11,8,7,1645,1597,1256,-341
2018,11,8,8,1571,1555,1211,-344
2018,11,8,9,1570,1530,1147,-383
2018,11,8,10,1593,1549,1130,-419
2018,11,8,11,1608,1565,1138,-427
2018,11,8,12,1673,1615,1106,-509
2018,11,8,13,1786,1741,1080,-661
2018,11,8,14,1970,1947,1233,-714
2018,11,8,15,2107,2068,1188,-880
2018,11,8,16,2090,2045,1194,-851
2018,11,8,17,2091,1964,1252,-712
2018,11,8,18,2026,1904,1216,-688
2018,11,8,19,1911,1826,1114,-712
2018,11,8,20,1827,1764,1128,-636
2018,11,8,21,1762,1732,1169,-563
2018,11,8,22,1714,1706,1433,-273
2018,11,8,23,1726,1700,1332,-368
2018,11,9,0,1776,1754,1237,-517
2018,11,9,1,1892,1863,1208,-655
2018,11,9,2,2000,1960,1199,-761
2018,11,9,3,2019,1954,1217,-737
2018,11,9,4,1978,1946,1128,-818
2018,11,9,5,1896,1868,1018,-850
2018,11,9,6,1793,1769,920,-849
2018,11,9,7,1712,1684,907,-777
2018,11,9,8,1617,1636,803,-833
2018,11,9,9,1619,1628,793,-835
2018,11,9,10,1658,1629,769,-860
2018,11,9,11,1678,1654,795,-859
2018,11,9,12,1732,1712,818,-894
2018,11,9,13,1874,1827,912,-915
2018,11,9,14,2088,2020,1023,-997
2018,11,9,15,2218,2132,1101,-1031
2018,11,9,16,2138,2128,1146,-982
2018,11,9,17,2070,2061,1194,-867
2018,11,9,18,1994,1978,1177,-801
2018,11,9,19,1916,1912,1131,-781
2018,11,9,20,1867,1839,1158,-681
2018,11,9,21,1838,1793,1139,-654
2018,11,9,22,1805,1765,1168,-597
2018,11,9,23,1795,1748,1042,-706
2018,11,10,0,1834,1779,1018,-761
2018,11,10,1,1846,1869,1064,-805
2018,11,10,2,1894,1911,1089,-822
2018,11,10,3,1943,1886,1063,-823
2018,11,10,4,1890,1852,1002,-850
2018,11,10,5,1817,1793,951,-842
2018,11,10,6,1744,1706,948,-758
2018,11,10,7,1668,1640,942,-698
2018,11,10,8,1562,1572,866,-706
2018,11,10,9,1552,1530,918,-612
2018,11,10,10,1607,1520,997,-523
2018,11,10,11,1613,1528,1121,-407
2018,11,10,12,1648,1556,1106,-450
2018,11,10,13,1725,1593,1234,-359
2018,11,10,14,1802,1695,1315,-380
2018,11,10,15,1871,1814,1377,-437
2018,11,10,16,1921,1881,1448,-433
2018,11,10,17,1902,1885,1588,-297
2018,11,10,18,1855,1857,1647,-210
2018,11,10,19,1821,1792,1664,-128
2018,11,10,20,1775,1739,1691,-48
2018,11,10,21,1732,1695,1650,-45
2018,11,10,22,1710,1641,1649,8
2018,11,10,23,1721,1639,1665,26
2018,11,11,0,1748,1680,1558,-122
2018,11,11,1,1860,1779,1458,-321
2018,11,11,2,1918,1836,1461,-375
2018,11,11,3,1901,1806,1389,-417
2018,11,11,4,1863,1797,1266,-531
2018,11,11,5,1812,1744,1093,-651
2018,11,11,6,1746,1662,978,-684
2018,11,11,7,1702,1586,1021,-565
2018,11,11,8,1616,1540,961,-579
2018,11,11,9,1626,1522,886,-636
2018,11,11,10,1625,1523,871,-652
2018,11,11,11,1634,1554,835,-719
2018,11,11,12,1666,1592,801,-791
2018,11,11,13,1721,1643,869,-774
2018,11,11,14,1790,1750,989,-761
2018,11,11,15,1862,1832,1057,-775
2018,11,11,16,1912,1917,1163,-754
2018,11,11,17,1927,1883,1207,-676
2018,11,11,18,1909,1816,1147,-669
2018,11,11,19,1833,1755,1087,-668
2018,11,11,20,1782,1718,1181,-537
2018,11,11,21,1737,1679,1265,-414
2018,11,11,22,1687,1635,1453,-182
2018,11,11,23,1679,1625,1332,-293
2018,11,12,0,1731,1681,1249,-432
2018,11,12,1,1862,1804,1387,-417
2018,11,12,2,1942,1895,1397,-498
2018,11,12,3,1954,1884,1426,-458
2018,11,12,4,1962,1869,1335,-534
2018,11,12,5,1896,1805,1203,-602
2018,11,12,6,1788,1718,1117,-601
2018,11,12,7,1699,1638,1032,-606
2018,11,12,8,1656,1602,1044,-558
2018,11,12,9,1645,1597,1007,-590
2018,11,12,10,1644,1623,946,-677
2018,11,12,11,1667,1649,942,-707
2018,11,12,12,1736,1721,944,-777
2018,11,12,13,1876,1843,1049,-794
2018,11,12,14,2086,2025,1087,-938
2018,11,12,15,2224,2157,1147,-1010
2018,11,12,16,2209,2141,1068,-1073
2018,11,12,17,2125,2092,1119,-973
2018,11,12,18,2040,2034,1092,-942
2018,11,12,19,1986,1979,1055,-924
2018,11,12,20,1943,1921,1015,-906
2018,11,12,21,1914,1871,1007,-864
2018,11,12,22,1873,1836,1009,-827
2018,11,12,23,1866,1810,1067,-743
2018,11,13,0,1886,1841,1026,-815
2018,11,13,1,2024,1986,1052,-934
2018,11,13,2,2096,2054,1064,-990
2018,11,13,3,2080,2033,1105,-928
2018,11,13,4,2056,2006,1077,-929
2018,11,13,5,1981,1938,988,-950
2018,11,13,6,1863,1825,883,-942
2018,11,13,7,1764,1753,774,-979
2018,11,13,8,1704,1705,761,-944
2018,11,13,9,1690,1689,818,-871
2018,11,13,10,1716,1696,908,-788
2018,11,13,11,1735,1728,894,-834
2018,11,13,12,1795,1789,907,-882
2018,11,13,13,1913,1902,974,-928
2018,11,13,14,2115,2091,1165,-926
2018,11,13,15,2254,2202,1302,-900
2018,11,13,16,2204,2167,1310,-857
2018,11,13,17,2111,2086,1303,-783
2018,11,13,18,2049,2016,1306,-710
2018,11,13,19,1987,1941,1272,-669
2018,11,13,20,1930,1874,1240,-634
2018,11,13,21,1876,1829,1149,-680
2018,11,13,22,1828,1802,1150,-652
2018,11,13,23,1822,1792,1105,-687
2018,11,14,0,1868,1814,1002,-812
2018,11,14,1,2006,1937,1022,-915
2018,11,14,2,2057,1998,1032,-966
2018,11,14,3,2009,1988,1085,-903
2018,11,14,4,1983,1964,1085,-879
2018,11,14,5,1924,1873,1021,-852
2018,11,14,6,1820,1767,1168,-599
2018,11,14,7,1746,1699,1129,-570
2018,11,14,8,1669,1666,1153,-513
2018,11,14,9,1669,1640,1102,-538
2018,11,14,10,1696,1652,1058,-594
2018,11,14,11,1724,1666,1024,-642
2018,11,14,12,1783,1716,1046,-670
2018,11,14,13,1883,1833,1070,-763
2018,11,14,14,2070,2029,1166,-863
2018,11,14,15,2190,2157,1292,-865
2018,11,14,16,2162,2117,1246,-871
2018,11,14,17,2090,2054,1239,-815
2018,11,14,18,2022,1971,1207,-764
2018,11,14,19,1981,1879,1136,-743
2018,11,14,20,1911,1810,1107,-703
2018,11,14,21,1840,1753,1055,-698
2018,11,14,22,1774,1722,1015,-707
2018,11,14,23,1750,1696,1019,-677
2018,11,15,0,1786,1721,956,-765
2018,11,15,1,1927,1858,1054,-804
2018,11,15,2,1994,1935,1104,-831
2018,11,15,3,1962,1932,1103,-829
2018,11,15,4,1947,1916,1075,-841
2018,11,15,5,1901,1852,1046,-806
2018,11,15,6,1796,1739,947,-792
2018,11,15,7,1702,1645,937,-708
2018,11,15,8,1662,1599,911,-688
2018,11,15,9,1638,1595,893,-702
2018,11,15,10,1639,1602,865,-737
2018,11,15,11,1674,1615,872,-743
2018,11,15,12,1720,1673,870,-803
2018,11,15,13,1829,1802,922,-880
2018,11,15,14,2013,1981,1025,-956
2018,11,15,15,2126,2113,993,-1120
2018,11,15,16,2099,2093,1047,-1046
2018,11,15,17,2034,2003,1148,-855
2018,11,15,18,1962,1946,1150,-796
2018,11,15,19,1904,1855,1061,-794
2018,11,15,20,1869,1793,1037,-756
2018,11,15,21,1829,1735,1010,-725
2018,11,15,22,1775,1713,1023,-690
2018,11,15,23,1746,1686,998,-688
2018,11,16,0,1781,1714,871,-843
2018,11,16,1,1927,1846,891,-955
2018,11,16,2,1987,1913,870,-1043
2018,11,16,3,1957,1913,887,-1026
2018,11,16,4,1922,1907,950,-957
2018,11,16,5,1866,1832,930,-902
2018,11,16,6,1770,1749,924,-825
2018,11,16,7,1682,1659,879,-780
2018,11,16,8,1631,1607,866,-741
2018,11,16,9,1612,1598,809,-789
2018,11,16,10,1638,1596,828,-768
2018,11,16,11,1660,1615,814,-801
2018,11,16,12,1713,1672,808,-864
2018,11,16,13,1835,1785,906,-879
2018,11,16,14,2007,1969,1052,-917
2018,11,16,15,2125,2106,1055,-1051
2018,11,16,16,2085,2076,1097,-979
2018,11,16,17,2011,2023,1243,-780
2018,11,16,18,1955,1930,1152,-778
2018,11,16,19,1909,1860,1094,-766
2018,11,16,20,1861,1791,1048,-743
2018,11,16,21,1824,1742,1207,-535
2018,11,16,22,1775,1694,1207,-487
2018,11,16,23,1756,1669,1235,-434
2018,11,17,0,1784,1695,1210,-485
2018,11,17,1,1831,1780,1216,-564
2018,11,17,2,1852,1807,1231,-576
2018,11,17,3,1857,1763,1264,-499
2018,11,17,4,1817,1729,1316,-413
2018,11,17,5,1763,1668,1290,-378
2018,11,17,6,1690,1578,1216,-362
2018,11,17,7,1618,1498,1111,-387
2018,11,17,8,1563,1430,1004,-426
2018,11,17,9,1543,1420,936,-484
2018,11,17,10,1517,1410,932,-478
2018,11,17,11,1525,1427,968,-459
2018,11,17,12,1556,1451,995,-456
2018,11,17,13,1624,1512,1036,-476
2018,11,17,14,1701,1610,1013,-597
2018,11,17,15,1790,1708,1042,-666
2018,11,17,16,1871,1797,1059,-738
2018,11,17,17,1880,1822,1142,-680
2018,11,17,18,1864,1797,1136,-661
2018,11,17,19,1820,1752,1145,-607
2018,11,17,20,1759,1692,1118,-574
2018,11,17,21,1712,1645,1087,-558
2018,11,17,22,1660,1614,1051,-563
2018,11,17,23,1640,1597,1017,-580
2018,11,18,0,1679,1638,932,-706
2018,11,18,1,1803,1762,872,-890
2018,11,18,2,1860,1830,943,-887
2018,11,18,3,1868,1825,1010,-815
2018,11,18,4,1858,1824,980,-844
2018,11,18,5,1814,1786,972,-814
2018,11,18,6,1762,1732,894,-838
2018,11,18,7,1708,1681,897,-784
2018,11,18,8,1650,1642,893,-749
2018,11,18,9,1624,1619,831,-788
2018,11,18,10,1634,1620,847,-773
2018,11,18,11,1659,1646,878,-768
2018,11,18,12,1705,1686,889,-797
2018,11,18,13,1764,1744,916,-828
2018,11,18,14,1844,1829,1038,-791
2018,11,18,15,1926,1920,1056,-864
2018,11,18,16,1959,1997,1107,-890
2018,11,18,17,1966,1994,1108,-886
2018,11,18,18,1932,1923,1099,-824
2018,11,18,19,1845,1839,1049,-790
2018,11,18,20,1800,1767,1068,-699
2018,11,18,21,1776,1719,1066,-653
2018,11,18,22,1744,1686,1128,-558
2018,11,18,23,1729,1680,1032,-648
2018,11,19,0,1771,1717,939,-778
2018,11,19,1,1914,1846,950,-896
2018,11,19,2,1970,1932,1006,-926
2018,11,19,3,1951,1933,983,-950
2018,11,19,4,1943,1924,965,-959
2018,11,19,5,1895,1866,908,-958
2018,11,19,6,1800,1779,902,-877
2018,11,19,7,1712,1697,902,-795
2018,11,19,8,1627,1652,930,-722
2018,11,19,9,1633,1657,940,-717
2018,11,19,10,1685,1658,931,-727
2018,11,19,11,1726,1694,971,-723
2018,11,19,12,1804,1757,1020,-737
2018,11,19,13,1936,1878,1057,-821
2018,11,19,14,2132,2045,1179,-866
2018,11,19,15,2268,2172,1241,-931
2018,11,19,16,2260,2179,1235,-944
2018,11,19,17,2188,2114,1309,-805
2018,11,19,18,2099,2043,1269,-774
2018,11,19,19,2021,1969,1205,-764
2018,11,19,20,1939,1894,1076,-818
2018,11,19,21,1882,1851,1064,-787
2018,11,19,22,1847,1817,1110,-707
2018,11,19,23,1830,1774,1092,-682
2018,11,20,0,1858,1797,925,-872
2018,11,20,1,1996,1928,925,-1003
2018,11,20,2,2053,2018,1002,-1016
2018,11,20,3,2036,2001,1007,-994
2018,11,20,4,2030,1975,1021,-954
2018,11,20,5,1955,1916,975,-941
2018,11,20,6,1848,1820,960,-860
2018,11,20,7,1767,1723,987,-736
2018,11,20,8,1704,1672,993,-679
2018,11,20,9,1712,1682,963,-719
2018,11,20,10,1723,1694,1012,-682
2018,11,20,11,1746,1704,1054,-650
2018,11,20,12,1801,1753,1087,-666
2018,11,20,13,1917,1874,1121,-753
2018,11,20,14,2109,2025,1270,-755
2018,11,20,15,2244,2155,1411,-744
2018,11,20,16,2195,2142,1441,-701
2018,11,20,17,2124,2104,1495,-609
2018,11,20,18,2064,2024,1365,-659
2018,11,20,19,1985,1919,1210,-709
2018,11,20,20,1919,1857,1190,-667
2018,11,20,21,1862,1793,1172,-621
2018,11,20,22,1817,1766,1153,-613
2018,11,20,23,1782,1734,1093,-641
2018,11,21,0,1805,1768,1034,-734
2018,11,21,1,1965,1895,1073,-822
2018,11,21,2,2040,1978,1165,-813
2018,11,21,3,2006,1978,1152,-826
2018,11,21,4,1981,1961,1189,-772
2018,11,21,5,1927,1900,1230,-670
2018,11,21,6,1840,1819,1167,-652
2018,11,21,7,1768,1721,1106,-615
2018,11,21,8,1714,1684,1096,-588
2018,11,21,9,1689,1661,1117,-544
2018,11,21,10,1734,1672,1141,-531
2018,11,21,11,1754,1685,1206,-479
2018,11,21,12,1801,1735,1292,-443
2018,11,21,13,1896,1844,1356,-488
2018,11,21,14,2071,1989,1481,-508
2018,11,21,15,2192,2098,1540,-558
2018,11,21,16,2157,2126,1597,-529
2018,11,21,17,2084,2129,1549,-580
2018,11,21,18,2042,2063,1553,-510
2018,11,21,19,1994,2000,1478,-522
2018,11,21,20,1921,1934,1483,-451
2018,11,21,21,1882,1896,1350,-546
2018,11,21,22,1884,1872,1336,-536
2018,11,21,23,1886,1879,1303,-576
2018,11,22,0,1933,1873,1269,-604
2018,11,22,1,2080,1939,1360,-579
2018,11,22,2,2093,1953,1365,-588
2018,11,22,3,1972,1915,1330,-585
2018,11,22,4,1884,1878,1272,-606
2018,11,22,5,1802,1811,1271,-540
2018,11,22,6,1714,1711,1338,-373
2018,11,22,7,1639,1630,1365,-265
2018,11,22,8,1540,1548,1356,-192
2018,11,22,9,1530,1498,1244,-254
2018,11,22,10,1539,1474,1142,-332
2018,11,22,11,1551,1464,1123,-341
2018,11,22,12,1586,1484,1087,-397
2018,11,22,13,1676,1522,1104,-418
2018,11,22,14,1821,1603,1147,-456
2018,11,22,15,1928,1685,1134,-551
2018,11,22,16,1911,1777,1017,-760
2018,11,22,17,1886,1860,1021,-839
2018,11,22,18,1853,1888,1039,-849
2018,11,22,19,1821,1868,1079,-789
2018,11,22,20,1784,1787,988,-799
2018,11,22,21,1767,1706,975,-731
2018,11,22,22,1763,1631,931,-700
2018,11,22,23,1761,1557,963,-594
2018,11,23,0,1796,1540,941,-599
2018,11,23,1,1942,1595,980,-615
2018,11,23,2,1985,1598,1045,-553
2018,11,23,3,1930,1595,1095,-500
2018,11,23,4,1868,1596,1087,-509
2018,11,23,5,1776,1549,1021,-528
2018,11,23,6,1677,1519,935,-584
2018,11,23,7,1582,1453,1051,-402
2018,11,23,8,1537,1409,1232,-177
2018,11,23,9,1526,1400,1082,-318
2018,11,23,10,1533,1403,1007,-396
2018,11,23,11,1552,1414,1045,-369
2018,11,23,12,1599,1452,1045,-407
2018,11,23,13,1703,1522,1024,-498
2018,11,23,14,1858,1606,1024,-582
2018,11,23,15,1971,1686,1057,-629
2018,11,23,16,1946,1744,1013,-731
2018,11,23,17,1912,1786,1049,-737
2018,11,23,18,1879,1783,950,-833
2018,11,23,19,1843,1794,1011,-783
2018,11,23,20,1811,1788,1043,-745
2018,11,23,21,1800,1774,1092,-682
2018,11,23,22,1789,1775,1116,-659
2018,11,23,23,1777,1781,1143,-638
2018,11,24,0,1802,1797,1179,-618
2018,11,24,1,1861,1862,1330,-532
2018,11,24,2,1878,1853,1270,-583
2018,11,24,3,1827,1799,1149,-650
2018,11,24,4,1786,1763,1048,-715
2018,11,24,5,1736,1690,1095,-595
2018,11,24,6,1686,1626,1168,-458
2018,11,24,7,1626,1529,1357,-172
2018,11,24,8,1592,1481,1338,-143
2018,11,24,9,1580,1461,1334,-127
2018,11,24,10,1593,1445,1344,-101
2018,11,24,11,1610,1436,1360,-76
2018,11,24,12,1641,1463,1373,-90
2018,11,24,13,1699,1533,1384,-149
2018,11,24,14,1767,1609,1376,-233
2018,11,24,15,1849,1690,1429,-261
2018,11,24,16,1905,1771,1465,-306
2018,11,24,17,1914,1797,1488,-309
2018,11,24,18,1883,1798,1515,-283
2018,11,24,19,1830,1767,1460,-307
2018,11,24,20,1777,1747,1504,-243
2018,11,24,21,1739,1681,1527,-154
2018,11,24,22,1719,1657,1525,-132
2018,11,24,23,1717,1657,1547,-110
2018,11,25,0,1750,1711,1495,-216
2018,11,25,1,1885,1848,1421,-427
2018,11,25,2,1925,1892,1448,-444
2018,11,25,3,1888,1906,1329,-577
2018,11,25,4,1843,1879,1255,-624
2018,11,25,5,1790,1844,1071,-773
2018,11,25,6,1741,1790,1007,-783
2018,11,25,7,1681,1716,901,-815
2018,11,25,8,1644,1687,828,-859
2018,11,25,9,1624,1651,807,-844
2018,11,25,10,1629,1611,830,-781
2018,11,25,11,1637,1619,939,-680
2018,11,25,12,1659,1656,939,-717
2018,11,25,13,1699,1708,933,-775
2018,11,25,14,1743,1788,1031,-757
2018,11,25,15,1802,1868,1072,-796
2018,11,25,16,1845,1954,1108,-846
2018,11,25,17,1838,1941,1171,-770
2018,11,25,18,1791,1902,1124,-778
2018,11,25,19,1732,1846,1038,-808
2018,11,25,20,1694,1781,1025,-756
2018,11,25,21,1669,1725,1026,-699
2018,11,25,22,1662,1711,1070,-641
2018,11,25,23,1669,1692,1071,-621
2018,11,26,0,1715,1731,955,-776
2018,11,26,1,1868,1897,975,-922
2018,11,26,2,1921,1983,1037,-946
2018,11,26,3,1891,1987,1013,-974
2018,11,26,4,1855,1966,1020,-946
2018,11,26,5,1783,1905,937,-968
2018,11,26,6,1697,1796,894,-902
2018,11,26,7,1605,1697,919,-778
2018,11,26,8,1555,1663,952,-711
2018,11,26,9,1552,1634,907,-727
2018,11,26,10,1563,1651,906,-745
2018,11,26,11,1583,1675,937,-738
2018,11,26,12,1633,1728,1070,-658
2018,11,26,13,1738,1849,1083,-766
2018,11,26,14,1895,2045,1169,-876
2018,11,26,15,2007,2183,1213,-970
2018,11,26,16,2012,2168,1261,-907
2018,11,26,17,1962,2134,1368,-766
2018,11,26,18,1910,2054,1368,-686
2018,11,26,19,1862,1994,1319,-675
2018,11,26,20,1818,1954,1252,-702
2018,11,26,21,1796,1931,1242,-689
2018,11,26,22,1857,1892,1212,-680
2018,11,26,23,1845,1903,1161,-742
2018,11,27,0,1879,1957,1189,-768
2018,11,27,1,2006,2080,1266,-814
2018,11,27,2,2079,2109,1296,-813
2018,11,27,3,2058,2084,1309,-775
2018,11,27,4,2027,2034,1275,-759
2018,11,27,5,1960,1949,1286,-663
2018,11,27,6,1844,1815,1176,-639
2018,11,27,7,1758,1677,1150,-527
2018,11,27,8,1716,1612,1196,-416
2018,11,27,9,1706,1604,1175,-429
2018,11,27,10,1713,1598,1286,-312
2018,11,27,11,1737,1581,1274,-307
2018,11,27,12,1795,1636,1265,-371
2018,11,27,13,1913,1714,1408,-306
2018,11,27,14,2107,1912,1462,-450
2018,11,27,15,2230,2025,1460,-565
2018,11,27,16,2201,2031,1617,-414
2018,11,27,17,2131,2008,1598,-410
2018,11,27,18,2058,2012,1479,-533
2018,11,27,19,1993,1968,1368,-600
2018,11,27,20,1933,1922,1293,-629
2018,11,27,21,1893,1919,1188,-731
2018,11,27,22,1857,1914,1153,-761
2018,11,27,23,1845,1919,1140,-779
2018,11,28,0,1879,1958,1110,-848
2018,11,28,1,2006,2059,1171,-888
2018,11,28,2,2079,2067,1360,-707
2018,11,28,3,2058,2021,1314,-707
2018,11,28,4,2027,1980,1143,-837
2018,11,28,5,1960,1885,1026,-859
2018,11,28,6,1844,1761,876,-885
2018,11,28,7,1758,1649,879,-770
2018,11,28,8,1716,1589,767,-822
2018,11,28,9,1706,1561,771,-790
2018,11,28,10,1713,1542,738,-804
2018,11,28,11,1737,1549,797,-752
2018,11,28,12,1795,1593,806,-787
2018,11,28,13,1913,1698,893,-805
2018,11,28,14,2107,1868,1029,-839
2018,11,28,15,2230,1997,1056,-941
2018,11,28,16,2201,1991,1086,-905
2018,11,28,17,2131,2009,1027,-982
2018,11,28,18,2058,1986,991,-995
2018,11,28,19,1993,1954,1008,-946
2018,11,28,20,1933,1913,989,-924
2018,11,28,21,1893,1862,976,-886
2018,11,28,22,1857,1845,954,-891
2018,11,28,23,1845,1847,931,-916
2018,11,29,0,1941,1898,892,-1006
2018,11,29,1,2052,2015,982,-1033
2018,11,29,2,2134,2050,1088,-962
2018,11,29,3,2088,1998,1068,-930
2018,11,29,4,2028,1966,1059,-907
2018,11,29,5,1954,1889,961,-928
2018,11,29,6,1834,1763,959,-804
2018,11,29,7,1754,1645,943,-702
2018,11,29,8,1680,1578,954,-624
2018,11,29,9,1670,1552,851,-701
2018,11,29,10,1643,1544,943,-601
2018,11,29,11,1658,1563,978,-585
2018,11,29,12,1698,1609,990,-619
2018,11,29,13,1795,1726,1031,-695
2018,11,29,14,1989,1913,1259,-654
2018,11,29,15,2108,2016,1332,-684
2018,11,29,16,2083,2021,1452,-569
2018,11,29,17,2007,1979,1411,-568
2018,11,29,18,1970,1951,1488,-463
2018,11,29,19,1925,1923,1516,-407
2018,11,29,20,1888,1890,1516,-374
2018,11,29,21,1917,1906,1495,-411
2018,11,29,22,1935,1903,1497,-406
2018,11,29,23,2033,1918,1405,-513
2018,11,30,0,2080,1968,1261,-707
2018,11,30,1,2092,2068,1272,-796
2018,11,30,2,2134,2085,1259,-826
2018,11,30,3,2082,2052,1150,-902
2018,11,30,4,2037,2011,1052,-959
2018,11,30,5,1962,1931,968,-963
2018,11,30,6,1842,1814,899,-915
2018,11,30,7,1742,1722,883,-839
2018,11,30,8,1675,1631,890,-741
2018,11,30,9,1654,1580,925,-655
2018,11,30,10,1661,1566,929,-637
2018,11,30,11,1651,1568,940,-628
2018,11,30,12,1679,1597,982,-615
2018,11,30,13,1779,1707,1031,-676
2018,11,30,14,1940,1857,1196,-661
2018,11,30,15,2054,1988,1193,-795
2018,11,30,16,2022,2024,1155,-869
2018,11,30,17,1980,2039,1095,-944
2018,11,30,18,1982,2048,1150,-898
2018,11,30,19,2013,2030,1267,-763
2018,11,30,20,2014,2003,1358,-645
2018,11,30,21,2051,1983,1373,-610
2018,11,30,22,2044,1958,1413,-545
2018,11,30,23,1959,1934,1418,-516
2018,12,1,0,1997,1985,1357,-628
2018,12,1,1,2049,2070,1345,-725
2018,12,1,2,2073,2084,1279,-805
2018,12,1,3,2067,2041,1316,-725
2018,12,1,4,2038,2001,1327,-674
2018,12,1,5,1997,1952,1269,-683
2018,12,1,6,1918,1876,1179,-697
2018,12,1,7,1843,1784,1080,-704
2018,12,1,8,1740,1742,1033,-709
2018,12,1,9,1702,1659,971,-688
2018,12,1,10,1687,1642,907,-735
2018,12,1,11,1684,1651,867,-784
2018,12,1,12,1701,1674,872,-802
2018,12,1,13,1762,1716,860,-856
2018,12,1,14,1838,1796,918,-878
2018,12,1,15,1930,1889,977,-912
2018,12,1,16,1996,1955,1015,-940
2018,12,1,17,2018,2034,1038,-996
2018,12,1,18,2002,2072,1059,-1013
2018,12,1,19,2011,2064,1079,-985
2018,12,1,20,1997,2010,1101,-909
2018,12,1,21,2005,1972,1092,-880
2018,12,1,22,1969,1965,1058,-907
2018,12,1,23,1929,1981,1070,-911
2018,12,2,0,2021,1994,1078,-916
2018,12,2,1,2147,2071,1241,-830
2018,12,2,2,2126,2053,1237,-816
2018,12,2,3,2062,2023,1084,-939
2018,12,2,4,2006,1984,1135,-849
2018,12,2,5,1959,1928,1145,-783
2018,12,2,6,1883,1844,1066,-778
2018,12,2,7,1799,1745,1035,-710
2018,12,2,8,1692,1681,1022,-659
2018,12,2,9,1674,1662,956,-706
2018,12,2,10,1683,1650,971,-679
2018,12,2,11,1701,1640,988,-652
2018,12,2,12,1720,1668,1023,-645
2018,12,2,13,1751,1708,1041,-667
2018,12,2,14,1813,1789,1095,-694
2018,12,2,15,1888,1869,1058,-811
2018,12,2,16,1970,1950,1053,-897
2018,12,2,17,2021,2007,987,-1020
2018,12,2,18,2018,2048,1019,-1029
2018,12,2,19,1999,1990,1085,-905
2018,12,2,20,1999,1967,1117,-850
2018,12,2,21,1988,1939,1149,-790
2018,12,2,22,1969,1945,1153,-792
2018,12,2,23,1946,1952,1147,-805
2018,12,3,0,2022,1997,1113,-884
2018,12,3,1,2152,2102,1088,-1014
2018,12,3,2,2168,2127,1116,-1011
2018,12,3,3,2132,2098,1104,-994
2018,12,3,4,2099,2060,1094,-966
2018,12,3,5,2028,1982,1065,-917
2018,12,3,6,1922,1858,983,-875
2018,12,3,7,1799,1745,955,-790
2018,12,3,8,1704,1689,956,-733
2018,12,3,9,1716,1659,892,-767
2018,12,3,10,1720,1659,865,-794
2018,12,3,11,1721,1680,873,-807
2018,12,3,12,1774,1724,923,-801
2018,12,3,13,1898,1847,983,-864
2018,12,3,14,2092,2029,1130,-899
2018,12,3,15,2232,2180,1172,-1008
2018,12,3,16,2280,2173,1177,-996
2018,12,3,17,2268,2173,1151,-1022
2018,12,3,18,2214,2152,1252,-900
2018,12,3,19,2177,2095,1237,-858
2018,12,3,20,2130,2040,1117,-923
2018,12,3,21,2092,2013,1084,-929
2018,12,3,22,2049,1984,1076,-908
2018,12,3,23,2017,1974,1050,-924
2018,12,4,0,2041,2012,983,-1029
2018,12,4,1,2196,2151,1179,-972
2018,12,4,2,2245,2231,1194,-1037
2018,12,4,3,2247,2223,1195,-1028
2018,12,4,4,2229,2207,1162,-1045
2018,12,4,5,2161,2127,1077,-1050
2018,12,4,6,2038,2006,897,-1109
2018,12,4,7,1929,1907,761,-1146
2018,12,4,8,1851,1847,756,-1091
2018,12,4,9,1830,1839,743,-1096
2018,12,4,10,1850,1843,740,-1103
2018,12,4,11,1885,1853,764,-1089
2018,12,4,12,1949,1914,827,-1087
2018,12,4,13,2086,2023,873,-1150
2018,12,4,14,2310,2215,1057,-1158
2018,12,4,15,2416,2346,1364,-982
2018,12,4,16,2391,2341,1336,-1005
2018,12,4,17,2348,2288,1296,-992
2018,12,4,18,2304,2238,1203,-1035
2018,12,4,19,2239,2179,1199,-980
2018,12,4,20,2166,2111,1167,-944
2018,12,4,21,2123,2066,1156,-910
2018,12,4,22,2079,2034,1134,-900
2018,12,4,23,2064,2032,1105,-927
2018,12,5,0,2103,2091,1069,-1022
2018,12,5,1,2257,2260,1160,-1100
2018,12,5,2,2345,2334,1233,-1101
2018,12,5,3,2349,2326,1287,-1039
2018,12,5,4,2324,2298,1307,-991
2018,12,5,5,2250,2225,1289,-936
2018,12,5,6,2129,2084,1142,-942
2018,12,5,7,2020,1985,1109,-876
2018,12,5,8,1930,1937,1041,-896
2018,12,5,9,1936,1922,985,-937
2018,12,5,10,1954,1936,957,-979
2018,12,5,11,1981,1963,900,-1063
2018,12,5,12,2054,2013,912,-1101
2018,12,5,13,2179,2133,939,-1194
2018,12,5,14,2362,2317,1117,-1200
2018,12,5,15,2517,2449,1357,-1092
2018,12,5,16,2482,2443,1278,-1165
2018,12,5,17,2438,2409,1314,-1095
2018,12,5,18,2400,2317,1332,-985
2018,12,5,19,2326,2255,1241,-1014
2018,12,5,20,2201,2187,1238,-949
2018,12,5,21,2201,2143,1147,-996
2018,12,5,22,2156,2111,1195,-916
2018,12,5,23,2145,2104,1196,-908
2018,12,6,0,2189,2156,1039,-1117
2018,12,6,1,2346,2321,1121,-1200
2018,12,6,2,2424,2374,1185,-1189
2018,12,6,3,2419,2372,1198,-1174
2018,12,6,4,2383,2350,1133,-1217
2018,12,6,5,2313,2265,1127,-1138
2018,12,6,6,2177,2133,1018,-1115
2018,12,6,7,2063,2035,832,-1203
2018,12,6,8,1993,1977,757,-1220
2018,12,6,9,1992,1963,835,-1128
2018,12,6,10,1995,1968,854,-1114
2018,12,6,11,2021,1986,855,-1131
2018,12,6,12,2084,2038,879,-1159
2018,12,6,13,2210,2150,1028,-1122
2018,12,6,14,2395,2339,1128,-1211
2018,12,6,15,2526,2469,1279,-1190
2018,12,6,16,2502,2461,1188,-1273
2018,12,6,17,2381,2399,1236,-1163
2018,12,6,18,2376,2329,1209,-1120
2018,12,6,19,2356,2260,1123,-1137
2018,12,6,20,2243,2194,1090,-1104
2018,12,6,21,2203,2139,1192,-947
2018,12,6,22,2168,2096,1299,-797
2018,12,6,23,2150,2096,1109,-987
2018,12,7,0,2203,2174,1019,-1155
2018,12,7,1,2380,2325,1051,-1274
2018,12,7,2,2450,2398,1075,-1323
2018,12,7,3,2440,2380,1103,-1277
2018,12,7,4,2410,2359,1145,-1214
2018,12,7,5,2326,2289,1146,-1143
2018,12,7,6,2190,2166,1044,-1122
2018,12,7,7,2085,2058,995,-1063
2018,12,7,8,1996,1998,915,-1083
2018,12,7,9,2018,1969,961,-1008
2018,12,7,10,2018,1975,967,-1008
2018,12,7,11,2030,1987,985,-1002
2018,12,7,12,2082,2034,1044,-990
2018,12,7,13,2214,2132,1134,-998
2018,12,7,14,2398,2309,1282,-1027
2018,12,7,15,2519,2452,1429,-1023
2018,12,7,16,2506,2432,1419,-1013
2018,12,7,17,2397,2378,1393,-985
2018,12,7,18,2346,2305,1298,-1007
2018,12,7,19,2302,2237,1233,-1004
2018,12,7,20,2208,2198,1160,-1038
2018,12,7,21,2157,2169,1098,-1071
2018,12,7,22,2137,2143,1091,-1052
2018,12,7,23,2144,2110,1154,-956
2018,12,8,0,2220,2151,1121,-1030
2018,12,8,1,2317,2267,1307,-960
2018,12,8,2,2330,2282,1302,-980
2018,12,8,3,2324,2220,1265,-955
2018,12,8,4,2283,2193,1265,-928
2018,12,8,5,2224,2143,1192,-951
2018,12,8,6,2130,2046,1106,-940
2018,12,8,7,2049,1958,1075,-883
2018,12,8,8,2021,1886,991,-895
2018,12,8,9,1990,1870,885,-985
2018,12,8,10,1902,1856,880,-976
2018,12,8,11,1901,1848,880,-968
2018,12,8,12,1912,1870,878,-992
2018,12,8,13,1961,1927,913,-1014
2018,12,8,14,2038,1997,996,-1001
2018,12,8,15,2135,2084,1166,-918
2018,12,8,16,2236,2165,1187,-978
2018,12,8,17,2241,2221,1215,-1006
2018,12,8,18,2208,2235,1128,-1107
2018,12,8,19,2178,2195,1114,-1081
2018,12,8,20,2140,2138,1022,-1116
2018,12,8,21,2112,2093,928,-1165
2018,12,8,22,2068,2058,823,-1235
2018,12,8,23,2065,2063,873,-1190
2018,12,9,0,2131,2093,996,-1097
2018,12,9,1,2286,2174,1153,-1021
2018,12,9,2,2302,2171,1219,-952
2018,12,9,3,2245,2125,1214,-911
2018,12,9,4,2188,2095,1184,-911
2018,12,9,5,2123,2035,1077,-958
2018,12,9,6,2012,1941,1031,-910
2018,12,9,7,1918,1872,964,-908
2018,12,9,8,1925,1804,960,-844
2018,12,9,9,1866,1759,967,-792
2018,12,9,10,1845,1743,1062,-681
2018,12,9,11,1821,1737,1079,-658
2018,12,9,12,1818,1758,1118,-640
2018,12,9,13,1883,1809,1157,-652
2018,12,9,14,1932,1881,1193,-688
2018,12,9,15,1991,1952,1186,-766
2018,12,9,16,2088,2034,1252,-782
2018,12,9,17,2133,2070,1308,-762
2018,12,9,18,2101,2045,1385,-660
2018,12,9,19,2042,1988,1534,-454
2018,12,9,20,1989,1961,1600,-361
2018,12,9,21,1967,1922,1580,-342
2018,12,9,22,1941,1925,1604,-321
2018,12,9,23,1952,1934,1547,-387
2018,12,10,0,2036,1993,1460,-533
2018,12,10,1,2197,2141,1544,-597
2018,12,10,2,2234,2179,1550,-629
2018,12,10,3,2217,2167,1635,-532
2018,12,10,4,2196,2122,1546,-576
2018,12,10,5,2132,2052,1547,-505
2018,12,10,6,2001,1933,1512,-421
2018,12,10,7,1882,1856,1519,-337
2018,12,10,8,1815,1788,1483,-305
2018,12,10,9,1823,1751,1447,-304
2018,12,10,10,1838,1762,1448,-314
2018,12,10,11,1831,1776,1411,-365
2018,12,10,12,1881,1830,1401,-429
2018,12,10,13,2017,1944,1390,-554
2018,12,10,14,2200,2129,1401,-728
2018,12,10,15,2320,2249,1322,-927
2018,12,10,16,2359,2247,1340,-907
2018,12,10,17,2300,2225,1211,-1014
2018,12,10,18,2244,2195,1177,-1018
2018,12,10,19,2215,2157,1183,-974
2018,12,10,20,2156,2122,1138,-984
2018,12,10,21,2139,2083,1133,-950
2018,12,10,22,2116,2064,1127,-937
2018,12,10,23,2111,2057,1077,-980
2018,12,11,0,2172,2130,1263,-867
2018,12,11,1,2327,2230,1375,-855
2018,12,11,2,2368,2269,1417,-852
2018,12,11,3,2325,2221,1396,-825
2018,12,11,4,2276,2184,1406,-778
2018,12,11,5,2190,2093,1289,-804
2018,12,11,6,2043,1958,1160,-798
2018,12,11,7,1934,1833,1134,-699
2018,12,11,8,1933,1787,1021,-766
2018,12,11,9,1884,1770,871,-899
2018,12,11,10,1817,1766,862,-904
2018,12,11,11,1831,1772,882,-890
2018,12,11,12,1868,1797,989,-808
2018,12,11,13,1979,1897,1102,-795
2018,12,11,14,2149,2055,1260,-795
2018,12,11,15,2265,2203,1303,-900
2018,12,11,16,2247,2198,1304,-894
2018,12,11,17,2232,2164,1261,-903
2018,12,11,18,2199,2114,1206,-908
2018,12,11,19,2155,2052,1237,-815
2018,12,11,20,2094,2028,1198,-830
2018,12,11,21,2038,2031,1184,-847
2018,12,11,22,2022,2014,1215,-799
2018,12,11,23,2050,2030,1260,-770
2018,12,12,0,2123,2073,1289,-784
2018,12,12,1,2280,2199,1455,-744
2018,12,12,2,2306,2229,1549,-680
2018,12,12,3,2259,2196,1548,-648
2018,12,12,4,2200,2153,1559,-594
2018,12,12,5,2102,2069,1416,-653
2018,12,12,6,1955,1928,1306,-622
2018,12,12,7,1844,1816,1287,-529
2018,12,12,8,1782,1749,1236,-513
2018,12,12,9,1769,1709,1092,-617
2018,12,12,10,1756,1687,1013,-674
2018,12,12,11,1749,1698,996,-702
2018,12,12,12,1778,1697,948,-749
2018,12,12,13,1879,1850,1042,-808
2018,12,12,14,2049,2032,1339,-693
2018,12,12,15,2207,2160,1485,-675
2018,12,12,16,2209,2168,1522,-646
2018,12,12,17,2166,2134,1559,-575
2018,12,12,18,2140,2070,1570,-500
2018,12,12,19,2093,2002,1539,-463
2018,12,12,20,2044,1950,1588,-362
2018,12,12,21,1998,1930,1526,-404
2018,12,12,22,1958,1913,1467,-446
2018,12,12,23,1968,1936,1510,-426
2018,12,13,0,2038,2014,1574,-440
2018,12,13,1,2210,2159,1603,-556
2018,12,13,2,2276,2205,1698,-507
2018,12,13,3,2267,2203,1653,-550
2018,12,13,4,2233,2162,1565,-597
2018,12,13,5,2153,2109,1352,-757
2018,12,13,6,2022,1985,1176,-809
2018,12,13,7,1930,1887,1135,-752
2018,12,13,8,1882,1836,1113,-723
2018,12,13,9,1867,1808,1083,-725
2018,12,13,10,1840,1822,1200,-622
2018,12,13,11,1851,1839,1241,-598
2018,12,13,12,1909,1892,1244,-648
2018,12,13,13,2034,1999,1253,-746
2018,12,13,14,2226,2198,1443,-755
2018,12,13,15,2359,2338,1580,-758
2018,12,13,16,2349,2325,1576,-749
2018,12,13,17,2306,2297,1511,-786
2018,12,13,18,2228,2228,1395,-833
2018,12,13,19,2165,2157,1309,-848
2018,12,13,20,2139,2086,1264,-822
2018,12,13,21,2114,2026,1224,-802
2018,12,13,22,2072,1989,1227,-762
2018,12,13,23,2061,1980,1254,-726
2018,12,14,0,2109,2033,1306,-727
2018,12,14,1,2261,2175,1473,-702
2018,12,14,2,2310,2247,1577,-670
2018,12,14,3,2290,2237,1564,-673
2018,12,14,4,2258,2220,1611,-609
2018,12,14,5,2187,2144,1424,-720
2018,12,14,6,2062,2036,1385,-651
2018,12,14,7,1968,1949,1495,-454
2018,12,14,8,1924,1885,1464,-421
2018,12,14,9,1906,1882,1461,-421
2018,12,14,10,1911,1882,1436,-446
2018,12,14,11,1939,1886,1417,-469
2018,12,14,12,1988,1936,1408,-528
2018,12,14,13,2087,2036,1435,-601
2018,12,14,14,2284,2202,1539,-663
2018,12,14,15,2410,2326,1684,-642
2018,12,14,16,2372,2340,1764,-576
2018,12,14,17,2322,2322,1871,-451
2018,12,14,18,2265,2262,1759,-503
2018,12,14,19,2193,2218,1663,-555
2018,12,14,20,2141,2156,1605,-551
2018,12,14,21,2125,2115,1612,-503
2018,12,14,22,2098,2130,1572,-558
2018,12,14,23,2098,2101,1543,-558
2018,12,15,0,2209,2127,1517,-610
2018,12,15,1,2259,2182,1718,-464
2018,12,15,2,2238,2179,1732,-447
2018,12,15,3,2201,2120,1743,-377
2018,12,15,4,2146,2081,1742,-339
2018,12,15,5,2071,2020,1708,-312
2018,12,15,6,1972,1915,1552,-363
2018,12,15,7,1885,1822,1233,-589
2018,12,15,8,1806,1739,1254,-485
2018,12,15,9,1766,1689,1204,-485
2018,12,15,10,1732,1694,1130,-564
2018,12,15,11,1721,1698,1101,-597
2018,12,15,12,1762,1735,1077,-658
2018,12,15,13,1820,1791,1078,-713
2018,12,15,14,1907,1865,1177,-688
2018,12,15,15,1996,1961,1338,-623
2018,12,15,16,2079,2056,1415,-641
2018,12,15,17,2120,2101,1421,-680
2018,12,15,18,2094,2111,1379,-732
2018,12,15,19,2050,2071,1384,-687
2018,12,15,20,2014,2005,1367,-638
2018,12,15,21,1963,1958,1357,-601
2018,12,15,22,1958,1928,1324,-604
2018,12,15,23,1974,1930,1349,-581
2018,12,16,0,2006,1943,1346,-597
2018,12,16,1,2114,2036,1403,-633
2018,12,16,2,2104,2041,1444,-597
2018,12,16,3,2082,2006,1416,-590
2018,12,16,4,2039,1986,1466,-520
2018,12,16,5,1977,1953,1404,-549
2018,12,16,6,1897,1880,1406,-474
2018,12,16,7,1837,1799,1430,-369
2018,12,16,8,1770,1739,1397,-342
2018,12,16,9,1752,1705,1386,-319
2018,12,16,10,1752,1710,1431,-279
2018,12,16,11,1757,1710,1444,-266
2018,12,16,12,1786,1724,1429,-295
2018,12,16,13,1826,1762,1462,-300
2018,12,16,14,1889,1837,1466,-371
2018,12,16,15,1962,1906,1506,-400
2018,12,16,16,2049,1981,1631,-350
2018,12,16,17,2087,2036,1677,-359
2018,12,16,18,2049,2025,1657,-368
2018,12,16,19,1982,1985,1577,-408
2018,12,16,20,1949,1962,1478,-484
2018,12,16,21,1924,1927,1502,-425
2018,12,16,22,1922,1915,1480,-435
2018,12,16,23,1945,1906,1522,-384
2018,12,17,0,2010,1929,1634,-295
2018,12,17,1,2139,2040,1637,-403
2018,12,17,2,2140,2062,1574,-488
2018,12,17,3,2104,2026,1576,-450
2018,12,17,4,2059,1990,1665,-325
2018,12,17,5,1973,1911,1654,-257
2018,12,17,6,1858,1808,1375,-433
2018,12,17,7,1752,1686,1274,-412
2018,12,17,8,1708,1626,1316,-310
2018,12,17,9,1678,1602,1290,-312
2018,12,17,10,1643,1591,1101,-490
2018,12,17,11,1652,1606,1094,-512
2018,12,17,12,1693,1654,1086,-568
2018,12,17,13,1811,1750,1139,-611
2018,12,17,14,1988,1942,1185,-757
2018,12,17,15,2109,2061,1366,-695
2018,12,17,16,2154,2085,1348,-737
2018,12,17,17,2132,2049,1372,-677
2018,12,17,18,2102,2041,1229,-812
2018,12,17,19,2069,1995,1236,-759
2018,12,17,20,2032,1937,1091,-846
2018,12,17,21,2015,1902,1060,-842
2018,12,17,22,1968,1866,1024,-842
2018,12,17,23,1943,1855,1009,-846
2018,12,18,0,1968,1912,1160,-752
2018,12,18,1,2100,2027,1384,-643
2018,12,18,2,2145,2063,1500,-563
2018,12,18,3,2131,2042,1489,-553
2018,12,18,4,2103,2006,1420,-586
2018,12,18,5,2025,1933,1389,-544
2018,12,18,6,1886,1808,1262,-546
2018,12,18,7,1780,1683,1141,-542
2018,12,18,8,1792,1621,1055,-566
2018,12,18,9,1731,1576,1030,-546
2018,12,18,10,1653,1565,1007,-558
2018,12,18,11,1638,1571,987,-584
2018,12,18,12,1669,1612,979,-633
2018,12,18,13,1772,1708,1098,-610
2018,12,18,14,1948,1899,1258,-641
2018,12,18,15,2067,2030,1422,-608
2018,12,18,16,2069,2039,1400,-639
2018,12,18,17,2074,2020,1374,-646
2018,12,18,18,2068,2005,1254,-751
2018,12,18,19,2025,1977,1196,-781
2018,12,18,20,1984,1943,1117,-826
2018,12,18,21,1976,1918,1139,-779
2018,12,18,22,1968,1904,1107,-797
2018,12,18,23,1962,1892,1121,-771
2018,12,19,0,1994,1951,1195,-756
2018,12,19,1,2107,2047,1316,-731
2018,12,19,2,2129,2053,1418,-635
2018,12,19,3,2085,2007,1478,-529
2018,12,19,4,2035,1992,1412,-580
2018,12,19,5,1952,1930,1360,-570
2018,12,19,6,1834,1781,1279,-502
2018,12,19,7,1744,1686,1252,-434
2018,12,19,8,1687,1589,1324,-265
2018,12,19,9,1650,1565,1351,-214
2018,12,19,10,1627,1548,1323,-225
2018,12,19,11,1642,1562,1285,-277
2018,12,19,12,1672,1619,1337,-282
2018,12,19,13,1778,1716,1383,-333
2018,12,19,14,1978,1908,1444,-464
2018,12,19,15,2105,2048,1435,-613
2018,12,19,16,2105,2066,1503,-563
2018,12,19,17,2102,2021,1402,-619
2018,12,19,18,2086,1963,1334,-629
2018,12,19,19,2022,1939,1370,-569
2018,12,19,20,1956,1870,1415,-455
2018,12,19,21,1934,1854,1348,-506
2018,12,19,22,1881,1811,1292,-519
2018,12,19,23,1886,1807,1213,-594
2018,12,20,0,1940,1865,1238,-627
2018,12,20,1,2072,2001,1354,-647
2018,12,20,2,2111,2052,1336,-716
2018,12,20,3,2109,2041,1325,-716
2018,12,20,4,2097,2019,1210,-809
2018,12,20,5,2022,1968,1243,-725
2018,12,20,6,1888,1844,1098,-746
2018,12,20,7,1787,1735,1095,-640
2018,12,20,8,1739,1672,1165,-507
2018,12,20,9,1705,1660,1124,-536
2018,12,20,10,1679,1654,1187,-467
2018,12,20,11,1696,1644,1235,-409
2018,12,20,12,1756,1689,1256,-433
2018,12,20,13,1857,1807,1251,-556
2018,12,20,14,2037,1983,1405,-578
2018,12,20,15,2197,2115,1575,-540
2018,12,20,16,2198,2131,1639,-492
2018,12,20,17,2154,2084,1699,-385
2018,12,20,18,2111,2058,1628,-430
2018,12,20,19,2058,1992,1598,-394
2018,12,20,20,1991,1936,1584,-352
2018,12,20,21,1942,1870,1495,-375
2018,12,20,22,1891,1846,1409,-437
2018,12,20,23,1887,1847,1367,-480
2018,12,21,0,1953,1903,1384,-519
2018,12,21,1,2091,2024,1464,-560
2018,12,21,2,2127,2041,1588,-453
2018,12,21,3,2098,2020,1552,-468
2018,12,21,4,2049,1985,1543,-442
2018,12,21,5,1972,1915,1437,-478
2018,12,21,6,1854,1815,1322,-493
2018,12,21,7,1742,1692,1124,-568
2018,12,21,8,1689,1614,1018,-596
2018,12,21,9,1647,1574,1057,-517
2018,12,21,10,1627,1534,1309,-225
2018,12,21,11,1618,1550,1366,-184
2018,12,21,12,1649,1590,1396,-194
2018,12,21,13,1766,1722,1416,-306
2018,12,21,14,1942,1894,1398,-496
2018,12,21,15,2098,2032,1365,-667
2018,12,21,16,2108,2073,1476,-597
2018,12,21,17,2086,2042,1450,-592
2018,12,21,18,2076,2000,1397,-603
2018,12,21,19,2048,1959,1428,-531
2018,12,21,20,1998,1921,1474,-447
2018,12,21,21,1986,1873,1493,-380
2018,12,21,22,1954,1887,1395,-492
2018,12,21,23,1952,1901,1502,-399
2018,12,22,0,2038,1955,1565,-390
2018,12,22,1,2118,2060,1714,-346
2018,12,22,2,2119,2085,1755,-330
2018,12,22,3,2121,2057,1772,-285
2018,12,22,4,2106,2039,1819,-220
2018,12,22,5,2070,1997,1835,-162
2018,12,22,6,1995,1910,1752,-158
2018,12,22,7,1905,1821,1633,-188
2018,12,22,8,1840,1761,1481,-280
2018,12,22,9,1788,1741,1236,-505
2018,12,22,10,1771,1736,1211,-525
2018,12,22,11,1787,1752,1177,-575
2018,12,22,12,1824,1788,1284,-504
2018,12,22,13,1906,1845,1293,-552
2018,12,22,14,1978,1935,1335,-600
2018,12,22,15,2075,2043,1447,-596
2018,12,22,16,2166,2131,1435,-696
2018,12,22,17,2204,2139,1484,-655
2018,12,22,18,2178,2091,1394,-697
2018,12,22,19,2097,2057,1258,-799
2018,12,22,20,2016,1964,1211,-753
2018,12,22,21,1979,1895,1238,-657
2018,12,22,22,1936,1881,1219,-662
2018,12,22,23,1930,1903,1170,-733
2018,12,23,0,1975,1952,1264,-688
2018,12,23,1,2112,2053,1369,-684
2018,12,23,2,2124,2068,1476,-592
2018,12,23,3,2102,2045,1547,-498
2018,12,23,4,2070,2020,1565,-455
2018,12,23,5,2025,1988,1515,-473
2018,12,23,6,1947,1886,1445,-441
2018,12,23,7,1844,1801,1494,-307
2018,12,23,8,1759,1724,1305,-419
2018,12,23,9,1723,1662,1200,-462
2018,12,23,10,1710,1649,1284,-365
2018,12,23,11,1708,1640,1290,-350
2018,12,23,12,1720,1659,1320,-339
2018,12,23,13,1764,1694,1356,-338
2018,12,23,14,1825,1771,1281,-490
2018,12,23,15,1896,1863,1188,-675
2018,12,23,16,1990,1950,1224,-726
2018,12,23,17,2017,1997,1196,-801
2018,12,23,18,1990,2038,1209,-829
2018,12,23,19,1979,2007,1313,-694
2018,12,23,20,1996,1981,1273,-708
2018,12,23,21,1996,1954,1245,-709
2018,12,23,22,2008,1946,1277,-669
2018,12,23,23,2022,1929,1293,-636
2018,12,24,0,2061,1968,1459,-509
2018,12,24,1,2171,2045,1447,-598
2018,12,24,2,2149,2046,1443,-603
2018,12,24,3,2097,2010,1436,-574
2018,12,24,4,2054,1989,1413,-576
2018,12,24,5,1969,1918,1403,-515
2018,12,24,6,1847,1838,1164,-674
2018,12,24,7,1730,1723,1051,-672
2018,12,24,8,1671,1650,962,-688
2018,12,24,9,1649,1613,861,-752
2018,12,24,10,1648,1594,786,-808
2018,12,24,11,1653,1604,771,-833
2018,12,24,12,1697,1624,761,-863
2018,12,24,13,1802,1683,811,-872
2018,12,24,14,1971,1740,1037,-703
2018,12,24,15,2058,1838,1176,-662
2018,12,24,16,2043,1917,1243,-674
2018,12,24,17,1988,1969,1324,-645
2018,12,24,18,1984,1977,1369,-608
2018,12,24,19,2004,1973,1292,-681
2018,12,24,20,1973,1914,1214,-700
2018,12,24,21,1944,1924,1177,-747
2018,12,24,22,1936,1873,1160,-713
2018,12,24,23,1957,1870,1248,-622
2018,12,25,0,1983,1892,1247,-645
2018,12,25,1,2078,1927,1338,-589
2018,12,25,2,2107,1898,1366,-532
2018,12,25,3,2041,1851,1398,-453
2018,12,25,4,1980,1824,1418,-406
2018,12,25,5,1893,1790,1312,-478
2018,12,25,6,1778,1717,1245,-472
2018,12,25,7,1667,1636,1264,-372
2018,12,25,8,1723,1580,1298,-282
2018,12,25,9,1708,1547,1133,-414
2018,12,25,10,1600,1546,1043,-503
2018,12,25,11,1601,1541,1025,-516
2018,12,25,12,1641,1560,1021,-539
2018,12,25,13,1724,1597,1063,-534
2018,12,25,14,1873,1675,1214,-461
2018,12,25,15,1952,1743,1351,-392
2018,12,25,16,1928,1835,1367,-468
2018,12,25,17,1968,1864,1376,-488
2018,12,25,18,2008,1865,1376,-489
2018,12,25,19,1977,1830,1335,-495
2018,12,25,20,1905,1779,1370,-409
2018,12,25,21,1846,1716,1292,-424
2018,12,25,22,1780,1683,1416,-267
2018,12,25,23,1793,1658,1418,-240
2018,12,26,0,1833,1697,1347,-350
2018,12,26,1,1916,1823,1464,-359
2018,12,26,2,1942,1872,1652,-220
2018,12,26,3,1919,1881,1685,-196
2018,12,26,4,1931,1877,1675,-202
2018,12,26,5,1912,1847,1657,-190
2018,12,26,6,1842,1790,1510,-280
2018,12,26,7,1762,1714,1478,-236
2018,12,26,8,1834,1677,1451,-226
2018,12,26,9,1738,1653,1327,-326
2018,12,26,10,1702,1656,1344,-312
2018,12,26,11,1708,1673,1301,-372
2018,12,26,12,1757,1723,1307,-416
2018,12,26,13,1854,1812,1345,-467
2018,12,26,14,1980,1942,1459,-483
2018,12,26,15,2100,2056,1381,-675
2018,12,26,16,2146,2128,1359,-769
2018,12,26,17,2142,2127,1337,-790
2018,12,26,18,2131,2155,1389,-766
2018,12,26,19,2102,2086,1298,-788
2018,12,26,20,2043,2041,1163,-878
2018,12,26,21,1991,2000,1224,-776
2018,12,26,22,1975,1939,1209,-730
2018,12,26,23,1971,1966,1305,-661
2018,12,27,0,2000,2002,1267,-735
2018,12,27,1,2125,2122,1335,-787
2018,12,27,2,2148,2157,1222,-935
2018,12,27,3,2148,2136,1259,-877
2018,12,27,4,2132,2095,1250,-845
2018,12,27,5,2075,2027,1165,-862
2018,12,27,6,1967,1915,1049,-866
2018,12,27,7,1860,1804,1075,-729
2018,12,27,8,1750,1736,1017,-719
2018,12,27,9,1706,1713,978,-735
2018,12,27,10,1726,1698,979,-719
2018,12,27,11,1736,1690,1020,-670
2018,12,27,12,1777,1730,1136,-594
2018,12,27,13,1848,1801,1190,-611
2018,12,27,14,1966,1919,1359,-560
2018,12,27,15,2100,2043,1609,-434
2018,12,27,16,2141,2117,1644,-473
2018,12,27,17,2156,2138,1612,-526
2018,12,27,18,2151,2141,1505,-636
2018,12,27,19,2130,2106,1406,-700
2018,12,27,20,2091,2061,1346,-715
2018,12,27,21,2068,2017,1364,-653
2018,12,27,22,2024,1967,1479,-488
2018,12,27,23,2017,1951,1525,-426
2018,12,28,0,2040,1993,1514,-479
2018,12,28,1,2128,2130,1594,-536
2018,12,28,2,2167,2181,1726,-455
2018,12,28,3,2171,2165,1693,-472
2018,12,28,4,2164,2137,1498,-639
2018,12,28,5,2122,2062,1395,-667
2018,12,28,6,2010,1964,1235,-729
2018,12,28,7,1912,1857,1113,-744
2018,12,28,8,1797,1810,1079,-731
2018,12,28,9,1789,1780,1049,-731
2018,12,28,10,1810,1779,1020,-759
2018,12,28,11,1814,1796,996,-800
2018,12,28,12,1866,1843,989,-854
2018,12,28,13,1966,1926,1045,-881
2018,12,28,14,2097,2066,1154,-912
2018,12,28,15,2224,2196,1354,-842
2018,12,28,16,2275,2252,1347,-905
2018,12,28,17,2287,2253,1428,-825
2018,12,28,18,2249,2202,1354,-848
2018,12,28,19,2198,2132,1287,-845
2018,12,28,20,2163,2082,1300,-782
2018,12,28,21,2110,2034,1266,-768
2018,12,28,22,2058,1993,1239,-754
2018,12,28,23,2052,1991,1285,-706
2018,12,29,0,2109,2033,1385,-648
2018,12,29,1,2213,2150,1500,-650
2018,12,29,2,2229,2193,1492,-701
2018,12,29,3,2216,2158,1438,-720
2018,12,29,4,2185,2136,1430,-706
2018,12,29,5,2137,2060,1276,-784
2018,12,29,6,2068,1959,1139,-820
2018,12,29,7,1960,1865,1089,-776
2018,12,29,8,1836,1793,1047,-746
2018,12,29,9,1834,1754,985,-769
2018,12,29,10,1791,1732,970,-762
2018,12,29,11,1785,1732,971,-761
2018,12,29,12,1794,1756,969,-787
2018,12,29,13,1829,1809,987,-822
2018,12,29,14,1888,1886,1073,-813
2018,12,29,15,1999,1967,1228,-739
2018,12,29,16,2143,2048,1337,-711
2018,12,29,17,2195,2088,1330,-758
2018,12,29,18,2139,2113,1375,-738
2018,12,29,19,2076,2118,1363,-755
2018,12,29,20,2041,2108,1283,-825
2018,12,29,21,2041,2059,1172,-887
2018,12,29,22,2054,2015,1098,-917
2018,12,29,23,2041,1982,1075,-907
2018,12,30,0,2059,2007,1184,-823
2018,12,30,1,2127,2112,1266,-846
2018,12,30,2,2126,2149,1323,-826
2018,12,30,3,2122,2121,1155,-966
2018,12,30,4,2104,2075,1219,-856
2018,12,30,5,2039,2015,1165,-850
2018,12,30,6,1946,1908,1121,-787
2018,12,30,7,1854,1817,1109,-708
2018,12,30,8,1714,1737,1088,-649
2018,12,30,9,1676,1696,1148,-548
2018,12,30,10,1720,1687,1102,-585
2018,12,30,11,1733,1675,1065,-610
2018,12,30,12,1768,1703,1091,-612
2018,12,30,13,1803,1719,1154,-565
2018,12,30,14,1790,1780,1210,-570
2018,12,30,15,1852,1863,1249,-614
2018,12,30,16,1955,1937,1314,-623
2018,12,30,17,2004,1964,1463,-501
2018,12,30,18,2010,1952,1523,-429
2018,12,30,19,1971,1940,1586,-354
2018,12,30,20,1964,1906,1587,-319
2018,12,30,21,1952,1864,1587,-277
2018,12,30,22,1912,1865,1554,-311
2018,12,30,23,1900,1863,1482,-381
2018,12,31,0,1957,1919,1522,-397
2018,12,31,1,2094,2036,1524,-512
2018,12,31,2,2150,2098,1593,-505
2018,12,31,3,2145,2072,1683,-389
2018,12,31,4,2128,2030,1753,-277
2018,12,31,5,2046,1966,1650,-316
2018,12,31,6,1935,1867,1438,-429
2018,12,31,7,1826,1767,1405,-362
2018,12,31,8,1752,1743,1421,-322
2018,12,31,9,1760,1719,1332,-387
2018,12,31,10,1811,1703,1333,-370
2018,12,31,11,1805,1723,1295,-428
2018,12,31,12,1834,1800,1254,-546
2018,12,31,13,1942,1884,1344,-540
2018,12,31,14,2111,2007,1462,-545
2018,12,31,15,2240,2124,1501,-623
2018,12,31,16,2292,2197,1467,-730
2018,12,31,17,2288,2223,1604,-619
2018,12,31,18,2237,2190,1641,-549
2018,12,31,19,2214,2123,1564,-559
2018,12,31,20,2152,2039,1418,-621
2018,12,31,21,2077,1994,1420,-574
2018,12,31,22,2028,1964,1355,-609
2018,12,31,23,2012,1955,1327,-628
2019,1,1,0,2069,2027,1329,-698
2019,1,1,1,2234,2180,1369,-811
2019,1,1,2,2319,2218,1386,-832
2019,1,1,3,2304,2165,1437,-728
2019,1,1,4,2257,2112,1484,-628
2019,1,1,5,2161,2066,1381,-685
2019,1,1,6,2036,2002,1202,-800
2019,1,1,7,1940,1952,1101,-851
2019,1,1,8,1958,1958,1111,-847
2019,1,1,9,1937,1899,1015,-884
2019,1,1,10,1937,1892,972,-920
2019,1,1,11,1982,1902,915,-987
2019,1,1,12,2037,1946,927,-1019
2019,1,1,13,2117,1993,1006,-987
2019,1,1,14,2258,2070,1071,-999
2019,1,1,15,2348,2126,1135,-991
2019,1,1,16,2317,2174,1131,-1043
2019,1,1,17,2316,2211,1169,-1042
2019,1,1,18,2276,2170,1192,-978
2019,1,1,19,2213,2125,1183,-942
2019,1,1,20,2130,2073,1154,-919
2019,1,1,21,2073,2003,1171,-832
2019,1,1,22,2033,1984,1151,-833
2019,1,1,23,2020,1999,1106,-893
2019,1,2,0,2091,2055,1121,-934
2019,1,2,1,2278,2191,1215,-976
2019,1,2,2,2338,2235,1230,-1005
2019,1,2,3,2281,2213,1244,-969
2019,1,2,4,2225,2188,1261,-927
2019,1,2,5,2188,2116,1192,-924
2019,1,2,6,2099,2024,1223,-801
2019,1,2,7,2013,1938,1062,-876
2019,1,2,8,1994,1885,1042,-843
2019,1,2,9,1932,1864,944,-920
2019,1,2,10,1907,1874,959,-915
2019,1,2,11,1935,1901,1033,-868
2019,1,2,12,1994,1942,1064,-878
2019,1,2,13,2073,2044,1158,-886
2019,1,2,14,2185,2199,1268,-931
2019,1,2,15,2338,2340,1445,-895
2019,1,2,16,2398,2377,1485,-892
2019,1,2,17,2398,2348,1513,-835
2019,1,2,18,2358,2289,1427,-862
2019,1,2,19,2283,2251,1266,-985
2019,1,2,20,2217,2226,1224,-1002
2019,1,2,21,2175,2161,1170,-991
2019,1,2,22,2176,2127,1138,-989
2019,1,2,23,2160,2119,1152,-967
2019,1,3,0,2215,2145,1044,-1101
2019,1,3,1,2357,2278,1112,-1166
2019,1,3,2,2396,2319,1339,-980
2019,1,3,3,2344,2293,1430,-863
2019,1,3,4,2298,2246,1463,-783
2019,1,3,5,2232,2159,1394,-765
2019,1,3,6,2125,2045,1247,-798
2019,1,3,7,2031,1941,1254,-687
2019,1,3,8,1966,1890,1277,-613
2019,1,3,9,1950,1876,1148,-728
2019,1,3,10,1928,1871,1173,-698
2019,1,3,11,1946,1890,1198,-692
2019,1,3,12,1992,1930,1229,-701
2019,1,3,13,2076,2030,1386,-644
2019,1,3,14,2210,2177,1630,-547
2019,1,3,15,2343,2310,1737,-573
2019,1,3,16,2392,2336,1801,-535
2019,1,3,17,2383,2297,1852,-445
2019,1,3,18,2324,2241,1752,-489
2019,1,3,19,2249,2206,1669,-537
2019,1,3,20,2188,2136,1471,-665
2019,1,3,21,2137,2103,1368,-735
2019,1,3,22,2085,2063,1304,-759
2019,1,3,23,2102,2032,1336,-696
2019,1,4,0,2156,2052,1415,-637
2019,1,4,1,2288,2178,1495,-683
2019,1,4,2,2323,2238,1641,-597
2019,1,4,3,2279,2195,1693,-502
2019,1,4,4,2226,2159,1626,-533
2019,1,4,5,2159,2093,1563,-530
2019,1,4,6,2051,1974,1373,-601
2019,1,4,7,1964,1872,1389,-483
2019,1,4,8,1936,1801,1424,-377
2019,1,4,9,1898,1783,1383,-400
2019,1,4,10,1853,1780,1324,-456
2019,1,4,11,1845,1787,1421,-366
2019,1,4,12,1875,1818,1403,-415
2019,1,4,13,1970,1908,1427,-481
2019,1,4,14,2096,2060,1535,-525
2019,1,4,15,2207,2185,1582,-603
2019,1,4,16,2271,2225,1559,-666
2019,1,4,17,2272,2201,1633,-568
2019,1,4,18,2223,2163,1610,-553
2019,1,4,19,2172,2099,1557,-542
2019,1,4,20,2119,2055,1534,-521
2019,1,4,21,2052,2030,1448,-582
2019,1,4,22,2008,2012,1401,-611
2019,1,4,23,2024,1993,1329,-664
2019,1,5,0,2101,2010,1295,-715
2019,1,5,1,2226,2119,1399,-720
2019,1,5,2,2227,2158,1474,-684
2019,1,5,3,2178,2142,1527,-615
2019,1,5,4,2149,2090,1465,-625
2019,1,5,5,2105,2054,1471,-583
2019,1,5,6,2026,1962,1426,-536
2019,1,5,7,1955,1876,1438,-438
2019,1,5,8,1911,1812,1321,-491
2019,1,5,9,1866,1777,1348,-429
2019,1,5,10,1829,1763,1364,-399
2019,1,5,11,1826,1773,1363,-410
2019,1,5,12,1852,1792,1278,-514
2019,1,5,13,1902,1845,1396,-449
2019,1,5,14,1948,1920,1419,-501
2019,1,5,15,2035,2013,1567,-446
2019,1,5,16,2157,2092,1569,-523
2019,1,5,17,2193,2115,1742,-373
2019,1,5,18,2158,2115,1811,-304
2019,1,5,19,2108,2074,1733,-341
2019,1,5,20,2058,2051,1824,-227
2019,1,5,21,1997,2006,1660,-346
2019,1,5,22,1975,1993,1597,-396
2019,1,5,23,1995,1995,1550,-445
2019,1,6,0,2034,2010,1500,-510
2019,1,6,1,2135,2082,1533,-549
2019,1,6,2,2144,2086,1533,-553
2019,1,6,3,2064,2014,1514,-500
2019,1,6,4,1999,1985,1462,-523
2019,1,6,5,1942,1908,1426,-482
2019,1,6,6,1866,1821,1489,-332
2019,1,6,7,1776,1712,1381,-331
2019,1,6,8,1693,1625,1356,-269
2019,1,6,9,1658,1593,1367,-226
2019,1,6,10,1642,1562,1309,-253
2019,1,6,11,1637,1557,1271,-286
2019,1,6,12,1628,1569,1138,-431
2019,1,6,13,1657,1619,1033,-586
2019,1,6,14,1712,1687,1081,-606
2019,1,6,15,1802,1772,1181,-591
2019,1,6,16,1909,1854,1303,-551
2019,1,6,17,1953,1899,1321,-578
2019,1,6,18,1944,1890,1375,-515
2019,1,6,19,1918,1844,1362,-482
2019,1,6,20,1909,1819,1460,-359
2019,1,6,21,1872,1803,1311,-492
2019,1,6,22,1846,1813,1246,-567
2019,1,6,23,1864,1840,1148,-692
2019,1,7,0,1918,1902,1114,-788
2019,1,7,1,2073,1999,1242,-757
2019,1,7,2,2123,2036,1391,-645
2019,1,7,3,2078,2007,1399,-608
2019,1,7,4,2021,1975,1418,-557
2019,1,7,5,1959,1886,1359,-527
2019,1,7,6,1854,1775,1200,-575
2019,1,7,7,1740,1650,1112,-538
2019,1,7,8,1685,1600,1033,-567
2019,1,7,9,1656,1573,1030,-543
2019,1,7,10,1623,1574,960,-614
2019,1,7,11,1635,1585,1010,-575
2019,1,7,12,1689,1616,1255,-361
2019,1,7,13,1804,1740,1448,-292
2019,1,7,14,1928,1935,1606,-329
2019,1,7,15,2074,2095,1682,-413
2019,1,7,16,2198,2116,1723,-393
2019,1,7,17,2193,2081,1715,-366
2019,1,7,18,2131,2038,1400,-638
2019,1,7,19,2069,1998,1384,-614
2019,1,7,20,2024,1931,1308,-623
2019,1,7,21,2002,1871,1249,-622
2019,1,7,22,1952,1852,1221,-631
2019,1,7,23,1938,1840,1148,-692
2019,1,8,0,1990,1885,1165,-720
2019,1,8,1,2105,2044,1255,-789
2019,1,8,2,2163,2151,1300,-851
2019,1,8,3,2159,2142,1313,-829
2019,1,8,4,2146,2114,1322,-792
2019,1,8,5,2089,2035,1152,-883
2019,1,8,6,1976,1926,1046,-880
2019,1,8,7,1869,1804,978,-826
2019,1,8,8,1818,1748,1009,-739
2019,1,8,9,1786,1733,1088,-645
2019,1,8,10,1769,1732,1120,-612
2019,1,8,11,1788,1732,1090,-642
2019,1,8,12,1825,1782,1131,-651
2019,1,8,13,1930,1889,1293,-596
2019,1,8,14,2100,2087,1486,-601
2019,1,8,15,2246,2221,1628,-593
2019,1,8,16,2282,2230,1654,-576
2019,1,8,17,2243,2174,1627,-547
2019,1,8,18,2192,2110,1562,-548
2019,1,8,19,2139,2042,1608,-434
2019,1,8,20,2079,1979,1587,-392
2019,1,8,21,2018,1967,1538,-429
2019,1,8,22,1973,1942,1523,-419
2019,1,8,23,1990,1966,1494,-472
2019,1,9,0,2045,2020,1522,-498
2019,1,9,1,2207,2123,1576,-547
2019,1,9,2,2262,2172,1583,-589
2019,1,9,3,2211,2121,1540,-581
2019,1,9,4,2151,2073,1524,-549
2019,1,9,5,2068,1981,1523,-458
2019,1,9,6,1940,1850,1505,-345
2019,1,9,7,1818,1723,1482,-241
2019,1,9,8,1782,1649,1443,-206
2019,1,9,9,1743,1621,1415,-206
2019,1,9,10,1682,1614,1410,-204
2019,1,9,11,1668,1603,1384,-219
2019,1,9,12,1683,1645,1419,-226
2019,1,9,13,1788,1750,1493,-257
2019,1,9,14,1961,1923,1581,-342
2019,1,9,15,2076,2062,1694,-368
2019,1,9,16,2090,2061,1693,-368
2019,1,9,17,2061,2044,1557,-487
2019,1,9,18,2015,2006,1532,-474
2019,1,9,19,1977,1974,1422,-552
2019,1,9,20,1964,1943,1445,-498
2019,1,9,21,1963,1905,1444,-461
2019,1,9,22,1949,1883,1343,-540
2019,1,9,23,1951,1877,1329,-548
2019,1,10,0,1996,1913,1383,-530
2019,1,10,1,2105,1982,1404,-578
2019,1,10,2,2128,2032,1413,-619
2019,1,10,3,2060,1995,1370,-625
2019,1,10,4,2006,1948,1343,-605
2019,1,10,5,1929,1870,1268,-602
2019,1,10,6,1823,1742,1156,-586
2019,1,10,7,1719,1624,1122,-502
2019,1,10,8,1707,1568,1093,-475
2019,1,10,9,1666,1534,1046,-488
2019,1,10,10,1595,1526,943,-583
2019,1,10,11,1578,1545,921,-624
2019,1,10,12,1626,1590,934,-656
2019,1,10,13,1743,1689,988,-701
2019,1,10,14,1921,1880,1155,-725
2019,1,10,15,2037,2025,1132,-893
2019,1,10,16,2074,2049,1129,-920
2019,1,10,17,2062,2005,1152,-853
2019,1,10,18,2037,1949,1091,-858
2019,1,10,19,2000,1872,1133,-739
2019,1,10,20,1926,1813,1103,-710
2019,1,10,21,1866,1760,1038,-722
2019,1,10,22,1806,1721,1018,-703
2019,1,10,23,1808,1708,1116,-592
2019,1,11,0,1852,1745,1184,-561
2019,1,11,1,1962,1858,1174,-684
2019,1,11,2,2031,1948,1245,-703
2019,1,11,3,1997,1946,1245,-701
2019,1,11,4,1967,1919,1265,-654
2019,1,11,5,1919,1863,1196,-667
2019,1,11,6,1822,1752,1173,-579
2019,1,11,7,1725,1659,1037,-622
2019,1,11,8,1728,1606,947,-659
2019,1,11,9,1671,1580,1031,-549
2019,1,11,10,1639,1588,1067,-521
2019,1,11,11,1649,1601,1075,-526
2019,1,11,12,1692,1655,1113,-542
2019,1,11,13,1828,1755,1167,-588
2019,1,11,14,2014,1946,1359,-587
2019,1,11,15,2152,2102,1422,-680
2019,1,11,16,2170,2123,1420,-703
2019,1,11,17,2147,2073,1423,-650
2019,1,11,18,2085,2009,1399,-610
2019,1,11,19,2020,1940,1339,-601
2019,1,11,20,1962,1870,1333,-537
2019,1,11,21,1901,1829,1344,-485
2019,1,11,22,1855,1779,1402,-377
2019,1,11,23,1852,1751,1449,-302
2019,1,12,0,1887,1780,1463,-317
2019,1,12,1,1982,1910,1520,-390
2019,1,12,2,2049,1985,1494,-491
2019,1,12,3,2033,1956,1364,-592
2019,1,12,4,2001,1935,1415,-520
2019,1,12,5,1961,1877,1281,-596
2019,1,12,6,1881,1797,1295,-502
2019,1,12,7,1796,1719,1332,-387
2019,1,12,8,1764,1656,1334,-322
2019,1,12,9,1714,1635,1333,-302
2019,1,12,10,1689,1632,1336,-296
2019,1,12,11,1704,1639,1339,-300
2019,1,12,12,1732,1669,1357,-312
2019,1,12,13,1811,1734,1429,-305
2019,1,12,14,1907,1825,1418,-407
2019,1,12,15,2006,1924,1353,-571
2019,1,12,16,2078,1997,1331,-666
2019,1,12,17,2109,2010,1458,-552
2019,1,12,18,2075,1994,1474,-520
2019,1,12,19,2014,1940,1499,-441
2019,1,12,20,1946,1883,1401,-482
2019,1,12,21,1885,1824,1351,-473
2019,1,12,22,1835,1776,1360,-416
2019,1,12,23,1841,1745,1331,-414
2019,1,13,0,1869,1781,1211,-570
2019,1,13,1,1977,1931,1318,-613
2019,1,13,2,2049,2020,1324,-696
2019,1,13,3,2041,2004,1346,-658
2019,1,13,4,2044,1995,1390,-605
2019,1,13,5,1998,1964,1303,-661
2019,1,13,6,1925,1889,1211,-678
2019,1,13,7,1846,1819,1202,-617
2019,1,13,8,1772,1762,1099,-663
2019,1,13,9,1744,1742,1067,-675
2019,1,13,10,1781,1741,1012,-729
2019,1,13,11,1806,1753,1001,-752
2019,1,13,12,1830,1780,995,-785
2019,1,13,13,1870,1834,1016,-818
2019,1,13,14,1963,1921,1125,-796
2019,1,13,15,2081,2013,1087,-926
2019,1,13,16,2134,2085,1157,-928
2019,1,13,17,2129,2114,1195,-919
2019,1,13,18,2092,2082,1170,-912
2019,1,13,19,2036,2048,1165,-883
2019,1,13,20,2014,1995,1144,-851
2019,1,13,21,2004,1946,1143,-803
2019,1,13,22,1975,1907,1175,-732
2019,1,13,23,1947,1889,1175,-714
2019,1,14,0,1979,1919,1113,-806
2019,1,14,1,2109,2044,1131,-913
2019,1,14,2,2186,2153,1167,-986
2019,1,14,3,2162,2149,1209,-940
2019,1,14,4,2140,2126,1230,-896
2019,1,14,5,2080,2043,1157,-886
2019,1,14,6,1965,1938,1124,-814
2019,1,14,7,1858,1823,967,-856
2019,1,14,8,1748,1778,938,-840
2019,1,14,9,1754,1764,1049,-715
2019,1,14,10,1802,1781,1074,-707
2019,1,14,11,1846,1804,1107,-697
2019,1,14,12,1913,1862,1285,-577
2019,1,14,13,2022,1980,1334,-646
2019,1,14,14,2212,2199,1572,-627
2019,1,14,15,2388,2349,1607,-742
2019,1,14,16,2425,2347,1730,-617
2019,1,14,17,2345,2279,1609,-670
2019,1,14,18,2264,2209,1607,-602
2019,1,14,19,2194,2117,1527,-590
2019,1,14,20,2128,2050,1583,-467
2019,1,14,21,2060,1996,1568,-428
2019,1,14,22,1995,1930,1511,-419
2019,1,14,23,1965,1926,1526,-400
2019,1,15,0,2007,1977,1486,-491
2019,1,15,1,2179,2112,1602,-510
2019,1,15,2,2276,2194,1734,-460
2019,1,15,3,2250,2188,1781,-407
2019,1,15,4,2215,2161,1725,-436
2019,1,15,5,2153,2065,1605,-460
2019,1,15,6,2023,1938,1543,-395
2019,1,15,7,1905,1839,1408,-431
2019,1,15,8,1824,1776,1230,-546
2019,1,15,9,1838,1767,1207,-560
2019,1,15,10,1835,1764,1236,-528
2019,1,15,11,1842,1770,1257,-513
2019,1,15,12,1889,1818,1303,-515
2019,1,15,13,2003,1936,1347,-589
2019,1,15,14,2185,2117,1460,-657
2019,1,15,15,2316,2251,1587,-664
2019,1,15,16,2326,2265,1516,-749
2019,1,15,17,2270,2233,1564,-669
2019,1,15,18,2209,2201,1540,-661
2019,1,15,19,2158,2162,1557,-605
2019,1,15,20,2092,2095,1470,-625
2019,1,15,21,2032,2046,1527,-519
2019,1,15,22,1975,2001,1480,-521
2019,1,15,23,1962,1980,1417,-563
2019,1,16,0,2011,2003,1315,-688
2019,1,16,1,2194,2087,1380,-707
2019,1,16,2,2267,2173,1425,-748
2019,1,16,3,2219,2144,1452,-692
2019,1,16,4,2166,2108,1419,-689
2019,1,16,5,2082,2022,1298,-724
2019,1,16,6,1963,1898,1261,-637
2019,1,16,7,1863,1788,1222,-566
2019,1,16,8,1830,1736,1202,-534
2019,1,16,9,1801,1721,1198,-523
2019,1,16,10,1763,1715,1211,-504
2019,1,16,11,1772,1735,1240,-495
2019,1,16,12,1814,1780,1213,-567
2019,1,16,13,1910,1883,1276,-607
2019,1,16,14,2092,2063,1470,-593
2019,1,16,15,2236,2180,1589,-591
2019,1,16,16,2228,2181,1537,-644
2019,1,16,17,2193,2162,1497,-665
2019,1,16,18,2144,2143,1391,-752
2019,1,16,19,2056,2065,1408,-657
2019,1,16,20,2000,1997,1228,-769
2019,1,16,21,1973,1962,1218,-744
2019,1,16,22,1922,1955,1175,-780
2019,1,16,23,1940,1955,1151,-804
2019,1,17,0,2005,1993,1201,-792
2019,1,17,1,2157,2075,1370,-705
2019,1,17,2,2204,2092,1542,-550
2019,1,17,3,2147,2071,1597,-474
2019,1,17,4,2042,2030,1615,-415
2019,1,17,5,1950,1937,1575,-362
2019,1,17,6,1820,1806,1409,-397
2019,1,17,7,1708,1668,1377,-291
2019,1,17,8,1634,1603,1441,-162
2019,1,17,9,1592,1560,1422,-138
2019,1,17,10,1611,1557,1469,-88
2019,1,17,11,1620,1541,1473,-68
2019,1,17,12,1651,1578,1493,-85
2019,1,17,13,1735,1674,1455,-219
2019,1,17,14,1891,1858,1376,-482
2019,1,17,15,2022,1976,1377,-599
2019,1,17,16,2037,1982,1422,-560
2019,1,17,17,2015,1958,1358,-600
2019,1,17,18,1993,1916,1318,-598
2019,1,17,19,1943,1871,1309,-562
2019,1,17,20,1871,1837,1193,-644
2019,1,17,21,1848,1839,1074,-765
2019,1,17,22,1856,1847,1156,-691
2019,1,17,23,1881,1847,1152,-695
2019,1,18,0,1949,1887,1224,-663
2019,1,18,1,2049,1957,1298,-659
2019,1,18,2,2094,2005,1404,-601
2019,1,18,3,2037,1961,1519,-442
2019,1,18,4,1990,1924,1436,-488
2019,1,18,5,1909,1837,1245,-592
2019,1,18,6,1792,1744,1050,-694
2019,1,18,7,1685,1624,1107,-517
2019,1,18,8,1648,1558,1263,-295
2019,1,18,9,1641,1536,1279,-257
2019,1,18,10,1592,1528,1155,-373
2019,1,18,11,1593,1535,1131,-404
2019,1,18,12,1641,1556,1217,-339
2019,1,18,13,1753,1657,1276,-381
2019,1,18,14,1927,1841,1351,-490
2019,1,18,15,2026,1986,1521,-465
2019,1,18,16,2054,2011,1447,-564
2019,1,18,17,2078,2011,1427,-584
2019,1,18,18,2043,1975,1272,-703
2019,1,18,19,1973,1938,1270,-668
2019,1,18,20,1926,1901,1269,-632
2019,1,18,21,1899,1864,1224,-640
2019,1,18,22,1890,1844,1167,-677
2019,1,18,23,1885,1837,1109,-728
2019,1,19,0,1926,1849,1110,-739
2019,1,19,1,1998,1913,1202,-711
2019,1,19,2,2021,1992,1202,-790
2019,1,19,3,1978,1961,1259,-702
2019,1,19,4,1956,1918,1285,-633
2019,1,19,5,1908,1856,1199,-657
2019,1,19,6,1822,1754,1236,-518
2019,1,19,7,1722,1686,1117,-569
2019,1,19,8,1689,1635,1075,-560
2019,1,19,9,1632,1613,1038,-575
2019,1,19,10,1640,1592,1048,-544
2019,1,19,11,1649,1601,1064,-537
2019,1,19,12,1656,1617,1065,-552
2019,1,19,13,1716,1670,1029,-641
2019,1,19,14,1810,1733,1114,-619
2019,1,19,15,1893,1823,1180,-643
2019,1,19,16,1936,1882,1205,-677
2019,1,19,17,1961,1926,1260,-666
2019,1,19,18,1959,1934,1266,-668
2019,1,19,19,1935,1901,1172,-729
2019,1,19,20,1908,1851,1142,-709
2019,1,19,21,1857,1790,1097,-693
2019,1,19,22,1843,1798,1042,-756
2019,1,19,23,1858,1813,1026,-787
2019,1,20,0,1879,1843,1128,-715
2019,1,20,1,1972,1896,1237,-659
2019,1,20,2,2002,1916,1298,-618
2019,1,20,3,1954,1882,1274,-608
2019,1,20,4,1902,1843,1256,-587
2019,1,20,5,1832,1776,1114,-662
2019,1,20,6,1754,1686,1115,-571
2019,1,20,7,1666,1599,1052,-547
2019,1,20,8,1608,1535,1034,-501
2019,1,20,9,1590,1488,940,-548
2019,1,20,10,1538,1483,993,-490
2019,1,20,11,1524,1471,980,-491
2019,1,20,12,1533,1491,1026,-465
2019,1,20,13,1572,1536,1044,-492
2019,1,20,14,1655,1607,1112,-495
2019,1,20,15,1734,1682,1176,-506
2019,1,20,16,1809,1780,1400,-380
2019,1,20,17,1849,1854,1438,-416
2019,1,20,18,1856,1888,1422,-466
2019,1,20,19,1844,1895,1359,-536
2019,1,20,20,1850,1861,1343,-518
2019,1,20,21,1874,1828,1317,-511
2019,1,20,22,1885,1778,1180,-598
2019,1,20,23,1863,1763,1107,-656
2019,1,21,0,1852,1797,1102,-695
2019,1,21,1,1921,1865,1155,-710
2019,1,21,2,1972,1893,1258,-635
2019,1,21,3,1941,1843,1201,-642
2019,1,21,4,1890,1830,1120,-710
2019,1,21,5,1801,1763,1164,-599
2019,1,21,6,1708,1672,1099,-573
2019,1,21,7,1623,1595,1121,-474
2019,1,21,8,1607,1551,1132,-419
2019,1,21,9,1576,1528,1117,-411
2019,1,21,10,1582,1526,1283,-243
2019,1,21,11,1594,1539,1363,-176
2019,1,21,12,1638,1593,1378,-215
2019,1,21,13,1758,1683,1408,-275
2019,1,21,14,1938,1844,1491,-353
2019,1,21,15,2058,1967,1518,-449
2019,1,21,16,2080,2043,1567,-476
2019,1,21,17,2097,2026,1576,-450
2019,1,21,18,2089,2016,1593,-423
2019,1,21,19,2042,1994,1510,-484
2019,1,21,20,1990,1948,1501,-447
2019,1,21,21,1955,1917,1530,-387
2019,1,21,22,1933,1868,1593,-275
2019,1,21,23,1932,1861,1591,-270
2019,1,22,0,1949,1893,1511,-382
2019,1,22,1,2063,2004,1553,-451
2019,1,22,2,2128,2118,1612,-506
2019,1,22,3,2102,2120,1579,-541
2019,1,22,4,2118,2076,1484,-592
2019,1,22,5,2064,1994,1432,-562
2019,1,22,6,1940,1870,1340,-530
2019,1,22,7,1836,1751,1278,-473
2019,1,22,8,1756,1701,1236,-465
2019,1,22,9,1730,1684,1221,-463
2019,1,22,10,1742,1696,1203,-493
2019,1,22,11,1757,1714,1253,-461
2019,1,22,12,1810,1787,1245,-542
2019,1,22,13,1930,1904,1201,-703
2019,1,22,14,2120,2100,1305,-795
2019,1,22,15,2282,2241,1358,-883
2019,1,22,16,2306,2241,1445,-796
2019,1,22,17,2271,2182,1394,-788
2019,1,22,18,2227,2146,1404,-742
2019,1,22,19,2155,2076,1320,-756
2019,1,22,20,2089,2027,1312,-715
2019,1,22,21,2022,1987,1220,-767
2019,1,22,22,1976,1962,1261,-701
2019,1,22,23,1988,1952,1248,-704
2019,1,23,0,2030,1955,1255,-700
2019,1,23,1,2131,2050,1309,-741
2019,1,23,2,2196,2146,1313,-833
2019,1,23,3,2167,2122,1310,-812
2019,1,23,4,2136,2086,1341,-745
2019,1,23,5,2046,1995,1320,-675
2019,1,23,6,1910,1878,1175,-703
2019,1,23,7,1794,1760,1090,-670
2019,1,23,8,1714,1692,1053,-639
2019,1,23,9,1692,1672,1062,-610
2019,1,23,10,1694,1677,1065,-612
2019,1,23,11,1715,1671,1092,-579
2019,1,23,12,1769,1718,1103,-615
2019,1,23,13,1862,1811,1088,-723
2019,1,23,14,2014,1997,1115,-882
2019,1,23,15,2150,2123,1222,-901
2019,1,23,16,2161,2128,1239,-889
2019,1,23,17,2115,2186,1190,-996
2019,1,23,18,2077,2063,1077,-986
2019,1,23,19,2044,2023,1056,-967
2019,1,23,20,2005,1972,1094,-878
2019,1,23,21,1978,1946,1094,-852
2019,1,23,22,1940,1907,1085,-822
2019,1,23,23,1930,1901,1250,-651
2019,1,24,0,1958,1890,1362,-528
2019,1,24,1,2053,1966,1551,-415
2019,1,24,2,2117,2035,1543,-492
2019,1,24,3,2067,2028,1549,-479
2019,1,24,4,2014,1988,1517,-471
2019,1,24,5,1952,1929,1443,-486
2019,1,24,6,1842,1806,1338,-468
2019,1,24,7,1751,1704,1402,-302
2019,1,24,8,1673,1641,1298,-343
2019,1,24,9,1677,1643,1265,-378
2019,1,24,10,1687,1634,1240,-394
2019,1,24,11,1703,1639,1279,-360
2019,1,24,12,1741,1676,1314,-362
2019,1,24,13,1852,1766,1332,-434
2019,1,24,14,2022,1958,1476,-482
2019,1,24,15,2147,2113,1595,-518
2019,1,24,16,2177,2108,1519,-589
2019,1,24,17,2158,2071,1374,-697
2019,1,24,18,2105,2010,1284,-726
2019,1,24,19,2033,1917,1314,-603
2019,1,24,20,1956,1837,1364,-473
2019,1,24,21,1893,1787,1447,-340
2019,1,24,22,1828,1760,1503,-257
2019,1,24,23,1808,1738,1530,-208
2019,1,25,0,1828,1774,1496,-278
2019,1,25,1,1946,1845,1426,-419
2019,1,25,2,2065,1983,1492,-491
2019,1,25,3,2026,1986,1491,-495
2019,1,25,4,1992,1962,1548,-414
2019,1,25,5,1963,1902,1598,-304
2019,1,25,6,1859,1790,1451,-339
2019,1,25,7,1754,1699,1414,-285
2019,1,25,8,1731,1650,1386,-264
2019,1,25,9,1705,1630,1329,-301
2019,1,25,10,1698,1630,1271,-359
2019,1,25,11,1683,1634,1390,-244
2019,1,25,12,1713,1683,1320,-363
2019,1,25,13,1841,1777,1285,-492
2019,1,25,14,2023,1942,1411,-531
2019,1,25,15,2153,2086,1435,-651
2019,1,25,16,2151,2127,1351,-776
2019,1,25,17,2119,2091,1401,-690
2019,1,25,18,2078,2044,1349,-695
2019,1,25,19,2008,1991,1281,-710
2019,1,25,20,1945,1908,1156,-752
2019,1,25,21,1932,1849,1224,-625
2019,1,25,22,1872,1775,1332,-443
2019,1,25,23,1833,1745,1464,-281
2019,1,26,0,1837,1747,1547,-200
2019,1,26,1,1896,1818,1632,-186
2019,1,26,2,2003,1943,1614,-329
2019,1,26,3,1981,1925,1615,-310
2019,1,26,4,1955,1911,1603,-308
2019,1,26,5,1927,1868,1524,-344
2019,1,26,6,1852,1788,1420,-368
2019,1,26,7,1779,1712,1433,-279
2019,1,26,8,1756,1655,1298,-357
2019,1,26,9,1730,1643,1150,-493
2019,1,26,10,1687,1654,1031,-623
2019,1,26,11,1690,1670,890,-780
2019,1,26,12,1732,1700,964,-736
2019,1,26,13,1806,1742,961,-781
2019,1,26,14,1896,1831,1064,-767
2019,1,26,15,1987,1933,1167,-766
2019,1,26,16,2054,2020,1186,-834
2019,1,26,17,2067,2037,1257,-780
2019,1,26,18,2032,1969,1226,-743
2019,1,26,19,1970,1890,1156,-734
2019,1,26,20,1868,1808,1114,-694
2019,1,26,21,1791,1725,1113,-612
2019,1,26,22,1730,1673,1128,-545
2019,1,26,23,1698,1654,1140,-514
2019,1,27,0,1715,1664,987,-677
2019,1,27,1,1815,1759,1130,-629
2019,1,27,2,1930,1877,1133,-744
2019,1,27,3,1928,1869,1109,-760
2019,1,27,4,1916,1849,1006,-843
2019,1,27,5,1883,1807,1003,-804
2019,1,27,6,1804,1735,994,-741
2019,1,27,7,1721,1660,964,-696
2019,1,27,8,1706,1614,983,-631
2019,1,27,9,1657,1586,910,-676
2019,1,27,10,1621,1581,911,-670
2019,1,27,11,1628,1589,924,-665
2019,1,27,12,1643,1598,942,-656
2019,1,27,13,1690,1651,984,-667
2019,1,27,14,1773,1723,1035,-688
2019,1,27,15,1873,1817,1108,-709
2019,1,27,16,1952,1914,1233,-681
2019,1,27,17,1980,1911,1322,-589
2019,1,27,18,1939,1875,1260,-615
2019,1,27,19,1872,1809,1215,-594
2019,1,27,20,1800,1751,1128,-623
2019,1,27,21,1740,1688,1131,-557
2019,1,27,22,1689,1632,1250,-382
2019,1,27,23,1667,1613,1405,-208
2019,1,28,0,1687,1630,1407,-223
2019,1,28,1,1794,1744,1530,-214
2019,1,28,2,1913,1873,1595,-278
2019,1,28,3,1913,1875,1664,-211
2019,1,28,4,1914,1860,1548,-312
2019,1,28,5,1869,1794,1475,-319
2019,1,28,6,1770,1688,1478,-210
2019,1,28,7,1676,1594,1415,-179
2019,1,28,8,1663,1566,1436,-130
2019,1,28,9,1628,1558,1355,-203
2019,1,28,10,1616,1563,1303,-260
2019,1,28,11,1639,1590,1310,-280
2019,1,28,12,1681,1663,1483,-180
2019,1,28,13,1813,1773,1417,-356
2019,1,28,14,2008,1997,1406,-591
2019,1,28,15,2162,2131,1435,-696
2019,1,28,16,2243,2134,1483,-651
2019,1,28,17,2172,2074,1492,-582
2019,1,28,18,2072,2013,1420,-593
2019,1,28,19,1990,1946,1402,-544
2019,1,28,20,1918,1874,1421,-453
2019,1,28,21,1863,1829,1401,-428
2019,1,28,22,1807,1818,1310,-508
2019,1,28,23,1803,1816,1324,-492
2019,1,29,0,1859,1843,1368,-475
2019,1,29,1,2008,1930,1331,-599
2019,1,29,2,2127,2044,1481,-563
2019,1,29,3,2122,2044,1519,-525
2019,1,29,4,2082,2016,1425,-591
2019,1,29,5,2016,1951,1402,-549
2019,1,29,6,1894,1836,1302,-534
2019,1,29,7,1794,1746,1137,-609
2019,1,29,8,1758,1699,1023,-676
2019,1,29,9,1738,1682,1068,-614
2019,1,29,10,1731,1676,1100,-576
2019,1,29,11,1751,1711,1104,-607
2019,1,29,12,1799,1764,1079,-685
2019,1,29,13,1919,1875,1202,-673
2019,1,29,14,2134,2086,1342,-744
2019,1,29,15,2289,2240,1346,-894
2019,1,29,16,2288,2212,1381,-831
2019,1,29,17,2224,2153,1353,-800
2019,1,29,18,2147,2087,1256,-831
2019,1,29,19,2077,2001,1162,-839
2019,1,29,20,2000,1914,1113,-801
2019,1,29,21,1909,1849,1167,-682
2019,1,29,22,1852,1808,1194,-614
2019,1,29,23,1836,1770,1189,-581
2019,1,30,0,1862,1789,1165,-624
2019,1,30,1,1980,1877,1161,-716
2019,1,30,2,2126,2034,1246,-788
2019,1,30,3,2105,2053,1250,-803
2019,1,30,4,2072,2047,1306,-741
2019,1,30,5,2034,1956,1207,-749
2019,1,30,6,1915,1857,1082,-775
2019,1,30,7,1820,1765,1046,-719
2019,1,30,8,1794,1721,1045,-676
2019,1,30,9,1762,1724,1027,-697
2019,1,30,10,1748,1737,1006,-731
2019,1,30,11,1786,1767,1029,-738
2019,1,30,12,1852,1810,1026,-784
2019,1,30,13,1965,1938,1178,-760
2019,1,30,14,2180,2148,1321,-827
2019,1,30,15,2351,2293,1372,-921
2019,1,30,16,2324,2271,1424,-847
2019,1,30,17,2236,2209,1456,-753
2019,1,30,18,2163,2119,1262,-857
2019,1,30,19,2083,2051,1223,-828
2019,1,30,20,2000,1975,1155,-820
2019,1,30,21,1946,1902,1140,-762
2019,1,30,22,1908,1842,1163,-679
2019,1,30,23,1880,1817,1327,-490
2019,1,31,0,1889,1851,1382,-469
2019,1,31,1,1998,1956,1366,-590
2019,1,31,2,2149,2070,1436,-634
2019,1,31,3,2144,2067,1245,-822
2019,1,31,4,2108,2061,1251,-810
2019,1,31,5,2033,1979,1155,-824
2019,1,31,6,1914,1857,1035,-822
2019,1,31,7,1824,1769,976,-793
2019,1,31,8,1794,1711,989,-722
2019,1,31,9,1776,1708,980,-728
2019,1,31,10,1749,1712,1029,-683
2019,1,31,11,1768,1729,1047,-682
2019,1,31,12,1825,1791,1126,-665
2019,1,31,13,1944,1898,1282,-616
2019,1,31,14,2155,2119,1405,-714
2019,1,31,15,2304,2249,1409,-840
2019,1,31,16,2283,2241,1466,-775
2019,1,31,17,2198,2142,1471,-671
2019,1,31,18,2131,2058,1344,-714
2019,1,31,19,2049,1757,1099,-658
2019,1,31,20,1952,1912,1297,-615
2019,1,31,21,1874,1838,1257,-581
2019,1,31,22,1828,1796,1263,-533
2019,1,31,23,1811,1753,1267,-486
2019,2,1,0,1840,1761,1233,-528
2019,2,1,1,1948,1826,1315,-511
2019,2,1,2,2094,1966,1415,-551
2019,2,1,3,2085,1991,1517,-474
2019,2,1,4,2035,1969,1411,-558
2019,2,1,5,1970,1908,1298,-610
2019,2,1,6,1847,1800,1312,-488
2019,2,1,7,1768,1711,1326,-385
2019,2,1,8,1751,1635,1329,-306
2019,2,1,9,1708,1645,1370,-275
2019,2,1,10,1696,1652,1365,-287
2019,2,1,11,1718,1674,1391,-283
2019,2,1,12,1774,1731,1412,-319
2019,2,1,13,1901,1829,1563,-266
2019,2,1,14,2103,2015,1655,-360
2019,2,1,15,2225,2148,1645,-503
2019,2,1,16,2184,2145,1682,-463
2019,2,1,17,2100,2108,1760,-348
2019,2,1,18,2020,2066,1728,-338
2019,2,1,19,1966,1979,1656,-323
2019,2,1,20,1907,1913,1665,-248
2019,2,1,21,1866,1864,1634,-230
2019,2,1,22,1828,1823,1590,-233
2019,2,1,23,1813,1790,1563,-227
2019,2,2,0,1845,1778,1653,-125
2019,2,2,1,1880,1834,1676,-158
2019,2,2,2,1968,1910,1694,-216
2019,2,2,3,1969,1898,1670,-228
2019,2,2,4,1919,1868,1608,-260
2019,2,2,5,1853,1811,1518,-293
2019,2,2,6,1756,1739,1487,-252
2019,2,2,7,1685,1653,1516,-137
2019,2,2,8,1609,1581,1452,-129
2019,2,2,9,1578,1556,1388,-168
2019,2,2,10,1586,1550,1367,-183
2019,2,2,11,1586,1548,1270,-278
2019,2,2,12,1607,1556,1210,-346
2019,2,2,13,1638,1603,1198,-405
2019,2,2,14,1717,1682,1364,-318
2019,2,2,15,1795,1755,1330,-425
2019,2,2,16,1829,1835,1320,-515
2019,2,2,17,1826,1892,1373,-519
2019,2,2,18,1839,1899,1266,-633
2019,2,2,19,1871,1878,1209,-669
2019,2,2,20,1876,1844,1191,-653
2019,2,2,21,1840,1787,1256,-531
2019,2,2,22,1822,1742,1311,-431
2019,2,2,23,1799,1735,1305,-430
2019,2,3,0,1786,1753,1416,-337
2019,2,3,1,1844,1804,1617,-187
2019,2,3,2,1912,1854,1652,-202
2019,2,3,3,1884,1826,1644,-182
2019,2,3,4,1793,1785,1642,-143
2019,2,3,5,1728,1732,1608,-124
2019,2,3,6,1646,1654,1376,-278
2019,2,3,7,1603,1583,1294,-289
2019,2,3,8,1535,1536,1277,-259
2019,2,3,9,1516,1478,1232,-246
2019,2,3,10,1548,1474,1225,-249
2019,2,3,11,1532,1477,1108,-369
2019,2,3,12,1540,1489,1106,-383
2019,2,3,13,1569,1521,1108,-413
2019,2,3,14,1651,1585,1244,-341
2019,2,3,15,1743,1680,1392,-288
2019,2,3,16,1806,1786,1429,-357
2019,2,3,17,1828,1827,1481,-346
2019,2,3,18,1847,1830,1338,-492
2019,2,3,19,1846,1798,1362,-436
2019,2,3,20,1824,1773,1459,-314
2019,2,3,21,1719,1765,1478,-287
2019,2,3,22,1694,1753,1429,-324
2019,2,3,23,1711,1738,1292,-446
2019,2,4,0,1703,1707,1162,-545
2019,2,4,1,1751,1746,1253,-493
2019,2,4,2,1854,1789,1332,-457
2019,2,4,3,1821,1796,1274,-522
2019,2,4,4,1743,1802,1239,-563
2019,2,4,5,1660,1780,1225,-555
2019,2,4,6,1609,1663,1110,-553
2019,2,4,7,1531,1559,1026,-533
2019,2,4,8,1530,1512,1040,-472
2019,2,4,9,1494,1500,1037,-463
2019,2,4,10,1513,1498,1001,-497
2019,2,4,11,1554,1502,965,-537
2019,2,4,12,1594,1537,1043,-494
2019,2,4,13,1649,1654,1145,-509
2019,2,4,14,1811,1822,1244,-578
2019,2,4,15,1913,1953,1287,-666
2019,2,4,16,1917,1968,1343,-625
2019,2,4,17,1925,1945,1408,-537
2019,2,4,18,1883,1959,1322,-637
2019,2,4,19,1811,1944,1419,-525
2019,2,4,20,1788,1938,1469,-469
2019,2,4,21,1811,1912,1456,-456
2019,2,4,22,1798,1914,1360,-554
2019,2,4,23,1769,1935,1374,-561
2019,2,5,0,1827,1915,1370,-545
2019,2,5,1,1933,1963,1359,-604
2019,2,5,2,1981,2047,1434,-613
2019,2,5,3,1940,2016,1339,-677
2019,2,5,4,1924,1976,1296,-680
2019,2,5,5,1872,1896,1286,-610
2019,2,5,6,1763,1771,1149,-622
2019,2,5,7,1676,1658,975,-683
2019,2,5,8,1616,1626,859,-767
2019,2,5,9,1601,1621,1044,-577
2019,2,5,10,1543,1617,1089,-528
2019,2,5,11,1553,1640,1017,-623
2019,2,5,12,1605,1685,1054,-631
2019,2,5,13,1727,1778,1183,-595
2019,2,5,14,1886,1974,1462,-512
2019,2,5,15,2022,2099,1546,-553
2019,2,5,16,2086,2127,1550,-577
2019,2,5,17,2038,2116,1653,-463
2019,2,5,18,2035,2060,1745,-315
2019,2,5,19,2064,2004,1826,-178
2019,2,5,20,2035,1941,1732,-209
2019,2,5,21,1968,1930,1597,-333
2019,2,5,22,1919,1901,1543,-358
2019,2,5,23,1918,1910,1506,-404
2019,2,6,0,1944,1952,1522,-430
2019,2,6,1,2032,2029,1493,-536
2019,2,6,2,2125,2119,1453,-666
2019,2,6,3,2126,2124,1567,-557
2019,2,6,4,2113,2091,1586,-505
2019,2,6,5,2044,2011,1485,-526
2019,2,6,6,1925,1887,1452,-435
2019,2,6,7,1831,1795,1236,-559
2019,2,6,8,1774,1743,1199,-544
2019,2,6,9,1720,1740,1207,-533
2019,2,6,10,1772,1740,1256,-484
2019,2,6,11,1783,1745,1263,-482
2019,2,6,12,1820,1793,1242,-551
2019,2,6,13,1937,1906,1435,-471
2019,2,6,14,2141,2099,1693,-406
2019,2,6,15,2292,2231,1934,-297
2019,2,6,16,2261,2256,1853,-403
2019,2,6,17,2260,2252,1730,-522
2019,2,6,18,2238,2240,1661,-579
2019,2,6,19,2179,2192,1737,-455
2019,2,6,20,2160,2132,1717,-415
2019,2,6,21,2154,2112,1729,-383
2019,2,6,22,2115,2071,1714,-357
2019,2,6,23,2103,2061,1734,-327
2019,2,7,0,2118,2098,1811,-287
2019,2,7,1,2197,2149,1849,-300
2019,2,7,2,2283,2290,1980,-310
2019,2,7,3,2281,2294,2020,-274
2019,2,7,4,2284,2269,1866,-403
2019,2,7,5,2211,2185,1794,-391
2019,2,7,6,2069,2077,1754,-323
2019,2,7,7,1967,1974,1641,-333
2019,2,7,8,1836,1918,1544,-374
2019,2,7,9,1867,1929,1525,-404
2019,2,7,10,1960,1934,1511,-423
2019,2,7,11,1963,1950,1527,-423
2019,2,7,12,2030,2010,1497,-513
2019,2,7,13,2163,2121,1796,-325
2019,2,7,14,2369,2309,1952,-357
2019,2,7,15,2537,2438,2050,-388
2019,2,7,16,2496,2428,1974,-454
2019,2,7,17,2448,2384,1975,-409
2019,2,7,18,2389,2317,1869,-448
2019,2,7,19,2297,2260,1734,-526
2019,2,7,20,2221,2181,1578,-603
2019,2,7,21,2185,2134,1435,-699
2019,2,7,22,2136,2086,1424,-662
2019,2,7,23,2113,2044,1526,-518
2019,2,8,0,2114,2057,1534,-523
2019,2,8,1,2190,2102,1580,-522
2019,2,8,2,2322,2245,1750,-495
2019,2,8,3,2292,2267,1734,-533
2019,2,8,4,2250,2256,1657,-599
2019,2,8,5,2193,2202,1662,-540
2019,2,8,6,2083,2084,1602,-482
2019,2,8,7,1989,2007,1405,-602
2019,2,8,8,1880,1949,1265,-684
2019,2,8,9,1917,1939,1294,-645
2019,2,8,10,1956,1944,1343,-601
2019,2,8,11,1964,1955,1368,-587
2019,2,8,12,2028,1990,1378,-612
2019,2,8,13,2113,2095,1564,-531
2019,2,8,14,2292,2256,1652,-604
2019,2,8,15,2434,2391,1676,-715
2019,2,8,16,2396,2400,1680,-720
2019,2,8,17,2348,2382,1682,-700
2019,2,8,18,2319,2328,1747,-581
2019,2,8,19,2264,2270,1762,-508
2019,2,8,20,2197,2211,1632,-579
2019,2,8,21,2152,2124,1503,-621
2019,2,8,22,2108,2083,1418,-665
2019,2,8,23,2062,2079,1401,-678
2019,2,9,0,2069,2100,1356,-744
2019,2,9,1,2140,2156,1512,-644
2019,2,9,2,2224,2222,1617,-605
2019,2,9,3,2247,2195,1609,-586
2019,2,9,4,2193,2151,1639,-512
2019,2,9,5,2130,2101,1625,-476
2019,2,9,6,2016,2022,1475,-547
2019,2,9,7,1923,1920,1367,-553
2019,2,9,8,1812,1848,1315,-533
2019,2,9,9,1802,1819,1324,-495
2019,2,9,10,1838,1817,1330,-487
2019,2,9,11,1844,1803,1369,-434
2019,2,9,12,1870,1831,1435,-396
2019,2,9,13,1893,1868,1439,-429
2019,2,9,14,1970,1945,1474,-471
2019,2,9,15,2062,2040,1467,-573
2019,2,9,16,2119,2123,1417,-706
2019,2,9,17,2135,2179,1443,-736
2019,2,9,18,2145,2209,1485,-724
2019,2,9,19,2140,2181,1561,-620
2019,2,9,20,2122,2134,1585,-549
2019,2,9,21,2066,2083,1672,-411
2019,2,9,22,2031,2027,1626,-401
2019,2,9,23,2031,2028,1606,-422
2019,2,10,0,2050,1996,1544,-452
2019,2,10,1,2075,2057,1708,-349
2019,2,10,2,2104,2111,1749,-362
2019,2,10,3,2088,2080,1796,-284
2019,2,10,4,2070,2047,1637,-410
2019,2,10,5,2014,1981,1606,-375
2019,2,10,6,1921,1891,1585,-306
2019,2,10,7,1821,1795,1392,-403
2019,2,10,8,1707,1747,1379,-368
2019,2,10,9,1680,1734,1374,-360
2019,2,10,10,1744,1739,1353,-386
2019,2,10,11,1774,1762,1253,-509
2019,2,10,12,1803,1805,1243,-562
2019,2,10,13,1860,1825,1260,-565
2019,2,10,14,1923,1889,1264,-625
2019,2,10,15,2043,1968,1364,-604
2019,2,10,16,2112,2078,1374,-704
2019,2,10,17,2120,2114,1408,-706
2019,2,10,18,2140,2060,1413,-647
2019,2,10,19,2112,2043,1255,-788
2019,2,10,20,2038,2009,1178,-831
2019,2,10,21,2032,1981,1249,-732
2019,2,10,22,1989,1972,1276,-696
2019,2,10,23,1972,1955,1316,-639
2019,2,11,0,2024,1972,1406,-566
2019,2,11,1,2096,2070,1345,-725
2019,2,11,2,2192,2136,1439,-697
2019,2,11,3,2205,2177,1413,-764
2019,2,11,4,2189,2147,1388,-759
2019,2,11,5,2146,2090,1274,-816
2019,2,11,6,2031,1968,1258,-710
2019,2,11,7,1935,1866,1151,-715
2019,2,11,8,1858,1817,1198,-619
2019,2,11,9,1862,1800,1241,-559
2019,2,11,10,1838,1814,1243,-571
2019,2,11,11,1839,1826,1216,-610
2019,2,11,12,1891,1865,1238,-627
2019,2,11,13,2008,1986,1333,-653
2019,2,11,14,2157,2154,1432,-722
2019,2,11,15,2291,2297,1615,-682
2019,2,11,16,2343,2301,1582,-719
2019,2,11,17,2294,2301,1464,-837
2019,2,11,18,2227,2294,1384,-910
2019,2,11,19,2213,2236,1419,-817
2019,2,11,20,2202,2215,1431,-784
2019,2,11,21,2157,2205,1499,-706
2019,2,11,22,2163,2213,1598,-615
2019,2,11,23,2184,2210,1448,-762
2019,2,12,0,2230,2215,1374,-841
2019,2,12,1,2266,2211,1401,-810
2019,2,12,2,2324,2193,1614,-579
2019,2,12,3,2295,2217,1684,-533
2019,2,12,4,2186,2171,1463,-708
2019,2,12,5,2106,2076,1293,-783
2019,2,12,6,1974,1944,1245,-699
2019,2,12,7,1870,1842,1251,-591
2019,2,12,8,1802,1780,1266,-514
2019,2,12,9,1809,1773,1301,-472
2019,2,12,10,1822,1767,1329,-438
2019,2,12,11,1830,1787,1343,-444
2019,2,12,12,1871,1834,1424,-410
2019,2,12,13,1963,1953,1580,-373
2019,2,12,14,2142,2133,1714,-419
2019,2,12,15,2288,2260,1816,-444
2019,2,12,16,2281,2246,1841,-405
2019,2,12,17,2251,2248,1791,-457
2019,2,12,18,2203,2244,1705,-539
2019,2,12,19,2174,2210,1668,-542
2019,2,12,20,2160,2145,1642,-503
2019,2,12,21,2142,2092,1686,-406
2019,2,12,22,2127,2063,1665,-398
2019,2,12,23,2088,2061,1654,-407
2019,2,13,0,2092,2083,1597,-486
2019,2,13,1,2139,2103,1669,-434
2019,2,13,2,2181,2183,1792,-391
2019,2,13,3,2187,2153,1685,-468
2019,2,13,4,2160,2114,1437,-677
2019,2,13,5,2053,2017,1270,-747
2019,2,13,6,1928,1890,1307,-583
2019,2,13,7,1821,1798,1184,-614
2019,2,13,8,1752,1755,1131,-624
2019,2,13,9,1740,1712,1149,-563
2019,2,13,10,1766,1702,1198,-504
2019,2,13,11,1754,1712,1277,-435
2019,2,13,12,1788,1766,1284,-482
2019,2,13,13,1884,1866,1316,-550
2019,2,13,14,2055,2038,1503,-535
2019,2,13,15,2188,2168,1508,-660
2019,2,13,16,2172,2183,1491,-692
2019,2,13,17,2154,2207,1387,-820
2019,2,13,18,2160,2220,1398,-822
2019,2,13,19,2157,2203,1340,-863
2019,2,13,20,2165,2182,1332,-850
2019,2,13,21,2170,2129,1446,-683
2019,2,13,22,2176,2115,1453,-662
2019,2,13,23,2165,2110,1479,-631
2019,2,14,0,2164,2112,1478,-634
2019,2,14,1,2165,2140,1472,-668
2019,2,14,2,2186,2172,1470,-702
2019,2,14,3,2200,2141,1454,-687
2019,2,14,4,2158,2098,1446,-652
2019,2,14,5,2025,2004,1445,-559
2019,2,14,6,1893,1883,1324,-559
2019,2,14,7,1788,1751,1239,-512
2019,2,14,8,1704,1674,1243,-431
2019,2,14,9,1709,1655,1234,-421
2019,2,14,10,1658,1644,1243,-401
2019,2,14,11,1683,1644,1279,-365
2019,2,14,12,1728,1690,1288,-402
2019,2,14,13,1822,1786,1369,-417
2019,2,14,14,1988,1940,1719,-221
2019,2,14,15,2100,2057,1876,-181
2019,2,14,16,2088,2079,1814,-265
2019,2,14,17,2076,2048,1833,-215
2019,2,14,18,2080,2050,1786,-264
2019,2,14,19,2064,2012,1754,-258
2019,2,14,20,2032,1982,1646,-336
2019,2,14,21,1997,1940,1626,-314
2019,2,14,22,1964,1919,1558,-361
2019,2,14,23,1933,1922,1539,-383
2019,2,15,0,1943,1948,1536,-412
2019,2,15,1,2019,1999,1615,-384
2019,2,15,2,2076,2027,1457,-570
2019,2,15,3,2092,2004,1472,-532
2019,2,15,4,2041,1954,1409,-545
2019,2,15,5,1956,1908,1247,-661
2019,2,15,6,1834,1792,1176,-616
2019,2,15,7,1740,1707,1091,-616
2019,2,15,8,1705,1658,1125,-533
2019,2,15,9,1696,1622,1250,-372
2019,2,15,10,1675,1623,1256,-367
2019,2,15,11,1689,1627,1115,-512
2019,2,15,12,1731,1671,1120,-551
2019,2,15,13,1839,1767,1284,-483
2019,2,15,14,2008,1927,1443,-484
2019,2,15,15,2132,2043,1481,-562
2019,2,15,16,2141,2083,1501,-582
2019,2,15,17,2151,2102,1402,-700
2019,2,15,18,2165,2069,1522,-547
2019,2,15,19,2139,2043,1486,-557
2019,2,15,20,2068,2027,1448,-579
2019,2,15,21,2040,2019,1398,-621
2019,2,15,22,2040,2003,1458,-545
2019,2,15,23,2042,1949,1590,-359
2019,2,16,0,2072,1938,1640,-298
2019,2,16,1,2052,1956,1591,-365
2019,2,16,2,2114,2058,1453,-605
2019,2,16,3,2088,2053,1392,-661
2019,2,16,4,2059,2032,1389,-643
2019,2,16,5,2022,1971,1420,-551
2019,2,16,6,1947,1896,1368,-528
2019,2,16,7,1866,1833,1246,-587
2019,2,16,8,1842,1788,1229,-559
2019,2,16,9,1793,1734,1212,-522
2019,2,16,10,1773,1747,1138,-609
2019,2,16,11,1783,1754,1172,-582
2019,2,16,12,1826,1783,1213,-570
2019,2,16,13,1884,1817,1223,-594
2019,2,16,14,1950,1882,1271,-611
2019,2,16,15,2044,1981,1244,-737
2019,2,16,16,2146,2060,1179,-881
2019,2,16,17,2191,2093,1333,-760
2019,2,16,18,2193,2067,1373,-694
2019,2,16,19,2156,2026,1297,-729
2019,2,16,20,2051,1965,1272,-693
2019,2,16,21,1968,1903,1193,-710
2019,2,16,22,1891,1877,1174,-703
2019,2,16,23,1860,1862,1124,-738
2019,2,17,0,1875,1891,1120,-771
2019,2,17,1,1970,1950,1066,-884
2019,2,17,2,2083,2040,1280,-760
2019,2,17,3,2075,2050,1307,-743
2019,2,17,4,2054,2029,1274,-755
2019,2,17,5,2028,1964,1250,-714
2019,2,17,6,1956,1891,1125,-766
2019,2,17,7,1870,1815,1012,-803
2019,2,17,8,1842,1744,910,-834
2019,2,17,9,1795,1724,1081,-643
2019,2,17,10,1746,1716,1128,-588
2019,2,17,11,1763,1713,1150,-563
2019,2,17,12,1794,1746,1137,-609
2019,2,17,13,1840,1778,1143,-635
2019,2,17,14,1901,1830,1182,-648
2019,2,17,15,1989,1907,1219,-688
2019,2,17,16,2088,1992,1237,-755
2019,2,17,17,2136,2016,1366,-650
2019,2,17,18,2092,1996,1404,-592
2019,2,17,19,2030,1964,1308,-656
2019,2,17,20,1916,1935,1310,-625
2019,2,17,21,1886,1884,1236,-648
2019,2,17,22,1893,1855,1252,-603
2019,2,17,23,1850,1847,1241,-606
2019,2,18,0,1859,1876,1248,-628
2019,2,18,1,1975,1903,1300,-603
2019,2,18,2,2102,2002,1226,-776
2019,2,18,3,2084,2048,1235,-813
2019,2,18,4,2075,2026,1250,-776
2019,2,18,5,2030,1973,1104,-869
2019,2,18,6,1930,1911,1108,-803
2019,2,18,7,1867,1830,1000,-830
2019,2,18,8,1860,1786,996,-790
2019,2,18,9,1816,1785,1178,-607
2019,2,18,10,1819,1801,1186,-615
2019,2,18,11,1843,1796,1245,-551
2019,2,18,12,1902,1858,1333,-525
2019,2,18,13,2035,1928,1452,-476
2019,2,18,14,2194,2043,1473,-570
2019,2,18,15,2310,2160,1546,-614
2019,2,18,16,2309,2208,1602,-606
2019,2,18,17,2288,2212,1780,-432
2019,2,18,18,2210,2205,1853,-352
2019,2,18,19,2146,2184,1781,-403
2019,2,18,20,2091,2148,1681,-467
2019,2,18,21,2084,2117,1652,-465
2019,2,18,22,2080,2097,1632,-465
2019,2,18,23,2078,2052,1698,-354
2019,2,19,0,2126,2068,1701,-367
2019,2,19,1,2183,2126,1643,-483
2019,2,19,2,2292,2217,1710,-507
2019,2,19,3,2304,2230,1719,-511
2019,2,19,4,2254,2180,1720,-460
2019,2,19,5,2186,2107,1600,-507
2019,2,19,6,2061,1984,1453,-531
2019,2,19,7,1967,1882,1567,-315
2019,2,19,8,1944,1825,1384,-441
2019,2,19,9,1897,1817,1397,-420
2019,2,19,10,1860,1817,1302,-515
2019,2,19,11,1884,1834,1280,-554
2019,2,19,12,1934,1884,1283,-601
2019,2,19,13,2051,1989,1330,-659
2019,2,19,14,2230,2180,1450,-730
2019,2,19,15,2367,2318,1579,-739
2019,2,19,16,2364,2319,1644,-675
2019,2,19,17,2322,2265,1587,-678
2019,2,19,18,2284,2193,1525,-668
2019,2,19,19,2255,2104,1582,-522
2019,2,19,20,2178,2066,1651,-415
2019,2,19,21,2085,2041,1600,-441
2019,2,19,22,2074,2034,1413,-621
2019,2,19,23,2064,2031,1359,-672
2019,2,20,0,2070,2075,1464,-611
2019,2,20,1,2163,2145,1486,-659
2019,2,20,2,2288,2225,1574,-651
2019,2,20,3,2298,2218,1532,-686
2019,2,20,4,2227,2175,1511,-664
2019,2,20,5,2133,2102,1479,-623
2019,2,20,6,2016,1980,1283,-697
2019,2,20,7,1917,1864,1095,-769
2019,2,20,8,1864,1806,1097,-709
2019,2,20,9,1818,1792,1137,-655
2019,2,20,10,1830,1790,1146,-644
2019,2,20,11,1845,1793,1110,-683
2019,2,20,12,1897,1829,1151,-678
2019,2,20,13,1980,1929,1292,-637
2019,2,20,14,2134,2103,1392,-711
2019,2,20,15,2274,2207,1536,-671
2019,2,20,16,2260,2193,1506,-687
2019,2,20,17,2213,2184,1558,-626
2019,2,20,18,2169,2138,1503,-635
2019,2,20,19,2131,2108,1531,-577
2019,2,20,20,2104,2035,1483,-552
2019,2,20,21,2078,1994,1510,-484
2019,2,20,22,2054,1941,1540,-401
2019,2,20,23,2022,1929,1564,-365
2019,2,21,0,2015,1935,1516,-419
2019,2,21,1,2069,1994,1495,-499
2019,2,21,2,2198,2115,1585,-530
2019,2,21,3,2214,2136,1605,-531
2019,2,21,4,2162,2117,1611,-506
2019,2,21,5,2100,2036,1551,-485
2019,2,21,6,2006,1904,1344,-560
2019,2,21,7,1914,1816,1234,-582
2019,2,21,8,1879,1757,1183,-574
2019,2,21,9,1864,1744,1349,-395
2019,2,21,10,1813,1752,1473,-279
2019,2,21,11,1830,1781,1568,-213
2019,2,21,12,1885,1821,1552,-269
2019,2,21,13,1996,1939,1542,-397
2019,2,21,14,2183,2140,1706,-434
2019,2,21,15,2304,2281,1810,-471
2019,2,21,16,2299,2261,1814,-447
2019,2,21,17,2285,2212,1871,-341
2019,2,21,18,2247,2167,1777,-390
2019,2,21,19,2192,2109,1779,-330
2019,2,21,20,2127,2055,1788,-267
2019,2,21,21,2080,2003,1780,-223
2019,2,21,22,2044,1959,1771,-188
2019,2,21,23,2007,1928,1777,-151
2019,2,22,0,2004,1933,1801,-132
2019,2,22,1,2064,1991,1780,-211
2019,2,22,2,2206,2120,1705,-415
2019,2,22,3,2234,2189,1712,-477
2019,2,22,4,2205,2182,1724,-458
2019,2,22,5,2154,2118,1632,-486
2019,2,22,6,2055,2010,1518,-492
2019,2,22,7,1972,1920,1320,-600
2019,2,22,8,1944,1876,1305,-571
2019,2,22,9,1896,1864,1305,-559
2019,2,22,10,1932,1878,1302,-576
2019,2,22,11,1954,1898,1300,-598
2019,2,22,12,2006,1957,1427,-530
2019,2,22,13,2128,2064,1427,-637
2019,2,22,14,2309,2272,1604,-668
2019,2,22,15,2455,2395,1539,-856
2019,2,22,16,2426,2371,1581,-790
2019,2,22,17,2352,2306,1684,-622
2019,2,22,18,2290,2212,1719,-493
2019,2,22,19,2222,2136,1711,-425
2019,2,22,20,2143,2038,1750,-288
2019,2,22,21,2059,1966,1713,-253
2019,2,22,22,2002,1930,1687,-243
2019,2,22,23,1960,1893,1706,-187
2019,2,23,0,1966,1910,1540,-370
2019,2,23,1,2018,1963,1551,-412
2019,2,23,2,2143,2087,1557,-530
2019,2,23,3,2187,2134,1581,-553
2019,2,23,4,2161,2110,1525,-585
2019,2,23,5,2120,2058,1549,-509
2019,2,23,6,2031,1956,1525,-431
2019,2,23,7,1946,1861,1430,-431
2019,2,23,8,1877,1804,1397,-407
2019,2,23,9,1845,1770,1403,-367
2019,2,23,10,1752,1768,1405,-363
2019,2,23,11,1833,1747,1384,-363
2019,2,23,12,1845,1777,1378,-399
2019,2,23,13,1880,1815,1402,-413
2019,2,23,14,1966,1903,1405,-498
2019,2,23,15,2039,1991,1513,-478
2019,2,23,16,2103,2061,1540,-521
2019,2,23,17,2125,2083,1600,-483
2019,2,23,18,2098,2049,1613,-436
2019,2,23,19,2054,2002,1607,-395
2019,2,23,20,1996,1937,1623,-314
2019,2,23,21,1943,1883,1644,-239
2019,2,23,22,1900,1837,1704,-133
2019,2,23,23,1875,1820,1606,-214
2019,2,24,0,1885,1866,1517,-349
2019,2,24,1,1966,1919,1542,-377
2019,2,24,2,2058,1998,1526,-472
2019,2,24,3,2079,2008,1535,-473
2019,2,24,4,2046,1968,1517,-451
2019,2,24,5,1996,1921,1402,-519
2019,2,24,6,1871,1844,1400,-444
2019,2,24,7,1806,1746,1391,-355
2019,2,24,8,1763,1679,1367,-312
2019,2,24,9,1731,1659,1371,-288
2019,2,24,10,1724,1635,1348,-287
2019,2,24,11,1704,1649,1364,-285
2019,2,24,12,1698,1676,1448,-228
2019,2,24,13,1754,1708,1466,-242
2019,2,24,14,1829,1780,1433,-347
2019,2,24,15,1900,1871,1581,-290
2019,2,24,16,1965,1950,1625,-325
2019,2,24,17,1985,1985,1627,-358
2019,2,24,18,1953,1997,1635,-362
2019,2,24,19,1924,1981,1678,-303
2019,2,24,20,1944,1953,1687,-266
2019,2,24,21,1954,1923,1709,-214
2019,2,24,22,1913,1917,1662,-255
2019,2,24,23,1902,1895,1543,-352
2019,2,25,0,1955,1927,1541,-386
2019,2,25,1,2010,1965,1650,-315
2019,2,25,2,2055,2026,1683,-343
2019,2,25,3,2059,2006,1720,-286
2019,2,25,4,2026,1974,1764,-210
2019,2,25,5,1946,1887,1704,-183
2019,2,25,6,1803,1774,1659,-115
2019,2,25,7,1724,1679,1674,-5
2019,2,25,8,1637,1616,1621,5
2019,2,25,9,1642,1592,1562,-30
2019,2,25,10,1669,1591,1534,-57
2019,2,25,11,1658,1597,1467,-130
2019,2,25,12,1697,1651,1444,-207
2019,2,25,13,1792,1732,1535,-197
2019,2,25,14,1942,1927,1569,-358
2019,2,25,15,2049,2055,1695,-360
2019,2,25,16,2120,2061,1684,-377
2019,2,25,17,2084,2066,1638,-428
2019,2,25,18,2042,2043,1648,-395
2019,2,25,19,2027,2045,1653,-392
2019,2,25,20,2005,2041,1627,-414
2019,2,25,21,2030,2011,1571,-440
2019,2,25,22,2023,1985,1592,-393
2019,2,25,23,2012,1984,1593,-391
2019,2,26,0,2036,1968,1540,-428
2019,2,26,1,2096,1998,1557,-441
2019,2,26,2,2140,2029,1718,-311
2019,2,26,3,2131,2015,1735,-280
2019,2,26,4,2068,1953,1764,-189
2019,2,26,5,1982,1875,1743,-132
2019,2,26,6,1848,1746,1700,-46
2019,2,26,7,1738,1637,1643,6
2019,2,26,8,1652,1573,1781,208
2019,2,26,9,1653,1556,1780,224
2019,2,26,10,1658,1553,1702,149
2019,2,26,11,1675,1581,1680,99
2019,2,26,12,1724,1622,1719,97
2019,2,26,13,1828,1744,1777,33
2019,2,26,14,1978,1942,1917,-25
2019,2,26,15,2115,2081,1892,-189
2019,2,26,16,2104,2112,1903,-209
2019,2,26,17,2101,2099,1918,-181
2019,2,26,18,2119,2110,1868,-242
2019,2,26,19,2132,2081,1770,-311
2019,2,26,20,2110,2040,1778,-262
2019,2,26,21,2067,1984,1772,-212
2019,2,26,22,2045,1963,1784,-179
2019,2,26,23,2002,1947,1515,-432
2019,2,27,0,2005,2003,1403,-600
2019,2,27,1,2075,2079,1383,-696
2019,2,27,2,2152,2130,1560,-570
2019,2,27,3,2164,2150,1614,-536
2019,2,27,4,2114,2103,1638,-465
2019,2,27,5,2040,1995,1618,-377
2019,2,27,6,1906,1874,1604,-270
2019,2,27,7,1784,1759,1609,-150
2019,2,27,8,1709,1684,1595,-89
2019,2,27,9,1690,1641,1610,-31
2019,2,27,10,1698,1638,1591,-47
2019,2,27,11,1682,1646,1624,-22
2019,2,27,12,1728,1684,1658,-26
2019,2,27,13,1810,1795,1660,-135
2019,2,27,14,2011,1967,1756,-211
2019,2,27,15,2147,2075,1784,-291
2019,2,27,16,2119,2086,1767,-319
2019,2,27,17,2088,2081,1755,-326
2019,2,27,18,2104,2088,1754,-334
2019,2,27,19,2092,2001,1760,-241
2019,2,27,20,2043,1932,1766,-166
2019,2,27,21,1943,1879,1784,-95
2019,2,27,22,1910,1838,1783,-55
2019,2,27,23,1898,1830,1671,-159
2019,2,28,0,1909,1850,1620,-230
2019,2,28,1,1971,1866,1530,-336
2019,2,28,2,2045,1935,1766,-169
2019,2,28,3,2040,1966,1861,-105
2019,2,28,4,1976,1930,1805,-125
2019,2,28,5,1902,1852,1861,9
2019,2,28,6,1794,1727,1894,167
2019,2,28,7,1698,1636,1904,268
2019,2,28,8,1666,1563,1896,333
2019,2,28,9,1631,1539,1886,347
2019,2,28,10,1601,1539,1847,308
2019,2,28,11,1591,1547,1823,276
2019,2,28,12,1640,1593,1841,248
2019,2,28,13,1755,1713,1893,180
2019,2,28,14,1949,1882,1941,59
2019,2,28,15,2068,2005,1900,-105
2019,2,28,16,2077,2000,1901,-99
2019,2,28,17,2083,1997,1876,-121
2019,2,28,18,2061,1970,1867,-103
2019,2,28,19,2014,1908,1958,50
2019,2,28,20,1941,1836,2167,331
2019,2,28,21,1866,1791,2107,316
2019,2,28,22,1814,1768,2185,417
2019,2,28,23,1826,1765,2196,431
2019,3,1,0,1849,1771,2200,429
2019,3,1,1,1917,1830,2139,309
2019,3,1,2,2000,1927,2070,143
2019,3,1,3,2025,2006,2061,55
2019,3,1,4,1995,2003,1984,-19
2019,3,1,5,1968,1944,2053,109
2019,3,1,6,1871,1854,1975,121
2019,3,1,7,1788,1761,1944,183
2019,3,1,8,1748,1765,1952,187
2019,3,1,9,1708,1712,1881,169
2019,3,1,10,1769,1708,1870,162
2019,3,1,11,1795,1721,1866,145
2019,3,1,12,1834,1776,1810,34
2019,3,1,13,1962,1878,1755,-123
2019,3,1,14,2149,2075,1760,-315
2019,3,1,15,2271,2201,1792,-409
2019,3,1,16,2243,2195,1931,-264
2019,3,1,17,2207,2124,1987,-137
2019,3,1,18,2162,2042,2024,-18
2019,3,1,19,2075,1969,2039,70
2019,3,1,20,1953,1880,2066,186
2019,3,1,21,1888,1819,2037,218
2019,3,1,22,1836,1800,2010,210
2019,3,1,23,1823,1793,1892,99
2019,3,2,0,1864,1808,1859,51
2019,3,2,1,1892,1842,1756,-86
2019,3,2,2,1978,1929,1716,-213
2019,3,2,3,2028,1971,1764,-207
2019,3,2,4,2006,1934,1779,-155
2019,3,2,5,1970,1896,1798,-98
2019,3,2,6,1868,1832,1803,-29
2019,3,2,7,1813,1754,1807,53
2019,3,2,8,1751,1711,1811,100
2019,3,2,9,1762,1684,1731,47
2019,3,2,10,1764,1676,1688,12
2019,3,2,11,1760,1694,1678,-16
2019,3,2,12,1771,1726,1658,-68
2019,3,2,13,1850,1808,1714,-94
2019,3,2,14,1955,1906,1742,-164
2019,3,2,15,2058,1999,1751,-248
2019,3,2,16,2129,2020,1891,-129
2019,3,2,17,2152,1999,2045,46
2019,3,2,18,2092,1937,2031,94
2019,3,2,19,1977,1867,1992,125
2019,3,2,20,1856,1811,1954,143
2019,3,2,21,1780,1737,1925,188
2019,3,2,22,1753,1715,1919,204
2019,3,2,23,1740,1672,1883,211
2019,3,3,0,1767,1689,1968,279
2019,3,3,1,1840,1725,1847,122
2019,3,3,2,1926,1806,1754,-52
2019,3,3,3,1961,1912,1743,-169
2019,3,3,4,1941,1891,1758,-133
2019,3,3,5,1947,1864,1759,-105
2019,3,3,6,1899,1802,1768,-34
2019,3,3,7,1810,1729,1749,20
2019,3,3,8,1790,1680,1729,49
2019,3,3,9,1750,1671,1741,70
2019,3,3,10,1717,1672,1729,57
2019,3,3,11,1737,1686,1743,57
2019,3,3,12,1767,1715,1781,66
2019,3,3,13,1827,1759,1805,46
2019,3,3,14,1918,1848,1810,-38
2019,3,3,15,1994,1948,1817,-131
2019,3,3,16,2063,2005,1907,-98
2019,3,3,17,2080,1994,2034,40
2019,3,3,18,2030,1924,2031,107
2019,3,3,19,1948,1843,2027,184
2019,3,3,20,1863,1785,2021,236
2019,3,3,21,1779,1732,2022,290
2019,3,3,22,1745,1691,2024,333
2019,3,3,23,1733,1663,2046,383
2019,3,4,0,1743,1678,2006,328
2019,3,4,1,1805,1718,1879,161
2019,3,4,2,1919,1830,1855,25
2019,3,4,3,1978,1938,1896,-42
2019,3,4,4,1966,1956,1908,-48
2019,3,4,5,1932,1885,1940,55
2019,3,4,6,1862,1785,1942,157
2019,3,4,7,1773,1685,1872,187
2019,3,4,8,1754,1639,1904,265
2019,3,4,9,1700,1631,1879,248
2019,3,4,10,1687,1630,1878,248
2019,3,4,11,1707,1657,1851,194
2019,3,4,12,1762,1710,1895,185
2019,3,4,13,1894,1824,1946,122
2019,3,4,14,2077,2042,1996,-46
2019,3,4,15,2208,2161,1951,-210
2019,3,4,16,2243,2140,2061,-79
2019,3,4,17,2172,2070,2225,155
2019,3,4,18,2074,1993,2320,327
2019,3,4,19,1969,1914,2277,363
2019,3,4,20,1872,1865,2315,450
2019,3,4,21,1844,1822,2272,450
2019,3,4,22,1823,1782,2265,483
2019,3,4,23,1814,1746,2233,487
2019,3,5,0,1819,1749,2260,511
2019,3,5,1,1882,1790,2168,378
2019,3,5,2,1990,1878,2035,157
2019,3,5,3,2047,1954,2034,80
2019,3,5,4,2013,1942,2059,117
2019,3,5,5,1953,1886,2052,166
2019,3,5,6,1846,1768,2059,291
2019,3,5,7,1744,1669,1991,322
2019,3,5,8,1729,1616,1983,367
2019,3,5,9,1698,1601,2031,430
2019,3,5,10,1675,1606,2074,468
2019,3,5,11,1686,1617,2056,439
2019,3,5,12,1730,1675,2077,402
2019,3,5,13,1869,1791,2090,299
2019,3,5,14,2073,1990,2177,187
2019,3,5,15,2191,2123,2096,-27
2019,3,5,16,2143,2117,2025,-92
2019,3,5,17,2081,2077,2060,-17
2019,3,5,18,2021,2018,2155,137
2019,3,5,19,1967,1967,2236,269
2019,3,5,20,1915,1872,2223,351
2019,3,5,21,1894,1844,2284,440
2019,3,5,22,1836,1816,2206,390
2019,3,5,23,1838,1830,2128,298
2019,3,6,0,1859,1836,2031,195
2019,3,6,1,1919,1890,1983,93
2019,3,6,2,1998,1946,1923,-23
2019,3,6,3,2046,1969,1927,-42
2019,3,6,4,2011,1944,1929,-15
2019,3,6,5,1916,1854,1851,-3
2019,3,6,6,1794,1741,1799,58
2019,3,6,7,1686,1624,1811,187
2019,3,6,8,1631,1575,1825,250
2019,3,6,9,1593,1529,1778,249
2019,3,6,10,1591,1532,1770,238
2019,3,6,11,1595,1528,1766,238
2019,3,6,12,1631,1562,1807,245
2019,3,6,13,1720,1663,1820,157
2019,3,6,14,1905,1843,1931,88
2019,3,6,15,2019,1975,1925,-50
2019,3,6,16,1996,1966,1910,-56
2019,3,6,17,1949,1949,1898,-51
2019,3,6,18,1909,1913,1923,10
2019,3,6,19,1866,1852,1955,103
2019,3,6,20,1840,1815,1891,76
2019,3,6,21,1805,1810,1807,-3
2019,3,6,22,1823,1789,1681,-108
2019,3,6,23,1823,1780,1577,-203
2019,3,7,0,1843,1787,1630,-157
2019,3,7,1,1885,1801,1678,-123
2019,3,7,2,1936,1849,1676,-173
2019,3,7,3,1963,1879,1757,-122
2019,3,7,4,1918,1858,1784,-74
2019,3,7,5,1824,1778,1778,0
2019,3,7,6,1712,1655,1763,108
2019,3,7,7,1614,1550,1683,133
2019,3,7,8,1573,1480,1586,106
2019,3,7,9,1531,1455,1565,110
2019,3,7,10,1517,1441,1651,210
2019,3,7,11,1521,1449,1686,237
2019,3,7,12,1545,1482,1637,155
2019,3,7,13,1652,1590,1691,101
2019,3,7,14,1840,1780,1744,-36
2019,3,7,15,1958,1914,1771,-143
2019,3,7,16,1949,1913,1800,-113
2019,3,7,17,1926,1899,1802,-97
2019,3,7,18,1908,1860,1865,5
2019,3,7,19,1878,1818,1940,122
2019,3,7,20,1845,1768,1934,166
2019,3,7,21,1831,1725,1862,137
2019,3,7,22,1794,1707,1803,96
2019,3,7,23,1759,1686,1796,110
2019,3,8,0,1766,1706,1789,83
2019,3,8,1,1805,1736,1657,-79
2019,3,8,2,1897,1796,1606,-190
2019,3,8,3,1944,1869,1625,-244
2019,3,8,4,1917,1861,1608,-253
2019,3,8,5,1862,1792,1557,-235
2019,3,8,6,1759,1685,1499,-186
2019,3,8,7,1661,1604,1472,-132
2019,3,8,8,1646,1533,1445,-88
2019,3,8,9,1606,1512,1468,-44
2019,3,8,10,1586,1511,1454,-57
2019,3,8,11,1593,1531,1466,-65
2019,3,8,12,1635,1576,1506,-70
2019,3,8,13,1767,1681,1554,-127
2019,3,8,14,1972,1868,1737,-131
2019,3,8,15,2098,2000,1823,-177
2019,3,8,16,2079,2001,1835,-166
2019,3,8,17,2053,1972,1988,16
2019,3,8,18,2007,1932,2125,193
2019,3,8,19,1950,1863,2271,408
2019,3,8,20,1867,1798,2319,521
2019,3,8,21,1823,1761,2275,514
2019,3,8,22,1796,1739,2262,523
2019,3,8,23,1784,1721,2305,584
2019,3,9,0,1803,1718,2294,576
2019,3,9,1,1830,1764,2216,452
2019,3,9,2,1906,1835,2106,271
2019,3,9,3,1979,1915,2092,177
2019,3,9,4,1951,1907,2055,148
2019,3,9,5,1922,1861,1999,138
2019,3,9,6,1837,1791,1925,134
2019,3,9,7,1765,1702,1819,117
2019,3,9,8,1721,1659,1808,149
2019,3,9,9,1684,1643,1669,26
2019,3,9,10,1699,1644,1581,-63
2019,3,9,11,1710,1656,1581,-75
2019,3,9,12,1735,1686,1537,-149
2019,3,9,13,1798,1745,1584,-161
2019,3,9,14,1892,1827,1563,-264
2019,3,9,15,1984,1923,1560,-363
2019,3,9,16,2024,1968,1581,-387
2019,3,9,17,2021,1977,1675,-302
2019,3,9,18,1998,1938,1744,-194
2019,3,9,19,1948,1871,1741,-130
2019,3,9,20,1880,1823,1723,-100
2019,3,9,21,1822,1763,1691,-72
2019,3,9,22,1786,1726,1676,-50
2019,3,9,23,1772,1737,1685,-52
2019,3,10,0,1794,1766,1649,-117
2019,3,10,1,1864,1798,1665,-133
2019,3,10,2,1927,1853,1715,-138
2019,3,10,3,1973,1889,1703,-186
2019,3,10,4,1953,1881,1640,-241
2019,3,10,5,1904,1820,1610,-210
2019,3,10,6,1825,1731,1594,-137
2019,3,10,7,1728,1655,1564,-91
2019,3,10,8,1668,1590,1531,-59
2019,3,10,9,1653,1653,1531,-9999
2019,3,10,10,953,953,1581,-9999
2019,3,10,11,1657,1657,1581,-9999
2019,3,10,12,1709,1709,1537,-9999
2019,3,10,13,1800,1800,1584,-9999
2019,3,10,14,1882,1882,1563,-9999
2019,3,10,15,1946,1946,1560,-9999
2019,3,10,16,1971,1971,1581,-9999
2019,3,10,17,1943,1943,1675,-9999
2019,3,10,18,1875,1875,1744,-9999
2019,3,10,19,1816,1816,1741,-9999
2019,3,10,20,1749,1749,1723,-9999
2019,3,10,21,1704,1704,1691,-9999
2019,3,10,22,1696,1696,1676,-9999
2019,3,10,23,1693,1693,1685,-9999
2019,3,11,0,1721,1721,1649,-9999
2019,3,11,1,1773,1773,1665,-9999
2019,3,11,2,1830,1830,1715,-9999
2019,3,11,3,1825,1825,1703,-9999
2019,3,11,4,1778,1778,1640,-9999
2019,3,11,5,-9999,1820,1610,-9999
2019,3,11,6,1668,1668,1594,-9999
2019,3,11,7,1633,1633,1564,-9999
2019,3,11,8,1612,1581,1484,-97
2019,3,11,9,1639,1576,1449,-127
2019,3,11,10,1661,1605,1446,-159
2019,3,11,11,1706,1667,1495,-172
2019,3,11,12,1814,1799,1490,-309
2019,3,11,13,2018,2001,1606,-395
2019,3,11,14,2173,2170,1619,-551
2019,3,11,15,2206,2181,1682,-499
2019,3,11,16,2162,2101,1781,-320
2019,3,11,17,2112,2007,1828,-179
2019,3,11,18,2024,1935,1840,-95
2019,3,11,19,1931,1851,1825,-26
2019,3,11,20,1876,1792,1810,18
2019,3,11,21,1825,1726,1663,-63
2019,3,11,22,1787,1673,1705,32
2019,3,11,23,1769,1657,1765,108
2019,3,12,0,1808,1655,1795,140
2019,3,12,1,1858,1666,1720,54
2019,3,12,2,1882,1735,1646,-89
2019,3,12,3,1826,1823,1632,-191
2019,3,12,4,1768,1816,1640,-176
2019,3,12,5,1739,1710,1646,-64
2019,3,12,6,1675,1613,1665,52
2019,3,12,7,1613,1552,1628,76
2019,3,12,8,1598,1541,1449,-92
2019,3,12,9,1596,1545,1380,-165
2019,3,12,10,1615,1561,1209,-352
2019,3,12,11,1666,1618,1263,-355
2019,3,12,12,1768,1707,1345,-362
2019,3,12,13,1967,1919,1394,-525
2019,3,12,14,2106,2070,1593,-477
2019,3,12,15,2095,2080,1770,-310
2019,3,12,16,2035,2023,1808,-215
2019,3,12,17,1986,1952,1973,21
2019,3,12,18,1939,1893,1986,93
2019,3,12,19,1863,1828,1804,-24
2019,3,12,20,1822,1764,1784,20
2019,3,12,21,1782,1721,1731,10
2019,3,12,22,1753,1732,1636,-96
2019,3,12,23,1759,1772,1656,-116
2019,3,13,0,1830,1795,1740,-55
2019,3,13,1,1883,1828,2076,248
2019,3,13,2,1944,1860,2060,200
2019,3,13,3,1973,1926,2079,153
2019,3,13,4,1902,1880,2020,140
2019,3,13,5,1807,1763,2044,281
2019,3,13,6,1714,1654,2088,434
2019,3,13,7,1654,1602,2128,526
2019,3,13,8,1620,1583,2017,434
2019,3,13,9,1643,1582,2000,418
2019,3,13,10,1667,1602,1889,287
2019,3,13,11,1717,1648,1884,236
2019,3,13,12,1837,1760,2016,256
2019,3,13,13,2024,1974,2169,195
2019,3,13,14,2160,2134,2185,51
2019,3,13,15,2160,2134,2217,83
2019,3,13,16,2122,2110,2344,234
2019,3,13,17,2089,2035,2407,372
2019,3,13,18,2039,1982,2395,413
2019,3,13,19,1968,1918,2387,469
2019,3,13,20,1917,1881,2303,422
2019,3,13,21,1885,1838,2328,490
2019,3,13,22,1868,1800,2296,496
2019,3,13,23,1872,1805,2280,475
2019,3,14,0,1874,1804,2269,465
2019,3,14,1,1900,1812,2214,402
2019,3,14,2,1949,1857,2137,280
2019,3,14,3,1967,1942,2103,161
2019,3,14,4,1896,1910,2103,193
2019,3,14,5,1808,1797,2058,261
2019,3,14,6,1727,1687,1951,264
2019,3,14,7,1657,1629,1901,272
2019,3,14,8,1641,1619,1791,172
2019,3,14,9,1676,1623,1701,78
2019,3,14,10,1699,1651,1639,-12
2019,3,14,11,1748,1703,1709,6
2019,3,14,12,1886,1812,1735,-77
2019,3,14,13,2078,2005,1676,-329
2019,3,14,14,2222,2178,1678,-500
2019,3,14,15,2214,2160,1712,-448
2019,3,14,16,2168,2099,1839,-260
2019,3,14,17,2114,1998,1896,-102
2019,3,14,18,2030,1928,1914,-14
2019,3,14,19,1919,1880,1927,47
2019,3,14,20,1862,1814,1882,68
2019,3,14,21,1828,1758,1892,134
2019,3,14,22,1798,1704,1904,200
2019,3,14,23,1776,1680,1923,243
2019,3,15,0,1813,1683,1910,227
2019,3,15,1,1823,1688,1840,152
2019,3,15,2,1862,1765,1736,-29
2019,3,15,3,1935,1875,1713,-162
2019,3,15,4,1901,1858,1691,-167
2019,3,15,5,1810,1766,1658,-108
2019,3,15,6,1711,1657,1644,-13
2019,3,15,7,1659,1611,1656,45
2019,3,15,8,1642,1597,1665,68
2019,3,15,9,1634,1604,1635,31
2019,3,15,10,1659,1617,1613,-4
2019,3,15,11,1710,1670,1643,-27
2019,3,15,12,1814,1778,1654,-124
2019,3,15,13,2017,1966,1674,-292
2019,3,15,14,2166,2131,1699,-432
2019,3,15,15,2152,2140,1754,-386
2019,3,15,16,2081,2061,1873,-188
2019,3,15,17,2014,1961,1967,6
2019,3,15,18,1956,1864,1897,33
2019,3,15,19,1880,1776,1886,110
2019,3,15,20,1794,1721,1832,111
2019,3,15,21,1729,1658,1824,166
2019,3,15,22,1680,1625,1794,169
2019,3,15,23,1662,1589,1871,282
2019,3,16,0,1667,1577,1855,278
2019,3,16,1,1684,1576,1797,221
2019,3,16,2,1736,1615,1687,72
2019,3,16,3,1801,1695,1685,-10
2019,3,16,4,1787,1699,1699,0
2019,3,16,5,1711,1651,1700,49
2019,3,16,6,1626,1573,1696,123
2019,3,16,7,1626,1534,1710,176
2019,3,16,8,1602,1518,1678,160
2019,3,16,9,1584,1519,1695,176
2019,3,16,10,1591,1543,1718,175
2019,3,16,11,1620,1562,1747,185
2019,3,16,12,1656,1628,1795,167
2019,3,16,13,1773,1727,1834,107
2019,3,16,14,1887,1845,1874,29
2019,3,16,15,1966,1910,1928,18
2019,3,16,16,1962,1898,2024,126
2019,3,16,17,1892,1822,2042,220
2019,3,16,18,1806,1737,2007,270
2019,3,16,19,1721,1655,2003,348
2019,3,16,20,1635,1578,1949,371
2019,3,16,21,1559,1519,1949,430
2019,3,16,22,1527,1495,1942,447
2019,3,16,23,1513,1482,1941,459
2019,3,17,0,1569,1484,1940,456
2019,3,17,1,1580,1498,1893,395
2019,3,17,2,1627,1534,1770,236
2019,3,17,3,1721,1634,1786,152
2019,3,17,4,1727,1614,1756,142
2019,3,17,5,1663,1559,1738,179
2019,3,17,6,1565,1493,1739,246
2019,3,17,7,1578,1443,1733,290
2019,3,17,8,1534,1427,1703,276
2019,3,17,9,1496,1436,1726,290
2019,3,17,10,1507,1439,1763,324
2019,3,17,11,1540,1480,1789,309
2019,3,17,12,1567,1530,1779,249
2019,3,17,13,1669,1617,1781,164
2019,3,17,14,1784,1727,1820,93
2019,3,17,15,1874,1824,1884,60
2019,3,17,16,1868,1830,1955,125
2019,3,17,17,1801,1746,1952,206
2019,3,17,18,1740,1671,1908,237
2019,3,17,19,1657,1614,1883,269
2019,3,17,20,1598,1554,1842,288
2019,3,17,21,1537,1512,1820,308
2019,3,17,22,1503,1481,1821,340
2019,3,17,23,1497,1473,1883,410
2019,3,18,0,1562,1489,1879,390
2019,3,18,1,1581,1507,1852,345
2019,3,18,2,1616,1555,1790,235
2019,3,18,3,1704,1651,1794,143
2019,3,18,4,1701,1627,1766,139
2019,3,18,5,1622,1532,1761,229
2019,3,18,6,1526,1435,1758,323
2019,3,18,7,1496,1395,1759,364
2019,3,18,8,1445,1379,1725,346
2019,3,18,9,1434,1395,1743,348
2019,3,18,10,1460,1432,1757,325
2019,3,18,11,1521,1489,1796,307
2019,3,18,12,1632,1605,1798,193
2019,3,18,13,1826,1815,1794,-21
2019,3,18,14,1978,1978,1784,-194
2019,3,18,15,2018,1991,1838,-153
2019,3,18,16,1952,1915,1958,43
2019,3,18,17,1866,1861,1985,124
2019,3,18,18,1798,1771,1973,202
2019,3,18,19,1743,1711,2065,354
2019,3,18,20,1710,1660,2081,421
2019,3,18,21,1658,1618,2078,460
2019,3,18,22,1614,1580,2047,467
2019,3,18,23,1606,1576,2023,447
2019,3,19,0,1666,1580,2049,469
2019,3,19,1,1654,1573,1965,392
2019,3,19,2,1686,1597,1800,203
2019,3,19,3,1772,1692,1778,86
2019,3,19,4,1727,1654,1792,138
2019,3,19,5,1614,1560,1751,191
2019,3,19,6,1512,1453,1696,243
2019,3,19,7,1459,1404,1690,286
2019,3,19,8,1435,1380,1687,307
2019,3,19,9,1431,1404,1678,274
2019,3,19,10,1465,1440,1673,233
2019,3,19,11,1523,1485,1711,226
2019,3,19,12,1633,1605,1724,119
2019,3,19,13,1826,1809,1737,-72
2019,3,19,14,1980,1966,1725,-241
2019,3,19,15,1978,1965,1902,-63
2019,3,19,16,1900,1888,2029,141
2019,3,19,17,1844,1823,1994,171
2019,3,19,18,1792,1748,2068,320
2019,3,19,19,1727,1673,2141,468
2019,3,19,20,1682,1623,2201,578
2019,3,19,21,1632,1586,2198,612
2019,3,19,22,1589,1574,2239,665
2019,3,19,23,1583,1560,2287,727
2019,3,20,0,1635,1556,2296,740
2019,3,20,1,1638,1550,2198,648
2019,3,20,2,1673,1571,2021,450
2019,3,20,3,1741,1681,2009,328
2019,3,20,4,1688,1640,2037,397
2019,3,20,5,1571,1623,2039,416
2019,3,20,6,1464,1433,1858,425
2019,3,20,7,1423,1390,1859,469
2019,3,20,8,1386,1369,1833,464
2019,3,20,9,1432,1372,1850,478
2019,3,20,10,1462,1396,1918,522
2019,3,20,11,1490,1444,1950,506
2019,3,20,12,1567,1560,1977,417
2019,3,20,13,1770,1772,1981,209
2019,3,20,14,1937,1923,1956,33
2019,3,20,15,1938,1914,2048,134
2019,3,20,16,1868,1860,2172,312
2019,3,20,17,1803,1800,2265,465
2019,3,20,18,1746,1731,2254,523
2019,3,20,19,1702,1670,2250,580
2019,3,20,20,1630,1639,2259,620
2019,3,20,21,1612,1587,2214,627
2019,3,20,22,1610,1563,2215,652
2019,3,20,23,1602,1554,2256,702
2019,3,21,0,1611,1550,2238,688
2019,3,21,1,1616,1563,2175,612
2019,3,21,2,1647,1579,2094,515
2019,3,21,3,1721,1652,2065,413
2019,3,21,4,1660,1621,2037,416
2019,3,21,5,1535,1524,2033,509
2019,3,21,6,1431,1412,2003,591
2019,3,21,7,1356,1367,1946,579
2019,3,21,8,1332,1343,1897,554
2019,3,21,9,1390,1334,1835,501
2019,3,21,10,1414,1363,1802,439
2019,3,21,11,1465,1404,1843,439
2019,3,21,12,1554,1515,1832,317
2019,3,21,13,1739,1702,1849,147
2019,3,21,14,1887,1854,1871,17
2019,3,21,15,1870,1877,1855,-22
2019,3,21,16,1795,1835,1894,59
2019,3,21,17,1776,1778,1891,113
2019,3,21,18,1771,1724,1969,245
2019,3,21,19,1737,1687,1967,280
2019,3,21,20,1703,1638,1920,282
2019,3,21,21,1683,1603,1876,273
2019,3,21,22,1649,1599,1801,202
2019,3,21,23,1619,1571,1792,221
2019,3,22,0,1627,1571,1754,183
2019,3,22,1,1642,1584,1727,143
2019,3,22,2,1667,1603,1691,88
2019,3,22,3,1732,1677,1700,23
2019,3,22,4,1679,1628,1699,71
2019,3,22,5,1554,1528,1720,192
2019,3,22,6,1435,1408,1755,347
2019,3,22,7,1348,1350,1770,420
2019,3,22,8,1330,1316,1744,428
2019,3,22,9,1359,1298,1746,448
2019,3,22,10,1375,1316,1744,428
2019,3,22,11,1404,1353,1727,374
2019,3,22,12,1500,1437,1734,297
2019,3,22,13,1671,1593,1722,129
2019,3,22,14,1804,1737,1725,-12
2019,3,22,15,1792,1776,1725,-51
2019,3,22,16,1748,1780,1764,-16
2019,3,22,17,1756,1744,1778,34
2019,3,22,18,1782,1701,1822,121
2019,3,22,19,1757,1637,1957,320
2019,3,22,20,1726,1596,2063,467
2019,3,22,21,1680,1582,2057,475
2019,3,22,22,1646,1549,1943,394
2019,3,22,23,1612,1543,1825,282
2019,3,23,0,1593,1563,1761,198
2019,3,23,1,1616,1545,1773,228
2019,3,23,2,1663,1552,1733,181
2019,3,23,3,1710,1618,1703,85
2019,3,23,4,1659,1583,1700,117
2019,3,23,5,1566,1511,1736,225
2019,3,23,6,1469,1412,1711,299
2019,3,23,7,1406,1338,1716,378
2019,3,23,8,1366,1299,1792,493
2019,3,23,9,1358,1277,1804,527
2019,3,23,10,1350,1275,1838,563
2019,3,23,11,1368,1282,1836,554
2019,3,23,12,1403,1344,1757,413
2019,3,23,13,1483,1424,1690,266
2019,3,23,14,1585,1543,1669,126
2019,3,23,15,1672,1592,1697,105
2019,3,23,16,1696,1627,1727,100
2019,3,23,17,1666,1609,1812,203
2019,3,23,18,1654,1566,1813,247
2019,3,23,19,1603,1512,1793,281
2019,3,23,20,1552,1471,1769,298
2019,3,23,21,1517,1452,1796,344
2019,3,23,22,1500,1434,1779,345
2019,3,23,23,1495,1461,1795,334
2019,3,24,0,1546,1475,1806,331
2019,3,24,1,1581,1513,1783,270
2019,3,24,2,1614,1521,1773,252
2019,3,24,3,1670,1571,1783,212
2019,3,24,4,1621,1546,1766,220
2019,3,24,5,1534,1474,1754,280
2019,3,24,6,1439,1391,1711,320
2019,3,24,7,1404,1340,1701,361
2019,3,24,8,1361,1303,1696,393
2019,3,24,9,1340,1289,1701,412
2019,3,24,10,1355,1285,1694,409
2019,3,24,11,1369,1314,1711,397
2019,3,24,12,1402,1338,1703,365
2019,3,24,13,1480,1418,1782,364
2019,3,24,14,1568,1499,1883,384
2019,3,24,15,1654,1575,1910,335
2019,3,24,16,1690,1633,1981,348
2019,3,24,17,1678,1658,2014,356
2019,3,24,18,1665,1662,1966,304
2019,3,24,19,1668,1643,1998,355
2019,3,24,20,1652,1619,1920,301
2019,3,24,21,1629,1569,1862,293
2019,3,24,22,1608,1540,1938,398
2019,3,24,23,1603,1518,1960,442
2019,3,25,0,1612,1521,2011,490
2019,3,25,1,1625,1539,1919,380
2019,3,25,2,1633,1567,1751,184
2019,3,25,3,1686,1670,1697,27
2019,3,25,4,1653,1646,1689,43
2019,3,25,5,1581,1568,1711,143
2019,3,25,6,1505,1471,1748,277
2019,3,25,7,1431,1414,1751,337
2019,3,25,8,1393,1390,1746,356
2019,3,25,9,1419,1400,1767,367
2019,3,25,10,1442,1403,1805,402
2019,3,25,11,1495,1454,1812,358
2019,3,25,12,1590,1553,1838,285
2019,3,25,13,1746,1719,1922,203
2019,3,25,14,1892,1850,2007,157
2019,3,25,15,1899,1876,2067,191
2019,3,25,16,1838,1866,2174,308
2019,3,25,17,1814,1788,2208,420
2019,3,25,18,1798,1731,2385,654
2019,3,25,19,1735,1666,2452,786
2019,3,25,20,1666,1616,2470,854
2019,3,25,21,1633,1586,2433,847
2019,3,25,22,1603,1541,2338,797
2019,3,25,23,1584,1540,2270,730
2019,3,26,0,1609,1551,2215,664
2019,3,26,1,1627,1586,2182,596
2019,3,26,2,1643,1585,2168,583
2019,3,26,3,1706,1666,2196,530
2019,3,26,4,1653,1614,2210,596
2019,3,26,5,1550,1512,2221,709
2019,3,26,6,1448,1398,2155,757
2019,3,26,7,1351,1337,2157,820
2019,3,26,8,1336,1315,2140,825
2019,3,26,9,1364,1297,2126,829
2019,3,26,10,1379,1312,2096,784
2019,3,26,11,1409,1336,1982,646
2019,3,26,12,1488,1438,1917,479
2019,3,26,13,1644,1605,1846,241
2019,3,26,14,1786,1744,1781,37
2019,3,26,15,1806,1776,1756,-20
2019,3,26,16,1785,1779,1712,-67
2019,3,26,17,1770,1751,1763,12
2019,3,26,18,1757,1695,1818,123
2019,3,26,19,1728,1636,1742,106
2019,3,26,20,1686,1598,1771,173
2019,3,26,21,1633,1580,1795,215
2019,3,26,22,1605,1550,1803,253
2019,3,26,23,1585,1541,1744,203
2019,3,27,0,1620,1550,1706,156
2019,3,27,1,1639,1567,1633,66
2019,3,27,2,1654,1598,1635,37
2019,3,27,3,1721,1644,1640,-4
2019,3,27,4,1678,1602,1637,35
2019,3,27,5,1567,1501,1665,164
2019,3,27,6,1457,1397,1657,260
2019,3,27,7,1403,1338,1676,338
2019,3,27,8,1380,1319,1664,345
2019,3,27,9,1346,1313,1663,350
2019,3,27,10,1367,1308,1652,344
2019,3,27,11,1400,1344,1653,309
2019,3,27,12,1482,1424,1640,216
2019,3,27,13,1647,1582,1650,68
2019,3,27,14,1775,1710,1641,-69
2019,3,27,15,1795,1744,1679,-65
2019,3,27,16,1796,1750,1740,-10
2019,3,27,17,1759,1753,1869,116
2019,3,27,18,1726,1686,1868,182
2019,3,27,19,1684,1638,1940,302
2019,3,27,20,1639,1604,1962,358
2019,3,27,21,1617,1579,1997,418
2019,3,27,22,1599,1576,1966,390
2019,3,27,23,1595,1548,1879,331
2019,3,28,0,1619,1566,1800,234
2019,3,28,1,1634,1583,1739,156
2019,3,28,2,1651,1601,1657,56
2019,3,28,3,1705,1633,1643,10
2019,3,28,4,1657,1611,1676,65
2019,3,28,5,1539,1507,1724,217
2019,3,28,6,1443,1413,1715,302
2019,3,28,7,1397,1355,1725,370
2019,3,28,8,1346,1306,1809,503
2019,3,28,9,1356,1306,1894,588
2019,3,28,10,1362,1302,2062,760
2019,3,28,11,1402,1340,1956,616
2019,3,28,12,1479,1450,1829,379
2019,3,28,13,1647,1609,1851,242
2019,3,28,14,1802,1740,1850,110
2019,3,28,15,1826,1775,1846,71
2019,3,28,16,1803,1730,1895,165
2019,3,28,17,1789,1700,2038,338
2019,3,28,18,1747,1667,2028,361
2019,3,28,19,1691,1628,1978,350
2019,3,28,20,1660,1612,1988,376
2019,3,28,21,1648,1581,2007,426
2019,3,28,22,1629,1563,1957,394
2019,3,28,23,1615,1549,1914,365
2019,3,29,0,1632,1567,1802,235
2019,3,29,1,1653,1571,1782,211
2019,3,29,2,1671,1590,1869,279
2019,3,29,3,1726,1658,1771,113
2019,3,29,4,1689,1641,1687,46
2019,3,29,5,1594,1549,1725,176
2019,3,29,6,1497,1450,1794,344
2019,3,29,7,1435,1380,1855,475
2019,3,29,8,1414,1357,1987,630
2019,3,29,9,1398,1363,1941,578
2019,3,29,10,1409,1375,1900,525
2019,3,29,11,1474,1390,1908,518
2019,3,29,12,1581,1489,1975,486
2019,3,29,13,1723,1640,1989,349
2019,3,29,14,1847,1783,2014,231
2019,3,29,15,1867,1801,2068,267
2019,3,29,16,1858,1795,2202,407
2019,3,29,17,1824,1727,2297,570
2019,3,29,18,1777,1686,2281,595
2019,3,29,19,1720,1637,2322,685
2019,3,29,20,1677,1593,2275,682
2019,3,29,21,1637,1561,2294,733
2019,3,29,22,1594,1534,2315,781
2019,3,29,23,1572,1524,2231,707
2019,3,30,0,1559,1537,2255,718
2019,3,30,1,1592,1529,2219,690
2019,3,30,2,1623,1554,2091,537
2019,3,30,3,1664,1610,2008,398
2019,3,30,4,1654,1584,2004,420
2019,3,30,5,1590,1542,1920,378
2019,3,30,6,1514,1461,1850,389
2019,3,30,7,1460,1403,1771,368
2019,3,30,8,1426,1379,1752,373
2019,3,30,9,1441,1375,1747,372
2019,3,30,10,1449,1382,1732,350
2019,3,30,11,1471,1398,1730,332
2019,3,30,12,1534,1454,1732,278
2019,3,30,13,1609,1544,1731,187
2019,3,30,14,1711,1647,1739,92
2019,3,30,15,1795,1701,1805,104
2019,3,30,16,1809,1698,1931,233
2019,3,30,17,1750,1641,1954,313
2019,3,30,18,1683,1586,1962,376
2019,3,30,19,1607,1527,1954,427
2019,3,30,20,1552,1474,1924,450
2019,3,30,21,1504,1446,1914,468
2019,3,30,22,1481,1427,1874,447
2019,3,30,23,1478,1424,1841,417
2019,3,31,0,1520,1443,1890,447
2019,3,31,1,1546,1459,1817,358
2019,3,31,2,1555,1464,1680,216
2019,3,31,3,1605,1530,1643,113
2019,3,31,4,1584,1540,1657,117
2019,3,31,5,1539,1473,1641,168
2019,3,31,6,1476,1413,1662,249
2019,3,31,7,1427,1355,1662,307
2019,3,31,8,1405,1331,1663,332
2019,3,31,9,1383,1321,1654,333
2019,3,31,10,1396,1345,1664,319
2019,3,31,11,1422,1370,1657,287
2019,3,31,12,1463,1430,1647,217
2019,3,31,13,1544,1510,1644,134
2019,3,31,14,1653,1614,1664,50
2019,3,31,15,1736,1651,1753,102
2019,3,31,16,1715,1646,1888,242
2019,3,31,17,1653,1583,1927,344
2019,3,31,18,1610,1541,1927,386
2019,3,31,19,1562,1497,1933,436
2019,3,31,20,1524,1456,1914,458
2019,3,31,21,1484,1430,1919,489
2019,3,31,22,1456,1413,1901,488
2019,3,31,23,1458,1424,1896,472
2019,4,1,0,1509,1469,1871,402
2019,4,1,1,1537,1473,1775,302
2019,4,1,2,1555,1498,1730,232
2019,4,1,3,1619,1578,1685,107
2019,4,1,4,1594,1551,1660,109
2019,4,1,5,1519,1466,1654,188
2019,4,1,6,1433,1365,1665,300
2019,4,1,7,1370,1363,1738,375
2019,4,1,8,1334,1284,1671,387
2019,4,1,9,1327,1280,1670,390
2019,4,1,10,1358,1289,1634,345
2019,4,1,11,1406,1346,1577,231
2019,4,1,12,1507,1457,1500,43
2019,4,1,13,1658,1652,1434,-218
2019,4,1,14,1804,1791,1403,-388
2019,4,1,15,1836,1780,1411,-369
2019,4,1,16,1775,1760,1469,-291
2019,4,1,17,1738,1721,1487,-234
2019,4,1,18,1710,1665,1463,-202
2019,4,1,19,1686,1627,1451,-176
2019,4,1,20,1666,1591,1430,-161
2019,4,1,21,1630,1558,1418,-140
2019,4,1,22,1604,1566,1366,-200
2019,4,1,23,1597,1554,1332,-222
2019,4,2,0,1623,1579,1356,-223
2019,4,2,1,1631,1584,1369,-215
2019,4,2,2,1640,1591,1353,-238
2019,4,2,3,1694,1645,1397,-248
2019,4,2,4,1650,1600,1449,-151
2019,4,2,5,1539,1477,1439,-38
2019,4,2,6,1424,1351,1415,64
2019,4,2,7,1346,1288,1407,119
2019,4,2,8,1316,1276,1352,76
2019,4,2,9,1313,1266,1326,60
2019,4,2,10,1329,1244,1311,67
2019,4,2,11,1362,1293,1338,45
2019,4,2,12,1441,1379,1352,-27
2019,4,2,13,1602,1565,1361,-204
2019,4,2,14,1725,1710,1388,-322
2019,4,2,15,1747,1698,1439,-259
2019,4,2,16,1738,1690,1466,-224
2019,4,2,17,1719,1671,1417,-254
2019,4,2,18,1697,1658,1427,-231
2019,4,2,19,1672,1626,1533,-93
2019,4,2,20,1671,1628,1522,-106
2019,4,2,21,1661,1607,1518,-89
2019,4,2,22,1656,1612,1553,-59
2019,4,2,23,1655,1614,1605,-9
2019,4,3,0,1686,1626,1541,-85
2019,4,3,1,1695,1647,1549,-98
2019,4,3,2,1702,1651,1516,-135
2019,4,3,3,1759,1684,1470,-214
2019,4,3,4,1706,1640,1483,-157
2019,4,3,5,1573,1515,1467,-48
2019,4,3,6,1456,1390,1423,33
2019,4,3,7,1377,1325,1406,81
2019,4,3,8,1349,1290,1397,107
2019,4,3,9,1339,1263,1387,124
2019,4,3,10,1337,1279,1389,110
2019,4,3,11,1372,1299,1391,92
2019,4,3,12,1462,1395,1389,-6
2019,4,3,13,1637,1580,1385,-195
2019,4,3,14,1764,1718,1383,-335
2019,4,3,15,1762,1724,1396,-328
2019,4,3,16,1760,1745,1460,-285
2019,4,3,17,1756,1706,1501,-205
2019,4,3,18,1738,1655,1607,-48
2019,4,3,19,1692,1529,1643,114
2019,4,3,20,1651,1488,1727,239
2019,4,3,21,1594,1538,1769,231
2019,4,3,22,1568,1510,1716,206
2019,4,3,23,1570,1526,1691,165
2019,4,4,0,1589,1503,1596,93
2019,4,4,1,1608,1508,1513,5
2019,4,4,2,1607,1524,1486,-38
2019,4,4,3,1661,1587,1412,-175
2019,4,4,4,1620,1570,1436,-134
2019,4,4,5,1510,1467,1461,-6
2019,4,4,6,1403,1342,1456,114
2019,4,4,7,1349,1272,1480,208
2019,4,4,8,1318,1256,1482,226
2019,4,4,9,1300,1241,1452,211
2019,4,4,10,1308,1247,1450,203
2019,4,4,11,1346,1280,1465,185
2019,4,4,12,1431,1381,1478,97
2019,4,4,13,1607,1564,1487,-77
2019,4,4,14,1751,1688,1523,-165
2019,4,4,15,1766,1692,1581,-111
2019,4,4,16,1734,1659,1643,-16
2019,4,4,17,1698,1622,1712,90
2019,4,4,18,1655,1579,1690,111
2019,4,4,19,1598,1563,1646,83
2019,4,4,20,1570,1519,1614,95
2019,4,4,21,1574,1535,1647,112
2019,4,4,22,1568,1496,1607,111
2019,4,4,23,1557,1508,1534,26
2019,4,5,0,1580,1499,1468,-31
2019,4,5,1,1592,1506,1638,132
2019,4,5,2,1590,1519,1691,172
2019,4,5,3,1636,1569,1667,98
2019,4,5,4,1603,1543,1684,141
2019,4,5,5,1487,1429,1688,259
2019,4,5,6,1377,1319,1738,419
2019,4,5,7,1315,1239,1704,465
2019,4,5,8,1282,1197,1664,467
2019,4,5,9,1270,1201,1635,434
2019,4,5,10,1265,1193,1627,434
2019,4,5,11,1294,1222,1705,483
2019,4,5,12,1391,1312,1725,413
2019,4,5,13,1573,1477,1724,247
2019,4,5,14,1692,1614,1685,71
2019,4,5,15,1695,1646,1738,92
2019,4,5,16,1685,1621,1821,200
2019,4,5,17,1672,1609,1876,267
2019,4,5,18,1646,1572,1853,281
2019,4,5,19,1617,1540,1834,294
2019,4,5,20,1583,1525,1807,282
2019,4,5,21,1569,1518,1845,327
2019,4,5,22,1559,1516,1935,419
2019,4,5,23,1568,1506,1847,341
2019,4,6,0,1532,1492,1843,351
2019,4,6,1,1546,1497,1809,312
2019,4,6,2,1572,1523,1732,209
2019,4,6,3,1618,1573,1762,189
2019,4,6,4,1602,1520,1758,238
2019,4,6,5,1522,1439,1811,372
2019,4,6,6,1419,1362,1913,551
2019,4,6,7,1344,1298,1830,532
2019,4,6,8,1310,1272,1814,542
2019,4,6,9,1331,1246,1869,623
2019,4,6,10,1348,1265,1878,613
2019,4,6,11,1359,1274,1763,489
2019,4,6,12,1417,1344,1767,423
2019,4,6,13,1529,1426,1772,346
2019,4,6,14,1628,1536,1749,213
2019,4,6,15,1660,1593,1715,122
2019,4,6,16,1654,1638,1729,91
2019,4,6,17,1644,1659,1735,76
2019,4,6,18,1627,1631,1741,110
2019,4,6,19,1612,1609,1836,227
2019,4,6,20,1578,1555,1933,378
2019,4,6,21,1606,1503,1819,316
2019,4,6,22,1583,1468,1850,382
2019,4,6,23,1545,1481,1811,330
2019,4,7,0,1532,1452,1766,314
2019,4,7,1,1533,1461,1679,218
2019,4,7,2,1537,1469,1712,243
2019,4,7,3,1581,1535,1685,150
2019,4,7,4,1563,1532,1722,190
2019,4,7,5,1492,1461,1759,298
2019,4,7,6,1408,1370,1772,402
2019,4,7,7,1320,1305,1840,535
2019,4,7,8,1298,1259,1873,614
2019,4,7,9,1314,1237,1855,618
2019,4,7,10,1316,1233,1849,616
2019,4,7,11,1322,1245,1865,620
2019,4,7,12,1342,1269,1856,587
2019,4,7,13,1397,1319,1830,511
2019,4,7,14,1498,1401,1768,367
2019,4,7,15,1550,1495,1742,247
2019,4,7,16,1572,1555,1749,194
2019,4,7,17,1608,1566,1807,241
2019,4,7,18,1631,1550,1751,201
2019,4,7,19,1645,1530,1758,228
2019,4,7,20,1623,1512,1735,223
2019,4,7,21,1593,1463,1619,156
2019,4,7,22,1577,1450,1615,165
2019,4,7,23,1579,1447,1670,223
2019,4,8,0,1528,1471,1678,207
2019,4,8,1,1540,1488,1675,187
2019,4,8,2,1554,1502,1737,235
2019,4,8,3,1603,1564,1728,164
2019,4,8,4,1563,1519,1742,223
2019,4,8,5,1481,1424,1808,384
2019,4,8,6,1387,1310,1788,478
2019,4,8,7,1285,1233,1816,583
2019,4,8,8,1280,1194,1907,713
2019,4,8,9,1263,1170,1863,693
2019,4,8,10,1272,1188,1769,581
2019,4,8,11,1302,1219,1710,491
2019,4,8,12,1384,1325,1735,410
2019,4,8,13,1549,1501,1690,189
2019,4,8,14,1665,1644,1649,5
2019,4,8,15,1712,1657,1652,-5
2019,4,8,16,1725,1662,1659,-3
2019,4,8,17,1730,1645,1734,89
2019,4,8,18,1691,1622,1800,178
2019,4,8,19,1655,1600,1909,309
2019,4,8,20,1648,1588,1910,322
2019,4,8,21,1626,1559,1939,380
2019,4,8,22,1593,1561,1903,342
2019,4,8,23,1607,1553,1778,225
2019,4,9,0,1626,1576,1751,175
2019,4,9,1,1618,1563,1877,314
2019,4,9,2,1624,1593,1673,80
2019,4,9,3,1683,1614,1718,104
2019,4,9,4,1645,1566,1770,204
2019,4,9,5,1519,1436,1768,332
2019,4,9,6,1400,1329,1827,498
2019,4,9,7,1338,1253,1901,648
2019,4,9,8,1307,1234,1851,617
2019,4,9,9,1267,1218,1919,701
2019,4,9,10,1288,1230,1845,615
2019,4,9,11,1344,1272,1746,474
2019,4,9,12,1435,1360,1744,384
2019,4,9,13,1610,1531,1764,233
2019,4,9,14,1748,1671,2025,354
2019,4,9,15,1777,1702,2174,472
2019,4,9,16,1796,1699,2207,508
2019,4,9,17,1800,1691,2135,444
2019,4,9,18,1777,1659,2224,565
2019,4,9,19,1728,1628,2242,614
2019,4,9,20,1678,1603,2291,688
2019,4,9,21,1647,1611,2312,701
2019,4,9,22,1622,1600,2295,695
2019,4,9,23,1626,1595,2356,761
2019,4,10,0,1667,1620,2332,712
2019,4,10,1,1676,1633,2367,734
2019,4,10,2,1697,1659,2263,604
2019,4,10,3,1765,1714,2234,520
2019,4,10,4,1729,1698,2229,531
2019,4,10,5,1629,1591,2242,651
2019,4,10,6,1538,1482,2229,747
2019,4,10,7,1439,1415,2204,789
2019,4,10,8,1410,1389,2206,817
2019,4,10,9,1452,1383,2188,805
2019,4,10,10,1464,1408,2222,814
2019,4,10,11,1515,1449,2203,754
2019,4,10,12,1623,1541,2172,631
2019,4,10,13,1794,1746,2177,431
2019,4,10,14,1961,1882,2172,290
2019,4,10,15,1992,1858,2215,357
2019,4,10,16,1952,1847,2274,427
2019,4,10,17,1908,1815,2278,463
2019,4,10,18,1845,1772,2292,520
2019,4,10,19,1788,1728,2244,516
2019,4,10,20,1748,1714,2285,571
2019,4,10,21,1722,1680,2231,551
2019,4,10,22,1706,1671,2303,632
2019,4,10,23,1717,1636,2328,692
2019,4,11,0,1721,1659,2298,639
2019,4,11,1,1713,1651,2269,618
2019,4,11,2,1730,1686,2168,482
2019,4,11,3,1783,1731,2088,357
2019,4,11,4,1758,1704,2055,351
2019,4,11,5,1654,1586,2020,434
2019,4,11,6,1558,1465,2015,550
2019,4,11,7,1437,1388,2043,655
2019,4,11,8,1441,1369,2052,683
2019,4,11,9,1450,1356,2038,682
2019,4,11,10,1470,1366,2042,676
2019,4,11,11,1511,1399,1974,575
2019,4,11,12,1605,1491,1892,401
2019,4,11,13,1788,1685,1862,177
2019,4,11,14,1913,1814,1904,90
2019,4,11,15,1919,1802,1952,150
2019,4,11,16,1887,1770,2014,244
2019,4,11,17,1852,1735,2117,382
2019,4,11,18,1817,1695,2113,418
2019,4,11,19,1750,1647,2155,508
2019,4,11,20,1719,1625,2158,533
2019,4,11,21,1691,1595,2194,599
2019,4,11,22,1658,1572,2231,659
2019,4,11,23,1639,1586,2340,754
2019,4,12,0,1661,1583,2281,698
2019,4,12,1,1683,1601,2273,672
2019,4,12,2,1711,1603,2133,530
2019,4,12,3,1769,1674,2082,408
2019,4,12,4,1744,1669,2075,406
2019,4,12,5,1642,1561,2097,536
2019,4,12,6,1537,1459,2068,609
2019,4,12,7,1480,1374,2035,661
2019,4,12,8,1458,1362,2016,654
2019,4,12,9,1452,1362,2014,652
2019,4,12,10,1464,1372,2030,658
2019,4,12,11,1506,1410,2004,594
2019,4,12,12,1633,1505,1908,403
2019,4,12,13,1825,1685,1813,128
2019,4,12,14,1941,1814,1833,19
2019,4,12,15,1925,1808,1970,162
2019,4,12,16,1892,1737,2095,358
2019,4,12,17,1834,1700,2117,417
2019,4,12,18,1771,1660,2119,459
2019,4,12,19,1704,1609,2126,517
2019,4,12,20,1681,1577,2081,504
2019,4,12,21,1634,1542,2086,544
2019,4,12,22,1610,1541,2098,557
2019,4,12,23,1610,1533,2131,598
2019,4,13,0,1592,1542,2262,720
2019,4,13,1,1605,1519,2315,796
2019,4,13,2,1642,1523,2213,690
2019,4,13,3,1697,1561,2006,445
2019,4,13,4,1678,1578,1958,380
2019,4,13,5,1588,1519,1925,406
2019,4,13,6,1506,1434,1850,416
2019,4,13,7,1474,1377,1856,479
2019,4,13,8,1447,1344,1834,490
2019,4,13,9,1440,1334,1827,493
2019,4,13,10,1441,1331,1823,492
2019,4,13,11,1457,1345,1818,473
2019,4,13,12,1520,1418,1824,406
2019,4,13,13,1612,1509,1777,268
2019,4,13,14,1698,1601,1733,132
2019,4,13,15,1738,1630,1831,201
2019,4,13,16,1734,1621,1956,335
2019,4,13,17,1693,1587,2033,446
2019,4,13,18,1644,1534,2019,485
2019,4,13,19,1586,1490,1967,477
2019,4,13,20,1543,1468,1974,506
2019,4,13,21,1502,1437,2001,564
2019,4,13,22,1500,1444,1997,553
2019,4,13,23,1520,1436,1936,500
2019,4,14,0,1539,1453,1881,428
2019,4,14,1,1541,1455,1820,365
2019,4,14,2,1556,1464,1744,280
2019,4,14,3,1602,1518,1803,285
2019,4,14,4,1588,1501,1820,319
2019,4,14,5,1512,1428,1823,395
2019,4,14,6,1418,1345,1912,567
2019,4,14,7,1371,1272,2004,732
2019,4,14,8,1332,1239,2088,849
2019,4,14,9,1314,1219,2059,840
2019,4,14,10,1314,1208,1985,777
2019,4,14,11,1330,1240,2075,835
2019,4,14,12,1365,1263,2213,950
2019,4,14,13,1443,1336,2303,967
2019,4,14,14,1517,1414,2229,815
2019,4,14,15,1576,1488,2184,696
2019,4,14,16,1619,1547,2220,673
2019,4,14,17,1626,1537,2142,605
2019,4,14,18,1612,1520,1962,442
2019,4,14,19,1594,1492,1883,391
2019,4,14,20,1571,1479,1889,410
2019,4,14,21,1531,1450,1696,246
2019,4,14,22,1512,1462,1741,279
2019,4,14,23,1532,1496,1815,319
2019,4,15,0,1578,1546,1782,236
2019,4,15,1,1616,1578,1784,206
2019,4,15,2,1645,1594,1821,227
2019,4,15,3,1714,1641,1804,163
2019,4,15,4,1690,1604,1828,224
2019,4,15,5,1581,1498,1835,337
2019,4,15,6,1468,1386,1834,448
2019,4,15,7,1405,1314,1878,564
2019,4,15,8,1387,1302,1886,584
2019,4,15,9,1365,1283,1914,631
2019,4,15,10,1379,1301,1888,587
2019,4,15,11,1424,1338,1828,490
2019,4,15,12,1529,1438,1781,343
2019,4,15,13,1710,1641,1777,136
2019,4,15,14,1831,1768,1780,12
2019,4,15,15,1836,1781,1822,41
2019,4,15,16,1818,1738,1830,92
2019,4,15,17,1785,1714,1930,216
2019,4,15,18,1737,1671,2022,351
2019,4,15,19,1691,1614,1998,384
2019,4,15,20,1658,1602,1954,352
2019,4,15,21,1634,1577,2008,431
2019,4,15,22,1635,1551,2002,451
2019,4,15,23,1645,1551,1951,400
2019,4,16,0,1645,1558,1932,374
2019,4,16,1,1654,1575,1904,329
2019,4,16,2,1652,1605,1888,283
2019,4,16,3,1696,1650,1811,161
2019,4,16,4,1675,1609,1774,165
2019,4,16,5,1569,1495,1792,297
2019,4,16,6,1453,1370,1747,377
2019,4,16,7,1388,1295,1737,442
2019,4,16,8,1351,1264,1788,524
2019,4,16,9,1334,1250,1866,616
2019,4,16,10,1344,1256,1953,697
2019,4,16,11,1372,1285,2146,861
2019,4,16,12,1471,1395,2174,779
2019,4,16,13,1653,1595,2217,622
2019,4,16,14,1782,1726,2244,518
2019,4,16,15,1798,1711,2317,606
2019,4,16,16,1771,1678,2421,743
2019,4,16,17,1744,1665,2502,837
2019,4,16,18,1706,1639,2511,872
2019,4,16,19,1667,1599,2500,901
2019,4,16,20,1655,1563,2490,927
2019,4,16,21,1639,1549,2495,946
2019,4,16,22,1612,1530,2533,1003
2019,4,16,23,1614,1543,2549,1006
2019,4,17,0,1631,1536,2550,1014
2019,4,17,1,1644,1540,2483,943
2019,4,17,2,1653,1539,2322,783
2019,4,17,3,1690,1596,2211,615
2019,4,17,4,1546,1615,2176,561
2019,4,17,5,1439,1497,2147,650
2019,4,17,6,1396,1400,2106,706
2019,4,17,7,1376,1317,2056,739
2019,4,17,8,1361,1306,2077,771
2019,4,17,9,1385,1299,2016,717
2019,4,17,10,1443,1324,1977,653
2019,4,17,11,1552,1371,1935,564
2019,4,17,12,1755,1465,1897,432
2019,4,17,13,1880,1672,1912,240
2019,4,17,14,1849,1774,1900,126
2019,4,17,15,1790,1753,1937,184
2019,4,17,16,1744,1702,1999,297
2019,4,17,17,1746,1690,2122,432
2019,4,17,18,1659,1624,2221,597
2019,4,17,19,1640,1583,2398,815
2019,4,17,20,1626,1564,2458,894
2019,4,17,21,1603,1538,2492,954
2019,4,17,22,1613,1527,2534,1007
2019,4,17,23,1621,1519,2580,1061
2019,4,18,0,1627,1523,2604,1081
2019,4,18,1,1629,1514,2571,1057
2019,4,18,2,1668,1527,2401,874
2019,4,18,3,1646,1581,2232,651
2019,4,18,4,1536,1576,2188,612
2019,4,18,5,1419,1463,2215,752
2019,4,18,6,1358,1344,2165,821
2019,4,18,7,1335,1279,2141,862
2019,4,18,8,1335,1252,2161,909
2019,4,18,9,1348,1250,2156,906
2019,4,18,10,1383,1253,2087,834
2019,4,18,11,1485,1298,2045,747
2019,4,18,12,1684,1391,1964,573
2019,4,18,13,1799,1607,1876,269
2019,4,18,14,1767,1720,1868,148
2019,4,18,15,1722,1676,1984,308
2019,4,18,16,1687,1652,2072,420
2019,4,18,17,1641,1611,2075,464
2019,4,18,18,1612,1586,2080,494
2019,4,18,19,1598,1564,2083,519
2019,4,18,20,1594,1543,2068,525
2019,4,18,21,1593,1551,2084,533
2019,4,18,22,1612,1542,2096,554
2019,4,18,23,1627,1551,2114,563
2019,4,19,0,1634,1556,2132,576
2019,4,19,1,1639,1562,2089,527
2019,4,19,2,1670,1569,1935,366
2019,4,19,3,1645,1593,1817,224
2019,4,19,4,1519,1601,1801,200
2019,4,19,5,1390,1483,1798,315
2019,4,19,6,1312,1355,1838,483
2019,4,19,7,1284,1258,1851,593
2019,4,19,8,1274,1210,1832,622
2019,4,19,9,1287,1196,1845,649
2019,4,19,10,1307,1190,1850,660
2019,4,19,11,1396,1213,1872,659
2019,4,19,12,1573,1299,1932,633
2019,4,19,13,1673,1462,1985,523
2019,4,19,14,1646,1590,2102,512
2019,4,19,15,1631,1598,2218,620
2019,4,19,16,1625,1596,2223,627
2019,4,19,17,1625,1588,2252,664
2019,4,19,18,1632,1584,2290,706
2019,4,19,19,1655,1556,2221,665
2019,4,19,20,1666,1586,2206,620
2019,4,19,21,1675,1594,2147,553
2019,4,19,22,1697,1610,2104,494
2019,4,19,23,1677,1625,2036,411
2019,4,20,0,1679,1641,2065,424
2019,4,20,1,1676,1627,2088,461
2019,4,20,2,1700,1608,2022,414
2019,4,20,3,1680,1619,1978,359
2019,4,20,4,1569,1600,1986,386
2019,4,20,5,1445,1503,2018,515
2019,4,20,6,1341,1373,2029,656
2019,4,20,7,1299,1281,2033,752
2019,4,20,8,1269,1225,2062,837
2019,4,20,9,1262,1181,2055,874
2019,4,20,10,1261,1161,2060,899
2019,4,20,11,1300,1164,2025,861
2019,4,20,12,1387,1151,1998,847
2019,4,20,13,1451,1232,2088,856
2019,4,20,14,1474,1304,2083,779
2019,4,20,15,1525,1398,2046,648
2019,4,20,16,1551,1455,2160,705
2019,4,20,17,1542,1477,2151,674
2019,4,20,18,1530,1489,2130,641
2019,4,20,19,1509,1478,2049,571
2019,4,20,20,1511,1472,2089,617
2019,4,20,21,1509,1465,2009,544
2019,4,20,22,1526,1460,2017,557
2019,4,20,23,1545,1486,2242,756
2019,4,21,0,1558,1466,2189,723
2019,4,21,1,1559,1483,2097,614
2019,4,21,2,1585,1484,2297,813
2019,4,21,3,1606,1511,2129,618
2019,4,21,4,1538,1503,2144,641
2019,4,21,5,1438,1423,2163,740
2019,4,21,6,1353,1331,2233,902
2019,4,21,7,1315,1251,2277,1026
2019,4,21,8,1292,1200,2289,1089
2019,4,21,9,1272,1192,2312,1120
2019,4,21,10,1270,1185,2307,1122
2019,4,21,11,1293,1190,2334,1144
2019,4,21,12,1382,1229,2350,1121
2019,4,21,13,1456,1288,2395,1107
2019,4,21,14,1549,1382,2412,1030
2019,4,21,15,1599,1464,2470,1006
2019,4,21,16,1606,1511,2473,962
2019,4,21,17,1590,1503,2376,873
2019,4,21,18,1564,1497,2434,937
2019,4,21,19,1536,1483,2304,821
2019,4,21,20,1510,1441,2342,901
2019,4,21,21,1490,1417,2304,887
2019,4,21,22,1496,1407,2335,928
2019,4,21,23,1521,1395,2348,953
2019,4,22,0,1539,1409,2205,796
2019,4,22,1,1540,1412,1995,583
2019,4,22,2,1582,1440,2007,567
2019,4,22,3,1574,1493,1989,496
2019,4,22,4,1481,1507,1957,450
2019,4,22,5,1369,1404,1909,505
2019,4,22,6,1316,1295,1870,575
2019,4,22,7,1287,1228,1858,630
2019,4,22,8,1269,1192,1865,673
2019,4,22,9,1279,1189,1921,732
2019,4,22,10,1323,1192,1939,747
2019,4,22,11,1415,1227,1945,718
2019,4,22,12,1611,1335,1913,578
2019,4,22,13,1733,1520,1890,370
2019,4,22,14,1744,1642,1902,260
2019,4,22,15,1720,1647,2020,373
2019,4,22,16,1687,1642,2113,471
2019,4,22,17,1652,1631,2125,494
2019,4,22,18,1623,1618,2103,485
2019,4,22,19,1620,1613,2083,470
2019,4,22,20,1623,1583,2076,493
2019,4,22,21,1630,1582,2115,533
2019,4,22,22,1637,1587,2116,529
2019,4,22,23,1650,1589,2103,514
2019,4,23,0,1653,1594,2127,533
2019,4,23,1,1665,1610,2161,551
2019,4,23,2,1683,1595,2088,493
2019,4,23,3,1666,1639,2054,415
2019,4,23,4,1538,1624,2094,470
2019,4,23,5,1413,1494,2035,541
2019,4,23,6,1317,1354,2060,706
2019,4,23,7,1278,1278,1982,704
2019,4,23,8,1274,1241,1878,637
2019,4,23,9,1296,1228,1832,604
2019,4,23,10,1331,1227,1796,569
2019,4,23,11,1418,1266,1813,547
2019,4,23,12,1587,1363,1810,447
2019,4,23,13,1711,1539,1822,283
2019,4,23,14,1713,1657,1839,182
2019,4,23,15,1686,1658,1961,303
2019,4,23,16,1676,1658,2058,400
2019,4,23,17,1684,1660,2063,403
2019,4,23,18,1682,1659,2096,437
2019,4,23,19,1692,1657,2136,479
2019,4,23,20,1707,1676,2194,518
2019,4,23,21,1712,1685,2291,606
2019,4,23,22,1746,1688,2392,704
2019,4,23,23,1758,1708,2420,712
2019,4,24,0,1754,1721,2419,698
2019,4,24,1,1746,1744,2383,639
2019,4,24,2,1760,1724,2199,475
2019,4,24,3,1739,1749,2092,343
2019,4,24,4,1592,1722,2000,278
2019,4,24,5,1454,1591,2009,418
2019,4,24,6,1320,1442,2023,581
2019,4,24,7,1277,1345,2011,666
2019,4,24,8,1279,1295,1969,674
2019,4,24,9,1342,1269,1961,692
2019,4,24,10,1389,1263,1931,668
2019,4,24,11,1465,1288,1927,639
2019,4,24,12,1646,1363,1909,546
2019,4,24,13,1745,1533,1920,387
2019,4,24,14,1735,1638,1966,328
2019,4,24,15,1714,1665,2028,363
2019,4,24,16,1721,1679,2069,390
2019,4,24,17,1754,1690,2128,438
2019,4,24,18,1765,1693,2273,580
2019,4,24,19,1781,1681,2426,745
2019,4,24,20,1788,1677,2535,858
2019,4,24,21,1775,1681,2599,918
2019,4,24,22,1786,1706,2661,955
2019,4,24,23,1798,1706,2660,954
2019,4,25,0,1803,1716,2655,939
2019,4,25,1,1781,1728,2635,907
2019,4,25,2,1798,1710,2460,750
2019,4,25,3,1780,1718,2325,607
2019,4,25,4,1636,1728,2245,517
2019,4,25,5,1492,1598,2153,555
2019,4,25,6,1344,1458,2109,651
2019,4,25,7,1307,1368,2092,724
2019,4,25,8,1343,1326,2063,737
2019,4,25,9,1411,1312,1985,673
2019,4,25,10,1450,1317,1925,608
2019,4,25,11,1545,1357,1906,549
2019,4,25,12,1741,1451,1854,403
2019,4,25,13,1859,1627,1832,205
2019,4,25,14,1847,1743,1887,144
2019,4,25,15,1809,1764,2011,247
2019,4,25,16,1788,1743,2038,295
2019,4,25,17,1803,1732,2045,313
2019,4,25,18,1797,1732,2054,322
2019,4,25,19,1802,1711,2068,357
2019,4,25,20,1817,1715,2062,347
2019,4,25,21,1817,1726,2066,340
2019,4,25,22,1847,1740,2070,330
2019,4,25,23,1862,1766,2060,294
2019,4,26,0,1876,1776,2054,278
2019,4,26,1,1867,1789,2008,219
2019,4,26,2,1874,1775,1844,69
2019,4,26,3,1858,1777,1795,18
2019,4,26,4,1715,1772,1803,31
2019,4,26,5,1558,1651,1836,185
2019,4,26,6,1408,1509,1912,403
2019,4,26,7,1361,1414,1949,535
2019,4,26,8,1380,1360,1976,616
2019,4,26,9,1429,1350,1979,629
2019,4,26,10,1456,1335,1936,601
2019,4,26,11,1543,1367,1944,577
2019,4,26,12,1706,1446,1974,528
2019,4,26,13,1801,1582,1961,379
2019,4,26,14,1816,1694,1990,296
2019,4,26,15,1805,1727,2111,384
2019,4,26,16,1822,1759,2264,505
2019,4,26,17,1860,1771,2472,701
2019,4,26,18,1864,1761,2554,793
2019,4,26,19,1870,1726,2576,850
2019,4,26,20,1863,1721,2616,895
2019,4,26,21,1845,1720,2693,973
2019,4,26,22,1845,1709,2701,992
2019,4,26,23,1782,1719,2708,989
2019,4,27,0,1769,1711,2690,979
2019,4,27,1,1739,1707,2681,974
2019,4,27,2,1778,1689,2526,837
2019,4,27,3,1790,1690,2322,632
2019,4,27,4,1704,1713,2235,522
2019,4,27,5,1584,1622,2149,527
2019,4,27,6,1451,1522,2056,534
2019,4,27,7,1410,1438,2008,570
2019,4,27,8,1424,1399,1986,587
2019,4,27,9,1472,1400,1981,581
2019,4,27,10,1502,1386,1920,534
2019,4,27,11,1547,1400,1898,498
2019,4,27,12,1613,1440,1884,444
2019,4,27,13,1685,1527,1875,348
2019,4,27,14,1761,1599,1893,294
2019,4,27,15,1788,1660,1979,319
2019,4,27,16,1795,1691,2097,406
2019,4,27,17,1802,1686,2093,407
2019,4,27,18,1768,1663,2127,464
2019,4,27,19,1737,1643,2128,485
2019,4,27,20,1722,1592,2225,633
2019,4,27,21,1722,1631,2401,770
2019,4,27,22,1749,1628,2478,850
2019,4,27,23,1768,1657,2501,844
2019,4,28,0,1770,1663,2464,801
2019,4,28,1,1757,1672,2458,786
2019,4,28,2,1760,1687,2354,667
2019,4,28,3,1769,1681,2175,494
2019,4,28,4,1691,1673,2179,506
2019,4,28,5,1594,1607,2230,623
2019,4,28,6,1484,1510,2398,888
2019,4,28,7,1442,1449,2375,926
2019,4,28,8,1461,1411,2382,971
2019,4,28,9,1511,1399,2370,971
2019,4,28,10,1534,1407,2425,1018
2019,4,28,11,1577,1432,2430,998
2019,4,28,12,1658,1463,2392,929
2019,4,28,13,1745,1534,2379,845
2019,4,28,14,1833,1596,2470,874
2019,4,28,15,1864,1679,2618,939
2019,4,28,16,1854,1702,2636,934
2019,4,28,17,1821,1699,2612,913
2019,4,28,18,1778,1684,2587,903
2019,4,28,19,1746,1657,2521,864
2019,4,28,20,1720,1620,2452,832
2019,4,28,21,1695,1587,2440,853
2019,4,28,22,1690,1577,2433,856
2019,4,28,23,1711,1574,2366,792
2019,4,29,0,1725,1601,2355,754
2019,4,29,1,1726,1601,2350,749
2019,4,29,2,1762,1625,2233,608
2019,4,29,3,1788,1639,2088,449
2019,4,29,4,1698,1665,2080,415
2019,4,29,5,1577,1570,1987,417
2019,4,29,6,1514,1448,1939,491
2019,4,29,7,1491,1394,1968,574
2019,4,29,8,1531,1381,2166,785
2019,4,29,9,1506,1387,2246,859
2019,4,29,10,1560,1407,2265,858
2019,4,29,11,1678,1460,2201,741
2019,4,29,12,1880,1580,2228,648
2019,4,29,13,2015,1775,2228,453
2019,4,29,14,2029,1893,2229,336
2019,4,29,15,2003,1876,2369,493
2019,4,29,16,1963,1852,2385,533
2019,4,29,17,1911,1840,2268,428
2019,4,29,18,1867,1812,2210,398
2019,4,29,19,1841,1790,2095,305
2019,4,29,20,1828,1751,2043,292
2019,4,29,21,1824,1739,2116,377
2019,4,29,22,1824,1720,2151,431
2019,4,29,23,1832,1730,2305,575
2019,4,30,0,1837,1754,2491,737
2019,4,30,1,1841,1763,2512,749
2019,4,30,2,1864,1769,2391,622
2019,4,30,3,1888,1776,2202,426
2019,4,30,4,1788,1789,2186,397
2019,4,30,5,1665,1663,2103,440
2019,4,30,6,1591,1544,1992,448
2019,4,30,7,1573,1473,2019,546
2019,4,30,8,1573,1446,2042,596
2019,4,30,9,1595,1443,2058,615
2019,4,30,10,1635,1451,2000,549
2019,4,30,11,1739,1495,1982,487
2019,4,30,12,1927,1608,1947,339
2019,4,30,13,2031,1789,1911,122
2019,4,30,14,2006,1902,1949,47
2019,4,30,15,1990,1889,2087,198
2019,4,30,16,1974,1880,2179,299
2019,4,30,17,1938,1871,2162,291
2019,4,30,18,1906,1857,2141,284
2019,4,30,19,1885,1834,2154,320
2019,4,30,20,1882,1823,2154,331
2019,4,30,21,1874,1814,2176,362
2019,4,30,22,1886,1808,2167,359
2019,4,30,23,1904,1809,2083,274
2019,5,1,0,1914,1811,2204,393
2019,5,1,1,1910,1804,2300,496
2019,5,1,2,1918,1809,2322,513
2019,5,1,3,1934,1832,2172,340
2019,5,1,4,1818,1826,1996,170
2019,5,1,5,1696,1711,1892,181
2019,5,1,6,1593,1576,1851,275
2019,5,1,7,1576,1570,1889,319
2019,5,1,8,1594,1490,1819,329
2019,5,1,9,1626,1498,1833,335
2019,5,1,10,1655,1512,1831,319
2019,5,1,11,1780,1559,1841,282
2019,5,1,12,1989,1675,1828,153
2019,5,1,13,2086,1870,1816,-54
2019,5,1,14,2045,1964,1878,-86
2019,5,1,15,2024,1919,1990,71
2019,5,1,16,1987,1903,2037,134
2019,5,1,17,1953,1876,2035,159
2019,5,1,18,1927,1850,2063,213
2019,5,1,19,1902,1829,2071,242
2019,5,1,20,1898,1801,2072,271
2019,5,1,21,1893,1796,2110,314
2019,5,1,22,1904,1775,2111,336
2019,5,1,23,1905,1789,2100,311
2019,5,2,0,1909,1791,2067,276
2019,5,2,1,1906,1804,2042,238
2019,5,2,2,1918,1840,1940,100
2019,5,2,3,1932,1863,1832,-31
2019,5,2,4,1821,1870,1844,-26
2019,5,2,5,1691,1748,1874,126
2019,5,2,6,1562,1629,1919,290
2019,5,2,7,1530,1569,1942,373
2019,5,2,8,1526,1525,1946,421
2019,5,2,9,1593,1523,1974,451
2019,5,2,10,1648,1530,1992,462
2019,5,2,11,1747,1575,2022,447
2019,5,2,12,1933,1668,2005,337
2019,5,2,13,2022,1884,2041,157
2019,5,2,14,1997,1973,2049,76
2019,5,2,15,1978,1969,2131,162
2019,5,2,16,1987,1958,2185,227
2019,5,2,17,2016,1932,2225,293
2019,5,2,18,2015,1893,2329,436
2019,5,2,19,2006,1886,2387,501
2019,5,2,20,2002,1858,2447,589
2019,5,2,21,1967,1846,2441,595
2019,5,2,22,1978,1806,2462,656
2019,5,2,23,1967,1853,2537,684
2019,5,3,0,1969,1839,2553,714
2019,5,3,1,1960,1830,2574,744
2019,5,3,2,1969,1850,2481,631
2019,5,3,3,1964,1851,2268,417
2019,5,3,4,1834,1880,2144,264
2019,5,3,5,1701,1763,2033,270
2019,5,3,6,1574,1641,1980,339
2019,5,3,7,1537,1577,1964,387
2019,5,3,8,1586,1538,1952,414
2019,5,3,9,1653,1526,1881,355
2019,5,3,10,1686,1534,1833,299
2019,5,3,11,1796,1572,1805,233
2019,5,3,12,1985,1667,1801,134
2019,5,3,13,2069,1854,1807,-47
2019,5,3,14,2028,1943,1882,-61
2019,5,3,15,2010,1957,2029,72
2019,5,3,16,2005,1955,2075,120
2019,5,3,17,2016,1929,2076,147
2019,5,3,18,2002,1911,2077,166
2019,5,3,19,1992,1908,2084,176
2019,5,3,20,1987,1905,2084,179
2019,5,3,21,1975,1896,2083,187
2019,5,3,22,1991,1895,2095,200
2019,5,3,23,1936,1901,2093,192
2019,5,4,0,1930,1901,2101,200
2019,5,4,1,1922,1896,2134,238
2019,5,4,2,1957,1895,2022,127
2019,5,4,3,1968,1914,1902,-12
2019,5,4,4,1873,1911,1888,-23
2019,5,4,5,1766,1827,1892,65
2019,5,4,6,1605,1694,1898,204
2019,5,4,7,1565,1604,1912,308
2019,5,4,8,1579,1560,1910,350
2019,5,4,9,1628,1525,1898,373
2019,5,4,10,1644,1518,1893,375
2019,5,4,11,1678,1527,1893,366
2019,5,4,12,1743,1567,1922,355
2019,5,4,13,1799,1638,1957,319
2019,5,4,14,1855,1734,1984,250
2019,5,4,15,1903,1796,2018,222
2019,5,4,16,1929,1830,2046,216
2019,5,4,17,1949,1834,2049,215
2019,5,4,18,1937,1836,2050,214
2019,5,4,19,1930,1823,2053,230
2019,5,4,20,1922,1827,2092,265
2019,5,4,21,1918,1823,2106,283
2019,5,4,22,1949,1843,2164,321
2019,5,4,23,1967,1865,2243,378
2019,5,5,0,1978,1901,2298,397
2019,5,5,1,1980,1911,2307,396
2019,5,5,2,1990,1912,2178,266
2019,5,5,3,1986,1909,2018,109
2019,5,5,4,1885,1921,1991,70
2019,5,5,5,1766,1831,1923,92
2019,5,5,6,1635,1701,1916,215
2019,5,5,7,1580,1621,1960,339
2019,5,5,8,1581,1566,1919,353
2019,5,5,9,1622,1536,1894,358
2019,5,5,10,1639,1513,1868,355
2019,5,5,11,1666,1535,1872,337
2019,5,5,12,1709,1535,1845,310
2019,5,5,13,1765,1588,1860,272
2019,5,5,14,1840,1650,1889,239
2019,5,5,15,1886,1726,1991,265
2019,5,5,16,1904,1760,2062,302
2019,5,5,17,1920,1766,2034,268
2019,5,5,18,1922,1762,2017,255
2019,5,5,19,1926,1772,2007,235
2019,5,5,20,1908,1771,2059,288
2019,5,5,21,1902,1787,2116,329
2019,5,5,22,1928,1802,2205,403
2019,5,5,23,1975,1846,2291,445
2019,5,6,0,2011,1889,2334,445
2019,5,6,1,2025,1907,2344,437
2019,5,6,2,2046,1908,2226,318
2019,5,6,3,2024,1919,2089,170
2019,5,6,4,1883,1917,1986,69
2019,5,6,5,1725,1796,1975,179
2019,5,6,6,1631,1647,1951,304
2019,5,6,7,1579,1533,1946,413
2019,5,6,8,1587,1484,1961,477
2019,5,6,9,1571,1464,1984,520
2019,5,6,10,1601,1455,2004,549
2019,5,6,11,1688,1470,1963,493
2019,5,6,12,1861,1562,1953,391
2019,5,6,13,1950,1724,1917,193
2019,5,6,14,1979,1850,1885,35
2019,5,6,15,1986,1894,2011,117
2019,5,6,16,2008,1936,2035,99
2019,5,6,17,2028,1947,2034,87
2019,5,6,18,2063,1984,2045,61
2019,5,6,19,2103,1998,2013,15
2019,5,6,20,2134,2002,1982,-20
2019,5,6,21,2168,2030,2017,-13
2019,5,6,22,2196,2061,2040,-21
2019,5,6,23,2216,2072,2097,25
2019,5,7,0,2210,2089,2068,-21
2019,5,7,1,2198,2095,2089,-6
2019,5,7,2,2174,2106,2134,28
2019,5,7,3,2155,2083,2019,-64
2019,5,7,4,2014,2066,1962,-104
2019,5,7,5,1842,1935,2034,99
2019,5,7,6,1717,1807,2007,200
2019,5,7,7,1659,1704,2004,300
2019,5,7,8,1633,1634,2030,396
2019,5,7,9,1663,1596,2012,416
2019,5,7,10,1689,1558,2035,477
2019,5,7,11,1758,1575,2046,471
2019,5,7,12,1909,1642,2080,438
2019,5,7,13,2016,1791,2100,309
2019,5,7,14,2035,1885,2100,215
2019,5,7,15,2049,1964,2233,269
2019,5,7,16,2064,1976,2300,324
2019,5,7,17,2084,1990,2376,386
2019,5,7,18,2128,2007,2404,397
2019,5,7,19,2157,2007,2437,430
2019,5,7,20,2180,2021,2466,445
2019,5,7,21,2183,2012,2461,449
2019,5,7,22,2181,2018,2459,441
2019,5,7,23,2173,2037,2385,348
2019,5,8,0,2160,2035,2219,184
2019,5,8,1,2153,2035,2091,56
2019,5,8,2,2133,2037,1979,-58
2019,5,8,3,2124,2034,1792,-242
2019,5,8,4,2007,2033,1706,-327
2019,5,8,5,1853,1906,1653,-253
2019,5,8,6,1710,1761,1627,-134
2019,5,8,7,1655,1672,1579,-93
2019,5,8,8,1672,1615,1555,-60
2019,5,8,9,1668,1597,1559,-38
2019,5,8,10,1700,1575,1571,-4
2019,5,8,11,1790,1603,1623,20
2019,5,8,12,1949,1685,1634,-51
2019,5,8,13,2042,1823,1643,-180
2019,5,8,14,2073,1945,1751,-194
2019,5,8,15,2110,1981,1887,-94
2019,5,8,16,2133,1990,1937,-53
2019,5,8,17,2153,2001,1963,-38
2019,5,8,18,2148,1999,1963,-36
2019,5,8,19,2152,2000,1969,-31
2019,5,8,20,2158,2012,1940,-72
2019,5,8,21,2154,2023,1928,-95
2019,5,8,22,2168,2028,1950,-78
2019,5,8,23,2180,2034,1923,-111
2019,5,9,0,2175,2049,2046,-3
2019,5,9,1,2174,2053,2205,152
2019,5,9,2,2163,2061,2020,-41
2019,5,9,3,2159,2068,1777,-291
2019,5,9,4,2028,2076,1749,-327
2019,5,9,5,1876,1943,1772,-171
2019,5,9,6,1759,1830,1677,-153
2019,5,9,7,1704,1699,1703,4
2019,5,9,8,1697,1653,1751,98
2019,5,9,9,1694,1620,1734,114
2019,5,9,10,1735,1609,1819,210
2019,5,9,11,1816,1631,1864,233
2019,5,9,12,1968,1697,1819,122
2019,5,9,13,2068,1861,1798,-63
2019,5,9,14,2103,1981,1806,-175
2019,5,9,15,2131,2010,1810,-200
2019,5,9,16,2150,2013,1911,-102
2019,5,9,17,2156,2039,2049,10
2019,5,9,18,2151,2029,2028,-1
2019,5,9,19,2174,2025,2017,-8
2019,5,9,20,2179,2028,2001,-27
2019,5,9,21,2178,2014,2017,3
2019,5,9,22,2189,2023,1937,-86
2019,5,9,23,2181,2003,1915,-88
2019,5,10,0,2187,2018,1940,-78
2019,5,10,1,2187,2017,1982,-35
2019,5,10,2,2180,2036,1877,-159
2019,5,10,3,2158,2034,1670,-364
2019,5,10,4,2024,2037,1608,-429
2019,5,10,5,1865,1938,1615,-323
2019,5,10,6,1780,1788,1610,-178
2019,5,10,7,1726,1693,1610,-83
2019,5,10,8,1716,1651,1651,0
2019,5,10,9,1703,1616,1582,-34
2019,5,10,10,1725,1609,1567,-42
2019,5,10,11,1804,1624,1576,-48
2019,5,10,12,1960,1710,1574,-136
2019,5,10,13,2067,1842,1562,-280
2019,5,10,14,2109,1954,1658,-296
2019,5,10,15,2134,2001,1774,-227
2019,5,10,16,2157,2026,1799,-227
2019,5,10,17,2181,2016,1791,-225
2019,5,10,18,2189,2021,1800,-221
2019,5,10,19,2201,2015,1811,-204
2019,5,10,20,2198,2023,1785,-238
2019,5,10,21,2199,2035,1792,-243
2019,5,10,22,2204,2033,1791,-242
2019,5,10,23,2154,2051,1795,-256
2019,5,11,0,2150,2051,1787,-264
2019,5,11,1,2150,2059,1760,-299
2019,5,11,2,2185,2057,1649,-408
2019,5,11,3,2174,2069,1543,-526
2019,5,11,4,2076,2067,1523,-544
2019,5,11,5,1934,1986,1533,-453
2019,5,11,6,1840,1833,1521,-312
2019,5,11,7,1783,1751,1521,-230
2019,5,11,8,1751,1684,1520,-164
2019,5,11,9,1736,1653,1530,-123
2019,5,11,10,1725,1640,1531,-109
2019,5,11,11,1751,1635,1521,-114
2019,5,11,12,1806,1664,1517,-147
2019,5,11,13,1892,1711,1518,-193
2019,5,11,14,2013,1819,1620,-199
2019,5,11,15,2087,1902,1741,-161
2019,5,11,16,2124,1939,1767,-172
2019,5,11,17,2117,1967,1764,-203
2019,5,11,18,2112,1955,1751,-204
2019,5,11,19,2105,1965,1734,-231
2019,5,11,20,2097,1983,1744,-239
2019,5,11,21,2106,2001,1769,-232
2019,5,11,22,2143,2054,1773,-281
2019,5,11,23,2193,2082,1776,-306
2019,5,12,0,2222,2143,1828,-315
2019,5,12,1,2243,2151,1829,-322
2019,5,12,2,2251,2170,1768,-402
2019,5,12,3,2242,2130,1680,-450
2019,5,12,4,2152,2121,1672,-449
2019,5,12,5,1999,2018,1624,-394
2019,5,12,6,1869,1872,1613,-259
2019,5,12,7,1809,1768,1590,-178
2019,5,12,8,1780,1694,1607,-87
2019,5,12,9,1768,1666,1611,-55
2019,5,12,10,1755,1621,1609,-12
2019,5,12,11,1764,1623,1615,-8
2019,5,12,12,1789,1635,1602,-33
2019,5,12,13,1865,1655,1599,-56
2019,5,12,14,1987,1724,1671,-53
2019,5,12,15,2061,1814,1695,-119
2019,5,12,16,2087,1857,1611,-246
2019,5,12,17,2097,1886,1724,-162
2019,5,12,18,2098,1902,1711,-191
2019,5,12,19,2114,1926,1713,-213
2019,5,12,20,2124,1950,1729,-221
2019,5,12,21,2134,1997,1795,-202
2019,5,12,22,2175,2044,1859,-185
2019,5,12,23,2259,2112,1937,-175
2019,5,13,0,2319,2160,1956,-204
2019,5,13,1,2348,2187,1983,-204
2019,5,13,2,2334,2200,1879,-321
2019,5,13,3,2292,2183,1724,-459
2019,5,13,4,2136,2149,1643,-506
2019,5,13,5,1950,2022,1637,-385
2019,5,13,6,1865,1842,1604,-238
2019,5,13,7,1805,1738,1634,-104
2019,5,13,8,1779,1670,1621,-49
2019,5,13,9,1746,1629,1628,-1
2019,5,13,10,1746,1599,1603,4
2019,5,13,11,1823,1615,1572,-43
2019,5,13,12,1977,1685,1593,-92
2019,5,13,13,2090,1828,1579,-249
2019,5,13,14,2157,1954,1624,-330
2019,5,13,15,2184,2038,1666,-372
2019,5,13,16,2216,2101,1728,-373
2019,5,13,17,2240,2150,1759,-391
2019,5,13,18,2270,2210,1708,-502
2019,5,13,19,2339,2242,1700,-542
2019,5,13,20,2402,2305,1760,-545
2019,5,13,21,2447,2347,1786,-561
2019,5,13,22,2486,2406,1788,-618
2019,5,13,23,2535,2461,1828,-633
2019,5,14,0,2565,2485,1838,-647
2019,5,14,1,2578,2475,1905,-570
2019,5,14,2,2539,2445,1735,-710
2019,5,14,3,2490,2410,1640,-770
2019,5,14,4,2316,2364,1661,-703
2019,5,14,5,2138,2216,1744,-472
2019,5,14,6,1964,2023,1807,-216
2019,5,14,7,1894,1896,1776,-120
2019,5,14,8,1873,1820,1768,-52
2019,5,14,9,1868,1766,1726,-40
2019,5,14,10,1872,1750,1607,-143
2019,5,14,11,1943,1733,1574,-159
2019,5,14,12,2082,1802,1548,-254
2019,5,14,13,2192,1930,1520,-410
2019,5,14,14,2236,2033,1555,-478
2019,5,14,15,2265,2110,1651,-459
2019,5,14,16,2308,2170,1687,-483
2019,5,14,17,2354,2224,1735,-489
2019,5,14,18,2385,2262,1762,-500
2019,5,14,19,2435,2339,1814,-525
2019,5,14,20,2508,2397,1853,-544
2019,5,14,21,2577,2448,1893,-555
2019,5,14,22,2625,2460,1894,-566
2019,5,14,23,2666,2501,1899,-602
2019,5,15,0,2639,2478,1798,-680
2019,5,15,1,2622,2432,1746,-686
2019,5,15,2,2551,2379,1811,-568
2019,5,15,3,2469,2340,1919,-421
2019,5,15,4,2270,2308,1852,-456
2019,5,15,5,2069,2168,1829,-339
2019,5,15,6,1962,1993,1762,-231
2019,5,15,7,1884,1876,1739,-137
2019,5,15,8,1900,1798,1847,49
2019,5,15,9,1843,1754,1790,36
2019,5,15,10,1844,1717,1768,51
2019,5,15,11,1904,1730,1780,50
2019,5,15,12,2036,1784,1647,-137
2019,5,15,13,2158,1915,1535,-380
2019,5,15,14,2218,2041,1494,-547
2019,5,15,15,2271,2104,1471,-633
2019,5,15,16,2323,2130,1483,-647
2019,5,15,17,2361,2142,1569,-573
2019,5,15,18,2306,2157,1480,-677
2019,5,15,19,2318,2167,1489,-678
2019,5,15,20,2368,2178,1566,-612
2019,5,15,21,2396,2187,1636,-551
2019,5,15,22,2427,2183,1830,-353
2019,5,15,23,2387,2190,1861,-329
2019,5,16,0,2350,2176,1818,-358
2019,5,16,1,2312,2168,1992,-176
2019,5,16,2,2250,2157,2007,-150
2019,5,16,3,2215,2149,1719,-430
2019,5,16,4,2196,2147,1573,-574
2019,5,16,5,2010,2030,1632,-398
2019,5,16,6,1954,1890,1678,-212
2019,5,16,7,1875,1779,1668,-111
2019,5,16,8,1838,1721,1579,-142
2019,5,16,9,1758,1673,1424,-249
2019,5,16,10,1770,1667,1425,-242
2019,5,16,11,1849,1674,1461,-213
2019,5,16,12,1989,1741,1506,-235
2019,5,16,13,2118,1874,1548,-326
2019,5,16,14,2183,2005,1623,-382
2019,5,16,15,2221,2065,1632,-433
2019,5,16,16,2230,2097,1620,-477
2019,5,16,17,2235,2108,1629,-479
2019,5,16,18,2232,2105,1662,-443
2019,5,16,19,2236,2097,1742,-355
2019,5,16,20,2232,2085,1822,-263
2019,5,16,21,2222,2047,1848,-199
2019,5,16,22,2200,2013,1953,-60
2019,5,16,23,2136,2012,1856,-156
2019,5,17,0,2094,2004,1849,-155
2019,5,17,1,2097,2010,1882,-128
2019,5,17,2,2091,1987,1841,-146
2019,5,17,3,2108,1987,1627,-360
2019,5,17,4,2066,1990,1503,-487
2019,5,17,5,1928,1863,1522,-341
2019,5,17,6,1857,1747,1495,-252
2019,5,17,7,1810,1684,1422,-262
2019,5,17,8,1777,1639,1394,-245
2019,5,17,9,1716,1617,1402,-215
2019,5,17,10,1725,1607,1478,-129
2019,5,17,11,1811,1626,1577,-49
2019,5,17,12,1944,1704,1550,-154
2019,5,17,13,2074,1860,1611,-249
2019,5,17,14,2132,1961,1659,-302
2019,5,17,15,2164,1990,1767,-223
2019,5,17,16,2150,1983,1830,-153
2019,5,17,17,2136,1995,1897,-98
2019,5,17,18,2111,1974,1973,-1
2019,5,17,19,2092,1930,1927,-3
2019,5,17,20,2077,1907,2001,94
2019,5,17,21,2055,1855,1893,38
2019,5,17,22,2051,1823,1878,55
2019,5,17,23,1971,1801,1769,-32
2019,5,18,0,1950,1810,1795,-15
2019,5,18,1,1955,1810,1803,-7
2019,5,18,2,1977,1804,1852,48
2019,5,18,3,2004,1830,2066,236
2019,5,18,4,1958,1829,2074,245
2019,5,18,5,1863,1756,2059,303
2019,5,18,6,1854,1656,2016,360
2019,5,18,7,1800,1566,1835,269
2019,5,18,8,1751,1524,1788,264
2019,5,18,9,1604,1508,1816,308
2019,5,18,10,1601,1486,1817,331
2019,5,18,11,1638,1506,1899,393
2019,5,18,12,1700,1524,1972,448
2019,5,18,13,1790,1567,1940,373
2019,5,18,14,1906,1627,1898,271
2019,5,18,15,1978,1679,1899,220
2019,5,18,16,1984,1683,1974,291
2019,5,18,17,1932,1685,1931,246
2019,5,18,18,1888,1658,1956,298
2019,5,18,19,1829,1639,1920,281
2019,5,18,20,1788,1598,1852,254
2019,5,18,21,1765,1586,1840,254
2019,5,18,22,1758,1571,1788,217
2019,5,18,23,1808,1585,1778,193
2019,5,19,0,1859,1599,1743,144
2019,5,19,1,1920,1613,1684,71
2019,5,19,2,1899,1606,1615,9
2019,5,19,3,1875,1606,1582,-24
2019,5,19,4,1794,1641,1613,-28
2019,5,19,5,1680,1582,1666,84
2019,5,19,6,1881,1487,1791,304
2019,5,19,7,1822,1408,1841,433
2019,5,19,8,1705,1368,1783,415
2019,5,19,9,1464,1340,1758,418
2019,5,19,10,1460,1310,1694,384
2019,5,19,11,1490,1297,1608,311
2019,5,19,12,1547,1332,1611,279
2019,5,19,13,1580,1360,1601,241
2019,5,19,14,1660,1430,1599,169
2019,5,19,15,1762,1512,1627,115
2019,5,19,16,1768,1543,1717,174
2019,5,19,17,1713,1573,1754,181
2019,5,19,18,1678,1583,1866,283
2019,5,19,19,1652,1572,1734,162
2019,5,19,20,1639,1571,1740,169
2019,5,19,21,1633,1553,1592,39
2019,5,19,22,1656,1531,1416,-115
2019,5,19,23,1692,1553,1604,51
2019,5,20,0,1727,1598,1595,-3
2019,5,20,1,1757,1601,1649,48
2019,5,20,2,1773,1580,1557,-23
2019,5,20,3,1788,1594,1527,-67
2019,5,20,4,1712,1591,1516,-75
2019,5,20,5,1574,1512,1539,27
2019,5,20,6,1700,1396,1519,123
2019,5,20,7,1660,1333,1451,118
2019,5,20,8,1536,1296,1378,82
2019,5,20,9,1410,1273,1397,124
2019,5,20,10,1429,1281,1399,118
2019,5,20,11,1525,1320,1610,290
2019,5,20,12,1699,1417,1612,195
2019,5,20,13,1819,1559,1647,88
2019,5,20,14,1864,1667,1674,7
2019,5,20,15,1871,1691,1625,-66
2019,5,20,16,1872,1691,1590,-101
2019,5,20,17,1839,1690,1641,-49
2019,5,20,18,1818,1659,1665,6
2019,5,20,19,1786,1646,1688,42
2019,5,20,20,1754,1620,1693,73
2019,5,20,21,1736,1592,1696,104
2019,5,20,22,1722,1579,1636,57
2019,5,20,23,1741,1565,1670,105
2019,5,21,0,1771,1579,1662,83
2019,5,21,1,1790,1584,1631,47
2019,5,21,2,1762,1602,1644,42
2019,5,21,3,1745,1606,1630,24
2019,5,21,4,1655,1607,1642,35
2019,5,21,5,1538,1498,1608,110
2019,5,21,6,1663,1383,1661,278
2019,5,21,7,1623,1323,1645,322
2019,5,21,8,1530,1289,1601,312
2019,5,21,9,1387,1278,1616,338
2019,5,21,10,1418,1277,1629,352
2019,5,21,11,1510,1294,1725,431
2019,5,21,12,1671,1390,1925,535
2019,5,21,13,1760,1541,1983,442
2019,5,21,14,1760,1639,1814,175
2019,5,21,15,1776,1658,1877,219
2019,5,21,16,1781,1655,1778,123
2019,5,21,17,1782,1653,1759,106
2019,5,21,18,1760,1641,1826,185
2019,5,21,19,1736,1614,1933,319
2019,5,21,20,1701,1581,1930,349
2019,5,21,21,1677,1560,1951,391
2019,5,21,22,1684,1541,1952,411
2019,5,21,23,1691,1532,2016,484
2019,5,22,0,1708,1540,2146,606
2019,5,22,1,1725,1555,2215,660
2019,5,22,2,1726,1552,2148,596
2019,5,22,3,1709,1550,2110,560
2019,5,22,4,1611,1563,2035,472
2019,5,22,5,1481,1480,2113,633
2019,5,22,6,1593,1358,2117,759
2019,5,22,7,1551,1291,2086,795
2019,5,22,8,1442,1257,2073,816
2019,5,22,9,1366,1237,2016,779
2019,5,22,10,1383,1228,1947,719
2019,5,22,11,1474,1257,1884,627
2019,5,22,12,1626,1351,1858,507
2019,5,22,13,1723,1494,1848,354
2019,5,22,14,1721,1601,1866,265
2019,5,22,15,1744,1617,1842,225
2019,5,22,16,1752,1611,1919,308
2019,5,22,17,1749,1596,1864,268
2019,5,22,18,1728,1589,2028,439
2019,5,22,19,1696,1572,2059,487
2019,5,22,20,1673,1553,2084,531
2019,5,22,21,1666,1541,2117,576
2019,5,22,22,1640,1542,2061,519
2019,5,22,23,1637,1560,2143,583
2019,5,23,0,1679,1570,2225,655
2019,5,23,1,1700,1566,2187,621
2019,5,23,2,1715,1558,2162,604
2019,5,23,3,1715,1558,2148,590
2019,5,23,4,1634,1560,2009,449
2019,5,23,5,1500,1460,1959,499
2019,5,23,6,1498,1336,1888,552
2019,5,23,7,1464,1256,1844,588
2019,5,23,8,1378,1232,1811,579
2019,5,23,9,1338,1217,1915,698
2019,5,23,10,1355,1204,1907,703
2019,5,23,11,1454,1246,1933,687
2019,5,23,12,1607,1327,1939,612
2019,5,23,13,1711,1478,1966,488
2019,5,23,14,1709,1569,1968,399
2019,5,23,15,1714,1596,1990,394
2019,5,23,16,1714,1594,2040,446
2019,5,23,17,1734,1576,2149,573
2019,5,23,18,1721,1583,2229,646
2019,5,23,19,1722,1572,2228,656
2019,5,23,20,1708,1577,2265,688
2019,5,23,21,1722,1584,2257,673
2019,5,23,22,1742,1574,2234,660
2019,5,23,23,1768,1589,2164,575
2019,5,24,0,1773,1595,2089,494
2019,5,24,1,1772,1585,2076,491
2019,5,24,2,1752,1579,2095,516
2019,5,24,3,1711,1591,2074,483
2019,5,24,4,1621,1582,2014,432
2019,5,24,5,1472,1479,1985,506
2019,5,24,6,1464,1359,1979,620
2019,5,24,7,1420,1273,1973,700
2019,5,24,8,1346,1242,1965,723
2019,5,24,9,1340,1220,1915,695
2019,5,24,10,1365,1221,1899,678
2019,5,24,11,1457,1253,1921,668
2019,5,24,12,1605,1324,1895,571
2019,5,24,13,1707,1453,1859,406
2019,5,24,14,1711,1558,1919,361
2019,5,24,15,1697,1588,1995,407
2019,5,24,16,1703,1579,2084,505
2019,5,24,17,1725,1572,2026,454
2019,5,24,18,1717,1564,2030,466
2019,5,24,19,1704,1569,2058,489
2019,5,24,20,1697,1539,2020,481
2019,5,24,21,1690,1528,2036,508
2019,5,24,22,1662,1509,2262,753
2019,5,24,23,1630,1508,2173,665
2019,5,25,0,1630,1503,2168,665
2019,5,25,1,1628,1487,2083,596
2019,5,25,2,1615,1472,2046,574
2019,5,25,3,1613,1471,1872,401
2019,5,25,4,1552,1484,1845,361
2019,5,25,5,1456,1431,1855,424
2019,5,25,6,1417,1334,1833,499
2019,5,25,7,1377,1275,1835,560
2019,5,25,8,1340,1252,1845,593
2019,5,25,9,1341,1226,1835,609
2019,5,25,10,1362,1235,1844,609
2019,5,25,11,1397,1261,1866,605
2019,5,25,12,1452,1267,1841,574
2019,5,25,13,1530,1301,1839,538
2019,5,25,14,1580,1357,1844,487
2019,5,25,15,1582,1400,1767,367
2019,5,25,16,1550,1436,1795,359
2019,5,25,17,1528,1435,1856,421
2019,5,25,18,1510,1417,1864,447
2019,5,25,19,1504,1404,1929,525
2019,5,25,20,1513,1384,1982,598
2019,5,25,21,1539,1373,2026,653
2019,5,25,22,1538,1367,1969,602
2019,5,25,23,1550,1373,1969,596
2019,5,26,0,1572,1379,1871,492
2019,5,26,1,1583,1396,1956,560
2019,5,26,2,1556,1401,1897,496
2019,5,26,3,1552,1403,1872,469
2019,5,26,4,1505,1419,1870,451
2019,5,26,5,1402,1372,1891,519
2019,5,26,6,1366,1280,1882,602
2019,5,26,7,1327,1205,1924,719
2019,5,26,8,1298,1166,2048,882
2019,5,26,9,1272,1150,2088,938
2019,5,26,10,1281,1152,2096,944
2019,5,26,11,1306,1157,2026,869
2019,5,26,12,1337,1173,1981,808
2019,5,26,13,1387,1199,1989,790
2019,5,26,14,1452,1248,2042,794
2019,5,26,15,1493,1302,2046,744
2019,5,26,16,1500,1334,2059,725
2019,5,26,17,1505,1341,2194,853
2019,5,26,18,1523,1345,2235,890
2019,5,26,19,1542,1347,2109,762
2019,5,26,20,1553,1346,2050,704
2019,5,26,21,1567,1321,2082,761
2019,5,26,22,1590,1328,2241,913
2019,5,26,23,1586,1341,2081,740
2019,5,27,0,1598,1357,1999,642
2019,5,27,1,1591,1357,2082,725
2019,5,27,2,1571,1336,1985,649
2019,5,27,3,1517,1335,2008,673
2019,5,27,4,1431,1352,1982,630
2019,5,27,5,1255,1313,1978,665
2019,5,27,6,1339,1210,1942,732
2019,5,27,7,1297,1138,1942,804
2019,5,27,8,1246,1104,2031,927
2019,5,27,9,1233,1087,1981,894
2019,5,27,10,1257,1088,1934,846
2019,5,27,11,1344,1102,1941,839
2019,5,27,12,1480,1140,1944,804
2019,5,27,13,1553,1181,1954,773
2019,5,27,14,1529,1252,2001,749
2019,5,27,15,1452,1301,2060,759
2019,5,27,16,1421,1382,2292,910
2019,5,27,17,1450,1420,2394,974
2019,5,27,18,1509,1433,2393,960
2019,5,27,19,1561,1435,2348,913
2019,5,27,20,1587,1416,2301,885
2019,5,27,21,1606,1415,2324,909
2019,5,27,22,1606,1429,2297,868
2019,5,27,23,1634,1441,2080,639
2019,5,28,0,1690,1477,2048,571
2019,5,28,1,1670,1477,2024,547
2019,5,28,2,1626,1491,2008,517
2019,5,28,3,1600,1482,1929,447
2019,5,28,4,1538,1494,1926,432
2019,5,28,5,1409,1408,1934,526
2019,5,28,6,1363,1282,2155,873
2019,5,28,7,1326,1214,2034,820
2019,5,28,8,1269,1159,1944,785
2019,5,28,9,1262,1149,1916,767
2019,5,28,10,1284,1164,1958,794
2019,5,28,11,1348,1177,1973,796
2019,5,28,12,1458,1255,1996,741
2019,5,28,13,1536,1377,2011,634
2019,5,28,14,1548,1494,2103,609
2019,5,28,15,1591,1542,2219,677
2019,5,28,16,1632,1568,2239,671
2019,5,28,17,1699,1568,2257,689
2019,5,28,18,1740,1586,2237,651
2019,5,28,19,1787,1585,2223,638
2019,5,28,20,1811,1598,2198,600
2019,5,28,21,1831,1603,2163,560
2019,5,28,22,1845,1617,2139,522
2019,5,28,23,1868,1635,2102,467
2019,5,29,0,1867,1653,2101,448
2019,5,29,1,1860,1661,2080,419
2019,5,29,2,1804,1639,2110,471
2019,5,29,3,1730,1615,2035,420
2019,5,29,4,1576,1592,1973,381
2019,5,29,5,1428,1500,1954,454
2019,5,29,6,1404,1359,1903,544
2019,5,29,7,1344,1274,1966,692
2019,5,29,8,1278,1234,1965,731
2019,5,29,9,1302,1208,1932,724
2019,5,29,10,1310,1213,1930,717
2019,5,29,11,1378,1215,1893,678
2019,5,29,12,1483,1298,1895,597
2019,5,29,13,1593,1416,1906,490
2019,5,29,14,1629,1523,1942,419
2019,5,29,15,1645,1575,1949,374
2019,5,29,16,1674,1592,1961,369
2019,5,29,17,1720,1611,2036,425
2019,5,29,18,1742,1612,2072,460
2019,5,29,19,1731,1634,2103,469
2019,5,29,20,1840,1655,2109,454
2019,5,29,21,1870,1676,2066,390
2019,5,29,22,1894,1701,2045,344
2019,5,29,23,1947,1700,2064,364
2019,5,30,0,1982,1723,2098,375
2019,5,30,1,1958,1743,2043,300
2019,5,30,2,1913,1721,1961,240
2019,5,30,3,1808,1698,2109,411
2019,5,30,4,1608,1685,1981,296
2019,5,30,5,1392,1572,1934,362
2019,5,30,6,1417,1427,1936,509
2019,5,30,7,1346,1311,1897,586
2019,5,30,8,1200,1266,1870,604
2019,5,30,9,1305,1227,1830,603
2019,5,30,10,1333,1211,1821,610
2019,5,30,11,1382,1233,1828,595
2019,5,30,12,1469,1278,1828,550
2019,5,30,13,1565,1413,1864,451
2019,5,30,14,1599,1533,1957,424
2019,5,30,15,1639,1590,1968,378
2019,5,30,16,1684,1646,2058,412
2019,5,30,17,1778,1680,2076,396
2019,5,30,18,1840,1714,2114,400
2019,5,30,19,1906,1738,2146,408
2019,5,30,20,1916,1755,2121,366
2019,5,30,21,1942,1782,2133,351
2019,5,30,22,1981,1748,2140,392
2019,5,30,23,1999,1767,2001,234
2019,5,31,0,2113,1761,1961,200
2019,5,31,1,2041,1735,1989,254
2019,5,31,2,1969,1711,1950,239
2019,5,31,3,1835,1688,1866,178
2019,5,31,4,1652,1678,1832,154
2019,5,31,5,1437,1586,1825,239
2019,5,31,6,1387,1447,1804,357
2019,5,31,7,1337,1344,1818,474
2019,5,31,8,1303,1295,1833,538
2019,5,31,9,1400,1278,1860,582
2019,5,31,10,1395,1267,1861,594
2019,5,31,11,1446,1265,1854,589
2019,5,31,12,1547,1321,1847,526
2019,5,31,13,1654,1439,1865,426
2019,5,31,14,1702,1565,1970,405
2019,5,31,15,1747,1646,2078,432
2019,5,31,16,1773,1677,2108,431
2019,5,31,17,1872,1726,2140,414
2019,5,31,18,1926,1744,2107,363
2019,5,31,19,1979,1766,2089,323
2019,5,31,20,1991,1821,2084,263
2019,5,31,21,2030,1839,2084,245
2019,5,31,22,2068,1866,2095,229
2019,5,31,23,2017,1894,2153,259
2019,6,1,0,2002,1883,2066,183
2019,6,1,1,1974,1868,2055,187
2019,6,1,2,1964,1817,1998,181
2019,6,1,3,1885,1771,1980,209
2019,6,1,4,1773,1752,1934,182
2019,6,1,5,1599,1677,1860,183
2019,6,1,6,1471,1545,1886,341
2019,6,1,7,1392,1503,1931,428
2019,6,1,8,1394,1360,1855,495
2019,6,1,9,1366,1320,1837,517
2019,6,1,10,1373,1299,1840,541
2019,6,1,11,1385,1287,1835,548
2019,6,1,12,1413,1302,1851,549
2019,6,1,13,1506,1344,1884,540
2019,6,1,14,1652,1435,1963,528
2019,6,1,15,1758,1531,2042,511
2019,6,1,16,1828,1590,2042,452
2019,6,1,17,1886,1664,2074,410
2019,6,1,18,1935,1704,2083,379
2019,6,1,19,1992,1749,2065,316
2019,6,1,20,1994,1780,2072,292
2019,6,1,21,2075,1804,2074,270
2019,6,1,22,2126,1832,2026,194
2019,6,1,23,2144,1887,2026,139
2019,6,2,0,2133,1927,2003,76
2019,6,2,1,2093,1940,2011,71
2019,6,2,2,2022,1912,1929,17
2019,6,2,3,1934,1864,1819,-45
2019,6,2,4,1823,1840,1803,-37
2019,6,2,5,1656,1745,1801,56
2019,6,2,6,1531,1599,1799,200
2019,6,2,7,1443,1477,1800,323
2019,6,2,8,1426,1405,1832,427
2019,6,2,9,1401,1343,1878,535
2019,6,2,10,1385,1314,1816,502
2019,6,2,11,1397,1295,1833,538
2019,6,2,12,1400,1303,1822,519
2019,6,2,13,1504,1325,1855,530
2019,6,2,14,1658,1385,1937,552
2019,6,2,15,1750,1486,1982,496
2019,6,2,16,1807,1560,2016,456
2019,6,2,17,1835,1618,2062,444
2019,6,2,18,1910,1683,2085,402
2019,6,2,19,1982,1740,2076,336
2019,6,2,20,2040,1804,2050,246
2019,6,2,21,2086,1875,2093,218
2019,6,2,22,2158,1920,2120,200
2019,6,2,23,2248,1981,2064,83
2019,6,3,0,2305,2038,2210,172
2019,6,3,1,2256,2064,2123,59
2019,6,3,2,2176,2049,1933,-116
2019,6,3,3,2028,2003,1810,-193
2019,6,3,4,1868,1959,1781,-178
2019,6,3,5,1655,1842,1797,-45
2019,6,3,6,1593,1654,1816,162
2019,6,3,7,1506,1514,1782,268
2019,6,3,8,1485,1446,1827,381
2019,6,3,9,1432,1389,1817,428
2019,6,3,10,1440,1374,1787,413
2019,6,3,11,1506,1334,1481,147
2019,6,3,12,1603,1384,1497,113
2019,6,3,13,1707,1500,1637,137
2019,6,3,14,1870,1664,1827,163
2019,6,3,15,1990,1791,1966,175
2019,6,3,16,2042,1906,2021,115
2019,6,3,17,2114,2001,2015,14
2019,6,3,18,2216,2074,2012,-62
2019,6,3,19,2334,2154,2005,-149
2019,6,3,20,2427,2203,1988,-215
2019,6,3,21,2493,2272,2145,-127
2019,6,3,22,2525,2316,2106,-210
2019,6,3,23,2561,2339,1886,-453
2019,6,4,0,2509,2365,1955,-410
2019,6,4,1,2454,2377,1959,-418
2019,6,4,2,2408,2339,1996,-343
2019,6,4,3,2334,2276,1882,-394
2019,6,4,4,2144,2176,1904,-272
2019,6,4,5,1894,2041,1888,-153
2019,6,4,6,1693,1851,2032,181
2019,6,4,7,1598,1702,1895,193
2019,6,4,8,1563,1614,1896,282
2019,6,4,9,1586,1558,1897,339
2019,6,4,10,1562,1537,1905,368
2019,6,4,11,1623,1520,1899,379
2019,6,4,12,1769,1572,1922,350
2019,6,4,13,1932,1676,1943,267
2019,6,4,14,1996,1818,2038,220
2019,6,4,15,2045,1918,2148,230
2019,6,4,16,2097,1989,2157,168
2019,6,4,17,2198,2069,2148,79
2019,6,4,18,2276,2117,2129,12
2019,6,4,19,2367,2180,2150,-30
2019,6,4,20,2465,2233,2161,-72
2019,6,4,21,2534,2284,2174,-110
2019,6,4,22,2569,2347,2225,-122
2019,6,4,23,2621,2389,2212,-177
2019,6,5,0,2627,2431,2264,-167
2019,6,5,1,2614,2474,2341,-133
2019,6,5,2,2536,2465,2368,-97
2019,6,5,3,2430,2373,2169,-204
2019,6,5,4,2229,2270,2012,-258
2019,6,5,5,1960,2129,1963,-166
2019,6,5,6,1750,1927,1933,6
2019,6,5,7,1649,1781,1963,182
2019,6,5,8,1642,1678,2069,391
2019,6,5,9,1647,1611,2021,410
2019,6,5,10,1626,1588,1979,391
2019,6,5,11,1686,1581,1963,382
2019,6,5,12,1811,1600,1949,349
2019,6,5,13,1972,1722,1914,192
2019,6,5,14,2058,1854,1987,133
2019,6,5,15,2121,1963,2044,81
2019,6,5,16,2178,2045,2066,21
2019,6,5,17,2256,2093,2029,-64
2019,6,5,18,2317,2149,1940,-209
2019,6,5,19,2370,2208,1938,-270
2019,6,5,20,2428,2273,2005,-268
2019,6,5,21,2507,2365,1983,-382
2019,6,5,22,2602,2447,2020,-427
2019,6,5,23,2698,2530,2028,-502
2019,6,6,0,2734,2604,2052,-552
2019,6,6,1,2770,2642,2032,-610
2019,6,6,2,2702,2645,1941,-704
2019,6,6,3,2622,2573,1852,-721
2019,6,6,4,2442,2479,1812,-667
2019,6,6,5,2213,2329,1885,-444
2019,6,6,6,1968,2098,1918,-180
2019,6,6,7,1849,1940,2030,90
2019,6,6,8,1798,1841,2080,239
2019,6,6,9,1799,1762,2036,274
2019,6,6,10,1776,1719,2015,296
2019,6,6,11,1841,1707,1999,292
2019,6,6,12,1948,1742,1948,206
2019,6,6,13,2075,1829,1986,157
2019,6,6,14,2158,1978,2106,128
2019,6,6,15,2199,2096,2118,22
2019,6,6,16,2237,2149,2060,-89
2019,6,6,17,2295,2217,1990,-227
2019,6,6,18,2334,2266,1980,-286
2019,6,6,19,2384,2317,1984,-333
2019,6,6,20,2474,2369,2003,-366
2019,6,6,21,2538,2411,2010,-401
2019,6,6,22,2595,2408,1981,-427
2019,6,6,23,2616,2360,2063,-297
2019,6,7,0,2567,2316,2292,-24
2019,6,7,1,2362,2253,2345,92
2019,6,7,2,2156,2175,2239,64
2019,6,7,3,2058,2125,2175,50
2019,6,7,4,1995,2085,2204,119
2019,6,7,5,1921,1985,2219,234
2019,6,7,6,1668,1857,2185,328
2019,6,7,7,1603,1760,2210,450
2019,6,7,8,1612,1698,2100,402
2019,6,7,9,1748,1660,2024,364
2019,6,7,10,1746,1642,2021,379
2019,6,7,11,1797,1650,2013,363
2019,6,7,12,1905,1695,1960,265
2019,6,7,13,2069,1785,1909,124
2019,6,7,14,2175,1913,1993,80
2019,6,7,15,2166,2001,2060,59
2019,6,7,16,2126,2045,2138,93
2019,6,7,17,2109,2064,2213,149
2019,6,7,18,2097,2064,2221,157
2019,6,7,19,2071,2051,2246,195
2019,6,7,20,2068,2027,2294,267
2019,6,7,21,2059,2005,2364,359
2019,6,7,22,2078,1974,2293,319
2019,6,7,23,1996,1955,2228,273
2019,6,8,0,2000,1938,2292,354
2019,6,8,1,1971,1938,2266,328
2019,6,8,2,2011,1935,2303,368
2019,6,8,3,2057,1916,2245,329
2019,6,8,4,2056,1923,2080,157
2019,6,8,5,1952,1882,2101,219
2019,6,8,6,1644,1789,2084,295
2019,6,8,7,1598,1702,2046,344
2019,6,8,8,1736,1655,1963,308
2019,6,8,9,1755,1631,1919,288
2019,6,8,10,1759,1612,1897,285
2019,6,8,11,1785,1623,1922,299
2019,6,8,12,1812,1652,1987,335
2019,6,8,13,1902,1705,2004,299
2019,6,8,14,2019,1787,2113,326
2019,6,8,15,2057,1876,2219,343
2019,6,8,16,2038,1906,2270,364
2019,6,8,17,1969,1908,2239,331
2019,6,8,18,1936,1879,2153,274
2019,6,8,19,1901,1865,2116,251
2019,6,8,20,1895,1843,2233,390
2019,6,8,21,1895,1834,2231,397
2019,6,8,22,1917,1830,2261,431
2019,6,8,23,1934,1823,2261,438
2019,6,9,0,1958,1857,2222,365
2019,6,9,1,1983,1859,2229,370
2019,6,9,2,1986,1865,2147,282
2019,6,9,3,1986,1855,1932,77
2019,6,9,4,1948,1870,1862,-8
2019,6,9,5,1851,1831,1832,1
2019,6,9,6,1770,1726,1739,13
2019,6,9,7,1712,1642,1724,82
2019,6,9,8,1685,1588,1688,100
2019,6,9,9,1652,1555,1641,86
2019,6,9,10,1644,1544,1624,80
2019,6,9,11,1673,1536,1646,110
2019,6,9,12,1686,1566,1662,96
2019,6,9,13,1768,1580,1710,130
2019,6,9,14,1871,1639,1873,234
2019,6,9,15,1943,1692,1872,180
2019,6,9,16,1937,1720,1748,28
2019,6,9,17,1887,1729,1773,44
2019,6,9,18,1860,1744,1859,115
2019,6,9,19,1849,1746,1882,136
2019,6,9,20,1860,1744,1934,190
2019,6,9,21,1878,1758,1984,226
2019,6,9,22,1905,1774,1983,209
2019,6,9,23,1970,1819,1984,165
2019,6,10,0,2048,1883,1932,49
2019,6,10,1,2086,1915,1887,-28
2019,6,10,2,2086,1933,1795,-138
2019,6,10,3,2035,1905,1704,-201
2019,6,10,4,1968,1907,1705,-202
2019,6,10,5,1792,1818,1697,-121
2019,6,10,6,1777,1681,1703,22
2019,6,10,7,1704,1581,1726,145
2019,6,10,8,1629,1507,1641,134
2019,6,10,9,1548,1482,1645,163
2019,6,10,10,1553,1472,1635,163
2019,6,10,11,1636,1498,1648,150
2019,6,10,12,1759,1574,1740,166
2019,6,10,13,1902,1685,1747,62
2019,6,10,14,2088,1837,1859,22
2019,6,10,15,2166,1935,1932,-3
2019,6,10,16,2258,2001,1901,-100
2019,6,10,17,2269,2045,1893,-152
2019,6,10,18,2318,2103,1952,-151
2019,6,10,19,2345,2146,1969,-177
2019,6,10,20,2447,2182,1990,-192
2019,6,10,21,2492,2231,2045,-186
2019,6,10,22,2509,2275,2167,-108
2019,6,10,23,2539,2325,2232,-93
2019,6,11,0,2579,2394,2310,-84
2019,6,11,1,2606,2400,2327,-73
2019,6,11,2,2584,2438,2433,-5
2019,6,11,3,2444,2407,2450,43
2019,6,11,4,2276,2338,2449,111
2019,6,11,5,2058,2233,2405,172
2019,6,11,6,2020,2026,2327,301
2019,6,11,7,1901,1884,2136,252
2019,6,11,8,1841,1771,2077,306
2019,6,11,9,1756,1716,2025,309
2019,6,11,10,1764,1696,1969,273
2019,6,11,11,1838,1686,1955,269
2019,6,11,12,1960,1736,1934,198
2019,6,11,13,2102,1841,1957,116
2019,6,11,14,2185,1984,2076,92
2019,6,11,15,2301,2083,2040,-43
2019,6,11,16,2412,2133,1774,-359
2019,6,11,17,2512,2200,1768,-432
2019,6,11,18,2564,2274,1774,-500
2019,6,11,19,2630,2326,1922,-404
2019,6,11,20,2702,2413,1980,-433
2019,6,11,21,2766,2504,2026,-478
2019,6,11,22,2810,2555,2044,-511
2019,6,11,23,2856,2624,2090,-534
2019,6,12,0,2857,2693,2172,-521
2019,6,12,1,2895,2731,2182,-549
2019,6,12,2,2850,2729,2102,-627
2019,6,12,3,2752,2686,1965,-721
2019,6,12,4,2524,2592,2182,-410
2019,6,12,5,2263,2435,2197,-238
2019,6,12,6,2197,2215,2162,-53
2019,6,12,7,2064,2029,2011,-18
2019,6,12,8,1960,1923,1836,-87
2019,6,12,9,1922,1858,1808,-50
2019,6,12,10,1913,1813,1775,-38
2019,6,12,11,1963,1790,1707,-83
2019,6,12,12,2060,1831,1633,-198
2019,6,12,13,2201,1930,1758,-172
2019,6,12,14,2312,2081,1862,-219
2019,6,12,15,2447,2212,1910,-302
2019,6,12,16,2598,2310,1854,-456
2019,6,12,17,2716,2416,1865,-551
2019,6,12,18,2798,2501,1871,-630
2019,6,12,19,2860,2604,1897,-707
2019,6,12,20,3020,2692,1868,-824
2019,6,12,21,2984,2798,1892,-906
2019,6,12,22,3001,2858,2018,-840
2019,6,12,23,3049,2903,2081,-822
2019,6,13,0,3144,2934,2068,-866
2019,6,13,1,3134,2914,2097,-817
2019,6,13,2,3058,2843,1919,-924
2019,6,13,3,2938,2763,1847,-916
2019,6,13,4,2750,2654,1813,-841
2019,6,13,5,2470,2480,1861,-619
2019,6,13,6,2370,2260,2087,-173
2019,6,13,7,2199,2092,2104,12
2019,6,13,8,2139,1979,1958,-21
2019,6,13,9,1994,1915,1945,30
2019,6,13,10,1942,1862,1827,-35
2019,6,13,11,1955,1843,1790,-53
2019,6,13,12,2150,1883,1751,-132
2019,6,13,13,2275,1979,1759,-220
2019,6,13,14,2352,2119,1765,-354
2019,6,13,15,2414,2282,1869,-413
2019,6,13,16,2565,2398,1967,-431
2019,6,13,17,2658,2487,2005,-482
2019,6,13,18,2750,2564,1947,-617
2019,6,13,19,2796,2658,1941,-717
2019,6,13,20,2847,2727,1926,-801
2019,6,13,21,2898,2810,1993,-817
2019,6,13,22,2972,2879,2076,-803
2019,6,13,23,3043,2935,2095,-840
2019,6,14,0,3100,2954,2243,-711
2019,6,14,1,3032,2932,2347,-585
2019,6,14,2,2967,2926,2311,-615
2019,6,14,3,2852,2868,2320,-548
2019,6,14,4,2696,2682,2248,-434
2019,6,14,5,2455,2544,2171,-373
2019,6,14,6,2284,2332,2023,-309
2019,6,14,7,2171,2163,2142,-21
2019,6,14,8,2124,2072,2165,93
2019,6,14,9,2025,1986,2050,64
2019,6,14,10,2009,1928,1983,55
2019,6,14,11,2032,1903,1861,-42
2019,6,14,12,2116,1927,1864,-63
2019,6,14,13,2275,2021,1867,-154
2019,6,14,14,2392,2186,1929,-257
2019,6,14,15,2483,2303,1893,-410
2019,6,14,16,2559,2387,1914,-473
2019,6,14,17,2629,2469,2001,-468
2019,6,14,18,2716,2543,2089,-454
2019,6,14,19,2794,2605,2068,-537
2019,6,14,20,2866,2689,2094,-595
2019,6,14,21,2932,2745,2145,-600
2019,6,14,22,2991,2799,2249,-550
2019,6,14,23,2991,2829,2312,-517
2019,6,15,0,2915,2846,2336,-510
2019,6,15,1,2874,2862,2421,-441
2019,6,15,2,2875,2849,2471,-378
2019,6,15,3,2797,2758,2306,-452
2019,6,15,4,2706,2647,2207,-440
2019,6,15,5,2431,2521,2017,-504
2019,6,15,6,2178,2307,1938,-369
2019,6,15,7,2054,2141,1834,-307
2019,6,15,8,2000,2004,1778,-226
2019,6,15,9,1945,1925,1785,-140
2019,6,15,10,1903,1872,1680,-192
2019,6,15,11,1893,1833,1600,-233
2019,6,15,12,1898,1837,1674,-163
2019,6,15,13,2028,1870,1693,-177
2019,6,15,14,2238,1989,1801,-188
2019,6,15,15,2370,2128,1863,-265
2019,6,15,16,2434,2228,1948,-280
2019,6,15,17,2463,2304,2152,-152
2019,6,15,18,2549,2371,2237,-134
2019,6,15,19,2608,2433,2294,-139
2019,6,15,20,2663,2498,2343,-155
2019,6,15,21,2757,2550,2370,-180
2019,6,15,22,2866,2600,2374,-226
2019,6,15,23,2926,2668,2545,-123
2019,6,16,0,2922,2709,2572,-137
2019,6,16,1,2886,2735,2568,-167
2019,6,16,2,2817,2723,2506,-217
2019,6,16,3,2660,2673,2351,-322
2019,6,16,4,2479,2560,2271,-289
2019,6,16,5,2253,2442,2190,-252
2019,6,16,6,2177,2241,2131,-110
2019,6,16,7,2056,2082,1965,-117
2019,6,16,8,1824,1974,1980,6
2019,6,16,9,1887,1911,1950,39
2019,6,16,10,1867,1869,1872,3
2019,6,16,11,1871,1830,1845,15
2019,6,16,12,1870,1831,1801,-30
2019,6,16,13,2008,1832,1820,-12
2019,6,16,14,2236,1918,1934,16
2019,6,16,15,2347,2029,1953,-76
2019,6,16,16,2389,2113,1981,-132
2019,6,16,17,2420,2184,1975,-209
2019,6,16,18,2506,2259,2004,-255
2019,6,16,19,2571,2331,2027,-304
2019,6,16,20,2623,2399,2050,-349
2019,6,16,21,2697,2494,2099,-395
2019,6,16,22,2794,2569,2122,-447
2019,6,16,23,2886,2654,2196,-458
2019,6,17,0,2938,2706,2195,-511
2019,6,17,1,2905,2729,2210,-519
2019,6,17,2,2835,2708,2143,-565
2019,6,17,3,2662,2651,1960,-691
2019,6,17,4,2480,2550,1940,-610
2019,6,17,5,2200,2418,1878,-540
2019,6,17,6,2088,2201,1783,-418
2019,6,17,7,1952,2045,1720,-325
2019,6,17,8,1791,1945,1661,-284
2019,6,17,9,1864,1882,1668,-214
2019,6,17,10,1863,1849,1702,-147
2019,6,17,11,1918,1850,1749,-101
2019,6,17,12,2028,1893,1769,-124
2019,6,17,13,2235,2006,1807,-199
2019,6,17,14,2528,2197,1896,-301
2019,6,17,15,2618,2349,1971,-378
2019,6,17,16,2716,2462,2015,-447
2019,6,17,17,2731,2561,2018,-543
2019,6,17,18,2874,2643,1998,-645
2019,6,17,19,2971,2739,1987,-752
2019,6,17,20,3088,2833,1977,-856
2019,6,17,21,3212,2918,2090,-828
2019,6,17,22,3313,2978,2208,-770
2019,6,17,23,3325,3025,2342,-683
2019,6,18,0,3286,3052,2459,-593
2019,6,18,1,3219,3056,2496,-560
2019,6,18,2,3105,3047,2447,-600
2019,6,18,3,2916,2955,2151,-804
2019,6,18,4,2678,2843,1976,-867
2019,6,18,5,2383,2669,1793,-876
2019,6,18,6,2207,2454,1752,-702
2019,6,18,7,2043,2256,1686,-570
2019,6,18,8,1903,2138,1656,-482
2019,6,18,9,2017,2055,1670,-385
2019,6,18,10,2025,2005,1648,-357
2019,6,18,11,2067,1987,1697,-290
2019,6,18,12,2165,2017,1712,-305
2019,6,18,13,2357,2108,1719,-389
2019,6,18,14,2457,2254,1834,-420
2019,6,18,15,2534,2407,1991,-416
2019,6,18,16,2620,2504,2054,-450
2019,6,18,17,2747,2578,2085,-493
2019,6,18,18,2871,2664,2165,-499
2019,6,18,19,2973,2728,2265,-463
2019,6,18,20,3098,2802,2303,-499
2019,6,18,21,3227,2877,2352,-525
2019,6,18,22,3342,2937,2417,-520
2019,6,18,23,3360,2988,2501,-487
2019,6,19,0,3331,3038,2535,-503
2019,6,19,1,3241,3050,2628,-422
2019,6,19,2,3099,3045,2529,-516
2019,6,19,3,2887,2955,2192,-763
2019,6,19,4,2650,2851,2000,-851
2019,6,19,5,2345,2696,1921,-775
2019,6,19,6,2141,2455,1818,-637
2019,6,19,7,1990,2274,1828,-446
2019,6,19,8,1874,2158,1872,-286
2019,6,19,9,2008,2071,1934,-137
2019,6,19,10,2009,2027,1999,-28
2019,6,19,11,2059,2015,2026,11
2019,6,19,12,2198,2039,2024,-15
2019,6,19,13,2389,2115,2086,-29
2019,6,19,14,2442,2267,2037,-230
2019,6,19,15,2534,2366,2139,-227
2019,6,19,16,2622,2426,2216,-210
2019,6,19,17,2807,2468,2194,-274
2019,6,19,18,2894,2479,2184,-295
2019,6,19,19,2952,2509,2280,-229
2019,6,19,20,2990,2538,2390,-148
2019,6,19,21,3010,2561,2446,-115
2019,6,19,22,3009,2598,2465,-133
2019,6,19,23,2968,2632,2531,-101
2019,6,20,0,2763,2691,2612,-79
2019,6,20,1,2708,2686,2600,-86
2019,6,20,2,2620,2670,2556,-114
2019,6,20,3,2501,2607,2361,-246
2019,6,20,4,2368,2522,2229,-293
2019,6,20,5,2156,2430,2211,-219
2019,6,20,6,2033,2253,2183,-70
2019,6,20,7,1910,2116,2115,-1
2019,6,20,8,1913,2018,2109,91
2019,6,20,9,1978,1965,2034,69
2019,6,20,10,1996,1946,2054,108
2019,6,20,11,2062,1949,2048,99
2019,6,20,12,2155,1998,2088,90
2019,6,20,13,2333,2081,2089,8
2019,6,20,14,2428,2224,2090,-134
2019,6,20,15,2467,2297,2159,-138
2019,6,20,16,2443,2347,2236,-111
2019,6,20,17,2422,2344,2099,-245
2019,6,20,18,2416,2357,2225,-132
2019,6,20,19,2402,2343,2163,-180
2019,6,20,20,2427,2331,2185,-146
2019,6,20,21,2487,2312,2141,-171
2019,6,20,22,2561,2301,2182,-119
2019,6,20,23,2563,2306,2347,41
2019,6,21,0,2510,2296,2331,35
2019,6,21,1,2426,2305,2486,181
2019,6,21,2,2313,2292,2479,187
2019,6,21,3,2220,2285,2366,81
2019,6,21,4,2137,2299,2228,-71
2019,6,21,5,1975,2239,2128,-111
2019,6,21,6,1957,2101,1976,-125
2019,6,21,7,1877,2020,1882,-138
2019,6,21,8,1739,1967,1954,-13
2019,6,21,9,1972,1929,1997,68
2019,6,21,10,2006,1906,1970,64
2019,6,21,11,2074,1910,1969,59
2019,6,21,12,2147,1962,1992,30
2019,6,21,13,2300,2069,2015,-54
2019,6,21,14,2421,2213,2031,-182
2019,6,21,15,2457,2307,1996,-311
2019,6,21,16,2420,2361,1995,-366
2019,6,21,17,2376,2383,2065,-318
2019,6,21,18,2378,2402,2209,-193
2019,6,21,19,2378,2400,2155,-245
2019,6,21,20,2412,2389,2126,-263
2019,6,21,21,2485,2386,2229,-157
2019,6,21,22,2594,2366,2331,-35
2019,6,21,23,2606,2343,2372,29
2019,6,22,0,2574,2346,2345,-1
2019,6,22,1,2474,2353,2432,79
2019,6,22,2,2369,2367,2343,-24
2019,6,22,3,2243,2352,2269,-83
2019,6,22,4,2270,2359,2005,-354
2019,6,22,5,2108,2318,1967,-351
2019,6,22,6,1953,2199,1930,-269
2019,6,22,7,1880,2092,1973,-119
2019,6,22,8,1932,2030,1987,-43
2019,6,22,9,2060,1993,1981,-12
2019,6,22,10,2052,1960,1966,6
2019,6,22,11,2065,1954,1989,35
2019,6,22,12,2072,1960,1988,28
2019,6,22,13,2188,2000,2012,12
2019,6,22,14,2364,2103,2062,-41
2019,6,22,15,2450,2212,2159,-53
2019,6,22,16,2454,2246,2095,-151
2019,6,22,17,2414,2284,2068,-216
2019,6,22,18,2417,2294,2100,-194
2019,6,22,19,2434,2299,2135,-164
2019,6,22,20,2431,2286,2166,-120
2019,6,22,21,2470,2300,2204,-96
2019,6,22,22,2528,2333,2258,-75
2019,6,22,23,2579,2356,2383,27
2019,6,23,0,2585,2395,2480,85
2019,6,23,1,2587,2428,2473,45
2019,6,23,2,2554,2424,2324,-100
2019,6,23,3,2481,2397,2165,-232
2019,6,23,4,2397,2374,2001,-373
2019,6,23,5,2224,2333,1930,-403
2019,6,23,6,2101,2200,1872,-328
2019,6,23,7,2023,2079,1879,-200
2019,6,23,8,2029,2008,1927,-81
2019,6,23,9,2022,1966,1925,-41
2019,6,23,10,1996,1931,1863,-68
2019,6,23,11,2000,1917,1890,-27
2019,6,23,12,1998,1910,1895,-15
2019,6,23,13,2096,1915,1906,-9
2019,6,23,14,2250,1974,1923,-51
2019,6,23,15,2336,2080,1984,-96
2019,6,23,16,2352,2095,1961,-134
2019,6,23,17,2356,2182,2065,-117
2019,6,23,18,2379,2227,2216,-11
2019,6,23,19,2404,2252,2306,54
2019,6,23,20,2410,2285,2422,137
2019,6,23,21,2444,2321,2515,194
2019,6,23,22,2490,2348,2508,160
2019,6,23,23,2569,2411,2613,202
2019,6,24,0,2579,2458,2612,154
2019,6,24,1,2598,2484,2612,128
2019,6,24,2,2553,2471,2461,-10
2019,6,24,3,2476,2429,2278,-151
2019,6,24,4,2381,2369,2026,-343
2019,6,24,5,2207,2290,2004,-286
2019,6,24,6,2102,2117,2000,-117
2019,6,24,7,2027,1975,1870,-105
2019,6,24,8,1996,1912,1798,-114
2019,6,24,9,1949,1863,1738,-125
2019,6,24,10,1944,1844,1773,-71
2019,6,24,11,2002,1852,1785,-67
2019,6,24,12,2114,1905,1784,-121
2019,6,24,13,2274,2024,1755,-269
2019,6,24,14,2561,2185,1853,-332
2019,6,24,15,2605,2309,1913,-396
2019,6,24,16,2632,2385,2028,-357
2019,6,24,17,2541,2441,2012,-429
2019,6,24,18,2584,2471,2009,-462
2019,6,24,19,2617,2506,2118,-388
2019,6,24,20,2652,2546,2161,-385
2019,6,24,21,2681,2578,2262,-316
2019,6,24,22,2723,2630,2262,-368
2019,6,24,23,2785,2671,2283,-388
2019,6,25,0,2806,2733,2364,-369
2019,6,25,1,2841,2770,2312,-458
2019,6,25,2,2831,2798,2255,-543
2019,6,25,3,2778,2766,2074,-692
2019,6,25,4,2667,2684,1992,-692
2019,6,25,5,2483,2573,1948,-625
2019,6,25,6,2395,2384,1902,-482
2019,6,25,7,2329,2237,1770,-467
2019,6,25,8,2270,2141,1705,-436
2019,6,25,9,2212,2082,1773,-309
2019,6,25,10,2187,2044,1736,-308
2019,6,25,11,2230,2027,1708,-319
2019,6,25,12,2328,2073,1763,-310
2019,6,25,13,2471,2158,1787,-371
2019,6,25,14,2465,2300,1853,-447
2019,6,25,15,2535,2409,1958,-451
2019,6,25,16,2684,2472,2016,-456
2019,6,25,17,2744,2544,2025,-519
2019,6,25,18,2793,2609,2052,-557
2019,6,25,19,2838,2660,2047,-613
2019,6,25,20,2907,2740,2022,-718
2019,6,25,21,2970,2798,2022,-776
2019,6,25,22,3036,2852,2031,-821
2019,6,25,23,3081,2871,2001,-870
2019,6,26,0,3103,2882,1947,-935
2019,6,26,1,3062,2858,1860,-998
2019,6,26,2,2960,2851,1993,-858
2019,6,26,3,2809,2793,2168,-625
2019,6,26,4,2644,2763,2154,-609
2019,6,26,5,2456,2665,2084,-581
2019,6,26,6,2378,2452,1968,-484
2019,6,26,7,2275,2296,1909,-387
2019,6,26,8,2322,2208,2011,-197
2019,6,26,9,2190,2136,2063,-73
2019,6,26,10,2173,2101,1964,-137
2019,6,26,11,2211,2072,1868,-204
2019,6,26,12,2309,2109,1846,-263
2019,6,26,13,2467,2207,1782,-425
2019,6,26,14,2587,2337,1785,-552
2019,6,26,15,2692,2436,1793,-643
2019,6,26,16,2768,2514,1796,-718
2019,6,26,17,2846,2556,1809,-747
2019,6,26,18,2897,2616,1967,-649
2019,6,26,19,2867,2666,2033,-633
2019,6,26,20,2947,2747,2075,-672
2019,6,26,21,3028,2816,2144,-672
2019,6,26,22,3109,2888,2153,-735
2019,6,26,23,3141,2960,2121,-839
2019,6,27,0,3145,2993,2029,-964
2019,6,27,1,3145,3036,2021,-1015
2019,6,27,2,3092,3013,2139,-874
2019,6,27,3,3001,2948,2113,-835
2019,6,27,4,2862,2876,2124,-752
2019,6,27,5,2630,2738,2142,-596
2019,6,27,6,2523,2527,2033,-494
2019,6,27,7,2404,2371,2003,-368
2019,6,27,8,2313,2258,1901,-357
2019,6,27,9,2159,2188,1955,-233
2019,6,27,10,2139,2115,1940,-175
2019,6,27,11,2160,2085,1899,-186
2019,6,27,12,2228,2114,2063,-51
2019,6,27,13,2390,2213,2146,-67
2019,6,27,14,2519,2341,2002,-339
2019,6,27,15,2620,2455,1982,-473
2019,6,27,16,2675,2515,1991,-524
2019,6,27,17,2743,2578,1960,-618
2019,6,27,18,2806,2650,1935,-715
2019,6,27,19,2887,2679,1913,-766
2019,6,27,20,2975,2731,1803,-928
2019,6,27,21,3038,2777,1753,-1024
2019,6,27,22,3110,2831,1724,-1107
2019,6,27,23,3132,2865,1701,-1164
2019,6,28,0,3135,2896,1816,-1080
2019,6,28,1,3082,2925,1789,-1136
2019,6,28,2,2987,2903,1812,-1091
2019,6,28,3,2893,2870,1800,-1070
2019,6,28,4,2773,2800,1816,-984
2019,6,28,5,2571,2687,1771,-916
2019,6,28,6,2425,2481,1729,-752
2019,6,28,7,2327,2324,1658,-666
2019,6,28,8,2231,2215,1582,-633
2019,6,28,9,2173,2145,1655,-490
2019,6,28,10,2156,2099,1749,-350
2019,6,28,11,2201,2078,1668,-410
2019,6,28,12,2301,2108,1638,-470
2019,6,28,13,2462,2193,1592,-601
2019,6,28,14,2556,2342,1794,-548
2019,6,28,15,2607,2444,1764,-680
2019,6,28,16,2650,2496,1821,-675
2019,6,28,17,2705,2517,1814,-703
2019,6,28,18,2739,2549,1815,-734
2019,6,28,19,2766,2564,1805,-759
2019,6,28,20,2793,2577,1759,-818
2019,6,28,21,2831,2581,1785,-796
2019,6,28,22,2853,2593,1865,-728
2019,6,28,23,2831,2587,2022,-565
2019,6,29,0,2801,2605,2126,-479
2019,6,29,1,2748,2607,2119,-488
2019,6,29,2,2671,2616,2076,-540
2019,6,29,3,2586,2596,1938,-658
2019,6,29,4,2468,2571,1753,-818
2019,6,29,5,2278,2516,1633,-883
2019,6,29,6,2329,2378,1588,-790
2019,6,29,7,2213,2263,1724,-539
2019,6,29,8,1975,2184,1651,-533
2019,6,29,9,2077,2117,1606,-511
2019,6,29,10,2073,2071,1587,-484
2019,6,29,11,2071,2043,1592,-451
2019,6,29,12,2084,2038,1576,-462
2019,6,29,13,2219,2056,1580,-476
2019,6,29,14,2403,2160,1685,-475
2019,6,29,15,2531,2293,1783,-510
2019,6,29,16,2613,2377,1788,-589
2019,6,29,17,2651,2432,1790,-642
2019,6,29,18,2704,2487,1789,-698
2019,6,29,19,2761,2542,1794,-748
2019,6,29,20,2831,2604,1814,-790
2019,6,29,21,2876,2684,1935,-749
2019,6,29,22,2941,2757,1978,-779
2019,6,29,23,3019,2827,2014,-813
2019,6,30,0,3058,2912,2153,-759
2019,6,30,1,3071,2950,2127,-823
2019,6,30,2,3030,2952,2024,-928
2019,6,30,3,2900,2911,1956,-955
2019,6,30,4,2698,2820,1892,-928
2019,6,30,5,2470,2680,1840,-840
2019,6,30,6,2351,2502,1695,-807
2019,6,30,7,2215,2328,1569,-759
2019,6,30,8,2069,2218,1569,-649
2019,6,30,9,2109,2128,1564,-564
2019,6,30,10,2059,2071,1563,-508
2019,6,30,11,2038,2032,1582,-450
2019,6,30,12,2027,2022,1572,-450
2019,6,30,13,2157,2006,1552,-454
2019,6,30,14,2357,2082,1595,-487
2019,6,30,15,2487,2194,1624,-570
2019,6,30,16,2550,2283,1671,-612
2019,6,30,17,2603,2351,1649,-702
2019,6,30,18,2685,2429,1685,-744
2019,6,30,19,2767,2505,1811,-694
2019,6,30,20,2850,2597,1839,-758
2019,6,30,21,2911,2672,1848,-824
2019,6,30,22,3000,2738,1844,-894
2019,6,30,23,3102,2828,1961,-867
2019,7,1,0,3165,2892,1929,-963
2019,7,1,1,3166,2875,1957,-918
2019,7,1,2,3082,2874,2155,-719
2019,7,1,3,2908,2815,2189,-626
2019,7,1,4,2789,2739,2204,-535
2019,7,1,5,2552,2608,1967,-641
2019,7,1,6,2357,2387,1749,-638
2019,7,1,7,2244,2248,1638,-610
2019,7,1,8,2183,2121,1599,-522
2019,7,1,9,2050,2054,1597,-457
2019,7,1,10,2044,2010,1546,-464
2019,7,1,11,2109,1995,1514,-481
2019,7,1,12,2227,2045,1493,-552
2019,7,1,13,2402,2147,1493,-654
2019,7,1,14,2608,2322,1589,-733
2019,7,1,15,2707,2476,1636,-840
2019,7,1,16,2820,2593,1778,-815
2019,7,1,17,2885,2691,1835,-856
2019,7,1,18,2992,2793,1954,-839
2019,7,1,19,3074,2874,1949,-925
2019,7,1,20,3186,2970,1933,-1037
2019,7,1,21,3279,3090,1929,-1161
2019,7,1,22,3357,3150,2031,-1119
2019,7,1,23,3406,3211,2162,-1049
2019,7,2,0,3422,3266,2188,-1078
2019,7,2,1,3402,3317,2111,-1206
2019,7,2,2,3340,3317,2113,-1204
2019,7,2,3,3194,3246,2055,-1191
2019,7,2,4,2965,3113,1939,-1174
2019,7,2,5,2688,2957,1935,-1022
2019,7,2,6,2599,2679,1832,-847
2019,7,2,7,2476,2493,1740,-753
2019,7,2,8,2304,2360,1865,-495
2019,7,2,9,2322,2254,1748,-506
2019,7,2,10,2274,2180,1706,-474
2019,7,2,11,2290,2155,1707,-448
2019,7,2,12,2396,2184,1683,-501
2019,7,2,13,2576,2256,1649,-607
2019,7,2,14,2640,2424,1728,-696
2019,7,2,15,2684,2554,1814,-740
2019,7,2,16,2747,2650,1895,-755
2019,7,2,17,2876,2716,1934,-782
2019,7,2,18,2962,2775,2050,-725
2019,7,2,19,3043,2853,2172,-681
2019,7,2,20,3131,2911,2088,-823
2019,7,2,21,3190,2969,2121,-848
2019,7,2,22,3214,3023,2237,-786
2019,7,2,23,3233,3073,2355,-718
2019,7,3,0,3246,3124,2419,-705
2019,7,3,1,3230,3155,2513,-642
2019,7,3,2,3164,3147,2499,-648
2019,7,3,3,3062,3071,2386,-685
2019,7,3,4,2922,2958,2276,-682
2019,7,3,5,2658,2827,2120,-707
2019,7,3,6,2415,2591,1913,-678
2019,7,3,7,2306,2426,1805,-621
2019,7,3,8,2202,2314,1627,-687
2019,7,3,9,2200,2243,1681,-562
2019,7,3,10,2203,2180,1772,-408
2019,7,3,11,2258,2147,1775,-372
2019,7,3,12,2352,2164,1740,-424
2019,7,3,13,2513,2234,1788,-446
2019,7,3,14,2591,2369,1757,-612
2019,7,3,15,2635,2487,1849,-638
2019,7,3,16,2682,2556,1955,-601
2019,7,3,17,2785,2617,2047,-570
2019,7,3,18,2877,2653,2042,-611
2019,7,3,19,2972,2699,2124,-575
2019,7,3,20,3044,2724,2060,-664
2019,7,3,21,3080,2771,2125,-646
2019,7,3,22,3090,2817,2108,-709
2019,7,3,23,3095,2828,2198,-630
2019,7,4,0,3080,2854,2251,-603
2019,7,4,1,3018,2863,2209,-654
2019,7,4,2,2925,2816,2096,-720
2019,7,4,3,2810,2759,2046,-713
2019,7,4,4,2669,2700,1966,-734
2019,7,4,5,2418,2607,1900,-707
2019,7,4,6,2331,2440,1845,-595
2019,7,4,7,2194,2294,1778,-516
2019,7,4,8,2049,2200,1682,-518
2019,7,4,9,2055,2119,1643,-476
2019,7,4,10,2052,2071,1557,-514
2019,7,4,11,2100,2015,1502,-513
2019,7,4,12,2186,2014,1520,-494
2019,7,4,13,2352,2036,1534,-502
2019,7,4,14,2446,2116,1543,-573
2019,7,4,15,2488,2221,1625,-596
2019,7,4,16,2542,2309,1650,-659
2019,7,4,17,2632,2389,1770,-619
2019,7,4,18,2725,2422,1774,-648
2019,7,4,19,2813,2473,1837,-636
2019,7,4,20,2879,2527,1792,-735
2019,7,4,21,2916,2568,1900,-668
2019,7,4,22,2932,2619,1919,-700
2019,7,4,23,2955,2635,1931,-704
2019,7,5,0,2944,2669,2016,-653
2019,7,5,1,2879,2661,2007,-654
2019,7,5,2,2764,2631,1954,-677
2019,7,5,3,2654,2569,1806,-763
2019,7,5,4,2641,2471,1763,-708
2019,7,5,5,2410,2359,1626,-733
2019,7,5,6,2389,2290,1566,-724
2019,7,5,7,2281,2189,1560,-629
2019,7,5,8,2245,2075,1448,-627
2019,7,5,9,2052,2010,1439,-571
2019,7,5,10,2016,1955,1423,-532
2019,7,5,11,2010,1938,1438,-500
2019,7,5,12,2072,1948,1456,-492
2019,7,5,13,2223,1987,1494,-493
2019,7,5,14,2415,2121,1606,-515
2019,7,5,15,2559,2259,1714,-545
2019,7,5,16,2658,2370,1683,-687
2019,7,5,17,2726,2486,1826,-660
2019,7,5,18,2804,2559,1855,-704
2019,7,5,19,2871,2658,1934,-724
2019,7,5,20,2940,2744,1918,-826
2019,7,5,21,3001,2839,1958,-881
2019,7,5,22,3078,2910,2135,-775
2019,7,5,23,3055,2998,2154,-844
2019,7,6,0,3100,3058,2165,-893
2019,7,6,1,3096,3104,2206,-898
2019,7,6,2,3101,3091,2240,-851
2019,7,6,3,2950,3020,2038,-982
2019,7,6,4,2790,2908,1969,-939
2019,7,6,5,2589,2768,1971,-797
2019,7,6,6,2534,2555,1758,-797
2019,7,6,7,2454,2382,1655,-727
2019,7,6,8,2350,2265,1586,-679
2019,7,6,9,2287,2169,1595,-574
2019,7,6,10,2204,2109,1566,-543
2019,7,6,11,2130,2065,1561,-504
2019,7,6,12,2090,2040,1564,-476
2019,7,6,13,2176,2055,1561,-494
2019,7,6,14,2391,2147,1596,-551
2019,7,6,15,2581,2280,1640,-640
2019,7,6,16,2696,2427,1738,-689
2019,7,6,17,2763,2549,1785,-764
2019,7,6,18,2847,2665,1835,-830
2019,7,6,19,2939,2784,1907,-877
2019,7,6,20,3054,2886,2006,-880
2019,7,6,21,3140,2969,2075,-894
2019,7,6,22,3246,3004,2100,-904
2019,7,6,23,3328,3031,2296,-735
2019,7,7,0,3322,3033,2306,-727
2019,7,7,1,3253,3029,2224,-805
2019,7,7,2,3115,2953,2209,-744
2019,7,7,3,2986,2871,2211,-660
2019,7,7,4,2888,2803,2164,-639
2019,7,7,5,2684,2683,2051,-632
2019,7,7,6,2632,2488,1909,-579
2019,7,7,7,2508,2337,1754,-583
2019,7,7,8,2415,2228,1664,-564
2019,7,7,9,2136,2116,1477,-639
2019,7,7,10,2078,2058,1523,-535
2019,7,7,11,2030,2017,1497,-520
2019,7,7,12,2011,1998,1556,-442
2019,7,7,13,2086,1984,1597,-387
2019,7,7,14,2232,2051,1635,-416
2019,7,7,15,2381,2145,1615,-530
2019,7,7,16,2446,2230,1636,-594
2019,7,7,17,2498,2327,1848,-479
2019,7,7,18,2556,2433,1954,-479
2019,7,7,19,2641,2510,1959,-551
2019,7,7,20,2738,2596,2039,-557
2019,7,7,21,2802,2680,1957,-723
2019,7,7,22,2900,2794,1957,-837
2019,7,7,23,2977,2780,1912,-868
2019,7,8,0,3014,2800,2094,-706
2019,7,8,1,2954,2825,2087,-738
2019,7,8,2,2829,2793,1953,-840
2019,7,8,3,2730,2718,1939,-779
2019,7,8,4,2670,2633,1834,-799
2019,7,8,5,2454,2501,1813,-688
2019,7,8,6,2313,2301,1687,-614
2019,7,8,7,2212,2134,1479,-655
2019,7,8,8,2101,2024,1324,-700
2019,7,8,9,2043,1957,1257,-700
2019,7,8,10,2022,1928,1247,-681
2019,7,8,11,2056,1924,1250,-674
2019,7,8,12,2149,1960,1288,-672
2019,7,8,13,2308,2071,1307,-764
2019,7,8,14,2450,2209,1411,-798
2019,7,8,15,2540,2328,1541,-787
2019,7,8,16,2604,2389,1709,-680
2019,7,8,17,2664,2444,1700,-744
2019,7,8,18,2711,2513,1823,-690
2019,7,8,19,2757,2546,1928,-618
2019,7,8,20,2822,2612,1916,-696
2019,7,8,21,2866,2672,1977,-695
2019,7,8,22,2921,2735,1990,-745
2019,7,8,23,2956,2785,2088,-697
2019,7,9,0,2979,2817,2102,-715
2019,7,9,1,2951,2846,2142,-704
2019,7,9,2,2884,2827,2140,-687
2019,7,9,3,2784,2774,2048,-726
2019,7,9,4,2704,2715,2041,-674
2019,7,9,5,2513,2588,1903,-685
2019,7,9,6,2368,2393,1790,-603
2019,7,9,7,2257,2226,1625,-601
2019,7,9,8,2170,2131,1494,-637
2019,7,9,9,2058,2051,1412,-639
2019,7,9,10,2034,1988,1417,-571
2019,7,9,11,2051,1964,1456,-508
2019,7,9,12,2146,1995,1559,-436
2019,7,9,13,2294,2064,1555,-509
2019,7,9,14,2430,2220,1575,-645
2019,7,9,15,2519,2341,1690,-651
2019,7,9,16,2614,2413,1672,-741
2019,7,9,17,2712,2501,1704,-797
2019,7,9,18,2777,2582,1871,-711
2019,7,9,19,2850,2667,1876,-791
2019,7,9,20,2925,2752,1984,-768
2019,7,9,21,3016,2854,2135,-719
2019,7,9,22,3104,2931,2215,-716
2019,7,9,23,3171,2956,2169,-787
2019,7,10,0,3210,3002,2142,-860
2019,7,10,1,3158,3029,2088,-941
2019,7,10,2,3080,2987,2030,-957
2019,7,10,3,2946,2909,2047,-862
2019,7,10,4,2874,2849,1999,-850
2019,7,10,5,2677,2703,1958,-745
2019,7,10,6,2565,2485,1802,-683
2019,7,10,7,2471,2318,1582,-736
2019,7,10,8,2411,2224,1507,-717
2019,7,10,9,2228,2143,1482,-661
2019,7,10,10,2198,2065,1553,-512
2019,7,10,11,2190,2045,1533,-512
2019,7,10,12,2275,2076,1568,-508
2019,7,10,13,2405,2164,1602,-562
2019,7,10,14,2565,2317,1601,-716
2019,7,10,15,2704,2429,1667,-762
2019,7,10,16,2804,2541,1785,-756
2019,7,10,17,2881,2633,1872,-761
2019,7,10,18,2960,2743,1942,-801
2019,7,10,19,3057,2818,2053,-765
2019,7,10,20,3166,2931,2175,-756
2019,7,10,21,3231,3046,2281,-765
2019,7,10,22,3308,3135,2351,-784
2019,7,10,23,3387,3175,2412,-763
2019,7,11,0,3412,3230,2419,-811
2019,7,11,1,3364,3245,2357,-888
2019,7,11,2,3253,3221,2348,-873
2019,7,11,3,3109,3161,2242,-919
2019,7,11,4,2944,3047,2227,-820
2019,7,11,5,2702,2898,2192,-706
2019,7,11,6,2724,2624,2102,-522
2019,7,11,7,2569,2434,1896,-538
2019,7,11,8,2264,2299,1784,-515
2019,7,11,9,2172,2203,1796,-407
2019,7,11,10,2135,2131,1797,-334
2019,7,11,11,2150,2094,1758,-336
2019,7,11,12,2252,2112,1749,-363
2019,7,11,13,2413,2181,1806,-375
2019,7,11,14,2558,2336,1841,-495
2019,7,11,15,2675,2498,1973,-525
2019,7,11,16,2795,2617,1947,-670
2019,7,11,17,2933,2723,1982,-741
2019,7,11,18,3026,2851,1975,-876
2019,7,11,19,3138,2959,2002,-957
2019,7,11,20,3291,3102,2230,-872
2019,7,11,21,3432,3155,2291,-864
2019,7,11,22,3552,3179,2313,-866
2019,7,11,23,3564,3186,2281,-905
2019,7,12,0,3523,3179,2326,-853
2019,7,12,1,3420,3237,2355,-882
2019,7,12,2,3243,3283,2348,-935
2019,7,12,3,3110,3266,2324,-942
2019,7,12,4,3023,3194,2324,-870
2019,7,12,5,2757,3018,2271,-747
2019,7,12,6,2605,2744,2198,-546
2019,7,12,7,2490,2533,1990,-543
2019,7,12,8,2364,2374,1930,-444
2019,7,12,9,2301,2271,1937,-334
2019,7,12,10,2223,2201,1917,-284
2019,7,12,11,2256,2145,1884,-261
2019,7,12,12,2350,2137,1774,-363
2019,7,12,13,2495,2179,1767,-412
2019,7,12,14,2614,2366,1816,-550
2019,7,12,15,2690,2556,2044,-512
2019,7,12,16,2837,2682,2016,-666
2019,7,12,17,2967,2850,2065,-785
2019,7,12,18,3088,2937,2208,-729
2019,7,12,19,3224,3069,2239,-830
2019,7,12,20,3348,3200,2214,-986
2019,7,12,21,3431,3347,2244,-1103
2019,7,12,22,3510,3403,2252,-1151
2019,7,12,23,3508,3406,2282,-1124
2019,7,13,0,3558,3406,2349,-1057
2019,7,13,1,3490,3372,2473,-899
2019,7,13,2,3438,3318,2377,-941
2019,7,13,3,3213,3230,2221,-1009
2019,7,13,4,2994,3122,2437,-685
2019,7,13,5,2693,2962,2206,-756
2019,7,13,6,2663,2734,2159,-575
2019,7,13,7,2534,2545,1998,-547
2019,7,13,8,2248,2387,1818,-569
2019,7,13,9,2330,2280,1741,-539
2019,7,13,10,2244,2195,1776,-419
2019,7,13,11,2195,2127,1813,-314
2019,7,13,12,2168,2102,1866,-236
2019,7,13,13,2288,2108,1882,-226
2019,7,13,14,2471,2224,1913,-311
2019,7,13,15,2645,2374,1894,-480
2019,7,13,16,2760,2504,1980,-524
2019,7,13,17,2853,2656,2048,-608
2019,7,13,18,2922,2787,2136,-651
2019,7,13,19,3039,2906,2148,-758
2019,7,13,20,3159,3036,2085,-951
2019,7,13,21,3245,3146,2155,-991
2019,7,13,22,3330,3218,2129,-1089
2019,7,13,23,3337,3259,2261,-998
2019,7,14,0,3378,3287,2374,-913
2019,7,14,1,3342,3316,2464,-852
2019,7,14,2,3273,3284,2165,-1119
2019,7,14,3,3173,3175,2165,-1010
2019,7,14,4,2934,3051,2092,-959
2019,7,14,5,2679,2904,2058,-846
2019,7,14,6,2454,2685,1950,-735
2019,7,14,7,2315,2497,1849,-648
2019,7,14,8,2194,2356,1819,-537
2019,7,14,9,2250,2237,1736,-501
2019,7,14,10,2203,2145,1685,-460
2019,7,14,11,2161,2069,1641,-428
2019,7,14,12,2096,2031,1616,-415
2019,7,14,13,2180,2010,1645,-365
2019,7,14,14,2343,2083,1726,-357
2019,7,14,15,2465,2245,1799,-446
2019,7,14,16,2582,2373,1796,-577
2019,7,14,17,2691,2511,1870,-641
2019,7,14,18,2792,2613,1845,-768
2019,7,14,19,2882,2752,1849,-903
2019,7,14,20,2975,2834,1819,-1015
2019,7,14,21,3046,2945,1864,-1081
2019,7,14,22,3130,3026,2071,-955
2019,7,14,23,3167,3077,2187,-890
2019,7,15,0,3235,3127,2375,-752
2019,7,15,1,3208,3136,2469,-667
2019,7,15,2,3129,3112,2405,-707
2019,7,15,3,2951,2983,2234,-749
2019,7,15,4,2785,2805,2145,-660
2019,7,15,5,2506,2648,2088,-560
2019,7,15,6,2250,2414,2078,-336
2019,7,15,7,2112,2228,1814,-414
2019,7,15,8,2024,2105,1825,-280
2019,7,15,9,2025,2026,1770,-256
2019,7,15,10,1999,1966,1720,-246
2019,7,15,11,2028,1959,1673,-286
2019,7,15,12,2125,1991,1672,-319
2019,7,15,13,2332,2086,1656,-430
2019,7,15,14,2493,2261,1692,-569
2019,7,15,15,2623,2416,1832,-584
2019,7,15,16,2761,2535,1841,-694
2019,7,15,17,2902,2640,1969,-671
2019,7,15,18,3005,2743,1982,-761
2019,7,15,19,3100,2864,2108,-756
2019,7,15,20,3187,2972,2138,-834
2019,7,15,21,3244,3043,2428,-615
2019,7,15,22,3258,3162,2430,-732
2019,7,15,23,3261,3201,2445,-756
2019,7,16,0,3288,3238,2504,-734
2019,7,16,1,3290,3262,2482,-780
2019,7,16,2,3218,3232,2403,-829
2019,7,16,3,3050,3071,2375,-696
2019,7,16,4,2881,2967,2318,-649
2019,7,16,5,2614,2802,2245,-557
2019,7,16,6,2373,2546,2117,-429
2019,7,16,7,2236,2352,1841,-511
2019,7,16,8,2175,2227,1787,-440
2019,7,16,9,2131,2137,1741,-396
2019,7,16,10,2108,2085,1702,-383
2019,7,16,11,2136,2047,1606,-441
2019,7,16,12,2247,2079,1641,-438
2019,7,16,13,2420,2147,1657,-490
2019,7,16,14,2570,2286,1668,-618
2019,7,16,15,2657,2381,1728,-653
2019,7,16,16,2735,2462,1726,-736
2019,7,16,17,2810,2542,1861,-681
2019,7,16,18,2900,2630,1853,-777
2019,7,16,19,2998,2703,1805,-898
2019,7,16,20,3094,2777,1894,-883
2019,7,16,21,3130,2838,1962,-876
2019,7,16,22,3118,2904,1981,-923
2019,7,16,23,3104,2939,2133,-806
2019,7,17,0,3093,3000,2268,-732
2019,7,17,1,3072,3023,2167,-856
2019,7,17,2,2998,3011,2080,-931
2019,7,17,3,2879,2955,2031,-924
2019,7,17,4,2707,2833,1922,-911
2019,7,17,5,2453,2683,1883,-800
2019,7,17,6,2351,2464,1861,-603
2019,7,17,7,2220,2279,1664,-615
2019,7,17,8,1994,2163,1610,-553
2019,7,17,9,2047,2076,1433,-643
2019,7,17,10,2031,2019,1417,-602
2019,7,17,11,2064,1999,1404,-595
2019,7,17,12,2154,2017,1432,-585
2019,7,17,13,2324,2114,1457,-657
2019,7,17,14,2466,2233,1486,-747
2019,7,17,15,2567,2375,1597,-778
2019,7,17,16,2662,2371,1567,-804
2019,7,17,17,2758,2550,1812,-738
2019,7,17,18,2849,2654,1826,-828
2019,7,17,19,2950,2759,1931,-828
2019,7,17,20,3050,2875,1958,-917
2019,7,17,21,3141,2977,1966,-1011
2019,7,17,22,3197,3068,1985,-1083
2019,7,17,23,3232,3121,2002,-1119
2019,7,18,0,3273,3185,2100,-1085
2019,7,18,1,3253,3206,2166,-1040
2019,7,18,2,3150,3181,2174,-1007
2019,7,18,3,2969,3100,2069,-1031
2019,7,18,4,2750,2958,1925,-1033
2019,7,18,5,2481,2789,1824,-965
2019,7,18,6,2256,2558,1683,-875
2019,7,18,7,2113,2359,1511,-848
2019,7,18,8,1930,2217,1493,-724
2019,7,18,9,2124,2140,1470,-670
2019,7,18,10,2107,2057,1415,-642
2019,7,18,11,2143,2026,1386,-640
2019,7,18,12,2211,2045,1403,-642
2019,7,18,13,2353,2136,1458,-678
2019,7,18,14,2496,2287,1546,-741
2019,7,18,15,2589,2427,1753,-674
2019,7,18,16,2715,2524,1848,-676
2019,7,18,17,2815,2620,1914,-706
2019,7,18,18,2897,2702,1921,-781
2019,7,18,19,2965,2786,1997,-789
2019,7,18,20,3068,2858,1975,-883
2019,7,18,21,3147,2955,2133,-822
2019,7,18,22,3196,3032,2209,-823
2019,7,18,23,3224,3088,2289,-799
2019,7,19,0,3259,3141,2410,-731
2019,7,19,1,3233,3175,2465,-710
2019,7,19,2,3117,3149,2404,-745
2019,7,19,3,2944,3057,2151,-906
2019,7,19,4,2719,2938,2043,-895
2019,7,19,5,2452,2767,1999,-768
2019,7,19,6,2173,2525,1822,-703
2019,7,19,7,2034,2343,1717,-626
2019,7,19,8,1912,2219,1609,-610
2019,7,19,9,2086,2118,1551,-567
2019,7,19,10,2055,2050,1633,-417
2019,7,19,11,2072,2015,1589,-426
2019,7,19,12,2175,2028,1599,-429
2019,7,19,13,2343,2095,1724,-371
2019,7,19,14,2473,2224,1805,-419
2019,7,19,15,2548,2330,1902,-428
2019,7,19,16,2664,2395,1973,-422
2019,7,19,17,2752,2454,2045,-409
2019,7,19,18,2830,2501,2029,-472
2019,7,19,19,2894,2536,2037,-499
2019,7,19,20,2976,2580,1993,-587
2019,7,19,21,3025,2620,1972,-648
2019,7,19,22,3025,2668,1963,-705
2019,7,19,23,3007,2712,2032,-680
2019,7,20,0,2948,2737,2072,-665
2019,7,20,1,2878,2760,2187,-573
2019,7,20,2,2766,2753,2217,-536
2019,7,20,3,2645,2677,2027,-650
2019,7,20,4,2486,2589,1923,-666
2019,7,20,5,2248,2476,1936,-540
2019,7,20,6,2120,2306,1871,-435
2019,7,20,7,1963,2161,1639,-522
2019,7,20,8,1838,2054,1442,-612
2019,7,20,9,1838,1998,1444,-554
2019,7,20,10,1794,1934,1437,-497
2019,7,20,11,1777,1898,1429,-469
2019,7,20,12,1801,1902,1434,-468
2019,7,20,13,1951,1917,1488,-429
2019,7,20,14,2170,1999,1490,-509
2019,7,20,15,2394,2109,1577,-532
2019,7,20,16,2581,2195,1568,-627
2019,7,20,17,2735,2270,1579,-691
2019,7,20,18,2836,2334,1600,-734
2019,7,20,19,2873,2385,1613,-772
2019,7,20,20,2924,2460,1628,-832
2019,7,20,21,2939,2548,1654,-894
2019,7,20,22,2954,2646,1784,-862
2019,7,20,23,2946,2724,1947,-777
2019,7,21,0,2957,2799,2055,-744
2019,7,21,1,2911,2849,2162,-687
2019,7,21,2,2816,2836,2142,-694
2019,7,21,3,2668,2773,2105,-668
2019,7,21,4,2484,2658,2075,-583
2019,7,21,5,2259,2535,2018,-517
2019,7,21,6,2103,2328,1983,-345
2019,7,21,7,1949,2178,1906,-272
2019,7,21,8,1823,2070,1715,-355
2019,7,21,9,1869,1994,1695,-299
2019,7,21,10,1832,1937,1689,-248
2019,7,21,11,1818,1904,1652,-252
2019,7,21,12,1804,1889,1624,-265
2019,7,21,13,1926,1877,1613,-264
2019,7,21,14,2179,1929,1491,-438
2019,7,21,15,2443,2042,1473,-569
2019,7,21,16,2621,2139,1501,-638
2019,7,21,17,2728,2225,1670,-555
2019,7,21,18,2806,2331,1704,-627
2019,7,21,19,2847,2437,1741,-696
2019,7,21,20,2890,2540,1758,-782
2019,7,21,21,2932,2693,1771,-922
2019,7,21,22,3003,2818,1782,-1036
2019,7,21,23,3086,2951,1776,-1175
2019,7,22,0,3167,3069,1915,-1154
2019,7,22,1,3177,3113,1964,-1149
2019,7,22,2,3110,3076,1946,-1130
2019,7,22,3,2910,3020,2031,-989
2019,7,22,4,2724,2918,1819,-1099
2019,7,22,5,2500,2744,1813,-931
2019,7,22,6,2139,2520,1844,-676
2019,7,22,7,2006,2323,1811,-512
2019,7,22,8,1930,2183,1709,-474
2019,7,22,9,2101,2109,1733,-376
2019,7,22,10,2080,2036,1677,-359
2019,7,22,11,2079,2013,1712,-301
2019,7,22,12,2263,2055,1815,-240
2019,7,22,13,2432,2157,1854,-303
2019,7,22,14,2506,2297,1754,-543
2019,7,22,15,2633,2436,1917,-519
2019,7,22,16,2734,2566,1967,-599
2019,7,22,17,2909,2726,1960,-766
2019,7,22,18,3016,2887,1955,-932
2019,7,22,19,3142,3021,1923,-1098
2019,7,22,20,3285,3208,1967,-1241
2019,7,22,21,3429,3354,2233,-1121
2019,7,22,22,3562,3391,2269,-1122
2019,7,22,23,3641,3384,2295,-1089
2019,7,23,0,3644,3463,2511,-952
2019,7,23,1,3542,3489,2417,-1072
2019,7,23,2,3429,3515,2292,-1223
2019,7,23,3,3245,3422,2230,-1192
2019,7,23,4,3032,3287,2218,-1069
2019,7,23,5,2758,3063,2169,-894
2019,7,23,6,2456,2763,2135,-628
2019,7,23,7,2322,2567,1840,-727
2019,7,23,8,2326,2413,1829,-584
2019,7,23,9,2386,2308,1708,-600
2019,7,23,10,2342,2231,1688,-543
2019,7,23,11,2352,2191,1809,-382
2019,7,23,12,2436,2200,1791,-409
2019,7,23,13,2564,2291,1894,-397
2019,7,23,14,2712,2423,1856,-567
2019,7,23,15,2812,2552,1962,-590
2019,7,23,16,2930,2636,1962,-674
2019,7,23,17,3026,2732,2096,-636
2019,7,23,18,3132,2797,2280,-517
2019,7,23,19,3240,2851,2337,-514
2019,7,23,20,3325,2946,2393,-553
2019,7,23,21,3334,2950,2486,-464
2019,7,23,22,3327,2939,2538,-401
2019,7,23,23,3307,2920,2578,-342
2019,7,24,0,3206,2868,2539,-329
2019,7,24,1,3108,2880,2431,-449
2019,7,24,2,2950,2841,2232,-609
2019,7,24,3,2859,2813,2111,-702
2019,7,24,4,2713,2806,2002,-804
2019,7,24,5,2515,2714,2219,-495
2019,7,24,6,2522,2493,2114,-379
2019,7,24,7,2393,2343,1869,-474
2019,7,24,8,2391,2228,1761,-467
2019,7,24,9,2093,2144,1674,-470
2019,7,24,10,2044,2075,1587,-488
2019,7,24,11,2057,2046,1580,-466
2019,7,24,12,2111,2077,1620,-457
2019,7,24,13,2267,2166,1632,-534
2019,7,24,14,2466,2297,1697,-600
2019,7,24,15,2635,2439,1955,-484
2019,7,24,16,2826,2581,2148,-433
2019,7,24,17,2959,2658,2240,-418
2019,7,24,18,2928,2740,2300,-440
2019,7,24,19,3035,2807,2426,-381
2019,7,24,20,3120,2870,2313,-557
2019,7,24,21,3152,2939,2350,-589
2019,7,24,22,3130,3029,2442,-587
2019,7,24,23,3148,3060,2469,-591
2019,7,25,0,3188,3105,2483,-622
2019,7,25,1,3194,3107,2512,-595
2019,7,25,2,3142,3094,2461,-633
2019,7,25,3,3033,2959,2174,-785
2019,7,25,4,2836,2843,2181,-662
2019,7,25,5,2537,2645,2115,-530
2019,7,25,6,2318,2409,2025,-384
2019,7,25,7,2166,2228,1750,-478
2019,7,25,8,2043,2122,1658,-464
2019,7,25,9,2007,2035,1596,-439
2019,7,25,10,1999,1980,1560,-420
2019,7,25,11,2040,1960,1522,-438
2019,7,25,12,2147,1989,1509,-480
2019,7,25,13,2320,2056,1529,-527
2019,7,25,14,2489,2193,1631,-562
2019,7,25,15,2580,2305,1729,-576
2019,7,25,16,2692,2422,1868,-554
2019,7,25,17,2780,2506,2085,-421
2019,7,25,18,2870,2595,2158,-437
2019,7,25,19,2965,2676,2076,-600
2019,7,25,20,3060,2783,2015,-768
2019,7,25,21,3128,2897,2010,-887
2019,7,25,22,3150,3017,2115,-902
2019,7,25,23,3182,3101,2238,-863
2019,7,26,0,3214,3173,2184,-989
2019,7,26,1,3243,3214,2251,-963
2019,7,26,2,3185,3182,2192,-990
2019,7,26,3,3045,3075,2104,-971
2019,7,26,4,2832,2953,2095,-858
2019,7,26,5,2550,2777,2001,-776
2019,7,26,6,2380,2535,1845,-690
2019,7,26,7,2251,2339,1733,-606
2019,7,26,8,2202,2201,1514,-687
2019,7,26,9,2193,2107,1509,-598
2019,7,26,10,2110,2046,1408,-638
2019,7,26,11,2133,2012,1387,-625
2019,7,26,12,2242,2029,1394,-635
2019,7,26,13,2411,2113,1459,-654
2019,7,26,14,2571,2242,1590,-652
2019,7,26,15,2673,2360,1638,-722
2019,7,26,16,2750,2453,1683,-770
2019,7,26,17,2798,2518,1717,-801
2019,7,26,18,2893,2571,1704,-867
2019,7,26,19,3001,2591,1703,-888
2019,7,26,20,3082,2637,1917,-720
2019,7,26,21,3110,2703,2026,-677
2019,7,26,22,3108,2711,1913,-798
2019,7,26,23,3014,2705,1944,-761
2019,7,27,0,2868,2703,1973,-730
2019,7,27,1,2743,2683,2006,-677
2019,7,27,2,2738,2668,2144,-524
2019,7,27,3,2704,2655,2054,-601
2019,7,27,4,2616,2617,1932,-685
2019,7,27,5,2419,2545,1834,-711
2019,7,27,6,2427,2366,1765,-601
2019,7,27,7,2321,2232,1596,-636
2019,7,27,8,2224,2130,1500,-630
2019,7,27,9,2018,2039,1518,-521
2019,7,27,10,1984,2002,1559,-443
2019,7,27,11,1977,1975,1525,-450
2019,7,27,12,1992,1958,1548,-410
2019,7,27,13,2104,1989,1590,-399
2019,7,27,14,2282,2064,1604,-460
2019,7,27,15,2471,2201,1684,-517
2019,7,27,16,2552,2331,1728,-603
2019,7,27,17,2635,2470,1803,-667
2019,7,27,18,2720,2584,1923,-661
2019,7,27,19,2839,2691,1977,-714
2019,7,27,20,2956,2783,2069,-714
2019,7,27,21,3048,2903,2248,-655
2019,7,27,22,3118,2996,2358,-638
2019,7,27,23,3179,3064,2394,-670
2019,7,28,0,3236,3113,2477,-636
2019,7,28,1,3213,3116,2476,-640
2019,7,28,2,3122,3093,2461,-632
2019,7,28,3,3003,2985,2228,-757
2019,7,28,4,2821,2845,2077,-768
2019,7,28,5,2599,2680,1963,-717
2019,7,28,6,2487,2449,1741,-708
2019,7,28,7,2329,2274,1485,-789
2019,7,28,8,2221,2141,1515,-626
2019,7,28,9,2057,2061,1506,-555
2019,7,28,10,1988,1987,1485,-502
2019,7,28,11,1966,1938,1491,-447
2019,7,28,12,1961,1917,1542,-375
2019,7,28,13,2053,1910,1544,-366
2019,7,28,14,2192,1959,1587,-372
2019,7,28,15,2306,2078,1670,-408
2019,7,28,16,2392,2193,1683,-510
2019,7,28,17,2494,2294,1707,-587
2019,7,28,18,2605,2425,1752,-673
2019,7,28,19,2730,2546,1695,-851
2019,7,28,20,2854,2656,1723,-933
2019,7,28,21,2968,2790,1948,-842
2019,7,28,22,3065,2909,2111,-798
2019,7,28,23,3174,3022,2147,-875
2019,7,29,0,3237,3091,2194,-897
2019,7,29,1,3226,3109,2178,-931
2019,7,29,2,3128,3078,2065,-1013
2019,7,29,3,2971,2966,1951,-1015
2019,7,29,4,2803,2877,1838,-1039
2019,7,29,5,2583,2718,1751,-967
2019,7,29,6,2424,2490,1624,-866
2019,7,29,7,2302,2308,1583,-725
2019,7,29,8,2233,2176,1567,-609
2019,7,29,9,2192,2097,1501,-596
2019,7,29,10,2169,2037,1514,-523
2019,7,29,11,2186,2020,1547,-473
2019,7,29,12,2239,2045,1598,-447
2019,7,29,13,2443,2122,1683,-439
2019,7,29,14,2514,2263,1806,-457
2019,7,29,15,2594,2388,1945,-443
2019,7,29,16,2639,2468,1969,-499
2019,7,29,17,2801,2580,2052,-528
2019,7,29,18,2911,2630,1996,-634
2019,7,29,19,3033,2708,2023,-685
2019,7,29,20,3150,2839,2157,-682
2019,7,29,21,3191,2987,2194,-793
2019,7,29,22,3233,3082,2166,-916
2019,7,29,23,3323,3169,2289,-880
2019,7,30,0,3392,3205,2164,-1041
2019,7,30,1,3362,3212,2267,-945
2019,7,30,2,3225,3143,2260,-883
2019,7,30,3,3084,3046,2146,-900
2019,7,30,4,2892,2945,1975,-970
2019,7,30,5,2632,2783,1862,-921
2019,7,30,6,2482,2556,1808,-748
2019,7,30,7,2335,2370,1675,-695
2019,7,30,8,2222,2266,1737,-529
2019,7,30,9,2114,2177,1807,-370
2019,7,30,10,2090,2121,1843,-278
2019,7,30,11,2136,2072,1788,-284
2019,7,30,12,2252,2107,1773,-334
2019,7,30,13,2414,2189,1844,-345
2019,7,30,14,2598,2316,1851,-465
2019,7,30,15,2687,2434,1721,-713
2019,7,30,16,2777,2583,1806,-777
2019,7,30,17,2847,2707,1730,-977
2019,7,30,18,2969,2836,1714,-1122
2019,7,30,19,3098,2957,1729,-1228
2019,7,30,20,3239,3102,1868,-1234
2019,7,30,21,3359,3229,2047,-1182
2019,7,30,22,3463,3324,2164,-1160
2019,7,30,23,3550,3373,2280,-1093
2019,7,31,0,3590,3430,2265,-1165
2019,7,31,1,3515,3440,2253,-1187
2019,7,31,2,3362,3407,2176,-1231
2019,7,31,3,3177,3288,2131,-1157
2019,7,31,4,2963,3155,2059,-1096
2019,7,31,5,2687,2923,1852,-1071
2019,7,31,6,2496,2656,1682,-974
2019,7,31,7,2349,2451,1602,-849
2019,7,31,8,2168,2315,1531,-784
2019,7,31,9,2159,2215,1508,-707
2019,7,31,10,2119,2129,1495,-634
2019,7,31,11,2146,2078,1518,-560
2019,7,31,12,2232,2099,1550,-549
2019,7,31,13,2365,2163,1595,-568
2019,7,31,14,2537,2276,1625,-651
2019,7,31,15,2656,2395,1857,-538
2019,7,31,16,2790,2499,1922,-577
2019,7,31,17,2902,2625,2136,-489
2019,7,31,18,3014,2742,2040,-702
2019,7,31,19,3158,2875,2051,-824
2019,7,31,20,3296,3003,2120,-883
2019,7,31,21,3412,3142,2175,-967
2019,7,31,22,3481,3239,2112,-1127
2019,7,31,23,3542,3320,2149,-1171
2019,8,1,0,3538,3383,2179,-1204
2019,8,1,1,3475,3391,2197,-1194
2019,8,1,2,3336,3351,2266,-1085
2019,8,1,3,3183,3238,2260,-978
2019,8,1,4,2958,3096,2166,-930
2019,8,1,5,2673,2880,2126,-754
2019,8,1,6,2498,2630,1970,-660
2019,8,1,7,2348,2438,1878,-560
2019,8,1,8,2192,2278,1911,-367
2019,8,1,9,2111,2190,1895,-295
2019,8,1,10,2058,2107,1877,-230
2019,8,1,11,2094,2078,1901,-177
2019,8,1,12,2182,2091,1799,-292
2019,8,1,13,2334,2173,1815,-358
2019,8,1,14,2502,2287,1827,-460
2019,8,1,15,2619,2408,1866,-542
2019,8,1,16,2756,2526,1847,-679
2019,8,1,17,2872,2654,1972,-682
2019,8,1,18,3011,2782,1968,-814
2019,8,1,19,3172,2915,1998,-917
2019,8,1,20,3331,3056,2106,-950
2019,8,1,21,3459,3189,2216,-973
2019,8,1,22,3539,3284,2238,-1046
2019,8,1,23,3593,3307,2269,-1038
2019,8,2,0,3593,3317,2451,-866
2019,8,2,1,3475,3331,2284,-1047
2019,8,2,2,3310,3260,2279,-981
2019,8,2,3,3136,3176,2162,-1014
2019,8,2,4,2903,3034,2211,-823
2019,8,2,5,2617,2864,2143,-721
2019,8,2,6,2476,2624,2025,-599
2019,8,2,7,2325,2421,1856,-565
2019,8,2,8,2174,2282,1920,-362
2019,8,2,9,2106,2193,1781,-412
2019,8,2,10,2048,2143,1676,-467
2019,8,2,11,2081,2109,1693,-416
2019,8,2,12,2188,2137,1752,-385
2019,8,2,13,2358,2225,1773,-452
2019,8,2,14,2552,2319,1765,-554
2019,8,2,15,2683,2448,1826,-622
2019,8,2,16,2815,2543,1930,-613
2019,8,2,17,2934,2665,2066,-599
2019,8,2,18,3049,2779,2114,-665
2019,8,2,19,3202,2912,1979,-933
2019,8,2,20,3351,3049,2029,-1020
2019,8,2,21,3478,3160,2063,-1097
2019,8,2,22,3526,3261,2056,-1205
2019,8,2,23,3349,3298,2171,-1127
2019,8,3,0,3300,3318,2197,-1121
2019,8,3,1,3210,3346,2293,-1053
2019,8,3,2,3238,3294,2312,-982
2019,8,3,3,3079,3182,2231,-951
2019,8,3,4,2867,3043,2171,-872
2019,8,3,5,2606,2844,1976,-868
2019,8,3,6,2364,2610,1877,-733
2019,8,3,7,2195,2421,1758,-663
2019,8,3,8,2073,2272,1739,-533
2019,8,3,9,2094,2170,1714,-456
2019,8,3,10,2042,2089,1716,-373
2019,8,3,11,2013,2016,1610,-406
2019,8,3,12,2007,2014,1586,-428
2019,8,3,13,2089,2014,1631,-383
2019,8,3,14,2250,2085,1602,-483
2019,8,3,15,2453,2227,1693,-534
2019,8,3,16,2654,2343,1650,-693
2019,8,3,17,2855,2462,1697,-765
2019,8,3,18,2992,2586,1797,-789
2019,8,3,19,3118,2708,1914,-794
2019,8,3,20,3233,2842,1948,-894
2019,8,3,21,3318,2976,2098,-878
2019,8,3,22,3373,3107,2199,-908
2019,8,3,23,3358,3169,2149,-1020
2019,8,4,0,3370,3224,2214,-1010
2019,8,4,1,3286,3253,2241,-1012
2019,8,4,2,3179,3233,2185,-1048
2019,8,4,3,3006,3121,2183,-938
2019,8,4,4,2794,2972,2104,-868
2019,8,4,5,2561,2781,2060,-721
2019,8,4,6,2397,2555,2028,-527
2019,8,4,7,2238,2368,1807,-561
2019,8,4,8,2125,2233,1768,-465
2019,8,4,9,2069,2131,1634,-497
2019,8,4,10,2012,2059,1528,-531
2019,8,4,11,1982,2002,1497,-505
2019,8,4,12,1971,1981,1502,-479
2019,8,4,13,2045,1967,1481,-486
2019,8,4,14,2222,2009,1462,-547
2019,8,4,15,2442,2145,1524,-621
2019,8,4,16,2611,2279,1576,-703
2019,8,4,17,2776,2414,1664,-750
2019,8,4,18,2920,2570,1722,-848
2019,8,4,19,3071,2709,1786,-923
2019,8,4,20,3219,2830,1782,-1048
2019,8,4,21,3348,2960,1984,-976
2019,8,4,22,3409,3064,1987,-1077
2019,8,4,23,3423,3134,2063,-1071
2019,8,5,0,3386,3192,2077,-1115
2019,8,5,1,3282,3201,2156,-1045
2019,8,5,2,3142,3181,2137,-1044
2019,8,5,3,2950,3097,2075,-1022
2019,8,5,4,2774,2977,2039,-938
2019,8,5,5,2538,2763,1959,-804
2019,8,5,6,2417,2513,1850,-663
2019,8,5,7,2258,2317,1677,-640
2019,8,5,8,2145,2183,1459,-724
2019,8,5,9,2033,2086,1344,-742
2019,8,5,10,1998,2023,1363,-660
2019,8,5,11,2024,2008,1338,-670
2019,8,5,12,2131,2033,1352,-681
2019,8,5,13,2293,2127,1512,-615
2019,8,5,14,2406,2277,1592,-685
2019,8,5,15,2628,2434,1601,-833
2019,8,5,16,2862,2570,1582,-988
2019,8,5,17,3148,2728,1589,-1139
2019,8,5,18,3275,2873,1626,-1247
2019,8,5,19,3426,3022,1624,-1398
2019,8,5,20,3547,3174,1703,-1471
2019,8,5,21,3650,3281,1954,-1327
2019,8,5,22,3685,3295,1993,-1302
2019,8,5,23,3657,3321,2231,-1090
2019,8,6,0,3554,3275,2233,-1042
2019,8,6,1,3430,3278,2299,-979
2019,8,6,2,3201,3259,2226,-1033
2019,8,6,3,2981,3174,2034,-1140
2019,8,6,4,2754,3108,1883,-1225
2019,8,6,5,2512,2885,1790,-1095
2019,8,6,6,2501,2620,1585,-1035
2019,8,6,7,2330,2427,1478,-949
2019,8,6,8,2194,2293,1468,-825
2019,8,6,9,2088,2202,1437,-765
2019,8,6,10,2048,2127,1283,-844
2019,8,6,11,2079,2108,1287,-821
2019,8,6,12,2176,2211,1286,-925
2019,8,6,13,2328,2238,1283,-955
2019,8,6,14,2551,2352,1301,-1051
2019,8,6,15,2782,2444,1331,-1113
2019,8,6,16,2980,2485,1473,-1012
2019,8,6,17,3087,2638,1524,-1114
2019,8,6,18,3186,2760,1643,-1117
2019,8,6,19,3315,2940,1723,-1217
2019,8,6,20,3435,3106,1697,-1409
2019,8,6,21,3544,3264,1826,-1438
2019,8,6,22,3586,3352,1897,-1455
2019,8,6,23,3618,3378,2002,-1376
2019,8,7,0,3588,3398,2044,-1354
2019,8,7,1,3493,3368,2029,-1339
2019,8,7,2,3297,3351,1928,-1423
2019,8,7,3,3058,3237,1837,-1400
2019,8,7,4,2850,3117,1809,-1308
2019,8,7,5,2585,2898,1741,-1157
2019,8,7,6,2468,2656,1703,-953
2019,8,7,7,2306,2449,1534,-915
2019,8,7,8,2172,2305,1519,-786
2019,8,7,9,2132,2214,1520,-694
2019,8,7,10,2072,2141,1459,-682
2019,8,7,11,2097,2095,1394,-701
2019,8,7,12,2170,2126,1405,-721
2019,8,7,13,2265,2208,1458,-750
2019,8,7,14,2454,2344,1667,-677
2019,8,7,15,2678,2465,1738,-727
2019,8,7,16,2955,2547,1759,-788
2019,8,7,17,3127,2644,1792,-852
2019,8,7,18,3184,2746,1839,-907
2019,8,7,19,3243,2857,1786,-1071
2019,8,7,20,3296,2998,1824,-1174
2019,8,7,21,3351,3132,1835,-1297
2019,8,7,22,3354,3213,1970,-1243
2019,8,7,23,3402,3247,2111,-1136
2019,8,8,0,3392,3233,2050,-1183
2019,8,8,1,3349,3233,1993,-1240
2019,8,8,2,3216,3197,1931,-1266
2019,8,8,3,3103,3104,1843,-1261
2019,8,8,4,2889,2996,1779,-1217
2019,8,8,5,2663,2796,1759,-1037
2019,8,8,6,2488,2543,1562,-981
2019,8,8,7,2355,2367,1478,-889
2019,8,8,8,2302,2238,1465,-773
2019,8,8,9,2224,2152,1428,-724
2019,8,8,10,2204,2089,1321,-768
2019,8,8,11,2261,2074,1280,-794
2019,8,8,12,2355,2102,1239,-863
2019,8,8,13,2466,2182,1194,-988
2019,8,8,14,2600,2311,1304,-1007
2019,8,8,15,2697,2407,1429,-978
2019,8,8,16,2798,2463,1511,-952
2019,8,8,17,2845,2520,1482,-1038
2019,8,8,18,2945,2555,1540,-1015
2019,8,8,19,3064,2593,1539,-1054
2019,8,8,20,3150,2617,1740,-877
2019,8,8,21,3118,2629,1790,-839
2019,8,8,22,3009,2652,1856,-796
2019,8,8,23,2885,2669,1824,-845
2019,8,9,0,2785,2682,1768,-914
2019,8,9,1,2765,2664,1827,-837
2019,8,9,2,2691,2632,1727,-905
2019,8,9,3,2574,2608,1738,-870
2019,8,9,4,2428,2571,1647,-924
2019,8,9,5,2249,2450,1499,-951
2019,8,9,6,2324,2290,1342,-948
2019,8,9,7,2211,2169,1375,-794
2019,8,9,8,2127,2076,1362,-714
2019,8,9,9,2070,2017,1329,-688
2019,8,9,10,2070,1984,1367,-617
2019,8,9,11,2099,1962,1369,-593
2019,8,9,12,2175,2002,1424,-578
2019,8,9,13,2295,2078,1443,-635
2019,8,9,14,2495,2178,1450,-728
2019,8,9,15,2631,2313,1592,-721
2019,8,9,16,2756,2426,1620,-806
2019,8,9,17,2875,2544,1683,-861
2019,8,9,18,2980,2648,1754,-894
2019,8,9,19,3045,2749,1749,-1000
2019,8,9,20,3116,2872,1883,-989
2019,8,9,21,3128,2972,1876,-1096
2019,8,9,22,3120,3024,1916,-1108
2019,8,9,23,3046,3009,1871,-1138
2019,8,10,0,3037,2982,1957,-1025
2019,8,10,1,2974,2924,1936,-988
2019,8,10,2,2932,2807,1961,-846
2019,8,10,3,2818,2699,1977,-722
2019,8,10,4,2604,2556,1721,-835
2019,8,10,5,2383,2405,1666,-739
2019,8,10,6,2304,2235,1578,-657
2019,8,10,7,2145,2096,1574,-522
2019,8,10,8,2056,1997,1359,-638
2019,8,10,9,1972,1939,1189,-750
2019,8,10,10,1974,1889,1230,-659
2019,8,10,11,1989,1849,1246,-603
2019,8,10,12,1988,1845,1281,-564
2019,8,10,13,2062,1878,1282,-596
2019,8,10,14,2211,1917,1281,-636
2019,8,10,15,2341,2018,1372,-646
2019,8,10,16,2468,2122,1381,-741
2019,8,10,17,2592,2224,1441,-783
2019,8,10,18,2705,2292,1520,-772
2019,8,10,19,2825,2342,1632,-710
2019,8,10,20,2858,2366,1760,-606
2019,8,10,21,2847,2437,1826,-611
2019,8,10,22,2796,2455,1835,-620
2019,8,10,23,2760,2455,1830,-625
2019,8,11,0,2649,2508,1974,-534
2019,8,11,1,2569,2556,2134,-422
2019,8,11,2,2540,2515,1938,-577
2019,8,11,3,2486,2416,1810,-606
2019,8,11,4,2334,2346,1718,-628
2019,8,11,5,2148,2213,1739,-474
2019,8,11,6,2283,2050,1711,-339
2019,8,11,7,2157,1931,1686,-245
2019,8,11,8,2110,1848,1702,-146
2019,8,11,9,1900,1793,1717,-76
2019,8,11,10,1884,1759,1685,-74
2019,8,11,11,1857,1727,1616,-111
2019,8,11,12,1860,1726,1574,-152
2019,8,11,13,1886,1745,1542,-203
2019,8,11,14,1993,1769,1568,-201
2019,8,11,15,2092,1870,1724,-146
2019,8,11,16,2157,1937,1705,-232
2019,8,11,17,2223,1986,1689,-297
2019,8,11,18,2258,2044,1663,-381
2019,8,11,19,2300,2079,1660,-419
2019,8,11,20,2363,2128,1686,-442
2019,8,11,21,2378,2182,1735,-447
2019,8,11,22,2417,2241,1776,-465
2019,8,11,23,2456,2328,1870,-458
2019,8,12,0,2486,2376,1946,-430
2019,8,12,1,2467,2419,2046,-373
2019,8,12,2,2413,2376,1973,-403
2019,8,12,3,2376,2323,1750,-573
2019,8,12,4,2297,2269,1578,-691
2019,8,12,5,2113,2127,1504,-623
2019,8,12,6,2124,1938,1400,-538
2019,8,12,7,2017,1822,1329,-493
2019,8,12,8,1866,1741,1337,-404
2019,8,12,9,1730,1706,1303,-403
2019,8,12,10,1758,1682,1260,-422
2019,8,12,11,1799,1688,1284,-404
2019,8,12,12,1895,1751,1329,-422
2019,8,12,13,1992,1853,1353,-500
2019,8,12,14,2096,1991,1382,-609
2019,8,12,15,2230,2099,1396,-703
2019,8,12,16,2387,2185,1401,-784
2019,8,12,17,2566,2263,1485,-778
2019,8,12,18,2611,2342,1559,-783
2019,8,12,19,2652,2410,1565,-845
2019,8,12,20,2705,2497,1630,-867
2019,8,12,21,2734,2584,1768,-816
2019,8,12,22,2734,2658,1888,-770
2019,8,12,23,2782,2719,1933,-786
2019,8,13,0,2817,2763,1917,-846
2019,8,13,1,2836,2808,1921,-887
2019,8,13,2,2759,2781,1925,-856
2019,8,13,3,2699,2681,1743,-938
2019,8,13,4,2520,2588,1851,-737
2019,8,13,5,2295,2394,1700,-694
2019,8,13,6,2158,2173,1495,-678
2019,8,13,7,2052,2027,1389,-638
2019,8,13,8,1962,1932,1350,-582
2019,8,13,9,1935,1866,1330,-536
2019,8,13,10,1940,1837,1345,-492
2019,8,13,11,1991,1815,1313,-502
2019,8,13,12,2072,1857,1347,-510
2019,8,13,13,2157,1934,1412,-522
2019,8,13,14,2363,2049,1428,-621
2019,8,13,15,2485,2152,1519,-633
2019,8,13,16,2595,2219,1560,-659
2019,8,13,17,2624,2310,1693,-617
2019,8,13,18,2694,2392,1678,-714
2019,8,13,19,2744,2486,1682,-804
2019,8,13,20,2822,2598,1682,-916
2019,8,13,21,2847,2724,1869,-855
2019,8,13,22,2906,2818,1903,-915
2019,8,13,23,2986,2884,1970,-914
2019,8,14,0,3038,2915,2077,-838
2019,8,14,1,3029,2926,2147,-779
2019,8,14,2,2910,2900,2152,-748
2019,8,14,3,2824,2817,2002,-815
2019,8,14,4,2654,2701,1889,-812
2019,8,14,5,2441,2474,1743,-731
2019,8,14,6,2251,2259,1520,-739
2019,8,14,7,2156,2090,1435,-655
2019,8,14,8,2111,1985,1360,-625
2019,8,14,9,2064,1916,1333,-583
2019,8,14,10,2014,1864,1303,-561
2019,8,14,11,2051,1860,1285,-575
2019,8,14,12,2118,1900,1320,-580
2019,8,14,13,2209,1993,1346,-647
2019,8,14,14,2363,2108,1376,-732
2019,8,14,15,2476,2228,1652,-576
2019,8,14,16,2570,2334,1737,-597
2019,8,14,17,2642,2421,1785,-636
2019,8,14,18,2714,2523,1769,-754
2019,8,14,19,2765,2632,1797,-835
2019,8,14,20,2901,2751,1824,-927
2019,8,14,21,3015,2899,2034,-865
2019,8,14,22,3096,3005,2074,-931
2019,8,14,23,3166,3088,2019,-1069
2019,8,15,0,3210,3154,2090,-1064
2019,8,15,1,3208,3166,2234,-932
2019,8,15,2,3126,3116,2229,-887
2019,8,15,3,3013,3007,2093,-914
2019,8,15,4,2804,2872,1949,-923
2019,8,15,5,2547,2641,1755,-886
2019,8,15,6,2282,2393,1521,-872
2019,8,15,7,2204,2214,1492,-722
2019,8,15,8,2128,2105,1416,-689
2019,8,15,9,2081,2020,1404,-616
2019,8,15,10,2031,1957,1411,-546
2019,8,15,11,2072,1929,1461,-468
2019,8,15,12,2149,1964,1447,-517
2019,8,15,13,2242,2051,1447,-604
2019,8,15,14,2360,2167,1472,-695
2019,8,15,15,2411,2283,1620,-663
2019,8,15,16,2486,2377,1672,-705
2019,8,15,17,2599,2478,1691,-787
2019,8,15,18,2712,2593,1753,-840
2019,8,15,19,2842,2696,1887,-809
2019,8,15,20,2969,2803,2027,-776
2019,8,15,21,3057,2927,2211,-716
2019,8,15,22,3120,2980,2359,-621
2019,8,15,23,3169,3005,2435,-570
2019,8,16,0,3148,3034,2486,-548
2019,8,16,1,3072,3038,2339,-699
2019,8,16,2,2954,2986,2270,-716
2019,8,16,3,2858,2887,2234,-653
2019,8,16,4,2654,2763,1874,-889
2019,8,16,5,2420,2554,1702,-852
2019,8,16,6,2249,2332,1666,-666
2019,8,16,7,2152,2180,1640,-540
2019,8,16,8,2070,2064,1503,-561
2019,8,16,9,1998,1980,1546,-434
2019,8,16,10,1979,1949,1567,-382
2019,8,16,11,2017,1913,1563,-350
2019,8,16,12,2100,1953,1562,-391
2019,8,16,13,2202,2047,1591,-456
2019,8,16,14,2341,2140,1614,-526
2019,8,16,15,2440,2242,1688,-554
2019,8,16,16,2484,2346,1826,-520
2019,8,16,17,2577,2413,1880,-533
2019,8,16,18,2651,2509,1936,-573
2019,8,16,19,2758,2577,2080,-497
2019,8,16,20,2879,2661,2088,-573
2019,8,16,21,2940,2739,2067,-672
2019,8,16,22,2939,2815,2079,-736
2019,8,16,23,2888,2870,2173,-697
2019,8,17,0,2890,2909,2211,-698
2019,8,17,1,2844,2909,2345,-564
2019,8,17,2,2793,2835,2204,-631
2019,8,17,3,2674,2718,2033,-685
2019,8,17,4,2507,2601,1937,-664
2019,8,17,5,2302,2416,1758,-658
2019,8,17,6,2146,2251,1601,-650
2019,8,17,7,2042,2105,1472,-633
2019,8,17,8,1978,1995,1470,-525
2019,8,17,9,1955,1926,1398,-528
2019,8,17,10,1922,1880,1349,-531
2019,8,17,11,1918,1849,1371,-478
2019,8,17,12,1925,1850,1413,-437
2019,8,17,13,1992,1875,1516,-359
2019,8,17,14,2118,1925,1540,-385
2019,8,17,15,2256,2030,1644,-386
2019,8,17,16,2330,2117,1725,-392
2019,8,17,17,2439,2201,1836,-365
2019,8,17,18,2488,2265,1820,-445
2019,8,17,19,2527,2341,1838,-503
2019,8,17,20,2608,2399,1838,-561
2019,8,17,21,2670,2479,1938,-541
2019,8,17,22,2712,2570,2048,-522
2019,8,17,23,2747,2652,2064,-588
2019,8,18,0,2787,2704,2102,-602
2019,8,18,1,2771,2704,2087,-617
2019,8,18,2,2642,2662,1919,-743
2019,8,18,3,2540,2579,1914,-665
2019,8,18,4,2368,2478,1668,-810
2019,8,18,5,2216,2337,1477,-860
2019,8,18,6,2146,2165,1309,-856
2019,8,18,7,2056,2027,1302,-725
2019,8,18,8,2026,1938,1262,-676
2019,8,18,9,1947,1869,1239,-630
2019,8,18,10,1919,1820,1222,-598
2019,8,18,11,1931,1797,1206,-591
2019,8,18,12,1923,1791,1198,-593
2019,8,18,13,1973,1802,1184,-618
2019,8,18,14,2059,1841,1239,-602
2019,8,18,15,2130,1932,1347,-585
2019,8,18,16,2174,2035,1400,-635
2019,8,18,17,2241,2118,1437,-681
2019,8,18,18,2295,2199,1588,-611
2019,8,18,19,2391,2317,1599,-718
2019,8,18,20,2503,2457,1634,-823
2019,8,18,21,2643,2585,1624,-961
2019,8,18,22,2808,2723,1796,-927
2019,8,18,23,2941,2831,1835,-996
2019,8,19,0,2998,2923,1977,-946
2019,8,19,1,2980,2962,1990,-972
2019,8,19,2,2877,2933,1957,-976
2019,8,19,3,2796,2830,1813,-1017
2019,8,19,4,2662,2707,1779,-928
2019,8,19,5,2448,2445,1476,-969
2019,8,19,6,2222,2215,1370,-845
2019,8,19,7,2142,2049,1267,-782
2019,8,19,8,2068,1949,1211,-738
2019,8,19,9,2016,1871,1203,-668
2019,8,19,10,2010,1830,1174,-656
2019,8,19,11,2045,1820,1186,-634
2019,8,19,12,2107,1879,1326,-553
2019,8,19,13,2192,2019,1539,-480
2019,8,19,14,2266,2138,1537,-601
2019,8,19,15,2400,2273,1597,-676
2019,8,19,16,2496,2384,1661,-723
2019,8,19,17,2675,2517,1745,-772
2019,8,19,18,2788,2643,1773,-870
2019,8,19,19,2926,2766,1721,-1045
2019,8,19,20,3064,2907,1683,-1224
2019,8,19,21,3167,3041,1819,-1222
2019,8,19,22,3252,3140,1931,-1209
2019,8,19,23,3341,3224,2065,-1159
2019,8,20,0,3348,3266,2056,-1210
2019,8,20,1,3316,3279,2161,-1118
2019,8,20,2,3169,3245,2157,-1088
2019,8,20,3,3044,3111,2080,-1031
2019,8,20,4,2817,2967,2015,-952
2019,8,20,5,2586,2706,1848,-858
2019,8,20,6,2307,2451,1701,-750
2019,8,20,7,2195,2265,1510,-755
2019,8,20,8,2096,2131,1312,-819
2019,8,20,9,2101,2030,1217,-813
2019,8,20,10,2060,1956,1183,-773
2019,8,20,11,2083,1942,1201,-741
2019,8,20,12,2158,1967,1201,-766
2019,8,20,13,2258,2098,1247,-851
2019,8,20,14,2426,2205,1282,-923
2019,8,20,15,2588,2327,1499,-828
2019,8,20,16,2684,2420,1521,-899
2019,8,20,17,2775,2536,1556,-980
2019,8,20,18,2870,2660,1636,-1024
2019,8,20,19,3013,2797,1833,-964
2019,8,20,20,3158,2938,1883,-1055
2019,8,20,21,3284,3110,2033,-1077
2019,8,20,22,3378,3219,2066,-1153
2019,8,20,23,3457,3321,2202,-1119
2019,8,21,0,3487,3372,2182,-1190
2019,8,21,1,3450,3390,2160,-1230
2019,8,21,2,3328,3370,2122,-1248
2019,8,21,3,3183,3232,2077,-1155
2019,8,21,4,2924,3063,2081,-982
2019,8,21,5,2662,2778,1901,-877
2019,8,21,6,2336,2489,1762,-727
2019,8,21,7,2225,2303,1545,-758
2019,8,21,8,2169,2169,1415,-754
2019,8,21,9,2167,2080,1347,-733
2019,8,21,10,2136,2008,1313,-695
2019,8,21,11,2156,1996,1336,-660
2019,8,21,12,2250,2039,1361,-678
2019,8,21,13,2312,2134,1385,-749
2019,8,21,14,2482,2242,1463,-779
2019,8,21,15,2576,2346,1610,-736
2019,8,21,16,2684,2456,1624,-832
2019,8,21,17,2764,2559,1638,-921
2019,8,21,18,2874,2689,1774,-915
2019,8,21,19,3058,2815,1801,-1014
2019,8,21,20,3181,2965,1933,-1032
2019,8,21,21,3300,3099,1992,-1107
2019,8,21,22,3402,3217,2017,-1200
2019,8,21,23,3462,3286,2110,-1176
2019,8,22,0,3485,3341,2164,-1177
2019,8,22,1,3432,3331,2135,-1196
2019,8,22,2,3285,3278,2101,-1177
2019,8,22,3,3123,3147,1925,-1222
2019,8,22,4,2848,3002,1897,-1105
2019,8,22,5,2598,2743,1741,-1002
2019,8,22,6,2352,2498,1730,-768
2019,8,22,7,2239,2338,1800,-538
2019,8,22,8,2176,2221,1731,-490
2019,8,22,9,2143,2140,1709,-431
2019,8,22,10,2122,2085,1743,-342
2019,8,22,11,2178,2066,1751,-315
2019,8,22,12,2297,2094,1743,-351
2019,8,22,13,2385,2194,1797,-397
2019,8,22,14,2442,2289,1800,-489
2019,8,22,15,2490,2363,1976,-387
2019,8,22,16,2532,2440,2036,-404
2019,8,22,17,2621,2490,2088,-402
2019,8,22,18,2735,2441,2038,-403
2019,8,22,19,2874,2624,2140,-484
2019,8,22,20,2972,2689,2129,-560
2019,8,22,21,3030,2749,2104,-645
2019,8,22,22,3073,2796,2147,-649
2019,8,22,23,3046,2843,2166,-677
2019,8,23,0,2988,2874,2179,-695
2019,8,23,1,2915,2872,2257,-615
2019,8,23,2,2807,2858,2331,-527
2019,8,23,3,2711,2742,2223,-519
2019,8,23,4,2505,2660,2135,-525
2019,8,23,5,2295,2472,1925,-547
2019,8,23,6,2205,2264,1838,-426
2019,8,23,7,2095,2121,1621,-500
2019,8,23,8,2030,2020,1543,-477
2019,8,23,9,1937,1958,1461,-497
2019,8,23,10,1934,1918,1350,-568
2019,8,23,11,1981,1907,1291,-616
2019,8,23,12,2098,1955,1258,-697
2019,8,23,13,2219,2056,1283,-773
2019,8,23,14,2372,2161,1445,-716
2019,8,23,15,2484,2262,1554,-708
2019,8,23,16,2587,2338,1610,-728
2019,8,23,17,2663,2402,1675,-727
2019,8,23,18,2724,2464,1721,-743
2019,8,23,19,2813,2535,1780,-755
2019,8,23,20,2871,2626,1744,-882
2019,8,23,21,2931,2725,1754,-971
2019,8,23,22,2959,2795,1803,-992
2019,8,23,23,2896,2852,1749,-1103
2019,8,24,0,2880,2895,1866,-1029
2019,8,24,1,2814,2903,2095,-808
2019,8,24,2,2788,2847,2048,-799
2019,8,24,3,2688,2737,1992,-745
2019,8,24,4,2530,2638,1852,-786
2019,8,24,5,2351,2469,1663,-806
2019,8,24,6,2220,2284,1463,-821
2019,8,24,7,2124,2148,1396,-752
2019,8,24,8,2081,2042,1319,-723
2019,8,24,9,2056,1968,1324,-644
2019,8,24,10,2048,1913,1287,-626
2019,8,24,11,2037,1892,1258,-634
2019,8,24,12,2071,1894,1283,-611
2019,8,24,13,2121,1926,1340,-586
2019,8,24,14,2218,1971,1324,-647
2019,8,24,15,2330,2086,1461,-625
2019,8,24,16,2430,2205,1516,-689
2019,8,24,17,2548,2310,1594,-716
2019,8,24,18,2576,2410,1696,-714
2019,8,24,19,2668,2520,1732,-788
2019,8,24,20,2784,2625,1758,-867
2019,8,24,21,2871,2760,1777,-983
2019,8,24,22,2986,2876,1809,-1067
2019,8,24,23,3077,2970,1842,-1128
2019,8,25,0,3120,3031,1985,-1046
2019,8,25,1,3089,3046,2180,-866
2019,8,25,2,2961,2990,2266,-724
2019,8,25,3,2862,2868,2166,-702
2019,8,25,4,2654,2739,2016,-723
2019,8,25,5,2471,2537,1675,-862
2019,8,25,6,2324,2333,1581,-752
2019,8,25,7,2217,2163,1521,-642
2019,8,25,8,2154,2054,1310,-744
2019,8,25,9,2045,1959,1397,-562
2019,8,25,10,1999,1904,1447,-457
2019,8,25,11,1969,1860,1517,-343
2019,8,25,12,1964,1853,1552,-301
2019,8,25,13,1987,1868,1506,-362
2019,8,25,14,2076,1889,1449,-440
2019,8,25,15,2123,1995,1549,-446
2019,8,25,16,2176,2102,1658,-444
2019,8,25,17,2253,2185,1768,-417
2019,8,25,18,2339,2274,1870,-404
2019,8,25,19,2437,2356,1938,-418
2019,8,25,20,2556,2443,2099,-344
2019,8,25,21,2654,2521,2125,-396
2019,8,25,22,2753,2609,2212,-397
2019,8,25,23,2826,2678,2196,-482
2019,8,26,0,2819,2734,2304,-430
2019,8,26,1,2756,2729,2340,-389
2019,8,26,2,2645,2683,2386,-297
2019,8,26,3,2561,2587,2177,-410
2019,8,26,4,2414,2478,1932,-546
2019,8,26,5,2214,2270,1794,-476
2019,8,26,6,2118,2058,1683,-375
2019,8,26,7,2022,1943,1599,-344
2019,8,26,8,1928,1846,1489,-357
2019,8,26,9,1801,1794,1487,-307
2019,8,26,10,1807,1759,1388,-371
2019,8,26,11,1873,1775,1369,-406
2019,8,26,12,2003,1825,1377,-448
2019,8,26,13,2116,1982,1366,-616
2019,8,26,14,2199,2104,1325,-779
2019,8,26,15,2318,2197,1490,-707
2019,8,26,16,2412,2277,1672,-605
2019,8,26,17,2539,2338,1616,-722
2019,8,26,18,2599,2405,1664,-741
2019,8,26,19,2700,2473,1742,-731
2019,8,26,20,2785,2522,1796,-726
2019,8,26,21,2819,2605,1859,-746
2019,8,26,22,2841,2664,1948,-716
2019,8,26,23,2866,2751,2128,-623
2019,8,27,0,2865,2799,2035,-764
2019,8,27,1,2854,2828,2136,-692
2019,8,27,2,2755,2811,2287,-524
2019,8,27,3,2656,2722,2148,-574
2019,8,27,4,2440,2597,2093,-504
2019,8,27,5,2219,2373,1789,-584
2019,8,27,6,2151,2178,1722,-456
2019,8,27,7,2066,2048,1576,-472
2019,8,27,8,1970,1970,1450,-520
2019,8,27,9,1951,1913,1331,-582
2019,8,27,10,1952,1891,1288,-603
2019,8,27,11,2001,1872,1246,-626
2019,8,27,12,2109,1936,1284,-652
2019,8,27,13,2220,2067,1373,-694
2019,8,27,14,2376,2183,1513,-670
2019,8,27,15,2493,2251,1607,-644
2019,8,27,16,2597,2313,1677,-636
2019,8,27,17,2622,2367,1678,-689
2019,8,27,18,2661,2428,1709,-719
2019,8,27,19,2724,2483,1682,-801
2019,8,27,20,2809,2571,1712,-859
2019,8,27,21,2858,2653,1755,-898
2019,8,27,22,2917,2768,2021,-747
2019,8,27,23,2983,2879,2080,-799
2019,8,28,0,3031,2951,2063,-888
2019,8,28,1,3028,2992,2092,-900
2019,8,28,2,2902,2966,2043,-923
2019,8,28,3,2803,2860,1956,-904
2019,8,28,4,2570,2723,1912,-811
2019,8,28,5,2354,2482,1697,-785
2019,8,28,6,2178,2249,1562,-687
2019,8,28,7,2081,2106,1464,-642
2019,8,28,8,2034,2009,1409,-600
2019,8,28,9,2041,1957,1316,-641
2019,8,28,10,2030,1918,1271,-647
2019,8,28,11,2080,1909,1257,-652
2019,8,28,12,2208,1954,1270,-684
2019,8,28,13,2284,2087,1388,-699
2019,8,28,14,2408,2191,1395,-796
2019,8,28,15,2494,2262,1518,-744
2019,8,28,16,2586,2330,1559,-771
2019,8,28,17,2651,2399,1591,-808
2019,8,28,18,2718,2467,1569,-898
2019,8,28,19,2827,2556,1579,-977
2019,8,28,20,2952,2687,1654,-1033
2019,8,28,21,3037,2816,1733,-1083
2019,8,28,22,3135,2961,1839,-1122
2019,8,28,23,3208,3072,2024,-1048
2019,8,29,0,3244,3157,2046,-1111
2019,8,29,1,3252,3197,2061,-1136
2019,8,29,2,3119,3141,1987,-1154
2019,8,29,3,3005,3030,1947,-1083
2019,8,29,4,2755,2881,1841,-1040
2019,8,29,5,2530,2630,1641,-989
2019,8,29,6,2367,2409,1552,-857
2019,8,29,7,2281,2238,1492,-746
2019,8,29,8,2226,2133,1420,-713
2019,8,29,9,2187,2073,1392,-681
2019,8,29,10,2162,2018,1341,-677
2019,8,29,11,2208,1997,1339,-658
2019,8,29,12,2296,2053,1397,-656
2019,8,29,13,2370,2184,1510,-674
2019,8,29,14,2465,2292,1533,-759
2019,8,29,15,2557,2361,1610,-751
2019,8,29,16,2648,2430,1462,-968
2019,8,29,17,2731,2503,1520,-983
2019,8,29,18,2785,2596,1700,-896
2019,8,29,19,2878,2714,1695,-1019
2019,8,29,20,3002,2847,1663,-1184
2019,8,29,21,3102,2959,1782,-1177
2019,8,29,22,3241,3075,1892,-1183
2019,8,29,23,3316,3173,2088,-1085
2019,8,30,0,3363,3215,2287,-928
2019,8,30,1,3304,3195,2150,-1045
2019,8,30,2,3168,3122,2020,-1102
2019,8,30,3,3013,3025,1940,-1085
2019,8,30,4,2774,2892,1942,-950
2019,8,30,5,2531,2678,1724,-954
2019,8,30,6,2363,2454,1633,-821
2019,8,30,7,2252,2273,1569,-704
2019,8,30,8,2166,2150,1412,-738
2019,8,30,9,2121,2066,1416,-650
2019,8,30,10,2101,2016,1372,-644
2019,8,30,11,2139,1995,1364,-631
2019,8,30,12,2250,2030,1361,-669
2019,8,30,13,2375,2131,1432,-699
2019,8,30,14,2461,2239,1543,-696
2019,8,30,15,2487,2343,1664,-679
2019,8,30,16,2555,2455,1787,-668
2019,8,30,17,2646,2564,1778,-786
2019,8,30,18,2765,2670,1844,-826
2019,8,30,19,2929,2768,1857,-911
2019,8,30,20,3086,2877,1903,-974
2019,8,30,21,3198,2977,1912,-1065
2019,8,30,22,3295,3062,2028,-1034
2019,8,30,23,3247,3107,2089,-1018
2019,8,31,0,3200,3136,2164,-972
2019,8,31,1,3106,3114,2230,-884
2019,8,31,2,3041,3031,2217,-814
2019,8,31,3,2894,2895,2036,-859
2019,8,31,4,2699,2748,1959,-789
2019,8,31,5,2474,2546,1719,-827
2019,8,31,6,2275,2349,1647,-702
2019,8,31,7,2183,2193,1512,-681
2019,8,31,8,2120,2078,1372,-706
2019,8,31,9,2062,1996,1293,-703
2019,8,31,10,2016,1940,1251,-689
2019,8,31,11,2004,1900,1216,-684
2019,8,31,12,2056,1903,1189,-714
2019,8,31,13,2090,1923,1233,-690
2019,8,31,14,2194,1971,1353,-618
2019,8,31,15,2291,2089,1437,-652
2019,8,31,16,2385,2218,1459,-759
2019,8,31,17,2509,2331,1509,-822
2019,8,31,18,2600,2453,1520,-933
2019,8,31,19,2720,2582,1575,-1007
2019,8,31,20,2853,2713,1606,-1107
2019,8,31,21,2960,2834,1656,-1178
2019,8,31,22,3076,2944,1694,-1250
2019,8,31,23,3174,3022,1927,-1095
2019,9,1,0,3178,3058,1962,-1096
2019,9,1,1,3095,3060,1990,-1070
2019,9,1,2,2934,2994,1883,-1111
2019,9,1,3,2812,2853,1693,-1160
2019,9,1,4,2612,2694,1484,-1210
2019,9,1,5,2423,2500,1423,-1077
2019,9,1,6,2305,2317,1437,-880
2019,9,1,7,2219,2176,1378,-798
2019,9,1,8,2156,2023,1362,-661
2019,9,1,9,2086,1954,1368,-586
2019,9,1,10,2040,1894,1366,-528
2019,9,1,11,2007,1846,1347,-499
2019,9,1,12,1983,1833,1354,-479
2019,9,1,13,1969,1832,1399,-433
2019,9,1,14,2055,1859,1432,-427
2019,9,1,15,2176,1944,1491,-453
2019,9,1,16,2258,2044,1481,-563
2019,9,1,17,2354,2175,1458,-717
2019,9,1,18,2414,2288,1491,-797
2019,9,1,19,2541,2433,1636,-797
2019,9,1,20,2676,2569,1696,-873
2019,9,1,21,2833,2691,1668,-1023
2019,9,1,22,2960,2808,1864,-944
2019,9,1,23,3056,2901,2010,-891
2019,9,2,0,3067,2962,1932,-1030
2019,9,2,1,3019,2946,1891,-1055
2019,9,2,2,2866,2871,1925,-946
2019,9,2,3,2724,2714,1677,-1037
2019,9,2,4,2509,2554,1521,-1033
2019,9,2,5,2285,2340,1472,-868
2019,9,2,6,2231,2147,1500,-647
2019,9,2,7,2133,1992,1386,-606
2019,9,2,8,2051,1884,1344,-540
2019,9,2,9,1925,1816,1345,-471
2019,9,2,10,1910,1765,1288,-477
2019,9,2,11,1952,1744,1274,-470
2019,9,2,12,2055,1752,1267,-485
2019,9,2,13,2117,1782,1355,-427
2019,9,2,14,2123,1845,1298,-547
2019,9,2,15,2135,1979,1384,-595
2019,9,2,16,2186,2135,1478,-657
2019,9,2,17,2377,2258,1514,-744
2019,9,2,18,2518,2396,1588,-808
2019,9,2,19,2673,2511,1584,-927
2019,9,2,20,2806,2634,1680,-954
2019,9,2,21,2910,2749,1827,-922
2019,9,2,22,2977,2868,1996,-872
2019,9,2,23,3036,2965,1993,-972
2019,9,3,0,3056,3039,1998,-1041
2019,9,3,1,3032,3051,1934,-1117
2019,9,3,2,2918,2988,1787,-1201
2019,9,3,3,2810,2882,1708,-1174
2019,9,3,4,2600,2721,1744,-977
2019,9,3,5,2408,2461,1675,-786
2019,9,3,6,2330,2231,1570,-661
2019,9,3,7,2225,2064,1411,-653
2019,9,3,8,2088,1969,1351,-618
2019,9,3,9,1959,1889,1287,-602
2019,9,3,10,1915,1841,1241,-600
2019,9,3,11,1939,1839,1249,-590
2019,9,3,12,2028,1890,1308,-582
2019,9,3,13,2099,2039,1442,-597
2019,9,3,14,2236,2157,1407,-750
2019,9,3,15,2434,2231,1533,-698
2019,9,3,16,2600,2326,1575,-751
2019,9,3,17,2740,2438,1609,-829
2019,9,3,18,2815,2530,1656,-874
2019,9,3,19,2970,2651,1710,-941
2019,9,3,20,3058,2777,1836,-941
2019,9,3,21,3140,2913,1927,-986
2019,9,3,22,3217,3046,2014,-1032
2019,9,3,23,3280,3149,2031,-1118
2019,9,4,0,3291,3194,1992,-1202
2019,9,4,1,3251,3218,2049,-1169
2019,9,4,2,3109,3183,2102,-1081
2019,9,4,3,2987,3048,1902,-1146
2019,9,4,4,2764,2886,1846,-1040
2019,9,4,5,2524,2610,1665,-945
2019,9,4,6,2332,2359,1583,-776
2019,9,4,7,2225,2197,1535,-662
2019,9,4,8,2100,2093,1502,-591
2019,9,4,9,2064,2000,1450,-550
2019,9,4,10,2032,1957,1489,-468
2019,9,4,11,2058,1932,1433,-499
2019,9,4,12,2148,1977,1515,-462
2019,9,4,13,2239,2114,1722,-392
2019,9,4,14,2352,2223,1830,-393
2019,9,4,15,2485,2295,1837,-458
2019,9,4,16,2603,2421,1714,-707
2019,9,4,17,2721,2495,1707,-788
2019,9,4,18,2795,2596,1627,-969
2019,9,4,19,2909,2711,1809,-902
2019,9,4,20,3051,2719,1831,-888
2019,9,4,21,3162,3095,2112,-983
2019,9,4,22,3290,3045,2142,-903
2019,9,4,23,3371,3123,2081,-1042
2019,9,5,0,3314,3194,2081,-1113
2019,9,5,1,3241,3217,2114,-1103
2019,9,5,2,3140,3164,2100,-1064
2019,9,5,3,3000,3056,1984,-1072
2019,9,5,4,2759,2878,1858,-1020
2019,9,5,5,2518,2612,1757,-855
2019,9,5,6,2305,2382,1542,-840
2019,9,5,7,2208,2226,1509,-717
2019,9,5,8,2157,2135,1540,-595
2019,9,5,9,2122,2045,1461,-584
2019,9,5,10,2105,2005,1461,-544
2019,9,5,11,2163,1987,1498,-489
2019,9,5,12,2299,2029,1481,-548
2019,9,5,13,2377,2174,1581,-593
2019,9,5,14,2468,2308,1608,-700
2019,9,5,15,2589,2368,1669,-699
2019,9,5,16,2741,2483,1794,-689
2019,9,5,17,2839,2617,1790,-827
2019,9,5,18,2969,2733,1755,-978
2019,9,5,19,3105,2896,1765,-1131
2019,9,5,20,3216,3041,1897,-1144
2019,9,5,21,3326,3183,2105,-1078
2019,9,5,22,3418,3274,2147,-1127
2019,9,5,23,3487,3308,2148,-1160
2019,9,6,0,3499,3317,2135,-1182
2019,9,6,1,3394,3263,2090,-1173
2019,9,6,2,3229,3176,2078,-1098
2019,9,6,3,3042,3073,2054,-1019
2019,9,6,4,2812,2862,2142,-720
2019,9,6,5,2585,2629,1949,-680
2019,9,6,6,2313,2419,1799,-620
2019,9,6,7,2189,2270,1836,-434
2019,9,6,8,2119,2172,1735,-437
2019,9,6,9,2155,2096,1663,-433
2019,9,6,10,2138,2045,1748,-297
2019,9,6,11,2184,2033,1686,-347
2019,9,6,12,2324,2062,1532,-530
2019,9,6,13,2418,2206,1538,-668
2019,9,6,14,2491,2311,1610,-701
2019,9,6,15,2572,2384,1633,-751
2019,9,6,16,2654,2446,1588,-858
2019,9,6,17,2736,2481,1596,-885
2019,9,6,18,2804,2447,1592,-855
2019,9,6,19,2878,2414,1896,-518
2019,9,6,20,2896,2467,2112,-355
2019,9,6,21,2862,2544,2121,-423
2019,9,6,22,2841,2625,2068,-557
2019,9,6,23,2773,2669,2040,-629
2019,9,7,0,2725,2653,2036,-617
2019,9,7,1,2651,2651,2040,-611
2019,9,7,2,2586,2604,2013,-591
2019,9,7,3,2511,2536,1932,-604
2019,9,7,4,2383,2446,1886,-560
2019,9,7,5,2246,2279,1635,-644
2019,9,7,6,2129,2118,1548,-570
2019,9,7,7,2042,1968,1343,-625
2019,9,7,8,2011,1900,1279,-621
2019,9,7,9,1896,1841,1253,-588
2019,9,7,10,1863,1802,1235,-567
2019,9,7,11,1868,1782,1236,-546
2019,9,7,12,1920,1785,1230,-555
2019,9,7,13,1982,1822,1271,-551
2019,9,7,14,2082,1853,1283,-570
2019,9,7,15,2180,1939,1382,-557
2019,9,7,16,2249,2039,1431,-608
2019,9,7,17,2320,2124,1499,-625
2019,9,7,18,2362,2186,1673,-513
2019,9,7,19,2457,2276,1767,-509
2019,9,7,20,2568,2353,1820,-533
2019,9,7,21,2677,2454,1791,-663
2019,9,7,22,2731,2524,1802,-722
2019,9,7,23,2785,2546,1793,-753
2019,9,8,0,2748,2549,1738,-811
2019,9,8,1,2669,2507,1784,-723
2019,9,8,2,2527,2440,1836,-604
2019,9,8,3,2390,2400,1673,-727
2019,9,8,4,2268,2290,1571,-719
2019,9,8,5,2149,2145,1358,-787
2019,9,8,6,2201,1997,1322,-675
2019,9,8,7,2122,1878,1196,-682
2019,9,8,8,2029,1800,1215,-585
2019,9,8,9,1856,1734,1348,-386
2019,9,8,10,1827,1683,1356,-327
2019,9,8,11,1809,1659,1387,-272
2019,9,8,12,1816,1627,1400,-227
2019,9,8,13,1852,1649,1374,-275
2019,9,8,14,1913,1700,1327,-373
2019,9,8,15,1944,1753,1281,-472
2019,9,8,16,1981,1824,1205,-619
2019,9,8,17,1975,1863,1105,-758
2019,9,8,18,1996,1897,1388,-509
2019,9,8,19,2054,1876,1442,-434
2019,9,8,20,2089,1890,1543,-347
2019,9,8,21,2093,1884,1597,-287
2019,9,8,22,2086,1873,1650,-223
2019,9,8,23,2086,1901,1758,-143
2019,9,9,0,2030,1939,1756,-183
2019,9,9,1,2007,1949,1666,-283
2019,9,9,2,1998,1959,1710,-249
2019,9,9,3,1984,1979,1667,-312
2019,9,9,4,1924,1905,1564,-341
2019,9,9,5,1825,1772,1480,-292
2019,9,9,6,1918,1636,1365,-271
2019,9,9,7,1853,1556,1291,-265
2019,9,9,8,1657,1514,1245,-269
2019,9,9,9,1518,1480,1178,-302
2019,9,9,10,1551,1487,1210,-277
2019,9,9,11,1625,1486,1219,-267
2019,9,9,12,1739,1574,1250,-324
2019,9,9,13,1851,1718,1359,-359
2019,9,9,14,1985,1858,1383,-475
2019,9,9,15,2125,1887,1466,-421
2019,9,9,16,2224,1931,1486,-445
2019,9,9,17,2212,1968,1551,-417
2019,9,9,18,2214,1987,1638,-349
2019,9,9,19,2243,2014,1647,-367
2019,9,9,20,2277,2038,1769,-269
2019,9,9,21,2284,2075,1762,-313
2019,9,9,22,2256,2113,1764,-349
2019,9,9,23,2238,2152,1739,-413
2019,9,10,0,2193,2156,1764,-392
2019,9,10,1,2164,2165,1864,-301
2019,9,10,2,2133,2141,1839,-302
2019,9,10,3,2111,2135,1847,-288
2019,9,10,4,2012,2039,1644,-395
2019,9,10,5,1886,1880,1534,-346
2019,9,10,6,2032,1737,1430,-307
2019,9,10,7,1960,1646,1293,-353
2019,9,10,8,1752,1598,1239,-359
2019,9,10,9,1620,1559,1161,-398
2019,9,10,10,1623,1551,1160,-391
2019,9,10,11,1679,1554,1173,-381
2019,9,10,12,1813,1619,1227,-392
2019,9,10,13,1909,1756,1245,-511
2019,9,10,14,1950,1863,1411,-452
2019,9,10,15,2031,1903,1528,-375
2019,9,10,16,2088,1913,1357,-556
2019,9,10,17,2160,1939,1450,-489
2019,9,10,18,2199,1928,1484,-444
2019,9,10,19,2241,1936,1542,-394
2019,9,10,20,2274,1940,1478,-462
2019,9,10,21,2210,1947,1567,-380
2019,9,10,22,2177,1953,1709,-244
2019,9,10,23,2115,1950,1721,-229
2019,9,11,0,2078,1978,1734,-244
2019,9,11,1,2053,1966,1800,-166
2019,9,11,2,2046,1947,1762,-185
2019,9,11,3,1973,1970,1798,-172
2019,9,11,4,1870,1902,1650,-252
2019,9,11,5,1775,1756,1600,-156
2019,9,11,6,1840,1610,1374,-236
2019,9,11,7,1770,1522,1231,-291
2019,9,11,8,1630,1486,1164,-322
2019,9,11,9,1540,1465,1165,-300
2019,9,11,10,1538,1458,1180,-278
2019,9,11,11,1596,1467,1220,-247
2019,9,11,12,1732,1541,1255,-286
2019,9,11,13,1821,1690,1365,-325
2019,9,11,14,1884,1804,1509,-295
2019,9,11,15,1966,1822,1640,-182
2019,9,11,16,2050,1848,1718,-130
2019,9,11,17,2104,1866,1765,-101
2019,9,11,18,2103,1887,1820,-67
2019,9,11,19,2124,1894,1849,-45
2019,9,11,20,2147,1899,1819,-80
2019,9,11,21,2137,1930,1849,-81
2019,9,11,22,2137,1938,2004,66
2019,9,11,23,2116,1998,2114,116
2019,9,12,0,2074,2017,2078,61
2019,9,12,1,2042,2009,1968,-41
2019,9,12,2,2031,1978,1888,-90
2019,9,12,3,1955,1996,1804,-192
2019,9,12,4,1828,1934,1864,-70
2019,9,12,5,1714,1773,1710,-63
2019,9,12,6,1746,1646,1756,110
2019,9,12,7,1684,1549,1549,0
2019,9,12,8,1590,1499,1252,-247
2019,9,12,9,1543,1465,1221,-244
2019,9,12,10,1552,1454,1226,-228
2019,9,12,11,1618,1466,1218,-248
2019,9,12,12,1762,1534,1252,-282
2019,9,12,13,1849,1693,1318,-375
2019,9,12,14,1900,1781,1331,-450
2019,9,12,15,1985,1828,1444,-384
2019,9,12,16,2062,1837,1539,-298
2019,9,12,17,2106,1848,1542,-306
2019,9,12,18,2075,1863,1528,-335
2019,9,12,19,2080,1885,1569,-316
2019,9,12,20,2075,1910,1736,-174
2019,9,12,21,2088,1948,1740,-208
2019,9,12,22,2112,1991,1800,-191
2019,9,12,23,2137,2016,1836,-180
2019,9,13,0,2132,2067,1856,-211
2019,9,13,1,2085,2074,1767,-307
2019,9,13,2,2074,2050,1694,-356
2019,9,13,3,2011,2044,1584,-460
2019,9,13,4,1863,1943,1593,-350
2019,9,13,5,1747,1792,1556,-236
2019,9,13,6,1779,1640,1443,-197
2019,9,13,7,1722,1555,1326,-229
2019,9,13,8,1657,1499,1289,-210
2019,9,13,9,1609,1458,1286,-172
2019,9,13,10,1616,1453,1335,-118
2019,9,13,11,1678,1448,1332,-116
2019,9,13,12,1817,1516,1307,-209
2019,9,13,13,1875,1650,1340,-310
2019,9,13,14,1914,1741,1369,-372
2019,9,13,15,1960,1794,1498,-296
2019,9,13,16,2018,1844,1582,-262
2019,9,13,17,2109,1870,1582,-288
2019,9,13,18,2135,1897,1578,-319
2019,9,13,19,2201,1923,1665,-258
2019,9,13,20,2227,1975,1680,-295
2019,9,13,21,2258,2036,1742,-294
2019,9,13,22,2300,2093,1739,-354
2019,9,13,23,2368,2155,1808,-347
2019,9,14,0,2347,2197,1831,-366
2019,9,14,1,2290,2166,1773,-393
2019,9,14,2,2141,2104,1666,-438
2019,9,14,3,2046,2058,1659,-399
2019,9,14,4,1914,1957,1713,-244
2019,9,14,5,1830,1839,1638,-201
2019,9,14,6,1855,1693,1501,-192
2019,9,14,7,1781,1585,1393,-192
2019,9,14,8,1677,1514,1264,-250
2019,9,14,9,1576,1462,1258,-204
2019,9,14,10,1552,1438,1254,-184
2019,9,14,11,1567,1425,1222,-203
2019,9,14,12,1622,1447,1270,-177
2019,9,14,13,1650,1493,1271,-222
2019,9,14,14,1725,1542,1242,-300
2019,9,14,15,1786,1633,1336,-297
2019,9,14,16,1860,1706,1405,-301
2019,9,14,17,1950,1765,1463,-302
2019,9,14,18,2001,1836,1478,-358
2019,9,14,19,2069,1875,1455,-420
2019,9,14,20,2147,1947,1569,-378
2019,9,14,21,2218,2039,1565,-474
2019,9,14,22,2289,2134,1650,-484
2019,9,14,23,2364,2218,1657,-561
2019,9,15,0,2390,2273,1720,-553
2019,9,15,1,2307,2277,1826,-451
2019,9,15,2,2223,2156,1717,-439
2019,9,15,3,2094,2100,1709,-391
2019,9,15,4,1966,1993,1724,-269
2019,9,15,5,1893,1842,1574,-268
2019,9,15,6,1910,1715,1500,-215
2019,9,15,7,1844,1591,1399,-192
2019,9,15,8,1775,1513,1398,-115
2019,9,15,9,1666,1464,1354,-110
2019,9,15,10,1637,1430,1391,-39
2019,9,15,11,1649,1411,1339,-72
2019,9,15,12,1683,1414,1345,-69
2019,9,15,13,1675,1445,1325,-120
2019,9,15,14,1689,1482,1277,-205
2019,9,15,15,1739,1562,1363,-199
2019,9,15,16,1799,1666,1514,-152
2019,9,15,17,1888,1749,1541,-208
2019,9,15,18,1963,1831,1534,-297
2019,9,15,19,2078,1913,1547,-366
2019,9,15,20,2195,2014,1661,-353
2019,9,15,21,2296,2125,1768,-357
2019,9,15,22,2388,2205,1910,-295
2019,9,15,23,2476,2265,1880,-385
2019,9,16,0,2447,2303,1847,-456
2019,9,16,1,2297,2317,1915,-402
2019,9,16,2,2201,2236,1808,-428
2019,9,16,3,2172,2178,1762,-416
2019,9,16,4,2045,2045,1786,-259
2019,9,16,5,1933,1850,1691,-159
2019,9,16,6,1757,1689,1559,-130
2019,9,16,7,1688,1567,1471,-96
2019,9,16,8,1596,1486,1313,-173
2019,9,16,9,1550,1443,1209,-234
2019,9,16,10,1540,1414,1205,-209
2019,9,16,11,1572,1427,1127,-300
2019,9,16,12,1685,1499,1142,-357
2019,9,16,13,1790,1649,1293,-356
2019,9,16,14,1903,1767,1415,-352
2019,9,16,15,2002,1807,1388,-419
2019,9,16,16,2047,1854,1474,-380
2019,9,16,17,2018,1905,1532,-373
2019,9,16,18,2016,1925,1619,-306
2019,9,16,19,2059,1956,1684,-272
2019,9,16,20,2097,1996,1661,-335
2019,9,16,21,2163,2043,1650,-393
2019,9,16,22,2163,2091,1664,-427
2019,9,16,23,2174,2150,1631,-519
2019,9,17,0,2152,2136,1740,-396
2019,9,17,1,2040,2054,1895,-159
2019,9,17,2,2015,2026,1836,-190
2019,9,17,3,1952,2005,1806,-199
2019,9,17,4,1878,1921,1866,-55
2019,9,17,5,1726,1753,1881,128
2019,9,17,6,1566,1612,1711,99
2019,9,17,7,1514,1530,1313,-217
2019,9,17,8,1473,1475,1194,-281
2019,9,17,9,1527,1446,1211,-235
2019,9,17,10,1542,1448,1324,-124
2019,9,17,11,1622,1458,1331,-127
2019,9,17,12,1768,1523,1269,-254
2019,9,17,13,1878,1666,1285,-381
2019,9,17,14,1905,1783,1206,-577
2019,9,17,15,1924,1809,1231,-578
2019,9,17,16,1916,1795,1300,-495
2019,9,17,17,1874,1800,1428,-372
2019,9,17,18,1817,1806,1489,-317
2019,9,17,19,1808,1810,1490,-320
2019,9,17,20,1840,1817,1521,-296
2019,9,17,21,1882,1828,1591,-237
2019,9,17,22,1925,1843,1668,-175
2019,9,17,23,1942,1894,1659,-235
2019,9,18,0,1950,1912,1689,-223
2019,9,18,1,1982,1909,1646,-263
2019,9,18,2,2027,1916,1666,-250
2019,9,18,3,1983,1935,1621,-314
2019,9,18,4,1881,1858,1681,-177
2019,9,18,5,1756,1723,1550,-173
2019,9,18,6,1554,1593,1453,-140
2019,9,18,7,1514,1510,1373,-137
2019,9,18,8,1498,1460,1408,-52
2019,9,18,9,1529,1438,1325,-113
2019,9,18,10,1554,1425,1353,-72
2019,9,18,11,1624,1439,1361,-78
2019,9,18,12,1768,1513,1369,-144
2019,9,18,13,1861,1670,1477,-193
2019,9,18,14,1880,1789,1310,-479
2019,9,18,15,1916,1820,1327,-493
2019,9,18,16,1932,1835,1324,-511
2019,9,18,17,1948,1848,1319,-529
2019,9,18,18,1927,1857,1381,-476
2019,9,18,19,1920,1863,1396,-467
2019,9,18,20,1917,1852,1501,-351
2019,9,18,21,1936,1846,1655,-191
2019,9,18,22,1949,1849,1697,-152
2019,9,18,23,1956,1835,1860,25
2019,9,19,0,1944,1842,1789,-53
2019,9,19,1,1924,1831,1822,-9
2019,9,19,2,1964,1865,1828,-37
2019,9,19,3,1906,1892,1748,-144
2019,9,19,4,1812,1823,1636,-187
2019,9,19,5,1686,1684,1443,-241
2019,9,19,6,1532,1574,1248,-326
2019,9,19,7,1488,1483,1183,-300
2019,9,19,8,1472,1455,1103,-352
2019,9,19,9,1500,1413,1085,-328
2019,9,19,10,1514,1413,1084,-329
2019,9,19,11,1586,1429,1085,-344
2019,9,19,12,1733,1511,1224,-287
2019,9,19,13,1848,1660,1345,-315
2019,9,19,14,1871,1796,1387,-409
2019,9,19,15,1897,1822,1375,-447
2019,9,19,16,1911,1841,1434,-407
2019,9,19,17,1919,1847,1450,-397
2019,9,19,18,1905,1841,1415,-426
2019,9,19,19,1914,1823,1382,-441
2019,9,19,20,1915,1816,1398,-418
2019,9,19,21,1912,1800,1455,-345
2019,9,19,22,1913,1803,1524,-279
2019,9,19,23,1910,1791,1514,-277
2019,9,20,0,1881,1801,1483,-318
2019,9,20,1,1873,1800,1373,-427
2019,9,20,2,1930,1816,1328,-488
2019,9,20,3,1882,1844,1350,-494
2019,9,20,4,1779,1776,1321,-455
2019,9,20,5,1649,1655,1253,-402
2019,9,20,6,1535,1542,1282,-260
2019,9,20,7,1496,1463,1236,-227
2019,9,20,8,1477,1416,1189,-227
2019,9,20,9,1479,1391,1247,-144
2019,9,20,10,1492,1389,1243,-146
2019,9,20,11,1561,1393,1261,-132
2019,9,20,12,1711,1477,1328,-149
2019,9,20,13,1825,1622,1426,-196
2019,9,20,14,1855,1760,1515,-245
2019,9,20,15,1864,1794,1571,-223
2019,9,20,16,1884,1806,1638,-168
2019,9,20,17,1890,1807,1738,-69
2019,9,20,18,1879,1796,1778,-18
2019,9,20,19,1873,1782,1855,73
2019,9,20,20,1877,1785,1898,113
2019,9,20,21,1875,1772,1964,192
2019,9,20,22,1879,1777,1991,214
2019,9,20,23,1836,1757,2028,271
2019,9,21,0,1827,1765,2019,254
2019,9,21,1,1801,1737,1876,139
2019,9,21,2,1828,1741,1716,-25
2019,9,21,3,1795,1743,1606,-137
2019,9,21,4,1720,1681,1638,-43
2019,9,21,5,1633,1610,1574,-36
2019,9,21,6,1534,1509,1456,-53
2019,9,21,7,1487,1432,1385,-47
2019,9,21,8,1454,1384,1368,-16
2019,9,21,9,1436,1357,1360,3
2019,9,21,10,1432,1344,1244,-100
2019,9,21,11,1466,1350,1249,-101
2019,9,21,12,1542,1377,1211,-166
2019,9,21,13,1621,1444,1160,-284
2019,9,21,14,1679,1527,1219,-308
2019,9,21,15,1712,1586,1334,-252
2019,9,21,16,1731,1608,1455,-153
2019,9,21,17,1729,1618,1488,-130
2019,9,21,18,1703,1631,1507,-124
2019,9,21,19,1717,1611,1516,-95
2019,9,21,20,1715,1610,1558,-52
2019,9,21,21,1704,1596,1596,0
2019,9,21,22,1708,1623,1691,68
2019,9,21,23,1717,1643,1784,141
2019,9,22,0,1726,1679,1768,89
2019,9,22,1,1729,1704,1689,-15
2019,9,22,2,1761,1725,1580,-145
2019,9,22,3,1722,1700,1559,-141
2019,9,22,4,1633,1645,1542,-103
2019,9,22,5,1523,1564,1526,-38
2019,9,22,6,1515,1464,1389,-75
2019,9,22,7,1465,1387,1264,-123
2019,9,22,8,1432,1338,1252,-86
2019,9,22,9,1400,1318,1263,-55
2019,9,22,10,1402,1296,1189,-107
2019,9,22,11,1433,1302,1219,-83
2019,9,22,12,1492,1334,1292,-42
2019,9,22,13,1554,1386,1325,-61
2019,9,22,14,1595,1434,1330,-104
2019,9,22,15,1616,1495,1380,-115
2019,9,22,16,1643,1507,1473,-34
2019,9,22,17,1671,1553,1495,-58
2019,9,22,18,1669,1584,1467,-117
2019,9,22,19,1721,1598,1519,-79
2019,9,22,20,1758,1629,1591,-38
2019,9,22,21,1787,1652,1591,-61
2019,9,22,22,1821,1669,1691,22
2019,9,22,23,1873,1700,1818,118
2019,9,23,0,1860,1744,1746,2
2019,9,23,1,1830,1767,1659,-108
2019,9,23,2,1817,1774,1593,-181
2019,9,23,3,1743,1791,1590,-201
2019,9,23,4,1622,1695,1509,-186
2019,9,23,5,1568,1561,1394,-167
2019,9,23,6,1508,1427,1225,-202
2019,9,23,7,1453,1348,1148,-200
2019,9,23,8,1396,1305,1168,-137
2019,9,23,9,1368,1280,1213,-67
2019,9,23,10,1394,1288,1185,-103
2019,9,23,11,1474,1307,1262,-45
2019,9,23,12,1620,1386,1356,-30
2019,9,23,13,1744,1556,1542,-14
2019,9,23,14,1838,1689,1672,-17
2019,9,23,15,1868,1725,1718,-7
2019,9,23,16,1901,1751,1727,-24
2019,9,23,17,1867,1752,1722,-30
2019,9,23,18,1854,1779,1701,-78
2019,9,23,19,1855,1787,1690,-97
2019,9,23,20,1891,1803,1672,-131
2019,9,23,21,1897,1830,1572,-258
2019,9,23,22,1921,1833,1634,-199
2019,9,23,23,1948,1869,1722,-147
2019,9,24,0,1972,1889,1791,-98
2019,9,24,1,1988,1897,1740,-157
2019,9,24,2,1995,1881,1773,-108
2019,9,24,3,1925,1897,1794,-103
2019,9,24,4,1800,1802,1731,-71
2019,9,24,5,1643,1644,1528,-116
2019,9,24,6,1564,1512,1425,-87
2019,9,24,7,1508,1427,1328,-99
2019,9,24,8,1470,1381,1306,-75
2019,9,24,9,1425,1344,1276,-68
2019,9,24,10,1440,1345,1251,-94
2019,9,24,11,1505,1352,1254,-98
2019,9,24,12,1644,1429,1353,-76
2019,9,24,13,1762,1592,1488,-104
2019,9,24,14,1785,1729,1577,-152
2019,9,24,15,1798,1757,1607,-150
2019,9,24,16,1837,1784,1672,-112
2019,9,24,17,1871,1778,1789,11
2019,9,24,18,1913,1792,1818,26
2019,9,24,19,1903,1830,1810,-20
2019,9,24,20,1912,1856,1829,-27
2019,9,24,21,1937,1882,1897,15
2019,9,24,22,1950,1922,1954,32
2019,9,24,23,1998,1954,2029,75
2019,9,25,0,2041,1973,2023,50
2019,9,25,1,2052,1967,1951,-16
2019,9,25,2,2045,1952,1919,-33
2019,9,25,3,1923,1945,1845,-100
2019,9,25,4,1755,1851,1744,-107
2019,9,25,5,1611,1698,1648,-50
2019,9,25,6,1571,1544,1363,-181
2019,9,25,7,1515,1461,1231,-230
2019,9,25,8,1456,1395,1219,-176
2019,9,25,9,1438,1368,1194,-174
2019,9,25,10,1438,1366,1336,-30
2019,9,25,11,1511,1371,1289,-82
2019,9,25,12,1669,1449,1326,-123
2019,9,25,13,1806,1612,1449,-163
2019,9,25,14,1826,1731,1497,-234
2019,9,25,15,1826,1770,1597,-173
2019,9,25,16,1813,1781,1650,-131
2019,9,25,17,1820,1792,1716,-76
2019,9,25,18,1837,1795,1729,-66
2019,9,25,19,1855,1801,1652,-149
2019,9,25,20,1877,1809,1648,-161
2019,9,25,21,1885,1834,1652,-182
2019,9,25,22,1917,1847,1576,-271
2019,9,25,23,1948,1860,1677,-183
2019,9,26,0,1960,1878,1689,-189
2019,9,26,1,1940,1869,1720,-149
2019,9,26,2,1950,1886,1675,-211
2019,9,26,3,1854,1900,1676,-224
2019,9,26,4,1727,1802,1598,-204
2019,9,26,5,1620,1673,1523,-150
2019,9,26,6,1502,1534,1308,-226
2019,9,26,7,1460,1454,1097,-357
2019,9,26,8,1425,1405,1012,-393
2019,9,26,9,1465,1384,1083,-301
2019,9,26,10,1485,1383,1025,-358
2019,9,26,11,1559,1393,993,-400
2019,9,26,12,1712,1481,967,-514
2019,9,26,13,1846,1653,1163,-490
2019,9,26,14,1864,1773,1161,-612
2019,9,26,15,1853,1800,1231,-569
2019,9,26,16,1834,1808,1327,-481
2019,9,26,17,1836,1811,1197,-614
2019,9,26,18,1860,1822,1222,-600
2019,9,26,19,1924,1815,1129,-686
2019,9,26,20,1961,1836,1162,-674
2019,9,26,21,1981,1849,1269,-580
2019,9,26,22,1992,1879,1402,-477
2019,9,26,23,2011,1908,1417,-491
2019,9,27,0,2032,1918,1517,-401
2019,9,27,1,1995,1909,1381,-528
2019,9,27,2,1963,1922,1294,-628
2019,9,27,3,1839,1938,1350,-588
2019,9,27,4,1694,1841,1364,-477
2019,9,27,5,1594,1709,1403,-306
2019,9,27,6,1537,1567,1284,-283
2019,9,27,7,1479,1478,1241,-237
2019,9,27,8,1453,1426,1261,-165
2019,9,27,9,1429,1396,1294,-102
2019,9,27,10,1444,1384,1273,-111
2019,9,27,11,1518,1390,1289,-101
2019,9,27,12,1689,1461,1234,-227
2019,9,27,13,1822,1604,1343,-261
2019,9,27,14,1849,1719,1433,-286
2019,9,27,15,1852,1763,1475,-288
2019,9,27,16,1847,1780,1536,-244
2019,9,27,17,1835,1791,1613,-178
2019,9,27,18,1814,1794,1596,-198
2019,9,27,19,1798,1781,1539,-242
2019,9,27,20,1800,1782,1499,-283
2019,9,27,21,1799,1805,1494,-311
2019,9,27,22,1821,1814,1562,-252
2019,9,27,23,1826,1815,1516,-299
2019,9,28,0,1826,1805,1482,-323
2019,9,28,1,1832,1773,1376,-397
2019,9,28,2,1878,1766,1307,-459
2019,9,28,3,1816,1757,1306,-451
2019,9,28,4,1707,1707,1332,-375
2019,9,28,5,1601,1603,1295,-308
2019,9,28,6,1482,1502,1233,-269
2019,9,28,7,1441,1419,1115,-304
2019,9,28,8,1422,1370,999,-371
2019,9,28,9,1431,1341,1056,-285
2019,9,28,10,1435,1328,1052,-276
2019,9,28,11,1467,1334,1052,-282
2019,9,28,12,1541,1367,1073,-294
2019,9,28,13,1625,1430,1175,-255
2019,9,28,14,1690,1501,1281,-220
2019,9,28,15,1708,1575,1269,-306
2019,9,28,16,1721,1652,1125,-527
2019,9,28,17,1712,1685,1134,-551
2019,9,28,18,1697,1681,1323,-358
2019,9,28,19,1655,1669,1325,-344
2019,9,28,20,1625,1645,1293,-352
2019,9,28,21,1610,1612,1298,-314
2019,9,28,22,1606,1601,1216,-385
2019,9,28,23,1602,1587,1107,-480
2019,9,29,0,1622,1605,1169,-436
2019,9,29,1,1661,1611,1395,-216
2019,9,29,2,1783,1653,1358,-295
2019,9,29,3,1791,1669,1426,-243
2019,9,29,4,1749,1614,1452,-162
2019,9,29,5,1607,1550,1437,-113
2019,9,29,6,1548,1487,1436,-51
2019,9,29,7,1532,1413,1307,-106
2019,9,29,8,1509,1371,1161,-210
2019,9,29,9,1476,1351,1153,-198
2019,9,29,10,1496,1322,1122,-200
2019,9,29,11,1539,1330,1091,-239
2019,9,29,12,1590,1374,1149,-225
2019,9,29,13,1656,1427,1148,-279
2019,9,29,14,1720,1522,1251,-271
2019,9,29,15,1721,1606,1319,-287
2019,9,29,16,1695,1649,1303,-346
2019,9,29,17,1658,1646,1365,-281
2019,9,29,18,1586,1638,1254,-384
2019,9,29,19,1534,1609,1273,-336
2019,9,29,20,1525,1592,1265,-327
2019,9,29,21,1542,1572,1169,-403
2019,9,29,22,1562,1563,1190,-373
2019,9,29,23,1607,1579,1130,-449
2019,9,30,0,1652,1610,1134,-476
2019,9,30,1,1718,1633,1164,-469
2019,9,30,2,1814,1697,1305,-392
2019,9,30,3,1812,1726,1327,-399
2019,9,30,4,1755,1659,1235,-424
2019,9,30,5,1632,1543,1090,-453
2019,9,30,6,1498,1437,983,-454
2019,9,30,7,1476,1374,947,-427
2019,9,30,8,1382,1357,962,-395
2019,9,30,9,1419,1343,910,-433
2019,9,30,10,1475,1365,904,-461
2019,9,30,11,1585,1407,890,-517
2019,9,30,12,1744,1523,1195,-328
2019,9,30,13,1923,1710,1273,-437
2019,9,30,14,2037,1865,1301,-564
2019,9,30,15,2028,1867,1318,-549
2019,9,30,16,1950,1859,1397,-462
2019,9,30,17,1803,1796,1251,-545
2019,9,30,18,1736,1765,1283,-482
2019,9,30,19,1707,1711,1270,-441
2019,9,30,20,1692,1675,1204,-471
2019,9,30,21,1686,1658,1160,-498
2019,9,30,22,1682,1661,1173,-488
2019,9,30,23,1701,1675,1075,-600
2019,10,1,0,1730,1674,977,-697
2019,10,1,1,1793,1686,1388,-298
2019,10,1,2,1842,1753,1390,-363
2019,10,1,3,1798,1771,1339,-432
2019,10,1,4,1702,1689,1207,-482
2019,10,1,5,1561,1572,1106,-466
2019,10,1,6,1499,1471,912,-559
2019,10,1,7,1470,1421,923,-498
2019,10,1,8,1461,1374,963,-411
2019,10,1,9,1431,1372,1010,-362
2019,10,1,10,1484,1380,1048,-332
2019,10,1,11,1546,1407,1041,-366
2019,10,1,12,1720,1514,1129,-385
2019,10,1,13,1886,1681,1277,-404
2019,10,1,14,1913,1821,1288,-533
2019,10,1,15,1902,1831,1448,-383
2019,10,1,16,1866,1790,1461,-329
2019,10,1,17,1859,1759,1556,-203
2019,10,1,18,1815,1700,1487,-213
2019,10,1,19,1736,1677,1465,-212
2019,10,1,20,1704,1663,1425,-238
2019,10,1,21,1722,1647,1444,-203
2019,10,1,22,1737,1616,1436,-180
2019,10,1,23,1746,1623,1438,-185
2019,10,2,0,1746,1649,1522,-127
2019,10,2,1,1807,1669,1643,-26
2019,10,2,2,1845,1717,1684,-33
2019,10,2,3,1756,1747,1680,-67
2019,10,2,4,1662,1682,1671,-11
2019,10,2,5,1568,1561,1402,-159
2019,10,2,6,1502,1458,1204,-254
2019,10,2,7,1479,1394,1135,-259
2019,10,2,8,1456,1365,1203,-162
2019,10,2,9,1506,1352,1234,-118
2019,10,2,10,1510,1368,1148,-220
2019,10,2,11,1606,1407,1137,-270
2019,10,2,12,1818,1519,1394,-125
2019,10,2,13,1961,1700,1554,-146
2019,10,2,14,1996,1849,1541,-308
2019,10,2,15,1989,1862,1559,-303
2019,10,2,16,1946,1816,1637,-179
2019,10,2,17,1854,1762,1505,-257
2019,10,2,18,1816,1730,1491,-239
2019,10,2,19,1791,1680,1457,-223
2019,10,2,20,1783,1660,1467,-193
2019,10,2,21,1752,1650,1525,-125
2019,10,2,22,1751,1630,1538,-92
2019,10,2,23,1768,1638,1538,-100
2019,10,3,0,1777,1647,1542,-105
2019,10,3,1,1828,1661,1626,-35
2019,10,3,2,1849,1716,1660,-56
2019,10,3,3,1754,1734,1650,-84
2019,10,3,4,1634,1681,1540,-141
2019,10,3,5,1522,1559,1384,-175
2019,10,3,6,1462,1452,1411,-41
2019,10,3,7,1444,1400,1309,-91
2019,10,3,8,1421,1380,1168,-212
2019,10,3,9,1474,1370,1128,-242
2019,10,3,10,1477,1379,1133,-246
2019,10,3,11,1577,1419,1173,-246
2019,10,3,12,1714,1514,1161,-353
2019,10,3,13,1843,1699,1355,-344
2019,10,3,14,1852,1836,1479,-357
2019,10,3,15,1822,1835,1504,-331
2019,10,3,16,1793,1814,1529,-285
2019,10,3,17,1761,1775,1401,-374
2019,10,3,18,1758,1756,1386,-370
2019,10,3,19,1766,1700,1333,-367
2019,10,3,20,1805,1696,1206,-490
2019,10,3,21,1785,1674,1179,-495
2019,10,3,22,1810,1648,1147,-501
2019,10,3,23,1802,1659,1201,-458
2019,10,4,0,1778,1654,1247,-407
2019,10,4,1,1795,1653,1354,-299
2019,10,4,2,1778,1704,1314,-390
2019,10,4,3,1711,1709,1410,-299
2019,10,4,4,1583,1644,1356,-288
2019,10,4,5,1468,1534,1292,-242
2019,10,4,6,1448,1429,1158,-271
2019,10,4,7,1405,1367,931,-436
2019,10,4,8,1372,1344,913,-431
2019,10,4,9,1374,1327,828,-499
2019,10,4,10,1435,1330,857,-473
2019,10,4,11,1532,1360,878,-482
2019,10,4,12,1683,1443,1013,-430
2019,10,4,13,1794,1605,1205,-400
2019,10,4,14,1786,1735,1401,-334
2019,10,4,15,1777,1789,1456,-333
2019,10,4,16,1800,1807,1339,-468
2019,10,4,17,1856,1817,1230,-587
2019,10,4,18,1853,1792,1320,-472
2019,10,4,19,1835,1747,1394,-353
2019,10,4,20,1790,1727,1354,-373
2019,10,4,21,1743,1691,1387,-304
2019,10,4,22,1715,1684,1531,-153
2019,10,4,23,1688,1662,1605,-57
2019,10,5,0,1689,1649,1771,122
2019,10,5,1,1720,1656,1700,44
2019,10,5,2,1751,1684,1532,-152
2019,10,5,3,1728,1704,1441,-263
2019,10,5,4,1650,1659,1371,-288
2019,10,5,5,1560,1584,1257,-327
2019,10,5,6,1480,1503,1151,-352
2019,10,5,7,1432,1438,1101,-337
2019,10,5,8,1417,1412,1064,-348
2019,10,5,9,1440,1395,1023,-372
2019,10,5,10,1472,1392,993,-399
2019,10,5,11,1533,1413,1004,-409
2019,10,5,12,1610,1472,999,-473
2019,10,5,13,1703,1549,988,-561
2019,10,5,14,1762,1653,1053,-600
2019,10,5,15,1759,1716,1133,-583
2019,10,5,16,1739,1738,1296,-442
2019,10,5,17,1705,1698,1305,-393
2019,10,5,18,1654,1646,1304,-342
2019,10,5,19,1622,1600,1305,-295
2019,10,5,20,1599,1572,1331,-241
2019,10,5,21,1607,1531,1336,-195
2019,10,5,22,1599,1532,1480,-52
2019,10,5,23,1602,1551,1617,66
2019,10,6,0,1589,1565,1684,119
2019,10,6,1,1638,1563,1583,20
2019,10,6,2,1654,1601,1407,-194
2019,10,6,3,1613,1624,1358,-266
2019,10,6,4,1552,1586,1292,-294
2019,10,6,5,1482,1526,1262,-264
2019,10,6,6,1435,1457,1153,-304
2019,10,6,7,1395,1391,1069,-322
2019,10,6,8,1399,1364,955,-409
2019,10,6,9,1420,1350,900,-450
2019,10,6,10,1453,1362,878,-484
2019,10,6,11,1506,1370,861,-509
2019,10,6,12,1577,1427,968,-459
2019,10,6,13,1639,1501,947,-554
2019,10,6,14,1700,1596,972,-624
2019,10,6,15,1674,1678,1041,-637
2019,10,6,16,1646,1720,1065,-655
2019,10,6,17,1624,1660,1098,-562
2019,10,6,18,1635,1625,1041,-584
2019,10,6,19,1614,1597,1080,-517
2019,10,6,20,1608,1568,1115,-453
2019,10,6,21,1619,1532,1109,-423
2019,10,6,22,1630,1525,1064,-461
2019,10,6,23,1647,1555,1085,-470
2019,10,7,0,1646,1583,1056,-527
2019,10,7,1,1668,1609,1142,-467
2019,10,7,2,1672,1664,1133,-531
2019,10,7,3,1639,1687,1156,-531
2019,10,7,4,1570,1618,1195,-423
2019,10,7,5,1495,1511,1185,-326
2019,10,7,6,1315,1404,1013,-391
2019,10,7,7,1283,1339,968,-371
2019,10,7,8,1278,1329,930,-399
2019,10,7,9,1342,1332,941,-391
2019,10,7,10,1396,1352,994,-358
2019,10,7,11,1511,1396,1034,-362
2019,10,7,12,1688,1516,1155,-361
2019,10,7,13,1860,1710,1265,-445
2019,10,7,14,1989,1860,1299,-561
2019,10,7,15,1979,1879,1344,-535
2019,10,7,16,1899,1846,1308,-538
2019,10,7,17,1736,1793,1303,-490
2019,10,7,18,1693,1746,1233,-513
2019,10,7,19,1711,1707,1226,-481
2019,10,7,20,1729,1672,1278,-394
2019,10,7,21,1755,1673,1272,-401
2019,10,7,22,1767,1658,1315,-343
2019,10,7,23,1779,1663,1331,-332
2019,10,8,0,1774,1685,1288,-397
2019,10,8,1,1778,1693,1198,-495
2019,10,8,2,1778,1743,1165,-578
2019,10,8,3,1700,1743,1171,-572
2019,10,8,4,1587,1671,1155,-516
2019,10,8,5,1490,1547,1139,-408
2019,10,8,6,1452,1436,1105,-331
2019,10,8,7,1406,1367,1020,-347
2019,10,8,8,1404,1347,1027,-320
2019,10,8,9,1375,1336,1045,-291
2019,10,8,10,1407,1338,982,-356
2019,10,8,11,1490,1386,1010,-376
2019,10,8,12,1639,1479,1069,-410
2019,10,8,13,1764,1666,1143,-523
2019,10,8,14,1736,1809,1136,-673
2019,10,8,15,1790,1816,1147,-669
2019,10,8,16,1829,1797,1198,-599
2019,10,8,17,1884,1755,1256,-499
2019,10,8,18,1858,1738,1199,-539
2019,10,8,19,1845,1707,1140,-567
2019,10,8,20,1802,1675,1151,-524
2019,10,8,21,1747,1658,1063,-595
2019,10,8,22,1712,1649,1084,-565
2019,10,8,23,1696,1665,1001,-664
2019,10,9,0,1670,1681,987,-694
2019,10,9,1,1713,1696,1057,-639
2019,10,9,2,1732,1744,1161,-583
2019,10,9,3,1698,1738,1242,-496
2019,10,9,4,1584,1655,1312,-343
2019,10,9,5,1477,1532,1428,-104
2019,10,9,6,1468,1443,1289,-154
2019,10,9,7,1436,1363,1351,-12
2019,10,9,8,1421,1331,1381,50
2019,10,9,9,1427,1331,1325,-6
2019,10,9,10,1470,1349,1304,-45
2019,10,9,11,1583,1395,1498,103
2019,10,9,12,1786,1506,1523,17
2019,10,9,13,1939,1702,1651,-51
2019,10,9,14,1947,1843,1692,-151
2019,10,9,15,1969,1872,1733,-139
2019,10,9,16,1945,1868,1836,-32
2019,10,9,17,1926,1858,1845,-13
2019,10,9,18,1822,1815,1772,-43
2019,10,9,19,1740,1805,1783,-22
2019,10,9,20,1687,1781,1779,-2
2019,10,9,21,1690,1781,1781,0
2019,10,9,22,1708,1750,1725,-25
2019,10,9,23,1740,1767,1699,-68
2019,10,10,0,1788,1791,1701,-90
2019,10,10,1,1938,1838,1707,-131
2019,10,10,2,2039,1901,1663,-238
2019,10,10,3,2007,1911,1657,-254
2019,10,10,4,1880,1843,1590,-253
2019,10,10,5,1753,1717,1566,-151
2019,10,10,6,1674,1614,1405,-209
2019,10,10,7,1670,1563,1196,-367
2019,10,10,8,1670,1531,1043,-488
2019,10,10,9,1675,1516,903,-613
2019,10,10,10,1690,1538,869,-669
2019,10,10,11,1737,1592,981,-611
2019,10,10,12,1869,1696,965,-731
2019,10,10,13,1950,1887,1056,-831
2019,10,10,14,1981,2043,1141,-902
2019,10,10,15,2046,2029,1146,-883
2019,10,10,16,2155,1994,1260,-734
2019,10,10,17,2110,1919,1321,-598
2019,10,10,18,1962,1859,1308,-551
2019,10,10,19,1774,1791,1244,-547
2019,10,10,20,1622,1741,1192,-549
2019,10,10,21,1597,1707,1197,-510
2019,10,10,22,1608,1683,1222,-461
2019,10,10,23,1646,1670,1224,-446
2019,10,11,0,1726,1692,1211,-481
2019,10,11,1,1842,1722,1096,-626
2019,10,11,2,1920,1825,1062,-763
2019,10,11,3,1882,1859,1091,-768
2019,10,11,4,1794,1804,1068,-736
2019,10,11,5,1682,1715,1027,-688
2019,10,11,6,1678,1628,1062,-566
2019,10,11,7,1660,1569,988,-581
2019,10,11,8,1563,1558,1004,-554
2019,10,11,9,1526,1563,1002,-561
2019,10,11,10,1581,1581,1076,-505
2019,10,11,11,1727,1616,1094,-522
2019,10,11,12,1949,1716,1169,-547
2019,10,11,13,2122,1909,1215,-694
2019,10,11,14,2120,2047,1333,-714
2019,10,11,15,2072,2048,1371,-677
2019,10,11,16,1960,2008,1343,-665
2019,10,11,17,1862,1929,1258,-671
2019,10,11,18,1781,1843,1204,-639
2019,10,11,19,1691,1780,1254,-526
2019,10,11,20,1710,1718,1206,-512
2019,10,11,21,1697,1676,1198,-478
2019,10,11,22,1695,1659,1171,-488
2019,10,11,23,1711,1636,1141,-495
2019,10,12,0,1732,1643,1119,-524
2019,10,12,1,1766,1654,1068,-586
2019,10,12,2,1765,1707,1102,-605
2019,10,12,3,1689,1722,1134,-588
2019,10,12,4,1607,1686,1077,-609
2019,10,12,5,1539,1624,1067,-557
2019,10,12,6,1480,1546,973,-573
2019,10,12,7,1456,1501,954,-547
2019,10,12,8,1444,1479,960,-519
2019,10,12,9,1517,1488,944,-544
2019,10,12,10,1540,1495,913,-582
2019,10,12,11,1611,1524,923,-601
2019,10,12,12,1729,1584,943,-641
2019,10,12,13,1846,1685,943,-742
2019,10,12,14,1884,1776,999,-777
2019,10,12,15,1820,1842,1070,-772
2019,10,12,16,1744,1862,1130,-732
2019,10,12,17,1698,1807,1134,-673
2019,10,12,18,1669,1740,1081,-659
2019,10,12,19,1671,1656,1012,-644
2019,10,12,20,1669,1612,990,-622
2019,10,12,21,1647,1577,981,-596
2019,10,12,22,1658,1560,1070,-490
2019,10,12,23,1671,1557,1054,-503
2019,10,13,0,1678,1572,993,-579
2019,10,13,1,1708,1596,899,-697
2019,10,13,2,1687,1659,981,-678
2019,10,13,3,1613,1648,957,-691
2019,10,13,4,1547,1610,938,-672
2019,10,13,5,1471,1555,941,-614
2019,10,13,6,1400,1489,897,-592
2019,10,13,7,1379,1444,924,-520
2019,10,13,8,1400,1421,926,-495
2019,10,13,9,1460,1420,983,-437
2019,10,13,10,1480,1432,1028,-404
2019,10,13,11,1528,1458,1030,-428
2019,10,13,12,1616,1511,998,-513
2019,10,13,13,1698,1588,1066,-522
2019,10,13,14,1726,1682,1071,-611
2019,10,13,15,1695,1766,1122,-644
2019,10,13,16,1649,1800,1255,-545
2019,10,13,17,1645,1762,1125,-637
2019,10,13,18,1664,1692,1157,-535
2019,10,13,19,1684,1619,1177,-442
2019,10,13,20,1662,1586,1199,-387
2019,10,13,21,1651,1571,1184,-387
2019,10,13,22,1661,1563,1088,-475
2019,10,13,23,1684,1585,1102,-483
2019,10,14,0,1696,1593,1037,-556
2019,10,14,1,1718,1622,1151,-471
2019,10,14,2,1700,1685,1313,-372
2019,10,14,3,1632,1683,1371,-312
2019,10,14,4,1547,1616,1240,-376
2019,10,14,5,1457,1509,1087,-422
2019,10,14,6,1311,1429,1123,-306
2019,10,14,7,1293,1373,1044,-329
2019,10,14,8,1313,1369,907,-462
2019,10,14,9,1414,1367,852,-515
2019,10,14,10,1476,1402,856,-546
2019,10,14,11,1583,1442,842,-600
2019,10,14,12,1746,1550,864,-686
2019,10,14,13,1885,1744,857,-887
2019,10,14,14,1994,1895,951,-944
2019,10,14,15,1986,1906,867,-1039
2019,10,14,16,1933,1889,875,-1014
2019,10,14,17,1829,1856,884,-972
2019,10,14,18,1807,1804,836,-968
2019,10,14,19,1829,1744,837,-907
2019,10,14,20,1809,1715,890,-825
2019,10,14,21,1772,1689,876,-813
2019,10,14,22,1736,1694,934,-760
2019,10,14,23,1733,1705,928,-777
2019,10,15,0,1760,1704,840,-864
2019,10,15,1,1827,1720,896,-824
2019,10,15,2,1824,1765,1032,-733
2019,10,15,3,1733,1760,1017,-743
2019,10,15,4,1616,1684,896,-788
2019,10,15,5,1515,1560,738,-822
2019,10,15,6,1455,1463,741,-722
2019,10,15,7,1423,1410,716,-694
2019,10,15,8,1445,1382,701,-681
2019,10,15,9,1432,1391,695,-696
2019,10,15,10,1472,1410,693,-717
2019,10,15,11,1567,1459,679,-780
2019,10,15,12,1739,1548,676,-872
2019,10,15,13,1872,1748,700,-1048
2019,10,15,14,1885,1896,887,-1009
2019,10,15,15,1895,1907,873,-1034
2019,10,15,16,1885,1873,814,-1059
2019,10,15,17,1859,1828,761,-1067
2019,10,15,18,1802,1777,752,-1025
2019,10,15,19,1808,1741,744,-997
2019,10,15,20,1796,1690,735,-955
2019,10,15,21,1783,1688,741,-947
2019,10,15,22,1782,1662,730,-932
2019,10,15,23,1781,1667,711,-956
2019,10,16,0,1768,1676,750,-926
2019,10,16,1,1785,1695,930,-765
2019,10,16,2,1751,1757,1071,-686
2019,10,16,3,1667,1737,979,-758
2019,10,16,4,1578,1655,923,-732
2019,10,16,5,1477,1534,799,-735
2019,10,16,6,1501,1440,640,-800
2019,10,16,7,1466,1366,638,-728
2019,10,16,8,1436,1343,620,-723
2019,10,16,9,1403,1340,659,-681
2019,10,16,10,1433,1341,726,-615
2019,10,16,11,1516,1380,851,-529
2019,10,16,12,1683,1482,911,-571
2019,10,16,13,1818,1671,922,-749
2019,10,16,14,1821,1806,923,-883
2019,10,16,15,1832,1814,980,-834
2019,10,16,16,1844,1800,1121,-679
2019,10,16,17,1858,1755,1137,-618
2019,10,16,18,1814,1728,1025,-703
2019,10,16,19,1809,1698,1023,-675
2019,10,16,20,1812,1672,969,-703
2019,10,16,21,1789,1680,939,-741
2019,10,16,22,1765,1658,922,-736
2019,10,16,23,1745,1675,858,-817
2019,10,17,0,1716,1669,989,-680
2019,10,17,1,1721,1670,986,-684
2019,10,17,2,1682,1745,863,-882
2019,10,17,3,1641,1706,793,-913
2019,10,17,4,1558,1641,797,-844
2019,10,17,5,1472,1525,796,-729
2019,10,17,6,1523,1414,770,-644
2019,10,17,7,1485,1344,729,-615
2019,10,17,8,1428,1310,782,-528
2019,10,17,9,1383,1293,811,-482
2019,10,17,10,1403,1287,775,-512
2019,10,17,11,1477,1302,800,-502
2019,10,17,12,1631,1391,778,-613
2019,10,17,13,1746,1561,804,-757
2019,10,17,14,1739,1699,808,-891
2019,10,17,15,1731,1728,893,-835
2019,10,17,16,1752,1750,1104,-646
2019,10,17,17,1751,1772,1069,-703
2019,10,17,18,1734,1742,1081,-661
2019,10,17,19,1697,1714,1124,-590
2019,10,17,20,1649,1682,1131,-551
2019,10,17,21,1616,1666,1199,-467
2019,10,17,22,1625,1656,1229,-427
2019,10,17,23,1654,1670,1173,-497
2019,10,18,0,1722,1675,1162,-513
2019,10,18,1,1863,1698,1156,-542
2019,10,18,2,1892,1755,1084,-671
2019,10,18,3,1822,1755,998,-757
2019,10,18,4,1676,1698,999,-699
2019,10,18,5,1565,1584,950,-634
2019,10,18,6,1486,1485,910,-575
2019,10,18,7,1467,1431,910,-521
2019,10,18,8,1431,1403,749,-654
2019,10,18,9,1452,1394,704,-690
2019,10,18,10,1491,1392,674,-718
2019,10,18,11,1578,1433,658,-775
2019,10,18,12,1744,1514,690,-824
2019,10,18,13,1889,1678,694,-984
2019,10,18,14,1884,1808,886,-922
2019,10,18,15,1844,1833,873,-960
2019,10,18,16,1818,1850,779,-1071
2019,10,18,17,1811,1832,828,-1004
2019,10,18,18,1782,1774,961,-813
2019,10,18,19,1733,1727,1134,-593
2019,10,18,20,1679,1700,1129,-571
2019,10,18,21,1658,1669,1158,-511
2019,10,18,22,1674,1654,1120,-534
2019,10,18,23,1689,1644,1141,-503
2019,10,19,0,1710,1621,1056,-565
2019,10,19,1,1776,1637,889,-748
2019,10,19,2,1776,1696,784,-912
2019,10,19,3,1727,1687,729,-958
2019,10,19,4,1636,1652,636,-1016
2019,10,19,5,1550,1580,628,-952
2019,10,19,6,1470,1509,576,-933
2019,10,19,7,1439,1459,548,-911
2019,10,19,8,1420,1423,576,-847
2019,10,19,9,1438,1408,614,-794
2019,10,19,10,1439,1405,634,-771
2019,10,19,11,1490,1414,647,-767
2019,10,19,12,1582,1463,703,-760
2019,10,19,13,1670,1539,795,-744
2019,10,19,14,1722,1623,877,-746
2019,10,19,15,1748,1727,869,-858
2019,10,19,16,1773,1775,829,-946
2019,10,19,17,1787,1802,837,-965
2019,10,19,18,1760,1788,806,-982
2019,10,19,19,1732,1725,824,-901
2019,10,19,20,1702,1651,959,-692
2019,10,19,21,1664,1586,1060,-526
2019,10,19,22,1637,1588,1060,-528
2019,10,19,23,1637,1594,1176,-418
2019,10,20,0,1675,1620,1273,-347
2019,10,20,1,1750,1653,1236,-417
2019,10,20,2,1765,1709,1225,-484
2019,10,20,3,1731,1692,1244,-448
2019,10,20,4,1648,1642,1226,-416
2019,10,20,5,1574,1591,1226,-365
2019,10,20,6,1484,1510,1202,-308
2019,10,20,7,1455,1448,1221,-227
2019,10,20,8,1450,1400,1166,-234
2019,10,20,9,1460,1395,1152,-243
2019,10,20,10,1478,1390,1111,-279
2019,10,20,11,1528,1413,1113,-300
2019,10,20,12,1604,1461,1076,-385
2019,10,20,13,1697,1532,1048,-484
2019,10,20,14,1783,1634,1063,-571
2019,10,20,15,1815,1716,1099,-617
2019,10,20,16,1810,1764,1062,-702
2019,10,20,17,1776,1735,1101,-634
2019,10,20,18,1703,1695,1105,-590
2019,10,20,19,1628,1652,1146,-506
2019,10,20,20,1580,1629,1106,-523
2019,10,20,21,1581,1605,986,-619
2019,10,20,22,1605,1599,899,-700
2019,10,20,23,1656,1618,873,-745
2019,10,21,0,1704,1664,850,-814
2019,10,21,1,1788,1702,836,-866
2019,10,21,2,1814,1761,785,-976
2019,10,21,3,1770,1727,741,-986
2019,10,21,4,1672,1659,724,-935
2019,10,21,5,1551,1534,676,-858
2019,10,21,6,1376,1430,634,-796
2019,10,21,7,1352,1369,626,-743
2019,10,21,8,1352,1347,623,-724
2019,10,21,9,1398,1339,667,-672
2019,10,21,10,1454,1365,708,-657
2019,10,21,11,1559,1395,804,-591
2019,10,21,12,1730,1510,848,-662
2019,10,21,13,1873,1693,798,-895
2019,10,21,14,1985,1854,867,-987
2019,10,21,15,2001,1881,836,-1045
2019,10,21,16,1979,1886,867,-1019
2019,10,21,17,1877,1875,917,-958
2019,10,21,18,1830,1831,1037,-794
2019,10,21,19,1788,1763,1181,-582
2019,10,21,20,1751,1730,1185,-545
2019,10,21,21,1719,1683,1210,-473
2019,10,21,22,1712,1678,1232,-446
2019,10,21,23,1736,1664,1233,-431
2019,10,22,0,1772,1700,1166,-534
2019,10,22,1,1843,1740,1010,-730
2019,10,22,2,1856,1800,902,-898
2019,10,22,3,1794,1772,827,-945
2019,10,22,4,1668,1680,787,-893
2019,10,22,5,1548,1561,707,-854
2019,10,22,6,1475,1445,658,-787
2019,10,22,7,1442,1390,634,-756
2019,10,22,8,1444,1352,627,-725
2019,10,22,9,1417,1342,670,-672
2019,10,22,10,1453,1346,677,-669
2019,10,22,11,1539,1370,695,-675
2019,10,22,12,1705,1474,709,-765
2019,10,22,13,1847,1661,755,-906
2019,10,22,14,1870,1796,783,-1013
2019,10,22,15,1886,1813,790,-1023
2019,10,22,16,1868,1790,847,-943
2019,10,22,17,1826,1769,796,-973
2019,10,22,18,1756,1742,846,-896
2019,10,22,19,1724,1718,1059,-659
2019,10,22,20,1705,1649,1135,-514
2019,10,22,21,1694,1629,1131,-498
2019,10,22,22,1678,1614,1309,-305
2019,10,22,23,1694,1609,1334,-275
2019,10,23,0,1724,1629,1267,-362
2019,10,23,1,1791,1667,1135,-532
2019,10,23,2,1771,1736,1215,-521
2019,10,23,3,1694,1703,965,-738
2019,10,23,4,1588,1634,863,-771
2019,10,23,5,1482,1511,804,-707
2019,10,23,6,1472,1406,874,-532
2019,10,23,7,1441,1349,976,-373
2019,10,23,8,1414,1321,1049,-272
2019,10,23,9,1374,1308,1066,-242
2019,10,23,10,1414,1325,1076,-249
2019,10,23,11,1520,1355,1087,-268
2019,10,23,12,1714,1469,1121,-348
2019,10,23,13,1874,1657,1124,-533
2019,10,23,14,1920,1820,1117,-703
2019,10,23,15,1927,1827,1194,-633
2019,10,23,16,1905,1841,1268,-573
2019,10,23,17,1852,1765,1269,-496
2019,10,23,18,1766,1727,1311,-416
2019,10,23,19,1697,1662,1259,-403
2019,10,23,20,1658,1655,1297,-358
2019,10,23,21,1635,1627,1367,-260
2019,10,23,22,1649,1600,1361,-239
2019,10,23,23,1679,1621,1410,-211
2019,10,24,0,1723,1631,1500,-131
2019,10,24,1,1809,1683,1367,-316
2019,10,24,2,1807,1771,1327,-444
2019,10,24,3,1749,1762,1241,-521
2019,10,24,4,1652,1698,1193,-505
2019,10,24,5,1562,1605,1107,-498
2019,10,24,6,1522,1505,962,-543
2019,10,24,7,1506,1451,823,-628
2019,10,24,8,1490,1441,797,-644
2019,10,24,9,1530,1448,829,-619
2019,10,24,10,1574,1468,783,-685
2019,10,24,11,1679,1524,769,-755
2019,10,24,12,1886,1641,814,-827
2019,10,24,13,2053,1832,863,-969
2019,10,24,14,2082,1979,1046,-933
2019,10,24,15,2022,2010,1184,-826
2019,10,24,16,1940,1969,1068,-901
2019,10,24,17,1860,1894,1016,-878
2019,10,24,18,1776,1827,917,-910
2019,10,24,19,1713,1755,888,-867
2019,10,24,20,1695,1727,913,-814
2019,10,24,21,1686,1681,961,-720
2019,10,24,22,1704,1665,955,-710
2019,10,24,23,1727,1649,1072,-577
2019,10,25,0,1780,1653,1129,-524
2019,10,25,1,1850,1690,1282,-408
2019,10,25,2,1823,1774,1211,-563
2019,10,25,3,1751,1765,1155,-610
2019,10,25,4,1645,1706,1157,-549
2019,10,25,5,1546,1613,908,-705
2019,10,25,6,1471,1521,867,-654
2019,10,25,7,1446,1469,834,-635
2019,10,25,8,1434,1441,822,-619
2019,10,25,9,1470,1442,843,-599
2019,10,25,10,1512,1448,882,-566
2019,10,25,11,1622,1499,925,-574
2019,10,25,12,1810,1592,1076,-516
2019,10,25,13,1958,1762,1165,-597
2019,10,25,14,1986,1906,1247,-659
2019,10,25,15,1924,1939,1299,-640
2019,10,25,16,1850,1911,1347,-564
2019,10,25,17,1803,1842,1395,-447
2019,10,25,18,1749,1730,1320,-410
2019,10,25,19,1718,1701,1405,-296
2019,10,25,20,1682,1655,1354,-301
2019,10,25,21,1673,1615,1330,-285
2019,10,25,22,1679,1594,1255,-339
2019,10,25,23,1691,1581,1246,-335
2019,10,26,0,1688,1590,1146,-444
2019,10,26,1,1717,1625,1106,-519
2019,10,26,2,1671,1669,1083,-586
2019,10,26,3,1613,1641,994,-647
2019,10,26,4,1547,1592,1070,-522
2019,10,26,5,1476,1526,1073,-453
2019,10,26,6,1436,1452,1077,-375
2019,10,26,7,1396,1384,940,-444
2019,10,26,8,1391,1353,831,-522
2019,10,26,9,1378,1351,898,-453
2019,10,26,10,1413,1353,1130,-223
2019,10,26,11,1482,1372,1204,-168
2019,10,26,12,1583,1420,1256,-164
2019,10,26,13,1685,1498,1280,-218
2019,10,26,14,1762,1603,1289,-314
2019,10,26,15,1791,1706,1279,-427
2019,10,26,16,1794,1757,1342,-415
2019,10,26,17,1787,1766,1433,-333
2019,10,26,18,1749,1730,1446,-284
2019,10,26,19,1698,1685,1418,-267
2019,10,26,20,1671,1661,1401,-260
2019,10,26,21,1655,1624,1398,-226
2019,10,26,22,1668,1609,1415,-194
2019,10,26,23,1697,1641,1470,-171
2019,10,27,0,1745,1662,1485,-177
2019,10,27,1,1832,1721,1537,-184
2019,10,27,2,1830,1777,1461,-316
2019,10,27,3,1803,1754,1327,-427
2019,10,27,4,1729,1719,1268,-451
2019,10,27,5,1645,1654,1384,-270
2019,10,27,6,1559,1588,1278,-310
2019,10,27,7,1522,1522,1244,-278
2019,10,27,8,1528,1487,1145,-342
2019,10,27,9,1558,1487,1148,-339
2019,10,27,10,1607,1490,1181,-309
2019,10,27,11,1669,1513,1190,-323
2019,10,27,12,1756,1567,1192,-375
2019,10,27,13,1812,1654,1153,-501
2019,10,27,14,1891,1760,1146,-614
2019,10,27,15,1904,1861,1186,-675
2019,10,27,16,1888,1894,1224,-670
2019,10,27,17,1858,1877,1296,-581
2019,10,27,18,1803,1841,1389,-452
2019,10,27,19,1746,1777,1360,-417
2019,10,27,20,1730,1730,1288,-442
2019,10,27,21,1707,1681,1283,-398
2019,10,27,22,1705,1653,1280,-373
2019,10,27,23,1745,1673,1352,-321
2019,10,28,0,1804,1711,1208,-503
2019,10,28,1,1907,1806,1142,-664
2019,10,28,2,1934,1900,1121,-779
2019,10,28,3,1932,1894,1110,-784
2019,10,28,4,1858,1835,1107,-728
2019,10,28,5,1750,1737,1075,-662
2019,10,28,6,1607,1650,1030,-620
2019,10,28,7,1567,1600,987,-613
2019,10,28,8,1567,1598,856,-742
2019,10,28,9,1622,1605,853,-752
2019,10,28,10,1694,1637,805,-832
2019,10,28,11,1824,1708,858,-850
2019,10,28,12,2045,1827,946,-881
2019,10,28,13,2231,2021,1132,-889
2019,10,28,14,2336,2166,1214,-952
2019,10,28,15,2308,2170,1221,-949
2019,10,28,16,2238,2156,1119,-1037
2019,10,28,17,2144,2139,1092,-1047
2019,10,28,18,2051,2079,1044,-1035
2019,10,28,19,2060,2043,1068,-975
2019,10,28,20,1981,1961,1037,-924
2019,10,28,21,1946,1920,1053,-867
2019,10,28,22,1914,1906,992,-914
2019,10,28,23,1947,1931,1079,-852
2019,10,29,0,2034,1951,1212,-739
2019,10,29,1,2135,1993,1168,-825
2019,10,29,2,2118,2035,1161,-874
2019,10,29,3,2010,1995,1143,-852
2019,10,29,4,1856,1918,1094,-824
2019,10,29,5,1748,1780,1208,-572
2019,10,29,6,1634,1680,1246,-434
2019,10,29,7,1617,1636,1225,-411
2019,10,29,8,1655,1628,1263,-365
2019,10,29,9,1731,1624,1236,-388
2019,10,29,10,1782,1665,1305,-360
2019,10,29,11,1918,1739,1451,-288
2019,10,29,12,2126,1874,1484,-390
2019,10,29,13,2291,2101,1460,-641
2019,10,29,14,2338,2252,1529,-723
2019,10,29,15,2317,2282,1648,-634
2019,10,29,16,2304,2257,1505,-752
2019,10,29,17,2266,2222,1339,-883
2019,10,29,18,2175,2158,1324,-834
2019,10,29,19,2117,2075,1318,-757
2019,10,29,20,2037,2000,1318,-682
2019,10,29,21,1996,1936,1215,-721
2019,10,29,22,1970,1904,1239,-665
2019,10,29,23,1938,1904,1177,-727
2019,10,30,0,1999,1941,1180,-761
2019,10,30,1,2123,2027,1283,-744
2019,10,30,2,2131,2136,1409,-727
2019,10,30,3,2108,2142,1284,-858
2019,10,30,4,1963,2087,1192,-895
2019,10,30,5,1858,1977,1069,-908
2019,10,30,6,1816,1906,1050,-856
2019,10,30,7,1790,1853,910,-943
2019,10,30,8,1841,1842,891,-951
2019,10,30,9,1865,1863,809,-1054
2019,10,30,10,1929,1884,756,-1128
2019,10,30,11,2060,1950,808,-1142
2019,10,30,12,2290,2068,933,-1135
2019,10,30,13,2460,2267,1122,-1145
2019,10,30,14,2464,2422,1264,-1158
2019,10,30,15,2361,2429,1285,-1144
2019,10,30,16,2297,2368,1295,-1073
2019,10,30,17,2228,2252,1223,-1029
2019,10,30,18,2182,2134,1102,-1032
2019,10,30,19,2038,2033,982,-1051
2019,10,30,20,1974,1949,1073,-876
2019,10,30,21,1919,1902,1051,-851
2019,10,30,22,1913,1851,935,-916
2019,10,30,23,1954,1864,926,-938
2019,10,31,0,2056,1891,1019,-872
2019,10,31,1,2158,1959,1172,-787
2019,10,31,2,2157,2077,1364,-713
2019,10,31,3,2084,2087,1359,-728
2019,10,31,4,1968,2043,1358,-685
2019,10,31,5,1847,1938,1289,-649
2019,10,31,6,1792,1841,1162,-679
2019,10,31,7,1762,1792,892,-900
2019,10,31,8,1794,1762,925,-837
2019,10,31,9,1822,1781,981,-800
2019,10,31,10,1859,1798,991,-807
2019,10,31,11,2004,1853,1031,-822
2019,10,31,12,2177,1961,1047,-914
2019,10,31,13,2334,2159,1232,-927
2019,10,31,14,2336,2303,1461,-842
2019,10,31,15,2288,2320,1512,-808
2019,10,31,16,2202,2264,1413,-851
2019,10,31,17,2113,2170,1187,-983
2019,10,31,18,2044,2071,1076,-995
2019,10,31,19,1926,1969,1030,-939
2019,10,31,20,1875,1896,942,-954
2019,10,31,21,1804,1845,881,-964
2019,10,31,22,1866,1821,840,-981
2019,10,31,23,1919,1819,887,-932
2019,11,1,0,2024,1829,810,-1019
2019,11,1,1,2136,1872,990,-882
2019,11,1,2,2095,1910,1035,-875
2019,11,1,3,1981,1929,1020,-909
2019,11,1,4,1814,1925,971,-954
2019,11,1,5,1765,1841,997,-844
2019,11,1,6,1749,1765,977,-788
2019,11,1,7,1740,1773,929,-844
2019,11,1,8,1780,1719,821,-898
2019,11,1,9,1805,1725,808,-917
2019,11,1,10,1850,1754,811,-943
2019,11,1,11,1941,1800,863,-937
2019,11,1,12,2119,1905,871,-1034
2019,11,1,13,2258,2084,1101,-983
2019,11,1,14,2221,2226,1195,-1031
2019,11,1,15,2147,2251,1250,-1001
2019,11,1,16,2062,2218,1170,-1048
2019,11,1,17,2014,2131,1120,-1011
2019,11,1,18,1958,2033,1102,-931
2019,11,1,19,1946,1937,987,-950
2019,11,1,20,1891,1856,896,-960
2019,11,1,21,1869,1795,886,-909
2019,11,1,22,1840,1765,874,-891
2019,11,1,23,1835,1742,914,-828
2019,11,2,0,1876,1753,915,-838
2019,11,2,1,1911,1806,894,-912
2019,11,2,2,1902,1891,1056,-835
2019,11,2,3,1892,1889,1084,-805
2019,11,2,4,1843,1863,1065,-798
2019,11,2,5,1753,1805,1097,-708
2019,11,2,6,1717,1725,1062,-663
2019,11,2,7,1690,1682,958,-724
2019,11,2,8,1682,1673,970,-703
2019,11,2,9,1661,1665,991,-674
2019,11,2,10,1696,1690,1058,-632
2019,11,2,11,1765,1722,1123,-599
2019,11,2,12,1862,1788,1199,-589
2019,11,2,13,1950,1871,1276,-595
2019,11,2,14,2019,1981,1313,-668
2019,11,2,15,2030,2073,1384,-689
2019,11,2,16,1982,2079,1401,-678
2019,11,2,17,1919,2008,1343,-665
2019,11,2,18,1861,1919,1112,-807
2019,11,2,19,1780,1824,1001,-823
2019,11,2,20,1785,1746,1034,-712
2019,11,2,21,1742,1661,1030,-631
2019,11,2,22,1728,1623,1064,-559
2019,11,2,23,1741,1626,1053,-573
2019,11,3,0,1810,1650,1004,-646
2019,11,3,1,1850,1732,1237,-495
2019,11,3,2,1816,1792,1384,-408
2019,11,3,3,1792,1786,1237,-549
2019,11,3,4,1758,1767,1091,-676
2019,11,3,5,1689,1717,1006,-711
2019,11,3,6,1655,1654,990,-664
2019,11,3,7,-9999,1618,908,-710
2019,11,3,8,-9999,1618,908,-9999
2019,11,3,9,-9999,1665,991,-9999
2019,11,3,10,-9999,1690,1058,-9999
2019,11,3,11,-9999,1722,1123,-9999
2019,11,3,12,-9999,1788,1199,-9999
2019,11,3,13,-9999,1871,1276,-9999
2019,11,3,14,-9999,1981,1313,-9999
2019,11,3,15,-9999,2073,1384,-9999
2019,11,3,16,-9999,2079,1401,-9999
2019,11,3,17,-9999,2008,1343,-9999
2019,11,3,18,-9999,1919,1112,-9999
2019,11,3,19,-9999,1824,1001,-9999
2019,11,3,20,-9999,1746,1034,-9999
2019,11,3,21,-9999,1661,1030,-9999
2019,11,3,22,-9999,1623,1064,-9999
2019,11,3,23,-9999,1626,1053,-9999
2019,11,4,0,-9999,1650,1004,-9999
2019,11,4,1,-9999,1732,1237,-9999
2019,11,4,2,-9999,1792,1384,-9999
2019,11,4,3,-9999,1786,1237,-9999
2019,11,4,4,-9999,1767,1091,-9999
2019,11,4,5,-9999,1717,1006,-9999
2019,11,4,6,-9999,1654,990,-9999
2019,11,4,7,1597,1597,908,-9999
2019,11,4,8,-9999,-9999,-9999,-9999
2019,11,4,9,1505,1522,1079,-443
2019,11,4,10,1558,1526,1010,-516
2019,11,4,11,1582,1562,1066,-496
2019,11,4,12,1637,1613,1088,-525
2019,11,4,13,1758,1747,1108,-639
2019,11,4,14,1944,1959,1273,-686
2019,11,4,15,2113,2079,1379,-700
2019,11,4,16,2184,2049,1354,-695
2019,11,4,17,2062,1964,1383,-581
2019,11,4,18,1883,1865,1434,-431
2019,11,4,19,1848,1806,1341,-465
2019,11,4,20,1787,1748,1309,-439
2019,11,4,21,1747,1717,1317,-400
2019,11,4,22,1726,1674,1328,-346
2019,11,4,23,1704,1673,1328,-345
2019,11,5,0,1710,1687,1281,-406
2019,11,5,1,1751,1784,1264,-520
2019,11,5,2,1849,1867,1278,-589
2019,11,5,3,1962,1851,1334,-517
2019,11,5,4,1933,1815,1331,-484
2019,11,5,5,1799,1743,1325,-418
2019,11,5,6,1681,1652,1321,-331
2019,11,5,7,1578,1558,1225,-333
2019,11,5,8,1584,1523,1048,-475
2019,11,5,9,1573,1515,1051,-464
2019,11,5,10,1522,1520,1015,-505
2019,11,5,11,1543,1542,1008,-534
2019,11,5,12,1599,1593,1062,-531
2019,11,5,13,1717,1726,1103,-623
2019,11,5,14,1902,1937,1286,-651
2019,11,5,15,2044,2053,1340,-713
2019,11,5,16,2029,1996,1400,-596
2019,11,5,17,1939,1919,1257,-662
2019,11,5,18,1852,1842,1209,-633
2019,11,5,19,1810,1767,1125,-642
2019,11,5,20,1760,1705,1095,-610
2019,11,5,21,1719,1660,1112,-548
2019,11,5,22,1685,1643,1135,-508
2019,11,5,23,1672,1624,1166,-458
2019,11,6,0,1688,1642,1108,-534
2019,11,6,1,1737,1741,1279,-462
2019,11,6,2,1825,1818,1321,-497
2019,11,6,3,1890,1817,1298,-519
2019,11,6,4,1848,1784,1224,-560
2019,11,6,5,1741,1723,1198,-525
2019,11,6,6,1643,1624,1092,-532
2019,11,6,7,1558,1546,1025,-521
2019,11,6,8,1570,1504,939,-565
2019,11,6,9,1523,1498,943,-555
2019,11,6,10,1516,1496,943,-553
2019,11,6,11,1537,1520,966,-554
2019,11,6,12,1589,1584,1107,-477
2019,11,6,13,1720,1702,1166,-536
2019,11,6,14,1911,1910,1291,-619
2019,11,6,15,2038,2033,1284,-749
2019,11,6,16,1993,1975,1296,-679
2019,11,6,17,1919,1893,1330,-563
2019,11,6,18,1843,1816,1289,-527
2019,11,6,19,1794,1746,1240,-506
2019,11,6,20,1742,1694,1203,-491
2019,11,6,21,1693,1662,1237,-425
2019,11,6,22,1653,1655,1310,-345
2019,11,6,23,1650,1635,1305,-330
2019,11,7,0,1686,1671,1301,-370
2019,11,7,1,1771,1766,1330,-436
2019,11,7,2,1870,1850,1349,-501
2019,11,7,3,1904,1836,1222,-614
2019,11,7,4,1871,1817,1220,-597
2019,11,7,5,1784,1739,1120,-619
2019,11,7,6,1681,1647,1214,-433
2019,11,7,7,1590,1561,1083,-478
2019,11,7,8,1586,1526,1036,-490
2019,11,7,9,1555,1518,1052,-466
2019,11,7,10,1542,1520,1049,-471
2019,11,7,11,1572,1551,1074,-477
2019,11,7,12,1641,1604,1061,-543
2019,11,7,13,1766,1734,1100,-634
2019,11,7,14,1966,1932,1253,-679
2019,11,7,15,2093,2050,1370,-680
2019,11,7,16,2040,2008,1449,-559
2019,11,7,17,1932,1933,1404,-529
2019,11,7,18,1866,1853,1221,-632
2019,11,7,19,1807,1774,1208,-566
2019,11,7,20,1744,1722,1186,-536
2019,11,7,21,1713,1674,1156,-518
2019,11,7,22,1682,1655,1151,-504
2019,11,7,23,1675,1644,1097,-547
2019,11,8,0,1703,1682,1076,-606
2019,11,8,1,1807,1798,1168,-630
2019,11,8,2,1914,1879,1162,-717
2019,11,8,3,1926,1869,1226,-643
2019,11,8,4,1865,1838,1178,-660
2019,11,8,5,1783,1781,1095,-686
2019,11,8,6,1684,1675,1055,-620
2019,11,8,7,1605,1602,1077,-525
2019,11,8,8,1571,1564,965,-599
2019,11,8,9,1541,1553,913,-640
2019,11,8,10,1566,1548,916,-632
2019,11,8,11,1586,1576,928,-648
2019,11,8,12,1640,1626,993,-633
2019,11,8,13,1769,1753,1017,-736
2019,11,8,14,1969,1948,1220,-728
2019,11,8,15,2073,2065,1339,-726
2019,11,8,16,2010,2032,1367,-665
2019,11,8,17,1929,1955,1428,-527
2019,11,8,18,1896,1884,1280,-604
2019,11,8,19,1842,1792,1249,-543
2019,11,8,20,1786,1710,1187,-523
2019,11,8,21,1736,1684,1152,-532
2019,11,8,22,1692,1637,1149,-488
2019,11,8,23,1685,1624,1133,-491
2019,11,9,0,1708,1639,1041,-598
2019,11,9,1,1768,1733,1189,-544
2019,11,9,2,1811,1794,1267,-527
2019,11,9,3,1814,1778,1271,-507
2019,11,9,4,1771,1761,1260,-501
2019,11,9,5,1709,1713,1251,-462
2019,11,9,6,1653,1655,1233,-422
2019,11,9,7,1598,1579,1131,-448
2019,11,9,8,1532,1539,1072,-467
2019,11,9,9,1505,1522,1035,-487
2019,11,9,10,1543,1524,1033,-491
2019,11,9,11,1549,1542,1071,-471
2019,11,9,12,1592,1570,1069,-501
2019,11,9,13,1661,1642,1105,-537
2019,11,9,14,1759,1735,1125,-610
2019,11,9,15,1828,1845,1211,-634
2019,11,9,16,1849,1879,1297,-582
2019,11,9,17,1844,1852,1324,-528
2019,11,9,18,1822,1780,1156,-624
2019,11,9,19,1777,1743,1131,-612
2019,11,9,20,1702,1673,1102,-571
2019,11,9,21,1669,1599,1072,-527
2019,11,9,22,1647,1560,1082,-478
2019,11,9,23,1618,1551,1074,-477
2019,11,10,0,1637,1570,1054,-516
2019,11,10,1,1719,1691,1158,-533
2019,11,10,2,1786,1745,1189,-556
2019,11,10,3,1777,1732,1211,-521
2019,11,10,4,1728,1708,1168,-540
2019,11,10,5,1681,1668,1159,-509
2019,11,10,6,1624,1622,1201,-421
2019,11,10,7,1564,1549,1145,-404
2019,11,10,8,1500,1498,955,-543
2019,11,10,9,1474,1468,965,-503
2019,11,10,10,1493,1460,957,-503
2019,11,10,11,1501,1453,964,-489
2019,11,10,12,1526,1473,958,-515
2019,11,10,13,1566,1501,960,-541
2019,11,10,14,1633,1576,1090,-486
2019,11,10,15,1691,1668,1093,-575
2019,11,10,16,1726,1726,1199,-527
2019,11,10,17,1749,1712,1278,-434
2019,11,10,18,1751,1657,1192,-465
2019,11,10,19,1696,1616,1304,-312
2019,11,10,20,1634,1581,1311,-270
2019,11,10,21,1594,1547,1351,-196
2019,11,10,22,1576,1530,1485,-45
2019,11,10,23,1577,1536,1537,1
2019,11,11,0,1615,1575,1527,-48
2019,11,11,1,1727,1672,1482,-190
2019,11,11,2,1787,1737,1484,-253
2019,11,11,3,1765,1715,1606,-109
2019,11,11,4,1742,1683,1543,-140
2019,11,11,5,1681,1606,1402,-204
2019,11,11,6,1586,1521,1354,-167
2019,11,11,7,1489,1444,1379,-65
2019,11,11,8,1421,1401,1306,-95
2019,11,11,9,1429,1394,1294,-100
2019,11,11,10,1472,1406,1148,-258
2019,11,11,11,1507,1426,1082,-344
2019,11,11,12,1565,1494,1206,-288
2019,11,11,13,1680,1621,1296,-325
2019,11,11,14,1885,1828,1440,-388
2019,11,11,15,2021,1969,1490,-479
2019,11,11,16,2023,1945,1548,-397
2019,11,11,17,1941,1866,1562,-304
2019,11,11,18,1837,1823,1350,-473
2019,11,11,19,1776,1766,1416,-350
2019,11,11,20,1735,1726,1389,-337
2019,11,11,21,1716,1695,1369,-326
2019,11,11,22,1706,1681,1289,-392
2019,11,11,23,1706,1676,1188,-488
2019,11,12,0,1738,1716,1162,-554
2019,11,12,1,1866,1860,1182,-678
2019,11,12,2,1959,1943,1310,-633
2019,11,12,3,1987,1920,1291,-629
2019,11,12,4,1957,1903,1320,-583
2019,11,12,5,1857,1817,1294,-523
2019,11,12,6,1752,1713,1191,-522
2019,11,12,7,1653,1611,1124,-487
2019,11,12,8,1578,1559,1090,-469
2019,11,12,9,1565,1541,1036,-505
2019,11,12,10,1564,1563,1054,-509
2019,11,12,11,1584,1580,1088,-492
2019,11,12,12,1646,1631,1144,-487
2019,11,12,13,1780,1757,1288,-469
2019,11,12,14,1998,1962,1424,-538
2019,11,12,15,2130,2089,1501,-588
2019,11,12,16,2081,2041,1496,-545
2019,11,12,17,1992,1982,1409,-573
2019,11,12,18,1919,1911,1401,-510
2019,11,12,19,1877,1827,1434,-393
2019,11,12,20,1805,1784,1389,-395
2019,11,12,21,1744,1750,1228,-522
2019,11,12,22,1740,1742,1177,-565
2019,11,12,23,1746,1730,1110,-620
2019,11,13,0,1794,1776,1101,-675
2019,11,13,1,1923,1889,1226,-663
2019,11,13,2,1996,1918,1301,-617
2019,11,13,3,1965,1892,1346,-546
2019,11,13,4,1892,1835,1295,-540
2019,11,13,5,1789,1758,1279,-479
2019,11,13,6,1688,1630,1186,-444
2019,11,13,7,1595,1533,1130,-403
2019,11,13,8,1547,1496,1084,-412
2019,11,13,9,1515,1474,1074,-400
2019,11,13,10,1537,1487,1035,-452
2019,11,13,11,1566,1499,1026,-473
2019,11,13,12,1600,1557,979,-578
2019,11,13,13,1708,1672,982,-690
2019,11,13,14,1910,1866,1228,-638
2019,11,13,15,2035,1976,1210,-766
2019,11,13,16,1980,1954,1243,-711
2019,11,13,17,1920,1884,1188,-696
2019,11,13,18,1892,1818,1171,-647
2019,11,13,19,1844,1747,1184,-563
2019,11,13,20,1785,1686,1118,-568
2019,11,13,21,1737,1662,1123,-539
2019,11,13,22,1694,1628,1228,-400
2019,11,13,23,1677,1619,1227,-392
2019,11,14,0,1707,1646,1212,-434
2019,11,14,1,1818,1779,1227,-552
2019,11,14,2,1871,1854,1186,-668
2019,11,14,3,1859,1847,1206,-641
2019,11,14,4,1858,1814,1196,-618
2019,11,14,5,1784,1758,1169,-589
2019,11,14,6,1680,1653,1038,-615
2019,11,14,7,1593,1558,930,-628
2019,11,14,8,1545,1519,929,-590
2019,11,14,9,1529,1505,1017,-488
2019,11,14,10,1526,1508,1025,-483
2019,11,14,11,1550,1532,1072,-460
2019,11,14,12,1612,1590,1113,-477
2019,11,14,13,1723,1714,1299,-415
2019,11,14,14,1918,1911,1281,-630
2019,11,14,15,2050,2028,1469,-559
2019,11,14,16,2026,1999,1416,-583
2019,11,14,17,1961,1926,1324,-602
2019,11,14,18,1890,1860,1230,-630
2019,11,14,19,1808,1799,1168,-631
2019,11,14,20,1766,1751,1112,-639
2019,11,14,21,1744,1727,1126,-601
2019,11,14,22,1738,1703,1089,-614
2019,11,14,23,1746,1693,1092,-601
2019,11,15,0,1789,1729,1226,-503
2019,11,15,1,1906,1825,1175,-650
2019,11,15,2,1960,1879,1194,-685
2019,11,15,3,1909,1852,1144,-708
2019,11,15,4,1857,1815,1123,-692
2019,11,15,5,1773,1730,1121,-609
2019,11,15,6,1659,1635,986,-649
2019,11,15,7,1571,1541,945,-596
2019,11,15,8,1532,1484,975,-509
2019,11,15,9,1498,1470,1030,-440
2019,11,15,10,1513,1463,990,-473
2019,11,15,11,1539,1494,966,-528
2019,11,15,12,1595,1524,980,-544
2019,11,15,13,1691,1637,1100,-537
2019,11,15,14,1846,1803,1128,-675
2019,11,15,15,1939,1927,1178,-749
2019,11,15,16,1907,1933,1180,-753
2019,11,15,17,1857,1892,1103,-789
2019,11,15,18,1839,1819,1137,-682
2019,11,15,19,1817,1753,1154,-599
2019,11,15,20,1775,1695,1156,-539
2019,11,15,21,1733,1661,1146,-515
2019,11,15,22,1700,1635,1133,-502
2019,11,15,23,1703,1630,1061,-569
2019,11,16,0,1726,1655,1121,-534
2019,11,16,1,1786,1747,1106,-641
2019,11,16,2,1818,1753,1174,-579
2019,11,16,3,1794,1735,1251,-484
2019,11,16,4,1730,1697,1263,-434
2019,11,16,5,1669,1639,1204,-435
2019,11,16,6,1599,1558,1114,-444
2019,11,16,7,1530,1485,1099,-386
2019,11,16,8,1487,1420,1120,-300
2019,11,16,9,1459,1388,1239,-149
2019,11,16,10,1443,1381,1331,-50
2019,11,16,11,1446,1379,1347,-32
2019,11,16,12,1463,1400,1345,-55
2019,11,16,13,1522,1456,1364,-92
2019,11,16,14,1607,1549,1372,-177
2019,11,16,15,1686,1649,1333,-316
2019,11,16,16,1758,1720,1387,-333
2019,11,16,17,1778,1734,1397,-337
2019,11,16,18,1759,1706,1322,-384
2019,11,16,19,1725,1666,1325,-341
2019,11,16,20,1677,1626,1363,-263
2019,11,16,21,1632,1575,1315,-260
2019,11,16,22,1600,1549,1322,-227
2019,11,16,23,1591,1536,1278,-258
2019,11,17,0,1625,1566,1220,-346
2019,11,17,1,1731,1677,1260,-417
2019,11,17,2,1781,1731,1223,-508
2019,11,17,3,1758,1722,1207,-515
2019,11,17,4,1729,1703,1214,-489
2019,11,17,5,1687,1664,1184,-480
2019,11,17,6,1626,1607,1065,-542
2019,11,17,7,1567,1546,986,-560
2019,11,17,8,1531,1499,907,-592
2019,11,17,9,1500,1473,855,-618
2019,11,17,10,1486,1473,834,-639
2019,11,17,11,1487,1479,846,-633
2019,11,17,12,1525,1505,842,-663
2019,11,17,13,1592,1562,871,-691
2019,11,17,14,1662,1633,876,-757
2019,11,17,15,1748,1722,1048,-674
2019,11,17,16,1796,1787,1090,-697
2019,11,17,17,1793,1759,1100,-659
2019,11,17,18,1756,1714,884,-830
2019,11,17,19,1705,1668,877,-791
2019,11,17,20,1669,1629,833,-796
2019,11,17,21,1641,1594,841,-753
2019,11,17,22,1629,1583,831,-752
2019,11,17,23,1630,1583,838,-745
2019,11,18,0,1666,1626,906,-720
2019,11,18,1,1788,1755,1042,-713
2019,11,18,2,1841,1804,1074,-730
2019,11,18,3,1823,1778,1074,-704
2019,11,18,4,1797,1731,1077,-654
2019,11,18,5,1726,1668,1074,-594
2019,11,18,6,1610,1568,974,-594
2019,11,18,7,1515,1467,931,-536
2019,11,18,8,1408,1432,873,-559
2019,11,18,9,1400,1423,921,-502
2019,11,18,10,1464,1428,914,-514
2019,11,18,11,1489,1451,884,-567
2019,11,18,12,1545,1505,864,-641
2019,11,18,13,1659,1634,905,-729
2019,11,18,14,1838,1836,1059,-777
2019,11,18,15,1974,1971,1193,-778
2019,11,18,16,2004,1949,1254,-695
2019,11,18,17,1950,1884,1316,-568
2019,11,18,18,1877,1817,1292,-525
2019,11,18,19,1810,1757,1289,-468
2019,11,18,20,1762,1709,1245,-464
2019,11,18,21,1729,1676,1190,-486
2019,11,18,22,1706,1647,1189,-458
2019,11,18,23,1706,1654,1203,-451
2019,11,19,0,1733,1709,1217,-492
2019,11,19,1,1843,1822,1332,-490
2019,11,19,2,1914,1870,1397,-473
2019,11,19,3,1900,1836,1385,-451
2019,11,19,4,1846,1795,1356,-439
2019,11,19,5,1755,1703,1288,-415
2019,11,19,6,1636,1592,1098,-494
2019,11,19,7,1536,1478,1135,-343
2019,11,19,8,1464,1436,1065,-371
2019,11,19,9,1466,1402,1058,-344
2019,11,19,10,1450,1395,1003,-392
2019,11,19,11,1459,1411,1091,-320
2019,11,19,12,1498,1438,1147,-291
2019,11,19,13,1596,1556,1083,-473
2019,11,19,14,1774,1740,1223,-517
2019,11,19,15,1891,1886,1162,-724
2019,11,19,16,1875,1878,1109,-769
2019,11,19,17,1834,1865,1105,-760
2019,11,19,18,1833,1825,1283,-542
2019,11,19,19,1835,1769,1396,-373
2019,11,19,20,1796,1730,1416,-314
2019,11,19,21,1761,1689,1428,-261
2019,11,19,22,1735,1668,1413,-255
2019,11,19,23,1720,1667,1398,-269
2019,11,20,0,1761,1721,1109,-612
2019,11,20,1,1885,1822,1106,-716
2019,11,20,2,1928,1878,1201,-677
2019,11,20,3,1896,1857,1140,-717
2019,11,20,4,1866,1822,1138,-684
2019,11,20,5,1793,1752,1222,-530
2019,11,20,6,1692,1641,1177,-464
2019,11,20,7,1597,1549,1167,-382
2019,11,20,8,1551,1497,1048,-449
2019,11,20,9,1528,1481,1010,-471
2019,11,20,10,1529,1480,962,-518
2019,11,20,11,1546,1494,989,-505
2019,11,20,12,1600,1550,1007,-543
2019,11,20,13,1715,1656,1034,-622
2019,11,20,14,1906,1851,1179,-672
2019,11,20,15,2046,1995,1309,-686
2019,11,20,16,2041,1974,1388,-586
2019,11,20,17,2000,1932,1484,-448
2019,11,20,18,1925,1872,1397,-475
2019,11,20,19,1859,1819,1400,-419
2019,11,20,20,1806,1757,1268,-489
2019,11,20,21,1766,1721,1287,-434
2019,11,20,22,1738,1700,1306,-394
2019,11,20,23,1728,1716,1335,-381
2019,11,21,0,1783,1750,1302,-448
2019,11,21,1,1922,1891,1314,-577
2019,11,21,2,1981,1938,1302,-636
2019,11,21,3,1957,1918,1411,-507
2019,11,21,4,1932,1894,1387,-507
2019,11,21,5,1848,1808,1388,-420
2019,11,21,6,1740,1708,1298,-410
2019,11,21,7,1651,1603,1222,-381
2019,11,21,8,1572,1549,1169,-380
2019,11,21,9,1555,1532,1211,-321
2019,11,21,10,1579,1534,1218,-316
2019,11,21,11,1604,1562,1215,-347
2019,11,21,12,1666,1617,1204,-413
2019,11,21,13,1791,1738,1265,-473
2019,11,21,14,1994,1943,1333,-610
2019,11,21,15,2147,2081,1274,-807
2019,11,21,16,2131,2067,1430,-637
2019,11,21,17,2051,1994,1310,-684
2019,11,21,18,1983,1914,1246,-668
2019,11,21,19,1899,1834,1057,-777
2019,11,21,20,1820,1783,982,-801
2019,11,21,21,1768,1728,986,-742
2019,11,21,22,1744,1704,1102,-602
2019,11,21,23,1733,1707,1082,-625
2019,11,22,0,1781,1760,997,-763
2019,11,22,1,1939,1883,1036,-847
2019,11,22,2,2010,1948,1122,-826
2019,11,22,3,1984,1939,1132,-807
2019,11,22,4,1971,1926,1108,-818
2019,11,22,5,1901,1867,1031,-836
2019,11,22,6,1785,1759,1024,-735
2019,11,22,7,1698,1658,1025,-633
2019,11,22,8,1652,1623,962,-661
2019,11,22,9,1640,1609,932,-677
2019,11,22,10,1631,1612,934,-678
2019,11,22,11,1651,1636,935,-701
2019,11,22,12,1763,1689,982,-707
2019,11,22,13,1854,1810,1032,-778
2019,11,22,14,2073,2006,1156,-850
2019,11,22,15,2196,2138,1221,-917
2019,11,22,16,2153,2128,1243,-885
2019,11,22,17,2067,2052,1153,-899
2019,11,22,18,2006,1933,1122,-811
2019,11,22,19,1931,1844,1072,-772
2019,11,22,20,1845,1792,1060,-732
2019,11,22,21,1793,1743,1042,-701
2019,11,22,22,1770,1705,1029,-676
2019,11,22,23,1763,1685,1033,-652
2019,11,23,0,1792,1723,1000,-723
2019,11,23,1,1868,1849,1070,-779
2019,11,23,2,1912,1909,1150,-759
2019,11,23,3,1928,1903,1052,-851
2019,11,23,4,1918,1893,1012,-881
2019,11,23,5,1877,1849,1068,-781
2019,11,23,6,1814,1779,1060,-719
2019,11,23,7,1737,1715,912,-803
2019,11,23,8,1669,1673,871,-802
2019,11,23,9,1639,1640,878,-762
2019,11,23,10,1673,1647,863,-784
2019,11,23,11,1680,1665,884,-781
2019,11,23,12,1702,1693,898,-795
2019,11,23,13,1786,1767,956,-811
2019,11,23,14,1890,1870,910,-960
2019,11,23,15,2004,1989,1098,-891
2019,11,23,16,2054,2036,1173,-863
2019,11,23,17,2014,2005,1218,-787
2019,11,23,18,1945,1954,966,-988
2019,11,23,19,1862,1868,954,-914
2019,11,23,20,1807,1772,932,-840
2019,11,23,21,1749,1712,944,-768
2019,11,23,22,1694,1658,939,-719
2019,11,23,23,1692,1638,911,-727
2019,11,24,0,1717,1680,853,-827
2019,11,24,1,1854,1827,1015,-812
2019,11,24,2,1924,1890,1000,-890
2019,11,24,3,1914,1885,1007,-878
2019,11,24,4,1887,1864,1021,-843
2019,11,24,5,1843,1828,1025,-803
2019,11,24,6,1781,1760,948,-812
2019,11,24,7,1712,1688,915,-773
2019,11,24,8,1609,1642,861,-781
2019,11,24,9,1586,1622,872,-750
2019,11,24,10,1641,1613,880,-733
2019,11,24,11,1651,1625,897,-728
2019,11,24,12,1677,1642,900,-742
2019,11,24,13,1733,1694,897,-797
2019,11,24,14,1801,1772,917,-855
2019,11,24,15,1886,1852,1012,-840
2019,11,24,16,1927,1915,1034,-881
2019,11,24,17,1892,1941,1029,-912
2019,11,24,18,1850,1899,939,-960
2019,11,24,19,1847,1827,913,-914
2019,11,24,20,1820,1790,958,-832
2019,11,24,21,1769,1756,999,-757
2019,11,24,22,1768,1704,1032,-672
2019,11,24,23,1770,1702,1136,-566
2019,11,25,0,1782,1741,1184,-557
2019,11,25,1,1928,1885,1324,-561
2019,11,25,2,1976,1926,1315,-611
2019,11,25,3,1944,1902,1303,-599
2019,11,25,4,1915,1881,1330,-551
2019,11,25,5,1862,1820,1322,-498
2019,11,25,6,1754,1717,1170,-547
2019,11,25,7,1665,1632,1203,-429
2019,11,25,8,1547,1564,1002,-562
2019,11,25,9,1576,1549,1209,-340
2019,11,25,10,1623,1537,1256,-281
2019,11,25,11,1643,1558,1309,-249
2019,11,25,12,1692,1599,1274,-325
2019,11,25,13,1817,1730,1414,-316
2019,11,25,14,2011,1889,1446,-443
2019,11,25,15,2150,2025,1458,-567
2019,11,25,16,2152,2071,1526,-545
2019,11,25,17,2095,2038,1485,-553
2019,11,25,18,2034,1999,1419,-580
2019,11,25,19,1983,1968,1309,-659
2019,11,25,20,1931,1919,1245,-674
2019,11,25,21,1926,1892,1307,-585
2019,11,25,22,1887,1866,1417,-449
2019,11,25,23,1900,1889,1471,-418
2019,11,26,0,1980,1953,1431,-522
2019,11,26,1,2150,2081,1513,-568
2019,11,26,2,2215,2125,1585,-540
2019,11,26,3,2177,2094,1512,-582
2019,11,26,4,2141,2047,1557,-490
2019,11,26,5,2048,1978,1537,-441
2019,11,26,6,1915,1859,1367,-492
2019,11,26,7,1811,1753,1349,-404
2019,11,26,8,1765,1704,1344,-360
2019,11,26,9,1763,1681,1313,-368
2019,11,26,10,1731,1683,1287,-396
2019,11,26,11,1744,1707,1285,-422
2019,11,26,12,1797,1751,1297,-454
2019,11,26,13,1920,1870,1393,-477
2019,11,26,14,2114,2026,1419,-607
2019,11,26,15,2255,2168,1398,-770
2019,11,26,16,2223,2176,1219,-957
2019,11,26,17,2162,2141,1047,-1094
2019,11,26,18,2143,2087,1022,-1065
2019,11,26,19,2086,2075,1080,-995
2019,11,26,20,2019,2033,959,-1074
2019,11,26,21,1990,2006,909,-1097
2019,11,26,22,1995,2000,903,-1097
2019,11,26,23,2011,1994,931,-1063
2019,11,27,0,2086,2012,1039,-973
2019,11,27,1,2242,2153,1450,-703
2019,11,27,2,2278,2172,1575,-597
2019,11,27,3,2200,2141,1543,-598
2019,11,27,4,2135,2101,1536,-565
2019,11,27,5,2033,2009,1444,-565
2019,11,27,6,1904,1911,1352,-559
2019,11,27,7,1794,1809,1368,-441
2019,11,27,8,1714,1753,1337,-416
2019,11,27,9,1678,1717,1337,-380
2019,11,27,10,1759,1704,1336,-368
2019,11,27,11,1769,1705,1284,-421
2019,11,27,12,1802,1743,1332,-411
2019,11,27,13,1898,1821,1379,-442
2019,11,27,14,2053,1941,1488,-453
2019,11,27,15,2159,2041,1481,-560
2019,11,27,16,2090,2066,1545,-521
2019,11,27,17,2020,2086,1596,-490
2019,11,27,18,2021,2061,1548,-513
2019,11,27,19,2061,2032,1469,-563
2019,11,27,20,2059,1998,1393,-605
2019,11,27,21,2038,1973,1433,-540
2019,11,27,22,2021,1959,1451,-508
2019,11,27,23,2024,1933,1387,-546
2019,11,28,0,2081,1956,1385,-571
2019,11,28,1,2179,2037,1395,-642
2019,11,28,2,2159,2044,1372,-672
2019,11,28,3,2090,2000,1264,-736
2019,11,28,4,2024,1964,1239,-725
2019,11,28,5,1948,1889,1194,-695
2019,11,28,6,1846,1801,1162,-639
2019,11,28,7,1747,1697,1123,-574
2019,11,28,8,1697,1638,1018,-620
2019,11,28,9,1728,1594,917,-677
2019,11,28,10,1676,1582,903,-679
2019,11,28,11,1668,1574,879,-695
2019,11,28,12,1682,1595,924,-671
2019,11,28,13,1712,1661,951,-710
2019,11,28,14,1766,1730,950,-780
2019,11,28,15,1865,1825,991,-834
2019,11,28,16,1969,1923,1080,-843
2019,11,28,17,1988,1990,1091,-899
2019,11,28,18,1987,1993,1114,-879
2019,11,28,19,1994,1951,1137,-814
2019,11,28,20,1958,1878,1121,-757
2019,11,28,21,1910,1783,1146,-637
2019,11,28,22,1838,1700,1104,-596
2019,11,28,23,1778,1650,1041,-609
2019,11,29,0,1775,1647,1042,-605
2019,11,29,1,1864,1716,1018,-698
2019,11,29,2,1870,1739,992,-747
2019,11,29,3,1804,1749,981,-768
2019,11,29,4,1790,1761,1000,-761
2019,11,29,5,1798,1732,1058,-674
2019,11,29,6,1765,1680,1030,-650
2019,11,29,7,1702,1643,1024,-619
2019,11,29,8,1824,1597,1014,-583
2019,11,29,9,1728,1584,1017,-567
2019,11,29,10,1593,1583,992,-591
2019,11,29,11,1613,1604,1037,-567
2019,11,29,12,1646,1624,1096,-528
2019,11,29,13,1688,1690,1087,-603
2019,11,29,14,1734,1773,1093,-680
2019,11,29,15,1858,1850,1058,-792
2019,11,29,16,2025,1916,1057,-859
2019,11,29,17,2077,1948,1067,-881
2019,11,29,18,2046,1951,1080,-871
2019,11,29,19,2004,1926,1114,-812
2019,11,29,20,1937,1892,1129,-763
2019,11,29,21,1864,1866,1122,-744
2019,11,29,22,1821,1865,1119,-746
2019,11,29,23,1842,1892,1138,-754
2019,11,30,0,1928,1931,1250,-681
2019,11,30,1,2069,2029,1326,-703
2019,11,30,2,2098,2045,1321,-724
2019,11,30,3,2067,2013,1411,-602
2019,11,30,4,2021,1987,1412,-575
2019,11,30,5,1987,1933,1407,-526
2019,11,30,6,1947,1857,1305,-552
2019,11,30,7,1870,1785,1242,-543
2019,11,30,8,1821,1720,1131,-589
2019,11,30,9,1726,1690,1115,-575
2019,11,30,10,1725,1680,1062,-618
2019,11,30,11,1733,1696,1088,-608
2019,11,30,12,1762,1725,1125,-600
2019,11,30,13,1805,1782,1153,-629
2019,11,30,14,1849,1877,1126,-751
2019,11,30,15,1961,1984,1010,-974
2019,11,30,16,2140,2079,958,-1121
2019,11,30,17,2190,2088,988,-1100
2019,11,30,18,2164,2048,1099,-949
2019,11,30,19,2106,1994,1059,-935
2019,11,30,20,2000,1931,1027,-904
2019,11,30,21,1913,1864,1083,-781
2019,11,30,22,1856,1829,1106,-723
2019,11,30,23,1854,1826,1012,-814
2019,12,1,0,1891,1877,962,-915
2019,12,1,1,2035,2040,1122,-918
2019,12,1,2,2098,2102,1142,-960
2019,12,1,3,2102,2101,1242,-859
2019,12,1,4,2095,2091,1245,-846
2019,12,1,5,2069,2049,1275,-774
2019,12,1,6,2023,1979,1282,-697
2019,12,1,7,1953,1907,1317,-590
2019,12,1,8,1803,1816,1245,-571
2019,12,1,9,1796,1832,1353,-479
2019,12,1,10,1839,1816,1321,-495
2019,12,1,11,1834,1825,1364,-461
2019,12,1,12,1842,1831,1378,-453
2019,12,1,13,1864,1871,1452,-419
2019,12,1,14,1897,1925,1445,-480
2019,12,1,15,1989,2013,1439,-574
2019,12,1,16,2101,2083,1437,-646
2019,12,1,17,2134,2122,1445,-677
2019,12,1,18,2123,2152,1463,-689
2019,12,1,19,2106,2136,1529,-607
2019,12,1,20,2110,2138,1527,-611
2019,12,1,21,2081,2121,1499,-622
2019,12,1,22,2099,2099,1476,-623
2019,12,1,23,2126,2103,1450,-653
2019,12,2,0,2190,2118,1385,-733
2019,12,2,1,2303,2212,1465,-747
2019,12,2,2,2295,2214,1494,-720
2019,12,2,3,2225,2179,1354,-825
2019,12,2,4,2174,2128,1383,-745
2019,12,2,5,2101,2032,1327,-705
2019,12,2,6,1969,1891,1281,-610
2019,12,2,7,1842,1786,1252,-534
2019,12,2,8,1624,1704,1161,-543
2019,12,2,9,1636,1684,1234,-450
2019,12,2,10,1701,1670,1129,-541
2019,12,2,11,1719,1681,1180,-501
2019,12,2,12,1769,1728,1188,-540
2019,12,2,13,1852,1832,1185,-647
2019,12,2,14,2004,2005,1187,-818
2019,12,2,15,2145,2118,1287,-831
2019,12,2,16,2190,2131,1246,-885
2019,12,2,17,2168,2124,1177,-947
2019,12,2,18,2148,2112,1095,-1017
2019,12,2,19,2134,2079,1015,-1064
2019,12,2,20,2113,2056,971,-1085
2019,12,2,21,2079,2017,1073,-944
2019,12,2,22,2054,2011,911,-1100
2019,12,2,23,2046,2012,1055,-957
2019,12,3,0,2076,2062,1052,-1010
2019,12,3,1,2184,2173,1121,-1052
2019,12,3,2,2216,2183,1120,-1063
2019,12,3,3,2187,2150,1038,-1112
2019,12,3,4,2146,2090,1022,-1068
2019,12,3,5,2050,1998,941,-1057
2019,12,3,6,1930,1862,825,-1037
2019,12,3,7,1823,1743,800,-943
2019,12,3,8,1683,1674,731,-943
2019,12,3,9,1696,1631,708,-923
2019,12,3,10,1691,1630,729,-901
2019,12,3,11,1701,1638,683,-955
2019,12,3,12,1742,1683,720,-963
2019,12,3,13,1831,1793,774,-1019
2019,12,3,14,1988,1963,983,-980
2019,12,3,15,2101,2094,1100,-994
2019,12,3,16,2152,2092,1110,-982
2019,12,3,17,2154,2067,1161,-906
2019,12,3,18,2126,2039,1199,-840
2019,12,3,19,2074,2010,1170,-840
2019,12,3,20,2032,1962,964,-998
2019,12,3,21,1994,1956,940,-1016
2019,12,3,22,1963,1927,1015,-912
2019,12,3,23,1967,1940,1081,-859
2019,12,4,0,2016,2008,1185,-823
2019,12,4,1,2141,2104,1099,-1005
2019,12,4,2,2187,2118,1116,-1002
2019,12,4,3,2153,2084,1216,-868
2019,12,4,4,2109,2038,1179,-859
2019,12,4,5,2033,1949,1003,-946
2019,12,4,6,1911,1818,949,-869
2019,12,4,7,1786,1700,1013,-687
2019,12,4,8,1746,1624,952,-672
2019,12,4,9,1720,1599,949,-650
2019,12,4,10,1664,1596,897,-699
2019,12,4,11,1683,1615,973,-642
2019,12,4,12,1723,1650,971,-679
2019,12,4,13,1815,1764,1005,-759
2019,12,4,14,1991,1943,1073,-870
2019,12,4,15,2129,2078,1186,-892
2019,12,4,16,2170,2082,1252,-830
2019,12,4,17,2165,2048,1448,-600
2019,12,4,18,2120,2003,1356,-647
2019,12,4,19,2042,1951,1403,-548
2019,12,4,20,1982,1883,1193,-690
2019,12,4,21,1921,1854,1291,-563
2019,12,4,22,1877,1841,1211,-630
2019,12,4,23,1876,1838,1164,-674
2019,12,5,0,1934,1939,1096,-843
2019,12,5,1,2085,2063,1151,-912
2019,12,5,2,2150,2110,1225,-885
2019,12,5,3,2151,2077,1061,-1016
2019,12,5,4,2134,2055,988,-1067
2019,12,5,5,2052,1981,933,-1048
2019,12,5,6,1926,1863,942,-921
2019,12,5,7,1811,1746,922,-824
2019,12,5,8,1778,1680,863,-817
2019,12,5,9,1739,1647,976,-671
2019,12,5,10,1696,1645,893,-752
2019,12,5,11,1710,1648,893,-755
2019,12,5,12,1751,1688,909,-779
2019,12,5,13,1849,1806,885,-921
2019,12,5,14,2023,1988,1113,-875
2019,12,5,15,2162,2129,1479,-650
2019,12,5,16,2172,2130,1443,-687
2019,12,5,17,2148,2110,1278,-832
2019,12,5,18,2121,2080,1102,-978
2019,12,5,19,2082,2043,1084,-959
2019,12,5,20,2043,2009,1053,-956
2019,12,5,21,2006,1976,1117,-859
2019,12,5,22,2008,1971,1115,-856
2019,12,5,23,2031,1974,1065,-909
2019,12,6,0,2099,2013,1106,-907
2019,12,6,1,2213,2103,1150,-953
2019,12,6,2,2220,2116,1307,-809
2019,12,6,3,2159,2092,1549,-543
2019,12,6,4,2105,2044,1604,-440
2019,12,6,5,2023,1949,1448,-501
2019,12,6,6,1896,1832,1368,-464
2019,12,6,7,1785,1705,1235,-470
2019,12,6,8,1742,1638,1183,-455
2019,12,6,9,1716,1602,952,-650
2019,12,6,10,1686,1588,974,-614
2019,12,6,11,1694,1589,867,-722
2019,12,6,12,1727,1642,883,-759
2019,12,6,13,1826,1735,906,-829
2019,12,6,14,2010,1907,1129,-778
2019,12,6,15,2140,2057,1383,-674
2019,12,6,16,2151,2051,1459,-592
2019,12,6,17,2123,2001,1532,-469
2019,12,6,18,2056,1960,1471,-489
2019,12,6,19,1985,1896,1394,-502
2019,12,6,20,1909,1890,1457,-433
2019,12,6,21,1856,1847,1526,-321
2019,12,6,22,1845,1815,1618,-197
2019,12,6,23,1884,1830,1601,-229
2019,12,7,0,1956,1871,1586,-285
2019,12,7,1,2028,1989,1734,-255
2019,12,7,2,2039,1992,1777,-215
2019,12,7,3,2065,1963,1632,-331
2019,12,7,4,2026,1941,1569,-372
2019,12,7,5,1963,1893,1534,-359
2019,12,7,6,1874,1813,1453,-360
2019,12,7,7,1776,1713,1345,-368
2019,12,7,8,1709,1640,1285,-355
2019,12,7,9,1670,1591,1218,-373
2019,12,7,10,1635,1580,1211,-369
2019,12,7,11,1620,1572,1147,-425
2019,12,7,12,1641,1601,1168,-433
2019,12,7,13,1691,1641,1200,-441
2019,12,7,14,1771,1719,1233,-486
2019,12,7,15,1870,1815,1330,-485
2019,12,7,16,1938,1894,1429,-465
2019,12,7,17,1932,1912,1519,-393
2019,12,7,18,1917,1901,1564,-337
2019,12,7,19,1906,1868,1538,-330
2019,12,7,20,1871,1811,1546,-265
2019,12,7,21,1844,1779,1457,-322
2019,12,7,22,1826,1756,1460,-296
2019,12,7,23,1838,1761,1530,-231
2019,12,8,0,1901,1821,1613,-208
2019,12,8,1,2001,1916,1558,-358
2019,12,8,2,1996,1894,1394,-500
2019,12,8,3,1933,1872,1376,-496
2019,12,8,4,1879,1842,1395,-447
2019,12,8,5,1832,1785,1300,-485
2019,12,8,6,1764,1694,1151,-543
2019,12,8,7,1678,1619,1044,-575
2019,12,8,8,1610,1543,922,-621
2019,12,8,9,1580,1514,892,-622
2019,12,8,10,1560,1491,902,-589
2019,12,8,11,1567,1489,893,-596
2019,12,8,12,1578,1500,909,-591
2019,12,8,13,1606,1535,930,-605
2019,12,8,14,1667,1595,948,-647
2019,12,8,15,1745,1697,987,-710
2019,12,8,16,1816,1775,1123,-652
2019,12,8,17,1868,1814,1093,-721
2019,12,8,18,1872,1811,1223,-588
2019,12,8,19,1851,1810,1301,-509
2019,12,8,20,1836,1788,1337,-451
2019,12,8,21,1834,1788,1305,-483
2019,12,8,22,1823,1768,1405,-363
2019,12,8,23,1840,1767,1456,-311
2019,12,9,0,1890,1808,1469,-339
2019,12,9,1,1989,1953,1588,-365
2019,12,9,2,1985,1991,1618,-373
2019,12,9,3,1989,1971,1540,-431
2019,12,9,4,1992,1949,1465,-484
2019,12,9,5,1930,1870,1379,-491
2019,12,9,6,1819,1757,1342,-415
2019,12,9,7,1710,1646,1241,-405
2019,12,9,8,1641,1591,1224,-367
2019,12,9,9,1621,1575,1187,-388
2019,12,9,10,1628,1565,1163,-402
2019,12,9,11,1657,1599,1201,-398
2019,12,9,12,1711,1652,1302,-350
2019,12,9,13,1830,1772,1365,-407
2019,12,9,14,2021,1955,1641,-314
2019,12,9,15,2167,2100,1801,-299
2019,12,9,16,2193,2090,1623,-467
2019,12,9,17,2162,2059,1681,-378
2019,12,9,18,2107,2001,1654,-347
2019,12,9,19,2056,1938,1491,-447
2019,12,9,20,1974,1888,1456,-432
2019,12,9,21,1951,1855,1432,-423
2019,12,9,22,1905,1831,1447,-384
2019,12,9,23,1901,1839,1435,-404
2019,12,10,0,1941,1880,1413,-467
2019,12,10,1,2069,2050,1565,-485
2019,12,10,2,2104,2106,1588,-518
2019,12,10,3,2122,2103,1716,-387
2019,12,10,4,2130,2071,1696,-375
2019,12,10,5,2056,2008,1571,-437
2019,12,10,6,1934,1886,1317,-569
2019,12,10,7,1826,1773,1144,-629
2019,12,10,8,1743,1709,1154,-555
2019,12,10,9,1725,1692,969,-723
2019,12,10,10,1724,1711,922,-789
2019,12,10,11,1742,1722,899,-823
2019,12,10,12,1796,1781,925,-856
2019,12,10,13,1914,1897,1045,-852
2019,12,10,14,2109,2080,1160,-920
2019,12,10,15,2261,2218,1512,-706
2019,12,10,16,2265,2204,1522,-682
2019,12,10,17,2211,2152,1320,-832
2019,12,10,18,2139,2069,1371,-698
2019,12,10,19,2083,2000,1357,-643
2019,12,10,20,2037,1917,1286,-631
2019,12,10,21,2007,1875,1327,-548
2019,12,10,22,1910,1824,1408,-416
2019,12,10,23,1889,1826,1438,-388
2019,12,11,0,1940,1902,1433,-469
2019,12,11,1,2076,2060,1621,-439
2019,12,11,2,2125,2119,1629,-490
2019,12,11,3,2105,2105,1613,-492
2019,12,11,4,2086,2089,1661,-428
2019,12,11,5,2017,2008,1601,-407
2019,12,11,6,1900,1894,1597,-297
2019,12,11,7,1792,1771,1560,-211
2019,12,11,8,1758,1702,1475,-227
2019,12,11,9,1728,1677,1447,-230
2019,12,11,10,1717,1663,1400,-263
2019,12,11,11,1724,1666,1302,-364
2019,12,11,12,1758,1705,1305,-400
2019,12,11,13,1864,1797,1338,-459
2019,12,11,14,2042,1979,1469,-510
2019,12,11,15,2153,2113,1612,-501
2019,12,11,16,2155,2130,1508,-622
2019,12,11,17,2113,2104,1391,-713
2019,12,11,18,2064,2091,1306,-785
2019,12,11,19,2039,2054,1253,-801
2019,12,11,20,2024,2019,1253,-766
2019,12,11,21,2018,1992,1219,-773
2019,12,11,22,2009,1971,1230,-741
2019,12,11,23,2005,1971,1282,-689
2019,12,12,0,2072,2029,1229,-800
2019,12,12,1,2204,2121,1407,-714
2019,12,12,2,2234,2127,1438,-689
2019,12,12,3,2161,2089,1470,-619
2019,12,12,4,2090,2041,1469,-572
2019,12,12,5,2000,1951,1359,-592
2019,12,12,6,1865,1830,1391,-439
2019,12,12,7,1745,1689,1370,-319
2019,12,12,8,1661,1630,1335,-295
2019,12,12,9,1642,1596,1318,-278
2019,12,12,10,1626,1581,1325,-256
2019,12,12,11,1634,1578,1289,-289
2019,12,12,12,1667,1611,1276,-335
2019,12,12,13,1753,1702,1259,-443
2019,12,12,14,1911,1876,1289,-587
2019,12,12,15,2038,2003,1345,-658
2019,12,12,16,2050,2023,1516,-507
2019,12,12,17,2018,2006,1318,-688
2019,12,12,18,1987,1983,1345,-638
2019,12,12,19,1971,1953,1358,-595
2019,12,12,20,1954,1927,1327,-600
2019,12,12,21,1933,1893,1313,-580
2019,12,12,22,1930,1882,1338,-544
2019,12,12,23,1936,1889,1327,-562
2019,12,13,0,1986,1946,1292,-654
2019,12,13,1,2121,2031,1462,-569
2019,12,13,2,2143,2044,1385,-659
2019,12,13,3,2069,2017,1416,-601
2019,12,13,4,2031,1984,1306,-678
2019,12,13,5,1952,1898,1270,-628
2019,12,13,6,1820,1778,1309,-469
2019,12,13,7,1711,1658,1248,-410
2019,12,13,8,1670,1583,1170,-413
2019,12,13,9,1650,1571,1162,-409
2019,12,13,10,1612,1553,1184,-369
2019,12,13,11,1622,1575,1233,-342
2019,12,13,12,1655,1630,1276,-354
2019,12,13,13,1769,1739,1306,-433
2019,12,13,14,1966,1917,1311,-606
2019,12,13,15,2107,2063,1687,-376
2019,12,13,16,2120,2080,1686,-394
2019,12,13,17,2096,2064,1586,-478
2019,12,13,18,2060,2020,1549,-471
2019,12,13,19,2031,2005,1568,-437
2019,12,13,20,2002,1980,1449,-531
2019,12,13,21,1984,1965,1525,-440
2019,12,13,22,1983,1957,1542,-415
2019,12,13,23,2009,1979,1561,-418
2019,12,14,0,2083,2038,1609,-429
2019,12,14,1,2134,2129,1637,-492
2019,12,14,2,2128,2122,1668,-454
2019,12,14,3,2107,2076,1666,-410
2019,12,14,4,2060,2048,1639,-409
2019,12,14,5,2001,1967,1466,-501
2019,12,14,6,1906,1877,1307,-570
2019,12,14,7,1790,1773,1258,-515
2019,12,14,8,1722,1689,1045,-644
2019,12,14,9,1673,1644,1043,-601
2019,12,14,10,1676,1629,1061,-568
2019,12,14,11,1678,1648,1094,-554
2019,12,14,12,1705,1668,1088,-580
2019,12,14,13,1774,1718,1250,-468
2019,12,14,14,1850,1797,1382,-415
2019,12,14,15,1960,1897,1420,-477
2019,12,14,16,2031,1989,1525,-464
2019,12,14,17,2043,2011,1578,-433
2019,12,14,18,2041,1988,1614,-374
2019,12,14,19,2026,1931,1567,-364
2019,12,14,20,1961,1869,1564,-305
2019,12,14,21,1886,1815,1592,-223
2019,12,14,22,1836,1795,1519,-276
2019,12,14,23,1831,1814,1507,-307
2019,12,15,0,1894,1892,1497,-395
2019,12,15,1,2031,2023,1691,-332
2019,12,15,2,2066,2031,1478,-553
2019,12,15,3,2055,2025,1583,-442
2019,12,15,4,2034,2009,1479,-530
2019,12,15,5,1993,1963,1446,-517
2019,12,15,6,1917,1889,1211,-678
2019,12,15,7,1833,1817,1193,-624
2019,12,15,8,1784,1757,1134,-623
2019,12,15,9,1749,1729,1121,-608
2019,12,15,10,1738,1713,1196,-517
2019,12,15,11,1747,1716,1132,-584
2019,12,15,12,1762,1739,1051,-688
2019,12,15,13,1816,1798,1055,-743
2019,12,15,14,1906,1881,1064,-817
2019,12,15,15,2012,1964,1126,-838
2019,12,15,16,2097,2050,1243,-807
2019,12,15,17,2122,2072,1311,-761
2019,12,15,18,2093,2042,1432,-610
2019,12,15,19,2051,1980,1452,-528
2019,12,15,20,2005,1934,1408,-526
2019,12,15,21,1951,1912,1378,-534
2019,12,15,22,1907,1901,1386,-515
2019,12,15,23,1924,1917,1383,-534
2019,12,16,0,2001,1986,1479,-507
2019,12,16,1,2150,2135,1716,-419
2019,12,16,2,2185,2166,1627,-539
2019,12,16,3,2182,2156,1675,-481
2019,12,16,4,2175,2133,1677,-456
2019,12,16,5,2093,2055,1623,-432
2019,12,16,6,1969,1939,1623,-316
2019,12,16,7,1860,1813,1390,-423
2019,12,16,8,1755,1757,1382,-375
2019,12,16,9,1743,1749,1408,-341
2019,12,16,10,1783,1748,1396,-352
2019,12,16,11,1818,1777,1403,-374
2019,12,16,12,1882,1849,1496,-353
2019,12,16,13,2023,1975,1669,-306
2019,12,16,14,2236,2189,1789,-400
2019,12,16,15,2377,2349,2034,-315
2019,12,16,16,2402,2363,1946,-417
2019,12,16,17,2357,2293,1854,-439
2019,12,16,18,2281,2229,1877,-352
2019,12,16,19,2197,2147,1709,-438
2019,12,16,20,2132,2067,1630,-437
2019,12,16,21,2087,2021,1522,-499
2019,12,16,22,2052,1980,1521,-459
2019,12,16,23,2048,1983,1545,-438
2019,12,17,0,2099,2051,1611,-440
2019,12,17,1,2234,2241,1819,-422
2019,12,17,2,2287,2313,1801,-512
2019,12,17,3,2313,2309,1800,-509
2019,12,17,4,2308,2267,1680,-587
2019,12,17,5,2226,2201,1648,-553
2019,12,17,6,2092,2073,1645,-428
2019,12,17,7,1970,1962,1481,-481
2019,12,17,8,1853,1905,1393,-512
2019,12,17,9,1863,1891,1421,-470
2019,12,17,10,1899,1893,1438,-455
2019,12,17,11,1930,1929,1423,-506
2019,12,17,12,1999,1976,1554,-422
2019,12,17,13,2138,2109,1917,-192
2019,12,17,14,2335,2323,1945,-378
2019,12,17,15,2491,2469,1990,-479
2019,12,17,16,2512,2463,1936,-527
2019,12,17,17,2443,2382,1869,-513
2019,12,17,18,2361,2292,1946,-346
2019,12,17,19,2256,2225,1922,-303
2019,12,17,20,2162,2153,1773,-380
2019,12,17,21,2115,2107,1734,-373
2019,12,17,22,2091,2092,1756,-336
2019,12,17,23,2099,2103,1755,-348
2019,12,18,0,2188,2186,1808,-378
2019,12,18,1,2375,2342,1986,-356
2019,12,18,2,2443,2388,2111,-277
2019,12,18,3,2422,2360,2095,-265
2019,12,18,4,2391,2330,2105,-225
2019,12,18,5,2299,2252,1937,-315
2019,12,18,6,2153,2102,1763,-339
2019,12,18,7,2028,1988,1560,-428
2019,12,18,8,1910,1927,1431,-496
2019,12,18,9,1929,1893,1431,-462
2019,12,18,10,1939,1910,1449,-461
2019,12,18,11,1960,1919,1425,-494
2019,12,18,12,2008,1960,1484,-476
2019,12,18,13,2127,2071,1650,-421
2019,12,18,14,2311,2253,1744,-509
2019,12,18,15,2427,2372,1869,-503
2019,12,18,16,2424,2385,1910,-475
2019,12,18,17,2348,2353,1766,-587
2019,12,18,18,2285,2318,1879,-439
2019,12,18,19,2256,2242,1797,-445
2019,12,18,20,2204,2167,1754,-413
2019,12,18,21,2163,2113,1737,-376
2019,12,18,22,2114,2097,1613,-484
2019,12,18,23,2128,2084,1512,-572
2019,12,19,0,2213,2125,1470,-655
2019,12,19,1,2354,2281,1702,-579
2019,12,19,2,2369,2323,1758,-565
2019,12,19,3,2331,2285,1685,-600
2019,12,19,4,2279,2250,1626,-624
2019,12,19,5,2182,2161,1574,-587
2019,12,19,6,2046,2028,1472,-556
2019,12,19,7,1930,1900,1389,-511
2019,12,19,8,1860,1816,1190,-626
2019,12,19,9,1838,1787,1246,-541
2019,12,19,10,1836,1792,1290,-502
2019,12,19,11,1836,1790,1189,-601
2019,12,19,12,1862,1819,1198,-621
2019,12,19,13,1949,1921,1372,-549
2019,12,19,14,2118,2102,1518,-584
2019,12,19,15,2243,2222,1646,-576
2019,12,19,16,2244,2236,1518,-718
2019,12,19,17,2193,2207,1520,-687
2019,12,19,18,2148,2186,1423,-763
2019,12,19,19,2121,2139,1415,-724
2019,12,19,20,2100,2076,1218,-858
2019,12,19,21,2079,2073,1184,-889
2019,12,19,22,2089,2043,1310,-733
2019,12,19,23,2119,2046,1350,-696
2019,12,20,0,2175,2072,1458,-614
2019,12,20,1,2305,2175,1530,-645
2019,12,20,2,2286,2196,1621,-575
2019,12,20,3,2205,2160,1639,-521
2019,12,20,4,2147,2110,1651,-459
2019,12,20,5,2076,2042,1618,-424
2019,12,20,6,1944,1889,1483,-406
2019,12,20,7,1820,1769,1467,-302
2019,12,20,8,1724,1687,1386,-301
2019,12,20,9,1719,1650,1393,-257
2019,12,20,10,1704,1629,1378,-251
2019,12,20,11,1714,1622,1268,-354
2019,12,20,12,1748,1661,1293,-368
2019,12,20,13,1846,1753,1368,-385
2019,12,20,14,1998,1937,1676,-261
2019,12,20,15,2112,2065,1690,-375
2019,12,20,16,2127,2107,1684,-423
2019,12,20,17,2095,2075,1658,-417
2019,12,20,18,2054,2038,1634,-404
2019,12,20,19,2011,1993,1594,-399
2019,12,20,20,1963,1939,1558,-381
2019,12,20,21,1943,1915,1574,-341
2019,12,20,22,1949,1896,1623,-273
2019,12,20,23,1953,1896,1640,-256
2019,12,21,0,2007,1947,1688,-259
2019,12,21,1,2090,2053,1690,-363
2019,12,21,2,2096,2056,1670,-386
2019,12,21,3,2073,2020,1715,-305
2019,12,21,4,2028,1989,1768,-221
2019,12,21,5,1970,1936,1815,-121
2019,12,21,6,1889,1836,1641,-195
2019,12,21,7,1793,1739,1536,-203
2019,12,21,8,1718,1660,1525,-135
2019,12,21,9,1692,1616,1472,-144
2019,12,21,10,1655,1604,1469,-135
2019,12,21,11,1662,1606,1459,-147
2019,12,21,12,1679,1620,1479,-141
2019,12,21,13,1728,1668,1515,-153
2019,12,21,14,1814,1760,1535,-225
2019,12,21,15,1898,1860,1557,-303
2019,12,21,16,1988,1949,1719,-230
2019,12,21,17,2002,1994,1755,-239
2019,12,21,18,1988,2008,1789,-219
2019,12,21,19,1963,1982,1632,-350
2019,12,21,20,1927,1950,1588,-362
2019,12,21,21,1916,1915,1505,-410
2019,12,21,22,1931,1889,1509,-380
2019,12,21,23,1940,1886,1531,-355
2019,12,22,0,1998,1932,1570,-362
2019,12,22,1,2111,2014,1668,-346
2019,12,22,2,2109,2020,1630,-390
2019,12,22,3,2040,1983,1639,-344
2019,12,22,4,1996,1954,1628,-326
2019,12,22,5,1946,1899,1449,-450
2019,12,22,6,1868,1809,1436,-373
2019,12,22,7,1766,1717,1446,-271
2019,12,22,8,1720,1634,1439,-195
2019,12,22,9,1684,1598,1437,-161
2019,12,22,10,1611,1574,1434,-140
2019,12,22,11,1597,1564,1407,-157
2019,12,22,12,1604,1589,1451,-138
2019,12,22,13,1640,1635,1491,-144
2019,12,22,14,1723,1704,1578,-126
2019,12,22,15,1812,1794,1690,-104
2019,12,22,16,1897,1895,1736,-159
2019,12,22,17,1942,1941,1799,-142
2019,12,22,18,1946,1922,1686,-236
2019,12,22,19,1922,1876,1653,-223
2019,12,22,20,1882,1820,1647,-173
2019,12,22,21,1851,1774,1663,-111
2019,12,22,22,1805,1739,1640,-99
2019,12,22,23,1792,1757,1677,-80
2019,12,23,0,1838,1781,1586,-195
2019,12,23,1,1970,1910,1682,-228
2019,12,23,2,1978,1958,1684,-274
2019,12,23,3,1948,1930,1648,-282
2019,12,23,4,1944,1912,1697,-215
2019,12,23,5,1881,1852,1657,-195
2019,12,23,6,1760,1750,1414,-336
2019,12,23,7,1660,1650,1307,-343
2019,12,23,8,1639,1579,1274,-305
2019,12,23,9,1590,1539,1140,-399
2019,12,23,10,1592,1520,1157,-363
2019,12,23,11,1598,1520,1145,-375
2019,12,23,12,1636,1553,1049,-504
2019,12,23,13,1742,1635,1258,-377
2019,12,23,14,1910,1764,1362,-402
2019,12,23,15,2014,1881,1327,-554
2019,12,23,16,2013,1953,1377,-576
2019,12,23,17,1992,1977,1516,-461
2019,12,23,18,1962,1974,1388,-586
2019,12,23,19,1969,1929,1296,-633
2019,12,23,20,1946,1878,1161,-717
2019,12,23,21,1939,1829,1117,-712
2019,12,23,22,1902,1800,1073,-727
2019,12,23,23,1892,1814,1217,-597
2019,12,24,0,1924,1868,1282,-586
2019,12,24,1,2062,1969,1323,-646
2019,12,24,2,2103,1977,1338,-639
2019,12,24,3,2050,1944,1342,-602
2019,12,24,4,2004,1917,1313,-604
2019,12,24,5,1930,1858,1316,-542
2019,12,24,6,1800,1758,1273,-485
2019,12,24,7,1706,1667,1118,-549
2019,12,24,8,1751,1592,932,-660
2019,12,24,9,1714,1539,894,-645
2019,12,24,10,1621,1534,910,-624
2019,12,24,11,1616,1544,977,-567
2019,12,24,12,1648,1583,1196,-387
2019,12,24,13,1747,1658,1210,-448
2019,12,24,14,1909,1774,1346,-428
2019,12,24,15,2016,1871,1351,-520
2019,12,24,16,2024,1959,1322,-637
2019,12,24,17,2034,1993,1296,-697
2019,12,24,18,2015,2006,1209,-797
2019,12,24,19,1984,1973,1190,-783
2019,12,24,20,1961,1892,1203,-689
2019,12,24,21,1909,1839,1162,-677
2019,12,24,22,1868,1801,1172,-629
2019,12,24,23,1860,1777,1150,-627
2019,12,25,0,1900,1814,1256,-558
2019,12,25,1,1989,1893,1224,-669
2019,12,25,2,1999,1884,1214,-670
2019,12,25,3,1948,1854,1226,-628
2019,12,25,4,1906,1833,1230,-603
2019,12,25,5,1864,1814,1229,-585
2019,12,25,6,1813,1773,1049,-724
2019,12,25,7,1751,1704,1005,-699
2019,12,25,8,1803,1643,941,-702
2019,12,25,9,1711,1624,929,-695
2019,12,25,10,1647,1611,912,-699
2019,12,25,11,1668,1604,932,-672
2019,12,25,12,1691,1630,951,-679
2019,12,25,13,1730,1674,969,-705
2019,12,25,14,1798,1754,1057,-697
2019,12,25,15,1894,1839,1167,-672
2019,12,25,16,2023,1909,1179,-730
2019,12,25,17,2082,1928,1210,-718
2019,12,25,18,2028,1916,1240,-676
2019,12,25,19,1925,1894,1195,-699
2019,12,25,20,1813,1849,1068,-781
2019,12,25,21,1769,1811,1070,-741
2019,12,25,22,1782,1783,993,-790
2019,12,25,23,1796,1774,985,-789
2019,12,26,0,1855,1778,1011,-767
2019,12,26,1,1970,1885,1047,-838
2019,12,26,2,1964,1892,1046,-846
2019,12,26,3,1916,1895,1052,-843
2019,12,26,4,1906,1880,1046,-834
2019,12,26,5,1910,1832,956,-876
2019,12,26,6,1867,1756,933,-823
2019,12,26,7,1778,1673,891,-782
2019,12,26,8,1788,1618,879,-739
2019,12,26,9,1680,1590,883,-707
2019,12,26,10,1624,1583,896,-687
2019,12,26,11,1655,1592,908,-684
2019,12,26,12,1669,1629,946,-683
2019,12,26,13,1682,1710,1113,-597
2019,12,26,14,1752,1833,1234,-599
2019,12,26,15,1897,1948,1265,-683
2019,12,26,16,2085,2022,1279,-743
2019,12,26,17,2118,2072,1510,-562
2019,12,26,18,2141,2091,1295,-796
2019,12,26,19,2094,2081,1182,-899
2019,12,26,20,2042,2060,1164,-896
2019,12,26,21,2033,2036,1144,-892
2019,12,26,22,2054,2010,1137,-873
2019,12,26,23,2072,1997,1151,-846
2019,12,27,0,2105,2037,1304,-733
2019,12,27,1,2215,2139,1324,-815
2019,12,27,2,2238,2148,1398,-750
2019,12,27,3,2195,2119,1423,-696
2019,12,27,4,2152,2071,1261,-810
2019,12,27,5,2108,1993,1266,-727
2019,12,27,6,2020,1884,1098,-786
2019,12,27,7,1909,1781,968,-813
2019,12,27,8,1864,1719,889,-830
2019,12,27,9,1756,1683,889,-794
2019,12,27,10,1753,1676,908,-768
2019,12,27,11,1764,1685,921,-764
2019,12,27,12,1787,1722,968,-754
2019,12,27,13,1833,1804,1129,-675
2019,12,27,14,1910,1928,1144,-784
2019,12,27,15,2053,2050,1250,-800
2019,12,27,16,2212,2132,1287,-845
2019,12,27,17,2268,2153,1242,-911
2019,12,27,18,2248,2149,1134,-1015
2019,12,27,19,2182,2114,1128,-986
2019,12,27,20,2115,2059,1122,-937
2019,12,27,21,2072,2023,1093,-930
2019,12,27,22,2037,1999,1078,-921
2019,12,27,23,2048,2001,1101,-900
2019,12,28,0,2098,2040,1421,-619
2019,12,28,1,2218,2137,1487,-650
2019,12,28,2,2231,2166,1524,-642
2019,12,28,3,2195,2125,1562,-563
2019,12,28,4,2174,2090,1465,-625
2019,12,28,5,2120,2034,1470,-564
2019,12,28,6,2039,1955,1436,-519
2019,12,28,7,1941,1860,1305,-555
2019,12,28,8,1810,1798,1254,-544
2019,12,28,9,1785,1767,1231,-536
2019,12,28,10,1819,1754,1207,-547
2019,12,28,11,1833,1753,1156,-597
2019,12,28,12,1842,1771,1150,-621
2019,12,28,13,1870,1826,1107,-719
2019,12,28,14,1935,1906,1108,-798
2019,12,28,15,2047,1990,1236,-754
2019,12,28,16,2187,2077,1304,-773
2019,12,28,17,2226,2112,1276,-836
2019,12,28,18,2198,2115,1272,-843
2019,12,28,19,2132,2070,1278,-792
2019,12,28,20,2052,1998,1094,-904
2019,12,28,21,1996,1918,1122,-796
2019,12,28,22,1962,1869,1140,-729
2019,12,28,23,1929,1860,1291,-569
2019,12,29,0,1964,1903,1216,-687
2019,12,29,1,2086,2050,1210,-840
2019,12,29,2,2134,2094,1167,-927
2019,12,29,3,2137,2069,1175,-894
2019,12,29,4,2121,2041,1157,-884
2019,12,29,5,2062,1981,1027,-954
2019,12,29,6,1993,1882,1005,-877
2019,12,29,7,1902,1799,1008,-791
2019,12,29,8,1818,1734,935,-799
2019,12,29,9,1794,1695,973,-722
2019,12,29,10,1739,1688,956,-732
2019,12,29,11,1745,1689,961,-728
2019,12,29,12,1772,1697,981,-716
2019,12,29,13,1820,1747,996,-751
2019,12,29,14,1856,1812,1033,-779
2019,12,29,15,1949,1899,1057,-842
2019,12,29,16,2069,1969,1273,-696
2019,12,29,17,2129,2026,1278,-748
2019,12,29,18,2111,2030,1279,-751
2019,12,29,19,2058,2026,1206,-820
2019,12,29,20,2027,2021,1058,-963
2019,12,29,21,2024,2000,1054,-946
2019,12,29,22,2030,1987,1038,-949
2019,12,29,23,2045,1975,1072,-903
2019,12,30,0,2092,2025,1294,-731
2019,12,30,1,2232,2123,1243,-880
2019,12,30,2,2258,2146,1294,-852
2019,12,30,3,2212,2100,1279,-821
2019,12,30,4,2167,2059,1203,-856
2019,12,30,5,2075,1980,1148,-832
2019,12,30,6,1943,1879,1075,-804
2019,12,30,7,1841,1762,1040,-722
2019,12,30,8,1802,1700,923,-777
2019,12,30,9,1779,1675,891,-784
2019,12,30,10,1749,1655,852,-803
2019,12,30,11,1752,1670,895,-775
2019,12,30,12,1785,1705,916,-789
2019,12,30,13,1896,1797,1082,-715
2019,12,30,14,2060,1928,1081,-847
2019,12,30,15,2169,2048,1220,-828
2019,12,30,16,2196,2112,1237,-875
2019,12,30,17,2180,2134,1303,-831
2019,12,30,18,2181,2124,1257,-867
2019,12,30,19,2164,2107,1208,-899
2019,12,30,20,2124,2069,1121,-948
2019,12,30,21,2108,2033,1093,-940
2019,12,30,22,2080,2013,1083,-930
2019,12,30,23,2078,2008,1164,-844
2019,12,31,0,2128,2056,1215,-841
2019,12,31,1,2258,2177,1324,-853
2019,12,31,2,2307,2199,1355,-844
2019,12,31,3,2271,2164,1344,-820
2019,12,31,4,2225,2115,1218,-897
2019,12,31,5,2136,2028,1080,-948
2019,12,31,6,2012,1911,1087,-824
2019,12,31,7,1893,1798,956,-842
2019,12,31,8,1848,1723,913,-810
2019,12,31,9,1794,1684,890,-794
2019,12,31,10,1752,1668,913,-755
2019,12,31,11,1752,1680,946,-734
2019,12,31,12,1764,1707,932,-775
2019,12,31,13,1816,1781,954,-827
2019,12,31,14,1888,1907,1175,-732
2019,12,31,15,2017,2013,1285,-728
2019,12,31,16,2161,2079,1278,-801
2019,12,31,17,2204,2099,1260,-839
2019,12,31,18,2207,2098,1276,-822
2019,12,31,19,2161,2061,1215,-846
2019,12,31,20,2104,2019,1221,-798
2019,12,31,21,2042,1976,1197,-779
2019,12,31,22,2020,1951,1185,-766
2019,12,31,23,2020,1938,1182,-756
2020,1,1,0,2065,1993,1239,-754
2020,1,1,1,2178,2094,1312,-782
2020,1,1,2,2198,2086,1338,-748
2020,1,1,3,2133,1990,1360,-630
2020,1,1,4,2058,1919,1210,-709
2020,1,1,5,1958,1855,1196,-659
2020,1,1,6,1838,1784,1153,-631
2020,1,1,7,1750,1710,1160,-550
2020,1,1,8,1699,1651,1089,-562
2020,1,1,9,1623,1628,1061,-567
2020,1,1,10,1662,1597,1030,-567
2020,1,1,11,1675,1589,989,-600
2020,1,1,12,1663,1603,957,-646
2020,1,1,13,1692,1641,1042,-599
2020,1,1,14,1741,1678,1102,-576
2020,1,1,15,1800,1731,1203,-528
2020,1,1,16,1903,1757,1176,-581
2020,1,1,17,1931,1806,1237,-569
2020,1,1,18,1900,1878,1121,-757
2020,1,1,19,1855,1883,1378,-505
2020,1,1,20,1833,1845,1418,-427
2020,1,1,21,1803,1799,1416,-383
2020,1,1,22,1802,1778,1462,-316
2020,1,1,23,1791,1774,1449,-325
2020,1,2,0,1856,1789,1547,-242
2020,1,2,1,1964,1918,1568,-350
2020,1,2,2,1963,1961,1576,-385
2020,1,2,3,1938,1924,1611,-313
2020,1,2,4,1914,1892,1592,-300
2020,1,2,5,1894,1829,1559,-270
2020,1,2,6,1849,1747,1561,-186
2020,1,2,7,1773,1655,1555,-100
2020,1,2,8,1686,1590,1422,-168
2020,1,2,9,1660,1574,1403,-171
2020,1,2,10,1615,1557,1342,-215
2020,1,2,11,1622,1565,1286,-279
2020,1,2,12,1642,1598,1276,-322
2020,1,2,13,1659,1699,1392,-307
2020,1,2,14,1704,1843,1472,-371
2020,1,2,15,1847,1953,1479,-474
2020,1,2,16,2038,2016,1507,-509
2020,1,2,17,2104,2024,1539,-485
2020,1,2,18,2139,1999,1621,-378
2020,1,2,19,2085,1969,1674,-295
2020,1,2,20,1987,1921,1702,-219
2020,1,2,21,1923,1907,1598,-309
2020,1,2,22,1896,1887,1562,-325
2020,1,2,23,1933,1901,1549,-352
2020,1,3,0,1997,1921,1527,-394
2020,1,3,1,2122,2022,1456,-566
2020,1,3,2,2124,2057,1470,-587
2020,1,3,3,2074,2013,1418,-595
2020,1,3,4,2038,1959,1538,-421
2020,1,3,5,1980,1881,1508,-373
2020,1,3,6,1911,1774,1294,-480
2020,1,3,7,1811,1671,1221,-450
2020,1,3,8,1695,1606,1123,-483
2020,1,3,9,1654,1578,1091,-487
2020,1,3,10,1636,1567,1086,-481
2020,1,3,11,1637,1581,1105,-476
2020,1,3,12,1670,1615,1073,-542
2020,1,3,13,1745,1708,1127,-581
2020,1,3,14,1863,1842,1333,-509
2020,1,3,15,1986,1970,1473,-497
2020,1,3,16,2049,2042,1536,-506
2020,1,3,17,2062,2039,1342,-697
2020,1,3,18,2065,2029,1286,-743
2020,1,3,19,2029,1944,1296,-648
2020,1,3,20,1959,1895,1189,-706
2020,1,3,21,1895,1847,1178,-669
2020,1,3,22,1854,1813,1195,-618
2020,1,3,23,1836,1806,1239,-567
2020,1,4,0,1874,1844,1217,-627
2020,1,4,1,1988,1934,1308,-626
2020,1,4,2,1998,1987,1435,-552
2020,1,4,3,1969,1983,1475,-508
2020,1,4,4,1946,1953,1525,-428
2020,1,4,5,1903,1905,1532,-373
2020,1,4,6,1855,1825,1553,-272
2020,1,4,7,1772,1720,1320,-400
2020,1,4,8,1655,1640,1368,-272
2020,1,4,9,1627,1639,1411,-228
2020,1,4,10,1646,1632,1410,-222
2020,1,4,11,1660,1629,1443,-186
2020,1,4,12,1677,1639,1453,-186
2020,1,4,13,1715,1687,1450,-237
2020,1,4,14,1745,1752,1360,-392
2020,1,4,15,1829,1836,1293,-543
2020,1,4,16,1952,1899,1209,-690
2020,1,4,17,1983,1951,1116,-835
2020,1,4,18,1974,1969,1119,-850
2020,1,4,19,1928,1974,1088,-886
2020,1,4,20,1896,1922,1116,-806
2020,1,4,21,1901,1852,1366,-486
2020,1,4,22,1896,1820,1429,-391
2020,1,4,23,1874,1784,1426,-358
2020,1,5,0,1902,1811,1487,-324
2020,1,5,1,2000,1910,1542,-368
2020,1,5,2,2027,2001,1495,-506
2020,1,5,3,2007,1990,1363,-627
2020,1,5,4,2018,1971,1322,-649
2020,1,5,5,1973,1926,1273,-653
2020,1,5,6,1922,1839,1227,-612
2020,1,5,7,1830,1749,1150,-599
2020,1,5,8,1719,1692,1105,-587
2020,1,5,9,1696,1655,1005,-650
2020,1,5,10,1675,1647,979,-668
2020,1,5,11,1676,1629,1041,-588
2020,1,5,12,1696,1647,1138,-509
2020,1,5,13,1732,1681,1162,-519
2020,1,5,14,1775,1747,1174,-573
2020,1,5,15,1868,1838,1345,-493
2020,1,5,16,1982,1940,1347,-593
2020,1,5,17,2023,1993,1347,-646
2020,1,5,18,2056,1994,1345,-649
2020,1,5,19,2053,1964,1341,-623
2020,1,5,20,2017,1924,1357,-567
2020,1,5,21,1970,1928,1272,-656
2020,1,5,22,1917,1858,1347,-511
2020,1,5,23,1882,1877,1349,-528
2020,1,6,0,1902,1930,1334,-596
2020,1,6,1,2082,2050,1391,-659
2020,1,6,2,2163,2097,1411,-686
2020,1,6,3,2112,2060,1402,-658
2020,1,6,4,2056,2018,1435,-583
2020,1,6,5,1980,1941,1395,-546
2020,1,6,6,1870,1823,1182,-641
2020,1,6,7,1766,1719,1200,-519
2020,1,6,8,1682,1672,1217,-455
2020,1,6,9,1672,1652,1293,-359
2020,1,6,10,1685,1652,1334,-318
2020,1,6,11,1704,1658,1336,-322
2020,1,6,12,1750,1719,1381,-338
2020,1,6,13,1840,1827,1434,-393
2020,1,6,14,2012,2010,1587,-423
2020,1,6,15,2156,2146,1602,-544
2020,1,6,16,2231,2150,1584,-566
2020,1,6,17,2203,2122,1499,-623
2020,1,6,18,2148,2073,1346,-727
2020,1,6,19,2083,2027,1419,-608
2020,1,6,20,2022,2000,1420,-580
2020,1,6,21,1984,1995,1384,-611
2020,1,6,22,1990,1979,1263,-716
2020,1,6,23,2023,1992,1293,-699
2020,1,7,0,2080,2034,1410,-624
2020,1,7,1,2208,2130,1486,-644
2020,1,7,2,2237,2152,1467,-685
2020,1,7,3,2175,2098,1428,-670
2020,1,7,4,2113,2040,1399,-641
2020,1,7,5,2020,1951,1405,-546
2020,1,7,6,1888,1812,1388,-424
2020,1,7,7,1774,1697,1350,-347
2020,1,7,8,1691,1637,1324,-313
2020,1,7,9,1663,1610,1079,-531
2020,1,7,10,1653,1599,1085,-514
2020,1,7,11,1667,1611,1091,-520
2020,1,7,12,1700,1649,1121,-528
2020,1,7,13,1793,1759,1172,-587
2020,1,7,14,1960,1946,1283,-663
2020,1,7,15,2088,2089,1378,-711
2020,1,7,16,2133,2090,1404,-686
2020,1,7,17,2120,2017,1441,-576
2020,1,7,18,2079,1922,1412,-510
2020,1,7,19,1992,1859,1342,-517
2020,1,7,20,1864,1834,1353,-481
2020,1,7,21,1818,1779,1431,-348
2020,1,7,22,1831,1748,1456,-292
2020,1,7,23,1830,1743,1406,-337
2020,1,8,0,1876,1804,1403,-401
2020,1,8,1,1994,1949,1504,-445
2020,1,8,2,2046,1985,1464,-521
2020,1,8,3,2008,1986,1455,-531
2020,1,8,4,1981,1920,1432,-488
2020,1,8,5,1920,1852,1304,-548
2020,1,8,6,1807,1731,1275,-456
2020,1,8,7,1704,1639,1231,-408
2020,1,8,8,1676,1576,1162,-414
2020,1,8,9,1663,1554,1120,-434
2020,1,8,10,1614,1551,1004,-547
2020,1,8,11,1611,1572,959,-613
2020,1,8,12,1651,1606,1015,-591
2020,1,8,13,1760,1715,1133,-582
2020,1,8,14,1940,1917,1419,-498
2020,1,8,15,2067,2042,1439,-603
2020,1,8,16,2117,2048,1541,-507
2020,1,8,17,2087,2011,1472,-539
2020,1,8,18,2021,1942,1423,-519
2020,1,8,19,1969,1896,1475,-421
2020,1,8,20,1956,1880,1494,-386
2020,1,8,21,1908,1881,1388,-493
2020,1,8,22,1874,1831,1363,-468
2020,1,8,23,1907,1838,1441,-397
2020,1,9,0,1966,1892,1449,-443
2020,1,9,1,2091,2009,1559,-450
2020,1,9,2,2141,2074,1545,-529
2020,1,9,3,2094,2041,1465,-576
2020,1,9,4,2036,1961,1408,-553
2020,1,9,5,1960,1884,1418,-466
2020,1,9,6,1845,1777,1321,-456
2020,1,9,7,1728,1683,1290,-393
2020,1,9,8,1731,1624,1219,-405
2020,1,9,9,1673,1602,1164,-438
2020,1,9,10,1650,1592,1080,-512
2020,1,9,11,1671,1597,1097,-500
2020,1,9,12,1714,1638,1130,-508
2020,1,9,13,1809,1760,1371,-389
2020,1,9,14,1993,1926,1489,-437
2020,1,9,15,2115,2063,1599,-464
2020,1,9,16,2138,2077,1617,-460
2020,1,9,17,2116,2054,1641,-413
2020,1,9,18,2054,2028,1644,-384
2020,1,9,19,2022,1962,1738,-224
2020,1,9,20,2008,1918,1690,-228
2020,1,9,21,1968,1902,1734,-168
2020,1,9,22,1944,1885,1658,-227
2020,1,9,23,1958,1921,1661,-260
2020,1,10,0,2009,1937,1756,-181
2020,1,10,1,2130,2088,1902,-186
2020,1,10,2,2172,2132,1918,-214
2020,1,10,3,2148,2118,1834,-284
2020,1,10,4,2128,2080,1784,-296
2020,1,10,5,2060,2005,1667,-338
2020,1,10,6,1944,1880,1453,-427
2020,1,10,7,1836,1774,1405,-369
2020,1,10,8,1791,1721,1316,-405
2020,1,10,9,1744,1697,1141,-556
2020,1,10,10,1746,1699,1072,-627
2020,1,10,11,1771,1702,1050,-652
2020,1,10,12,1818,1752,1025,-727
2020,1,10,13,1925,1888,1158,-730
2020,1,10,14,2133,2077,1219,-858
2020,1,10,15,2289,2226,1385,-841
2020,1,10,16,2292,2251,1536,-715
2020,1,10,17,2232,2207,1429,-778
2020,1,10,18,2163,2137,1465,-672
2020,1,10,19,2101,2099,1424,-675
2020,1,10,20,2080,2057,1360,-697
2020,1,10,21,2092,2036,1333,-703
2020,1,10,22,2077,2029,1360,-669
2020,1,10,23,2089,2034,1424,-610
2020,1,11,0,2141,2072,1561,-511
2020,1,11,1,2244,2137,1653,-484
2020,1,11,2,2249,2155,1618,-537
2020,1,11,3,2169,2103,1582,-521
2020,1,11,4,2099,2047,1467,-580
2020,1,11,5,2022,1963,1461,-502
2020,1,11,6,1928,1860,1303,-557
2020,1,11,7,1820,1771,1199,-572
2020,1,11,8,1716,1707,1160,-547
2020,1,11,9,1683,1674,1114,-560
2020,1,11,10,1706,1645,1004,-641
2020,1,11,11,1718,1648,1042,-606
2020,1,11,12,1736,1662,1093,-569
2020,1,11,13,1791,1713,1054,-659
2020,1,11,14,1871,1781,1069,-712
2020,1,11,15,1943,1864,1075,-789
2020,1,11,16,1989,1941,1064,-877
2020,1,11,17,1997,1991,1072,-919
2020,1,11,18,1980,2007,1242,-765
2020,1,11,19,1991,1993,1190,-803
2020,1,11,20,1987,1971,1216,-755
2020,1,11,21,1964,1926,1225,-701
2020,1,11,22,1968,1874,1249,-625
2020,1,11,23,1955,1848,1276,-572
2020,1,12,0,1959,1863,1327,-536
2020,1,12,1,2052,1960,1292,-668
2020,1,12,2,2071,2007,1249,-758
2020,1,12,3,2034,1966,1296,-670
2020,1,12,4,2008,1922,1376,-546
2020,1,12,5,1937,1878,1256,-622
2020,1,12,6,1858,1772,1183,-589
2020,1,12,7,1771,1698,1161,-537
2020,1,12,8,1737,1648,1136,-512
2020,1,12,9,1728,1608,1149,-459
2020,1,12,10,1659,1598,1102,-496
2020,1,12,11,1649,1602,1064,-538
2020,1,12,12,1672,1623,1086,-537
2020,1,12,13,1729,1676,1061,-615
2020,1,12,14,1789,1759,1096,-663
2020,1,12,15,1886,1848,1171,-677
2020,1,12,16,1976,1918,1192,-726
2020,1,12,17,1994,1955,1168,-787
2020,1,12,18,1981,1967,1288,-679
2020,1,12,19,1958,1950,1180,-770
2020,1,12,20,1961,1947,1249,-698
2020,1,12,21,1955,1900,1235,-665
2020,1,12,22,1925,1881,1297,-584
2020,1,12,23,1924,1903,1230,-673
2020,1,13,0,1971,1955,1244,-711
2020,1,13,1,2092,2038,1208,-830
2020,1,13,2,2138,2096,1209,-887
2020,1,13,3,2108,2042,1256,-786
2020,1,13,4,2061,2008,1393,-615
2020,1,13,5,1970,1912,1448,-464
2020,1,13,6,1855,1786,1428,-358
2020,1,13,7,1753,1688,1406,-282
2020,1,13,8,1696,1632,1349,-283
2020,1,13,9,1664,1607,1347,-260
2020,1,13,10,1675,1607,1359,-248
2020,1,13,11,1694,1614,1299,-315
2020,1,13,12,1740,1679,1418,-261
2020,1,13,13,1858,1813,1480,-333
2020,1,13,14,2046,2004,1507,-497
2020,1,13,15,2196,2140,1567,-573
2020,1,13,16,2236,2160,1639,-521
2020,1,13,17,2192,2138,1493,-645
2020,1,13,18,2139,2106,1339,-767
2020,1,13,19,2117,2058,1309,-749
2020,1,13,20,2095,2016,1283,-733
2020,1,13,21,2047,1995,1229,-766
2020,1,13,22,2023,1980,1240,-740
2020,1,13,23,2038,1996,1251,-745
2020,1,14,0,2078,2045,1323,-722
2020,1,14,1,2201,2146,1511,-635
2020,1,14,2,2251,2178,1585,-593
2020,1,14,3,2191,2142,1705,-437
2020,1,14,4,2130,2090,1631,-459
2020,1,14,5,2028,2007,1476,-531
2020,1,14,6,1900,1891,1409,-482
2020,1,14,7,1794,1784,1222,-562
2020,1,14,8,1715,1718,1129,-589
2020,1,14,9,1692,1675,988,-687
2020,1,14,10,1697,1660,898,-762
2020,1,14,11,1704,1660,899,-761
2020,1,14,12,1750,1710,981,-729
2020,1,14,13,1875,1828,1092,-736
2020,1,14,14,2060,2007,1316,-691
2020,1,14,15,2212,2134,1631,-503
2020,1,14,16,2222,2148,1576,-572
2020,1,14,17,2175,2124,1421,-703
2020,1,14,18,2134,2084,1247,-837
2020,1,14,19,2097,2016,1275,-741
2020,1,14,20,2056,1962,1311,-651
2020,1,14,21,1993,1958,1287,-671
2020,1,14,22,1966,1977,1173,-804
2020,1,14,23,2010,1970,1201,-769
2020,1,15,0,2073,2006,1348,-658
2020,1,15,1,2172,2110,1573,-537
2020,1,15,2,2206,2185,1568,-617
2020,1,15,3,2167,2169,1551,-618
2020,1,15,4,2160,2133,1536,-597
2020,1,15,5,2098,2033,1458,-575
2020,1,15,6,1978,1912,1370,-542
2020,1,15,7,1867,1811,1242,-569
2020,1,15,8,1830,1761,1120,-641
2020,1,15,9,1816,1750,983,-767
2020,1,15,10,1803,1761,1054,-707
2020,1,15,11,1825,1791,1050,-741
2020,1,15,12,1876,1852,1097,-755
2020,1,15,13,2021,1978,1149,-829
2020,1,15,14,2207,2167,1317,-850
2020,1,15,15,2333,2319,1593,-726
2020,1,15,16,2346,2322,1652,-670
2020,1,15,17,2301,2277,1548,-729
2020,1,15,18,2244,2188,1647,-541
2020,1,15,19,2164,2096,1614,-482
2020,1,15,20,2089,2033,1512,-521
2020,1,15,21,2049,1998,1567,-431
2020,1,15,22,2033,1977,1603,-374
2020,1,15,23,2014,1986,1551,-435
2020,1,16,0,2045,2065,1521,-544
2020,1,16,1,2162,2187,1648,-539
2020,1,16,2,2266,2247,1684,-563
2020,1,16,3,2250,2215,1739,-476
2020,1,16,4,2193,2176,1733,-443
2020,1,16,5,2106,2082,1744,-338
2020,1,16,6,1981,1949,1621,-328
2020,1,16,7,1881,1840,1516,-324
2020,1,16,8,1773,1774,1478,-296
2020,1,16,9,1746,1752,1397,-355
2020,1,16,10,1772,1722,1375,-347
2020,1,16,11,1770,1740,1278,-462
2020,1,16,12,1800,1760,1312,-448
2020,1,16,13,1908,1871,1298,-573
2020,1,16,14,2062,2054,1535,-519
2020,1,16,15,2176,2174,1585,-589
2020,1,16,16,2173,2179,1602,-577
2020,1,16,17,2108,2148,1654,-494
2020,1,16,18,2066,2106,1702,-404
2020,1,16,19,2024,2047,1804,-243
2020,1,16,20,2000,1985,1740,-245
2020,1,16,21,2001,1944,1535,-409
2020,1,16,22,1984,1919,1650,-269
2020,1,16,23,1968,1914,1631,-283
2020,1,17,0,2003,1924,1758,-166
2020,1,17,1,2100,1993,1686,-307
2020,1,17,2,2129,2035,1628,-407
2020,1,17,3,2081,2014,1580,-434
2020,1,17,4,2047,1962,1421,-541
2020,1,17,5,1967,1885,1334,-551
2020,1,17,6,1848,1777,1258,-519
2020,1,17,7,1750,1684,1206,-478
2020,1,17,8,1682,1535,1157,-378
2020,1,17,9,1688,1550,1258,-292
2020,1,17,10,1658,1572,1222,-350
2020,1,17,11,1688,1586,1308,-278
2020,1,17,12,1748,1628,1397,-231
2020,1,17,13,1862,1738,1391,-347
2020,1,17,14,2055,1921,1564,-357
2020,1,17,15,2180,2099,1654,-445
2020,1,17,16,2214,2160,1646,-514
2020,1,17,17,2189,2103,1680,-423
2020,1,17,18,2143,2056,1575,-481
2020,1,17,19,2061,2001,1480,-521
2020,1,17,20,1989,1926,1354,-572
2020,1,17,21,1983,1876,1278,-598
2020,1,17,22,1953,1828,1323,-505
2020,1,17,23,1919,1819,1362,-457
2020,1,18,0,1949,1862,1370,-492
2020,1,18,1,2040,1948,1420,-528
2020,1,18,2,2084,2031,1412,-619
2020,1,18,3,2057,2011,1361,-650
2020,1,18,4,2032,1996,1289,-707
2020,1,18,5,1971,1941,1027,-914
2020,1,18,6,1891,1845,946,-899
2020,1,18,7,1809,1761,949,-812
2020,1,18,8,1828,1696,914,-782
2020,1,18,9,1771,1680,918,-762
2020,1,18,10,1716,1662,923,-739
2020,1,18,11,1721,1671,968,-703
2020,1,18,12,1740,1707,1150,-557
2020,1,18,13,1809,1772,1353,-419
2020,1,18,14,1893,1847,1378,-469
2020,1,18,15,1986,1938,1428,-510
2020,1,18,16,2085,2013,1477,-536
2020,1,18,17,2098,2041,1494,-547
2020,1,18,18,2080,1994,1555,-439
2020,1,18,19,2025,1967,1497,-470
2020,1,18,20,1914,1901,1508,-393
2020,1,18,21,1858,1869,1438,-431
2020,1,18,22,1823,1852,1415,-437
2020,1,18,23,1843,1816,1349,-467
2020,1,19,0,1922,1846,1403,-443
2020,1,19,1,2056,1938,1523,-415
2020,1,19,2,2132,1992,1491,-501
2020,1,19,3,2076,1963,1411,-552
2020,1,19,4,2038,1932,1422,-510
2020,1,19,5,1973,1874,1246,-628
2020,1,19,6,1895,1796,1148,-648
2020,1,19,7,1831,1720,1130,-590
2020,1,19,8,1826,1678,1168,-510
2020,1,19,9,1799,1667,1194,-473
2020,1,19,10,1754,1668,1268,-400
2020,1,19,11,1764,1678,1269,-409
2020,1,19,12,1788,1704,1305,-399
2020,1,19,13,1843,1762,1341,-421
2020,1,19,14,1909,1843,1397,-446
2020,1,19,15,1990,1957,1425,-532
2020,1,19,16,2107,2039,1473,-566
2020,1,19,17,2134,2003,1560,-443
2020,1,19,18,2075,1955,1614,-341
2020,1,19,19,1981,1895,1591,-304
2020,1,19,20,1918,1857,1535,-322
2020,1,19,21,1854,1777,1558,-219
2020,1,19,22,1815,1740,1621,-119
2020,1,19,23,1804,1735,1651,-84
2020,1,20,0,1858,1774,1589,-185
2020,1,20,1,1993,1914,1597,-317
2020,1,20,2,2079,2016,1777,-239
2020,1,20,3,2074,2003,1567,-436
2020,1,20,4,2062,1979,1560,-419
2020,1,20,5,2005,1918,1431,-487
2020,1,20,6,1897,1831,1450,-381
2020,1,20,7,1801,1741,1445,-296
2020,1,20,8,1783,1658,1398,-260
2020,1,20,9,1757,1632,1375,-257
2020,1,20,10,1745,1637,1385,-252
2020,1,20,11,1749,1649,1390,-259
2020,1,20,12,1794,1714,1436,-278
2020,1,20,13,1915,1795,1432,-363
2020,1,20,14,2087,1940,1404,-536
2020,1,20,15,2179,2078,1451,-627
2020,1,20,16,2180,2135,1472,-663
2020,1,20,17,2118,2149,1488,-661
2020,1,20,18,2065,2128,1570,-558
2020,1,20,19,2060,2111,1552,-559
2020,1,20,20,2054,2051,1545,-506
2020,1,20,21,2049,2001,1550,-451
2020,1,20,22,2023,1960,1561,-399
2020,1,20,23,2000,1957,1494,-463
2020,1,21,0,2034,1993,1594,-399
2020,1,21,1,2161,2062,1662,-400
2020,1,21,2,2211,2097,1604,-493
2020,1,21,3,2145,2056,1586,-470
2020,1,21,4,2068,2007,1549,-458
2020,1,21,5,1972,1909,1499,-410
2020,1,21,6,1857,1773,1377,-396
2020,1,21,7,1748,1667,1276,-391
2020,1,21,8,1701,1582,1247,-335
2020,1,21,9,1693,1556,1256,-300
2020,1,21,10,1631,1538,1246,-292
2020,1,21,11,1622,1559,1268,-291
2020,1,21,12,1654,1605,1322,-283
2020,1,21,13,1757,1706,1313,-393
2020,1,21,14,1914,1877,1330,-547
2020,1,21,15,2041,2015,1422,-593
2020,1,21,16,2078,2026,1379,-647
2020,1,21,17,2050,1986,1432,-554
2020,1,21,18,2016,1959,1337,-622
2020,1,21,19,1971,1910,1278,-632
2020,1,21,20,1926,1870,1261,-609
2020,1,21,21,1889,1844,1237,-607
2020,1,21,22,1885,1809,1176,-633
2020,1,21,23,1903,1806,1171,-635
2020,1,22,0,1941,1856,1351,-505
2020,1,22,1,2037,1947,1433,-514
2020,1,22,2,2089,1987,1452,-535
2020,1,22,3,2033,1973,1421,-552
2020,1,22,4,1984,1935,1478,-457
2020,1,22,5,1915,1852,1477,-375
2020,1,22,6,1803,1719,1309,-410
2020,1,22,7,1709,1638,1237,-401
2020,1,22,8,1673,1592,1311,-281
2020,1,22,9,1643,1575,1372,-203
2020,1,22,10,1632,1579,1371,-208
2020,1,22,11,1658,1585,1364,-221
2020,1,22,12,1710,1634,1362,-272
2020,1,22,13,1817,1728,1444,-284
2020,1,22,14,1993,1946,1511,-435
2020,1,22,15,2132,2083,1482,-601
2020,1,22,16,2147,2097,1429,-668
2020,1,22,17,2103,2054,1289,-765
2020,1,22,18,2059,1992,1187,-805
2020,1,22,19,1994,1930,1139,-791
2020,1,22,20,1947,1862,1121,-741
2020,1,22,21,1901,1811,1190,-621
2020,1,22,22,1860,1764,1212,-552
2020,1,22,23,1843,1784,1241,-543
2020,1,23,0,1868,1843,1332,-511
2020,1,23,1,1986,1943,1480,-463
2020,1,23,2,2066,2002,1454,-548
2020,1,23,3,2047,1985,1504,-481
2020,1,23,4,2000,1944,1506,-438
2020,1,23,5,1908,1851,1461,-390
2020,1,23,6,1791,1731,1353,-378
2020,1,23,7,1684,1578,1052,-526
2020,1,23,8,1643,1511,962,-549
2020,1,23,9,1608,1470,1105,-365
2020,1,23,10,1567,1461,1115,-346
2020,1,23,11,1577,1512,1087,-425
2020,1,23,12,1621,1563,1153,-410
2020,1,23,13,1719,1663,1163,-500
2020,1,23,14,1900,1871,1376,-495
2020,1,23,15,2019,1994,1518,-476
2020,1,23,16,2037,2001,1497,-504
2020,1,23,17,2007,1964,1337,-627
2020,1,23,18,1968,1920,1247,-673
2020,1,23,19,1924,1869,1302,-567
2020,1,23,20,1872,1821,1114,-707
2020,1,23,21,1749,1766,1121,-645
2020,1,23,22,1716,1715,1171,-544
2020,1,23,23,1715,1682,1235,-447
2020,1,24,0,1728,1732,1296,-436
2020,1,24,1,1827,1830,1468,-362
2020,1,24,2,1887,1934,1604,-330
2020,1,24,3,1934,1913,1669,-244
2020,1,24,4,1912,1887,1696,-191
2020,1,24,5,1840,1804,1725,-79
2020,1,24,6,1731,1656,1522,-134
2020,1,24,7,1637,1602,1228,-374
2020,1,24,8,1643,1534,1230,-304
2020,1,24,9,1608,1512,1244,-268
2020,1,24,10,1575,1496,1316,-180
2020,1,24,11,1582,1505,1301,-204
2020,1,24,12,1629,1559,1228,-331
2020,1,24,13,1747,1645,1090,-555
2020,1,24,14,1929,1811,1263,-548
2020,1,24,15,2021,1965,1360,-605
2020,1,24,16,2012,1995,1387,-608
2020,1,24,17,1987,1985,1402,-583
2020,1,24,18,1964,1948,1405,-543
2020,1,24,19,1911,1903,1403,-500
2020,1,24,20,1877,1835,1404,-431
2020,1,24,21,1861,1816,1411,-405
2020,1,24,22,1814,1779,1411,-368
2020,1,24,23,1844,1763,1452,-311
2020,1,25,0,1899,1772,1529,-243
2020,1,25,1,1968,1841,1499,-342
2020,1,25,2,1992,1901,1494,-407
2020,1,25,3,1936,1878,1514,-364
2020,1,25,4,1918,1839,1529,-310
2020,1,25,5,1866,1771,1369,-402
2020,1,25,6,1769,1687,1291,-396
2020,1,25,7,1678,1592,1113,-479
2020,1,25,8,1636,1523,1069,-454
2020,1,25,9,1599,1509,1112,-397
2020,1,25,10,1567,1493,1120,-373
2020,1,25,11,1565,1489,1113,-376
2020,1,25,12,1574,1508,1167,-341
2020,1,25,13,1628,1566,1283,-283
2020,1,25,14,1717,1657,1325,-332
2020,1,25,15,1810,1743,1482,-261
2020,1,25,16,1897,1823,1525,-298
2020,1,25,17,1928,1863,1510,-353
2020,1,25,18,1896,1862,1421,-441
2020,1,25,19,1828,1849,1429,-420
2020,1,25,20,1782,1798,1202,-596
2020,1,25,21,1781,1757,1169,-588
2020,1,25,22,1743,1738,1136,-602
2020,1,25,23,1742,1719,1083,-636
2020,1,26,0,1808,1759,1078,-681
2020,1,26,1,1928,1833,1153,-680
2020,1,26,2,1974,1874,1137,-737
2020,1,26,3,1904,1834,1193,-641
2020,1,26,4,1837,1805,1228,-577
2020,1,26,5,1784,1748,1265,-483
2020,1,26,6,1708,1656,1280,-376
2020,1,26,7,1628,1567,1248,-319
2020,1,26,8,1544,1513,1290,-223
2020,1,26,9,1512,1479,1307,-172
2020,1,26,10,1526,1464,1268,-196
2020,1,26,11,1530,1448,1240,-208
2020,1,26,12,1536,1470,1274,-196
2020,1,26,13,1577,1509,1253,-256
2020,1,26,14,1642,1582,1292,-290
2020,1,26,15,1723,1671,1337,-334
2020,1,26,16,1783,1756,1359,-397
2020,1,26,17,1799,1802,1304,-498
2020,1,26,18,1811,1810,1233,-577
2020,1,26,19,1800,1808,1185,-623
2020,1,26,20,1785,1785,1160,-625
2020,1,26,21,1792,1768,1095,-673
2020,1,26,22,1788,1748,1120,-628
2020,1,26,23,1819,1771,1228,-543
2020,1,27,0,1866,1810,1227,-583
2020,1,27,1,1971,1881,1550,-331
2020,1,27,2,2026,1921,1762,-159
2020,1,27,3,1980,1903,1691,-212
2020,1,27,4,1926,1847,1574,-273
2020,1,27,5,1852,1785,1740,-45
2020,1,27,6,1730,1655,1388,-267
2020,1,27,7,1624,1556,1318,-238
2020,1,27,8,1559,1513,1330,-183
2020,1,27,9,1555,1481,1301,-180
2020,1,27,10,1538,1492,1255,-237
2020,1,27,11,1552,1507,1184,-323
2020,1,27,12,1603,1560,1246,-314
2020,1,27,13,1712,1678,1259,-419
2020,1,27,14,1889,1870,1419,-451
2020,1,27,15,2028,2000,1462,-538
2020,1,27,16,2094,2004,1464,-540
2020,1,27,17,2069,1963,1336,-627
2020,1,27,18,2003,1906,1313,-593
2020,1,27,19,1928,1848,1345,-503
2020,1,27,20,1865,1793,1440,-353
2020,1,27,21,1835,1749,1369,-380
2020,1,27,22,1784,1712,1358,-354
2020,1,27,23,1789,1736,1508,-228
2020,1,28,0,1830,1758,1362,-396
2020,1,28,1,1939,1868,1327,-541
2020,1,28,2,1997,1954,1359,-595
2020,1,28,3,1965,1938,1405,-533
2020,1,28,4,1949,1897,1356,-541
2020,1,28,5,1883,1834,1263,-571
2020,1,28,6,1761,1704,1119,-585
2020,1,28,7,1647,1594,1018,-576
2020,1,28,8,1586,1513,1012,-501
2020,1,28,9,1545,1480,1055,-425
2020,1,28,10,1545,1471,1101,-370
2020,1,28,11,1556,1475,1115,-360
2020,1,28,12,1595,1529,1152,-377
2020,1,28,13,1702,1636,1282,-354
2020,1,28,14,1882,1842,1352,-490
2020,1,28,15,2021,1937,1485,-452
2020,1,28,16,2007,1962,1459,-503
2020,1,28,17,1963,1948,1405,-543
2020,1,28,18,1943,1924,1431,-493
2020,1,28,19,1911,1884,1432,-452
2020,1,28,20,1879,1842,1514,-328
2020,1,28,21,1878,1831,1513,-318
2020,1,28,22,1872,1847,1452,-395
2020,1,28,23,1894,1791,1400,-391
2020,1,29,0,1939,1847,1549,-298
2020,1,29,1,1993,1913,1657,-256
2020,1,29,2,2057,1980,1683,-297
2020,1,29,3,2042,1959,1594,-365
2020,1,29,4,1993,1949,1531,-418
2020,1,29,5,1907,1867,1566,-301
2020,1,29,6,1786,1732,1459,-273
2020,1,29,7,1672,1608,1314,-294
2020,1,29,8,1621,1560,1319,-241
2020,1,29,9,1610,1551,1299,-252
2020,1,29,10,1602,1541,1281,-260
2020,1,29,11,1618,1557,1264,-293
2020,1,29,12,1671,1622,1294,-328
2020,1,29,13,1784,1705,1358,-347
2020,1,29,14,1983,1876,1450,-426
2020,1,29,15,2117,2061,1525,-536
2020,1,29,16,2114,2065,1617,-448
2020,1,29,17,2080,2023,1668,-355
2020,1,29,18,2049,1945,1558,-387
2020,1,29,19,1983,1892,1495,-397
2020,1,29,20,1904,1817,1373,-444
2020,1,29,21,1867,1808,1393,-415
2020,1,29,22,1834,1791,1355,-436
2020,1,29,23,1824,1808,1318,-490
2020,1,30,0,1873,1843,1449,-394
2020,1,30,1,1992,1925,1499,-426
2020,1,30,2,2059,1997,1587,-410
2020,1,30,3,2016,1976,1579,-397
2020,1,30,4,1987,1938,1534,-404
2020,1,30,5,1902,1840,1516,-324
2020,1,30,6,1777,1702,1257,-445
2020,1,30,7,1670,1603,1159,-444
2020,1,30,8,1610,1540,1051,-489
2020,1,30,9,1580,1507,1146,-361
2020,1,30,10,1571,1505,1160,-345
2020,1,30,11,1586,1514,1241,-273
2020,1,30,12,1621,1572,1467,-105
2020,1,30,13,1721,1660,1654,-6
2020,1,30,14,1904,1857,1693,-164
2020,1,30,15,2035,2007,1886,-121
2020,1,30,16,2049,2006,1871,-135
2020,1,30,17,2013,1986,1681,-305
2020,1,30,18,1978,1956,1590,-366
2020,1,30,19,1950,1916,1358,-558
2020,1,30,20,1911,1891,1326,-565
2020,1,30,21,1907,1848,1341,-507
2020,1,30,22,1896,1797,1353,-444
2020,1,30,23,1866,1772,1402,-370
2020,1,31,0,1886,1819,1462,-357
2020,1,31,1,1967,1900,1549,-351
2020,1,31,2,2054,1970,1614,-356
2020,1,31,3,2015,1978,1641,-337
2020,1,31,4,2002,1966,1625,-341
2020,1,31,5,1936,1901,1472,-429
2020,1,31,6,1810,1755,1271,-484
2020,1,31,7,1697,1681,1350,-331
2020,1,31,8,1653,1584,1197,-387
2020,1,31,9,1619,1571,1184,-387
2020,1,31,10,1615,1552,1179,-373
2020,1,31,11,1620,1559,1168,-391
2020,1,31,12,1660,1596,1184,-412
2020,1,31,13,1765,1684,1347,-337
2020,1,31,14,1950,1867,1498,-369
2020,1,31,15,2070,2009,1571,-438
2020,1,31,16,2047,2011,1594,-417
2020,1,31,17,2001,2001,1543,-458
2020,1,31,18,1952,1960,1513,-447
2020,1,31,19,1924,1910,1491,-419
2020,1,31,20,1896,1839,1416,-423
2020,1,31,21,1879,1806,1369,-437
2020,1,31,22,1836,1765,1401,-364
2020,1,31,23,1816,1733,1578,-155
2020,2,1,0,1850,1777,1571,-206
2020,2,1,1,1891,1835,1567,-268
2020,2,1,2,1953,1908,1611,-297
2020,2,1,3,1936,1889,1646,-243
2020,2,1,4,1895,1849,1653,-196
2020,2,1,5,1838,1818,1664,-154
2020,2,1,6,1757,1722,1467,-255
2020,2,1,7,1680,1630,1326,-304
2020,2,1,8,1574,1541,1207,-334
2020,2,1,9,1547,1535,1213,-322
2020,2,1,10,1568,1535,1257,-278
2020,2,1,11,1577,1538,1252,-286
2020,2,1,12,1618,1573,1242,-331
2020,2,1,13,1684,1625,1294,-331
2020,2,1,14,1772,1731,1504,-227
2020,2,1,15,1869,1830,1684,-146
2020,2,1,16,1931,1898,1672,-226
2020,2,1,17,1944,1916,1618,-298
2020,2,1,18,1914,1880,1622,-258
2020,2,1,19,1896,1834,1554,-280
2020,2,1,20,1817,1773,1369,-404
2020,2,1,21,1752,1731,1311,-420
2020,2,1,22,1700,1699,1298,-401
2020,2,1,23,1700,1690,1333,-357
2020,2,2,0,1732,1703,1331,-372
2020,2,2,1,1818,1786,1540,-246
2020,2,2,2,1887,1879,1694,-185
2020,2,2,3,1877,1852,1678,-174
2020,2,2,4,1865,1819,1601,-218
2020,2,2,5,1807,1766,1497,-269
2020,2,2,6,1719,1686,1392,-294
2020,2,2,7,1648,1593,1233,-360
2020,2,2,8,1508,1543,1126,-417
2020,2,2,9,1505,1497,1179,-318
2020,2,2,10,1579,1488,1223,-265
2020,2,2,11,1562,1487,1371,-116
2020,2,2,12,1571,1496,1575,79
2020,2,2,13,1630,1564,1626,62
2020,2,2,14,1698,1634,1632,-2
2020,2,2,15,1815,1749,1756,7
2020,2,2,16,1875,1850,1741,-109
2020,2,2,17,1916,1907,1661,-246
2020,2,2,18,1903,1942,1718,-224
2020,2,2,19,1921,1946,1734,-212
2020,2,2,20,1952,1950,1707,-243
2020,2,2,21,1966,1969,1621,-348
2020,2,2,22,1985,1969,1615,-354
2020,2,2,23,2024,1966,1684,-282
2020,2,3,0,2068,1941,1839,-102
2020,2,3,1,2141,1948,1895,-53
2020,2,3,2,2173,2038,2087,49
2020,2,3,3,2090,2048,1939,-109
2020,2,3,4,2054,2058,1833,-225
2020,2,3,5,1995,2044,1745,-299
2020,2,3,6,1917,1926,1688,-238
2020,2,3,7,1865,1830,1609,-221
2020,2,3,8,1718,1780,1695,-85
2020,2,3,9,1727,1765,1773,8
2020,2,3,10,1797,1775,1798,23
2020,2,3,11,1823,1790,1791,1
2020,2,3,12,1871,1850,1735,-115
2020,2,3,13,2021,1966,1696,-270
2020,2,3,14,2232,2159,1807,-352
2020,2,3,15,2376,2304,1830,-474
2020,2,3,16,2370,2290,1800,-490
2020,2,3,17,2306,2237,1824,-413
2020,2,3,18,2239,2175,1756,-419
2020,2,3,19,2192,2118,1677,-441
2020,2,3,20,2150,2055,1591,-464
2020,2,3,21,2114,2027,1607,-420
2020,2,3,22,2070,1990,1670,-320
2020,2,3,23,2030,1976,1740,-236
2020,2,4,0,2038,2000,1859,-141
2020,2,4,1,2117,2077,1815,-262
2020,2,4,2,2228,2225,1869,-356
2020,2,4,3,2242,2228,1855,-373
2020,2,4,4,2258,2187,1835,-352
2020,2,4,5,2207,2116,1825,-291
2020,2,4,6,2062,1986,1660,-326
2020,2,4,7,1931,1874,1611,-263
2020,2,4,8,1834,1827,1496,-331
2020,2,4,9,1893,1826,1802,-24
2020,2,4,10,1875,1835,1754,-81
2020,2,4,11,1905,1859,1637,-222
2020,2,4,12,1965,1914,1566,-348
2020,2,4,13,2104,2041,1594,-447
2020,2,4,14,2330,2262,1730,-532
2020,2,4,15,2484,2407,1848,-559
2020,2,4,16,2480,2375,1907,-468
2020,2,4,17,2401,2273,1859,-414
2020,2,4,18,2311,2184,1803,-381
2020,2,4,19,2215,2093,1753,-340
2020,2,4,20,2106,2019,1632,-387
2020,2,4,21,2059,1973,1626,-347
2020,2,4,22,2024,1935,1603,-332
2020,2,4,23,2007,1937,1720,-217
2020,2,5,0,2044,1984,1851,-133
2020,2,5,1,2148,2114,2091,-23
2020,2,5,2,2301,2212,2081,-131
2020,2,5,3,2287,2201,2118,-83
2020,2,5,4,2226,2159,2105,-54
2020,2,5,5,2148,2078,2055,-23
2020,2,5,6,2007,1937,1943,6
2020,2,5,7,1886,1824,1752,-72
2020,2,5,8,1852,1762,1666,-96
2020,2,5,9,1830,1721,1408,-313
2020,2,5,10,1807,1725,1349,-376
2020,2,5,11,1810,1726,1373,-353
2020,2,5,12,1849,1777,1541,-236
2020,2,5,13,1963,1891,1554,-337
2020,2,5,14,2163,2096,1768,-328
2020,2,5,15,2303,2215,1737,-478
2020,2,5,16,2273,2204,1808,-396
2020,2,5,17,2195,2185,1630,-555
2020,2,5,18,2146,2156,1633,-523
2020,2,5,19,2138,2114,1555,-559
2020,2,5,20,2119,2056,1530,-526
2020,2,5,21,2109,2042,1530,-512
2020,2,5,22,2086,2028,1469,-559
2020,2,5,23,2070,2028,1544,-484
2020,2,6,0,2097,2071,1561,-510
2020,2,6,1,2182,2129,1635,-494
2020,2,6,2,2264,2200,1688,-512
2020,2,6,3,2220,2165,1724,-441
2020,2,6,4,2136,2099,1698,-401
2020,2,6,5,2063,2017,1574,-443
2020,2,6,6,1929,1860,1329,-531
2020,2,6,7,1819,1750,1208,-542
2020,2,6,8,1714,1679,1148,-531
2020,2,6,9,1713,1656,1178,-478
2020,2,6,10,1708,1644,1174,-470
2020,2,6,11,1708,1645,1229,-416
2020,2,6,12,1731,1683,1330,-353
2020,2,6,13,1833,1789,1481,-308
2020,2,6,14,2004,1968,1623,-345
2020,2,6,15,2114,2079,1660,-419
2020,2,6,16,2094,2072,1830,-242
2020,2,6,17,2034,2034,1754,-280
2020,2,6,18,2024,2003,1784,-219
2020,2,6,19,2000,1968,1807,-161
2020,2,6,20,1979,1916,1808,-108
2020,2,6,21,1983,1893,1758,-135
2020,2,6,22,1968,1860,1726,-134
2020,2,6,23,1942,1854,1664,-190
2020,2,7,0,1956,1885,1623,-262
2020,2,7,1,2032,1939,1795,-144
2020,2,7,2,2105,1995,1793,-202
2020,2,7,3,2062,1974,1847,-127
2020,2,7,4,1981,1924,1839,-85
2020,2,7,5,1903,1838,1665,-173
2020,2,7,6,1782,1717,1657,-60
2020,2,7,7,1676,1599,1527,-72
2020,2,7,8,1627,1514,1530,16
2020,2,7,9,1618,1440,1464,24
2020,2,7,10,1572,1511,1494,-17
2020,2,7,11,1554,1498,1464,-34
2020,2,7,12,1609,1529,1475,-54
2020,2,7,13,1717,1633,1471,-162
2020,2,7,14,1896,1787,1653,-134
2020,2,7,15,2001,1911,1566,-345
2020,2,7,16,2000,1926,1552,-374
2020,2,7,17,1974,1905,1528,-377
2020,2,7,18,1953,1887,1532,-355
2020,2,7,19,1928,1831,1513,-318
2020,2,7,20,1892,1804,1525,-279
2020,2,7,21,1856,1764,1563,-201
2020,2,7,22,1841,1722,1558,-164
2020,2,7,23,1830,1689,1500,-189
2020,2,8,0,1839,1699,1546,-153
2020,2,8,1,1872,1752,1443,-309
2020,2,8,2,1935,1830,1450,-380
2020,2,8,3,1899,1815,1491,-324
2020,2,8,4,1872,1779,1531,-248
2020,2,8,5,1827,1734,1519,-215
2020,2,8,6,1741,1653,1514,-139
2020,2,8,7,1652,1568,1268,-300
2020,2,8,8,1650,1518,1287,-231
2020,2,8,9,1611,1489,1261,-228
2020,2,8,10,1577,1476,1221,-255
2020,2,8,11,1596,1483,1287,-196
2020,2,8,12,1587,1509,1319,-190
2020,2,8,13,1639,1568,1420,-148
2020,2,8,14,1757,1660,1670,10
2020,2,8,15,1845,1753,1713,-40
2020,2,8,16,1921,1828,1713,-115
2020,2,8,17,1970,1863,1521,-342
2020,2,8,18,1962,1889,1392,-497
2020,2,8,19,1943,1855,1387,-468
2020,2,8,20,1884,1823,1341,-482
2020,2,8,21,1834,1778,1299,-479
2020,2,8,22,1822,1753,1359,-394
2020,2,8,23,1786,1739,1378,-361
2020,2,9,0,1816,1788,1561,-227
2020,2,9,1,1942,1870,1679,-191
2020,2,9,2,2044,1941,1784,-157
2020,2,9,3,2021,1940,1804,-136
2020,2,9,4,1989,1897,1708,-189
2020,2,9,5,1925,1844,1694,-150
2020,2,9,6,1846,1772,1666,-106
2020,2,9,7,1771,1696,1459,-237
2020,2,9,8,1768,1642,1392,-250
2020,2,9,9,1722,1616,1211,-405
2020,2,9,10,1667,1611,1089,-522
2020,2,9,11,1690,1618,1084,-534
2020,2,9,12,1715,1640,1185,-455
2020,2,9,13,1770,1692,1210,-482
2020,2,9,14,1844,1783,1254,-529
2020,2,9,15,1967,1874,1223,-651
2020,2,9,16,2042,1952,1468,-484
2020,2,9,17,2069,1938,1632,-306
2020,2,9,18,2039,1881,1450,-431
2020,2,9,19,1945,1826,1243,-583
2020,2,9,20,1852,1750,1203,-547
2020,2,9,21,1804,1711,1069,-642
2020,2,9,22,1763,1674,1085,-589
2020,2,9,23,1754,1660,1208,-452
2020,2,10,0,1799,1706,1324,-382
2020,2,10,1,1888,1801,1457,-344
2020,2,10,2,1988,1939,1749,-190
2020,2,10,3,1997,1973,1922,-51
2020,2,10,4,2022,1957,1910,-47
2020,2,10,5,1990,1895,1716,-179
2020,2,10,6,1883,1789,1703,-86
2020,2,10,7,1771,1686,1577,-109
2020,2,10,8,1747,1639,1456,-183
2020,2,10,9,1710,1622,1306,-316
2020,2,10,10,1703,1643,1318,-325
2020,2,10,11,1742,1657,1313,-344
2020,2,10,12,1786,1733,1412,-321
2020,2,10,13,1917,1865,1561,-304
2020,2,10,14,2121,2077,1722,-355
2020,2,10,15,2277,2216,1752,-464
2020,2,10,16,2304,2189,1849,-340
2020,2,10,17,2207,2124,1949,-175
2020,2,10,18,2113,2060,1964,-96
2020,2,10,19,2036,1967,1853,-114
2020,2,10,20,1972,1912,1643,-269
2020,2,10,21,1913,1865,1671,-194
2020,2,10,22,1871,1826,1854,28
2020,2,10,23,1875,1808,1819,11
2020,2,11,0,1934,1830,1806,-24
2020,2,11,1,2022,1919,1906,-13
2020,2,11,2,2116,2033,1869,-164
2020,2,11,3,2105,2054,1807,-247
2020,2,11,4,2118,2038,1782,-256
2020,2,11,5,2052,1964,1737,-227
2020,2,11,6,1937,1862,1704,-158
2020,2,11,7,1825,1764,1649,-115
2020,2,11,8,1769,1719,1423,-296
2020,2,11,9,1752,1709,1349,-360
2020,2,11,10,1797,1716,1255,-461
2020,2,11,11,1814,1751,1273,-478
2020,2,11,12,1871,1807,1398,-409
2020,2,11,13,2008,1933,1504,-429
2020,2,11,14,2230,2154,1737,-417
2020,2,11,15,2363,2282,1726,-556
2020,2,11,16,2316,2233,1668,-565
2020,2,11,17,2225,2156,1497,-659
2020,2,11,18,2148,2079,1466,-613
2020,2,11,19,2060,1977,1567,-410
2020,2,11,20,1995,1890,1545,-345
2020,2,11,21,1920,1824,1594,-230
2020,2,11,22,1879,1786,1652,-134
2020,2,11,23,1842,1751,1474,-277
2020,2,12,0,1866,1777,1737,-40
2020,2,12,1,1941,1864,1905,41
2020,2,12,2,2088,1998,1859,-139
2020,2,12,3,2092,2032,1922,-110
2020,2,12,4,2057,2013,1915,-98
2020,2,12,5,2002,1939,1867,-72
2020,2,12,6,1918,1812,1795,-17
2020,2,12,7,1818,1700,1539,-161
2020,2,12,8,1697,1643,1505,-138
2020,2,12,9,1706,1627,1279,-348
2020,2,12,10,1731,1632,1241,-391
2020,2,12,11,1751,1643,1107,-536
2020,2,12,12,1809,1696,1226,-470
2020,2,12,13,1936,1831,1384,-447
2020,2,12,14,2151,2043,1633,-410
2020,2,12,15,2285,2174,1773,-401
2020,2,12,16,2230,2137,1791,-346
2020,2,12,17,2159,2039,1757,-282
2020,2,12,18,2083,1979,1606,-373
2020,2,12,19,1957,1907,1541,-366
2020,2,12,20,1859,1832,1401,-431
2020,2,12,21,1853,1780,1372,-408
2020,2,12,22,1830,1743,1421,-322
2020,2,12,23,1819,1731,1526,-205
2020,2,13,0,1851,1745,1516,-229
2020,2,13,1,1953,1821,1698,-123
2020,2,13,2,2074,1955,2099,144
2020,2,13,3,2058,1990,1964,-26
2020,2,13,4,2030,1978,1904,-74
2020,2,13,5,1968,1921,1889,-32
2020,2,13,6,1852,1816,1816,0
2020,2,13,7,1767,1709,1645,-64
2020,2,13,8,1735,1671,1505,-166
2020,2,13,9,1729,1643,1239,-404
2020,2,13,10,1730,1661,1230,-431
2020,2,13,11,1754,1683,1287,-396
2020,2,13,12,1827,1746,1360,-386
2020,2,13,13,1947,1873,1518,-355
2020,2,13,14,2155,2092,1673,-419
2020,2,13,15,2287,2226,1773,-453
2020,2,13,16,2211,2179,1653,-526
2020,2,13,17,2112,2069,1735,-334
2020,2,13,18,2051,1987,1719,-268
2020,2,13,19,1973,1885,1644,-241
2020,2,13,20,1886,1813,1473,-340
2020,2,13,21,1833,1745,1345,-400
2020,2,13,22,1788,1709,1365,-344
2020,2,13,23,1766,1682,1410,-272
2020,2,14,0,1806,1707,1429,-278
2020,2,14,1,1901,1766,1510,-256
2020,2,14,2,2033,1910,1749,-161
2020,2,14,3,2024,1951,1710,-241
2020,2,14,4,1997,1950,1657,-293
2020,2,14,5,1962,1886,1589,-297
2020,2,14,6,1847,1765,1389,-376
2020,2,14,7,1724,1664,1324,-340
2020,2,14,8,1680,1599,1294,-305
2020,2,14,9,1660,1575,1290,-285
2020,2,14,10,1630,1580,1379,-201
2020,2,14,11,1670,1603,1408,-195
2020,2,14,12,1734,1641,1438,-203
2020,2,14,13,1871,1751,1483,-268
2020,2,14,14,2028,1931,1565,-366
2020,2,14,15,2101,2056,1628,-428
2020,2,14,16,2065,2050,1847,-203
2020,2,14,17,2009,2005,1970,-35
2020,2,14,18,1994,1957,2086,129
2020,2,14,19,1967,1905,2075,170
2020,2,14,20,1940,1863,2013,150
2020,2,14,21,1905,1831,1903,72
2020,2,14,22,1907,1808,1877,69
2020,2,14,23,1902,1778,1789,11
2020,2,15,0,1925,1795,1840,45
2020,2,15,1,1958,1841,1644,-197
2020,2,15,2,2050,1928,1550,-378
2020,2,15,3,2039,1956,1579,-377
2020,2,15,4,1988,1929,1539,-390
2020,2,15,5,1950,1888,1450,-438
2020,2,15,6,1862,1818,1392,-426
2020,2,15,7,1796,1745,1321,-424
2020,2,15,8,1748,1683,1159,-524
2020,2,15,9,1724,1665,1104,-561
2020,2,15,10,1750,1661,1165,-496
2020,2,15,11,1731,1656,1189,-467
2020,2,15,12,1748,1670,1188,-482
2020,2,15,13,1806,1722,1283,-439
2020,2,15,14,1901,1790,1335,-455
2020,2,15,15,1983,1875,1352,-523
2020,2,15,16,1996,1942,1350,-592
2020,2,15,17,1992,1957,1386,-571
2020,2,15,18,1999,1952,1441,-511
2020,2,15,19,1994,1907,1447,-460
2020,2,15,20,1947,1840,1418,-422
2020,2,15,21,1885,1788,1403,-385
2020,2,15,22,1835,1788,1418,-370
2020,2,15,23,1805,1761,1353,-408
2020,2,16,0,1827,1777,1275,-502
2020,2,16,1,1911,1838,1423,-415
2020,2,16,2,1996,1906,1435,-471
2020,2,16,3,2006,1898,1445,-453
2020,2,16,4,1956,1870,1480,-390
2020,2,16,5,1890,1794,1477,-317
2020,2,16,6,1789,1721,1415,-306
2020,2,16,7,1687,1630,1260,-370
2020,2,16,8,1636,1579,1219,-360
2020,2,16,9,1620,1542,1205,-337
2020,2,16,10,1613,1549,1231,-318
2020,2,16,11,1615,1545,1223,-322
2020,2,16,12,1631,1568,1220,-348
2020,2,16,13,1690,1616,1244,-372
2020,2,16,14,1772,1664,1233,-431
2020,2,16,15,1847,1763,1265,-498
2020,2,16,16,1892,1831,1295,-536
2020,2,16,17,1888,1865,1094,-771
2020,2,16,18,1882,1855,1076,-779
2020,2,16,19,1884,1833,1143,-690
2020,2,16,20,1888,1797,1230,-567
2020,2,16,21,1855,1739,1222,-517
2020,2,16,22,1778,1714,1337,-377
2020,2,16,23,1748,1711,1307,-404
2020,2,17,0,1768,1722,1387,-335
2020,2,17,1,1859,1795,1408,-387
2020,2,17,2,1978,1894,1533,-361
2020,2,17,3,1996,1925,1606,-319
2020,2,17,4,1987,1903,1588,-315
2020,2,17,5,1933,1849,1618,-231
2020,2,17,6,1832,1776,1580,-196
2020,2,17,7,1745,1695,1491,-204
2020,2,17,8,1726,1653,1423,-230
2020,2,17,9,1716,1629,1284,-345
2020,2,17,10,1733,1650,1265,-385
2020,2,17,11,1747,1679,1250,-429
2020,2,17,12,1800,1724,1263,-461
2020,2,17,13,1909,1830,1333,-497
2020,2,17,14,2099,1973,1299,-674
2020,2,17,15,2218,2087,1384,-703
2020,2,17,16,2201,2115,1407,-708
2020,2,17,17,2141,2096,1445,-651
2020,2,17,18,2089,2067,1387,-680
2020,2,17,19,2047,2012,1410,-602
2020,2,17,20,2003,1945,1421,-524
2020,2,17,21,1964,1912,1546,-366
2020,2,17,22,1906,1877,1528,-349
2020,2,17,23,1922,1855,1524,-331
2020,2,18,0,1943,1883,1675,-208
2020,2,18,1,2037,1960,1762,-198
2020,2,18,2,2160,2074,1716,-358
2020,2,18,3,2155,2107,1614,-493
2020,2,18,4,2127,2075,1649,-426
2020,2,18,5,2076,2010,1560,-450
2020,2,18,6,1962,1882,1480,-402
2020,2,18,7,1864,1784,1364,-420
2020,2,18,8,1814,1733,1164,-569
2020,2,18,9,1785,1729,1118,-611
2020,2,18,10,1775,1742,1064,-678
2020,2,18,11,1810,1767,1042,-725
2020,2,18,12,1872,1836,1094,-742
2020,2,18,13,1991,1962,1250,-712
2020,2,18,14,2192,2180,1522,-658
2020,2,18,15,2344,2309,1701,-608
2020,2,18,16,2333,2259,1681,-578
2020,2,18,17,2253,2157,1701,-456
2020,2,18,18,2183,2074,1663,-411
2020,2,18,19,2069,1984,1702,-282
2020,2,18,20,1959,1913,1635,-278
2020,2,18,21,1914,1848,1593,-255
2020,2,18,22,1868,1807,1600,-207
2020,2,18,23,1865,1786,1601,-185
2020,2,19,0,1886,1807,1567,-240
2020,2,19,1,1984,1911,1669,-242
2020,2,19,2,2126,2045,1786,-259
2020,2,19,3,2167,2102,1811,-291
2020,2,19,4,2161,2089,1807,-282
2020,2,19,5,2106,2034,1864,-170
2020,2,19,6,1982,1912,1818,-94
2020,2,19,7,1868,1824,1654,-170
2020,2,19,8,1843,1789,1474,-315
2020,2,19,9,1811,1768,1244,-524
2020,2,19,10,1842,1784,1153,-631
2020,2,19,11,1869,1812,1138,-674
2020,2,19,12,1926,1888,1206,-682
2020,2,19,13,2050,2015,1369,-646
2020,2,19,14,2259,2240,1677,-563
2020,2,19,15,2398,2370,1737,-633
2020,2,19,16,2363,2327,1730,-597
2020,2,19,17,2280,2207,1676,-531
2020,2,19,18,2218,2110,1681,-429
2020,2,19,19,2130,2033,1514,-519
2020,2,19,20,2034,1966,1467,-499
2020,2,19,21,1974,1899,1448,-451
2020,2,19,22,1940,1854,1457,-397
2020,2,19,23,1923,1839,1419,-420
2020,2,20,0,1941,1838,1467,-371
2020,2,20,1,2029,1926,1477,-449
2020,2,20,2,2185,2064,1595,-469
2020,2,20,3,2219,2127,1823,-304
2020,2,20,4,2182,2128,1838,-290
2020,2,20,5,2118,2048,1674,-374
2020,2,20,6,1990,1932,1536,-396
2020,2,20,7,1887,1833,1325,-508
2020,2,20,8,1837,1800,1254,-546
2020,2,20,9,1824,1797,1239,-558
2020,2,20,10,1856,1815,1256,-559
2020,2,20,11,1910,1843,1289,-554
2020,2,20,12,1981,1919,1494,-425
2020,2,20,13,2108,2049,1577,-472
2020,2,20,14,2323,2264,1780,-484
2020,2,20,15,2475,2402,1912,-490
2020,2,20,16,2395,2367,1872,-495
2020,2,20,17,2284,2276,1836,-440
2020,2,20,18,2226,2203,1853,-350
2020,2,20,19,2176,2118,1750,-368
2020,2,20,20,2105,2023,1700,-323
2020,2,20,21,2024,1927,1731,-196
2020,2,20,22,1962,1891,1753,-138
2020,2,20,23,1925,1841,1745,-96
2020,2,21,0,1951,1872,1703,-169
2020,2,21,1,2046,1937,1746,-191
2020,2,21,2,2194,2088,1865,-223
2020,2,21,3,2226,2136,1922,-214
2020,2,21,4,2217,2122,1872,-250
2020,2,21,5,2145,2046,1746,-300
2020,2,21,6,2012,1932,1410,-522
2020,2,21,7,1907,1834,1343,-491
2020,2,21,8,1818,1784,1251,-533
2020,2,21,9,1832,1777,1247,-530
2020,2,21,10,1862,1790,1215,-575
2020,2,21,11,1886,1811,1241,-570
2020,2,21,12,1938,1859,1275,-584
2020,2,21,13,2055,1991,1558,-433
2020,2,21,14,2242,2182,1711,-471
2020,2,21,15,2361,2313,1911,-402
2020,2,21,16,2294,2283,1941,-342
2020,2,21,17,2220,2177,1792,-385
2020,2,21,18,2180,2088,1702,-386
2020,2,21,19,2070,2002,1611,-391
2020,2,21,20,1970,1911,1489,-422
2020,2,21,21,1913,1840,1406,-434
2020,2,21,22,1863,1781,1391,-390
2020,2,21,23,1848,1746,1382,-364
2020,2,22,0,1873,1746,1385,-361
2020,2,22,1,1919,1795,1467,-328
2020,2,22,2,2042,1909,1469,-440
2020,2,22,3,2049,1968,1724,-244
2020,2,22,4,2019,1961,1663,-298
2020,2,22,5,2004,1912,1423,-489
2020,2,22,6,1914,1852,1261,-591
2020,2,22,7,1824,1769,1286,-483
2020,2,22,8,1796,1735,1260,-475
2020,2,22,9,1778,1712,1182,-530
2020,2,22,10,1773,1715,1149,-566
2020,2,22,11,1803,1736,1148,-588
2020,2,22,12,1835,1771,1189,-582
2020,2,22,13,1882,1843,1220,-623
2020,2,22,14,1974,1935,1359,-576
2020,2,22,15,2076,2031,1452,-579
2020,2,22,16,2128,2071,1569,-502
2020,2,22,17,2111,2033,1604,-429
2020,2,22,18,2077,1969,1521,-448
2020,2,22,19,1994,1878,1328,-550
2020,2,22,20,1896,1785,1282,-503
2020,2,22,21,1797,1714,1302,-412
2020,2,22,22,1747,1657,1239,-418
2020,2,22,23,1732,1628,1169,-459
2020,2,23,0,1739,1633,1303,-330
2020,2,23,1,1824,1683,1286,-397
2020,2,23,2,1950,1784,1301,-483
2020,2,23,3,1959,1843,1429,-414
2020,2,23,4,1937,1850,1421,-429
2020,2,23,5,1909,1821,1354,-467
2020,2,23,6,1821,1763,1338,-425
2020,2,23,7,1768,1700,1208,-492
2020,2,23,8,1746,1652,1265,-387
2020,2,23,9,1711,1653,1300,-353
2020,2,23,10,1685,1648,1261,-387
2020,2,23,11,1705,1674,1240,-434
2020,2,23,12,1726,1712,1220,-492
2020,2,23,13,1795,1766,1249,-517
2020,2,23,14,1895,1846,1353,-493
2020,2,23,15,1985,1929,1396,-533
2020,2,23,16,2001,1982,1414,-568
2020,2,23,17,1951,1947,1361,-586
2020,2,23,18,1927,1898,1344,-554
2020,2,23,19,1894,1830,1078,-752
2020,2,23,20,1835,1741,1124,-617
2020,2,23,21,1755,1672,1225,-447
2020,2,23,22,1693,1620,1168,-452
2020,2,23,23,1673,1604,1070,-534
2020,2,24,0,1666,1655,996,-659
2020,2,24,1,1744,1722,1197,-525
2020,2,24,2,1887,1828,1598,-230
2020,2,24,3,1937,1901,1850,-51
2020,2,24,4,1932,1872,1757,-115
2020,2,24,5,1900,1813,1662,-151
2020,2,24,6,1782,1704,1449,-255
2020,2,24,7,1705,1617,1457,-160
2020,2,24,8,1637,1592,1462,-130
2020,2,24,9,1636,1581,1460,-121
2020,2,24,10,1683,1597,1509,-88
2020,2,24,11,1711,1620,1506,-114
2020,2,24,12,1789,1684,1502,-182
2020,2,24,13,1890,1823,1517,-306
2020,2,24,14,2060,2035,1647,-388
2020,2,24,15,2212,2181,1918,-263
2020,2,24,16,2239,2140,1830,-310
2020,2,24,17,2140,2038,1808,-230
2020,2,24,18,2032,1976,1666,-310
2020,2,24,19,1954,1937,1769,-168
2020,2,24,20,1923,1877,1634,-243
2020,2,24,21,1905,1842,1538,-304
2020,2,24,22,1884,1817,1500,-317
2020,2,24,23,1894,1790,1583,-207
2020,2,25,0,1913,1805,1607,-198
2020,2,25,1,1981,1881,1840,-41
2020,2,25,2,2091,2022,1933,-89
2020,2,25,3,2118,2073,1897,-176
2020,2,25,4,2110,2037,1777,-260
2020,2,25,5,2030,1974,1715,-259
2020,2,25,6,1894,1843,1603,-240
2020,2,25,7,1779,1740,1368,-372
2020,2,25,8,1745,1700,1242,-458
2020,2,25,9,1759,1682,1185,-497
2020,2,25,10,1773,1697,1145,-552
2020,2,25,11,1794,1719,1068,-651
2020,2,25,12,1860,1782,974,-808
2020,2,25,13,1974,1924,1145,-779
2020,2,25,14,2186,2153,1376,-777
2020,2,25,15,2331,2256,1564,-692
2020,2,25,16,2266,2196,1537,-659
2020,2,25,17,2156,2081,1468,-613
2020,2,25,18,2067,1986,1378,-608
2020,2,25,19,1977,1894,1284,-610
2020,2,25,20,1922,1818,1197,-621
2020,2,25,21,1865,1765,1174,-591
2020,2,25,22,1802,1719,1136,-583
2020,2,25,23,1794,1697,1124,-573
2020,2,26,0,1848,1704,1087,-617
2020,2,26,1,1933,1773,1337,-436
2020,2,26,2,2069,1897,1383,-514
2020,2,26,3,2068,1988,1486,-502
2020,2,26,4,2016,1986,1629,-357
2020,2,26,5,1980,1926,1612,-314
2020,2,26,6,1871,1812,1515,-297
2020,2,26,7,1766,1707,1444,-263
2020,2,26,8,1747,1658,1316,-342
2020,2,26,9,1723,1641,1152,-489
2020,2,26,10,1691,1642,1104,-538
2020,2,26,11,1715,1659,1115,-544
2020,2,26,12,1770,1711,1184,-527
2020,2,26,13,1888,1837,1421,-416
2020,2,26,14,2091,2050,1610,-440
2020,2,26,15,2218,2166,1734,-432
2020,2,26,16,2153,2117,1573,-544
2020,2,26,17,2054,2038,1422,-616
2020,2,26,18,2023,1936,1482,-454
2020,2,26,19,1949,1848,1356,-492
2020,2,26,20,1876,1777,1329,-448
2020,2,26,21,1809,1737,1174,-563
2020,2,26,22,1759,1680,1157,-523
2020,2,26,23,1746,1656,1226,-430
2020,2,27,0,1766,1669,1225,-444
2020,2,27,1,1836,1713,1267,-446
2020,2,27,2,1970,1813,1495,-318
2020,2,27,3,2007,1887,1662,-225
2020,2,27,4,1967,1886,1720,-166
2020,2,27,5,1906,1833,1374,-459
2020,2,27,6,1800,1728,1181,-547
2020,2,27,7,1712,1656,1187,-469
2020,2,27,8,1702,1617,1164,-453
2020,2,27,9,1671,1601,1051,-550
2020,2,27,10,1690,1629,977,-652
2020,2,27,11,1709,1648,974,-674
2020,2,27,12,1770,1717,986,-731
2020,2,27,13,1897,1855,1080,-775
2020,2,27,14,2105,2063,1350,-713
2020,2,27,15,2224,2182,1448,-734
2020,2,27,16,2140,2123,1479,-644
2020,2,27,17,2030,2002,1388,-614
2020,2,27,18,1959,1907,1334,-573
2020,2,27,19,1909,1824,1236,-588
2020,2,27,20,1830,1746,1260,-486
2020,2,27,21,1792,1698,1280,-418
2020,2,27,22,1753,1649,1352,-297
2020,2,27,23,1730,1638,1407,-231
2020,2,28,0,1735,1645,1502,-143
2020,2,28,1,1797,1669,1366,-303
2020,2,28,2,1922,1781,1407,-374
2020,2,28,3,1958,1847,1494,-353
2020,2,28,4,1924,1838,1455,-383
2020,2,28,5,1870,1788,1250,-538
2020,2,28,6,1755,1691,1122,-569
2020,2,28,7,1666,1607,1101,-506
2020,2,28,8,1633,1567,972,-595
2020,2,28,9,1628,1550,1052,-498
2020,2,28,10,1630,1565,1093,-472
2020,2,28,11,1654,1589,1115,-474
2020,2,28,12,1717,1647,1217,-430
2020,2,28,13,1847,1766,1294,-472
2020,2,28,14,2047,1965,1394,-571
2020,2,28,15,2152,2079,1475,-604
2020,2,28,16,2088,2038,1587,-451
2020,2,28,17,2002,1959,1692,-267
2020,2,28,18,1937,1878,1661,-217
2020,2,28,19,1853,1798,1604,-194
2020,2,28,20,1779,1733,1568,-165
2020,2,28,21,1732,1670,1537,-133
2020,2,28,22,1689,1626,1541,-85
2020,2,28,23,1670,1621,1545,-76
2020,2,29,0,1697,1626,1508,-118
2020,2,29,1,1735,1674,1452,-222
2020,2,29,2,1824,1738,1381,-357
2020,2,29,3,1879,1774,1374,-400
2020,2,29,4,1834,1755,1344,-411
2020,2,29,5,1777,1700,1336,-364
2020,2,29,6,1711,1621,1228,-393
2020,2,29,7,1636,1552,1292,-260
2020,2,29,8,1565,1489,1228,-261
2020,2,29,9,1538,1458,1161,-297
2020,2,29,10,1551,1448,1127,-321
2020,2,29,11,1551,1470,1144,-326
2020,2,29,12,1570,1484,1105,-379
2020,2,29,13,1633,1554,1134,-420
2020,2,29,14,1714,1637,1145,-492
2020,2,29,15,1791,1745,1292,-453
2020,2,29,16,1825,1802,1316,-486
2020,2,29,17,1826,1800,1366,-434
2020,2,29,18,1835,1766,1352,-414
2020,2,29,19,1836,1707,1362,-345
2020,2,29,20,1790,1674,1446,-228
2020,2,29,21,1748,1637,1517,-120
2020,2,29,22,1734,1613,1497,-116
2020,2,29,23,1720,1618,1366,-252
2020,3,1,0,1732,1649,1360,-289
2020,3,1,1,1804,1715,1379,-336
2020,3,1,2,1907,1786,1364,-422
2020,3,1,3,1921,1809,1460,-349
2020,3,1,4,1895,1787,1463,-324
2020,3,1,5,1834,1737,1458,-279
2020,3,1,6,1752,1650,1225,-425
2020,3,1,7,1678,1584,1283,-301
2020,3,1,8,1646,1532,1429,-103
2020,3,1,9,1627,1519,1510,-9
2020,3,1,10,1606,1530,1528,-2
2020,3,1,11,1609,1534,1546,12
2020,3,1,12,1628,1559,1546,-13
2020,3,1,13,1685,1623,1601,-22
2020,3,1,14,1764,1697,1615,-82
2020,3,1,15,1859,1788,1495,-293
2020,3,1,16,1926,1855,1457,-398
2020,3,1,17,1918,1828,1432,-396
2020,3,1,18,1861,1787,1366,-421
2020,3,1,19,1810,1728,1353,-375
2020,3,1,20,1767,1682,1321,-361
2020,3,1,21,1717,1648,1275,-373
2020,3,1,22,1688,1618,1341,-277
2020,3,1,23,1698,1598,1367,-231
2020,3,2,0,1730,1628,1377,-251
2020,3,2,1,1791,1682,1358,-324
2020,3,2,2,1896,1797,1386,-411
2020,3,2,3,1929,1884,1218,-666
2020,3,2,4,1919,1879,1251,-628
2020,3,2,5,1903,1833,1251,-582
2020,3,2,6,1810,1725,1255,-470
2020,3,2,7,1718,1635,1205,-430
2020,3,2,8,1706,1590,1232,-358
2020,3,2,9,1673,1592,1299,-293
2020,3,2,10,1657,1604,1406,-198
2020,3,2,11,1693,1636,1394,-242
2020,3,2,12,1754,1686,1460,-226
2020,3,2,13,1872,1816,1449,-367
2020,3,2,14,2060,2029,1599,-430
2020,3,2,15,2181,2156,1837,-319
2020,3,2,16,2160,2114,1825,-289
2020,3,2,17,2067,2027,1802,-225
2020,3,2,18,2008,1957,1839,-118
2020,3,2,19,1955,1878,1797,-81
2020,3,2,20,1901,1802,1764,-38
2020,3,2,21,1855,1759,1649,-110
2020,3,2,22,1812,1705,1465,-240
2020,3,2,23,1787,1693,1513,-180
2020,3,3,0,1788,1717,1399,-318
2020,3,3,1,1855,1780,1436,-344
2020,3,3,2,1962,1876,1494,-382
2020,3,3,3,2002,1913,1516,-397
2020,3,3,4,1953,1881,1531,-350
2020,3,3,5,1860,1805,1483,-322
2020,3,3,6,1733,1671,1300,-371
2020,3,3,7,1636,1567,1373,-194
2020,3,3,8,1604,1497,1202,-295
2020,3,3,9,1572,1472,1177,-295
2020,3,3,10,1547,1457,1204,-253
2020,3,3,11,1561,1466,1200,-266
2020,3,3,12,1591,1500,1272,-228
2020,3,3,13,1685,1613,1297,-316
2020,3,3,14,1856,1802,1324,-478
2020,3,3,15,1949,1910,1336,-574
2020,3,3,16,1934,1883,1327,-556
2020,3,3,17,1878,1824,1468,-356
2020,3,3,18,1838,1758,1638,-120
2020,3,3,19,1808,1705,1629,-76
2020,3,3,20,1757,1657,1485,-172
2020,3,3,21,1717,1624,1475,-149
2020,3,3,22,1692,1597,1534,-63
2020,3,3,23,1673,1573,1543,-30
2020,3,4,0,1699,1589,1485,-104
2020,3,4,1,1752,1627,1526,-101
2020,3,4,2,1829,1724,1551,-173
2020,3,4,3,1860,1806,1529,-277
2020,3,4,4,1843,1785,1478,-307
2020,3,4,5,1786,1718,1498,-220
2020,3,4,6,1665,1608,1455,-153
2020,3,4,7,1568,1500,1200,-300
2020,3,4,8,1536,1452,1126,-326
2020,3,4,9,1512,1436,990,-446
2020,3,4,10,1506,1437,971,-466
2020,3,4,11,1516,1474,1007,-467
2020,3,4,12,1574,1519,984,-535
2020,3,4,13,1689,1649,995,-654
2020,3,4,14,1892,1866,1278,-588
2020,3,4,15,2017,1973,1510,-463
2020,3,4,16,1975,1934,1495,-439
2020,3,4,17,1895,1811,1502,-309
2020,3,4,18,1844,1734,1583,-151
2020,3,4,19,1775,1740,1709,-31
2020,3,4,20,1717,1644,1661,17
2020,3,4,21,1696,1614,1655,41
2020,3,4,22,1680,1584,1766,182
2020,3,4,23,1663,1529,1714,185
2020,3,5,0,1675,1595,1743,148
2020,3,5,1,1728,1621,1616,-5
2020,3,5,2,1822,1698,1575,-123
2020,3,5,3,1877,1782,1558,-224
2020,3,5,4,1835,1770,1510,-260
2020,3,5,5,1767,1706,1302,-404
2020,3,5,6,1660,1598,1201,-397
2020,3,5,7,1573,1511,1155,-356
2020,3,5,8,1529,1471,1129,-342
2020,3,5,9,1508,1453,1146,-307
2020,3,5,10,1522,1464,1222,-242
2020,3,5,11,1542,1481,1321,-160
2020,3,5,12,1596,1544,1430,-114
2020,3,5,13,1715,1667,1491,-176
2020,3,5,14,1912,1884,1621,-263
2020,3,5,15,2036,1995,1770,-225
2020,3,5,16,2001,1942,1750,-192
2020,3,5,17,1912,1849,1598,-251
2020,3,5,18,1844,1774,1399,-375
2020,3,5,19,1768,1700,1555,-145
2020,3,5,20,1702,1652,1565,-87
2020,3,5,21,1654,1618,1612,-6
2020,3,5,22,1633,1584,1626,42
2020,3,5,23,1630,1573,1649,76
2020,3,6,0,1653,1575,1654,79
2020,3,6,1,1700,1601,1575,-26
2020,3,6,2,1791,1667,1676,9
2020,3,6,3,1846,1726,1700,-26
2020,3,6,4,1780,1704,1621,-83
2020,3,6,5,1700,1641,1588,-53
2020,3,6,6,1591,1522,1463,-59
2020,3,6,7,1497,1432,1435,3
2020,3,6,8,1443,1381,1389,8
2020,3,6,9,1421,1362,1368,6
2020,3,6,10,1433,1347,1311,-36
2020,3,6,11,1450,1377,1314,-63
2020,3,6,12,1501,1418,1321,-97
2020,3,6,13,1601,1529,1367,-162
2020,3,6,14,1782,1715,1519,-196
2020,3,6,15,1897,1838,1580,-258
2020,3,6,16,1843,1817,1504,-313
2020,3,6,17,1770,1784,1525,-259
2020,3,6,18,1760,1722,1459,-263
2020,3,6,19,1732,1675,1368,-307
2020,3,6,20,1702,1636,1331,-305
2020,3,6,21,1688,1606,1338,-268
2020,3,6,22,1660,1586,1292,-294
2020,3,6,23,1645,1577,1233,-344
2020,3,7,0,1654,1586,1312,-274
2020,3,7,1,1680,1600,1348,-252
2020,3,7,2,1733,1645,1538,-107
2020,3,7,3,1770,1681,1752,71
2020,3,7,4,1722,1637,1617,-20
2020,3,7,5,1643,1577,1427,-150
2020,3,7,6,1554,1511,1451,-60
2020,3,7,7,1482,1418,1365,-53
2020,3,7,8,1412,1360,1292,-68
2020,3,7,9,1394,1319,1266,-53
2020,3,7,10,1381,1309,1254,-55
2020,3,7,11,1384,1307,1224,-83
2020,3,7,12,1409,1320,1202,-118
2020,3,7,13,1460,1374,1140,-234
2020,3,7,14,1548,1456,1367,-89
2020,3,7,15,1624,1548,1367,-181
2020,3,7,16,1662,1635,1276,-359
2020,3,7,17,1690,1693,1407,-286
2020,3,7,18,1725,1705,1323,-382
2020,3,7,19,1749,1687,1296,-391
2020,3,7,20,1736,1654,1196,-458
2020,3,7,21,1712,1642,1236,-406
2020,3,7,22,1691,1632,1347,-285
2020,3,7,23,1695,1609,1432,-177
2020,3,8,0,1706,1631,1264,-367
2020,3,8,1,1739,1654,1348,-306
2020,3,8,2,1799,1710,1479,-231
2020,3,8,3,1832,1736,1440,-296
2020,3,8,4,1797,1716,1432,-284
2020,3,8,5,1736,1655,1449,-206
2020,3,8,6,1655,1581,1351,-230
2020,3,8,7,1574,1516,1300,-216
2020,3,8,8,1528,1414,1047,-367
2020,3,8,9,1509,1509,1047,-9999
2020,3,8,10,968,968,1254,-9999
2020,3,8,11,1523,1523,1224,-9999
2020,3,8,12,1583,1583,1202,-9999
2020,3,8,13,1663,1663,1140,-9999
2020,3,8,14,1734,1734,1367,-9999
2020,3,8,15,1795,1795,1367,-9999
2020,3,8,16,1833,1833,1276,-9999
2020,3,8,17,1826,1826,1407,-9999
2020,3,8,18,1784,1784,1323,-9999
2020,3,8,19,1738,1738,1296,-9999
2020,3,8,20,1686,1686,1196,-9999
2020,3,8,21,1633,1633,1236,-9999
2020,3,8,22,1615,1615,1347,-9999
2020,3,8,23,1626,1626,1432,-9999
2020,3,9,0,1665,1665,1264,-9999
2020,3,9,1,1743,1743,1348,-9999
2020,3,9,2,1778,1778,1479,-9999
2020,3,9,3,1724,1724,1440,-9999
2020,3,9,4,1683,1683,1432,-9999
2020,3,9,5,1652,1652,1449,-9999
2020,3,9,6,-9999,1581,1351,-9999
2020,3,9,7,-9999,1516,1300,-9999
2020,3,9,8,1473,1390,1155,-235
2020,3,9,9,1473,1373,1239,-134
2020,3,9,10,1519,1392,1245,-147
2020,3,9,11,1622,1437,1279,-158
2020,3,9,12,1815,1533,1375,-158
2020,3,9,13,1934,1731,1411,-320
2020,3,9,14,1935,1887,1491,-396
2020,3,9,15,1918,1909,1573,-336
2020,3,9,16,1909,1891,1532,-359
2020,3,9,17,1888,1869,1419,-450
2020,3,9,18,1875,1810,1403,-407
2020,3,9,19,1839,1763,1388,-375
2020,3,9,20,1791,1713,1245,-468
2020,3,9,21,1759,1680,1267,-413
2020,3,9,22,1753,1657,1346,-311
2020,3,9,23,1793,1646,1496,-150
2020,3,10,0,1862,1674,1310,-364
2020,3,10,1,1896,1700,1305,-395
2020,3,10,2,1844,1747,1595,-152
2020,3,10,3,1735,1794,1401,-393
2020,3,10,4,1627,1731,1344,-387
2020,3,10,5,1584,1613,1198,-415
2020,3,10,6,1533,1511,1188,-323
2020,3,10,7,1519,1442,1183,-259
2020,3,10,8,1515,1426,1177,-249
2020,3,10,9,1540,1420,1155,-265
2020,3,10,10,1585,1436,1155,-281
2020,3,10,11,1696,1478,1206,-272
2020,3,10,12,1895,1614,1371,-243
2020,3,10,13,2028,1823,1413,-410
2020,3,10,14,2044,1995,1571,-424
2020,3,10,15,2002,1994,1589,-405
2020,3,10,16,1960,1929,1761,-168
2020,3,10,17,1907,1835,1667,-168
2020,3,10,18,1830,1772,1625,-147
2020,3,10,19,1762,1718,1391,-327
2020,3,10,20,1707,1648,1357,-291
2020,3,10,21,1672,1624,1383,-241
2020,3,10,22,1676,1595,1387,-208
2020,3,10,23,1716,1576,1474,-102
2020,3,11,0,1773,1597,1546,-51
2020,3,11,1,1807,1598,1438,-160
2020,3,11,2,1793,1652,1406,-246
2020,3,11,3,1710,1748,1576,-172
2020,3,11,4,1615,1716,1513,-203
2020,3,11,5,1564,1603,1461,-142
2020,3,11,6,1506,1507,1262,-245
2020,3,11,7,1490,1446,1130,-316
2020,3,11,8,1478,1435,1084,-351
2020,3,11,9,1494,1432,985,-447
2020,3,11,10,1542,1453,1023,-430
2020,3,11,11,1647,1518,1214,-304
2020,3,11,12,1866,1640,1364,-276
2020,3,11,13,2015,1848,1443,-405
2020,3,11,14,2019,2008,1478,-530
2020,3,11,15,1950,2001,1537,-464
2020,3,11,16,1880,1937,1546,-391
2020,3,11,17,1888,1843,1400,-443
2020,3,11,18,1817,1753,1323,-430
2020,3,11,19,1761,1674,1317,-357
2020,3,11,20,1705,1646,1222,-424
2020,3,11,21,1669,1608,1209,-399
2020,3,11,22,1611,1580,1400,-180
2020,3,11,23,1612,1555,1579,24
2020,3,12,0,1646,1546,1514,-32
2020,3,12,1,1697,1578,1591,13
2020,3,12,2,1691,1616,1480,-136
2020,3,12,3,1745,1694,1694,0
2020,3,12,4,1691,1664,1773,109
2020,3,12,5,1607,1579,1904,325
2020,3,12,6,1523,1469,1828,359
2020,3,12,7,1462,1410,1867,457
2020,3,12,8,1450,1391,1621,230
2020,3,12,9,1480,1403,1687,284
2020,3,12,10,1513,1427,1701,274
2020,3,12,11,1577,1476,1723,247
2020,3,12,12,1699,1606,1806,200
2020,3,12,13,1906,1806,1884,78
2020,3,12,14,2063,1970,2021,51
2020,3,12,15,2069,1967,2090,123
2020,3,12,16,2018,1903,2108,205
2020,3,12,17,1950,1835,2004,169
2020,3,12,18,1874,1779,2117,338
2020,3,12,19,1811,1728,2381,653
2020,3,12,20,1750,1688,2259,571
2020,3,12,21,1711,1640,2267,627
2020,3,12,22,1713,1619,2165,546
2020,3,12,23,1714,1584,1963,379
2020,3,13,0,1695,1588,1904,316
2020,3,13,1,1736,1597,1778,181
2020,3,13,2,1787,1678,1704,26
2020,3,13,3,1836,1762,1806,44
2020,3,13,4,1802,1743,1733,-10
2020,3,13,5,1691,1641,1603,-38
2020,3,13,6,1597,1565,1320,-245
2020,3,13,7,1567,1514,1155,-359
2020,3,13,8,1566,1499,1199,-300
2020,3,13,9,1565,1511,1163,-348
2020,3,13,10,1578,1572,1097,-475
2020,3,13,11,1632,1604,1261,-343
2020,3,13,12,1766,1720,1303,-417
2020,3,13,13,1978,1908,1517,-391
2020,3,13,14,2122,2060,1542,-518
2020,3,13,15,2113,2066,1613,-453
2020,3,13,16,2049,1998,1752,-246
2020,3,13,17,1963,1919,1723,-196
2020,3,13,18,1874,1836,1650,-186
2020,3,13,19,1820,1758,1447,-311
2020,3,13,20,1767,1691,1467,-224
2020,3,13,21,1720,1643,1462,-181
2020,3,13,22,1698,1613,1344,-269
2020,3,13,23,1686,1567,1301,-266
2020,3,14,0,1667,1579,1410,-169
2020,3,14,1,1674,1587,1388,-199
2020,3,14,2,1704,1629,1443,-186
2020,3,14,3,1760,1704,1635,-69
2020,3,14,4,1742,1678,1530,-148
2020,3,14,5,1666,1622,1411,-211
2020,3,14,6,1553,1523,1398,-125
2020,3,14,7,1474,1462,1341,-121
2020,3,14,8,1416,1419,1248,-171
2020,3,14,9,1461,1392,1185,-207
2020,3,14,10,1473,1382,1091,-291
2020,3,14,11,1479,1395,1084,-311
2020,3,14,12,1537,1428,1126,-302
2020,3,14,13,1633,1507,1130,-377
2020,3,14,14,1731,1597,1276,-321
2020,3,14,15,1781,1702,1404,-298
2020,3,14,16,1778,1765,1457,-308
2020,3,14,17,1780,1803,1384,-419
2020,3,14,18,1798,1802,1323,-479
2020,3,14,19,1819,1767,1316,-451
2020,3,14,20,1805,1716,1364,-352
2020,3,14,21,1763,1651,1319,-332
2020,3,14,22,1719,1631,1333,-298
2020,3,14,23,1675,1621,1423,-198
2020,3,15,0,1678,1653,1365,-288
2020,3,15,1,1708,1682,1445,-237
2020,3,15,2,1751,1712,1282,-430
2020,3,15,3,1808,1734,1325,-409
2020,3,15,4,1766,1685,1313,-372
2020,3,15,5,1670,1613,1444,-169
2020,3,15,6,1569,1532,1356,-176
2020,3,15,7,1496,1465,1370,-95
2020,3,15,8,1496,1428,1266,-162
2020,3,15,9,1473,1401,1269,-132
2020,3,15,10,1458,1401,1252,-149
2020,3,15,11,1465,1417,1192,-225
2020,3,15,12,1516,1464,1267,-197
2020,3,15,13,1587,1517,1480,-37
2020,3,15,14,1683,1613,1413,-200
2020,3,15,15,1768,1703,1363,-340
2020,3,15,16,1765,1770,1323,-447
2020,3,15,17,1744,1768,1251,-517
2020,3,15,18,1768,1773,1321,-452
2020,3,15,19,1771,1713,1307,-406
2020,3,15,20,1725,1647,1320,-327
2020,3,15,21,1674,1607,1266,-341
2020,3,15,22,1644,1570,1302,-268
2020,3,15,23,1635,1565,1348,-217
2020,3,16,0,1670,1584,1277,-307
2020,3,16,1,1683,1625,1284,-341
2020,3,16,2,1727,1653,1475,-178
2020,3,16,3,1771,1703,1622,-81
2020,3,16,4,1706,1659,1622,-37
2020,3,16,5,1619,1569,1602,33
2020,3,16,6,1525,1447,1361,-86
2020,3,16,7,1480,1379,1383,4
2020,3,16,8,1447,1354,1560,206
2020,3,16,9,1402,1351,1547,196
2020,3,16,10,1420,1367,1634,267
2020,3,16,11,1471,1417,1574,157
2020,3,16,12,1570,1531,1555,24
2020,3,16,13,1746,1709,1780,71
2020,3,16,14,1890,1851,1776,-75
2020,3,16,15,1933,1886,1682,-204
2020,3,16,16,1902,1860,1695,-165
2020,3,16,17,1852,1836,1832,-4
2020,3,16,18,1825,1779,1803,24
2020,3,16,19,1764,1726,1716,-10
2020,3,16,20,1702,1667,1736,69
2020,3,16,21,1667,1629,1797,168
2020,3,16,22,1653,1605,1652,47
2020,3,16,23,1649,1576,1756,180
2020,3,17,0,1667,1594,1783,189
2020,3,17,1,1698,1602,1704,102
2020,3,17,2,1730,1629,1560,-69
2020,3,17,3,1770,1673,1636,-37
2020,3,17,4,1711,1615,1663,48
2020,3,17,5,1599,1521,1603,82
2020,3,17,6,1496,1425,1453,28
2020,3,17,7,1472,1357,1323,-34
2020,3,17,8,1427,1323,1350,27
2020,3,17,9,1417,1298,1215,-83
2020,3,17,10,1423,1300,1227,-73
2020,3,17,11,1450,1350,1249,-101
2020,3,17,12,1549,1439,1277,-162
2020,3,17,13,1713,1588,1357,-231
2020,3,17,14,1829,1707,1356,-351
2020,3,17,15,1838,1743,1334,-409
2020,3,17,16,1814,1749,1400,-349
2020,3,17,17,1769,1721,1422,-299
2020,3,17,18,1727,1682,1420,-262
2020,3,17,19,1699,1643,1378,-265
2020,3,17,20,1662,1627,1398,-229
2020,3,17,21,1646,1594,1467,-127
2020,3,17,22,1645,1566,1405,-161
2020,3,17,23,1641,1586,1372,-214
2020,3,18,0,1659,1594,1475,-119
2020,3,18,1,1703,1622,1484,-138
2020,3,18,2,1738,1640,1475,-165
2020,3,18,3,1784,1663,1373,-290
2020,3,18,4,1717,1603,1414,-189
2020,3,18,5,1579,1494,1288,-206
2020,3,18,6,1465,1409,1109,-300
2020,3,18,7,1467,1371,1035,-336
2020,3,18,8,1432,1337,1019,-318
2020,3,18,9,1394,1339,997,-342
2020,3,18,10,1406,1353,993,-360
2020,3,18,11,1460,1398,991,-407
2020,3,18,12,1567,1497,1010,-487
2020,3,18,13,1736,1642,1230,-412
2020,3,18,14,1847,1782,1217,-565
2020,3,18,15,1865,1835,1283,-552
2020,3,18,16,1854,1836,1223,-613
2020,3,18,17,1832,1855,1249,-606
2020,3,18,18,1821,1792,1206,-586
2020,3,18,19,1803,1762,1229,-533
2020,3,18,20,1764,1733,1276,-457
2020,3,18,21,1744,1690,1262,-428
2020,3,18,22,1730,1633,1235,-398
2020,3,18,23,1717,1600,1300,-300
2020,3,19,0,1706,1603,1357,-246
2020,3,19,1,1725,1625,1560,-65
2020,3,19,2,1741,1649,1523,-126
2020,3,19,3,1772,1720,1449,-271
2020,3,19,4,1714,1674,1440,-234
2020,3,19,5,1621,1589,1428,-161
2020,3,19,6,1533,1513,1431,-82
2020,3,19,7,1522,1456,1343,-113
2020,3,19,8,1474,1436,1353,-83
2020,3,19,9,1471,1440,1414,-26
2020,3,19,10,1486,1461,1398,-63
2020,3,19,11,1532,1501,1419,-82
2020,3,19,12,1641,1608,1446,-162
2020,3,19,13,1807,1754,1450,-304
2020,3,19,14,1945,1894,1485,-409
2020,3,19,15,1968,1928,1555,-373
2020,3,19,16,1938,1881,1652,-229
2020,3,19,17,1903,1819,1661,-158
2020,3,19,18,1836,1748,1463,-285
2020,3,19,19,1784,1691,1448,-243
2020,3,19,20,1733,1646,1443,-203
2020,3,19,21,1679,1592,1404,-188
2020,3,19,22,1627,1562,1441,-121
2020,3,19,23,1608,1543,1451,-92
2020,3,20,0,1626,1552,1390,-162
2020,3,20,1,1650,1567,1307,-260
2020,3,20,2,1633,1584,1331,-253
2020,3,20,3,1695,1651,1402,-249
2020,3,20,4,1664,1604,1407,-197
2020,3,20,5,1573,1507,1408,-99
2020,3,20,6,1484,1431,1442,11
2020,3,20,7,1444,1361,1420,59
2020,3,20,8,1411,1343,1398,55
2020,3,20,9,1367,1340,1385,45
2020,3,20,10,1377,1348,1401,53
2020,3,20,11,1428,1382,1399,17
2020,3,20,12,1527,1453,1442,-11
2020,3,20,13,1668,1590,1509,-81
2020,3,20,14,1785,1728,1522,-206
2020,3,20,15,1836,1793,1553,-240
2020,3,20,16,1808,1784,1461,-323
2020,3,20,17,1772,1749,1508,-241
2020,3,20,18,1758,1705,1522,-183
2020,3,20,19,1707,1647,1598,-49
2020,3,20,20,1671,1607,1616,9
2020,3,20,21,1578,1562,1658,96
2020,3,20,22,1501,1532,1669,137
2020,3,20,23,1590,1517,1739,222
2020,3,21,0,1582,1526,1708,182
2020,3,21,1,1599,1535,1729,194
2020,3,21,2,1625,1548,1619,71
2020,3,21,3,1666,1614,1652,38
2020,3,21,4,1630,1569,1539,-30
2020,3,21,5,1571,1460,1483,23
2020,3,21,6,1496,1408,1367,-41
2020,3,21,7,1437,1350,1352,2
2020,3,21,8,1385,1325,1354,29
2020,3,21,9,1372,1316,1342,26
2020,3,21,10,1379,1330,1322,-8
2020,3,21,11,1400,1354,1295,-59
2020,3,21,12,1444,1413,1298,-115
2020,3,21,13,1516,1498,1457,-41
2020,3,21,14,1656,1609,1469,-140
2020,3,21,15,1788,1664,1534,-130
2020,3,21,16,1805,1667,1637,-30
2020,3,21,17,1765,1650,1582,-68
2020,3,21,18,1698,1598,1449,-149
2020,3,21,19,1606,1557,1395,-162
2020,3,21,20,1539,1502,1417,-85
2020,3,21,21,1562,1460,1518,58
2020,3,21,22,1557,1454,1614,160
2020,3,21,23,1505,1454,1707,253
2020,3,22,0,1519,1485,1728,243
2020,3,22,1,1558,1512,1730,218
2020,3,22,2,1587,1537,1685,148
2020,3,22,3,1628,1593,1678,85
2020,3,22,4,1594,1565,1645,80
2020,3,22,5,1544,1488,1421,-67
2020,3,22,6,1476,1410,1362,-48
2020,3,22,7,1396,1358,1153,-205
2020,3,22,8,1366,1346,1137,-209
2020,3,22,9,1378,1336,1089,-247
2020,3,22,10,1378,1358,1051,-307
2020,3,22,11,1420,1384,1049,-335
2020,3,22,12,1494,1436,1024,-412
2020,3,22,13,1566,1510,1102,-408
2020,3,22,14,1658,1607,1209,-398
2020,3,22,15,1740,1663,1235,-428
2020,3,22,16,1738,1655,1366,-289
2020,3,22,17,1703,1622,1345,-277
2020,3,22,18,1668,1585,1449,-136
2020,3,22,19,1607,1529,1439,-90
2020,3,22,20,1538,1482,1472,-10
2020,3,22,21,1536,1444,1541,97
2020,3,22,22,1525,1416,1581,165
2020,3,22,23,1494,1428,1613,185
2020,3,23,0,1520,1455,1569,114
2020,3,23,1,1563,1493,1447,-46
2020,3,23,2,1579,1500,1337,-163
2020,3,23,3,1634,1577,1343,-234
2020,3,23,4,1596,1555,1324,-231
2020,3,23,5,1506,1465,1219,-246
2020,3,23,6,1427,1386,1241,-145
2020,3,23,7,1345,1320,1131,-189
2020,3,23,8,1314,1313,1077,-236
2020,3,23,9,1340,1303,1101,-202
2020,3,23,10,1369,1323,1113,-210
2020,3,23,11,1419,1376,1132,-244
2020,3,23,12,1523,1457,1321,-136
2020,3,23,13,1687,1609,1401,-208
2020,3,23,14,1796,1740,1409,-331
2020,3,23,15,1761,1784,1480,-304
2020,3,23,16,1730,1787,1501,-286
2020,3,23,17,1735,1769,1401,-368
2020,3,23,18,1748,1745,1371,-374
2020,3,23,19,1717,1730,1373,-357
2020,3,23,20,1695,1704,1345,-359
2020,3,23,21,1712,1663,1323,-340
2020,3,23,22,1675,1622,1360,-262
2020,3,23,23,1666,1626,1264,-362
2020,3,24,0,1662,1633,1334,-299
2020,3,24,1,1694,1648,1327,-321
2020,3,24,2,1725,1671,1454,-217
2020,3,24,3,1743,1687,1404,-283
2020,3,24,4,1680,1621,1414,-207
2020,3,24,5,1540,1526,1605,79
2020,3,24,6,1440,1434,1434,0
2020,3,24,7,1370,1365,1194,-171
2020,3,24,8,1360,1348,1181,-167
2020,3,24,9,1423,1332,1220,-112
2020,3,24,10,1442,1341,1173,-168
2020,3,24,11,1475,1375,1195,-180
2020,3,24,12,1568,1458,1156,-302
2020,3,24,13,1714,1577,1286,-291
2020,3,24,14,1827,1705,1278,-427
2020,3,24,15,1829,1746,1373,-373
2020,3,24,16,1818,1762,1357,-405
2020,3,24,17,1808,1750,1330,-420
2020,3,24,18,1802,1740,1398,-342
2020,3,24,19,1779,1701,1363,-338
2020,3,24,20,1740,1680,1424,-256
2020,3,24,21,1717,1634,1410,-224
2020,3,24,22,1700,1640,1368,-272
2020,3,24,23,1686,1625,1193,-432
2020,3,25,0,1723,1637,1297,-340
2020,3,25,1,1736,1640,1315,-325
2020,3,25,2,1738,1681,1280,-401
2020,3,25,3,1773,1719,1206,-513
2020,3,25,4,1726,1660,1276,-384
2020,3,25,5,1616,1569,1421,-148
2020,3,25,6,1506,1467,1328,-139
2020,3,25,7,1444,1416,1176,-240
2020,3,25,8,1448,1396,1145,-251
2020,3,25,9,1454,1398,1137,-261
2020,3,25,10,1457,1401,1054,-347
2020,3,25,11,1497,1447,1030,-417
2020,3,25,12,1594,1539,1167,-372
2020,3,25,13,1740,1668,1258,-410
2020,3,25,14,1869,1787,1267,-520
2020,3,25,15,1901,1830,1264,-566
2020,3,25,16,1876,1849,1266,-583
2020,3,25,17,1851,1835,1228,-607
2020,3,25,18,1862,1804,1312,-492
2020,3,25,19,1836,1758,1384,-374
2020,3,25,20,1780,1731,1514,-217
2020,3,25,21,1746,1681,1458,-223
2020,3,25,22,1742,1649,1570,-79
2020,3,25,23,1728,1637,1657,20
2020,3,26,0,1722,1649,1652,3
2020,3,26,1,1734,1659,1682,23
2020,3,26,2,1768,1691,1529,-162
2020,3,26,3,1810,1742,1518,-224
2020,3,26,4,1755,1712,1450,-262
2020,3,26,5,1664,1635,1440,-195
2020,3,26,6,1585,1550,1336,-214
2020,3,26,7,1535,1504,1213,-291
2020,3,26,8,1508,1484,1187,-297
2020,3,26,9,1552,1481,1146,-335
2020,3,26,10,1579,1491,1199,-292
2020,3,26,11,1616,1552,1258,-294
2020,3,26,12,1719,1650,1398,-252
2020,3,26,13,1864,1786,1439,-347
2020,3,26,14,1988,1916,1549,-367
2020,3,26,15,2022,1943,1604,-339
2020,3,26,16,2020,1892,1706,-186
2020,3,26,17,1951,1854,1823,-31
2020,3,26,18,1840,1807,1642,-165
2020,3,26,19,1765,1757,1425,-332
2020,3,26,20,1762,1706,1559,-147
2020,3,26,21,1743,1666,1483,-183
2020,3,26,22,1712,1636,1502,-134
2020,3,26,23,1691,1640,1377,-263
2020,3,27,0,1704,1639,1608,-31
2020,3,27,1,1725,1660,1798,138
2020,3,27,2,1752,1668,1660,-8
2020,3,27,3,1802,1732,1659,-73
2020,3,27,4,1752,1725,1676,-49
2020,3,27,5,1653,1641,1609,-32
2020,3,27,6,1593,1560,1572,12
2020,3,27,7,1522,1518,1380,-138
2020,3,27,8,1497,1492,1282,-210
2020,3,27,9,1502,1500,1245,-255
2020,3,27,10,1532,1531,1399,-132
2020,3,27,11,1573,1563,1334,-229
2020,3,27,12,1675,1655,1297,-358
2020,3,27,13,1810,1795,1239,-556
2020,3,27,14,1945,1913,1241,-672
2020,3,27,15,1954,1946,1317,-629
2020,3,27,16,1922,1891,1299,-592
2020,3,27,17,1881,1854,1505,-349
2020,3,27,18,1843,1795,1640,-155
2020,3,27,19,1807,1741,1624,-117
2020,3,27,20,1758,1706,1751,45
2020,3,27,21,1729,1654,1608,-46
2020,3,27,22,1701,1627,1484,-143
2020,3,27,23,1683,1619,1550,-69
2020,3,28,0,1680,1633,1512,-121
2020,3,28,1,1671,1644,1752,108
2020,3,28,2,1694,1664,1738,74
2020,3,28,3,1743,1711,1714,3
2020,3,28,4,1725,1669,1528,-141
2020,3,28,5,1658,1585,1518,-67
2020,3,28,6,1566,1506,1384,-122
2020,3,28,7,1492,1447,1365,-82
2020,3,28,8,1463,1425,1311,-114
2020,3,28,9,1472,1420,1375,-45
2020,3,28,10,1486,1421,1387,-34
2020,3,28,11,1511,1438,1356,-82
2020,3,28,12,1552,1488,1436,-52
2020,3,28,13,1604,1558,1450,-108
2020,3,28,14,1690,1641,1618,-23
2020,3,28,15,1781,1687,1442,-245
2020,3,28,16,1801,1694,1335,-359
2020,3,28,17,1782,1683,1461,-222
2020,3,28,18,1749,1639,1534,-105
2020,3,28,19,1695,1600,1432,-168
2020,3,28,20,1641,1567,1441,-126
2020,3,28,21,1600,1494,1401,-93
2020,3,28,22,1580,1518,1513,-5
2020,3,28,23,1566,1491,1472,-19
2020,3,29,0,1584,1525,1540,15
2020,3,29,1,1598,1536,1542,6
2020,3,29,2,1602,1538,1427,-111
2020,3,29,3,1655,1601,1346,-255
2020,3,29,4,1623,1576,1331,-245
2020,3,29,5,1554,1502,1187,-315
2020,3,29,6,1483,1423,1148,-275
2020,3,29,7,1433,1366,1087,-279
2020,3,29,8,1403,1332,1070,-262
2020,3,29,9,1375,1323,1123,-200
2020,3,29,10,1376,1319,1138,-181
2020,3,29,11,1385,1335,1174,-161
2020,3,29,12,1430,1383,1272,-111
2020,3,29,13,1474,1437,1268,-169
2020,3,29,14,1546,1498,1228,-270
2020,3,29,15,1623,1566,1245,-321
2020,3,29,16,1638,1612,1257,-355
2020,3,29,17,1632,1631,1285,-346
2020,3,29,18,1652,1627,1298,-329
2020,3,29,19,1654,1609,1266,-343
2020,3,29,20,1630,1551,1283,-268
2020,3,29,21,1597,1510,1286,-224
2020,3,29,22,1571,1480,1194,-286
2020,3,29,23,1566,1492,1192,-300
2020,3,30,0,1603,1530,1220,-310
2020,3,30,1,1632,1541,1248,-293
2020,3,30,2,1636,1548,1350,-198
2020,3,30,3,1684,1594,1320,-274
2020,3,30,4,1633,1588,1314,-274
2020,3,30,5,1526,1493,1172,-321
2020,3,30,6,1438,1400,1084,-316
2020,3,30,7,1405,1343,1030,-313
2020,3,30,8,1374,1322,929,-393
2020,3,30,9,1377,1320,970,-350
2020,3,30,10,1386,1334,1060,-274
2020,3,30,11,1427,1363,1099,-264
2020,3,30,12,1528,1460,1242,-218
2020,3,30,13,1667,1600,1342,-258
2020,3,30,14,1758,1750,1414,-336
2020,3,30,15,1764,1791,1462,-329
2020,3,30,16,1769,1788,1373,-415
2020,3,30,17,1799,1792,1357,-435
2020,3,30,18,1791,1769,1411,-358
2020,3,30,19,1774,1769,1448,-321
2020,3,30,20,1752,1719,1535,-184
2020,3,30,21,1742,1702,1464,-238
2020,3,30,22,1705,1683,1310,-373
2020,3,30,23,1717,1699,1257,-442
2020,3,31,0,1725,1702,1273,-429
2020,3,31,1,1742,1717,1300,-417
2020,3,31,2,1763,1707,1375,-332
2020,3,31,3,1770,1713,1253,-460
2020,3,31,4,1709,1649,1177,-472
2020,3,31,5,1584,1543,1210,-333
2020,3,31,6,1485,1448,1221,-227
2020,3,31,7,1383,1370,1187,-183
2020,3,31,8,1375,1348,1094,-254
2020,3,31,9,1406,1326,1091,-235
2020,3,31,10,1412,1329,991,-338
2020,3,31,11,1438,1365,954,-411
2020,3,31,12,1526,1436,1146,-290
2020,3,31,13,1664,1576,1490,-86
2020,3,31,14,1769,1681,1501,-180
2020,3,31,15,1788,1733,1462,-271
2020,3,31,16,1789,1753,1460,-293
2020,3,31,17,1801,1731,1386,-345
2020,3,31,18,1810,1738,1347,-391
2020,3,31,19,1776,1736,1246,-490
2020,3,31,20,1755,1719,1456,-263
2020,3,31,21,1750,1686,1429,-257
2020,3,31,22,1740,1661,1569,-92
2020,3,31,23,1736,1649,1471,-178
2020,4,1,0,1747,1689,1509,-180
2020,4,1,1,1759,1644,1569,-75
2020,4,1,2,1782,1686,1676,-10
2020,4,1,3,1786,1737,1582,-155
2020,4,1,4,1750,1693,1590,-103
2020,4,1,5,1646,1611,1531,-80
2020,4,1,6,1559,1517,1488,-29
2020,4,1,7,1479,1513,1430,-83
2020,4,1,8,1482,1432,1382,-50
2020,4,1,9,1507,1436,1289,-147
2020,4,1,10,1533,1447,1237,-210
2020,4,1,11,1582,1483,1226,-257
2020,4,1,12,1678,1581,1372,-209
2020,4,1,13,1818,1710,1468,-242
2020,4,1,14,1930,1840,1490,-350
2020,4,1,15,1959,1869,1515,-354
2020,4,1,16,1965,1843,1535,-308
2020,4,1,17,1948,1839,1603,-236
2020,4,1,18,1848,1786,1555,-231
2020,4,1,19,1824,1755,1434,-321
2020,4,1,20,1796,1722,1412,-310
2020,4,1,21,1768,1610,1376,-234
2020,4,1,22,1738,1670,1411,-259
2020,4,1,23,1718,1661,1525,-136
2020,4,2,0,1750,1708,1483,-225
2020,4,2,1,1777,1724,1581,-143
2020,4,2,2,1782,1751,1736,-15
2020,4,2,3,1869,1786,1647,-139
2020,4,2,4,1830,1755,1588,-167
2020,4,2,5,1716,1661,1536,-125
2020,4,2,6,1626,1575,1519,-56
2020,4,2,7,1567,1521,1393,-128
2020,4,2,8,1563,1529,1360,-169
2020,4,2,9,1577,1513,1362,-151
2020,4,2,10,1623,1535,1404,-131
2020,4,2,11,1654,1577,1342,-235
2020,4,2,12,1727,1673,1414,-259
2020,4,2,13,1898,1808,1529,-279
2020,4,2,14,2043,1936,1594,-342
2020,4,2,15,2037,1936,1627,-309
2020,4,2,16,1977,1904,1716,-188
2020,4,2,17,1908,1852,1672,-180
2020,4,2,18,1899,1804,1653,-151
2020,4,2,19,1871,1767,1581,-186
2020,4,2,20,1799,1705,1563,-142
2020,4,2,21,1724,1666,1541,-125
2020,4,2,22,1692,1637,1519,-118
2020,4,2,23,1740,1619,1599,-20
2020,4,3,0,1716,1642,1659,17
2020,4,3,1,1692,1646,1706,60
2020,4,3,2,1730,1647,1426,-221
2020,4,3,3,1809,1715,1304,-411
2020,4,3,4,1764,1713,1246,-467
2020,4,3,5,1682,1623,1107,-516
2020,4,3,6,1621,1541,1016,-525
2020,4,3,7,1552,1500,960,-540
2020,4,3,8,1558,1487,969,-518
2020,4,3,9,1553,1497,994,-503
2020,4,3,10,1554,1510,987,-523
2020,4,3,11,1605,1545,998,-547
2020,4,3,12,1711,1645,1224,-421
2020,4,3,13,1843,1775,1318,-457
2020,4,3,14,1956,1896,1422,-474
2020,4,3,15,1968,1920,1499,-421
2020,4,3,16,1905,1876,1553,-323
2020,4,3,17,1847,1819,1589,-230
2020,4,3,18,1821,1762,1560,-202
2020,4,3,19,1804,1696,1385,-311
2020,4,3,20,1737,1662,1437,-225
2020,4,3,21,1696,1619,1182,-437
2020,4,3,22,1669,1561,1239,-322
2020,4,3,23,1637,1556,1256,-300
2020,4,4,0,1603,1558,1306,-252
2020,4,4,1,1659,1565,1274,-291
2020,4,4,2,1659,1571,1185,-386
2020,4,4,3,1690,1620,1137,-483
2020,4,4,4,1702,1619,1187,-432
2020,4,4,5,1658,1552,1203,-349
2020,4,4,6,1554,1490,1188,-302
2020,4,4,7,1534,1445,1207,-238
2020,4,4,8,1524,1428,1172,-256
2020,4,4,9,1477,1430,1098,-332
2020,4,4,10,1503,1449,1039,-410
2020,4,4,11,1535,1483,1010,-473
2020,4,4,12,1585,1544,1141,-403
2020,4,4,13,1659,1628,1225,-403
2020,4,4,14,1765,1710,1240,-470
2020,4,4,15,1837,1734,1345,-389
2020,4,4,16,1815,1716,1334,-382
2020,4,4,17,1727,1664,1307,-357
2020,4,4,18,1696,1610,1315,-295
2020,4,4,19,1670,1590,1397,-193
2020,4,4,20,1597,1537,1381,-156
2020,4,4,21,1555,1489,1378,-111
2020,4,4,22,1516,1460,1410,-50
2020,4,4,23,1541,1468,1428,-40
2020,4,5,0,1553,1487,1441,-46
2020,4,5,1,1559,1527,1367,-160
2020,4,5,2,1607,1536,1433,-103
2020,4,5,3,1640,1578,1348,-230
2020,4,5,4,1620,1533,1133,-400
2020,4,5,5,1550,1453,1074,-379
2020,4,5,6,1441,1378,1008,-370
2020,4,5,7,1424,1308,975,-333
2020,4,5,8,1386,1289,951,-338
2020,4,5,9,1333,1287,984,-303
2020,4,5,10,1375,1288,1101,-187
2020,4,5,11,1377,1311,1121,-190
2020,4,5,12,1411,1349,1168,-181
2020,4,5,13,1475,1415,1264,-151
2020,4,5,14,1536,1473,1340,-133
2020,4,5,15,1597,1525,1432,-93
2020,4,5,16,1614,1557,1535,-22
2020,4,5,17,1632,1533,1506,-27
2020,4,5,18,1615,1540,1621,81
2020,4,5,19,1597,1530,1688,158
2020,4,5,20,1581,1521,1546,25
2020,4,5,21,1557,1493,1323,-170
2020,4,5,22,1541,1491,1401,-90
2020,4,5,23,1508,1507,1519,12
2020,4,6,0,1608,1543,1585,42
2020,4,6,1,1632,1538,1589,51
2020,4,6,2,1618,1542,1643,101
2020,4,6,3,1668,1569,1373,-196
2020,4,6,4,1584,1536,1282,-254
2020,4,6,5,1478,1431,1129,-302
2020,4,6,6,1397,1347,1117,-230
2020,4,6,7,1373,1301,1093,-208
2020,4,6,8,1345,1274,1039,-235
2020,4,6,9,1359,1266,1048,-218
2020,4,6,10,1379,1279,1113,-166
2020,4,6,11,1426,1308,1077,-231
2020,4,6,12,1477,1391,1061,-330
2020,4,6,13,1630,1526,1148,-378
2020,4,6,14,1726,1652,1175,-477
2020,4,6,15,1724,1712,1304,-408
2020,4,6,16,1715,1725,1357,-368
2020,4,6,17,1728,1694,1319,-375
2020,4,6,18,1760,1665,1262,-403
2020,4,6,19,1742,1616,1239,-377
2020,4,6,20,1692,1593,1236,-357
2020,4,6,21,1636,1570,1255,-315
2020,4,6,22,1602,1544,1250,-294
2020,4,6,23,1620,1545,1300,-245
2020,4,7,0,1628,1546,1277,-269
2020,4,7,1,1632,1552,1443,-109
2020,4,7,2,1665,1541,1386,-155
2020,4,7,3,1691,1593,1317,-276
2020,4,7,4,1625,1549,1282,-267
2020,4,7,5,1531,1467,1312,-155
2020,4,7,6,1457,1373,1184,-189
2020,4,7,7,1373,1299,1073,-226
2020,4,7,8,1381,1291,1109,-182
2020,4,7,9,1412,1284,1141,-143
2020,4,7,10,1408,1293,1081,-212
2020,4,7,11,1424,1341,1084,-257
2020,4,7,12,1486,1420,1144,-276
2020,4,7,13,1622,1584,1330,-254
2020,4,7,14,1784,1680,1301,-379
2020,4,7,15,1785,1704,1407,-297
2020,4,7,16,1756,1664,1453,-211
2020,4,7,17,1720,1627,1351,-276
2020,4,7,18,1622,1591,1077,-514
2020,4,7,19,1592,1560,1205,-355
2020,4,7,20,1579,1537,1153,-384
2020,4,7,21,1617,1506,1237,-269
2020,4,7,22,1602,1492,1306,-186
2020,4,7,23,1582,1502,1411,-91
2020,4,8,0,1599,1523,1543,20
2020,4,8,1,1628,1552,1651,99
2020,4,8,2,1648,1528,1592,64
2020,4,8,3,1657,1557,1501,-56
2020,4,8,4,1592,1543,1478,-65
2020,4,8,5,1523,1445,1488,43
2020,4,8,6,1456,1341,1412,71
2020,4,8,7,1357,1283,1184,-99
2020,4,8,8,1363,1251,1096,-155
2020,4,8,9,1340,1252,1015,-237
2020,4,8,10,1326,1266,919,-347
2020,4,8,11,1400,1300,903,-397
2020,4,8,12,1489,1394,1013,-381
2020,4,8,13,1612,1535,1315,-220
2020,4,8,14,1725,1644,1331,-313
2020,4,8,15,1762,1677,1478,-199
2020,4,8,16,1715,1674,1549,-125
2020,4,8,17,1678,1636,1541,-95
2020,4,8,18,1690,1605,1594,-11
2020,4,8,19,1751,1582,1472,-110
2020,4,8,20,1685,1561,1457,-104
2020,4,8,21,1639,1549,1526,-23
2020,4,8,22,1627,1525,1496,-29
2020,4,8,23,1589,1527,1509,-18
2020,4,9,0,1590,1554,1582,28
2020,4,9,1,1630,1575,1798,223
2020,4,9,2,1631,1561,1519,-42
2020,4,9,3,1652,1581,1484,-97
2020,4,9,4,1600,1561,1367,-194
2020,4,9,5,1515,1453,1278,-175
2020,4,9,6,1441,1354,1229,-125
2020,4,9,7,1355,1287,1127,-160
2020,4,9,8,1334,1249,1095,-154
2020,4,9,9,1349,1241,1090,-151
2020,4,9,10,1351,1246,1031,-215
2020,4,9,11,1382,1293,1125,-168
2020,4,9,12,1484,1384,1222,-162
2020,4,9,13,1584,1514,1451,-63
2020,4,9,14,1721,1630,1526,-104
2020,4,9,15,1760,1660,1561,-99
2020,4,9,16,1709,1657,1685,28
2020,4,9,17,1667,1633,1605,-28
2020,4,9,18,1691,1602,1635,33
2020,4,9,19,1676,1581,1547,-34
2020,4,9,20,1654,1558,1453,-105
2020,4,9,21,1581,1538,1533,-5
2020,4,9,22,1582,1536,1436,-100
2020,4,9,23,1589,1545,1449,-96
2020,4,10,0,1605,1575,1493,-82
2020,4,10,1,1634,1582,1692,110
2020,4,10,2,1650,1559,1595,36
2020,4,10,3,1696,1586,1520,-66
2020,4,10,4,1639,1572,1530,-42
2020,4,10,5,1542,1456,1532,76
2020,4,10,6,1470,1346,1566,220
2020,4,10,7,1338,1268,1379,111
2020,4,10,8,1318,1234,1273,39
2020,4,10,9,1336,1221,1186,-35
2020,4,10,10,1316,1213,1166,-47
2020,4,10,11,1337,1241,1172,-69
2020,4,10,12,1449,1318,1352,34
2020,4,10,13,1596,1430,1430,0
2020,4,10,14,1659,1527,1432,-95
2020,4,10,15,1658,1571,1536,-35
2020,4,10,16,1679,1582,1544,-38
2020,4,10,17,1626,1568,1619,51
2020,4,10,18,1603,1561,1650,89
2020,4,10,19,1677,1540,1561,21
2020,4,10,20,1690,1527,1588,61
2020,4,10,21,1598,1522,1615,93
2020,4,10,22,1633,1517,1702,185
2020,4,10,23,1627,1538,1769,231
2020,4,11,0,1658,1541,1847,306
2020,4,11,1,1668,1552,1993,441
2020,4,11,2,1644,1535,1896,361
2020,4,11,3,1671,1558,1756,198
2020,4,11,4,1647,1529,1675,146
2020,4,11,5,1535,1436,1584,148
2020,4,11,6,1445,1347,1440,93
2020,4,11,7,1362,1266,1279,13
2020,4,11,8,1338,1237,1341,104
2020,4,11,9,1306,1210,1195,-15
2020,4,11,10,1298,1210,1315,105
2020,4,11,11,1294,1227,1423,196
2020,4,11,12,1342,1258,1490,232
2020,4,11,13,1406,1328,1569,241
2020,4,11,14,1438,1380,1649,269
2020,4,11,15,1512,1446,1763,317
2020,4,11,16,1591,1523,1911,388
2020,4,11,17,1682,1539,1803,264
2020,4,11,18,1647,1555,1841,286
2020,4,11,19,1608,1526,1935,409
2020,4,11,20,1618,1496,1938,442
2020,4,11,21,1619,1466,1923,457
2020,4,11,22,1584,1456,1856,400
2020,4,11,23,1610,1468,1796,328
2020,4,12,0,1632,1498,1998,500
2020,4,12,1,1648,1507,2030,523
2020,4,12,2,1637,1498,2054,556
2020,4,12,3,1653,1535,1947,412
2020,4,12,4,1622,1524,1897,373
2020,4,12,5,1572,1462,1780,318
2020,4,12,6,1516,1383,1724,341
2020,4,12,7,1401,1310,1595,285
2020,4,12,8,1361,1284,1583,299
2020,4,12,9,1387,1275,1516,241
2020,4,12,10,1403,1279,1469,190
2020,4,12,11,1472,1309,1400,91
2020,4,12,12,1476,1355,1463,108
2020,4,12,13,1572,1427,1408,-19
2020,4,12,14,1656,1510,1404,-106
2020,4,12,15,1684,1571,1391,-180
2020,4,12,16,1718,1587,1457,-130
2020,4,12,17,1719,1582,1565,-17
2020,4,12,18,1680,1568,1613,45
2020,4,12,19,1695,1538,1602,64
2020,4,12,20,1663,1500,1504,4
2020,4,12,21,1577,1456,1584,128
2020,4,12,22,1604,1442,1665,223
2020,4,12,23,1632,1437,1568,131
2020,4,13,0,1633,1449,1686,237
2020,4,13,1,1661,1462,1955,493
2020,4,13,2,1628,1470,2016,546
2020,4,13,3,1666,1540,1909,369
2020,4,13,4,1665,1544,1852,308
2020,4,13,5,1592,1476,1674,198
2020,4,13,6,1521,1399,1668,269
2020,4,13,7,1450,1354,1582,228
2020,4,13,8,1437,1341,1455,114
2020,4,13,9,1490,1346,1148,-198
2020,4,13,10,1514,1364,1087,-277
2020,4,13,11,1585,1420,1140,-280
2020,4,13,12,1709,1516,1122,-394
2020,4,13,13,1859,1671,1299,-372
2020,4,13,14,1976,1782,1314,-468
2020,4,13,15,1942,1816,1442,-374
2020,4,13,16,1885,1788,1536,-252
2020,4,13,17,1871,1763,1512,-251
2020,4,13,18,1893,1736,1498,-238
2020,4,13,19,1851,1694,1485,-209
2020,4,13,20,1824,1674,1494,-180
2020,4,13,21,1752,1645,1552,-93
2020,4,13,22,1714,1623,1635,12
2020,4,13,23,1744,1611,1663,52
2020,4,14,0,1733,1634,1882,248
2020,4,14,1,1784,1636,1937,301
2020,4,14,2,1758,1655,1954,299
2020,4,14,3,1756,1691,1839,148
2020,4,14,4,1736,1689,1767,78
2020,4,14,5,1683,1600,1688,88
2020,4,14,6,1602,1521,1550,29
2020,4,14,7,1486,1464,1373,-91
2020,4,14,8,1485,1457,1378,-79
2020,4,14,9,1494,1449,1375,-74
2020,4,14,10,1510,1487,1294,-193
2020,4,14,11,1561,1525,1375,-150
2020,4,14,12,1663,1628,1363,-265
2020,4,14,13,1785,1758,1453,-305
2020,4,14,14,1879,1869,1491,-378
2020,4,14,15,1870,1903,1507,-396
2020,4,14,16,1868,1863,1469,-394
2020,4,14,17,1916,1824,1298,-526
2020,4,14,18,1949,1784,1440,-344
2020,4,14,19,1848,1757,1527,-230
2020,4,14,20,1839,1717,1599,-118
2020,4,14,21,1834,1705,1689,-16
2020,4,14,22,1807,1675,1723,48
2020,4,14,23,1834,1663,1715,52
2020,4,15,0,1822,1688,1800,112
2020,4,15,1,1765,1708,2061,353
2020,4,15,2,1751,1701,1980,279
2020,4,15,3,1795,1734,1733,-1
2020,4,15,4,1764,1712,1618,-94
2020,4,15,5,1662,1608,1543,-65
2020,4,15,6,1610,1502,1557,55
2020,4,15,7,1431,1434,1451,17
2020,4,15,8,1417,1394,1348,-46
2020,4,15,9,1433,1389,1321,-68
2020,4,15,10,1432,1383,1284,-99
2020,4,15,11,1471,1408,1306,-102
2020,4,15,12,1545,1475,1392,-83
2020,4,15,13,1634,1604,1539,-65
2020,4,15,14,1746,1717,1788,71
2020,4,15,15,1773,1766,1802,36
2020,4,15,16,1825,1785,1875,90
2020,4,15,17,1902,1816,1958,142
2020,4,15,18,1938,1837,1979,142
2020,4,15,19,1910,1784,1917,133
2020,4,15,20,1856,1761,1936,175
2020,4,15,21,1862,1730,1943,213
2020,4,15,22,1820,1711,1803,92
2020,4,15,23,1842,1726,1815,89
2020,4,16,0,1861,1735,1820,85
2020,4,16,1,1819,1728,1838,110
2020,4,16,2,1788,1708,1885,177
2020,4,16,3,1813,1732,1857,125
2020,4,16,4,1831,1707,1847,140
2020,4,16,5,1678,1627,1894,267
2020,4,16,6,1557,1532,1931,399
2020,4,16,7,1495,1489,1657,168
2020,4,16,8,1497,1455,1456,1
2020,4,16,9,1545,1447,1493,46
2020,4,16,10,1543,1457,1459,2
2020,4,16,11,1586,1487,1610,123
2020,4,16,12,1700,1589,1640,51
2020,4,16,13,1820,1727,1765,38
2020,4,16,14,1909,1839,1771,-68
2020,4,16,15,1981,1878,1826,-52
2020,4,16,16,1973,1883,1956,73
2020,4,16,17,1971,1850,1991,141
2020,4,16,18,1906,1834,1937,103
2020,4,16,19,1871,1792,1844,52
2020,4,16,20,1833,1751,1783,32
2020,4,16,21,1801,1704,1698,-6
2020,4,16,22,1765,1689,1748,59
2020,4,16,23,1750,1671,1845,174
2020,4,17,0,1768,1666,1719,53
2020,4,17,1,1745,1667,1686,19
2020,4,17,2,1709,1671,1500,-171
2020,4,17,3,1775,1696,1329,-367
2020,4,17,4,1798,1708,1306,-402
2020,4,17,5,1674,1615,1276,-339
2020,4,17,6,1615,1541,1327,-214
2020,4,17,7,1539,1474,1133,-341
2020,4,17,8,1546,1460,1147,-313
2020,4,17,9,1494,1462,1094,-368
2020,4,17,10,1552,1488,1103,-385
2020,4,17,11,1602,1534,1204,-330
2020,4,17,12,1655,1629,1387,-242
2020,4,17,13,1805,1758,1550,-208
2020,4,17,14,1895,1865,1675,-190
2020,4,17,15,1928,1872,1746,-126
2020,4,17,16,1934,1832,1768,-64
2020,4,17,17,1874,1793,2015,222
2020,4,17,18,1822,1787,1814,27
2020,4,17,19,1816,1762,1701,-61
2020,4,17,20,1795,1720,1651,-69
2020,4,17,21,1786,1680,1607,-73
2020,4,17,22,1775,1657,1590,-67
2020,4,17,23,1750,1646,1541,-105
2020,4,18,0,1727,1663,1532,-131
2020,4,18,1,1690,1671,1605,-66
2020,4,18,2,1724,1660,1447,-213
2020,4,18,3,1746,1699,1428,-271
2020,4,18,4,1740,1683,1326,-357
2020,4,18,5,1678,1619,1341,-278
2020,4,18,6,1594,1518,1261,-257
2020,4,18,7,1524,1465,1208,-257
2020,4,18,8,1489,1436,1214,-222
2020,4,18,9,1471,1439,1193,-246
2020,4,18,10,1462,1458,1185,-273
2020,4,18,11,1506,1478,1187,-291
2020,4,18,12,1549,1540,1175,-365
2020,4,18,13,1638,1625,1212,-413
2020,4,18,14,1722,1688,1284,-404
2020,4,18,15,1748,1715,1369,-346
2020,4,18,16,1822,1735,1458,-277
2020,4,18,17,1802,1733,1494,-239
2020,4,18,18,1754,1718,1484,-234
2020,4,18,19,1760,1687,1485,-202
2020,4,18,20,1734,1667,1500,-167
2020,4,18,21,1689,1649,1518,-131
2020,4,18,22,1760,1637,1529,-108
2020,4,18,23,1748,1652,1539,-113
2020,4,19,0,1732,1689,1723,34
2020,4,19,1,1722,1715,1906,191
2020,4,19,2,1716,1721,1840,119
2020,4,19,3,1744,1739,1734,-5
2020,4,19,4,1742,1738,1757,19
2020,4,19,5,1667,1654,1671,17
2020,4,19,6,1601,1559,1554,-5
2020,4,19,7,1454,1481,1510,29
2020,4,19,8,1435,1435,1435,0
2020,4,19,9,1520,1427,1399,-28
2020,4,19,10,1503,1418,1375,-43
2020,4,19,11,1519,1429,1366,-63
2020,4,19,12,1543,1468,1320,-148
2020,4,19,13,1566,1525,1236,-289
2020,4,19,14,1613,1581,1307,-274
2020,4,19,15,1665,1641,1520,-121
2020,4,19,16,1734,1675,1657,-18
2020,4,19,17,1809,1685,1625,-60
2020,4,19,18,1825,1675,1617,-58
2020,4,19,19,1753,1648,1435,-213
2020,4,19,20,1760,1642,1336,-306
2020,4,19,21,1752,1607,1307,-300
2020,4,19,22,1692,1606,1537,-69
2020,4,19,23,1704,1632,1617,-15
2020,4,20,0,1761,1678,1705,27
2020,4,20,1,1793,1699,1967,268
2020,4,20,2,1798,1687,1909,222
2020,4,20,3,1784,1720,1748,28
2020,4,20,4,1771,1704,1769,65
2020,4,20,5,1659,1619,1797,178
2020,4,20,6,1604,1495,1650,155
2020,4,20,7,1451,1438,1484,46
2020,4,20,8,1470,1403,1370,-33
2020,4,20,9,1471,1389,1232,-157
2020,4,20,10,1466,1404,1154,-250
2020,4,20,11,1546,1439,1169,-270
2020,4,20,12,1606,1534,1299,-235
2020,4,20,13,1714,1667,1377,-290
2020,4,20,14,1858,1783,1455,-328
2020,4,20,15,1869,1828,1586,-242
2020,4,20,16,1880,1854,1728,-126
2020,4,20,17,1895,1852,1699,-153
2020,4,20,18,1878,1851,1473,-378
2020,4,20,19,1882,1833,1451,-382
2020,4,20,20,1900,1815,1397,-418
2020,4,20,21,1887,1815,1371,-444
2020,4,20,22,1844,1813,1491,-322
2020,4,20,23,1856,1823,1616,-207
2020,4,21,0,1900,1866,1784,-82
2020,4,21,1,1902,1870,1892,22
2020,4,21,2,1902,1853,1766,-87
2020,4,21,3,1911,1866,1710,-156
2020,4,21,4,1905,1855,1657,-198
2020,4,21,5,1802,1744,1505,-239
2020,4,21,6,1687,1612,1324,-288
2020,4,21,7,1531,1536,1232,-304
2020,4,21,8,1499,1486,1165,-321
2020,4,21,9,1533,1477,1161,-316
2020,4,21,10,1571,1477,1131,-346
2020,4,21,11,1575,1505,1292,-213
2020,4,21,12,1677,1580,1459,-121
2020,4,21,13,1796,1714,1555,-159
2020,4,21,14,1845,1817,1723,-94
2020,4,21,15,1868,1878,1841,-37
2020,4,21,16,1916,1893,1874,-19
2020,4,21,17,1956,1893,1819,-74
2020,4,21,18,1991,1879,1828,-51
2020,4,21,19,2016,1883,1867,-16
2020,4,21,20,2008,1872,1819,-53
2020,4,21,21,2015,1870,1860,-10
2020,4,21,22,1975,1876,1922,46
2020,4,21,23,1984,1894,1955,61
2020,4,22,0,2056,1913,1896,-17
2020,4,22,1,2042,1922,1968,46
2020,4,22,2,1986,1902,2086,184
2020,4,22,3,1986,1909,1964,55
2020,4,22,4,1939,1895,1856,-39
2020,4,22,5,1819,1788,1594,-194
2020,4,22,6,1693,1657,1490,-167
2020,4,22,7,1496,1577,1313,-264
2020,4,22,8,1534,1538,1372,-166
2020,4,22,9,1574,1515,1299,-216
2020,4,22,10,1578,1515,1453,-62
2020,4,22,11,1612,1538,1466,-72
2020,4,22,12,1714,1617,1740,123
2020,4,22,13,1808,1733,1867,134
2020,4,22,14,1915,1830,1797,-33
2020,4,22,15,1944,1889,1842,-47
2020,4,22,16,1964,1901,1741,-160
2020,4,22,17,2026,1906,1807,-99
2020,4,22,18,2043,1895,1704,-191
2020,4,22,19,2004,1903,1678,-225
2020,4,22,20,1982,1877,1692,-185
2020,4,22,21,1964,1878,1704,-174
2020,4,22,22,1929,1878,1865,-13
2020,4,22,23,1964,1901,1857,-44
2020,4,23,0,2008,1911,1952,41
2020,4,23,1,1985,1932,1869,-63
2020,4,23,2,1933,1889,1993,104
2020,4,23,3,1943,1900,2011,111
2020,4,23,4,1952,1882,1783,-99
2020,4,23,5,1831,1771,1552,-219
2020,4,23,6,1728,1656,1438,-218
2020,4,23,7,1575,1584,1439,-145
2020,4,23,8,1596,1548,1208,-340
2020,4,23,9,1601,1523,1252,-271
2020,4,23,10,1598,1528,1286,-242
2020,4,23,11,1609,1545,1335,-210
2020,4,23,12,1688,1595,1469,-126
2020,4,23,13,1813,1707,1698,-9
2020,4,23,14,1875,1818,1803,-15
2020,4,23,15,1934,1875,1809,-66
2020,4,23,16,1981,1904,1933,29
2020,4,23,17,2016,1917,2006,89
2020,4,23,18,2047,1909,1856,-53
2020,4,23,19,2049,1899,1868,-31
2020,4,23,20,2025,1874,1879,5
2020,4,23,21,2020,1870,2016,146
2020,4,23,22,1985,1832,1985,153
2020,4,23,23,1956,1848,2151,303
2020,4,24,0,1961,1855,2202,347
2020,4,24,1,1946,1859,2363,504
2020,4,24,2,1918,1842,2263,421
2020,4,24,3,1960,1839,2129,290
2020,4,24,4,1943,1849,2087,238
2020,4,24,5,1805,1742,1882,140
2020,4,24,6,1712,1639,1737,98
2020,4,24,7,1684,1569,1533,-36
2020,4,24,8,1679,1530,1356,-174
2020,4,24,9,1564,1520,1273,-247
2020,4,24,10,1590,1517,1231,-286
2020,4,24,11,1616,1545,1239,-306
2020,4,24,12,1721,1625,1294,-331
2020,4,24,13,1847,1745,1411,-334
2020,4,24,14,1916,1853,1542,-311
2020,4,24,15,2025,1910,1559,-351
2020,4,24,16,1942,1930,1522,-408
2020,4,24,17,2003,1920,1362,-558
2020,4,24,18,2010,1918,1289,-629
2020,4,24,19,1977,1885,1301,-584
2020,4,24,20,1976,1855,1382,-473
2020,4,24,21,1951,1851,1484,-367
2020,4,24,22,1899,1837,1614,-223
2020,4,24,23,1919,1840,1733,-107
2020,4,25,0,1936,1856,1821,-35
2020,4,25,1,1901,1876,1937,61
2020,4,25,2,1887,1867,1845,-22
2020,4,25,3,1947,1894,1641,-253
2020,4,25,4,1920,1897,1644,-253
2020,4,25,5,1840,1813,1551,-262
2020,4,25,6,1743,1707,1430,-277
2020,4,25,7,1574,1639,1339,-300
2020,4,25,8,1598,1579,1190,-389
2020,4,25,9,1640,1563,1138,-425
2020,4,25,10,1619,1553,1106,-447
2020,4,25,11,1627,1563,1007,-556
2020,4,25,12,1695,1603,1013,-590
2020,4,25,13,1760,1672,1041,-631
2020,4,25,14,1763,1736,1156,-580
2020,4,25,15,1876,1802,1461,-341
2020,4,25,16,1944,1843,1496,-347
2020,4,25,17,2001,1870,1495,-375
2020,4,25,18,2055,1872,1476,-396
2020,4,25,19,2025,1862,1505,-357
2020,4,25,20,1984,1841,1517,-324
2020,4,25,21,1967,1816,1495,-321
2020,4,25,22,1897,1834,1627,-207
2020,4,25,23,1888,1854,1719,-135
2020,4,26,0,1968,1897,1922,25
2020,4,26,1,1977,1924,1991,67
2020,4,26,2,1926,1929,1873,-56
2020,4,26,3,1961,1950,1816,-134
2020,4,26,4,1975,1939,1752,-187
2020,4,26,5,1885,1846,1601,-245
2020,4,26,6,1808,1733,1435,-298
2020,4,26,7,1616,1642,1350,-292
2020,4,26,8,1619,1583,1264,-319
2020,4,26,9,1618,1543,1308,-235
2020,4,26,10,1645,1516,1348,-168
2020,4,26,11,1641,1521,1288,-233
2020,4,26,12,1626,1534,1286,-248
2020,4,26,13,1671,1573,1354,-219
2020,4,26,14,1708,1607,1340,-267
2020,4,26,15,1824,1678,1364,-314
2020,4,26,16,1868,1751,1415,-336
2020,4,26,17,1885,1779,1402,-377
2020,4,26,18,1923,1795,1447,-348
2020,4,26,19,1948,1792,1591,-201
2020,4,26,20,1918,1779,1613,-166
2020,4,26,21,1910,1759,1640,-119
2020,4,26,22,1923,1789,1806,17
2020,4,26,23,1924,1819,1927,108
2020,4,27,0,1965,1871,2004,133
2020,4,27,1,2002,1899,1998,99
2020,4,27,2,1966,1888,1818,-70
2020,4,27,3,1960,1891,1643,-248
2020,4,27,4,1943,1887,1608,-279
2020,4,27,5,1808,1780,1503,-277
2020,4,27,6,1702,1646,1400,-246
2020,4,27,7,1678,1569,1260,-309
2020,4,27,8,1672,1510,1050,-460
2020,4,27,9,1581,1491,1053,-438
2020,4,27,10,1558,1449,1061,-388
2020,4,27,11,1573,1456,1215,-241
2020,4,27,12,1671,1574,1433,-141
2020,4,27,13,1803,1677,1444,-233
2020,4,27,14,1848,1819,1505,-314
2020,4,27,15,1947,1913,1597,-316
2020,4,27,16,2015,1966,1927,-39
2020,4,27,17,2080,1997,2114,117
2020,4,27,18,2079,1993,2191,198
2020,4,27,19,2136,1967,2070,103
2020,4,27,20,2112,1931,2012,81
2020,4,27,21,2093,1924,1890,-34
2020,4,27,22,2068,1926,1925,-1
2020,4,27,23,2018,1932,1858,-74
2020,4,28,0,2046,1972,2013,41
2020,4,28,1,2051,1985,1986,1
2020,4,28,2,2039,1967,1787,-180
2020,4,28,3,2059,1973,1582,-391
2020,4,28,4,2040,1966,1569,-397
2020,4,28,5,1871,1851,1439,-412
2020,4,28,6,1796,1724,1337,-387
2020,4,28,7,1723,1645,1208,-437
2020,4,28,8,1678,1598,1226,-372
2020,4,28,9,1649,1556,1186,-370
2020,4,28,10,1652,1550,1157,-393
2020,4,28,11,1648,1569,1207,-362
2020,4,28,12,1725,1631,1239,-392
2020,4,28,13,1863,1740,1372,-368
2020,4,28,14,1946,1852,1494,-358
2020,4,28,15,2026,1940,1619,-321
2020,4,28,16,2065,1945,1548,-397
2020,4,28,17,2132,1953,1479,-474
2020,4,28,18,2111,1966,1499,-467
2020,4,28,19,2115,1974,1499,-475
2020,4,28,20,2061,1980,1482,-498
2020,4,28,21,2036,1885,1562,-323
2020,4,28,22,1999,2094,1806,-288
2020,4,28,23,2036,2027,1725,-302
2020,4,29,0,2076,2070,1861,-209
2020,4,29,1,2140,2101,1916,-185
2020,4,29,2,2152,2105,1803,-302
2020,4,29,3,2145,2094,1659,-435
2020,4,29,4,2123,2086,1625,-461
2020,4,29,5,2015,1959,1471,-488
2020,4,29,6,1877,1811,1382,-429
2020,4,29,7,1736,1711,1236,-475
2020,4,29,8,1735,1642,1204,-438
2020,4,29,9,1706,1611,1197,-414
2020,4,29,10,1677,1591,1188,-403
2020,4,29,11,1710,1617,1301,-316
2020,4,29,12,1754,1675,1544,-131
2020,4,29,13,1884,1785,1713,-72
2020,4,29,14,1977,1896,1907,11
2020,4,29,15,2080,1976,1984,8
2020,4,29,16,2131,2015,2098,83
2020,4,29,17,2217,2025,2200,175
2020,4,29,18,2167,2063,2214,151
2020,4,29,19,2185,2079,2124,45
2020,4,29,20,2214,2107,2002,-105
2020,4,29,21,2193,2132,1927,-205
2020,4,29,22,2241,2168,1848,-320
2020,4,29,23,2281,2231,1830,-401
2020,4,30,0,2343,2275,1842,-433
2020,4,30,1,2399,2297,1617,-680
2020,4,30,2,2358,2264,1551,-713
2020,4,30,3,2323,2267,1474,-793
2020,4,30,4,2303,2232,1526,-706
2020,4,30,5,2175,2084,1411,-673
2020,4,30,6,1998,1912,1188,-724
2020,4,30,7,1901,1791,1204,-587
2020,4,30,8,1894,1734,1334,-400
2020,4,30,9,1750,1670,1310,-360
2020,4,30,10,1741,1651,1322,-329
2020,4,30,11,1735,1621,1205,-416
2020,4,30,12,1794,1687,1358,-329
2020,4,30,13,1902,1771,1454,-317
2020,4,30,14,1967,1877,1352,-525
2020,4,30,15,2098,1978,1500,-478
2020,4,30,16,2102,2032,1551,-481
2020,4,30,17,2137,2063,1593,-470
2020,4,30,18,2159,2103,1662,-441
2020,4,30,19,2178,2139,1703,-436
2020,4,30,20,2194,2151,1671,-480
2020,4,30,21,2164,2096,1530,-566
2020,4,30,22,2158,2009,1599,-410
2020,4,30,23,2151,2025,2046,21
2020,5,1,0,2122,2031,2281,250
2020,5,1,1,2096,2020,2286,266
2020,5,1,2,2116,2001,2202,201
2020,5,1,3,2120,1995,2095,100
2020,5,1,4,2090,2001,2125,124
2020,5,1,5,1966,1878,1999,121
2020,5,1,6,1849,1742,1750,8
2020,5,1,7,1802,1708,1757,49
2020,5,1,8,1752,1612,1521,-91
2020,5,1,9,1668,1573,1212,-361
2020,5,1,10,1635,1559,1075,-484
2020,5,1,11,1655,1573,1085,-488
2020,5,1,12,1718,1630,1139,-491
2020,5,1,13,1839,1730,1226,-504
2020,5,1,14,1935,1854,1337,-517
2020,5,1,15,2049,1948,1429,-519
2020,5,1,16,2090,1971,1496,-475
2020,5,1,17,2140,1987,1553,-434
2020,5,1,18,2131,1975,1614,-361
2020,5,1,19,2087,1960,1527,-433
2020,5,1,20,2077,1957,1459,-498
2020,5,1,21,2102,1968,1488,-480
2020,5,1,22,2097,1971,1559,-412
2020,5,1,23,2151,1987,1568,-419
2020,5,2,0,2162,2019,1612,-407
2020,5,2,1,2120,2040,1763,-277
2020,5,2,2,2116,2051,1682,-369
2020,5,2,3,2118,2028,1497,-531
2020,5,2,4,2103,2038,1367,-671
2020,5,2,5,2000,1942,1210,-732
2020,5,2,6,1895,1825,1141,-684
2020,5,2,7,1853,1726,988,-738
2020,5,2,8,1792,1670,969,-701
2020,5,2,9,1697,1636,967,-669
2020,5,2,10,1705,1616,951,-665
2020,5,2,11,1717,1612,975,-637
2020,5,2,12,1707,1639,1033,-606
2020,5,2,13,1752,1698,1213,-485
2020,5,2,14,1822,1771,1403,-368
2020,5,2,15,1988,1846,1365,-481
2020,5,2,16,2090,1893,1445,-448
2020,5,2,17,2141,1929,1551,-378
2020,5,2,18,2102,1935,1639,-296
2020,5,2,19,2125,1927,1617,-310
2020,5,2,20,2133,1929,1540,-389
2020,5,2,21,2130,1954,1485,-469
2020,5,2,22,2081,1976,1485,-491
2020,5,2,23,2068,2009,1435,-574
2020,5,3,0,2110,2062,1553,-509
2020,5,3,1,2163,2100,1638,-462
2020,5,3,2,2147,2108,1684,-424
2020,5,3,3,2144,2084,1718,-366
2020,5,3,4,2151,2081,1814,-267
2020,5,3,5,2051,1972,1619,-353
2020,5,3,6,1935,1851,1437,-414
2020,5,3,7,1879,1748,1308,-440
2020,5,3,8,1813,1684,1341,-343
2020,5,3,9,1704,1648,1659,11
2020,5,3,10,1652,1615,1751,136
2020,5,3,11,1668,1622,1743,121
2020,5,3,12,1690,1634,1740,106
2020,5,3,13,1707,1644,1739,95
2020,5,3,14,1777,1701,1812,111
2020,5,3,15,1924,1739,1737,-2
2020,5,3,16,1963,1808,1753,-55
2020,5,3,17,1993,1836,1751,-85
2020,5,3,18,2046,1848,1653,-195
2020,5,3,19,2075,1845,1717,-128
2020,5,3,20,2014,1827,1818,-9
2020,5,3,21,1946,1809,1841,32
2020,5,3,22,1953,1800,1892,92
2020,5,3,23,1903,1831,1940,109
2020,5,4,0,1934,1872,2136,264
2020,5,4,1,1969,1896,2180,284
2020,5,4,2,1984,1906,2104,198
2020,5,4,3,1972,1897,1958,61
2020,5,4,4,1955,1909,1826,-83
2020,5,4,5,1877,1814,1677,-137
2020,5,4,6,1795,1704,1467,-237
2020,5,4,7,1779,1627,1417,-210
2020,5,4,8,1726,1587,1344,-243
2020,5,4,9,1656,1574,1262,-312
2020,5,4,10,1645,1576,1256,-320
2020,5,4,11,1686,1604,1241,-363
2020,5,4,12,1760,1686,1356,-330
2020,5,4,13,1868,1807,1295,-512
2020,5,4,14,1966,1941,1340,-601
2020,5,4,15,2100,2021,1455,-566
2020,5,4,16,2140,2048,1508,-540
2020,5,4,17,2144,2059,1509,-550
2020,5,4,18,2149,2064,1540,-524
2020,5,4,19,2130,2053,1553,-500
2020,5,4,20,2116,2035,1604,-431
2020,5,4,21,2073,2027,1613,-414
2020,5,4,22,2063,2022,1616,-406
2020,5,4,23,2069,2024,1626,-398
2020,5,5,0,2087,2064,1664,-400
2020,5,5,1,2129,2097,1757,-340
2020,5,5,2,2145,2115,1655,-460
2020,5,5,3,2132,2097,1391,-706
2020,5,5,4,2134,2100,1422,-678
2020,5,5,5,2033,1984,1292,-692
2020,5,5,6,1907,1848,990,-858
2020,5,5,7,1824,1739,938,-801
2020,5,5,8,1778,1692,965,-727
2020,5,5,9,1733,1668,943,-725
2020,5,5,10,1724,1660,952,-708
2020,5,5,11,1770,1662,953,-709
2020,5,5,12,1834,1734,1019,-715
2020,5,5,13,1949,1845,1072,-773
2020,5,5,14,2016,1967,1053,-914
2020,5,5,15,2116,2026,1133,-893
2020,5,5,16,2177,2060,1175,-885
2020,5,5,17,2190,2084,1287,-797
2020,5,5,18,2202,2096,1463,-633
2020,5,5,19,2205,2084,1458,-626
2020,5,5,20,2189,2096,1499,-597
2020,5,5,21,2172,2113,1486,-627
2020,5,5,22,2168,2136,1601,-535
2020,5,5,23,2185,2172,1764,-408
2020,5,6,0,2243,2211,1913,-298
2020,5,6,1,2305,2242,1974,-268
2020,5,6,2,2308,2272,1932,-340
2020,5,6,3,2272,2222,1788,-434
2020,5,6,4,2257,2206,1752,-454
2020,5,6,5,2156,2086,1585,-501
2020,5,6,6,2010,1935,1490,-445
2020,5,6,7,1912,1812,1335,-477
2020,5,6,8,1891,1749,1356,-393
2020,5,6,9,1808,1702,1322,-380
2020,5,6,10,1808,1676,1271,-405
2020,5,6,11,1815,1695,1143,-552
2020,5,6,12,1856,1740,1116,-624
2020,5,6,13,1959,1818,1191,-627
2020,5,6,14,1999,1934,1330,-604
2020,5,6,15,2122,2016,1318,-698
2020,5,6,16,2177,2056,1469,-587
2020,5,6,17,2168,2093,1500,-593
2020,5,6,18,2168,2056,1541,-515
2020,5,6,19,2175,2046,1772,-274
2020,5,6,20,2145,2018,1879,-139
2020,5,6,21,2112,2002,1874,-128
2020,5,6,22,2090,2009,1961,-48
2020,5,6,23,2105,2033,2116,83
2020,5,7,0,2117,2041,2273,232
2020,5,7,1,2150,2030,2306,276
2020,5,7,2,2122,2009,2277,268
2020,5,7,3,2100,1969,2047,78
2020,5,7,4,2106,1970,1755,-215
2020,5,7,5,1981,1858,1610,-248
2020,5,7,6,1835,1736,1494,-242
2020,5,7,7,1835,1656,1366,-290
2020,5,7,8,1789,1621,1332,-289
2020,5,7,9,1702,1595,1264,-331
2020,5,7,10,1680,1595,1260,-335
2020,5,7,11,1704,1626,1289,-337
2020,5,7,12,1769,1710,1330,-380
2020,5,7,13,1898,1823,1468,-355
2020,5,7,14,1969,1944,1603,-341
2020,5,7,15,2081,2004,1641,-363
2020,5,7,16,2149,2056,1642,-414
2020,5,7,17,2159,2070,1565,-505
2020,5,7,18,2181,2086,1497,-589
2020,5,7,19,2168,2086,1510,-576
2020,5,7,20,2137,2057,1319,-738
2020,5,7,21,2127,2050,1311,-739
2020,5,7,22,2139,2048,1472,-576
2020,5,7,23,2126,2043,1506,-537
2020,5,8,0,2129,2063,1572,-491
2020,5,8,1,2154,2108,1651,-457
2020,5,8,2,2160,2110,1480,-630
2020,5,8,3,2137,2100,1304,-796
2020,5,8,4,2155,2117,1291,-826
2020,5,8,5,2101,2021,1294,-727
2020,5,8,6,1954,1881,1150,-731
2020,5,8,7,1842,1791,1109,-682
2020,5,8,8,1811,1733,1100,-633
2020,5,8,9,1807,1677,1058,-619
2020,5,8,10,1802,1670,1079,-591
2020,5,8,11,1780,1692,1105,-587
2020,5,8,12,1875,1751,1151,-600
2020,5,8,13,1997,1862,1216,-646
2020,5,8,14,2046,1988,1521,-467
2020,5,8,15,2138,2062,1591,-471
2020,5,8,16,2211,2112,1504,-608
2020,5,8,17,2222,2117,1456,-661
2020,5,8,18,2215,2132,1400,-732
2020,5,8,19,2201,2129,1412,-717
2020,5,8,20,2190,2115,1336,-779
2020,5,8,21,2185,2132,1451,-681
2020,5,8,22,2180,2129,1495,-634
2020,5,8,23,2204,2144,1510,-634
2020,5,9,0,2188,2176,1534,-642
2020,5,9,1,2215,2194,1576,-618
2020,5,9,2,2258,2196,1438,-758
2020,5,9,3,2242,2166,1384,-782
2020,5,9,4,2227,2166,1384,-782
2020,5,9,5,2169,2058,1404,-654
2020,5,9,6,2043,1939,1312,-627
2020,5,9,7,1928,1835,1477,-358
2020,5,9,8,1903,1782,1521,-261
2020,5,9,9,1818,1742,1389,-353
2020,5,9,10,1815,1724,1362,-362
2020,5,9,11,1826,1718,1423,-295
2020,5,9,12,1819,1750,1559,-191
2020,5,9,13,1841,1785,1420,-365
2020,5,9,14,1858,1859,1405,-454
2020,5,9,15,2017,1956,1388,-568
2020,5,9,16,2157,2014,1555,-459
2020,5,9,17,2194,2058,1695,-363
2020,5,9,18,2159,2070,1671,-399
2020,5,9,19,2165,2067,1616,-451
2020,5,9,20,2147,2056,1440,-616
2020,5,9,21,2142,2076,1377,-699
2020,5,9,22,2135,2098,1238,-860
2020,5,9,23,2154,2162,1472,-690
2020,5,10,0,2211,2226,1540,-686
2020,5,10,1,2267,2283,1717,-566
2020,5,10,2,2301,2286,1440,-846
2020,5,10,3,2299,2248,1263,-985
2020,5,10,4,2299,2208,1236,-972
2020,5,10,5,2191,2111,1167,-944
2020,5,10,6,2061,1977,1210,-767
2020,5,10,7,1953,1844,1114,-730
2020,5,10,8,1899,1770,919,-851
2020,5,10,9,1840,1710,932,-778
2020,5,10,10,1796,1705,957,-748
2020,5,10,11,1782,1686,1044,-642
2020,5,10,12,1800,1714,1238,-476
2020,5,10,13,1819,1736,1303,-433
2020,5,10,14,1832,1768,1194,-574
2020,5,10,15,1986,1867,1228,-639
2020,5,10,16,2088,1917,1309,-608
2020,5,10,17,2133,1943,1371,-572
2020,5,10,18,2149,1966,1402,-564
2020,5,10,19,2120,1970,1281,-689
2020,5,10,20,2092,1996,1275,-721
2020,5,10,21,2103,2024,1145,-879
2020,5,10,22,2132,2093,1229,-864
2020,5,10,23,2190,2165,1451,-714
2020,5,11,0,2309,2222,1333,-889
2020,5,11,1,2350,2223,1324,-899
2020,5,11,2,2366,2200,1299,-901
2020,5,11,3,2311,2167,1244,-923
2020,5,11,4,2222,2163,1202,-961
2020,5,11,5,2114,2044,1173,-871
2020,5,11,6,1999,1879,1022,-857
2020,5,11,7,1993,1755,936,-819
2020,5,11,8,1940,1710,1070,-640
2020,5,11,9,1769,1661,1092,-569
2020,5,11,10,1750,1635,1150,-485
2020,5,11,11,1766,1643,1249,-394
2020,5,11,12,1834,1699,1398,-301
2020,5,11,13,1936,1786,1483,-303
2020,5,11,14,1971,1937,1655,-282
2020,5,11,15,2120,2040,1650,-390
2020,5,11,16,2210,2135,1643,-492
2020,5,11,17,2230,2204,1574,-630
2020,5,11,18,2258,2269,1457,-812
2020,5,11,19,2311,2319,1545,-774
2020,5,11,20,2327,2335,1562,-773
2020,5,11,21,2381,2369,1478,-891
2020,5,11,22,2400,2361,1236,-1125
2020,5,11,23,2435,2403,1571,-832
2020,5,12,0,2439,2438,1351,-1087
2020,5,12,1,2483,2473,1552,-921
2020,5,12,2,2487,2459,1315,-1144
2020,5,12,3,2444,2402,1201,-1201
2020,5,12,4,2422,2374,1146,-1228
2020,5,12,5,2294,2218,1133,-1085
2020,5,12,6,2114,2046,1216,-830
2020,5,12,7,2021,1926,1312,-614
2020,5,12,8,1934,1837,1150,-687
2020,5,12,9,1880,1800,1102,-698
2020,5,12,10,1864,1771,1097,-674
2020,5,12,11,1868,1763,1149,-614
2020,5,12,12,1909,1803,1190,-613
2020,5,12,13,2011,1884,1139,-745
2020,5,12,14,2041,2000,1008,-992
2020,5,12,15,2138,2098,1185,-913
2020,5,12,16,2216,2146,1388,-758
2020,5,12,17,2237,2165,1251,-914
2020,5,12,18,2245,2199,1289,-910
2020,5,12,19,2276,2218,1182,-1036
2020,5,12,20,2273,2229,1251,-978
2020,5,12,21,2256,2232,1264,-968
2020,5,12,22,2266,2212,1150,-1062
2020,5,12,23,2272,2194,1274,-920
2020,5,13,0,2279,2190,1388,-802
2020,5,13,1,2289,2196,1226,-970
2020,5,13,2,2274,2192,1174,-1018
2020,5,13,3,2228,2163,1198,-965
2020,5,13,4,2214,2151,1109,-1042
2020,5,13,5,2110,2048,1002,-1046
2020,5,13,6,1954,1932,1024,-908
2020,5,13,7,1885,1839,1000,-839
2020,5,13,8,1870,1769,888,-881
2020,5,13,9,1812,1748,974,-774
2020,5,13,10,1788,1727,949,-778
2020,5,13,11,1809,1752,891,-861
2020,5,13,12,1866,1808,870,-938
2020,5,13,13,1973,1912,907,-1005
2020,5,13,14,2064,2028,870,-1158
2020,5,13,15,2149,2128,875,-1253
2020,5,13,16,2216,2177,938,-1239
2020,5,13,17,2233,2183,1069,-1114
2020,5,13,18,2238,2174,1139,-1035
2020,5,13,19,2234,2165,1109,-1056
2020,5,13,20,2219,2145,1186,-959
2020,5,13,21,2217,2103,1224,-879
2020,5,13,22,2212,2091,1298,-793
2020,5,13,23,2190,2079,1265,-814
2020,5,14,0,2201,2095,1346,-749
2020,5,14,1,2201,2110,1375,-735
2020,5,14,2,2193,2112,1322,-790
2020,5,14,3,2182,2117,1265,-852
2020,5,14,4,2178,2114,1131,-983
2020,5,14,5,2066,2038,1071,-967
2020,5,14,6,1946,1915,1008,-907
2020,5,14,7,1890,1827,935,-892
2020,5,14,8,1912,1788,795,-993
2020,5,14,9,1881,1745,744,-1001
2020,5,14,10,1810,1728,709,-1019
2020,5,14,11,1823,1729,733,-996
2020,5,14,12,1881,1780,960,-820
2020,5,14,13,1977,1894,1110,-784
2020,5,14,14,2048,2037,1068,-969
2020,5,14,15,2200,2094,1024,-1070
2020,5,14,16,2271,2137,1097,-1040
2020,5,14,17,2266,2132,1132,-1000
2020,5,14,18,2253,2140,905,-1235
2020,5,14,19,2244,2125,977,-1148
2020,5,14,20,2206,2119,1016,-1103
2020,5,14,21,2188,2084,989,-1095
2020,5,14,22,2193,2069,1050,-1019
2020,5,14,23,2198,2050,1052,-998
2020,5,15,0,2202,2053,1030,-1023
2020,5,15,1,2200,2077,1160,-917
2020,5,15,2,2176,2090,1120,-970
2020,5,15,3,2188,2080,1191,-889
2020,5,15,4,2207,2089,997,-1092
2020,5,15,5,2087,2006,978,-1028
2020,5,15,6,1960,1885,977,-908
2020,5,15,7,1918,1798,901,-897
2020,5,15,8,1923,1741,946,-795
2020,5,15,9,1824,1715,842,-873
2020,5,15,10,1780,1715,893,-822
2020,5,15,11,1793,1711,920,-791
2020,5,15,12,1877,1778,994,-784
2020,5,15,13,1978,1859,1159,-700
2020,5,15,14,2019,1996,1246,-750
2020,5,15,15,2176,2040,1338,-702
2020,5,15,16,2250,2063,1399,-664
2020,5,15,17,2244,2078,1436,-642
2020,5,15,18,2207,2071,1345,-726
2020,5,15,19,2194,2056,1450,-606
2020,5,15,20,2177,2024,1617,-407
2020,5,15,21,2159,2011,1687,-324
2020,5,15,22,2149,2001,1726,-275
2020,5,15,23,2139,1993,1833,-160
2020,5,16,0,2106,2013,1911,-102
2020,5,16,1,2107,2019,1913,-106
2020,5,16,2,2149,2015,1888,-127
2020,5,16,3,2134,1995,1394,-601
2020,5,16,4,2142,2011,1305,-706
2020,5,16,5,2025,1946,990,-956
2020,5,16,6,1929,1832,979,-853
2020,5,16,7,1988,1746,872,-874
2020,5,16,8,1941,1687,816,-871
2020,5,16,9,1785,1650,740,-910
2020,5,16,10,1733,1653,722,-931
2020,5,16,11,1752,1650,748,-902
2020,5,16,12,1775,1668,771,-897
2020,5,16,13,1815,1726,922,-804
2020,5,16,14,1820,1829,1148,-681
2020,5,16,15,2040,1913,1176,-737
2020,5,16,16,2179,1964,1300,-664
2020,5,16,17,2154,1982,1349,-633
2020,5,16,18,2082,1979,1362,-617
2020,5,16,19,2114,1968,1426,-542
2020,5,16,20,2102,1950,1340,-610
2020,5,16,21,2060,1936,1351,-585
2020,5,16,22,2053,1943,1475,-468
2020,5,16,23,2055,1934,1495,-439
2020,5,17,0,2099,1952,1435,-517
2020,5,17,1,2096,1980,1552,-428
2020,5,17,2,2089,1985,1358,-627
2020,5,17,3,2098,1994,1364,-630
2020,5,17,4,2127,2001,1266,-735
2020,5,17,5,2040,1933,1286,-647
2020,5,17,6,1942,1804,1276,-528
2020,5,17,7,1976,1704,1165,-539
2020,5,17,8,1910,1646,1197,-449
2020,5,17,9,1844,1607,1068,-539
2020,5,17,10,1739,1585,1060,-525
2020,5,17,11,1695,1573,986,-587
2020,5,17,12,1699,1588,962,-626
2020,5,17,13,1744,1609,960,-649
2020,5,17,14,1747,1662,981,-681
2020,5,17,15,1940,1739,1107,-632
2020,5,17,16,2061,1812,1213,-599
2020,5,17,17,2013,1858,1122,-736
2020,5,17,18,1959,1871,1242,-629
2020,5,17,19,1976,1883,1196,-687
2020,5,17,20,2017,1867,1242,-625
2020,5,17,21,2012,1862,1304,-558
2020,5,17,22,1983,1892,1307,-585
2020,5,17,23,2008,1918,1282,-636
2020,5,18,0,2048,1992,1262,-730
2020,5,18,1,2093,1989,1201,-788
2020,5,18,2,2125,1964,1109,-855
2020,5,18,3,2088,1938,1094,-844
2020,5,18,4,2069,1945,1181,-764
2020,5,18,5,1945,1841,1240,-601
2020,5,18,6,1809,1707,1263,-444
2020,5,18,7,1876,1614,1243,-371
2020,5,18,8,1819,1549,1142,-407
2020,5,18,9,1681,1517,1155,-362
2020,5,18,10,1633,1503,958,-545
2020,5,18,11,1652,1505,873,-632
2020,5,18,12,1706,1573,894,-679
2020,5,18,13,1825,1678,899,-779
2020,5,18,14,1876,1825,1122,-703
2020,5,18,15,1993,1952,1161,-791
2020,5,18,16,2081,2028,1399,-629
2020,5,18,17,2091,2062,1346,-716
2020,5,18,18,2166,2101,1212,-889
2020,5,18,19,2162,2100,1156,-944
2020,5,18,20,2160,2103,1186,-917
2020,5,18,21,2137,2082,1431,-651
2020,5,18,22,2140,2074,1442,-632
2020,5,18,23,2147,2054,1409,-645
2020,5,19,0,2162,2057,1438,-619
2020,5,19,1,2167,2047,1355,-692
2020,5,19,2,2156,2017,1216,-801
2020,5,19,3,2114,1996,1023,-973
2020,5,19,4,2082,1986,972,-1014
2020,5,19,5,1976,1904,975,-929
2020,5,19,6,1983,1788,929,-859
2020,5,19,7,1730,1712,924,-788
2020,5,19,8,1603,1667,905,-762
2020,5,19,9,1680,1648,813,-835
2020,5,19,10,1680,1636,813,-823
2020,5,19,11,1711,1642,823,-819
2020,5,19,12,1800,1708,895,-813
2020,5,19,13,1909,1809,969,-840
2020,5,19,14,2020,1950,999,-951
2020,5,19,15,2052,2015,930,-1085
2020,5,19,16,2062,2049,1051,-998
2020,5,19,17,2110,2074,1178,-896
2020,5,19,18,2160,2059,964,-1095
2020,5,19,19,2138,2066,1047,-1019
2020,5,19,20,2109,2038,1192,-846
2020,5,19,21,2102,2015,1234,-781
2020,5,19,22,2093,2005,1140,-865
2020,5,19,23,2056,1990,1113,-877
2020,5,20,0,2085,1989,975,-1014
2020,5,20,1,2090,1998,1036,-962
2020,5,20,2,2082,1982,968,-1014
2020,5,20,3,2028,1995,1005,-990
2020,5,20,4,2035,1954,980,-974
2020,5,20,5,1987,1855,1027,-828
2020,5,20,6,1988,1739,987,-752
2020,5,20,7,1650,1669,1058,-611
2020,5,20,8,1594,1630,1065,-565
2020,5,20,9,1657,1605,1012,-593
2020,5,20,10,1665,1592,1056,-536
2020,5,20,11,1702,1617,972,-645
2020,5,20,12,1763,1661,934,-727
2020,5,20,13,1861,1768,943,-825
2020,5,20,14,1969,1884,958,-926
2020,5,20,15,1996,1981,820,-1161
2020,5,20,16,2024,1994,800,-1194
2020,5,20,17,2156,2035,838,-1197
2020,5,20,18,2167,2018,1032,-986
2020,5,20,19,2136,2020,1007,-1013
2020,5,20,20,2165,1994,1153,-841
2020,5,20,21,2088,1980,1169,-811
2020,5,20,22,2079,1913,1065,-848
2020,5,20,23,2073,1952,1043,-909
2020,5,21,0,2076,1886,1100,-786
2020,5,21,1,2107,1918,1265,-653
2020,5,21,2,2059,1905,1230,-675
2020,5,21,3,2057,1906,1257,-649
2020,5,21,4,2068,1895,1459,-436
2020,5,21,5,1975,1794,1455,-339
2020,5,21,6,1907,1679,1457,-222
2020,5,21,7,1855,1574,1007,-567
2020,5,21,8,1764,1535,1094,-441
2020,5,21,9,1632,1517,1086,-431
2020,5,21,10,1609,1507,1010,-497
2020,5,21,11,1612,1499,928,-571
2020,5,21,12,1661,1589,1033,-556
2020,5,21,13,1764,1675,1185,-490
2020,5,21,14,1873,1781,1275,-506
2020,5,21,15,2048,1815,1373,-442
2020,5,21,16,2107,1812,1481,-331
2020,5,21,17,2091,1834,1722,-112
2020,5,21,18,2039,1840,1578,-262
2020,5,21,19,1998,1825,1573,-252
2020,5,21,20,1970,1796,1590,-206
2020,5,21,21,1958,1766,1583,-183
2020,5,21,22,1950,1753,1580,-173
2020,5,21,23,1973,1750,1562,-188
2020,5,22,0,1929,1774,1460,-314
2020,5,22,1,1873,1771,1571,-200
2020,5,22,2,1926,1759,1511,-248
2020,5,22,3,1958,1758,1323,-435
2020,5,22,4,1928,1757,1208,-549
2020,5,22,5,1806,1696,1097,-599
2020,5,22,6,1661,1570,1001,-569
2020,5,22,7,1823,1503,1037,-466
2020,5,22,8,1687,1463,1114,-349
2020,5,22,9,1533,1434,1035,-399
2020,5,22,10,1525,1422,854,-568
2020,5,22,11,1532,1446,879,-567
2020,5,22,12,1574,1520,1171,-349
2020,5,22,13,1690,1627,1394,-233
2020,5,22,14,1808,1743,1531,-212
2020,5,22,15,1953,1808,1506,-302
2020,5,22,16,1986,1824,1614,-210
2020,5,22,17,1928,1843,1708,-135
2020,5,22,18,1891,1840,1749,-91
2020,5,22,19,1909,1796,1706,-90
2020,5,22,20,1889,1763,1550,-213
2020,5,22,21,1863,1712,1439,-273
2020,5,22,22,1847,1681,1458,-223
2020,5,22,23,1847,1656,1440,-216
2020,5,23,0,1828,1641,1495,-146
2020,5,23,1,1812,1651,1526,-125
2020,5,23,2,1774,1646,1644,-2
2020,5,23,3,1798,1629,1876,247
2020,5,23,4,1785,1620,1770,150
2020,5,23,5,1765,1583,1470,-113
2020,5,23,6,1676,1488,1576,88
2020,5,23,7,1770,1417,1456,39
2020,5,23,8,1619,1388,1491,103
2020,5,23,9,1460,1364,1521,157
2020,5,23,10,1435,1365,1476,111
2020,5,23,11,1450,1369,1451,82
2020,5,23,12,1496,1428,1522,94
2020,5,23,13,1539,1459,1513,54
2020,5,23,14,1616,1502,1559,57
2020,5,23,15,1762,1518,1642,124
2020,5,23,16,1822,1535,1560,25
2020,5,23,17,1784,1529,1417,-112
2020,5,23,18,1711,1510,1290,-220
2020,5,23,19,1749,1473,1299,-174
2020,5,23,20,1656,1424,1204,-220
2020,5,23,21,1585,1415,1342,-73
2020,5,23,22,1565,1393,1356,-37
2020,5,23,23,1594,1398,1348,-50
2020,5,24,0,1653,1420,1326,-94
2020,5,24,1,1593,1443,1623,180
2020,5,24,2,1556,1431,1628,197
2020,5,24,3,1653,1428,1457,29
2020,5,24,4,1629,1447,1388,-59
2020,5,24,5,1462,1412,1368,-44
2020,5,24,6,1427,1311,1249,-62
2020,5,24,7,1688,1252,1195,-57
2020,5,24,8,1545,1213,1221,8
2020,5,24,9,1287,1203,1182,-21
2020,5,24,10,1311,1192,1147,-45
2020,5,24,11,1308,1213,1164,-49
2020,5,24,12,1314,1245,1154,-91
2020,5,24,13,1360,1272,1183,-89
2020,5,24,14,1415,1308,1255,-53
2020,5,24,15,1580,1345,1382,37
2020,5,24,16,1638,1390,1433,43
2020,5,24,17,1605,1384,1258,-126
2020,5,24,18,1495,1373,1207,-166
2020,5,24,19,1461,1359,1171,-188
2020,5,24,20,1480,1344,1273,-71
2020,5,24,21,1453,1336,1294,-42
2020,5,24,22,1489,1358,1520,162
2020,5,24,23,1439,1375,1602,227
2020,5,25,0,1478,1412,1749,337
2020,5,25,1,1548,1439,1758,319
2020,5,25,2,1533,1458,1773,315
2020,5,25,3,1554,1445,1613,168
2020,5,25,4,1560,1461,1563,102
2020,5,25,5,1459,1411,1510,99
2020,5,25,6,1392,1302,1522,220
2020,5,25,7,1589,1228,1508,280
2020,5,25,8,1414,1182,1436,254
2020,5,25,9,1290,1150,1395,245
2020,5,25,10,1305,1163,1420,257
2020,5,25,11,1306,1185,1406,221
2020,5,25,12,1362,1206,1395,189
2020,5,25,13,1487,1254,1402,148
2020,5,25,14,1530,1322,1519,197
2020,5,25,15,1531,1310,1444,134
2020,5,25,16,1513,1422,1481,59
2020,5,25,17,1520,1438,1407,-31
2020,5,25,18,1585,1548,1482,-66
2020,5,25,19,1653,1558,1415,-143
2020,5,25,20,1719,1595,1456,-139
2020,5,25,21,1680,1608,1436,-172
2020,5,25,22,1704,1654,1429,-225
2020,5,25,23,1705,1659,1430,-229
2020,5,26,0,1743,1799,1553,-246
2020,5,26,1,1842,1808,1546,-262
2020,5,26,2,1882,1791,1508,-283
2020,5,26,3,1888,1774,1443,-331
2020,5,26,4,1869,1782,1418,-364
2020,5,26,5,1739,1688,1341,-347
2020,5,26,6,1645,1543,1387,-156
2020,5,26,7,1721,1441,1422,-19
2020,5,26,8,1522,1381,1424,43
2020,5,26,9,1449,1346,1472,126
2020,5,26,10,1431,1323,1477,154
2020,5,26,11,1438,1331,1437,106
2020,5,26,12,1465,1379,1450,71
2020,5,26,13,1534,1498,1546,48
2020,5,26,14,1645,1627,1580,-47
2020,5,26,15,1704,1742,1546,-196
2020,5,26,16,1810,1794,1656,-138
2020,5,26,17,1858,1850,1652,-198
2020,5,26,18,1863,1886,1666,-220
2020,5,26,19,1888,1949,2001,52
2020,5,26,20,1931,1970,2141,171
2020,5,26,21,1982,1986,2089,103
2020,5,26,22,2018,2018,1903,-115
2020,5,26,23,2064,2046,1939,-107
2020,5,27,0,2144,2096,1964,-132
2020,5,27,1,2168,2133,1998,-135
2020,5,27,2,2203,2115,2037,-78
2020,5,27,3,2218,2065,1748,-317
2020,5,27,4,2281,2026,1641,-385
2020,5,27,5,2140,1923,1723,-200
2020,5,27,6,1989,1749,1669,-80
2020,5,27,7,1671,1622,1676,54
2020,5,27,8,1532,1544,1681,137
2020,5,27,9,1630,1491,1670,179
2020,5,27,10,1615,1470,1648,178
2020,5,27,11,1583,1469,1637,168
2020,5,27,12,1641,1522,1627,105
2020,5,27,13,1744,1619,1649,30
2020,5,27,14,1836,1751,1778,27
2020,5,27,15,1917,1869,1855,-14
2020,5,27,16,1957,1980,1964,-16
2020,5,27,17,2032,2026,1990,-36
2020,5,27,18,2095,2107,2069,-38
2020,5,27,19,2148,2142,2129,-13
2020,5,27,20,2185,2210,2196,-14
2020,5,27,21,2217,2261,2219,-42
2020,5,27,22,2297,2316,2193,-123
2020,5,27,23,2340,2357,2192,-165
2020,5,28,0,2401,2429,2213,-216
2020,5,28,1,2483,2453,2318,-135
2020,5,28,2,2535,2448,2309,-139
2020,5,28,3,2513,2387,2114,-273
2020,5,28,4,2408,2313,2075,-238
2020,5,28,5,2281,2174,1941,-233
2020,5,28,6,2111,1977,1931,-46
2020,5,28,7,1601,1844,1773,-71
2020,5,28,8,1606,1753,1818,65
2020,5,28,9,1741,1706,1718,12
2020,5,28,10,1723,1673,1632,-41
2020,5,28,11,1738,1669,1619,-50
2020,5,28,12,1798,1715,1674,-41
2020,5,28,13,1879,1799,1699,-100
2020,5,28,14,2013,1956,1838,-118
2020,5,28,15,2096,2095,1952,-143
2020,5,28,16,2204,2172,1995,-177
2020,5,28,17,2320,2245,2030,-215
2020,5,28,18,2372,2284,2024,-260
2020,5,28,19,2444,2385,2076,-309
2020,5,28,20,2527,2463,2063,-400
2020,5,28,21,2570,2549,2135,-414
2020,5,28,22,2588,2636,2147,-489
2020,5,28,23,2661,2724,2190,-534
2020,5,29,0,2790,2802,2199,-603
2020,5,29,1,2898,2861,2200,-661
2020,5,29,2,2848,2863,2149,-714
2020,5,29,3,2852,2805,2005,-800
2020,5,29,4,2701,2714,1956,-758
2020,5,29,5,2477,2550,1974,-576
2020,5,29,6,2280,2326,1923,-403
2020,5,29,7,1944,2174,1924,-250
2020,5,29,8,1955,2043,1944,-99
2020,5,29,9,2092,1969,1949,-20
2020,5,29,10,2023,1915,2003,88
2020,5,29,11,1987,1899,1968,69
2020,5,29,12,2012,1925,1987,62
2020,5,29,13,2107,2008,1937,-71
2020,5,29,14,2231,2163,1941,-222
2020,5,29,15,2373,2322,2071,-251
2020,5,29,16,2474,2458,2045,-413
2020,5,29,17,2592,2549,1949,-600
2020,5,29,18,2719,2676,1978,-698
2020,5,29,19,2806,2786,1944,-842
2020,5,29,20,2939,2886,2110,-776
2020,5,29,21,3038,3010,2222,-788
2020,5,29,22,3135,3066,2260,-806
2020,5,29,23,3204,3121,2329,-792
2020,5,30,0,3227,3160,2420,-740
2020,5,30,1,3260,3173,2403,-770
2020,5,30,2,3255,3156,2334,-822
2020,5,30,3,3130,3051,2214,-837
2020,5,30,4,3096,2922,2232,-690
2020,5,30,5,2888,2767,2103,-664
2020,5,30,6,2624,2535,2020,-515
2020,5,30,7,2226,2350,1936,-414
2020,5,30,8,2235,2199,1994,-205
2020,5,30,9,2252,2095,1977,-118
2020,5,30,10,2157,2033,1919,-114
2020,5,30,11,2160,1994,1994,0
2020,5,30,12,2128,1994,2085,91
2020,5,30,13,2079,2005,2077,72
2020,5,30,14,2172,2106,2057,-49
2020,5,30,15,2413,2239,2116,-123
2020,5,30,16,2606,2381,2269,-112
2020,5,30,17,2736,2490,2319,-171
2020,5,30,18,2804,2583,2352,-231
2020,5,30,19,2901,2718,2353,-365
2020,5,30,20,2968,2835,2394,-441
2020,5,30,21,2978,2928,2420,-508
2020,5,30,22,3046,2956,2456,-500
2020,5,30,23,3124,2955,2434,-521
2020,5,31,0,3136,2902,2356,-546
2020,5,31,1,3112,2775,2234,-541
2020,5,31,2,2972,2735,2031,-704
2020,5,31,3,2874,2672,2019,-653
2020,5,31,4,2662,2580,2024,-556
2020,5,31,5,2520,2470,2057,-413
2020,5,31,6,2301,2272,1902,-370
2020,5,31,7,2164,2132,2062,-70
2020,5,31,8,2061,2038,2317,279
2020,5,31,9,1912,1971,2317,346
2020,5,31,10,1918,1901,2001,100
2020,5,31,11,1863,1849,1910,61
2020,5,31,12,1844,1837,1804,-33
2020,5,31,13,1852,1824,1650,-174
2020,5,31,14,1964,1892,1768,-124
2020,5,31,15,2097,2025,1901,-124
2020,5,31,16,2208,2134,1975,-159
2020,5,31,17,2222,2206,1895,-311
2020,5,31,18,2239,2269,1845,-424
2020,5,31,19,2306,2318,1881,-437
2020,5,31,20,2359,2341,1831,-510
2020,5,31,21,2413,2382,1837,-545
2020,5,31,22,2455,2432,2015,-417
2020,5,31,23,2483,2477,1981,-496
2020,6,1,0,2510,2532,2034,-498
2020,6,1,1,2569,2549,2038,-511
2020,6,1,2,2582,2531,1976,-555
2020,6,1,3,2494,2435,1823,-612
2020,6,1,4,2420,2386,1771,-615
2020,6,1,5,2259,2267,1772,-495
2020,6,1,6,2126,2079,1734,-345
2020,6,1,7,1983,1961,1716,-245
2020,6,1,8,1874,1860,1609,-251
2020,6,1,9,1863,1813,1579,-234
2020,6,1,10,1848,1778,1520,-258
2020,6,1,11,1859,1777,1515,-262
2020,6,1,12,1905,1824,1496,-328
2020,6,1,13,2008,1931,1499,-432
2020,6,1,14,2142,2071,1560,-511
2020,6,1,15,2237,2184,1660,-524
2020,6,1,16,2304,2248,1740,-508
2020,6,1,17,2375,2314,1816,-498
2020,6,1,18,2431,2358,1863,-495
2020,6,1,19,2451,2390,2034,-356
2020,6,1,20,2522,2426,2221,-205
2020,6,1,21,2562,2465,2266,-199
2020,6,1,22,2566,2492,2227,-265
2020,6,1,23,2590,2517,2202,-315
2020,6,2,0,2605,2529,2086,-443
2020,6,2,1,2600,2499,1971,-528
2020,6,2,2,2602,2491,1916,-575
2020,6,2,3,2549,2458,1846,-612
2020,6,2,4,2480,2438,1810,-628
2020,6,2,5,2381,2335,1754,-581
2020,6,2,6,2057,2168,1780,-388
2020,6,2,7,2222,2028,1562,-466
2020,6,2,8,2158,1952,1423,-529
2020,6,2,9,1987,1880,1322,-558
2020,6,2,10,1929,1851,1260,-591
2020,6,2,11,1937,1839,1246,-593
2020,6,2,12,1959,1885,1236,-649
2020,6,2,13,2040,1964,1287,-677
2020,6,2,14,2176,2133,1609,-524
2020,6,2,15,2334,2230,1692,-538
2020,6,2,16,2440,2310,1767,-543
2020,6,2,17,2491,2360,1827,-533
2020,6,2,18,2531,2430,1824,-606
2020,6,2,19,2575,2473,1811,-662
2020,6,2,20,2631,2542,1773,-769
2020,6,2,21,2645,2622,1820,-802
2020,6,2,22,2662,2710,1994,-716
2020,6,2,23,2780,2779,2023,-756
2020,6,3,0,2844,2847,2103,-744
2020,6,3,1,2899,2867,2031,-836
2020,6,3,2,2925,2857,2075,-782
2020,6,3,3,2894,2777,1911,-866
2020,6,3,4,2776,2705,1804,-901
2020,6,3,5,2604,2573,1949,-624
2020,6,3,6,2425,2371,1924,-447
2020,6,3,7,2408,2184,1725,-459
2020,6,3,8,2355,2071,1433,-638
2020,6,3,9,2128,1989,1158,-831
2020,6,3,10,2085,1943,1226,-717
2020,6,3,11,2036,1928,1306,-622
2020,6,3,12,2036,1961,1365,-596
2020,6,3,13,2116,2037,1517,-520
2020,6,3,14,2246,2189,1491,-698
2020,6,3,15,2447,2298,1498,-800
2020,6,3,16,2525,2383,1529,-854
2020,6,3,17,2569,2481,1624,-857
2020,6,3,18,2650,2551,1583,-968
2020,6,3,19,2719,2599,1725,-874
2020,6,3,20,2759,2686,1854,-832
2020,6,3,21,2790,2761,1927,-834
2020,6,3,22,2877,2826,2024,-802
2020,6,3,23,2938,2852,2163,-689
2020,6,4,0,2986,2860,2200,-660
2020,6,4,1,2962,2863,1933,-930
2020,6,4,2,2906,2863,1897,-966
2020,6,4,3,2834,2815,1925,-890
2020,6,4,4,2774,2723,1755,-968
2020,6,4,5,2656,2586,1647,-939
2020,6,4,6,2454,2366,1533,-833
2020,6,4,7,2230,2197,1455,-742
2020,6,4,8,2168,2084,1408,-676
2020,6,4,9,2095,2022,1374,-648
2020,6,4,10,2050,1965,1325,-640
2020,6,4,11,2029,1948,1391,-557
2020,6,4,12,2017,1984,1544,-440
2020,6,4,13,2110,2069,1619,-450
2020,6,4,14,2271,2206,1802,-404
2020,6,4,15,2386,2319,1938,-381
2020,6,4,16,2455,2406,1990,-416
2020,6,4,17,2538,2465,2101,-364
2020,6,4,18,2595,2515,2012,-503
2020,6,4,19,2600,2544,1961,-583
2020,6,4,20,2644,2604,1901,-703
2020,6,4,21,2694,2648,1860,-788
2020,6,4,22,2741,2733,2063,-670
2020,6,4,23,2775,2774,2182,-592
2020,6,5,0,2835,2800,2094,-706
2020,6,5,1,2860,2840,2061,-779
2020,6,5,2,2818,2827,1952,-875
2020,6,5,3,2787,2751,1743,-1008
2020,6,5,4,2770,2688,1774,-914
2020,6,5,5,2659,2554,1749,-805
2020,6,5,6,2431,2349,1574,-775
2020,6,5,7,2197,2200,1429,-771
2020,6,5,8,2141,2084,1336,-748
2020,6,5,9,2108,2003,1289,-714
2020,6,5,10,2045,1954,1191,-763
2020,6,5,11,2051,1939,1183,-756
2020,6,5,12,2085,1960,1211,-749
2020,6,5,13,2165,2030,1208,-822
2020,6,5,14,2309,2167,1350,-817
2020,6,5,15,2428,2279,1469,-810
2020,6,5,16,2539,2398,1649,-749
2020,6,5,17,2661,2472,1753,-719
2020,6,5,18,2792,2563,1798,-765
2020,6,5,19,2841,2675,1767,-908
2020,6,5,20,2960,2815,1899,-916
2020,6,5,21,3057,2944,1955,-989
2020,6,5,22,3122,3031,1981,-1050
2020,6,5,23,3172,3116,2036,-1080
2020,6,6,0,3145,3134,2201,-933
2020,6,6,1,3184,3147,2123,-1024
2020,6,6,2,3226,3101,2167,-934
2020,6,6,3,3123,2976,2062,-914
2020,6,6,4,3025,2828,1955,-873
2020,6,6,5,2839,2604,1724,-880
2020,6,6,6,2515,2390,1653,-737
2020,6,6,7,2410,2255,1833,-422
2020,6,6,8,2305,2143,1893,-250
2020,6,6,9,2078,2039,1790,-249
2020,6,6,10,2015,2002,1804,-198
2020,6,6,11,2001,1957,1755,-202
2020,6,6,12,1981,1962,1713,-249
2020,6,6,13,1964,1978,1696,-282
2020,6,6,14,2057,2044,1764,-280
2020,6,6,15,2218,2139,1857,-282
2020,6,6,16,2294,2197,1668,-529
2020,6,6,17,2302,2225,1607,-618
2020,6,6,18,2336,2268,1911,-357
2020,6,6,19,2351,2169,1832,-337
2020,6,6,20,2385,2253,1801,-452
2020,6,6,21,2363,2260,1809,-451
2020,6,6,22,2339,2249,1874,-375
2020,6,6,23,2359,2234,1744,-490
2020,6,7,0,2390,2215,1596,-619
2020,6,7,1,2365,2162,1563,-599
2020,6,7,2,2265,2122,1695,-427
2020,6,7,3,2190,2089,1704,-385
2020,6,7,4,2138,2051,1505,-546
2020,6,7,5,2117,1983,1494,-489
2020,6,7,6,1998,1894,1370,-524
2020,6,7,7,2019,1794,1160,-634
2020,6,7,8,1896,1734,1294,-440
2020,6,7,9,1780,1695,1433,-262
2020,6,7,10,1750,1685,1553,-132
2020,6,7,11,1739,1693,1647,-46
2020,6,7,12,1740,1705,1822,117
2020,6,7,13,1762,1723,1921,198
2020,6,7,14,1860,1777,1858,81
2020,6,7,15,1973,1819,1569,-250
2020,6,7,16,2065,1906,1634,-272
2020,6,7,17,2136,1941,1746,-195
2020,6,7,18,2184,1953,1798,-155
2020,6,7,19,2182,1940,1780,-160
2020,6,7,20,2160,1930,1775,-155
2020,6,7,21,2190,1907,1749,-158
2020,6,7,22,2225,1869,1824,-45
2020,6,7,23,2189,1897,1772,-125
2020,6,8,0,2147,1898,1763,-135
2020,6,8,1,2096,1918,1775,-143
2020,6,8,2,2046,1924,1942,18
2020,6,8,3,1999,1913,1885,-28
2020,6,8,4,1989,1915,1930,15
2020,6,8,5,1952,1854,1943,89
2020,6,8,6,1891,1792,1918,126
2020,6,8,7,1840,1715,1813,98
2020,6,8,8,1791,1659,1748,89
2020,6,8,9,1695,1651,1808,157
2020,6,8,10,1696,1659,1981,322
2020,6,8,11,1725,1686,2048,362
2020,6,8,12,1814,1756,2030,274
2020,6,8,13,1933,1853,1912,59
2020,6,8,14,2065,1983,1964,-19
2020,6,8,15,2162,2071,2104,33
2020,6,8,16,2209,2117,2203,86
2020,6,8,17,2267,2098,1769,-329
2020,6,8,18,2277,2079,1613,-466
2020,6,8,19,2290,2091,1847,-244
2020,6,8,20,2293,2043,1815,-228
2020,6,8,21,2228,2030,1904,-126
2020,6,8,22,2198,2017,1987,-30
2020,6,8,23,2164,2030,2093,63
2020,6,9,0,2147,2033,1991,-42
2020,6,9,1,2123,2047,2026,-21
2020,6,9,2,2118,2069,2015,-54
2020,6,9,3,2151,2039,1833,-206
2020,6,9,4,2139,2041,1720,-321
2020,6,9,5,2042,1976,1625,-351
2020,6,9,6,1914,1829,1437,-392
2020,6,9,7,1964,1732,1363,-369
2020,6,9,8,1866,1686,1343,-343
2020,6,9,9,1727,1615,1230,-385
2020,6,9,10,1717,1633,1238,-395
2020,6,9,11,1733,1627,1236,-391
2020,6,9,12,1790,1681,1263,-418
2020,6,9,13,1892,1772,1347,-425
2020,6,9,14,2010,1913,1410,-503
2020,6,9,15,2168,2010,1405,-605
2020,6,9,16,2240,2025,1417,-608
2020,6,9,17,2281,2074,1511,-563
2020,6,9,18,2259,2071,1664,-407
2020,6,9,19,2231,2073,1866,-207
2020,6,9,20,2240,2060,1741,-319
2020,6,9,21,2267,2029,1715,-314
2020,6,9,22,2222,2091,1839,-252
2020,6,9,23,2179,2048,1815,-233
2020,6,10,0,2201,2153,1796,-357
2020,6,10,1,2239,2189,1753,-436
2020,6,10,2,2297,2177,1841,-336
2020,6,10,3,2326,2232,1768,-464
2020,6,10,4,2279,2184,1625,-559
2020,6,10,5,2263,2106,1602,-504
2020,6,10,6,2092,1910,1412,-498
2020,6,10,7,2040,1838,1310,-528
2020,6,10,8,1908,1756,1266,-490
2020,6,10,9,1828,1704,1236,-468
2020,6,10,10,1788,1755,1258,-497
2020,6,10,11,1808,1663,1178,-485
2020,6,10,12,1853,1754,1320,-434
2020,6,10,13,1945,1840,1349,-491
2020,6,10,14,2085,1957,1445,-512
2020,6,10,15,2231,2083,1662,-421
2020,6,10,16,2301,2152,1683,-469
2020,6,10,17,2338,2209,1696,-513
2020,6,10,18,2410,2225,1770,-455
2020,6,10,19,2426,2277,1844,-433
2020,6,10,20,2406,2315,1858,-457
2020,6,10,21,2432,2390,1927,-463
2020,6,10,22,2489,2459,1962,-497
2020,6,10,23,2549,2519,2017,-502
2020,6,11,0,2632,2585,2009,-576
2020,6,11,1,2686,2650,1979,-671
2020,6,11,2,2714,2655,1890,-765
2020,6,11,3,2701,2621,1763,-858
2020,6,11,4,2674,2532,1706,-826
2020,6,11,5,2624,2416,1617,-799
2020,6,11,6,2324,2224,1612,-612
2020,6,11,7,2063,2045,1528,-517
2020,6,11,8,1955,1962,1605,-357
2020,6,11,9,2026,1867,1646,-221
2020,6,11,10,2008,1810,1668,-142
2020,6,11,11,2020,1820,1655,-165
2020,6,11,12,2021,1817,1672,-145
2020,6,11,13,2075,1892,1701,-191
2020,6,11,14,2210,2103,1818,-285
2020,6,11,15,2365,2222,1848,-374
2020,6,11,16,2453,2322,1954,-368
2020,6,11,17,2572,2405,2165,-240
2020,6,11,18,2690,2489,2132,-357
2020,6,11,19,2726,2594,2167,-427
2020,6,11,20,2766,2690,2067,-623
2020,6,11,21,2836,2773,2051,-722
2020,6,11,22,2888,2845,2125,-720
2020,6,11,23,2937,2885,2242,-643
2020,6,12,0,3040,2922,2278,-644
2020,6,12,1,3159,2963,2263,-700
2020,6,12,2,3084,2965,2113,-852
2020,6,12,3,3064,2864,1933,-931
2020,6,12,4,2948,2742,1913,-829
2020,6,12,5,2803,2636,1989,-647
2020,6,12,6,2562,2391,1911,-480
2020,6,12,7,2253,2265,1951,-314
2020,6,12,8,2174,2128,1933,-195
2020,6,12,9,2244,2062,1957,-105
2020,6,12,10,2167,1986,1830,-156
2020,6,12,11,2127,1996,1844,-152
2020,6,12,12,2120,2003,1888,-115
2020,6,12,13,2208,2069,1927,-142
2020,6,12,14,2359,2242,1947,-295
2020,6,12,15,2487,2368,1956,-412
2020,6,12,16,2592,2477,2011,-466
2020,6,12,17,2686,2587,2015,-572
2020,6,12,18,2774,2659,1954,-705
2020,6,12,19,2810,2808,2012,-796
2020,6,12,20,2893,2901,2017,-884
2020,6,12,21,2974,2987,1993,-994
2020,6,12,22,3058,3044,1970,-1074
2020,6,12,23,3161,3066,1971,-1095
2020,6,13,0,3147,3085,1966,-1119
2020,6,13,1,3123,3083,2005,-1078
2020,6,13,2,3142,3017,2080,-937
2020,6,13,3,3033,2910,2064,-846
2020,6,13,4,2936,2829,2049,-780
2020,6,13,5,2811,2697,1947,-750
2020,6,13,6,2599,2510,1950,-560
2020,6,13,7,2234,2333,1945,-388
2020,6,13,8,2117,2199,1983,-216
2020,6,13,9,2156,2117,1956,-161
2020,6,13,10,2101,2036,1943,-93
2020,6,13,11,2064,1997,1884,-113
2020,6,13,12,2021,1976,1791,-185
2020,6,13,13,2009,2008,1715,-293
2020,6,13,14,2116,2097,1866,-231
2020,6,13,15,2214,2192,1852,-340
2020,6,13,16,2305,2245,1691,-554
2020,6,13,17,2346,2303,1734,-569
2020,6,13,18,2380,2317,1924,-393
2020,6,13,19,2353,2304,1927,-377
2020,6,13,20,2332,2289,2053,-236
2020,6,13,21,2342,2251,1966,-285
2020,6,13,22,2378,2219,1911,-308
2020,6,13,23,2323,2214,1947,-267
2020,6,14,0,2323,2210,1901,-309
2020,6,14,1,2293,2237,1727,-510
2020,6,14,2,2271,2239,1687,-552
2020,6,14,3,2248,2213,1631,-582
2020,6,14,4,2283,2196,1679,-517
2020,6,14,5,2259,2142,1607,-535
2020,6,14,6,2125,2032,1658,-374
2020,6,14,7,1849,1957,1555,-402
2020,6,14,8,1796,1900,1503,-397
2020,6,14,9,1898,1851,1532,-319
2020,6,14,10,1877,1831,1572,-259
2020,6,14,11,1867,1821,1530,-291
2020,6,14,12,1891,1826,1517,-309
2020,6,14,13,1878,1818,1574,-244
2020,6,14,14,1976,1885,1684,-201
2020,6,14,15,2086,1954,1597,-357
2020,6,14,16,2182,2022,1753,-269
2020,6,14,17,2265,2065,1783,-282
2020,6,14,18,2316,2076,1714,-362
2020,6,14,19,2294,2093,1779,-314
2020,6,14,20,2308,2075,1806,-269
2020,6,14,21,2205,2083,1862,-221
2020,6,14,22,2189,2069,1839,-230
2020,6,14,23,2196,2075,1860,-215
2020,6,15,0,2193,2111,1876,-235
2020,6,15,1,2185,2137,1804,-333
2020,6,15,2,2199,2142,1776,-366
2020,6,15,3,2179,2119,1537,-582
2020,6,15,4,2164,2108,1443,-665
2020,6,15,5,2094,2063,1438,-625
2020,6,15,6,1953,1943,1415,-528
2020,6,15,7,1866,1842,1399,-443
2020,6,15,8,1809,1783,1428,-355
2020,6,15,9,1826,1758,1442,-316
2020,6,15,10,1829,1748,1440,-308
2020,6,15,11,1846,1746,1454,-292
2020,6,15,12,1904,1806,1540,-266
2020,6,15,13,1986,1919,1640,-279
2020,6,15,14,2165,2059,1706,-353
2020,6,15,15,2269,2174,1714,-460
2020,6,15,16,2351,2242,1721,-521
2020,6,15,17,2420,2275,1668,-607
2020,6,15,18,2450,2292,1639,-653
2020,6,15,19,2412,2327,1583,-744
2020,6,15,20,2419,2322,1586,-736
2020,6,15,21,2436,2323,1681,-642
2020,6,15,22,2462,2286,1816,-470
2020,6,15,23,2418,2279,1857,-422
2020,6,16,0,2411,2286,1929,-357
2020,6,16,1,2393,2294,1975,-319
2020,6,16,2,2392,2308,1957,-351
2020,6,16,3,2324,2281,1911,-370
2020,6,16,4,2326,2277,1882,-395
2020,6,16,5,2301,2190,1803,-387
2020,6,16,6,2170,2071,1701,-370
2020,6,16,7,2053,1986,1616,-370
2020,6,16,8,1960,1907,1546,-361
2020,6,16,9,1936,1885,1526,-359
2020,6,16,10,1922,1847,1518,-329
2020,6,16,11,1934,1847,1551,-296
2020,6,16,12,1970,1879,1582,-297
2020,6,16,13,2050,1960,1612,-348
2020,6,16,14,2173,2075,1634,-441
2020,6,16,15,2272,2151,1624,-527
2020,6,16,16,2301,2197,1641,-556
2020,6,16,17,2293,2214,1707,-507
2020,6,16,18,2273,2216,1788,-428
2020,6,16,19,2258,2215,1829,-386
2020,6,16,20,2276,2199,1847,-352
2020,6,16,21,2243,2172,1848,-324
2020,6,16,22,2237,2149,1861,-288
2020,6,16,23,2220,2122,1940,-182
2020,6,17,0,2225,2115,1947,-168
2020,6,17,1,2238,2091,1888,-203
2020,6,17,2,2241,2071,1874,-197
2020,6,17,3,2216,2057,1756,-301
2020,6,17,4,2176,2059,1815,-244
2020,6,17,5,2122,1986,1771,-215
2020,6,17,6,1986,1901,1871,-30
2020,6,17,7,1982,1784,1821,37
2020,6,17,8,1936,1744,1828,84
2020,6,17,9,1769,1713,1899,186
2020,6,17,10,1760,1703,1875,172
2020,6,17,11,1763,1721,1891,170
2020,6,17,12,1817,1781,1920,139
2020,6,17,13,1927,1885,1949,64
2020,6,17,14,2064,1961,1970,9
2020,6,17,15,2205,2014,2020,6
2020,6,17,16,2217,2036,2074,38
2020,6,17,17,2237,2046,2108,62
2020,6,17,18,2283,2032,2160,128
2020,6,17,19,2172,2017,2136,119
2020,6,17,20,2136,2002,2102,100
2020,6,17,21,2112,1982,2132,150
2020,6,17,22,2191,1962,2139,177
2020,6,17,23,2166,1966,2140,174
2020,6,18,0,2150,1945,2138,193
2020,6,18,1,2141,1949,2102,153
2020,6,18,2,2138,1956,2065,109
2020,6,18,3,2148,1940,1886,-54
2020,6,18,4,2109,1945,1805,-140
2020,6,18,5,2042,1846,1678,-168
2020,6,18,6,1875,1726,1508,-218
2020,6,18,7,2084,1627,1414,-213
2020,6,18,8,1936,1630,1375,-255
2020,6,18,9,1653,1576,1339,-237
2020,6,18,10,1637,1545,1304,-241
2020,6,18,11,1652,1602,1373,-229
2020,6,18,12,1710,1617,1409,-208
2020,6,18,13,1825,1695,1432,-263
2020,6,18,14,1924,1853,1634,-219
2020,6,18,15,2087,1905,1683,-222
2020,6,18,16,2182,1934,1691,-243
2020,6,18,17,2126,1957,1708,-249
2020,6,18,18,2086,2000,1735,-265
2020,6,18,19,2110,1976,1635,-341
2020,6,18,20,2175,2046,1603,-443
2020,6,18,21,2163,2013,1520,-493
2020,6,18,22,2131,2092,1611,-481
2020,6,18,23,2171,2107,1765,-342
2020,6,19,0,2204,2187,1816,-371
2020,6,19,1,2274,2223,1891,-332
2020,6,19,2,2285,2188,1760,-428
2020,6,19,3,2302,2198,1682,-516
2020,6,19,4,2261,2133,1669,-464
2020,6,19,5,2154,2030,1654,-376
2020,6,19,6,1981,1923,1608,-315
2020,6,19,7,2053,1755,1530,-225
2020,6,19,8,1855,1704,1444,-260
2020,6,19,9,1760,1653,1427,-226
2020,6,19,10,1735,1651,1428,-223
2020,6,19,11,1731,1640,1448,-192
2020,6,19,12,1776,1671,1410,-261
2020,6,19,13,1863,1720,1402,-318
2020,6,19,14,1954,1856,1669,-187
2020,6,19,15,2100,2010,1766,-244
2020,6,19,16,2193,2062,1737,-325
2020,6,19,17,2202,2100,1674,-426
2020,6,19,18,2206,2166,1674,-492
2020,6,19,19,2265,2184,1655,-529
2020,6,19,20,2346,2260,1682,-578
2020,6,19,21,2330,2262,1655,-607
2020,6,19,22,2353,2260,1609,-651
2020,6,19,23,2423,2425,1714,-711
2020,6,20,0,2538,2442,1704,-738
2020,6,20,1,2588,2520,1819,-701
2020,6,20,2,2552,2488,1793,-695
2020,6,20,3,2512,2413,1627,-786
2020,6,20,4,2435,2384,1566,-818
2020,6,20,5,2330,2232,1425,-807
2020,6,20,6,2183,2069,1431,-638
2020,6,20,7,2088,1976,1442,-534
2020,6,20,8,1956,1875,1427,-448
2020,6,20,9,1931,1813,1432,-381
2020,6,20,10,1902,1756,1397,-359
2020,6,20,11,1891,1742,1383,-359
2020,6,20,12,1876,1741,1382,-359
2020,6,20,13,1872,1776,1402,-374
2020,6,20,14,1946,1886,1502,-384
2020,6,20,15,2114,2003,1611,-392
2020,6,20,16,2264,2105,1707,-398
2020,6,20,17,2339,2187,1707,-480
2020,6,20,18,2391,2227,1819,-408
2020,6,20,19,2459,2274,1832,-442
2020,6,20,20,2493,2352,1832,-520
2020,6,20,21,2514,2430,1858,-572
2020,6,20,22,2549,2502,1870,-632
2020,6,20,23,2621,2575,1894,-681
2020,6,21,0,2723,2638,1899,-739
2020,6,21,1,2785,2682,1950,-732
2020,6,21,2,2767,2669,1872,-797
2020,6,21,3,2732,2620,1796,-824
2020,6,21,4,2664,2548,1667,-881
2020,6,21,5,2551,2448,1586,-862
2020,6,21,6,2390,2282,1553,-729
2020,6,21,7,2189,2137,1569,-568
2020,6,21,8,2097,2053,1736,-317
2020,6,21,9,2068,1948,1781,-167
2020,6,21,10,2003,1918,1867,-51
2020,6,21,11,1933,1881,1926,45
2020,6,21,12,1915,1858,1955,97
2020,6,21,13,1935,1855,1975,120
2020,6,21,14,2014,1940,2143,203
2020,6,21,15,2148,2055,2130,75
2020,6,21,16,2258,2169,2374,205
2020,6,21,17,2342,2268,2429,161
2020,6,21,18,2318,2344,2446,102
2020,6,21,19,2340,2390,2406,16
2020,6,21,20,2398,2430,2374,-56
2020,6,21,21,2476,2475,2381,-94
2020,6,21,22,2525,2533,2424,-109
2020,6,21,23,2574,2581,2449,-132
2020,6,22,0,2648,2620,2484,-136
2020,6,22,1,2680,2651,2531,-120
2020,6,22,2,2638,2623,2527,-96
2020,6,22,3,2551,2565,2322,-243
2020,6,22,4,2517,2452,2101,-351
2020,6,22,5,2433,2362,2063,-299
2020,6,22,6,2258,2165,1999,-166
2020,6,22,7,2031,2013,2000,-13
2020,6,22,8,1970,1930,2064,134
2020,6,22,9,1945,1853,2012,159
2020,6,22,10,1906,1821,1964,143
2020,6,22,11,1880,1836,2009,173
2020,6,22,12,1927,1816,2013,197
2020,6,22,13,2022,1978,2049,71
2020,6,22,14,2156,2102,2120,18
2020,6,22,15,2255,2304,2177,-127
2020,6,22,16,2332,2406,2096,-310
2020,6,22,17,2465,2494,2061,-433
2020,6,22,18,2551,2580,2149,-431
2020,6,22,19,2623,2643,2094,-549
2020,6,22,20,2704,2720,2119,-601
2020,6,22,21,2808,2779,2101,-678
2020,6,22,22,2866,2871,2255,-616
2020,6,22,23,2933,2929,2277,-652
2020,6,23,0,3008,3010,2484,-526
2020,6,23,1,3049,3063,2549,-514
2020,6,23,2,3063,3052,2525,-527
2020,6,23,3,3006,2992,2440,-552
2020,6,23,4,2935,2866,2370,-496
2020,6,23,5,2799,2721,2367,-354
2020,6,23,6,2572,2506,2278,-228
2020,6,23,7,2156,2335,2152,-183
2020,6,23,8,2073,2193,1917,-276
2020,6,23,9,2203,2104,1838,-266
2020,6,23,10,2137,2045,1811,-234
2020,6,23,11,2100,2047,1814,-233
2020,6,23,12,2122,2064,1792,-272
2020,6,23,13,2200,2145,1752,-393
2020,6,23,14,2371,2293,1961,-332
2020,6,23,15,2523,2458,1974,-484
2020,6,23,16,2634,2590,2023,-567
2020,6,23,17,2839,2689,1988,-701
2020,6,23,18,2922,2775,2033,-742
2020,6,23,19,2916,2885,2171,-714
2020,6,23,20,3026,3002,2314,-688
2020,6,23,21,3111,3101,2342,-759
2020,6,23,22,3210,3181,2490,-691
2020,6,23,23,3322,3252,2452,-800
2020,6,24,0,3372,3336,2505,-831
2020,6,24,1,3448,3388,2521,-867
2020,6,24,2,3424,3372,2401,-971
2020,6,24,3,3341,3281,2213,-1068
2020,6,24,4,3258,3131,2171,-960
2020,6,24,5,3115,2961,2104,-857
2020,6,24,6,2823,2702,2056,-646
2020,6,24,7,2312,2493,1869,-624
2020,6,24,8,2307,2345,1640,-705
2020,6,24,9,2378,2245,1651,-594
2020,6,24,10,2314,2178,1610,-568
2020,6,24,11,2276,2148,1592,-556
2020,6,24,12,2271,2182,1646,-536
2020,6,24,13,2341,2274,1878,-396
2020,6,24,14,2523,2412,1778,-634
2020,6,24,15,2723,2562,1855,-707
2020,6,24,16,2855,2711,1842,-869
2020,6,24,17,3062,2841,1876,-965
2020,6,24,18,3166,2983,1983,-1000
2020,6,24,19,3237,3124,2025,-1099
2020,6,24,20,3376,3245,2087,-1158
2020,6,24,21,3446,3279,2232,-1047
2020,6,24,22,3454,3251,2304,-947
2020,6,24,23,3467,3252,2366,-886
2020,6,25,0,3413,3220,2439,-781
2020,6,25,1,3399,3222,2538,-684
2020,6,25,2,3275,3181,2260,-921
2020,6,25,3,3180,3149,2155,-994
2020,6,25,4,3115,3115,2254,-861
2020,6,25,5,3046,2971,2438,-533
2020,6,25,6,2889,2753,2303,-450
2020,6,25,7,2525,2567,2155,-412
2020,6,25,8,2505,2420,1876,-544
2020,6,25,9,2410,2326,1738,-588
2020,6,25,10,2326,2254,1704,-550
2020,6,25,11,2292,2212,1727,-485
2020,6,25,12,2298,2213,1755,-458
2020,6,25,13,2375,2280,1875,-405
2020,6,25,14,2490,2419,1899,-520
2020,6,25,15,2581,2560,2031,-529
2020,6,25,16,2682,2683,2112,-571
2020,6,25,17,2809,2781,2160,-621
2020,6,25,18,2900,2866,2288,-578
2020,6,25,19,2971,2950,2356,-594
2020,6,25,20,3073,3021,2294,-727
2020,6,25,21,3143,3136,2333,-803
2020,6,25,22,3160,3157,2330,-827
2020,6,25,23,3238,3209,2276,-933
2020,6,26,0,3323,3264,2278,-986
2020,6,26,1,3354,3297,2286,-1011
2020,6,26,2,3370,3277,2225,-1052
2020,6,26,3,3271,3206,2203,-1003
2020,6,26,4,3194,3074,2144,-930
2020,6,26,5,3029,2931,2032,-899
2020,6,26,6,2732,2689,1954,-735
2020,6,26,7,2527,2518,1829,-689
2020,6,26,8,2440,2388,1671,-717
2020,6,26,9,2352,2280,1610,-670
2020,6,26,10,2262,2217,1623,-594
2020,6,26,11,2251,2181,1643,-538
2020,6,26,12,2262,2197,1631,-566
2020,6,26,13,2330,2275,1664,-611
2020,6,26,14,2505,2429,1754,-675
2020,6,26,15,2667,2574,1841,-733
2020,6,26,16,2814,2714,1874,-840
2020,6,26,17,2948,2824,1869,-955
2020,6,26,18,3060,2936,1854,-1082
2020,6,26,19,3124,3060,2004,-1056
2020,6,26,20,3216,3158,2155,-1003
2020,6,26,21,3287,3255,2184,-1071
2020,6,26,22,3329,3316,2260,-1056
2020,6,26,23,3379,3365,2323,-1042
2020,6,27,0,3431,3402,2267,-1135
2020,6,27,1,3448,3412,2428,-984
2020,6,27,2,3435,3395,2336,-1059
2020,6,27,3,3326,3313,2238,-1075
2020,6,27,4,3221,3155,2010,-1145
2020,6,27,5,3116,2998,1953,-1045
2020,6,27,6,2866,2768,1935,-833
2020,6,27,7,2684,2581,1855,-726
2020,6,27,8,2574,2429,1665,-764
2020,6,27,9,2450,2329,1574,-755
2020,6,27,10,2368,2249,1493,-756
2020,6,27,11,2294,2196,1530,-666
2020,6,27,12,2252,2177,1634,-543
2020,6,27,13,2236,2200,1681,-519
2020,6,27,14,2350,2296,1716,-580
2020,6,27,15,2547,2465,1875,-590
2020,6,27,16,2713,2603,1880,-723
2020,6,27,17,2828,2705,1899,-806
2020,6,27,18,2900,2791,1871,-920
2020,6,27,19,2975,2857,1947,-910
2020,6,27,20,3004,2900,2019,-881
2020,6,27,21,3022,2921,2000,-921
2020,6,27,22,3055,2951,2140,-811
2020,6,27,23,3075,2976,2117,-859
2020,6,28,0,3100,3011,2087,-924
2020,6,28,1,3110,3000,2164,-836
2020,6,28,2,3050,2928,2095,-833
2020,6,28,3,2948,2856,2021,-835
2020,6,28,4,2806,2757,1771,-986
2020,6,28,5,2674,2655,1770,-885
2020,6,28,6,2545,2493,1781,-712
2020,6,28,7,2548,2341,1864,-477
2020,6,28,8,2415,2231,1693,-538
2020,6,28,9,2158,2139,1692,-447
2020,6,28,10,2088,2077,1693,-384
2020,6,28,11,2022,2025,1719,-306
2020,6,28,12,2007,2008,1738,-270
2020,6,28,13,2018,1999,1738,-261
2020,6,28,14,2105,2039,1603,-436
2020,6,28,15,2253,2131,1470,-661
2020,6,28,16,2310,2211,1487,-724
2020,6,28,17,2305,2282,1598,-684
2020,6,28,18,2309,2299,1696,-603
2020,6,28,19,2345,2298,1632,-666
2020,6,28,20,2417,2275,1733,-542
2020,6,28,21,2387,2262,1828,-434
2020,6,28,22,2377,2264,1682,-582
2020,6,28,23,2446,2248,1565,-683
2020,6,29,0,2382,2213,1682,-531
2020,6,29,1,2342,2189,1762,-427
2020,6,29,2,2260,2139,1820,-319
2020,6,29,3,2169,2117,1764,-353
2020,6,29,4,2135,2102,1699,-403
2020,6,29,5,2125,2046,1670,-376
2020,6,29,6,2075,1943,1705,-238
2020,6,29,7,2017,1858,1692,-166
2020,6,29,8,1912,1804,1526,-278
2020,6,29,9,1843,1759,1431,-328
2020,6,29,10,1826,1754,1285,-469
2020,6,29,11,1815,1763,1123,-640
2020,6,29,12,1876,1836,1451,-385
2020,6,29,13,2003,1931,1490,-441
2020,6,29,14,2156,2019,1491,-528
2020,6,29,15,2240,2090,1495,-595
2020,6,29,16,2247,2122,1504,-618
2020,6,29,17,2253,2164,1477,-687
2020,6,29,18,2294,2167,1480,-687
2020,6,29,19,2280,2152,1413,-739
2020,6,29,20,2250,2107,1368,-739
2020,6,29,21,2242,2088,1331,-757
2020,6,29,22,2204,2054,1217,-837
2020,6,29,23,2169,2043,1246,-797
2020,6,30,0,2137,2039,1246,-793
2020,6,30,1,2118,2018,1317,-701
2020,6,30,2,2128,2018,1403,-615
2020,6,30,3,2113,1976,1303,-673
2020,6,30,4,2083,1995,1322,-673
2020,6,30,5,2064,1921,1258,-663
2020,6,30,6,1971,1814,1068,-746
2020,6,30,7,2061,1731,1045,-686
2020,6,30,8,1973,1676,979,-697
2020,6,30,9,1724,1647,954,-693
2020,6,30,10,1710,1626,960,-666
2020,6,30,11,1722,1627,854,-773
2020,6,30,12,1758,1697,940,-757
2020,6,30,13,1865,1769,1029,-740
2020,6,30,14,1995,1835,1018,-817
2020,6,30,15,2098,1897,1090,-807
2020,6,30,16,2132,1928,1101,-827
2020,6,30,17,2128,1935,1114,-821
2020,6,30,18,2145,1975,1173,-802
2020,6,30,19,2160,1964,1148,-816
2020,6,30,20,2170,1969,1220,-749
2020,6,30,21,2152,1966,1293,-673
2020,6,30,22,2169,1993,1343,-650
2020,6,30,23,2206,2033,1412,-621
2020,7,1,0,2177,2077,1437,-640
2020,7,1,1,2182,2091,1392,-699
2020,7,1,2,2208,2086,1376,-710
2020,7,1,3,2222,2054,1211,-843
2020,7,1,4,2171,2017,1127,-890
2020,7,1,5,2090,1951,1096,-855
2020,7,1,6,1948,1802,1157,-645
2020,7,1,7,2228,1688,1170,-518
2020,7,1,8,1998,1619,1195,-424
2020,7,1,9,1666,1574,1170,-404
2020,7,1,10,1628,1551,1209,-342
2020,7,1,11,1630,1553,1194,-359
2020,7,1,12,1678,1624,1187,-437
2020,7,1,13,1777,1670,1242,-428
2020,7,1,14,1861,1762,1353,-409
2020,7,1,15,1948,1851,1686,-165
2020,7,1,16,2005,1906,1753,-153
2020,7,1,17,2037,1940,1856,-84
2020,7,1,18,2068,1965,1776,-189
2020,7,1,19,2061,1975,1706,-269
2020,7,1,20,2068,2003,1653,-350
2020,7,1,21,2097,2031,1634,-397
2020,7,1,22,2132,2065,1656,-409
2020,7,1,23,2134,2110,1674,-436
2020,7,2,0,2178,2180,1690,-490
2020,7,2,1,2218,2206,1847,-359
2020,7,2,2,2244,2220,1941,-279
2020,7,2,3,2224,2192,1826,-366
2020,7,2,4,2196,2137,1608,-529
2020,7,2,5,2088,2045,1626,-419
2020,7,2,6,1870,1874,1392,-482
2020,7,2,7,2092,1741,1234,-507
2020,7,2,8,1796,1652,1205,-447
2020,7,2,9,1702,1601,1076,-525
2020,7,2,10,1684,1577,1042,-535
2020,7,2,11,1675,1570,994,-576
2020,7,2,12,1716,1624,1014,-610
2020,7,2,13,1785,1688,1079,-609
2020,7,2,14,1861,1827,1313,-514
2020,7,2,15,1955,1932,1422,-510
2020,7,2,16,2042,2026,1623,-403
2020,7,2,17,2115,2069,1623,-446
2020,7,2,18,2210,2108,1604,-504
2020,7,2,19,2257,2155,1616,-539
2020,7,2,20,2298,2194,1622,-572
2020,7,2,21,2334,2254,1762,-492
2020,7,2,22,2385,2314,1760,-554
2020,7,2,23,2444,2384,1759,-625
2020,7,3,0,2524,2449,1740,-709
2020,7,3,1,2576,2502,1775,-727
2020,7,3,2,2569,2501,1757,-744
2020,7,3,3,2522,2439,1609,-830
2020,7,3,4,2422,2361,1548,-813
2020,7,3,5,2305,2258,1551,-707
2020,7,3,6,2127,2065,1352,-713
2020,7,3,7,2052,1916,1345,-571
2020,7,3,8,1895,1822,1289,-533
2020,7,3,9,1843,1761,1289,-472
2020,7,3,10,1837,1708,1171,-537
2020,7,3,11,1829,1688,1204,-484
2020,7,3,12,1840,1694,1289,-405
2020,7,3,13,1873,1734,1354,-380
2020,7,3,14,1952,1853,1538,-315
2020,7,3,15,2072,1991,1659,-332
2020,7,3,16,2240,2125,1692,-433
2020,7,3,17,2368,2215,1623,-592
2020,7,3,18,2479,2321,1716,-605
2020,7,3,19,2555,2377,1708,-669
2020,7,3,20,2635,2459,1681,-778
2020,7,3,21,2705,2555,1685,-870
2020,7,3,22,2782,2640,1727,-913
2020,7,3,23,2779,2714,1884,-830
2020,7,4,0,2912,2850,1943,-907
2020,7,4,1,2946,2887,1934,-953
2020,7,4,2,2880,2874,1858,-1016
2020,7,4,3,2838,2788,1844,-944
2020,7,4,4,2770,2664,1727,-937
2020,7,4,5,2618,2542,1441,-1101
2020,7,4,6,2398,2319,1448,-871
2020,7,4,7,2250,2145,1326,-819
2020,7,4,8,2092,2014,1307,-707
2020,7,4,9,2033,1921,1309,-612
2020,7,4,10,1926,1846,1288,-558
2020,7,4,11,1845,1815,1287,-528
2020,7,4,12,1854,1795,1312,-483
2020,7,4,13,1862,1812,1322,-490
2020,7,4,14,1945,1908,1473,-435
2020,7,4,15,2113,2047,1572,-475
2020,7,4,16,2306,2181,1671,-510
2020,7,4,17,2439,2273,1750,-523
2020,7,4,18,2534,2351,1683,-668
2020,7,4,19,2607,2395,1655,-740
2020,7,4,20,2684,2492,1646,-846
2020,7,4,21,2675,2570,1736,-834
2020,7,4,22,2668,2646,1803,-843
2020,7,4,23,2770,2695,1944,-751
2020,7,5,0,2893,2757,2020,-737
2020,7,5,1,2903,2767,2057,-710
2020,7,5,2,2834,2743,2032,-711
2020,7,5,3,2720,2621,1814,-807
2020,7,5,4,2648,2476,1595,-881
2020,7,5,5,2515,2352,1582,-770
2020,7,5,6,2258,2247,1562,-685
2020,7,5,7,2164,2129,1519,-610
2020,7,5,8,2070,1994,1527,-467
2020,7,5,9,1999,1917,1483,-434
2020,7,5,10,1950,1862,1478,-384
2020,7,5,11,1897,1832,1566,-266
2020,7,5,12,1838,1810,1563,-247
2020,7,5,13,1843,1809,1533,-276
2020,7,5,14,1968,1848,1634,-214
2020,7,5,15,2129,1950,1694,-256
2020,7,5,16,2285,2066,1700,-366
2020,7,5,17,2388,2200,1745,-455
2020,7,5,18,2476,2282,1806,-476
2020,7,5,19,2475,2357,1790,-567
2020,7,5,20,2498,2451,1889,-562
2020,7,5,21,2569,2537,1898,-639
2020,7,5,22,2636,2626,1914,-712
2020,7,5,23,2719,2724,1958,-766
2020,7,6,0,2819,2813,2091,-722
2020,7,6,1,2893,2856,2148,-708
2020,7,6,2,2904,2851,2153,-698
2020,7,6,3,2835,2764,2091,-673
2020,7,6,4,2708,2632,1839,-793
2020,7,6,5,2547,2497,1668,-829
2020,7,6,6,2380,2263,1589,-674
2020,7,6,7,2091,2099,1583,-516
2020,7,6,8,2009,1994,1579,-415
2020,7,6,9,2018,1930,1578,-352
2020,7,6,10,1962,1897,1565,-332
2020,7,6,11,1955,1887,1553,-334
2020,7,6,12,1991,1933,1556,-377
2020,7,6,13,2080,2022,1467,-555
2020,7,6,14,2240,2174,1541,-633
2020,7,6,15,2345,2330,1638,-692
2020,7,6,16,2492,2469,1724,-745
2020,7,6,17,2643,2570,1791,-779
2020,7,6,18,2736,2680,1893,-787
2020,7,6,19,2841,2786,1859,-927
2020,7,6,20,2964,2883,1847,-1036
2020,7,6,21,3045,3002,1850,-1152
2020,7,6,22,3092,3098,1859,-1239
2020,7,6,23,3185,3209,1887,-1322
2020,7,7,0,3251,3282,2120,-1162
2020,7,7,1,3321,3362,2191,-1171
2020,7,7,2,3331,3359,2289,-1070
2020,7,7,3,3261,3280,2192,-1088
2020,7,7,4,3158,3114,2007,-1107
2020,7,7,5,3037,2924,1957,-967
2020,7,7,6,2760,2687,1868,-819
2020,7,7,7,2269,2506,1727,-779
2020,7,7,8,2186,2349,1606,-743
2020,7,7,9,2331,2244,1703,-541
2020,7,7,10,2190,2154,1769,-385
2020,7,7,11,2144,2125,1955,-170
2020,7,7,12,2146,2150,1944,-206
2020,7,7,13,2199,2201,2013,-188
2020,7,7,14,2334,2314,2123,-191
2020,7,7,15,2463,2460,2228,-232
2020,7,7,16,2538,2552,2337,-215
2020,7,7,17,2561,2629,2471,-158
2020,7,7,18,2640,2679,2407,-272
2020,7,7,19,2733,2741,2423,-318
2020,7,7,20,2775,2783,2426,-357
2020,7,7,21,2808,2831,2385,-446
2020,7,7,22,2853,2862,2409,-453
2020,7,7,23,2901,2917,2395,-522
2020,7,8,0,2917,2961,2399,-562
2020,7,8,1,2947,3011,2408,-603
2020,7,8,2,2936,2996,2402,-594
2020,7,8,3,2851,2923,2183,-740
2020,7,8,4,2745,2815,2028,-787
2020,7,8,5,2673,2679,1933,-746
2020,7,8,6,2541,2458,1780,-678
2020,7,8,7,2067,2307,1775,-532
2020,7,8,8,2083,2198,1793,-405
2020,7,8,9,2091,2126,1742,-384
2020,7,8,10,2067,2077,1783,-294
2020,7,8,11,2060,2049,1916,-133
2020,7,8,12,2073,2081,1898,-183
2020,7,8,13,2133,2146,1883,-263
2020,7,8,14,2288,2307,1992,-315
2020,7,8,15,2443,2406,2053,-353
2020,7,8,16,2534,2499,2100,-399
2020,7,8,17,2609,2584,2159,-425
2020,7,8,18,2674,2627,2162,-465
2020,7,8,19,2789,2672,2139,-533
2020,7,8,20,2839,2710,2131,-579
2020,7,8,21,2872,2738,2136,-602
2020,7,8,22,2821,2792,2120,-672
2020,7,8,23,2888,2837,2129,-708
2020,7,9,0,2972,2909,2194,-715
2020,7,9,1,3028,2964,2367,-597
2020,7,9,2,3027,2964,2330,-634
2020,7,9,3,2954,2895,2226,-669
2020,7,9,4,2852,2797,2204,-593
2020,7,9,5,2730,2672,2149,-523
2020,7,9,6,2548,2456,2066,-390
2020,7,9,7,2213,2282,1684,-598
2020,7,9,8,2177,2178,1436,-742
2020,7,9,9,2190,2111,1507,-604
2020,7,9,10,2161,2073,1558,-515
2020,7,9,11,2151,2054,1600,-454
2020,7,9,12,2158,2085,1601,-484
2020,7,9,13,2216,2162,1539,-623
2020,7,9,14,2396,2303,1562,-741
2020,7,9,15,2581,2423,1630,-793
2020,7,9,16,2700,2533,1744,-789
2020,7,9,17,2821,2636,2012,-624
2020,7,9,18,2866,2703,2070,-633
2020,7,9,19,2948,2775,2167,-608
2020,7,9,20,2968,2865,2179,-686
2020,7,9,21,3038,2954,2170,-784
2020,7,9,22,3078,3061,2196,-865
2020,7,9,23,3160,3156,2262,-894
2020,7,10,0,3260,3234,2254,-980
2020,7,10,1,3328,3306,2325,-981
2020,7,10,2,3356,3301,2251,-1050
2020,7,10,3,3291,3223,2140,-1083
2020,7,10,4,3178,3095,2026,-1069
2020,7,10,5,3053,2917,1903,-1014
2020,7,10,6,2811,2684,1778,-906
2020,7,10,7,2535,2494,1634,-860
2020,7,10,8,2455,2358,1638,-720
2020,7,10,9,2357,2272,1662,-610
2020,7,10,10,2264,2204,1966,-238
2020,7,10,11,2229,2153,1765,-388
2020,7,10,12,2253,2175,1985,-190
2020,7,10,13,2294,2233,2030,-203
2020,7,10,14,2434,2389,2124,-265
2020,7,10,15,2585,2518,2137,-381
2020,7,10,16,2690,2651,2275,-376
2020,7,10,17,2798,2712,2291,-421
2020,7,10,18,2900,2804,2320,-484
2020,7,10,19,2934,2841,2277,-564
2020,7,10,20,2981,2916,2245,-671
2020,7,10,21,3068,2990,2196,-794
2020,7,10,22,3138,3043,2222,-821
2020,7,10,23,3164,3102,2272,-830
2020,7,11,0,3151,3159,2204,-955
2020,7,11,1,3194,3192,2298,-894
2020,7,11,2,3239,3177,2287,-890
2020,7,11,3,3137,3125,2210,-915
2020,7,11,4,3068,2967,1927,-1040
2020,7,11,5,2949,2803,1774,-1029
2020,7,11,6,2690,2598,1621,-977
2020,7,11,7,2534,2418,1486,-932
2020,7,11,8,2422,2293,1497,-796
2020,7,11,9,2293,2183,1373,-810
2020,7,11,10,2268,2118,1389,-729
2020,7,11,11,2185,2063,1391,-672
2020,7,11,12,2122,2054,1388,-666
2020,7,11,13,2164,2069,1417,-652
2020,7,11,14,2280,2184,1575,-609
2020,7,11,15,2500,2338,1709,-629
2020,7,11,16,2708,2478,1898,-580
2020,7,11,17,2789,2617,1912,-705
2020,7,11,18,2854,2727,2009,-718
2020,7,11,19,2976,2866,2219,-647
2020,7,11,20,3044,3004,2195,-809
2020,7,11,21,3113,3163,2190,-973
2020,7,11,22,3257,3271,2168,-1103
2020,7,11,23,3384,3368,2184,-1184
2020,7,12,0,3486,3445,2125,-1320
2020,7,12,1,3512,3485,2204,-1281
2020,7,12,2,3496,3492,2302,-1190
2020,7,12,3,3410,3399,2229,-1170
2020,7,12,4,3279,3220,1995,-1225
2020,7,12,5,3157,3040,1612,-1428
2020,7,12,6,2976,2791,1858,-933
2020,7,12,7,2693,2603,1861,-742
2020,7,12,8,2542,2446,1887,-559
2020,7,12,9,2436,2318,1911,-407
2020,7,12,10,2317,2222,1861,-361
2020,7,12,11,2230,2165,1830,-335
2020,7,12,12,2182,2114,1811,-303
2020,7,12,13,2162,2089,1784,-305
2020,7,12,14,2223,2145,1890,-255
2020,7,12,15,2375,2258,1967,-291
2020,7,12,16,2508,2394,2027,-367
2020,7,12,17,2554,2518,2239,-279
2020,7,12,18,2618,2601,2284,-317
2020,7,12,19,2659,2672,2277,-395
2020,7,12,20,2733,2753,2234,-519
2020,7,12,21,2837,2827,2197,-630
2020,7,12,22,2946,2918,2178,-740
2020,7,12,23,2994,3004,2174,-830
2020,7,13,0,3102,3072,2212,-860
2020,7,13,1,3184,3070,2215,-855
2020,7,13,2,3116,3018,2201,-817
2020,7,13,3,3001,2899,2077,-822
2020,7,13,4,2828,2811,2074,-737
2020,7,13,5,2697,2672,2137,-535
2020,7,13,6,2532,2475,2109,-366
2020,7,13,7,2448,2333,2107,-226
2020,7,13,8,2326,2193,2000,-193
2020,7,13,9,2213,2109,2026,-83
2020,7,13,10,2131,2057,2025,-32
2020,7,13,11,2081,2033,2018,-15
2020,7,13,12,2123,2063,2011,-52
2020,7,13,13,2202,2142,1990,-152
2020,7,13,14,2337,2290,2057,-233
2020,7,13,15,2410,2406,2186,-220
2020,7,13,16,2494,2496,2349,-147
2020,7,13,17,2612,2570,2376,-194
2020,7,13,18,2706,2623,2374,-249
2020,7,13,19,2744,2707,2425,-282
2020,7,13,20,2886,2766,2529,-237
2020,7,13,21,2936,2835,2494,-341
2020,7,13,22,2982,2901,2504,-397
2020,7,13,23,3040,2941,2553,-388
2020,7,14,0,3096,3011,2537,-474
2020,7,14,1,3096,3045,2581,-464
2020,7,14,2,3085,3026,2564,-462
2020,7,14,3,3015,2971,2517,-454
2020,7,14,4,2926,2843,2353,-490
2020,7,14,5,2841,2688,2142,-546
2020,7,14,6,2600,2477,2048,-429
2020,7,14,7,2444,2316,2081,-235
2020,7,14,8,2292,2220,1929,-291
2020,7,14,9,2140,2144,1700,-444
2020,7,14,10,2078,2090,1685,-405
2020,7,14,11,2095,2050,1628,-422
2020,7,14,12,2105,2073,1666,-407
2020,7,14,13,2164,2153,1661,-492
2020,7,14,14,2316,2254,1619,-635
2020,7,14,15,2481,2395,1660,-735
2020,7,14,16,2590,2488,1710,-778
2020,7,14,17,2685,2555,1735,-820
2020,7,14,18,2744,2622,1772,-850
2020,7,14,19,2802,2686,1883,-803
2020,7,14,20,2879,2778,2006,-772
2020,7,14,21,2947,2835,2202,-633
2020,7,14,22,2995,2904,2249,-655
2020,7,14,23,3069,2962,2357,-605
2020,7,15,0,3136,3039,2490,-549
2020,7,15,1,3164,3082,2532,-550
2020,7,15,2,3149,3080,2489,-591
2020,7,15,3,3079,3017,2339,-678
2020,7,15,4,2964,2894,2315,-579
2020,7,15,5,2813,2730,2143,-587
2020,7,15,6,2587,2527,2005,-522
2020,7,15,7,2451,2358,1937,-421
2020,7,15,8,2315,2243,1705,-538
2020,7,15,9,2215,2143,1433,-710
2020,7,15,10,2206,2108,1413,-695
2020,7,15,11,2148,2072,1431,-641
2020,7,15,12,2158,2096,1406,-690
2020,7,15,13,2196,2162,1392,-770
2020,7,15,14,2337,2308,1643,-665
2020,7,15,15,2508,2428,1776,-652
2020,7,15,16,2658,2537,1780,-757
2020,7,15,17,2760,2596,1820,-776
2020,7,15,18,2854,2679,1834,-845
2020,7,15,19,2885,2768,2116,-652
2020,7,15,20,2944,2852,2221,-631
2020,7,15,21,3008,2966,2270,-696
2020,7,15,22,3092,3023,2375,-648
2020,7,15,23,3175,3103,2406,-697
2020,7,16,0,3252,3182,2422,-760
2020,7,16,1,3312,3242,2450,-792
2020,7,16,2,3323,3242,2512,-730
2020,7,16,3,3260,3155,2370,-785
2020,7,16,4,3127,3027,2332,-695
2020,7,16,5,2987,2840,1959,-881
2020,7,16,6,2727,2608,1861,-747
2020,7,16,7,2550,2419,1783,-636
2020,7,16,8,2456,2299,1582,-717
2020,7,16,9,2306,2196,1469,-727
2020,7,16,10,2224,2145,1465,-680
2020,7,16,11,2219,2109,1448,-661
2020,7,16,12,2217,2132,1538,-594
2020,7,16,13,2273,2205,1547,-658
2020,7,16,14,2434,2348,1649,-699
2020,7,16,15,2614,2501,1781,-720
2020,7,16,16,2755,2618,1799,-819
2020,7,16,17,2873,2710,1904,-806
2020,7,16,18,2923,2827,1907,-920
2020,7,16,19,2991,2952,2008,-944
2020,7,16,20,3100,3089,2044,-1045
2020,7,16,21,3222,3205,2140,-1065
2020,7,16,22,3311,3305,2264,-1041
2020,7,16,23,3403,3359,2304,-1055
2020,7,17,0,3502,3414,2374,-1040
2020,7,17,1,3564,3462,2422,-1040
2020,7,17,2,3523,3467,2393,-1074
2020,7,17,3,3441,3387,2274,-1113
2020,7,17,4,3310,3226,2131,-1095
2020,7,17,5,3145,3028,2108,-920
2020,7,17,6,2869,2777,1874,-903
2020,7,17,7,2708,2573,1684,-889
2020,7,17,8,2562,2417,1506,-911
2020,7,17,9,2489,2312,1416,-896
2020,7,17,10,2379,2227,1396,-831
2020,7,17,11,2316,2184,1374,-810
2020,7,17,12,2284,2193,1409,-784
2020,7,17,13,2326,2245,1432,-813
2020,7,17,14,2469,2390,1514,-876
2020,7,17,15,2648,2547,1651,-896
2020,7,17,16,2805,2709,1826,-883
2020,7,17,17,2871,2853,1860,-993
2020,7,17,18,2969,2991,2008,-983
2020,7,17,19,3138,3100,2089,-1011
2020,7,17,20,3310,3222,2187,-1035
2020,7,17,21,3417,3315,2348,-967
2020,7,17,22,3455,3389,2418,-971
2020,7,17,23,3545,3452,2479,-973
2020,7,18,0,3522,3474,2576,-898
2020,7,18,1,3533,3481,2556,-925
2020,7,18,2,3528,3469,2585,-884
2020,7,18,3,3354,3341,2326,-1015
2020,7,18,4,3194,3202,2126,-1076
2020,7,18,5,3047,3047,2074,-973
2020,7,18,6,2887,2788,2031,-757
2020,7,18,7,2712,2596,1850,-746
2020,7,18,8,2560,2442,1861,-581
2020,7,18,9,2313,2308,1745,-563
2020,7,18,10,2227,2226,1819,-407
2020,7,18,11,2157,2159,1796,-363
2020,7,18,12,2120,2131,1734,-397
2020,7,18,13,2126,2114,1603,-511
2020,7,18,14,2250,2211,1648,-563
2020,7,18,15,2428,2323,1688,-635
2020,7,18,16,2563,2447,1726,-721
2020,7,18,17,2642,2571,1969,-602
2020,7,18,18,2727,2664,2063,-601
2020,7,18,19,2848,2743,2140,-603
2020,7,18,20,2928,2824,2100,-724
2020,7,18,21,3014,2916,2125,-791
2020,7,18,22,3113,2985,2136,-849
2020,7,18,23,3176,3061,2214,-847
2020,7,19,0,3212,3115,2223,-892
2020,7,19,1,3251,3155,2273,-882
2020,7,19,2,3248,3149,2323,-826
2020,7,19,3,3140,3027,2098,-929
2020,7,19,4,3004,2917,2073,-844
2020,7,19,5,2870,2743,2008,-735
2020,7,19,6,2710,2536,1797,-739
2020,7,19,7,2577,2366,1804,-562
2020,7,19,8,2392,2240,1797,-443
2020,7,19,9,2224,2139,1641,-498
2020,7,19,10,2147,2069,1637,-432
2020,7,19,11,2078,2035,1588,-447
2020,7,19,12,2089,2011,1567,-444
2020,7,19,13,2077,2010,1547,-463
2020,7,19,14,2159,2056,1570,-486
2020,7,19,15,2379,2177,1617,-560
2020,7,19,16,2534,2312,1638,-674
2020,7,19,17,2622,2448,1741,-707
2020,7,19,18,2728,2553,1787,-766
2020,7,19,19,2819,2675,2003,-672
2020,7,19,20,2955,2791,2080,-711
2020,7,19,21,3039,2888,2111,-777
2020,7,19,22,3085,2996,2098,-898
2020,7,19,23,3140,3094,2238,-856
2020,7,20,0,3224,3168,2259,-909
2020,7,20,1,3265,3206,2283,-923
2020,7,20,2,3279,3165,2343,-822
2020,7,20,3,3181,3096,2122,-974
2020,7,20,4,3040,2946,2041,-905
2020,7,20,5,2896,2763,2081,-682
2020,7,20,6,2641,2518,1772,-746
2020,7,20,7,2528,2340,1644,-696
2020,7,20,8,2382,2209,1647,-562
2020,7,20,9,2245,2137,1523,-614
2020,7,20,10,2181,2072,1506,-566
2020,7,20,11,2184,2066,1522,-544
2020,7,20,12,2164,2082,1480,-602
2020,7,20,13,2225,2164,1495,-669
2020,7,20,14,2388,2321,1538,-783
2020,7,20,15,2592,2478,1728,-750
2020,7,20,16,2726,2607,1850,-757
2020,7,20,17,2853,2761,1859,-902
2020,7,20,18,2996,2902,1921,-981
2020,7,20,19,3118,3040,2008,-1032
2020,7,20,20,3241,3173,2174,-999
2020,7,20,21,3355,3260,2254,-1006
2020,7,20,22,3491,3342,2304,-1038
2020,7,20,23,3569,3403,2415,-988
2020,7,21,0,3607,3453,2436,-1017
2020,7,21,1,3654,3471,2568,-903
2020,7,21,2,3640,3459,2528,-931
2020,7,21,3,3496,3339,2341,-998
2020,7,21,4,3341,3193,2336,-857
2020,7,21,5,3182,2985,2305,-680
2020,7,21,6,2892,2734,2028,-706
2020,7,21,7,2681,2514,1702,-812
2020,7,21,8,2525,2388,1513,-875
2020,7,21,9,2425,2287,1344,-943
2020,7,21,10,2350,2220,1260,-960
2020,7,21,11,2276,2168,1253,-915
2020,7,21,12,2238,2191,1237,-954
2020,7,21,13,2319,2250,1231,-1019
2020,7,21,14,2476,2392,1315,-1077
2020,7,21,15,2649,2539,1591,-948
2020,7,21,16,2827,2694,1616,-1078
2020,7,21,17,3012,2821,1853,-968
2020,7,21,18,3126,2968,2028,-940
2020,7,21,19,3211,3115,2091,-1024
2020,7,21,20,3320,3258,2180,-1078
2020,7,21,21,3432,3312,2194,-1118
2020,7,21,22,3531,3329,2329,-1000
2020,7,21,23,3575,3340,2352,-988
2020,7,22,0,3589,3356,2345,-1011
2020,7,22,1,3594,3383,2314,-1069
2020,7,22,2,3452,3430,2257,-1173
2020,7,22,3,3389,3389,2081,-1308
2020,7,22,4,3229,3289,2013,-1276
2020,7,22,5,3092,3088,1938,-1150
2020,7,22,6,2940,2819,1903,-916
2020,7,22,7,2724,2608,1738,-870
2020,7,22,8,2606,2488,1557,-931
2020,7,22,9,2543,2390,1369,-1021
2020,7,22,10,2433,2318,1365,-953
2020,7,22,11,2384,2286,1411,-875
2020,7,22,12,2407,2294,1452,-842
2020,7,22,13,2510,2342,1545,-797
2020,7,22,14,2663,2464,1619,-845
2020,7,22,15,2782,2591,1645,-946
2020,7,22,16,2867,2679,1603,-1076
2020,7,22,17,2993,2773,1751,-1022
2020,7,22,18,3035,2851,1792,-1059
2020,7,22,19,3102,2927,1833,-1094
2020,7,22,20,3221,2952,1990,-962
2020,7,22,21,3234,3024,2122,-902
2020,7,22,22,3187,3143,2069,-1074
2020,7,22,23,3213,3194,2041,-1153
2020,7,23,0,3240,3173,2097,-1076
2020,7,23,1,3338,3138,2020,-1118
2020,7,23,2,3293,3103,2046,-1057
2020,7,23,3,3168,3046,2183,-863
2020,7,23,4,3132,2988,2215,-773
2020,7,23,5,2986,2813,2042,-771
2020,7,23,6,2767,2604,1812,-792
2020,7,23,7,2622,2426,1738,-688
2020,7,23,8,2486,2317,1627,-690
2020,7,23,9,2375,2231,1462,-769
2020,7,23,10,2319,2172,1452,-720
2020,7,23,11,2279,2139,1505,-634
2020,7,23,12,2258,2172,1548,-624
2020,7,23,13,2341,2244,1527,-717
2020,7,23,14,2502,2357,1617,-740
2020,7,23,15,2644,2522,1831,-691
2020,7,23,16,2743,2659,1945,-714
2020,7,23,17,2936,2788,1948,-840
2020,7,23,18,3102,2930,1923,-1007
2020,7,23,19,3177,3042,1924,-1118
2020,7,23,20,3249,3179,1973,-1206
2020,7,23,21,3356,3270,1930,-1340
2020,7,23,22,3424,3312,1930,-1382
2020,7,23,23,3511,3305,2031,-1274
2020,7,24,0,3480,3197,2230,-967
2020,7,24,1,3385,2975,2131,-844
2020,7,24,2,3268,2838,2206,-632
2020,7,24,3,3036,2744,2137,-607
2020,7,24,4,2975,2652,1956,-696
2020,7,24,5,2806,2522,1710,-812
2020,7,24,6,2566,2361,1663,-698
2020,7,24,7,2433,2224,1541,-683
2020,7,24,8,2306,2129,1502,-627
2020,7,24,9,2197,2085,1463,-622
2020,7,24,10,2146,2030,1392,-638
2020,7,24,11,2126,2011,1366,-645
2020,7,24,12,2122,2041,1340,-701
2020,7,24,13,2180,2110,1470,-640
2020,7,24,14,2334,2212,1557,-655
2020,7,24,15,2506,2344,1657,-687
2020,7,24,16,2641,2485,2066,-419
2020,7,24,17,2808,2549,1964,-585
2020,7,24,18,2938,2654,1922,-732
2020,7,24,19,2959,2765,1889,-876
2020,7,24,20,3002,2873,1775,-1098
2020,7,24,21,3070,2988,2097,-891
2020,7,24,22,3154,3083,2158,-925
2020,7,24,23,3208,3121,2290,-831
2020,7,25,0,3122,3144,2368,-776
2020,7,25,1,3098,3141,2204,-937
2020,7,25,2,3209,3107,2136,-971
2020,7,25,3,3158,3015,2045,-970
2020,7,25,4,3000,2913,1912,-1001
2020,7,25,5,2851,2735,1740,-995
2020,7,25,6,2663,2533,1572,-961
2020,7,25,7,2554,2361,1418,-943
2020,7,25,8,2375,2222,1297,-925
2020,7,25,9,2231,2133,1276,-857
2020,7,25,10,2137,2062,1298,-764
2020,7,25,11,2076,2004,1338,-666
2020,7,25,12,2026,2003,1416,-587
2020,7,25,13,2026,2007,1440,-567
2020,7,25,14,2115,2065,1471,-594
2020,7,25,15,2296,2179,1571,-608
2020,7,25,16,2443,2278,1616,-662
2020,7,25,17,2543,2377,1624,-753
2020,7,25,18,2631,2467,1672,-795
2020,7,25,19,2717,2554,1638,-916
2020,7,25,20,2794,2653,1662,-991
2020,7,25,21,2831,2742,1728,-1014
2020,7,25,22,2928,2847,1878,-969
2020,7,25,23,2994,2929,1987,-942
2020,7,26,0,3023,3005,2101,-904
2020,7,26,1,3000,3021,2122,-899
2020,7,26,2,3072,2978,2012,-966
2020,7,26,3,3038,2894,1955,-939
2020,7,26,4,2878,2752,1842,-910
2020,7,26,5,2656,2588,1784,-804
2020,7,26,6,2485,2388,1623,-765
2020,7,26,7,2424,2233,1373,-860
2020,7,26,8,2277,2114,1336,-778
2020,7,26,9,2100,2027,1299,-728
2020,7,26,10,2023,1981,1260,-721
2020,7,26,11,1990,1954,1265,-689
2020,7,26,12,1962,1927,1333,-594
2020,7,26,13,1972,1926,1323,-603
2020,7,26,14,2042,1975,1387,-588
2020,7,26,15,2226,2089,1568,-521
2020,7,26,16,2414,2200,1550,-650
2020,7,26,17,2525,2289,1555,-734
2020,7,26,18,2631,2388,1581,-807
2020,7,26,19,2718,2511,1612,-899
2020,7,26,20,2756,2629,1610,-1019
2020,7,26,21,2812,2765,1776,-989
2020,7,26,22,2973,2896,1806,-1090
2020,7,26,23,3062,3002,2027,-975
2020,7,27,0,3133,3114,2066,-1048
2020,7,27,1,3224,3127,2185,-942
2020,7,27,2,3205,3096,2102,-994
2020,7,27,3,3135,3005,2193,-812
2020,7,27,4,3024,2849,2132,-717
2020,7,27,5,2789,2650,2010,-640
2020,7,27,6,2535,2416,1779,-637
2020,7,27,7,2412,2225,1446,-779
2020,7,27,8,2257,2100,1183,-917
2020,7,27,9,2203,2010,1181,-829
2020,7,27,10,2157,1967,1164,-803
2020,7,27,11,2092,1956,1158,-798
2020,7,27,12,2090,1991,1173,-818
2020,7,27,13,2201,2067,1196,-871
2020,7,27,14,2362,2185,1292,-893
2020,7,27,15,2497,2332,1366,-966
2020,7,27,16,2630,2455,1328,-1127
2020,7,27,17,2785,2586,1464,-1122
2020,7,27,18,2848,2716,1551,-1165
2020,7,27,19,2955,2878,1831,-1047
2020,7,27,20,3096,3020,1994,-1026
2020,7,27,21,3218,3164,1951,-1213
2020,7,27,22,3355,3274,1902,-1372
2020,7,27,23,3471,3287,2051,-1236
2020,7,28,0,3482,3257,2094,-1163
2020,7,28,1,3406,3231,2107,-1124
2020,7,28,2,3344,3224,2308,-916
2020,7,28,3,3277,3120,2070,-1050
2020,7,28,4,3151,3049,1922,-1127
2020,7,28,5,3029,2853,1843,-1010
2020,7,28,6,2786,2635,1842,-793
2020,7,28,7,2698,2449,1763,-686
2020,7,28,8,2585,2323,1724,-599
2020,7,28,9,2355,2238,1641,-597
2020,7,28,10,2298,2177,1435,-742
2020,7,28,11,2313,2156,1422,-734
2020,7,28,12,2278,2170,1483,-687
2020,7,28,13,2308,2233,1499,-734
2020,7,28,14,2438,2355,1611,-744
2020,7,28,15,2597,2459,1566,-893
2020,7,28,16,2699,2571,1694,-877
2020,7,28,17,2780,2706,1696,-1010
2020,7,28,18,2882,2844,1691,-1153
2020,7,28,19,2996,2976,1860,-1116
2020,7,28,20,3103,3084,1944,-1140
2020,7,28,21,3258,3186,2011,-1175
2020,7,28,22,3354,3288,2181,-1107
2020,7,28,23,3387,3340,2194,-1146
2020,7,29,0,3467,3352,2252,-1100
2020,7,29,1,3521,3340,2186,-1154
2020,7,29,2,3530,3268,2150,-1118
2020,7,29,3,3306,3129,2173,-956
2020,7,29,4,3183,2981,2047,-934
2020,7,29,5,3014,2807,1903,-904
2020,7,29,6,2824,2592,1671,-921
2020,7,29,7,2544,2423,1479,-944
2020,7,29,8,2374,2290,1357,-933
2020,7,29,9,2395,2193,1295,-898
2020,7,29,10,2308,2123,1295,-828
2020,7,29,11,2249,2079,1332,-747
2020,7,29,12,2220,2105,1386,-719
2020,7,29,13,2316,2172,1463,-709
2020,7,29,14,2451,2294,1540,-754
2020,7,29,15,2588,2410,1631,-779
2020,7,29,16,2774,2549,1672,-877
2020,7,29,17,2905,2688,1712,-976
2020,7,29,18,2995,2837,1837,-1000
2020,7,29,19,3170,2978,1803,-1175
2020,7,29,20,3308,3109,1909,-1200
2020,7,29,21,3396,3246,2010,-1236
2020,7,29,22,3504,3377,2173,-1204
2020,7,29,23,3505,3460,2106,-1354
2020,7,30,0,3521,3491,2128,-1363
2020,7,30,1,3559,3528,2250,-1278
2020,7,30,2,3570,3503,2191,-1312
2020,7,30,3,3530,3383,2143,-1240
2020,7,30,4,3377,3213,2013,-1200
2020,7,30,5,3158,3023,2040,-983
2020,7,30,6,2884,2752,2111,-641
2020,7,30,7,2575,2538,1865,-673
2020,7,30,8,2506,2395,1649,-746
2020,7,30,9,2448,2285,1625,-660
2020,7,30,10,2370,2218,1627,-591
2020,7,30,11,2283,2174,1588,-586
2020,7,30,12,2256,2186,1598,-588
2020,7,30,13,2379,2247,1589,-658
2020,7,30,14,2503,2370,1701,-669
2020,7,30,15,2594,2505,1844,-661
2020,7,30,16,2760,2661,1882,-779
2020,7,30,17,2954,2794,1908,-886
2020,7,30,18,3101,2931,1886,-1045
2020,7,30,19,3274,3092,2108,-984
2020,7,30,20,3404,3254,2116,-1138
2020,7,30,21,3665,3381,2271,-1110
2020,7,30,22,3744,3508,2281,-1227
2020,7,30,23,3814,3554,2301,-1253
2020,7,31,0,3778,3613,2359,-1254
2020,7,31,1,3761,3611,2316,-1295
2020,7,31,2,3729,3617,2424,-1193
2020,7,31,3,3604,3539,2368,-1171
2020,7,31,4,3523,3399,2189,-1210
2020,7,31,5,3374,3167,2044,-1123
2020,7,31,6,3141,2913,1922,-991
2020,7,31,7,2827,2700,1800,-900
2020,7,31,8,2689,2519,1614,-905
2020,7,31,9,2565,2391,1589,-802
2020,7,31,10,2455,2304,1548,-756
2020,7,31,11,2365,2252,1597,-655
2020,7,31,12,2322,2252,1554,-698
2020,7,31,13,2414,2295,1565,-730
2020,7,31,14,2548,2397,1530,-867
2020,7,31,15,2674,2554,1605,-949
2020,7,31,16,2882,2732,1743,-989
2020,7,31,17,3103,2925,1975,-950
2020,7,31,18,3274,3108,2009,-1099
2020,7,31,19,3467,3284,2142,-1142
2020,7,31,20,3618,3421,1992,-1429
2020,7,31,21,3719,3489,2180,-1309
2020,7,31,22,3852,3468,2121,-1347
2020,7,31,23,3772,3466,2101,-1365
2020,8,1,0,3627,3459,2148,-1311
2020,8,1,1,3589,3479,2196,-1283
2020,8,1,2,3587,3491,2210,-1281
2020,8,1,3,3461,3435,2293,-1142
2020,8,1,4,3380,3328,2097,-1231
2020,8,1,5,3203,3120,1984,-1136
2020,8,1,6,2976,2881,1944,-937
2020,8,1,7,2850,2658,1796,-862
2020,8,1,8,2649,2481,1645,-836
2020,8,1,9,2426,2361,1519,-842
2020,8,1,10,2295,2246,1438,-808
2020,8,1,11,2248,2191,1446,-745
2020,8,1,12,2210,2141,1449,-692
2020,8,1,13,2199,2125,1391,-734
2020,8,1,14,2291,2212,1352,-860
2020,8,1,15,2487,2364,1289,-1075
2020,8,1,16,2660,2496,1227,-1269
2020,8,1,17,2792,2671,1470,-1201
2020,8,1,18,2920,2833,1841,-992
2020,8,1,19,3044,2957,1911,-1046
2020,8,1,20,3186,3069,1968,-1101
2020,8,1,21,3187,3194,2024,-1170
2020,8,1,22,3252,3339,2066,-1273
2020,8,1,23,3389,3429,2211,-1218
2020,8,2,0,3532,3498,2280,-1218
2020,8,2,1,3571,3498,2255,-1243
2020,8,2,2,3530,3468,2378,-1090
2020,8,2,3,3408,3349,2329,-1020
2020,8,2,4,3276,3179,2168,-1011
2020,8,2,5,3105,2978,1998,-980
2020,8,2,6,2905,2738,1866,-872
2020,8,2,7,2676,2539,1569,-970
2020,8,2,8,2497,2393,1526,-867
2020,8,2,9,2327,2256,1368,-888
2020,8,2,10,2206,2169,1360,-809
2020,8,2,11,2160,2114,1365,-749
2020,8,2,12,2114,2078,1409,-669
2020,8,2,13,2068,2052,1332,-720
2020,8,2,14,2146,2093,1362,-731
2020,8,2,15,2352,2224,1451,-773
2020,8,2,16,2535,2383,1430,-953
2020,8,2,17,2685,2551,1723,-828
2020,8,2,18,2844,2714,1926,-788
2020,8,2,19,2986,2872,2069,-803
2020,8,2,20,3096,3027,2199,-828
2020,8,2,21,3207,3166,2214,-952
2020,8,2,22,3307,3290,2236,-1054
2020,8,2,23,3418,3409,2252,-1157
2020,8,3,0,3491,3484,2296,-1188
2020,8,3,1,3497,3472,2295,-1177
2020,8,3,2,3481,3412,2297,-1115
2020,8,3,3,3346,3272,2410,-862
2020,8,3,4,3209,3133,2255,-878
2020,8,3,5,3028,2917,2040,-877
2020,8,3,6,2792,2656,1690,-966
2020,8,3,7,2594,2454,1487,-967
2020,8,3,8,2430,2313,1555,-758
2020,8,3,9,2230,2211,1655,-556
2020,8,3,10,2163,2137,1716,-421
2020,8,3,11,2154,2118,1769,-349
2020,8,3,12,2198,2147,1790,-357
2020,8,3,13,2255,2214,1844,-370
2020,8,3,14,2366,2342,1870,-472
2020,8,3,15,2515,2491,2188,-303
2020,8,3,16,2661,2637,2260,-377
2020,8,3,17,2795,2748,2277,-471
2020,8,3,18,2931,2865,2394,-471
2020,8,3,19,3089,2975,2571,-404
2020,8,3,20,3228,3080,2560,-520
2020,8,3,21,3251,3175,2499,-676
2020,8,3,22,3305,3249,2445,-804
2020,8,3,23,3336,3299,2374,-925
2020,8,4,0,3371,3332,2426,-906
2020,8,4,1,3354,3363,2462,-901
2020,8,4,2,3328,3317,2490,-827
2020,8,4,3,3224,3187,2306,-881
2020,8,4,4,3153,3053,2171,-882
2020,8,4,5,2932,2850,2139,-711
2020,8,4,6,2690,2585,1849,-736
2020,8,4,7,2542,2398,1543,-855
2020,8,4,8,2362,2263,1532,-731
2020,8,4,9,2187,2169,1549,-620
2020,8,4,10,2126,2098,1550,-548
2020,8,4,11,2116,2063,1535,-528
2020,8,4,12,2153,2103,1560,-543
2020,8,4,13,2212,2147,1484,-663
2020,8,4,14,2333,2276,1502,-774
2020,8,4,15,2494,2397,1643,-754
2020,8,4,16,2642,2508,1783,-725
2020,8,4,17,2769,2617,1802,-815
2020,8,4,18,2853,2734,1856,-878
2020,8,4,19,3065,2847,1928,-919
2020,8,4,20,3209,2964,2027,-937
2020,8,4,21,3184,3092,2200,-892
2020,8,4,22,3317,3186,2225,-961
2020,8,4,23,3360,3262,2231,-1031
2020,8,5,0,3394,3310,2251,-1059
2020,8,5,1,3449,3336,2261,-1075
2020,8,5,2,3421,3304,2297,-1007
2020,8,5,3,3308,3165,2144,-1021
2020,8,5,4,3207,3019,2142,-877
2020,8,5,5,2950,2794,1947,-847
2020,8,5,6,2626,2544,1691,-853
2020,8,5,7,2492,2352,1499,-853
2020,8,5,8,2341,2217,1374,-843
2020,8,5,9,2265,2142,1374,-768
2020,8,5,10,2187,2077,1352,-725
2020,8,5,11,2150,2059,1341,-718
2020,8,5,12,2143,2083,1331,-752
2020,8,5,13,2222,2143,1351,-792
2020,8,5,14,2355,2255,1446,-809
2020,8,5,15,2547,2394,1544,-850
2020,8,5,16,2733,2515,1585,-930
2020,8,5,17,2923,2611,1618,-993
2020,8,5,18,3073,2817,1656,-1161
2020,8,5,19,3141,2933,1479,-1454
2020,8,5,20,3330,3090,1696,-1394
2020,8,5,21,3440,3243,1962,-1281
2020,8,5,22,3495,3382,2019,-1363
2020,8,5,23,3614,3418,2066,-1352
2020,8,6,0,3718,3414,2091,-1323
2020,8,6,1,3704,3400,2018,-1382
2020,8,6,2,3597,3342,1990,-1352
2020,8,6,3,3452,3251,1987,-1264
2020,8,6,4,3277,3165,1955,-1210
2020,8,6,5,3133,2974,1715,-1259
2020,8,6,6,2931,2749,1823,-926
2020,8,6,7,2738,2592,1772,-820
2020,8,6,8,2642,2474,1643,-831
2020,8,6,9,2557,2393,1534,-859
2020,8,6,10,2418,2288,1346,-942
2020,8,6,11,2343,2238,1391,-847
2020,8,6,12,2267,2240,1402,-838
2020,8,6,13,2311,2294,1456,-838
2020,8,6,14,2413,2389,1594,-795
2020,8,6,15,2620,2545,1702,-843
2020,8,6,16,2796,2683,1724,-959
2020,8,6,17,2902,2812,1744,-1068
2020,8,6,18,3013,2948,1768,-1180
2020,8,6,19,3122,3055,1754,-1301
2020,8,6,20,3243,3180,1866,-1314
2020,8,6,21,3335,3282,1955,-1327
2020,8,6,22,3424,3361,2046,-1315
2020,8,6,23,3400,3413,2125,-1288
2020,8,7,0,3414,3403,2122,-1281
2020,8,7,1,3385,3415,2136,-1279
2020,8,7,2,3306,3325,2049,-1276
2020,8,7,3,3185,3186,2004,-1182
2020,8,7,4,3092,3047,1898,-1149
2020,8,7,5,2848,2834,1819,-1015
2020,8,7,6,2622,2600,1615,-985
2020,8,7,7,2428,2410,1592,-818
2020,8,7,8,2283,2283,1640,-643
2020,8,7,9,2152,2182,1634,-548
2020,8,7,10,2102,2121,1673,-448
2020,8,7,11,2093,2080,1640,-440
2020,8,7,12,2124,2095,1638,-457
2020,8,7,13,2171,2139,1608,-531
2020,8,7,14,2274,2237,1674,-563
2020,8,7,15,2362,2334,1738,-596
2020,8,7,16,2508,2414,1847,-567
2020,8,7,17,2581,2456,1846,-610
2020,8,7,18,2640,2507,1794,-713
2020,8,7,19,2716,2559,1718,-841
2020,8,7,20,2875,2612,1843,-769
2020,8,7,21,2869,2684,1858,-826
2020,8,7,22,2846,2739,1830,-909
2020,8,7,23,2917,2786,1858,-928
2020,8,8,0,2828,2841,1878,-963
2020,8,8,1,2826,2873,1975,-898
2020,8,8,2,2892,2838,1978,-860
2020,8,8,3,2794,2759,1832,-927
2020,8,8,4,2687,2664,1820,-844
2020,8,8,5,2542,2511,1807,-704
2020,8,8,6,2399,2322,1577,-745
2020,8,8,7,2203,2186,1366,-820
2020,8,8,8,2115,2085,1235,-850
2020,8,8,9,2041,2025,1246,-779
2020,8,8,10,2016,1967,1247,-720
2020,8,8,11,1991,1936,1210,-726
2020,8,8,12,1977,1950,1202,-748
2020,8,8,13,1988,1954,1244,-710
2020,8,8,14,2088,2032,1205,-827
2020,8,8,15,2276,2132,1194,-938
2020,8,8,16,2433,2221,1166,-1055
2020,8,8,17,2510,2298,1192,-1106
2020,8,8,18,2538,2380,1469,-911
2020,8,8,19,2628,2450,1526,-924
2020,8,8,20,2716,2554,1551,-1003
2020,8,8,21,2742,2629,1628,-1001
2020,8,8,22,2824,2732,1714,-1018
2020,8,8,23,2870,2841,1887,-954
2020,8,9,0,2940,2928,1904,-1024
2020,8,9,1,3030,2964,1899,-1065
2020,8,9,2,2934,2949,1966,-983
2020,8,9,3,2818,2842,1791,-1051
2020,8,9,4,2752,2730,1636,-1094
2020,8,9,5,2605,2570,1565,-1005
2020,8,9,6,2426,2366,1486,-880
2020,8,9,7,2325,2222,1262,-960
2020,8,9,8,2234,2097,1151,-946
2020,8,9,9,2065,2027,1166,-861
2020,8,9,10,2028,1967,1166,-801
2020,8,9,11,2015,1924,1197,-727
2020,8,9,12,2002,1920,1212,-708
2020,8,9,13,1987,1918,1200,-718
2020,8,9,14,2020,1955,1216,-739
2020,8,9,15,2186,2053,1315,-738
2020,8,9,16,2339,2162,1314,-848
2020,8,9,17,2448,2283,1372,-911
2020,8,9,18,2582,2395,1566,-829
2020,8,9,19,2600,2488,1623,-865
2020,8,9,20,2630,2563,1700,-863
2020,8,9,21,2727,2667,1911,-756
2020,8,9,22,2818,2773,1992,-781
2020,8,9,23,2925,2864,2082,-782
2020,8,10,0,3007,2944,2082,-862
2020,8,10,1,3008,2964,2095,-869
2020,8,10,2,2925,2919,2047,-872
2020,8,10,3,2811,2805,1915,-890
2020,8,10,4,2756,2697,1800,-897
2020,8,10,5,2590,2515,1697,-818
2020,8,10,6,2378,2309,1660,-649
2020,8,10,7,2278,2147,1546,-601
2020,8,10,8,2134,2042,1413,-629
2020,8,10,9,2053,1964,1378,-586
2020,8,10,10,1995,1921,1345,-576
2020,8,10,11,1973,1920,1233,-687
2020,8,10,12,2016,1963,1199,-764
2020,8,10,13,2109,2040,1204,-836
2020,8,10,14,2221,2175,1235,-940
2020,8,10,15,2414,2298,1365,-933
2020,8,10,16,2547,2421,1439,-982
2020,8,10,17,2596,2507,1413,-1094
2020,8,10,18,2644,2603,1413,-1190
2020,8,10,19,2873,2698,1562,-1136
2020,8,10,20,2924,2808,1676,-1132
2020,8,10,21,3007,2910,1746,-1164
2020,8,10,22,3069,3002,1785,-1217
2020,8,10,23,3132,3073,1915,-1158
2020,8,11,0,3208,3151,2006,-1145
2020,8,11,1,3272,3191,2158,-1033
2020,8,11,2,3273,3173,2177,-996
2020,8,11,3,3147,3035,1846,-1189
2020,8,11,4,3004,2873,1653,-1220
2020,8,11,5,2755,2673,1551,-1122
2020,8,11,6,2506,2442,1512,-930
2020,8,11,7,2358,2271,1319,-952
2020,8,11,8,2246,2159,1196,-963
2020,8,11,9,2180,2084,1127,-957
2020,8,11,10,2148,2034,1112,-922
2020,8,11,11,2121,2016,1121,-895
2020,8,11,12,2123,2034,1127,-907
2020,8,11,13,2205,2111,1144,-967
2020,8,11,14,2340,2215,1222,-993
2020,8,11,15,2499,2341,1335,-1006
2020,8,11,16,2653,2451,1414,-1037
2020,8,11,17,2822,2563,1419,-1144
2020,8,11,18,2932,2713,1634,-1079
2020,8,11,19,2906,2844,1673,-1171
2020,8,11,20,3091,2986,1666,-1320
2020,8,11,21,3139,3123,1683,-1440
2020,8,11,22,3266,3251,1826,-1425
2020,8,11,23,3352,3318,1820,-1498
2020,8,12,0,3437,3340,1954,-1386
2020,8,12,1,3460,3338,1925,-1413
2020,8,12,2,3366,3258,1851,-1407
2020,8,12,3,3226,3136,1741,-1395
2020,8,12,4,3095,3039,1717,-1322
2020,8,12,5,2933,2844,1542,-1302
2020,8,12,6,2784,2614,1476,-1138
2020,8,12,7,2622,2457,1426,-1031
2020,8,12,8,2459,2342,1414,-928
2020,8,12,9,2322,2242,1319,-923
2020,8,12,10,2252,2172,1283,-889
2020,8,12,11,2195,2122,1321,-801
2020,8,12,12,2140,2118,1392,-726
2020,8,12,13,2198,2183,1429,-754
2020,8,12,14,2265,2269,1456,-813
2020,8,12,15,2452,2401,1536,-865
2020,8,12,16,2617,2521,1637,-884
2020,8,12,17,2693,2644,1717,-927
2020,8,12,18,2788,2759,1702,-1057
2020,8,12,19,2827,2844,1689,-1155
2020,8,12,20,2927,2938,1768,-1170
2020,8,12,21,3045,2977,1816,-1161
2020,8,12,22,3121,3045,1843,-1202
2020,8,12,23,3151,3038,1861,-1177
2020,8,13,0,3200,3034,1912,-1122
2020,8,13,1,3182,3033,1781,-1252
2020,8,13,2,3108,2969,1607,-1362
2020,8,13,3,2943,2875,1643,-1232
2020,8,13,4,2823,2791,1476,-1315
2020,8,13,5,2681,2625,1391,-1234
2020,8,13,6,2492,2415,1345,-1070
2020,8,13,7,2339,2254,1362,-892
2020,8,13,8,2182,2148,1323,-825
2020,8,13,9,2120,2078,1291,-787
2020,8,13,10,2098,2019,1337,-682
2020,8,13,11,2064,2002,1314,-688
2020,8,13,12,2085,1993,1305,-688
2020,8,13,13,2191,2080,1224,-856
2020,8,13,14,2239,2178,1261,-917
2020,8,13,15,2356,2274,1353,-921
2020,8,13,16,2522,2365,1413,-952
2020,8,13,17,2545,2443,1421,-1022
2020,8,13,18,2607,2536,1444,-1092
2020,8,13,19,2727,2630,1529,-1101
2020,8,13,20,2844,2732,1449,-1283
2020,8,13,21,2978,2825,1612,-1213
2020,8,13,22,3096,2935,1847,-1088
2020,8,13,23,3168,3021,1813,-1208
2020,8,14,0,3160,3087,1954,-1133
2020,8,14,1,3303,3117,2019,-1098
2020,8,14,2,3185,3095,1834,-1261
2020,8,14,3,3022,2963,1827,-1136
2020,8,14,4,2973,2875,2007,-868
2020,8,14,5,2708,2671,1876,-795
2020,8,14,6,2506,2439,1701,-738
2020,8,14,7,2309,2273,1623,-650
2020,8,14,8,2229,2146,1571,-575
2020,8,14,9,2104,2070,1414,-656
2020,8,14,10,2014,2001,1328,-673
2020,8,14,11,1994,1982,1290,-692
2020,8,14,12,1995,2005,1290,-715
2020,8,14,13,2085,2080,1359,-721
2020,8,14,14,2198,2186,1286,-900
2020,8,14,15,2324,2292,1406,-886
2020,8,14,16,2504,2387,1512,-875
2020,8,14,17,2604,2457,1599,-858
2020,8,14,18,2637,2527,1575,-952
2020,8,14,19,2744,2600,1583,-1017
2020,8,14,20,2832,2685,1694,-991
2020,8,14,21,2897,2789,1837,-952
2020,8,14,22,2932,2869,1908,-961
2020,8,14,23,3074,2943,1966,-977
2020,8,15,0,3056,3007,2124,-883
2020,8,15,1,3044,3039,2272,-767
2020,8,15,2,3116,3012,2244,-768
2020,8,15,3,2919,2879,2083,-796
2020,8,15,4,2758,2741,1901,-840
2020,8,15,5,2631,2555,1783,-772
2020,8,15,6,2478,2367,1729,-638
2020,8,15,7,2319,2218,1479,-739
2020,8,15,8,2186,2104,1379,-725
2020,8,15,9,2116,2031,1332,-699
2020,8,15,10,2070,1975,1333,-642
2020,8,15,11,2044,1947,1277,-670
2020,8,15,12,2008,1941,1288,-653
2020,8,15,13,2030,1965,1322,-643
2020,8,15,14,2113,2020,1165,-855
2020,8,15,15,2277,2131,1238,-893
2020,8,15,16,2414,2243,1324,-919
2020,8,15,17,2492,2348,1523,-825
2020,8,15,18,2527,2436,1558,-878
2020,8,15,19,2614,2549,1606,-943
2020,8,15,20,2702,2657,1594,-1063
2020,8,15,21,2823,2806,1654,-1152
2020,8,15,22,2996,2952,1850,-1102
2020,8,15,23,3132,3069,1964,-1105
2020,8,16,0,3242,3187,2048,-1139
2020,8,16,1,3352,3227,2107,-1120
2020,8,16,2,3286,3211,2221,-990
2020,8,16,3,3124,3061,1805,-1256
2020,8,16,4,3021,2929,1540,-1389
2020,8,16,5,2853,2724,1460,-1264
2020,8,16,6,2651,2510,1379,-1131
2020,8,16,7,2439,2341,1323,-1018
2020,8,16,8,2351,2202,1274,-928
2020,8,16,9,2290,2115,1269,-846
2020,8,16,10,2210,2048,1254,-794
2020,8,16,11,2181,1992,1163,-829
2020,8,16,12,2116,1982,1262,-720
2020,8,16,13,2107,1979,1347,-632
2020,8,16,14,2143,2008,1304,-704
2020,8,16,15,2316,2103,1299,-804
2020,8,16,16,2491,2231,1272,-959
2020,8,16,17,2547,2302,1412,-890
2020,8,16,18,2686,2437,1505,-932
2020,8,16,19,2784,2582,1515,-1067
2020,8,16,20,2936,2702,1688,-1014
2020,8,16,21,3092,2767,1625,-1142
2020,8,16,22,3218,2857,1716,-1141
2020,8,16,23,3272,3022,1813,-1209
2020,8,17,0,3307,3182,1856,-1326
2020,8,17,1,3323,3214,1867,-1347
2020,8,17,2,3318,3170,1831,-1339
2020,8,17,3,3164,3062,1735,-1327
2020,8,17,4,3088,2981,1708,-1273
2020,8,17,5,2909,2786,1652,-1134
2020,8,17,6,2692,2597,1660,-937
2020,8,17,7,2526,2427,1325,-1102
2020,8,17,8,2397,2291,1175,-1116
2020,8,17,9,2282,2183,1123,-1060
2020,8,17,10,2195,2119,1202,-917
2020,8,17,11,2165,2085,1127,-958
2020,8,17,12,2203,2107,1115,-992
2020,8,17,13,2271,2201,1175,-1026
2020,8,17,14,2402,2292,1220,-1072
2020,8,17,15,2604,2462,1368,-1094
2020,8,17,16,2785,2628,1424,-1204
2020,8,17,17,2909,2796,1515,-1281
2020,8,17,18,3024,2964,1616,-1348
2020,8,17,19,3189,3136,1852,-1284
2020,8,17,20,3421,3286,1984,-1302
2020,8,17,21,3540,3456,2144,-1312
2020,8,17,22,3678,3575,2148,-1427
2020,8,17,23,3823,3635,2128,-1507
2020,8,18,0,3860,3593,2074,-1519
2020,8,18,1,3807,3542,2192,-1350
2020,8,18,2,3753,3390,2315,-1075
2020,8,18,3,3477,3259,2263,-996
2020,8,18,4,3285,3137,1983,-1154
2020,8,18,5,3117,2913,1828,-1085
2020,8,18,6,2899,2676,1695,-981
2020,8,18,7,2680,2484,1598,-886
2020,8,18,8,2532,2344,1542,-802
2020,8,18,9,2415,2265,1473,-792
2020,8,18,10,2315,2203,1416,-787
2020,8,18,11,2295,2185,1352,-833
2020,8,18,12,2280,2203,1243,-960
2020,8,18,13,2372,2296,1270,-1026
2020,8,18,14,2475,2405,1239,-1166
2020,8,18,15,2631,2528,1336,-1192
2020,8,18,16,2804,2686,1447,-1239
2020,8,18,17,2924,2860,1655,-1205
2020,8,18,18,3055,3011,1811,-1200
2020,8,18,19,3198,3197,1936,-1261
2020,8,18,20,3446,3357,2031,-1326
2020,8,18,21,3615,3494,2172,-1322
2020,8,18,22,3655,3597,2361,-1236
2020,8,18,23,3783,3651,2457,-1194
2020,8,19,0,3819,3649,2396,-1253
2020,8,19,1,3762,3628,2310,-1318
2020,8,19,2,3659,3522,2199,-1323
2020,8,19,3,3456,3397,2154,-1243
2020,8,19,4,3358,3268,1954,-1314
2020,8,19,5,3181,3045,1613,-1432
2020,8,19,6,2918,2821,1656,-1165
2020,8,19,7,2741,2647,1525,-1122
2020,8,19,8,2582,2517,1603,-914
2020,8,19,9,2498,2414,1409,-1005
2020,8,19,10,2432,2350,1343,-1007
2020,8,19,11,2372,2314,1179,-1135
2020,8,19,12,2410,2325,1224,-1101
2020,8,19,13,2467,2386,1260,-1126
2020,8,19,14,2566,2501,1416,-1085
2020,8,19,15,2734,2619,1499,-1120
2020,8,19,16,2899,2752,1536,-1216
2020,8,19,17,3056,2898,1483,-1415
2020,8,19,18,3225,3052,1665,-1387
2020,8,19,19,3359,3208,1771,-1437
2020,8,19,20,3469,3313,1850,-1463
2020,8,19,21,3575,3357,2027,-1330
2020,8,19,22,3614,3383,2099,-1284
2020,8,19,23,3650,3361,2046,-1315
2020,8,20,0,3638,3352,2046,-1306
2020,8,20,1,3614,3328,1971,-1357
2020,8,20,2,3484,3237,1927,-1310
2020,8,20,3,3285,3154,1895,-1259
2020,8,20,4,3141,3016,1781,-1235
2020,8,20,5,3011,2790,1592,-1198
2020,8,20,6,2812,2578,1515,-1063
2020,8,20,7,2563,2412,1352,-1060
2020,8,20,8,2446,2297,1320,-977
2020,8,20,9,2454,2221,1215,-1006
2020,8,20,10,2350,2178,1268,-910
2020,8,20,11,2279,2152,1310,-842
2020,8,20,12,2250,2187,1350,-837
2020,8,20,13,2349,2261,1342,-919
2020,8,20,14,2416,2371,1339,-1032
2020,8,20,15,2532,2477,1469,-1008
2020,8,20,16,2768,2580,1546,-1034
2020,8,20,17,2808,2669,1595,-1074
2020,8,20,18,2902,2770,1646,-1124
2020,8,20,19,3035,2881,1744,-1137
2020,8,20,20,3164,2977,1791,-1186
2020,8,20,21,3272,3086,1791,-1295
2020,8,20,22,3360,3175,1839,-1336
2020,8,20,23,3415,3223,2006,-1217
2020,8,21,0,3392,3251,1996,-1255
2020,8,21,1,3375,3214,1965,-1249
2020,8,21,2,3280,3144,1791,-1353
2020,8,21,3,3126,3006,1627,-1379
2020,8,21,4,2949,2893,1503,-1390
2020,8,21,5,2805,2670,1342,-1328
2020,8,21,6,2640,2455,1315,-1140
2020,8,21,7,2382,2292,1253,-1039
2020,8,21,8,2310,2183,1161,-1022
2020,8,21,9,2244,2100,1148,-952
2020,8,21,10,2131,2057,1147,-910
2020,8,21,11,2087,2038,1165,-873
2020,8,21,12,2091,2063,1210,-853
2020,8,21,13,2204,2138,1307,-831
2020,8,21,14,2364,2240,1366,-874
2020,8,21,15,2448,2326,1433,-893
2020,8,21,16,2554,2401,1459,-942
2020,8,21,17,2731,2471,1601,-870
2020,8,21,18,2859,2549,1629,-920
2020,8,21,19,3022,2651,1635,-1016
2020,8,21,20,3170,2759,1627,-1132
2020,8,21,21,3279,2893,1640,-1253
2020,8,21,22,3374,3000,1684,-1316
2020,8,21,23,3371,3077,1742,-1335
2020,8,22,0,3250,3103,1783,-1320
2020,8,22,1,3288,3087,1784,-1303
2020,8,22,2,3286,3000,1700,-1300
2020,8,22,3,3052,2886,1628,-1258
2020,8,22,4,2928,2767,1498,-1269
2020,8,22,5,2821,2597,1446,-1151
2020,8,22,6,2620,2427,1467,-960
2020,8,22,7,2501,2268,1324,-944
2020,8,22,8,2313,2169,1382,-787
2020,8,22,9,2146,2074,1337,-737
2020,8,22,10,2083,2034,1313,-721
2020,8,22,11,2044,2002,1276,-726
2020,8,22,12,2045,2007,1271,-736
2020,8,22,13,2086,2019,1342,-677
2020,8,22,14,2150,2074,1378,-696
2020,8,22,15,2244,2167,1449,-718
2020,8,22,16,2322,2261,1512,-749
2020,8,22,17,2421,2336,1530,-806
2020,8,22,18,2515,2430,1508,-922
2020,8,22,19,2622,2517,1603,-914
2020,8,22,20,2762,2619,1610,-1009
2020,8,22,21,2863,2729,1653,-1076
2020,8,22,22,2974,2849,1740,-1109
2020,8,22,23,3090,2926,1702,-1224
2020,8,23,0,3159,3005,1696,-1309
2020,8,23,1,3180,3019,1669,-1350
2020,8,23,2,3126,2921,1513,-1408
2020,8,23,3,2956,2819,1474,-1345
2020,8,23,4,2856,2706,1459,-1247
2020,8,23,5,2741,2529,1407,-1122
2020,8,23,6,2540,2346,1386,-960
2020,8,23,7,2364,2192,1303,-889
2020,8,23,8,2222,2090,1239,-851
2020,8,23,9,2127,2006,1189,-817
2020,8,23,10,2083,1959,1183,-776
2020,8,23,11,2051,1921,1169,-752
2020,8,23,12,2037,1913,1179,-734
2020,8,23,13,2020,1923,1200,-723
2020,8,23,14,2063,1935,1198,-737
2020,8,23,15,2191,2020,1233,-787
2020,8,23,16,2368,2115,1248,-867
2020,8,23,17,2482,2210,1288,-922
2020,8,23,18,2564,2320,1328,-992
2020,8,23,19,2697,2424,1348,-1076
2020,8,23,20,2784,2536,1451,-1085
2020,8,23,21,2902,2671,1602,-1069
2020,8,23,22,3070,2807,1610,-1197
2020,8,23,23,3159,2939,1619,-1320
2020,8,24,0,3268,3001,1703,-1298
2020,8,24,1,3286,2994,1683,-1311
2020,8,24,2,3183,2927,1655,-1272
2020,8,24,3,3034,2849,1534,-1315
2020,8,24,4,2941,2727,1392,-1335
2020,8,24,5,2756,2546,1370,-1176
2020,8,24,6,2498,2340,1314,-1026
2020,8,24,7,2407,2178,1217,-961
2020,8,24,8,2272,2076,1229,-847
2020,8,24,9,2124,1987,1247,-740
2020,8,24,10,2070,1947,1224,-723
2020,8,24,11,2037,1923,1222,-701
2020,8,24,12,2055,1982,1269,-713
2020,8,24,13,2153,2094,1247,-847
2020,8,24,14,2259,2238,1215,-1023
2020,8,24,15,2465,2344,1171,-1173
2020,8,24,16,2601,2419,1123,-1296
2020,8,24,17,2716,2498,1160,-1338
2020,8,24,18,2821,2592,1351,-1241
2020,8,24,19,2958,2649,1380,-1269
2020,8,24,20,3064,2706,1430,-1276
2020,8,24,21,3086,2768,1696,-1072
2020,8,24,22,3130,2880,1938,-942
2020,8,24,23,3204,2965,1772,-1193
2020,8,25,0,3261,3019,1681,-1338
2020,8,25,1,3236,3050,1848,-1202
2020,8,25,2,3163,2983,1778,-1205
2020,8,25,3,3083,2902,1748,-1154
2020,8,25,4,2956,2789,1780,-1009
2020,8,25,5,2796,2567,1643,-924
2020,8,25,6,2558,2394,1496,-898
2020,8,25,7,2515,2247,1313,-934
2020,8,25,8,2334,2149,1414,-735
2020,8,25,9,2198,2090,1239,-851
2020,8,25,10,2174,2034,1171,-863
2020,8,25,11,2138,2022,1197,-825
2020,8,25,12,2157,2061,1155,-906
2020,8,25,13,2276,2162,1208,-954
2020,8,25,14,2400,2283,1216,-1067
2020,8,25,15,2452,2359,1310,-1049
2020,8,25,16,2566,2428,1293,-1135
2020,8,25,17,2703,2515,1428,-1087
2020,8,25,18,2776,2643,1492,-1151
2020,8,25,19,2896,2777,1535,-1242
2020,8,25,20,3064,2910,1487,-1423
2020,8,25,21,3188,3058,1644,-1414
2020,8,25,22,3272,3137,1787,-1350
2020,8,25,23,3324,3181,1834,-1347
2020,8,26,0,3258,3105,1951,-1154
2020,8,26,1,3184,3021,1820,-1201
2020,8,26,2,3054,2942,1884,-1058
2020,8,26,3,2920,2796,1620,-1176
2020,8,26,4,2884,2690,1556,-1134
2020,8,26,5,2753,2496,1408,-1088
2020,8,26,6,2536,2322,1377,-945
2020,8,26,7,2361,2173,1284,-889
2020,8,26,8,2233,2078,1122,-956
2020,8,26,9,2112,2006,1160,-846
2020,8,26,10,2068,1961,1143,-818
2020,8,26,11,2028,1946,1170,-776
2020,8,26,12,2043,1976,1188,-788
2020,8,26,13,2160,2088,1208,-880
2020,8,26,14,2292,2197,1190,-1007
2020,8,26,15,2392,2285,1280,-1005
2020,8,26,16,2454,2380,1281,-1099
2020,8,26,17,2605,2483,1256,-1227
2020,8,26,18,2734,2586,1346,-1240
2020,8,26,19,2866,2730,1544,-1186
2020,8,26,20,2989,2846,1623,-1223
2020,8,26,21,3091,2978,1733,-1245
2020,8,26,22,3210,3083,1778,-1305
2020,8,26,23,3319,3168,1794,-1374
2020,8,27,0,3333,3196,1715,-1481
2020,8,27,1,3335,3185,1749,-1436
2020,8,27,2,3298,3094,1801,-1293
2020,8,27,3,3097,2999,1576,-1423
2020,8,27,4,2980,2852,1396,-1456
2020,8,27,5,2798,2622,1244,-1378
2020,8,27,6,2657,2404,1280,-1124
2020,8,27,7,2383,2259,1271,-988
2020,8,27,8,2247,2157,1272,-885
2020,8,27,9,2189,2087,1254,-833
2020,8,27,10,2118,2029,1236,-793
2020,8,27,11,2095,2018,1241,-777
2020,8,27,12,2103,2040,1175,-865
2020,8,27,13,2224,2132,1392,-740
2020,8,27,14,2338,2256,1432,-824
2020,8,27,15,2436,2349,1450,-899
2020,8,27,16,2530,2443,1358,-1085
2020,8,27,17,2624,2524,1482,-1042
2020,8,27,18,2697,2604,1507,-1097
2020,8,27,19,2834,2692,1401,-1291
2020,8,27,20,2969,2814,1648,-1166
2020,8,27,21,3154,2899,1686,-1213
2020,8,27,22,3169,2991,1677,-1314
2020,8,27,23,3205,3035,1682,-1353
2020,8,28,0,3296,3062,1722,-1340
2020,8,28,1,3264,3050,1734,-1316
2020,8,28,2,3268,2999,1777,-1222
2020,8,28,3,3076,2878,1626,-1252
2020,8,28,4,2918,2741,1591,-1150
2020,8,28,5,2735,2525,1501,-1024
2020,8,28,6,2511,2332,1474,-858
2020,8,28,7,2291,2181,1283,-898
2020,8,28,8,2174,2064,1266,-798
2020,8,28,9,2072,1998,1259,-739
2020,8,28,10,1997,1960,1248,-712
2020,8,28,11,1969,1930,1273,-657
2020,8,28,12,2001,1965,1301,-664
2020,8,28,13,2084,2059,1339,-720
2020,8,28,14,2205,2162,1351,-811
2020,8,28,15,2302,2253,1382,-871
2020,8,28,16,2447,2342,1451,-891
2020,8,28,17,2591,2417,1453,-964
2020,8,28,18,2633,2514,1579,-935
2020,8,28,19,2778,2608,1576,-1032
2020,8,28,20,2913,2720,1567,-1153
2020,8,28,21,2951,2842,1517,-1325
2020,8,28,22,3082,2969,1632,-1337
2020,8,28,23,3125,3024,1607,-1417
2020,8,29,0,3077,3055,1669,-1386
2020,8,29,1,3061,3038,1680,-1358
2020,8,29,2,3041,2941,1243,-1698
2020,8,29,3,2937,2818,1410,-1408
2020,8,29,4,2900,2686,1497,-1189
2020,8,29,5,2712,2509,1551,-958
2020,8,29,6,2488,2308,1380,-928
2020,8,29,7,2322,2152,1193,-959
2020,8,29,8,2176,2054,1136,-918
2020,8,29,9,2081,1974,1144,-830
2020,8,29,10,2008,1926,1142,-784
2020,8,29,11,1982,1900,1184,-716
2020,8,29,12,1983,1903,1184,-719
2020,8,29,13,2034,1926,1167,-759
2020,8,29,14,2077,1999,1155,-844
2020,8,29,15,2186,2088,1241,-847
2020,8,29,16,2329,2190,1279,-911
2020,8,29,17,2454,2303,1341,-962
2020,8,29,18,2545,2393,1366,-1027
2020,8,29,19,2629,2496,1445,-1051
2020,8,29,20,2765,2610,1469,-1141
2020,8,29,21,2811,2738,1508,-1230
2020,8,29,22,2980,2824,1616,-1208
2020,8,29,23,3030,2914,1730,-1184
2020,8,30,0,3083,2990,1793,-1197
2020,8,30,1,3068,2971,1763,-1208
2020,8,30,2,3056,2864,1602,-1262
2020,8,30,3,2893,2740,1534,-1206
2020,8,30,4,2746,2612,1443,-1169
2020,8,30,5,2555,2447,1301,-1146
2020,8,30,6,2385,2265,1330,-935
2020,8,30,7,2236,2124,1261,-863
2020,8,30,8,2110,2002,1322,-680
2020,8,30,9,1998,1935,1423,-512
2020,8,30,10,1908,1881,1462,-419
2020,8,30,11,1841,1844,1506,-338
2020,8,30,12,1831,1834,1555,-279
2020,8,30,13,1942,1842,1593,-249
2020,8,30,14,1984,1849,1613,-236
2020,8,30,15,2138,1927,1723,-204
2020,8,30,16,2135,2001,1803,-198
2020,8,30,17,2194,2054,1799,-255
2020,8,30,18,2265,2099,1786,-313
2020,8,30,19,2336,2151,1786,-365
2020,8,30,20,2408,2165,1775,-390
2020,8,30,21,2471,2211,1837,-374
2020,8,30,22,2507,2261,1843,-418
2020,8,30,23,2459,2345,1892,-453
2020,8,31,0,2587,2397,1889,-508
2020,8,31,1,2540,2412,1849,-563
2020,8,31,2,2443,2371,1751,-620
2020,8,31,3,2354,2303,1631,-672
2020,8,31,4,2295,2243,1621,-622
2020,8,31,5,2183,2085,1558,-527
2020,8,31,6,2006,1933,1521,-412
2020,8,31,7,1901,1826,1415,-411
2020,8,31,8,1783,1768,1369,-399
2020,8,31,9,1759,1727,1348,-379
2020,8,31,10,1775,1719,1305,-414
2020,8,31,11,1806,1730,1204,-526
2020,8,31,12,1857,1784,1230,-554
2020,8,31,13,1947,1912,1242,-670
2020,8,31,14,2043,2038,1175,-863
2020,8,31,15,2219,2120,1259,-861
2020,8,31,16,2336,2183,1373,-810
2020,8,31,17,2319,2224,1371,-853
2020,8,31,18,2377,2260,1563,-697
2020,8,31,19,2393,2280,1653,-627
2020,8,31,20,2417,2295,1699,-596
2020,8,31,21,2379,2292,1738,-554
2020,8,31,22,2450,2307,1775,-532
2020,8,31,23,2401,2327,1765,-562
2020,9,1,0,2451,2353,1804,-549
2020,9,1,1,2430,2382,1828,-554
2020,9,1,2,2383,2368,1801,-567
2020,9,1,3,2402,2360,1765,-595
2020,9,1,4,2390,2293,1783,-510
2020,9,1,5,2252,2169,1664,-505
2020,9,1,6,2104,2012,1358,-654
2020,9,1,7,1986,1966,1262,-704
2020,9,1,8,1887,1846,1043,-803
2020,9,1,9,1840,1813,992,-821
2020,9,1,10,1802,1794,965,-829
2020,9,1,11,1838,1793,955,-838
2020,9,1,12,1897,1846,947,-899
2020,9,1,13,1982,1965,1109,-856
2020,9,1,14,2063,2054,1158,-896
2020,9,1,15,2156,2142,1372,-770
2020,9,1,16,2268,2192,1457,-735
2020,9,1,17,2323,2226,1384,-842
2020,9,1,18,2360,2274,1368,-906
2020,9,1,19,2454,2302,1396,-906
2020,9,1,20,2489,2356,1453,-903
2020,9,1,21,2466,2417,1562,-855
2020,9,1,22,2560,2489,1670,-819
2020,9,1,23,2618,2551,1682,-869
2020,9,2,0,2731,2632,1764,-868
2020,9,2,1,2763,2671,1845,-826
2020,9,2,2,2696,2663,1713,-950
2020,9,2,3,2641,2593,1550,-1043
2020,9,2,4,2589,2506,1505,-1001
2020,9,2,5,2417,2335,1333,-1002
2020,9,2,6,2233,2158,1157,-1001
2020,9,2,7,2149,2026,1112,-914
2020,9,2,8,2034,1951,1078,-873
2020,9,2,9,2001,1893,991,-902
2020,9,2,10,1979,1866,985,-881
2020,9,2,11,1976,1858,972,-886
2020,9,2,12,2018,1902,1074,-828
2020,9,2,13,2105,2010,1128,-882
2020,9,2,14,2172,2107,1207,-900
2020,9,2,15,2263,2199,1364,-835
2020,9,2,16,2426,2272,1417,-855
2020,9,2,17,2544,2351,1437,-914
2020,9,2,18,2583,2425,1475,-950
2020,9,2,19,2661,2536,1578,-958
2020,9,2,20,2776,2666,1625,-1041
2020,9,2,21,2849,2790,1769,-1021
2020,9,2,22,2971,2920,1958,-962
2020,9,2,23,3056,3035,2048,-987
2020,9,3,0,3154,3098,2134,-964
2020,9,3,1,3212,3128,2271,-857
2020,9,3,2,3140,3062,2093,-969
2020,9,3,3,3034,2926,1943,-983
2020,9,3,4,2890,2769,1845,-924
2020,9,3,5,2624,2533,1621,-912
2020,9,3,6,2422,2327,1526,-801
2020,9,3,7,2326,2161,1431,-730
2020,9,3,8,2169,2047,1226,-821
2020,9,3,9,2055,1973,1218,-755
2020,9,3,10,2008,1931,1196,-735
2020,9,3,11,2002,1912,1222,-690
2020,9,3,12,2034,1948,1246,-702
2020,9,3,13,2105,2046,1233,-813
2020,9,3,14,2199,2149,1254,-895
2020,9,3,15,2285,2236,1347,-889
2020,9,3,16,2453,2330,1429,-901
2020,9,3,17,2566,2409,1540,-869
2020,9,3,18,2592,2520,1564,-956
2020,9,3,19,2674,2628,1632,-996
2020,9,3,20,2798,2751,1721,-1030
2020,9,3,21,2892,2896,1896,-1000
2020,9,3,22,3006,3008,2031,-977
2020,9,3,23,3112,3119,2110,-1009
2020,9,4,0,3211,3173,2152,-1021
2020,9,4,1,3261,3184,2089,-1095
2020,9,4,2,3197,3106,1928,-1178
2020,9,4,3,3030,2972,1887,-1085
2020,9,4,4,2900,2799,1813,-986
2020,9,4,5,2668,2565,1626,-939
2020,9,4,6,2448,2346,1496,-850
2020,9,4,7,2343,2184,1369,-815
2020,9,4,8,2192,2071,1208,-863
2020,9,4,9,2128,1989,1174,-815
2020,9,4,10,2072,1939,1164,-775
2020,9,4,11,2045,1921,1138,-783
2020,9,4,12,2070,1958,1163,-795
2020,9,4,13,2147,2040,1218,-822
2020,9,4,14,2266,2140,1237,-903
2020,9,4,15,2372,2240,1387,-853
2020,9,4,16,2492,2348,1383,-965
2020,9,4,17,2597,2451,1429,-1022
2020,9,4,18,2670,2569,1525,-1044
2020,9,4,19,2805,2699,1538,-1161
2020,9,4,20,2952,2853,1569,-1284
2020,9,4,21,3061,3022,1754,-1268
2020,9,4,22,3189,3163,1845,-1318
2020,9,4,23,3303,3245,1884,-1361
2020,9,5,0,3320,3297,1917,-1380
2020,9,5,1,3334,3293,2014,-1279
2020,9,5,2,3341,3159,1839,-1320
2020,9,5,3,3123,3042,1833,-1209
2020,9,5,4,2975,2833,1750,-1083
2020,9,5,5,2792,2612,1538,-1074
2020,9,5,6,2585,2420,1498,-922
2020,9,5,7,2374,2242,1371,-871
2020,9,5,8,2263,2115,1228,-887
2020,9,5,9,2215,2038,1177,-861
2020,9,5,10,2172,1980,1186,-794
2020,9,5,11,2120,1933,1195,-738
2020,9,5,12,2081,1924,1265,-659
2020,9,5,13,2068,1934,1269,-665
2020,9,5,14,2082,1969,1253,-716
2020,9,5,15,2203,2066,1322,-744
2020,9,5,16,2357,2190,1314,-876
2020,9,5,17,2447,2285,1414,-871
2020,9,5,18,2534,2418,1356,-1062
2020,9,5,19,2659,2570,1408,-1162
2020,9,5,20,2807,2727,1476,-1251
2020,9,5,21,2983,2887,1683,-1204
2020,9,5,22,3123,3021,1766,-1255
2020,9,5,23,3229,3114,1956,-1158
2020,9,6,0,3324,3159,2207,-952
2020,9,6,1,3336,3139,2261,-878
2020,9,6,2,3136,3012,2191,-821
2020,9,6,3,2969,2873,2205,-668
2020,9,6,4,2907,2708,2158,-550
2020,9,6,5,2687,2490,2006,-484
2020,9,6,6,2432,2307,1890,-417
2020,9,6,7,2337,2130,1574,-556
2020,9,6,8,2191,2025,1425,-600
2020,9,6,9,2000,1951,1214,-737
2020,9,6,10,1952,1884,1195,-689
2020,9,6,11,1898,1843,1269,-574
2020,9,6,12,1864,1822,1238,-584
2020,9,6,13,1877,1833,1274,-559
2020,9,6,14,1853,1835,1240,-595
2020,9,6,15,1992,1921,1256,-665
2020,9,6,16,2212,2005,1272,-733
2020,9,6,17,2265,2108,1408,-700
2020,9,6,18,2289,2230,1495,-735
2020,9,6,19,2394,2345,1713,-632
2020,9,6,20,2519,2476,1798,-678
2020,9,6,21,2571,2584,1920,-664
2020,9,6,22,2762,2661,2065,-596
2020,9,6,23,2865,2741,2121,-620
2020,9,7,0,2911,2777,2207,-570
2020,9,7,1,2927,2740,1989,-751
2020,9,7,2,2800,2606,1914,-692
2020,9,7,3,2654,2493,1783,-710
2020,9,7,4,2550,2350,1713,-637
2020,9,7,5,2348,2179,1614,-565
2020,9,7,6,2100,2017,1482,-535
2020,9,7,7,2194,1894,1333,-561
2020,9,7,8,2019,1803,1287,-516
2020,9,7,9,1859,1747,1243,-504
2020,9,7,10,1817,1709,1206,-503
2020,9,7,11,1792,1697,1258,-439
2020,9,7,12,1773,1712,1240,-472
2020,9,7,13,1839,1733,1303,-430
2020,9,7,14,1908,1799,1353,-446
2020,9,7,15,2019,1901,1453,-448
2020,9,7,16,2135,2009,1649,-360
2020,9,7,17,2167,2136,1893,-243
2020,9,7,18,2226,2230,1966,-264
2020,9,7,19,2345,2315,1958,-357
2020,9,7,20,2462,2407,1925,-482
2020,9,7,21,2496,2479,1898,-581
2020,9,7,22,2542,2518,1882,-636
2020,9,7,23,2591,2523,1810,-713
2020,9,8,0,2570,2445,1708,-737
2020,9,8,1,2495,2353,1659,-694
2020,9,8,2,2258,2197,1660,-537
2020,9,8,3,2184,2075,1671,-404
2020,9,8,4,2160,1952,1603,-349
2020,9,8,5,1927,1802,1582,-220
2020,9,8,6,1773,1660,1328,-332
2020,9,8,7,1887,1570,1175,-395
2020,9,8,8,1787,1518,1130,-388
2020,9,8,9,1571,1500,1117,-383
2020,9,8,10,1550,1480,1082,-398
2020,9,8,11,1534,1498,1084,-414
2020,9,8,12,1575,1561,1144,-417
2020,9,8,13,1671,1710,1179,-531
2020,9,8,14,1826,1837,1246,-591
2020,9,8,15,1900,1921,1341,-580
2020,9,8,16,1970,1960,1438,-522
2020,9,8,17,2004,1981,1441,-540
2020,9,8,18,2019,1992,1436,-556
2020,9,8,19,2060,2000,1414,-586
2020,9,8,20,2095,2001,1396,-605
2020,9,8,21,2105,2042,1381,-661
2020,9,8,22,2120,2067,1437,-630
2020,9,8,23,2184,2094,1465,-629
2020,9,9,0,2189,2146,1503,-643
2020,9,9,1,2175,2155,1433,-722
2020,9,9,2,2184,2152,1291,-861
2020,9,9,3,2112,2155,1255,-900
2020,9,9,4,2088,2077,1240,-837
2020,9,9,5,2071,1942,1227,-715
2020,9,9,6,1903,1811,1154,-657
2020,9,9,7,1835,1739,1115,-624
2020,9,9,8,1580,1687,1063,-624
2020,9,9,9,1663,1658,1028,-630
2020,9,9,10,1709,1642,1060,-582
2020,9,9,11,1721,1664,1053,-611
2020,9,9,12,1762,1717,1097,-620
2020,9,9,13,1864,1862,1091,-771
2020,9,9,14,1972,1981,1142,-839
2020,9,9,15,2049,2049,1317,-732
2020,9,9,16,2087,2095,1385,-710
2020,9,9,17,2177,2122,1370,-752
2020,9,9,18,2189,2124,1342,-782
2020,9,9,19,2224,2133,1460,-673
2020,9,9,20,2268,2137,1558,-579
2020,9,9,21,2267,2155,1521,-634
2020,9,9,22,2296,2196,1471,-725
2020,9,9,23,2330,2239,1234,-1005
2020,9,10,0,2338,2277,1344,-933
2020,9,10,1,2360,2299,1345,-954
2020,9,10,2,2336,2284,1289,-995
2020,9,10,3,2236,2266,1291,-975
2020,9,10,4,2195,2190,1250,-940
2020,9,10,5,2079,2039,1203,-836
2020,9,10,6,1951,1897,1203,-694
2020,9,10,7,1713,1791,1104,-687
2020,9,10,8,1750,1751,1028,-723
2020,9,10,9,1816,1712,1080,-632
2020,9,10,10,1807,1703,1075,-628
2020,9,10,11,1808,1715,1023,-692
2020,9,10,12,1856,1773,1013,-760
2020,9,10,13,1949,1906,1075,-831
2020,9,10,14,2054,2020,1123,-897
2020,9,10,15,2138,2094,1293,-801
2020,9,10,16,2184,2137,1391,-746
2020,9,10,17,2235,2171,1386,-785
2020,9,10,18,2233,2197,1365,-832
2020,9,10,19,2259,2215,1319,-896
2020,9,10,20,2336,2249,1304,-945
2020,9,10,21,2382,2295,1351,-944
2020,9,10,22,2396,2353,1342,-1011
2020,9,10,23,2459,2409,1549,-860
2020,9,11,0,2493,2479,1609,-870
2020,9,11,1,2533,2488,1616,-872
2020,9,11,2,2502,2457,1471,-986
2020,9,11,3,2438,2408,1443,-965
2020,9,11,4,2355,2295,1388,-907
2020,9,11,5,2243,2126,1302,-824
2020,9,11,6,2081,1973,1214,-759
2020,9,11,7,1906,1861,1096,-765
2020,9,11,8,1896,1799,1075,-724
2020,9,11,9,1883,1753,1019,-734
2020,9,11,10,1842,1732,1025,-707
2020,9,11,11,1835,1739,956,-783
2020,9,11,12,1866,1789,1018,-771
2020,9,11,13,2025,1904,1033,-871
2020,9,11,14,2082,2010,1064,-946
2020,9,11,15,2155,2079,1197,-882
2020,9,11,16,2253,2132,1279,-853
2020,9,11,17,2290,2173,1273,-900
2020,9,11,18,2312,2206,1219,-987
2020,9,11,19,2373,2230,1242,-988
2020,9,11,20,2399,2279,1281,-998
2020,9,11,21,2457,2359,1415,-944
2020,9,11,22,2521,2432,1705,-727
2020,9,11,23,2620,2506,1922,-584
2020,9,12,0,2616,2564,2034,-530
2020,9,12,1,2626,2545,1937,-608
2020,9,12,2,2570,2472,1776,-696
2020,9,12,3,2452,2382,1690,-692
2020,9,12,4,2385,2280,1588,-692
2020,9,12,5,2260,2128,1485,-643
2020,9,12,6,2108,1998,1439,-559
2020,9,12,7,2014,1879,1304,-575
2020,9,12,8,1941,1802,1114,-688
2020,9,12,9,1869,1747,1045,-702
2020,9,12,10,1820,1715,1034,-681
2020,9,12,11,1815,1699,1011,-688
2020,9,12,12,1795,1719,983,-736
2020,9,12,13,1844,1753,983,-770
2020,9,12,14,1913,1805,1111,-694
2020,9,12,15,2010,1896,1253,-643
2020,9,12,16,2088,1972,1277,-695
2020,9,12,17,2129,2017,1330,-687
2020,9,12,18,2152,2042,1343,-699
2020,9,12,19,2206,2069,1332,-737
2020,9,12,20,2251,2097,1340,-757
2020,9,12,21,2307,2145,1338,-807
2020,9,12,22,2378,2180,1329,-851
2020,9,12,23,2470,2215,1429,-786
2020,9,13,0,2510,2261,1578,-683
2020,9,13,1,2462,2250,1611,-639
2020,9,13,2,2334,2211,1543,-668
2020,9,13,3,2292,2189,1539,-650
2020,9,13,4,2287,2100,1443,-657
2020,9,13,5,2164,1993,1330,-663
2020,9,13,6,2024,1868,1197,-671
2020,9,13,7,1924,1782,1168,-614
2020,9,13,8,1844,1709,1117,-592
2020,9,13,9,1793,1666,1116,-550
2020,9,13,10,1769,1642,1110,-532
2020,9,13,11,1770,1622,1111,-511
2020,9,13,12,1756,1625,1126,-499
2020,9,13,13,1789,1666,1175,-491
2020,9,13,14,1799,1696,1211,-485
2020,9,13,15,1855,1782,1319,-463
2020,9,13,16,1997,1847,1378,-469
2020,9,13,17,2056,1895,1420,-475
2020,9,13,18,2054,1921,1421,-500
2020,9,13,19,2149,1954,1511,-443
2020,9,13,20,2223,1987,1634,-353
2020,9,13,21,2292,2050,1620,-430
2020,9,13,22,2422,2147,1626,-521
2020,9,13,23,2523,2255,1775,-480
2020,9,14,0,2537,2354,1811,-543
2020,9,14,1,2553,2376,1748,-628
2020,9,14,2,2473,2301,1685,-616
2020,9,14,3,2404,2264,1753,-511
2020,9,14,4,2356,2142,1685,-457
2020,9,14,5,2260,1981,1599,-382
2020,9,14,6,2098,1828,1487,-341
2020,9,14,7,1982,1720,1394,-326
2020,9,14,8,1901,1645,1275,-370
2020,9,14,9,1808,1612,1243,-369
2020,9,14,10,1766,1595,1272,-323
2020,9,14,11,1741,1602,1263,-339
2020,9,14,12,1728,1670,1255,-415
2020,9,14,13,1856,1797,1262,-535
2020,9,14,14,2002,1930,1300,-630
2020,9,14,15,2175,2006,1333,-673
2020,9,14,16,2264,2052,1459,-593
2020,9,14,17,2316,2096,1544,-552
2020,9,14,18,2372,2132,1560,-572
2020,9,14,19,2447,2200,1477,-723
2020,9,14,20,2495,2268,1415,-853
2020,9,14,21,2565,2334,1439,-895
2020,9,14,22,2633,2405,1526,-879
2020,9,14,23,2704,2477,1534,-943
2020,9,15,0,2749,2523,1511,-1012
2020,9,15,1,2752,2502,1545,-957
2020,9,15,2,2647,2455,1534,-921
2020,9,15,3,2542,2400,1421,-979
2020,9,15,4,2490,2265,1315,-950
2020,9,15,5,2359,2095,1225,-870
2020,9,15,6,2174,1930,1171,-759
2020,9,15,7,2113,1814,1168,-646
2020,9,15,8,2000,1734,1177,-557
2020,9,15,9,1865,1689,1186,-503
2020,9,15,10,1833,1669,1182,-487
2020,9,15,11,1822,1662,1192,-470
2020,9,15,12,1821,1718,1142,-576
2020,9,15,13,1943,1833,1176,-657
2020,9,15,14,2069,1954,1224,-730
2020,9,15,15,2080,2022,1247,-775
2020,9,15,16,2149,2049,1291,-758
2020,9,15,17,2278,2094,1296,-798
2020,9,15,18,2261,2121,1277,-844
2020,9,15,19,2284,2163,1323,-840
2020,9,15,20,2297,2213,1333,-880
2020,9,15,21,2375,2278,1465,-813
2020,9,15,22,2427,2339,1511,-828
2020,9,15,23,2460,2401,1667,-734
2020,9,16,0,2522,2416,1613,-803
2020,9,16,1,2538,2411,1656,-755
2020,9,16,2,2561,2366,1660,-706
2020,9,16,3,2528,2341,1657,-684
2020,9,16,4,2358,2198,1507,-691
2020,9,16,5,2173,2038,1339,-699
2020,9,16,6,2013,1875,1243,-632
2020,9,16,7,1920,1761,1132,-629
2020,9,16,8,1821,1704,1119,-585
2020,9,16,9,1771,1665,1104,-561
2020,9,16,10,1711,1647,1111,-536
2020,9,16,11,1716,1644,1068,-576
2020,9,16,12,1792,1725,1131,-594
2020,9,16,13,1912,1829,1152,-677
2020,9,16,14,1999,1946,1230,-716
2020,9,16,15,2057,2012,1301,-711
2020,9,16,16,2112,2043,1440,-603
2020,9,16,17,2142,2072,1447,-625
2020,9,16,18,2175,2116,1439,-677
2020,9,16,19,2227,2145,1447,-698
2020,9,16,20,2291,2177,1567,-610
2020,9,16,21,2360,2229,1660,-569
2020,9,16,22,2434,2284,1692,-592
2020,9,16,23,2482,2360,1670,-690
2020,9,17,0,2569,2399,1666,-733
2020,9,17,1,2565,2410,1629,-781
2020,9,17,2,2520,2357,1516,-841
2020,9,17,3,2484,2324,1529,-795
2020,9,17,4,2351,2199,1461,-738
2020,9,17,5,2149,2030,1305,-725
2020,9,17,6,1960,1871,1179,-692
2020,9,17,7,1886,1765,1121,-644
2020,9,17,8,1800,1694,981,-713
2020,9,17,9,1749,1664,1037,-627
2020,9,17,10,1716,1628,1011,-617
2020,9,17,11,1702,1635,1002,-633
2020,9,17,12,1777,1691,1066,-625
2020,9,17,13,1910,1812,1129,-683
2020,9,17,14,2025,1923,1239,-684
2020,9,17,15,2046,1995,1349,-646
2020,9,17,16,2091,2032,1540,-492
2020,9,17,17,2103,2059,1538,-521
2020,9,17,18,2144,2101,1671,-430
2020,9,17,19,2203,2145,1629,-516
2020,9,17,20,2272,2220,1596,-624
2020,9,17,21,2330,2301,1678,-623
2020,9,17,22,2424,2372,1763,-609
2020,9,17,23,2503,2427,1771,-656
2020,9,18,0,2539,2465,1731,-734
2020,9,18,1,2566,2456,1667,-789
2020,9,18,2,2514,2405,1668,-737
2020,9,18,3,2497,2323,1659,-664
2020,9,18,4,2336,2201,1520,-681
2020,9,18,5,2133,2029,1362,-667
2020,9,18,6,1926,1866,1187,-679
2020,9,18,7,1923,1750,1027,-723
2020,9,18,8,1825,1683,979,-704
2020,9,18,9,1693,1639,986,-653
2020,9,18,10,1665,1616,968,-648
2020,9,18,11,1682,1626,1022,-604
2020,9,18,12,1745,1680,1034,-646
2020,9,18,13,1827,1785,1214,-571
2020,9,18,14,1929,1918,1205,-713
2020,9,18,15,1996,1986,1159,-827
2020,9,18,16,2050,2025,1264,-761
2020,9,18,17,2096,2056,1166,-890
2020,9,18,18,2098,2068,1230,-838
2020,9,18,19,2126,2060,1274,-786
2020,9,18,20,2131,2067,1368,-699
2020,9,18,21,2151,2101,1448,-653
2020,9,18,22,2181,2091,1513,-578
2020,9,18,23,2210,2058,1541,-517
2020,9,19,0,2195,2067,1533,-534
2020,9,19,1,2129,2044,1623,-421
2020,9,19,2,2105,2033,1722,-311
2020,9,19,3,2115,2081,1431,-650
2020,9,19,4,2035,1951,1348,-603
2020,9,19,5,1905,1867,1256,-611
2020,9,19,6,1792,1755,1132,-623
2020,9,19,7,1780,1687,1129,-558
2020,9,19,8,1668,1607,1215,-392
2020,9,19,9,1614,1575,1232,-343
2020,9,19,10,1600,1539,1187,-352
2020,9,19,11,1596,1534,1172,-362
2020,9,19,12,1619,1544,1181,-363
2020,9,19,13,1679,1584,1230,-354
2020,9,19,14,1729,1629,1174,-455
2020,9,19,15,1822,1700,1215,-485
2020,9,19,16,1857,1764,1300,-464
2020,9,19,17,1835,1810,1391,-419
2020,9,19,18,1840,1809,1535,-274
2020,9,19,19,1793,1842,1705,-137
2020,9,19,20,1787,1846,1761,-85
2020,9,19,21,1794,1883,1790,-93
2020,9,19,22,1805,1919,1804,-115
2020,9,19,23,1862,1939,1837,-102
2020,9,20,0,1922,1972,1946,-26
2020,9,20,1,1929,1952,1786,-166
2020,9,20,2,1933,1949,1557,-392
2020,9,20,3,1950,1936,1550,-386
2020,9,20,4,1864,1844,1484,-360
2020,9,20,5,1774,1727,1156,-571
2020,9,20,6,1647,1613,1115,-498
2020,9,20,7,1622,1534,1064,-470
2020,9,20,8,1573,1485,1009,-476
2020,9,20,9,1519,1444,931,-513
2020,9,20,10,1500,1434,928,-506
2020,9,20,11,1498,1426,960,-466
2020,9,20,12,1541,1444,986,-458
2020,9,20,13,1593,1479,1003,-476
2020,9,20,14,1639,1525,1038,-487
2020,9,20,15,1739,1592,1176,-416
2020,9,20,16,1773,1662,1284,-378
2020,9,20,17,1749,1699,1270,-429
2020,9,20,18,1761,1718,1327,-391
2020,9,20,19,1749,1749,1352,-397
2020,9,20,20,1761,1789,1351,-438
2020,9,20,21,1797,1825,1360,-465
2020,9,20,22,1814,1888,1382,-506
2020,9,20,23,1880,1966,1527,-439
2020,9,21,0,1942,2023,1488,-535
2020,9,21,1,1964,2031,1457,-574
2020,9,21,2,1942,2004,1255,-749
2020,9,21,3,1968,1975,1226,-749
2020,9,21,4,1873,1873,1262,-611
2020,9,21,5,1752,1738,1232,-506
2020,9,21,6,1655,1599,1085,-514
2020,9,21,7,1544,1502,968,-534
2020,9,21,8,1483,1450,957,-493
2020,9,21,9,1514,1418,937,-481
2020,9,21,10,1488,1409,1003,-406
2020,9,21,11,1499,1428,1036,-392
2020,9,21,12,1566,1498,1042,-456
2020,9,21,13,1699,1646,1134,-512
2020,9,21,14,1824,1760,1173,-587
2020,9,21,15,1938,1825,1296,-529
2020,9,21,16,1995,1870,1419,-451
2020,9,21,17,1958,1892,1441,-451
2020,9,21,18,1976,1926,1501,-425
2020,9,21,19,1993,1958,1671,-287
2020,9,21,20,2069,2034,1690,-344
2020,9,21,21,2169,2113,1751,-362
2020,9,21,22,2230,2182,1714,-468
2020,9,21,23,2264,2253,1683,-570
2020,9,22,0,2317,2305,1674,-631
2020,9,22,1,2372,2304,1625,-679
2020,9,22,2,2298,2244,1664,-580
2020,9,22,3,2251,2188,1728,-460
2020,9,22,4,2103,2036,1657,-379
2020,9,22,5,1885,1881,1408,-473
2020,9,22,6,1770,1718,1182,-536
2020,9,22,7,1733,1617,1162,-455
2020,9,22,8,1672,1557,1106,-451
2020,9,22,9,1552,1517,1097,-420
2020,9,22,10,1531,1488,1105,-383
2020,9,22,11,1535,1485,1127,-358
2020,9,22,12,1580,1564,1157,-407
2020,9,22,13,1697,1674,1148,-526
2020,9,22,14,1810,1806,1389,-417
2020,9,22,15,1849,1857,1393,-464
2020,9,22,16,1911,1889,1442,-447
2020,9,22,17,1982,1908,1422,-486
2020,9,22,18,2020,1951,1485,-466
2020,9,22,19,2022,1961,1499,-462
2020,9,22,20,2054,2012,1504,-508
2020,9,22,21,2073,2040,1521,-519
2020,9,22,22,2099,2106,1637,-469
2020,9,22,23,2153,2137,1620,-517
2020,9,23,0,2238,2189,1720,-469
2020,9,23,1,2219,2173,1639,-534
2020,9,23,2,2196,2155,1587,-568
2020,9,23,3,2166,2118,1467,-651
2020,9,23,4,2074,1999,1391,-608
2020,9,23,5,1946,1851,1297,-554
2020,9,23,6,1800,1716,1162,-554
2020,9,23,7,1721,1608,1085,-523
2020,9,23,8,1595,1550,962,-588
2020,9,23,9,1578,1499,925,-574
2020,9,23,10,1585,1490,1020,-470
2020,9,23,11,1579,1493,1064,-429
2020,9,23,12,1626,1569,1066,-503
2020,9,23,13,1758,1694,1099,-595
2020,9,23,14,1881,1832,1105,-727
2020,9,23,15,1903,1877,1119,-758
2020,9,23,16,1930,1915,1206,-709
2020,9,23,17,2005,1947,1385,-562
2020,9,23,18,2030,1974,1434,-540
2020,9,23,19,2040,2013,1419,-594
2020,9,23,20,2098,2077,1424,-653
2020,9,23,21,2142,2140,1606,-534
2020,9,23,22,2199,2176,1556,-620
2020,9,23,23,2269,2204,1642,-562
2020,9,24,0,2320,2223,1683,-540
2020,9,24,1,2310,2197,1724,-473
2020,9,24,2,2284,2185,1717,-468
2020,9,24,3,2253,2156,1734,-422
2020,9,24,4,2118,2060,1699,-361
2020,9,24,5,1940,1898,1582,-316
2020,9,24,6,1830,1752,1492,-260
2020,9,24,7,1713,1637,1340,-297
2020,9,24,8,1634,1584,1355,-229
2020,9,24,9,1600,1535,1311,-224
2020,9,24,10,1601,1508,1278,-230
2020,9,24,11,1580,1513,1290,-223
2020,9,24,12,1642,1576,1427,-149
2020,9,24,13,1771,1710,1569,-141
2020,9,24,14,1883,1843,1604,-239
2020,9,24,15,1917,1888,1620,-268
2020,9,24,16,1992,1940,1758,-182
2020,9,24,17,2010,1956,1661,-295
2020,9,24,18,2017,1979,1690,-289
2020,9,24,19,1994,2001,1716,-285
2020,9,24,20,2001,2034,1907,-127
2020,9,24,21,2043,2037,1914,-123
2020,9,24,22,2046,2047,1818,-229
2020,9,24,23,2059,2058,1858,-200
2020,9,25,0,2103,2053,1895,-158
2020,9,25,1,2049,2029,1870,-159
2020,9,25,2,2050,2036,1850,-186
2020,9,25,3,2061,2029,1848,-181
2020,9,25,4,1988,1943,1830,-113
2020,9,25,5,1859,1820,1813,-7
2020,9,25,6,1738,1681,1574,-107
2020,9,25,7,1606,1592,1482,-110
2020,9,25,8,1557,1533,1409,-124
2020,9,25,9,1572,1497,1364,-133
2020,9,25,10,1572,1490,1266,-224
2020,9,25,11,1603,1492,1240,-252
2020,9,25,12,1668,1563,1253,-310
2020,9,25,13,1798,1683,1339,-344
2020,9,25,14,1898,1809,1407,-402
2020,9,25,15,1952,1882,1453,-429
2020,9,25,16,1978,1907,1492,-415
2020,9,25,17,1975,1932,1513,-419
2020,9,25,18,1963,1943,1550,-393
2020,9,25,19,1962,1956,1598,-358
2020,9,25,20,2003,1984,1572,-412
2020,9,25,21,2051,1999,1552,-447
2020,9,25,22,2081,1990,1459,-531
2020,9,25,23,2108,1969,1463,-506
2020,9,26,0,2073,1968,1445,-523
2020,9,26,1,2019,1946,1475,-471
2020,9,26,2,2019,1959,1390,-569
2020,9,26,3,2014,1951,1392,-559
2020,9,26,4,1920,1874,1350,-524
2020,9,26,5,1831,1787,1381,-406
2020,9,26,6,1751,1685,1459,-226
2020,9,26,7,1595,1587,1409,-178
2020,9,26,8,1568,1540,1462,-78
2020,9,26,9,1560,1501,1440,-61
2020,9,26,10,1547,1477,1294,-183
2020,9,26,11,1588,1470,1312,-158
2020,9,26,12,1551,1492,1387,-105
2020,9,26,13,1636,1548,1514,-34
2020,9,26,14,1713,1609,1523,-86
2020,9,26,15,1790,1679,1610,-69
2020,9,26,16,1830,1735,1564,-171
2020,9,26,17,1832,1767,1694,-73
2020,9,26,18,1818,1779,1728,-51
2020,9,26,19,1798,1763,1731,-32
2020,9,26,20,1791,1766,1739,-27
2020,9,26,21,1804,1776,1782,6
2020,9,26,22,1801,1772,1717,-55
2020,9,26,23,1828,1799,1687,-112
2020,9,27,0,1880,1825,1651,-174
2020,9,27,1,1881,1815,1717,-98
2020,9,27,2,1869,1822,1695,-127
2020,9,27,3,1893,1812,1722,-90
2020,9,27,4,1838,1752,1586,-166
2020,9,27,5,1738,1662,1514,-148
2020,9,27,6,1662,1571,1428,-143
2020,9,27,7,1534,1483,1306,-177
2020,9,27,8,1520,1440,1194,-246
2020,9,27,9,1524,1408,1196,-212
2020,9,27,10,1472,1394,1251,-143
2020,9,27,11,1502,1401,1392,-9
2020,9,27,12,1538,1414,1525,111
2020,9,27,13,1590,1465,1637,172
2020,9,27,14,1665,1511,1526,15
2020,9,27,15,1738,1574,1504,-70
2020,9,27,16,1817,1629,1558,-71
2020,9,27,17,1765,1654,1624,-30
2020,9,27,18,1724,1663,1647,-16
2020,9,27,19,1719,1661,1668,7
2020,9,27,20,1715,1657,1592,-65
2020,9,27,21,1725,1673,1643,-30
2020,9,27,22,1737,1683,1662,-21
2020,9,27,23,1752,1721,1683,-38
2020,9,28,0,1799,1752,1685,-67
2020,9,28,1,1804,1771,1615,-156
2020,9,28,2,1803,1779,1585,-194
2020,9,28,3,1838,1793,1587,-206
2020,9,28,4,1819,1712,1624,-88
2020,9,28,5,1732,1597,1537,-60
2020,9,28,6,1601,1494,1321,-173
2020,9,28,7,1508,1415,1182,-233
2020,9,28,8,1453,1370,1125,-245
2020,9,28,9,1423,1351,1097,-254
2020,9,28,10,1445,1352,1090,-262
2020,9,28,11,1453,1373,1084,-289
2020,9,28,12,1535,1450,1149,-301
2020,9,28,13,1672,1615,1134,-481
2020,9,28,14,1813,1759,1217,-542
2020,9,28,15,1960,1812,1290,-522
2020,9,28,16,1982,1838,1376,-462
2020,9,28,17,1925,1831,1328,-503
2020,9,28,18,1910,1844,1354,-490
2020,9,28,19,1901,1838,1406,-432
2020,9,28,20,1924,1856,1416,-440
2020,9,28,21,1934,1868,1443,-425
2020,9,28,22,1949,1882,1384,-498
2020,9,28,23,1955,1916,1393,-523
2020,9,29,0,1981,1944,1327,-617
2020,9,29,1,2003,1951,1366,-585
2020,9,29,2,2021,1951,1359,-592
2020,9,29,3,2006,1959,1367,-592
2020,9,29,4,1913,1850,1365,-485
2020,9,29,5,1786,1706,1342,-364
2020,9,29,6,1679,1573,1160,-413
2020,9,29,7,1606,1494,1005,-489
2020,9,29,8,1544,1437,936,-501
2020,9,29,9,1484,1419,944,-475
2020,9,29,10,1480,1403,856,-547
2020,9,29,11,1504,1423,869,-554
2020,9,29,12,1568,1501,1078,-423
2020,9,29,13,1703,1656,1145,-511
2020,9,29,14,1835,1784,1256,-528
2020,9,29,15,1858,1830,1373,-457
2020,9,29,16,1909,1841,1486,-355
2020,9,29,17,1949,1788,1418,-370
2020,9,29,18,1943,1796,1379,-417
2020,9,29,19,1960,1860,1378,-482
2020,9,29,20,1992,1891,1368,-523
2020,9,29,21,2015,1923,1349,-574
2020,9,29,22,2040,1965,1385,-580
2020,9,29,23,2080,2008,1399,-609
2020,9,30,0,2108,2054,1473,-581
2020,9,30,1,2110,2069,1439,-630
2020,9,30,2,2114,2023,1383,-640
2020,9,30,3,2095,1980,1402,-578
2020,9,30,4,1925,1910,1446,-464
2020,9,30,5,1743,1752,1213,-539
2020,9,30,6,1633,1594,1179,-415
2020,9,30,7,1611,1505,1051,-454
2020,9,30,8,1536,1457,945,-512
2020,9,30,9,1482,1424,953,-471
2020,9,30,10,1475,1422,952,-470
2020,9,30,11,1491,1437,952,-485
2020,9,30,12,1586,1518,989,-529
2020,9,30,13,1706,1654,1063,-591
2020,9,30,14,1854,1782,1135,-647
2020,9,30,15,1880,1840,1232,-608
2020,9,30,16,1895,1861,1327,-534
2020,9,30,17,1949,1858,1339,-519
2020,9,30,18,1960,1883,1355,-528
2020,9,30,19,1975,1898,1325,-573
2020,9,30,20,1998,1928,1302,-626
2020,9,30,21,2017,1968,1349,-619
2020,9,30,22,2036,2014,1514,-500
2020,9,30,23,2062,2052,1551,-501
2020,10,1,0,2100,2071,1671,-400
2020,10,1,1,2112,2075,1638,-437
2020,10,1,2,2120,2051,1611,-440
2020,10,1,3,2075,2012,1583,-429
2020,10,1,4,1961,1886,1383,-503
2020,10,1,5,1790,1741,1097,-644
2020,10,1,6,1634,1601,1067,-534
2020,10,1,7,1585,1565,1054,-511
2020,10,1,8,1524,1463,948,-515
2020,10,1,9,1480,1431,924,-507
2020,10,1,10,1465,1412,918,-494
2020,10,1,11,1461,1430,993,-437
2020,10,1,12,1564,1504,1097,-407
2020,10,1,13,1682,1641,1195,-446
2020,10,1,14,1810,1794,1208,-586
2020,10,1,15,1882,1833,1178,-655
2020,10,1,16,1926,1850,1291,-559
2020,10,1,17,1946,1863,1306,-557
2020,10,1,18,1949,1863,1285,-578
2020,10,1,19,1945,1886,1264,-622
2020,10,1,20,1970,1913,1227,-686
2020,10,1,21,2036,1959,1227,-732
2020,10,1,22,2043,2001,1303,-698
2020,10,1,23,2089,2057,1314,-743
2020,10,2,0,2130,2084,1380,-704
2020,10,2,1,2132,2078,1334,-744
2020,10,2,2,2133,2057,1322,-735
2020,10,2,3,2084,2005,1401,-604
2020,10,2,4,1962,1896,1417,-479
2020,10,2,5,1793,1751,1329,-422
2020,10,2,6,1620,1624,1077,-547
2020,10,2,7,1565,1527,946,-581
2020,10,2,8,1508,1482,762,-720
2020,10,2,9,1503,1438,728,-710
2020,10,2,10,1484,1424,698,-726
2020,10,2,11,1491,1440,698,-742
2020,10,2,12,1570,1511,730,-781
2020,10,2,13,1719,1633,793,-840
2020,10,2,14,1829,1749,1036,-713
2020,10,2,15,1862,1810,1053,-757
2020,10,2,16,1874,1849,1173,-676
2020,10,2,17,1920,1856,1220,-636
2020,10,2,18,1922,1865,1221,-644
2020,10,2,19,1903,1879,1244,-635
2020,10,2,20,1943,1912,1226,-686
2020,10,2,21,2002,1931,1237,-694
2020,10,2,22,2049,1985,1307,-678
2020,10,2,23,2086,2025,1353,-672
2020,10,3,0,2140,2050,1546,-504
2020,10,3,1,2128,2023,1479,-544
2020,10,3,2,2098,1983,1440,-543
2020,10,3,3,2005,1939,1357,-582
2020,10,3,4,1884,1829,1252,-577
2020,10,3,5,1728,1727,1147,-580
2020,10,3,6,1596,1612,882,-730
2020,10,3,7,1555,1527,723,-804
2020,10,3,8,1497,1483,774,-709
2020,10,3,9,1468,1418,736,-682
2020,10,3,10,1476,1411,720,-691
2020,10,3,11,1462,1414,721,-693
2020,10,3,12,1496,1454,745,-709
2020,10,3,13,1584,1500,776,-724
2020,10,3,14,1642,1567,847,-720
2020,10,3,15,1708,1672,892,-780
2020,10,3,16,1766,1718,990,-728
2020,10,3,17,1776,1727,974,-753
2020,10,3,18,1771,1745,1028,-717
2020,10,3,19,1798,1765,1018,-747
2020,10,3,20,1838,1783,1108,-675
2020,10,3,21,1898,1827,1108,-719
2020,10,3,22,1928,1863,1091,-772
2020,10,3,23,1982,1922,1210,-712
2020,10,4,0,2052,1970,1233,-737
2020,10,4,1,2030,1951,1113,-838
2020,10,4,2,1957,1916,1079,-837
2020,10,4,3,1904,1873,1068,-805
2020,10,4,4,1793,1762,965,-797
2020,10,4,5,1698,1674,963,-711
2020,10,4,6,1579,1555,836,-719
2020,10,4,7,1494,1483,716,-767
2020,10,4,8,1445,1418,718,-700
2020,10,4,9,1414,1374,734,-640
2020,10,4,10,1424,1356,757,-599
2020,10,4,11,1426,1348,796,-552
2020,10,4,12,1439,1365,824,-541
2020,10,4,13,1494,1404,812,-592
2020,10,4,14,1515,1464,926,-538
2020,10,4,15,1588,1534,1019,-515
2020,10,4,16,1686,1616,1116,-500
2020,10,4,17,1702,1629,1088,-541
2020,10,4,18,1735,1646,1088,-558
2020,10,4,19,1750,1680,1106,-574
2020,10,4,20,1773,1713,1186,-527
2020,10,4,21,1805,1741,1162,-579
2020,10,4,22,1863,1812,1196,-616
2020,10,4,23,1919,1873,1219,-654
2020,10,5,0,1982,1917,1189,-728
2020,10,5,1,1956,1902,1185,-717
2020,10,5,2,1901,1902,1328,-574
2020,10,5,3,1897,1847,1395,-452
2020,10,5,4,1802,1751,1350,-401
2020,10,5,5,1704,1619,1303,-316
2020,10,5,6,1558,1485,1292,-193
2020,10,5,7,1439,1390,1038,-352
2020,10,5,8,1406,1350,992,-358
2020,10,5,9,1351,1331,925,-406
2020,10,5,10,1355,1335,892,-443
2020,10,5,11,1379,1338,939,-399
2020,10,5,12,1440,1435,979,-456
2020,10,5,13,1589,1580,1040,-540
2020,10,5,14,1731,1710,968,-742
2020,10,5,15,1877,1754,1013,-741
2020,10,5,16,1921,1792,1111,-681
2020,10,5,17,1891,1815,1194,-621
2020,10,5,18,1860,1810,1171,-639
2020,10,5,19,1860,1827,1234,-593
2020,10,5,20,1836,1849,1341,-508
2020,10,5,21,1871,1873,1346,-527
2020,10,5,22,1888,1906,1385,-521
2020,10,5,23,1917,1975,1466,-509
2020,10,6,0,1973,1972,1434,-538
2020,10,6,1,1994,1999,1336,-663
2020,10,6,2,1990,1986,1259,-727
2020,10,6,3,1966,1919,1258,-661
2020,10,6,4,1835,1808,1280,-528
2020,10,6,5,1726,1653,1099,-554
2020,10,6,6,1589,1537,929,-608
2020,10,6,7,1534,1448,810,-638
2020,10,6,8,1484,1404,659,-745
2020,10,6,9,1439,1369,656,-713
2020,10,6,10,1418,1363,609,-754
2020,10,6,11,1455,1387,626,-761
2020,10,6,12,1514,1469,715,-754
2020,10,6,13,1649,1610,815,-795
2020,10,6,14,1827,1737,823,-914
2020,10,6,15,1922,1769,911,-858
2020,10,6,16,1910,1805,1120,-685
2020,10,6,17,1889,1812,1131,-681
2020,10,6,18,1847,1796,1121,-675
2020,10,6,19,1860,1831,1062,-769
2020,10,6,20,1916,1860,1047,-813
2020,10,6,21,1914,1892,1046,-846
2020,10,6,22,1947,1942,1094,-848
2020,10,6,23,2022,1985,1096,-889
2020,10,7,0,2096,2015,1159,-856
2020,10,7,1,2067,1989,1061,-928
2020,10,7,2,2055,1981,1004,-977
2020,10,7,3,1968,1927,957,-970
2020,10,7,4,1873,1820,971,-849
2020,10,7,5,1764,1666,882,-784
2020,10,7,6,1652,1536,743,-793
2020,10,7,7,1518,1439,686,-753
2020,10,7,8,1462,1385,686,-699
2020,10,7,9,1465,1366,724,-642
2020,10,7,10,1404,1347,722,-625
2020,10,7,11,1444,1370,787,-583
2020,10,7,12,1530,1445,809,-636
2020,10,7,13,1686,1610,944,-666
2020,10,7,14,1808,1731,1231,-500
2020,10,7,15,1870,1781,1279,-502
2020,10,7,16,1962,1802,1346,-456
2020,10,7,17,1946,1796,1384,-412
2020,10,7,18,1887,1796,1379,-417
2020,10,7,19,1870,1807,1380,-427
2020,10,7,20,1845,1818,1373,-445
2020,10,7,21,1953,1847,1330,-517
2020,10,7,22,2013,1873,1276,-597
2020,10,7,23,1990,1904,1235,-669
2020,10,8,0,2041,1926,1350,-576
2020,10,8,1,2006,1939,1275,-664
2020,10,8,2,1994,1930,1215,-715
2020,10,8,3,1987,1891,1139,-752
2020,10,8,4,1860,1815,1122,-693
2020,10,8,5,1692,1657,924,-733
2020,10,8,6,1566,1535,848,-687
2020,10,8,7,1503,1450,821,-629
2020,10,8,8,1446,1401,872,-529
2020,10,8,9,1396,1376,898,-478
2020,10,8,10,1419,1358,926,-432
2020,10,8,11,1445,1382,923,-459
2020,10,8,12,1541,1457,920,-537
2020,10,8,13,1710,1625,933,-692
2020,10,8,14,1830,1749,954,-795
2020,10,8,15,1854,1794,979,-815
2020,10,8,16,1880,1815,1026,-789
2020,10,8,17,1881,1806,1045,-761
2020,10,8,18,1848,1826,1062,-764
2020,10,8,19,1855,1808,1063,-745
2020,10,8,20,1871,1817,1048,-769
2020,10,8,21,1895,1858,1062,-796
2020,10,8,22,1908,1896,1087,-809
2020,10,8,23,1929,1895,1197,-698
2020,10,9,0,1980,1909,1124,-785
2020,10,9,1,1954,1905,1176,-729
2020,10,9,2,1965,1911,1240,-671
2020,10,9,3,1984,1871,1266,-605
2020,10,9,4,1889,1770,1209,-561
2020,10,9,5,1722,1653,1142,-511
2020,10,9,6,1607,1519,1010,-509
2020,10,9,7,1501,1452,890,-562
2020,10,9,8,1438,1415,886,-529
2020,10,9,9,1418,1388,848,-540
2020,10,9,10,1420,1383,834,-549
2020,10,9,11,1453,1406,849,-557
2020,10,9,12,1572,1478,893,-585
2020,10,9,13,1737,1638,981,-657
2020,10,9,14,1863,1776,1014,-762
2020,10,9,15,1906,1810,981,-829
2020,10,9,16,1920,1842,1049,-793
2020,10,9,17,1906,1805,1095,-710
2020,10,9,18,1848,1788,1102,-686
2020,10,9,19,1814,1772,1061,-711
2020,10,9,20,1805,1784,1092,-692
2020,10,9,21,1804,1780,1100,-680
2020,10,9,22,1821,1793,1120,-673
2020,10,9,23,1854,1808,1114,-694
2020,10,10,0,1884,1820,1135,-685
2020,10,10,1,1909,1804,1037,-767
2020,10,10,2,1903,1834,1034,-800
2020,10,10,3,1845,1779,1062,-717
2020,10,10,4,1763,1698,1071,-627
2020,10,10,5,1661,1616,969,-647
2020,10,10,6,1546,1518,893,-625
2020,10,10,7,1472,1441,810,-631
2020,10,10,8,1432,1386,845,-541
2020,10,10,9,1416,1360,894,-466
2020,10,10,10,1401,1341,943,-398
2020,10,10,11,1431,1344,988,-356
2020,10,10,12,1452,1389,1023,-366
2020,10,10,13,1559,1445,1129,-316
2020,10,10,14,1648,1546,1131,-415
2020,10,10,15,1658,1630,1089,-541
2020,10,10,16,1718,1668,1097,-571
2020,10,10,17,1742,1702,981,-721
2020,10,10,18,1657,1717,909,-808
2020,10,10,19,1709,1701,835,-866
2020,10,10,20,1714,1703,866,-837
2020,10,10,21,1675,1692,912,-780
2020,10,10,22,1635,1683,1056,-627
2020,10,10,23,1646,1692,1276,-416
2020,10,11,0,1670,1702,1048,-654
2020,10,11,1,1668,1751,929,-822
2020,10,11,2,1765,1734,1009,-725
2020,10,11,3,1823,1701,1053,-648
2020,10,11,4,1757,1631,1085,-546
2020,10,11,5,1653,1544,1246,-298
2020,10,11,6,1531,1469,1354,-115
2020,10,11,7,1437,1413,1221,-192
2020,10,11,8,1405,1341,1115,-226
2020,10,11,9,1412,1324,1117,-207
2020,10,11,10,1399,1313,1136,-177
2020,10,11,11,1394,1326,1111,-215
2020,10,11,12,1439,1347,1101,-246
2020,10,11,13,1499,1412,1182,-230
2020,10,11,14,1581,1486,1205,-281
2020,10,11,15,1683,1571,1203,-368
2020,10,11,16,1763,1611,1280,-331
2020,10,11,17,1816,1619,1321,-298
2020,10,11,18,1746,1614,1354,-260
2020,10,11,19,1700,1608,1351,-257
2020,10,11,20,1691,1587,1329,-258
2020,10,11,21,1595,1572,1254,-318
2020,10,11,22,1608,1577,1260,-317
2020,10,11,23,1639,1597,1155,-442
2020,10,12,0,1661,1638,1101,-537
2020,10,12,1,1667,1691,1007,-684
2020,10,12,2,1785,1744,1025,-719
2020,10,12,3,1788,1704,979,-725
2020,10,12,4,1719,1618,927,-691
2020,10,12,5,1604,1527,905,-622
2020,10,12,6,1476,1407,853,-554
2020,10,12,7,1385,1353,850,-503
2020,10,12,8,1353,1305,829,-476
2020,10,12,9,1354,1306,802,-504
2020,10,12,10,1357,1309,761,-548
2020,10,12,11,1392,1331,784,-547
2020,10,12,12,1457,1419,783,-636
2020,10,12,13,1617,1555,929,-626
2020,10,12,14,1757,1704,946,-758
2020,10,12,15,1876,1750,950,-800
2020,10,12,16,1916,1766,957,-809
2020,10,12,17,1893,1743,970,-773
2020,10,12,18,1841,1737,964,-773
2020,10,12,19,1804,1723,1044,-679
2020,10,12,20,1721,1723,1207,-516
2020,10,12,21,1711,1715,1146,-569
2020,10,12,22,1693,1697,1186,-511
2020,10,12,23,1692,1705,1303,-402
2020,10,13,0,1712,1727,1226,-501
2020,10,13,1,1734,1742,1107,-635
2020,10,13,2,1798,1787,957,-830
2020,10,13,3,1826,1762,925,-837
2020,10,13,4,1750,1671,899,-772
2020,10,13,5,1619,1537,849,-688
2020,10,13,6,1503,1426,688,-738
2020,10,13,7,1467,1364,682,-682
2020,10,13,8,1439,1330,665,-665
2020,10,13,9,1420,1318,667,-651
2020,10,13,10,1379,1313,665,-648
2020,10,13,11,1405,1352,717,-635
2020,10,13,12,1506,1425,866,-559
2020,10,13,13,1647,1602,887,-715
2020,10,13,14,1772,1723,880,-843
2020,10,13,15,1830,1769,913,-856
2020,10,13,16,1888,1801,978,-823
2020,10,13,17,1948,1803,974,-829
2020,10,13,18,1876,1800,1006,-794
2020,10,13,19,1787,1779,997,-782
2020,10,13,20,1842,1744,1006,-738
2020,10,13,21,1835,1728,989,-739
2020,10,13,22,1794,1718,984,-734
2020,10,13,23,1829,1728,912,-816
2020,10,14,0,1876,1742,846,-896
2020,10,14,1,1928,1760,862,-898
2020,10,14,2,1936,1795,905,-890
2020,10,14,3,1860,1741,1022,-719
2020,10,14,4,1774,1655,1280,-375
2020,10,14,5,1598,1540,1406,-134
2020,10,14,6,1462,1434,1407,-27
2020,10,14,7,1493,1360,1346,-14
2020,10,14,8,1420,1322,1294,-28
2020,10,14,9,1310,1296,1250,-46
2020,10,14,10,1318,1304,1253,-51
2020,10,14,11,1351,1322,1210,-112
2020,10,14,12,1429,1400,1225,-175
2020,10,14,13,1588,1565,1227,-338
2020,10,14,14,1731,1691,1220,-471
2020,10,14,15,1821,1744,1238,-506
2020,10,14,16,1880,1765,1299,-466
2020,10,14,17,1885,1733,1421,-312
2020,10,14,18,1809,1732,1466,-266
2020,10,14,19,1749,1703,1428,-275
2020,10,14,20,1686,1700,1437,-263
2020,10,14,21,1703,1680,1396,-284
2020,10,14,22,1702,1690,1397,-293
2020,10,14,23,1744,1689,1344,-345
2020,10,15,0,1803,1712,1228,-484
2020,10,15,1,1815,1721,1334,-387
2020,10,15,2,1907,1773,1197,-576
2020,10,15,3,1824,1764,1242,-522
2020,10,15,4,1650,1690,1030,-660
2020,10,15,5,1673,1570,1033,-537
2020,10,15,6,1543,1464,1088,-376
2020,10,15,7,1493,1404,989,-415
2020,10,15,8,1402,1377,968,-409
2020,10,15,9,1398,1363,915,-448
2020,10,15,10,1416,1375,914,-461
2020,10,15,11,1451,1404,970,-434
2020,10,15,12,1536,1499,1176,-323
2020,10,15,13,1727,1659,1193,-466
2020,10,15,14,1918,1816,1193,-623
2020,10,15,15,1996,1863,1259,-604
2020,10,15,16,2028,1886,1367,-519
2020,10,15,17,1954,1839,1429,-410
2020,10,15,18,1837,1797,1486,-311
2020,10,15,19,1804,1757,1523,-234
2020,10,15,20,1717,1725,1548,-177
2020,10,15,21,1720,1705,1515,-190
2020,10,15,22,1805,1689,1583,-106
2020,10,15,23,1836,1699,1593,-106
2020,10,16,0,1766,1701,1540,-161
2020,10,16,1,1817,1730,1476,-254
2020,10,16,2,1781,1789,1486,-303
2020,10,16,3,1799,1772,1326,-446
2020,10,16,4,1741,1708,1278,-430
2020,10,16,5,1623,1601,1251,-350
2020,10,16,6,1525,1507,1125,-382
2020,10,16,7,1444,1444,993,-451
2020,10,16,8,1386,1419,947,-472
2020,10,16,9,1442,1398,898,-500
2020,10,16,10,1434,1411,848,-563
2020,10,16,11,1504,1435,794,-641
2020,10,16,12,1581,1539,914,-625
2020,10,16,13,1729,1689,922,-767
2020,10,16,14,1847,1826,869,-957
2020,10,16,15,1909,1875,938,-937
2020,10,16,16,1969,1874,1038,-836
2020,10,16,17,1925,1821,1058,-763
2020,10,16,18,1847,1772,1073,-699
2020,10,16,19,1847,1731,1089,-642
2020,10,16,20,1867,1696,1127,-569
2020,10,16,21,1847,1677,1126,-551
2020,10,16,22,1796,1657,1180,-477
2020,10,16,23,1804,1654,1292,-362
2020,10,17,0,1733,1658,1222,-436
2020,10,17,1,1686,1670,1018,-652
2020,10,17,2,1783,1711,986,-725
2020,10,17,3,1783,1684,965,-719
2020,10,17,4,1678,1623,841,-782
2020,10,17,5,1527,1548,838,-710
2020,10,17,6,1490,1458,835,-623
2020,10,17,7,1401,1372,864,-508
2020,10,17,8,1369,1335,956,-379
2020,10,17,9,1342,1305,973,-332
2020,10,17,10,1332,1287,1000,-287
2020,10,17,11,1333,1304,1042,-262
2020,10,17,12,1380,1336,1086,-250
2020,10,17,13,1460,1407,1159,-248
2020,10,17,14,1541,1493,1250,-243
2020,10,17,15,1625,1564,1294,-270
2020,10,17,16,1700,1604,1402,-202
2020,10,17,17,1721,1612,1430,-182
2020,10,17,18,1674,1597,1418,-179
2020,10,17,19,1660,1582,1438,-144
2020,10,17,20,1659,1567,1378,-189
2020,10,17,21,1590,1543,1354,-189
2020,10,17,22,1609,1552,1354,-198
2020,10,17,23,1631,1561,1388,-173
2020,10,18,0,1649,1583,1335,-248
2020,10,18,1,1705,1613,1190,-423
2020,10,18,2,1732,1658,1110,-548
2020,10,18,3,1693,1616,971,-645
2020,10,18,4,1638,1557,980,-577
2020,10,18,5,1549,1473,950,-523
2020,10,18,6,1466,1404,881,-523
2020,10,18,7,1376,1341,912,-429
2020,10,18,8,1312,1289,890,-399
2020,10,18,9,1318,1278,963,-315
2020,10,18,10,1312,1264,1006,-258
2020,10,18,11,1362,1266,1002,-264
2020,10,18,12,1388,1294,930,-364
2020,10,18,13,1496,1362,962,-400
2020,10,18,14,1473,1429,948,-481
2020,10,18,15,1556,1500,924,-576
2020,10,18,16,1658,1563,953,-610
2020,10,18,17,1687,1577,1027,-550
2020,10,18,18,1593,1558,1150,-408
2020,10,18,19,1600,1563,1278,-285
2020,10,18,20,1581,1556,1333,-223
2020,10,18,21,1559,1550,1323,-227
2020,10,18,22,1599,1562,1283,-279
2020,10,18,23,1638,1586,1264,-322
2020,10,19,0,1686,1624,1125,-499
2020,10,19,1,1711,1637,906,-731
2020,10,19,2,1741,1690,837,-853
2020,10,19,3,1688,1644,838,-806
2020,10,19,4,1618,1580,883,-697
2020,10,19,5,1476,1459,816,-643
2020,10,19,6,1429,1361,778,-583
2020,10,19,7,1309,1284,759,-525
2020,10,19,8,1278,1250,769,-481
2020,10,19,9,1286,1233,821,-412
2020,10,19,10,1272,1233,919,-314
2020,10,19,11,1319,1262,978,-284
2020,10,19,12,1359,1344,931,-413
2020,10,19,13,1487,1502,1066,-436
2020,10,19,14,1669,1642,1144,-498
2020,10,19,15,1810,1704,1138,-566
2020,10,19,16,1876,1731,1099,-632
2020,10,19,17,1785,1726,1038,-688
2020,10,19,18,1727,1706,1129,-577
2020,10,19,19,1689,1683,1182,-501
2020,10,19,20,1719,1674,1151,-523
2020,10,19,21,1704,1650,1169,-481
2020,10,19,22,1698,1667,1205,-462
2020,10,19,23,1732,1669,1164,-505
2020,10,20,0,1784,1692,1039,-653
2020,10,20,1,1834,1711,848,-863
2020,10,20,2,1891,1744,816,-928
2020,10,20,3,1831,1707,781,-926
2020,10,20,4,1749,1618,831,-787
2020,10,20,5,1629,1502,856,-646
2020,10,20,6,1509,1395,850,-545
2020,10,20,7,1415,1324,898,-426
2020,10,20,8,1357,1285,948,-337
2020,10,20,9,1402,1285,998,-287
2020,10,20,10,1338,1277,1091,-186
2020,10,20,11,1401,1302,1154,-148
2020,10,20,12,1489,1400,1198,-202
2020,10,20,13,1590,1541,1193,-348
2020,10,20,14,1811,1679,1170,-509
2020,10,20,15,1835,1728,1099,-629
2020,10,20,16,1810,1751,1089,-662
2020,10,20,17,1843,1756,1055,-701
2020,10,20,18,1808,1724,1127,-597
2020,10,20,19,1771,1687,1135,-552
2020,10,20,20,1724,1666,1107,-559
2020,10,20,21,1762,1654,1061,-593
2020,10,20,22,1737,1659,1068,-591
2020,10,20,23,1730,1667,1087,-580
2020,10,21,0,1785,1658,980,-678
2020,10,21,1,1823,1705,911,-794
2020,10,21,2,1879,1740,965,-775
2020,10,21,3,1814,1702,955,-747
2020,10,21,4,1686,1613,873,-740
2020,10,21,5,1583,1509,905,-604
2020,10,21,6,1476,1423,866,-557
2020,10,21,7,1410,1342,757,-585
2020,10,21,8,1349,1309,728,-581
2020,10,21,9,1432,1285,736,-549
2020,10,21,10,1414,1283,759,-524
2020,10,21,11,1373,1302,792,-510
2020,10,21,12,1449,1390,842,-548
2020,10,21,13,1630,1539,946,-593
2020,10,21,14,1760,1675,953,-722
2020,10,21,15,1820,1738,937,-801
2020,10,21,16,1808,1739,986,-753
2020,10,21,17,1817,1724,1105,-619
2020,10,21,18,1525,1698,1174,-524
2020,10,21,19,1790,1668,1238,-430
2020,10,21,20,1713,1661,1247,-414
2020,10,21,21,1650,1645,1269,-376
2020,10,21,22,1737,1644,1317,-327
2020,10,21,23,1758,1638,1398,-240
2020,10,22,0,1819,1662,1317,-345
2020,10,22,1,1783,1700,1137,-563
2020,10,22,2,1779,1751,1179,-572
2020,10,22,3,1811,1712,1175,-537
2020,10,22,4,1741,1646,1123,-523
2020,10,22,5,1655,1555,1181,-374
2020,10,22,6,1625,1458,1185,-273
2020,10,22,7,1458,1389,1140,-249
2020,10,22,8,1400,1377,1168,-209
2020,10,22,9,1403,1368,1159,-209
2020,10,22,10,1476,1364,1107,-257
2020,10,22,11,1550,1416,1077,-339
2020,10,22,12,1616,1520,1092,-428
2020,10,22,13,1813,1697,1061,-636
2020,10,22,14,1951,1862,1035,-827
2020,10,22,15,1953,1889,1064,-825
2020,10,22,16,1929,1881,1132,-749
2020,10,22,17,1998,1856,1144,-712
2020,10,22,18,1887,1800,1025,-775
2020,10,22,19,1747,1766,976,-790
2020,10,22,20,1787,1720,924,-796
2020,10,22,21,1723,1687,1056,-631
2020,10,22,22,1682,1665,1087,-578
2020,10,22,23,1722,1671,982,-689
2020,10,23,0,1757,1695,918,-777
2020,10,23,1,1755,1747,832,-915
2020,10,23,2,1830,1809,986,-823
2020,10,23,3,1853,1790,987,-803
2020,10,23,4,1822,1741,908,-833
2020,10,23,5,1778,1641,851,-790
2020,10,23,6,1680,1556,821,-735
2020,10,23,7,1568,1511,896,-615
2020,10,23,8,1529,1488,834,-654
2020,10,23,9,1574,1479,831,-648
2020,10,23,10,1543,1489,865,-624
2020,10,23,11,1576,1524,907,-617
2020,10,23,12,1652,1617,951,-666
2020,10,23,13,1839,1769,976,-793
2020,10,23,14,1959,1906,987,-919
2020,10,23,15,1974,1977,1106,-871
2020,10,23,16,2022,1960,1229,-731
2020,10,23,17,2014,1904,1261,-643
2020,10,23,18,1845,1849,1250,-599
2020,10,23,19,1828,1780,1218,-562
2020,10,23,20,1840,1720,1185,-535
2020,10,23,21,1760,1679,1099,-580
2020,10,23,22,1764,1670,1040,-630
2020,10,23,23,1777,1646,1031,-615
2020,10,24,0,1806,1655,1021,-634
2020,10,24,1,1731,1700,937,-763
2020,10,24,2,1798,1753,939,-814
2020,10,24,3,1772,1728,926,-802
2020,10,24,4,1673,1665,931,-734
2020,10,24,5,1571,1594,946,-648
2020,10,24,6,1552,1514,933,-581
2020,10,24,7,1441,1437,858,-579
2020,10,24,8,1380,1394,810,-584
2020,10,24,9,1439,1371,793,-578
2020,10,24,10,1419,1354,786,-568
2020,10,24,11,1372,1348,809,-539
2020,10,24,12,1443,1391,908,-483
2020,10,24,13,1510,1454,1001,-453
2020,10,24,14,1600,1545,1012,-533
2020,10,24,15,1646,1630,1044,-586
2020,10,24,16,1692,1701,1110,-591
2020,10,24,17,1773,1742,1241,-501
2020,10,24,18,1741,1736,1389,-347
2020,10,24,19,1781,1712,1455,-257
2020,10,24,20,1782,1665,1479,-186
2020,10,24,21,1695,1637,1504,-133
2020,10,24,22,1679,1628,1510,-118
2020,10,24,23,1751,1635,1509,-126
2020,10,25,0,1722,1675,1492,-183
2020,10,25,1,1778,1705,1398,-307
2020,10,25,2,1826,1759,1398,-361
2020,10,25,3,1790,1746,1386,-360
2020,10,25,4,1699,1724,1404,-320
2020,10,25,5,1627,1651,1410,-241
2020,10,25,6,1670,1597,1408,-189
2020,10,25,7,1515,1557,1312,-245
2020,10,25,8,1540,1523,1287,-236
2020,10,25,9,1587,1509,1188,-321
2020,10,25,10,1538,1522,1125,-397
2020,10,25,11,1551,1551,1058,-493
2020,10,25,12,1556,1610,1070,-540
2020,10,25,13,1625,1689,1096,-593
2020,10,25,14,1715,1784,1166,-618
2020,10,25,15,1807,1894,1149,-745
2020,10,25,16,1876,1939,1259,-680
2020,10,25,17,2031,1931,1367,-564
2020,10,25,18,2052,1884,1412,-472
2020,10,25,19,1938,1856,1413,-443
2020,10,25,20,1805,1793,1359,-434
2020,10,25,21,1716,1748,1307,-441
2020,10,25,22,1692,1734,1328,-406
2020,10,25,23,1670,1731,1354,-377
2020,10,26,0,1711,1784,1268,-516
2020,10,26,1,1746,1854,1125,-729
2020,10,26,2,1872,1937,1252,-685
2020,10,26,3,1920,1923,1159,-764
2020,10,26,4,1871,1868,1082,-786
2020,10,26,5,1789,1777,1077,-700
2020,10,26,6,1732,1688,1084,-604
2020,10,26,7,1569,1622,1057,-565
2020,10,26,8,1525,1618,1064,-554
2020,10,26,9,1579,1621,1053,-568
2020,10,26,10,1610,1653,1025,-628
2020,10,26,11,1665,1709,1037,-672
2020,10,26,12,1811,1818,1080,-738
2020,10,26,13,1957,2007,1218,-789
2020,10,26,14,2165,2166,1292,-874
2020,10,26,15,2238,2223,1404,-819
2020,10,26,16,2266,2172,1328,-844
2020,10,26,17,2216,2117,1267,-850
2020,10,26,18,2130,2029,1236,-793
2020,10,26,19,2019,1966,1212,-754
2020,10,26,20,1939,1911,1237,-674
2020,10,26,21,1821,1866,1331,-535
2020,10,26,22,1801,1828,1469,-359
2020,10,26,23,1809,1817,1597,-220
2020,10,27,0,1860,1851,1520,-331
2020,10,27,1,1886,1928,1525,-403
2020,10,27,2,1926,1981,1474,-507
2020,10,27,3,1972,1949,1448,-501
2020,10,27,4,1913,1879,1363,-516
2020,10,27,5,1796,1754,1275,-479
2020,10,27,6,1701,1649,1219,-430
2020,10,27,7,1614,1580,1203,-377
2020,10,27,8,1601,1555,1085,-470
2020,10,27,9,1558,1564,990,-574
2020,10,27,10,1563,1571,941,-630
2020,10,27,11,1611,1619,909,-710
2020,10,27,12,1746,1714,892,-822
2020,10,27,13,1902,1896,944,-952
2020,10,27,14,2034,2063,993,-1070
2020,10,27,15,2099,2092,1153,-939
2020,10,27,16,2103,2039,1191,-848
2020,10,27,17,2068,1962,1139,-823
2020,10,27,18,1950,1880,1092,-788
2020,10,27,19,1837,1816,1079,-737
2020,10,27,20,1798,1741,1053,-688
2020,10,27,21,1776,1711,1030,-681
2020,10,27,22,1777,1681,1162,-519
2020,10,27,23,1749,1661,1217,-444
2020,10,28,0,1739,1681,1198,-483
2020,10,28,1,1800,1735,1236,-499
2020,10,28,2,1860,1820,1183,-637
2020,10,28,3,1849,1789,1135,-654
2020,10,28,4,1799,1719,898,-821
2020,10,28,5,1668,1613,785,-828
2020,10,28,6,1579,1535,756,-779
2020,10,28,7,1563,1477,739,-738
2020,10,28,8,1517,1467,774,-693
2020,10,28,9,1492,1463,735,-728
2020,10,28,10,1494,1488,728,-760
2020,10,28,11,1509,1543,713,-830
2020,10,28,12,1636,1650,876,-774
2020,10,28,13,1834,1828,903,-925
2020,10,28,14,1968,1998,1038,-960
2020,10,28,15,2020,2031,1188,-843
2020,10,28,16,2011,1995,1135,-860
2020,10,28,17,1972,1917,1136,-781
2020,10,28,18,1898,1863,1101,-762
2020,10,28,19,1817,1779,1029,-750
2020,10,28,20,1789,1717,1094,-623
2020,10,28,21,1760,1686,1172,-514
2020,10,28,22,1741,1654,1230,-424
2020,10,28,23,1718,1671,1230,-441
2020,10,29,0,1737,1680,1110,-570
2020,10,29,1,1787,1710,1123,-587
2020,10,29,2,1860,1774,1049,-725
2020,10,29,3,1816,1753,1017,-736
2020,10,29,4,1740,1680,994,-686
2020,10,29,5,1608,1574,990,-584
2020,10,29,6,1510,1490,1001,-489
2020,10,29,7,1516,1439,959,-480
2020,10,29,8,1468,1424,974,-450
2020,10,29,9,1447,1424,972,-452
2020,10,29,10,1465,1442,970,-472
2020,10,29,11,1490,1508,987,-521
2020,10,29,12,1620,1596,1109,-487
2020,10,29,13,1788,1770,1246,-524
2020,10,29,14,1924,1927,1293,-634
2020,10,29,15,1967,1971,1405,-566
2020,10,29,16,1952,1926,1409,-517
2020,10,29,17,1922,1850,1437,-413
2020,10,29,18,1868,1811,1348,-463
2020,10,29,19,1833,1747,1295,-452
2020,10,29,20,1811,1687,1253,-434
2020,10,29,21,1756,1652,1260,-392
2020,10,29,22,1749,1643,1302,-341
2020,10,29,23,1722,1661,1353,-308
2020,10,30,0,1702,1639,1250,-389
2020,10,30,1,1783,1674,1256,-418
2020,10,30,2,1840,1728,1272,-456
2020,10,30,3,1790,1696,1176,-520
2020,10,30,4,1734,1622,1093,-529
2020,10,30,5,1590,1545,1029,-516
2020,10,30,6,1493,1456,1001,-455
2020,10,30,7,1482,1406,902,-504
2020,10,30,8,1446,1384,951,-433
2020,10,30,9,1446,1372,980,-392
2020,10,30,10,1437,1397,1011,-386
2020,10,30,11,1477,1424,1080,-344
2020,10,30,12,1570,1558,1149,-409
2020,10,30,13,1752,1759,1280,-479
2020,10,30,14,1883,1903,1414,-489
2020,10,30,15,1935,1969,1421,-548
2020,10,30,16,1920,1917,1467,-450
2020,10,30,17,1886,1841,1470,-371
2020,10,30,18,1843,1784,1391,-393
2020,10,30,19,1761,1712,1285,-427
2020,10,30,20,1713,1678,1251,-427
2020,10,30,21,1707,1646,1189,-457
2020,10,30,22,1701,1646,1208,-438
2020,10,30,23,1725,1634,1219,-415
2020,10,31,0,1778,1629,1054,-575
2020,10,31,1,1740,1648,1097,-551
2020,10,31,2,1810,1675,1132,-543
2020,10,31,3,1684,1654,1281,-373
2020,10,31,4,1643,1574,1380,-194
2020,10,31,5,1558,1536,1368,-168
2020,10,31,6,1520,1417,1363,-54
2020,10,31,7,1458,1376,1354,-22
2020,10,31,8,1421,1310,1385,75
2020,10,31,9,1406,1295,1391,96
2020,10,31,10,1364,1300,1358,58
2020,10,31,11,1416,1342,1370,28
2020,10,31,12,1465,1406,1386,-20
2020,10,31,13,1550,1473,1379,-94
2020,10,31,14,1669,1575,1371,-204
2020,10,31,15,1783,1674,1275,-399
2020,10,31,16,1795,1716,1238,-478
2020,10,31,17,1801,1706,1220,-486
2020,10,31,18,1785,1679,1173,-506
2020,10,31,19,1648,1658,1125,-533
2020,10,31,20,1579,1601,1077,-524
2020,10,31,21,1586,1555,1079,-476
2020,10,31,22,1603,1552,1122,-430
2020,10,31,23,1554,1525,1111,-414
2020,11,1,0,1556,1524,991,-533
2020,11,1,1,1614,1550,916,-634
2020,11,1,2,1700,1589,913,-676
2020,11,1,3,1651,1576,837,-739
2020,11,1,4,1601,1561,878,-683
2020,11,1,5,1527,1492,890,-602
2020,11,1,6,1450,1444,860,-584
2020,11,1,7,1452,1474,899,-575
2020,11,1,8,-9999,1474,899,-9999
2020,11,1,9,-9999,1295,1391,-9999
2020,11,1,10,-9999,1300,1358,-9999
2020,11,1,11,-9999,1342,1370,-9999
2020,11,1,12,-9999,1406,1386,-9999
2020,11,1,13,-9999,1473,1379,-9999
2020,11,1,14,-9999,1575,1371,-9999
2020,11,1,15,-9999,1674,1275,-9999
2020,11,1,16,-9999,1716,1238,-9999
2020,11,1,17,-9999,1706,1220,-9999
2020,11,1,18,-9999,1679,1173,-9999
2020,11,1,19,-9999,1658,1125,-9999
2020,11,1,20,-9999,1601,1077,-9999
2020,11,1,21,-9999,1555,1079,-9999
2020,11,1,22,-9999,1552,1122,-9999
2020,11,1,23,-9999,1525,1111,-9999
2020,11,2,0,-9999,1524,991,-9999
2020,11,2,1,-9999,1550,916,-9999
2020,11,2,2,-9999,1589,913,-9999
2020,11,2,3,-9999,1576,837,-9999
2020,11,2,4,-9999,1561,878,-9999
2020,11,2,5,-9999,1492,890,-9999
2020,11,2,6,-9999,1444,860,-9999
2020,11,2,7,1418,1418,899,-9999
2020,11,2,8,-9999,-9999,-9999,-9999
2020,11,2,9,1355,1377,1008,-369
2020,11,2,10,1398,1387,982,-405
2020,11,2,11,1436,1413,1027,-386
2020,11,2,12,1447,1473,1044,-429
2020,11,2,13,1575,1596,1101,-495
2020,11,2,14,1739,1780,1242,-538
2020,11,2,15,1929,1921,1364,-557
2020,11,2,16,2026,1900,1403,-497
2020,11,2,17,1948,1842,1401,-441
2020,11,2,18,1822,1784,1252,-532
2020,11,2,19,1779,1724,1219,-505
2020,11,2,20,1721,1673,1174,-499
2020,11,2,21,1677,1657,1165,-492
2020,11,2,22,1631,1621,1163,-458
2020,11,2,23,1663,1622,1190,-432
2020,11,3,0,1637,1633,1123,-510
2020,11,3,1,1611,1696,1184,-512
2020,11,3,2,1642,1768,1203,-565
2020,11,3,3,1757,1729,1027,-702
2020,11,3,4,1778,1689,968,-721
2020,11,3,5,1670,1601,949,-652
2020,11,3,6,1564,1506,934,-572
2020,11,3,7,1467,1445,900,-545
2020,11,3,8,1470,1408,834,-574
2020,11,3,9,1437,1387,886,-501
2020,11,3,10,1404,1401,911,-490
2020,11,3,11,1441,1419,1014,-405
2020,11,3,12,1460,1482,1000,-482
2020,11,3,13,1570,1588,1043,-545
2020,11,3,14,1788,1774,1077,-697
2020,11,3,15,1923,1891,1146,-745
2020,11,3,16,1925,1880,1246,-634
2020,11,3,17,1882,1815,1307,-508
2020,11,3,18,1808,1750,1250,-500
2020,11,3,19,1743,1696,1179,-517
2020,11,3,20,1695,1646,1147,-499
2020,11,3,21,1671,1632,1102,-530
2020,11,3,22,1653,1598,1058,-540
2020,11,3,23,1644,1611,1035,-576
2020,11,4,0,1656,1625,934,-691
2020,11,4,1,1661,1685,975,-710
2020,11,4,2,1708,1745,1083,-662
2020,11,4,3,1756,1712,1041,-671
2020,11,4,4,1732,1660,1017,-643
2020,11,4,5,1643,1595,904,-691
2020,11,4,6,1532,1521,870,-651
2020,11,4,7,1442,1435,870,-565
2020,11,4,8,1456,1398,837,-561
2020,11,4,9,1394,1378,819,-559
2020,11,4,10,1424,1389,794,-595
2020,11,4,11,1434,1396,777,-619
2020,11,4,12,1452,1439,816,-623
2020,11,4,13,1557,1556,833,-723
2020,11,4,14,1752,1739,990,-749
2020,11,4,15,1872,1862,1000,-862
2020,11,4,16,1882,1846,971,-875
2020,11,4,17,1850,1787,1041,-746
2020,11,4,18,1800,1732,1039,-693
2020,11,4,19,1720,1688,1040,-648
2020,11,4,20,1666,1658,1061,-597
2020,11,4,21,1653,1647,1082,-565
2020,11,4,22,1635,1623,1132,-491
2020,11,4,23,1636,1617,1099,-518
2020,11,5,0,1640,1640,1010,-630
2020,11,5,1,1695,1692,975,-717
2020,11,5,2,1732,1764,1014,-750
2020,11,5,3,1730,1724,1019,-705
2020,11,5,4,1686,1664,945,-719
2020,11,5,5,1605,1588,919,-669
2020,11,5,6,1524,1486,929,-557
2020,11,5,7,1444,1400,926,-474
2020,11,5,8,1420,1344,946,-398
2020,11,5,9,1391,1331,888,-443
2020,11,5,10,1350,1335,835,-500
2020,11,5,11,1370,1356,805,-551
2020,11,5,12,1414,1395,818,-577
2020,11,5,13,1539,1515,890,-625
2020,11,5,14,1725,1685,1008,-677
2020,11,5,15,1849,1831,1130,-701
2020,11,5,16,1848,1805,1078,-727
2020,11,5,17,1816,1753,1137,-616
2020,11,5,18,1772,1714,1168,-546
2020,11,5,19,1722,1692,1173,-519
2020,11,5,20,1690,1655,1123,-532
2020,11,5,21,1649,1641,1111,-530
2020,11,5,22,1634,1611,1109,-502
2020,11,5,23,1670,1641,1195,-446
2020,11,6,0,1670,1656,1183,-473
2020,11,6,1,1722,1701,1214,-487
2020,11,6,2,1778,1736,1248,-488
2020,11,6,3,1721,1696,1272,-424
2020,11,6,4,1675,1647,1201,-446
2020,11,6,5,1601,1562,1107,-455
2020,11,6,6,1498,1472,1086,-386
2020,11,6,7,1413,1375,1148,-227
2020,11,6,8,1412,1323,1214,-109
2020,11,6,9,1354,1284,1185,-99
2020,11,6,10,1308,1280,1192,-88
2020,11,6,11,1334,1282,1176,-106
2020,11,6,12,1368,1315,1165,-150
2020,11,6,13,1462,1387,1135,-252
2020,11,6,14,1632,1531,1222,-309
2020,11,6,15,1745,1660,1302,-358
2020,11,6,16,1737,1699,1329,-370
2020,11,6,17,1727,1698,1293,-405
2020,11,6,18,1711,1685,1293,-392
2020,11,6,19,1676,1673,1267,-406
2020,11,6,20,1644,1659,1355,-304
2020,11,6,21,1654,1635,1288,-347
2020,11,6,22,1642,1616,1263,-353
2020,11,6,23,1628,1582,1243,-339
2020,11,7,0,1651,1614,1180,-434
2020,11,7,1,1635,1682,1205,-477
2020,11,7,2,1675,1729,1238,-491
2020,11,7,3,1696,1682,1209,-473
2020,11,7,4,1623,1631,1328,-303
2020,11,7,5,1568,1570,1351,-219
2020,11,7,6,1521,1492,1355,-137
2020,11,7,7,1440,1400,1251,-149
2020,11,7,8,1397,1352,1253,-99
2020,11,7,9,1355,1327,1167,-160
2020,11,7,10,1354,1307,1056,-251
2020,11,7,11,1361,1326,1004,-322
2020,11,7,12,1402,1343,981,-362
2020,11,7,13,1472,1416,988,-428
2020,11,7,14,1581,1495,998,-497
2020,11,7,15,1680,1594,1098,-496
2020,11,7,16,1758,1653,1259,-394
2020,11,7,17,1755,1654,1238,-416
2020,11,7,18,1721,1648,1185,-463
2020,11,7,19,1665,1638,1156,-482
2020,11,7,20,1588,1631,1152,-479
2020,11,7,21,1532,1603,1086,-517
2020,11,7,22,1506,1602,1080,-522
2020,11,7,23,1474,1626,1061,-565
2020,11,8,0,1501,1678,1160,-518
2020,11,8,1,1580,1791,1364,-427
2020,11,8,2,1668,1811,1460,-351
2020,11,8,3,1678,1777,1411,-366
2020,11,8,4,1656,1759,1340,-419
2020,11,8,5,1613,1695,1426,-269
2020,11,8,6,1562,1627,1394,-233
2020,11,8,7,1503,1572,1403,-169
2020,11,8,8,1459,1521,1396,-125
2020,11,8,9,1452,1495,1361,-134
2020,11,8,10,1499,1477,1363,-114
2020,11,8,11,1502,1492,1383,-109
2020,11,8,12,1547,1517,1444,-73
2020,11,8,13,1596,1555,1313,-242
2020,11,8,14,1685,1627,1273,-354
2020,11,8,15,1768,1716,1229,-487
2020,11,8,16,1840,1814,1188,-626
2020,11,8,17,1874,1850,1075,-775
2020,11,8,18,1856,1866,1177,-689
2020,11,8,19,1826,1855,1257,-598
2020,11,8,20,1771,1860,1311,-549
2020,11,8,21,1714,1835,1221,-614
2020,11,8,22,1650,1823,1268,-555
2020,11,8,23,1634,1844,1281,-563
2020,11,9,0,1649,1905,1385,-520
2020,11,9,1,1736,2005,1297,-708
2020,11,9,2,1828,2035,1390,-645
2020,11,9,3,1857,1980,1366,-614
2020,11,9,4,1855,1950,1310,-640
2020,11,9,5,1810,1842,1296,-546
2020,11,9,6,1732,1742,1307,-435
2020,11,9,7,1645,1646,1199,-447
2020,11,9,8,1529,1603,1186,-417
2020,11,9,9,1577,1582,1202,-380
2020,11,9,10,1594,1571,1132,-439
2020,11,9,11,1613,1588,1154,-434
2020,11,9,12,1650,1649,1171,-478
2020,11,9,13,1766,1754,1123,-631
2020,11,9,14,1925,1938,1249,-689
2020,11,9,15,2104,2072,1486,-586
2020,11,9,16,2188,2101,1342,-759
2020,11,9,17,2182,2114,1182,-932
2020,11,9,18,2156,2113,1200,-913
2020,11,9,19,2130,2074,1205,-869
2020,11,9,20,2089,2035,1253,-782
2020,11,9,21,2002,1991,1219,-772
2020,11,9,22,1901,1964,1207,-757
2020,11,9,23,1846,1949,1203,-746
2020,11,10,0,1854,2002,1112,-890
2020,11,10,1,1932,2116,1159,-957
2020,11,10,2,2045,2156,1121,-1035
2020,11,10,3,2074,2119,1081,-1038
2020,11,10,4,2079,2063,1082,-981
2020,11,10,5,1983,1969,963,-1006
2020,11,10,6,1867,1846,976,-870
2020,11,10,7,1773,1727,966,-761
2020,11,10,8,1682,1677,954,-723
2020,11,10,9,1687,1640,924,-716
2020,11,10,10,1663,1631,963,-668
2020,11,10,11,1664,1630,983,-647
2020,11,10,12,1702,1679,967,-712
2020,11,10,13,1820,1780,1125,-655
2020,11,10,14,1988,1945,1088,-857
2020,11,10,15,2117,2070,1088,-982
2020,11,10,16,2138,2100,1085,-1015
2020,11,10,17,2117,2101,1115,-986
2020,11,10,18,2071,2060,1093,-967
2020,11,10,19,2005,2028,1148,-880
2020,11,10,20,1931,1968,1142,-826
2020,11,10,21,1877,1912,1121,-791
2020,11,10,22,1820,1906,1110,-796
2020,11,10,23,1790,1904,1090,-814
2020,11,11,0,1818,1945,1044,-901
2020,11,11,1,1922,2062,1103,-959
2020,11,11,2,1993,2092,1086,-1006
2020,11,11,3,2003,2046,1119,-927
2020,11,11,4,1954,1992,1091,-901
2020,11,11,5,1870,1896,1085,-811
2020,11,11,6,1757,1773,1088,-685
2020,11,11,7,1673,1677,1107,-570
2020,11,11,8,1623,1614,1092,-522
2020,11,11,9,1577,1591,1083,-508
2020,11,11,10,1584,1589,1091,-498
2020,11,11,11,1582,1591,1082,-509
2020,11,11,12,1607,1632,1094,-538
2020,11,11,13,1664,1722,1188,-534
2020,11,11,14,1752,1893,1271,-622
2020,11,11,15,1835,2009,1346,-663
2020,11,11,16,1920,2041,1377,-664
2020,11,11,17,1962,2034,1330,-704
2020,11,11,18,1961,1964,1306,-658
2020,11,11,19,1931,1921,1492,-429
2020,11,11,20,1899,1885,1518,-367
2020,11,11,21,1853,1867,1396,-471
2020,11,11,22,1829,1869,1394,-475
2020,11,11,23,1812,1854,1373,-481
2020,11,12,0,1872,1929,1328,-601
2020,11,12,1,1974,2064,1354,-710
2020,11,12,2,2023,2106,1479,-627
2020,11,12,3,2010,2074,1444,-630
2020,11,12,4,1979,2028,1365,-663
2020,11,12,5,1931,1961,1304,-657
2020,11,12,6,1846,1864,1233,-631
2020,11,12,7,1782,1790,1123,-667
2020,11,12,8,1731,1735,1073,-662
2020,11,12,9,1725,1719,1080,-639
2020,11,12,10,1719,1730,1060,-670
2020,11,12,11,1720,1760,1021,-739
2020,11,12,12,1754,1815,1053,-762
2020,11,12,13,1867,1923,1198,-725
2020,11,12,14,2037,2098,1313,-785
2020,11,12,15,2168,2234,1507,-727
2020,11,12,16,2221,2211,1523,-688
2020,11,12,17,2229,2112,1447,-665
2020,11,12,18,2185,2039,1437,-602
2020,11,12,19,2096,1977,1302,-675
2020,11,12,20,2021,1931,1308,-623
2020,11,12,21,1957,1882,1310,-572
2020,11,12,22,1910,1837,1316,-521
2020,11,12,23,1881,1850,1279,-571
2020,11,13,0,1922,1932,1308,-624
2020,11,13,1,2040,2067,1415,-652
2020,11,13,2,2074,2107,1467,-640
2020,11,13,3,2047,2067,1407,-660
2020,11,13,4,1990,2018,1405,-613
2020,11,13,5,1912,1927,1265,-662
2020,11,13,6,1779,1819,1248,-571
2020,11,13,7,1689,1727,1202,-525
2020,11,13,8,1616,1682,1218,-464
2020,11,13,9,1666,1659,1239,-420
2020,11,13,10,1714,1642,1250,-392
2020,11,13,11,1723,1657,1246,-411
2020,11,13,12,1758,1683,1233,-450
2020,11,13,13,1854,1781,1266,-515
2020,11,13,14,1987,1931,1267,-664
2020,11,13,15,2093,2059,1305,-754
2020,11,13,16,2097,2102,1294,-808
2020,11,13,17,2081,2135,1169,-966
2020,11,13,18,2022,2170,1059,-1111
2020,11,13,19,1976,2194,1042,-1152
2020,11,13,20,1955,2177,1090,-1087
2020,11,13,21,1935,2143,1090,-1053
2020,11,13,22,1921,2091,1048,-1043
2020,11,13,23,1928,2043,1024,-1019
2020,11,14,0,1984,2060,1040,-1020
2020,11,14,1,2018,2094,1154,-940
2020,11,14,2,2017,2075,1312,-763
2020,11,14,3,1971,2015,1186,-829
2020,11,14,4,1876,1933,1333,-600
2020,11,14,5,1839,1869,1348,-521
2020,11,14,6,1732,1774,1304,-470
2020,11,14,7,1657,1686,1325,-361
2020,11,14,8,1569,1635,1354,-281
2020,11,14,9,1644,1605,1366,-239
2020,11,14,10,1631,1595,1341,-254
2020,11,14,11,1639,1604,1315,-289
2020,11,14,12,1676,1627,1340,-287
2020,11,14,13,1734,1689,1296,-393
2020,11,14,14,1789,1767,1205,-562
2020,11,14,15,1882,1859,1147,-712
2020,11,14,16,1986,1902,1131,-771
2020,11,14,17,2042,1892,1047,-845
2020,11,14,18,2035,1873,1074,-799
2020,11,14,19,2032,1836,1148,-688
2020,11,14,20,2001,1809,1179,-630
2020,11,14,21,1967,1772,1166,-606
2020,11,14,22,1941,1766,1099,-667
2020,11,14,23,1925,1777,1066,-711
2020,11,15,0,1970,1818,1044,-774
2020,11,15,1,2078,1938,1109,-829
2020,11,15,2,2079,1965,1078,-887
2020,11,15,3,2028,1929,1110,-819
2020,11,15,4,1977,1884,1212,-672
2020,11,15,5,1899,1819,1244,-575
2020,11,15,6,1787,1750,1111,-639
2020,11,15,7,1710,1675,1128,-547
2020,11,15,8,1654,1638,1154,-484
2020,11,15,9,1626,1588,1263,-325
2020,11,15,10,1632,1575,1237,-338
2020,11,15,11,1616,1565,1174,-391
2020,11,15,12,1628,1562,1112,-450
2020,11,15,13,1662,1599,1048,-551
2020,11,15,14,1688,1652,1010,-642
2020,11,15,15,1744,1727,986,-741
2020,11,15,16,1830,1820,932,-888
2020,11,15,17,1903,1864,885,-979
2020,11,15,18,1909,1875,867,-1008
2020,11,15,19,1905,1872,841,-1031
2020,11,15,20,1888,1857,809,-1048
2020,11,15,21,1878,1840,769,-1071
2020,11,15,22,1856,1824,768,-1056
2020,11,15,23,1867,1817,909,-908
2020,11,16,0,1904,1853,975,-878
2020,11,16,1,1998,1941,1076,-865
2020,11,16,2,1996,1958,1092,-866
2020,11,16,3,1946,1910,1415,-495
2020,11,16,4,1875,1851,1408,-443
2020,11,16,5,1824,1757,1094,-663
2020,11,16,6,1700,1651,947,-704
2020,11,16,7,1607,1558,906,-652
2020,11,16,8,1523,1495,884,-611
2020,11,16,9,1524,1471,905,-566
2020,11,16,10,1485,1455,934,-521
2020,11,16,11,1521,1481,982,-499
2020,11,16,12,1555,1520,1022,-498
2020,11,16,13,1653,1600,1057,-543
2020,11,16,14,1779,1762,1127,-635
2020,11,16,15,1909,1887,1201,-686
2020,11,16,16,1998,1914,1297,-617
2020,11,16,17,2013,1888,1306,-582
2020,11,16,18,1987,1853,1298,-555
2020,11,16,19,1958,1806,1316,-490
2020,11,16,20,1931,1746,1294,-452
2020,11,16,21,1903,1743,1275,-468
2020,11,16,22,1865,1737,1360,-377
2020,11,16,23,1855,1722,1316,-406
2020,11,17,0,1880,1766,1368,-398
2020,11,17,1,1959,1879,1383,-496
2020,11,17,2,1997,1916,1409,-507
2020,11,17,3,1965,1874,1430,-444
2020,11,17,4,1917,1828,1451,-377
2020,11,17,5,1842,1752,1441,-311
2020,11,17,6,1731,1652,1455,-197
2020,11,17,7,1655,1564,1364,-200
2020,11,17,8,1642,1504,1379,-125
2020,11,17,9,1603,1483,1390,-93
2020,11,17,10,1566,1473,1389,-84
2020,11,17,11,1582,1483,1384,-99
2020,11,17,12,1620,1532,1363,-169
2020,11,17,13,1711,1633,1468,-165
2020,11,17,14,1860,1808,1489,-319
2020,11,17,15,1980,1932,1397,-535
2020,11,17,16,1988,1670,1059,-611
2020,11,17,17,1987,1989,1397,-592
2020,11,17,18,1952,1898,1373,-525
2020,11,17,19,1914,1885,1342,-543
2020,11,17,20,1869,1849,1383,-466
2020,11,17,21,1858,1836,1380,-456
2020,11,17,22,1831,1817,1337,-480
2020,11,17,23,1826,1802,1377,-425
2020,11,18,0,1846,1835,1440,-395
2020,11,18,1,1930,1914,1389,-525
2020,11,18,2,1952,1921,1328,-593
2020,11,18,3,1916,1872,1213,-659
2020,11,18,4,1850,1804,1096,-708
2020,11,18,5,1757,1712,1266,-446
2020,11,18,6,1639,1592,1343,-249
2020,11,18,7,1557,1491,1317,-174
2020,11,18,8,1552,1432,1243,-189
2020,11,18,9,1507,1393,1220,-173
2020,11,18,10,1498,1385,1027,-358
2020,11,18,11,1514,1379,980,-399
2020,11,18,12,1530,1423,926,-497
2020,11,18,13,1619,1515,904,-611
2020,11,18,14,1777,1663,934,-729
2020,11,18,15,1897,1796,893,-903
2020,11,18,16,1941,1826,903,-923
2020,11,18,17,1976,1855,938,-917
2020,11,18,18,1964,1852,902,-950
2020,11,18,19,1952,1814,908,-906
2020,11,18,20,1933,1769,926,-843
2020,11,18,21,1935,1749,961,-788
2020,11,18,22,1908,1731,932,-799
2020,11,18,23,1884,1743,850,-893
2020,11,19,0,1902,1814,917,-897
2020,11,19,1,1994,1892,949,-943
2020,11,19,2,2020,1928,942,-986
2020,11,19,3,1985,1881,1156,-725
2020,11,19,4,1918,1822,1263,-559
2020,11,19,5,1834,1740,1165,-575
2020,11,19,6,1715,1648,1133,-515
2020,11,19,7,1649,1557,1100,-457
2020,11,19,8,1606,1494,998,-496
2020,11,19,9,1573,1472,940,-532
2020,11,19,10,1537,1457,909,-548
2020,11,19,11,1564,1457,856,-601
2020,11,19,12,1604,1521,853,-668
2020,11,19,13,1708,1609,912,-697
2020,11,19,14,1868,1775,1034,-741
2020,11,19,15,1987,1918,1180,-738
2020,11,19,16,2044,1943,1160,-783
2020,11,19,17,2071,1897,1165,-732
2020,11,19,18,2056,1861,1147,-714
2020,11,19,19,2018,1817,1196,-621
2020,11,19,20,1973,1798,1303,-495
2020,11,19,21,1945,1773,1317,-456
2020,11,19,22,1924,1750,1332,-418
2020,11,19,23,1934,1759,1313,-446
2020,11,20,0,1927,1803,1243,-560
2020,11,20,1,2008,1940,1198,-742
2020,11,20,2,2041,2015,1159,-856
2020,11,20,3,2011,1993,1142,-851
2020,11,20,4,1974,1939,1085,-854
2020,11,20,5,1893,1880,1075,-805
2020,11,20,6,1775,1783,1069,-714
2020,11,20,7,1720,1702,1028,-674
2020,11,20,8,1690,1652,1008,-644
2020,11,20,9,1654,1631,957,-674
2020,11,20,10,1629,1640,946,-694
2020,11,20,11,1640,1661,930,-731
2020,11,20,12,1699,1712,950,-762
2020,11,20,13,1797,1820,986,-834
2020,11,20,14,1974,1983,1253,-730
2020,11,20,15,2105,2114,1260,-854
2020,11,20,16,2177,2127,1260,-867
2020,11,20,17,2173,2044,1303,-741
2020,11,20,18,2112,1981,1218,-763
2020,11,20,19,2067,1911,1166,-745
2020,11,20,20,2038,1846,1181,-665
2020,11,20,21,2004,1783,1219,-564
2020,11,20,22,1967,1734,1241,-493
2020,11,20,23,1966,1731,1234,-497
2020,11,21,0,1967,1786,1143,-643
2020,11,21,1,2015,1945,1126,-819
2020,11,21,2,2048,2005,1116,-889
2020,11,21,3,2020,1995,1086,-909
2020,11,21,4,1978,1958,1092,-866
2020,11,21,5,1927,1925,1033,-892
2020,11,21,6,1841,1837,1006,-831
2020,11,21,7,1785,1788,1019,-769
2020,11,21,8,1747,1737,976,-761
2020,11,21,9,1703,1712,975,-737
2020,11,21,10,1678,1717,958,-759
2020,11,21,11,1676,1724,955,-769
2020,11,21,12,1705,1774,1001,-773
2020,11,21,13,1752,1834,1043,-791
2020,11,21,14,1832,1925,1084,-841
2020,11,21,15,1913,2033,1115,-918
2020,11,21,16,2002,2084,1145,-939
2020,11,21,17,2020,2049,1181,-868
2020,11,21,18,1995,2000,1149,-851
2020,11,21,19,1963,1920,1133,-787
2020,11,21,20,1919,1846,1134,-712
2020,11,21,21,1871,1771,1139,-632
2020,11,21,22,1858,1738,1131,-607
2020,11,21,23,1846,1725,1115,-610
2020,11,22,0,1874,1814,1058,-756
2020,11,22,1,2002,1975,1043,-932
2020,11,22,2,2052,2052,1067,-985
2020,11,22,3,2026,2033,1060,-973
2020,11,22,4,1987,2001,1063,-938
2020,11,22,5,1926,1943,1083,-860
2020,11,22,6,1844,1879,1014,-865
2020,11,22,7,1796,1815,1038,-777
2020,11,22,8,1741,1766,1016,-750
2020,11,22,9,1712,1734,1089,-645
2020,11,22,10,1701,1710,1100,-610
2020,11,22,11,1713,1725,1167,-558
2020,11,22,12,1738,1778,1206,-572
2020,11,22,13,1770,1825,1219,-606
2020,11,22,14,1842,1894,1309,-585
2020,11,22,15,1918,1987,1287,-700
2020,11,22,16,2030,2029,1311,-718
2020,11,22,17,2048,1995,1318,-677
2020,11,22,18,2018,1939,1345,-594
2020,11,22,19,1952,1898,1392,-506
2020,11,22,20,1890,1844,1363,-481
2020,11,22,21,1831,1783,1293,-490
2020,11,22,22,1801,1754,1342,-412
2020,11,22,23,1784,1758,1267,-491
2020,11,23,0,1834,1848,1216,-632
2020,11,23,1,1974,2013,1281,-732
2020,11,23,2,2040,2064,1211,-853
2020,11,23,3,2002,2060,1225,-835
2020,11,23,4,1956,2012,1172,-840
2020,11,23,5,1896,1952,1061,-891
2020,11,23,6,1807,1873,1060,-813
2020,11,23,7,1723,1787,956,-831
2020,11,23,8,1649,1734,900,-834
2020,11,23,9,1673,1711,860,-851
2020,11,23,10,1725,1694,875,-819
2020,11,23,11,1758,1708,861,-847
2020,11,23,12,1806,1749,892,-857
2020,11,23,13,1910,1851,1048,-803
2020,11,23,14,2054,1996,1120,-876
2020,11,23,15,2195,2133,1133,-1000
2020,11,23,16,2252,2167,1206,-961
2020,11,23,17,2216,2160,1232,-928
2020,11,23,18,2140,2138,1098,-1040
2020,11,23,19,2071,2093,1128,-965
2020,11,23,20,2013,2030,1127,-903
2020,11,23,21,1956,1970,1161,-809
2020,11,23,22,1946,1934,1198,-736
2020,11,23,23,1930,1908,1217,-691
2020,11,24,0,1990,1958,1278,-680
2020,11,24,1,2112,2099,1332,-767
2020,11,24,2,2173,2134,1317,-817
2020,11,24,3,2152,2092,1324,-768
2020,11,24,4,2109,2050,1283,-767
2020,11,24,5,2032,1945,1222,-723
2020,11,24,6,1921,1840,1202,-638
2020,11,24,7,1843,1739,1113,-626
2020,11,24,8,1757,1689,1035,-654
2020,11,24,9,1758,1670,954,-716
2020,11,24,10,1685,1675,936,-739
2020,11,24,11,1704,1679,943,-736
2020,11,24,12,1758,1732,972,-760
2020,11,24,13,1866,1825,960,-865
2020,11,24,14,2036,1960,1126,-834
2020,11,24,15,2166,2096,1234,-862
2020,11,24,16,2184,2138,1294,-844
2020,11,24,17,2166,2108,1252,-856
2020,11,24,18,2107,2033,1206,-827
2020,11,24,19,2045,1956,1186,-770
2020,11,24,20,1985,1888,1175,-713
2020,11,24,21,1925,1840,1199,-641
2020,11,24,22,1889,1804,1238,-566
2020,11,24,23,1891,1783,1233,-550
2020,11,25,0,1928,1848,1148,-700
2020,11,25,1,2065,1988,1197,-791
2020,11,25,2,2147,2053,1272,-781
2020,11,25,3,2133,2031,1350,-681
2020,11,25,4,2101,2005,1455,-550
2020,11,25,5,2004,1929,1431,-498
2020,11,25,6,1889,1816,1369,-447
2020,11,25,7,1799,1715,1397,-318
2020,11,25,8,1783,1646,1376,-270
2020,11,25,9,1700,1624,1247,-377
2020,11,25,10,1623,1615,1177,-438
2020,11,25,11,1636,1616,1130,-486
2020,11,25,12,1676,1636,1134,-502
2020,11,25,13,1772,1728,1172,-556
2020,11,25,14,1929,1850,1195,-655
2020,11,25,15,2054,1981,1184,-797
2020,11,25,16,2079,2045,1143,-902
2020,11,25,17,2083,2080,1088,-992
2020,11,25,18,2033,2079,1155,-924
2020,11,25,19,1980,2024,1258,-766
2020,11,25,20,1929,1937,1232,-705
2020,11,25,21,1909,1932,1344,-588
2020,11,25,22,1884,1912,1320,-592
2020,11,25,23,1868,1897,1312,-585
2020,11,26,0,1938,1914,1245,-669
2020,11,26,1,2045,2025,1317,-708
2020,11,26,2,2107,2051,1291,-760
2020,11,26,3,2093,2010,1294,-716
2020,11,26,4,2055,1968,1400,-568
2020,11,26,5,1969,1895,1375,-520
2020,11,26,6,1850,1810,1360,-450
2020,11,26,7,1765,1713,1282,-431
2020,11,26,8,1750,1750,1282,-9999
2020,11,26,9,1698,1698,1247,-9999
2020,11,26,10,1632,1632,1177,-9999
2020,11,26,11,1634,1634,1130,-9999
2020,11,26,12,1666,1666,1134,-9999
2020,11,26,13,1718,1718,1172,-9999
2020,11,26,14,1786,1786,1195,-9999
2020,11,26,15,1869,1869,1184,-9999
2020,11,26,16,1977,1977,1143,-9999
2020,11,26,17,2039,2039,1088,-9999
2020,11,26,18,2030,2030,1155,-9999
2020,11,26,19,1977,1977,1258,-9999
2020,11,26,20,1908,1908,1232,-9999
2020,11,26,21,1870,1870,1344,-9999
2020,11,26,22,1861,1861,1320,-9999
2020,11,26,23,1830,1830,1312,-9999
2020,11,27,0,1886,1886,1245,-9999
2020,11,27,1,1992,1992,1317,-9999
2020,11,27,2,2042,2042,1291,-9999
2020,11,27,3,2021,2021,1294,-9999
2020,11,27,4,1992,1992,1400,-9999
2020,11,27,5,1938,1938,1375,-9999
2020,11,27,6,1867,1867,1360,-9999
2020,11,27,7,1799,1799,1282,-9999
2020,11,27,8,1768,1768,-9999,-9999
2020,11,27,9,1664,1615,875,-740
2020,11,27,10,1582,1631,855,-776
2020,11,27,11,1578,1649,851,-798
2020,11,27,12,1604,1688,879,-809
2020,11,27,13,1635,1767,958,-809
2020,11,27,14,1683,1869,1105,-764
2020,11,27,15,1752,1956,1146,-810
2020,11,27,16,1879,2010,1216,-794
2020,11,27,17,1945,1983,1309,-674
2020,11,27,18,1943,1919,1282,-637
2020,11,27,19,1914,1867,1188,-679
2020,11,27,20,1856,1792,1045,-747
2020,11,27,21,1802,1738,1026,-712
2020,11,27,22,1777,1685,1047,-638
2020,11,27,23,1745,1690,1009,-681
2020,11,28,0,1756,1739,975,-764
2020,11,28,1,1836,1904,1044,-860
2020,11,28,2,1879,1966,1118,-848
2020,11,28,3,1871,1967,1138,-829
2020,11,28,4,1858,1949,1098,-851
2020,11,28,5,1836,1900,1099,-801
2020,11,28,6,1783,1833,1144,-689
2020,11,28,7,1722,1756,1234,-522
2020,11,28,8,1719,1714,1203,-511
2020,11,28,9,1629,1687,1203,-484
2020,11,28,10,1649,1692,1222,-470
2020,11,28,11,1659,1700,1197,-503
2020,11,28,12,1703,1743,1139,-604
2020,11,28,13,1763,1797,1123,-674
2020,11,28,14,1782,1884,1245,-639
2020,11,28,15,1850,1978,1260,-718
2020,11,28,16,1972,2034,1300,-734
2020,11,28,17,2000,2016,1333,-683
2020,11,28,18,1982,1969,1284,-685
2020,11,28,19,1944,1906,1230,-676
2020,11,28,20,1849,1849,1156,-693
2020,11,28,21,1772,1787,1105,-682
2020,11,28,22,1760,1746,1094,-652
2020,11,28,23,1752,1739,1078,-661
2020,11,29,0,1760,1828,1080,-748
2020,11,29,1,1902,1987,1156,-831
2020,11,29,2,1991,2040,1139,-901
2020,11,29,3,1962,2018,1078,-940
2020,11,29,4,1954,2000,1174,-826
2020,11,29,5,1909,1948,1272,-676
2020,11,29,6,1842,1879,1056,-823
2020,11,29,7,1799,1827,1019,-808
2020,11,29,8,1662,1772,890,-882
2020,11,29,9,1651,1758,926,-832
2020,11,29,10,1725,1745,930,-815
2020,11,29,11,1733,1772,947,-825
2020,11,29,12,1788,1794,992,-802
2020,11,29,13,1815,1854,1139,-715
2020,11,29,14,1850,1933,1173,-760
2020,11,29,15,1927,2023,1199,-824
2020,11,29,16,2022,2099,1199,-900
2020,11,29,17,2028,2077,1327,-750
2020,11,29,18,2001,2029,1344,-685
2020,11,29,19,1980,1951,1224,-727
2020,11,29,20,1916,1896,1260,-636
2020,11,29,21,1836,1839,1247,-592
2020,11,29,22,1805,1801,1222,-579
2020,11,29,23,1806,1780,1176,-604
2020,11,30,0,1844,1872,1116,-756
2020,11,30,1,1960,2067,1118,-949
2020,11,30,2,2043,2128,1104,-1024
2020,11,30,3,2028,2116,1249,-867
2020,11,30,4,2017,2095,1252,-843
2020,11,30,5,1975,2016,1331,-685
2020,11,30,6,1885,1917,1290,-627
2020,11,30,7,1812,1817,1225,-592
2020,11,30,8,1627,1787,1158,-629
2020,11,30,9,1666,1765,1133,-632
2020,11,30,10,1727,1780,1178,-602
2020,11,30,11,1782,1807,1215,-592
2020,11,30,12,1823,1861,1246,-615
2020,11,30,13,1932,1976,1275,-701
2020,11,30,14,2073,2150,1355,-795
2020,11,30,15,2221,2290,1482,-808
2020,11,30,16,2270,2324,1656,-668
2020,11,30,17,2237,2272,1602,-670
2020,11,30,18,2166,2198,1540,-658
2020,11,30,19,2086,2168,1420,-748
2020,11,30,20,2016,2126,1279,-847
2020,11,30,21,1978,2079,1164,-915
2020,11,30,22,1951,2053,1107,-946
2020,11,30,23,1944,2039,1224,-815
2020,12,1,0,2014,2070,1448,-622
2020,12,1,1,2150,2196,1633,-563
2020,12,1,2,2213,2246,1659,-587
2020,12,1,3,2178,2207,1675,-532
2020,12,1,4,2164,2164,1620,-544
2020,12,1,5,2052,2067,1534,-533
2020,12,1,6,1921,1948,1463,-485
2020,12,1,7,1860,1850,1375,-475
2020,12,1,8,1707,1789,1311,-478
2020,12,1,9,1720,1783,1201,-582
2020,12,1,10,1749,1785,1175,-610
2020,12,1,11,1774,1810,1225,-585
2020,12,1,12,1819,1872,1267,-605
2020,12,1,13,1965,1978,1320,-658
2020,12,1,14,2113,2145,1481,-664
2020,12,1,15,2240,2289,1628,-661
2020,12,1,16,2300,2313,1572,-741
2020,12,1,17,2270,2251,1349,-902
2020,12,1,18,2212,2184,1345,-839
2020,12,1,19,2174,2099,1342,-757
2020,12,1,20,2115,2412,1691,-721
2020,12,1,21,2025,1957,1224,-733
2020,12,1,22,1967,1894,1262,-632
2020,12,1,23,1954,1892,1182,-710
2020,12,2,0,2191,1954,1157,-797
2020,12,2,1,2308,2135,1269,-866
2020,12,2,2,2374,2199,1340,-859
2020,12,2,3,2309,2193,1319,-874
2020,12,2,4,2253,2151,1273,-878
2020,12,2,5,2170,2082,1245,-837
2020,12,2,6,2044,1969,1205,-764
2020,12,2,7,1932,1869,1191,-678
2020,12,2,8,1790,1815,1172,-643
2020,12,2,9,1795,1796,1164,-632
2020,12,2,10,1787,1814,1234,-580
2020,12,2,11,1805,1819,1201,-618
2020,12,2,12,1853,1884,1232,-652
2020,12,2,13,1956,2001,1247,-754
2020,12,2,14,2124,2176,1387,-789
2020,12,2,15,2261,2330,1528,-802
2020,12,2,16,2311,2347,1460,-887
2020,12,2,17,2285,2295,1354,-941
2020,12,2,18,2224,2197,1368,-829
2020,12,2,19,2156,2117,1412,-705
2020,12,2,20,2103,2035,1411,-624
2020,12,2,21,2038,1988,1517,-471
2020,12,2,22,2106,1924,1486,-438
2020,12,2,23,1978,1914,1483,-431
2020,12,3,0,2012,1966,1418,-548
2020,12,3,1,2146,2138,1467,-671
2020,12,3,2,2238,2205,1494,-711
2020,12,3,3,2209,2189,1439,-750
2020,12,3,4,2169,2174,1449,-725
2020,12,3,5,2091,2096,1360,-736
2020,12,3,6,1975,1985,1249,-736
2020,12,3,7,1882,1888,1245,-643
2020,12,3,8,1833,1833,1259,-574
2020,12,3,9,1823,1817,1269,-548
2020,12,3,10,1851,1834,1285,-549
2020,12,3,11,1869,1847,1285,-562
2020,12,3,12,1922,1913,1279,-634
2020,12,3,13,2038,2021,1253,-768
2020,12,3,14,2220,2211,1411,-800
2020,12,3,15,2364,2360,1422,-938
2020,12,3,16,2422,2383,1433,-950
2020,12,3,17,2384,2298,1492,-806
2020,12,3,18,2295,2268,1464,-804
2020,12,3,19,2220,2109,1412,-697
2020,12,3,20,2150,2024,1341,-683
2020,12,3,21,2064,1969,1311,-658
2020,12,3,22,2077,1915,1317,-598
2020,12,3,23,1987,1905,1283,-622
2020,12,4,0,2029,1969,1250,-719
2020,12,4,1,2174,2153,1335,-818
2020,12,4,2,2259,2216,1350,-866
2020,12,4,3,2239,2209,1339,-870
2020,12,4,4,2193,2178,1349,-829
2020,12,4,5,2126,2110,1317,-793
2020,12,4,6,2008,2002,1261,-741
2020,12,4,7,1919,1912,1247,-665
2020,12,4,8,1844,1870,1203,-667
2020,12,4,9,1836,1853,1150,-703
2020,12,4,10,1864,1862,1131,-731
2020,12,4,11,1882,1891,1183,-708
2020,12,4,12,1929,1941,1144,-797
2020,12,4,13,2045,2058,1321,-737
2020,12,4,14,2223,2223,1341,-882
2020,12,4,15,2364,2365,1376,-989
2020,12,4,16,2412,2396,1504,-892
2020,12,4,17,2361,2324,1297,-1027
2020,12,4,18,2274,2227,1203,-1024
2020,12,4,19,2197,2134,1160,-974
2020,12,4,20,2134,2051,1097,-954
2020,12,4,21,2068,1975,1091,-884
2020,12,4,22,2056,1935,1246,-689
2020,12,4,23,1993,1916,1223,-693
2020,12,5,0,2049,1981,1185,-796
2020,12,5,1,2133,2138,1240,-898
2020,12,5,2,2196,2199,1245,-954
2020,12,5,3,2175,2182,1305,-877
2020,12,5,4,2126,2161,1429,-732
2020,12,5,5,2091,2115,1476,-639
2020,12,5,6,2012,2027,1311,-716
2020,12,5,7,1935,1940,1165,-775
2020,12,5,8,1856,1886,981,-905
2020,12,5,9,1870,1873,979,-894
2020,12,5,10,1874,1868,955,-913
2020,12,5,11,1884,1878,963,-915
2020,12,5,12,1922,1914,993,-921
2020,12,5,13,1985,1982,1116,-866
2020,12,5,14,2083,2081,1199,-882
2020,12,5,15,2178,2190,1144,-1046
2020,12,5,16,2250,2250,1156,-1094
2020,12,5,17,2212,2221,1238,-983
2020,12,5,18,2126,2158,1215,-943
2020,12,5,19,2042,2062,1162,-900
2020,12,5,20,1957,1976,1108,-868
2020,12,5,21,1872,1893,1130,-763
2020,12,5,22,1853,1833,1167,-666
2020,12,5,23,1823,1831,1160,-671
2020,12,6,0,1898,1893,1113,-780
2020,12,6,1,2063,2077,1140,-937
2020,12,6,2,2128,2145,1249,-896
2020,12,6,3,2101,2131,1356,-775
2020,12,6,4,2079,2101,1440,-661
2020,12,6,5,2038,2069,1442,-627
2020,12,6,6,1968,1970,1426,-544
2020,12,6,7,1918,1897,1303,-594
2020,12,6,8,1873,1857,1272,-585
2020,12,6,9,1866,1824,1323,-501
2020,12,6,10,1838,1810,1334,-476
2020,12,6,11,1851,1825,1347,-478
2020,12,6,12,1891,1848,1248,-600
2020,12,6,13,1931,1893,1169,-724
2020,12,6,14,2003,1967,1186,-781
2020,12,6,15,2084,2060,1191,-869
2020,12,6,16,2180,2126,1207,-919
2020,12,6,17,2171,2147,1076,-1071
2020,12,6,18,2094,2117,1017,-1100
2020,12,6,19,2017,2067,1056,-1011
2020,12,6,20,1954,2008,1078,-930
2020,12,6,21,1889,1927,1076,-851
2020,12,6,22,1864,1879,1237,-642
2020,12,6,23,1853,1861,1178,-683
2020,12,7,0,1938,1935,1094,-841
2020,12,7,1,2106,2107,1205,-902
2020,12,7,2,2180,2166,1275,-891
2020,12,7,3,2155,2157,1275,-882
2020,12,7,4,2121,2141,1222,-919
2020,12,7,5,2066,2071,1178,-893
2020,12,7,6,1965,1956,1130,-826
2020,12,7,7,1868,1871,1031,-840
2020,12,7,8,1830,1813,999,-814
2020,12,7,9,1841,1807,1016,-791
2020,12,7,10,1854,1815,1012,-803
2020,12,7,11,1876,1844,1047,-797
2020,12,7,12,1942,1906,1089,-817
2020,12,7,13,2058,2029,1215,-814
2020,12,7,14,2239,2216,1265,-951
2020,12,7,15,2402,2378,1482,-896
2020,12,7,16,2449,2407,1587,-820
2020,12,7,17,2425,2324,1664,-660
2020,12,7,18,2343,2229,1617,-612
2020,12,7,19,2252,2123,1343,-780
2020,12,7,20,2166,2040,1213,-827
2020,12,7,21,2074,1972,1160,-812
2020,12,7,22,2033,1920,1207,-713
2020,12,7,23,1980,1909,1257,-652
2020,12,8,0,2018,1973,1254,-719
2020,12,8,1,2182,2174,1331,-843
2020,12,8,2,2283,2238,1461,-777
2020,12,8,3,2262,2230,1494,-736
2020,12,8,4,2227,2193,1489,-704
2020,12,8,5,2151,2109,1345,-764
2020,12,8,6,2034,2006,1205,-801
2020,12,8,7,1944,1899,1107,-792
2020,12,8,8,1882,1847,1072,-775
2020,12,8,9,1883,1847,974,-873
2020,12,8,10,1874,1849,960,-889
2020,12,8,11,1885,1867,978,-889
2020,12,8,12,1941,1924,1161,-763
2020,12,8,13,2060,2043,1279,-764
2020,12,8,14,2238,2233,1351,-882
2020,12,8,15,2391,2371,1498,-873
2020,12,8,16,2449,2391,1510,-881
2020,12,8,17,2398,2294,1516,-778
2020,12,8,18,2323,2201,1484,-717
2020,12,8,19,2231,2108,1286,-822
2020,12,8,20,2108,2022,1179,-843
2020,12,8,21,2024,1954,1141,-813
2020,12,8,22,1972,1913,1189,-724
2020,12,8,23,1938,1899,1192,-707
2020,12,9,0,1979,1957,1110,-847
2020,12,9,1,2150,2151,1282,-869
2020,12,9,2,2232,2222,1362,-860
2020,12,9,3,2214,2217,1385,-832
2020,12,9,4,2180,2179,1447,-732
2020,12,9,5,2108,2099,1452,-647
2020,12,9,6,2007,1978,1365,-613
2020,12,9,7,1925,1886,1321,-565
2020,12,9,8,1886,1829,1172,-657
2020,12,9,9,1894,1818,1197,-621
2020,12,9,10,1895,1828,1259,-569
2020,12,9,11,1908,1850,1332,-518
2020,12,9,12,1966,1918,1354,-564
2020,12,9,13,2088,2038,1361,-677
2020,12,9,14,2255,2205,1417,-788
2020,12,9,15,2392,2365,1507,-858
2020,12,9,16,2428,2360,1486,-874
2020,12,9,17,2370,2309,1563,-746
2020,12,9,18,2290,2198,1412,-786
2020,12,9,19,2178,2113,1214,-899
2020,12,9,20,2072,2047,1291,-756
2020,12,9,21,2014,2003,1175,-828
2020,12,9,22,1984,1982,1273,-709
2020,12,9,23,1969,1985,1409,-576
2020,12,10,0,2019,2061,1600,-461
2020,12,10,1,2197,2213,1718,-495
2020,12,10,2,2260,2238,1736,-502
2020,12,10,3,2241,2215,1615,-600
2020,12,10,4,2204,2180,1611,-569
2020,12,10,5,2139,2095,1499,-596
2020,12,10,6,2030,1972,1318,-654
2020,12,10,7,1942,1858,1236,-622
2020,12,10,8,1897,1811,1182,-629
2020,12,10,9,1870,1791,1121,-670
2020,12,10,10,1882,1778,1077,-701
2020,12,10,11,1889,1809,1053,-756
2020,12,10,12,1931,1866,1208,-658
2020,12,10,13,2034,1982,1213,-769
2020,12,10,14,2210,2163,1336,-827
2020,12,10,15,2357,2311,1333,-978
2020,12,10,16,2388,2352,1358,-994
2020,12,10,17,2333,2288,1461,-827
2020,12,10,18,2267,2203,1530,-673
2020,12,10,19,2207,2119,1392,-727
2020,12,10,20,2132,2033,1298,-735
2020,12,10,21,2089,1972,1304,-668
2020,12,10,22,2067,1939,1327,-612
2020,12,10,23,2053,1923,1309,-614
2020,12,11,0,2090,2006,1274,-732
2020,12,11,1,2256,2162,1413,-749
2020,12,11,2,2317,2238,1460,-778
2020,12,11,3,2302,2233,1441,-792
2020,12,11,4,2277,2199,1397,-802
2020,12,11,5,2215,2134,1415,-719
2020,12,11,6,2087,2001,1364,-637
2020,12,11,7,1993,1918,1143,-775
2020,12,11,8,1916,1862,1083,-779
2020,12,11,9,1933,1842,1134,-708
2020,12,11,10,1910,1831,1112,-719
2020,12,11,11,1917,1856,1128,-728
2020,12,11,12,1977,1900,1335,-565
2020,12,11,13,2088,1999,1416,-583
2020,12,11,14,2266,2139,1428,-711
2020,12,11,15,2401,2283,1479,-804
2020,12,11,16,2420,2324,1516,-808
2020,12,11,17,2363,2315,1547,-768
2020,12,11,18,2285,2252,1541,-711
2020,12,11,19,2220,2191,1532,-659
2020,12,11,20,2139,2117,1490,-627
2020,12,11,21,2085,2074,1418,-656
2020,12,11,22,2051,2060,1456,-604
2020,12,11,23,2039,2043,1404,-639
2020,12,12,0,2102,2084,1455,-629
2020,12,12,1,2145,2207,1448,-759
2020,12,12,2,2185,2254,1442,-812
2020,12,12,3,2186,2221,1381,-840
2020,12,12,4,2157,2194,1420,-774
2020,12,12,5,2128,2132,1353,-779
2020,12,12,6,2036,2043,1190,-853
2020,12,12,7,1942,1946,1106,-840
2020,12,12,8,1893,1899,1050,-849
2020,12,12,9,1886,1874,1050,-824
2020,12,12,10,1897,1867,1022,-845
2020,12,12,11,1909,1887,1030,-857
2020,12,12,12,1948,1930,1135,-795
2020,12,12,13,2006,1999,1225,-774
2020,12,12,14,2100,2094,1239,-855
2020,12,12,15,2207,2199,1323,-876
2020,12,12,16,2307,2270,1403,-867
2020,12,12,17,2302,2258,1495,-763
2020,12,12,18,2238,2198,1439,-759
2020,12,12,19,2170,2108,1435,-673
2020,12,12,20,2099,2038,1363,-675
2020,12,12,21,2031,1963,1380,-583
2020,12,12,22,2001,1910,1501,-409
2020,12,12,23,2001,1909,1575,-334
2020,12,13,0,2073,1994,1539,-455
2020,12,13,1,2239,2158,1646,-512
2020,12,13,2,2309,2222,1500,-722
2020,12,13,3,2271,2214,1522,-692
2020,12,13,4,2236,2200,1569,-631
2020,12,13,5,2186,2148,1550,-598
2020,12,13,6,2095,2067,1259,-808
2020,12,13,7,2021,1984,1212,-772
2020,12,13,8,1971,1927,1169,-758
2020,12,13,9,1966,1904,1270,-634
2020,12,13,10,1932,1876,1332,-544
2020,12,13,11,1948,1884,1455,-429
2020,12,13,12,1970,1889,1483,-406
2020,12,13,13,2003,1950,1537,-413
2020,12,13,14,2060,2017,1792,-225
2020,12,13,15,2128,2088,1747,-341
2020,12,13,16,2198,2177,1759,-418
2020,12,13,17,2222,2250,1823,-427
2020,12,13,18,2156,2224,1876,-348
2020,12,13,19,2090,2215,1880,-335
2020,12,13,20,2028,2186,1684,-502
2020,12,13,21,1963,2302,1618,-684
2020,12,13,22,1946,2188,1675,-513
2020,12,13,23,1964,2191,1595,-596
2020,12,14,0,2044,2225,1598,-627
2020,12,14,1,2209,2328,1705,-623
2020,12,14,2,2255,2338,1707,-631
2020,12,14,3,2209,2288,1647,-641
2020,12,14,4,2182,2229,1552,-677
2020,12,14,5,2108,2127,1454,-673
2020,12,14,6,1987,2005,1386,-619
2020,12,14,7,1886,1878,1219,-659
2020,12,14,8,1828,1806,1126,-680
2020,12,14,9,1850,1770,1119,-651
2020,12,14,10,1879,1780,1090,-690
2020,12,14,11,1916,1786,1135,-651
2020,12,14,12,1970,1837,1156,-681
2020,12,14,13,2088,1944,1310,-634
2020,12,14,14,2279,2118,1462,-656
2020,12,14,15,2438,2252,1633,-619
2020,12,14,16,2509,2294,1667,-627
2020,12,14,17,2484,2282,1546,-736
2020,12,14,18,2431,2232,1375,-857
2020,12,14,19,2371,2169,1341,-828
2020,12,14,20,2299,2128,1368,-760
2020,12,14,21,2305,2094,1341,-753
2020,12,14,22,2235,2091,1358,-733
2020,12,14,23,2207,2109,1439,-670
2020,12,15,0,2229,2171,1399,-772
2020,12,15,1,2369,2330,1669,-661
2020,12,15,2,2414,2357,1728,-629
2020,12,15,3,2406,2324,1657,-667
2020,12,15,4,2369,2279,1610,-669
2020,12,15,5,2286,2184,1455,-729
2020,12,15,6,2152,2062,1298,-764
2020,12,15,7,2047,1934,1097,-837
2020,12,15,8,1964,1872,1097,-775
2020,12,15,9,1960,1833,1064,-769
2020,12,15,10,1910,1821,1072,-749
2020,12,15,11,1918,1846,1112,-734
2020,12,15,12,1957,1895,1156,-739
2020,12,15,13,2068,2002,1198,-804
2020,12,15,14,2249,2188,1365,-823
2020,12,15,15,2384,2325,1394,-931
2020,12,15,16,2422,2363,1418,-945
2020,12,15,17,2405,2331,1355,-976
2020,12,15,18,2326,2296,1312,-984
2020,12,15,19,2246,2229,1258,-971
2020,12,15,20,2161,2198,1208,-990
2020,12,15,21,2109,2183,1218,-965
2020,12,15,22,2088,2172,1167,-1005
2020,12,15,23,2093,2178,1146,-1032
2020,12,16,0,2151,2225,1222,-1003
2020,12,16,1,2300,2338,1368,-970
2020,12,16,2,2344,2340,1332,-1008
2020,12,16,3,2314,2299,1297,-1002
2020,12,16,4,2278,2222,1282,-940
2020,12,16,5,2191,2123,1244,-879
2020,12,16,6,2057,1984,1176,-808
2020,12,16,7,1963,1856,1074,-782
2020,12,16,8,1892,1780,1011,-769
2020,12,16,9,1850,1735,1078,-657
2020,12,16,10,1812,1725,1138,-587
2020,12,16,11,1830,1726,1183,-543
2020,12,16,12,1868,1766,1166,-600
2020,12,16,13,1977,1868,1346,-522
2020,12,16,14,2139,2051,1508,-543
2020,12,16,15,2269,2182,1694,-488
2020,12,16,16,2309,2234,1699,-535
2020,12,16,17,2310,2212,1497,-715
2020,12,16,18,2268,2212,1497,-715
2020,12,16,19,2202,2154,1315,-839
2020,12,16,20,2137,2126,1251,-875
2020,12,16,21,2112,2094,1205,-889
2020,12,16,22,2101,2073,1202,-871
2020,12,16,23,2100,2072,1197,-875
2020,12,17,0,2144,2136,1417,-719
2020,12,17,1,2263,2252,1518,-734
2020,12,17,2,2300,2247,1687,-560
2020,12,17,3,2268,2196,1751,-445
2020,12,17,4,2222,2146,1767,-379
2020,12,17,5,2136,2052,1738,-314
2020,12,17,6,2000,1906,1485,-421
2020,12,17,7,1900,1788,1414,-374
2020,12,17,8,1845,1716,1455,-261
2020,12,17,9,1766,1672,1412,-260
2020,12,17,10,1729,1652,1392,-260
2020,12,17,11,1741,1648,1317,-331
2020,12,17,12,1789,1681,1252,-429
2020,12,17,13,1898,1786,1265,-521
2020,12,17,14,2071,1945,1316,-629
2020,12,17,15,2204,2103,1391,-712
2020,12,17,16,2247,2147,1386,-761
2020,12,17,17,2250,2150,1296,-854
2020,12,17,18,2241,2152,1309,-843
2020,12,17,19,2207,2121,1243,-878
2020,12,17,20,2161,2067,1136,-931
2020,12,17,21,2141,2018,1202,-816
2020,12,17,22,2130,1979,1305,-674
2020,12,17,23,2145,1956,1526,-430
2020,12,18,0,2179,2003,1562,-441
2020,12,18,1,2287,2154,1678,-476
2020,12,18,2,2313,2177,1648,-529
2020,12,18,3,2282,2145,1647,-498
2020,12,18,4,2250,2101,1557,-544
2020,12,18,5,2173,2011,1526,-485
2020,12,18,6,2050,1892,1399,-493
2020,12,18,7,1950,1779,1375,-404
2020,12,18,8,1890,1711,1314,-397
2020,12,18,9,1819,1673,1245,-428
2020,12,18,10,1753,1665,1204,-461
2020,12,18,11,1748,1673,1158,-515
2020,12,18,12,1795,1725,1252,-473
2020,12,18,13,1914,1837,1472,-365
2020,12,18,14,2095,1986,1584,-402
2020,12,18,15,2244,2144,1641,-503
2020,12,18,16,2300,2192,1634,-558
2020,12,18,17,2303,2149,1348,-801
2020,12,18,18,2291,2105,1255,-850
2020,12,18,19,2246,2040,1239,-801
2020,12,18,20,2196,1982,1294,-688
2020,12,18,21,2127,1934,1262,-672
2020,12,18,22,2092,1927,1189,-738
2020,12,18,23,2086,1942,1114,-828
2020,12,19,0,2133,1994,1154,-840
2020,12,19,1,2158,2127,1361,-766
2020,12,19,2,2174,2136,1369,-767
2020,12,19,3,2167,2121,1325,-796
2020,12,19,4,2140,2092,1382,-710
2020,12,19,5,2082,2017,1334,-683
2020,12,19,6,1986,1941,1288,-653
2020,12,19,7,1885,1827,1152,-675
2020,12,19,8,1847,1768,1106,-662
2020,12,19,9,1769,1740,1176,-564
2020,12,19,10,1771,1715,1123,-592
2020,12,19,11,1762,1718,1112,-606
2020,12,19,12,1787,1744,1086,-658
2020,12,19,13,1844,1805,1121,-684
2020,12,19,14,1922,1877,1151,-726
2020,12,19,15,2005,1971,1230,-741
2020,12,19,16,2073,2043,1235,-808
2020,12,19,17,2082,2081,1218,-863
2020,12,19,18,2057,2034,1144,-890
2020,12,19,19,2020,1964,1123,-841
2020,12,19,20,1982,1894,1145,-749
2020,12,19,21,1906,1846,1183,-663
2020,12,19,22,1901,1800,1158,-642
2020,12,19,23,1926,1813,1106,-707
2020,12,20,0,1992,1855,1187,-668
2020,12,20,1,2143,2012,1435,-577
2020,12,20,2,2179,2050,1406,-644
2020,12,20,3,2135,2033,1399,-634
2020,12,20,4,2098,2009,1251,-758
2020,12,20,5,2025,1954,1253,-701
2020,12,20,6,1918,1857,1136,-721
2020,12,20,7,1834,1763,1133,-630
2020,12,20,8,1759,1685,1099,-586
2020,12,20,9,1701,1638,1140,-498
2020,12,20,10,1665,1615,1110,-505
2020,12,20,11,1658,1596,1205,-391
2020,12,20,12,1677,1614,1234,-380
2020,12,20,13,1712,1649,1254,-395
2020,12,20,14,1763,1720,1254,-466
2020,12,20,15,1828,1796,1274,-522
2020,12,20,16,1909,1871,1315,-556
2020,12,20,17,1978,1933,1205,-728
2020,12,20,18,1970,1940,1179,-761
2020,12,20,19,1962,1932,1136,-796
2020,12,20,20,1930,1925,1094,-831
2020,12,20,21,1885,1906,1114,-792
2020,12,20,22,1873,1873,1034,-839
2020,12,20,23,1884,1875,1059,-816
2020,12,21,0,1941,1913,1126,-787
2020,12,21,1,2047,2027,1340,-687
2020,12,21,2,2064,2031,1351,-680
2020,12,21,3,2010,1987,1364,-623
2020,12,21,4,1980,1940,1320,-620
2020,12,21,5,1901,1875,1277,-598
2020,12,21,6,1790,1771,1223,-548
2020,12,21,7,1692,1672,1161,-511
2020,12,21,8,1632,1593,1052,-541
2020,12,21,9,1596,1545,992,-553
2020,12,21,10,1624,1535,1001,-534
2020,12,21,11,1633,1534,952,-582
2020,12,21,12,1667,1583,909,-674
2020,12,21,13,1769,1676,1038,-638
2020,12,21,14,1930,1823,1236,-587
2020,12,21,15,2064,1950,1254,-696
2020,12,21,16,2135,2002,1363,-639
2020,12,21,17,2148,2012,1461,-551
2020,12,21,18,2112,1979,1410,-569
2020,12,21,19,2084,1924,1434,-490
2020,12,21,20,2026,1875,1434,-441
2020,12,21,21,1990,1820,1397,-423
2020,12,21,22,1973,1797,1394,-403
2020,12,21,23,1960,1786,1383,-403
2020,12,22,0,1994,1813,1412,-401
2020,12,22,1,2096,1947,1490,-457
2020,12,22,2,2128,2010,1551,-459
2020,12,22,3,2110,1978,1570,-408
2020,12,22,4,2080,1950,1495,-455
2020,12,22,5,2000,1883,1419,-464
2020,12,22,6,1886,1780,1256,-524
2020,12,22,7,1801,1660,1149,-511
2020,12,22,8,1713,1592,1092,-500
2020,12,22,9,1654,1549,1120,-429
2020,12,22,10,1634,1538,1133,-405
2020,12,22,11,1636,1533,1154,-379
2020,12,22,12,1688,1585,1344,-241
2020,12,22,13,1802,1688,1570,-118
2020,12,22,14,1968,1843,1745,-98
2020,12,22,15,2112,1997,1731,-266
2020,12,22,16,2191,2090,1810,-280
2020,12,22,17,2215,2096,1805,-291
2020,12,22,18,2211,2107,1782,-325
2020,12,22,19,2175,2079,1713,-366
2020,12,22,20,2136,2070,1678,-392
2020,12,22,21,2108,2059,1685,-374
2020,12,22,22,2107,2052,1583,-469
2020,12,22,23,2100,2045,1524,-521
2020,12,23,0,2137,2094,1686,-408
2020,12,23,1,2255,2216,1755,-461
2020,12,23,2,2297,2256,1825,-431
2020,12,23,3,2275,2214,1738,-476
2020,12,23,4,2242,2178,1724,-454
2020,12,23,5,2164,2095,1672,-423
2020,12,23,6,2045,2012,1651,-361
2020,12,23,7,1939,1903,1480,-423
2020,12,23,8,1860,1830,1438,-392
2020,12,23,9,1798,1792,1337,-455
2020,12,23,10,1808,1792,1350,-442
2020,12,23,11,1810,1802,1353,-449
2020,12,23,12,1868,1860,1462,-398
2020,12,23,13,2004,1961,1614,-347
2020,12,23,14,2179,2113,1656,-457
2020,12,23,15,2303,2234,1633,-601
2020,12,23,16,2363,2295,1611,-684
2020,12,23,17,2356,2284,1701,-583
2020,12,23,18,2332,2212,1572,-640
2020,12,23,19,2285,2142,1551,-591
2020,12,23,20,2220,2050,1506,-544
2020,12,23,21,2178,1987,1490,-497
2020,12,23,22,2179,1937,1421,-516
2020,12,23,23,2156,1923,1546,-377
2020,12,24,0,2166,1973,1531,-442
2020,12,24,1,2292,2142,1645,-497
2020,12,24,2,2352,2196,1641,-555
2020,12,24,3,2328,2194,1633,-561
2020,12,24,4,2289,2170,1589,-581
2020,12,24,5,2208,2122,1522,-600
2020,12,24,6,2094,2029,1380,-649
2020,12,24,7,1983,1935,1384,-551
2020,12,24,8,1865,1872,1249,-623
2020,12,24,9,1840,1837,1196,-641
2020,12,24,10,1846,1840,1182,-658
2020,12,24,11,1848,1852,1253,-599
2020,12,24,12,1878,1890,1286,-604
2020,12,24,13,1936,1968,1366,-602
2020,12,24,14,2000,2074,1568,-506
2020,12,24,15,2069,2192,1703,-489
2020,12,24,16,2154,2281,1723,-558
2020,12,24,17,2163,2263,1782,-481
2020,12,24,18,2135,2183,1811,-372
2020,12,24,19,2078,2107,1801,-306
2020,12,24,20,2006,2025,1702,-323
2020,12,24,21,1945,1925,1723,-202
2020,12,24,22,1917,1878,1742,-136
2020,12,24,23,1919,1869,1717,-152
2020,12,25,0,1964,1942,1671,-271
2020,12,25,1,2110,2075,1789,-286
2020,12,25,2,2192,2080,1739,-341
2020,12,25,3,2162,2038,1745,-293
2020,12,25,4,2136,2022,1635,-387
2020,12,25,5,2090,1991,1654,-337
2020,12,25,6,2023,1925,1661,-264
2020,12,25,7,1949,1859,1663,-196
2020,12,25,8,1873,1795,1590,-205
2020,12,25,9,1830,1770,1485,-285
2020,12,25,10,1799,1757,1455,-302
2020,12,25,11,1809,1761,1444,-317
2020,12,25,12,1833,1801,1499,-302
2020,12,25,13,1889,1847,1466,-381
2020,12,25,14,1946,1937,1589,-348
2020,12,25,15,2014,2019,1597,-422
2020,12,25,16,2105,2101,1682,-419
2020,12,25,17,2102,2065,1715,-350
2020,12,25,18,2060,2018,1737,-281
2020,12,25,19,1999,1993,1514,-479
2020,12,25,20,1927,1934,1558,-376
2020,12,25,21,1852,1892,1482,-410
2020,12,25,22,1810,1903,1327,-576
2020,12,25,23,1829,1912,1340,-572
2020,12,26,0,1891,1928,1554,-374
2020,12,26,1,2033,1980,1673,-307
2020,12,26,2,2068,1976,1627,-349
2020,12,26,3,2022,1941,1636,-305
2020,12,26,4,1987,1909,1555,-354
2020,12,26,5,1944,1858,1583,-275
2020,12,26,6,1861,1784,1557,-227
2020,12,26,7,1798,1694,1438,-256
2020,12,26,8,1764,1642,1391,-251
2020,12,26,9,1695,1598,1285,-313
2020,12,26,10,1646,1583,1290,-293
2020,12,26,11,1644,1578,1218,-360
2020,12,26,12,1657,1614,1260,-354
2020,12,26,13,1699,1664,1312,-352
2020,12,26,14,1726,1724,1265,-459
2020,12,26,15,1765,1797,1276,-521
2020,12,26,16,1864,1886,1341,-545
2020,12,26,17,1875,1940,1253,-687
2020,12,26,18,1842,1992,1136,-856
2020,12,26,19,1823,1964,1056,-908
2020,12,26,20,1783,1954,985,-969
2020,12,26,21,1749,1906,1024,-882
2020,12,26,22,1747,1860,1040,-820
2020,12,26,23,1792,1845,1094,-751
2020,12,27,0,1844,1909,1357,-552
2020,12,27,1,1967,2023,1415,-608
2020,12,27,2,1996,2052,1621,-431
2020,12,27,3,1957,2020,1714,-306
2020,12,27,4,1930,1985,1579,-406
2020,12,27,5,1886,1936,1511,-425
2020,12,27,6,1810,1863,1490,-373
2020,12,27,7,1756,1776,1461,-315
2020,12,27,8,1734,1722,1292,-430
2020,12,27,9,1681,1690,1300,-390
2020,12,27,10,1665,1682,1307,-375
2020,12,27,11,1661,1682,1214,-468
2020,12,27,12,1671,1711,1311,-400
2020,12,27,13,1706,1762,1394,-368
2020,12,27,14,1747,1833,1365,-468
2020,12,27,15,1797,1923,1310,-613
2020,12,27,16,1904,2015,1263,-752
2020,12,27,17,1975,2049,1369,-680
2020,12,27,18,1977,2042,1320,-722
2020,12,27,19,1988,2010,1202,-808
2020,12,27,20,1959,1780,1010,-770
2020,12,27,21,1911,2129,1356,-773
2020,12,27,22,1887,1901,1118,-783
2020,12,27,23,1888,1912,1069,-843
2020,12,28,0,1930,2008,1192,-816
2020,12,28,1,2035,2154,1426,-728
2020,12,28,2,2080,2184,1415,-769
2020,12,28,3,2048,2151,1427,-724
2020,12,28,4,2018,2122,1378,-744
2020,12,28,5,1960,2062,1351,-711
2020,12,28,6,1860,1949,1207,-742
2020,12,28,7,1794,1870,1205,-665
2020,12,28,8,1736,1813,1174,-639
2020,12,28,9,1737,1783,1142,-641
2020,12,28,10,1791,1783,1200,-583
2020,12,28,11,1810,1813,1240,-573
2020,12,28,12,1841,1865,1250,-615
2020,12,28,13,1943,1964,1380,-584
2020,12,28,14,2087,2116,1521,-595
2020,12,28,15,2197,2254,1571,-683
2020,12,28,16,2261,2328,1530,-798
2020,12,28,17,2250,2300,1536,-764
2020,12,28,18,2229,2263,1440,-823
2020,12,28,19,2197,2213,1399,-814
2020,12,28,20,2138,2172,1261,-911
2020,12,28,21,2085,2139,1266,-873
2020,12,28,22,2057,2125,1292,-833
2020,12,28,23,2042,2146,1388,-758
2020,12,29,0,2072,2195,1485,-710
2020,12,29,1,2213,2337,1691,-646
2020,12,29,2,2269,2355,1669,-686
2020,12,29,3,2251,2319,1635,-684
2020,12,29,4,2208,2273,1677,-596
2020,12,29,5,2142,2195,1642,-553
2020,12,29,6,2034,1838,1236,-602
2020,12,29,7,1942,1747,1104,-643
2020,12,29,8,1838,2173,1441,-732
2020,12,29,9,1865,1913,1166,-747
2020,12,29,10,1892,1916,1151,-765
2020,12,29,11,1894,1926,1023,-903
2020,12,29,12,1910,1975,1032,-943
2020,12,29,13,2018,2068,1255,-813
2020,12,29,14,2154,2212,1231,-981
2020,12,29,15,2271,2324,1398,-926
2020,12,29,16,2327,2401,1383,-1018
2020,12,29,17,2306,2416,1409,-1007
2020,12,29,18,2294,2391,1264,-1127
2020,12,29,19,2250,2373,1172,-1201
2020,12,29,20,2182,2332,1160,-1172
2020,12,29,21,2113,2241,1157,-1084
2020,12,29,22,2086,2005,935,-1070
2020,12,29,23,2084,1989,902,-1087
2020,12,30,0,2120,2543,1525,-1018
2020,12,30,1,2252,2394,1574,-820
2020,12,30,2,2308,2417,1573,-844
2020,12,30,3,2266,2365,1553,-812
2020,12,30,4,2218,2310,1545,-765
2020,12,30,5,2149,2222,1505,-717
2020,12,30,6,2035,2108,1376,-732
2020,12,30,7,1940,1994,1205,-789
2020,12,30,8,1859,1928,1199,-729
2020,12,30,9,1911,1893,1261,-632
2020,12,30,10,1917,1890,1289,-601
2020,12,30,11,1922,1906,1299,-607
2020,12,30,12,1950,1948,1370,-578
2020,12,30,13,2053,2031,1410,-621
2020,12,30,14,2172,2154,1505,-649
2020,12,30,15,2283,2278,1658,-620
2020,12,30,16,2344,2346,1615,-731
2020,12,30,17,2344,2366,1527,-839
2020,12,30,18,2331,2349,1528,-821
2020,12,30,19,2296,2319,1495,-824
2020,12,30,20,2222,2275,1385,-890
2020,12,30,21,2138,2231,1406,-825
2020,12,30,22,2103,2197,1482,-715
2020,12,30,23,2096,2177,1533,-644
2020,12,31,0,2136,2214,1660,-554
2020,12,31,1,2244,2298,1724,-574
2020,12,31,2,2276,2305,1766,-539
2020,12,31,3,2220,2265,1749,-516
2020,12,31,4,2158,2208,1714,-494
2020,12,31,5,2079,2112,1438,-674
2020,12,31,6,1965,1995,1382,-613
2020,12,31,7,1886,1871,1397,-474
2020,12,31,8,1783,1795,1398,-397
2020,12,31,9,1788,1759,1287,-472
2020,12,31,10,1795,1741,1213,-528
2020,12,31,11,1814,1744,1128,-616
2020,12,31,12,1832,1769,1113,-656
2020,12,31,13,1874,1851,1258,-593
2020,12,31,14,1913,1966,1347,-619
2020,12,31,15,1968,2082,1400,-682
2020,12,31,16,2062,2155,1543,-612
2020,12,31,17,2117,2179,1493,-686
2020,12,31,18,2146,2168,1394,-774
2020,12,31,19,2144,2139,1291,-848
2020,12,31,20,2105,2096,1259,-837
2020,12,31,21,2048,2048,1186,-862
2020,12,31,22,2018,2009,1175,-834
2020,12,31,23,2025,1991,1167,-824
2021,1,1,0,2081,2045,1343,-702
2021,1,1,1,2166,2168,1668,-500
2021,1,1,2,2201,2157,1573,-584
2021,1,1,3,2145,2081,1474,-607
2021,1,1,4,2088,2022,1491,-531
2021,1,1,5,2024,1940,1345,-595
2021,1,1,6,1931,1878,1399,-479
2021,1,1,7,1885,1801,1148,-653
2021,1,1,8,1814,1754,1153,-601
2021,1,1,9,1766,1714,1116,-598
2021,1,1,10,1730,1684,1108,-576
2021,1,1,11,1748,1677,1127,-550
2021,1,1,12,1771,1696,1136,-560
2021,1,1,13,1814,1738,1199,-539
2021,1,1,14,1860,1804,1233,-571
2021,1,1,15,1918,1871,1419,-452
2021,1,1,16,2014,1925,1422,-503
2021,1,1,17,2073,1950,1435,-515
2021,1,1,18,2094,1931,1368,-563
2021,1,1,19,2085,1896,1303,-593
2021,1,1,20,2043,1850,1298,-552
2021,1,1,21,1994,1825,1281,-544
2021,1,1,22,1953,1808,1253,-555
2021,1,1,23,1960,1831,1302,-529
2021,1,2,0,2023,1893,1471,-422
2021,1,2,1,2124,2025,1630,-395
2021,1,2,2,2156,2065,1726,-339
2021,1,2,3,2091,2024,1700,-324
2021,1,2,4,2044,1989,1769,-220
2021,1,2,5,1982,1928,1679,-249
2021,1,2,6,1902,1839,1584,-255
2021,1,2,7,1852,1754,1418,-336
2021,1,2,8,1806,1692,1330,-362
2021,1,2,9,1702,1646,1350,-296
2021,1,2,10,1659,1635,1209,-426
2021,1,2,11,1679,1628,1076,-552
2021,1,2,12,1712,1652,1055,-597
2021,1,2,13,1739,1699,1095,-604
2021,1,2,14,1758,1775,1125,-650
2021,1,2,15,1791,1860,1157,-703
2021,1,2,16,1878,1937,1261,-676
2021,1,2,17,1946,1987,1324,-663
2021,1,2,18,1973,1981,1215,-766
2021,1,2,19,1957,1960,1225,-735
2021,1,2,20,1925,1904,1210,-694
2021,1,2,21,1886,1834,1191,-643
2021,1,2,22,1851,1829,1129,-700
2021,1,2,23,1864,1839,1272,-567
2021,1,3,0,1930,1912,1491,-421
2021,1,3,1,2049,2028,1485,-543
2021,1,3,2,2082,2054,1472,-582
2021,1,3,3,2021,2012,1464,-548
2021,1,3,4,1974,1965,1471,-494
2021,1,3,5,1906,1907,1413,-494
2021,1,3,6,1820,1807,1382,-425
2021,1,3,7,1761,1719,1343,-376
2021,1,3,8,1702,1653,1317,-336
2021,1,3,9,1640,1610,1175,-435
2021,1,3,10,1589,1595,1116,-479
2021,1,3,11,1589,1582,1123,-459
2021,1,3,12,1610,1609,1121,-488
2021,1,3,13,1633,1648,1142,-506
2021,1,3,14,1664,1721,1265,-456
2021,1,3,15,1715,1797,1270,-527
2021,1,3,16,1803,1856,1229,-627
2021,1,3,17,1882,1904,1197,-707
2021,1,3,18,1907,1928,1255,-673
2021,1,3,19,1910,1909,1277,-632
2021,1,3,20,1902,1878,1332,-546
2021,1,3,21,1852,1820,1296,-524
2021,1,3,22,1837,1769,1303,-466
2021,1,3,23,1843,1758,1317,-441
2021,1,4,0,1910,1807,1317,-490
2021,1,4,1,2016,1958,1469,-489
2021,1,4,2,2035,2012,1388,-624
2021,1,4,3,1998,1986,1327,-659
2021,1,4,4,1958,1960,1356,-604
2021,1,4,5,1890,1873,1239,-634
2021,1,4,6,1786,1780,1147,-633
2021,1,4,7,1692,1682,1057,-625
2021,1,4,8,1647,1617,1072,-545
2021,1,4,9,1623,1588,1198,-390
2021,1,4,10,1613,1588,1259,-329
2021,1,4,11,1626,1601,1244,-357
2021,1,4,12,1659,1646,1323,-323
2021,1,4,13,1743,1753,1535,-218
2021,1,4,14,1862,1906,1623,-283
2021,1,4,15,1977,2056,1691,-365
2021,1,4,16,2009,2087,1733,-354
2021,1,4,17,2024,2099,1717,-382
2021,1,4,18,2032,2114,1632,-482
2021,1,4,19,2011,2102,1650,-452
2021,1,4,20,1975,2088,1679,-409
2021,1,4,21,1935,2100,1594,-506
2021,1,4,22,1922,2079,1449,-630
2021,1,4,23,1921,2072,1492,-580
2021,1,5,0,1955,2102,1562,-540
2021,1,5,1,2070,2175,1734,-441
2021,1,5,2,2089,2163,1610,-553
2021,1,5,3,2046,2104,1556,-548
2021,1,5,4,2003,2028,1403,-625
2021,1,5,5,1928,1939,1378,-561
2021,1,5,6,1817,1808,1302,-506
2021,1,5,7,1730,1703,1344,-359
2021,1,5,8,1671,1631,1349,-282
2021,1,5,9,1668,1622,1362,-260
2021,1,5,10,1608,1605,1347,-258
2021,1,5,11,1621,1630,1354,-276
2021,1,5,12,1676,1678,1374,-304
2021,1,5,13,1768,1793,1501,-292
2021,1,5,14,1915,1972,1597,-375
2021,1,5,15,2038,2102,1572,-530
2021,1,5,16,2134,2175,1701,-474
2021,1,5,17,2166,2110,1644,-466
2021,1,5,18,2178,2035,1500,-535
2021,1,5,19,2142,1935,1344,-591
2021,1,5,20,2088,1931,1403,-528
2021,1,5,21,2052,1896,1357,-539
2021,1,5,22,2032,1859,1311,-548
2021,1,5,23,2026,1843,1252,-591
2021,1,6,0,2052,1920,1305,-615
2021,1,6,1,2155,2049,1341,-708
2021,1,6,2,2173,2127,1449,-678
2021,1,6,3,2140,2118,1471,-647
2021,1,6,4,2103,2077,1462,-615
2021,1,6,5,2024,2003,1446,-557
2021,1,6,6,1896,1894,1298,-596
2021,1,6,7,1788,1788,1233,-555
2021,1,6,8,1742,1739,1235,-504
2021,1,6,9,1695,1719,1231,-488
2021,1,6,10,1702,1709,1263,-446
2021,1,6,11,1722,1716,1289,-427
2021,1,6,12,1764,1768,1289,-479
2021,1,6,13,1857,1866,1368,-498
2021,1,6,14,2004,2053,1541,-512
2021,1,6,15,2125,2198,1739,-459
2021,1,6,16,2186,2233,1751,-482
2021,1,6,17,2185,2209,1851,-358
2021,1,6,18,2164,2159,1875,-284
2021,1,6,19,2108,2102,1839,-263
2021,1,6,20,2045,2056,1782,-274
2021,1,6,21,2002,2007,1783,-224
2021,1,6,22,1984,1966,1797,-169
2021,1,6,23,1965,1964,1780,-184
2021,1,7,0,2002,2012,1617,-395
2021,1,7,1,2119,2123,1677,-446
2021,1,7,2,2159,2160,1639,-521
2021,1,7,3,2119,2118,1632,-486
2021,1,7,4,2070,2079,1719,-360
2021,1,7,5,1994,1972,1617,-355
2021,1,7,6,1877,1868,1525,-343
2021,1,7,7,1776,1759,1392,-367
2021,1,7,8,1692,1675,1373,-302
2021,1,7,9,1691,1659,1322,-337
2021,1,7,10,1662,1638,1156,-482
2021,1,7,11,1678,1660,1098,-562
2021,1,7,12,1721,1704,1114,-590
2021,1,7,13,1817,1810,1327,-483
2021,1,7,14,1965,1966,1461,-505
2021,1,7,15,2089,2100,1512,-588
2021,1,7,16,2134,2137,1509,-628
2021,1,7,17,2132,2114,1476,-638
2021,1,7,18,2113,2103,1319,-784
2021,1,7,19,2062,2049,1212,-837
2021,1,7,20,2023,1993,1200,-793
2021,1,7,21,1992,1967,1190,-777
2021,1,7,22,1971,1930,1200,-730
2021,1,7,23,1958,1915,1119,-796
2021,1,8,0,2002,1967,1130,-837
2021,1,8,1,2113,2071,1367,-704
2021,1,8,2,2151,2114,1347,-767
2021,1,8,3,2123,2078,1344,-734
2021,1,8,4,2078,2032,1195,-837
2021,1,8,5,2005,1963,1284,-679
2021,1,8,6,1891,1844,1182,-662
2021,1,8,7,1790,1736,1053,-683
2021,1,8,8,1743,1678,1051,-627
2021,1,8,9,1717,1651,1148,-503
2021,1,8,10,1671,1659,1235,-424
2021,1,8,11,1693,1663,1204,-459
2021,1,8,12,1738,1715,1207,-508
2021,1,8,13,1846,1824,1270,-554
2021,1,8,14,2019,1995,1314,-681
2021,1,8,15,2157,2131,1374,-757
2021,1,8,16,2221,2202,1404,-798
2021,1,8,17,2211,2181,1356,-825
2021,1,8,18,2170,2137,1370,-767
2021,1,8,19,2095,2112,1326,-786
2021,1,8,20,2039,2091,1321,-770
2021,1,8,21,2013,2068,1268,-800
2021,1,8,22,1989,2052,1315,-737
2021,1,8,23,1964,2050,1421,-629
2021,1,9,0,2003,2071,1366,-705
2021,1,9,1,2022,2152,1394,-758
2021,1,9,2,2043,2142,1353,-789
2021,1,9,3,2035,2109,1389,-720
2021,1,9,4,2001,2050,1420,-630
2021,1,9,5,1957,1972,1490,-482
2021,1,9,6,1868,1893,1541,-352
2021,1,9,7,1767,1789,1394,-395
2021,1,9,8,1722,1722,1292,-430
2021,1,9,9,1680,1689,1285,-404
2021,1,9,10,1704,1669,1233,-436
2021,1,9,11,1723,1676,1275,-401
2021,1,9,12,1745,1698,1295,-403
2021,1,9,13,1803,1763,1230,-533
2021,1,9,14,1899,1846,1331,-515
2021,1,9,15,1996,1945,1411,-534
2021,1,9,16,2074,2038,1316,-722
2021,1,9,17,2110,2074,1299,-775
2021,1,9,18,2103,2088,1328,-760
2021,1,9,19,2065,2065,1241,-824
2021,1,9,20,2019,1994,1095,-899
2021,1,9,21,1982,1924,1073,-851
2021,1,9,22,1950,1881,1148,-733
2021,1,9,23,1943,1871,1194,-677
2021,1,10,0,1988,1925,1238,-687
2021,1,10,1,2092,2042,1302,-740
2021,1,10,2,2139,2105,1357,-748
2021,1,10,3,2094,2069,1346,-723
2021,1,10,4,2043,2042,1366,-676
2021,1,10,5,1988,1975,1282,-693
2021,1,10,6,1905,1884,1206,-678
2021,1,10,7,1825,1796,1154,-642
2021,1,10,8,1738,1740,1135,-605
2021,1,10,9,1705,1705,1076,-629
2021,1,10,10,1693,1690,1064,-626
2021,1,10,11,1698,1697,1043,-654
2021,1,10,12,1724,1721,1052,-669
2021,1,10,13,1784,1769,1140,-629
2021,1,10,14,1856,1824,1130,-694
2021,1,10,15,1950,1914,1252,-662
2021,1,10,16,2038,1998,1356,-642
2021,1,10,17,2085,2044,1368,-676
2021,1,10,18,2081,2054,1350,-704
2021,1,10,19,2069,2040,1334,-706
2021,1,10,20,2022,1999,1370,-629
2021,1,10,21,1971,1939,1343,-596
2021,1,10,22,1937,1890,1335,-555
2021,1,10,23,1931,1869,1346,-523
2021,1,11,0,1969,1917,1326,-591
2021,1,11,1,2077,2044,1369,-675
2021,1,11,2,2143,2131,1428,-703
2021,1,11,3,2129,2123,1325,-798
2021,1,11,4,2090,2087,1394,-693
2021,1,11,5,2025,2026,1327,-699
2021,1,11,6,1925,1910,1151,-759
2021,1,11,7,1834,1825,1084,-741
2021,1,11,8,1775,1759,1053,-706
2021,1,11,9,1769,1758,1115,-643
2021,1,11,10,1770,1764,1095,-669
2021,1,11,11,1798,1783,1122,-661
2021,1,11,12,1847,1844,1212,-632
2021,1,11,13,1962,1958,1357,-601
2021,1,11,14,2132,2144,1365,-779
2021,1,11,15,2289,2296,1483,-813
2021,1,11,16,2331,2327,1589,-738
2021,1,11,17,2323,2295,1656,-639
2021,1,11,18,2287,2214,1714,-500
2021,1,11,19,2221,2147,1599,-548
2021,1,11,20,2144,2082,1512,-570
2021,1,11,21,2099,2010,1478,-532
2021,1,11,22,2053,1957,1494,-463
2021,1,11,23,2016,1965,1508,-457
2021,1,12,0,2045,1988,1518,-470
2021,1,12,1,2168,2133,1629,-504
2021,1,12,2,2233,2207,1669,-538
2021,1,12,3,2212,2177,1713,-464
2021,1,12,4,2170,2156,1781,-375
2021,1,12,5,2089,2072,1786,-286
2021,1,12,6,1973,1962,1651,-311
2021,1,12,7,1865,1857,1498,-359
2021,1,12,8,1800,1784,1442,-342
2021,1,12,9,1781,1770,1461,-309
2021,1,12,10,1775,1780,1469,-311
2021,1,12,11,1786,1778,1463,-315
2021,1,12,12,1820,1823,1465,-358
2021,1,12,13,1915,1926,1597,-329
2021,1,12,14,2068,2089,1671,-418
2021,1,12,15,2191,2230,1715,-515
2021,1,12,16,2245,2267,1626,-641
2021,1,12,17,2218,2260,1527,-733
2021,1,12,18,2197,2234,1491,-743
2021,1,12,19,2136,2209,1526,-683
2021,1,12,20,2083,2161,1504,-657
2021,1,12,21,2045,2141,1365,-776
2021,1,12,22,2007,2113,1394,-719
2021,1,12,23,1978,2114,1420,-694
2021,1,13,0,2012,2116,1570,-546
2021,1,13,1,2123,2189,1594,-595
2021,1,13,2,2173,2176,1613,-563
2021,1,13,3,2129,2133,1675,-458
2021,1,13,4,2068,2064,1686,-378
2021,1,13,5,1970,1959,1693,-266
2021,1,13,6,1846,1834,1640,-194
2021,1,13,7,1742,1706,1568,-138
2021,1,13,8,1672,1676,1294,-382
2021,1,13,9,1654,1611,1205,-406
2021,1,13,10,1622,1602,1191,-411
2021,1,13,11,1626,1595,1276,-319
2021,1,13,12,1658,1619,1295,-324
2021,1,13,13,1754,1714,1414,-300
2021,1,13,14,1899,1885,1407,-478
2021,1,13,15,2016,2013,1448,-565
2021,1,13,16,2066,2018,1402,-616
2021,1,13,17,2065,2039,1466,-573
2021,1,13,18,2057,2030,1776,-254
2021,1,13,19,2033,1998,1825,-173
2021,1,13,20,2005,1957,1705,-252
2021,1,13,21,1996,1918,1694,-224
2021,1,13,22,1986,1873,1733,-140
2021,1,13,23,1980,1864,1752,-112
2021,1,14,0,2013,1904,1825,-79
2021,1,14,1,2114,2021,1800,-221
2021,1,14,2,2151,2083,1726,-357
2021,1,14,3,2126,2064,1668,-396
2021,1,14,4,2073,2045,1610,-435
2021,1,14,5,1986,1969,1472,-497
2021,1,14,6,1872,1880,1250,-630
2021,1,14,7,1777,1781,1202,-579
2021,1,14,8,1734,1734,1163,-571
2021,1,14,9,1707,1729,1154,-575
2021,1,14,10,1720,1719,1087,-632
2021,1,14,11,1731,1729,1056,-673
2021,1,14,12,1782,1780,1083,-697
2021,1,14,13,1890,1881,1237,-644
2021,1,14,14,2052,2065,1556,-509
2021,1,14,15,2187,2206,1563,-643
2021,1,14,16,2233,2240,1582,-658
2021,1,14,17,2219,2187,1634,-553
2021,1,14,18,2204,2112,1661,-451
2021,1,14,19,2145,2010,1462,-548
2021,1,14,20,2078,1938,1383,-555
2021,1,14,21,2037,1892,1406,-486
2021,1,14,22,2007,1844,1263,-581
2021,1,14,23,1983,1836,1269,-567
2021,1,15,0,1999,1874,1271,-603
2021,1,15,1,2114,1999,1441,-558
2021,1,15,2,2183,2087,1346,-741
2021,1,15,3,2169,2090,1439,-651
2021,1,15,4,2121,2058,1445,-613
2021,1,15,5,2034,1995,1266,-729
2021,1,15,6,1932,1909,1104,-805
2021,1,15,7,1825,1808,1068,-740
2021,1,15,8,1764,1765,1021,-744
2021,1,15,9,1761,1749,1053,-696
2021,1,15,10,1731,1751,1090,-661
2021,1,15,11,1738,1758,1013,-745
2021,1,15,12,1776,1806,1041,-765
2021,1,15,13,1869,1920,1263,-657
2021,1,15,14,2043,2083,1419,-664
2021,1,15,15,2177,2235,1504,-731
2021,1,15,16,2224,2281,1515,-766
2021,1,15,17,2209,2220,1468,-752
2021,1,15,18,2178,2180,1318,-862
2021,1,15,19,2119,2129,1249,-880
2021,1,15,20,2056,2068,1135,-933
2021,1,15,21,2005,2034,1017,-1017
2021,1,15,22,1972,2044,981,-1063
2021,1,15,23,1954,2046,955,-1091
2021,1,16,0,1966,2070,1224,-846
2021,1,16,1,2005,2146,1290,-856
2021,1,16,2,2066,2160,1439,-721
2021,1,16,3,2067,2120,1372,-748
2021,1,16,4,2034,2078,1303,-775
2021,1,16,5,1978,1994,1337,-657
2021,1,16,6,1898,1901,1284,-617
2021,1,16,7,1802,1818,1273,-545
2021,1,16,8,1757,1760,1277,-483
2021,1,16,9,1724,1713,1192,-521
2021,1,16,10,1716,1710,1208,-502
2021,1,16,11,1725,1717,1169,-548
2021,1,16,12,1751,1754,1136,-618
2021,1,16,13,1810,1820,1237,-583
2021,1,16,14,1900,1910,1284,-626
2021,1,16,15,1993,2019,1327,-692
2021,1,16,16,2052,2112,1293,-819
2021,1,16,17,2074,2125,1199,-926
2021,1,16,18,2061,2107,1250,-857
2021,1,16,19,2004,2026,1183,-843
2021,1,16,20,1950,1961,1129,-832
2021,1,16,21,1889,1905,1079,-826
2021,1,16,22,1883,1873,1072,-801
2021,1,16,23,1866,1850,1028,-822
2021,1,17,0,1891,1856,1186,-670
2021,1,17,1,2004,1984,1341,-643
2021,1,17,2,2088,2066,1307,-759
2021,1,17,3,2058,2056,1254,-802
2021,1,17,4,2014,2020,1317,-703
2021,1,17,5,1952,1973,1280,-693
2021,1,17,6,1878,1884,1078,-806
2021,1,17,7,1806,1801,1041,-760
2021,1,17,8,1745,1733,951,-782
2021,1,17,9,1704,1707,983,-724
2021,1,17,10,1674,1694,968,-726
2021,1,17,11,1674,1696,980,-716
2021,1,17,12,1702,1716,975,-741
2021,1,17,13,1746,1769,982,-787
2021,1,17,14,1823,1834,1015,-819
2021,1,17,15,1910,1926,1036,-890
2021,1,17,16,1978,2008,987,-1021
2021,1,17,17,2015,2025,927,-1098
2021,1,17,18,1998,1983,936,-1047
2021,1,17,19,1981,1954,1040,-914
2021,1,17,20,1944,1885,975,-910
2021,1,17,21,1908,1852,1048,-804
2021,1,17,22,1877,1796,1326,-470
2021,1,17,23,1865,1780,1472,-308
2021,1,18,0,1878,1831,1508,-323
2021,1,18,1,1990,1944,1586,-358
2021,1,18,2,2067,2011,1541,-470
2021,1,18,3,2055,1999,1568,-431
2021,1,18,4,2015,1967,1545,-422
2021,1,18,5,1946,1900,1508,-392
2021,1,18,6,1850,1806,1498,-308
2021,1,18,7,1763,1724,1481,-243
2021,1,18,8,1737,1675,1502,-173
2021,1,18,9,1700,1653,1482,-171
2021,1,18,10,1682,1654,1453,-201
2021,1,18,11,1690,1677,1436,-241
2021,1,18,12,1727,1726,1388,-338
2021,1,18,13,1788,1833,1345,-488
2021,1,18,14,1881,1982,1443,-539
2021,1,18,15,1989,2125,1517,-608
2021,1,18,16,2070,2182,1448,-734
2021,1,18,17,2109,2164,1364,-800
2021,1,18,18,2107,2129,1326,-803
2021,1,18,19,2056,2076,1306,-770
2021,1,18,20,2014,2000,1279,-721
2021,1,18,21,1968,1940,1253,-687
2021,1,18,22,1939,1886,1256,-630
2021,1,18,23,1926,1878,1291,-587
2021,1,19,0,1929,1916,1369,-547
2021,1,19,1,2021,2035,1297,-738
2021,1,19,2,2109,2136,1287,-849
2021,1,19,3,2095,2111,1275,-836
2021,1,19,4,2066,2076,1321,-755
2021,1,19,5,2012,2006,1366,-640
2021,1,19,6,1940,1899,1151,-748
2021,1,19,7,1870,1823,1067,-756
2021,1,19,8,1848,1774,1080,-694
2021,1,19,9,1786,1752,1102,-650
2021,1,19,10,1774,1756,1084,-672
2021,1,19,11,1785,1786,1077,-709
2021,1,19,12,1837,1840,1186,-654
2021,1,19,13,1948,1961,1300,-661
2021,1,19,14,2117,2157,1284,-873
2021,1,19,15,2265,2316,1340,-976
2021,1,19,16,2335,2345,1371,-974
2021,1,19,17,2318,2269,1530,-739
2021,1,19,18,2269,2173,1376,-797
2021,1,19,19,2179,2067,1295,-772
2021,1,19,20,2110,1980,1167,-813
2021,1,19,21,2063,1918,1190,-728
2021,1,19,22,2019,1865,1210,-655
2021,1,19,23,2002,1830,1225,-605
2021,1,20,0,2019,1887,1300,-587
2021,1,20,1,2119,2009,1266,-743
2021,1,20,2,2220,2154,1311,-843
2021,1,20,3,2207,2142,1245,-897
2021,1,20,4,2174,2123,1270,-853
2021,1,20,5,2098,2051,1284,-767
2021,1,20,6,1982,1941,1217,-724
2021,1,20,7,1891,1857,1100,-757
2021,1,20,8,1851,1815,1018,-797
2021,1,20,9,1792,1792,1002,-790
2021,1,20,10,1799,1803,939,-864
2021,1,20,11,1814,1827,906,-921
2021,1,20,12,1856,1887,913,-974
2021,1,20,13,1961,1997,1138,-859
2021,1,20,14,2126,2201,1303,-898
2021,1,20,15,2287,2342,1398,-944
2021,1,20,16,2343,2367,1480,-887
2021,1,20,17,2299,2312,1653,-659
2021,1,20,18,2226,2190,1655,-535
2021,1,20,19,2127,2088,1539,-549
2021,1,20,20,2042,2026,1268,-758
2021,1,20,21,1975,1937,1167,-770
2021,1,20,22,1917,1906,1154,-752
2021,1,20,23,1901,1872,1146,-726
2021,1,21,0,1926,1937,1200,-737
2021,1,21,1,2047,2037,1277,-760
2021,1,21,2,2165,2122,1279,-843
2021,1,21,3,2162,2098,1277,-821
2021,1,21,4,2127,2054,1226,-828
2021,1,21,5,2026,1977,1155,-822
2021,1,21,6,1913,1880,1029,-851
2021,1,21,7,1829,1765,946,-819
2021,1,21,8,1788,1720,971,-749
2021,1,21,9,1755,1686,1059,-627
2021,1,21,10,1732,1686,1170,-516
2021,1,21,11,1741,1688,1150,-538
2021,1,21,12,1788,1743,1137,-606
2021,1,21,13,1890,1847,1293,-554
2021,1,21,14,2052,2013,1490,-523
2021,1,21,15,2188,2144,1528,-616
2021,1,21,16,2227,2180,1556,-624
2021,1,21,17,2186,2161,1392,-769
2021,1,21,18,2138,2133,1322,-811
2021,1,21,19,2058,2083,1251,-832
2021,1,21,20,1987,2042,1230,-812
2021,1,21,21,1941,1985,1158,-827
2021,1,21,22,1906,1959,1128,-831
2021,1,21,23,1903,1952,1131,-821
2021,1,22,0,1923,1975,1290,-685
2021,1,22,1,2029,1978,1470,-508
2021,1,22,2,2122,2127,1414,-713
2021,1,22,3,2106,2073,1399,-674
2021,1,22,4,2069,2036,1345,-691
2021,1,22,5,1971,1947,1327,-620
2021,1,22,6,1864,1831,1268,-563
2021,1,22,7,1783,1728,1152,-576
2021,1,22,8,1748,1285,1147,-138
2021,1,22,9,1716,1645,1148,-497
2021,1,22,10,1711,1623,1229,-394
2021,1,22,11,1725,1635,1288,-347
2021,1,22,12,1783,1671,1301,-370
2021,1,22,13,1896,1771,1408,-363
2021,1,22,14,2071,1933,1436,-497
2021,1,22,15,2224,2068,1509,-559
2021,1,22,16,2270,2124,1525,-599
2021,1,22,17,2249,2141,1482,-659
2021,1,22,18,2209,2133,1335,-798
2021,1,22,19,2089,2092,1256,-836
2021,1,22,20,2044,2023,1260,-763
2021,1,22,21,1994,2018,1350,-668
2021,1,22,22,1952,1951,1331,-620
2021,1,22,23,1944,1937,1284,-653
2021,1,23,0,1964,1980,1447,-533
2021,1,23,1,2002,2032,1529,-503
2021,1,23,2,2046,2060,1595,-465
2021,1,23,3,2033,2038,1617,-421
2021,1,23,4,2004,1983,1676,-307
2021,1,23,5,1942,1918,1650,-268
2021,1,23,6,1859,1840,1560,-280
2021,1,23,7,1785,1747,1296,-451
2021,1,23,8,1724,1691,1187,-504
2021,1,23,9,1659,1675,1172,-503
2021,1,23,10,1693,1674,1165,-509
2021,1,23,11,1702,1663,1143,-520
2021,1,23,12,1738,1699,1176,-523
2021,1,23,13,1804,1760,1150,-610
2021,1,23,14,1902,1856,1308,-548
2021,1,23,15,2010,1975,1432,-543
2021,1,23,16,2087,2063,1449,-614
2021,1,23,17,2131,2087,1601,-486
2021,1,23,18,2108,2059,1614,-445
2021,1,23,19,2039,2029,1628,-401
2021,1,23,20,1987,1959,1446,-513
2021,1,23,21,1915,1897,1433,-464
2021,1,23,22,1877,1848,1443,-405
2021,1,23,23,1859,1829,1455,-374
2021,1,24,0,1891,1851,1413,-438
2021,1,24,1,1988,1964,1410,-554
2021,1,24,2,2081,2065,1406,-659
2021,1,24,3,2053,2060,1324,-736
2021,1,24,4,2016,2025,1281,-744
2021,1,24,5,1960,1975,1268,-707
2021,1,24,6,1895,1908,1231,-677
2021,1,24,7,1856,1833,1115,-718
2021,1,24,8,1781,1795,1119,-676
2021,1,24,9,1738,1770,1072,-698
2021,1,24,10,1757,1776,1040,-736
2021,1,24,11,1752,1788,1066,-722
2021,1,24,12,1771,1824,1258,-566
2021,1,24,13,1829,1882,1272,-610
2021,1,24,14,1919,1969,1282,-687
2021,1,24,15,2010,2064,1300,-764
2021,1,24,16,2095,2150,1337,-813
2021,1,24,17,2132,2152,1390,-762
2021,1,24,18,2116,2097,1458,-639
2021,1,24,19,2076,2012,1304,-708
2021,1,24,20,2023,1954,1368,-586
2021,1,24,21,1938,1886,1387,-499
2021,1,24,22,1886,1852,1432,-420
2021,1,24,23,1859,1847,1492,-355
2021,1,25,0,1891,1895,1414,-481
2021,1,25,1,1995,2018,1400,-618
2021,1,25,2,2106,2126,1524,-602
2021,1,25,3,2091,2122,1567,-555
2021,1,25,4,2049,2108,1528,-580
2021,1,25,5,1987,2015,1418,-597
2021,1,25,6,1890,1900,1287,-613
2021,1,25,7,1806,1805,1161,-644
2021,1,25,8,1761,1747,1053,-694
2021,1,25,9,1738,1736,1067,-669
2021,1,25,10,1727,1734,1053,-681
2021,1,25,11,1744,1758,1091,-667
2021,1,25,12,1787,1814,1160,-654
2021,1,25,13,1896,1917,1287,-630
2021,1,25,14,2077,2102,1415,-687
2021,1,25,15,2224,2259,1475,-784
2021,1,25,16,2272,2296,1524,-772
2021,1,25,17,2253,2277,1609,-668
2021,1,25,18,2223,2240,1597,-643
2021,1,25,19,2158,2185,1548,-637
2021,1,25,20,2092,2117,1565,-552
2021,1,25,21,2029,2055,1454,-601
2021,1,25,22,1995,2019,1476,-543
2021,1,25,23,1975,2001,1569,-432
2021,1,26,0,2004,2043,1530,-513
2021,1,26,1,2117,2134,1589,-545
2021,1,26,2,2202,2226,1709,-517
2021,1,26,3,2185,2196,1671,-525
2021,1,26,4,2136,2147,1591,-556
2021,1,26,5,2055,2070,1573,-497
2021,1,26,6,1947,1946,1461,-485
2021,1,26,7,1860,1835,1180,-655
2021,1,26,8,1824,1805,1211,-594
2021,1,26,9,1784,1789,1215,-574
2021,1,26,10,1796,1783,1205,-578
2021,1,26,11,1799,1814,1277,-537
2021,1,26,12,1843,1866,1258,-608
2021,1,26,13,1952,1985,1316,-669
2021,1,26,14,2122,2148,1444,-704
2021,1,26,15,2255,2295,1490,-805
2021,1,26,16,2303,2325,1513,-812
2021,1,26,17,2287,2303,1411,-892
2021,1,26,18,2247,2262,1375,-887
2021,1,26,19,2207,2199,1417,-782
2021,1,26,20,2141,2118,1330,-788
2021,1,26,21,2071,2073,1306,-767
2021,1,26,22,2036,2030,1278,-752
2021,1,26,23,2013,2025,1343,-682
2021,1,27,0,2033,2051,1392,-659
2021,1,27,1,2129,2139,1423,-716
2021,1,27,2,2223,2229,1500,-729
2021,1,27,3,2198,2219,1530,-689
2021,1,27,4,2147,2178,1616,-562
2021,1,27,5,2054,2080,1564,-516
2021,1,27,6,1931,1947,1564,-383
2021,1,27,7,1841,1850,1547,-303
2021,1,27,8,1767,1787,1554,-233
2021,1,27,9,1735,1770,1644,-126
2021,1,27,10,1724,1747,1704,-43
2021,1,27,11,1714,1764,1757,-7
2021,1,27,12,1754,1793,1788,-5
2021,1,27,13,1852,1917,1761,-156
2021,1,27,14,2000,2093,1767,-326
2021,1,27,15,2124,2226,1774,-452
2021,1,27,16,2163,2264,1810,-454
2021,1,27,17,2152,2255,1857,-398
2021,1,27,18,2111,2243,1858,-385
2021,1,27,19,2079,2213,1751,-462
2021,1,27,20,2010,2143,1724,-419
2021,1,27,21,1965,2085,1743,-342
2021,1,27,22,1939,2038,1671,-367
2021,1,27,23,1929,2035,1744,-291
2021,1,28,0,1970,2065,1814,-251
2021,1,28,1,2046,2139,2060,-79
2021,1,28,2,2121,2179,2045,-134
2021,1,28,3,2089,2146,2079,-67
2021,1,28,4,2035,2073,1912,-161
2021,1,28,5,1942,1984,1925,-59
2021,1,28,6,1822,1856,1880,24
2021,1,28,7,1740,1748,1821,73
2021,1,28,8,1680,1661,1665,4
2021,1,28,9,1681,1629,1367,-262
2021,1,28,10,1655,1614,1355,-259
2021,1,28,11,1664,1613,1330,-283
2021,1,28,12,1716,1650,1352,-298
2021,1,28,13,1823,1753,1477,-276
2021,1,28,14,1983,1927,1632,-295
2021,1,28,15,2115,2063,1767,-296
2021,1,28,16,2153,2085,1868,-217
2021,1,28,17,2154,2085,1754,-331
2021,1,28,18,2151,2076,1728,-348
2021,1,28,19,2102,2042,1686,-356
2021,1,28,20,2051,1987,1655,-332
2021,1,28,21,2013,1951,1554,-397
2021,1,28,22,1981,1923,1510,-413
2021,1,28,23,1984,1910,1673,-237
2021,1,29,0,2023,1950,1635,-315
2021,1,29,1,2095,1998,1724,-274
2021,1,29,2,2165,2033,1707,-326
2021,1,29,3,2124,1994,1540,-454
2021,1,29,4,2062,1928,1492,-436
2021,1,29,5,1965,1859,1599,-260
2021,1,29,6,1843,1750,1356,-394
2021,1,29,7,1751,1640,1204,-436
2021,1,29,8,1696,1587,1171,-416
2021,1,29,9,1647,1546,1073,-473
2021,1,29,10,1580,1554,1036,-518
2021,1,29,11,1591,1549,1068,-481
2021,1,29,12,1646,1591,1204,-387
2021,1,29,13,1752,1676,1320,-356
2021,1,29,14,1924,1835,1395,-440
2021,1,29,15,2063,1980,1517,-463
2021,1,29,16,2105,2038,1518,-520
2021,1,29,17,2117,2047,1438,-609
2021,1,29,18,2104,2038,1342,-696
2021,1,29,19,2059,2022,1231,-791
2021,1,29,20,2013,1986,1235,-751
2021,1,29,21,1980,1980,1219,-761
2021,1,29,22,1939,1949,1232,-717
2021,1,29,23,1953,1948,1398,-550
2021,1,30,0,1988,1947,1506,-441
2021,1,30,1,2009,1999,1592,-407
2021,1,30,2,2038,2053,1653,-400
2021,1,30,3,2017,2024,1647,-377
2021,1,30,4,1968,1969,1626,-343
2021,1,30,5,1900,1916,1499,-417
2021,1,30,6,1805,1824,1474,-350
2021,1,30,7,1734,1733,1359,-374
2021,1,30,8,1707,1671,1339,-332
2021,1,30,9,1649,1641,1345,-296
2021,1,30,10,1648,1628,1328,-300
2021,1,30,11,1648,1631,1269,-362
2021,1,30,12,1673,1668,1400,-268
2021,1,30,13,1737,1704,1433,-271
2021,1,30,14,1842,1796,1449,-347
2021,1,30,15,1936,1893,1519,-374
2021,1,30,16,2017,1972,1470,-502
2021,1,30,17,2066,1967,1477,-490
2021,1,30,18,2042,1913,1379,-534
2021,1,30,19,2008,1832,1349,-483
2021,1,30,20,1947,1790,1228,-562
2021,1,30,21,1886,1739,1088,-651
2021,1,30,22,1857,1717,974,-743
2021,1,30,23,1840,1698,1033,-665
2021,1,31,0,1870,1733,1245,-488
2021,1,31,1,1946,1808,1171,-637
2021,1,31,2,2040,1919,1177,-742
2021,1,31,3,1994,1920,1210,-710
2021,1,31,4,1942,1899,1305,-594
2021,1,31,5,1890,1850,1288,-562
2021,1,31,6,1806,1783,1266,-517
2021,1,31,7,1725,1709,1256,-453
2021,1,31,8,1672,1663,1251,-412
2021,1,31,9,1635,1627,1339,-288
2021,1,31,10,1611,1632,1376,-256
2021,1,31,11,1612,1630,1374,-256
2021,1,31,12,1635,1664,1377,-287
2021,1,31,13,1679,1719,1347,-372
2021,1,31,14,1755,1788,1229,-559
2021,1,31,15,1845,1876,1320,-556
2021,1,31,16,1936,1953,1380,-573
2021,1,31,17,1975,1941,1450,-491
2021,1,31,18,1945,1902,1518,-384
2021,1,31,19,1921,1850,1553,-297
2021,1,31,20,1886,1784,1555,-229
2021,1,31,21,1836,1730,1569,-161
2021,1,31,22,1786,1698,1611,-87
2021,1,31,23,1782,1683,1678,-5
2021,2,1,0,1818,1711,1644,-67
2021,2,1,1,1896,1827,1554,-273
2021,2,1,2,1975,1933,1549,-384
2021,2,1,3,1957,1931,1493,-438
2021,2,1,4,1924,1905,1545,-360
2021,2,1,5,1860,1836,1477,-359
2021,2,1,6,1765,1723,1445,-278
2021,2,1,7,1677,1632,1487,-145
2021,2,1,8,1644,1597,1506,-91
2021,2,1,9,1638,1572,1466,-106
2021,2,1,10,1610,1578,1469,-109
2021,2,1,11,1629,1595,1481,-114
2021,2,1,12,1678,1647,1518,-129
2021,2,1,13,1774,1750,1613,-137
2021,2,1,14,1951,1931,1621,-310
2021,2,1,15,2090,2085,1661,-424
2021,2,1,16,2145,2116,1642,-474
2021,2,1,17,2134,2100,1653,-447
2021,2,1,18,2066,2056,1667,-389
2021,2,1,19,2001,1996,1699,-297
2021,2,1,20,1935,1937,1661,-276
2021,2,1,21,1889,1893,1632,-261
2021,2,1,22,1856,1870,1661,-209
2021,2,1,23,1837,1844,1711,-133
2021,2,2,0,1864,1852,1764,-88
2021,2,2,1,1948,1915,1701,-214
2021,2,2,2,2032,2015,1694,-321
2021,2,2,3,2011,1988,1679,-309
2021,2,2,4,1970,1945,1675,-270
2021,2,2,5,1879,1864,1659,-205
2021,2,2,6,1771,1747,1508,-239
2021,2,2,7,1680,1635,1465,-170
2021,2,2,8,1639,1579,1481,-98
2021,2,2,9,1600,1561,1471,-90
2021,2,2,10,1576,1548,1431,-117
2021,2,2,11,1589,1554,1424,-130
2021,2,2,12,1630,1607,1562,-45
2021,2,2,13,1729,1711,1664,-47
2021,2,2,14,1905,1878,1634,-244
2021,2,2,15,2035,2021,1603,-418
2021,2,2,16,2063,2053,1616,-437
2021,2,2,17,2059,2026,1584,-442
2021,2,2,18,1996,1971,1455,-516
2021,2,2,19,1943,1924,1357,-567
2021,2,2,20,1901,1843,1357,-486
2021,2,2,21,1880,1785,1370,-415
2021,2,2,22,1859,1782,1253,-529
2021,2,2,23,1846,1770,1308,-462
2021,2,3,0,1866,1805,1388,-417
2021,2,3,1,1932,1881,1354,-527
2021,2,3,2,2022,1973,1369,-604
2021,2,3,3,2008,1940,1384,-556
2021,2,3,4,1965,1908,1403,-505
2021,2,3,5,1871,1818,1352,-466
2021,2,3,6,1762,1720,1323,-397
2021,2,3,7,1674,1622,1345,-277
2021,2,3,8,1636,1565,1323,-242
2021,2,3,9,1590,1564,1387,-177
2021,2,3,10,1591,1579,1414,-165
2021,2,3,11,1612,1580,1366,-214
2021,2,3,12,1671,1640,1289,-351
2021,2,3,13,1779,1751,1346,-405
2021,2,3,14,1981,1941,1509,-432
2021,2,3,15,2126,2089,1436,-653
2021,2,3,16,2173,2119,1402,-717
2021,2,3,17,2178,2093,1283,-810
2021,2,3,18,2133,2063,1216,-847
2021,2,3,19,2077,2005,1204,-801
2021,2,3,20,2011,1974,1196,-778
2021,2,3,21,1963,1930,1238,-692
2021,2,3,22,1940,1909,1331,-578
2021,2,3,23,1920,1897,1440,-457
2021,2,4,0,1934,1908,1510,-398
2021,2,4,1,2008,1983,1514,-469
2021,2,4,2,2106,2093,1600,-493
2021,2,4,3,2102,2099,1630,-469
2021,2,4,4,2050,2067,1669,-398
2021,2,4,5,1971,1983,1579,-404
2021,2,4,6,1858,1858,1387,-471
2021,2,4,7,1774,1762,1348,-414
2021,2,4,8,1715,1706,1258,-448
2021,2,4,9,1665,-9999,-9999,-9999
2021,2,4,10,1712,-9999,-9999,-9999
2021,2,4,11,1721,-9999,-9999,-9999
2021,2,4,12,1777,-9999,-9999,-9999
2021,2,4,13,1885,-9999,-9999,-9999
2021,2,4,14,2071,-9999,-9999,-9999
2021,2,4,15,2213,-9999,-9999,-9999
2021,2,4,16,2244,-9999,-9999,-9999
2021,2,4,17,2236,-9999,-9999,-9999
2021,2,4,18,2182,-9999,-9999,-9999
2021,2,4,19,2100,-9999,-9999,-9999
2021,2,4,20,2028,-9999,-9999,-9999
2021,2,4,21,1969,-9999,-9999,-9999
2021,2,4,22,1928,-9999,-9999,-9999
2021,2,4,23,1889,-9999,-9999,-9999
2021,2,5,0,1902,-9999,-9999,-9999
2021,2,5,1,1953,-9999,-9999,-9999
2021,2,5,2,2066,-9999,-9999,-9999
2021,2,5,3,2064,-9999,-9999,-9999
2021,2,5,4,2010,-9999,-9999,-9999
2021,2,5,5,1935,-9999,-9999,-9999
2021,2,5,6,1823,-9999,-9999,-9999
2021,2,5,7,1733,-9999,-9999,-9999
2021,2,5,8,1648,-9999,-9999,-9999
