Year,Month,Day,Hour,Forecast_Demand_MWh,Adjusted_Demand_MWh,Adjusted_Generation_MWh,Adjusted_Interchange_MWh
2015,7,1,5,11810,12583,11322,-1261
2015,7,1,6,11190,12349,11376,-973
2015,7,1,7,10860,12445,11305,-1140
2015,7,1,8,10760,12385,11303,-1082
2015,7,1,9,11200,12387,11460,-927
2015,7,1,10,11830,12931,11817,-1114
2015,7,1,11,13200,13655,12358,-1297
2015,7,1,12,14640,14740,13630,-1110
2015,7,1,13,15530,15669,14357,-1312
2015,7,1,14,16160,16275,14684,-1591
2015,7,1,15,16750,16801,15202,-1599
2015,7,1,16,17160,17112,15482,-1630
2015,7,1,17,17450,17218,15560,-1658
2015,7,1,18,17830,17569,15763,-1806
2015,7,1,19,18060,17846,16163,-1683
2015,7,1,20,18180,18117,16443,-1674
2015,7,1,21,18260,18354,16771,-1583
2015,7,1,22,18190,18456,16906,-1550
2015,7,1,23,17820,18150,16488,-1662
2015,7,2,0,17410,17653,16007,-1646
2015,7,2,1,17290,17286,15468,-1818
2015,7,2,2,16720,16701,14882,-1819
2015,7,2,3,15240,15220,13830,-1390
2015,7,2,4,13690,13594,12151,-1443
2015,7,2,5,12460,13011,11606,-1405
2015,7,2,6,11770,12881,11648,-1233
2015,7,2,7,11320,12635,11237,-1398
2015,7,2,8,11090,12426,11085,-1341
2015,7,2,9,11190,12459,11109,-1350
2015,7,2,10,11580,12942,11656,-1286
2015,7,2,11,13030,13642,12557,-1085
2015,7,2,12,14380,14158,13124,-1034
2015,7,2,13,15220,15123,14120,-1003
2015,7,2,14,15860,15784,14661,-1123
2015,7,2,15,16450,16339,15030,-1309
2015,7,2,16,16880,16730,15205,-1525
2015,7,2,17,17030,16988,15328,-1660
2015,7,2,18,17370,17270,15646,-1624
2015,7,2,19,17770,17394,15860,-1534
2015,7,2,20,17930,17342,15794,-1548
2015,7,2,21,18200,17280,15573,-1707
2015,7,2,22,18000,17139,15336,-1803
2015,7,2,23,17520,16726,14943,-1783
2015,7,3,0,16950,16305,14608,-1697
2015,7,3,1,16730,16178,14409,-1769
2015,7,3,2,16140,15779,14308,-1471
2015,7,3,3,14690,14564,13521,-1043
2015,7,3,4,13250,13356,12292,-1064
2015,7,3,5,12130,12463,11312,-1151
2015,7,3,6,11340,11827,11003,-824
2015,7,3,7,10850,11543,10788,-755
2015,7,3,8,10560,11491,10781,-710
2015,7,3,9,10340,11705,10922,-783
2015,7,3,10,10380,11785,10666,-1119
2015,7,3,11,10830,11714,10899,-815
2015,7,3,12,11800,12415,11388,-1027
2015,7,3,13,12860,13099,12052,-1047
2015,7,3,14,13660,13793,12840,-953
2015,7,3,15,14170,14295,13421,-874
2015,7,3,16,14480,14614,13470,-1144
2015,7,3,17,14670,14792,13754,-1038
2015,7,3,18,14760,14984,13878,-1106
2015,7,3,19,14820,15227,14071,-1156
2015,7,3,20,14860,15551,14482,-1069
2015,7,3,21,14830,15947,14826,-1121
2015,7,3,22,14910,16186,15143,-1043
2015,7,3,23,14830,15858,14978,-880
2015,7,4,0,14660,15256,14273,-983
2015,7,4,1,14510,14964,14000,-964
2015,7,4,2,14490,14578,13604,-974
2015,7,4,3,13500,13600,12707,-893
2015,7,4,4,12310,12491,11715,-776
2015,7,4,5,11410,11669,11010,-659
2015,7,4,6,10840,11348,10590,-758
2015,7,4,7,10520,11348,10270,-1078
2015,7,4,8,10330,11349,10211,-1138
2015,7,4,9,10270,11283,10283,-1000
2015,7,4,10,10090,11274,10233,-1041
2015,7,4,11,10420,11574,10484,-1090
2015,7,4,12,11230,11956,11218,-738
2015,7,4,13,12580,12243,11525,-718
2015,7,4,14,13530,12809,12030,-779
2015,7,4,15,14150,13352,12686,-666
2015,7,4,16,14480,13635,12837,-798
2015,7,4,17,14650,13828,13059,-769
2015,7,4,18,14680,13749,12893,-856
2015,7,4,19,14860,13511,12566,-945
2015,7,4,20,14890,13334,12372,-962
2015,7,4,21,14820,13297,12349,-948
2015,7,4,22,14860,13386,12405,-981
2015,7,4,23,14860,13371,12491,-880
2015,7,5,0,14600,13208,12524,-684
2015,7,5,1,14350,13137,12372,-765
2015,7,5,2,14020,12953,12344,-609
2015,7,5,3,13070,12421,11713,-708
2015,7,5,4,11980,11655,11168,-487
2015,7,5,5,10980,10803,10455,-348
2015,7,5,6,10420,10678,10381,-297
2015,7,5,7,10020,10755,10405,-350
2015,7,5,8,9790,10711,10303,-408
2015,7,5,9,9740,10885,10326,-559
2015,7,5,10,9620,10675,10342,-333
2015,7,5,11,10020,10368,10446,78
2015,7,5,12,10950,10611,10808,197
2015,7,5,13,12030,11543,11539,-4
2015,7,5,14,13010,12519,12007,-512
2015,7,5,15,13790,13338,12627,-711
2015,7,5,16,14430,13975,13287,-688
2015,7,5,17,14840,14510,14082,-428
2015,7,5,18,15190,14883,14002,-881
2015,7,5,19,15540,15226,14288,-938
2015,7,5,20,15740,15647,14705,-942
2015,7,5,21,16300,16138,14696,-1442
2015,7,5,22,16670,16595,15247,-1348
2015,7,5,23,16580,16653,15470,-1183
2015,7,6,0,16260,16440,15442,-998
2015,7,6,1,16140,16383,14972,-1411
2015,7,6,2,15810,16084,15156,-928
2015,7,6,3,14580,14848,14383,-465
2015,7,6,4,13360,13411,12850,-561
2015,7,6,5,12080,12775,12073,-702
2015,7,6,6,11480,12634,12030,-604
2015,7,6,7,11090,12607,11992,-615
2015,7,6,8,10960,12590,12016,-574
2015,7,6,9,11130,12640,11983,-657
2015,7,6,10,11750,12575,11953,-622
2015,7,6,11,13250,13004,12449,-555
2015,7,6,12,14840,14476,13836,-640
2015,7,6,13,15920,15660,14843,-817
2015,7,6,14,16810,16665,15852,-813
2015,7,6,15,17690,17625,16720,-905
2015,7,6,16,18350,18394,17444,-950
2015,7,6,17,18870,18838,17521,-1317
2015,7,6,18,19420,19262,17925,-1337
2015,7,6,19,19790,19504,18032,-1472
2015,7,6,20,20080,19680,18282,-1398
2015,7,6,21,20340,19896,18601,-1295
2015,7,6,22,20170,20011,18966,-1045
2015,7,6,23,19730,19683,18562,-1121
2015,7,7,0,19080,19154,17852,-1302
2015,7,7,1,18790,18843,17354,-1489
2015,7,7,2,17950,18103,16899,-1204
2015,7,7,3,16300,16373,14982,-1391
2015,7,7,4,14680,15134,13164,-1970
2015,7,7,5,13240,14126,12822,-1304
2015,7,7,6,12470,13627,12504,-1123
2015,7,7,7,11980,13608,12031,-1577
2015,7,7,8,11780,13501,11428,-2073
2015,7,7,9,11910,13659,12014,-1645
2015,7,7,10,12600,14141,12664,-1477
2015,7,7,11,14050,14813,13423,-1390
2015,7,7,12,15650,16068,14661,-1407
2015,7,7,13,16710,16864,15785,-1079
2015,7,7,14,17550,17751,16755,-996
2015,7,7,15,18420,18678,17163,-1515
2015,7,7,16,19180,19376,17471,-1905
2015,7,7,17,19670,19910,17966,-1944
2015,7,7,18,20190,20424,18405,-2019
2015,7,7,19,20590,20699,18750,-1949
2015,7,7,20,20820,20835,19174,-1661
2015,7,7,21,21020,20867,19107,-1760
2015,7,7,22,20720,20831,18779,-2052
2015,7,7,23,20320,20474,18410,-2064
2015,7,8,0,19790,20000,17833,-2167
2015,7,8,1,19520,19794,17422,-2372
2015,7,8,2,18750,19039,16849,-2190
2015,7,8,3,17110,17421,15314,-2107
2015,7,8,4,15430,16032,14210,-1822
2015,7,8,5,14510,15512,13939,-1573
2015,7,8,6,13710,15199,13501,-1698
2015,7,8,7,13190,14746,13115,-1631
2015,7,8,8,12930,14464,12860,-1604
2015,7,8,9,13100,14589,13101,-1488
2015,7,8,10,13730,14968,13284,-1684
2015,7,8,11,15150,15884,14123,-1761
2015,7,8,12,16810,17112,15303,-1809
2015,7,8,13,17950,17857,16118,-1739
2015,7,8,14,18840,18572,16706,-1866
2015,7,8,15,19670,19338,17300,-2038
2015,7,8,16,20330,20077,17765,-2312
2015,7,8,17,20860,20625,18368,-2257
2015,7,8,18,21300,21114,18943,-2171
2015,7,8,19,21600,21407,19094,-2313
2015,7,8,20,21740,21497,19047,-2450
2015,7,8,21,21810,21512,19490,-2022
2015,7,8,22,21580,21340,19477,-1863
2015,7,8,23,20920,20865,18550,-2315
2015,7,9,0,20240,20138,17939,-2199
2015,7,9,1,19810,19668,17736,-1932
2015,7,9,2,18940,18789,17004,-1785
2015,7,9,3,17120,16971,15436,-1535
2015,7,9,4,15330,15323,13825,-1498
2015,7,9,5,13840,14004,12775,-1229
2015,7,9,6,12950,13562,12346,-1216
2015,7,9,7,12410,13381,11838,-1543
2015,7,9,8,12170,13019,11965,-1054
2015,7,9,9,12200,13025,12049,-976
2015,7,9,10,12550,13505,12698,-807
2015,7,9,11,13830,13941,13446,-495
2015,7,9,12,15150,14967,14554,-413
2015,7,9,13,16030,15762,15182,-580
2015,7,9,14,16600,16240,15280,-960
2015,7,9,15,17100,16666,15486,-1180
2015,7,9,16,17570,16952,15730,-1222
2015,7,9,17,17790,17145,15777,-1368
2015,7,9,18,18100,17508,16013,-1495
2015,7,9,19,18270,17663,15994,-1669
2015,7,9,20,18340,17724,15982,-1742
2015,7,9,21,18400,17799,15973,-1826
2015,7,9,22,18290,17693,15768,-1925
2015,7,9,23,17860,17350,15692,-1658
2015,7,10,0,17430,17043,15512,-1531
2015,7,10,1,17330,16991,15525,-1466
2015,7,10,2,16820,16392,15166,-1226
2015,7,10,3,15340,15007,13610,-1397
2015,7,10,4,13900,13574,12351,-1223
2015,7,10,5,12800,12940,11437,-1503
2015,7,10,6,12170,12637,11388,-1249
2015,7,10,7,11810,12559,11441,-1118
2015,7,10,8,11610,12417,11242,-1175
2015,7,10,9,11670,12516,11273,-1243
2015,7,10,10,12180,13077,11848,-1229
2015,7,10,11,13420,13712,12770,-942
2015,7,10,12,14870,14813,13561,-1252
2015,7,10,13,15790,15615,14395,-1220
2015,7,10,14,16580,16253,15075,-1178
2015,7,10,15,17170,16819,15399,-1420
2015,7,10,16,17650,17349,15903,-1446
2015,7,10,17,17940,17648,16197,-1451
2015,7,10,18,18340,17963,16553,-1410
2015,7,10,19,18650,18197,16786,-1411
2015,7,10,20,18850,18431,16996,-1435
2015,7,10,21,19000,18666,17217,-1449
2015,7,10,22,18800,18688,17227,-1461
2015,7,10,23,18200,18296,16671,-1625
2015,7,11,0,17480,17663,15960,-1703
2015,7,11,1,17270,17255,15440,-1815
2015,7,11,2,16700,16814,15142,-1672
2015,7,11,3,15380,15499,13984,-1515
2015,7,11,4,13910,14234,13134,-1100
2015,7,11,5,12890,12817,11311,-1506
2015,7,11,6,12050,11882,10885,-997
2015,7,11,7,11580,11890,10622,-1268
2015,7,11,8,11250,12001,10447,-1554
2015,7,11,9,11150,11966,10466,-1500
2015,7,11,10,10960,11762,10458,-1304
2015,7,11,11,11390,12048,10510,-1538
2015,7,11,12,12380,12524,11312,-1212
2015,7,11,13,13530,13772,12181,-1591
2015,7,11,14,14790,14857,13351,-1506
2015,7,11,15,15690,15700,13865,-1835
2015,7,11,16,16430,16345,14395,-1950
2015,7,11,17,16990,16781,14947,-1834
2015,7,11,18,17430,17103,15059,-2044
2015,7,11,19,17780,17407,15329,-2078
2015,7,11,20,18110,17806,15558,-2248
2015,7,11,21,18370,18196,16019,-2177
2015,7,11,22,18430,18480,16214,-2266
2015,7,11,23,18160,18400,15862,-2538
2015,7,12,0,17660,17888,15299,-2589
2015,7,12,1,17350,17515,15126,-2389
2015,7,12,2,16900,17081,14891,-2190
2015,7,12,3,15700,15884,13583,-2301
2015,7,12,4,14290,14587,12499,-2088
2015,7,12,5,13100,13361,11573,-1788
2015,7,12,6,12360,12462,11187,-1275
2015,7,12,7,11800,12165,11096,-1069
2015,7,12,8,11360,12151,10739,-1412
2015,7,12,9,11260,12149,10653,-1496
2015,7,12,10,11220,11991,10413,-1578
2015,7,12,11,11520,12480,10729,-1751
2015,7,12,12,12490,13251,11611,-1640
2015,7,12,13,13730,14056,12158,-1898
2015,7,12,14,14940,14866,12732,-2134
2015,7,12,15,16000,16020,13660,-2360
2015,7,12,16,16960,17041,14379,-2662
2015,7,12,17,17790,17832,15096,-2736
2015,7,12,18,18400,18371,15483,-2888
2015,7,12,19,18940,18827,15902,-2925
2015,7,12,20,19490,19319,16484,-2835
2015,7,12,21,19950,19763,16882,-2881
2015,7,12,22,20190,20069,17059,-3010
2015,7,12,23,20030,19963,16716,-3247
2015,7,13,0,19640,19591,16312,-3279
2015,7,13,1,19310,19468,16705,-2763
2015,7,13,2,18650,19004,16719,-2285
2015,7,13,3,17150,17433,14897,-2536
2015,7,13,4,15590,15685,13479,-2206
2015,7,13,5,14520,14398,12387,-2011
2015,7,13,6,13650,13699,11911,-1788
2015,7,13,7,13120,13808,12041,-1767
2015,7,13,8,12830,13584,11845,-1739
2015,7,13,9,12890,13672,11922,-1750
2015,7,13,10,13460,14027,12110,-1917
2015,7,13,11,15000,14903,12757,-2146
2015,7,13,12,16740,16424,13924,-2500
2015,7,13,13,17890,17567,15239,-2328
2015,7,13,14,18860,18480,16335,-2145
2015,7,13,15,19760,19336,17275,-2061
2015,7,13,16,20430,20003,18025,-1978
2015,7,13,17,20900,20500,18586,-1914
2015,7,13,18,21300,20915,19144,-1771
2015,7,13,19,21520,20990,19519,-1471
2015,7,13,20,21470,20975,19125,-1850
2015,7,13,21,21340,21027,19190,-1837
2015,7,13,22,21080,20950,18862,-2088
2015,7,13,23,20520,20481,18014,-2467
2015,7,14,0,19920,19759,17611,-2148
2015,7,14,1,19490,19266,16951,-2315
2015,7,14,2,18620,18457,16151,-2306
2015,7,14,3,16840,16655,14601,-2054
2015,7,14,4,15060,14902,12891,-2011
2015,7,14,5,13540,13601,11977,-1624
2015,7,14,6,12730,13335,11940,-1395
2015,7,14,7,12230,13262,11811,-1451
2015,7,14,8,11990,13293,11518,-1775
2015,7,14,9,12260,13456,11773,-1683
2015,7,14,10,12900,14058,12073,-1985
2015,7,14,11,14250,14655,12688,-1967
2015,7,14,12,15710,16011,13908,-2103
2015,7,14,13,16620,17114,15262,-1852
2015,7,14,14,17310,17975,16204,-1771
2015,7,14,15,18000,18632,16722,-1910
2015,7,14,16,18590,18972,16943,-2029
2015,7,14,17,19060,19170,17185,-1985
2015,7,14,18,19480,19616,17325,-2291
2015,7,14,19,19730,19905,17573,-2332
2015,7,14,20,19800,19930,17536,-2394
2015,7,14,21,19950,19759,17413,-2346
2015,7,14,22,19800,19637,17061,-2576
2015,7,14,23,19630,19536,17178,-2358
2015,7,15,0,19100,19221,17100,-2121
2015,7,15,1,18870,19165,17116,-2049
2015,7,15,2,18130,18545,16120,-2425
2015,7,15,3,16500,17080,14406,-2674
2015,7,15,4,14880,15631,13332,-2299
2015,7,15,5,13940,14560,12432,-2128
2015,7,15,6,13180,14361,12089,-2272
2015,7,15,7,12740,14373,11831,-2542
2015,7,15,8,12530,14277,11712,-2565
2015,7,15,9,12870,14405,11910,-2495
2015,7,15,10,13530,14846,12546,-2300
2015,7,15,11,14960,15716,13303,-2413
2015,7,15,12,16470,16837,14721,-2116
2015,7,15,13,17380,17893,15895,-1998
2015,7,15,14,18090,18763,16561,-2202
2015,7,15,15,18790,19580,16895,-2685
2015,7,15,16,19300,20169,17314,-2855
2015,7,15,17,19640,20539,17501,-3038
2015,7,15,18,19930,20904,17827,-3077
2015,7,15,19,19980,20974,17949,-3025
2015,7,15,20,20000,20839,17631,-3208
2015,7,15,21,20100,20668,17702,-2966
2015,7,15,22,19780,20289,17432,-2857
2015,7,15,23,19370,19627,17092,-2535
2015,7,16,0,18860,18847,16216,-2631
2015,7,16,1,18450,18333,15852,-2481
2015,7,16,2,17580,17428,15126,-2302
2015,7,16,3,15900,15874,13645,-2229
2015,7,16,4,14290,14342,12310,-2032
2015,7,16,5,12960,13540,11257,-2283
2015,7,16,6,12130,13094,10836,-2258
2015,7,16,7,11620,12970,10573,-2397
2015,7,16,8,11340,12754,10381,-2373
2015,7,16,9,11320,12799,10326,-2473
2015,7,16,10,11860,13168,10903,-2265
2015,7,16,11,13100,13305,11038,-2267
2015,7,16,12,14410,14393,12229,-2164
2015,7,16,13,15200,14873,13027,-1846
2015,7,16,14,15860,15319,13131,-2188
2015,7,16,15,16310,15914,13648,-2266
2015,7,16,16,16620,15955,14012,-1943
2015,7,16,17,16820,16079,13999,-2080
2015,7,16,18,17150,16325,14207,-2118
2015,7,16,19,17360,16503,14424,-2079
2015,7,16,20,17510,16698,15021,-1677
2015,7,16,21,17650,16981,15198,-1783
2015,7,16,22,17550,17119,15478,-1641
2015,7,16,23,17250,16892,15234,-1658
2015,7,17,0,16700,16410,14492,-1918
2015,7,17,1,16560,16191,14398,-1793
2015,7,17,2,15950,15734,14057,-1677
2015,7,17,3,14520,14338,12359,-1979
2015,7,17,4,13030,12918,10925,-1993
2015,7,17,5,11720,12039,10250,-1789
2015,7,17,6,11090,11355,10005,-1350
2015,7,17,7,10720,11490,9991,-1499
2015,7,17,8,10500,11340,9801,-1539
2015,7,17,9,10660,11473,9816,-1657
2015,7,17,10,11250,11723,10000,-1723
2015,7,17,11,12460,12765,10882,-1883
2015,7,17,12,14010,13807,12170,-1637
2015,7,17,13,15050,14726,13226,-1500
2015,7,17,14,15730,15390,13944,-1446
2015,7,17,15,16320,15996,14115,-1881
2015,7,17,16,16790,16459,14596,-1863
2015,7,17,17,17080,16771,15018,-1753
2015,7,17,18,17440,17160,15271,-1889
2015,7,17,19,17650,17388,15513,-1875
2015,7,17,20,17800,17523,15690,-1833
2015,7,17,21,17960,17637,15947,-1690
2015,7,17,22,17850,17649,15933,-1716
2015,7,17,23,17450,17190,15121,-2069
2015,7,18,0,16860,16666,14525,-2141
2015,7,18,1,16570,16568,14526,-2042
2015,7,18,2,16130,16128,14246,-1882
2015,7,18,3,14900,14946,12954,-1992
2015,7,18,4,13510,13649,11656,-1993
2015,7,18,5,12230,12574,11076,-1498
2015,7,18,6,11600,12176,11174,-1002
2015,7,18,7,11200,11777,10914,-863
2015,7,18,8,11010,11633,10814,-819
2015,7,18,9,10960,11819,10929,-890
2015,7,18,10,11380,12021,10874,-1147
2015,7,18,11,11850,12491,11356,-1135
2015,7,18,12,12780,13008,12046,-962
2015,7,18,13,13850,14143,12700,-1443
2015,7,18,14,14770,14779,13274,-1505
2015,7,18,15,15430,15279,13493,-1786
2015,7,18,16,15920,15509,13751,-1758
2015,7,18,17,16150,15629,13788,-1841
2015,7,18,18,16300,15766,13904,-1862
2015,7,18,19,16380,15841,14143,-1698
2015,7,18,20,16590,16085,14531,-1554
2015,7,18,21,16870,16460,14935,-1525
2015,7,18,22,17200,16770,15268,-1502
2015,7,18,23,17050,16819,15251,-1568
2015,7,19,0,16780,16657,15080,-1577
2015,7,19,1,16840,16699,14968,-1731
2015,7,19,2,16550,16465,14604,-1861
2015,7,19,3,15540,15438,13710,-1728
2015,7,19,4,14320,14279,12851,-1428
2015,7,19,5,13400,13293,12009,-1284
2015,7,19,6,12690,12958,12014,-944
2015,7,19,7,12230,12778,12036,-742
2015,7,19,8,11940,12517,11735,-782
2015,7,19,9,11840,12426,11585,-841
2015,7,19,10,11870,12458,11455,-1003
2015,7,19,11,12150,12770,11772,-998
2015,7,19,12,13080,13575,12550,-1025
2015,7,19,13,14340,14988,13587,-1401
2015,7,19,14,15660,16248,14601,-1647
2015,7,19,15,16840,17522,15888,-1634
2015,7,19,16,17890,18636,16758,-1878
2015,7,19,17,18730,19517,17365,-2152
2015,7,19,18,19340,20094,17890,-2204
2015,7,19,19,19900,20354,17892,-2462
2015,7,19,20,20440,20522,17806,-2716
2015,7,19,21,20950,20904,18267,-2637
2015,7,19,22,21370,21290,18958,-2332
2015,7,19,23,21200,21142,18749,-2393
2015,7,20,0,20780,20788,18122,-2666
2015,7,20,1,20600,20690,18152,-2538
2015,7,20,2,19980,19878,17407,-2471
2015,7,20,3,18440,18326,15865,-2461
2015,7,20,4,16840,16938,14618,-2320
2015,7,20,5,15600,16223,14092,-2131
2015,7,20,6,14820,15725,13828,-1897
2015,7,20,7,14320,15478,13322,-2156
2015,7,20,8,14050,15274,12788,-2486
2015,7,20,9,14130,15534,13193,-2341
2015,7,20,10,14680,16157,13663,-2494
2015,7,20,11,16190,16634,14354,-2280
2015,7,20,12,17860,18149,16243,-1906
2015,7,20,13,19310,19750,17853,-1897
2015,7,20,14,20550,21013,18632,-2381
2015,7,20,15,22070,22137,19290,-2847
2015,7,20,16,22970,22970,19948,-3022
2015,7,20,17,23500,23474,20487,-2987
2015,7,20,18,23990,23930,20799,-3131
2015,7,20,19,24150,24087,20644,-3443
2015,7,20,20,24270,24174,20665,-3509
2015,7,20,21,24300,24298,20975,-3323
2015,7,20,22,23970,24287,20881,-3406
2015,7,20,23,23210,23818,20249,-3569
2015,7,21,0,22460,23021,19415,-3606
2015,7,21,1,21930,22482,19019,-3463
2015,7,21,2,20690,21419,18340,-3079
2015,7,21,3,18610,19303,16345,-2958
2015,7,21,4,16650,17385,14805,-2580
2015,7,21,5,15030,16428,13789,-2639
2015,7,21,6,14140,16070,13517,-2553
2015,7,21,7,13560,15459,12642,-2817
2015,7,21,8,13250,15225,12271,-2954
2015,7,21,9,13700,15295,12504,-2791
2015,7,21,10,14240,15646,12832,-2814
2015,7,21,11,15610,16310,13526,-2784
2015,7,21,12,17150,17210,14632,-2578
2015,7,21,13,18200,17943,15057,-2886
2015,7,21,14,19070,18498,15540,-2958
2015,7,21,15,19890,19179,16297,-2882
2015,7,21,16,20690,19778,16831,-2947
2015,7,21,17,21310,20288,17537,-2751
2015,7,21,18,21900,20971,18046,-2925
2015,7,21,19,22370,21490,18306,-3184
2015,7,21,20,22620,22035,18819,-3216
2015,7,21,21,22750,22398,19290,-3108
2015,7,21,22,22580,22549,19286,-3263
2015,7,21,23,21820,21977,18816,-3161
2015,7,22,0,21170,21199,17995,-3204
2015,7,22,1,20820,20691,17583,-3108
2015,7,22,2,19830,19794,16630,-3164
2015,7,22,3,17970,17947,15120,-2827
2015,7,22,4,16120,16043,13489,-2554
2015,7,22,5,14640,15114,12581,-2533
2015,7,22,6,13690,14527,12452,-2075
2015,7,22,7,13070,14027,12419,-1608
2015,7,22,8,12730,13787,12182,-1605
2015,7,22,9,12610,13945,11909,-2036
2015,7,22,10,13170,14092,12079,-2013
2015,7,22,11,14390,15133,12788,-2345
2015,7,22,12,15780,15778,13459,-2319
2015,7,22,13,16720,16684,14439,-2245
2015,7,22,14,17360,17322,14939,-2383
2015,7,22,15,17980,17903,15615,-2288
2015,7,22,16,18440,18341,15685,-2656
2015,7,22,17,18740,18690,15959,-2731
2015,7,22,18,19110,19132,16218,-2914
2015,7,22,19,19320,19364,16515,-2849
2015,7,22,20,19400,19517,16845,-2672
2015,7,22,21,19500,19572,16902,-2670
2015,7,22,22,19320,19494,16879,-2615
2015,7,22,23,18830,18971,16392,-2579
2015,7,23,0,18320,18328,15719,-2609
2015,7,23,1,18040,18004,15470,-2534
2015,7,23,2,17330,17408,15098,-2310
2015,7,23,3,15730,15842,13805,-2037
2015,7,23,4,14110,14345,12564,-1781
2015,7,23,5,12920,13022,11667,-1355
2015,7,23,6,12150,12704,11632,-1072
2015,7,23,7,11660,12534,11694,-840
2015,7,23,8,11430,12245,11068,-1177
2015,7,23,9,11540,12299,11048,-1251
2015,7,23,10,12140,12626,11582,-1044
2015,7,23,11,13410,13605,12493,-1112
2015,7,23,12,14830,14834,13584,-1250
2015,7,23,13,15730,15814,14150,-1664
2015,7,23,14,16380,16493,14812,-1681
2015,7,23,15,17120,17099,15357,-1742
2015,7,23,16,17560,17583,15564,-2019
2015,7,23,17,17810,17942,15838,-2104
2015,7,23,18,18210,18361,16428,-1933
2015,7,23,19,18470,18572,16559,-2013
2015,7,23,20,18610,18649,16624,-2025
2015,7,23,21,18750,18760,16822,-1938
2015,7,23,22,18620,18720,16837,-1883
2015,7,23,23,18150,18397,16309,-2088
2015,7,24,0,17650,17867,15975,-1892
2015,7,24,1,17480,17678,15711,-1967
2015,7,24,2,16820,17088,15376,-1712
2015,7,24,3,15280,15588,13936,-1652
2015,7,24,4,13760,14049,12798,-1251
2015,7,24,5,12620,12825,11960,-865
2015,7,24,6,11900,12311,11545,-766
2015,7,24,7,11440,12335,11334,-1001
2015,7,24,8,11220,12367,11393,-974
2015,7,24,9,11370,12249,11359,-890
2015,7,24,10,11950,12525,11467,-1058
2015,7,24,11,13170,13391,11810,-1581
2015,7,24,12,14630,14491,13179,-1312
2015,7,24,13,15590,15549,14150,-1399
2015,7,24,14,16240,16267,15006,-1261
2015,7,24,15,16800,16882,15185,-1697
2015,7,24,16,17230,17360,15340,-2020
2015,7,24,17,17470,17682,15846,-1836
2015,7,24,18,17820,17921,16061,-1860
2015,7,24,19,17980,18027,16108,-1919
2015,7,24,20,18030,18068,16201,-1867
2015,7,24,21,18100,18039,16371,-1668
2015,7,24,22,17950,17856,16137,-1719
2015,7,24,23,17450,17349,15680,-1669
2015,7,25,0,16910,16759,15329,-1430
2015,7,25,1,16690,16574,14894,-1680
2015,7,25,2,16210,16084,14476,-1608
2015,7,25,3,14970,14836,13753,-1083
2015,7,25,4,13630,13491,12509,-982
2015,7,25,5,12430,12639,11920,-719
2015,7,25,6,11730,11886,11351,-535
2015,7,25,7,11270,11770,10987,-783
2015,7,25,8,10980,11894,11012,-882
2015,7,25,9,10910,11892,11102,-790
2015,7,25,10,10810,11732,10933,-799
2015,7,25,11,11250,11967,11047,-920
2015,7,25,12,12280,12577,11809,-768
2015,7,25,13,13430,13336,12428,-908
2015,7,25,14,14290,14180,13034,-1146
2015,7,25,15,14920,14711,13379,-1332
2015,7,25,16,15340,15052,13820,-1232
2015,7,25,17,15570,15195,13904,-1291
2015,7,25,18,15670,15230,13738,-1492
2015,7,25,19,15800,15283,13766,-1517
2015,7,25,20,15970,15404,13954,-1450
2015,7,25,21,16150,15585,14293,-1292
2015,7,25,22,16350,15694,14538,-1156
2015,7,25,23,16100,15541,14029,-1512
2015,7,26,0,15800,15194,13797,-1397
2015,7,26,1,15740,15276,13526,-1750
2015,7,26,2,15410,14944,13660,-1284
2015,7,26,3,14380,14113,13252,-861
2015,7,26,4,13200,12987,12647,-340
2015,7,26,5,11980,12508,11714,-794
2015,7,26,6,11360,11954,11260,-694
2015,7,26,7,10990,11802,11017,-785
2015,7,26,8,10780,11592,10792,-800
2015,7,26,9,10720,11793,10996,-797
2015,7,26,10,10730,12206,10947,-1259
2015,7,26,11,11040,12471,11083,-1388
2015,7,26,12,11800,12566,11644,-922
2015,7,26,13,12800,12844,12035,-809
2015,7,26,14,13820,13771,12749,-1022
2015,7,26,15,14600,14486,13280,-1206
2015,7,26,16,15220,14975,13603,-1372
2015,7,26,17,15680,15401,13861,-1540
2015,7,26,18,15980,15782,14298,-1484
2015,7,26,19,16190,16036,14550,-1486
2015,7,26,20,16510,16300,14788,-1512
2015,7,26,21,16910,16682,15047,-1635
2015,7,26,22,17170,17001,15379,-1622
2015,7,26,23,17350,17021,15356,-1665
2015,7,27,0,17080,16871,15119,-1752
2015,7,27,1,16980,16922,15027,-1895
2015,7,27,2,16710,16487,14840,-1647
2015,7,27,3,15440,15293,14171,-1122
2015,7,27,4,14150,13956,12571,-1385
2015,7,27,5,13020,13512,11728,-1784
2015,7,27,6,12370,13562,11770,-1792
2015,7,27,7,12050,13493,11778,-1715
2015,7,27,8,11920,13423,11959,-1464
2015,7,27,9,12170,13437,12070,-1367
2015,7,27,10,12900,13872,12144,-1728
2015,7,27,11,14320,14680,12744,-1936
2015,7,27,12,15890,15590,13954,-1636
2015,7,27,13,16940,16714,14815,-1899
2015,7,27,14,17870,17553,15794,-1759
2015,7,27,15,18710,18278,16398,-1880
2015,7,27,16,19330,18885,16896,-1989
2015,7,27,17,19790,19340,17400,-1940
2015,7,27,18,20220,19804,18075,-1729
2015,7,27,19,20610,20277,18798,-1479
2015,7,27,20,20870,20615,19234,-1381
2015,7,27,21,21000,20815,19488,-1327
2015,7,27,22,20910,20756,19450,-1306
2015,7,27,23,20430,20383,18630,-1753
2015,7,28,0,19950,19792,17898,-1894
2015,7,28,1,19530,19566,17661,-1905
2015,7,28,2,18680,18733,16825,-1908
2015,7,28,3,16970,17037,15225,-1812
2015,7,28,4,15280,15769,14016,-1753
2015,7,28,5,14280,14918,12875,-2043
2015,7,28,6,13500,14416,12466,-1950
2015,7,28,7,13030,13975,12013,-1962
2015,7,28,8,12790,13963,12030,-1933
2015,7,28,9,12910,13857,12191,-1666
2015,7,28,10,13460,14289,12509,-1780
2015,7,28,11,14830,15066,12989,-2077
2015,7,28,12,16460,16464,14724,-1740
2015,7,28,13,17590,17618,15676,-1942
2015,7,28,14,18640,18702,16296,-2406
2015,7,28,15,19590,19832,17175,-2657
2015,7,28,16,20470,20806,18120,-2686
2015,7,28,17,21140,21631,19014,-2617
2015,7,28,18,21880,22365,19909,-2456
2015,7,28,19,22370,22815,20298,-2517
2015,7,28,20,22700,23012,20522,-2490
2015,7,28,21,23010,23083,20551,-2532
2015,7,28,22,22830,22972,20449,-2523
2015,7,28,23,22190,22452,19909,-2543
2015,7,29,0,21610,21730,18891,-2839
2015,7,29,1,21400,21389,18505,-2884
2015,7,29,2,20400,20440,17836,-2604
2015,7,29,3,18530,18660,16121,-2539
2015,7,29,4,16670,17048,14674,-2374
2015,7,29,5,15270,15948,13410,-2538
2015,7,29,6,14370,15464,13190,-2274
2015,7,29,7,13800,15154,13318,-1836
2015,7,29,8,13520,14839,13284,-1555
2015,7,29,9,13570,14598,13189,-1409
2015,7,29,10,13960,14513,12724,-1789
2015,7,29,11,15320,15209,13092,-2117
2015,7,29,12,17080,16959,14523,-2436
2015,7,29,13,18360,18434,15921,-2513
2015,7,29,14,19550,19748,17025,-2723
2015,7,29,15,20750,21063,18281,-2782
2015,7,29,16,21810,22145,19208,-2937
2015,7,29,17,22740,22876,19654,-3222
2015,7,29,18,23590,23538,20379,-3159
2015,7,29,19,24110,23852,20838,-3014
2015,7,29,20,24420,24051,21269,-2782
2015,7,29,21,24600,24300,21555,-2745
2015,7,29,22,24420,24329,21488,-2841
2015,7,29,23,23730,23951,20907,-3044
2015,7,30,0,23010,23325,20325,-3000
2015,7,30,1,22650,22928,19943,-2985
2015,7,30,2,21550,21906,18769,-3137
2015,7,30,3,19550,19876,16909,-2967
2015,7,30,4,17540,18096,15313,-2783
2015,7,30,5,16390,17288,14476,-2812
2015,7,30,6,15370,16707,13988,-2719
2015,7,30,7,14750,16027,13772,-2255
2015,7,30,8,14380,15949,13764,-2185
2015,7,30,9,14440,15987,13840,-2147
2015,7,30,10,15030,16358,13994,-2364
2015,7,30,11,16380,17358,14755,-2603
2015,7,30,12,18130,18142,15551,-2591
2015,7,30,13,19450,19507,16439,-3068
2015,7,30,14,20610,20714,17571,-3143
2015,7,30,15,21760,21814,18495,-3319
2015,7,30,16,22730,22550,19139,-3411
2015,7,30,17,23420,22991,19605,-3386
2015,7,30,18,24030,23426,20268,-3158
2015,7,30,19,24280,23723,20676,-3047
2015,7,30,20,24360,23631,20754,-2877
2015,7,30,21,24400,23278,20354,-2924
2015,7,30,22,24160,22771,19662,-3109
2015,7,30,23,23550,22038,19005,-3033
2015,7,31,0,22800,21348,17907,-3441
2015,7,31,1,22350,21009,17487,-3522
2015,7,31,2,21300,20126,16943,-3183
2015,7,31,3,19380,18420,15372,-3048
2015,7,31,4,17470,17020,14196,-2824
2015,7,31,5,15180,15892,13421,-2471
2015,7,31,6,14340,15155,13242,-1913
2015,7,31,7,13720,14721,13130,-1591
2015,7,31,8,13450,14593,13205,-1388
2015,7,31,9,13470,14519,13192,-1327
2015,7,31,10,14080,14748,13037,-1711
2015,7,31,11,15540,15375,13336,-2039
2015,7,31,12,17140,16710,14440,-2270
2015,7,31,13,18310,17993,15949,-2044
2015,7,31,14,19140,18931,16476,-2455
2015,7,31,15,20030,19824,17238,-2586
2015,7,31,16,20840,20417,17651,-2766
2015,7,31,17,21290,20752,18093,-2659
2015,7,31,18,21720,21141,18448,-2693
2015,7,31,19,21960,21434,19128,-2306
2015,7,31,20,22270,21597,19525,-2072
2015,7,31,21,22330,21691,19563,-2128
2015,7,31,22,21830,21560,19316,-2244
2015,7,31,23,21200,20913,18601,-2312
2015,8,1,0,20220,19990,17661,-2329
2015,8,1,1,19890,19328,16696,-2632
2015,8,1,2,19090,18443,15985,-2458
2015,8,1,3,17390,16833,14855,-1978
2015,8,1,4,15580,15149,13131,-2018
2015,8,1,5,14080,14020,12537,-1483
2015,8,1,6,13130,13160,12095,-1065
2015,8,1,7,12560,12546,11779,-767
2015,8,1,8,12220,12651,11758,-893
2015,8,1,9,11850,12682,11746,-936
2015,8,1,10,11940,12829,11961,-868
2015,8,1,11,12360,13520,12141,-1379
2015,8,1,12,13630,14035,12886,-1149
2015,8,1,13,15120,14937,13706,-1231
2015,8,1,14,16300,16201,14784,-1417
2015,8,1,15,17190,17091,15502,-1589
2015,8,1,16,17820,17755,15648,-2107
2015,8,1,17,18120,18301,15933,-2368
2015,8,1,18,18390,18580,16322,-2258
2015,8,1,19,18680,18713,16378,-2335
2015,8,1,20,18820,18739,16527,-2212
2015,8,1,21,18850,18658,16860,-1798
2015,8,1,22,18720,18662,16791,-1871
2015,8,1,23,18550,18484,16470,-2014
2015,8,2,0,17960,17971,16103,-1868
2015,8,2,1,17910,17742,15968,-1774
2015,8,2,2,17130,17151,15363,-1788
2015,8,2,3,15900,15868,14420,-1448
2015,8,2,4,14530,14440,12986,-1454
2015,8,2,5,13150,13318,12192,-1126
2015,8,2,6,12310,12790,11853,-937
2015,8,2,7,11740,12646,11281,-1365
2015,8,2,8,11410,12462,11020,-1442
2015,8,2,9,11260,12302,10945,-1357
2015,8,2,10,11230,12228,11026,-1202
2015,8,2,11,11440,12367,11151,-1216
2015,8,2,12,12320,12898,11828,-1070
2015,8,2,13,13520,13412,12586,-826
2015,8,2,14,14600,14412,13156,-1256
2015,8,2,15,15510,15298,13622,-1676
2015,8,2,16,16220,16054,14292,-1762
2015,8,2,17,16700,16661,15008,-1653
2015,8,2,18,17030,17131,15505,-1626
2015,8,2,19,17300,17506,15458,-2048
2015,8,2,20,17610,17947,15824,-2123
2015,8,2,21,17910,18469,16385,-2084
2015,8,2,22,18200,18881,17079,-1802
2015,8,2,23,18080,18851,16905,-1946
2015,8,3,0,17660,18387,16594,-1793
2015,8,3,1,17580,18292,16513,-1779
2015,8,3,2,16940,17637,15552,-2085
2015,8,3,3,15580,16173,13963,-2210
2015,8,3,4,14200,14944,13111,-1833
2015,8,3,5,13620,14348,12679,-1669
2015,8,3,6,12960,13980,12379,-1601
2015,8,3,7,12500,13871,12388,-1483
2015,8,3,8,12300,13495,12071,-1424
2015,8,3,9,12520,13616,11972,-1644
2015,8,3,10,13240,14143,12728,-1415
2015,8,3,11,14580,14814,13109,-1705
2015,8,3,12,16390,16303,14611,-1692
2015,8,3,13,17670,17647,15918,-1729
2015,8,3,14,18940,18723,16683,-2040
2015,8,3,15,19990,19726,17461,-2265
2015,8,3,16,20760,20530,18377,-2153
2015,8,3,17,21560,21155,18765,-2390
2015,8,3,18,22070,21813,19348,-2465
2015,8,3,19,22450,22243,19750,-2493
2015,8,3,20,22710,22567,20323,-2244
2015,8,3,21,22800,22788,20891,-1897
2015,8,3,22,22610,22673,20538,-2135
2015,8,3,23,22010,22003,19325,-2678
2015,8,4,0,21170,21228,18479,-2749
2015,8,4,1,20970,20960,18330,-2630
2015,8,4,2,19900,20056,17926,-2130
2015,8,4,3,18080,18273,16501,-1772
2015,8,4,4,16350,16528,14609,-1919
2015,8,4,5,14900,15517,13347,-2170
2015,8,4,6,14050,15241,12643,-2598
2015,8,4,7,13530,15206,12509,-2697
2015,8,4,8,13270,15101,12260,-2841
2015,8,4,9,13410,15227,12328,-2899
2015,8,4,10,14490,15491,12961,-2530
2015,8,4,11,15750,16010,13569,-2441
2015,8,4,12,17270,17028,14901,-2127
2015,8,4,13,18420,17539,15626,-1913
2015,8,4,14,19450,18333,16466,-1867
2015,8,4,15,19860,19318,17326,-1992
2015,8,4,16,20500,20239,18091,-2148
2015,8,4,17,20960,20912,18553,-2359
2015,8,4,18,21360,21570,19055,-2515
2015,8,4,19,21650,21778,19337,-2441
2015,8,4,20,21710,21454,19165,-2289
2015,8,4,21,21700,20972,18465,-2507
2015,8,4,22,21500,20841,18210,-2631
2015,8,4,23,20820,20380,17824,-2556
2015,8,5,0,20060,19782,17520,-2262
2015,8,5,1,19880,19539,17273,-2266
2015,8,5,2,18840,18550,16406,-2144
2015,8,5,3,17100,16845,14977,-1868
2015,8,5,4,15390,15121,13203,-1918
2015,8,5,5,14120,14032,11859,-2173
2015,8,5,6,13300,13711,11482,-2229
2015,8,5,7,12780,13573,11347,-2226
2015,8,5,8,12510,13466,11218,-2248
2015,8,5,9,12130,13499,11109,-2390
2015,8,5,10,12740,13773,11621,-2152
2015,8,5,11,14000,14274,12167,-2107
2015,8,5,12,15560,15280,13362,-1918
2015,8,5,13,16630,16332,14420,-1912
2015,8,5,14,17430,17165,15420,-1745
2015,8,5,15,18210,17854,15748,-2106
2015,8,5,16,18790,18434,16146,-2288
2015,8,5,17,19150,18980,16637,-2343
2015,8,5,18,19660,19515,17106,-2409
2015,8,5,19,19910,19844,17220,-2624
2015,8,5,20,19950,19933,17211,-2722
2015,8,5,21,19870,20051,17451,-2600
2015,8,5,22,19720,19900,17158,-2742
2015,8,5,23,19230,19340,16564,-2776
2015,8,6,0,18490,18631,15734,-2897
2015,8,6,1,18300,18413,15714,-2699
2015,8,6,2,17340,17519,15237,-2282
2015,8,6,3,15670,15863,13822,-2041
2015,8,6,4,14060,14423,12497,-1926
2015,8,6,5,12930,13362,11714,-1648
2015,8,6,6,12170,13039,11716,-1323
2015,8,6,7,11690,12711,11831,-880
2015,8,6,8,11430,12445,11614,-831
2015,8,6,9,11450,12602,11650,-952
2015,8,6,10,12060,13337,12209,-1128
2015,8,6,11,13290,13802,12472,-1330
2015,8,6,12,14800,14933,13315,-1618
2015,8,6,13,15750,15582,14057,-1525
2015,8,6,14,16430,16235,14499,-1736
2015,8,6,15,17070,16805,14963,-1842
2015,8,6,16,17510,17225,15446,-1779
2015,8,6,17,17780,17551,15712,-1839
2015,8,6,18,18240,17865,15978,-1887
2015,8,6,19,18500,18063,16356,-1707
2015,8,6,20,18580,18147,16527,-1620
2015,8,6,21,18700,18196,16516,-1680
2015,8,6,22,18590,18106,16329,-1777
2015,8,6,23,18130,17691,15868,-1823
2015,8,7,0,17590,17277,15404,-1873
2015,8,7,1,17480,17321,15576,-1745
2015,8,7,2,16690,16548,14899,-1649
2015,8,7,3,15130,15163,13542,-1621
2015,8,7,4,13640,13725,12575,-1150
2015,8,7,5,12450,12866,11815,-1051
2015,8,7,6,11820,12357,11489,-868
2015,8,7,7,11400,12191,11272,-919
2015,8,7,8,11180,11967,11095,-872
2015,8,7,9,11270,12059,11162,-897
2015,8,7,10,11850,12603,11457,-1146
2015,8,7,11,12970,13167,12161,-1006
2015,8,7,12,14400,14249,12967,-1282
2015,8,7,13,15390,15291,14000,-1291
2015,8,7,14,16120,16001,14609,-1392
2015,8,7,15,16700,16575,14829,-1746
2015,8,7,16,17110,17001,15142,-1859
2015,8,7,17,17380,17299,15462,-1837
2015,8,7,18,17720,17631,15735,-1896
2015,8,7,19,17910,17796,16063,-1733
2015,8,7,20,17970,17839,16186,-1653
2015,8,7,21,18000,17874,16163,-1711
2015,8,7,22,17830,17756,16003,-1753
2015,8,7,23,17320,17289,15665,-1624
2015,8,8,0,16770,16677,15003,-1674
2015,8,8,1,16730,16571,14653,-1918
2015,8,8,2,16090,15904,14092,-1812
2015,8,8,3,14870,14639,13059,-1580
2015,8,8,4,13520,13267,12185,-1082
2015,8,8,5,12430,12178,10982,-1196
2015,8,8,6,11710,11710,10927,-783
2015,8,8,7,11270,11888,11074,-814
2015,8,8,8,10960,11811,11007,-804
2015,8,8,9,10890,11736,10735,-1001
2015,8,8,10,10800,11852,10855,-997
2015,8,8,11,11090,12376,11329,-1047
2015,8,8,12,12100,13093,12428,-665
2015,8,8,13,13320,13430,12734,-696
2015,8,8,14,14220,13976,12801,-1175
2015,8,8,15,14810,14556,12895,-1661
2015,8,8,16,15160,14941,13146,-1795
2015,8,8,17,15380,15220,13686,-1534
2015,8,8,18,15530,15327,13746,-1581
2015,8,8,19,15700,15408,13716,-1692
2015,8,8,20,15820,15541,13733,-1808
2015,8,8,21,16020,15770,14105,-1665
2015,8,8,22,16100,15918,14281,-1637
2015,8,8,23,15900,15680,13764,-1916
2015,8,9,0,15570,15372,13498,-1874
2015,8,9,1,15560,15516,13552,-1964
2015,8,9,2,15070,15020,13150,-1870
2015,8,9,3,14010,13984,12562,-1422
2015,8,9,4,12830,12829,11793,-1036
2015,8,9,5,11950,12036,11197,-839
2015,8,9,6,11300,11820,10950,-870
2015,8,9,7,10880,11610,10619,-991
2015,8,9,8,10590,11355,10231,-1124
2015,8,9,9,10490,11260,10280,-980
2015,8,9,10,10470,11564,10529,-1035
2015,8,9,11,10650,11744,10563,-1181
2015,8,9,12,11360,12331,11150,-1181
2015,8,9,13,12350,12588,11701,-887
2015,8,9,14,13320,13239,11975,-1264
2015,8,9,15,13930,13823,12312,-1511
2015,8,9,16,14430,14200,12347,-1853
2015,8,9,17,14830,14482,12744,-1738
2015,8,9,18,15060,14591,13057,-1534
2015,8,9,19,15300,14659,13125,-1534
2015,8,9,20,15510,14804,13491,-1313
2015,8,9,21,15830,15145,13786,-1359
2015,8,9,22,16200,15516,14050,-1466
2015,8,9,23,16050,15576,13903,-1673
2015,8,10,0,15750,15356,13823,-1533
2015,8,10,1,15850,15513,13859,-1654
2015,8,10,2,15210,14919,13214,-1705
2015,8,10,3,13970,13714,12113,-1601
2015,8,10,4,12720,12565,11418,-1147
2015,8,10,5,11740,12112,11117,-995
2015,8,10,6,11210,11916,10862,-1054
2015,8,10,7,10880,11732,10744,-988
2015,8,10,8,10750,11618,10655,-963
2015,8,10,9,10990,11828,10712,-1116
2015,8,10,10,11620,12522,11212,-1310
2015,8,10,11,12850,13039,11594,-1445
2015,8,10,12,14320,14085,12617,-1468
2015,8,10,13,15310,15137,13225,-1912
2015,8,10,14,16120,15939,13969,-1970
2015,8,10,15,16820,16635,14488,-2147
2015,8,10,16,17320,17225,15193,-2032
2015,8,10,17,17750,17669,15740,-1929
2015,8,10,18,18140,18178,16061,-2117
2015,8,10,19,18500,18528,16398,-2130
2015,8,10,20,18680,18735,16884,-1851
2015,8,10,21,18800,18848,17031,-1817
2015,8,10,22,18710,18819,16822,-1997
2015,8,10,23,18270,18419,16207,-2212
2015,8,11,0,17830,17861,15683,-2178
2015,8,11,1,17750,17834,15672,-2162
2015,8,11,2,16830,16900,14863,-2037
2015,8,11,3,15230,15378,13810,-1568
2015,8,11,4,13700,14172,12434,-1738
2015,8,11,5,12580,13124,11891,-1233
2015,8,11,6,11990,12956,11857,-1099
2015,8,11,7,11610,12954,11908,-1046
2015,8,11,8,11480,12826,11745,-1081
2015,8,11,9,11620,13020,11984,-1036
2015,8,11,10,12640,13663,12250,-1413
2015,8,11,11,13950,14336,12519,-1817
2015,8,11,12,15300,15434,13608,-1826
2015,8,11,13,16180,16299,14487,-1812
2015,8,11,14,16810,16893,14990,-1903
2015,8,11,15,17330,17357,15374,-1983
2015,8,11,16,17610,17581,15484,-2097
2015,8,11,17,17770,17579,15519,-2060
2015,8,11,18,17960,17643,15911,-1732
2015,8,11,19,17990,17545,15608,-1937
2015,8,11,20,17960,17486,15436,-2050
2015,8,11,21,17940,17570,15441,-2129
2015,8,11,22,18350,17710,15638,-2072
2015,8,11,23,17930,17600,15442,-2158
2015,8,12,0,17710,17488,15384,-2104
2015,8,12,1,17990,17459,15523,-1936
2015,8,12,2,17030,16595,14616,-1979
2015,8,12,3,15600,15264,13091,-2173
2015,8,12,4,14190,14228,12588,-1640
2015,8,12,5,13330,13461,12070,-1391
2015,8,12,6,12650,13072,11542,-1530
2015,8,12,7,12190,13081,11558,-1523
2015,8,12,8,11970,13074,11541,-1533
2015,8,12,9,12060,13213,11395,-1818
2015,8,12,10,12640,13663,11821,-1842
2015,8,12,11,13870,14094,12292,-1802
2015,8,12,12,15330,15154,13312,-1842
2015,8,12,13,16310,16237,14208,-2029
2015,8,12,14,17160,16999,14929,-2070
2015,8,12,15,17840,17727,15641,-2086
2015,8,12,16,18400,18328,16281,-2047
2015,8,12,17,18770,18687,16493,-2194
2015,8,12,18,19160,19109,16641,-2468
2015,8,12,19,19430,19343,16818,-2525
2015,8,12,20,19530,19532,17122,-2410
2015,8,12,21,19650,19733,17575,-2158
2015,8,12,22,19440,19754,17567,-2187
2015,8,12,23,18930,19319,17049,-2270
2015,8,13,0,18360,18664,16535,-2129
2015,8,13,1,18260,18508,16165,-2343
2015,8,13,2,17350,17522,15521,-2001
2015,8,13,3,15710,15959,14323,-1636
2015,8,13,4,14100,14548,12805,-1743
2015,8,13,5,12930,13740,12047,-1693
2015,8,13,6,12250,13319,11548,-1771
2015,8,13,7,11790,13221,11365,-1856
2015,8,13,8,11520,13173,11030,-2143
2015,8,13,9,11640,13243,11147,-2096
2015,8,13,10,12270,13860,11835,-2025
2015,8,13,11,13350,14122,12363,-1759
2015,8,13,12,14720,14762,13286,-1476
2015,8,13,13,15680,15777,14164,-1613
2015,8,13,14,16400,16500,14729,-1771
2015,8,13,15,17000,17148,15457,-1691
2015,8,13,16,17480,17674,15937,-1737
2015,8,13,17,17830,18021,16081,-1940
2015,8,13,18,18220,18466,16553,-1913
2015,8,13,19,18450,18705,16962,-1743
2015,8,13,20,18550,18883,17119,-1764
2015,8,13,21,18670,19082,17325,-1757
2015,8,13,22,18570,19073,17287,-1786
2015,8,13,23,18140,18661,16540,-2121
2015,8,14,0,17590,18043,15962,-2081
2015,8,14,1,17480,17930,15752,-2178
2015,8,14,2,16600,17014,15290,-1724
2015,8,14,3,15120,15584,14155,-1429
2015,8,14,4,13640,14390,12708,-1682
2015,8,14,5,12690,13574,11465,-2109
2015,8,14,6,11970,13016,10903,-2113
2015,8,14,7,11530,12780,10690,-2090
2015,8,14,8,11310,12510,10560,-1950
2015,8,14,9,11440,12559,10642,-1917
2015,8,14,10,11890,12918,11242,-1676
2015,8,14,11,13060,13723,11748,-1975
2015,8,14,12,14570,14850,13256,-1594
2015,8,14,13,15670,15469,13847,-1622
2015,8,14,14,16530,16351,14976,-1375
2015,8,14,15,17270,17120,15812,-1308
2015,8,14,16,17880,17704,16434,-1270
2015,8,14,17,18280,18132,16577,-1555
2015,8,14,18,18830,18699,16946,-1753
2015,8,14,19,19120,19205,17729,-1476
2015,8,14,20,19290,19579,18231,-1348
2015,8,14,21,19400,19903,18295,-1608
2015,8,14,22,19250,19921,17815,-2106
2015,8,14,23,18760,19415,17184,-2231
2015,8,15,0,17810,18685,16662,-2023
2015,8,15,1,17800,18487,16294,-2193
2015,8,15,2,17000,17566,15504,-2062
2015,8,15,3,15660,16146,14444,-1702
2015,8,15,4,14230,14649,13141,-1508
2015,8,15,5,13270,13643,11851,-1792
2015,8,15,6,12460,13324,11425,-1899
2015,8,15,7,11960,13253,11198,-2055
2015,8,15,8,11700,12819,11115,-1704
2015,8,15,9,11650,12716,10904,-1812
2015,8,15,10,11820,12895,11502,-1393
2015,8,15,11,12240,13077,11226,-1851
2015,8,15,12,13340,14108,11979,-2129
2015,8,15,13,14770,14739,12912,-1827
2015,8,15,14,16000,15772,14256,-1516
2015,8,15,15,16930,16886,15022,-1864
2015,8,15,16,17610,17885,15735,-2150
2015,8,15,17,18110,18670,16330,-2340
2015,8,15,18,18470,19255,16554,-2701
2015,8,15,19,18760,19632,16989,-2643
2015,8,15,20,18910,19956,17330,-2626
2015,8,15,21,18990,20094,17437,-2657
2015,8,15,22,19100,20002,17047,-2955
2015,8,15,23,18820,19563,16316,-3247
2015,8,16,0,18300,18983,16074,-2909
2015,8,16,1,18200,18808,16215,-2593
2015,8,16,2,17490,17907,15541,-2366
2015,8,16,3,16230,16526,14492,-2034
2015,8,16,4,14900,15105,12944,-2161
2015,8,16,5,14090,14002,11884,-2118
2015,8,16,6,13270,13763,11653,-2110
2015,8,16,7,12680,13895,11618,-2277
2015,8,16,8,12390,13650,11346,-2304
2015,8,16,9,12140,13351,11378,-1973
2015,8,16,10,12170,13458,11692,-1766
2015,8,16,11,12370,13674,11825,-1849
2015,8,16,12,13250,14027,12007,-2020
2015,8,16,13,14530,14409,12332,-2077
2015,8,16,14,15800,15645,13542,-2103
2015,8,16,15,17120,16833,15012,-1821
2015,8,16,16,18280,17859,15891,-1968
2015,8,16,17,19180,18677,16455,-2222
2015,8,16,18,19840,19286,17130,-2156
2015,8,16,19,20350,19754,17562,-2192
2015,8,16,20,20910,20168,17995,-2173
2015,8,16,21,21250,20559,18351,-2208
2015,8,16,22,21170,20843,18599,-2244
2015,8,16,23,20820,20694,18760,-1934
2015,8,17,0,19960,20237,18369,-1868
2015,8,17,1,20040,20198,18117,-2081
2015,8,17,2,18990,19183,16947,-2236
2015,8,17,3,17330,17541,15370,-2171
2015,8,17,4,15720,16096,14168,-1928
2015,8,17,5,14830,15449,13078,-2371
2015,8,17,6,14110,15450,12643,-2807
2015,8,17,7,13550,15003,12227,-2776
2015,8,17,8,13370,14736,12152,-2584
2015,8,17,9,13330,14823,12451,-2372
2015,8,17,10,14130,15293,12818,-2475
2015,8,17,11,15570,15728,13314,-2414
2015,8,17,12,17400,16739,14265,-2474
2015,8,17,13,18930,18201,15955,-2246
2015,8,17,14,20160,19527,17130,-2397
2015,8,17,15,21350,20817,18286,-2531
2015,8,17,16,22390,21849,19343,-2506
2015,8,17,17,23130,22618,20157,-2461
2015,8,17,18,23870,23301,20866,-2435
2015,8,17,19,24290,23630,21329,-2301
2015,8,17,20,24640,23818,21742,-2076
2015,8,17,21,25000,23968,21730,-2238
2015,8,17,22,24720,23971,21524,-2447
2015,8,17,23,23940,23534,20722,-2812
2015,8,18,0,23190,22908,20209,-2699
2015,8,18,1,22910,22617,19876,-2741
2015,8,18,2,21480,21241,18630,-2611
2015,8,18,3,19370,19267,16828,-2439
2015,8,18,4,17380,17588,14894,-2694
2015,8,18,5,15980,16703,14133,-2570
2015,8,18,6,14940,16366,13768,-2598
2015,8,18,7,14260,15940,13391,-2549
2015,8,18,8,13840,15556,12910,-2646
2015,8,18,9,13960,15589,12947,-2642
2015,8,18,10,14640,16124,13516,-2608
2015,8,18,11,15890,16246,14097,-2149
2015,8,18,12,17560,17422,15024,-2398
2015,8,18,13,18890,18759,16155,-2604
2015,8,18,14,20090,20009,17330,-2679
2015,8,18,15,21300,21296,18568,-2728
2015,8,18,16,22320,22380,19380,-3000
2015,8,18,17,23120,23248,20364,-2884
2015,8,18,18,23830,23920,21048,-2872
2015,8,18,19,24230,24049,21404,-2645
2015,8,18,20,24400,23811,21109,-2702
2015,8,18,21,24500,23625,20930,-2695
2015,8,18,22,24280,23290,20370,-2920
2015,8,18,23,23580,22585,19597,-2988
2015,8,19,0,22810,22037,19022,-3015
2015,8,19,1,22420,21777,18767,-3010
2015,8,19,2,21090,20505,17397,-3108
2015,8,19,3,19010,18636,15416,-3220
2015,8,19,4,17040,17085,14035,-3050
2015,8,19,5,15630,16172,13492,-2680
2015,8,19,6,14770,15656,13140,-2516
2015,8,19,7,14150,15554,12878,-2676
2015,8,19,8,13850,15564,12772,-2792
2015,8,19,9,13940,15665,13014,-2651
2015,8,19,10,14600,16049,13525,-2524
2015,8,19,11,15910,16533,13852,-2681
2015,8,19,12,17360,17545,15043,-2502
2015,8,19,13,18600,18800,16384,-2416
2015,8,19,14,19550,19823,17371,-2452
2015,8,19,15,20510,20807,18160,-2647
2015,8,19,16,21300,21648,18668,-2980
2015,8,19,17,22000,22281,19286,-2995
2015,8,19,18,22590,22865,20045,-2820
2015,8,19,19,22880,23247,20619,-2628
2015,8,19,20,22900,23433,21212,-2221
2015,8,19,21,23000,23530,21100,-2430
2015,8,19,22,22790,23388,20687,-2701
2015,8,19,23,22140,22733,19805,-2928
2015,8,20,0,21400,21983,18982,-3001
2015,8,20,1,21080,21719,18823,-2896
2015,8,20,2,19820,20473,17679,-2794
2015,8,20,3,17870,18597,15757,-2840
2015,8,20,4,16090,16796,14089,-2707
2015,8,20,5,15550,16068,13519,-2549
2015,8,20,6,14790,15719,12930,-2789
2015,8,20,7,14240,15393,12509,-2884
2015,8,20,8,13970,15562,12752,-2810
2015,8,20,9,13940,15683,12718,-2965
2015,8,20,10,14690,15994,13300,-2694
2015,8,20,11,15940,16820,14470,-2350
2015,8,20,12,17310,17616,15551,-2065
2015,8,20,13,18510,18711,16709,-2002
2015,8,20,14,19320,19608,17152,-2456
2015,8,20,15,20110,20450,17971,-2479
2015,8,20,16,20860,21123,18773,-2350
2015,8,20,17,21390,21579,19353,-2226
2015,8,20,18,21960,22092,19830,-2262
2015,8,20,19,22100,22310,20037,-2273
2015,8,20,20,22160,22396,20071,-2325
2015,8,20,21,22300,22386,20106,-2280
2015,8,20,22,21950,22160,19838,-2322
2015,8,20,23,21220,21500,18921,-2579
2015,8,21,0,20530,20890,18060,-2830
2015,8,21,1,20320,20744,18149,-2595
2015,8,21,2,19170,19645,17209,-2436
2015,8,21,3,17480,18034,15407,-2627
2015,8,21,4,15790,16738,14423,-2315
2015,8,21,5,14690,15760,13442,-2318
2015,8,21,6,14010,15416,13114,-2302
2015,8,21,7,13580,15199,12697,-2502
2015,8,21,8,13400,15017,12747,-2270
2015,8,21,9,13570,15034,12812,-2222
2015,8,21,10,14420,15367,13318,-2049
2015,8,21,11,15740,16350,14490,-1860
2015,8,21,12,17020,17409,15478,-1931
2015,8,21,13,18100,18402,16510,-1892
2015,8,21,14,18990,19022,17107,-1915
2015,8,21,15,19660,19453,17113,-2340
2015,8,21,16,20160,19740,16846,-2894
2015,8,21,17,20320,20068,16799,-3269
2015,8,21,18,20370,20541,17327,-3214
2015,8,21,19,20150,20838,17676,-3162
2015,8,21,20,19790,20982,17846,-3136
2015,8,21,21,19680,21107,18182,-2925
2015,8,21,22,19390,20932,17906,-3026
2015,8,21,23,19040,20321,17134,-3187
2015,8,22,0,18790,19783,16631,-3152
2015,8,22,1,18670,19566,16493,-3073
2015,8,22,2,17970,18531,15692,-2839
2015,8,22,3,16710,17084,14338,-2746
2015,8,22,4,15300,15578,12810,-2768
2015,8,22,5,14110,14789,11883,-2906
2015,8,22,6,13280,14479,11602,-2877
2015,8,22,7,12780,14529,11339,-3190
2015,8,22,8,12470,14229,11287,-2942
2015,8,22,9,12330,14007,11097,-2910
2015,8,22,10,12630,13915,11191,-2724
2015,8,22,11,12940,13910,11044,-2866
2015,8,22,12,13810,14230,11700,-2530
2015,8,22,13,14910,14893,12394,-2499
2015,8,22,14,15920,15601,13232,-2369
2015,8,22,15,16580,16312,14035,-2277
2015,8,22,16,17100,16777,14559,-2218
2015,8,22,17,17510,17033,14829,-2204
2015,8,22,18,17800,17163,14748,-2415
2015,8,22,19,17990,17265,14741,-2524
2015,8,22,20,18030,17412,15086,-2326
2015,8,22,21,18160,17598,15340,-2258
2015,8,22,22,18130,17657,15597,-2060
2015,8,22,23,18150,17437,15330,-2107
2015,8,23,0,17800,17115,14707,-2408
2015,8,23,1,17720,17137,14619,-2518
2015,8,23,2,16960,16403,13939,-2464
2015,8,23,3,15790,15271,12581,-2690
2015,8,23,4,14500,14197,11752,-2445
2015,8,23,5,13440,13324,10523,-2801
2015,8,23,6,12760,12956,10343,-2613
2015,8,23,7,12250,12995,10453,-2542
2015,8,23,8,11970,12752,10218,-2534
2015,8,23,9,11870,12650,10208,-2442
2015,8,23,10,11750,12745,10272,-2473
2015,8,23,11,11910,12946,10846,-2100
2015,8,23,12,12640,13816,11544,-2272
2015,8,23,13,13670,13911,11797,-2114
2015,8,23,14,14660,14700,12104,-2596
2015,8,23,15,15530,15184,12682,-2502
2015,8,23,16,16210,15738,13045,-2693
2015,8,23,17,16770,16170,13472,-2698
2015,8,23,18,17130,16415,13575,-2840
2015,8,23,19,17310,16590,13641,-2949
2015,8,23,20,17540,16725,14077,-2648
2015,8,23,21,17830,16999,14485,-2514
2015,8,23,22,18060,17322,14827,-2495
2015,8,23,23,17820,17403,14921,-2482
2015,8,24,0,17700,17377,14778,-2599
2015,8,24,1,17670,17511,14977,-2534
2015,8,24,2,16850,16700,14542,-2158
2015,8,24,3,15460,15459,13175,-2284
2015,8,24,4,14150,14306,11679,-2627
2015,8,24,5,12970,13784,10993,-2791
2015,8,24,6,12400,13308,10610,-2698
2015,8,24,7,12040,13467,10708,-2759
2015,8,24,8,11920,13601,10901,-2700
2015,8,24,9,12160,13706,10905,-2801
2015,8,24,10,13460,13974,11350,-2624
2015,8,24,11,14740,14860,12243,-2617
2015,8,24,12,16060,16169,13954,-2215
2015,8,24,13,16970,17180,15239,-1941
2015,8,24,14,17840,17933,15609,-2324
2015,8,24,15,18630,18690,16353,-2337
2015,8,24,16,19260,19279,16802,-2477
2015,8,24,17,19760,19744,16951,-2793
2015,8,24,18,20250,20292,17666,-2626
2015,8,24,19,20500,20582,18198,-2384
2015,8,24,20,20600,20753,18440,-2313
2015,8,24,21,20750,20814,18242,-2572
2015,8,24,22,20650,20847,18153,-2694
2015,8,24,23,20270,20442,17464,-2978
2015,8,25,0,19860,20009,17214,-2795
2015,8,25,1,19690,19867,17043,-2824
2015,8,25,2,18540,18648,15748,-2900
2015,8,25,3,16830,16987,14375,-2612
2015,8,25,4,15190,15398,13055,-2343
2015,8,25,5,14030,14700,12457,-2243
2015,8,25,6,13330,14618,12340,-2278
2015,8,25,7,12900,14292,11440,-2852
2015,8,25,8,12690,14084,11322,-2762
2015,8,25,9,12890,14547,11907,-2640
2015,8,25,10,13650,15096,12735,-2361
2015,8,25,11,15030,15721,13668,-2053
2015,8,25,12,16400,16587,14193,-2394
2015,8,25,13,17400,17523,15239,-2284
2015,8,25,14,18290,18331,16202,-2129
2015,8,25,15,19200,19170,17077,-2093
2015,8,25,16,19860,19831,17423,-2408
2015,8,25,17,20430,20345,17885,-2460
2015,8,25,18,20920,20874,18396,-2478
2015,8,25,19,21200,21281,19043,-2238
2015,8,25,20,21340,21538,19478,-2060
2015,8,25,21,21500,21667,19561,-2106
2015,8,25,22,21320,21551,19411,-2140
2015,8,25,23,20710,21051,18838,-2213
2015,8,26,0,20200,20662,18417,-2245
2015,8,26,1,19990,20368,17777,-2591
2015,8,26,2,18820,19058,16134,-2924
2015,8,26,3,17060,17301,14716,-2585
2015,8,26,4,15360,15658,13320,-2338
2015,8,26,5,14010,14955,12463,-2492
2015,8,26,6,13240,14851,12374,-2477
2015,8,26,7,12730,14604,11786,-2818
2015,8,26,8,12500,14334,11236,-3098
2015,8,26,9,12790,14392,11511,-2881
2015,8,26,10,13520,15066,12306,-2760
2015,8,26,11,14770,15949,13374,-2575
2015,8,26,12,16110,16298,13571,-2727
2015,8,26,13,17020,16966,14455,-2511
2015,8,26,14,17740,17691,15271,-2420
2015,8,26,15,18440,18390,15810,-2580
2015,8,26,16,18990,18971,16346,-2625
2015,8,26,17,19400,19374,16850,-2524
2015,8,26,18,19810,19808,17183,-2625
2015,8,26,19,20160,20049,17473,-2576
2015,8,26,20,20290,20160,17853,-2307
2015,8,26,21,20320,20168,17711,-2457
2015,8,26,22,20080,19978,17537,-2441
2015,8,26,23,19540,19350,16501,-2849
2015,8,27,0,19050,18817,15931,-2886
2015,8,27,1,18820,18564,15986,-2578
2015,8,27,2,17580,17298,14955,-2343
2015,8,27,3,15900,15611,13377,-2234
2015,8,27,4,14320,13974,11927,-2047
2015,8,27,5,13190,13094,10807,-2287
2015,8,27,6,12440,12837,10691,-2146
2015,8,27,7,11980,12601,10764,-1837
2015,8,27,8,11730,12491,10619,-1872
2015,8,27,9,11620,12582,10619,-1963
2015,8,27,10,12350,12839,10711,-2128
2015,8,27,11,13670,13815,11569,-2246
2015,8,27,12,15030,14897,12767,-2130
2015,8,27,13,15880,15535,13415,-2120
2015,8,27,14,16630,16175,13958,-2217
2015,8,27,15,16860,16749,14680,-2069
2015,8,27,16,17340,17189,15106,-2083
2015,8,27,17,17630,17503,15072,-2431
2015,8,27,18,18080,17881,15579,-2302
2015,8,27,19,18370,18056,15767,-2289
2015,8,27,20,18480,18100,15929,-2171
2015,8,27,21,18600,18136,16008,-2128
2015,8,27,22,18510,18121,15959,-2162
2015,8,27,23,17990,17722,15422,-2300
2015,8,28,0,17560,17398,15083,-2315
2015,8,28,1,17520,17333,15036,-2297
2015,8,28,2,16540,16247,14064,-2183
2015,8,28,3,15010,14765,12654,-2111
2015,8,28,4,13530,13516,11453,-2063
2015,8,28,5,12410,12596,10834,-1762
2015,8,28,6,11760,12414,10676,-1738
2015,8,28,7,11360,12334,10462,-1872
2015,8,28,8,11120,12244,10273,-1971
2015,8,28,9,11080,12206,10354,-1852
2015,8,28,10,11800,12430,10582,-1848
2015,8,28,11,13030,13125,11224,-1901
2015,8,28,12,14360,14116,12428,-1688
2015,8,28,13,15240,15003,12885,-2118
2015,8,28,14,15960,15639,13565,-2074
2015,8,28,15,16520,16180,14201,-1979
2015,8,28,16,16940,16603,14566,-2037
2015,8,28,17,17160,16893,14794,-2099
2015,8,28,18,17540,17226,15214,-2012
2015,8,28,19,17720,17363,15485,-1878
2015,8,28,20,17830,17421,15437,-1984
2015,8,28,21,17950,17522,15454,-2068
2015,8,28,22,17670,17495,15414,-2081
2015,8,28,23,17180,17063,15105,-1958
2015,8,29,0,16730,16771,14902,-1869
2015,8,29,1,16690,16609,14730,-1879
2015,8,29,2,15870,15668,13905,-1763
2015,8,29,3,14600,14356,12494,-1862
2015,8,29,4,13320,13028,11193,-1835
2015,8,29,5,12090,11974,10379,-1595
2015,8,29,6,11500,11567,10021,-1546
2015,8,29,7,11070,11380,9921,-1459
2015,8,29,8,10820,11127,9861,-1266
2015,8,29,9,10590,11344,9912,-1432
2015,8,29,10,10780,11291,10189,-1102
2015,8,29,11,11190,11631,10703,-928
2015,8,29,12,12150,12422,11761,-661
2015,8,29,13,13220,13081,12149,-932
2015,8,29,14,14140,13917,12596,-1321
2015,8,29,15,14750,14526,12913,-1613
2015,8,29,16,15220,14942,13300,-1642
2015,8,29,17,15470,15233,13568,-1665
2015,8,29,18,15650,15463,13791,-1672
2015,8,29,19,15830,15672,13986,-1686
2015,8,29,20,15990,15944,14212,-1732
2015,8,29,21,16220,16271,14682,-1589
2015,8,29,22,16400,16466,15006,-1460
2015,8,29,23,16170,16271,14831,-1440
2015,8,30,0,15920,16150,14672,-1478
2015,8,30,1,15960,16120,14755,-1365
2015,8,30,2,15350,15346,13932,-1414
2015,8,30,3,14280,14310,12761,-1549
2015,8,30,4,13110,13162,11578,-1584
2015,8,30,5,12080,12271,10574,-1697
2015,8,30,6,11450,11645,10457,-1188
2015,8,30,7,11040,11490,10365,-1125
2015,8,30,8,10840,11480,10419,-1061
2015,8,30,9,10760,11473,10404,-1069
2015,8,30,10,10870,11569,10324,-1245
2015,8,30,11,11080,11864,10594,-1270
2015,8,30,12,11890,12659,11414,-1245
2015,8,30,13,12990,13128,12036,-1092
2015,8,30,14,14020,14146,12579,-1567
2015,8,30,15,14870,15167,13625,-1542
2015,8,30,16,15660,16129,14380,-1749
2015,8,30,17,16240,16848,15072,-1776
2015,8,30,18,16690,17317,15415,-1902
2015,8,30,19,16970,17649,15677,-1972
2015,8,30,20,17270,18007,16053,-1954
2015,8,30,21,17600,18430,16523,-1907
2015,8,30,22,18000,18734,16952,-1782
2015,8,30,23,17810,18637,16618,-2019
2015,8,31,0,17730,18758,16847,-1911
2015,8,31,1,17720,18747,16955,-1792
2015,8,31,2,16920,17694,15696,-1998
2015,8,31,3,15550,16209,14334,-1875
2015,8,31,4,14150,15026,13368,-1658
2015,8,31,5,13290,14488,12324,-2164
2015,8,31,6,12650,13849,11880,-1969
2015,8,31,7,12260,13642,11635,-2007
2015,8,31,8,12100,13460,11543,-1917
2015,8,31,9,12290,13634,11729,-1905
2015,8,31,10,13420,14538,12159,-2379
2015,8,31,11,14770,15620,12989,-2631
2015,8,31,12,16240,16454,13603,-2851
2015,8,31,13,17420,17437,14412,-3025
2015,8,31,14,18450,18446,15379,-3067
2015,8,31,15,19490,19472,16267,-3205
2015,8,31,16,20400,20383,17190,-3193
2015,8,31,17,21120,21073,18122,-2951
2015,8,31,18,21800,21672,18300,-3372
2015,8,31,19,22280,22022,18696,-3326
2015,8,31,20,22600,22256,18921,-3335
2015,8,31,21,22750,22450,18921,-3529
2015,8,31,22,22680,22430,19218,-3212
2015,8,31,23,22070,21923,18489,-3434
2015,9,1,0,21720,21666,18069,-3597
2015,9,1,1,21380,21278,17630,-3648
2015,9,1,2,19960,19732,16403,-3329
2015,9,1,3,18050,17755,14533,-3222
2015,9,1,4,16270,16378,13583,-2795
2015,9,1,5,14630,15239,12776,-2463
2015,9,1,6,13820,14821,12110,-2711
2015,9,1,7,13210,14485,11391,-3094
2015,9,1,8,12900,14153,11071,-3082
2015,9,1,9,13000,14197,11250,-2947
2015,9,1,10,13550,14486,11720,-2766
2015,9,1,11,15030,15262,12392,-2870
2015,9,1,12,16270,16193,13253,-2940
2015,9,1,13,17300,17145,14004,-3141
2015,9,1,14,18230,17981,14606,-3375
2015,9,1,15,19090,18794,15310,-3484
2015,9,1,16,20200,19398,15726,-3672
2015,9,1,17,20870,19812,16566,-3246
2015,9,1,18,21500,20396,17733,-2663
2015,9,1,19,21890,20801,18509,-2292
2015,9,1,20,22130,21109,18330,-2779
2015,9,1,21,22370,21344,18353,-2991
2015,9,1,22,21860,21212,17890,-3322
2015,9,1,23,20910,20622,17010,-3612
2015,9,2,0,20580,20267,16591,-3676
2015,9,2,1,20230,19888,16570,-3318
2015,9,2,2,18670,18382,15118,-3264
2015,9,2,3,16400,16491,13335,-3156
2015,9,2,4,14630,15221,12496,-2725
2015,9,2,5,13690,14157,11317,-2840
2015,9,2,6,12980,14022,11520,-2502
2015,9,2,7,12470,13553,10992,-2561
2015,9,2,8,12250,13216,11128,-2088
2015,9,2,9,12410,13355,11256,-2099
2015,9,2,10,13100,14187,11587,-2600
2015,9,2,11,14480,15052,12128,-2924
2015,9,2,12,15820,15862,12704,-3158
2015,9,2,13,16900,16738,13518,-3220
2015,9,2,14,17880,17650,14021,-3629
2015,9,2,15,18890,18650,15200,-3450
2015,9,2,16,19810,19640,16261,-3379
2015,9,2,17,20550,20422,17330,-3092
2015,9,2,18,21420,21255,18190,-3065
2015,9,2,19,22030,21808,18839,-2969
2015,9,2,20,22420,22319,19062,-3257
2015,9,2,21,22630,22654,19235,-3419
2015,9,2,22,22500,22592,19181,-3411
2015,9,2,23,21780,21961,18262,-3699
2015,9,3,0,21480,21597,17574,-4023
2015,9,3,1,20990,21117,17104,-4013
2015,9,3,2,19540,19529,15620,-3909
2015,9,3,3,17580,17539,13995,-3544
2015,9,3,4,15830,16079,13009,-3070
2015,9,3,5,14360,15002,12419,-2583
2015,9,3,6,13570,14640,12126,-2514
2015,9,3,7,13040,14200,11492,-2708
2015,9,3,8,12820,14139,11422,-2717
2015,9,3,9,12990,13831,11152,-2679
2015,9,3,10,13830,14288,11815,-2473
2015,9,3,11,15380,15260,12855,-2405
2015,9,3,12,16730,16430,13856,-2574
2015,9,3,13,17760,17388,14518,-2870
2015,9,3,14,18810,18352,15136,-3216
2015,9,3,15,19810,19359,16093,-3266
2015,9,3,16,20680,20297,16739,-3558
2015,9,3,17,21280,21095,17696,-3399
2015,9,3,18,21930,21865,18936,-2929
2015,9,3,19,22160,22272,19409,-2863
2015,9,3,20,22180,22605,19895,-2710
2015,9,3,21,22200,22753,19832,-2921
2015,9,3,22,21830,22427,19511,-2916
2015,9,3,23,21270,21830,18554,-3276
2015,9,4,0,21130,21708,18425,-3283
2015,9,4,1,20610,21253,17927,-3326
2015,9,4,2,19180,19843,16503,-3340
2015,9,4,3,17390,17909,14875,-3034
2015,9,4,4,15640,16140,13392,-2748
2015,9,4,5,14180,15344,12552,-2792
2015,9,4,6,13450,14935,12097,-2838
2015,9,4,7,12890,14908,12025,-2883
2015,9,4,8,12660,14597,11781,-2816
2015,9,4,9,12710,14406,11762,-2644
2015,9,4,10,14000,14603,11941,-2662
2015,9,4,11,15210,15137,12435,-2702
2015,9,4,12,16240,16080,13689,-2391
2015,9,4,13,16800,16647,14453,-2194
2015,9,4,14,17310,17050,14431,-2619
2015,9,4,15,17730,17426,14287,-3139
2015,9,4,16,18010,17765,14830,-2935
2015,9,4,17,18110,17959,15470,-2489
2015,9,4,18,18330,18138,15945,-2193
2015,9,4,19,18370,18213,15805,-2408
2015,9,4,20,18260,18195,15734,-2461
2015,9,4,21,18050,18252,15960,-2292
2015,9,4,22,17830,18063,15310,-2753
2015,9,4,23,17160,17443,14509,-2934
2015,9,5,0,17070,17147,14304,-2843
2015,9,5,1,16600,16801,14103,-2698
2015,9,5,2,15550,15791,13616,-2175
2015,9,5,3,14180,14432,12350,-2082
2015,9,5,4,12810,13054,11052,-2002
2015,9,5,5,11870,12578,10730,-1848
2015,9,5,6,11230,12187,10773,-1414
2015,9,5,7,10820,11939,10962,-977
2015,9,5,8,10560,11642,10774,-868
2015,9,5,9,10530,11835,10482,-1353
2015,9,5,10,10810,12017,10173,-1844
2015,9,5,11,11240,11977,9843,-2134
2015,9,5,12,12070,12478,10150,-2328
2015,9,5,13,13010,12735,10901,-1834
2015,9,5,14,13910,13445,11513,-1932
2015,9,5,15,14490,13946,11973,-1973
2015,9,5,16,14810,14276,12386,-1890
2015,9,5,17,14910,14556,12553,-2003
2015,9,5,18,15060,14799,12832,-1967
2015,9,5,19,15230,15065,13194,-1871
2015,9,5,20,15390,15379,13749,-1630
2015,9,5,21,15600,15726,13663,-2063
2015,9,5,22,15700,15948,13661,-2287
2015,9,5,23,15390,15745,13438,-2307
2015,9,6,0,15440,15632,13634,-1998
2015,9,6,1,15230,15441,13328,-2113
2015,9,6,2,14510,14619,12247,-2372
2015,9,6,3,13430,13683,11384,-2299
2015,9,6,4,12330,12616,10774,-1842
2015,9,6,5,11330,11715,10301,-1414
2015,9,6,6,10830,11126,10060,-1066
2015,9,6,7,10420,11394,9874,-1520
2015,9,6,8,10160,11574,10119,-1455
2015,9,6,9,10150,11536,9840,-1696
2015,9,6,10,10250,11643,9855,-1788
2015,9,6,11,10450,11345,9897,-1448
2015,9,6,12,11100,11708,10157,-1551
2015,9,6,13,12070,12124,10840,-1284
2015,9,6,14,13050,12972,11199,-1773
2015,9,6,15,13780,13704,11677,-2027
2015,9,6,16,14380,14369,12054,-2315
2015,9,6,17,14920,14962,12900,-2062
2015,9,6,18,15220,15469,13485,-1984
2015,9,6,19,15570,15907,13613,-2294
2015,9,6,20,15920,16393,14189,-2204
2015,9,6,21,16380,16845,14669,-2176
2015,9,6,22,16700,17091,14931,-2160
2015,9,6,23,16630,16783,14207,-2576
2015,9,7,0,16640,16597,13578,-3019
2015,9,7,1,16470,16326,13768,-2558
2015,9,7,2,15520,15464,13108,-2356
2015,9,7,3,14150,14350,12226,-2124
2015,9,7,4,12750,13225,11144,-2081
2015,9,7,5,12230,13120,10673,-2447
2015,9,7,6,11590,12871,10716,-2155
2015,9,7,7,11180,12483,10334,-2149
2015,9,7,8,10900,12246,10120,-2126
2015,9,7,9,10820,12223,10218,-2005
2015,9,7,10,10940,12207,10742,-1465
2015,9,7,11,11190,12467,10884,-1583
2015,9,7,12,11900,12874,10742,-2132
2015,9,7,13,13030,13830,11404,-2426
2015,9,7,14,14210,14482,11894,-2588
2015,9,7,15,15300,15624,13368,-2256
2015,9,7,16,16300,16710,14294,-2416
2015,9,7,17,17110,17702,15164,-2538
2015,9,7,18,17770,18534,15835,-2699
2015,9,7,19,18350,19303,16512,-2791
2015,9,7,20,18940,19978,16861,-3117
2015,9,7,21,19490,20596,17253,-3343
2015,9,7,22,19820,20935,17699,-3236
2015,9,7,23,19500,20670,17352,-3318
2015,9,8,0,19340,20748,17533,-3215
2015,9,8,1,19080,20432,17180,-3252
2015,9,8,2,17910,19018,15902,-3116
2015,9,8,3,16340,17176,14321,-2855
2015,9,8,4,14860,15971,13171,-2800
2015,9,8,5,14000,15410,12345,-3065
2015,9,8,6,13310,14974,11886,-3088
2015,9,8,7,12860,14608,11871,-2737
2015,9,8,8,12640,14384,11847,-2537
2015,9,8,9,13180,14551,12141,-2410
2015,9,8,10,14040,15251,12772,-2479
2015,9,8,11,15430,16394,13893,-2501
2015,9,8,12,16850,17557,14669,-2888
2015,9,8,13,18000,18415,15308,-3107
2015,9,8,14,19220,19584,16269,-3315
2015,9,8,15,20380,20837,17490,-3347
2015,9,8,16,21400,21963,18472,-3491
2015,9,8,17,22190,22923,19522,-3401
2015,9,8,18,22990,23765,20394,-3371
2015,9,8,19,23470,24138,20755,-3383
2015,9,8,20,23830,24257,20840,-3417
2015,9,8,21,24000,24280,20849,-3431
2015,9,8,22,23970,24058,20544,-3514
2015,9,8,23,23060,23531,20058,-3473
2015,9,9,0,22910,23434,20033,-3401
2015,9,9,1,22210,22714,19029,-3685
2015,9,9,2,20730,20998,17423,-3575
2015,9,9,3,18620,18878,15589,-3289
2015,9,9,4,16800,17469,14402,-3067
2015,9,9,5,15670,16472,13697,-2775
2015,9,9,6,14830,15834,13079,-2755
2015,9,9,7,14120,15492,13054,-2438
2015,9,9,8,13810,15377,12863,-2514
2015,9,9,9,14090,15441,12917,-2524
2015,9,9,10,14980,16286,13555,-2731
2015,9,9,11,16470,17215,14857,-2358
2015,9,9,12,17800,17818,15203,-2615
2015,9,9,13,18740,18755,15831,-2924
2015,9,9,14,19710,19766,16385,-3381
2015,9,9,15,20660,20825,17405,-3420
2015,9,9,16,21580,21694,18306,-3388
2015,9,9,17,22430,22468,18949,-3519
2015,9,9,18,23120,23295,19768,-3527
2015,9,9,19,23460,23811,20404,-3407
2015,9,9,20,23700,24091,20912,-3179
2015,9,9,21,23810,24247,21256,-2991
2015,9,9,22,23710,23971,21240,-2731
2015,9,9,23,22840,23379,20298,-3081
2015,9,10,0,22730,23269,20058,-3211
2015,9,10,1,22090,22621,19348,-3273
2015,9,10,2,20480,21036,17824,-3212
2015,9,10,3,18460,18995,15948,-3047
2015,9,10,4,16660,17354,14817,-2537
2015,9,10,5,15580,16147,13553,-2594
2015,9,10,6,14690,15756,13310,-2446
2015,9,10,7,14210,15879,13280,-2599
2015,9,10,8,13960,15623,12944,-2679
2015,9,10,9,14300,15687,12921,-2766
2015,9,10,10,15190,15897,13413,-2484
2015,9,10,11,16680,16974,14410,-2564
2015,9,10,12,17630,17843,15493,-2350
2015,9,10,13,18370,18392,15682,-2710
2015,9,10,14,19040,18784,15776,-3008
2015,9,10,15,19540,19051,16175,-2876
2015,9,10,16,19970,19127,16149,-2978
2015,9,10,17,20150,19066,16033,-3033
2015,9,10,18,20400,18963,16042,-2921
2015,9,10,19,20260,18628,15784,-2844
2015,9,10,20,20010,18369,15481,-2888
2015,9,10,21,19870,18262,15396,-2866
2015,9,10,22,19600,18184,14873,-3311
2015,9,10,23,19620,18027,14663,-3364
2015,9,11,0,19400,18066,14656,-3410
2015,9,11,1,18580,17469,14216,-3253
2015,9,11,2,17380,16299,13151,-3148
2015,9,11,3,15660,14956,11983,-2973
2015,9,11,4,14140,13616,11093,-2523
2015,9,11,5,12930,13137,10199,-2938
2015,9,11,6,12360,12989,9799,-3190
2015,9,11,7,11970,12605,9847,-2758
2015,9,11,8,11760,12453,9906,-2547
2015,9,11,9,11540,12629,10333,-2296
2015,9,11,10,12400,13303,10613,-2690
2015,9,11,11,13850,14442,11537,-2905
2015,9,11,12,14880,15070,12021,-3049
2015,9,11,13,15500,15619,12478,-3141
2015,9,11,14,15890,15989,12789,-3200
2015,9,11,15,16190,16223,12903,-3320
2015,9,11,16,16380,16309,12917,-3392
2015,9,11,17,16500,16325,13053,-3272
2015,9,11,18,16760,16504,13069,-3435
2015,9,11,19,16860,16618,13221,-3397
2015,9,11,20,16970,16679,13060,-3619
2015,9,11,21,17080,16789,13493,-3296
2015,9,11,22,16990,16756,13906,-2850
2015,9,11,23,16680,16471,13510,-2961
2015,9,12,0,16670,16553,13532,-3021
2015,9,12,1,16300,16176,13632,-2544
2015,9,12,2,15350,15197,12405,-2792
2015,9,12,3,14090,13952,11501,-2451
2015,9,12,4,12830,12975,10950,-2025
2015,9,12,5,11800,12255,9990,-2265
2015,9,12,6,11130,11614,9602,-2012
2015,9,12,7,10700,11759,9670,-2089
2015,9,12,8,10500,11850,9759,-2091
2015,9,12,9,10480,11838,9269,-2569
2015,9,12,10,10770,12082,9155,-2927
2015,9,12,11,11350,12030,9443,-2587
2015,9,12,12,12090,12482,10081,-2401
2015,9,12,13,13080,13030,11254,-1776
2015,9,12,14,13870,13735,11724,-2011
2015,9,12,15,14410,14239,11726,-2513
2015,9,12,16,14740,14595,11903,-2692
2015,9,12,17,14780,14854,12022,-2832
2015,9,12,18,14810,15031,12351,-2680
2015,9,12,19,14870,15146,12292,-2854
2015,9,12,20,14960,15305,12486,-2819
2015,9,12,21,15140,15360,12627,-2733
2015,9,12,22,15230,15351,12465,-2886
2015,9,12,23,15210,15384,12112,-3272
2015,9,13,0,15500,15681,12733,-2948
2015,9,13,1,15160,15317,12275,-3042
2015,9,13,2,14330,14557,11747,-2810
2015,9,13,3,13310,13563,11229,-2334
2015,9,13,4,12220,12480,10250,-2230
2015,9,13,5,11310,11709,9283,-2426
2015,9,13,6,10710,11282,9188,-2094
2015,9,13,7,10400,11207,9142,-2065
2015,9,13,8,10210,11272,9062,-2210
2015,9,13,9,10130,11245,8973,-2272
2015,9,13,10,10550,11396,9027,-2369
2015,9,13,11,10810,11730,9367,-2363
2015,9,13,12,11430,12408,9896,-2512
2015,9,13,13,12320,12568,10221,-2347
2015,9,13,14,13070,13323,10685,-2638
2015,9,13,15,13580,13927,10989,-2938
2015,9,13,16,13960,14303,11027,-3276
2015,9,13,17,14200,14573,11222,-3351
2015,9,13,18,14320,14714,11584,-3130
2015,9,13,19,14380,14750,11600,-3150
2015,9,13,20,14550,14875,11634,-3241
2015,9,13,21,14800,15186,11799,-3387
2015,9,13,22,15040,15493,12065,-3428
2015,9,13,23,15190,15634,12001,-3633
2015,9,14,0,15400,15848,12437,-3411
2015,9,14,1,15120,15362,11843,-3519
2015,9,14,2,14250,14361,11206,-3155
2015,9,14,3,13060,13148,10512,-2636
2015,9,14,4,11890,11962,9699,-2263
2015,9,14,5,10980,11380,9454,-1926
2015,9,14,6,10510,11100,9147,-1953
2015,9,14,7,10210,11046,9074,-1972
2015,9,14,8,10130,10939,8809,-2130
2015,9,14,9,10360,10942,8954,-1988
2015,9,14,10,11180,11207,9452,-1755
2015,9,14,11,12670,12673,10482,-2191
2015,9,14,12,13800,13710,10953,-2757
2015,9,14,13,14430,14275,11105,-3170
2015,9,14,14,14800,14681,11110,-3571
2015,9,14,15,15130,15071,11367,-3704
2015,9,14,16,15340,15296,11972,-3324
2015,9,14,17,15420,15384,11899,-3485
2015,9,14,18,15600,15540,11903,-3637
2015,9,14,19,15630,15498,11866,-3632
2015,9,14,20,15710,15495,11854,-3641
2015,9,14,21,15830,15569,11992,-3577
2015,9,14,22,15920,15699,12133,-3566
2015,9,14,23,15860,15691,12058,-3633
2015,9,15,0,16000,16012,12358,-3654
2015,9,15,1,15600,15562,11937,-3625
2015,9,15,2,14600,14363,11308,-3055
2015,9,15,3,13200,12966,10359,-2607
2015,9,15,4,11920,11914,10133,-1781
2015,9,15,5,10990,11038,9582,-1456
2015,9,15,6,10500,10498,9624,-874
2015,9,15,7,10170,10319,9688,-631
2015,9,15,8,10090,10247,9679,-568
2015,9,15,9,10330,10487,9696,-791
2015,9,15,10,11200,11417,10127,-1290
2015,9,15,11,12880,12844,11041,-1803
2015,9,15,12,14060,13804,11518,-2286
2015,9,15,13,14650,14333,11954,-2379
2015,9,15,14,15160,14780,12246,-2534
2015,9,15,15,15690,15225,12865,-2360
2015,9,15,16,16050,15593,13291,-2302
2015,9,15,17,16190,15890,13643,-2247
2015,9,15,18,16590,16320,13959,-2361
2015,9,15,19,16760,16689,14367,-2322
2015,9,15,20,16910,17010,15054,-1956
2015,9,15,21,17000,17361,15502,-1859
2015,9,15,22,17200,17569,15701,-1868
2015,9,15,23,16920,17340,15385,-1955
2015,9,16,0,17030,17530,15280,-2250
2015,9,16,1,16600,16999,14638,-2361
2015,9,16,2,15450,15699,13562,-2137
2015,9,16,3,13880,14087,12068,-2019
2015,9,16,4,12470,12703,10762,-1941
2015,9,16,5,11530,11958,10146,-1812
2015,9,16,6,10980,11885,10152,-1733
2015,9,16,7,10620,11832,9821,-2011
2015,9,16,8,10520,11700,9594,-2106
2015,9,16,9,10750,11883,9680,-2203
2015,9,16,10,11750,12504,10585,-1919
2015,9,16,11,13410,13549,11348,-2201
2015,9,16,12,14590,14286,12150,-2136
2015,9,16,13,15260,14887,12928,-1959
2015,9,16,14,15950,15485,13410,-2075
2015,9,16,15,16580,16136,14318,-1818
2015,9,16,16,17070,16675,14778,-1897
2015,9,16,17,17400,17111,14948,-2163
2015,9,16,18,17880,17694,15373,-2321
2015,9,16,19,18140,18124,16165,-1959
2015,9,16,20,18360,18516,16257,-2259
2015,9,16,21,18420,18837,16506,-2331
2015,9,16,22,18550,18859,16607,-2252
2015,9,16,23,18120,18466,16175,-2291
2015,9,17,0,18240,18623,16298,-2325
2015,9,17,1,17690,17989,15480,-2509
2015,9,17,2,16430,16630,14183,-2447
2015,9,17,3,14770,14980,12756,-2224
2015,9,17,4,13260,13614,11763,-1851
2015,9,17,5,12270,13367,11269,-2098
2015,9,17,6,11590,13036,11081,-1955
2015,9,17,7,11180,12668,10463,-2205
2015,9,17,8,11050,12432,10357,-2075
2015,9,17,9,11240,12589,10622,-1967
2015,9,17,10,12190,13419,11605,-1814
2015,9,17,11,13810,14496,12423,-2073
2015,9,17,12,14980,14729,12602,-2127
2015,9,17,13,15720,15403,13299,-2104
2015,9,17,14,16510,16035,14030,-2005
2015,9,17,15,17300,16803,14522,-2281
2015,9,17,16,17960,17458,14987,-2471
2015,9,17,17,18460,18028,15465,-2563
2015,9,17,18,19010,18710,16064,-2646
2015,9,17,19,19300,19218,16941,-2277
2015,9,17,20,19500,19598,17078,-2520
2015,9,17,21,19620,19837,17234,-2603
2015,9,17,22,19480,19723,16926,-2797
2015,9,17,23,18870,19184,16313,-2871
2015,9,18,0,19030,19253,15919,-3334
2015,9,18,1,18420,18595,15022,-3573
2015,9,18,2,17060,17222,14069,-3153
2015,9,18,3,15350,15471,12789,-2682
2015,9,18,4,13750,13889,11580,-2309
2015,9,18,5,12700,13132,10599,-2533
2015,9,18,6,11980,12861,10339,-2522
2015,9,18,7,11470,12907,9865,-3042
2015,9,18,8,11300,12682,9287,-3395
2015,9,18,9,11480,12791,9549,-3242
2015,9,18,10,12300,13370,10287,-3083
2015,9,18,11,13800,14307,11130,-3177
2015,9,18,12,14940,14775,11506,-3269
2015,9,18,13,15670,15474,11907,-3567
2015,9,18,14,16390,16154,12720,-3434
2015,9,18,15,17100,16920,13734,-3186
2015,9,18,16,17660,17587,14694,-2893
2015,9,18,17,18070,18064,15043,-3021
2015,9,18,18,18540,18610,15223,-3387
2015,9,18,19,18840,18969,15366,-3603
2015,9,18,20,19080,19243,15659,-3584
2015,9,18,21,18970,19373,16108,-3265
2015,9,18,22,18870,19086,15761,-3325
2015,9,18,23,18220,18401,14847,-3554
2015,9,19,0,18200,18250,14648,-3602
2015,9,19,1,17520,17525,14068,-3457
2015,9,19,2,16340,16375,13358,-3017
2015,9,19,3,14830,14960,12054,-2906
2015,9,19,4,13380,13565,10401,-3164
2015,9,19,5,12570,12484,8921,-3563
2015,9,19,6,11840,12177,8543,-3634
2015,9,19,7,11330,12088,8585,-3503
2015,9,19,8,11040,11870,8205,-3665
2015,9,19,9,11040,11782,8024,-3758
2015,9,19,10,11350,12077,8479,-3598
2015,9,19,11,11970,12120,8820,-3300
2015,9,19,12,12660,12603,9709,-2894
2015,9,19,13,13580,13610,10829,-2781
2015,9,19,14,14410,14329,11355,-2974
2015,9,19,15,15030,14878,11642,-3236
2015,9,19,16,15510,15350,11959,-3391
2015,9,19,17,15800,15733,12480,-3253
2015,9,19,18,16010,15995,12612,-3383
2015,9,19,19,16220,16216,12846,-3370
2015,9,19,20,16420,16461,13170,-3291
2015,9,19,21,16570,16683,13349,-3334
2015,9,19,22,16650,16717,13091,-3626
2015,9,19,23,16440,16484,12892,-3592
2015,9,20,0,16680,16638,13110,-3528
2015,9,20,1,16200,16147,12570,-3577
2015,9,20,2,15270,15324,11920,-3404
2015,9,20,3,14180,14269,10820,-3449
2015,9,20,4,13030,13207,9817,-3390
2015,9,20,5,12200,12348,9198,-3150
2015,9,20,6,11520,11780,8751,-3029
2015,9,20,7,11110,11675,8602,-3073
2015,9,20,8,10900,11729,8553,-3176
2015,9,20,9,11130,11729,8570,-3159
2015,9,20,10,11320,12182,8937,-3245
2015,9,20,11,11600,12792,9351,-3441
2015,9,20,12,12010,13360,9965,-3395
2015,9,20,13,12740,13656,10288,-3368
2015,9,20,14,13380,14121,10700,-3421
2015,9,20,15,13750,14009,10736,-3273
2015,9,20,16,14060,14113,10980,-3133
2015,9,20,17,14200,14293,11074,-3219
2015,9,20,18,14280,14346,11176,-3170
2015,9,20,19,14250,14398,11214,-3184
2015,9,20,20,14310,14534,11597,-2937
2015,9,20,21,14530,14731,11731,-3000
2015,9,20,22,14780,15060,11940,-3120
2015,9,20,23,14750,15068,11912,-3156
2015,9,21,0,15100,15363,12168,-3195
2015,9,21,1,14680,14781,11899,-2882
2015,9,21,2,13590,13641,10922,-2719
2015,9,21,3,12320,12301,9337,-2964
2015,9,21,4,11230,11319,8559,-2760
2015,9,21,5,10440,10637,7855,-2782
2015,9,21,6,10000,10594,7746,-2848
2015,9,21,7,9780,10524,8037,-2487
2015,9,21,8,9770,10719,8191,-2528
2015,9,21,9,9970,10938,7991,-2947
2015,9,21,10,10920,11339,8267,-3072
2015,9,21,11,12510,12464,9298,-3166
2015,9,21,12,13610,13399,10480,-2919
2015,9,21,13,14050,13750,10751,-2999
2015,9,21,14,14320,14001,10849,-3152
2015,9,21,15,14560,14247,11172,-3075
2015,9,21,16,14720,14420,11375,-3045
2015,9,21,17,14830,14458,11481,-2977
2015,9,21,18,14970,14672,11675,-2997
2015,9,21,19,14990,14711,11762,-2949
2015,9,21,20,15010,14769,11994,-2775
2015,9,21,21,15120,14908,12164,-2744
2015,9,21,22,15380,15063,11973,-3090
2015,9,21,23,15390,15226,11960,-3266
2015,9,22,0,15700,15654,12451,-3203
2015,9,22,1,15100,15006,12042,-2964
2015,9,22,2,13940,13851,10966,-2885
2015,9,22,3,12500,12442,9350,-3092
2015,9,22,4,11270,11281,8328,-2953
2015,9,22,5,10450,10525,7976,-2549
2015,9,22,6,10010,10003,7828,-2175
2015,9,22,7,9780,10224,7973,-2251
2015,9,22,8,9730,10306,7914,-2392
2015,9,22,9,10010,10419,8027,-2392
2015,9,22,10,10960,11151,8525,-2626
2015,9,22,11,12680,12644,9710,-2934
2015,9,22,12,13740,13711,11069,-2642
2015,9,22,13,14130,14088,11535,-2553
2015,9,22,14,14420,14379,11808,-2571
2015,9,22,15,14680,14684,11922,-2762
2015,9,22,16,14890,14814,12280,-2534
2015,9,22,17,14920,14858,12416,-2442
2015,9,22,18,15090,14953,12404,-2549
2015,9,22,19,15100,14928,12277,-2651
2015,9,22,20,15160,14968,12103,-2865
2015,9,22,21,15220,15035,12335,-2700
2015,9,22,22,15430,15148,12509,-2639
2015,9,22,23,15410,15263,12763,-2500
2015,9,23,0,15750,15661,12942,-2719
2015,9,23,1,15170,15096,12535,-2561
2015,9,23,2,14060,13963,11517,-2446
2015,9,23,3,12610,12543,9990,-2553
2015,9,23,4,11370,11286,9065,-2221
2015,9,23,5,10540,10933,8307,-2626
2015,9,23,6,10090,10615,8154,-2461
2015,9,23,7,9840,10862,8500,-2362
2015,9,23,8,9750,10826,8356,-2470
2015,9,23,9,10010,10955,8233,-2722
2015,9,23,10,10950,11256,8641,-2615
2015,9,23,11,12620,12382,9895,-2487
2015,9,23,12,13710,13362,10883,-2479
2015,9,23,13,14080,13774,11224,-2550
2015,9,23,14,14350,14021,11632,-2389
2015,9,23,15,14670,14325,11994,-2331
2015,9,23,16,14900,14508,12094,-2414
2015,9,23,17,15000,14633,12284,-2349
2015,9,23,18,15240,14858,12616,-2242
2015,9,23,19,15350,14986,12638,-2348
2015,9,23,20,15430,15164,12672,-2492
2015,9,23,21,15560,15420,12928,-2492
2015,9,23,22,15680,15604,13033,-2571
2015,9,23,23,15560,15604,12987,-2617
2015,9,24,0,15900,15928,13381,-2547
2015,9,24,1,15380,15306,12759,-2547
2015,9,24,2,14300,14123,11639,-2484
2015,9,24,3,12800,12773,10089,-2684
2015,9,24,4,11520,11678,9487,-2191
2015,9,24,5,10610,11272,9293,-1979
2015,9,24,6,10170,11049,9369,-1680
2015,9,24,7,9890,10649,8944,-1705
2015,9,24,8,9800,10552,8947,-1605
2015,9,24,9,10080,10807,9478,-1329
2015,9,24,10,11000,11459,9941,-1518
2015,9,24,11,12660,12672,10726,-1946
2015,9,24,12,13670,13573,11650,-1923
2015,9,24,13,14140,13988,11996,-1992
2015,9,24,14,14470,14317,12146,-2171
2015,9,24,15,14810,14655,12230,-2425
2015,9,24,16,15050,14906,12531,-2375
2015,9,24,17,15080,15043,12934,-2109
2015,9,24,18,15380,15307,13316,-1991
2015,9,24,19,15480,15398,13351,-2047
2015,9,24,20,15570,15507,13303,-2204
2015,9,24,21,15610,15644,13408,-2236
2015,9,24,22,15680,15697,13391,-2306
2015,9,24,23,15540,15658,13251,-2407
2015,9,25,0,15900,16056,13928,-2128
2015,9,25,1,15340,15463,13351,-2112
2015,9,25,2,14280,14307,12166,-2141
2015,9,25,3,12830,12871,10995,-1876
2015,9,25,4,11560,11836,9887,-1949
2015,9,25,5,10710,10726,9042,-1684
2015,9,25,6,10240,10459,8741,-1718
2015,9,25,7,9970,10297,8564,-1733
2015,9,25,8,9870,10329,8367,-1962
2015,9,25,9,10070,10558,8558,-2000
2015,9,25,10,10940,11166,9189,-1977
2015,9,25,11,12510,12416,10523,-1893
2015,9,25,12,13440,13399,11465,-1934
2015,9,25,13,13770,13842,11932,-1910
2015,9,25,14,13900,14079,11987,-2092
2015,9,25,15,14060,14335,12392,-1943
2015,9,25,16,14120,14474,12106,-2368
2015,9,25,17,14120,14429,12069,-2360
2015,9,25,18,14250,14515,12066,-2449
2015,9,25,19,14280,14509,12322,-2187
2015,9,25,20,14340,14459,12348,-2111
2015,9,25,21,14490,14507,12445,-2062
2015,9,25,22,14610,14528,12278,-2250
2015,9,25,23,14650,14595,12469,-2126
2015,9,26,0,14920,14856,12912,-1944
2015,9,26,1,14430,14298,12366,-1932
2015,9,26,2,13510,13424,11713,-1711
2015,9,26,3,12370,12309,10595,-1714
2015,9,26,4,11220,11212,9156,-2056
2015,9,26,5,10440,10368,8426,-1942
2015,9,26,6,9960,10297,8402,-1895
2015,9,26,7,9670,10391,8437,-1954
2015,9,26,8,9540,10527,8422,-2105
2015,9,26,9,9570,10562,8375,-2187
2015,9,26,10,9790,10580,8852,-1728
2015,9,26,11,10380,10946,9042,-1904
2015,9,26,12,11070,11795,9368,-2427
2015,9,26,13,11870,12234,10223,-2011
2015,9,26,14,12400,12645,10725,-1920
2015,9,26,15,12570,12499,10683,-1816
2015,9,26,16,12600,12497,10398,-2099
2015,9,26,17,12540,12396,10082,-2314
2015,9,26,18,12500,12248,10055,-2193
2015,9,26,19,12490,12163,10134,-2029
2015,9,26,20,12640,12255,10029,-2226
2015,9,26,21,12980,12510,10345,-2165
2015,9,26,22,13440,12850,10600,-2250
2015,9,26,23,13650,13231,11157,-2074
2015,9,27,0,13930,13631,11787,-1844
2015,9,27,1,13580,13211,11197,-2014
2015,9,27,2,12820,12507,10577,-1930
2015,9,27,3,11880,11587,9439,-2148
2015,9,27,4,10920,10644,8521,-2123
2015,9,27,5,10080,10164,8385,-1779
2015,9,27,6,9650,9863,8078,-1785
2015,9,27,7,9350,10009,8211,-1798
2015,9,27,8,9210,10149,8219,-1930
2015,9,27,9,9190,10172,8257,-1915
2015,9,27,10,9360,10390,8313,-2077
2015,9,27,11,9760,10511,8583,-1928
2015,9,27,12,10220,10908,8938,-1970
2015,9,27,13,11150,11287,9215,-2072
2015,9,27,14,11750,11591,9563,-2028
2015,9,27,15,11990,11815,9655,-2160
2015,9,27,16,12130,11953,9710,-2243
2015,9,27,17,12230,12101,10057,-2044
2015,9,27,18,12240,12155,10330,-1825
2015,9,27,19,12250,12232,10187,-2045
2015,9,27,20,12300,12407,10167,-2240
2015,9,27,21,12650,12893,10850,-2043
2015,9,27,22,13270,13459,11297,-2162
2015,9,27,23,13740,13971,11434,-2537
2015,9,28,0,14280,14473,12159,-2314
2015,9,28,1,13730,13881,11825,-2056
2015,9,28,2,12770,12879,10931,-1948
2015,9,28,3,11570,11698,9626,-2072
2015,9,28,4,10640,10712,8697,-2015
2015,9,28,5,9950,10091,7860,-2231
2015,9,28,6,9550,10127,7937,-2190
2015,9,28,7,9380,9936,7747,-2189
2015,9,28,8,9340,10118,7845,-2273
2015,9,28,9,9650,10205,7920,-2285
2015,9,28,10,10620,11174,8950,-2224
2015,9,28,11,12310,12490,10186,-2304
2015,9,28,12,13450,13481,11282,-2199
2015,9,28,13,13930,13948,11755,-2193
2015,9,28,14,14250,14329,12245,-2084
2015,9,28,15,14680,14732,12643,-2089
2015,9,28,16,15020,15027,12876,-2151
2015,9,28,17,15230,15249,12960,-2289
2015,9,28,18,15550,15581,13303,-2278
2015,9,28,19,15730,15723,13493,-2230
2015,9,28,20,15910,15815,13653,-2162
2015,9,28,21,15970,16000,13876,-2124
2015,9,28,22,16180,16192,14130,-2062
2015,9,28,23,16340,16473,14364,-2109
2015,9,29,0,16570,16815,14487,-2328
2015,9,29,1,16080,16101,13791,-2310
2015,9,29,2,14690,14903,12640,-2263
2015,9,29,3,13200,13443,11061,-2382
2015,9,29,4,11890,12154,9845,-2309
2015,9,29,5,10940,11771,9445,-2326
2015,9,29,6,10350,11519,9206,-2313
2015,9,29,7,10110,11544,9039,-2505
2015,9,29,8,10100,11505,8818,-2687
2015,9,29,9,10580,11783,9159,-2624
2015,9,29,10,11660,12297,10046,-2251
2015,9,29,11,13450,13669,11583,-2086
2015,9,29,12,14430,14844,12666,-2178
2015,9,29,13,15110,15451,13306,-2145
2015,9,29,14,15480,15950,13931,-2019
2015,9,29,15,15870,16449,14418,-2031
2015,9,29,16,16250,16828,14637,-2191
2015,9,29,17,16450,17185,15071,-2114
2015,9,29,18,16630,17526,15599,-1927
2015,9,29,19,16800,17627,15270,-2357
2015,9,29,20,16760,17673,15233,-2440
2015,9,29,21,16810,17741,15325,-2416
2015,9,29,22,17010,17848,15563,-2285
2015,9,29,23,17320,18132,15927,-2205
2015,9,30,0,17580,18246,15894,-2352
2015,9,30,1,17140,17519,15424,-2095
2015,9,30,2,15690,16326,14298,-2028
2015,9,30,3,14160,14840,12798,-2042
2015,9,30,4,12800,13514,11481,-2033
2015,9,30,5,12260,13047,10795,-2252
2015,9,30,6,11710,12989,10557,-2432
2015,9,30,7,11410,12845,10330,-2515
2015,9,30,8,11230,12911,10330,-2581
2015,9,30,9,11840,13189,10689,-2500
2015,9,30,10,12670,13769,11325,-2444
2015,9,30,11,14480,15010,12554,-2456
2015,9,30,12,15610,16273,14014,-2259
2015,9,30,13,16070,16915,14569,-2346
2015,9,30,14,16420,17352,15113,-2239
2015,9,30,15,16700,17754,15197,-2557
2015,9,30,16,16900,17902,15446,-2456
2015,9,30,17,16890,17857,15331,-2526
2015,9,30,18,17000,17801,15237,-2564
2015,9,30,19,16910,17476,14881,-2595
2015,9,30,20,16810,17007,14410,-2597
2015,9,30,21,16700,16702,14121,-2581
2015,9,30,22,16670,16595,14035,-2560
2015,9,30,23,16980,16605,14273,-2332
2015,10,1,0,16690,16587,14350,-2237
2015,10,1,1,15840,15861,13535,-2326
2015,10,1,2,14650,14740,12563,-2177
2015,10,1,3,13120,13713,11493,-2220
2015,10,1,4,11850,12396,10224,-2172
2015,10,1,5,11180,11808,9311,-2497
2015,10,1,6,10600,11485,9088,-2397
2015,10,1,7,10310,11310,9104,-2206
2015,10,1,8,10210,11201,8541,-2660
2015,10,1,9,10100,11354,8480,-2874
2015,10,1,10,10990,11783,9206,-2577
2015,10,1,11,12850,13095,10730,-2365
2015,10,1,12,13980,13930,11345,-2585
2015,10,1,13,14360,14036,11207,-2829
2015,10,1,14,14570,14139,11312,-2827
2015,10,1,15,14760,14299,11670,-2629
2015,10,1,16,14800,14345,11906,-2439
2015,10,1,17,14750,14280,11913,-2367
2015,10,1,18,14870,14309,11917,-2392
2015,10,1,19,14830,14216,11880,-2336
2015,10,1,20,14830,14234,11839,-2395
2015,10,1,21,14960,14346,11842,-2504
2015,10,1,22,15200,14665,12191,-2474
2015,10,1,23,15680,15152,12500,-2652
2015,10,2,0,15800,15292,12714,-2578
2015,10,2,1,15030,14680,12249,-2431
2015,10,2,2,13970,13655,11539,-2116
2015,10,2,3,12600,12284,10539,-1745
2015,10,2,4,11360,11405,9173,-2232
2015,10,2,5,10250,10700,8037,-2663
2015,10,2,6,9900,10144,7751,-2393
2015,10,2,7,9650,10090,7761,-2329
2015,10,2,8,9600,10019,7646,-2373
2015,10,2,9,9750,10237,7696,-2541
2015,10,2,10,10690,11023,8317,-2706
2015,10,2,11,12430,12349,9765,-2584
2015,10,2,12,13470,13443,10782,-2661
2015,10,2,13,13680,13916,11689,-2227
2015,10,2,14,13820,14148,11873,-2275
2015,10,2,15,13880,14296,11946,-2350
2015,10,2,16,13820,14312,11647,-2665
2015,10,2,17,13700,14234,11696,-2538
2015,10,2,18,13720,14211,11696,-2515
2015,10,2,19,13620,14119,11544,-2575
2015,10,2,20,13540,14065,11558,-2507
2015,10,2,21,13590,14173,11484,-2689
2015,10,2,22,13820,14443,11608,-2835
2015,10,2,23,14020,14822,11664,-3158
2015,10,3,0,14500,14771,11762,-3009
2015,10,3,1,14050,14190,11497,-2693
2015,10,3,2,13300,13376,11105,-2271
2015,10,3,3,12210,12302,9575,-2727
2015,10,3,4,11080,11239,8548,-2691
2015,10,3,5,10350,10898,8199,-2699
2015,10,3,6,9860,10434,7924,-2510
2015,10,3,7,9600,10150,7760,-2390
2015,10,3,8,9470,10279,7771,-2508
2015,10,3,9,9460,10401,7840,-2561
2015,10,3,10,9850,10729,8021,-2708
2015,10,3,11,10520,11165,8574,-2591
2015,10,3,12,11390,11981,9459,-2522
2015,10,3,13,12480,12689,9950,-2739
2015,10,3,14,13220,13122,10998,-2124
2015,10,3,15,13570,13410,11494,-1916
2015,10,3,16,13700,13425,11400,-2025
2015,10,3,17,13540,13300,11028,-2272
2015,10,3,18,13260,13072,10704,-2368
2015,10,3,19,12990,12887,10731,-2156
2015,10,3,20,12940,12846,10833,-2013
2015,10,3,21,13240,12993,10881,-2112
2015,10,3,22,13620,13352,11247,-2105
2015,10,3,23,14050,13896,11484,-2412
2015,10,4,0,14300,14014,11719,-2295
2015,10,4,1,13510,13571,11778,-1793
2015,10,4,2,12840,12882,11122,-1760
2015,10,4,3,11990,11974,10070,-1904
2015,10,4,4,11020,11006,9119,-1887
2015,10,4,5,10260,10227,7890,-2337
2015,10,4,6,9760,9750,7468,-2282
2015,10,4,7,9470,9746,7394,-2352
2015,10,4,8,9350,9825,7352,-2473
2015,10,4,9,9360,9927,7513,-2414
2015,10,4,10,9600,9979,7573,-2406
2015,10,4,11,10070,10316,7843,-2473
2015,10,4,12,10710,10616,8665,-1951
2015,10,4,13,11640,11411,9353,-2058
2015,10,4,14,12260,11881,9651,-2230
2015,10,4,15,12540,12092,9532,-2560
2015,10,4,16,12660,12164,9737,-2427
2015,10,4,17,12660,12113,10102,-2011
2015,10,4,18,12530,12002,9901,-2101
2015,10,4,19,12400,11934,10025,-1909
2015,10,4,20,12500,12054,10227,-1827
2015,10,4,21,12840,12476,10466,-2010
2015,10,4,22,13400,13123,10880,-2243
2015,10,4,23,14330,13933,11451,-2482
2015,10,5,0,14500,14366,11867,-2499
2015,10,5,1,13800,13796,11059,-2737
2015,10,5,2,12830,12807,9982,-2825
2015,10,5,3,11770,11643,9055,-2588
2015,10,5,4,10760,10584,7758,-2826
2015,10,5,5,9980,10163,6992,-3171
2015,10,5,6,9600,10275,7096,-3179
2015,10,5,7,9390,10334,7342,-2992
2015,10,5,8,9400,10493,7243,-3250
2015,10,5,9,9710,10812,7822,-2990
2015,10,5,10,10780,11437,8368,-3069
2015,10,5,11,12640,12635,9679,-2956
2015,10,5,12,13670,13698,10680,-3018
2015,10,5,13,13980,13938,11058,-2880
2015,10,5,14,14070,13966,11188,-2778
2015,10,5,15,14160,14033,10876,-3157
2015,10,5,16,14100,14077,10787,-3290
2015,10,5,17,14050,14043,10525,-3518
2015,10,5,18,14080,14100,10389,-3711
2015,10,5,19,14060,14044,10401,-3643
2015,10,5,20,14110,14004,10454,-3550
2015,10,5,21,14320,14155,10984,-3171
2015,10,5,22,14710,14522,11397,-3125
2015,10,5,23,15330,15157,11820,-3337
2015,10,6,0,15700,15423,12134,-3289
2015,10,6,1,14880,14762,11388,-3374
2015,10,6,2,13720,13643,10515,-3128
2015,10,6,3,12320,12329,8917,-3412
2015,10,6,4,11070,11678,8099,-3579
2015,10,6,5,10220,11124,8029,-3095
2015,10,6,6,9810,10977,7816,-3161
2015,10,6,7,9640,10765,7846,-2919
2015,10,6,8,9630,10725,7466,-3259
2015,10,6,9,9920,11004,7779,-3225
2015,10,6,10,10960,11704,8539,-3165
2015,10,6,11,12690,12803,9587,-3216
2015,10,6,12,13690,13769,10452,-3317
2015,10,6,13,13810,13878,10762,-3116
2015,10,6,14,13880,13855,11046,-2809
2015,10,6,15,13940,13884,11022,-2862
2015,10,6,16,13970,13900,11007,-2893
2015,10,6,17,13950,13869,10944,-2925
2015,10,6,18,14050,13948,11071,-2877
2015,10,6,19,14040,13936,11166,-2770
2015,10,6,20,14030,13983,11067,-2916
2015,10,6,21,14210,14253,11287,-2966
2015,10,6,22,14510,14654,11669,-2985
2015,10,6,23,15130,15225,12231,-2994
2015,10,7,0,15350,15446,12282,-3164
2015,10,7,1,14630,14767,11506,-3261
2015,10,7,2,13560,13665,10759,-2906
2015,10,7,3,12100,12283,9684,-2599
2015,10,7,4,10910,11040,8533,-2507
2015,10,7,5,10260,10684,7702,-2982
2015,10,7,6,9840,10763,7489,-3274
2015,10,7,7,9640,10713,7347,-3366
2015,10,7,8,9570,10734,7213,-3521
2015,10,7,9,9870,10933,7307,-3626
2015,10,7,10,10880,11344,7935,-3409
2015,10,7,11,12740,12740,9597,-3143
2015,10,7,12,13730,13711,10658,-3053
2015,10,7,13,13850,13863,10839,-3024
2015,10,7,14,13930,13889,10820,-3069
2015,10,7,15,14040,13952,10945,-3007
2015,10,7,16,14080,14008,10832,-3176
2015,10,7,17,14010,13995,10885,-3110
2015,10,7,18,14100,14110,11015,-3095
2015,10,7,19,14180,14140,11174,-2966
2015,10,7,20,14210,14249,11311,-2938
2015,10,7,21,14470,14489,11550,-2939
2015,10,7,22,14740,14804,11675,-3129
2015,10,7,23,15190,15311,12179,-3132
2015,10,8,0,15360,15542,12558,-2984
2015,10,8,1,14770,14860,11757,-3103
2015,10,8,2,13680,13746,10676,-3070
2015,10,8,3,12280,12352,9334,-3018
2015,10,8,4,11070,11156,8221,-2935
2015,10,8,5,10330,11079,7923,-3156
2015,10,8,6,9840,11102,7957,-3145
2015,10,8,7,9630,11025,7998,-3027
2015,10,8,8,9590,10944,7693,-3251
2015,10,8,9,9890,11184,7941,-3243
2015,10,8,10,10850,11809,8539,-3270
2015,10,8,11,12710,12628,9569,-3059
2015,10,8,12,13710,13596,10378,-3218
2015,10,8,13,13870,13753,10708,-3045
2015,10,8,14,13940,13733,10450,-3283
2015,10,8,15,14030,13761,10472,-3289
2015,10,8,16,14030,13761,10452,-3309
2015,10,8,17,14020,13723,10585,-3138
2015,10,8,18,14120,13836,10831,-3005
2015,10,8,19,14090,13825,10776,-3049
2015,10,8,20,14120,13846,10682,-3164
2015,10,8,21,14290,14066,10820,-3246
2015,10,8,22,14630,14385,11125,-3260
2015,10,8,23,15250,14985,11705,-3280
2015,10,9,0,15330,15231,12111,-3120
2015,10,9,1,14730,14653,11434,-3219
2015,10,9,2,13690,13646,10514,-3132
2015,10,9,3,12310,12314,9341,-2973
2015,10,9,4,11100,11076,8596,-2480
2015,10,9,5,10170,10618,7828,-2790
2015,10,9,6,9770,10578,7561,-3017
2015,10,9,7,9560,10642,8046,-2596
2015,10,9,8,9520,10666,8032,-2634
2015,10,9,9,9810,10845,8035,-2810
2015,10,9,10,10790,11403,8570,-2833
2015,10,9,11,12540,12590,10062,-2528
2015,10,9,12,13650,13652,11146,-2506
2015,10,9,13,13950,14157,11584,-2573
2015,10,9,14,14140,14465,11580,-2885
2015,10,9,15,14340,14816,11875,-2941
2015,10,9,16,14410,14941,12002,-2939
2015,10,9,17,14400,14940,11951,-2989
2015,10,9,18,14450,14988,12039,-2949
2015,10,9,19,14380,14933,12061,-2872
2015,10,9,20,14330,14844,12074,-2770
2015,10,9,21,14400,14938,12286,-2652
2015,10,9,22,14570,15196,12450,-2746
2015,10,9,23,14950,15460,12672,-2788
2015,10,10,0,14840,15135,12355,-2780
2015,10,10,1,14240,14498,11547,-2951
2015,10,10,2,13340,13637,10794,-2843
2015,10,10,3,12250,12517,9854,-2663
2015,10,10,4,11120,11346,8887,-2459
2015,10,10,5,10230,10789,8172,-2617
2015,10,10,6,9750,10718,7925,-2793
2015,10,10,7,9490,10357,7548,-2809
2015,10,10,8,9360,10454,7301,-3153
2015,10,10,9,9380,10509,7474,-3035
2015,10,10,10,9740,10590,7710,-2880
2015,10,10,11,10430,10983,8118,-2865
2015,10,10,12,11180,11383,8597,-2786
2015,10,10,13,12050,12106,9195,-2911
2015,10,10,14,12470,12548,9518,-3030
2015,10,10,15,12600,12605,9750,-2855
2015,10,10,16,12610,12481,9681,-2800
2015,10,10,17,12430,12035,9341,-2694
2015,10,10,18,12260,11812,9123,-2689
2015,10,10,19,12150,11692,9083,-2609
2015,10,10,20,12210,11767,9325,-2442
2015,10,10,21,12430,12136,9780,-2356
2015,10,10,22,12880,12693,10144,-2549
2015,10,10,23,13530,13416,10621,-2795
2015,10,11,0,13750,13585,10722,-2863
2015,10,11,1,13260,13172,10238,-2934
2015,10,11,2,12620,12531,9790,-2741
2015,10,11,3,11750,11669,8928,-2741
2015,10,11,4,10810,10749,7819,-2930
2015,10,11,5,10030,10316,7281,-3035
2015,10,11,6,9630,10148,7386,-2762
2015,10,11,7,9330,10179,7472,-2707
2015,10,11,8,9200,10320,7421,-2899
2015,10,11,9,9260,10350,7358,-2992
2015,10,11,10,9550,10226,7193,-3033
2015,10,11,11,10080,10544,7438,-3106
2015,10,11,12,10630,11115,8200,-2915
2015,10,11,13,11340,11596,8726,-2870
2015,10,11,14,11840,11769,9228,-2541
2015,10,11,15,12090,11890,9443,-2447
2015,10,11,16,12160,11835,9360,-2475
2015,10,11,17,12120,11756,9200,-2556
2015,10,11,18,11980,11686,8948,-2738
2015,10,11,19,11850,11678,8946,-2732
2015,10,11,20,11940,11861,9159,-2702
2015,10,11,21,12340,12351,9538,-2813
2015,10,11,22,13140,12892,10197,-2695
2015,10,11,23,13940,13595,10841,-2754
2015,10,12,0,14100,13720,11040,-2680
2015,10,12,1,13520,13254,10646,-2608
2015,10,12,2,12570,12392,9799,-2593
2015,10,12,3,11410,11439,8720,-2719
2015,10,12,4,10400,10517,7725,-2792
2015,10,12,5,9770,10046,7240,-2806
2015,10,12,6,9380,10222,7428,-2794
2015,10,12,7,9190,10034,7317,-2717
2015,10,12,8,9170,9991,7179,-2812
2015,10,12,9,9460,10218,7574,-2644
2015,10,12,10,10260,10636,7957,-2679
2015,10,12,11,11370,11569,8873,-2696
2015,10,12,12,12330,12230,9760,-2470
2015,10,12,13,12960,12861,10458,-2403
2015,10,12,14,13330,13275,10985,-2290
2015,10,12,15,13600,13503,11210,-2293
2015,10,12,16,13760,13606,11313,-2293
2015,10,12,17,13770,13606,11352,-2254
2015,10,12,18,13820,13638,11197,-2441
2015,10,12,19,13820,13659,11169,-2490
2015,10,12,20,13930,13833,11455,-2378
2015,10,12,21,14350,14188,11638,-2550
2015,10,12,22,14780,14668,12122,-2546
2015,10,12,23,15500,15282,12685,-2597
2015,10,13,0,15750,15332,13063,-2269
2015,10,13,1,14710,14573,12055,-2518
2015,10,13,2,13570,13464,10873,-2591
2015,10,13,3,12170,12397,9639,-2758
2015,10,13,4,10970,11238,8507,-2731
2015,10,13,5,10090,10906,8094,-2812
2015,10,13,6,9700,10755,7600,-3155
2015,10,13,7,9510,10567,7415,-3152
2015,10,13,8,9470,10516,7434,-3082
2015,10,13,9,9800,10788,7776,-3012
2015,10,13,10,10720,11769,8653,-3116
2015,10,13,11,12430,12828,9924,-2904
2015,10,13,12,13490,13773,10868,-2905
2015,10,13,13,13870,14208,11328,-2880
2015,10,13,14,14150,14531,11606,-2925
2015,10,13,15,14380,14678,11881,-2797
2015,10,13,16,14510,14653,11795,-2858
2015,10,13,17,14500,14712,11845,-2867
2015,10,13,18,14610,14813,12032,-2781
2015,10,13,19,14570,14790,11947,-2843
2015,10,13,20,14630,14761,11918,-2843
2015,10,13,21,14840,14901,12109,-2792
2015,10,13,22,15140,15185,12423,-2762
2015,10,13,23,15530,15802,13374,-2428
2015,10,14,0,15600,15751,13684,-2067
2015,10,14,1,14860,15019,12836,-2183
2015,10,14,2,13690,13878,11399,-2479
2015,10,14,3,12300,12547,10014,-2533
2015,10,14,4,10980,11477,9108,-2369
2015,10,14,5,10180,11403,8789,-2614
2015,10,14,6,9840,11007,8311,-2696
2015,10,14,7,9610,10715,7980,-2735
2015,10,14,8,9530,10636,8235,-2401
2015,10,14,9,9800,10871,8386,-2485
2015,10,14,10,10750,11796,9330,-2466
2015,10,14,11,12540,12591,10565,-2026
2015,10,14,12,13610,13528,11291,-2237
2015,10,14,13,13860,13735,11481,-2254
2015,10,14,14,14040,13855,11476,-2379
2015,10,14,15,14200,14043,11606,-2437
2015,10,14,16,14240,14161,11790,-2371
2015,10,14,17,14270,14186,11756,-2430
2015,10,14,18,14320,14245,11872,-2373
2015,10,14,19,14290,14182,11768,-2414
2015,10,14,20,14300,14104,11755,-2349
2015,10,14,21,14450,14194,11895,-2299
2015,10,14,22,14780,14537,12237,-2300
2015,10,14,23,15360,15226,12861,-2365
2015,10,15,0,15400,15251,13027,-2224
2015,10,15,1,14650,14566,12276,-2290
2015,10,15,2,13590,13471,11123,-2348
2015,10,15,3,12250,12268,9908,-2360
2015,10,15,4,10980,11363,8997,-2366
2015,10,15,5,10340,11133,8972,-2161
2015,10,15,6,9880,10791,8472,-2319
2015,10,15,7,9660,10567,8170,-2397
2015,10,15,8,9630,10527,8137,-2390
2015,10,15,9,9750,10798,8685,-2113
2015,10,15,10,10790,11731,9759,-1972
2015,10,15,11,12620,12789,10825,-1964
2015,10,15,12,13540,13715,11648,-2067
2015,10,15,13,13740,13816,11828,-1988
2015,10,15,14,13740,13713,11670,-2043
2015,10,15,15,13750,13619,11619,-2000
2015,10,15,16,13750,13550,11560,-1990
2015,10,15,17,13620,13456,11500,-1956
2015,10,15,18,13580,13476,11611,-1865
2015,10,15,19,13570,13455,11537,-1918
2015,10,15,20,13520,13524,11576,-1948
2015,10,15,21,13770,13840,11820,-2020
2015,10,15,22,14170,14311,12358,-1953
2015,10,15,23,15050,15092,13070,-2022
2015,10,16,0,14960,15198,13304,-1894
2015,10,16,1,14510,14602,12710,-1892
2015,10,16,2,13470,13587,11691,-1896
2015,10,16,3,12110,12270,10355,-1915
2015,10,16,4,10950,11069,9070,-1999
2015,10,16,5,10240,10772,8265,-2507
2015,10,16,6,9790,10620,8091,-2529
2015,10,16,7,9560,10362,7910,-2452
2015,10,16,8,9520,10315,8017,-2298
2015,10,16,9,9770,10579,8146,-2433
2015,10,16,10,10710,11549,9175,-2374
2015,10,16,11,12490,12683,10611,-2072
2015,10,16,12,13550,13726,11513,-2213
2015,10,16,13,13790,14054,11725,-2329
2015,10,16,14,13850,14148,11809,-2339
2015,10,16,15,13840,14105,11771,-2334
2015,10,16,16,13780,13891,11495,-2396
2015,10,16,17,13650,13725,11321,-2404
2015,10,16,18,13600,13662,11306,-2356
2015,10,16,19,13540,13556,11391,-2165
2015,10,16,20,13530,13503,11160,-2343
2015,10,16,21,13750,13647,11264,-2383
2015,10,16,22,14080,13987,11644,-2343
2015,10,16,23,14590,14602,12444,-2158
2015,10,17,0,14480,14556,12266,-2290
2015,10,17,1,13920,14012,11558,-2454
2015,10,17,2,13130,13234,10537,-2697
2015,10,17,3,12090,12229,9803,-2426
2015,10,17,4,11000,11434,9025,-2409
2015,10,17,5,10250,10882,8532,-2350
2015,10,17,6,9810,10699,8108,-2591
2015,10,17,7,9560,10592,7797,-2795
2015,10,17,8,9450,10622,7941,-2681
2015,10,17,9,9500,10468,8168,-2300
2015,10,17,10,9960,10820,8660,-2160
2015,10,17,11,10710,11300,8990,-2310
2015,10,17,12,11520,11661,9492,-2169
2015,10,17,13,12400,12401,10283,-2118
2015,10,17,14,12860,12652,10517,-2135
2015,10,17,15,12770,12671,10514,-2157
2015,10,17,16,12680,12570,10350,-2220
2015,10,17,17,12560,12435,10226,-2209
2015,10,17,18,12410,12268,10061,-2207
2015,10,17,19,12320,12161,9901,-2260
2015,10,17,20,12380,12248,10079,-2169
2015,10,17,21,12680,12583,10481,-2102
2015,10,17,22,13260,13206,11133,-2073
2015,10,17,23,14160,14031,11954,-2077
2015,10,18,0,14070,14004,11901,-2103
2015,10,18,1,13680,13575,11255,-2320
2015,10,18,2,12980,12964,10652,-2312
2015,10,18,3,12170,12144,9621,-2523
2015,10,18,4,11180,11486,9152,-2334
2015,10,18,5,10620,10767,8200,-2567
2015,10,18,6,10190,10810,7904,-2906
2015,10,18,7,9950,10640,7711,-2929
2015,10,18,8,9950,10545,7611,-2934
2015,10,18,9,9980,10625,7325,-3300
2015,10,18,10,10070,10926,7821,-3105
2015,10,18,11,10710,11785,8805,-2980
2015,10,18,12,11360,11981,9281,-2700
2015,10,18,13,12110,12547,9491,-3056
2015,10,18,14,12510,12498,9440,-3058
2015,10,18,15,12650,12548,9444,-3104
2015,10,18,16,12660,12617,9543,-3074
2015,10,18,17,12650,13014,9868,-3146
2015,10,18,18,12580,13141,10007,-3134
2015,10,18,19,12410,13177,10190,-2987
2015,10,18,20,12630,13310,10397,-2913
2015,10,18,21,13140,13754,10826,-2928
2015,10,18,22,13960,14276,11257,-3019
2015,10,18,23,14930,15212,12246,-2966
2015,10,19,0,14950,15261,12290,-2971
2015,10,19,1,14500,14773,11733,-3040
2015,10,19,2,13600,13809,10527,-3282
2015,10,19,3,12460,12790,9513,-3277
2015,10,19,4,11450,11797,8362,-3435
2015,10,19,5,10830,11281,7951,-3330
2015,10,19,6,10500,11179,7853,-3326
2015,10,19,7,10380,11239,7898,-3341
2015,10,19,8,10430,11277,7947,-3330
2015,10,19,9,10830,11658,8395,-3263
2015,10,19,10,11950,12524,9382,-3142
2015,10,19,11,13890,14061,11306,-2755
2015,10,19,12,14910,15209,12607,-2602
2015,10,19,13,14980,15264,12580,-2684
2015,10,19,14,14830,15049,12282,-2767
2015,10,19,15,14680,14835,12113,-2722
2015,10,19,16,14510,14576,11751,-2825
2015,10,19,17,14340,14292,11290,-3002
2015,10,19,18,14280,14110,11085,-3025
2015,10,19,19,14140,13933,11007,-2926
2015,10,19,20,14100,13941,11044,-2897
2015,10,19,21,14360,14339,11411,-2928
2015,10,19,22,15050,15137,12274,-2863
2015,10,19,23,16010,16143,13501,-2642
2015,10,20,0,15990,16145,13434,-2711
2015,10,20,1,15440,15467,12617,-2850
2015,10,20,2,14300,14388,11373,-3015
2015,10,20,3,12970,12948,9773,-3175
2015,10,20,4,11750,11683,8334,-3349
2015,10,20,5,10990,10953,7667,-3286
2015,10,20,6,10520,10687,7319,-3368
2015,10,20,7,10310,10550,7198,-3352
2015,10,20,8,10290,10667,7310,-3357
2015,10,20,9,10570,10942,7608,-3334
2015,10,20,10,11450,11729,8658,-3071
2015,10,20,11,13420,13374,10451,-2923
2015,10,20,12,14500,14397,11747,-2650
2015,10,20,13,14530,14496,11839,-2657
2015,10,20,14,14480,14382,11690,-2692
2015,10,20,15,14440,14439,11597,-2842
2015,10,20,16,14320,14373,11441,-2932
2015,10,20,17,14190,14192,11168,-3024
2015,10,20,18,14100,14158,11200,-2958
2015,10,20,19,13980,13972,11163,-2809
2015,10,20,20,13950,13987,11050,-2937
2015,10,20,21,14200,14262,11330,-2932
2015,10,20,22,14670,14762,11771,-2991
2015,10,20,23,15470,15630,12773,-2857
2015,10,21,0,15380,15555,12747,-2808
2015,10,21,1,14910,14836,12171,-2665
2015,10,21,2,13800,13735,10919,-2816
2015,10,21,3,12410,12359,9256,-3103
2015,10,21,4,11200,11413,8351,-3062
2015,10,21,5,10350,11132,8162,-2970
2015,10,21,6,9930,10995,7942,-3053
2015,10,21,7,9720,10770,7683,-3087
2015,10,21,8,9670,10717,7491,-3226
2015,10,21,9,9960,10977,7711,-3266
2015,10,21,10,10970,11656,8484,-3172
2015,10,21,11,12890,12874,9737,-3137
2015,10,21,12,13960,13981,10792,-3189
2015,10,21,13,14110,14258,11460,-2798
2015,10,21,14,14150,14380,11216,-3164
2015,10,21,15,14200,14473,11361,-3112
2015,10,21,16,14200,14438,11273,-3165
2015,10,21,17,14120,14247,11110,-3137
2015,10,21,18,14140,14234,11237,-2997
2015,10,21,19,14110,14155,11301,-2854
2015,10,21,20,14120,14128,11124,-3004
2015,10,21,21,14380,14361,11265,-3096
2015,10,21,22,14840,14782,11854,-2928
2015,10,21,23,15600,15546,12801,-2745
2015,10,22,0,15430,15414,12768,-2646
2015,10,22,1,14740,14740,11788,-2952
2015,10,22,2,13660,13682,10601,-3081
2015,10,22,3,12330,12329,9383,-2946
2015,10,22,4,11120,11607,8608,-2999
2015,10,22,5,10290,11397,8661,-2736
2015,10,22,6,9850,10976,8489,-2487
2015,10,22,7,9610,10725,8188,-2537
2015,10,22,8,9560,10680,8020,-2660
2015,10,22,9,9860,10942,8253,-2689
2015,10,22,10,10870,11937,9186,-2751
2015,10,22,11,12780,12959,10350,-2609
2015,10,22,12,13860,13943,11318,-2625
2015,10,22,13,14090,14142,11491,-2651
2015,10,22,14,14220,14230,11515,-2715
2015,10,22,15,14340,14363,11672,-2691
2015,10,22,16,14380,14426,11677,-2749
2015,10,22,17,14320,14371,11684,-2687
2015,10,22,18,14410,14402,11567,-2835
2015,10,22,19,14350,14403,11517,-2886
2015,10,22,20,14340,14406,11602,-2804
2015,10,22,21,14500,14573,11586,-2987
2015,10,22,22,14790,14982,11967,-3015
2015,10,22,23,15520,15628,12457,-3171
2015,10,23,0,15320,15434,12298,-3136
2015,10,23,1,14730,14781,11714,-3067
2015,10,23,2,13690,13733,10778,-2955
2015,10,23,3,12330,12383,9529,-2854
2015,10,23,4,11130,11733,9215,-2518
2015,10,23,5,10310,11369,8695,-2674
2015,10,23,6,9820,10864,8537,-2327
2015,10,23,7,9550,10593,8101,-2492
2015,10,23,8,9500,10498,8008,-2490
2015,10,23,9,9780,10770,8268,-2502
2015,10,23,10,10730,11535,8987,-2548
2015,10,23,11,12510,12669,9917,-2752
2015,10,23,12,13600,13696,10470,-3226
2015,10,23,13,13910,13911,10678,-3233
2015,10,23,14,13970,13912,10826,-3086
2015,10,23,15,13970,13902,11324,-2578
2015,10,23,16,13890,13828,11563,-2265
2015,10,23,17,13720,13680,11398,-2282
2015,10,23,18,13620,13656,11434,-2222
2015,10,23,19,13520,13578,11340,-2238
2015,10,23,20,13480,13495,11286,-2209
2015,10,23,21,13630,13742,11458,-2284
2015,10,23,22,14080,14244,11892,-2352
2015,10,23,23,14900,14966,12558,-2408
2015,10,24,0,14740,14851,12454,-2397
2015,10,24,1,14260,14374,11961,-2413
2015,10,24,2,13450,13670,11309,-2361
2015,10,24,3,12420,12679,10403,-2276
2015,10,24,4,11370,11811,9703,-2108
2015,10,24,5,10590,11088,8751,-2337
2015,10,24,6,10140,10841,8391,-2450
2015,10,24,7,9870,10662,8181,-2481
2015,10,24,8,9760,10587,8092,-2495
2015,10,24,9,9840,10684,8262,-2422
2015,10,24,10,10690,11114,8770,-2344
2015,10,24,11,11550,11669,9360,-2309
2015,10,24,12,12240,12261,10056,-2205
2015,10,24,13,12940,13115,10932,-2183
2015,10,24,14,13180,13545,11292,-2253
2015,10,24,15,13220,13619,11400,-2219
2015,10,24,16,13000,13491,11247,-2244
2015,10,24,17,12760,13337,10995,-2342
2015,10,24,18,12560,13158,10800,-2358
2015,10,24,19,12390,13018,10586,-2432
2015,10,24,20,12430,13053,10708,-2345
2015,10,24,21,12770,13360,11022,-2338
2015,10,24,22,13380,13916,11604,-2312
2015,10,24,23,14250,14479,12213,-2266
2015,10,25,0,14030,14190,11784,-2406
2015,10,25,1,13620,13699,11186,-2513
2015,10,25,2,12950,13024,10471,-2553
2015,10,25,3,12040,12131,9667,-2464
2015,10,25,4,11120,11174,8655,-2519
2015,10,25,5,10470,11035,8634,-2401
2015,10,25,6,9950,10745,8327,-2418
2015,10,25,7,9640,10642,8188,-2454
2015,10,25,8,9470,10587,7896,-2691
2015,10,25,9,9460,10592,7845,-2747
2015,10,25,10,9700,10809,8164,-2645
2015,10,25,11,10340,11018,8467,-2551
2015,10,25,12,10860,11363,8813,-2550
2015,10,25,13,11830,11905,9617,-2288
2015,10,25,14,12420,12686,10268,-2418
2015,10,25,15,12750,13129,10785,-2344
2015,10,25,16,12890,13358,10767,-2591
2015,10,25,17,12920,13417,10860,-2557
2015,10,25,18,13000,13195,10810,-2385
2015,10,25,19,12950,12963,10522,-2441
2015,10,25,20,12930,12863,10388,-2475
2015,10,25,21,13260,13077,10701,-2376
2015,10,25,22,13770,13671,11046,-2625
2015,10,25,23,14600,14580,12240,-2340
2015,10,26,0,14540,14449,12192,-2257
2015,10,26,1,14010,13818,11524,-2294
2015,10,26,2,12970,12842,10483,-2359
2015,10,26,3,11920,11693,9539,-2154
2015,10,26,4,10920,11077,9104,-1973
2015,10,26,5,10220,10569,8430,-2139
2015,10,26,6,9830,10077,8167,-1910
2015,10,26,7,9680,9810,8396,-1414
2015,10,26,8,9700,9844,8585,-1259
2015,10,26,9,9980,10044,8392,-1652
2015,10,26,10,11060,11087,9006,-2081
2015,10,26,11,12990,12920,10985,-1935
2015,10,26,12,14030,14330,11911,-2419
2015,10,26,13,14210,14356,11913,-2443
2015,10,26,14,14190,14147,11651,-2496
2015,10,26,15,14140,14034,11515,-2519
2015,10,26,16,14070,13880,11485,-2395
2015,10,26,17,13890,13695,11240,-2455
2015,10,26,18,13820,13614,11104,-2510
2015,10,26,19,13730,13497,11065,-2432
2015,10,26,20,13700,13558,11401,-2157
2015,10,26,21,13980,13959,11707,-2252
2015,10,26,22,14740,14734,12216,-2518
2015,10,26,23,15800,15768,13380,-2388
2015,10,27,0,15750,15660,13221,-2439
2015,10,27,1,15130,15036,12571,-2465
2015,10,27,2,13980,14065,11475,-2590
2015,10,27,3,12640,12933,10588,-2345
2015,10,27,4,11470,11839,9590,-2249
2015,10,27,5,10670,11497,9049,-2448
2015,10,27,6,10290,11228,8725,-2503
2015,10,27,7,10120,11077,8496,-2581
2015,10,27,8,10140,11087,8715,-2372
2015,10,27,9,10550,11352,8861,-2491
2015,10,27,10,11710,12016,9445,-2571
2015,10,27,11,13690,13791,11301,-2490
2015,10,27,12,14780,14912,12478,-2434
2015,10,27,13,14830,14900,12512,-2388
2015,10,27,14,14700,14588,12053,-2535
2015,10,27,15,14600,14280,11616,-2664
2015,10,27,16,14430,14098,11348,-2750
2015,10,27,17,14260,13863,11097,-2766
2015,10,27,18,14170,13764,11069,-2695
2015,10,27,19,14030,13685,11023,-2662
2015,10,27,20,14010,13786,11193,-2593
2015,10,27,21,14320,14156,11612,-2544
2015,10,27,22,15060,14899,12344,-2555
2015,10,27,23,15900,15904,13542,-2362
2015,10,28,0,15790,15724,13384,-2340
2015,10,28,1,15150,15104,12706,-2398
2015,10,28,2,14120,14098,11536,-2562
2015,10,28,3,12760,12731,10153,-2578
2015,10,28,4,11560,11586,8999,-2587
2015,10,28,5,10730,11131,8408,-2723
2015,10,28,6,10310,10922,8236,-2686
2015,10,28,7,10090,10711,7969,-2742
2015,10,28,8,10060,10685,7886,-2799
2015,10,28,9,10370,10978,8239,-2739
2015,10,28,10,11440,11999,9439,-2560
2015,10,28,11,13410,13512,11040,-2472
2015,10,28,12,14530,14600,12208,-2392
2015,10,28,13,14680,14709,12224,-2485
2015,10,28,14,14620,14751,12198,-2553
2015,10,28,15,14660,14784,12221,-2563
2015,10,28,16,14650,14728,12121,-2607
2015,10,28,17,14540,14727,12132,-2595
2015,10,28,18,14540,14905,12299,-2606
2015,10,28,19,14470,14853,12266,-2587
2015,10,28,20,14600,14928,12349,-2579
2015,10,28,21,15000,15292,12771,-2521
2015,10,28,22,15530,15978,13427,-2551
2015,10,28,23,16100,16269,13726,-2543
2015,10,29,0,15640,15872,13304,-2568
2015,10,29,1,14840,15436,12661,-2775
2015,10,29,2,13700,14465,11739,-2726
2015,10,29,3,12300,13134,10353,-2781
2015,10,29,4,11140,11949,9286,-2663
2015,10,29,5,10680,11371,8671,-2700
2015,10,29,6,10220,10897,8187,-2710
2015,10,29,7,10000,10664,7940,-2724
2015,10,29,8,9970,10598,7834,-2764
2015,10,29,9,10460,10822,8023,-2799
2015,10,29,10,11460,11531,8799,-2732
2015,10,29,11,13490,13133,10367,-2766
2015,10,29,12,14570,14484,11736,-2748
2015,10,29,13,14860,14740,11979,-2761
2015,10,29,14,15020,14835,12041,-2794
2015,10,29,15,15120,14841,12108,-2733
2015,10,29,16,15100,14714,11926,-2788
2015,10,29,17,14940,14607,11819,-2788
2015,10,29,18,14990,14684,11908,-2776
2015,10,29,19,14930,14509,11723,-2786
2015,10,29,20,14820,14321,11584,-2737
2015,10,29,21,14930,14308,11603,-2705
2015,10,29,22,15340,14682,11942,-2740
2015,10,29,23,16000,15459,12809,-2650
2015,10,30,0,15480,15238,12582,-2656
2015,10,30,1,14840,14611,11958,-2653
2015,10,30,2,13760,13571,10878,-2693
2015,10,30,3,12490,12342,9608,-2734
2015,10,30,4,11310,11457,8702,-2755
2015,10,30,5,10410,10951,8272,-2679
2015,10,30,6,9960,10611,8128,-2483
2015,10,30,7,9720,10332,8006,-2326
2015,10,30,8,9670,10498,7994,-2504
2015,10,30,9,9780,10490,8043,-2447
2015,10,30,10,10750,11127,8779,-2348
2015,10,30,11,12590,12627,10224,-2403
2015,10,30,12,13760,13788,11053,-2735
2015,10,30,13,13850,13893,11159,-2734
2015,10,30,14,13770,13818,11099,-2719
2015,10,30,15,13650,13835,11071,-2764
2015,10,30,16,13530,13773,11048,-2725
2015,10,30,17,13380,13553,10893,-2660
2015,10,30,18,13360,13407,10647,-2760
2015,10,30,19,13310,13224,10460,-2764
2015,10,30,20,13300,13248,10527,-2721
2015,10,30,21,13550,13535,10842,-2693
2015,10,30,22,14080,14082,11425,-2657
2015,10,30,23,14960,14800,12168,-2632
2015,10,31,0,14670,14531,11977,-2554
2015,10,31,1,14140,14040,11324,-2716
2015,10,31,2,13370,13353,10622,-2731
2015,10,31,3,12340,12364,9805,-2559
2015,10,31,4,11300,11325,9128,-2197
2015,10,31,5,10540,10818,8197,-2621
2015,10,31,6,10100,10393,7919,-2474
2015,10,31,7,9870,10164,7799,-2365
2015,10,31,8,9780,10091,7953,-2138
2015,10,31,9,9900,10221,8027,-2194
2015,10,31,10,10410,10667,8303,-2364
2015,10,31,11,11270,11320,8657,-2663
2015,10,31,12,12070,12070,9369,-2701
2015,10,31,13,12780,12813,10195,-2618
2015,10,31,14,13030,13019,10362,-2657
2015,10,31,15,13030,12927,10275,-2652
2015,10,31,16,12910,12690,10026,-2664
2015,10,31,17,12680,12501,9802,-2699
2015,10,31,18,12460,12359,9565,-2794
2015,10,31,19,12360,12285,9547,-2738
2015,10,31,20,12430,12353,9591,-2762
2015,10,31,21,12830,12739,10046,-2693
2015,10,31,22,13500,13314,10647,-2667
2015,10,31,23,14300,13695,11201,-2494
2015,11,1,0,14020,13368,10951,-2417
2015,11,1,1,13580,13049,10481,-2568
2015,11,1,2,12910,12543,9911,-2632
2015,11,1,3,12050,11786,9225,-2561
2015,11,1,4,11110,10915,8385,-2530
2015,11,1,5,10360,10236,7623,-2613
2015,11,1,6,9890,9767,7392,-2375
2015,11,1,7,9890,9489,7153,-2336
2015,11,1,8,9510,9595,7200,-2395
2015,11,1,9,9470,9598,7111,-2487
2015,11,1,10,9600,9711,7159,-2552
2015,11,1,11,9850,10189,7569,-2620
2015,11,1,12,10300,10645,7972,-2673
2015,11,1,13,11290,11196,8740,-2456
2015,11,1,14,12150,12105,9773,-2332
2015,11,1,15,12650,12760,10309,-2451
2015,11,1,16,12830,13080,10527,-2553
2015,11,1,17,13010,13199,10535,-2664
2015,11,1,18,12840,13120,10395,-2725
2015,11,1,19,12730,12981,10259,-2722
2015,11,1,20,12680,12860,10136,-2724
2015,11,1,21,12890,12971,10289,-2682
2015,11,1,22,13680,13716,11083,-2633
2015,11,1,23,14780,14952,12448,-2504
2015,11,2,0,14690,14784,12167,-2617
2015,11,2,1,14230,14249,11575,-2674
2015,11,2,2,13710,13559,10889,-2670
2015,11,2,3,12630,12487,9826,-2661
2015,11,2,4,11520,11453,8879,-2574
2015,11,2,5,10550,10563,7905,-2658
2015,11,2,6,9880,10286,7612,-2674
2015,11,2,7,9540,10262,7588,-2674
2015,11,2,8,9390,10289,7650,-2639
2015,11,2,9,9400,10329,7642,-2687
2015,11,2,10,9770,10641,7847,-2794
2015,11,2,11,10980,11375,8645,-2730
2015,11,2,12,12750,12910,10213,-2697
2015,11,2,13,13740,13828,11120,-2708
2015,11,2,14,14050,13950,11325,-2625
2015,11,2,15,14170,13890,11182,-2708
2015,11,2,16,14300,13926,11210,-2716
2015,11,2,17,14310,13923,11902,-2021
2015,11,2,18,14170,13899,11933,-1966
2015,11,2,19,14130,13874,11889,-1985
2015,11,2,20,14070,13882,11884,-1998
2015,11,2,21,14130,14054,12107,-1947
2015,11,2,22,14950,14724,12863,-1861
2015,11,2,23,16180,15892,14115,-1777
2015,11,3,0,15870,15735,13808,-1927
2015,11,3,1,15400,15171,13142,-2029
2015,11,3,2,14660,14383,12339,-2044
2015,11,3,3,13520,13351,10773,-2578
2015,11,3,4,12200,12100,9537,-2563
2015,11,3,5,11100,11383,8683,-2700
2015,11,3,6,10230,10926,8240,-2686
2015,11,3,7,9860,10539,7825,-2714
2015,11,3,8,9720,10600,7846,-2754
2015,11,3,9,9760,10630,7946,-2684
2015,11,3,10,10180,10834,8180,-2654
2015,11,3,11,11290,11551,9094,-2457
2015,11,3,12,13020,13004,10617,-2387
2015,11,3,13,13790,13842,11636,-2206
2015,11,3,14,13830,13823,11528,-2295
2015,11,3,15,13810,13775,11442,-2333
2015,11,3,16,13790,13837,11449,-2388
2015,11,3,17,13730,13852,11485,-2367
2015,11,3,18,13640,13832,11428,-2404
2015,11,3,19,13690,13973,11541,-2432
2015,11,3,20,13700,14084,11717,-2367
2015,11,3,21,13850,14242,11932,-2310
2015,11,3,22,14610,14790,12596,-2194
2015,11,3,23,15700,15918,13963,-1955
2015,11,4,0,15550,15793,13717,-2076
2015,11,4,1,15180,15247,13121,-2126
2015,11,4,2,14500,14482,12286,-2196
2015,11,4,3,13390,13355,10973,-2382
2015,11,4,4,12090,12030,9575,-2455
2015,11,4,5,11030,10928,8616,-2312
2015,11,4,6,10090,10676,8226,-2450
2015,11,4,7,9720,10651,8084,-2567
2015,11,4,8,9570,10464,7904,-2560
2015,11,4,9,9590,10468,8039,-2429
2015,11,4,10,10010,10803,8360,-2443
2015,11,4,11,11130,11548,9248,-2300
2015,11,4,12,12960,12880,10563,-2317
2015,11,4,13,13800,13784,11448,-2336
2015,11,4,14,13750,13787,11436,-2351
2015,11,4,15,13680,13720,11361,-2359
2015,11,4,16,13740,13767,11227,-2540
2015,11,4,17,13770,13783,11265,-2518
2015,11,4,18,13630,13746,11290,-2456
2015,11,4,19,13690,13843,11443,-2400
2015,11,4,20,13840,13910,11453,-2457
2015,11,4,21,14020,14108,11760,-2348
2015,11,4,22,14830,14668,12356,-2312
2015,11,4,23,15900,15793,13680,-2113
2015,11,5,0,15600,15703,13430,-2273
2015,11,5,1,15050,15212,12908,-2304
2015,11,5,2,14310,14464,12099,-2365
2015,11,5,3,13310,13375,10964,-2411
2015,11,5,4,12110,12086,9596,-2490
2015,11,5,5,11110,10972,8766,-2206
2015,11,5,6,10180,10726,8342,-2384
2015,11,5,7,9790,10464,8038,-2426
2015,11,5,8,9630,10443,8016,-2427
2015,11,5,9,9660,10434,8043,-2391
2015,11,5,10,10040,10757,8360,-2397
2015,11,5,11,11160,11355,9116,-2239
2015,11,5,12,13060,12979,10586,-2393
2015,11,5,13,13930,13754,11392,-2362
2015,11,5,14,13960,13967,11567,-2400
2015,11,5,15,13950,14073,11696,-2377
2015,11,5,16,14100,14213,11880,-2333
2015,11,5,17,14140,14343,12058,-2285
2015,11,5,18,14120,14431,12475,-1956
2015,11,5,19,14230,14535,12603,-1932
2015,11,5,20,14260,14553,12527,-2026
2015,11,5,21,14350,14566,12673,-1893
2015,11,5,22,14860,15140,13215,-1925
2015,11,5,23,15950,16131,14205,-1926
2015,11,6,0,15700,15934,13891,-2043
2015,11,6,1,15170,15446,13084,-2362
2015,11,6,2,14460,14768,12314,-2454
2015,11,6,3,13360,13678,11124,-2554
2015,11,6,4,12110,12563,10180,-2383
2015,11,6,5,11060,11470,9369,-2101
2015,11,6,6,10240,11262,8861,-2401
2015,11,6,7,9830,11083,8728,-2355
2015,11,6,8,9660,10848,8476,-2372
2015,11,6,9,9650,10781,8372,-2409
2015,11,6,10,10040,10854,8521,-2333
2015,11,6,11,11060,11503,9185,-2318
2015,11,6,12,12860,12754,10348,-2406
2015,11,6,13,13870,13804,11277,-2527
2015,11,6,14,14250,14310,11734,-2576
2015,11,6,15,14200,14638,12150,-2488
2015,11,6,16,14420,14851,12318,-2533
2015,11,6,17,14540,14885,12324,-2561
2015,11,6,18,14520,14757,12132,-2625
2015,11,6,19,14540,14855,12796,-2059
2015,11,6,20,14500,14827,12300,-2527
2015,11,6,21,14550,14530,12049,-2481
2015,11,6,22,14960,15258,12715,-2543
2015,11,6,23,15850,16004,13643,-2361
2015,11,7,0,15520,15640,13172,-2468
2015,11,7,1,14860,15026,12562,-2464
2015,11,7,2,14100,14383,11847,-2536
2015,11,7,3,13180,13511,10862,-2649
2015,11,7,4,12110,12410,9845,-2565
2015,11,7,5,11080,11275,8819,-2456
2015,11,7,6,10550,10421,8037,-2384
2015,11,7,7,10080,10143,7631,-2512
2015,11,7,8,9840,9860,7353,-2507
2015,11,7,9,9760,9707,7458,-2249
2015,11,7,10,9400,9772,7736,-2036
2015,11,7,11,9770,10109,7716,-2393
2015,11,7,12,10380,10726,8102,-2624
2015,11,7,13,10960,11345,8729,-2616
2015,11,7,14,11920,12017,9487,-2530
2015,11,7,15,12560,12525,9762,-2763
2015,11,7,16,12760,12726,9849,-2877
2015,11,7,17,12790,12741,9465,-3276
2015,11,7,18,12580,12658,9791,-2867
2015,11,7,19,12530,12558,9825,-2733
2015,11,7,20,12410,12590,10090,-2500
2015,11,7,21,12550,12755,10205,-2550
2015,11,7,22,13280,13540,10943,-2597
2015,11,7,23,14450,14358,11933,-2425
2015,11,8,0,14220,14099,11639,-2460
2015,11,8,1,13640,13616,11070,-2546
2015,11,8,2,13150,13068,10402,-2666
2015,11,8,3,12500,12397,9655,-2742
2015,11,8,4,11620,11563,8841,-2722
2015,11,8,5,10730,10979,8316,-2663
2015,11,8,6,10110,10343,7641,-2702
2015,11,8,7,9690,10183,7518,-2665
2015,11,8,8,9450,10168,7354,-2814
2015,11,8,9,9420,9944,7278,-2666
2015,11,8,10,9420,9937,7190,-2747
2015,11,8,11,9730,10230,7521,-2709
2015,11,8,12,10200,10507,7775,-2732
2015,11,8,13,10720,10970,8255,-2715
2015,11,8,14,11550,11616,8922,-2694
2015,11,8,15,12040,12034,9272,-2762
2015,11,8,16,12190,12038,9169,-2869
2015,11,8,17,12260,11973,8400,-3573
2015,11,8,18,12280,12066,9170,-2896
2015,11,8,19,12240,12079,9405,-2674
2015,11,8,20,12240,12204,9593,-2611
2015,11,8,21,12530,12540,9835,-2705
2015,11,8,22,13700,13561,10867,-2694
2015,11,8,23,15000,14894,12240,-2654
2015,11,9,0,14900,14794,12100,-2694
2015,11,9,1,14470,14393,11692,-2701
2015,11,9,2,13860,13806,11116,-2690
2015,11,9,3,12870,12847,10261,-2586
2015,11,9,4,11780,11775,9131,-2644
2015,11,9,5,10820,10867,8120,-2747
2015,11,9,6,10230,10805,8116,-2689
2015,11,9,7,9900,10776,8077,-2699
2015,11,9,8,9790,10859,8131,-2728
2015,11,9,9,9850,10943,8244,-2699
2015,11,9,10,10310,11127,8502,-2625
2015,11,9,11,11440,11940,9481,-2459
2015,11,9,12,13280,13327,10446,-2881
2015,11,9,13,14230,14210,10774,-3436
2015,11,9,14,14280,14134,10675,-3459
2015,11,9,15,14200,13957,10513,-3444
2015,11,9,16,14140,14127,10575,-3552
2015,11,9,17,14080,13792,10361,-3431
2015,11,9,18,13930,13700,10349,-3351
2015,11,9,19,13940,13750,10333,-3417
2015,11,9,20,13890,13834,10695,-3139
2015,11,9,21,13970,14072,10901,-3171
2015,11,9,22,14870,14958,11823,-3135
2015,11,9,23,16000,16166,13354,-2812
2015,11,10,0,15880,16168,13099,-3069
2015,11,10,1,15480,16168,12792,-3376
2015,11,10,2,14750,16168,12668,-3500
2015,11,10,3,13660,13723,10128,-3595
2015,11,10,4,12330,12465,8837,-3628
2015,11,10,5,11190,11603,8798,-2805
2015,11,10,6,10560,11423,8201,-3222
2015,11,10,7,10190,11225,7835,-3390
2015,11,10,8,10030,11086,7802,-3284
2015,11,10,9,10030,11091,7817,-3274
2015,11,10,10,10410,11188,7882,-3306
2015,11,10,11,11550,12219,8585,-3634
2015,11,10,12,13370,13376,9701,-3675
2015,11,10,13,14270,14354,10730,-3624
2015,11,10,14,14370,14516,10978,-3538
2015,11,10,15,14310,14559,10985,-3574
2015,11,10,16,14480,14617,11098,-3519
2015,11,10,17,14290,14589,11018,-3571
2015,11,10,18,14290,14562,11054,-3508
2015,11,10,19,14380,14613,11049,-3564
2015,11,10,20,14410,14595,11079,-3516
2015,11,10,21,14580,14742,11272,-3470
2015,11,10,22,15470,15493,12038,-3455
2015,11,10,23,16400,16302,13089,-3213
2015,11,11,0,16230,16087,12839,-3248
2015,11,11,1,15690,15547,12020,-3527
2015,11,11,2,14950,14842,11225,-3617
2015,11,11,3,13800,13815,10018,-3797
2015,11,11,4,12450,12621,8889,-3732
2015,11,11,5,11310,11867,8424,-3443
2015,11,11,6,10560,11190,8207,-2983
2015,11,11,7,10140,11008,8082,-2926
2015,11,11,8,9940,10789,7869,-2920
2015,11,11,9,9930,10752,7858,-2894
2015,11,11,10,10270,11006,7925,-3081
2015,11,11,11,11270,11574,8390,-3184
2015,11,11,12,12870,12651,9200,-3451
2015,11,11,13,13960,13536,10085,-3451
2015,11,11,14,14300,14223,10818,-3405
2015,11,11,15,14480,14643,11327,-3316
2015,11,11,16,14570,14866,11492,-3374
2015,11,11,17,14550,14926,11520,-3406
2015,11,11,18,14580,14850,11564,-3286
2015,11,11,19,14580,14831,11922,-2909
2015,11,11,20,14660,14745,11373,-3372
2015,11,11,21,14850,14857,11492,-3365
2015,11,11,22,15660,15630,12301,-3329
2015,11,11,23,16480,16409,13171,-3238
2015,11,12,0,16260,16120,12888,-3232
2015,11,12,1,15720,15559,12315,-3244
2015,11,12,2,15040,14829,11473,-3356
2015,11,12,3,13990,13737,10451,-3286
2015,11,12,4,12660,12459,9111,-3348
2015,11,12,5,11520,11737,8348,-3389
2015,11,12,6,10640,11146,7835,-3311
2015,11,12,7,10230,10998,8042,-2956
2015,11,12,8,10050,10781,7594,-3187
2015,11,12,9,10080,10956,7844,-3112
2015,11,12,10,10430,11079,7939,-3140
2015,11,12,11,11450,12032,8641,-3391
2015,11,12,12,13190,13223,9937,-3286
2015,11,12,13,14200,14247,10940,-3307
2015,11,12,14,14470,14632,11400,-3232
2015,11,12,15,14570,14826,11439,-3387
2015,11,12,16,14660,15031,12097,-2934
2015,11,12,17,14630,15099,12256,-2843
2015,11,12,18,14570,15054,11650,-3404
2015,11,12,19,14640,15059,11667,-3392
2015,11,12,20,14640,15002,11453,-3549
2015,11,12,21,14800,15108,11550,-3558
2015,11,12,22,15610,15823,12269,-3554
2015,11,12,23,16300,16406,12867,-3539
2015,11,13,0,16010,16155,12520,-3635
2015,11,13,1,15490,15600,11934,-3666
2015,11,13,2,14790,14925,11329,-3596
2015,11,13,3,13700,13846,10233,-3613
2015,11,13,4,12390,12799,9394,-3405
2015,11,13,5,11260,11851,8601,-3250
2015,11,13,6,10500,11469,8616,-2853
2015,11,13,7,10080,11145,8178,-2967
2015,11,13,8,9880,10902,8246,-2656
2015,11,13,9,9840,10861,8212,-2649
2015,11,13,10,10160,11145,8358,-2787
2015,11,13,11,11130,11858,8779,-3079
2015,11,13,12,12840,12978,9563,-3415
2015,11,13,13,13780,13701,10152,-3549
2015,11,13,14,14050,13835,10287,-3548
2015,11,13,15,14140,13849,10403,-3446
2015,11,13,16,14210,13985,10665,-3320
2015,11,13,17,14130,13969,10548,-3421
2015,11,13,18,14020,13817,10476,-3341
2015,11,13,19,13960,13913,10547,-3366
2015,11,13,20,13890,13979,10676,-3303
2015,11,13,21,13990,14044,10748,-3296
2015,11,13,22,14770,14772,11478,-3294
2015,11,13,23,15700,15608,12252,-3356
2015,11,14,0,15400,15364,12005,-3359
2015,11,14,1,14760,14851,11388,-3463
2015,11,14,2,14200,14281,10902,-3379
2015,11,14,3,13410,13444,10562,-2882
2015,11,14,4,12410,12422,9957,-2465
2015,11,14,5,11420,11716,9109,-2607
2015,11,14,6,10670,11120,8690,-2430
2015,11,14,7,10220,10688,8419,-2269
2015,11,14,8,10000,10439,8152,-2287
2015,11,14,9,9930,10333,8059,-2274
2015,11,14,10,10010,10455,8104,-2351
2015,11,14,11,10490,10906,8331,-2575
2015,11,14,12,11230,11365,8556,-2809
2015,11,14,13,12050,11878,8890,-2988
2015,11,14,14,12850,12615,9571,-3044
2015,11,14,15,13370,13037,10123,-2914
2015,11,14,16,13500,13301,10341,-2960
2015,11,14,17,13420,13337,10427,-2910
2015,11,14,18,13250,13119,10281,-2838
2015,11,14,19,13040,12864,10061,-2803
2015,11,14,20,12970,12872,9932,-2940
2015,11,14,21,13230,13203,10481,-2722
2015,11,14,22,14200,14208,11337,-2871
2015,11,14,23,15500,15244,11976,-3268
2015,11,15,0,15300,15034,11646,-3388
2015,11,15,1,14660,14600,11496,-3104
2015,11,15,2,14200,14135,11193,-2942
2015,11,15,3,13570,13475,10490,-2985
2015,11,15,4,12680,12603,10014,-2589
2015,11,15,5,11790,11716,9069,-2647
2015,11,15,6,11040,11021,8708,-2313
2015,11,15,7,10640,10560,8273,-2287
2015,11,15,8,10350,10306,8429,-1877
2015,11,15,9,10270,10464,8698,-1766
2015,11,15,10,10320,10593,8404,-2189
2015,11,15,11,10680,10898,8487,-2411
2015,11,15,12,11140,11413,8666,-2747
2015,11,15,13,11680,11767,8980,-2787
2015,11,15,14,12350,12198,9380,-2818
2015,11,15,15,12700,12607,10054,-2553
2015,11,15,16,12880,12714,10162,-2552
2015,11,15,17,12880,12809,10301,-2508
2015,11,15,18,12870,12762,10196,-2566
2015,11,15,19,12870,12608,9966,-2642
2015,11,15,20,12910,12676,10135,-2541
2015,11,15,21,13240,13112,10581,-2531
2015,11,15,22,14400,14247,11413,-2834
2015,11,15,23,15500,15210,12266,-2944
2015,11,16,0,15330,15045,12082,-2963
2015,11,16,1,14720,14421,11322,-3099
2015,11,16,2,14180,14025,11083,-2942
2015,11,16,3,13120,13076,10001,-3075
2015,11,16,4,12000,11898,9160,-2738
2015,11,16,5,11030,10925,8574,-2351
2015,11,16,6,10390,10578,8520,-2058
2015,11,16,7,10030,10480,8520,-1960
2015,11,16,8,9900,10338,8403,-1935
2015,11,16,9,9930,10383,8346,-2037
2015,11,16,10,10270,10883,8471,-2412
2015,11,16,11,11430,11594,8976,-2618
2015,11,16,12,13290,13316,10229,-3087
2015,11,16,13,14280,14288,10899,-3389
2015,11,16,14,14320,14322,11032,-3290
2015,11,16,15,14270,14138,10956,-3182
2015,11,16,16,14250,13977,10686,-3291
2015,11,16,17,14220,13943,10987,-2956
2015,11,16,18,14040,13848,10920,-2928
2015,11,16,19,13960,13897,10716,-3181
2015,11,16,20,13970,13961,10861,-3100
2015,11,16,21,14180,14191,11135,-3056
2015,11,16,22,15200,15117,11894,-3223
2015,11,16,23,16300,16242,12912,-3330
2015,11,17,0,16200,16142,12769,-3373
2015,11,17,1,15860,15699,12600,-3099
2015,11,17,2,15260,15001,11826,-3175
2015,11,17,3,14180,13911,10818,-3093
2015,11,17,4,12880,12617,9678,-2939
2015,11,17,5,11780,11776,9254,-2522
2015,11,17,6,11000,11086,9032,-2054
2015,11,17,7,10620,10752,9034,-1718
2015,11,17,8,10480,10604,9052,-1552
2015,11,17,9,10520,10659,9097,-1562
2015,11,17,10,10910,11297,9237,-2060
2015,11,17,11,11950,12155,9634,-2521
2015,11,17,12,13850,13873,10987,-2886
2015,11,17,13,14740,14762,11499,-3263
2015,11,17,14,14740,14628,11567,-3061
2015,11,17,15,14550,14335,11381,-2954
2015,11,17,16,14390,14169,11320,-2849
2015,11,17,17,14330,13974,11212,-2762
2015,11,17,18,14130,13829,11042,-2787
2015,11,17,19,14110,13854,11180,-2674
2015,11,17,20,14160,13952,11339,-2613
2015,11,17,21,14370,14316,11828,-2488
2015,11,17,22,15520,15411,12849,-2562
2015,11,17,23,16700,16577,13856,-2721
2015,11,18,0,16600,16550,13599,-2951
2015,11,18,1,16200,16210,13128,-3082
2015,11,18,2,15540,15632,12436,-3196
2015,11,18,3,14450,14599,11619,-2980
2015,11,18,4,13120,13285,10550,-2735
2015,11,18,5,11970,12164,9539,-2625
2015,11,18,6,11220,11939,9206,-2733
2015,11,18,7,10840,11650,9208,-2442
2015,11,18,8,10670,11851,8896,-2955
2015,11,18,9,10710,11995,8907,-3088
2015,11,18,10,11100,12387,9428,-2959
2015,11,18,11,12490,12781,9850,-2931
2015,11,18,12,14290,14386,11090,-3296
2015,11,18,13,15130,15256,11917,-3339
2015,11,18,14,15020,15119,11750,-3369
2015,11,18,15,14850,14868,11540,-3328
2015,11,18,16,14700,14643,11291,-3352
2015,11,18,17,14550,14419,11120,-3299
2015,11,18,18,14390,14197,11136,-3061
2015,11,18,19,14390,14207,11220,-2987
2015,11,18,20,14360,14290,11501,-2789
2015,11,18,21,14580,14601,12047,-2554
2015,11,18,22,15800,15720,12751,-2969
2015,11,18,23,16800,16619,13632,-2987
2015,11,19,0,16490,16482,13404,-3078
2015,11,19,1,15920,16096,12763,-3333
2015,11,19,2,15290,15413,12143,-3270
2015,11,19,3,14200,14347,11174,-3173
2015,11,19,4,12840,12957,10060,-2897
2015,11,19,5,11680,12040,9566,-2474
2015,11,19,6,11010,11554,9621,-1933
2015,11,19,7,10570,11239,9129,-2110
2015,11,19,8,10360,11167,8991,-2176
2015,11,19,9,10310,11273,9247,-2026
2015,11,19,10,10530,11343,9336,-2007
2015,11,19,11,11620,12122,10015,-2107
2015,11,19,12,13480,13542,10987,-2555
2015,11,19,13,14470,14515,11582,-2933
2015,11,19,14,14650,14721,11777,-2944
2015,11,19,15,14710,14802,12095,-2707
2015,11,19,16,14790,14891,12416,-2475
2015,11,19,17,14800,14900,12573,-2327
2015,11,19,18,14720,14799,12406,-2393
2015,11,19,19,14710,14807,12476,-2331
2015,11,19,20,14720,14764,12631,-2133
2015,11,19,21,14970,14943,12822,-2121
2015,11,19,22,15890,15777,13254,-2523
2015,11,19,23,16600,16333,13951,-2382
2015,11,20,0,16200,16114,13647,-2467
2015,11,20,1,15630,15656,12951,-2705
2015,11,20,2,14890,14984,12388,-2596
2015,11,20,3,13780,13901,11827,-2074
2015,11,20,4,12440,12593,10756,-1837
2015,11,20,5,11300,11536,9881,-1655
2015,11,20,6,10530,11194,9528,-1666
2015,11,20,7,10060,11005,9259,-1746
2015,11,20,8,9780,10770,9382,-1388
2015,11,20,9,9800,10689,9322,-1367
2015,11,20,10,10170,10949,9318,-1631
2015,11,20,11,11210,11655,10043,-1612
2015,11,20,12,12980,13008,10993,-2015
2015,11,20,13,14010,13885,11299,-2586
2015,11,20,14,14200,14058,11130,-2928
2015,11,20,15,14240,14014,11210,-2804
2015,11,20,16,14230,13973,10986,-2987
2015,11,20,17,14080,13841,11075,-2766
2015,11,20,18,13930,13668,11104,-2564
2015,11,20,19,13820,13664,11108,-2556
2015,11,20,20,13810,13692,11068,-2624
2015,11,20,21,14050,13882,11132,-2750
2015,11,20,22,14960,14674,11925,-2749
2015,11,20,23,15710,15525,12791,-2734
2015,11,21,0,15470,15229,12517,-2712
2015,11,21,1,14940,14782,12212,-2570
2015,11,21,2,14420,14266,11516,-2750
2015,11,21,3,13590,13493,10946,-2547
2015,11,21,4,12640,12537,10070,-2467
2015,11,21,5,11690,11720,9487,-2233
2015,11,21,6,10850,11356,9437,-1919
2015,11,21,7,10400,11138,9555,-1583
2015,11,21,8,10210,10783,9307,-1476
2015,11,21,9,10190,10833,9391,-1442
2015,11,21,10,10300,11023,9972,-1051
2015,11,21,11,10790,11270,9913,-1357
2015,11,21,12,11500,11789,9950,-1839
2015,11,21,13,12270,12304,9990,-2314
2015,11,21,14,12880,13009,10509,-2500
2015,11,21,15,13150,13233,10774,-2459
2015,11,21,16,13100,13066,10238,-2828
2015,11,21,17,12890,12881,10078,-2803
2015,11,21,18,12770,12692,9788,-2904
2015,11,21,19,12610,12584,9605,-2979
2015,11,21,20,12690,12640,9813,-2827
2015,11,21,21,13000,12974,10337,-2637
2015,11,21,22,14150,14051,11138,-2913
2015,11,21,23,15240,15036,11896,-3140
2015,11,22,0,14990,14855,11808,-3047
2015,11,22,1,14440,14437,11597,-2840
2015,11,22,2,13950,14015,11216,-2799
2015,11,22,3,13260,13367,10514,-2853
2015,11,22,4,12360,12502,9792,-2710
2015,11,22,5,11460,11625,9370,-2255
2015,11,22,6,10780,11064,8830,-2234
2015,11,22,7,10350,10624,8729,-1895
2015,11,22,8,10080,10363,8550,-1813
2015,11,22,9,9980,10740,8596,-2144
2015,11,22,10,10030,10802,8586,-2216
2015,11,22,11,10330,10900,8620,-2280
2015,11,22,12,10860,11349,8658,-2691
2015,11,22,13,11460,11789,8783,-3006
2015,11,22,14,12350,12434,9043,-3391
2015,11,22,15,12830,13007,9799,-3208
2015,11,22,16,13100,13281,9842,-3439
2015,11,22,17,13110,13538,9932,-3606
2015,11,22,18,13110,13697,10127,-3570
2015,11,22,19,13000,13798,10164,-3634
2015,11,22,20,13040,13827,10146,-3681
2015,11,22,21,13470,14114,10428,-3686
2015,11,22,22,14700,15073,11387,-3686
2015,11,22,23,15720,15688,12273,-3415
2015,11,23,0,15520,15470,12183,-3287
2015,11,23,1,15030,15006,11500,-3506
2015,11,23,2,14360,14400,10940,-3460
2015,11,23,3,13480,13463,10042,-3421
2015,11,23,4,12390,12404,9548,-2856
2015,11,23,5,11410,11564,9259,-2305
2015,11,23,6,10840,11073,9473,-1600
2015,11,23,7,10570,10818,9443,-1375
2015,11,23,8,10480,11046,9487,-1559
2015,11,23,9,10540,11182,9570,-1612
2015,11,23,10,11090,11594,9774,-1820
2015,11,23,11,12000,12339,10033,-2306
2015,11,23,12,13950,13975,11179,-2796
2015,11,23,13,14960,14988,11709,-3279
2015,11,23,14,15080,15009,11493,-3516
2015,11,23,15,14980,14768,11187,-3581
2015,11,23,16,14880,14675,11226,-3449
2015,11,23,17,14720,14546,11091,-3455
2015,11,23,18,14670,14415,10930,-3485
2015,11,23,19,14630,14509,11159,-3350
2015,11,23,20,14670,14660,11324,-3336
2015,11,23,21,14970,15044,11721,-3323
2015,11,23,22,16220,16219,12852,-3367
2015,11,23,23,17410,17372,14356,-3016
2015,11,24,0,17320,17329,14126,-3203
2015,11,24,1,16960,16970,13633,-3337
2015,11,24,2,16320,16441,13228,-3213
2015,11,24,3,15210,15421,12241,-3180
2015,11,24,4,13850,14188,11098,-3090
2015,11,24,5,12680,13026,10437,-2589
2015,11,24,6,11950,12299,9642,-2657
2015,11,24,7,11580,12161,9528,-2633
2015,11,24,8,11410,12025,9469,-2556
2015,11,24,9,11440,12028,9385,-2643
2015,11,24,10,11850,12256,9608,-2648
2015,11,24,11,13140,13175,10215,-2960
2015,11,24,12,15010,14938,11684,-3254
2015,11,24,13,15880,15880,13116,-2764
2015,11,24,14,15740,15781,12583,-3198
2015,11,24,15,15430,15449,11876,-3573
2015,11,24,16,15240,15234,11747,-3487
2015,11,24,17,15020,14990,11501,-3489
2015,11,24,18,14820,14785,11147,-3638
2015,11,24,19,14780,14745,11081,-3664
2015,11,24,20,14810,14802,11332,-3470
2015,11,24,21,15100,15128,11684,-3444
2015,11,24,22,16280,16163,12774,-3389
2015,11,24,23,17300,17132,13916,-3216
2015,11,25,0,17150,17091,13585,-3506
2015,11,25,1,16800,16814,13224,-3590
2015,11,25,2,16190,16252,12681,-3571
2015,11,25,3,15090,15289,11865,-3424
2015,11,25,4,13730,14040,10644,-3396
2015,11,25,5,12570,13050,10125,-2925
2015,11,25,6,11880,12419,9633,-2786
2015,11,25,7,11450,12131,9037,-3094
2015,11,25,8,11250,11938,9241,-2697
2015,11,25,9,11260,11950,9228,-2722
2015,11,25,10,11660,12312,9247,-3065
2015,11,25,11,12880,13248,10323,-2925
2015,11,25,12,14750,14453,11495,-2958
2015,11,25,13,15630,15463,12324,-3139
2015,11,25,14,15560,15630,12486,-3144
2015,11,25,15,15340,15398,12274,-3124
2015,11,25,16,15170,15140,11789,-3351
2015,11,25,17,14970,14906,11453,-3453
2015,11,25,18,14780,14607,11150,-3457
2015,11,25,19,14690,14580,11619,-2961
2015,11,25,20,14750,14626,12155,-2471
2015,11,25,21,15010,14860,12312,-2548
2015,11,25,22,16030,15856,13006,-2850
2015,11,25,23,16880,16771,13694,-3077
2015,11,26,0,16790,16545,13453,-3092
2015,11,26,1,16430,16098,12986,-3112
2015,11,26,2,15820,15535,12370,-3165
2015,11,26,3,14780,14673,11332,-3341
2015,11,26,4,13500,13523,10654,-2869
2015,11,26,5,12330,12297,9744,-2553
2015,11,26,6,11410,11605,9548,-2057
2015,11,26,7,10790,11343,9334,-2009
2015,11,26,8,10530,11530,9524,-2006
2015,11,26,9,10400,11475,8991,-2484
2015,11,26,10,10500,11560,8799,-2761
2015,11,26,11,10940,11648,8775,-2873
2015,11,26,12,11720,11868,8973,-2895
2015,11,26,13,12440,12563,9330,-3233
2015,11,26,14,13540,13289,10386,-2903
2015,11,26,15,14230,13812,10786,-3026
2015,11,26,16,14560,14020,10711,-3309
2015,11,26,17,14620,14168,11057,-3111
2015,11,26,18,14030,13860,11114,-2746
2015,11,26,19,13460,13192,10385,-2807
2015,11,26,20,12710,12555,9346,-3209
2015,11,26,21,12370,12178,9258,-2920
2015,11,26,22,12950,12846,9779,-3067
2015,11,26,23,13370,12939,9692,-3247
2015,11,27,0,13330,12780,9484,-3296
2015,11,27,1,13190,12667,9710,-2957
2015,11,27,2,13170,12505,9962,-2543
2015,11,27,3,12720,12108,9861,-2247
2015,11,27,4,11990,11488,9469,-2019
2015,11,27,5,11330,10752,8919,-1833
2015,11,27,6,10540,10459,9106,-1353
2015,11,27,7,10200,10676,9185,-1491
2015,11,27,8,10110,10655,8715,-1940
2015,11,27,9,10100,10611,8821,-1790
2015,11,27,10,10330,10788,9025,-1763
2015,11,27,11,10310,11314,9141,-2173
2015,11,27,12,11170,11594,9437,-2157
2015,11,27,13,11700,11912,9343,-2569
2015,11,27,14,12460,12182,9707,-2475
2015,11,27,15,12820,12548,10122,-2426
2015,11,27,16,12980,12611,10178,-2433
2015,11,27,17,13100,12558,9885,-2673
2015,11,27,18,12900,12490,9847,-2643
2015,11,27,19,12930,12451,9890,-2561
2015,11,27,20,12800,12519,9817,-2702
2015,11,27,21,12960,12763,10013,-2750
2015,11,27,22,14160,13834,10781,-3053
2015,11,27,23,15000,14621,11654,-2967
2015,11,28,0,14620,14332,11147,-3185
2015,11,28,1,14100,13845,10983,-2862
2015,11,28,2,13680,13337,10455,-2882
2015,11,28,3,12950,12640,9900,-2740
2015,11,28,4,12080,11779,9467,-2312
2015,11,28,5,11220,10796,8372,-2424
2015,11,28,6,10360,10212,8211,-2001
2015,11,28,7,9940,10003,8435,-1568
2015,11,28,8,9690,9819,8253,-1566
2015,11,28,9,9620,9736,8218,-1518
2015,11,28,10,9210,9819,8502,-1317
2015,11,28,11,9600,9940,8287,-1653
2015,11,28,12,10090,10692,8697,-1995
2015,11,28,13,10870,11074,9044,-2030
2015,11,28,14,11940,12040,9824,-2216
2015,11,28,15,12560,12852,10637,-2215
2015,11,28,16,12940,13345,10632,-2713
2015,11,28,17,13110,13566,10766,-2800
2015,11,28,18,13020,13647,11236,-2411
2015,11,28,19,12860,13568,11168,-2400
2015,11,28,20,12890,13449,11329,-2120
2015,11,28,21,13300,13613,10988,-2625
2015,11,28,22,14270,14446,11756,-2690
2015,11,28,23,15100,14913,12347,-2566
2015,11,29,0,14610,14674,11865,-2809
2015,11,29,1,13920,14272,11317,-2955
2015,11,29,2,13480,13850,10870,-2980
2015,11,29,3,12800,13244,10191,-3053
2015,11,29,4,12010,12407,9776,-2631
2015,11,29,5,11160,11508,9382,-2126
2015,11,29,6,10480,11268,9243,-2025
2015,11,29,7,10070,11146,9222,-1924
2015,11,29,8,9850,10937,9203,-1734
2015,11,29,9,9770,10885,9392,-1493
2015,11,29,10,10180,10977,9024,-1953
2015,11,29,11,10440,11301,9220,-2081
2015,11,29,12,11050,11574,9203,-2371
2015,11,29,13,11630,11765,9427,-2338
2015,11,29,14,12410,12482,10142,-2340
2015,11,29,15,12770,12852,10344,-2508
2015,11,29,16,12870,12886,9934,-2952
2015,11,29,17,12890,12870,10244,-2626
2015,11,29,18,12910,12880,10490,-2390
2015,11,29,19,12820,12913,10256,-2657
2015,11,29,20,12790,13077,10436,-2641
2015,11,29,21,13210,13566,10835,-2731
2015,11,29,22,14590,15003,11797,-3206
2015,11,29,23,15700,16166,13039,-3127
2015,11,30,0,15550,16165,13093,-3072
2015,11,30,1,15090,15811,12885,-2926
2015,11,30,2,14620,15311,12379,-2932
2015,11,30,3,13750,14358,10999,-3359
2015,11,30,4,12690,13303,10178,-3125
2015,11,30,5,11700,12276,9310,-2966
2015,11,30,6,11020,12078,9164,-2914
2015,11,30,7,10730,12162,9050,-3112
2015,11,30,8,10670,11997,8919,-3078
2015,11,30,9,10780,12044,9245,-2799
2015,11,30,10,11470,12465,9645,-2820
2015,11,30,11,12660,13376,10319,-3057
2015,11,30,12,14610,14646,11464,-3182
2015,11,30,13,15630,15573,12689,-2884
2015,11,30,14,15680,15655,12712,-2943
2015,11,30,15,15550,15552,12678,-2874
2015,11,30,16,15430,15413,12922,-2491
2015,11,30,17,15300,15305,12700,-2605
2015,11,30,18,15160,15243,12821,-2422
2015,11,30,19,15140,15376,13300,-2076
2015,11,30,20,15130,15401,12875,-2526
2015,11,30,21,15480,15632,13110,-2522
2015,11,30,22,16710,16748,14233,-2515
2015,11,30,23,17600,17659,14977,-2682
2015,12,1,0,17370,17598,15040,-2558
2015,12,1,1,16890,17177,14533,-2644
2015,12,1,2,16220,16557,13868,-2689
2015,12,1,3,15070,15467,12750,-2717
2015,12,1,4,13700,14044,11070,-2974
2015,12,1,5,12500,12876,10067,-2809
2015,12,1,6,11850,12579,9957,-2622
2015,12,1,7,11400,12437,9835,-2602
2015,12,1,8,11190,12437,9871,-2566
2015,12,1,9,11220,12444,9823,-2621
2015,12,1,10,11590,12570,10013,-2557
2015,12,1,11,12840,13342,10484,-2858
2015,12,1,12,14730,14756,11884,-2872
2015,12,1,13,15740,15649,12927,-2722
2015,12,1,14,15850,15743,13105,-2638
2015,12,1,15,15800,15759,13055,-2704
2015,12,1,16,15750,15790,13102,-2688
2015,12,1,17,15650,15736,13055,-2681
2015,12,1,18,15550,15642,12937,-2705
2015,12,1,19,15540,15627,12943,-2684
2015,12,1,20,15550,15583,12876,-2707
2015,12,1,21,15700,15804,13156,-2648
2015,12,1,22,16780,16838,14186,-2652
2015,12,1,23,17500,17538,14845,-2693
2015,12,2,0,17360,17399,14726,-2673
2015,12,2,1,16980,16907,14164,-2743
2015,12,2,2,16260,16219,13517,-2702
2015,12,2,3,15160,15074,12360,-2714
2015,12,2,4,13690,13592,11281,-2311
2015,12,2,5,12390,12656,10216,-2440
2015,12,2,6,11500,12386,10265,-2121
2015,12,2,7,11020,12010,9829,-2181
2015,12,2,8,10760,11768,9709,-2059
2015,12,2,9,10760,11725,9766,-1959
2015,12,2,10,11070,12021,10075,-1946
2015,12,2,11,12150,12710,10723,-1987
2015,12,2,12,14000,13951,11525,-2426
2015,12,2,13,15030,15014,12544,-2470
2015,12,2,14,15230,15283,13272,-2011
2015,12,2,15,15290,15438,13297,-2141
2015,12,2,16,15350,15569,13162,-2407
2015,12,2,17,15300,15600,13358,-2242
2015,12,2,18,15210,15453,13273,-2180
2015,12,2,19,15150,15445,13379,-2066
2015,12,2,20,15170,15375,13303,-2072
2015,12,2,21,15440,15592,13364,-2228
2015,12,2,22,16450,16518,14287,-2231
2015,12,2,23,17150,17057,14785,-2272
2015,12,3,0,16890,16835,14606,-2229
2015,12,3,1,16420,16351,14191,-2160
2015,12,3,2,15680,15652,13564,-2088
2015,12,3,3,14560,14561,12507,-2054
2015,12,3,4,13170,13122,11143,-1979
2015,12,3,5,11880,11802,9830,-1972
2015,12,3,6,10990,11664,9802,-1862
2015,12,3,7,10510,11475,9606,-1869
2015,12,3,8,10290,11239,9517,-1722
2015,12,3,9,10280,11201,9431,-1770
2015,12,3,10,10560,11505,9865,-1640
2015,12,3,11,11670,12198,10379,-1819
2015,12,3,12,13590,13455,11157,-2298
2015,12,3,13,14710,14548,11768,-2780
2015,12,3,14,14940,14646,11847,-2799
2015,12,3,15,15000,14703,11944,-2759
2015,12,3,16,15010,14759,11882,-2877
2015,12,3,17,14960,14742,11955,-2787
2015,12,3,18,14860,14657,12182,-2475
2015,12,3,19,14800,14638,12293,-2345
2015,12,3,20,14810,14628,12396,-2232
2015,12,3,21,15040,14909,12421,-2488
2015,12,3,22,16200,16024,13434,-2590
2015,12,3,23,17100,17025,14918,-2107
2015,12,4,0,17050,16931,14603,-2328
2015,12,4,1,16700,16546,13952,-2594
2015,12,4,2,16140,15984,13468,-2516
2015,12,4,3,15160,14963,12380,-2583
2015,12,4,4,13740,13564,11165,-2399
2015,12,4,5,12450,12311,10144,-2167
2015,12,4,6,11400,11712,9803,-1909
2015,12,4,7,10910,11756,9621,-2135
2015,12,4,8,10710,11802,9612,-2190
2015,12,4,9,10720,11818,9735,-2083
2015,12,4,10,11040,12047,9669,-2378
2015,12,4,11,12100,12582,10016,-2566
2015,12,4,12,13950,14133,11368,-2765
2015,12,4,13,14910,15139,12535,-2604
2015,12,4,14,14950,15139,12728,-2411
2015,12,4,15,14890,14947,12549,-2398
2015,12,4,16,14820,14746,12309,-2437
2015,12,4,17,14660,14562,12052,-2510
2015,12,4,18,14480,14453,12117,-2336
2015,12,4,19,14380,14530,12174,-2356
2015,12,4,20,14370,14612,12224,-2388
2015,12,4,21,14570,14889,12410,-2479
2015,12,4,22,15770,15925,13510,-2415
2015,12,4,23,16600,16546,14090,-2456
2015,12,5,0,16340,16275,13698,-2577
2015,12,5,1,15910,15815,13223,-2592
2015,12,5,2,15380,15312,12773,-2539
2015,12,5,3,14580,14526,11888,-2638
2015,12,5,4,13480,13431,11109,-2322
2015,12,5,5,12310,12258,9957,-2301
2015,12,5,6,11500,11633,9777,-1856
2015,12,5,7,10980,11385,9521,-1864
2015,12,5,8,10710,11358,9612,-1746
2015,12,5,9,10650,11402,9711,-1691
2015,12,5,10,10800,11496,9841,-1655
2015,12,5,11,11230,11682,9994,-1688
2015,12,5,12,11980,12055,10030,-2025
2015,12,5,13,12690,12847,10831,-2016
2015,12,5,14,13330,13473,11665,-1808
2015,12,5,15,13620,13587,11575,-2012
2015,12,5,16,13580,13459,11212,-2247
2015,12,5,17,13380,13207,11283,-1924
2015,12,5,18,13130,12962,11007,-1955
2015,12,5,19,12860,12805,11244,-1561
2015,12,5,20,12910,12861,11312,-1549
2015,12,5,21,13170,13232,11376,-1856
2015,12,5,22,14420,14443,12354,-2089
2015,12,5,23,15360,15457,13356,-2101
2015,12,6,0,15310,15347,13272,-2075
2015,12,6,1,14890,14977,12833,-2144
2015,12,6,2,14500,14583,12659,-1924
2015,12,6,3,13800,13979,11806,-2173
2015,12,6,4,12920,13125,11025,-2100
2015,12,6,5,11920,12159,10247,-1912
2015,12,6,6,11240,11600,9623,-1977
2015,12,6,7,10750,11376,9805,-1571
2015,12,6,8,10510,11442,9767,-1675
2015,12,6,9,10440,11359,9613,-1746
2015,12,6,10,10540,11436,9625,-1811
2015,12,6,11,10890,11765,9854,-1911
2015,12,6,12,11430,12071,10188,-1883
2015,12,6,13,11970,12223,10458,-1765
2015,12,6,14,12650,12857,11227,-1630
2015,12,6,15,13030,13130,11033,-2097
2015,12,6,16,13110,13090,11208,-1882
2015,12,6,17,13100,12938,11019,-1919
2015,12,6,18,13080,12833,11101,-1732
2015,12,6,19,13040,12780,11092,-1688
2015,12,6,20,12960,12929,10900,-2029
2015,12,6,21,13400,13406,11292,-2114
2015,12,6,22,14830,14929,12701,-2228
2015,12,6,23,15880,16008,13607,-2401
2015,12,7,0,15790,15982,13657,-2325
2015,12,7,1,15400,15560,13248,-2312
2015,12,7,2,14830,15136,13001,-2135
2015,12,7,3,13860,14142,11971,-2171
2015,12,7,4,12690,12909,10384,-2525
2015,12,7,5,11600,11973,9912,-2061
2015,12,7,6,11060,11687,9925,-1762
2015,12,7,7,10670,11684,10143,-1541
2015,12,7,8,10520,11545,10115,-1430
2015,12,7,9,10600,11599,9999,-1600
2015,12,7,10,11000,12000,10348,-1652
2015,12,7,11,12210,13156,11131,-2025
2015,12,7,12,14230,14196,12343,-1853
2015,12,7,13,15320,15189,13176,-2013
2015,12,7,14,15250,15337,13401,-1936
2015,12,7,15,15020,15161,13250,-1911
2015,12,7,16,14900,14858,12914,-1944
2015,12,7,17,14710,14539,12870,-1669
2015,12,7,18,14510,14318,12753,-1565
2015,12,7,19,14480,14341,12471,-1870
2015,12,7,20,14510,14397,12689,-1708
2015,12,7,21,14720,14745,12951,-1794
2015,12,7,22,16060,16046,14113,-1933
2015,12,7,23,17190,17191,15526,-1665
2015,12,8,0,17060,17149,15365,-1784
2015,12,8,1,16660,16744,14634,-2110
2015,12,8,2,16070,16113,13839,-2274
2015,12,8,3,14980,14974,12811,-2163
2015,12,8,4,13600,13551,11453,-2098
2015,12,8,5,12340,12307,10521,-1786
2015,12,8,6,11590,12080,10259,-1821
2015,12,8,7,11160,11870,10206,-1664
2015,12,8,8,10940,11779,10139,-1640
2015,12,8,9,10990,11775,10112,-1663
2015,12,8,10,11090,12143,10335,-1808
2015,12,8,11,12210,12991,10885,-2106
2015,12,8,12,14220,14278,12401,-1877
2015,12,8,13,15310,15286,13553,-1733
2015,12,8,14,15520,15538,13865,-1673
2015,12,8,15,15530,15594,14005,-1589
2015,12,8,16,15550,15622,13857,-1765
2015,12,8,17,15430,15510,13499,-2011
2015,12,8,18,15300,15319,13281,-2038
2015,12,8,19,15340,15306,13419,-1887
2015,12,8,20,15390,15281,13315,-1966
2015,12,8,21,15620,15522,13663,-1859
2015,12,8,22,16840,16689,14927,-1762
2015,12,8,23,17900,17518,15706,-1812
2015,12,9,0,17660,17393,15716,-1677
2015,12,9,1,17290,16997,15189,-1808
2015,12,9,2,16570,16378,14386,-1992
2015,12,9,3,15500,15284,13036,-2248
2015,12,9,4,14040,13811,11478,-2333
2015,12,9,5,12690,12617,10536,-2081
2015,12,9,6,11780,12170,9840,-2330
2015,12,9,7,11330,12137,9832,-2305
2015,12,9,8,11120,11934,9697,-2237
2015,12,9,9,11130,11912,9685,-2227
2015,12,9,10,11240,12271,10088,-2183
2015,12,9,11,12350,12860,10586,-2274
2015,12,9,12,14310,14272,12215,-2057
2015,12,9,13,15400,15292,13312,-1980
2015,12,9,14,15540,15401,13406,-1995
2015,12,9,15,15490,15354,13371,-1983
2015,12,9,16,15400,15308,13321,-1987
2015,12,9,17,15260,15133,13215,-1918
2015,12,9,18,15110,14958,13006,-1952
2015,12,9,19,15100,15068,13069,-1999
2015,12,9,20,15150,15038,13163,-1875
2015,12,9,21,15490,15263,13384,-1879
2015,12,9,22,16700,16491,14630,-1861
2015,12,9,23,17540,17347,15489,-1858
2015,12,10,0,17310,17205,15330,-1875
2015,12,10,1,16840,16756,14945,-1811
2015,12,10,2,16170,16119,14270,-1849
2015,12,10,3,15050,14996,12878,-2118
2015,12,10,4,13620,13489,11377,-2112
2015,12,10,5,12310,12135,10096,-2039
2015,12,10,6,11200,11687,10212,-1475
2015,12,10,7,10710,11667,10214,-1453
2015,12,10,8,10490,11453,10240,-1213
2015,12,10,9,10470,11416,10154,-1262
2015,12,10,10,10710,11534,10191,-1343
2015,12,10,11,11720,12278,10580,-1698
2015,12,10,12,13730,13672,11573,-2099
2015,12,10,13,14720,14730,12773,-1957
2015,12,10,14,14840,14859,13030,-1829
2015,12,10,15,14800,14854,12872,-1982
2015,12,10,16,14740,14782,12800,-1982
2015,12,10,17,14620,14653,12689,-1964
2015,12,10,18,14470,14396,12445,-1951
2015,12,10,19,14470,14311,12474,-1837
2015,12,10,20,14550,14321,12713,-1608
2015,12,10,21,14820,14518,13025,-1493
2015,12,10,22,15820,15684,13830,-1854
2015,12,10,23,16480,16641,14976,-1665
2015,12,11,0,16310,16522,14834,-1688
2015,12,11,1,15930,16162,14454,-1708
2015,12,11,2,15370,15595,13993,-1602
2015,12,11,3,14360,14584,12663,-1921
2015,12,11,4,13000,13181,11075,-2106
2015,12,11,5,11740,11847,10118,-1729
2015,12,11,6,10890,11139,9529,-1610
2015,12,11,7,10410,11022,9535,-1487
2015,12,11,8,10190,10884,9522,-1362
2015,12,11,9,10190,10990,9592,-1398
2015,12,11,10,10500,11193,9731,-1462
2015,12,11,11,11550,12069,10239,-1830
2015,12,11,12,13460,13508,11458,-2050
2015,12,11,13,14520,14530,12695,-1835
2015,12,11,14,14650,14772,12979,-1793
2015,12,11,15,14620,14797,13172,-1625
2015,12,11,16,14550,14719,13150,-1569
2015,12,11,17,14420,14605,12929,-1676
2015,12,11,18,14290,14408,12687,-1721
2015,12,11,19,14300,14285,12715,-1570
2015,12,11,20,14350,14274,12771,-1503
2015,12,11,21,14520,14503,13123,-1380
2015,12,11,22,15510,15618,14009,-1609
2015,12,11,23,16250,16347,14702,-1645
2015,12,12,0,15850,16066,14374,-1692
2015,12,12,1,15350,15574,13568,-2006
2015,12,12,2,14770,15015,13362,-1653
2015,12,12,3,13950,14208,12641,-1567
2015,12,12,4,12830,13062,11429,-1633
2015,12,12,5,11660,11829,10349,-1480
2015,12,12,6,10730,11116,9540,-1576
2015,12,12,7,10220,11056,9193,-1863
2015,12,12,8,9970,10842,9068,-1774
2015,12,12,9,9880,10875,9083,-1792
2015,12,12,10,10120,11058,9106,-1952
2015,12,12,11,10540,11481,9462,-2019
2015,12,12,12,11330,11757,9745,-2012
2015,12,12,13,12130,12157,10133,-2024
2015,12,12,14,12860,12813,10764,-2049
2015,12,12,15,13270,13175,10907,-2268
2015,12,12,16,13360,13031,11122,-1909
2015,12,12,17,13250,12851,11098,-1753
2015,12,12,18,13080,12712,11123,-1589
2015,12,12,19,12900,12626,11099,-1527
2015,12,12,20,12920,12741,11069,-1672
2015,12,12,21,13190,13110,11774,-1336
2015,12,12,22,14400,14369,12700,-1669
2015,12,12,23,15250,15188,13554,-1634
2015,12,13,0,15040,14956,13215,-1741
2015,12,13,1,14620,14554,12769,-1785
2015,12,13,2,14180,14069,12101,-1968
2015,12,13,3,13460,13381,11550,-1831
2015,12,13,4,12550,12458,11016,-1442
2015,12,13,5,11530,11418,10328,-1090
2015,12,13,6,10630,11088,9576,-1512
2015,12,13,7,10110,11064,9089,-1975
2015,12,13,8,9820,10765,8977,-1788
2015,12,13,9,9710,10617,8870,-1747
2015,12,13,10,9790,10642,8942,-1700
2015,12,13,11,10110,10894,9095,-1799
2015,12,13,12,10720,11334,9353,-1981
2015,12,13,13,11390,11444,9673,-1771
2015,12,13,14,12230,11963,10108,-1855
2015,12,13,15,12850,12643,10642,-2001
2015,12,13,16,13120,12964,11174,-1790
2015,12,13,17,13270,13119,11227,-1892
2015,12,13,18,13370,13222,11233,-1989
2015,12,13,19,13360,13228,11037,-2191
2015,12,13,20,13490,13258,10864,-2394
2015,12,13,21,13910,13569,11344,-2225
2015,12,13,22,15280,14927,12601,-2326
2015,12,13,23,16200,15877,13393,-2484
2015,12,14,0,15830,15793,13407,-2386
2015,12,14,1,15400,15412,13262,-2150
2015,12,14,2,14700,14870,12506,-2364
2015,12,14,3,13680,13844,11818,-2026
2015,12,14,4,12470,12640,10567,-2073
2015,12,14,5,11320,11737,9717,-2020
2015,12,14,6,10530,11084,9377,-1707
2015,12,14,7,10130,11005,9110,-1895
2015,12,14,8,9970,10831,8906,-1925
2015,12,14,9,10030,10842,9089,-1753
2015,12,14,10,10140,11159,9271,-1888
2015,12,14,11,11230,12123,9966,-2157
2015,12,14,12,13190,13202,10844,-2358
2015,12,14,13,14310,14396,12283,-2113
2015,12,14,14,14610,14739,12642,-2097
2015,12,14,15,14780,14933,12760,-2173
2015,12,14,16,14860,15061,13112,-1949
2015,12,14,17,14820,15078,13299,-1779
2015,12,14,18,14720,14995,12931,-2064
2015,12,14,19,14740,14996,13075,-1921
2015,12,14,20,14770,14965,13016,-1949
2015,12,14,21,15020,15176,13411,-1765
2015,12,14,22,16250,16275,14751,-1524
2015,12,14,23,17000,17097,15385,-1712
2015,12,15,0,16760,16932,15191,-1741
2015,12,15,1,16230,16462,14737,-1725
2015,12,15,2,15410,15790,13688,-2102
2015,12,15,3,14200,14651,12664,-1987
2015,12,15,4,12780,13164,11492,-1672
2015,12,15,5,11450,11755,10231,-1524
2015,12,15,6,10480,11256,9880,-1376
2015,12,15,7,9980,11349,9802,-1547
2015,12,15,8,9730,11087,9494,-1593
2015,12,15,9,9690,11020,9254,-1766
2015,12,15,10,10090,11283,9462,-1821
2015,12,15,11,11340,11881,9950,-1931
2015,12,15,12,13210,13311,11247,-2064
2015,12,15,13,14320,14214,12268,-1946
2015,12,15,14,14480,14300,12500,-1800
2015,12,15,15,14540,14168,12224,-1944
2015,12,15,16,14590,14141,12108,-2033
2015,12,15,17,14520,14056,12218,-1838
2015,12,15,18,14450,14045,12283,-1762
2015,12,15,19,14410,14222,12668,-1554
2015,12,15,20,14520,14297,12674,-1623
2015,12,15,21,14670,14540,13035,-1505
2015,12,15,22,15870,15687,13955,-1732
2015,12,15,23,16810,16705,15070,-1635
2015,12,16,0,16710,16613,14846,-1767
2015,12,16,1,16170,16206,14557,-1649
2015,12,16,2,15530,15610,14214,-1396
2015,12,16,3,14470,14599,12961,-1638
2015,12,16,4,13020,13230,11503,-1727
2015,12,16,5,11710,11846,10794,-1052
2015,12,16,6,10920,11285,9799,-1486
2015,12,16,7,10470,11424,9872,-1552
2015,12,16,8,10290,11297,9716,-1581
2015,12,16,9,10310,11270,9588,-1682
2015,12,16,10,10660,11613,9901,-1712
2015,12,16,11,11760,12288,10582,-1706
2015,12,16,12,13760,13649,11394,-2255
2015,12,16,13,14840,14753,13068,-1685
2015,12,16,14,14890,14792,13321,-1471
2015,12,16,15,14820,14641,13208,-1433
2015,12,16,16,14780,14477,13155,-1322
2015,12,16,17,14650,14404,13206,-1198
2015,12,16,18,14510,14213,13139,-1074
2015,12,16,19,14520,14268,13156,-1112
2015,12,16,20,14610,14385,13043,-1342
2015,12,16,21,14890,14744,13476,-1268
2015,12,16,22,16130,16064,14758,-1306
2015,12,16,23,17140,17131,16033,-1098
2015,12,17,0,16950,17078,15701,-1377
2015,12,17,1,16550,16736,15121,-1615
2015,12,17,2,16000,16201,14473,-1728
2015,12,17,3,14970,15174,13253,-1921
2015,12,17,4,13560,13695,12064,-1631
2015,12,17,5,12220,12495,11060,-1435
2015,12,17,6,11340,11922,10342,-1580
2015,12,17,7,10830,11898,10241,-1657
2015,12,17,8,10600,11625,10027,-1598
2015,12,17,9,10660,11578,10079,-1499
2015,12,17,10,10970,11834,10483,-1351
2015,12,17,11,11970,12415,10865,-1550
2015,12,17,12,13930,13811,12217,-1594
2015,12,17,13,15060,14945,13655,-1290
2015,12,17,14,15270,15238,13838,-1400
2015,12,17,15,15320,15354,13980,-1374
2015,12,17,16,15390,15465,13926,-1539
2015,12,17,17,15400,15460,13617,-1843
2015,12,17,18,15290,15368,13599,-1769
2015,12,17,19,15280,15418,13558,-1860
2015,12,17,20,15260,15402,13565,-1837
2015,12,17,21,15400,15652,13790,-1862
2015,12,17,22,16440,16575,14769,-1806
2015,12,17,23,17060,17049,15252,-1797
2015,12,18,0,16840,16878,14936,-1942
2015,12,18,1,16360,16453,14318,-2135
2015,12,18,2,15760,15818,13713,-2105
2015,12,18,3,14720,14772,12705,-2067
2015,12,18,4,13270,13319,11598,-1721
2015,12,18,5,11890,12139,10460,-1679
2015,12,18,6,10870,11434,9692,-1742
2015,12,18,7,10350,11347,9389,-1958
2015,12,18,8,10130,11148,9276,-1872
2015,12,18,9,10050,11097,9143,-1954
2015,12,18,10,10350,11385,9394,-1991
2015,12,18,11,11340,12139,9897,-2242
2015,12,18,12,13180,13543,11267,-2276
2015,12,18,13,14330,14409,12383,-2026
2015,12,18,14,14560,14712,12726,-1986
2015,12,18,15,14600,14894,12833,-2061
2015,12,18,16,14840,15014,12947,-2067
2015,12,18,17,14750,15056,12980,-2076
2015,12,18,18,14590,14929,12775,-2154
2015,12,18,19,14540,14923,12881,-2042
2015,12,18,20,14580,14887,12840,-2047
2015,12,18,21,14750,15061,12931,-2130
2015,12,18,22,15860,16002,14038,-1964
2015,12,18,23,16600,16745,14850,-1895
2015,12,19,0,16330,16574,14620,-1954
2015,12,19,1,15910,16115,14285,-1830
2015,12,19,2,15370,15646,13662,-1984
2015,12,19,3,14580,14894,12794,-2100
2015,12,19,4,13470,13848,11646,-2202
2015,12,19,5,12270,12717,10934,-1783
2015,12,19,6,11410,12328,9694,-2634
2015,12,19,7,10920,11920,9337,-2583
2015,12,19,8,10690,11805,9350,-2455
2015,12,19,9,10620,11813,9288,-2525
2015,12,19,10,10930,11930,9376,-2554
2015,12,19,11,11380,11973,9346,-2627
2015,12,19,12,12180,12622,9920,-2702
2015,12,19,13,13040,13098,10424,-2674
2015,12,19,14,13800,13874,11419,-2455
2015,12,19,15,14180,14119,11856,-2263
2015,12,19,16,14260,14119,11609,-2510
2015,12,19,17,14120,14005,11525,-2480
2015,12,19,18,14060,13870,11409,-2461
2015,12,19,19,13910,13841,11169,-2672
2015,12,19,20,13860,13993,11518,-2475
2015,12,19,21,14270,14425,11964,-2461
2015,12,19,22,15510,15689,13326,-2363
2015,12,19,23,16600,16680,14380,-2300
2015,12,20,0,16320,16563,14142,-2421
2015,12,20,1,15950,16156,13872,-2284
2015,12,20,2,15560,15763,13468,-2295
2015,12,20,3,14940,15146,12796,-2350
2015,12,20,4,14020,14222,11755,-2467
2015,12,20,5,12950,13161,10485,-2676
2015,12,20,6,12080,12489,9551,-2938
2015,12,20,7,11570,12436,9476,-2960
2015,12,20,8,11320,12401,9590,-2811
2015,12,20,9,11220,12260,9468,-2792
2015,12,20,10,11320,12310,9429,-2881
2015,12,20,11,11640,12358,9557,-2801
2015,12,20,12,12280,12890,9951,-2939
2015,12,20,13,12960,12851,10094,-2757
2015,12,20,14,13770,13503,10737,-2766
2015,12,20,15,14220,13819,11049,-2770
2015,12,20,16,14010,13816,11064,-2752
2015,12,20,17,14070,13769,11113,-2656
2015,12,20,18,14070,13745,11055,-2690
2015,12,20,19,14080,13704,11146,-2558
2015,12,20,20,13760,13806,11158,-2648
2015,12,20,21,14230,14184,11601,-2583
2015,12,20,22,15800,15663,13327,-2336
2015,12,20,23,16900,16862,14410,-2452
2015,12,21,0,16710,16864,14545,-2319
2015,12,21,1,16290,16586,14142,-2444
2015,12,21,2,15960,16155,13837,-2318
2015,12,21,3,14870,15246,12557,-2689
2015,12,21,4,13710,13968,11089,-2879
2015,12,21,5,12560,12707,9787,-2920
2015,12,21,6,11780,12139,9209,-2930
2015,12,21,7,11360,11929,9012,-2917
2015,12,21,8,11180,11820,9051,-2769
2015,12,21,9,11200,11975,9132,-2843
2015,12,21,10,11580,12367,9275,-3092
2015,12,21,11,12740,12882,9818,-3064
2015,12,21,12,14710,14454,11648,-2806
2015,12,21,13,15740,15589,12916,-2673
2015,12,21,14,15920,15691,13055,-2636
2015,12,21,15,15850,15601,13124,-2477
2015,12,21,16,15550,15584,13362,-2222
2015,12,21,17,15400,15497,13275,-2222
2015,12,21,18,15200,15266,13110,-2156
2015,12,21,19,15150,15242,12963,-2279
2015,12,21,20,15130,15204,12830,-2374
2015,12,21,21,15460,15424,13130,-2294
2015,12,21,22,16750,16577,14447,-2130
2015,12,21,23,17700,17302,15079,-2223
2015,12,22,0,17500,17136,14601,-2535
2015,12,22,1,17070,16735,13991,-2744
2015,12,22,2,16450,16116,13546,-2570
2015,12,22,3,15330,15038,12329,-2709
2015,12,22,4,13830,13562,11035,-2527
2015,12,22,5,12470,12240,9993,-2247
2015,12,22,6,11390,11880,9946,-1934
2015,12,22,7,10860,11306,9272,-2034
2015,12,22,8,10610,11030,9111,-1919
2015,12,22,9,10560,10969,9123,-1846
2015,12,22,10,10510,11252,9413,-1839
2015,12,22,11,11580,12109,10143,-1966
2015,12,22,12,13450,13321,10990,-2331
2015,12,22,13,14570,14554,12178,-2376
2015,12,22,14,14810,14940,12786,-2154
2015,12,22,15,14870,15126,12967,-2159
2015,12,22,16,15000,15270,13242,-2028
2015,12,22,17,15020,15327,13304,-2023
2015,12,22,18,14860,15262,13141,-2121
2015,12,22,19,14860,15315,13261,-2054
2015,12,22,20,14880,15269,13212,-2057
2015,12,22,21,15150,15408,13348,-2060
2015,12,22,22,16240,16286,14323,-1963
2015,12,22,23,16860,16856,14705,-2151
2015,12,23,0,16650,16676,14304,-2372
2015,12,23,1,16230,16241,13946,-2295
2015,12,23,2,15620,15629,13584,-2045
2015,12,23,3,14580,14653,12714,-1939
2015,12,23,4,13100,13269,11591,-1678
2015,12,23,5,11780,12061,10290,-1771
2015,12,23,6,10860,11386,9685,-1701
2015,12,23,7,10400,10898,9066,-1832
2015,12,23,8,10180,10842,8756,-2086
2015,12,23,9,10170,11014,8709,-2305
2015,12,23,10,10520,11133,8867,-2266
2015,12,23,11,11420,12040,9684,-2356
2015,12,23,12,13290,13249,11153,-2096
2015,12,23,13,14370,14192,12233,-1959
2015,12,23,14,14610,14610,12469,-2141
2015,12,23,15,14770,14757,12572,-2185
2015,12,23,16,14820,14807,12724,-2083
2015,12,23,17,14840,14797,12900,-1897
2015,12,23,18,14730,14639,12673,-1966
2015,12,23,19,14720,14606,12666,-1940
2015,12,23,20,14780,14611,12533,-2078
2015,12,23,21,15020,14855,12622,-2233
2015,12,23,22,16100,15976,13513,-2463
2015,12,23,23,16860,16594,14146,-2448
2015,12,24,0,16580,16429,13971,-2458
2015,12,24,1,16120,15994,13606,-2388
2015,12,24,2,15460,15447,13290,-2157
2015,12,24,3,14400,14568,12330,-2238
2015,12,24,4,12970,13300,11296,-2004
2015,12,24,5,11660,12157,10339,-1818
2015,12,24,6,10850,11652,9565,-2087
2015,12,24,7,10220,11133,9170,-1963
2015,12,24,8,9940,10869,8968,-1901
2015,12,24,9,9860,10706,8916,-1790
2015,12,24,10,9870,10840,9108,-1732
2015,12,24,11,10580,11164,9092,-2072
2015,12,24,12,11720,12174,9628,-2546
2015,12,24,13,12810,12582,10528,-2054
2015,12,24,14,13620,13403,11161,-2242
2015,12,24,15,14180,13995,11660,-2335
2015,12,24,16,14380,14284,11894,-2390
2015,12,24,17,14370,14374,11941,-2433
2015,12,24,18,14190,14300,11903,-2397
2015,12,24,19,14010,14170,11736,-2434
2015,12,24,20,14070,13999,11634,-2365
2015,12,24,21,14130,14032,11837,-2195
2015,12,24,22,15000,14830,12286,-2544
2015,12,24,23,15350,15322,12632,-2690
2015,12,25,0,14360,14555,12027,-2528
2015,12,25,1,13620,13792,11417,-2375
2015,12,25,2,13210,13292,11093,-2199
2015,12,25,3,12740,12853,10829,-2024
2015,12,25,4,12130,12223,10217,-2006
2015,12,25,5,11310,11565,9747,-1818
2015,12,25,6,10340,10773,9012,-1761
2015,12,25,7,9790,10421,8626,-1795
2015,12,25,8,9260,10213,8565,-1648
2015,12,25,9,9240,10052,8511,-1541
2015,12,25,10,9380,10070,8511,-1559
2015,12,25,11,9600,10357,8792,-1565
2015,12,25,12,10330,10696,9027,-1669
2015,12,25,13,10920,11399,9168,-2231
2015,12,25,14,11730,11804,9375,-2429
2015,12,25,15,12250,12072,9508,-2564
2015,12,25,16,12350,12172,9578,-2594
2015,12,25,17,12410,12228,9584,-2644
2015,12,25,18,12190,12256,9500,-2756
2015,12,25,19,11840,12072,9453,-2619
2015,12,25,20,11700,11916,9446,-2470
2015,12,25,21,11690,11898,9595,-2303
2015,12,25,22,12440,12620,9928,-2692
2015,12,25,23,13020,13198,10406,-2792
2015,12,26,0,12980,13076,10410,-2666
2015,12,26,1,12790,12918,10500,-2418
2015,12,26,2,12830,12711,10439,-2272
2015,12,26,3,12460,12265,10044,-2221
2015,12,26,4,11670,11489,9577,-1912
2015,12,26,5,10780,10562,8859,-1703
2015,12,26,6,10130,10049,8564,-1485
2015,12,26,7,9670,9890,8410,-1480
2015,12,26,8,9440,9927,8534,-1393
2015,12,26,9,9380,9879,8431,-1448
2015,12,26,10,9480,9901,8473,-1428
2015,12,26,11,9450,10083,8394,-1689
2015,12,26,12,9930,10356,8604,-1752
2015,12,26,13,10740,10869,8933,-1936
2015,12,26,14,11810,11631,9511,-2120
2015,12,26,15,12510,12209,9975,-2234
2015,12,26,16,12430,12392,9966,-2426
2015,12,26,17,12430,12367,9795,-2572
2015,12,26,18,12280,12363,9635,-2728
2015,12,26,19,12190,12303,9613,-2690
2015,12,26,20,12220,12450,9854,-2596
2015,12,26,21,12750,12849,10191,-2658
2015,12,26,22,14050,13995,11254,-2741
2015,12,26,23,14890,14825,11987,-2838
2015,12,27,0,14450,14702,11949,-2753
2015,12,27,1,13710,14358,11708,-2650
2015,12,27,2,13360,13937,11323,-2614
2015,12,27,3,13040,13261,10637,-2624
2015,12,27,4,12220,12299,9886,-2413
2015,12,27,5,11370,11270,9040,-2230
2015,12,27,6,10500,10513,8512,-2001
2015,12,27,7,10040,10144,8260,-1884
2015,12,27,8,9790,10120,8379,-1741
2015,12,27,9,9650,10004,8276,-1728
2015,12,27,10,9720,10032,8286,-1746
2015,12,27,11,9710,10286,8463,-1823
2015,12,27,12,10230,10763,8668,-2095
2015,12,27,13,10890,11366,8958,-2408
2015,12,27,14,11840,11834,9501,-2333
2015,12,27,15,12450,12572,9958,-2614
2015,12,27,16,12950,13128,10302,-2826
2015,12,27,17,13070,13391,10468,-2923
2015,12,27,18,13090,13514,10626,-2888
2015,12,27,19,13100,13377,10468,-2909
2015,12,27,20,13010,13307,10341,-2966
2015,12,27,21,13340,13387,10494,-2893
2015,12,27,22,14570,14454,11352,-3102
2015,12,27,23,15480,15212,12173,-3039
2015,12,28,0,15280,15061,12105,-2956
2015,12,28,1,14850,14630,11523,-3107
2015,12,28,2,14420,14112,11088,-3024
2015,12,28,3,13520,13333,10339,-2994
2015,12,28,4,12460,12330,9796,-2534
2015,12,28,5,11340,11491,9279,-2212
2015,12,28,6,10510,11339,9181,-2158
2015,12,28,7,10190,11074,9031,-2043
2015,12,28,8,10070,11199,9103,-2096
2015,12,28,9,10160,11143,9108,-2035
2015,12,28,10,10610,11379,9142,-2237
2015,12,28,11,11720,12041,10039,-2002
2015,12,28,12,13620,13034,10494,-2540
2015,12,28,13,14800,14064,11520,-2544
2015,12,28,14,15170,14656,12161,-2495
2015,12,28,15,15180,14938,12227,-2711
2015,12,28,16,15120,14972,12048,-2924
2015,12,28,17,15070,14914,12105,-2809
2015,12,28,18,15070,14882,12083,-2799
2015,12,28,19,15060,14950,12335,-2615
2015,12,28,20,15190,15156,12587,-2569
2015,12,28,21,15490,15550,12882,-2668
2015,12,28,22,16730,16799,13893,-2906
2015,12,28,23,18000,17728,14702,-3026
2015,12,29,0,17820,17611,14401,-3210
2015,12,29,1,17420,17190,13782,-3408
2015,12,29,2,16920,16615,13196,-3419
2015,12,29,3,15880,15676,12157,-3519
2015,12,29,4,14430,14384,10947,-3437
2015,12,29,5,13130,13144,10001,-3143
2015,12,29,6,12200,12448,9010,-3438
2015,12,29,7,11730,12450,8695,-3755
2015,12,29,8,11540,12419,8639,-3780
2015,12,29,9,11520,12381,8627,-3754
2015,12,29,10,11860,12658,8809,-3849
2015,12,29,11,12820,13121,9423,-3698
2015,12,29,12,14270,14099,10883,-3216
2015,12,29,13,15380,14890,11424,-3466
2015,12,29,14,16030,15627,12152,-3475
2015,12,29,15,16210,16313,12935,-3378
2015,12,29,16,16360,16743,13261,-3482
2015,12,29,17,16410,16981,13543,-3438
2015,12,29,18,16290,16940,13685,-3255
2015,12,29,19,16190,16776,13628,-3148
2015,12,29,20,16180,16584,13473,-3111
2015,12,29,21,16260,16547,13374,-3173
2015,12,29,22,17240,17357,14423,-2934
2015,12,29,23,18070,18116,14906,-3210
2015,12,30,0,17900,17820,14446,-3374
2015,12,30,1,17230,17272,13710,-3562
2015,12,30,2,16630,16601,13060,-3541
2015,12,30,3,15570,15608,12037,-3571
2015,12,30,4,14170,14315,10593,-3722
2015,12,30,5,12850,13071,9634,-3437
2015,12,30,6,11960,12663,9006,-3657
2015,12,30,7,11500,12543,8839,-3704
2015,12,30,8,11270,12550,8725,-3825
2015,12,30,9,11240,12509,8715,-3794
2015,12,30,10,11570,12521,8752,-3769
2015,12,30,11,12770,12963,9033,-3930
2015,12,30,12,14490,14109,10130,-3979
2015,12,30,13,15550,14922,10921,-4001
2015,12,30,14,15840,15596,11602,-3994
2015,12,30,15,15980,16065,12144,-3921
2015,12,30,16,16070,16357,12476,-3881
2015,12,30,17,16040,16406,12430,-3976
2015,12,30,18,15840,16265,12301,-3964
2015,12,30,19,15740,16188,12208,-3980
2015,12,30,20,15920,16124,12114,-4010
2015,12,30,21,16100,16190,12262,-3928
2015,12,30,22,17090,17068,13143,-3925
2015,12,30,23,17900,17654,13926,-3728
2015,12,31,0,17630,17423,13669,-3754
2015,12,31,1,17200,16924,13110,-3814
2015,12,31,2,16580,16298,12357,-3941
2015,12,31,3,15510,15302,11307,-3995
2015,12,31,4,14080,14032,9940,-4092
2015,12,31,5,12780,12980,9128,-3852
2015,12,31,6,11780,12671,9149,-3522
2015,12,31,7,11280,12395,8832,-3563
2015,12,31,8,11020,12078,8436,-3642
2015,12,31,9,11010,11957,8509,-3448
2015,12,31,10,11250,12156,8632,-3524
2015,12,31,11,11990,12525,9084,-3441
2015,12,31,12,13100,13152,9496,-3656
2015,12,31,13,14140,13893,10038,-3855
2015,12,31,14,14830,14480,10627,-3853
2015,12,31,15,15240,14695,10888,-3807
2015,12,31,16,14860,14613,10801,-3812
2015,12,31,17,14870,14499,10685,-3814
2015,12,31,18,14730,14335,10514,-3821
2015,12,31,19,14700,14292,10484,-3808
2015,12,31,20,14680,14310,10496,-3814
2015,12,31,21,14860,14607,10811,-3796
2015,12,31,22,15800,15725,11912,-3813
2015,12,31,23,16550,16512,12943,-3569
2016,1,1,0,16430,16063,12541,-3522
2016,1,1,1,16170,15273,11589,-3684
2016,1,1,2,15850,14568,10784,-3784
2016,1,1,3,15000,13850,10014,-3836
2016,1,1,4,13790,13108,9240,-3868
2016,1,1,5,12630,12737,9203,-3534
2016,1,1,6,11940,12503,8759,-3744
2016,1,1,7,11380,12241,8530,-3711
2016,1,1,8,10990,11824,8165,-3659
2016,1,1,9,10780,11616,7958,-3658
2016,1,1,10,10810,11626,7939,-3687
2016,1,1,11,10830,11902,8022,-3880
2016,1,1,12,11390,12104,8333,-3771
2016,1,1,13,11650,12263,8518,-3745
2016,1,1,14,12280,12711,9005,-3706
2016,1,1,15,12820,13135,9465,-3670
2016,1,1,16,13180,13314,9513,-3801
2016,1,1,17,13390,13603,9733,-3870
2016,1,1,18,13400,13810,10027,-3783
2016,1,1,19,13360,13920,10130,-3790
2016,1,1,20,13340,13961,10140,-3821
2016,1,1,21,13620,14180,10326,-3854
2016,1,1,22,14760,15128,11225,-3903
2016,1,1,23,15770,15895,12041,-3854
2016,1,2,0,15530,15695,11827,-3868
2016,1,2,1,15030,15279,11461,-3818
2016,1,2,2,14570,14820,10932,-3888
2016,1,2,3,13840,14180,10236,-3944
2016,1,2,4,13060,13331,9433,-3898
2016,1,2,5,12130,12600,8753,-3847
2016,1,2,6,11360,11845,7968,-3877
2016,1,2,7,10970,11783,7962,-3821
2016,1,2,8,10720,11450,7935,-3515
2016,1,2,9,10690,11558,8063,-3495
2016,1,2,10,10860,11739,8060,-3679
2016,1,2,11,11250,11928,8011,-3917
2016,1,2,12,11710,12100,8432,-3668
2016,1,2,13,12430,12681,8866,-3815
2016,1,2,14,13260,13511,9747,-3764
2016,1,2,15,13810,14037,10161,-3876
2016,1,2,16,13990,14168,10327,-3841
2016,1,2,17,14010,14120,10281,-3839
2016,1,2,18,13900,14039,10181,-3858
2016,1,2,19,13740,13921,10034,-3887
2016,1,2,20,13730,13979,10056,-3923
2016,1,2,21,13990,14037,10129,-3908
2016,1,2,22,15180,15114,11175,-3939
2016,1,2,23,16040,16176,12209,-3967
2016,1,3,0,15800,16083,12218,-3865
2016,1,3,1,15340,15677,11792,-3885
2016,1,3,2,14840,15216,11305,-3911
2016,1,3,3,14130,14544,10498,-4046
2016,1,3,4,13280,13619,9680,-3939
2016,1,3,5,12400,12648,8646,-4002
2016,1,3,6,11740,12261,8368,-3893
2016,1,3,7,11270,11928,8169,-3759
2016,1,3,8,11000,11811,8263,-3548
2016,1,3,9,10970,11711,8115,-3596
2016,1,3,10,10930,11752,8121,-3631
2016,1,3,11,11180,11880,8403,-3477
2016,1,3,12,11580,12242,8780,-3462
2016,1,3,13,12190,12896,9414,-3482
2016,1,3,14,12970,13307,9852,-3455
2016,1,3,15,13590,13517,9999,-3518
2016,1,3,16,13650,13657,10052,-3605
2016,1,3,17,13860,13682,9984,-3698
2016,1,3,18,13920,13721,10053,-3668
2016,1,3,19,13820,13702,10013,-3689
2016,1,3,20,13860,13744,10046,-3698
2016,1,3,21,14180,14011,10344,-3667
2016,1,3,22,15420,15217,11422,-3795
2016,1,3,23,16500,16455,12715,-3740
2016,1,4,0,16380,16393,12811,-3582
2016,1,4,1,15930,15976,12295,-3681
2016,1,4,2,15470,15408,11879,-3529
2016,1,4,3,14490,14417,10580,-3837
2016,1,4,4,13370,13261,9471,-3790
2016,1,4,5,12330,12194,8514,-3680
2016,1,4,6,11600,11764,8633,-3131
2016,1,4,7,11260,11433,8348,-3085
2016,1,4,8,11240,11317,8353,-2964
2016,1,4,9,11340,11421,8562,-2859
2016,1,4,10,11620,11854,8825,-3029
2016,1,4,11,12850,12872,9681,-3191
2016,1,4,12,14910,14764,11414,-3350
2016,1,4,13,16000,16004,12591,-3413
2016,1,4,14,16240,16275,12735,-3540
2016,1,4,15,16360,16392,12716,-3676
2016,1,4,16,16420,16437,12654,-3783
2016,1,4,17,16440,16434,12558,-3876
2016,1,4,18,16260,16425,12461,-3964
2016,1,4,19,16310,16471,12442,-4029
2016,1,4,20,16300,16487,12519,-3968
2016,1,4,21,16490,16795,12972,-3823
2016,1,4,22,17610,17834,13938,-3896
2016,1,4,23,19100,19077,15211,-3866
2016,1,5,0,18930,19142,15562,-3580
2016,1,5,1,18570,18775,14915,-3860
2016,1,5,2,17960,18229,14456,-3773
2016,1,5,3,16890,17152,13151,-4001
2016,1,5,4,15520,15800,11749,-4051
2016,1,5,5,14320,14594,10663,-3931
2016,1,5,6,13690,13867,9897,-3970
2016,1,5,7,13360,13500,9689,-3811
2016,1,5,8,13250,13387,9587,-3800
2016,1,5,9,13290,13456,9526,-3930
2016,1,5,10,13710,13897,9943,-3954
2016,1,5,11,14980,15008,11271,-3737
2016,1,5,12,16860,16938,13472,-3466
2016,1,5,13,17820,18019,14870,-3149
2016,1,5,14,17810,17971,14662,-3309
2016,1,5,15,17700,17678,14059,-3619
2016,1,5,16,17420,17439,13493,-3946
2016,1,5,17,17230,17147,13428,-3719
2016,1,5,18,16970,16846,13167,-3679
2016,1,5,19,16830,16729,12841,-3888
2016,1,5,20,16660,16684,12737,-3947
2016,1,5,21,17120,16949,13086,-3863
2016,1,5,22,18140,17924,14357,-3567
2016,1,5,23,19150,19197,15897,-3300
2016,1,6,0,19200,19221,15774,-3447
2016,1,6,1,18880,18885,15414,-3471
2016,1,6,2,18210,18286,14656,-3630
2016,1,6,3,17090,17174,13492,-3682
2016,1,6,4,15660,15748,12089,-3659
2016,1,6,5,14390,14699,11109,-3590
2016,1,6,6,13490,14009,10497,-3512
2016,1,6,7,13130,13640,10165,-3475
2016,1,6,8,12930,13432,9946,-3486
2016,1,6,9,12880,13746,10163,-3583
2016,1,6,10,13670,14220,10501,-3719
2016,1,6,11,14700,14836,11601,-3235
2016,1,6,12,16540,16543,13512,-3031
2016,1,6,13,17430,17586,14770,-2816
2016,1,6,14,17250,17449,14085,-3364
2016,1,6,15,16920,16991,13640,-3351
2016,1,6,16,16620,16550,13062,-3488
2016,1,6,17,16330,16161,12773,-3388
2016,1,6,18,15820,15758,12283,-3475
2016,1,6,19,15720,15810,12227,-3583
2016,1,6,20,15610,15640,12280,-3360
2016,1,6,21,15870,15855,12635,-3220
2016,1,6,22,16870,16866,13622,-3244
2016,1,6,23,18050,18212,15410,-2802
2016,1,7,0,18100,18224,15048,-3176
2016,1,7,1,17720,17860,14643,-3217
2016,1,7,2,17090,17243,13975,-3268
2016,1,7,3,16080,16161,12760,-3401
2016,1,7,4,14780,14792,11071,-3721
2016,1,7,5,13580,13820,10016,-3804
2016,1,7,6,12840,13172,9273,-3899
2016,1,7,7,12540,13159,9213,-3946
2016,1,7,8,12440,13094,9097,-3997
2016,1,7,9,12390,13144,9094,-4050
2016,1,7,10,12780,13541,9510,-4031
2016,1,7,11,13940,14326,10255,-4071
2016,1,7,12,15790,15785,11988,-3797
2016,1,7,13,16710,16878,13279,-3599
2016,1,7,14,16650,16727,12979,-3748
2016,1,7,15,16350,16322,12324,-3998
2016,1,7,16,16010,16134,12148,-3986
2016,1,7,17,15710,15655,11714,-3941
2016,1,7,18,15420,15350,11557,-3793
2016,1,7,19,15310,15517,11646,-3871
2016,1,7,20,15240,15508,11655,-3853
2016,1,7,21,15510,15737,12010,-3727
2016,1,7,22,16490,16426,12960,-3466
2016,1,7,23,17700,17754,14262,-3492
2016,1,8,0,17640,17830,14159,-3671
2016,1,8,1,17310,17490,13786,-3704
2016,1,8,2,16730,16917,13063,-3854
2016,1,8,3,15700,15918,12003,-3915
2016,1,8,4,14410,14589,10685,-3904
2016,1,8,5,13290,13624,9813,-3811
2016,1,8,6,12580,13034,9366,-3668
2016,1,8,7,12160,12815,9208,-3607
2016,1,8,8,11980,12894,9156,-3738
2016,1,8,9,11950,13108,9217,-3891
2016,1,8,10,12260,13390,9556,-3834
2016,1,8,11,13240,13589,10190,-3399
2016,1,8,12,14950,15283,11694,-3589
2016,1,8,13,15960,16357,12872,-3485
2016,1,8,14,16190,16359,12791,-3568
2016,1,8,15,16240,16225,12662,-3563
2016,1,8,16,16130,16148,12692,-3456
2016,1,8,17,16080,16012,12709,-3303
2016,1,8,18,15920,15810,12768,-3042
2016,1,8,19,15840,15739,12702,-3037
2016,1,8,20,15720,15700,12194,-3506
2016,1,8,21,15990,16058,12513,-3545
2016,1,8,22,16750,16562,12990,-3572
2016,1,8,23,17520,17176,13682,-3494
2016,1,9,0,17170,16899,13247,-3652
2016,1,9,1,16600,16356,12792,-3564
2016,1,9,2,15990,15742,12130,-3612
2016,1,9,3,15100,14899,11163,-3736
2016,1,9,4,13980,13841,10390,-3451
2016,1,9,5,12930,13163,9765,-3398
2016,1,9,6,12080,12677,8968,-3709
2016,1,9,7,11690,12403,8958,-3445
2016,1,9,8,11400,12106,8904,-3202
2016,1,9,9,11240,11982,8852,-3130
2016,1,9,10,10950,12062,9252,-2810
2016,1,9,11,11370,12426,9038,-3388
2016,1,9,12,12160,12671,9393,-3278
2016,1,9,13,13070,13435,9988,-3447
2016,1,9,14,14020,13865,10342,-3523
2016,1,9,15,14650,14465,10954,-3511
2016,1,9,16,14860,14727,11578,-3149
2016,1,9,17,14880,14707,11550,-3157
2016,1,9,18,14630,14541,11338,-3203
2016,1,9,19,14490,14356,11088,-3268
2016,1,9,20,14430,14196,10841,-3355
2016,1,9,21,14660,14286,10894,-3392
2016,1,9,22,15520,15085,11711,-3374
2016,1,9,23,16260,15886,12577,-3309
2016,1,10,0,16030,15699,12213,-3486
2016,1,10,1,15470,15192,11849,-3343
2016,1,10,2,14920,14678,11220,-3458
2016,1,10,3,14080,13960,10350,-3610
2016,1,10,4,13240,13230,9659,-3571
2016,1,10,5,12310,12661,9414,-3247
2016,1,10,6,11340,11832,9159,-2673
2016,1,10,7,10830,11323,8923,-2400
2016,1,10,8,10500,11268,8676,-2592
2016,1,10,9,10360,11124,8791,-2333
2016,1,10,10,10370,11218,8498,-2720
2016,1,10,11,10580,11161,8607,-2554
2016,1,10,12,11030,11361,8912,-2449
2016,1,10,13,11670,12011,9495,-2516
2016,1,10,14,12630,12702,9882,-2820
2016,1,10,15,13380,13591,10743,-2848
2016,1,10,16,13710,14232,11313,-2919
2016,1,10,17,13950,14617,11508,-3109
2016,1,10,18,14010,14783,11286,-3497
2016,1,10,19,14050,14688,11389,-3299
2016,1,10,20,14020,14600,11480,-3120
2016,1,10,21,14230,14649,11630,-3019
2016,1,10,22,15070,15252,12404,-2848
2016,1,10,23,15820,15855,12970,-2885
2016,1,11,0,15590,15606,12702,-2904
2016,1,11,1,15020,15021,11858,-3163
2016,1,11,2,14420,14302,11289,-3013
2016,1,11,3,13470,13327,10317,-3010
2016,1,11,4,12380,12465,9714,-2751
2016,1,11,5,11390,11930,9567,-2363
2016,1,11,6,10710,11644,9238,-2406
2016,1,11,7,10350,11385,9139,-2246
2016,1,11,8,10260,11325,9259,-2066
2016,1,11,9,10400,11433,9671,-1762
2016,1,11,10,10900,11784,9511,-2273
2016,1,11,11,12080,12204,10153,-2051
2016,1,11,12,14080,14177,11834,-2343
2016,1,11,13,15150,15400,12479,-2921
2016,1,11,14,15400,15455,12749,-2706
2016,1,11,15,15410,15273,12610,-2663
2016,1,11,16,15480,15242,12626,-2616
2016,1,11,17,15500,15175,12650,-2525
2016,1,11,18,15480,15110,12456,-2654
2016,1,11,19,15510,15201,12387,-2814
2016,1,11,20,15570,15291,12611,-2680
2016,1,11,21,15820,15656,12973,-2683
2016,1,11,22,16850,16645,14014,-2631
2016,1,11,23,18100,18030,15274,-2756
2016,1,12,0,18060,18101,15232,-2869
2016,1,12,1,17720,17719,14700,-3019
2016,1,12,2,17080,17080,14247,-2833
2016,1,12,3,16020,16017,12995,-3022
2016,1,12,4,14680,14663,11669,-2994
2016,1,12,5,13520,13478,10678,-2800
2016,1,12,6,12780,13326,10421,-2905
2016,1,12,7,12400,13439,10375,-3064
2016,1,12,8,12260,13274,10246,-3028
2016,1,12,9,12300,13291,10456,-2835
2016,1,12,10,12610,13647,10617,-3030
2016,1,12,11,13810,13968,11018,-2950
2016,1,12,12,15900,15764,12716,-3048
2016,1,12,13,16920,16843,13557,-3286
2016,1,12,14,16870,16713,13573,-3140
2016,1,12,15,16770,16358,13190,-3168
2016,1,12,16,16660,16131,12859,-3272
2016,1,12,17,16370,15957,12784,-3173
2016,1,12,18,16180,15856,12572,-3284
2016,1,12,19,16170,15981,12765,-3216
2016,1,12,20,16050,16028,12849,-3179
2016,1,12,21,16400,16208,13194,-3014
2016,1,12,22,17290,17065,14155,-2910
2016,1,12,23,18350,18100,14737,-3363
2016,1,13,0,18300,18046,14534,-3512
2016,1,13,1,17790,17529,14130,-3399
2016,1,13,2,17070,16799,13490,-3309
2016,1,13,3,15990,15649,12228,-3421
2016,1,13,4,14610,14327,11006,-3321
2016,1,13,5,13390,13384,10419,-2965
2016,1,13,6,12570,12869,10087,-2782
2016,1,13,7,12180,12805,9867,-2938
2016,1,13,8,12080,12738,9715,-3023
2016,1,13,9,12260,12848,9781,-3067
2016,1,13,10,12510,13230,10139,-3091
2016,1,13,11,13670,13985,10973,-3012
2016,1,13,12,15760,15602,12550,-3052
2016,1,13,13,16820,16683,13342,-3341
2016,1,13,14,16880,16763,13233,-3530
2016,1,13,15,16810,16704,13127,-3577
2016,1,13,16,16770,16686,13402,-3284
2016,1,13,17,16760,16554,13433,-3121
2016,1,13,18,16620,16338,13296,-3042
2016,1,13,19,16600,16268,13126,-3142
2016,1,13,20,16530,16249,13134,-3115
2016,1,13,21,16710,16504,13255,-3249
2016,1,13,22,17670,17460,14401,-3059
2016,1,13,23,19000,18806,15842,-2964
2016,1,14,0,18900,18827,15669,-3158
2016,1,14,1,18410,18432,15425,-3007
2016,1,14,2,17790,17793,14745,-3048
2016,1,14,3,16770,16710,13699,-3011
2016,1,14,4,15420,15305,12429,-2876
2016,1,14,5,14240,14054,11066,-2988
2016,1,14,6,13470,13511,10251,-3260
2016,1,14,7,13070,13152,10104,-3048
2016,1,14,8,12890,12990,9981,-3009
2016,1,14,9,12930,13017,9781,-3236
2016,1,14,10,13100,13576,10347,-3229
2016,1,14,11,14210,14283,11357,-2926
2016,1,14,12,16160,16083,13312,-2771
2016,1,14,13,17260,17249,14593,-2656
2016,1,14,14,17240,17357,14792,-2565
2016,1,14,15,17020,17237,14575,-2662
2016,1,14,16,16890,16842,13762,-3080
2016,1,14,17,16780,16417,13200,-3217
2016,1,14,18,16590,16096,13075,-3021
2016,1,14,19,16530,16030,13076,-2954
2016,1,14,20,16390,16020,13168,-2852
2016,1,14,21,16600,16300,13545,-2755
2016,1,14,22,17450,17134,14384,-2750
2016,1,14,23,18650,18369,15537,-2832
2016,1,15,0,18550,18357,15416,-2941
2016,1,15,1,17990,17938,14941,-2997
2016,1,15,2,17320,17314,13916,-3398
2016,1,15,3,16230,16267,12638,-3629
2016,1,15,4,14840,14909,11244,-3665
2016,1,15,5,13620,13683,10343,-3340
2016,1,15,6,12880,13326,10123,-3203
2016,1,15,7,12420,13168,9800,-3368
2016,1,15,8,12220,12993,9823,-3170
2016,1,15,9,12180,12981,9983,-2998
2016,1,15,10,12510,13052,10151,-2901
2016,1,15,11,13530,13795,10754,-3041
2016,1,15,12,15400,15376,12150,-3226
2016,1,15,13,16450,16488,13252,-3236
2016,1,15,14,16540,16645,13498,-3147
2016,1,15,15,16480,16574,13302,-3272
2016,1,15,16,16340,16338,13005,-3333
2016,1,15,17,16200,16032,12569,-3463
2016,1,15,18,15920,15843,12472,-3371
2016,1,15,19,15850,15659,12456,-3203
2016,1,15,20,15760,15532,12437,-3095
2016,1,15,21,15870,15589,12504,-3085
2016,1,15,22,16620,16252,13020,-3232
2016,1,15,23,17500,17035,13943,-3092
2016,1,16,0,17090,16781,13654,-3127
2016,1,16,1,16540,16269,13357,-2912
2016,1,16,2,15890,15670,12667,-3003
2016,1,16,3,15010,14837,11658,-3179
2016,1,16,4,13910,13755,10671,-3084
2016,1,16,5,12840,12681,10031,-2650
2016,1,16,6,12030,12344,9582,-2762
2016,1,16,7,11530,11831,9358,-2473
2016,1,16,8,11270,11536,8966,-2570
2016,1,16,9,11180,11681,9203,-2478
2016,1,16,10,11280,11828,9327,-2501
2016,1,16,11,11460,12214,9463,-2751
2016,1,16,12,12260,12416,9580,-2836
2016,1,16,13,13100,13030,10147,-2883
2016,1,16,14,14180,14013,11103,-2910
2016,1,16,15,14700,14832,12167,-2665
2016,1,16,16,14750,15243,12524,-2719
2016,1,16,17,14760,15226,12214,-3012
2016,1,16,18,14620,14971,11888,-3083
2016,1,16,19,14430,14705,11878,-2827
2016,1,16,20,14310,14523,11844,-2679
2016,1,16,21,14450,14497,11776,-2721
2016,1,16,22,15290,15090,12344,-2746
2016,1,16,23,16350,15829,13199,-2630
2016,1,17,0,16000,15691,12887,-2804
2016,1,17,1,15540,15078,12266,-2812
2016,1,17,2,14850,14774,12001,-2773
2016,1,17,3,14190,14060,11093,-2967
2016,1,17,4,13310,13165,10218,-2947
2016,1,17,5,12420,12314,9412,-2902
2016,1,17,6,11790,12384,9198,-3186
2016,1,17,7,11360,12115,9127,-2988
2016,1,17,8,11130,11876,8957,-2919
2016,1,17,9,11100,11807,8923,-2884
2016,1,17,10,10880,11892,9032,-2860
2016,1,17,11,11190,12219,9360,-2859
2016,1,17,12,11760,12572,9726,-2846
2016,1,17,13,12450,12924,10027,-2897
2016,1,17,14,13330,13298,10351,-2947
2016,1,17,15,14000,13716,10905,-2811
2016,1,17,16,14270,14217,11434,-2783
2016,1,17,17,14420,14514,11782,-2732
2016,1,17,18,14420,14706,11885,-2821
2016,1,17,19,14390,14744,11705,-3039
2016,1,17,20,14420,14757,11658,-3099
2016,1,17,21,14750,14954,11859,-3095
2016,1,17,22,15690,15755,12777,-2978
2016,1,17,23,16850,16590,13784,-2806
2016,1,18,0,16760,16485,13480,-3005
2016,1,18,1,16140,15969,12870,-3099
2016,1,18,2,15620,15492,12365,-3127
2016,1,18,3,14590,14668,11341,-3327
2016,1,18,4,13470,13707,10174,-3533
2016,1,18,5,12490,12733,9561,-3172
2016,1,18,6,12040,12451,9090,-3361
2016,1,18,7,11630,12454,8936,-3518
2016,1,18,8,11480,12320,8923,-3397
2016,1,18,9,11500,12580,9179,-3401
2016,1,18,10,11870,12912,9603,-3309
2016,1,18,11,12740,13265,10224,-3041
2016,1,18,12,14100,14041,11426,-2615
2016,1,18,13,15130,15048,12632,-2416
2016,1,18,14,15830,15858,13414,-2444
2016,1,18,15,16300,16339,13683,-2656
2016,1,18,16,16570,16590,14309,-2281
2016,1,18,17,16620,16642,14331,-2311
2016,1,18,18,16600,16522,14229,-2293
2016,1,18,19,16600,16553,14177,-2376
2016,1,18,20,16570,16539,14047,-2492
2016,1,18,21,16570,16722,14576,-2146
2016,1,18,22,17530,17548,15596,-1952
2016,1,18,23,18750,18887,17119,-1768
2016,1,19,0,18660,18875,17206,-1669
2016,1,19,1,18150,18519,16731,-1788
2016,1,19,2,17580,17870,16209,-1661
2016,1,19,3,16480,16755,14563,-2192
2016,1,19,4,15160,15421,13144,-2277
2016,1,19,5,14040,14414,11956,-2458
2016,1,19,6,13520,14136,11336,-2800
2016,1,19,7,13150,14085,11203,-2882
2016,1,19,8,13050,13886,11255,-2631
2016,1,19,9,13110,13949,11332,-2617
2016,1,19,10,13540,14305,11743,-2562
2016,1,19,11,14610,14773,12425,-2348
2016,1,19,12,16410,16718,14619,-2099
2016,1,19,13,17440,17772,15756,-2016
2016,1,19,14,17680,17749,15603,-2146
2016,1,19,15,17540,17623,15465,-2158
2016,1,19,16,17430,17571,15390,-2181
2016,1,19,17,17430,17510,15190,-2320
2016,1,19,18,17260,17372,15313,-2059
2016,1,19,19,17210,17359,15340,-2019
2016,1,19,20,17140,17391,15236,-2155
2016,1,19,21,17410,17528,15429,-2099
2016,1,19,22,18160,18170,16263,-1907
2016,1,19,23,19350,19383,17398,-1985
2016,1,20,0,19340,19443,17413,-2030
2016,1,20,1,18870,19039,17031,-2008
2016,1,20,2,18140,18388,16367,-2021
2016,1,20,3,17000,17224,15080,-2144
2016,1,20,4,15580,15769,13315,-2454
2016,1,20,5,14400,14510,11982,-2528
2016,1,20,6,13750,13986,11878,-2108
2016,1,20,7,13220,13833,11555,-2278
2016,1,20,8,13060,13687,11292,-2395
2016,1,20,9,13130,13692,11161,-2531
2016,1,20,10,13440,13990,11609,-2381
2016,1,20,11,14590,14590,12381,-2209
2016,1,20,12,16650,16462,14279,-2183
2016,1,20,13,17650,17508,15332,-2176
2016,1,20,14,17600,17416,15462,-1954
2016,1,20,15,17340,17095,15211,-1884
2016,1,20,16,17080,16799,14592,-2207
2016,1,20,17,16850,16477,14079,-2398
2016,1,20,18,16650,16170,13702,-2468
2016,1,20,19,16560,16090,13479,-2611
2016,1,20,20,16470,16314,13674,-2640
2016,1,20,21,16610,16524,13947,-2577
2016,1,20,22,17380,17259,14745,-2514
2016,1,20,23,18620,18539,16004,-2535
2016,1,21,0,18750,18606,16318,-2288
2016,1,21,1,18330,18191,15935,-2256
2016,1,21,2,17700,17561,15114,-2447
2016,1,21,3,16640,16453,13695,-2758
2016,1,21,4,15250,15026,12037,-2989
2016,1,21,5,14030,13818,10871,-2947
2016,1,21,6,13270,13367,10580,-2787
2016,1,21,7,12710,13248,10575,-2673
2016,1,21,8,12670,13349,10560,-2789
2016,1,21,9,12750,13500,10668,-2832
2016,1,21,10,13200,13813,11025,-2788
2016,1,21,11,14200,14535,11912,-2623
2016,1,21,12,16190,16099,13389,-2710
2016,1,21,13,17110,17157,14709,-2448
2016,1,21,14,17120,17001,14642,-2359
2016,1,21,15,16900,16606,13881,-2725
2016,1,21,16,16700,16311,13498,-2813
2016,1,21,17,16430,16079,13486,-2593
2016,1,21,18,16210,16044,13412,-2632
2016,1,21,19,16180,16227,13553,-2674
2016,1,21,20,16040,16255,13648,-2607
2016,1,21,21,16190,16541,13888,-2653
2016,1,21,22,17100,16937,14561,-2376
2016,1,21,23,18410,18309,15865,-2444
2016,1,22,0,18700,18460,15682,-2778
2016,1,22,1,18300,18124,15327,-2797
2016,1,22,2,17770,17534,14549,-2985
2016,1,22,3,16780,16530,13735,-2795
2016,1,22,4,15420,15213,12080,-3133
2016,1,22,5,14250,14124,10890,-3234
2016,1,22,6,13490,13772,10497,-3275
2016,1,22,7,13090,13814,10288,-3526
2016,1,22,8,12940,13697,10201,-3496
2016,1,22,9,13020,13767,10386,-3381
2016,1,22,10,13380,14147,10749,-3398
2016,1,22,11,14500,14769,11550,-3219
2016,1,22,12,16410,16285,13395,-2890
2016,1,22,13,17380,17322,14334,-2988
2016,1,22,14,17220,17199,14323,-2876
2016,1,22,15,16960,16825,14147,-2678
2016,1,22,16,16660,16442,13696,-2746
2016,1,22,17,16340,16262,13496,-2766
2016,1,22,18,16070,16048,13386,-2662
2016,1,22,19,15970,16023,13558,-2465
2016,1,22,20,15910,16186,13747,-2439
2016,1,22,21,16190,16420,13809,-2611
2016,1,22,22,17010,17086,14371,-2715
2016,1,22,23,18150,18029,15145,-2884
2016,1,23,0,18120,17883,14884,-2999
2016,1,23,1,17640,17379,14375,-3004
2016,1,23,2,17050,16820,13748,-3072
2016,1,23,3,16220,16011,13043,-2968
2016,1,23,4,15140,14962,11939,-3023
2016,1,23,5,14090,13867,10843,-3024
2016,1,23,6,13310,13346,10183,-3163
2016,1,23,7,12860,13232,10006,-3226
2016,1,23,8,12680,13437,9961,-3476
2016,1,23,9,12630,13363,9840,-3523
2016,1,23,10,12760,13425,9817,-3608
2016,1,23,11,12690,13746,10182,-3564
2016,1,23,12,13430,13804,10837,-2967
2016,1,23,13,14300,14362,11473,-2889
2016,1,23,14,15250,15351,12343,-3008
2016,1,23,15,15970,16142,12905,-3237
2016,1,23,16,16370,16543,13448,-3095
2016,1,23,17,16370,16728,13449,-3279
2016,1,23,18,16210,16760,13706,-3054
2016,1,23,19,16460,16628,13398,-3230
2016,1,23,20,16440,16513,13253,-3260
2016,1,23,21,16620,16550,13444,-3106
2016,1,23,22,16960,17092,14111,-2981
2016,1,23,23,17900,17968,15220,-2748
2016,1,24,0,17740,17813,15013,-2800
2016,1,24,1,17080,17252,14356,-2896
2016,1,24,2,16530,16609,13687,-2922
2016,1,24,3,15840,15772,12950,-2822
2016,1,24,4,14860,14774,11942,-2832
2016,1,24,5,13930,13807,10791,-3016
2016,1,24,6,13070,13305,10308,-2997
2016,1,24,7,12630,13054,10202,-2852
2016,1,24,8,12420,13128,10122,-3006
2016,1,24,9,12360,13330,10154,-3176
2016,1,24,10,12370,13447,10171,-3276
2016,1,24,11,12690,13467,10368,-3099
2016,1,24,12,13340,13549,10639,-2910
2016,1,24,13,14020,13887,11034,-2853
2016,1,24,14,14400,14588,11464,-3124
2016,1,24,15,14750,15002,11828,-3174
2016,1,24,16,14740,15108,11898,-3210
2016,1,24,17,14820,15065,11770,-3295
2016,1,24,18,14750,14926,11657,-3269
2016,1,24,19,14690,14752,11329,-3423
2016,1,24,20,14710,14749,11388,-3361
2016,1,24,21,15120,14891,11606,-3285
2016,1,24,22,16010,15524,12404,-3120
2016,1,24,23,17500,16819,13873,-2946
2016,1,25,0,17490,16708,13820,-2888
2016,1,25,1,16930,16669,13874,-2795
2016,1,25,2,16340,16042,13220,-2822
2016,1,25,3,15340,15054,12237,-2817
2016,1,25,4,14240,13887,10834,-3053
2016,1,25,5,13220,13104,9693,-3411
2016,1,25,6,12470,12967,9639,-3328
2016,1,25,7,12130,12920,9628,-3292
2016,1,25,8,12010,12852,9143,-3709
2016,1,25,9,12090,12867,8943,-3924
2016,1,25,10,12520,12958,9137,-3821
2016,1,25,11,13540,14011,10023,-3988
2016,1,25,12,15590,15469,11632,-3837
2016,1,25,13,16670,16558,12989,-3569
2016,1,25,14,16590,16514,13054,-3460
2016,1,25,15,16320,16186,12926,-3260
2016,1,25,16,16070,15935,12625,-3310
2016,1,25,17,15880,15639,12375,-3264
2016,1,25,18,15660,15334,12118,-3216
2016,1,25,19,15640,15207,11921,-3286
2016,1,25,20,15680,15216,11953,-3263
2016,1,25,21,15800,15478,12180,-3298
2016,1,25,22,16690,16224,12914,-3310
2016,1,25,23,17990,17680,14305,-3375
2016,1,26,0,18080,17827,14539,-3288
2016,1,26,1,17670,17396,14116,-3280
2016,1,26,2,17000,16722,13407,-3315
2016,1,26,3,15880,15652,12319,-3333
2016,1,26,4,14450,14315,10846,-3469
2016,1,26,5,13220,13231,9636,-3595
2016,1,26,6,12490,13137,9518,-3619
2016,1,26,7,12010,13104,9511,-3593
2016,1,26,8,11760,12927,9485,-3442
2016,1,26,9,11780,12931,9433,-3498
2016,1,26,10,12210,13311,9790,-3521
2016,1,26,11,13290,14107,10704,-3403
2016,1,26,12,15180,15256,12150,-3106
2016,1,26,13,16180,16181,13065,-3116
2016,1,26,14,16200,16106,12980,-3126
2016,1,26,15,16090,15961,12944,-3017
2016,1,26,16,15960,15854,12805,-3049
2016,1,26,17,15920,15664,12451,-3213
2016,1,26,18,15720,15371,12211,-3160
2016,1,26,19,15670,15181,12043,-3138
2016,1,26,20,15660,15061,11927,-3134
2016,1,26,21,15830,15247,12079,-3168
2016,1,26,22,16580,15994,12626,-3368
2016,1,26,23,17650,17157,13674,-3483
2016,1,27,0,17500,17138,13724,-3414
2016,1,27,1,16940,16665,13465,-3200
2016,1,27,2,16200,15982,12737,-3245
2016,1,27,3,15060,14915,11756,-3159
2016,1,27,4,13720,13652,10498,-3154
2016,1,27,5,12540,12889,9537,-3352
2016,1,27,6,11730,12649,9110,-3539
2016,1,27,7,11290,12224,8703,-3521
2016,1,27,8,11100,11801,8764,-3037
2016,1,27,9,11120,11775,8579,-3196
2016,1,27,10,11520,12112,8807,-3305
2016,1,27,11,12420,12993,9657,-3336
2016,1,27,12,14350,14338,11220,-3118
2016,1,27,13,15400,15407,11984,-3423
2016,1,27,14,15570,15519,12084,-3435
2016,1,27,15,15550,15473,12028,-3445
2016,1,27,16,15540,15416,11999,-3417
2016,1,27,17,15330,15183,11772,-3411
2016,1,27,18,15160,14859,11553,-3306
2016,1,27,19,15090,14800,11617,-3183
2016,1,27,20,15100,14849,11639,-3210
2016,1,27,21,15310,15051,11777,-3274
2016,1,27,22,16120,15741,12204,-3537
2016,1,27,23,17320,17055,13537,-3518
2016,1,28,0,17410,17257,13808,-3449
2016,1,28,1,16850,16947,13511,-3436
2016,1,28,2,16300,16384,13000,-3384
2016,1,28,3,15270,15395,11845,-3550
2016,1,28,4,13960,14086,10502,-3584
2016,1,28,5,12850,12951,9535,-3416
2016,1,28,6,12150,12428,8791,-3637
2016,1,28,7,11700,12468,8847,-3621
2016,1,28,8,11570,12143,8546,-3597
2016,1,28,9,11650,12195,8476,-3719
2016,1,28,10,12240,12619,8796,-3823
2016,1,28,11,13400,13491,9926,-3565
2016,1,28,12,15340,15505,12141,-3364
2016,1,28,13,16230,16526,12851,-3675
2016,1,28,14,15980,16294,12781,-3513
2016,1,28,15,15630,15823,12231,-3592
2016,1,28,16,15410,15425,12209,-3216
2016,1,28,17,15160,15089,11807,-3282
2016,1,28,18,14920,14850,11560,-3290
2016,1,28,19,14910,14834,11647,-3187
2016,1,28,20,14980,14772,11548,-3224
2016,1,28,21,15270,15076,11656,-3420
2016,1,28,22,16160,15807,12187,-3620
2016,1,28,23,17300,17130,13423,-3707
2016,1,29,0,17310,17319,13720,-3599
2016,1,29,1,16860,16919,13064,-3855
2016,1,29,2,16290,16332,12800,-3532
2016,1,29,3,15270,15314,11741,-3573
2016,1,29,4,13930,14000,10346,-3654
2016,1,29,5,12770,12827,9046,-3781
2016,1,29,6,12080,12148,8655,-3493
2016,1,29,7,11690,12133,8513,-3620
2016,1,29,8,11390,11933,8183,-3750
2016,1,29,9,11390,11927,8241,-3686
2016,1,29,10,11780,12516,8781,-3735
2016,1,29,11,12820,13270,9667,-3603
2016,1,29,12,14670,14605,11386,-3219
2016,1,29,13,15740,15729,12651,-3078
2016,1,29,14,15850,15832,12815,-3017
2016,1,29,15,15820,15729,12846,-2883
2016,1,29,16,15720,15637,12862,-2775
2016,1,29,17,15690,15423,12344,-3079
2016,1,29,18,15560,15372,12388,-2984
2016,1,29,19,15520,15438,12581,-2857
2016,1,29,20,15470,15304,12359,-2945
2016,1,29,21,15610,15306,12233,-3073
2016,1,29,22,16220,15791,12740,-3051
2016,1,29,23,17120,16714,13554,-3160
2016,1,30,0,16940,16685,13689,-2996
2016,1,30,1,16380,16238,13593,-2645
2016,1,30,2,15770,15696,13152,-2544
2016,1,30,3,14940,14925,12005,-2920
2016,1,30,4,13920,13873,10871,-3002
2016,1,30,5,12900,12826,10212,-2614
2016,1,30,6,12110,12461,9388,-3073
2016,1,30,7,11670,12316,9202,-3114
2016,1,30,8,11460,12228,9134,-3094
2016,1,30,9,11410,12169,9141,-3028
2016,1,30,10,11520,12296,9316,-2980
2016,1,30,11,12020,12735,9672,-3063
2016,1,30,12,12830,13282,10209,-3073
2016,1,30,13,13630,13734,10766,-2968
2016,1,30,14,14240,14098,11102,-2996
2016,1,30,15,14360,14282,11290,-2992
2016,1,30,16,14280,14366,11467,-2899
2016,1,30,17,14110,14210,11360,-2850
2016,1,30,18,14050,13958,10961,-2997
2016,1,30,19,13920,13640,10851,-2789
2016,1,30,20,13880,13556,10656,-2900
2016,1,30,21,14190,13888,10942,-2946
2016,1,30,22,14950,14407,11360,-3047
2016,1,30,23,16090,15606,12705,-2901
2016,1,31,0,16250,15741,12910,-2831
2016,1,31,1,15580,15326,12519,-2807
2016,1,31,2,15090,14942,12330,-2612
2016,1,31,3,14380,14438,11525,-2913
2016,1,31,4,13500,13317,10486,-2831
2016,1,31,5,12590,12671,9689,-2982
2016,1,31,6,11830,12147,9123,-3024
2016,1,31,7,11360,11909,8779,-3130
2016,1,31,8,11110,11773,8791,-2982
2016,1,31,9,11000,11490,8669,-2821
2016,1,31,10,11080,11520,8645,-2875
2016,1,31,11,11120,11784,9025,-2759
2016,1,31,12,11680,12064,9052,-3012
2016,1,31,13,12330,12340,9421,-2919
2016,1,31,14,12990,12828,10138,-2690
2016,1,31,15,13440,13266,10469,-2797
2016,1,31,16,13640,13245,10491,-2754
2016,1,31,17,13620,13117,10401,-2716
2016,1,31,18,13650,13014,10474,-2540
2016,1,31,19,13650,12952,10394,-2558
2016,1,31,20,13650,12871,10215,-2656
2016,1,31,21,13820,13090,10484,-2606
2016,1,31,22,14620,13777,10942,-2835
2016,1,31,23,15800,15188,12168,-3020
2016,2,1,0,15790,15475,12486,-2989
2016,2,1,1,15320,15064,12014,-3050
2016,2,1,2,14800,14467,11539,-2928
2016,2,1,3,13730,13549,10434,-3115
2016,2,1,4,12650,12476,9536,-2940
2016,2,1,5,11650,11679,9478,-2201
2016,2,1,6,10770,11317,9062,-2255
2016,2,1,7,10390,11402,9260,-2142
2016,2,1,8,10240,11269,9300,-1969
2016,2,1,9,10330,11317,9267,-2050
2016,2,1,10,10760,11445,9498,-1947
2016,2,1,11,12050,12276,10155,-2121
2016,2,1,12,14090,13732,11054,-2678
2016,2,1,13,14870,14710,11454,-3256
2016,2,1,14,14930,14672,11661,-3011
2016,2,1,15,14690,14446,11753,-2693
2016,2,1,16,14580,14280,11662,-2618
2016,2,1,17,14510,14254,11691,-2563
2016,2,1,18,14360,14238,11673,-2565
2016,2,1,19,14360,14180,11620,-2560
2016,2,1,20,14370,14164,11736,-2428
2016,2,1,21,14600,14327,11823,-2504
2016,2,1,22,15300,14980,11982,-2998
2016,2,1,23,16620,16201,13215,-2986
2016,2,2,0,16650,16314,13503,-2811
2016,2,2,1,16200,15890,13276,-2614
2016,2,2,2,15560,15238,12714,-2524
2016,2,2,3,14510,14209,11305,-2904
2016,2,2,4,13200,12915,9949,-2966
2016,2,2,5,12080,11898,9450,-2448
2016,2,2,6,11280,11356,9588,-1768
2016,2,2,7,10940,11177,9417,-1760
2016,2,2,8,10800,11118,9336,-1782
2016,2,2,9,10870,10963,9417,-1546
2016,2,2,10,11270,11268,9570,-1698
2016,2,2,11,12230,12232,10337,-1895
2016,2,2,12,14170,14252,12158,-2094
2016,2,2,13,15040,15226,12855,-2371
2016,2,2,14,15070,15041,12850,-2191
2016,2,2,15,14750,14650,12533,-2117
2016,2,2,16,14480,14363,12096,-2267
2016,2,2,17,14220,14115,11802,-2313
2016,2,2,18,14110,13867,11432,-2435
2016,2,2,19,14010,13825,11400,-2425
2016,2,2,20,14070,13794,11367,-2427
2016,2,2,21,14230,14018,11573,-2445
2016,2,2,22,15000,14735,12155,-2580
2016,2,2,23,16300,16111,13025,-3086
2016,2,3,0,16700,16505,13583,-2922
2016,2,3,1,16140,16183,13564,-2619
2016,2,3,2,15700,15634,12957,-2677
2016,2,3,3,14650,14616,11886,-2730
2016,2,3,4,13370,13315,10939,-2376
2016,2,3,5,12260,12198,9896,-2302
2016,2,3,6,11400,11720,9425,-2295
2016,2,3,7,11020,11557,9287,-2270
2016,2,3,8,10800,11409,9401,-2008
2016,2,3,9,10810,11430,9475,-1955
2016,2,3,10,11160,11802,10010,-1792
2016,2,3,11,12360,12595,11039,-1556
2016,2,3,12,14300,14241,12245,-1996
2016,2,3,13,15310,15308,12975,-2333
2016,2,3,14,15440,15522,13270,-2252
2016,2,3,15,15430,15668,13523,-2145
2016,2,3,16,15470,15818,13525,-2293
2016,2,3,17,15530,15801,13782,-2019
2016,2,3,18,15300,15699,13488,-2211
2016,2,3,19,15240,15666,13106,-2560
2016,2,3,20,15110,15516,13035,-2481
2016,2,3,21,15170,15537,13313,-2224
2016,2,3,22,15720,15962,13743,-2219
2016,2,3,23,16570,16704,13920,-2784
2016,2,4,0,16520,16594,13577,-3017
2016,2,4,1,16020,16032,13198,-2834
2016,2,4,2,15240,15260,12658,-2602
2016,2,4,3,14120,14137,11774,-2363
2016,2,4,4,12710,12761,10650,-2111
2016,2,4,5,11540,11827,9618,-2209
2016,2,4,6,10830,11468,9484,-1984
2016,2,4,7,10410,11389,9628,-1761
2016,2,4,8,10210,11127,9304,-1823
2016,2,4,9,10200,11079,9253,-1826
2016,2,4,10,10510,11375,9460,-1915
2016,2,4,11,11390,12323,10358,-1965
2016,2,4,12,13260,13257,10889,-2368
2016,2,4,13,14360,14299,11817,-2482
2016,2,4,14,14530,14533,12197,-2336
2016,2,4,15,14470,14612,12407,-2205
2016,2,4,16,14470,14624,12340,-2284
2016,2,4,17,14390,14473,12182,-2291
2016,2,4,18,14120,14240,11707,-2533
2016,2,4,19,14090,14223,11872,-2351
2016,2,4,20,14050,14225,11851,-2374
2016,2,4,21,14170,14337,11969,-2368
2016,2,4,22,14770,14849,12537,-2312
2016,2,4,23,15940,15922,13414,-2508
2016,2,5,0,15940,16065,13355,-2710
2016,2,5,1,15740,15704,12922,-2782
2016,2,5,2,15230,15124,12685,-2439
2016,2,5,3,14240,14165,11894,-2271
2016,2,5,4,13020,12924,10801,-2123
2016,2,5,5,11980,12257,10199,-2058
2016,2,5,6,11160,11885,9582,-2303
2016,2,5,7,10770,11773,9363,-2410
2016,2,5,8,10600,11637,9318,-2319
2016,2,5,9,10650,11655,9597,-2058
2016,2,5,10,11030,12000,9997,-2003
2016,2,5,11,12100,12707,10644,-2063
2016,2,5,12,14030,13657,11230,-2427
2016,2,5,13,15120,14868,12540,-2328
2016,2,5,14,15430,15595,13525,-2070
2016,2,5,15,15550,16194,14021,-2173
2016,2,5,16,15520,16617,14202,-2415
2016,2,5,17,15400,16770,13950,-2820
2016,2,5,18,15280,16639,13694,-2945
2016,2,5,19,15190,16421,13631,-2790
2016,2,5,20,15120,15991,13124,-2867
2016,2,5,21,15080,15674,12684,-2990
2016,2,5,22,15610,15887,13128,-2759
2016,2,5,23,16400,16825,13975,-2850
2016,2,6,0,16560,17098,14199,-2899
2016,2,6,1,16150,16616,14070,-2546
2016,2,6,2,15720,16042,13501,-2541
2016,2,6,3,14990,15235,12882,-2353
2016,2,6,4,14030,14190,11845,-2345
2016,2,6,5,13010,13180,10779,-2401
2016,2,6,6,12370,12899,9975,-2924
2016,2,6,7,12050,12594,9676,-2918
2016,2,6,8,11710,12409,9342,-3067
2016,2,6,9,11730,12374,9382,-2992
2016,2,6,10,11900,12644,9540,-3104
2016,2,6,11,12460,12634,9735,-2899
2016,2,6,12,13170,13445,10469,-2976
2016,2,6,13,13750,14165,11054,-3111
2016,2,6,14,14270,14661,11657,-3004
2016,2,6,15,14550,15016,12008,-3008
2016,2,6,16,14520,15022,12066,-2956
2016,2,6,17,14210,14776,11791,-2985
2016,2,6,18,13950,14423,11372,-3051
2016,2,6,19,13770,14114,10952,-3162
2016,2,6,20,13600,13905,10902,-3003
2016,2,6,21,13740,14004,11207,-2797
2016,2,6,22,14450,14508,11774,-2734
2016,2,6,23,15620,15732,12863,-2869
2016,2,7,0,16140,16073,13372,-2701
2016,2,7,1,15700,15669,12946,-2723
2016,2,7,2,15170,15204,12462,-2742
2016,2,7,3,14360,14552,11810,-2742
2016,2,7,4,13460,13719,10965,-2754
2016,2,7,5,12570,12811,9810,-3001
2016,2,7,6,11940,12511,9025,-3486
2016,2,7,7,11470,12176,8853,-3323
2016,2,7,8,11230,12185,8820,-3365
2016,2,7,9,11140,12099,8715,-3384
2016,2,7,10,11190,12305,8957,-3348
2016,2,7,11,11710,12773,9505,-3268
2016,2,7,12,12210,13273,10043,-3230
2016,2,7,13,12560,13264,10138,-3126
2016,2,7,14,13090,13755,10815,-2940
2016,2,7,15,13410,13872,10610,-3262
2016,2,7,16,13420,13842,10436,-3406
2016,2,7,17,13430,13752,10430,-3322
2016,2,7,18,13390,13629,10262,-3367
2016,2,7,19,13240,13473,10162,-3311
2016,2,7,20,13260,13418,10295,-3123
2016,2,7,21,13590,13699,10576,-3123
2016,2,7,22,14500,14445,11532,-2913
2016,2,7,23,15740,15844,12805,-3039
2016,2,8,0,16200,15995,12934,-3061
2016,2,8,1,15750,15265,12258,-3007
2016,2,8,2,15120,14755,11750,-3005
2016,2,8,3,14170,14109,11038,-3071
2016,2,8,4,13090,13278,10261,-3017
2016,2,8,5,12140,12433,9470,-2963
2016,2,8,6,11570,12321,9089,-3232
2016,2,8,7,11200,12222,9149,-3073
2016,2,8,8,11050,12095,8946,-3149
2016,2,8,9,11170,12177,9307,-2870
2016,2,8,10,11530,12633,9142,-3491
2016,2,8,11,12700,13341,9902,-3439
2016,2,8,12,14510,14357,11127,-3230
2016,2,8,13,15720,15490,12103,-3387
2016,2,8,14,16130,16158,12855,-3303
2016,2,8,15,16420,16723,13282,-3441
2016,2,8,16,16620,17171,13715,-3456
2016,2,8,17,16740,17458,13920,-3538
2016,2,8,18,16740,17531,13927,-3604
2016,2,8,19,16730,17460,13765,-3695
2016,2,8,20,16660,17218,13623,-3595
2016,2,8,21,16770,17079,13384,-3695
2016,2,8,22,17170,17418,13664,-3754
2016,2,8,23,18100,18536,14698,-3838
2016,2,9,0,18300,18651,14819,-3832
2016,2,9,1,17880,18066,14302,-3764
2016,2,9,2,17180,17250,13374,-3876
2016,2,9,3,16050,16144,12293,-3851
2016,2,9,4,14630,15047,11183,-3864
2016,2,9,5,13440,13911,10363,-3548
2016,2,9,6,12830,13377,9680,-3697
2016,2,9,7,12410,13284,9576,-3708
2016,2,9,8,12230,13188,9655,-3533
2016,2,9,9,12250,13224,9704,-3520
2016,2,9,10,12620,13535,10015,-3520
2016,2,9,11,13780,14094,10637,-3457
2016,2,9,12,15540,15554,12299,-3255
2016,2,9,13,16530,16526,13108,-3418
2016,2,9,14,16700,16867,13534,-3333
2016,2,9,15,16710,16900,13679,-3221
2016,2,9,16,16700,16806,13582,-3224
2016,2,9,17,16560,16679,13352,-3327
2016,2,9,18,16360,16465,13106,-3359
2016,2,9,19,16230,16334,12906,-3428
2016,2,9,20,16000,16109,12758,-3351
2016,2,9,21,16020,16053,12766,-3287
2016,2,9,22,16640,16486,13366,-3120
2016,2,9,23,17830,17674,14244,-3430
2016,2,10,0,18150,18036,14631,-3405
2016,2,10,1,17650,17676,14356,-3320
2016,2,10,2,16960,17060,13710,-3350
2016,2,10,3,16000,16016,12548,-3468
2016,2,10,4,14640,14691,11213,-3478
2016,2,10,5,13480,13855,10444,-3411
2016,2,10,6,12710,13755,9955,-3800
2016,2,10,7,12340,13208,9501,-3707
2016,2,10,8,12160,13032,9238,-3794
2016,2,10,9,12160,13067,9319,-3748
2016,2,10,10,12620,13399,9606,-3793
2016,2,10,11,13680,14192,10414,-3778
2016,2,10,12,15540,15500,11870,-3630
2016,2,10,13,16460,16467,12679,-3788
2016,2,10,14,16600,16589,12960,-3629
2016,2,10,15,16530,16556,13008,-3548
2016,2,10,16,16390,16434,12867,-3567
2016,2,10,17,16230,16161,12543,-3618
2016,2,10,18,15990,15932,12317,-3615
2016,2,10,19,15870,16163,12681,-3482
2016,2,10,20,15690,16176,12623,-3553
2016,2,10,21,15770,16195,12471,-3724
2016,2,10,22,16360,16292,12561,-3731
2016,2,10,23,17610,17353,13500,-3853
2016,2,11,0,18000,17705,13995,-3710
2016,2,11,1,17470,17331,13613,-3718
2016,2,11,2,16750,16773,13096,-3677
2016,2,11,3,15690,15773,11939,-3834
2016,2,11,4,14370,14704,10777,-3927
2016,2,11,5,13210,14024,10093,-3931
2016,2,11,6,12450,13639,9693,-3946
2016,2,11,7,12120,13249,9545,-3704
2016,2,11,8,11970,13071,9242,-3829
2016,2,11,9,12050,13118,9324,-3794
2016,2,11,10,12490,13511,9714,-3797
2016,2,11,11,13600,14241,10689,-3552
2016,2,11,12,15490,15518,12456,-3062
2016,2,11,13,16410,16483,13288,-3195
2016,2,11,14,16630,16645,13226,-3419
2016,2,11,15,16660,16648,13005,-3643
2016,2,11,16,16650,16586,12792,-3794
2016,2,11,17,16480,16536,13109,-3427
2016,2,11,18,16330,16445,12983,-3462
2016,2,11,19,16300,16430,13211,-3219
2016,2,11,20,16200,16369,13257,-3112
2016,2,11,21,16310,16502,13766,-2736
2016,2,11,22,16750,17119,14357,-2762
2016,2,11,23,17980,18368,15347,-3021
2016,2,12,0,18500,19013,16160,-2853
2016,2,12,1,18250,18806,16098,-2708
2016,2,12,2,17770,18401,15669,-2732
2016,2,12,3,16800,17455,14447,-3008
2016,2,12,4,15490,16143,12886,-3257
2016,2,12,5,14380,15029,11928,-3101
2016,2,12,6,13840,14938,11516,-3422
2016,2,12,7,13470,14749,11725,-3024
2016,2,12,8,13330,14615,11625,-2990
2016,2,12,9,13390,14635,11373,-3262
2016,2,12,10,14300,14781,11556,-3225
2016,2,12,11,15400,15301,12265,-3036
2016,2,12,12,17320,17091,14491,-2600
2016,2,12,13,18220,17992,14897,-3095
2016,2,12,14,18230,17964,14533,-3431
2016,2,12,15,18020,17698,14232,-3466
2016,2,12,16,17850,17477,14087,-3390
2016,2,12,17,17610,17164,13971,-3193
2016,2,12,18,17300,16836,13585,-3251
2016,2,12,19,17110,16742,13383,-3359
2016,2,12,20,16920,16710,13725,-2985
2016,2,12,21,16760,16858,13777,-3081
2016,2,12,22,17140,17293,14333,-2960
2016,2,12,23,18140,18251,15131,-3120
2016,2,13,0,18500,18447,15577,-2870
2016,2,13,1,17850,18007,15356,-2651
2016,2,13,2,17340,17449,14736,-2713
2016,2,13,3,16500,16623,14209,-2414
2016,2,13,4,15360,15538,12963,-2575
2016,2,13,5,14290,14996,12050,-2946
2016,2,13,6,13840,14598,11867,-2731
2016,2,13,7,13420,14359,11818,-2541
2016,2,13,8,13130,14185,11555,-2630
2016,2,13,9,13100,14110,11323,-2787
2016,2,13,10,13200,14202,11189,-3013
2016,2,13,11,13590,14505,11206,-3299
2016,2,13,12,14270,14771,11736,-3035
2016,2,13,13,15140,15205,12085,-3120
2016,2,13,14,15900,15807,12552,-3255
2016,2,13,15,16640,16233,12917,-3316
2016,2,13,16,16960,16245,12989,-3256
2016,2,13,17,16960,16138,13027,-3111
2016,2,13,18,16880,15958,12887,-3071
2016,2,13,19,16690,15786,12695,-3091
2016,2,13,20,16640,15775,12805,-2970
2016,2,13,21,16760,16080,13158,-2922
2016,2,13,22,17520,16797,14394,-2403
2016,2,13,23,18780,18173,15990,-2183
2016,2,14,0,19240,18845,16710,-2135
2016,2,14,1,18990,18695,16696,-1999
2016,2,14,2,18490,18422,16263,-2159
2016,2,14,3,17890,17837,15500,-2337
2016,2,14,4,17100,17089,14683,-2406
2016,2,14,5,16170,16244,13672,-2572
2016,2,14,6,15180,15615,12833,-2782
2016,2,14,7,14750,15381,12485,-2896
2016,2,14,8,14540,15379,12382,-2997
2016,2,14,9,14480,15176,12326,-2850
2016,2,14,10,14570,15248,12509,-2739
2016,2,14,11,15360,15601,12601,-3000
2016,2,14,12,15720,16152,13071,-3081
2016,2,14,13,16430,16745,13611,-3134
2016,2,14,14,17330,17500,14106,-3394
2016,2,14,15,17710,17915,14604,-3311
2016,2,14,16,17820,17990,14795,-3195
2016,2,14,17,17870,17936,14605,-3331
2016,2,14,18,17810,17723,14314,-3409
2016,2,14,19,17440,17382,14034,-3348
2016,2,14,20,17040,17443,13924,-3519
2016,2,14,21,16970,17548,14172,-3376
2016,2,14,22,17680,17859,14675,-3184
2016,2,14,23,18980,19014,15729,-3285
2016,2,15,0,19690,19562,16509,-3053
2016,2,15,1,19110,19181,16152,-3029
2016,2,15,2,18600,18650,15748,-2902
2016,2,15,3,17770,17802,14834,-2968
2016,2,15,4,16810,16847,13712,-3135
2016,2,15,5,15710,15942,12746,-3196
2016,2,15,6,15400,15523,12286,-3237
2016,2,15,7,15080,15372,12485,-2887
2016,2,15,8,14980,15321,12428,-2893
2016,2,15,9,14930,15351,12259,-3092
2016,2,15,10,15110,15709,12346,-3363
2016,2,15,11,15760,15876,12253,-3623
2016,2,15,12,16900,17001,13529,-3472
2016,2,15,13,17610,17826,14704,-3122
2016,2,15,14,17910,18253,15150,-3103
2016,2,15,15,18080,18471,15388,-3083
2016,2,15,16,18050,18614,15275,-3339
2016,2,15,17,17910,18564,15393,-3171
2016,2,15,18,17690,18479,15351,-3128
2016,2,15,19,17490,18345,14873,-3472
2016,2,15,20,17380,18253,14924,-3329
2016,2,15,21,17380,18310,15047,-3263
2016,2,15,22,17750,18711,15419,-3292
2016,2,15,23,18690,19530,16198,-3332
2016,2,16,0,18950,19574,16226,-3348
2016,2,16,1,18330,18985,15682,-3303
2016,2,16,2,17680,18196,15146,-3050
2016,2,16,3,16530,17056,14200,-2856
2016,2,16,4,15250,15680,12604,-3076
2016,2,16,5,14150,14452,11321,-3131
2016,2,16,6,13150,13819,10808,-3011
2016,2,16,7,12590,13505,10479,-3026
2016,2,16,8,12320,13602,10508,-3094
2016,2,16,9,12130,13489,10388,-3101
2016,2,16,10,12730,13467,10411,-3056
2016,2,16,11,13580,13898,11046,-2852
2016,2,16,12,15010,15167,12397,-2770
2016,2,16,13,16090,15747,12997,-2750
2016,2,16,14,16280,16159,13659,-2500
2016,2,16,15,16320,16380,14166,-2214
2016,2,16,16,16340,16428,14167,-2261
2016,2,16,17,16270,16366,14103,-2263
2016,2,16,18,16110,16342,14095,-2247
2016,2,16,19,16080,16328,14007,-2321
2016,2,16,20,15910,16189,13803,-2386
2016,2,16,21,15890,16152,13558,-2594
2016,2,16,22,16060,16478,13929,-2549
2016,2,16,23,16880,17151,14304,-2847
2016,2,17,0,17000,17125,14355,-2770
2016,2,17,1,16580,16530,13953,-2577
2016,2,17,2,15900,15785,13197,-2588
2016,2,17,3,14840,14724,12036,-2688
2016,2,17,4,13550,13471,10588,-2883
2016,2,17,5,12370,12841,9927,-2914
2016,2,17,6,11730,12735,9639,-3096
2016,2,17,7,11420,12455,9699,-2756
2016,2,17,8,11290,12317,9496,-2821
2016,2,17,9,11350,12342,9438,-2904
2016,2,17,10,11690,12752,9736,-3016
2016,2,17,11,12770,13516,10393,-3123
2016,2,17,12,14580,14386,11656,-2730
2016,2,17,13,15530,15292,12161,-3131
2016,2,17,14,15670,15425,12582,-2843
2016,2,17,15,15450,15186,12198,-2988
2016,2,17,16,15220,15041,12067,-2974
2016,2,17,17,14960,14915,12498,-2417
2016,2,17,18,14660,14815,12362,-2453
2016,2,17,19,14550,14962,11903,-3059
2016,2,17,20,14500,14785,11891,-2894
2016,2,17,21,14700,14968,12112,-2856
2016,2,17,22,15280,15522,12457,-3065
2016,2,17,23,16540,16609,13814,-2795
2016,2,18,0,17100,17119,14614,-2505
2016,2,18,1,16780,16780,14403,-2377
2016,2,18,2,16250,16201,13642,-2559
2016,2,18,3,15320,15270,12506,-2764
2016,2,18,4,14090,14282,11378,-2904
2016,2,18,5,12970,13720,10621,-3099
2016,2,18,6,12050,13287,9960,-3327
2016,2,18,7,11700,13000,9858,-3142
2016,2,18,8,11590,13031,9803,-3228
2016,2,18,9,11670,13056,9731,-3325
2016,2,18,10,12180,13430,10022,-3408
2016,2,18,11,13320,13715,10872,-2843
2016,2,18,12,15150,14819,11826,-2993
2016,2,18,13,15790,15742,12092,-3650
2016,2,18,14,15670,15743,12312,-3431
2016,2,18,15,15420,15525,12299,-3226
2016,2,18,16,15110,15345,12026,-3319
2016,2,18,17,14990,15156,12024,-3132
2016,2,18,18,14780,14950,11881,-3069
2016,2,18,19,14710,14862,11740,-3122
2016,2,18,20,14710,14865,11910,-2955
2016,2,18,21,14900,15302,12165,-3137
2016,2,18,22,15600,15770,12576,-3194
2016,2,18,23,16970,17003,13783,-3220
2016,2,19,0,17700,17674,14335,-3339
2016,2,19,1,17410,17399,14240,-3159
2016,2,19,2,16900,16888,13760,-3128
2016,2,19,3,15980,16022,12772,-3250
2016,2,19,4,14750,14866,11292,-3574
2016,2,19,5,13630,13740,10428,-3312
2016,2,19,6,12910,13501,9686,-3815
2016,2,19,7,12570,13268,9400,-3868
2016,2,19,8,12410,13106,9339,-3767
2016,2,19,9,12480,13161,9337,-3824
2016,2,19,10,13010,13528,9667,-3861
2016,2,19,11,14100,14197,10604,-3593
2016,2,19,12,15800,15574,12325,-3249
2016,2,19,13,16520,16397,12726,-3671
2016,2,19,14,16490,16282,12697,-3585
2016,2,19,15,16310,15906,12353,-3553
2016,2,19,16,16120,15604,11978,-3626
2016,2,19,17,15830,15291,11703,-3588
2016,2,19,18,15530,15035,11639,-3396
2016,2,19,19,15360,15067,11693,-3374
2016,2,19,20,15260,15171,11824,-3347
2016,2,19,21,15390,15267,11890,-3377
2016,2,19,22,15920,15659,12419,-3240
2016,2,19,23,16930,16560,13144,-3416
2016,2,20,0,17250,16861,13509,-3352
2016,2,20,1,16730,16397,13210,-3187
2016,2,20,2,16150,15827,12736,-3091
2016,2,20,3,15370,15033,11852,-3181
2016,2,20,4,14330,14024,10867,-3157
2016,2,20,5,13270,13158,10536,-2622
2016,2,20,6,12300,12449,9690,-2759
2016,2,20,7,11830,12199,9693,-2506
2016,2,20,8,11550,11915,9395,-2520
2016,2,20,9,11480,12011,9436,-2575
2016,2,20,10,11330,11853,9425,-2428
2016,2,20,11,11730,12150,9457,-2693
2016,2,20,12,12300,12906,10087,-2819
2016,2,20,13,13070,13125,10509,-2616
2016,2,20,14,13790,13780,11220,-2560
2016,2,20,15,14000,14057,11531,-2526
2016,2,20,16,13860,13723,11106,-2617
2016,2,20,17,13610,13459,10628,-2831
2016,2,20,18,13340,13159,10453,-2706
2016,2,20,19,13090,12982,10643,-2339
2016,2,20,20,13020,12758,10550,-2208
2016,2,20,21,13260,12757,10513,-2244
2016,2,20,22,13790,13182,10766,-2416
2016,2,20,23,15000,14158,11591,-2567
2016,2,21,0,15550,14686,12416,-2270
2016,2,21,1,14820,14314,11982,-2332
2016,2,21,2,14320,13844,11475,-2369
2016,2,21,3,13650,13189,10592,-2597
2016,2,21,4,12860,12361,10187,-2174
2016,2,21,5,11970,11468,9883,-1585
2016,2,21,6,11200,11398,9589,-1809
2016,2,21,7,10760,11627,9333,-2294
2016,2,21,8,10480,11012,9228,-1784
2016,2,21,9,10410,11032,9256,-1776
2016,2,21,10,10150,11098,9318,-1780
2016,2,21,11,10440,11252,9449,-1803
2016,2,21,12,10880,11413,9359,-2054
2016,2,21,13,11350,11784,9793,-1991
2016,2,21,14,12130,11910,10184,-1726
2016,2,21,15,12630,12386,10576,-1810
2016,2,21,16,12640,12606,10817,-1789
2016,2,21,17,12690,12828,10801,-2027
2016,2,21,18,12780,12896,10943,-1953
2016,2,21,19,12850,12856,10606,-2250
2016,2,21,20,12920,12776,10439,-2337
2016,2,21,21,13200,12825,10440,-2385
2016,2,21,22,13910,13407,10927,-2480
2016,2,21,23,15220,14596,12397,-2199
2016,2,22,0,15750,15249,13150,-2099
2016,2,22,1,15360,14916,12744,-2172
2016,2,22,2,14620,14343,11963,-2380
2016,2,22,3,13660,13411,11268,-2143
2016,2,22,4,12630,12366,10236,-2130
2016,2,22,5,11670,11633,9793,-1840
2016,2,22,6,10800,11092,9676,-1416
2016,2,22,7,10560,11128,9605,-1523
2016,2,22,8,10470,11148,9591,-1557
2016,2,22,9,10520,11223,9600,-1623
2016,2,22,10,10870,11656,9810,-1846
2016,2,22,11,12090,12471,10424,-2047
2016,2,22,12,14010,13939,11762,-2177
2016,2,22,13,14930,14797,12541,-2256
2016,2,22,14,14730,14657,12339,-2318
2016,2,22,15,14430,14364,12074,-2290
2016,2,22,16,14180,14231,12344,-1887
2016,2,22,17,14080,14090,12289,-1801
2016,2,22,18,13880,13891,11970,-1921
2016,2,22,19,13890,13807,11687,-2120
2016,2,22,20,13900,13751,11553,-2198
2016,2,22,21,14230,13967,11829,-2138
2016,2,22,22,15050,14621,12284,-2337
2016,2,22,23,16530,15870,13422,-2448
2016,2,23,0,17250,16676,14275,-2401
2016,2,23,1,16850,16373,14049,-2324
2016,2,23,2,16230,15818,13574,-2244
2016,2,23,3,15240,14864,12427,-2437
2016,2,23,4,13960,13618,11073,-2545
2016,2,23,5,12840,12550,10107,-2443
2016,2,23,6,11990,12062,9591,-2471
2016,2,23,7,11660,12071,9475,-2596
2016,2,23,8,11520,12185,9518,-2667
2016,2,23,9,11570,12268,9579,-2689
2016,2,23,10,12070,12616,9823,-2793
2016,2,23,11,13070,13171,10587,-2584
2016,2,23,12,14900,14793,12371,-2422
2016,2,23,13,15790,15717,13235,-2482
2016,2,23,14,15780,15800,13407,-2393
2016,2,23,15,15620,15697,13317,-2380
2016,2,23,16,15480,15655,13020,-2635
2016,2,23,17,15330,15609,12869,-2740
2016,2,23,18,15200,15427,12672,-2755
2016,2,23,19,15260,15497,12774,-2723
2016,2,23,20,15220,15563,12882,-2681
2016,2,23,21,15360,15690,12918,-2772
2016,2,23,22,15880,16167,13481,-2686
2016,2,23,23,17050,17108,14278,-2830
2016,2,24,0,17400,17524,14583,-2941
2016,2,24,1,17010,17066,14218,-2848
2016,2,24,2,16360,16361,13442,-2919
2016,2,24,3,15350,15253,12225,-3028
2016,2,24,4,13990,13916,11232,-2684
2016,2,24,5,12810,12728,10451,-2277
2016,2,24,6,12010,11976,9962,-2014
2016,2,24,7,11620,11944,9574,-2370
2016,2,24,8,11400,12034,9656,-2378
2016,2,24,9,11370,12125,9712,-2413
2016,2,24,10,11680,12437,10060,-2377
2016,2,24,11,12710,12637,10615,-2022
2016,2,24,12,14600,14379,12001,-2378
2016,2,24,13,15600,15428,12995,-2433
2016,2,24,14,15760,15814,13441,-2373
2016,2,24,15,15770,15933,13463,-2470
2016,2,24,16,15820,16048,13817,-2231
2016,2,24,17,15830,16045,13871,-2174
2016,2,24,18,15690,15933,13700,-2233
2016,2,24,19,15710,15953,13439,-2514
2016,2,24,20,15620,15925,13416,-2509
2016,2,24,21,15690,15952,13637,-2315
2016,2,24,22,16100,16247,14107,-2140
2016,2,24,23,17030,16920,14670,-2250
2016,2,25,0,17200,16996,14559,-2437
2016,2,25,1,16640,16459,13913,-2546
2016,2,25,2,15870,15701,13302,-2399
2016,2,25,3,14700,14583,12619,-1964
2016,2,25,4,13300,13180,10966,-2214
2016,2,25,5,12100,12217,10278,-1939
2016,2,25,6,11230,12061,10117,-1944
2016,2,25,7,10660,11870,9773,-2097
2016,2,25,8,10420,11675,9794,-1881
2016,2,25,9,10390,11554,9651,-1903
2016,2,25,10,10590,11770,9986,-1784
2016,2,25,11,11510,12290,10551,-1739
2016,2,25,12,13290,13429,11572,-1857
2016,2,25,13,14320,14051,12035,-2016
2016,2,25,14,14490,14325,12243,-2082
2016,2,25,15,14560,14178,12262,-1916
2016,2,25,16,14580,14308,12236,-2072
2016,2,25,17,14490,14185,12119,-2066
2016,2,25,18,14370,14055,12025,-2030
2016,2,25,19,14340,14040,11820,-2220
2016,2,25,20,14270,14044,11787,-2257
2016,2,25,21,14390,14323,12012,-2311
2016,2,25,22,14810,14837,12615,-2222
2016,2,25,23,15850,15655,13260,-2395
2016,2,26,0,16100,15991,13270,-2721
2016,2,26,1,15760,15697,12984,-2713
2016,2,26,2,15130,15143,12542,-2601
2016,2,26,3,14280,14219,11757,-2462
2016,2,26,4,13050,13049,10765,-2284
2016,2,26,5,11930,12291,10212,-2079
2016,2,26,6,11110,12230,9737,-2493
2016,2,26,7,10760,12272,9925,-2347
2016,2,26,8,10660,12134,9999,-2135
2016,2,26,9,10700,12163,9711,-2452
2016,2,26,10,11080,12309,9886,-2423
2016,2,26,11,12320,13010,10534,-2476
2016,2,26,12,14090,14032,11765,-2267
2016,2,26,13,15060,14960,12448,-2512
2016,2,26,14,15250,14980,12626,-2354
2016,2,26,15,15280,14736,12557,-2179
2016,2,26,16,15190,14586,12377,-2209
2016,2,26,17,15000,14422,12145,-2277
2016,2,26,18,14810,14241,11842,-2399
2016,2,26,19,14760,14169,11660,-2509
2016,2,26,20,14720,14123,11786,-2337
2016,2,26,21,14820,14336,12145,-2191
2016,2,26,22,15360,14949,12674,-2275
2016,2,26,23,16450,16005,13273,-2732
2016,2,27,0,16830,16779,14281,-2498
2016,2,27,1,16490,16505,13912,-2593
2016,2,27,2,16020,16054,13425,-2629
2016,2,27,3,15330,15334,12664,-2670
2016,2,27,4,14370,14350,11689,-2661
2016,2,27,5,13380,13428,10790,-2638
2016,2,27,6,12700,12930,10069,-2861
2016,2,27,7,12290,12769,9618,-3151
2016,2,27,8,12070,12603,9463,-3140
2016,2,27,9,12030,12552,9582,-2970
2016,2,27,10,12200,12906,9992,-2914
2016,2,27,11,12670,12926,10323,-2603
2016,2,27,12,13290,13240,10429,-2811
2016,2,27,13,13750,13815,11098,-2717
2016,2,27,14,14090,14218,11455,-2763
2016,2,27,15,14210,14321,11755,-2566
2016,2,27,16,14100,14190,11632,-2558
2016,2,27,17,13680,13872,11433,-2439
2016,2,27,18,13400,13520,11108,-2412
2016,2,27,19,13120,13187,10669,-2518
2016,2,27,20,13150,13081,10517,-2564
2016,2,27,21,13460,13504,10909,-2595
2016,2,27,22,14190,13824,11156,-2668
2016,2,27,23,15360,14874,12071,-2803
2016,2,28,0,15810,15656,12852,-2804
2016,2,28,1,15430,15369,12490,-2879
2016,2,28,2,14990,14930,11988,-2942
2016,2,28,3,14360,14253,11714,-2539
2016,2,28,4,13580,13375,10898,-2477
2016,2,28,5,12700,12578,10022,-2556
2016,2,28,6,11920,12246,9512,-2734
2016,2,28,7,11500,12018,9561,-2457
2016,2,28,8,11240,11953,9579,-2374
2016,2,28,9,11110,11867,9463,-2404
2016,2,28,10,10790,12068,9487,-2581
2016,2,28,11,11080,12164,9594,-2570
2016,2,28,12,11450,12162,9439,-2723
2016,2,28,13,11900,12480,9594,-2886
2016,2,28,14,12570,12734,10067,-2667
2016,2,28,15,12940,12880,10202,-2678
2016,2,28,16,12940,12779,10174,-2605
2016,2,28,17,12830,12672,9987,-2685
2016,2,28,18,12740,12526,9872,-2654
2016,2,28,19,12570,12266,9661,-2605
2016,2,28,20,12550,12181,9770,-2411
2016,2,28,21,12880,12431,9836,-2595
2016,2,28,22,13690,13041,10549,-2492
2016,2,28,23,14860,14140,11367,-2773
2016,2,29,0,15430,15104,12308,-2796
2016,2,29,1,15080,14823,12008,-2815
2016,2,29,2,14520,14256,11436,-2820
2016,2,29,3,13580,13332,10892,-2440
2016,2,29,4,12600,12266,9995,-2271
2016,2,29,5,11630,11432,9091,-2341
2016,2,29,6,10740,11445,9041,-2404
2016,2,29,7,10390,11146,9026,-2120
2016,2,29,8,10270,11018,8783,-2235
2016,2,29,9,10310,11159,8978,-2181
2016,2,29,10,10610,11668,9385,-2283
2016,2,29,11,11730,12334,10074,-2260
2016,2,29,12,13570,13518,11112,-2406
2016,2,29,13,14530,14258,11418,-2840
2016,2,29,14,14670,14140,11549,-2591
2016,2,29,15,14550,13939,11646,-2293
2016,2,29,16,14370,14048,11811,-2237
2016,2,29,17,14280,14205,11767,-2438
2016,2,29,18,14050,14294,11927,-2367
2016,2,29,19,14020,14313,12005,-2308
2016,2,29,20,13900,14106,11959,-2147
2016,2,29,21,14050,14016,11784,-2232
2016,2,29,22,14520,14301,11823,-2478
2016,2,29,23,15720,15186,12689,-2497
2016,3,1,0,16300,16029,13568,-2461
2016,3,1,1,15950,15706,13343,-2363
2016,3,1,2,15250,15089,12908,-2181
2016,3,1,3,14280,14065,11900,-2165
2016,3,1,4,13000,12772,10663,-2109
2016,3,1,5,11880,12056,9964,-2092
2016,3,1,6,11140,11918,9685,-2233
2016,3,1,7,10800,11796,9575,-2221
2016,3,1,8,10680,11696,9558,-2138
2016,3,1,9,10760,11749,9627,-2122
2016,3,1,10,10970,12186,9969,-2217
2016,3,1,11,12170,12911,10808,-2103
2016,3,1,12,13980,14155,12294,-1861
2016,3,1,13,14820,14741,13031,-1710
2016,3,1,14,14740,14550,12871,-1679
2016,3,1,15,14440,14313,12605,-1708
2016,3,1,16,14300,14335,12738,-1597
2016,3,1,17,14140,14154,12451,-1703
2016,3,1,18,14020,13874,12097,-1777
2016,3,1,19,13890,13800,11970,-1830
2016,3,1,20,13880,13711,11854,-1857
2016,3,1,21,13990,13877,11987,-1890
2016,3,1,22,14570,14405,12547,-1858
2016,3,1,23,15720,15451,13235,-2216
2016,3,2,0,16600,16367,13894,-2473
2016,3,2,1,16340,16110,13593,-2517
2016,3,2,2,15740,15544,13430,-2114
2016,3,2,3,14740,14492,12062,-2430
2016,3,2,4,13360,13205,10800,-2405
2016,3,2,5,12250,12326,10055,-2271
2016,3,2,6,11460,12032,9796,-2236
2016,3,2,7,10970,11594,9582,-2012
2016,3,2,8,10760,11383,9423,-1960
2016,3,2,9,10730,10851,8965,-1886
2016,3,2,10,10980,11188,9194,-1994
2016,3,2,11,11940,12249,9783,-2466
2016,3,2,12,13860,13563,10983,-2580
2016,3,2,13,14830,14686,11731,-2955
2016,3,2,14,15020,15008,12037,-2971
2016,3,2,15,14940,14984,11870,-3114
2016,3,2,16,14890,14898,11513,-3385
2016,3,2,17,14750,14707,11428,-3279
2016,3,2,18,14540,14537,11350,-3187
2016,3,2,19,14500,14457,11468,-2989
2016,3,2,20,14420,14479,11301,-3178
2016,3,2,21,14620,14557,11368,-3189
2016,3,2,22,15170,14928,11806,-3122
2016,3,2,23,16400,16022,12793,-3229
2016,3,3,0,17110,17045,13699,-3346
2016,3,3,1,16880,16898,13641,-3257
2016,3,3,2,16290,16403,13386,-3017
2016,3,3,3,15380,15476,12261,-3215
2016,3,3,4,14060,14208,11077,-3131
2016,3,3,5,12940,13108,10075,-3033
2016,3,3,6,12300,12882,9543,-3339
2016,3,3,7,11930,12975,9389,-3586
2016,3,3,8,11830,13073,9464,-3609
2016,3,3,9,11890,13143,9381,-3762
2016,3,3,10,12310,13340,9752,-3588
2016,3,3,11,13630,13923,10874,-3049
2016,3,3,12,15520,15398,12244,-3154
2016,3,3,13,16130,16102,12747,-3355
2016,3,3,14,15860,15866,12218,-3648
2016,3,3,15,15380,15503,11674,-3829
2016,3,3,16,14980,15281,11316,-3965
2016,3,3,17,14700,15043,11127,-3916
2016,3,3,18,14390,14778,10831,-3947
2016,3,3,19,14300,14637,10688,-3949
2016,3,3,20,14260,14560,10746,-3814
2016,3,3,21,14520,14748,11001,-3747
2016,3,3,22,15160,15377,11463,-3914
2016,3,3,23,16470,16421,12333,-4088
2016,3,4,0,17520,17276,13246,-4030
2016,3,4,1,17310,17047,12909,-4138
2016,3,4,2,16850,16567,12328,-4239
2016,3,4,3,15890,15601,11353,-4248
2016,3,4,4,14590,14359,10371,-3988
2016,3,4,5,13500,13224,9396,-3828
2016,3,4,6,12850,12572,8774,-3798
2016,3,4,7,12370,12629,9002,-3627
2016,3,4,8,12200,12473,8784,-3689
2016,3,4,9,12270,12483,8705,-3778
2016,3,4,10,12330,12815,9166,-3649
2016,3,4,11,13440,13703,10082,-3621
2016,3,4,12,15170,15039,11420,-3619
2016,3,4,13,16160,15996,12222,-3774
2016,3,4,14,16310,16272,12822,-3450
2016,3,4,15,16150,16353,12726,-3627
2016,3,4,16,16050,16315,12436,-3879
2016,3,4,17,15790,16030,12296,-3734
2016,3,4,18,15740,15722,11771,-3951
2016,3,4,19,15790,15636,11730,-3906
2016,3,4,20,15700,15554,11529,-4025
2016,3,4,21,15800,15580,11692,-3888
2016,3,4,22,16200,15915,12110,-3805
2016,3,4,23,16860,16533,12338,-4195
2016,3,5,0,17250,17014,12728,-4286
2016,3,5,1,16870,16652,12419,-4233
2016,3,5,2,16350,16139,11933,-4206
2016,3,5,3,15550,15317,11213,-4104
2016,3,5,4,14430,14254,10440,-3814
2016,3,5,5,13310,13228,9517,-3711
2016,3,5,6,12400,12452,8886,-3566
2016,3,5,7,11930,12208,9106,-3102
2016,3,5,8,11740,12203,9113,-3090
2016,3,5,9,11670,12301,9499,-2802
2016,3,5,10,11820,12228,9495,-2733
2016,3,5,11,12350,12905,10028,-2877
2016,3,5,12,12990,13265,10168,-3097
2016,3,5,13,13570,13650,10588,-3062
2016,3,5,14,14190,14070,10925,-3145
2016,3,5,15,14400,14173,10946,-3227
2016,3,5,16,14050,14070,11078,-2992
2016,3,5,17,13770,13880,11072,-2808
2016,3,5,18,13590,13637,10754,-2883
2016,3,5,19,13330,13393,10375,-3018
2016,3,5,20,13190,13542,10662,-2880
2016,3,5,21,13290,13833,10683,-3150
2016,3,5,22,13730,14346,10964,-3382
2016,3,5,23,14780,14901,11049,-3852
2016,3,6,0,15550,15666,11799,-3867
2016,3,6,1,15470,15381,11706,-3675
2016,3,6,2,15070,14943,11268,-3675
2016,3,6,3,14420,14303,10942,-3361
2016,3,6,4,13550,13446,10522,-2924
2016,3,6,5,12690,12538,9932,-2606
2016,3,6,6,11920,12112,9317,-2795
2016,3,6,7,11540,11905,9064,-2841
2016,3,6,8,11320,11771,8940,-2831
2016,3,6,9,11180,11694,8625,-3069
2016,3,6,10,11320,11795,8579,-3216
2016,3,6,11,11580,11912,8539,-3373
2016,3,6,12,11950,12330,8855,-3475
2016,3,6,13,12410,12824,9531,-3293
2016,3,6,14,13030,12950,9948,-3002
2016,3,6,15,13350,13063,10006,-3057
2016,3,6,16,13390,13025,10320,-2705
2016,3,6,17,13170,12921,10417,-2504
2016,3,6,18,13110,12795,10127,-2668
2016,3,6,19,12940,12805,10091,-2714
2016,3,6,20,12930,12774,9965,-2809
2016,3,6,21,13100,12994,10189,-2805
2016,3,6,22,13680,13673,10874,-2799
2016,3,6,23,15030,14559,11747,-2812
2016,3,7,0,15820,15677,12731,-2946
2016,3,7,1,15670,15547,12397,-3150
2016,3,7,2,15160,15059,11954,-3105
2016,3,7,3,14230,14143,11119,-3024
2016,3,7,4,13150,13069,10321,-2748
2016,3,7,5,12190,12226,9540,-2686
2016,3,7,6,11560,11968,8936,-3032
2016,3,7,7,11260,12028,8938,-3090
2016,3,7,8,11140,12155,9214,-2941
2016,3,7,9,11200,12279,9466,-2813
2016,3,7,10,11630,12487,9713,-2774
2016,3,7,11,12780,12931,9916,-3015
2016,3,7,12,14540,14401,11723,-2678
2016,3,7,13,15410,15173,12583,-2590
2016,3,7,14,15270,15251,12294,-2957
2016,3,7,15,15070,15367,12286,-3081
2016,3,7,16,14880,15319,12365,-2954
2016,3,7,17,14730,15115,12061,-3054
2016,3,7,18,14510,14770,11718,-3052
2016,3,7,19,14410,14640,11706,-2934
2016,3,7,20,14330,14669,11954,-2715
2016,3,7,21,14410,14852,12089,-2763
2016,3,7,22,14860,15195,12277,-2918
2016,3,7,23,15820,15919,12651,-3268
2016,3,8,0,16600,16489,13442,-3047
2016,3,8,1,16340,16098,13015,-3083
2016,3,8,2,15680,15385,12290,-3095
2016,3,8,3,14570,14284,11088,-3196
2016,3,8,4,13220,13132,10198,-2934
2016,3,8,5,12070,12446,10021,-2425
2016,3,8,6,11230,12352,9900,-2452
2016,3,8,7,10870,12176,9947,-2229
2016,3,8,8,10710,11999,9821,-2178
2016,3,8,9,10720,12026,9975,-2051
2016,3,8,10,11100,12428,10107,-2321
2016,3,8,11,12170,13063,10567,-2496
2016,3,8,12,13800,13951,11399,-2552
2016,3,8,13,14530,14586,12037,-2549
2016,3,8,14,14530,14359,12053,-2306
2016,3,8,15,14410,14036,11799,-2237
2016,3,8,16,14260,13879,11769,-2110
2016,3,8,17,14130,13730,11629,-2101
2016,3,8,18,13930,13550,11603,-1947
2016,3,8,19,13840,13499,11489,-2010
2016,3,8,20,13750,13384,11114,-2270
2016,3,8,21,13800,13488,11264,-2224
2016,3,8,22,14290,13946,11794,-2152
2016,3,8,23,15210,14754,12391,-2363
2016,3,9,0,15970,15757,13514,-2243
2016,3,9,1,15700,15509,13186,-2323
2016,3,9,2,15080,14904,12562,-2342
2016,3,9,3,14040,13878,11814,-2064
2016,3,9,4,12760,12592,10866,-1726
2016,3,9,5,11630,11826,9901,-1925
2016,3,9,6,10800,11492,9549,-1943
2016,3,9,7,10420,11209,9413,-1796
2016,3,9,8,10240,11242,9343,-1899
2016,3,9,9,10240,11254,9253,-2001
2016,3,9,10,10600,11582,9344,-2238
2016,3,9,11,11710,12383,10083,-2300
2016,3,9,12,13360,13270,11460,-1810
2016,3,9,13,14170,14045,12216,-1829
2016,3,9,14,14030,13888,12076,-1812
2016,3,9,15,13790,13588,11701,-1887
2016,3,9,16,13640,13493,11590,-1903
2016,3,9,17,13570,13415,11377,-2038
2016,3,9,18,13430,13357,11237,-2120
2016,3,9,19,13450,13429,11335,-2094
2016,3,9,20,13460,13463,11382,-2081
2016,3,9,21,13540,13561,11726,-1835
2016,3,9,22,13950,13879,12183,-1696
2016,3,9,23,14720,14445,12669,-1776
2016,3,10,0,15500,15302,13537,-1765
2016,3,10,1,15150,15064,13338,-1726
2016,3,10,2,14500,14387,12750,-1637
2016,3,10,3,13450,13341,11845,-1496
2016,3,10,4,12140,12035,10630,-1405
2016,3,10,5,11040,11130,9848,-1282
2016,3,10,6,10230,11070,9477,-1593
2016,3,10,7,9910,11056,9432,-1624
2016,3,10,8,9770,10765,9508,-1257
2016,3,10,9,9720,10791,9198,-1593
2016,3,10,10,10040,11070,9325,-1745
2016,3,10,11,10860,11980,10414,-1566
2016,3,10,12,12570,12630,11489,-1141
2016,3,10,13,13470,13536,11989,-1547
2016,3,10,14,13750,13897,12274,-1623
2016,3,10,15,13800,14080,12447,-1633
2016,3,10,16,13890,14221,12409,-1812
2016,3,10,17,13920,14301,12460,-1841
2016,3,10,18,13870,14321,12505,-1816
2016,3,10,19,13910,14361,12740,-1621
2016,3,10,20,13860,14241,12615,-1626
2016,3,10,21,13900,14276,12467,-1809
2016,3,10,22,14170,14537,12795,-1742
2016,3,10,23,14850,15112,13230,-1882
2016,3,11,0,15500,15532,13584,-1948
2016,3,11,1,15100,15133,13262,-1871
2016,3,11,2,14440,14461,12761,-1700
2016,3,11,3,13390,13434,11909,-1525
2016,3,11,4,12120,12150,10720,-1430
2016,3,11,5,11020,11127,9657,-1470
2016,3,11,6,10270,11418,9384,-2034
2016,3,11,7,9820,11100,9142,-1958
2016,3,11,8,9620,10854,8898,-1956
2016,3,11,9,9580,10828,8867,-1961
2016,3,11,10,9860,11110,9298,-1812
2016,3,11,11,10870,11561,9798,-1763
2016,3,11,12,12490,12717,10957,-1760
2016,3,11,13,13290,13509,11654,-1855
2016,3,11,14,13410,13688,11876,-1812
2016,3,11,15,13330,13759,12088,-1671
2016,3,11,16,13050,13768,12072,-1696
2016,3,11,17,12780,13575,11875,-1700
2016,3,11,18,12550,13248,11578,-1670
2016,3,11,19,12510,13083,11440,-1643
2016,3,11,20,12530,12973,11342,-1631
2016,3,11,21,12680,12994,11268,-1726
2016,3,11,22,13200,13323,11780,-1543
2016,3,11,23,14100,13865,12271,-1594
2016,3,12,0,14930,14656,13108,-1548
2016,3,12,1,14600,14422,12903,-1519
2016,3,12,2,14070,13924,12205,-1719
2016,3,12,3,13380,13203,11552,-1651
2016,3,12,4,12370,12242,10770,-1472
2016,3,12,5,11400,11416,9772,-1644
2016,3,12,6,10680,11115,8955,-2160
2016,3,12,7,10230,10939,8649,-2290
2016,3,12,8,10050,10777,8892,-1885
2016,3,12,9,9990,10733,8693,-2040
2016,3,12,10,10150,11003,8803,-2200
2016,3,12,11,10600,11281,9217,-2064
2016,3,12,12,11140,11718,9813,-1905
2016,3,12,13,11590,12122,10081,-2041
2016,3,12,14,11970,12250,10418,-1832
2016,3,12,15,12060,12282,10670,-1612
2016,3,12,16,11880,12250,10870,-1380
2016,3,12,17,11640,12063,10762,-1301
2016,3,12,18,11370,11801,10407,-1394
2016,3,12,19,11160,11718,10389,-1329
2016,3,12,20,11240,11872,10479,-1393
2016,3,12,21,11540,12015,10411,-1604
2016,3,12,22,12210,12424,10612,-1812
2016,3,12,23,13190,12952,11157,-1795
2016,3,13,0,14000,13872,12243,-1629
2016,3,13,1,13690,13655,11977,-1678
2016,3,13,2,13240,13201,11463,-1738
2016,3,13,3,12590,12524,10654,-1870
2016,3,13,4,11770,11816,9934,-1882
2016,3,13,5,10920,11297,9425,-1872
2016,3,13,6,10490,11116,8930,-2186
2016,3,13,7,9800,11059,8960,-2099
2016,3,13,8,9710,10851,8811,-2040
2016,3,13,9,9810,10806,9034,-1772
2016,3,13,10,9670,10959,9246,-1713
2016,3,13,11,10070,11360,9915,-1445
2016,3,13,12,10680,11539,10121,-1418
2016,3,13,13,11250,11461,10004,-1457
2016,3,13,14,11690,11577,10229,-1348
2016,3,13,15,11890,11750,10516,-1234
2016,3,13,16,12000,11638,10568,-1070
2016,3,13,17,11980,11532,10439,-1093
2016,3,13,18,11910,11412,10287,-1125
2016,3,13,19,11790,11296,10233,-1063
2016,3,13,20,11880,11404,10229,-1175
2016,3,13,21,12160,11813,10633,-1180
2016,3,13,22,12650,12484,11044,-1440
2016,3,13,23,13370,13211,11431,-1780
2016,3,14,0,14100,13990,12321,-1669
2016,3,14,1,13700,13673,12020,-1653
2016,3,14,2,12820,12809,11227,-1582
2016,3,14,3,11840,11711,9907,-1804
2016,3,14,4,10890,11295,9607,-1688
2016,3,14,5,10340,10737,9194,-1543
2016,3,14,6,10230,10329,8874,-1455
2016,3,14,7,10190,10388,8973,-1415
2016,3,14,8,10180,10460,9206,-1254
2016,3,14,9,10470,10545,9515,-1030
2016,3,14,10,10800,11166,10224,-942
2016,3,14,11,12830,12696,11711,-985
2016,3,14,12,13780,13946,12297,-1649
2016,3,14,13,13800,14314,12633,-1681
2016,3,14,14,13860,14543,13022,-1521
2016,3,14,15,13990,14781,13370,-1411
2016,3,14,16,14100,14897,13418,-1479
2016,3,14,17,14180,14901,13260,-1641
2016,3,14,18,14240,14897,13264,-1633
2016,3,14,19,14200,14772,13400,-1372
2016,3,14,20,14410,14778,13342,-1436
2016,3,14,21,14770,15019,13570,-1449
2016,3,14,22,15260,15483,13979,-1504
2016,3,14,23,15780,15854,14022,-1832
2016,3,15,0,16140,16065,14271,-1794
2016,3,15,1,15400,15487,13995,-1492
2016,3,15,2,14290,14428,12834,-1594
2016,3,15,3,12970,13102,11627,-1475
2016,3,15,4,11730,11874,10377,-1497
2016,3,15,5,10970,11460,9814,-1646
2016,3,15,6,10530,11274,9594,-1680
2016,3,15,7,10360,11227,9551,-1676
2016,3,15,8,10340,11166,9580,-1586
2016,3,15,9,10660,11257,9652,-1605
2016,3,15,10,11670,12092,10343,-1749
2016,3,15,11,13730,13414,11885,-1529
2016,3,15,12,14710,14601,13084,-1517
2016,3,15,13,14770,14875,13452,-1423
2016,3,15,14,14650,14971,13393,-1578
2016,3,15,15,14700,15032,13382,-1650
2016,3,15,16,14640,14956,13101,-1855
2016,3,15,17,14630,14747,12769,-1978
2016,3,15,18,14600,14679,12582,-2097
2016,3,15,19,14480,14505,12628,-1877
2016,3,15,20,14560,14430,12918,-1512
2016,3,15,21,14730,14835,12941,-1894
2016,3,15,22,15070,15039,13068,-1971
2016,3,15,23,15420,15267,13205,-2062
2016,3,16,0,15900,15555,13448,-2107
2016,3,16,1,15430,15114,13160,-1954
2016,3,16,2,14420,14145,12132,-2013
2016,3,16,3,13050,13000,10854,-2146
2016,3,16,4,11770,11960,10040,-1920
2016,3,16,5,11050,11234,9433,-1801
2016,3,16,6,10620,11197,9572,-1625
2016,3,16,7,10420,11178,9530,-1648
2016,3,16,8,10110,11212,9648,-1564
2016,3,16,9,10430,11368,9846,-1522
2016,3,16,10,11480,11906,10403,-1503
2016,3,16,11,13340,13431,11608,-1823
2016,3,16,12,14410,14301,12222,-2079
2016,3,16,13,14510,14434,12338,-2096
2016,3,16,14,14370,14344,12523,-1821
2016,3,16,15,14280,14254,12198,-2056
2016,3,16,16,14130,14033,11994,-2039
2016,3,16,17,13940,13742,11653,-2089
2016,3,16,18,13860,13601,11739,-1862
2016,3,16,19,13740,13381,11565,-1816
2016,3,16,20,13750,13341,11752,-1589
2016,3,16,21,14030,13503,11921,-1582
2016,3,16,22,14490,13849,12062,-1787
2016,3,16,23,14860,14412,12375,-2037
2016,3,17,0,15350,15043,13133,-1910
2016,3,17,1,14910,14661,12827,-1834
2016,3,17,2,13970,13751,11806,-1945
2016,3,17,3,12690,12460,10808,-1652
2016,3,17,4,11470,11622,10208,-1414
2016,3,17,5,10540,11304,9096,-2208
2016,3,17,6,10060,10906,8763,-2143
2016,3,17,7,9880,10947,8802,-2145
2016,3,17,8,9870,10885,8935,-1950
2016,3,17,9,10130,11022,9010,-2012
2016,3,17,10,11090,11858,9816,-2042
2016,3,17,11,12840,13132,11442,-1690
2016,3,17,12,13760,14031,11979,-2052
2016,3,17,13,13890,14191,12479,-1712
2016,3,17,14,13740,14046,12486,-1560
2016,3,17,15,13610,13681,12207,-1474
2016,3,17,16,13400,13412,11884,-1528
2016,3,17,17,13190,13318,11910,-1408
2016,3,17,18,13150,13461,12206,-1255
2016,3,17,19,13050,13445,12371,-1074
2016,3,17,20,13090,13371,12362,-1009
2016,3,17,21,13390,13633,12511,-1122
2016,3,17,22,14020,13915,12606,-1309
2016,3,17,23,14400,14232,12826,-1406
2016,3,18,0,15000,14688,13181,-1507
2016,3,18,1,14580,14429,12934,-1495
2016,3,18,2,13730,13564,12116,-1448
2016,3,18,3,12470,12368,10750,-1618
2016,3,18,4,11290,11691,9692,-1999
2016,3,18,5,10470,11341,9320,-2021
2016,3,18,6,10040,11372,9376,-1996
2016,3,18,7,9840,11300,9282,-2018
2016,3,18,8,9820,11278,9182,-2096
2016,3,18,9,10200,11547,9488,-2059
2016,3,18,10,11030,11851,9996,-1855
2016,3,18,11,12800,13000,11276,-1724
2016,3,18,12,13860,13985,12047,-1938
2016,3,18,13,14030,14010,12126,-1884
2016,3,18,14,13890,13884,12137,-1747
2016,3,18,15,13690,13890,12213,-1677
2016,3,18,16,13560,13794,12132,-1662
2016,3,18,17,13500,13713,12243,-1470
2016,3,18,18,13520,13631,12185,-1446
2016,3,18,19,13540,13535,11746,-1789
2016,3,18,20,13500,13416,11736,-1680
2016,3,18,21,13610,13477,11764,-1713
2016,3,18,22,13880,13707,11999,-1708
2016,3,18,23,14150,14006,12222,-1784
2016,3,19,0,14700,14589,12634,-1955
2016,3,19,1,14390,14413,12434,-1979
2016,3,19,2,13740,13768,11685,-2083
2016,3,19,3,12780,12834,10969,-1865
2016,3,19,4,11790,11877,10062,-1815
2016,3,19,5,10960,11715,9515,-2200
2016,3,19,6,10580,11999,9778,-2221
2016,3,19,7,10360,11812,9509,-2303
2016,3,19,8,10350,11546,9342,-2204
2016,3,19,9,10460,11642,9866,-1776
2016,3,19,10,10900,12077,10018,-2059
2016,3,19,11,11650,12858,10612,-2246
2016,3,19,12,12440,12894,10820,-2074
2016,3,19,13,12990,13071,11041,-2030
2016,3,19,14,13320,13241,11236,-2005
2016,3,19,15,13140,13125,11119,-2006
2016,3,19,16,12820,12870,10761,-2109
2016,3,19,17,12520,12558,10274,-2284
2016,3,19,18,12200,12274,10181,-2093
2016,3,19,19,12010,12199,10054,-2145
2016,3,19,20,11970,12160,10037,-2123
2016,3,19,21,12360,12329,10203,-2126
2016,3,19,22,13030,12696,10617,-2079
2016,3,19,23,13510,13275,11163,-2112
2016,3,20,0,14270,14076,12085,-1991
2016,3,20,1,14020,14045,12046,-1999
2016,3,20,2,13540,13550,11583,-1967
2016,3,20,3,12820,12780,10484,-2296
2016,3,20,4,11910,11989,9790,-2199
2016,3,20,5,11400,11921,9401,-2520
2016,3,20,6,11020,11620,9179,-2441
2016,3,20,7,10840,11431,8814,-2617
2016,3,20,8,10800,11393,8772,-2621
2016,3,20,9,10900,11272,8831,-2441
2016,3,20,10,11060,11516,9028,-2488
2016,3,20,11,11500,12072,9770,-2302
2016,3,20,12,12060,12170,10277,-1893
2016,3,20,13,12740,12592,10889,-1703
2016,3,20,14,13120,12815,11166,-1649
2016,3,20,15,13190,12823,11206,-1617
2016,3,20,16,13150,12829,11231,-1598
2016,3,20,17,13040,12800,11173,-1627
2016,3,20,18,12820,12716,11104,-1612
2016,3,20,19,12590,12649,10901,-1748
2016,3,20,20,12600,12803,11048,-1755
2016,3,20,21,12830,13062,11315,-1747
2016,3,20,22,13290,13692,11900,-1792
2016,3,20,23,13980,14338,12284,-2054
2016,3,21,0,14910,15040,12818,-2222
2016,3,21,1,14770,14737,12413,-2324
2016,3,21,2,13870,13850,11926,-1924
2016,3,21,3,12770,12728,10753,-1975
2016,3,21,4,11770,12240,10032,-2208
2016,3,21,5,11030,12133,9814,-2319
2016,3,21,6,10710,11915,9465,-2450
2016,3,21,7,10600,11611,9368,-2243
2016,3,21,8,10670,11598,9073,-2525
2016,3,21,9,11070,11953,9526,-2427
2016,3,21,10,12180,12510,10249,-2261
2016,3,21,11,14110,13683,11599,-2084
2016,3,21,12,15190,14806,12780,-2026
2016,3,21,13,15370,15514,13190,-2324
2016,3,21,14,15340,15718,13462,-2256
2016,3,21,15,15360,15717,13346,-2371
2016,3,21,16,15170,15504,12970,-2534
2016,3,21,17,14860,15094,12263,-2831
2016,3,21,18,14620,14776,12085,-2691
2016,3,21,19,14380,14442,11733,-2709
2016,3,21,20,14260,14078,11520,-2558
2016,3,21,21,14370,14131,11464,-2667
2016,3,21,22,14690,14609,11884,-2725
2016,3,21,23,15310,15063,12244,-2819
2016,3,22,0,16120,15774,13081,-2693
2016,3,22,1,15890,15551,12748,-2803
2016,3,22,2,14850,14594,12092,-2502
2016,3,22,3,13640,13294,11098,-2196
2016,3,22,4,12490,12638,10085,-2553
2016,3,22,5,11430,12002,9428,-2574
2016,3,22,6,11070,11804,9073,-2731
2016,3,22,7,10930,11857,9024,-2833
2016,3,22,8,10980,12022,9219,-2803
2016,3,22,9,11340,11976,9471,-2505
2016,3,22,10,12370,12565,10188,-2377
2016,3,22,11,14060,14296,12303,-1993
2016,3,22,12,15000,15247,13147,-2100
2016,3,22,13,15180,15091,13020,-2071
2016,3,22,14,14780,14748,12747,-2001
2016,3,22,15,14500,14452,12414,-2038
2016,3,22,16,14240,14157,12235,-1922
2016,3,22,17,13980,14026,11975,-2051
2016,3,22,18,13850,13932,11876,-2056
2016,3,22,19,13700,13661,11507,-2154
2016,3,22,20,13700,13577,11488,-2089
2016,3,22,21,13840,13696,11580,-2116
2016,3,22,22,14190,14140,11814,-2326
2016,3,22,23,14780,14674,12228,-2446
2016,3,23,0,15500,15414,12674,-2740
2016,3,23,1,15240,15212,12551,-2661
2016,3,23,2,14240,14280,11560,-2720
2016,3,23,3,12930,12948,10159,-2789
2016,3,23,4,11810,12014,9743,-2271
2016,3,23,5,11010,11744,9489,-2255
2016,3,23,6,10600,11316,9250,-2066
2016,3,23,7,10400,11115,9369,-1746
2016,3,23,8,10390,11287,9416,-1871
2016,3,23,9,10480,11336,9390,-1946
2016,3,23,10,11500,11882,9820,-2062
2016,3,23,11,13420,13340,11088,-2252
2016,3,23,12,14470,14442,12091,-2351
2016,3,23,13,14440,14679,12031,-2648
2016,3,23,14,14340,14707,12070,-2637
2016,3,23,15,14200,14562,12081,-2481
2016,3,23,16,13890,14346,12078,-2268
2016,3,23,17,13690,13979,11758,-2221
2016,3,23,18,13550,13794,11569,-2225
2016,3,23,19,13400,13655,11672,-1983
2016,3,23,20,13280,13533,11380,-2153
2016,3,23,21,13310,13780,11536,-2244
2016,3,23,22,13500,14275,12405,-1870
2016,3,23,23,14090,14609,12618,-1991
2016,3,24,0,14880,15037,12730,-2307
2016,3,24,1,14620,14711,12266,-2445
2016,3,24,2,13680,13762,11363,-2399
2016,3,24,3,12440,12465,10208,-2257
2016,3,24,4,11310,11528,9512,-2016
2016,3,24,5,10660,11550,9164,-2386
2016,3,24,6,10290,11390,9127,-2263
2016,3,24,7,10110,11355,9210,-2145
2016,3,24,8,10120,11353,9132,-2221
2016,3,24,9,10370,11682,9382,-2300
2016,3,24,10,11440,12446,10173,-2273
2016,3,24,11,13330,13291,11346,-1945
2016,3,24,12,14480,14340,12122,-2218
2016,3,24,13,14730,14448,12278,-2170
2016,3,24,14,14690,14336,12235,-2101
2016,3,24,15,14730,14265,12171,-2094
2016,3,24,16,14580,14226,12194,-2032
2016,3,24,17,14310,14129,12110,-2019
2016,3,24,18,14250,14163,12154,-2009
2016,3,24,19,14140,14113,11946,-2167
2016,3,24,20,14140,14081,12018,-2063
2016,3,24,21,14320,14284,12045,-2239
2016,3,24,22,14720,14663,12448,-2215
2016,3,24,23,15090,15035,12768,-2267
2016,3,25,0,15300,15451,13113,-2338
2016,3,25,1,15200,15125,12963,-2162
2016,3,25,2,14260,14260,12415,-1845
2016,3,25,3,12940,13043,11106,-1937
2016,3,25,4,11750,11883,9822,-2061
2016,3,25,5,10950,11522,9420,-2102
2016,3,25,6,10340,11479,9435,-2044
2016,3,25,7,10010,11474,9366,-2108
2016,3,25,8,9920,11391,9389,-2002
2016,3,25,9,10410,11372,9266,-2106
2016,3,25,10,11050,11617,9466,-2151
2016,3,25,11,12060,12655,10563,-2092
2016,3,25,12,12830,13726,11453,-2273
2016,3,25,13,13270,14398,11964,-2434
2016,3,25,14,13600,14816,12354,-2462
2016,3,25,15,13600,15033,12448,-2585
2016,3,25,16,13440,15002,12357,-2645
2016,3,25,17,13210,14777,11880,-2897
2016,3,25,18,13060,14559,11538,-3021
2016,3,25,19,12840,14202,11633,-2569
2016,3,25,20,12720,13881,11509,-2372
2016,3,25,21,12790,13887,11546,-2341
2016,3,25,22,13050,14122,11640,-2482
2016,3,25,23,13290,14232,11469,-2763
2016,3,26,0,14000,14426,11888,-2538
2016,3,26,1,13640,14113,11992,-2121
2016,3,26,2,12980,13400,11348,-2052
2016,3,26,3,12060,12458,10394,-2064
2016,3,26,4,11120,11600,9528,-2072
2016,3,26,5,10630,11281,9389,-1892
2016,3,26,6,10220,11156,9266,-1890
2016,3,26,7,10040,11191,9117,-2074
2016,3,26,8,9980,11121,8824,-2297
2016,3,26,9,10110,11225,8972,-2253
2016,3,26,10,10460,11490,9252,-2238
2016,3,26,11,11030,11804,9631,-2173
2016,3,26,12,11630,12251,9974,-2277
2016,3,26,13,12250,12864,10696,-2168
2016,3,26,14,12430,13363,11200,-2163
2016,3,26,15,12250,13386,11247,-2139
2016,3,26,16,11990,13216,10979,-2237
2016,3,26,17,11690,12942,10829,-2113
2016,3,26,18,11370,12519,10399,-2120
2016,3,26,19,11240,12011,10140,-1871
2016,3,26,20,11310,11929,10064,-1865
2016,3,26,21,11640,12158,9778,-2380
2016,3,26,22,12260,12406,10182,-2224
2016,3,26,23,12910,12961,10551,-2410
2016,3,27,0,13660,13753,11166,-2587
2016,3,27,1,13590,13852,11450,-2402
2016,3,27,2,13020,13341,11046,-2295
2016,3,27,3,12220,12536,10339,-2197
2016,3,27,4,11300,11802,9572,-2230
2016,3,27,5,10660,11829,9219,-2610
2016,3,27,6,10250,11450,9002,-2448
2016,3,27,7,10060,11198,8888,-2310
2016,3,27,8,10030,11187,8781,-2406
2016,3,27,9,10130,11237,8880,-2357
2016,3,27,10,10460,11347,8923,-2424
2016,3,27,11,10910,11626,9164,-2462
2016,3,27,12,11520,12142,9533,-2609
2016,3,27,13,12250,12586,10180,-2406
2016,3,27,14,12630,13101,10746,-2355
2016,3,27,15,12730,13227,10857,-2370
2016,3,27,16,12690,12909,10627,-2282
2016,3,27,17,12540,12291,10210,-2081
2016,3,27,18,12280,11526,9638,-1888
2016,3,27,19,12020,11208,9426,-1782
2016,3,27,20,11990,11316,9574,-1742
2016,3,27,21,12280,11495,9773,-1722
2016,3,27,22,12880,11527,9634,-1893
2016,3,27,23,13410,12181,10067,-2114
2016,3,28,0,14150,13320,11097,-2223
2016,3,28,1,14000,13568,11318,-2250
2016,3,28,2,13220,12924,10670,-2254
2016,3,28,3,12170,11926,9929,-1997
2016,3,28,4,11180,11085,9113,-1972
2016,3,28,5,10410,11094,8628,-2466
2016,3,28,6,10090,10813,8309,-2504
2016,3,28,7,9980,10876,8338,-2538
2016,3,28,8,10040,10949,8415,-2534
2016,3,28,9,10430,11352,8804,-2548
2016,3,28,10,11430,12173,9817,-2356
2016,3,28,11,13450,13208,10834,-2374
2016,3,28,12,14700,14385,11811,-2574
2016,3,28,13,14940,14911,12358,-2553
2016,3,28,14,14990,15191,12710,-2481
2016,3,28,15,15070,15410,12932,-2478
2016,3,28,16,15000,15494,12931,-2563
2016,3,28,17,14880,15403,12683,-2720
2016,3,28,18,14780,15257,12503,-2754
2016,3,28,19,14580,14964,12405,-2559
2016,3,28,20,14460,14809,12379,-2430
2016,3,28,21,14600,14811,12382,-2429
2016,3,28,22,14940,15044,12492,-2552
2016,3,28,23,15260,15217,12421,-2796
2016,3,29,0,15650,15543,12617,-2926
2016,3,29,1,15220,15184,12486,-2698
2016,3,29,2,14190,14140,11866,-2274
2016,3,29,3,12830,12918,10629,-2289
2016,3,29,4,11630,11861,9459,-2402
2016,3,29,5,10840,11738,9089,-2649
2016,3,29,6,10440,11705,8873,-2832
2016,3,29,7,10280,11610,8706,-2904
2016,3,29,8,10290,11603,8751,-2852
2016,3,29,9,10630,11925,9176,-2749
2016,3,29,10,11670,12537,9921,-2616
2016,3,29,11,13530,13518,11094,-2424
2016,3,29,12,14460,14480,11955,-2525
2016,3,29,13,14420,14549,12317,-2232
2016,3,29,14,14240,14361,12089,-2272
2016,3,29,15,14070,14209,11877,-2332
2016,3,29,16,13880,13940,11600,-2340
2016,3,29,17,13790,13661,11417,-2244
2016,3,29,18,13590,13765,11582,-2183
2016,3,29,19,13430,13555,11192,-2363
2016,3,29,20,13390,13454,10989,-2465
2016,3,29,21,13690,13405,10855,-2550
2016,3,29,22,14220,13905,11408,-2497
2016,3,29,23,14790,14439,11681,-2758
2016,3,30,0,15570,15206,12350,-2856
2016,3,30,1,15310,15210,12496,-2714
2016,3,30,2,14390,14297,12010,-2287
2016,3,30,3,13100,12981,10646,-2335
2016,3,30,4,11950,11960,9538,-2422
2016,3,30,5,11200,11745,8836,-2909
2016,3,30,6,10810,11767,8704,-3063
2016,3,30,7,10680,11603,8620,-2983
2016,3,30,8,10730,11876,8720,-3156
2016,3,30,9,11080,12025,9027,-2998
2016,3,30,10,12160,12453,9538,-2915
2016,3,30,11,14070,13907,11364,-2543
2016,3,30,12,14930,14785,12047,-2738
2016,3,30,13,14530,14530,11840,-2690
2016,3,30,14,14110,14113,11272,-2841
2016,3,30,15,13790,13761,10838,-2923
2016,3,30,16,13370,13482,10558,-2924
2016,3,30,17,13170,13187,10446,-2741
2016,3,30,18,13020,13079,10345,-2734
2016,3,30,19,12910,13131,10406,-2725
2016,3,30,20,12880,13073,10418,-2655
2016,3,30,21,13190,13115,10579,-2536
2016,3,30,22,13760,13560,11074,-2486
2016,3,30,23,14330,14045,11400,-2645
2016,3,31,0,15070,14844,12184,-2660
2016,3,31,1,14910,14782,12065,-2717
2016,3,31,2,13970,13870,11357,-2513
2016,3,31,3,12680,12606,9936,-2670
2016,3,31,4,11520,11893,9215,-2678
2016,3,31,5,10730,11434,8967,-2467
2016,3,31,6,10300,11308,8726,-2582
2016,3,31,7,10120,11200,8873,-2327
2016,3,31,8,10110,11277,8834,-2443
2016,3,31,9,10420,11447,8806,-2641
2016,3,31,10,11400,11812,9388,-2424
2016,3,31,11,13150,13093,11449,-1644
2016,3,31,12,14170,13941,12349,-1592
2016,3,31,13,14030,13855,12619,-1236
2016,3,31,14,13780,13681,12364,-1317
2016,3,31,15,13590,13628,11973,-1655
2016,3,31,16,13320,13587,12043,-1544
2016,3,31,17,13170,13390,11769,-1621
2016,3,31,18,13150,13324,11983,-1341
2016,3,31,19,13160,13232,11824,-1408
2016,3,31,20,13190,13151,11257,-1894
2016,3,31,21,13370,13345,10808,-2537
2016,3,31,22,13720,13642,10722,-2920
2016,3,31,23,14060,13876,10940,-2936
2016,4,1,0,14640,14520,11595,-2925
2016,4,1,1,14560,14345,11907,-2438
2016,4,1,2,13520,13438,11357,-2081
2016,4,1,3,12210,12165,10253,-1912
2016,4,1,4,11050,11461,9699,-1762
2016,4,1,5,10260,10988,9229,-1759
2016,4,1,6,9810,10777,9196,-1581
2016,4,1,7,9600,10552,9015,-1537
2016,4,1,8,9530,10461,8791,-1670
2016,4,1,9,9830,10700,8993,-1707
2016,4,1,10,10570,11416,9810,-1606
2016,4,1,11,12190,12349,11148,-1201
2016,4,1,12,13450,13407,12199,-1208
2016,4,1,13,13980,13847,12655,-1192
2016,4,1,14,14160,14150,13143,-1007
2016,4,1,15,14320,14366,13360,-1006
2016,4,1,16,14370,14403,13351,-1052
2016,4,1,17,14180,14354,13296,-1058
2016,4,1,18,14080,14240,13153,-1087
2016,4,1,19,13930,13920,13021,-899
2016,4,1,20,13780,13611,12834,-777
2016,4,1,21,13750,13646,13018,-628
2016,4,1,22,13910,13804,13107,-697
2016,4,1,23,13930,13835,13025,-810
2016,4,2,0,14160,14172,13277,-895
2016,4,2,1,13840,13966,13237,-729
2016,4,2,2,13090,13137,12605,-532
2016,4,2,3,12060,12110,11691,-419
2016,4,2,4,11020,11429,10641,-788
2016,4,2,5,10200,10515,9781,-734
2016,4,2,6,9690,10159,9196,-963
2016,4,2,7,9450,10052,8928,-1124
2016,4,2,8,9310,9988,8967,-1021
2016,4,2,9,9320,10051,9144,-907
2016,4,2,10,9720,10138,9170,-968
2016,4,2,11,10440,10523,9549,-974
2016,4,2,12,11290,11326,10283,-1043
2016,4,2,13,12140,12068,11224,-844
2016,4,2,14,12680,12892,11785,-1107
2016,4,2,15,12810,13338,12130,-1208
2016,4,2,16,12810,13534,12548,-986
2016,4,2,17,12680,13377,12509,-868
2016,4,2,18,12460,13097,12350,-747
2016,4,2,19,12290,12832,11892,-940
2016,4,2,20,12170,12664,11561,-1103
2016,4,2,21,12270,12739,11813,-926
2016,4,2,22,12700,12813,11726,-1087
2016,4,2,23,13050,13079,11997,-1082
2016,4,3,0,13460,13508,12259,-1249
2016,4,3,1,13290,13412,12379,-1033
2016,4,3,2,12720,12804,11892,-912
2016,4,3,3,11930,12006,11006,-1000
2016,4,3,4,11020,11225,10330,-895
2016,4,3,5,10310,11069,9779,-1290
2016,4,3,6,9910,10978,9530,-1448
2016,4,3,7,9680,10952,9428,-1524
2016,4,3,8,9600,10990,9486,-1504
2016,4,3,9,9770,11076,9462,-1614
2016,4,3,10,10060,11326,9770,-1556
2016,4,3,11,10650,11692,10323,-1369
2016,4,3,12,11380,12357,10885,-1472
2016,4,3,13,12270,12382,10730,-1652
2016,4,3,14,12990,13065,11345,-1720
2016,4,3,15,13280,13408,11873,-1535
2016,4,3,16,13400,13465,11940,-1525
2016,4,3,17,13320,13326,11821,-1505
2016,4,3,18,13220,13178,11691,-1487
2016,4,3,19,13040,13064,11381,-1683
2016,4,3,20,13070,13240,11453,-1787
2016,4,3,21,13600,13479,11738,-1741
2016,4,3,22,14230,13714,12062,-1652
2016,4,3,23,14740,14250,12447,-1803
2016,4,4,0,15550,15048,13112,-1936
2016,4,4,1,14940,15153,13368,-1785
2016,4,4,2,14210,14301,12554,-1747
2016,4,4,3,13140,13247,11526,-1721
2016,4,4,4,12100,12684,11206,-1478
2016,4,4,5,11460,12339,10711,-1628
2016,4,4,6,11130,12136,10282,-1854
2016,4,4,7,11000,11983,10131,-1852
2016,4,4,8,11070,11587,9874,-1713
2016,4,4,9,11410,11764,10242,-1522
2016,4,4,10,12520,12416,10880,-1536
2016,4,4,11,14430,14232,12435,-1797
2016,4,4,12,15580,15463,13637,-1826
2016,4,4,13,15800,15978,14062,-1916
2016,4,4,14,15910,16284,14329,-1955
2016,4,4,15,15990,16526,14564,-1962
2016,4,4,16,15920,16621,14592,-2029
2016,4,4,17,15770,16600,14630,-1970
2016,4,4,18,15630,16528,14623,-1905
2016,4,4,19,15410,16270,14411,-1859
2016,4,4,20,15310,16157,14310,-1847
2016,4,4,21,15330,16266,14420,-1846
2016,4,4,22,15800,16525,14699,-1826
2016,4,4,23,16190,16682,14757,-1925
2016,4,5,0,16800,16956,15033,-1923
2016,4,5,1,16410,16638,14762,-1876
2016,4,5,2,15400,15573,13706,-1867
2016,4,5,3,14040,14396,12459,-1937
2016,4,5,4,12800,13587,11663,-1924
2016,4,5,5,12070,12908,10953,-1955
2016,4,5,6,11710,12364,10413,-1951
2016,4,5,7,11600,12466,10495,-1971
2016,4,5,8,11670,12504,10536,-1968
2016,4,5,9,12060,12892,10615,-2277
2016,4,5,10,13290,13410,11211,-2199
2016,4,5,11,15140,14906,13026,-1880
2016,4,5,12,16140,15912,13890,-2022
2016,4,5,13,16200,16045,13957,-2088
2016,4,5,14,15980,15921,13817,-2104
2016,4,5,15,15650,15769,13546,-2223
2016,4,5,16,15310,15539,13315,-2224
2016,4,5,17,15060,15210,13001,-2209
2016,4,5,18,14860,15012,12842,-2170
2016,4,5,19,14590,14838,12630,-2208
2016,4,5,20,14460,14592,12365,-2227
2016,4,5,21,14690,14674,12398,-2276
2016,4,5,22,15230,15078,12791,-2287
2016,4,5,23,15790,15261,12968,-2293
2016,4,6,0,16480,15952,13594,-2358
2016,4,6,1,16370,16089,13868,-2221
2016,4,6,2,15390,15217,13035,-2182
2016,4,6,3,14060,13941,11649,-2292
2016,4,6,4,12930,12818,10611,-2207
2016,4,6,5,12200,12792,10429,-2363
2016,4,6,6,11930,12697,10363,-2334
2016,4,6,7,11830,12627,10237,-2390
2016,4,6,8,11910,12458,10174,-2284
2016,4,6,9,12310,12693,10418,-2275
2016,4,6,10,13110,13217,11042,-2175
2016,4,6,11,14930,14825,12753,-2072
2016,4,6,12,15850,15726,13691,-2035
2016,4,6,13,15760,15520,13339,-2181
2016,4,6,14,15510,15156,12985,-2171
2016,4,6,15,15370,14937,12612,-2325
2016,4,6,16,15280,14692,12406,-2286
2016,4,6,17,15150,14305,12205,-2100
2016,4,6,18,15060,14116,11947,-2169
2016,4,6,19,14920,13986,12148,-1838
2016,4,6,20,14850,14170,12286,-1884
2016,4,6,21,15010,14636,12677,-1959
2016,4,6,22,15340,15181,13196,-1985
2016,4,6,23,15710,15493,13153,-2340
2016,4,7,0,16300,15930,13710,-2220
2016,4,7,1,15880,15703,13508,-2195
2016,4,7,2,14850,14700,12526,-2174
2016,4,7,3,13510,13312,10970,-2342
2016,4,7,4,12310,12204,10232,-1972
2016,4,7,5,11560,11549,9360,-2189
2016,4,7,6,11000,11340,9168,-2172
2016,4,7,7,10760,11136,9083,-2053
2016,4,7,8,10680,11343,9242,-2101
2016,4,7,9,10800,11427,9384,-2043
2016,4,7,10,11780,11782,9935,-1847
2016,4,7,11,13540,13474,11351,-2123
2016,4,7,12,14580,14407,12349,-2058
2016,4,7,13,14770,14577,12490,-2087
2016,4,7,14,14820,14718,12749,-1969
2016,4,7,15,14930,14782,12883,-1899
2016,4,7,16,14840,14833,12819,-2014
2016,4,7,17,14860,14795,12955,-1840
2016,4,7,18,14830,14811,13023,-1788
2016,4,7,19,14860,14769,12924,-1845
2016,4,7,20,14620,14821,12744,-2077
2016,4,7,21,14600,14984,12912,-2072
2016,4,7,22,14810,15089,12962,-2127
2016,4,7,23,14850,15080,13003,-2077
2016,4,8,0,15010,15187,13062,-2125
2016,4,8,1,14830,14861,12885,-1976
2016,4,8,2,13940,13879,12008,-1871
2016,4,8,3,12620,12672,10977,-1695
2016,4,8,4,11460,12057,10347,-1710
2016,4,8,5,10560,11779,10016,-1763
2016,4,8,6,10150,11568,10096,-1472
2016,4,8,7,9940,11350,9893,-1457
2016,4,8,8,9910,11316,9981,-1335
2016,4,8,9,10240,11597,10208,-1389
2016,4,8,10,11220,12407,10683,-1724
2016,4,8,11,12940,13362,11596,-1766
2016,4,8,12,13960,13944,12201,-1743
2016,4,8,13,14250,14010,12552,-1458
2016,4,8,14,14310,13984,12412,-1572
2016,4,8,15,14280,14029,12326,-1703
2016,4,8,16,14200,13997,12243,-1754
2016,4,8,17,14010,13777,11996,-1781
2016,4,8,18,13900,13658,12083,-1575
2016,4,8,19,13690,13554,11957,-1597
2016,4,8,20,13560,13470,11798,-1672
2016,4,8,21,13720,13669,12138,-1531
2016,4,8,22,13980,13958,12341,-1617
2016,4,8,23,14150,14164,12386,-1778
2016,4,9,0,14530,14538,12817,-1721
2016,4,9,1,14410,14513,12895,-1618
2016,4,9,2,13710,13827,12150,-1677
2016,4,9,3,12770,12858,11251,-1607
2016,4,9,4,11770,12076,10502,-1574
2016,4,9,5,10940,11656,9823,-1833
2016,4,9,6,10600,11641,9734,-1907
2016,4,9,7,10360,11621,9709,-1912
2016,4,9,8,10310,11573,9584,-1989
2016,4,9,9,10450,11523,9586,-1937
2016,4,9,10,11050,11814,9710,-2104
2016,4,9,11,11770,12192,10009,-2183
2016,4,9,12,12540,12449,10367,-2082
2016,4,9,13,13180,12832,10892,-1940
2016,4,9,14,13500,12883,11061,-1822
2016,4,9,15,13520,12783,11126,-1657
2016,4,9,16,13350,12576,10930,-1646
2016,4,9,17,13050,12436,10715,-1721
2016,4,9,18,12740,12331,10680,-1651
2016,4,9,19,12540,12356,10834,-1522
2016,4,9,20,12450,12472,10854,-1618
2016,4,9,21,12680,12725,10697,-2028
2016,4,9,22,13140,13125,10904,-2221
2016,4,9,23,13520,13398,11119,-2279
2016,4,10,0,13940,13831,11560,-2271
2016,4,10,1,13920,13850,11616,-2234
2016,4,10,2,13400,13276,11074,-2202
2016,4,10,3,12600,12480,10349,-2131
2016,4,10,4,11730,11855,9837,-2018
2016,4,10,5,11120,11219,9206,-2013
2016,4,10,6,10760,11079,9003,-2076
2016,4,10,7,10590,11241,9155,-2086
2016,4,10,8,10560,11078,8874,-2204
2016,4,10,9,10680,11037,8827,-2210
2016,4,10,10,10900,11566,9409,-2157
2016,4,10,11,11350,11665,9610,-2055
2016,4,10,12,11770,11755,9914,-1841
2016,4,10,13,12210,12176,10536,-1640
2016,4,10,14,12530,12378,10884,-1494
2016,4,10,15,12540,12357,10645,-1712
2016,4,10,16,12460,12269,10613,-1656
2016,4,10,17,12260,12091,10438,-1653
2016,4,10,18,12000,11822,10152,-1670
2016,4,10,19,11790,11635,9997,-1638
2016,4,10,20,11820,11650,9967,-1683
2016,4,10,21,12230,11993,10129,-1864
2016,4,10,22,12860,12609,10569,-2040
2016,4,10,23,13500,13160,10989,-2171
2016,4,11,0,14360,13912,11765,-2147
2016,4,11,1,14330,14191,12003,-2188
2016,4,11,2,13490,13399,11235,-2164
2016,4,11,3,12400,12246,10293,-1953
2016,4,11,4,11440,11234,9249,-1985
2016,4,11,5,10730,10854,8809,-2045
2016,4,11,6,10400,10897,8800,-2097
2016,4,11,7,10260,10795,8964,-1831
2016,4,11,8,10310,10813,9075,-1738
2016,4,11,9,10750,11117,9380,-1737
2016,4,11,10,11450,11698,10105,-1593
2016,4,11,11,13320,13249,11604,-1645
2016,4,11,12,14490,14459,12747,-1712
2016,4,11,13,14650,14813,12921,-1892
2016,4,11,14,14640,14867,12765,-2102
2016,4,11,15,14670,14752,12739,-2013
2016,4,11,16,14580,14643,12610,-2033
2016,4,11,17,14390,14499,12557,-1942
2016,4,11,18,14340,14257,12440,-1817
2016,4,11,19,14200,14057,12233,-1824
2016,4,11,20,14110,13806,12012,-1794
2016,4,11,21,14170,13898,12102,-1796
2016,4,11,22,14600,14263,12625,-1638
2016,4,11,23,14640,14568,12749,-1819
2016,4,12,0,15130,14946,12997,-1949
2016,4,12,1,14900,14731,12852,-1879
2016,4,12,2,13830,13704,11922,-1782
2016,4,12,3,12510,12353,10618,-1735
2016,4,12,4,11320,11437,9887,-1550
2016,4,12,5,10420,11022,9436,-1586
2016,4,12,6,9980,11020,9471,-1549
2016,4,12,7,9780,10865,9402,-1463
2016,4,12,8,9730,11045,9497,-1548
2016,4,12,9,10000,11025,9625,-1400
2016,4,12,10,11000,11599,10263,-1336
2016,4,12,11,12790,12722,11444,-1278
2016,4,12,12,13880,13842,12510,-1332
2016,4,12,13,14140,14259,12842,-1417
2016,4,12,14,14200,14452,13025,-1427
2016,4,12,15,14350,14656,13584,-1072
2016,4,12,16,14340,14696,13568,-1128
2016,4,12,17,14280,14602,13227,-1375
2016,4,12,18,14270,14501,13158,-1343
2016,4,12,19,14120,14189,12651,-1538
2016,4,12,20,14060,14038,12682,-1356
2016,4,12,21,14230,14226,12846,-1380
2016,4,12,22,14470,14170,12741,-1429
2016,4,12,23,14520,14166,12710,-1456
2016,4,13,0,14960,14562,13076,-1486
2016,4,13,1,14770,14771,13426,-1345
2016,4,13,2,13790,13896,12430,-1466
2016,4,13,3,12490,12651,11314,-1337
2016,4,13,4,11300,11607,10549,-1058
2016,4,13,5,10560,11592,10089,-1503
2016,4,13,6,10160,11508,10024,-1484
2016,4,13,7,10010,11366,9987,-1379
2016,4,13,8,10020,11359,9999,-1360
2016,4,13,9,10380,11398,10374,-1024
2016,4,13,10,11670,12194,11215,-979
2016,4,13,11,13410,13420,12362,-1058
2016,4,13,12,13950,14237,12795,-1442
2016,4,13,13,13720,14062,12592,-1470
2016,4,13,14,13410,13734,12596,-1138
2016,4,13,15,13140,13498,12290,-1208
2016,4,13,16,12960,13278,11781,-1497
2016,4,13,17,12760,13054,11455,-1599
2016,4,13,18,12640,12941,11425,-1516
2016,4,13,19,12540,12742,11218,-1524
2016,4,13,20,12520,12683,11054,-1629
2016,4,13,21,12890,12894,11118,-1776
2016,4,13,22,13450,13292,11412,-1880
2016,4,13,23,13980,13677,11679,-1998
2016,4,14,0,14590,14307,12364,-1943
2016,4,14,1,14660,14587,12858,-1729
2016,4,14,2,13620,13753,12021,-1732
2016,4,14,3,12320,12525,10925,-1600
2016,4,14,4,11170,11488,9997,-1491
2016,4,14,5,10690,11361,9625,-1736
2016,4,14,6,10270,11310,9464,-1846
2016,4,14,7,10120,11186,9198,-1988
2016,4,14,8,10130,11207,9253,-1954
2016,4,14,9,10540,11536,9462,-2074
2016,4,14,10,11590,11940,10159,-1781
2016,4,14,11,13320,13163,11380,-1783
2016,4,14,12,14220,14031,12214,-1817
2016,4,14,13,14060,13870,11755,-2115
2016,4,14,14,13810,13583,11461,-2122
2016,4,14,15,13460,13371,11378,-1993
2016,4,14,16,13270,13152,11327,-1825
2016,4,14,17,13030,12952,11026,-1926
2016,4,14,18,12900,12850,11061,-1789
2016,4,14,19,12700,12657,10848,-1809
2016,4,14,20,12600,12607,10826,-1781
2016,4,14,21,12790,12800,11061,-1739
2016,4,14,22,13240,13182,11306,-1876
2016,4,14,23,13550,13541,11654,-1887
2016,4,15,0,14280,14102,12018,-2084
2016,4,15,1,14500,14465,12276,-2189
2016,4,15,2,13630,13659,11636,-2023
2016,4,15,3,12410,12444,10752,-1692
2016,4,15,4,11250,11579,9913,-1666
2016,4,15,5,10590,10864,9338,-1526
2016,4,15,6,10290,10497,9417,-1080
2016,4,15,7,10130,10353,9211,-1142
2016,4,15,8,10140,10373,9131,-1242
2016,4,15,9,10490,10693,9023,-1670
2016,4,15,10,11480,11470,9733,-1737
2016,4,15,11,12970,13037,11302,-1735
2016,4,15,12,14000,13894,11948,-1946
2016,4,15,13,13720,13794,11823,-1971
2016,4,15,14,13460,13524,11776,-1748
2016,4,15,15,13230,13309,11805,-1504
2016,4,15,16,13010,13104,11772,-1332
2016,4,15,17,12770,12860,11613,-1247
2016,4,15,18,12600,12729,11508,-1221
2016,4,15,19,12410,12534,11449,-1085
2016,4,15,20,12290,12414,11311,-1103
2016,4,15,21,12420,12561,11154,-1407
2016,4,15,22,12670,12824,11302,-1522
2016,4,15,23,12900,13040,11342,-1698
2016,4,16,0,13460,13441,11654,-1787
2016,4,16,1,13770,13741,11993,-1748
2016,4,16,2,13090,13106,11279,-1827
2016,4,16,3,12130,12120,10373,-1747
2016,4,16,4,11140,11094,9680,-1414
2016,4,16,5,10470,10360,9364,-996
2016,4,16,6,10080,10188,9129,-1059
2016,4,16,7,9850,10128,8993,-1135
2016,4,16,8,9810,10224,9134,-1090
2016,4,16,9,9960,10358,9439,-919
2016,4,16,10,10240,10558,9574,-984
2016,4,16,11,10760,10840,9826,-1014
2016,4,16,12,11490,11443,10364,-1079
2016,4,16,13,12020,11891,11104,-787
2016,4,16,14,12230,12046,11270,-776
2016,4,16,15,12120,11972,11101,-871
2016,4,16,16,11900,11775,10905,-870
2016,4,16,17,11640,11534,10330,-1204
2016,4,16,18,11360,11230,10343,-887
2016,4,16,19,11210,11176,10179,-997
2016,4,16,20,11190,11288,10279,-1009
2016,4,16,21,11400,11535,10586,-949
2016,4,16,22,11710,11699,10589,-1110
2016,4,16,23,12220,12106,10848,-1258
2016,4,17,0,12690,12573,11161,-1412
2016,4,17,1,13050,12929,11711,-1218
2016,4,17,2,12510,12412,11042,-1370
2016,4,17,3,11730,11596,10515,-1081
2016,4,17,4,10820,10729,9594,-1135
2016,4,17,5,10150,10368,9030,-1338
2016,4,17,6,9710,10205,8980,-1225
2016,4,17,7,9520,10263,8940,-1323
2016,4,17,8,9450,10411,9083,-1328
2016,4,17,9,9550,10618,9099,-1519
2016,4,17,10,9810,10903,9259,-1644
2016,4,17,11,10060,11002,9383,-1619
2016,4,17,12,10510,10936,9420,-1516
2016,4,17,13,10950,11029,9723,-1306
2016,4,17,14,11180,11211,10047,-1164
2016,4,17,15,11160,11189,10176,-1013
2016,4,17,16,11080,11086,10133,-953
2016,4,17,17,10960,10953,10005,-948
2016,4,17,18,10830,10780,9852,-928
2016,4,17,19,10730,10676,9805,-871
2016,4,17,20,10790,10759,9796,-963
2016,4,17,21,11240,11149,9963,-1186
2016,4,17,22,11900,11748,10594,-1154
2016,4,17,23,12360,12171,11053,-1118
2016,4,18,0,12960,12639,11465,-1174
2016,4,18,1,13200,12999,11722,-1277
2016,4,18,2,12360,12273,11232,-1041
2016,4,18,3,11260,11255,10075,-1180
2016,4,18,4,10320,10761,9517,-1244
2016,4,18,5,9680,10608,9159,-1449
2016,4,18,6,9260,10616,9280,-1336
2016,4,18,7,9140,10472,9255,-1217
2016,4,18,8,9180,10471,9067,-1404
2016,4,18,9,9470,10778,9573,-1205
2016,4,18,10,10230,11300,10240,-1060
2016,4,18,11,11480,11653,10990,-663
2016,4,18,12,12440,12570,12118,-452
2016,4,18,13,12770,12906,12764,-142
2016,4,18,14,12890,12995,12660,-335
2016,4,18,15,13000,13057,12714,-343
2016,4,18,16,13020,12985,12671,-314
2016,4,18,17,12930,12854,12815,-39
2016,4,18,18,12960,12839,12668,-171
2016,4,18,19,12890,12762,12659,-103
2016,4,18,20,12930,12743,12683,-60
2016,4,18,21,13130,12971,12817,-154
2016,4,18,22,13500,13320,13056,-264
2016,4,18,23,13700,13497,13329,-168
2016,4,19,0,14040,13803,13371,-432
2016,4,19,1,14100,13884,13491,-393
2016,4,19,2,13110,12961,12200,-761
2016,4,19,3,11820,11804,11034,-770
2016,4,19,4,10690,11142,9982,-1160
2016,4,19,5,9930,10711,9338,-1373
2016,4,19,6,9570,10792,9127,-1665
2016,4,19,7,9380,10614,9014,-1600
2016,4,19,8,9390,10591,8978,-1613
2016,4,19,9,9710,10690,9188,-1502
2016,4,19,10,10670,11273,9870,-1403
2016,4,19,11,12150,12031,11112,-919
2016,4,19,12,13170,13005,12296,-709
2016,4,19,13,13400,13382,12751,-631
2016,4,19,14,13370,13446,12999,-447
2016,4,19,15,13310,13544,13192,-352
2016,4,19,16,13410,13483,13104,-379
2016,4,19,17,13310,13332,13026,-306
2016,4,19,18,13210,13188,12895,-293
2016,4,19,19,13090,12947,12714,-233
2016,4,19,20,12980,12877,12695,-182
2016,4,19,21,13200,13033,12631,-402
2016,4,19,22,13520,13322,12746,-576
2016,4,19,23,13740,13541,12869,-672
2016,4,20,0,14100,13864,13119,-745
2016,4,20,1,14250,14133,13456,-677
2016,4,20,2,13310,13249,12490,-759
2016,4,20,3,12040,12009,11049,-960
2016,4,20,4,10890,11355,10409,-946
2016,4,20,5,10170,11059,9614,-1445
2016,4,20,6,9760,10933,9326,-1607
2016,4,20,7,9590,10846,9232,-1614
2016,4,20,8,9600,10832,9202,-1630
2016,4,20,9,9940,11077,9440,-1637
2016,4,20,10,10910,11402,10224,-1178
2016,4,20,11,12400,12077,11429,-648
2016,4,20,12,13390,12965,12114,-851
2016,4,20,13,13440,13116,12451,-665
2016,4,20,14,13270,13013,12306,-707
2016,4,20,15,13100,12937,12379,-558
2016,4,20,16,12990,12833,12243,-590
2016,4,20,17,12820,12677,12166,-511
2016,4,20,18,12730,12653,12376,-277
2016,4,20,19,12640,12545,12228,-317
2016,4,20,20,12630,12509,12001,-508
2016,4,20,21,12860,12699,12075,-624
2016,4,20,22,13250,13044,12236,-808
2016,4,20,23,13380,13303,12415,-888
2016,4,21,0,13920,13652,12551,-1101
2016,4,21,1,14250,14017,13038,-979
2016,4,21,2,13280,13212,12353,-859
2016,4,21,3,12010,11976,10945,-1031
2016,4,21,4,10880,10851,9744,-1107
2016,4,21,5,10170,10419,9382,-1037
2016,4,21,6,9740,10287,9026,-1261
2016,4,21,7,9540,10379,9315,-1064
2016,4,21,8,9570,10389,8996,-1393
2016,4,21,9,9900,10708,9188,-1520
2016,4,21,10,10820,11295,10123,-1172
2016,4,21,11,12170,12140,11232,-908
2016,4,21,12,12990,13047,12177,-870
2016,4,21,13,12980,13130,12341,-789
2016,4,21,14,12840,13083,12269,-814
2016,4,21,15,12790,13070,12444,-626
2016,4,21,16,12700,13004,12326,-678
2016,4,21,17,12580,12916,12229,-687
2016,4,21,18,12600,12937,12329,-608
2016,4,21,19,12480,12911,12198,-713
2016,4,21,20,12550,12914,12196,-718
2016,4,21,21,12780,13080,12346,-734
2016,4,21,22,13140,13294,12322,-972
2016,4,21,23,13390,13403,12378,-1025
2016,4,22,0,13670,13677,12578,-1099
2016,4,22,1,13800,13940,13096,-844
2016,4,22,2,13120,13118,12315,-803
2016,4,22,3,11880,11871,11170,-701
2016,4,22,4,10760,10761,9977,-784
2016,4,22,5,10020,10313,9484,-829
2016,4,22,6,9560,10038,9144,-894
2016,4,22,7,9370,10073,9012,-1061
2016,4,22,8,9320,10158,9007,-1151
2016,4,22,9,9600,10494,9300,-1194
2016,4,22,10,10510,10974,10000,-974
2016,4,22,11,11940,11532,11047,-485
2016,4,22,12,13040,12666,12122,-544
2016,4,22,13,13360,13293,12748,-545
2016,4,22,14,13480,13526,12944,-582
2016,4,22,15,13600,13697,13169,-528
2016,4,22,16,13620,13701,13214,-487
2016,4,22,17,13540,13634,13086,-548
2016,4,22,18,13600,13751,13258,-493
2016,4,22,19,13490,13738,13048,-690
2016,4,22,20,13430,13769,13034,-735
2016,4,22,21,13500,13809,12840,-969
2016,4,22,22,13660,13847,12769,-1078
2016,4,22,23,13610,13729,12555,-1174
2016,4,23,0,13660,13818,12524,-1294
2016,4,23,1,13850,13819,12629,-1190
2016,4,23,2,13040,13076,12005,-1071
2016,4,23,3,11970,12028,10958,-1070
2016,4,23,4,10940,10965,10115,-850
2016,4,23,5,9970,10423,9819,-604
2016,4,23,6,9640,10191,9789,-402
2016,4,23,7,9310,10351,9924,-427
2016,4,23,8,9190,10273,9794,-479
2016,4,23,9,9220,10289,9769,-520
2016,4,23,10,9470,10180,9910,-270
2016,4,23,11,9830,10304,10147,-157
2016,4,23,12,10710,10824,10643,-181
2016,4,23,13,11540,11743,11650,-93
2016,4,23,14,11990,12333,12319,-14
2016,4,23,15,12020,12551,12659,108
2016,4,23,16,11970,12457,12691,234
2016,4,23,17,11800,12155,12255,100
2016,4,23,18,11630,11776,11774,-2
2016,4,23,19,11180,11479,11402,-77
2016,4,23,20,11040,11420,11225,-195
2016,4,23,21,11390,11567,11198,-369
2016,4,23,22,11790,11889,11250,-639
2016,4,23,23,12000,12124,11722,-402
2016,4,24,0,12380,12345,11753,-592
2016,4,24,1,12700,12691,12314,-377
2016,4,24,2,12150,12145,11910,-235
2016,4,24,3,11300,11290,11252,-38
2016,4,24,4,10370,10367,10489,122
2016,4,24,5,9840,10134,9927,-207
2016,4,24,6,9440,10334,10102,-232
2016,4,24,7,9210,10340,10040,-300
2016,4,24,8,9180,10248,9644,-604
2016,4,24,9,9260,10309,9872,-437
2016,4,24,10,9180,10528,10182,-346
2016,4,24,11,9440,10618,10356,-262
2016,4,24,12,10070,11059,10722,-337
2016,4,24,13,10770,10858,10940,82
2016,4,24,14,11160,11011,10854,-157
2016,4,24,15,11150,10955,10915,-40
2016,4,24,16,11050,10957,11070,113
2016,4,24,17,11000,10902,10779,-123
2016,4,24,18,10890,10764,10426,-338
2016,4,24,19,10770,10659,10329,-330
2016,4,24,20,10860,10771,10343,-428
2016,4,24,21,11300,11168,10939,-229
2016,4,24,22,11990,11841,11557,-284
2016,4,24,23,12470,12309,11878,-431
2016,4,25,0,12930,12796,12291,-505
2016,4,25,1,13180,13195,12613,-582
2016,4,25,2,12370,12407,11887,-520
2016,4,25,3,11290,11326,10679,-647
2016,4,25,4,10320,10296,9964,-332
2016,4,25,5,9720,9993,9153,-840
2016,4,25,6,9400,10153,8919,-1234
2016,4,25,7,9230,10324,8938,-1386
2016,4,25,8,9290,10458,9017,-1441
2016,4,25,9,9660,10801,9491,-1310
2016,4,25,10,10530,11313,10442,-871
2016,4,25,11,12200,12150,11685,-465
2016,4,25,12,13210,13279,12950,-329
2016,4,25,13,13350,13619,13175,-444
2016,4,25,14,13330,13673,12964,-709
2016,4,25,15,13350,13612,12689,-923
2016,4,25,16,13270,13460,12565,-895
2016,4,25,17,13180,13225,12363,-862
2016,4,25,18,13100,13206,12299,-907
2016,4,25,19,12960,13157,12262,-895
2016,4,25,20,12940,13153,12168,-985
2016,4,25,21,13180,13278,12355,-923
2016,4,25,22,13610,13553,12566,-987
2016,4,25,23,13780,13754,12727,-1027
2016,4,26,0,13990,14062,13011,-1051
2016,4,26,1,14080,14208,13149,-1059
2016,4,26,2,13110,13258,12126,-1132
2016,4,26,3,11780,11914,10900,-1014
2016,4,26,4,10640,10994,10033,-961
2016,4,26,5,9830,10679,9501,-1178
2016,4,26,6,9470,10687,9465,-1222
2016,4,26,7,9290,10675,9540,-1135
2016,4,26,8,9300,10655,9462,-1193
2016,4,26,9,9670,10692,9743,-949
2016,4,26,10,10640,11274,10635,-639
2016,4,26,11,12290,12236,11855,-381
2016,4,26,12,13480,13495,12600,-895
2016,4,26,13,13860,14013,13033,-980
2016,4,26,14,14000,14322,13438,-884
2016,4,26,15,14120,14606,13558,-1048
2016,4,26,16,14150,14763,13728,-1035
2016,4,26,17,14120,14747,13646,-1101
2016,4,26,18,14120,14690,13755,-935
2016,4,26,19,13980,14479,13608,-871
2016,4,26,20,13950,14384,13390,-994
2016,4,26,21,14220,14506,13552,-954
2016,4,26,22,14600,14815,13802,-1013
2016,4,26,23,14780,14930,13785,-1145
2016,4,27,0,14960,15030,13827,-1203
2016,4,27,1,15050,14969,13750,-1219
2016,4,27,2,14080,14019,12698,-1321
2016,4,27,3,12720,12661,11479,-1182
2016,4,27,4,11530,11877,10808,-1069
2016,4,27,5,10710,11726,10518,-1208
2016,4,27,6,10150,11395,10230,-1165
2016,4,27,7,10060,11378,10086,-1292
2016,4,27,8,10010,11463,10093,-1370
2016,4,27,9,10510,11780,10504,-1276
2016,4,27,10,11550,12201,10877,-1324
2016,4,27,11,13020,12977,11763,-1214
2016,4,27,12,13950,13805,12439,-1366
2016,4,27,13,13870,13611,12191,-1420
2016,4,27,14,13570,13310,11937,-1373
2016,4,27,15,13350,13143,12029,-1114
2016,4,27,16,13120,13023,11918,-1105
2016,4,27,17,12850,12825,11750,-1075
2016,4,27,18,12740,12760,11764,-996
2016,4,27,19,12670,12655,11546,-1109
2016,4,27,20,12630,12595,11488,-1107
2016,4,27,21,12740,12775,11680,-1095
2016,4,27,22,13130,13138,12047,-1091
2016,4,27,23,13340,13394,12169,-1225
2016,4,28,0,14050,13729,12392,-1337
2016,4,28,1,14320,14217,12983,-1234
2016,4,28,2,13480,13421,12370,-1051
2016,4,28,3,12090,12100,11046,-1054
2016,4,28,4,10940,11363,10263,-1100
2016,4,28,5,10330,11207,9734,-1473
2016,4,28,6,9970,10872,9416,-1456
2016,4,28,7,9830,10701,9236,-1465
2016,4,28,8,9880,10720,9209,-1511
2016,4,28,9,10060,11179,9676,-1503
2016,4,28,10,11030,11801,10346,-1455
2016,4,28,11,12610,12605,11252,-1353
2016,4,28,12,13360,13463,11965,-1498
2016,4,28,13,13400,13360,11941,-1419
2016,4,28,14,13120,13161,11832,-1329
2016,4,28,15,13050,13056,12023,-1033
2016,4,28,16,12830,12934,12103,-831
2016,4,28,17,12690,12770,12010,-760
2016,4,28,18,12610,12810,12037,-773
2016,4,28,19,12450,12831,12043,-788
2016,4,28,20,12540,12880,11912,-968
2016,4,28,21,12730,13086,11976,-1110
2016,4,28,22,13170,13382,12088,-1294
2016,4,28,23,13410,13626,12384,-1242
2016,4,29,0,13950,14014,12814,-1200
2016,4,29,1,14170,14288,12848,-1440
2016,4,29,2,13320,13458,12148,-1310
2016,4,29,3,12160,12176,10951,-1225
2016,4,29,4,11030,11371,10133,-1238
2016,4,29,5,10220,10891,9514,-1377
2016,4,29,6,9830,10627,9166,-1461
2016,4,29,7,9650,10668,9169,-1499
2016,4,29,8,9630,10688,9271,-1417
2016,4,29,9,9960,10792,9397,-1395
2016,4,29,10,10880,11015,9889,-1126
2016,4,29,11,12350,12338,11290,-1048
2016,4,29,12,13230,13351,12110,-1241
2016,4,29,13,13390,13424,12272,-1152
2016,4,29,14,13340,13294,12241,-1053
2016,4,29,15,13230,13184,12101,-1083
2016,4,29,16,13100,13014,11823,-1191
2016,4,29,17,12970,12803,11745,-1058
2016,4,29,18,12830,12697,11822,-875
2016,4,29,19,12670,12506,11790,-716
2016,4,29,20,12570,12433,11716,-717
2016,4,29,21,12630,12636,11864,-772
2016,4,29,22,12790,12878,12210,-668
2016,4,29,23,12870,13013,12185,-828
2016,4,30,0,13240,13311,12477,-834
2016,4,30,1,13600,13644,12898,-746
2016,4,30,2,12940,13026,12178,-848
2016,4,30,3,11930,12013,11063,-950
2016,4,30,4,10890,10957,10324,-633
2016,4,30,5,10200,10550,9856,-694
2016,4,30,6,9770,10359,9601,-758
2016,4,30,7,9550,10295,9457,-838
2016,4,30,8,9470,10230,9478,-752
2016,4,30,9,9580,10339,9567,-772
2016,4,30,10,9950,10671,9958,-713
2016,4,30,11,10400,10780,10357,-423
2016,4,30,12,11100,11078,10739,-339
2016,4,30,13,11700,11573,11508,-65
2016,4,30,14,11920,11679,11369,-310
2016,4,30,15,11930,11573,11028,-545
2016,4,30,16,11790,11452,10994,-458
2016,4,30,17,11600,11277,10783,-494
2016,4,30,18,11410,11130,10566,-564
2016,4,30,19,11280,11100,10561,-539
2016,4,30,20,11240,11167,10653,-514
2016,4,30,21,11460,11399,10700,-699
2016,4,30,22,11880,11711,10936,-775
2016,4,30,23,12140,11981,11286,-695
2016,5,1,0,12480,12243,11584,-659
2016,5,1,1,12800,12723,12025,-698
2016,5,1,2,12240,12260,11788,-472
2016,5,1,3,11430,11432,10798,-634
2016,5,1,4,10530,10519,9777,-742
2016,5,1,5,9760,9812,9196,-616
2016,5,1,6,9350,9559,8967,-592
2016,5,1,7,9100,9409,8699,-710
2016,5,1,8,9030,9338,8545,-793
2016,5,1,9,9090,9390,8542,-848
2016,5,1,10,9260,9601,8776,-825
2016,5,1,11,9550,9731,8769,-962
2016,5,1,12,10230,10336,9342,-994
2016,5,1,13,10980,11135,10365,-770
2016,5,1,14,11550,11736,11045,-691
2016,5,1,15,11770,12137,11550,-587
2016,5,1,16,11910,12408,11901,-507
2016,5,1,17,11930,12468,11690,-778
2016,5,1,18,11920,12440,11504,-936
2016,5,1,19,11780,12404,11613,-791
2016,5,1,20,11930,12506,11711,-795
2016,5,1,21,12230,12790,11967,-823
2016,5,1,22,12700,13255,12292,-963
2016,5,1,23,13000,13500,12317,-1183
2016,5,2,0,13250,13708,12577,-1131
2016,5,2,1,13450,13700,12643,-1057
2016,5,2,2,12590,12827,11925,-902
2016,5,2,3,11520,11694,10806,-888
2016,5,2,4,10480,10625,9835,-790
2016,5,2,5,9790,10323,9492,-831
2016,5,2,6,9400,10151,9283,-868
2016,5,2,7,9250,10302,9393,-909
2016,5,2,8,9280,10518,9548,-970
2016,5,2,9,9620,10721,9706,-1015
2016,5,2,10,10580,11352,10443,-909
2016,5,2,11,12200,12554,12051,-503
2016,5,2,12,13430,13738,13063,-675
2016,5,2,13,13700,14133,13485,-648
2016,5,2,14,13810,14332,13536,-796
2016,5,2,15,13860,14556,13663,-893
2016,5,2,16,13860,14678,13725,-953
2016,5,2,17,13800,14617,13602,-1015
2016,5,2,18,13730,14494,13512,-982
2016,5,2,19,13610,14327,13443,-884
2016,5,2,20,13580,14128,13208,-920
2016,5,2,21,13690,14259,13345,-914
2016,5,2,22,13980,14523,13476,-1047
2016,5,2,23,14070,14548,13423,-1125
2016,5,3,0,14210,14564,13508,-1056
2016,5,3,1,14350,14543,13510,-1033
2016,5,3,2,13420,13618,12728,-890
2016,5,3,3,12050,12252,11325,-927
2016,5,3,4,10860,11140,10242,-898
2016,5,3,5,10110,10803,9778,-1025
2016,5,3,6,9680,10614,9309,-1305
2016,5,3,7,9490,10644,9254,-1390
2016,5,3,8,9460,10674,9243,-1431
2016,5,3,9,9760,10964,9642,-1322
2016,5,3,10,10810,11467,10397,-1070
2016,5,3,11,12450,12578,11852,-726
2016,5,3,12,13600,13697,12676,-1021
2016,5,3,13,13860,14046,13241,-805
2016,5,3,14,13920,14143,13258,-885
2016,5,3,15,13990,14126,13201,-925
2016,5,3,16,13950,14211,13137,-1074
2016,5,3,17,13850,14122,13143,-979
2016,5,3,18,13790,14069,13282,-787
2016,5,3,19,13670,13931,13080,-851
2016,5,3,20,13680,13875,13145,-730
2016,5,3,21,13940,14016,13270,-746
2016,5,3,22,14320,14239,13302,-937
2016,5,3,23,14430,14331,13310,-1021
2016,5,4,0,14490,14457,13363,-1094
2016,5,4,1,14430,14520,13299,-1221
2016,5,4,2,13500,13635,12735,-900
2016,5,4,3,12170,12267,11471,-796
2016,5,4,4,11000,11179,10377,-802
2016,5,4,5,10220,10953,9906,-1047
2016,5,4,6,9800,10656,9737,-919
2016,5,4,7,9570,10668,9567,-1101
2016,5,4,8,9570,10661,9520,-1141
2016,5,4,9,9880,10925,9783,-1142
2016,5,4,10,10810,11242,10423,-819
2016,5,4,11,12420,12502,12009,-493
2016,5,4,12,13560,13642,12910,-732
2016,5,4,13,13730,13934,13106,-828
2016,5,4,14,13770,14039,13173,-866
2016,5,4,15,13750,14201,13291,-910
2016,5,4,16,13690,14207,13338,-869
2016,5,4,17,13600,14090,12988,-1102
2016,5,4,18,13570,14099,13044,-1055
2016,5,4,19,13480,14020,13039,-981
2016,5,4,20,13500,14025,12856,-1169
2016,5,4,21,13690,14236,13167,-1069
2016,5,4,22,14060,14564,13390,-1174
2016,5,4,23,14130,14745,13559,-1186
2016,5,5,0,14280,14849,13698,-1151
2016,5,5,1,14400,14780,13666,-1114
2016,5,5,2,13500,13839,12627,-1212
2016,5,5,3,12180,12482,11456,-1026
2016,5,5,4,10980,11309,10163,-1146
2016,5,5,5,10290,11022,9751,-1271
2016,5,5,6,9860,11040,9697,-1343
2016,5,5,7,9660,10890,9453,-1437
2016,5,5,8,9640,10867,9467,-1400
2016,5,5,9,9960,10928,9585,-1343
2016,5,5,10,11030,11568,10349,-1219
2016,5,5,11,12660,12735,11588,-1147
2016,5,5,12,13770,13913,12761,-1152
2016,5,5,13,14020,14235,13095,-1140
2016,5,5,14,14110,14341,13207,-1134
2016,5,5,15,14170,14446,13368,-1078
2016,5,5,16,14140,14435,13192,-1243
2016,5,5,17,14060,14293,12987,-1306
2016,5,5,18,14000,14285,12993,-1292
2016,5,5,19,13890,14205,12948,-1257
2016,5,5,20,13850,14187,12988,-1199
2016,5,5,21,13960,14306,13127,-1179
2016,5,5,22,14230,14502,13319,-1183
2016,5,5,23,14350,14575,13274,-1301
2016,5,6,0,14470,14678,13399,-1279
2016,5,6,1,14480,14685,13565,-1120
2016,5,6,2,13620,13814,12602,-1212
2016,5,6,3,12270,12509,11169,-1340
2016,5,6,4,11080,11806,10480,-1326
2016,5,6,5,10280,11311,10311,-1000
2016,5,6,6,9810,11134,10175,-959
2016,5,6,7,9580,11066,10011,-1055
2016,5,6,8,9520,11102,9939,-1163
2016,5,6,9,9800,11119,9857,-1262
2016,5,6,10,10900,11503,10225,-1278
2016,5,6,11,12350,12489,11645,-844
2016,5,6,12,13480,13512,12449,-1063
2016,5,6,13,13770,13757,12631,-1126
2016,5,6,14,13910,13797,12678,-1119
2016,5,6,15,13930,13663,12538,-1125
2016,5,6,16,13840,13460,12271,-1189
2016,5,6,17,13740,13154,11877,-1277
2016,5,6,18,13700,13137,11954,-1183
2016,5,6,19,13560,13073,11892,-1181
2016,5,6,20,13470,13079,11913,-1166
2016,5,6,21,13540,13202,12092,-1110
2016,5,6,22,13640,13420,12337,-1083
2016,5,6,23,13610,13529,12240,-1289
2016,5,7,0,13660,13652,12351,-1301
2016,5,7,1,13840,13777,12483,-1294
2016,5,7,2,13180,13175,12009,-1166
2016,5,7,3,12120,12147,11145,-1002
2016,5,7,4,11030,11042,10033,-1009
2016,5,7,5,10340,10501,9822,-679
2016,5,7,6,9840,10229,9513,-716
2016,5,7,7,9600,10152,9449,-703
2016,5,7,8,9510,10153,9378,-775
2016,5,7,9,9440,10225,9360,-865
2016,5,7,10,9780,10366,9556,-810
2016,5,7,11,10340,10359,9591,-768
2016,5,7,12,11160,11237,10510,-727
2016,5,7,13,11890,12142,11174,-968
2016,5,7,14,12360,12683,11721,-962
2016,5,7,15,12460,12862,11987,-875
2016,5,7,16,12430,12833,11953,-880
2016,5,7,17,12240,12604,11694,-910
2016,5,7,18,12070,12375,11414,-961
2016,5,7,19,11930,12242,11251,-991
2016,5,7,20,11920,12217,11213,-1004
2016,5,7,21,12080,12318,11237,-1081
2016,5,7,22,12360,12502,11301,-1201
2016,5,7,23,12580,12652,11365,-1287
2016,5,8,0,12760,12835,11555,-1280
2016,5,8,1,13100,13077,11780,-1297
2016,5,8,2,12420,12584,11421,-1163
2016,5,8,3,11520,11712,10483,-1229
2016,5,8,4,10600,10765,9499,-1266
2016,5,8,5,9820,10526,9048,-1478
2016,5,8,6,9340,10311,8690,-1621
2016,5,8,7,9100,10022,8392,-1630
2016,5,8,8,9000,9889,8370,-1519
2016,5,8,9,9130,9908,8341,-1567
2016,5,8,10,9260,10058,8472,-1586
2016,5,8,11,9540,10387,8865,-1522
2016,5,8,12,10290,10642,9244,-1398
2016,5,8,13,11040,11444,9978,-1466
2016,5,8,14,11620,11905,10594,-1311
2016,5,8,15,11930,12344,10966,-1378
2016,5,8,16,11840,12455,11126,-1329
2016,5,8,17,11740,12381,11086,-1295
2016,5,8,18,11420,11971,10837,-1134
2016,5,8,19,11350,11555,10458,-1097
2016,5,8,20,11360,11252,10079,-1173
2016,5,8,21,11650,11369,10113,-1256
2016,5,8,22,12140,11739,10440,-1299
2016,5,8,23,12540,12096,10896,-1200
2016,5,9,0,13030,12466,11204,-1262
2016,5,9,1,13200,13071,11832,-1239
2016,5,9,2,12580,12540,11190,-1350
2016,5,9,3,11510,11500,10188,-1312
2016,5,9,4,10440,10439,9062,-1377
2016,5,9,5,9740,10071,8749,-1322
2016,5,9,6,9370,9918,8638,-1280
2016,5,9,7,9220,10008,8593,-1415
2016,5,9,8,9240,10063,8682,-1381
2016,5,9,9,9630,10274,8823,-1451
2016,5,9,10,10530,11123,9556,-1567
2016,5,9,11,12140,12292,10897,-1395
2016,5,9,12,13160,13314,11962,-1352
2016,5,9,13,13270,13379,12038,-1341
2016,5,9,14,13330,13238,12030,-1208
2016,5,9,15,13340,13199,11651,-1548
2016,5,9,16,13270,13154,11515,-1639
2016,5,9,17,13200,13051,11477,-1574
2016,5,9,18,13170,13029,11575,-1454
2016,5,9,19,13030,12863,11180,-1683
2016,5,9,20,13000,12817,11196,-1621
2016,5,9,21,13120,12993,11408,-1585
2016,5,9,22,13610,13299,11669,-1630
2016,5,9,23,13810,13526,11906,-1620
2016,5,10,0,14180,13727,12059,-1668
2016,5,10,1,14270,14153,12544,-1609
2016,5,10,2,13380,13420,11839,-1581
2016,5,10,3,12040,12035,10486,-1549
2016,5,10,4,10870,10785,9172,-1613
2016,5,10,5,10130,10442,8879,-1563
2016,5,10,6,9690,10405,8745,-1660
2016,5,10,7,9510,10236,8671,-1565
2016,5,10,8,9470,10253,8671,-1582
2016,5,10,9,9790,10587,8942,-1645
2016,5,10,10,10630,11095,9515,-1580
2016,5,10,11,12280,12309,10816,-1493
2016,5,10,12,13240,13187,11742,-1445
2016,5,10,13,13230,13135,11649,-1486
2016,5,10,14,13120,13018,11533,-1485
2016,5,10,15,13080,13022,11514,-1508
2016,5,10,16,13040,13024,11357,-1667
2016,5,10,17,12970,12973,11341,-1632
2016,5,10,18,12990,13013,11367,-1646
2016,5,10,19,12930,13003,11331,-1672
2016,5,10,20,12870,13023,11409,-1614
2016,5,10,21,12950,13244,11701,-1543
2016,5,10,22,13220,13519,11986,-1533
2016,5,10,23,13500,13611,11903,-1708
2016,5,11,0,13840,13756,11919,-1837
2016,5,11,1,14100,14169,12264,-1905
2016,5,11,2,13430,13445,11731,-1714
2016,5,11,3,12030,12017,10329,-1688
2016,5,11,4,10780,10845,9303,-1542
2016,5,11,5,9970,10486,8927,-1559
2016,5,11,6,9600,10139,8622,-1517
2016,5,11,7,9450,10095,8555,-1540
2016,5,11,8,9430,10110,8544,-1566
2016,5,11,9,9660,10148,8813,-1335
2016,5,11,10,10540,10755,9716,-1039
2016,5,11,11,12180,12045,10836,-1209
2016,5,11,12,13230,13019,11641,-1378
2016,5,11,13,13360,13131,11752,-1379
2016,5,11,14,13360,13149,11766,-1383
2016,5,11,15,13430,13219,11971,-1248
2016,5,11,16,13400,13226,12117,-1109
2016,5,11,17,13330,13198,12060,-1138
2016,5,11,18,13350,13280,12147,-1133
2016,5,11,19,13350,13303,12270,-1033
2016,5,11,20,13340,13379,12099,-1280
2016,5,11,21,13570,13584,12281,-1303
2016,5,11,22,13790,13806,12397,-1409
2016,5,11,23,13810,13883,12324,-1559
2016,5,12,0,13880,13955,12396,-1559
2016,5,12,1,14240,14345,12766,-1579
2016,5,12,2,13450,13582,12109,-1473
2016,5,12,3,12060,12144,10960,-1184
2016,5,12,4,10820,10852,9942,-910
2016,5,12,5,10060,10005,9228,-777
2016,5,12,6,9600,9817,9119,-698
2016,5,12,7,9410,9604,8863,-741
2016,5,12,8,9340,9552,8709,-843
2016,5,12,9,9640,9791,8950,-841
2016,5,12,10,10450,10326,9603,-723
2016,5,12,11,11990,11823,10724,-1099
2016,5,12,12,12930,12891,11667,-1224
2016,5,12,13,13150,13144,11781,-1363
2016,5,12,14,13240,13248,11925,-1323
2016,5,12,15,13390,13373,12080,-1293
2016,5,12,16,13370,13440,12258,-1182
2016,5,12,17,13360,13458,12249,-1209
2016,5,12,18,13430,13571,12337,-1234
2016,5,12,19,13440,13613,12429,-1184
2016,5,12,20,13480,13708,12496,-1212
2016,5,12,21,13680,13920,12677,-1243
2016,5,12,22,13870,14100,12788,-1312
2016,5,12,23,13910,14072,12575,-1497
2016,5,13,0,14000,14099,12566,-1533
2016,5,13,1,14320,14458,13005,-1453
2016,5,13,2,13470,13714,12207,-1507
2016,5,13,3,12100,12296,10935,-1361
2016,5,13,4,10860,10974,9585,-1389
2016,5,13,5,10110,10303,9083,-1220
2016,5,13,6,9640,10115,9083,-1032
2016,5,13,7,9410,10211,9138,-1073
2016,5,13,8,9360,10138,9316,-822
2016,5,13,9,9610,10028,9325,-703
2016,5,13,10,10380,10755,9917,-838
2016,5,13,11,11950,11757,10725,-1032
2016,5,13,12,13110,12897,11374,-1523
2016,5,13,13,13550,13431,11990,-1441
2016,5,13,14,13770,13753,12472,-1281
2016,5,13,15,13940,13980,12825,-1155
2016,5,13,16,14030,14110,12748,-1362
2016,5,13,17,13970,14193,12509,-1684
2016,5,13,18,14100,14308,12379,-1929
2016,5,13,19,13950,14259,12307,-1952
2016,5,13,20,13940,14232,12332,-1900
2016,5,13,21,14020,14244,12159,-2085
2016,5,13,22,14120,14235,12300,-1935
2016,5,13,23,13920,14108,12107,-2001
2016,5,14,0,13900,14033,12178,-1855
2016,5,14,1,14050,14009,12213,-1796
2016,5,14,2,13340,13323,11716,-1607
2016,5,14,3,12230,12222,10961,-1261
2016,5,14,4,11100,11216,10129,-1087
2016,5,14,5,10270,10678,9439,-1239
2016,5,14,6,9730,10503,9566,-937
2016,5,14,7,9420,10414,9420,-994
2016,5,14,8,9280,10276,9107,-1169
2016,5,14,9,9320,10296,9082,-1214
2016,5,14,10,9520,10509,9160,-1349
2016,5,14,11,10030,10759,9433,-1326
2016,5,14,12,10810,11272,10003,-1269
2016,5,14,13,11580,11514,10138,-1376
2016,5,14,14,12010,11899,10425,-1474
2016,5,14,15,12240,12047,10710,-1337
2016,5,14,16,12430,12071,10731,-1340
2016,5,14,17,12330,12005,10799,-1206
2016,5,14,18,12270,11945,10740,-1205
2016,5,14,19,12180,11956,10808,-1148
2016,5,14,20,12250,12104,11010,-1094
2016,5,14,21,12480,12321,11318,-1003
2016,5,14,22,12820,12531,11421,-1110
2016,5,14,23,12960,12593,11435,-1158
2016,5,15,0,12990,12682,11474,-1208
2016,5,15,1,13220,13027,11889,-1138
2016,5,15,2,12720,12529,11657,-872
2016,5,15,3,11770,11602,10928,-674
2016,5,15,4,10750,10833,9953,-880
2016,5,15,5,9980,10080,8976,-1104
2016,5,15,6,9500,9607,8431,-1176
2016,5,15,7,9200,9569,8269,-1300
2016,5,15,8,9070,9574,8277,-1297
2016,5,15,9,9080,9632,8371,-1261
2016,5,15,10,9000,9687,8608,-1079
2016,5,15,11,9350,10014,8618,-1396
2016,5,15,12,10010,9902,8668,-1234
2016,5,15,13,10750,10550,9216,-1334
2016,5,15,14,11310,11109,9690,-1419
2016,5,15,15,11530,11352,10094,-1258
2016,5,15,16,11650,11391,10199,-1192
2016,5,15,17,11640,11446,10213,-1233
2016,5,15,18,11560,11440,10170,-1270
2016,5,15,19,11380,11543,10257,-1286
2016,5,15,20,11500,11721,10367,-1354
2016,5,15,21,11780,12018,10509,-1509
2016,5,15,22,12190,12379,10819,-1560
2016,5,15,23,12550,12600,11001,-1599
2016,5,16,0,12800,12787,11180,-1607
2016,5,16,1,13270,13118,11289,-1829
2016,5,16,2,12500,12465,10883,-1582
2016,5,16,3,11420,11348,10008,-1340
2016,5,16,4,10380,10312,8940,-1372
2016,5,16,5,9700,10084,8627,-1457
2016,5,16,6,9360,9859,8366,-1493
2016,5,16,7,9210,9707,8210,-1497
2016,5,16,8,9300,9742,8190,-1552
2016,5,16,9,9700,10116,8710,-1406
2016,5,16,10,10580,11031,9622,-1409
2016,5,16,11,12240,12149,10800,-1349
2016,5,16,12,13300,13219,11594,-1625
2016,5,16,13,13400,13514,11983,-1531
2016,5,16,14,13410,13661,12273,-1388
2016,5,16,15,13390,13640,12271,-1369
2016,5,16,16,13360,13487,12197,-1290
2016,5,16,17,13280,13296,11893,-1403
2016,5,16,18,13280,13218,11923,-1295
2016,5,16,19,13150,13048,11762,-1286
2016,5,16,20,13070,12976,11666,-1310
2016,5,16,21,13190,13145,11857,-1288
2016,5,16,22,13460,13485,12262,-1223
2016,5,16,23,13700,13730,12294,-1436
2016,5,17,0,13820,13842,12376,-1466
2016,5,17,1,14220,14178,12635,-1543
2016,5,17,2,13300,13488,12125,-1363
2016,5,17,3,11960,12125,10959,-1166
2016,5,17,4,10760,10892,9553,-1339
2016,5,17,5,10010,10474,9032,-1442
2016,5,17,6,9590,10428,8916,-1512
2016,5,17,7,9410,10552,9052,-1500
2016,5,17,8,9380,10532,9105,-1427
2016,5,17,9,9680,10705,9179,-1526
2016,5,17,10,10500,11395,9804,-1591
2016,5,17,11,12150,12314,10721,-1593
2016,5,17,12,13250,13535,12175,-1360
2016,5,17,13,13500,13826,12482,-1344
2016,5,17,14,13600,13832,12516,-1316
2016,5,17,15,13740,13570,12254,-1316
2016,5,17,16,13730,13401,12011,-1390
2016,5,17,17,13680,13328,11918,-1410
2016,5,17,18,13720,13474,12114,-1360
2016,5,17,19,13690,13553,12230,-1323
2016,5,17,20,13690,13523,12085,-1438
2016,5,17,21,13820,13532,12028,-1504
2016,5,17,22,14000,13694,12086,-1608
2016,5,17,23,14040,13754,12000,-1754
2016,5,18,0,14060,13800,12065,-1735
2016,5,18,1,14280,14092,12423,-1669
2016,5,18,2,13500,13434,11930,-1504
2016,5,18,3,12120,12044,10522,-1522
2016,5,18,4,10870,10799,9698,-1101
2016,5,18,5,10090,10430,8919,-1511
2016,5,18,6,9670,10326,8629,-1697
2016,5,18,7,9410,10177,8473,-1704
2016,5,18,8,9380,10366,8578,-1788
2016,5,18,9,9660,10173,8615,-1558
2016,5,18,10,10480,10600,9163,-1437
2016,5,18,11,12130,11849,10411,-1438
2016,5,18,12,13220,12895,11397,-1498
2016,5,18,13,13380,13113,11571,-1542
2016,5,18,14,13410,13179,11710,-1469
2016,5,18,15,13460,13265,11943,-1322
2016,5,18,16,13480,13096,11764,-1332
2016,5,18,17,13480,12995,11404,-1591
2016,5,18,18,13560,13066,11475,-1591
2016,5,18,19,13560,13007,11322,-1685
2016,5,18,20,13590,13020,11277,-1743
2016,5,18,21,13780,13224,11556,-1668
2016,5,18,22,13920,13500,11883,-1617
2016,5,18,23,13860,13604,12006,-1598
2016,5,19,0,13860,13682,11992,-1690
2016,5,19,1,14210,14012,12171,-1841
2016,5,19,2,13510,13384,11858,-1526
2016,5,19,3,12140,12038,10718,-1320
2016,5,19,4,10880,10761,9331,-1430
2016,5,19,5,9980,10102,8633,-1469
2016,5,19,6,9550,10010,8381,-1629
2016,5,19,7,9360,10066,8295,-1771
2016,5,19,8,9320,9991,8332,-1659
2016,5,19,9,9590,10247,8515,-1732
2016,5,19,10,10420,10625,9144,-1481
2016,5,19,11,12070,11870,10596,-1274
2016,5,19,12,13100,13016,12080,-936
2016,5,19,13,13330,13316,12362,-954
2016,5,19,14,13380,13434,12208,-1226
2016,5,19,15,13410,13496,11610,-1886
2016,5,19,16,13370,13473,11404,-2069
2016,5,19,17,13340,13408,12084,-1324
2016,5,19,18,13450,13533,11708,-1825
2016,5,19,19,13430,13542,11481,-2061
2016,5,19,20,13450,13582,12046,-1536
2016,5,19,21,13600,13693,12143,-1550
2016,5,19,22,13790,13775,11502,-2273
2016,5,19,23,13790,13732,12359,-1373
2016,5,20,0,13920,13769,12432,-1337
2016,5,20,1,14250,14034,12820,-1214
2016,5,20,2,13500,13376,12501,-875
2016,5,20,3,12120,12034,11072,-962
2016,5,20,4,10900,10795,9931,-864
2016,5,20,5,10130,10217,9370,-847
2016,5,20,6,9630,10059,9324,-735
2016,5,20,7,9380,10108,9038,-1070
2016,5,20,8,9320,10067,8779,-1288
2016,5,20,9,9580,10301,9023,-1278
2016,5,20,10,10340,10960,9872,-1088
2016,5,20,11,11800,12041,11255,-786
2016,5,20,12,12940,12826,11813,-1013
2016,5,20,13,13360,13122,12245,-877
2016,5,20,14,13560,13246,12365,-881
2016,5,20,15,13680,13355,12713,-642
2016,5,20,16,13750,13387,12821,-566
2016,5,20,17,13730,13388,12889,-499
2016,5,20,18,13830,13445,12894,-551
2016,5,20,19,13790,13422,12674,-748
2016,5,20,20,13830,13430,12691,-739
2016,5,20,21,13900,13530,13056,-474
2016,5,20,22,13980,13599,13085,-514
2016,5,20,23,13700,13530,12989,-541
2016,5,21,0,13560,13417,12753,-664
2016,5,21,1,13790,13638,12762,-876
2016,5,21,2,13280,13193,12534,-659
2016,5,21,3,12140,12082,11491,-591
2016,5,21,4,11000,10917,10357,-560
2016,5,21,5,10180,10132,9477,-655
2016,5,21,6,9690,9896,9181,-715
2016,5,21,7,9390,9970,9181,-789
2016,5,21,8,9280,9816,8964,-852
2016,5,21,9,9370,9862,8980,-882
2016,5,21,10,9310,10013,9306,-707
2016,5,21,11,9850,10364,9862,-502
2016,5,21,12,10650,10714,10296,-418
2016,5,21,13,11390,11427,11093,-334
2016,5,21,14,11910,11937,11712,-225
2016,5,21,15,12130,12278,11935,-343
2016,5,21,16,12170,12440,12272,-168
2016,5,21,17,12070,12467,12276,-191
2016,5,21,18,11970,12346,12419,73
2016,5,21,19,11930,12169,12635,466
2016,5,21,20,11940,12069,12487,418
2016,5,21,21,12150,12169,11733,-436
2016,5,21,22,12460,12391,11851,-540
2016,5,21,23,12560,12464,11994,-470
2016,5,22,0,12640,12513,12038,-475
2016,5,22,1,12960,12769,12296,-473
2016,5,22,2,12450,12338,12117,-221
2016,5,22,3,11490,11462,11269,-193
2016,5,22,4,10530,10476,10287,-189
2016,5,22,5,9790,9978,9445,-533
2016,5,22,6,9300,10006,9276,-730
2016,5,22,7,9050,9774,9371,-403
2016,5,22,8,8930,9647,9142,-505
2016,5,22,9,8950,9650,9136,-514
2016,5,22,10,8930,9719,9179,-540
2016,5,22,11,9250,9787,9209,-578
2016,5,22,12,9950,10257,9953,-304
2016,5,22,13,10820,10990,10962,-28
2016,5,22,14,11440,11610,11731,121
2016,5,22,15,11740,11935,11505,-430
2016,5,22,16,11930,11987,11967,-20
2016,5,22,17,11990,11966,11937,-29
2016,5,22,18,11980,11753,11620,-133
2016,5,22,19,11850,11709,11547,-162
2016,5,22,20,11940,11768,11666,-102
2016,5,22,21,12190,12058,11877,-181
2016,5,22,22,12580,12526,12438,-88
2016,5,22,23,12780,12790,12632,-158
2016,5,23,0,12900,12910,12699,-211
2016,5,23,1,13210,13235,12990,-245
2016,5,23,2,12600,12695,12737,42
2016,5,23,3,11490,11529,11552,23
2016,5,23,4,10460,10374,10036,-338
2016,5,23,5,9800,9814,9213,-601
2016,5,23,6,9260,9428,8848,-580
2016,5,23,7,9070,9543,8871,-672
2016,5,23,8,9080,9767,9111,-656
2016,5,23,9,9250,9858,9242,-616
2016,5,23,10,10130,10465,9972,-493
2016,5,23,11,11710,11695,11380,-315
2016,5,23,12,12930,12853,12636,-217
2016,5,23,13,13430,13243,12982,-261
2016,5,23,14,13780,13481,13128,-353
2016,5,23,15,14030,13731,13389,-342
2016,5,23,16,14110,13890,12903,-987
2016,5,23,17,14090,14008,13135,-873
2016,5,23,18,14170,14210,13693,-517
2016,5,23,19,14160,14229,13678,-551
2016,5,23,20,14220,14341,13786,-555
2016,5,23,21,14360,14481,13863,-618
2016,5,23,22,14600,14556,13626,-930
2016,5,23,23,14590,14508,13701,-807
2016,5,24,0,14480,14473,13985,-488
2016,5,24,1,14520,14662,14491,-171
2016,5,24,2,13720,13873,13764,-109
2016,5,24,3,12330,12416,12189,-227
2016,5,24,4,11030,11106,10767,-339
2016,5,24,5,10260,10447,9863,-584
2016,5,24,6,9830,10248,9640,-608
2016,5,24,7,9570,10267,9509,-758
2016,5,24,8,9510,10212,9346,-866
2016,5,24,9,9790,10427,9544,-883
2016,5,24,10,10570,10987,10281,-706
2016,5,24,11,12220,12103,11521,-582
2016,5,24,12,13470,13242,12787,-455
2016,5,24,13,13900,13700,13286,-414
2016,5,24,14,14110,13960,13724,-236
2016,5,24,15,14310,14185,13545,-640
2016,5,24,16,14450,14258,13378,-880
2016,5,24,17,14410,14210,13419,-791
2016,5,24,18,14480,14203,13245,-958
2016,5,24,19,14440,14107,13944,-163
2016,5,24,20,14400,14078,14097,19
2016,5,24,21,14550,14550,14097,-9999
2016,5,24,22,14600,14600,13626,-9999
2016,5,24,23,14540,14540,13701,-9999
2016,5,25,0,14510,14199,14147,-52
2016,5,25,1,14750,14395,14222,-173
2016,5,25,2,13890,13655,13480,-175
2016,5,25,3,12480,12271,11867,-404
2016,5,25,4,11150,11277,10669,-608
2016,5,25,5,10330,11375,10364,-1011
2016,5,25,6,9830,11010,10278,-732
2016,5,25,7,9580,10757,10135,-622
2016,5,25,8,9570,10694,10296,-398
2016,5,25,9,9790,10681,10192,-489
2016,5,25,10,10400,11434,10798,-636
2016,5,25,11,12170,12077,11839,-238
2016,5,25,12,13430,13196,12252,-944
2016,5,25,13,13980,13605,12421,-1184
2016,5,25,14,14280,14011,12848,-1163
2016,5,25,15,14290,14065,12988,-1077
2016,5,25,16,14450,14348,13303,-1045
2016,5,25,17,14640,14595,13617,-978
2016,5,25,18,15070,14995,14286,-709
2016,5,25,19,15420,15275,14272,-1003
2016,5,25,20,15820,15533,14371,-1162
2016,5,25,21,16070,15868,15056,-812
2016,5,25,22,16300,16081,15344,-737
2016,5,25,23,16200,16013,15185,-828
2016,5,26,0,15900,15891,15189,-702
2016,5,26,1,15990,16003,15305,-698
2016,5,26,2,15260,15294,14512,-782
2016,5,26,3,13600,14008,13270,-738
2016,5,26,4,12180,12749,12253,-496
2016,5,26,5,11350,11725,11223,-502
2016,5,26,6,10750,11104,10495,-609
2016,5,26,7,10320,10985,10451,-534
2016,5,26,8,10100,10814,10505,-309
2016,5,26,9,10260,10983,10645,-338
2016,5,26,10,11040,11259,10937,-322
2016,5,26,11,12740,12822,12038,-784
2016,5,26,12,14120,13932,13230,-702
2016,5,26,13,14760,14602,13923,-679
2016,5,26,14,15190,15122,14743,-379
2016,5,26,15,15660,15665,15056,-609
2016,5,26,16,16080,16131,15563,-568
2016,5,26,17,16330,16514,15980,-534
2016,5,26,18,16760,16907,16129,-778
2016,5,26,19,16850,17216,15569,-1647
2016,5,26,20,16970,17392,16566,-826
2016,5,26,21,17270,17476,16938,-538
2016,5,26,22,17500,17375,16658,-717
2016,5,26,23,17110,17070,16310,-760
2016,5,27,0,16610,16807,15977,-830
2016,5,27,1,16560,16814,15726,-1088
2016,5,27,2,15580,16061,15255,-806
2016,5,27,3,13920,14497,13690,-807
2016,5,27,4,12520,13067,12370,-697
2016,5,27,5,11480,11948,11295,-653
2016,5,27,6,10840,11497,10756,-741
2016,5,27,7,10460,11085,10623,-462
2016,5,27,8,10290,11025,10652,-373
2016,5,27,9,10420,11341,10907,-434
2016,5,27,10,11160,11736,11322,-414
2016,5,27,11,12700,13039,12634,-405
2016,5,27,12,14030,13966,13941,-25
2016,5,27,13,14700,14609,14519,-90
2016,5,27,14,15160,15132,14496,-636
2016,5,27,15,15660,15614,14907,-707
2016,5,27,16,15970,16056,15697,-359
2016,5,27,17,16290,16438,16760,322
2016,5,27,18,16650,16795,17107,312
2016,5,27,19,16800,16969,17314,345
2016,5,27,20,17040,17130,17596,466
2016,5,27,21,17190,17343,17702,359
2016,5,27,22,17150,17385,17534,149
2016,5,27,23,16780,16996,16704,-292
2016,5,28,0,16450,16532,16236,-296
2016,5,28,1,16380,16486,16167,-319
2016,5,28,2,15580,15931,15840,-91
2016,5,28,3,14220,14583,14349,-234
2016,5,28,4,12830,13290,12943,-347
2016,5,28,5,12060,12264,11573,-691
2016,5,28,6,11320,11999,11406,-593
2016,5,28,7,10940,11903,11200,-703
2016,5,28,8,10680,11624,10859,-765
2016,5,28,9,10640,11552,10486,-1066
2016,5,28,10,10810,11353,10429,-924
2016,5,28,11,11450,12149,11288,-861
2016,5,28,12,12790,12959,12407,-552
2016,5,28,13,13920,13732,13485,-247
2016,5,28,14,14780,14415,14043,-372
2016,5,28,15,15620,15242,14885,-357
2016,5,28,16,16320,16036,15860,-176
2016,5,28,17,16920,16688,16551,-137
2016,5,28,18,17110,17151,16858,-293
2016,5,28,19,17350,17575,16988,-587
2016,5,28,20,17560,17892,17037,-855
2016,5,28,21,17760,18253,17406,-847
2016,5,28,22,18200,18433,17338,-1095
2016,5,28,23,17790,18279,17122,-1157
2016,5,29,0,17440,17913,16765,-1148
2016,5,29,1,17570,17772,16752,-1020
2016,5,29,2,16790,17210,16358,-852
2016,5,29,3,15370,15875,15260,-615
2016,5,29,4,13880,14399,13825,-574
2016,5,29,5,12640,13172,12127,-1045
2016,5,29,6,12020,12473,11573,-900
2016,5,29,7,11600,12233,11334,-899
2016,5,29,8,11320,12039,10997,-1042
2016,5,29,9,11190,12065,10907,-1158
2016,5,29,10,11020,11905,10993,-912
2016,5,29,11,11450,12112,11102,-1010
2016,5,29,12,12340,12521,11947,-574
2016,5,29,13,13340,13080,12781,-299
2016,5,29,14,14170,13712,13587,-125
2016,5,29,15,14550,14241,13990,-251
2016,5,29,16,15020,14350,14167,-183
2016,5,29,17,15270,14549,14283,-266
2016,5,29,18,15040,14603,14473,-130
2016,5,29,19,15140,14652,14678,26
2016,5,29,20,15210,14733,14806,73
2016,5,29,21,15490,14801,14920,119
2016,5,29,22,15600,14808,14767,-41
2016,5,29,23,15280,14595,14298,-297
2016,5,30,0,15070,14310,14012,-298
2016,5,30,1,15570,14320,14115,-205
2016,5,30,2,15090,13859,13800,-59
2016,5,30,3,13860,12891,12758,-133
2016,5,30,4,12560,11810,11516,-294
2016,5,30,5,11270,10947,10397,-550
2016,5,30,6,10960,10567,10235,-332
2016,5,30,7,10660,10502,10102,-400
2016,5,30,8,10460,10602,9945,-657
2016,5,30,9,10480,10957,10199,-758
2016,5,30,10,10200,10970,10358,-612
2016,5,30,11,10620,11352,10454,-898
2016,5,30,12,11370,11820,11290,-530
2016,5,30,13,12330,12157,12024,-133
2016,5,30,14,13060,12954,13007,53
2016,5,30,15,13510,13581,13614,33
2016,5,30,16,13890,13960,13748,-212
2016,5,30,17,14060,14155,13982,-173
2016,5,30,18,14100,14215,13722,-493
2016,5,30,19,14200,14421,13906,-515
2016,5,30,20,14400,14703,14078,-625
2016,5,30,21,14760,15101,14368,-733
2016,5,30,22,15140,15545,14413,-1132
2016,5,30,23,14890,15611,14644,-967
2016,5,31,0,15060,15604,14531,-1073
2016,5,31,1,15560,15851,14676,-1175
2016,5,31,2,14860,15250,14311,-939
2016,5,31,3,13550,13904,13035,-869
2016,5,31,4,12270,12561,11302,-1259
2016,5,31,5,11280,11918,10497,-1421
2016,5,31,6,10750,11619,10189,-1430
2016,5,31,7,10500,11326,9702,-1624
2016,5,31,8,10390,11217,9619,-1598
2016,5,31,9,10790,11542,10082,-1460
2016,5,31,10,11600,12370,11303,-1067
2016,5,31,11,13240,13681,12617,-1064
2016,5,31,12,14570,15016,14244,-772
2016,5,31,13,15220,15721,14967,-754
2016,5,31,14,15640,16218,15433,-785
2016,5,31,15,16630,16639,15946,-693
2016,5,31,16,16980,16985,16086,-899
2016,5,31,17,17020,17268,16466,-802
2016,5,31,18,17180,17663,16945,-718
2016,5,31,19,17330,17983,17084,-899
2016,5,31,20,17470,18352,17281,-1071
2016,5,31,21,17600,18730,17610,-1120
2016,5,31,22,17490,18941,17622,-1319
2016,5,31,23,17050,18715,17334,-1381
2016,6,1,0,16700,18236,16779,-1457
2016,6,1,1,16670,17905,16679,-1226
2016,6,1,2,15720,17017,15789,-1228
2016,6,1,3,14170,15154,14166,-988
2016,6,1,4,12650,13383,12240,-1143
2016,6,1,5,11470,12414,11038,-1376
2016,6,1,6,10860,11856,10614,-1242
2016,6,1,7,10460,11667,10253,-1414
2016,6,1,8,10300,11463,10087,-1376
2016,6,1,9,10740,11555,10229,-1326
2016,6,1,10,11410,12162,10536,-1626
2016,6,1,11,12960,13098,11659,-1439
2016,6,1,12,14280,14283,12897,-1386
2016,6,1,13,14850,14881,13593,-1288
2016,6,1,14,15170,15296,13960,-1336
2016,6,1,15,15370,15693,14176,-1517
2016,6,1,16,15610,15991,14322,-1669
2016,6,1,17,15780,16309,14149,-2160
2016,6,1,18,15990,16662,14906,-1756
2016,6,1,19,16150,16887,15563,-1324
2016,6,1,20,16270,17090,16161,-929
2016,6,1,21,16400,17230,16379,-851
2016,6,1,22,16350,17137,16188,-949
2016,6,1,23,16120,16721,15695,-1026
2016,6,2,0,15830,16211,14852,-1359
2016,6,2,1,15660,16050,14692,-1358
2016,6,2,2,14850,15406,14263,-1143
2016,6,2,3,13310,13813,12312,-1501
2016,6,2,4,11840,12752,11189,-1563
2016,6,2,5,11010,11766,10134,-1632
2016,6,2,6,10450,11148,9586,-1562
2016,6,2,7,10110,11031,9304,-1727
2016,6,2,8,10000,11072,9236,-1836
2016,6,2,9,10290,11364,9396,-1968
2016,6,2,10,11030,11794,9842,-1952
2016,6,2,11,12610,12880,11129,-1751
2016,6,2,12,13860,13833,12196,-1637
2016,6,2,13,14390,14250,13192,-1058
2016,6,2,14,14770,14565,13741,-824
2016,6,2,15,15090,14817,13910,-907
2016,6,2,16,15300,14972,13627,-1345
2016,6,2,17,15420,15047,13709,-1338
2016,6,2,18,15590,15315,13964,-1351
2016,6,2,19,15660,15526,14170,-1356
2016,6,2,20,15750,15703,14330,-1373
2016,6,2,21,15840,15917,14499,-1418
2016,6,2,22,15850,15933,14625,-1308
2016,6,2,23,15670,15699,14548,-1151
2016,6,3,0,15470,15420,14319,-1101
2016,6,3,1,15440,15448,14146,-1302
2016,6,3,2,14750,14758,13628,-1130
2016,6,3,3,13290,13310,12138,-1172
2016,6,3,4,11910,11939,10568,-1371
2016,6,3,5,10910,11286,9821,-1465
2016,6,3,6,10340,11014,9510,-1504
2016,6,3,7,10030,10962,9322,-1640
2016,6,3,8,9940,10911,9387,-1524
2016,6,3,9,10290,11074,9605,-1469
2016,6,3,10,10960,11329,9965,-1364
2016,6,3,11,12410,12542,11123,-1419
2016,6,3,12,13570,13802,12517,-1285
2016,6,3,13,14140,14393,12933,-1460
2016,6,3,14,14470,14700,13082,-1618
2016,6,3,15,15000,14941,13233,-1708
2016,6,3,16,15160,15074,13494,-1580
2016,6,3,17,15240,15112,13525,-1587
2016,6,3,18,15430,15155,13514,-1641
2016,6,3,19,15480,15076,13409,-1667
2016,6,3,20,15490,15048,13578,-1470
2016,6,3,21,15510,15018,13478,-1540
2016,6,3,22,15550,14955,13345,-1610
2016,6,3,23,15220,14818,13310,-1508
2016,6,4,0,14930,14668,13091,-1577
2016,6,4,1,14980,14791,13107,-1684
2016,6,4,2,14530,14437,13160,-1277
2016,6,4,3,13330,13404,12161,-1243
2016,6,4,4,12060,12461,10960,-1501
2016,6,4,5,11030,11610,10073,-1537
2016,6,4,6,10420,11355,9531,-1824
2016,6,4,7,10060,11301,9711,-1590
2016,6,4,8,9890,11155,9599,-1556
2016,6,4,9,9850,11148,9492,-1656
2016,6,4,10,10260,11042,9597,-1445
2016,6,4,11,10700,11343,9835,-1508
2016,6,4,12,11650,11949,10737,-1212
2016,6,4,13,12620,12709,11159,-1550
2016,6,4,14,13300,13445,11858,-1587
2016,6,4,15,13760,14027,12517,-1510
2016,6,4,16,14000,14515,13230,-1285
2016,6,4,17,14090,14898,13821,-1077
2016,6,4,18,14220,15117,13707,-1410
2016,6,4,19,14320,15277,13879,-1398
2016,6,4,20,14510,15426,14009,-1417
2016,6,4,21,14750,15664,14138,-1526
2016,6,4,22,15200,15876,14263,-1613
2016,6,4,23,15030,15788,14018,-1770
2016,6,5,0,14870,15426,13659,-1767
2016,6,5,1,14910,15383,13593,-1790
2016,6,5,2,14500,15043,13293,-1750
2016,6,5,3,13370,13981,12186,-1795
2016,6,5,4,12220,12775,11065,-1710
2016,6,5,5,11180,12007,10336,-1671
2016,6,5,6,10600,11601,9638,-1963
2016,6,5,7,10220,11386,9490,-1896
2016,6,5,8,10040,11100,9084,-2016
2016,6,5,9,9960,11019,8925,-2094
2016,6,5,10,10290,11016,8917,-2099
2016,6,5,11,10600,11508,9263,-2245
2016,6,5,12,11370,11640,9853,-1787
2016,6,5,13,12330,12344,10525,-1819
2016,6,5,14,13150,13016,11151,-1865
2016,6,5,15,13660,13573,11886,-1687
2016,6,5,16,13960,13905,12240,-1665
2016,6,5,17,14040,14007,12283,-1724
2016,6,5,18,14070,13918,12275,-1643
2016,6,5,19,14090,13817,12040,-1777
2016,6,5,20,14250,13877,12215,-1662
2016,6,5,21,14530,14119,12459,-1660
2016,6,5,22,14800,14420,12676,-1744
2016,6,5,23,14920,14544,12829,-1715
2016,6,6,0,14860,14499,12560,-1939
2016,6,6,1,15000,14445,12383,-2062
2016,6,6,2,14400,13788,12056,-1732
2016,6,6,3,13150,12644,10706,-1938
2016,6,6,4,11960,11521,9578,-1943
2016,6,6,5,11140,10866,9083,-1783
2016,6,6,6,10640,10537,9178,-1359
2016,6,6,7,10340,10412,8979,-1433
2016,6,6,8,10240,10324,9064,-1260
2016,6,6,9,10490,10424,9468,-956
2016,6,6,10,11110,11112,10182,-930
2016,6,6,11,13060,12756,11207,-1549
2016,6,6,12,14670,14183,12067,-2116
2016,6,6,13,15550,14881,12874,-2007
2016,6,6,14,16130,15407,13808,-1599
2016,6,6,15,16730,15824,13944,-1880
2016,6,6,16,17230,16125,14177,-1948
2016,6,6,17,17550,16362,14291,-2071
2016,6,6,18,17930,16744,14737,-2007
2016,6,6,19,18160,17034,14478,-2556
2016,6,6,20,18330,17338,14781,-2557
2016,6,6,21,18540,17701,15703,-1998
2016,6,6,22,18750,17898,16367,-1531
2016,6,6,23,18400,17743,16153,-1590
2016,6,7,0,17830,17329,15911,-1418
2016,6,7,1,17510,17062,15629,-1433
2016,6,7,2,16600,16426,15090,-1336
2016,6,7,3,14860,14784,13444,-1340
2016,6,7,4,13260,13158,11771,-1387
2016,6,7,5,11980,11979,10477,-1502
2016,6,7,6,11370,11548,10218,-1330
2016,6,7,7,10990,11325,10382,-943
2016,6,7,8,10840,11130,10212,-918
2016,6,7,9,11000,11322,10196,-1126
2016,6,7,10,11610,12262,10526,-1736
2016,6,7,11,13300,13288,11742,-1546
2016,6,7,12,14650,14634,13067,-1567
2016,6,7,13,15400,15422,13918,-1504
2016,6,7,14,16010,16065,14523,-1542
2016,6,7,15,16600,16678,15046,-1632
2016,6,7,16,17020,17175,15421,-1754
2016,6,7,17,17280,17465,15574,-1891
2016,6,7,18,17640,17826,15895,-1931
2016,6,7,19,17810,18016,15882,-2134
2016,6,7,20,17860,18173,16054,-2119
2016,6,7,21,17960,18270,15978,-2292
2016,6,7,22,17850,18228,16274,-1954
2016,6,7,23,17530,17812,15894,-1918
2016,6,8,0,17100,17262,15683,-1579
2016,6,8,1,16820,16870,15370,-1500
2016,6,8,2,15960,15870,14054,-1816
2016,6,8,3,14320,14187,12526,-1661
2016,6,8,4,12750,12625,10872,-1753
2016,6,8,5,11740,11562,9659,-1903
2016,6,8,6,11020,11078,9450,-1628
2016,6,8,7,10610,10668,9199,-1469
2016,6,8,8,10390,10705,9193,-1512
2016,6,8,9,10530,11048,9332,-1716
2016,6,8,10,11080,11984,9892,-2092
2016,6,8,11,12600,12666,10695,-1971
2016,6,8,12,13830,13698,11765,-1933
2016,6,8,13,14250,14141,12219,-1922
2016,6,8,14,14560,14413,12412,-2001
2016,6,8,15,14810,14712,12549,-2163
2016,6,8,16,14910,14983,12740,-2243
2016,6,8,17,15010,15096,12699,-2397
2016,6,8,18,15180,15183,12638,-2545
2016,6,8,19,15230,15009,12536,-2473
2016,6,8,20,15290,14993,12245,-2748
2016,6,8,21,15400,14969,12485,-2484
2016,6,8,22,15480,15039,12459,-2580
2016,6,8,23,15300,14676,12455,-2221
2016,6,9,0,15090,14409,12233,-2176
2016,6,9,1,14990,14414,12576,-1838
2016,6,9,2,14230,13964,12365,-1599
2016,6,9,3,12820,12599,10922,-1677
2016,6,9,4,11460,11426,9873,-1553
2016,6,9,5,10480,11023,9498,-1525
2016,6,9,6,9940,10649,9444,-1205
2016,6,9,7,9680,10497,9259,-1238
2016,6,9,8,9600,10748,9254,-1494
2016,6,9,9,9860,10711,9310,-1401
2016,6,9,10,10520,10836,9720,-1116
2016,6,9,11,12040,11847,10244,-1603
2016,6,9,12,13330,13033,11174,-1859
2016,6,9,13,13620,13466,11632,-1834
2016,6,9,14,13790,13632,11810,-1822
2016,6,9,15,13930,13774,12166,-1608
2016,6,9,16,13920,13816,12050,-1766
2016,6,9,17,13920,13804,11812,-1992
2016,6,9,18,14010,13888,11868,-2020
2016,6,9,19,14020,13901,11829,-2072
2016,6,9,20,14040,13932,11870,-2062
2016,6,9,21,14210,14091,12269,-1822
2016,6,9,22,14470,14220,12210,-2010
2016,6,9,23,14300,14125,12143,-1982
2016,6,10,0,14240,14014,12088,-1926
2016,6,10,1,14400,14098,12078,-2020
2016,6,10,2,13820,13685,11935,-1750
2016,6,10,3,12470,12423,10724,-1699
2016,6,10,4,11190,11258,9671,-1587
2016,6,10,5,10300,10250,9265,-985
2016,6,10,6,9830,9991,9162,-829
2016,6,10,7,9570,10244,8887,-1357
2016,6,10,8,9480,10070,8891,-1179
2016,6,10,9,9720,10290,9031,-1259
2016,6,10,10,10410,10806,9173,-1633
2016,6,10,11,11850,11831,10065,-1766
2016,6,10,12,13040,12858,11043,-1815
2016,6,10,13,13440,13276,11644,-1632
2016,6,10,14,13630,13461,11705,-1756
2016,6,10,15,13800,13640,11809,-1831
2016,6,10,16,13860,13770,11793,-1977
2016,6,10,17,13860,13853,11858,-1995
2016,6,10,18,13930,14015,12079,-1936
2016,6,10,19,13900,14062,12266,-1796
2016,6,10,20,13890,14115,12237,-1878
2016,6,10,21,14000,14310,12519,-1791
2016,6,10,22,13940,14428,12578,-1850
2016,6,10,23,13690,14305,12284,-2021
2016,6,11,0,13420,14092,11991,-2101
2016,6,11,1,13640,14032,12208,-1824
2016,6,11,2,13340,13719,11963,-1756
2016,6,11,3,12290,12601,10835,-1766
2016,6,11,4,11140,11396,9570,-1826
2016,6,11,5,10320,10453,8570,-1883
2016,6,11,6,9790,9865,8241,-1624
2016,6,11,7,9490,9529,8016,-1513
2016,6,11,8,9350,9653,7819,-1834
2016,6,11,9,9360,9658,7932,-1726
2016,6,11,10,9550,9750,8115,-1635
2016,6,11,11,10140,10056,8323,-1733
2016,6,11,12,11090,10874,9148,-1726
2016,6,11,13,11960,11795,9963,-1832
2016,6,11,14,12600,12472,10420,-2052
2016,6,11,15,12910,12837,10627,-2210
2016,6,11,16,13050,13031,10856,-2175
2016,6,11,17,13010,13265,11108,-2157
2016,6,11,18,12950,13217,11022,-2195
2016,6,11,19,12950,12979,10794,-2185
2016,6,11,20,13060,12868,10685,-2183
2016,6,11,21,13230,12977,11051,-1926
2016,6,11,22,13450,13217,11189,-2028
2016,6,11,23,13390,13277,11082,-2195
2016,6,12,0,13330,13207,11132,-2075
2016,6,12,1,13560,13290,11373,-1917
2016,6,12,2,13330,13098,11278,-1820
2016,6,12,3,12410,12238,10504,-1734
2016,6,12,4,11350,11242,9512,-1730
2016,6,12,5,10490,10510,8762,-1748
2016,6,12,6,9900,10234,8426,-1808
2016,6,12,7,9580,10209,8498,-1711
2016,6,12,8,9400,10421,8557,-1864
2016,6,12,9,9410,10416,8602,-1814
2016,6,12,10,9500,10343,8610,-1733
2016,6,12,11,9880,10494,8665,-1829
2016,6,12,12,10630,11210,9459,-1751
2016,6,12,13,11600,12080,10293,-1787
2016,6,12,14,12270,12519,10560,-1959
2016,6,12,15,12740,12964,10893,-2071
2016,6,12,16,13050,13274,11210,-2064
2016,6,12,17,13140,13390,11311,-2079
2016,6,12,18,13100,13260,11107,-2153
2016,6,12,19,13020,13410,11142,-2268
2016,6,12,20,13050,13465,11202,-2263
2016,6,12,21,13300,13287,11017,-2270
2016,6,12,22,13560,13423,11172,-2251
2016,6,12,23,13610,13401,11190,-2211
2016,6,13,0,13500,13301,11381,-1920
2016,6,13,1,13650,13353,11264,-2089
2016,6,13,2,13070,12896,11151,-1745
2016,6,13,3,11960,11775,10109,-1666
2016,6,13,4,10850,10746,9080,-1666
2016,6,13,5,9870,10245,7604,-2641
2016,6,13,6,9460,10137,7459,-2678
2016,6,13,7,9260,10251,7513,-2738
2016,6,13,8,9240,10367,7545,-2822
2016,6,13,9,9640,10604,7761,-2843
2016,6,13,10,10360,11072,8456,-2616
2016,6,13,11,11940,11888,9523,-2365
2016,6,13,12,13170,13005,10838,-2167
2016,6,13,13,13710,13541,11242,-2299
2016,6,13,14,14030,13867,11523,-2344
2016,6,13,15,14330,14228,11935,-2293
2016,6,13,16,14520,14399,11992,-2407
2016,6,13,17,14720,14462,11870,-2592
2016,6,13,18,14900,14524,11803,-2721
2016,6,13,19,14810,14456,11842,-2614
2016,6,13,20,14850,14566,12063,-2503
2016,6,13,21,15010,14740,12242,-2498
2016,6,13,22,15200,14867,12306,-2561
2016,6,13,23,15010,14768,12168,-2600
2016,6,14,0,14770,14655,11776,-2879
2016,6,14,1,14750,14646,11890,-2756
2016,6,14,2,14130,14087,11594,-2493
2016,6,14,3,12710,12713,10678,-2035
2016,6,14,4,11390,11536,9643,-1893
2016,6,14,5,10430,10706,8825,-1881
2016,6,14,6,9960,10575,8461,-2114
2016,6,14,7,9660,10601,8534,-2067
2016,6,14,8,9560,10650,8840,-1810
2016,6,14,9,9780,10846,8946,-1900
2016,6,14,10,10520,11121,9355,-1766
2016,6,14,11,12060,12189,10192,-1997
2016,6,14,12,13260,13370,11273,-2097
2016,6,14,13,13740,13819,11665,-2154
2016,6,14,14,14030,14046,11662,-2384
2016,6,14,15,14280,14237,11945,-2292
2016,6,14,16,14490,14176,11992,-2184
2016,6,14,17,14650,14279,12154,-2125
2016,6,14,18,14910,14526,12300,-2226
2016,6,14,19,15050,14721,12594,-2127
2016,6,14,20,15160,15017,13008,-2009
2016,6,14,21,15450,15397,13351,-2046
2016,6,14,22,15530,15682,13495,-2187
2016,6,14,23,15290,15633,13425,-2208
2016,6,15,0,15050,15384,12994,-2390
2016,6,15,1,15080,15233,12943,-2290
2016,6,15,2,14480,14767,12779,-1988
2016,6,15,3,13060,13330,11529,-1801
2016,6,15,4,11700,11863,9990,-1873
2016,6,15,5,10710,11132,8785,-2347
2016,6,15,6,10200,10589,8485,-2104
2016,6,15,7,9890,10525,8368,-2157
2016,6,15,8,9760,10600,8339,-2261
2016,6,15,9,10170,10693,8358,-2335
2016,6,15,10,10860,11045,8705,-2340
2016,6,15,11,12390,12247,9847,-2400
2016,6,15,12,13680,13635,11483,-2152
2016,6,15,13,14310,14343,12490,-1853
2016,6,15,14,14730,14838,12509,-2329
2016,6,15,15,15120,15307,12867,-2440
2016,6,15,16,15490,15669,13209,-2460
2016,6,15,17,15660,15948,13623,-2325
2016,6,15,18,15980,16400,14070,-2330
2016,6,15,19,16110,16751,14570,-2181
2016,6,15,20,16280,17074,14851,-2223
2016,6,15,21,16490,17400,15216,-2184
2016,6,15,22,16480,17598,15302,-2296
2016,6,15,23,16210,17426,15087,-2339
2016,6,16,0,15980,16998,14616,-2382
2016,6,16,1,15950,16702,14333,-2369
2016,6,16,2,15360,16097,13858,-2239
2016,6,16,3,13810,14510,12189,-2321
2016,6,16,4,12320,12910,10383,-2527
2016,6,16,5,11820,12096,9418,-2678
2016,6,16,6,11130,11678,9231,-2447
2016,6,16,7,10730,11555,8880,-2675
2016,6,16,8,10560,11627,8831,-2796
2016,6,16,9,10770,11579,9000,-2579
2016,6,16,10,11420,11929,9680,-2249
2016,6,16,11,12910,12835,10885,-1950
2016,6,16,12,14230,14139,12169,-1970
2016,6,16,13,14920,14940,12661,-2279
2016,6,16,14,15410,15469,13133,-2336
2016,6,16,15,15870,15966,13525,-2441
2016,6,16,16,16200,16385,13769,-2616
2016,6,16,17,16460,16656,14139,-2517
2016,6,16,18,16770,17023,14588,-2435
2016,6,16,19,16960,17341,14638,-2703
2016,6,16,20,17120,17613,14819,-2794
2016,6,16,21,17300,17879,14867,-3012
2016,6,16,22,17360,17967,15172,-2795
2016,6,16,23,17000,17760,14999,-2761
2016,6,17,0,16530,17260,14456,-2804
2016,6,17,1,16270,16917,14016,-2901
2016,6,17,2,15600,16315,13512,-2803
2016,6,17,3,14100,14758,11920,-2838
2016,6,17,4,12620,13132,10621,-2511
2016,6,17,5,11810,12673,10052,-2621
2016,6,17,6,11150,12342,9677,-2665
2016,6,17,7,10730,12041,9292,-2749
2016,6,17,8,10560,11942,9228,-2714
2016,6,17,9,10730,12014,9487,-2527
2016,6,17,10,11320,12093,9686,-2407
2016,6,17,11,12690,12858,10633,-2225
2016,6,17,12,13960,13918,11868,-2050
2016,6,17,13,14600,14656,12499,-2157
2016,6,17,14,15040,15119,12858,-2261
2016,6,17,15,15390,15491,13052,-2439
2016,6,17,16,15640,15791,13084,-2707
2016,6,17,17,15830,16015,13443,-2572
2016,6,17,18,16030,16350,13815,-2535
2016,6,17,19,16160,16532,13762,-2770
2016,6,17,20,16300,16676,13831,-2845
2016,6,17,21,16410,16847,14017,-2830
2016,6,17,22,16460,16856,14076,-2780
2016,6,17,23,16030,16499,13619,-2880
2016,6,18,0,15520,15883,13092,-2791
2016,6,18,1,15250,15478,12495,-2983
2016,6,18,2,14760,15051,12066,-2985
2016,6,18,3,13470,13803,10959,-2844
2016,6,18,4,12160,12597,9958,-2639
2016,6,18,5,11260,11803,9175,-2628
2016,6,18,6,10660,11486,8975,-2511
2016,6,18,7,10200,11084,8635,-2449
2016,6,18,8,9940,11033,8518,-2515
2016,6,18,9,9950,10969,8525,-2444
2016,6,18,10,10030,11014,8529,-2485
2016,6,18,11,10630,11332,8871,-2461
2016,6,18,12,11590,12080,9728,-2352
2016,6,18,13,12530,12482,10459,-2023
2016,6,18,14,13240,13145,11248,-1897
2016,6,18,15,13580,13649,11746,-1903
2016,6,18,16,13890,13998,12084,-1914
2016,6,18,17,14140,14220,12103,-2117
2016,6,18,18,14220,14377,12352,-2025
2016,6,18,19,14440,14600,12450,-2150
2016,6,18,20,14660,14910,12799,-2111
2016,6,18,21,14930,15267,13209,-2058
2016,6,18,22,15050,15539,13402,-2137
2016,6,18,23,14980,15485,13267,-2218
2016,6,19,0,14630,15088,12701,-2387
2016,6,19,1,14760,14794,12452,-2342
2016,6,19,2,14350,14480,12295,-2185
2016,6,19,3,13220,13402,11142,-2260
2016,6,19,4,11990,12439,9978,-2461
2016,6,19,5,11000,11606,8947,-2659
2016,6,19,6,10470,11316,8955,-2361
2016,6,19,7,10080,11134,8831,-2303
2016,6,19,8,9880,10976,8553,-2423
2016,6,19,9,9780,11072,8802,-2270
2016,6,19,10,9750,10974,8693,-2281
2016,6,19,11,10160,11359,8804,-2555
2016,6,19,12,10900,11869,9556,-2313
2016,6,19,13,11830,12107,9777,-2330
2016,6,19,14,12660,12544,10187,-2357
2016,6,19,15,13340,13148,10890,-2258
2016,6,19,16,13920,13721,11611,-2110
2016,6,19,17,14410,14166,12030,-2136
2016,6,19,18,14770,14490,12323,-2167
2016,6,19,19,15120,14824,12747,-2077
2016,6,19,20,15520,15187,13169,-2018
2016,6,19,21,16000,15560,13439,-2121
2016,6,19,22,16410,15806,13677,-2129
2016,6,19,23,16270,15693,13537,-2156
2016,6,20,0,15970,15323,13169,-2154
2016,6,20,1,15610,15190,13047,-2143
2016,6,20,2,14930,14939,12942,-1997
2016,6,20,3,13590,13702,11684,-2018
2016,6,20,4,12250,12364,10721,-1643
2016,6,20,5,11290,11647,9112,-2535
2016,6,20,6,10750,11391,9062,-2329
2016,6,20,7,10340,11222,9114,-2108
2016,6,20,8,10220,11354,9271,-2083
2016,6,20,9,10480,11496,9367,-2129
2016,6,20,10,11230,11758,9665,-2093
2016,6,20,11,12810,12617,10203,-2414
2016,6,20,12,14260,14099,11564,-2535
2016,6,20,13,15130,15021,12100,-2921
2016,6,20,14,15780,15707,12910,-2797
2016,6,20,15,16410,16385,13637,-2748
2016,6,20,16,16930,16987,14120,-2867
2016,6,20,17,17320,17545,14874,-2671
2016,6,20,18,17850,18169,15387,-2782
2016,6,20,19,18250,18617,15630,-2987
2016,6,20,20,18950,18941,15853,-3088
2016,6,20,21,19250,19279,16632,-2647
2016,6,20,22,19350,19346,16583,-2763
2016,6,20,23,18800,19026,16121,-2905
2016,6,21,0,18090,18426,15463,-2963
2016,6,21,1,17580,17911,15008,-2903
2016,6,21,2,16690,17158,14382,-2776
2016,6,21,3,15000,15485,12803,-2682
2016,6,21,4,13420,13779,11421,-2358
2016,6,21,5,12280,12867,10437,-2430
2016,6,21,6,11620,12525,10076,-2449
2016,6,21,7,11230,12314,9861,-2453
2016,6,21,8,11050,12397,9774,-2623
2016,6,21,9,11240,12539,10062,-2477
2016,6,21,10,12300,13010,10633,-2377
2016,6,21,11,13740,13736,11535,-2201
2016,6,21,12,15130,15005,12454,-2551
2016,6,21,13,15930,15811,13102,-2709
2016,6,21,14,16500,16403,13662,-2741
2016,6,21,15,17030,16926,14057,-2869
2016,6,21,16,17500,17586,14433,-3153
2016,6,21,17,17640,17855,14645,-3210
2016,6,21,18,18020,18254,15051,-3203
2016,6,21,19,18460,18480,15311,-3169
2016,6,21,20,18750,18778,15722,-3056
2016,6,21,21,19080,19078,16307,-2771
2016,6,21,22,19200,19102,16321,-2781
2016,6,21,23,18580,18739,15908,-2831
2016,6,22,0,17790,18094,15195,-2899
2016,6,22,1,17310,17524,14699,-2825
2016,6,22,2,16430,16754,13770,-2984
2016,6,22,3,14820,15051,12219,-2832
2016,6,22,4,13260,13330,10509,-2821
2016,6,22,5,11990,12324,9671,-2653
2016,6,22,6,11260,11958,9756,-2202
2016,6,22,7,10820,11718,9465,-2253
2016,6,22,8,10620,11693,9360,-2333
2016,6,22,9,10780,11784,9538,-2246
2016,6,22,10,11400,11822,9610,-2212
2016,6,22,11,12890,12846,10782,-2064
2016,6,22,12,14230,13965,12019,-1946
2016,6,22,13,15010,14855,12982,-1873
2016,6,22,14,15520,15459,13364,-2095
2016,6,22,15,16030,16054,13663,-2391
2016,6,22,16,16370,16605,14187,-2418
2016,6,22,17,16650,16722,14168,-2554
2016,6,22,18,17000,16662,13968,-2694
2016,6,22,19,17280,16536,14178,-2358
2016,6,22,20,17470,16599,14172,-2427
2016,6,22,21,17700,16842,14546,-2296
2016,6,22,22,17550,17075,14524,-2551
2016,6,22,23,17300,16906,14560,-2346
2016,6,23,0,16750,16466,13913,-2553
2016,6,23,1,16530,16143,13476,-2667
2016,6,23,2,15860,15602,13380,-2222
2016,6,23,3,14340,14139,11838,-2301
2016,6,23,4,12820,12619,10252,-2367
2016,6,23,5,11560,11533,8992,-2541
2016,6,23,6,10880,11241,9064,-2177
2016,6,23,7,10510,11242,8998,-2244
2016,6,23,8,10380,11213,8978,-2235
2016,6,23,9,10480,11442,9150,-2292
2016,6,23,10,11110,11511,9476,-2035
2016,6,23,11,12580,12235,10372,-1863
2016,6,23,12,13960,13531,11485,-2046
2016,6,23,13,14670,14326,12357,-1969
2016,6,23,14,15100,14903,12645,-2258
2016,6,23,15,15540,15459,13076,-2383
2016,6,23,16,15920,15973,13336,-2637
2016,6,23,17,16160,16348,13952,-2396
2016,6,23,18,16410,16861,14475,-2386
2016,6,23,19,16600,17195,14826,-2369
2016,6,23,20,16890,17383,14713,-2670
2016,6,23,21,17100,17420,14486,-2934
2016,6,23,22,17040,17377,14504,-2873
2016,6,23,23,16780,17253,14450,-2803
2016,6,24,0,16400,16952,14012,-2940
2016,6,24,1,16240,16704,13935,-2769
2016,6,24,2,15680,16232,13504,-2728
2016,6,24,3,14190,14768,12105,-2663
2016,6,24,4,12680,13222,10720,-2502
2016,6,24,5,11930,12291,10163,-2128
2016,6,24,6,11190,11792,9714,-2078
2016,6,24,7,10610,11841,9626,-2215
2016,6,24,8,10410,11870,9519,-2351
2016,6,24,9,10560,11993,9694,-2299
2016,6,24,10,11130,12197,9880,-2317
2016,6,24,11,12520,12689,10504,-2185
2016,6,24,12,13860,13766,11722,-2044
2016,6,24,13,14640,14699,12632,-2067
2016,6,24,14,15200,15304,13146,-2158
2016,6,24,15,15680,15782,13536,-2246
2016,6,24,16,16150,16112,13831,-2281
2016,6,24,17,16410,16352,14152,-2200
2016,6,24,18,16720,16676,14416,-2260
2016,6,24,19,16960,16953,14941,-2012
2016,6,24,20,17180,17165,15342,-1823
2016,6,24,21,17360,17370,15627,-1743
2016,6,24,22,17240,17412,15681,-1731
2016,6,24,23,16820,17043,15181,-1862
2016,6,25,0,16260,16393,14435,-1958
2016,6,25,1,15960,15895,13902,-1993
2016,6,25,2,15480,15405,13384,-2021
2016,6,25,3,14210,14153,12143,-2010
2016,6,25,4,12780,12965,11105,-1860
2016,6,25,5,11900,12204,10210,-1994
2016,6,25,6,11190,11709,9693,-2016
2016,6,25,7,10640,11433,9159,-2274
2016,6,25,8,10310,11279,9070,-2209
2016,6,25,9,10180,11254,9140,-2114
2016,6,25,10,10200,11390,9325,-2065
2016,6,25,11,10810,11339,9669,-1670
2016,6,25,12,11880,12057,10447,-1610
2016,6,25,13,12960,12971,11224,-1747
2016,6,25,14,13810,13560,11999,-1561
2016,6,25,15,14420,14071,12651,-1420
2016,6,25,16,14900,14457,13237,-1220
2016,6,25,17,15240,14722,13351,-1371
2016,6,25,18,15420,14932,13489,-1443
2016,6,25,19,15650,15193,13622,-1571
2016,6,25,20,15990,15488,13981,-1507
2016,6,25,21,16280,15845,14220,-1625
2016,6,25,22,16500,16129,14310,-1819
2016,6,25,23,16250,16045,14264,-1781
2016,6,26,0,15780,15548,13922,-1626
2016,6,26,1,15400,15161,13541,-1620
2016,6,26,2,15060,14809,13085,-1724
2016,6,26,3,13890,13708,11824,-1884
2016,6,26,4,12610,12473,10756,-1717
2016,6,26,5,11550,11643,9875,-1768
2016,6,26,6,10770,11248,9318,-1930
2016,6,26,7,10330,11242,9263,-1979
2016,6,26,8,10070,11118,9189,-1929
2016,6,26,9,9950,11006,8999,-2007
2016,6,26,10,9880,10861,8964,-1897
2016,6,26,11,10220,11031,9283,-1748
2016,6,26,12,11070,11680,9966,-1714
2016,6,26,13,12110,12044,10431,-1613
2016,6,26,14,13050,12863,11278,-1585
2016,6,26,15,13850,13631,12278,-1353
2016,6,26,16,14560,14333,12888,-1445
2016,6,26,17,15060,14956,13341,-1615
2016,6,26,18,15470,15444,13852,-1592
2016,6,26,19,15890,15875,14237,-1638
2016,6,26,20,16340,16351,14429,-1922
2016,6,26,21,16920,16854,14907,-1947
2016,6,26,22,17300,17277,15303,-1974
2016,6,26,23,17230,17272,15162,-2110
2016,6,27,0,16730,16839,14920,-1919
2016,6,27,1,16380,16481,14639,-1842
2016,6,27,2,15800,15993,14139,-1854
2016,6,27,3,14440,14601,12662,-1939
2016,6,27,4,13030,13258,11162,-2096
2016,6,27,5,11970,12374,9934,-2440
2016,6,27,6,11300,12118,9760,-2358
2016,6,27,7,10910,11976,9765,-2211
2016,6,27,8,10750,11844,9850,-1994
2016,6,27,9,10980,12025,10040,-1985
2016,6,27,10,11700,12348,10447,-1901
2016,6,27,11,13260,13269,11284,-1985
2016,6,27,12,14700,14672,12823,-1849
2016,6,27,13,15610,15548,13825,-1723
2016,6,27,14,16340,16302,14547,-1755
2016,6,27,15,16970,17050,15221,-1829
2016,6,27,16,17530,17658,15925,-1733
2016,6,27,17,17980,18084,16344,-1740
2016,6,27,18,18450,18540,16587,-1953
2016,6,27,19,18840,18724,16709,-2015
2016,6,27,20,19130,18744,16624,-2120
2016,6,27,21,19350,18722,16754,-1968
2016,6,27,22,19410,18707,16616,-2091
2016,6,27,23,19080,18296,16182,-2114
2016,6,28,0,18560,17906,15797,-2109
2016,6,28,1,18120,17699,15664,-2035
2016,6,28,2,17200,17092,15253,-1839
2016,6,28,3,15470,15628,13797,-1831
2016,6,28,4,13830,14135,12150,-1985
2016,6,28,5,12950,13238,11168,-2070
2016,6,28,6,12220,12942,10828,-2114
2016,6,28,7,11780,12801,10624,-2177
2016,6,28,8,11570,12919,11050,-1869
2016,6,28,9,11980,13117,11219,-1898
2016,6,28,10,12700,13333,11380,-1953
2016,6,28,11,13990,14171,12307,-1864
2016,6,28,12,15440,15504,13619,-1885
2016,6,28,13,16340,16343,14435,-1908
2016,6,28,14,16980,16892,15015,-1877
2016,6,28,15,17600,17411,15246,-2165
2016,6,28,16,18190,17741,15535,-2206
2016,6,28,17,18490,17818,15576,-2242
2016,6,28,18,18880,18021,15653,-2368
2016,6,28,19,19150,18075,15333,-2742
2016,6,28,20,19410,18029,15284,-2745
2016,6,28,21,19600,18143,15324,-2819
2016,6,28,22,18260,18164,15341,-2823
2016,6,28,23,18140,17897,15250,-2647
2016,6,29,0,17990,17633,15069,-2564
2016,6,29,1,17780,17540,15102,-2438
2016,6,29,2,17030,16946,14797,-2149
2016,6,29,3,15530,15534,13484,-2050
2016,6,29,4,14110,14087,11943,-2144
2016,6,29,5,13160,13204,10894,-2310
2016,6,29,6,12420,13064,10603,-2461
2016,6,29,7,11950,13016,10823,-2193
2016,6,29,8,11760,12989,10598,-2391
2016,6,29,9,11870,13040,10684,-2356
2016,6,29,10,12820,13297,11177,-2120
2016,6,29,11,14220,14239,12111,-2128
2016,6,29,12,15640,15543,13531,-2012
2016,6,29,13,16360,16412,14163,-2249
2016,6,29,14,16930,17036,14546,-2490
2016,6,29,15,17460,17701,15417,-2284
2016,6,29,16,17990,18217,15871,-2346
2016,6,29,17,18330,18596,16308,-2288
2016,6,29,18,18750,19103,16415,-2688
2016,6,29,19,19050,19463,16561,-2902
2016,6,29,20,19270,19674,16841,-2833
2016,6,29,21,19600,19797,17045,-2752
2016,6,29,22,19520,19794,16961,-2833
2016,6,29,23,19230,19507,16854,-2653
2016,6,30,0,18700,19063,16590,-2473
2016,6,30,1,18360,18545,15978,-2567
2016,6,30,2,17540,17876,15399,-2477
2016,6,30,3,15810,16244,13675,-2569
2016,6,30,4,14120,14525,11822,-2703
2016,6,30,5,12810,13193,10536,-2657
2016,6,30,6,12150,12831,10130,-2701
2016,6,30,7,11600,12634,9996,-2638
2016,6,30,8,11350,12736,10082,-2654
2016,6,30,9,11480,12840,10572,-2268
2016,6,30,10,12060,12878,10332,-2546
2016,6,30,11,13500,13833,11468,-2365
2016,6,30,12,14930,14942,13004,-1938
2016,6,30,13,15760,15832,13970,-1862
2016,6,30,14,16420,16492,14602,-1890
2016,6,30,15,17100,17139,15286,-1853
2016,6,30,16,17680,17697,15806,-1891
2016,6,30,17,18000,18094,15954,-2140
2016,6,30,18,18440,18648,16491,-2157
2016,6,30,19,18910,18956,16621,-2335
2016,6,30,20,19180,19159,16744,-2415
2016,6,30,21,19500,19391,16839,-2552
2016,6,30,22,19370,19510,16881,-2629
2016,6,30,23,18930,19301,16696,-2605
2016,7,1,0,18370,18717,16062,-2655
2016,7,1,1,18160,18189,15820,-2369
2016,7,1,2,17410,17629,15332,-2297
2016,7,1,3,15580,16075,13688,-2387
2016,7,1,4,14040,14447,11998,-2449
2016,7,1,5,13020,13183,10806,-2377
2016,7,1,6,12320,12581,10586,-1995
2016,7,1,7,11810,12556,10536,-2020
2016,7,1,8,11550,12549,10407,-2142
2016,7,1,9,11660,12632,10472,-2160
2016,7,1,10,12190,12576,10558,-2018
2016,7,1,11,13600,13329,11389,-1940
2016,7,1,12,15100,14782,12912,-1870
2016,7,1,13,16150,15939,14068,-1871
2016,7,1,14,16860,16902,15053,-1849
2016,7,1,15,17520,17762,15733,-2029
2016,7,1,16,17890,18366,16118,-2248
2016,7,1,17,18270,18659,16210,-2449
2016,7,1,18,18630,18932,16229,-2703
2016,7,1,19,18790,19037,16245,-2792
2016,7,1,20,18850,18941,16090,-2851
2016,7,1,21,18810,18861,15918,-2943
2016,7,1,22,18570,18697,15660,-3037
2016,7,1,23,18050,18228,15126,-3102
2016,7,2,0,17480,17697,14620,-3077
2016,7,2,1,17210,17382,14337,-3045
2016,7,2,2,16700,16781,14056,-2725
2016,7,2,3,15380,15422,12748,-2674
2016,7,2,4,14150,14059,11231,-2828
2016,7,2,5,13130,12977,10464,-2513
2016,7,2,6,12330,12611,10273,-2338
2016,7,2,7,11780,12552,10082,-2470
2016,7,2,8,11430,12487,9738,-2749
2016,7,2,9,11310,12369,9651,-2718
2016,7,2,10,11250,12307,9669,-2638
2016,7,2,11,11640,12612,9775,-2837
2016,7,2,12,12580,13174,10557,-2617
2016,7,2,13,13590,13256,10924,-2332
2016,7,2,14,14240,13794,11404,-2390
2016,7,2,15,14670,14146,11600,-2546
2016,7,2,16,15020,14542,11633,-2909
2016,7,2,17,15140,14442,11594,-2848
2016,7,2,18,15200,14444,11558,-2886
2016,7,2,19,15300,14550,11815,-2735
2016,7,2,20,15350,14397,11928,-2469
2016,7,2,21,15560,14565,12205,-2360
2016,7,2,22,15720,14816,12417,-2399
2016,7,2,23,15560,14863,12429,-2434
2016,7,3,0,15160,14531,12241,-2290
2016,7,3,1,14990,14218,11872,-2346
2016,7,3,2,14640,13938,11586,-2352
2016,7,3,3,13640,13048,10986,-2062
2016,7,3,4,12490,11986,10165,-1821
2016,7,3,5,11140,11336,9492,-1844
2016,7,3,6,10600,11032,9243,-1789
2016,7,3,7,10190,10902,9155,-1747
2016,7,3,8,9930,10788,9341,-1447
2016,7,3,9,9860,10691,9180,-1511
2016,7,3,10,9620,10598,9204,-1394
2016,7,3,11,9940,10806,9553,-1253
2016,7,3,12,10670,11519,9989,-1530
2016,7,3,13,11610,11845,10434,-1411
2016,7,3,14,12390,12317,10687,-1630
2016,7,3,15,12950,12850,11318,-1532
2016,7,3,16,13380,13303,11693,-1610
2016,7,3,17,13750,13629,11673,-1956
2016,7,3,18,13900,13860,12076,-1784
2016,7,3,19,14130,14102,12317,-1785
2016,7,3,20,14420,14393,12310,-2083
2016,7,3,21,14890,14779,12577,-2202
2016,7,3,22,15340,15042,12561,-2481
2016,7,3,23,15750,14934,12489,-2445
2016,7,4,0,15210,14572,12359,-2213
2016,7,4,1,15010,14342,12364,-1978
2016,7,4,2,14590,14167,12130,-2037
2016,7,4,3,13500,13441,11229,-2212
2016,7,4,4,12340,12469,10115,-2354
2016,7,4,5,11170,11523,9700,-1823
2016,7,4,6,10530,10863,9528,-1335
2016,7,4,7,10170,10416,9277,-1139
2016,7,4,8,9980,10168,9113,-1055
2016,7,4,9,9890,10101,8903,-1198
2016,7,4,10,10150,10352,8936,-1416
2016,7,4,11,10570,10867,9398,-1469
2016,7,4,12,11590,11832,10386,-1446
2016,7,4,13,12560,12547,11033,-1514
2016,7,4,14,13450,13348,11639,-1709
2016,7,4,15,14150,14130,12542,-1588
2016,7,4,16,14750,14736,12871,-1865
2016,7,4,17,14970,15227,13287,-1940
2016,7,4,18,15010,15541,13490,-2051
2016,7,4,19,15380,15858,13854,-2004
2016,7,4,20,15670,16300,14343,-1957
2016,7,4,21,16300,16824,14776,-2048
2016,7,4,22,16740,17187,14992,-2195
2016,7,4,23,16950,17000,14630,-2370
2016,7,5,0,16310,16452,14092,-2360
2016,7,5,1,15850,16157,13893,-2264
2016,7,5,2,15400,15674,13576,-2098
2016,7,5,3,14270,14669,12853,-1816
2016,7,5,4,13080,13471,11512,-1959
2016,7,5,5,12300,12435,10500,-1935
2016,7,5,6,11660,12396,10164,-2232
2016,7,5,7,11280,12312,10006,-2306
2016,7,5,8,11110,12067,9978,-2089
2016,7,5,9,11380,12202,10370,-1832
2016,7,5,10,11880,12650,10851,-1799
2016,7,5,11,13100,13558,11581,-1977
2016,7,5,12,14410,14799,12673,-2126
2016,7,5,13,15670,15795,13564,-2231
2016,7,5,14,16600,16498,14275,-2223
2016,7,5,15,17580,17157,14992,-2165
2016,7,5,16,18490,17647,15443,-2204
2016,7,5,17,18720,18009,15895,-2114
2016,7,5,18,19440,18381,16325,-2056
2016,7,5,19,19730,18841,16752,-2089
2016,7,5,20,20110,19422,17299,-2123
2016,7,5,21,20710,20037,17826,-2211
2016,7,5,22,20800,20555,18070,-2485
2016,7,5,23,20420,20553,17832,-2721
2016,7,6,0,19690,20076,17605,-2471
2016,7,6,1,19290,19499,17471,-2028
2016,7,6,2,18590,18808,16724,-2084
2016,7,6,3,16990,17095,14712,-2383
2016,7,6,4,15480,15647,13244,-2403
2016,7,6,5,14080,14786,12170,-2616
2016,7,6,6,13210,14169,11562,-2607
2016,7,6,7,12650,13744,11274,-2470
2016,7,6,8,12370,13564,11127,-2437
2016,7,6,9,12320,13579,11195,-2384
2016,7,6,10,12820,14062,11701,-2361
2016,7,6,11,14390,15378,12908,-2470
2016,7,6,12,16300,16429,14223,-2206
2016,7,6,13,17640,17199,14901,-2298
2016,7,6,14,18950,18394,16086,-2308
2016,7,6,15,20100,19519,17250,-2269
2016,7,6,16,21000,20426,18210,-2216
2016,7,6,17,21610,21151,18861,-2290
2016,7,6,18,22240,21845,19499,-2346
2016,7,6,19,22550,22306,19974,-2332
2016,7,6,20,22790,22581,20191,-2390
2016,7,6,21,23000,22881,20425,-2456
2016,7,6,22,22910,23010,20408,-2602
2016,7,6,23,22400,22760,20154,-2606
2016,7,7,0,21710,22108,19076,-3032
2016,7,7,1,21240,21499,18450,-3049
2016,7,7,2,20340,20667,17944,-2723
2016,7,7,3,18390,18765,16154,-2611
2016,7,7,4,16480,17059,14702,-2357
2016,7,7,5,14940,16048,13723,-2325
2016,7,7,6,14040,15476,13047,-2429
2016,7,7,7,13470,15098,12653,-2445
2016,7,7,8,13170,14733,12487,-2246
2016,7,7,9,13430,14704,12473,-2231
2016,7,7,10,13990,15126,12897,-2229
2016,7,7,11,15310,15948,13593,-2355
2016,7,7,12,16940,16677,14328,-2349
2016,7,7,13,18190,17618,15159,-2459
2016,7,7,14,19190,18319,15706,-2613
2016,7,7,15,20200,18983,16521,-2462
2016,7,7,16,21070,19784,17723,-2061
2016,7,7,17,21710,20309,18465,-1844
2016,7,7,18,22340,20711,18861,-1850
2016,7,7,19,22740,20877,19459,-1418
2016,7,7,20,23060,20575,18461,-2114
2016,7,7,21,23250,20387,17902,-2485
2016,7,7,22,23060,20160,17400,-2760
2016,7,7,23,22550,19689,16863,-2826
2016,7,8,0,21940,19156,16294,-2862
2016,7,8,1,21310,18823,15839,-2984
2016,7,8,2,20370,18188,15646,-2542
2016,7,8,3,18570,16682,14283,-2399
2016,7,8,4,16710,15466,13098,-2368
2016,7,8,5,14620,14262,12180,-2082
2016,7,8,6,13780,13987,11905,-2082
2016,7,8,7,13260,13510,11873,-1637
2016,7,8,8,12970,13516,11886,-1630
2016,7,8,9,12450,13618,11946,-1672
2016,7,8,10,12970,13795,12066,-1729
2016,7,8,11,14310,14449,12608,-1841
2016,7,8,12,15870,15430,13418,-2012
2016,7,8,13,16850,16191,14026,-2165
2016,7,8,14,17600,16631,14554,-2077
2016,7,8,15,17120,16875,14804,-2071
2016,7,8,16,17470,17064,15329,-1735
2016,7,8,17,17710,17155,15827,-1328
2016,7,8,18,18070,17277,16332,-945
2016,7,8,19,18130,17313,16131,-1182
2016,7,8,20,18250,17279,16375,-904
2016,7,8,21,18300,17257,16130,-1127
2016,7,8,22,18190,17078,15735,-1343
2016,7,8,23,17670,16596,15116,-1480
2016,7,9,0,17020,16104,14404,-1700
2016,7,9,1,16650,15895,14360,-1535
2016,7,9,2,16140,15347,14199,-1148
2016,7,9,3,14950,14186,13308,-878
2016,7,9,4,13520,12882,11841,-1041
2016,7,9,5,12420,11858,10131,-1727
2016,7,9,6,11750,11213,9620,-1593
2016,7,9,7,11290,11032,9348,-1684
2016,7,9,8,11060,10799,9242,-1557
2016,7,9,9,10960,10941,9221,-1720
2016,7,9,10,10630,11155,9318,-1837
2016,7,9,11,11080,11331,9288,-2043
2016,7,9,12,11920,12030,10184,-1846
2016,7,9,13,12900,12723,10787,-1936
2016,7,9,14,13540,13464,11215,-2249
2016,7,9,15,13910,13875,11662,-2213
2016,7,9,16,14100,14071,11799,-2272
2016,7,9,17,14140,14074,11717,-2357
2016,7,9,18,14050,13921,11534,-2387
2016,7,9,19,14050,13786,11352,-2434
2016,7,9,20,14020,13825,11472,-2353
2016,7,9,21,14200,13875,11675,-2200
2016,7,9,22,14410,13895,11790,-2105
2016,7,9,23,14600,13814,11748,-2066
2016,7,10,0,14320,13738,11997,-1741
2016,7,10,1,14200,13793,12243,-1550
2016,7,10,2,13930,13400,11753,-1647
2016,7,10,3,13080,12553,10881,-1672
2016,7,10,4,12060,11588,9930,-1658
2016,7,10,5,11330,10793,9169,-1624
2016,7,10,6,10770,10295,9157,-1138
2016,7,10,7,10390,10249,9078,-1171
2016,7,10,8,10210,10103,8592,-1511
2016,7,10,9,10140,10062,8714,-1348
2016,7,10,10,9830,10206,8751,-1455
2016,7,10,11,10140,10560,8620,-1940
2016,7,10,12,10890,11032,9142,-1890
2016,7,10,13,11830,11632,9666,-1966
2016,7,10,14,12460,12491,10286,-2205
2016,7,10,15,13160,13115,10993,-2122
2016,7,10,16,13580,13510,11426,-2084
2016,7,10,17,13900,13751,11557,-2194
2016,7,10,18,13860,13863,11796,-2067
2016,7,10,19,14010,13926,12085,-1841
2016,7,10,20,14000,14067,12225,-1842
2016,7,10,21,14390,14348,12480,-1868
2016,7,10,22,14630,14662,12959,-1703
2016,7,10,23,14800,14704,13001,-1703
2016,7,11,0,14700,14549,12896,-1653
2016,7,11,1,14710,14498,12802,-1696
2016,7,11,2,14270,14085,12605,-1480
2016,7,11,3,13110,13010,11655,-1355
2016,7,11,4,11980,11833,10349,-1484
2016,7,11,5,11030,11149,9587,-1562
2016,7,11,6,10560,10697,9455,-1242
2016,7,11,7,10270,10412,9708,-704
2016,7,11,8,10210,10352,9534,-818
2016,7,11,9,10390,10591,9804,-787
2016,7,11,10,11090,11257,10078,-1179
2016,7,11,11,12560,12326,10841,-1485
2016,7,11,12,13860,13644,11680,-1964
2016,7,11,13,14630,14477,12639,-1838
2016,7,11,14,14980,15004,12992,-2012
2016,7,11,15,15520,15436,13383,-2053
2016,7,11,16,15860,15715,13610,-2105
2016,7,11,17,16030,15787,13776,-2011
2016,7,11,18,16300,15990,13945,-2045
2016,7,11,19,16490,16141,14119,-2022
2016,7,11,20,16620,16413,14598,-1815
2016,7,11,21,16900,16746,15120,-1626
2016,7,11,22,17150,16939,15220,-1719
2016,7,11,23,16840,16858,14960,-1898
2016,7,12,0,16540,16524,14599,-1925
2016,7,12,1,16340,16351,14515,-1836
2016,7,12,2,15750,15893,13983,-1910
2016,7,12,3,14250,14418,12677,-1741
2016,7,12,4,12830,12883,10960,-1923
2016,7,12,5,11780,12441,10625,-1816
2016,7,12,6,11070,12402,10424,-1978
2016,7,12,7,10690,12085,10165,-1920
2016,7,12,8,10550,11880,10120,-1760
2016,7,12,9,10690,11811,10268,-1543
2016,7,12,10,11330,11867,10391,-1476
2016,7,12,11,12810,12597,10929,-1668
2016,7,12,12,14270,14059,12108,-1951
2016,7,12,13,15220,15040,13031,-2009
2016,7,12,14,15870,15805,13737,-2068
2016,7,12,15,16660,16534,14456,-2078
2016,7,12,16,17290,17133,15197,-1936
2016,7,12,17,17620,17601,15836,-1765
2016,7,12,18,18250,18183,16301,-1882
2016,7,12,19,18560,18683,16799,-1884
2016,7,12,20,18890,19141,17400,-1741
2016,7,12,21,19220,19546,17580,-1966
2016,7,12,22,19390,19744,17641,-2103
2016,7,12,23,19020,19456,17288,-2168
2016,7,13,0,18500,18817,16543,-2274
2016,7,13,1,18080,18391,16102,-2289
2016,7,13,2,17360,17777,15436,-2341
2016,7,13,3,15690,16179,13843,-2336
2016,7,13,4,14030,14516,12817,-1699
2016,7,13,5,13040,13756,11517,-2239
2016,7,13,6,12320,13215,10648,-2567
2016,7,13,7,11890,13024,10530,-2494
2016,7,13,8,11670,13048,10553,-2495
2016,7,13,9,11840,13147,10672,-2475
2016,7,13,10,12450,13492,10800,-2692
2016,7,13,11,13910,14018,11292,-2726
2016,7,13,12,15520,15545,12934,-2611
2016,7,13,13,16690,16749,13862,-2887
2016,7,13,14,17580,17733,14963,-2770
2016,7,13,15,18620,18757,16082,-2675
2016,7,13,16,19380,19669,16798,-2871
2016,7,13,17,20000,20403,17269,-3134
2016,7,13,18,20690,21126,17677,-3449
2016,7,13,19,21150,21503,17856,-3647
2016,7,13,20,21480,21828,18368,-3460
2016,7,13,21,21800,22086,19060,-3026
2016,7,13,22,21620,22147,18892,-3255
2016,7,13,23,20980,21671,18157,-3514
2016,7,14,0,20300,20869,17108,-3761
2016,7,14,1,19800,20245,16679,-3566
2016,7,14,2,18880,19419,15956,-3463
2016,7,14,3,17110,17567,14508,-3059
2016,7,14,4,15320,15937,12829,-3108
2016,7,14,5,14170,14736,11971,-2765
2016,7,14,6,13430,14368,11823,-2545
2016,7,14,7,12960,14090,11578,-2512
2016,7,14,8,12740,13929,11460,-2469
2016,7,14,9,12920,14136,11632,-2504
2016,7,14,10,13600,14349,12175,-2174
2016,7,14,11,14990,15358,13030,-2328
2016,7,14,12,16530,16822,14261,-2561
2016,7,14,13,17670,17802,15027,-2775
2016,7,14,14,18610,18635,15499,-3136
2016,7,14,15,19580,19465,16310,-3155
2016,7,14,16,20430,20048,17002,-3046
2016,7,14,17,21080,20472,17414,-3058
2016,7,14,18,21780,20822,17858,-2964
2016,7,14,19,22230,21056,18283,-2773
2016,7,14,20,22510,21184,18696,-2488
2016,7,14,21,22750,21173,18667,-2506
2016,7,14,22,22720,21184,18416,-2768
2016,7,14,23,22300,20889,17918,-2971
2016,7,15,0,21820,20399,17459,-2940
2016,7,15,1,21340,20130,17348,-2782
2016,7,15,2,20440,19467,16873,-2594
2016,7,15,3,18630,17856,15381,-2475
2016,7,15,4,16880,16506,13745,-2761
2016,7,15,5,15240,15563,12570,-2993
2016,7,15,6,14360,15049,12207,-2842
2016,7,15,7,13790,14573,12092,-2481
2016,7,15,8,13510,14301,12180,-2121
2016,7,15,9,13560,14275,12343,-1932
2016,7,15,10,13990,14285,12241,-2044
2016,7,15,11,15320,15380,12914,-2466
2016,7,15,12,17070,17195,14651,-2544
2016,7,15,13,18360,18749,16145,-2604
2016,7,15,14,19400,19958,17120,-2838
2016,7,15,15,20550,21075,17997,-3078
2016,7,15,16,21430,21802,18555,-3247
2016,7,15,17,22080,22308,18773,-3535
2016,7,15,18,22660,22723,18882,-3841
2016,7,15,19,23120,22884,19041,-3843
2016,7,15,20,23290,22900,19314,-3586
2016,7,15,21,23400,22910,19358,-3552
2016,7,15,22,23130,22878,19060,-3818
2016,7,15,23,22470,22552,18961,-3591
2016,7,16,0,21750,21890,18273,-3617
2016,7,16,1,21110,21237,17573,-3664
2016,7,16,2,20290,20441,16899,-3542
2016,7,16,3,18620,18813,15763,-3050
2016,7,16,4,16870,17194,14307,-2887
2016,7,16,5,15170,16029,13315,-2714
2016,7,16,6,14250,15272,12668,-2604
2016,7,16,7,13560,14865,12272,-2593
2016,7,16,8,13090,14355,11771,-2584
2016,7,16,9,12980,14323,11501,-2822
2016,7,16,10,12970,14229,11473,-2756
2016,7,16,11,13500,14706,11849,-2857
2016,7,16,12,14640,14823,12668,-2155
2016,7,16,13,16020,16050,14217,-1833
2016,7,16,14,17090,17266,15438,-1828
2016,7,16,15,18110,18259,16020,-2239
2016,7,16,16,18800,18988,16834,-2154
2016,7,16,17,19420,19495,17406,-2089
2016,7,16,18,19760,19919,17717,-2202
2016,7,16,19,20050,20236,18010,-2226
2016,7,16,20,20380,20591,18311,-2280
2016,7,16,21,20440,20749,18344,-2405
2016,7,16,22,20500,20751,18069,-2682
2016,7,16,23,20340,20308,17469,-2839
2016,7,17,0,19570,19696,16848,-2848
2016,7,17,1,19270,19346,16348,-2998
2016,7,17,2,18550,18807,15849,-2958
2016,7,17,3,17310,17476,14723,-2753
2016,7,17,4,15800,16105,13082,-3023
2016,7,17,5,14720,15160,12169,-2991
2016,7,17,6,13960,14825,11488,-3337
2016,7,17,7,13380,14740,11334,-3406
2016,7,17,8,12950,14650,11289,-3361
2016,7,17,9,12910,14508,11215,-3293
2016,7,17,10,12770,14447,11427,-3020
2016,7,17,11,12990,14400,11407,-2993
2016,7,17,12,13830,15007,12094,-2913
2016,7,17,13,15040,15015,12375,-2640
2016,7,17,14,16090,15924,13350,-2574
2016,7,17,15,16960,16991,14609,-2382
2016,7,17,16,17670,17930,15459,-2471
2016,7,17,17,18410,18667,15852,-2815
2016,7,17,18,18810,19107,16321,-2786
2016,7,17,19,19090,19477,16755,-2722
2016,7,17,20,19380,19857,17207,-2650
2016,7,17,21,19740,20252,17493,-2759
2016,7,17,22,19880,20510,17769,-2741
2016,7,17,23,19750,20409,17943,-2466
2016,7,18,0,19280,19919,17584,-2335
2016,7,18,1,19110,19613,17097,-2516
2016,7,18,2,18430,19015,16263,-2752
2016,7,18,3,17080,17364,14625,-2739
2016,7,18,4,15540,15966,13195,-2771
2016,7,18,5,14410,14812,12134,-2678
2016,7,18,6,13560,14692,11832,-2860
2016,7,18,7,13070,14423,11420,-3003
2016,7,18,8,12880,14474,11546,-2928
2016,7,18,9,12980,14567,11735,-2832
2016,7,18,10,13730,14714,12178,-2536
2016,7,18,11,15080,15871,13228,-2643
2016,7,18,12,16760,16936,14337,-2599
2016,7,18,13,18010,18110,15389,-2721
2016,7,18,14,19030,19360,16651,-2709
2016,7,18,15,20080,20622,18014,-2608
2016,7,18,16,20920,21671,19035,-2636
2016,7,18,17,21550,22450,19311,-3139
2016,7,18,18,22050,23208,20060,-3148
2016,7,18,19,22460,23617,20346,-3271
2016,7,18,20,22720,23083,20205,-2878
2016,7,18,21,22740,22391,19768,-2623
2016,7,18,22,22900,21851,19276,-2575
2016,7,18,23,22260,21484,18461,-3023
2016,7,19,0,21780,21066,18119,-2947
2016,7,19,1,21250,20707,17778,-2929
2016,7,19,2,20240,19881,16779,-3102
2016,7,19,3,18440,18147,15154,-2993
2016,7,19,4,16700,16660,13882,-2778
2016,7,19,5,15230,15607,13166,-2441
2016,7,19,6,14280,15181,12646,-2535
2016,7,19,7,13630,14791,12027,-2764
2016,7,19,8,13270,14802,11984,-2818
2016,7,19,9,13200,14943,12058,-2885
2016,7,19,10,13750,14909,12144,-2765
2016,7,19,11,14950,15563,12896,-2667
2016,7,19,12,16100,16520,14211,-2309
2016,7,19,13,16870,17283,14591,-2692
2016,7,19,14,17400,17824,15109,-2715
2016,7,19,15,17940,18374,15661,-2713
2016,7,19,16,18370,18835,15998,-2837
2016,7,19,17,18580,19021,16209,-2812
2016,7,19,18,18960,19247,16538,-2709
2016,7,19,19,19220,19340,16516,-2824
2016,7,19,20,19310,19393,16547,-2846
2016,7,19,21,19450,19399,16716,-2683
2016,7,19,22,19370,19286,16287,-2999
2016,7,19,23,18860,18777,16031,-2746
2016,7,20,0,18130,18032,15214,-2818
2016,7,20,1,17810,17524,14934,-2590
2016,7,20,2,16960,16800,14588,-2212
2016,7,20,3,15370,15194,12966,-2228
2016,7,20,4,13780,13599,11297,-2302
2016,7,20,5,12760,12717,10207,-2510
2016,7,20,6,12030,12360,9716,-2644
2016,7,20,7,11520,12125,9723,-2402
2016,7,20,8,11280,11801,9901,-1900
2016,7,20,9,11110,11882,10011,-1871
2016,7,20,10,11730,12196,10333,-1863
2016,7,20,11,13070,13174,11027,-2147
2016,7,20,12,14450,14256,12056,-2200
2016,7,20,13,15240,15105,12857,-2248
2016,7,20,14,15790,15689,13608,-2081
2016,7,20,15,16370,16157,13987,-2170
2016,7,20,16,16790,16603,14396,-2207
2016,7,20,17,17120,16941,14508,-2433
2016,7,20,18,17550,17443,14906,-2537
2016,7,20,19,17890,17836,15380,-2456
2016,7,20,20,18200,18191,15889,-2302
2016,7,20,21,18500,18618,16375,-2243
2016,7,20,22,18430,18808,16285,-2523
2016,7,20,23,18040,18526,15795,-2731
2016,7,21,0,17540,17970,15355,-2615
2016,7,21,1,17140,17710,15178,-2532
2016,7,21,2,16470,17058,14826,-2232
2016,7,21,3,14940,15465,13151,-2314
2016,7,21,4,13420,13855,11410,-2445
2016,7,21,5,12360,12913,10594,-2319
2016,7,21,6,11650,12194,10270,-1924
2016,7,21,7,11170,11713,10336,-1377
2016,7,21,8,10930,11479,10268,-1211
2016,7,21,9,11020,11836,10245,-1591
2016,7,21,10,11900,12644,10408,-2236
2016,7,21,11,13290,13687,11333,-2354
2016,7,21,12,14730,15204,12742,-2462
2016,7,21,13,15760,15804,13486,-2318
2016,7,21,14,16610,16586,14107,-2479
2016,7,21,15,17460,17417,15113,-2304
2016,7,21,16,18110,18111,16052,-2059
2016,7,21,17,18680,18695,16714,-1981
2016,7,21,18,19340,19418,17471,-1947
2016,7,21,19,19730,20041,18009,-2032
2016,7,21,20,20190,20629,18382,-2247
2016,7,21,21,20480,21164,18712,-2452
2016,7,21,22,20520,21396,18980,-2416
2016,7,21,23,20030,21154,18493,-2661
2016,7,22,0,19460,20572,17724,-2848
2016,7,22,1,19200,20171,17208,-2963
2016,7,22,2,18430,19392,16504,-2888
2016,7,22,3,16720,17694,15089,-2605
2016,7,22,4,15100,16029,13067,-2962
2016,7,22,5,13800,15368,12384,-2984
2016,7,22,6,12980,15120,12452,-2668
2016,7,22,7,12500,14906,12261,-2645
2016,7,22,8,12250,14586,11890,-2696
2016,7,22,9,12360,14439,11676,-2763
2016,7,22,10,13790,14728,12057,-2671
2016,7,22,11,15240,15512,13094,-2418
2016,7,22,12,16820,16727,14544,-2183
2016,7,22,13,18250,17877,15604,-2273
2016,7,22,14,19440,18955,16656,-2299
2016,7,22,15,20350,20179,17627,-2552
2016,7,22,16,21340,21262,18588,-2674
2016,7,22,17,22260,22213,19473,-2740
2016,7,22,18,23010,23086,20389,-2697
2016,7,22,19,23600,23646,20857,-2789
2016,7,22,20,23910,24015,20916,-3099
2016,7,22,21,24000,24254,20825,-3429
2016,7,22,22,23870,24305,21139,-3166
2016,7,22,23,23220,23880,20963,-2917
2016,7,23,0,22570,23141,20196,-2945
2016,7,23,1,21920,22423,19220,-3203
2016,7,23,2,21130,21387,18350,-3037
2016,7,23,3,19410,19676,16743,-2933
2016,7,23,4,17590,18088,14905,-3183
2016,7,23,5,16410,16980,13936,-3044
2016,7,23,6,15340,16338,13357,-2981
2016,7,23,7,14750,15853,12785,-3068
2016,7,23,8,14270,15567,12903,-2664
2016,7,23,9,14080,15275,12651,-2624
2016,7,23,10,14070,15444,12781,-2663
2016,7,23,11,14710,15754,13200,-2554
2016,7,23,12,15880,16298,13925,-2373
2016,7,23,13,17360,17261,14845,-2416
2016,7,23,14,18680,18473,15858,-2615
2016,7,23,15,19760,19520,16567,-2953
2016,7,23,16,20630,20313,17137,-3176
2016,7,23,17,21150,20895,17829,-3066
2016,7,23,18,21570,21333,18450,-2883
2016,7,23,19,21830,21553,18767,-2786
2016,7,23,20,21970,21733,18882,-2851
2016,7,23,21,22000,21926,19015,-2911
2016,7,23,22,21980,21929,19062,-2867
2016,7,23,23,21510,21262,18362,-2900
2016,7,24,0,20740,20158,17053,-3105
2016,7,24,1,20200,19281,16368,-2913
2016,7,24,2,19540,18462,15913,-2549
2016,7,24,3,17970,16998,14673,-2325
2016,7,24,4,16340,15662,13957,-1705
2016,7,24,5,14770,14679,12429,-2250
2016,7,24,6,13950,14220,12057,-2163
2016,7,24,7,13290,14095,11914,-2181
2016,7,24,8,12840,13836,11527,-2309
2016,7,24,9,12630,13592,11318,-2274
2016,7,24,10,11970,13472,11516,-1956
2016,7,24,11,12200,13727,11608,-2119
2016,7,24,12,13080,13787,11710,-2077
2016,7,24,13,14370,14276,12337,-1939
2016,7,24,14,15470,15419,13658,-1761
2016,7,24,15,16540,16383,14478,-1905
2016,7,24,16,17310,17248,15094,-2154
2016,7,24,17,18060,17970,15890,-2080
2016,7,24,18,18500,18408,16166,-2242
2016,7,24,19,18980,18933,16557,-2376
2016,7,24,20,19550,19513,17141,-2372
2016,7,24,21,20030,20085,17411,-2674
2016,7,24,22,20300,20542,17659,-2883
2016,7,24,23,19890,20478,17377,-3101
2016,7,25,0,19400,19935,16992,-2943
2016,7,25,1,18990,19528,16914,-2614
2016,7,25,2,18280,18778,16445,-2333
2016,7,25,3,16790,17128,14893,-2235
2016,7,25,4,15220,15850,13561,-2289
2016,7,25,5,13980,14761,12239,-2522
2016,7,25,6,13280,14194,11650,-2544
2016,7,25,7,12810,13867,11656,-2211
2016,7,25,8,12590,13340,11710,-1630
2016,7,25,9,12910,13402,11678,-1724
2016,7,25,10,13390,13793,12136,-1657
2016,7,25,11,14900,14779,12408,-2371
2016,7,25,12,16750,16180,13603,-2577
2016,7,25,13,18080,17448,14817,-2631
2016,7,25,14,19530,18640,15890,-2750
2016,7,25,15,20790,19975,16895,-3080
2016,7,25,16,21960,21175,17860,-3315
2016,7,25,17,22750,22124,18890,-3234
2016,7,25,18,23600,23074,19817,-3257
2016,7,25,19,24080,23591,20640,-2951
2016,7,25,20,24500,23641,20677,-2964
2016,7,25,21,24340,23411,20573,-2838
2016,7,25,22,24070,23220,20592,-2628
2016,7,25,23,23640,22726,19976,-2750
2016,7,26,0,22920,22101,18882,-3219
2016,7,26,1,22280,21609,18475,-3134
2016,7,26,2,21090,20597,17095,-3502
2016,7,26,3,19110,19012,15969,-3043
2016,7,26,4,17260,17355,14358,-2997
2016,7,26,5,15800,16555,13689,-2866
2016,7,26,6,14840,16142,13115,-3027
2016,7,26,7,14330,15820,12792,-3028
2016,7,26,8,14000,15465,12731,-2734
2016,7,26,9,14080,15439,12730,-2709
2016,7,26,10,14560,15724,13037,-2687
2016,7,26,11,15910,16559,13657,-2902
2016,7,26,12,17530,17587,14780,-2807
2016,7,26,13,18680,18782,15926,-2856
2016,7,26,14,19690,19754,16562,-3192
2016,7,26,15,20710,20685,17689,-2996
2016,7,26,16,21610,21468,18365,-3103
2016,7,26,17,22220,22014,18767,-3247
2016,7,26,18,22910,22690,19543,-3147
2016,7,26,19,23320,23159,20162,-2997
2016,7,26,20,23520,23455,20548,-2907
2016,7,26,21,23800,23742,20910,-2832
2016,7,26,22,23610,23839,20863,-2976
2016,7,26,23,23000,23445,20424,-3021
2016,7,27,0,22280,22679,19618,-3061
2016,7,27,1,21840,22038,18789,-3249
2016,7,27,2,20750,20987,18017,-2970
2016,7,27,3,18750,19015,16237,-2778
2016,7,27,4,16810,17319,14510,-2809
2016,7,27,5,15300,16013,13298,-2715
2016,7,27,6,14300,15459,12738,-2721
2016,7,27,7,13730,15315,12404,-2911
2016,7,27,8,13410,14937,12065,-2872
2016,7,27,9,13450,14892,12044,-2848
2016,7,27,10,13840,15113,12532,-2581
2016,7,27,11,15320,15665,13213,-2452
2016,7,27,12,16940,16801,14387,-2414
2016,7,27,13,18170,17998,15332,-2666
2016,7,27,14,19220,19023,16634,-2389
2016,7,27,15,20310,20071,17644,-2427
2016,7,27,16,21270,20981,18366,-2615
2016,7,27,17,21960,21730,18614,-3116
2016,7,27,18,22710,22384,18893,-3491
2016,7,27,19,23290,22817,19453,-3364
2016,7,27,20,23350,23149,19980,-3169
2016,7,27,21,23570,23487,20581,-2906
2016,7,27,22,23460,23620,20766,-2854
2016,7,27,23,23000,23212,20250,-2962
2016,7,28,0,22280,22378,19106,-3272
2016,7,28,1,21840,21781,18376,-3405
2016,7,28,2,20770,20761,17699,-3062
2016,7,28,3,18740,18875,16053,-2822
2016,7,28,4,16790,17085,14214,-2871
2016,7,28,5,15430,15816,13464,-2352
2016,7,28,6,14500,15334,12850,-2484
2016,7,28,7,13850,15268,12794,-2474
2016,7,28,8,13550,15158,12768,-2390
2016,7,28,9,13560,14931,12742,-2189
2016,7,28,10,14010,15200,13189,-2011
2016,7,28,11,15430,15827,13650,-2177
2016,7,28,12,17190,17083,14908,-2175
2016,7,28,13,18530,18372,16097,-2275
2016,7,28,14,19730,19621,17297,-2324
2016,7,28,15,20790,20885,18258,-2627
2016,7,28,16,21690,21882,19042,-2840
2016,7,28,17,22420,22590,19642,-2948
2016,7,28,18,23150,23268,20386,-2882
2016,7,28,19,23600,23573,20817,-2756
2016,7,28,20,23790,23689,21001,-2688
2016,7,28,21,23940,23738,21019,-2719
2016,7,28,22,23870,23698,20547,-3151
2016,7,28,23,23240,23165,19827,-3338
2016,7,29,0,22640,22531,19020,-3511
2016,7,29,1,22150,22273,18704,-3569
2016,7,29,2,21180,21295,18019,-3276
2016,7,29,3,19240,19538,16572,-2966
2016,7,29,4,17370,17839,15666,-2173
2016,7,29,5,15970,16782,13984,-2798
2016,7,29,6,15110,16352,13473,-2879
2016,7,29,7,14570,16036,13069,-2967
2016,7,29,8,14270,15699,12933,-2766
2016,7,29,9,14320,15465,12639,-2826
2016,7,29,10,15200,15811,13110,-2701
2016,7,29,11,16430,16641,13737,-2904
2016,7,29,12,17750,17590,14641,-2949
2016,7,29,13,18570,18275,15311,-2964
2016,7,29,14,19200,18762,15608,-3154
2016,7,29,15,19870,19082,15941,-3141
2016,7,29,16,20340,19320,16328,-2992
2016,7,29,17,20660,19478,16558,-2920
2016,7,29,18,21010,19863,17046,-2817
2016,7,29,19,21230,20457,17617,-2840
2016,7,29,20,21330,20966,18095,-2871
2016,7,29,21,21500,21354,18465,-2889
2016,7,29,22,21220,21368,18554,-2814
2016,7,29,23,20510,20833,17463,-3370
2016,7,30,0,19780,20054,16759,-3295
2016,7,30,1,19400,19619,16479,-3140
2016,7,30,2,18650,18855,15536,-3319
2016,7,30,3,17210,17407,14305,-3102
2016,7,30,4,15650,15804,12669,-3135
2016,7,30,5,14450,14575,11393,-3182
2016,7,30,6,13550,14170,10829,-3341
2016,7,30,7,12910,13654,10496,-3158
2016,7,30,8,12540,13472,10369,-3103
2016,7,30,9,12400,13546,10516,-3030
2016,7,30,10,12560,13648,10616,-3032
2016,7,30,11,12970,13832,10975,-2857
2016,7,30,12,13900,14338,11949,-2389
2016,7,30,13,15040,15354,12608,-2746
2016,7,30,14,15950,15963,13472,-2491
2016,7,30,15,16660,16764,14388,-2376
2016,7,30,16,17170,17417,14975,-2442
2016,7,30,17,17490,18018,15554,-2464
2016,7,30,18,17700,18453,15957,-2496
2016,7,30,19,18140,18707,15933,-2774
2016,7,30,20,18470,18875,15873,-3002
2016,7,30,21,18770,19052,15990,-3062
2016,7,30,22,18970,19122,16176,-2946
2016,7,30,23,18680,18756,15558,-3198
2016,7,31,0,18070,18296,14844,-3452
2016,7,31,1,17830,18198,14807,-3391
2016,7,31,2,17220,17605,14360,-3245
2016,7,31,3,16120,16476,13452,-3024
2016,7,31,4,14830,15260,12271,-2989
2016,7,31,5,13760,14507,11832,-2675
2016,7,31,6,13000,14018,11442,-2576
2016,7,31,7,12520,14026,11567,-2459
2016,7,31,8,12190,13792,11271,-2521
2016,7,31,9,12090,13845,11204,-2641
2016,7,31,10,12660,13937,11367,-2570
2016,7,31,11,12910,13924,11184,-2740
2016,7,31,12,13460,13906,11097,-2809
2016,7,31,13,14280,14308,11628,-2680
2016,7,31,14,15250,15034,12451,-2583
2016,7,31,15,15680,15581,13128,-2453
2016,7,31,16,16140,15943,13611,-2332
2016,7,31,17,16420,16138,13994,-2144
2016,7,31,18,16570,16227,13906,-2321
2016,7,31,19,16820,16310,13949,-2361
2016,7,31,20,16890,16452,14196,-2256
2016,7,31,21,17220,16755,14459,-2296
2016,7,31,22,17490,17025,14651,-2374
2016,7,31,23,17540,16986,14568,-2418
2016,8,1,0,17090,16858,14295,-2563
2016,8,1,1,16980,16864,14342,-2522
2016,8,1,2,16330,16245,13522,-2723
2016,8,1,3,15160,15025,12296,-2729
2016,8,1,4,13900,13794,11208,-2586
2016,8,1,5,12970,13371,10888,-2483
2016,8,1,6,12360,13212,10726,-2486
2016,8,1,7,12020,13297,10772,-2525
2016,8,1,8,11910,13162,10769,-2393
2016,8,1,9,12110,13217,10883,-2334
2016,8,1,10,12800,13385,11309,-2076
2016,8,1,11,14140,14258,12201,-2057
2016,8,1,12,15410,15355,13057,-2298
2016,8,1,13,16190,16258,13755,-2503
2016,8,1,14,16760,17004,14650,-2354
2016,8,1,15,17180,17598,15255,-2343
2016,8,1,16,17490,18016,15512,-2504
2016,8,1,17,17500,18251,15649,-2602
2016,8,1,18,17790,18505,15809,-2696
2016,8,1,19,17810,18604,15991,-2613
2016,8,1,20,17830,18516,16179,-2337
2016,8,1,21,17870,18467,16219,-2248
2016,8,1,22,17900,18388,16083,-2305
2016,8,1,23,17350,18031,15552,-2479
2016,8,2,0,17100,17696,15220,-2476
2016,8,2,1,17140,17581,15221,-2360
2016,8,2,2,16190,16736,14190,-2546
2016,8,2,3,14750,15318,13026,-2292
2016,8,2,4,13450,13908,11642,-2266
2016,8,2,5,12510,12989,10308,-2681
2016,8,2,6,11960,12709,10234,-2475
2016,8,2,7,11600,12685,10195,-2490
2016,8,2,8,11460,12725,10436,-2289
2016,8,2,9,11580,12866,10511,-2355
2016,8,2,10,12530,13289,10854,-2435
2016,8,2,11,13880,13934,11333,-2601
2016,8,2,12,15050,15051,12533,-2518
2016,8,2,13,15800,15842,13302,-2540
2016,8,2,14,16250,16294,13614,-2680
2016,8,2,15,16670,16726,14017,-2709
2016,8,2,16,16960,16928,14247,-2681
2016,8,2,17,17170,16983,14295,-2688
2016,8,2,18,17530,17065,14311,-2754
2016,8,2,19,17700,17015,14225,-2790
2016,8,2,20,17860,17031,14482,-2549
2016,8,2,21,17990,17189,14737,-2452
2016,8,2,22,18180,17373,14735,-2638
2016,8,2,23,17850,17278,14887,-2391
2016,8,3,0,17370,16842,14545,-2297
2016,8,3,1,17270,16711,14348,-2363
2016,8,3,2,16420,16018,13626,-2392
2016,8,3,3,14890,14593,12085,-2508
2016,8,3,4,13460,13261,10651,-2610
2016,8,3,5,12460,12405,9671,-2734
2016,8,3,6,11790,12290,9506,-2784
2016,8,3,7,11380,12127,9468,-2659
2016,8,3,8,11180,12365,9692,-2673
2016,8,3,9,11350,12547,9724,-2823
2016,8,3,10,12010,12616,9781,-2835
2016,8,3,11,13220,13017,10445,-2572
2016,8,3,12,14590,14076,11634,-2442
2016,8,3,13,15430,14971,12533,-2438
2016,8,3,14,16080,15587,13007,-2580
2016,8,3,15,16640,16192,13661,-2531
2016,8,3,16,17150,16718,14115,-2603
2016,8,3,17,17530,17134,14708,-2426
2016,8,3,18,17990,17683,15387,-2296
2016,8,3,19,18320,18110,15752,-2358
2016,8,3,20,18590,18470,16103,-2367
2016,8,3,21,18810,18755,16217,-2538
2016,8,3,22,19000,18851,16195,-2656
2016,8,3,23,18520,18536,16000,-2536
2016,8,4,0,17890,17927,15414,-2513
2016,8,4,1,17770,17640,15231,-2409
2016,8,4,2,16890,16820,14415,-2405
2016,8,4,3,15320,15237,12768,-2469
2016,8,4,4,13790,13721,11114,-2607
2016,8,4,5,12420,12809,10505,-2304
2016,8,4,6,11730,12668,10227,-2441
2016,8,4,7,11300,12640,10133,-2507
2016,8,4,8,11100,12504,10117,-2387
2016,8,4,9,11260,12461,10218,-2243
2016,8,4,10,11880,12812,10454,-2358
2016,8,4,11,13090,13661,11045,-2616
2016,8,4,12,14470,14350,11823,-2527
2016,8,4,13,15410,15273,12998,-2275
2016,8,4,14,16120,16055,13673,-2382
2016,8,4,15,16820,16761,14338,-2423
2016,8,4,16,17310,17357,14923,-2434
2016,8,4,17,17740,17861,15599,-2262
2016,8,4,18,18230,18429,16168,-2261
2016,8,4,19,18570,18874,16427,-2447
2016,8,4,20,18860,19262,16737,-2525
2016,8,4,21,19100,19627,17009,-2618
2016,8,4,22,19070,19767,16842,-2925
2016,8,4,23,18750,19435,16552,-2883
2016,8,5,0,18050,18688,15665,-3023
2016,8,5,1,17940,18373,15663,-2710
2016,8,5,2,17100,17503,15107,-2396
2016,8,5,3,15510,15886,13285,-2601
2016,8,5,4,14010,14286,11412,-2874
2016,8,5,5,12810,13374,10798,-2576
2016,8,5,6,12080,13074,10378,-2696
2016,8,5,7,11600,12913,10206,-2707
2016,8,5,8,11370,13152,10484,-2668
2016,8,5,9,11700,13205,10406,-2799
2016,8,5,10,12290,13441,10534,-2907
2016,8,5,11,13460,13943,10889,-3054
2016,8,5,12,14960,14757,11947,-2810
2016,8,5,13,15960,15800,13378,-2422
2016,8,5,14,16850,16705,14138,-2567
2016,8,5,15,17700,17524,14927,-2597
2016,8,5,16,18540,18256,15646,-2610
2016,8,5,17,19070,18843,16389,-2454
2016,8,5,18,19640,19450,16821,-2629
2016,8,5,19,20180,19937,17390,-2547
2016,8,5,20,20340,20246,17781,-2465
2016,8,5,21,20540,20540,17704,-2836
2016,8,5,22,20350,20588,17587,-3001
2016,8,5,23,19880,20098,16722,-3376
2016,8,6,0,18950,19269,15825,-3444
2016,8,6,1,18610,18869,15729,-3140
2016,8,6,2,17820,18058,15037,-3021
2016,8,6,3,16430,16682,13825,-2857
2016,8,6,4,14880,15204,12302,-2902
2016,8,6,5,13770,14013,11509,-2504
2016,8,6,6,12970,13543,10545,-2998
2016,8,6,7,12420,13453,10550,-2903
2016,8,6,8,12110,13125,10212,-2913
2016,8,6,9,12070,13326,10376,-2950
2016,8,6,10,12420,13248,10289,-2959
2016,8,6,11,12800,13214,10147,-3067
2016,8,6,12,13920,13986,11175,-2811
2016,8,6,13,15290,15128,12399,-2729
2016,8,6,14,16510,16286,13235,-3051
2016,8,6,15,17440,17203,14008,-3195
2016,8,6,16,18200,17876,14597,-3279
2016,8,6,17,18760,18470,15235,-3235
2016,8,6,18,19170,19115,15833,-3282
2016,8,6,19,19520,19583,16116,-3467
2016,8,6,20,19830,20011,16621,-3390
2016,8,6,21,20020,20364,16958,-3406
2016,8,6,22,20030,20509,17069,-3440
2016,8,6,23,19700,20098,16491,-3607
2016,8,7,0,19090,19442,15875,-3567
2016,8,7,1,18740,19111,15726,-3385
2016,8,7,2,18030,18281,15357,-2924
2016,8,7,3,16810,16860,14073,-2787
2016,8,7,4,15340,15349,12133,-3216
2016,8,7,5,13740,14209,11149,-3060
2016,8,7,6,12970,13886,11024,-2862
2016,8,7,7,12340,13500,10924,-2576
2016,8,7,8,11920,13079,10539,-2540
2016,8,7,9,11680,13065,10390,-2675
2016,8,7,10,11570,13009,10393,-2616
2016,8,7,11,11770,13020,10248,-2772
2016,8,7,12,12630,13227,10646,-2581
2016,8,7,13,13820,14067,11494,-2573
2016,8,7,14,14920,14813,12548,-2265
2016,8,7,15,15820,15693,13348,-2345
2016,8,7,16,16600,16476,13947,-2529
2016,8,7,17,17200,17098,14504,-2594
2016,8,7,18,17690,17485,14757,-2728
2016,8,7,19,18110,17770,14941,-2829
2016,8,7,20,18650,18143,15302,-2841
2016,8,7,21,19200,18614,15856,-2758
2016,8,7,22,19620,18967,16296,-2671
2016,8,7,23,19550,18913,16056,-2857
2016,8,8,0,19000,18384,15473,-2911
2016,8,8,1,18710,18169,15592,-2577
2016,8,8,2,17950,17356,15044,-2312
2016,8,8,3,16390,15901,13606,-2295
2016,8,8,4,14890,14695,12450,-2245
2016,8,8,5,13180,13845,11498,-2347
2016,8,8,6,12430,13226,10985,-2241
2016,8,8,7,11900,12994,10640,-2354
2016,8,8,8,11690,13027,10543,-2484
2016,8,8,9,11810,13125,10646,-2479
2016,8,8,10,12460,13185,10754,-2431
2016,8,8,11,13640,14072,11828,-2244
2016,8,8,12,15030,14904,12297,-2607
2016,8,8,13,16060,15944,13449,-2495
2016,8,8,14,16910,16706,14056,-2650
2016,8,8,15,17650,17434,14783,-2651
2016,8,8,16,18300,18019,15309,-2710
2016,8,8,17,18760,18566,15893,-2673
2016,8,8,18,19250,19096,16557,-2539
2016,8,8,19,19670,19513,17129,-2384
2016,8,8,20,19940,19841,17379,-2462
2016,8,8,21,20240,20229,17901,-2328
2016,8,8,22,20420,20434,17950,-2484
2016,8,8,23,19920,20173,17201,-2972
2016,8,9,0,18990,19424,16418,-3006
2016,8,9,1,18590,18999,16014,-2985
2016,8,9,2,17480,17883,14902,-2981
2016,8,9,3,15800,16089,13265,-2824
2016,8,9,4,14250,14521,12179,-2342
2016,8,9,5,12880,13803,10817,-2986
2016,8,9,6,12130,13397,10379,-3018
2016,8,9,7,11640,13167,10489,-2678
2016,8,9,8,11400,12836,10338,-2498
2016,8,9,9,11510,12901,10486,-2415
2016,8,9,10,12240,13344,10618,-2726
2016,8,9,11,13460,14093,11400,-2693
2016,8,9,12,14750,15051,12365,-2686
2016,8,9,13,15760,15735,13021,-2714
2016,8,9,14,16520,16463,13642,-2821
2016,8,9,15,17310,17209,14612,-2597
2016,8,9,16,17980,17932,15288,-2644
2016,8,9,17,18500,18570,15998,-2572
2016,8,9,18,19130,19321,16742,-2579
2016,8,9,19,19610,19902,17054,-2848
2016,8,9,20,19970,20437,17649,-2788
2016,8,9,21,20340,20819,18255,-2564
2016,8,9,22,20400,20947,18261,-2686
2016,8,9,23,20000,20538,17728,-2810
2016,8,10,0,19400,19857,16974,-2883
2016,8,10,1,19100,19526,16578,-2948
2016,8,10,2,18110,18449,15726,-2723
2016,8,10,3,16400,16768,14051,-2717
2016,8,10,4,14820,15106,12327,-2779
2016,8,10,5,13590,14598,11833,-2765
2016,8,10,6,12870,14399,11634,-2765
2016,8,10,7,12390,14187,11349,-2838
2016,8,10,8,12180,14030,11434,-2596
2016,8,10,9,12330,14179,11593,-2586
2016,8,10,10,13300,14783,12162,-2621
2016,8,10,11,14600,15234,12558,-2676
2016,8,10,12,16100,16196,13666,-2530
2016,8,10,13,17150,17306,14685,-2621
2016,8,10,14,18000,18020,15549,-2471
2016,8,10,15,18830,18544,16208,-2336
2016,8,10,16,19540,18822,16524,-2298
2016,8,10,17,20120,18871,16696,-2175
2016,8,10,18,20630,19007,16933,-2074
2016,8,10,19,21130,19124,17292,-1832
2016,8,10,20,21510,19446,17902,-1544
2016,8,10,21,21830,19895,18356,-1539
2016,8,10,22,22050,20195,18493,-1702
2016,8,10,23,21730,20215,18169,-2046
2016,8,11,0,21180,20057,17768,-2289
2016,8,11,1,20700,20220,17740,-2480
2016,8,11,2,19690,19458,16681,-2777
2016,8,11,3,18040,18037,15291,-2746
2016,8,11,4,16320,16961,14430,-2531
2016,8,11,5,15040,16302,13460,-2842
2016,8,11,6,14150,16169,13123,-3046
2016,8,11,7,13580,15755,12788,-2967
2016,8,11,8,13320,15518,12855,-2663
2016,8,11,9,13950,15647,13219,-2428
2016,8,11,10,14800,16287,13784,-2503
2016,8,11,11,16200,16973,14333,-2640
2016,8,11,12,17930,17938,15428,-2510
2016,8,11,13,19160,19228,16410,-2818
2016,8,11,14,20380,20348,17358,-2990
2016,8,11,15,21320,21513,18245,-3268
2016,8,11,16,22380,22535,19372,-3163
2016,8,11,17,23200,23323,20304,-3019
2016,8,11,18,24050,24158,21254,-2904
2016,8,11,19,24700,24539,21680,-2859
2016,8,11,20,24800,24699,21289,-3410
2016,8,11,21,25100,24953,21376,-3577
2016,8,11,22,24950,25013,21444,-3569
2016,8,11,23,24350,24555,20768,-3787
2016,8,12,0,23610,24064,20255,-3809
2016,8,12,1,23330,23732,20049,-3683
2016,8,12,2,22060,22500,18954,-3546
2016,8,12,3,20140,20597,17138,-3459
2016,8,12,4,18270,19065,15747,-3318
2016,8,12,5,16500,18481,15099,-3382
2016,8,12,6,15870,17621,14425,-3196
2016,8,12,7,15090,17226,13982,-3244
2016,8,12,8,14790,16887,13696,-3191
2016,8,12,9,15220,16896,13692,-3204
2016,8,12,10,15960,17352,14219,-3133
2016,8,12,11,17290,18039,14908,-3131
2016,8,12,12,19020,18832,15652,-3180
2016,8,12,13,20590,19988,16621,-3367
2016,8,12,14,21820,21232,17737,-3495
2016,8,12,15,22840,22516,19122,-3394
2016,8,12,16,23780,23594,20288,-3306
2016,8,12,17,24550,24402,21152,-3250
2016,8,12,18,25170,25035,21875,-3160
2016,8,12,19,25420,25411,22035,-3376
2016,8,12,20,25400,25463,22064,-3399
2016,8,12,21,25260,25101,21719,-3382
2016,8,12,22,24690,24554,21089,-3465
2016,8,12,23,24370,23739,20084,-3655
2016,8,13,0,23570,23037,19354,-3683
2016,8,13,1,23070,22596,19069,-3527
2016,8,13,2,22070,21378,17903,-3475
2016,8,13,3,20400,19837,16312,-3525
2016,8,13,4,18710,18667,15202,-3465
2016,8,13,5,16920,17378,14192,-3186
2016,8,13,6,15950,16717,13307,-3410
2016,8,13,7,15370,16292,13152,-3140
2016,8,13,8,14930,16047,13290,-2757
2016,8,13,9,14690,16175,13293,-2882
2016,8,13,10,14760,16156,13209,-2947
2016,8,13,11,15130,16209,13214,-2995
2016,8,13,12,16200,16677,13528,-3149
2016,8,13,13,17560,17160,14119,-3041
2016,8,13,14,18680,18048,14797,-3251
2016,8,13,15,19680,18946,15785,-3161
2016,8,13,16,20260,19610,16603,-3007
2016,8,13,17,20860,20095,17245,-2850
2016,8,13,18,21150,20412,18161,-2251
2016,8,13,19,21210,20643,18234,-2409
2016,8,13,20,21280,20786,18486,-2300
2016,8,13,21,21500,20926,18720,-2206
2016,8,13,22,21380,20858,18562,-2296
2016,8,13,23,21040,20473,18066,-2407
2016,8,14,0,20360,20013,17469,-2544
2016,8,14,1,20080,19852,17407,-2445
2016,8,14,2,19230,18865,16076,-2789
2016,8,14,3,17990,17409,14796,-2613
2016,8,14,4,16520,16205,13661,-2544
2016,8,14,5,15490,15330,12714,-2616
2016,8,14,6,14900,15040,12492,-2548
2016,8,14,7,14560,14553,12130,-2423
2016,8,14,8,14190,14260,12208,-2052
2016,8,14,9,14170,14148,12360,-1788
2016,8,14,10,13230,14175,12410,-1765
2016,8,14,11,13520,13622,12119,-1503
2016,8,14,12,14560,14389,12732,-1657
2016,8,14,13,16060,15837,13559,-2278
2016,8,14,14,17720,17546,14948,-2598
2016,8,14,15,19130,19222,16310,-2912
2016,8,14,16,20100,20557,17631,-2926
2016,8,14,17,21060,21579,18571,-3008
2016,8,14,18,21780,22293,18996,-3297
2016,8,14,19,22370,22762,19494,-3268
2016,8,14,20,22580,23209,20276,-2933
2016,8,14,21,22840,23635,20679,-2956
2016,8,14,22,22900,23994,20726,-3268
2016,8,14,23,22710,23747,20491,-3256
2016,8,15,0,22470,23146,19588,-3558
2016,8,15,1,21970,22786,19334,-3452
2016,8,15,2,21040,21510,18076,-3434
2016,8,15,3,19350,19769,16255,-3514
2016,8,15,4,17770,18040,14796,-3244
2016,8,15,5,15920,16924,13891,-3033
2016,8,15,6,14950,16538,13510,-3028
2016,8,15,7,14440,16494,13460,-3034
2016,8,15,8,14190,16224,13086,-3138
2016,8,15,9,14180,16200,13038,-3162
2016,8,15,10,15190,16361,13205,-3156
2016,8,15,11,16080,16455,13342,-3113
2016,8,15,12,17440,17628,14740,-2888
2016,8,15,13,18670,18775,15916,-2859
2016,8,15,14,19650,19666,17035,-2631
2016,8,15,15,20590,20523,17318,-3205
2016,8,15,16,21310,21219,17982,-3237
2016,8,15,17,21930,21750,18994,-2756
2016,8,15,18,22480,22340,19115,-3225
2016,8,15,19,22770,22772,19647,-3125
2016,8,15,20,22930,23046,20062,-2984
2016,8,15,21,23050,23266,20246,-3020
2016,8,15,22,22950,23178,20107,-3071
2016,8,15,23,22560,22622,19311,-3311
2016,8,16,0,21880,21795,18659,-3136
2016,8,16,1,21440,21352,17961,-3391
2016,8,16,2,20220,19969,16688,-3281
2016,8,16,3,18330,18100,14845,-3255
2016,8,16,4,16520,16528,13294,-3234
2016,8,16,5,15420,15398,11903,-3495
2016,8,16,6,14590,15164,11770,-3394
2016,8,16,7,14060,14978,11531,-3447
2016,8,16,8,13760,14707,11202,-3505
2016,8,16,9,13790,14773,11423,-3350
2016,8,16,10,13970,15197,11968,-3229
2016,8,16,11,15240,15951,12817,-3134
2016,8,16,12,16720,16718,13655,-3063
2016,8,16,13,17790,17453,14293,-3160
2016,8,16,14,18500,18218,14939,-3279
2016,8,16,15,19550,19009,15611,-3398
2016,8,16,16,20220,19854,16424,-3430
2016,8,16,17,20640,20548,17131,-3417
2016,8,16,18,21380,21213,17746,-3467
2016,8,16,19,21770,21450,17924,-3526
2016,8,16,20,22140,21444,17950,-3494
2016,8,16,21,22400,21537,18159,-3378
2016,8,16,22,22330,21634,18199,-3435
2016,8,16,23,21850,21411,17982,-3429
2016,8,17,0,21300,21173,17660,-3513
2016,8,17,1,21330,21108,17559,-3549
2016,8,17,2,20170,20089,16472,-3617
2016,8,17,3,18430,18592,14960,-3632
2016,8,17,4,16750,17136,13755,-3381
2016,8,17,5,15840,16373,12977,-3396
2016,8,17,6,15100,16357,13301,-3056
2016,8,17,7,14750,16569,13476,-3093
2016,8,17,8,14510,16606,13496,-3110
2016,8,17,9,14700,16654,13552,-3102
2016,8,17,10,15560,16906,13790,-3116
2016,8,17,11,16940,17469,14372,-3097
2016,8,17,12,18190,18483,15335,-3148
2016,8,17,13,19150,19264,16096,-3168
2016,8,17,14,19910,19577,16434,-3143
2016,8,17,15,20680,20024,16879,-3145
2016,8,17,16,21240,20288,17190,-3098
2016,8,17,17,21440,20312,17373,-2939
2016,8,17,18,21910,20529,17401,-3128
2016,8,17,19,22260,20699,17294,-3405
2016,8,17,20,22390,20858,17550,-3308
2016,8,17,21,22480,20929,17593,-3336
2016,8,17,22,22300,20794,17481,-3313
2016,8,17,23,21650,20182,16741,-3441
2016,8,18,0,21040,19590,16242,-3348
2016,8,18,1,20710,19401,16084,-3317
2016,8,18,2,19420,18293,15136,-3157
2016,8,18,3,17580,16595,13448,-3147
2016,8,18,4,15810,15063,12298,-2765
2016,8,18,5,14270,14008,12073,-1935
2016,8,18,6,13430,13797,12017,-1780
2016,8,18,7,12950,13721,11929,-1792
2016,8,18,8,12740,13575,12123,-1452
2016,8,18,9,12830,13682,12282,-1400
2016,8,18,10,13190,14178,12670,-1508
2016,8,18,11,14420,14691,12782,-1909
2016,8,18,12,15880,15489,13610,-1879
2016,8,18,13,16960,16313,14400,-1913
2016,8,18,14,17740,17056,14961,-2095
2016,8,18,15,18640,17998,15766,-2232
2016,8,18,16,19400,18842,16307,-2535
2016,8,18,17,19990,19593,16867,-2726
2016,8,18,18,20710,20458,17769,-2689
2016,8,18,19,21230,21109,18417,-2692
2016,8,18,20,21660,21585,18742,-2843
2016,8,18,21,22000,21918,19050,-2868
2016,8,18,22,21780,22046,19231,-2815
2016,8,18,23,21160,21667,18696,-2971
2016,8,19,0,20720,21030,18071,-2959
2016,8,19,1,20470,20808,17846,-2962
2016,8,19,2,19340,19681,16857,-2824
2016,8,19,3,17640,17968,15220,-2748
2016,8,19,4,15940,16253,13449,-2804
2016,8,19,5,14720,15207,12726,-2481
2016,8,19,6,13940,14836,12454,-2382
2016,8,19,7,13400,14779,12229,-2550
2016,8,19,8,13070,14568,11708,-2860
2016,8,19,9,13160,14559,11572,-2987
2016,8,19,10,13880,14680,11912,-2768
2016,8,19,11,15010,15018,12355,-2663
2016,8,19,12,16370,16308,13712,-2596
2016,8,19,13,17420,17413,14681,-2732
2016,8,19,14,18320,18243,15277,-2966
2016,8,19,15,19170,19030,16091,-2939
2016,8,19,16,19890,19716,16620,-3096
2016,8,19,17,20300,20248,17193,-3055
2016,8,19,18,20860,20763,17548,-3215
2016,8,19,19,21350,21089,17869,-3220
2016,8,19,20,21520,21316,18163,-3153
2016,8,19,21,21600,21432,18345,-3087
2016,8,19,22,21340,21208,18062,-3146
2016,8,19,23,20700,20549,17550,-2999
2016,8,20,0,19880,19757,16665,-3092
2016,8,20,1,19610,19411,16424,-2987
2016,8,20,2,18470,18306,15623,-2683
2016,8,20,3,16930,16816,14184,-2632
2016,8,20,4,15340,15248,12505,-2743
2016,8,20,5,14130,14002,10977,-3025
2016,8,20,6,13290,13326,10591,-2735
2016,8,20,7,12730,13358,10401,-2957
2016,8,20,8,12340,13049,10004,-3045
2016,8,20,9,12130,13197,9858,-3339
2016,8,20,10,12370,13389,10171,-3218
2016,8,20,11,12690,13481,10521,-2960
2016,8,20,12,13670,13825,11121,-2704
2016,8,20,13,15000,14947,12344,-2603
2016,8,20,14,15930,15665,13132,-2533
2016,8,20,15,16860,16572,13853,-2719
2016,8,20,16,17600,17314,14412,-2902
2016,8,20,17,18060,17829,14867,-2962
2016,8,20,18,18450,18051,15093,-2958
2016,8,20,19,18840,18213,15329,-2884
2016,8,20,20,19060,18396,15275,-3121
2016,8,20,21,19200,18607,15473,-3134
2016,8,20,22,19120,18791,15690,-3101
2016,8,20,23,18670,18456,15119,-3337
2016,8,21,0,18150,17920,14628,-3292
2016,8,21,1,18070,17806,14652,-3154
2016,8,21,2,17110,16993,14171,-2822
2016,8,21,3,15960,15789,13051,-2738
2016,8,21,4,14600,14508,11667,-2841
2016,8,21,5,13400,13502,10372,-3130
2016,8,21,6,12760,13031,9865,-3166
2016,8,21,7,12260,12839,9793,-3046
2016,8,21,8,11930,12781,9644,-3137
2016,8,21,9,12070,12950,9760,-3190
2016,8,21,10,12130,13094,9798,-3296
2016,8,21,11,12310,13519,10156,-3363
2016,8,21,12,13090,14093,11188,-2905
2016,8,21,13,14040,14141,11426,-2715
2016,8,21,14,15130,15001,12129,-2872
2016,8,21,15,15940,15806,13083,-2723
2016,8,21,16,16770,16566,13747,-2819
2016,8,21,17,17160,17182,14214,-2968
2016,8,21,18,17580,17653,14771,-2882
2016,8,21,19,17880,18106,15132,-2974
2016,8,21,20,18260,18546,15287,-3259
2016,8,21,21,18530,18905,15522,-3383
2016,8,21,22,18650,19111,15702,-3409
2016,8,21,23,18430,18940,15341,-3599
2016,8,22,0,18420,18842,15211,-3631
2016,8,22,1,18480,18859,15245,-3614
2016,8,22,2,17480,17990,14607,-3383
2016,8,22,3,16160,16682,13343,-3339
2016,8,22,4,14840,15366,12152,-3214
2016,8,22,5,13790,14384,11027,-3357
2016,8,22,6,13340,14155,10757,-3398
2016,8,22,7,12890,14051,10457,-3594
2016,8,22,8,12730,13852,10185,-3667
2016,8,22,9,13180,13766,10110,-3656
2016,8,22,10,13840,14041,10475,-3566
2016,8,22,11,14860,14541,11233,-3308
2016,8,22,12,16070,15691,12229,-3462
2016,8,22,13,16770,16554,13173,-3381
2016,8,22,14,17320,17112,13858,-3254
2016,8,22,15,17800,17480,13972,-3508
2016,8,22,16,18290,17699,14233,-3466
2016,8,22,17,18360,17785,14370,-3415
2016,8,22,18,18710,17843,14424,-3419
2016,8,22,19,19040,17893,14497,-3396
2016,8,22,20,19090,17960,14399,-3561
2016,8,22,21,19200,18022,14525,-3497
2016,8,22,22,19050,17958,14332,-3626
2016,8,22,23,18420,17415,14036,-3379
2016,8,23,0,17700,16806,13693,-3113
2016,8,23,1,17500,16577,13472,-3105
2016,8,23,2,16320,15433,12754,-2679
2016,8,23,3,14630,13918,11372,-2546
2016,8,23,4,13060,12558,10431,-2127
2016,8,23,5,12050,11797,9525,-2272
2016,8,23,6,11450,11504,9017,-2487
2016,8,23,7,11010,11206,8937,-2269
2016,8,23,8,10800,11446,8971,-2475
2016,8,23,9,10570,11273,9085,-2188
2016,8,23,10,11220,11779,9300,-2479
2016,8,23,11,12430,12347,9870,-2477
2016,8,23,12,13680,13520,10982,-2538
2016,8,23,13,14530,14288,11596,-2692
2016,8,23,14,15030,14790,12045,-2745
2016,8,23,15,15380,15267,12387,-2880
2016,8,23,16,15800,15634,12844,-2790
2016,8,23,17,16120,15910,12974,-2936
2016,8,23,18,16530,16321,13150,-3171
2016,8,23,19,16860,16643,13399,-3244
2016,8,23,20,17290,16978,13824,-3154
2016,8,23,21,17560,17404,14399,-3005
2016,8,23,22,17600,17672,14817,-2855
2016,8,23,23,17260,17484,14553,-2931
2016,8,24,0,16900,17157,14532,-2625
2016,8,24,1,16790,17045,14395,-2650
2016,8,24,2,15800,15983,13351,-2632
2016,8,24,3,14340,14524,11843,-2681
2016,8,24,4,12950,13126,10234,-2892
2016,8,24,5,11930,12151,9261,-2890
2016,8,24,6,11440,11923,9131,-2792
2016,8,24,7,11090,11753,9105,-2648
2016,8,24,8,10960,11623,9156,-2467
2016,8,24,9,11100,11533,9097,-2436
2016,8,24,10,11820,12002,9162,-2840
2016,8,24,11,13060,12937,9861,-3076
2016,8,24,12,14450,14172,11079,-3093
2016,8,24,13,15320,15135,12036,-3099
2016,8,24,14,16020,15920,12821,-3099
2016,8,24,15,16770,16696,13527,-3169
2016,8,24,16,17500,17416,14384,-3032
2016,8,24,17,18020,18053,14782,-3271
2016,8,24,18,18720,18793,15761,-3032
2016,8,24,19,19280,19378,16520,-2858
2016,8,24,20,19700,19884,16887,-2997
2016,8,24,21,20120,20344,17557,-2787
2016,8,24,22,20140,20456,17194,-3262
2016,8,24,23,19800,19993,16724,-3269
2016,8,25,0,19220,19542,16138,-3404
2016,8,25,1,19000,19353,15913,-3440
2016,8,25,2,17850,18095,14877,-3218
2016,8,25,3,16150,16580,13207,-3373
2016,8,25,4,14570,15285,12067,-3218
2016,8,25,5,13370,13936,10913,-3023
2016,8,25,6,12570,13838,10724,-3114
2016,8,25,7,12130,13630,10502,-3128
2016,8,25,8,11900,13424,10135,-3289
2016,8,25,9,12240,13718,10385,-3333
2016,8,25,10,12940,14083,10822,-3261
2016,8,25,11,14190,14486,11380,-3106
2016,8,25,12,15430,15510,12286,-3224
2016,8,25,13,16410,16590,13246,-3344
2016,8,25,14,17190,17469,14064,-3405
2016,8,25,15,18010,18334,14716,-3618
2016,8,25,16,18720,19082,15490,-3592
2016,8,25,17,19310,19732,16265,-3467
2016,8,25,18,19950,20351,16732,-3619
2016,8,25,19,20480,20652,17122,-3530
2016,8,25,20,20740,20851,17362,-3489
2016,8,25,21,21050,21050,17689,-3361
2016,8,25,22,20970,20855,17436,-3419
2016,8,25,23,20510,20335,16983,-3352
2016,8,26,0,20000,20098,16909,-3189
2016,8,26,1,19810,19929,16785,-3144
2016,8,26,2,18630,18849,15896,-2953
2016,8,26,3,16960,17289,14522,-2767
2016,8,26,4,15300,15733,13125,-2608
2016,8,26,5,14700,15040,12243,-2797
2016,8,26,6,13930,15020,12114,-2906
2016,8,26,7,13450,14966,12071,-2895
2016,8,26,8,13180,14763,11796,-2967
2016,8,26,9,13340,14540,11712,-2828
2016,8,26,10,14060,14526,11850,-2676
2016,8,26,11,15250,15312,12538,-2774
2016,8,26,12,16720,16797,14190,-2607
2016,8,26,13,17930,18036,15412,-2624
2016,8,26,14,18880,18951,16038,-2913
2016,8,26,15,19910,19815,16776,-3039
2016,8,26,16,20640,20650,17479,-3171
2016,8,26,17,21280,21408,18099,-3309
2016,8,26,18,22010,22067,18569,-3498
2016,8,26,19,22620,22418,19044,-3374
2016,8,26,20,22920,22821,19438,-3383
2016,8,26,21,23100,23114,19984,-3130
2016,8,26,22,22690,23021,19961,-3060
2016,8,26,23,22060,22306,18930,-3376
2016,8,27,0,21370,21462,17993,-3469
2016,8,27,1,20820,20903,17458,-3445
2016,8,27,2,19570,19536,16560,-2976
2016,8,27,3,17950,17821,14942,-2879
2016,8,27,4,16210,16221,13316,-2905
2016,8,27,5,14620,14972,12001,-2971
2016,8,27,6,13680,14159,11280,-2879
2016,8,27,7,13070,14031,11129,-2902
2016,8,27,8,12670,13827,11115,-2712
2016,8,27,9,12440,13403,10654,-2749
2016,8,27,10,12510,13476,10741,-2735
2016,8,27,11,12910,13758,11048,-2710
2016,8,27,12,13720,14184,11581,-2603
2016,8,27,13,14980,15084,12682,-2402
2016,8,27,14,15960,15963,13587,-2376
2016,8,27,15,16840,16776,14356,-2420
2016,8,27,16,17540,17481,14863,-2618
2016,8,27,17,18030,18086,15277,-2809
2016,8,27,18,18450,18488,15494,-2994
2016,8,27,19,18760,18817,15745,-3072
2016,8,27,20,19080,19130,16154,-2976
2016,8,27,21,19260,19370,16635,-2735
2016,8,27,22,19250,19431,16680,-2751
2016,8,27,23,18920,18979,15939,-3040
2016,8,28,0,18390,18438,15352,-3086
2016,8,28,1,18240,18168,15265,-2903
2016,8,28,2,17190,17170,14271,-2899
2016,8,28,3,15950,15872,12906,-2966
2016,8,28,4,14600,14765,11869,-2896
2016,8,28,5,13510,13659,10709,-2950
2016,8,28,6,12810,12881,9997,-2884
2016,8,28,7,12280,12821,9967,-2854
2016,8,28,8,11910,12797,10038,-2759
2016,8,28,9,11790,12632,9934,-2698
2016,8,28,10,11750,12672,9948,-2724
2016,8,28,11,11860,12612,9880,-2732
2016,8,28,12,12560,13278,10610,-2668
2016,8,28,13,13610,14151,11513,-2638
2016,8,28,14,14620,14660,12131,-2529
2016,8,28,15,15380,15445,13000,-2445
2016,8,28,16,16170,16212,13767,-2445
2016,8,28,17,16820,16895,14438,-2457
2016,8,28,18,17240,17485,15015,-2470
2016,8,28,19,17730,18033,15279,-2754
2016,8,28,20,18120,18534,15741,-2793
2016,8,28,21,18610,18991,16294,-2697
2016,8,28,22,18860,19267,16313,-2954
2016,8,28,23,18530,18997,15856,-3141
2016,8,29,0,18250,18655,15608,-3047
2016,8,29,1,18090,18449,15360,-3089
2016,8,29,2,17040,17331,14284,-3047
2016,8,29,3,15590,15846,12699,-3147
2016,8,29,4,14240,14430,12076,-2354
2016,8,29,5,13310,13755,10862,-2893
2016,8,29,6,12640,13776,10750,-3026
2016,8,29,7,12290,13524,10638,-2886
2016,8,29,8,12110,13379,10519,-2860
2016,8,29,9,12320,13462,10793,-2669
2016,8,29,10,13380,14142,11454,-2688
2016,8,29,11,14630,15159,12442,-2717
2016,8,29,12,15920,16248,13567,-2681
2016,8,29,13,17000,17238,14216,-3022
2016,8,29,14,17910,17993,14929,-3064
2016,8,29,15,18870,18935,16004,-2931
2016,8,29,16,19600,19710,16808,-2902
2016,8,29,17,20010,20278,17474,-2804
2016,8,29,18,20570,20796,17910,-2886
2016,8,29,19,20950,21151,18511,-2640
2016,8,29,20,21160,21324,18455,-2869
2016,8,29,21,21230,21421,18608,-2813
2016,8,29,22,21110,21307,18302,-3005
2016,8,29,23,20560,20640,17730,-2910
2016,8,30,0,19890,19899,16878,-3021
2016,8,30,1,19350,19340,16351,-2989
2016,8,30,2,17960,17808,15009,-2799
2016,8,30,3,16100,15919,13324,-2595
2016,8,30,4,14450,14221,11913,-2308
2016,8,30,5,13120,13449,11194,-2255
2016,8,30,6,12410,12963,10575,-2388
2016,8,30,7,11900,12769,10368,-2401
2016,8,30,8,11660,12976,10533,-2443
2016,8,30,9,11790,12838,10590,-2248
2016,8,30,10,12310,12989,10764,-2225
2016,8,30,11,13660,13912,11516,-2396
2016,8,30,12,14950,14522,11934,-2588
2016,8,30,13,15790,15294,12629,-2665
2016,8,30,14,16360,15937,13204,-2733
2016,8,30,15,16900,16552,14005,-2547
2016,8,30,16,17360,17088,14581,-2507
2016,8,30,17,17780,17558,15169,-2389
2016,8,30,18,18340,18153,15517,-2636
2016,8,30,19,18680,18608,15941,-2667
2016,8,30,20,18940,18990,16483,-2507
2016,8,30,21,19140,19369,16756,-2613
2016,8,30,22,19260,19505,16899,-2606
2016,8,30,23,18690,19167,16300,-2867
2016,8,31,0,18300,18882,16187,-2695
2016,8,31,1,18210,18539,15710,-2829
2016,8,31,2,17040,17219,14655,-2564
2016,8,31,3,15400,15576,12789,-2787
2016,8,31,4,13870,14041,11641,-2400
2016,8,31,5,12990,13164,10387,-2777
2016,8,31,6,12290,13279,10303,-2976
2016,8,31,7,11870,13389,10328,-3061
2016,8,31,8,11760,13337,10279,-3058
2016,8,31,9,12000,13463,10701,-2762
2016,8,31,10,12840,13690,11171,-2519
2016,8,31,11,14050,14476,11699,-2777
2016,8,31,12,15440,15594,12858,-2736
2016,8,31,13,16280,16457,13772,-2685
2016,8,31,14,17110,17166,14322,-2844
2016,8,31,15,17870,17827,15028,-2799
2016,8,31,16,18550,18314,15448,-2866
2016,8,31,17,19210,18659,15873,-2786
2016,8,31,18,19790,19012,16064,-2948
2016,8,31,19,20140,19067,16016,-3051
2016,8,31,20,20280,19177,16298,-2879
2016,8,31,21,20480,19350,16690,-2660
2016,8,31,22,20390,19418,16631,-2787
2016,8,31,23,19950,19277,16180,-3097
2016,9,1,0,19880,19469,16291,-3178
2016,9,1,1,19530,19278,16229,-3049
2016,9,1,2,18350,18131,15348,-2783
2016,9,1,3,16750,16541,13707,-2834
2016,9,1,4,15200,15058,12294,-2764
2016,9,1,5,13710,14156,11354,-2802
2016,9,1,6,13060,13850,11136,-2714
2016,9,1,7,12690,13728,11067,-2661
2016,9,1,8,12560,13523,10811,-2712
2016,9,1,9,12720,13682,10795,-2887
2016,9,1,10,13730,14312,11407,-2905
2016,9,1,11,15260,15347,12558,-2789
2016,9,1,12,16230,16429,13858,-2571
2016,9,1,13,16660,17053,14485,-2568
2016,9,1,14,17080,17518,15149,-2369
2016,9,1,15,17630,17885,15398,-2487
2016,9,1,16,17850,18061,15482,-2579
2016,9,1,17,18190,18013,15328,-2685
2016,9,1,18,18500,18028,15257,-2771
2016,9,1,19,18730,18002,14940,-3062
2016,9,1,20,18820,18071,15283,-2788
2016,9,1,21,19000,18190,15521,-2669
2016,9,1,22,18820,18215,15360,-2855
2016,9,1,23,18450,18016,15022,-2994
2016,9,2,0,18490,18102,15199,-2903
2016,9,2,1,18120,17950,15159,-2791
2016,9,2,2,16810,16832,13829,-3003
2016,9,2,3,15160,15175,12131,-3044
2016,9,2,4,13610,13832,10889,-2943
2016,9,2,5,12750,12679,9966,-2713
2016,9,2,6,12050,12380,9621,-2759
2016,9,2,7,11580,12294,9720,-2574
2016,9,2,8,11370,12134,9456,-2678
2016,9,2,9,11520,12308,9576,-2732
2016,9,2,10,11820,12397,9824,-2573
2016,9,2,11,13110,12955,10321,-2634
2016,9,2,12,14300,14017,11155,-2862
2016,9,2,13,15080,14782,11909,-2873
2016,9,2,14,15650,15311,12503,-2808
2016,9,2,15,16060,15716,13124,-2592
2016,9,2,16,16310,16086,13520,-2566
2016,9,2,17,16380,16286,13647,-2639
2016,9,2,18,16700,16502,13732,-2770
2016,9,2,19,16910,16617,13826,-2791
2016,9,2,20,17100,16720,13962,-2758
2016,9,2,21,17200,16890,14139,-2751
2016,9,2,22,16970,16886,14084,-2802
2016,9,2,23,16630,16448,13701,-2747
2016,9,3,0,16360,16285,13658,-2627
2016,9,3,1,16180,15999,13408,-2591
2016,9,3,2,15170,15064,12517,-2547
2016,9,3,3,13870,13815,11432,-2383
2016,9,3,4,12540,12556,10249,-2307
2016,9,3,5,11570,11759,9449,-2310
2016,9,3,6,10940,11430,9119,-2311
2016,9,3,7,10560,11067,8776,-2291
2016,9,3,8,10390,10827,8767,-2060
2016,9,3,9,10290,10750,8613,-2137
2016,9,3,10,10530,10718,8845,-1873
2016,9,3,11,11020,10824,8850,-1974
2016,9,3,12,11770,11381,9361,-2020
2016,9,3,13,12690,12225,10154,-2071
2016,9,3,14,13360,12875,10807,-2068
2016,9,3,15,13400,13192,11091,-2101
2016,9,3,16,13690,13408,11065,-2343
2016,9,3,17,13850,13560,11312,-2248
2016,9,3,18,13950,13615,11508,-2107
2016,9,3,19,14060,13680,11594,-2086
2016,9,3,20,14310,13727,11568,-2159
2016,9,3,21,14650,13934,11772,-2162
2016,9,3,22,14940,14159,12151,-2008
2016,9,3,23,14470,14181,12209,-1972
2016,9,4,0,14420,14366,12082,-2284
2016,9,4,1,14350,14307,11894,-2413
2016,9,4,2,13710,13579,11241,-2338
2016,9,4,3,12780,12619,10219,-2400
2016,9,4,4,11760,11599,9142,-2457
2016,9,4,5,10960,10764,8274,-2490
2016,9,4,6,10430,10528,8098,-2430
2016,9,4,7,10070,10603,8318,-2285
2016,9,4,8,9890,10695,8591,-2104
2016,9,4,9,9830,10736,8377,-2359
2016,9,4,10,9750,10607,8305,-2302
2016,9,4,11,9850,10812,8353,-2459
2016,9,4,12,10440,10836,8829,-2007
2016,9,4,13,11310,11382,9023,-2359
2016,9,4,14,12080,11977,9394,-2583
2016,9,4,15,12510,12354,9872,-2482
2016,9,4,16,12870,12612,10201,-2411
2016,9,4,17,13060,12812,10537,-2275
2016,9,4,18,13180,12925,10678,-2247
2016,9,4,19,13240,13102,10916,-2186
2016,9,4,20,13440,13376,11419,-1957
2016,9,4,21,13800,13773,11824,-1949
2016,9,4,22,14250,14121,11732,-2389
2016,9,4,23,14340,14085,11665,-2420
2016,9,5,0,14560,14192,11675,-2517
2016,9,5,1,14410,14050,11691,-2359
2016,9,5,2,13470,13303,11063,-2240
2016,9,5,3,12310,12379,9840,-2539
2016,9,5,4,11240,11387,8856,-2531
2016,9,5,5,10330,10756,8348,-2408
2016,9,5,6,9960,10077,8216,-1861
2016,9,5,7,9650,9786,8353,-1433
2016,9,5,8,9490,9878,8187,-1691
2016,9,5,9,9520,9916,8001,-1915
2016,9,5,10,9660,10199,8088,-2111
2016,9,5,11,9910,10576,8445,-2131
2016,9,5,12,10480,11090,8787,-2303
2016,9,5,13,11330,11753,9546,-2207
2016,9,5,14,11990,12451,10266,-2185
2016,9,5,15,12320,12916,10625,-2291
2016,9,5,16,12710,13017,10801,-2216
2016,9,5,17,12850,13119,10865,-2254
2016,9,5,18,12960,13270,11046,-2224
2016,9,5,19,12980,13487,11235,-2252
2016,9,5,20,13160,13751,11515,-2236
2016,9,5,21,13660,14195,12011,-2184
2016,9,5,22,14040,14669,12406,-2263
2016,9,5,23,14310,14842,12704,-2138
2016,9,6,0,14590,15133,13009,-2124
2016,9,6,1,14480,14992,12851,-2141
2016,9,6,2,13650,13976,11939,-2037
2016,9,6,3,12530,12658,10483,-2175
2016,9,6,4,11430,11552,9326,-2226
2016,9,6,5,10760,11305,9095,-2210
2016,9,6,6,10430,11299,9116,-2183
2016,9,6,7,10260,11315,9120,-2195
2016,9,6,8,10250,11281,9083,-2198
2016,9,6,9,10490,11525,9248,-2277
2016,9,6,10,11340,12061,9622,-2439
2016,9,6,11,12720,13274,11160,-2114
2016,9,6,12,13790,14386,12521,-1865
2016,9,6,13,14540,15007,12971,-2036
2016,9,6,14,15030,15503,13313,-2190
2016,9,6,15,15950,15899,13805,-2094
2016,9,6,16,16180,16124,14160,-1964
2016,9,6,17,16380,16249,14263,-1986
2016,9,6,18,16640,16430,14325,-2105
2016,9,6,19,16830,16540,14735,-1805
2016,9,6,20,16980,16653,15163,-1490
2016,9,6,21,17230,16812,15407,-1405
2016,9,6,22,17500,16965,15494,-1471
2016,9,6,23,17240,16973,15307,-1666
2016,9,7,0,17270,17196,15363,-1833
2016,9,7,1,16960,16861,15007,-1854
2016,9,7,2,15970,15792,13714,-2078
2016,9,7,3,14550,14375,12327,-2048
2016,9,7,4,13240,13078,10970,-2108
2016,9,7,5,12460,12719,10177,-2542
2016,9,7,6,11850,12469,9865,-2604
2016,9,7,7,11640,12438,9729,-2709
2016,9,7,8,11460,12333,9666,-2667
2016,9,7,9,11650,12557,9972,-2585
2016,9,7,10,12500,13103,10598,-2505
2016,9,7,11,14010,14396,12012,-2384
2016,9,7,12,15260,15441,13230,-2211
2016,9,7,13,16150,16070,14082,-1988
2016,9,7,14,16920,16531,14598,-1933
2016,9,7,15,17510,16957,14840,-2117
2016,9,7,16,17710,17330,15262,-2068
2016,9,7,17,17960,17679,15434,-2245
2016,9,7,18,18290,18017,15819,-2198
2016,9,7,19,18690,18177,16198,-1979
2016,9,7,20,18800,18412,16605,-1807
2016,9,7,21,19100,18681,16980,-1701
2016,9,7,22,19200,18794,16906,-1888
2016,9,7,23,19010,18630,16524,-2106
2016,9,8,0,18920,18764,16593,-2171
2016,9,8,1,18530,18408,16231,-2177
2016,9,8,2,17540,17240,14899,-2341
2016,9,8,3,15900,15963,13578,-2385
2016,9,8,4,14370,14754,12511,-2243
2016,9,8,5,13020,14230,11231,-2999
2016,9,8,6,12360,13789,10678,-3111
2016,9,8,7,11970,13396,10279,-3117
2016,9,8,8,11810,13215,10171,-3044
2016,9,8,9,11990,13371,10312,-3059
2016,9,8,10,12910,14293,11447,-2846
2016,9,8,11,14510,15534,12864,-2670
2016,9,8,12,15630,15933,13326,-2607
2016,9,8,13,16260,16515,14116,-2399
2016,9,8,14,16890,17053,14572,-2481
2016,9,8,15,17680,17597,15180,-2417
2016,9,8,16,18100,18066,15476,-2590
2016,9,8,17,18600,18484,15869,-2615
2016,9,8,18,19120,18934,15884,-3050
2016,9,8,19,19480,19320,16604,-2716
2016,9,8,20,19810,19717,17353,-2364
2016,9,8,21,20140,20197,17998,-2199
2016,9,8,22,20210,20417,18076,-2341
2016,9,8,23,19930,20075,17332,-2743
2016,9,9,0,19910,20174,17243,-2931
2016,9,9,1,19560,19689,16689,-3000
2016,9,9,2,18310,18389,15455,-2934
2016,9,9,3,16690,16736,14061,-2675
2016,9,9,4,15110,15775,13037,-2738
2016,9,9,5,14150,15229,12345,-2884
2016,9,9,6,13390,14693,11832,-2861
2016,9,9,7,13000,14280,11655,-2625
2016,9,9,8,12810,14105,11731,-2374
2016,9,9,9,13080,14312,11698,-2614
2016,9,9,10,13990,15267,12624,-2643
2016,9,9,11,15600,16591,13936,-2655
2016,9,9,12,16870,17358,14892,-2466
2016,9,9,13,17950,17906,15475,-2431
2016,9,9,14,18850,18725,15831,-2894
2016,9,9,15,19650,19571,16617,-2954
2016,9,9,16,20410,20522,17485,-3037
2016,9,9,17,20810,21328,18342,-2986
2016,9,9,18,21570,22029,19213,-2816
2016,9,9,19,22040,22463,19759,-2704
2016,9,9,20,22330,22806,20162,-2644
2016,9,9,21,22420,23034,20312,-2722
2016,9,9,22,22020,22772,19888,-2884
2016,9,9,23,21210,22017,18929,-3088
2016,9,10,0,20840,21631,18398,-3233
2016,9,10,1,20180,20859,17569,-3290
2016,9,10,2,18830,19443,16133,-3310
2016,9,10,3,17100,17759,14815,-2944
2016,9,10,4,15440,16073,13110,-2963
2016,9,10,5,14220,15017,12114,-2903
2016,9,10,6,13450,14174,11420,-2754
2016,9,10,7,12900,13983,11280,-2703
2016,9,10,8,12570,13933,11175,-2758
2016,9,10,9,12370,14048,11129,-2919
2016,9,10,10,13010,14020,11019,-3001
2016,9,10,11,13530,14258,11382,-2876
2016,9,10,12,14180,14333,12050,-2283
2016,9,10,13,15110,15218,12917,-2301
2016,9,10,14,15940,16116,13914,-2202
2016,9,10,15,16620,16899,14945,-1954
2016,9,10,16,17100,17389,14973,-2416
2016,9,10,17,17570,17644,15085,-2559
2016,9,10,18,17750,17836,15396,-2440
2016,9,10,19,17870,18135,15951,-2184
2016,9,10,20,18170,18499,16346,-2153
2016,9,10,21,18450,18753,16362,-2391
2016,9,10,22,18500,18784,15942,-2842
2016,9,10,23,18220,18501,15561,-2940
2016,9,11,0,18330,18609,15530,-3079
2016,9,11,1,18220,18277,15126,-3151
2016,9,11,2,17170,17432,14585,-2847
2016,9,11,3,16020,16297,13779,-2518
2016,9,11,4,14750,15097,12562,-2535
2016,9,11,5,14220,14145,11152,-2993
2016,9,11,6,13510,13780,11087,-2693
2016,9,11,7,12930,13848,11307,-2541
2016,9,11,8,12620,13582,10871,-2711
2016,9,11,9,12570,13501,10920,-2581
2016,9,11,10,12870,13702,10938,-2764
2016,9,11,11,13120,14117,11439,-2678
2016,9,11,12,13720,14391,11645,-2746
2016,9,11,13,14640,15047,12270,-2777
2016,9,11,14,15580,15959,13056,-2903
2016,9,11,15,16290,16173,13316,-2857
2016,9,11,16,16720,16039,13164,-2875
2016,9,11,17,17060,15973,13399,-2574
2016,9,11,18,17050,16057,13403,-2654
2016,9,11,19,17170,16196,13331,-2865
2016,9,11,20,17240,16517,13619,-2898
2016,9,11,21,17310,16841,13944,-2897
2016,9,11,22,17350,17101,14152,-2949
2016,9,11,23,16960,16851,13938,-2913
2016,9,12,0,16910,16742,13717,-3025
2016,9,12,1,16410,16173,13252,-2921
2016,9,12,2,15260,14908,12043,-2865
2016,9,12,3,13920,13493,10766,-2727
2016,9,12,4,12630,12411,9682,-2729
2016,9,12,5,11430,11687,9152,-2535
2016,9,12,6,10830,11520,8916,-2604
2016,9,12,7,10410,11305,8746,-2559
2016,9,12,8,10270,11377,8837,-2540
2016,9,12,9,10510,11363,9042,-2321
2016,9,12,10,11130,12124,9709,-2415
2016,9,12,11,12630,12879,10434,-2445
2016,9,12,12,13730,13541,11069,-2472
2016,9,12,13,14330,13956,11497,-2459
2016,9,12,14,14770,14304,11903,-2401
2016,9,12,15,14610,14636,12344,-2292
2016,9,12,16,14760,14878,12426,-2452
2016,9,12,17,14970,15057,12584,-2473
2016,9,12,18,15300,15347,12981,-2366
2016,9,12,19,15560,15624,13239,-2385
2016,9,12,20,15820,15899,13334,-2565
2016,9,12,21,16110,16255,13698,-2557
2016,9,12,22,16230,16543,13928,-2615
2016,9,12,23,16060,16408,13717,-2691
2016,9,13,0,16210,16497,14093,-2404
2016,9,13,1,15830,15974,13597,-2377
2016,9,13,2,14660,14732,12300,-2432
2016,9,13,3,13200,13239,10686,-2553
2016,9,13,4,11890,11927,9439,-2488
2016,9,13,5,11130,11428,8869,-2559
2016,9,13,6,10650,11467,8658,-2809
2016,9,13,7,10310,11514,8610,-2904
2016,9,13,8,10200,11390,8866,-2524
2016,9,13,9,10370,11610,8721,-2889
2016,9,13,10,11300,11862,8860,-3002
2016,9,13,11,12960,12797,9742,-3055
2016,9,13,12,14020,13705,10691,-3014
2016,9,13,13,14500,14189,10933,-3256
2016,9,13,14,14990,14588,11484,-3104
2016,9,13,15,15340,15026,11951,-3075
2016,9,13,16,15690,15380,12211,-3169
2016,9,13,17,15890,15677,12601,-3076
2016,9,13,18,16380,16104,13265,-2839
2016,9,13,19,16710,16451,13359,-3092
2016,9,13,20,17100,16865,13769,-3096
2016,9,13,21,17430,17277,14279,-2998
2016,9,13,22,17550,17480,14503,-2977
2016,9,13,23,17220,17262,14247,-3015
2016,9,14,0,17230,17403,14244,-3159
2016,9,14,1,16860,16873,13728,-3145
2016,9,14,2,15660,15647,12520,-3127
2016,9,14,3,14140,14105,11006,-3099
2016,9,14,4,12740,12746,9850,-2896
2016,9,14,5,11710,12051,8985,-3066
2016,9,14,6,11180,11799,8820,-2979
2016,9,14,7,10870,11663,8715,-2948
2016,9,14,8,10760,11624,8642,-2982
2016,9,14,9,11100,11682,8653,-3029
2016,9,14,10,12000,12234,9320,-2914
2016,9,14,11,13600,13621,10598,-3023
2016,9,14,12,14780,14718,11546,-3172
2016,9,14,13,15380,15354,12024,-3330
2016,9,14,14,15940,15964,13051,-2913
2016,9,14,15,16450,16714,13998,-2716
2016,9,14,16,16930,17364,14709,-2655
2016,9,14,17,17240,17913,15055,-2858
2016,9,14,18,17990,18665,15719,-2946
2016,9,14,19,18370,19207,16241,-2966
2016,9,14,20,18680,19471,16505,-2966
2016,9,14,21,18890,19587,16603,-2984
2016,9,14,22,18950,19280,16357,-2923
2016,9,14,23,18400,18810,15831,-2979
2016,9,15,0,18360,18680,15732,-2948
2016,9,15,1,17670,17777,14869,-2908
2016,9,15,2,16370,16194,13185,-3009
2016,9,15,3,14700,14322,11492,-2830
2016,9,15,4,13100,12857,10005,-2852
2016,9,15,5,11340,11941,8881,-3060
2016,9,15,6,10760,11404,8365,-3039
2016,9,15,7,10430,11428,8257,-3171
2016,9,15,8,10270,11440,8094,-3346
2016,9,15,9,10590,11248,7936,-3312
2016,9,15,10,11410,11762,8515,-3247
2016,9,15,11,12930,12804,9851,-2953
2016,9,15,12,13950,13658,10763,-2895
2016,9,15,13,14250,13944,11020,-2924
2016,9,15,14,14410,14141,11249,-2892
2016,9,15,15,14650,14364,11366,-2998
2016,9,15,16,14780,14565,11621,-2944
2016,9,15,17,14810,14580,11560,-3020
2016,9,15,18,15060,14707,11359,-3348
2016,9,15,19,15160,14774,11489,-3285
2016,9,15,20,15390,14924,11880,-3044
2016,9,15,21,15550,15203,12150,-3053
2016,9,15,22,15640,15410,12323,-3087
2016,9,15,23,15540,15328,12297,-3031
2016,9,16,0,15700,15570,12514,-3056
2016,9,16,1,15410,15083,12337,-2746
2016,9,16,2,14280,13991,11123,-2868
2016,9,16,3,12950,12600,9597,-3003
2016,9,16,4,11700,11353,8389,-2964
2016,9,16,5,10510,10890,7349,-3541
2016,9,16,6,10050,10648,6979,-3669
2016,9,16,7,9810,10627,6856,-3771
2016,9,16,8,9710,10745,7029,-3716
2016,9,16,9,9910,10782,7140,-3642
2016,9,16,10,10830,11244,7604,-3640
2016,9,16,11,12440,12323,8818,-3505
2016,9,16,12,13410,13228,9699,-3529
2016,9,16,13,13730,13594,10076,-3518
2016,9,16,14,13950,13828,10368,-3460
2016,9,16,15,14170,14123,10869,-3254
2016,9,16,16,14290,14283,10975,-3308
2016,9,16,17,14170,14350,11075,-3275
2016,9,16,18,14350,14476,11305,-3171
2016,9,16,19,14440,14515,11633,-2882
2016,9,16,20,14600,14637,11720,-2917
2016,9,16,21,14800,14869,11695,-3174
2016,9,16,22,14860,14977,11842,-3135
2016,9,16,23,14630,14809,11654,-3155
2016,9,17,0,14950,14998,11723,-3275
2016,9,17,1,14420,14520,11441,-3079
2016,9,17,2,13630,13617,10240,-3377
2016,9,17,3,12450,12487,8999,-3488
2016,9,17,4,11370,11341,7848,-3493
2016,9,17,5,10470,10658,7387,-3271
2016,9,17,6,9950,10462,7171,-3291
2016,9,17,7,9660,10429,7234,-3195
2016,9,17,8,9520,10553,7238,-3315
2016,9,17,9,9560,10587,7273,-3314
2016,9,17,10,9880,10689,7373,-3316
2016,9,17,11,10480,10759,7502,-3257
2016,9,17,12,11210,11054,8102,-2952
2016,9,17,13,12020,11805,8766,-3039
2016,9,17,14,12530,12313,9352,-2961
2016,9,17,15,12850,12569,9844,-2725
2016,9,17,16,13000,12721,9985,-2736
2016,9,17,17,13070,12787,10186,-2601
2016,9,17,18,13080,12838,10000,-2838
2016,9,17,19,13140,13019,10221,-2798
2016,9,17,20,13350,13367,10699,-2668
2016,9,17,21,13710,13790,10873,-2917
2016,9,17,22,13980,14192,11141,-3051
2016,9,17,23,14110,14308,11068,-3240
2016,9,18,0,14500,14710,11546,-3164
2016,9,18,1,14050,14395,11308,-3087
2016,9,18,2,13390,13702,10711,-2991
2016,9,18,3,12430,12791,9679,-3112
2016,9,18,4,11430,12102,9713,-2389
2016,9,18,5,10760,11808,8647,-3161
2016,9,18,6,10240,11695,8530,-3165
2016,9,18,7,9990,11422,8340,-3082
2016,9,18,8,9860,11296,8377,-2919
2016,9,18,9,9810,11331,8346,-2985
2016,9,18,10,10510,11557,8688,-2869
2016,9,18,11,10930,11966,9125,-2841
2016,9,18,12,11450,12377,9475,-2902
2016,9,18,13,12350,12950,9985,-2965
2016,9,18,14,13150,13650,10783,-2867
2016,9,18,15,13760,14314,11479,-2835
2016,9,18,16,14740,14895,11966,-2929
2016,9,18,17,15110,15322,12554,-2768
2016,9,18,18,15440,15565,12844,-2721
2016,9,18,19,15590,15706,13029,-2677
2016,9,18,20,15970,15938,13273,-2665
2016,9,18,21,16350,16279,13857,-2422
2016,9,18,22,17020,16735,14161,-2574
2016,9,18,23,17320,17065,14541,-2524
2016,9,19,0,17500,17532,15099,-2433
2016,9,19,1,16870,17066,14600,-2466
2016,9,19,2,15900,16024,13265,-2759
2016,9,19,3,14550,14694,11914,-2780
2016,9,19,4,13380,13680,10922,-2758
2016,9,19,5,12620,12976,10237,-2739
2016,9,19,6,12090,12677,10067,-2610
2016,9,19,7,11790,12646,9991,-2655
2016,9,19,8,11670,12583,9864,-2719
2016,9,19,9,11940,12879,10147,-2732
2016,9,19,10,13030,13578,10891,-2687
2016,9,19,11,14610,14931,12178,-2753
2016,9,19,12,15870,16147,13588,-2559
2016,9,19,13,16650,16775,14231,-2544
2016,9,19,14,17230,17264,14468,-2796
2016,9,19,15,17780,17702,14871,-2831
2016,9,19,16,18170,17838,14967,-2871
2016,9,19,17,18430,17770,14963,-2807
2016,9,19,18,18780,17676,15231,-2445
2016,9,19,19,18930,17411,14985,-2426
2016,9,19,20,19060,17263,14776,-2487
2016,9,19,21,19130,17279,14788,-2491
2016,9,19,22,19150,17479,14986,-2493
2016,9,19,23,19040,17634,15156,-2478
2016,9,20,0,19060,17856,15422,-2434
2016,9,20,1,18210,17232,14725,-2507
2016,9,20,2,16830,16051,13681,-2370
2016,9,20,3,15150,14580,12191,-2389
2016,9,20,4,13670,13484,10950,-2534
2016,9,20,5,12830,12829,10329,-2500
2016,9,20,6,12190,12536,9990,-2546
2016,9,20,7,11820,12476,9912,-2564
2016,9,20,8,11660,12373,9782,-2591
2016,9,20,9,11840,12597,9948,-2649
2016,9,20,10,12620,13550,10880,-2670
2016,9,20,11,14360,14802,12195,-2607
2016,9,20,12,15360,15399,12876,-2523
2016,9,20,13,15950,15930,13635,-2295
2016,9,20,14,16400,16315,13970,-2345
2016,9,20,15,16960,16710,14308,-2402
2016,9,20,16,17320,17042,14652,-2390
2016,9,20,17,17800,17356,14986,-2370
2016,9,20,18,18230,17876,15544,-2332
2016,9,20,19,18470,18291,15940,-2351
2016,9,20,20,18770,18647,16283,-2364
2016,9,20,21,19080,18891,16566,-2325
2016,9,20,22,19200,18890,16530,-2360
2016,9,20,23,18770,18731,16234,-2497
2016,9,21,0,19000,18981,16507,-2474
2016,9,21,1,18120,18243,15770,-2473
2016,9,21,2,16760,16885,14416,-2469
2016,9,21,3,15030,15218,12751,-2467
2016,9,21,4,13510,14122,11592,-2530
2016,9,21,5,12380,13179,10658,-2521
2016,9,21,6,11770,12749,10122,-2627
2016,9,21,7,11380,12581,9950,-2631
2016,9,21,8,11240,12375,9950,-2425
2016,9,21,9,11360,12489,10494,-1995
2016,9,21,10,12290,13201,10708,-2493
2016,9,21,11,13890,14391,11475,-2916
2016,9,21,12,14940,14847,11829,-3018
2016,9,21,13,15410,15273,12300,-2973
2016,9,21,14,15760,15588,12783,-2805
2016,9,21,15,16140,16008,13244,-2764
2016,9,21,16,16410,16333,13499,-2834
2016,9,21,17,16750,16669,13917,-2752
2016,9,21,18,17150,17160,14485,-2675
2016,9,21,19,17340,17456,14830,-2626
2016,9,21,20,17650,17686,15067,-2619
2016,9,21,21,17910,17818,15211,-2607
2016,9,21,22,18100,17684,14963,-2721
2016,9,21,23,17640,17444,14548,-2896
2016,9,22,0,17840,17587,14819,-2768
2016,9,22,1,17000,16824,14230,-2594
2016,9,22,2,15710,15498,12794,-2704
2016,9,22,3,14100,13900,11155,-2745
2016,9,22,4,12650,12735,10227,-2508
2016,9,22,5,11730,11840,9347,-2493
2016,9,22,6,11070,11629,9159,-2470
2016,9,22,7,10740,11572,9279,-2293
2016,9,22,8,10610,11433,9155,-2278
2016,9,22,9,10840,11428,9170,-2258
2016,9,22,10,11630,11958,9300,-2658
2016,9,22,11,13270,12992,10356,-2636
2016,9,22,12,14280,14108,11235,-2873
2016,9,22,13,14810,14427,11640,-2787
2016,9,22,14,15270,14854,12274,-2580
2016,9,22,15,15790,15390,12803,-2587
2016,9,22,16,16180,15833,13212,-2621
2016,9,22,17,16570,16205,13586,-2619
2016,9,22,18,16980,16717,14199,-2518
2016,9,22,19,17350,17129,14453,-2676
2016,9,22,20,17670,17534,14982,-2552
2016,9,22,21,17850,17879,15593,-2286
2016,9,22,22,17880,17875,15319,-2556
2016,9,22,23,17510,17543,14914,-2629
2016,9,23,0,17670,17633,14979,-2654
2016,9,23,1,16940,16887,14067,-2820
2016,9,23,2,15680,15589,13017,-2572
2016,9,23,3,14070,14086,11281,-2805
2016,9,23,4,12600,12896,10313,-2583
2016,9,23,5,11550,12298,9849,-2449
2016,9,23,6,10970,11829,9425,-2404
2016,9,23,7,10610,11730,9344,-2386
2016,9,23,8,10490,11741,9381,-2360
2016,9,23,9,10690,11819,9436,-2383
2016,9,23,10,11580,12068,9795,-2273
2016,9,23,11,13120,12989,10641,-2348
2016,9,23,12,14170,13985,11444,-2541
2016,9,23,13,14670,14539,11709,-2830
2016,9,23,14,15080,14982,12272,-2710
2016,9,23,15,15440,15349,12749,-2600
2016,9,23,16,15670,15660,13101,-2559
2016,9,23,17,15940,15761,13271,-2490
2016,9,23,18,16280,15891,13404,-2487
2016,9,23,19,16480,15959,13515,-2444
2016,9,23,20,16610,16194,13694,-2500
2016,9,23,21,16700,16529,14242,-2287
2016,9,23,22,16610,16551,14214,-2337
2016,9,23,23,16220,16368,14034,-2334
2016,9,24,0,16360,16266,13794,-2472
2016,9,24,1,15630,15509,13117,-2392
2016,9,24,2,14610,14419,12170,-2249
2016,9,24,3,13400,13147,10979,-2168
2016,9,24,4,12140,11880,9769,-2111
2016,9,24,5,10790,11157,9047,-2110
2016,9,24,6,10180,10827,8494,-2333
2016,9,24,7,9890,10713,8177,-2536
2016,9,24,8,9720,10773,8233,-2540
2016,9,24,9,9720,10799,8320,-2479
2016,9,24,10,9990,10982,8314,-2668
2016,9,24,11,10530,10836,8473,-2363
2016,9,24,12,11160,11387,9305,-2082
2016,9,24,13,11840,11898,9796,-2102
2016,9,24,14,12160,12201,10115,-2086
2016,9,24,15,12150,12346,10322,-2024
2016,9,24,16,12070,12408,10500,-1908
2016,9,24,17,11970,12324,10393,-1931
2016,9,24,18,11790,12182,10187,-1995
2016,9,24,19,11860,12133,10118,-2015
2016,9,24,20,12180,12257,9972,-2285
2016,9,24,21,12600,12571,10507,-2064
2016,9,24,22,12980,12967,10956,-2011
2016,9,24,23,13300,13203,10776,-2427
2016,9,25,0,13720,13503,10991,-2512
2016,9,25,1,13260,13078,10834,-2244
2016,9,25,2,12490,12369,10202,-2167
2016,9,25,3,11560,11495,9589,-1906
2016,9,25,4,10660,10927,9000,-1927
2016,9,25,5,10000,10814,8637,-2177
2016,9,25,6,9560,10399,8331,-2068
2016,9,25,7,9310,10307,8232,-2075
2016,9,25,8,9180,10020,8375,-1645
2016,9,25,9,9010,10013,8478,-1535
2016,9,25,10,9300,10141,8477,-1664
2016,9,25,11,9670,10294,8548,-1746
2016,9,25,12,10250,10645,8692,-1953
2016,9,25,13,10890,11018,8931,-2087
2016,9,25,14,11230,11322,9449,-1873
2016,9,25,15,11330,11201,9280,-1921
2016,9,25,16,11260,11238,9204,-2034
2016,9,25,17,11090,11321,9437,-1884
2016,9,25,18,11020,11337,9603,-1734
2016,9,25,19,11230,11406,9760,-1646
2016,9,25,20,11620,11688,9900,-1788
2016,9,25,21,12380,12226,10450,-1776
2016,9,25,22,12990,12962,11054,-1908
2016,9,25,23,13470,13479,11208,-2271
2016,9,26,0,13730,13939,11569,-2370
2016,9,26,1,13400,13361,10943,-2418
2016,9,26,2,12510,12372,10167,-2205
2016,9,26,3,11410,11207,9079,-2128
2016,9,26,4,10370,10392,8366,-2026
2016,9,26,5,9730,9842,8229,-1613
2016,9,26,6,9390,9483,8252,-1231
2016,9,26,7,9240,9426,8210,-1216
2016,9,26,8,9260,9581,8369,-1212
2016,9,26,9,9360,9896,8680,-1216
2016,9,26,10,10390,10439,9304,-1135
2016,9,26,11,12200,12147,11108,-1039
2016,9,26,12,13260,13131,12188,-943
2016,9,26,13,13450,13251,12293,-958
2016,9,26,14,13530,13213,12280,-933
2016,9,26,15,13270,13258,12323,-935
2016,9,26,16,13280,13281,12356,-925
2016,9,26,17,13300,13294,12324,-970
2016,9,26,18,13380,13414,12495,-919
2016,9,26,19,13440,13488,12511,-977
2016,9,26,20,13620,13638,12576,-1062
2016,9,26,21,14040,14008,12883,-1125
2016,9,26,22,14510,14398,13167,-1231
2016,9,26,23,14820,14838,13599,-1239
2016,9,27,0,15100,15174,14010,-1164
2016,9,27,1,14330,14536,13345,-1191
2016,9,27,2,13210,13348,12087,-1261
2016,9,27,3,11820,12137,10800,-1337
2016,9,27,4,10650,11052,9786,-1266
2016,9,27,5,10070,10518,9685,-833
2016,9,27,6,9650,10310,9590,-720
2016,9,27,7,9480,10360,9649,-711
2016,9,27,8,9460,10370,9647,-723
2016,9,27,9,9790,10652,9702,-950
2016,9,27,10,10880,11143,10244,-899
2016,9,27,11,12760,12646,11943,-703
2016,9,27,12,13850,13826,13107,-719
2016,9,27,13,14160,14265,13775,-490
2016,9,27,14,14280,14499,13920,-579
2016,9,27,15,14480,14725,13913,-812
2016,9,27,16,14590,14696,13784,-912
2016,9,27,17,14630,14651,13785,-866
2016,9,27,18,14800,14710,13780,-930
2016,9,27,19,14820,14701,13831,-870
2016,9,27,20,14860,14731,14015,-716
2016,9,27,21,15160,14915,14410,-505
2016,9,27,22,15370,15171,14700,-471
2016,9,27,23,15640,15433,14938,-495
2016,9,28,0,15730,15775,15279,-496
2016,9,28,1,15060,15078,14341,-737
2016,9,28,2,13950,13906,13099,-807
2016,9,28,3,12600,12510,11605,-905
2016,9,28,4,11420,11309,10455,-854
2016,9,28,5,10650,10977,10037,-940
2016,9,28,6,10120,10856,10018,-838
2016,9,28,7,9870,10839,9783,-1056
2016,9,28,8,9750,10743,9719,-1024
2016,9,28,9,9920,10977,10007,-970
2016,9,28,10,10870,11439,10547,-892
2016,9,28,11,12600,12622,11903,-719
2016,9,28,12,13730,13723,13030,-693
2016,9,28,13,14100,14109,13441,-668
2016,9,28,14,14330,14327,13655,-672
2016,9,28,15,14460,14458,13681,-777
2016,9,28,16,14520,14503,13677,-826
2016,9,28,17,14530,14427,13506,-921
2016,9,28,18,14550,14376,13506,-870
2016,9,28,19,14500,14225,13319,-906
2016,9,28,20,14490,14138,13380,-758
2016,9,28,21,14680,14267,13494,-773
2016,9,28,22,14920,14567,13802,-765
2016,9,28,23,15260,14944,14178,-766
2016,9,29,0,15490,15089,14364,-725
2016,9,29,1,14710,14462,13632,-830
2016,9,29,2,13570,13406,12558,-848
2016,9,29,3,12230,12352,11574,-778
2016,9,29,4,11070,11694,10957,-737
2016,9,29,5,10270,10967,10219,-748
2016,9,29,6,9870,10778,9916,-862
2016,9,29,7,9660,10582,9644,-938
2016,9,29,8,9580,10514,9690,-824
2016,9,29,9,9850,10740,9750,-990
2016,9,29,10,10620,11524,10509,-1015
2016,9,29,11,12470,12788,11816,-972
2016,9,29,12,13490,13280,12360,-920
2016,9,29,13,13750,13509,12632,-877
2016,9,29,14,13820,13588,12695,-893
2016,9,29,15,13670,13664,12760,-904
2016,9,29,16,13650,13639,12742,-897
2016,9,29,17,13750,13507,12615,-892
2016,9,29,18,13890,13514,12573,-941
2016,9,29,19,13850,13450,12590,-860
2016,9,29,20,13950,13488,12749,-739
2016,9,29,21,13830,13726,12904,-822
2016,9,29,22,14140,14067,13317,-750
2016,9,29,23,14490,14580,13816,-764
2016,9,30,0,14820,14909,14208,-701
2016,9,30,1,14370,14331,13647,-684
2016,9,30,2,13320,13340,12735,-605
2016,9,30,3,12030,12037,11088,-949
2016,9,30,4,10880,11173,10295,-878
2016,9,30,5,10100,10643,9795,-848
2016,9,30,6,9680,10446,9636,-810
2016,9,30,7,9450,10470,9581,-889
2016,9,30,8,9370,10471,9455,-1016
2016,9,30,9,9670,10499,9512,-987
2016,9,30,10,10540,10972,10040,-932
2016,9,30,11,12180,12276,11535,-741
2016,9,30,12,13240,13304,12609,-695
2016,9,30,13,13600,13666,12934,-732
2016,9,30,14,13800,13843,13129,-714
2016,9,30,15,13960,13950,13187,-763
2016,9,30,16,13960,13987,13125,-862
2016,9,30,17,13920,13911,13039,-872
2016,9,30,18,13960,13970,13111,-859
2016,9,30,19,13880,13888,13041,-847
2016,9,30,20,13870,13789,12979,-810
2016,9,30,21,14000,13859,13013,-846
2016,9,30,22,14150,14049,13789,-260
2016,9,30,23,14460,14372,13493,-879
2016,10,1,0,14530,14366,13444,-922
2016,10,1,1,13920,13843,12857,-986
2016,10,1,2,13080,13050,12094,-956
2016,10,1,3,11930,11949,10913,-1036
2016,10,1,4,10980,10865,9808,-1057
2016,10,1,5,10180,10275,9156,-1119
2016,10,1,6,9700,9975,8923,-1052
2016,10,1,7,9460,10106,9034,-1072
2016,10,1,8,9240,9990,8936,-1054
2016,10,1,9,9300,10024,8995,-1029
2016,10,1,10,9600,10083,9010,-1073
2016,10,1,11,10240,10313,9348,-965
2016,10,1,12,11000,11117,10320,-797
2016,10,1,13,12060,12094,11284,-810
2016,10,1,14,12610,12776,11957,-819
2016,10,1,15,12870,13098,12273,-825
2016,10,1,16,12930,13177,12370,-807
2016,10,1,17,12910,13070,12169,-901
2016,10,1,18,12700,12926,12042,-884
2016,10,1,19,12520,12793,11907,-886
2016,10,1,20,12650,12775,11865,-910
2016,10,1,21,12840,12889,11903,-986
2016,10,1,22,13180,13160,11921,-1239
2016,10,1,23,13700,13567,12130,-1437
2016,10,2,0,13690,13575,11944,-1631
2016,10,2,1,13110,13120,11845,-1275
2016,10,2,2,12370,12439,11414,-1025
2016,10,2,3,11520,11776,10542,-1234
2016,10,2,4,10590,11067,10009,-1058
2016,10,2,5,9940,10411,8883,-1528
2016,10,2,6,9410,10156,8579,-1577
2016,10,2,7,9130,9875,8211,-1664
2016,10,2,8,8940,9743,8161,-1582
2016,10,2,9,8970,10025,8400,-1625
2016,10,2,10,9250,10030,8399,-1631
2016,10,2,11,9710,10485,8795,-1690
2016,10,2,12,10250,10996,9464,-1532
2016,10,2,13,11120,11432,10049,-1383
2016,10,2,14,11760,12018,10756,-1262
2016,10,2,15,12330,12405,10874,-1531
2016,10,2,16,12530,12622,11098,-1524
2016,10,2,17,12530,12790,11275,-1515
2016,10,2,18,12360,12825,11271,-1554
2016,10,2,19,12800,12782,11106,-1676
2016,10,2,20,12750,12814,11031,-1783
2016,10,2,21,13120,13106,11418,-1688
2016,10,2,22,13380,13545,11812,-1733
2016,10,2,23,13960,14038,12085,-1953
2016,10,3,0,13970,14078,12109,-1969
2016,10,3,1,13540,13465,11566,-1899
2016,10,3,2,12640,12494,10687,-1807
2016,10,3,3,11490,11393,9286,-2107
2016,10,3,4,10480,10656,8720,-1936
2016,10,3,5,9700,10509,8635,-1874
2016,10,3,6,9260,10183,8364,-1819
2016,10,3,7,9110,10008,8154,-1854
2016,10,3,8,9150,9995,8178,-1817
2016,10,3,9,9520,10379,8470,-1909
2016,10,3,10,10550,11002,9056,-1946
2016,10,3,11,12340,12188,10329,-1859
2016,10,3,12,13390,13278,11099,-2179
2016,10,3,13,13670,13690,11522,-2168
2016,10,3,14,13920,13887,11726,-2161
2016,10,3,15,14110,13971,11757,-2214
2016,10,3,16,14230,14049,11870,-2179
2016,10,3,17,14230,14157,12243,-1914
2016,10,3,18,14350,14307,12305,-2002
2016,10,3,19,14390,14384,12423,-1961
2016,10,3,20,14310,14425,12544,-1881
2016,10,3,21,14470,14557,12552,-2005
2016,10,3,22,14760,14866,12773,-2093
2016,10,3,23,15310,15344,12997,-2347
2016,10,4,0,15300,15475,13220,-2255
2016,10,4,1,14520,14758,12531,-2227
2016,10,4,2,13470,13651,11622,-2029
2016,10,4,3,12110,12308,10215,-2093
2016,10,4,4,10920,11386,9339,-2047
2016,10,4,5,10220,10585,8595,-1990
2016,10,4,6,9810,10379,8482,-1897
2016,10,4,7,9570,10140,8177,-1963
2016,10,4,8,9510,10067,8055,-2012
2016,10,4,9,9770,10292,8441,-1851
2016,10,4,10,10730,10858,9039,-1819
2016,10,4,11,12500,12472,10864,-1608
2016,10,4,12,13510,13571,11909,-1662
2016,10,4,13,13760,13891,12076,-1815
2016,10,4,14,13860,14020,12235,-1785
2016,10,4,15,13950,14121,12270,-1851
2016,10,4,16,13960,14139,12150,-1989
2016,10,4,17,13940,14058,12169,-1889
2016,10,4,18,13960,13998,12206,-1792
2016,10,4,19,13970,13876,12106,-1770
2016,10,4,20,13950,13874,12219,-1655
2016,10,4,21,14130,14057,12188,-1869
2016,10,4,22,14430,14376,12192,-2184
2016,10,4,23,14960,14937,13054,-1883
2016,10,5,0,15120,15183,13339,-1844
2016,10,5,1,14450,14520,12301,-2219
2016,10,5,2,13370,13424,11749,-1675
2016,10,5,3,12050,12098,10168,-1930
2016,10,5,4,10870,11188,9479,-1709
2016,10,5,5,10170,10691,8841,-1850
2016,10,5,6,9730,10577,8540,-2037
2016,10,5,7,9510,10367,8541,-1826
2016,10,5,8,9480,10246,8503,-1743
2016,10,5,9,9730,10265,8665,-1600
2016,10,5,10,10710,11071,9304,-1767
2016,10,5,11,12530,12502,10529,-1973
2016,10,5,12,13490,13446,11216,-2230
2016,10,5,13,13550,13543,11187,-2356
2016,10,5,14,13500,13471,11264,-2207
2016,10,5,15,13430,13427,11441,-1986
2016,10,5,16,13420,13366,11564,-1802
2016,10,5,17,13380,13371,11375,-1996
2016,10,5,18,13460,13507,11341,-2166
2016,10,5,19,13480,13548,11438,-2110
2016,10,5,20,13560,13658,11500,-2158
2016,10,5,21,13740,13954,11648,-2306
2016,10,5,22,14110,14368,12036,-2332
2016,10,5,23,14690,14899,12431,-2468
2016,10,6,0,14970,15128,12637,-2491
2016,10,6,1,14390,14476,12115,-2361
2016,10,6,2,13310,13421,11120,-2301
2016,10,6,3,11950,12096,10027,-2069
2016,10,6,4,10820,11515,9526,-1989
2016,10,6,5,10110,10915,8744,-2171
2016,10,6,6,9670,10476,8406,-2070
2016,10,6,7,9450,10262,8262,-2000
2016,10,6,8,9420,10230,8247,-1983
2016,10,6,9,9680,10507,8604,-1903
2016,10,6,10,10720,10904,9028,-1876
2016,10,6,11,12630,12506,10515,-1991
2016,10,6,12,13520,13502,11346,-2156
2016,10,6,13,13500,13620,11502,-2118
2016,10,6,14,13470,13542,11322,-2220
2016,10,6,15,13520,13518,11444,-2074
2016,10,6,16,13440,13479,11442,-2037
2016,10,6,17,13430,13494,11535,-1959
2016,10,6,18,13660,13670,11831,-1839
2016,10,6,19,13700,13753,11898,-1855
2016,10,6,20,13800,13914,12033,-1881
2016,10,6,21,14010,14245,12336,-1909
2016,10,6,22,14280,14593,12643,-1950
2016,10,6,23,14790,15036,12899,-2137
2016,10,7,0,15130,15192,13254,-1938
2016,10,7,1,14370,14568,12050,-2518
2016,10,7,2,13350,13511,10443,-3068
2016,10,7,3,11980,12204,9030,-3174
2016,10,7,4,10840,11319,8438,-2881
2016,10,7,5,10070,10953,8062,-2891
2016,10,7,6,9600,10947,7976,-2971
2016,10,7,7,9360,10820,8093,-2727
2016,10,7,8,9340,10756,8036,-2720
2016,10,7,9,9670,10726,8072,-2654
2016,10,7,10,10660,11061,8671,-2390
2016,10,7,11,12480,12259,9860,-2399
2016,10,7,12,13340,13238,10481,-2757
2016,10,7,13,13430,13487,10834,-2653
2016,10,7,14,13440,13528,11021,-2507
2016,10,7,15,13620,13645,11237,-2408
2016,10,7,16,13710,13727,10930,-2797
2016,10,7,17,13570,13717,10938,-2779
2016,10,7,18,13750,13845,11089,-2756
2016,10,7,19,13810,13911,11204,-2707
2016,10,7,20,14000,13970,11254,-2716
2016,10,7,21,14060,14174,11446,-2728
2016,10,7,22,14300,14388,11531,-2857
2016,10,7,23,14430,14657,11790,-2867
2016,10,8,0,14610,14638,11566,-3072
2016,10,8,1,14070,13990,11060,-2930
2016,10,8,2,13220,13153,10224,-2929
2016,10,8,3,12010,12081,9316,-2765
2016,10,8,4,10990,11263,8812,-2451
2016,10,8,5,10150,10675,7906,-2769
2016,10,8,6,9670,10369,7561,-2808
2016,10,8,7,9380,10378,7697,-2681
2016,10,8,8,9240,10264,7727,-2537
2016,10,8,9,9320,10139,7745,-2394
2016,10,8,10,9630,10492,7919,-2573
2016,10,8,11,10380,10640,8169,-2471
2016,10,8,12,11100,11168,8494,-2674
2016,10,8,13,11880,11682,8955,-2727
2016,10,8,14,12310,12179,9595,-2584
2016,10,8,15,12460,12367,9992,-2375
2016,10,8,16,12530,12340,9996,-2344
2016,10,8,17,12510,12385,10035,-2350
2016,10,8,18,12430,12517,10181,-2336
2016,10,8,19,12460,12554,10189,-2365
2016,10,8,20,12540,12650,10147,-2503
2016,10,8,21,12830,12873,10280,-2593
2016,10,8,22,13170,13312,10604,-2708
2016,10,8,23,13800,13935,11272,-2663
2016,10,9,0,13790,13867,11287,-2580
2016,10,9,1,13330,13410,11177,-2233
2016,10,9,2,12590,12749,10515,-2234
2016,10,9,3,11710,11874,9774,-2100
2016,10,9,4,10780,10952,9213,-1739
2016,10,9,5,10030,10451,8462,-1989
2016,10,9,6,9520,10063,7907,-2156
2016,10,9,7,9220,9972,7813,-2159
2016,10,9,8,9040,9823,7830,-1993
2016,10,9,9,9000,10066,8061,-2005
2016,10,9,10,9420,10233,8182,-2051
2016,10,9,11,9780,10397,8033,-2364
2016,10,9,12,10350,10840,8317,-2523
2016,10,9,13,11310,11426,8627,-2799
2016,10,9,14,11940,12279,9599,-2680
2016,10,9,15,12650,12801,9981,-2820
2016,10,9,16,12900,13114,10194,-2920
2016,10,9,17,13060,13299,10128,-3171
2016,10,9,18,13120,13238,9935,-3303
2016,10,9,19,13010,13101,9809,-3292
2016,10,9,20,13000,13056,9903,-3153
2016,10,9,21,13380,13245,10260,-2985
2016,10,9,22,13850,13580,10617,-2963
2016,10,9,23,14430,13891,10916,-2975
2016,10,10,0,14500,13763,10658,-3105
2016,10,10,1,13770,13214,10146,-3068
2016,10,10,2,12960,12315,9527,-2788
2016,10,10,3,11850,11557,8911,-2646
2016,10,10,4,10880,10890,8651,-2239
2016,10,10,5,10000,10541,8831,-1710
2016,10,10,6,9520,10157,8733,-1424
2016,10,10,7,9300,10123,8871,-1252
2016,10,10,8,9200,10060,8780,-1280
2016,10,10,9,9370,10303,8988,-1315
2016,10,10,10,10140,10864,9067,-1797
2016,10,10,11,11400,11682,9271,-2411
2016,10,10,12,12390,12465,9772,-2693
2016,10,10,13,13020,12770,10080,-2690
2016,10,10,14,13240,12939,10187,-2752
2016,10,10,15,13260,12910,10275,-2635
2016,10,10,16,13210,12791,10208,-2583
2016,10,10,17,13090,12647,10155,-2492
2016,10,10,18,12940,12573,10009,-2564
2016,10,10,19,12920,12555,9999,-2556
2016,10,10,20,12960,12701,10252,-2449
2016,10,10,21,13220,13207,10640,-2567
2016,10,10,22,13910,13983,11122,-2861
2016,10,10,23,14900,14766,11977,-2789
2016,10,11,0,15130,14924,11999,-2925
2016,10,11,1,14460,14304,11563,-2741
2016,10,11,2,13330,13282,10591,-2691
2016,10,11,3,12030,12009,9358,-2651
2016,10,11,4,10910,10920,8867,-2053
2016,10,11,5,10260,10565,8601,-1964
2016,10,11,6,9850,10601,8204,-2397
2016,10,11,7,9640,10611,8390,-2221
2016,10,11,8,9630,10620,8450,-2170
2016,10,11,9,9920,10800,8497,-2303
2016,10,11,10,10890,11319,8815,-2504
2016,10,11,11,12750,12794,10370,-2424
2016,10,11,12,13630,13854,11060,-2794
2016,10,11,13,13660,13897,11078,-2819
2016,10,11,14,13440,13612,10795,-2817
2016,10,11,15,13280,13423,10620,-2803
2016,10,11,16,13130,13294,10459,-2835
2016,10,11,17,12990,13152,10520,-2632
2016,10,11,18,12970,13191,10500,-2691
2016,10,11,19,13010,13175,10253,-2922
2016,10,11,20,13070,13316,10471,-2845
2016,10,11,21,13350,13693,10908,-2785
2016,10,11,22,13940,14272,11057,-3215
2016,10,11,23,14750,15091,11974,-3117
2016,10,12,0,15000,15140,11786,-3354
2016,10,12,1,14390,14470,11337,-3133
2016,10,12,2,13320,13421,10659,-2762
2016,10,12,3,11890,12100,9127,-2973
2016,10,12,4,10800,10977,8574,-2403
2016,10,12,5,10090,10580,8189,-2391
2016,10,12,6,9680,10822,8133,-2689
2016,10,12,7,9490,10854,8088,-2766
2016,10,12,8,9460,10897,8021,-2876
2016,10,12,9,9770,10942,8179,-2763
2016,10,12,10,10700,11410,8824,-2586
2016,10,12,11,12520,12655,10180,-2475
2016,10,12,12,13420,13600,10734,-2866
2016,10,12,13,13410,13726,10775,-2951
2016,10,12,14,13360,13592,10707,-2885
2016,10,12,15,13500,13506,10808,-2698
2016,10,12,16,13390,13404,10834,-2570
2016,10,12,17,13300,13310,10768,-2542
2016,10,12,18,13390,13367,10822,-2545
2016,10,12,19,13430,13376,10822,-2554
2016,10,12,20,13530,13512,10837,-2675
2016,10,12,21,13840,13842,11004,-2838
2016,10,12,22,14300,14353,11260,-3093
2016,10,12,23,14960,15065,11797,-3268
2016,10,13,0,15100,15120,11968,-3152
2016,10,13,1,14430,14448,11230,-3218
2016,10,13,2,13360,13382,10506,-2876
2016,10,13,3,12020,12053,9268,-2785
2016,10,13,4,10870,10900,8215,-2685
2016,10,13,5,10150,10668,7754,-2914
2016,10,13,6,9700,10507,7543,-2964
2016,10,13,7,9490,10513,7548,-2965
2016,10,13,8,9460,10544,7530,-3014
2016,10,13,9,9750,10813,7972,-2841
2016,10,13,10,10720,11244,8586,-2658
2016,10,13,11,12560,12564,9774,-2790
2016,10,13,12,13510,13586,10585,-3001
2016,10,13,13,13710,13790,10701,-3089
2016,10,13,14,13740,13862,10555,-3307
2016,10,13,15,13830,13942,10824,-3118
2016,10,13,16,13820,13919,10839,-3080
2016,10,13,17,13800,13846,10849,-2997
2016,10,13,18,13910,14033,11051,-2982
2016,10,13,19,13860,14191,11275,-2916
2016,10,13,20,13940,14279,11209,-3070
2016,10,13,21,14200,14416,11269,-3147
2016,10,13,22,14520,14813,11654,-3159
2016,10,13,23,15100,15344,12254,-3090
2016,10,14,0,15200,15214,12023,-3191
2016,10,14,1,14450,14545,11427,-3118
2016,10,14,2,13400,13474,10590,-2884
2016,10,14,3,12110,12112,9360,-2752
2016,10,14,4,10930,11303,8695,-2608
2016,10,14,5,10180,10943,8349,-2594
2016,10,14,6,9760,10723,8194,-2529
2016,10,14,7,9540,10632,7919,-2713
2016,10,14,8,9510,10716,8009,-2707
2016,10,14,9,9790,10769,8083,-2686
2016,10,14,10,10610,11232,8476,-2756
2016,10,14,11,12450,12405,10007,-2398
2016,10,14,12,13410,13455,10904,-2551
2016,10,14,13,13590,13579,10869,-2710
2016,10,14,14,13460,13365,10618,-2747
2016,10,14,15,13330,13204,10452,-2752
2016,10,14,16,13180,13031,10314,-2717
2016,10,14,17,13040,12842,10092,-2750
2016,10,14,18,13020,12840,10017,-2823
2016,10,14,19,13060,12806,9936,-2870
2016,10,14,20,13110,12926,10176,-2750
2016,10,14,21,13260,13275,10515,-2760
2016,10,14,22,13710,13757,10995,-2762
2016,10,14,23,14250,14399,11043,-3356
2016,10,15,0,14290,14362,11092,-3270
2016,10,15,1,13840,13842,10759,-3083
2016,10,15,2,13030,13098,10160,-2938
2016,10,15,3,12040,12108,9071,-3037
2016,10,15,4,11020,11297,8494,-2803
2016,10,15,5,10300,10796,7748,-3048
2016,10,15,6,9870,10363,7531,-2832
2016,10,15,7,9590,10148,7266,-2882
2016,10,15,8,9540,10078,7317,-2761
2016,10,15,9,9580,10179,7204,-2975
2016,10,15,10,10030,10542,7648,-2894
2016,10,15,11,10830,10893,8146,-2747
2016,10,15,12,11510,11677,9044,-2633
2016,10,15,13,12140,12279,9593,-2686
2016,10,15,14,12200,12364,9707,-2657
2016,10,15,15,12250,12200,9404,-2796
2016,10,15,16,12090,11969,9012,-2957
2016,10,15,17,11900,11717,8966,-2751
2016,10,15,18,11710,11743,9077,-2666
2016,10,15,19,11670,11715,9517,-2198
2016,10,15,20,11790,11885,9672,-2213
2016,10,15,21,12160,12283,10140,-2143
2016,10,15,22,12780,12637,10147,-2490
2016,10,15,23,13510,13480,10631,-2849
2016,10,16,0,13500,13513,10443,-3070
2016,10,16,1,13090,13079,10168,-2911
2016,10,16,2,12410,12452,9801,-2651
2016,10,16,3,11550,11612,8985,-2627
2016,10,16,4,10680,10716,8059,-2657
2016,10,16,5,10040,9997,7543,-2454
2016,10,16,6,9580,9803,7526,-2277
2016,10,16,7,9350,9594,7549,-2045
2016,10,16,8,9260,9507,7725,-1782
2016,10,16,9,9320,9544,7698,-1846
2016,10,16,10,9520,9813,7601,-2212
2016,10,16,11,10030,10338,7993,-2345
2016,10,16,12,10670,10924,8281,-2643
2016,10,16,13,11260,11333,8842,-2491
2016,10,16,14,11640,11683,9296,-2387
2016,10,16,15,11820,11812,9808,-2004
2016,10,16,16,11890,11834,9816,-2018
2016,10,16,17,11860,11894,9961,-1933
2016,10,16,18,11890,11879,9900,-1979
2016,10,16,19,11940,11889,9970,-1919
2016,10,16,20,12150,12082,10165,-1917
2016,10,16,21,12740,12542,10557,-1985
2016,10,16,22,13320,13268,11081,-2187
2016,10,16,23,14210,14171,11519,-2652
2016,10,17,0,14050,14103,11603,-2500
2016,10,17,1,13450,13490,11366,-2124
2016,10,17,2,12500,12519,10578,-1941
2016,10,17,3,11450,11400,9414,-1986
2016,10,17,4,10490,10415,8459,-1956
2016,10,17,5,9870,10173,8089,-2084
2016,10,17,6,9470,9899,8018,-1881
2016,10,17,7,9280,9754,7983,-1771
2016,10,17,8,9290,9749,8035,-1714
2016,10,17,9,9590,9972,8279,-1693
2016,10,17,10,10620,10770,9093,-1677
2016,10,17,11,12430,12372,10461,-1911
2016,10,17,12,13530,13442,11601,-1841
2016,10,17,13,13700,13678,12010,-1668
2016,10,17,14,13860,13822,12275,-1547
2016,10,17,15,14140,13997,12457,-1540
2016,10,17,16,14340,14227,12633,-1594
2016,10,17,17,14320,14289,12517,-1772
2016,10,17,18,14550,14412,12735,-1677
2016,10,17,19,14610,14624,13042,-1582
2016,10,17,20,14730,14718,13132,-1586
2016,10,17,21,14920,14941,13322,-1619
2016,10,17,22,15330,15360,13359,-2001
2016,10,17,23,15940,15959,14067,-1892
2016,10,18,0,15760,15735,13929,-1806
2016,10,18,1,14950,14977,13024,-1953
2016,10,18,2,13820,13876,11802,-2074
2016,10,18,3,12480,12619,10631,-1988
2016,10,18,4,11220,11585,9978,-1607
2016,10,18,5,10320,11162,9651,-1511
2016,10,18,6,9880,11062,9455,-1607
2016,10,18,7,9650,10834,9081,-1753
2016,10,18,8,9620,10764,9110,-1654
2016,10,18,9,9930,10984,9120,-1864
2016,10,18,10,10980,11269,9378,-1891
2016,10,18,11,12860,12611,10679,-1932
2016,10,18,12,13900,13700,11822,-1878
2016,10,18,13,14130,14026,12309,-1717
2016,10,18,14,14340,14226,12497,-1729
2016,10,18,15,14660,14394,12653,-1741
2016,10,18,16,14870,14472,12716,-1756
2016,10,18,17,15040,14455,12645,-1810
2016,10,18,18,15300,14548,12702,-1846
2016,10,18,19,15450,14590,12688,-1902
2016,10,18,20,15680,14737,12763,-1974
2016,10,18,21,15930,15002,13076,-1926
2016,10,18,22,16400,15292,13319,-1973
2016,10,18,23,17000,15903,13907,-1996
2016,10,19,0,16600,15762,13828,-1934
2016,10,19,1,15690,15066,13105,-1961
2016,10,19,2,14480,13998,12437,-1561
2016,10,19,3,13000,12866,11020,-1846
2016,10,19,4,11770,12143,10002,-2141
2016,10,19,5,11000,11494,9366,-2128
2016,10,19,6,10560,11248,9238,-2010
2016,10,19,7,10210,11052,9055,-1997
2016,10,19,8,10140,10966,9053,-1913
2016,10,19,9,10220,11221,9217,-2004
2016,10,19,10,11220,11744,10006,-1738
2016,10,19,11,13140,13034,11152,-1882
2016,10,19,12,14300,14061,12305,-1756
2016,10,19,13,14570,14385,12279,-2106
2016,10,19,14,14790,14612,12422,-2190
2016,10,19,15,15140,14875,12579,-2296
2016,10,19,16,15300,14931,13039,-1892
2016,10,19,17,15250,14927,12695,-2232
2016,10,19,18,15470,15090,12717,-2373
2016,10,19,19,15570,15144,12867,-2277
2016,10,19,20,15750,15207,13062,-2145
2016,10,19,21,15860,15388,13255,-2133
2016,10,19,22,16300,15500,13230,-2270
2016,10,19,23,16800,15946,13548,-2398
2016,10,20,0,16280,15702,13371,-2331
2016,10,20,1,15260,14977,12772,-2205
2016,10,20,2,14220,13761,11717,-2044
2016,10,20,3,12850,12677,10454,-2223
2016,10,20,4,11370,11524,9284,-2240
2016,10,20,5,10490,10860,8255,-2605
2016,10,20,6,9990,10748,8116,-2632
2016,10,20,7,9720,10584,8074,-2510
2016,10,20,8,9620,10473,7897,-2576
2016,10,20,9,9670,10674,8253,-2421
2016,10,20,10,10620,11162,8665,-2497
2016,10,20,11,12490,12548,10026,-2522
2016,10,20,12,13560,13306,10855,-2451
2016,10,20,13,13780,13482,11069,-2413
2016,10,20,14,13960,13515,11262,-2253
2016,10,20,15,14080,13568,11511,-2057
2016,10,20,16,14050,13662,11668,-1994
2016,10,20,17,14050,13756,11716,-2040
2016,10,20,18,14120,13943,11852,-2091
2016,10,20,19,14120,13982,11743,-2239
2016,10,20,20,14220,13992,11646,-2346
2016,10,20,21,14560,14160,11970,-2190
2016,10,20,22,14920,14633,12347,-2286
2016,10,20,23,15600,15279,13174,-2105
2016,10,21,0,15410,15046,12797,-2249
2016,10,21,1,14670,14393,12083,-2310
2016,10,21,2,13580,13404,11108,-2296
2016,10,21,3,12270,12171,9971,-2200
2016,10,21,4,11140,11019,8886,-2133
2016,10,21,5,10250,10475,8331,-2144
2016,10,21,6,9750,10618,8217,-2401
2016,10,21,7,9560,10585,8087,-2498
2016,10,21,8,9510,10383,8104,-2279
2016,10,21,9,9820,10798,8348,-2450
2016,10,21,10,10780,11182,8820,-2362
2016,10,21,11,12550,12499,10039,-2460
2016,10,21,12,13580,13734,11201,-2533
2016,10,21,13,13890,14202,11865,-2337
2016,10,21,14,14100,14487,12399,-2088
2016,10,21,15,14360,14734,12527,-2207
2016,10,21,16,14400,14898,12573,-2325
2016,10,21,17,14360,14960,12529,-2431
2016,10,21,18,14380,15111,12531,-2580
2016,10,21,19,14320,15014,12347,-2667
2016,10,21,20,14360,14940,12349,-2591
2016,10,21,21,14430,14999,12399,-2600
2016,10,21,22,14700,15219,12722,-2497
2016,10,21,23,15400,15499,12961,-2538
2016,10,22,0,15120,15108,12589,-2519
2016,10,22,1,14300,14467,12007,-2460
2016,10,22,2,13410,13688,11351,-2337
2016,10,22,3,12350,12650,10296,-2354
2016,10,22,4,11270,11599,9131,-2468
2016,10,22,5,10360,10986,8272,-2714
2016,10,22,6,9820,10707,8076,-2631
2016,10,22,7,9580,10574,7868,-2706
2016,10,22,8,9350,10480,7772,-2708
2016,10,22,9,9320,10444,7740,-2704
2016,10,22,10,10020,10719,8012,-2707
2016,10,22,11,10800,11200,8565,-2635
2016,10,22,12,11500,11859,9319,-2540
2016,10,22,13,12300,12329,9951,-2378
2016,10,22,14,12810,12944,10686,-2258
2016,10,22,15,12960,13283,10880,-2403
2016,10,22,16,12970,13346,10766,-2580
2016,10,22,17,12850,13219,10643,-2576
2016,10,22,18,12620,12940,10431,-2509
2016,10,22,19,12560,12784,10428,-2356
2016,10,22,20,12550,12807,10581,-2226
2016,10,22,21,12840,12930,10587,-2343
2016,10,22,22,13220,13305,10802,-2503
2016,10,22,23,14000,13725,11085,-2640
2016,10,23,0,13710,13448,10726,-2722
2016,10,23,1,13210,12984,10189,-2795
2016,10,23,2,12510,12368,9836,-2532
2016,10,23,3,11690,11554,8942,-2612
2016,10,23,4,10860,10904,8180,-2724
2016,10,23,5,10120,10528,7783,-2745
2016,10,23,6,9730,10568,7840,-2728
2016,10,23,7,9450,10337,7704,-2633
2016,10,23,8,9340,10203,7836,-2367
2016,10,23,9,9380,10226,7934,-2292
2016,10,23,10,9550,10475,8013,-2462
2016,10,23,11,10040,10999,8283,-2716
2016,10,23,12,10790,11649,9075,-2574
2016,10,23,13,11480,11836,9411,-2425
2016,10,23,14,11820,11902,9385,-2517
2016,10,23,15,11860,11956,9572,-2384
2016,10,23,16,11900,11812,9646,-2166
2016,10,23,17,11860,11563,9389,-2174
2016,10,23,18,11720,11481,9381,-2100
2016,10,23,19,11670,11494,9523,-1971
2016,10,23,20,11870,11788,9868,-1920
2016,10,23,21,12360,12391,10458,-1933
2016,10,23,22,13240,13171,11049,-2122
2016,10,23,23,14300,14105,11882,-2223
2016,10,24,0,14070,13960,11991,-1969
2016,10,24,1,13580,13516,11360,-2156
2016,10,24,2,12660,12543,10290,-2253
2016,10,24,3,11610,11443,9110,-2333
2016,10,24,4,10610,10839,8644,-2195
2016,10,24,5,9780,10300,8134,-2166
2016,10,24,6,9450,9930,8281,-1649
2016,10,24,7,9290,9766,8237,-1529
2016,10,24,8,9300,9744,7772,-1972
2016,10,24,9,9640,10014,7808,-2206
2016,10,24,10,10690,10589,8369,-2220
2016,10,24,11,12590,12430,9898,-2532
2016,10,24,12,13660,13595,11054,-2541
2016,10,24,13,13790,13679,11316,-2363
2016,10,24,14,13720,13476,10863,-2613
2016,10,24,15,13630,13407,10831,-2576
2016,10,24,16,13540,13304,10685,-2619
2016,10,24,17,13440,13177,10617,-2560
2016,10,24,18,13370,13151,10545,-2606
2016,10,24,19,13360,13106,10546,-2560
2016,10,24,20,13460,13237,10754,-2483
2016,10,24,21,13850,13598,10981,-2617
2016,10,24,22,14590,14321,11749,-2572
2016,10,24,23,15500,15218,12678,-2540
2016,10,25,0,15250,15022,12624,-2398
2016,10,25,1,14690,14384,12101,-2283
2016,10,25,2,13620,13382,10718,-2664
2016,10,25,3,12350,12117,9388,-2729
2016,10,25,4,11210,11299,8575,-2724
2016,10,25,5,10410,10693,8133,-2560
2016,10,25,6,10040,10378,7804,-2574
2016,10,25,7,9850,10582,7778,-2804
2016,10,25,8,9830,10481,7861,-2620
2016,10,25,9,10160,10540,8063,-2477
2016,10,25,10,11160,11273,8806,-2467
2016,10,25,11,13170,12982,10686,-2296
2016,10,25,12,14190,14074,11853,-2221
2016,10,25,13,14200,14070,11985,-2085
2016,10,25,14,13980,13802,11842,-1960
2016,10,25,15,13860,13582,11663,-1919
2016,10,25,16,13730,13558,11687,-1871
2016,10,25,17,13630,13521,11237,-2284
2016,10,25,18,13590,13569,11147,-2422
2016,10,25,19,13580,13542,11192,-2350
2016,10,25,20,13740,13669,11317,-2352
2016,10,25,21,14230,14048,11654,-2394
2016,10,25,22,15010,14810,12470,-2340
2016,10,25,23,15900,15745,13566,-2179
2016,10,26,0,15680,15591,13472,-2119
2016,10,26,1,15040,15000,12874,-2126
2016,10,26,2,13990,13977,11783,-2194
2016,10,26,3,12700,12648,10197,-2451
2016,10,26,4,11550,11443,9040,-2403
2016,10,26,5,10730,11151,8634,-2517
2016,10,26,6,10340,10879,8494,-2385
2016,10,26,7,10140,10730,8438,-2292
2016,10,26,8,10170,10900,8570,-2330
2016,10,26,9,10520,11472,9214,-2258
2016,10,26,10,11680,11944,9717,-2227
2016,10,26,11,13680,13521,11262,-2259
2016,10,26,12,14580,14603,12845,-1758
2016,10,26,13,14380,14585,12957,-1628
2016,10,26,14,14110,14244,12565,-1679
2016,10,26,15,13900,13969,11778,-2191
2016,10,26,16,13710,13785,11239,-2546
2016,10,26,17,13530,13658,11268,-2390
2016,10,26,18,13480,13676,11466,-2210
2016,10,26,19,13520,13661,11487,-2174
2016,10,26,20,13650,13770,11724,-2046
2016,10,26,21,14160,14157,11999,-2158
2016,10,26,22,14940,14985,12562,-2423
2016,10,26,23,15930,15810,13337,-2473
2016,10,27,0,15770,15655,13409,-2246
2016,10,27,1,15190,15150,12900,-2250
2016,10,27,2,14200,14207,11552,-2655
2016,10,27,3,12910,12900,10213,-2687
2016,10,27,4,11750,11746,9034,-2712
2016,10,27,5,10940,11105,8374,-2731
2016,10,27,6,10530,11158,8325,-2833
2016,10,27,7,10340,11259,8341,-2918
2016,10,27,8,10320,11258,8323,-2935
2016,10,27,9,10720,11595,8745,-2850
2016,10,27,10,11870,12424,9705,-2719
2016,10,27,11,13810,13791,11344,-2447
2016,10,27,12,14930,14886,12493,-2393
2016,10,27,13,14980,15001,12586,-2415
2016,10,27,14,14850,14959,12616,-2343
2016,10,27,15,14740,14926,12869,-2057
2016,10,27,16,14660,14953,13005,-1948
2016,10,27,17,14630,14942,12876,-2066
2016,10,27,18,14680,15009,12839,-2170
2016,10,27,19,14700,14990,12795,-2195
2016,10,27,20,14780,15079,12936,-2143
2016,10,27,21,15200,15404,13246,-2158
2016,10,27,22,15650,16019,13876,-2143
2016,10,27,23,16190,16315,14223,-2092
2016,10,28,0,16020,15949,13969,-1980
2016,10,28,1,15210,15323,13271,-2052
2016,10,28,2,14140,14287,12070,-2217
2016,10,28,3,12800,12908,10503,-2405
2016,10,28,4,11620,11683,9220,-2463
2016,10,28,5,10790,10888,8683,-2205
2016,10,28,6,10320,10709,8526,-2183
2016,10,28,7,10070,10465,8232,-2233
2016,10,28,8,9990,10393,8213,-2180
2016,10,28,9,10280,10781,8657,-2124
2016,10,28,10,11300,11648,9631,-2017
2016,10,28,11,13070,13382,11452,-1930
2016,10,28,12,14220,14572,12580,-1992
2016,10,28,13,14470,14754,12747,-2007
2016,10,28,14,14530,14616,12485,-2131
2016,10,28,15,14500,14511,12600,-1911
2016,10,28,16,14410,14427,12350,-2077
2016,10,28,17,14280,14297,12354,-1943
2016,10,28,18,14180,14262,12379,-1883
2016,10,28,19,14160,14172,12397,-1775
2016,10,28,20,14190,14169,12465,-1704
2016,10,28,21,14430,14445,12657,-1788
2016,10,28,22,14900,14928,12831,-2097
2016,10,28,23,15400,15346,13305,-2041
2016,10,29,0,15090,14967,12858,-2109
2016,10,29,1,14510,14408,12401,-2007
2016,10,29,2,13690,13643,11766,-1877
2016,10,29,3,12660,12606,10549,-2057
2016,10,29,4,11600,11566,9458,-2108
2016,10,29,5,10780,10734,8672,-2062
2016,10,29,6,10330,10481,8525,-1956
2016,10,29,7,10050,10402,8444,-1958
2016,10,29,8,9900,10149,8305,-1844
2016,10,29,9,10000,10363,8467,-1896
2016,10,29,10,10400,10893,8943,-1950
2016,10,29,11,11200,11656,9723,-1933
2016,10,29,12,12030,12244,10270,-1974
2016,10,29,13,12750,12814,10758,-2056
2016,10,29,14,13100,13312,11463,-1849
2016,10,29,15,13140,13690,12041,-1649
2016,10,29,16,13100,13519,12039,-1480
2016,10,29,17,12890,13009,11280,-1729
2016,10,29,18,12640,12804,11032,-1772
2016,10,29,19,12550,12794,11005,-1789
2016,10,29,20,12640,12871,11287,-1584
2016,10,29,21,12970,13086,11509,-1577
2016,10,29,22,13540,13682,12105,-1577
2016,10,29,23,14150,14110,12619,-1491
2016,10,30,0,13810,13710,12138,-1572
2016,10,30,1,13320,13184,11516,-1668
2016,10,30,2,12660,12533,10740,-1793
2016,10,30,3,11790,11697,9725,-1972
2016,10,30,4,10890,10978,9026,-1952
2016,10,30,5,10130,10638,8378,-2260
2016,10,30,6,9660,10439,8122,-2317
2016,10,30,7,9420,10294,8052,-2242
2016,10,30,8,9270,10295,8053,-2242
2016,10,30,9,9280,10303,8077,-2226
2016,10,30,10,9520,10512,8270,-2242
2016,10,30,11,9980,10707,8585,-2122
2016,10,30,12,10690,10824,8905,-1919
2016,10,30,13,11460,11304,9481,-1823
2016,10,30,14,12260,11746,9919,-1827
2016,10,30,15,12540,11963,10203,-1760
2016,10,30,16,12600,12019,10136,-1883
2016,10,30,17,12580,12084,9948,-2136
2016,10,30,18,12500,12145,9763,-2382
2016,10,30,19,12430,12275,9826,-2449
2016,10,30,20,12520,12632,10082,-2550
2016,10,30,21,12970,13173,10635,-2538
2016,10,30,22,13620,13978,11428,-2550
2016,10,30,23,14400,14362,11970,-2392
2016,10,31,0,14330,14022,11458,-2564
2016,10,31,1,13700,13410,10819,-2591
2016,10,31,2,12710,12486,9973,-2513
2016,10,31,3,11610,11418,8859,-2559
2016,10,31,4,10670,10484,7846,-2638
2016,10,31,5,9980,10280,7698,-2582
2016,10,31,6,9640,10285,7612,-2673
2016,10,31,7,9500,10362,7665,-2697
2016,10,31,8,9530,10374,7764,-2610
2016,10,31,9,9670,10486,8062,-2424
2016,10,31,10,10750,11432,8988,-2444
2016,10,31,11,12640,12806,10591,-2215
2016,10,31,12,13910,13952,11802,-2150
2016,10,31,13,14080,14039,11660,-2379
2016,10,31,14,13920,13837,11473,-2364
2016,10,31,15,13800,13742,11219,-2523
2016,10,31,16,13720,13571,11076,-2495
2016,10,31,17,13570,13409,11158,-2251
2016,10,31,18,13500,13333,11011,-2322
2016,10,31,19,13490,13223,10988,-2235
2016,10,31,20,13630,13345,11159,-2186
2016,10,31,21,14040,13788,11279,-2509
2016,10,31,22,14860,14442,11840,-2602
2016,10,31,23,15700,14890,12310,-2580
2016,11,1,0,15550,14603,11979,-2624
2016,11,1,1,14940,14325,11702,-2623
2016,11,1,2,13920,13621,11303,-2318
2016,11,1,3,12620,12425,10066,-2359
2016,11,1,4,11490,11365,8683,-2682
2016,11,1,5,10740,10957,8110,-2847
2016,11,1,6,10350,10910,8096,-2814
2016,11,1,7,10190,11091,8175,-2916
2016,11,1,8,10200,11347,8399,-2948
2016,11,1,9,10520,11444,8597,-2847
2016,11,1,10,11640,12249,9661,-2588
2016,11,1,11,13650,13680,11100,-2580
2016,11,1,12,14620,14807,12358,-2449
2016,11,1,13,14450,14740,12277,-2463
2016,11,1,14,14010,14309,11811,-2498
2016,11,1,15,13730,13949,11537,-2412
2016,11,1,16,13490,13623,11105,-2518
2016,11,1,17,13350,13360,11148,-2212
2016,11,1,18,13280,13276,10904,-2372
2016,11,1,19,13290,13254,10948,-2306
2016,11,1,20,13500,13402,11071,-2331
2016,11,1,21,14160,13930,11488,-2442
2016,11,1,22,14900,14868,12310,-2558
2016,11,1,23,15600,15741,13044,-2697
2016,11,2,0,15310,15482,12875,-2607
2016,11,2,1,14770,14825,12271,-2554
2016,11,2,2,13720,13816,11113,-2703
2016,11,2,3,12380,12493,9918,-2575
2016,11,2,4,11270,11556,8830,-2726
2016,11,2,5,10530,10943,8130,-2813
2016,11,2,6,10080,10674,7924,-2750
2016,11,2,7,9880,10678,7856,-2822
2016,11,2,8,9860,10617,8038,-2579
2016,11,2,9,10110,10798,8245,-2553
2016,11,2,10,11120,11624,8902,-2722
2016,11,2,11,13030,13045,10373,-2672
2016,11,2,12,14120,14043,11289,-2754
2016,11,2,13,14070,14062,11477,-2585
2016,11,2,14,13920,13820,11543,-2277
2016,11,2,15,13850,13668,11520,-2148
2016,11,2,16,13700,13525,11570,-1955
2016,11,2,17,13580,13448,11592,-1856
2016,11,2,18,13650,13550,11818,-1732
2016,11,2,19,13710,13655,11926,-1729
2016,11,2,20,13800,13769,11800,-1969
2016,11,2,21,14340,14058,11922,-2136
2016,11,2,22,14860,14769,12379,-2390
2016,11,2,23,15470,15494,13080,-2414
2016,11,3,0,15110,15157,12778,-2379
2016,11,3,1,14460,14449,12290,-2159
2016,11,3,2,13410,13428,11207,-2221
2016,11,3,3,12120,12162,9942,-2220
2016,11,3,4,11010,11289,8906,-2383
2016,11,3,5,10270,10892,8691,-2201
2016,11,3,6,9800,10629,8533,-2096
2016,11,3,7,9610,10600,8298,-2302
2016,11,3,8,9580,10568,8449,-2119
2016,11,3,9,9790,10460,8510,-1950
2016,11,3,10,10810,11299,8864,-2435
2016,11,3,11,12790,12551,10214,-2337
2016,11,3,12,13860,13723,11655,-2068
2016,11,3,13,13990,13963,12113,-1850
2016,11,3,14,14020,14152,12363,-1789
2016,11,3,15,14030,14292,12668,-1624
2016,11,3,16,13990,14379,12770,-1609
2016,11,3,17,13970,14454,12774,-1680
2016,11,3,18,14050,14488,12640,-1848
2016,11,3,19,14030,14402,12492,-1910
2016,11,3,20,14120,14348,12499,-1849
2016,11,3,21,14540,14503,12476,-2027
2016,11,3,22,14920,14961,12748,-2213
2016,11,3,23,15350,15380,13400,-1980
2016,11,4,0,15090,15026,12931,-2095
2016,11,4,1,14480,14368,11996,-2372
2016,11,4,2,13460,13376,11049,-2327
2016,11,4,3,12190,12082,9768,-2314
2016,11,4,4,11090,11057,8945,-2112
2016,11,4,5,10260,10695,8655,-2040
2016,11,4,6,9830,10518,8359,-2159
2016,11,4,7,9630,10535,8416,-2119
2016,11,4,8,9610,10533,8347,-2186
2016,11,4,9,9870,10740,8450,-2290
2016,11,4,10,10680,11560,9048,-2512
2016,11,4,11,12490,12746,10374,-2372
2016,11,4,12,13660,13775,11464,-2311
2016,11,4,13,13720,13906,12115,-1791
2016,11,4,14,13710,13730,11956,-1774
2016,11,4,15,13580,13731,11873,-1858
2016,11,4,16,13400,13459,11617,-1842
2016,11,4,17,13350,13146,11451,-1695
2016,11,4,18,13360,13003,11283,-1720
2016,11,4,19,13350,12887,11168,-1719
2016,11,4,20,13380,13049,11316,-1733
2016,11,4,21,13910,13532,11725,-1807
2016,11,4,22,14530,14109,11637,-2472
2016,11,4,23,15010,14766,12246,-2520
2016,11,5,0,14630,14451,12152,-2299
2016,11,5,1,14190,13957,11791,-2166
2016,11,5,2,13390,13279,11352,-1927
2016,11,5,3,12360,12328,10146,-2182
2016,11,5,4,11380,11312,9461,-1851
2016,11,5,5,10550,10865,8359,-2506
2016,11,5,6,10150,10625,8079,-2546
2016,11,5,7,9920,10723,8073,-2650
2016,11,5,8,9830,10698,7888,-2810
2016,11,5,9,9950,10823,7687,-3136
2016,11,5,10,10460,11234,8176,-3058
2016,11,5,11,11280,11558,8855,-2703
2016,11,5,12,12100,12405,9439,-2966
2016,11,5,13,12690,12908,9941,-2967
2016,11,5,14,12900,13338,10437,-2901
2016,11,5,15,13210,13438,10572,-2866
2016,11,5,16,13000,13076,10116,-2960
2016,11,5,17,12740,12756,9897,-2859
2016,11,5,18,12600,12493,9553,-2940
2016,11,5,19,12490,12242,9462,-2780
2016,11,5,20,12550,12311,9460,-2851
2016,11,5,21,13170,12792,10004,-2788
2016,11,5,22,13580,13583,10861,-2722
2016,11,5,23,14140,14100,11414,-2686
2016,11,6,0,13750,13755,11109,-2646
2016,11,6,1,13330,13288,10645,-2643
2016,11,6,2,12670,12666,10116,-2550
2016,11,6,3,11840,11832,9231,-2601
2016,11,6,4,10950,11067,8735,-2332
2016,11,6,5,9950,10507,8162,-2345
2016,11,6,6,9500,10266,7826,-2440
2016,11,6,7,9500,10266,7811,-2455
2016,11,6,8,9310,10142,7664,-2478
2016,11,6,9,9190,10349,7757,-2592
2016,11,6,10,9280,10488,7913,-2575
2016,11,6,11,9800,10837,8063,-2774
2016,11,6,12,10330,11213,8480,-2733
2016,11,6,13,10970,11537,8977,-2560
2016,11,6,14,11680,11898,9453,-2445
2016,11,6,15,12330,12286,9946,-2340
2016,11,6,16,12410,12359,9837,-2522
2016,11,6,17,12360,12420,9941,-2479
2016,11,6,18,12270,12518,10010,-2508
2016,11,6,19,12200,12595,10030,-2565
2016,11,6,20,12300,12688,9951,-2737
2016,11,6,21,12820,13045,10345,-2700
2016,11,6,22,13810,13995,11350,-2645
2016,11,6,23,15000,15010,12457,-2553
2016,11,7,0,14770,14790,12029,-2761
2016,11,7,1,14330,14292,11453,-2839
2016,11,7,2,13830,13612,10846,-2766
2016,11,7,3,12810,12650,10015,-2635
2016,11,7,4,11760,11593,9138,-2455
2016,11,7,5,11080,10850,8454,-2396
2016,11,7,6,10310,10673,8361,-2312
2016,11,7,7,10010,10497,8116,-2381
2016,11,7,8,9880,10673,8172,-2501
2016,11,7,9,9970,10790,8341,-2449
2016,11,7,10,10460,10991,8631,-2360
2016,11,7,11,11590,11922,9548,-2374
2016,11,7,12,13490,13553,11426,-2127
2016,11,7,13,14580,14021,11841,-2180
2016,11,7,14,14320,14177,11941,-2236
2016,11,7,15,13940,13951,11759,-2192
2016,11,7,16,13700,13819,11438,-2381
2016,11,7,17,13500,13654,11255,-2399
2016,11,7,18,13390,13519,11170,-2349
2016,11,7,19,13370,13529,11326,-2203
2016,11,7,20,13450,13624,11493,-2131
2016,11,7,21,13790,13993,11689,-2304
2016,11,7,22,14770,14898,12386,-2512
2016,11,7,23,16000,16082,13412,-2670
2016,11,8,0,15980,16006,13378,-2628
2016,11,8,1,15520,15603,12769,-2834
2016,11,8,2,14870,14913,12230,-2683
2016,11,8,3,13760,13908,11169,-2739
2016,11,8,4,12470,12777,10106,-2671
2016,11,8,5,11410,12153,9688,-2465
2016,11,8,6,10700,11830,9046,-2784
2016,11,8,7,10320,11597,8811,-2786
2016,11,8,8,10180,11527,8698,-2829
2016,11,8,9,10260,11557,8796,-2761
2016,11,8,10,10600,11952,9202,-2750
2016,11,8,11,12040,12458,9692,-2766
2016,11,8,12,13800,13649,10872,-2777
2016,11,8,13,14530,14340,11549,-2791
2016,11,8,14,14230,14134,11288,-2846
2016,11,8,15,13810,13782,11194,-2588
2016,11,8,16,13640,13538,11132,-2406
2016,11,8,17,13340,13411,11119,-2292
2016,11,8,18,13310,13329,10959,-2370
2016,11,8,19,13190,13440,10910,-2530
2016,11,8,20,13230,13604,11098,-2506
2016,11,8,21,13490,13897,11370,-2527
2016,11,8,22,14610,14662,12062,-2600
2016,11,8,23,15740,15667,13160,-2507
2016,11,9,0,15650,15548,12968,-2580
2016,11,9,1,15150,15078,12331,-2747
2016,11,9,2,14480,14401,11885,-2516
2016,11,9,3,13450,13446,11144,-2302
2016,11,9,4,12110,12338,9567,-2771
2016,11,9,5,11040,11640,8982,-2658
2016,11,9,6,10470,11683,8580,-3103
2016,11,9,7,10070,11627,8479,-3148
2016,11,9,8,9900,11477,8324,-3153
2016,11,9,9,9890,11415,8224,-3191
2016,11,9,10,10280,11701,8576,-3125
2016,11,9,11,11540,12358,9292,-3066
2016,11,9,12,13280,13464,10477,-2987
2016,11,9,13,14150,14029,11292,-2737
2016,11,9,14,14180,14073,11929,-2144
2016,11,9,15,14110,14066,11841,-2225
2016,11,9,16,14030,14273,12067,-2206
2016,11,9,17,14040,14318,11953,-2365
2016,11,9,18,13930,14266,12124,-2142
2016,11,9,19,14070,14345,12286,-2059
2016,11,9,20,14140,14324,12252,-2072
2016,11,9,21,14340,14429,12338,-2091
2016,11,9,22,15230,15220,12934,-2286
2016,11,9,23,16240,15909,13425,-2484
2016,11,10,0,15920,15682,13198,-2484
2016,11,10,1,15450,15157,12689,-2468
2016,11,10,2,14690,14442,12396,-2046
2016,11,10,3,13640,13387,11250,-2137
2016,11,10,4,12380,12124,9548,-2576
2016,11,10,5,11340,11313,8802,-2511
2016,11,10,6,10740,10988,7994,-2994
2016,11,10,7,10390,11055,7875,-3180
2016,11,10,8,10200,11049,8020,-3029
2016,11,10,9,10220,11076,8184,-2892
2016,11,10,10,10640,11460,8518,-2942
2016,11,10,11,11580,12107,9393,-2714
2016,11,10,12,13390,13358,10925,-2433
2016,11,10,13,14220,14142,11941,-2201
2016,11,10,14,14210,13980,11790,-2190
2016,11,10,15,14040,13664,11429,-2235
2016,11,10,16,13930,13493,11361,-2132
2016,11,10,17,13820,13347,11353,-1994
2016,11,10,18,13720,13225,11162,-2063
2016,11,10,19,13760,13383,11183,-2200
2016,11,10,20,13800,13548,11353,-2195
2016,11,10,21,14100,13885,11709,-2176
2016,11,10,22,15120,14742,12610,-2132
2016,11,10,23,16150,15677,13546,-2131
2016,11,11,0,15890,15541,13211,-2330
2016,11,11,1,15370,15091,12806,-2285
2016,11,11,2,14680,14469,12191,-2278
2016,11,11,3,13630,13573,11181,-2392
2016,11,11,4,12330,12410,10036,-2374
2016,11,11,5,11250,11314,8975,-2339
2016,11,11,6,10540,11013,8671,-2342
2016,11,11,7,10120,10936,8623,-2313
2016,11,11,8,9930,10739,8455,-2284
2016,11,11,9,9910,10705,8487,-2218
2016,11,11,10,10190,10966,8923,-2043
2016,11,11,11,11010,11397,9411,-1986
2016,11,11,12,12250,12222,10235,-1987
2016,11,11,13,13090,13098,10949,-2149
2016,11,11,14,13400,13375,11123,-2252
2016,11,11,15,13570,13422,11724,-1698
2016,11,11,16,13460,13374,11920,-1454
2016,11,11,17,13290,13304,11791,-1513
2016,11,11,18,13140,13260,11736,-1524
2016,11,11,19,13070,13228,11703,-1525
2016,11,11,20,13120,13324,11654,-1670
2016,11,11,21,13360,13669,11274,-2395
2016,11,11,22,14560,14532,12045,-2487
2016,11,11,23,15850,15480,12983,-2497
2016,11,12,0,15640,15271,12696,-2575
2016,11,12,1,15010,14764,12610,-2154
2016,11,12,2,14500,14247,12172,-2075
2016,11,12,3,13620,13527,11411,-2116
2016,11,12,4,12680,12593,10468,-2125
2016,11,12,5,11630,12075,9665,-2410
2016,11,12,6,10970,11330,8746,-2584
2016,11,12,7,10600,10897,8320,-2577
2016,11,12,8,10360,10899,8443,-2456
2016,11,12,9,10320,11133,8809,-2324
2016,11,12,10,10510,11297,9013,-2284
2016,11,12,11,10970,11426,9354,-2072
2016,11,12,12,11630,11722,9885,-1837
2016,11,12,13,12220,12376,10282,-2094
2016,11,12,14,12790,12790,10848,-1942
2016,11,12,15,12930,12848,10849,-1999
2016,11,12,16,12790,12703,10777,-1926
2016,11,12,17,12550,12492,10390,-2102
2016,11,12,18,12360,12316,10365,-1951
2016,11,12,19,12260,12222,10230,-1992
2016,11,12,20,12260,12359,10269,-2090
2016,11,12,21,12680,12814,10542,-2272
2016,11,12,22,13830,13812,11403,-2409
2016,11,12,23,14850,14857,12380,-2477
2016,11,13,0,14630,14672,12079,-2593
2016,11,13,1,14190,14220,11802,-2418
2016,11,13,2,13680,13759,11605,-2154
2016,11,13,3,13050,13100,11227,-1873
2016,11,13,4,12210,12253,10438,-1815
2016,11,13,5,11400,11651,9673,-1978
2016,11,13,6,10660,11250,8773,-2477
2016,11,13,7,10350,10864,8279,-2585
2016,11,13,8,10110,10913,8234,-2679
2016,11,13,9,10030,11031,8388,-2643
2016,11,13,10,10000,10905,8373,-2532
2016,11,13,11,10340,11099,8536,-2563
2016,11,13,12,10770,11407,9046,-2361
2016,11,13,13,11340,11861,9716,-2145
2016,11,13,14,11860,12049,10145,-1904
2016,11,13,15,12040,11894,10103,-1791
2016,11,13,16,12010,11831,9877,-1954
2016,11,13,17,11990,11741,9759,-1982
2016,11,13,18,11970,11748,9830,-1918
2016,11,13,19,11910,11801,9742,-2059
2016,11,13,20,11890,12023,9841,-2182
2016,11,13,21,12240,12527,10407,-2120
2016,11,13,22,13690,13607,11530,-2077
2016,11,13,23,14900,14791,12485,-2306
2016,11,14,0,14720,14681,12246,-2435
2016,11,14,1,14270,14214,11924,-2290
2016,11,14,2,13730,13690,11659,-2031
2016,11,14,3,12700,12764,10799,-1965
2016,11,14,4,11680,11790,9741,-2049
2016,11,14,5,10810,10902,8719,-2183
2016,11,14,6,10240,10436,7972,-2464
2016,11,14,7,9900,10186,7873,-2313
2016,11,14,8,9810,10327,8033,-2294
2016,11,14,9,9870,10441,8121,-2320
2016,11,14,10,10290,10864,8523,-2341
2016,11,14,11,11390,11876,9630,-2246
2016,11,14,12,13150,13310,11031,-2279
2016,11,14,13,14000,14174,12287,-1887
2016,11,14,14,13930,13987,12293,-1694
2016,11,14,15,13580,13641,12135,-1506
2016,11,14,16,13520,13473,12033,-1440
2016,11,14,17,13260,13376,11987,-1389
2016,11,14,18,13300,13320,12079,-1241
2016,11,14,19,13310,13434,12056,-1378
2016,11,14,20,13400,13632,12075,-1557
2016,11,14,21,13680,13961,12197,-1764
2016,11,14,22,14750,14910,13104,-1806
2016,11,14,23,15900,15903,13945,-1958
2016,11,15,0,15640,15694,13802,-1892
2016,11,15,1,15090,15191,13584,-1607
2016,11,15,2,14450,14495,12976,-1519
2016,11,15,3,13340,13467,12046,-1421
2016,11,15,4,12060,12191,10496,-1695
2016,11,15,5,11020,11362,9444,-1918
2016,11,15,6,10370,10683,8960,-1723
2016,11,15,7,10010,10544,8821,-1723
2016,11,15,8,9820,10599,8649,-1950
2016,11,15,9,9830,10616,8681,-1935
2016,11,15,10,10220,10954,9046,-1908
2016,11,15,11,11340,11575,9837,-1738
2016,11,15,12,13170,13010,11472,-1538
2016,11,15,13,14100,14035,12536,-1499
2016,11,15,14,14240,14229,12764,-1465
2016,11,15,15,14220,14340,13018,-1322
2016,11,15,16,14320,14509,13079,-1430
2016,11,15,17,14340,14619,13388,-1231
2016,11,15,18,14290,14616,13371,-1245
2016,11,15,19,14390,14715,13247,-1468
2016,11,15,20,14410,14743,13039,-1704
2016,11,15,21,14750,14964,13340,-1624
2016,11,15,22,15590,15696,13893,-1803
2016,11,15,23,16400,16200,14345,-1855
2016,11,16,0,15990,15955,14356,-1599
2016,11,16,1,15440,15466,13844,-1622
2016,11,16,2,14620,14739,13134,-1605
2016,11,16,3,13460,13634,12309,-1325
2016,11,16,4,12150,12307,10879,-1428
2016,11,16,5,11020,11199,9650,-1549
2016,11,16,6,10440,10809,9194,-1615
2016,11,16,7,10010,10814,8930,-1884
2016,11,16,8,9800,10835,8863,-1972
2016,11,16,9,9810,10814,8860,-1954
2016,11,16,10,10130,10963,9147,-1816
2016,11,16,11,11190,11711,9918,-1793
2016,11,16,12,12930,12862,11138,-1724
2016,11,16,13,13920,13819,11915,-1904
2016,11,16,14,13850,14030,12173,-1857
2016,11,16,15,13710,14108,12334,-1774
2016,11,16,16,13640,14152,12277,-1875
2016,11,16,17,13540,14107,12142,-1965
2016,11,16,18,13430,14028,12168,-1860
2016,11,16,19,13490,14042,12037,-2005
2016,11,16,20,13600,14013,12216,-1797
2016,11,16,21,13930,14144,12387,-1757
2016,11,16,22,14910,14928,12931,-1997
2016,11,16,23,15900,15784,14122,-1662
2016,11,17,0,15710,15618,13612,-2006
2016,11,17,1,15200,15163,13374,-1789
2016,11,17,2,14500,14511,12790,-1721
2016,11,17,3,13530,13508,11752,-1756
2016,11,17,4,12290,12228,10279,-1949
2016,11,17,5,11210,11320,9484,-1836
2016,11,17,6,10440,11035,9161,-1874
2016,11,17,7,10020,10953,8873,-2080
2016,11,17,8,9840,10913,8734,-2179
2016,11,17,9,9860,10946,8755,-2191
2016,11,17,10,10190,11232,9311,-1921
2016,11,17,11,11270,12019,10257,-1762
2016,11,17,12,13040,13135,11702,-1433
2016,11,17,13,13920,14015,12467,-1548
2016,11,17,14,13890,14091,12562,-1529
2016,11,17,15,13700,13960,12702,-1258
2016,11,17,16,13610,13884,12698,-1186
2016,11,17,17,13510,13806,12529,-1277
2016,11,17,18,13360,13722,12428,-1294
2016,11,17,19,13430,13721,13320,-401
2016,11,17,20,13490,13686,13128,-558
2016,11,17,21,13800,13922,12963,-959
2016,11,17,22,14770,14774,12909,-1865
2016,11,17,23,15800,15703,13923,-1780
2016,11,18,0,15550,15583,13720,-1863
2016,11,18,1,15100,15179,13292,-1887
2016,11,18,2,14560,14564,12925,-1639
2016,11,18,3,13590,13604,12042,-1562
2016,11,18,4,12340,12494,10757,-1737
2016,11,18,5,11250,11817,9895,-1922
2016,11,18,6,10530,11185,9399,-1786
2016,11,18,7,10070,11182,9037,-2145
2016,11,18,8,9880,11017,8934,-2083
2016,11,18,9,9920,11011,9055,-1956
2016,11,18,10,10230,11348,9543,-1805
2016,11,18,11,11280,12344,10352,-1992
2016,11,18,12,12960,13223,11622,-1601
2016,11,18,13,13850,13980,12026,-1954
2016,11,18,14,13700,13869,12181,-1688
2016,11,18,15,13580,13592,12217,-1375
2016,11,18,16,13450,13409,12303,-1106
2016,11,18,17,13250,13247,12181,-1066
2016,11,18,18,13150,13133,11962,-1171
2016,11,18,19,13230,13258,12240,-1018
2016,11,18,20,13300,13393,12379,-1014
2016,11,18,21,13460,13699,12477,-1222
2016,11,18,22,14270,14442,12772,-1670
2016,11,18,23,15060,15222,13294,-1928
2016,11,19,0,14850,14944,12883,-2061
2016,11,19,1,14300,14458,12518,-1940
2016,11,19,2,13770,13921,12035,-1886
2016,11,19,3,13030,13184,11454,-1730
2016,11,19,4,12060,12195,10247,-1948
2016,11,19,5,11080,11228,9250,-1978
2016,11,19,6,10450,10740,8157,-2583
2016,11,19,7,9970,10515,8128,-2387
2016,11,19,8,9760,10380,8177,-2203
2016,11,19,9,9720,10573,8170,-2403
2016,11,19,10,9840,10702,8295,-2407
2016,11,19,11,10350,10976,8580,-2396
2016,11,19,12,11060,11428,9071,-2357
2016,11,19,13,11680,11955,9589,-2366
2016,11,19,14,12250,12451,9911,-2540
2016,11,19,15,12420,12585,10006,-2579
2016,11,19,16,12370,12472,9714,-2758
2016,11,19,17,12230,12290,9651,-2639
2016,11,19,18,12120,12135,9502,-2633
2016,11,19,19,12030,12068,9332,-2736
2016,11,19,20,12070,12186,9517,-2669
2016,11,19,21,12440,12544,10312,-2232
2016,11,19,22,13530,13520,11267,-2253
2016,11,19,23,14290,14383,12047,-2336
2016,11,20,0,13990,14134,11630,-2504
2016,11,20,1,13710,13658,10947,-2711
2016,11,20,2,13180,13172,10417,-2755
2016,11,20,3,12510,12510,10014,-2496
2016,11,20,4,11670,11641,9088,-2553
2016,11,20,5,10780,10964,8319,-2645
2016,11,20,6,10220,10496,7745,-2751
2016,11,20,7,9770,10243,7574,-2669
2016,11,20,8,9520,10016,7339,-2677
2016,11,20,9,9430,9935,7273,-2662
2016,11,20,10,9550,10095,7424,-2671
2016,11,20,11,9860,10588,7861,-2727
2016,11,20,12,10280,11093,8311,-2782
2016,11,20,13,11040,11475,8726,-2749
2016,11,20,14,11950,11975,9361,-2614
2016,11,20,15,12550,12594,9991,-2603
2016,11,20,16,12810,12907,10222,-2685
2016,11,20,17,12940,13074,10368,-2706
2016,11,20,18,13050,13253,10714,-2539
2016,11,20,19,13070,13425,10874,-2551
2016,11,20,20,13130,13617,10990,-2627
2016,11,20,21,13620,13986,11318,-2668
2016,11,20,22,14790,15035,12308,-2727
2016,11,20,23,15600,15755,13011,-2744
2016,11,21,0,15310,15594,12996,-2598
2016,11,21,1,14900,15165,12570,-2595
2016,11,21,2,14280,14664,12055,-2609
2016,11,21,3,13380,13731,11106,-2625
2016,11,21,4,12310,12645,9935,-2710
2016,11,21,5,11350,11687,9019,-2668
2016,11,21,6,10880,11305,8593,-2712
2016,11,21,7,10530,11205,8482,-2723
2016,11,21,8,10370,11334,8658,-2676
2016,11,21,9,10420,11436,8678,-2758
2016,11,21,10,10870,11430,8726,-2704
2016,11,21,11,12140,12232,9713,-2519
2016,11,21,12,13980,14097,11224,-2873
2016,11,21,13,15020,15099,12078,-3021
2016,11,21,14,15170,15320,12510,-2810
2016,11,21,15,15110,15295,12654,-2641
2016,11,21,16,15190,15237,12382,-2855
2016,11,21,17,15050,15183,12297,-2886
2016,11,21,18,15000,15146,12279,-2867
2016,11,21,19,14990,15286,12493,-2793
2016,11,21,20,15120,15265,12612,-2653
2016,11,21,21,15440,15572,12704,-2868
2016,11,21,22,16590,16616,13743,-2873
2016,11,21,23,17400,17473,14539,-2934
2016,11,22,0,17190,17326,14201,-3125
2016,11,22,1,16760,16894,13896,-2998
2016,11,22,2,16020,16207,13251,-2956
2016,11,22,3,15020,15128,12072,-3056
2016,11,22,4,13640,13808,10901,-2907
2016,11,22,5,12440,12598,9859,-2739
2016,11,22,6,11710,11849,8965,-2884
2016,11,22,7,11320,11421,8648,-2773
2016,11,22,8,11150,11697,8935,-2762
2016,11,22,9,11160,11791,8884,-2907
2016,11,22,10,11600,11892,9086,-2806
2016,11,22,11,12740,12802,9867,-2935
2016,11,22,12,14650,14512,11634,-2878
2016,11,22,13,15560,15399,12627,-2772
2016,11,22,14,15410,15251,12671,-2580
2016,11,22,15,15150,14945,12346,-2599
2016,11,22,16,14930,14730,12220,-2510
2016,11,22,17,14780,14553,12166,-2387
2016,11,22,18,14640,14421,11875,-2546
2016,11,22,19,14660,14530,11998,-2532
2016,11,22,20,14740,14718,12178,-2540
2016,11,22,21,15090,15151,12503,-2648
2016,11,22,22,16240,16193,13397,-2796
2016,11,22,23,17300,17139,14377,-2762
2016,11,23,0,17110,17025,14221,-2804
2016,11,23,1,16640,16688,13954,-2734
2016,11,23,2,16060,16099,13641,-2458
2016,11,23,3,15020,15117,12513,-2604
2016,11,23,4,13680,13870,11347,-2523
2016,11,23,5,12530,12698,10080,-2618
2016,11,23,6,11840,12082,9111,-2971
2016,11,23,7,11460,11773,8783,-2990
2016,11,23,8,11290,11783,8898,-2885
2016,11,23,9,11320,11942,8985,-2957
2016,11,23,10,11600,11902,9168,-2734
2016,11,23,11,12770,12693,9994,-2699
2016,11,23,12,14600,14153,11563,-2590
2016,11,23,13,15500,15085,12558,-2527
2016,11,23,14,15280,15205,12717,-2488
2016,11,23,15,15000,14988,12410,-2578
2016,11,23,16,14730,14789,12400,-2389
2016,11,23,17,14490,14586,12118,-2468
2016,11,23,18,14280,14329,11875,-2454
2016,11,23,19,14290,14367,11793,-2574
2016,11,23,20,14370,14560,12028,-2532
2016,11,23,21,14740,14875,12470,-2405
2016,11,23,22,15860,15926,13526,-2400
2016,11,23,23,16900,16768,14358,-2410
2016,11,24,0,16800,16528,13644,-2884
2016,11,24,1,16420,16056,13302,-2754
2016,11,24,2,15810,15490,12768,-2722
2016,11,24,3,14830,14656,11963,-2693
2016,11,24,4,13540,13517,10624,-2893
2016,11,24,5,12400,12384,9135,-3249
2016,11,24,6,11810,11548,8553,-2995
2016,11,24,7,11260,11299,8284,-3015
2016,11,24,8,10940,11251,8031,-3220
2016,11,24,9,10810,11302,7965,-3337
2016,11,24,10,10760,11319,8112,-3207
2016,11,24,11,11220,11397,8372,-3025
2016,11,24,12,12010,11841,9188,-2653
2016,11,24,13,12780,12701,10088,-2613
2016,11,24,14,13750,13809,11312,-2497
2016,11,24,15,14520,14634,11904,-2730
2016,11,24,16,14900,15038,12011,-3027
2016,11,24,17,15000,15100,12316,-2784
2016,11,24,18,14620,14717,11861,-2856
2016,11,24,19,13990,14036,11234,-2802
2016,11,24,20,13460,13456,11086,-2370
2016,11,24,21,13290,13374,10970,-2404
2016,11,24,22,13670,13357,10879,-2478
2016,11,24,23,14050,13372,11007,-2365
2016,11,25,0,13920,13191,11158,-2033
2016,11,25,1,13840,13053,10613,-2440
2016,11,25,2,13650,12900,10500,-2400
2016,11,25,3,13240,12513,10304,-2209
2016,11,25,4,12520,11867,10002,-1865
2016,11,25,5,11730,11159,8743,-2416
2016,11,25,6,11100,10821,8016,-2805
2016,11,25,7,10680,10685,7779,-2906
2016,11,25,8,10530,10769,7616,-3153
2016,11,25,9,10370,10788,7572,-3216
2016,11,25,10,10230,11238,8073,-3165
2016,11,25,11,10780,11336,8331,-3005
2016,11,25,12,11510,11795,8915,-2880
2016,11,25,13,12050,12536,9498,-3038
2016,11,25,14,12960,13042,10085,-2957
2016,11,25,15,13370,13578,10710,-2868
2016,11,25,16,13480,13834,10898,-2936
2016,11,25,17,13520,13912,11273,-2639
2016,11,25,18,13410,13872,11381,-2491
2016,11,25,19,13440,13793,11239,-2554
2016,11,25,20,13500,13757,11139,-2618
2016,11,25,21,13850,13879,11195,-2684
2016,11,25,22,14820,14647,11896,-2751
2016,11,25,23,15460,15075,12243,-2832
2016,11,26,0,15090,14769,11743,-3026
2016,11,26,1,14560,14311,11200,-3111
2016,11,26,2,14210,13811,10631,-3180
2016,11,26,3,13490,13117,9999,-3118
2016,11,26,4,12580,12242,9012,-3230
2016,11,26,5,11690,11428,8205,-3223
2016,11,26,6,10940,10863,7761,-3102
2016,11,26,7,10480,10661,7623,-3038
2016,11,26,8,10230,10855,7668,-3187
2016,11,26,9,10120,10901,7733,-3168
2016,11,26,10,10260,10987,7831,-3156
2016,11,26,11,10340,11374,8308,-3066
2016,11,26,12,10940,11813,8729,-3084
2016,11,26,13,11560,12323,9298,-3025
2016,11,26,14,12620,12703,9783,-2920
2016,11,26,15,13060,13107,10310,-2797
2016,11,26,16,13080,13381,10659,-2722
2016,11,26,17,12960,13306,10513,-2793
2016,11,26,18,12790,13140,10256,-2884
2016,11,26,19,12690,12981,10164,-2817
2016,11,26,20,12730,12985,10301,-2684
2016,11,26,21,13120,13212,10449,-2763
2016,11,26,22,14160,14200,11212,-2988
2016,11,26,23,15000,14906,11861,-3045
2016,11,27,0,14730,14714,11438,-3276
2016,11,27,1,14370,14329,11226,-3103
2016,11,27,2,13850,13909,10978,-2931
2016,11,27,3,13210,13306,10370,-2936
2016,11,27,4,12420,12478,9757,-2721
2016,11,27,5,11590,11622,8775,-2847
2016,11,27,6,10730,11188,7690,-3498
2016,11,27,7,10370,10934,7406,-3528
2016,11,27,8,10110,10894,7552,-3342
2016,11,27,9,10010,10894,7636,-3258
2016,11,27,10,10150,11208,7850,-3358
2016,11,27,11,10480,11337,8116,-3221
2016,11,27,12,10930,11630,8441,-3189
2016,11,27,13,11470,12192,8807,-3385
2016,11,27,14,12150,12567,8949,-3618
2016,11,27,15,12550,12993,9259,-3734
2016,11,27,16,12570,13167,9787,-3380
2016,11,27,17,12680,13205,9916,-3289
2016,11,27,18,12700,13288,9861,-3427
2016,11,27,19,12720,13408,10070,-3338
2016,11,27,20,12940,13449,10377,-3072
2016,11,27,21,13450,13937,10731,-3206
2016,11,27,22,14880,15173,11655,-3518
2016,11,27,23,15800,15963,12316,-3647
2016,11,28,0,15500,15857,12315,-3542
2016,11,28,1,15090,15396,11927,-3469
2016,11,28,2,14580,14940,11614,-3326
2016,11,28,3,13680,13978,10675,-3303
2016,11,28,4,12620,12826,9417,-3409
2016,11,28,5,11660,11838,8358,-3480
2016,11,28,6,10920,11438,8095,-3343
2016,11,28,7,10590,11281,8116,-3165
2016,11,28,8,10480,11546,8039,-3507
2016,11,28,9,10560,11759,8265,-3494
2016,11,28,10,10980,12038,8435,-3603
2016,11,28,11,12390,12904,9577,-3327
2016,11,28,12,13930,14291,11198,-3093
2016,11,28,13,14830,15273,12520,-2753
2016,11,28,14,14790,15162,12517,-2645
2016,11,28,15,14560,14794,12093,-2701
2016,11,28,16,14370,14516,12083,-2433
2016,11,28,17,14080,14291,11690,-2601
2016,11,28,18,13940,14094,11594,-2500
2016,11,28,19,13960,14125,11498,-2627
2016,11,28,20,14070,14278,11547,-2731
2016,11,28,21,14470,14710,11788,-2922
2016,11,28,22,15790,15943,12950,-2993
2016,11,28,23,16750,17082,14032,-3050
2016,11,29,0,16510,17093,13859,-3234
2016,11,29,1,16150,16719,13587,-3132
2016,11,29,2,15510,16060,12762,-3298
2016,11,29,3,14480,15009,11520,-3489
2016,11,29,4,13110,13671,10198,-3473
2016,11,29,5,12000,12438,9068,-3370
2016,11,29,6,11390,11897,8284,-3613
2016,11,29,7,10990,11717,8007,-3710
2016,11,29,8,10770,11799,8081,-3718
2016,11,29,9,10710,11753,7981,-3772
2016,11,29,10,11050,12181,8319,-3862
2016,11,29,11,12270,12495,8817,-3678
2016,11,29,12,14080,14093,10704,-3389
2016,11,29,13,15070,15141,11707,-3434
2016,11,29,14,15150,15360,11933,-3427
2016,11,29,15,15010,15529,11955,-3574
2016,11,29,16,15020,15785,12293,-3492
2016,11,29,17,14950,15846,12456,-3390
2016,11,29,18,14900,15766,12504,-3262
2016,11,29,19,15010,15739,12401,-3338
2016,11,29,20,15060,15680,12383,-3297
2016,11,29,21,15390,15844,12691,-3153
2016,11,29,22,16500,16531,13217,-3314
2016,11,29,23,16800,16947,13824,-3123
2016,11,30,0,16450,16732,13228,-3504
2016,11,30,1,15930,16181,12541,-3640
2016,11,30,2,15170,15386,11807,-3579
2016,11,30,3,14030,14192,11147,-3045
2016,11,30,4,12690,13081,10166,-2915
2016,11,30,5,11510,12326,9422,-2904
2016,11,30,6,10930,11908,8748,-3160
2016,11,30,7,10440,11548,8284,-3264
2016,11,30,8,10250,11320,8370,-2950
2016,11,30,9,10180,11292,8819,-2473
2016,11,30,10,10520,11614,8797,-2817
2016,11,30,11,11480,12411,9555,-2856
2016,11,30,12,13350,13313,10714,-2599
2016,11,30,13,14410,14241,11529,-2712
2016,11,30,14,14650,14453,11746,-2707
2016,11,30,15,14680,14518,11607,-2911
2016,11,30,16,14650,14667,11877,-2790
2016,11,30,17,14630,14788,12059,-2729
2016,11,30,18,14500,14784,11978,-2806
2016,11,30,19,14610,14855,12135,-2720
2016,11,30,20,14710,14882,12063,-2819
2016,11,30,21,15050,15152,12240,-2912
2016,11,30,22,16090,16010,12796,-3214
2016,11,30,23,16580,16526,13362,-3164
2016,12,1,0,16240,16342,12960,-3382
2016,12,1,1,15890,15877,12660,-3217
2016,12,1,2,15130,15227,12545,-2682
2016,12,1,3,14000,14195,11501,-2694
2016,12,1,4,12610,13164,10357,-2807
2016,12,1,5,11330,12508,9638,-2870
2016,12,1,6,10710,11646,8638,-3008
2016,12,1,7,10240,11494,8463,-3031
2016,12,1,8,10020,11216,8515,-2701
2016,12,1,9,10040,11329,8686,-2643
2016,12,1,10,10330,11599,8913,-2686
2016,12,1,11,11410,12138,9264,-2874
2016,12,1,12,13250,13127,10237,-2890
2016,12,1,13,14350,14013,10898,-3115
2016,12,1,14,14320,13961,10924,-3037
2016,12,1,15,14190,13696,10649,-3047
2016,12,1,16,14040,13641,10746,-2895
2016,12,1,17,13900,13639,10730,-2909
2016,12,1,18,13700,13613,11056,-2557
2016,12,1,19,13740,13774,11366,-2408
2016,12,1,20,13850,13982,11482,-2500
2016,12,1,21,14190,14357,12141,-2216
2016,12,1,22,15400,15397,12466,-2931
2016,12,1,23,16450,16151,13201,-2950
2016,12,2,0,16400,16060,13244,-2816
2016,12,2,1,16030,15692,12809,-2883
2016,12,2,2,15470,15148,12252,-2896
2016,12,2,3,14480,14235,11673,-2562
2016,12,2,4,13170,12948,10449,-2499
2016,12,2,5,11910,11898,9658,-2240
2016,12,2,6,10970,11714,9235,-2479
2016,12,2,7,10500,11387,8764,-2623
2016,12,2,8,10320,11178,8689,-2489
2016,12,2,9,10330,11437,8893,-2544
2016,12,2,10,10650,11591,9015,-2576
2016,12,2,11,11710,12278,9654,-2624
2016,12,2,12,13480,13642,11228,-2414
2016,12,2,13,14370,14567,12095,-2472
2016,12,2,14,14380,14539,11920,-2619
2016,12,2,15,14230,14239,11583,-2656
2016,12,2,16,14100,13998,11398,-2600
2016,12,2,17,14020,13871,11351,-2520
2016,12,2,18,13890,13884,11275,-2609
2016,12,2,19,13900,14098,11537,-2561
2016,12,2,20,13960,14144,11699,-2445
2016,12,2,21,14240,14365,11652,-2713
2016,12,2,22,15340,15351,12470,-2881
2016,12,2,23,16250,16069,13147,-2922
2016,12,3,0,15980,15863,12986,-2877
2016,12,3,1,15460,15423,12655,-2768
2016,12,3,2,14960,14913,12512,-2401
2016,12,3,3,14240,14171,11886,-2285
2016,12,3,4,13180,13137,10488,-2649
2016,12,3,5,12040,12022,9512,-2510
2016,12,3,6,11190,11305,8923,-2382
2016,12,3,7,10720,11272,8873,-2399
2016,12,3,8,10480,11221,8767,-2454
2016,12,3,9,10440,11422,8805,-2617
2016,12,3,10,10580,11541,8971,-2570
2016,12,3,11,11060,11756,9333,-2423
2016,12,3,12,11870,12005,9704,-2301
2016,12,3,13,12520,12483,10166,-2317
2016,12,3,14,13090,13086,10638,-2448
2016,12,3,15,13350,13267,10621,-2646
2016,12,3,16,13360,13317,10944,-2373
2016,12,3,17,13270,13402,11080,-2322
2016,12,3,18,13140,13361,10956,-2405
2016,12,3,19,13020,13338,10881,-2457
2016,12,3,20,13150,13426,10961,-2465
2016,12,3,21,13570,13729,11251,-2478
2016,12,3,22,14740,14825,12005,-2820
2016,12,3,23,15700,15646,12808,-2838
2016,12,4,0,15590,15481,12872,-2609
2016,12,4,1,15130,15086,12221,-2865
2016,12,4,2,14730,14650,12099,-2551
2016,12,4,3,14100,14025,11628,-2397
2016,12,4,4,13230,13148,10470,-2678
2016,12,4,5,12210,12219,9474,-2745
2016,12,4,6,11350,11953,9512,-2441
2016,12,4,7,10930,11761,9786,-1975
2016,12,4,8,10690,11754,9658,-2096
2016,12,4,9,10640,11653,9444,-2209
2016,12,4,10,10730,11724,9429,-2295
2016,12,4,11,11020,12043,9658,-2385
2016,12,4,12,11530,12561,10047,-2514
2016,12,4,13,12120,13016,10569,-2447
2016,12,4,14,12630,13524,11041,-2483
2016,12,4,15,12990,13500,11064,-2436
2016,12,4,16,13040,13418,10838,-2580
2016,12,4,17,13050,13241,10631,-2610
2016,12,4,18,13050,13088,10547,-2541
2016,12,4,19,13040,13283,10796,-2487
2016,12,4,20,13070,13506,10944,-2562
2016,12,4,21,13600,13812,11387,-2425
2016,12,4,22,15150,15357,12677,-2680
2016,12,4,23,16300,16480,13722,-2758
2016,12,5,0,16280,16498,13674,-2824
2016,12,5,1,15920,16175,13342,-2833
2016,12,5,2,15460,15646,12708,-2938
2016,12,5,3,14560,14681,11981,-2700
2016,12,5,4,13420,13449,10644,-2805
2016,12,5,5,12390,12624,9658,-2966
2016,12,5,6,11620,12679,9402,-3277
2016,12,5,7,11250,12547,9095,-3452
2016,12,5,8,11110,12397,9004,-3393
2016,12,5,9,11180,12439,9017,-3422
2016,12,5,10,11600,12812,9478,-3334
2016,12,5,11,12710,13511,10286,-3225
2016,12,5,12,14770,14639,11684,-2955
2016,12,5,13,15980,15823,12723,-3100
2016,12,5,14,16070,16162,12926,-3236
2016,12,5,15,15970,16364,13147,-3217
2016,12,5,16,15830,16496,13384,-3112
2016,12,5,17,15770,16457,13244,-3213
2016,12,5,18,15650,16240,13062,-3178
2016,12,5,19,15620,16015,12752,-3263
2016,12,5,20,15690,15707,12492,-3215
2016,12,5,21,15830,15731,12534,-3197
2016,12,5,22,17040,16826,13789,-3037
2016,12,5,23,17950,17844,14822,-3022
2016,12,6,0,17660,17731,14493,-3238
2016,12,6,1,17250,17248,14060,-3188
2016,12,6,2,16600,16568,13647,-2921
2016,12,6,3,15480,15465,12717,-2748
2016,12,6,4,14040,14006,11418,-2588
2016,12,6,5,12730,13056,10298,-2758
2016,12,6,6,11990,12952,9812,-3140
2016,12,6,7,11410,12729,9515,-3214
2016,12,6,8,11180,12539,9610,-2929
2016,12,6,9,11170,12552,9714,-2838
2016,12,6,10,11560,12939,10039,-2900
2016,12,6,11,12740,13659,10635,-3024
2016,12,6,12,14650,14761,11746,-3015
2016,12,6,13,15620,15651,12430,-3221
2016,12,6,14,15560,15519,11837,-3682
2016,12,6,15,15440,15132,11476,-3656
2016,12,6,16,14980,14812,11224,-3588
2016,12,6,17,14840,14602,10947,-3655
2016,12,6,18,14770,14442,10841,-3601
2016,12,6,19,14760,14629,11104,-3525
2016,12,6,20,15110,14867,11609,-3258
2016,12,6,21,15650,15218,12148,-3070
2016,12,6,22,16840,16490,13220,-3270
2016,12,6,23,17600,17405,14198,-3207
2016,12,7,0,17410,17309,14113,-3196
2016,12,7,1,17040,16887,13651,-3236
2016,12,7,2,16400,16226,12827,-3399
2016,12,7,3,15320,15153,11881,-3272
2016,12,7,4,13890,13715,10375,-3340
2016,12,7,5,12620,12792,9488,-3304
2016,12,7,6,11820,12750,9214,-3536
2016,12,7,7,11340,12472,8857,-3615
2016,12,7,8,11090,12277,8531,-3746
2016,12,7,9,11060,12257,8662,-3595
2016,12,7,10,11360,12592,9093,-3499
2016,12,7,11,12390,13195,9972,-3223
2016,12,7,12,14200,14246,11146,-3100
2016,12,7,13,15240,15307,12193,-3114
2016,12,7,14,15370,15508,12263,-3245
2016,12,7,15,15350,15538,12441,-3097
2016,12,7,16,15330,15535,12787,-2748
2016,12,7,17,15250,15379,12601,-2778
2016,12,7,18,15110,15260,12422,-2838
2016,12,7,19,15130,15281,12418,-2863
2016,12,7,20,15140,15394,12535,-2859
2016,12,7,21,15460,15603,12716,-2887
2016,12,7,22,16640,16498,13292,-3206
2016,12,7,23,17400,17301,14080,-3221
2016,12,8,0,17210,17155,13818,-3337
2016,12,8,1,16800,16745,13614,-3131
2016,12,8,2,16140,16101,13411,-2690
2016,12,8,3,15120,15072,12337,-2735
2016,12,8,4,13740,13785,11065,-2720
2016,12,8,5,12500,13101,9859,-3242
2016,12,8,6,11710,12514,9267,-3247
2016,12,8,7,11280,12394,9299,-3095
2016,12,8,8,11120,12243,9425,-2818
2016,12,8,9,11130,12250,9200,-3050
2016,12,8,10,11340,12340,9265,-3075
2016,12,8,11,12410,13226,10102,-3124
2016,12,8,12,14340,14347,11923,-2424
2016,12,8,13,15260,15361,12898,-2463
2016,12,8,14,15320,15456,13230,-2226
2016,12,8,15,15190,15415,13226,-2189
2016,12,8,16,15060,15324,13105,-2219
2016,12,8,17,14920,15285,12783,-2502
2016,12,8,18,14710,15111,12600,-2511
2016,12,8,19,14740,15082,12646,-2436
2016,12,8,20,14760,15056,12770,-2286
2016,12,8,21,15180,15275,13064,-2211
2016,12,8,22,16530,16453,14462,-1991
2016,12,8,23,17400,17408,15268,-2140
2016,12,9,0,17330,17348,14917,-2431
2016,12,9,1,16930,17021,14729,-2292
2016,12,9,2,16370,16492,14277,-2215
2016,12,9,3,15420,15551,13233,-2318
2016,12,9,4,14120,14190,12179,-2011
2016,12,9,5,12880,13366,11290,-2076
2016,12,9,6,12040,13098,10687,-2411
2016,12,9,7,11540,13033,10585,-2448
2016,12,9,8,11330,12872,10532,-2340
2016,12,9,9,11390,12893,10505,-2388
2016,12,9,10,11920,13197,10824,-2373
2016,12,9,11,13030,13837,11143,-2694
2016,12,9,12,14930,14913,12347,-2566
2016,12,9,13,15890,15891,13139,-2752
2016,12,9,14,15970,15867,12993,-2874
2016,12,9,15,15860,15589,12794,-2795
2016,12,9,16,15660,15380,12581,-2799
2016,12,9,17,15510,15225,12344,-2881
2016,12,9,18,15360,15073,12141,-2932
2016,12,9,19,15370,15141,12155,-2986
2016,12,9,20,15390,15333,12263,-3070
2016,12,9,21,15730,15768,12699,-3069
2016,12,9,22,16960,17020,13604,-3416
2016,12,9,23,17780,17926,14428,-3498
2016,12,10,0,17580,17745,14003,-3742
2016,12,10,1,17090,17331,13774,-3557
2016,12,10,2,16580,16814,13344,-3470
2016,12,10,3,15800,16055,12667,-3388
2016,12,10,4,14720,14939,11842,-3097
2016,12,10,5,13560,13768,10751,-3017
2016,12,10,6,12800,13251,9888,-3363
2016,12,10,7,12320,13344,9867,-3477
2016,12,10,8,12120,13298,9921,-3377
2016,12,10,9,12080,13234,9921,-3313
2016,12,10,10,12250,13235,9914,-3321
2016,12,10,11,12790,13501,10235,-3266
2016,12,10,12,13710,13858,10576,-3282
2016,12,10,13,14450,14470,11293,-3177
2016,12,10,14,14890,15123,11576,-3547
2016,12,10,15,15050,15350,11844,-3506
2016,12,10,16,15020,15152,11445,-3707
2016,12,10,17,14860,14858,11254,-3604
2016,12,10,18,14720,14710,11357,-3353
2016,12,10,19,14570,14931,11394,-3537
2016,12,10,20,14600,15143,11397,-3746
2016,12,10,21,15190,15621,11690,-3931
2016,12,10,22,16410,16616,12600,-4016
2016,12,10,23,17200,17512,13451,-4061
2016,12,11,0,17160,17341,13262,-4079
2016,12,11,1,16740,16940,12841,-4099
2016,12,11,2,16250,16504,12474,-4030
2016,12,11,3,15580,15904,12222,-3682
2016,12,11,4,14620,15002,11444,-3558
2016,12,11,5,13620,14003,10354,-3649
2016,12,11,6,12820,13444,9837,-3607
2016,12,11,7,12320,13265,9684,-3581
2016,12,11,8,12090,13057,9650,-3407
2016,12,11,9,12010,13007,9567,-3440
2016,12,11,10,12110,13352,9782,-3570
2016,12,11,11,12910,13688,9894,-3794
2016,12,11,12,13480,13947,9966,-3981
2016,12,11,13,13970,14314,10230,-4084
2016,12,11,14,14630,14815,10795,-4020
2016,12,11,15,14850,14936,10920,-4016
2016,12,11,16,14990,14855,10882,-3973
2016,12,11,17,14930,14650,10730,-3920
2016,12,11,18,14870,14628,10730,-3898
2016,12,11,19,14890,14800,10757,-4043
2016,12,11,20,15000,15038,11077,-3961
2016,12,11,21,15460,15501,11576,-3925
2016,12,11,22,16920,16892,13021,-3871
2016,12,11,23,17770,17778,13885,-3893
2016,12,12,0,17580,17663,13767,-3896
2016,12,12,1,17070,17251,13332,-3919
2016,12,12,2,16530,16646,12716,-3930
2016,12,12,3,15490,15595,12207,-3388
2016,12,12,4,14250,14275,11035,-3240
2016,12,12,5,13130,13200,9943,-3257
2016,12,12,6,12470,13047,9867,-3180
2016,12,12,7,11990,12834,9884,-2950
2016,12,12,8,11770,12762,9868,-2894
2016,12,12,9,11740,12816,10076,-2740
2016,12,12,10,12070,13146,10357,-2789
2016,12,12,11,13030,13569,10841,-2728
2016,12,12,12,14930,14680,11812,-2868
2016,12,12,13,16070,15843,12939,-2904
2016,12,12,14,16350,16421,13606,-2815
2016,12,12,15,16320,16640,13685,-2955
2016,12,12,16,16340,16663,13536,-3127
2016,12,12,17,16250,16537,13417,-3120
2016,12,12,18,15940,16278,13222,-3056
2016,12,12,19,15860,16153,13203,-2950
2016,12,12,20,15750,16030,12923,-3107
2016,12,12,21,16060,16026,12858,-3168
2016,12,12,22,17330,17069,13827,-3242
2016,12,12,23,18300,18150,14800,-3350
2016,12,13,0,17950,18051,14496,-3555
2016,12,13,1,17500,17606,13874,-3732
2016,12,13,2,16790,16914,13448,-3466
2016,12,13,3,15720,15808,12492,-3316
2016,12,13,4,14300,14422,11072,-3350
2016,12,13,5,12970,13651,10295,-3356
2016,12,13,6,12100,13128,9768,-3360
2016,12,13,7,11680,12989,9606,-3383
2016,12,13,8,11530,12833,9512,-3321
2016,12,13,9,11570,12842,9502,-3340
2016,12,13,10,11970,13238,9967,-3271
2016,12,13,11,13070,13681,10477,-3204
2016,12,13,12,15020,15076,11616,-3460
2016,12,13,13,15980,15932,12451,-3481
2016,12,13,14,15830,15862,12515,-3347
2016,12,13,15,15600,15435,12196,-3239
2016,12,13,16,15210,15101,12046,-3055
2016,12,13,17,15030,14833,11731,-3102
2016,12,13,18,14890,14663,11753,-2910
2016,12,13,19,14990,14846,11971,-2875
2016,12,13,20,15180,15105,12269,-2836
2016,12,13,21,15680,15554,12500,-3054
2016,12,13,22,17070,16907,13768,-3139
2016,12,13,23,17940,17854,14641,-3213
2016,12,14,0,17810,17771,14319,-3452
2016,12,14,1,17430,17378,13812,-3566
2016,12,14,2,16770,16751,13241,-3510
2016,12,14,3,15670,15673,12625,-3048
2016,12,14,4,14210,14218,11214,-3004
2016,12,14,5,12920,13340,10211,-3129
2016,12,14,6,12060,13106,10114,-2992
2016,12,14,7,11580,12788,9740,-3048
2016,12,14,8,11410,12372,9366,-3006
2016,12,14,9,11420,12278,9224,-3054
2016,12,14,10,11810,12409,9333,-3076
2016,12,14,11,12770,13456,10505,-2951
2016,12,14,12,14590,14674,11617,-3057
2016,12,14,13,15590,15717,12626,-3091
2016,12,14,14,15510,15639,12465,-3174
2016,12,14,15,15330,15275,11929,-3346
2016,12,14,16,15090,14890,11617,-3273
2016,12,14,17,14910,14568,11524,-3044
2016,12,14,18,14780,14514,11715,-2799
2016,12,14,19,14730,14665,11849,-2816
2016,12,14,20,14830,14856,12032,-2824
2016,12,14,21,15250,15368,12584,-2784
2016,12,14,22,16720,16898,13551,-3347
2016,12,14,23,18020,18067,14534,-3533
2016,12,15,0,17930,18128,14465,-3663
2016,12,15,1,17520,17854,13994,-3860
2016,12,15,2,17100,17342,13517,-3825
2016,12,15,3,16020,16736,12995,-3741
2016,12,15,4,14670,15648,12204,-3444
2016,12,15,5,13440,14041,10376,-3665
2016,12,15,6,12660,13356,9528,-3828
2016,12,15,7,12210,13163,9682,-3481
2016,12,15,8,12010,13106,9522,-3584
2016,12,15,9,12070,13090,9516,-3574
2016,12,15,10,12420,12953,9515,-3438
2016,12,15,11,13560,13773,10101,-3672
2016,12,15,12,15520,15734,12167,-3567
2016,12,15,13,16570,16662,13184,-3478
2016,12,15,14,16710,16653,13302,-3351
2016,12,15,15,16670,16427,12912,-3515
2016,12,15,16,16430,16216,12828,-3388
2016,12,15,17,16400,16159,12938,-3221
2016,12,15,18,16440,16283,13287,-2996
2016,12,15,19,16490,16640,13517,-3123
2016,12,15,20,16500,16837,13971,-2866
2016,12,15,21,16910,17295,14343,-2952
2016,12,15,22,18410,18646,15623,-3023
2016,12,15,23,19500,19646,16589,-3057
2016,12,16,0,19410,19624,16485,-3139
2016,12,16,1,19060,19372,16016,-3356
2016,12,16,2,18510,18941,15911,-3030
2016,12,16,3,17490,18094,15377,-2717
2016,12,16,4,16080,16740,13429,-3311
2016,12,16,5,14890,15591,12128,-3463
2016,12,16,6,14450,14688,11182,-3506
2016,12,16,7,14040,14196,10967,-3229
2016,12,16,8,13840,14094,10868,-3226
2016,12,16,9,13890,14144,10884,-3260
2016,12,16,10,14300,14542,11337,-3205
2016,12,16,11,15580,15556,12604,-2952
2016,12,16,12,17570,17378,15225,-2153
2016,12,16,13,18590,18475,16472,-2003
2016,12,16,14,18660,18585,16276,-2309
2016,12,16,15,18440,18206,15743,-2463
2016,12,16,16,18310,17890,15351,-2539
2016,12,16,17,18030,17554,14840,-2714
2016,12,16,18,17680,17248,14389,-2859
2016,12,16,19,17630,17227,14389,-2838
2016,12,16,20,17420,17356,14462,-2894
2016,12,16,21,17690,17746,14716,-3030
2016,12,16,22,19230,18911,16183,-2728
2016,12,16,23,20110,19686,17108,-2578
2016,12,17,0,19850,19488,16925,-2563
2016,12,17,1,19300,19060,16246,-2814
2016,12,17,2,18730,18509,15336,-3173
2016,12,17,3,17800,17736,14619,-3117
2016,12,17,4,16470,16589,13685,-2904
2016,12,17,5,15130,15255,12613,-2642
2016,12,17,6,14080,14274,11158,-3116
2016,12,17,7,13440,13685,10485,-3200
2016,12,17,8,13020,13596,10525,-3071
2016,12,17,9,12830,13494,10404,-3090
2016,12,17,10,13290,13589,10463,-3126
2016,12,17,11,13640,13944,10712,-3232
2016,12,17,12,14300,14402,11102,-3300
2016,12,17,13,15000,15211,12041,-3170
2016,12,17,14,15960,16184,12864,-3320
2016,12,17,15,16370,17019,13915,-3104
2016,12,17,16,16600,17445,14461,-2984
2016,12,17,17,16490,17535,14451,-3084
2016,12,17,18,16290,17395,14261,-3134
2016,12,17,19,16150,17057,13909,-3148
2016,12,17,20,16020,16723,13924,-2799
2016,12,17,21,16350,16575,13743,-2832
2016,12,17,22,17230,17428,14355,-3073
2016,12,17,23,17710,18075,14788,-3287
2016,12,18,0,17430,17701,14201,-3500
2016,12,18,1,16830,17117,13689,-3428
2016,12,18,2,16270,16490,13545,-2945
2016,12,18,3,15440,15715,12975,-2740
2016,12,18,4,14430,14675,11969,-2706
2016,12,18,5,13360,13538,10763,-2775
2016,12,18,6,12520,13311,10133,-3178
2016,12,18,7,11840,13013,9650,-3363
2016,12,18,8,11440,12916,9577,-3339
2016,12,18,9,11270,12728,9418,-3310
2016,12,18,10,11390,12725,9344,-3381
2016,12,18,11,11580,12948,9578,-3370
2016,12,18,12,12040,13196,9949,-3247
2016,12,18,13,12800,13671,10137,-3534
2016,12,18,14,13630,14445,10900,-3545
2016,12,18,15,14260,14709,11196,-3513
2016,12,18,16,14420,14753,11288,-3465
2016,12,18,17,14460,14907,11632,-3275
2016,12,18,18,14600,14862,11449,-3413
2016,12,18,19,14810,14658,11237,-3421
2016,12,18,20,14970,14664,11311,-3353
2016,12,18,21,15170,15100,11903,-3197
2016,12,18,22,16470,16236,12944,-3292
2016,12,18,23,17500,16877,13469,-3408
2016,12,19,0,17300,16844,13525,-3319
2016,12,19,1,16950,16582,13162,-3420
2016,12,19,2,16430,16197,12691,-3506
2016,12,19,3,15560,15347,12108,-3239
2016,12,19,4,14310,14253,10631,-3622
2016,12,19,5,13210,13559,9793,-3766
2016,12,19,6,12550,13108,9429,-3679
2016,12,19,7,12300,13251,9582,-3669
2016,12,19,8,12200,13268,9550,-3718
2016,12,19,9,12270,13376,9545,-3831
2016,12,19,10,12530,13563,9793,-3770
2016,12,19,11,13720,14101,10495,-3606
2016,12,19,12,15680,15683,12283,-3400
2016,12,19,13,16720,16987,14044,-2943
2016,12,19,14,16980,17300,14390,-2910
2016,12,19,15,16620,17163,13964,-3199
2016,12,19,16,16320,16604,13451,-3153
2016,12,19,17,16130,16195,12968,-3227
2016,12,19,18,15980,16100,12757,-3343
2016,12,19,19,16210,16319,12919,-3400
2016,12,19,20,16350,16480,13123,-3357
2016,12,19,21,16880,16947,13917,-3030
2016,12,19,22,18240,18290,15657,-2633
2016,12,19,23,19400,19405,16349,-3056
2016,12,20,0,19280,19437,16215,-3222
2016,12,20,1,18890,19154,15940,-3214
2016,12,20,2,18260,18596,15354,-3242
2016,12,20,3,17120,17609,14491,-3118
2016,12,20,4,15700,16198,13069,-3129
2016,12,20,5,14470,14856,11584,-3272
2016,12,20,6,13600,13952,10447,-3505
2016,12,20,7,13200,13742,10498,-3244
2016,12,20,8,13000,14096,10835,-3261
2016,12,20,9,13030,14181,10918,-3263
2016,12,20,10,13400,14578,11466,-3112
2016,12,20,11,14890,15462,12433,-3029
2016,12,20,12,16920,16831,14120,-2711
2016,12,20,13,17530,17909,15086,-2823
2016,12,20,14,17340,17873,15310,-2563
2016,12,20,15,16890,17386,14642,-2744
2016,12,20,16,16600,16913,14335,-2578
2016,12,20,17,16280,16555,13895,-2660
2016,12,20,18,16010,16304,13593,-2711
2016,12,20,19,15970,16245,13471,-2774
2016,12,20,20,15880,16330,13601,-2729
2016,12,20,21,16350,16710,14069,-2641
2016,12,20,22,17910,17907,15140,-2767
2016,12,20,23,19000,18946,16105,-2841
2016,12,21,0,18960,18883,16133,-2750
2016,12,21,1,18620,18509,15548,-2961
2016,12,21,2,17890,17928,14873,-3055
2016,12,21,3,16750,16929,13648,-3281
2016,12,21,4,15370,15594,12353,-3241
2016,12,21,5,13960,14336,11162,-3174
2016,12,21,6,13110,13288,10114,-3174
2016,12,21,7,12640,13113,10027,-3086
2016,12,21,8,12470,13066,10002,-3064
2016,12,21,9,12480,13167,9965,-3202
2016,12,21,10,12790,13299,10321,-2978
2016,12,21,11,13910,14205,11232,-2973
2016,12,21,12,15710,15746,13028,-2718
2016,12,21,13,16710,16819,14338,-2481
2016,12,21,14,16580,16817,14430,-2387
2016,12,21,15,16270,16309,13823,-2486
2016,12,21,16,15910,15760,13260,-2500
2016,12,21,17,15640,15417,12888,-2529
2016,12,21,18,15370,15255,12869,-2386
2016,12,21,19,15400,15505,13047,-2458
2016,12,21,20,15410,15622,13218,-2404
2016,12,21,21,15880,16018,13359,-2659
2016,12,21,22,17280,17241,14436,-2805
2016,12,21,23,18350,18218,15286,-2932
2016,12,22,0,18200,18173,14937,-3236
2016,12,22,1,17810,17846,14539,-3307
2016,12,22,2,17300,17332,13935,-3397
2016,12,22,3,16240,16391,13029,-3362
2016,12,22,4,14800,15027,11684,-3343
2016,12,22,5,13480,13631,10615,-3016
2016,12,22,6,12520,12924,9344,-3580
2016,12,22,7,12030,12742,9226,-3516
2016,12,22,8,11830,12568,8999,-3569
2016,12,22,9,11790,12742,9157,-3585
2016,12,22,10,12140,12931,9427,-3504
2016,12,22,11,13320,13557,10014,-3543
2016,12,22,12,14990,15028,11597,-3431
2016,12,22,13,16020,16218,13091,-3127
2016,12,22,14,16140,16567,13440,-3127
2016,12,22,15,16030,16704,13578,-3126
2016,12,22,16,15960,16739,13659,-3080
2016,12,22,17,15690,16616,13626,-2990
2016,12,22,18,15570,16242,13300,-2942
2016,12,22,19,15490,15954,12916,-3038
2016,12,22,20,15470,15688,12458,-3230
2016,12,22,21,15780,15772,12557,-3215
2016,12,22,22,17030,16855,13288,-3567
2016,12,22,23,17850,17820,14211,-3609
2016,12,23,0,17780,17754,14036,-3718
2016,12,23,1,17420,17413,13640,-3773
2016,12,23,2,16840,16887,12834,-4053
2016,12,23,3,15850,16032,11859,-4173
2016,12,23,4,14470,14752,10820,-3932
2016,12,23,5,13200,13454,9824,-3630
2016,12,23,6,12110,12839,9023,-3816
2016,12,23,7,11630,12662,8804,-3858
2016,12,23,8,11480,12558,8707,-3851
2016,12,23,9,11490,12871,8956,-3915
2016,12,23,10,11870,13139,9278,-3861
2016,12,23,11,12880,13663,9934,-3729
2016,12,23,12,14600,14303,10679,-3624
2016,12,23,13,15520,15228,11511,-3717
2016,12,23,14,15450,15453,11900,-3553
2016,12,23,15,15280,15193,11623,-3570
2016,12,23,16,15030,14905,11226,-3679
2016,12,23,17,14760,14692,11180,-3512
2016,12,23,18,14570,14736,11331,-3405
2016,12,23,19,14490,14534,11257,-3277
2016,12,23,20,14580,14581,11215,-3366
2016,12,23,21,14950,14792,11464,-3328
2016,12,23,22,16230,15928,12507,-3421
2016,12,23,23,17000,16968,13341,-3627
2016,12,24,0,16800,16811,13087,-3724
2016,12,24,1,16470,16441,12808,-3633
2016,12,24,2,16070,15955,12479,-3476
2016,12,24,3,15290,15272,11611,-3661
2016,12,24,4,14210,14237,10770,-3467
2016,12,24,5,13070,13205,9790,-3415
2016,12,24,6,11840,12391,8879,-3512
2016,12,24,7,11200,12229,8681,-3548
2016,12,24,8,10830,12184,8734,-3450
2016,12,24,9,10660,12048,8683,-3365
2016,12,24,10,10720,12076,8686,-3390
2016,12,24,11,11490,12193,8821,-3372
2016,12,24,12,12250,12310,9035,-3275
2016,12,24,13,13240,12932,9599,-3333
2016,12,24,14,14040,14015,10622,-3393
2016,12,24,15,14510,14900,11608,-3292
2016,12,24,16,14740,15443,12101,-3342
2016,12,24,17,14690,15764,12296,-3468
2016,12,24,18,14570,15790,12345,-3445
2016,12,24,19,14490,15480,12006,-3474
2016,12,24,20,14410,14934,11372,-3562
2016,12,24,21,14660,14710,11148,-3562
2016,12,24,22,15600,15372,11727,-3645
2016,12,24,23,16090,15875,12318,-3557
2016,12,25,0,15490,15351,11652,-3699
2016,12,25,1,14950,14785,11075,-3710
2016,12,25,2,14480,14407,10624,-3783
2016,12,25,3,13920,14065,10362,-3703
2016,12,25,4,13170,13478,10012,-3466
2016,12,25,5,12220,12829,9427,-3402
2016,12,25,6,12020,12121,9414,-2707
2016,12,25,7,11350,11785,9222,-2563
2016,12,25,8,10980,11720,9061,-2659
2016,12,25,9,10860,11866,9153,-2713
2016,12,25,10,10910,11924,9110,-2814
2016,12,25,11,11180,11943,9236,-2707
2016,12,25,12,11730,12221,9418,-2803
2016,12,25,13,12590,12461,9724,-2737
2016,12,25,14,13470,13011,10389,-2622
2016,12,25,15,13930,13067,10373,-2694
2016,12,25,16,14080,12888,9914,-2974
2016,12,25,17,14000,12747,9716,-3031
2016,12,25,18,13810,12632,9509,-3123
2016,12,25,19,13660,12478,9542,-2936
2016,12,25,20,13280,12516,9580,-2936
2016,12,25,21,13370,12845,9820,-3025
2016,12,25,22,14480,13751,10455,-3296
2016,12,25,23,15310,14538,10976,-3562
2016,12,26,0,15040,14587,10974,-3613
2016,12,26,1,15000,14571,10960,-3611
2016,12,26,2,14870,14510,10905,-3605
2016,12,26,3,14370,14184,10846,-3338
2016,12,26,4,13580,13541,10408,-3133
2016,12,26,5,12620,12714,9923,-2791
2016,12,26,6,11900,12136,9327,-2809
2016,12,26,7,11340,12099,9140,-2959
2016,12,26,8,11070,12375,9213,-3162
2016,12,26,9,10970,12659,9554,-3105
2016,12,26,10,11110,12746,9701,-3045
2016,12,26,11,12660,13142,9962,-3180
2016,12,26,12,14100,13208,10210,-2998
2016,12,26,13,15000,13694,10883,-2811
2016,12,26,14,15460,14186,11358,-2828
2016,12,26,15,15700,14386,11633,-2753
2016,12,26,16,15710,14424,11824,-2600
2016,12,26,17,15810,14448,11888,-2560
2016,12,26,18,15810,14511,12008,-2503
2016,12,26,19,15850,14588,12106,-2482
2016,12,26,20,15810,14854,12220,-2634
2016,12,26,21,16110,15221,12439,-2782
2016,12,26,22,17290,16310,13165,-3145
2016,12,26,23,17870,17019,13770,-3249
2016,12,27,0,17590,16766,13475,-3291
2016,12,27,1,16990,16284,13113,-3171
2016,12,27,2,16330,15673,12365,-3308
2016,12,27,3,15310,14782,11369,-3413
2016,12,27,4,13910,13545,10284,-3261
2016,12,27,5,12660,12362,9255,-3107
2016,12,27,6,11260,11987,8885,-3102
2016,12,27,7,10700,11768,8704,-3064
2016,12,27,8,10420,11871,8857,-3014
2016,12,27,9,10350,11818,9195,-2623
2016,12,27,10,10670,12013,9131,-2882
2016,12,27,11,11440,12590,9540,-3050
2016,12,27,12,12810,12631,10094,-2537
2016,12,27,13,13890,13507,10744,-2763
2016,12,27,14,14350,14160,11167,-2993
2016,12,27,15,14500,14596,11568,-3028
2016,12,27,16,14560,14793,11940,-2853
2016,12,27,17,14550,14697,12006,-2691
2016,12,27,18,14460,14391,11559,-2832
2016,12,27,19,14530,14244,11210,-3034
2016,12,27,20,14530,14178,11102,-3076
2016,12,27,21,14780,14413,11273,-3140
2016,12,27,22,16000,15411,12140,-3271
2016,12,27,23,17000,16529,13203,-3326
2016,12,28,0,16700,16422,12948,-3474
2016,12,28,1,16110,15996,12531,-3465
2016,12,28,2,15630,15467,12043,-3424
2016,12,28,3,14780,14619,11223,-3396
2016,12,28,4,13530,13448,10158,-3290
2016,12,28,5,12390,12786,9596,-3190
2016,12,28,6,11630,12483,9751,-2732
2016,12,28,7,11100,12129,9409,-2720
2016,12,28,8,10970,12150,9187,-2963
2016,12,28,9,11000,12142,9137,-3005
2016,12,28,10,11190,12183,9274,-2909
2016,12,28,11,12180,12760,9788,-2972
2016,12,28,12,13820,13220,10427,-2793
2016,12,28,13,14910,14229,11120,-3109
2016,12,28,14,15120,14804,11675,-3129
2016,12,28,15,15010,14986,12011,-2975
2016,12,28,16,14840,15086,12008,-3078
2016,12,28,17,14630,15161,11962,-3199
2016,12,28,18,14450,15147,11937,-3210
2016,12,28,19,14620,15208,12100,-3108
2016,12,28,20,14680,15224,11918,-3306
2016,12,28,21,15140,15409,12076,-3333
2016,12,28,22,16490,16367,13113,-3254
2016,12,28,23,17400,17331,14189,-3142
2016,12,29,0,17300,17185,13718,-3467
2016,12,29,1,16900,16770,13414,-3356
2016,12,29,2,16500,16192,12802,-3390
2016,12,29,3,15500,15334,12243,-3091
2016,12,29,4,14170,14169,10967,-3202
2016,12,29,5,12950,13035,9790,-3245
2016,12,29,6,11900,12740,9373,-3367
2016,12,29,7,11440,12562,9240,-3322
2016,12,29,8,11250,12346,8946,-3400
2016,12,29,9,11270,12335,8940,-3395
2016,12,29,10,11890,12634,9163,-3471
2016,12,29,11,12780,12943,9743,-3200
2016,12,29,12,14300,13859,10540,-3319
2016,12,29,13,15320,14901,11829,-3072
2016,12,29,14,15750,15561,12623,-2938
2016,12,29,15,15780,16037,13114,-2923
2016,12,29,16,15900,16378,13586,-2792
2016,12,29,17,15870,16587,13729,-2858
2016,12,29,18,15750,16595,13511,-3084
2016,12,29,19,15750,16612,13541,-3071
2016,12,29,20,15670,16547,13434,-3113
2016,12,29,21,15870,16580,13634,-2946
2016,12,29,22,16990,17296,14219,-3077
2016,12,29,23,17800,17846,14594,-3252
2016,12,30,0,17500,17491,14036,-3455
2016,12,30,1,17050,16900,13484,-3416
2016,12,30,2,16510,16211,12871,-3340
2016,12,30,3,15570,15256,11738,-3518
2016,12,30,4,14240,14038,10554,-3484
2016,12,30,5,13040,12983,9486,-3497
2016,12,30,6,11990,12399,9210,-3189
2016,12,30,7,11530,12337,9253,-3084
2016,12,30,8,11330,12332,9289,-3043
2016,12,30,9,11300,12292,9225,-3067
2016,12,30,10,11650,12329,9367,-2962
2016,12,30,11,12570,12660,9754,-2906
2016,12,30,12,14080,13377,10440,-2937
2016,12,30,13,15130,14412,11680,-2732
2016,12,30,14,15470,14694,12098,-2596
2016,12,30,15,15450,14832,12187,-2645
2016,12,30,16,15300,14793,12151,-2642
2016,12,30,17,15220,14763,11966,-2797
2016,12,30,18,15080,14776,11964,-2812
2016,12,30,19,15010,14773,12083,-2690
2016,12,30,20,15070,14758,12096,-2662
2016,12,30,21,15390,14988,12218,-2770
2016,12,30,22,16440,15993,13069,-2924
2016,12,30,23,17250,17023,14041,-2982
2016,12,31,0,17080,16819,13820,-2999
2016,12,31,1,16640,16392,13399,-2993
2016,12,31,2,16210,15903,12855,-3048
2016,12,31,3,15530,15194,12259,-2935
2016,12,31,4,14500,14214,11332,-2882
2016,12,31,5,13360,13188,10460,-2728
2016,12,31,6,12500,12411,9452,-2959
2016,12,31,7,12030,11932,9113,-2819
2016,12,31,8,11770,11927,9120,-2807
2016,12,31,9,11670,11858,9111,-2747
2016,12,31,10,11790,11989,9248,-2741
2016,12,31,11,12190,12349,9357,-2992
2016,12,31,12,12800,12724,9880,-2844
2016,12,31,13,13580,13362,10445,-2917
2016,12,31,14,14390,13982,11131,-2851
2016,12,31,15,14890,14547,11701,-2846
2016,12,31,16,15020,14976,12146,-2830
2016,12,31,17,14940,15108,12169,-2939
2016,12,31,18,14790,14966,11885,-3081
2016,12,31,19,14590,14716,11529,-3187
2016,12,31,20,14670,14714,11581,-3133
2016,12,31,21,15090,14965,11858,-3107
2016,12,31,22,16170,15996,12753,-3243
2016,12,31,23,16850,16702,13351,-3351
2017,1,1,0,16550,16262,12927,-3335
2017,1,1,1,16050,15510,12329,-3181
2017,1,1,2,15510,14801,11869,-2932
2017,1,1,3,14770,14120,11117,-3003
2017,1,1,4,13810,13381,10367,-3014
2017,1,1,5,12770,12670,9543,-3127
2017,1,1,6,11860,12269,9120,-3149
2017,1,1,7,11230,11824,8867,-2957
2017,1,1,8,10930,11791,8609,-3182
2017,1,1,9,10700,11871,8477,-3394
2017,1,1,10,10660,11818,8560,-3258
2017,1,1,11,10860,11986,8676,-3310
2017,1,1,12,11280,12355,9054,-3301
2017,1,1,13,11620,12257,9033,-3224
2017,1,1,14,12260,12191,9128,-3063
2017,1,1,15,12810,12406,9455,-2951
2017,1,1,16,13170,12633,9230,-3403
2017,1,1,17,13340,12566,9283,-3283
2017,1,1,18,13410,12584,9410,-3174
2017,1,1,19,13310,12611,9500,-3111
2017,1,1,20,13340,12785,9615,-3170
2017,1,1,21,13630,13202,10004,-3198
2017,1,1,22,14970,14373,10822,-3551
2017,1,1,23,16250,15558,12094,-3464
2017,1,2,0,16040,15537,12021,-3516
2017,1,2,1,15580,15230,11628,-3602
2017,1,2,2,15140,14808,11186,-3622
2017,1,2,3,14340,14191,10667,-3524
2017,1,2,4,13350,13346,9657,-3689
2017,1,2,5,12300,12516,8695,-3821
2017,1,2,6,11400,12317,8899,-3418
2017,1,2,7,10890,12043,9101,-2942
2017,1,2,8,10620,12066,9004,-3062
2017,1,2,9,10570,12079,8872,-3207
2017,1,2,10,10660,12292,8931,-3361
2017,1,2,11,12460,12562,9342,-3220
2017,1,2,12,13960,12842,9715,-3127
2017,1,2,13,14870,13435,10347,-3088
2017,1,2,14,15020,14029,11001,-3028
2017,1,2,15,15170,14589,11613,-2976
2017,1,2,16,15180,14916,11676,-3240
2017,1,2,17,15150,14999,11596,-3403
2017,1,2,18,15120,14997,11582,-3415
2017,1,2,19,15030,14974,11428,-3546
2017,1,2,20,15090,14975,11233,-3742
2017,1,2,21,15380,15218,11701,-3517
2017,1,2,22,16510,16268,12566,-3702
2017,1,2,23,17500,17232,13569,-3663
2017,1,3,0,17350,16979,13319,-3660
2017,1,3,1,16830,16460,12815,-3645
2017,1,3,2,16130,15749,12077,-3672
2017,1,3,3,15150,14706,10849,-3857
2017,1,3,4,13870,13381,9911,-3470
2017,1,3,5,12710,12248,8829,-3419
2017,1,3,6,11830,11905,8592,-3313
2017,1,3,7,11370,12050,8502,-3548
2017,1,3,8,11100,12077,8583,-3494
2017,1,3,9,11080,11909,8803,-3106
2017,1,3,10,11390,12012,8983,-3029
2017,1,3,11,12110,12625,9851,-2774
2017,1,3,12,13670,14115,11455,-2660
2017,1,3,13,14670,15220,12542,-2678
2017,1,3,14,15130,15484,12386,-3098
2017,1,3,15,15310,15649,12394,-3255
2017,1,3,16,15490,15835,12573,-3262
2017,1,3,17,15580,15917,12438,-3479
2017,1,3,18,15480,15919,12332,-3587
2017,1,3,19,15570,15938,12307,-3631
2017,1,3,20,15570,15890,12225,-3665
2017,1,3,21,15800,16046,12427,-3619
2017,1,3,22,16800,16914,13319,-3595
2017,1,3,23,17690,17574,14027,-3547
2017,1,4,0,17280,17372,13797,-3575
2017,1,4,1,16700,16827,13204,-3623
2017,1,4,2,15940,16059,12367,-3692
2017,1,4,3,14810,14932,11114,-3818
2017,1,4,4,13420,13620,9788,-3832
2017,1,4,5,12260,13092,9583,-3509
2017,1,4,6,11490,12613,9139,-3474
2017,1,4,7,10990,12359,9197,-3162
2017,1,4,8,10730,12146,8824,-3322
2017,1,4,9,10650,12138,8832,-3306
2017,1,4,10,10990,12425,9053,-3372
2017,1,4,11,12100,12929,9529,-3400
2017,1,4,12,13810,14025,10648,-3377
2017,1,4,13,14930,14991,11694,-3297
2017,1,4,14,15000,15158,11762,-3396
2017,1,4,15,14980,15109,11608,-3501
2017,1,4,16,14880,15059,11576,-3483
2017,1,4,17,14780,14983,11371,-3612
2017,1,4,18,14730,14941,11393,-3548
2017,1,4,19,14630,14976,11386,-3590
2017,1,4,20,14760,14840,11205,-3635
2017,1,4,21,15010,14969,11426,-3543
2017,1,4,22,15980,15915,12240,-3675
2017,1,4,23,16980,16972,13323,-3649
2017,1,5,0,16940,16943,13304,-3639
2017,1,5,1,16570,16538,12975,-3563
2017,1,5,2,15990,15991,12398,-3593
2017,1,5,3,15070,15033,11459,-3574
2017,1,5,4,13860,13808,10288,-3520
2017,1,5,5,12760,13115,9835,-3280
2017,1,5,6,12000,12931,9412,-3519
2017,1,5,7,11620,12781,9218,-3563
2017,1,5,8,11510,12311,9054,-3257
2017,1,5,9,11590,12124,9030,-3094
2017,1,5,10,12030,12499,9388,-3111
2017,1,5,11,13260,13382,10053,-3329
2017,1,5,12,15220,15063,11544,-3519
2017,1,5,13,16140,16152,12629,-3523
2017,1,5,14,16010,16104,12563,-3541
2017,1,5,15,15710,15798,12272,-3526
2017,1,5,16,15460,15640,12050,-3590
2017,1,5,17,15350,15532,12000,-3532
2017,1,5,18,15330,15610,11880,-3730
2017,1,5,19,15360,15531,11766,-3765
2017,1,5,20,15440,15542,11711,-3831
2017,1,5,21,15800,15978,12153,-3825
2017,1,5,22,16840,17010,13079,-3931
2017,1,5,23,18060,18085,14246,-3839
2017,1,6,0,17890,18041,14216,-3825
2017,1,6,1,17470,17631,13830,-3801
2017,1,6,2,16870,16969,13234,-3735
2017,1,6,3,15800,15947,12226,-3721
2017,1,6,4,14420,14612,10916,-3696
2017,1,6,5,13230,13390,9870,-3520
2017,1,6,6,12470,13054,9266,-3788
2017,1,6,7,12010,12811,9037,-3774
2017,1,6,8,11790,12799,8938,-3861
2017,1,6,9,11830,12806,9029,-3777
2017,1,6,10,12240,13147,9239,-3908
2017,1,6,11,13250,14017,10326,-3691
2017,1,6,12,15040,15108,11767,-3341
2017,1,6,13,16090,16289,12858,-3431
2017,1,6,14,16320,16514,12968,-3546
2017,1,6,15,16240,16588,12816,-3772
2017,1,6,16,16170,16539,12806,-3733
2017,1,6,17,16030,16296,12594,-3702
2017,1,6,18,15730,16012,12355,-3657
2017,1,6,19,15780,15872,12219,-3653
2017,1,6,20,15730,15849,12201,-3648
2017,1,6,21,15940,16054,12609,-3445
2017,1,6,22,16890,16845,13369,-3476
2017,1,6,23,17960,17756,14297,-3459
2017,1,7,0,17740,17596,14031,-3565
2017,1,7,1,17310,17129,13521,-3608
2017,1,7,2,16680,16593,13070,-3523
2017,1,7,3,15820,15844,12493,-3351
2017,1,7,4,14750,14860,11641,-3219
2017,1,7,5,13670,14028,10757,-3271
2017,1,7,6,12950,13639,10463,-3176
2017,1,7,7,12520,13208,10294,-2914
2017,1,7,8,12290,13207,10208,-2999
2017,1,7,9,12270,13176,10122,-3054
2017,1,7,10,12560,13128,10182,-2946
2017,1,7,11,12980,12950,10502,-2448
2017,1,7,12,13680,13650,11126,-2524
2017,1,7,13,14530,14487,12029,-2458
2017,1,7,14,15390,15369,12714,-2655
2017,1,7,15,16010,16029,13334,-2695
2017,1,7,16,16240,16463,13948,-2515
2017,1,7,17,16220,16752,14185,-2567
2017,1,7,18,16200,16912,14010,-2902
2017,1,7,19,16140,16912,13903,-3009
2017,1,7,20,16180,16881,13941,-2940
2017,1,7,21,16420,16989,14133,-2856
2017,1,7,22,17230,17713,14966,-2747
2017,1,7,23,17850,18513,15541,-2972
2017,1,8,0,17670,18304,15485,-2819
2017,1,8,1,17090,17706,14979,-2727
2017,1,8,2,16440,17047,14387,-2660
2017,1,8,3,15690,16216,13537,-2679
2017,1,8,4,14780,15196,12839,-2357
2017,1,8,5,13860,14207,11580,-2627
2017,1,8,6,13260,13431,10667,-2764
2017,1,8,7,12890,13211,10603,-2608
2017,1,8,8,12680,13228,10602,-2626
2017,1,8,9,12610,13474,10768,-2706
2017,1,8,10,12860,13656,10844,-2812
2017,1,8,11,13060,13728,10952,-2776
2017,1,8,12,13830,14042,11102,-2940
2017,1,8,13,14240,14441,11568,-2873
2017,1,8,14,14860,15176,12248,-2928
2017,1,8,15,15410,15683,12736,-2947
2017,1,8,16,15530,15942,12920,-3022
2017,1,8,17,15620,16063,12995,-3068
2017,1,8,18,15650,16064,12983,-3081
2017,1,8,19,15510,15988,13013,-2975
2017,1,8,20,15650,15933,13048,-2885
2017,1,8,21,16050,16196,13519,-2677
2017,1,8,22,17140,17259,14543,-2716
2017,1,8,23,18450,18467,15816,-2651
2017,1,9,0,18410,18441,15704,-2737
2017,1,9,1,18010,18001,15278,-2723
2017,1,9,2,17330,17417,14623,-2794
2017,1,9,3,16350,16449,13842,-2607
2017,1,9,4,15200,15295,12894,-2401
2017,1,9,5,14150,14337,11625,-2712
2017,1,9,6,13650,14020,11266,-2754
2017,1,9,7,13350,14244,11512,-2732
2017,1,9,8,13220,14233,11448,-2785
2017,1,9,9,13320,14337,11633,-2704
2017,1,9,10,13970,14751,12154,-2597
2017,1,9,11,15040,15660,13005,-2655
2017,1,9,12,16890,17074,14469,-2605
2017,1,9,13,17960,18210,15672,-2538
2017,1,9,14,17850,18313,15741,-2572
2017,1,9,15,17810,18241,15405,-2836
2017,1,9,16,17680,18139,15485,-2654
2017,1,9,17,17650,17991,15399,-2592
2017,1,9,18,17540,17847,15159,-2688
2017,1,9,19,17450,17789,15088,-2701
2017,1,9,20,17280,17657,15014,-2643
2017,1,9,21,17470,17696,14848,-2848
2017,1,9,22,18400,18437,15642,-2795
2017,1,9,23,19690,19577,16920,-2657
2017,1,10,0,19700,19572,17028,-2544
2017,1,10,1,19160,19169,16653,-2516
2017,1,10,2,18360,18498,16037,-2461
2017,1,10,3,17120,17397,14901,-2496
2017,1,10,4,15760,16037,13517,-2520
2017,1,10,5,14470,14870,12275,-2595
2017,1,10,6,13700,14136,11258,-2878
2017,1,10,7,13290,13738,10831,-2907
2017,1,10,8,13160,13576,10741,-2835
2017,1,10,9,13150,13634,10778,-2856
2017,1,10,10,13570,14001,11225,-2776
2017,1,10,11,15070,15072,12405,-2667
2017,1,10,12,17030,16941,14526,-2415
2017,1,10,13,17990,17936,15705,-2231
2017,1,10,14,17930,18009,15596,-2413
2017,1,10,15,17670,17861,15509,-2352
2017,1,10,16,17420,17634,14704,-2930
2017,1,10,17,17330,17356,14550,-2806
2017,1,10,18,17120,16969,14128,-2841
2017,1,10,19,17060,16730,13741,-2989
2017,1,10,20,16990,16598,13602,-2996
2017,1,10,21,17160,16734,13665,-3069
2017,1,10,22,18050,17520,14346,-3174
2017,1,10,23,19100,18409,14980,-3429
2017,1,11,0,18840,18239,14727,-3512
2017,1,11,1,18140,17703,14256,-3447
2017,1,11,2,17310,16949,13636,-3313
2017,1,11,3,16040,15783,12323,-3460
2017,1,11,4,14570,14405,11084,-3321
2017,1,11,5,13340,13368,9943,-3425
2017,1,11,6,12530,12675,9375,-3300
2017,1,11,7,11900,12799,9357,-3442
2017,1,11,8,11670,12819,9364,-3455
2017,1,11,9,11610,12777,9379,-3398
2017,1,11,10,11650,13051,9594,-3457
2017,1,11,11,12750,13515,10198,-3317
2017,1,11,12,14430,14805,11492,-3313
2017,1,11,13,15570,15459,11907,-3552
2017,1,11,14,15530,15311,11793,-3518
2017,1,11,15,15380,14943,11661,-3282
2017,1,11,16,15050,14666,11528,-3138
2017,1,11,17,14770,14410,11644,-2766
2017,1,11,18,14570,14272,11539,-2733
2017,1,11,19,14590,14444,11406,-3038
2017,1,11,20,14800,14661,11687,-2974
2017,1,11,21,15060,14892,11785,-3107
2017,1,11,22,16100,15560,12432,-3128
2017,1,11,23,17160,16685,13191,-3494
2017,1,12,0,17100,16654,13364,-3290
2017,1,12,1,16700,16222,12850,-3372
2017,1,12,2,16010,15598,12292,-3306
2017,1,12,3,14900,14596,11387,-3209
2017,1,12,4,13630,13310,10303,-3007
2017,1,12,5,12480,12993,10173,-2820
2017,1,12,6,11510,11922,9182,-2740
2017,1,12,7,11060,11233,8654,-2579
2017,1,12,8,10780,11064,8531,-2533
2017,1,12,9,10740,11201,8569,-2632
2017,1,12,10,11000,11387,8603,-2784
2017,1,12,11,11850,12151,9234,-2917
2017,1,12,12,13660,13622,10868,-2754
2017,1,12,13,14760,14747,12033,-2714
2017,1,12,14,14870,14842,12085,-2757
2017,1,12,15,14900,14829,12791,-2038
2017,1,12,16,15050,14673,12740,-1933
2017,1,12,17,15060,14546,11229,-3317
2017,1,12,18,15110,14495,11558,-2937
2017,1,12,19,15120,14532,11755,-2777
2017,1,12,20,15030,14485,11738,-2747
2017,1,12,21,15300,14689,11646,-3043
2017,1,12,22,16070,15400,12785,-2615
2017,1,12,23,16780,16213,13496,-2717
2017,1,13,0,16520,16069,13339,-2730
2017,1,13,1,16000,15601,12629,-2972
2017,1,13,2,15240,14942,12170,-2772
2017,1,13,3,14180,13966,11037,-2929
2017,1,13,4,12830,12824,10056,-2768
2017,1,13,5,11610,12075,9834,-2241
2017,1,13,6,10800,11716,9843,-1873
2017,1,13,7,10410,11641,9849,-1792
2017,1,13,8,10160,11479,9780,-1699
2017,1,13,9,10170,11459,9848,-1611
2017,1,13,10,10540,11738,9989,-1749
2017,1,13,11,11510,12482,10240,-2242
2017,1,13,12,13210,13361,10812,-2549
2017,1,13,13,14450,14376,11367,-3009
2017,1,13,14,14500,14412,11404,-3008
2017,1,13,15,14250,14170,11248,-2922
2017,1,13,16,14040,14037,11247,-2790
2017,1,13,17,13910,13859,11324,-2535
2017,1,13,18,13840,13714,11033,-2681
2017,1,13,19,13860,13761,11348,-2413
2017,1,13,20,14070,13995,11658,-2337
2017,1,13,21,14340,14478,12256,-2222
2017,1,13,22,15430,15473,12948,-2525
2017,1,13,23,16850,16577,13464,-3113
2017,1,14,0,16700,16526,13569,-2957
2017,1,14,1,16150,16183,13325,-2858
2017,1,14,2,15630,15726,13092,-2634
2017,1,14,3,14920,15048,12624,-2424
2017,1,14,4,13980,14138,12072,-2066
2017,1,14,5,13020,13180,11245,-1935
2017,1,14,6,12260,12938,10304,-2634
2017,1,14,7,11830,12849,10072,-2777
2017,1,14,8,11710,12978,9968,-3010
2017,1,14,9,11670,12383,9424,-2959
2017,1,14,10,11720,12303,9880,-2423
2017,1,14,11,12420,12786,10146,-2640
2017,1,14,12,13230,13376,10709,-2667
2017,1,14,13,13910,14160,11254,-2906
2017,1,14,14,14510,14782,11732,-3050
2017,1,14,15,14620,15098,12025,-3073
2017,1,14,16,14650,15016,12144,-2872
2017,1,14,17,14430,14747,11982,-2765
2017,1,14,18,14200,14590,11605,-2985
2017,1,14,19,14060,14654,11621,-3033
2017,1,14,20,14250,14902,11890,-3012
2017,1,14,21,14660,15191,11913,-3278
2017,1,14,22,15630,16024,12981,-3043
2017,1,14,23,16800,16852,13727,-3125
2017,1,15,0,16430,16716,13324,-3392
2017,1,15,1,15990,16254,12695,-3559
2017,1,15,2,15430,15719,12225,-3494
2017,1,15,3,14710,14971,11686,-3285
2017,1,15,4,13790,14139,11034,-3105
2017,1,15,5,12890,13280,10203,-3077
2017,1,15,6,12170,12550,9649,-2901
2017,1,15,7,11690,12361,9559,-2802
2017,1,15,8,11460,12470,9652,-2818
2017,1,15,9,11400,12408,9429,-2979
2017,1,15,10,11470,12597,9545,-3052
2017,1,15,11,11940,12613,9700,-2913
2017,1,15,12,12550,12793,9937,-2856
2017,1,15,13,13080,13359,10599,-2760
2017,1,15,14,13820,13766,11181,-2585
2017,1,15,15,14110,13767,11224,-2543
2017,1,15,16,14070,13675,11088,-2587
2017,1,15,17,13910,13531,11065,-2466
2017,1,15,18,13780,13399,10899,-2500
2017,1,15,19,13630,13278,10696,-2582
2017,1,15,20,13550,13425,10705,-2720
2017,1,15,21,13930,13947,10995,-2952
2017,1,15,22,15310,15035,11867,-3168
2017,1,15,23,16800,16333,13027,-3306
2017,1,16,0,16750,16402,13287,-3115
2017,1,16,1,16400,15947,12882,-3065
2017,1,16,2,15850,15529,12370,-3159
2017,1,16,3,14970,14844,11676,-3168
2017,1,16,4,13900,13940,11085,-2855
2017,1,16,5,12980,13081,10273,-2808
2017,1,16,6,12380,12476,10034,-2442
2017,1,16,7,11940,12400,9877,-2523
2017,1,16,8,11770,12542,9900,-2642
2017,1,16,9,11830,12613,10047,-2566
2017,1,16,10,12200,12724,10265,-2459
2017,1,16,11,13250,13359,11218,-2141
2017,1,16,12,14480,14620,12394,-2226
2017,1,16,13,15110,15580,13676,-1904
2017,1,16,14,15470,15959,14113,-1846
2017,1,16,15,15570,15786,13763,-2023
2017,1,16,16,15550,15510,13186,-2324
2017,1,16,17,15450,15210,12863,-2347
2017,1,16,18,15210,14941,12739,-2202
2017,1,16,19,15140,14837,12536,-2301
2017,1,16,20,15060,14918,12673,-2245
2017,1,16,21,15170,15294,12819,-2475
2017,1,16,22,16080,16224,13556,-2668
2017,1,16,23,17410,17492,14782,-2710
2017,1,17,0,17360,17384,14815,-2569
2017,1,17,1,16890,16887,14373,-2514
2017,1,17,2,16130,16181,13724,-2457
2017,1,17,3,15070,15087,12559,-2528
2017,1,17,4,13820,13781,11468,-2313
2017,1,17,5,12720,12823,10435,-2388
2017,1,17,6,12050,13198,9983,-3215
2017,1,17,7,11650,12912,9572,-3340
2017,1,17,8,11500,12745,9445,-3300
2017,1,17,9,11490,12773,9452,-3321
2017,1,17,10,11900,13136,9773,-3363
2017,1,17,11,12950,13470,10454,-3016
2017,1,17,12,14840,14799,12062,-2737
2017,1,17,13,15820,15849,12914,-2935
2017,1,17,14,15770,15821,13003,-2818
2017,1,17,15,15700,15598,12899,-2699
2017,1,17,16,15590,15406,12805,-2601
2017,1,17,17,15420,15222,12603,-2619
2017,1,17,18,15370,14985,12466,-2519
2017,1,17,19,15480,15185,12734,-2451
2017,1,17,20,15590,15399,13397,-2002
2017,1,17,21,15900,15660,13006,-2654
2017,1,17,22,16620,16385,13434,-2951
2017,1,17,23,17550,17305,14455,-2850
2017,1,18,0,17340,17219,14113,-3106
2017,1,18,1,16850,16750,13820,-2930
2017,1,18,2,16170,16037,13062,-2975
2017,1,18,3,15010,14994,12001,-2993
2017,1,18,4,13670,13680,10918,-2762
2017,1,18,5,12520,12981,10137,-2844
2017,1,18,6,11810,12612,9827,-2785
2017,1,18,7,11360,12371,9821,-2550
2017,1,18,8,11150,12012,9738,-2274
2017,1,18,9,11160,11986,9594,-2392
2017,1,18,10,11490,12198,9788,-2410
2017,1,18,11,12520,12798,10497,-2301
2017,1,18,12,14370,14283,12256,-2027
2017,1,18,13,15480,15426,13445,-1981
2017,1,18,14,15620,15762,13472,-2290
2017,1,18,15,15730,15871,13485,-2386
2017,1,18,16,15840,15985,13647,-2338
2017,1,18,17,15850,15988,13783,-2205
2017,1,18,18,15830,15940,13668,-2272
2017,1,18,19,15790,15896,13602,-2294
2017,1,18,20,15710,15760,13407,-2353
2017,1,18,21,15900,15815,13343,-2472
2017,1,18,22,16590,16438,13987,-2451
2017,1,18,23,17600,17301,15042,-2259
2017,1,19,0,17240,17218,14782,-2436
2017,1,19,1,16800,16742,14295,-2447
2017,1,19,2,16080,16060,13562,-2498
2017,1,19,3,14990,15001,12305,-2696
2017,1,19,4,13630,13694,11263,-2431
2017,1,19,5,12480,12547,10174,-2373
2017,1,19,6,11640,12039,9757,-2282
2017,1,19,7,11220,11923,9463,-2460
2017,1,19,8,11040,11991,9520,-2471
2017,1,19,9,11050,11981,9500,-2481
2017,1,19,10,11380,12164,9463,-2701
2017,1,19,11,12720,12618,10151,-2467
2017,1,19,12,14620,14426,12011,-2415
2017,1,19,13,15510,15472,13397,-2075
2017,1,19,14,15470,15429,13410,-2019
2017,1,19,15,15170,15104,13183,-1921
2017,1,19,16,14890,14842,13014,-1828
2017,1,19,17,14650,14641,12658,-1983
2017,1,19,18,14490,14460,12401,-2059
2017,1,19,19,14470,14550,12537,-2013
2017,1,19,20,14510,14673,12645,-2028
2017,1,19,21,14740,14915,13076,-1839
2017,1,19,22,15620,15635,13899,-1736
2017,1,19,23,16830,16600,14592,-2008
2017,1,20,0,16560,16545,14574,-1971
2017,1,20,1,16290,16141,14326,-1815
2017,1,20,2,15720,15500,13706,-1794
2017,1,20,3,14800,14542,12520,-2022
2017,1,20,4,13540,13269,11295,-1974
2017,1,20,5,12420,12156,10279,-1877
2017,1,20,6,11730,11779,9320,-2459
2017,1,20,7,11310,11725,9175,-2550
2017,1,20,8,11150,11719,9054,-2665
2017,1,20,9,11180,11722,9059,-2663
2017,1,20,10,11540,11816,9208,-2608
2017,1,20,11,12340,12493,10015,-2478
2017,1,20,12,14210,14021,11941,-2080
2017,1,20,13,15250,15134,13212,-1922
2017,1,20,14,15280,15401,13500,-1901
2017,1,20,15,15080,15459,13382,-2077
2017,1,20,16,14960,15484,13172,-2312
2017,1,20,17,14750,15295,13007,-2288
2017,1,20,18,14540,15086,12741,-2345
2017,1,20,19,14510,15199,13021,-2178
2017,1,20,20,14540,15102,12951,-2151
2017,1,20,21,14700,15098,12813,-2285
2017,1,20,22,15460,15600,12870,-2730
2017,1,20,23,16400,16336,13525,-2811
2017,1,21,0,16150,16115,13304,-2811
2017,1,21,1,15680,15599,12855,-2744
2017,1,21,2,15120,15025,12598,-2427
2017,1,21,3,14300,14224,11646,-2578
2017,1,21,4,13280,13200,10571,-2629
2017,1,21,5,12250,12252,9925,-2327
2017,1,21,6,11460,11720,9461,-2259
2017,1,21,7,11000,11483,9256,-2227
2017,1,21,8,10750,11449,9068,-2381
2017,1,21,9,10660,11345,9028,-2317
2017,1,21,10,10730,11417,8881,-2536
2017,1,21,11,11100,11529,8952,-2577
2017,1,21,12,11940,12007,9233,-2774
2017,1,21,13,12730,12515,9882,-2633
2017,1,21,14,13410,13308,10730,-2578
2017,1,21,15,13780,13848,11153,-2695
2017,1,21,16,13880,13992,11494,-2498
2017,1,21,17,13690,13693,11202,-2491
2017,1,21,18,13530,13171,10847,-2324
2017,1,21,19,13380,12731,10384,-2347
2017,1,21,20,13300,12656,10333,-2323
2017,1,21,21,13490,12953,10531,-2422
2017,1,21,22,14180,13644,11079,-2565
2017,1,21,23,15200,14784,12343,-2441
2017,1,22,0,15000,14753,12244,-2509
2017,1,22,1,14490,14319,11845,-2474
2017,1,22,2,13990,13827,11209,-2618
2017,1,22,3,13310,13197,10370,-2827
2017,1,22,4,12490,12394,9899,-2495
2017,1,22,5,11640,11549,9260,-2289
2017,1,22,6,10830,11356,8888,-2468
2017,1,22,7,10390,11201,8686,-2515
2017,1,22,8,10140,11057,8458,-2599
2017,1,22,9,10020,11344,8810,-2534
2017,1,22,10,10110,11262,8761,-2501
2017,1,22,11,10440,11473,8753,-2720
2017,1,22,12,11020,11760,9062,-2698
2017,1,22,13,11710,12145,9558,-2587
2017,1,22,14,12400,12734,10115,-2619
2017,1,22,15,12920,13184,10534,-2650
2017,1,22,16,13160,13251,10783,-2468
2017,1,22,17,13300,13394,10795,-2599
2017,1,22,18,13350,13595,11106,-2489
2017,1,22,19,13440,13714,11085,-2629
2017,1,22,20,13540,13855,10941,-2914
2017,1,22,21,13750,14155,11370,-2785
2017,1,22,22,14620,14924,12091,-2833
2017,1,22,23,15800,15764,12881,-2883
2017,1,23,0,15540,15602,12971,-2631
2017,1,23,1,15030,14901,12238,-2663
2017,1,23,2,14460,14359,11632,-2727
2017,1,23,3,13560,13509,10605,-2904
2017,1,23,4,12490,12574,9932,-2642
2017,1,23,5,11540,11549,9060,-2489
2017,1,23,6,10990,11307,8934,-2373
2017,1,23,7,10620,11498,9205,-2293
2017,1,23,8,10430,11433,9070,-2363
2017,1,23,9,10530,11487,9099,-2388
2017,1,23,10,10900,11887,9352,-2535
2017,1,23,11,11970,12708,10085,-2623
2017,1,23,12,13850,13889,11514,-2375
2017,1,23,13,14970,15051,12870,-2181
2017,1,23,14,15260,15295,12813,-2482
2017,1,23,15,15480,15427,13057,-2370
2017,1,23,16,15750,15457,13168,-2289
2017,1,23,17,15740,15610,13282,-2328
2017,1,23,18,15750,15603,13016,-2587
2017,1,23,19,15770,15678,13225,-2453
2017,1,23,20,15760,15668,13259,-2409
2017,1,23,21,15960,15852,13490,-2362
2017,1,23,22,16570,16552,14078,-2474
2017,1,23,23,17800,17495,14801,-2694
2017,1,24,0,17510,17413,14602,-2811
2017,1,24,1,16910,16901,14186,-2715
2017,1,24,2,16050,16156,13430,-2726
2017,1,24,3,14730,15066,12366,-2700
2017,1,24,4,13400,13797,11203,-2594
2017,1,24,5,12450,12652,10307,-2345
2017,1,24,6,11750,12204,9712,-2492
2017,1,24,7,11340,12016,9489,-2527
2017,1,24,8,11080,12121,9561,-2560
2017,1,24,9,11090,12149,9525,-2624
2017,1,24,10,11500,12508,9938,-2570
2017,1,24,11,12600,13049,10698,-2351
2017,1,24,12,14390,14133,11924,-2209
2017,1,24,13,15650,15216,13106,-2110
2017,1,24,14,15820,15713,13689,-2024
2017,1,24,15,15730,15996,13879,-2117
2017,1,24,16,15850,16223,13984,-2239
2017,1,24,17,15810,16346,14066,-2280
2017,1,24,18,15750,16339,13847,-2492
2017,1,24,19,15750,16312,13852,-2460
2017,1,24,20,15750,16177,13847,-2330
2017,1,24,21,15950,16162,13964,-2198
2017,1,24,22,16600,16666,14348,-2318
2017,1,24,23,17700,17483,14948,-2535
2017,1,25,0,17390,17331,14879,-2452
2017,1,25,1,16790,16780,14574,-2206
2017,1,25,2,16060,16015,13597,-2418
2017,1,25,3,14950,14940,12211,-2729
2017,1,25,4,13600,13738,10955,-2783
2017,1,25,5,12480,12721,10264,-2457
2017,1,25,6,11710,11982,9276,-2706
2017,1,25,7,11300,11622,9196,-2426
2017,1,25,8,11120,11840,9092,-2748
2017,1,25,9,11130,11856,9191,-2665
2017,1,25,10,11510,11940,9253,-2687
2017,1,25,11,12560,12483,9793,-2690
2017,1,25,12,14300,14303,11428,-2875
2017,1,25,13,15400,15334,12721,-2613
2017,1,25,14,15320,15347,12521,-2826
2017,1,25,15,15130,15146,12223,-2923
2017,1,25,16,14790,14868,11736,-3132
2017,1,25,17,14580,14567,11613,-2954
2017,1,25,18,14340,14354,11401,-2953
2017,1,25,19,14330,14320,11308,-3012
2017,1,25,20,14430,14667,11690,-2977
2017,1,25,21,14680,14774,12447,-2327
2017,1,25,22,15450,15386,12967,-2419
2017,1,25,23,16800,16619,13672,-2947
2017,1,26,0,16630,16759,13759,-3000
2017,1,26,1,16300,16348,13315,-3033
2017,1,26,2,15670,15734,13089,-2645
2017,1,26,3,14650,14724,11772,-2952
2017,1,26,4,13370,13417,10574,-2843
2017,1,26,5,12250,12270,9676,-2594
2017,1,26,6,11550,11902,9096,-2806
2017,1,26,7,11120,11807,8935,-2872
2017,1,26,8,10900,11897,9047,-2850
2017,1,26,9,10910,11891,8943,-2948
2017,1,26,10,11230,12207,9313,-2894
2017,1,26,11,12260,12625,10008,-2617
2017,1,26,12,14160,13973,11178,-2795
2017,1,26,13,15050,15065,12496,-2569
2017,1,26,14,15030,15220,12713,-2507
2017,1,26,15,14860,15229,12547,-2682
2017,1,26,16,14720,15252,12705,-2547
2017,1,26,17,14550,15104,12640,-2464
2017,1,26,18,14430,14808,12180,-2628
2017,1,26,19,14440,14502,11810,-2692
2017,1,26,20,14460,14469,11840,-2629
2017,1,26,21,14620,14604,12316,-2288
2017,1,26,22,15330,15214,13041,-2173
2017,1,26,23,16400,16316,13869,-2447
2017,1,27,0,16260,16414,13924,-2490
2017,1,27,1,15940,16032,13595,-2437
2017,1,27,2,15390,15437,13151,-2286
2017,1,27,3,14410,14476,12277,-2199
2017,1,27,4,13170,13301,11374,-1927
2017,1,27,5,12080,12587,10883,-1704
2017,1,27,6,11430,12510,10382,-2128
2017,1,27,7,11030,12356,9973,-2383
2017,1,27,8,10850,12157,9559,-2598
2017,1,27,9,10840,12146,9478,-2668
2017,1,27,10,11170,12484,9789,-2695
2017,1,27,11,12170,13437,10784,-2653
2017,1,27,12,13990,14282,11721,-2561
2017,1,27,13,14950,14983,12715,-2268
2017,1,27,14,15010,15084,12917,-2167
2017,1,27,15,14970,15011,12929,-2082
2017,1,27,16,14920,14976,12793,-2183
2017,1,27,17,14720,14834,12770,-2064
2017,1,27,18,14610,14692,12594,-2098
2017,1,27,19,14560,14710,12571,-2139
2017,1,27,20,14600,14732,12400,-2332
2017,1,27,21,14710,14920,12696,-2224
2017,1,27,22,15420,15529,13325,-2204
2017,1,27,23,16360,16395,13771,-2624
2017,1,28,0,16220,16259,13627,-2632
2017,1,28,1,15750,15797,13441,-2356
2017,1,28,2,15200,15254,13061,-2193
2017,1,28,3,14390,14493,11985,-2508
2017,1,28,4,13350,13505,11039,-2466
2017,1,28,5,12380,12559,9952,-2607
2017,1,28,6,11600,12424,9530,-2894
2017,1,28,7,11150,12357,9713,-2644
2017,1,28,8,10950,12126,9432,-2694
2017,1,28,9,10870,12316,9535,-2781
2017,1,28,10,11030,12275,9506,-2769
2017,1,28,11,11430,12552,9606,-2946
2017,1,28,12,12180,13137,10333,-2804
2017,1,28,13,12850,13519,10971,-2548
2017,1,28,14,13540,13849,11159,-2690
2017,1,28,15,13860,13710,11100,-2610
2017,1,28,16,13950,13778,11155,-2623
2017,1,28,17,13790,13946,11363,-2583
2017,1,28,18,13630,13996,11275,-2721
2017,1,28,19,13450,14011,11252,-2759
2017,1,28,20,13450,14051,11253,-2798
2017,1,28,21,13920,14177,11558,-2619
2017,1,28,22,14560,14673,12153,-2520
2017,1,28,23,15560,15610,13032,-2578
2017,1,29,0,15650,15578,13138,-2440
2017,1,29,1,15130,15144,12692,-2452
2017,1,29,2,14630,14678,12032,-2646
2017,1,29,3,13990,14034,11356,-2678
2017,1,29,4,13160,13249,10431,-2818
2017,1,29,5,12320,12625,9735,-2890
2017,1,29,6,11650,11957,8842,-3115
2017,1,29,7,11200,11793,8630,-3163
2017,1,29,8,10940,11643,8557,-3086
2017,1,29,9,10880,11735,8546,-3189
2017,1,29,10,10960,11790,8598,-3192
2017,1,29,11,11270,11843,8680,-3163
2017,1,29,12,11830,12551,9412,-3139
2017,1,29,13,12410,12813,9871,-2942
2017,1,29,14,12870,12921,10045,-2876
2017,1,29,15,13200,13127,10187,-2940
2017,1,29,16,13250,13155,10071,-3084
2017,1,29,17,13250,13202,10039,-3163
2017,1,29,18,13240,13413,10395,-3018
2017,1,29,19,13290,13489,10361,-3128
2017,1,29,20,13370,13476,10274,-3202
2017,1,29,21,13710,13738,10503,-3235
2017,1,29,22,14510,14544,11326,-3218
2017,1,29,23,15870,15878,12673,-3205
2017,1,30,0,16000,16098,12780,-3318
2017,1,30,1,15330,15729,12457,-3272
2017,1,30,2,14810,15159,11988,-3171
2017,1,30,3,14050,14266,11158,-3108
2017,1,30,4,13110,13211,9820,-3391
2017,1,30,5,12200,12242,8874,-3368
2017,1,30,6,11570,11907,8516,-3391
2017,1,30,7,11280,11882,8516,-3366
2017,1,30,8,11200,11798,8604,-3194
2017,1,30,9,11290,11886,8806,-3080
2017,1,30,10,11710,12308,9164,-3144
2017,1,30,11,12830,13051,9951,-3100
2017,1,30,12,14680,14842,11989,-2853
2017,1,30,13,15700,15894,13100,-2794
2017,1,30,14,15770,15885,12795,-3090
2017,1,30,15,15680,15630,12712,-2918
2017,1,30,16,15600,15287,12062,-3225
2017,1,30,17,15550,15143,11956,-3187
2017,1,30,18,15420,15112,11885,-3227
2017,1,30,19,15390,15058,11730,-3328
2017,1,30,20,15430,15093,11750,-3343
2017,1,30,21,15590,15209,12081,-3128
2017,1,30,22,16270,15991,12760,-3231
2017,1,30,23,17430,17356,14255,-3101
2017,1,31,0,17600,17594,14431,-3163
2017,1,31,1,17160,17210,14048,-3162
2017,1,31,2,16540,16591,13458,-3133
2017,1,31,3,15470,15573,12372,-3201
2017,1,31,4,14220,14309,11397,-2912
2017,1,31,5,13130,13506,10299,-3207
2017,1,31,6,12580,13151,9980,-3171
2017,1,31,7,12280,13124,9797,-3327
2017,1,31,8,12180,12750,9644,-3106
2017,1,31,9,12240,12825,9614,-3211
2017,1,31,10,12700,13027,9987,-3040
2017,1,31,11,13820,13828,10989,-2839
2017,1,31,12,15720,15751,12701,-3050
2017,1,31,13,16610,16691,13717,-2974
2017,1,31,14,16590,16413,13225,-3188
2017,1,31,15,16500,16021,12980,-3041
2017,1,31,16,16390,15941,12658,-3283
2017,1,31,17,16200,16123,12906,-3217
2017,1,31,18,16050,16236,13042,-3194
2017,1,31,19,16050,16405,13103,-3302
2017,1,31,20,16080,16449,13165,-3284
2017,1,31,21,16260,16579,13470,-3109
2017,1,31,22,16800,17098,14158,-2940
2017,1,31,23,18010,18230,14882,-3348
2017,2,1,0,18050,18283,14947,-3336
2017,2,1,1,17550,17756,14625,-3131
2017,2,1,2,16870,16971,13743,-3228
2017,2,1,3,15710,15833,12750,-3083
2017,2,1,4,14290,14449,11374,-3075
2017,2,1,5,13150,13506,10334,-3172
2017,2,1,6,12400,13273,9962,-3311
2017,2,1,7,12000,12986,9745,-3241
2017,2,1,8,11790,13050,9854,-3196
2017,2,1,9,11810,13053,9959,-3094
2017,2,1,10,12310,13097,10105,-2992
2017,2,1,11,13350,13449,10555,-2894
2017,2,1,12,15190,15148,12483,-2665
2017,2,1,13,16060,16096,13398,-2698
2017,2,1,14,15910,16243,13598,-2645
2017,2,1,15,15800,16209,13435,-2774
2017,2,1,16,15620,16144,13053,-3091
2017,2,1,17,15470,15838,12963,-2875
2017,2,1,18,15300,15576,12637,-2939
2017,2,1,19,15240,15390,12317,-3073
2017,2,1,20,15190,15214,12130,-3084
2017,2,1,21,15270,15461,12383,-3078
2017,2,1,22,15900,15828,13159,-2669
2017,2,1,23,17010,17008,14224,-2784
2017,2,2,0,17200,17204,14486,-2718
2017,2,2,1,16860,16802,14138,-2664
2017,2,2,2,16180,16198,13361,-2837
2017,2,2,3,15200,15188,12271,-2917
2017,2,2,4,13910,13906,10986,-2920
2017,2,2,5,12810,12787,10449,-2338
2017,2,2,6,12190,12554,9926,-2628
2017,2,2,7,11790,12789,9942,-2847
2017,2,2,8,11690,12989,10196,-2793
2017,2,2,9,11700,12924,10184,-2740
2017,2,2,10,12120,12939,10270,-2669
2017,2,2,11,13170,13695,10951,-2744
2017,2,2,12,14960,15142,12640,-2502
2017,2,2,13,15710,16108,13398,-2710
2017,2,2,14,15680,16013,13700,-2313
2017,2,2,15,15430,15757,13432,-2325
2017,2,2,16,15430,15324,13046,-2278
2017,2,2,17,15190,15070,12775,-2295
2017,2,2,18,14960,14935,12536,-2399
2017,2,2,19,14880,14936,12435,-2501
2017,2,2,20,14930,14937,12511,-2426
2017,2,2,21,15150,15146,12759,-2387
2017,2,2,22,15820,15825,13455,-2370
2017,2,2,23,17020,17079,14557,-2522
2017,2,3,0,17350,17369,14901,-2468
2017,2,3,1,16960,17021,14511,-2510
2017,2,3,2,16390,16489,13934,-2555
2017,2,3,3,15510,15546,12899,-2647
2017,2,3,4,14260,14359,11725,-2634
2017,2,3,5,13210,13458,10826,-2632
2017,2,3,6,12450,12967,10131,-2836
2017,2,3,7,12110,13088,10041,-3047
2017,2,3,8,11990,13213,10189,-3024
2017,2,3,9,12050,13139,10244,-2895
2017,2,3,10,12450,13303,10444,-2859
2017,2,3,11,13530,14109,10913,-3196
2017,2,3,12,15270,15496,12409,-3087
2017,2,3,13,16100,16363,13189,-3174
2017,2,3,14,16030,16207,13204,-3003
2017,2,3,15,15880,15969,13049,-2920
2017,2,3,16,15640,15914,12980,-2934
2017,2,3,17,15470,15583,12609,-2974
2017,2,3,18,15300,15194,12100,-3094
2017,2,3,19,15210,15048,11965,-3083
2017,2,3,20,15300,14982,11818,-3164
2017,2,3,21,15430,15282,12018,-3264
2017,2,3,22,16020,15958,12797,-3161
2017,2,3,23,17050,17016,13912,-3104
2017,2,4,0,17250,17112,13966,-3146
2017,2,4,1,16740,16668,13642,-3026
2017,2,4,2,16160,16146,13204,-2942
2017,2,4,3,15460,15407,12362,-3045
2017,2,4,4,14490,14419,11273,-3146
2017,2,4,5,13500,13441,10653,-2788
2017,2,4,6,12850,12759,10166,-2593
2017,2,4,7,12430,12618,10095,-2523
2017,2,4,8,12270,12595,10158,-2437
2017,2,4,9,12190,12474,10013,-2461
2017,2,4,10,12280,12551,10139,-2412
2017,2,4,11,12720,13014,10504,-2510
2017,2,4,12,13510,13527,10906,-2621
2017,2,4,13,14130,14276,11662,-2614
2017,2,4,14,14750,14699,12065,-2634
2017,2,4,15,15060,14676,12139,-2537
2017,2,4,16,14990,14516,11782,-2734
2017,2,4,17,14780,14320,11313,-3007
2017,2,4,18,14550,14029,10876,-3153
2017,2,4,19,14340,13820,10746,-3074
2017,2,4,20,14270,13961,10949,-3012
2017,2,4,21,14470,14183,10964,-3219
2017,2,4,22,15030,14954,11681,-3273
2017,2,4,23,16200,16224,13048,-3176
2017,2,5,0,16500,16481,13388,-3093
2017,2,5,1,16020,16123,12646,-3477
2017,2,5,2,15500,15637,12387,-3250
2017,2,5,3,14850,14970,12003,-2967
2017,2,5,4,14010,14052,11141,-2911
2017,2,5,5,13120,13123,10175,-2948
2017,2,5,6,12480,12577,9937,-2640
2017,2,5,7,12090,12480,9624,-2856
2017,2,5,8,11860,12257,9363,-2894
2017,2,5,9,11820,12396,9386,-3010
2017,2,5,10,11950,12462,9448,-3014
2017,2,5,11,11980,12712,9681,-3031
2017,2,5,12,12730,13007,9928,-3079
2017,2,5,13,13180,13385,10561,-2824
2017,2,5,14,13740,13883,11188,-2695
2017,2,5,15,14140,14279,11530,-2749
2017,2,5,16,14290,14368,11613,-2755
2017,2,5,17,14250,14478,11653,-2825
2017,2,5,18,14150,14479,11686,-2793
2017,2,5,19,14080,14288,11314,-2974
2017,2,5,20,14060,14216,11223,-2993
2017,2,5,21,14260,14586,11526,-3060
2017,2,5,22,15010,15223,12139,-3084
2017,2,5,23,16170,16309,12959,-3350
2017,2,6,0,16500,16019,12751,-3268
2017,2,6,1,15780,15093,11671,-3422
2017,2,6,2,15180,14569,11404,-3165
2017,2,6,3,14390,13971,10788,-3183
2017,2,6,4,13520,13285,10264,-3021
2017,2,6,5,12640,12970,9964,-3006
2017,2,6,6,11690,12377,9422,-2955
2017,2,6,7,11360,12272,9470,-2802
2017,2,6,8,11280,12025,9282,-2743
2017,2,6,9,11370,11788,9414,-2374
2017,2,6,10,11850,12030,9755,-2275
2017,2,6,11,12740,12626,10113,-2513
2017,2,6,12,14720,14439,11806,-2633
2017,2,6,13,15610,15407,12692,-2715
2017,2,6,14,15620,15312,12436,-2876
2017,2,6,15,15420,14895,11851,-3044
2017,2,6,16,15140,14680,11714,-2966
2017,2,6,17,15010,14510,11303,-3207
2017,2,6,18,14820,14348,11237,-3111
2017,2,6,19,14740,14409,11246,-3163
2017,2,6,20,14770,14570,11379,-3191
2017,2,6,21,15050,15033,11859,-3174
2017,2,6,22,15860,15807,12612,-3195
2017,2,6,23,17210,17037,13736,-3301
2017,2,7,0,17600,17272,13748,-3524
2017,2,7,1,17150,16860,13516,-3344
2017,2,7,2,16400,16183,12708,-3475
2017,2,7,3,15350,15084,11917,-3167
2017,2,7,4,14080,13772,10402,-3370
2017,2,7,5,12970,12652,9189,-3463
2017,2,7,6,12190,12258,8725,-3533
2017,2,7,7,11740,12122,8591,-3531
2017,2,7,8,11500,11984,8432,-3552
2017,2,7,9,11520,11970,8543,-3427
2017,2,7,10,11850,12301,9001,-3300
2017,2,7,11,12800,13035,9775,-3260
2017,2,7,12,14620,14487,11384,-3103
2017,2,7,13,15630,15626,12420,-3206
2017,2,7,14,15900,16095,12779,-3316
2017,2,7,15,15910,16398,13049,-3349
2017,2,7,16,16080,16634,13410,-3224
2017,2,7,17,16080,16702,13276,-3426
2017,2,7,18,16080,16653,13268,-3385
2017,2,7,19,16070,16656,13282,-3374
2017,2,7,20,16020,16567,13273,-3294
2017,2,7,21,16140,16526,13644,-2882
2017,2,7,22,16600,16885,14010,-2875
2017,2,7,23,17460,17751,14768,-2983
2017,2,8,0,17420,17709,14811,-2898
2017,2,8,1,16760,17168,14236,-2932
2017,2,8,2,16100,16395,13324,-3071
2017,2,8,3,14960,15299,12316,-2983
2017,2,8,4,13610,14206,11484,-2722
2017,2,8,5,12490,13516,10824,-2692
2017,2,8,6,11660,12801,9707,-3094
2017,2,8,7,11210,12649,9591,-3058
2017,2,8,8,10960,12619,9425,-3194
2017,2,8,9,10910,12376,9350,-3026
2017,2,8,10,11200,12583,9470,-3113
2017,2,8,11,12730,13098,9940,-3158
2017,2,8,12,14560,14545,11426,-3119
2017,2,8,13,15270,15554,12242,-3312
2017,2,8,14,15140,15848,12491,-3357
2017,2,8,15,14970,15690,12402,-3288
2017,2,8,16,14660,15267,11948,-3319
2017,2,8,17,14440,14704,11616,-3088
2017,2,8,18,14170,14382,11555,-2827
2017,2,8,19,14140,14266,11684,-2582
2017,2,8,20,14190,14304,11709,-2595
2017,2,8,21,14340,14461,11658,-2803
2017,2,8,22,14900,15036,12306,-2730
2017,2,8,23,16180,15986,13075,-2911
2017,2,9,0,16350,16316,13509,-2807
2017,2,9,1,16070,15963,13099,-2864
2017,2,9,2,15540,15409,12543,-2866
2017,2,9,3,14630,14573,11783,-2790
2017,2,9,4,13360,13739,11302,-2437
2017,2,9,5,12310,13039,10771,-2268
2017,2,9,6,11920,13034,9946,-3088
2017,2,9,7,11570,12642,9384,-3258
2017,2,9,8,11510,12466,9428,-3038
2017,2,9,9,11490,12442,9474,-2968
2017,2,9,10,11960,12727,9785,-2942
2017,2,9,11,13030,13051,10421,-2630
2017,2,9,12,14930,13717,11370,-2347
2017,2,9,13,15910,14693,12296,-2397
2017,2,9,14,16450,15305,12667,-2638
2017,2,9,15,16780,16026,13503,-2523
2017,2,9,16,16960,16589,13874,-2715
2017,2,9,17,17000,16515,13662,-2853
2017,2,9,18,17100,17043,14081,-2962
2017,2,9,19,17060,16961,13801,-3160
2017,2,9,20,17170,16708,13490,-3218
2017,2,9,21,17210,16550,13238,-3312
2017,2,9,22,17690,16807,13469,-3338
2017,2,9,23,18900,17830,14475,-3355
2017,2,10,0,18850,18124,14626,-3498
2017,2,10,1,18200,17659,14353,-3306
2017,2,10,2,17710,17038,13874,-3164
2017,2,10,3,16780,16169,13143,-3026
2017,2,10,4,15550,15086,11870,-3216
2017,2,10,5,14480,14101,11127,-2974
2017,2,10,6,13690,13816,10450,-3366
2017,2,10,7,13310,13906,10227,-3679
2017,2,10,8,13110,13672,10151,-3521
2017,2,10,9,13230,13577,10317,-3260
2017,2,10,10,13600,13697,10591,-3106
2017,2,10,11,14510,14343,11459,-2884
2017,2,10,12,16350,15838,13270,-2568
2017,2,10,13,17260,16805,13899,-2906
2017,2,10,14,17320,17123,13835,-3288
2017,2,10,15,17290,17132,13909,-3223
2017,2,10,16,17270,17134,14088,-3046
2017,2,10,17,17160,16985,13925,-3060
2017,2,10,18,17080,16745,13525,-3220
2017,2,10,19,16870,16535,13220,-3315
2017,2,10,20,16790,16314,13093,-3221
2017,2,10,21,16850,16222,13009,-3213
2017,2,10,22,17150,16578,13451,-3127
2017,2,10,23,18140,17529,14308,-3221
2017,2,11,0,18400,17853,14660,-3193
2017,2,11,1,17970,17502,14315,-3187
2017,2,11,2,17450,16938,13678,-3260
2017,2,11,3,16590,16117,13063,-3054
2017,2,11,4,15510,15075,11841,-3234
2017,2,11,5,14410,14078,10697,-3381
2017,2,11,6,13420,13351,10288,-3063
2017,2,11,7,12890,12890,9939,-2951
2017,2,11,8,12580,12642,9805,-2837
2017,2,11,9,12540,12541,9829,-2712
2017,2,11,10,12580,12635,9920,-2715
2017,2,11,11,12890,13002,10305,-2697
2017,2,11,12,13280,13654,11090,-2564
2017,2,11,13,14020,14358,11772,-2586
2017,2,11,14,14860,15272,12640,-2632
2017,2,11,15,15410,15927,13204,-2723
2017,2,11,16,15520,16221,13335,-2886
2017,2,11,17,15420,16202,13217,-2985
2017,2,11,18,15210,16010,12821,-3189
2017,2,11,19,15000,15735,12413,-3322
2017,2,11,20,14820,15496,12307,-3189
2017,2,11,21,14880,15417,12243,-3174
2017,2,11,22,15280,15744,12554,-3190
2017,2,11,23,16220,16647,13150,-3497
2017,2,12,0,16280,16861,13520,-3341
2017,2,12,1,15700,16403,13140,-3263
2017,2,12,2,15190,15893,13079,-2814
2017,2,12,3,14650,15198,12438,-2760
2017,2,12,4,13830,14336,11202,-3134
2017,2,12,5,13040,13451,10187,-3264
2017,2,12,6,12410,12952,9625,-3327
2017,2,12,7,11980,12842,9594,-3248
2017,2,12,8,11740,13041,9800,-3241
2017,2,12,9,11650,12801,9694,-3107
2017,2,12,10,12020,12691,9710,-2981
2017,2,12,11,12210,12651,9662,-2989
2017,2,12,12,12660,13184,10146,-3038
2017,2,12,13,13310,13810,10839,-2971
2017,2,12,14,14030,14674,11855,-2819
2017,2,12,15,14640,15124,12395,-2729
2017,2,12,16,14870,15563,12723,-2840
2017,2,12,17,15190,15917,12818,-3099
2017,2,12,18,15260,16078,13058,-3020
2017,2,12,19,15240,16124,13049,-3075
2017,2,12,20,15160,16094,12937,-3157
2017,2,12,21,15260,16141,13029,-3112
2017,2,12,22,15760,16498,13352,-3146
2017,2,12,23,16790,17320,14298,-3022
2017,2,13,0,16800,17383,14220,-3163
2017,2,13,1,16150,16715,13398,-3317
2017,2,13,2,15390,15819,12454,-3365
2017,2,13,3,14390,14887,11493,-3394
2017,2,13,4,13520,14124,11068,-3056
2017,2,13,5,12440,13432,10082,-3350
2017,2,13,6,11850,12872,9406,-3466
2017,2,13,7,11480,12910,9339,-3571
2017,2,13,8,11310,12769,9223,-3546
2017,2,13,9,11390,12787,9216,-3571
2017,2,13,10,12120,13115,9460,-3655
2017,2,13,11,13170,13467,10025,-3442
2017,2,13,12,14920,14109,11039,-3070
2017,2,13,13,15900,15027,12170,-2857
2017,2,13,14,16290,15811,12865,-2946
2017,2,13,15,16400,16214,13174,-3040
2017,2,13,16,16480,16408,13300,-3108
2017,2,13,17,16410,16467,13130,-3337
2017,2,13,18,16210,16313,12919,-3394
2017,2,13,19,16150,16150,12880,-3270
2017,2,13,20,16020,16054,12880,-3174
2017,2,13,21,16140,16050,12992,-3058
2017,2,13,22,16460,16454,13068,-3386
2017,2,13,23,17740,17571,14063,-3508
2017,2,14,0,18130,18003,14463,-3540
2017,2,14,1,17720,17580,13999,-3581
2017,2,14,2,16990,16907,13660,-3247
2017,2,14,3,15970,15896,12329,-3567
2017,2,14,4,14590,14963,11498,-3465
2017,2,14,5,13540,13925,10433,-3492
2017,2,14,6,12750,13319,9674,-3645
2017,2,14,7,12400,13189,9492,-3697
2017,2,14,8,12270,13269,9614,-3655
2017,2,14,9,12310,13329,9826,-3503
2017,2,14,10,12680,13540,10116,-3424
2017,2,14,11,13640,14227,11161,-3066
2017,2,14,12,15350,15500,12835,-2665
2017,2,14,13,16240,16363,13681,-2682
2017,2,14,14,16360,16282,13383,-2899
2017,2,14,15,16120,16048,13103,-2945
2017,2,14,16,15930,15901,13061,-2840
2017,2,14,17,15770,15575,12699,-2876
2017,2,14,18,15500,15206,12375,-2831
2017,2,14,19,15470,14988,11966,-3022
2017,2,14,20,15440,14844,11724,-3120
2017,2,14,21,15500,15137,11938,-3199
2017,2,14,22,16050,15624,12496,-3128
2017,2,14,23,17350,16553,13511,-3042
2017,2,15,0,17800,17182,13867,-3315
2017,2,15,1,17230,16865,13667,-3198
2017,2,15,2,16620,16299,13495,-2804
2017,2,15,3,15600,15378,12536,-2842
2017,2,15,4,14320,14158,11408,-2750
2017,2,15,5,13260,13089,10166,-2923
2017,2,15,6,12490,12416,9121,-3295
2017,2,15,7,12080,12277,8828,-3449
2017,2,15,8,11880,12349,8980,-3369
2017,2,15,9,11870,12426,9119,-3307
2017,2,15,10,12180,12753,9564,-3189
2017,2,15,11,13230,13330,10368,-2962
2017,2,15,12,14990,15017,12413,-2604
2017,2,15,13,15890,15907,13634,-2273
2017,2,15,14,15960,16045,13703,-2342
2017,2,15,15,15910,16039,13401,-2638
2017,2,15,16,15970,16042,13479,-2563
2017,2,15,17,15850,15907,13364,-2543
2017,2,15,18,15710,15719,13266,-2453
2017,2,15,19,15730,15600,13120,-2480
2017,2,15,20,15670,15446,12962,-2484
2017,2,15,21,15680,15504,12931,-2573
2017,2,15,22,16260,15891,13193,-2698
2017,2,15,23,17300,16843,14372,-2471
2017,2,16,0,17500,17165,14470,-2695
2017,2,16,1,16820,16778,14117,-2661
2017,2,16,2,16150,16123,13606,-2517
2017,2,16,3,15140,15114,12531,-2583
2017,2,16,4,13880,13869,11046,-2823
2017,2,16,5,12840,12761,9846,-2915
2017,2,16,6,12180,12353,9369,-2984
2017,2,16,7,11820,12542,9224,-3318
2017,2,16,8,11670,12593,9261,-3332
2017,2,16,9,11680,12382,9315,-3067
2017,2,16,10,11970,12723,9568,-3155
2017,2,16,11,12980,13437,10415,-3022
2017,2,16,12,14730,14707,11809,-2898
2017,2,16,13,15640,15617,12757,-2860
2017,2,16,14,15870,15733,12685,-3048
2017,2,16,15,15880,15690,12676,-3014
2017,2,16,16,15810,15665,12741,-2924
2017,2,16,17,15720,15626,12588,-3038
2017,2,16,18,15560,15459,12399,-3060
2017,2,16,19,15470,15355,12370,-2985
2017,2,16,20,15410,15352,12416,-2936
2017,2,16,21,15520,15471,12576,-2895
2017,2,16,22,16070,15904,13082,-2822
2017,2,16,23,17120,16998,14278,-2720
2017,2,17,0,17480,17531,15121,-2410
2017,2,17,1,17110,17237,14989,-2248
2017,2,17,2,16550,16676,14264,-2412
2017,2,17,3,15590,15742,13201,-2541
2017,2,17,4,14340,14467,11754,-2713
2017,2,17,5,13300,13545,10863,-2682
2017,2,17,6,12510,13004,10249,-2755
2017,2,17,7,12180,12649,9768,-2881
2017,2,17,8,12050,12496,9541,-2955
2017,2,17,9,12090,12515,9436,-3079
2017,2,17,10,12550,12812,9830,-2982
2017,2,17,11,13540,13611,10667,-2944
2017,2,17,12,15180,15344,12467,-2877
2017,2,17,13,15900,16163,13919,-2244
2017,2,17,14,15910,15981,13586,-2395
2017,2,17,15,15590,15678,13056,-2622
2017,2,17,16,15320,15435,12791,-2644
2017,2,17,17,15130,15163,12420,-2743
2017,2,17,18,14770,14821,11973,-2848
2017,2,17,19,14620,14606,11734,-2872
2017,2,17,20,14550,14468,11551,-2917
2017,2,17,21,14680,14559,11511,-3048
2017,2,17,22,15290,15111,12165,-2946
2017,2,17,23,16320,16168,13328,-2840
2017,2,18,0,16730,16640,13837,-2803
2017,2,18,1,16370,16270,13493,-2777
2017,2,18,2,15820,15762,13013,-2749
2017,2,18,3,15070,15014,12186,-2828
2017,2,18,4,14100,14027,11116,-2911
2017,2,18,5,13150,13038,10156,-2882
2017,2,18,6,12480,12601,9528,-3073
2017,2,18,7,12080,12187,9100,-3087
2017,2,18,8,11850,11958,9030,-2928
2017,2,18,9,11770,11876,9049,-2827
2017,2,18,10,11970,12005,9215,-2790
2017,2,18,11,12190,12436,9564,-2872
2017,2,18,12,12830,13107,10160,-2947
2017,2,18,13,13330,13459,10838,-2621
2017,2,18,14,13920,13865,11120,-2745
2017,2,18,15,13970,13904,11185,-2719
2017,2,18,16,13880,13687,11453,-2234
2017,2,18,17,13630,13404,11274,-2130
2017,2,18,18,13390,13022,10729,-2293
2017,2,18,19,13180,12680,10289,-2391
2017,2,18,20,12980,12486,10039,-2447
2017,2,18,21,13180,12686,10123,-2563
2017,2,18,22,13730,13260,10795,-2465
2017,2,18,23,14720,14320,11752,-2568
2017,2,19,0,15200,14893,12203,-2690
2017,2,19,1,14770,14555,11836,-2719
2017,2,19,2,14180,14079,11339,-2740
2017,2,19,3,13510,13463,10944,-2519
2017,2,19,4,12710,12635,10099,-2536
2017,2,19,5,11880,11770,9136,-2634
2017,2,19,6,11130,11347,8847,-2500
2017,2,19,7,10730,11076,8567,-2509
2017,2,19,8,10510,10854,8499,-2355
2017,2,19,9,10410,11027,8641,-2386
2017,2,19,10,10500,11273,8721,-2552
2017,2,19,11,10600,11431,8848,-2583
2017,2,19,12,10910,11741,9053,-2688
2017,2,19,13,11280,12413,9572,-2841
2017,2,19,14,11970,12430,9690,-2740
2017,2,19,15,12440,12363,9806,-2557
2017,2,19,16,12520,12530,9690,-2840
2017,2,19,17,12500,12490,9575,-2915
2017,2,19,18,12380,12287,9392,-2895
2017,2,19,19,12200,12281,9508,-2773
2017,2,19,20,12190,12291,9541,-2750
2017,2,19,21,12580,12564,9808,-2756
2017,2,19,22,13290,12975,10250,-2725
2017,2,19,23,14430,13817,11067,-2750
2017,2,20,0,15150,14479,12085,-2394
2017,2,20,1,14800,14098,11834,-2264
2017,2,20,2,14170,13572,11223,-2349
2017,2,20,3,13290,12840,10515,-2325
2017,2,20,4,12350,11985,9830,-2155
2017,2,20,5,11490,11318,8853,-2465
2017,2,20,6,10980,10972,8608,-2364
2017,2,20,7,10610,11027,8577,-2450
2017,2,20,8,10500,11132,8606,-2526
2017,2,20,9,10560,11232,8647,-2585
2017,2,20,10,10900,11379,8945,-2434
2017,2,20,11,11340,12116,9692,-2424
2017,2,20,12,12660,12976,10379,-2597
2017,2,20,13,13320,13487,11256,-2231
2017,2,20,14,13830,13689,11670,-2019
2017,2,20,15,13960,13478,11230,-2248
2017,2,20,16,14090,13385,11001,-2384
2017,2,20,17,13920,13257,10990,-2267
2017,2,20,18,13740,13050,10753,-2297
2017,2,20,19,13680,12917,10787,-2130
2017,2,20,20,13570,12925,10919,-2006
2017,2,20,21,13700,13255,11267,-1988
2017,2,20,22,14330,14097,11826,-2271
2017,2,20,23,15620,15330,12673,-2657
2017,2,21,0,16450,16030,13456,-2574
2017,2,21,1,15890,15654,13304,-2350
2017,2,21,2,15190,15095,12759,-2336
2017,2,21,3,14300,14225,11919,-2306
2017,2,21,4,13250,13136,10858,-2278
2017,2,21,5,12220,12155,9746,-2409
2017,2,21,6,11580,11579,9159,-2420
2017,2,21,7,11250,11488,9025,-2463
2017,2,21,8,11140,11406,8889,-2517
2017,2,21,9,11160,11490,8915,-2575
2017,2,21,10,11510,11894,9304,-2590
2017,2,21,11,12640,12690,10078,-2612
2017,2,21,12,14200,14264,11537,-2727
2017,2,21,13,15010,15042,12464,-2578
2017,2,21,14,14880,14853,12305,-2548
2017,2,21,15,14550,14486,12191,-2295
2017,2,21,16,14360,14283,12068,-2215
2017,2,21,17,14170,14010,11648,-2362
2017,2,21,18,13960,13814,11579,-2235
2017,2,21,19,13950,13853,11795,-2058
2017,2,21,20,13960,13904,11811,-2093
2017,2,21,21,14250,14216,12059,-2157
2017,2,21,22,14910,14840,12542,-2298
2017,2,21,23,15840,15942,13521,-2421
2017,2,22,0,16360,16413,13788,-2625
2017,2,22,1,16030,16020,13499,-2521
2017,2,22,2,15490,15370,12979,-2391
2017,2,22,3,14530,14408,12164,-2244
2017,2,22,4,13300,13192,10781,-2411
2017,2,22,5,12230,12088,9266,-2822
2017,2,22,6,11440,11378,8720,-2658
2017,2,22,7,11030,11212,8545,-2667
2017,2,22,8,10840,11258,8562,-2696
2017,2,22,9,10850,11029,8492,-2537
2017,2,22,10,11200,11228,8672,-2556
2017,2,22,11,12190,11953,9667,-2286
2017,2,22,12,13850,13506,11365,-2141
2017,2,22,13,14740,14405,12143,-2262
2017,2,22,14,14830,14549,12311,-2238
2017,2,22,15,14570,14313,12269,-2044
2017,2,22,16,14410,13962,11908,-2054
2017,2,22,17,14160,13691,11674,-2017
2017,2,22,18,13940,13419,11457,-1962
2017,2,22,19,13860,13316,11426,-1890
2017,2,22,20,13780,13308,11299,-2009
2017,2,22,21,13880,13425,11450,-1975
2017,2,22,22,14470,13996,11875,-2121
2017,2,22,23,15510,14989,12675,-2314
2017,2,23,0,16050,15640,13268,-2372
2017,2,23,1,15660,15298,12791,-2507
2017,2,23,2,15050,14723,12332,-2391
2017,2,23,3,14050,13857,11165,-2692
2017,2,23,4,12860,12685,10129,-2556
2017,2,23,5,11800,11633,9466,-2167
2017,2,23,6,11020,11198,9029,-2169
2017,2,23,7,10600,11127,8994,-2133
2017,2,23,8,10410,11065,8870,-2195
2017,2,23,9,10390,11052,8798,-2254
2017,2,23,10,10750,11309,8902,-2407
2017,2,23,11,11740,12104,9846,-2258
2017,2,23,12,13380,13274,11242,-2032
2017,2,23,13,14160,14114,11886,-2228
2017,2,23,14,13980,14016,11557,-2459
2017,2,23,15,13640,13652,11317,-2335
2017,2,23,16,13370,13446,11109,-2337
2017,2,23,17,13140,13256,11135,-2121
2017,2,23,18,12930,13047,11056,-1991
2017,2,23,19,12910,13026,10637,-2389
2017,2,23,20,12930,13073,10714,-2359
2017,2,23,21,13300,13332,10934,-2398
2017,2,23,22,13900,13814,11290,-2524
2017,2,23,23,14970,14611,11788,-2823
2017,2,24,0,15510,15219,12491,-2728
2017,2,24,1,15170,14887,12663,-2224
2017,2,24,2,14490,14294,12199,-2095
2017,2,24,3,13540,13421,11569,-1852
2017,2,24,4,12350,12281,10572,-1709
2017,2,24,5,11280,11425,9841,-1584
2017,2,24,6,10530,10857,8862,-1995
2017,2,24,7,10100,10627,8627,-2000
2017,2,24,8,9900,10402,8568,-1834
2017,2,24,9,9870,10361,8479,-1882
2017,2,24,10,10210,10700,8491,-2209
2017,2,24,11,11160,11668,9405,-2263
2017,2,24,12,12770,12517,10610,-1907
2017,2,24,13,13770,13325,11036,-2289
2017,2,24,14,13990,13476,11535,-1941
2017,2,24,15,14010,13506,11650,-1856
2017,2,24,16,13860,13488,11868,-1620
2017,2,24,17,13740,13319,11749,-1570
2017,2,24,18,13540,13138,11643,-1495
2017,2,24,19,13470,13062,11553,-1509
2017,2,24,20,13440,13072,11391,-1681
2017,2,24,21,13500,13190,11618,-1572
2017,2,24,22,13920,13548,11726,-1822
2017,2,24,23,14520,14189,12044,-2145
2017,2,25,0,14900,14640,12469,-2171
2017,2,25,1,14470,14195,12171,-2024
2017,2,25,2,13700,13594,11662,-1932
2017,2,25,3,12950,12816,10986,-1830
2017,2,25,4,11990,11879,10052,-1827
2017,2,25,5,11040,10889,8982,-1907
2017,2,25,6,10290,10415,8528,-1887
2017,2,25,7,9870,9969,8250,-1719
2017,2,25,8,9640,9964,8116,-1848
2017,2,25,9,9520,10131,8203,-1928
2017,2,25,10,9650,10055,8188,-1867
2017,2,25,11,9760,10261,8320,-1941
2017,2,25,12,10400,10672,8474,-2198
2017,2,25,13,11070,11496,9250,-2246
2017,2,25,14,11840,11888,9895,-1993
2017,2,25,15,12280,12332,10511,-1821
2017,2,25,16,12410,12439,10403,-2036
2017,2,25,17,12370,12368,10330,-2038
2017,2,25,18,12170,12224,10101,-2123
2017,2,25,19,11940,12113,9834,-2279
2017,2,25,20,11950,12098,9786,-2312
2017,2,25,21,12110,12254,9831,-2423
2017,2,25,22,12680,12676,10362,-2314
2017,2,25,23,13450,13514,11171,-2343
2017,2,26,0,13900,13876,11257,-2619
2017,2,26,1,13390,13440,11076,-2364
2017,2,26,2,12820,12921,10504,-2417
2017,2,26,3,12200,12272,9941,-2331
2017,2,26,4,11460,11551,9219,-2332
2017,2,26,5,10650,10951,8780,-2171
2017,2,26,6,10000,10604,8774,-1830
2017,2,26,7,9700,10633,8779,-1854
2017,2,26,8,9530,10576,8984,-1592
2017,2,26,9,9460,10438,8894,-1544
2017,2,26,10,9650,10449,8657,-1792
2017,2,26,11,10060,10741,8795,-1946
2017,2,26,12,10510,11511,9016,-2495
2017,2,26,13,10970,12047,9463,-2584
2017,2,26,14,11670,12184,9755,-2429
2017,2,26,15,12040,12128,9726,-2402
2017,2,26,16,12140,12199,9713,-2486
2017,2,26,17,12230,12137,9837,-2300
2017,2,26,18,12210,12221,10020,-2201
2017,2,26,19,12180,12201,9822,-2379
2017,2,26,20,12220,12232,9870,-2362
2017,2,26,21,12450,12581,10220,-2361
2017,2,26,22,13230,13229,10749,-2480
2017,2,26,23,14510,14525,11985,-2540
2017,2,27,0,15200,15381,12741,-2640
2017,2,27,1,14840,15150,12631,-2519
2017,2,27,2,14330,14590,12044,-2546
2017,2,27,3,13440,13711,11169,-2542
2017,2,27,4,12450,12669,10220,-2449
2017,2,27,5,11580,11789,9223,-2566
2017,2,27,6,10950,11232,8859,-2373
2017,2,27,7,10620,11065,8665,-2400
2017,2,27,8,10530,11202,8854,-2348
2017,2,27,9,10600,11281,8995,-2286
2017,2,27,10,11250,11521,9293,-2228
2017,2,27,11,12310,12411,10188,-2223
2017,2,27,12,14180,14118,11675,-2443
2017,2,27,13,14930,14824,12239,-2585
2017,2,27,14,14620,14496,12007,-2489
2017,2,27,15,14190,14094,11848,-2246
2017,2,27,16,13900,13837,11449,-2388
2017,2,27,17,13680,13535,11097,-2438
2017,2,27,18,13510,13313,10912,-2401
2017,2,27,19,13420,13314,10832,-2482
2017,2,27,20,13450,13384,10869,-2515
2017,2,27,21,13580,13547,10991,-2556
2017,2,27,22,14110,14121,11766,-2355
2017,2,27,23,15360,15169,12717,-2452
2017,2,28,0,15930,15972,13435,-2537
2017,2,28,1,15610,15644,13217,-2427
2017,2,28,2,14960,14999,12793,-2206
2017,2,28,3,13970,14007,12014,-1993
2017,2,28,4,12740,12752,10695,-2057
2017,2,28,5,11670,11673,9601,-2072
2017,2,28,6,10970,11324,9541,-1783
2017,2,28,7,10660,11565,9303,-2262
2017,2,28,8,10510,11571,9360,-2211
2017,2,28,9,10520,11554,9417,-2137
2017,2,28,10,10880,11863,9648,-2215
2017,2,28,11,11950,12568,10189,-2379
2017,2,28,12,13680,13627,11349,-2278
2017,2,28,13,14410,14499,12483,-2016
2017,2,28,14,14450,14638,12642,-1996
2017,2,28,15,14330,14403,12559,-1844
2017,2,28,16,14250,13987,12170,-1817
2017,2,28,17,14080,13677,11672,-2005
2017,2,28,18,13870,13448,11474,-1974
2017,2,28,19,13810,13312,11362,-1950
2017,2,28,20,13880,13311,11154,-2157
2017,2,28,21,13980,13621,11612,-2009
2017,2,28,22,14500,14202,12339,-1863
2017,2,28,23,15560,15171,13129,-2042
2017,3,1,0,15950,15625,13613,-2012
2017,3,1,1,15490,15213,13313,-1900
2017,3,1,2,14730,14562,12462,-2100
2017,3,1,3,13680,13539,11420,-2119
2017,3,1,4,12430,12402,10249,-2153
2017,3,1,5,11320,11633,9617,-2016
2017,3,1,6,10560,11241,9052,-2189
2017,3,1,7,10160,11007,9011,-1996
2017,3,1,8,9970,10645,8437,-2208
2017,3,1,9,9980,10602,8457,-2145
2017,3,1,10,10220,10911,8974,-1937
2017,3,1,11,11240,11700,9651,-2049
2017,3,1,12,12830,12800,10792,-2008
2017,3,1,13,13790,13789,11699,-2090
2017,3,1,14,13970,14036,12023,-2013
2017,3,1,15,13970,14159,12110,-2049
2017,3,1,16,14140,14292,11954,-2338
2017,3,1,17,14030,14299,11907,-2392
2017,3,1,18,13940,14209,11546,-2663
2017,3,1,19,13900,14088,11302,-2786
2017,3,1,20,13990,13992,11211,-2781
2017,3,1,21,14100,14090,11231,-2859
2017,3,1,22,14510,14372,11725,-2647
2017,3,1,23,15170,15063,12475,-2588
2017,3,2,0,15700,15472,13155,-2317
2017,3,2,1,15290,15075,12962,-2113
2017,3,2,2,14540,14430,11848,-2582
2017,3,2,3,13520,13409,10759,-2650
2017,3,2,4,12170,12156,9751,-2405
2017,3,2,5,11100,11122,9164,-1958
2017,3,2,6,10360,10951,8571,-2380
2017,3,2,7,9890,10894,8603,-2291
2017,3,2,8,9650,10746,8767,-1979
2017,3,2,9,9660,10964,8706,-2258
2017,3,2,10,9920,11193,8667,-2526
2017,3,2,11,10990,11408,9365,-2043
2017,3,2,12,12650,12600,10346,-2254
2017,3,2,13,13600,13400,10744,-2656
2017,3,2,14,13780,13532,11013,-2519
2017,3,2,15,13730,13529,10954,-2575
2017,3,2,16,13320,13314,10596,-2718
2017,3,2,17,13290,13071,10347,-2724
2017,3,2,18,13230,12950,10512,-2438
2017,3,2,19,13040,13022,10632,-2390
2017,3,2,20,13260,13110,10839,-2271
2017,3,2,21,13620,13376,10938,-2438
2017,3,2,22,14290,14169,11736,-2433
2017,3,2,23,15320,15309,12951,-2358
2017,3,3,0,16000,16228,13858,-2370
2017,3,3,1,15850,16046,13634,-2412
2017,3,3,2,15450,15602,13537,-2065
2017,3,3,3,14580,14725,12735,-1990
2017,3,3,4,13370,13532,11075,-2457
2017,3,3,5,12360,12901,10494,-2407
2017,3,3,6,11740,12266,10193,-2073
2017,3,3,7,11340,11996,10067,-1929
2017,3,3,8,11190,12098,10135,-1963
2017,3,3,9,11260,12144,10135,-2009
2017,3,3,10,11640,12345,10352,-1993
2017,3,3,11,12800,13441,11393,-2048
2017,3,3,12,14460,14596,12885,-1711
2017,3,3,13,15230,15192,13486,-1706
2017,3,3,14,15220,14910,13141,-1769
2017,3,3,15,14940,14517,12740,-1777
2017,3,3,16,14760,14209,12222,-1987
2017,3,3,17,14550,13986,11980,-2006
2017,3,3,18,14400,13764,11793,-1971
2017,3,3,19,14290,13860,11785,-2075
2017,3,3,20,14280,14126,11861,-2265
2017,3,3,21,14440,14544,12206,-2338
2017,3,3,22,15010,14840,12627,-2213
2017,3,3,23,15850,15712,13123,-2589
2017,3,4,0,16480,16369,13707,-2662
2017,3,4,1,16150,16114,13475,-2639
2017,3,4,2,15710,15708,13292,-2416
2017,3,4,3,15140,15102,12928,-2174
2017,3,4,4,14260,14233,12260,-1973
2017,3,4,5,13300,13338,11598,-1740
2017,3,4,6,12720,12781,10781,-2000
2017,3,4,7,12380,12701,10524,-2177
2017,3,4,8,12250,12586,10189,-2397
2017,3,4,9,12220,12610,10134,-2476
2017,3,4,10,12430,12798,10429,-2369
2017,3,4,11,12940,13048,10819,-2229
2017,3,4,12,13730,13703,11429,-2274
2017,3,4,13,14440,14261,11799,-2462
2017,3,4,14,15110,14651,12259,-2392
2017,3,4,15,15290,14855,12483,-2372
2017,3,4,16,15320,15123,12664,-2459
2017,3,4,17,15130,15195,12708,-2487
2017,3,4,18,14960,14939,12456,-2483
2017,3,4,19,14640,14486,12088,-2398
2017,3,4,20,14580,14274,11881,-2393
2017,3,4,21,14760,14554,11999,-2555
2017,3,4,22,15220,15325,12700,-2625
2017,3,4,23,16310,16453,13566,-2887
2017,3,5,0,17110,17276,14775,-2501
2017,3,5,1,16970,17068,14440,-2628
2017,3,5,2,16670,16718,14085,-2633
2017,3,5,3,16020,16152,13735,-2417
2017,3,5,4,15270,15301,12811,-2490
2017,3,5,5,14320,14504,12000,-2504
2017,3,5,6,13700,13922,11505,-2417
2017,3,5,7,13360,13566,10870,-2696
2017,3,5,8,13190,13401,10747,-2654
2017,3,5,9,13120,13352,10703,-2649
2017,3,5,10,13250,13438,10774,-2664
2017,3,5,11,13800,13799,11261,-2538
2017,3,5,12,14130,14399,11845,-2554
2017,3,5,13,14690,14390,11965,-2425
2017,3,5,14,14850,14525,12269,-2256
2017,3,5,15,14870,14499,12116,-2383
2017,3,5,16,14800,14409,11991,-2418
2017,3,5,17,14540,14265,11818,-2447
2017,3,5,18,14290,14037,11602,-2435
2017,3,5,19,13990,13764,11460,-2304
2017,3,5,20,13920,13889,11445,-2444
2017,3,5,21,14290,14254,11705,-2549
2017,3,5,22,14770,15089,12455,-2634
2017,3,5,23,16110,16080,13413,-2667
2017,3,6,0,17110,17028,14313,-2715
2017,3,6,1,16810,16798,14269,-2529
2017,3,6,2,16330,16293,13460,-2833
2017,3,6,3,15470,15383,12509,-2874
2017,3,6,4,14520,14275,11716,-2559
2017,3,6,5,13570,13567,11027,-2540
2017,3,6,6,13100,13065,10508,-2557
2017,3,6,7,12850,13088,10361,-2727
2017,3,6,8,12750,13067,10288,-2779
2017,3,6,9,12880,13167,10302,-2865
2017,3,6,10,13280,13527,10729,-2798
2017,3,6,11,14440,14247,11694,-2553
2017,3,6,12,16340,15870,13597,-2273
2017,3,6,13,17080,16383,14172,-2211
2017,3,6,14,16440,15905,13639,-2266
2017,3,6,15,15650,15354,13156,-2198
2017,3,6,16,15320,14965,13098,-1867
2017,3,6,17,15030,14621,12785,-1836
2017,3,6,18,14630,14244,12366,-1878
2017,3,6,19,14260,14320,12338,-1982
2017,3,6,20,14200,14289,12107,-2182
2017,3,6,21,14360,14552,12227,-2325
2017,3,6,22,15030,14983,12788,-2195
2017,3,6,23,16310,16063,13679,-2384
2017,3,7,0,17220,16875,14343,-2532
2017,3,7,1,17040,16574,14005,-2569
2017,3,7,2,16410,15936,13416,-2520
2017,3,7,3,15340,14894,12396,-2498
2017,3,7,4,14010,13602,11011,-2591
2017,3,7,5,12960,12595,9942,-2653
2017,3,7,6,12170,12046,9377,-2669
2017,3,7,7,11950,11718,9237,-2481
2017,3,7,8,11730,11864,9575,-2289
2017,3,7,9,11720,12030,10002,-2028
2017,3,7,10,11600,12094,9934,-2160
2017,3,7,11,12670,12841,10642,-2199
2017,3,7,12,14290,14263,12045,-2218
2017,3,7,13,15070,15248,13348,-1900
2017,3,7,14,15200,15407,13430,-1977
2017,3,7,15,15230,15418,13479,-1939
2017,3,7,16,15140,15484,13490,-1994
2017,3,7,17,15070,15428,13188,-2240
2017,3,7,18,15000,15299,13087,-2212
2017,3,7,19,14900,15209,12885,-2324
2017,3,7,20,14880,15333,13073,-2260
2017,3,7,21,14930,15495,13298,-2197
2017,3,7,22,15310,15584,13175,-2409
2017,3,7,23,16200,16184,13547,-2637
2017,3,8,0,16730,16396,13855,-2541
2017,3,8,1,16320,15969,13417,-2552
2017,3,8,2,15520,15231,12841,-2390
2017,3,8,3,14410,14166,11540,-2626
2017,3,8,4,12920,13118,10290,-2828
2017,3,8,5,11730,12195,9868,-2327
2017,3,8,6,10990,11561,9335,-2226
2017,3,8,7,10620,11272,9157,-2115
2017,3,8,8,10420,11416,9162,-2254
2017,3,8,9,10370,11416,9096,-2320
2017,3,8,10,10630,11301,9116,-2185
2017,3,8,11,11600,11921,9666,-2255
2017,3,8,12,13300,13604,11254,-2350
2017,3,8,13,14350,14467,12304,-2163
2017,3,8,14,14350,14671,12546,-2125
2017,3,8,15,14310,14436,11982,-2454
2017,3,8,16,14170,14121,12022,-2099
2017,3,8,17,13980,13750,11727,-2023
2017,3,8,18,13760,13445,11734,-1711
2017,3,8,19,13570,13409,11716,-1693
2017,3,8,20,13540,13446,11773,-1673
2017,3,8,21,13610,13791,12091,-1700
2017,3,8,22,13990,13963,12335,-1628
2017,3,8,23,14770,14631,13138,-1493
2017,3,9,0,15600,15498,13928,-1570
2017,3,9,1,15510,15298,13661,-1637
2017,3,9,2,14990,14732,12967,-1765
2017,3,9,3,14020,13802,11813,-1989
2017,3,9,4,12800,13025,10884,-2141
2017,3,9,5,11680,12244,10283,-1961
2017,3,9,6,10870,11825,9752,-2073
2017,3,9,7,10450,11642,9624,-2018
2017,3,9,8,10300,11579,9651,-1928
2017,3,9,9,10360,11580,9713,-1867
2017,3,9,10,10510,11805,9969,-1836
2017,3,9,11,11540,12776,10705,-2071
2017,3,9,12,13410,13921,11977,-1944
2017,3,9,13,14260,13957,12259,-1698
2017,3,9,14,13980,13762,12038,-1724
2017,3,9,15,13640,13518,12021,-1497
2017,3,9,16,13360,13448,11721,-1727
2017,3,9,17,13180,13460,11787,-1673
2017,3,9,18,13100,13279,11492,-1787
2017,3,9,19,12960,13282,11598,-1684
2017,3,9,20,13030,13234,11272,-1962
2017,3,9,21,13390,13302,11247,-2055
2017,3,9,22,13780,13944,11936,-2008
2017,3,9,23,14570,14894,12746,-2148
2017,3,10,0,15600,15770,13769,-2001
2017,3,10,1,15450,15586,13670,-1916
2017,3,10,2,15280,15081,13377,-1704
2017,3,10,3,14470,14191,12382,-1809
2017,3,10,4,13260,12978,11167,-1811
2017,3,10,5,12210,12075,9983,-2092
2017,3,10,6,11720,11724,9140,-2584
2017,3,10,7,11230,11238,8962,-2276
2017,3,10,8,10990,10769,9110,-1659
2017,3,10,9,11010,10719,9427,-1292
2017,3,10,10,11060,11108,9305,-1803
2017,3,10,11,12060,12174,10131,-2043
2017,3,10,12,13250,13761,11224,-2537
2017,3,10,13,14420,14812,12150,-2662
2017,3,10,14,15160,15346,12751,-2595
2017,3,10,15,15360,15672,12951,-2721
2017,3,10,16,15710,15880,12821,-3059
2017,3,10,17,15440,15933,13010,-2923
2017,3,10,18,15810,15855,12873,-2982
2017,3,10,19,15410,15734,12545,-3189
2017,3,10,20,15230,15504,12096,-3408
2017,3,10,21,15040,15332,11957,-3375
2017,3,10,22,15230,15447,12281,-3166
2017,3,10,23,16050,15909,12794,-3115
2017,3,11,0,16600,16604,13611,-2993
2017,3,11,1,16320,16367,13611,-2756
2017,3,11,2,15820,15892,13164,-2728
2017,3,11,3,15180,15225,12682,-2543
2017,3,11,4,14300,14331,11889,-2442
2017,3,11,5,13310,13786,11128,-2658
2017,3,11,6,12820,13272,10322,-2950
2017,3,11,7,12350,13086,10057,-3029
2017,3,11,8,12240,13352,10280,-3072
2017,3,11,9,12190,13310,10130,-3180
2017,3,11,10,12460,13657,10238,-3419
2017,3,11,11,13170,14134,10800,-3334
2017,3,11,12,13880,14506,11367,-3139
2017,3,11,13,14620,14911,11660,-3251
2017,3,11,14,15150,15304,12161,-3143
2017,3,11,15,15250,15651,12350,-3301
2017,3,11,16,15750,15738,12479,-3259
2017,3,11,17,15510,15589,12372,-3217
2017,3,11,18,15300,15354,12036,-3318
2017,3,11,19,14950,15143,11935,-3208
2017,3,11,20,14840,15073,12028,-3045
2017,3,11,21,14800,15241,12218,-3023
2017,3,11,22,15140,15709,12580,-3129
2017,3,11,23,15840,16489,12941,-3548
2017,3,12,0,17000,17285,13823,-3462
2017,3,12,1,16730,17056,13681,-3375
2017,3,12,2,16530,16621,13100,-3521
2017,3,12,3,15990,15996,12763,-3233
2017,3,12,4,15250,15157,11735,-3422
2017,3,12,5,14340,14283,11202,-3081
2017,3,12,6,13870,13655,10692,-2963
2017,3,12,7,13250,13260,10927,-2333
2017,3,12,8,13140,13287,10304,-2983
2017,3,12,9,13220,13526,10541,-2985
2017,3,12,10,13400,13671,10744,-2927
2017,3,12,11,14210,13917,11039,-2878
2017,3,12,12,15040,14304,11548,-2756
2017,3,12,13,15280,14738,11720,-3018
2017,3,12,14,15410,14948,11813,-3135
2017,3,12,15,15140,14953,11674,-3279
2017,3,12,16,15090,14845,11575,-3270
2017,3,12,17,14890,14610,11241,-3369
2017,3,12,18,14570,14740,11462,-3278
2017,3,12,19,14540,14861,11419,-3442
2017,3,12,20,14590,14866,11404,-3462
2017,3,12,21,14750,15204,11904,-3300
2017,3,12,22,15520,15781,12353,-3428
2017,3,12,23,16240,16232,12825,-3407
2017,3,13,0,17000,17134,13953,-3181
2017,3,13,1,16400,16920,13952,-2968
2017,3,13,2,15560,16159,13232,-2927
2017,3,13,3,14590,15070,11992,-3078
2017,3,13,4,13700,14001,10721,-3280
2017,3,13,5,13310,13774,10316,-3458
2017,3,13,6,13030,14026,10327,-3699
2017,3,13,7,12950,13952,10175,-3777
2017,3,13,8,13020,14013,10288,-3725
2017,3,13,9,13390,14609,10899,-3710
2017,3,13,10,14450,14808,11817,-2991
2017,3,13,11,16280,16237,14101,-2136
2017,3,13,12,17130,17296,15292,-2004
2017,3,13,13,17070,17055,15122,-1933
2017,3,13,14,16850,16490,14547,-1943
2017,3,13,15,16410,16008,14029,-1979
2017,3,13,16,16120,15530,13134,-2396
2017,3,13,17,15780,15072,12623,-2449
2017,3,13,18,15540,14775,12397,-2378
2017,3,13,19,15360,14807,12309,-2498
2017,3,13,20,15280,14891,12181,-2710
2017,3,13,21,15570,15233,12411,-2822
2017,3,13,22,16230,15504,12838,-2666
2017,3,13,23,16960,16153,13394,-2759
2017,3,14,0,17750,16920,14458,-2462
2017,3,14,1,17270,16625,14105,-2520
2017,3,14,2,16260,15846,13334,-2512
2017,3,14,3,14770,14729,12051,-2678
2017,3,14,4,13660,13641,10746,-2895
2017,3,14,5,12900,12932,10167,-2765
2017,3,14,6,12450,12989,10317,-2672
2017,3,14,7,12190,12915,10280,-2635
2017,3,14,8,12270,12790,10463,-2327
2017,3,14,9,12570,12951,10803,-2148
2017,3,14,10,12750,13303,11215,-2088
2017,3,14,11,14390,13954,11912,-2042
2017,3,14,12,15270,14439,12615,-1824
2017,3,14,13,15970,15051,13040,-2011
2017,3,14,14,16600,15768,13791,-1977
2017,3,14,15,16170,16320,14457,-1863
2017,3,14,16,16590,16620,15009,-1611
2017,3,14,17,16840,16659,14926,-1733
2017,3,14,18,16840,16489,14825,-1664
2017,3,14,19,16600,16203,14671,-1532
2017,3,14,20,16520,15902,14562,-1340
2017,3,14,21,16730,15857,14578,-1279
2017,3,14,22,17130,16076,14606,-1470
2017,3,14,23,17720,16155,14557,-1598
2017,3,15,0,17750,16270,14531,-1739
2017,3,15,1,16980,15722,14033,-1689
2017,3,15,2,16010,14852,12977,-1875
2017,3,15,3,14800,13806,11743,-2063
2017,3,15,4,13720,13161,10842,-2319
2017,3,15,5,12650,12724,10470,-2254
2017,3,15,6,12310,12625,10335,-2290
2017,3,15,7,12110,12597,10143,-2454
2017,3,15,8,12130,12648,10156,-2492
2017,3,15,9,12550,12737,10259,-2478
2017,3,15,10,13180,13430,11225,-2205
2017,3,15,11,14660,14726,12591,-2135
2017,3,15,12,15460,15802,13549,-2253
2017,3,15,13,15640,16250,13627,-2623
2017,3,15,14,15710,16214,13482,-2732
2017,3,15,15,16070,16113,13725,-2388
2017,3,15,16,15890,15965,13736,-2229
2017,3,15,17,15690,15807,13599,-2208
2017,3,15,18,15480,15704,13604,-2100
2017,3,15,19,15380,15668,13685,-1983
2017,3,15,20,15290,15716,13565,-2151
2017,3,15,21,15510,15918,13889,-2029
2017,3,15,22,16090,16397,14406,-1991
2017,3,15,23,16930,16835,14897,-1938
2017,3,16,0,17560,17466,15618,-1848
2017,3,16,1,17100,17125,15217,-1908
2017,3,16,2,16100,16244,14226,-2018
2017,3,16,3,14830,14960,12502,-2458
2017,3,16,4,13610,13797,11145,-2652
2017,3,16,5,12710,13092,10873,-2219
2017,3,16,6,12470,12947,10618,-2329
2017,3,16,7,12340,12830,10644,-2186
2017,3,16,8,12390,12845,10793,-2052
2017,3,16,9,12630,13178,11096,-2082
2017,3,16,10,13650,13911,12100,-1811
2017,3,16,11,15440,15699,14158,-1541
2017,3,16,12,16310,16618,14905,-1713
2017,3,16,13,16280,16529,14641,-1888
2017,3,16,14,15900,16247,14606,-1641
2017,3,16,15,15660,15938,14459,-1479
2017,3,16,16,15420,15598,14155,-1443
2017,3,16,17,15150,15217,13762,-1455
2017,3,16,18,14870,14953,13511,-1442
2017,3,16,19,14730,14683,12961,-1722
2017,3,16,20,14630,14602,12957,-1645
2017,3,16,21,14880,14836,13292,-1544
2017,3,16,22,15490,15376,13769,-1607
2017,3,16,23,16050,16028,14232,-1796
2017,3,17,0,16880,16816,15085,-1731
2017,3,17,1,16460,16599,14738,-1861
2017,3,17,2,15570,15783,14009,-1774
2017,3,17,3,14310,14512,12753,-1759
2017,3,17,4,13310,13345,11525,-1820
2017,3,17,5,12820,12662,10650,-2012
2017,3,17,6,12450,12773,10474,-2299
2017,3,17,7,12310,12850,10274,-2576
2017,3,17,8,12350,12875,10306,-2569
2017,3,17,9,12720,13209,10641,-2568
2017,3,17,10,13440,14227,11604,-2623
2017,3,17,11,15090,15620,13269,-2351
2017,3,17,12,16210,16185,14686,-1499
2017,3,17,13,16300,16067,14406,-1661
2017,3,17,14,15740,15600,14000,-1600
2017,3,17,15,15310,15172,13441,-1731
2017,3,17,16,14950,14786,12659,-2127
2017,3,17,17,14610,14401,12147,-2254
2017,3,17,18,14360,14126,11748,-2378
2017,3,17,19,14140,13801,11419,-2382
2017,3,17,20,13920,13629,11307,-2322
2017,3,17,21,14180,13781,11407,-2374
2017,3,17,22,14700,14178,11700,-2478
2017,3,17,23,15080,14671,12205,-2466
2017,3,18,0,15720,15370,13056,-2314
2017,3,18,1,15600,15210,13083,-2127
2017,3,18,2,14930,14668,12488,-2180
2017,3,18,3,13970,13805,11768,-2037
2017,3,18,4,13040,12897,10445,-2452
2017,3,18,5,12280,12264,9395,-2869
2017,3,18,6,11910,12109,9241,-2868
2017,3,18,7,11800,11958,9200,-2758
2017,3,18,8,11730,12037,9250,-2787
2017,3,18,9,11790,12375,9481,-2894
2017,3,18,10,12270,12559,10009,-2550
2017,3,18,11,12930,13070,11164,-1906
2017,3,18,12,13650,13758,11946,-1812
2017,3,18,13,14330,14111,12111,-2000
2017,3,18,14,14340,14114,12152,-1962
2017,3,18,15,13930,13963,11861,-2102
2017,3,18,16,13550,13681,11790,-1891
2017,3,18,17,13310,13338,11483,-1855
2017,3,18,18,12980,13038,11040,-1998
2017,3,18,19,12790,13050,11111,-1939
2017,3,18,20,12730,13059,10920,-2139
2017,3,18,21,13100,13227,10937,-2290
2017,3,18,22,13500,13848,11373,-2475
2017,3,18,23,14060,14396,11979,-2417
2017,3,19,0,14550,14966,12538,-2428
2017,3,19,1,14440,14711,12542,-2169
2017,3,19,2,13910,14180,11628,-2552
2017,3,19,3,13100,13341,10876,-2465
2017,3,19,4,12270,12570,10186,-2384
2017,3,19,5,11590,12045,9480,-2565
2017,3,19,6,11200,11882,9231,-2651
2017,3,19,7,10970,11985,9242,-2743
2017,3,19,8,10870,11889,9208,-2681
2017,3,19,9,11060,12118,9292,-2826
2017,3,19,10,11340,12241,9429,-2812
2017,3,19,11,11840,12613,9621,-2992
2017,3,19,12,12420,13004,10024,-2980
2017,3,19,13,13000,13495,10538,-2957
2017,3,19,14,13420,13696,10969,-2727
2017,3,19,15,13610,13839,10991,-2848
2017,3,19,16,13650,13842,10976,-2866
2017,3,19,17,13550,13777,10868,-2909
2017,3,19,18,13370,13536,10696,-2840
2017,3,19,19,13250,13269,10340,-2929
2017,3,19,20,13220,13297,10170,-3127
2017,3,19,21,13530,13663,10504,-3159
2017,3,19,22,13990,13800,10434,-3366
2017,3,19,23,14590,14313,10832,-3481
2017,3,20,0,15250,15163,11619,-3544
2017,3,20,1,14890,14997,11680,-3317
2017,3,20,2,14090,14205,10670,-3535
2017,3,20,3,13040,13135,9741,-3394
2017,3,20,4,12130,12422,9375,-3047
2017,3,20,5,11460,12553,9442,-3111
2017,3,20,6,11150,12495,9349,-3146
2017,3,20,7,11080,12156,9160,-2996
2017,3,20,8,11140,12244,9446,-2798
2017,3,20,9,11530,12369,9801,-2568
2017,3,20,10,12590,12957,10565,-2392
2017,3,20,11,14350,14612,12153,-2459
2017,3,20,12,15270,15443,13410,-2033
2017,3,20,13,15180,15070,13370,-1700
2017,3,20,14,14960,14507,12877,-1630
2017,3,20,15,14590,14098,12360,-1738
2017,3,20,16,14260,13764,11848,-1916
2017,3,20,17,13970,13439,11479,-1960
2017,3,20,18,13780,13253,11295,-1958
2017,3,20,19,13660,13020,10962,-2058
2017,3,20,20,13560,13021,10895,-2126
2017,3,20,21,13860,13376,11185,-2191
2017,3,20,22,14400,14038,11765,-2273
2017,3,20,23,14920,14673,12403,-2270
2017,3,21,0,15600,15411,13109,-2302
2017,3,21,1,15330,15190,12599,-2591
2017,3,21,2,14340,14307,11607,-2700
2017,3,21,3,13110,13079,10445,-2634
2017,3,21,4,12030,12163,9718,-2445
2017,3,21,5,11340,11516,9577,-1939
2017,3,21,6,10950,11553,9400,-2153
2017,3,21,7,10800,11498,9417,-2081
2017,3,21,8,10820,11503,9434,-2069
2017,3,21,9,10980,11794,9999,-1795
2017,3,21,10,12040,12279,10617,-1662
2017,3,21,11,13940,13960,12063,-1897
2017,3,21,12,14900,14856,12768,-2088
2017,3,21,13,14770,14803,12508,-2295
2017,3,21,14,14450,14480,12266,-2214
2017,3,21,15,13980,14199,12256,-1943
2017,3,21,16,13680,13959,11994,-1965
2017,3,21,17,13480,13655,11647,-2008
2017,3,21,18,13410,13495,11350,-2145
2017,3,21,19,13320,13305,11139,-2166
2017,3,21,20,13310,13044,10834,-2210
2017,3,21,21,13700,13252,11155,-2097
2017,3,21,22,14230,13864,11890,-1974
2017,3,21,23,14640,14394,12281,-2113
2017,3,22,0,15280,15096,12783,-2313
2017,3,22,1,14960,14850,12772,-2078
2017,3,22,2,14020,13995,11878,-2117
2017,3,22,3,12780,12744,10800,-1944
2017,3,22,4,11700,11657,9771,-1886
2017,3,22,5,11010,11576,9539,-2037
2017,3,22,6,10650,11935,9649,-2286
2017,3,22,7,10580,11828,9441,-2387
2017,3,22,8,10670,11873,9510,-2363
2017,3,22,9,11060,12199,9705,-2494
2017,3,22,10,12110,12749,10440,-2309
2017,3,22,11,14190,13933,11654,-2279
2017,3,22,12,15250,14868,12412,-2456
2017,3,22,13,15070,14940,12538,-2402
2017,3,22,14,14730,14744,12457,-2287
2017,3,22,15,14530,14444,11892,-2552
2017,3,22,16,14380,14151,11695,-2456
2017,3,22,17,14230,13930,11653,-2277
2017,3,22,18,14030,13835,11546,-2289
2017,3,22,19,13990,13729,11445,-2284
2017,3,22,20,14170,13858,11506,-2352
2017,3,22,21,14560,14383,12091,-2292
2017,3,22,22,15300,15275,12716,-2559
2017,3,22,23,15740,16149,13448,-2701
2017,3,23,0,16900,17026,14325,-2701
2017,3,23,1,16550,16954,14134,-2820
2017,3,23,2,15620,16114,13345,-2769
2017,3,23,3,14390,14798,11855,-2943
2017,3,23,4,13290,13688,10945,-2743
2017,3,23,5,12680,13029,10042,-2987
2017,3,23,6,12310,12730,9448,-3282
2017,3,23,7,12200,12608,9244,-3364
2017,3,23,8,12210,12641,9253,-3388
2017,3,23,9,13040,13006,9738,-3268
2017,3,23,10,14130,14090,10742,-3348
2017,3,23,11,15970,15972,12952,-3020
2017,3,23,12,16740,16831,13879,-2952
2017,3,23,13,16630,16414,13608,-2806
2017,3,23,14,16090,15778,12787,-2991
2017,3,23,15,15490,15303,12669,-2634
2017,3,23,16,15040,14881,12188,-2693
2017,3,23,17,14680,14483,11912,-2571
2017,3,23,18,14440,14329,11871,-2458
2017,3,23,19,14220,14447,11988,-2459
2017,3,23,20,14060,14396,11939,-2457
2017,3,23,21,14360,14683,12140,-2543
2017,3,23,22,14800,14889,12271,-2618
2017,3,23,23,15520,15502,12605,-2897
2017,3,24,0,16400,16271,13454,-2817
2017,3,24,1,16260,16196,13435,-2761
2017,3,24,2,15460,15364,12639,-2725
2017,3,24,3,14180,14104,11269,-2835
2017,3,24,4,13070,12972,10267,-2705
2017,3,24,5,12380,12555,9986,-2569
2017,3,24,6,11990,12407,9791,-2616
2017,3,24,7,11760,12227,9744,-2483
2017,3,24,8,11770,12497,9942,-2555
2017,3,24,9,12150,12575,10075,-2500
2017,3,24,10,13080,12991,10937,-2054
2017,3,24,11,14910,14761,13189,-1572
2017,3,24,12,15990,15695,14447,-1248
2017,3,24,13,15940,15818,14358,-1460
2017,3,24,14,15740,15816,14412,-1404
2017,3,24,15,15760,15880,14499,-1381
2017,3,24,16,15560,15880,14400,-1480
2017,3,24,17,15370,15751,14156,-1595
2017,3,24,18,15290,15730,14087,-1643
2017,3,24,19,15200,15585,13815,-1770
2017,3,24,20,15010,15374,13501,-1873
2017,3,24,21,15070,15308,13139,-2169
2017,3,24,22,15060,15360,12937,-2423
2017,3,24,23,15250,15297,12756,-2541
2017,3,25,0,15590,15490,12949,-2541
2017,3,25,1,15060,15078,12717,-2361
2017,3,25,2,14340,14307,12189,-2118
2017,3,25,3,13280,13263,11304,-1959
2017,3,25,4,12180,12188,11085,-1103
2017,3,25,5,11210,11518,9387,-2131
2017,3,25,6,10760,11464,9296,-2168
2017,3,25,7,10490,11241,9352,-1889
2017,3,25,8,10360,11148,9150,-1998
2017,3,25,9,10490,11477,9253,-2224
2017,3,25,10,10890,11876,9474,-2402
2017,3,25,11,11620,12151,9889,-2262
2017,3,25,12,12320,12761,10519,-2242
2017,3,25,13,13140,13386,11086,-2300
2017,3,25,14,13560,13899,11613,-2286
2017,3,25,15,14000,14060,11620,-2440
2017,3,25,16,13880,14089,11338,-2751
2017,3,25,17,13710,13969,11297,-2672
2017,3,25,18,13460,13861,11192,-2669
2017,3,25,19,13290,13752,11093,-2659
2017,3,25,20,13140,13692,10938,-2754
2017,3,25,21,13280,13857,11054,-2803
2017,3,25,22,13620,14249,11246,-3003
2017,3,25,23,14040,14297,11478,-2819
2017,3,26,0,14300,14505,11902,-2603
2017,3,26,1,14080,14334,11799,-2535
2017,3,26,2,13490,13786,11274,-2512
2017,3,26,3,12680,12990,10526,-2464
2017,3,26,4,11860,12139,9764,-2375
2017,3,26,5,11060,11740,9408,-2332
2017,3,26,6,10700,11595,9176,-2419
2017,3,26,7,10470,11670,9089,-2581
2017,3,26,8,10390,11780,9113,-2667
2017,3,26,9,10480,11966,9095,-2871
2017,3,26,10,11010,12062,9390,-2672
2017,3,26,11,11540,12272,9798,-2474
2017,3,26,12,11980,12742,10063,-2679
2017,3,26,13,12560,13160,10424,-2736
2017,3,26,14,12860,12958,10529,-2429
2017,3,26,15,12970,13140,10814,-2326
2017,3,26,16,12990,13283,10849,-2434
2017,3,26,17,12950,13454,11088,-2366
2017,3,26,18,12910,13498,11138,-2360
2017,3,26,19,12850,13486,11303,-2183
2017,3,26,20,12850,13548,11328,-2220
2017,3,26,21,13360,13905,11504,-2401
2017,3,26,22,13840,14485,12032,-2453
2017,3,26,23,14210,14893,12406,-2487
2017,3,27,0,14770,15249,12471,-2778
2017,3,27,1,14360,14872,12265,-2607
2017,3,27,2,13560,13972,11301,-2671
2017,3,27,3,12500,12830,10044,-2786
2017,3,27,4,11600,12046,9434,-2612
2017,3,27,5,11030,11619,8994,-2625
2017,3,27,6,10680,11606,9026,-2580
2017,3,27,7,10520,11737,9027,-2710
2017,3,27,8,10570,11748,8925,-2823
2017,3,27,9,10940,11763,9190,-2573
2017,3,27,10,12000,12510,10264,-2246
2017,3,27,11,13870,13960,11977,-1983
2017,3,27,12,14860,15132,13025,-2107
2017,3,27,13,15140,15492,13277,-2215
2017,3,27,14,15220,15685,13417,-2268
2017,3,27,15,15340,15850,13356,-2494
2017,3,27,16,15270,15833,13236,-2597
2017,3,27,17,15140,15665,12980,-2685
2017,3,27,18,15070,15496,12848,-2648
2017,3,27,19,14700,15183,12573,-2610
2017,3,27,20,14570,15001,12699,-2302
2017,3,27,21,14600,15130,12952,-2178
2017,3,27,22,14910,15465,12930,-2535
2017,3,27,23,15100,15631,13036,-2595
2017,3,28,0,15580,15861,13389,-2472
2017,3,28,1,15220,15416,12831,-2585
2017,3,28,2,14130,14410,11682,-2728
2017,3,28,3,12830,13262,10680,-2582
2017,3,28,4,11640,12227,9956,-2271
2017,3,28,5,11160,11701,9406,-2295
2017,3,28,6,10750,11785,9253,-2532
2017,3,28,7,10540,11956,9411,-2545
2017,3,28,8,10520,11963,9406,-2557
2017,3,28,9,10840,11912,9357,-2555
2017,3,28,10,12010,12469,10193,-2276
2017,3,28,11,13780,13928,12337,-1591
2017,3,28,12,14800,14841,12991,-1850
2017,3,28,13,15000,15043,13125,-1918
2017,3,28,14,14960,15071,12986,-2085
2017,3,28,15,14900,15028,12918,-2110
2017,3,28,16,14830,14900,12892,-2008
2017,3,28,17,14660,14751,12596,-2155
2017,3,28,18,14580,14799,12813,-1986
2017,3,28,19,14460,14812,12988,-1824
2017,3,28,20,14390,14867,12822,-2045
2017,3,28,21,14630,15069,13117,-1952
2017,3,28,22,14930,15461,13357,-2104
2017,3,28,23,15210,15706,13370,-2336
2017,3,29,0,15570,15902,13539,-2363
2017,3,29,1,15100,15406,13230,-2176
2017,3,29,2,14090,14421,12420,-2001
2017,3,29,3,12800,13076,11165,-1911
2017,3,29,4,11620,11885,10080,-1805
2017,3,29,5,10940,11814,9613,-2201
2017,3,29,6,10540,12007,9517,-2490
2017,3,29,7,10370,11886,9184,-2702
2017,3,29,8,10380,11633,8897,-2736
2017,3,29,9,10710,11977,9430,-2547
2017,3,29,10,11860,12681,10369,-2312
2017,3,29,11,13600,13899,11690,-2209
2017,3,29,12,14440,14676,12404,-2272
2017,3,29,13,14330,14731,12329,-2402
2017,3,29,14,14080,14660,12077,-2583
2017,3,29,15,13800,14480,12039,-2441
2017,3,29,16,13530,14194,11812,-2382
2017,3,29,17,13240,13993,11756,-2237
2017,3,29,18,13060,14286,11924,-2362
2017,3,29,19,12880,14084,11787,-2297
2017,3,29,20,12700,14062,11506,-2556
2017,3,29,21,13000,14450,12224,-2226
2017,3,29,22,13720,14916,12580,-2336
2017,3,29,23,14340,14770,12319,-2451
2017,3,30,0,15080,15343,12851,-2492
2017,3,30,1,14770,15185,12750,-2435
2017,3,30,2,13850,14320,11937,-2383
2017,3,30,3,12610,13117,10791,-2326
2017,3,30,4,11540,12346,10104,-2242
2017,3,30,5,11160,11989,9860,-2129
2017,3,30,6,10790,11689,9307,-2382
2017,3,30,7,10650,11573,9412,-2161
2017,3,30,8,10690,11380,9490,-1890
2017,3,30,9,11020,11687,9828,-1859
2017,3,30,10,12120,12410,10641,-1769
2017,3,30,11,13980,14141,12251,-1890
2017,3,30,12,14810,14914,13142,-1772
2017,3,30,13,14440,14517,12739,-1778
2017,3,30,14,14060,14006,12267,-1739
2017,3,30,15,13550,13581,11878,-1703
2017,3,30,16,13270,13247,11433,-1814
2017,3,30,17,13020,12917,11116,-1801
2017,3,30,18,12840,12939,11042,-1897
2017,3,30,19,12650,12824,11115,-1709
2017,3,30,20,12650,12803,11186,-1617
2017,3,30,21,13150,13192,11463,-1729
2017,3,30,22,13750,13769,11795,-1974
2017,3,30,23,14270,14326,12249,-2077
2017,3,31,0,15000,15035,13037,-1998
2017,3,31,1,14840,14861,12944,-1917
2017,3,31,2,13950,14023,12193,-1830
2017,3,31,3,12660,12775,10749,-2026
2017,3,31,4,11560,11737,9397,-2340
2017,3,31,5,10900,11174,8756,-2418
2017,3,31,6,10590,10795,8519,-2276
2017,3,31,7,10480,10895,8429,-2466
2017,3,31,8,10510,11132,8544,-2588
2017,3,31,9,10870,11233,8702,-2531
2017,3,31,10,11820,11944,9724,-2220
2017,3,31,11,13750,13428,11407,-2021
2017,3,31,12,14800,14524,12178,-2346
2017,3,31,13,14950,14905,12612,-2293
2017,3,31,14,15010,15122,12725,-2397
2017,3,31,15,15070,15252,12962,-2290
2017,3,31,16,15030,15282,13091,-2191
2017,3,31,17,14960,15167,13051,-2116
2017,3,31,18,14930,15204,13229,-1975
2017,3,31,19,14810,15148,13202,-1946
2017,3,31,20,14710,15156,13083,-2073
2017,3,31,21,14780,15280,13276,-2004
2017,3,31,22,15090,15511,13241,-2270
2017,3,31,23,15140,15607,13338,-2269
2017,4,1,0,15450,15726,13072,-2654
2017,4,1,1,14940,15280,12473,-2807
2017,4,1,2,14170,14540,12075,-2465
2017,4,1,3,13110,13523,11323,-2200
2017,4,1,4,12040,12500,10483,-2017
2017,4,1,5,11350,11735,9527,-2208
2017,4,1,6,10900,11239,8876,-2363
2017,4,1,7,10640,10991,8642,-2349
2017,4,1,8,10540,10895,8539,-2356
2017,4,1,9,10610,10978,8591,-2387
2017,4,1,10,11360,11354,8986,-2368
2017,4,1,11,12210,12046,9696,-2350
2017,4,1,12,12890,12822,10465,-2357
2017,4,1,13,13640,13758,11517,-2241
2017,4,1,14,14080,14458,11920,-2538
2017,4,1,15,14360,14819,12380,-2439
2017,4,1,16,14390,14904,12380,-2524
2017,4,1,17,14270,14755,12177,-2578
2017,4,1,18,14040,14493,11725,-2768
2017,4,1,19,13810,14260,11519,-2741
2017,4,1,20,13780,14124,11422,-2702
2017,4,1,21,14090,14207,11579,-2628
2017,4,1,22,14550,14419,11519,-2900
2017,4,1,23,14740,14545,11576,-2969
2017,4,2,0,14920,14880,12035,-2845
2017,4,2,1,14600,14647,12128,-2519
2017,4,2,2,13970,14008,11274,-2734
2017,4,2,3,13100,13080,10170,-2910
2017,4,2,4,12200,12152,9082,-3070
2017,4,2,5,11370,11413,8261,-3152
2017,4,2,6,10920,11166,8158,-3008
2017,4,2,7,10720,11221,8196,-3025
2017,4,2,8,10560,11120,8059,-3061
2017,4,2,9,10600,11159,8122,-3037
2017,4,2,10,10900,11147,8295,-2852
2017,4,2,11,11320,11605,8890,-2715
2017,4,2,12,11880,11918,9398,-2520
2017,4,2,13,12370,12471,9666,-2805
2017,4,2,14,12640,12507,9642,-2865
2017,4,2,15,12540,12247,9428,-2819
2017,4,2,16,12350,11974,9117,-2857
2017,4,2,17,12220,11945,9178,-2767
2017,4,2,18,12050,11686,9007,-2679
2017,4,2,19,11960,11701,8926,-2775
2017,4,2,20,12020,11819,9122,-2697
2017,4,2,21,12510,12280,9563,-2717
2017,4,2,22,13050,12649,9989,-2660
2017,4,2,23,13540,13151,10404,-2747
2017,4,3,0,14300,13874,11096,-2778
2017,4,3,1,14100,13924,11223,-2701
2017,4,3,2,13240,13159,10330,-2829
2017,4,3,3,12230,12118,9360,-2758
2017,4,3,4,11300,11155,8678,-2477
2017,4,3,5,10490,10981,8394,-2587
2017,4,3,6,10170,11084,8420,-2664
2017,4,3,7,10070,11141,8267,-2874
2017,4,3,8,10130,11239,8326,-2913
2017,4,3,9,10590,11459,8471,-2988
2017,4,3,10,11680,12131,9525,-2606
2017,4,3,11,13520,13571,11295,-2276
2017,4,3,12,14420,14386,12095,-2291
2017,4,3,13,14310,14228,11972,-2256
2017,4,3,14,13970,13786,11395,-2391
2017,4,3,15,13720,13546,11451,-2095
2017,4,3,16,13500,13321,11277,-2044
2017,4,3,17,13320,13127,11160,-1967
2017,4,3,18,13210,12977,10958,-2019
2017,4,3,19,13000,12686,10706,-1980
2017,4,3,20,13060,12673,10609,-2064
2017,4,3,21,13450,13076,10929,-2147
2017,4,3,22,13920,13406,11157,-2249
2017,4,3,23,14280,13934,11595,-2339
2017,4,4,0,14810,14648,12366,-2282
2017,4,4,1,14620,14530,12185,-2345
2017,4,4,2,13640,13593,11229,-2364
2017,4,4,3,12420,12325,10109,-2216
2017,4,4,4,11310,11312,9420,-1892
2017,4,4,5,10580,11449,9302,-2147
2017,4,4,6,10160,11413,9157,-2256
2017,4,4,7,10010,11260,8859,-2401
2017,4,4,8,10000,11243,8841,-2402
2017,4,4,9,10370,11539,9128,-2411
2017,4,4,10,11410,12074,9857,-2217
2017,4,4,11,13230,13376,11133,-2243
2017,4,4,12,14300,14394,12288,-2106
2017,4,4,13,14470,14767,12620,-2147
2017,4,4,14,14540,14966,12794,-2172
2017,4,4,15,14730,15179,13006,-2173
2017,4,4,16,14760,15263,13109,-2154
2017,4,4,17,14700,15203,12989,-2214
2017,4,4,18,14580,15156,12842,-2314
2017,4,4,19,14470,14997,12739,-2258
2017,4,4,20,14430,14948,12898,-2050
2017,4,4,21,14570,15124,12808,-2316
2017,4,4,22,14910,15425,12939,-2486
2017,4,4,23,15170,15461,12696,-2765
2017,4,5,0,15500,15622,12833,-2789
2017,4,5,1,15140,15259,12593,-2666
2017,4,5,2,14100,14344,12701,-1643
2017,4,5,3,12760,13009,11450,-1559
2017,4,5,4,11610,11899,10466,-1433
2017,4,5,5,10730,11596,9895,-1701
2017,4,5,6,10330,11479,9288,-2191
2017,4,5,7,10030,11547,9175,-2372
2017,4,5,8,9990,11416,9395,-2021
2017,4,5,9,10390,11522,9438,-2084
2017,4,5,10,11740,11920,9892,-2028
2017,4,5,11,13320,13616,11435,-2181
2017,4,5,12,14340,14687,12336,-2351
2017,4,5,13,14430,14891,12511,-2380
2017,4,5,14,14330,14811,12475,-2336
2017,4,5,15,14660,14577,12312,-2265
2017,4,5,16,14540,14247,11898,-2349
2017,4,5,17,14360,14064,11622,-2442
2017,4,5,18,14200,13983,11529,-2454
2017,4,5,19,14050,13841,11421,-2420
2017,4,5,20,13900,13727,11397,-2330
2017,4,5,21,13940,13919,11514,-2405
2017,4,5,22,14460,14290,11849,-2441
2017,4,5,23,14860,14616,12122,-2494
2017,4,6,0,15350,15113,12156,-2957
2017,4,6,1,15000,14960,12158,-2802
2017,4,6,2,14100,14045,11408,-2637
2017,4,6,3,12800,12752,10331,-2421
2017,4,6,4,11490,12007,9626,-2381
2017,4,6,5,10730,11705,9037,-2668
2017,4,6,6,10420,11524,9073,-2451
2017,4,6,7,10300,11489,8991,-2498
2017,4,6,8,10340,11598,8988,-2610
2017,4,6,9,10690,11801,9311,-2490
2017,4,6,10,11830,12230,10083,-2147
2017,4,6,11,13740,13521,11354,-2167
2017,4,6,12,14810,14644,12530,-2114
2017,4,6,13,15010,15054,12978,-2076
2017,4,6,14,15120,15258,13208,-2050
2017,4,6,15,15320,15424,13359,-2065
2017,4,6,16,15280,15479,13251,-2228
2017,4,6,17,15130,15480,13336,-2144
2017,4,6,18,15120,15518,13646,-1872
2017,4,6,19,15020,15387,13776,-1611
2017,4,6,20,15010,15316,13659,-1657
2017,4,6,21,15140,15455,13441,-2014
2017,4,6,22,15400,15661,13468,-2193
2017,4,6,23,15500,15642,13200,-2442
2017,4,7,0,15750,15661,12963,-2698
2017,4,7,1,15270,15277,12450,-2827
2017,4,7,2,14220,14301,11466,-2835
2017,4,7,3,12780,12964,10191,-2773
2017,4,7,4,11610,11761,9592,-2169
2017,4,7,5,10600,11632,9285,-2347
2017,4,7,6,10190,11645,9193,-2452
2017,4,7,7,9980,11447,9159,-2288
2017,4,7,8,9950,11398,9119,-2279
2017,4,7,9,10240,11661,9452,-2209
2017,4,7,10,11450,12056,9996,-2060
2017,4,7,11,12890,13221,10774,-2447
2017,4,7,12,13890,14082,11473,-2609
2017,4,7,13,14030,14041,11513,-2528
2017,4,7,14,14110,13914,11859,-2055
2017,4,7,15,14090,13929,12094,-1835
2017,4,7,16,14020,13935,12075,-1860
2017,4,7,17,13840,13802,11832,-1970
2017,4,7,18,13750,13640,11526,-2114
2017,4,7,19,13640,13373,11393,-1980
2017,4,7,20,13530,13473,11530,-1943
2017,4,7,21,13700,13733,11371,-2362
2017,4,7,22,13870,14007,11408,-2599
2017,4,7,23,14040,14118,11313,-2805
2017,4,8,0,14330,14413,11770,-2643
2017,4,8,1,14200,14319,11835,-2484
2017,4,8,2,13480,13626,11399,-2227
2017,4,8,3,12510,12651,10494,-2157
2017,4,8,4,11520,11634,9616,-2018
2017,4,8,5,10890,11164,9298,-1866
2017,4,8,6,10470,10999,8984,-2015
2017,4,8,7,10270,11319,9172,-2147
2017,4,8,8,10200,11278,9304,-1974
2017,4,8,9,10340,11392,9301,-2091
2017,4,8,10,10810,11588,9447,-2141
2017,4,8,11,11370,11938,9958,-1980
2017,4,8,12,12050,12333,10165,-2168
2017,4,8,13,12570,12561,10423,-2138
2017,4,8,14,12700,12851,10924,-1927
2017,4,8,15,12570,12834,10869,-1965
2017,4,8,16,12450,12634,10235,-2399
2017,4,8,17,12280,12359,9804,-2555
2017,4,8,18,12040,12066,9825,-2241
2017,4,8,19,12030,11870,9484,-2386
2017,4,8,20,12020,11983,9520,-2463
2017,4,8,21,12350,12178,9807,-2371
2017,4,8,22,12700,12422,10128,-2294
2017,4,8,23,13080,12892,10518,-2374
2017,4,9,0,13480,13419,11022,-2397
2017,4,9,1,13580,13468,11348,-2120
2017,4,9,2,12940,12925,10798,-2127
2017,4,9,3,12120,12118,10063,-2055
2017,4,9,4,11290,11226,9203,-2023
2017,4,9,5,10590,10556,8817,-1739
2017,4,9,6,10190,10330,8543,-1787
2017,4,9,7,10010,10719,8847,-1872
2017,4,9,8,9940,10760,8832,-1928
2017,4,9,9,10030,10866,8924,-1942
2017,4,9,10,10300,11039,9090,-1949
2017,4,9,11,10670,11137,9142,-1995
2017,4,9,12,11030,11276,9421,-1855
2017,4,9,13,11460,11422,9743,-1679
2017,4,9,14,11510,11399,9777,-1622
2017,4,9,15,11310,11219,9648,-1571
2017,4,9,16,11160,11009,9327,-1682
2017,4,9,17,11010,10831,9030,-1801
2017,4,9,18,10780,10645,8920,-1725
2017,4,9,19,10640,10512,8674,-1838
2017,4,9,20,10830,10628,8758,-1870
2017,4,9,21,11340,11130,9192,-1938
2017,4,9,22,12000,11868,9877,-1991
2017,4,9,23,12550,12461,10225,-2236
2017,4,10,0,13130,13168,10916,-2252
2017,4,10,1,13290,13331,10962,-2369
2017,4,10,2,12420,12545,10105,-2440
2017,4,10,3,11360,11436,9201,-2235
2017,4,10,4,10380,10423,8312,-2111
2017,4,10,5,9760,9895,7784,-2111
2017,4,10,6,9440,9903,7849,-2054
2017,4,10,7,9330,9868,7769,-2099
2017,4,10,8,9370,9913,7779,-2134
2017,4,10,9,9720,10284,8161,-2123
2017,4,10,10,10730,11013,9008,-2005
2017,4,10,11,12460,12385,10723,-1662
2017,4,10,12,13350,13245,11349,-1896
2017,4,10,13,13260,13116,11109,-2007
2017,4,10,14,13110,12878,10776,-2102
2017,4,10,15,13010,12802,10786,-2016
2017,4,10,16,12870,12751,10791,-1960
2017,4,10,17,12840,12678,10652,-2026
2017,4,10,18,12850,12720,10678,-2042
2017,4,10,19,12840,12699,10691,-2008
2017,4,10,20,12860,12805,10820,-1985
2017,4,10,21,12970,13032,10937,-2095
2017,4,10,22,13350,13377,11285,-2092
2017,4,10,23,13640,13651,11405,-2246
2017,4,11,0,14190,14141,11774,-2367
2017,4,11,1,14020,14086,11796,-2290
2017,4,11,2,13020,13168,10836,-2332
2017,4,11,3,11770,11790,9417,-2373
2017,4,11,4,10670,10712,8317,-2395
2017,4,11,5,9940,10362,7617,-2745
2017,4,11,6,9510,9997,7282,-2715
2017,4,11,7,9350,9806,7015,-2791
2017,4,11,8,9300,9756,7071,-2685
2017,4,11,9,9520,10025,7372,-2653
2017,4,11,10,10520,10720,8101,-2619
2017,4,11,11,12200,11884,9524,-2360
2017,4,11,12,13100,12848,10491,-2357
2017,4,11,13,13210,12904,10712,-2192
2017,4,11,14,13180,12836,10925,-1911
2017,4,11,15,13090,12886,11016,-1870
2017,4,11,16,13150,12945,11103,-1842
2017,4,11,17,13230,12939,11091,-1848
2017,4,11,18,13400,13136,11267,-1869
2017,4,11,19,13450,13262,11274,-1988
2017,4,11,20,13660,13514,11761,-1753
2017,4,11,21,13910,13842,11886,-1956
2017,4,11,22,14210,14135,11933,-2202
2017,4,11,23,14240,14169,11774,-2395
2017,4,12,0,14600,14545,12112,-2433
2017,4,12,1,14270,14441,12194,-2247
2017,4,12,2,13360,13391,11076,-2315
2017,4,12,3,11990,12065,9928,-2137
2017,4,12,4,10830,10848,8630,-2218
2017,4,12,5,10050,10312,7648,-2664
2017,4,12,6,9590,10125,7238,-2887
2017,4,12,7,9410,10124,7296,-2828
2017,4,12,8,9360,10077,7323,-2754
2017,4,12,9,9600,10057,7515,-2542
2017,4,12,10,10580,10520,8161,-2359
2017,4,12,11,12160,11868,9843,-2025
2017,4,12,12,13210,12830,10775,-2055
2017,4,12,13,13410,13111,10772,-2339
2017,4,12,14,13500,13211,11021,-2190
2017,4,12,15,13300,13450,11361,-2089
2017,4,12,16,13320,13690,11708,-1982
2017,4,12,17,13310,13813,11609,-2204
2017,4,12,18,13300,13899,11504,-2395
2017,4,12,19,13330,13744,11231,-2513
2017,4,12,20,13310,13499,10955,-2544
2017,4,12,21,13370,13423,11030,-2393
2017,4,12,22,13510,13519,11043,-2476
2017,4,12,23,13670,13656,11277,-2379
2017,4,13,0,14120,13982,11766,-2216
2017,4,13,1,13910,14029,12016,-2013
2017,4,13,2,12990,13112,10984,-2128
2017,4,13,3,11800,11798,9576,-2222
2017,4,13,4,10740,10809,8578,-2231
2017,4,13,5,10070,10344,7843,-2501
2017,4,13,6,9670,9974,7458,-2516
2017,4,13,7,9490,9787,7217,-2570
2017,4,13,8,9500,10023,7311,-2712
2017,4,13,9,9550,10132,7514,-2618
2017,4,13,10,10520,10729,8317,-2412
2017,4,13,11,12170,12063,9849,-2214
2017,4,13,12,13190,12962,10937,-2025
2017,4,13,13,13290,13061,11185,-1876
2017,4,13,14,13170,13016,11110,-1906
2017,4,13,15,13040,12956,11026,-1930
2017,4,13,16,12970,12794,10909,-1885
2017,4,13,17,12780,12343,10692,-1651
2017,4,13,18,12670,12139,10598,-1541
2017,4,13,19,12570,12005,10641,-1364
2017,4,13,20,12560,12075,10675,-1400
2017,4,13,21,12870,12456,11110,-1346
2017,4,13,22,13200,12931,11607,-1324
2017,4,13,23,13460,13310,11665,-1645
2017,4,14,0,13990,13801,12076,-1725
2017,4,14,1,14230,13845,12074,-1771
2017,4,14,2,13160,13079,11459,-1620
2017,4,14,3,11930,11932,9960,-1972
2017,4,14,4,10820,10799,8644,-2155
2017,4,14,5,10110,10301,8105,-2196
2017,4,14,6,9730,10120,7855,-2265
2017,4,14,7,9530,10054,7634,-2420
2017,4,14,8,9540,10057,7587,-2470
2017,4,14,9,9820,10332,7889,-2443
2017,4,14,10,10630,10818,8513,-2305
2017,4,14,11,11950,11804,9547,-2257
2017,4,14,12,12750,12527,10587,-1940
2017,4,14,13,12950,12561,10794,-1767
2017,4,14,14,12860,12359,10836,-1523
2017,4,14,15,12720,12182,10741,-1441
2017,4,14,16,12520,11981,10377,-1604
2017,4,14,17,12290,11753,9964,-1789
2017,4,14,18,12170,11625,9815,-1810
2017,4,14,19,12110,11534,9781,-1753
2017,4,14,20,12090,11535,9771,-1764
2017,4,14,21,12340,11803,9858,-1945
2017,4,14,22,12700,12264,10633,-1631
2017,4,14,23,12840,12565,10565,-2000
2017,4,15,0,13170,12913,10796,-2117
2017,4,15,1,13300,13110,11244,-1866
2017,4,15,2,12570,12510,10734,-1776
2017,4,15,3,11670,11569,9343,-2226
2017,4,15,4,10740,10626,8220,-2406
2017,4,15,5,10000,10118,7823,-2295
2017,4,15,6,9710,9942,7672,-2270
2017,4,15,7,9480,9793,7537,-2256
2017,4,15,8,9420,9736,7618,-2118
2017,4,15,9,9520,9586,7768,-1818
2017,4,15,10,9720,10235,8466,-1769
2017,4,15,11,10410,10550,8636,-1914
2017,4,15,12,10960,10859,9484,-1375
2017,4,15,13,11510,11236,9923,-1313
2017,4,15,14,11760,11335,10068,-1267
2017,4,15,15,11610,11186,9540,-1646
2017,4,15,16,11430,11003,9078,-1925
2017,4,15,17,11190,10818,8848,-1970
2017,4,15,18,10920,10661,8537,-2124
2017,4,15,19,10820,10629,8640,-1989
2017,4,15,20,10960,10874,8706,-2168
2017,4,15,21,11280,11346,9160,-2186
2017,4,15,22,11730,11966,10015,-1951
2017,4,15,23,12140,12395,10446,-1949
2017,4,16,0,12430,12779,10809,-1970
2017,4,16,1,12750,12720,10947,-1773
2017,4,16,2,12030,12142,10367,-1775
2017,4,16,3,11160,11255,9108,-2147
2017,4,16,4,10330,10483,8004,-2479
2017,4,16,5,9580,9937,7489,-2448
2017,4,16,6,9160,9603,7264,-2339
2017,4,16,7,8960,9465,6964,-2501
2017,4,16,8,8870,9487,7089,-2398
2017,4,16,9,8950,9368,7024,-2344
2017,4,16,10,9150,9470,7248,-2222
2017,4,16,11,9590,9552,7486,-2066
2017,4,16,12,10200,10137,8139,-1998
2017,4,16,13,10900,10673,8570,-2103
2017,4,16,14,11080,11047,8833,-2214
2017,4,16,15,10900,11199,8852,-2347
2017,4,16,16,10800,11264,9126,-2138
2017,4,16,17,10520,11294,9159,-2135
2017,4,16,18,10300,11269,9163,-2106
2017,4,16,19,10290,11129,8912,-2217
2017,4,16,20,10690,11061,8845,-2216
2017,4,16,21,11030,11414,9323,-2091
2017,4,16,22,11450,11818,9612,-2206
2017,4,16,23,11920,12211,9798,-2413
2017,4,17,0,12510,12774,10551,-2223
2017,4,17,1,13000,13102,11113,-1989
2017,4,17,2,12280,12492,10384,-2108
2017,4,17,3,11230,11453,9197,-2256
2017,4,17,4,10220,10451,8027,-2424
2017,4,17,5,9490,9934,7357,-2577
2017,4,17,6,9040,9943,7238,-2705
2017,4,17,7,8870,9819,7256,-2563
2017,4,17,8,8860,9736,7279,-2457
2017,4,17,9,9170,9933,7571,-2362
2017,4,17,10,10120,10370,8273,-2097
2017,4,17,11,11180,11252,9124,-2128
2017,4,17,12,12090,12281,10168,-2113
2017,4,17,13,12610,12705,10789,-1916
2017,4,17,14,12470,12837,11431,-1406
2017,4,17,15,12210,12921,11520,-1401
2017,4,17,16,12030,12991,11354,-1637
2017,4,17,17,11870,12962,11061,-1901
2017,4,17,18,11720,13044,11100,-1944
2017,4,17,19,11940,13080,11259,-1821
2017,4,17,20,12250,12992,11071,-1921
2017,4,17,21,12590,13021,11089,-1932
2017,4,17,22,12930,13297,11507,-1790
2017,4,17,23,13220,13447,11463,-1984
2017,4,18,0,13460,13733,11765,-1968
2017,4,18,1,13750,13775,12026,-1749
2017,4,18,2,12610,12830,10558,-2272
2017,4,18,3,11480,11552,9093,-2459
2017,4,18,4,10440,10472,7949,-2523
2017,4,18,5,9870,10249,7795,-2454
2017,4,18,6,9450,10224,7444,-2780
2017,4,18,7,9270,10113,7277,-2836
2017,4,18,8,9290,10080,7133,-2947
2017,4,18,9,9350,10359,7661,-2698
2017,4,18,10,10300,10992,8722,-2270
2017,4,18,11,11850,11686,9656,-2030
2017,4,18,12,12730,12481,10534,-1947
2017,4,18,13,12830,12588,10550,-2038
2017,4,18,14,12640,12454,10504,-1950
2017,4,18,15,12540,12402,10136,-2266
2017,4,18,16,12430,12341,9832,-2509
2017,4,18,17,12360,12237,9441,-2796
2017,4,18,18,12310,12162,9235,-2927
2017,4,18,19,12340,11959,9167,-2792
2017,4,18,20,12480,11972,9030,-2942
2017,4,18,21,12680,12246,9409,-2837
2017,4,18,22,13160,12744,9983,-2761
2017,4,18,23,13560,13159,10608,-2551
2017,4,19,0,13940,13628,11353,-2275
2017,4,19,1,14280,13837,11617,-2220
2017,4,19,2,13090,12986,10353,-2633
2017,4,19,3,11770,11835,9066,-2769
2017,4,19,4,10690,10960,8213,-2747
2017,4,19,5,10040,9992,7373,-2619
2017,4,19,6,9640,9642,7185,-2457
2017,4,19,7,9490,9683,7163,-2520
2017,4,19,8,9540,9682,7088,-2594
2017,4,19,9,9830,9780,7565,-2215
2017,4,19,10,10780,10647,8881,-1766
2017,4,19,11,12300,12103,10233,-1870
2017,4,19,12,13290,13023,10983,-2040
2017,4,19,13,13390,13077,11126,-1951
2017,4,19,14,13270,12835,10945,-1890
2017,4,19,15,12760,12676,10477,-2199
2017,4,19,16,12670,12627,10086,-2541
2017,4,19,17,12600,12675,10172,-2503
2017,4,19,18,12520,12686,10083,-2603
2017,4,19,19,12510,12664,10048,-2616
2017,4,19,20,12560,12833,10406,-2427
2017,4,19,21,12980,13299,10970,-2329
2017,4,19,22,13590,13821,11720,-2101
2017,4,19,23,13870,14099,12127,-1972
2017,4,20,0,14090,14405,12775,-1630
2017,4,20,1,14240,14227,12674,-1553
2017,4,20,2,13270,13327,11259,-2068
2017,4,20,3,11910,12071,9697,-2374
2017,4,20,4,10970,10964,8119,-2845
2017,4,20,5,10200,10220,7411,-2809
2017,4,20,6,9680,10001,7360,-2641
2017,4,20,7,9450,9852,7310,-2542
2017,4,20,8,9420,9833,7163,-2670
2017,4,20,9,9800,10100,7561,-2539
2017,4,20,10,10750,10716,8584,-2132
2017,4,20,11,12370,12108,10176,-1932
2017,4,20,12,13270,13186,11338,-1848
2017,4,20,13,13440,13574,12009,-1565
2017,4,20,14,13300,13612,11998,-1614
2017,4,20,15,13520,13372,11932,-1440
2017,4,20,16,13310,13135,11463,-1672
2017,4,20,17,13090,12878,11313,-1565
2017,4,20,18,12940,12892,11014,-1878
2017,4,20,19,12870,12890,11215,-1675
2017,4,20,20,12860,12826,10945,-1881
2017,4,20,21,13050,12892,10927,-1965
2017,4,20,22,13350,13140,11202,-1938
2017,4,20,23,13480,13320,11459,-1861
2017,4,21,0,13780,13725,11918,-1807
2017,4,21,1,13870,13782,12169,-1613
2017,4,21,2,13040,12960,10850,-2110
2017,4,21,3,11820,11773,9203,-2570
2017,4,21,4,10750,10685,8065,-2620
2017,4,21,5,10070,10117,7651,-2466
2017,4,21,6,9650,9965,7340,-2625
2017,4,21,7,9480,9869,7261,-2608
2017,4,21,8,9440,9994,7373,-2621
2017,4,21,9,9740,10371,7818,-2553
2017,4,21,10,10650,10995,8831,-2164
2017,4,21,11,12090,11973,10112,-1861
2017,4,21,12,13260,13102,11273,-1829
2017,4,21,13,13610,13745,11862,-1883
2017,4,21,14,13800,14099,12039,-2060
2017,4,21,15,14120,14278,12172,-2106
2017,4,21,16,13880,14251,12234,-2017
2017,4,21,17,13770,14069,11958,-2111
2017,4,21,18,13610,13975,11835,-2140
2017,4,21,19,13580,13827,11806,-2021
2017,4,21,20,13470,13728,11660,-2068
2017,4,21,21,13540,13773,11527,-2246
2017,4,21,22,13750,13910,11644,-2266
2017,4,21,23,13660,13910,11546,-2364
2017,4,22,0,13750,13961,11694,-2267
2017,4,22,1,13850,13748,11572,-2176
2017,4,22,2,13110,13036,10676,-2360
2017,4,22,3,12070,12180,9656,-2524
2017,4,22,4,11050,11341,8883,-2458
2017,4,22,5,9960,10647,7838,-2809
2017,4,22,6,9540,10390,7555,-2835
2017,4,22,7,9300,10337,7555,-2782
2017,4,22,8,9240,10222,7466,-2756
2017,4,22,9,9480,10311,7618,-2693
2017,4,22,10,9850,10680,8041,-2639
2017,4,22,11,10390,11008,8632,-2376
2017,4,22,12,11160,11611,9272,-2339
2017,4,22,13,11970,12300,9977,-2323
2017,4,22,14,12350,12823,10574,-2249
2017,4,22,15,12800,13082,11119,-1963
2017,4,22,16,12560,13125,11081,-2044
2017,4,22,17,12980,12986,10948,-2038
2017,4,22,18,12800,12677,10517,-2160
2017,4,22,19,12740,12488,10276,-2212
2017,4,22,20,12760,12740,10291,-2449
2017,4,22,21,12800,12617,10233,-2384
2017,4,22,22,12810,12751,10440,-2311
2017,4,22,23,12850,12882,10535,-2347
2017,4,23,0,13020,13080,10574,-2506
2017,4,23,1,13050,13082,10704,-2378
2017,4,23,2,12420,12514,10294,-2220
2017,4,23,3,11590,11653,9597,-2056
2017,4,23,4,10710,11014,9109,-1905
2017,4,23,5,9940,10727,8386,-2341
2017,4,23,6,9570,10776,8077,-2699
2017,4,23,7,9330,10704,7766,-2938
2017,4,23,8,9240,10610,7862,-2748
2017,4,23,9,9350,10661,8001,-2660
2017,4,23,10,9580,10677,8165,-2512
2017,4,23,11,9890,10706,8289,-2417
2017,4,23,12,10480,10797,8764,-2033
2017,4,23,13,11050,11055,9408,-1647
2017,4,23,14,11310,10900,9419,-1481
2017,4,23,15,10630,10568,9121,-1447
2017,4,23,16,10560,10486,8976,-1510
2017,4,23,17,10460,10368,8660,-1708
2017,4,23,18,10340,10353,8713,-1640
2017,4,23,19,10460,10404,8711,-1693
2017,4,23,20,10760,10535,8696,-1839
2017,4,23,21,11230,10821,8806,-2015
2017,4,23,22,11780,11510,9455,-2055
2017,4,23,23,12120,12097,10310,-1787
2017,4,24,0,12620,12593,10649,-1944
2017,4,24,1,13000,12970,11101,-1869
2017,4,24,2,12110,12253,10439,-1814
2017,4,24,3,11070,11164,9115,-2049
2017,4,24,4,10160,10354,8085,-2269
2017,4,24,5,9610,9799,7562,-2237
2017,4,24,6,9250,9646,7423,-2223
2017,4,24,7,9120,9510,7283,-2227
2017,4,24,8,9150,9714,7387,-2327
2017,4,24,9,9330,10187,7909,-2278
2017,4,24,10,10300,10883,8999,-1884
2017,4,24,11,12010,11972,10365,-1607
2017,4,24,12,12910,12773,11234,-1539
2017,4,24,13,13010,12753,11309,-1444
2017,4,24,14,12890,12653,11126,-1527
2017,4,24,15,12790,12650,11191,-1459
2017,4,24,16,12790,12697,11376,-1321
2017,4,24,17,12720,12736,11342,-1394
2017,4,24,18,12700,12699,11257,-1442
2017,4,24,19,12680,12558,11031,-1527
2017,4,24,20,12740,12594,11133,-1461
2017,4,24,21,12930,12810,11308,-1502
2017,4,24,22,13250,13212,11575,-1637
2017,4,24,23,13530,13456,11587,-1869
2017,4,25,0,13830,13731,11603,-2128
2017,4,25,1,13950,13883,11971,-1912
2017,4,25,2,13010,12958,10968,-1990
2017,4,25,3,11600,11616,9507,-2109
2017,4,25,4,10610,10698,8645,-2053
2017,4,25,5,9740,9853,7490,-2363
2017,4,25,6,9360,9426,6789,-2637
2017,4,25,7,9230,9397,6780,-2617
2017,4,25,8,9240,9379,6795,-2584
2017,4,25,9,9580,9678,7374,-2304
2017,4,25,10,10410,10352,8456,-1896
2017,4,25,11,12050,11958,10431,-1527
2017,4,25,12,13160,13048,11380,-1668
2017,4,25,13,13570,13392,11730,-1662
2017,4,25,14,13680,13545,11883,-1662
2017,4,25,15,13680,13711,11872,-1839
2017,4,25,16,13690,13758,11946,-1812
2017,4,25,17,13720,13719,11999,-1720
2017,4,25,18,13620,13742,12019,-1723
2017,4,25,19,13550,13714,11904,-1810
2017,4,25,20,13540,13771,12136,-1635
2017,4,25,21,13830,14008,12495,-1513
2017,4,25,22,14210,14382,12713,-1669
2017,4,25,23,14180,14535,12852,-1683
2017,4,26,0,14450,14571,12786,-1785
2017,4,26,1,14300,14292,12555,-1737
2017,4,26,2,13280,13328,11435,-1893
2017,4,26,3,11980,12031,9996,-2035
2017,4,26,4,10840,10894,8706,-2188
2017,4,26,5,10090,10161,7293,-2868
2017,4,26,6,9590,9750,6953,-2797
2017,4,26,7,9430,9518,6917,-2601
2017,4,26,8,9390,9486,6867,-2619
2017,4,26,9,9750,9763,7114,-2649
2017,4,26,10,10680,10714,8173,-2541
2017,4,26,11,12270,12327,10269,-2058
2017,4,26,12,13340,13512,11487,-2025
2017,4,26,13,13670,13890,11690,-2200
2017,4,26,14,13720,14033,12015,-2018
2017,4,26,15,14010,14091,12000,-2091
2017,4,26,16,13960,14030,11593,-2437
2017,4,26,17,13840,13919,11625,-2294
2017,4,26,18,13870,13874,11642,-2232
2017,4,26,19,13770,13744,11532,-2212
2017,4,26,20,13640,13657,11431,-2226
2017,4,26,21,13770,13767,11632,-2135
2017,4,26,22,14100,13979,11768,-2211
2017,4,26,23,14020,14057,12133,-1924
2017,4,27,0,14200,14218,12203,-2015
2017,4,27,1,14150,14153,12336,-1817
2017,4,27,2,13200,13239,11380,-1859
2017,4,27,3,11910,11949,9861,-2088
2017,4,27,4,10780,10760,8332,-2428
2017,4,27,5,10020,10140,7575,-2565
2017,4,27,6,9570,9987,7161,-2826
2017,4,27,7,9390,9856,7180,-2676
2017,4,27,8,9350,9809,7308,-2501
2017,4,27,9,9530,10096,7592,-2504
2017,4,27,10,10510,10828,8303,-2525
2017,4,27,11,12100,12022,9886,-2136
2017,4,27,12,13150,13081,10908,-2173
2017,4,27,13,13440,13378,11347,-2031
2017,4,27,14,13410,13473,11465,-2008
2017,4,27,15,13430,13548,11574,-1974
2017,4,27,16,13320,13535,11478,-2057
2017,4,27,17,13260,13430,11376,-2054
2017,4,27,18,13140,13409,11442,-1967
2017,4,27,19,13030,13273,11277,-1996
2017,4,27,20,13030,13212,11172,-2040
2017,4,27,21,13210,13342,11248,-2094
2017,4,27,22,13660,13513,11216,-2297
2017,4,27,23,13730,13678,11225,-2453
2017,4,28,0,13950,13952,11482,-2470
2017,4,28,1,13920,14071,11854,-2217
2017,4,28,2,13180,13200,10975,-2225
2017,4,28,3,11930,11941,9476,-2465
2017,4,28,4,10780,10754,8173,-2581
2017,4,28,5,10030,10247,7070,-3177
2017,4,28,6,9500,10055,6653,-3402
2017,4,28,7,9340,10072,6520,-3552
2017,4,28,8,9290,10010,6426,-3584
2017,4,28,9,9570,10273,6646,-3627
2017,4,28,10,10460,10631,7551,-3080
2017,4,28,11,11840,11839,9386,-2453
2017,4,28,12,13070,13059,10807,-2252
2017,4,28,13,13410,13517,11385,-2132
2017,4,28,14,13550,13688,11567,-2121
2017,4,28,15,13580,13558,11363,-2195
2017,4,28,16,13470,13251,10771,-2480
2017,4,28,17,13390,13085,10868,-2217
2017,4,28,18,13480,13239,11088,-2151
2017,4,28,19,13410,13349,11247,-2102
2017,4,28,20,13500,13537,11520,-2017
2017,4,28,21,13710,13851,11808,-2043
2017,4,28,22,13930,14097,11866,-2231
2017,4,28,23,13750,14062,11634,-2428
2017,4,29,0,13810,14060,11759,-2301
2017,4,29,1,13720,14264,12051,-2213
2017,4,29,2,13390,13537,11186,-2351
2017,4,29,3,12270,12427,10089,-2338
2017,4,29,4,11120,11248,8759,-2489
2017,4,29,5,10280,10613,7950,-2663
2017,4,29,6,9710,10252,7685,-2567
2017,4,29,7,9400,9934,7327,-2607
2017,4,29,8,9260,9753,7131,-2622
2017,4,29,9,9280,9763,7209,-2554
2017,4,29,10,9610,9826,7235,-2591
2017,4,29,11,10140,10297,7688,-2609
2017,4,29,12,10910,11066,8554,-2512
2017,4,29,13,11820,11797,9279,-2518
2017,4,29,14,12260,12015,9668,-2347
2017,4,29,15,12540,12364,10100,-2264
2017,4,29,16,12460,12513,10288,-2225
2017,4,29,17,12410,12659,10419,-2240
2017,4,29,18,12310,12787,10560,-2227
2017,4,29,19,12080,12746,10062,-2684
2017,4,29,20,12210,12867,10162,-2705
2017,4,29,21,12370,13247,10622,-2625
2017,4,29,22,12720,13525,10940,-2585
2017,4,29,23,12720,13476,10918,-2558
2017,4,30,0,13180,13397,11025,-2372
2017,4,30,1,13110,13551,11348,-2203
2017,4,30,2,12570,12915,10751,-2164
2017,4,30,3,11570,11894,9713,-2181
2017,4,30,4,10670,10830,8585,-2245
2017,4,30,5,9830,10242,7726,-2516
2017,4,30,6,9340,9694,7292,-2402
2017,4,30,7,9010,9617,7232,-2385
2017,4,30,8,8880,9407,6723,-2684
2017,4,30,9,8880,9361,6574,-2787
2017,4,30,10,9090,9184,6658,-2526
2017,4,30,11,9240,9416,7001,-2415
2017,4,30,12,9860,9636,7268,-2368
2017,4,30,13,10570,10102,7855,-2247
2017,4,30,14,11020,10440,8309,-2131
2017,4,30,15,10550,10596,8463,-2133
2017,4,30,16,10700,10871,9007,-1864
2017,4,30,17,10730,11237,9449,-1788
2017,4,30,18,10850,11529,9492,-2037
2017,4,30,19,10980,11568,9313,-2255
2017,4,30,20,11210,11638,9299,-2339
2017,4,30,21,11600,11994,9839,-2155
2017,4,30,22,12120,12478,10110,-2368
2017,4,30,23,12580,12735,10156,-2579
2017,5,1,0,12990,12958,10422,-2536
2017,5,1,1,13130,12996,10551,-2445
2017,5,1,2,12160,12213,9539,-2674
2017,5,1,3,11080,11071,8086,-2985
2017,5,1,4,10140,10071,7294,-2777
2017,5,1,5,9560,9694,6995,-2699
2017,5,1,6,9250,9613,6925,-2688
2017,5,1,7,9060,9454,6666,-2788
2017,5,1,8,9060,9476,6730,-2746
2017,5,1,9,9340,9604,7051,-2553
2017,5,1,10,10240,10283,8345,-1938
2017,5,1,11,11890,11944,9895,-2049
2017,5,1,12,13010,13048,11185,-1863
2017,5,1,13,13260,13417,11690,-1727
2017,5,1,14,13350,13617,11879,-1738
2017,5,1,15,13550,13746,12189,-1557
2017,5,1,16,13470,13685,12160,-1525
2017,5,1,17,13380,13539,11767,-1772
2017,5,1,18,13270,13419,11626,-1793
2017,5,1,19,13160,13342,11846,-1496
2017,5,1,20,13140,13291,11852,-1439
2017,5,1,21,13250,13454,12025,-1429
2017,5,1,22,13550,13845,12225,-1620
2017,5,1,23,13780,14036,12270,-1766
2017,5,2,0,13890,14215,12555,-1660
2017,5,2,1,14110,14210,12347,-1863
2017,5,2,2,13090,13246,11514,-1732
2017,5,2,3,11740,11963,10207,-1756
2017,5,2,4,10600,11034,8848,-2186
2017,5,2,5,9970,10573,8621,-1952
2017,5,2,6,9490,10367,8346,-2021
2017,5,2,7,9350,10190,8141,-2049
2017,5,2,8,9310,10152,8075,-2077
2017,5,2,9,9600,10439,8153,-2286
2017,5,2,10,10570,11272,9431,-1841
2017,5,2,11,12190,12285,10890,-1395
2017,5,2,12,13310,13412,12200,-1212
2017,5,2,13,13650,13761,12424,-1337
2017,5,2,14,13640,13935,12814,-1121
2017,5,2,15,13780,13960,12777,-1183
2017,5,2,16,13790,14011,12368,-1643
2017,5,2,17,13700,13881,12184,-1697
2017,5,2,18,13740,13770,12116,-1654
2017,5,2,19,13680,13479,12129,-1350
2017,5,2,20,13650,13287,12090,-1197
2017,5,2,21,13830,13374,12246,-1128
2017,5,2,22,13980,13690,12583,-1107
2017,5,2,23,13930,13812,12515,-1297
2017,5,3,0,14080,13943,12388,-1555
2017,5,3,1,14180,14158,12644,-1514
2017,5,3,2,13150,13308,11814,-1494
2017,5,3,3,11770,11940,10377,-1563
2017,5,3,4,10610,10971,8997,-1974
2017,5,3,5,9860,10294,7816,-2478
2017,5,3,6,9470,10092,7566,-2526
2017,5,3,7,9260,10032,7576,-2456
2017,5,3,8,9230,9995,7559,-2436
2017,5,3,9,9500,9996,7692,-2304
2017,5,3,10,10410,10615,8914,-1701
2017,5,3,11,11970,11860,10479,-1381
2017,5,3,12,12940,12738,11657,-1081
2017,5,3,13,13120,12745,11569,-1176
2017,5,3,14,13150,12747,11579,-1168
2017,5,3,15,13180,12889,11542,-1347
2017,5,3,16,13180,12872,11413,-1459
2017,5,3,17,13120,12789,11403,-1386
2017,5,3,18,13130,12849,11633,-1216
2017,5,3,19,13080,12657,11236,-1421
2017,5,3,20,13090,12655,11223,-1432
2017,5,3,21,13230,12897,11487,-1410
2017,5,3,22,13440,13105,11863,-1242
2017,5,3,23,13640,13310,12059,-1251
2017,5,4,0,13860,13551,12374,-1177
2017,5,4,1,13960,13928,12761,-1167
2017,5,4,2,13100,13208,12350,-858
2017,5,4,3,11820,11919,10807,-1112
2017,5,4,4,10660,11129,9400,-1729
2017,5,4,5,9940,10475,8764,-1711
2017,5,4,6,9530,10126,8363,-1763
2017,5,4,7,9350,10147,8125,-2022
2017,5,4,8,9340,10150,8015,-2135
2017,5,4,9,9670,10246,8112,-2134
2017,5,4,10,10570,10816,9242,-1574
2017,5,4,11,12230,12166,10905,-1261
2017,5,4,12,13080,12918,12087,-831
2017,5,4,13,13020,12758,12045,-713
2017,5,4,14,12900,12499,11974,-525
2017,5,4,15,12800,12373,11711,-662
2017,5,4,16,12690,12239,11592,-647
2017,5,4,17,12650,12169,11417,-752
2017,5,4,18,12610,12171,11570,-601
2017,5,4,19,12640,12113,11455,-658
2017,5,4,20,12710,12181,11413,-768
2017,5,4,21,12890,12535,11892,-643
2017,5,4,22,13190,12903,12291,-612
2017,5,4,23,13310,13120,12268,-852
2017,5,5,0,13490,13529,12647,-882
2017,5,5,1,13860,13836,12719,-1117
2017,5,5,2,13050,13059,12053,-1006
2017,5,5,3,11770,11840,10647,-1193
2017,5,5,4,10600,11041,9574,-1467
2017,5,5,5,9910,10347,8508,-1839
2017,5,5,6,9520,9912,7999,-1913
2017,5,5,7,9340,9794,7719,-2075
2017,5,5,8,9320,9920,7583,-2337
2017,5,5,9,9630,10197,7918,-2279
2017,5,5,10,10400,11097,9143,-1954
2017,5,5,11,11880,12054,10297,-1757
2017,5,5,12,12980,13084,11915,-1169
2017,5,5,13,13330,13556,12372,-1184
2017,5,5,14,13500,13808,12344,-1464
2017,5,5,15,13700,13917,12390,-1527
2017,5,5,16,13520,13993,12564,-1429
2017,5,5,17,13470,13925,12462,-1463
2017,5,5,18,13400,13888,12522,-1366
2017,5,5,19,13280,13931,12542,-1389
2017,5,5,20,13290,13977,12914,-1063
2017,5,5,21,13340,14026,12591,-1435
2017,5,5,22,13420,14123,12139,-1984
2017,5,5,23,13320,13954,12236,-1718
2017,5,6,0,13310,13821,12044,-1777
2017,5,6,1,13400,13631,12334,-1297
2017,5,6,2,12730,12900,11845,-1055
2017,5,6,3,11730,11871,10830,-1041
2017,5,6,4,10680,10796,9223,-1573
2017,5,6,5,9850,10265,8235,-2030
2017,5,6,6,9420,9801,7797,-2004
2017,5,6,7,9200,9765,7680,-2085
2017,5,6,8,9070,9655,7845,-1810
2017,5,6,9,9160,9718,7877,-1841
2017,5,6,10,9500,9936,8004,-1932
2017,5,6,11,10140,10398,8674,-1724
2017,5,6,12,10880,11074,9401,-1673
2017,5,6,13,11760,11986,10056,-1930
2017,5,6,14,12170,12531,10304,-2227
2017,5,6,15,12360,12871,10571,-2300
2017,5,6,16,12260,12868,10488,-2380
2017,5,6,17,12060,12587,10109,-2478
2017,5,6,18,11770,12099,9928,-2171
2017,5,6,19,11630,11637,9636,-2001
2017,5,6,20,11740,11370,9385,-1985
2017,5,6,21,11880,11569,9830,-1739
2017,5,6,22,12100,12023,10225,-1798
2017,5,6,23,12360,12266,10141,-2125
2017,5,7,0,12460,12474,10361,-2113
2017,5,7,1,12750,12660,10705,-1955
2017,5,7,2,12170,12138,10324,-1814
2017,5,7,3,11300,11291,9540,-1751
2017,5,7,4,10390,10465,8841,-1624
2017,5,7,5,9620,9924,8156,-1768
2017,5,7,6,9190,9681,7733,-1948
2017,5,7,7,8960,9599,7717,-1882
2017,5,7,8,8810,9549,7788,-1761
2017,5,7,9,8850,9569,7782,-1787
2017,5,7,10,8980,9567,7640,-1927
2017,5,7,11,9270,10003,7872,-2131
2017,5,7,12,9900,10245,8028,-2217
2017,5,7,13,10580,10635,8478,-2157
2017,5,7,14,11040,10798,8885,-1913
2017,5,7,15,11180,10797,9062,-1735
2017,5,7,16,11270,11054,9188,-1866
2017,5,7,17,11270,11084,9493,-1591
2017,5,7,18,11130,10943,9469,-1474
2017,5,7,19,11040,11090,9407,-1683
2017,5,7,20,11230,11249,9273,-1976
2017,5,7,21,11550,11641,9786,-1855
2017,5,7,22,12000,12198,10241,-1957
2017,5,7,23,12320,12558,10468,-2090
2017,5,8,0,12690,12768,10465,-2303
2017,5,8,1,13050,12957,10512,-2445
2017,5,8,2,12210,12262,10011,-2251
2017,5,8,3,11030,11158,8818,-2340
2017,5,8,4,10070,10366,8206,-2160
2017,5,8,5,9420,9734,7814,-1920
2017,5,8,6,9080,9375,7525,-1850
2017,5,8,7,8960,9264,7442,-1822
2017,5,8,8,9020,9520,7517,-2003
2017,5,8,9,9370,9769,7742,-2027
2017,5,8,10,10300,10426,8563,-1863
2017,5,8,11,11940,11871,9934,-1937
2017,5,8,12,12950,12817,10901,-1916
2017,5,8,13,13060,12880,10882,-1998
2017,5,8,14,13070,12892,10845,-2047
2017,5,8,15,13060,13041,11049,-1992
2017,5,8,16,12960,13024,11210,-1814
2017,5,8,17,12960,12892,11040,-1852
2017,5,8,18,12930,12930,11045,-1885
2017,5,8,19,12860,12911,11046,-1865
2017,5,8,20,12900,12896,11181,-1715
2017,5,8,21,13100,13006,11161,-1845
2017,5,8,22,13440,13380,11589,-1791
2017,5,8,23,13640,13675,11676,-1999
2017,5,9,0,13790,13878,11794,-2084
2017,5,9,1,14000,14080,11780,-2300
2017,5,9,2,13090,13292,11093,-2199
2017,5,9,3,11780,11974,10064,-1910
2017,5,9,4,10700,11025,8667,-2358
2017,5,9,5,9940,10367,7885,-2482
2017,5,9,6,9570,10124,7643,-2481
2017,5,9,7,9380,10325,7643,-2682
2017,5,9,8,9400,10072,7797,-2275
2017,5,9,9,9750,10385,8286,-2099
2017,5,9,10,10800,11059,9415,-1644
2017,5,9,11,12330,12331,11253,-1078
2017,5,9,12,13140,13189,11931,-1258
2017,5,9,13,12990,13118,11679,-1439
2017,5,9,14,12980,13010,11614,-1396
2017,5,9,15,12900,13003,11537,-1466
2017,5,9,16,12870,13080,11636,-1444
2017,5,9,17,12820,13196,11816,-1380
2017,5,9,18,12820,13323,11899,-1424
2017,5,9,19,12750,13224,11754,-1470
2017,5,9,20,12800,13174,11708,-1466
2017,5,9,21,12880,13369,11908,-1461
2017,5,9,22,13070,13680,12101,-1579
2017,5,9,23,13300,13957,12423,-1534
2017,5,10,0,13620,14139,12486,-1653
2017,5,10,1,14000,14183,12442,-1741
2017,5,10,2,13070,13305,11744,-1561
2017,5,10,3,11770,11995,10221,-1774
2017,5,10,4,10600,10829,8778,-2051
2017,5,10,5,10090,10497,8042,-2455
2017,5,10,6,9680,10184,7799,-2385
2017,5,10,7,9480,10174,7934,-2240
2017,5,10,8,9470,10226,7991,-2235
2017,5,10,9,9810,10344,8182,-2162
2017,5,10,10,10710,10894,8841,-2053
2017,5,10,11,12300,12255,10358,-1897
2017,5,10,12,13200,13145,11176,-1969
2017,5,10,13,13160,13095,11317,-1778
2017,5,10,14,12970,12772,10953,-1819
2017,5,10,15,12660,12751,10889,-1862
2017,5,10,16,12650,13148,11046,-2102
2017,5,10,17,12650,13171,10912,-2259
2017,5,10,18,12670,13096,10642,-2454
2017,5,10,19,12550,12911,10751,-2160
2017,5,10,20,12640,12823,10613,-2210
2017,5,10,21,12910,12951,10914,-2037
2017,5,10,22,13220,13213,11155,-2058
2017,5,10,23,13380,13467,11270,-2197
2017,5,11,0,13530,13712,11460,-2252
2017,5,11,1,13860,13960,11625,-2335
2017,5,11,2,13010,13202,10927,-2275
2017,5,11,3,11730,11936,9636,-2300
2017,5,11,4,10530,10951,8395,-2556
2017,5,11,5,9900,10280,7612,-2668
2017,5,11,6,9500,10061,7500,-2561
2017,5,11,7,9300,9921,7422,-2499
2017,5,11,8,9310,9992,7185,-2807
2017,5,11,9,9650,10451,7724,-2727
2017,5,11,10,10580,10892,8516,-2376
2017,5,11,11,12220,12106,9928,-2178
2017,5,11,12,13120,12951,10972,-1979
2017,5,11,13,13210,12828,10916,-1912
2017,5,11,14,13130,12865,11163,-1702
2017,5,11,15,12840,13031,11252,-1779
2017,5,11,16,12880,13087,10944,-2143
2017,5,11,17,12880,12854,10634,-2220
2017,5,11,18,12860,12664,10618,-2046
2017,5,11,19,12730,12394,10589,-1805
2017,5,11,20,12720,12361,10702,-1659
2017,5,11,21,12920,12654,10917,-1737
2017,5,11,22,13200,13064,11241,-1823
2017,5,11,23,13340,13283,11167,-2116
2017,5,12,0,13580,13515,11436,-2079
2017,5,12,1,13850,13831,11815,-2016
2017,5,12,2,13080,13158,11120,-2038
2017,5,12,3,11790,11896,9572,-2324
2017,5,12,4,10640,10944,8472,-2472
2017,5,12,5,9960,10369,7935,-2434
2017,5,12,6,9540,10023,7514,-2509
2017,5,12,7,9330,10109,7520,-2589
2017,5,12,8,9280,10082,7494,-2588
2017,5,12,9,9570,10139,7569,-2570
2017,5,12,10,10450,10876,8500,-2376
2017,5,12,11,12030,11949,10041,-1908
2017,5,12,12,13060,12950,11165,-1785
2017,5,12,13,13300,13180,11616,-1564
2017,5,12,14,13340,13228,11414,-1814
2017,5,12,15,13330,13246,11318,-1928
2017,5,12,16,13290,13176,11310,-1866
2017,5,12,17,13210,12974,11020,-1954
2017,5,12,18,13100,12779,10765,-2014
2017,5,12,19,12990,12499,10468,-2031
2017,5,12,20,12890,12359,10354,-2005
2017,5,12,21,12940,12408,10435,-1973
2017,5,12,22,12920,12629,10730,-1899
2017,5,12,23,12890,12763,10749,-2014
2017,5,13,0,13020,12881,10801,-2080
2017,5,13,1,13310,13227,11181,-2046
2017,5,13,2,12700,12763,10720,-2043
2017,5,13,3,11650,11833,9924,-1909
2017,5,13,4,10630,10937,8673,-2264
2017,5,13,5,9820,10481,7919,-2562
2017,5,13,6,9400,10222,7828,-2394
2017,5,13,7,9160,9955,7550,-2405
2017,5,13,8,9060,9853,7348,-2505
2017,5,13,9,9150,9932,7551,-2381
2017,5,13,10,9460,10131,7803,-2328
2017,5,13,11,9980,10275,8379,-1896
2017,5,13,12,10820,11076,9074,-2002
2017,5,13,13,11610,11586,9750,-1836
2017,5,13,14,12100,12026,10120,-1906
2017,5,13,15,12220,12188,10396,-1792
2017,5,13,16,12220,12129,9994,-2135
2017,5,13,17,12070,11895,9666,-2229
2017,5,13,18,11940,11674,9678,-1996
2017,5,13,19,11890,11611,9405,-2206
2017,5,13,20,11920,11707,9405,-2302
2017,5,13,21,12050,11933,9697,-2236
2017,5,13,22,12320,12312,9954,-2358
2017,5,13,23,12470,12562,10129,-2433
2017,5,14,0,12670,12707,10066,-2641
2017,5,14,1,12820,12816,10129,-2687
2017,5,14,2,12300,12320,10127,-2193
2017,5,14,3,11420,11495,9317,-2178
2017,5,14,4,10500,10723,8456,-2267
2017,5,14,5,9820,10343,7823,-2520
2017,5,14,6,9340,9986,7629,-2357
2017,5,14,7,9080,9960,7613,-2347
2017,5,14,8,8960,9876,7549,-2327
2017,5,14,9,9050,9907,7679,-2228
2017,5,14,10,9320,9888,7618,-2270
2017,5,14,11,9520,10002,7801,-2201
2017,5,14,12,10280,10726,8687,-2039
2017,5,14,13,11070,11336,9337,-1999
2017,5,14,14,11870,11975,9880,-2095
2017,5,14,15,12270,12208,10070,-2138
2017,5,14,16,12190,12197,9981,-2216
2017,5,14,17,12150,12112,9652,-2460
2017,5,14,18,12080,11847,9324,-2523
2017,5,14,19,11900,11630,9110,-2520
2017,5,14,20,11980,11645,9172,-2473
2017,5,14,21,12120,11889,9417,-2472
2017,5,14,22,12340,12287,9759,-2528
2017,5,14,23,12570,12506,10059,-2447
2017,5,15,0,12790,12800,10332,-2468
2017,5,15,1,13150,13078,10626,-2452
2017,5,15,2,12570,12480,9995,-2485
2017,5,15,3,11470,11422,8852,-2570
2017,5,15,4,10310,10606,8075,-2531
2017,5,15,5,9650,9981,7898,-2083
2017,5,15,6,9300,9799,8017,-1782
2017,5,15,7,9140,9722,8049,-1673
2017,5,15,8,9160,9732,7972,-1760
2017,5,15,9,9500,10059,7994,-2065
2017,5,15,10,10490,10745,8707,-2038
2017,5,15,11,12110,12174,9745,-2429
2017,5,15,12,13250,13240,10956,-2284
2017,5,15,13,13530,13727,11357,-2370
2017,5,15,14,13610,13958,11590,-2368
2017,5,15,15,13660,14023,11597,-2426
2017,5,15,16,13640,13852,11467,-2385
2017,5,15,17,13530,13688,11648,-2040
2017,5,15,18,13410,13607,11530,-2077
2017,5,15,19,13210,13486,11495,-1991
2017,5,15,20,13210,13519,11424,-2095
2017,5,15,21,13380,13658,11627,-2031
2017,5,15,22,13510,13828,11676,-2152
2017,5,15,23,13730,13865,11733,-2132
2017,5,16,0,13860,13927,11704,-2223
2017,5,16,1,14110,14074,11926,-2148
2017,5,16,2,13250,13345,11189,-2156
2017,5,16,3,11900,12042,9725,-2317
2017,5,16,4,10720,10851,8405,-2446
2017,5,16,5,9780,10062,7852,-2210
2017,5,16,6,9390,9857,7489,-2368
2017,5,16,7,9210,9479,7481,-1998
2017,5,16,8,9230,9883,7918,-1965
2017,5,16,9,9630,9985,8178,-1807
2017,5,16,10,10460,10708,9037,-1671
2017,5,16,11,12000,12004,10249,-1755
2017,5,16,12,13120,12816,10885,-1931
2017,5,16,13,13350,12804,10957,-1847
2017,5,16,14,13400,12708,10742,-1966
2017,5,16,15,13530,12692,10927,-1765
2017,5,16,16,13550,12786,11369,-1417
2017,5,16,17,13570,13025,11572,-1453
2017,5,16,18,13690,13191,11786,-1405
2017,5,16,19,13760,13282,11865,-1417
2017,5,16,20,13800,13574,11815,-1759
2017,5,16,21,14050,13790,11834,-1956
2017,5,16,22,14180,13981,11995,-1986
2017,5,16,23,14320,14163,12200,-1963
2017,5,17,0,14270,14273,12146,-2127
2017,5,17,1,14550,14523,12272,-2251
2017,5,17,2,13720,13818,11540,-2278
2017,5,17,3,12320,12371,9850,-2521
2017,5,17,4,11020,11174,8775,-2399
2017,5,17,5,10230,10654,8461,-2193
2017,5,17,6,9800,10417,7998,-2419
2017,5,17,7,9560,10123,8034,-2089
2017,5,17,8,9500,9910,7796,-2114
2017,5,17,9,9480,10275,8181,-2094
2017,5,17,10,10290,11088,9206,-1882
2017,5,17,11,11920,12498,10160,-2338
2017,5,17,12,13270,12931,10390,-2541
2017,5,17,13,13580,13196,10773,-2423
2017,5,17,14,13900,13387,10934,-2453
2017,5,17,15,13730,13659,11100,-2559
2017,5,17,16,14300,14031,11333,-2698
2017,5,17,17,14560,14409,11666,-2743
2017,5,17,18,15060,14952,12146,-2806
2017,5,17,19,15420,15371,12806,-2565
2017,5,17,20,15650,15868,13590,-2278
2017,5,17,21,16080,16494,14161,-2333
2017,5,17,22,16340,16985,14482,-2503
2017,5,17,23,16620,17107,14521,-2586
2017,5,18,0,16460,17062,14457,-2605
2017,5,18,1,16500,17230,14522,-2708
2017,5,18,2,15690,16464,13749,-2715
2017,5,18,3,14130,14913,12543,-2370
2017,5,18,4,12780,13579,11371,-2208
2017,5,18,5,11890,12542,10008,-2534
2017,5,18,6,11300,12131,9922,-2209
2017,5,18,7,10910,11899,9508,-2391
2017,5,18,8,10760,11678,9269,-2409
2017,5,18,9,11070,11829,9748,-2081
2017,5,18,10,11800,12340,10058,-2282
2017,5,18,11,13540,13521,11279,-2242
2017,5,18,12,14860,14920,12576,-2344
2017,5,18,13,15620,15752,13597,-2155
2017,5,18,14,16320,16489,14276,-2213
2017,5,18,15,17120,17154,15011,-2143
2017,5,18,16,17790,17684,15587,-2097
2017,5,18,17,18190,18094,16001,-2093
2017,5,18,18,18850,18682,16597,-2085
2017,5,18,19,19050,19233,17030,-2203
2017,5,18,20,19440,19577,17451,-2126
2017,5,18,21,19900,19787,17384,-2403
2017,5,18,22,20000,20011,17388,-2623
2017,5,18,23,19450,19794,16806,-2988
2017,5,19,0,19140,19427,16306,-3121
2017,5,19,1,18960,19294,16343,-2951
2017,5,19,2,17870,18297,15386,-2911
2017,5,19,3,16060,16403,13568,-2835
2017,5,19,4,14340,14936,12319,-2617
2017,5,19,5,13490,14131,12032,-2099
2017,5,19,6,12840,13006,11242,-1764
2017,5,19,7,12280,12766,10825,-1941
2017,5,19,8,12010,12460,10482,-1978
2017,5,19,9,11810,12526,10608,-1918
2017,5,19,10,12510,13119,11231,-1888
2017,5,19,11,13940,14086,12521,-1565
2017,5,19,12,15390,15391,13776,-1615
2017,5,19,13,16190,16134,14426,-1708
2017,5,19,14,16840,16742,14588,-2154
2017,5,19,15,17230,17317,15244,-2073
2017,5,19,16,17290,17785,15498,-2287
2017,5,19,17,17310,18192,16120,-2072
2017,5,19,18,18250,18595,16442,-2153
2017,5,19,19,18350,18805,16402,-2403
2017,5,19,20,18280,18967,16661,-2306
2017,5,19,21,18900,19084,16716,-2368
2017,5,19,22,18460,18969,16464,-2505
2017,5,19,23,17990,18307,15754,-2553
2017,5,20,0,17130,17442,15010,-2432
2017,5,20,1,16480,16842,14486,-2356
2017,5,20,2,15100,15767,13480,-2287
2017,5,20,3,13630,14106,11709,-2397
2017,5,20,4,12290,12488,10062,-2426
2017,5,20,5,11050,11548,9620,-1928
2017,5,20,6,10380,10790,9129,-1661
2017,5,20,7,9930,10339,8725,-1614
2017,5,20,8,9700,10201,8427,-1774
2017,5,20,9,9740,10255,8459,-1796
2017,5,20,10,9960,10349,8521,-1828
2017,5,20,11,10510,10751,8775,-1976
2017,5,20,12,11220,11190,9486,-1704
2017,5,20,13,12010,11460,9923,-1537
2017,5,20,14,12400,11705,10112,-1593
2017,5,20,15,11850,11786,10193,-1593
2017,5,20,16,11880,11702,9983,-1719
2017,5,20,17,11900,11365,9854,-1511
2017,5,20,18,11960,11278,9750,-1528
2017,5,20,19,11290,11505,9820,-1685
2017,5,20,20,11440,11715,9848,-1867
2017,5,20,21,11790,11987,10186,-1801
2017,5,20,22,12300,12510,10412,-2098
2017,5,20,23,12480,12816,10664,-2152
2017,5,21,0,12700,12757,10451,-2306
2017,5,21,1,13000,12878,10655,-2223
2017,5,21,2,12140,12529,10579,-1950
2017,5,21,3,11310,11635,9560,-2075
2017,5,21,4,10450,10609,8248,-2361
2017,5,21,5,9770,9935,7792,-2143
2017,5,21,6,9450,9783,7798,-1985
2017,5,21,7,9150,9519,7799,-1720
2017,5,21,8,9010,9396,7595,-1801
2017,5,21,9,9040,9420,7576,-1844
2017,5,21,10,8990,9430,7570,-1860
2017,5,21,11,9500,9737,7528,-2209
2017,5,21,12,10030,10214,8099,-2115
2017,5,21,13,10600,10544,8698,-1846
2017,5,21,14,11090,10945,8994,-1951
2017,5,21,15,11280,11127,9068,-2059
2017,5,21,16,11360,11044,9066,-1978
2017,5,21,17,11370,11104,9143,-1961
2017,5,21,18,11400,11050,8972,-2078
2017,5,21,19,11440,11009,8848,-2161
2017,5,21,20,11590,11160,8934,-2226
2017,5,21,21,11940,11707,9468,-2239
2017,5,21,22,12380,12405,10566,-1839
2017,5,21,23,12620,12768,11187,-1581
2017,5,22,0,12810,12860,11428,-1432
2017,5,22,1,13000,13152,11605,-1547
2017,5,22,2,12460,12592,10430,-2162
2017,5,22,3,11290,11425,9185,-2240
2017,5,22,4,10250,10529,8273,-2256
2017,5,22,5,9540,9884,7649,-2235
2017,5,22,6,9220,9709,7421,-2288
2017,5,22,7,9070,9507,7436,-2071
2017,5,22,8,9060,9493,7520,-1973
2017,5,22,9,9370,9770,7829,-1941
2017,5,22,10,10130,10648,8855,-1793
2017,5,22,11,11870,11904,10018,-1886
2017,5,22,12,12980,12889,11167,-1722
2017,5,22,13,13350,13371,11735,-1636
2017,5,22,14,13550,13639,11946,-1693
2017,5,22,15,13720,13882,12251,-1631
2017,5,22,16,13690,13923,12247,-1676
2017,5,22,17,13630,13938,12232,-1706
2017,5,22,18,13600,13984,12258,-1726
2017,5,22,19,13550,13906,12159,-1747
2017,5,22,20,13560,13890,12081,-1809
2017,5,22,21,13830,14063,12249,-1814
2017,5,22,22,14040,14396,12584,-1812
2017,5,22,23,14110,14458,12802,-1656
2017,5,23,0,14150,14321,12564,-1757
2017,5,23,1,14250,14097,12354,-1743
2017,5,23,2,13290,13174,11376,-1798
2017,5,23,3,11910,11858,9919,-1939
2017,5,23,4,10740,10938,8911,-2027
2017,5,23,5,10080,10204,8141,-2063
2017,5,23,6,9560,10022,7970,-2052
2017,5,23,7,9340,9828,7783,-2045
2017,5,23,8,9290,9790,7723,-2067
2017,5,23,9,9560,10027,7913,-2114
2017,5,23,10,10410,10568,8420,-2148
2017,5,23,11,12050,11785,9874,-1911
2017,5,23,12,13230,12776,11064,-1712
2017,5,23,13,13580,12931,11259,-1672
2017,5,23,14,13640,12885,11605,-1280
2017,5,23,15,13670,12889,11543,-1346
2017,5,23,16,13750,13110,11862,-1248
2017,5,23,17,13730,13301,11915,-1386
2017,5,23,18,13830,13378,12196,-1182
2017,5,23,19,13860,13430,12095,-1335
2017,5,23,20,13850,13456,12039,-1417
2017,5,23,21,14130,13616,12230,-1386
2017,5,23,22,14370,13823,12586,-1237
2017,5,23,23,14380,13903,12335,-1568
2017,5,24,0,14360,13963,12387,-1576
2017,5,24,1,14480,14195,12929,-1266
2017,5,24,2,13750,13537,12620,-917
2017,5,24,3,12330,12205,10922,-1283
2017,5,24,4,11060,11167,9492,-1675
2017,5,24,5,10160,10383,8391,-1992
2017,5,24,6,9690,10103,7926,-2177
2017,5,24,7,9440,9842,7813,-2029
2017,5,24,8,9390,9774,8309,-1465
2017,5,24,9,9600,10021,9003,-1018
2017,5,24,10,10420,10632,9834,-798
2017,5,24,11,11820,11907,11438,-469
2017,5,24,12,12930,12992,12800,-192
2017,5,24,13,13060,13337,13310,-27
2017,5,24,14,13180,13477,13501,24
2017,5,24,15,13250,13687,13523,-164
2017,5,24,16,13370,13702,13498,-204
2017,5,24,17,13420,13596,13486,-110
2017,5,24,18,13760,13548,13790,242
2017,5,24,19,13920,13375,14176,801
2017,5,24,20,14070,13420,14146,726
2017,5,24,21,14410,13707,13850,143
2017,5,24,22,14560,13873,13699,-174
2017,5,24,23,14660,13931,13519,-412
2017,5,25,0,14490,13927,13437,-490
2017,5,25,1,14500,14125,13672,-453
2017,5,25,2,13670,13530,13309,-221
2017,5,25,3,12210,12199,11746,-453
2017,5,25,4,10950,11159,10279,-880
2017,5,25,5,10110,10110,9135,-975
2017,5,25,6,9630,9812,8886,-926
2017,5,25,7,9380,9589,8820,-769
2017,5,25,8,9330,9505,8735,-770
2017,5,25,9,9540,9520,8978,-542
2017,5,25,10,10350,10297,10089,-208
2017,5,25,11,11910,11818,11664,-154
2017,5,25,12,13070,13053,12736,-317
2017,5,25,13,13440,13551,13307,-244
2017,5,25,14,13580,13796,13532,-264
2017,5,25,15,13740,13958,13695,-263
2017,5,25,16,13850,14065,13804,-261
2017,5,25,17,13840,14043,13881,-162
2017,5,25,18,13860,14062,13991,-71
2017,5,25,19,13860,13969,14036,67
2017,5,25,20,13850,13910,13763,-147
2017,5,25,21,14040,13962,13842,-120
2017,5,25,22,14180,14185,14158,-27
2017,5,25,23,14060,14219,13981,-238
2017,5,26,0,14050,14171,13910,-261
2017,5,26,1,14200,14119,13852,-267
2017,5,26,2,13440,13341,13037,-304
2017,5,26,3,12130,12075,11359,-716
2017,5,26,4,10890,10915,10128,-787
2017,5,26,5,10080,10317,9357,-960
2017,5,26,6,9610,9932,8946,-986
2017,5,26,7,9380,9687,8990,-697
2017,5,26,8,9350,9629,9010,-619
2017,5,26,9,9610,9847,9292,-555
2017,5,26,10,10430,10595,9905,-690
2017,5,26,11,11950,11841,11244,-597
2017,5,26,12,13110,13061,12412,-649
2017,5,26,13,13500,13610,12891,-719
2017,5,26,14,13670,13816,13097,-719
2017,5,26,15,13810,13908,13127,-781
2017,5,26,16,13850,13787,13089,-698
2017,5,26,17,13800,13696,13041,-655
2017,5,26,18,13680,13747,12908,-839
2017,5,26,19,13590,13617,12806,-811
2017,5,26,20,13520,13495,12699,-796
2017,5,26,21,13590,13477,12785,-692
2017,5,26,22,13620,13605,12590,-1015
2017,5,26,23,13520,13562,12511,-1051
2017,5,27,0,13450,13479,12317,-1162
2017,5,27,1,13510,13493,12459,-1034
2017,5,27,2,12940,12926,12071,-855
2017,5,27,3,11900,11892,10829,-1063
2017,5,27,4,10810,10796,9401,-1395
2017,5,27,5,10010,10014,8413,-1601
2017,5,27,6,9540,9516,7956,-1560
2017,5,27,7,9250,9504,8171,-1333
2017,5,27,8,9080,9622,8495,-1127
2017,5,27,9,9150,9651,8485,-1166
2017,5,27,10,9340,9826,8911,-915
2017,5,27,11,9910,10284,9153,-1131
2017,5,27,12,10610,10930,10060,-870
2017,5,27,13,11430,11246,10471,-775
2017,5,27,14,11740,11497,10782,-715
2017,5,27,15,11890,11556,10892,-664
2017,5,27,16,11720,11419,10706,-713
2017,5,27,17,11580,11287,10593,-694
2017,5,27,18,11540,11148,10419,-729
2017,5,27,19,11460,11129,10403,-726
2017,5,27,20,11600,11265,10493,-772
2017,5,27,21,11880,11609,10829,-780
2017,5,27,22,12150,11990,11151,-839
2017,5,27,23,12400,12166,11048,-1118
2017,5,28,0,12420,12215,10924,-1291
2017,5,28,1,12700,12456,11361,-1095
2017,5,28,2,12300,12224,11221,-1003
2017,5,28,3,11390,11361,10200,-1161
2017,5,28,4,10450,10420,9103,-1317
2017,5,28,5,9710,9904,8056,-1848
2017,5,28,6,9260,9467,7614,-1853
2017,5,28,7,8970,9177,7890,-1287
2017,5,28,8,8810,9057,7975,-1082
2017,5,28,9,8860,9205,7665,-1540
2017,5,28,10,8930,9361,7617,-1744
2017,5,28,11,9190,9666,7997,-1669
2017,5,28,12,9870,10117,8352,-1765
2017,5,28,13,10730,10645,8751,-1894
2017,5,28,14,11330,10739,8807,-1932
2017,5,28,15,11550,10934,8929,-2005
2017,5,28,16,11720,11143,9237,-1906
2017,5,28,17,11720,11421,9486,-1935
2017,5,28,18,11710,11537,9553,-1984
2017,5,28,19,11680,11529,9581,-1948
2017,5,28,20,11790,11479,9495,-1984
2017,5,28,21,12130,11619,9632,-1987
2017,5,28,22,12490,11862,9752,-2110
2017,5,28,23,12700,11976,9751,-2225
2017,5,29,0,12750,12022,9577,-2445
2017,5,29,1,12950,12257,9911,-2346
2017,5,29,2,12510,11973,9536,-2437
2017,5,29,3,11470,11156,9011,-2145
2017,5,29,4,10450,10631,8447,-2184
2017,5,29,5,9710,10037,7720,-2317
2017,5,29,6,9220,9581,7611,-1970
2017,5,29,7,8950,9342,7569,-1773
2017,5,29,8,8720,9220,7541,-1679
2017,5,29,9,8840,9018,7503,-1515
2017,5,29,10,8940,9193,7603,-1590
2017,5,29,11,9170,9587,7891,-1696
2017,5,29,12,9810,10125,8434,-1691
2017,5,29,13,10560,10942,9538,-1404
2017,5,29,14,11230,11750,10226,-1524
2017,5,29,15,11650,12309,10570,-1739
2017,5,29,16,11820,12684,10945,-1739
2017,5,29,17,11850,12744,11028,-1716
2017,5,29,18,11790,12633,10834,-1799
2017,5,29,19,11810,12596,10724,-1872
2017,5,29,20,11880,12534,10649,-1885
2017,5,29,21,12200,12757,10908,-1849
2017,5,29,22,12620,13121,11207,-1914
2017,5,29,23,12750,13179,10931,-2248
2017,5,30,0,12890,13148,11049,-2099
2017,5,30,1,13150,13144,11074,-2070
2017,5,30,2,12400,12451,10182,-2269
2017,5,30,3,11240,11273,8955,-2318
2017,5,30,4,10160,10272,8028,-2244
2017,5,30,5,9620,9609,7362,-2247
2017,5,30,6,9200,9277,7088,-2189
2017,5,30,7,9000,9160,7143,-2017
2017,5,30,8,8900,9407,7171,-2236
2017,5,30,9,9200,9725,7607,-2118
2017,5,30,10,9970,10604,8773,-1831
2017,5,30,11,11670,11828,10191,-1637
2017,5,30,12,12870,12925,11336,-1589
2017,5,30,13,13310,13329,11761,-1568
2017,5,30,14,13430,13482,11933,-1549
2017,5,30,15,13530,13567,11963,-1604
2017,5,30,16,13570,13609,11937,-1672
2017,5,30,17,13540,13655,11915,-1740
2017,5,30,18,13590,13761,12008,-1753
2017,5,30,19,13490,13650,11835,-1815
2017,5,30,20,13450,13620,11565,-2055
2017,5,30,21,13580,13758,11595,-2163
2017,5,30,22,13680,13969,11798,-2171
2017,5,30,23,13680,14035,11815,-2220
2017,5,31,0,13650,14037,11710,-2327
2017,5,31,1,13860,14048,11762,-2286
2017,5,31,2,13220,13308,11140,-2168
2017,5,31,3,11940,11996,9788,-2208
2017,5,31,4,10760,10800,8604,-2196
2017,5,31,5,10130,10206,7902,-2304
2017,5,31,6,9670,9869,7643,-2226
2017,5,31,7,9440,9862,7501,-2361
2017,5,31,8,9380,9830,7405,-2425
2017,5,31,9,9660,10076,7513,-2563
2017,5,31,10,10480,10908,8336,-2572
2017,5,31,11,12090,12279,10075,-2204
2017,5,31,12,13300,13190,11042,-2148
2017,5,31,13,13710,13680,11523,-2157
2017,5,31,14,13880,13849,11643,-2206
2017,5,31,15,14060,14002,11593,-2409
2017,5,31,16,14130,14133,11740,-2393
2017,5,31,17,14130,14009,11656,-2353
2017,5,31,18,14230,13893,11708,-2185
2017,5,31,19,14200,13862,11692,-2170
2017,5,31,20,14270,13889,11800,-2089
2017,5,31,21,14480,14104,11946,-2158
2017,5,31,22,14580,14338,12324,-2014
2017,5,31,23,14580,14421,12198,-2223
2017,6,1,0,14530,14479,11908,-2571
2017,6,1,1,14720,14464,12270,-2194
2017,6,1,2,13890,13690,11904,-1786
2017,6,1,3,12480,12310,10306,-2004
2017,6,1,4,11200,11028,9019,-2009
2017,6,1,5,10170,10198,7808,-2390
2017,6,1,6,9670,9843,7260,-2583
2017,6,1,7,9410,9686,7265,-2421
2017,6,1,8,9380,9616,7219,-2397
2017,6,1,9,9630,9840,7571,-2269
2017,6,1,10,10420,10320,8053,-2267
2017,6,1,11,12080,11807,9505,-2302
2017,6,1,12,13120,12887,10628,-2259
2017,6,1,13,13590,13201,11233,-1968
2017,6,1,14,13700,13235,11300,-1935
2017,6,1,15,13860,13418,11435,-1983
2017,6,1,16,13960,13604,11546,-2058
2017,6,1,17,14000,13919,12006,-1913
2017,6,1,18,14080,14200,12517,-1683
2017,6,1,19,14150,14151,12384,-1767
2017,6,1,20,14300,14133,12073,-2060
2017,6,1,21,14480,14262,12164,-2098
2017,6,1,22,14700,14377,12173,-2204
2017,6,1,23,14580,14470,12216,-2254
2017,6,2,0,14510,14401,12204,-2197
2017,6,2,1,14430,14457,12427,-2030
2017,6,2,2,13690,13931,12115,-1816
2017,6,2,3,12320,12562,10554,-2008
2017,6,2,4,11070,11211,9022,-2189
2017,6,2,5,10140,10284,7834,-2450
2017,6,2,6,9640,10006,7595,-2411
2017,6,2,7,9370,9934,7873,-2061
2017,6,2,8,9310,9819,7693,-2126
2017,6,2,9,9560,9874,7860,-2014
2017,6,2,10,10290,10342,8251,-2091
2017,6,2,11,11590,11525,9717,-1808
2017,6,2,12,12700,12517,10786,-1731
2017,6,2,13,12950,12801,11072,-1729
2017,6,2,14,12940,12905,11435,-1470
2017,6,2,15,13010,13093,11812,-1281
2017,6,2,16,13200,13335,11976,-1359
2017,6,2,17,13280,13414,11630,-1784
2017,6,2,18,13340,13522,11721,-1801
2017,6,2,19,13370,13506,11481,-2025
2017,6,2,20,13560,13415,11530,-1885
2017,6,2,21,13630,13407,11571,-1836
2017,6,2,22,13690,13541,11719,-1822
2017,6,2,23,13680,13518,11544,-1974
2017,6,3,0,13540,13418,11713,-1705
2017,6,3,1,13540,13431,11740,-1691
2017,6,3,2,13120,13060,11553,-1507
2017,6,3,3,12100,11980,10153,-1827
2017,6,3,4,10950,10821,8821,-2000
2017,6,3,5,10030,9980,7708,-2272
2017,6,3,6,9540,9574,7019,-2555
2017,6,3,7,9230,9621,6980,-2641
2017,6,3,8,9120,9565,6980,-2585
2017,6,3,9,9170,9599,7079,-2520
2017,6,3,10,9350,9751,6972,-2779
2017,6,3,11,9720,10280,7671,-2609
2017,6,3,12,10420,10981,8617,-2364
2017,6,3,13,11140,11186,9188,-1998
2017,6,3,14,11560,11517,9653,-1864
2017,6,3,15,11590,11824,9923,-1901
2017,6,3,16,11480,11943,9869,-2074
2017,6,3,17,11390,11767,9595,-2172
2017,6,3,18,11240,11559,9386,-2173
2017,6,3,19,11210,11512,9317,-2195
2017,6,3,20,11440,11541,9438,-2103
2017,6,3,21,11670,11804,9716,-2088
2017,6,3,22,12000,12195,10156,-2039
2017,6,3,23,12140,12373,10303,-2070
2017,6,4,0,12220,12439,10463,-1976
2017,6,4,1,12490,12599,10828,-1771
2017,6,4,2,12220,12338,10583,-1755
2017,6,4,3,11360,11484,9667,-1817
2017,6,4,4,10400,10557,8665,-1892
2017,6,4,5,9820,10100,7906,-2194
2017,6,4,6,9330,9750,7656,-2094
2017,6,4,7,9050,9475,7341,-2134
2017,6,4,8,8930,9325,7243,-2082
2017,6,4,9,8940,9323,7172,-2151
2017,6,4,10,8980,9419,7150,-2269
2017,6,4,11,9270,9907,7564,-2343
2017,6,4,12,9730,10208,7737,-2471
2017,6,4,13,10430,10343,8041,-2302
2017,6,4,14,10720,10686,8706,-1980
2017,6,4,15,11140,10946,8946,-2000
2017,6,4,16,11400,11327,9312,-2015
2017,6,4,17,11590,11663,9640,-2023
2017,6,4,18,11650,11974,9765,-2209
2017,6,4,19,11720,12174,9934,-2240
2017,6,4,20,12090,12318,9910,-2408
2017,6,4,21,12500,12642,10276,-2366
2017,6,4,22,12870,13024,10336,-2688
2017,6,4,23,13040,13221,10484,-2737
2017,6,5,0,13200,13246,10542,-2704
2017,6,5,1,13090,13194,10513,-2681
2017,6,5,2,12590,12513,9882,-2631
2017,6,5,3,11470,11402,8536,-2866
2017,6,5,4,10430,10600,7653,-2947
2017,6,5,5,9750,10204,7414,-2790
2017,6,5,6,9350,10145,7346,-2799
2017,6,5,7,9190,10078,7199,-2879
2017,6,5,8,9220,10052,7319,-2733
2017,6,5,9,9480,10338,7616,-2722
2017,6,5,10,10310,10979,8456,-2523
2017,6,5,11,11910,12017,9708,-2309
2017,6,5,12,13230,13215,10962,-2253
2017,6,5,13,13630,13620,11502,-2118
2017,6,5,14,14080,13960,12105,-1855
2017,6,5,15,14210,14233,12355,-1878
2017,6,5,16,14260,14319,12560,-1759
2017,6,5,17,14230,14287,12420,-1867
2017,6,5,18,14250,14290,12536,-1754
2017,6,5,19,14200,14200,12442,-1758
2017,6,5,20,14190,14131,12251,-1880
2017,6,5,21,14320,14267,12250,-2017
2017,6,5,22,14540,14503,12480,-2023
2017,6,5,23,14510,14503,12071,-2432
2017,6,6,0,14360,14339,11919,-2420
2017,6,6,1,14180,14112,11771,-2341
2017,6,6,2,13510,13247,11100,-2147
2017,6,6,3,12160,11925,9870,-2055
2017,6,6,4,10950,10723,8898,-1825
2017,6,6,5,10080,10056,7816,-2240
2017,6,6,6,9610,10073,7980,-2093
2017,6,6,7,9380,10048,7703,-2345
2017,6,6,8,9270,10056,8094,-1962
2017,6,6,9,9570,10078,8127,-1951
2017,6,6,10,10410,10721,8644,-2077
2017,6,6,11,11980,12062,9965,-2097
2017,6,6,12,13200,13216,11362,-1854
2017,6,6,13,13590,13703,11931,-1772
2017,6,6,14,13880,13964,12501,-1463
2017,6,6,15,14050,14217,12821,-1396
2017,6,6,16,14140,14298,12915,-1383
2017,6,6,17,14120,14280,12650,-1630
2017,6,6,18,14170,14155,12468,-1687
2017,6,6,19,14070,14021,12270,-1751
2017,6,6,20,13950,14002,12182,-1820
2017,6,6,21,14110,14173,12263,-1910
2017,6,6,22,14320,14437,12312,-2125
2017,6,6,23,14350,14418,12326,-2092
2017,6,7,0,14280,14252,12074,-2178
2017,6,7,1,14140,14133,12180,-1953
2017,6,7,2,13410,13372,11472,-1900
2017,6,7,3,12140,12089,9808,-2281
2017,6,7,4,10960,10853,8639,-2214
2017,6,7,5,10040,10263,7807,-2456
2017,6,7,6,9600,10014,7409,-2605
2017,6,7,7,9380,9713,7307,-2406
2017,6,7,8,9360,9877,7348,-2529
2017,6,7,9,9580,10171,7809,-2362
2017,6,7,10,10300,10697,8443,-2254
2017,6,7,11,11800,11933,9844,-2089
2017,6,7,12,12930,12934,10545,-2389
2017,6,7,13,13260,13133,10953,-2180
2017,6,7,14,13290,13122,11056,-2066
2017,6,7,15,13180,13063,11386,-1677
2017,6,7,16,13050,12903,11373,-1530
2017,6,7,17,13050,12771,11170,-1601
2017,6,7,18,13030,12784,11117,-1667
2017,6,7,19,13190,12791,11062,-1729
2017,6,7,20,13370,12919,11230,-1689
2017,6,7,21,13530,13244,11644,-1600
2017,6,7,22,13690,13632,11934,-1698
2017,6,7,23,13730,13865,12021,-1844
2017,6,8,0,13830,13903,12180,-1723
2017,6,8,1,14020,13984,12180,-1804
2017,6,8,2,13490,13576,11951,-1625
2017,6,8,3,12160,12234,10242,-1992
2017,6,8,4,10890,10957,8915,-2042
2017,6,8,5,10020,10314,8070,-2244
2017,6,8,6,9560,9841,7703,-2138
2017,6,8,7,9320,9868,7881,-1987
2017,6,8,8,9240,9784,7737,-2047
2017,6,8,9,9560,10012,7913,-2099
2017,6,8,10,10370,10699,8595,-2104
2017,6,8,11,11960,11997,9992,-2005
2017,6,8,12,13140,12722,10475,-2247
2017,6,8,13,13530,12943,10773,-2170
2017,6,8,14,13710,13152,11088,-2064
2017,6,8,15,13930,13323,11178,-2145
2017,6,8,16,14110,13478,11380,-2098
2017,6,8,17,14150,13525,11515,-2010
2017,6,8,18,14260,13749,11647,-2102
2017,6,8,19,14380,13959,11974,-1985
2017,6,8,20,14550,14119,12072,-2047
2017,6,8,21,14610,14301,12121,-2180
2017,6,8,22,14750,14234,11904,-2330
2017,6,8,23,14570,14066,11735,-2331
2017,6,9,0,14390,14033,11886,-2147
2017,6,9,1,14390,14119,12095,-2024
2017,6,9,2,13840,13508,11439,-2069
2017,6,9,3,12520,12207,10227,-1980
2017,6,9,4,11220,11043,9105,-1938
2017,6,9,5,10050,10330,8359,-1971
2017,6,9,6,9570,9931,7778,-2153
2017,6,9,7,9320,9862,7729,-2133
2017,6,9,8,9290,9813,7510,-2303
2017,6,9,9,9530,10283,7659,-2624
2017,6,9,10,10270,10740,8342,-2398
2017,6,9,11,11650,11879,9832,-2047
2017,6,9,12,12840,12902,10774,-2128
2017,6,9,13,13230,13292,10909,-2383
2017,6,9,14,13490,13221,11145,-2076
2017,6,9,15,13690,13495,11538,-1957
2017,6,9,16,13820,13751,11655,-2096
2017,6,9,17,13920,13788,11711,-2077
2017,6,9,18,14030,13881,11739,-2142
2017,6,9,19,14010,14032,11938,-2094
2017,6,9,20,14080,14131,12043,-2088
2017,6,9,21,14200,14368,12410,-1958
2017,6,9,22,14240,14542,12645,-1897
2017,6,9,23,14050,14525,12500,-2025
2017,6,10,0,13880,14385,12315,-2070
2017,6,10,1,13960,14324,12254,-2070
2017,6,10,2,13570,13959,12147,-1812
2017,6,10,3,12470,12855,10338,-2517
2017,6,10,4,11300,11768,9273,-2495
2017,6,10,5,10820,10934,8371,-2563
2017,6,10,6,10220,10717,7990,-2727
2017,6,10,7,9870,10436,7738,-2698
2017,6,10,8,9420,10222,7561,-2661
2017,6,10,9,9450,10187,7489,-2698
2017,6,10,10,9590,10287,7540,-2747
2017,6,10,11,10210,10622,8019,-2603
2017,6,10,12,11080,11585,8928,-2657
2017,6,10,13,12020,12142,9654,-2488
2017,6,10,14,12660,12434,10224,-2210
2017,6,10,15,13120,12882,10328,-2554
2017,6,10,16,13420,13183,10595,-2588
2017,6,10,17,13580,13499,11335,-2164
2017,6,10,18,13730,13789,11478,-2311
2017,6,10,19,13850,13930,11556,-2374
2017,6,10,20,14160,14148,11802,-2346
2017,6,10,21,14480,14567,12169,-2398
2017,6,10,22,14800,14931,12666,-2265
2017,6,10,23,14900,15035,12306,-2729
2017,6,11,0,14760,14848,11969,-2879
2017,6,11,1,14910,14838,11973,-2865
2017,6,11,2,14600,14591,12156,-2435
2017,6,11,3,13540,13619,11021,-2598
2017,6,11,4,12420,12479,9974,-2505
2017,6,11,5,11670,11722,8861,-2861
2017,6,11,6,11000,11286,8649,-2637
2017,6,11,7,10580,11163,8421,-2742
2017,6,11,8,10100,10723,8054,-2669
2017,6,11,9,10000,10512,8028,-2484
2017,6,11,10,9960,10494,8210,-2284
2017,6,11,11,10530,10920,8793,-2127
2017,6,11,12,11450,11477,9550,-1927
2017,6,11,13,12780,12517,10764,-1753
2017,6,11,14,13950,13692,11707,-1985
2017,6,11,15,14750,14659,12695,-1964
2017,6,11,16,15830,15371,13434,-1937
2017,6,11,17,16470,15799,13739,-2060
2017,6,11,18,16820,16121,13781,-2340
2017,6,11,19,17390,16497,14117,-2380
2017,6,11,20,17990,17061,14701,-2360
2017,6,11,21,18640,17874,15617,-2257
2017,6,11,22,19000,18564,16479,-2085
2017,6,11,23,18920,18885,16330,-2555
2017,6,12,0,18420,18732,15819,-2913
2017,6,12,1,18390,18522,15513,-3009
2017,6,12,2,17780,17946,15139,-2807
2017,6,12,3,16190,16283,13585,-2698
2017,6,12,4,14650,14799,11871,-2928
2017,6,12,5,13540,13893,11021,-2872
2017,6,12,6,12720,13369,10420,-2949
2017,6,12,7,12280,13123,10084,-3039
2017,6,12,8,11950,12922,9802,-3120
2017,6,12,9,12000,13003,10223,-2780
2017,6,12,10,12710,13533,10822,-2711
2017,6,12,11,14310,14465,12103,-2362
2017,6,12,12,16170,15935,13657,-2278
2017,6,12,13,17330,17038,14981,-2057
2017,6,12,14,18500,17980,15848,-2132
2017,6,12,15,19670,18984,16993,-1991
2017,6,12,16,20540,19871,17579,-2292
2017,6,12,17,21140,20589,17729,-2860
2017,6,12,18,21870,21274,18145,-3129
2017,6,12,19,22430,21730,18850,-2880
2017,6,12,20,22870,22269,19588,-2681
2017,6,12,21,23400,22802,20179,-2623
2017,6,12,22,23210,23087,20349,-2738
2017,6,12,23,22870,22916,20007,-2909
2017,6,13,0,21830,22345,19315,-3030
2017,6,13,1,21650,21758,18819,-2939
2017,6,13,2,20510,20718,18101,-2617
2017,6,13,3,18440,18582,16019,-2563
2017,6,13,4,16440,16628,14064,-2564
2017,6,13,5,14880,15785,13061,-2724
2017,6,13,6,14090,15178,12557,-2621
2017,6,13,7,13450,14915,12301,-2614
2017,6,13,8,13080,14539,11735,-2804
2017,6,13,9,13180,14552,11782,-2770
2017,6,13,10,13720,14886,12296,-2590
2017,6,13,11,15370,15754,13717,-2037
2017,6,13,12,17010,17084,14786,-2298
2017,6,13,13,18310,18222,15508,-2714
2017,6,13,14,19200,19160,16530,-2630
2017,6,13,15,20190,20032,17187,-2845
2017,6,13,16,20900,20984,17981,-3003
2017,6,13,17,21270,21756,18689,-3067
2017,6,13,18,21820,22532,19368,-3164
2017,6,13,19,22290,23095,19873,-3222
2017,6,13,20,22470,23516,20297,-3219
2017,6,13,21,22500,23717,20590,-3127
2017,6,13,22,22330,23426,20109,-3317
2017,6,13,23,21880,22831,19325,-3506
2017,6,14,0,21150,22206,19049,-3157
2017,6,14,1,20540,21702,18557,-3145
2017,6,14,2,19500,20612,17537,-3075
2017,6,14,3,17540,18501,15690,-2811
2017,6,14,4,15520,16697,14282,-2415
2017,6,14,5,14540,15285,12633,-2652
2017,6,14,6,13580,14371,11754,-2617
2017,6,14,7,12870,13784,11794,-1990
2017,6,14,8,12480,13560,11570,-1990
2017,6,14,9,12870,13856,11317,-2539
2017,6,14,10,13220,13767,11228,-2539
2017,6,14,11,14370,14519,12145,-2374
2017,6,14,12,15570,15557,13316,-2241
2017,6,14,13,16000,15871,13505,-2366
2017,6,14,14,16260,16064,14011,-2053
2017,6,14,15,16440,16340,14284,-2056
2017,6,14,16,16430,16594,14584,-2010
2017,6,14,17,16600,16784,14779,-2005
2017,6,14,18,16950,17106,15109,-1997
2017,6,14,19,17190,17339,15568,-1771
2017,6,14,20,17340,17711,16081,-1630
2017,6,14,21,17450,18091,16436,-1655
2017,6,14,22,17600,18156,16035,-2121
2017,6,14,23,17270,17792,15779,-2013
2017,6,15,0,16900,17121,15347,-1774
2017,6,15,1,16690,16515,14442,-2073
2017,6,15,2,15900,15778,13399,-2379
2017,6,15,3,14240,14159,11799,-2360
2017,6,15,4,12620,12525,10415,-2110
2017,6,15,5,11500,11463,9680,-1783
2017,6,15,6,10780,11428,9318,-2110
2017,6,15,7,10330,11473,9390,-2083
2017,6,15,8,10100,11285,9235,-2050
2017,6,15,9,10190,11391,8920,-2471
2017,6,15,10,10720,11967,9568,-2399
2017,6,15,11,12130,12674,10854,-1820
2017,6,15,12,13230,13448,11987,-1461
2017,6,15,13,13640,13831,12751,-1080
2017,6,15,14,14060,14044,12927,-1117
2017,6,15,15,14280,14258,13138,-1120
2017,6,15,16,14450,14473,13267,-1206
2017,6,15,17,14550,14598,13377,-1221
2017,6,15,18,14790,14871,13651,-1220
2017,6,15,19,15010,15048,13819,-1229
2017,6,15,20,15310,15334,14138,-1196
2017,6,15,21,15650,15609,14276,-1333
2017,6,15,22,15830,15743,14441,-1302
2017,6,15,23,15620,15544,14183,-1361
2017,6,16,0,15390,15220,13894,-1326
2017,6,16,1,15330,15122,13831,-1291
2017,6,16,2,14710,14553,13027,-1526
2017,6,16,3,13200,13212,11262,-1950
2017,6,16,4,11750,11879,10184,-1695
2017,6,16,5,10840,11252,9418,-1834
2017,6,16,6,10320,11005,9196,-1809
2017,6,16,7,10020,10977,9010,-1967
2017,6,16,8,9960,10908,8989,-1919
2017,6,16,9,10190,11066,9068,-1998
2017,6,16,10,10920,11347,9696,-1651
2017,6,16,11,12330,12501,11337,-1164
2017,6,16,12,13500,13512,12460,-1052
2017,6,16,13,13940,14109,13106,-1003
2017,6,16,14,14210,14389,13326,-1063
2017,6,16,15,14480,14633,13445,-1188
2017,6,16,16,14650,14883,13647,-1236
2017,6,16,17,14640,14987,13692,-1295
2017,6,16,18,14740,15148,13824,-1324
2017,6,16,19,14700,15113,13787,-1326
2017,6,16,20,14620,14951,13505,-1446
2017,6,16,21,14610,14830,13353,-1477
2017,6,16,22,14590,14714,13156,-1558
2017,6,16,23,14420,14497,12940,-1557
2017,6,17,0,14210,14265,12654,-1611
2017,6,17,1,14160,14126,12519,-1607
2017,6,17,2,13810,13605,11925,-1680
2017,6,17,3,12820,12754,10954,-1800
2017,6,17,4,11710,11805,10098,-1707
2017,6,17,5,10680,11227,8860,-2367
2017,6,17,6,10160,10700,8550,-2150
2017,6,17,7,9890,10665,8672,-1993
2017,6,17,8,9760,10579,8559,-2020
2017,6,17,9,9850,10807,8612,-2195
2017,6,17,10,10060,11067,8854,-2213
2017,6,17,11,10680,11559,9195,-2364
2017,6,17,12,11670,11850,9651,-2199
2017,6,17,13,12730,12408,10498,-1910
2017,6,17,14,13430,13100,11306,-1794
2017,6,17,15,13940,13435,11762,-1673
2017,6,17,16,14230,13547,11928,-1619
2017,6,17,17,14540,13495,11999,-1496
2017,6,17,18,14680,13468,12073,-1395
2017,6,17,19,14730,13574,11954,-1620
2017,6,17,20,14840,13671,12071,-1600
2017,6,17,21,15110,13809,12298,-1511
2017,6,17,22,15270,14057,12546,-1511
2017,6,17,23,15360,14167,12636,-1531
2017,6,18,0,15140,14186,12514,-1672
2017,6,18,1,15170,14303,12566,-1737
2017,6,18,2,14990,14119,12355,-1764
2017,6,18,3,13960,13293,11284,-2009
2017,6,18,4,12790,12279,10420,-1859
2017,6,18,5,11430,11495,9456,-2039
2017,6,18,6,10880,11160,8915,-2245
2017,6,18,7,10550,11066,8702,-2364
2017,6,18,8,10380,11081,8695,-2386
2017,6,18,9,10370,11135,8734,-2401
2017,6,18,10,10490,11308,8765,-2543
2017,6,18,11,10950,11613,9386,-2227
2017,6,18,12,11780,12097,9880,-2217
2017,6,18,13,12870,12905,10917,-1988
2017,6,18,14,13670,13511,11871,-1640
2017,6,18,15,14370,14198,12684,-1514
2017,6,18,16,14890,14907,13382,-1525
2017,6,18,17,15250,15467,14040,-1427
2017,6,18,18,15470,15965,14592,-1373
2017,6,18,19,15630,16359,14870,-1489
2017,6,18,20,15950,16730,15054,-1676
2017,6,18,21,16280,17231,15472,-1759
2017,6,18,22,16750,17621,15617,-2004
2017,6,18,23,16900,17695,15626,-2069
2017,6,19,0,16730,17510,15496,-2014
2017,6,19,1,16740,17486,15454,-2032
2017,6,19,2,16410,17078,14968,-2110
2017,6,19,3,15080,15677,13425,-2252
2017,6,19,4,13750,14205,11688,-2517
2017,6,19,5,13180,13402,10844,-2558
2017,6,19,6,12600,13127,10731,-2396
2017,6,19,7,12270,12827,10512,-2315
2017,6,19,8,12190,12951,10347,-2604
2017,6,19,9,12520,13247,10585,-2662
2017,6,19,10,13050,13590,11245,-2345
2017,6,19,11,14490,14874,12894,-1980
2017,6,19,12,16080,16389,14632,-1757
2017,6,19,13,16970,17234,15329,-1905
2017,6,19,14,17760,17940,15975,-1965
2017,6,19,15,18450,18607,16452,-2155
2017,6,19,16,18890,19075,16574,-2501
2017,6,19,17,19460,19458,17179,-2279
2017,6,19,18,19900,19937,17451,-2486
2017,6,19,19,20210,20365,17853,-2512
2017,6,19,20,20370,20598,18341,-2257
2017,6,19,21,20560,20516,18326,-2190
2017,6,19,22,20750,20424,18046,-2378
2017,6,19,23,20370,19895,17437,-2458
2017,6,20,0,19580,19231,16584,-2647
2017,6,20,1,19250,18721,16269,-2452
2017,6,20,2,18420,17684,15592,-2092
2017,6,20,3,16550,16021,14145,-1876
2017,6,20,4,14750,14404,12430,-1974
2017,6,20,5,13470,13633,11497,-2136
2017,6,20,6,12760,13426,10934,-2492
2017,6,20,7,12310,13272,10692,-2580
2017,6,20,8,12000,13301,10564,-2737
2017,6,20,9,12160,13387,10540,-2847
2017,6,20,10,12890,13784,11156,-2628
2017,6,20,11,14400,14706,12172,-2534
2017,6,20,12,15930,15748,13479,-2269
2017,6,20,13,16700,16436,14251,-2185
2017,6,20,14,17270,16962,15038,-1924
2017,6,20,15,17940,17576,15635,-1941
2017,6,20,16,18520,18038,15992,-2046
2017,6,20,17,18870,18255,16007,-2248
2017,6,20,18,19260,18554,16259,-2295
2017,6,20,19,19540,18725,16404,-2321
2017,6,20,20,19830,19009,16415,-2594
2017,6,20,21,20000,19297,16620,-2677
2017,6,20,22,19820,19411,16594,-2817
2017,6,20,23,19320,19082,16455,-2627
2017,6,21,0,18650,18458,16078,-2380
2017,6,21,1,18340,17897,15470,-2427
2017,6,21,2,17580,17187,14964,-2223
2017,6,21,3,15870,15493,13391,-2102
2017,6,21,4,14180,13764,11713,-2051
2017,6,21,5,12710,12823,10663,-2160
2017,6,21,6,11930,12537,10276,-2261
2017,6,21,7,11450,12310,10247,-2063
2017,6,21,8,11090,12351,10118,-2233
2017,6,21,9,11240,12230,9973,-2257
2017,6,21,10,11780,12582,10289,-2293
2017,6,21,11,13200,13451,11553,-1898
2017,6,21,12,14600,14531,12919,-1612
2017,6,21,13,15470,15335,13827,-1508
2017,6,21,14,15840,15876,14196,-1680
2017,6,21,15,16530,16336,14524,-1812
2017,6,21,16,16910,16684,14997,-1687
2017,6,21,17,17120,16986,15439,-1547
2017,6,21,18,17540,17334,15663,-1671
2017,6,21,19,17850,17649,15952,-1697
2017,6,21,20,18100,17965,16178,-1787
2017,6,21,21,18600,18293,16200,-2093
2017,6,21,22,18390,18424,16221,-2203
2017,6,21,23,18000,18170,16033,-2137
2017,6,22,0,17390,17673,15778,-1895
2017,6,22,1,17130,17194,15218,-1976
2017,6,22,2,16540,16616,14846,-1770
2017,6,22,3,15000,15056,13314,-1742
2017,6,22,4,13440,13636,11762,-1874
2017,6,22,5,12100,12652,10581,-2071
2017,6,22,6,11390,11930,9614,-2316
2017,6,22,7,10940,11838,9327,-2511
2017,6,22,8,10690,11745,9039,-2706
2017,6,22,9,10770,11820,9112,-2708
2017,6,22,10,11340,12335,9687,-2648
2017,6,22,11,12720,13197,10766,-2431
2017,6,22,12,13980,14032,11784,-2248
2017,6,22,13,14660,14651,12723,-1928
2017,6,22,14,15120,15103,12989,-2114
2017,6,22,15,15730,15572,13611,-1961
2017,6,22,16,16120,16018,13996,-2022
2017,6,22,17,16520,16401,14572,-1829
2017,6,22,18,17000,16980,15199,-1781
2017,6,22,19,17200,17367,15811,-1556
2017,6,22,20,17750,17848,16078,-1770
2017,6,22,21,18140,18323,16198,-2125
2017,6,22,22,18240,18555,16520,-2035
2017,6,22,23,18030,18218,15883,-2335
2017,6,23,0,17470,17838,15843,-1995
2017,6,23,1,17320,17632,15720,-1912
2017,6,23,2,16710,17092,14949,-2143
2017,6,23,3,15200,15631,13205,-2426
2017,6,23,4,13700,14088,11719,-2369
2017,6,23,5,12930,13031,10735,-2296
2017,6,23,6,12190,12924,10407,-2517
2017,6,23,7,11770,12764,10342,-2422
2017,6,23,8,11580,12648,10218,-2430
2017,6,23,9,11760,12525,9922,-2603
2017,6,23,10,12420,12924,10488,-2436
2017,6,23,11,13870,13890,11808,-2082
2017,6,23,12,15330,15308,13456,-1852
2017,6,23,13,16360,16352,14367,-1985
2017,6,23,14,17050,17053,15155,-1898
2017,6,23,15,17910,17722,15949,-1773
2017,6,23,16,18630,18458,16495,-1963
2017,6,23,17,19240,19315,17249,-2066
2017,6,23,18,19570,20089,17532,-2557
2017,6,23,19,19790,20206,17229,-2977
2017,6,23,20,19930,20330,17122,-3208
2017,6,23,21,19990,20387,17177,-3210
2017,6,23,22,19560,20302,17464,-2838
2017,6,23,23,19040,19770,17008,-2762
2017,6,24,0,18520,19100,16462,-2638
2017,6,24,1,18310,18722,16277,-2445
2017,6,24,2,17840,18154,15773,-2381
2017,6,24,3,16480,16881,14494,-2387
2017,6,24,4,14980,15433,12991,-2442
2017,6,24,5,13840,14308,11962,-2346
2017,6,24,6,13120,13568,11293,-2275
2017,6,24,7,12640,13325,10719,-2606
2017,6,24,8,12350,13553,10784,-2769
2017,6,24,9,12710,13532,10742,-2790
2017,6,24,10,12730,13661,10546,-3115
2017,6,24,11,13250,14119,11190,-2929
2017,6,24,12,14220,14651,12003,-2648
2017,6,24,13,15140,15588,13070,-2518
2017,6,24,14,16160,16347,13688,-2659
2017,6,24,15,16840,16790,14169,-2621
2017,6,24,16,17160,16883,14092,-2791
2017,6,24,17,17410,16914,14673,-2241
2017,6,24,18,17640,17058,15050,-2008
2017,6,24,19,17750,17378,15475,-1903
2017,6,24,20,18080,17748,15722,-2026
2017,6,24,21,18220,18083,16121,-1962
2017,6,24,22,18500,18215,15801,-2414
2017,6,24,23,18130,18201,15718,-2483
2017,6,25,0,17470,17672,15351,-2321
2017,6,25,1,17030,16976,14759,-2217
2017,6,25,2,16660,16409,14508,-1901
2017,6,25,3,15350,15161,13286,-1875
2017,6,25,4,13920,13796,12147,-1649
2017,6,25,5,12920,12769,10942,-1827
2017,6,25,6,12120,12458,10645,-1813
2017,6,25,7,11560,12457,10487,-1970
2017,6,25,8,11150,12097,9957,-2140
2017,6,25,9,10980,11872,9463,-2409
2017,6,25,10,10880,11900,9421,-2479
2017,6,25,11,11190,12165,9621,-2544
2017,6,25,12,12060,12276,10163,-2113
2017,6,25,13,12970,12683,10982,-1701
2017,6,25,14,13870,13373,11545,-1828
2017,6,25,15,14760,13982,11853,-2129
2017,6,25,16,15270,14499,12449,-2050
2017,6,25,17,15630,15010,13005,-2005
2017,6,25,18,16180,15476,13388,-2088
2017,6,25,19,16520,15920,13675,-2245
2017,6,25,20,16940,16085,13710,-2375
2017,6,25,21,17440,16029,13745,-2284
2017,6,25,22,17750,16304,14186,-2118
2017,6,25,23,17440,16405,14379,-2026
2017,6,26,0,16770,16148,13964,-2184
2017,6,26,1,16710,15873,13749,-2124
2017,6,26,2,16120,15439,13435,-2004
2017,6,26,3,14760,14105,12046,-2059
2017,6,26,4,13300,12753,10606,-2147
2017,6,26,5,11950,11774,9755,-2019
2017,6,26,6,11300,11369,9468,-1901
2017,6,26,7,10870,11194,9186,-2008
2017,6,26,8,10620,11104,8981,-2123
2017,6,26,9,10650,11202,8914,-2288
2017,6,26,10,11310,11585,9501,-2084
2017,6,26,11,12800,12718,10856,-1862
2017,6,26,12,14270,13699,11797,-1902
2017,6,26,13,14940,14340,12456,-1884
2017,6,26,14,15380,14713,13126,-1587
2017,6,26,15,15910,15160,13761,-1399
2017,6,26,16,16240,15556,14239,-1317
2017,6,26,17,16520,15848,14244,-1604
2017,6,26,18,16880,16154,14366,-1788
2017,6,26,19,17190,16320,14062,-2258
2017,6,26,20,17420,16542,14448,-2094
2017,6,26,21,17750,16859,14679,-2180
2017,6,26,22,17610,17099,14853,-2246
2017,6,26,23,17280,16933,14907,-2026
2017,6,27,0,16670,16517,14537,-1980
2017,6,27,1,16510,16163,14328,-1835
2017,6,27,2,15820,15558,13657,-1901
2017,6,27,3,14290,14141,12052,-2089
2017,6,27,4,12840,12623,10606,-2017
2017,6,27,5,11570,11579,9855,-1724
2017,6,27,6,10920,11241,9450,-1791
2017,6,27,7,10570,11331,9464,-1867
2017,6,27,8,10420,11164,9472,-1692
2017,6,27,9,10600,11085,9283,-1802
2017,6,27,10,11230,11373,9874,-1499
2017,6,27,11,12590,12344,10982,-1362
2017,6,27,12,13820,13553,12185,-1368
2017,6,27,13,14490,14266,13066,-1200
2017,6,27,14,14860,14828,13693,-1135
2017,6,27,15,15330,15160,13967,-1193
2017,6,27,16,15680,15192,13627,-1565
2017,6,27,17,15910,15240,13649,-1591
2017,6,27,18,16300,15579,13970,-1609
2017,6,27,19,16500,15717,14310,-1407
2017,6,27,20,16630,15663,14378,-1285
2017,6,27,21,16850,15709,14423,-1286
2017,6,27,22,16820,15908,14320,-1588
2017,6,27,23,16410,15780,14201,-1579
2017,6,28,0,16150,15359,13605,-1754
2017,6,28,1,15870,15087,13458,-1629
2017,6,28,2,15220,14471,12884,-1587
2017,6,28,3,13760,13624,11839,-1785
2017,6,28,4,12350,12234,10458,-1776
2017,6,28,5,10830,11456,9516,-1940
2017,6,28,6,10250,10928,8908,-2020
2017,6,28,7,9930,11001,8693,-2308
2017,6,28,8,9800,10981,8607,-2374
2017,6,28,9,9980,11272,9068,-2204
2017,6,28,10,10550,11752,9739,-2013
2017,6,28,11,11790,12551,10683,-1868
2017,6,28,12,12950,13549,11764,-1785
2017,6,28,13,13450,13626,12081,-1545
2017,6,28,14,13660,13703,12410,-1293
2017,6,28,15,14080,13977,12976,-1001
2017,6,28,16,14250,14245,13135,-1110
2017,6,28,17,14510,14504,13580,-924
2017,6,28,18,15070,14816,13627,-1189
2017,6,28,19,15440,14979,13649,-1330
2017,6,28,20,15630,15142,13742,-1400
2017,6,28,21,15880,15510,14413,-1097
2017,6,28,22,16150,15900,14622,-1278
2017,6,28,23,15990,15917,14471,-1446
2017,6,29,0,15610,15648,14107,-1541
2017,6,29,1,15360,15413,13954,-1459
2017,6,29,2,14770,14966,13574,-1392
2017,6,29,3,13520,13621,11909,-1712
2017,6,29,4,12170,12225,10566,-1659
2017,6,29,5,10930,11733,10068,-1665
2017,6,29,6,10300,11469,9570,-1899
2017,6,29,7,10050,11144,9086,-2058
2017,6,29,8,9880,11267,9117,-2150
2017,6,29,9,10110,11235,9131,-2104
2017,6,29,10,10730,11544,9745,-1799
2017,6,29,11,12350,12323,10594,-1729
2017,6,29,12,13390,13488,11621,-1867
2017,6,29,13,14240,14235,12379,-1856
2017,6,29,14,14580,14627,12768,-1859
2017,6,29,15,15050,15136,13334,-1802
2017,6,29,16,15410,15604,13754,-1850
2017,6,29,17,15780,15921,13990,-1931
2017,6,29,18,16140,16147,14096,-2051
2017,6,29,19,16400,16396,14478,-1918
2017,6,29,20,16450,16489,14735,-1754
2017,6,29,21,16840,16507,14708,-1799
2017,6,29,22,16850,16417,14714,-1703
2017,6,29,23,16640,16146,14302,-1844
2017,6,30,0,16260,15900,13779,-2121
2017,6,30,1,16180,15841,13561,-2280
2017,6,30,2,15740,15353,13505,-1848
2017,6,30,3,14310,14137,11825,-2312
2017,6,30,4,12950,12832,10681,-2151
2017,6,30,5,12270,11953,9758,-2195
2017,6,30,6,11640,11823,9867,-1956
2017,6,30,7,11290,11768,9860,-1908
2017,6,30,8,10900,11682,9655,-2027
2017,6,30,9,11020,11787,9651,-2136
2017,6,30,10,11740,11995,9956,-2039
2017,6,30,11,13190,12924,10999,-1925
2017,6,30,12,14740,14307,12446,-1861
2017,6,30,13,15750,15223,13381,-1842
2017,6,30,14,16530,15828,13997,-1831
2017,6,30,15,17360,16361,14410,-1951
2017,6,30,16,18070,16704,14640,-2064
2017,6,30,17,18740,17158,15102,-2056
2017,6,30,18,19450,17805,15684,-2121
2017,6,30,19,19840,18467,16711,-1756
2017,6,30,20,20120,18966,17110,-1856
2017,6,30,21,20300,19536,17589,-1947
2017,6,30,22,20180,19662,17524,-2138
2017,6,30,23,19660,19072,16546,-2526
2017,7,1,0,19100,18364,15803,-2561
2017,7,1,1,18710,17783,15078,-2705
2017,7,1,2,18230,17022,14572,-2450
2017,7,1,3,16830,15798,13236,-2562
2017,7,1,4,15310,14338,12089,-2249
2017,7,1,5,13180,13341,11068,-2273
2017,7,1,6,12410,12700,10703,-1997
2017,7,1,7,11920,12461,10146,-2315
2017,7,1,8,11790,12154,9874,-2280
2017,7,1,9,11680,12059,9743,-2316
2017,7,1,10,11830,12329,9758,-2571
2017,7,1,11,12360,12674,10115,-2559
2017,7,1,12,13420,13418,11254,-2164
2017,7,1,13,14700,14649,12741,-1908
2017,7,1,14,15670,15420,13299,-2121
2017,7,1,15,16540,16419,14182,-2237
2017,7,1,16,17080,17308,14983,-2325
2017,7,1,17,17390,17904,15397,-2507
2017,7,1,18,17520,18180,15485,-2695
2017,7,1,19,17750,18283,15430,-2853
2017,7,1,20,18010,18327,15646,-2681
2017,7,1,21,18040,18254,15954,-2300
2017,7,1,22,18200,18127,15603,-2524
2017,7,1,23,17930,17834,15259,-2575
2017,7,2,0,17580,17454,14976,-2478
2017,7,2,1,17310,17242,14849,-2393
2017,7,2,2,16890,16743,14203,-2540
2017,7,2,3,15750,15935,13131,-2804
2017,7,2,4,14480,14783,12111,-2672
2017,7,2,5,13480,13815,11024,-2791
2017,7,2,6,12770,13566,10627,-2939
2017,7,2,7,12260,13079,9954,-3125
2017,7,2,8,11940,12745,9716,-3029
2017,7,2,9,11790,12685,9749,-2936
2017,7,2,10,11770,12761,9893,-2868
2017,7,2,11,12040,13085,9964,-3121
2017,7,2,12,12780,13707,10690,-3017
2017,7,2,13,13790,14406,11735,-2671
2017,7,2,14,14700,15028,12539,-2489
2017,7,2,15,15710,15733,13382,-2351
2017,7,2,16,16420,16312,14117,-2195
2017,7,2,17,17080,16784,14684,-2100
2017,7,2,18,17500,17194,15015,-2179
2017,7,2,19,17950,17597,15500,-2097
2017,7,2,20,18630,18072,15861,-2211
2017,7,2,21,19130,18625,16497,-2128
2017,7,2,22,19250,19076,16917,-2159
2017,7,2,23,19030,19128,16888,-2240
2017,7,3,0,18800,18582,16233,-2349
2017,7,3,1,18600,18001,15719,-2282
2017,7,3,2,17770,17508,15114,-2394
2017,7,3,3,16340,16265,13643,-2622
2017,7,3,4,14800,15101,12435,-2666
2017,7,3,5,13620,14212,11604,-2608
2017,7,3,6,12850,13673,11078,-2595
2017,7,3,7,12320,13400,10955,-2445
2017,7,3,8,11980,13313,10745,-2568
2017,7,3,9,12010,13311,10552,-2759
2017,7,3,10,12450,13567,10766,-2801
2017,7,3,11,13470,14230,11713,-2517
2017,7,3,12,14780,14864,12557,-2307
2017,7,3,13,15790,15531,13509,-2022
2017,7,3,14,16620,16403,14541,-1862
2017,7,3,15,17500,17042,15091,-1951
2017,7,3,16,18150,17644,15595,-2049
2017,7,3,17,18620,17950,15954,-1996
2017,7,3,18,19040,18259,16239,-2020
2017,7,3,19,19310,18498,16488,-2010
2017,7,3,20,19500,18829,17001,-1828
2017,7,3,21,19740,19285,17471,-1814
2017,7,3,22,19900,19536,17665,-1871
2017,7,3,23,19250,19262,16940,-2322
2017,7,4,0,18600,18427,15879,-2548
2017,7,4,1,18060,17503,15075,-2428
2017,7,4,2,17270,16722,14824,-1898
2017,7,4,3,15720,15360,13212,-2148
2017,7,4,4,14250,14248,12115,-2133
2017,7,4,5,12790,13317,11127,-2190
2017,7,4,6,11950,12677,10529,-2148
2017,7,4,7,11370,12366,9888,-2478
2017,7,4,8,10990,12219,9646,-2573
2017,7,4,9,10850,12112,9550,-2562
2017,7,4,10,10810,12046,9418,-2628
2017,7,4,11,10990,12191,9531,-2660
2017,7,4,12,11940,12439,10176,-2263
2017,7,4,13,12840,13007,11124,-1883
2017,7,4,14,13800,13515,11725,-1790
2017,7,4,15,14560,14172,12343,-1829
2017,7,4,16,15100,14714,12932,-1782
2017,7,4,17,15510,15187,13382,-1805
2017,7,4,18,15750,15493,13932,-1561
2017,7,4,19,16100,15728,13937,-1791
2017,7,4,20,16380,16055,14308,-1747
2017,7,4,21,16720,16522,14540,-1982
2017,7,4,22,16900,16907,14575,-2332
2017,7,4,23,16710,16851,14551,-2300
2017,7,5,0,16160,16419,14250,-2169
2017,7,5,1,15720,15932,13765,-2167
2017,7,5,2,15180,15384,13143,-2241
2017,7,5,3,14060,14366,12216,-2150
2017,7,5,4,12890,13145,10903,-2242
2017,7,5,5,12000,12057,9817,-2240
2017,7,5,6,11330,11320,9337,-1983
2017,7,5,7,10890,11349,9152,-2197
2017,7,5,8,10720,11445,9297,-2148
2017,7,5,9,10730,11508,9197,-2311
2017,7,5,10,11220,11953,9507,-2446
2017,7,5,11,12300,12688,10572,-2116
2017,7,5,12,13670,13729,11868,-1861
2017,7,5,13,14540,14609,12856,-1753
2017,7,5,14,15210,15324,13675,-1649
2017,7,5,15,15840,15963,14272,-1691
2017,7,5,16,16460,16521,14685,-1836
2017,7,5,17,16770,16966,14837,-2129
2017,7,5,18,17240,17504,15735,-1769
2017,7,5,19,17600,17915,16116,-1799
2017,7,5,20,17830,18333,16155,-2178
2017,7,5,21,18200,18749,16292,-2457
2017,7,5,22,18130,19019,16411,-2608
2017,7,5,23,17830,18837,16316,-2521
2017,7,6,0,17220,18172,15763,-2409
2017,7,6,1,16850,17500,15238,-2262
2017,7,6,2,16210,16838,14473,-2365
2017,7,6,3,14770,15224,12565,-2659
2017,7,6,4,13330,13599,11054,-2545
2017,7,6,5,12080,12969,11043,-1926
2017,7,6,6,11370,12758,11209,-1549
2017,7,6,7,10970,12507,10629,-1878
2017,7,6,8,10750,12268,10247,-2021
2017,7,6,9,11030,12347,10341,-2006
2017,7,6,10,11620,12822,10880,-1942
2017,7,6,11,13040,13601,11808,-1793
2017,7,6,12,14330,14535,12968,-1567
2017,7,6,13,15070,15105,13381,-1724
2017,7,6,14,15590,15416,13519,-1897
2017,7,6,15,16120,15853,13971,-1882
2017,7,6,16,16460,16192,14370,-1822
2017,7,6,17,16790,16499,14603,-1896
2017,7,6,18,17130,16820,14833,-1987
2017,7,6,19,17380,17080,15030,-2050
2017,7,6,20,17420,17409,15494,-1915
2017,7,6,21,17260,17728,16028,-1700
2017,7,6,22,17100,17705,15717,-1988
2017,7,6,23,16980,17401,15699,-1702
2017,7,7,0,16660,16955,15435,-1520
2017,7,7,1,16410,16734,15217,-1517
2017,7,7,2,15900,16226,14596,-1630
2017,7,7,3,14570,15091,13276,-1815
2017,7,7,4,13210,13682,11430,-2252
2017,7,7,5,12280,13111,11066,-2045
2017,7,7,6,11650,12520,10753,-1767
2017,7,7,7,11290,12576,10517,-2059
2017,7,7,8,11110,12423,10381,-2042
2017,7,7,9,11210,12565,10482,-2083
2017,7,7,10,11810,13055,10849,-2206
2017,7,7,11,12980,13547,11604,-1943
2017,7,7,12,14480,14362,12435,-1927
2017,7,7,13,15210,15040,13360,-1680
2017,7,7,14,15780,15734,13991,-1743
2017,7,7,15,16120,16201,14474,-1727
2017,7,7,16,16370,16395,14837,-1558
2017,7,7,17,16390,16343,14839,-1504
2017,7,7,18,16670,16238,14748,-1490
2017,7,7,19,16870,16029,14525,-1504
2017,7,7,20,16930,15754,14251,-1503
2017,7,7,21,17070,15686,14530,-1156
2017,7,7,22,17090,15816,14954,-862
2017,7,7,23,16810,15687,14839,-848
2017,7,8,0,16350,15416,14433,-983
2017,7,8,1,16090,15256,14254,-1002
2017,7,8,2,15700,14859,13566,-1293
2017,7,8,3,14560,13821,12084,-1737
2017,7,8,4,13310,12633,10653,-1980
2017,7,8,5,11670,11806,10069,-1737
2017,7,8,6,11060,11580,10187,-1393
2017,7,8,7,10710,11238,9939,-1299
2017,7,8,8,10550,11553,10007,-1546
2017,7,8,9,10550,11553,9785,-1768
2017,7,8,10,10710,11687,9571,-2116
2017,7,8,11,11330,12184,9930,-2254
2017,7,8,12,12110,12467,10532,-1935
2017,7,8,13,13290,13136,11474,-1662
2017,7,8,14,14100,13985,12409,-1576
2017,7,8,15,14710,14742,13351,-1391
2017,7,8,16,15240,15489,14105,-1384
2017,7,8,17,15630,16087,14342,-1745
2017,7,8,18,15950,16570,15168,-1402
2017,7,8,19,16120,16939,15427,-1512
2017,7,8,20,16390,17069,15414,-1655
2017,7,8,21,16720,17385,15520,-1865
2017,7,8,22,17110,17631,15775,-1856
2017,7,8,23,17050,17373,15306,-2067
2017,7,9,0,16600,16754,14604,-2150
2017,7,9,1,16240,16351,14419,-1932
2017,7,9,2,15890,15865,13844,-2021
2017,7,9,3,14820,14771,12877,-1894
2017,7,9,4,13420,13487,11556,-1931
2017,7,9,5,12270,12427,10558,-1869
2017,7,9,6,11580,11990,10244,-1746
2017,7,9,7,11100,11953,10138,-1815
2017,7,9,8,10760,11835,9859,-1976
2017,7,9,9,10700,11649,9684,-1965
2017,7,9,10,10530,11504,9503,-2001
2017,7,9,11,10770,11781,9586,-2195
2017,7,9,12,11470,12017,9857,-2160
2017,7,9,13,12230,12475,10662,-1813
2017,7,9,14,12980,13128,11272,-1856
2017,7,9,15,13590,13378,11691,-1687
2017,7,9,16,14220,13764,11837,-1927
2017,7,9,17,14650,14116,11989,-2127
2017,7,9,18,14970,14490,12450,-2040
2017,7,9,19,15430,14843,12647,-2196
2017,7,9,20,15860,15312,13132,-2180
2017,7,9,21,16460,15931,13647,-2284
2017,7,9,22,16920,16570,14289,-2281
2017,7,9,23,16780,16778,14412,-2366
2017,7,10,0,16400,16469,14042,-2427
2017,7,10,1,16250,16126,13767,-2359
2017,7,10,2,15810,15749,13564,-2185
2017,7,10,3,14470,14462,12162,-2300
2017,7,10,4,13110,13318,11075,-2243
2017,7,10,5,11960,12280,10146,-2134
2017,7,10,6,11330,12098,10073,-2025
2017,7,10,7,10900,12007,9819,-2188
2017,7,10,8,10780,11828,9738,-2090
2017,7,10,9,10900,12005,9866,-2139
2017,7,10,10,11590,12556,10243,-2313
2017,7,10,11,13040,13154,11082,-2072
2017,7,10,12,14550,14284,12226,-2058
2017,7,10,13,15450,15251,13489,-1762
2017,7,10,14,16040,15962,14534,-1428
2017,7,10,15,16850,16596,15249,-1347
2017,7,10,16,17400,17155,15440,-1715
2017,7,10,17,17980,17659,15989,-1670
2017,7,10,18,18470,18168,16664,-1504
2017,7,10,19,18930,18546,16781,-1765
2017,7,10,20,19210,18920,16772,-2148
2017,7,10,21,19510,19267,16836,-2431
2017,7,10,22,19530,19478,17115,-2363
2017,7,10,23,19200,19257,16851,-2406
2017,7,11,0,18640,18777,16363,-2414
2017,7,11,1,18260,18486,16548,-1938
2017,7,11,2,17450,17803,15379,-2424
2017,7,11,3,16060,16261,13851,-2410
2017,7,11,4,14460,14852,12738,-2114
2017,7,11,5,13560,14124,12229,-1895
2017,7,11,6,12850,13680,11767,-1913
2017,7,11,7,12430,13504,11644,-1860
2017,7,11,8,12250,13556,11548,-2008
2017,7,11,9,12390,13685,11646,-2039
2017,7,11,10,13090,13930,12118,-1812
2017,7,11,11,14440,14667,12995,-1672
2017,7,11,12,15820,15640,13973,-1667
2017,7,11,13,16920,16468,14625,-1843
2017,7,11,14,17320,17219,15506,-1713
2017,7,11,15,17970,17679,15905,-1774
2017,7,11,16,18570,18102,16283,-1819
2017,7,11,17,18950,18391,16575,-1816
2017,7,11,18,19380,18920,17102,-1818
2017,7,11,19,19760,19336,17705,-1631
2017,7,11,20,20180,19652,17841,-1811
2017,7,11,21,20420,19924,17822,-2102
2017,7,11,22,20550,20207,17930,-2277
2017,7,11,23,20090,20172,17629,-2543
2017,7,12,0,19630,19823,17112,-2711
2017,7,12,1,19300,19429,16721,-2708
2017,7,12,2,18620,18699,16246,-2453
2017,7,12,3,17030,17016,14725,-2291
2017,7,12,4,15440,15937,13677,-2260
2017,7,12,5,14040,14880,13123,-1757
2017,7,12,6,13240,14309,12653,-1656
2017,7,12,7,12750,14068,12394,-1674
2017,7,12,8,12490,13801,12027,-1774
2017,7,12,9,12630,13905,12125,-1780
2017,7,12,10,13300,14520,12777,-1743
2017,7,12,11,14720,15713,13827,-1886
2017,7,12,12,16170,16648,14776,-1872
2017,7,12,13,17230,17379,15426,-1953
2017,7,12,14,18000,18220,16001,-2219
2017,7,12,15,18820,19103,16672,-2431
2017,7,12,16,19670,19831,17179,-2652
2017,7,12,17,20220,20459,17795,-2664
2017,7,12,18,20690,21120,18439,-2681
2017,7,12,19,21150,21278,18065,-3213
2017,7,12,20,21360,21443,18166,-3277
2017,7,12,21,21550,21501,18245,-3256
2017,7,12,22,21540,21382,18137,-3245
2017,7,12,23,21390,20815,17875,-2940
2017,7,13,0,20800,20038,17488,-2550
2017,7,13,1,20290,19445,17033,-2412
2017,7,13,2,19350,18571,16417,-2154
2017,7,13,3,17580,16970,14727,-2243
2017,7,13,4,15860,15565,13454,-2111
2017,7,13,5,14100,14429,12533,-1896
2017,7,13,6,13320,14132,12077,-2055
2017,7,13,7,12850,13926,11925,-2001
2017,7,13,8,12620,13896,12038,-1858
2017,7,13,9,12720,14017,12104,-1913
2017,7,13,10,13420,14408,12356,-2052
2017,7,13,11,14930,15249,13455,-1794
2017,7,13,12,16070,15922,14230,-1692
2017,7,13,13,16850,16664,14900,-1764
2017,7,13,14,17210,17295,15441,-1854
2017,7,13,15,17740,17959,16056,-1903
2017,7,13,16,18170,18406,16490,-1916
2017,7,13,17,18420,18577,16594,-1983
2017,7,13,18,18990,18535,16664,-1871
2017,7,13,19,19170,18175,16499,-1676
2017,7,13,20,19180,17765,16552,-1213
2017,7,13,21,19200,17269,16530,-739
2017,7,13,22,19000,16779,16019,-760
2017,7,13,23,18690,16265,15112,-1153
2017,7,14,0,18200,15805,14434,-1371
2017,7,14,1,17580,15565,13887,-1678
2017,7,14,2,16800,14866,13365,-1501
2017,7,14,3,15320,13611,12048,-1563
2017,7,14,4,13780,12457,11073,-1384
2017,7,14,5,11340,11718,10427,-1291
2017,7,14,6,10790,11550,10170,-1380
2017,7,14,7,10480,11544,10094,-1450
2017,7,14,8,10350,11410,9968,-1442
2017,7,14,9,10560,11446,10014,-1432
2017,7,14,10,11300,12119,10248,-1871
2017,7,14,11,12650,12759,10901,-1858
2017,7,14,12,13900,13435,11845,-1590
2017,7,14,13,14530,14199,12560,-1639
2017,7,14,14,14900,14619,12930,-1689
2017,7,14,15,15160,14930,13405,-1525
2017,7,14,16,15210,15101,13708,-1393
2017,7,14,17,15250,15065,13909,-1156
2017,7,14,18,15400,15018,13850,-1168
2017,7,14,19,15260,14847,13693,-1154
2017,7,14,20,15220,14570,13451,-1119
2017,7,14,21,15280,14690,13425,-1265
2017,7,14,22,15220,14718,13491,-1227
2017,7,14,23,14900,14541,13492,-1049
2017,7,15,0,14660,14345,13092,-1253
2017,7,15,1,14580,14366,13120,-1246
2017,7,15,2,14170,13964,12927,-1037
2017,7,15,3,13340,12966,11299,-1667
2017,7,15,4,12160,11919,10153,-1766
2017,7,15,5,11050,11482,9735,-1747
2017,7,15,6,10530,11052,9431,-1621
2017,7,15,7,10230,11091,9376,-1715
2017,7,15,8,10120,11126,9501,-1625
2017,7,15,9,10130,11329,9390,-1939
2017,7,15,10,10260,11538,9718,-1820
2017,7,15,11,10920,11703,9704,-1999
2017,7,15,12,11630,12073,10160,-1913
2017,7,15,13,12760,12813,11141,-1672
2017,7,15,14,13370,13257,11555,-1702
2017,7,15,15,13800,13710,12336,-1374
2017,7,15,16,14190,13929,12459,-1470
2017,7,15,17,14480,14094,12789,-1305
2017,7,15,18,14670,14279,12776,-1503
2017,7,15,19,14790,14552,13169,-1383
2017,7,15,20,14930,14949,13511,-1438
2017,7,15,21,15190,15526,13977,-1549
2017,7,15,22,15500,16017,14335,-1682
2017,7,15,23,15460,16201,14339,-1862
2017,7,16,0,15240,15932,13944,-1988
2017,7,16,1,15270,15712,13654,-2058
2017,7,16,2,15040,15419,13104,-2315
2017,7,16,3,14050,14542,12227,-2315
2017,7,16,4,12900,13437,11312,-2125
2017,7,16,5,12150,12426,10212,-2214
2017,7,16,6,11510,11731,9298,-2433
2017,7,16,7,11050,11266,9014,-2252
2017,7,16,8,10750,11188,8868,-2320
2017,7,16,9,10650,11106,8874,-2232
2017,7,16,10,10660,11032,8828,-2204
2017,7,16,11,10860,11240,9072,-2168
2017,7,16,12,11710,11608,9573,-2035
2017,7,16,13,12730,12613,10814,-1799
2017,7,16,14,13720,13561,11911,-1650
2017,7,16,15,14540,14413,12433,-1980
2017,7,16,16,15300,15196,13213,-1983
2017,7,16,17,15800,15852,13806,-2046
2017,7,16,18,16300,16365,14328,-2037
2017,7,16,19,16770,16820,14862,-1958
2017,7,16,20,17160,17339,15448,-1891
2017,7,16,21,17700,17988,15710,-2278
2017,7,16,22,18100,18583,15864,-2719
2017,7,16,23,18000,18757,15871,-2886
2017,7,17,0,17640,18428,15616,-2812
2017,7,17,1,17470,18122,15346,-2776
2017,7,17,2,16880,17555,14875,-2680
2017,7,17,3,15570,16384,13291,-3093
2017,7,17,4,14110,15082,12317,-2765
2017,7,17,5,13310,13933,11427,-2506
2017,7,17,6,12590,13407,11046,-2361
2017,7,17,7,12140,13087,10684,-2403
2017,7,17,8,11840,12915,10441,-2474
2017,7,17,9,11900,13272,10907,-2365
2017,7,17,10,12530,13692,11305,-2387
2017,7,17,11,13880,14359,12218,-2141
2017,7,17,12,15440,15594,13094,-2500
2017,7,17,13,16580,16487,14210,-2277
2017,7,17,14,17460,17421,15532,-1889
2017,7,17,15,18340,18341,16025,-2316
2017,7,17,16,18990,19078,16345,-2733
2017,7,17,17,19500,19676,16772,-2904
2017,7,17,18,20000,20259,17446,-2813
2017,7,17,19,20290,20574,17611,-2963
2017,7,17,20,20490,20715,17775,-2940
2017,7,17,21,20620,20916,18151,-2765
2017,7,17,22,20540,21080,18284,-2796
2017,7,17,23,20190,20750,17735,-3015
2017,7,18,0,19580,20029,16931,-3098
2017,7,18,1,19140,19510,16298,-3212
2017,7,18,2,18270,18601,15671,-2930
2017,7,18,3,16570,17159,14401,-2758
2017,7,18,4,14940,15703,13193,-2510
2017,7,18,5,13750,14780,12438,-2342
2017,7,18,6,13100,14367,12262,-2105
2017,7,18,7,12670,14130,12089,-2041
2017,7,18,8,12520,13911,11791,-2120
2017,7,18,9,12850,14069,11987,-2082
2017,7,18,10,13600,14714,12576,-2138
2017,7,18,11,14780,15890,13613,-2277
2017,7,18,12,16070,17006,14583,-2423
2017,7,18,13,17090,17654,15653,-2001
2017,7,18,14,17670,18365,16525,-1840
2017,7,18,15,18040,18889,16713,-2176
2017,7,18,16,18650,19570,17064,-2506
2017,7,18,17,19200,20152,17674,-2478
2017,7,18,18,19820,20591,18131,-2460
2017,7,18,19,20060,20952,18601,-2351
2017,7,18,20,20420,21422,19063,-2359
2017,7,18,21,20450,21728,19185,-2543
2017,7,18,22,20600,21734,19126,-2608
2017,7,18,23,20050,21454,18676,-2778
2017,7,19,0,19500,20816,17983,-2833
2017,7,19,1,19420,20380,17894,-2486
2017,7,19,2,18510,19558,16961,-2597
2017,7,19,3,16840,17832,14905,-2927
2017,7,19,4,15250,16357,13738,-2619
2017,7,19,5,14660,15597,12532,-3065
2017,7,19,6,13900,15022,12140,-2882
2017,7,19,7,13390,14742,11870,-2872
2017,7,19,8,13090,14457,11564,-2893
2017,7,19,9,13250,14542,11674,-2868
2017,7,19,10,13880,14831,12031,-2800
2017,7,19,11,15230,16007,13295,-2712
2017,7,19,12,16710,17272,14645,-2627
2017,7,19,13,17820,17871,15398,-2473
2017,7,19,14,18760,18822,16630,-2192
2017,7,19,15,19830,19787,17251,-2536
2017,7,19,16,20770,20657,17610,-3047
2017,7,19,17,21440,21363,18069,-3294
2017,7,19,18,22240,22088,19006,-3082
2017,7,19,19,22670,22538,19517,-3021
2017,7,19,20,22920,22807,19736,-3071
2017,7,19,21,23550,23146,20120,-3026
2017,7,19,22,23460,23358,20318,-3040
2017,7,19,23,22930,23152,19890,-3262
2017,7,20,0,22060,22449,19157,-3292
2017,7,20,1,21620,21791,18383,-3408
2017,7,20,2,20540,20776,17670,-3106
2017,7,20,3,18620,18815,15618,-3197
2017,7,20,4,16800,16853,13985,-2868
2017,7,20,5,15240,16104,13478,-2626
2017,7,20,6,14400,15673,12857,-2816
2017,7,20,7,13810,15001,12040,-2961
2017,7,20,8,13470,14593,11676,-2917
2017,7,20,9,13570,14596,11736,-2860
2017,7,20,10,14130,15111,12341,-2770
2017,7,20,11,15470,16253,13457,-2796
2017,7,20,12,17080,17332,14473,-2859
2017,7,20,13,18290,18038,15478,-2560
2017,7,20,14,19200,19032,16323,-2709
2017,7,20,15,20300,20196,17493,-2703
2017,7,20,16,21110,21138,18070,-3068
2017,7,20,17,21610,21838,18760,-3078
2017,7,20,18,22410,22555,19471,-3084
2017,7,20,19,22810,23005,20123,-2882
2017,7,20,20,23060,23233,20553,-2680
2017,7,20,21,23250,23343,20504,-2839
2017,7,20,22,23010,23266,20212,-3054
2017,7,20,23,22360,22642,19624,-3018
2017,7,21,0,21610,22042,19152,-2890
2017,7,21,1,21150,21688,18947,-2741
2017,7,21,2,20150,20733,18129,-2604
2017,7,21,3,18310,18826,15807,-3019
2017,7,21,4,16530,17318,14579,-2739
2017,7,21,5,15630,16317,13492,-2825
2017,7,21,6,14640,15776,12772,-3004
2017,7,21,7,14030,15119,12190,-2929
2017,7,21,8,13740,14695,11901,-2794
2017,7,21,9,13300,14619,11823,-2796
2017,7,21,10,13870,15024,12364,-2660
2017,7,21,11,15170,16097,13182,-2915
2017,7,21,12,17110,16978,14045,-2933
2017,7,21,13,18310,17414,14906,-2508
2017,7,21,14,19130,18311,15539,-2772
2017,7,21,15,20120,19142,16401,-2741
2017,7,21,16,20850,19823,16899,-2924
2017,7,21,17,21370,20399,17532,-2867
2017,7,21,18,22000,21107,18308,-2799
2017,7,21,19,22340,21692,18414,-3278
2017,7,21,20,22690,22267,18947,-3320
2017,7,21,21,22880,22669,19138,-3531
2017,7,21,22,22640,22729,18953,-3776
2017,7,21,23,21870,22285,18555,-3730
2017,7,22,0,20820,21485,17761,-3724
2017,7,22,1,20380,20859,17307,-3552
2017,7,22,2,19400,19961,16801,-3160
2017,7,22,3,17730,18358,15226,-3132
2017,7,22,4,16010,16907,13728,-3179
2017,7,22,5,15260,15563,13123,-2440
2017,7,22,6,14260,14798,12308,-2490
2017,7,22,7,13610,14389,12040,-2349
2017,7,22,8,13150,14200,11896,-2304
2017,7,22,9,12850,13909,11457,-2452
2017,7,22,10,12830,13586,11183,-2403
2017,7,22,11,13250,13720,11285,-2435
2017,7,22,12,14320,14344,12197,-2147
2017,7,22,13,15570,15123,13462,-1661
2017,7,22,14,16520,15925,14059,-1866
2017,7,22,15,17410,16557,14569,-1988
2017,7,22,16,17980,17189,15336,-1853
2017,7,22,17,18440,17757,15980,-1777
2017,7,22,18,18750,18201,16352,-1849
2017,7,22,19,19090,18461,16408,-2053
2017,7,22,20,19190,18698,16625,-2073
2017,7,22,21,19250,18890,16738,-2152
2017,7,22,22,19500,18864,16735,-2129
2017,7,22,23,19230,18560,16310,-2250
2017,7,23,0,18700,18201,16011,-2190
2017,7,23,1,18320,18035,15841,-2194
2017,7,23,2,17850,17466,15222,-2244
2017,7,23,3,16490,16294,13936,-2358
2017,7,23,4,15100,15004,12465,-2539
2017,7,23,5,13920,14131,11630,-2501
2017,7,23,6,13200,13623,11000,-2623
2017,7,23,7,12670,13213,10480,-2733
2017,7,23,8,12300,13081,10115,-2966
2017,7,23,9,12090,12889,10136,-2753
2017,7,23,10,11840,12751,10254,-2497
2017,7,23,11,11930,12811,10318,-2493
2017,7,23,12,12400,13312,10849,-2463
2017,7,23,13,13110,13876,11560,-2316
2017,7,23,14,13850,14123,12321,-1802
2017,7,23,15,14320,14326,12668,-1658
2017,7,23,16,14700,14714,13167,-1547
2017,7,23,17,15200,15057,13433,-1624
2017,7,23,18,15500,15254,13700,-1554
2017,7,23,19,15700,15348,13744,-1604
2017,7,23,20,15920,15576,13930,-1646
2017,7,23,21,16250,15940,14070,-1870
2017,7,23,22,16380,16220,14252,-1968
2017,7,23,23,16520,16151,13806,-2345
2017,7,24,0,16060,15829,13555,-2274
2017,7,24,1,16020,15797,13709,-2088
2017,7,24,2,15460,15243,13273,-1970
2017,7,24,3,14260,14233,12355,-1878
2017,7,24,4,12970,13097,10775,-2322
2017,7,24,5,11900,12193,9758,-2435
2017,7,24,6,11360,11894,9516,-2378
2017,7,24,7,11050,11847,9374,-2473
2017,7,24,8,10970,11750,9151,-2599
2017,7,24,9,11210,11944,9360,-2584
2017,7,24,10,11900,12444,10073,-2371
2017,7,24,11,13240,13132,10892,-2240
2017,7,24,12,14560,14219,12289,-1930
2017,7,24,13,15200,14815,12963,-1852
2017,7,24,14,15590,15173,13390,-1783
2017,7,24,15,15830,15434,13686,-1748
2017,7,24,16,15990,15453,13397,-2056
2017,7,24,17,16000,15354,13406,-1948
2017,7,24,18,15900,15272,13302,-1970
2017,7,24,19,15910,15053,12917,-2136
2017,7,24,20,15880,14817,12692,-2125
2017,7,24,21,15930,14793,12942,-1851
2017,7,24,22,16150,14908,13039,-1869
2017,7,24,23,15700,14800,12881,-1919
2017,7,25,0,15600,14577,12535,-2042
2017,7,25,1,15240,14383,12247,-2136
2017,7,25,2,14550,13653,11523,-2130
2017,7,25,3,13290,12738,10617,-2121
2017,7,25,4,12090,11590,9703,-1887
2017,7,25,5,10580,11091,9254,-1837
2017,7,25,6,10120,11250,8831,-2419
2017,7,25,7,9870,11178,9015,-2163
2017,7,25,8,9830,11102,9089,-2013
2017,7,25,9,10050,11322,9157,-2165
2017,7,25,10,10700,11877,9297,-2580
2017,7,25,11,12020,12214,9798,-2416
2017,7,25,12,13250,13154,10835,-2319
2017,7,25,13,13770,13797,11725,-2072
2017,7,25,14,14150,14225,12399,-1826
2017,7,25,15,14520,14518,12663,-1855
2017,7,25,16,14720,14687,12866,-1821
2017,7,25,17,14820,14625,12603,-2022
2017,7,25,18,14840,14626,12518,-2108
2017,7,25,19,14860,14542,12518,-2024
2017,7,25,20,14900,14464,12641,-1823
2017,7,25,21,15200,14505,12836,-1669
2017,7,25,22,15500,14620,12955,-1665
2017,7,25,23,15330,14613,12875,-1738
2017,7,26,0,15200,14471,12629,-1842
2017,7,26,1,14990,14455,12553,-1902
2017,7,26,2,14350,13921,12062,-1859
2017,7,26,3,13010,12715,10597,-2118
2017,7,26,4,11740,11631,9571,-2060
2017,7,26,5,10610,11079,9050,-2029
2017,7,26,6,10090,10370,8584,-1786
2017,7,26,7,9810,10076,8693,-1383
2017,7,26,8,9690,10213,8551,-1662
2017,7,26,9,9920,10262,8522,-1740
2017,7,26,10,10550,10623,8748,-1875
2017,7,26,11,11850,11744,9435,-2309
2017,7,26,12,13130,12955,10715,-2240
2017,7,26,13,13760,13583,11587,-1996
2017,7,26,14,14010,13952,12241,-1711
2017,7,26,15,14490,14345,12683,-1662
2017,7,26,16,14720,14704,12957,-1747
2017,7,26,17,14970,15011,13399,-1612
2017,7,26,18,15410,15373,13490,-1883
2017,7,26,19,15680,15600,13808,-1792
2017,7,26,20,15930,15899,14457,-1442
2017,7,26,21,16220,16395,14723,-1672
2017,7,26,22,16500,16746,15043,-1703
2017,7,26,23,16360,16645,14737,-1908
2017,7,27,0,15920,16229,14227,-2002
2017,7,27,1,15770,16098,13845,-2253
2017,7,27,2,15210,15447,13163,-2284
2017,7,27,3,13880,14042,11624,-2418
2017,7,27,4,12480,12677,10073,-2604
2017,7,27,5,11620,11901,9027,-2874
2017,7,27,6,11000,11706,9151,-2555
2017,7,27,7,10640,11473,9063,-2410
2017,7,27,8,10490,11541,9049,-2492
2017,7,27,9,10690,11723,9001,-2722
2017,7,27,10,11400,12193,9690,-2503
2017,7,27,11,12530,12631,10210,-2421
2017,7,27,12,13750,13734,11126,-2608
2017,7,27,13,14460,14450,11983,-2467
2017,7,27,14,14880,14879,12780,-2099
2017,7,27,15,15480,15213,13254,-1959
2017,7,27,16,15880,15672,13842,-1830
2017,7,27,17,16160,15965,14288,-1677
2017,7,27,18,16570,16142,14464,-1678
2017,7,27,19,16800,16134,14285,-1849
2017,7,27,20,16920,16029,14242,-1787
2017,7,27,21,17250,16016,14338,-1678
2017,7,27,22,17500,16060,14303,-1757
2017,7,27,23,17300,15979,14358,-1621
2017,7,28,0,16920,15840,14432,-1408
2017,7,28,1,16880,15920,14522,-1398
2017,7,28,2,16310,15432,14052,-1380
2017,7,28,3,14890,14219,12578,-1641
2017,7,28,4,13470,13179,11649,-1530
2017,7,28,5,12030,12315,10958,-1357
2017,7,28,6,11480,12166,10718,-1448
2017,7,28,7,11140,12063,10455,-1608
2017,7,28,8,10950,12015,10208,-1807
2017,7,28,9,11130,12166,10496,-1670
2017,7,28,10,11790,12521,10941,-1580
2017,7,28,11,12940,13020,11386,-1634
2017,7,28,12,14300,14258,12230,-2028
2017,7,28,13,15160,15195,13381,-1814
2017,7,28,14,15600,15829,13890,-1939
2017,7,28,15,16150,16473,14548,-1925
2017,7,28,16,16650,17004,14891,-2113
2017,7,28,17,17060,17404,15385,-2019
2017,7,28,18,17650,17795,15832,-1963
2017,7,28,19,17950,18059,15835,-2224
2017,7,28,20,18200,18307,15950,-2357
2017,7,28,21,18230,18607,16263,-2344
2017,7,28,22,18350,18661,15963,-2698
2017,7,28,23,17800,18192,15288,-2904
2017,7,29,0,17300,17676,14920,-2756
2017,7,29,1,17050,17463,14891,-2572
2017,7,29,2,16400,16743,14234,-2509
2017,7,29,3,15200,15429,13001,-2428
2017,7,29,4,13840,13910,11789,-2121
2017,7,29,5,12720,12743,10674,-2069
2017,7,29,6,11840,11899,10518,-1381
2017,7,29,7,11370,11399,10351,-1048
2017,7,29,8,11090,11281,10241,-1040
2017,7,29,9,10890,11148,10199,-949
2017,7,29,10,10920,11174,10154,-1020
2017,7,29,11,11230,11574,10293,-1281
2017,7,29,12,12030,11947,10324,-1623
2017,7,29,13,12870,12618,11139,-1479
2017,7,29,14,13520,13083,11420,-1663
2017,7,29,15,13830,13283,11735,-1548
2017,7,29,16,13940,13377,11666,-1711
2017,7,29,17,13990,13559,11752,-1807
2017,7,29,18,13920,13632,11917,-1715
2017,7,29,19,13900,13159,11618,-1541
2017,7,29,20,14020,12995,11700,-1295
2017,7,29,21,14020,13174,12109,-1065
2017,7,29,22,14210,13667,12385,-1282
2017,7,29,23,14180,13889,12558,-1331
2017,7,30,0,13980,13756,12158,-1598
2017,7,30,1,13980,13740,12040,-1700
2017,7,30,2,13680,13357,11804,-1553
2017,7,30,3,12880,12432,10915,-1517
2017,7,30,4,11890,11419,9641,-1778
2017,7,30,5,11180,11065,8841,-2224
2017,7,30,6,10570,10835,8713,-2122
2017,7,30,7,10140,10751,8726,-2025
2017,7,30,8,9980,10812,8668,-2144
2017,7,30,9,9500,10782,8497,-2285
2017,7,30,10,9650,10824,8404,-2420
2017,7,30,11,9900,11034,8526,-2508
2017,7,30,12,10650,11596,9096,-2500
2017,7,30,13,11380,11883,9664,-2219
2017,7,30,14,12030,12268,10042,-2226
2017,7,30,15,12480,12026,10012,-2014
2017,7,30,16,12710,12290,10341,-1949
2017,7,30,17,13080,12607,10773,-1834
2017,7,30,18,13380,12882,10984,-1898
2017,7,30,19,13740,13391,11511,-1880
2017,7,30,20,14170,13813,12107,-1706
2017,7,30,21,14600,14429,12804,-1625
2017,7,30,22,15300,15137,13301,-1836
2017,7,30,23,15140,15400,13251,-2149
2017,7,31,0,14910,15189,12984,-2205
2017,7,31,1,14870,15120,13140,-1980
2017,7,31,2,14510,14526,12393,-2133
2017,7,31,3,13300,13309,10989,-2320
2017,7,31,4,12190,12282,9845,-2437
2017,7,31,5,11320,11799,9289,-2510
2017,7,31,6,10790,11605,8995,-2610
2017,7,31,7,10440,11462,8698,-2764
2017,7,31,8,10340,11391,8570,-2821
2017,7,31,9,10410,11338,8711,-2627
2017,7,31,10,11180,11562,8940,-2622
2017,7,31,11,12540,12588,10087,-2501
2017,7,31,12,13990,13503,11239,-2264
2017,7,31,13,14830,14176,12237,-1939
2017,7,31,14,15610,14794,13732,-1062
2017,7,31,15,16330,15438,14078,-1360
2017,7,31,16,16970,16011,14552,-1459
2017,7,31,17,17510,16549,15083,-1466
2017,7,31,18,18090,17220,15797,-1423
2017,7,31,19,18570,17813,15961,-1852
2017,7,31,20,18940,18449,16747,-1702
2017,7,31,21,19300,19064,17168,-1896
2017,7,31,22,19550,19530,17582,-1948
2017,7,31,23,19270,19422,17489,-1933
2017,8,1,0,18740,18856,16837,-2019
2017,8,1,1,18500,18508,15953,-2555
2017,8,1,2,17660,17530,15109,-2421
2017,8,1,3,16000,15852,13107,-2745
2017,8,1,4,14430,14509,11979,-2530
2017,8,1,5,12650,13754,11183,-2571
2017,8,1,6,12000,13302,10849,-2453
2017,8,1,7,11600,12947,10465,-2482
2017,8,1,8,11390,12878,10347,-2531
2017,8,1,9,11580,12735,10309,-2426
2017,8,1,10,12250,13362,10913,-2449
2017,8,1,11,13600,14394,11690,-2704
2017,8,1,12,14900,15814,12906,-2908
2017,8,1,13,15730,16169,13971,-2198
2017,8,1,14,16510,16900,14965,-1935
2017,8,1,15,17390,17616,15797,-1819
2017,8,1,16,18240,18321,16105,-2216
2017,8,1,17,18860,19036,16537,-2499
2017,8,1,18,19690,19737,17109,-2628
2017,8,1,19,20200,20277,17495,-2782
2017,8,1,20,20590,20714,18195,-2519
2017,8,1,21,21040,21179,18646,-2533
2017,8,1,22,20910,21450,19050,-2400
2017,8,1,23,20460,21176,18340,-2836
2017,8,2,0,19640,20568,17556,-3012
2017,8,2,1,19550,20137,17120,-3017
2017,8,2,2,18360,19064,16343,-2721
2017,8,2,3,16640,17248,14177,-3071
2017,8,2,4,15040,15790,13104,-2686
2017,8,2,5,13770,15035,12779,-2256
2017,8,2,6,13000,14406,12909,-1497
2017,8,2,7,12510,14076,12607,-1469
2017,8,2,8,12260,13746,12242,-1504
2017,8,2,9,12320,13785,12299,-1486
2017,8,2,10,13060,14366,13054,-1312
2017,8,2,11,14270,15091,13488,-1603
2017,8,2,12,15540,16256,14456,-1800
2017,8,2,13,16560,16713,15349,-1364
2017,8,2,14,17270,17477,16363,-1114
2017,8,2,15,18090,18493,17301,-1192
2017,8,2,16,18670,19232,17717,-1515
2017,8,2,17,19470,19839,18261,-1578
2017,8,2,18,20000,20649,19020,-1629
2017,8,2,19,20430,20858,18912,-1946
2017,8,2,20,20600,20532,18347,-2185
2017,8,2,21,20480,20290,18238,-2052
2017,8,2,22,20400,19786,17575,-2211
2017,8,2,23,20130,19073,16571,-2502
2017,8,3,0,19590,18403,15824,-2579
2017,8,3,1,19390,18047,15683,-2364
2017,8,3,2,18360,17138,14802,-2336
2017,8,3,3,16690,15745,13479,-2266
2017,8,3,4,15160,14728,12307,-2421
2017,8,3,5,13100,13900,11368,-2532
2017,8,3,6,12460,13487,10915,-2572
2017,8,3,7,12040,13364,10874,-2490
2017,8,3,8,11860,13144,10747,-2397
2017,8,3,9,11980,13266,10753,-2513
2017,8,3,10,12640,13466,11206,-2260
2017,8,3,11,13790,14127,11704,-2423
2017,8,3,12,15000,15186,12599,-2587
2017,8,3,13,15910,16031,13646,-2385
2017,8,3,14,16670,16640,14529,-2111
2017,8,3,15,17440,17232,15329,-1903
2017,8,3,16,18070,17898,15897,-2001
2017,8,3,17,18700,18553,16343,-2210
2017,8,3,18,19510,19308,16827,-2481
2017,8,3,19,20040,19944,17411,-2533
2017,8,3,20,20370,20431,17866,-2565
2017,8,3,21,20570,20819,17782,-3037
2017,8,3,22,20440,20979,17776,-3203
2017,8,3,23,20030,20646,17289,-3357
2017,8,4,0,19340,19903,16353,-3550
2017,8,4,1,19020,19494,16174,-3320
2017,8,4,2,18100,18455,15512,-2943
2017,8,4,3,16430,16785,14063,-2722
2017,8,4,4,14790,15141,12296,-2845
2017,8,4,5,13800,14136,11242,-2894
2017,8,4,6,13070,13600,10915,-2685
2017,8,4,7,12650,13424,11032,-2392
2017,8,4,8,12370,13441,10939,-2502
2017,8,4,9,12510,13526,10767,-2759
2017,8,4,10,13180,13839,11032,-2807
2017,8,4,11,14170,14461,11799,-2662
2017,8,4,12,15550,15654,13146,-2508
2017,8,4,13,16500,16601,14004,-2597
2017,8,4,14,17190,17298,14683,-2615
2017,8,4,15,17780,17936,15109,-2827
2017,8,4,16,18360,18599,15803,-2796
2017,8,4,17,18690,19208,16230,-2978
2017,8,4,18,19130,19901,16869,-3032
2017,8,4,19,19560,20236,17148,-3088
2017,8,4,20,19660,20425,17807,-2618
2017,8,4,21,19700,20483,18068,-2415
2017,8,4,22,19500,20314,17517,-2797
2017,8,4,23,18860,19709,16638,-3071
2017,8,5,0,18160,18916,16100,-2816
2017,8,5,1,18030,18557,15741,-2816
2017,8,5,2,17190,17786,15024,-2762
2017,8,5,3,15890,16549,13852,-2697
2017,8,5,4,14490,15281,13139,-2142
2017,8,5,5,13860,14156,12230,-1926
2017,8,5,6,13130,13411,11817,-1594
2017,8,5,7,12660,13108,11618,-1490
2017,8,5,8,12470,13294,11624,-1670
2017,8,5,9,12390,13200,11687,-1513
2017,8,5,10,12550,13076,11807,-1269
2017,8,5,11,12890,13228,11862,-1366
2017,8,5,12,13650,13961,12599,-1362
2017,8,5,13,14790,14995,13495,-1500
2017,8,5,14,15540,15583,13822,-1761
2017,8,5,15,16010,16137,14219,-1918
2017,8,5,16,16300,16317,14035,-2282
2017,8,5,17,16450,16259,14061,-2198
2017,8,5,18,16490,16284,14318,-1966
2017,8,5,19,16510,16306,14693,-1613
2017,8,5,20,16610,16101,14651,-1450
2017,8,5,21,16760,16319,14793,-1526
2017,8,5,22,16980,16671,14831,-1840
2017,8,5,23,16720,16669,14637,-2032
2017,8,6,0,16150,16352,14226,-2126
2017,8,6,1,16010,16212,13991,-2221
2017,8,6,2,15430,15594,13372,-2222
2017,8,6,3,14280,14440,12544,-1896
2017,8,6,4,13060,13111,11136,-1975
2017,8,6,5,11970,12281,10467,-1814
2017,8,6,6,11210,11935,10243,-1692
2017,8,6,7,10710,11719,9896,-1823
2017,8,6,8,10390,11735,9706,-2029
2017,8,6,9,10250,11575,9508,-2067
2017,8,6,10,10210,11527,9695,-1832
2017,8,6,11,10320,11623,9616,-2007
2017,8,6,12,10850,12141,10600,-1541
2017,8,6,13,11520,12384,11244,-1140
2017,8,6,14,11960,12391,11269,-1122
2017,8,6,15,12200,12485,11259,-1226
2017,8,6,16,12430,12477,11122,-1355
2017,8,6,17,12640,12640,11358,-1282
2017,8,6,18,12910,12914,11575,-1339
2017,8,6,19,13210,13202,11939,-1263
2017,8,6,20,13590,13584,12061,-1523
2017,8,6,21,14130,14040,12353,-1687
2017,8,6,22,14600,14550,12976,-1574
2017,8,6,23,14700,14756,13420,-1336
2017,8,7,0,14570,14665,13300,-1365
2017,8,7,1,14600,14865,13434,-1431
2017,8,7,2,14040,14257,12879,-1378
2017,8,7,3,12930,13212,11779,-1433
2017,8,7,4,11700,12263,10655,-1608
2017,8,7,5,11240,11404,9590,-1814
2017,8,7,6,10710,11013,9273,-1740
2017,8,7,7,10370,10918,9302,-1616
2017,8,7,8,10280,10986,9260,-1726
2017,8,7,9,10500,11208,9246,-1962
2017,8,7,10,11250,11893,10067,-1826
2017,8,7,11,12420,12529,10654,-1875
2017,8,7,12,13640,13457,11671,-1786
2017,8,7,13,14410,14489,12957,-1532
2017,8,7,14,14900,14975,13718,-1257
2017,8,7,15,15300,15474,14051,-1423
2017,8,7,16,15540,15778,13951,-1827
2017,8,7,17,15790,15944,13954,-1990
2017,8,7,18,15930,16132,14042,-2090
2017,8,7,19,16020,16086,14186,-1900
2017,8,7,20,16060,15967,14275,-1692
2017,8,7,21,16200,16013,14564,-1449
2017,8,7,22,16400,16082,14370,-1712
2017,8,7,23,15990,15915,14020,-1895
2017,8,8,0,15950,15722,13642,-2080
2017,8,8,1,15830,15612,13840,-1772
2017,8,8,2,14920,14750,13003,-1747
2017,8,8,3,13600,13508,11755,-1753
2017,8,8,4,12360,12324,10338,-1986
2017,8,8,5,11610,11744,10127,-1617
2017,8,8,6,11100,11233,9693,-1540
2017,8,8,7,10820,10926,9530,-1396
2017,8,8,8,10720,10820,9377,-1443
2017,8,8,9,10930,11027,9815,-1212
2017,8,8,10,11780,11807,10298,-1509
2017,8,8,11,13020,12786,11012,-1774
2017,8,8,12,14120,13987,12301,-1686
2017,8,8,13,14730,14706,13087,-1619
2017,8,8,14,15130,15060,13571,-1489
2017,8,8,15,15450,15368,14008,-1360
2017,8,8,16,15710,15459,14083,-1376
2017,8,8,17,15960,15444,13814,-1630
2017,8,8,18,16170,15606,13981,-1625
2017,8,8,19,16330,15823,14273,-1550
2017,8,8,20,16460,15897,14422,-1475
2017,8,8,21,16690,16099,14554,-1545
2017,8,8,22,16800,16392,14919,-1473
2017,8,8,23,16570,16424,15141,-1283
2017,8,9,0,16330,16169,14491,-1678
2017,8,9,1,16250,16143,14621,-1522
2017,8,9,2,15380,15335,13599,-1736
2017,8,9,3,14000,13973,12045,-1928
2017,8,9,4,12670,12580,10550,-2030
2017,8,9,5,11530,11773,9337,-2436
2017,8,9,6,10930,11807,9150,-2657
2017,8,9,7,10530,11922,9259,-2663
2017,8,9,8,10340,11754,9142,-2612
2017,8,9,9,10470,11879,9421,-2458
2017,8,9,10,11180,12269,9757,-2512
2017,8,9,11,12320,13061,10350,-2711
2017,8,9,12,13570,13608,10944,-2664
2017,8,9,13,14370,14187,11982,-2205
2017,8,9,14,14970,14672,12841,-1831
2017,8,9,15,15590,15103,13330,-1773
2017,8,9,16,16140,15541,13847,-1694
2017,8,9,17,16580,15963,14340,-1623
2017,8,9,18,17110,16583,15026,-1557
2017,8,9,19,17570,17150,15656,-1494
2017,8,9,20,17980,17673,16248,-1425
2017,8,9,21,18460,18185,16542,-1643
2017,8,9,22,18600,18522,16476,-2046
2017,8,9,23,18240,18394,16000,-2394
2017,8,10,0,17640,17864,15461,-2403
2017,8,10,1,17350,17641,15513,-2128
2017,8,10,2,16500,16685,14518,-2167
2017,8,10,3,14940,15143,12918,-2225
2017,8,10,4,13410,13903,12015,-1888
2017,8,10,5,12350,13065,11269,-1796
2017,8,10,6,11720,12548,10570,-1978
2017,8,10,7,11300,12572,10245,-2327
2017,8,10,8,11100,12386,10462,-1924
2017,8,10,9,11260,12470,10249,-2221
2017,8,10,10,11940,12683,10465,-2218
2017,8,10,11,13090,13467,11321,-2146
2017,8,10,12,14340,14452,12209,-2243
2017,8,10,13,15250,15327,13227,-2100
2017,8,10,14,15940,15748,14028,-1720
2017,8,10,15,16680,16475,14770,-1705
2017,8,10,16,17240,17228,15636,-1592
2017,8,10,17,17750,17904,16171,-1733
2017,8,10,18,18240,18543,16729,-1814
2017,8,10,19,18700,19001,16982,-2019
2017,8,10,20,18990,19366,17045,-2321
2017,8,10,21,19230,19703,17084,-2619
2017,8,10,22,19300,19815,17009,-2806
2017,8,10,23,18810,19364,16465,-2899
2017,8,11,0,18270,18713,16068,-2645
2017,8,11,1,18090,18437,16012,-2425
2017,8,11,2,17150,17376,15086,-2290
2017,8,11,3,15570,15824,13547,-2277
2017,8,11,4,14030,14474,12391,-2083
2017,8,11,5,13010,13473,11606,-1867
2017,8,11,6,12250,13040,11167,-1873
2017,8,11,7,11750,12802,11020,-1782
2017,8,11,8,11490,12719,10840,-1879
2017,8,11,9,11580,12856,10952,-1904
2017,8,11,10,12180,12994,11376,-1618
2017,8,11,11,13180,13695,12061,-1634
2017,8,11,12,14410,14924,13215,-1709
2017,8,11,13,15280,15310,14055,-1255
2017,8,11,14,15840,15881,14407,-1474
2017,8,11,15,16430,16432,14680,-1752
2017,8,11,16,16910,16938,15118,-1820
2017,8,11,17,17360,17288,15426,-1862
2017,8,11,18,17780,17697,15851,-1846
2017,8,11,19,18050,18081,16272,-1809
2017,8,11,20,18110,18290,16361,-1929
2017,8,11,21,18220,18356,16305,-2051
2017,8,11,22,18020,18282,16157,-2125
2017,8,11,23,17560,17820,15568,-2252
2017,8,12,0,16960,17314,15119,-2195
2017,8,12,1,16760,17168,15104,-2064
2017,8,12,2,15990,16318,14411,-1907
2017,8,12,3,14790,15087,13304,-1783
2017,8,12,4,13530,13762,11753,-2009
2017,8,12,5,12560,12980,11019,-1961
2017,8,12,6,11910,12284,10499,-1785
2017,8,12,7,11470,12117,10216,-1901
2017,8,12,8,11280,12347,10266,-2081
2017,8,12,9,11210,12227,10241,-1986
2017,8,12,10,11490,12367,10235,-2132
2017,8,12,11,11750,12454,10330,-2124
2017,8,12,12,12510,12816,10605,-2211
2017,8,12,13,13540,13448,11536,-1912
2017,8,12,14,14260,13864,12049,-1815
2017,8,12,15,14790,14521,12426,-2095
2017,8,12,16,15070,14715,12718,-1997
2017,8,12,17,15300,14867,12843,-2024
2017,8,12,18,15420,14937,12757,-2180
2017,8,12,19,15390,14915,12825,-2090
2017,8,12,20,15470,15075,12933,-2142
2017,8,12,21,15710,15476,13454,-2022
2017,8,12,22,15880,15918,13628,-2290
2017,8,12,23,15900,16000,13309,-2691
2017,8,13,0,15800,15830,13270,-2560
2017,8,13,1,15870,15936,13444,-2492
2017,8,13,2,15380,15381,13024,-2357
2017,8,13,3,14460,14471,11991,-2480
2017,8,13,4,13410,13690,11418,-2272
2017,8,13,5,12810,12868,10597,-2271
2017,8,13,6,12090,12556,9944,-2612
2017,8,13,7,11700,12657,10046,-2611
2017,8,13,8,11390,12764,10280,-2484
2017,8,13,9,11260,12674,10208,-2466
2017,8,13,10,11280,12582,10111,-2471
2017,8,13,11,11160,12510,10051,-2459
2017,8,13,12,11930,12787,10389,-2398
2017,8,13,13,12480,13640,11319,-2321
2017,8,13,14,13350,14276,12166,-2110
2017,8,13,15,13960,14906,12641,-2265
2017,8,13,16,14670,15460,13313,-2147
2017,8,13,17,15140,15895,13825,-2070
2017,8,13,18,15660,16141,13922,-2219
2017,8,13,19,16250,16380,14281,-2099
2017,8,13,20,16560,16814,14692,-2122
2017,8,13,21,17140,17353,14986,-2367
2017,8,13,22,17530,17872,15368,-2504
2017,8,13,23,17280,17883,15082,-2801
2017,8,14,0,16940,17408,14603,-2805
2017,8,14,1,16860,17221,14228,-2993
2017,8,14,2,15950,16215,13495,-2720
2017,8,14,3,14670,14805,12165,-2640
2017,8,14,4,13300,13425,10972,-2453
2017,8,14,5,12320,12740,10560,-2180
2017,8,14,6,11650,12192,10206,-1986
2017,8,14,7,11280,12000,9875,-2125
2017,8,14,8,11090,11924,9754,-2170
2017,8,14,9,11240,12171,9831,-2340
2017,8,14,10,11940,12371,10132,-2239
2017,8,14,11,13190,12823,10690,-2133
2017,8,14,12,14480,13982,12154,-1828
2017,8,14,13,15310,14838,12989,-1849
2017,8,14,14,15910,15438,13783,-1655
2017,8,14,15,16610,15980,14279,-1701
2017,8,14,16,17070,16582,14866,-1716
2017,8,14,17,17470,16989,15115,-1874
2017,8,14,18,17940,17650,15686,-1964
2017,8,14,19,18390,17951,15832,-2119
2017,8,14,20,18710,18117,16183,-1934
2017,8,14,21,19000,18146,16053,-2093
2017,8,14,22,19140,18220,16229,-1991
2017,8,14,23,18640,18005,16002,-2003
2017,8,15,0,18220,17731,15799,-1932
2017,8,15,1,18000,17679,15522,-2157
2017,8,15,2,17000,16662,14416,-2246
2017,8,15,3,15520,15178,12941,-2237
2017,8,15,4,14050,13900,11871,-2029
2017,8,15,5,12700,13223,11199,-2024
2017,8,15,6,12070,13290,11031,-2259
2017,8,15,7,11690,13002,10812,-2190
2017,8,15,8,11520,12852,10740,-2112
2017,8,15,9,11820,13057,10869,-2188
2017,8,15,10,12600,13577,11107,-2470
2017,8,15,11,13800,14400,12326,-2074
2017,8,15,12,15020,15079,13027,-2052
2017,8,15,13,15760,15807,13879,-1928
2017,8,15,14,16140,16285,14461,-1824
2017,8,15,15,16660,16764,15247,-1517
2017,8,15,16,17000,17231,15677,-1554
2017,8,15,17,17500,17608,16199,-1409
2017,8,15,18,17930,17911,16428,-1483
2017,8,15,19,18230,17973,16549,-1424
2017,8,15,20,18320,17798,16441,-1357
2017,8,15,21,18520,17698,16442,-1256
2017,8,15,22,18800,17663,16240,-1423
2017,8,15,23,18540,17469,15652,-1817
2017,8,16,0,18210,17277,15635,-1642
2017,8,16,1,17930,17247,15574,-1673
2017,8,16,2,16950,16376,14570,-1806
2017,8,16,3,15470,15016,13164,-1852
2017,8,16,4,14020,13928,11954,-1974
2017,8,16,5,12670,13446,11106,-2340
2017,8,16,6,12070,13125,10819,-2306
2017,8,16,7,11740,13029,10882,-2147
2017,8,16,8,11570,12873,10659,-2214
2017,8,16,9,11900,13036,10781,-2255
2017,8,16,10,12630,13645,11532,-2113
2017,8,16,11,13770,14388,12177,-2211
2017,8,16,12,14970,15243,13128,-2115
2017,8,16,13,15590,15794,13911,-1883
2017,8,16,14,16020,16343,14621,-1722
2017,8,16,15,16890,16862,14828,-2034
2017,8,16,16,17420,17353,15656,-1697
2017,8,16,17,18040,17760,16001,-1759
2017,8,16,18,18610,18325,16593,-1732
2017,8,16,19,19140,18622,16849,-1773
2017,8,16,20,19410,18895,17278,-1617
2017,8,16,21,19580,19237,17733,-1504
2017,8,16,22,19600,19397,17895,-1502
2017,8,16,23,19010,19018,17321,-1697
2017,8,17,0,18460,18377,16529,-1848
2017,8,17,1,18200,18082,16346,-1736
2017,8,17,2,16980,16936,15338,-1598
2017,8,17,3,15300,15294,13373,-1921
2017,8,17,4,13700,13720,11800,-1920
2017,8,17,5,12370,12786,10730,-2056
2017,8,17,6,11660,12336,10196,-2140
2017,8,17,7,11210,12308,9942,-2366
2017,8,17,8,10970,12085,9973,-2112
2017,8,17,9,11070,12155,9984,-2171
2017,8,17,10,11690,12571,10258,-2313
2017,8,17,11,12870,13285,10786,-2499
2017,8,17,12,13890,14002,11507,-2495
2017,8,17,13,14560,14401,12344,-2057
2017,8,17,14,14860,14828,12747,-2081
2017,8,17,15,15320,15236,13523,-1713
2017,8,17,16,15570,15560,13987,-1573
2017,8,17,17,16060,15889,14424,-1465
2017,8,17,18,16550,16406,14610,-1796
2017,8,17,19,16820,16942,15446,-1496
2017,8,17,20,17210,17436,16106,-1330
2017,8,17,21,17570,17886,16703,-1183
2017,8,17,22,17680,18097,16926,-1171
2017,8,17,23,17380,17758,16172,-1586
2017,8,18,0,17020,17278,15599,-1679
2017,8,18,1,16930,17178,15515,-1663
2017,8,18,2,15990,16182,14296,-1886
2017,8,18,3,14550,14744,12515,-2229
2017,8,18,4,13150,13350,10888,-2462
2017,8,18,5,12560,12366,10102,-2264
2017,8,18,6,12020,11951,10027,-1924
2017,8,18,7,11640,11905,9941,-1964
2017,8,18,8,11510,11804,9895,-1909
2017,8,18,9,11790,11795,9934,-1861
2017,8,18,10,12620,12534,10474,-2060
2017,8,18,11,13850,13802,11924,-1878
2017,8,18,12,15070,15012,13150,-1862
2017,8,18,13,16040,15861,13679,-2182
2017,8,18,14,16730,16559,13861,-2698
2017,8,18,15,17080,17168,14677,-2491
2017,8,18,16,17490,17515,15349,-2166
2017,8,18,17,17530,17731,15477,-2254
2017,8,18,18,17730,17988,15466,-2522
2017,8,18,19,17900,18068,15511,-2557
2017,8,18,20,18000,18042,15852,-2190
2017,8,18,21,18100,18096,15769,-2327
2017,8,18,22,17940,18153,15771,-2382
2017,8,18,23,17670,18058,15537,-2521
2017,8,19,0,17680,17965,15490,-2475
2017,8,19,1,17630,17795,15394,-2401
2017,8,19,2,16800,17062,14447,-2615
2017,8,19,3,15680,15967,13346,-2621
2017,8,19,4,14500,14794,12146,-2648
2017,8,19,5,13560,14425,11196,-3229
2017,8,19,6,12920,14084,10926,-3158
2017,8,19,7,12490,13721,10783,-2938
2017,8,19,8,12210,13621,10740,-2881
2017,8,19,9,12100,13509,10707,-2802
2017,8,19,10,12360,13647,10805,-2842
2017,8,19,11,12760,13995,11435,-2560
2017,8,19,12,13680,14526,11969,-2557
2017,8,19,13,14780,15390,12950,-2440
2017,8,19,14,15750,16143,13825,-2318
2017,8,19,15,16630,16077,13871,-2206
2017,8,19,16,17290,16579,14434,-2145
2017,8,19,17,17790,17102,14859,-2243
2017,8,19,18,18300,17607,15380,-2227
2017,8,19,19,18610,17880,15400,-2480
2017,8,19,20,18950,18146,15600,-2546
2017,8,19,21,19190,18481,15547,-2934
2017,8,19,22,19250,18694,15349,-3345
2017,8,19,23,18820,18502,14937,-3565
2017,8,20,0,18380,17996,14698,-3298
2017,8,20,1,18250,17756,14733,-3023
2017,8,20,2,17320,16858,13896,-2962
2017,8,20,3,15970,15648,12435,-3213
2017,8,20,4,14590,14595,11484,-3111
2017,8,20,5,13250,13532,10599,-2933
2017,8,20,6,12530,12802,10102,-2700
2017,8,20,7,12030,12547,10077,-2470
2017,8,20,8,11670,12218,9739,-2479
2017,8,20,9,11510,12053,9355,-2698
2017,8,20,10,11540,12072,9396,-2676
2017,8,20,11,11680,12187,9683,-2504
2017,8,20,12,12370,13116,10626,-2490
2017,8,20,13,13250,13636,11432,-2204
2017,8,20,14,14010,13996,11996,-2000
2017,8,20,15,14630,14625,12570,-2055
2017,8,20,16,15180,15177,12630,-2547
2017,8,20,17,15630,15635,13202,-2433
2017,8,20,18,16140,15932,13119,-2813
2017,8,20,19,16570,16193,13448,-2745
2017,8,20,20,16880,16554,14023,-2531
2017,8,20,21,17340,17061,14646,-2415
2017,8,20,22,17640,17498,15095,-2403
2017,8,20,23,17580,17467,15005,-2462
2017,8,21,0,17290,17077,14566,-2511
2017,8,21,1,17070,16975,14341,-2634
2017,8,21,2,16110,15936,13527,-2409
2017,8,21,3,14830,14567,11842,-2725
2017,8,21,4,13430,13231,10366,-2865
2017,8,21,5,12190,12217,10155,-2062
2017,8,21,6,11580,11844,9469,-2375
2017,8,21,7,11220,11711,9793,-1918
2017,8,21,8,11070,11828,9708,-2120
2017,8,21,9,11270,12007,9633,-2374
2017,8,21,10,12010,12475,10281,-2194
2017,8,21,11,13110,13347,11157,-2190
2017,8,21,12,14340,14466,11962,-2504
2017,8,21,13,15210,15201,12754,-2447
2017,8,21,14,16440,15970,13641,-2329
2017,8,21,15,17320,16751,14248,-2503
2017,8,21,16,18000,17572,15325,-2247
2017,8,21,17,18920,18209,15940,-2269
2017,8,21,18,20470,19008,16564,-2444
2017,8,21,19,21560,19550,17305,-2245
2017,8,21,20,20880,19246,17202,-2044
2017,8,21,21,21350,19653,17626,-2027
2017,8,21,22,21470,20025,17996,-2029
2017,8,21,23,21080,19900,17699,-2201
2017,8,22,0,20580,19421,17095,-2326
2017,8,22,1,20140,19202,16930,-2272
2017,8,22,2,18770,17965,15867,-2098
2017,8,22,3,16870,16556,14317,-2239
2017,8,22,4,15000,15006,12479,-2527
2017,8,22,5,13630,14120,11721,-2399
2017,8,22,6,12940,14006,11336,-2670
2017,8,22,7,12510,13792,11190,-2602
2017,8,22,8,12300,13576,10834,-2742
2017,8,22,9,12450,13725,11007,-2718
2017,8,22,10,13250,14057,11494,-2563
2017,8,22,11,14500,14800,12370,-2430
2017,8,22,12,15870,15841,13849,-1992
2017,8,22,13,16920,16887,15230,-1657
2017,8,22,14,17730,17693,16128,-1565
2017,8,22,15,18660,18509,16779,-1730
2017,8,22,16,19470,19350,17157,-2193
2017,8,22,17,20550,20213,18086,-2127
2017,8,22,18,21350,21082,18721,-2361
2017,8,22,19,21900,21625,18938,-2687
2017,8,22,20,22070,22102,19380,-2722
2017,8,22,21,22170,22506,19788,-2718
2017,8,22,22,22140,22573,19662,-2911
2017,8,22,23,22080,22098,19112,-2986
2017,8,23,0,21730,21651,18838,-2813
2017,8,23,1,21330,21299,18587,-2712
2017,8,23,2,19970,19989,17380,-2609
2017,8,23,3,18200,18312,15557,-2755
2017,8,23,4,16410,16749,14231,-2518
2017,8,23,5,15260,15691,13414,-2277
2017,8,23,6,14510,15113,12938,-2175
2017,8,23,7,14030,14586,12385,-2201
2017,8,23,8,13800,14291,11834,-2457
2017,8,23,9,13800,14099,11600,-2499
2017,8,23,10,14610,14808,12475,-2333
2017,8,23,11,15740,16001,13843,-2158
2017,8,23,12,16980,16856,14671,-2185
2017,8,23,13,17530,17489,15420,-2069
2017,8,23,14,17710,17783,15562,-2221
2017,8,23,15,17800,17989,15541,-2448
2017,8,23,16,18000,18090,16102,-1988
2017,8,23,17,18160,18200,16328,-1872
2017,8,23,18,18500,18509,16357,-2152
2017,8,23,19,18690,18799,16346,-2453
2017,8,23,20,18920,18972,16287,-2685
2017,8,23,21,19060,19162,16566,-2596
2017,8,23,22,19120,19085,16628,-2457
2017,8,23,23,18650,18632,16265,-2367
2017,8,24,0,18190,18014,16201,-1813
2017,8,24,1,17920,17585,15802,-1783
2017,8,24,2,16710,16374,14183,-2191
2017,8,24,3,15100,14760,12402,-2358
2017,8,24,4,13580,13238,11243,-1995
2017,8,24,5,12570,12172,10041,-2131
2017,8,24,6,11930,12052,9914,-2138
2017,8,24,7,11450,12079,9762,-2317
2017,8,24,8,11170,11862,9666,-2196
2017,8,24,9,10920,11946,9595,-2351
2017,8,24,10,11610,12178,10096,-2082
2017,8,24,11,12800,12660,10878,-1782
2017,8,24,12,13910,13738,12071,-1667
2017,8,24,13,14570,14408,13049,-1359
2017,8,24,14,14970,14737,13522,-1215
2017,8,24,15,15470,15227,13743,-1484
2017,8,24,16,15860,15567,13993,-1574
2017,8,24,17,16070,15915,14362,-1553
2017,8,24,18,16640,16347,14550,-1797
2017,8,24,19,17260,16671,14727,-1944
2017,8,24,20,17540,16953,14727,-2226
2017,8,24,21,17850,17241,15002,-2239
2017,8,24,22,17900,17321,15192,-2129
2017,8,24,23,17380,16989,14757,-2232
2017,8,25,0,17070,16663,14539,-2124
2017,8,25,1,16930,16478,14564,-1914
2017,8,25,2,15860,15427,13646,-1781
2017,8,25,3,14390,14024,12288,-1736
2017,8,25,4,13030,12673,10953,-1720
2017,8,25,5,11640,12142,10172,-1970
2017,8,25,6,11040,11836,9839,-1997
2017,8,25,7,10670,11749,9472,-2277
2017,8,25,8,10530,11601,9432,-2169
2017,8,25,9,10740,11743,9467,-2276
2017,8,25,10,11450,12169,10125,-2044
2017,8,25,11,12510,12968,11215,-1753
2017,8,25,12,13590,13682,12105,-1577
2017,8,25,13,14220,14190,12714,-1476
2017,8,25,14,14470,14457,12972,-1485
2017,8,25,15,14760,14625,13238,-1387
2017,8,25,16,14990,14863,13261,-1602
2017,8,25,17,15110,15099,13459,-1640
2017,8,25,18,15360,15419,13871,-1548
2017,8,25,19,15560,15463,13997,-1466
2017,8,25,20,15570,15362,13949,-1413
2017,8,25,21,15740,15485,14125,-1360
2017,8,25,22,15730,15629,14186,-1443
2017,8,25,23,15400,15432,13702,-1730
2017,8,26,0,15090,15220,13257,-1963
2017,8,26,1,14950,15055,13032,-2023
2017,8,26,2,14140,14203,12336,-1867
2017,8,26,3,13070,13017,11112,-1905
2017,8,26,4,11880,11846,10016,-1830
2017,8,26,5,10950,10941,9057,-1884
2017,8,26,6,10400,10627,8689,-1938
2017,8,26,7,10020,10562,8318,-2244
2017,8,26,8,9850,10564,8546,-2018
2017,8,26,9,9750,10519,8632,-1887
2017,8,26,10,9980,10784,8431,-2353
2017,8,26,11,10300,11167,8877,-2290
2017,8,26,12,10970,11392,9119,-2273
2017,8,26,13,11770,11663,9910,-1753
2017,8,26,14,12290,12110,10883,-1227
2017,8,26,15,12580,12332,11048,-1284
2017,8,26,16,12730,12428,10862,-1566
2017,8,26,17,12870,12498,10853,-1645
2017,8,26,18,12900,12566,11097,-1469
2017,8,26,19,13040,12720,11096,-1624
2017,8,26,20,13170,13010,11362,-1648
2017,8,26,21,13560,13478,11623,-1855
2017,8,26,22,13920,13893,12080,-1813
2017,8,26,23,13840,13964,12206,-1758
2017,8,27,0,13880,13959,12126,-1833
2017,8,27,1,13870,13876,11732,-2144
2017,8,27,2,13250,13145,11170,-1975
2017,8,27,3,12350,12178,10292,-1886
2017,8,27,4,11400,11189,9061,-2128
2017,8,27,5,10390,10668,8541,-2127
2017,8,27,6,9940,10213,8452,-1761
2017,8,27,7,9620,9965,8301,-1664
2017,8,27,8,9420,9933,8223,-1710
2017,8,27,9,9410,9987,8401,-1586
2017,8,27,10,9540,10464,8661,-1803
2017,8,27,11,9730,10441,8525,-1916
2017,8,27,12,10230,10862,9149,-1713
2017,8,27,13,10830,11056,9489,-1567
2017,8,27,14,11290,11457,9910,-1547
2017,8,27,15,11630,11794,10110,-1684
2017,8,27,16,11880,11891,10158,-1733
2017,8,27,17,12110,12220,10347,-1873
2017,8,27,18,12310,12438,10442,-1996
2017,8,27,19,12550,12576,10549,-2027
2017,8,27,20,12800,12864,10936,-1928
2017,8,27,21,13380,13422,11504,-1918
2017,8,27,22,13820,14031,12149,-1882
2017,8,27,23,14000,14223,12102,-2121
2017,8,28,0,14160,14321,11995,-2326
2017,8,28,1,14210,14347,12094,-2253
2017,8,28,2,13330,13470,11102,-2368
2017,8,28,3,12210,12355,10052,-2303
2017,8,28,4,11160,11237,8853,-2384
2017,8,28,5,10360,10500,8264,-2236
2017,8,28,6,9930,10354,8161,-2193
2017,8,28,7,9650,10521,8391,-2130
2017,8,28,8,9570,10450,8211,-2239
2017,8,28,9,9840,10682,8410,-2272
2017,8,28,10,10700,11256,8968,-2288
2017,8,28,11,11970,11963,9668,-2295
2017,8,28,12,12980,12861,10627,-2234
2017,8,28,13,13340,13369,11177,-2192
2017,8,28,14,13460,13726,11901,-1825
2017,8,28,15,13750,14073,12366,-1707
2017,8,28,16,13960,14344,12457,-1887
2017,8,28,17,14130,14466,12406,-2060
2017,8,28,18,14430,14687,12642,-2045
2017,8,28,19,14680,14856,12854,-2002
2017,8,28,20,14730,15070,13021,-2049
2017,8,28,21,14960,15369,13324,-2045
2017,8,28,22,15100,15571,13506,-2065
2017,8,28,23,15030,15467,12944,-2523
2017,8,29,0,15140,15520,12900,-2620
2017,8,29,1,15040,15302,12580,-2722
2017,8,29,2,14000,14189,11726,-2463
2017,8,29,3,12680,12795,10406,-2389
2017,8,29,4,11510,11570,8881,-2689
2017,8,29,5,10680,10975,8668,-2307
2017,8,29,6,10190,10783,8745,-2038
2017,8,29,7,9930,10857,8659,-2198
2017,8,29,8,9830,10901,8587,-2314
2017,8,29,9,10040,11091,8812,-2279
2017,8,29,10,10870,11608,9589,-2019
2017,8,29,11,12190,12420,10796,-1624
2017,8,29,12,13250,13202,11941,-1261
2017,8,29,13,13750,13761,12691,-1070
2017,8,29,14,13970,13794,12757,-1037
2017,8,29,15,14240,14313,13056,-1257
2017,8,29,16,14480,14543,13196,-1347
2017,8,29,17,14620,14562,13320,-1242
2017,8,29,18,14850,14605,13350,-1255
2017,8,29,19,14930,14693,13249,-1444
2017,8,29,20,14930,14668,13267,-1401
2017,8,29,21,15120,14765,13342,-1423
2017,8,29,22,15340,14934,13370,-1564
2017,8,29,23,15360,15005,13540,-1465
2017,8,30,0,15250,15171,13673,-1498
2017,8,30,1,15130,14853,13129,-1724
2017,8,30,2,14160,13841,12022,-1819
2017,8,30,3,12860,12856,10848,-2008
2017,8,30,4,11670,12172,9588,-2584
2017,8,30,5,10720,11461,8824,-2637
2017,8,30,6,10260,11284,8897,-2387
2017,8,30,7,10030,11274,9185,-2089
2017,8,30,8,9920,11185,9068,-2117
2017,8,30,9,10180,11350,9026,-2324
2017,8,30,10,11040,11812,9795,-2017
2017,8,30,11,12390,12724,10798,-1926
2017,8,30,12,13450,13548,11640,-1908
2017,8,30,13,13830,13981,12195,-1786
2017,8,30,14,14150,14133,12622,-1511
2017,8,30,15,14250,14131,12569,-1562
2017,8,30,16,14270,13971,12119,-1852
2017,8,30,17,14370,13918,12342,-1576
2017,8,30,18,14590,14042,12456,-1586
2017,8,30,19,14730,14186,12660,-1526
2017,8,30,20,14800,14442,13052,-1390
2017,8,30,21,15060,14903,13882,-1021
2017,8,30,22,15310,15335,14259,-1076
2017,8,30,23,15230,15379,13920,-1459
2017,8,31,0,15220,15426,13849,-1577
2017,8,31,1,15150,15241,14043,-1198
2017,8,31,2,14200,14188,12681,-1507
2017,8,31,3,12880,12789,11056,-1733
2017,8,31,4,11650,11506,9538,-1968
2017,8,31,5,10660,10984,8710,-2274
2017,8,31,6,10180,10900,8542,-2358
2017,8,31,7,9910,10710,8671,-2039
2017,8,31,8,9820,10888,8683,-2205
2017,8,31,9,10040,11317,9014,-2303
2017,8,31,10,10890,11584,9348,-2236
2017,8,31,11,12220,12238,10124,-2114
2017,8,31,12,13180,13159,11265,-1894
2017,8,31,13,13670,13652,12003,-1649
2017,8,31,14,14080,14005,12541,-1464
2017,8,31,15,14350,14384,13266,-1118
2017,8,31,16,14560,14723,13756,-967
2017,8,31,17,14790,15081,14075,-1006
2017,8,31,18,15100,15558,14360,-1198
2017,8,31,19,15310,15532,14204,-1328
2017,8,31,20,15560,15289,13838,-1451
2017,8,31,21,15830,15301,13832,-1469
2017,8,31,22,15900,15407,13850,-1557
2017,8,31,23,15670,15319,13401,-1918
2017,9,1,0,15610,15392,13332,-2060
2017,9,1,1,15410,15174,13349,-1825
2017,9,1,2,14360,14164,12174,-1990
2017,9,1,3,13000,12822,10590,-2232
2017,9,1,4,11700,11599,9363,-2236
2017,9,1,5,10630,10909,8634,-2275
2017,9,1,6,10070,10335,8348,-1987
2017,9,1,7,9710,9980,8169,-1811
2017,9,1,8,9570,9829,8149,-1680
2017,9,1,9,9760,10025,8241,-1784
2017,9,1,10,10610,10999,8816,-2183
2017,9,1,11,11850,11718,9485,-2233
2017,9,1,12,12910,12566,10376,-2190
2017,9,1,13,13260,12845,11268,-1577
2017,9,1,14,13430,12864,11645,-1219
2017,9,1,15,13500,12872,11600,-1272
2017,9,1,16,13470,12774,11301,-1473
2017,9,1,17,13400,12695,11345,-1350
2017,9,1,18,13520,12779,11372,-1407
2017,9,1,19,13650,12793,11193,-1600
2017,9,1,20,13680,12901,11398,-1503
2017,9,1,21,13880,13253,11845,-1408
2017,9,1,22,14010,13682,12406,-1276
2017,9,1,23,13930,13735,12587,-1148
2017,9,2,0,14090,13873,12535,-1338
2017,9,2,1,13910,13709,12374,-1335
2017,9,2,2,13060,12960,11590,-1370
2017,9,2,3,12020,11920,10038,-1882
2017,9,2,4,10960,10813,9336,-1477
2017,9,2,5,10080,10037,8811,-1226
2017,9,2,6,9670,9728,8179,-1549
2017,9,2,7,9380,9751,8309,-1442
2017,9,2,8,9350,9687,8076,-1611
2017,9,2,9,9150,9717,8029,-1688
2017,9,2,10,9550,10206,8506,-1700
2017,9,2,11,10130,10281,8687,-1594
2017,9,2,12,10490,10372,8831,-1541
2017,9,2,13,11100,10871,9413,-1458
2017,9,2,14,11300,11172,9898,-1274
2017,9,2,15,11530,11295,10059,-1236
2017,9,2,16,11680,11258,9947,-1311
2017,9,2,17,11700,11180,9900,-1280
2017,9,2,18,11830,11156,9931,-1225
2017,9,2,19,11880,11328,10058,-1270
2017,9,2,20,12040,11567,10230,-1337
2017,9,2,21,12280,11929,10549,-1380
2017,9,2,22,12710,12367,10771,-1596
2017,9,2,23,12930,12610,10937,-1673
2017,9,3,0,13180,12960,11278,-1682
2017,9,3,1,13070,12826,11158,-1668
2017,9,3,2,12400,12221,10578,-1643
2017,9,3,3,11560,11379,9760,-1619
2017,9,3,4,10630,10509,8784,-1725
2017,9,3,5,10150,9998,8001,-1997
2017,9,3,6,9700,9733,7759,-1974
2017,9,3,7,9380,9633,7864,-1769
2017,9,3,8,9190,9508,7683,-1825
2017,9,3,9,9100,9507,7683,-1824
2017,9,3,10,9180,9679,7825,-1854
2017,9,3,11,9120,10004,8137,-1867
2017,9,3,12,9500,10452,8693,-1759
2017,9,3,13,10600,11063,9562,-1501
2017,9,3,14,11460,11805,10494,-1311
2017,9,3,15,12060,12376,11030,-1346
2017,9,3,16,12310,12723,11411,-1312
2017,9,3,17,12460,12854,11431,-1423
2017,9,3,18,12360,12841,11357,-1484
2017,9,3,19,12530,12723,11162,-1561
2017,9,3,20,12680,12694,11146,-1548
2017,9,3,21,12850,12898,11352,-1546
2017,9,3,22,13330,13156,11420,-1736
2017,9,3,23,13670,13181,11278,-1903
2017,9,4,0,13940,13197,11188,-2009
2017,9,4,1,13650,12908,11151,-1757
2017,9,4,2,12660,12209,10597,-1612
2017,9,4,3,11610,11336,9696,-1640
2017,9,4,4,10680,10457,8838,-1619
2017,9,4,5,9900,9990,8209,-1781
2017,9,4,6,9460,9610,7630,-1980
2017,9,4,7,9460,9652,7495,-2157
2017,9,4,8,9280,9618,7565,-2053
2017,9,4,9,9450,9734,7629,-2105
2017,9,4,10,9720,10003,7585,-2418
2017,9,4,11,10050,10403,7660,-2743
2017,9,4,12,10310,10574,8346,-2228
2017,9,4,13,10450,10976,9159,-1817
2017,9,4,14,11160,11520,9935,-1585
2017,9,4,15,11850,11853,10243,-1610
2017,9,4,16,11980,11989,10184,-1805
2017,9,4,17,12280,12108,10332,-1776
2017,9,4,18,12710,12197,10351,-1846
2017,9,4,19,12920,12399,10402,-1997
2017,9,4,20,13360,12787,10655,-2132
2017,9,4,21,14080,13475,11294,-2181
2017,9,4,22,14300,14221,12181,-2040
2017,9,4,23,15040,14483,12512,-1971
2017,9,5,0,15110,14871,12897,-1974
2017,9,5,1,15000,14788,12990,-1798
2017,9,5,2,13930,13788,11759,-2029
2017,9,5,3,12660,12499,10499,-2000
2017,9,5,4,11520,11612,9728,-1884
2017,9,5,5,10610,11252,8637,-2615
2017,9,5,6,10210,11289,8575,-2714
2017,9,5,7,10020,11311,8562,-2749
2017,9,5,8,9960,11238,8724,-2514
2017,9,5,9,10220,11415,8937,-2478
2017,9,5,10,11190,11780,9706,-2074
2017,9,5,11,12800,12915,11365,-1550
2017,9,5,12,14000,14076,12172,-1904
2017,9,5,13,14600,14694,12831,-1863
2017,9,5,14,15160,15155,13265,-1890
2017,9,5,15,15700,15701,13875,-1826
2017,9,5,16,16390,16346,14230,-2116
2017,9,5,17,16880,16940,15100,-1840
2017,9,5,18,17220,17575,15762,-1813
2017,9,5,19,17790,17999,15882,-2117
2017,9,5,20,17990,18344,15784,-2560
2017,9,5,21,18160,18667,15800,-2867
2017,9,5,22,18300,18843,15837,-3006
2017,9,5,23,18070,18539,15709,-2830
2017,9,6,0,18240,18394,15883,-2511
2017,9,6,1,17610,17840,15431,-2409
2017,9,6,2,16210,16570,14429,-2141
2017,9,6,3,14740,15002,12829,-2173
2017,9,6,4,13300,13823,11459,-2364
2017,9,6,5,12540,12621,10312,-2309
2017,9,6,6,11940,12195,10050,-2145
2017,9,6,7,11590,12201,10084,-2117
2017,9,6,8,11430,12232,9871,-2361
2017,9,6,9,11620,12395,9828,-2567
2017,9,6,10,12590,13075,10704,-2371
2017,9,6,11,14150,14147,11972,-2175
2017,9,6,12,15190,15284,12919,-2365
2017,9,6,13,15580,15896,13624,-2272
2017,9,6,14,15820,16429,14055,-2374
2017,9,6,15,16170,16864,14309,-2555
2017,9,6,16,16330,16693,14095,-2598
2017,9,6,17,16430,16425,13986,-2439
2017,9,6,18,16630,16255,13970,-2285
2017,9,6,19,16700,16026,13820,-2206
2017,9,6,20,16660,15857,13800,-2057
2017,9,6,21,16780,15955,14018,-1937
2017,9,6,22,17030,16150,14213,-1937
2017,9,6,23,17010,16153,14245,-1908
2017,9,7,0,17000,16163,14232,-1931
2017,9,7,1,16410,15594,13848,-1746
2017,9,7,2,15340,14525,12975,-1550
2017,9,7,3,13900,13158,11455,-1703
2017,9,7,4,12620,11922,9904,-2018
2017,9,7,5,11080,11370,9683,-1687
2017,9,7,6,10610,11561,9799,-1762
2017,9,7,7,10310,11650,9556,-2094
2017,9,7,8,10200,11522,9230,-2292
2017,9,7,9,10400,11730,9287,-2443
2017,9,7,10,11380,12561,10129,-2432
2017,9,7,11,12980,13287,11483,-1804
2017,9,7,12,14050,13910,12099,-1811
2017,9,7,13,14460,14299,12436,-1863
2017,9,7,14,14400,14406,12610,-1796
2017,9,7,15,14590,14500,12661,-1839
2017,9,7,16,14630,14518,12615,-1903
2017,9,7,17,14730,14527,12878,-1649
2017,9,7,18,15160,14662,13026,-1636
2017,9,7,19,15460,14783,13084,-1699
2017,9,7,20,15840,14920,12972,-1948
2017,9,7,21,16210,15251,13271,-1980
2017,9,7,22,16250,15495,13557,-1938
2017,9,7,23,16030,15452,13457,-1995
2017,9,8,0,16000,15659,13684,-1975
2017,9,8,1,15400,15240,13469,-1771
2017,9,8,2,14250,14125,11923,-2202
2017,9,8,3,12790,12862,10800,-2062
2017,9,8,4,11510,11850,9885,-1965
2017,9,8,5,10680,10972,8415,-2557
2017,9,8,6,10110,10414,7971,-2443
2017,9,8,7,9790,10460,8279,-2181
2017,9,8,8,9660,10462,8554,-1908
2017,9,8,9,9880,10397,8156,-2241
2017,9,8,10,10790,11096,8591,-2505
2017,9,8,11,12170,12061,9696,-2365
2017,9,8,12,13100,12973,10821,-2152
2017,9,8,13,13350,13231,11256,-1975
2017,9,8,14,13380,13348,11506,-1842
2017,9,8,15,13620,13513,11510,-2003
2017,9,8,16,13660,13640,11724,-1916
2017,9,8,17,13740,13830,11990,-1840
2017,9,8,18,14220,14125,12211,-1914
2017,9,8,19,14350,14201,12115,-2086
2017,9,8,20,14520,14193,11995,-2198
2017,9,8,21,14580,14288,12077,-2211
2017,9,8,22,14630,14426,12336,-2090
2017,9,8,23,14690,14372,12159,-2213
2017,9,9,0,14820,14547,12319,-2228
2017,9,9,1,14510,14207,12336,-1871
2017,9,9,2,13600,13373,11332,-2041
2017,9,9,3,12500,12279,9990,-2289
2017,9,9,4,11370,11151,9114,-2037
2017,9,9,5,10300,10353,8034,-2319
2017,9,9,6,9770,10174,7896,-2278
2017,9,9,7,9470,10026,7741,-2285
2017,9,9,8,9360,9873,7767,-2106
2017,9,9,9,9420,9888,8181,-1707
2017,9,9,10,9740,10187,8261,-1926
2017,9,9,11,10260,10673,8509,-2164
2017,9,9,12,10680,11021,8781,-2240
2017,9,9,13,11160,11400,9177,-2223
2017,9,9,14,11420,11730,9793,-1937
2017,9,9,15,11620,11974,10210,-1764
2017,9,9,16,11690,12200,10548,-1652
2017,9,9,17,11920,12266,10587,-1679
2017,9,9,18,12000,12200,10363,-1837
2017,9,9,19,12110,12105,10518,-1587
2017,9,9,20,12220,12188,10643,-1545
2017,9,9,21,12650,12520,10549,-1971
2017,9,9,22,13010,12952,11038,-1914
2017,9,9,23,13220,13162,10788,-2374
2017,9,10,0,13450,13465,11170,-2295
2017,9,10,1,13160,13248,10973,-2275
2017,9,10,2,12450,12567,10301,-2266
2017,9,10,3,11570,11719,9974,-1745
2017,9,10,4,10660,10999,9239,-1760
2017,9,10,5,9970,10257,8013,-2244
2017,9,10,6,9480,10024,7602,-2422
2017,9,10,7,9190,9982,7365,-2617
2017,9,10,8,9080,10104,7445,-2659
2017,9,10,9,9100,10121,7327,-2794
2017,9,10,10,9250,10316,7320,-2996
2017,9,10,11,9450,10364,7774,-2590
2017,9,10,12,9960,10984,8388,-2596
2017,9,10,13,10450,11649,9132,-2517
2017,9,10,14,10830,11788,9219,-2569
2017,9,10,15,11110,11680,9539,-2141
2017,9,10,16,11320,11739,9504,-2235
2017,9,10,17,11450,11795,9594,-2201
2017,9,10,18,11750,11779,9642,-2137
2017,9,10,19,11820,11924,10212,-1712
2017,9,10,20,12210,12240,10025,-2215
2017,9,10,21,12670,12723,10425,-2298
2017,9,10,22,13210,13334,11008,-2326
2017,9,10,23,13470,13687,11253,-2434
2017,9,11,0,13650,14129,11683,-2446
2017,9,11,1,13480,13814,11246,-2568
2017,9,11,2,12640,12827,10416,-2411
2017,9,11,3,11550,11633,9296,-2337
2017,9,11,4,10540,10571,8248,-2323
2017,9,11,5,9820,10079,7924,-2155
2017,9,11,6,9420,10165,7908,-2257
2017,9,11,7,9230,10398,7504,-2894
2017,9,11,8,9180,10501,7857,-2644
2017,9,11,9,9550,10756,8250,-2506
2017,9,11,10,10500,11242,9064,-2178
2017,9,11,11,12040,12433,10670,-1763
2017,9,11,12,13010,12785,11159,-1626
2017,9,11,13,13150,12999,11628,-1371
2017,9,11,14,13110,13304,11793,-1511
2017,9,11,15,13290,13515,12092,-1423
2017,9,11,16,13480,13402,12001,-1401
2017,9,11,17,13710,13542,12164,-1378
2017,9,11,18,14160,13814,12229,-1585
2017,9,11,19,14500,14061,12398,-1663
2017,9,11,20,14820,14424,12761,-1663
2017,9,11,21,15500,14936,13411,-1525
2017,9,11,22,15530,15380,13863,-1517
2017,9,11,23,15700,15460,13624,-1836
2017,9,12,0,16000,15747,13763,-1984
2017,9,12,1,15260,15177,13418,-1759
2017,9,12,2,14130,13958,12098,-1860
2017,9,12,3,12740,12588,10877,-1711
2017,9,12,4,11470,11539,9561,-1978
2017,9,12,5,10660,10715,8207,-2508
2017,9,12,6,10180,10441,7842,-2599
2017,9,12,7,9920,10163,7851,-2312
2017,9,12,8,9840,10311,7706,-2605
2017,9,12,9,9800,10557,7865,-2692
2017,9,12,10,10750,10973,8751,-2222
2017,9,12,11,12240,12295,9955,-2340
2017,9,12,12,13120,13129,10683,-2446
2017,9,12,13,13470,13385,11528,-1857
2017,9,12,14,13730,13762,11978,-1784
2017,9,12,15,14240,13832,12091,-1741
2017,9,12,16,14650,14060,12086,-1974
2017,9,12,17,15050,14356,12446,-1910
2017,9,12,18,15550,14808,12739,-2069
2017,9,12,19,15960,15214,13274,-1940
2017,9,12,20,16370,15626,13457,-2169
2017,9,12,21,16700,16106,13715,-2391
2017,9,12,22,16800,16445,13853,-2592
2017,9,12,23,16760,16320,13592,-2728
2017,9,13,0,16850,16494,13781,-2713
2017,9,13,1,16270,15919,13343,-2576
2017,9,13,2,15040,14679,12680,-1999
2017,9,13,3,13540,13135,11072,-2063
2017,9,13,4,12180,12073,9906,-2167
2017,9,13,5,10870,11655,9575,-2080
2017,9,13,6,10360,11643,9312,-2331
2017,9,13,7,10040,11333,8801,-2532
2017,9,13,8,9930,11153,8888,-2265
2017,9,13,9,10040,11335,8944,-2391
2017,9,13,10,10920,12182,9861,-2321
2017,9,13,11,12450,13044,11362,-1682
2017,9,13,12,13500,13379,12006,-1373
2017,9,13,13,13860,13639,12426,-1213
2017,9,13,14,14270,13882,12917,-965
2017,9,13,15,14650,14222,12970,-1252
2017,9,13,16,14960,14578,13407,-1171
2017,9,13,17,15230,14881,13797,-1084
2017,9,13,18,15600,15370,14380,-990
2017,9,13,19,15940,15795,14435,-1360
2017,9,13,20,16210,16208,14787,-1421
2017,9,13,21,16640,16618,14890,-1728
2017,9,13,22,17000,16747,14850,-1897
2017,9,13,23,16780,16695,14566,-2129
2017,9,14,0,16910,16977,14770,-2207
2017,9,14,1,16400,16499,14646,-1853
2017,9,14,2,15260,15365,13667,-1698
2017,9,14,3,13860,13910,12026,-1884
2017,9,14,4,12540,12652,10968,-1684
2017,9,14,5,11740,12014,10035,-1979
2017,9,14,6,11240,11751,9592,-2159
2017,9,14,7,10950,11964,9660,-2304
2017,9,14,8,10790,12052,9554,-2498
2017,9,14,9,11030,12265,9690,-2575
2017,9,14,10,11980,12597,10223,-2374
2017,9,14,11,13690,13999,11999,-2000
2017,9,14,12,14550,14827,13178,-1649
2017,9,14,13,15110,15356,13976,-1380
2017,9,14,14,15410,15726,14248,-1478
2017,9,14,15,15840,16080,14444,-1636
2017,9,14,16,16110,16497,14535,-1962
2017,9,14,17,16510,16713,14574,-2139
2017,9,14,18,16830,17095,15300,-1795
2017,9,14,19,17070,17217,15343,-1874
2017,9,14,20,17250,17470,15633,-1837
2017,9,14,21,17470,17729,15825,-1904
2017,9,14,22,17540,17855,15936,-1919
2017,9,14,23,17430,17772,15856,-1916
2017,9,15,0,17550,17998,15958,-2040
2017,9,15,1,16990,17494,15624,-1870
2017,9,15,2,15800,16400,14388,-2012
2017,9,15,3,14360,14930,12781,-2149
2017,9,15,4,13040,13511,11246,-2265
2017,9,15,5,12530,12843,10960,-1883
2017,9,15,6,11980,12765,10945,-1820
2017,9,15,7,11620,12610,10638,-1972
2017,9,15,8,11440,12514,10464,-2050
2017,9,15,9,11590,12685,10544,-2141
2017,9,15,10,12410,13316,11261,-2055
2017,9,15,11,13620,14226,12483,-1743
2017,9,15,12,14840,15184,13035,-2149
2017,9,15,13,15310,15730,13710,-2020
2017,9,15,14,15840,16127,14163,-1964
2017,9,15,15,16210,16435,14625,-1810
2017,9,15,16,16490,16757,14836,-1921
2017,9,15,17,16720,17155,15295,-1860
2017,9,15,18,16930,17633,15612,-2021
2017,9,15,19,17170,17877,15911,-1966
2017,9,15,20,17390,18002,16020,-1982
2017,9,15,21,17450,18118,16052,-2066
2017,9,15,22,17550,18053,15661,-2392
2017,9,15,23,17320,17709,15342,-2367
2017,9,16,0,17310,17656,15162,-2494
2017,9,16,1,16650,17040,14591,-2449
2017,9,16,2,15550,16029,13676,-2353
2017,9,16,3,14330,14756,12528,-2228
2017,9,16,4,12990,13454,11050,-2404
2017,9,16,5,12080,12449,9966,-2483
2017,9,16,6,11460,12216,9889,-2327
2017,9,16,7,11040,11906,9821,-2085
2017,9,16,8,11100,12159,9839,-2320
2017,9,16,9,11110,12144,9894,-2250
2017,9,16,10,11390,12419,10100,-2319
2017,9,16,11,12090,12772,10571,-2201
2017,9,16,12,12710,13089,10966,-2123
2017,9,16,13,13480,13685,11610,-2075
2017,9,16,14,14130,14282,12181,-2101
2017,9,16,15,14440,14571,12578,-1993
2017,9,16,16,14750,14645,12874,-1771
2017,9,16,17,15030,14721,12891,-1830
2017,9,16,18,15300,14949,13277,-1672
2017,9,16,19,15550,15334,13973,-1361
2017,9,16,20,15780,15847,14375,-1472
2017,9,16,21,16060,16384,14490,-1894
2017,9,16,22,16180,16652,14371,-2281
2017,9,16,23,16130,16462,14152,-2310
2017,9,17,0,16340,16489,14295,-2194
2017,9,17,1,15770,15932,13753,-2179
2017,9,17,2,14820,15026,13065,-1961
2017,9,17,3,13760,13918,12236,-1682
2017,9,17,4,12650,13016,11279,-1737
2017,9,17,5,11820,12123,10715,-1408
2017,9,17,6,11200,11708,10161,-1547
2017,9,17,7,10790,11737,10058,-1679
2017,9,17,8,10560,11874,10034,-1840
2017,9,17,9,10500,11821,10173,-1648
2017,9,17,10,10680,11980,10246,-1734
2017,9,17,11,10980,12160,10368,-1792
2017,9,17,12,11540,12402,10550,-1852
2017,9,17,13,12350,12836,11256,-1580
2017,9,17,14,13120,13000,11748,-1252
2017,9,17,15,13640,13346,12125,-1221
2017,9,17,16,13990,13687,12542,-1145
2017,9,17,17,14440,14276,13089,-1187
2017,9,17,18,14680,14927,13556,-1371
2017,9,17,19,15140,15509,13730,-1779
2017,9,17,20,15610,16034,14403,-1631
2017,9,17,21,16020,16548,14887,-1661
2017,9,17,22,16590,16879,14943,-1936
2017,9,17,23,16620,16822,14864,-1958
2017,9,18,0,17000,16982,14809,-2173
2017,9,18,1,16140,16327,14351,-1976
2017,9,18,2,15110,15177,13304,-1873
2017,9,18,3,13730,13832,12020,-1812
2017,9,18,4,12420,12946,11214,-1732
2017,9,18,5,11420,12758,10508,-2250
2017,9,18,6,10920,12288,10144,-2144
2017,9,18,7,10630,11965,10089,-1876
2017,9,18,8,10760,11895,9792,-2103
2017,9,18,9,11010,12153,9980,-2173
2017,9,18,10,11920,12990,10615,-2375
2017,9,18,11,13540,14270,11854,-2416
2017,9,18,12,14600,14887,12709,-2178
2017,9,18,13,15130,15320,13132,-2188
2017,9,18,14,15470,15646,13386,-2260
2017,9,18,15,15720,15918,13506,-2412
2017,9,18,16,15830,16047,13822,-2225
2017,9,18,17,16070,16096,14117,-1979
2017,9,18,18,16330,16244,14301,-1943
2017,9,18,19,16560,16238,14375,-1863
2017,9,18,20,16730,16268,14445,-1823
2017,9,18,21,16790,16409,14699,-1710
2017,9,18,22,16850,16619,14811,-1808
2017,9,18,23,16910,16797,14893,-1904
2017,9,19,0,17150,16984,14972,-2012
2017,9,19,1,16390,16347,14354,-1993
2017,9,19,2,15130,15201,12954,-2247
2017,9,19,3,13670,13939,11937,-2002
2017,9,19,4,12410,13062,10643,-2419
2017,9,19,5,11670,12228,10309,-1919
2017,9,19,6,11160,11968,10278,-1690
2017,9,19,7,10870,11901,10157,-1744
2017,9,19,8,10780,11818,10304,-1514
2017,9,19,9,10940,12020,10416,-1604
2017,9,19,10,11900,12619,11246,-1373
2017,9,19,11,13510,13671,12699,-972
2017,9,19,12,14490,14675,13592,-1083
2017,9,19,13,14970,15069,13843,-1226
2017,9,19,14,15110,15345,13907,-1438
2017,9,19,15,15240,15604,14002,-1602
2017,9,19,16,15360,15742,14231,-1511
2017,9,19,17,15440,15767,14599,-1168
2017,9,19,18,15540,15789,14859,-930
2017,9,19,19,15580,15712,14773,-939
2017,9,19,20,15650,15668,14575,-1093
2017,9,19,21,15840,15832,14763,-1069
2017,9,19,22,16030,16061,15280,-781
2017,9,19,23,16230,16226,15428,-798
2017,9,20,0,16390,16349,15487,-862
2017,9,20,1,15730,15764,14890,-874
2017,9,20,2,14570,14713,13913,-800
2017,9,20,3,13210,13425,12647,-778
2017,9,20,4,12030,12493,11481,-1012
2017,9,20,5,11360,12151,10345,-1806
2017,9,20,6,10880,11935,9994,-1941
2017,9,20,7,10620,11693,9895,-1798
2017,9,20,8,10560,11627,9768,-1859
2017,9,20,9,10820,11886,9945,-1941
2017,9,20,10,11810,12605,10821,-1784
2017,9,20,11,13580,13948,12415,-1533
2017,9,20,12,14670,14765,13549,-1216
2017,9,20,13,15200,15280,14336,-944
2017,9,20,14,15630,15648,14679,-969
2017,9,20,15,15830,15970,14932,-1038
2017,9,20,16,16020,16108,14994,-1114
2017,9,20,17,16110,16134,15054,-1080
2017,9,20,18,16210,16190,15145,-1045
2017,9,20,19,16210,16177,15546,-631
2017,9,20,20,16230,16160,15695,-465
2017,9,20,21,16450,16266,15703,-563
2017,9,20,22,16670,16486,15850,-636
2017,9,20,23,16810,16638,15624,-1014
2017,9,21,0,16970,16852,15898,-954
2017,9,21,1,16310,16295,15487,-808
2017,9,21,2,15200,15260,14180,-1080
2017,9,21,3,13820,14198,12932,-1266
2017,9,21,4,12540,12968,11255,-1713
2017,9,21,5,11800,11976,10040,-1936
2017,9,21,6,11260,12040,9973,-2067
2017,9,21,7,10950,11734,9484,-2250
2017,9,21,8,10800,11578,9395,-2183
2017,9,21,9,11010,11522,9469,-2053
2017,9,21,10,11960,12166,10298,-1868
2017,9,21,11,13620,13585,12288,-1297
2017,9,21,12,14620,14608,13362,-1246
2017,9,21,13,15050,15049,13614,-1435
2017,9,21,14,15260,15269,13937,-1332
2017,9,21,15,15370,15378,14107,-1271
2017,9,21,16,15450,15455,14354,-1101
2017,9,21,17,15340,15335,14334,-1001
2017,9,21,18,15300,15310,14338,-972
2017,9,21,19,15260,15260,14320,-940
2017,9,21,20,15430,15344,14654,-690
2017,9,21,21,15520,15525,14840,-685
2017,9,21,22,15590,15567,14429,-1138
2017,9,21,23,15590,15720,14330,-1390
2017,9,22,0,15800,15984,14629,-1355
2017,9,22,1,15230,15426,14194,-1232
2017,9,22,2,14180,14353,12923,-1430
2017,9,22,3,12870,13004,11401,-1603
2017,9,22,4,11640,11761,10074,-1687
2017,9,22,5,10930,10906,9049,-1857
2017,9,22,6,10390,10845,9021,-1824
2017,9,22,7,10060,10583,8466,-2117
2017,9,22,8,9940,10678,8572,-2106
2017,9,22,9,10100,10847,8597,-2250
2017,9,22,10,10960,11350,9350,-2000
2017,9,22,11,12550,12514,10724,-1790
2017,9,22,12,13510,13432,12093,-1339
2017,9,22,13,13900,13846,12363,-1483
2017,9,22,14,14110,14049,12592,-1457
2017,9,22,15,14230,14235,13084,-1151
2017,9,22,16,14340,14327,12993,-1334
2017,9,22,17,14330,14359,13299,-1060
2017,9,22,18,14410,14491,13538,-953
2017,9,22,19,14380,14584,13738,-846
2017,9,22,20,14400,14716,14028,-688
2017,9,22,21,14580,14885,14146,-739
2017,9,22,22,14650,14984,14085,-899
2017,9,22,23,14730,15002,13934,-1068
2017,9,23,0,14900,15073,13772,-1301
2017,9,23,1,14290,14504,13238,-1266
2017,9,23,2,13390,13716,12439,-1277
2017,9,23,3,12280,12680,11251,-1429
2017,9,23,4,11260,11737,10215,-1522
2017,9,23,5,10800,11423,9663,-1760
2017,9,23,6,10270,11243,9126,-2117
2017,9,23,7,9920,10976,8846,-2130
2017,9,23,8,9770,10800,8846,-1954
2017,9,23,9,9890,10823,8842,-1981
2017,9,23,10,10290,11151,9074,-2077
2017,9,23,11,10860,11608,9855,-1753
2017,9,23,12,11560,12191,10273,-1918
2017,9,23,13,12170,12785,10912,-1873
2017,9,23,14,12640,13017,11168,-1849
2017,9,23,15,12920,13051,11458,-1593
2017,9,23,16,13170,13240,11932,-1308
2017,9,23,17,13320,13517,12458,-1059
2017,9,23,18,13450,13874,13067,-807
2017,9,23,19,13680,14288,13491,-797
2017,9,23,20,13980,14750,13838,-912
2017,9,23,21,14410,15297,14179,-1118
2017,9,23,22,14860,15678,14384,-1294
2017,9,23,23,14900,15594,14068,-1526
2017,9,24,0,15250,15620,14235,-1385
2017,9,24,1,14870,14995,13463,-1532
2017,9,24,2,14020,14136,12874,-1262
2017,9,24,3,13000,13096,11471,-1625
2017,9,24,4,11970,12019,10435,-1584
2017,9,24,5,11090,11378,9377,-2001
2017,9,24,6,10540,10788,8808,-1980
2017,9,24,7,10130,10651,8486,-2165
2017,9,24,8,9860,10554,8395,-2159
2017,9,24,9,9900,10629,8165,-2464
2017,9,24,10,10160,10787,8362,-2425
2017,9,24,11,10680,10911,8677,-2234
2017,9,24,12,11290,11179,9158,-2021
2017,9,24,13,11900,11748,9984,-1764
2017,9,24,14,12710,12502,11106,-1396
2017,9,24,15,13410,13251,11996,-1255
2017,9,24,16,14220,14092,12990,-1102
2017,9,24,17,14740,14969,13990,-979
2017,9,24,18,15400,15728,14683,-1045
2017,9,24,19,15840,16360,14820,-1540
2017,9,24,20,16380,17034,15450,-1584
2017,9,24,21,17230,17654,15745,-1909
2017,9,24,22,17660,18177,16167,-2010
2017,9,24,23,17740,18141,15958,-2183
2017,9,25,0,18000,18235,15825,-2410
2017,9,25,1,17290,17400,15042,-2358
2017,9,25,2,16030,16147,14231,-1916
2017,9,25,3,14600,14862,12919,-1943
2017,9,25,4,13220,13541,11682,-1859
2017,9,25,5,12320,12836,10683,-2153
2017,9,25,6,11740,12664,10641,-2023
2017,9,25,7,11360,12330,10206,-2124
2017,9,25,8,11480,12167,10018,-2149
2017,9,25,9,11340,12102,9896,-2206
2017,9,25,10,12310,12548,10384,-2164
2017,9,25,11,14050,13968,12145,-1823
2017,9,25,12,15260,14955,12862,-2093
2017,9,25,13,15900,15524,13310,-2214
2017,9,25,14,16520,16221,14141,-2080
2017,9,25,15,17320,16995,15176,-1819
2017,9,25,16,17980,17731,15690,-2041
2017,9,25,17,18700,18467,16015,-2452
2017,9,25,18,19290,19229,16464,-2765
2017,9,25,19,19690,19642,16879,-2763
2017,9,25,20,19980,19984,17169,-2815
2017,9,25,21,20220,20277,17335,-2942
2017,9,25,22,20250,20258,17167,-3091
2017,9,25,23,19870,19923,16839,-3084
2017,9,26,0,19850,19801,16713,-3088
2017,9,26,1,18860,18695,15779,-2916
2017,9,26,2,17280,17181,14479,-2702
2017,9,26,3,15500,15617,13305,-2312
2017,9,26,4,13960,14313,12116,-2197
2017,9,26,5,12690,13547,11422,-2125
2017,9,26,6,12050,13129,10990,-2139
2017,9,26,7,11660,12731,10633,-2098
2017,9,26,8,11500,12549,10458,-2091
2017,9,26,9,11670,12737,10441,-2296
2017,9,26,10,12640,13391,11427,-1964
2017,9,26,11,14320,14881,12822,-2059
2017,9,26,12,15390,15506,13445,-2061
2017,9,26,13,15950,15626,13468,-2158
2017,9,26,14,16490,15976,13983,-1993
2017,9,26,15,16890,16439,14231,-2208
2017,9,26,16,17420,17078,14317,-2761
2017,9,26,17,18060,17775,14655,-3120
2017,9,26,18,18670,18534,15163,-3371
2017,9,26,19,19090,19120,15862,-3258
2017,9,26,20,19290,19632,16666,-2966
2017,9,26,21,19450,20094,17236,-2858
2017,9,26,22,19460,20155,17031,-3124
2017,9,26,23,19110,19908,16716,-3192
2017,9,27,0,19290,19805,16506,-3299
2017,9,27,1,18370,18771,15436,-3335
2017,9,27,2,16920,17304,14073,-3231
2017,9,27,3,15290,15732,12806,-2926
2017,9,27,4,13740,14649,11830,-2819
2017,9,27,5,12770,13896,11085,-2811
2017,9,27,6,12100,13227,10416,-2811
2017,9,27,7,11660,12765,9979,-2786
2017,9,27,8,11500,12542,9615,-2927
2017,9,27,9,11660,12685,9775,-2910
2017,9,27,10,12580,13395,10742,-2653
2017,9,27,11,14240,14471,12145,-2326
2017,9,27,12,15240,15193,12869,-2324
2017,9,27,13,15800,15950,13503,-2447
2017,9,27,14,16360,16586,14127,-2459
2017,9,27,15,16880,16831,14144,-2687
2017,9,27,16,17440,17722,14633,-3089
2017,9,27,17,17990,18543,15333,-3210
2017,9,27,18,18660,19394,16129,-3265
2017,9,27,19,19160,19956,16831,-3125
2017,9,27,20,19530,20437,17272,-3165
2017,9,27,21,19850,20856,17545,-3311
2017,9,27,22,19900,20961,17699,-3262
2017,9,27,23,19580,20734,17443,-3291
2017,9,28,0,19770,20817,17589,-3228
2017,9,28,1,18910,19918,16886,-3032
2017,9,28,2,17450,18487,16001,-2486
2017,9,28,3,15760,16784,14198,-2586
2017,9,28,4,14250,15237,12531,-2706
2017,9,28,5,13470,14145,11532,-2613
2017,9,28,6,12880,13757,11240,-2517
2017,9,28,7,12400,13827,11260,-2567
2017,9,28,8,12830,13653,11329,-2324
2017,9,28,9,13020,13541,11444,-2097
2017,9,28,10,13810,13937,11884,-2053
2017,9,28,11,15240,15460,13241,-2219
2017,9,28,12,15530,16177,13822,-2355
2017,9,28,13,15610,16196,13903,-2293
2017,9,28,14,15670,16104,13870,-2234
2017,9,28,15,15860,16029,13586,-2443
2017,9,28,16,16020,15981,13634,-2347
2017,9,28,17,16050,15933,13647,-2286
2017,9,28,18,16190,16010,13692,-2318
2017,9,28,19,16350,16038,13599,-2439
2017,9,28,20,16430,16157,13679,-2478
2017,9,28,21,16600,16288,13720,-2568
2017,9,28,22,16400,16221,13731,-2490
2017,9,28,23,16150,15967,13678,-2289
2017,9,29,0,16140,15995,13836,-2159
2017,9,29,1,15380,15183,12910,-2273
2017,9,29,2,14110,14256,11764,-2492
2017,9,29,3,12670,13082,10441,-2641
2017,9,29,4,11370,12257,9422,-2835
2017,9,29,5,10630,11292,8703,-2589
2017,9,29,6,10030,10478,8412,-2066
2017,9,29,7,9730,10438,8134,-2304
2017,9,29,8,9610,10315,8129,-2186
2017,9,29,9,9810,10322,8447,-1875
2017,9,29,10,10630,11079,8928,-2151
2017,9,29,11,12030,12126,9988,-2138
2017,9,29,12,12850,12901,10773,-2128
2017,9,29,13,13100,12952,10998,-1954
2017,9,29,14,12820,12820,10710,-2110
2017,9,29,15,12850,12788,10688,-2100
2017,9,29,16,12820,12752,10791,-1961
2017,9,29,17,12780,12713,10820,-1893
2017,9,29,18,12980,12816,11026,-1790
2017,9,29,19,13130,12911,11148,-1763
2017,9,29,20,13250,13106,11250,-1856
2017,9,29,21,13550,13521,11972,-1549
2017,9,29,22,13900,13864,12083,-1781
2017,9,29,23,13970,14061,11926,-2135
2017,9,30,0,14140,14186,11849,-2337
2017,9,30,1,13770,13590,11411,-2179
2017,9,30,2,12950,12778,10774,-2004
2017,9,30,3,11890,11768,9661,-2107
2017,9,30,4,10820,10748,8573,-2175
2017,9,30,5,9990,10441,7790,-2651
2017,9,30,6,9550,10150,7575,-2575
2017,9,30,7,9290,9806,7882,-1924
2017,9,30,8,9140,9441,7552,-1889
2017,9,30,9,9200,9724,7471,-2253
2017,9,30,10,9510,10070,7918,-2152
2017,9,30,11,10360,10706,8084,-2622
2017,9,30,12,10850,11234,8807,-2427
2017,9,30,13,11640,11797,9213,-2584
2017,9,30,14,11910,12361,9718,-2643
2017,9,30,15,12060,12728,10000,-2728
2017,9,30,16,12160,12763,9991,-2772
2017,9,30,17,12080,12624,9959,-2665
2017,9,30,18,12070,12460,9797,-2663
2017,9,30,19,12030,12333,9641,-2692
2017,9,30,20,12180,12312,9585,-2727
2017,9,30,21,12550,12450,9727,-2723
2017,9,30,22,12920,12803,10172,-2631
2017,9,30,23,13200,13213,10606,-2607
2017,10,1,0,13560,13295,10774,-2521
2017,10,1,1,12780,12819,10296,-2523
2017,10,1,2,12070,12177,9825,-2352
2017,10,1,3,11230,11311,8917,-2394
2017,10,1,4,10370,10424,8281,-2143
2017,10,1,5,9700,10142,7437,-2705
2017,10,1,6,9300,9846,7481,-2365
2017,10,1,7,9030,9602,7436,-2166
2017,10,1,8,8920,9482,7233,-2249
2017,10,1,9,9000,9514,7406,-2108
2017,10,1,10,9180,9621,7596,-2025
2017,10,1,11,9530,9939,7711,-2228
2017,10,1,12,10100,10238,8009,-2229
2017,10,1,13,10590,10752,8496,-2256
2017,10,1,14,10770,10907,8747,-2160
2017,10,1,15,10750,10788,8559,-2229
2017,10,1,16,10690,10819,8600,-2219
2017,10,1,17,10720,10973,8772,-2201
2017,10,1,18,10700,10896,8957,-1939
2017,10,1,19,10850,10847,8922,-1925
2017,10,1,20,11150,11165,9194,-1971
2017,10,1,21,11710,11910,9819,-2091
2017,10,1,22,12600,12758,10348,-2410
2017,10,1,23,13200,13441,11036,-2405
2017,10,2,0,13470,13768,11543,-2225
2017,10,2,1,12990,13190,10803,-2387
2017,10,2,2,12140,12259,9858,-2401
2017,10,2,3,11060,11139,8832,-2307
2017,10,2,4,10090,10213,7921,-2292
2017,10,2,5,9490,9847,7761,-2086
2017,10,2,6,9120,9463,7765,-1698
2017,10,2,7,8950,9734,7851,-1883
2017,10,2,8,8960,9824,7592,-2232
2017,10,2,9,9270,10035,7826,-2209
2017,10,2,10,10200,10642,8710,-1932
2017,10,2,11,11970,12094,10288,-1806
2017,10,2,12,12900,13045,11181,-1864
2017,10,2,13,12810,13020,10843,-2177
2017,10,2,14,12680,12854,10920,-1934
2017,10,2,15,12670,12794,11141,-1653
2017,10,2,16,12650,12783,11019,-1764
2017,10,2,17,12770,12766,11117,-1649
2017,10,2,18,12880,12867,11138,-1729
2017,10,2,19,12960,12976,11217,-1759
2017,10,2,20,13120,13215,11374,-1841
2017,10,2,21,13550,13692,11627,-2065
2017,10,2,22,14060,14316,12035,-2281
2017,10,2,23,14660,14786,12220,-2566
2017,10,3,0,14830,14947,12340,-2607
2017,10,3,1,14060,14217,11782,-2435
2017,10,3,2,12980,13116,10709,-2407
2017,10,3,3,11680,11801,9343,-2458
2017,10,3,4,10550,10729,8290,-2439
2017,10,3,5,9950,10467,8065,-2402
2017,10,3,6,9540,10074,7660,-2414
2017,10,3,7,9350,10119,7621,-2498
2017,10,3,8,9330,10345,7770,-2575
2017,10,3,9,9630,10602,8139,-2463
2017,10,3,10,10620,10990,8757,-2233
2017,10,3,11,12400,12286,10126,-2160
2017,10,3,12,13160,13200,10971,-2229
2017,10,3,13,13020,13145,11113,-2032
2017,10,3,14,12860,12922,11043,-1879
2017,10,3,15,12800,12864,11215,-1649
2017,10,3,16,12770,12849,11031,-1818
2017,10,3,17,12720,12831,10776,-2055
2017,10,3,18,12920,13002,10964,-2038
2017,10,3,19,13060,13076,10918,-2158
2017,10,3,20,13270,13278,11160,-2118
2017,10,3,21,13690,13730,11488,-2242
2017,10,3,22,14140,14294,11992,-2302
2017,10,3,23,14700,14782,12429,-2353
2017,10,4,0,14850,14957,12571,-2386
2017,10,4,1,14150,14269,11777,-2492
2017,10,4,2,13100,13185,10776,-2409
2017,10,4,3,11780,11883,9549,-2334
2017,10,4,4,10630,10982,8481,-2501
2017,10,4,5,9980,10690,8090,-2600
2017,10,4,6,9580,10399,7892,-2507
2017,10,4,7,9370,10393,7972,-2421
2017,10,4,8,9330,10350,7818,-2532
2017,10,4,9,9650,10624,8045,-2579
2017,10,4,10,10650,11230,8930,-2300
2017,10,4,11,12440,12273,10286,-1987
2017,10,4,12,13160,13145,10973,-2172
2017,10,4,13,13000,13139,10890,-2249
2017,10,4,14,13010,12966,10745,-2221
2017,10,4,15,12970,12951,11058,-1893
2017,10,4,16,13050,12998,11089,-1909
2017,10,4,17,13190,13087,11286,-1801
2017,10,4,18,13380,13327,11300,-2027
2017,10,4,19,13560,13582,11656,-1926
2017,10,4,20,13860,13937,11919,-2018
2017,10,4,21,14310,14436,11998,-2438
2017,10,4,22,14780,14903,12404,-2499
2017,10,4,23,15280,15297,12827,-2470
2017,10,5,0,15350,15427,12967,-2460
2017,10,5,1,14660,14742,12456,-2286
2017,10,5,2,13590,13685,11312,-2373
2017,10,5,3,12230,12372,10056,-2316
2017,10,5,4,11060,11667,9004,-2663
2017,10,5,5,10510,11042,8198,-2844
2017,10,5,6,10070,10839,7959,-2880
2017,10,5,7,9850,10723,7831,-2892
2017,10,5,8,9820,10821,7787,-3034
2017,10,5,9,10070,10835,7970,-2865
2017,10,5,10,11080,11376,8855,-2521
2017,10,5,11,12840,12635,10262,-2373
2017,10,5,12,13600,13619,11050,-2569
2017,10,5,13,13600,13852,11137,-2715
2017,10,5,14,13660,13929,11313,-2616
2017,10,5,15,13830,14045,11705,-2340
2017,10,5,16,14080,14233,11854,-2379
2017,10,5,17,14200,14361,11916,-2445
2017,10,5,18,14550,14810,12376,-2434
2017,10,5,19,14800,15104,12581,-2523
2017,10,5,20,15020,15310,12896,-2414
2017,10,5,21,15420,15633,13467,-2166
2017,10,5,22,15700,15956,13591,-2365
2017,10,5,23,15990,16301,13987,-2314
2017,10,6,0,16030,16321,14012,-2309
2017,10,6,1,15400,15639,13383,-2256
2017,10,6,2,14310,14597,12437,-2160
2017,10,6,3,12860,13345,11031,-2314
2017,10,6,4,11580,12141,9695,-2446
2017,10,6,5,10970,11162,8997,-2165
2017,10,6,6,10350,10753,8904,-1849
2017,10,6,7,10020,10926,8962,-1964
2017,10,6,8,9890,11056,8944,-2112
2017,10,6,9,10050,11163,8918,-2245
2017,10,6,10,10890,11428,9641,-1787
2017,10,6,11,12470,12430,10761,-1669
2017,10,6,12,13350,13341,11594,-1747
2017,10,6,13,13630,13706,12054,-1652
2017,10,6,14,14000,14006,12357,-1649
2017,10,6,15,14020,14276,12595,-1681
2017,10,6,16,14220,14520,12851,-1669
2017,10,6,17,14240,14702,13019,-1683
2017,10,6,18,14480,14909,13201,-1708
2017,10,6,19,14630,14791,12950,-1841
2017,10,6,20,14730,14714,12838,-1876
2017,10,6,21,14840,14783,12899,-1884
2017,10,6,22,15030,14832,12895,-1937
2017,10,6,23,15190,15040,12933,-2107
2017,10,7,0,15120,14929,12870,-2059
2017,10,7,1,14440,14298,12403,-1895
2017,10,7,2,13550,13453,11840,-1613
2017,10,7,3,12470,12403,10593,-1810
2017,10,7,4,11380,11317,9824,-1493
2017,10,7,5,10510,10484,8920,-1564
2017,10,7,6,10010,10380,8464,-1916
2017,10,7,7,9660,10221,8346,-1875
2017,10,7,8,9530,10075,8173,-1902
2017,10,7,9,9570,10145,7991,-2154
2017,10,7,10,9910,10464,8373,-2091
2017,10,7,11,10820,11130,9210,-1920
2017,10,7,12,11300,11868,9761,-2107
2017,10,7,13,12140,12670,10663,-2007
2017,10,7,14,12430,13116,11234,-1882
2017,10,7,15,12680,12910,11164,-1746
2017,10,7,16,12940,12894,11202,-1692
2017,10,7,17,13120,12954,11463,-1491
2017,10,7,18,13540,13173,11572,-1601
2017,10,7,19,13770,13535,12083,-1452
2017,10,7,20,14200,13714,12317,-1397
2017,10,7,21,14510,13962,12407,-1555
2017,10,7,22,14990,14262,12450,-1812
2017,10,7,23,15200,14655,12872,-1783
2017,10,8,0,15060,14678,12889,-1789
2017,10,8,1,14450,14195,12502,-1693
2017,10,8,2,13590,13535,11716,-1819
2017,10,8,3,12640,12695,10835,-1860
2017,10,8,4,11700,12087,10177,-1910
2017,10,8,5,10820,11547,9873,-1674
2017,10,8,6,10310,10866,9107,-1759
2017,10,8,7,10060,10568,9056,-1512
2017,10,8,8,10120,10524,8920,-1604
2017,10,8,9,10190,10694,8901,-1793
2017,10,8,10,10440,10944,9032,-1912
2017,10,8,11,10900,11430,9659,-1771
2017,10,8,12,11640,12063,9962,-2101
2017,10,8,13,12370,13006,10805,-2201
2017,10,8,14,12950,13854,11783,-2071
2017,10,8,15,13390,14203,12378,-1825
2017,10,8,16,13820,14267,12408,-1859
2017,10,8,17,14190,14375,12587,-1788
2017,10,8,18,14390,14411,12990,-1421
2017,10,8,19,14660,14430,13121,-1309
2017,10,8,20,15060,14552,13358,-1194
2017,10,8,21,15310,14876,13586,-1290
2017,10,8,22,15990,15319,13823,-1496
2017,10,8,23,16390,15875,13825,-2050
2017,10,9,0,16580,15866,13807,-2059
2017,10,9,1,15680,15368,13579,-1789
2017,10,9,2,14680,14519,12767,-1752
2017,10,9,3,13450,13511,11716,-1795
2017,10,9,4,12270,12650,10598,-2052
2017,10,9,5,11740,11941,9972,-1969
2017,10,9,6,11340,11642,9445,-2197
2017,10,9,7,10940,11350,9293,-2057
2017,10,9,8,10750,11262,9678,-1584
2017,10,9,9,10980,11478,10654,-824
2017,10,9,10,11760,12206,11531,-675
2017,10,9,11,13130,12966,12376,-590
2017,10,9,12,14190,13955,13070,-885
2017,10,9,13,15170,14886,13947,-939
2017,10,9,14,15640,15678,14880,-798
2017,10,9,15,16100,16175,15636,-539
2017,10,9,16,16440,16435,15743,-692
2017,10,9,17,16350,16601,15834,-767
2017,10,9,18,16340,16696,15944,-752
2017,10,9,19,16360,16612,15847,-765
2017,10,9,20,16240,16561,15761,-800
2017,10,9,21,16460,16710,15861,-849
2017,10,9,22,17070,17040,16223,-817
2017,10,9,23,17880,17279,16378,-901
2017,10,10,0,17580,17031,16228,-803
2017,10,10,1,16700,16414,15630,-784
2017,10,10,2,15560,15444,14869,-575
2017,10,10,3,14260,14203,13416,-787
2017,10,10,4,13020,13360,12618,-742
2017,10,10,5,12420,12750,11860,-890
2017,10,10,6,11820,12186,11483,-703
2017,10,10,7,11490,11795,11228,-567
2017,10,10,8,11490,11555,10885,-670
2017,10,10,9,11120,11643,10805,-838
2017,10,10,10,12080,12439,11469,-970
2017,10,10,11,13730,13872,12867,-1005
2017,10,10,12,14530,15005,14169,-836
2017,10,10,13,14580,14827,14154,-673
2017,10,10,14,14630,14916,14323,-593
2017,10,10,15,14820,15109,14590,-519
2017,10,10,16,15040,15317,14926,-391
2017,10,10,17,15430,15514,15187,-327
2017,10,10,18,15900,15826,15625,-201
2017,10,10,19,16190,15949,15768,-181
2017,10,10,20,16610,15978,15531,-447
2017,10,10,21,17180,16238,15841,-397
2017,10,10,22,17310,16449,15878,-571
2017,10,10,23,17350,16648,15843,-805
2017,10,11,0,17030,16480,15965,-515
2017,10,11,1,16210,15580,14779,-801
2017,10,11,2,14900,14368,13812,-556
2017,10,11,3,13360,12904,12287,-617
2017,10,11,4,11960,11896,11178,-718
2017,10,11,5,10900,11012,10045,-967
2017,10,11,6,10380,10718,9813,-905
2017,10,11,7,10060,10477,9488,-989
2017,10,11,8,9900,10368,9350,-1018
2017,10,11,9,10090,10584,9583,-1001
2017,10,11,10,10990,11454,10486,-968
2017,10,11,11,12740,12628,11676,-952
2017,10,11,12,13540,13614,12795,-819
2017,10,11,13,13620,13933,13132,-801
2017,10,11,14,13550,14119,13210,-909
2017,10,11,15,13720,14089,13210,-879
2017,10,11,16,13730,13818,12948,-870
2017,10,11,17,13810,13953,13057,-896
2017,10,11,18,14030,14238,13271,-967
2017,10,11,19,14110,14313,13426,-887
2017,10,11,20,14210,14394,13440,-954
2017,10,11,21,14400,14577,13598,-979
2017,10,11,22,14790,14933,13992,-941
2017,10,11,23,15300,15495,14647,-848
2017,10,12,0,15290,15313,14501,-812
2017,10,12,1,14440,14586,13733,-853
2017,10,12,2,13240,13539,12749,-790
2017,10,12,3,11970,12212,11417,-795
2017,10,12,4,10830,11078,10191,-887
2017,10,12,5,10060,10442,9390,-1052
2017,10,12,6,9630,10330,9217,-1113
2017,10,12,7,9410,10072,8924,-1148
2017,10,12,8,9350,10028,8798,-1230
2017,10,12,9,9590,10233,9031,-1202
2017,10,12,10,10550,11106,10215,-891
2017,10,12,11,12330,12382,11672,-710
2017,10,12,12,13260,13238,12533,-705
2017,10,12,13,13270,13233,12565,-668
2017,10,12,14,13030,12976,12340,-636
2017,10,12,15,12910,12734,12309,-425
2017,10,12,16,12690,12606,12576,-30
2017,10,12,17,12650,12635,12375,-260
2017,10,12,18,12740,12849,12524,-325
2017,10,12,19,12800,12895,12505,-390
2017,10,12,20,13030,12910,12482,-428
2017,10,12,21,13380,13366,12860,-506
2017,10,12,22,13880,13939,13183,-756
2017,10,12,23,14500,14637,13769,-868
2017,10,13,0,14620,14694,13900,-794
2017,10,13,1,14000,14093,13408,-685
2017,10,13,2,13000,13133,12311,-822
2017,10,13,3,11790,11889,11085,-804
2017,10,13,4,10670,10782,9873,-909
2017,10,13,5,9960,10332,9307,-1025
2017,10,13,6,9540,10151,9092,-1059
2017,10,13,7,9340,9940,8882,-1058
2017,10,13,8,9310,9909,8906,-1003
2017,10,13,9,9580,10182,9198,-984
2017,10,13,10,10510,11117,10166,-951
2017,10,13,11,12200,12398,11899,-499
2017,10,13,12,13130,13318,12550,-768
2017,10,13,13,12960,13251,12373,-878
2017,10,13,14,12800,12928,12153,-775
2017,10,13,15,12690,12729,11988,-741
2017,10,13,16,12550,12589,11984,-605
2017,10,13,17,12490,12477,12001,-476
2017,10,13,18,12510,12556,11998,-558
2017,10,13,19,12600,12880,12205,-675
2017,10,13,20,12810,13054,12219,-835
2017,10,13,21,13240,13291,12418,-873
2017,10,13,22,13590,13760,12708,-1052
2017,10,13,23,14150,14342,13307,-1035
2017,10,14,0,14130,14233,13161,-1072
2017,10,14,1,13490,13684,12559,-1125
2017,10,14,2,12650,12902,11812,-1090
2017,10,14,3,11650,12080,11002,-1078
2017,10,14,4,10630,11322,10156,-1166
2017,10,14,5,10090,10651,9389,-1262
2017,10,14,6,9630,10165,9101,-1064
2017,10,14,7,9340,9885,8841,-1044
2017,10,14,8,9260,9776,8810,-966
2017,10,14,9,9360,9842,8640,-1202
2017,10,14,10,9730,10188,8866,-1322
2017,10,14,11,10350,10894,9797,-1097
2017,10,14,12,11050,11644,10804,-840
2017,10,14,13,11540,12345,11371,-974
2017,10,14,14,11850,12437,11599,-838
2017,10,14,15,11920,12636,11574,-1062
2017,10,14,16,11870,12569,11476,-1093
2017,10,14,17,11960,12431,11421,-1010
2017,10,14,18,12010,12328,11331,-997
2017,10,14,19,12230,12310,11298,-1012
2017,10,14,20,12530,12446,11429,-1017
2017,10,14,21,12870,12824,11599,-1225
2017,10,14,22,13320,13314,11928,-1386
2017,10,14,23,13950,13900,12530,-1370
2017,10,15,0,13910,13784,12470,-1314
2017,10,15,1,13440,13264,11942,-1322
2017,10,15,2,12670,12576,11408,-1168
2017,10,15,3,11830,11890,10839,-1051
2017,10,15,4,10940,11087,9957,-1130
2017,10,15,5,10090,10374,9329,-1045
2017,10,15,6,9620,10132,8976,-1156
2017,10,15,7,9360,9893,8699,-1194
2017,10,15,8,9220,9761,8536,-1225
2017,10,15,9,9240,9764,8671,-1093
2017,10,15,10,9520,9979,9002,-977
2017,10,15,11,9990,10371,9265,-1106
2017,10,15,12,10680,10688,9529,-1159
2017,10,15,13,11530,11393,10449,-944
2017,10,15,14,12170,12044,11229,-815
2017,10,15,15,12610,12423,11584,-839
2017,10,15,16,12890,12683,12053,-630
2017,10,15,17,13240,12774,12238,-536
2017,10,15,18,13470,12784,12100,-684
2017,10,15,19,13720,12803,12071,-732
2017,10,15,20,14030,12958,12178,-780
2017,10,15,21,14380,13398,12537,-861
2017,10,15,22,14890,14023,13104,-919
2017,10,15,23,15500,14771,13799,-972
2017,10,16,0,15650,14720,13766,-954
2017,10,16,1,15100,14111,13262,-849
2017,10,16,2,13960,13202,12399,-803
2017,10,16,3,12790,12351,11467,-884
2017,10,16,4,11680,11384,10301,-1083
2017,10,16,5,10450,10817,9681,-1136
2017,10,16,6,10040,10567,9637,-930
2017,10,16,7,9820,10350,9478,-872
2017,10,16,8,9700,10289,9262,-1027
2017,10,16,9,9790,10150,9299,-851
2017,10,16,10,10680,10816,9873,-943
2017,10,16,11,12310,12457,11487,-970
2017,10,16,12,13480,13414,12455,-959
2017,10,16,13,13570,13681,12690,-991
2017,10,16,14,13450,13823,12621,-1202
2017,10,16,15,13390,13821,12576,-1245
2017,10,16,16,13360,13695,12431,-1264
2017,10,16,17,13210,13572,12314,-1258
2017,10,16,18,13110,13602,12436,-1166
2017,10,16,19,12950,13559,12333,-1226
2017,10,16,20,12940,13505,12295,-1210
2017,10,16,21,13430,13669,12547,-1122
2017,10,16,22,14170,14249,12960,-1289
2017,10,16,23,15000,14915,13579,-1336
2017,10,17,0,14710,14769,13467,-1302
2017,10,17,1,13940,14091,12808,-1283
2017,10,17,2,12980,13054,11883,-1171
2017,10,17,3,11740,11799,10544,-1255
2017,10,17,4,10600,10694,9525,-1169
2017,10,17,5,10100,9975,8778,-1197
2017,10,17,6,9740,9588,8521,-1067
2017,10,17,7,9540,9423,8530,-893
2017,10,17,8,9560,9426,8532,-894
2017,10,17,9,9830,9748,8903,-845
2017,10,17,10,10900,10780,9772,-1008
2017,10,17,11,12790,12653,11826,-827
2017,10,17,12,13690,13663,12554,-1109
2017,10,17,13,13480,13501,12407,-1094
2017,10,17,14,13030,13041,11900,-1141
2017,10,17,15,12780,12702,11526,-1176
2017,10,17,16,12580,12472,11497,-975
2017,10,17,17,12300,12304,11212,-1092
2017,10,17,18,12240,12301,11350,-951
2017,10,17,19,12240,12350,11319,-1031
2017,10,17,20,12440,12627,11555,-1072
2017,10,17,21,12950,13229,11991,-1238
2017,10,17,22,13860,14040,12792,-1248
2017,10,17,23,14760,14916,13664,-1252
2017,10,18,0,14610,14887,13749,-1138
2017,10,18,1,13950,14250,13000,-1250
2017,10,18,2,13030,13249,12032,-1217
2017,10,18,3,11790,11944,10609,-1335
2017,10,18,4,10700,10822,9633,-1189
2017,10,18,5,10030,10325,9187,-1138
2017,10,18,6,9560,10193,9033,-1160
2017,10,18,7,9350,10031,8837,-1194
2017,10,18,8,9320,10021,8854,-1167
2017,10,18,9,9750,10321,9231,-1090
2017,10,18,10,10730,11209,10127,-1082
2017,10,18,11,12530,12669,11552,-1117
2017,10,18,12,13520,13596,12414,-1182
2017,10,18,13,13230,13450,12316,-1134
2017,10,18,14,12910,13068,11961,-1107
2017,10,18,15,12780,12851,11862,-989
2017,10,18,16,12690,12737,11703,-1034
2017,10,18,17,12630,12688,11834,-854
2017,10,18,18,12770,12810,11982,-828
2017,10,18,19,12890,12951,12140,-811
2017,10,18,20,13080,13229,12261,-968
2017,10,18,21,13580,13737,12622,-1115
2017,10,18,22,14170,14325,13058,-1267
2017,10,18,23,14950,14965,13848,-1117
2017,10,19,0,14660,14706,13227,-1479
2017,10,19,1,13990,14093,12639,-1454
2017,10,19,2,13050,13078,11878,-1200
2017,10,19,3,11730,11808,10661,-1147
2017,10,19,4,10590,10688,9526,-1162
2017,10,19,5,9900,10214,9116,-1098
2017,10,19,6,9470,9837,8656,-1181
2017,10,19,7,9260,9869,8386,-1483
2017,10,19,8,9350,9866,7934,-1932
2017,10,19,9,9680,10149,7918,-2231
2017,10,19,10,10630,10862,8671,-2191
2017,10,19,11,12430,12450,10521,-1929
2017,10,19,12,13360,13407,11454,-1953
2017,10,19,13,13260,13383,11489,-1894
2017,10,19,14,13040,13120,11207,-1913
2017,10,19,15,12940,12998,11253,-1745
2017,10,19,16,12860,12893,11258,-1635
2017,10,19,17,12770,12812,11255,-1557
2017,10,19,18,12910,12966,11349,-1617
2017,10,19,19,13030,13072,11319,-1753
2017,10,19,20,13260,13303,11536,-1767
2017,10,19,21,13680,13755,11892,-1863
2017,10,19,22,14280,14268,12182,-2086
2017,10,19,23,14800,14938,12792,-2146
2017,10,20,0,14570,14792,12707,-2085
2017,10,20,1,13960,14148,12229,-1919
2017,10,20,2,13040,13169,11441,-1728
2017,10,20,3,11770,11884,9802,-2082
2017,10,20,4,10640,11032,8664,-2368
2017,10,20,5,10000,10451,8280,-2171
2017,10,20,6,9530,10125,8412,-1713
2017,10,20,7,9280,9902,7992,-1910
2017,10,20,8,9230,9848,7942,-1906
2017,10,20,9,9570,10076,8088,-1988
2017,10,20,10,10480,10847,8654,-2193
2017,10,20,11,12190,12154,10085,-2069
2017,10,20,12,13100,13098,10642,-2456
2017,10,20,13,13060,13143,10852,-2291
2017,10,20,14,12820,12944,11006,-1938
2017,10,20,15,12650,12784,10911,-1873
2017,10,20,16,12530,12679,11040,-1639
2017,10,20,17,12420,12579,10842,-1737
2017,10,20,18,12470,12681,11081,-1600
2017,10,20,19,12560,12810,11194,-1616
2017,10,20,20,12610,13021,11326,-1695
2017,10,20,21,13110,13449,11449,-2000
2017,10,20,22,13650,13903,11537,-2366
2017,10,20,23,14050,14343,11899,-2444
2017,10,21,0,13750,14056,11656,-2400
2017,10,21,1,13190,13469,11238,-2231
2017,10,21,2,12490,12717,10761,-1956
2017,10,21,3,11460,11720,9821,-1899
2017,10,21,4,10440,10855,8830,-2025
2017,10,21,5,9900,10178,7840,-2338
2017,10,21,6,9420,9710,7362,-2348
2017,10,21,7,9140,9454,7062,-2392
2017,10,21,8,9100,9444,6985,-2459
2017,10,21,9,9160,9612,7248,-2364
2017,10,21,10,9520,9797,7361,-2436
2017,10,21,11,10200,10344,7913,-2431
2017,10,21,12,10980,10999,8468,-2531
2017,10,21,13,11460,11530,8874,-2656
2017,10,21,14,11360,11614,9140,-2474
2017,10,21,15,11330,11529,9307,-2222
2017,10,21,16,11070,11420,9378,-2042
2017,10,21,17,11020,11322,9189,-2133
2017,10,21,18,10910,11314,9182,-2132
2017,10,21,19,11040,11471,9452,-2019
2017,10,21,20,11280,11855,10024,-1831
2017,10,21,21,11900,12401,10214,-2187
2017,10,21,22,12660,12915,10321,-2594
2017,10,21,23,13360,13541,11125,-2416
2017,10,22,0,13120,13253,10993,-2260
2017,10,22,1,12580,12742,10085,-2657
2017,10,22,2,12020,12077,9765,-2312
2017,10,22,3,11150,11251,9039,-2212
2017,10,22,4,10240,10616,8007,-2609
2017,10,22,5,9630,10062,7353,-2709
2017,10,22,6,9170,9755,7148,-2607
2017,10,22,7,8930,9525,7170,-2355
2017,10,22,8,8820,9403,6974,-2429
2017,10,22,9,8830,9412,6995,-2417
2017,10,22,10,9060,9620,6994,-2626
2017,10,22,11,9600,9863,7431,-2432
2017,10,22,12,10190,10400,8002,-2398
2017,10,22,13,10790,10755,8274,-2481
2017,10,22,14,11010,11023,8773,-2250
2017,10,22,15,11180,11080,8850,-2230
2017,10,22,16,11130,11096,8730,-2366
2017,10,22,17,11170,11228,8989,-2239
2017,10,22,18,11250,11432,9120,-2312
2017,10,22,19,11410,11683,9147,-2536
2017,10,22,20,11690,12016,9360,-2656
2017,10,22,21,12300,12570,9922,-2648
2017,10,22,22,13110,13312,10567,-2745
2017,10,22,23,13890,14108,11687,-2421
2017,10,23,0,13770,13893,11544,-2349
2017,10,23,1,13140,13234,10803,-2431
2017,10,23,2,12270,12303,9794,-2509
2017,10,23,3,11210,11308,8621,-2687
2017,10,23,4,10260,10329,7505,-2824
2017,10,23,5,9500,9865,7162,-2703
2017,10,23,6,9120,9541,6845,-2696
2017,10,23,7,8940,9401,6781,-2620
2017,10,23,8,8970,9628,7001,-2627
2017,10,23,9,9310,9934,7263,-2671
2017,10,23,10,10500,10832,8301,-2531
2017,10,23,11,12420,12151,9846,-2305
2017,10,23,12,13490,13228,10962,-2266
2017,10,23,13,13600,13472,11193,-2279
2017,10,23,14,13590,13541,11235,-2306
2017,10,23,15,13540,13619,11200,-2419
2017,10,23,16,13480,13577,11155,-2422
2017,10,23,17,13460,13507,10908,-2599
2017,10,23,18,13690,13628,10989,-2639
2017,10,23,19,13780,13800,11222,-2578
2017,10,23,20,13930,13986,11383,-2603
2017,10,23,21,14200,14307,11745,-2562
2017,10,23,22,14820,14891,12456,-2435
2017,10,23,23,15530,15542,13223,-2319
2017,10,24,0,15180,15200,12844,-2356
2017,10,24,1,14510,14446,11695,-2751
2017,10,24,2,13390,13428,10907,-2521
2017,10,24,3,12080,12204,9501,-2703
2017,10,24,4,10990,11624,8652,-2972
2017,10,24,5,10350,10921,8039,-2882
2017,10,24,6,9920,10489,7873,-2616
2017,10,24,7,9670,10251,7892,-2359
2017,10,24,8,9660,10222,7891,-2331
2017,10,24,9,9950,10518,8242,-2276
2017,10,24,10,10970,11495,8961,-2534
2017,10,24,11,12830,13240,10653,-2587
2017,10,24,12,13960,14071,11673,-2398
2017,10,24,13,14260,14437,12037,-2400
2017,10,24,14,14480,14691,12251,-2440
2017,10,24,15,14580,14928,12630,-2298
2017,10,24,16,14750,15018,12834,-2184
2017,10,24,17,14700,15064,12945,-2119
2017,10,24,18,14730,15190,12977,-2213
2017,10,24,19,14680,15160,12742,-2418
2017,10,24,20,14770,15187,12681,-2506
2017,10,24,21,15040,15405,12785,-2620
2017,10,24,22,15520,15867,13182,-2685
2017,10,24,23,15960,16262,14003,-2259
2017,10,25,0,15720,15876,13747,-2129
2017,10,25,1,15040,15190,12622,-2568
2017,10,25,2,13970,14173,11879,-2294
2017,10,25,3,12670,12887,10403,-2484
2017,10,25,4,11530,12048,9521,-2527
2017,10,25,5,10940,11490,8679,-2811
2017,10,25,6,10520,11058,8123,-2935
2017,10,25,7,10280,10811,7869,-2942
2017,10,25,8,10140,10700,7776,-2924
2017,10,25,9,10320,10879,7995,-2884
2017,10,25,10,11280,11776,9009,-2767
2017,10,25,11,13160,13087,10675,-2412
2017,10,25,12,14310,14301,11644,-2657
2017,10,25,13,14630,14683,11882,-2801
2017,10,25,14,14920,14907,12004,-2903
2017,10,25,15,15050,15134,12150,-2984
2017,10,25,16,15060,15223,12301,-2922
2017,10,25,17,14980,15102,12148,-2954
2017,10,25,18,15040,14931,11967,-2964
2017,10,25,19,15020,14774,11836,-2938
2017,10,25,20,15050,14647,11981,-2666
2017,10,25,21,15240,14848,12190,-2658
2017,10,25,22,15600,15319,12649,-2670
2017,10,25,23,16000,15568,12717,-2851
2017,10,26,0,15710,15128,12486,-2642
2017,10,26,1,14710,14389,11537,-2852
2017,10,26,2,13570,13393,10977,-2416
2017,10,26,3,12310,12341,9837,-2504
2017,10,26,4,11120,11297,8609,-2688
2017,10,26,5,10230,10702,7790,-2912
2017,10,26,6,9760,10333,7400,-2933
2017,10,26,7,9550,10084,7545,-2539
2017,10,26,8,9430,10023,7623,-2400
2017,10,26,9,9650,10259,7865,-2394
2017,10,26,10,10620,11152,8484,-2668
2017,10,26,11,12460,12579,10266,-2313
2017,10,26,12,13610,13619,11370,-2249
2017,10,26,13,13860,13998,11540,-2458
2017,10,26,14,14200,14219,11760,-2459
2017,10,26,15,14290,14280,11779,-2501
2017,10,26,16,14300,14320,11690,-2630
2017,10,26,17,14260,14137,11448,-2689
2017,10,26,18,14280,14025,11334,-2691
2017,10,26,19,14230,13866,11349,-2517
2017,10,26,20,14250,13794,11311,-2483
2017,10,26,21,14500,13946,11377,-2569
2017,10,26,22,14920,14461,11879,-2582
2017,10,26,23,15500,14874,12301,-2573
2017,10,27,0,14950,14528,11939,-2589
2017,10,27,1,14200,13920,11350,-2570
2017,10,27,2,13180,12969,10582,-2387
2017,10,27,3,11960,12134,9394,-2740
2017,10,27,4,10850,11180,8607,-2573
2017,10,27,5,9900,10440,7455,-2985
2017,10,27,6,9490,10032,7257,-2775
2017,10,27,7,9300,9825,7305,-2520
2017,10,27,8,9270,9798,7259,-2539
2017,10,27,9,9510,10057,7525,-2532
2017,10,27,10,10490,10728,8259,-2469
2017,10,27,11,12290,12296,10134,-2162
2017,10,27,12,13280,13360,10939,-2421
2017,10,27,13,13260,13340,11030,-2310
2017,10,27,14,13020,12985,10780,-2205
2017,10,27,15,12770,12663,10502,-2161
2017,10,27,16,12570,12423,10172,-2251
2017,10,27,17,12350,12227,9935,-2292
2017,10,27,18,12360,12243,9845,-2398
2017,10,27,19,12350,12300,9799,-2501
2017,10,27,20,12470,12523,10017,-2506
2017,10,27,21,13000,13044,10326,-2718
2017,10,27,22,13680,13557,10842,-2715
2017,10,27,23,14400,14145,11303,-2842
2017,10,28,0,14040,13852,10986,-2866
2017,10,28,1,13360,13353,10806,-2547
2017,10,28,2,12610,12627,9988,-2639
2017,10,28,3,11640,11664,8783,-2881
2017,10,28,4,10640,10725,8078,-2647
2017,10,28,5,9900,10214,7319,-2895
2017,10,28,6,9450,9715,6898,-2817
2017,10,28,7,9230,9508,6758,-2750
2017,10,28,8,9130,9404,6882,-2522
2017,10,28,9,9230,9504,6989,-2515
2017,10,28,10,9570,9868,7265,-2603
2017,10,28,11,10310,10387,7779,-2608
2017,10,28,12,11020,11161,8506,-2655
2017,10,28,13,11590,11698,9014,-2684
2017,10,28,14,11680,11745,9237,-2508
2017,10,28,15,11660,11654,9214,-2440
2017,10,28,16,11540,11531,9231,-2300
2017,10,28,17,11390,11352,9048,-2304
2017,10,28,18,11280,11235,9124,-2111
2017,10,28,19,11310,11261,9104,-2157
2017,10,28,20,11530,11587,9265,-2322
2017,10,28,21,12040,12135,9801,-2334
2017,10,28,22,12830,12814,10442,-2372
2017,10,28,23,13500,13480,10690,-2790
2017,10,29,0,13240,13154,10503,-2651
2017,10,29,1,12650,12676,10498,-2178
2017,10,29,2,11960,12034,9486,-2548
2017,10,29,3,11140,11210,8600,-2610
2017,10,29,4,10300,10583,7930,-2653
2017,10,29,5,9760,9975,7238,-2737
2017,10,29,6,9320,9558,6937,-2621
2017,10,29,7,9040,9317,6647,-2670
2017,10,29,8,8870,9437,6719,-2718
2017,10,29,9,8880,9459,6810,-2649
2017,10,29,10,9160,9670,6899,-2771
2017,10,29,11,9740,9912,7001,-2911
2017,10,29,12,10350,10528,7708,-2820
2017,10,29,13,11150,11383,8747,-2636
2017,10,29,14,11720,11888,9596,-2292
2017,10,29,15,12040,12353,10315,-2038
2017,10,29,16,12230,12735,10292,-2443
2017,10,29,17,12310,12994,10346,-2648
2017,10,29,18,12320,13032,10203,-2829
2017,10,29,19,12380,13000,10131,-2869
2017,10,29,20,12600,13019,10270,-2749
2017,10,29,21,13140,13443,10718,-2725
2017,10,29,22,13940,14093,11307,-2786
2017,10,29,23,14500,14362,11496,-2866
2017,10,30,0,14170,13930,11423,-2507
2017,10,30,1,13310,13307,10911,-2396
2017,10,30,2,12290,12393,10023,-2370
2017,10,30,3,11310,11363,8836,-2527
2017,10,30,4,10390,10542,7719,-2823
2017,10,30,5,9410,9700,6877,-2823
2017,10,30,6,8810,9241,6620,-2621
2017,10,30,7,8480,9029,6422,-2607
2017,10,30,8,8840,9016,6261,-2755
2017,10,30,9,8590,9379,6551,-2828
2017,10,30,10,9480,9881,7114,-2767
2017,10,30,11,11300,10560,8285,-2275
2017,10,30,12,12330,11973,9468,-2505
2017,10,30,13,12650,11823,9561,-2262
2017,10,30,14,12820,11893,9686,-2207
2017,10,30,15,12940,12109,9889,-2220
2017,10,30,16,12940,12154,9915,-2239
2017,10,30,17,12930,11870,9580,-2290
2017,10,30,18,12740,11806,9508,-2298
2017,10,30,19,12740,11685,9304,-2381
2017,10,30,20,12850,11706,9242,-2464
2017,10,30,21,13270,12126,9595,-2531
2017,10,30,22,13990,12842,10119,-2723
2017,10,30,23,14580,13587,10566,-3021
2017,10,31,0,14320,13425,10807,-2618
2017,10,31,1,13700,12910,10441,-2469
2017,10,31,2,12750,12087,9638,-2449
2017,10,31,3,11540,11029,8433,-2596
2017,10,31,4,10410,10306,7557,-2749
2017,10,31,5,9240,9765,7213,-2552
2017,10,31,6,8980,9543,7213,-2330
2017,10,31,7,8910,9085,6938,-2147
2017,10,31,8,8980,9324,6917,-2407
2017,10,31,9,9270,9588,7084,-2504
2017,10,31,10,10400,9994,7554,-2440
2017,10,31,11,12280,11631,9217,-2414
2017,10,31,12,13300,12725,10414,-2311
2017,10,31,13,13220,12752,10342,-2410
2017,10,31,14,12930,12554,10101,-2453
2017,10,31,15,12680,12526,10236,-2290
2017,10,31,16,12490,12333,10203,-2130
2017,10,31,17,12390,12101,9655,-2446
2017,10,31,18,12420,12173,9877,-2296
2017,10,31,19,12510,12166,9954,-2212
2017,10,31,20,12810,12413,10185,-2228
2017,10,31,21,13440,12946,10657,-2289
2017,10,31,22,14190,13447,11243,-2204
2017,10,31,23,15030,13811,11922,-1889
2017,11,1,0,14880,13540,11810,-1730
2017,11,1,1,14240,13259,11620,-1639
2017,11,1,2,13230,12632,10776,-1856
2017,11,1,3,11960,11582,9461,-2121
2017,11,1,4,10870,10595,8053,-2542
2017,11,1,5,9980,10173,7805,-2368
2017,11,1,6,9740,10242,7712,-2530
2017,11,1,7,9580,10444,8098,-2346
2017,11,1,8,9600,10293,7960,-2333
2017,11,1,9,9790,10230,7999,-2231
2017,11,1,10,10840,10917,8792,-2125
2017,11,1,11,12880,12438,10774,-1664
2017,11,1,12,13870,13589,11679,-1910
2017,11,1,13,13930,13738,12022,-1716
2017,11,1,14,13690,13715,12070,-1645
2017,11,1,15,13490,13762,12293,-1469
2017,11,1,16,13270,13857,12418,-1439
2017,11,1,17,13200,13731,12375,-1356
2017,11,1,18,13270,13657,12146,-1511
2017,11,1,19,13350,13535,12249,-1286
2017,11,1,20,13540,13634,12175,-1459
2017,11,1,21,14150,14017,12479,-1538
2017,11,1,22,15020,14763,12972,-1791
2017,11,1,23,15350,15271,13580,-1691
2017,11,2,0,14850,14944,13332,-1612
2017,11,2,1,14290,14312,12567,-1745
2017,11,2,2,13250,13312,11311,-2001
2017,11,2,3,11970,12199,10313,-1886
2017,11,2,4,10880,11210,9174,-2036
2017,11,2,5,10020,10770,8847,-1923
2017,11,2,6,9600,10499,8769,-1730
2017,11,2,7,9390,10249,8403,-1846
2017,11,2,8,9350,10320,8402,-1918
2017,11,2,9,9670,10846,8994,-1852
2017,11,2,10,10680,11649,9890,-1759
2017,11,2,11,12410,13036,11507,-1529
2017,11,2,12,13480,13672,12382,-1290
2017,11,2,13,13610,13766,12545,-1221
2017,11,2,14,13840,13820,12439,-1381
2017,11,2,15,13880,13951,12835,-1116
2017,11,2,16,13870,13975,12809,-1166
2017,11,2,17,13780,13855,12796,-1059
2017,11,2,18,13880,13680,12463,-1217
2017,11,2,19,13960,13700,12576,-1124
2017,11,2,20,14100,13786,12836,-950
2017,11,2,21,14700,14009,12946,-1063
2017,11,2,22,15390,14621,13304,-1317
2017,11,2,23,15480,15202,14040,-1162
2017,11,3,0,15040,14858,13727,-1131
2017,11,3,1,14250,14162,13082,-1080
2017,11,3,2,13180,13166,11948,-1218
2017,11,3,3,11890,11904,10397,-1507
2017,11,3,4,10830,11057,9686,-1371
2017,11,3,5,10060,10576,9437,-1139
2017,11,3,6,9580,10428,9164,-1264
2017,11,3,7,9340,10417,8997,-1420
2017,11,3,8,9270,10353,8726,-1627
2017,11,3,9,9510,10580,8725,-1855
2017,11,3,10,10390,11127,9489,-1638
2017,11,3,11,12140,12416,11092,-1324
2017,11,3,12,13320,13343,12289,-1054
2017,11,3,13,13590,13569,12477,-1092
2017,11,3,14,13730,13584,12541,-1043
2017,11,3,15,13800,13521,12398,-1123
2017,11,3,16,13760,13567,12391,-1176
2017,11,3,17,13730,13578,12368,-1210
2017,11,3,18,13770,13765,12495,-1270
2017,11,3,19,13870,13935,12560,-1375
2017,11,3,20,13990,13971,12824,-1147
2017,11,3,21,14190,14366,13207,-1159
2017,11,3,22,14630,14637,13362,-1275
2017,11,3,23,14980,14729,13273,-1456
2017,11,4,0,14440,14168,12969,-1199
2017,11,4,1,13490,13476,12618,-858
2017,11,4,2,12600,12629,11689,-940
2017,11,4,3,11570,11768,10909,-859
2017,11,4,4,10560,11131,10168,-963
2017,11,4,5,9810,10374,9400,-974
2017,11,4,6,9360,9912,9045,-867
2017,11,4,7,9110,9545,8810,-735
2017,11,4,8,9020,9533,8764,-769
2017,11,4,9,9150,9654,8691,-963
2017,11,4,10,9550,10025,9025,-1000
2017,11,4,11,10440,10562,9618,-944
2017,11,4,12,11290,11128,10266,-862
2017,11,4,13,11950,11759,10874,-885
2017,11,4,14,12220,11821,10756,-1065
2017,11,4,15,12200,11617,10603,-1014
2017,11,4,16,12000,11389,10496,-893
2017,11,4,17,11850,11180,10309,-871
2017,11,4,18,11760,11159,10241,-918
2017,11,4,19,11830,11259,10339,-920
2017,11,4,20,12180,11534,10577,-957
2017,11,4,21,13040,12099,11158,-941
2017,11,4,22,14040,13009,12035,-974
2017,11,4,23,14110,13593,12541,-1052
2017,11,5,0,13530,13246,12215,-1031
2017,11,5,1,12920,12806,12140,-666
2017,11,5,2,12190,12212,11263,-949
2017,11,5,3,11370,11398,10172,-1226
2017,11,5,4,10580,10571,9211,-1360
2017,11,5,5,9840,9870,8368,-1502
2017,11,5,6,9390,9780,8151,-1629
2017,11,5,7,9390,9846,8269,-1577
2017,11,5,8,9020,9806,8319,-1487
2017,11,5,9,9010,9788,8705,-1083
2017,11,5,10,9170,9914,8724,-1190
2017,11,5,11,9540,10177,8983,-1194
2017,11,5,12,10070,10635,9577,-1058
2017,11,5,13,10690,11113,10065,-1048
2017,11,5,14,11250,11639,10958,-681
2017,11,5,15,11640,12069,11178,-891
2017,11,5,16,11870,12304,11347,-957
2017,11,5,17,12050,12508,11618,-890
2017,11,5,18,12260,12636,11550,-1086
2017,11,5,19,12380,12726,11662,-1064
2017,11,5,20,12550,12792,11576,-1216
2017,11,5,21,12980,13037,11883,-1154
2017,11,5,22,13930,13819,12582,-1237
2017,11,5,23,14770,14548,13408,-1140
2017,11,6,0,14520,14264,12980,-1284
2017,11,6,1,13970,13715,12528,-1187
2017,11,6,2,13280,12983,11960,-1023
2017,11,6,3,12220,12034,10909,-1125
2017,11,6,4,11160,10991,9723,-1268
2017,11,6,5,10310,10244,8992,-1252
2017,11,6,6,9590,10176,9172,-1004
2017,11,6,7,9320,10129,9148,-981
2017,11,6,8,9190,10333,9262,-1071
2017,11,6,9,9230,10300,9348,-952
2017,11,6,10,9550,10575,9284,-1291
2017,11,6,11,10700,11308,10066,-1242
2017,11,6,12,12430,12569,11368,-1201
2017,11,6,13,13460,13461,12357,-1104
2017,11,6,14,13740,13859,12698,-1161
2017,11,6,15,13920,14102,12943,-1159
2017,11,6,16,14150,14251,13087,-1164
2017,11,6,17,14180,14279,12900,-1379
2017,11,6,18,14020,14319,12893,-1426
2017,11,6,19,14090,14399,12861,-1538
2017,11,6,20,14140,14301,12830,-1471
2017,11,6,21,14390,14334,12909,-1425
2017,11,6,22,14990,15000,13406,-1594
2017,11,6,23,15720,15650,14115,-1535
2017,11,7,0,15580,15277,13727,-1550
2017,11,7,1,15010,14624,13243,-1381
2017,11,7,2,13990,13841,12800,-1041
2017,11,7,3,12900,12795,11707,-1088
2017,11,7,4,11730,11902,10833,-1069
2017,11,7,5,10720,11540,9897,-1643
2017,11,7,6,9890,10962,9035,-1927
2017,11,7,7,9560,10851,8771,-2080
2017,11,7,8,9400,10699,8682,-2017
2017,11,7,9,9470,10707,8833,-1874
2017,11,7,10,9860,10820,9093,-1727
2017,11,7,11,11020,11654,10137,-1517
2017,11,7,12,12970,12774,11284,-1490
2017,11,7,13,13810,13276,11429,-1847
2017,11,7,14,13630,13176,11506,-1670
2017,11,7,15,13330,13033,11757,-1276
2017,11,7,16,13070,13063,11956,-1107
2017,11,7,17,12950,13388,11988,-1400
2017,11,7,18,12920,13729,12374,-1355
2017,11,7,19,13100,13962,12401,-1561
2017,11,7,20,13350,14022,12420,-1602
2017,11,7,21,13760,14238,12443,-1795
2017,11,7,22,14820,15068,12923,-2145
2017,11,7,23,15950,15797,13615,-2182
2017,11,8,0,15830,15629,13363,-2266
2017,11,8,1,15310,15160,12916,-2244
2017,11,8,2,14580,14443,12371,-2072
2017,11,8,3,13550,13437,11463,-1974
2017,11,8,4,12270,12368,10593,-1775
2017,11,8,5,11230,11931,9968,-1963
2017,11,8,6,10500,11059,8992,-2067
2017,11,8,7,10150,10976,8822,-2154
2017,11,8,8,10000,11047,8918,-2129
2017,11,8,9,10060,11006,9252,-1754
2017,11,8,10,10470,11206,9518,-1688
2017,11,8,11,11650,11785,10390,-1395
2017,11,8,12,13470,13354,11895,-1459
2017,11,8,13,14250,14180,12267,-1913
2017,11,8,14,14130,14191,11927,-2264
2017,11,8,15,13700,13871,11686,-2185
2017,11,8,16,13340,13540,11373,-2167
2017,11,8,17,13080,13262,11136,-2126
2017,11,8,18,13000,13035,10985,-2050
2017,11,8,19,12960,13120,11151,-1969
2017,11,8,20,13190,13329,11429,-1900
2017,11,8,21,13680,13862,11812,-2050
2017,11,8,22,14770,14896,12447,-2449
2017,11,8,23,15900,15980,13452,-2528
2017,11,9,0,15890,15896,13099,-2797
2017,11,9,1,15450,15515,12625,-2890
2017,11,9,2,14820,14902,12322,-2580
2017,11,9,3,13820,13956,11583,-2373
2017,11,9,4,12600,12729,10495,-2234
2017,11,9,5,11560,11687,9717,-1970
2017,11,9,6,11030,11193,9358,-1835
2017,11,9,7,10730,11711,9603,-2108
2017,11,9,8,10580,11837,9554,-2283
2017,11,9,9,10650,11955,9735,-2220
2017,11,9,10,11040,12143,9844,-2299
2017,11,9,11,12150,12811,10793,-2018
2017,11,9,12,13970,13961,11782,-2179
2017,11,9,13,14530,14574,12086,-2488
2017,11,9,14,14200,14127,11612,-2515
2017,11,9,15,13740,13506,11329,-2177
2017,11,9,16,13390,13395,11442,-1953
2017,11,9,17,13080,13363,11446,-1917
2017,11,9,18,12920,13572,11540,-2032
2017,11,9,19,13020,13796,11551,-2245
2017,11,9,20,13320,13775,11511,-2264
2017,11,9,21,13820,13954,11757,-2197
2017,11,9,22,15010,14801,12634,-2167
2017,11,9,23,16000,15736,13804,-1932
2017,11,10,0,15690,15572,13036,-2536
2017,11,10,1,15150,15106,12571,-2535
2017,11,10,2,14460,14473,12050,-2423
2017,11,10,3,13460,13631,11243,-2388
2017,11,10,4,12260,12702,10060,-2642
2017,11,10,5,11200,11846,9371,-2475
2017,11,10,6,10540,11585,9010,-2575
2017,11,10,7,10120,11432,8788,-2644
2017,11,10,8,9910,11234,8343,-2891
2017,11,10,9,9880,10966,8304,-2662
2017,11,10,10,10200,11090,8319,-2771
2017,11,10,11,11350,11198,8681,-2517
2017,11,10,12,13170,12557,9992,-2565
2017,11,10,13,14450,13454,10536,-2918
2017,11,10,14,14310,13634,11043,-2591
2017,11,10,15,14030,13510,10917,-2593
2017,11,10,16,13700,13408,10510,-2898
2017,11,10,17,13390,13330,10497,-2833
2017,11,10,18,13350,13279,10311,-2968
2017,11,10,19,13690,13490,10314,-3176
2017,11,10,20,14050,14157,11025,-3132
2017,11,10,21,14650,14691,11484,-3207
2017,11,10,22,15770,15770,12517,-3253
2017,11,10,23,17000,16671,13309,-3362
2017,11,11,0,16940,16508,13139,-3369
2017,11,11,1,16540,16118,12729,-3389
2017,11,11,2,15960,15591,12245,-3346
2017,11,11,3,15160,14839,11481,-3358
2017,11,11,4,14140,13897,10611,-3286
2017,11,11,5,13210,13386,10078,-3308
2017,11,11,6,12290,12605,9258,-3347
2017,11,11,7,11910,11928,8694,-3234
2017,11,11,8,11680,11701,8592,-3109
2017,11,11,9,11630,11648,8411,-3237
2017,11,11,10,11790,11969,8653,-3316
2017,11,11,11,12270,12295,9025,-3270
2017,11,11,12,12960,12970,9606,-3364
2017,11,11,13,13550,13559,10189,-3370
2017,11,11,14,13740,13756,10271,-3485
2017,11,11,15,13650,13617,9959,-3658
2017,11,11,16,13350,13596,9749,-3847
2017,11,11,17,13120,13348,9471,-3877
2017,11,11,18,12760,13117,9303,-3814
2017,11,11,19,12570,13252,9342,-3910
2017,11,11,20,12590,13409,9481,-3928
2017,11,11,21,13230,13733,10085,-3648
2017,11,11,22,14520,14877,11306,-3571
2017,11,11,23,15800,15830,12468,-3362
2017,11,12,0,15650,15639,12135,-3504
2017,11,12,1,15110,15232,11594,-3638
2017,11,12,2,14500,14767,10754,-4013
2017,11,12,3,13810,14135,10408,-3727
2017,11,12,4,13050,13307,9832,-3475
2017,11,12,5,12300,12704,9137,-3567
2017,11,12,6,11820,12090,8617,-3473
2017,11,12,7,11450,11819,8312,-3507
2017,11,12,8,11230,11788,8213,-3575
2017,11,12,9,11160,11695,8205,-3490
2017,11,12,10,11270,11550,8059,-3491
2017,11,12,11,11580,11845,8418,-3427
2017,11,12,12,12100,12316,8993,-3323
2017,11,12,13,12690,12685,9382,-3303
2017,11,12,14,13290,13282,9926,-3356
2017,11,12,15,13330,13273,9918,-3355
2017,11,12,16,13320,12953,9589,-3364
2017,11,12,17,13320,12706,9329,-3377
2017,11,12,18,13260,12639,9050,-3589
2017,11,12,19,13190,12845,9398,-3447
2017,11,12,20,13240,13524,9922,-3602
2017,11,12,21,13610,13633,10183,-3450
2017,11,12,22,14700,14622,11166,-3456
2017,11,12,23,16040,15698,12036,-3662
2017,11,13,0,16010,15609,11919,-3690
2017,11,13,1,15660,15191,11554,-3637
2017,11,13,2,14980,14597,10967,-3630
2017,11,13,3,14000,13704,10167,-3537
2017,11,13,4,12900,12707,9209,-3498
2017,11,13,5,11900,12022,8496,-3526
2017,11,13,6,11280,11553,8299,-3254
2017,11,13,7,10930,11636,8347,-3289
2017,11,13,8,10760,11719,8480,-3239
2017,11,13,9,10780,11777,8512,-3265
2017,11,13,10,11140,11889,8760,-3129
2017,11,13,11,12250,12434,9438,-2996
2017,11,13,12,14090,13938,10892,-3046
2017,11,13,13,15090,14904,11854,-3050
2017,11,13,14,15060,15143,12003,-3140
2017,11,13,15,14900,15273,12154,-3119
2017,11,13,16,14790,15424,12140,-3284
2017,11,13,17,14660,15511,12060,-3451
2017,11,13,18,14560,15509,11992,-3517
2017,11,13,19,14600,15484,12007,-3477
2017,11,13,20,14600,15361,11875,-3486
2017,11,13,21,14920,15540,12103,-3437
2017,11,13,22,15850,16264,12988,-3276
2017,11,13,23,16880,16926,13653,-3273
2017,11,14,0,16780,16740,13381,-3359
2017,11,14,1,16390,16252,12899,-3353
2017,11,14,2,15630,15526,12108,-3418
2017,11,14,3,14530,14419,10886,-3533
2017,11,14,4,13280,13101,9562,-3539
2017,11,14,5,12200,12228,8680,-3548
2017,11,14,6,11280,12217,8719,-3498
2017,11,14,7,10890,12225,8737,-3488
2017,11,14,8,10710,12028,8569,-3459
2017,11,14,9,10720,12017,8524,-3493
2017,11,14,10,11070,12356,8811,-3545
2017,11,14,11,12170,12913,9571,-3342
2017,11,14,12,13930,14023,10680,-3343
2017,11,14,13,15090,14816,11456,-3360
2017,11,14,14,15130,15000,11597,-3403
2017,11,14,15,15020,15007,11613,-3394
2017,11,14,16,14860,15028,11612,-3416
2017,11,14,17,14650,15036,11654,-3382
2017,11,14,18,14390,14964,11516,-3448
2017,11,14,19,14380,14976,11365,-3611
2017,11,14,20,14640,14962,11448,-3514
2017,11,14,21,14950,15153,11744,-3409
2017,11,14,22,15890,16014,12479,-3535
2017,11,14,23,16830,16652,13220,-3432
2017,11,15,0,16650,16495,13030,-3465
2017,11,15,1,16170,16051,12503,-3548
2017,11,15,2,15370,15363,11757,-3606
2017,11,15,3,14260,14325,10775,-3550
2017,11,15,4,13010,13088,9524,-3564
2017,11,15,5,11940,12396,8881,-3515
2017,11,15,6,11300,11773,8699,-3074
2017,11,15,7,10970,11687,8507,-3180
2017,11,15,8,10790,11563,8301,-3262
2017,11,15,9,10800,11846,8531,-3315
2017,11,15,10,11200,11953,8704,-3249
2017,11,15,11,12300,12575,9543,-3032
2017,11,15,12,14160,14102,11102,-3000
2017,11,15,13,14960,14841,11840,-3001
2017,11,15,14,14480,14422,11321,-3101
2017,11,15,15,14040,13843,11015,-2828
2017,11,15,16,13620,13534,11048,-2486
2017,11,15,17,13330,13442,11029,-2413
2017,11,15,18,13200,13439,10991,-2448
2017,11,15,19,13360,13778,11310,-2468
2017,11,15,20,13630,13962,11489,-2473
2017,11,15,21,14190,14374,11595,-2779
2017,11,15,22,15330,15462,12511,-2951
2017,11,15,23,16430,16414,13498,-2916
2017,11,16,0,16290,16326,13129,-3197
2017,11,16,1,15820,15906,12672,-3234
2017,11,16,2,15080,15305,12310,-2995
2017,11,16,3,14030,14422,11392,-3030
2017,11,16,4,12780,13430,10319,-3111
2017,11,16,5,11710,12719,9384,-3335
2017,11,16,6,11090,12288,9033,-3255
2017,11,16,7,10650,11878,8883,-2995
2017,11,16,8,10450,11828,8787,-3041
2017,11,16,9,10460,11865,8839,-3026
2017,11,16,10,10770,11914,9033,-2881
2017,11,16,11,11840,12795,9915,-2880
2017,11,16,12,13620,14132,11240,-2892
2017,11,16,13,14570,14629,11747,-2882
2017,11,16,14,14830,14887,12218,-2669
2017,11,16,15,14860,14916,12097,-2819
2017,11,16,16,14880,14888,11874,-3014
2017,11,16,17,14810,14881,11824,-3057
2017,11,16,18,14800,14833,11622,-3211
2017,11,16,19,14660,14793,11595,-3198
2017,11,16,20,14730,14723,11538,-3185
2017,11,16,21,14980,14845,11812,-3033
2017,11,16,22,15770,15540,12352,-3188
2017,11,16,23,16370,16169,13032,-3137
2017,11,17,0,16160,15968,12719,-3249
2017,11,17,1,15670,15519,12267,-3252
2017,11,17,2,15030,14906,11820,-3086
2017,11,17,3,14040,13956,10908,-3048
2017,11,17,4,12830,12761,9439,-3322
2017,11,17,5,11740,11922,8704,-3218
2017,11,17,6,10980,11786,8655,-3131
2017,11,17,7,10590,11688,8445,-3243
2017,11,17,8,10460,11700,8417,-3283
2017,11,17,9,10480,11817,8507,-3310
2017,11,17,10,10850,12163,8882,-3281
2017,11,17,11,11920,12606,9698,-2908
2017,11,17,12,13700,13703,10596,-3107
2017,11,17,13,14210,14609,11487,-3122
2017,11,17,14,14180,14699,11578,-3121
2017,11,17,15,14250,14297,11352,-2945
2017,11,17,16,13670,13885,10956,-2929
2017,11,17,17,13420,13595,10697,-2898
2017,11,17,18,13290,13362,10545,-2817
2017,11,17,19,13340,13444,10393,-3051
2017,11,17,20,13550,13760,10753,-3007
2017,11,17,21,14030,14362,11351,-3011
2017,11,17,22,15160,15391,12178,-3213
2017,11,17,23,16100,16206,13274,-2932
2017,11,18,0,15850,16018,12974,-3044
2017,11,18,1,15360,15579,12434,-3145
2017,11,18,2,14830,15081,12133,-2948
2017,11,18,3,14100,14336,11485,-2851
2017,11,18,4,13130,13348,10548,-2800
2017,11,18,5,12130,12396,9506,-2890
2017,11,18,6,11690,12086,9787,-2299
2017,11,18,7,11310,11878,9556,-2322
2017,11,18,8,11130,11693,9158,-2535
2017,11,18,9,11080,11637,9100,-2537
2017,11,18,10,11230,11782,9212,-2570
2017,11,18,11,11650,11951,9486,-2465
2017,11,18,12,12320,12746,10152,-2594
2017,11,18,13,12800,13190,10419,-2771
2017,11,18,14,13290,13570,10719,-2851
2017,11,18,15,13450,13806,11082,-2724
2017,11,18,16,13450,13916,11514,-2402
2017,11,18,17,13290,13873,11506,-2367
2017,11,18,18,13180,13805,11576,-2229
2017,11,18,19,13130,13828,11184,-2644
2017,11,18,20,13290,13775,11039,-2736
2017,11,18,21,13550,13969,11124,-2845
2017,11,18,22,14520,14774,11615,-3159
2017,11,18,23,15100,15187,12413,-2774
2017,11,19,0,14800,14854,11940,-2914
2017,11,19,1,14190,14290,11236,-3054
2017,11,19,2,13700,13745,10849,-2896
2017,11,19,3,12970,13020,10213,-2807
2017,11,19,4,12080,12169,9150,-3019
2017,11,19,5,11490,11728,8863,-2865
2017,11,19,6,10530,11369,8507,-2862
2017,11,19,7,10050,11144,8123,-3021
2017,11,19,8,9760,11043,8106,-2937
2017,11,19,9,9630,10954,8057,-2897
2017,11,19,10,9640,10964,7992,-2972
2017,11,19,11,9960,11226,8147,-3079
2017,11,19,12,10410,11745,8505,-3240
2017,11,19,13,11120,11985,8852,-3133
2017,11,19,14,11750,12609,9527,-3082
2017,11,19,15,12170,13044,9798,-3246
2017,11,19,16,12400,13001,9894,-3107
2017,11,19,17,12460,12856,9817,-3039
2017,11,19,18,12440,12551,9626,-2925
2017,11,19,19,12560,12365,9422,-2943
2017,11,19,20,12740,12651,9957,-2694
2017,11,19,21,13240,13274,10757,-2517
2017,11,19,22,14420,14514,12043,-2471
2017,11,19,23,15400,15423,12805,-2618
2017,11,20,0,15170,15251,12378,-2873
2017,11,20,1,14750,14860,12202,-2658
2017,11,20,2,14030,14347,11619,-2728
2017,11,20,3,13130,13488,10847,-2641
2017,11,20,4,12160,12722,9985,-2737
2017,11,20,5,11290,12036,9098,-2938
2017,11,20,6,10890,11493,8475,-3018
2017,11,20,7,10570,11381,8223,-3158
2017,11,20,8,10500,11296,8226,-3070
2017,11,20,9,10580,11381,8412,-2969
2017,11,20,10,11030,11811,8952,-2859
2017,11,20,11,12060,12531,9628,-2903
2017,11,20,12,14050,13986,11098,-2888
2017,11,20,13,14860,14833,12072,-2761
2017,11,20,14,14660,14665,11994,-2671
2017,11,20,15,14400,14331,11766,-2565
2017,11,20,16,14230,14285,11693,-2592
2017,11,20,17,14030,14316,11647,-2669
2017,11,20,18,14030,14245,11404,-2841
2017,11,20,19,14170,14323,11443,-2880
2017,11,20,20,14390,14535,11621,-2914
2017,11,20,21,14970,14991,12107,-2884
2017,11,20,22,16070,16042,13274,-2768
2017,11,20,23,17000,16782,14009,-2773
2017,11,21,0,16730,16644,13632,-3012
2017,11,21,1,16180,16241,13151,-3090
2017,11,21,2,15400,15577,12664,-2913
2017,11,21,3,14310,14538,11641,-2897
2017,11,21,4,13040,13243,10360,-2883
2017,11,21,5,11880,12122,9106,-3016
2017,11,21,6,11330,11587,8753,-2834
2017,11,21,7,10950,11325,8431,-2894
2017,11,21,8,10790,11532,8736,-2796
2017,11,21,9,10810,11395,8651,-2744
2017,11,21,10,11180,11456,8778,-2678
2017,11,21,11,12290,12250,9802,-2448
2017,11,21,12,14050,13999,11444,-2555
2017,11,21,13,14840,14760,12364,-2396
2017,11,21,14,14420,14451,12048,-2403
2017,11,21,15,13890,13807,11355,-2452
2017,11,21,16,13600,13388,10735,-2653
2017,11,21,17,13330,13164,10538,-2626
2017,11,21,18,13230,13277,10505,-2772
2017,11,21,19,13280,13286,10683,-2603
2017,11,21,20,13440,13746,11098,-2648
2017,11,21,21,13920,14000,11508,-2492
2017,11,21,22,15140,14966,12224,-2742
2017,11,21,23,16050,15823,13283,-2540
2017,11,22,0,15910,15686,13111,-2575
2017,11,22,1,15420,15275,12701,-2574
2017,11,22,2,14760,14654,12061,-2593
2017,11,22,3,13710,13733,11110,-2623
2017,11,22,4,12470,12662,9790,-2872
2017,11,22,5,11320,11850,8819,-3031
2017,11,22,6,10520,11673,8960,-2713
2017,11,22,7,10060,11288,8753,-2535
2017,11,22,8,9880,11057,8644,-2413
2017,11,22,9,9860,11033,8647,-2386
2017,11,22,10,10190,11305,8801,-2504
2017,11,22,11,11220,11620,9343,-2277
2017,11,22,12,13020,12930,10537,-2393
2017,11,22,13,13960,13905,11420,-2485
2017,11,22,14,14120,14577,12179,-2398
2017,11,22,15,15000,14952,12664,-2288
2017,11,22,16,15010,15238,12780,-2458
2017,11,22,17,14920,15340,12819,-2521
2017,11,22,18,14880,15215,12353,-2862
2017,11,22,19,14950,15156,12257,-2899
2017,11,22,20,14990,15027,12175,-2852
2017,11,22,21,14990,15018,12135,-2883
2017,11,22,22,15470,15573,12520,-3053
2017,11,22,23,16600,16068,13229,-2839
2017,11,23,0,16270,15787,13016,-2771
2017,11,23,1,15620,15310,12576,-2734
2017,11,23,2,15020,14757,12238,-2519
2017,11,23,3,14060,13963,11619,-2344
2017,11,23,4,12850,12919,10588,-2331
2017,11,23,5,11850,12113,9836,-2277
2017,11,23,6,11130,11523,9559,-1964
2017,11,23,7,10690,11390,9314,-2076
2017,11,23,8,10460,11696,9581,-2115
2017,11,23,9,10430,11647,9673,-1974
2017,11,23,10,10610,11639,9830,-1809
2017,11,23,11,11120,11815,9896,-1919
2017,11,23,12,11860,11928,9813,-2115
2017,11,23,13,12590,12595,10311,-2284
2017,11,23,14,13110,13105,10876,-2229
2017,11,23,15,13450,13324,11149,-2175
2017,11,23,16,13520,13368,11485,-1883
2017,11,23,17,13510,13334,11431,-1903
2017,11,23,18,13090,13037,11162,-1875
2017,11,23,19,12360,12565,10725,-1840
2017,11,23,20,11890,12299,10350,-1949
2017,11,23,21,11880,12386,10220,-2166
2017,11,23,22,12560,12906,10674,-2232
2017,11,23,23,13150,13225,10931,-2294
2017,11,24,0,13110,13165,10687,-2478
2017,11,24,1,13090,13122,10627,-2495
2017,11,24,2,12900,13024,10601,-2423
2017,11,24,3,12590,12705,10422,-2283
2017,11,24,4,11970,12115,9881,-2234
2017,11,24,5,11280,11598,9600,-1998
2017,11,24,6,10850,11214,9200,-2014
2017,11,24,7,10560,10691,8704,-1987
2017,11,24,8,10480,10722,8686,-2036
2017,11,24,9,10480,10814,8860,-1954
2017,11,24,10,10760,10963,8850,-2113
2017,11,24,11,11330,11384,9633,-1751
2017,11,24,12,11980,12179,10347,-1832
2017,11,24,13,12470,12705,10778,-1927
2017,11,24,14,12730,12860,10923,-1937
2017,11,24,15,12550,12676,10635,-2041
2017,11,24,16,12210,12451,10178,-2273
2017,11,24,17,12060,12232,10234,-1998
2017,11,24,18,11940,12026,10001,-2025
2017,11,24,19,11740,12026,9780,-2246
2017,11,24,20,11900,12347,10112,-2235
2017,11,24,21,12420,12949,10895,-2054
2017,11,24,22,13880,14009,11871,-2138
2017,11,24,23,14870,14799,12723,-2076
2017,11,25,0,14620,14593,12357,-2236
2017,11,25,1,14120,14219,11829,-2390
2017,11,25,2,13670,13770,11475,-2295
2017,11,25,3,13160,13153,10803,-2350
2017,11,25,4,12290,12358,9934,-2424
2017,11,25,5,11410,11439,9280,-2159
2017,11,25,6,10860,11019,9134,-1885
2017,11,25,7,10440,10646,8606,-2040
2017,11,25,8,10200,10813,8501,-2312
2017,11,25,9,10120,10934,8739,-2195
2017,11,25,10,10240,11040,8857,-2183
2017,11,25,11,10670,11173,8952,-2221
2017,11,25,12,11360,11304,9297,-2007
2017,11,25,13,11910,11831,10102,-1729
2017,11,25,14,12330,12138,10321,-1817
2017,11,25,15,12380,12072,10265,-1807
2017,11,25,16,12220,11914,9960,-1954
2017,11,25,17,12050,11791,9598,-2193
2017,11,25,18,11990,11702,9580,-2122
2017,11,25,19,11920,11681,9591,-2090
2017,11,25,20,12080,12025,9878,-2147
2017,11,25,21,12640,12547,10304,-2243
2017,11,25,22,13790,13603,11516,-2087
2017,11,25,23,14620,14274,12472,-1802
2017,11,26,0,14240,14057,12011,-2046
2017,11,26,1,13800,13685,11618,-2067
2017,11,26,2,13350,13240,11154,-2086
2017,11,26,3,12690,12591,10489,-2102
2017,11,26,4,11860,11758,9436,-2322
2017,11,26,5,11030,10963,8629,-2334
2017,11,26,6,10150,10487,7895,-2592
2017,11,26,7,9750,10357,7724,-2633
2017,11,26,8,9510,10309,7684,-2625
2017,11,26,9,9430,10225,7618,-2607
2017,11,26,10,9550,9915,7519,-2396
2017,11,26,11,9900,10093,7643,-2450
2017,11,26,12,10390,10620,8016,-2604
2017,11,26,13,11120,11141,8732,-2409
2017,11,26,14,11630,11440,9330,-2110
2017,11,26,15,11800,11805,9856,-1949
2017,11,26,16,11840,12174,10270,-1904
2017,11,26,17,11890,12261,10584,-1677
2017,11,26,18,11950,12270,10641,-1629
2017,11,26,19,11960,12352,10757,-1595
2017,11,26,20,12200,12677,10867,-1810
2017,11,26,21,12800,13395,11344,-2051
2017,11,26,22,14220,14744,12608,-2136
2017,11,26,23,15420,15648,13728,-1920
2017,11,27,0,15220,15537,13567,-1970
2017,11,27,1,14990,15125,13153,-1972
2017,11,27,2,14330,14520,12769,-1751
2017,11,27,3,13440,13588,11589,-1999
2017,11,27,4,12460,12466,10218,-2248
2017,11,27,5,11500,11560,9136,-2424
2017,11,27,6,10860,11634,9107,-2527
2017,11,27,7,10560,11555,8992,-2563
2017,11,27,8,10410,11735,9000,-2735
2017,11,27,9,10480,11777,8957,-2820
2017,11,27,10,10880,11974,9092,-2882
2017,11,27,11,12050,12732,10008,-2724
2017,11,27,12,13860,13858,11493,-2365
2017,11,27,13,14750,14850,12468,-2382
2017,11,27,14,14470,15015,12518,-2497
2017,11,27,15,14150,14757,12393,-2364
2017,11,27,16,13930,14498,11997,-2501
2017,11,27,17,13800,14447,12064,-2383
2017,11,27,18,13900,14256,11949,-2307
2017,11,27,19,13920,14202,12268,-1934
2017,11,27,20,14090,14313,12487,-1826
2017,11,27,21,14590,14755,12582,-2173
2017,11,27,22,15860,15937,13847,-2090
2017,11,27,23,16840,16899,15185,-1714
2017,11,28,0,16690,16858,14940,-1918
2017,11,28,1,16270,16485,14233,-2252
2017,11,28,2,15640,15884,13385,-2499
2017,11,28,3,14600,14882,12252,-2630
2017,11,28,4,13340,13585,10936,-2649
2017,11,28,5,12220,12547,10141,-2406
2017,11,28,6,11700,12113,9950,-2163
2017,11,28,7,11380,12011,9915,-2096
2017,11,28,8,11280,12166,9861,-2305
2017,11,28,9,11320,12264,9836,-2428
2017,11,28,10,11830,12448,10147,-2301
2017,11,28,11,12810,13288,11279,-2009
2017,11,28,12,14690,14888,12676,-2212
2017,11,28,13,15460,15753,13406,-2347
2017,11,28,14,15220,15457,12926,-2531
2017,11,28,15,14860,14856,12323,-2533
2017,11,28,16,14480,14416,11750,-2666
2017,11,28,17,14150,14078,11466,-2612
2017,11,28,18,13960,13872,11329,-2543
2017,11,28,19,14010,13946,11436,-2510
2017,11,28,20,14200,14262,11799,-2463
2017,11,28,21,14590,14866,12336,-2530
2017,11,28,22,15900,16052,13589,-2463
2017,11,28,23,16800,16992,14543,-2449
2017,11,29,0,16630,16848,14292,-2556
2017,11,29,1,16160,16418,13800,-2618
2017,11,29,2,15410,15686,13206,-2480
2017,11,29,3,14320,14553,12222,-2331
2017,11,29,4,12980,13189,10852,-2337
2017,11,29,5,11750,12161,9871,-2290
2017,11,29,6,11060,11354,9043,-2311
2017,11,29,7,10620,11137,9064,-2073
2017,11,29,8,10400,11171,9273,-1898
2017,11,29,9,10360,11148,9286,-1862
2017,11,29,10,10700,11254,9452,-1802
2017,11,29,11,11800,12019,10096,-1923
2017,11,29,12,13530,13449,11803,-1646
2017,11,29,13,14400,14290,12277,-2013
2017,11,29,14,14390,14304,12266,-2038
2017,11,29,15,14070,14009,11868,-2141
2017,11,29,16,13690,13567,11504,-2063
2017,11,29,17,13530,13250,11289,-1961
2017,11,29,18,13440,13183,11468,-1715
2017,11,29,19,13510,13806,12035,-1771
2017,11,29,20,13640,14045,12182,-1863
2017,11,29,21,14040,14125,12248,-1877
2017,11,29,22,15300,15239,13072,-2167
2017,11,29,23,16300,16233,14050,-2183
2017,11,30,0,16160,16175,13956,-2219
2017,11,30,1,15680,15795,13702,-2093
2017,11,30,2,15100,15188,13138,-2050
2017,11,30,3,14190,14231,12158,-2073
2017,11,30,4,12960,12966,10784,-2182
2017,11,30,5,11890,12027,9826,-2201
2017,11,30,6,11240,11634,9454,-2180
2017,11,30,7,10890,11380,9192,-2188
2017,11,30,8,10750,11548,9080,-2468
2017,11,30,9,10820,11630,9015,-2615
2017,11,30,10,11240,11821,9391,-2430
2017,11,30,11,12390,12740,10284,-2456
2017,11,30,12,14250,14376,11901,-2475
2017,11,30,13,14980,15268,12549,-2719
2017,11,30,14,14880,15044,12508,-2536
2017,11,30,15,14740,14575,12181,-2394
2017,11,30,16,14620,14441,12179,-2262
2017,11,30,17,14480,14318,11904,-2414
2017,11,30,18,14320,14267,11779,-2488
2017,11,30,19,14390,14327,11823,-2504
2017,11,30,20,14550,14446,11938,-2508
2017,11,30,21,14940,14777,12277,-2500
2017,11,30,22,16070,15907,13313,-2594
2017,11,30,23,16700,16630,14103,-2527
2017,12,1,0,16340,16484,13948,-2536
2017,12,1,1,15840,16091,13537,-2554
2017,12,1,2,15180,15451,13029,-2422
2017,12,1,3,14150,14423,11988,-2435
2017,12,1,4,12820,13039,10545,-2494
2017,12,1,5,11660,12065,9786,-2279
2017,12,1,6,10950,11628,9557,-2071
2017,12,1,7,10520,11317,9330,-1987
2017,12,1,8,10290,11111,9096,-2015
2017,12,1,9,10250,11278,9104,-2174
2017,12,1,10,10480,11496,9355,-2141
2017,12,1,11,11480,12088,9933,-2155
2017,12,1,12,13300,13381,10840,-2541
2017,12,1,13,14290,14296,11758,-2538
2017,12,1,14,14140,14285,11646,-2639
2017,12,1,15,13770,13988,11664,-2324
2017,12,1,16,13510,13824,11404,-2420
2017,12,1,17,13320,13810,11457,-2353
2017,12,1,18,13150,13859,11562,-2297
2017,12,1,19,13150,14029,11637,-2392
2017,12,1,20,13240,14164,11907,-2257
2017,12,1,21,13690,14430,12312,-2118
2017,12,1,22,15020,15364,12780,-2584
2017,12,1,23,16020,15985,13677,-2308
2017,12,2,0,15790,15723,13338,-2385
2017,12,2,1,15340,15299,12927,-2372
2017,12,2,2,14820,14815,12603,-2212
2017,12,2,3,14150,14115,12213,-1902
2017,12,2,4,13120,13105,11294,-1811
2017,12,2,5,12080,12081,10192,-1889
2017,12,2,6,11270,11350,9563,-1787
2017,12,2,7,10790,11194,9373,-1821
2017,12,2,8,10550,11490,9415,-2075
2017,12,2,9,10570,11534,9285,-2249
2017,12,2,10,10720,11691,9311,-2380
2017,12,2,11,11180,12128,9698,-2430
2017,12,2,12,11960,12411,9927,-2484
2017,12,2,13,12670,13008,10521,-2487
2017,12,2,14,13250,13530,11093,-2437
2017,12,2,15,13540,13601,11209,-2392
2017,12,2,16,13500,13517,11172,-2345
2017,12,2,17,13500,13407,11110,-2297
2017,12,2,18,13370,13286,11085,-2201
2017,12,2,19,13330,13323,11143,-2180
2017,12,2,20,13420,13696,11399,-2297
2017,12,2,21,13790,14086,11505,-2581
2017,12,2,22,14790,14992,12214,-2778
2017,12,2,23,15600,15587,12936,-2651
2017,12,3,0,15330,15367,12802,-2565
2017,12,3,1,14930,14968,12452,-2516
2017,12,3,2,14490,14542,11956,-2586
2017,12,3,3,13870,13904,11386,-2518
2017,12,3,4,13000,13012,10765,-2247
2017,12,3,5,12050,12181,9646,-2535
2017,12,3,6,11200,11558,9222,-2336
2017,12,3,7,10750,11380,9153,-2227
2017,12,3,8,10480,11693,9423,-2270
2017,12,3,9,10550,11630,9247,-2383
2017,12,3,10,10680,11745,9193,-2552
2017,12,3,11,10990,12071,9356,-2715
2017,12,3,12,11580,12439,9867,-2572
2017,12,3,13,12120,12785,10291,-2494
2017,12,3,14,12730,13201,10738,-2463
2017,12,3,15,13120,13313,10820,-2493
2017,12,3,16,13190,13277,11052,-2225
2017,12,3,17,13100,13304,11169,-2135
2017,12,3,18,13120,13489,11351,-2138
2017,12,3,19,13160,13638,11287,-2351
2017,12,3,20,13290,13786,11441,-2345
2017,12,3,21,13770,14109,11733,-2376
2017,12,3,22,15140,15347,12821,-2526
2017,12,3,23,16000,16175,13792,-2383
2017,12,4,0,15860,16062,13674,-2388
2017,12,4,1,15450,15644,13959,-1685
2017,12,4,2,14940,15004,13228,-1776
2017,12,4,3,14010,14013,12220,-1793
2017,12,4,4,12910,12920,10960,-1960
2017,12,4,5,11870,11955,9811,-2144
2017,12,4,6,11000,11576,9380,-2196
2017,12,4,7,10630,11439,9058,-2381
2017,12,4,8,10510,11562,9226,-2336
2017,12,4,9,10590,11672,9471,-2201
2017,12,4,10,11030,12106,10113,-1993
2017,12,4,11,12170,12967,10881,-2086
2017,12,4,12,14060,14503,12548,-1955
2017,12,4,13,15150,15144,13201,-1943
2017,12,4,14,15120,14988,13020,-1968
2017,12,4,15,14490,14440,12525,-1915
2017,12,4,16,14060,14064,12162,-1902
2017,12,4,17,13780,14026,12222,-1804
2017,12,4,18,13650,13874,12038,-1836
2017,12,4,19,13680,13989,12105,-1884
2017,12,4,20,13850,14131,12227,-1904
2017,12,4,21,14410,14617,12440,-2177
2017,12,4,22,15770,15976,13523,-2453
2017,12,4,23,16850,17026,14788,-2238
2017,12,5,0,16740,17002,14630,-2372
2017,12,5,1,16350,16585,14037,-2548
2017,12,5,2,15710,15934,13539,-2395
2017,12,5,3,14660,14865,12710,-2155
2017,12,5,4,13310,13434,11130,-2304
2017,12,5,5,12080,12440,9984,-2456
2017,12,5,6,11300,11646,9294,-2352
2017,12,5,7,10870,11414,9282,-2132
2017,12,5,8,10610,11245,9096,-2149
2017,12,5,9,10580,11215,9123,-2092
2017,12,5,10,10900,11542,9529,-2013
2017,12,5,11,11980,12310,10244,-2066
2017,12,5,12,13780,13920,11841,-2079
2017,12,5,13,14800,14927,12731,-2196
2017,12,5,14,14960,15086,12678,-2408
2017,12,5,15,15010,15153,12827,-2326
2017,12,5,16,15020,15271,13252,-2019
2017,12,5,17,15040,15357,13659,-1698
2017,12,5,18,14930,15366,13397,-1969
2017,12,5,19,14980,15373,13408,-1965
2017,12,5,20,15040,15326,13366,-1960
2017,12,5,21,15340,15507,13765,-1742
2017,12,5,22,16390,16321,14661,-1660
2017,12,5,23,16900,16827,15057,-1770
2017,12,6,0,16570,16594,14880,-1714
2017,12,6,1,16050,16070,14222,-1848
2017,12,6,2,15330,15334,13278,-2056
2017,12,6,3,14220,14236,12200,-2036
2017,12,6,4,12810,12792,10754,-2038
2017,12,6,5,11550,11711,9364,-2347
2017,12,6,6,10670,11149,8706,-2443
2017,12,6,7,10140,10868,8441,-2427
2017,12,6,8,9940,10754,8299,-2455
2017,12,6,9,9880,10703,8321,-2382
2017,12,6,10,10220,10974,8528,-2446
2017,12,6,11,11310,11499,9131,-2368
2017,12,6,12,13160,12949,10899,-2050
2017,12,6,13,14270,14078,12103,-1975
2017,12,6,14,14400,14358,12472,-1886
2017,12,6,15,14400,14420,12390,-2030
2017,12,6,16,14270,14428,12441,-1987
2017,12,6,17,14090,14273,12166,-2107
2017,12,6,18,14080,13850,11562,-2288
2017,12,6,19,14020,13619,11487,-2132
2017,12,6,20,14220,13858,11538,-2320
2017,12,6,21,14580,14768,12461,-2307
2017,12,6,22,15770,15853,13539,-2314
2017,12,6,23,16800,16850,14696,-2154
2017,12,7,0,16730,16754,14454,-2300
2017,12,7,1,16330,16411,13840,-2571
2017,12,7,2,15730,15832,13262,-2570
2017,12,7,3,14770,14853,12357,-2496
2017,12,7,4,13410,13669,11000,-2669
2017,12,7,5,12200,12556,10031,-2525
2017,12,7,6,11380,12310,9940,-2370
2017,12,7,7,10890,12181,9682,-2499
2017,12,7,8,10710,12317,9830,-2487
2017,12,7,9,10730,12336,9903,-2433
2017,12,7,10,11300,12501,10111,-2390
2017,12,7,11,12290,13175,10754,-2421
2017,12,7,12,14050,14370,11838,-2532
2017,12,7,13,14880,15333,12484,-2849
2017,12,7,14,14660,15092,12271,-2821
2017,12,7,15,14340,14532,11819,-2713
2017,12,7,16,14000,14136,11772,-2364
2017,12,7,17,13870,13921,11665,-2256
2017,12,7,18,13820,14022,11715,-2307
2017,12,7,19,13920,14344,11996,-2348
2017,12,7,20,14140,14610,12001,-2609
2017,12,7,21,14580,14881,12423,-2458
2017,12,7,22,15940,16067,13814,-2253
2017,12,7,23,16900,16962,15004,-1958
2017,12,8,0,16860,16881,14569,-2312
2017,12,8,1,16480,16534,13760,-2774
2017,12,8,2,15910,15963,13115,-2848
2017,12,8,3,14960,15045,12148,-2897
2017,12,8,4,13630,13630,10496,-3134
2017,12,8,5,12410,12732,9843,-2889
2017,12,8,6,11680,11976,9273,-2703
2017,12,8,7,11300,11762,9112,-2650
2017,12,8,8,11140,11698,9107,-2591
2017,12,8,9,11180,11727,9044,-2683
2017,12,8,10,11590,12114,9254,-2860
2017,12,8,11,12700,12970,10303,-2667
2017,12,8,12,14570,14535,11812,-2723
2017,12,8,13,15580,15578,12775,-2803
2017,12,8,14,15580,15612,12580,-3032
2017,12,8,15,15240,15273,12221,-3052
2017,12,8,16,14990,15070,11933,-3137
2017,12,8,17,14810,15049,12162,-2887
2017,12,8,18,14650,14943,12105,-2838
2017,12,8,19,14720,15227,12164,-3063
2017,12,8,20,14830,15416,12284,-3132
2017,12,8,21,15140,15607,12405,-3202
2017,12,8,22,16330,16592,13337,-3255
2017,12,8,23,17000,17127,13625,-3502
2017,12,9,0,16700,16830,13305,-3525
2017,12,9,1,16210,16368,12970,-3398
2017,12,9,2,15680,15811,12621,-3190
2017,12,9,3,14920,15025,11822,-3203
2017,12,9,4,13850,14101,10727,-3374
2017,12,9,5,12720,13351,10225,-3126
2017,12,9,6,11910,12488,9667,-2821
2017,12,9,7,11400,11996,9177,-2819
2017,12,9,8,11110,12138,9082,-3056
2017,12,9,9,11020,12119,9089,-3030
2017,12,9,10,11160,12235,9175,-3060
2017,12,9,11,11550,12308,9480,-2828
2017,12,9,12,12210,12479,9564,-2915
2017,12,9,13,12970,13268,10186,-3082
2017,12,9,14,14030,14164,11395,-2769
2017,12,9,15,14520,14713,12270,-2443
2017,12,9,16,14750,15121,12378,-2743
2017,12,9,17,14880,15463,12378,-3085
2017,12,9,18,14850,15643,12393,-3250
2017,12,9,19,14790,15678,12398,-3280
2017,12,9,20,14720,15706,12597,-3109
2017,12,9,21,15010,15927,12980,-2947
2017,12,9,22,16120,16840,14031,-2809
2017,12,9,23,16750,17348,14532,-2816
2017,12,10,0,16420,17046,14026,-3020
2017,12,10,1,15810,16475,13521,-2954
2017,12,10,2,15290,15817,12665,-3152
2017,12,10,3,14510,15006,12180,-2826
2017,12,10,4,13590,13938,11172,-2766
2017,12,10,5,12620,12923,10073,-2850
2017,12,10,6,11870,12733,9546,-3187
2017,12,10,7,11350,12402,9584,-2818
2017,12,10,8,11090,12348,9534,-2814
2017,12,10,9,10980,12220,9279,-2941
2017,12,10,10,11090,12147,9241,-2906
2017,12,10,11,11440,12309,9247,-3062
2017,12,10,12,12030,12570,9307,-3263
2017,12,10,13,12780,12797,9633,-3164
2017,12,10,14,13380,13601,10400,-3201
2017,12,10,15,13520,14111,10939,-3172
2017,12,10,16,13560,14164,11032,-3132
2017,12,10,17,13590,14110,10892,-3218
2017,12,10,18,13600,14041,10799,-3242
2017,12,10,19,13640,14013,10777,-3236
2017,12,10,20,13740,14142,10931,-3211
2017,12,10,21,14220,14586,11448,-3138
2017,12,10,22,15590,15952,12868,-3084
2017,12,10,23,16600,16966,13901,-3065
2017,12,11,0,16550,16889,13671,-3218
2017,12,11,1,16090,16501,13393,-3108
2017,12,11,2,15620,15925,12753,-3172
2017,12,11,3,14740,14901,11724,-3177
2017,12,11,4,13640,13626,10308,-3318
2017,12,11,5,12610,12513,9096,-3417
2017,12,11,6,11790,12131,8750,-3381
2017,12,11,7,11450,12208,8880,-3328
2017,12,11,8,11330,12271,9178,-3093
2017,12,11,9,11390,12281,8994,-3287
2017,12,11,10,11820,12440,9422,-3018
2017,12,11,11,12900,13289,10614,-2675
2017,12,11,12,14640,14675,11877,-2798
2017,12,11,13,15700,15729,12989,-2740
2017,12,11,14,15830,15904,12978,-2926
2017,12,11,15,15430,15770,12695,-3075
2017,12,11,16,15000,15533,12627,-2906
2017,12,11,17,14850,15181,12386,-2795
2017,12,11,18,14720,14957,12186,-2771
2017,12,11,19,14750,14993,12223,-2770
2017,12,11,20,14920,15121,12325,-2796
2017,12,11,21,15400,15504,12740,-2764
2017,12,11,22,16740,16787,14202,-2585
2017,12,11,23,17790,17870,15453,-2417
2017,12,12,0,17710,17831,15260,-2571
2017,12,12,1,17320,17430,14755,-2675
2017,12,12,2,16650,16794,14177,-2617
2017,12,12,3,15630,15698,13009,-2689
2017,12,12,4,14250,14333,11530,-2803
2017,12,12,5,13040,13197,10322,-2875
2017,12,12,6,12120,12367,9362,-3005
2017,12,12,7,11640,12264,9335,-2929
2017,12,12,8,11440,12272,9187,-3085
2017,12,12,9,11460,12273,9177,-3096
2017,12,12,10,11760,12329,9325,-3004
2017,12,12,11,12800,13091,10325,-2766
2017,12,12,12,14640,14580,11904,-2676
2017,12,12,13,15710,15657,13035,-2622
2017,12,12,14,15910,15964,13317,-2647
2017,12,12,15,15930,16160,13689,-2471
2017,12,12,16,15960,16289,13719,-2570
2017,12,12,17,15910,16299,13803,-2496
2017,12,12,18,15720,16217,13752,-2465
2017,12,12,19,15710,16168,13714,-2454
2017,12,12,20,15680,16079,13574,-2505
2017,12,12,21,15940,16275,13553,-2722
2017,12,12,22,17120,17154,14304,-2850
2017,12,12,23,17850,17812,14835,-2977
2017,12,13,0,17580,17640,14436,-3204
2017,12,13,1,17060,17179,14152,-3027
2017,12,13,2,16430,16521,13573,-2948
2017,12,13,3,15430,15491,12541,-2950
2017,12,13,4,14040,14109,11002,-3107
2017,12,13,5,12780,12889,10020,-2869
2017,12,13,6,12090,12949,9831,-3118
2017,12,13,7,11750,13265,9805,-3460
2017,12,13,8,11630,13215,9812,-3403
2017,12,13,9,11710,13313,9744,-3569
2017,12,13,10,12150,13461,9920,-3541
2017,12,13,11,13320,13914,10566,-3348
2017,12,13,12,15320,15593,12113,-3480
2017,12,13,13,16400,16427,12835,-3592
2017,12,13,14,16450,16502,13119,-3383
2017,12,13,15,16450,16669,13063,-3606
2017,12,13,16,16310,16453,12887,-3566
2017,12,13,17,16150,16300,12715,-3585
2017,12,13,18,16070,16253,12919,-3334
2017,12,13,19,16160,16318,12908,-3410
2017,12,13,20,16320,16417,13183,-3234
2017,12,13,21,16710,16848,13428,-3420
2017,12,13,22,18040,18141,14755,-3386
2017,12,13,23,18900,19126,15882,-3244
2017,12,14,0,18830,19044,15803,-3241
2017,12,14,1,18410,18688,15277,-3411
2017,12,14,2,17750,18095,14634,-3461
2017,12,14,3,16770,17073,13464,-3609
2017,12,14,4,15330,15578,11981,-3597
2017,12,14,5,13990,14620,11250,-3370
2017,12,14,6,13290,13847,10401,-3446
2017,12,14,7,12810,13607,10092,-3515
2017,12,14,8,12640,13566,10084,-3482
2017,12,14,9,12660,13540,10032,-3508
2017,12,14,10,13030,13754,10302,-3452
2017,12,14,11,14110,14165,10896,-3269
2017,12,14,12,15930,15898,12639,-3259
2017,12,14,13,16890,16948,13523,-3425
2017,12,14,14,17040,17193,13671,-3522
2017,12,14,15,16900,17148,13766,-3382
2017,12,14,16,16470,16949,13319,-3630
2017,12,14,17,16180,16567,13135,-3432
2017,12,14,18,15840,16221,12788,-3433
2017,12,14,19,15840,16126,12669,-3457
2017,12,14,20,15930,16076,12652,-3424
2017,12,14,21,16360,16458,12996,-3462
2017,12,14,22,17760,17806,14200,-3606
2017,12,14,23,18900,18792,15308,-3484
2017,12,15,0,18740,18795,15315,-3480
2017,12,15,1,18440,18564,15125,-3439
2017,12,15,2,17890,18073,14660,-3413
2017,12,15,3,16990,17129,13817,-3312
2017,12,15,4,15600,15805,12331,-3474
2017,12,15,5,14330,14770,11259,-3511
2017,12,15,6,13700,14293,11107,-3186
2017,12,15,7,13320,14175,10949,-3226
2017,12,15,8,13150,14006,10795,-3211
2017,12,15,9,13210,14030,10867,-3163
2017,12,15,10,13550,14087,11059,-3028
2017,12,15,11,14530,14685,11770,-2915
2017,12,15,12,16290,16479,13513,-2966
2017,12,15,13,17280,17521,14328,-3193
2017,12,15,14,17310,17716,14442,-3274
2017,12,15,15,17100,17613,14349,-3264
2017,12,15,16,16750,17404,14127,-3277
2017,12,15,17,16560,17208,13962,-3246
2017,12,15,18,16340,17020,13819,-3201
2017,12,15,19,16290,16997,13697,-3300
2017,12,15,20,16320,16960,13659,-3301
2017,12,15,21,16810,17168,13796,-3372
2017,12,15,22,17950,18164,14555,-3609
2017,12,15,23,18600,18685,15232,-3453
2017,12,16,0,18190,18416,14899,-3517
2017,12,16,1,17700,17922,14374,-3548
2017,12,16,2,17030,17353,13917,-3436
2017,12,16,3,16190,16536,13262,-3274
2017,12,16,4,15020,15394,12194,-3200
2017,12,16,5,13770,14196,10764,-3432
2017,12,16,6,13120,13310,10209,-3101
2017,12,16,7,12650,13068,9955,-3113
2017,12,16,8,12420,13103,10026,-3077
2017,12,16,9,12520,13323,10223,-3100
2017,12,16,10,12680,13501,10386,-3115
2017,12,16,11,13190,13685,10594,-3091
2017,12,16,12,14060,13967,10933,-3034
2017,12,16,13,14820,14826,11919,-2907
2017,12,16,14,15520,15603,12493,-3110
2017,12,16,15,15550,15770,12589,-3181
2017,12,16,16,15500,15609,12404,-3205
2017,12,16,17,15250,15418,12152,-3266
2017,12,16,18,14860,15471,12131,-3340
2017,12,16,19,14830,15513,12213,-3300
2017,12,16,20,14920,15547,12278,-3269
2017,12,16,21,15330,15618,12448,-3170
2017,12,16,22,16590,16640,13410,-3230
2017,12,16,23,17410,17306,14024,-3282
2017,12,17,0,17200,17095,13589,-3506
2017,12,17,1,16860,16672,13183,-3489
2017,12,17,2,16440,16253,12746,-3507
2017,12,17,3,15810,15681,12241,-3440
2017,12,17,4,14850,14854,11403,-3451
2017,12,17,5,13800,14101,10599,-3502
2017,12,17,6,12980,13636,10235,-3401
2017,12,17,7,12530,13195,9755,-3440
2017,12,17,8,12340,13350,9938,-3412
2017,12,17,9,12280,13486,10034,-3452
2017,12,17,10,12550,13315,9993,-3322
2017,12,17,11,12860,13393,10196,-3197
2017,12,17,12,13770,13663,10452,-3211
2017,12,17,13,14270,14324,11087,-3237
2017,12,17,14,14960,15009,11809,-3200
2017,12,17,15,15220,15187,12211,-2976
2017,12,17,16,15190,15082,12221,-2861
2017,12,17,17,15200,14953,12084,-2869
2017,12,17,18,15170,15031,12171,-2860
2017,12,17,19,15190,15145,12232,-2913
2017,12,17,20,15200,15398,12473,-2925
2017,12,17,21,15360,15851,12755,-3096
2017,12,17,22,16850,17138,13960,-3178
2017,12,17,23,18000,17986,14724,-3262
2017,12,18,0,17740,17889,15557,-2332
2017,12,18,1,17330,17485,14561,-2924
2017,12,18,2,16720,17052,14238,-2814
2017,12,18,3,15730,16071,13413,-2658
2017,12,18,4,14490,14750,12064,-2686
2017,12,18,5,13400,13607,10612,-2995
2017,12,18,6,12840,13050,9951,-3099
2017,12,18,7,12420,12975,9987,-2988
2017,12,18,8,12250,12790,9816,-2974
2017,12,18,9,12290,12823,9863,-2960
2017,12,18,10,12700,12982,10127,-2855
2017,12,18,11,13810,13800,11190,-2610
2017,12,18,12,15620,15580,13162,-2418
2017,12,18,13,16760,16741,14188,-2553
2017,12,18,14,16980,16998,14455,-2543
2017,12,18,15,17030,17030,14120,-2910
2017,12,18,16,16980,16981,14011,-2970
2017,12,18,17,16840,17123,14175,-2948
2017,12,18,18,16670,17148,14281,-2867
2017,12,18,19,16540,16808,14181,-2627
2017,12,18,20,16480,16642,13963,-2679
2017,12,18,21,16530,16827,14221,-2606
2017,12,18,22,17630,17792,14980,-2812
2017,12,18,23,18350,18514,15649,-2865
2017,12,19,0,18230,18332,15358,-2974
2017,12,19,1,17700,17854,14735,-3119
2017,12,19,2,16970,17155,14106,-3049
2017,12,19,3,15830,16033,13243,-2790
2017,12,19,4,14370,14555,11762,-2793
2017,12,19,5,13100,13190,10200,-2990
2017,12,19,6,12300,12388,9501,-2887
2017,12,19,7,11810,12469,9513,-2956
2017,12,19,8,11560,12531,9575,-2956
2017,12,19,9,11580,12611,9631,-2980
2017,12,19,10,11920,12719,9842,-2877
2017,12,19,11,12990,13456,10533,-2923
2017,12,19,12,14820,14724,11837,-2887
2017,12,19,13,15920,15737,12806,-2931
2017,12,19,14,16030,15880,13135,-2745
2017,12,19,15,15910,15855,13083,-2772
2017,12,19,16,15540,15731,13018,-2713
2017,12,19,17,15240,15344,12665,-2679
2017,12,19,18,15110,15254,12796,-2458
2017,12,19,19,15230,15199,12427,-2772
2017,12,19,20,15320,15458,12817,-2641
2017,12,19,21,15620,15749,13298,-2451
2017,12,19,22,16780,16613,13805,-2808
2017,12,19,23,17500,17413,14370,-3043
2017,12,20,0,17310,17136,14090,-3046
2017,12,20,1,16910,16719,13739,-2980
2017,12,20,2,16380,16116,13089,-3027
2017,12,20,3,15210,15272,12266,-3006
2017,12,20,4,13750,14224,11209,-3015
2017,12,20,5,12540,13280,9989,-3291
2017,12,20,6,11750,12538,9408,-3130
2017,12,20,7,11220,12480,9535,-2945
2017,12,20,8,10980,12453,9351,-3102
2017,12,20,9,11020,12447,9275,-3172
2017,12,20,10,11440,12547,9525,-3022
2017,12,20,11,12520,12566,9868,-2698
2017,12,20,12,14350,14143,11305,-2838
2017,12,20,13,15170,15229,11857,-3372
2017,12,20,14,15180,15280,11825,-3455
2017,12,20,15,15000,15055,11454,-3601
2017,12,20,16,14800,14929,11316,-3613
2017,12,20,17,14630,14713,11311,-3402
2017,12,20,18,14570,14369,11098,-3271
2017,12,20,19,14690,14507,11203,-3304
2017,12,20,20,14860,14842,11398,-3444
2017,12,20,21,15290,15371,11870,-3501
2017,12,20,22,16670,16629,12978,-3651
2017,12,20,23,17800,17637,13942,-3695
2017,12,21,0,17690,17611,13876,-3735
2017,12,21,1,17370,17347,13781,-3566
2017,12,21,2,16810,16829,13197,-3632
2017,12,21,3,15840,15934,12391,-3543
2017,12,21,4,14380,14625,11191,-3434
2017,12,21,5,13270,13589,10090,-3499
2017,12,21,6,12410,12802,9368,-3434
2017,12,21,7,11990,12521,8930,-3591
2017,12,21,8,11840,12432,8836,-3596
2017,12,21,9,11890,12489,8969,-3520
2017,12,21,10,12290,12874,9369,-3505
2017,12,21,11,13350,13631,10217,-3414
2017,12,21,12,15170,15200,11851,-3349
2017,12,21,13,16100,16244,12911,-3333
2017,12,21,14,16050,16196,12809,-3387
2017,12,21,15,15800,15695,12127,-3568
2017,12,21,16,15540,15180,11734,-3446
2017,12,21,17,15300,14875,11422,-3453
2017,12,21,18,15120,14787,11297,-3490
2017,12,21,19,15130,14846,11377,-3469
2017,12,21,20,15240,15011,11545,-3466
2017,12,21,21,15780,15658,12293,-3365
2017,12,21,22,16990,16940,13574,-3366
2017,12,21,23,18100,17969,14694,-3275
2017,12,22,0,17920,17940,14458,-3482
2017,12,22,1,17520,17634,14022,-3612
2017,12,22,2,16980,17174,13611,-3563
2017,12,22,3,16040,16298,12794,-3504
2017,12,22,4,14720,15028,11441,-3587
2017,12,22,5,13550,13751,10170,-3581
2017,12,22,6,12700,12884,9430,-3454
2017,12,22,7,12230,12524,9032,-3492
2017,12,22,8,12020,12434,8997,-3437
2017,12,22,9,12030,12419,9005,-3414
2017,12,22,10,12380,12731,9401,-3330
2017,12,22,11,13420,13390,10207,-3183
2017,12,22,12,15090,14993,12069,-2924
2017,12,22,13,16290,16192,13121,-3071
2017,12,22,14,16510,16642,13700,-2942
2017,12,22,15,16560,16849,13656,-3193
2017,12,22,16,16650,16970,14113,-2857
2017,12,22,17,16570,16970,14064,-2906
2017,12,22,18,16520,16798,13524,-3274
2017,12,22,19,16510,16778,13416,-3362
2017,12,22,20,16430,16796,13582,-3214
2017,12,22,21,16630,17009,13794,-3215
2017,12,22,22,17610,17867,14681,-3186
2017,12,22,23,18000,18368,15418,-2950
2017,12,23,0,17720,17982,14988,-2994
2017,12,23,1,17110,17377,14158,-3219
2017,12,23,2,16490,16733,13389,-3344
2017,12,23,3,15620,15863,12590,-3273
2017,12,23,4,14480,14712,11227,-3485
2017,12,23,5,13270,13672,10140,-3532
2017,12,23,6,12640,12851,9323,-3528
2017,12,23,7,12090,12332,9039,-3293
2017,12,23,8,11790,12297,8920,-3377
2017,12,23,9,11690,12243,8816,-3427
2017,12,23,10,11780,12326,8915,-3411
2017,12,23,11,12090,12546,9160,-3386
2017,12,23,12,12680,13171,9773,-3398
2017,12,23,13,13530,13847,10512,-3335
2017,12,23,14,14550,14755,11375,-3380
2017,12,23,15,15070,15569,12164,-3405
2017,12,23,16,15260,16075,12717,-3358
2017,12,23,17,15330,16298,12940,-3358
2017,12,23,18,15190,16334,12902,-3432
2017,12,23,19,14950,16119,12736,-3383
2017,12,23,20,14720,15897,12498,-3399
2017,12,23,21,14820,15908,12420,-3488
2017,12,23,22,15780,16507,12918,-3589
2017,12,23,23,16450,16800,13089,-3711
2017,12,24,0,16000,16455,12781,-3674
2017,12,24,1,15430,15966,12370,-3596
2017,12,24,2,14990,15493,11955,-3538
2017,12,24,3,14430,15193,11621,-3572
2017,12,24,4,13610,14271,10691,-3580
2017,12,24,5,12650,13262,9645,-3617
2017,12,24,6,11810,12858,9187,-3671
2017,12,24,7,11290,12788,9136,-3652
2017,12,24,8,11030,12646,9030,-3616
2017,12,24,9,10920,12540,8924,-3616
2017,12,24,10,11080,12604,8923,-3681
2017,12,24,11,11520,12752,9091,-3661
2017,12,24,12,12260,13046,9398,-3648
2017,12,24,13,13020,13473,9946,-3527
2017,12,24,14,13970,13922,10483,-3439
2017,12,24,15,14620,14077,10671,-3406
2017,12,24,16,14920,14379,10937,-3442
2017,12,24,17,15000,14443,11005,-3438
2017,12,24,18,14910,14329,10819,-3510
2017,12,24,19,14800,14211,10616,-3595
2017,12,24,20,14650,14283,10842,-3441
2017,12,24,21,14920,14500,11111,-3389
2017,12,24,22,15920,15427,12050,-3377
2017,12,24,23,16600,15861,12407,-3454
2017,12,25,0,15900,15370,11745,-3625
2017,12,25,1,15320,14849,11307,-3542
2017,12,25,2,14850,14508,10947,-3561
2017,12,25,3,14320,14175,10671,-3504
2017,12,25,4,13520,13603,10078,-3525
2017,12,25,5,12610,12976,9518,-3458
2017,12,25,6,12020,12467,8979,-3488
2017,12,25,7,11520,12222,8813,-3409
2017,12,25,8,11250,12062,8644,-3418
2017,12,25,9,11180,11988,8673,-3315
2017,12,25,10,11210,12087,8838,-3249
2017,12,25,11,11390,12093,9002,-3091
2017,12,25,12,11820,12517,9423,-3094
2017,12,25,13,12650,13047,9897,-3150
2017,12,25,14,13660,13979,10783,-3196
2017,12,25,15,14210,14689,11494,-3195
2017,12,25,16,14460,14883,11682,-3201
2017,12,25,17,14450,14846,11726,-3120
2017,12,25,18,14260,14605,11568,-3037
2017,12,25,19,14040,14313,11248,-3065
2017,12,25,20,13870,14107,11059,-3048
2017,12,25,21,13920,14181,11051,-3130
2017,12,25,22,14920,14922,11625,-3297
2017,12,25,23,15700,15545,12223,-3322
2017,12,26,0,15650,15433,12084,-3349
2017,12,26,1,15370,15295,11934,-3361
2017,12,26,2,15240,15090,11760,-3330
2017,12,26,3,14710,14621,11339,-3282
2017,12,26,4,13870,13829,10457,-3372
2017,12,26,5,12910,13186,9810,-3376
2017,12,26,6,12180,12672,9283,-3389
2017,12,26,7,11770,12856,9437,-3419
2017,12,26,8,11660,13085,9664,-3421
2017,12,26,9,11710,13111,9737,-3374
2017,12,26,10,12110,13197,9960,-3237
2017,12,26,11,13260,13594,10297,-3297
2017,12,26,12,15200,14299,11050,-3249
2017,12,26,13,16360,15204,11980,-3224
2017,12,26,14,16300,15815,12656,-3159
2017,12,26,15,15860,15822,12749,-3073
2017,12,26,16,15650,16018,12934,-3084
2017,12,26,17,15580,16185,13150,-3035
2017,12,26,18,15520,16070,12945,-3125
2017,12,26,19,15580,15932,12633,-3299
2017,12,26,20,15850,15996,12734,-3262
2017,12,26,21,16390,16340,13064,-3276
2017,12,26,22,17700,17509,14068,-3441
2017,12,26,23,18700,18608,15337,-3271
2017,12,27,0,18680,18500,15149,-3351
2017,12,27,1,18340,18112,14787,-3325
2017,12,27,2,17820,17561,14203,-3358
2017,12,27,3,16870,16693,13346,-3347
2017,12,27,4,15500,15807,12236,-3571
2017,12,27,5,14200,14945,11426,-3519
2017,12,27,6,13740,14133,10537,-3596
2017,12,27,7,13360,13649,10249,-3400
2017,12,27,8,13200,13550,10146,-3404
2017,12,27,9,13280,13769,10372,-3397
2017,12,27,10,13620,13854,10594,-3260
2017,12,27,11,14400,14415,11267,-3148
2017,12,27,12,15440,15690,12584,-3106
2017,12,27,13,16370,16742,13526,-3216
2017,12,27,14,16960,17244,14081,-3163
2017,12,27,15,17150,17296,14019,-3277
2017,12,27,16,17010,17178,14033,-3145
2017,12,27,17,16890,16985,13749,-3236
2017,12,27,18,16650,16815,13480,-3335
2017,12,27,19,16680,16812,13553,-3259
2017,12,27,20,16610,16959,13575,-3384
2017,12,27,21,17130,17347,14078,-3269
2017,12,27,22,18220,18435,15032,-3403
2017,12,27,23,19300,19522,16155,-3367
2017,12,28,0,19230,19457,16064,-3393
2017,12,28,1,18790,19080,15542,-3538
2017,12,28,2,18240,18544,15099,-3445
2017,12,28,3,17350,17647,14326,-3321
2017,12,28,4,16120,16811,13597,-3214
2017,12,28,5,15000,15993,12483,-3510
2017,12,28,6,14520,15347,12153,-3194
2017,12,28,7,14160,14983,11875,-3108
2017,12,28,8,14030,15058,12123,-2935
2017,12,28,9,14100,14959,12024,-2935
2017,12,28,10,14430,15210,12321,-2889
2017,12,28,11,15360,15540,12908,-2632
2017,12,28,12,16930,16490,13905,-2585
2017,12,28,13,17850,17523,15220,-2303
2017,12,28,14,18550,18071,15726,-2345
2017,12,28,15,18520,18238,15951,-2287
2017,12,28,16,18450,18213,16067,-2146
2017,12,28,17,18150,18108,16003,-2105
2017,12,28,18,18250,17961,15687,-2274
2017,12,28,19,18210,17936,15341,-2595
2017,12,28,20,17890,18063,15589,-2474
2017,12,28,21,18650,18447,16162,-2285
2017,12,28,22,19310,19550,17103,-2447
2017,12,28,23,20400,20523,18328,-2195
2017,12,29,0,20400,20418,18430,-1988
2017,12,29,1,19970,20015,17700,-2315
2017,12,29,2,19350,19429,16831,-2598
2017,12,29,3,18400,18612,16071,-2541
2017,12,29,4,17000,17523,14774,-2749
2017,12,29,5,15940,16388,13420,-2968
2017,12,29,6,15320,15514,12677,-2837
2017,12,29,7,14860,15402,12421,-2981
2017,12,29,8,14680,15229,12344,-2885
2017,12,29,9,14670,15481,12437,-3044
2017,12,29,10,14950,15540,12557,-2983
2017,12,29,11,15800,15984,12975,-3009
2017,12,29,12,17040,16738,13832,-2906
2017,12,29,13,18130,17737,14917,-2820
2017,12,29,14,18450,18395,15416,-2979
2017,12,29,15,18430,18742,15744,-2998
2017,12,29,16,18350,18709,15735,-2974
2017,12,29,17,18140,18583,15659,-2924
2017,12,29,18,18020,18316,15393,-2923
2017,12,29,19,17920,18037,15005,-3032
2017,12,29,20,17830,17951,14889,-3062
2017,12,29,21,18230,18161,15012,-3149
2017,12,29,22,19030,19125,15970,-3155
2017,12,29,23,20030,20014,16928,-3086
2017,12,30,0,19790,19825,16702,-3123
2017,12,30,1,19280,19397,16193,-3204
2017,12,30,2,18640,18874,15761,-3113
2017,12,30,3,17860,18098,15229,-2869
2017,12,30,4,16800,17039,14283,-2756
2017,12,30,5,15720,15967,13121,-2846
2017,12,30,6,15040,15324,12606,-2718
2017,12,30,7,14540,15523,12772,-2751
2017,12,30,8,14320,15706,12637,-3069
2017,12,30,9,14240,15602,12854,-2748
2017,12,30,10,14260,15589,12807,-2782
2017,12,30,11,14480,15490,12805,-2685
2017,12,30,12,15050,15746,13083,-2663
2017,12,30,13,15700,16359,13825,-2534
2017,12,30,14,16980,16994,14304,-2690
2017,12,30,15,17210,17619,14822,-2797
2017,12,30,16,17220,17940,15149,-2791
2017,12,30,17,17040,17972,15080,-2892
2017,12,30,18,16930,17839,14783,-3056
2017,12,30,19,16750,17591,14706,-2885
2017,12,30,20,16710,17377,14574,-2803
2017,12,30,21,17130,17433,14574,-2859
2017,12,30,22,18050,18260,15465,-2795
2017,12,30,23,19030,19097,16284,-2813
2017,12,31,0,18560,18947,16052,-2895
2017,12,31,1,18070,18554,15788,-2766
2017,12,31,2,17510,18113,15336,-2777
2017,12,31,3,16840,17451,14585,-2866
2017,12,31,4,15840,16735,13848,-2887
2017,12,31,5,14910,16006,12868,-3138
2017,12,31,6,14780,15325,12086,-3239
2017,12,31,7,14250,15203,12127,-3076
2017,12,31,8,13980,15589,12527,-3062
2017,12,31,9,14100,15643,12580,-3063
2017,12,31,10,14180,15454,12488,-2966
2017,12,31,11,14620,15690,12641,-3049
2017,12,31,12,14980,15976,13029,-2947
2017,12,31,13,15470,15910,12982,-2928
2017,12,31,14,16520,16439,13689,-2750
2017,12,31,15,17110,17009,14240,-2769
2017,12,31,16,17150,17285,14544,-2741
2017,12,31,17,17110,17461,14716,-2745
2017,12,31,18,17060,17618,15069,-2549
2017,12,31,19,17080,17712,15042,-2670
2017,12,31,20,17040,17840,15142,-2698
2017,12,31,21,17510,18063,15482,-2581
2017,12,31,22,19110,18967,16192,-2775
2017,12,31,23,19980,19860,16944,-2916
2018,1,1,0,20450,19561,16724,-2837
2018,1,1,1,19480,18932,16295,-2637
2018,1,1,2,19130,18310,15603,-2707
2018,1,1,3,18110,17651,15008,-2643
2018,1,1,4,16920,17005,14581,-2424
2018,1,1,5,15900,16575,13924,-2651
2018,1,1,6,15650,16005,13381,-2624
2018,1,1,7,15170,15583,13117,-2466
2018,1,1,8,14870,15570,13110,-2460
2018,1,1,9,14730,15424,12888,-2536
2018,1,1,10,14810,15251,12913,-2338
2018,1,1,11,15130,15549,13070,-2479
2018,1,1,12,15630,16018,13492,-2526
2018,1,1,13,15980,16171,13678,-2493
2018,1,1,14,16450,16729,14244,-2485
2018,1,1,15,17240,17251,14887,-2364
2018,1,1,16,17460,17583,15525,-2058
2018,1,1,17,17720,17692,15431,-2261
2018,1,1,18,17840,17649,15279,-2370
2018,1,1,19,17750,17543,15360,-2183
2018,1,1,20,17770,17568,15467,-2101
2018,1,1,21,18130,17937,15664,-2273
2018,1,1,22,19230,19134,16614,-2520
2018,1,1,23,20500,20314,17736,-2578
2018,1,2,0,20340,20181,17678,-2503
2018,1,2,1,19710,19788,17236,-2552
2018,1,2,2,18880,19142,16574,-2568
2018,1,2,3,18060,18176,15458,-2718
2018,1,2,4,17110,16950,14460,-2490
2018,1,2,5,16250,16046,13124,-2922
2018,1,2,6,15420,15758,12976,-2782
2018,1,2,7,15090,15470,12826,-2644
2018,1,2,8,14980,15164,12516,-2648
2018,1,2,9,15010,15141,12585,-2556
2018,1,2,10,15380,15480,13130,-2350
2018,1,2,11,16400,16466,14299,-2167
2018,1,2,12,18180,17939,16215,-1724
2018,1,2,13,19310,19033,17591,-1442
2018,1,2,14,19440,19214,17427,-1787
2018,1,2,15,19120,19100,17067,-2033
2018,1,2,16,19010,18905,17121,-1784
2018,1,2,17,18760,18665,16753,-1912
2018,1,2,18,18620,18420,16630,-1790
2018,1,2,19,18460,18401,16483,-1918
2018,1,2,20,18270,18560,16657,-1903
2018,1,2,21,18610,18672,16712,-1960
2018,1,2,22,19310,19568,17618,-1950
2018,1,2,23,20700,20629,18724,-1905
2018,1,3,0,20570,20639,18535,-2104
2018,1,3,1,20010,20266,18050,-2216
2018,1,3,2,19220,19601,17376,-2225
2018,1,3,3,18140,18510,16207,-2303
2018,1,3,4,16720,17249,14761,-2488
2018,1,3,5,15500,16335,13607,-2728
2018,1,3,6,15040,15552,12911,-2641
2018,1,3,7,14630,15148,12665,-2483
2018,1,3,8,14480,15009,12483,-2526
2018,1,3,9,14520,14954,12660,-2294
2018,1,3,10,14850,15357,12849,-2508
2018,1,3,11,15880,15850,13627,-2223
2018,1,3,12,17640,17600,15293,-2307
2018,1,3,13,18660,18634,16353,-2281
2018,1,3,14,18600,18590,16092,-2498
2018,1,3,15,18210,18191,15639,-2552
2018,1,3,16,17950,17808,15112,-2696
2018,1,3,17,17630,17408,14763,-2645
2018,1,3,18,17350,17069,14375,-2694
2018,1,3,19,17440,17030,13940,-3090
2018,1,3,20,17500,17083,14236,-2847
2018,1,3,21,17640,17343,14392,-2951
2018,1,3,22,18600,18305,15087,-3218
2018,1,3,23,19800,19446,16680,-2766
2018,1,4,0,19700,19539,16976,-2563
2018,1,4,1,19360,19238,16699,-2539
2018,1,4,2,18740,18729,16051,-2678
2018,1,4,3,17730,17847,15243,-2604
2018,1,4,4,16360,16689,13972,-2717
2018,1,4,5,15090,15684,12894,-2790
2018,1,4,6,14420,15259,12143,-3116
2018,1,4,7,13990,15186,12018,-3168
2018,1,4,8,13780,14885,11816,-3069
2018,1,4,9,13730,14804,11565,-3239
2018,1,4,10,14030,15027,11653,-3374
2018,1,4,11,15000,15392,12075,-3317
2018,1,4,12,16720,15809,12655,-3154
2018,1,4,13,17710,16474,13554,-2920
2018,1,4,14,17910,17286,14523,-2763
2018,1,4,15,18190,18065,15281,-2784
2018,1,4,16,18380,18847,16020,-2827
2018,1,4,17,18830,19038,16045,-2993
2018,1,4,18,18750,18696,15559,-3137
2018,1,4,19,18800,18494,15213,-3281
2018,1,4,20,18680,18185,14955,-3230
2018,1,4,21,18970,18044,14948,-3096
2018,1,4,22,19300,18674,15330,-3344
2018,1,4,23,20000,19450,16369,-3081
2018,1,5,0,19960,19156,16021,-3135
2018,1,5,1,19660,18523,15284,-3239
2018,1,5,2,18970,17816,14723,-3093
2018,1,5,3,17900,16920,14079,-2841
2018,1,5,4,16470,16200,13150,-3050
2018,1,5,5,15210,15366,12334,-3032
2018,1,5,6,14330,14911,11995,-2916
2018,1,5,7,13950,14522,11695,-2827
2018,1,5,8,13810,14389,11295,-3094
2018,1,5,9,13840,14458,11115,-3343
2018,1,5,10,14160,14768,11469,-3299
2018,1,5,11,15050,15139,12044,-3095
2018,1,5,12,16440,16204,13357,-2847
2018,1,5,13,17400,17306,14415,-2891
2018,1,5,14,18090,17977,14646,-3331
2018,1,5,15,18320,18260,14933,-3327
2018,1,5,16,18270,18340,14886,-3454
2018,1,5,17,18000,18425,15013,-3412
2018,1,5,18,17860,18406,15018,-3388
2018,1,5,19,17710,18427,15077,-3350
2018,1,5,20,17640,18494,15367,-3127
2018,1,5,21,18200,18746,15548,-3198
2018,1,5,22,19390,19631,16278,-3353
2018,1,5,23,20450,20663,17477,-3186
2018,1,6,0,20110,20607,17284,-3323
2018,1,6,1,19670,20185,16938,-3247
2018,1,6,2,19030,19648,16395,-3253
2018,1,6,3,18240,18874,15811,-3063
2018,1,6,4,17190,17900,14608,-3292
2018,1,6,5,16140,16879,13331,-3548
2018,1,6,6,15690,16547,13305,-3242
2018,1,6,7,15290,16508,12985,-3523
2018,1,6,8,15070,16282,12824,-3458
2018,1,6,9,14950,16202,12826,-3376
2018,1,6,10,15130,16303,12831,-3472
2018,1,6,11,15520,16448,13046,-3402
2018,1,6,12,16230,16809,13520,-3289
2018,1,6,13,17050,17332,14188,-3144
2018,1,6,14,17890,18034,14868,-3166
2018,1,6,15,18630,18445,15212,-3233
2018,1,6,16,18520,18585,15582,-3003
2018,1,6,17,18470,18554,16049,-2505
2018,1,6,18,18370,18376,15665,-2711
2018,1,6,19,18220,18204,15478,-2726
2018,1,6,20,18050,18183,15219,-2964
2018,1,6,21,18400,18461,15668,-2793
2018,1,6,22,19760,19425,16768,-2657
2018,1,6,23,20750,20414,17644,-2770
2018,1,7,0,19940,20331,17757,-2574
2018,1,7,1,19470,19883,17045,-2838
2018,1,7,2,18970,19438,16789,-2649
2018,1,7,3,18310,18738,16031,-2707
2018,1,7,4,17370,17854,15119,-2735
2018,1,7,5,16310,16970,14299,-2671
2018,1,7,6,16210,16315,13655,-2660
2018,1,7,7,15750,16105,13520,-2585
2018,1,7,8,15590,16048,13377,-2671
2018,1,7,9,15490,16184,13516,-2668
2018,1,7,10,15720,16279,13762,-2517
2018,1,7,11,16030,16590,14035,-2555
2018,1,7,12,16590,16773,14138,-2635
2018,1,7,13,17180,17288,14790,-2498
2018,1,7,14,17760,17945,15751,-2194
2018,1,7,15,18500,18293,16434,-1859
2018,1,7,16,18720,18351,16265,-2086
2018,1,7,17,18230,18262,15869,-2393
2018,1,7,18,18260,18084,15238,-2846
2018,1,7,19,18180,17868,14647,-3221
2018,1,7,20,18100,17808,14385,-3423
2018,1,7,21,18180,18136,14872,-3264
2018,1,7,22,19230,19209,16004,-3205
2018,1,7,23,20650,20305,17343,-2962
2018,1,8,0,20260,20223,17099,-3124
2018,1,8,1,19480,19665,16521,-3144
2018,1,8,2,18760,18991,15920,-3071
2018,1,8,3,17930,17943,15114,-2829
2018,1,8,4,16940,16671,13627,-3044
2018,1,8,5,16110,15762,12227,-3535
2018,1,8,6,14800,15205,11568,-3637
2018,1,8,7,14360,14964,11491,-3473
2018,1,8,8,14150,14751,11403,-3348
2018,1,8,9,14120,14716,11335,-3381
2018,1,8,10,14430,14977,11718,-3259
2018,1,8,11,15390,15892,12602,-3290
2018,1,8,12,17060,17092,13984,-3108
2018,1,8,13,17960,17962,14897,-3065
2018,1,8,14,18120,18013,14980,-3033
2018,1,8,15,17900,17878,14952,-2926
2018,1,8,16,17770,17789,14949,-2840
2018,1,8,17,17630,17644,14618,-3026
2018,1,8,18,17530,17527,14567,-2960
2018,1,8,19,17480,17496,14654,-2842
2018,1,8,20,17440,17435,14362,-3073
2018,1,8,21,17830,17561,14486,-3075
2018,1,8,22,18900,18359,15224,-3135
2018,1,8,23,20000,19209,16482,-2727
2018,1,9,0,19730,19104,16319,-2785
2018,1,9,1,19080,18596,15830,-2766
2018,1,9,2,18220,17868,15153,-2715
2018,1,9,3,17010,16770,13753,-3017
2018,1,9,4,15480,15411,12199,-3212
2018,1,9,5,14270,14212,10892,-3320
2018,1,9,6,13420,13449,10130,-3319
2018,1,9,7,12970,13008,9709,-3299
2018,1,9,8,12800,12824,9476,-3348
2018,1,9,9,12820,12843,9548,-3295
2018,1,9,10,13150,13157,9899,-3258
2018,1,9,11,14110,14098,10839,-3259
2018,1,9,12,15810,15794,12852,-2942
2018,1,9,13,16740,16748,13350,-3398
2018,1,9,14,16690,16726,13220,-3506
2018,1,9,15,16320,16352,12967,-3385
2018,1,9,16,15940,15994,12377,-3617
2018,1,9,17,15690,15778,12167,-3611
2018,1,9,18,15640,15655,12183,-3472
2018,1,9,19,15610,15891,12445,-3446
2018,1,9,20,15700,15963,12685,-3278
2018,1,9,21,16090,16290,13002,-3288
2018,1,9,22,17320,17052,13713,-3339
2018,1,9,23,18400,18108,14610,-3498
2018,1,10,0,18340,18115,14579,-3536
2018,1,10,1,17950,17757,14238,-3519
2018,1,10,2,17340,17155,13559,-3596
2018,1,10,3,16370,16192,12615,-3577
2018,1,10,4,15100,14942,11479,-3463
2018,1,10,5,13950,14136,10588,-3548
2018,1,10,6,13140,13725,10025,-3700
2018,1,10,7,12810,13385,9725,-3660
2018,1,10,8,12700,13522,9849,-3673
2018,1,10,9,12790,13606,9913,-3693
2018,1,10,10,13210,13747,10091,-3656
2018,1,10,11,14310,14498,10993,-3505
2018,1,10,12,16190,16153,12417,-3736
2018,1,10,13,17160,17162,13475,-3687
2018,1,10,14,16950,16975,13291,-3684
2018,1,10,15,16300,16347,12686,-3661
2018,1,10,16,15910,15860,12256,-3604
2018,1,10,17,15720,15437,11920,-3517
2018,1,10,18,15490,15129,11690,-3439
2018,1,10,19,15450,15110,11656,-3454
2018,1,10,20,15460,15543,12113,-3430
2018,1,10,21,15830,15853,12073,-3780
2018,1,10,22,16970,16786,12865,-3921
2018,1,10,23,18540,17983,14125,-3858
2018,1,11,0,18470,18015,14170,-3845
2018,1,11,1,17630,17632,13942,-3690
2018,1,11,2,16900,17001,13266,-3735
2018,1,11,3,15790,15970,12189,-3781
2018,1,11,4,14420,14624,10872,-3752
2018,1,11,5,13670,13453,9703,-3750
2018,1,11,6,12520,12699,8976,-3723
2018,1,11,7,12100,12294,8490,-3804
2018,1,11,8,11910,12093,8330,-3763
2018,1,11,9,11880,12074,8172,-3902
2018,1,11,10,12230,12386,8464,-3922
2018,1,11,11,13180,13326,9462,-3864
2018,1,11,12,14890,15007,11276,-3731
2018,1,11,13,15770,15904,12076,-3828
2018,1,11,14,15720,15881,12027,-3854
2018,1,11,15,15650,15669,11876,-3793
2018,1,11,16,15470,15517,11742,-3775
2018,1,11,17,15240,15719,11733,-3986
2018,1,11,18,15090,15648,11751,-3897
2018,1,11,19,15150,15606,11689,-3917
2018,1,11,20,15170,15485,11572,-3913
2018,1,11,21,15470,15606,11717,-3889
2018,1,11,22,16520,16205,12324,-3881
2018,1,11,23,17200,16965,13335,-3630
2018,1,12,0,16900,16855,13262,-3593
2018,1,12,1,16490,16440,12655,-3785
2018,1,12,2,15900,15875,12132,-3743
2018,1,12,3,14890,15116,11479,-3637
2018,1,12,4,13600,13848,10462,-3386
2018,1,12,5,12430,13094,9894,-3200
2018,1,12,6,11680,12738,9496,-3242
2018,1,12,7,11260,12443,9273,-3170
2018,1,12,8,11030,12360,9200,-3160
2018,1,12,9,10990,12051,8993,-3058
2018,1,12,10,11290,12568,9446,-3122
2018,1,12,11,12200,13245,10156,-3089
2018,1,12,12,13810,14449,11412,-3037
2018,1,12,13,14780,14808,11984,-2824
2018,1,12,14,14970,14985,11942,-3043
2018,1,12,15,15080,15065,12237,-2828
2018,1,12,16,15010,15109,12404,-2705
2018,1,12,17,15000,15141,12481,-2660
2018,1,12,18,14860,15356,12589,-2767
2018,1,12,19,14840,15199,12583,-2616
2018,1,12,20,14950,15094,12660,-2434
2018,1,12,21,15150,15178,12504,-2674
2018,1,12,22,16130,15702,12902,-2800
2018,1,12,23,16520,16135,13477,-2658
2018,1,13,0,15990,15824,13377,-2447
2018,1,13,1,15340,15265,12546,-2719
2018,1,13,2,14680,14646,11822,-2824
2018,1,13,3,13750,13971,11166,-2805
2018,1,13,4,12780,13359,10466,-2893
2018,1,13,5,11700,12102,9464,-2638
2018,1,13,6,11050,11355,8719,-2636
2018,1,13,7,10560,10910,8308,-2602
2018,1,13,8,10300,10580,8193,-2387
2018,1,13,9,10210,10513,8092,-2421
2018,1,13,10,10310,10866,8174,-2692
2018,1,13,11,10720,11475,8231,-3244
2018,1,13,12,11350,11924,8476,-3448
2018,1,13,13,12190,12604,9164,-3440
2018,1,13,14,13070,13032,9893,-3139
2018,1,13,15,13730,13643,10686,-2957
2018,1,13,16,14160,13765,10972,-2793
2018,1,13,17,14280,13473,10645,-2828
2018,1,13,18,14300,13262,10462,-2800
2018,1,13,19,14230,13443,10621,-2822
2018,1,13,20,14230,13991,11038,-2953
2018,1,13,21,14580,14432,11365,-3067
2018,1,13,22,15520,15376,12203,-3173
2018,1,13,23,16350,16581,13534,-3047
2018,1,14,0,16210,16650,13722,-2928
2018,1,14,1,15920,16314,13446,-2868
2018,1,14,2,15750,15952,12909,-3043
2018,1,14,3,15130,15378,12575,-2803
2018,1,14,4,14360,14763,12282,-2481
2018,1,14,5,13420,14031,11456,-2575
2018,1,14,6,13370,13407,10943,-2464
2018,1,14,7,13000,13409,10623,-2786
2018,1,14,8,12850,13606,10453,-3153
2018,1,14,9,12790,13334,10409,-2925
2018,1,14,10,12920,13817,10721,-3096
2018,1,14,11,13250,13607,10606,-3001
2018,1,14,12,13840,14089,11390,-2699
2018,1,14,13,14480,14548,11495,-3053
2018,1,14,14,15140,15106,12499,-2607
2018,1,14,15,15310,15309,12305,-3004
2018,1,14,16,15310,15237,12268,-2969
2018,1,14,17,15150,15085,12210,-2875
2018,1,14,18,14970,15186,12287,-2899
2018,1,14,19,14800,15281,12128,-3153
2018,1,14,20,14910,15761,12421,-3340
2018,1,14,21,15360,16322,12977,-3345
2018,1,14,22,16940,16830,13627,-3203
2018,1,14,23,18440,18085,15229,-2856
2018,1,15,0,18230,18064,15362,-2702
2018,1,15,1,17600,17627,15041,-2586
2018,1,15,2,17430,17162,14160,-3002
2018,1,15,3,16760,16480,13662,-2818
2018,1,15,4,15750,15505,12468,-3037
2018,1,15,5,14710,14635,11612,-3023
2018,1,15,6,13690,14343,11231,-3112
2018,1,15,7,13190,14521,11096,-3425
2018,1,15,8,13030,14409,10963,-3446
2018,1,15,9,13090,14439,11132,-3307
2018,1,15,10,13410,14526,11725,-2801
2018,1,15,11,14040,14835,12358,-2477
2018,1,15,12,15050,15935,13004,-2931
2018,1,15,13,16020,16951,14642,-2309
2018,1,15,14,16810,17647,14808,-2839
2018,1,15,15,18000,17990,15105,-2885
2018,1,15,16,18100,18189,14993,-3196
2018,1,15,17,18050,18374,15138,-3236
2018,1,15,18,17900,18369,15416,-2953
2018,1,15,19,17750,18343,15275,-3068
2018,1,15,20,17600,18272,15310,-2962
2018,1,15,21,17770,18382,15437,-2945
2018,1,15,22,18110,19046,16559,-2487
2018,1,15,23,19380,19837,17819,-2018
2018,1,16,0,19130,19598,17390,-2208
2018,1,16,1,18610,19028,16692,-2336
2018,1,16,2,17830,18280,15706,-2574
2018,1,16,3,16690,17135,14550,-2585
2018,1,16,4,15350,15775,12799,-2976
2018,1,16,5,14170,14888,11844,-3044
2018,1,16,6,13830,14215,10634,-3581
2018,1,16,7,13390,13799,10107,-3692
2018,1,16,8,13260,13622,9813,-3809
2018,1,16,9,13260,13642,9875,-3767
2018,1,16,10,13570,13988,10277,-3711
2018,1,16,11,14590,14712,10948,-3764
2018,1,16,12,16360,16464,12968,-3496
2018,1,16,13,17250,17411,13983,-3428
2018,1,16,14,17280,17299,13667,-3632
2018,1,16,15,17020,17009,13302,-3707
2018,1,16,16,16770,16817,13415,-3402
2018,1,16,17,16580,16420,13192,-3228
2018,1,16,18,16320,16290,13257,-3033
2018,1,16,19,16300,16357,13252,-3105
2018,1,16,20,16270,16444,13372,-3072
2018,1,16,21,16550,16637,13316,-3321
2018,1,16,22,17240,17336,13783,-3553
2018,1,16,23,18300,18303,14840,-3463
2018,1,17,0,18270,18241,14966,-3275
2018,1,17,1,17860,17763,14546,-3217
2018,1,17,2,17100,17057,13669,-3388
2018,1,17,3,16010,15993,12841,-3152
2018,1,17,4,14700,14752,11530,-3222
2018,1,17,5,13520,13649,10166,-3483
2018,1,17,6,12870,12911,9491,-3420
2018,1,17,7,12470,12726,9569,-3157
2018,1,17,8,12270,12554,9346,-3208
2018,1,17,9,12270,12788,9490,-3298
2018,1,17,10,12600,12949,9788,-3161
2018,1,17,11,13700,13504,10417,-3087
2018,1,17,12,15470,14929,12035,-2894
2018,1,17,13,16570,15945,13026,-2919
2018,1,17,14,16550,16391,13697,-2694
2018,1,17,15,16670,16715,14228,-2487
2018,1,17,16,16630,16939,14349,-2590
2018,1,17,17,16620,17046,14261,-2785
2018,1,17,18,16510,17037,14114,-2923
2018,1,17,19,16480,17009,14122,-2887
2018,1,17,20,16430,16827,13891,-2936
2018,1,17,21,16620,16829,13976,-2853
2018,1,17,22,17340,17465,14907,-2558
2018,1,17,23,18400,18300,15678,-2622
2018,1,18,0,18260,18136,15298,-2838
2018,1,18,1,17810,17621,14812,-2809
2018,1,18,2,17160,16894,14015,-2879
2018,1,18,3,16280,15855,12781,-3074
2018,1,18,4,15140,14607,11580,-3027
2018,1,18,5,14040,13543,10763,-2780
2018,1,18,6,12930,13130,10375,-2755
2018,1,18,7,12610,13197,10299,-2898
2018,1,18,8,12530,13101,10269,-2832
2018,1,18,9,12640,13209,10460,-2749
2018,1,18,10,13100,13648,11231,-2417
2018,1,18,11,14240,14541,12032,-2509
2018,1,18,12,16090,16059,13823,-2236
2018,1,18,13,17100,17107,14792,-2315
2018,1,18,14,17040,17063,14276,-2787
2018,1,18,15,16700,16714,14034,-2680
2018,1,18,16,16320,16363,13734,-2629
2018,1,18,17,15940,15989,13637,-2352
2018,1,18,18,15730,16113,13526,-2587
2018,1,18,19,15740,15993,13404,-2589
2018,1,18,20,15910,15919,13095,-2824
2018,1,18,21,16380,16270,13411,-2859
2018,1,18,22,17330,16871,13919,-2952
2018,1,18,23,18500,18059,15288,-2771
2018,1,19,0,18350,18128,15430,-2698
2018,1,19,1,17860,17812,14871,-2941
2018,1,19,2,17370,17242,14543,-2699
2018,1,19,3,16430,16301,13748,-2553
2018,1,19,4,15210,15057,12398,-2659
2018,1,19,5,14120,14007,11438,-2569
2018,1,19,6,13310,13344,10442,-2902
2018,1,19,7,12890,13176,10290,-2886
2018,1,19,8,12700,13112,10318,-2794
2018,1,19,9,12810,13136,10314,-2822
2018,1,19,10,13220,13299,10518,-2781
2018,1,19,11,14260,14199,11434,-2765
2018,1,19,12,16150,15914,13190,-2724
2018,1,19,13,17060,16895,13921,-2974
2018,1,19,14,16910,16853,13875,-2978
2018,1,19,15,16550,16561,13658,-2903
2018,1,19,16,16150,16310,13343,-2967
2018,1,19,17,15940,16016,13040,-2976
2018,1,19,18,15730,15724,12716,-3008
2018,1,19,19,15720,16107,13179,-2928
2018,1,19,20,15890,16255,13419,-2836
2018,1,19,21,16170,16123,13341,-2782
2018,1,19,22,16870,16501,13716,-2785
2018,1,19,23,18000,17352,14571,-2781
2018,1,20,0,17750,17207,14375,-2832
2018,1,20,1,17300,16750,13918,-2832
2018,1,20,2,16740,16185,13368,-2817
2018,1,20,3,15920,15450,12647,-2803
2018,1,20,4,14810,14452,11765,-2687
2018,1,20,5,13680,13743,11003,-2740
2018,1,20,6,12720,12786,10248,-2538
2018,1,20,7,12240,12480,9877,-2603
2018,1,20,8,11990,12494,9759,-2735
2018,1,20,9,11880,12693,9875,-2818
2018,1,20,10,11980,12807,9913,-2894
2018,1,20,11,12360,12921,10008,-2913
2018,1,20,12,13030,13298,10684,-2614
2018,1,20,13,13730,13904,11198,-2706
2018,1,20,14,14270,14283,11491,-2792
2018,1,20,15,14440,14373,11563,-2810
2018,1,20,16,14420,14315,11504,-2811
2018,1,20,17,14240,14182,11419,-2763
2018,1,20,18,14050,14178,11523,-2655
2018,1,20,19,13940,14086,11308,-2778
2018,1,20,20,14030,14098,11476,-2622
2018,1,20,21,14280,14110,11446,-2664
2018,1,20,22,15050,14614,11894,-2720
2018,1,20,23,15920,15652,12843,-2809
2018,1,21,0,15870,15588,12878,-2710
2018,1,21,1,15480,15155,12690,-2465
2018,1,21,2,15010,14663,12203,-2460
2018,1,21,3,14370,14050,11587,-2463
2018,1,21,4,13530,13224,10843,-2381
2018,1,21,5,12690,12506,10015,-2491
2018,1,21,6,11730,12012,9342,-2670
2018,1,21,7,11340,12013,9328,-2685
2018,1,21,8,11140,12197,9541,-2656
2018,1,21,9,11070,12151,9710,-2441
2018,1,21,10,11150,12208,9668,-2540
2018,1,21,11,11450,12508,9926,-2582
2018,1,21,12,12000,12787,10098,-2689
2018,1,21,13,12620,13225,10519,-2706
2018,1,21,14,13170,13176,10311,-2865
2018,1,21,15,13290,13259,10217,-3042
2018,1,21,16,13360,13102,10143,-2959
2018,1,21,17,13430,12924,10162,-2762
2018,1,21,18,13470,13093,10390,-2703
2018,1,21,19,13380,13120,10448,-2672
2018,1,21,20,13460,13374,10488,-2886
2018,1,21,21,13840,13796,10842,-2954
2018,1,21,22,14860,14398,11491,-2907
2018,1,21,23,16160,15359,12487,-2872
2018,1,22,0,16200,15531,12618,-2913
2018,1,22,1,15730,15400,12486,-2914
2018,1,22,2,15150,14875,12042,-2833
2018,1,22,3,14210,14007,10993,-3014
2018,1,22,4,13140,12927,9984,-2943
2018,1,22,5,12200,12260,9222,-3038
2018,1,22,6,11400,11547,8813,-2734
2018,1,22,7,11050,11332,8839,-2493
2018,1,22,8,10910,11197,8911,-2286
2018,1,22,9,10970,11243,8657,-2586
2018,1,22,10,11390,11497,8767,-2730
2018,1,22,11,12480,12456,9868,-2588
2018,1,22,12,14260,14234,11711,-2523
2018,1,22,13,15400,15410,12746,-2664
2018,1,22,14,15710,15728,12945,-2783
2018,1,22,15,15850,15885,12897,-2988
2018,1,22,16,15920,15987,13032,-2955
2018,1,22,17,15960,16084,13310,-2774
2018,1,22,18,15910,16045,13287,-2758
2018,1,22,19,15890,16040,13295,-2745
2018,1,22,20,15890,15949,13197,-2752
2018,1,22,21,16110,16023,13297,-2726
2018,1,22,22,16820,16661,13891,-2770
2018,1,22,23,17630,17432,14564,-2868
2018,1,23,0,17400,17286,14462,-2824
2018,1,23,1,16850,16784,13935,-2849
2018,1,23,2,16060,16048,13276,-2772
2018,1,23,3,14930,14973,12165,-2808
2018,1,23,4,13620,13669,10700,-2969
2018,1,23,5,12500,12857,9903,-2954
2018,1,23,6,11850,12169,9460,-2709
2018,1,23,7,11470,11907,9204,-2703
2018,1,23,8,11310,12230,9370,-2860
2018,1,23,9,11330,12370,9513,-2857
2018,1,23,10,11690,12463,9656,-2807
2018,1,23,11,12680,12949,10158,-2791
2018,1,23,12,14360,14328,11684,-2644
2018,1,23,13,15480,15487,12657,-2830
2018,1,23,14,15860,15877,13083,-2794
2018,1,23,15,16110,16113,13297,-2816
2018,1,23,16,16070,16316,13500,-2816
2018,1,23,17,16010,16394,13593,-2801
2018,1,23,18,15790,16287,13543,-2744
2018,1,23,19,15740,16191,13452,-2739
2018,1,23,20,15460,15890,13156,-2734
2018,1,23,21,15460,15659,12810,-2849
2018,1,23,22,15620,16052,13200,-2852
2018,1,23,23,16700,16856,14162,-2694
2018,1,24,0,16440,16776,13992,-2784
2018,1,24,1,15930,16259,13447,-2812
2018,1,24,2,15220,15553,12810,-2743
2018,1,24,3,14260,14562,11777,-2785
2018,1,24,4,13070,13624,10779,-2845
2018,1,24,5,12000,12572,9849,-2723
2018,1,24,6,11640,12613,9767,-2846
2018,1,24,7,11280,12523,9616,-2907
2018,1,24,8,11140,12463,9636,-2827
2018,1,24,9,11190,12483,9733,-2750
2018,1,24,10,11560,12835,9988,-2847
2018,1,24,11,12580,13350,10662,-2688
2018,1,24,12,14350,14593,12035,-2558
2018,1,24,13,15300,15413,12691,-2722
2018,1,24,14,15270,15288,12834,-2454
2018,1,24,15,15250,15218,13070,-2148
2018,1,24,16,14830,15023,12281,-2742
2018,1,24,17,14620,14516,11722,-2794
2018,1,24,18,14480,14083,11262,-2821
2018,1,24,19,14530,14180,11830,-2350
2018,1,24,20,14840,14379,12646,-1733
2018,1,24,21,15220,15004,12991,-2013
2018,1,24,22,16020,16035,13573,-2462
2018,1,24,23,17480,17379,14552,-2827
2018,1,25,0,17230,17579,14727,-2852
2018,1,25,1,16880,17263,14374,-2889
2018,1,25,2,16270,16723,13831,-2892
2018,1,25,3,15280,15818,12867,-2951
2018,1,25,4,14060,14670,11822,-2848
2018,1,25,5,12990,13814,11046,-2768
2018,1,25,6,12570,12941,10040,-2901
2018,1,25,7,12240,12633,9764,-2869
2018,1,25,8,12140,12789,9756,-3033
2018,1,25,9,12200,12867,9875,-2992
2018,1,25,10,12580,13004,10180,-2824
2018,1,25,11,13710,14078,11355,-2723
2018,1,25,12,15550,15938,13174,-2764
2018,1,25,13,16520,16914,13980,-2934
2018,1,25,14,16280,16593,13794,-2799
2018,1,25,15,15940,15958,13300,-2658
2018,1,25,16,15580,15413,12463,-2950
2018,1,25,17,15270,15054,12136,-2918
2018,1,25,18,15120,14826,11916,-2910
2018,1,25,19,15080,14859,11993,-2866
2018,1,25,20,15200,15404,12505,-2899
2018,1,25,21,15630,15942,13064,-2878
2018,1,25,22,16530,16944,14241,-2703
2018,1,25,23,18300,18223,15443,-2780
2018,1,26,0,18530,18400,15273,-3127
2018,1,26,1,17720,18079,14972,-3107
2018,1,26,2,17150,17490,14566,-2924
2018,1,26,3,16190,16539,13467,-3072
2018,1,26,4,14950,15327,12180,-3147
2018,1,26,5,13810,14510,11322,-3188
2018,1,26,6,13300,14103,11040,-3063
2018,1,26,7,12910,13734,10695,-3039
2018,1,26,8,12790,13608,10610,-2998
2018,1,26,9,12820,13662,10739,-2923
2018,1,26,10,13140,14012,11102,-2910
2018,1,26,11,14200,14813,11910,-2903
2018,1,26,12,15990,16350,13261,-3089
2018,1,26,13,16860,17224,14149,-3075
2018,1,26,14,16600,16824,13824,-3000
2018,1,26,15,16110,16031,13103,-2928
2018,1,26,16,15710,15450,12688,-2762
2018,1,26,17,15440,15018,12259,-2759
2018,1,26,18,15090,14670,12005,-2665
2018,1,26,19,14860,14640,12031,-2609
2018,1,26,20,14870,14943,12289,-2654
2018,1,26,21,15360,15232,12507,-2725
2018,1,26,22,16110,16108,13252,-2856
2018,1,26,23,17500,17230,14171,-3059
2018,1,27,0,17360,17278,14229,-3049
2018,1,27,1,16700,16864,13894,-2970
2018,1,27,2,16170,16324,13490,-2834
2018,1,27,3,15400,15592,12723,-2869
2018,1,27,4,14410,14635,11809,-2826
2018,1,27,5,13410,13645,11085,-2560
2018,1,27,6,12840,12958,10474,-2484
2018,1,27,7,12400,12547,10181,-2366
2018,1,27,8,12150,12332,9812,-2520
2018,1,27,9,12060,12235,9672,-2563
2018,1,27,10,12170,12341,9875,-2466
2018,1,27,11,12530,12731,10224,-2507
2018,1,27,12,13340,13470,10775,-2695
2018,1,27,13,13920,14107,11407,-2700
2018,1,27,14,14490,14410,11660,-2750
2018,1,27,15,14060,14115,11379,-2736
2018,1,27,16,13910,13750,11425,-2325
2018,1,27,17,13740,13456,11145,-2311
2018,1,27,18,13510,13594,11371,-2223
2018,1,27,19,13400,13725,11336,-2389
2018,1,27,20,13470,13988,11673,-2315
2018,1,27,21,14040,14171,11869,-2302
2018,1,27,22,14820,14517,12273,-2244
2018,1,27,23,16300,15373,12833,-2540
2018,1,28,0,16070,15268,12588,-2680
2018,1,28,1,15190,14762,12144,-2618
2018,1,28,2,14630,14190,11735,-2455
2018,1,28,3,13940,13754,11242,-2512
2018,1,28,4,13090,12953,10182,-2771
2018,1,28,5,12190,12351,9343,-3008
2018,1,28,6,11080,11747,9169,-2578
2018,1,28,7,10570,11731,9401,-2330
2018,1,28,8,10320,11469,9292,-2177
2018,1,28,9,10240,11357,9203,-2154
2018,1,28,10,10240,11406,9052,-2354
2018,1,28,11,10550,11660,9196,-2464
2018,1,28,12,11040,12155,9653,-2502
2018,1,28,13,11670,12582,10070,-2512
2018,1,28,14,12360,13046,10561,-2485
2018,1,28,15,13130,13376,10949,-2427
2018,1,28,16,13250,13552,11050,-2502
2018,1,28,17,13260,13495,11028,-2467
2018,1,28,18,13240,13496,11003,-2493
2018,1,28,19,13160,13418,11060,-2358
2018,1,28,20,13120,13661,11308,-2353
2018,1,28,21,13430,13728,11317,-2411
2018,1,28,22,14220,14440,11977,-2463
2018,1,28,23,15360,15557,13030,-2527
2018,1,29,0,15700,15573,13164,-2409
2018,1,29,1,14920,15142,13001,-2141
2018,1,29,2,14350,14511,12209,-2302
2018,1,29,3,13460,13643,10886,-2757
2018,1,29,4,12460,12601,9603,-2998
2018,1,29,5,11520,11931,8856,-3075
2018,1,29,6,11090,11371,8699,-2672
2018,1,29,7,10770,11093,8649,-2444
2018,1,29,8,10670,11201,8915,-2286
2018,1,29,9,10760,11290,9132,-2158
2018,1,29,10,11200,11394,9232,-2162
2018,1,29,11,12330,12306,10014,-2292
2018,1,29,12,14190,14157,11619,-2538
2018,1,29,13,15250,15259,12462,-2797
2018,1,29,14,15360,15376,12544,-2832
2018,1,29,15,15250,15311,12509,-2802
2018,1,29,16,15190,15263,12472,-2791
2018,1,29,17,14990,15050,12430,-2620
2018,1,29,18,15000,14824,12214,-2610
2018,1,29,19,14950,14986,12335,-2651
2018,1,29,20,15070,15183,12566,-2617
2018,1,29,21,15250,15494,12892,-2602
2018,1,29,22,16100,16231,13576,-2655
2018,1,29,23,17280,17324,14705,-2619
2018,1,30,0,17350,17351,14775,-2576
2018,1,30,1,17050,16882,14375,-2507
2018,1,30,2,16350,16209,13606,-2603
2018,1,30,3,15400,15219,12485,-2734
2018,1,30,4,14140,13988,11142,-2846
2018,1,30,5,13060,13216,10167,-3049
2018,1,30,6,12330,12843,9620,-3223
2018,1,30,7,12010,12546,9444,-3102
2018,1,30,8,11910,12662,9442,-3220
2018,1,30,9,12000,12707,9504,-3203
2018,1,30,10,12400,12894,9823,-3071
2018,1,30,11,13500,13499,10498,-3001
2018,1,30,12,15230,15200,12018,-3182
2018,1,30,13,16270,16269,13044,-3225
2018,1,30,14,16650,16658,13352,-3306
2018,1,30,15,16820,16836,13517,-3319
2018,1,30,16,16870,16904,13582,-3322
2018,1,30,17,16790,16849,13583,-3266
2018,1,30,18,16560,16630,13435,-3195
2018,1,30,19,16450,16462,13534,-2928
2018,1,30,20,16410,16314,13484,-2830
2018,1,30,21,16360,16343,13493,-2850
2018,1,30,22,16710,16888,13958,-2930
2018,1,30,23,17260,17998,15023,-2975
2018,1,31,0,17800,18071,15103,-2968
2018,1,31,1,17350,17637,14788,-2849
2018,1,31,2,16790,17021,14282,-2739
2018,1,31,3,15780,16037,13135,-2902
2018,1,31,4,14500,14879,11822,-3057
2018,1,31,5,13570,14019,11110,-2909
2018,1,31,6,13150,13211,10191,-3020
2018,1,31,7,12840,13125,10147,-2978
2018,1,31,8,12730,13058,10088,-2970
2018,1,31,9,12850,13124,10134,-2990
2018,1,31,10,13270,13574,10755,-2819
2018,1,31,11,14370,14430,11557,-2873
2018,1,31,12,16100,16244,13292,-2952
2018,1,31,13,17070,17167,13792,-3375
2018,1,31,14,16850,16943,13588,-3355
2018,1,31,15,16540,16392,13084,-3308
2018,1,31,16,16140,15934,12756,-3178
2018,1,31,17,15820,15522,12511,-3011
2018,1,31,18,15440,15234,12230,-3004
2018,1,31,19,15330,15085,11995,-3090
2018,1,31,20,15450,15205,12159,-3046
2018,1,31,21,15750,15894,12996,-2898
2018,1,31,22,16630,16543,13669,-2874
2018,1,31,23,17900,17796,14716,-3080
2018,2,1,0,18030,17938,14920,-3018
2018,2,1,1,17650,17527,14599,-2928
2018,2,1,2,16930,16864,14109,-2755
2018,2,1,3,15930,15833,13002,-2831
2018,2,1,4,14690,14537,11591,-2946
2018,2,1,5,13560,13568,10721,-2847
2018,2,1,6,12650,12936,10130,-2806
2018,2,1,7,12250,12520,9755,-2765
2018,2,1,8,12030,12294,9524,-2770
2018,2,1,9,12020,12284,9510,-2774
2018,2,1,10,12350,12610,9908,-2702
2018,2,1,11,13380,13393,10686,-2707
2018,2,1,12,15110,15078,12342,-2736
2018,2,1,13,16030,16031,13222,-2809
2018,2,1,14,16150,16151,13309,-2842
2018,2,1,15,16090,16076,13260,-2816
2018,2,1,16,15830,15827,13169,-2658
2018,2,1,17,15510,15497,12907,-2590
2018,2,1,18,15320,15230,12667,-2563
2018,2,1,19,15280,15190,12585,-2605
2018,2,1,20,15270,15303,12771,-2532
2018,2,1,21,15450,15569,13069,-2500
2018,2,1,22,16120,16014,13494,-2520
2018,2,1,23,17140,16903,14454,-2449
2018,2,2,0,17200,16872,14161,-2711
2018,2,2,1,16650,16469,13801,-2668
2018,2,2,2,15960,15842,13091,-2751
2018,2,2,3,14940,15166,12405,-2761
2018,2,2,4,13680,14401,11553,-2848
2018,2,2,5,12580,13617,10648,-2969
2018,2,2,6,11860,12959,9805,-3154
2018,2,2,7,11490,12693,9532,-3161
2018,2,2,8,11310,12629,9528,-3101
2018,2,2,9,11350,12657,9601,-3056
2018,2,2,10,11760,12992,9975,-3017
2018,2,2,11,12810,13374,10468,-2906
2018,2,2,12,14470,14944,12080,-2864
2018,2,2,13,15650,15699,12799,-2900
2018,2,2,14,16180,16203,13409,-2794
2018,2,2,15,16380,16349,13512,-2837
2018,2,2,16,16280,16256,13468,-2788
2018,2,2,17,15960,15931,13114,-2817
2018,2,2,18,15730,15659,12810,-2849
2018,2,2,19,15660,15652,12797,-2855
2018,2,2,20,15620,15752,12989,-2763
2018,2,2,21,15840,16046,13308,-2738
2018,2,2,22,16580,16766,14012,-2754
2018,2,2,23,17740,17867,15254,-2613
2018,2,3,0,17940,18090,15419,-2671
2018,2,3,1,17370,17813,14981,-2832
2018,2,3,2,16830,17406,14637,-2769
2018,2,3,3,16070,16723,13941,-2782
2018,2,3,4,15160,15774,12963,-2811
2018,2,3,5,14210,14826,11994,-2832
2018,2,3,6,14170,14173,11460,-2713
2018,2,3,7,13680,13789,10959,-2830
2018,2,3,8,13510,13607,10616,-2991
2018,2,3,9,13440,13562,10632,-2930
2018,2,3,10,13660,13717,10739,-2978
2018,2,3,11,14050,14149,11204,-2945
2018,2,3,12,14490,14882,12023,-2859
2018,2,3,13,15430,15606,12840,-2766
2018,2,3,14,15960,16034,13527,-2507
2018,2,3,15,16040,16011,13515,-2496
2018,2,3,16,15870,15722,12976,-2746
2018,2,3,17,15500,15347,12481,-2866
2018,2,3,18,15160,14935,12125,-2810
2018,2,3,19,14920,14666,11890,-2776
2018,2,3,20,14980,14896,11992,-2904
2018,2,3,21,15420,15153,12219,-2934
2018,2,3,22,16080,15842,12964,-2878
2018,2,3,23,17050,17023,14052,-2971
2018,2,4,0,17200,17195,14166,-3029
2018,2,4,1,16730,16777,13790,-2987
2018,2,4,2,16180,16289,13444,-2845
2018,2,4,3,15500,15589,12808,-2781
2018,2,4,4,14620,14671,11886,-2785
2018,2,4,5,13790,13755,10939,-2816
2018,2,4,6,13100,13294,10538,-2756
2018,2,4,7,12660,12822,10196,-2626
2018,2,4,8,12360,12608,9977,-2631
2018,2,4,9,12230,12665,10004,-2661
2018,2,4,10,12260,12671,9986,-2685
2018,2,4,11,12550,12873,10186,-2687
2018,2,4,12,12800,13157,10532,-2625
2018,2,4,13,13570,13652,10957,-2695
2018,2,4,14,14370,14232,11488,-2744
2018,2,4,15,14680,14681,11841,-2840
2018,2,4,16,14820,14753,12005,-2748
2018,2,4,17,14860,14806,12060,-2746
2018,2,4,18,14800,15079,12184,-2895
2018,2,4,19,14760,15210,12142,-3068
2018,2,4,20,14750,15478,12342,-3136
2018,2,4,21,15040,15687,12593,-3094
2018,2,4,22,15820,16041,12993,-3048
2018,2,4,23,16380,16586,13319,-3267
2018,2,5,0,15990,15885,12715,-3170
2018,2,5,1,15170,14889,11666,-3223
2018,2,5,2,14670,14375,11134,-3241
2018,2,5,3,14070,13951,10536,-3415
2018,2,5,4,13140,13762,10449,-3313
2018,2,5,5,12240,12948,9962,-2986
2018,2,5,6,11330,12494,9385,-3109
2018,2,5,7,10900,12277,9124,-3153
2018,2,5,8,10760,12359,9198,-3161
2018,2,5,9,10770,12313,9216,-3097
2018,2,5,10,11190,12384,9269,-3115
2018,2,5,11,12250,12931,9989,-2942
2018,2,5,12,14080,14158,11332,-2826
2018,2,5,13,15030,14704,11713,-2991
2018,2,5,14,15090,14781,11737,-3044
2018,2,5,15,14720,14734,11672,-3062
2018,2,5,16,14510,14799,11760,-3039
2018,2,5,17,14350,14536,11407,-3129
2018,2,5,18,14210,14220,11151,-3069
2018,2,5,19,14220,14073,11189,-2884
2018,2,5,20,14370,14078,11402,-2676
2018,2,5,21,14800,14668,11828,-2840
2018,2,5,22,15550,15758,12573,-3185
2018,2,5,23,17100,17200,14064,-3136
2018,2,6,0,17500,17603,14368,-3235
2018,2,6,1,17140,17259,13964,-3295
2018,2,6,2,16470,16675,13436,-3239
2018,2,6,3,15440,15681,12501,-3180
2018,2,6,4,14160,14453,11353,-3100
2018,2,6,5,13090,13462,10471,-2991
2018,2,6,6,12830,12848,9884,-2964
2018,2,6,7,12520,12779,9871,-2908
2018,2,6,8,12380,12643,9773,-2870
2018,2,6,9,12400,12660,9860,-2800
2018,2,6,10,12750,12978,10257,-2721
2018,2,6,11,13790,13760,11166,-2594
2018,2,6,12,15570,15530,13066,-2464
2018,2,6,13,16510,16511,13972,-2539
2018,2,6,14,16600,16615,13970,-2645
2018,2,6,15,16600,16623,13888,-2735
2018,2,6,16,16400,16534,13880,-2654
2018,2,6,17,16120,16099,13495,-2604
2018,2,6,18,15710,15701,13111,-2590
2018,2,6,19,15420,15796,13368,-2428
2018,2,6,20,15440,15718,12953,-2765
2018,2,6,21,15710,15562,12731,-2831
2018,2,6,22,16500,16152,13384,-2768
2018,2,6,23,17460,17294,14446,-2848
2018,2,7,0,17610,17577,14739,-2838
2018,2,7,1,17220,17190,14359,-2831
2018,2,7,2,16600,16591,13784,-2807
2018,2,7,3,15580,15649,12883,-2766
2018,2,7,4,14340,14469,11533,-2936
2018,2,7,5,13360,13419,10724,-2695
2018,2,7,6,12590,13184,10303,-2881
2018,2,7,7,12200,13302,10412,-2890
2018,2,7,8,12070,13181,10334,-2847
2018,2,7,9,12080,13230,10403,-2827
2018,2,7,10,12490,13601,10843,-2758
2018,2,7,11,13600,14272,11579,-2693
2018,2,7,12,15170,15341,12940,-2401
2018,2,7,13,16260,16217,13760,-2457
2018,2,7,14,16410,16492,13826,-2666
2018,2,7,15,16480,16724,14074,-2650
2018,2,7,16,16690,17139,14582,-2557
2018,2,7,17,17520,17435,14695,-2740
2018,2,7,18,17480,17511,14758,-2753
2018,2,7,19,17520,17438,14616,-2822
2018,2,7,20,17540,17222,14467,-2755
2018,2,7,21,17590,17142,14397,-2745
2018,2,7,22,17640,17481,14760,-2721
2018,2,7,23,17900,18176,15541,-2635
2018,2,8,0,17780,17923,15230,-2693
2018,2,8,1,17120,17197,14378,-2819
2018,2,8,2,16360,16290,13439,-2851
2018,2,8,3,15310,15161,12121,-3040
2018,2,8,4,14100,13925,10702,-3223
2018,2,8,5,13050,13308,10138,-3170
2018,2,8,6,12340,13131,10112,-3019
2018,2,8,7,12030,12839,9841,-2998
2018,2,8,8,11930,12830,9838,-2992
2018,2,8,9,12030,12989,10060,-2929
2018,2,8,10,12450,13033,10177,-2856
2018,2,8,11,13580,13565,10642,-2923
2018,2,8,12,15320,15245,12538,-2707
2018,2,8,13,16240,16227,13284,-2943
2018,2,8,14,16030,16378,13311,-3067
2018,2,8,15,15750,16012,12934,-3078
2018,2,8,16,15190,15631,12668,-2963
2018,2,8,17,14850,15378,12286,-3092
2018,2,8,18,14690,15156,12026,-3130
2018,2,8,19,14660,15034,11896,-3138
2018,2,8,20,14760,15008,12277,-2731
2018,2,8,21,15260,15262,12792,-2470
2018,2,8,22,16070,16023,13390,-2633
2018,2,8,23,17320,17248,14499,-2749
2018,2,9,0,17740,17617,14919,-2698
2018,2,9,1,17410,17336,14699,-2637
2018,2,9,2,16890,16780,14257,-2523
2018,2,9,3,15980,15864,13396,-2468
2018,2,9,4,14780,14675,12126,-2549
2018,2,9,5,13760,13664,11086,-2578
2018,2,9,6,13020,13042,10527,-2515
2018,2,9,7,12720,12742,10316,-2426
2018,2,9,8,12620,12639,10276,-2363
2018,2,9,9,12700,12707,10366,-2341
2018,2,9,10,13110,13113,10884,-2229
2018,2,9,11,14100,14135,11895,-2240
2018,2,9,12,15780,15925,13692,-2233
2018,2,9,13,16760,16766,14279,-2487
2018,2,9,14,16510,16549,14262,-2287
2018,2,9,15,16210,16167,13889,-2278
2018,2,9,16,16100,15880,13403,-2477
2018,2,9,17,15910,15597,13015,-2582
2018,2,9,18,15600,15496,12987,-2509
2018,2,9,19,15520,15522,13002,-2520
2018,2,9,20,15520,15663,13136,-2527
2018,2,9,21,15660,15877,13298,-2579
2018,2,9,22,16170,16282,13555,-2727
2018,2,9,23,17100,17119,14456,-2663
2018,2,10,0,17200,17171,14385,-2786
2018,2,10,1,16700,16725,14025,-2700
2018,2,10,2,16010,16153,13427,-2726
2018,2,10,3,15200,15352,12687,-2665
2018,2,10,4,14230,14303,11687,-2616
2018,2,10,5,13260,13270,10674,-2596
2018,2,10,6,12470,12523,10123,-2400
2018,2,10,7,12040,12296,9873,-2423
2018,2,10,8,11830,12296,9908,-2388
2018,2,10,9,11680,12430,10008,-2422
2018,2,10,10,11790,12513,10083,-2430
2018,2,10,11,12180,12385,9985,-2400
2018,2,10,12,12900,12718,10198,-2520
2018,2,10,13,13600,13369,10815,-2554
2018,2,10,14,14170,14031,11482,-2549
2018,2,10,15,14450,14379,11813,-2566
2018,2,10,16,14420,14337,11752,-2585
2018,2,10,17,14330,14175,11586,-2589
2018,2,10,18,14200,14051,11263,-2788
2018,2,10,19,14090,14224,11419,-2805
2018,2,10,20,13930,14072,11393,-2679
2018,2,10,21,14090,13999,11306,-2693
2018,2,10,22,14540,14399,11815,-2584
2018,2,10,23,15300,15161,12397,-2764
2018,2,11,0,15170,15117,12371,-2746
2018,2,11,1,14640,14650,11901,-2749
2018,2,11,2,14070,14153,11330,-2823
2018,2,11,3,13410,13854,11214,-2640
2018,2,11,4,12620,12958,10138,-2820
2018,2,11,5,11820,12074,9357,-2717
2018,2,11,6,11000,11586,8939,-2647
2018,2,11,7,10570,11636,8922,-2714
2018,2,11,8,10340,11837,9338,-2499
2018,2,11,9,10250,11845,9211,-2634
2018,2,11,10,10290,11856,9225,-2631
2018,2,11,11,10560,11845,9456,-2389
2018,2,11,12,11090,11895,9537,-2358
2018,2,11,13,11730,12452,9839,-2613
2018,2,11,14,12600,12797,10232,-2565
2018,2,11,15,13390,13381,10907,-2474
2018,2,11,16,13900,13899,11481,-2418
2018,2,11,17,14200,14203,11832,-2371
2018,2,11,18,14180,14372,11935,-2437
2018,2,11,19,14240,14332,11990,-2342
2018,2,11,20,14390,14317,11948,-2369
2018,2,11,21,14780,14459,11936,-2523
2018,2,11,22,15490,14957,12447,-2510
2018,2,11,23,16150,15710,13389,-2321
2018,2,12,0,16050,15651,13349,-2302
2018,2,12,1,15550,15125,12556,-2569
2018,2,12,2,14750,14435,11868,-2567
2018,2,12,3,13690,13474,10891,-2583
2018,2,12,4,12600,12407,9797,-2610
2018,2,12,5,11630,11474,8950,-2524
2018,2,12,6,10780,11250,8713,-2537
2018,2,12,7,10430,11193,8574,-2619
2018,2,12,8,10270,11193,8620,-2573
2018,2,12,9,10290,10828,8465,-2363
2018,2,12,10,10690,10972,8661,-2311
2018,2,12,11,11790,12017,9620,-2397
2018,2,12,12,13620,13588,11271,-2317
2018,2,12,13,14610,14617,12178,-2439
2018,2,12,14,14820,14844,12219,-2625
2018,2,12,15,14940,15001,12086,-2915
2018,2,12,16,14810,15051,12265,-2786
2018,2,12,17,14650,15002,12304,-2698
2018,2,12,18,14430,14778,12112,-2666
2018,2,12,19,14280,14448,11749,-2699
2018,2,12,20,14210,14046,11333,-2713
2018,2,12,21,14440,14238,11691,-2547
2018,2,12,22,15010,14976,12281,-2695
2018,2,12,23,16220,16343,13589,-2754
2018,2,13,0,16700,16873,14259,-2614
2018,2,13,1,16350,16532,13573,-2959
2018,2,13,2,15730,15940,13063,-2877
2018,2,13,3,14790,15026,12362,-2664
2018,2,13,4,13600,13906,11085,-2821
2018,2,13,5,12610,13086,10481,-2605
2018,2,13,6,12200,12485,9618,-2867
2018,2,13,7,11890,12167,9327,-2840
2018,2,13,8,11810,12073,9222,-2851
2018,2,13,9,11890,12155,9330,-2825
2018,2,13,10,12320,12341,9786,-2555
2018,2,13,11,13460,13429,10782,-2647
2018,2,13,12,15280,15255,12766,-2489
2018,2,13,13,15970,15976,13688,-2288
2018,2,13,14,15430,15464,13023,-2441
2018,2,13,15,14900,14885,12272,-2613
2018,2,13,16,14520,14374,11723,-2651
2018,2,13,17,14180,13984,11401,-2583
2018,2,13,18,14070,13836,11322,-2514
2018,2,13,19,14160,14000,11471,-2529
2018,2,13,20,14440,14158,11763,-2395
2018,2,13,21,14870,14509,12131,-2378
2018,2,13,22,15680,15456,12788,-2668
2018,2,13,23,16810,16786,14261,-2525
2018,2,14,0,17250,17251,14671,-2580
2018,2,14,1,16790,16936,14282,-2654
2018,2,14,2,16230,16387,13705,-2682
2018,2,14,3,15290,15440,12655,-2785
2018,2,14,4,14020,14229,11447,-2782
2018,2,14,5,13000,13079,10716,-2363
2018,2,14,6,12340,12410,9766,-2644
2018,2,14,7,11960,12403,9705,-2698
2018,2,14,8,11780,12289,9611,-2678
2018,2,14,9,11750,12271,9658,-2613
2018,2,14,10,12070,12261,9789,-2472
2018,2,14,11,13100,13080,10628,-2452
2018,2,14,12,14820,14806,12360,-2446
2018,2,14,13,15660,15674,13070,-2604
2018,2,14,14,15710,15742,12824,-2918
2018,2,14,15,15500,15507,12577,-2930
2018,2,14,16,15120,15066,12292,-2774
2018,2,14,17,14580,14628,12059,-2569
2018,2,14,18,14110,14078,11581,-2497
2018,2,14,19,13960,13948,11426,-2522
2018,2,14,20,14100,13648,11001,-2647
2018,2,14,21,14470,13967,11347,-2620
2018,2,14,22,15150,14685,12052,-2633
2018,2,14,23,16430,15666,13017,-2649
2018,2,15,0,16750,16117,13594,-2523
2018,2,15,1,16200,15767,13156,-2611
2018,2,15,2,15350,15222,12600,-2622
2018,2,15,3,14360,14337,11705,-2632
2018,2,15,4,13150,13378,10638,-2740
2018,2,15,5,12160,12406,9904,-2502
2018,2,15,6,11410,12165,9556,-2609
2018,2,15,7,11040,12141,9530,-2611
2018,2,15,8,10830,11998,9318,-2680
2018,2,15,9,10790,11957,9307,-2650
2018,2,15,10,11110,12022,9402,-2620
2018,2,15,11,12080,12754,10272,-2482
2018,2,15,12,13730,13970,11707,-2263
2018,2,15,13,14640,14802,12526,-2276
2018,2,15,14,14820,14873,12570,-2303
2018,2,15,15,14710,14704,12376,-2328
2018,2,15,16,14600,14608,12298,-2310
2018,2,15,17,14440,14641,12440,-2201
2018,2,15,18,14250,14499,12367,-2132
2018,2,15,19,14300,14421,12096,-2325
2018,2,15,20,14250,14522,12238,-2284
2018,2,15,21,14450,14426,12311,-2115
2018,2,15,22,14880,14876,12743,-2133
2018,2,15,23,15630,15666,13431,-2235
2018,2,16,0,15750,15906,13741,-2165
2018,2,16,1,15200,15530,13338,-2192
2018,2,16,2,14610,14914,12760,-2154
2018,2,16,3,13650,13953,11620,-2333
2018,2,16,4,12470,12771,10243,-2528
2018,2,16,5,11460,12013,9755,-2258
2018,2,16,6,10910,11648,9274,-2374
2018,2,16,7,10580,11612,9246,-2366
2018,2,16,8,10340,11189,9108,-2081
2018,2,16,9,10360,11281,9284,-1997
2018,2,16,10,10650,11664,9626,-2038
2018,2,16,11,11620,12394,10120,-2274
2018,2,16,12,13270,13453,11150,-2303
2018,2,16,13,14280,14167,11610,-2557
2018,2,16,14,14450,14457,11974,-2483
2018,2,16,15,14530,14525,12138,-2387
2018,2,16,16,14640,14538,12305,-2233
2018,2,16,17,14570,14496,12353,-2143
2018,2,16,18,14290,14425,12162,-2263
2018,2,16,19,14290,14321,11904,-2417
2018,2,16,20,14160,14198,11766,-2432
2018,2,16,21,14290,14341,12016,-2325
2018,2,16,22,14740,14751,12479,-2272
2018,2,16,23,15450,15411,12914,-2497
2018,2,17,0,15660,15498,12978,-2520
2018,2,17,1,15250,15138,12927,-2211
2018,2,17,2,14710,14659,12389,-2270
2018,2,17,3,13940,14171,11973,-2198
2018,2,17,4,13170,13438,11212,-2226
2018,2,17,5,12320,12746,10469,-2277
2018,2,17,6,11400,12318,10149,-2169
2018,2,17,7,11130,12159,9794,-2365
2018,2,17,8,10890,11993,9629,-2364
2018,2,17,9,10890,11987,9606,-2381
2018,2,17,10,11050,12112,9837,-2275
2018,2,17,11,11450,12283,10052,-2231
2018,2,17,12,12150,12566,10198,-2368
2018,2,17,13,12740,13092,10646,-2446
2018,2,17,14,13260,13181,10641,-2540
2018,2,17,15,12970,12959,10398,-2561
2018,2,17,16,12550,12719,10333,-2386
2018,2,17,17,12380,12655,10145,-2510
2018,2,17,18,12350,12745,10035,-2710
2018,2,17,19,12280,12824,9993,-2831
2018,2,17,20,12560,13508,10964,-2544
2018,2,17,21,13180,13681,11315,-2366
2018,2,17,22,13990,14336,12181,-2155
2018,2,17,23,14820,15277,13219,-2058
2018,2,18,0,15220,15488,13262,-2226
2018,2,18,1,14890,15131,12722,-2409
2018,2,18,2,14280,14690,12498,-2192
2018,2,18,3,13600,14077,12000,-2077
2018,2,18,4,12780,13255,11341,-1914
2018,2,18,5,11900,12417,10438,-1979
2018,2,18,6,11790,11818,9806,-2012
2018,2,18,7,11410,11431,9413,-2018
2018,2,18,8,11160,11450,9297,-2153
2018,2,18,9,11020,11326,9058,-2268
2018,2,18,10,11060,11359,9042,-2317
2018,2,18,11,11290,11589,9246,-2343
2018,2,18,12,11740,11936,9436,-2500
2018,2,18,13,12270,12267,9744,-2523
2018,2,18,14,12830,12825,10314,-2511
2018,2,18,15,13130,13125,10810,-2315
2018,2,18,16,13030,13178,10906,-2272
2018,2,18,17,12720,12994,10753,-2241
2018,2,18,18,12550,12741,10351,-2390
2018,2,18,19,12470,12913,10607,-2306
2018,2,18,20,12820,12797,10231,-2566
2018,2,18,21,13110,12916,10187,-2729
2018,2,18,22,13980,13425,11051,-2374
2018,2,18,23,14910,14656,12209,-2447
2018,2,19,0,15270,15214,12780,-2434
2018,2,19,1,14890,14854,12227,-2627
2018,2,19,2,14460,14368,11688,-2680
2018,2,19,3,13670,13686,11058,-2628
2018,2,19,4,12760,12854,10195,-2659
2018,2,19,5,11970,12061,9377,-2684
2018,2,19,6,11530,11642,9458,-2184
2018,2,19,7,11250,11778,9696,-2082
2018,2,19,8,11160,11736,9774,-1962
2018,2,19,9,11240,11806,9774,-2032
2018,2,19,10,11600,12152,10076,-2076
2018,2,19,11,12400,12598,10418,-2180
2018,2,19,12,13360,13550,11097,-2453
2018,2,19,13,13970,14182,11880,-2302
2018,2,19,14,14090,14131,11944,-2187
2018,2,19,15,13890,13886,11563,-2323
2018,2,19,16,13630,13661,11186,-2475
2018,2,19,17,13510,13510,11113,-2397
2018,2,19,18,13240,13492,11102,-2390
2018,2,19,19,13190,13540,11285,-2255
2018,2,19,20,13460,13847,11716,-2131
2018,2,19,21,14000,14371,12243,-2128
2018,2,19,22,14800,14976,12693,-2283
2018,2,19,23,15850,15863,13248,-2615
2018,2,20,0,16280,15929,13229,-2700
2018,2,20,1,15780,15372,12611,-2761
2018,2,20,2,15030,14664,12134,-2530
2018,2,20,3,14080,13698,10964,-2734
2018,2,20,4,12890,12550,9604,-2946
2018,2,20,5,11870,11704,9029,-2675
2018,2,20,6,10790,11349,8954,-2395
2018,2,20,7,10380,10921,8757,-2164
2018,2,20,8,10200,10727,8611,-2116
2018,2,20,9,10180,10948,8729,-2219
2018,2,20,10,10510,11143,8969,-2174
2018,2,20,11,11490,11488,9535,-1953
2018,2,20,12,13100,12794,10812,-1982
2018,2,20,13,13990,13716,11449,-2267
2018,2,20,14,14130,14039,11484,-2555
2018,2,20,15,13970,13957,11539,-2418
2018,2,20,16,13870,13684,11227,-2457
2018,2,20,17,13480,13342,10954,-2388
2018,2,20,18,13170,13064,10645,-2419
2018,2,20,19,13030,13072,10550,-2522
2018,2,20,20,13050,13118,10650,-2468
2018,2,20,21,13290,13385,10829,-2556
2018,2,20,22,13880,13976,11256,-2720
2018,2,20,23,14760,14869,11720,-3149
2018,2,21,0,15400,15301,12264,-3037
2018,2,21,1,14970,14827,11881,-2946
2018,2,21,2,14340,14140,11371,-2769
2018,2,21,3,13300,13210,10512,-2698
2018,2,21,4,12100,12093,9478,-2615
2018,2,21,5,11000,11349,8866,-2483
2018,2,21,6,10360,10920,8874,-2046
2018,2,21,7,9980,10524,8691,-1833
2018,2,21,8,9810,10589,8868,-1721
2018,2,21,9,9820,10892,8804,-2088
2018,2,21,10,10140,11035,9143,-1892
2018,2,21,11,10950,11446,9546,-1900
2018,2,21,12,12570,12704,10733,-1971
2018,2,21,13,13480,13488,11094,-2394
2018,2,21,14,13740,13735,11246,-2489
2018,2,21,15,13740,13636,11223,-2413
2018,2,21,16,13620,13308,11094,-2214
2018,2,21,17,13390,13004,10938,-2066
2018,2,21,18,13290,13022,10968,-2054
2018,2,21,19,13400,12865,10793,-2072
2018,2,21,20,13420,13047,10949,-2098
2018,2,21,21,13580,13349,11257,-2092
2018,2,21,22,14200,13913,11763,-2150
2018,2,21,23,15090,14733,12359,-2374
2018,2,22,0,15300,15145,12709,-2436
2018,2,22,1,14770,14687,12169,-2518
2018,2,22,2,14100,13996,11728,-2268
2018,2,22,3,13170,13046,10953,-2093
2018,2,22,4,11940,12203,9907,-2296
2018,2,22,5,10910,11564,9066,-2498
2018,2,22,6,10230,11264,9170,-2094
2018,2,22,7,9860,11191,8646,-2545
2018,2,22,8,9690,11017,8599,-2418
2018,2,22,9,9670,10747,8584,-2163
2018,2,22,10,10000,10893,8692,-2201
2018,2,22,11,10940,11290,9201,-2089
2018,2,22,12,12480,12447,10609,-1838
2018,2,22,13,13540,13539,11384,-2155
2018,2,22,14,13970,13978,11912,-2066
2018,2,22,15,14200,14188,12097,-2091
2018,2,22,16,14350,14439,12115,-2324
2018,2,22,17,14450,14525,12388,-2137
2018,2,22,18,14530,14562,12602,-1960
2018,2,22,19,14530,14709,12483,-2226
2018,2,22,20,14520,14751,12595,-2156
2018,2,22,21,14620,14913,12545,-2368
2018,2,22,22,15120,15338,12997,-2341
2018,2,22,23,15850,16011,13702,-2309
2018,2,23,0,16400,16250,13740,-2510
2018,2,23,1,15970,15858,13380,-2478
2018,2,23,2,15260,15254,12990,-2264
2018,2,23,3,14280,14328,12119,-2209
2018,2,23,4,13040,13233,10814,-2419
2018,2,23,5,11940,12229,9845,-2384
2018,2,23,6,11550,11586,9241,-2345
2018,2,23,7,11150,11545,9280,-2265
2018,2,23,8,10980,11538,9218,-2320
2018,2,23,9,11010,11785,9347,-2438
2018,2,23,10,11360,11761,9312,-2449
2018,2,23,11,12320,12291,10010,-2281
2018,2,23,12,13770,13747,11249,-2498
2018,2,23,13,14610,14608,12182,-2426
2018,2,23,14,14720,14746,12343,-2403
2018,2,23,15,14650,14674,12677,-1997
2018,2,23,16,14600,14607,12716,-1891
2018,2,23,17,14580,14622,12768,-1854
2018,2,23,18,14500,14701,12544,-2157
2018,2,23,19,14560,14816,12576,-2240
2018,2,23,20,14610,14865,12534,-2331
2018,2,23,21,14840,14942,12627,-2315
2018,2,23,22,15130,15237,12699,-2538
2018,2,23,23,15800,15801,13109,-2692
2018,2,24,0,16000,15840,13072,-2768
2018,2,24,1,15420,15366,12510,-2856
2018,2,24,2,14720,14758,12040,-2718
2018,2,24,3,13920,14012,11490,-2522
2018,2,24,4,12880,13013,10567,-2446
2018,2,24,5,11970,12250,9642,-2608
2018,2,24,6,11280,11380,9037,-2343
2018,2,24,7,10810,10842,8729,-2113
2018,2,24,8,10540,10737,8729,-2008
2018,2,24,9,10430,10702,8609,-2093
2018,2,24,10,10520,10991,8747,-2244
2018,2,24,11,10870,11158,8883,-2275
2018,2,24,12,11520,11521,9315,-2206
2018,2,24,13,12000,12005,9358,-2647
2018,2,24,14,12110,12123,9558,-2565
2018,2,24,15,11990,12013,9720,-2293
2018,2,24,16,11900,11865,9515,-2350
2018,2,24,17,11740,12042,9832,-2210
2018,2,24,18,11740,12520,10353,-2167
2018,2,24,19,11710,12821,10474,-2347
2018,2,24,20,11840,12833,10312,-2521
2018,2,24,21,12210,12950,10563,-2387
2018,2,24,22,12620,13347,10989,-2358
2018,2,24,23,13690,13975,11327,-2648
2018,2,25,0,14100,14182,11772,-2410
2018,2,25,1,13700,13799,11146,-2653
2018,2,25,2,13290,13350,10563,-2787
2018,2,25,3,12740,12842,10174,-2668
2018,2,25,4,12000,12087,9400,-2687
2018,2,25,5,11200,11311,8930,-2381
2018,2,25,6,10680,10826,8786,-2040
2018,2,25,7,10340,11117,8983,-2134
2018,2,25,8,10120,10955,9001,-1954
2018,2,25,9,10050,10870,8843,-2027
2018,2,25,10,10150,10956,8829,-2127
2018,2,25,11,10490,11029,9184,-1845
2018,2,25,12,11050,11368,9454,-1914
2018,2,25,13,11710,12325,10126,-2199
2018,2,25,14,12600,13274,11118,-2156
2018,2,25,15,13450,13700,11572,-2128
2018,2,25,16,13830,13945,11765,-2180
2018,2,25,17,14010,14304,12248,-2056
2018,2,25,18,14140,14392,12283,-2109
2018,2,25,19,14010,14359,12285,-2074
2018,2,25,20,13990,14265,12173,-2092
2018,2,25,21,14030,14267,12162,-2105
2018,2,25,22,14590,14604,12680,-1924
2018,2,25,23,15220,15270,13203,-2067
2018,2,26,0,15400,15426,13363,-2063
2018,2,26,1,14910,14951,12599,-2352
2018,2,26,2,14240,14281,11839,-2442
2018,2,26,3,13350,13318,10928,-2390
2018,2,26,4,12260,12253,9739,-2514
2018,2,26,5,11400,11834,9240,-2594
2018,2,26,6,10710,11777,9188,-2589
2018,2,26,7,10370,11455,8873,-2582
2018,2,26,8,10240,11309,8716,-2593
2018,2,26,9,10290,11349,8772,-2577
2018,2,26,10,10680,11450,8966,-2484
2018,2,26,11,11770,11964,9610,-2354
2018,2,26,12,13430,13402,11028,-2374
2018,2,26,13,14200,14215,11894,-2321
2018,2,26,14,14120,14141,11794,-2347
2018,2,26,15,14120,14105,11845,-2260
2018,2,26,16,13930,14076,11724,-2352
2018,2,26,17,13650,13861,11518,-2343
2018,2,26,18,13370,13516,11348,-2168
2018,2,26,19,13200,13446,11367,-2079
2018,2,26,20,13130,13189,10918,-2271
2018,2,26,21,13390,13686,11351,-2335
2018,2,26,22,14060,14001,11820,-2181
2018,2,26,23,15310,14995,12743,-2252
2018,2,27,0,16000,15801,13639,-2162
2018,2,27,1,15670,15495,13219,-2276
2018,2,27,2,15090,14897,12499,-2398
2018,2,27,3,14160,13965,11633,-2332
2018,2,27,4,13000,12809,10378,-2431
2018,2,27,5,11980,12246,10094,-2152
2018,2,27,6,11200,12245,10172,-2073
2018,2,27,7,10910,12192,10093,-2099
2018,2,27,8,10790,12100,9852,-2248
2018,2,27,9,10830,12133,9705,-2428
2018,2,27,10,11240,12189,9929,-2260
2018,2,27,11,12330,12737,10671,-2066
2018,2,27,12,13960,13936,11807,-2129
2018,2,27,13,14400,14404,12070,-2334
2018,2,27,14,13740,13760,11660,-2100
2018,2,27,15,13060,13266,11250,-2016
2018,2,27,16,12580,12934,11003,-1931
2018,2,27,17,12350,12663,10735,-1928
2018,2,27,18,12190,12437,10728,-1709
2018,2,27,19,12280,12432,10948,-1484
2018,2,27,20,12500,12311,10777,-1534
2018,2,27,21,12940,12636,10943,-1693
2018,2,27,22,13750,13495,11360,-2135
2018,2,27,23,14920,14659,12356,-2303
2018,2,28,0,15670,15464,13339,-2125
2018,2,28,1,15210,15215,13085,-2130
2018,2,28,2,14740,14669,12509,-2160
2018,2,28,3,13840,13763,11577,-2186
2018,2,28,4,12640,12616,10218,-2398
2018,2,28,5,11630,11797,9623,-2174
2018,2,28,6,10930,11249,9125,-2124
2018,2,28,7,10610,11230,9109,-2121
2018,2,28,8,10460,11033,8876,-2157
2018,2,28,9,10480,11273,8946,-2327
2018,2,28,10,10870,11348,9059,-2289
2018,2,28,11,11890,11868,9723,-2145
2018,2,28,12,13490,13469,11333,-2136
2018,2,28,13,14040,14058,11969,-2089
2018,2,28,14,13520,13544,11545,-1999
2018,2,28,15,12850,12876,10887,-1989
2018,2,28,16,12580,12476,10822,-1654
2018,2,28,17,12560,12251,10766,-1485
2018,2,28,18,12520,12257,10598,-1659
2018,2,28,19,12600,12465,10564,-1901
2018,2,28,20,12700,12627,10591,-2036
2018,2,28,21,13040,12877,10853,-2024
2018,2,28,22,13770,13528,11574,-1954
2018,2,28,23,14770,14502,12193,-2309
2018,3,1,0,15240,15145,12929,-2216
2018,3,1,1,14910,14811,12467,-2344
2018,3,1,2,14470,14221,11977,-2244
2018,3,1,3,13420,13285,11054,-2231
2018,3,1,4,12230,12114,9801,-2313
2018,3,1,5,11190,11074,8920,-2154
2018,3,1,6,10510,10909,8713,-2196
2018,3,1,7,10220,10612,8531,-2081
2018,3,1,8,10030,10486,8507,-1979
2018,3,1,9,10040,10706,8566,-2140
2018,3,1,10,10440,10830,8776,-2054
2018,3,1,11,11420,11864,9425,-2439
2018,3,1,12,12960,13401,11097,-2304
2018,3,1,13,13700,13563,11366,-2197
2018,3,1,14,13290,13184,11143,-2041
2018,3,1,15,12770,12784,10975,-1809
2018,3,1,16,12700,12444,10594,-1850
2018,3,1,17,12740,12299,10249,-2050
2018,3,1,18,12810,12343,10386,-1957
2018,3,1,19,12820,12804,10722,-2082
2018,3,1,20,13010,12863,10750,-2113
2018,3,1,21,13330,12983,10893,-2090
2018,3,1,22,13910,13513,11412,-2101
2018,3,1,23,14570,14440,12518,-1922
2018,3,2,0,15190,14975,13114,-1861
2018,3,2,1,14950,14685,12682,-2003
2018,3,2,2,14460,14159,12039,-2120
2018,3,2,3,13500,13288,10985,-2303
2018,3,2,4,12370,12180,9717,-2463
2018,3,2,5,11310,11425,9192,-2233
2018,3,2,6,10840,11056,8618,-2438
2018,3,2,7,10580,10784,8463,-2321
2018,3,2,8,10440,10800,8554,-2246
2018,3,2,9,10500,10863,8974,-1889
2018,3,2,10,10920,11069,8874,-2195
2018,3,2,11,11910,11846,9739,-2107
2018,3,2,12,13490,13291,11044,-2247
2018,3,2,13,14300,14438,12014,-2424
2018,3,2,14,14640,14998,12549,-2449
2018,3,2,15,15420,15349,12964,-2385
2018,3,2,16,15300,15590,13216,-2374
2018,3,2,17,15290,15663,13181,-2482
2018,3,2,18,15260,15591,13103,-2488
2018,3,2,19,15290,15454,12866,-2588
2018,3,2,20,15230,15185,12618,-2567
2018,3,2,21,15330,15000,12455,-2545
2018,3,2,22,15570,15123,12644,-2479
2018,3,2,23,15690,15472,12920,-2552
2018,3,3,0,15900,15360,13062,-2298
2018,3,3,1,15560,14650,12213,-2437
2018,3,3,2,15060,14034,11893,-2141
2018,3,3,3,14330,13286,11189,-2097
2018,3,3,4,13360,12356,10201,-2155
2018,3,3,5,12420,11461,9458,-2003
2018,3,3,6,10790,10810,8613,-2197
2018,3,3,7,10430,10695,8540,-2155
2018,3,3,8,10230,10743,8553,-2190
2018,3,3,9,10210,10938,8637,-2301
2018,3,3,10,10370,11052,8579,-2473
2018,3,3,11,10810,11106,8645,-2461
2018,3,3,12,11310,11527,9133,-2394
2018,3,3,13,11890,12189,9699,-2490
2018,3,3,14,12710,12737,10692,-2045
2018,3,3,15,12880,12875,11169,-1706
2018,3,3,16,12900,12875,10755,-2120
2018,3,3,17,12890,12872,10857,-2015
2018,3,3,18,12750,12787,10645,-2142
2018,3,3,19,12680,12606,10445,-2161
2018,3,3,20,12750,12765,10607,-2158
2018,3,3,21,13100,12844,10771,-2073
2018,3,3,22,13700,13064,11051,-2013
2018,3,3,23,14400,13835,12130,-1705
2018,3,4,0,14950,14303,12875,-1428
2018,3,4,1,14430,13973,12434,-1539
2018,3,4,2,14040,13555,11774,-1781
2018,3,4,3,13400,12958,10933,-2025
2018,3,4,4,12610,12186,9698,-2488
2018,3,4,5,11710,11622,9283,-2339
2018,3,4,6,10860,11042,8868,-2174
2018,3,4,7,10540,10800,8521,-2279
2018,3,4,8,10350,10457,8283,-2174
2018,3,4,9,10250,10606,8280,-2326
2018,3,4,10,10290,10699,8278,-2421
2018,3,4,11,10580,10949,8598,-2351
2018,3,4,12,10970,11146,8736,-2410
2018,3,4,13,11570,11877,9440,-2437
2018,3,4,14,12220,12440,10039,-2401
2018,3,4,15,12670,12579,9995,-2584
2018,3,4,16,12850,12846,10168,-2678
2018,3,4,17,12980,12956,10380,-2576
2018,3,4,18,12960,12932,10319,-2613
2018,3,4,19,13010,12922,10295,-2627
2018,3,4,20,13100,12996,10471,-2525
2018,3,4,21,13380,13227,10747,-2480
2018,3,4,22,14180,13867,11262,-2605
2018,3,4,23,14830,14759,12304,-2455
2018,3,5,0,15450,15272,13135,-2137
2018,3,5,1,15020,14992,12725,-2267
2018,3,5,2,14480,14395,12020,-2375
2018,3,5,3,13670,13531,11331,-2200
2018,3,5,4,12700,12511,10184,-2327
2018,3,5,5,11720,11625,9436,-2189
2018,3,5,6,11060,11326,9488,-1838
2018,3,5,7,10770,11078,9325,-1753
2018,3,5,8,10680,10967,9141,-1826
2018,3,5,9,10740,11267,9345,-1922
2018,3,5,10,11150,11482,9698,-1784
2018,3,5,11,12150,12249,10400,-1849
2018,3,5,12,13760,13878,11815,-2063
2018,3,5,13,14650,14896,12744,-2152
2018,3,5,14,14900,15147,12934,-2213
2018,3,5,15,15210,15207,13265,-1942
2018,3,5,16,15080,15138,13199,-1939
2018,3,5,17,14960,14777,12623,-2154
2018,3,5,18,14780,14379,12262,-2117
2018,3,5,19,14700,14437,12377,-2060
2018,3,5,20,14700,14305,12053,-2252
2018,3,5,21,14750,14442,12379,-2063
2018,3,5,22,15210,14578,12403,-2175
2018,3,5,23,15900,15527,13530,-1997
2018,3,6,0,16600,16322,14504,-1818
2018,3,6,1,16160,16017,14168,-1849
2018,3,6,2,15430,15412,13394,-2018
2018,3,6,3,14450,14436,12228,-2208
2018,3,6,4,13220,13230,10892,-2338
2018,3,6,5,12130,12216,9856,-2360
2018,3,6,6,11310,11919,9730,-2189
2018,3,6,7,11080,12028,9717,-2311
2018,3,6,8,10880,12071,9464,-2607
2018,3,6,9,10970,12030,9297,-2733
2018,3,6,10,11350,12036,9433,-2603
2018,3,6,11,12410,12552,10240,-2312
2018,3,6,12,14030,14163,12161,-2002
2018,3,6,13,14680,14771,12852,-1919
2018,3,6,14,14590,14428,12763,-1665
2018,3,6,15,14040,14002,12071,-1931
2018,3,6,16,13680,13998,12091,-1907
2018,3,6,17,13610,14047,12135,-1912
2018,3,6,18,13510,13670,11979,-1691
2018,3,6,19,13480,13568,11832,-1736
2018,3,6,20,13690,13705,11531,-2174
2018,3,6,21,14040,13972,11913,-2059
2018,3,6,22,14600,14356,12388,-1968
2018,3,6,23,15670,15282,13521,-1761
2018,3,7,0,16350,16067,14298,-1769
2018,3,7,1,16020,15866,14078,-1788
2018,3,7,2,15450,15319,13681,-1638
2018,3,7,3,14480,14369,12716,-1653
2018,3,7,4,13240,13195,11101,-2094
2018,3,7,5,12090,12307,10287,-2020
2018,3,7,6,11470,11716,9667,-2049
2018,3,7,7,11150,11343,9223,-2120
2018,3,7,8,11020,11398,9274,-2124
2018,3,7,9,11000,11464,9231,-2233
2018,3,7,10,11390,11835,9576,-2259
2018,3,7,11,12460,12532,10338,-2194
2018,3,7,12,14320,13807,11790,-2017
2018,3,7,13,15210,14832,12692,-2140
2018,3,7,14,15380,15443,13211,-2232
2018,3,7,15,15370,15372,13229,-2143
2018,3,7,16,15420,15577,13402,-2175
2018,3,7,17,15430,15626,13501,-2125
2018,3,7,18,15420,15662,13585,-2077
2018,3,7,19,15450,15775,13930,-1845
2018,3,7,20,15460,15752,13868,-1884
2018,3,7,21,15520,15782,13619,-2163
2018,3,7,22,15990,16096,13770,-2326
2018,3,7,23,16680,16720,14205,-2515
2018,3,8,0,17000,16776,14388,-2388
2018,3,8,1,16570,16138,13668,-2470
2018,3,8,2,15910,15299,12722,-2577
2018,3,8,3,14810,14225,11718,-2507
2018,3,8,4,13540,13041,10422,-2619
2018,3,8,5,12420,12167,9418,-2749
2018,3,8,6,11350,11591,9722,-1869
2018,3,8,7,10920,10946,9462,-1484
2018,3,8,8,10680,10955,8937,-2018
2018,3,8,9,10550,11226,8754,-2472
2018,3,8,10,10800,11526,8707,-2819
2018,3,8,11,11500,11860,9197,-2663
2018,3,8,12,12480,12747,10115,-2632
2018,3,8,13,13310,13586,11042,-2544
2018,3,8,14,13830,14163,11621,-2542
2018,3,8,15,14200,14133,11540,-2593
2018,3,8,16,14180,14218,11670,-2548
2018,3,8,17,14210,14288,11658,-2630
2018,3,8,18,14160,14334,11747,-2587
2018,3,8,19,14170,14264,11666,-2598
2018,3,8,20,14260,14203,11581,-2622
2018,3,8,21,14320,14275,11849,-2426
2018,3,8,22,14770,14599,12296,-2303
2018,3,8,23,15510,15227,13071,-2156
2018,3,9,0,16030,15729,13724,-2005
2018,3,9,1,15710,15409,13314,-2095
2018,3,9,2,15180,14859,12838,-2021
2018,3,9,3,14260,13988,11929,-2059
2018,3,9,4,13070,12871,10421,-2450
2018,3,9,5,12010,11943,9348,-2595
2018,3,9,6,11310,11650,8813,-2837
2018,3,9,7,11020,11559,8667,-2892
2018,3,9,8,10890,11441,8670,-2771
2018,3,9,9,10950,11658,9001,-2657
2018,3,9,10,11320,11724,9213,-2511
2018,3,9,11,12310,12293,10217,-2076
2018,3,9,12,13770,13732,11857,-1875
2018,3,9,13,14490,14489,12308,-2181
2018,3,9,14,14510,14532,12351,-2181
2018,3,9,15,14420,14431,12411,-2020
2018,3,9,16,14270,14432,12450,-1982
2018,3,9,17,14260,14332,12366,-1966
2018,3,9,18,14160,14171,12252,-1919
2018,3,9,19,14200,14170,12085,-2085
2018,3,9,20,14240,14128,11841,-2287
2018,3,9,21,14370,14187,11953,-2234
2018,3,9,22,14890,14482,12168,-2314
2018,3,9,23,15360,15110,12957,-2153
2018,3,10,0,15710,15667,13303,-2364
2018,3,10,1,15360,15364,12928,-2436
2018,3,10,2,14840,14883,12669,-2214
2018,3,10,3,14150,14169,11739,-2430
2018,3,10,4,13180,13268,10809,-2459
2018,3,10,5,12190,12355,9790,-2565
2018,3,10,6,11600,11699,9226,-2473
2018,3,10,7,11250,11539,9118,-2421
2018,3,10,8,11070,11795,9286,-2509
2018,3,10,9,10960,11853,9333,-2520
2018,3,10,10,11130,11975,9373,-2602
2018,3,10,11,11560,11890,9715,-2175
2018,3,10,12,12130,12177,9890,-2287
2018,3,10,13,12720,12680,10303,-2377
2018,3,10,14,13070,13051,10802,-2249
2018,3,10,15,13180,13216,10719,-2497
2018,3,10,16,13170,13479,10968,-2511
2018,3,10,17,13020,13548,10949,-2599
2018,3,10,18,12890,13227,10612,-2615
2018,3,10,19,12910,13398,10766,-2632
2018,3,10,20,13020,13407,10849,-2558
2018,3,10,21,13200,13292,10919,-2373
2018,3,10,22,13810,13689,11329,-2360
2018,3,10,23,14310,14367,11930,-2437
2018,3,11,0,14930,15046,12639,-2407
2018,3,11,1,14600,14766,12423,-2343
2018,3,11,2,14300,14325,11936,-2389
2018,3,11,3,13730,13702,11332,-2370
2018,3,11,4,12960,12896,10530,-2366
2018,3,11,5,12100,12123,9851,-2272
2018,3,11,6,11410,11745,9557,-2188
2018,3,11,7,11100,11736,9324,-2412
2018,3,11,8,10640,11793,9382,-2411
2018,3,11,9,10760,11723,9319,-2404
2018,3,11,10,10970,11667,9272,-2395
2018,3,11,11,11360,11863,9563,-2300
2018,3,11,12,11890,12271,9937,-2334
2018,3,11,13,12510,12353,10049,-2304
2018,3,11,14,12510,12430,10024,-2406
2018,3,11,15,12270,12392,10097,-2295
2018,3,11,16,12130,12316,9967,-2349
2018,3,11,17,11940,12432,9977,-2455
2018,3,11,18,11930,12280,9836,-2444
2018,3,11,19,11950,12228,9721,-2507
2018,3,11,20,12230,12326,9852,-2474
2018,3,11,21,12800,12480,10033,-2447
2018,3,11,22,13550,13439,10934,-2505
2018,3,11,23,14420,14105,11668,-2437
2018,3,12,0,14870,14796,12564,-2232
2018,3,12,1,14620,14541,12292,-2249
2018,3,12,2,13710,13815,11579,-2236
2018,3,12,3,12710,12782,10227,-2555
2018,3,12,4,11710,11821,9250,-2571
2018,3,12,5,11000,11683,9122,-2561
2018,3,12,6,10750,11895,9142,-2753
2018,3,12,7,10720,11831,9027,-2804
2018,3,12,8,10750,11908,9109,-2799
2018,3,12,9,11170,12060,9413,-2647
2018,3,12,10,12150,12650,10294,-2356
2018,3,12,11,13880,14140,12214,-1926
2018,3,12,12,14750,15225,13420,-1805
2018,3,12,13,14950,14934,12815,-2119
2018,3,12,14,14270,14245,12172,-2073
2018,3,12,15,14050,13860,12077,-1783
2018,3,12,16,14040,13749,12042,-1707
2018,3,12,17,13990,13837,11988,-1849
2018,3,12,18,13880,13893,11914,-1979
2018,3,12,19,13910,13905,11950,-1955
2018,3,12,20,14220,14051,12049,-2002
2018,3,12,21,14750,14306,12233,-2073
2018,3,12,22,15050,14808,12643,-2165
2018,3,12,23,15630,15377,13320,-2057
2018,3,13,0,16010,15730,13675,-2055
2018,3,13,1,15380,15285,13193,-2092
2018,3,13,2,14380,14463,12370,-2093
2018,3,13,3,13140,13403,11166,-2237
2018,3,13,4,12030,12551,10295,-2256
2018,3,13,5,11580,11888,9436,-2452
2018,3,13,6,11150,11671,9248,-2423
2018,3,13,7,10970,11528,9163,-2365
2018,3,13,8,10990,11320,9023,-2297
2018,3,13,9,11300,11505,9218,-2287
2018,3,13,10,11980,11908,9723,-2185
2018,3,13,11,12920,12892,10757,-2135
2018,3,13,12,13660,13742,11852,-1890
2018,3,13,13,14310,14455,12544,-1911
2018,3,13,14,14960,15020,12878,-2142
2018,3,13,15,15370,15329,13203,-2126
2018,3,13,16,15690,15577,13415,-2162
2018,3,13,17,15780,15634,13195,-2439
2018,3,13,18,15790,15445,12895,-2550
2018,3,13,19,15740,15169,12546,-2623
2018,3,13,20,15750,14959,12326,-2633
2018,3,13,21,15880,15018,12270,-2748
2018,3,13,22,15990,15331,12655,-2676
2018,3,13,23,16200,15496,13051,-2445
2018,3,14,0,16620,15735,13639,-2096
2018,3,14,1,15500,15230,13050,-2180
2018,3,14,2,14380,14362,11973,-2389
2018,3,14,3,13230,13285,10669,-2616
2018,3,14,4,12210,12286,9744,-2542
2018,3,14,5,11690,11850,9281,-2569
2018,3,14,6,11370,11829,9082,-2747
2018,3,14,7,11180,11862,9117,-2745
2018,3,14,8,11150,11674,8904,-2770
2018,3,14,9,11480,11882,9049,-2833
2018,3,14,10,12380,12279,9598,-2681
2018,3,14,11,14130,13703,11075,-2628
2018,3,14,12,15150,14716,12251,-2465
2018,3,14,13,15240,15095,12738,-2357
2018,3,14,14,15160,15149,13710,-1439
2018,3,14,15,14980,15066,12503,-2563
2018,3,14,16,14780,14899,12157,-2742
2018,3,14,17,14620,14599,11799,-2800
2018,3,14,18,14490,14455,11758,-2697
2018,3,14,19,14400,14266,11531,-2735
2018,3,14,20,14330,14154,11332,-2822
2018,3,14,21,14830,14320,11421,-2899
2018,3,14,22,15130,14784,11975,-2809
2018,3,14,23,15670,15596,12829,-2767
2018,3,15,0,16140,15844,13228,-2616
2018,3,15,1,15720,15507,12864,-2643
2018,3,15,2,14810,14641,11959,-2682
2018,3,15,3,13530,13461,10558,-2903
2018,3,15,4,12380,12396,9657,-2739
2018,3,15,5,11680,12021,9121,-2900
2018,3,15,6,11320,12196,9359,-2837
2018,3,15,7,11150,11989,9252,-2737
2018,3,15,8,11170,11962,9233,-2729
2018,3,15,9,11560,12288,9648,-2640
2018,3,15,10,12440,13223,10690,-2533
2018,3,15,11,14190,14224,11782,-2442
2018,3,15,12,15190,15185,12823,-2362
2018,3,15,13,15200,15231,12710,-2521
2018,3,15,14,14940,14936,12434,-2502
2018,3,15,15,14620,14615,12032,-2583
2018,3,15,16,14470,14910,12276,-2634
2018,3,15,17,14210,14389,11654,-2735
2018,3,15,18,14050,14197,11529,-2668
2018,3,15,19,14050,14228,11531,-2697
2018,3,15,20,14050,14252,11464,-2788
2018,3,15,21,14400,14359,11466,-2893
2018,3,15,22,14800,14501,11674,-2827
2018,3,15,23,15340,15002,12216,-2786
2018,3,16,0,15870,15636,13023,-2613
2018,3,16,1,15530,15362,12759,-2603
2018,3,16,2,14660,14558,11916,-2642
2018,3,16,3,13480,13692,10862,-2830
2018,3,16,4,12360,12808,9917,-2891
2018,3,16,5,11710,12212,9534,-2678
2018,3,16,6,11300,12077,9468,-2609
2018,3,16,7,11200,11909,9283,-2626
2018,3,16,8,11270,11919,9325,-2594
2018,3,16,9,11670,12256,9556,-2700
2018,3,16,10,12410,12768,10190,-2578
2018,3,16,11,14030,14169,11699,-2470
2018,3,16,12,14920,15135,12599,-2536
2018,3,16,13,15000,14992,12458,-2534
2018,3,16,14,14620,14670,12134,-2536
2018,3,16,15,14300,14574,12092,-2482
2018,3,16,16,13940,14341,11935,-2406
2018,3,16,17,13790,14076,11559,-2517
2018,3,16,18,13660,14000,11439,-2561
2018,3,16,19,13630,13870,11132,-2738
2018,3,16,20,13690,13841,11157,-2684
2018,3,16,21,14260,14085,11283,-2802
2018,3,16,22,14720,14533,11743,-2790
2018,3,16,23,15040,15073,12297,-2776
2018,3,17,0,15630,15708,12937,-2771
2018,3,17,1,15380,15500,12765,-2735
2018,3,17,2,14840,14900,12175,-2725
2018,3,17,3,13960,14004,11179,-2825
2018,3,17,4,12930,13063,10232,-2831
2018,3,17,5,12230,12353,9536,-2817
2018,3,17,6,11850,12176,9417,-2759
2018,3,17,7,11630,12246,9372,-2874
2018,3,17,8,11610,12161,9367,-2794
2018,3,17,9,11700,12122,9333,-2789
2018,3,17,10,12090,12140,9406,-2734
2018,3,17,11,12780,12862,10094,-2768
2018,3,17,12,13450,13548,10792,-2756
2018,3,17,13,13930,13920,11236,-2684
2018,3,17,14,13820,13800,11075,-2725
2018,3,17,15,13730,13561,10908,-2653
2018,3,17,16,13490,13291,10622,-2669
2018,3,17,17,13160,12935,10248,-2687
2018,3,17,18,12850,12805,10116,-2689
2018,3,17,19,12730,12884,10120,-2764
2018,3,17,20,12880,12937,10110,-2827
2018,3,17,21,13300,13285,10481,-2804
2018,3,17,22,13900,13458,10684,-2774
2018,3,17,23,14440,14015,11342,-2673
2018,3,18,0,15150,14732,11936,-2796
2018,3,18,1,15070,14685,11915,-2770
2018,3,18,2,14570,14245,11477,-2768
2018,3,18,3,13770,13535,10719,-2816
2018,3,18,4,12900,12776,9970,-2806
2018,3,18,5,12570,12255,9393,-2862
2018,3,18,6,12380,12246,9420,-2826
2018,3,18,7,12310,12238,9450,-2788
2018,3,18,8,12240,12222,9441,-2781
2018,3,18,9,12240,12080,9353,-2727
2018,3,18,10,12460,12379,9754,-2625
2018,3,18,11,12870,12723,10090,-2633
2018,3,18,12,13130,13264,10714,-2550
2018,3,18,13,13300,13563,10959,-2604
2018,3,18,14,13500,13521,10715,-2806
2018,3,18,15,13270,13335,10540,-2795
2018,3,18,16,12890,13182,10483,-2699
2018,3,18,17,12560,12989,10281,-2708
2018,3,18,18,12190,13021,10304,-2717
2018,3,18,19,12040,13092,10341,-2751
2018,3,18,20,12480,12915,10200,-2715
2018,3,18,21,13460,13305,10563,-2742
2018,3,18,22,14260,14138,11325,-2813
2018,3,18,23,15140,14744,12009,-2735
2018,3,19,0,16030,15547,12854,-2693
2018,3,19,1,15670,15359,12621,-2738
2018,3,19,2,14920,14607,11790,-2817
2018,3,19,3,13800,13562,10712,-2850
2018,3,19,4,12740,12604,9647,-2957
2018,3,19,5,12020,12289,9513,-2776
2018,3,19,6,11750,12255,9502,-2753
2018,3,19,7,11670,12180,9357,-2823
2018,3,19,8,11740,11864,9267,-2597
2018,3,19,9,12130,12129,9575,-2554
2018,3,19,10,13200,13178,10848,-2330
2018,3,19,11,15070,15037,12714,-2323
2018,3,19,12,15970,15977,13725,-2252
2018,3,19,13,15590,15619,13231,-2388
2018,3,19,14,14900,14986,12504,-2482
2018,3,19,15,14430,14542,12096,-2446
2018,3,19,16,14060,14189,11615,-2574
2018,3,19,17,13580,13849,11241,-2608
2018,3,19,18,13320,13641,11003,-2638
2018,3,19,19,13240,13625,11025,-2600
2018,3,19,20,13270,13593,10924,-2669
2018,3,19,21,14020,14041,11301,-2740
2018,3,19,22,14790,14606,11811,-2795
2018,3,19,23,15450,15400,12636,-2764
2018,3,20,0,16350,16137,13371,-2766
2018,3,20,1,16060,15906,13047,-2859
2018,3,20,2,15270,15025,12171,-2854
2018,3,20,3,14070,13820,10939,-2881
2018,3,20,4,13040,12937,9986,-2951
2018,3,20,5,12110,12537,9613,-2924
2018,3,20,6,11810,12430,9673,-2757
2018,3,20,7,11710,12322,9584,-2738
2018,3,20,8,11780,12320,9596,-2724
2018,3,20,9,12180,12293,9669,-2624
2018,3,20,10,13260,13235,10660,-2575
2018,3,20,11,15090,15059,12613,-2446
2018,3,20,12,15930,15926,13402,-2524
2018,3,20,13,15470,15498,13021,-2477
2018,3,20,14,14850,14845,12294,-2551
2018,3,20,15,14370,14323,11687,-2636
2018,3,20,16,14040,13965,11301,-2664
2018,3,20,17,13720,14071,11455,-2616
2018,3,20,18,13520,13919,11331,-2588
2018,3,20,19,13300,13802,11168,-2634
2018,3,20,20,13270,13850,11237,-2613
2018,3,20,21,13680,14141,11509,-2632
2018,3,20,22,14350,14796,11932,-2864
2018,3,20,23,15030,15368,12479,-2889
2018,3,21,0,16080,15855,13046,-2809
2018,3,21,1,15660,15517,12694,-2823
2018,3,21,2,14800,14624,11836,-2788
2018,3,21,3,13620,13416,10736,-2680
2018,3,21,4,12540,12356,9673,-2683
2018,3,21,5,11660,11912,9239,-2673
2018,3,21,6,11330,11846,9181,-2665
2018,3,21,7,11160,11702,9137,-2565
2018,3,21,8,11180,11726,9229,-2497
2018,3,21,9,11530,11899,9524,-2375
2018,3,21,10,12530,12496,10183,-2313
2018,3,21,11,14260,14219,11857,-2362
2018,3,21,12,15220,15220,12801,-2419
2018,3,21,13,15470,15476,13044,-2432
2018,3,21,14,15550,15571,13074,-2497
2018,3,21,15,15500,15651,13196,-2455
2018,3,21,16,15470,15550,12896,-2654
2018,3,21,17,15330,15303,12510,-2793
2018,3,21,18,15270,15085,12335,-2750
2018,3,21,19,15070,15006,12088,-2918
2018,3,21,20,15050,15040,12078,-2962
2018,3,21,21,15370,15375,12470,-2905
2018,3,21,22,15560,15861,12867,-2994
2018,3,21,23,15800,16103,13138,-2965
2018,3,22,0,16200,16254,13357,-2897
2018,3,22,1,15730,15728,13032,-2696
2018,3,22,2,14930,14725,11982,-2743
2018,3,22,3,13590,13469,10634,-2835
2018,3,22,4,12470,12533,9643,-2890
2018,3,22,5,11710,12193,9228,-2965
2018,3,22,6,11340,11892,8857,-3035
2018,3,22,7,11260,11735,8668,-3067
2018,3,22,8,11220,11756,8696,-3060
2018,3,22,9,11570,11788,8860,-2928
2018,3,22,10,12530,12538,9705,-2833
2018,3,22,11,14380,14212,11651,-2561
2018,3,22,12,15360,15276,12523,-2753
2018,3,22,13,15320,15579,12782,-2797
2018,3,22,14,15530,15528,12894,-2634
2018,3,22,15,15250,15204,12595,-2609
2018,3,22,16,14790,14818,12194,-2624
2018,3,22,17,14540,14652,12125,-2527
2018,3,22,18,14410,14463,11876,-2587
2018,3,22,19,14230,14221,11607,-2614
2018,3,22,20,14230,14126,11461,-2665
2018,3,22,21,14420,14382,11741,-2641
2018,3,22,22,14640,14517,11761,-2756
2018,3,22,23,15190,14935,12149,-2786
2018,3,23,0,15540,15450,12666,-2784
2018,3,23,1,15330,15189,12478,-2711
2018,3,23,2,14550,14329,11638,-2691
2018,3,23,3,13340,13170,10500,-2670
2018,3,23,4,12310,12628,9767,-2861
2018,3,23,5,11420,12102,9238,-2864
2018,3,23,6,11090,12083,9203,-2880
2018,3,23,7,10970,12241,9377,-2864
2018,3,23,8,11000,12306,9441,-2865
2018,3,23,9,11350,12420,9609,-2811
2018,3,23,10,12340,13004,10388,-2616
2018,3,23,11,14080,14180,11676,-2504
2018,3,23,12,14840,14863,12341,-2522
2018,3,23,13,14640,14681,12044,-2637
2018,3,23,14,14250,14187,11636,-2551
2018,3,23,15,13900,13635,11085,-2550
2018,3,23,16,13720,13337,10876,-2461
2018,3,23,17,13360,13077,10469,-2608
2018,3,23,18,13420,12740,10136,-2604
2018,3,23,19,13290,12957,10271,-2686
2018,3,23,20,13310,13127,10423,-2704
2018,3,23,21,13590,13240,10578,-2662
2018,3,23,22,13890,13700,11114,-2586
2018,3,23,23,14190,14094,11442,-2652
2018,3,24,0,14790,14588,12045,-2543
2018,3,24,1,14580,14369,11968,-2401
2018,3,24,2,13930,13755,11228,-2527
2018,3,24,3,13020,12871,10247,-2624
2018,3,24,4,12020,12186,9524,-2662
2018,3,24,5,11190,11486,8825,-2661
2018,3,24,6,10810,11076,8462,-2614
2018,3,24,7,10620,10878,8400,-2478
2018,3,24,8,10570,10828,8352,-2476
2018,3,24,9,10710,10952,8469,-2483
2018,3,24,10,11120,11162,8743,-2419
2018,3,24,11,11900,11860,9467,-2393
2018,3,24,12,12520,12571,10175,-2396
2018,3,24,13,12940,13047,10724,-2323
2018,3,24,14,12910,12917,10426,-2491
2018,3,24,15,12700,12480,10182,-2298
2018,3,24,16,12420,12112,9640,-2472
2018,3,24,17,12210,12009,9489,-2520
2018,3,24,18,12080,12132,9447,-2685
2018,3,24,19,11980,12110,9257,-2853
2018,3,24,20,12070,11984,9129,-2855
2018,3,24,21,12520,12377,9586,-2791
2018,3,24,22,13030,12875,10154,-2721
2018,3,24,23,13540,13340,10662,-2678
2018,3,25,0,14000,13854,11288,-2566
2018,3,25,1,13880,13696,11083,-2613
2018,3,25,2,13320,13188,10632,-2556
2018,3,25,3,12570,12454,9688,-2766
2018,3,25,4,11730,11648,8920,-2728
2018,3,25,5,11070,11114,8513,-2601
2018,3,25,6,10680,10910,8352,-2558
2018,3,25,7,10520,10952,8447,-2505
2018,3,25,8,10420,10883,8425,-2458
2018,3,25,9,10560,10955,8551,-2404
2018,3,25,10,10850,11021,8602,-2419
2018,3,25,11,11420,11385,9038,-2347
2018,3,25,12,12000,11920,9280,-2640
2018,3,25,13,12480,12696,10116,-2580
2018,3,25,14,13180,13193,10861,-2332
2018,3,25,15,13380,13334,11160,-2174
2018,3,25,16,13280,13151,10939,-2212
2018,3,25,17,13210,12902,10457,-2445
2018,3,25,18,13100,12646,10031,-2615
2018,3,25,19,12920,12371,9816,-2555
2018,3,25,20,12880,12374,9734,-2640
2018,3,25,21,13260,12720,10139,-2581
2018,3,25,22,13780,13432,10869,-2563
2018,3,25,23,14370,14123,11791,-2332
2018,3,26,0,14890,14821,12466,-2355
2018,3,26,1,14650,14704,12243,-2461
2018,3,26,2,13780,13928,11630,-2298
2018,3,26,3,12770,12878,10363,-2515
2018,3,26,4,11760,11908,9290,-2618
2018,3,26,5,11320,11565,8945,-2620
2018,3,26,6,11020,11324,8703,-2621
2018,3,26,7,10920,11215,8650,-2565
2018,3,26,8,11020,11305,8814,-2491
2018,3,26,9,11430,11714,9418,-2296
2018,3,26,10,12400,12545,10397,-2148
2018,3,26,11,14150,14395,12381,-2014
2018,3,26,12,14950,15168,13239,-1929
2018,3,26,13,14610,14619,12408,-2211
2018,3,26,14,13960,13867,11493,-2374
2018,3,26,15,13380,13356,11099,-2257
2018,3,26,16,13050,12993,10855,-2138
2018,3,26,17,12890,12918,10685,-2233
2018,3,26,18,12700,12830,10481,-2349
2018,3,26,19,12630,12817,10399,-2418
2018,3,26,20,12600,12604,10078,-2526
2018,3,26,21,13170,12806,10252,-2554
2018,3,26,22,13930,13705,11079,-2626
2018,3,26,23,14660,14536,12096,-2440
2018,3,27,0,15440,15324,12892,-2432
2018,3,27,1,15200,15179,12717,-2462
2018,3,27,2,14300,14308,11856,-2452
2018,3,27,3,13140,13130,10592,-2538
2018,3,27,4,12080,12298,9527,-2771
2018,3,27,5,11410,12007,9396,-2611
2018,3,27,6,11160,11738,9147,-2591
2018,3,27,7,11040,11656,9049,-2607
2018,3,27,8,11110,11732,9228,-2504
2018,3,27,9,11470,12128,9705,-2423
2018,3,27,10,12590,12957,10803,-2154
2018,3,27,11,14500,14700,12323,-2377
2018,3,27,12,15190,15177,12801,-2376
2018,3,27,13,14560,14624,12366,-2258
2018,3,27,14,13990,13852,11779,-2073
2018,3,27,15,13440,13279,11711,-1568
2018,3,27,16,13080,12894,11380,-1514
2018,3,27,17,12730,12620,11185,-1435
2018,3,27,18,12730,12949,11307,-1642
2018,3,27,19,12680,13165,11469,-1696
2018,3,27,20,12760,13323,11648,-1675
2018,3,27,21,13290,13573,11871,-1702
2018,3,27,22,13910,14213,12437,-1776
2018,3,27,23,14550,14732,12500,-2232
2018,3,28,0,15200,15257,12977,-2280
2018,3,28,1,14990,14902,12527,-2375
2018,3,28,2,14180,14059,12144,-1915
2018,3,28,3,12950,12822,10672,-2150
2018,3,28,4,11890,12051,9724,-2327
2018,3,28,5,10970,11682,9234,-2448
2018,3,28,6,10630,11661,9157,-2504
2018,3,28,7,10450,11489,8802,-2687
2018,3,28,8,10430,11462,8795,-2667
2018,3,28,9,10790,11733,9164,-2569
2018,3,28,10,11800,12227,10071,-2156
2018,3,28,11,13620,13581,11662,-1919
2018,3,28,12,14560,14561,12616,-1945
2018,3,28,13,14570,14593,12791,-1802
2018,3,28,14,13970,14430,12768,-1662
2018,3,28,15,13730,14046,12470,-1576
2018,3,28,16,13410,13235,11568,-1667
2018,3,28,17,13120,12632,11097,-1535
2018,3,28,18,12420,12502,11059,-1443
2018,3,28,19,12440,12658,11073,-1585
2018,3,28,20,12520,12761,11097,-1664
2018,3,28,21,13030,13153,11495,-1658
2018,3,28,22,13750,13577,11804,-1773
2018,3,28,23,14340,14004,12409,-1595
2018,3,29,0,14750,14582,12997,-1585
2018,3,29,1,14420,14384,12556,-1828
2018,3,29,2,13590,13547,11876,-1671
2018,3,29,3,12440,12401,10631,-1770
2018,3,29,4,11330,11566,9311,-2255
2018,3,29,5,10630,11150,9081,-2069
2018,3,29,6,10280,10845,8805,-2040
2018,3,29,7,10130,10690,8676,-2014
2018,3,29,8,10160,10957,8818,-2139
2018,3,29,9,10530,11105,9216,-1889
2018,3,29,10,11540,11721,9969,-1752
2018,3,29,11,13280,13249,11672,-1577
2018,3,29,12,14080,14082,12351,-1731
2018,3,29,13,13890,13914,12119,-1795
2018,3,29,14,13750,13725,11760,-1965
2018,3,29,15,13540,13408,11449,-1959
2018,3,29,16,13450,13084,11276,-1808
2018,3,29,17,13270,13458,11774,-1684
2018,3,29,18,13280,13645,11803,-1842
2018,3,29,19,13180,13339,11291,-2048
2018,3,29,20,13300,13438,11147,-2291
2018,3,29,21,13630,13717,11388,-2329
2018,3,29,22,14030,14076,11677,-2399
2018,3,29,23,14410,14331,11896,-2435
2018,3,30,0,14700,14586,12281,-2305
2018,3,30,1,14310,14210,11779,-2431
2018,3,30,2,13440,13383,11004,-2379
2018,3,30,3,12270,12392,10272,-2120
2018,3,30,4,11130,11678,9422,-2256
2018,3,30,5,10430,10975,8547,-2428
2018,3,30,6,10030,10568,8270,-2298
2018,3,30,7,9810,10386,8140,-2246
2018,3,30,8,9770,10545,8248,-2297
2018,3,30,9,9990,10762,8201,-2561
2018,3,30,10,10780,11383,8867,-2516
2018,3,30,11,12090,12269,9720,-2549
2018,3,30,12,13010,13008,10801,-2207
2018,3,30,13,13560,13546,11206,-2340
2018,3,30,14,13840,13796,11415,-2381
2018,3,30,15,13790,13821,11578,-2243
2018,3,30,16,13790,13764,11490,-2274
2018,3,30,17,13570,13628,11290,-2338
2018,3,30,18,13500,13537,11132,-2405
2018,3,30,19,13460,13182,10815,-2367
2018,3,30,20,13440,12969,10529,-2440
2018,3,30,21,13280,13146,10697,-2449
2018,3,30,22,13400,13482,11257,-2225
2018,3,30,23,13670,13603,11426,-2177
2018,3,31,0,13900,13773,11585,-2188
2018,3,31,1,13360,13483,11366,-2117
2018,3,31,2,12650,12846,10749,-2097
2018,3,31,3,11900,12010,10005,-2005
2018,3,31,4,10870,11320,9319,-2001
2018,3,31,5,10360,10642,9126,-1516
2018,3,31,6,9970,10243,8811,-1432
2018,3,31,7,9770,10304,8697,-1607
2018,3,31,8,9730,10499,8729,-1770
2018,3,31,9,9870,10427,8924,-1503
2018,3,31,10,10300,10814,9041,-1773
2018,3,31,11,10970,11401,9190,-2211
2018,3,31,12,11560,11567,9759,-1808
2018,3,31,13,11760,11767,9921,-1846
2018,3,31,14,11600,11590,9712,-1878
2018,3,31,15,11200,11265,9419,-1846
2018,3,31,16,10770,10948,9029,-1919
2018,3,31,17,10450,10807,8849,-1958
2018,3,31,18,10360,10783,8943,-1840
2018,3,31,19,10350,10433,8822,-1611
2018,3,31,20,10470,10721,8977,-1744
2018,3,31,21,11030,10959,9109,-1850
2018,3,31,22,11650,11627,9785,-1842
2018,3,31,23,12570,12344,10302,-2042
2018,4,1,0,13250,13026,11012,-2014
2018,4,1,1,13040,13079,11137,-1942
2018,4,1,2,12670,12620,10823,-1797
2018,4,1,3,11870,11881,9809,-2072
2018,4,1,4,11000,10991,8942,-2049
2018,4,1,5,10250,10401,8834,-1567
2018,4,1,6,9810,10345,8605,-1740
2018,4,1,7,9570,10342,8426,-1916
2018,4,1,8,9460,10280,8444,-1836
2018,4,1,9,9520,10332,8419,-1913
2018,4,1,10,9770,10304,8526,-1778
2018,4,1,11,10260,10488,8724,-1764
2018,4,1,12,10970,11146,9278,-1868
2018,4,1,13,11680,11688,9720,-1968
2018,4,1,14,12000,11897,10215,-1682
2018,4,1,15,11960,11756,10090,-1666
2018,4,1,16,11620,11546,9745,-1801
2018,4,1,17,11130,11317,9439,-1878
2018,4,1,18,10490,10918,9085,-1833
2018,4,1,19,10140,10571,8501,-2070
2018,4,1,20,10170,10539,8434,-2105
2018,4,1,21,10620,10781,8733,-2048
2018,4,1,22,11020,10983,9104,-1879
2018,4,1,23,11870,11724,9798,-1926
2018,4,2,0,12860,12798,11136,-1662
2018,4,2,1,13500,13074,11476,-1598
2018,4,2,2,12750,12519,10679,-1840
2018,4,2,3,11830,11630,9771,-1859
2018,4,2,4,10850,10757,8878,-1879
2018,4,2,5,10210,10514,8618,-1896
2018,4,2,6,9970,10520,8530,-1990
2018,4,2,7,9890,10418,8543,-1875
2018,4,2,8,9950,10472,8497,-1975
2018,4,2,9,10340,10856,8822,-2034
2018,4,2,10,11460,11987,9802,-2185
2018,4,2,11,13260,13374,11119,-2255
2018,4,2,12,14410,14423,12194,-2229
2018,4,2,13,14900,14907,12492,-2415
2018,4,2,14,15190,15191,12623,-2568
2018,4,2,15,15220,15288,12696,-2592
2018,4,2,16,15110,15087,12563,-2524
2018,4,2,17,14810,14650,12119,-2531
2018,4,2,18,14590,14213,11666,-2547
2018,4,2,19,14200,13916,11433,-2483
2018,4,2,20,13880,13853,11472,-2381
2018,4,2,21,14050,13772,11468,-2304
2018,4,2,22,14390,13927,11556,-2371
2018,4,2,23,14790,14518,12132,-2386
2018,4,3,0,15300,15192,12846,-2346
2018,4,3,1,15040,15088,12740,-2348
2018,4,3,2,14000,14185,11706,-2479
2018,4,3,3,12740,12938,10346,-2592
2018,4,3,4,11550,11839,9440,-2399
2018,4,3,5,11140,11396,9234,-2162
2018,4,3,6,10800,11345,9163,-2182
2018,4,3,7,10690,11230,8855,-2375
2018,4,3,8,10740,11271,8830,-2441
2018,4,3,9,11140,11422,9004,-2418
2018,4,3,10,12200,12176,9853,-2323
2018,4,3,11,13920,13896,11654,-2242
2018,4,3,12,14670,14685,12670,-2015
2018,4,3,13,14280,14328,12223,-2105
2018,4,3,14,13850,13751,11551,-2200
2018,4,3,15,13780,13864,11658,-2206
2018,4,3,16,13770,14087,11939,-2148
2018,4,3,17,13710,14252,12197,-2055
2018,4,3,18,13890,14439,12365,-2074
2018,4,3,19,13920,14386,12187,-2199
2018,4,3,20,14250,14514,12311,-2203
2018,4,3,21,14590,14854,12534,-2320
2018,4,3,22,14970,15363,13184,-2179
2018,4,3,23,15010,15529,13141,-2388
2018,4,4,0,15390,15568,13056,-2512
2018,4,4,1,14970,15157,12919,-2238
2018,4,4,2,13980,14176,11997,-2179
2018,4,4,3,12670,13114,10945,-2169
2018,4,4,4,11480,12284,9867,-2417
2018,4,4,5,10960,11377,8871,-2506
2018,4,4,6,10560,11059,8521,-2538
2018,4,4,7,10390,10924,8478,-2446
2018,4,4,8,10370,10903,8433,-2470
2018,4,4,9,10690,11210,8747,-2463
2018,4,4,10,11680,11760,9167,-2593
2018,4,4,11,13440,13411,10731,-2680
2018,4,4,12,14480,14477,11826,-2651
2018,4,4,13,14660,14682,12060,-2622
2018,4,4,14,14730,14694,12039,-2655
2018,4,4,15,14780,14673,12116,-2557
2018,4,4,16,14670,14570,12155,-2415
2018,4,4,17,14520,14479,11937,-2542
2018,4,4,18,14300,14827,12188,-2639
2018,4,4,19,14080,14715,12024,-2691
2018,4,4,20,14040,14612,11945,-2667
2018,4,4,21,14160,14675,12022,-2653
2018,4,4,22,14250,14705,12118,-2587
2018,4,4,23,14490,14668,12112,-2556
2018,4,5,0,14950,14823,12303,-2520
2018,4,5,1,14930,14727,12274,-2453
2018,4,5,2,13980,13883,11440,-2443
2018,4,5,3,12770,12684,10110,-2574
2018,4,5,4,11740,11837,9406,-2431
2018,4,5,5,11250,11253,9073,-2180
2018,4,5,6,10950,11337,8810,-2527
2018,4,5,7,10880,11373,8825,-2548
2018,4,5,8,10620,11691,9162,-2529
2018,4,5,9,11030,11906,9411,-2495
2018,4,5,10,12270,12728,10358,-2370
2018,4,5,11,14000,13999,11865,-2134
2018,4,5,12,14770,14662,12547,-2115
2018,4,5,13,14140,14168,11892,-2276
2018,4,5,14,13510,13791,11472,-2319
2018,4,5,15,13190,13723,11427,-2296
2018,4,5,16,13010,13753,11417,-2336
2018,4,5,17,12830,13473,11150,-2323
2018,4,5,18,12590,13549,11211,-2338
2018,4,5,19,12560,13414,11070,-2344
2018,4,5,20,12630,13460,11121,-2339
2018,4,5,21,13360,13520,11166,-2354
2018,4,5,22,13770,14011,11633,-2378
2018,4,5,23,14610,14609,12249,-2360
2018,4,6,0,15370,15117,12774,-2343
2018,4,6,1,15580,15158,12867,-2291
2018,4,6,2,14620,14431,12152,-2279
2018,4,6,3,13470,13268,11001,-2267
2018,4,6,4,12390,12404,10075,-2329
2018,4,6,5,11480,11790,9514,-2276
2018,4,6,6,11110,11435,9081,-2354
2018,4,6,7,10980,11314,8957,-2357
2018,4,6,8,11080,11351,8861,-2490
2018,4,6,9,11410,11715,9370,-2345
2018,4,6,10,12380,12514,10137,-2377
2018,4,6,11,14060,14115,11646,-2469
2018,4,6,12,14800,14800,12321,-2479
2018,4,6,13,14750,14559,12095,-2464
2018,4,6,14,14450,14350,11847,-2503
2018,4,6,15,14260,14360,11890,-2470
2018,4,6,16,14230,14513,12023,-2490
2018,4,6,17,14160,14737,12263,-2474
2018,4,6,18,14120,14942,12519,-2423
2018,4,6,19,14060,14961,12530,-2431
2018,4,6,20,14000,14887,12535,-2352
2018,4,6,21,14170,14739,12389,-2350
2018,4,6,22,14450,14669,12210,-2459
2018,4,6,23,14240,14573,12055,-2518
2018,4,7,0,14600,14751,12287,-2464
2018,4,7,1,14330,14523,11978,-2545
2018,4,7,2,13650,13787,11452,-2335
2018,4,7,3,12600,12753,10605,-2148
2018,4,7,4,11630,11746,9466,-2280
2018,4,7,5,10980,11252,8951,-2301
2018,4,7,6,10520,10965,8681,-2284
2018,4,7,7,10290,10812,8674,-2138
2018,4,7,8,10210,10735,8581,-2154
2018,4,7,9,10330,10839,8556,-2283
2018,4,7,10,10750,11186,9015,-2171
2018,4,7,11,11510,11569,9443,-2126
2018,4,7,12,12390,12359,10176,-2183
2018,4,7,13,13230,13203,11015,-2188
2018,4,7,14,13500,13488,11242,-2246
2018,4,7,15,13470,13063,10841,-2222
2018,4,7,16,13120,12568,10346,-2222
2018,4,7,17,12880,12109,9938,-2171
2018,4,7,18,12580,11993,9710,-2283
2018,4,7,19,12310,11726,9591,-2135
2018,4,7,20,12240,11486,9345,-2141
2018,4,7,21,12280,12105,9939,-2166
2018,4,7,22,12650,12510,10362,-2148
2018,4,7,23,12960,12876,10765,-2111
2018,4,8,0,13690,13489,11414,-2075
2018,4,8,1,13710,13540,11469,-2071
2018,4,8,2,13300,13030,10958,-2072
2018,4,8,3,12510,12296,10188,-2108
2018,4,8,4,11700,11515,9293,-2222
2018,4,8,5,11180,11138,8777,-2361
2018,4,8,6,10630,10774,8412,-2362
2018,4,8,7,10540,10614,8368,-2246
2018,4,8,8,10460,10570,8401,-2169
2018,4,8,9,10580,10674,8491,-2183
2018,4,8,10,11010,10986,8938,-2048
2018,4,8,11,11450,11458,9301,-2157
2018,4,8,12,12030,11887,9624,-2263
2018,4,8,13,12270,12312,10124,-2188
2018,4,8,14,12160,12402,10211,-2191
2018,4,8,15,12160,12454,10251,-2203
2018,4,8,16,12000,12187,9997,-2190
2018,4,8,17,11920,12042,9847,-2195
2018,4,8,18,11730,11919,9731,-2188
2018,4,8,19,11690,11805,9551,-2254
2018,4,8,20,11840,11986,9724,-2262
2018,4,8,21,12380,12391,10076,-2315
2018,4,8,22,12700,13095,10771,-2324
2018,4,8,23,13860,13642,11384,-2258
2018,4,9,0,14750,14297,12154,-2143
2018,4,9,1,14800,14257,12114,-2143
2018,4,9,2,13570,13494,11253,-2241
2018,4,9,3,12570,12463,10101,-2362
2018,4,9,4,11600,11778,9377,-2401
2018,4,9,5,10960,11511,8998,-2513
2018,4,9,6,10680,11217,8678,-2539
2018,4,9,7,10600,11154,8679,-2475
2018,4,9,8,10730,11262,8757,-2505
2018,4,9,9,11180,11695,9312,-2383
2018,4,9,10,12330,12402,10204,-2198
2018,4,9,11,14180,13935,11750,-2185
2018,4,9,12,15070,14608,12414,-2194
2018,4,9,13,14370,14190,11919,-2271
2018,4,9,14,13610,13643,11301,-2342
2018,4,9,15,13210,13212,10935,-2277
2018,4,9,16,13000,12936,10626,-2310
2018,4,9,17,12620,12598,10349,-2249
2018,4,9,18,12450,12554,10287,-2267
2018,4,9,19,12320,12305,10265,-2040
2018,4,9,20,12470,12330,10309,-2021
2018,4,9,21,12900,12810,10773,-2037
2018,4,9,22,13710,13500,11391,-2109
2018,4,9,23,14370,14209,11921,-2288
2018,4,10,0,15150,14849,12516,-2333
2018,4,10,1,15030,14795,12509,-2286
2018,4,10,2,14120,13896,11605,-2291
2018,4,10,3,12890,12673,10439,-2234
2018,4,10,4,11830,11626,9230,-2396
2018,4,10,5,11010,10935,8682,-2253
2018,4,10,6,10610,10617,8392,-2225
2018,4,10,7,10510,10725,8580,-2145
2018,4,10,8,10520,10738,8690,-2048
2018,4,10,9,10880,11096,9029,-2067
2018,4,10,10,11890,11888,9899,-1989
2018,4,10,11,13650,13521,11678,-1843
2018,4,10,12,14530,14444,12582,-1862
2018,4,10,13,14460,14526,12543,-1983
2018,4,10,14,14340,14459,12367,-2092
2018,4,10,15,14160,14490,12353,-2137
2018,4,10,16,14120,14400,12192,-2208
2018,4,10,17,13840,14193,11987,-2206
2018,4,10,18,13780,14054,11898,-2156
2018,4,10,19,13650,13841,11732,-2109
2018,4,10,20,13770,13728,11643,-2085
2018,4,10,21,13900,13924,11879,-2045
2018,4,10,22,14210,14348,12289,-2059
2018,4,10,23,14490,14648,12570,-2078
2018,4,11,0,15070,15025,12964,-2061
2018,4,11,1,14870,14968,12978,-1990
2018,4,11,2,14040,14119,12141,-1978
2018,4,11,3,12750,12908,10832,-2076
2018,4,11,4,11640,11857,9609,-2248
2018,4,11,5,10960,11223,8978,-2245
2018,4,11,6,10620,11193,9057,-2136
2018,4,11,7,10530,11121,8953,-2168
2018,4,11,8,10840,11110,8898,-2212
2018,4,11,9,11230,11413,9286,-2127
2018,4,11,10,12170,12330,10431,-1899
2018,4,11,11,13570,13980,12032,-1948
2018,4,11,12,14230,14633,12737,-1896
2018,4,11,13,13850,14110,12177,-1933
2018,4,11,14,13280,13316,11313,-2003
2018,4,11,15,12770,12820,10750,-2070
2018,4,11,16,12500,12602,10402,-2200
2018,4,11,17,12340,12401,10158,-2243
2018,4,11,18,12340,12359,10099,-2260
2018,4,11,19,12330,12592,10308,-2284
2018,4,11,20,12480,12812,10545,-2267
2018,4,11,21,12800,13185,10866,-2319
2018,4,11,22,13430,13523,11172,-2351
2018,4,11,23,13930,13920,11584,-2336
2018,4,12,0,14610,14485,12189,-2296
2018,4,12,1,14510,14544,12361,-2183
2018,4,12,2,13780,13717,11452,-2265
2018,4,12,3,12560,12528,10244,-2284
2018,4,12,4,11450,11637,9361,-2276
2018,4,12,5,10790,11072,8782,-2290
2018,4,12,6,10440,10960,8626,-2334
2018,4,12,7,10320,10884,8550,-2334
2018,4,12,8,10360,10909,8604,-2305
2018,4,12,9,10750,11288,9119,-2169
2018,4,12,10,11820,12006,10031,-1975
2018,4,12,11,13410,13388,11415,-1973
2018,4,12,12,13960,13975,11879,-2096
2018,4,12,13,13430,13466,11401,-2065
2018,4,12,14,12900,12819,10897,-1922
2018,4,12,15,12660,12576,10827,-1749
2018,4,12,16,12640,12572,10747,-1825
2018,4,12,17,12690,12555,11092,-1463
2018,4,12,18,12670,12626,11220,-1406
2018,4,12,19,12730,12801,11459,-1342
2018,4,12,20,13050,13082,11449,-1633
2018,4,12,21,13280,13419,11601,-1818
2018,4,12,22,13730,13871,11915,-1956
2018,4,12,23,13940,14201,12071,-2130
2018,4,13,0,14400,14473,12434,-2039
2018,4,13,1,14250,14186,12216,-1970
2018,4,13,2,13350,13307,11295,-2012
2018,4,13,3,12170,12165,10286,-1879
2018,4,13,4,11040,11304,9138,-2166
2018,4,13,5,10310,10840,8780,-2060
2018,4,13,6,9930,10725,8737,-1988
2018,4,13,7,9720,10587,8422,-2165
2018,4,13,8,9700,10762,8584,-2178
2018,4,13,9,10000,10535,8530,-2005
2018,4,13,10,10960,11167,9093,-2074
2018,4,13,11,12410,12388,10260,-2128
2018,4,13,12,13130,13125,10873,-2252
2018,4,13,13,13230,13253,11182,-2071
2018,4,13,14,13430,13443,11382,-2061
2018,4,13,15,13320,13423,11421,-2002
2018,4,13,16,13190,13202,10977,-2225
2018,4,13,17,12920,13024,10828,-2196
2018,4,13,18,12860,12826,10522,-2304
2018,4,13,19,12720,12859,10451,-2408
2018,4,13,20,12720,12728,10348,-2380
2018,4,13,21,12720,12528,10186,-2342
2018,4,13,22,12900,12612,10374,-2238
2018,4,13,23,13100,12837,10653,-2184
2018,4,14,0,13410,13206,10999,-2207
2018,4,14,1,13400,13191,11100,-2091
2018,4,14,2,12850,12519,10366,-2153
2018,4,14,3,11760,11576,9407,-2169
2018,4,14,4,10730,10848,8765,-2083
2018,4,14,5,9880,10472,8294,-2178
2018,4,14,6,9450,10334,8304,-2030
2018,4,14,7,9270,10486,8461,-2025
2018,4,14,8,9190,10494,8328,-2166
2018,4,14,9,9270,10341,8484,-1857
2018,4,14,10,9650,10687,8741,-1946
2018,4,14,11,10230,11251,9215,-2036
2018,4,14,12,10800,11431,9413,-2018
2018,4,14,13,11160,11194,9404,-1790
2018,4,14,14,11280,11167,9544,-1623
2018,4,14,15,11360,11084,9609,-1475
2018,4,14,16,11340,11066,9519,-1547
2018,4,14,17,11290,10977,9693,-1284
2018,4,14,18,11200,10862,9598,-1264
2018,4,14,19,11040,10869,9494,-1375
2018,4,14,20,11260,11101,9830,-1271
2018,4,14,21,11800,11570,10196,-1374
2018,4,14,22,12320,12175,10691,-1484
2018,4,14,23,12860,12583,11041,-1542
2018,4,15,0,12980,12907,11115,-1792
2018,4,15,1,13030,12836,11249,-1587
2018,4,15,2,12590,12303,10578,-1725
2018,4,15,3,11710,11570,9837,-1733
2018,4,15,4,10860,10824,9154,-1670
2018,4,15,5,10170,10537,8674,-1863
2018,4,15,6,9820,10333,8512,-1821
2018,4,15,7,9670,10181,8336,-1845
2018,4,15,8,9620,10120,8228,-1892
2018,4,15,9,9700,10187,8305,-1882
2018,4,15,10,10010,10121,8242,-1879
2018,4,15,11,10490,10465,8684,-1781
2018,4,15,12,11210,11182,9529,-1653
2018,4,15,13,12090,12066,10521,-1545
2018,4,15,14,12880,12846,11180,-1666
2018,4,15,15,13420,13337,11369,-1968
2018,4,15,16,13690,13575,11546,-2029
2018,4,15,17,13790,13672,11845,-1827
2018,4,15,18,13910,13638,11681,-1957
2018,4,15,19,13870,13587,11604,-1983
2018,4,15,20,13820,13653,11694,-1959
2018,4,15,21,14200,13962,11893,-2069
2018,4,15,22,14540,14333,12110,-2223
2018,4,15,23,14860,14501,12252,-2249
2018,4,16,0,14820,14643,12569,-2074
2018,4,16,1,14570,14346,12613,-1733
2018,4,16,2,13760,13555,11813,-1742
2018,4,16,3,12650,12571,10515,-2056
2018,4,16,4,11580,11687,9784,-1903
2018,4,16,5,10780,11265,9270,-1995
2018,4,16,6,10370,10988,9252,-1736
2018,4,16,7,10220,10828,9109,-1719
2018,4,16,8,10230,11107,9167,-1940
2018,4,16,9,10610,11253,9693,-1560
2018,4,16,10,11610,11769,9999,-1770
2018,4,16,11,12920,13082,11335,-1747
2018,4,16,12,14220,14162,12393,-1769
2018,4,16,13,14660,14834,13154,-1680
2018,4,16,14,15260,15256,13436,-1820
2018,4,16,15,15530,15477,13465,-2012
2018,4,16,16,15640,15529,13605,-1924
2018,4,16,17,15610,15424,13666,-1758
2018,4,16,18,15520,15329,13498,-1831
2018,4,16,19,15330,15093,13129,-1964
2018,4,16,20,15340,14913,12953,-1960
2018,4,16,21,15370,15099,13020,-2079
2018,4,16,22,15660,15052,13013,-2039
2018,4,16,23,15440,14878,12890,-1988
2018,4,17,0,15500,14865,12875,-1990
2018,4,17,1,15410,14579,12877,-1702
2018,4,17,2,14250,13806,11932,-1874
2018,4,17,3,12680,12667,10487,-2180
2018,4,17,4,11280,11848,9676,-2172
2018,4,17,5,10570,11153,9217,-1936
2018,4,17,6,10180,10788,8692,-2096
2018,4,17,7,10000,10716,8579,-2137
2018,4,17,8,10000,10767,8716,-2051
2018,4,17,9,10350,11116,9081,-2035
2018,4,17,10,11290,11536,9498,-2038
2018,4,17,11,12650,12580,10699,-1881
2018,4,17,12,13480,13398,11441,-1957
2018,4,17,13,13250,13456,11487,-1969
2018,4,17,14,13000,13345,11213,-2132
2018,4,17,15,12890,13461,11437,-2024
2018,4,17,16,13020,13397,11448,-1949
2018,4,17,17,12960,13189,11333,-1856
2018,4,17,18,13080,13481,11819,-1662
2018,4,17,19,13000,13331,11636,-1695
2018,4,17,20,13110,13721,11855,-1866
2018,4,17,21,13440,14221,12384,-1837
2018,4,17,22,13830,14237,12342,-1895
2018,4,17,23,14130,14295,12370,-1925
2018,4,18,0,14410,14583,12632,-1951
2018,4,18,1,14460,14470,12775,-1695
2018,4,18,2,13550,13671,11805,-1866
2018,4,18,3,12310,12883,10879,-2004
2018,4,18,4,11200,12044,10015,-2029
2018,4,18,5,10830,11489,9281,-2208
2018,4,18,6,10450,11321,9053,-2268
2018,4,18,7,10330,11272,9012,-2260
2018,4,18,8,10350,11208,8997,-2211
2018,4,18,9,10720,11164,9033,-2131
2018,4,18,10,11610,11699,9629,-2070
2018,4,18,11,12890,12996,10881,-2115
2018,4,18,12,13710,13764,11593,-2171
2018,4,18,13,13470,13754,11517,-2237
2018,4,18,14,13080,13511,11313,-2198
2018,4,18,15,12810,13247,11131,-2116
2018,4,18,16,12480,12940,10829,-2111
2018,4,18,17,12580,12614,10384,-2230
2018,4,18,18,12500,12884,10690,-2194
2018,4,18,19,12410,12956,10746,-2210
2018,4,18,20,12610,12961,10876,-2085
2018,4,18,21,12880,12932,10678,-2254
2018,4,18,22,13420,13266,11145,-2121
2018,4,18,23,13510,13734,11609,-2125
2018,4,19,0,14020,14164,11872,-2292
2018,4,19,1,14130,14199,12010,-2189
2018,4,19,2,13350,13421,11264,-2157
2018,4,19,3,12140,12296,10178,-2118
2018,4,19,4,11040,11482,9131,-2351
2018,4,19,5,10550,10706,8569,-2137
2018,4,19,6,10170,10468,8344,-2124
2018,4,19,7,10010,10380,8197,-2183
2018,4,19,8,10000,10531,8239,-2292
2018,4,19,9,10290,10627,8365,-2262
2018,4,19,10,11310,11465,9328,-2137
2018,4,19,11,12920,12671,10432,-2239
2018,4,19,12,13900,13837,11591,-2246
2018,4,19,13,14080,14393,12195,-2198
2018,4,19,14,14540,14612,12556,-2056
2018,4,19,15,14570,14684,12455,-2229
2018,4,19,16,14560,14466,12306,-2160
2018,4,19,17,14530,14218,12024,-2194
2018,4,19,18,14410,14286,11966,-2320
2018,4,19,19,14330,14257,11963,-2294
2018,4,19,20,14310,13977,11702,-2275
2018,4,19,21,14480,13828,11631,-2197
2018,4,19,22,14790,13923,11666,-2257
2018,4,19,23,14960,14255,12016,-2239
2018,4,20,0,15150,14588,12406,-2182
2018,4,20,1,14700,14546,12514,-2032
2018,4,20,2,13790,13793,11598,-2195
2018,4,20,3,12570,12675,10607,-2068
2018,4,20,4,11470,11899,9661,-2238
2018,4,20,5,10930,11000,9000,-2000
2018,4,20,6,10570,10580,8498,-2082
2018,4,20,7,10400,10686,8567,-2119
2018,4,20,8,10410,10691,8505,-2186
2018,4,20,9,10770,11017,8778,-2239
2018,4,20,10,11610,11662,9631,-2031
2018,4,20,11,12870,12920,11274,-1646
2018,4,20,12,13540,13595,12122,-1473
2018,4,20,13,13330,13446,11774,-1672
2018,4,20,14,13130,13096,11194,-1902
2018,4,20,15,12530,12998,11192,-1806
2018,4,20,16,12330,12601,10801,-1800
2018,4,20,17,12210,12621,10724,-1897
2018,4,20,18,12140,12295,10336,-1959
2018,4,20,19,12070,12007,10037,-1970
2018,4,20,20,12320,12112,10118,-1994
2018,4,20,21,12560,12547,10501,-2046
2018,4,20,22,12840,12790,10693,-2097
2018,4,20,23,13040,13162,11032,-2130
2018,4,21,0,13470,13564,11477,-2087
2018,4,21,1,13710,13729,11693,-2036
2018,4,21,2,13080,13157,10940,-2217
2018,4,21,3,12170,12273,10071,-2202
2018,4,21,4,11150,11332,9162,-2170
2018,4,21,5,10670,10645,8468,-2177
2018,4,21,6,10230,10417,8338,-2079
2018,4,21,7,10040,10331,8218,-2113
2018,4,21,8,9980,10293,8172,-2121
2018,4,21,9,10090,10418,8452,-1966
2018,4,21,10,10420,10583,8615,-1968
2018,4,21,11,10720,11073,9211,-1862
2018,4,21,12,11030,11415,9714,-1701
2018,4,21,13,11400,11410,9788,-1622
2018,4,21,14,11180,11213,9702,-1511
2018,4,21,15,10880,11545,9958,-1587
2018,4,21,16,10470,11421,9764,-1657
2018,4,21,17,10340,11127,9729,-1398
2018,4,21,18,10170,10943,9581,-1362
2018,4,21,19,10050,10921,9458,-1463
2018,4,21,20,10250,11213,9592,-1621
2018,4,21,21,10590,11471,9768,-1703
2018,4,21,22,11270,11843,10024,-1819
2018,4,21,23,11860,12081,10324,-1757
2018,4,22,0,12320,12310,10471,-1839
2018,4,22,1,12680,12583,10753,-1830
2018,4,22,2,12300,12114,10250,-1864
2018,4,22,3,11520,11620,9867,-1753
2018,4,22,4,10690,10844,9087,-1757
2018,4,22,5,10080,10345,8804,-1541
2018,4,22,6,9660,10139,8455,-1684
2018,4,22,7,9440,9975,8322,-1653
2018,4,22,8,9450,9932,8292,-1640
2018,4,22,9,9490,10032,8345,-1687
2018,4,22,10,9750,10097,8468,-1629
2018,4,22,11,10000,10208,8621,-1587
2018,4,22,12,10290,10396,8870,-1526
2018,4,22,13,10490,10390,8808,-1582
2018,4,22,14,10290,10258,8787,-1471
2018,4,22,15,10130,10087,8863,-1224
2018,4,22,16,9960,9935,8777,-1158
2018,4,22,17,9690,10065,8855,-1210
2018,4,22,18,9600,9921,8719,-1202
2018,4,22,19,9420,10063,8942,-1121
2018,4,22,20,9640,10088,8942,-1146
2018,4,22,21,10240,10605,9435,-1170
2018,4,22,22,11340,11306,9836,-1470
2018,4,22,23,11960,12013,10196,-1817
2018,4,23,0,12620,12559,10804,-1755
2018,4,23,1,12980,12912,11340,-1572
2018,4,23,2,12270,12195,10555,-1640
2018,4,23,3,11210,11138,9417,-1721
2018,4,23,4,10310,10459,8605,-1854
2018,4,23,5,9630,9709,7890,-1819
2018,4,23,6,9360,9427,7673,-1754
2018,4,23,7,9300,9540,7626,-1914
2018,4,23,8,9400,9401,7659,-1742
2018,4,23,9,9850,9837,7986,-1851
2018,4,23,10,10950,10915,8991,-1924
2018,4,23,11,12500,12473,10506,-1967
2018,4,23,12,13040,13060,11212,-1848
2018,4,23,13,12540,12574,10747,-1827
2018,4,23,14,12050,12064,10305,-1759
2018,4,23,15,11620,11757,10227,-1530
2018,4,23,16,11410,11567,10111,-1456
2018,4,23,17,11120,11385,10049,-1336
2018,4,23,18,10920,11316,9877,-1439
2018,4,23,19,10760,11214,9733,-1481
2018,4,23,20,10880,11295,9763,-1532
2018,4,23,21,11330,11705,10041,-1664
2018,4,23,22,12050,12385,10699,-1686
2018,4,23,23,12580,12968,11141,-1827
2018,4,24,0,13400,13404,11616,-1788
2018,4,24,1,13500,13650,11969,-1681
2018,4,24,2,12670,12797,10990,-1807
2018,4,24,3,11410,11554,9569,-1985
2018,4,24,4,10390,10616,8561,-2055
2018,4,24,5,9790,10063,7993,-2070
2018,4,24,6,9450,9825,7771,-2054
2018,4,24,7,9350,9865,7769,-2096
2018,4,24,8,9410,9917,7809,-2108
2018,4,24,9,9790,10117,8047,-2070
2018,4,24,10,10820,10790,8843,-1947
2018,4,24,11,12310,12279,10122,-2157
2018,4,24,12,12850,12852,10739,-2113
2018,4,24,13,12440,12472,10290,-2182
2018,4,24,14,11980,11990,9894,-2096
2018,4,24,15,11790,11679,9622,-2057
2018,4,24,16,11630,11511,9440,-2071
2018,4,24,17,11660,11470,9643,-1827
2018,4,24,18,11740,11578,10013,-1565
2018,4,24,19,11720,11360,9838,-1522
2018,4,24,20,11850,11602,10049,-1553
2018,4,24,21,12150,12057,10514,-1543
2018,4,24,22,12560,12708,11053,-1655
2018,4,24,23,12930,13123,11290,-1833
2018,4,25,0,13380,13559,11588,-1971
2018,4,25,1,13650,13619,11653,-1966
2018,4,25,2,12810,12733,10972,-1761
2018,4,25,3,11550,11488,9559,-1929
2018,4,25,4,10420,10427,8683,-1744
2018,4,25,5,9680,10279,8387,-1892
2018,4,25,6,9290,10095,8153,-1942
2018,4,25,7,9110,9910,7962,-1948
2018,4,25,8,9100,9899,8126,-1773
2018,4,25,9,9410,10199,8523,-1676
2018,4,25,10,10350,10903,9178,-1725
2018,4,25,11,11900,12066,10244,-1822
2018,4,25,12,13010,13005,11320,-1685
2018,4,25,13,13380,13382,11887,-1495
2018,4,25,14,13500,13481,12227,-1254
2018,4,25,15,13540,13501,12089,-1412
2018,4,25,16,13470,13540,12035,-1505
2018,4,25,17,13410,13579,11751,-1828
2018,4,25,18,13380,13675,11881,-1794
2018,4,25,19,13280,13627,11959,-1668
2018,4,25,20,13380,13612,11859,-1753
2018,4,25,21,13510,13800,12253,-1547
2018,4,25,22,13720,14095,12497,-1598
2018,4,25,23,13790,14170,12425,-1745
2018,4,26,0,14000,14193,12268,-1925
2018,4,26,1,13800,13908,12084,-1824
2018,4,26,2,12880,13009,11399,-1610
2018,4,26,3,11630,11969,10183,-1786
2018,4,26,4,10510,10945,9067,-1878
2018,4,26,5,9850,10206,7960,-2246
2018,4,26,6,9460,9757,7818,-1939
2018,4,26,7,9290,9707,7794,-1913
2018,4,26,8,9280,9676,7584,-2092
2018,4,26,9,9520,9821,7546,-2275
2018,4,26,10,10420,10428,8266,-2162
2018,4,26,11,12020,12011,9891,-2120
2018,4,26,12,12980,13099,10953,-2146
2018,4,26,13,13320,13362,11292,-2070
2018,4,26,14,13200,13223,11101,-2122
2018,4,26,15,12940,12913,10767,-2146
2018,4,26,16,12720,12598,10438,-2160
2018,4,26,17,12340,12342,10190,-2152
2018,4,26,18,12230,12478,10371,-2107
2018,4,26,19,12140,12653,10644,-2009
2018,4,26,20,12330,12558,10549,-2009
2018,4,26,21,12560,12533,10584,-1949
2018,4,26,22,12830,12687,10819,-1868
2018,4,26,23,13070,13026,11045,-1981
2018,4,27,0,13480,13305,11348,-1957
2018,4,27,1,13670,13537,12040,-1497
2018,4,27,2,12870,12811,11338,-1473
2018,4,27,3,11680,11620,9919,-1701
2018,4,27,4,10550,10679,8785,-1894
2018,4,27,5,9830,10285,8372,-1913
2018,4,27,6,9440,9907,8164,-1743
2018,4,27,7,9250,9965,8220,-1745
2018,4,27,8,9230,9835,8395,-1440
2018,4,27,9,9540,9882,8275,-1607
2018,4,27,10,10410,10335,9034,-1301
2018,4,27,11,11800,11715,10093,-1622
2018,4,27,12,12740,12427,10931,-1496
2018,4,27,13,12740,12353,11187,-1166
2018,4,27,14,12230,12252,10901,-1351
2018,4,27,15,12420,12684,11338,-1346
2018,4,27,16,12550,13131,11794,-1337
2018,4,27,17,12700,13199,11859,-1340
2018,4,27,18,12810,13305,11969,-1336
2018,4,27,19,12720,13221,11910,-1311
2018,4,27,20,12810,13225,11835,-1390
2018,4,27,21,12900,13286,11584,-1702
2018,4,27,22,12960,13394,11616,-1778
2018,4,27,23,13010,13420,11743,-1677
2018,4,28,0,13190,13416,11381,-2035
2018,4,28,1,13170,13244,11103,-2141
2018,4,28,2,12490,12554,10516,-2038
2018,4,28,3,11500,11578,9330,-2248
2018,4,28,4,10500,10585,8276,-2309
2018,4,28,5,9850,10105,7646,-2459
2018,4,28,6,9420,9645,7259,-2386
2018,4,28,7,9210,9584,7213,-2371
2018,4,28,8,9100,9573,7143,-2430
2018,4,28,9,9190,9674,7373,-2301
2018,4,28,10,9520,9773,7367,-2406
2018,4,28,11,10020,10311,7877,-2434
2018,4,28,12,10720,10639,8542,-2097
2018,4,28,13,11160,11064,8848,-2216
2018,4,28,14,11070,11067,8862,-2205
2018,4,28,15,10930,10774,8819,-1955
2018,4,28,16,10670,10497,8422,-2075
2018,4,28,17,10450,10282,8175,-2107
2018,4,28,18,10290,10195,8155,-2040
2018,4,28,19,10220,10184,8289,-1895
2018,4,28,20,10430,10177,8270,-1907
2018,4,28,21,10890,10655,8643,-2012
2018,4,28,22,11420,11302,9170,-2132
2018,4,28,23,11810,11705,9600,-2105
2018,4,29,0,12210,11962,9773,-2189
2018,4,29,1,12430,12255,10038,-2217
2018,4,29,2,12030,11730,9629,-2101
2018,4,29,3,11220,10925,8761,-2164
2018,4,29,4,10320,10216,8181,-2035
2018,4,29,5,9550,10077,8040,-2037
2018,4,29,6,9100,9760,8081,-1679
2018,4,29,7,8820,9779,8076,-1703
2018,4,29,8,8800,9910,7899,-2011
2018,4,29,9,8840,9971,7847,-2124
2018,4,29,10,8970,10073,7972,-2101
2018,4,29,11,9320,10189,8043,-2146
2018,4,29,12,9940,10443,8486,-1957
2018,4,29,13,10580,10773,8884,-1889
2018,4,29,14,11530,11494,9614,-1880
2018,4,29,15,11710,11866,10022,-1844
2018,4,29,16,11720,11917,10012,-1905
2018,4,29,17,11700,11713,9751,-1962
2018,4,29,18,11510,11499,9471,-2028
2018,4,29,19,11450,11229,9121,-2108
2018,4,29,20,11400,11226,9160,-2066
2018,4,29,21,11680,11558,9559,-1999
2018,4,29,22,12250,12102,10097,-2005
2018,4,29,23,12590,12528,10526,-2002
2018,4,30,0,12810,12829,10889,-1940
2018,4,30,1,12900,12977,11035,-1942
2018,4,30,2,12270,12244,10188,-2056
2018,4,30,3,11270,11193,9096,-2097
2018,4,30,4,10300,10343,8225,-2118
2018,4,30,5,9590,10022,8107,-1915
2018,4,30,6,9270,9833,8053,-1780
2018,4,30,7,9160,9718,7893,-1825
2018,4,30,8,9210,9755,7945,-1810
2018,4,30,9,9580,10089,8173,-1916
2018,4,30,10,10630,11088,9172,-1916
2018,4,30,11,12140,12181,10440,-1741
2018,4,30,12,13180,13073,11502,-1571
2018,4,30,13,13370,13204,11841,-1363
2018,4,30,14,13280,13256,11915,-1341
2018,4,30,15,13410,13317,11965,-1352
2018,4,30,16,13410,13232,12126,-1106
2018,4,30,17,13370,13051,11964,-1087
2018,4,30,18,13270,13042,11841,-1201
2018,4,30,19,13350,13066,11997,-1069
2018,4,30,20,13350,13078,11858,-1220
2018,4,30,21,13430,13322,11904,-1418
2018,4,30,22,13760,13675,12115,-1560
2018,4,30,23,13940,13864,12097,-1767
2018,5,1,0,14180,14096,12273,-1823
2018,5,1,1,14140,14127,12514,-1613
2018,5,1,2,13270,13236,11257,-1979
2018,5,1,3,11870,11992,9954,-2038
2018,5,1,4,10830,10970,8950,-2020
2018,5,1,5,9940,10781,8589,-2192
2018,5,1,6,9650,10602,8292,-2310
2018,5,1,7,9470,10437,8083,-2354
2018,5,1,8,9510,10427,8101,-2326
2018,5,1,9,9740,10737,8649,-2088
2018,5,1,10,10620,11479,9629,-1850
2018,5,1,11,12110,12376,10836,-1540
2018,5,1,12,12790,13018,11423,-1595
2018,5,1,13,12870,12808,11156,-1652
2018,5,1,14,12710,12685,10953,-1732
2018,5,1,15,12320,12592,11013,-1579
2018,5,1,16,12220,12769,11114,-1655
2018,5,1,17,11960,12800,11186,-1614
2018,5,1,18,11970,12469,10722,-1747
2018,5,1,19,12020,11512,9696,-1816
2018,5,1,20,12270,11663,9990,-1673
2018,5,1,21,12490,12060,10690,-1370
2018,5,1,22,12920,12714,11133,-1581
2018,5,1,23,13260,13132,11355,-1777
2018,5,2,0,13610,13519,11643,-1876
2018,5,2,1,14000,13718,11770,-1948
2018,5,2,2,13050,12878,10817,-2061
2018,5,2,3,11690,11699,9631,-2068
2018,5,2,4,10540,10753,8645,-2108
2018,5,2,5,9670,10354,8077,-2277
2018,5,2,6,9260,10296,7908,-2388
2018,5,2,7,9070,10349,7851,-2498
2018,5,2,8,9030,10322,7843,-2479
2018,5,2,9,9290,10590,8280,-2310
2018,5,2,10,10070,10878,8910,-1968
2018,5,2,11,11590,11645,9828,-1817
2018,5,2,12,12430,12352,10482,-1870
2018,5,2,13,12500,12359,10325,-2034
2018,5,2,14,12280,12296,10281,-2015
2018,5,2,15,12540,12328,10404,-1924
2018,5,2,16,12670,12405,10425,-1980
2018,5,2,17,12960,12527,10821,-1706
2018,5,2,18,13250,12824,11027,-1797
2018,5,2,19,13400,13105,11395,-1710
2018,5,2,20,13730,13504,11656,-1848
2018,5,2,21,14190,14038,12084,-1954
2018,5,2,22,14470,14459,12468,-1991
2018,5,2,23,14690,14593,12413,-2180
2018,5,3,0,14770,14738,12529,-2209
2018,5,3,1,15000,14958,12911,-2047
2018,5,3,2,14080,14082,12124,-1958
2018,5,3,3,12570,12679,10585,-2094
2018,5,3,4,11260,11534,9589,-1945
2018,5,3,5,10470,10909,8778,-2131
2018,5,3,6,9930,10480,8421,-2059
2018,5,3,7,9620,10231,8100,-2131
2018,5,3,8,9510,10272,8033,-2239
2018,5,3,9,9720,10244,7956,-2288
2018,5,3,10,10560,10808,8777,-2031
2018,5,3,11,11990,12216,10450,-1766
2018,5,3,12,12970,13220,11533,-1687
2018,5,3,13,13230,13468,11717,-1751
2018,5,3,14,13270,13296,11514,-1782
2018,5,3,15,13530,13792,12098,-1694
2018,5,3,16,13930,14358,12699,-1659
2018,5,3,17,14210,14880,13248,-1632
2018,5,3,18,14760,15341,13692,-1649
2018,5,3,19,14940,15546,13833,-1713
2018,5,3,20,15130,15679,14078,-1601
2018,5,3,21,15360,15825,14160,-1665
2018,5,3,22,15600,15887,14134,-1753
2018,5,3,23,15770,15866,14252,-1614
2018,5,4,0,15700,15976,14228,-1748
2018,5,4,1,16000,15845,14228,-1617
2018,5,4,2,15090,14986,13192,-1794
2018,5,4,3,13660,13590,11649,-1941
2018,5,4,4,12390,12373,10397,-1976
2018,5,4,5,11350,11666,9702,-1964
2018,5,4,6,10790,11170,9237,-1933
2018,5,4,7,10460,11172,9175,-1997
2018,5,4,8,10330,11309,9254,-2055
2018,5,4,9,10500,11542,9571,-1971
2018,5,4,10,11310,11842,10121,-1721
2018,5,4,11,12790,13053,11703,-1350
2018,5,4,12,13910,13888,12482,-1406
2018,5,4,13,14340,14321,12928,-1393
2018,5,4,14,14530,14530,13005,-1525
2018,5,4,15,14690,14658,13115,-1543
2018,5,4,16,14790,14797,13191,-1606
2018,5,4,17,14660,14789,13392,-1397
2018,5,4,18,14630,14605,13168,-1437
2018,5,4,19,14780,14802,13512,-1290
2018,5,4,20,14850,15177,13799,-1378
2018,5,4,21,14850,15492,14034,-1458
2018,5,4,22,14880,15477,13785,-1692
2018,5,4,23,15050,15327,13612,-1715
2018,5,5,0,14540,15334,13308,-2026
2018,5,5,1,14480,15354,13499,-1855
2018,5,5,2,14000,14551,12696,-1855
2018,5,5,3,12900,13249,11437,-1812
2018,5,5,4,11800,12152,10379,-1773
2018,5,5,5,11010,11077,9133,-1944
2018,5,5,6,10330,10610,8527,-2083
2018,5,5,7,9840,10299,8209,-2090
2018,5,5,8,9530,10260,8139,-2121
2018,5,5,9,9400,10206,8083,-2123
2018,5,5,10,9520,10318,8352,-1966
2018,5,5,11,9870,10660,8649,-2011
2018,5,5,12,10460,11203,9130,-2073
2018,5,5,13,10910,11185,9283,-1902
2018,5,5,14,11000,11214,9427,-1787
2018,5,5,15,10990,11118,9468,-1650
2018,5,5,16,10980,11057,9616,-1441
2018,5,5,17,10960,10886,9539,-1347
2018,5,5,18,11030,11202,9687,-1515
2018,5,5,19,11140,11073,9606,-1467
2018,5,5,20,11400,11268,9969,-1299
2018,5,5,21,11600,11848,10506,-1342
2018,5,5,22,11970,12332,10663,-1669
2018,5,5,23,12510,12526,10575,-1951
2018,5,6,0,12440,12611,10508,-2103
2018,5,6,1,12850,12838,10943,-1895
2018,5,6,2,12280,12305,10400,-1905
2018,5,6,3,11370,11400,9424,-1976
2018,5,6,4,10420,10710,8886,-1824
2018,5,6,5,9750,10458,8205,-2253
2018,5,6,6,9270,10235,7916,-2319
2018,5,6,7,9000,10045,8063,-1982
2018,5,6,8,8870,9903,8083,-1820
2018,5,6,9,8880,9898,7898,-2000
2018,5,6,10,9000,9791,7800,-1991
2018,5,6,11,9300,10065,8228,-1837
2018,5,6,12,9960,10488,8753,-1735
2018,5,6,13,10780,11095,9441,-1654
2018,5,6,14,11500,11537,10119,-1418
2018,5,6,15,11780,11789,10209,-1580
2018,5,6,16,11960,11921,10369,-1552
2018,5,6,17,11840,12019,10330,-1689
2018,5,6,18,11800,11965,10174,-1791
2018,5,6,19,11710,11984,10155,-1829
2018,5,6,20,11710,12038,10147,-1891
2018,5,6,21,11880,12265,10260,-2005
2018,5,6,22,12400,12649,10652,-1997
2018,5,6,23,12660,12836,10952,-1884
2018,5,7,0,12860,12872,11118,-1754
2018,5,7,1,12930,12822,11159,-1663
2018,5,7,2,12240,12048,10203,-1845
2018,5,7,3,11170,11125,9089,-2036
2018,5,7,4,10200,10496,8605,-1891
2018,5,7,5,9320,9876,8001,-1875
2018,5,7,6,8940,9470,7754,-1716
2018,5,7,7,8770,9558,8136,-1422
2018,5,7,8,8780,9565,8081,-1484
2018,5,7,9,9100,9869,8570,-1299
2018,5,7,10,10010,10483,9283,-1200
2018,5,7,11,11430,11403,9971,-1432
2018,5,7,12,12250,12236,10829,-1407
2018,5,7,13,12250,12251,10802,-1449
2018,5,7,14,12190,12138,10881,-1257
2018,5,7,15,12230,12041,10630,-1411
2018,5,7,16,12210,12069,10682,-1387
2018,5,7,17,12130,12044,10771,-1273
2018,5,7,18,12180,12126,10819,-1307
2018,5,7,19,12140,12154,10703,-1451
2018,5,7,20,12300,12311,11036,-1275
2018,5,7,21,12610,12605,11205,-1400
2018,5,7,22,13100,13061,11655,-1406
2018,5,7,23,13460,13392,11830,-1562
2018,5,8,0,13610,13509,11654,-1855
2018,5,8,1,13850,13703,11857,-1846
2018,5,8,2,12990,12882,10868,-2014
2018,5,8,3,11710,11678,9748,-1930
2018,5,8,4,10580,10689,8865,-1824
2018,5,8,5,9600,10163,7789,-2374
2018,5,8,6,9180,9737,7498,-2239
2018,5,8,7,8990,9577,7409,-2168
2018,5,8,8,8960,9753,7547,-2206
2018,5,8,9,9230,9771,7640,-2131
2018,5,8,10,10080,10399,8095,-2304
2018,5,8,11,11530,11679,9551,-2128
2018,5,8,12,12270,12271,10366,-1905
2018,5,8,13,12140,12148,10315,-1833
2018,5,8,14,11800,11924,10213,-1711
2018,5,8,15,11710,11893,10321,-1572
2018,5,8,16,11720,11941,10386,-1555
2018,5,8,17,11670,12019,10659,-1360
2018,5,8,18,11800,12234,11023,-1211
2018,5,8,19,11840,12312,11034,-1278
2018,5,8,20,12220,12465,11068,-1397
2018,5,8,21,13010,12833,11435,-1398
2018,5,8,22,13040,13358,11997,-1361
2018,5,8,23,13300,13616,12029,-1587
2018,5,9,0,13520,13694,11813,-1881
2018,5,9,1,13800,13890,12178,-1712
2018,5,9,2,13040,13069,11426,-1643
2018,5,9,3,11690,11723,10079,-1644
2018,5,9,4,10530,10717,8976,-1741
2018,5,9,5,9710,10492,8299,-2193
2018,5,9,6,9260,10096,7800,-2296
2018,5,9,7,9030,10194,7789,-2405
2018,5,9,8,9010,10303,7967,-2336
2018,5,9,9,9280,10314,7928,-2386
2018,5,9,10,10080,10547,8638,-1909
2018,5,9,11,11490,11717,9715,-2002
2018,5,9,12,12230,12223,10224,-1999
2018,5,9,13,12160,12171,10617,-1554
2018,5,9,14,12020,12072,10628,-1444
2018,5,9,15,11980,12088,10857,-1231
2018,5,9,16,11960,12164,11072,-1092
2018,5,9,17,12020,12222,10862,-1360
2018,5,9,18,12090,12431,11124,-1307
2018,5,9,19,12180,12544,11323,-1221
2018,5,9,20,12460,12812,11845,-967
2018,5,9,21,12860,13200,11974,-1226
2018,5,9,22,13030,13517,12117,-1400
2018,5,9,23,13330,13685,12124,-1561
2018,5,10,0,13470,13722,12085,-1637
2018,5,10,1,13790,13919,12106,-1813
2018,5,10,2,12950,13111,11294,-1817
2018,5,10,3,11620,11876,10020,-1856
2018,5,10,4,10440,10984,8743,-2241
2018,5,10,5,9810,10298,8457,-1841
2018,5,10,6,9420,10029,8066,-1963
2018,5,10,7,9220,9849,7825,-2024
2018,5,10,8,9190,9810,7958,-1852
2018,5,10,9,9470,10073,8058,-2015
2018,5,10,10,10340,10794,8607,-2187
2018,5,10,11,11870,11844,9728,-2116
2018,5,10,12,12670,12542,10652,-1890
2018,5,10,13,12820,12642,11083,-1559
2018,5,10,14,12420,12438,11073,-1365
2018,5,10,15,12340,12169,10628,-1541
2018,5,10,16,12320,12124,10681,-1443
2018,5,10,17,12280,12240,11188,-1052
2018,5,10,18,12360,12554,11396,-1158
2018,5,10,19,12380,12800,11536,-1264
2018,5,10,20,12630,12989,11473,-1516
2018,5,10,21,13070,13061,11351,-1710
2018,5,10,22,13280,13293,11615,-1678
2018,5,10,23,13520,13469,11788,-1681
2018,5,11,0,13680,13599,11727,-1872
2018,5,11,1,13900,13799,12205,-1594
2018,5,11,2,13100,13080,11938,-1142
2018,5,11,3,11800,11869,10581,-1288
2018,5,11,4,10650,10915,9521,-1394
2018,5,11,5,9860,10121,8638,-1483
2018,5,11,6,9430,9959,8454,-1505
2018,5,11,7,9210,9976,8238,-1738
2018,5,11,8,9170,9858,8224,-1634
2018,5,11,9,9410,9909,8231,-1678
2018,5,11,10,10140,10574,8588,-1986
2018,5,11,11,11520,11519,9771,-1748
2018,5,11,12,12310,12297,10761,-1536
2018,5,11,13,12340,12330,10790,-1540
2018,5,11,14,12250,12267,10671,-1596
2018,5,11,15,12170,12194,10748,-1446
2018,5,11,16,12030,11880,10422,-1458
2018,5,11,17,11950,11626,10146,-1480
2018,5,11,18,11890,11689,10241,-1448
2018,5,11,19,11780,11729,10260,-1469
2018,5,11,20,12010,11964,10539,-1425
2018,5,11,21,12200,12418,11019,-1399
2018,5,11,22,12430,12791,11301,-1490
2018,5,11,23,12680,12855,11122,-1733
2018,5,12,0,12830,12871,10833,-2038
2018,5,12,1,13150,13075,10890,-2185
2018,5,12,2,12650,12513,10538,-1975
2018,5,12,3,11590,11501,9431,-2070
2018,5,12,4,10570,10823,8665,-2158
2018,5,12,5,9600,10101,8122,-1979
2018,5,12,6,9150,9697,7546,-2151
2018,5,12,7,8880,9428,7352,-2076
2018,5,12,8,8790,9331,7368,-1963
2018,5,12,9,8870,9401,7194,-2207
2018,5,12,10,9120,9647,7280,-2367
2018,5,12,11,9630,10143,7771,-2372
2018,5,12,12,10400,10914,8267,-2647
2018,5,12,13,11250,11298,8724,-2574
2018,5,12,14,11800,11770,9014,-2756
2018,5,12,15,12080,12048,9229,-2819
2018,5,12,16,12200,12088,9053,-3035
2018,5,12,17,12020,12031,9141,-2890
2018,5,12,18,11960,12003,9441,-2562
2018,5,12,19,11850,12065,9485,-2580
2018,5,12,20,11790,11921,9414,-2507
2018,5,12,21,11920,12057,9506,-2551
2018,5,12,22,12260,12336,9580,-2756
2018,5,12,23,12280,12420,9779,-2641
2018,5,13,0,12520,12441,10028,-2413
2018,5,13,1,12550,12465,10033,-2432
2018,5,13,2,12110,11977,9827,-2150
2018,5,13,3,11250,11114,8686,-2428
2018,5,13,4,10370,10452,8003,-2449
2018,5,13,5,9480,10008,7604,-2404
2018,5,13,6,9070,9875,7388,-2487
2018,5,13,7,8830,9635,7067,-2568
2018,5,13,8,8730,9531,6997,-2534
2018,5,13,9,8790,9574,6877,-2697
2018,5,13,10,8990,9737,7093,-2644
2018,5,13,11,9240,10098,7312,-2786
2018,5,13,12,9870,10696,7840,-2856
2018,5,13,13,10450,11157,8236,-2921
2018,5,13,14,11110,11321,8414,-2907
2018,5,13,15,11210,11152,8336,-2816
2018,5,13,16,11210,10999,8284,-2715
2018,5,13,17,10910,10683,8135,-2548
2018,5,13,18,10760,10514,8231,-2283
2018,5,13,19,10770,10390,8345,-2045
2018,5,13,20,10940,10218,8210,-2008
2018,5,13,21,11040,10596,8397,-2199
2018,5,13,22,11440,11216,9160,-2056
2018,5,13,23,11570,11813,9422,-2391
2018,5,14,0,12450,12201,9923,-2278
2018,5,14,1,12510,12577,10279,-2298
2018,5,14,2,12150,12049,9490,-2559
2018,5,14,3,10970,11169,8380,-2789
2018,5,14,4,10180,10347,7707,-2640
2018,5,14,5,9280,9847,7424,-2423
2018,5,14,6,8920,9471,7172,-2299
2018,5,14,7,8780,9537,7056,-2481
2018,5,14,8,8780,9610,7154,-2456
2018,5,14,9,9100,9627,7486,-2141
2018,5,14,10,10020,10190,8383,-1807
2018,5,14,11,11740,11526,9733,-1793
2018,5,14,12,12700,12592,11321,-1271
2018,5,14,13,13120,12739,10918,-1821
2018,5,14,14,12730,12692,10573,-2119
2018,5,14,15,12630,12689,10930,-1759
2018,5,14,16,12630,12567,10721,-1846
2018,5,14,17,12270,12198,10231,-1967
2018,5,14,18,12370,12233,10460,-1773
2018,5,14,19,12360,12306,10686,-1620
2018,5,14,20,12680,12567,11039,-1528
2018,5,14,21,13130,12754,11236,-1518
2018,5,14,22,13550,13384,11883,-1501
2018,5,14,23,13800,13740,12142,-1598
2018,5,15,0,14010,13838,12141,-1697
2018,5,15,1,14150,14020,12094,-1926
2018,5,15,2,13310,13243,11367,-1876
2018,5,15,3,11950,11878,9673,-2205
2018,5,15,4,10800,10645,8442,-2203
2018,5,15,5,9870,9944,7744,-2200
2018,5,15,6,9450,9696,7646,-2050
2018,5,15,7,9220,9454,7373,-2081
2018,5,15,8,9150,9644,7394,-2250
2018,5,15,9,9430,9855,7634,-2221
2018,5,15,10,10260,10504,8497,-2007
2018,5,15,11,11640,11873,9556,-2317
2018,5,15,12,12690,12754,10660,-2094
2018,5,15,13,12990,13118,11420,-1698
2018,5,15,14,13150,13260,11653,-1607
2018,5,15,15,13320,13366,11679,-1687
2018,5,15,16,13530,13458,11871,-1587
2018,5,15,17,13560,13604,11915,-1689
2018,5,15,18,13780,13869,12265,-1604
2018,5,15,19,13900,14160,12455,-1705
2018,5,15,20,14080,15048,13433,-1615
2018,5,15,21,14390,15792,14186,-1606
2018,5,15,22,14770,15639,13580,-2059
2018,5,15,23,14930,15270,13374,-1896
2018,5,16,0,15150,14723,13077,-1646
2018,5,16,1,14800,14296,12745,-1551
2018,5,16,2,13730,13404,12039,-1365
2018,5,16,3,12350,12061,10836,-1225
2018,5,16,4,11130,10868,9047,-1821
2018,5,16,5,10120,10336,8049,-2287
2018,5,16,6,9650,10122,7712,-2410
2018,5,16,7,9340,10188,7659,-2529
2018,5,16,8,9290,10234,7551,-2683
2018,5,16,9,9520,10441,7654,-2787
2018,5,16,10,10200,10685,8169,-2516
2018,5,16,11,11710,11950,9215,-2735
2018,5,16,12,12570,12376,10175,-2201
2018,5,16,13,12720,12306,10547,-1759
2018,5,16,14,12220,12282,10584,-1698
2018,5,16,15,12160,12287,10641,-1646
2018,5,16,16,11990,12228,10514,-1714
2018,5,16,17,11950,12353,10566,-1787
2018,5,16,18,11940,12601,10939,-1662
2018,5,16,19,12150,12713,10984,-1729
2018,5,16,20,12550,12838,11093,-1745
2018,5,16,21,13000,13023,11158,-1865
2018,5,16,22,13280,13257,11407,-1850
2018,5,16,23,13620,13393,11623,-1770
2018,5,17,0,13780,13491,11803,-1688
2018,5,17,1,13800,13606,12011,-1595
2018,5,17,2,12990,12849,11192,-1657
2018,5,17,3,11760,11614,9831,-1783
2018,5,17,4,10640,10783,8789,-1994
2018,5,17,5,9700,10204,8173,-2031
2018,5,17,6,9300,9847,7670,-2177
2018,5,17,7,9080,9635,7384,-2251
2018,5,17,8,9070,10007,7494,-2513
2018,5,17,9,9340,10138,7692,-2446
2018,5,17,10,10160,10527,8306,-2221
2018,5,17,11,11620,11707,9790,-1917
2018,5,17,12,12690,12677,11233,-1444
2018,5,17,13,13030,13031,11675,-1356
2018,5,17,14,13260,13192,11682,-1510
2018,5,17,15,13250,13153,11534,-1619
2018,5,17,16,13270,13248,11901,-1347
2018,5,17,17,13190,13144,11646,-1498
2018,5,17,18,13170,13082,11565,-1517
2018,5,17,19,13160,13012,11463,-1549
2018,5,17,20,13370,13216,11657,-1559
2018,5,17,21,13620,13570,12094,-1476
2018,5,17,22,13860,13833,12414,-1419
2018,5,17,23,13950,13925,12440,-1485
2018,5,18,0,14180,14027,12555,-1472
2018,5,18,1,14340,14227,12685,-1542
2018,5,18,2,13480,13550,12005,-1545
2018,5,18,3,12170,12228,10327,-1901
2018,5,18,4,10980,11149,9025,-2124
2018,5,18,5,10150,10707,8331,-2376
2018,5,18,6,9640,10385,8054,-2331
2018,5,18,7,9330,10391,7876,-2515
2018,5,18,8,9190,10265,7767,-2498
2018,5,18,9,9390,10322,7865,-2457
2018,5,18,10,10050,10495,8119,-2376
2018,5,18,11,11340,11303,8848,-2455
2018,5,18,12,12150,12152,10023,-2129
2018,5,18,13,12280,12274,10518,-1756
2018,5,18,14,12240,12150,10372,-1778
2018,5,18,15,12290,11968,10601,-1367
2018,5,18,16,12220,11903,10432,-1471
2018,5,18,17,12100,11785,10193,-1592
2018,5,18,18,12190,11767,10121,-1646
2018,5,18,19,12240,11828,10237,-1591
2018,5,18,20,12430,12009,10303,-1706
2018,5,18,21,12620,12188,10483,-1705
2018,5,18,22,12970,12294,10595,-1699
2018,5,18,23,12940,12440,10666,-1774
2018,5,19,0,12970,12566,10550,-2016
2018,5,19,1,13060,12812,10805,-2007
2018,5,19,2,12680,12357,10415,-1942
2018,5,19,3,11670,11400,9610,-1790
2018,5,19,4,10600,10597,8550,-2047
2018,5,19,5,9580,9755,7665,-2090
2018,5,19,6,9120,9440,7216,-2224
2018,5,19,7,8890,9427,7196,-2231
2018,5,19,8,8820,9354,7221,-2133
2018,5,19,9,8940,9467,7401,-2066
2018,5,19,10,9210,9737,7516,-2221
2018,5,19,11,9680,10202,7921,-2281
2018,5,19,12,10210,10468,8204,-2264
2018,5,19,13,10820,10816,8781,-2035
2018,5,19,14,11210,11290,9319,-1971
2018,5,19,15,11500,11671,9687,-1984
2018,5,19,16,11760,11862,9911,-1951
2018,5,19,17,11710,11947,10172,-1775
2018,5,19,18,11690,11998,10071,-1927
2018,5,19,19,11710,11947,9912,-2035
2018,5,19,20,11820,12018,10018,-2000
2018,5,19,21,12040,12238,10332,-1906
2018,5,19,22,12410,12519,10364,-2155
2018,5,19,23,12400,12565,10365,-2200
2018,5,20,0,12520,12553,10168,-2385
2018,5,20,1,12510,12514,10410,-2104
2018,5,20,2,12120,11995,10510,-1485
2018,5,20,3,11230,11157,9831,-1326
2018,5,20,4,10340,10240,8184,-2056
2018,5,20,5,9540,9680,7634,-2046
2018,5,20,6,9120,9522,7428,-2094
2018,5,20,7,8890,9733,7606,-2127
2018,5,20,8,8810,9886,7861,-2025
2018,5,20,9,8890,9942,7778,-2164
2018,5,20,10,9020,9952,7802,-2150
2018,5,20,11,9420,10194,8216,-1978
2018,5,20,12,10100,10612,8729,-1883
2018,5,20,13,10900,11306,9520,-1786
2018,5,20,14,11580,11751,9736,-2015
2018,5,20,15,11820,11972,9813,-2159
2018,5,20,16,12020,11974,9966,-2008
2018,5,20,17,12160,12348,10463,-1885
2018,5,20,18,12280,12286,10363,-1923
2018,5,20,19,12430,12385,10516,-1869
2018,5,20,20,12610,12557,10797,-1760
2018,5,20,21,12890,12927,11267,-1660
2018,5,20,22,13380,13426,11805,-1621
2018,5,20,23,13590,13628,11828,-1800
2018,5,21,0,13780,13619,11681,-1938
2018,5,21,1,13980,13726,12091,-1635
2018,5,21,2,13140,13118,11554,-1564
2018,5,21,3,11940,11869,10044,-1825
2018,5,21,4,10800,10666,8776,-1890
2018,5,21,5,9780,10072,8237,-1835
2018,5,21,6,9310,10011,7926,-2085
2018,5,21,7,9060,10131,7985,-2146
2018,5,21,8,8990,10044,7943,-2101
2018,5,21,9,9220,9987,8098,-1889
2018,5,21,10,9980,10740,9078,-1662
2018,5,21,11,11400,11730,10229,-1501
2018,5,21,12,12200,12202,10869,-1333
2018,5,21,13,12230,12237,11273,-964
2018,5,21,14,12240,12207,11377,-830
2018,5,21,15,12350,12266,11239,-1027
2018,5,21,16,12410,12369,11415,-954
2018,5,21,17,12760,12432,11630,-802
2018,5,21,18,12980,12660,11818,-842
2018,5,21,19,13210,12848,11975,-873
2018,5,21,20,13600,13135,12012,-1123
2018,5,21,21,13720,13640,12541,-1099
2018,5,21,22,14310,14273,13205,-1068
2018,5,21,23,14550,14572,13227,-1345
2018,5,22,0,14550,14472,13098,-1374
2018,5,22,1,14720,14479,13123,-1356
2018,5,22,2,13620,13684,12226,-1458
2018,5,22,3,12080,12279,10548,-1731
2018,5,22,4,10640,11036,9362,-1674
2018,5,22,5,10350,10243,8354,-1889
2018,5,22,6,9830,9805,8123,-1682
2018,5,22,7,9590,9525,8025,-1500
2018,5,22,8,9500,9426,7985,-1441
2018,5,22,9,9710,9673,8119,-1554
2018,5,22,10,10490,10160,8346,-1814
2018,5,22,11,12050,11407,9586,-1821
2018,5,22,12,13080,12499,11274,-1225
2018,5,22,13,13160,12974,11785,-1189
2018,5,22,14,13330,13275,12199,-1076
2018,5,22,15,13480,13565,12557,-1008
2018,5,22,16,13640,13648,12391,-1257
2018,5,22,17,13690,13733,12479,-1254
2018,5,22,18,13690,13820,12610,-1210
2018,5,22,19,13700,13678,12476,-1202
2018,5,22,20,13810,13648,12444,-1204
2018,5,22,21,13930,13813,12628,-1185
2018,5,22,22,14080,14008,12668,-1340
2018,5,22,23,14140,13973,12581,-1392
2018,5,23,0,14090,13856,12700,-1156
2018,5,23,1,13960,13705,12926,-779
2018,5,23,2,13300,12893,12067,-826
2018,5,23,3,11940,11630,10261,-1369
2018,5,23,4,10780,10681,8709,-1972
2018,5,23,5,9970,10287,8273,-2014
2018,5,23,6,9570,10123,8320,-1803
2018,5,23,7,9410,9937,8067,-1870
2018,5,23,8,9250,9881,8051,-1830
2018,5,23,9,9600,10145,8229,-1916
2018,5,23,10,10320,10447,8769,-1678
2018,5,23,11,11830,11578,9912,-1666
2018,5,23,12,12810,12567,11149,-1418
2018,5,23,13,13050,12652,11526,-1126
2018,5,23,14,12700,12655,11549,-1106
2018,5,23,15,12950,12777,11739,-1038
2018,5,23,16,13220,12849,11855,-994
2018,5,23,17,13240,12878,11838,-1040
2018,5,23,18,13680,13188,12164,-1024
2018,5,23,19,13920,13538,12598,-940
2018,5,23,20,14450,13982,12815,-1167
2018,5,23,21,14950,14506,13373,-1133
2018,5,23,22,15100,14998,13861,-1137
2018,5,23,23,15140,15170,13880,-1290
2018,5,24,0,14940,15128,13740,-1388
2018,5,24,1,14970,15137,13761,-1376
2018,5,24,2,13980,14330,12895,-1435
2018,5,24,3,12440,12869,11111,-1758
2018,5,24,4,11040,11457,9444,-2013
2018,5,24,5,10420,10718,8884,-1834
2018,5,24,6,9830,10368,8705,-1663
2018,5,24,7,9500,10299,8647,-1652
2018,5,24,8,9370,10204,8599,-1605
2018,5,24,9,9580,10399,8706,-1693
2018,5,24,10,10330,10585,8934,-1651
2018,5,24,11,11650,11664,9961,-1703
2018,5,24,12,12500,12578,11180,-1398
2018,5,24,13,12490,12743,11615,-1128
2018,5,24,14,12470,12648,11632,-1016
2018,5,24,15,12470,12576,11701,-875
2018,5,24,16,12410,12593,11770,-823
2018,5,24,17,12570,12625,11911,-714
2018,5,24,18,12800,12816,11943,-873
2018,5,24,19,12960,12945,12063,-882
2018,5,24,20,13040,13285,12657,-628
2018,5,24,21,13220,13782,13195,-587
2018,5,24,22,13480,14259,13636,-623
2018,5,24,23,13610,14414,13754,-660
2018,5,25,0,13760,14332,13497,-835
2018,5,25,1,13940,14300,13250,-1050
2018,5,25,2,13140,13656,12830,-826
2018,5,25,3,11860,12270,10715,-1555
2018,5,25,4,10720,11291,9159,-2132
2018,5,25,5,10000,10909,9039,-1870
2018,5,25,6,9760,10656,8773,-1883
2018,5,25,7,9230,10362,8323,-2039
2018,5,25,8,9310,10266,8294,-1972
2018,5,25,9,9490,10496,8605,-1891
2018,5,25,10,10230,10689,9006,-1683
2018,5,25,11,11610,11867,10165,-1702
2018,5,25,12,12790,12906,11170,-1736
2018,5,25,13,12850,13052,11484,-1568
2018,5,25,14,12950,12930,11908,-1022
2018,5,25,15,13390,13277,12511,-766
2018,5,25,16,13820,13877,12936,-941
2018,5,25,17,14130,14077,13098,-979
2018,5,25,18,14410,14270,13260,-1010
2018,5,25,19,15020,14628,13500,-1128
2018,5,25,20,15380,15079,13913,-1166
2018,5,25,21,15570,15564,14173,-1391
2018,5,25,22,15700,15875,14397,-1478
2018,5,25,23,15460,15825,14084,-1741
2018,5,26,0,15610,15507,13900,-1607
2018,5,26,1,15800,15461,13989,-1472
2018,5,26,2,15050,14880,13366,-1514
2018,5,26,3,13780,13696,12384,-1312
2018,5,26,4,12420,12423,10865,-1558
2018,5,26,5,11330,11413,9704,-1709
2018,5,26,6,10800,10739,8956,-1783
2018,5,26,7,10170,10535,8726,-1809
2018,5,26,8,10080,10679,8736,-1943
2018,5,26,9,10190,10656,8727,-1929
2018,5,26,10,10180,10728,8813,-1915
2018,5,26,11,11020,11208,8983,-2225
2018,5,26,12,11900,11778,9805,-1973
2018,5,26,13,12730,12468,10709,-1759
2018,5,26,14,13130,13245,11829,-1416
2018,5,26,15,13650,13927,12793,-1134
2018,5,26,16,14190,14312,13136,-1176
2018,5,26,17,14330,14545,13202,-1343
2018,5,26,18,14900,14847,13541,-1306
2018,5,26,19,15090,15195,14098,-1097
2018,5,26,20,15480,15452,14167,-1285
2018,5,26,21,15640,15833,14604,-1229
2018,5,26,22,15940,16069,14562,-1507
2018,5,26,23,15980,15925,14113,-1812
2018,5,27,0,15790,15546,13892,-1654
2018,5,27,1,15580,15424,13674,-1750
2018,5,27,2,14800,14806,13074,-1732
2018,5,27,3,13850,13710,11825,-1885
2018,5,27,4,12560,12496,10515,-1981
2018,5,27,5,11090,11527,9963,-1564
2018,5,27,6,10490,10848,9381,-1467
2018,5,27,7,10040,10410,8722,-1688
2018,5,27,8,10050,10277,8472,-1805
2018,5,27,9,9830,10099,8465,-1634
2018,5,27,10,9840,10108,8358,-1750
2018,5,27,11,10020,10551,8335,-2216
2018,5,27,12,10440,11004,8666,-2338
2018,5,27,13,11100,11295,8978,-2317
2018,5,27,14,11680,11677,9782,-1895
2018,5,27,15,11870,11967,9974,-1993
2018,5,27,16,12040,12071,10127,-1944
2018,5,27,17,12020,12084,10059,-2025
2018,5,27,18,11940,11988,9914,-2074
2018,5,27,19,11870,11847,9748,-2099
2018,5,27,20,11880,11707,9807,-1900
2018,5,27,21,11980,12105,9931,-2174
2018,5,27,22,12490,12344,10189,-2155
2018,5,27,23,12750,12169,9924,-2245
2018,5,28,0,12710,12160,10008,-2152
2018,5,28,1,12520,12154,10083,-2071
2018,5,28,2,12230,11687,9533,-2154
2018,5,28,3,11120,10932,8715,-2217
2018,5,28,4,10230,10521,7917,-2604
2018,5,28,5,9400,9935,7476,-2459
2018,5,28,6,8970,9781,7435,-2346
2018,5,28,7,8740,9544,7297,-2247
2018,5,28,8,8680,9740,7284,-2456
2018,5,28,9,8760,9827,7109,-2718
2018,5,28,10,8980,10051,7467,-2584
2018,5,28,11,9400,10111,7668,-2443
2018,5,28,12,10040,10507,8047,-2460
2018,5,28,13,10800,10806,8862,-1944
2018,5,28,14,11400,11437,9470,-1967
2018,5,28,15,11790,11854,9801,-2053
2018,5,28,16,12020,11767,10223,-1544
2018,5,28,17,12030,11658,10256,-1402
2018,5,28,18,11980,11644,10009,-1635
2018,5,28,19,12140,11468,9934,-1534
2018,5,28,20,12150,11362,9932,-1430
2018,5,28,21,12410,11766,10302,-1464
2018,5,28,22,12880,12318,10819,-1499
2018,5,28,23,13000,12670,11112,-1558
2018,5,29,0,13150,12876,11306,-1570
2018,5,29,1,13400,13074,11560,-1514
2018,5,29,2,12620,12537,10825,-1712
2018,5,29,3,11330,11385,9512,-1873
2018,5,29,4,10220,10371,8295,-2076
2018,5,29,5,9570,10171,7758,-2413
2018,5,29,6,9180,10268,7701,-2567
2018,5,29,7,8990,10056,7258,-2798
2018,5,29,8,8970,10022,7311,-2711
2018,5,29,9,9310,10256,7911,-2345
2018,5,29,10,10140,10595,8595,-2000
2018,5,29,11,11680,11741,9767,-1974
2018,5,29,12,12790,12781,10799,-1982
2018,5,29,13,13090,13076,11122,-1954
2018,5,29,14,13350,13353,11582,-1771
2018,5,29,15,13870,13792,12350,-1442
2018,5,29,16,14340,14262,12871,-1391
2018,5,29,17,14720,14733,13776,-957
2018,5,29,18,15470,15324,14674,-650
2018,5,29,19,15920,15761,15076,-685
2018,5,29,20,16510,16212,15382,-830
2018,5,29,21,16670,16779,16021,-758
2018,5,29,22,16800,17227,16429,-798
2018,5,29,23,16560,17367,16154,-1213
2018,5,30,0,16360,17112,15765,-1347
2018,5,30,1,16170,16835,15552,-1283
2018,5,30,2,15400,15934,14649,-1285
2018,5,30,3,13860,14220,12483,-1737
2018,5,30,4,12510,12598,10334,-2264
2018,5,30,5,11420,11514,8842,-2672
2018,5,30,6,10810,11118,8544,-2574
2018,5,30,7,10390,10690,8292,-2398
2018,5,30,8,10190,10701,8191,-2510
2018,5,30,9,10310,10797,8311,-2486
2018,5,30,10,10970,11240,8803,-2437
2018,5,30,11,12340,12322,10470,-1852
2018,5,30,12,13210,13221,11559,-1662
2018,5,30,13,13470,13471,12133,-1338
2018,5,30,14,13610,13620,12596,-1024
2018,5,30,15,13830,13829,13096,-733
2018,5,30,16,14080,14075,13453,-622
2018,5,30,17,14290,14266,13795,-471
2018,5,30,18,14600,14604,14208,-396
2018,5,30,19,14900,14866,14579,-287
2018,5,30,20,15070,15255,15070,-185
2018,5,30,21,15390,15616,15404,-212
2018,5,30,22,15600,15892,15629,-263
2018,5,30,23,15850,15810,15139,-671
2018,5,31,0,15450,15474,14269,-1205
2018,5,31,1,15200,15318,14340,-978
2018,5,31,2,14430,14602,13386,-1216
2018,5,31,3,12940,13121,11428,-1693
2018,5,31,4,11730,11914,9664,-2250
2018,5,31,5,10700,11312,8924,-2388
2018,5,31,6,10120,11144,8866,-2278
2018,5,31,7,9810,11155,8873,-2282
2018,5,31,8,9660,11007,8603,-2404
2018,5,31,9,9860,11116,8700,-2416
2018,5,31,10,10460,11267,9168,-2099
2018,5,31,11,11860,12386,10198,-2188
2018,5,31,12,12860,12948,11370,-1578
2018,5,31,13,13120,13113,12037,-1076
2018,5,31,14,13290,13277,12265,-1012
2018,5,31,15,13540,13527,12757,-770
2018,5,31,16,13850,13837,13291,-546
2018,5,31,17,14150,14133,13714,-419
2018,5,31,18,14560,14559,13825,-734
2018,5,31,19,14990,14934,14168,-766
2018,5,31,20,15320,15402,14645,-757
2018,5,31,21,15610,15837,14983,-854
2018,5,31,22,15890,16063,14984,-1079
2018,5,31,23,15940,16056,14662,-1394
2018,6,1,0,15780,15898,14424,-1474
2018,6,1,1,15580,15841,14168,-1673
2018,6,1,2,14600,15278,13295,-1983
2018,6,1,3,13240,15119,14832,-287
2018,6,1,4,11980,15119,14844,-275
2018,6,1,5,11430,14102,11613,-2489
2018,6,1,6,10910,11718,9321,-2397
2018,6,1,7,10580,11294,9037,-2257
2018,6,1,8,10440,10984,8669,-2315
2018,6,1,9,10770,11207,8954,-2253
2018,6,1,10,11370,11898,9406,-2492
2018,6,1,11,13050,13052,10712,-2340
2018,6,1,12,14290,14104,12325,-1779
2018,6,1,13,14900,14727,13189,-1538
2018,6,1,14,15200,15209,14016,-1193
2018,6,1,15,15590,15589,14492,-1097
2018,6,1,16,16030,15910,14688,-1222
2018,6,1,17,16270,16088,14870,-1218
2018,6,1,18,16480,16261,14917,-1344
2018,6,1,19,16750,16390,15306,-1084
2018,6,1,20,16870,16490,15756,-734
2018,6,1,21,17270,16759,15773,-986
2018,6,1,22,17290,17011,15878,-1133
2018,6,1,23,17060,16980,15518,-1462
2018,6,2,0,16970,16780,15224,-1556
2018,6,2,1,16750,16762,15349,-1413
2018,6,2,2,16280,16187,14627,-1560
2018,6,2,3,14970,14913,13008,-1905
2018,6,2,4,13480,13533,11291,-2242
2018,6,2,5,12480,12461,10746,-1715
2018,6,2,6,11930,11768,9852,-1916
2018,6,2,7,11490,11612,9507,-2105
2018,6,2,8,11290,11382,9186,-2196
2018,6,2,9,11050,11336,9137,-2199
2018,6,2,10,11660,11730,9190,-2540
2018,6,2,11,12330,12333,9458,-2875
2018,6,2,12,13140,13179,10409,-2770
2018,6,2,13,13880,13847,11533,-2314
2018,6,2,14,14650,14744,12355,-2389
2018,6,2,15,15360,15539,13197,-2342
2018,6,2,16,15890,15906,13311,-2595
2018,6,2,17,16000,15963,13661,-2302
2018,6,2,18,16120,16051,14102,-1949
2018,6,2,19,16200,16112,14494,-1618
2018,6,2,20,16390,16275,14423,-1852
2018,6,2,21,16510,16454,14333,-2121
2018,6,2,22,16640,16508,14328,-2180
2018,6,2,23,16140,16412,14436,-1976
2018,6,3,0,15760,15943,13983,-1960
2018,6,3,1,15650,15577,13543,-2034
2018,6,3,2,14980,14935,13014,-1921
2018,6,3,3,13740,13745,11718,-2027
2018,6,3,4,12370,12656,10358,-2298
2018,6,3,5,11100,11818,9442,-2376
2018,6,3,6,10630,11058,8734,-2324
2018,6,3,7,10050,10575,8291,-2284
2018,6,3,8,9550,10270,7923,-2347
2018,6,3,9,9600,10190,7552,-2638
2018,6,3,10,9640,10225,7430,-2795
2018,6,3,11,9930,10491,7614,-2877
2018,6,3,12,10470,10908,7863,-3045
2018,6,3,13,11130,11589,8497,-3092
2018,6,3,14,10930,11401,8802,-2599
2018,6,3,15,10960,11244,9130,-2114
2018,6,3,16,11320,11177,9157,-2020
2018,6,3,17,11230,11102,9164,-1938
2018,6,3,18,11330,11052,8975,-2077
2018,6,3,19,11450,11131,9093,-2038
2018,6,3,20,11540,11396,9384,-2012
2018,6,3,21,12350,11770,9697,-2073
2018,6,3,22,12910,12517,10420,-2097
2018,6,3,23,12970,12905,10866,-2039
2018,6,4,0,13030,12953,10764,-2189
2018,6,4,1,13130,13056,10705,-2351
2018,6,4,2,12570,12551,10121,-2430
2018,6,4,3,11530,11418,8890,-2528
2018,6,4,4,10540,10830,8374,-2456
2018,6,4,5,9580,9901,7831,-2070
2018,6,4,6,9200,9733,7726,-2007
2018,6,4,7,9020,9550,7636,-1914
2018,6,4,8,9000,9521,7331,-2190
2018,6,4,9,9260,9810,7611,-2199
2018,6,4,10,10190,10610,8222,-2388
2018,6,4,11,11800,11834,9462,-2372
2018,6,4,12,12920,12776,10704,-2072
2018,6,4,13,13420,13319,11369,-1950
2018,6,4,14,13600,13616,11542,-2074
2018,6,4,15,13820,13814,11607,-2207
2018,6,4,16,13850,13761,11589,-2172
2018,6,4,17,13860,13591,11316,-2275
2018,6,4,18,13900,13606,11262,-2344
2018,6,4,19,13920,13556,11324,-2232
2018,6,4,20,13850,13489,11346,-2143
2018,6,4,21,14010,13581,11525,-2056
2018,6,4,22,14310,13895,12070,-1825
2018,6,4,23,14290,13968,11980,-1988
2018,6,5,0,14220,13859,11690,-2169
2018,6,5,1,13930,13751,11593,-2158
2018,6,5,2,13150,13012,11031,-1981
2018,6,5,3,11870,11752,9403,-2349
2018,6,5,4,10700,10608,7968,-2640
2018,6,5,5,9840,9850,7053,-2797
2018,6,5,6,9410,9642,7171,-2471
2018,6,5,7,9210,9704,7487,-2217
2018,6,5,8,9180,9963,7802,-2161
2018,6,5,9,9470,9966,7806,-2160
2018,6,5,10,10220,10439,8512,-1927
2018,6,5,11,11670,12048,10188,-1860
2018,6,5,12,12600,13091,11029,-2062
2018,6,5,13,12640,12650,11024,-1626
2018,6,5,14,12520,12583,10896,-1687
2018,6,5,15,12640,12937,11518,-1419
2018,6,5,16,12730,13409,11578,-1831
2018,6,5,17,13080,13589,11395,-2194
2018,6,5,18,13070,13693,11591,-2102
2018,6,5,19,13230,13470,11183,-2287
2018,6,5,20,13380,13406,10965,-2441
2018,6,5,21,13630,13412,11020,-2392
2018,6,5,22,13820,13851,11917,-1934
2018,6,5,23,13880,13973,11827,-2146
2018,6,6,0,14000,13912,11652,-2260
2018,6,6,1,13840,13800,11583,-2217
2018,6,6,2,13190,13102,10913,-2189
2018,6,6,3,11880,11843,9477,-2366
2018,6,6,4,10670,10686,8149,-2537
2018,6,6,5,9890,10352,8102,-2250
2018,6,6,6,9450,9987,8092,-1895
2018,6,6,7,9220,9745,7676,-2069
2018,6,6,8,9180,9695,7706,-1989
2018,6,6,9,9450,9946,7749,-2197
2018,6,6,10,10250,10458,8338,-2120
2018,6,6,11,11830,11622,9902,-1720
2018,6,6,12,12850,12625,10912,-1713
2018,6,6,13,13050,12878,11144,-1734
2018,6,6,14,13020,12928,11149,-1779
2018,6,6,15,13040,12981,10758,-2223
2018,6,6,16,13020,12986,10896,-2090
2018,6,6,17,13030,12912,11165,-1747
2018,6,6,18,13110,12980,11292,-1688
2018,6,6,19,13210,12955,11239,-1716
2018,6,6,20,13330,13028,11495,-1533
2018,6,6,21,13580,13273,11783,-1490
2018,6,6,22,13790,13598,11696,-1902
2018,6,6,23,13830,13729,11837,-1892
2018,6,7,0,13900,13751,11619,-2132
2018,6,7,1,13890,13847,11577,-2270
2018,6,7,2,13320,13281,11347,-1934
2018,6,7,3,12020,12016,9745,-2271
2018,6,7,4,10790,10815,8395,-2420
2018,6,7,5,10000,10299,7702,-2597
2018,6,7,6,9530,9819,7399,-2420
2018,6,7,7,9300,9773,7288,-2485
2018,6,7,8,9240,10024,7522,-2502
2018,6,7,9,9480,10252,7617,-2635
2018,6,7,10,10200,10235,8004,-2231
2018,6,7,11,11590,11548,9576,-1972
2018,6,7,12,12570,12559,10846,-1713
2018,6,7,13,12810,12789,10986,-1803
2018,6,7,14,12890,12915,10800,-2115
2018,6,7,15,13010,12949,10945,-2004
2018,6,7,16,13190,13052,11039,-2013
2018,6,7,17,13320,13153,11260,-1893
2018,6,7,18,13390,13378,11492,-1886
2018,6,7,19,13530,13461,11677,-1784
2018,6,7,20,13620,13478,11577,-1901
2018,6,7,21,13870,13613,11978,-1635
2018,6,7,22,14100,13871,12329,-1542
2018,6,7,23,14070,13910,11985,-1925
2018,6,8,0,14150,13858,11563,-2295
2018,6,8,1,14020,13955,11606,-2349
2018,6,8,2,13440,13449,11323,-2126
2018,6,8,3,12170,12203,9593,-2610
2018,6,8,4,10930,11009,8308,-2701
2018,6,8,5,10130,10151,7717,-2434
2018,6,8,6,9660,9933,7713,-2220
2018,6,8,7,9410,10182,8020,-2162
2018,6,8,8,9320,10127,7817,-2310
2018,6,8,9,9550,10346,7801,-2545
2018,6,8,10,10200,10417,8056,-2361
2018,6,8,11,11550,11520,8989,-2531
2018,6,8,12,12530,12515,10240,-2275
2018,6,8,13,12820,12813,10874,-1939
2018,6,8,14,13050,13003,10986,-2017
2018,6,8,15,13340,13265,11449,-1816
2018,6,8,16,13650,13546,11496,-2050
2018,6,8,17,13980,13839,12070,-1769
2018,6,8,18,14270,14330,12634,-1696
2018,6,8,19,14710,14639,12981,-1658
2018,6,8,20,14970,14776,13024,-1752
2018,6,8,21,15220,15022,13426,-1596
2018,6,8,22,15290,15262,13409,-1853
2018,6,8,23,15140,15174,13163,-2011
2018,6,9,0,14940,14908,12846,-2062
2018,6,9,1,14870,14781,12650,-2131
2018,6,9,2,14330,14353,12302,-2051
2018,6,9,3,13060,13207,10716,-2491
2018,6,9,4,11650,11941,9349,-2592
2018,6,9,5,10950,10974,8563,-2411
2018,6,9,6,10300,10321,8140,-2181
2018,6,9,7,9880,10141,7995,-2146
2018,6,9,8,9650,9926,7821,-2105
2018,6,9,9,9600,9867,7600,-2267
2018,6,9,10,9650,9908,8045,-1863
2018,6,9,11,10180,10419,8334,-2085
2018,6,9,12,10890,10866,8955,-1911
2018,6,9,13,11520,11507,9521,-1986
2018,6,9,14,11940,11908,9830,-2078
2018,6,9,15,12120,12195,9994,-2201
2018,6,9,16,12280,12492,10406,-2086
2018,6,9,17,12490,12712,10729,-1983
2018,6,9,18,12630,12877,10974,-1903
2018,6,9,19,12950,12973,10944,-2029
2018,6,9,20,13220,13198,11445,-1753
2018,6,9,21,13630,13600,11743,-1857
2018,6,9,22,13880,13994,12040,-1954
2018,6,9,23,14020,14075,12103,-1972
2018,6,10,0,13860,13960,11760,-2200
2018,6,10,1,13870,13880,11646,-2234
2018,6,10,2,13590,13534,11720,-1814
2018,6,10,3,12670,12573,10210,-2363
2018,6,10,4,11510,11474,8938,-2536
2018,6,10,5,10550,10836,8894,-1942
2018,6,10,6,9950,10222,8582,-1640
2018,6,10,7,9580,10093,8251,-1842
2018,6,10,8,9350,10156,8265,-1891
2018,6,10,9,9260,10054,8044,-2010
2018,6,10,10,9170,9968,7837,-2131
2018,6,10,11,9430,10205,7945,-2260
2018,6,10,12,9950,10805,8457,-2348
2018,6,10,13,10580,11160,8957,-2203
2018,6,10,14,11050,11309,9421,-1888
2018,6,10,15,11280,11437,9708,-1729
2018,6,10,16,11510,11666,10154,-1512
2018,6,10,17,11670,11814,10505,-1309
2018,6,10,18,11880,11751,10000,-1751
2018,6,10,19,12060,11791,9938,-1853
2018,6,10,20,12190,12053,10472,-1581
2018,6,10,21,12650,12493,10888,-1605
2018,6,10,22,13080,13031,10951,-2080
2018,6,10,23,13500,13294,10973,-2321
2018,6,11,0,13430,13375,10952,-2423
2018,6,11,1,13410,13481,11017,-2464
2018,6,11,2,12810,13050,10718,-2332
2018,6,11,3,11740,11868,9360,-2508
2018,6,11,4,10610,10728,8298,-2430
2018,6,11,5,9930,10230,7989,-2241
2018,6,11,6,9480,9942,7597,-2345
2018,6,11,7,9260,9976,7689,-2287
2018,6,11,8,9210,9988,7992,-1996
2018,6,11,9,9490,10260,7882,-2378
2018,6,11,10,10240,10598,8216,-2382
2018,6,11,11,11640,11601,8994,-2607
2018,6,11,12,12640,12625,10385,-2240
2018,6,11,13,12860,12877,10724,-2153
2018,6,11,14,12850,12881,10778,-2103
2018,6,11,15,13050,12989,10829,-2160
2018,6,11,16,13200,12978,10958,-2020
2018,6,11,17,13230,12925,10931,-1994
2018,6,11,18,13460,13140,10955,-2185
2018,6,11,19,13430,13338,11187,-2151
2018,6,11,20,13630,13519,11561,-1958
2018,6,11,21,14060,13827,11741,-2086
2018,6,11,22,14190,14233,12047,-2186
2018,6,11,23,14310,14433,11925,-2508
2018,6,12,0,14240,14297,11513,-2784
2018,6,12,1,14210,14106,11348,-2758
2018,6,12,2,13420,13527,10785,-2742
2018,6,12,3,12060,12184,9084,-3100
2018,6,12,4,10850,10881,7937,-2944
2018,6,12,5,10010,10200,7470,-2730
2018,6,12,6,9540,9800,7177,-2623
2018,6,12,7,9300,10008,7234,-2774
2018,6,12,8,9230,10022,7052,-2970
2018,6,12,9,9480,10237,7228,-3009
2018,6,12,10,10160,10472,7744,-2728
2018,6,12,11,11530,11502,8750,-2752
2018,6,12,12,12460,12462,9493,-2969
2018,6,12,13,12460,12458,9525,-2933
2018,6,12,14,12670,12688,9942,-2746
2018,6,12,15,12800,12830,10054,-2776
2018,6,12,16,13040,13003,10314,-2689
2018,6,12,17,13090,13121,10652,-2469
2018,6,12,18,13450,13424,10877,-2547
2018,6,12,19,13650,13636,10866,-2770
2018,6,12,20,13860,13991,11044,-2947
2018,6,12,21,14330,14486,11691,-2795
2018,6,12,22,14600,14990,12243,-2747
2018,6,12,23,14620,15098,12265,-2833
2018,6,13,0,14520,14814,11891,-2923
2018,6,13,1,14460,14671,11629,-3042
2018,6,13,2,13790,14060,11079,-2981
2018,6,13,3,12390,12681,9227,-3454
2018,6,13,4,11110,11326,8619,-2707
2018,6,13,5,10490,11001,8110,-2891
2018,6,13,6,9960,10636,7855,-2781
2018,6,13,7,9700,10484,7744,-2740
2018,6,13,8,9580,10368,7689,-2679
2018,6,13,9,9820,10587,7725,-2862
2018,6,13,10,10480,10921,8195,-2726
2018,6,13,11,11930,11896,9285,-2611
2018,6,13,12,13000,12997,10834,-2163
2018,6,13,13,13520,13515,11623,-1892
2018,6,13,14,13950,13988,11710,-2278
2018,6,13,15,14120,14533,12173,-2360
2018,6,13,16,14700,14883,12593,-2290
2018,6,13,17,14890,14978,12259,-2719
2018,6,13,18,15340,15324,12547,-2777
2018,6,13,19,15360,15391,12888,-2503
2018,6,13,20,15550,15405,12676,-2729
2018,6,13,21,15800,15407,12948,-2459
2018,6,13,22,15880,15512,12971,-2541
2018,6,13,23,15690,15426,13012,-2414
2018,6,14,0,15680,15394,13014,-2380
2018,6,14,1,15660,15367,12797,-2570
2018,6,14,2,15040,14816,12514,-2302
2018,6,14,3,13580,13536,11008,-2528
2018,6,14,4,12260,12269,9843,-2426
2018,6,14,5,11530,11669,9423,-2246
2018,6,14,6,11050,11516,9305,-2211
2018,6,14,7,10570,11756,9469,-2287
2018,6,14,8,10540,11617,9188,-2429
2018,6,14,9,10620,11721,8979,-2742
2018,6,14,10,11140,11906,9285,-2621
2018,6,14,11,12700,12714,10091,-2623
2018,6,14,12,13740,13760,11314,-2446
2018,6,14,13,14110,14063,11426,-2637
2018,6,14,14,14170,14240,11455,-2785
2018,6,14,15,14390,14531,11692,-2839
2018,6,14,16,14750,14825,11950,-2875
2018,6,14,17,14970,15185,12679,-2506
2018,6,14,18,15280,15519,12855,-2664
2018,6,14,19,15460,15619,12834,-2785
2018,6,14,20,15670,15693,12986,-2707
2018,6,14,21,16030,15768,13392,-2376
2018,6,14,22,16280,15703,13424,-2279
2018,6,14,23,15990,15416,12843,-2573
2018,6,15,0,15680,15156,12679,-2477
2018,6,15,1,15510,15005,13003,-2002
2018,6,15,2,14740,14465,12591,-1874
2018,6,15,3,13250,13172,10991,-2181
2018,6,15,4,11870,12085,9759,-2326
2018,6,15,5,10960,11065,8663,-2402
2018,6,15,6,10350,10848,8378,-2470
2018,6,15,7,9970,10704,8206,-2498
2018,6,15,8,9910,10648,7991,-2657
2018,6,15,9,10070,10731,8067,-2664
2018,6,15,10,10710,11172,8696,-2476
2018,6,15,11,12090,12098,9961,-2137
2018,6,15,12,13140,13178,11164,-2014
2018,6,15,13,13610,13620,11388,-2232
2018,6,15,14,13720,13762,11240,-2522
2018,6,15,15,13680,13896,11546,-2350
2018,6,15,16,13590,13912,11682,-2230
2018,6,15,17,13710,13788,11522,-2266
2018,6,15,18,13940,13622,11358,-2264
2018,6,15,19,13830,13484,11442,-2042
2018,6,15,20,14240,13541,11727,-1814
2018,6,15,21,14100,13637,12083,-1554
2018,6,15,22,14400,13817,12225,-1592
2018,6,15,23,14100,13931,11977,-1954
2018,6,16,0,13890,13870,11633,-2237
2018,6,16,1,13910,13707,11277,-2430
2018,6,16,2,13580,13398,11106,-2292
2018,6,16,3,12480,12400,9872,-2528
2018,6,16,4,11320,11265,8450,-2815
2018,6,16,5,10390,10600,7598,-3002
2018,6,16,6,9850,10403,7512,-2891
2018,6,16,7,9530,10597,7784,-2813
2018,6,16,8,9340,10437,7679,-2758
2018,6,16,9,9410,10430,7494,-2936
2018,6,16,10,9490,10222,7597,-2625
2018,6,16,11,9850,10728,8106,-2622
2018,6,16,12,10660,11071,8985,-2086
2018,6,16,13,11480,11433,9335,-2098
2018,6,16,14,11890,11826,9512,-2314
2018,6,16,15,12270,12145,10006,-2139
2018,6,16,16,12350,12338,10496,-1842
2018,6,16,17,12740,12531,10910,-1621
2018,6,16,18,13010,12848,11261,-1587
2018,6,16,19,13560,13252,12046,-1206
2018,6,16,20,14150,13815,12920,-895
2018,6,16,21,14600,14419,13189,-1230
2018,6,16,22,15190,14818,13224,-1594
2018,6,16,23,15650,15003,13085,-1918
2018,6,17,0,15060,14908,12643,-2265
2018,6,17,1,14940,14656,12576,-2080
2018,6,17,2,14690,14297,12277,-2020
2018,6,17,3,13810,13234,10921,-2313
2018,6,17,4,12410,12248,9804,-2444
2018,6,17,5,11020,11166,8221,-2945
2018,6,17,6,10380,10627,7567,-3060
2018,6,17,7,9970,10496,7544,-2952
2018,6,17,8,9740,10278,7279,-2999
2018,6,17,9,9560,10185,7152,-3033
2018,6,17,10,9620,10331,7350,-2981
2018,6,17,11,10290,10591,7501,-3090
2018,6,17,12,10670,10796,8168,-2628
2018,6,17,13,11580,11253,9387,-1866
2018,6,17,14,12170,11925,10342,-1583
2018,6,17,15,12670,12676,11049,-1627
2018,6,17,16,13410,13273,11649,-1624
2018,6,17,17,13780,13740,11914,-1826
2018,6,17,18,14560,14139,12217,-1922
2018,6,17,19,15170,14588,12425,-2163
2018,6,17,20,16070,15198,13216,-1982
2018,6,17,21,16590,15923,13822,-2101
2018,6,17,22,16660,16431,14402,-2029
2018,6,17,23,16900,16577,14278,-2299
2018,6,18,0,16640,16334,13798,-2536
2018,6,18,1,16630,16151,13726,-2425
2018,6,18,2,15950,15699,13403,-2296
2018,6,18,3,14690,14331,11730,-2601
2018,6,18,4,12980,12996,10090,-2906
2018,6,18,5,11680,12040,9034,-3006
2018,6,18,6,11060,11561,8855,-2706
2018,6,18,7,10750,11299,8656,-2643
2018,6,18,8,10640,11376,8691,-2685
2018,6,18,9,10900,11517,8949,-2568
2018,6,18,10,11570,11729,9331,-2398
2018,6,18,11,13080,13107,11168,-1939
2018,6,18,12,14490,14462,12215,-2247
2018,6,18,13,15290,15257,13025,-2232
2018,6,18,14,16160,16073,13779,-2294
2018,6,18,15,17050,16997,14777,-2220
2018,6,18,16,17880,17933,15645,-2288
2018,6,18,17,18550,18658,16669,-1989
2018,6,18,18,19250,19449,17882,-1567
2018,6,18,19,19720,19993,18328,-1665
2018,6,18,20,20240,20337,18677,-1660
2018,6,18,21,20770,20685,19081,-1604
2018,6,18,22,21000,20822,19077,-1745
2018,6,18,23,20670,20233,17646,-2587
2018,6,19,0,20200,19513,16708,-2805
2018,6,19,1,19570,18848,16497,-2351
2018,6,19,2,18570,17807,15701,-2106
2018,6,19,3,16760,16156,14171,-1985
2018,6,19,4,15070,14634,12713,-1921
2018,6,19,5,13760,13755,11284,-2471
2018,6,19,6,13330,13730,11198,-2532
2018,6,19,7,12730,13756,11206,-2550
2018,6,19,8,12690,13649,10968,-2681
2018,6,19,9,12750,13810,11032,-2778
2018,6,19,10,13600,14229,11488,-2741
2018,6,19,11,14900,15018,12359,-2659
2018,6,19,12,16020,15926,13559,-2367
2018,6,19,13,16200,16296,14054,-2242
2018,6,19,14,16400,16448,14224,-2224
2018,6,19,15,16570,16595,14353,-2242
2018,6,19,16,16880,16812,14665,-2147
2018,6,19,17,17180,16979,15122,-1857
2018,6,19,18,17550,17288,15374,-1914
2018,6,19,19,17870,17586,15886,-1700
2018,6,19,20,18100,18005,16580,-1425
2018,6,19,21,18480,18506,16996,-1510
2018,6,19,22,18750,18860,16909,-1951
2018,6,19,23,18240,18778,16582,-2196
2018,6,20,0,17470,18181,15924,-2257
2018,6,20,1,17110,17457,15161,-2296
2018,6,20,2,16150,16581,14302,-2279
2018,6,20,3,14470,14861,12727,-2134
2018,6,20,4,12780,13154,10888,-2266
2018,6,20,5,11880,12003,9399,-2604
2018,6,20,6,11260,11507,8686,-2821
2018,6,20,7,10760,11275,8402,-2873
2018,6,20,8,10560,11100,8215,-2885
2018,6,20,9,10650,11172,8275,-2897
2018,6,20,10,11200,11706,8698,-3008
2018,6,20,11,12460,12558,9800,-2758
2018,6,20,12,13750,13599,11469,-2130
2018,6,20,13,14310,14042,11826,-2216
2018,6,20,14,14670,14368,12349,-2019
2018,6,20,15,15100,14793,13360,-1433
2018,6,20,16,15510,15078,13830,-1248
2018,6,20,17,15800,15416,14291,-1125
2018,6,20,18,16190,16085,15093,-992
2018,6,20,19,16620,16589,15551,-1038
2018,6,20,20,16940,16934,15681,-1253
2018,6,20,21,17360,17178,15765,-1413
2018,6,20,22,17560,17270,15395,-1875
2018,6,20,23,17170,17100,15229,-1871
2018,6,21,0,16830,16873,15237,-1636
2018,6,21,1,16580,16687,14928,-1759
2018,6,21,2,15940,16119,14598,-1521
2018,6,21,3,14550,14678,12889,-1789
2018,6,21,4,13090,13190,10782,-2408
2018,6,21,5,12130,12235,9591,-2644
2018,6,21,6,11460,12004,9438,-2566
2018,6,21,7,11060,12060,9623,-2437
2018,6,21,8,10880,11937,9462,-2475
2018,6,21,9,11030,12067,9452,-2615
2018,6,21,10,11630,12270,9639,-2631
2018,6,21,11,12990,13117,10699,-2418
2018,6,21,12,14120,14097,11916,-2181
2018,6,21,13,14590,14587,12558,-2029
2018,6,21,14,14870,14933,12926,-2007
2018,6,21,15,15300,15301,13368,-1933
2018,6,21,16,15660,15736,13607,-2129
2018,6,21,17,16110,16183,14038,-2145
2018,6,21,18,16360,16666,14302,-2364
2018,6,21,19,16980,17055,14905,-2150
2018,6,21,20,17470,17288,15162,-2126
2018,6,21,21,17540,17565,15218,-2347
2018,6,21,22,17550,17650,15239,-2411
2018,6,21,23,17200,17448,14936,-2512
2018,6,22,0,16770,16988,14587,-2401
2018,6,22,1,16160,16575,14002,-2573
2018,6,22,2,15550,15961,13589,-2372
2018,6,22,3,14120,14485,11859,-2626
2018,6,22,4,12520,12943,10331,-2612
2018,6,22,5,11800,12057,9822,-2235
2018,6,22,6,11090,11801,9793,-2008
2018,6,22,7,10650,11689,9875,-1814
2018,6,22,8,10420,11726,9809,-1917
2018,6,22,9,10490,11799,9571,-2228
2018,6,22,10,10960,11990,9675,-2315
2018,6,22,11,12120,12649,10551,-2098
2018,6,22,12,13090,13070,11200,-1870
2018,6,22,13,13500,13489,11613,-1876
2018,6,22,14,13780,13755,11857,-1898
2018,6,22,15,14010,14051,12464,-1587
2018,6,22,16,14230,14376,13012,-1364
2018,6,22,17,14370,14648,13051,-1597
2018,6,22,18,14670,14954,13123,-1831
2018,6,22,19,14980,15175,13101,-2074
2018,6,22,20,15090,15424,13555,-1869
2018,6,22,21,15260,15624,13499,-2125
2018,6,22,22,15380,15647,13114,-2533
2018,6,22,23,15030,15285,12711,-2574
2018,6,23,0,14670,14862,12352,-2510
2018,6,23,1,14450,14656,12144,-2512
2018,6,23,2,13980,14200,12095,-2105
2018,6,23,3,13040,13091,10830,-2261
2018,6,23,4,11830,12047,9468,-2579
2018,6,23,5,10960,11282,8500,-2782
2018,6,23,6,10370,11106,8319,-2787
2018,6,23,7,9990,11011,8022,-2989
2018,6,23,8,9820,11059,7945,-3114
2018,6,23,9,9830,11161,8009,-3152
2018,6,23,10,10000,11314,8350,-2964
2018,6,23,11,10500,11521,8549,-2972
2018,6,23,12,11250,11950,8951,-2999
2018,6,23,13,12070,12094,9362,-2732
2018,6,23,14,12650,12654,9883,-2771
2018,6,23,15,12980,12925,10119,-2806
2018,6,23,16,13200,12973,10314,-2659
2018,6,23,17,13220,13010,10562,-2448
2018,6,23,18,13210,12867,10444,-2423
2018,6,23,19,13210,12738,10275,-2463
2018,6,23,20,13200,12649,9774,-2875
2018,6,23,21,13320,12712,9827,-2885
2018,6,23,22,13550,12903,9895,-3008
2018,6,23,23,13460,12944,9798,-3146
2018,6,24,0,13350,12869,9698,-3171
2018,6,24,1,13210,12862,9818,-3044
2018,6,24,2,12920,12499,9575,-2924
2018,6,24,3,12130,11707,8554,-3153
2018,6,24,4,11220,10807,7776,-3031
2018,6,24,5,10430,10106,7966,-2140
2018,6,24,6,9920,9893,7903,-1990
2018,6,24,7,9640,9857,7721,-2136
2018,6,24,8,9450,10013,7788,-2225
2018,6,24,9,9570,10033,7522,-2511
2018,6,24,10,9470,10079,7585,-2494
2018,6,24,11,9780,10155,7680,-2475
2018,6,24,12,10360,10554,8323,-2231
2018,6,24,13,11120,11347,9128,-2219
2018,6,24,14,11710,11774,9712,-2062
2018,6,24,15,12200,12181,10084,-2097
2018,6,24,16,12620,12429,10536,-1893
2018,6,24,17,13050,12770,10993,-1777
2018,6,24,18,13350,13199,11614,-1585
2018,6,24,19,13780,13669,12324,-1345
2018,6,24,20,13960,14058,12743,-1315
2018,6,24,21,14600,14573,13227,-1346
2018,6,24,22,15060,15149,13658,-1491
2018,6,24,23,15020,15279,13480,-1799
2018,6,25,0,14990,15188,13401,-1787
2018,6,25,1,14750,15050,13136,-1914
2018,6,25,2,14290,14510,12578,-1932
2018,6,25,3,13230,13412,11097,-2315
2018,6,25,4,12030,12275,9703,-2572
2018,6,25,5,11420,11537,9118,-2419
2018,6,25,6,10880,11170,8887,-2283
2018,6,25,7,10560,10859,8780,-2079
2018,6,25,8,10440,10740,8677,-2063
2018,6,25,9,10660,10937,8804,-2133
2018,6,25,10,11290,11550,9493,-2057
2018,6,25,11,12560,12812,10476,-2336
2018,6,25,12,13730,13988,11742,-2246
2018,6,25,13,14380,14656,12563,-2093
2018,6,25,14,14570,14573,12743,-1830
2018,6,25,15,14610,14615,12587,-2028
2018,6,25,16,14620,14634,12422,-2212
2018,6,25,17,14550,14538,12569,-1969
2018,6,25,18,14610,14614,12550,-2064
2018,6,25,19,14670,14664,12638,-2026
2018,6,25,20,14780,14784,12911,-1873
2018,6,25,21,15180,15173,13318,-1855
2018,6,25,22,15810,15587,13768,-1819
2018,6,25,23,15880,15691,13751,-1940
2018,6,26,0,15380,15357,13067,-2290
2018,6,26,1,15040,14953,12606,-2347
2018,6,26,2,14290,14366,12090,-2276
2018,6,26,3,13000,12992,10547,-2445
2018,6,26,4,11570,11609,9308,-2301
2018,6,26,5,10700,10666,8326,-2340
2018,6,26,6,10130,10471,8273,-2198
2018,6,26,7,9790,10786,8448,-2338
2018,6,26,8,9710,10962,8491,-2471
2018,6,26,9,9900,11394,8744,-2650
2018,6,26,10,10540,11433,9213,-2220
2018,6,26,11,11710,11940,9896,-2044
2018,6,26,12,12810,12541,10681,-1860
2018,6,26,13,13200,12887,11017,-1870
2018,6,26,14,13020,13034,11383,-1651
2018,6,26,15,13250,13249,11837,-1412
2018,6,26,16,13540,13445,11746,-1699
2018,6,26,17,13790,13596,12059,-1537
2018,6,26,18,14040,13946,12435,-1511
2018,6,26,19,14600,14254,12861,-1393
2018,6,26,20,15080,14666,13503,-1163
2018,6,26,21,15750,15223,14210,-1013
2018,6,26,22,16120,15754,14639,-1115
2018,6,26,23,15890,15867,14063,-1804
2018,6,27,0,15550,15524,13600,-1924
2018,6,27,1,15550,15264,13059,-2205
2018,6,27,2,14830,14739,12497,-2242
2018,6,27,3,13490,13420,11005,-2415
2018,6,27,4,12060,12321,10004,-2317
2018,6,27,5,11020,11555,9504,-2051
2018,6,27,6,10480,11088,9120,-1968
2018,6,27,7,10180,10765,8741,-2024
2018,6,27,8,10110,10914,8683,-2231
2018,6,27,9,10330,11106,8649,-2457
2018,6,27,10,10990,11696,9355,-2341
2018,6,27,11,12280,12602,10316,-2286
2018,6,27,12,13520,13254,11298,-1956
2018,6,27,13,14050,13805,12203,-1602
2018,6,27,14,14180,14137,12487,-1650
2018,6,27,15,14580,14428,12854,-1574
2018,6,27,16,14960,14709,13083,-1626
2018,6,27,17,15090,14922,13210,-1712
2018,6,27,18,15480,15370,13545,-1825
2018,6,27,19,15630,15692,13994,-1698
2018,6,27,20,15700,15777,14167,-1610
2018,6,27,21,15860,15759,14037,-1722
2018,6,27,22,16150,15756,13649,-2107
2018,6,27,23,15870,15576,13307,-2269
2018,6,28,0,15680,15373,13089,-2284
2018,6,28,1,15450,15287,12908,-2379
2018,6,28,2,14910,14692,12459,-2233
2018,6,28,3,13690,13482,11194,-2288
2018,6,28,4,12350,12300,9674,-2626
2018,6,28,5,11400,11701,9002,-2699
2018,6,28,6,10910,11454,9038,-2416
2018,6,28,7,10660,11498,9215,-2283
2018,6,28,8,10600,11664,9202,-2462
2018,6,28,9,10900,11872,9184,-2688
2018,6,28,10,11750,12208,9696,-2512
2018,6,28,11,13370,13115,10645,-2470
2018,6,28,12,14660,14484,11932,-2552
2018,6,28,13,15520,15356,13193,-2163
2018,6,28,14,16010,15908,13788,-2120
2018,6,28,15,16280,16251,14214,-2037
2018,6,28,16,16460,16415,14479,-1936
2018,6,28,17,16660,16530,14814,-1716
2018,6,28,18,16800,16673,15049,-1624
2018,6,28,19,16960,16833,15222,-1611
2018,6,28,20,17150,16888,15520,-1368
2018,6,28,21,17330,16982,15926,-1056
2018,6,28,22,17700,17119,15963,-1156
2018,6,28,23,17580,17030,15484,-1546
2018,6,29,0,17260,16814,14893,-1921
2018,6,29,1,17080,16625,14533,-2092
2018,6,29,2,16490,16189,14531,-1658
2018,6,29,3,14950,14904,12866,-2038
2018,6,29,4,13580,13541,11059,-2482
2018,6,29,5,12600,12917,10346,-2571
2018,6,29,6,11930,12542,10198,-2344
2018,6,29,7,11520,12699,10303,-2396
2018,6,29,8,11300,12512,10218,-2294
2018,6,29,9,11400,12616,9934,-2682
2018,6,29,10,11980,13078,10387,-2691
2018,6,29,11,13360,13664,11128,-2536
2018,6,29,12,14830,14845,12504,-2341
2018,6,29,13,15740,15620,13818,-1802
2018,6,29,14,16310,16303,14574,-1729
2018,6,29,15,17020,16982,15168,-1814
2018,6,29,16,17680,17630,15849,-1781
2018,6,29,17,18200,18115,15724,-2391
2018,6,29,18,18940,18837,16453,-2384
2018,6,29,19,19360,19309,17319,-1990
2018,6,29,20,19980,19641,17776,-1865
2018,6,29,21,20480,20037,17946,-2091
2018,6,29,22,20500,20399,18440,-1959
2018,6,29,23,19990,20345,18167,-2178
2018,6,30,0,19270,19730,16987,-2743
2018,6,30,1,18860,19000,15892,-3108
2018,6,30,2,18200,18190,15632,-2558
2018,6,30,3,16740,16710,14447,-2263
2018,6,30,4,15080,15379,12910,-2469
2018,6,30,5,13840,14113,11649,-2464
2018,6,30,6,12890,13474,10874,-2600
2018,6,30,7,12380,13238,10485,-2753
2018,6,30,8,11960,13293,10427,-2866
2018,6,30,9,11790,13129,10399,-2730
2018,6,30,10,11880,13365,10467,-2898
2018,6,30,11,12470,13609,10658,-2951
2018,6,30,12,13460,14012,11290,-2722
2018,6,30,13,14830,14502,12286,-2216
2018,6,30,14,15600,15673,13646,-2027
2018,6,30,15,16410,16678,14432,-2246
2018,6,30,16,17110,17439,15266,-2173
2018,6,30,17,17830,17979,15825,-2154
2018,6,30,18,18480,18526,16495,-2031
2018,6,30,19,19040,18988,17120,-1868
2018,6,30,20,19670,19385,17613,-1772
2018,6,30,21,20080,19837,18126,-1711
2018,6,30,22,20200,20292,18036,-2256
2018,6,30,23,20130,20399,17902,-2497
2018,7,1,0,19520,19914,16955,-2959
2018,7,1,1,19030,19355,16769,-2586
2018,7,1,2,18530,18770,16293,-2477
2018,7,1,3,17080,17421,15376,-2045
2018,7,1,4,15650,16406,14146,-2260
2018,7,1,5,14800,15203,13079,-2124
2018,7,1,6,13770,14307,12382,-1925
2018,7,1,7,13140,14347,12255,-2092
2018,7,1,8,12760,14227,12061,-2166
2018,7,1,9,12610,14016,11748,-2268
2018,7,1,10,12700,13710,11493,-2217
2018,7,1,11,12670,13530,11345,-2185
2018,7,1,12,13960,13989,11890,-2099
2018,7,1,13,15160,14878,12921,-1957
2018,7,1,14,16260,16181,14478,-1703
2018,7,1,15,17840,17462,16056,-1406
2018,7,1,16,18910,18708,17450,-1258
2018,7,1,17,19960,19735,18189,-1546
2018,7,1,18,20900,20542,18509,-2033
2018,7,1,19,21570,21095,19170,-1925
2018,7,1,20,22320,21568,19699,-1869
2018,7,1,21,22700,22068,20105,-1963
2018,7,1,22,22830,22517,20377,-2140
2018,7,1,23,22880,22498,20428,-2070
2018,7,2,0,22430,22008,20013,-1995
2018,7,2,1,21680,21444,19311,-2133
2018,7,2,2,20870,20695,18817,-1878
2018,7,2,3,18850,19005,16768,-2237
2018,7,2,4,17160,17439,14969,-2470
2018,7,2,5,15810,16338,14086,-2252
2018,7,2,6,14900,16037,13860,-2177
2018,7,2,7,14290,15899,13550,-2349
2018,7,2,8,13940,15524,13236,-2288
2018,7,2,9,13930,15496,13318,-2178
2018,7,2,10,14400,15798,13441,-2357
2018,7,2,11,15630,16356,14070,-2286
2018,7,2,12,17040,17134,15246,-1888
2018,7,2,13,18120,18092,16510,-1582
2018,7,2,14,19020,19001,17556,-1445
2018,7,2,15,19880,19864,18475,-1389
2018,7,2,16,20680,20657,19489,-1168
2018,7,2,17,21300,21285,19980,-1305
2018,7,2,18,21890,21862,20624,-1238
2018,7,2,19,22240,22241,21107,-1134
2018,7,2,20,22510,22531,21503,-1028
2018,7,2,21,23000,22893,21691,-1202
2018,7,2,22,23210,23194,21862,-1332
2018,7,2,23,23000,23153,21024,-2129
2018,7,3,0,22280,22636,19921,-2715
2018,7,3,1,21470,21981,19142,-2839
2018,7,3,2,20630,20979,18614,-2365
2018,7,3,3,18620,19075,17268,-1807
2018,7,3,4,16790,17395,14917,-2478
2018,7,3,5,15730,16617,14088,-2529
2018,7,3,6,14800,16092,13560,-2532
2018,7,3,7,14250,15848,13242,-2606
2018,7,3,8,13970,15554,13160,-2394
2018,7,3,9,14040,15609,13247,-2362
2018,7,3,10,14610,15895,13409,-2486
2018,7,3,11,15930,16603,14307,-2296
2018,7,3,12,17330,17650,15237,-2413
2018,7,3,13,18370,18607,15917,-2690
2018,7,3,14,19350,19336,16651,-2685
2018,7,3,15,20280,20393,17753,-2640
2018,7,3,16,21050,21410,18691,-2719
2018,7,3,17,21690,22316,19385,-2931
2018,7,3,18,22450,23141,20479,-2662
2018,7,3,19,22640,23561,21320,-2241
2018,7,3,20,23050,23829,21695,-2134
2018,7,3,21,23540,23992,21638,-2354
2018,7,3,22,23800,23904,21194,-2710
2018,7,3,23,23650,23580,20444,-3136
2018,7,4,0,23120,22982,19506,-3476
2018,7,4,1,22360,22211,18722,-3489
2018,7,4,2,21230,21307,18082,-3225
2018,7,4,3,19280,19725,16692,-3033
2018,7,4,4,17270,18458,15221,-3237
2018,7,4,5,16580,17126,13839,-3287
2018,7,4,6,15510,16302,12926,-3376
2018,7,4,7,14790,15793,12333,-3460
2018,7,4,8,14300,15596,12392,-3204
2018,7,4,9,14060,15346,12154,-3192
2018,7,4,10,14000,14831,11652,-3179
2018,7,4,11,14490,15177,11955,-3222
2018,7,4,12,15360,15635,12676,-2959
2018,7,4,13,16490,16475,13653,-2822
2018,7,4,14,17650,17642,14963,-2679
2018,7,4,15,18780,18642,16017,-2625
2018,7,4,16,19350,19464,16586,-2878
2018,7,4,17,19980,20001,17332,-2669
2018,7,4,18,20440,20282,17724,-2558
2018,7,4,19,20850,20543,18281,-2262
2018,7,4,20,21570,20831,18632,-2199
2018,7,4,21,21900,21218,18721,-2497
2018,7,4,22,22000,21615,18775,-2840
2018,7,4,23,21800,21572,18310,-3262
2018,7,5,0,21390,21027,17682,-3345
2018,7,5,1,20800,20358,16846,-3512
2018,7,5,2,19750,19572,16385,-3187
2018,7,5,3,18380,18379,15380,-2999
2018,7,5,4,17290,17013,14305,-2708
2018,7,5,5,15720,15751,13073,-2678
2018,7,5,6,14840,15211,12629,-2582
2018,7,5,7,14260,15319,12509,-2810
2018,7,5,8,13960,15221,12473,-2748
2018,7,5,9,14000,15333,12377,-2956
2018,7,5,10,14500,15573,12840,-2733
2018,7,5,11,15790,16186,13827,-2359
2018,7,5,12,17350,17320,14977,-2343
2018,7,5,13,18650,18620,16003,-2617
2018,7,5,14,19860,19822,16947,-2875
2018,7,5,15,20830,20919,18054,-2865
2018,7,5,16,21670,21757,18782,-2975
2018,7,5,17,22440,22402,19356,-3046
2018,7,5,18,23090,22992,20002,-2990
2018,7,5,19,23390,23349,21261,-2088
2018,7,5,20,23610,23678,21254,-2424
2018,7,5,21,23790,23992,20953,-3039
2018,7,5,22,23900,24188,21032,-3156
2018,7,5,23,23510,23966,20375,-3591
2018,7,6,0,22700,23440,19597,-3843
2018,7,6,1,21960,22738,18633,-4105
2018,7,6,2,20870,21852,17991,-3861
2018,7,6,3,19160,20098,16309,-3789
2018,7,6,4,17540,18313,15003,-3310
2018,7,6,5,16800,17183,14024,-3159
2018,7,6,6,15800,16813,13792,-3021
2018,7,6,7,15210,16566,13641,-2925
2018,7,6,8,14970,16455,13430,-3025
2018,7,6,9,15040,16674,13962,-2712
2018,7,6,10,15670,16731,14243,-2488
2018,7,6,11,16800,17289,14697,-2592
2018,7,6,12,18100,18362,15654,-2708
2018,7,6,13,19010,19315,16565,-2750
2018,7,6,14,20090,20054,17027,-3027
2018,7,6,15,20650,20482,17411,-3071
2018,7,6,16,20790,20513,17359,-3154
2018,7,6,17,20940,19939,16605,-3334
2018,7,6,18,21020,19585,16342,-3243
2018,7,6,19,20990,19642,16383,-3259
2018,7,6,20,20580,19859,16522,-3337
2018,7,6,21,20230,19902,16657,-3245
2018,7,6,22,19810,19768,16640,-3128
2018,7,6,23,19320,19120,15989,-3131
2018,7,7,0,18550,18156,15236,-2920
2018,7,7,1,17750,17238,14482,-2756
2018,7,7,2,16950,16490,13817,-2673
2018,7,7,3,15550,15093,12428,-2665
2018,7,7,4,13950,13721,10810,-2911
2018,7,7,5,12300,12312,9618,-2694
2018,7,7,6,11510,11655,9370,-2285
2018,7,7,7,10900,11412,9070,-2342
2018,7,7,8,10540,11554,9213,-2341
2018,7,7,9,10470,11787,8967,-2820
2018,7,7,10,10200,11518,8580,-2938
2018,7,7,11,10550,11674,8695,-2979
2018,7,7,12,11270,11744,8713,-3031
2018,7,7,13,12030,11954,9098,-2856
2018,7,7,14,12100,12086,9853,-2233
2018,7,7,15,12360,12329,10739,-1590
2018,7,7,16,12540,12488,10891,-1597
2018,7,7,17,12730,12608,11018,-1590
2018,7,7,18,12950,12732,10416,-2316
2018,7,7,19,13170,13017,10781,-2236
2018,7,7,20,13880,13463,11061,-2402
2018,7,7,21,14640,14083,11698,-2385
2018,7,7,22,15060,14761,12178,-2583
2018,7,7,23,15380,15040,12389,-2651
2018,7,8,0,15030,14777,12148,-2629
2018,7,8,1,14820,14417,11696,-2721
2018,7,8,2,14550,14036,11254,-2782
2018,7,8,3,13610,13091,9961,-3130
2018,7,8,4,12510,12019,8893,-3126
2018,7,8,5,11060,11091,7840,-3251
2018,7,8,6,10430,10455,7772,-2683
2018,7,8,7,10020,10186,7837,-2349
2018,7,8,8,9820,10349,7700,-2649
2018,7,8,9,9750,10659,7744,-2915
2018,7,8,10,9700,10761,7844,-2917
2018,7,8,11,9960,10340,7707,-2633
2018,7,8,12,10480,10742,8081,-2661
2018,7,8,13,11130,11108,8525,-2583
2018,7,8,14,11780,11729,9227,-2502
2018,7,8,15,12500,12276,9679,-2597
2018,7,8,16,13110,12773,10010,-2763
2018,7,8,17,13640,13257,10639,-2618
2018,7,8,18,14100,13679,11020,-2659
2018,7,8,19,14570,14176,11250,-2926
2018,7,8,20,15300,14850,12170,-2680
2018,7,8,21,15990,15705,13265,-2440
2018,7,8,22,16600,16491,14107,-2384
2018,7,8,23,16680,16791,14046,-2745
2018,7,9,0,16280,16522,13493,-3029
2018,7,9,1,15930,16096,13238,-2858
2018,7,9,2,15390,15558,12591,-2967
2018,7,9,3,14110,14232,11118,-3114
2018,7,9,4,12760,12865,9460,-3405
2018,7,9,5,11800,11910,8716,-3194
2018,7,9,6,11160,11696,8559,-3137
2018,7,9,7,10780,11797,8571,-3226
2018,7,9,8,10620,11697,8449,-3248
2018,7,9,9,10790,11872,8404,-3468
2018,7,9,10,11480,12282,8758,-3524
2018,7,9,11,12830,12766,9541,-3225
2018,7,9,12,13990,13785,10712,-3073
2018,7,9,13,14810,14507,11776,-2731
2018,7,9,14,15420,15105,12480,-2625
2018,7,9,15,16290,15848,13363,-2485
2018,7,9,16,17070,16591,14254,-2337
2018,7,9,17,17770,17259,14936,-2323
2018,7,9,18,18630,18030,15911,-2119
2018,7,9,19,19100,18717,16658,-2059
2018,7,9,20,19780,19415,17250,-2165
2018,7,9,21,20250,20168,17688,-2480
2018,7,9,22,20700,20795,18051,-2744
2018,7,9,23,20580,20919,17855,-3064
2018,7,10,0,19800,20344,17204,-3140
2018,7,10,1,19070,19525,16470,-3055
2018,7,10,2,18190,18558,15843,-2715
2018,7,10,3,16500,16789,13652,-3137
2018,7,10,4,14780,15003,11935,-3068
2018,7,10,5,13690,13815,10780,-3035
2018,7,10,6,12830,13442,10404,-3038
2018,7,10,7,12280,13352,10213,-3139
2018,7,10,8,11940,13255,10176,-3079
2018,7,10,9,11980,12987,9941,-3046
2018,7,10,10,12630,13268,10299,-2969
2018,7,10,11,13840,14353,11583,-2770
2018,7,10,12,15320,15169,12761,-2408
2018,7,10,13,16310,15991,13490,-2501
2018,7,10,14,17020,16818,14668,-2150
2018,7,10,15,17990,17732,15651,-2081
2018,7,10,16,18900,18614,16513,-2101
2018,7,10,17,19700,19344,17117,-2227
2018,7,10,18,20540,20234,18175,-2059
2018,7,10,19,21060,20936,18637,-2299
2018,7,10,20,21680,21649,19497,-2152
2018,7,10,21,22220,22369,20313,-2056
2018,7,10,22,22450,22734,20092,-2642
2018,7,10,23,22310,22421,19418,-3003
2018,7,11,0,21510,21690,18827,-2863
2018,7,11,1,20870,21051,18243,-2808
2018,7,11,2,19790,20043,17284,-2759
2018,7,11,3,18110,18184,15525,-2659
2018,7,11,4,16120,16368,13941,-2427
2018,7,11,5,14970,15013,12236,-2777
2018,7,11,6,14090,14432,11967,-2465
2018,7,11,7,13480,14271,12036,-2235
2018,7,11,8,13140,14035,11691,-2344
2018,7,11,9,13140,14182,11675,-2507
2018,7,11,10,13580,14196,11829,-2367
2018,7,11,11,14630,14908,12508,-2400
2018,7,11,12,15670,15653,13262,-2391
2018,7,11,13,16180,16178,13875,-2303
2018,7,11,14,16490,16495,14383,-2112
2018,7,11,15,16870,16861,14526,-2335
2018,7,11,16,17190,17198,15016,-2182
2018,7,11,17,17450,17455,15426,-2029
2018,7,11,18,17770,17771,15675,-2096
2018,7,11,19,18040,18050,15826,-2224
2018,7,11,20,18340,18332,16215,-2117
2018,7,11,21,18650,18619,16587,-2032
2018,7,11,22,18960,18732,16550,-2182
2018,7,11,23,18870,18493,16108,-2385
2018,7,12,0,18340,17978,15795,-2183
2018,7,12,1,17810,17433,15206,-2227
2018,7,12,2,16910,16711,14607,-2104
2018,7,12,3,15410,15179,13206,-1973
2018,7,12,4,13930,13611,11532,-2079
2018,7,12,5,12470,12742,10378,-2364
2018,7,12,6,11730,12268,9921,-2347
2018,7,12,7,11280,12258,10051,-2207
2018,7,12,8,11030,12116,9804,-2312
2018,7,12,9,11090,11902,9539,-2363
2018,7,12,10,11550,12327,10157,-2170
2018,7,12,11,12690,12724,10455,-2269
2018,7,12,12,13790,13783,11430,-2353
2018,7,12,13,14340,14333,11990,-2343
2018,7,12,14,14600,14613,12685,-1928
2018,7,12,15,15320,14997,13549,-1448
2018,7,12,16,15680,15381,14103,-1278
2018,7,12,17,15990,15719,14619,-1100
2018,7,12,18,16450,16264,14884,-1380
2018,7,12,19,16850,16732,15487,-1245
2018,7,12,20,17130,17197,16224,-973
2018,7,12,21,17600,17647,16533,-1114
2018,7,12,22,18300,17948,16559,-1389
2018,7,12,23,17890,17870,16400,-1470
2018,7,13,0,17540,17404,15745,-1659
2018,7,13,1,17220,17032,15359,-1673
2018,7,13,2,16520,17032,15408,-1624
2018,7,13,3,15100,14835,13208,-1627
2018,7,13,4,13640,13599,11690,-1909
2018,7,13,5,12320,13195,10843,-2352
2018,7,13,6,11610,12804,9901,-2903
2018,7,13,7,11200,12510,9987,-2523
2018,7,13,8,11000,12305,9615,-2690
2018,7,13,9,11120,12407,9763,-2644
2018,7,13,10,11630,12751,10201,-2550
2018,7,13,11,12770,13512,11159,-2353
2018,7,13,12,13990,14202,12169,-2033
2018,7,13,13,14740,14721,13149,-1572
2018,7,13,14,15190,15206,14271,-935
2018,7,13,15,15980,15694,14967,-727
2018,7,13,16,16570,16206,15441,-765
2018,7,13,17,16880,16682,15883,-799
2018,7,13,18,17360,17293,16338,-955
2018,7,13,19,17680,17685,16812,-873
2018,7,13,20,17980,17996,17317,-679
2018,7,13,21,18390,18289,17479,-810
2018,7,13,22,18500,18344,17279,-1065
2018,7,13,23,17970,17919,16477,-1442
2018,7,14,0,17360,17249,15820,-1429
2018,7,14,1,17050,16708,15398,-1310
2018,7,14,2,16440,16097,14782,-1315
2018,7,14,3,15230,14845,13261,-1584
2018,7,14,4,13720,13484,11522,-1962
2018,7,14,5,12380,12417,10074,-2343
2018,7,14,6,11690,11981,9521,-2460
2018,7,14,7,11230,12130,9475,-2655
2018,7,14,8,10990,12364,9796,-2568
2018,7,14,9,10910,12508,9814,-2694
2018,7,14,10,10960,12541,9725,-2816
2018,7,14,11,11380,12337,9696,-2641
2018,7,14,12,12200,12487,10630,-1857
2018,7,14,13,13080,13330,11591,-1739
2018,7,14,14,13860,13897,12649,-1248
2018,7,14,15,14370,14335,13491,-844
2018,7,14,16,14790,14795,13984,-811
2018,7,14,17,15150,15069,14402,-667
2018,7,14,18,15460,15401,14670,-731
2018,7,14,19,15790,15765,14969,-796
2018,7,14,20,16140,16089,15355,-734
2018,7,14,21,16650,16475,15907,-568
2018,7,14,22,16960,16658,16138,-520
2018,7,14,23,17250,16503,15767,-736
2018,7,15,0,16820,16211,15390,-821
2018,7,15,1,16420,16089,15163,-926
2018,7,15,2,15990,15693,14643,-1050
2018,7,15,3,14960,14718,13457,-1261
2018,7,15,4,13760,13593,11822,-1771
2018,7,15,5,12660,12684,10594,-2090
2018,7,15,6,12040,12574,10258,-2316
2018,7,15,7,11640,12433,10090,-2343
2018,7,15,8,11410,12393,9999,-2394
2018,7,15,9,11330,12366,10040,-2326
2018,7,15,10,11370,12179,9923,-2256
2018,7,15,11,11630,12408,9964,-2444
2018,7,15,12,12230,12610,10533,-2077
2018,7,15,13,12990,13229,11632,-1597
2018,7,15,14,13720,13962,12429,-1533
2018,7,15,15,14680,14540,13520,-1020
2018,7,15,16,15410,15374,14603,-771
2018,7,15,17,16110,16156,15187,-969
2018,7,15,18,16700,16761,15653,-1108
2018,7,15,19,17250,17287,15958,-1329
2018,7,15,20,17730,17835,16564,-1271
2018,7,15,21,18170,18481,17178,-1303
2018,7,15,22,18690,19126,17643,-1483
2018,7,15,23,19000,19314,17927,-1387
2018,7,16,0,18540,18940,17290,-1650
2018,7,16,1,18080,18597,17079,-1518
2018,7,16,2,17540,17987,16497,-1490
2018,7,16,3,15970,16509,14750,-1759
2018,7,16,4,14560,15038,13007,-2031
2018,7,16,5,13790,14163,11574,-2589
2018,7,16,6,13060,13954,11449,-2505
2018,7,16,7,12600,13984,11431,-2553
2018,7,16,8,12370,13956,11290,-2666
2018,7,16,9,12510,14007,11465,-2542
2018,7,16,10,13130,14039,12118,-1921
2018,7,16,11,14350,14389,12315,-2074
2018,7,16,12,15740,15715,13969,-1746
2018,7,16,13,16680,16672,14987,-1685
2018,7,16,14,17490,17492,16074,-1418
2018,7,16,15,18430,18473,17052,-1421
2018,7,16,16,19290,19453,18133,-1320
2018,7,16,17,20180,20249,18604,-1645
2018,7,16,18,21070,21062,19523,-1539
2018,7,16,19,21580,21555,19763,-1792
2018,7,16,20,22080,21908,19989,-1919
2018,7,16,21,22540,22299,20105,-2194
2018,7,16,22,22700,22557,20353,-2204
2018,7,16,23,22570,22360,19915,-2445
2018,7,17,0,21920,21726,18968,-2758
2018,7,17,1,21240,21168,18238,-2930
2018,7,17,2,20300,20157,17215,-2942
2018,7,17,3,18300,18392,15645,-2747
2018,7,17,4,16560,16651,13849,-2802
2018,7,17,5,15360,15717,13206,-2511
2018,7,17,6,14530,15589,13172,-2417
2018,7,17,7,14010,15381,12896,-2485
2018,7,17,8,13750,15178,12702,-2476
2018,7,17,9,13870,15451,13038,-2413
2018,7,17,10,14500,15791,13470,-2321
2018,7,17,11,15820,16492,14478,-2014
2018,7,17,12,17310,17314,15361,-1953
2018,7,17,13,18320,18300,15968,-2332
2018,7,17,14,19300,19266,16908,-2358
2018,7,17,15,20370,20340,17781,-2559
2018,7,17,16,21240,21225,18304,-2921
2018,7,17,17,21730,21722,18525,-3197
2018,7,17,18,22030,22027,18810,-3217
2018,7,17,19,21450,21486,18552,-2934
2018,7,17,20,20720,20763,17988,-2775
2018,7,17,21,20250,20269,17544,-2725
2018,7,17,22,19890,19935,17072,-2863
2018,7,17,23,19470,19376,16229,-3147
2018,7,18,0,19020,18778,15535,-3243
2018,7,18,1,18800,18364,15333,-3031
2018,7,18,2,17980,17533,14598,-2935
2018,7,18,3,16560,16346,13367,-2979
2018,7,18,4,15040,15136,12262,-2874
2018,7,18,5,13610,14209,11488,-2721
2018,7,18,6,12980,14157,11204,-2953
2018,7,18,7,12570,13887,11388,-2499
2018,7,18,8,12350,13915,11211,-2704
2018,7,18,9,12480,13792,11089,-2703
2018,7,18,10,13100,13881,11452,-2429
2018,7,18,11,14200,14638,12061,-2577
2018,7,18,12,15290,15535,12954,-2581
2018,7,18,13,15790,15788,13515,-2273
2018,7,18,14,16030,16027,14016,-2011
2018,7,18,15,16290,16299,14509,-1790
2018,7,18,16,16570,16561,14751,-1810
2018,7,18,17,16830,16832,15377,-1455
2018,7,18,18,17220,17228,15668,-1560
2018,7,18,19,17550,17568,15936,-1632
2018,7,18,20,18020,17966,16417,-1549
2018,7,18,21,18240,18458,16937,-1521
2018,7,18,22,18450,18766,16935,-1831
2018,7,18,23,17930,18637,16855,-1782
2018,7,19,0,17360,18048,15938,-2110
2018,7,19,1,16880,17362,15189,-2173
2018,7,19,2,16090,16549,14485,-2064
2018,7,19,3,14570,14922,12920,-2002
2018,7,19,4,13010,13310,10966,-2344
2018,7,19,5,12110,12395,9824,-2571
2018,7,19,6,11410,12227,9489,-2738
2018,7,19,7,10950,12042,9193,-2849
2018,7,19,8,10730,11804,9160,-2644
2018,7,19,9,10850,11866,9200,-2666
2018,7,19,10,11390,11886,9433,-2453
2018,7,19,11,12580,12620,10109,-2511
2018,7,19,12,13570,13468,11212,-2256
2018,7,19,13,14200,13964,11914,-2050
2018,7,19,14,14330,14248,12350,-1898
2018,7,19,15,14720,14579,13021,-1558
2018,7,19,16,15100,14891,13370,-1521
2018,7,19,17,15400,15176,13865,-1311
2018,7,19,18,15820,15647,14156,-1491
2018,7,19,19,16140,16097,14605,-1492
2018,7,19,20,17010,16628,15161,-1467
2018,7,19,21,17560,17202,15978,-1224
2018,7,19,22,17900,17703,16463,-1240
2018,7,19,23,17730,17819,16013,-1806
2018,7,20,0,17240,17326,15381,-1945
2018,7,20,1,16860,16797,14827,-1970
2018,7,20,2,16160,16090,14458,-1632
2018,7,20,3,14740,14644,12442,-2202
2018,7,20,4,13260,13152,10740,-2412
2018,7,20,5,12070,12385,9720,-2665
2018,7,20,6,11350,11791,9199,-2592
2018,7,20,7,10930,11788,9136,-2652
2018,7,20,8,10740,11583,8847,-2736
2018,7,20,9,10880,11690,8829,-2861
2018,7,20,10,11410,12186,9262,-2924
2018,7,20,11,12530,12796,10087,-2709
2018,7,20,12,13720,13701,11474,-2227
2018,7,20,13,14430,14425,12460,-1965
2018,7,20,14,15070,14966,13073,-1893
2018,7,20,15,15670,15548,13944,-1604
2018,7,20,16,16180,16033,14768,-1265
2018,7,20,17,16570,16416,15174,-1242
2018,7,20,18,17030,16949,15817,-1132
2018,7,20,19,17450,17347,15967,-1380
2018,7,20,20,17850,17758,16204,-1554
2018,7,20,21,18320,18219,16814,-1405
2018,7,20,22,18550,18496,17075,-1421
2018,7,20,23,18330,18287,16473,-1814
2018,7,21,0,17670,17618,15626,-1992
2018,7,21,1,17020,17009,15316,-1693
2018,7,21,2,16360,16304,14618,-1686
2018,7,21,3,15110,14988,12697,-2291
2018,7,21,4,13720,13484,10796,-2688
2018,7,21,5,12070,12358,9536,-2822
2018,7,21,6,11290,11627,8968,-2659
2018,7,21,7,10870,11852,8935,-2917
2018,7,21,8,10560,11810,8783,-3027
2018,7,21,9,10440,11696,8673,-3023
2018,7,21,10,10540,11738,8669,-3069
2018,7,21,11,10910,12144,8909,-3235
2018,7,21,12,11750,12460,9601,-2859
2018,7,21,13,12730,12831,10424,-2407
2018,7,21,14,13050,13066,10919,-2147
2018,7,21,15,13470,13344,11618,-1726
2018,7,21,16,13830,13595,12041,-1554
2018,7,21,17,13930,13813,12251,-1562
2018,7,21,18,14030,13995,12307,-1688
2018,7,21,19,14200,14256,12645,-1611
2018,7,21,20,14370,14651,12897,-1754
2018,7,21,21,14720,15103,13152,-1951
2018,7,21,22,15000,15372,13274,-2098
2018,7,21,23,14790,15309,12910,-2399
2018,7,22,0,14540,15038,12658,-2380
2018,7,22,1,14590,14974,12452,-2522
2018,7,22,2,14230,14570,12287,-2283
2018,7,22,3,13330,13625,10654,-2971
2018,7,22,4,12320,12584,9475,-3109
2018,7,22,5,11710,11975,8709,-3266
2018,7,22,6,11160,11448,8265,-3183
2018,7,22,7,10840,11481,8118,-3363
2018,7,22,8,10640,11440,8211,-3229
2018,7,22,9,10690,11658,8452,-3206
2018,7,22,10,10930,11611,8719,-2892
2018,7,22,11,11180,11902,8906,-2996
2018,7,22,12,11990,12208,8947,-3261
2018,7,22,13,13080,12870,9990,-2880
2018,7,22,14,13740,13696,11639,-2057
2018,7,22,15,14410,14385,12519,-1866
2018,7,22,16,14800,14835,12907,-1928
2018,7,22,17,15300,15221,13552,-1669
2018,7,22,18,15380,15428,13774,-1654
2018,7,22,19,15660,15597,13674,-1923
2018,7,22,20,15970,15978,13931,-2047
2018,7,22,21,16290,16556,14816,-1740
2018,7,22,22,16820,17083,15435,-1648
2018,7,22,23,17000,17203,15340,-1863
2018,7,23,0,16760,17038,15075,-1963
2018,7,23,1,16700,16993,14879,-2114
2018,7,23,2,16240,16500,14490,-2010
2018,7,23,3,15010,15458,13254,-2204
2018,7,23,4,13800,14301,12080,-2221
2018,7,23,5,13400,13681,11102,-2579
2018,7,23,6,12920,13795,10863,-2932
2018,7,23,7,12670,13749,10599,-3150
2018,7,23,8,12620,13860,10772,-3088
2018,7,23,9,12910,14218,11015,-3203
2018,7,23,10,13740,14524,11696,-2828
2018,7,23,11,15080,15371,12840,-2531
2018,7,23,12,16470,16435,14000,-2435
2018,7,23,13,17390,17381,15260,-2121
2018,7,23,14,18110,18066,15803,-2263
2018,7,23,15,18720,18560,16378,-2182
2018,7,23,16,19170,18992,16539,-2453
2018,7,23,17,19420,19390,16886,-2504
2018,7,23,18,19630,19855,17347,-2508
2018,7,23,19,19990,20188,17742,-2446
2018,7,23,20,20250,20449,18056,-2393
2018,7,23,21,20360,20796,18458,-2338
2018,7,23,22,20700,21109,18445,-2664
2018,7,23,23,20100,20975,17874,-3101
2018,7,24,0,19580,20431,17257,-3174
2018,7,24,1,19420,20002,17078,-2924
2018,7,24,2,18500,19096,16175,-2921
2018,7,24,3,16860,17496,14609,-2887
2018,7,24,4,15320,15888,13182,-2706
2018,7,24,5,14780,15257,12587,-2670
2018,7,24,6,14060,15092,12068,-3024
2018,7,24,7,13630,14974,11881,-3093
2018,7,24,8,13460,15013,11819,-3194
2018,7,24,9,13620,15170,12154,-3016
2018,7,24,10,14230,15171,12250,-2921
2018,7,24,11,15650,15904,13333,-2571
2018,7,24,12,17000,16934,14278,-2656
2018,7,24,13,17860,17789,15367,-2422
2018,7,24,14,18340,18516,16166,-2350
2018,7,24,15,18980,19270,16720,-2550
2018,7,24,16,19650,19944,17479,-2465
2018,7,24,17,20230,20405,17938,-2467
2018,7,24,18,20560,20960,18549,-2411
2018,7,24,19,20830,21360,19131,-2229
2018,7,24,20,21310,21611,19640,-1971
2018,7,24,21,21580,21892,19935,-1957
2018,7,24,22,21750,22102,19874,-2228
2018,7,24,23,21240,21833,19079,-2754
2018,7,25,0,20510,21204,18042,-3162
2018,7,25,1,20270,20745,17682,-3063
2018,7,25,2,19180,19844,16938,-2906
2018,7,25,3,17480,18180,15501,-2679
2018,7,25,4,15860,16531,14000,-2531
2018,7,25,5,15280,15995,13247,-2748
2018,7,25,6,14530,15976,13486,-2490
2018,7,25,7,13930,15530,12950,-2580
2018,7,25,8,13860,15497,12945,-2552
2018,7,25,9,14070,15379,12776,-2603
2018,7,25,10,14850,15404,12981,-2423
2018,7,25,11,16140,16065,13834,-2231
2018,7,25,12,17520,17359,15000,-2359
2018,7,25,13,18320,18213,15685,-2528
2018,7,25,14,19020,18932,16229,-2703
2018,7,25,15,19470,19599,16679,-2920
2018,7,25,16,20120,20032,17161,-2871
2018,7,25,17,20150,20332,17409,-2923
2018,7,25,18,20220,20631,17636,-2995
2018,7,25,19,20200,20575,17675,-2900
2018,7,25,20,20310,20433,17574,-2859
2018,7,25,21,20350,20394,17979,-2415
2018,7,25,22,20330,20316,17899,-2417
2018,7,25,23,19840,20084,17333,-2751
2018,7,26,0,19490,19752,17176,-2576
2018,7,26,1,19380,19565,16963,-2602
2018,7,26,2,18550,18727,16215,-2512
2018,7,26,3,17030,17229,14832,-2397
2018,7,26,4,15490,15719,13570,-2149
2018,7,26,5,14560,15249,12372,-2877
2018,7,26,6,13880,15161,11965,-3196
2018,7,26,7,13440,14822,11473,-3349
2018,7,26,8,13250,14836,11411,-3425
2018,7,26,9,13430,14988,11544,-3444
2018,7,26,10,14180,15236,12065,-3171
2018,7,26,11,15400,15923,13224,-2699
2018,7,26,12,16630,16653,14208,-2445
2018,7,26,13,17460,17441,15193,-2248
2018,7,26,14,18100,18077,15764,-2313
2018,7,26,15,18660,18591,16196,-2395
2018,7,26,16,19360,19151,16903,-2248
2018,7,26,17,19800,19592,17416,-2176
2018,7,26,18,20050,20062,17788,-2274
2018,7,26,19,20470,20231,18115,-2116
2018,7,26,20,20860,20339,18596,-1743
2018,7,26,21,20910,20185,18473,-1712
2018,7,26,22,21050,20151,18397,-1754
2018,7,26,23,20670,20172,18251,-1921
2018,7,27,0,20170,19728,17549,-2179
2018,7,27,1,19830,19330,17323,-2007
2018,7,27,2,19010,18555,16703,-1852
2018,7,27,3,17330,17005,14945,-2060
2018,7,27,4,15720,15616,13244,-2372
2018,7,27,5,14150,14930,12338,-2592
2018,7,27,6,13370,14667,11867,-2800
2018,7,27,7,12850,14206,11126,-3080
2018,7,27,8,12590,14035,10897,-3138
2018,7,27,9,12700,14171,11339,-2832
2018,7,27,10,13340,14179,11655,-2524
2018,7,27,11,14540,14688,12382,-2306
2018,7,27,12,15890,15879,13592,-2287
2018,7,27,13,16920,16905,14774,-2131
2018,7,27,14,17780,17845,15837,-2008
2018,7,27,15,18690,18836,16865,-1971
2018,7,27,16,19570,19793,17706,-2087
2018,7,27,17,20270,20420,18121,-2299
2018,7,27,18,20910,21019,18717,-2302
2018,7,27,19,21190,21510,19216,-2294
2018,7,27,20,21450,21779,19508,-2271
2018,7,27,21,21520,21835,19677,-2158
2018,7,27,22,21490,21689,19560,-2129
2018,7,27,23,20860,21113,18574,-2539
2018,7,28,0,20220,20365,17337,-3028
2018,7,28,1,19690,19860,16852,-3008
2018,7,28,2,19090,18841,15874,-2967
2018,7,28,3,17460,17317,14695,-2622
2018,7,28,4,15710,15893,13305,-2588
2018,7,28,5,14510,14796,11705,-3091
2018,7,28,6,13690,14221,11303,-2918
2018,7,28,7,13180,14001,10903,-3098
2018,7,28,8,12860,13670,10446,-3224
2018,7,28,9,12750,13553,10367,-3186
2018,7,28,10,12850,13645,10499,-3146
2018,7,28,11,13240,14007,10806,-3201
2018,7,28,12,14150,14642,11853,-2789
2018,7,28,13,15220,15251,12666,-2585
2018,7,28,14,16190,16181,13680,-2501
2018,7,28,15,17010,17008,14352,-2656
2018,7,28,16,17780,17777,15018,-2759
2018,7,28,17,18220,18377,15729,-2648
2018,7,28,18,18530,18847,16022,-2825
2018,7,28,19,18730,19268,16278,-2990
2018,7,28,20,18930,19661,16551,-3110
2018,7,28,21,19050,19983,17187,-2796
2018,7,28,22,19220,19930,16985,-2945
2018,7,28,23,19020,19440,16483,-2957
2018,7,29,0,18360,18770,15817,-2953
2018,7,29,1,18030,18451,15663,-2788
2018,7,29,2,17390,17710,15165,-2545
2018,7,29,3,16220,16483,13869,-2614
2018,7,29,4,14850,15178,12328,-2850
2018,7,29,5,14050,14079,11070,-3009
2018,7,29,6,13230,13525,10656,-2869
2018,7,29,7,12640,13154,10316,-2838
2018,7,29,8,12240,12962,10130,-2832
2018,7,29,9,11980,12926,10020,-2906
2018,7,29,10,11860,12922,9913,-3009
2018,7,29,11,11980,13072,10056,-3016
2018,7,29,12,12640,13899,10941,-2958
2018,7,29,13,13420,14209,11669,-2540
2018,7,29,14,14090,14612,12323,-2289
2018,7,29,15,14690,14901,12867,-2034
2018,7,29,16,15310,15138,13136,-2002
2018,7,29,17,15940,15624,13591,-2033
2018,7,29,18,16410,15929,13880,-2049
2018,7,29,19,16940,16207,13907,-2300
2018,7,29,20,17400,16629,14368,-2261
2018,7,29,21,17950,17188,15108,-2080
2018,7,29,22,18340,17784,15746,-2038
2018,7,29,23,18360,17992,15826,-2166
2018,7,30,0,17900,17646,15243,-2403
2018,7,30,1,17420,17333,14835,-2498
2018,7,30,2,16740,16624,14349,-2275
2018,7,30,3,15430,15208,12586,-2622
2018,7,30,4,14050,13810,11045,-2765
2018,7,30,5,12700,13149,10540,-2609
2018,7,30,6,11990,12999,10327,-2672
2018,7,30,7,11570,12668,10055,-2613
2018,7,30,8,11350,12595,10282,-2313
2018,7,30,9,11500,12661,10363,-2298
2018,7,30,10,12140,12889,10459,-2430
2018,7,30,11,13180,13671,11127,-2544
2018,7,30,12,14420,14456,11853,-2603
2018,7,30,13,15180,15318,12461,-2857
2018,7,30,14,15780,15741,12999,-2742
2018,7,30,15,16470,16407,14116,-2291
2018,7,30,16,17060,17009,14941,-2068
2018,7,30,17,17720,17596,15481,-2115
2018,7,30,18,18290,18060,15445,-2615
2018,7,30,19,18750,18371,15670,-2701
2018,7,30,20,19020,18426,16096,-2330
2018,7,30,21,19430,18486,16303,-2183
2018,7,30,22,19640,18594,16315,-2279
2018,7,30,23,19520,18442,16053,-2389
2018,7,31,0,18970,18182,15879,-2303
2018,7,31,1,18470,18026,15722,-2304
2018,7,31,2,17500,17161,14920,-2241
2018,7,31,3,15980,15641,13321,-2320
2018,7,31,4,14360,14094,11843,-2251
2018,7,31,5,13060,13076,10436,-2640
2018,7,31,6,12340,12869,10072,-2797
2018,7,31,7,11920,12801,10144,-2657
2018,7,31,8,11700,12716,9828,-2888
2018,7,31,9,11860,12834,9927,-2907
2018,7,31,10,12490,13144,10663,-2481
2018,7,31,11,13710,13691,11448,-2243
2018,7,31,12,14960,14806,12735,-2071
2018,7,31,13,15800,15626,13962,-1664
2018,7,31,14,16250,16228,14618,-1610
2018,7,31,15,16970,16849,15043,-1806
2018,7,31,16,17790,17522,16054,-1468
2018,7,31,17,18240,18082,16468,-1614
2018,7,31,18,18730,18751,16929,-1822
2018,7,31,19,19230,19254,17218,-2036
2018,7,31,20,19380,19826,17459,-2367
2018,7,31,21,19630,20394,18005,-2389
2018,7,31,22,19760,20759,18297,-2462
2018,7,31,23,19560,20609,17578,-3031
2018,8,1,0,19050,19985,16722,-3263
2018,8,1,1,18690,19572,16616,-2956
2018,8,1,2,17800,18540,16118,-2422
2018,8,1,3,16210,16799,14281,-2518
2018,8,1,4,14690,15097,12861,-2236
2018,8,1,5,13550,14134,11502,-2632
2018,8,1,6,12740,13925,11173,-2752
2018,8,1,7,12350,13646,11292,-2354
2018,8,1,8,12110,13367,10826,-2541
2018,8,1,9,12280,13465,10853,-2612
2018,8,1,10,12950,13756,11302,-2454
2018,8,1,11,14180,14621,12370,-2251
2018,8,1,12,15510,15536,13518,-2018
2018,8,1,13,16430,16307,14460,-1847
2018,8,1,14,17050,17008,14998,-2010
2018,8,1,15,17650,17749,15837,-1912
2018,8,1,16,18180,18260,16218,-2042
2018,8,1,17,18700,18636,16466,-2170
2018,8,1,18,19110,19030,17002,-2028
2018,8,1,19,19500,19306,17462,-1844
2018,8,1,20,19900,19584,17789,-1795
2018,8,1,21,20210,19895,18303,-1592
2018,8,1,22,20500,20174,18417,-1757
2018,8,1,23,20240,20162,17831,-2331
2018,8,2,0,20030,19899,17380,-2519
2018,8,2,1,20000,19740,17318,-2422
2018,8,2,2,19280,18982,16690,-2292
2018,8,2,3,17800,17528,15484,-2044
2018,8,2,4,16240,16041,14211,-1830
2018,8,2,5,14920,15264,12993,-2271
2018,8,2,6,14230,15253,12614,-2639
2018,8,2,7,13880,15221,12666,-2555
2018,8,2,8,13390,15043,12548,-2495
2018,8,2,9,13950,15249,12539,-2710
2018,8,2,10,14790,16025,13493,-2532
2018,8,2,11,16740,16605,14171,-2434
2018,8,2,12,17390,17620,15324,-2296
2018,8,2,13,18760,18660,16265,-2395
2018,8,2,14,19290,19475,17126,-2349
2018,8,2,15,20170,20352,17916,-2436
2018,8,2,16,20980,21115,18609,-2506
2018,8,2,17,21580,21787,19137,-2650
2018,8,2,18,22170,22580,19725,-2855
2018,8,2,19,22740,23115,19863,-3252
2018,8,2,20,23040,23401,20206,-3195
2018,8,2,21,23400,23639,20418,-3221
2018,8,2,22,23300,23605,20499,-3106
2018,8,2,23,22840,23061,19781,-3280
2018,8,3,0,22350,22253,18719,-3534
2018,8,3,1,22020,21689,18202,-3487
2018,8,3,2,20920,20592,17263,-3329
2018,8,3,3,19000,18886,15847,-3039
2018,8,3,4,17320,17227,14568,-2659
2018,8,3,5,15930,16731,13943,-2788
2018,8,3,6,15110,16559,13619,-2940
2018,8,3,7,14580,16264,13287,-2977
2018,8,3,8,14240,15966,12950,-3016
2018,8,3,9,14490,16043,13007,-3036
2018,8,3,10,15180,16607,13581,-3026
2018,8,3,11,16250,16950,14108,-2842
2018,8,3,12,17640,17818,15159,-2659
2018,8,3,13,18630,18895,15994,-2901
2018,8,3,14,19800,19779,16743,-3036
2018,8,3,15,20600,20537,17104,-3433
2018,8,3,16,21290,21116,17436,-3680
2018,8,3,17,21730,21650,18064,-3586
2018,8,3,18,22040,22157,18740,-3417
2018,8,3,19,22310,22329,19158,-3171
2018,8,3,20,22600,22503,19247,-3256
2018,8,3,21,22520,22740,19561,-3179
2018,8,3,22,22410,22556,19426,-3130
2018,8,3,23,21700,21915,18525,-3390
2018,8,4,0,21060,21066,17507,-3559
2018,8,4,1,20600,20506,16930,-3576
2018,8,4,2,19600,19510,16254,-3256
2018,8,4,3,18070,18083,15036,-3047
2018,8,4,4,16560,16871,14248,-2623
2018,8,4,5,15790,15978,13056,-2922
2018,8,4,6,14550,15476,12448,-3028
2018,8,4,7,13960,15269,12125,-3144
2018,8,4,8,13700,15092,12003,-3089
2018,8,4,9,13680,15227,12124,-3103
2018,8,4,10,14030,15179,12184,-2995
2018,8,4,11,13970,15326,12505,-2821
2018,8,4,12,15010,15656,13285,-2371
2018,8,4,13,15950,16522,14001,-2521
2018,8,4,14,16950,17443,14734,-2709
2018,8,4,15,17190,17957,14849,-3108
2018,8,4,16,17760,17799,14567,-3232
2018,8,4,17,17450,17526,14255,-3271
2018,8,4,18,17350,17278,14380,-2898
2018,8,4,19,17610,17120,14746,-2374
2018,8,4,20,17940,17327,15264,-2063
2018,8,4,21,18050,17762,15545,-2217
2018,8,4,22,18120,18240,16116,-2124
2018,8,4,23,18100,18288,15946,-2342
2018,8,5,0,17390,17988,15520,-2468
2018,8,5,1,17680,17772,15131,-2641
2018,8,5,2,17080,17117,14891,-2226
2018,8,5,3,15890,15951,13693,-2258
2018,8,5,4,14600,14815,12236,-2579
2018,8,5,5,14160,14276,11223,-3053
2018,8,5,6,13300,13876,10871,-3005
2018,8,5,7,12800,13613,10643,-2970
2018,8,5,8,12180,13575,10454,-3121
2018,8,5,9,12290,13439,10325,-3114
2018,8,5,10,12100,13311,10589,-2722
2018,8,5,11,12120,13089,10794,-2295
2018,8,5,12,12730,13578,11206,-2372
2018,8,5,13,13770,13969,11863,-2106
2018,8,5,14,14950,14886,12880,-2006
2018,8,5,15,15830,15932,14240,-1692
2018,8,5,16,16890,16921,15307,-1614
2018,8,5,17,17810,17831,16021,-1810
2018,8,5,18,18950,18524,16401,-2123
2018,8,5,19,19660,19134,16733,-2401
2018,8,5,20,20440,19762,17341,-2421
2018,8,5,21,21080,20497,18314,-2183
2018,8,5,22,21600,21121,18736,-2385
2018,8,5,23,21470,21235,18356,-2879
2018,8,6,0,20770,20761,17538,-3223
2018,8,6,1,20260,20431,17154,-3277
2018,8,6,2,19410,19487,16207,-3280
2018,8,6,3,17840,17887,14772,-3115
2018,8,6,4,16150,16555,13454,-3101
2018,8,6,5,15040,15895,12675,-3220
2018,8,6,6,14200,15785,12382,-3403
2018,8,6,7,13630,15234,11969,-3265
2018,8,6,8,13330,14900,11822,-3078
2018,8,6,9,13410,14968,11970,-2998
2018,8,6,10,14030,15118,11981,-3137
2018,8,6,11,15200,15432,12377,-3055
2018,8,6,12,16650,16626,13592,-3034
2018,8,6,13,17850,17823,15185,-2638
2018,8,6,14,18960,18895,16488,-2407
2018,8,6,15,20270,20047,17819,-2228
2018,8,6,16,21190,21122,18385,-2737
2018,8,6,17,22360,21947,19037,-2910
2018,8,6,18,23140,22816,19691,-3125
2018,8,6,19,23790,23303,20369,-2934
2018,8,6,20,24130,23788,20885,-2903
2018,8,6,21,24480,24300,21128,-3172
2018,8,6,22,24650,24685,21409,-3276
2018,8,6,23,24180,24555,21306,-3249
2018,8,7,0,23610,23983,20892,-3091
2018,8,7,1,23070,23435,20266,-3169
2018,8,7,2,21830,22061,18839,-3222
2018,8,7,3,19890,20328,17072,-3256
2018,8,7,4,17950,18660,15776,-2884
2018,8,7,5,16690,17531,14291,-3240
2018,8,7,6,15770,17026,13538,-3488
2018,8,7,7,15150,16732,13580,-3152
2018,8,7,8,14790,16382,13343,-3039
2018,8,7,9,14830,16379,13330,-3049
2018,8,7,10,15460,16745,13794,-2951
2018,8,7,11,16690,17599,14636,-2963
2018,8,7,12,18160,18654,15660,-2994
2018,8,7,13,19290,19322,16513,-2809
2018,8,7,14,20370,20320,17409,-2911
2018,8,7,15,21530,21463,18258,-3205
2018,8,7,16,22520,22486,19117,-3369
2018,8,7,17,23030,23244,19711,-3533
2018,8,7,18,23800,23873,20452,-3421
2018,8,7,19,24240,24236,20783,-3453
2018,8,7,20,24530,24335,21011,-3324
2018,8,7,21,25000,24334,21013,-3321
2018,8,7,22,24870,24202,20807,-3395
2018,8,7,23,24230,23730,20284,-3446
2018,8,8,0,23360,23111,19526,-3585
2018,8,8,1,22910,22470,18994,-3476
2018,8,8,2,21760,21152,17555,-3597
2018,8,8,3,19760,19379,15727,-3652
2018,8,8,4,17930,17998,14685,-3313
2018,8,8,5,16290,17412,13597,-3815
2018,8,8,6,15430,16960,12994,-3966
2018,8,8,7,14870,16462,12734,-3728
2018,8,8,8,14520,16109,12298,-3811
2018,8,8,9,14550,16122,12256,-3866
2018,8,8,10,15210,16750,13283,-3467
2018,8,8,11,16390,17091,13775,-3316
2018,8,8,12,17790,17983,14737,-3246
2018,8,8,13,18770,18735,15254,-3481
2018,8,8,14,19580,19547,16407,-3140
2018,8,8,15,20530,20365,17160,-3205
2018,8,8,16,21460,21220,17847,-3373
2018,8,8,17,22060,21973,18390,-3583
2018,8,8,18,22600,22648,19239,-3409
2018,8,8,19,22910,23014,19639,-3375
2018,8,8,20,23160,23266,20046,-3220
2018,8,8,21,23300,23514,20579,-2935
2018,8,8,22,23110,23591,20546,-3045
2018,8,8,23,22660,23056,20037,-3019
2018,8,9,0,21940,22306,19172,-3134
2018,8,9,1,21680,21762,18646,-3116
2018,8,9,2,20570,20552,17520,-3032
2018,8,9,3,18740,18844,15831,-3013
2018,8,9,4,16990,17464,14850,-2614
2018,8,9,5,16170,16546,13568,-2978
2018,8,9,6,15190,16096,12747,-3349
2018,8,9,7,14570,15951,12323,-3628
2018,8,9,8,14230,15764,12144,-3620
2018,8,9,9,14400,15848,12357,-3491
2018,8,9,10,15090,16324,12892,-3432
2018,8,9,11,16280,16863,13856,-3007
2018,8,9,12,17560,17685,14542,-3143
2018,8,9,13,18360,18412,15054,-3358
2018,8,9,14,18920,18940,15573,-3367
2018,8,9,15,19690,19650,16270,-3380
2018,8,9,16,20540,20243,16798,-3445
2018,8,9,17,21090,20826,17496,-3330
2018,8,9,18,21690,21480,18074,-3406
2018,8,9,19,22230,21921,18503,-3418
2018,8,9,20,22620,22235,19065,-3170
2018,8,9,21,22890,22774,19683,-3091
2018,8,9,22,22930,23046,19998,-3048
2018,8,9,23,22430,22714,19757,-2957
2018,8,10,0,21510,21839,18683,-3156
2018,8,10,1,21150,21159,17780,-3379
2018,8,10,2,19860,19862,16462,-3400
2018,8,10,3,18050,17982,14625,-3357
2018,8,10,4,16130,16159,13260,-2899
2018,8,10,5,14900,15314,11980,-3334
2018,8,10,6,14060,14927,11460,-3467
2018,8,10,7,13440,14296,11132,-3164
2018,8,10,8,12960,14149,10871,-3278
2018,8,10,9,13160,14235,10868,-3367
2018,8,10,10,13690,14303,11048,-3255
2018,8,10,11,14650,14688,11837,-2851
2018,8,10,12,15980,15633,12647,-2986
2018,8,10,13,16500,16555,13942,-2613
2018,8,10,14,17220,17242,14811,-2431
2018,8,10,15,18200,17929,16943,-986
2018,8,10,16,19010,18576,17311,-1265
2018,8,10,17,19620,19211,17183,-2028
2018,8,10,18,20270,19931,17831,-2100
2018,8,10,19,20810,20405,18349,-2056
2018,8,10,20,21150,20729,17977,-2752
2018,8,10,21,21410,20953,18286,-2667
2018,8,10,22,21240,20896,17980,-2916
2018,8,10,23,20530,20368,17342,-3026
2018,8,11,0,19670,19675,16635,-3040
2018,8,11,1,19370,19269,16547,-2722
2018,8,11,2,18510,18231,15548,-2683
2018,8,11,3,17070,16796,14162,-2634
2018,8,11,4,15460,15327,13202,-2125
2018,8,11,5,14070,14188,12046,-2142
2018,8,11,6,13280,13657,11211,-2446
2018,8,11,7,12770,13118,10692,-2426
2018,8,11,8,12410,12776,10303,-2473
2018,8,11,9,12300,12665,10269,-2396
2018,8,11,10,12340,12819,10488,-2331
2018,8,11,11,12570,13181,10959,-2222
2018,8,11,12,13290,13759,11486,-2273
2018,8,11,13,14190,14418,11925,-2493
2018,8,11,14,15100,15103,12477,-2626
2018,8,11,15,15390,15498,12876,-2622
2018,8,11,16,15370,15679,12930,-2749
2018,8,11,17,15350,15673,12882,-2791
2018,8,11,18,15190,15553,13187,-2366
2018,8,11,19,15160,15437,12959,-2478
2018,8,11,20,15250,15415,12997,-2418
2018,8,11,21,15250,15754,13379,-2375
2018,8,11,22,15360,15769,13450,-2319
2018,8,11,23,15400,15691,13636,-2055
2018,8,12,0,15190,15682,13876,-1806
2018,8,12,1,15440,15703,13511,-2192
2018,8,12,2,15030,15185,12728,-2457
2018,8,12,3,14270,14319,12112,-2207
2018,8,12,4,13330,13592,11370,-2222
2018,8,12,5,12820,13247,10713,-2534
2018,8,12,6,12150,12787,10168,-2619
2018,8,12,7,11800,12421,9876,-2545
2018,8,12,8,11580,12479,9995,-2484
2018,8,12,9,11470,12448,9905,-2543
2018,8,12,10,11630,12591,10021,-2570
2018,8,12,11,11720,12882,10307,-2575
2018,8,12,12,12340,13362,10758,-2604
2018,8,12,13,13300,13903,11557,-2346
2018,8,12,14,14170,14415,12430,-1985
2018,8,12,15,14810,14868,12838,-2030
2018,8,12,16,15270,15340,13253,-2087
2018,8,12,17,15900,15685,13771,-1914
2018,8,12,18,15990,15960,13971,-1989
2018,8,12,19,16230,16136,14198,-1938
2018,8,12,20,16490,16352,14534,-1818
2018,8,12,21,16810,16607,15144,-1463
2018,8,12,22,17020,16886,15479,-1407
2018,8,12,23,17190,16854,15358,-1496
2018,8,13,0,17000,16704,15053,-1651
2018,8,13,1,16990,16584,14896,-1688
2018,8,13,2,16260,15832,13814,-2018
2018,8,13,3,15010,14684,12602,-2082
2018,8,13,4,13820,13724,11707,-2017
2018,8,13,5,12740,13740,11439,-2301
2018,8,13,6,12210,13483,10844,-2639
2018,8,13,7,11880,13328,10695,-2633
2018,8,13,8,11800,13281,10697,-2584
2018,8,13,9,12050,13269,10868,-2401
2018,8,13,10,12850,14017,11501,-2516
2018,8,13,11,14110,14293,12313,-1980
2018,8,13,12,15290,15036,13127,-1909
2018,8,13,13,16010,15845,14162,-1683
2018,8,13,14,16330,16340,14975,-1365
2018,8,13,15,16770,16731,15408,-1323
2018,8,13,16,17030,16944,15646,-1298
2018,8,13,17,17410,17091,15779,-1312
2018,8,13,18,17640,17233,16014,-1219
2018,8,13,19,17710,17186,16180,-1006
2018,8,13,20,17300,17108,16007,-1101
2018,8,13,21,17570,17138,16108,-1030
2018,8,13,22,17900,17252,16096,-1156
2018,8,13,23,17860,17187,15679,-1508
2018,8,14,0,17670,17089,15496,-1593
2018,8,14,1,17590,16927,15535,-1392
2018,8,14,2,16790,16112,14736,-1376
2018,8,14,3,15450,14912,13322,-1590
2018,8,14,4,14150,13725,12359,-1366
2018,8,14,5,12870,13058,10988,-2070
2018,8,14,6,12320,13018,10576,-2442
2018,8,14,7,12000,12950,10371,-2579
2018,8,14,8,11870,12917,10377,-2540
2018,8,14,9,12110,13135,10476,-2659
2018,8,14,10,12990,13707,11110,-2597
2018,8,14,11,14340,14472,12068,-2404
2018,8,14,12,15680,15489,13044,-2445
2018,8,14,13,16370,16391,14102,-2289
2018,8,14,14,16990,17064,15001,-2063
2018,8,14,15,17610,17649,15386,-2263
2018,8,14,16,18250,18241,15942,-2299
2018,8,14,17,18800,18752,16491,-2261
2018,8,14,18,19310,19257,16950,-2307
2018,8,14,19,19650,19549,17128,-2421
2018,8,14,20,20000,19774,17402,-2372
2018,8,14,21,20200,20054,17732,-2322
2018,8,14,22,20400,20227,17744,-2483
2018,8,14,23,19990,19911,17276,-2635
2018,8,15,0,19500,19352,16844,-2508
2018,8,15,1,19220,19013,16399,-2614
2018,8,15,2,18150,17895,15171,-2724
2018,8,15,3,16480,16370,13571,-2799
2018,8,15,4,14970,15077,12404,-2673
2018,8,15,5,13710,14353,11392,-2961
2018,8,15,6,13000,13847,10807,-3040
2018,8,15,7,12550,13905,10847,-3058
2018,8,15,8,12410,13942,10823,-3119
2018,8,15,9,12510,13999,10880,-3119
2018,8,15,10,13260,14061,10969,-3092
2018,8,15,11,14540,14902,11920,-2982
2018,8,15,12,15840,15682,12783,-2899
2018,8,15,13,16570,16490,13911,-2579
2018,8,15,14,17140,16990,14820,-2170
2018,8,15,15,17890,17469,15384,-2085
2018,8,15,16,18510,18060,15948,-2112
2018,8,15,17,19470,18757,16580,-2177
2018,8,15,18,20100,19596,17786,-1810
2018,8,15,19,20710,20351,18732,-1619
2018,8,15,20,21260,20973,19445,-1528
2018,8,15,21,21760,21537,19721,-1816
2018,8,15,22,22000,21921,19807,-2114
2018,8,15,23,21730,21684,19239,-2445
2018,8,16,0,21070,21102,18530,-2572
2018,8,16,1,20720,20745,18066,-2679
2018,8,16,2,19550,19537,17046,-2491
2018,8,16,3,17880,17771,15392,-2379
2018,8,16,4,16160,16336,14192,-2144
2018,8,16,5,14820,15558,13132,-2426
2018,8,16,6,14000,15027,12161,-2866
2018,8,16,7,13450,14964,11972,-2992
2018,8,16,8,13170,14752,11777,-2975
2018,8,16,9,13250,14543,11543,-3000
2018,8,16,10,13920,14973,12148,-2825
2018,8,16,11,15030,15286,12965,-2321
2018,8,16,12,16340,16315,14012,-2303
2018,8,16,13,17350,17336,15328,-2008
2018,8,16,14,18210,18188,16391,-1797
2018,8,16,15,19240,19029,17022,-2007
2018,8,16,16,20160,19843,17654,-2189
2018,8,16,17,20880,20522,18337,-2185
2018,8,16,18,21550,21209,18842,-2367
2018,8,16,19,22160,21665,19231,-2434
2018,8,16,20,22660,22089,19670,-2419
2018,8,16,21,23240,22481,20163,-2318
2018,8,16,22,23400,22595,20105,-2490
2018,8,16,23,22790,22167,19516,-2651
2018,8,17,0,22310,21443,18897,-2546
2018,8,17,1,21660,20950,18370,-2580
2018,8,17,2,20310,19655,17146,-2509
2018,8,17,3,18420,18135,15417,-2718
2018,8,17,4,16600,16531,14285,-2246
2018,8,17,5,14800,15567,13043,-2524
2018,8,17,6,13890,15165,12385,-2780
2018,8,17,7,13300,14886,12017,-2869
2018,8,17,8,12920,14521,11549,-2972
2018,8,17,9,12920,14224,11263,-2961
2018,8,17,10,13490,14506,11637,-2869
2018,8,17,11,14450,14969,12244,-2725
2018,8,17,12,15610,15610,13239,-2371
2018,8,17,13,16520,16488,14447,-2041
2018,8,17,14,17310,17289,15409,-1880
2018,8,17,15,18230,18112,16129,-1983
2018,8,17,16,19090,18931,16727,-2204
2018,8,17,17,19650,19698,17223,-2475
2018,8,17,18,20100,20537,18131,-2406
2018,8,17,19,20490,21044,18677,-2367
2018,8,17,20,20900,21186,18687,-2499
2018,8,17,21,21200,21192,18818,-2374
2018,8,17,22,20990,21129,18559,-2570
2018,8,17,23,20390,20575,17897,-2678
2018,8,18,0,19890,20110,17228,-2882
2018,8,18,1,19730,19784,16895,-2889
2018,8,18,2,18840,18846,16145,-2701
2018,8,18,3,17440,17543,14652,-2891
2018,8,18,4,15980,16106,13383,-2723
2018,8,18,5,14970,14996,12593,-2403
2018,8,18,6,14160,14232,11836,-2396
2018,8,18,7,13640,13912,11659,-2253
2018,8,18,8,13330,13852,11566,-2286
2018,8,18,9,13220,13981,11628,-2353
2018,8,18,10,13400,14071,11766,-2305
2018,8,18,11,13830,14338,12093,-2245
2018,8,18,12,14630,14656,12777,-1879
2018,8,18,13,15600,15581,13580,-2001
2018,8,18,14,16430,16389,14500,-1889
2018,8,18,15,17170,17078,15040,-2038
2018,8,18,16,17750,17670,15719,-1951
2018,8,18,17,18110,18199,16053,-2146
2018,8,18,18,18230,18648,16281,-2367
2018,8,18,19,18310,18855,16541,-2314
2018,8,18,20,18450,18871,16358,-2513
2018,8,18,21,18320,18346,15963,-2383
2018,8,18,22,18240,17852,15482,-2370
2018,8,18,23,18110,17532,15501,-2031
2018,8,19,0,17770,17262,15359,-1903
2018,8,19,1,17370,17029,15176,-1853
2018,8,19,2,16370,16137,14362,-1775
2018,8,19,3,15160,14926,13105,-1821
2018,8,19,4,14010,13675,11829,-1846
2018,8,19,5,12690,12709,10614,-2095
2018,8,19,6,12000,12277,10126,-2151
2018,8,19,7,11510,12057,9872,-2185
2018,8,19,8,11250,12041,9916,-2125
2018,8,19,9,11100,12159,9770,-2389
2018,8,19,10,11170,12214,9796,-2418
2018,8,19,11,11330,12351,9970,-2381
2018,8,19,12,11770,12541,10302,-2239
2018,8,19,13,12370,12866,10695,-2171
2018,8,19,14,12800,12850,10915,-1935
2018,8,19,15,13070,13069,11206,-1863
2018,8,19,16,13240,13242,11183,-2059
2018,8,19,17,13410,13408,11462,-1946
2018,8,19,18,13780,13574,11576,-1998
2018,8,19,19,13900,13797,11978,-1819
2018,8,19,20,14200,14108,12244,-1864
2018,8,19,21,14470,14546,12743,-1803
2018,8,19,22,14900,14971,12881,-2090
2018,8,19,23,15030,15052,12905,-2147
2018,8,20,0,14910,15054,13118,-1936
2018,8,20,1,14780,15093,13258,-1835
2018,8,20,2,14170,14373,12359,-2014
2018,8,20,3,13140,13285,11553,-1732
2018,8,20,4,12080,12239,10417,-1822
2018,8,20,5,11440,11593,9197,-2396
2018,8,20,6,10960,11679,9378,-2301
2018,8,20,7,10720,11510,9256,-2254
2018,8,20,8,10670,11682,9319,-2363
2018,8,20,9,10930,11704,9462,-2242
2018,8,20,10,11710,11973,9847,-2126
2018,8,20,11,12860,13116,10884,-2232
2018,8,20,12,13940,13944,12138,-1806
2018,8,20,13,14540,14527,13054,-1473
2018,8,20,14,14900,14910,13606,-1304
2018,8,20,15,15310,15198,13961,-1237
2018,8,20,16,15730,15428,14153,-1275
2018,8,20,17,15870,15672,14431,-1241
2018,8,20,18,16230,16017,15031,-986
2018,8,20,19,16320,16268,15442,-826
2018,8,20,20,16560,16398,15218,-1180
2018,8,20,21,16900,16513,15186,-1327
2018,8,20,22,17100,16768,15248,-1520
2018,8,20,23,16890,16698,15228,-1470
2018,8,21,0,16700,16466,15026,-1440
2018,8,21,1,16540,16333,15047,-1286
2018,8,21,2,15480,15319,14156,-1163
2018,8,21,3,14050,13924,11950,-1974
2018,8,21,4,12750,12610,10717,-1893
2018,8,21,5,11690,11712,9554,-2158
2018,8,21,6,11130,11502,9161,-2341
2018,8,21,7,10790,11319,8807,-2512
2018,8,21,8,10640,11169,8674,-2495
2018,8,21,9,10830,11352,8807,-2545
2018,8,21,10,11550,11587,9233,-2354
2018,8,21,11,12690,12673,10540,-2133
2018,8,21,12,13710,13690,11523,-2167
2018,8,21,13,14330,14312,12528,-1784
2018,8,21,14,14690,14672,12979,-1693
2018,8,21,15,15020,15008,13672,-1336
2018,8,21,16,15430,15285,13668,-1617
2018,8,21,17,15730,15462,13757,-1705
2018,8,21,18,15970,15721,14169,-1552
2018,8,21,19,16150,15917,14251,-1666
2018,8,21,20,16350,16062,14593,-1469
2018,8,21,21,16700,16366,14735,-1631
2018,8,21,22,17020,16573,14824,-1749
2018,8,21,23,16870,16440,14459,-1981
2018,8,22,0,16680,16383,14496,-1887
2018,8,22,1,16680,16285,14472,-1813
2018,8,22,2,15670,15377,13812,-1565
2018,8,22,3,14290,14117,12135,-1982
2018,8,22,4,13030,13161,11132,-2029
2018,8,22,5,12030,12583,10229,-2354
2018,8,22,6,11490,12290,9977,-2313
2018,8,22,7,11200,12327,10008,-2319
2018,8,22,8,11100,12336,9919,-2417
2018,8,22,9,11360,12019,9449,-2570
2018,8,22,10,12180,12353,10152,-2201
2018,8,22,11,13480,13450,11718,-1732
2018,8,22,12,14770,14732,12928,-1804
2018,8,22,13,15580,15555,13892,-1663
2018,8,22,14,16060,16064,14645,-1419
2018,8,22,15,16510,16465,15214,-1251
2018,8,22,16,16840,16776,15405,-1371
2018,8,22,17,17230,17003,15610,-1393
2018,8,22,18,17710,17490,16135,-1355
2018,8,22,19,18020,17939,16582,-1357
2018,8,22,20,18550,18282,16981,-1301
2018,8,22,21,18770,18490,17182,-1308
2018,8,22,22,18640,18742,17322,-1420
2018,8,22,23,18300,18610,17213,-1397
2018,8,23,0,17900,18192,16615,-1577
2018,8,23,1,17690,17852,16222,-1630
2018,8,23,2,16600,16706,15008,-1698
2018,8,23,3,15020,15145,13390,-1755
2018,8,23,4,13510,13644,11978,-1666
2018,8,23,5,12600,12882,10576,-2306
2018,8,23,6,11910,12712,10353,-2359
2018,8,23,7,11450,12497,9933,-2564
2018,8,23,8,11210,12272,9798,-2474
2018,8,23,9,11310,12333,9866,-2467
2018,8,23,10,11960,12490,10572,-1918
2018,8,23,11,12990,13122,11673,-1449
2018,8,23,12,13870,13861,12455,-1406
2018,8,23,13,14270,14276,12937,-1339
2018,8,23,14,14410,14409,13312,-1097
2018,8,23,15,14450,14455,13371,-1084
2018,8,23,16,14470,14471,13730,-741
2018,8,23,17,14530,14534,14029,-505
2018,8,23,18,14910,14815,14022,-793
2018,8,23,19,15340,15423,14324,-1099
2018,8,23,20,15690,15701,14774,-927
2018,8,23,21,15990,15995,14990,-1005
2018,8,23,22,16280,16336,15350,-986
2018,8,23,23,16140,16273,14905,-1368
2018,8,24,0,15740,15953,14529,-1424
2018,8,24,1,15580,15753,14547,-1206
2018,8,24,2,14640,14785,13492,-1293
2018,8,24,3,13300,13448,12015,-1433
2018,8,24,4,12030,12144,10927,-1217
2018,8,24,5,11350,11502,9873,-1629
2018,8,24,6,10810,11166,9527,-1639
2018,8,24,7,10470,11054,9428,-1626
2018,8,24,8,10340,11097,9394,-1703
2018,8,24,9,10500,11195,9374,-1821
2018,8,24,10,11190,11450,9870,-1580
2018,8,24,11,12240,12182,10866,-1316
2018,8,24,12,13230,12975,11631,-1344
2018,8,24,13,13830,13507,12281,-1226
2018,8,24,14,13900,13849,12903,-946
2018,8,24,15,14200,14261,13521,-740
2018,8,24,16,14490,14724,14086,-638
2018,8,24,17,14860,15144,14665,-479
2018,8,24,18,15430,15741,15453,-288
2018,8,24,19,16090,16289,16068,-221
2018,8,24,20,16930,16833,16606,-227
2018,8,24,21,17400,17411,16884,-527
2018,8,24,22,18050,17798,17047,-751
2018,8,24,23,17570,17550,16490,-1060
2018,8,25,0,17070,17092,15957,-1135
2018,8,25,1,16900,16762,15723,-1039
2018,8,25,2,15860,15759,14847,-912
2018,8,25,3,14560,14674,13144,-1530
2018,8,25,4,13230,13385,12013,-1372
2018,8,25,5,12160,12389,10260,-2129
2018,8,25,6,11450,11719,9427,-2292
2018,8,25,7,10970,11798,9333,-2465
2018,8,25,8,10720,11761,9044,-2717
2018,8,25,9,10570,11700,8762,-2938
2018,8,25,10,10830,11709,8859,-2850
2018,8,25,11,11090,11934,9329,-2605
2018,8,25,12,11870,12404,9851,-2553
2018,8,25,13,12860,12717,10497,-2220
2018,8,25,14,13340,13334,11432,-1902
2018,8,25,15,13810,13768,11828,-1940
2018,8,25,16,14230,14196,12333,-1863
2018,8,25,17,14490,14640,12911,-1729
2018,8,25,18,14880,15046,13369,-1677
2018,8,25,19,15120,15294,13807,-1487
2018,8,25,20,15500,15535,13968,-1567
2018,8,25,21,15910,15761,14052,-1709
2018,8,25,22,16100,15968,14237,-1731
2018,8,25,23,16090,15902,13909,-1993
2018,8,26,0,15800,15672,13855,-1817
2018,8,26,1,15630,15452,13678,-1774
2018,8,26,2,14810,14664,12591,-2073
2018,8,26,3,13790,13619,11182,-2437
2018,8,26,4,12670,12712,10159,-2553
2018,8,26,5,11550,11816,9172,-2644
2018,8,26,6,10910,11154,8561,-2593
2018,8,26,7,10510,10984,8723,-2261
2018,8,26,8,10240,10983,8526,-2457
2018,8,26,9,10110,10792,8360,-2432
2018,8,26,10,10200,10583,8896,-1687
2018,8,26,11,10300,10624,9032,-1592
2018,8,26,12,10930,11065,9277,-1788
2018,8,26,13,11660,11567,9589,-1978
2018,8,26,14,12330,12190,10448,-1742
2018,8,26,15,13020,12722,11364,-1358
2018,8,26,16,13650,13254,12082,-1172
2018,8,26,17,14180,13901,12679,-1222
2018,8,26,18,14620,14467,13521,-946
2018,8,26,19,15160,15134,14310,-824
2018,8,26,20,15620,15892,14744,-1148
2018,8,26,21,16350,16675,15550,-1125
2018,8,26,22,16860,17226,15874,-1352
2018,8,26,23,17000,17317,15606,-1711
2018,8,27,0,16680,17335,15674,-1661
2018,8,27,1,16870,17297,15551,-1746
2018,8,27,2,15880,16419,14543,-1876
2018,8,27,3,14520,15196,13182,-2014
2018,8,27,4,13360,14163,12080,-2083
2018,8,27,5,12980,13571,11477,-2094
2018,8,27,6,12420,13523,11433,-2090
2018,8,27,7,12060,13205,11446,-1759
2018,8,27,8,11930,13270,11572,-1698
2018,8,27,9,12260,13324,11757,-1567
2018,8,27,10,13090,13603,11935,-1668
2018,8,27,11,14450,14375,12975,-1400
2018,8,27,12,15800,15491,14026,-1465
2018,8,27,13,16610,16437,14923,-1514
2018,8,27,14,17300,17277,16033,-1244
2018,8,27,15,18230,18106,16962,-1144
2018,8,27,16,19030,18919,17655,-1264
2018,8,27,17,19740,19674,18195,-1479
2018,8,27,18,20490,20436,18869,-1567
2018,8,27,19,21050,21070,19493,-1577
2018,8,27,20,21480,21619,19823,-1796
2018,8,27,21,22240,22066,20356,-1710
2018,8,27,22,22400,22239,20208,-2031
2018,8,27,23,22070,21982,19564,-2418
2018,8,28,0,21640,21724,19239,-2485
2018,8,28,1,21160,21233,18662,-2571
2018,8,28,2,19630,19782,17043,-2739
2018,8,28,3,17750,18211,15317,-2894
2018,8,28,4,16070,16877,14465,-2412
2018,8,28,5,15090,16261,13723,-2538
2018,8,28,6,14300,15934,13257,-2677
2018,8,28,7,13830,15436,12914,-2522
2018,8,28,8,13570,15154,12692,-2462
2018,8,28,9,13700,15261,12918,-2343
2018,8,28,10,14520,15781,13502,-2279
2018,8,28,11,15860,16154,13975,-2179
2018,8,28,12,17210,17399,15108,-2291
2018,8,28,13,18320,18292,16257,-2035
2018,8,28,14,19530,19334,17371,-1963
2018,8,28,15,20630,20615,18270,-2345
2018,8,28,16,21810,21870,19343,-2527
2018,8,28,17,22630,22922,20268,-2654
2018,8,28,18,23550,23856,21622,-2234
2018,8,28,19,24210,24311,22139,-2172
2018,8,28,20,24500,24683,22174,-2509
2018,8,28,21,24800,25086,22579,-2507
2018,8,28,22,24750,25365,22898,-2467
2018,8,28,23,24390,25125,22601,-2524
2018,8,29,0,23980,24814,22196,-2618
2018,8,29,1,23550,24289,21664,-2625
2018,8,29,2,22040,22745,19884,-2861
2018,8,29,3,20080,21018,18227,-2791
2018,8,29,4,18260,19510,16987,-2523
2018,8,29,5,17400,18780,15887,-2893
2018,8,29,6,16210,18238,15342,-2896
2018,8,29,7,15860,17569,15044,-2525
2018,8,29,8,15650,17146,14635,-2511
2018,8,29,9,15660,17143,14834,-2309
2018,8,29,10,16270,17558,15165,-2393
2018,8,29,11,17420,18544,16052,-2492
2018,8,29,12,18910,19350,16861,-2489
2018,8,29,13,20110,19852,17434,-2418
2018,8,29,14,21190,20956,18362,-2594
2018,8,29,15,22370,21980,19240,-2740
2018,8,29,16,23480,23084,20320,-2764
2018,8,29,17,24330,23968,21334,-2634
2018,8,29,18,24610,24720,22133,-2587
2018,8,29,19,25020,25025,22602,-2423
2018,8,29,20,25660,25232,22898,-2334
2018,8,29,21,26400,25573,23184,-2389
2018,8,29,22,26500,25763,23434,-2329
2018,8,29,23,25730,25317,22875,-2442
2018,8,30,0,24960,24931,22402,-2529
2018,8,30,1,24790,24308,21557,-2751
2018,8,30,2,23110,22668,19854,-2814
2018,8,30,3,21160,20768,17863,-2905
2018,8,30,4,19120,19121,16369,-2752
2018,8,30,5,17350,18332,15536,-2796
2018,8,30,6,16450,18010,15206,-2804
2018,8,30,7,15830,17444,14924,-2520
2018,8,30,8,15460,17052,14597,-2455
2018,8,30,9,15550,17111,14632,-2479
2018,8,30,10,16290,17574,15072,-2502
2018,8,30,11,17630,18438,15779,-2659
2018,8,30,12,18740,19035,16377,-2658
2018,8,30,13,19470,19484,16866,-2618
2018,8,30,14,20150,20117,17478,-2639
2018,8,30,15,21020,20826,18100,-2726
2018,8,30,16,22090,21462,18821,-2641
2018,8,30,17,22500,21866,19244,-2622
2018,8,30,18,22810,22305,19589,-2716
2018,8,30,19,23270,22453,19900,-2553
2018,8,30,20,23670,22528,19927,-2601
2018,8,30,21,24000,22531,19950,-2581
2018,8,30,22,23780,22302,19617,-2685
2018,8,30,23,22890,21601,18917,-2684
2018,8,31,0,22240,21007,18267,-2740
2018,8,31,1,21600,20307,17408,-2899
2018,8,31,2,20070,18810,15922,-2888
2018,8,31,3,18160,17002,14144,-2858
2018,8,31,4,16320,15265,12997,-2268
2018,8,31,5,13990,14307,11971,-2336
2018,8,31,6,13140,13716,11586,-2130
2018,8,31,7,12570,13162,11035,-2127
2018,8,31,8,12230,13089,10912,-2177
2018,8,31,9,12260,13067,10933,-2134
2018,8,31,10,12880,13373,11450,-1923
2018,8,31,11,13940,13967,12291,-1676
2018,8,31,12,14750,14738,13126,-1612
2018,8,31,13,15140,15121,13715,-1406
2018,8,31,14,15360,15359,13969,-1390
2018,8,31,15,15650,15515,14194,-1321
2018,8,31,16,15870,15659,14371,-1288
2018,8,31,17,16340,15838,14584,-1254
2018,8,31,18,16450,16064,14823,-1241
2018,8,31,19,16790,16179,14908,-1271
2018,8,31,20,16870,16286,14956,-1330
2018,8,31,21,17020,16337,15061,-1276
2018,8,31,22,16980,16297,14961,-1336
2018,8,31,23,16600,15996,14566,-1430
2018,9,1,0,16310,15833,14230,-1603
2018,9,1,1,16110,15504,13960,-1544
2018,9,1,2,15250,14645,13135,-1510
2018,9,1,3,14160,13507,11580,-1927
2018,9,1,4,12980,12334,10431,-1903
2018,9,1,5,11470,11492,9173,-2319
2018,9,1,6,10890,11314,8760,-2554
2018,9,1,7,10530,11465,8904,-2561
2018,9,1,8,10340,11671,9132,-2539
2018,9,1,9,10320,11645,8990,-2655
2018,9,1,10,10540,11832,8990,-2842
2018,9,1,11,10900,11692,9017,-2675
2018,9,1,12,11490,11968,9225,-2743
2018,9,1,13,12200,12450,10033,-2417
2018,9,1,14,12690,12725,10763,-1962
2018,9,1,15,12940,12900,11188,-1712
2018,9,1,16,13190,12945,11674,-1271
2018,9,1,17,13400,13151,12088,-1063
2018,9,1,18,13550,13499,12292,-1207
2018,9,1,19,13840,13817,12563,-1254
2018,9,1,20,14520,14184,12904,-1280
2018,9,1,21,14900,14650,13337,-1313
2018,9,1,22,15210,15015,13802,-1213
2018,9,1,23,15120,15062,13686,-1376
2018,9,2,0,15340,15053,13690,-1363
2018,9,2,1,15080,14898,13190,-1708
2018,9,2,2,14320,14201,12511,-1690
2018,9,2,3,13280,13259,11173,-2086
2018,9,2,4,12240,12242,9864,-2378
2018,9,2,5,11430,11614,9024,-2590
2018,9,2,6,10850,11161,8542,-2619
2018,9,2,7,10490,11271,8465,-2806
2018,9,2,8,10280,11345,8432,-2913
2018,9,2,9,10210,11287,8450,-2837
2018,9,2,10,10330,11157,8330,-2827
2018,9,2,11,10560,11376,8426,-2950
2018,9,2,12,11080,11643,8742,-2901
2018,9,2,13,11870,12009,9673,-2336
2018,9,2,14,12480,12439,10347,-2092
2018,9,2,15,13020,12777,11138,-1639
2018,9,2,16,13530,13274,11585,-1689
2018,9,2,17,14230,13873,12365,-1508
2018,9,2,18,14700,14447,13023,-1424
2018,9,2,19,15090,15088,14039,-1049
2018,9,2,20,15590,15702,14606,-1096
2018,9,2,21,16170,16303,15073,-1230
2018,9,2,22,16700,16745,15170,-1575
2018,9,2,23,16770,16745,14703,-2042
2018,9,3,0,17030,16699,14582,-2117
2018,9,3,1,16700,16543,14490,-2053
2018,9,3,2,15860,15847,13808,-2039
2018,9,3,3,14460,14888,12747,-2141
2018,9,3,4,13370,13836,11457,-2379
2018,9,3,5,12950,12978,10503,-2475
2018,9,3,6,12370,12612,10259,-2353
2018,9,3,7,12040,12587,10102,-2485
2018,9,3,8,11900,12700,10081,-2619
2018,9,3,9,11990,12777,10089,-2688
2018,9,3,10,12380,12960,10449,-2511
2018,9,3,11,12890,13383,10804,-2579
2018,9,3,12,13590,13846,11456,-2390
2018,9,3,13,14680,14822,12798,-2024
2018,9,3,14,15860,15846,13839,-2007
2018,9,3,15,17090,17076,15214,-1862
2018,9,3,16,18360,18350,16022,-2328
2018,9,3,17,19560,19528,17212,-2316
2018,9,3,18,20530,20518,18188,-2330
2018,9,3,19,21260,21262,18743,-2519
2018,9,3,20,21880,21895,18889,-3006
2018,9,3,21,22400,22435,19128,-3307
2018,9,3,22,22820,22983,19248,-3735
2018,9,3,23,22720,22815,19269,-3546
2018,9,4,0,22660,22651,19051,-3600
2018,9,4,1,21990,22166,18971,-3195
2018,9,4,2,20690,20710,17608,-3102
2018,9,4,3,18970,18851,15698,-3153
2018,9,4,4,17320,17207,14095,-3112
2018,9,4,5,16000,16339,13327,-3012
2018,9,4,6,15280,16002,12887,-3115
2018,9,4,7,14600,15757,12610,-3147
2018,9,4,8,14350,15725,12519,-3206
2018,9,4,9,14450,16042,12858,-3184
2018,9,4,10,15190,16829,13750,-3079
2018,9,4,11,16540,17688,14646,-3042
2018,9,4,12,17860,18286,15450,-2836
2018,9,4,13,18730,19119,16213,-2906
2018,9,4,14,19300,19511,16639,-2872
2018,9,4,15,20150,20226,17371,-2855
2018,9,4,16,20900,20882,18105,-2777
2018,9,4,17,21420,21522,18790,-2732
2018,9,4,18,22070,22049,19254,-2795
2018,9,4,19,22460,22342,20020,-2322
2018,9,4,20,22690,22637,20500,-2137
2018,9,4,21,22890,22968,20724,-2244
2018,9,4,22,23000,23024,20598,-2426
2018,9,4,23,22530,22529,19923,-2606
2018,9,5,0,22150,22066,19412,-2654
2018,9,5,1,21280,21268,18493,-2775
2018,9,5,2,19820,19635,16677,-2958
2018,9,5,3,17970,17692,14780,-2912
2018,9,5,4,16290,15974,13352,-2622
2018,9,5,5,14730,15509,12633,-2876
2018,9,5,6,13910,15499,12504,-2995
2018,9,5,7,13380,14997,12244,-2753
2018,9,5,8,13100,14691,11806,-2885
2018,9,5,9,13220,14794,11889,-2905
2018,9,5,10,14050,15597,12775,-2822
2018,9,5,11,15240,16606,13782,-2824
2018,9,5,12,16500,16862,14349,-2513
2018,9,5,13,17210,17054,14772,-2282
2018,9,5,14,17580,17567,15445,-2122
2018,9,5,15,18320,18251,16076,-2175
2018,9,5,16,19100,19130,16980,-2150
2018,9,5,17,20100,20029,17819,-2210
2018,9,5,18,20960,21027,18819,-2208
2018,9,5,19,21570,21770,19489,-2281
2018,9,5,20,22100,22445,20283,-2162
2018,9,5,21,22500,23007,20857,-2150
2018,9,5,22,22600,23300,20634,-2666
2018,9,5,23,22000,22932,19863,-3069
2018,9,6,0,21830,22487,19362,-3125
2018,9,6,1,21110,21720,18566,-3154
2018,9,6,2,19780,20182,17070,-3112
2018,9,6,3,17980,18483,15502,-2981
2018,9,6,4,16230,17072,14169,-2903
2018,9,6,5,14950,16149,12950,-3199
2018,9,6,6,14230,15708,12577,-3131
2018,9,6,7,13710,15411,12316,-3095
2018,9,6,8,13420,15389,12290,-3099
2018,9,6,9,13740,15724,12750,-2974
2018,9,6,10,14690,16663,13896,-2767
2018,9,6,11,16220,17610,14692,-2918
2018,9,6,12,17470,18075,15436,-2639
2018,9,6,13,18430,18952,16181,-2771
2018,9,6,14,19340,19820,17016,-2804
2018,9,6,15,20190,20639,17613,-3026
2018,9,6,16,21100,21590,18484,-3106
2018,9,6,17,21740,22458,19385,-3073
2018,9,6,18,22490,23330,20356,-2974
2018,9,6,19,23020,23868,21004,-2864
2018,9,6,20,23420,24197,21391,-2806
2018,9,6,21,23390,23499,20649,-2850
2018,9,6,22,23100,22281,19962,-2319
2018,9,6,23,22500,21356,18994,-2362
2018,9,7,0,22390,20961,18111,-2850
2018,9,7,1,21420,20175,17361,-2814
2018,9,7,2,19810,18823,15778,-3045
2018,9,7,3,17850,17208,14163,-3045
2018,9,7,4,16050,15619,13128,-2491
2018,9,7,5,13760,14704,12226,-2478
2018,9,7,6,13040,14417,11874,-2543
2018,9,7,7,12650,14410,11911,-2499
2018,9,7,8,12080,14194,11714,-2480
2018,9,7,9,12130,14170,11639,-2531
2018,9,7,10,12920,14290,11894,-2396
2018,9,7,11,14390,14778,12572,-2206
2018,9,7,12,15200,15397,13457,-1940
2018,9,7,13,15380,15601,13953,-1648
2018,9,7,14,15550,15733,14224,-1509
2018,9,7,15,15780,15911,14676,-1235
2018,9,7,16,15740,15941,14599,-1342
2018,9,7,17,15750,15834,14746,-1088
2018,9,7,18,16040,15774,14467,-1307
2018,9,7,19,16010,15585,13828,-1757
2018,9,7,20,16140,15507,13848,-1659
2018,9,7,21,16460,15541,14358,-1183
2018,9,7,22,16360,15584,14233,-1351
2018,9,7,23,16180,15523,13848,-1675
2018,9,8,0,16180,15615,13837,-1778
2018,9,8,1,15820,15263,13727,-1536
2018,9,8,2,14870,14464,12895,-1569
2018,9,8,3,13750,13415,11574,-1841
2018,9,8,4,12600,12302,10409,-1893
2018,9,8,5,12090,11496,9601,-1895
2018,9,8,6,11360,11222,9306,-1916
2018,9,8,7,10980,11174,9225,-1949
2018,9,8,8,10590,11024,9224,-1800
2018,9,8,9,10570,11006,9250,-1756
2018,9,8,10,10970,11231,9560,-1671
2018,9,8,11,11240,11727,9819,-1908
2018,9,8,12,11780,11858,10168,-1690
2018,9,8,13,12410,12478,10838,-1640
2018,9,8,14,12770,12851,11264,-1587
2018,9,8,15,13070,12879,11291,-1588
2018,9,8,16,12860,12757,11208,-1549
2018,9,8,17,12850,12774,11444,-1330
2018,9,8,18,12900,12777,11330,-1447
2018,9,8,19,12920,12764,11512,-1252
2018,9,8,20,12990,12832,11644,-1188
2018,9,8,21,13250,13001,11912,-1089
2018,9,8,22,13590,13188,11714,-1474
2018,9,8,23,13740,13289,11899,-1390
2018,9,9,0,14050,13480,12109,-1371
2018,9,9,1,13470,13148,11759,-1389
2018,9,9,2,12850,12474,10830,-1644
2018,9,9,3,11900,11618,9594,-2024
2018,9,9,4,10980,10823,8705,-2118
2018,9,9,5,10070,10282,8406,-1876
2018,9,9,6,9590,10099,8357,-1742
2018,9,9,7,9300,10221,8426,-1795
2018,9,9,8,9150,10124,8254,-1870
2018,9,9,9,9120,10195,8254,-1941
2018,9,9,10,9250,10334,8287,-2047
2018,9,9,11,9560,10428,8208,-2220
2018,9,9,12,9960,10755,8336,-2419
2018,9,9,13,10650,10834,8685,-2149
2018,9,9,14,11060,11240,9098,-2142
2018,9,9,15,11110,11476,9234,-2242
2018,9,9,16,11320,11556,9562,-1994
2018,9,9,17,11370,11672,9558,-2114
2018,9,9,18,11440,11670,9613,-2057
2018,9,9,19,11540,11916,9475,-2441
2018,9,9,20,11770,12134,9587,-2547
2018,9,9,21,12220,12249,9795,-2454
2018,9,9,22,12740,12787,10587,-2200
2018,9,9,23,13230,13125,10961,-2164
2018,9,10,0,13500,13444,11651,-1793
2018,9,10,1,13070,13012,11286,-1726
2018,9,10,2,12250,12126,10265,-1861
2018,9,10,3,11240,11097,8887,-2210
2018,9,10,4,10290,10210,7912,-2298
2018,9,10,5,9700,9950,7459,-2491
2018,9,10,6,9360,9760,7300,-2460
2018,9,10,7,9210,9707,7386,-2321
2018,9,10,8,9050,9860,7499,-2361
2018,9,10,9,9380,10121,7927,-2194
2018,9,10,10,10290,10368,8453,-1915
2018,9,10,11,11970,11762,9678,-2084
2018,9,10,12,13030,12787,10972,-1815
2018,9,10,13,13320,13314,11383,-1931
2018,9,10,14,13670,13660,11986,-1674
2018,9,10,15,13920,13914,12416,-1498
2018,9,10,16,13990,14002,12339,-1663
2018,9,10,17,14080,14000,12209,-1791
2018,9,10,18,14140,14134,12325,-1809
2018,9,10,19,13990,14135,12509,-1626
2018,9,10,20,14190,14170,12435,-1735
2018,9,10,21,14430,14345,12655,-1690
2018,9,10,22,14920,14710,13055,-1655
2018,9,10,23,15110,14844,12987,-1857
2018,9,11,0,15300,14858,13120,-1738
2018,9,11,1,14670,14248,12306,-1942
2018,9,11,2,13630,13233,11356,-1877
2018,9,11,3,12410,12191,10172,-2019
2018,9,11,4,11200,11392,9564,-1828
2018,9,11,5,10330,10893,8840,-2053
2018,9,11,6,9970,10756,8782,-1974
2018,9,11,7,9780,10756,8716,-2040
2018,9,11,8,9770,10798,8719,-2079
2018,9,11,9,10070,10624,8888,-1736
2018,9,11,10,10970,11340,9617,-1723
2018,9,11,11,12570,12539,10764,-1775
2018,9,11,12,13610,13598,11902,-1696
2018,9,11,13,14060,14065,12603,-1462
2018,9,11,14,14320,14335,12758,-1577
2018,9,11,15,14710,14549,12735,-1814
2018,9,11,16,15160,14652,12551,-2101
2018,9,11,17,15530,14748,12804,-1944
2018,9,11,18,16010,15047,13144,-1903
2018,9,11,19,16400,15195,13438,-1757
2018,9,11,20,16810,15506,13621,-1885
2018,9,11,21,17480,15928,14119,-1809
2018,9,11,22,17690,16378,14399,-1979
2018,9,11,23,17660,16550,14388,-2162
2018,9,12,0,17960,16755,14768,-1987
2018,9,12,1,17350,16275,14442,-1833
2018,9,12,2,16110,15208,13273,-1935
2018,9,12,3,14660,13896,12131,-1765
2018,9,12,4,13290,12936,11243,-1693
2018,9,12,5,11850,12362,10179,-2183
2018,9,12,6,11350,11887,9814,-2073
2018,9,12,7,11070,11607,9434,-2173
2018,9,12,8,10990,11515,9474,-2041
2018,9,12,9,11260,11705,9713,-1992
2018,9,12,10,12190,12413,10382,-2031
2018,9,12,11,13870,13837,12117,-1720
2018,9,12,12,14970,14955,13212,-1743
2018,9,12,13,15480,15479,13855,-1624
2018,9,12,14,15800,15821,14221,-1600
2018,9,12,15,16160,16110,14679,-1431
2018,9,12,16,16350,16160,14658,-1502
2018,9,12,17,16420,16079,14659,-1420
2018,9,12,18,16610,16065,14511,-1554
2018,9,12,19,16640,15947,14507,-1440
2018,9,12,20,16690,15823,14578,-1245
2018,9,12,21,16620,15861,14445,-1416
2018,9,12,22,16810,15972,14600,-1372
2018,9,12,23,16810,16002,14634,-1368
2018,9,13,0,16930,16174,14854,-1320
2018,9,13,1,16370,15699,14670,-1029
2018,9,13,2,15220,14731,13560,-1171
2018,9,13,3,13910,13448,12013,-1435
2018,9,13,4,12730,12238,10874,-1364
2018,9,13,5,11510,11437,9622,-1815
2018,9,13,6,11010,11160,9472,-1688
2018,9,13,7,10730,10899,9075,-1824
2018,9,13,8,10650,10817,9105,-1712
2018,9,13,9,10880,11029,9318,-1711
2018,9,13,10,11790,11721,9969,-1752
2018,9,13,11,13370,13305,11691,-1614
2018,9,13,12,14340,14306,12737,-1569
2018,9,13,13,14670,14696,13432,-1264
2018,9,13,14,14970,14923,13967,-956
2018,9,13,15,15220,15195,14280,-915
2018,9,13,16,15460,15374,14659,-715
2018,9,13,17,15670,15486,15263,-223
2018,9,13,18,15940,15690,15190,-500
2018,9,13,19,16070,15794,15437,-357
2018,9,13,20,16240,15875,15607,-268
2018,9,13,21,16360,16017,15933,-84
2018,9,13,22,16450,16207,16308,101
2018,9,13,23,16490,16259,16092,-167
2018,9,14,0,16580,16466,16053,-413
2018,9,14,1,16130,16029,15541,-488
2018,9,14,2,15100,15011,14372,-639
2018,9,14,3,13740,13682,12714,-968
2018,9,14,4,12480,12401,11103,-1298
2018,9,14,5,11550,11725,10453,-1272
2018,9,14,6,11000,11645,10136,-1509
2018,9,14,7,10700,11698,10196,-1502
2018,9,14,8,10560,11573,10093,-1480
2018,9,14,9,10800,12010,10394,-1616
2018,9,14,10,11700,12166,10879,-1287
2018,9,14,11,13150,13042,11646,-1396
2018,9,14,12,14110,13988,12916,-1072
2018,9,14,13,14450,14420,13739,-681
2018,9,14,14,14760,14734,14333,-401
2018,9,14,15,15080,15020,14573,-447
2018,9,14,16,15390,15260,15133,-127
2018,9,14,17,15490,15415,15157,-258
2018,9,14,18,15840,15674,15683,9
2018,9,14,19,15990,15710,15564,-146
2018,9,14,20,16160,15831,15745,-86
2018,9,14,21,16280,16076,16021,-55
2018,9,14,22,16400,16256,15619,-637
2018,9,14,23,16210,16101,15223,-878
2018,9,15,0,16170,16081,15225,-856
2018,9,15,1,15640,15554,14638,-916
2018,9,15,2,14690,14645,13972,-673
2018,9,15,3,13540,13500,12496,-1004
2018,9,15,4,12350,12316,10932,-1384
2018,9,15,5,11390,11710,10019,-1691
2018,9,15,6,10840,11619,9910,-1709
2018,9,15,7,10480,11631,9674,-1957
2018,9,15,8,10320,11685,9568,-2117
2018,9,15,9,10330,11497,9604,-1893
2018,9,15,10,10780,11641,9727,-1914
2018,9,15,11,11290,11926,9840,-2086
2018,9,15,12,11940,12260,10497,-1763
2018,9,15,13,12650,13049,11580,-1469
2018,9,15,14,13340,13315,12134,-1181
2018,9,15,15,13560,13685,12804,-881
2018,9,15,16,13740,14033,13228,-805
2018,9,15,17,13990,14146,13747,-399
2018,9,15,18,14240,14321,13991,-330
2018,9,15,19,14390,14365,14214,-151
2018,9,15,20,14840,14692,14425,-267
2018,9,15,21,15280,15301,14983,-318
2018,9,15,22,15640,15830,15601,-229
2018,9,15,23,15600,15805,15222,-583
2018,9,16,0,15700,15730,14792,-938
2018,9,16,1,15430,15225,14120,-1105
2018,9,16,2,14480,14394,13202,-1192
2018,9,16,3,13400,13321,12161,-1160
2018,9,16,4,12360,12263,10724,-1539
2018,9,16,5,11410,11580,9911,-1669
2018,9,16,6,10810,11493,9871,-1622
2018,9,16,7,10450,11685,10021,-1664
2018,9,16,8,10280,11591,9913,-1678
2018,9,16,9,10190,11515,9714,-1801
2018,9,16,10,10370,11853,10057,-1796
2018,9,16,11,10710,12129,10248,-1881
2018,9,16,12,11220,12546,10620,-1926
2018,9,16,13,11910,12749,10944,-1805
2018,9,16,14,12500,13210,11769,-1441
2018,9,16,15,12980,13372,12276,-1096
2018,9,16,16,13530,13671,12702,-969
2018,9,16,17,14170,14484,13866,-618
2018,9,16,18,15340,15305,14877,-428
2018,9,16,19,15850,16059,15617,-442
2018,9,16,20,16830,16836,16398,-438
2018,9,16,21,17500,17639,17178,-461
2018,9,16,22,17930,18173,17196,-977
2018,9,16,23,18030,18079,16517,-1562
2018,9,17,0,18200,18031,16467,-1564
2018,9,17,1,17440,17401,15695,-1706
2018,9,17,2,16130,16093,14214,-1879
2018,9,17,3,14510,14741,12969,-1772
2018,9,17,4,13130,13528,11484,-2044
2018,9,17,5,12240,12954,10645,-2309
2018,9,17,6,11660,12499,10264,-2235
2018,9,17,7,11310,12372,10314,-2058
2018,9,17,8,11190,12480,10298,-2182
2018,9,17,9,11540,12923,10527,-2396
2018,9,17,10,12360,13251,11067,-2184
2018,9,17,11,13980,14852,12588,-2264
2018,9,17,12,14790,15498,13403,-2095
2018,9,17,13,15250,15777,14069,-1708
2018,9,17,14,15550,15773,14353,-1420
2018,9,17,15,15920,16080,14713,-1367
2018,9,17,16,16300,16334,15070,-1264
2018,9,17,17,16850,16926,15562,-1364
2018,9,17,18,17330,17557,16090,-1467
2018,9,17,19,17510,17826,16184,-1642
2018,9,17,20,17880,18166,16528,-1638
2018,9,17,21,18250,18418,16777,-1641
2018,9,17,22,18500,18568,16647,-1921
2018,9,17,23,18300,18530,16405,-2125
2018,9,18,0,18310,18734,16748,-1986
2018,9,18,1,17540,18077,15830,-2247
2018,9,18,2,16200,16870,14721,-2149
2018,9,18,3,14650,15669,13527,-2142
2018,9,18,4,13320,14387,12162,-2225
2018,9,18,5,13130,13982,11449,-2533
2018,9,18,6,12560,13674,11302,-2372
2018,9,18,7,12240,13603,11254,-2349
2018,9,18,8,12120,13467,11161,-2306
2018,9,18,9,12390,13707,11415,-2292
2018,9,18,10,13350,14141,12038,-2103
2018,9,18,11,15100,15156,13440,-1716
2018,9,18,12,16250,16244,14545,-1699
2018,9,18,13,16850,16851,15231,-1620
2018,9,18,14,17250,17311,15365,-1946
2018,9,18,15,17610,17642,15647,-1995
2018,9,18,16,17810,17668,15555,-2113
2018,9,18,17,17930,17534,15377,-2157
2018,9,18,18,18080,17338,15176,-2162
2018,9,18,19,18130,17159,15263,-1896
2018,9,18,20,18160,17118,15393,-1725
2018,9,18,21,18260,17271,15688,-1583
2018,9,18,22,18370,17611,15763,-1848
2018,9,18,23,18380,17700,15626,-2074
2018,9,19,0,18500,17787,15662,-2125
2018,9,19,1,17630,17101,15052,-2049
2018,9,19,2,16290,15892,13972,-1920
2018,9,19,3,14760,14707,12740,-1967
2018,9,19,4,13400,13592,11624,-1968
2018,9,19,5,12230,12939,10974,-1965
2018,9,19,6,11730,12847,11023,-1824
2018,9,19,7,11330,12593,10684,-1909
2018,9,19,8,11100,12434,10548,-1886
2018,9,19,9,11310,12141,10255,-1886
2018,9,19,10,12120,12444,10905,-1539
2018,9,19,11,13630,13467,12088,-1379
2018,9,19,12,14610,14280,13114,-1166
2018,9,19,13,14830,14666,13323,-1343
2018,9,19,14,15060,14906,13784,-1122
2018,9,19,15,15180,15041,13945,-1096
2018,9,19,16,15280,15096,14152,-944
2018,9,19,17,15310,15081,14284,-797
2018,9,19,18,15410,15162,14416,-746
2018,9,19,19,15490,15214,14562,-652
2018,9,19,20,15620,15241,14756,-485
2018,9,19,21,15730,15415,15205,-210
2018,9,19,22,15720,15584,15065,-519
2018,9,19,23,15870,15620,14691,-929
2018,9,20,0,15880,15738,14589,-1149
2018,9,20,1,15200,15108,13885,-1223
2018,9,20,2,14010,14062,12801,-1261
2018,9,20,3,12700,12907,11657,-1250
2018,9,20,4,11510,11819,10408,-1411
2018,9,20,5,10740,11308,9412,-1896
2018,9,20,6,10280,11090,9539,-1551
2018,9,20,7,9990,10968,9468,-1500
2018,9,20,8,9910,11170,9470,-1700
2018,9,20,9,10180,11459,9745,-1714
2018,9,20,10,11050,11910,10212,-1698
2018,9,20,11,12550,12666,10934,-1732
2018,9,20,12,13410,13399,11941,-1458
2018,9,20,13,13660,13669,12573,-1096
2018,9,20,14,13800,13773,12991,-782
2018,9,20,15,13820,13882,13363,-519
2018,9,20,16,13890,13847,13571,-276
2018,9,20,17,13900,13796,13510,-286
2018,9,20,18,14040,13987,13602,-385
2018,9,20,19,14130,14077,13846,-231
2018,9,20,20,14270,14216,14045,-171
2018,9,20,21,14450,14398,14258,-140
2018,9,20,22,14770,14657,14491,-166
2018,9,20,23,15060,14878,14448,-430
2018,9,21,0,15400,15153,14681,-472
2018,9,21,1,14770,14657,13978,-679
2018,9,21,2,13710,13690,12763,-927
2018,9,21,3,12400,12458,11356,-1102
2018,9,21,4,11240,11330,9857,-1473
2018,9,21,5,10530,11047,9210,-1837
2018,9,21,6,10050,10874,9161,-1713
2018,9,21,7,9810,10863,9184,-1679
2018,9,21,8,9770,10780,9137,-1643
2018,9,21,9,10000,10780,9171,-1609
2018,9,21,10,10860,11581,9884,-1697
2018,9,21,11,12370,12701,11051,-1650
2018,9,21,12,13330,13324,12106,-1218
2018,9,21,13,13700,13641,12606,-1035
2018,9,21,14,13780,13763,13045,-718
2018,9,21,15,13900,13818,13087,-731
2018,9,21,16,14000,13842,13134,-708
2018,9,21,17,14070,13937,13060,-877
2018,9,21,18,14290,14119,13266,-853
2018,9,21,19,14350,14144,13473,-671
2018,9,21,20,14450,14191,13470,-721
2018,9,21,21,14640,14320,13569,-751
2018,9,21,22,14820,14468,13297,-1171
2018,9,21,23,14930,14546,13007,-1539
2018,9,22,0,15100,14651,13312,-1339
2018,9,22,1,14610,14200,12867,-1333
2018,9,22,2,13740,13534,12149,-1385
2018,9,22,3,12720,12644,11359,-1285
2018,9,22,4,11690,11688,10320,-1368
2018,9,22,5,11000,10992,9656,-1336
2018,9,22,6,10580,10823,9232,-1591
2018,9,22,7,10330,10857,9323,-1534
2018,9,22,8,10210,10776,9267,-1509
2018,9,22,9,10250,10649,9366,-1283
2018,9,22,10,10610,11090,9645,-1445
2018,9,22,11,11140,11383,9856,-1527
2018,9,22,12,11690,11929,10320,-1609
2018,9,22,13,12230,12280,10637,-1643
2018,9,22,14,12620,12565,10937,-1628
2018,9,22,15,12830,12386,10980,-1406
2018,9,22,16,12890,12179,11507,-672
2018,9,22,17,12840,12013,11218,-795
2018,9,22,18,12760,11999,10602,-1397
2018,9,22,19,12710,12046,10640,-1406
2018,9,22,20,12760,12220,10664,-1556
2018,9,22,21,12880,12521,10838,-1683
2018,9,22,22,13140,12906,11125,-1781
2018,9,22,23,13480,13230,11212,-2018
2018,9,23,0,13600,13409,11655,-1754
2018,9,23,1,13040,12951,11053,-1898
2018,9,23,2,12290,12266,10406,-1860
2018,9,23,3,11420,11406,9711,-1695
2018,9,23,4,10540,10512,8717,-1795
2018,9,23,5,9780,9815,7717,-2098
2018,9,23,6,9350,9664,7654,-2010
2018,9,23,7,9090,9804,7684,-2120
2018,9,23,8,8970,9802,7650,-2152
2018,9,23,9,8980,9791,7588,-2203
2018,9,23,10,9170,9939,7780,-2159
2018,9,23,11,9550,10049,7871,-2178
2018,9,23,12,10050,10244,8009,-2235
2018,9,23,13,10580,10570,8567,-2003
2018,9,23,14,10920,10880,8877,-2003
2018,9,23,15,11180,11109,9045,-2064
2018,9,23,16,11350,11307,9112,-2195
2018,9,23,17,11470,11409,9155,-2254
2018,9,23,18,11590,11471,9197,-2274
2018,9,23,19,11640,11547,9434,-2113
2018,9,23,20,11670,11768,9691,-2077
2018,9,23,21,12200,12244,10136,-2108
2018,9,23,22,12800,12826,10480,-2346
2018,9,23,23,13350,13381,11065,-2316
2018,9,24,0,13750,13688,11380,-2308
2018,9,24,1,13080,13148,10795,-2353
2018,9,24,2,12150,12238,9603,-2635
2018,9,24,3,11090,11278,8450,-2828
2018,9,24,4,10160,10465,7701,-2764
2018,9,24,5,9530,9757,7300,-2457
2018,9,24,6,9160,9170,7110,-2060
2018,9,24,7,9000,9012,7130,-1882
2018,9,24,8,9000,9008,7413,-1595
2018,9,24,9,9300,9291,7416,-1875
2018,9,24,10,10250,10221,8066,-2155
2018,9,24,11,11900,11860,9535,-2325
2018,9,24,12,12820,12815,10154,-2661
2018,9,24,13,13080,13073,10046,-3027
2018,9,24,14,13170,13170,10310,-2860
2018,9,24,15,13270,13257,10198,-3059
2018,9,24,16,13270,13248,10158,-3090
2018,9,24,17,13170,13134,10405,-2729
2018,9,24,18,13180,13141,10447,-2694
2018,9,24,19,13270,13057,10441,-2616
2018,9,24,20,13300,13111,10480,-2631
2018,9,24,21,13620,13388,10628,-2760
2018,9,24,22,14030,13861,11017,-2844
2018,9,24,23,14530,14380,11427,-2953
2018,9,25,0,14750,14592,11992,-2600
2018,9,25,1,13970,13934,11169,-2765
2018,9,25,2,12820,12909,10085,-2824
2018,9,25,3,11550,11674,8567,-3107
2018,9,25,4,10490,10817,8030,-2787
2018,9,25,5,9870,10136,7316,-2820
2018,9,25,6,9510,9801,7132,-2669
2018,9,25,7,9350,9732,7166,-2566
2018,9,25,8,9330,9852,7215,-2637
2018,9,25,9,9620,9947,7297,-2650
2018,9,25,10,10570,10820,7901,-2919
2018,9,25,11,12270,12233,9217,-3016
2018,9,25,12,13290,13282,10205,-3077
2018,9,25,13,13700,13700,10907,-2793
2018,9,25,14,13950,13978,10998,-2980
2018,9,25,15,14170,14193,11346,-2847
2018,9,25,16,14280,14311,11463,-2848
2018,9,25,17,14390,14413,11927,-2486
2018,9,25,18,14400,14535,12087,-2448
2018,9,25,19,14280,14525,11949,-2576
2018,9,25,20,14370,14622,11933,-2689
2018,9,25,21,14610,14906,12097,-2809
2018,9,25,22,14820,15286,12499,-2787
2018,9,25,23,15400,15478,12461,-3017
2018,9,26,0,15150,15339,12419,-2920
2018,9,26,1,14590,14643,11739,-2904
2018,9,26,2,13500,13587,10813,-2774
2018,9,26,3,12290,12362,9204,-3158
2018,9,26,4,11160,11351,8270,-3081
2018,9,26,5,10590,11056,8007,-3049
2018,9,26,6,10180,10971,8000,-2971
2018,9,26,7,9990,10942,7830,-3112
2018,9,26,8,9980,11019,7986,-3033
2018,9,26,9,10270,11070,8024,-3046
2018,9,26,10,11250,11728,8950,-2778
2018,9,26,11,13090,13084,9975,-3109
2018,9,26,12,14230,14205,11005,-3200
2018,9,26,13,14750,14744,11882,-2862
2018,9,26,14,15010,15057,12089,-2968
2018,9,26,15,15600,15369,12421,-2948
2018,9,26,16,15910,15593,12616,-2977
2018,9,26,17,16070,15811,12680,-3131
2018,9,26,18,16260,16054,13227,-2827
2018,9,26,19,16570,16134,13469,-2665
2018,9,26,20,16820,16343,13924,-2419
2018,9,26,21,17110,16681,14178,-2503
2018,9,26,22,17540,17056,13987,-3069
2018,9,26,23,17920,17304,14363,-2941
2018,9,27,0,18250,17403,14635,-2768
2018,9,27,1,17070,16533,13973,-2560
2018,9,27,2,15840,15698,12989,-2709
2018,9,27,3,14360,14297,11650,-2647
2018,9,27,4,13020,12915,10324,-2591
2018,9,27,5,11710,12211,9651,-2560
2018,9,27,6,10970,11710,9217,-2493
2018,9,27,7,10690,11514,8860,-2654
2018,9,27,8,10450,11295,8612,-2683
2018,9,27,9,10510,11326,8459,-2867
2018,9,27,10,11320,11799,9058,-2741
2018,9,27,11,12880,12773,10185,-2588
2018,9,27,12,13750,13513,10830,-2683
2018,9,27,13,13920,13614,10790,-2824
2018,9,27,14,13500,13510,10676,-2834
2018,9,27,15,13460,13296,10219,-3077
2018,9,27,16,13470,13119,10039,-3080
2018,9,27,17,13470,13083,10259,-2824
2018,9,27,18,13710,13367,10721,-2646
2018,9,27,19,13820,13569,11038,-2531
2018,9,27,20,14020,13851,11472,-2379
2018,9,27,21,14350,14246,11746,-2500
2018,9,27,22,14720,14567,11818,-2749
2018,9,27,23,15000,14854,12035,-2819
2018,9,28,0,15230,15018,12280,-2738
2018,9,28,1,14410,14395,11512,-2883
2018,9,28,2,13360,13433,10180,-3253
2018,9,28,3,12150,12197,8878,-3319
2018,9,28,4,11040,11054,7969,-3085
2018,9,28,5,10390,10521,7532,-2989
2018,9,28,6,9970,10087,7359,-2728
2018,9,28,7,9740,9886,7130,-2756
2018,9,28,8,9550,10102,7207,-2895
2018,9,28,9,9780,10318,7353,-2965
2018,9,28,10,10650,11113,8116,-2997
2018,9,28,11,12190,12121,9416,-2705
2018,9,28,12,13200,13137,10299,-2838
2018,9,28,13,13550,13631,10901,-2730
2018,9,28,14,13900,13876,11346,-2530
2018,9,28,15,13950,13968,10810,-3158
2018,9,28,16,13920,13848,10645,-3203
2018,9,28,17,13850,13581,10594,-2987
2018,9,28,18,13850,13421,10239,-3182
2018,9,28,19,13770,13231,9781,-3450
2018,9,28,20,13750,13165,10038,-3127
2018,9,28,21,13910,13327,10293,-3034
2018,9,28,22,13920,13588,10555,-3033
2018,9,28,23,14220,13840,10758,-3082
2018,9,29,0,14250,13892,10896,-2996
2018,9,29,1,13520,13360,10140,-3220
2018,9,29,2,12650,12631,9061,-3570
2018,9,29,3,11650,11669,8241,-3428
2018,9,29,4,10720,10665,7468,-3197
2018,9,29,5,9900,9927,6388,-3539
2018,9,29,6,9440,9448,6053,-3395
2018,9,29,7,9200,9469,6131,-3338
2018,9,29,8,9110,9668,6476,-3192
2018,9,29,9,9190,9741,6451,-3290
2018,9,29,10,9540,10071,6824,-3247
2018,9,29,11,10110,10619,7353,-3266
2018,9,29,12,10770,11049,7736,-3313
2018,9,29,13,11240,11289,7999,-3290
2018,9,29,14,11270,11319,8169,-3150
2018,9,29,15,11240,11232,8131,-3101
2018,9,29,16,11170,11180,8180,-3000
2018,9,29,17,11030,11221,8244,-2977
2018,9,29,18,11040,11288,8298,-2990
2018,9,29,19,11100,11402,8392,-3010
2018,9,29,20,11360,11646,8724,-2922
2018,9,29,21,12050,12086,9158,-2928
2018,9,29,22,12720,12643,9776,-2867
2018,9,29,23,13090,13049,9763,-3286
2018,9,30,0,13350,13205,9862,-3343
2018,9,30,1,12770,12718,9484,-3234
2018,9,30,2,12040,12039,8715,-3324
2018,9,30,3,11190,11187,7565,-3622
2018,9,30,4,10310,10325,6783,-3542
2018,9,30,5,9600,9620,6309,-3311
2018,9,30,6,9140,9419,6282,-3137
2018,9,30,7,8890,9171,6173,-2998
2018,9,30,8,8770,9045,6130,-2915
2018,9,30,9,8820,9067,5952,-3115
2018,9,30,10,9010,9263,6025,-3238
2018,9,30,11,9310,9684,6369,-3315
2018,9,30,12,9760,9926,6725,-3201
2018,9,30,13,10180,10395,7155,-3240
2018,9,30,14,10400,10573,7659,-2914
2018,9,30,15,10530,10585,7484,-3101
2018,9,30,16,10640,10625,7736,-2889
2018,9,30,17,10800,10745,8164,-2581
2018,9,30,18,10890,10818,8282,-2536
2018,9,30,19,11170,10857,8436,-2421
2018,9,30,20,11510,11269,8963,-2306
2018,9,30,21,12160,11962,9529,-2433
2018,9,30,22,12830,12788,10077,-2711
2018,9,30,23,13370,13419,10659,-2760
2018,10,1,0,13600,13699,10506,-3193
2018,10,1,1,13080,13226,9898,-3328
2018,10,1,2,12090,12198,8786,-3412
2018,10,1,3,11050,11783,8393,-3390
2018,10,1,4,10100,11067,7651,-3416
2018,10,1,5,9470,10631,7096,-3535
2018,10,1,6,9200,10281,6589,-3692
2018,10,1,7,9060,10368,6673,-3695
2018,10,1,8,9090,10416,7185,-3231
2018,10,1,9,9400,10403,7743,-2660
2018,10,1,10,10340,11345,9188,-2157
2018,10,1,11,11970,12778,10869,-1909
2018,10,1,12,12980,13812,11995,-1817
2018,10,1,13,13260,13542,11850,-1692
2018,10,1,14,13360,13541,11888,-1653
2018,10,1,15,13420,13924,12206,-1718
2018,10,1,16,13520,14210,12413,-1797
2018,10,1,17,13540,14225,12455,-1770
2018,10,1,18,13690,14289,12361,-1928
2018,10,1,19,13740,14218,12306,-1912
2018,10,1,20,13840,14218,12372,-1846
2018,10,1,21,14040,14442,12709,-1733
2018,10,1,22,14420,14818,13038,-1780
2018,10,1,23,15000,15103,13503,-1600
2018,10,2,0,14940,14950,13343,-1607
2018,10,2,1,14170,14183,12501,-1682
2018,10,2,2,13050,13137,11262,-1875
2018,10,2,3,11770,11922,10149,-1773
2018,10,2,4,10670,11230,9287,-1943
2018,10,2,5,9900,10658,8438,-2220
2018,10,2,6,9490,10512,8264,-2248
2018,10,2,7,9290,10240,8046,-2194
2018,10,2,8,9380,10381,8364,-2017
2018,10,2,9,9650,10720,8754,-1966
2018,10,2,10,10580,11293,9352,-1941
2018,10,2,11,12240,12297,10464,-1833
2018,10,2,12,13210,13306,11375,-1931
2018,10,2,13,13540,13713,11755,-1958
2018,10,2,14,13710,13950,12112,-1838
2018,10,2,15,13810,14112,12385,-1727
2018,10,2,16,13810,14233,12363,-1870
2018,10,2,17,13800,14205,12305,-1900
2018,10,2,18,13950,14237,12228,-2009
2018,10,2,19,14000,14216,12344,-1872
2018,10,2,20,14070,14259,12455,-1804
2018,10,2,21,14310,14583,12761,-1822
2018,10,2,22,14660,15063,13213,-1850
2018,10,2,23,15100,15368,13494,-1874
2018,10,3,0,15080,15116,13386,-1730
2018,10,3,1,14520,14352,12501,-1851
2018,10,3,2,13480,13346,11280,-2066
2018,10,3,3,12220,12120,10098,-2022
2018,10,3,4,11100,11041,9042,-1999
2018,10,3,5,10300,10843,8561,-2282
2018,10,3,6,9870,10644,8418,-2226
2018,10,3,7,9640,10440,8010,-2430
2018,10,3,8,9570,10360,7835,-2525
2018,10,3,9,9820,10394,7950,-2444
2018,10,3,10,10710,11174,8790,-2384
2018,10,3,11,12370,12344,10200,-2144
2018,10,3,12,13360,13352,11212,-2140
2018,10,3,13,13590,13592,11390,-2202
2018,10,3,14,13600,13713,11530,-2183
2018,10,3,15,13540,13859,11641,-2218
2018,10,3,16,13540,13929,11782,-2147
2018,10,3,17,13590,13786,11655,-2131
2018,10,3,18,13740,13713,11590,-2123
2018,10,3,19,13790,13708,11668,-2040
2018,10,3,20,13930,13898,12067,-1831
2018,10,3,21,14270,14159,12216,-1943
2018,10,3,22,14640,14497,12642,-1855
2018,10,3,23,15190,14969,12842,-2127
2018,10,4,0,15120,14980,12945,-2035
2018,10,4,1,14450,14326,12089,-2237
2018,10,4,2,13330,13328,11043,-2285
2018,10,4,3,12040,12063,9817,-2246
2018,10,4,4,10910,10977,8773,-2204
2018,10,4,5,10190,10349,8532,-1817
2018,10,4,6,9730,10140,8367,-1773
2018,10,4,7,9480,10002,8044,-1958
2018,10,4,8,9410,10014,7851,-2163
2018,10,4,9,9670,10354,8114,-2240
2018,10,4,10,10610,10819,8571,-2248
2018,10,4,11,12300,12236,10011,-2225
2018,10,4,12,13240,13245,10996,-2249
2018,10,4,13,13470,13482,11345,-2137
2018,10,4,14,13570,13580,11591,-1989
2018,10,4,15,13720,13693,11858,-1835
2018,10,4,16,13690,13828,11913,-1915
2018,10,4,17,13830,13901,11824,-2077
2018,10,4,18,14050,14089,12006,-2083
2018,10,4,19,14110,14365,12360,-2005
2018,10,4,20,14220,14551,12373,-2178
2018,10,4,21,14410,14656,12478,-2178
2018,10,4,22,14720,14898,12765,-2133
2018,10,4,23,15300,15393,13158,-2235
2018,10,5,0,15320,15502,13281,-2221
2018,10,5,1,14720,14906,12729,-2177
2018,10,5,2,13760,13930,11650,-2280
2018,10,5,3,12480,12742,10479,-2263
2018,10,5,4,11320,11667,9501,-2166
2018,10,5,5,10760,11102,8846,-2256
2018,10,5,6,10170,10736,8437,-2299
2018,10,5,7,9800,10352,7959,-2393
2018,10,5,8,9640,10188,7770,-2418
2018,10,5,9,9790,10325,7965,-2360
2018,10,5,10,10560,10812,8542,-2270
2018,10,5,11,12010,11978,9789,-2189
2018,10,5,12,12840,12831,10611,-2220
2018,10,5,13,12820,12826,10630,-2196
2018,10,5,14,12510,12481,10351,-2130
2018,10,5,15,12390,12219,10195,-2024
2018,10,5,16,12340,12041,10096,-1945
2018,10,5,17,12220,11955,9956,-1999
2018,10,5,18,12250,11998,9946,-2052
2018,10,5,19,12320,12060,9986,-2074
2018,10,5,20,12600,12325,10197,-2128
2018,10,5,21,13070,12876,10622,-2254
2018,10,5,22,13520,13433,11256,-2177
2018,10,5,23,14200,13879,11751,-2128
2018,10,6,0,14040,13894,11753,-2141
2018,10,6,1,13350,13344,11152,-2192
2018,10,6,2,12640,12620,10594,-2026
2018,10,6,3,11550,11692,9629,-2063
2018,10,6,4,10540,10701,8640,-2061
2018,10,6,5,9910,9932,7970,-1962
2018,10,6,6,9450,9763,7731,-2032
2018,10,6,7,9210,10007,7839,-2168
2018,10,6,8,9110,9928,7741,-2187
2018,10,6,9,9200,9930,7726,-2204
2018,10,6,10,9510,10059,7911,-2148
2018,10,6,11,10160,10390,8444,-1946
2018,10,6,12,10840,10832,8973,-1859
2018,10,6,13,11500,11496,9788,-1708
2018,10,6,14,11880,11851,10250,-1601
2018,10,6,15,11830,11771,10119,-1652
2018,10,6,16,11750,11596,9879,-1717
2018,10,6,17,11580,11388,9609,-1779
2018,10,6,18,11460,11461,9705,-1756
2018,10,6,19,11500,11813,10026,-1787
2018,10,6,20,11780,11971,10240,-1731
2018,10,6,21,12060,12287,10519,-1768
2018,10,6,22,12610,12647,10796,-1851
2018,10,6,23,13310,13158,11396,-1762
2018,10,7,0,13400,13110,11405,-1705
2018,10,7,1,12630,12657,10387,-2270
2018,10,7,2,11920,12061,9601,-2460
2018,10,7,3,11110,11517,8749,-2768
2018,10,7,4,10310,10783,8010,-2773
2018,10,7,5,9790,10538,7511,-3027
2018,10,7,6,9400,10416,7345,-3071
2018,10,7,7,9180,10253,7156,-3097
2018,10,7,8,9060,10128,7001,-3127
2018,10,7,9,9090,10137,7003,-3134
2018,10,7,10,9320,10365,7317,-3048
2018,10,7,11,9810,10843,7969,-2874
2018,10,7,12,10420,11445,8748,-2697
2018,10,7,13,11220,11935,9394,-2541
2018,10,7,14,11870,12294,9812,-2482
2018,10,7,15,12290,12200,10026,-2174
2018,10,7,16,12630,12362,10118,-2244
2018,10,7,17,12880,12576,10256,-2320
2018,10,7,18,13030,12786,10385,-2401
2018,10,7,19,13150,12893,10520,-2373
2018,10,7,20,13380,13176,10801,-2375
2018,10,7,21,13790,13567,11150,-2417
2018,10,7,22,14290,14014,11556,-2458
2018,10,7,23,14900,14340,11844,-2496
2018,10,8,0,15300,14184,11721,-2463
2018,10,8,1,14330,13543,10970,-2573
2018,10,8,2,13320,12711,10062,-2649
2018,10,8,3,12150,11719,9123,-2596
2018,10,8,4,11130,10772,8078,-2694
2018,10,8,5,9780,10500,7793,-2707
2018,10,8,6,9310,10417,7583,-2834
2018,10,8,7,9160,10164,7285,-2879
2018,10,8,8,9110,10082,7132,-2950
2018,10,8,9,9310,10275,7320,-2955
2018,10,8,10,9980,10903,7915,-2988
2018,10,8,11,11080,11557,8954,-2603
2018,10,8,12,12080,12158,9668,-2490
2018,10,8,13,12870,12908,10216,-2692
2018,10,8,14,13400,13385,10809,-2576
2018,10,8,15,13660,13650,11297,-2353
2018,10,8,16,13570,13792,11240,-2552
2018,10,8,17,13520,13812,11121,-2691
2018,10,8,18,13610,13800,11176,-2624
2018,10,8,19,13650,13741,11207,-2534
2018,10,8,20,13360,13743,11258,-2485
2018,10,8,21,13940,13979,11773,-2206
2018,10,8,22,14240,14438,12163,-2275
2018,10,8,23,14990,14807,12425,-2382
2018,10,9,0,14740,14541,12090,-2451
2018,10,9,1,13830,13844,11067,-2777
2018,10,9,2,12820,12902,10122,-2780
2018,10,9,3,11630,11727,8858,-2869
2018,10,9,4,10560,10920,8043,-2877
2018,10,9,5,9990,10231,7215,-3016
2018,10,9,6,9620,10225,7107,-3118
2018,10,9,7,9370,10169,7025,-3144
2018,10,9,8,9480,10151,7011,-3140
2018,10,9,9,9780,10444,7323,-3121
2018,10,9,10,10810,11055,8075,-2980
2018,10,9,11,12550,12325,9530,-2795
2018,10,9,12,13510,13466,10561,-2905
2018,10,9,13,13760,13865,10982,-2883
2018,10,9,14,14000,14025,11141,-2884
2018,10,9,15,14200,13984,11037,-2947
2018,10,9,16,14280,14063,11107,-2956
2018,10,9,17,14430,14249,11554,-2695
2018,10,9,18,14790,14499,12165,-2334
2018,10,9,19,14920,14610,12356,-2254
2018,10,9,20,15140,14749,12484,-2265
2018,10,9,21,15410,15126,12936,-2190
2018,10,9,22,15770,15595,13300,-2295
2018,10,9,23,16310,16136,13507,-2629
2018,10,10,0,16340,16123,13561,-2562
2018,10,10,1,15670,15401,12716,-2685
2018,10,10,2,14540,14400,11477,-2923
2018,10,10,3,13160,13143,10308,-2835
2018,10,10,4,11970,11984,9290,-2694
2018,10,10,5,11290,11638,8884,-2754
2018,10,10,6,10790,11410,8716,-2694
2018,10,10,7,10480,11137,8263,-2874
2018,10,10,8,10410,11019,8094,-2925
2018,10,10,9,10670,11261,8299,-2962
2018,10,10,10,11620,12114,9188,-2926
2018,10,10,11,13340,13221,10630,-2591
2018,10,10,12,14340,14112,11348,-2764
2018,10,10,13,14540,14398,11600,-2798
2018,10,10,14,14500,14519,11857,-2662
2018,10,10,15,14760,14748,12171,-2577
2018,10,10,16,15060,14990,12268,-2722
2018,10,10,17,15450,15252,12456,-2796
2018,10,10,18,15950,15726,12993,-2733
2018,10,10,19,16120,16082,13671,-2411
2018,10,10,20,16540,16447,13936,-2511
2018,10,10,21,17030,16878,14337,-2541
2018,10,10,22,17430,17153,14362,-2791
2018,10,10,23,17610,17326,14333,-2993
2018,10,11,0,17540,17207,14161,-3046
2018,10,11,1,16820,16470,13336,-3134
2018,10,11,2,15380,15327,12234,-3093
2018,10,11,3,13920,13927,10997,-2930
2018,10,11,4,12660,12689,9847,-2842
2018,10,11,5,11740,12050,8941,-3109
2018,10,11,6,11160,11801,8783,-3018
2018,10,11,7,10890,11714,8784,-2930
2018,10,11,8,10720,11593,8486,-3107
2018,10,11,9,10850,11729,8708,-3021
2018,10,11,10,11890,12287,9473,-2814
2018,10,11,11,13680,13514,10765,-2749
2018,10,11,12,14660,14584,11843,-2741
2018,10,11,13,14990,14963,12257,-2706
2018,10,11,14,15300,15292,12692,-2600
2018,10,11,15,15450,15502,12908,-2594
2018,10,11,16,15550,15607,12867,-2740
2018,10,11,17,15620,15581,13234,-2347
2018,10,11,18,15670,15606,12686,-2920
2018,10,11,19,15600,15557,12594,-2963
2018,10,11,20,15600,15519,12648,-2871
2018,10,11,21,15800,15570,12701,-2869
2018,10,11,22,16110,15803,12841,-2962
2018,10,11,23,16430,16026,13004,-3022
2018,10,12,0,16600,15710,12607,-3103
2018,10,12,1,15820,15026,11792,-3234
2018,10,12,2,14800,14055,10895,-3160
2018,10,12,3,13520,12913,9855,-3058
2018,10,12,4,12380,11907,8964,-2943
2018,10,12,5,10780,11071,8142,-2929
2018,10,12,6,10260,10688,7602,-3086
2018,10,12,7,9970,10667,7527,-3140
2018,10,12,8,9830,10847,7785,-3062
2018,10,12,9,9990,11045,7991,-3054
2018,10,12,10,10800,11590,8519,-3071
2018,10,12,11,12400,12435,9706,-2729
2018,10,12,12,13490,13485,10728,-2757
2018,10,12,13,13860,13865,11233,-2632
2018,10,12,14,14000,14033,11359,-2674
2018,10,12,15,13910,14015,11312,-2703
2018,10,12,16,13740,13695,10946,-2749
2018,10,12,17,13540,13154,10315,-2839
2018,10,12,18,13460,12704,9829,-2875
2018,10,12,19,13320,12610,9689,-2921
2018,10,12,20,13310,12660,9751,-2909
2018,10,12,21,13400,13053,9741,-3312
2018,10,12,22,13600,13437,9938,-3499
2018,10,12,23,14200,13911,10370,-3541
2018,10,13,0,14080,13783,10334,-3449
2018,10,13,1,13480,13275,9759,-3516
2018,10,13,2,12670,12550,8965,-3585
2018,10,13,3,11750,11843,8218,-3625
2018,10,13,4,10800,11098,7476,-3622
2018,10,13,5,9960,10820,7471,-3349
2018,10,13,6,9530,10459,7352,-3107
2018,10,13,7,9280,10218,7034,-3184
2018,10,13,8,9190,10099,6907,-3192
2018,10,13,9,9330,10153,7030,-3123
2018,10,13,10,9640,10346,7420,-2926
2018,10,13,11,10370,10926,8123,-2803
2018,10,13,12,11130,11227,8713,-2514
2018,10,13,13,12010,11807,9242,-2565
2018,10,13,14,12640,12471,9627,-2844
2018,10,13,15,12960,12769,9774,-2995
2018,10,13,16,12960,12769,9776,-2993
2018,10,13,17,12840,12479,9372,-3107
2018,10,13,18,12660,12099,9114,-2985
2018,10,13,19,11670,11712,9094,-2618
2018,10,13,20,11780,11568,8752,-2816
2018,10,13,21,12030,11838,9094,-2744
2018,10,13,22,12510,12532,9941,-2591
2018,10,13,23,13400,13232,10724,-2508
2018,10,14,0,13490,13212,10617,-2595
2018,10,14,1,13050,12774,10364,-2410
2018,10,14,2,12360,12203,9626,-2577
2018,10,14,3,11490,11436,8678,-2758
2018,10,14,4,10590,10884,7946,-2938
2018,10,14,5,9890,10443,7535,-2908
2018,10,14,6,9430,9957,7304,-2653
2018,10,14,7,9220,9798,7172,-2626
2018,10,14,8,9110,9921,7278,-2643
2018,10,14,9,9140,9959,7267,-2692
2018,10,14,10,9390,10220,7531,-2689
2018,10,14,11,9880,10560,7734,-2826
2018,10,14,12,10450,10942,8093,-2849
2018,10,14,13,11010,11173,8259,-2914
2018,10,14,14,11350,11301,8499,-2802
2018,10,14,15,11220,10998,8186,-2812
2018,10,14,16,11200,10996,8277,-2719
2018,10,14,17,11080,10821,8124,-2697
2018,10,14,18,10630,10660,8042,-2618
2018,10,14,19,10610,10959,8464,-2495
2018,10,14,20,10770,11237,8755,-2482
2018,10,14,21,11320,11908,9449,-2459
2018,10,14,22,12220,12866,10162,-2704
2018,10,14,23,13390,13763,10791,-2972
2018,10,15,0,13380,13791,10657,-3134
2018,10,15,1,12850,13213,10107,-3106
2018,10,15,2,12000,12353,9500,-2853
2018,10,15,3,11000,11355,8598,-2757
2018,10,15,4,10110,10646,7645,-3001
2018,10,15,5,9760,10304,7291,-3013
2018,10,15,6,9370,9902,7260,-2642
2018,10,15,7,9240,10000,7301,-2699
2018,10,15,8,9280,10081,7434,-2647
2018,10,15,9,9640,10415,7593,-2822
2018,10,15,10,10630,11128,8060,-3068
2018,10,15,11,12400,12375,9525,-2850
2018,10,15,12,13470,13472,10495,-2977
2018,10,15,13,13870,13895,10876,-3019
2018,10,15,14,14200,14175,11265,-2910
2018,10,15,15,14290,14419,11615,-2804
2018,10,15,16,14220,14451,11592,-2859
2018,10,15,17,14200,14498,11643,-2855
2018,10,15,18,14190,14555,11621,-2934
2018,10,15,19,14120,14350,11341,-3009
2018,10,15,20,14210,14362,11206,-3156
2018,10,15,21,14260,14670,11488,-3182
2018,10,15,22,14450,15190,11979,-3211
2018,10,15,23,15000,15575,12422,-3153
2018,10,16,0,14780,15190,12014,-3176
2018,10,16,1,14090,14446,11061,-3385
2018,10,16,2,13000,13402,10109,-3293
2018,10,16,3,11790,12158,9034,-3124
2018,10,16,4,10720,11291,8147,-3144
2018,10,16,5,10210,11323,8122,-3201
2018,10,16,6,9700,11048,7886,-3162
2018,10,16,7,9430,10766,7823,-2943
2018,10,16,8,9380,10698,7834,-2864
2018,10,16,9,9630,10906,7883,-3023
2018,10,16,10,10540,11398,8242,-3156
2018,10,16,11,12300,12565,9455,-3110
2018,10,16,12,13220,13254,10076,-3178
2018,10,16,13,13010,13048,10068,-2980
2018,10,16,14,12510,12513,9653,-2860
2018,10,16,15,12270,12187,9428,-2759
2018,10,16,16,12080,12027,9485,-2542
2018,10,16,17,11970,11774,9405,-2369
2018,10,16,18,11950,12036,9609,-2427
2018,10,16,19,12040,12081,9527,-2554
2018,10,16,20,12390,12395,9588,-2807
2018,10,16,21,13060,12918,10059,-2859
2018,10,16,22,13880,13792,10662,-3130
2018,10,16,23,14750,14698,11662,-3036
2018,10,17,0,14420,14683,11737,-2946
2018,10,17,1,13900,14055,10874,-3181
2018,10,17,2,12930,13130,10236,-2894
2018,10,17,3,11690,12034,9034,-3000
2018,10,17,4,10620,11176,8002,-3174
2018,10,17,5,10170,10808,7488,-3320
2018,10,17,6,9800,10612,7437,-3175
2018,10,17,7,9620,10438,7120,-3318
2018,10,17,8,9630,10432,7189,-3243
2018,10,17,9,9970,10649,7342,-3307
2018,10,17,10,10970,11442,8314,-3128
2018,10,17,11,12780,12751,9822,-2929
2018,10,17,12,13760,13759,10983,-2776
2018,10,17,13,13510,13549,10839,-2710
2018,10,17,14,13060,13055,10444,-2611
2018,10,17,15,12780,12607,10224,-2383
2018,10,17,16,12530,12509,9931,-2578
2018,10,17,17,12320,12390,9766,-2624
2018,10,17,18,12230,12574,9983,-2591
2018,10,17,19,12280,12788,10247,-2541
2018,10,17,20,12630,13110,10464,-2646
2018,10,17,21,13040,13647,10998,-2649
2018,10,17,22,13850,14242,11521,-2721
2018,10,17,23,14800,14934,12281,-2653
2018,10,18,0,14600,14837,12222,-2615
2018,10,18,1,14100,14270,11860,-2410
2018,10,18,2,13260,13367,10576,-2791
2018,10,18,3,12090,12365,9330,-3035
2018,10,18,4,11060,11610,8508,-3102
2018,10,18,5,10290,11245,7815,-3430
2018,10,18,6,9890,11100,7620,-3480
2018,10,18,7,9750,10944,7470,-3474
2018,10,18,8,9810,10945,7742,-3203
2018,10,18,9,10190,10958,7829,-3129
2018,10,18,10,11180,11829,8891,-2938
2018,10,18,11,13070,13054,10157,-2897
2018,10,18,12,13880,14032,11030,-3002
2018,10,18,13,13630,13816,11146,-2670
2018,10,18,14,13220,13258,10618,-2640
2018,10,18,15,12790,12733,10099,-2634
2018,10,18,16,12510,12687,9760,-2927
2018,10,18,17,12390,12366,9367,-2999
2018,10,18,18,12300,12101,9089,-3012
2018,10,18,19,12400,12181,9013,-3168
2018,10,18,20,12730,12762,9585,-3177
2018,10,18,21,13290,13453,10139,-3314
2018,10,18,22,14360,14350,11165,-3185
2018,10,18,23,15250,15247,12456,-2791
2018,10,19,0,15150,15271,12742,-2529
2018,10,19,1,14540,14775,11523,-3252
2018,10,19,2,13670,13903,10680,-3223
2018,10,19,3,12500,12737,9592,-3145
2018,10,19,4,11440,11666,8752,-2914
2018,10,19,5,10760,10924,7607,-3317
2018,10,19,6,10340,10681,7633,-3048
2018,10,19,7,10160,10566,7490,-3076
2018,10,19,8,10140,10576,7465,-3111
2018,10,19,9,10450,10903,7925,-2978
2018,10,19,10,11430,11593,8701,-2892
2018,10,19,11,13250,13358,10457,-2901
2018,10,19,12,14100,14295,11416,-2879
2018,10,19,13,13840,14054,11324,-2730
2018,10,19,14,13350,13359,10663,-2696
2018,10,19,15,12930,12769,10181,-2588
2018,10,19,16,12590,12323,9915,-2408
2018,10,19,17,12360,12025,9597,-2428
2018,10,19,18,12310,11961,9571,-2390
2018,10,19,19,12320,11967,9531,-2436
2018,10,19,20,12500,12262,9975,-2287
2018,10,19,21,12990,12915,10455,-2460
2018,10,19,22,13600,13640,11177,-2463
2018,10,19,23,14090,14276,11911,-2365
2018,10,20,0,13890,14055,11537,-2518
2018,10,20,1,13420,13536,10909,-2627
2018,10,20,2,12670,12851,10074,-2777
2018,10,20,3,11720,11914,8796,-3118
2018,10,20,4,10750,10901,7834,-3067
2018,10,20,5,10160,10520,7452,-3068
2018,10,20,6,9700,10220,7412,-2808
2018,10,20,7,9450,10242,7277,-2965
2018,10,20,8,9320,10132,7336,-2796
2018,10,20,9,9410,10448,7520,-2928
2018,10,20,10,9760,10619,7723,-2896
2018,10,20,11,10480,10868,7971,-2897
2018,10,20,12,11300,11425,8490,-2935
2018,10,20,13,12080,12078,9213,-2865
2018,10,20,14,12460,12433,9602,-2831
2018,10,20,15,12380,12293,9542,-2751
2018,10,20,16,12270,11957,8942,-3015
2018,10,20,17,12100,11837,9071,-2766
2018,10,20,18,11970,11597,8882,-2715
2018,10,20,19,11820,11653,8877,-2776
2018,10,20,20,12010,11729,8813,-2916
2018,10,20,21,12570,12161,9305,-2856
2018,10,20,22,13230,12563,9706,-2857
2018,10,20,23,13600,13205,10158,-3047
2018,10,21,0,13320,13047,10108,-2939
2018,10,21,1,12810,12597,9879,-2718
2018,10,21,2,12170,12021,9472,-2549
2018,10,21,3,11400,11270,8539,-2731
2018,10,21,4,10570,10466,7605,-2861
2018,10,21,5,9670,10116,7154,-2962
2018,10,21,6,9290,9930,7109,-2821
2018,10,21,7,9020,9727,7032,-2695
2018,10,21,8,8970,9633,6985,-2648
2018,10,21,9,8980,9684,7027,-2657
2018,10,21,10,9210,9922,7048,-2874
2018,10,21,11,9770,10210,7778,-2432
2018,10,21,12,10480,10920,8326,-2594
2018,10,21,13,11230,11537,9043,-2494
2018,10,21,14,12070,12084,9682,-2402
2018,10,21,15,12160,12209,9904,-2305
2018,10,21,16,11920,11939,9642,-2297
2018,10,21,17,11800,11753,9475,-2278
2018,10,21,18,11590,11687,9447,-2240
2018,10,21,19,11610,11616,9222,-2394
2018,10,21,20,11910,11812,9304,-2508
2018,10,21,21,12430,12536,9696,-2840
2018,10,21,22,13390,13653,11053,-2600
2018,10,21,23,14240,14524,12142,-2382
2018,10,22,0,14130,14411,12110,-2301
2018,10,22,1,13580,13930,11129,-2801
2018,10,22,2,12740,13104,10049,-3055
2018,10,22,3,11850,12285,9500,-2785
2018,10,22,4,10960,11418,8503,-2915
2018,10,22,5,10520,11094,7930,-3164
2018,10,22,6,10230,10954,7686,-3268
2018,10,22,7,10120,10945,7851,-3094
2018,10,22,8,10200,11010,7958,-3052
2018,10,22,9,10630,11596,8605,-2991
2018,10,22,10,11690,12379,9769,-2610
2018,10,22,11,13620,13551,11763,-1788
2018,10,22,12,14540,14560,13478,-1082
2018,10,22,13,14190,14308,12951,-1357
2018,10,22,14,13650,13723,11892,-1831
2018,10,22,15,13190,13304,11447,-1857
2018,10,22,16,12820,13076,11009,-2067
2018,10,22,17,12490,13088,11255,-1833
2018,10,22,18,12350,13232,11260,-1972
2018,10,22,19,12490,13183,10772,-2411
2018,10,22,20,12890,13417,10734,-2683
2018,10,22,21,13540,14017,11098,-2919
2018,10,22,22,14400,14876,11571,-3305
2018,10,22,23,15240,15585,12220,-3365
2018,10,23,0,14940,15343,12205,-3138
2018,10,23,1,14480,14673,11356,-3317
2018,10,23,2,13580,13686,10557,-3129
2018,10,23,3,12330,12443,9250,-3193
2018,10,23,4,11240,11355,7822,-3533
2018,10,23,5,10680,10767,7629,-3138
2018,10,23,6,10300,10823,7699,-3124
2018,10,23,7,10140,10681,7672,-3009
2018,10,23,8,10110,10624,7576,-3048
2018,10,23,9,10370,11157,8057,-3100
2018,10,23,10,11370,11968,8930,-3038
2018,10,23,11,13220,13246,10434,-2812
2018,10,23,12,14150,14175,11344,-2831
2018,10,23,13,14000,14177,11448,-2729
2018,10,23,14,13910,13936,11531,-2405
2018,10,23,15,13640,13769,11324,-2445
2018,10,23,16,13410,14027,11323,-2704
2018,10,23,17,13300,13999,11273,-2726
2018,10,23,18,13220,13957,10952,-3005
2018,10,23,19,13200,13875,10909,-2966
2018,10,23,20,13300,13882,10762,-3120
2018,10,23,21,13730,14176,11094,-3082
2018,10,23,22,14430,14616,11582,-3034
2018,10,23,23,15120,15219,12148,-3071
2018,10,24,0,14880,14946,12351,-2595
2018,10,24,1,14210,14301,11380,-2921
2018,10,24,2,13200,13489,10448,-3041
2018,10,24,3,11970,12482,9532,-2950
2018,10,24,4,10900,11492,8726,-2766
2018,10,24,5,10460,11423,8254,-3169
2018,10,24,6,10050,11131,8139,-2992
2018,10,24,7,9850,10929,8128,-2801
2018,10,24,8,9820,10898,8007,-2891
2018,10,24,9,10130,11218,8147,-3071
2018,10,24,10,11140,12130,8953,-3177
2018,10,24,11,13050,13085,10166,-2919
2018,10,24,12,14160,13975,11116,-2859
2018,10,24,13,13910,14046,10926,-3120
2018,10,24,14,13870,13951,10781,-3170
2018,10,24,15,13630,14013,11062,-2951
2018,10,24,16,13490,14035,11029,-3006
2018,10,24,17,13380,13877,10851,-3026
2018,10,24,18,13400,13767,10792,-2975
2018,10,24,19,13390,13754,10812,-2942
2018,10,24,20,13530,13740,10900,-2840
2018,10,24,21,13910,13956,11013,-2943
2018,10,24,22,14540,14657,11632,-3025
2018,10,24,23,15200,15412,12717,-2695
2018,10,25,0,15020,15260,12636,-2624
2018,10,25,1,14410,14735,12061,-2674
2018,10,25,2,13470,13820,11007,-2813
2018,10,25,3,12280,12973,9946,-3027
2018,10,25,4,11240,12088,9024,-3064
2018,10,25,5,10820,11616,8737,-2879
2018,10,25,6,10430,11328,8504,-2824
2018,10,25,7,10270,11321,8482,-2839
2018,10,25,8,10250,11320,8487,-2833
2018,10,25,9,10570,11407,8821,-2586
2018,10,25,10,11590,12128,9543,-2585
2018,10,25,11,13400,13461,11194,-2267
2018,10,25,12,14300,14466,12301,-2165
2018,10,25,13,14170,14421,12244,-2177
2018,10,25,14,13760,13991,11789,-2202
2018,10,25,15,13410,13477,11222,-2255
2018,10,25,16,13190,13140,10997,-2143
2018,10,25,17,13000,12877,10875,-2002
2018,10,25,18,12930,12826,10813,-2013
2018,10,25,19,12890,12771,10686,-2085
2018,10,25,20,13080,13070,11022,-2048
2018,10,25,21,13600,13778,11542,-2236
2018,10,25,22,14480,14718,12524,-2194
2018,10,25,23,15500,15503,13346,-2157
2018,10,26,0,15190,15355,13150,-2205
2018,10,26,1,14660,14849,12597,-2252
2018,10,26,2,13770,13974,11782,-2192
2018,10,26,3,12590,12788,10222,-2566
2018,10,26,4,11530,11700,8727,-2973
2018,10,26,5,10990,11269,8347,-2922
2018,10,26,6,10640,10926,8064,-2862
2018,10,26,7,10490,10778,8061,-2717
2018,10,26,8,10530,10804,7977,-2827
2018,10,26,9,10910,11171,8246,-2925
2018,10,26,10,11940,11920,8766,-3154
2018,10,26,11,13760,13721,10664,-3057
2018,10,26,12,14720,14703,12115,-2588
2018,10,26,13,14540,14571,12069,-2502
2018,10,26,14,14080,14089,11400,-2689
2018,10,26,15,13700,13687,11454,-2233
2018,10,26,16,13360,13137,10968,-2169
2018,10,26,17,13140,12705,10673,-2032
2018,10,26,18,13050,12498,10593,-1905
2018,10,26,19,13040,12509,10512,-1997
2018,10,26,20,13230,12830,10893,-1937
2018,10,26,21,13570,13448,11228,-2220
2018,10,26,22,14160,14225,11686,-2539
2018,10,26,23,14900,14894,12443,-2451
2018,10,27,0,14430,14654,12106,-2548
2018,10,27,1,13870,14186,11372,-2814
2018,10,27,2,13130,13500,10650,-2850
2018,10,27,3,12180,12572,9543,-3029
2018,10,27,4,11230,11674,9177,-2497
2018,10,27,5,10990,11019,9418,-1601
2018,10,27,6,10550,10570,8868,-1702
2018,10,27,7,10230,10254,8248,-2006
2018,10,27,8,10060,10066,7346,-2720
2018,10,27,9,10100,10104,7450,-2654
2018,10,27,10,10450,10637,7971,-2666
2018,10,27,11,11120,11396,8999,-2397
2018,10,27,12,11950,12123,9759,-2364
2018,10,27,13,12840,12835,10530,-2305
2018,10,27,14,13650,13589,11545,-2044
2018,10,27,15,13730,14075,12312,-1763
2018,10,27,16,13790,14292,12349,-1943
2018,10,27,17,13670,14249,11691,-2558
2018,10,27,18,13580,14107,11494,-2613
2018,10,27,19,13570,13957,11358,-2599
2018,10,27,20,13590,13904,11304,-2600
2018,10,27,21,13650,14040,11392,-2648
2018,10,27,22,13990,14354,11770,-2584
2018,10,27,23,14500,14507,11633,-2874
2018,10,28,0,13880,14039,11362,-2677
2018,10,28,1,13240,13467,10804,-2663
2018,10,28,2,12550,12771,10127,-2644
2018,10,28,3,11750,11954,9074,-2880
2018,10,28,4,10900,11158,8015,-3143
2018,10,28,5,10450,10762,7371,-3391
2018,10,28,6,9980,10528,6945,-3583
2018,10,28,7,9680,10229,7001,-3228
2018,10,28,8,9570,10327,7021,-3306
2018,10,28,9,9610,10402,7116,-3286
2018,10,28,10,9850,10346,7141,-3205
2018,10,28,11,10330,10860,7624,-3236
2018,10,28,12,11020,11531,8167,-3364
2018,10,28,13,11730,12001,8748,-3253
2018,10,28,14,12350,12270,9224,-3046
2018,10,28,15,12570,12471,9342,-3129
2018,10,28,16,12530,12492,9340,-3152
2018,10,28,17,12450,12430,9337,-3093
2018,10,28,18,12360,12355,9159,-3196
2018,10,28,19,12350,12346,9468,-2878
2018,10,28,20,12470,12528,9611,-2917
2018,10,28,21,12940,13019,9922,-3097
2018,10,28,22,13600,13782,10514,-3268
2018,10,28,23,14500,14345,11081,-3264
2018,10,29,0,14120,14026,10805,-3221
2018,10,29,1,13460,13432,10443,-2989
2018,10,29,2,12520,12585,9318,-3267
2018,10,29,3,11490,11797,8413,-3384
2018,10,29,4,10580,11268,7709,-3559
2018,10,29,5,10010,10584,7103,-3481
2018,10,29,6,9610,10408,6893,-3515
2018,10,29,7,9420,10247,6698,-3549
2018,10,29,8,9430,10238,6735,-3503
2018,10,29,9,9780,10576,7101,-3475
2018,10,29,10,10790,11371,7887,-3484
2018,10,29,11,12540,12766,9484,-3282
2018,10,29,12,13670,13660,10660,-3000
2018,10,29,13,13980,14001,11467,-2534
2018,10,29,14,14120,14124,11263,-2861
2018,10,29,15,14050,13884,11342,-2542
2018,10,29,16,13910,13950,10986,-2964
2018,10,29,17,13770,13839,10863,-2976
2018,10,29,18,13740,13862,10873,-2989
2018,10,29,19,13720,13712,10707,-3005
2018,10,29,20,13790,13645,10591,-3054
2018,10,29,21,14040,13832,10938,-2894
2018,10,29,22,14620,14534,11705,-2829
2018,10,29,23,15500,15135,12448,-2687
2018,10,30,0,15010,14839,12171,-2668
2018,10,30,1,14270,14243,11548,-2695
2018,10,30,2,13220,13303,10544,-2759
2018,10,30,3,12020,12168,9359,-2809
2018,10,30,4,10970,11368,8158,-3210
2018,10,30,5,10360,11167,7891,-3276
2018,10,30,6,9990,11037,7764,-3273
2018,10,30,7,9820,10853,7618,-3235
2018,10,30,8,9830,10837,7611,-3226
2018,10,30,9,10180,11173,8086,-3087
2018,10,30,10,11210,12074,9166,-2908
2018,10,30,11,13010,13059,10521,-2538
2018,10,30,12,14030,14024,11614,-2410
2018,10,30,13,13880,13899,11191,-2708
2018,10,30,14,13390,13391,10927,-2464
2018,10,30,15,13110,13166,10723,-2443
2018,10,30,16,12920,13189,10776,-2413
2018,10,30,17,12840,13234,10699,-2535
2018,10,30,18,12800,13334,10440,-2894
2018,10,30,19,12770,13228,10354,-2874
2018,10,30,20,12970,13254,10464,-2790
2018,10,30,21,13590,13679,10956,-2723
2018,10,30,22,14510,14571,11882,-2689
2018,10,30,23,15500,15386,13071,-2315
2018,10,31,0,15120,15190,13009,-2181
2018,10,31,1,14540,14652,12383,-2269
2018,10,31,2,13590,13779,11261,-2518
2018,10,31,3,12390,12582,9914,-2668
2018,10,31,4,11330,11509,8597,-2912
2018,10,31,5,10820,11100,7958,-3142
2018,10,31,6,10480,10784,7663,-3121
2018,10,31,7,10320,10844,7656,-3188
2018,10,31,8,10350,10854,7584,-3270
2018,10,31,9,10740,11134,7895,-3239
2018,10,31,10,11830,11846,8704,-3142
2018,10,31,11,13720,13666,11037,-2629
2018,10,31,12,14720,14717,12069,-2648
2018,10,31,13,14490,14517,11859,-2658
2018,10,31,14,14010,13976,11371,-2605
2018,10,31,15,13640,13817,11227,-2590
2018,10,31,16,13470,13705,11415,-2290
2018,10,31,17,13380,13225,10875,-2350
2018,10,31,18,13330,13044,10660,-2384
2018,10,31,19,13260,12845,10461,-2384
2018,10,31,20,13330,13106,10669,-2437
2018,10,31,21,13740,13706,11357,-2349
2018,10,31,22,14510,14243,11995,-2248
2018,10,31,23,15220,14422,12267,-2155
2018,11,1,0,14860,14064,12138,-1926
2018,11,1,1,14210,13695,11615,-2080
2018,11,1,2,13260,12992,10550,-2442
2018,11,1,3,12010,11855,9110,-2745
2018,11,1,4,10910,10825,7972,-2853
2018,11,1,5,10240,10580,7551,-3029
2018,11,1,6,9790,10521,7300,-3221
2018,11,1,7,9570,10178,7192,-2986
2018,11,1,8,9520,10289,7107,-3182
2018,11,1,9,9800,10542,7374,-3168
2018,11,1,10,10820,11118,8014,-3104
2018,11,1,11,12590,12426,9904,-2522
2018,11,1,12,13670,13493,11242,-2251
2018,11,1,13,13760,13683,11033,-2650
2018,11,1,14,13700,13685,11641,-2044
2018,11,1,15,13650,13754,11756,-1998
2018,11,1,16,13600,13607,11650,-1957
2018,11,1,17,13620,13275,11361,-1914
2018,11,1,18,13650,13400,11289,-2111
2018,11,1,19,13650,13457,11262,-2195
2018,11,1,20,13670,13549,11523,-2026
2018,11,1,21,14120,13899,11589,-2310
2018,11,1,22,14650,14539,12025,-2514
2018,11,1,23,14990,14904,12608,-2296
2018,11,2,0,14600,14555,12145,-2410
2018,11,2,1,13960,13923,11419,-2504
2018,11,2,2,12970,12982,10262,-2720
2018,11,2,3,11790,11784,9003,-2781
2018,11,2,4,10710,10960,7742,-3218
2018,11,2,5,10020,10290,7062,-3228
2018,11,2,6,9570,10115,6923,-3192
2018,11,2,7,9350,10147,6906,-3241
2018,11,2,8,9360,10137,6902,-3235
2018,11,2,9,9610,10415,7177,-3238
2018,11,2,10,10520,11041,7970,-3071
2018,11,2,11,12240,12587,9818,-2769
2018,11,2,12,13440,13787,11269,-2518
2018,11,2,13,13700,13991,11860,-2131
2018,11,2,14,14270,14261,11848,-2413
2018,11,2,15,14260,14413,11765,-2648
2018,11,2,16,14270,14451,11853,-2598
2018,11,2,17,14180,14326,11848,-2478
2018,11,2,18,14210,14278,11624,-2654
2018,11,2,19,14060,14080,11316,-2764
2018,11,2,20,14190,13994,11359,-2635
2018,11,2,21,14330,14128,11512,-2616
2018,11,2,22,14460,14520,11886,-2634
2018,11,2,23,14600,14613,11793,-2820
2018,11,3,0,14180,14112,11451,-2661
2018,11,3,1,13530,13524,11020,-2504
2018,11,3,2,12720,12765,10272,-2493
2018,11,3,3,11800,11817,9191,-2626
2018,11,3,4,10870,10859,7857,-3002
2018,11,3,5,10010,10153,7514,-2639
2018,11,3,6,9570,10303,7437,-2866
2018,11,3,7,9310,10487,7529,-2958
2018,11,3,8,9130,10325,7439,-2886
2018,11,3,9,9140,10494,7418,-3076
2018,11,3,10,9430,10893,7713,-3180
2018,11,3,11,10110,11431,8246,-3185
2018,11,3,12,10950,11927,8936,-2991
2018,11,3,13,11760,12435,9581,-2854
2018,11,3,14,12450,12652,9723,-2929
2018,11,3,15,12620,12978,10241,-2737
2018,11,3,16,13040,13007,10119,-2888
2018,11,3,17,13000,12796,9780,-3016
2018,11,3,18,12960,12237,9270,-2967
2018,11,3,19,12830,12025,9254,-2771
2018,11,3,20,12870,11914,9261,-2653
2018,11,3,21,12970,12222,9537,-2685
2018,11,3,22,13170,12922,10173,-2749
2018,11,3,23,13400,13470,10827,-2643
2018,11,4,0,13250,13171,10629,-2542
2018,11,4,1,12790,12751,10005,-2746
2018,11,4,2,12170,12211,9579,-2632
2018,11,4,3,11400,11509,8999,-2510
2018,11,4,4,10610,10722,8043,-2679
2018,11,4,5,9910,10487,7385,-3102
2018,11,4,6,9500,10389,7288,-3101
2018,11,4,7,9500,10389,7331,-3058
2018,11,4,8,9320,10043,7054,-2989
2018,11,4,9,9370,10373,7293,-3080
2018,11,4,10,9410,10061,7204,-2857
2018,11,4,11,9690,10187,7453,-2734
2018,11,4,12,10180,10549,7831,-2718
2018,11,4,13,10650,11095,8424,-2671
2018,11,4,14,11040,11270,8587,-2683
2018,11,4,15,11280,11160,8523,-2637
2018,11,4,16,11240,10934,8457,-2477
2018,11,4,17,11220,10761,8209,-2552
2018,11,4,18,11220,10780,8335,-2445
2018,11,4,19,11160,10930,8352,-2578
2018,11,4,20,11310,11355,8532,-2823
2018,11,4,21,11770,12141,9221,-2920
2018,11,4,22,12760,13347,10345,-3002
2018,11,4,23,13800,14500,11509,-2991
2018,11,5,0,14200,14394,11351,-3043
2018,11,5,1,13890,13950,10912,-3038
2018,11,5,2,13390,13360,10293,-3067
2018,11,5,3,12510,12456,9699,-2757
2018,11,5,4,11530,11523,8593,-2930
2018,11,5,5,10630,10972,7826,-3146
2018,11,5,6,10150,10706,7506,-3200
2018,11,5,7,9840,10437,7252,-3185
2018,11,5,8,9730,10527,7352,-3175
2018,11,5,9,9770,10580,7327,-3253
2018,11,5,10,10210,10699,7569,-3130
2018,11,5,11,11300,11547,8654,-2893
2018,11,5,12,13330,13022,10796,-2226
2018,11,5,13,14250,13991,11589,-2402
2018,11,5,14,14230,14248,11739,-2509
2018,11,5,15,14350,14397,11818,-2579
2018,11,5,16,14210,14613,12216,-2397
2018,11,5,17,14180,14665,12451,-2214
2018,11,5,18,14040,14503,11950,-2553
2018,11,5,19,14140,14470,12000,-2470
2018,11,5,20,14250,14344,12011,-2333
2018,11,5,21,14500,14439,12149,-2290
2018,11,5,22,15110,15150,13153,-1997
2018,11,5,23,15920,15863,13576,-2287
2018,11,6,0,15610,15631,13263,-2368
2018,11,6,1,15030,15070,12508,-2562
2018,11,6,2,14240,14317,11753,-2564
2018,11,6,3,13110,13279,10689,-2590
2018,11,6,4,11880,12192,9532,-2660
2018,11,6,5,10850,11571,8766,-2805
2018,11,6,6,10180,10902,8043,-2859
2018,11,6,7,9810,10723,7876,-2847
2018,11,6,8,9620,10663,7723,-2940
2018,11,6,9,9630,11010,8043,-2967
2018,11,6,10,10000,11292,8442,-2850
2018,11,6,11,11050,11744,9116,-2628
2018,11,6,12,12800,12926,10305,-2621
2018,11,6,13,13710,13489,11153,-2336
2018,11,6,14,13810,13713,11481,-2232
2018,11,6,15,13810,13810,11617,-2193
2018,11,6,16,14040,13964,11444,-2520
2018,11,6,17,14180,14247,11969,-2278
2018,11,6,18,14190,14409,12161,-2248
2018,11,6,19,14250,14469,11948,-2521
2018,11,6,20,14210,14407,11810,-2597
2018,11,6,21,14370,14433,11873,-2560
2018,11,6,22,14990,14942,12346,-2596
2018,11,6,23,15600,15471,12889,-2582
2018,11,7,0,15350,15237,12718,-2519
2018,11,7,1,14800,14738,12285,-2453
2018,11,7,2,14050,14031,11679,-2352
2018,11,7,3,12960,13001,10621,-2380
2018,11,7,4,11720,11819,9419,-2400
2018,11,7,5,10710,10946,8732,-2214
2018,11,7,6,10040,10814,8662,-2152
2018,11,7,7,9640,10725,8312,-2413
2018,11,7,8,9440,10572,8056,-2516
2018,11,7,9,9440,10641,7969,-2672
2018,11,7,10,9810,11171,8571,-2600
2018,11,7,11,10770,11746,9315,-2431
2018,11,7,12,12410,12699,10418,-2281
2018,11,7,13,13130,13140,10542,-2598
2018,11,7,14,12930,12724,10187,-2537
2018,11,7,15,12350,12337,10140,-2197
2018,11,7,16,12070,12181,10010,-2171
2018,11,7,17,11950,12047,9908,-2139
2018,11,7,18,11840,12036,9947,-2089
2018,11,7,19,11930,12301,10286,-2015
2018,11,7,20,12140,12628,10525,-2103
2018,11,7,21,12950,13226,11027,-2199
2018,11,7,22,14140,14081,11685,-2396
2018,11,7,23,15340,15039,12885,-2154
2018,11,8,0,15150,14905,12584,-2321
2018,11,8,1,14520,14457,12005,-2452
2018,11,8,2,13760,13784,11479,-2305
2018,11,8,3,12690,12823,10542,-2281
2018,11,8,4,11350,11689,9489,-2200
2018,11,8,5,10330,11205,8948,-2257
2018,11,8,6,10010,10817,8590,-2227
2018,11,8,7,9670,10469,8072,-2397
2018,11,8,8,9530,10327,7943,-2384
2018,11,8,9,9570,10567,8015,-2552
2018,11,8,10,9960,10921,8479,-2442
2018,11,8,11,11070,11629,9449,-2180
2018,11,8,12,12770,12787,11129,-1658
2018,11,8,13,13500,13505,12111,-1394
2018,11,8,14,13270,13294,11864,-1430
2018,11,8,15,12640,12810,11401,-1409
2018,11,8,16,12270,12500,10861,-1639
2018,11,8,17,12060,12337,10595,-1742
2018,11,8,18,12060,12488,10583,-1905
2018,11,8,19,12160,12721,10899,-1822
2018,11,8,20,12320,13015,11154,-1861
2018,11,8,21,12980,13306,11688,-1618
2018,11,8,22,14180,14249,12062,-2187
2018,11,8,23,15320,15213,13244,-1969
2018,11,9,0,15240,15138,12974,-2164
2018,11,9,1,14720,14763,12490,-2273
2018,11,9,2,14130,14195,12254,-1941
2018,11,9,3,13380,13300,11672,-1628
2018,11,9,4,12030,12297,10701,-1596
2018,11,9,5,11060,11463,9926,-1537
2018,11,9,6,10470,11390,9061,-2329
2018,11,9,7,10130,11326,8669,-2657
2018,11,9,8,9990,11235,8493,-2742
2018,11,9,9,10040,11487,8910,-2577
2018,11,9,10,10440,11857,9015,-2842
2018,11,9,11,11580,12619,9697,-2922
2018,11,9,12,13260,13481,10806,-2675
2018,11,9,13,13860,13887,11015,-2872
2018,11,9,14,13580,13551,10600,-2951
2018,11,9,15,13340,13376,10837,-2539
2018,11,9,16,13300,13742,11392,-2350
2018,11,9,17,13280,13982,11676,-2306
2018,11,9,18,13290,13995,11715,-2280
2018,11,9,19,13420,14142,11852,-2290
2018,11,9,20,13670,14169,11680,-2489
2018,11,9,21,14120,14333,11673,-2660
2018,11,9,22,14860,14990,12145,-2845
2018,11,9,23,15610,15364,12861,-2503
2018,11,10,0,15220,15031,12497,-2534
2018,11,10,1,14550,14500,11789,-2711
2018,11,10,2,13920,13927,11385,-2542
2018,11,10,3,13080,13167,10659,-2508
2018,11,10,4,12130,12200,9723,-2477
2018,11,10,5,11200,11504,9063,-2441
2018,11,10,6,10530,11097,8258,-2839
2018,11,10,7,10080,10628,7977,-2651
2018,11,10,8,9810,10593,7854,-2739
2018,11,10,9,9690,10489,7859,-2630
2018,11,10,10,9790,10437,7747,-2690
2018,11,10,11,10190,10497,7746,-2751
2018,11,10,12,10900,11138,8211,-2927
2018,11,10,13,11660,11651,8869,-2782
2018,11,10,14,12380,12376,9577,-2799
2018,11,10,15,12760,12730,9859,-2871
2018,11,10,16,12730,12669,9560,-3109
2018,11,10,17,12520,12572,9373,-3199
2018,11,10,18,12320,12311,9100,-3211
2018,11,10,19,12230,12273,9117,-3156
2018,11,10,20,12330,12166,9278,-2888
2018,11,10,21,12910,12798,10116,-2682
2018,11,10,22,14120,13846,11254,-2592
2018,11,10,23,15030,14774,12398,-2376
2018,11,11,0,14870,14599,12096,-2503
2018,11,11,1,14270,14190,11584,-2606
2018,11,11,2,13620,13721,11269,-2452
2018,11,11,3,12910,13122,10753,-2369
2018,11,11,4,12090,12339,9995,-2344
2018,11,11,5,11360,11827,9384,-2443
2018,11,11,6,10960,11343,9033,-2310
2018,11,11,7,10600,11312,9101,-2211
2018,11,11,8,10410,11205,9238,-1967
2018,11,11,9,10350,10993,9193,-1800
2018,11,11,10,10460,10773,8963,-1810
2018,11,11,11,10790,10947,9005,-1942
2018,11,11,12,11310,11300,9502,-1798
2018,11,11,13,11760,11755,9781,-1974
2018,11,11,14,11910,11906,9812,-2094
2018,11,11,15,11900,11839,9619,-2220
2018,11,11,16,11770,11613,9498,-2115
2018,11,11,17,11610,11430,9538,-1892
2018,11,11,18,11680,11438,9933,-1505
2018,11,11,19,11730,11580,9928,-1652
2018,11,11,20,12000,12020,10152,-1868
2018,11,11,21,12760,12851,10623,-2228
2018,11,11,22,14260,14089,11752,-2337
2018,11,11,23,15410,15141,12982,-2159
2018,11,12,0,15200,14988,12894,-2094
2018,11,12,1,14830,14561,11966,-2595
2018,11,12,2,14220,14032,11171,-2861
2018,11,12,3,13330,13285,10390,-2895
2018,11,12,4,12360,12389,9497,-2892
2018,11,12,5,11500,11670,8679,-2991
2018,11,12,6,10910,11534,8578,-2956
2018,11,12,7,10590,11283,8405,-2878
2018,11,12,8,10470,11359,8287,-3072
2018,11,12,9,10510,11513,8383,-3130
2018,11,12,10,10900,11774,8579,-3195
2018,11,12,11,11780,12583,9412,-3171
2018,11,12,12,13100,13656,10677,-2979
2018,11,12,13,13780,14093,11421,-2672
2018,11,12,14,13700,13917,11140,-2777
2018,11,12,15,13490,13473,10408,-3065
2018,11,12,16,13240,13145,10117,-3028
2018,11,12,17,13010,12897,9866,-3031
2018,11,12,18,13020,12794,10231,-2563
2018,11,12,19,13110,13150,10408,-2742
2018,11,12,20,13400,13628,10855,-2773
2018,11,12,21,14040,14179,11304,-2875
2018,11,12,22,15110,15261,12135,-3126
2018,11,12,23,16000,16189,13158,-3031
2018,11,13,0,15830,15957,13085,-2872
2018,11,13,1,15350,15435,12291,-3144
2018,11,13,2,14670,14697,11626,-3071
2018,11,13,3,13700,13777,10714,-3063
2018,11,13,4,12560,12702,9672,-3030
2018,11,13,5,11600,11944,8855,-3089
2018,11,13,6,10880,11478,8458,-3020
2018,11,13,7,10430,11097,8230,-2867
2018,11,13,8,10230,10926,8032,-2894
2018,11,13,9,10210,10934,8068,-2866
2018,11,13,10,10520,11272,8418,-2854
2018,11,13,11,11460,12081,9229,-2852
2018,11,13,12,13110,13188,10650,-2538
2018,11,13,13,14130,14202,11678,-2524
2018,11,13,14,14540,14563,12085,-2478
2018,11,13,15,14770,14791,12110,-2681
2018,11,13,16,14840,14905,12098,-2807
2018,11,13,17,14890,14871,11960,-2911
2018,11,13,18,14790,14690,11756,-2934
2018,11,13,19,14750,14612,11590,-3022
2018,11,13,20,14680,14543,11632,-2911
2018,11,13,21,14770,14690,11809,-2881
2018,11,13,22,15510,15421,12338,-3083
2018,11,13,23,16260,16087,13042,-3045
2018,11,14,0,16070,15904,12705,-3199
2018,11,14,1,15530,15411,12303,-3108
2018,11,14,2,14900,14781,11632,-3149
2018,11,14,3,13980,13836,10947,-2889
2018,11,14,4,12880,12664,9800,-2864
2018,11,14,5,11860,11943,9066,-2877
2018,11,14,6,11100,11596,8498,-3098
2018,11,14,7,10830,11561,8351,-3210
2018,11,14,8,10610,11450,8363,-3087
2018,11,14,9,10710,11513,8511,-3002
2018,11,14,10,11220,11656,8656,-3000
2018,11,14,11,12240,12405,9183,-3222
2018,11,14,12,14050,14069,11221,-2848
2018,11,14,13,14890,14870,12234,-2636
2018,11,14,14,14740,14795,11945,-2850
2018,11,14,15,14360,14364,11026,-3338
2018,11,14,16,14090,13942,10581,-3361
2018,11,14,17,13840,13698,10392,-3306
2018,11,14,18,13790,13616,10499,-3117
2018,11,14,19,13910,14033,10904,-3129
2018,11,14,20,14170,14464,11300,-3164
2018,11,14,21,14750,15185,12154,-3031
2018,11,14,22,15950,16351,13455,-2896
2018,11,14,23,17070,17214,14454,-2760
2018,11,15,0,16940,17139,14259,-2880
2018,11,15,1,16500,16871,13999,-2872
2018,11,15,2,16030,16240,13309,-2931
2018,11,15,3,15010,15310,12169,-3141
2018,11,15,4,13820,14054,10785,-3269
2018,11,15,5,12730,13280,9765,-3515
2018,11,15,6,12280,12856,9499,-3357
2018,11,15,7,11940,12498,9191,-3307
2018,11,15,8,11810,12358,9079,-3279
2018,11,15,9,11850,12389,9062,-3327
2018,11,15,10,12260,12764,9432,-3332
2018,11,15,11,13350,13568,10231,-3337
2018,11,15,12,15120,15096,11985,-3111
2018,11,15,13,15890,15896,12956,-2940
2018,11,15,14,15930,15954,12936,-3018
2018,11,15,15,15920,15917,12912,-3005
2018,11,15,16,15640,15762,12618,-3144
2018,11,15,17,15440,15549,12150,-3399
2018,11,15,18,15250,15755,12368,-3387
2018,11,15,19,15180,15916,12638,-3278
2018,11,15,20,15370,15949,12683,-3266
2018,11,15,21,15500,16162,12991,-3171
2018,11,15,22,16480,16953,13920,-3033
2018,11,15,23,17350,17465,14618,-2847
2018,11,16,0,17050,17269,14299,-2970
2018,11,16,1,16520,16883,13644,-3239
2018,11,16,2,15750,16233,12827,-3406
2018,11,16,3,14710,15248,12039,-3209
2018,11,16,4,13490,14019,10710,-3309
2018,11,16,5,12400,12992,9456,-3536
2018,11,16,6,11860,12482,9121,-3361
2018,11,16,7,11360,12044,8741,-3303
2018,11,16,8,11220,12078,8857,-3221
2018,11,16,9,11130,12040,8851,-3189
2018,11,16,10,11350,12346,9196,-3150
2018,11,16,11,12250,12947,9853,-3094
2018,11,16,12,13890,14000,10926,-3074
2018,11,16,13,14790,14990,11668,-3322
2018,11,16,14,15020,15619,12493,-3126
2018,11,16,15,15620,15783,12574,-3209
2018,11,16,16,15500,15784,12367,-3417
2018,11,16,17,15350,15785,12416,-3369
2018,11,16,18,15220,15833,12466,-3367
2018,11,16,19,15230,15626,12279,-3347
2018,11,16,20,15280,15497,12199,-3298
2018,11,16,21,15490,15559,12289,-3270
2018,11,16,22,15850,16040,12803,-3237
2018,11,16,23,16500,16581,13277,-3304
2018,11,17,0,16130,16206,12708,-3498
2018,11,17,1,15580,15651,12388,-3263
2018,11,17,2,14900,15011,11788,-3223
2018,11,17,3,14150,14232,10886,-3346
2018,11,17,4,13180,13254,9938,-3316
2018,11,17,5,12210,12594,9263,-3331
2018,11,17,6,11530,12074,8884,-3190
2018,11,17,7,11080,11631,8502,-3129
2018,11,17,8,10860,11470,8379,-3091
2018,11,17,9,10780,11592,8473,-3119
2018,11,17,10,10920,11704,8704,-3000
2018,11,17,11,11330,12123,8994,-3129
2018,11,17,12,12020,12452,9472,-2980
2018,11,17,13,12720,12747,9764,-2983
2018,11,17,14,13180,13244,10209,-3035
2018,11,17,15,13230,13243,10126,-3117
2018,11,17,16,13080,13125,10091,-3034
2018,11,17,17,13000,13441,10322,-3119
2018,11,17,18,12710,13779,10683,-3096
2018,11,17,19,13100,13605,10550,-3055
2018,11,17,20,13210,13877,10819,-3058
2018,11,17,21,13570,13946,10920,-3026
2018,11,17,22,14400,14536,11464,-3072
2018,11,17,23,15100,15098,12073,-3025
2018,11,18,0,14960,14827,11721,-3106
2018,11,18,1,14530,14368,11228,-3140
2018,11,18,2,14020,13934,10682,-3252
2018,11,18,3,13390,13532,10245,-3287
2018,11,18,4,12610,12782,9520,-3262
2018,11,18,5,11830,12273,8962,-3311
2018,11,18,6,11120,12092,8664,-3428
2018,11,18,7,10660,11701,8487,-3214
2018,11,18,8,10420,11264,7956,-3308
2018,11,18,9,10330,11211,7995,-3216
2018,11,18,10,10440,11315,8105,-3210
2018,11,18,11,10760,11374,8214,-3160
2018,11,18,12,11370,11710,8473,-3237
2018,11,18,13,12000,11999,8928,-3071
2018,11,18,14,12650,12425,9202,-3223
2018,11,18,15,12980,12610,9329,-3281
2018,11,18,16,13100,12910,9705,-3205
2018,11,18,17,13140,13210,9978,-3232
2018,11,18,18,13250,13285,10018,-3267
2018,11,18,19,13390,13480,10244,-3236
2018,11,18,20,13590,13634,10341,-3293
2018,11,18,21,14020,14029,10752,-3277
2018,11,18,22,15280,15170,11952,-3218
2018,11,18,23,15950,15897,12639,-3258
2018,11,19,0,15790,15666,12406,-3260
2018,11,19,1,15340,15181,11897,-3284
2018,11,19,2,14780,14523,11150,-3373
2018,11,19,3,13770,13638,10213,-3425
2018,11,19,4,12570,12760,9292,-3468
2018,11,19,5,11570,12163,8809,-3354
2018,11,19,6,10990,11592,8580,-3012
2018,11,19,7,10680,11522,8362,-3160
2018,11,19,8,10560,11573,8365,-3208
2018,11,19,9,10640,11695,8414,-3281
2018,11,19,10,11050,12097,8832,-3265
2018,11,19,11,12100,13115,9810,-3305
2018,11,19,12,13840,14155,11063,-3092
2018,11,19,13,14880,14890,11809,-3081
2018,11,19,14,15170,15172,11852,-3320
2018,11,19,15,15200,15293,11831,-3462
2018,11,19,16,15320,15317,11964,-3353
2018,11,19,17,15320,15188,11773,-3415
2018,11,19,18,15250,14977,11644,-3333
2018,11,19,19,15230,14920,11485,-3435
2018,11,19,20,15160,14811,11258,-3553
2018,11,19,21,15310,15001,11543,-3458
2018,11,19,22,16020,15771,12292,-3479
2018,11,19,23,16650,16447,13081,-3366
2018,11,20,0,16450,16293,12826,-3467
2018,11,20,1,16030,15836,12248,-3588
2018,11,20,2,15370,15184,11502,-3682
2018,11,20,3,14390,14201,10523,-3678
2018,11,20,4,13100,13244,9760,-3484
2018,11,20,5,11950,12406,8895,-3511
2018,11,20,6,11200,11745,8140,-3605
2018,11,20,7,10780,11592,7943,-3649
2018,11,20,8,10600,11554,7854,-3700
2018,11,20,9,10620,11671,8115,-3556
2018,11,20,10,11010,11663,8241,-3422
2018,11,20,11,12010,12231,8953,-3278
2018,11,20,12,13720,13703,10510,-3193
2018,11,20,13,14840,14824,11589,-3235
2018,11,20,14,15240,15245,11713,-3532
2018,11,20,15,15480,15496,11912,-3584
2018,11,20,16,15400,15600,11960,-3640
2018,11,20,17,15200,15678,11981,-3697
2018,11,20,18,15130,15614,11905,-3709
2018,11,20,19,15250,15596,11830,-3766
2018,11,20,20,15340,15514,11781,-3733
2018,11,20,21,15600,15630,12077,-3553
2018,11,20,22,16520,16298,12814,-3484
2018,11,20,23,17150,16866,13384,-3482
2018,11,21,0,16970,16669,13142,-3527
2018,11,21,1,16430,16236,12593,-3643
2018,11,21,2,15610,15631,11926,-3705
2018,11,21,3,14590,14757,11146,-3611
2018,11,21,4,13360,13838,10202,-3636
2018,11,21,5,12290,12808,9211,-3597
2018,11,21,6,11810,12425,8731,-3694
2018,11,21,7,11450,12491,8778,-3713
2018,11,21,8,11260,12567,8914,-3653
2018,11,21,9,11320,12656,9046,-3610
2018,11,21,10,11680,12716,9155,-3561
2018,11,21,11,12640,13130,9606,-3524
2018,11,21,12,14140,14105,10664,-3441
2018,11,21,13,15000,15005,11609,-3396
2018,11,21,14,15230,15224,11736,-3488
2018,11,21,15,15310,15281,11511,-3770
2018,11,21,16,15200,15535,11821,-3714
2018,11,21,17,14780,15552,11832,-3720
2018,11,21,18,14510,15299,11566,-3733
2018,11,21,19,14490,15126,11568,-3558
2018,11,21,20,14660,14956,11325,-3631
2018,11,21,21,15110,15208,11597,-3611
2018,11,21,22,16180,16147,12507,-3640
2018,11,21,23,17000,16808,13223,-3585
2018,11,22,0,16880,16649,13119,-3530
2018,11,22,1,16510,16361,12701,-3660
2018,11,22,2,16040,15918,12368,-3550
2018,11,22,3,15140,15307,11824,-3483
2018,11,22,4,13960,14695,11102,-3593
2018,11,22,5,12930,13854,10266,-3588
2018,11,22,6,12610,13190,9569,-3621
2018,11,22,7,12300,12842,9233,-3609
2018,11,22,8,12110,12701,8861,-3840
2018,11,22,9,12100,12719,8870,-3849
2018,11,22,10,12350,12930,9189,-3741
2018,11,22,11,12830,13276,9611,-3665
2018,11,22,12,13420,13705,10075,-3630
2018,11,22,13,14250,14451,10692,-3759
2018,11,22,14,15040,15053,11428,-3625
2018,11,22,15,15390,15359,11208,-4151
2018,11,22,16,15850,15491,11541,-3950
2018,11,22,17,15820,15526,11597,-3929
2018,11,22,18,15500,15153,11168,-3985
2018,11,22,19,14680,14657,10708,-3949
2018,11,22,20,14290,14657,10851,-3806
2018,11,22,21,14210,14945,11354,-3591
2018,11,22,22,15080,15263,11685,-3578
2018,11,22,23,15570,15619,12116,-3503
2018,11,23,0,15570,15532,11908,-3624
2018,11,23,1,15550,15475,11811,-3664
2018,11,23,2,15400,15400,11489,-3911
2018,11,23,3,14990,15065,11179,-3886
2018,11,23,4,14400,14439,10645,-3794
2018,11,23,5,13620,13779,10211,-3568
2018,11,23,6,12950,13537,9847,-3690
2018,11,23,7,12640,13316,9774,-3542
2018,11,23,8,12570,13233,9703,-3530
2018,11,23,9,12560,13498,9930,-3568
2018,11,23,10,12820,13534,9982,-3552
2018,11,23,11,13450,14066,10566,-3500
2018,11,23,12,14070,14543,11193,-3350
2018,11,23,13,14560,15013,11512,-3501
2018,11,23,14,14840,14992,11329,-3663
2018,11,23,15,14740,14673,11195,-3478
2018,11,23,16,14490,14514,11028,-3486
2018,11,23,17,14150,14342,10827,-3515
2018,11,23,18,14010,14160,10764,-3396
2018,11,23,19,13860,14433,10969,-3464
2018,11,23,20,14040,14603,11131,-3472
2018,11,23,21,14700,14961,11535,-3426
2018,11,23,22,16140,16057,12448,-3609
2018,11,23,23,17150,16743,13229,-3514
2018,11,24,0,16790,16518,12828,-3690
2018,11,24,1,16270,16130,12379,-3751
2018,11,24,2,15740,15686,12011,-3675
2018,11,24,3,15250,15039,11397,-3642
2018,11,24,4,14510,14177,10710,-3467
2018,11,24,5,13570,13414,9905,-3509
2018,11,24,6,12570,12704,9259,-3445
2018,11,24,7,12150,12563,9013,-3550
2018,11,24,8,11920,12642,9128,-3514
2018,11,24,9,11840,12640,9091,-3549
2018,11,24,10,11940,12660,9148,-3512
2018,11,24,11,12290,12565,9170,-3395
2018,11,24,12,12910,13174,9964,-3210
2018,11,24,13,13490,13889,10730,-3159
2018,11,24,14,13850,14109,10966,-3143
2018,11,24,15,13730,13968,10775,-3193
2018,11,24,16,13630,13677,10518,-3159
2018,11,24,17,13510,13601,10507,-3094
2018,11,24,18,13360,13452,10343,-3109
2018,11,24,19,13360,13512,10425,-3087
2018,11,24,20,13450,13598,10522,-3076
2018,11,24,21,13910,14001,11011,-2990
2018,11,24,22,15070,14853,11895,-2958
2018,11,24,23,15630,15340,12290,-3050
2018,11,25,0,15260,15078,12034,-3044
2018,11,25,1,14710,14661,11526,-3135
2018,11,25,2,14160,14162,10989,-3173
2018,11,25,3,13520,13532,10384,-3148
2018,11,25,4,12690,12688,9603,-3085
2018,11,25,5,11850,11828,8700,-3128
2018,11,25,6,11140,11151,8184,-2967
2018,11,25,7,10680,10706,7824,-2882
2018,11,25,8,10430,10707,7836,-2871
2018,11,25,9,10320,10874,7888,-2986
2018,11,25,10,10360,10920,7974,-2946
2018,11,25,11,10610,10876,7894,-2982
2018,11,25,12,11100,11458,8689,-2769
2018,11,25,13,11670,12165,9586,-2579
2018,11,25,14,12440,12679,9898,-2781
2018,11,25,15,13100,13301,10187,-3114
2018,11,25,16,13370,13370,10381,-2989
2018,11,25,17,13460,13535,10356,-3179
2018,11,25,18,13450,13627,10475,-3152
2018,11,25,19,13390,13609,10499,-3110
2018,11,25,20,13370,13687,10630,-3057
2018,11,25,21,13670,13956,10907,-3049
2018,11,25,22,14930,14935,11969,-2966
2018,11,25,23,15490,15529,12587,-2942
2018,11,26,0,15270,15303,12413,-2890
2018,11,26,1,14720,14823,11891,-2932
2018,11,26,2,14090,14164,11242,-2922
2018,11,26,3,13210,13236,10101,-3135
2018,11,26,4,12220,12328,8904,-3424
2018,11,26,5,11310,11497,8292,-3205
2018,11,26,6,10590,11023,8165,-2858
2018,11,26,7,10270,10566,7773,-2793
2018,11,26,8,10160,10641,7841,-2800
2018,11,26,9,10210,10789,7975,-2814
2018,11,26,10,10680,11392,8602,-2790
2018,11,26,11,11840,12154,9587,-2567
2018,11,26,12,13530,13416,11128,-2288
2018,11,26,13,14490,14472,12352,-2120
2018,11,26,14,14890,14725,12423,-2302
2018,11,26,15,14920,14822,12347,-2475
2018,11,26,16,15040,14944,12456,-2488
2018,11,26,17,15090,15010,12567,-2443
2018,11,26,18,15080,15031,12673,-2358
2018,11,26,19,15110,15050,12835,-2215
2018,11,26,20,15190,15003,12679,-2324
2018,11,26,21,15370,15314,13066,-2248
2018,11,26,22,16080,16125,13878,-2247
2018,11,26,23,16620,16650,14465,-2185
2018,11,27,0,16400,16465,14188,-2277
2018,11,27,1,15750,15979,13617,-2362
2018,11,27,2,15000,15307,12864,-2443
2018,11,27,3,13950,14299,11798,-2501
2018,11,27,4,12720,13030,10384,-2646
2018,11,27,5,11640,12234,9563,-2671
2018,11,27,6,10720,12156,9334,-2822
2018,11,27,7,10330,12100,9363,-2737
2018,11,27,8,10170,11738,8939,-2799
2018,11,27,9,10180,11688,8909,-2779
2018,11,27,10,10590,12254,9488,-2766
2018,11,27,11,11630,12872,10279,-2593
2018,11,27,12,13350,13728,11419,-2309
2018,11,27,13,14310,14459,12229,-2230
2018,11,27,14,14610,14671,12434,-2237
2018,11,27,15,14650,14669,12300,-2369
2018,11,27,16,14670,14612,12074,-2538
2018,11,27,17,14580,14539,12143,-2396
2018,11,27,18,14470,14515,12295,-2220
2018,11,27,19,14480,14646,12289,-2357
2018,11,27,20,14600,14521,12235,-2286
2018,11,27,21,14880,14902,12637,-2265
2018,11,27,22,15970,15868,13590,-2278
2018,11,27,23,16700,16663,14211,-2452
2018,11,28,0,16450,16549,13965,-2584
2018,11,28,1,16010,16134,13388,-2746
2018,11,28,2,15320,15461,12786,-2675
2018,11,28,3,14300,14609,11856,-2753
2018,11,28,4,13040,13598,10885,-2713
2018,11,28,5,11910,12706,10247,-2459
2018,11,28,6,11410,12500,9340,-3160
2018,11,28,7,11020,12122,8969,-3153
2018,11,28,8,10870,11935,8803,-3132
2018,11,28,9,10860,11944,8834,-3110
2018,11,28,10,11240,12089,9090,-2999
2018,11,28,11,12260,12708,9747,-2961
2018,11,28,12,13890,14241,11445,-2796
2018,11,28,13,14780,14852,12223,-2629
2018,11,28,14,14780,14762,11948,-2814
2018,11,28,15,14480,14442,11675,-2767
2018,11,28,16,14410,14281,11606,-2675
2018,11,28,17,14260,14504,11792,-2712
2018,11,28,18,14220,14641,11853,-2788
2018,11,28,19,14460,14752,11977,-2775
2018,11,28,20,14620,14804,12097,-2707
2018,11,28,21,15000,15155,12530,-2625
2018,11,28,22,15990,16155,13544,-2611
2018,11,28,23,16750,16912,14082,-2830
2018,11,29,0,16440,16762,13817,-2945
2018,11,29,1,15930,16329,13332,-2997
2018,11,29,2,15290,15714,12620,-3094
2018,11,29,3,14340,14698,11638,-3060
2018,11,29,4,13130,13465,10346,-3119
2018,11,29,5,12060,12670,9939,-2731
2018,11,29,6,11500,12318,9295,-3023
2018,11,29,7,11110,11956,8930,-3026
2018,11,29,8,10920,11766,8701,-3065
2018,11,29,9,10960,11937,8856,-3081
2018,11,29,10,11340,12258,9303,-2955
2018,11,29,11,12400,12822,9912,-2910
2018,11,29,12,14150,14113,11327,-2786
2018,11,29,13,14940,14937,12356,-2581
2018,11,29,14,14690,14718,11980,-2738
2018,11,29,15,14180,14268,11606,-2662
2018,11,29,16,14020,14233,11455,-2778
2018,11,29,17,13880,14305,11580,-2725
2018,11,29,18,13930,14200,11828,-2372
2018,11,29,19,14100,14266,11964,-2302
2018,11,29,20,14220,14384,11868,-2516
2018,11,29,21,14660,14808,12147,-2661
2018,11,29,22,15810,15859,13143,-2716
2018,11,29,23,16580,16701,13969,-2732
2018,11,30,0,16340,16601,13798,-2803
2018,11,30,1,15950,16227,13390,-2837
2018,11,30,2,15370,15642,12881,-2761
2018,11,30,3,14470,14716,11872,-2844
2018,11,30,4,13290,13493,10628,-2865
2018,11,30,5,12230,12441,9625,-2816
2018,11,30,6,11660,12169,9224,-2945
2018,11,30,7,11320,12076,9079,-2997
2018,11,30,8,11190,12246,9211,-3035
2018,11,30,9,11240,12337,9396,-2941
2018,11,30,10,11630,12494,9616,-2878
2018,11,30,11,12670,13009,10237,-2772
2018,11,30,12,14430,14404,11905,-2499
2018,11,30,13,15250,15262,12907,-2355
2018,11,30,14,15000,15034,12526,-2508
2018,11,30,15,14550,14552,12436,-2116
2018,11,30,16,14320,14342,12250,-2092
2018,11,30,17,14140,14518,12387,-2131
2018,11,30,18,14060,14685,12555,-2130
2018,11,30,19,14170,14884,12707,-2177
2018,11,30,20,14450,14916,12628,-2288
2018,11,30,21,14780,15132,12900,-2232
2018,11,30,22,15700,16008,13903,-2105
2018,11,30,23,16250,16502,14343,-2159
2018,12,1,0,15790,16215,14015,-2200
2018,12,1,1,15240,15733,13059,-2674
2018,12,1,2,14680,15154,12485,-2669
2018,12,1,3,13930,14538,11939,-2599
2018,12,1,4,12980,13915,11153,-2762
2018,12,1,5,12020,12888,10241,-2647
2018,12,1,6,11590,12144,9500,-2644
2018,12,1,7,11170,11699,9068,-2631
2018,12,1,8,10930,11739,9091,-2648
2018,12,1,9,10910,11838,9128,-2710
2018,12,1,10,11070,12172,9592,-2580
2018,12,1,11,11540,12611,10102,-2509
2018,12,1,12,12340,13413,10940,-2473
2018,12,1,13,13070,13492,11108,-2384
2018,12,1,14,13420,13432,11090,-2342
2018,12,1,15,13280,13286,10825,-2461
2018,12,1,16,13140,12991,10656,-2335
2018,12,1,17,13040,12736,10402,-2334
2018,12,1,18,13010,12537,10209,-2328
2018,12,1,19,13070,12839,10476,-2363
2018,12,1,20,13270,13454,11113,-2341
2018,12,1,21,13770,13684,11422,-2262
2018,12,1,22,14910,14738,12491,-2247
2018,12,1,23,15750,15414,13140,-2274
2018,12,2,0,15470,15209,12809,-2400
2018,12,2,1,14970,14813,12393,-2420
2018,12,2,2,14420,14370,11890,-2480
2018,12,2,3,13750,13710,11191,-2519
2018,12,2,4,12900,12813,10284,-2529
2018,12,2,5,12020,11895,9361,-2534
2018,12,2,6,11150,11430,8821,-2609
2018,12,2,7,10700,11213,8593,-2620
2018,12,2,8,10450,11238,8618,-2620
2018,12,2,9,10350,11154,8496,-2658
2018,12,2,10,10420,11199,8691,-2508
2018,12,2,11,10680,11461,9090,-2371
2018,12,2,12,11230,12011,9619,-2392
2018,12,2,13,11920,12310,9940,-2370
2018,12,2,14,12820,12802,10368,-2434
2018,12,2,15,13680,13569,11158,-2411
2018,12,2,16,14040,13940,11516,-2424
2018,12,2,17,14190,14122,11646,-2476
2018,12,2,18,14220,14178,11690,-2488
2018,12,2,19,14220,14143,11591,-2552
2018,12,2,20,14270,14118,11554,-2564
2018,12,2,21,14620,14345,11814,-2531
2018,12,2,22,15470,15173,12559,-2614
2018,12,2,23,16000,15679,12982,-2697
2018,12,3,0,15650,15411,12610,-2801
2018,12,3,1,15060,14910,12008,-2902
2018,12,3,2,14480,14316,11373,-2943
2018,12,3,3,13580,13337,10347,-2990
2018,12,3,4,12500,12197,8984,-3213
2018,12,3,5,11510,11553,8378,-3175
2018,12,3,6,10490,11706,8531,-3175
2018,12,3,7,10090,11455,8437,-3018
2018,12,3,8,9930,11270,8186,-3084
2018,12,3,9,9950,11277,8336,-2941
2018,12,3,10,10340,11562,8773,-2789
2018,12,3,11,11380,12040,9255,-2785
2018,12,3,12,13110,13212,10784,-2428
2018,12,3,13,14090,14112,11683,-2429
2018,12,3,14,14080,14119,11694,-2425
2018,12,3,15,13730,13880,11371,-2509
2018,12,3,16,13580,13596,11073,-2523
2018,12,3,17,13470,13746,11184,-2562
2018,12,3,18,13500,13801,11281,-2520
2018,12,3,19,13640,13969,11467,-2502
2018,12,3,20,13900,14155,11656,-2499
2018,12,3,21,14310,14229,11730,-2499
2018,12,3,22,15560,15301,12796,-2505
2018,12,3,23,16500,16167,13679,-2488
2018,12,4,0,16260,16151,13707,-2444
2018,12,4,1,15800,15754,13439,-2315
2018,12,4,2,15130,15124,12721,-2403
2018,12,4,3,14160,14121,11619,-2502
2018,12,4,4,12860,12831,10275,-2556
2018,12,4,5,11760,11721,9301,-2420
2018,12,4,6,11010,11192,9147,-2045
2018,12,4,7,10670,11278,8940,-2338
2018,12,4,8,10560,11369,9077,-2292
2018,12,4,9,10650,11449,9221,-2228
2018,12,4,10,11090,12058,9851,-2207
2018,12,4,11,12220,12529,10178,-2351
2018,12,4,12,14090,14056,11549,-2507
2018,12,4,13,15000,14999,12530,-2469
2018,12,4,14,14900,14915,12446,-2469
2018,12,4,15,14480,14455,11958,-2497
2018,12,4,16,14240,13951,11456,-2495
2018,12,4,17,13970,13691,11216,-2475
2018,12,4,18,13940,13777,11276,-2501
2018,12,4,19,14000,13974,11478,-2496
2018,12,4,20,14230,14313,11848,-2465
2018,12,4,21,14950,15057,12558,-2499
2018,12,4,22,16440,16409,13879,-2530
2018,12,4,23,17450,17444,14909,-2535
2018,12,5,0,17410,17455,14766,-2689
2018,12,5,1,17060,17123,14289,-2834
2018,12,5,2,16420,16536,13743,-2793
2018,12,5,3,15470,15539,12663,-2876
2018,12,5,4,14160,14222,11482,-2740
2018,12,5,5,12970,13095,10502,-2593
2018,12,5,6,12210,12594,9625,-2969
2018,12,5,7,11820,12832,9946,-2886
2018,12,5,8,11680,12726,9982,-2744
2018,12,5,9,11810,12768,9864,-2904
2018,12,5,10,12230,13326,10551,-2775
2018,12,5,11,13310,14302,11559,-2743
2018,12,5,12,15130,15450,12857,-2593
2018,12,5,13,15980,16204,13775,-2429
2018,12,5,14,15500,15802,13240,-2562
2018,12,5,15,15150,15081,12499,-2582
2018,12,5,16,14760,14444,11575,-2869
2018,12,5,17,14500,14398,11830,-2568
2018,12,5,18,14440,14481,12098,-2383
2018,12,5,19,14630,14692,12222,-2470
2018,12,5,20,14910,15167,12545,-2622
2018,12,5,21,15530,15709,12895,-2814
2018,12,5,22,16880,16842,14165,-2677
2018,12,5,23,17700,17582,15131,-2451
2018,12,6,0,17620,17470,14987,-2483
2018,12,6,1,17170,17104,14274,-2830
2018,12,6,2,16580,16513,13850,-2663
2018,12,6,3,15640,15521,12882,-2639
2018,12,6,4,14310,14198,11346,-2852
2018,12,6,5,13100,13003,10136,-2867
2018,12,6,6,12340,12460,9313,-3147
2018,12,6,7,11930,12172,8984,-3188
2018,12,6,8,11780,12250,9107,-3143
2018,12,6,9,11770,12321,9106,-3215
2018,12,6,10,12180,12724,9475,-3249
2018,12,6,11,13230,13441,10230,-3211
2018,12,6,12,15030,15139,11919,-3220
2018,12,6,13,16000,15990,12941,-3049
2018,12,6,14,15630,15658,12575,-3083
2018,12,6,15,15260,15298,12209,-3089
2018,12,6,16,14910,14950,11809,-3141
2018,12,6,17,14750,15014,11851,-3163
2018,12,6,18,14640,14990,11831,-3159
2018,12,6,19,14810,15121,11803,-3318
2018,12,6,20,14990,14974,11665,-3309
2018,12,6,21,15490,15450,12508,-2942
2018,12,6,22,16620,16606,13635,-2971
2018,12,6,23,17500,17303,14447,-2856
2018,12,7,0,17230,17254,13938,-3316
2018,12,7,1,16740,16864,13815,-3049
2018,12,7,2,16180,16311,13062,-3249
2018,12,7,3,15230,15399,12284,-3115
2018,12,7,4,13930,13976,11221,-2755
2018,12,7,5,12790,12790,10353,-2437
2018,12,7,6,12180,12075,9345,-2730
2018,12,7,7,11720,11569,8861,-2708
2018,12,7,8,11550,11377,9028,-2349
2018,12,7,9,11520,11400,9131,-2269
2018,12,7,10,11880,11763,9513,-2250
2018,12,7,11,12890,12814,10121,-2693
2018,12,7,12,14700,14577,11363,-3214
2018,12,7,13,15850,15452,12356,-3096
2018,12,7,14,15380,15211,12219,-2992
2018,12,7,15,14830,14609,11465,-3144
2018,12,7,16,14380,14157,11105,-3052
2018,12,7,17,14000,13806,11149,-2657
2018,12,7,18,13940,13685,11251,-2434
2018,12,7,19,14000,13922,11496,-2426
2018,12,7,20,14190,14417,11929,-2488
2018,12,7,21,15240,15159,12397,-2762
2018,12,7,22,16550,16383,13244,-3139
2018,12,7,23,17500,17173,14120,-3053
2018,12,8,0,17310,17024,13742,-3282
2018,12,8,1,16870,16628,13110,-3518
2018,12,8,2,16360,16193,12914,-3279
2018,12,8,3,15640,15531,12269,-3262
2018,12,8,4,14600,14541,11451,-3090
2018,12,8,5,13530,13545,10281,-3264
2018,12,8,6,12800,13031,10093,-2938
2018,12,8,7,12390,12688,9903,-2785
2018,12,8,8,12250,12538,9831,-2707
2018,12,8,9,12220,12713,9921,-2792
2018,12,8,10,12400,12846,10130,-2716
2018,12,8,11,12870,13195,10275,-2920
2018,12,8,12,13590,13786,10663,-3123
2018,12,8,13,14370,14597,11532,-3065
2018,12,8,14,14760,15008,11625,-3383
2018,12,8,15,14820,14714,11262,-3452
2018,12,8,16,14560,14299,11165,-3134
2018,12,8,17,14190,14038,11065,-2973
2018,12,8,18,13990,13884,10929,-2955
2018,12,8,19,13870,13974,10870,-3104
2018,12,8,20,14020,14380,11381,-2999
2018,12,8,21,14710,15150,12049,-3101
2018,12,8,22,16150,16328,13021,-3307
2018,12,8,23,17070,17063,13797,-3266
2018,12,9,0,16840,16871,13469,-3402
2018,12,9,1,16410,16472,12792,-3680
2018,12,9,2,15930,16060,12357,-3703
2018,12,9,3,15360,15467,11975,-3492
2018,12,9,4,14450,14609,11190,-3419
2018,12,9,5,13490,13690,10227,-3463
2018,12,9,6,12970,12997,9753,-3244
2018,12,9,7,12530,12837,9654,-3183
2018,12,9,8,12320,12875,9575,-3300
2018,12,9,9,12250,12832,9493,-3339
2018,12,9,10,12370,12925,9452,-3473
2018,12,9,11,12670,13041,9631,-3410
2018,12,9,12,13050,13607,10353,-3254
2018,12,9,13,13580,14011,11070,-2941
2018,12,9,14,13920,14661,11447,-3214
2018,12,9,15,14870,14692,12002,-2690
2018,12,9,16,14580,14355,11721,-2634
2018,12,9,17,14470,14045,11332,-2713
2018,12,9,18,14400,14010,11292,-2718
2018,12,9,19,14440,14088,11449,-2639
2018,12,9,20,14640,14485,11693,-2792
2018,12,9,21,15330,15150,12194,-2956
2018,12,9,22,16180,16487,13424,-3063
2018,12,9,23,17300,17374,14342,-3032
2018,12,10,0,16980,17226,14129,-3097
2018,12,10,1,16510,16787,13758,-3029
2018,12,10,2,15960,16206,13227,-2979
2018,12,10,3,15120,15228,12266,-2962
2018,12,10,4,14040,13982,11102,-2880
2018,12,10,5,12990,13143,10198,-2945
2018,12,10,6,12280,12965,9855,-3110
2018,12,10,7,11960,13071,9901,-3170
2018,12,10,8,11850,12941,9716,-3225
2018,12,10,9,11970,13043,9789,-3254
2018,12,10,10,12420,13404,10203,-3201
2018,12,10,11,13580,13948,10698,-3250
2018,12,10,12,15450,15417,12184,-3233
2018,12,10,13,16350,16368,13225,-3143
2018,12,10,14,16050,16064,13030,-3034
2018,12,10,15,15330,15358,12219,-3139
2018,12,10,16,15000,14798,11707,-3091
2018,12,10,17,14720,14514,11367,-3147
2018,12,10,18,14640,14525,11221,-3304
2018,12,10,19,14750,14478,11414,-3064
2018,12,10,20,15100,14863,11938,-2925
2018,12,10,21,15650,15611,12602,-3009
2018,12,10,22,17000,16930,13905,-3025
2018,12,10,23,18100,17967,14945,-3022
2018,12,11,0,17980,17951,14612,-3339
2018,12,11,1,17600,17640,14303,-3337
2018,12,11,2,16970,17055,13769,-3286
2018,12,11,3,15950,16058,12581,-3477
2018,12,11,4,14620,14734,11620,-3114
2018,12,11,5,13450,13589,10604,-2985
2018,12,11,6,12840,13495,10103,-3392
2018,12,11,7,12510,13324,10050,-3274
2018,12,11,8,12420,13208,9896,-3312
2018,12,11,9,12510,13289,9960,-3329
2018,12,11,10,12970,13732,10380,-3352
2018,12,11,11,14120,14446,11422,-3024
2018,12,11,12,16020,15992,12758,-3234
2018,12,11,13,16890,16912,13593,-3319
2018,12,11,14,16490,16517,13301,-3216
2018,12,11,15,15700,15703,12537,-3166
2018,12,11,16,15130,15247,12112,-3135
2018,12,11,17,14650,14942,11967,-2975
2018,12,11,18,14470,14767,11850,-2917
2018,12,11,19,14490,14948,12140,-2808
2018,12,11,20,14630,15389,12553,-2836
2018,12,11,21,15220,16037,13168,-2869
2018,12,11,22,16700,17204,14206,-2998
2018,12,11,23,18000,17945,15145,-2800
2018,12,12,0,17720,17880,15025,-2855
2018,12,12,1,17320,17560,14376,-3184
2018,12,12,2,16730,16931,13669,-3262
2018,12,12,3,15760,15879,12676,-3203
2018,12,12,4,14440,14796,11634,-3162
2018,12,12,5,13210,14027,11125,-2902
2018,12,12,6,12440,13310,10557,-2753
2018,12,12,7,12050,13043,10277,-2766
2018,12,12,8,11910,12941,9909,-3032
2018,12,12,9,11970,13027,9817,-3210
2018,12,12,10,12370,13388,10339,-3049
2018,12,12,11,13480,14006,10889,-3117
2018,12,12,12,15340,15547,12387,-3160
2018,12,12,13,16350,16256,13117,-3139
2018,12,12,14,16150,16047,12538,-3509
2018,12,12,15,15460,15343,11889,-3454
2018,12,12,16,14960,15021,11727,-3294
2018,12,12,17,14730,14971,11770,-3201
2018,12,12,18,14640,14881,11615,-3266
2018,12,12,19,14890,14959,11737,-3222
2018,12,12,20,15290,15257,12156,-3101
2018,12,12,21,15970,15975,12905,-3070
2018,12,12,22,17250,17083,13997,-3086
2018,12,12,23,18150,17965,14786,-3179
2018,12,13,0,18000,17877,14533,-3344
2018,12,13,1,17710,17631,14135,-3496
2018,12,13,2,17140,17124,13569,-3555
2018,12,13,3,16230,16190,12724,-3466
2018,12,13,4,14820,15327,12054,-3273
2018,12,13,5,13660,14118,10921,-3197
2018,12,13,6,13010,13853,10899,-2954
2018,12,13,7,12650,13726,10902,-2824
2018,12,13,8,12530,13874,11255,-2619
2018,12,13,9,12580,13904,11382,-2522
2018,12,13,10,13010,14222,11720,-2502
2018,12,13,11,14130,14819,12345,-2474
2018,12,13,12,16000,16108,13433,-2675
2018,12,13,13,16970,16957,13911,-3046
2018,12,13,14,16770,16795,13713,-3082
2018,12,13,15,16340,16291,13261,-3030
2018,12,13,16,15990,15973,12932,-3041
2018,12,13,17,15760,15949,12926,-3023
2018,12,13,18,15560,15975,12758,-3217
2018,12,13,19,15640,16111,12864,-3247
2018,12,13,20,15720,16193,12864,-3329
2018,12,13,21,16160,16550,13315,-3235
2018,12,13,22,17360,17562,14502,-3060
2018,12,13,23,18250,18187,14992,-3195
2018,12,14,0,17970,17998,14745,-3253
2018,12,14,1,17550,17616,14206,-3410
2018,12,14,2,16940,16990,13550,-3440
2018,12,14,3,15970,16007,12673,-3334
2018,12,14,4,14640,14678,11660,-3018
2018,12,14,5,13420,13621,10830,-2791
2018,12,14,6,12520,12786,9871,-2915
2018,12,14,7,12080,12370,9508,-2862
2018,12,14,8,11880,12394,9474,-2920
2018,12,14,9,11890,12429,9421,-3008
2018,12,14,10,12250,12774,9641,-3133
2018,12,14,11,13290,13402,10509,-2893
2018,12,14,12,15040,15009,12188,-2821
2018,12,14,13,15980,15967,12867,-3100
2018,12,14,14,15850,15849,12751,-3098
2018,12,14,15,15370,15337,12304,-3033
2018,12,14,16,15070,14905,11925,-2980
2018,12,14,17,14880,14672,11880,-2792
2018,12,14,18,14760,14568,12103,-2465
2018,12,14,19,14810,14710,12255,-2455
2018,12,14,20,14900,14945,12464,-2481
2018,12,14,21,15200,15314,12671,-2643
2018,12,14,22,16250,16298,13407,-2891
2018,12,14,23,16830,16740,13773,-2967
2018,12,15,0,16490,16386,13266,-3120
2018,12,15,1,15880,15876,12701,-3175
2018,12,15,2,15240,15303,12051,-3252
2018,12,15,3,14450,14505,11431,-3074
2018,12,15,4,13380,13398,11056,-2342
2018,12,15,5,12300,12414,9837,-2577
2018,12,15,6,11400,11936,8666,-3270
2018,12,15,7,10880,11414,8171,-3243
2018,12,15,8,10610,11562,8292,-3270
2018,12,15,9,10490,11595,8443,-3152
2018,12,15,10,10580,11642,8268,-3374
2018,12,15,11,10970,12004,8627,-3377
2018,12,15,12,11720,12233,8931,-3302
2018,12,15,13,12590,13067,9794,-3273
2018,12,15,14,13410,13442,10212,-3230
2018,12,15,15,13770,13768,10615,-3153
2018,12,15,16,13840,13669,10645,-3024
2018,12,15,17,13550,13356,10416,-2940
2018,12,15,18,13420,13308,10442,-2866
2018,12,15,19,13340,13331,10508,-2823
2018,12,15,20,13400,13430,10498,-2932
2018,12,15,21,13940,13698,10752,-2946
2018,12,15,22,14940,14702,11559,-3143
2018,12,15,23,15500,15288,12045,-3243
2018,12,16,0,15300,15063,11755,-3308
2018,12,16,1,14890,14650,11348,-3302
2018,12,16,2,14440,14231,10985,-3246
2018,12,16,3,13840,13674,10778,-2896
2018,12,16,4,12990,12864,9790,-3074
2018,12,16,5,12100,11993,8981,-3012
2018,12,16,6,11190,11602,8725,-2877
2018,12,16,7,10730,11540,8550,-2990
2018,12,16,8,10480,11287,8392,-2895
2018,12,16,9,10420,11212,8402,-2810
2018,12,16,10,10510,11289,8391,-2898
2018,12,16,11,10830,11599,8625,-2974
2018,12,16,12,11400,11802,9025,-2777
2018,12,16,13,12160,12407,9756,-2651
2018,12,16,14,13060,13073,10510,-2563
2018,12,16,15,13600,13748,11235,-2513
2018,12,16,16,13980,14039,11704,-2335
2018,12,16,17,14300,14163,11749,-2414
2018,12,16,18,14360,14229,11517,-2712
2018,12,16,19,14460,14261,11564,-2697
2018,12,16,20,14490,14348,11782,-2566
2018,12,16,21,14810,14713,12034,-2679
2018,12,16,22,15800,15827,13017,-2810
2018,12,16,23,16420,16395,13895,-2500
2018,12,17,0,16050,16243,13662,-2581
2018,12,17,1,15510,15826,13049,-2777
2018,12,17,2,14950,15303,12328,-2975
2018,12,17,3,14060,14363,11341,-3022
2018,12,17,4,12940,13127,10382,-2745
2018,12,17,5,11910,12265,9516,-2749
2018,12,17,6,11180,11998,9011,-2987
2018,12,17,7,10790,11953,9005,-2948
2018,12,17,8,10670,11804,8806,-2998
2018,12,17,9,10710,11841,8777,-3064
2018,12,17,10,11100,11888,8734,-3154
2018,12,17,11,12170,12396,9507,-2889
2018,12,17,12,13930,14038,11406,-2632
2018,12,17,13,14920,15152,12588,-2564
2018,12,17,14,15090,15406,12605,-2801
2018,12,17,15,15300,15345,12371,-2974
2018,12,17,16,15140,15360,12160,-3200
2018,12,17,17,14810,15313,11902,-3411
2018,12,17,18,14620,15252,11834,-3418
2018,12,17,19,14630,15334,11987,-3347
2018,12,17,20,14730,15202,11971,-3231
2018,12,17,21,15210,15546,12432,-3114
2018,12,17,22,16500,16644,13412,-3232
2018,12,17,23,17430,17463,14330,-3133
2018,12,18,0,17310,17340,13948,-3392
2018,12,18,1,16900,16930,13504,-3426
2018,12,18,2,16150,16282,12948,-3334
2018,12,18,3,15050,15256,11790,-3466
2018,12,18,4,13740,13893,10827,-3066
2018,12,18,5,12550,12661,9759,-2902
2018,12,18,6,11900,12495,9665,-2830
2018,12,18,7,11610,12410,9657,-2753
2018,12,18,8,11460,12463,9603,-2860
2018,12,18,9,11590,12751,9791,-2960
2018,12,18,10,12130,13050,10064,-2986
2018,12,18,11,13260,13593,10626,-2967
2018,12,18,12,15050,15311,11836,-3475
2018,12,18,13,16010,16396,12710,-3686
2018,12,18,14,15990,16325,12670,-3655
2018,12,18,15,15890,15874,12543,-3331
2018,12,18,16,15520,15281,11812,-3469
2018,12,18,17,15170,14827,11448,-3379
2018,12,18,18,14990,14716,11444,-3272
2018,12,18,19,15080,15009,12017,-2992
2018,12,18,20,15430,15327,12328,-2999
2018,12,18,21,16070,16067,12706,-3361
2018,12,18,22,17060,17342,13703,-3639
2018,12,18,23,18100,18288,14597,-3691
2018,12,19,0,18040,18253,14580,-3673
2018,12,19,1,17690,17978,14381,-3597
2018,12,19,2,17070,17461,13706,-3755
2018,12,19,3,16130,16517,12696,-3821
2018,12,19,4,14820,15163,11724,-3439
2018,12,19,5,13590,13893,10814,-3079
2018,12,19,6,13020,13411,10219,-3192
2018,12,19,7,12610,13336,9768,-3568
2018,12,19,8,12440,13143,9709,-3434
2018,12,19,9,12470,13315,9770,-3545
2018,12,19,10,12870,13412,9843,-3569
2018,12,19,11,13970,14253,10755,-3498
2018,12,19,12,15840,15811,12598,-3213
2018,12,19,13,16740,16773,13538,-3235
2018,12,19,14,16410,16489,12963,-3526
2018,12,19,15,15700,15690,12254,-3436
2018,12,19,16,15120,14973,11732,-3241
2018,12,19,17,14690,14474,11387,-3087
2018,12,19,18,14480,14138,11189,-2949
2018,12,19,19,14710,14374,11202,-3172
2018,12,19,20,15060,14784,11846,-2938
2018,12,19,21,15660,15362,12439,-2923
2018,12,19,22,16850,16668,13425,-3243
2018,12,19,23,17640,17610,14329,-3281
2018,12,20,0,17500,17544,14029,-3515
2018,12,20,1,17290,17231,13872,-3359
2018,12,20,2,16720,16703,13354,-3349
2018,12,20,3,15790,15766,12431,-3335
2018,12,20,4,14410,14455,10877,-3578
2018,12,20,5,13170,13202,10125,-3077
2018,12,20,6,12370,12392,9182,-3210
2018,12,20,7,11950,12025,8681,-3344
2018,12,20,8,11770,12028,8808,-3220
2018,12,20,9,11810,12064,8926,-3138
2018,12,20,10,12210,12448,9339,-3109
2018,12,20,11,13380,13290,10340,-2950
2018,12,20,12,15320,15035,12144,-2891
2018,12,20,13,16010,16017,12802,-3215
2018,12,20,14,15480,15736,12517,-3219
2018,12,20,15,14940,14924,11876,-3048
2018,12,20,16,14510,14473,11657,-2816
2018,12,20,17,14280,14168,11474,-2694
2018,12,20,18,14160,14189,11551,-2638
2018,12,20,19,14370,14231,11619,-2612
2018,12,20,20,14640,14535,11948,-2587
2018,12,20,21,15130,15051,12483,-2568
2018,12,20,22,16330,16193,13321,-2872
2018,12,20,23,17000,16862,13815,-3047
2018,12,21,0,16860,16723,13434,-3289
2018,12,21,1,16460,16346,13251,-3095
2018,12,21,2,15920,15801,12807,-2994
2018,12,21,3,15010,14865,11979,-2886
2018,12,21,4,13640,13578,10770,-2808
2018,12,21,5,12430,12309,9681,-2628
2018,12,21,6,11380,11808,8963,-2845
2018,12,21,7,10870,11531,8739,-2792
2018,12,21,8,10600,11440,8956,-2484
2018,12,21,9,10570,11383,8843,-2540
2018,12,21,10,10910,11652,8920,-2732
2018,12,21,11,11980,12359,9615,-2744
2018,12,21,12,13840,13491,10834,-2657
2018,12,21,13,14890,14413,11715,-2698
2018,12,21,14,15040,14874,12171,-2703
2018,12,21,15,15150,15105,12703,-2402
2018,12,21,16,15110,15223,12935,-2288
2018,12,21,17,14970,15231,12847,-2384
2018,12,21,18,14940,15066,12524,-2542
2018,12,21,19,14940,14997,12299,-2698
2018,12,21,20,15070,14845,12041,-2804
2018,12,21,21,15290,14886,12060,-2826
2018,12,21,22,15890,15509,12580,-2929
2018,12,21,23,16280,15817,12940,-2877
2018,12,22,0,15930,15434,12372,-3062
2018,12,22,1,15370,14885,11945,-2940
2018,12,22,2,14630,14279,11335,-2944
2018,12,22,3,13940,13485,10598,-2887
2018,12,22,4,13240,12484,9953,-2531
2018,12,22,5,11930,11594,9306,-2288
2018,12,22,6,10480,10766,8483,-2283
2018,12,22,7,9950,10526,8240,-2286
2018,12,22,8,9660,10454,8306,-2148
2018,12,22,9,9530,10314,8185,-2129
2018,12,22,10,9590,10383,8293,-2090
2018,12,22,11,9950,10484,8362,-2122
2018,12,22,12,10650,10670,8362,-2308
2018,12,22,13,11740,11516,8648,-2868
2018,12,22,14,12420,12380,9389,-2991
2018,12,22,15,13020,12996,10368,-2628
2018,12,22,16,13210,13330,10665,-2665
2018,12,22,17,13230,13330,10590,-2740
2018,12,22,18,13070,13100,10405,-2695
2018,12,22,19,13010,12972,10277,-2695
2018,12,22,20,13110,13061,10432,-2629
2018,12,22,21,13430,13528,10921,-2607
2018,12,22,22,14600,14605,11961,-2644
2018,12,22,23,15380,15394,12969,-2425
2018,12,23,0,15340,15296,12898,-2398
2018,12,23,1,14870,14975,12861,-2114
2018,12,23,2,14400,14601,12455,-2146
2018,12,23,3,13870,14074,11839,-2235
2018,12,23,4,13040,13272,11087,-2185
2018,12,23,5,11900,12328,9824,-2504
2018,12,23,6,11330,11552,9238,-2314
2018,12,23,7,10880,11202,9007,-2195
2018,12,23,8,10670,11087,9023,-2064
2018,12,23,9,10630,11011,8986,-2025
2018,12,23,10,10680,11121,9049,-2072
2018,12,23,11,11010,11251,9134,-2117
2018,12,23,12,11620,11839,9205,-2634
2018,12,23,13,12170,12558,9996,-2562
2018,12,23,14,12790,13039,10829,-2210
2018,12,23,15,13050,12993,10854,-2139
2018,12,23,16,13020,12717,10511,-2206
2018,12,23,17,12860,12468,10164,-2304
2018,12,23,18,12730,12402,10137,-2265
2018,12,23,19,12760,12778,10464,-2314
2018,12,23,20,13000,13262,10884,-2378
2018,12,23,21,13870,13913,11499,-2414
2018,12,23,22,15240,14932,12475,-2457
2018,12,23,23,16100,15900,13547,-2353
2018,12,24,0,16050,15884,13479,-2405
2018,12,24,1,15710,15603,13112,-2491
2018,12,24,2,14970,15272,12836,-2436
2018,12,24,3,14370,14639,12097,-2542
2018,12,24,4,13200,13696,11074,-2622
2018,12,24,5,12170,12670,9984,-2686
2018,12,24,6,11840,11914,9094,-2820
2018,12,24,7,11350,11943,8714,-3229
2018,12,24,8,11130,12105,8732,-3373
2018,12,24,9,11100,12147,8866,-3281
2018,12,24,10,11330,12351,9106,-3245
2018,12,24,11,11890,12352,9174,-3178
2018,12,24,12,12780,12784,9830,-2954
2018,12,24,13,13650,13636,11414,-2222
2018,12,24,14,14310,14300,12384,-1916
2018,12,24,15,14560,14558,12664,-1894
2018,12,24,16,14810,14789,12955,-1834
2018,12,24,17,14880,14976,12799,-2177
2018,12,24,18,14690,14885,12629,-2256
2018,12,24,19,14580,14759,12396,-2363
2018,12,24,20,14520,14761,12390,-2371
2018,12,24,21,14790,14981,12605,-2376
2018,12,24,22,15930,15674,13319,-2355
2018,12,24,23,16350,15845,13498,-2347
2018,12,25,0,15910,15178,12934,-2244
2018,12,25,1,15360,14542,12251,-2291
2018,12,25,2,14890,14168,11482,-2686
2018,12,25,3,14400,14017,11348,-2669
2018,12,25,4,13600,13213,10962,-2251
2018,12,25,5,12770,12414,10154,-2260
2018,12,25,6,11700,11930,9251,-2679
2018,12,25,7,11220,11757,8876,-2881
2018,12,25,8,10980,11903,8895,-3008
2018,12,25,9,10900,11963,8771,-3192
2018,12,25,10,11040,12087,8974,-3113
2018,12,25,11,11400,12166,9169,-2997
2018,12,25,12,12030,12544,9668,-2876
2018,12,25,13,12700,13226,10695,-2531
2018,12,25,14,13120,13378,10964,-2414
2018,12,25,15,12970,12967,10331,-2636
2018,12,25,16,12690,12567,10091,-2476
2018,12,25,17,12430,12331,9960,-2371
2018,12,25,18,12150,12227,9779,-2448
2018,12,25,19,12120,12335,9873,-2462
2018,12,25,20,12280,12750,10281,-2469
2018,12,25,21,12700,13041,10749,-2292
2018,12,25,22,14400,13985,11548,-2437
2018,12,25,23,15000,14626,12089,-2537
2018,12,26,0,14800,14588,12120,-2468
2018,12,26,1,14740,14518,11931,-2587
2018,12,26,2,14520,14368,11924,-2444
2018,12,26,3,14180,13980,11616,-2364
2018,12,26,4,13420,13258,10869,-2389
2018,12,26,5,12570,12486,10064,-2422
2018,12,26,6,11850,12133,9282,-2851
2018,12,26,7,11540,11910,9021,-2889
2018,12,26,8,11440,11953,8972,-2981
2018,12,26,9,11500,12011,9038,-2973
2018,12,26,10,11850,12329,9344,-2985
2018,12,26,11,12660,12736,9833,-2903
2018,12,26,12,13850,13832,10895,-2937
2018,12,26,13,14770,14776,11898,-2878
2018,12,26,14,15110,15113,12312,-2801
2018,12,26,15,14930,14973,12254,-2719
2018,12,26,16,14420,14690,11894,-2796
2018,12,26,17,14020,14371,11737,-2634
2018,12,26,18,13810,14205,11843,-2362
2018,12,26,19,13820,14430,11749,-2681
2018,12,26,20,14010,14850,11851,-2999
2018,12,26,21,14670,15390,12563,-2827
2018,12,26,22,15850,16421,13624,-2797
2018,12,26,23,17000,17204,14049,-3155
2018,12,27,0,16730,17000,13646,-3354
2018,12,27,1,16320,16543,13006,-3537
2018,12,27,2,15810,15933,12351,-3582
2018,12,27,3,14880,15057,11474,-3583
2018,12,27,4,13620,13931,10331,-3600
2018,12,27,5,12530,13053,9766,-3287
2018,12,27,6,12010,12571,9046,-3525
2018,12,27,7,11530,12447,8911,-3536
2018,12,27,8,11400,12412,8710,-3702
2018,12,27,9,11480,12384,8732,-3652
2018,12,27,10,11560,12409,8859,-3550
2018,12,27,11,12570,12953,9554,-3399
2018,12,27,12,14250,13830,10534,-3296
2018,12,27,13,15110,14653,11310,-3343
2018,12,27,14,15260,14897,11593,-3304
2018,12,27,15,14610,14732,11477,-3255
2018,12,27,16,14230,14410,11043,-3367
2018,12,27,17,13970,14111,10750,-3361
2018,12,27,18,13870,13949,10229,-3720
2018,12,27,19,14040,14210,10522,-3688
2018,12,27,20,14290,14431,10642,-3789
2018,12,27,21,15030,15029,11373,-3656
2018,12,27,22,16110,16164,12386,-3778
2018,12,27,23,17100,17031,13350,-3681
2018,12,28,0,17090,16860,13175,-3685
2018,12,28,1,16850,16436,12793,-3643
2018,12,28,2,16280,15854,12238,-3616
2018,12,28,3,15310,14982,11366,-3616
2018,12,28,4,14060,13820,10581,-3239
2018,12,28,5,12910,12707,9916,-2791
2018,12,28,6,11830,11907,8842,-3065
2018,12,28,7,11250,11646,8460,-3186
2018,12,28,8,11060,11406,8507,-2899
2018,12,28,9,11070,11577,8615,-2962
2018,12,28,10,11290,11662,8679,-2983
2018,12,28,11,12150,12086,9101,-2985
2018,12,28,12,13530,13167,10375,-2792
2018,12,28,13,14530,14192,11488,-2704
2018,12,28,14,14920,14893,12179,-2714
2018,12,28,15,15410,15403,12664,-2739
2018,12,28,16,15400,15709,12955,-2754
2018,12,28,17,15360,15799,12953,-2846
2018,12,28,18,15260,15682,12723,-2959
2018,12,28,19,15200,15531,12577,-2954
2018,12,28,20,15070,15313,12424,-2889
2018,12,28,21,15260,15267,12347,-2920
2018,12,28,22,15960,15818,12646,-3172
2018,12,28,23,16110,16098,12855,-3243
2018,12,29,0,15730,15655,12304,-3351
2018,12,29,1,14980,15042,11684,-3358
2018,12,29,2,14460,14415,10887,-3528
2018,12,29,3,13630,13616,10270,-3346
2018,12,29,4,12630,12776,9478,-3298
2018,12,29,5,11600,11822,9029,-2793
2018,12,29,6,10900,11291,8437,-2854
2018,12,29,7,10340,10834,7893,-2941
2018,12,29,8,10130,10823,8246,-2577
2018,12,29,9,10070,10705,8259,-2446
2018,12,29,10,10130,10779,8337,-2442
2018,12,29,11,10410,10552,8191,-2361
2018,12,29,12,11060,10930,8491,-2439
2018,12,29,13,11670,11530,8694,-2836
2018,12,29,14,12420,12077,9170,-2907
2018,12,29,15,12200,12162,9411,-2751
2018,12,29,16,11950,12014,9365,-2649
2018,12,29,17,11840,12006,9338,-2668
2018,12,29,18,11740,12163,9687,-2476
2018,12,29,19,11890,12376,9738,-2638
2018,12,29,20,12190,12640,9923,-2717
2018,12,29,21,12940,13105,10401,-2704
2018,12,29,22,14180,14151,11437,-2714
2018,12,29,23,15200,15008,12104,-2904
2018,12,30,0,15110,14952,12222,-2730
2018,12,30,1,14750,14640,11891,-2749
2018,12,30,2,14450,14269,11489,-2780
2018,12,30,3,13890,13726,10741,-2985
2018,12,30,4,13040,12980,10012,-2968
2018,12,30,5,12190,12147,9324,-2823
2018,12,30,6,11500,11522,8677,-2845
2018,12,30,7,11110,11127,8547,-2580
2018,12,30,8,10920,11172,8469,-2703
2018,12,30,9,10900,11144,8516,-2628
2018,12,30,10,11010,11169,8430,-2739
2018,12,30,11,11340,11332,8498,-2834
2018,12,30,12,11830,11846,8843,-3003
2018,12,30,13,12470,12484,9767,-2717
2018,12,30,14,13160,13213,10245,-2968
2018,12,30,15,13630,13595,10735,-2860
2018,12,30,16,13660,13299,10365,-2934
2018,12,30,17,13530,12943,10112,-2831
2018,12,30,18,13490,12883,10009,-2874
2018,12,30,19,13680,12983,10174,-2809
2018,12,30,20,13870,13371,10369,-3002
2018,12,30,21,14550,13944,10805,-3139
2018,12,30,22,15870,15146,12170,-2976
2018,12,30,23,16250,16087,13170,-2917
2018,12,31,0,16180,15994,13325,-2669
2018,12,31,1,15730,15569,12979,-2590
2018,12,31,2,15210,15073,12634,-2439
2018,12,31,3,14370,14328,11790,-2538
2018,12,31,4,13320,13372,10662,-2710
2018,12,31,5,12290,12418,9437,-2981
2018,12,31,6,11600,12063,8985,-3078
2018,12,31,7,11070,11829,8848,-2981
2018,12,31,8,10810,11888,8783,-3105
2018,12,31,9,10700,11879,8804,-3075
2018,12,31,10,10950,12149,9157,-2992
2018,12,31,11,11650,12390,9472,-2918
2018,12,31,12,12820,13126,10214,-2912
2018,12,31,13,13750,13916,10964,-2952
2018,12,31,14,14310,14194,11457,-2737
2018,12,31,15,14130,14130,11337,-2793
2018,12,31,16,14050,14093,11292,-2801
2018,12,31,17,13920,14068,11214,-2854
2018,12,31,18,13770,14154,11338,-2816
2018,12,31,19,13810,14312,11516,-2796
2018,12,31,20,13970,14438,11564,-2874
2018,12,31,21,14420,14729,11877,-2852
2018,12,31,22,15670,15630,12880,-2750
2018,12,31,23,16600,16149,13304,-2845
2019,1,1,0,16060,15595,12742,-2853
2019,1,1,1,15270,14829,12103,-2726
2019,1,1,2,14530,14119,11410,-2709
2019,1,1,3,13770,13481,10468,-3013
2019,1,1,4,13030,12795,9916,-2879
2019,1,1,5,12350,12132,9667,-2465
2019,1,1,6,11500,11614,8902,-2712
2019,1,1,7,10960,11497,8809,-2688
2019,1,1,8,10560,11369,8538,-2831
2019,1,1,9,10300,11270,8433,-2837
2019,1,1,10,10250,11310,8245,-3065
2019,1,1,11,10480,11516,8386,-3130
2019,1,1,12,10800,11849,8526,-3323
2019,1,1,13,11060,11539,8355,-3184
2019,1,1,14,11430,11729,8770,-2959
2019,1,1,15,11820,12187,9170,-3017
2019,1,1,16,12030,12331,9222,-3109
2019,1,1,17,12070,12149,8918,-3231
2019,1,1,18,12310,12082,9033,-3049
2019,1,1,19,12380,12154,9433,-2721
2019,1,1,20,12540,12349,9750,-2599
2019,1,1,21,13140,13037,10209,-2828
2019,1,1,22,14510,14316,11391,-2925
2019,1,1,23,15680,15392,12469,-2923
2019,1,2,0,15500,15287,12623,-2664
2019,1,2,1,14950,14862,12137,-2725
2019,1,2,2,14350,14305,11640,-2665
2019,1,2,3,13660,13503,10553,-2950
2019,1,2,4,12780,12504,9754,-2750
2019,1,2,5,12030,11894,9211,-2683
2019,1,2,6,11610,11614,8555,-3059
2019,1,2,7,11270,11124,8174,-2950
2019,1,2,8,11100,11046,8269,-2777
2019,1,2,9,11090,11164,8389,-2775
2019,1,2,10,11460,11593,8828,-2765
2019,1,2,11,12560,12692,9864,-2828
2019,1,2,12,14400,14279,11616,-2663
2019,1,2,13,15240,15390,12457,-2933
2019,1,2,14,14910,15296,12039,-3257
2019,1,2,15,14470,14725,11748,-2977
2019,1,2,16,14200,14298,11579,-2719
2019,1,2,17,13990,14062,11553,-2509
2019,1,2,18,13930,13877,11327,-2550
2019,1,2,19,14130,14127,11589,-2538
2019,1,2,20,14300,14611,11849,-2762
2019,1,2,21,14910,15287,12607,-2680
2019,1,2,22,16180,16423,13387,-3036
2019,1,2,23,17340,17416,14598,-2818
2019,1,3,0,17090,17351,14567,-2784
2019,1,3,1,16700,16943,14149,-2794
2019,1,3,2,15980,16268,13408,-2860
2019,1,3,3,14950,15240,12671,-2569
2019,1,3,4,13740,13913,11371,-2542
2019,1,3,5,12660,12869,10153,-2716
2019,1,3,6,11990,12558,9718,-2840
2019,1,3,7,11590,12233,9501,-2732
2019,1,3,8,11390,12196,9375,-2821
2019,1,3,9,11370,12178,9407,-2771
2019,1,3,10,11700,12325,9496,-2829
2019,1,3,11,12670,13177,10333,-2844
2019,1,3,12,14280,14314,11581,-2733
2019,1,3,13,15340,15340,12545,-2795
2019,1,3,14,15440,15458,12649,-2809
2019,1,3,15,15270,15238,12581,-2657
2019,1,3,16,15050,14621,12047,-2574
2019,1,3,17,14720,14108,11478,-2630
2019,1,3,18,14570,13995,11315,-2680
2019,1,3,19,14400,14075,11275,-2800
2019,1,3,20,14470,14334,11726,-2608
2019,1,3,21,14820,14810,12102,-2708
2019,1,3,22,15910,15803,12601,-3202
2019,1,3,23,16900,16766,13457,-3309
2019,1,4,0,16600,16695,13495,-3200
2019,1,4,1,16200,16275,13038,-3237
2019,1,4,2,15630,15637,12555,-3082
2019,1,4,3,14720,14654,11650,-3004
2019,1,4,4,13530,13420,10321,-3099
2019,1,4,5,12470,12372,9298,-3074
2019,1,4,6,11600,11892,8731,-3161
2019,1,4,7,11200,11725,8703,-3022
2019,1,4,8,11020,11543,8589,-2954
2019,1,4,9,11040,11534,8638,-2896
2019,1,4,10,11410,11660,8857,-2803
2019,1,4,11,12410,12626,9746,-2880
2019,1,4,12,14130,14091,11254,-2837
2019,1,4,13,15060,15067,12181,-2886
2019,1,4,14,14870,14887,11947,-2940
2019,1,4,15,14300,14311,11396,-2915
2019,1,4,16,13810,13924,11056,-2868
2019,1,4,17,13410,13641,10740,-2901
2019,1,4,18,13300,13408,10562,-2846
2019,1,4,19,13340,13644,10753,-2891
2019,1,4,20,13590,13964,11090,-2874
2019,1,4,21,14310,14379,11318,-3061
2019,1,4,22,15440,15321,12247,-3074
2019,1,4,23,16500,16057,12794,-3263
2019,1,5,0,16090,15835,12413,-3422
2019,1,5,1,15530,15369,11758,-3611
2019,1,5,2,14900,14804,11259,-3545
2019,1,5,3,14200,14060,10964,-3096
2019,1,5,4,13100,13077,9849,-3228
2019,1,5,5,12160,12289,9542,-2747
2019,1,5,6,11300,11585,8352,-3233
2019,1,5,7,10840,11105,7931,-3174
2019,1,5,8,10570,10831,7719,-3112
2019,1,5,9,10490,10746,7786,-2960
2019,1,5,10,10610,11115,7722,-3393
2019,1,5,11,10990,11251,7960,-3291
2019,1,5,12,11650,11863,8391,-3472
2019,1,5,13,12400,12382,8992,-3390
2019,1,5,14,13150,13147,9843,-3304
2019,1,5,15,13820,13784,10569,-3215
2019,1,5,16,14090,14092,11106,-2986
2019,1,5,17,14130,14194,11227,-2967
2019,1,5,18,14160,14184,11169,-3015
2019,1,5,19,14100,14128,11226,-2902
2019,1,5,20,14230,14169,11288,-2881
2019,1,5,21,14410,14362,11326,-3036
2019,1,5,22,15220,15047,12199,-2848
2019,1,5,23,16000,15516,12412,-3104
2019,1,6,0,15660,15264,11886,-3378
2019,1,6,1,15100,14738,11339,-3399
2019,1,6,2,14560,14218,10874,-3344
2019,1,6,3,13880,13569,10344,-3225
2019,1,6,4,13000,12777,9690,-3087
2019,1,6,5,12150,11943,9054,-2889
2019,1,6,6,11230,11261,8562,-2699
2019,1,6,7,10790,11039,8431,-2608
2019,1,6,8,10580,11195,8598,-2597
2019,1,6,9,10510,11350,8747,-2603
2019,1,6,10,10610,11433,8687,-2746
2019,1,6,11,10900,11703,8759,-2944
2019,1,6,12,11430,11951,8908,-3043
2019,1,6,13,11990,12012,9313,-2699
2019,1,6,14,12640,12633,9716,-2917
2019,1,6,15,13000,12977,10076,-2901
2019,1,6,16,12990,13118,9812,-3306
2019,1,6,17,12840,13133,9864,-3269
2019,1,6,18,12820,13050,9727,-3323
2019,1,6,19,12910,13134,9894,-3240
2019,1,6,20,13180,13372,10207,-3165
2019,1,6,21,13810,13923,10713,-3210
2019,1,6,22,15040,15078,11770,-3308
2019,1,6,23,16200,16211,13289,-2922
2019,1,7,0,16040,16203,13249,-2954
2019,1,7,1,15750,15829,12902,-2927
2019,1,7,2,15410,15376,12585,-2791
2019,1,7,3,14660,14557,11609,-2948
2019,1,7,4,13660,13560,10773,-2787
2019,1,7,5,12780,12934,10002,-2932
2019,1,7,6,12110,12423,9227,-3196
2019,1,7,7,11830,12230,9223,-3007
2019,1,7,8,11710,12316,9249,-3067
2019,1,7,9,11880,12280,9228,-3052
2019,1,7,10,12420,12756,9603,-3153
2019,1,7,11,13610,13619,10199,-3420
2019,1,7,12,15370,15459,12131,-3328
2019,1,7,13,16260,16503,13066,-3437
2019,1,7,14,15930,16324,12479,-3845
2019,1,7,15,15700,15746,11999,-3747
2019,1,7,16,15450,15324,11770,-3554
2019,1,7,17,15220,14967,11543,-3424
2019,1,7,18,14950,14882,11955,-2927
2019,1,7,19,15060,15046,12018,-3028
2019,1,7,20,15250,15332,12085,-3247
2019,1,7,21,15900,15957,12666,-3291
2019,1,7,22,17030,17014,13454,-3560
2019,1,7,23,18200,17941,14261,-3680
2019,1,8,0,18050,17843,14069,-3774
2019,1,8,1,17520,17385,13956,-3429
2019,1,8,2,16840,16679,13208,-3471
2019,1,8,3,15800,15626,12647,-2979
2019,1,8,4,14500,14338,11600,-2738
2019,1,8,5,13400,13217,10376,-2841
2019,1,8,6,12620,12459,9365,-3094
2019,1,8,7,12120,12022,9122,-2900
2019,1,8,8,12000,11828,8907,-2921
2019,1,8,9,11960,12082,9142,-2940
2019,1,8,10,12250,12452,9398,-3054
2019,1,8,11,13250,13178,10113,-3065
2019,1,8,12,15040,14817,11934,-2883
2019,1,8,13,15960,15851,12695,-3156
2019,1,8,14,16010,16109,12969,-3140
2019,1,8,15,16160,16168,13232,-2936
2019,1,8,16,16090,16221,13330,-2891
2019,1,8,17,15980,16139,13049,-3090
2019,1,8,18,15950,15961,12638,-3323
2019,1,8,19,15910,15846,12458,-3388
2019,1,8,20,15950,15684,12238,-3446
2019,1,8,21,16180,15739,12415,-3324
2019,1,8,22,16770,16392,13148,-3244
2019,1,8,23,17500,17033,13568,-3465
2019,1,9,0,17140,16828,13188,-3640
2019,1,9,1,16530,16313,12732,-3581
2019,1,9,2,15800,15584,12131,-3453
2019,1,9,3,14680,14562,11019,-3543
2019,1,9,4,13410,13280,9870,-3410
2019,1,9,5,12310,12385,9203,-3182
2019,1,9,6,11450,12225,8715,-3510
2019,1,9,7,11050,12038,8805,-3233
2019,1,9,8,10870,12189,8695,-3494
2019,1,9,9,10870,12192,8804,-3388
2019,1,9,10,11200,12473,8951,-3522
2019,1,9,11,12250,12822,9288,-3534
2019,1,9,12,13930,13875,10426,-3449
2019,1,9,13,14960,14784,11543,-3241
2019,1,9,14,15000,14816,11313,-3503
2019,1,9,15,14610,14670,11166,-3504
2019,1,9,16,14470,14530,11069,-3461
2019,1,9,17,14320,14562,11055,-3507
2019,1,9,18,14250,14632,11301,-3331
2019,1,9,19,14310,14780,11308,-3472
2019,1,9,20,14460,14776,11229,-3547
2019,1,9,21,14820,15012,11617,-3395
2019,1,9,22,15900,15863,12430,-3433
2019,1,9,23,17070,16828,13567,-3261
2019,1,10,0,17020,16698,13622,-3076
2019,1,10,1,16570,16257,13229,-3028
2019,1,10,2,15940,15647,12657,-2990
2019,1,10,3,14990,14762,11929,-2833
2019,1,10,4,13690,13693,10871,-2822
2019,1,10,5,12600,12639,10002,-2637
2019,1,10,6,11690,12448,9319,-3129
2019,1,10,7,11340,12584,9418,-3166
2019,1,10,8,11160,12244,9229,-3015
2019,1,10,9,11160,12203,9482,-2721
2019,1,10,10,11500,12153,9380,-2773
2019,1,10,11,12590,12754,9560,-3194
2019,1,10,12,14320,14321,11198,-3123
2019,1,10,13,15260,15328,12274,-3054
2019,1,10,14,15260,15334,12317,-3017
2019,1,10,15,15090,15288,12319,-2969
2019,1,10,16,14900,15454,12306,-3148
2019,1,10,17,15270,15413,11984,-3429
2019,1,10,18,15140,15234,11779,-3455
2019,1,10,19,15280,15214,11837,-3377
2019,1,10,20,15430,15198,11761,-3437
2019,1,10,21,15760,15530,12115,-3415
2019,1,10,22,16620,16476,12867,-3609
2019,1,10,23,17700,17496,13861,-3635
2019,1,11,0,17690,17496,13763,-3733
2019,1,11,1,17460,17137,13475,-3662
2019,1,11,2,16900,16575,12830,-3745
2019,1,11,3,15960,15666,11802,-3864
2019,1,11,4,14730,14452,10747,-3705
2019,1,11,5,13650,13405,9996,-3409
2019,1,11,6,12750,13075,9660,-3415
2019,1,11,7,12390,13046,9489,-3557
2019,1,11,8,12250,13071,9585,-3486
2019,1,11,9,12310,13118,9755,-3363
2019,1,11,10,12640,12918,9652,-3266
2019,1,11,11,13810,13724,10689,-3035
2019,1,11,12,15530,15515,12295,-3220
2019,1,11,13,16500,16522,13112,-3410
2019,1,11,14,16310,16329,13112,-3217
2019,1,11,15,15860,15723,12579,-3144
2019,1,11,16,15580,15177,11781,-3396
2019,1,11,17,15320,15058,11784,-3274
2019,1,11,18,14570,14969,11856,-3113
2019,1,11,19,14850,15243,12062,-3181
2019,1,11,20,15190,15516,12335,-3181
2019,1,11,21,15800,15964,12585,-3379
2019,1,11,22,17080,16892,13326,-3566
2019,1,11,23,18150,17748,14208,-3540
2019,1,12,0,18050,17658,14170,-3488
2019,1,12,1,17570,17363,13755,-3608
2019,1,12,2,17060,16903,13229,-3674
2019,1,12,3,16300,16234,12601,-3633
2019,1,12,4,15310,15310,11809,-3501
2019,1,12,5,14360,14382,10942,-3440
2019,1,12,6,13610,13707,10360,-3347
2019,1,12,7,13200,13485,10301,-3184
2019,1,12,8,12990,13415,10034,-3381
2019,1,12,9,12950,13322,9904,-3418
2019,1,12,10,13060,13466,9912,-3554
2019,1,12,11,13500,13856,10339,-3517
2019,1,12,12,14240,14304,10855,-3449
2019,1,12,13,14900,15021,11678,-3343
2019,1,12,14,15300,15552,12155,-3397
2019,1,12,15,15650,15561,12248,-3313
2019,1,12,16,15400,15377,12067,-3310
2019,1,12,17,15080,15163,11754,-3409
2019,1,12,18,14850,15130,11654,-3476
2019,1,12,19,14800,15066,11439,-3627
2019,1,12,20,14970,15339,11684,-3655
2019,1,12,21,15400,15782,12246,-3536
2019,1,12,22,16410,16285,12725,-3560
2019,1,12,23,17300,17186,13734,-3452
2019,1,13,0,17250,17051,13448,-3603
2019,1,13,1,16740,16615,12978,-3637
2019,1,13,2,16260,16145,12563,-3582
2019,1,13,3,15560,15517,11867,-3650
2019,1,13,4,14700,14700,11007,-3693
2019,1,13,5,13870,13848,10274,-3574
2019,1,13,6,13300,13592,9992,-3600
2019,1,13,7,12960,13423,9970,-3453
2019,1,13,8,12720,13379,9903,-3476
2019,1,13,9,12650,13303,9828,-3475
2019,1,13,10,12750,13111,9590,-3521
2019,1,13,11,13030,13655,10123,-3532
2019,1,13,12,13570,14078,10515,-3563
2019,1,13,13,14170,14408,10898,-3510
2019,1,13,14,14640,14999,11547,-3452
2019,1,13,15,14870,14861,11429,-3432
2019,1,13,16,14640,14564,11152,-3412
2019,1,13,17,14250,14280,10913,-3367
2019,1,13,18,14160,14208,10788,-3420
2019,1,13,19,14140,14129,10593,-3536
2019,1,13,20,14300,14413,10898,-3515
2019,1,13,21,15010,15091,11622,-3469
2019,1,13,22,16250,16086,12608,-3478
2019,1,13,23,17450,17360,14046,-3314
2019,1,14,0,17430,17301,13994,-3307
2019,1,14,1,16990,16878,13477,-3401
2019,1,14,2,16410,16308,12700,-3608
2019,1,14,3,15530,15378,11711,-3667
2019,1,14,4,14500,14249,10790,-3459
2019,1,14,5,13590,13345,9896,-3449
2019,1,14,6,12770,12789,9436,-3353
2019,1,14,7,12490,12843,9473,-3370
2019,1,14,8,12410,12963,9743,-3220
2019,1,14,9,12480,13002,9816,-3186
2019,1,14,10,12890,13155,9988,-3167
2019,1,14,11,14000,14178,11009,-3169
2019,1,14,12,15800,15770,12593,-3177
2019,1,14,13,16830,16840,13740,-3100
2019,1,14,14,16860,16877,13631,-3246
2019,1,14,15,16600,16611,13454,-3157
2019,1,14,16,16180,16183,12936,-3247
2019,1,14,17,15800,15684,12156,-3528
2019,1,14,18,15550,15661,12183,-3478
2019,1,14,19,15440,15913,12387,-3526
2019,1,14,20,15520,15749,12390,-3359
2019,1,14,21,15820,16027,12565,-3462
2019,1,14,22,16880,16912,13743,-3169
2019,1,14,23,18100,17880,14794,-3086
2019,1,15,0,18070,17888,14693,-3195
2019,1,15,1,17620,17523,14217,-3306
2019,1,15,2,16980,16865,13420,-3445
2019,1,15,3,15920,15874,12291,-3583
2019,1,15,4,14640,14635,11103,-3532
2019,1,15,5,13560,13667,10030,-3637
2019,1,15,6,12950,13243,9824,-3419
2019,1,15,7,12660,13144,9682,-3462
2019,1,15,8,12560,13082,9643,-3439
2019,1,15,9,12620,13149,9658,-3491
2019,1,15,10,13040,13488,10057,-3431
2019,1,15,11,14120,14088,10906,-3182
2019,1,15,12,15950,15913,12834,-3079
2019,1,15,13,16820,16828,13678,-3150
2019,1,15,14,16450,16486,13303,-3183
2019,1,15,15,15780,15820,12398,-3422
2019,1,15,16,15260,15489,12121,-3368
2019,1,15,17,14890,15446,12209,-3237
2019,1,15,18,14650,15266,11881,-3385
2019,1,15,19,14600,15326,11886,-3440
2019,1,15,20,14900,15340,11934,-3406
2019,1,15,21,15470,15563,12262,-3301
2019,1,15,22,16480,16449,12966,-3483
2019,1,15,23,17500,17573,14130,-3443
2019,1,16,0,17400,17563,14056,-3507
2019,1,16,1,17090,17158,13503,-3655
2019,1,16,2,16510,16521,12897,-3624
2019,1,16,3,15610,15541,12039,-3502
2019,1,16,4,14370,14301,10702,-3599
2019,1,16,5,13270,13321,9831,-3490
2019,1,16,6,12590,13303,9801,-3502
2019,1,16,7,12240,13285,9859,-3426
2019,1,16,8,12100,13236,9817,-3419
2019,1,16,9,12130,13267,9921,-3346
2019,1,16,10,12520,13540,10277,-3263
2019,1,16,11,13540,14273,11105,-3168
2019,1,16,12,15280,15441,12189,-3252
2019,1,16,13,16160,16296,13025,-3271
2019,1,16,14,15850,16105,12741,-3364
2019,1,16,15,15700,15709,12307,-3402
2019,1,16,16,15170,16092,12683,-3409
2019,1,16,17,14750,16112,12693,-3419
2019,1,16,18,14430,16175,12805,-3370
2019,1,16,19,14270,16233,12734,-3499
2019,1,16,20,14460,16156,12519,-3637
2019,1,16,21,14930,16040,12546,-3494
2019,1,16,22,15910,16522,12987,-3535
2019,1,16,23,17150,17308,13753,-3555
2019,1,17,0,17130,17264,13624,-3640
2019,1,17,1,16780,16817,13061,-3756
2019,1,17,2,16240,16432,12641,-3791
2019,1,17,3,15310,15526,11863,-3663
2019,1,17,4,14190,14393,10615,-3778
2019,1,17,5,13230,13618,9763,-3855
2019,1,17,6,12620,13278,9339,-3939
2019,1,17,7,12320,13011,9110,-3901
2019,1,17,8,12270,12849,8956,-3893
2019,1,17,9,12330,12765,9082,-3683
2019,1,17,10,12640,13053,9628,-3425
2019,1,17,11,13780,13864,10287,-3577
2019,1,17,12,15790,15719,12458,-3261
2019,1,17,13,16700,16758,13393,-3365
2019,1,17,14,16570,16508,13000,-3508
2019,1,17,15,16060,15754,12075,-3679
2019,1,17,16,15560,15174,11329,-3845
2019,1,17,17,15090,15082,11167,-3915
2019,1,17,18,14890,14928,11092,-3836
2019,1,17,19,15120,15003,11358,-3645
2019,1,17,20,15380,15281,11743,-3538
2019,1,17,21,15850,15717,12423,-3294
2019,1,17,22,16960,16717,13406,-3311
2019,1,17,23,18090,17816,14433,-3383
2019,1,18,0,18200,17825,14421,-3404
2019,1,18,1,17690,17444,14102,-3342
2019,1,18,2,16950,16819,13423,-3396
2019,1,18,3,15950,15852,12388,-3464
2019,1,18,4,14710,14616,11386,-3230
2019,1,18,5,13590,13754,10530,-3224
2019,1,18,6,12800,12803,9645,-3158
2019,1,18,7,12330,12401,9265,-3136
2019,1,18,8,12190,12205,9255,-2950
2019,1,18,9,12170,12199,9369,-2830
2019,1,18,10,12560,12537,9589,-2948
2019,1,18,11,13520,13539,10540,-2999
2019,1,18,12,15250,15227,12219,-3008
2019,1,18,13,16100,16244,13337,-2907
2019,1,18,14,16200,16354,13301,-3053
2019,1,18,15,16270,16262,13242,-3020
2019,1,18,16,16130,16125,12999,-3126
2019,1,18,17,15810,15691,12431,-3260
2019,1,18,18,15440,15289,11957,-3332
2019,1,18,19,15350,15122,11671,-3451
2019,1,18,20,15410,15180,11721,-3459
2019,1,18,21,15550,15367,11912,-3455
2019,1,18,22,16050,16065,12489,-3576
2019,1,18,23,16850,16756,13097,-3659
2019,1,19,0,16610,16563,12805,-3758
2019,1,19,1,16100,16058,12174,-3884
2019,1,19,2,15490,15519,11562,-3957
2019,1,19,3,14720,14806,10794,-4012
2019,1,19,4,13790,13820,9978,-3842
2019,1,19,5,12850,12964,9557,-3407
2019,1,19,6,12090,12697,8886,-3811
2019,1,19,7,11730,12554,8719,-3835
2019,1,19,8,11510,12664,8709,-3955
2019,1,19,9,11480,12913,8915,-3998
2019,1,19,10,11660,12706,8746,-3960
2019,1,19,11,12120,12334,8583,-3751
2019,1,19,12,12890,13016,9425,-3591
2019,1,19,13,13610,13796,10087,-3709
2019,1,19,14,14210,14303,10340,-3963
2019,1,19,15,14360,14319,10562,-3757
2019,1,19,16,14460,14396,10612,-3784
2019,1,19,17,14480,14593,11082,-3511
2019,1,19,18,14350,14559,11157,-3402
2019,1,19,19,14400,14663,11181,-3482
2019,1,19,20,14510,14917,11436,-3481
2019,1,19,21,14920,15247,12259,-2988
2019,1,19,22,15900,15972,13837,-2135
2019,1,19,23,16800,16702,14395,-2307
2019,1,20,0,16310,16536,13748,-2788
2019,1,20,1,15820,16088,13033,-3055
2019,1,20,2,15150,15528,12429,-3099
2019,1,20,3,14460,14848,11738,-3110
2019,1,20,4,13640,14206,10992,-3214
2019,1,20,5,12900,13210,10171,-3039
2019,1,20,6,12330,12434,9365,-3069
2019,1,20,7,11920,12156,9303,-2853
2019,1,20,8,11660,12336,9353,-2983
2019,1,20,9,11550,12527,9388,-3139
2019,1,20,10,11620,12620,9428,-3192
2019,1,20,11,11850,12705,9671,-3034
2019,1,20,12,12300,13150,10220,-2930
2019,1,20,13,12890,13461,10508,-2953
2019,1,20,14,13800,14306,11209,-3097
2019,1,20,15,14560,15004,12007,-2997
2019,1,20,16,15430,15678,12860,-2818
2019,1,20,17,16090,16195,13218,-2977
2019,1,20,18,16120,16507,13790,-2717
2019,1,20,19,16120,16443,13493,-2950
2019,1,20,20,16130,16334,13318,-3016
2019,1,20,21,16290,16326,13158,-3168
2019,1,20,22,16800,16727,13628,-3099
2019,1,20,23,18100,17597,14504,-3093
2019,1,21,0,17820,17380,14290,-3090
2019,1,21,1,17380,16761,13632,-3129
2019,1,21,2,16890,16554,13497,-3057
2019,1,21,3,15960,15961,12976,-2985
2019,1,21,4,14980,15464,12548,-2916
2019,1,21,5,14060,14558,11591,-2967
2019,1,21,6,13790,14161,11163,-2998
2019,1,21,7,13550,14274,11142,-3132
2019,1,21,8,13460,13973,10888,-3085
2019,1,21,9,13540,14044,10941,-3103
2019,1,21,10,13990,14384,11425,-2959
2019,1,21,11,14770,14915,12152,-2763
2019,1,21,12,15810,16047,13151,-2896
2019,1,21,13,16820,17040,14115,-2925
2019,1,21,14,17600,17827,15106,-2721
2019,1,21,15,18370,18371,15862,-2509
2019,1,21,16,18540,18762,16116,-2646
2019,1,21,17,18580,18961,16341,-2620
2019,1,21,18,18550,18957,16420,-2537
2019,1,21,19,18340,18949,16575,-2374
2019,1,21,20,18290,18990,16621,-2369
2019,1,21,21,18530,19127,17091,-2036
2019,1,21,22,19410,19721,17546,-2175
2019,1,21,23,20700,20709,18298,-2411
2019,1,22,0,20390,20610,18272,-2338
2019,1,22,1,19880,20142,18187,-1955
2019,1,22,2,19120,19397,17330,-2067
2019,1,22,3,17970,18347,16089,-2258
2019,1,22,4,16740,17059,15149,-1910
2019,1,22,5,15720,15959,13935,-2024
2019,1,22,6,15130,15271,12995,-2276
2019,1,22,7,14850,15191,12974,-2217
2019,1,22,8,14790,15034,12849,-2185
2019,1,22,9,14820,15042,12744,-2298
2019,1,22,10,15110,15355,12863,-2492
2019,1,22,11,16100,16007,13584,-2423
2019,1,22,12,17820,17587,15516,-2071
2019,1,22,13,18870,18563,16099,-2464
2019,1,22,14,18710,18638,16218,-2420
2019,1,22,15,18280,18300,15470,-2830
2019,1,22,16,17850,17959,15249,-2710
2019,1,22,17,17640,17651,14824,-2827
2019,1,22,18,17310,17495,14428,-3067
2019,1,22,19,17280,17369,14390,-2979
2019,1,22,20,17370,17509,14337,-3172
2019,1,22,21,17500,17508,14479,-3029
2019,1,22,22,18340,17951,14807,-3144
2019,1,22,23,19410,19027,15763,-3264
2019,1,23,0,19470,19060,15796,-3264
2019,1,23,1,19070,18612,15381,-3231
2019,1,23,2,18370,17944,14900,-3044
2019,1,23,3,17230,16898,14150,-2748
2019,1,23,4,15900,15853,13201,-2652
2019,1,23,5,14760,14835,12257,-2578
2019,1,23,6,13840,14649,11798,-2851
2019,1,23,7,13500,14346,11704,-2642
2019,1,23,8,13350,14428,11739,-2689
2019,1,23,9,13330,14416,11826,-2590
2019,1,23,10,13640,14276,11584,-2692
2019,1,23,11,14590,14620,12021,-2599
2019,1,23,12,16230,16209,13546,-2663
2019,1,23,13,17060,17082,14181,-2901
2019,1,23,14,17310,17176,14148,-3028
2019,1,23,15,17150,17144,14157,-2987
2019,1,23,16,16870,17091,13904,-3187
2019,1,23,17,16560,16915,13616,-3299
2019,1,23,18,16200,16661,13268,-3393
2019,1,23,19,16060,16789,13387,-3402
2019,1,23,20,16200,16655,13286,-3369
2019,1,23,21,16530,16665,13442,-3223
2019,1,23,22,17100,16895,13687,-3208
2019,1,23,23,17700,17633,14397,-3236
2019,1,24,0,17500,17454,14101,-3353
2019,1,24,1,16930,16919,13451,-3468
2019,1,24,2,15960,16153,12664,-3489
2019,1,24,3,14810,15094,11616,-3478
2019,1,24,4,13590,14007,10396,-3611
2019,1,24,5,12550,13191,9588,-3603
2019,1,24,6,11880,13127,9534,-3593
2019,1,24,7,11480,12838,9307,-3531
2019,1,24,8,11230,12591,9323,-3268
2019,1,24,9,11180,12495,9259,-3236
2019,1,24,10,11440,12502,9307,-3195
2019,1,24,11,12370,13236,9710,-3526
2019,1,24,12,13970,14306,10424,-3882
2019,1,24,13,14890,14887,11046,-3841
2019,1,24,14,15090,15107,11446,-3661
2019,1,24,15,15230,15230,11454,-3776
2019,1,24,16,15300,15322,11620,-3702
2019,1,24,17,15400,15430,11926,-3504
2019,1,24,18,15450,15675,12002,-3673
2019,1,24,19,15430,15687,12061,-3626
2019,1,24,20,15630,15588,11883,-3705
2019,1,24,21,15670,15425,11644,-3781
2019,1,24,22,16130,15803,11922,-3881
2019,1,24,23,16800,16361,12331,-4030
2019,1,25,0,16560,16199,12209,-3990
2019,1,25,1,16170,15724,11756,-3968
2019,1,25,2,15500,15184,11350,-3834
2019,1,25,3,14540,14512,10774,-3738
2019,1,25,4,13340,13477,9834,-3643
2019,1,25,5,12360,12950,9366,-3584
2019,1,25,6,11710,12363,8940,-3423
2019,1,25,7,11410,11945,8656,-3289
2019,1,25,8,11290,11827,8673,-3154
2019,1,25,9,11360,11889,8818,-3071
2019,1,25,10,11800,11910,8932,-2978
2019,1,25,11,12760,12776,9529,-3247
2019,1,25,12,14420,14514,10714,-3800
2019,1,25,13,15500,15481,11680,-3801
2019,1,25,14,15340,15403,11668,-3735
2019,1,25,15,14730,14781,11124,-3657
2019,1,25,16,14200,14433,10587,-3846
2019,1,25,17,13870,14375,10550,-3825
2019,1,25,18,13840,14201,10383,-3818
2019,1,25,19,14020,14414,10504,-3910
2019,1,25,20,14370,14407,10594,-3813
2019,1,25,21,14680,14791,10780,-4011
2019,1,25,22,15510,15561,11557,-4004
2019,1,25,23,16600,16604,12703,-3901
2019,1,26,0,16560,16612,12655,-3957
2019,1,26,1,16120,16256,12200,-4056
2019,1,26,2,15580,15803,11634,-4169
2019,1,26,3,14950,15159,11010,-4149
2019,1,26,4,14050,14443,10385,-4058
2019,1,26,5,13120,13553,9735,-3818
2019,1,26,6,12630,12915,9195,-3720
2019,1,26,7,12250,12530,8932,-3598
2019,1,26,8,12100,12608,8794,-3814
2019,1,26,9,12100,12538,8954,-3584
2019,1,26,10,12280,12396,8872,-3524
2019,1,26,11,12760,12758,9040,-3718
2019,1,26,12,13540,13534,9759,-3775
2019,1,26,13,14230,14245,10587,-3658
2019,1,26,14,14580,14587,11008,-3579
2019,1,26,15,14360,14349,10824,-3525
2019,1,26,16,14150,13937,10515,-3422
2019,1,26,17,14000,13563,10096,-3467
2019,1,26,18,13800,13523,10003,-3520
2019,1,26,19,13680,13625,10467,-3158
2019,1,26,20,13890,13747,10650,-3097
2019,1,26,21,14240,14138,10967,-3171
2019,1,26,22,15080,15126,11834,-3292
2019,1,26,23,16180,16224,12742,-3482
2019,1,27,0,16250,16211,12545,-3666
2019,1,27,1,15770,15799,12114,-3685
2019,1,27,2,15100,15349,11574,-3775
2019,1,27,3,14500,14778,10978,-3800
2019,1,27,4,13750,14012,10496,-3516
2019,1,27,5,12960,13224,9795,-3429
2019,1,27,6,12330,12600,9174,-3426
2019,1,27,7,11960,12209,9022,-3187
2019,1,27,8,11750,12256,8979,-3277
2019,1,27,9,11670,12250,9145,-3105
2019,1,27,10,12080,12358,9573,-2785
2019,1,27,11,12340,12672,9641,-3031
2019,1,27,12,12810,13004,9860,-3144
2019,1,27,13,13340,13501,10116,-3385
2019,1,27,14,13740,13872,10573,-3299
2019,1,27,15,13840,13847,10405,-3442
2019,1,27,16,13670,13925,10429,-3496
2019,1,27,17,13530,13942,10196,-3746
2019,1,27,18,13420,14246,10597,-3649
2019,1,27,19,13440,14204,10760,-3444
2019,1,27,20,13670,14020,10562,-3458
2019,1,27,21,13990,14494,10833,-3661
2019,1,27,22,14760,15041,11510,-3531
2019,1,27,23,15810,16101,12574,-3527
2019,1,28,0,15750,16089,12536,-3553
2019,1,28,1,15220,15588,12137,-3451
2019,1,28,2,14800,14920,11272,-3648
2019,1,28,3,14170,13972,10239,-3733
2019,1,28,4,13260,13086,9465,-3621
2019,1,28,5,12430,12518,9168,-3350
2019,1,28,6,11410,12142,8778,-3364
2019,1,28,7,11190,11561,8718,-2843
2019,1,28,8,11140,11432,8573,-2859
2019,1,28,9,11300,11578,8241,-3337
2019,1,28,10,11810,11897,8624,-3273
2019,1,28,11,13020,12989,9994,-2995
2019,1,28,12,14920,14886,11532,-3354
2019,1,28,13,15980,15983,12167,-3816
2019,1,28,14,15940,15962,12177,-3785
2019,1,28,15,15200,15312,11224,-4088
2019,1,28,16,14880,14854,10662,-4192
2019,1,28,17,14700,14533,10487,-4046
2019,1,28,18,14580,14662,10712,-3950
2019,1,28,19,14570,14861,10922,-3939
2019,1,28,20,14730,15101,11044,-4057
2019,1,28,21,15220,15601,11329,-4272
2019,1,28,22,16140,16454,12412,-4042
2019,1,28,23,17410,17703,13478,-4225
2019,1,29,0,17600,17900,13586,-4314
2019,1,29,1,17140,17498,13246,-4252
2019,1,29,2,16400,16869,12598,-4271
2019,1,29,3,15420,15888,11943,-3945
2019,1,29,4,14200,14676,10785,-3891
2019,1,29,5,13170,13666,9785,-3881
2019,1,29,6,13020,13269,9494,-3775
2019,1,29,7,12680,13182,9469,-3713
2019,1,29,8,12550,13251,9377,-3874
2019,1,29,9,12610,13379,9692,-3687
2019,1,29,10,12990,13598,10027,-3571
2019,1,29,11,14040,14275,10689,-3586
2019,1,29,12,15860,15822,12155,-3667
2019,1,29,13,16710,16716,13044,-3672
2019,1,29,14,16670,16686,12833,-3853
2019,1,29,15,16560,16568,12633,-3935
2019,1,29,16,16480,16457,12611,-3846
2019,1,29,17,16340,16439,12615,-3824
2019,1,29,18,16280,16472,13019,-3453
2019,1,29,19,16240,16340,12911,-3429
2019,1,29,20,16470,16363,12892,-3471
2019,1,29,21,16770,16496,13001,-3495
2019,1,29,22,17350,17050,13577,-3473
2019,1,29,23,18100,17928,14430,-3498
2019,1,30,0,17950,17850,14201,-3649
2019,1,30,1,17310,17360,13603,-3757
2019,1,30,2,16440,16668,12871,-3797
2019,1,30,3,15320,15603,11862,-3741
2019,1,30,4,13940,14550,10677,-3873
2019,1,30,5,12810,13758,9983,-3775
2019,1,30,6,12590,13685,9866,-3819
2019,1,30,7,12080,13179,9434,-3745
2019,1,30,8,11880,12967,9527,-3440
2019,1,30,9,11910,12823,9432,-3391
2019,1,30,10,12290,12828,9536,-3292
2019,1,30,11,13320,13418,9987,-3431
2019,1,30,12,14960,14937,11490,-3447
2019,1,30,13,15950,15949,12309,-3640
2019,1,30,14,16180,16200,12313,-3887
2019,1,30,15,15850,15889,11967,-3922
2019,1,30,16,15490,15498,11848,-3650
2019,1,30,17,15150,15181,11745,-3436
2019,1,30,18,15100,14903,11461,-3442
2019,1,30,19,15230,14849,11340,-3509
2019,1,30,20,15630,14961,11409,-3552
2019,1,30,21,16110,15574,12262,-3312
2019,1,30,22,16900,16588,13516,-3072
2019,1,30,23,18050,17925,15049,-2876
2019,1,31,0,18500,18198,15289,-2909
2019,1,31,1,18210,18034,15200,-2834
2019,1,31,2,17800,17650,15316,-2334
2019,1,31,3,17030,16950,14508,-2442
2019,1,31,4,15760,16180,13676,-2504
2019,1,31,5,14760,15326,12838,-2488
2019,1,31,6,14480,14937,12300,-2637
2019,1,31,7,14260,15068,12257,-2811
2019,1,31,8,14200,15010,12189,-2821
2019,1,31,9,14290,14758,11787,-2971
2019,1,31,10,14700,14957,11951,-3006
2019,1,31,11,15780,15756,12852,-2904
2019,1,31,12,17480,17448,14731,-2717
2019,1,31,13,18500,18514,16255,-2259
2019,1,31,14,18540,18559,15990,-2569
2019,1,31,15,18100,18127,15444,-2683
2019,1,31,16,17800,17707,15015,-2692
2019,1,31,17,17560,17373,14695,-2678
2019,1,31,18,17480,17064,14629,-2435
2019,1,31,19,17420,16928,14567,-2361
2019,1,31,20,17580,16940,14599,-2341
2019,1,31,21,18120,17366,14922,-2444
2019,1,31,22,18930,18238,15234,-3004
2019,1,31,23,19910,19379,16459,-2920
2019,2,1,0,20110,19651,16857,-2794
2019,2,1,1,19600,19351,16570,-2781
2019,2,1,2,18810,18776,16334,-2442
2019,2,1,3,17790,17855,15058,-2797
2019,2,1,4,16500,16630,13964,-2666
2019,2,1,5,15440,15562,13185,-2377
2019,2,1,6,14570,14931,12659,-2272
2019,2,1,7,14270,14617,12241,-2376
2019,2,1,8,14120,14740,12351,-2389
2019,2,1,9,14200,14777,12567,-2210
2019,2,1,10,14530,14987,12750,-2237
2019,2,1,11,15550,15808,13449,-2359
2019,2,1,12,17250,17451,15500,-1951
2019,2,1,13,18160,18338,16358,-1980
2019,2,1,14,17940,18129,16063,-2066
2019,2,1,15,17650,17650,15702,-1948
2019,2,1,16,17270,17312,15079,-2233
2019,2,1,17,16870,16954,14612,-2342
2019,2,1,18,16580,16626,14392,-2234
2019,2,1,19,16490,16684,14179,-2505
2019,2,1,20,16310,16693,14169,-2524
2019,2,1,21,16510,16987,14280,-2707
2019,2,1,22,17170,17416,15067,-2349
2019,2,1,23,18310,18394,16029,-2365
2019,2,2,0,18420,18497,16077,-2420
2019,2,2,1,18040,18222,15830,-2392
2019,2,2,2,17470,17754,15522,-2232
2019,2,2,3,16650,17080,14156,-2924
2019,2,2,4,15750,16168,13276,-2892
2019,2,2,5,14830,15232,12678,-2554
2019,2,2,6,14360,14578,11788,-2790
2019,2,2,7,14020,14198,11440,-2758
2019,2,2,8,13850,14029,11552,-2477
2019,2,2,9,13810,13994,11560,-2434
2019,2,2,10,13970,14115,11724,-2391
2019,2,2,11,14380,14532,11960,-2572
2019,2,2,12,15090,15276,12894,-2382
2019,2,2,13,15700,15976,13072,-2904
2019,2,2,14,16240,16374,13147,-3227
2019,2,2,15,16250,16247,13038,-3209
2019,2,2,16,15990,15854,12323,-3531
2019,2,2,17,15670,16023,12489,-3534
2019,2,2,18,15360,15903,12492,-3411
2019,2,2,19,15240,15675,12209,-3466
2019,2,2,20,15290,15671,12137,-3534
2019,2,2,21,15530,15754,12129,-3625
2019,2,2,22,16170,16299,12603,-3696
2019,2,2,23,16830,17054,13419,-3635
2019,2,3,0,16930,16997,13471,-3526
2019,2,3,1,16520,16502,13039,-3463
2019,2,3,2,15990,15909,12505,-3404
2019,2,3,3,15290,15122,11827,-3295
2019,2,3,4,14400,14222,11206,-3016
2019,2,3,5,13500,13338,10417,-2921
2019,2,3,6,12680,12992,9680,-3312
2019,2,3,7,12240,12692,9407,-3285
2019,2,3,8,12000,12718,9512,-3206
2019,2,3,9,11910,12658,9236,-3422
2019,2,3,10,11930,12879,9277,-3602
2019,2,3,11,12160,12957,9376,-3581
2019,2,3,12,12620,13048,9672,-3376
2019,2,3,13,13160,13663,10134,-3529
2019,2,3,14,13800,14416,10798,-3618
2019,2,3,15,14420,14719,10970,-3749
2019,2,3,16,14480,14930,11118,-3812
2019,2,3,17,14730,15029,11120,-3909
2019,2,3,18,15010,14965,11015,-3950
2019,2,3,19,14840,14976,11033,-3943
2019,2,3,20,14820,14608,10713,-3895
2019,2,3,21,15080,14809,10816,-3993
2019,2,3,22,15590,15610,11691,-3919
2019,2,3,23,16280,16476,12757,-3719
2019,2,4,0,15930,16011,12390,-3621
2019,2,4,1,15110,15257,11685,-3572
2019,2,4,2,14620,14889,11313,-3576
2019,2,4,3,13900,14179,10566,-3613
2019,2,4,4,13050,13520,9907,-3613
2019,2,4,5,12340,12879,9615,-3264
2019,2,4,6,11490,12197,8858,-3339
2019,2,4,7,11060,12131,8864,-3267
2019,2,4,8,10940,11830,8847,-2983
2019,2,4,9,11000,11754,8837,-2917
2019,2,4,10,11370,12120,9005,-3115
2019,2,4,11,12390,12841,9580,-3261
2019,2,4,12,14100,14229,11256,-2973
2019,2,4,13,14950,15020,11963,-3057
2019,2,4,14,14700,14759,11585,-3174
2019,2,4,15,14160,14112,10813,-3299
2019,2,4,16,13700,13590,10181,-3409
2019,2,4,17,13320,13427,10050,-3377
2019,2,4,18,13130,13162,9855,-3307
2019,2,4,19,13000,13432,10032,-3400
2019,2,4,20,13030,13355,9967,-3388
2019,2,4,21,13430,13690,10434,-3256
2019,2,4,22,14220,14420,10941,-3479
2019,2,4,23,15600,15567,12029,-3538
2019,2,5,0,15870,15876,12302,-3574
2019,2,5,1,15450,15490,11992,-3498
2019,2,5,2,14850,14827,11427,-3400
2019,2,5,3,13850,13883,10353,-3530
2019,2,5,4,12700,12865,9356,-3509
2019,2,5,5,11700,12014,8895,-3119
2019,2,5,6,11070,11673,8580,-3093
2019,2,5,7,10680,11793,8917,-2876
2019,2,5,8,10530,11772,8878,-2894
2019,2,5,9,10540,11779,8947,-2832
2019,2,5,10,10880,11882,9086,-2796
2019,2,5,11,11860,12844,9707,-3137
2019,2,5,12,13550,13782,10770,-3012
2019,2,5,13,14390,14625,11615,-3010
2019,2,5,14,14180,14519,11399,-3120
2019,2,5,15,14200,14225,11045,-3180
2019,2,5,16,13690,13669,10625,-3044
2019,2,5,17,13280,13038,10205,-2833
2019,2,5,18,13070,12758,10223,-2535
2019,2,5,19,12940,12469,9870,-2599
2019,2,5,20,12980,12638,10049,-2589
2019,2,5,21,13400,13411,10496,-2915
2019,2,5,22,14070,14032,10880,-3152
2019,2,5,23,15280,15168,12234,-2934
2019,2,6,0,15600,15466,12621,-2845
2019,2,6,1,15180,15135,12081,-3054
2019,2,6,2,14770,14633,11754,-2879
2019,2,6,3,13880,13652,11371,-2281
2019,2,6,4,12750,12815,10306,-2509
2019,2,6,5,11790,11873,9371,-2502
2019,2,6,6,11310,11276,8943,-2333
2019,2,6,7,10980,10983,8689,-2294
2019,2,6,8,10860,10866,8505,-2361
2019,2,6,9,10670,10967,8468,-2499
2019,2,6,10,11080,11166,8773,-2393
2019,2,6,11,12140,12269,9645,-2624
2019,2,6,12,13920,14048,10864,-3184
2019,2,6,13,14760,14952,11932,-3020
2019,2,6,14,14610,14422,11488,-2934
2019,2,6,15,13700,13696,10694,-3002
2019,2,6,16,13640,13206,10265,-2941
2019,2,6,17,12950,12925,10036,-2889
2019,2,6,18,13020,12844,10048,-2796
2019,2,6,19,13240,13237,10186,-3051
2019,2,6,20,13620,13728,10967,-2761
2019,2,6,21,14270,14302,11755,-2547
2019,2,6,22,15060,15177,12440,-2737
2019,2,6,23,16200,16352,13726,-2626
2019,2,7,0,16420,16487,13857,-2630
2019,2,7,1,15910,16074,13282,-2792
2019,2,7,2,15300,15480,12603,-2877
2019,2,7,3,14340,14523,11182,-3341
2019,2,7,4,13140,13305,9894,-3411
2019,2,7,5,12110,12273,9084,-3189
2019,2,7,6,11500,11693,8594,-3099
2019,2,7,7,11130,11572,8385,-3187
2019,2,7,8,10980,11572,8674,-2898
2019,2,7,9,10990,11330,8554,-2776
2019,2,7,10,11360,11386,8627,-2759
2019,2,7,11,12420,12364,9346,-3018
2019,2,7,12,14040,14078,10847,-3231
2019,2,7,13,14990,15057,12061,-2996
2019,2,7,14,15150,15199,12639,-2560
2019,2,7,15,15250,15226,12396,-2830
2019,2,7,16,15410,15256,12002,-3254
2019,2,7,17,15450,15228,12110,-3118
2019,2,7,18,15250,15032,11941,-3091
2019,2,7,19,15250,14916,11879,-3037
2019,2,7,20,15140,15138,11955,-3183
2019,2,7,21,15240,15362,12131,-3231
2019,2,7,22,15550,15624,12407,-3217
2019,2,7,23,16570,16381,13177,-3204
2019,2,8,0,16490,16366,13078,-3288
2019,2,8,1,16020,15937,12831,-3106
2019,2,8,2,15340,15312,12100,-3212
2019,2,8,3,14330,14379,11034,-3345
2019,2,8,4,13210,13159,9960,-3199
2019,2,8,5,12090,12129,9206,-2923
2019,2,8,6,11400,11743,8815,-2928
2019,2,8,7,11020,11840,8766,-3074
2019,2,8,8,10850,11887,8765,-3122
2019,2,8,9,10840,11902,8814,-3088
2019,2,8,10,11170,12139,8970,-3169
2019,2,8,11,12140,12413,9211,-3202
2019,2,8,12,13800,13809,10869,-2940
2019,2,8,13,14780,14780,11730,-3050
2019,2,8,14,15090,15084,12194,-2890
2019,2,8,15,15240,15256,12233,-3023
2019,2,8,16,15200,15236,12057,-3179
2019,2,8,17,14930,14978,11788,-3190
2019,2,8,18,14070,14105,10792,-3313
2019,2,8,19,13460,13879,10616,-3263
2019,2,8,20,13290,13841,10577,-3264
2019,2,8,21,13480,14009,10868,-3141
2019,2,8,22,14030,14604,11742,-2862
2019,2,8,23,15280,15367,12643,-2724
2019,2,9,0,15450,15669,13016,-2653
2019,2,9,1,15250,15385,12699,-2686
2019,2,9,2,14910,15010,12471,-2539
2019,2,9,3,14300,14431,11649,-2782
2019,2,9,4,13490,13603,10856,-2747
2019,2,9,5,12700,13000,10604,-2396
2019,2,9,6,12200,12618,9752,-2866
2019,2,9,7,11880,12655,9716,-2939
2019,2,9,8,11780,12808,9683,-3125
2019,2,9,9,11800,12841,9758,-3083
2019,2,9,10,12020,12951,9887,-3064
2019,2,9,11,12520,13295,10133,-3162
2019,2,9,12,13310,13897,10778,-3119
2019,2,9,13,13950,14000,10974,-3026
2019,2,9,14,14100,14118,11063,-3055
2019,2,9,15,13840,13827,11085,-2742
2019,2,9,16,13460,13481,10534,-2947
2019,2,9,17,13120,13205,10355,-2850
2019,2,9,18,12960,13177,10253,-2924
2019,2,9,19,12830,13011,9925,-3086
2019,2,9,20,12970,13193,10315,-2878
2019,2,9,21,13750,13784,10811,-2973
2019,2,9,22,14560,14748,11644,-3104
2019,2,9,23,15750,15985,12695,-3290
2019,2,10,0,16250,16292,13142,-3150
2019,2,10,1,15570,15928,12548,-3380
2019,2,10,2,15190,15446,12120,-3326
2019,2,10,3,14610,14854,11371,-3483
2019,2,10,4,13850,14055,10692,-3363
2019,2,10,5,13090,13278,10300,-2978
2019,2,10,6,12660,12690,9662,-3028
2019,2,10,7,12330,12575,9382,-3193
2019,2,10,8,12160,12661,9529,-3132
2019,2,10,9,12110,12634,9546,-3088
2019,2,10,10,12210,12516,9357,-3159
2019,2,10,11,12520,12800,9808,-2992
2019,2,10,12,13050,13119,10188,-2931
2019,2,10,13,13460,13468,10602,-2866
2019,2,10,14,13500,13512,10547,-2965
2019,2,10,15,13220,13327,10514,-2813
2019,2,10,16,13040,13340,10357,-2983
2019,2,10,17,12860,13315,10387,-2928
2019,2,10,18,12860,13226,10297,-2929
2019,2,10,19,12920,13436,10806,-2630
2019,2,10,20,13310,13777,10860,-2917
2019,2,10,21,13750,13936,10817,-3119
2019,2,10,22,14580,14896,11384,-3512
2019,2,10,23,15770,16292,12940,-3352
2019,2,11,0,16200,16641,13172,-3469
2019,2,11,1,15640,16237,12663,-3574
2019,2,11,2,15070,15577,12066,-3511
2019,2,11,3,14380,14633,10977,-3656
2019,2,11,4,13370,13517,9843,-3674
2019,2,11,5,12600,12606,9061,-3545
2019,2,11,6,11900,12374,9047,-3327
2019,2,11,7,11580,12652,9063,-3589
2019,2,11,8,11480,12639,9115,-3524
2019,2,11,9,11530,12702,9243,-3459
2019,2,11,10,11870,12948,9565,-3383
2019,2,11,11,12920,13502,10182,-3320
2019,2,11,12,14600,14927,11696,-3231
2019,2,11,13,15530,15889,12559,-3330
2019,2,11,14,15550,15907,12574,-3333
2019,2,11,15,15280,15511,12257,-3254
2019,2,11,16,15120,14955,11759,-3196
2019,2,11,17,14750,14396,11378,-3018
2019,2,11,18,14180,14243,11410,-2833
2019,2,11,19,14060,14196,11282,-2914
2019,2,11,20,14260,14254,11074,-3180
2019,2,11,21,14690,14845,11542,-3303
2019,2,11,22,15470,15697,12376,-3321
2019,2,11,23,16900,16827,13436,-3391
2019,2,12,0,17400,17232,13747,-3485
2019,2,12,1,16910,16879,13267,-3612
2019,2,12,2,16250,16299,12687,-3612
2019,2,12,3,15350,15370,11668,-3702
2019,2,12,4,14180,14192,10976,-3216
2019,2,12,5,13290,13372,10209,-3163
2019,2,12,6,12600,12878,9584,-3294
2019,2,12,7,12320,12608,9319,-3289
2019,2,12,8,12250,12764,9450,-3314
2019,2,12,9,12350,12699,9408,-3291
2019,2,12,10,12760,13051,9858,-3193
2019,2,12,11,13960,13883,10905,-2978
2019,2,12,12,15930,15536,12496,-3040
2019,2,12,13,16810,16380,13402,-2978
2019,2,12,14,16630,16621,13739,-2882
2019,2,12,15,16620,16662,13306,-3356
2019,2,12,16,16470,16819,13821,-2998
2019,2,12,17,17000,16980,13900,-3080
2019,2,12,18,16930,17109,14317,-2792
2019,2,12,19,17050,17244,14316,-2928
2019,2,12,20,17010,17165,14212,-2953
2019,2,12,21,17160,17094,14126,-2968
2019,2,12,22,17260,17439,14576,-2863
2019,2,12,23,18110,18279,15533,-2746
2019,2,13,0,18030,18217,15386,-2831
2019,2,13,1,17460,17550,14534,-3016
2019,2,13,2,16730,16650,13513,-3137
2019,2,13,3,15600,15502,12304,-3198
2019,2,13,4,14360,14307,11050,-3257
2019,2,13,5,13190,13480,10152,-3328
2019,2,13,6,12440,12598,9324,-3274
2019,2,13,7,12010,12350,9059,-3291
2019,2,13,8,11780,12439,9101,-3338
2019,2,13,9,11770,12649,9240,-3409
2019,2,13,10,12060,12779,9533,-3246
2019,2,13,11,13030,13039,9700,-3339
2019,2,13,12,14700,14410,11230,-3180
2019,2,13,13,15580,15351,12085,-3266
2019,2,13,14,15630,15786,12434,-3352
2019,2,13,15,15700,15773,12508,-3265
2019,2,13,16,15520,15616,12346,-3270
2019,2,13,17,15280,15065,11704,-3361
2019,2,13,18,15170,14701,11227,-3474
2019,2,13,19,15150,14901,11414,-3487
2019,2,13,20,15070,15024,11570,-3454
2019,2,13,21,15160,15200,11849,-3351
2019,2,13,22,15730,15661,12266,-3395
2019,2,13,23,16710,16611,13176,-3435
2019,2,14,0,17050,16858,13503,-3355
2019,2,14,1,16580,16457,13067,-3390
2019,2,14,2,16000,15861,12474,-3387
2019,2,14,3,15050,14974,11686,-3288
2019,2,14,4,13890,13850,10456,-3394
2019,2,14,5,12910,13091,9556,-3535
2019,2,14,6,12160,12555,9312,-3243
2019,2,14,7,11820,12421,9281,-3140
2019,2,14,8,11680,12466,9239,-3227
2019,2,14,9,11760,12786,9443,-3343
2019,2,14,10,12160,12936,9803,-3133
2019,2,14,11,13140,13485,10555,-2930
2019,2,14,12,14900,14902,12023,-2879
2019,2,14,13,15560,15613,12652,-2961
2019,2,14,14,15200,15257,12282,-2975
2019,2,14,15,14710,14832,11885,-2947
2019,2,14,16,14240,14907,11821,-3086
2019,2,14,17,13920,14877,11884,-2993
2019,2,14,18,13670,14507,11492,-3015
2019,2,14,19,13620,14258,11389,-2869
2019,2,14,20,13680,13917,11012,-2905
2019,2,14,21,14060,14383,11544,-2839
2019,2,14,22,14900,14856,11809,-3047
2019,2,14,23,16280,16044,12517,-3527
2019,2,15,0,16760,16499,13162,-3337
2019,2,15,1,16340,16194,12985,-3209
2019,2,15,2,15780,15669,12555,-3114
2019,2,15,3,14930,14825,11502,-3323
2019,2,15,4,13780,13705,10466,-3239
2019,2,15,5,12750,12916,9964,-2952
2019,2,15,6,12020,12488,9835,-2653
2019,2,15,7,11640,12406,9814,-2592
2019,2,15,8,11470,12275,9798,-2477
2019,2,15,9,11480,12274,9706,-2568
2019,2,15,10,11800,12350,9856,-2494
2019,2,15,11,12770,13014,10648,-2366
2019,2,15,12,14300,14337,11779,-2558
2019,2,15,13,14940,15152,12249,-2903
2019,2,15,14,14970,15226,12391,-2835
2019,2,15,15,15100,15116,12407,-2709
2019,2,15,16,14950,15265,12504,-2761
2019,2,15,17,15200,15191,12234,-2957
2019,2,15,18,14950,15122,11946,-3176
2019,2,15,19,14840,14932,11696,-3236
2019,2,15,20,14810,14653,11363,-3290
2019,2,15,21,14870,14578,11224,-3354
2019,2,15,22,15310,14904,11600,-3304
2019,2,15,23,15700,15576,12250,-3326
2019,2,16,0,15590,15613,12154,-3459
2019,2,16,1,15020,15101,11504,-3597
2019,2,16,2,14430,14496,10976,-3520
2019,2,16,3,13700,13960,10431,-3529
2019,2,16,4,12790,13039,9687,-3352
2019,2,16,5,11910,12366,9241,-3125
2019,2,16,6,11120,12014,8692,-3322
2019,2,16,7,10820,11900,8548,-3352
2019,2,16,8,10660,11742,8357,-3385
2019,2,16,9,10650,11703,8331,-3372
2019,2,16,10,10940,11874,8503,-3371
2019,2,16,11,11410,11952,8655,-3297
2019,2,16,12,12050,12291,9122,-3169
2019,2,16,13,12570,12913,9622,-3291
2019,2,16,14,12890,13157,10085,-3072
2019,2,16,15,12500,12798,10094,-2704
2019,2,16,16,12160,12528,9756,-2772
2019,2,16,17,11840,12288,9654,-2634
2019,2,16,18,11710,12056,9412,-2644
2019,2,16,19,11520,11853,9261,-2592
2019,2,16,20,11730,11950,9420,-2530
2019,2,16,21,12260,12479,9826,-2653
2019,2,16,22,13070,13289,10672,-2617
2019,2,16,23,14310,14551,11570,-2981
2019,2,17,0,15000,15056,12043,-3013
2019,2,17,1,14560,14780,11484,-3296
2019,2,17,2,14210,14388,11163,-3225
2019,2,17,3,13670,13833,10872,-2961
2019,2,17,4,13000,13114,10375,-2739
2019,2,17,5,12270,12490,9858,-2632
2019,2,17,6,11800,12155,9358,-2797
2019,2,17,7,11500,11860,9015,-2845
2019,2,17,8,11320,11721,8885,-2836
2019,2,17,9,11300,11700,8945,-2755
2019,2,17,10,11480,11840,8872,-2968
2019,2,17,11,11730,12201,9172,-3029
2019,2,17,12,12010,12595,9519,-3076
2019,2,17,13,12290,12859,9850,-3009
2019,2,17,14,12530,12733,9869,-2864
2019,2,17,15,12430,12435,9667,-2768
2019,2,17,16,12420,12152,9098,-3054
2019,2,17,17,11850,12159,9105,-3054
2019,2,17,18,11880,11748,8683,-3065
2019,2,17,19,12170,11802,8882,-2920
2019,2,17,20,12580,12099,9302,-2797
2019,2,17,21,13320,12685,9993,-2692
2019,2,17,22,14170,13762,10616,-3146
2019,2,17,23,15390,15117,12103,-3014
2019,2,18,0,15650,15596,11939,-3657
2019,2,18,1,15190,15233,11330,-3903
2019,2,18,2,14740,14711,11021,-3690
2019,2,18,3,13890,13947,10191,-3756
2019,2,18,4,12940,13049,9714,-3335
2019,2,18,5,12100,12267,9286,-2981
2019,2,18,6,11700,12078,9120,-2958
2019,2,18,7,11450,12206,9296,-2910
2019,2,18,8,11330,12284,9303,-2981
2019,2,18,9,11410,12468,9377,-3091
2019,2,18,10,11700,12424,9557,-2867
2019,2,18,11,12420,12835,10025,-2810
2019,2,18,12,13500,13495,10759,-2736
2019,2,18,13,14370,14375,11386,-2989
2019,2,18,14,15100,15120,12788,-2332
2019,2,18,15,15700,15712,13002,-2710
2019,2,18,16,15820,16083,12744,-3339
2019,2,18,17,15840,16212,12904,-3308
2019,2,18,18,15660,16158,12884,-3274
2019,2,18,19,15510,16008,12744,-3264
2019,2,18,20,15410,15809,12502,-3307
2019,2,18,21,15430,15789,12492,-3297
2019,2,18,22,15840,16088,12889,-3199
2019,2,18,23,16860,16892,13616,-3276
2019,2,19,0,17150,17167,13950,-3217
2019,2,19,1,16790,16686,13606,-3080
2019,2,19,2,16120,16067,13028,-3039
2019,2,19,3,15230,15200,12441,-2759
2019,2,19,4,14100,14177,11566,-2611
2019,2,19,5,13040,13339,10671,-2668
2019,2,19,6,12780,13041,10380,-2661
2019,2,19,7,12500,13042,10147,-2895
2019,2,19,8,12430,13241,10199,-3042
2019,2,19,9,12540,13339,10369,-2970
2019,2,19,10,12970,13599,10861,-2738
2019,2,19,11,13980,14158,11456,-2702
2019,2,19,12,15470,15466,12865,-2601
2019,2,19,13,16340,16355,13421,-2934
2019,2,19,14,16430,16450,13472,-2978
2019,2,19,15,16200,16219,13445,-2774
2019,2,19,16,15770,15935,13159,-2776
2019,2,19,17,15400,15600,12610,-2990
2019,2,19,18,14870,15807,12692,-3115
2019,2,19,19,14870,15750,12655,-3095
2019,2,19,20,14820,15596,12424,-3172
2019,2,19,21,15010,15744,12575,-3169
2019,2,19,22,15820,15916,12864,-3052
2019,2,19,23,16960,16987,13779,-3208
2019,2,20,0,17590,17509,14469,-3040
2019,2,20,1,17340,17195,14432,-2763
2019,2,20,2,16810,16629,13807,-2822
2019,2,20,3,15820,15760,12811,-2949
2019,2,20,4,14700,14834,11815,-3019
2019,2,20,5,13810,13951,10941,-3010
2019,2,20,6,13070,13354,10751,-2603
2019,2,20,7,12760,13050,10398,-2652
2019,2,20,8,12680,13166,10507,-2659
2019,2,20,9,12740,13292,10736,-2556
2019,2,20,10,13150,13539,10885,-2654
2019,2,20,11,14150,14146,11722,-2424
2019,2,20,12,15660,15665,13167,-2498
2019,2,20,13,16470,16496,13739,-2757
2019,2,20,14,16580,16615,13862,-2753
2019,2,20,15,16380,16520,13646,-2874
2019,2,20,16,16360,16384,13402,-2982
2019,2,20,17,16300,16354,13493,-2861
2019,2,20,18,16210,16261,13494,-2767
2019,2,20,19,16140,16271,13479,-2792
2019,2,20,20,16120,16149,13778,-2371
2019,2,20,21,16170,16194,13905,-2289
2019,2,20,22,16380,16584,14130,-2454
2019,2,20,23,17270,17467,14416,-3051
2019,2,21,0,17770,17728,14616,-3112
2019,2,21,1,17400,17272,14122,-3150
2019,2,21,2,16750,16575,13416,-3159
2019,2,21,3,15670,15649,12606,-3043
2019,2,21,4,14350,14700,11635,-3065
2019,2,21,5,13210,13672,10529,-3143
2019,2,21,6,12620,12988,10032,-2956
2019,2,21,7,12200,12613,9757,-2856
2019,2,21,8,12040,12676,9819,-2857
2019,2,21,9,12000,12409,9629,-2780
2019,2,21,10,12350,12644,9761,-2883
2019,2,21,11,13250,13221,10650,-2571
2019,2,21,12,14820,14521,11827,-2694
2019,2,21,13,15610,15444,12653,-2791
2019,2,21,14,16000,15902,13214,-2688
2019,2,21,15,15860,15902,13086,-2816
2019,2,21,16,15360,15515,12655,-2860
2019,2,21,17,14840,14918,12132,-2786
2019,2,21,18,14400,14302,11858,-2444
2019,2,21,19,14240,14282,11995,-2287
2019,2,21,20,14070,14112,11931,-2181
2019,2,21,21,14200,14270,12156,-2114
2019,2,21,22,14770,14706,12309,-2397
2019,2,21,23,15760,15693,13184,-2509
2019,2,22,0,16170,16200,13748,-2452
2019,2,22,1,15950,15835,13158,-2677
2019,2,22,2,15410,15255,12588,-2667
2019,2,22,3,14470,14630,11627,-3003
2019,2,22,4,13360,13830,11229,-2601
2019,2,22,5,12410,13125,10344,-2781
2019,2,22,6,11610,12786,10114,-2672
2019,2,22,7,11210,12932,10195,-2737
2019,2,22,8,11060,12756,10087,-2669
2019,2,22,9,11100,12702,9997,-2705
2019,2,22,10,11530,12796,10088,-2708
2019,2,22,11,12490,13063,10471,-2592
2019,2,22,12,14010,13856,11129,-2727
2019,2,22,13,14660,14695,11782,-2913
2019,2,22,14,14580,14779,11816,-2963
2019,2,22,15,14120,14449,11412,-3037
2019,2,22,16,13680,13940,11055,-2885
2019,2,22,17,13470,13425,10688,-2737
2019,2,22,18,13230,13046,10725,-2321
2019,2,22,19,13120,13028,10750,-2278
2019,2,22,20,13170,13143,10752,-2391
2019,2,22,21,13550,13652,10966,-2686
2019,2,22,22,14130,14213,11394,-2819
2019,2,22,23,15200,15250,12052,-3198
2019,2,23,0,15680,15682,12430,-3252
2019,2,23,1,15230,15307,11955,-3352
2019,2,23,2,14690,14841,11644,-3197
2019,2,23,3,14020,14168,11200,-2968
2019,2,23,4,13160,13580,10965,-2615
2019,2,23,5,12320,12981,10461,-2520
2019,2,23,6,11710,12613,10111,-2502
2019,2,23,7,11380,12270,9644,-2626
2019,2,23,8,11180,12113,9370,-2743
2019,2,23,9,11170,12088,9316,-2772
2019,2,23,10,11380,12265,9398,-2867
2019,2,23,11,11790,12627,9732,-2895
2019,2,23,12,12370,12725,9989,-2736
2019,2,23,13,12890,13208,10369,-2839
2019,2,23,14,13410,13587,10599,-2988
2019,2,23,15,13120,13212,10473,-2739
2019,2,23,16,12930,12842,9904,-2938
2019,2,23,17,12890,12709,9948,-2761
2019,2,23,18,12790,12592,10056,-2536
2019,2,23,19,12370,12536,9993,-2543
2019,2,23,20,12380,12670,10040,-2630
2019,2,23,21,12800,13040,10152,-2888
2019,2,23,22,13530,13729,10480,-3249
2019,2,23,23,14490,14730,11480,-3250
2019,2,24,0,14870,15156,11933,-3223
2019,2,24,1,14450,14807,11539,-3268
2019,2,24,2,14010,14332,11092,-3240
2019,2,24,3,13460,13693,10452,-3241
2019,2,24,4,12750,12871,9960,-2911
2019,2,24,5,11950,12333,9415,-2918
2019,2,24,6,11450,11579,9077,-2502
2019,2,24,7,11050,11113,8818,-2295
2019,2,24,8,10840,11385,8986,-2399
2019,2,24,9,10760,11315,8834,-2481
2019,2,24,10,10840,11369,8869,-2500
2019,2,24,11,11100,11638,9224,-2414
2019,2,24,12,11520,11889,9718,-2171
2019,2,24,13,12060,12775,10351,-2424
2019,2,24,14,12740,13389,11120,-2269
2019,2,24,15,13900,13838,11583,-2255
2019,2,24,16,14000,14266,11459,-2807
2019,2,24,17,14220,14462,11453,-3009
2019,2,24,18,14310,14400,11373,-3027
2019,2,24,19,14160,14248,11225,-3023
2019,2,24,20,13970,14177,11365,-2812
2019,2,24,21,13920,14231,11472,-2759
2019,2,24,22,14250,14595,11381,-3214
2019,2,24,23,14940,15279,12100,-3179
2019,2,25,0,15130,15510,12371,-3139
2019,2,25,1,14860,15019,11758,-3261
2019,2,25,2,14220,14300,10957,-3343
2019,2,25,3,13310,13668,10215,-3453
2019,2,25,4,12370,12693,9629,-3064
2019,2,25,5,11500,12042,9077,-2965
2019,2,25,6,10900,11962,9065,-2897
2019,2,25,7,10600,11903,8965,-2938
2019,2,25,8,10540,11998,8896,-3102
2019,2,25,9,10670,12164,8954,-3210
2019,2,25,10,11040,12181,9103,-3078
2019,2,25,11,12080,12946,9815,-3131
2019,2,25,12,13740,14257,11097,-3160
2019,2,25,13,14570,14823,11493,-3330
2019,2,25,14,14710,14742,11351,-3391
2019,2,25,15,14610,14617,11371,-3246
2019,2,25,16,14430,14478,11210,-3268
2019,2,25,17,14270,14341,11105,-3236
2019,2,25,18,14180,14267,11091,-3176
2019,2,25,19,14210,14477,11064,-3413
2019,2,25,20,14180,14512,10944,-3568
2019,2,25,21,14600,14683,11177,-3506
2019,2,25,22,15390,15505,11961,-3544
2019,2,25,23,16580,16681,12940,-3741
2019,2,26,0,17220,17304,13721,-3583
2019,2,26,1,16840,16942,13438,-3504
2019,2,26,2,16180,16326,12825,-3501
2019,2,26,3,15230,15410,11845,-3565
2019,2,26,4,14060,14264,10649,-3615
2019,2,26,5,13130,13513,9751,-3762
2019,2,26,6,12380,13233,9502,-3731
2019,2,26,7,12040,13227,9437,-3790
2019,2,26,8,12000,13106,9375,-3731
2019,2,26,9,12080,12897,9286,-3611
2019,2,26,10,12320,13299,9661,-3638
2019,2,26,11,13430,14163,10605,-3558
2019,2,26,12,15080,15442,12156,-3286
2019,2,26,13,15570,15948,12536,-3412
2019,2,26,14,15460,15321,11824,-3497
2019,2,26,15,14620,14765,11235,-3530
2019,2,26,16,14220,14769,11386,-3383
2019,2,26,17,13830,14527,11425,-3102
2019,2,26,18,13750,14344,11278,-3066
2019,2,26,19,13720,14605,11506,-3099
2019,2,26,20,13910,14694,11624,-3070
2019,2,26,21,14430,14924,11734,-3190
2019,2,26,22,15480,15659,12384,-3275
2019,2,26,23,16820,17071,13718,-3353
2019,2,27,0,17640,17854,14658,-3196
2019,2,27,1,17430,17617,14239,-3378
2019,2,27,2,16820,17092,13661,-3431
2019,2,27,3,15950,16204,12840,-3364
2019,2,27,4,14790,15028,11798,-3230
2019,2,27,5,13800,14052,10727,-3325
2019,2,27,6,13340,13721,10367,-3354
2019,2,27,7,13040,13414,9986,-3428
2019,2,27,8,12900,13539,9968,-3571
2019,2,27,9,12940,13633,10137,-3496
2019,2,27,10,13310,13947,10500,-3447
2019,2,27,11,14350,14619,11198,-3421
2019,2,27,12,15950,16238,13116,-3122
2019,2,27,13,16680,16794,13693,-3101
2019,2,27,14,16450,16470,13559,-2911
2019,2,27,15,16220,16227,13862,-2365
2019,2,27,16,16070,15886,13382,-2504
2019,2,27,17,16060,15556,12379,-3177
2019,2,27,18,16050,15435,12500,-2935
2019,2,27,19,16110,15784,12764,-3020
2019,2,27,20,16190,15790,12381,-3409
2019,2,27,21,16360,16240,12884,-3356
2019,2,27,22,16730,16895,13473,-3422
2019,2,27,23,17640,17729,14631,-3098
2019,2,28,0,17860,18081,15261,-2820
2019,2,28,1,17470,17691,14542,-3149
2019,2,28,2,16720,17034,13759,-3275
2019,2,28,3,15730,16045,12584,-3461
2019,2,28,4,14530,14852,11490,-3362
2019,2,28,5,13490,13826,10132,-3694
2019,2,28,6,13200,13448,9860,-3588
2019,2,28,7,12900,13191,9705,-3486
2019,2,28,8,12750,13040,9602,-3438
2019,2,28,9,12790,13071,9712,-3359
2019,2,28,10,13120,13394,10200,-3194
2019,2,28,11,14080,14112,10964,-3148
2019,2,28,12,15550,15521,12406,-3115
2019,2,28,13,16450,16453,13705,-2748
2019,2,28,14,16740,16758,13866,-2892
2019,2,28,15,16500,16498,13306,-3192
2019,2,28,16,16290,16133,12748,-3385
2019,2,28,17,15980,15818,12398,-3420
2019,2,28,18,15690,15674,12612,-3062
2019,2,28,19,15470,15344,12186,-3158
2019,2,28,20,15290,15167,11827,-3340
2019,2,28,21,15740,15404,12275,-3129
2019,2,28,22,16150,15928,12888,-3040
2019,2,28,23,16870,16607,13624,-2983
2019,3,1,0,17410,17333,14616,-2717
2019,3,1,1,17090,17110,14019,-3091
2019,3,1,2,16580,16598,13692,-2906
2019,3,1,3,15790,15759,12537,-3222
2019,3,1,4,14620,14633,11321,-3312
2019,3,1,5,13570,13829,10652,-3177
2019,3,1,6,13030,13304,10581,-2723
2019,3,1,7,12690,12969,10240,-2729
2019,3,1,8,12540,12826,10145,-2681
2019,3,1,9,12550,12908,10300,-2608
2019,3,1,10,12910,13416,10908,-2508
2019,3,1,11,13920,14143,11775,-2368
2019,3,1,12,15480,15471,13267,-2204
2019,3,1,13,16310,16323,14162,-2161
2019,3,1,14,16160,16203,14058,-2145
2019,3,1,15,15580,15521,13212,-2309
2019,3,1,16,14960,15071,12852,-2219
2019,3,1,17,14400,14544,12200,-2344
2019,3,1,18,14200,14566,12169,-2397
2019,3,1,19,14070,14345,11971,-2374
2019,3,1,20,14020,14703,12322,-2381
2019,3,1,21,14210,15178,12724,-2454
2019,3,1,22,14860,15401,12919,-2482
2019,3,1,23,15740,15717,13209,-2508
2019,3,2,0,16090,16147,13635,-2512
2019,3,2,1,15850,15811,13281,-2530
2019,3,2,2,15310,15339,12753,-2586
2019,3,2,3,14600,14662,12018,-2644
2019,3,2,4,13640,13912,11252,-2660
2019,3,2,5,12730,13094,10365,-2729
2019,3,2,6,12130,12424,9635,-2789
2019,3,2,7,11730,12076,9293,-2783
2019,3,2,8,11540,12062,9327,-2735
2019,3,2,9,11470,11995,9370,-2625
2019,3,2,10,11570,12089,9571,-2518
2019,3,2,11,11960,12457,10039,-2418
2019,3,2,12,12650,12759,10466,-2293
2019,3,2,13,13400,13395,11074,-2321
2019,3,2,14,14220,14225,11863,-2362
2019,3,2,15,14640,14739,12466,-2273
2019,3,2,16,14610,14890,12634,-2256
2019,3,2,17,14500,14881,12544,-2337
2019,3,2,18,14360,14723,12212,-2511
2019,3,2,19,14140,14751,12059,-2692
2019,3,2,20,14130,14687,11989,-2698
2019,3,2,21,14470,14697,12078,-2619
2019,3,2,22,15110,14945,12384,-2561
2019,3,2,23,15630,15329,12885,-2444
2019,3,3,0,15700,15656,13216,-2440
2019,3,3,1,15090,15200,12697,-2503
2019,3,3,2,14610,14639,12082,-2557
2019,3,3,3,14010,13980,11274,-2706
2019,3,3,4,13260,13175,10404,-2771
2019,3,3,5,12520,12418,9652,-2766
2019,3,3,6,11730,12032,9244,-2788
2019,3,3,7,11350,11898,9095,-2803
2019,3,3,8,11160,11956,9165,-2791
2019,3,3,9,11090,11915,9170,-2745
2019,3,3,10,11200,12016,9338,-2678
2019,3,3,11,11550,11909,9359,-2550
2019,3,3,12,12040,12295,9733,-2562
2019,3,3,13,12450,12469,10082,-2387
2019,3,3,14,12650,12675,10325,-2350
2019,3,3,15,12590,12639,10195,-2444
2019,3,3,16,12650,12758,10243,-2515
2019,3,3,17,12430,12988,10376,-2612
2019,3,3,18,12570,12774,10100,-2674
2019,3,3,19,12390,12669,9994,-2675
2019,3,3,20,12400,12868,10167,-2701
2019,3,3,21,12760,13277,10655,-2622
2019,3,3,22,13720,13822,11345,-2477
2019,3,3,23,14720,14980,12657,-2323
2019,3,4,0,15400,15481,13174,-2307
2019,3,4,1,15100,15112,12774,-2338
2019,3,4,2,14660,14534,11971,-2563
2019,3,4,3,13850,13762,10991,-2771
2019,3,4,4,12890,12870,10101,-2769
2019,3,4,5,12020,12053,9263,-2790
2019,3,4,6,11490,11740,8921,-2819
2019,3,4,7,11210,11856,9030,-2826
2019,3,4,8,11090,11878,9215,-2663
2019,3,4,9,11160,12278,9569,-2709
2019,3,4,10,11480,12791,10125,-2666
2019,3,4,11,12250,13333,10930,-2403
2019,3,4,12,13290,13972,11682,-2290
2019,3,4,13,14100,14425,12007,-2418
2019,3,4,14,14770,15040,12662,-2378
2019,3,4,15,15150,15406,12996,-2410
2019,3,4,16,15140,15288,12947,-2341
2019,3,4,17,15050,15175,12781,-2394
2019,3,4,18,14810,15044,12651,-2393
2019,3,4,19,14620,15082,12671,-2411
2019,3,4,20,14440,15144,12717,-2427
2019,3,4,21,14400,15197,12815,-2382
2019,3,4,22,14820,15461,13087,-2374
2019,3,4,23,15760,16171,13814,-2357
2019,3,5,0,16600,16826,14627,-2199
2019,3,5,1,16370,16466,14230,-2236
2019,3,5,2,15920,15858,13444,-2414
2019,3,5,3,15060,14932,12510,-2422
2019,3,5,4,13940,14053,11557,-2496
2019,3,5,5,13010,13217,10528,-2689
2019,3,5,6,12410,12725,10169,-2556
2019,3,5,7,12170,12929,10215,-2714
2019,3,5,8,12130,12966,10255,-2711
2019,3,5,9,12250,13073,10437,-2636
2019,3,5,10,12710,13128,10598,-2530
2019,3,5,11,13850,13825,11353,-2472
2019,3,5,12,15480,15470,13197,-2273
2019,3,5,13,15990,16019,13611,-2408
2019,3,5,14,15550,15603,13122,-2481
2019,3,5,15,15160,15174,12562,-2612
2019,3,5,16,14570,14892,12332,-2560
2019,3,5,17,14180,14598,11950,-2648
2019,3,5,18,13800,14313,11663,-2650
2019,3,5,19,13730,14176,11485,-2691
2019,3,5,20,13920,14113,11483,-2630
2019,3,5,21,14290,14412,11859,-2553
2019,3,5,22,15030,15171,12812,-2359
2019,3,5,23,16070,16292,14014,-2278
2019,3,6,0,17000,17150,14898,-2252
2019,3,6,1,16650,16911,14697,-2214
2019,3,6,2,16110,16372,14032,-2340
2019,3,6,3,15150,15453,13049,-2404
2019,3,6,4,14060,14305,11805,-2500
2019,3,6,5,13000,13557,11006,-2551
2019,3,6,6,12650,12948,10496,-2452
2019,3,6,7,12380,12678,10301,-2377
2019,3,6,8,12300,12588,10238,-2350
2019,3,6,9,12400,12682,10366,-2316
2019,3,6,10,12860,13127,10919,-2208
2019,3,6,11,13990,14229,12015,-2214
2019,3,6,12,15590,15793,13672,-2121
2019,3,6,13,16060,16070,13957,-2113
2019,3,6,14,15580,15776,13542,-2234
2019,3,6,15,15190,15451,13311,-2140
2019,3,6,16,14830,15273,13130,-2143
2019,3,6,17,14510,15233,13083,-2150
2019,3,6,18,14460,15191,13015,-2176
2019,3,6,19,14530,15081,12799,-2282
2019,3,6,20,14740,15160,12809,-2351
2019,3,6,21,15040,15486,13234,-2252
2019,3,6,22,15810,16087,13826,-2261
2019,3,6,23,16850,17038,14739,-2299
2019,3,7,0,17600,17752,15463,-2289
2019,3,7,1,17360,17508,15088,-2420
2019,3,7,2,16780,17038,14631,-2407
2019,3,7,3,15890,16145,13625,-2520
2019,3,7,4,14710,14990,12244,-2746
2019,3,7,5,13720,14059,11289,-2770
2019,3,7,6,13460,14000,11332,-2668
2019,3,7,7,13190,13737,11113,-2624
2019,3,7,8,13120,13656,11101,-2555
2019,3,7,9,13240,13773,11329,-2444
2019,3,7,10,13650,14168,11848,-2320
2019,3,7,11,14750,14793,12562,-2231
2019,3,7,12,16360,16335,14102,-2233
2019,3,7,13,16900,16907,14893,-2014
2019,3,7,14,16430,16454,14263,-2191
2019,3,7,15,15970,15810,13493,-2317
2019,3,7,16,15570,15425,13099,-2326
2019,3,7,17,15250,15164,12751,-2413
2019,3,7,18,15110,15064,12578,-2486
2019,3,7,19,15000,15320,12922,-2398
2019,3,7,20,14880,15390,12922,-2468
2019,3,7,21,15050,15672,13305,-2367
2019,3,7,22,15700,16033,13787,-2246
2019,3,7,23,16730,16902,14787,-2115
2019,3,8,0,17400,17562,15507,-2055
2019,3,8,1,17210,17329,15215,-2114
2019,3,8,2,16720,16868,14740,-2128
2019,3,8,3,15830,15993,13785,-2208
2019,3,8,4,14670,14952,12385,-2567
2019,3,8,5,13680,14263,11660,-2603
2019,3,8,6,13110,13785,11207,-2578
2019,3,8,7,12760,13479,11043,-2436
2019,3,8,8,12660,13429,10990,-2439
2019,3,8,9,12740,13526,11098,-2428
2019,3,8,10,13040,13587,11349,-2238
2019,3,8,11,14080,14433,12239,-2194
2019,3,8,12,15620,15965,13798,-2167
2019,3,8,13,16190,16395,14109,-2286
2019,3,8,14,15790,15822,13437,-2385
2019,3,8,15,15150,15190,12922,-2268
2019,3,8,16,14690,14782,12540,-2242
2019,3,8,17,14270,14640,12421,-2219
2019,3,8,18,14010,14422,12286,-2136
2019,3,8,19,13870,14558,12157,-2401
2019,3,8,20,14000,14582,12156,-2426
2019,3,8,21,14130,15057,12661,-2396
2019,3,8,22,14660,14980,12606,-2374
2019,3,8,23,15510,15689,13180,-2509
2019,3,9,0,16070,16361,13935,-2426
2019,3,9,1,15770,16077,13669,-2408
2019,3,9,2,15280,15576,13130,-2446
2019,3,9,3,14760,14897,12319,-2578
2019,3,9,4,13880,14245,11432,-2813
2019,3,9,5,13000,13347,10522,-2825
2019,3,9,6,12400,12740,9820,-2920
2019,3,9,7,12020,12601,9690,-2911
2019,3,9,8,11790,12780,9877,-2903
2019,3,9,9,11710,12809,9901,-2908
2019,3,9,10,11890,12876,10046,-2830
2019,3,9,11,12230,12700,10062,-2638
2019,3,9,12,12710,13250,10631,-2619
2019,3,9,13,13170,13504,10851,-2653
2019,3,9,14,13280,13411,10803,-2608
2019,3,9,15,13130,13152,10480,-2672
2019,3,9,16,12800,13196,10556,-2640
2019,3,9,17,12520,13257,10556,-2701
2019,3,9,18,12190,12998,10255,-2743
2019,3,9,19,11880,12837,10034,-2803
2019,3,9,20,11690,12761,9990,-2771
2019,3,9,21,11880,13060,10336,-2724
2019,3,9,22,12710,13180,10468,-2712
2019,3,9,23,13720,13884,11282,-2602
2019,3,10,0,14540,14770,12227,-2543
2019,3,10,1,14260,14591,12046,-2545
2019,3,10,2,13990,14241,11650,-2591
2019,3,10,3,13540,13709,11099,-2610
2019,3,10,4,13000,13316,10609,-2707
2019,3,10,5,12280,12775,10118,-2657
2019,3,10,6,11680,12224,9638,-2586
2019,3,10,7,11320,11850,9270,-2580
2019,3,10,8,11150,11684,9178,-2506
2019,3,10,9,11160,11768,9455,-2313
2019,3,10,10,11300,12123,9892,-2231
2019,3,10,11,11700,12535,10287,-2248
2019,3,10,12,12250,13018,10766,-2252
2019,3,10,13,12830,13379,11270,-2109
2019,3,10,14,13980,14005,11790,-2215
2019,3,10,15,14460,14643,12312,-2331
2019,3,10,16,14830,15066,12693,-2373
2019,3,10,17,14900,15290,12878,-2412
2019,3,10,18,14970,15249,12865,-2384
2019,3,10,19,14980,15074,12402,-2672
2019,3,10,20,15000,14945,12304,-2641
2019,3,10,21,15100,15033,12547,-2486
2019,3,10,22,15250,15303,12712,-2591
2019,3,10,23,15270,15556,12981,-2575
2019,3,11,0,15380,15651,13092,-2559
2019,3,11,1,14330,15098,12529,-2569
2019,3,11,2,13470,14205,11352,-2853
2019,3,11,3,12440,13260,10357,-2903
2019,3,11,4,11590,12225,9290,-2935
2019,3,11,5,11380,11925,8974,-2951
2019,3,11,6,11020,11852,8927,-2925
2019,3,11,7,10870,11936,9014,-2922
2019,3,11,8,10880,11923,9017,-2906
2019,3,11,9,11240,12008,9103,-2905
2019,3,11,10,12030,12528,9822,-2706
2019,3,11,11,13650,13874,11303,-2571
2019,3,11,12,14440,14824,12237,-2587
2019,3,11,13,14140,14631,12057,-2574
2019,3,11,14,14100,14112,11623,-2489
2019,3,11,15,13470,13696,11486,-2210
2019,3,11,16,13180,13344,11224,-2120
2019,3,11,17,13040,12960,10797,-2163
2019,3,11,18,12870,12934,10734,-2200
2019,3,11,19,12740,13077,10810,-2267
2019,3,11,20,12810,13325,11005,-2320
2019,3,11,21,13160,13627,11371,-2256
2019,3,11,22,14020,13978,11605,-2373
2019,3,11,23,14770,14793,12231,-2562
2019,3,12,0,15200,15389,12959,-2430
2019,3,12,1,14770,15034,12446,-2588
2019,3,12,2,13930,14188,11660,-2528
2019,3,12,3,12820,13081,10349,-2732
2019,3,12,4,11840,12108,9704,-2404
2019,3,12,5,11170,12004,9179,-2825
2019,3,12,6,10890,11910,9051,-2859
2019,3,12,7,10850,11782,9028,-2754
2019,3,12,8,11020,11822,9172,-2650
2019,3,12,9,11440,12097,9458,-2639
2019,3,12,10,12480,12387,9916,-2471
2019,3,12,11,14070,14087,11846,-2241
2019,3,12,12,14920,15052,12860,-2192
2019,3,12,13,14540,14879,12657,-2222
2019,3,12,14,14230,14335,12159,-2176
2019,3,12,15,13710,14002,11793,-2209
2019,3,12,16,13360,13588,11324,-2264
2019,3,12,17,13050,13148,10925,-2223
2019,3,12,18,12910,12742,10487,-2255
2019,3,12,19,13070,12651,10316,-2335
2019,3,12,20,13260,12626,10332,-2294
2019,3,12,21,13770,13146,10893,-2253
2019,3,12,22,14650,13966,11512,-2454
2019,3,12,23,15450,14947,12415,-2532
2019,3,13,0,15880,15673,13165,-2508
2019,3,13,1,15520,15367,12917,-2450
2019,3,13,2,14690,14542,12012,-2530
2019,3,13,3,13570,13400,10720,-2680
2019,3,13,4,12520,12373,9771,-2602
2019,3,13,5,11470,11972,9205,-2767
2019,3,13,6,11160,11907,9172,-2735
2019,3,13,7,11090,11896,9166,-2730
2019,3,13,8,11170,11938,9182,-2756
2019,3,13,9,11520,12181,9626,-2555
2019,3,13,10,12560,12831,10348,-2483
2019,3,13,11,14260,14629,12112,-2517
2019,3,13,12,14990,15522,13010,-2512
2019,3,13,13,14590,14938,12349,-2589
2019,3,13,14,13870,13913,11403,-2510
2019,3,13,15,13360,13216,10666,-2550
2019,3,13,16,13010,12764,10274,-2490
2019,3,13,17,12850,12688,10177,-2511
2019,3,13,18,13030,12943,10283,-2660
2019,3,13,19,13050,13212,10622,-2590
2019,3,13,20,13280,13425,10847,-2578
2019,3,13,21,13730,14002,11308,-2694
2019,3,13,22,14360,14740,11936,-2804
2019,3,13,23,15170,15289,12502,-2787
2019,3,14,0,15670,15592,12784,-2808
2019,3,14,1,15040,15141,12282,-2859
2019,3,14,2,14140,14251,11520,-2731
2019,3,14,3,12990,13076,10280,-2796
2019,3,14,4,11950,12016,9378,-2638
2019,3,14,5,11290,11569,8731,-2838
2019,3,14,6,10910,11357,8581,-2776
2019,3,14,7,10720,11302,8519,-2783
2019,3,14,8,10730,11294,8592,-2702
2019,3,14,9,11050,11468,8875,-2593
2019,3,14,10,12020,12042,9645,-2397
2019,3,14,11,13780,13771,11358,-2413
2019,3,14,12,14690,14704,12251,-2453
2019,3,14,13,14670,14704,12282,-2422
2019,3,14,14,14270,14194,11795,-2399
2019,3,14,15,13720,13807,11292,-2515
2019,3,14,16,13410,13385,10771,-2614
2019,3,14,17,13140,13014,10447,-2567
2019,3,14,18,12940,12723,10283,-2440
2019,3,14,19,12830,12513,10303,-2210
2019,3,14,20,12960,12662,10257,-2405
2019,3,14,21,13310,13161,10633,-2528
2019,3,14,22,13900,13878,11280,-2598
2019,3,14,23,14560,14509,12029,-2480
2019,3,15,0,14880,14932,12501,-2431
2019,3,15,1,14460,14582,12199,-2383
2019,3,15,2,13630,13773,11386,-2387
2019,3,15,3,12470,12640,9996,-2644
2019,3,15,4,11430,11556,9532,-2024
2019,3,15,5,10820,11031,9109,-1922
2019,3,15,6,10430,11489,9193,-2296
2019,3,15,7,10220,11338,9120,-2218
2019,3,15,8,10190,11296,9012,-2284
2019,3,15,9,10440,11528,9237,-2291
2019,3,15,10,11330,12264,9599,-2665
2019,3,15,11,12920,13230,10532,-2698
2019,3,15,12,13860,13873,11346,-2527
2019,3,15,13,13900,13922,11688,-2234
2019,3,15,14,13970,13961,11840,-2121
2019,3,15,15,13900,13939,11322,-2617
2019,3,15,16,13730,13790,11067,-2723
2019,3,15,17,13580,13433,10796,-2637
2019,3,15,18,13430,13357,10899,-2458
2019,3,15,19,13180,12554,10464,-2090
2019,3,15,20,13100,12457,10590,-1867
2019,3,15,21,13140,13012,11043,-1969
2019,3,15,22,13340,13448,11333,-2115
2019,3,15,23,13710,13562,11511,-2051
2019,3,16,0,13900,13908,11736,-2172
2019,3,16,1,13390,13515,10847,-2668
2019,3,16,2,12700,12802,10476,-2326
2019,3,16,3,11810,11905,9493,-2412
2019,3,16,4,10850,11193,8622,-2571
2019,3,16,5,10270,10556,8066,-2490
2019,3,16,6,9860,10414,7952,-2462
2019,3,16,7,9610,10662,8124,-2538
2019,3,16,8,9540,10788,8263,-2525
2019,3,16,9,9650,10690,8307,-2383
2019,3,16,10,10040,10804,8285,-2519
2019,3,16,11,10750,11026,8544,-2482
2019,3,16,12,11400,11410,9179,-2231
2019,3,16,13,11720,11737,9671,-2066
2019,3,16,14,11650,11678,9676,-2002
2019,3,16,15,11520,11513,9850,-1663
2019,3,16,16,11240,11420,10006,-1414
2019,3,16,17,10980,11349,9999,-1350
2019,3,16,18,10950,11205,9757,-1448
2019,3,16,19,10940,11060,9667,-1393
2019,3,16,20,11090,11098,9814,-1284
2019,3,16,21,11380,11361,9925,-1436
2019,3,16,22,12300,12243,10501,-1742
2019,3,16,23,12920,13028,11106,-1922
2019,3,17,0,13600,13669,11831,-1838
2019,3,17,1,13360,13539,11772,-1767
2019,3,17,2,12860,13054,10951,-2103
2019,3,17,3,12160,12361,10205,-2156
2019,3,17,4,11400,11733,9451,-2282
2019,3,17,5,11000,11280,9309,-1971
2019,3,17,6,10660,10989,8815,-2174
2019,3,17,7,10480,11036,8805,-2231
2019,3,17,8,10420,10960,8725,-2235
2019,3,17,9,10530,10878,8867,-2011
2019,3,17,10,10860,11139,9233,-1906
2019,3,17,11,11410,11552,9841,-1711
2019,3,17,12,11930,11942,10443,-1499
2019,3,17,13,12180,12196,10579,-1617
2019,3,17,14,12190,12187,10588,-1599
2019,3,17,15,11910,12085,10510,-1575
2019,3,17,16,11600,11889,10279,-1610
2019,3,17,17,11440,11601,10121,-1480
2019,3,17,18,11290,11397,10068,-1329
2019,3,17,19,11050,11258,9879,-1379
2019,3,17,20,11080,11080,9640,-1440
2019,3,17,21,11700,11675,9857,-1818
2019,3,17,22,12810,12714,10539,-2175
2019,3,17,23,13610,13708,11787,-1921
2019,3,18,0,14500,14531,12753,-1778
2019,3,18,1,14290,14366,12565,-1801
2019,3,18,2,13540,13645,11596,-2049
2019,3,18,3,12600,12670,10480,-2190
2019,3,18,4,11740,12070,10076,-1994
2019,3,18,5,11130,11788,9845,-1943
2019,3,18,6,10850,11788,10039,-1749
2019,3,18,7,10740,11487,9916,-1571
2019,3,18,8,10850,11598,10102,-1496
2019,3,18,9,11400,12026,10442,-1584
2019,3,18,10,12460,12615,10934,-1681
2019,3,18,11,14260,14385,12357,-2028
2019,3,18,12,15090,15300,13211,-2089
2019,3,18,13,14690,14726,12483,-2243
2019,3,18,14,14120,13741,11540,-2201
2019,3,18,15,13570,13129,11151,-1978
2019,3,18,16,12950,12788,11078,-1710
2019,3,18,17,12620,12484,10904,-1580
2019,3,18,18,12600,12665,10951,-1714
2019,3,18,19,12020,12774,11024,-1750
2019,3,18,20,11990,12948,11108,-1840
2019,3,18,21,12620,13293,11377,-1916
2019,3,18,22,13690,13895,11749,-2146
2019,3,18,23,14830,14817,12636,-2181
2019,3,19,0,15500,15516,13371,-2145
2019,3,19,1,15180,15201,12992,-2209
2019,3,19,2,14360,14314,11935,-2379
2019,3,19,3,13170,13155,10719,-2436
2019,3,19,4,12170,12135,10082,-2053
2019,3,19,5,11530,11656,9461,-2195
2019,3,19,6,11250,11731,9530,-2201
2019,3,19,7,11150,11885,9633,-2252
2019,3,19,8,11220,12037,9804,-2233
2019,3,19,9,11600,12194,10169,-2025
2019,3,19,10,12570,12727,10764,-1963
2019,3,19,11,14290,14520,12850,-1670
2019,3,19,12,15180,15317,13687,-1630
2019,3,19,13,14530,14641,12617,-2024
2019,3,19,14,13690,13629,11888,-1741
2019,3,19,15,12860,12968,11531,-1437
2019,3,19,16,12560,12692,11099,-1593
2019,3,19,17,12300,12550,10954,-1596
2019,3,19,18,12380,12756,11224,-1532
2019,3,19,19,12410,13042,11146,-1896
2019,3,19,20,12610,13106,11249,-1857
2019,3,19,21,13160,13487,11562,-1925
2019,3,19,22,14000,13904,11769,-2135
2019,3,19,23,14670,14697,12327,-2370
2019,3,20,0,15430,15325,13079,-2246
2019,3,20,1,15040,15061,12848,-2213
2019,3,20,2,14190,14238,12059,-2179
2019,3,20,3,13020,13101,11060,-2041
2019,3,20,4,12010,12147,10271,-1876
2019,3,20,5,11470,11999,9550,-2449
2019,3,20,6,11190,12098,9634,-2464
2019,3,20,7,11100,12209,9893,-2316
2019,3,20,8,11170,12251,9970,-2281
2019,3,20,9,11550,12345,10222,-2123
2019,3,20,10,12590,12716,10809,-1907
2019,3,20,11,14530,14499,12480,-2019
2019,3,20,12,15050,15300,13144,-2156
2019,3,20,13,14200,14623,12279,-2344
2019,3,20,14,13440,13549,11165,-2384
2019,3,20,15,12850,12728,10807,-1921
2019,3,20,16,12430,12221,10556,-1665
2019,3,20,17,12200,12138,10468,-1670
2019,3,20,18,11690,12146,10683,-1463
2019,3,20,19,11650,12044,10272,-1772
2019,3,20,20,11590,12251,10389,-1862
2019,3,20,21,12470,12772,10669,-2103
2019,3,20,22,13350,13284,10995,-2289
2019,3,20,23,14140,14161,11880,-2281
2019,3,21,0,14780,14868,12449,-2419
2019,3,21,1,14630,14599,12015,-2584
2019,3,21,2,13790,13772,11334,-2438
2019,3,21,3,12600,12627,10112,-2515
2019,3,21,4,11550,11654,9174,-2480
2019,3,21,5,11040,11569,8974,-2595
2019,3,21,6,10670,11709,9133,-2576
2019,3,21,7,10570,11618,9060,-2558
2019,3,21,8,10590,11639,9075,-2564
2019,3,21,9,10970,11984,9588,-2396
2019,3,21,10,11930,12433,10179,-2254
2019,3,21,11,13580,13612,11540,-2072
2019,3,21,12,14440,14466,12498,-1968
2019,3,21,13,14270,14236,12299,-1937
2019,3,21,14,14000,13860,11998,-1862
2019,3,21,15,13850,13751,12060,-1691
2019,3,21,16,13510,13495,11692,-1803
2019,3,21,17,13420,13391,11718,-1673
2019,3,21,18,13370,13216,11674,-1542
2019,3,21,19,13340,13309,11722,-1587
2019,3,21,20,13430,13561,11721,-1840
2019,3,21,21,13740,13858,12030,-1828
2019,3,21,22,14130,14372,12530,-1842
2019,3,21,23,14490,14739,12930,-1809
2019,3,22,0,14960,15014,12983,-2031
2019,3,22,1,14560,14611,12574,-2037
2019,3,22,2,13660,13746,11597,-2149
2019,3,22,3,12550,12587,10401,-2186
2019,3,22,4,11500,11499,9262,-2237
2019,3,22,5,10810,11070,8747,-2323
2019,3,22,6,10450,10742,8531,-2211
2019,3,22,7,10290,10577,8374,-2203
2019,3,22,8,10260,10543,8403,-2140
2019,3,22,9,10600,10863,8615,-2248
2019,3,22,10,11570,11565,9178,-2387
2019,3,22,11,13250,13207,11002,-2205
2019,3,22,12,14330,14335,12265,-2070
2019,3,22,13,14690,14700,12532,-2168
2019,3,22,14,14810,14862,12906,-1956
2019,3,22,15,14950,14930,12812,-2118
2019,3,22,16,14800,14890,13028,-1862
2019,3,22,17,14530,14695,12763,-1932
2019,3,22,18,14550,14497,12627,-1870
2019,3,22,19,14170,14179,12304,-1875
2019,3,22,20,14120,13966,12087,-1879
2019,3,22,21,14370,14117,12020,-2097
2019,3,22,22,14500,14436,12231,-2205
2019,3,22,23,14500,14598,12388,-2210
2019,3,23,0,14640,14813,12634,-2179
2019,3,23,1,14410,14429,12367,-2062
2019,3,23,2,13710,13721,11377,-2344
2019,3,23,3,12780,12930,10562,-2368
2019,3,23,4,11830,12078,10102,-1976
2019,3,23,5,10990,11669,9617,-2052
2019,3,23,6,10550,11351,9240,-2111
2019,3,23,7,10350,11204,9172,-2032
2019,3,23,8,10290,11275,9286,-1989
2019,3,23,9,10400,11520,9516,-2004
2019,3,23,10,10840,11730,9631,-2099
2019,3,23,11,11610,12058,10165,-1893
2019,3,23,12,12480,12707,10737,-1970
2019,3,23,13,13210,13397,11226,-2171
2019,3,23,14,13390,13318,11233,-2085
2019,3,23,15,13050,12702,10780,-1922
2019,3,23,16,12650,12282,10429,-1853
2019,3,23,17,12200,12150,10271,-1879
2019,3,23,18,11730,11685,10243,-1442
2019,3,23,19,11400,11436,9805,-1631
2019,3,23,20,11390,11552,9934,-1618
2019,3,23,21,11770,11747,9862,-1885
2019,3,23,22,12490,12357,10456,-1901
2019,3,23,23,13100,13203,11346,-1857
2019,3,24,0,13850,13876,11899,-1977
2019,3,24,1,13780,13799,11929,-1870
2019,3,24,2,13250,13322,11544,-1778
2019,3,24,3,12480,12613,10943,-1670
2019,3,24,4,11650,11823,10122,-1701
2019,3,24,5,11070,11516,9523,-1993
2019,3,24,6,10700,11822,9714,-2108
2019,3,24,7,10480,11811,9722,-2089
2019,3,24,8,10470,11743,9630,-2113
2019,3,24,9,10630,11815,9738,-2077
2019,3,24,10,10900,11936,9799,-2137
2019,3,24,11,11310,11861,9727,-2134
2019,3,24,12,11630,11927,9887,-2040
2019,3,24,13,11590,11848,9699,-2149
2019,3,24,14,11470,11530,9634,-1896
2019,3,24,15,11200,11257,9489,-1768
2019,3,24,16,10790,10812,9117,-1695
2019,3,24,17,10690,10712,8926,-1786
2019,3,24,18,10580,10423,8818,-1605
2019,3,24,19,10590,10298,8866,-1432
2019,3,24,20,10860,11317,9769,-1548
2019,3,24,21,11660,12040,10182,-1858
2019,3,24,22,12410,12603,10601,-2002
2019,3,24,23,13100,13164,10839,-2325
2019,3,25,0,13600,13747,11360,-2387
2019,3,25,1,13470,13497,11088,-2409
2019,3,25,2,12610,12681,10368,-2313
2019,3,25,3,11710,11642,9733,-1909
2019,3,25,4,10880,10900,8926,-1974
2019,3,25,5,10070,10133,8731,-1402
2019,3,25,6,9780,9802,8382,-1420
2019,3,25,7,9660,9690,8450,-1240
2019,3,25,8,9720,9742,8542,-1200
2019,3,25,9,10110,10355,9073,-1282
2019,3,25,10,11190,11204,9459,-1745
2019,3,25,11,12960,12933,11238,-1695
2019,3,25,12,13910,13899,11900,-1999
2019,3,25,13,13870,13897,12038,-1859
2019,3,25,14,13670,13428,11876,-1552
2019,3,25,15,12990,12864,11481,-1383
2019,3,25,16,12460,12442,11045,-1397
2019,3,25,17,12040,12238,10924,-1314
2019,3,25,18,11930,11999,10617,-1382
2019,3,25,19,11800,11763,10413,-1350
2019,3,25,20,11760,12036,10675,-1361
2019,3,25,21,12040,12609,11045,-1564
2019,3,25,22,13010,13393,11587,-1806
2019,3,25,23,14190,14197,12281,-1916
2019,3,26,0,14960,14786,12576,-2210
2019,3,26,1,14720,14530,12498,-2032
2019,3,26,2,13890,13655,11514,-2141
2019,3,26,3,12750,12525,10716,-1809
2019,3,26,4,11780,11771,9816,-1955
2019,3,26,5,10900,11210,9175,-2035
2019,3,26,6,10650,10955,9255,-1700
2019,3,26,7,10580,10872,9147,-1725
2019,3,26,8,10690,10985,9378,-1607
2019,3,26,9,11130,11413,9921,-1492
2019,3,26,10,12220,12409,10806,-1603
2019,3,26,11,14010,13993,12577,-1416
2019,3,26,12,14670,14680,13327,-1353
2019,3,26,13,13970,14007,12484,-1523
2019,3,26,14,13050,13086,11699,-1387
2019,3,26,15,12470,12489,11123,-1366
2019,3,26,16,12080,12103,10747,-1356
2019,3,26,17,11750,11776,10558,-1218
2019,3,26,18,11580,11592,10391,-1201
2019,3,26,19,11400,11408,10069,-1339
2019,3,26,20,11500,11576,10322,-1254
2019,3,26,21,12420,12416,10976,-1440
2019,3,26,22,13260,13260,11560,-1700
2019,3,26,23,14230,14234,12615,-1619
2019,3,27,0,15130,14994,13483,-1511
2019,3,27,1,14980,14847,13424,-1423
2019,3,27,2,14210,14029,12435,-1594
2019,3,27,3,13080,12897,11400,-1497
2019,3,27,4,12070,11922,10170,-1752
2019,3,27,5,11270,11579,10163,-1416
2019,3,27,6,11010,11324,9994,-1330
2019,3,27,7,10920,11223,9879,-1344
2019,3,27,8,10980,11278,9908,-1370
2019,3,27,9,11440,11637,10379,-1258
2019,3,27,10,12590,12490,11039,-1451
2019,3,27,11,14400,14232,13241,-991
2019,3,27,12,15130,14934,13957,-977
2019,3,27,13,14200,14168,13356,-812
2019,3,27,14,13150,13210,12245,-965
2019,3,27,15,12500,12534,11500,-1034
2019,3,27,16,12100,12083,11085,-998
2019,3,27,17,11750,11896,10823,-1073
2019,3,27,18,11630,11898,10715,-1183
2019,3,27,19,11500,11968,10562,-1406
2019,3,27,20,11600,11944,10523,-1421
2019,3,27,21,12250,12536,11028,-1508
2019,3,27,22,13360,13250,11487,-1763
2019,3,27,23,14100,14091,12267,-1824
2019,3,28,0,14890,14861,13211,-1650
2019,3,28,1,14780,14830,13024,-1806
2019,3,28,2,13990,14400,12409,-1991
2019,3,28,3,12860,12798,10913,-1885
2019,3,28,4,11820,11767,9788,-1979
2019,3,28,5,11040,11767,9533,-2234
2019,3,28,6,10740,11948,9862,-2086
2019,3,28,7,10650,11855,9759,-2096
2019,3,28,8,10700,11881,9782,-2099
2019,3,28,9,11040,12247,10248,-1999
2019,3,28,10,12050,12672,10473,-2199
2019,3,28,11,13740,13930,11952,-1978
2019,3,28,12,14420,14555,12459,-2096
2019,3,28,13,13790,13884,11880,-2004
2019,3,28,14,13160,12989,11401,-1588
2019,3,28,15,12620,12342,10749,-1593
2019,3,28,16,12270,11963,10321,-1642
2019,3,28,17,11540,11870,10551,-1319
2019,3,28,18,11420,11738,10386,-1352
2019,3,28,19,11340,11631,10275,-1356
2019,3,28,20,11930,11895,10506,-1389
2019,3,28,21,12530,12538,10871,-1667
2019,3,28,22,13260,13236,11576,-1660
2019,3,28,23,14000,13967,12093,-1874
2019,3,29,0,14500,14597,12531,-2066
2019,3,29,1,14180,14308,12250,-2058
2019,3,29,2,13380,13427,11386,-2041
2019,3,29,3,12280,12273,10305,-1968
2019,3,29,4,11230,11194,9428,-1766
2019,3,29,5,10650,10500,8631,-1869
2019,3,29,6,10250,10391,8339,-2052
2019,3,29,7,10060,10212,8220,-1992
2019,3,29,8,9950,10186,8230,-1956
2019,3,29,9,10230,10466,8547,-1919
2019,3,29,10,11200,11143,8979,-2164
2019,3,29,11,12850,12763,10398,-2365
2019,3,29,12,13720,13668,11535,-2133
2019,3,29,13,13870,13832,11873,-1959
2019,3,29,14,13750,13859,11885,-1974
2019,3,29,15,13660,13883,11884,-1999
2019,3,29,16,13550,13761,11894,-1867
2019,3,29,17,13400,13422,11592,-1830
2019,3,29,18,13270,13409,11628,-1781
2019,3,29,19,13120,13278,11149,-2129
2019,3,29,20,13120,13149,10973,-2176
2019,3,29,21,13240,13168,10845,-2323
2019,3,29,22,13450,13415,11096,-2319
2019,3,29,23,13580,13552,11355,-2197
2019,3,30,0,13850,13824,11560,-2264
2019,3,30,1,13500,13504,11248,-2256
2019,3,30,2,12810,12825,10823,-2002
2019,3,30,3,11900,11895,10127,-1768
2019,3,30,4,10940,10971,9089,-1882
2019,3,30,5,10250,10550,8513,-2037
2019,3,30,6,9860,10447,8555,-1892
2019,3,30,7,9630,10238,8525,-1713
2019,3,30,8,9550,10152,8358,-1794
2019,3,30,9,9680,10226,8427,-1799
2019,3,30,10,10080,10591,8577,-2014
2019,3,30,11,10710,10995,8829,-2166
2019,3,30,12,11400,11711,9550,-2161
2019,3,30,13,11900,12033,9855,-2178
2019,3,30,14,12120,12087,10084,-2003
2019,3,30,15,11900,11706,9732,-1974
2019,3,30,16,11530,11128,9266,-1862
2019,3,30,17,11220,10807,9359,-1448
2019,3,30,18,10960,10776,8981,-1795
2019,3,30,19,10880,10561,8867,-1694
2019,3,30,20,11020,10721,9138,-1583
2019,3,30,21,11430,11160,9370,-1790
2019,3,30,22,12020,11570,9747,-1823
2019,3,30,23,12460,12116,10182,-1934
2019,3,31,0,12830,12582,10446,-2136
2019,3,31,1,12630,12426,10581,-1845
2019,3,31,2,12050,11867,9973,-1894
2019,3,31,3,11320,11102,9385,-1717
2019,3,31,4,10480,10541,8835,-1706
2019,3,31,5,9760,9984,7993,-1991
2019,3,31,6,9330,9741,7865,-1876
2019,3,31,7,9110,9630,7748,-1882
2019,3,31,8,8970,9685,7853,-1832
2019,3,31,9,9050,9716,7667,-2049
2019,3,31,10,9270,9673,7943,-1730
2019,3,31,11,9700,10093,8193,-1900
2019,3,31,12,10180,10532,8883,-1649
2019,3,31,13,10780,10935,8931,-2004
2019,3,31,14,11050,10766,8665,-2101
2019,3,31,15,11350,11092,9078,-2014
2019,3,31,16,11770,11862,9987,-1875
2019,3,31,17,12160,12337,10486,-1851
2019,3,31,18,12090,12379,10443,-1936
2019,3,31,19,12130,12327,10293,-2034
2019,3,31,20,12200,12687,10620,-2067
2019,3,31,21,12310,12908,10602,-2306
2019,3,31,22,13280,13248,10813,-2435
2019,3,31,23,13400,13358,10768,-2590
2019,4,1,0,13560,13582,10998,-2584
2019,4,1,1,13110,13308,11099,-2209
2019,4,1,2,12310,12513,10521,-1992
2019,4,1,3,11410,11720,9894,-1826
2019,4,1,4,10590,11164,9274,-1890
2019,4,1,5,10220,10545,9055,-1490
2019,4,1,6,9940,10584,9131,-1453
2019,4,1,7,9860,10636,9342,-1294
2019,4,1,8,9990,10616,9274,-1342
2019,4,1,9,10380,10683,9395,-1288
2019,4,1,10,11450,11872,10203,-1669
2019,4,1,11,13110,13215,11532,-1683
2019,4,1,12,13860,13948,12568,-1380
2019,4,1,13,13560,13427,12042,-1385
2019,4,1,14,12720,12727,11168,-1559
2019,4,1,15,12230,12234,10642,-1592
2019,4,1,16,11960,11926,10319,-1607
2019,4,1,17,11680,11650,10241,-1409
2019,4,1,18,11610,11573,10158,-1415
2019,4,1,19,11560,11565,10131,-1434
2019,4,1,20,11850,11638,10132,-1506
2019,4,1,21,12480,12252,10629,-1623
2019,4,1,22,13330,13108,11211,-1897
2019,4,1,23,13990,13991,12191,-1800
2019,4,2,0,14860,14688,13058,-1630
2019,4,2,1,14790,14588,13014,-1574
2019,4,2,2,13860,13838,12029,-1809
2019,4,2,3,12730,12700,10624,-2076
2019,4,2,4,11650,11695,9854,-1841
2019,4,2,5,11020,11081,9240,-1841
2019,4,2,6,10730,11066,9134,-1932
2019,4,2,7,10640,10932,9038,-1894
2019,4,2,8,10720,11025,9175,-1850
2019,4,2,9,11120,11415,9331,-2084
2019,4,2,10,12160,12264,10033,-2231
2019,4,2,11,13850,13962,11654,-2308
2019,4,2,12,14390,14435,11918,-2517
2019,4,2,13,13880,13693,11309,-2384
2019,4,2,14,12810,12851,10760,-2091
2019,4,2,15,12170,12236,10176,-2060
2019,4,2,16,11800,11905,9983,-1922
2019,4,2,17,11500,11624,9778,-1846
2019,4,2,18,11380,11594,9875,-1719
2019,4,2,19,11410,11649,9943,-1706
2019,4,2,20,11920,11917,10248,-1669
2019,4,2,21,12640,12446,10635,-1811
2019,4,2,22,13470,13465,11571,-1894
2019,4,2,23,14040,14134,11813,-2321
2019,4,3,0,14570,14603,12079,-2524
2019,4,3,1,14320,14312,12073,-2239
2019,4,3,2,13470,13453,11139,-2314
2019,4,3,3,12310,12228,10180,-2048
2019,4,3,4,11290,11166,9343,-1823
2019,4,3,5,10760,10783,9148,-1635
2019,4,3,6,10360,10751,8968,-1783
2019,4,3,7,10250,10598,8813,-1785
2019,4,3,8,10230,10600,8846,-1754
2019,4,3,9,10620,10969,8923,-2046
2019,4,3,10,11640,11601,9549,-2052
2019,4,3,11,13260,13117,11051,-2066
2019,4,3,12,14050,14066,12052,-2014
2019,4,3,13,13840,14032,11836,-2196
2019,4,3,14,13440,13426,11269,-2157
2019,4,3,15,12600,12513,10273,-2240
2019,4,3,16,11800,11728,9850,-1878
2019,4,3,17,11260,11511,9742,-1769
2019,4,3,18,11080,11692,9929,-1763
2019,4,3,19,10930,11761,10263,-1498
2019,4,3,20,11220,11647,10238,-1409
2019,4,3,21,11800,11858,10370,-1488
2019,4,3,22,12480,12702,11161,-1541
2019,4,3,23,13190,13351,11719,-1632
2019,4,4,0,14080,13944,12023,-1921
2019,4,4,1,14040,13885,11978,-1907
2019,4,4,2,13300,13087,11299,-1788
2019,4,4,3,12170,12143,10166,-1977
2019,4,4,4,11150,11229,9247,-1982
2019,4,4,5,10370,10870,9309,-1561
2019,4,4,6,10060,10874,9379,-1495
2019,4,4,7,9950,10758,9378,-1380
2019,4,4,8,9990,10795,9398,-1397
2019,4,4,9,10400,11143,9593,-1550
2019,4,4,10,11590,11698,9989,-1709
2019,4,4,11,13340,13079,11031,-2048
2019,4,4,12,13820,13715,11421,-2294
2019,4,4,13,13130,13106,10963,-2143
2019,4,4,14,12350,12324,10975,-1349
2019,4,4,15,11810,11878,10426,-1452
2019,4,4,16,11370,11765,10542,-1223
2019,4,4,17,11020,11544,10369,-1175
2019,4,4,18,10910,11680,10401,-1279
2019,4,4,19,10840,11537,10232,-1305
2019,4,4,20,11060,11362,10042,-1320
2019,4,4,21,11880,12045,10636,-1409
2019,4,4,22,12800,12766,11212,-1554
2019,4,4,23,13700,13607,11620,-1987
2019,4,5,0,14360,14326,12197,-2129
2019,4,5,1,14270,14298,12207,-2091
2019,4,5,2,13500,13544,11312,-2232
2019,4,5,3,12320,12461,9837,-2624
2019,4,5,4,11270,11658,9335,-2323
2019,4,5,5,10820,11091,8996,-2095
2019,4,5,6,10540,10814,8610,-2204
2019,4,5,7,10400,10672,8843,-1829
2019,4,5,8,10440,10691,8903,-1788
2019,4,5,9,10880,11136,9312,-1824
2019,4,5,10,11850,11831,10214,-1617
2019,4,5,11,13420,13397,12063,-1334
2019,4,5,12,14040,14044,12596,-1448
2019,4,5,13,13600,13626,12575,-1051
2019,4,5,14,13040,13096,11569,-1527
2019,4,5,15,12910,12875,11272,-1603
2019,4,5,16,12730,12679,11138,-1541
2019,4,5,17,12600,12418,10983,-1435
2019,4,5,18,12520,12449,11052,-1397
2019,4,5,19,12560,12614,11156,-1458
2019,4,5,20,12650,13098,11529,-1569
2019,4,5,21,13090,13453,11595,-1858
2019,4,5,22,13510,13883,11930,-1953
2019,4,5,23,13830,14092,12075,-2017
2019,4,6,0,14230,14304,12441,-1863
2019,4,6,1,14060,14038,12591,-1447
2019,4,6,2,13370,13397,11751,-1646
2019,4,6,3,12440,12440,10419,-2021
2019,4,6,4,11470,11473,9608,-1865
2019,4,6,5,10780,10804,8657,-2147
2019,4,6,6,10370,10494,8408,-2086
2019,4,6,7,10150,10444,8336,-2108
2019,4,6,8,10080,10350,8301,-2049
2019,4,6,9,10140,10419,8394,-2025
2019,4,6,10,10480,10772,8683,-2089
2019,4,6,11,11160,11174,9215,-1959
2019,4,6,12,11890,11891,9861,-2030
2019,4,6,13,12380,12392,10089,-2303
2019,4,6,14,12150,12146,9917,-2229
2019,4,6,15,11060,11387,9385,-2002
2019,4,6,16,10510,10869,8955,-1914
2019,4,6,17,9910,10809,9194,-1615
2019,4,6,18,9730,10726,9189,-1537
2019,4,6,19,9700,10456,9012,-1444
2019,4,6,20,10020,10551,9027,-1524
2019,4,6,21,10540,10992,9416,-1576
2019,4,6,22,11350,11257,9606,-1651
2019,4,6,23,12000,11868,10104,-1764
2019,4,7,0,12500,12353,10590,-1763
2019,4,7,1,12490,12381,10549,-1832
2019,4,7,2,11970,11859,9979,-1880
2019,4,7,3,11260,11111,9083,-2028
2019,4,7,4,10430,10348,8377,-1971
2019,4,7,5,9700,10097,8025,-2072
2019,4,7,6,9360,9892,7967,-1925
2019,4,7,7,9200,9829,7853,-1976
2019,4,7,8,9150,9966,7996,-1970
2019,4,7,9,9260,10043,8172,-1871
2019,4,7,10,9550,10077,8236,-1841
2019,4,7,11,9990,10301,8436,-1865
2019,4,7,12,10360,10623,8580,-2043
2019,4,7,13,10540,10594,8581,-2013
2019,4,7,14,10280,10566,8804,-1762
2019,4,7,15,9970,10466,8955,-1511
2019,4,7,16,9710,10284,8647,-1637
2019,4,7,17,9490,10137,8373,-1764
2019,4,7,18,9580,10505,8959,-1546
2019,4,7,19,9660,10608,9079,-1529
2019,4,7,20,10030,10591,8976,-1615
2019,4,7,21,10690,11203,9520,-1683
2019,4,7,22,11760,11732,10111,-1621
2019,4,7,23,12520,12314,10253,-2061
2019,4,8,0,12900,12885,10911,-1974
2019,4,8,1,12660,12745,10769,-1976
2019,4,8,2,11900,11922,9684,-2238
2019,4,8,3,10940,11121,8971,-2150
2019,4,8,4,10100,10183,8235,-1948
2019,4,8,5,9330,9896,7906,-1990
2019,4,8,6,9040,10028,7954,-2074
2019,4,8,7,8920,10283,8387,-1896
2019,4,8,8,8970,10307,8515,-1792
2019,4,8,9,9330,10631,9094,-1537
2019,4,8,10,10340,11219,9836,-1383
2019,4,8,11,12050,12018,11027,-991
2019,4,8,12,13230,13215,12383,-832
2019,4,8,13,13710,13710,12812,-898
2019,4,8,14,13940,13948,12722,-1226
2019,4,8,15,14160,14155,13239,-916
2019,4,8,16,14200,14195,13392,-803
2019,4,8,17,14030,14044,13228,-816
2019,4,8,18,13880,13877,12641,-1236
2019,4,8,19,13710,13713,12485,-1228
2019,4,8,20,13700,13700,12511,-1189
2019,4,8,21,13990,13950,12590,-1360
2019,4,8,22,14430,14303,12874,-1429
2019,4,8,23,14650,14465,12910,-1555
2019,4,9,0,14750,14633,13052,-1581
2019,4,9,1,14200,14279,12588,-1691
2019,4,9,2,13200,13348,11482,-1866
2019,4,9,3,12010,12148,10197,-1951
2019,4,9,4,10760,11150,9211,-1939
2019,4,9,5,10420,10772,8956,-1816
2019,4,9,6,10070,10635,8688,-1947
2019,4,9,7,9910,10468,8472,-1996
2019,4,9,8,9920,10472,8495,-1977
2019,4,9,9,10280,10817,8859,-1958
2019,4,9,10,11280,11560,9686,-1874
2019,4,9,11,12980,12974,11254,-1720
2019,4,9,12,13950,13951,12335,-1616
2019,4,9,13,14140,14149,12522,-1627
2019,4,9,14,14120,14094,12446,-1648
2019,4,9,15,14030,13916,12037,-1879
2019,4,9,16,13950,13663,11833,-1830
2019,4,9,17,13830,13520,11808,-1712
2019,4,9,18,13800,13544,12069,-1475
2019,4,9,19,13750,13484,12008,-1476
2019,4,9,20,13760,13488,11934,-1554
2019,4,9,21,13800,13852,12169,-1683
2019,4,9,22,14160,14491,12919,-1572
2019,4,9,23,14410,14782,13271,-1511
2019,4,10,0,14750,14834,13435,-1399
2019,4,10,1,14320,14484,13054,-1430
2019,4,10,2,13390,13638,12022,-1616
2019,4,10,3,12190,12696,11087,-1609
2019,4,10,4,11130,11834,10080,-1754
2019,4,10,5,10640,11177,9442,-1735
2019,4,10,6,10270,10822,9156,-1666
2019,4,10,7,10110,10838,9124,-1714
2019,4,10,8,10100,10957,9261,-1696
2019,4,10,9,10440,11061,9523,-1538
2019,4,10,10,11450,11685,10092,-1593
2019,4,10,11,13060,13040,11435,-1605
2019,4,10,12,13720,13742,11908,-1834
2019,4,10,13,13520,13528,11661,-1867
2019,4,10,14,13290,13309,11423,-1886
2019,4,10,15,13140,13149,11244,-1905
2019,4,10,16,12890,12944,11074,-1870
2019,4,10,17,12460,12992,11108,-1884
2019,4,10,18,12340,12891,10925,-1966
2019,4,10,19,12240,12672,10745,-1927
2019,4,10,20,12250,12637,10914,-1723
2019,4,10,21,12770,13050,11131,-1919
2019,4,10,22,13280,13333,11368,-1965
2019,4,10,23,13810,13819,11892,-1927
2019,4,11,0,14500,14360,12511,-1849
2019,4,11,1,14400,14360,12522,-1838
2019,4,11,2,13560,13559,11714,-1845
2019,4,11,3,12400,12437,10515,-1922
2019,4,11,4,11340,11692,9698,-1994
2019,4,11,5,10730,11310,9228,-2082
2019,4,11,6,10440,11242,9250,-1992
2019,4,11,7,10330,11143,9183,-1960
2019,4,11,8,10360,11176,9115,-2061
2019,4,11,9,10750,11553,9539,-2014
2019,4,11,10,11780,12360,10362,-1998
2019,4,11,11,13340,13332,11337,-1995
2019,4,11,12,13830,13810,11739,-2071
2019,4,11,13,13260,13128,11232,-1896
2019,4,11,14,12370,12389,10739,-1650
2019,4,11,15,11840,12011,10539,-1472
2019,4,11,16,11470,12037,10561,-1476
2019,4,11,17,11170,11879,10666,-1213
2019,4,11,18,11010,11964,10501,-1463
2019,4,11,19,10940,12012,10426,-1586
2019,4,11,20,11320,12369,10534,-1835
2019,4,11,21,12030,12546,10778,-1768
2019,4,11,22,12770,13219,11154,-2065
2019,4,11,23,13420,13609,11505,-2104
2019,4,12,0,14100,14003,12026,-1977
2019,4,12,1,14010,13967,11953,-2014
2019,4,12,2,13240,13181,10962,-2219
2019,4,12,3,12130,12007,9749,-2258
2019,4,12,4,11090,11064,8743,-2321
2019,4,12,5,10330,10583,8191,-2392
2019,4,12,6,9980,10252,7904,-2348
2019,4,12,7,9850,10085,7755,-2330
2019,4,12,8,9830,10073,7761,-2312
2019,4,12,9,10160,10393,8113,-2280
2019,4,12,10,11130,11127,9159,-1968
2019,4,12,11,12650,12612,10606,-2006
2019,4,12,12,13600,13590,11593,-1997
2019,4,12,13,13880,13913,12190,-1723
2019,4,12,14,14020,14026,12309,-1717
2019,4,12,15,13960,14022,12218,-1804
2019,4,12,16,13850,13821,12058,-1763
2019,4,12,17,13580,13473,11518,-1955
2019,4,12,18,13440,13254,11170,-2084
2019,4,12,19,13190,12974,10934,-2040
2019,4,12,20,13180,12897,10875,-2022
2019,4,12,21,13410,13031,10991,-2040
2019,4,12,22,13610,13250,11249,-2001
2019,4,12,23,13740,13415,11365,-2050
2019,4,13,0,13860,13625,11620,-2005
2019,4,13,1,13510,13383,11470,-1913
2019,4,13,2,12780,12669,10614,-2055
2019,4,13,3,11830,11777,9319,-2458
2019,4,13,4,10790,10993,8527,-2466
2019,4,13,5,10060,10247,7887,-2360
2019,4,13,6,9550,10188,7780,-2408
2019,4,13,7,9300,10107,7957,-2150
2019,4,13,8,9190,9994,8019,-1975
2019,4,13,9,9270,10068,7903,-2165
2019,4,13,10,9600,10223,8105,-2118
2019,4,13,11,10210,10527,8264,-2263
2019,4,13,12,10990,10920,8829,-2091
2019,4,13,13,11580,11665,9635,-2030
2019,4,13,14,11740,11990,9945,-2045
2019,4,13,15,11790,12011,9954,-2057
2019,4,13,16,11510,11822,9779,-2043
2019,4,13,17,11170,11111,9017,-2094
2019,4,13,18,10320,10516,8453,-2063
2019,4,13,19,10170,10469,8323,-2146
2019,4,13,20,10340,10781,8640,-2141
2019,4,13,21,10940,11054,8792,-2262
2019,4,13,22,11720,11414,9029,-2385
2019,4,13,23,12220,11922,9467,-2455
2019,4,14,0,12500,12321,9897,-2424
2019,4,14,1,12470,12314,9945,-2369
2019,4,14,2,11880,11741,9552,-2189
2019,4,14,3,11100,10958,8774,-2184
2019,4,14,4,10240,10326,8114,-2212
2019,4,14,5,9580,9744,7664,-2080
2019,4,14,6,9140,9798,7711,-2087
2019,4,14,7,8950,9653,7729,-1924
2019,4,14,8,8810,9736,7842,-1894
2019,4,14,9,8850,9687,7932,-1755
2019,4,14,10,9130,9707,7777,-1930
2019,4,14,11,9450,9875,7687,-2188
2019,4,14,12,9850,9964,7823,-2141
2019,4,14,13,10320,10342,8491,-1851
2019,4,14,14,10340,10393,8348,-2045
2019,4,14,15,10400,10218,8332,-1886
2019,4,14,16,10500,10535,8700,-1835
2019,4,14,17,10540,10099,8207,-1892
2019,4,14,18,10540,9874,7868,-2006
2019,4,14,19,10600,10249,8259,-1990
2019,4,14,20,10880,10842,8853,-1989
2019,4,14,21,11490,11449,9587,-1862
2019,4,14,22,12120,12021,9913,-2108
2019,4,14,23,12560,12370,10287,-2083
2019,4,15,0,12880,12617,10587,-2030
2019,4,15,1,12660,12361,10385,-1976
2019,4,15,2,11860,11541,9463,-2078
2019,4,15,3,10890,10802,8683,-2119
2019,4,15,4,9960,10357,8046,-2311
2019,4,15,5,9250,9806,7526,-2280
2019,4,15,6,8920,9467,7255,-2212
2019,4,15,7,8750,9298,7218,-2080
2019,4,15,8,8760,9310,7342,-1968
2019,4,15,9,9070,9595,7548,-2047
2019,4,15,10,9910,10244,8312,-1932
2019,4,15,11,11240,11199,9043,-2156
2019,4,15,12,12180,12172,10008,-2164
2019,4,15,13,12620,12633,10757,-1876
2019,4,15,14,12690,12694,10661,-2033
2019,4,15,15,12670,12927,10920,-2007
2019,4,15,16,13000,12909,10815,-2094
2019,4,15,17,12870,12653,10642,-2011
2019,4,15,18,12870,12522,10548,-1974
2019,4,15,19,13070,12587,10695,-1892
2019,4,15,20,13120,12753,10655,-2098
2019,4,15,21,13270,12662,10581,-2081
2019,4,15,22,13490,12987,10972,-2015
2019,4,15,23,13650,13240,11236,-2004
2019,4,16,0,13790,13481,11617,-1864
2019,4,16,1,13560,13349,11513,-1836
2019,4,16,2,12690,12565,10557,-2008
2019,4,16,3,11590,11500,9443,-2057
2019,4,16,4,10600,10774,8817,-1957
2019,4,16,5,9930,10020,8089,-1931
2019,4,16,6,9580,9567,7902,-1665
2019,4,16,7,9470,9953,8142,-1811
2019,4,16,8,9480,10097,8285,-1812
2019,4,16,9,9820,10184,8394,-1790
2019,4,16,10,10790,10724,8776,-1948
2019,4,16,11,12190,12083,10271,-1812
2019,4,16,12,12980,12700,10797,-1903
2019,4,16,13,12540,12402,10357,-2045
2019,4,16,14,11730,11826,9695,-2131
2019,4,16,15,11180,11451,9234,-2217
2019,4,16,16,10820,11236,8967,-2269
2019,4,16,17,10530,11279,9165,-2114
2019,4,16,18,10310,11189,9109,-2080
2019,4,16,19,10280,11162,9114,-2048
2019,4,16,20,10590,11425,9444,-1981
2019,4,16,21,11460,11479,9419,-2060
2019,4,16,22,12510,12357,10430,-1927
2019,4,16,23,13200,13017,11052,-1965
2019,4,17,0,13640,13490,11233,-2257
2019,4,17,1,13650,13539,11356,-2183
2019,4,17,2,12740,12733,10472,-2261
2019,4,17,3,11510,11625,9103,-2522
2019,4,17,4,10540,10866,8472,-2394
2019,4,17,5,9970,10249,7712,-2537
2019,4,17,6,9600,10123,7811,-2312
2019,4,17,7,9460,10010,7804,-2206
2019,4,17,8,9430,10029,7818,-2211
2019,4,17,9,9760,10516,8127,-2389
2019,4,17,10,10650,10828,8754,-2074
2019,4,17,11,12000,11938,9902,-2036
2019,4,17,12,12700,12455,10428,-2027
2019,4,17,13,12440,12022,10145,-1877
2019,4,17,14,11490,11534,9560,-1974
2019,4,17,15,10870,11290,9332,-1958
2019,4,17,16,10480,10884,8899,-1985
2019,4,17,17,10250,10840,8804,-2036
2019,4,17,18,10260,10783,8922,-1861
2019,4,17,19,10230,10728,8774,-1954
2019,4,17,20,10560,10852,9072,-1780
2019,4,17,21,11190,11140,9185,-1955
2019,4,17,22,12170,11888,9743,-2145
2019,4,17,23,12740,12568,10417,-2151
2019,4,18,0,13210,13093,10947,-2146
2019,4,18,1,13380,13237,11186,-2051
2019,4,18,2,12590,12491,10380,-2111
2019,4,18,3,11400,11424,9226,-2198
2019,4,18,4,10360,10446,8185,-2261
2019,4,18,5,9760,10204,7850,-2354
2019,4,18,6,9430,10002,7648,-2354
2019,4,18,7,9290,10127,7706,-2421
2019,4,18,8,9310,10127,7689,-2438
2019,4,18,9,9650,10450,8124,-2326
2019,4,18,10,10520,10789,8828,-1961
2019,4,18,11,11790,11751,9931,-1820
2019,4,18,12,12820,12791,11007,-1784
2019,4,18,13,13320,13325,11659,-1666
2019,4,18,14,13550,13529,11897,-1632
2019,4,18,15,13520,13655,11958,-1697
2019,4,18,16,13360,13655,11892,-1763
2019,4,18,17,13180,13550,11886,-1664
2019,4,18,18,13110,13468,11782,-1686
2019,4,18,19,12920,13478,11808,-1670
2019,4,18,20,13020,13545,11633,-1912
2019,4,18,21,13310,13706,11774,-1932
2019,4,18,22,13670,13906,12063,-1843
2019,4,18,23,13810,13929,12038,-1891
2019,4,19,0,13830,13888,12065,-1823
2019,4,19,1,13690,13581,11818,-1763
2019,4,19,2,12820,12773,10727,-2046
2019,4,19,3,11660,11884,9671,-2213
2019,4,19,4,10540,11140,8890,-2250
2019,4,19,5,9940,10522,8424,-2098
2019,4,19,6,9520,10314,8343,-1971
2019,4,19,7,9290,10082,8150,-1932
2019,4,19,8,9250,10452,8204,-2248
2019,4,19,9,9500,10792,8377,-2415
2019,4,19,10,10200,11138,8791,-2347
2019,4,19,11,11170,11666,9246,-2420
2019,4,19,12,11910,12393,10031,-2362
2019,4,19,13,12260,12490,10358,-2132
2019,4,19,14,12300,12324,10281,-2043
2019,4,19,15,12440,12402,10425,-1977
2019,4,19,16,12540,12349,10486,-1863
2019,4,19,17,12530,12067,10231,-1836
2019,4,19,18,12530,12063,10174,-1889
2019,4,19,19,12420,12143,10439,-1704
2019,4,19,20,12370,12209,10397,-1812
2019,4,19,21,12600,12432,10438,-1994
2019,4,19,22,12940,12691,10783,-1908
2019,4,19,23,12860,12772,10857,-1915
2019,4,20,0,13000,12963,11155,-1808
2019,4,20,1,12840,12848,11155,-1693
2019,4,20,2,12100,12193,10295,-1898
2019,4,20,3,11250,11508,9310,-2198
2019,4,20,4,10330,10651,8386,-2265
2019,4,20,5,9690,9719,7774,-1945
2019,4,20,6,9260,9385,7539,-1846
2019,4,20,7,9020,9541,7429,-2112
2019,4,20,8,8870,9410,7546,-1864
2019,4,20,9,8900,9424,7825,-1599
2019,4,20,10,9160,9536,7866,-1670
2019,4,20,11,9660,9921,8115,-1806
2019,4,20,12,10420,10394,8805,-1589
2019,4,20,13,11340,11324,9511,-1813
2019,4,20,14,12120,12103,9997,-2106
2019,4,20,15,12540,12538,10554,-1984
2019,4,20,16,12750,12745,10792,-1953
2019,4,20,17,12630,12638,10622,-2016
2019,4,20,18,12190,12423,10330,-2093
2019,4,20,19,12040,12233,10227,-2006
2019,4,20,20,12150,12100,10144,-1956
2019,4,20,21,12290,12302,10255,-2047
2019,4,20,22,12440,12622,10416,-2206
2019,4,20,23,12650,12709,10487,-2222
2019,4,21,0,12850,12778,10640,-2138
2019,4,21,1,12520,12645,10405,-2240
2019,4,21,2,11870,12054,9879,-2175
2019,4,21,3,11000,11231,9055,-2176
2019,4,21,4,10140,10491,8110,-2381
2019,4,21,5,9580,10100,7890,-2210
2019,4,21,6,9090,9758,7811,-1947
2019,4,21,7,8820,10070,7687,-2383
2019,4,21,8,8690,10150,7695,-2455
2019,4,21,9,8690,10296,7904,-2392
2019,4,21,10,8880,10447,8020,-2427
2019,4,21,11,9220,10270,8036,-2234
2019,4,21,12,9840,10393,8248,-2145
2019,4,21,13,10600,10840,8755,-2085
2019,4,21,14,11230,11391,9028,-2363
2019,4,21,15,11200,11443,9004,-2439
2019,4,21,16,11210,11519,9038,-2481
2019,4,21,17,11040,11245,8752,-2493
2019,4,21,18,10560,11068,8648,-2420
2019,4,21,19,10250,10755,8455,-2300
2019,4,21,20,10270,10543,8686,-1857
2019,4,21,21,10440,10474,8452,-2022
2019,4,21,22,10850,10867,8562,-2305
2019,4,21,23,11110,11303,8798,-2505
2019,4,22,0,11800,11873,9385,-2488
2019,4,22,1,12100,12220,9948,-2272
2019,4,22,2,11500,11552,9131,-2421
2019,4,22,3,10540,10803,8198,-2605
2019,4,22,4,9700,10148,7936,-2212
2019,4,22,5,9160,9758,7615,-2143
2019,4,22,6,8800,9682,7599,-2083
2019,4,22,7,8700,9686,7605,-2081
2019,4,22,8,8750,9660,7700,-1960
2019,4,22,9,9080,9689,7745,-1944
2019,4,22,10,10030,10326,8445,-1881
2019,4,22,11,11480,11337,9626,-1711
2019,4,22,12,12410,12159,10661,-1498
2019,4,22,13,12490,12302,10703,-1599
2019,4,22,14,12230,12217,10524,-1693
2019,4,22,15,12170,12253,11032,-1221
2019,4,22,16,12220,12337,11346,-991
2019,4,22,17,12210,12589,11445,-1144
2019,4,22,18,12220,12854,11408,-1446
2019,4,22,19,12260,12849,11221,-1628
2019,4,22,20,12540,12987,11348,-1639
2019,4,22,21,12890,13316,11684,-1632
2019,4,22,22,13430,13710,12232,-1478
2019,4,22,23,13630,13869,12194,-1675
2019,4,23,0,13750,13873,12098,-1775
2019,4,23,1,13540,13528,11875,-1653
2019,4,23,2,12580,12615,10839,-1776
2019,4,23,3,11370,11399,9129,-2270
2019,4,23,4,10290,10370,8057,-2313
2019,4,23,5,9600,10091,7864,-2227
2019,4,23,6,9240,9813,7721,-2092
2019,4,23,7,9080,9618,7705,-1913
2019,4,23,8,9060,9821,7711,-2110
2019,4,23,9,9360,10099,7966,-2133
2019,4,23,10,10290,10619,8332,-2287
2019,4,23,11,11730,11838,9825,-2013
2019,4,23,12,12680,12708,11021,-1687
2019,4,23,13,12800,12833,11128,-1705
2019,4,23,14,12700,12661,11011,-1650
2019,4,23,15,12550,12521,10699,-1822
2019,4,23,16,12390,12319,10599,-1720
2019,4,23,17,12170,12104,10567,-1537
2019,4,23,18,12100,11947,10261,-1686
2019,4,23,19,11960,12193,10528,-1665
2019,4,23,20,11960,12313,10750,-1563
2019,4,23,21,12310,12176,10991,-1185
2019,4,23,22,12770,12664,11335,-1329
2019,4,23,23,13090,13189,11729,-1460
2019,4,24,0,13500,13635,12161,-1474
2019,4,24,1,13400,13582,12138,-1444
2019,4,24,2,12640,12679,10997,-1682
2019,4,24,3,11450,11660,9684,-1976
2019,4,24,4,10370,10666,8555,-2111
2019,4,24,5,9710,10010,8213,-1797
2019,4,24,6,9340,10075,8262,-1813
2019,4,24,7,9140,10094,8166,-1928
2019,4,24,8,9110,10138,8038,-2100
2019,4,24,9,9380,10499,8413,-2086
2019,4,24,10,10260,10855,9130,-1725
2019,4,24,11,11700,11843,10274,-1569
2019,4,24,12,12610,12582,10914,-1668
2019,4,24,13,12500,12534,10921,-1613
2019,4,24,14,12100,12125,10779,-1346
2019,4,24,15,11790,11765,10465,-1300
2019,4,24,16,11570,11574,10226,-1348
2019,4,24,17,11310,11415,10240,-1175
2019,4,24,18,11190,11349,9833,-1516
2019,4,24,19,11220,11256,9785,-1471
2019,4,24,20,11440,11370,9969,-1401
2019,4,24,21,11970,11851,10500,-1351
2019,4,24,22,12690,12431,11264,-1167
2019,4,24,23,13090,12906,11664,-1242
2019,4,25,0,13350,13278,12000,-1278
2019,4,25,1,13420,13398,12239,-1159
2019,4,25,2,12610,12585,11244,-1341
2019,4,25,3,11480,11425,9554,-1871
2019,4,25,4,10400,10543,8662,-1881
2019,4,25,5,9680,9887,8390,-1497
2019,4,25,6,9310,9506,7940,-1566
2019,4,25,7,9160,9340,7863,-1477
2019,4,25,8,9160,9572,7694,-1878
2019,4,25,9,9530,9923,8052,-1871
2019,4,25,10,10340,10625,8840,-1785
2019,4,25,11,11780,11699,10172,-1527
2019,4,25,12,12450,12310,10658,-1652
2019,4,25,13,12200,11923,10185,-1738
2019,4,25,14,11390,11662,10133,-1529
2019,4,25,15,11100,11266,9887,-1379
2019,4,25,16,11000,10987,9711,-1276
2019,4,25,17,10850,11045,9865,-1180
2019,4,25,18,10810,10962,9597,-1365
2019,4,25,19,10850,10924,9473,-1451
2019,4,25,20,11120,10945,9905,-1040
2019,4,25,21,11740,11571,10331,-1240
2019,4,25,22,12290,12285,10919,-1366
2019,4,25,23,12810,12712,11249,-1463
2019,4,26,0,13120,13087,11423,-1664
2019,4,26,1,13320,13254,11556,-1698
2019,4,26,2,12470,12467,10607,-1860
2019,4,26,3,11320,11324,9321,-2003
2019,4,26,4,10260,10280,8219,-2061
2019,4,26,5,9630,9837,8209,-1628
2019,4,26,6,9250,9709,7976,-1733
2019,4,26,7,9080,9545,7877,-1668
2019,4,26,8,9040,9492,7664,-1828
2019,4,26,9,9340,9766,8104,-1662
2019,4,26,10,10240,10240,8465,-1775
2019,4,26,11,11640,11572,9785,-1787
2019,4,26,12,12670,12667,10891,-1776
2019,4,26,13,13070,13119,11532,-1587
2019,4,26,14,13300,13298,11996,-1302
2019,4,26,15,13410,13379,12110,-1269
2019,4,26,16,13420,13434,12147,-1287
2019,4,26,17,13290,13367,12254,-1113
2019,4,26,18,13250,13419,12318,-1101
2019,4,26,19,13090,13423,12378,-1045
2019,4,26,20,13030,13364,12142,-1222
2019,4,26,21,13130,13407,11949,-1458
2019,4,26,22,13400,13534,11952,-1582
2019,4,26,23,13270,13590,11568,-2022
2019,4,27,0,13210,13600,11560,-2040
2019,4,27,1,13090,13325,11183,-2142
2019,4,27,2,12370,12625,10358,-2267
2019,4,27,3,11430,11693,9336,-2357
2019,4,27,4,10450,10971,8623,-2348
2019,4,27,5,9890,10255,7965,-2290
2019,4,27,6,9440,10065,7880,-2185
2019,4,27,7,9220,9860,7660,-2200
2019,4,27,8,9170,9737,7495,-2242
2019,4,27,9,9290,9797,7598,-2199
2019,4,27,10,9590,10114,7756,-2358
2019,4,27,11,10190,10482,7895,-2587
2019,4,27,12,10870,11337,8900,-2437
2019,4,27,13,11430,11344,8961,-2383
2019,4,27,14,11710,11677,9214,-2463
2019,4,27,15,11680,11559,9111,-2448
2019,4,27,16,11550,11471,9026,-2445
2019,4,27,17,11440,11294,8951,-2343
2019,4,27,18,11320,11154,9155,-1999
2019,4,27,19,11230,11097,9067,-2030
2019,4,27,20,11280,10989,8789,-2200
2019,4,27,21,11640,11127,8847,-2280
2019,4,27,22,12280,11739,9558,-2181
2019,4,27,23,12480,12215,9869,-2346
2019,4,28,0,12710,12521,10172,-2349
2019,4,28,1,12720,12695,10425,-2270
2019,4,28,2,12190,12197,10003,-2194
2019,4,28,3,11430,11434,8990,-2444
2019,4,28,4,10560,10599,8232,-2367
2019,4,28,5,9930,10001,7842,-2159
2019,4,28,6,9490,9908,7622,-2286
2019,4,28,7,9270,9823,7816,-2007
2019,4,28,8,9210,9590,7584,-2006
2019,4,28,9,9250,9781,7586,-2195
2019,4,28,10,9480,9752,7823,-1929
2019,4,28,11,9840,10258,7877,-2381
2019,4,28,12,10200,10100,7760,-2340
2019,4,28,13,10700,10506,8384,-2122
2019,4,28,14,11080,10817,8643,-2174
2019,4,28,15,11390,11205,9135,-2070
2019,4,28,16,11630,11431,9431,-2000
2019,4,28,17,11820,11636,9612,-2024
2019,4,28,18,11830,11609,9524,-2085
2019,4,28,19,11760,11634,9473,-2161
2019,4,28,20,11800,11729,9389,-2340
2019,4,28,21,12100,12095,9871,-2224
2019,4,28,22,12590,12685,10342,-2343
2019,4,28,23,12860,12959,10645,-2314
2019,4,29,0,13230,13034,10743,-2291
2019,4,29,1,13150,13094,10852,-2242
2019,4,29,2,12340,12288,10015,-2273
2019,4,29,3,11370,11331,8936,-2395
2019,4,29,4,10480,10699,8654,-2045
2019,4,29,5,9840,10097,8160,-1937
2019,4,29,6,9530,9921,7801,-2120
2019,4,29,7,9470,10219,7920,-2299
2019,4,29,8,9540,10304,8272,-2032
2019,4,29,9,9960,10873,8551,-2322
2019,4,29,10,11020,11086,9116,-1970
2019,4,29,11,12440,12418,10565,-1853
2019,4,29,12,12880,12882,11151,-1731
2019,4,29,13,12270,12292,10365,-1927
2019,4,29,14,11780,11764,10056,-1708
2019,4,29,15,11410,11594,9927,-1667
2019,4,29,16,11210,11465,9797,-1668
2019,4,29,17,10990,11479,9745,-1734
2019,4,29,18,10950,11473,9930,-1543
2019,4,29,19,10960,11549,10099,-1450
2019,4,29,20,11320,11726,10124,-1602
2019,4,29,21,11890,12103,10415,-1688
2019,4,29,22,12610,12640,10753,-1887
2019,4,29,23,13180,13094,11152,-1942
2019,4,30,0,13400,13519,11497,-2022
2019,4,30,1,13500,13579,11407,-2172
2019,4,30,2,12620,12695,10450,-2245
2019,4,30,3,11460,11464,9039,-2425
2019,4,30,4,10420,10629,8391,-2238
2019,4,30,5,9710,10206,8107,-2099
2019,4,30,6,9340,9612,7615,-1997
2019,4,30,7,9220,9713,7564,-2149
2019,4,30,8,9230,9743,7716,-2027
2019,4,30,9,9560,10057,7825,-2232
2019,4,30,10,10510,10636,8317,-2319
2019,4,30,11,12120,12087,10018,-2069
2019,4,30,12,13160,13127,11154,-1973
2019,4,30,13,13450,13444,11774,-1670
2019,4,30,14,13520,13550,12056,-1494
2019,4,30,15,13410,13518,12374,-1144
2019,4,30,16,13290,13333,12123,-1210
2019,4,30,17,13060,13151,11803,-1348
2019,4,30,18,12890,13003,11688,-1315
2019,4,30,19,12650,12723,11044,-1679
2019,4,30,20,12610,12551,10814,-1737
2019,4,30,21,12860,12721,10854,-1867
2019,4,30,22,13340,13084,11199,-1885
2019,4,30,23,13640,13295,11204,-2091
2019,5,1,0,13800,13597,11398,-2199
2019,5,1,1,13640,13769,11724,-2045
2019,5,1,2,12810,12974,10725,-2249
2019,5,1,3,11770,11775,9534,-2241
2019,5,1,4,10740,10685,8277,-2408
2019,5,1,5,10010,10014,7895,-2119
2019,5,1,6,9640,9685,7699,-1986
2019,5,1,7,9470,9728,7526,-2202
2019,5,1,8,9470,9720,7489,-2231
2019,5,1,9,9760,10001,7822,-2179
2019,5,1,10,10710,10684,8760,-1924
2019,5,1,11,12220,12190,10226,-1964
2019,5,1,12,13100,13080,11136,-1944
2019,5,1,13,13240,13231,11396,-1835
2019,5,1,14,13280,13269,11170,-2099
2019,5,1,15,13290,13081,11278,-1803
2019,5,1,16,13270,12893,11125,-1768
2019,5,1,17,12980,12640,10998,-1642
2019,5,1,18,12870,12515,10910,-1605
2019,5,1,19,12690,12489,11042,-1447
2019,5,1,20,12660,12607,11045,-1562
2019,5,1,21,13130,12949,11282,-1667
2019,5,1,22,13490,13317,11343,-1974
2019,5,1,23,13600,13557,11518,-2039
2019,5,2,0,13750,13749,11616,-2133
2019,5,2,1,13710,13679,11825,-1854
2019,5,2,2,12820,12819,10742,-2077
2019,5,2,3,11670,11604,9316,-2288
2019,5,2,4,10530,10590,8490,-2100
2019,5,2,5,9880,10129,7965,-2164
2019,5,2,6,9490,9723,7469,-2254
2019,5,2,7,9300,9544,7624,-1920
2019,5,2,8,9220,9516,7676,-1840
2019,5,2,9,9540,9794,7834,-1960
2019,5,2,10,10430,10473,8497,-1976
2019,5,2,11,11930,11943,10083,-1860
2019,5,2,12,12920,12950,11324,-1626
2019,5,2,13,13000,13145,11592,-1553
2019,5,2,14,13090,13174,11340,-1834
2019,5,2,15,13070,13144,11190,-1954
2019,5,2,16,13030,13027,11093,-1934
2019,5,2,17,12920,12898,11189,-1709
2019,5,2,18,12890,12996,11528,-1468
2019,5,2,19,12800,12925,11510,-1415
2019,5,2,20,12890,13006,11590,-1416
2019,5,2,21,13050,13279,11847,-1432
2019,5,2,22,13370,13577,11906,-1671
2019,5,2,23,13550,13662,11601,-2061
2019,5,3,0,13650,13770,11725,-2045
2019,5,3,1,13630,13696,11855,-1841
2019,5,3,2,12810,12867,11017,-1850
2019,5,3,3,11670,11672,9723,-1949
2019,5,3,4,10580,10575,8612,-1963
2019,5,3,5,9840,10153,7992,-2161
2019,5,3,6,9460,10252,7798,-2454
2019,5,3,7,9290,10087,7683,-2404
2019,5,3,8,9260,10043,7628,-2415
2019,5,3,9,9550,10332,7836,-2496
2019,5,3,10,10430,10719,8595,-2124
2019,5,3,11,11930,11866,10025,-1841
2019,5,3,12,12900,12866,10982,-1884
2019,5,3,13,13120,13173,11296,-1877
2019,5,3,14,13070,13069,11202,-1867
2019,5,3,15,12960,12789,11032,-1757
2019,5,3,16,12490,12490,10891,-1599
2019,5,3,17,12340,12347,10643,-1704
2019,5,3,18,12360,12682,11072,-1610
2019,5,3,19,12450,12814,11249,-1565
2019,5,3,20,12580,12752,10886,-1866
2019,5,3,21,12830,12872,10982,-1890
2019,5,3,22,13060,13106,11033,-2073
2019,5,3,23,13120,13161,11008,-2153
2019,5,4,0,13190,13189,11046,-2143
2019,5,4,1,13040,13085,10926,-2159
2019,5,4,2,12390,12423,10159,-2264
2019,5,4,3,11450,11467,9133,-2334
2019,5,4,4,10490,10465,8460,-2005
2019,5,4,5,9720,9977,7696,-2281
2019,5,4,6,9310,9701,7252,-2449
2019,5,4,7,9050,9838,7508,-2330
2019,5,4,8,8960,9975,7570,-2405
2019,5,4,9,9050,10045,7794,-2251
2019,5,4,10,9350,9749,7645,-2104
2019,5,4,11,9890,10140,7982,-2158
2019,5,4,12,10600,10711,8588,-2123
2019,5,4,13,11230,11260,9250,-2010
2019,5,4,14,11520,11593,9692,-1901
2019,5,4,15,11500,11712,9894,-1818
2019,5,4,16,11300,11560,9867,-1693
2019,5,4,17,11100,11416,9624,-1792
2019,5,4,18,10860,11158,9620,-1538
2019,5,4,19,10770,10903,9336,-1567
2019,5,4,20,10890,10873,9203,-1670
2019,5,4,21,11130,11087,9461,-1626
2019,5,4,22,11600,11481,9806,-1675
2019,5,4,23,11940,11747,9861,-1886
2019,5,5,0,12100,11960,9904,-2056
2019,5,5,1,12240,12142,10023,-2119
2019,5,5,2,11760,11657,9625,-2032
2019,5,5,3,10990,10867,8895,-1972
2019,5,5,4,10090,10266,8099,-2167
2019,5,5,5,9330,9596,7713,-1883
2019,5,5,6,8890,9381,7516,-1865
2019,5,5,7,8670,9453,7300,-2153
2019,5,5,8,8560,9347,7182,-2165
2019,5,5,9,8570,9374,7188,-2186
2019,5,5,10,8760,9557,7481,-2076
2019,5,5,11,9210,9881,7715,-2166
2019,5,5,12,9810,9945,7757,-2188
2019,5,5,13,10540,10494,8320,-2174
2019,5,5,14,11080,11010,8769,-2241
2019,5,5,15,11320,11339,9161,-2178
2019,5,5,16,11400,11497,9379,-2118
2019,5,5,17,11430,11553,9449,-2104
2019,5,5,18,11370,11494,9362,-2132
2019,5,5,19,11350,11506,9457,-2049
2019,5,5,20,11460,11506,9490,-2016
2019,5,5,21,11810,11715,9780,-1935
2019,5,5,22,12330,12192,10277,-1915
2019,5,5,23,12580,12525,10526,-1999
2019,5,6,0,12640,12735,10585,-2150
2019,5,6,1,12680,12722,10453,-2269
2019,5,6,2,11930,11899,9604,-2295
2019,5,6,3,10890,10920,8635,-2285
2019,5,6,4,9930,10221,8167,-2054
2019,5,6,5,9320,9921,7905,-2016
2019,5,6,6,8970,9749,7665,-2084
2019,5,6,7,8840,9610,7439,-2171
2019,5,6,8,8850,9781,7847,-1934
2019,5,6,9,9170,10088,8173,-1915
2019,5,6,10,10100,10437,8669,-1768
2019,5,6,11,11570,11747,9571,-2176
2019,5,6,12,12450,12448,10273,-2175
2019,5,6,13,12470,12417,10171,-2246
2019,5,6,14,12080,12090,9876,-2214
2019,5,6,15,11880,11916,9647,-2269
2019,5,6,16,11610,11445,9261,-2184
2019,5,6,17,11470,11023,8776,-2247
2019,5,6,18,11450,10941,8762,-2179
2019,5,6,19,11480,10873,8652,-2221
2019,5,6,20,11730,11030,8863,-2167
2019,5,6,21,12190,11509,9179,-2330
2019,5,6,22,12760,12180,9717,-2463
2019,5,6,23,13060,12769,10320,-2449
2019,5,7,0,13390,13106,10762,-2344
2019,5,7,1,13490,13299,10864,-2435
2019,5,7,2,12690,12511,10225,-2286
2019,5,7,3,11430,11307,8669,-2638
2019,5,7,4,10310,10160,8009,-2151
2019,5,7,5,9520,9722,7912,-1810
2019,5,7,6,9130,9557,7713,-1844
2019,5,7,7,8960,9547,7633,-1914
2019,5,7,8,8950,9599,7716,-1883
2019,5,7,9,9250,9668,7789,-1879
2019,5,7,10,10090,10231,8389,-1842
2019,5,7,11,11530,11487,9159,-2328
2019,5,7,12,12250,12116,9739,-2377
2019,5,7,13,11940,11931,9495,-2436
2019,5,7,14,11600,11629,9327,-2302
2019,5,7,15,11510,11487,9132,-2355
2019,5,7,16,11460,11574,9386,-2188
2019,5,7,17,11460,11476,9612,-1864
2019,5,7,18,11600,11480,9298,-2182
2019,5,7,19,11800,11596,9262,-2334
2019,5,7,20,12230,11929,9376,-2553
2019,5,7,21,12760,12492,9923,-2569
2019,5,7,22,13200,13086,10550,-2536
2019,5,7,23,13520,13434,10891,-2543
2019,5,8,0,13700,13598,11049,-2549
2019,5,8,1,13720,13471,10874,-2597
2019,5,8,2,12810,12615,10001,-2614
2019,5,8,3,11460,11354,9167,-2187
2019,5,8,4,10330,10254,7828,-2426
2019,5,8,5,9510,9737,7512,-2225
2019,5,8,6,9090,9407,7289,-2118
2019,5,8,7,8890,9430,7294,-2136
2019,5,8,8,8850,9317,7248,-2069
2019,5,8,9,9210,9406,7364,-2042
2019,5,8,10,10090,10048,8014,-2034
2019,5,8,11,11420,11369,9309,-2060
2019,5,8,12,12040,12015,9491,-2524
2019,5,8,13,11870,11692,9157,-2535
2019,5,8,14,11270,11272,8749,-2523
2019,5,8,15,11010,11084,8561,-2523
2019,5,8,16,10900,11013,8783,-2230
2019,5,8,17,10770,11000,8721,-2279
2019,5,8,18,10850,11050,8842,-2208
2019,5,8,19,10920,11091,8742,-2349
2019,5,8,20,11130,11300,8935,-2365
2019,5,8,21,11820,11755,9328,-2427
2019,5,8,22,12580,12204,9644,-2560
2019,5,8,23,13030,12757,10204,-2553
2019,5,9,0,13300,13055,10518,-2537
2019,5,9,1,13400,13320,10885,-2435
2019,5,9,2,12630,12594,9890,-2704
2019,5,9,3,11440,11349,8611,-2738
2019,5,9,4,10330,10198,7951,-2247
2019,5,9,5,9450,9626,7482,-2144
2019,5,9,6,9070,9601,7413,-2188
2019,5,9,7,8890,9428,7314,-2114
2019,5,9,8,8900,9423,7407,-2016
2019,5,9,9,9220,9730,7718,-2012
2019,5,9,10,10120,10598,8625,-1973
2019,5,9,11,11520,11759,9255,-2504
2019,5,9,12,12080,12072,9485,-2587
2019,5,9,13,11750,11753,9405,-2348
2019,5,9,14,11210,11367,9031,-2336
2019,5,9,15,11030,11176,8880,-2296
2019,5,9,16,10940,11038,8682,-2356
2019,5,9,17,10790,10912,8447,-2465
2019,5,9,18,10800,11022,8654,-2368
2019,5,9,19,10930,11118,8732,-2386
2019,5,9,20,11330,11376,9035,-2341
2019,5,9,21,12120,11845,9499,-2346
2019,5,9,22,12690,12411,10101,-2310
2019,5,9,23,13040,12823,10575,-2248
2019,5,10,0,13280,13161,11051,-2110
2019,5,10,1,13330,13249,11204,-2045
2019,5,10,2,12530,12493,10256,-2237
2019,5,10,3,11370,11320,9036,-2284
2019,5,10,4,10310,10321,8395,-1926
2019,5,10,5,9520,9804,8067,-1737
2019,5,10,6,9130,9495,7628,-1867
2019,5,10,7,8960,9403,7552,-1851
2019,5,10,8,8940,9458,7568,-1890
2019,5,10,9,9210,9538,7625,-1913
2019,5,10,10,10090,10127,8157,-1970
2019,5,10,11,11600,11554,9535,-2019
2019,5,10,12,12640,12621,10539,-2082
2019,5,10,13,12940,12931,10969,-1962
2019,5,10,14,13050,12977,10797,-2180
2019,5,10,15,13160,13248,11262,-1986
2019,5,10,16,13090,13446,11322,-2124
2019,5,10,17,13060,13414,11231,-2183
2019,5,10,18,13030,13450,11251,-2199
2019,5,10,19,12880,13234,11038,-2196
2019,5,10,20,12800,12981,10780,-2201
2019,5,10,21,12790,13087,10863,-2224
2019,5,10,22,12780,13119,10822,-2297
2019,5,10,23,12940,13004,10777,-2227
2019,5,11,0,13120,12987,10726,-2261
2019,5,11,1,12970,13052,10832,-2220
2019,5,11,2,12320,12460,10229,-2231
2019,5,11,3,11370,11461,9120,-2341
2019,5,11,4,10420,10434,8331,-2103
2019,5,11,5,9690,9933,7923,-2010
2019,5,11,6,9230,9720,7491,-2229
2019,5,11,7,8960,9584,7539,-2045
2019,5,11,8,8790,9621,7827,-1794
2019,5,11,9,8860,9657,7822,-1835
2019,5,11,10,9150,9500,7835,-1665
2019,5,11,11,9690,9891,8358,-1533
2019,5,11,12,10220,10138,8727,-1411
2019,5,11,13,10550,10366,9111,-1255
2019,5,11,14,10180,10191,8917,-1274
2019,5,11,15,10010,9979,8939,-1040
2019,5,11,16,9810,9825,8864,-961
2019,5,11,17,9700,9631,8564,-1067
2019,5,11,18,9470,9489,8302,-1187
2019,5,11,19,9630,9678,8396,-1282
2019,5,11,20,9810,10089,8930,-1159
2019,5,11,21,10490,10344,9212,-1132
2019,5,11,22,11290,10741,9574,-1167
2019,5,11,23,11690,11416,10273,-1143
2019,5,12,0,11960,11698,10573,-1125
2019,5,12,1,12100,11995,10579,-1416
2019,5,12,2,11710,11594,10092,-1502
2019,5,12,3,10870,10774,9074,-1700
2019,5,12,4,10000,9905,7957,-1948
2019,5,12,5,9220,9418,7361,-2057
2019,5,12,6,8780,9267,7167,-2100
2019,5,12,7,8560,9313,7184,-2129
2019,5,12,8,8470,9243,7061,-2182
2019,5,12,9,8500,9274,7100,-2174
2019,5,12,10,8670,9454,7282,-2172
2019,5,12,11,9080,9760,7513,-2247
2019,5,12,12,9780,10032,7688,-2344
2019,5,12,13,10570,10705,8269,-2436
2019,5,12,14,11280,11148,8554,-2594
2019,5,12,15,11480,11537,9060,-2477
2019,5,12,16,11400,11638,9268,-2370
2019,5,12,17,11230,11619,9301,-2318
2019,5,12,18,11080,11536,9275,-2261
2019,5,12,19,11050,11518,9199,-2319
2019,5,12,20,11180,11629,9370,-2259
2019,5,12,21,11540,11918,9579,-2339
2019,5,12,22,11990,12336,10050,-2286
2019,5,12,23,12320,12601,10303,-2298
2019,5,13,0,12610,12755,10436,-2319
2019,5,13,1,12660,12810,10597,-2213
2019,5,13,2,12100,12083,9804,-2279
2019,5,13,3,11150,11058,8617,-2441
2019,5,13,4,10190,10381,8236,-2145
2019,5,13,5,9490,9774,7667,-2107
2019,5,13,6,9140,9710,7656,-2054
2019,5,13,7,9010,9825,7727,-2098
2019,5,13,8,9040,9840,7726,-2114
2019,5,13,9,9370,9906,8008,-1898
2019,5,13,10,10180,10310,8758,-1552
2019,5,13,11,11750,11708,9516,-2192
2019,5,13,12,12430,12424,10316,-2108
2019,5,13,13,12620,12605,10484,-2121
2019,5,13,14,12660,12708,10673,-2035
2019,5,13,15,12580,12623,10587,-2036
2019,5,13,16,12490,12406,10549,-1857
2019,5,13,17,12450,12407,10695,-1712
2019,5,13,18,12420,12601,10817,-1784
2019,5,13,19,12450,12765,10856,-1909
2019,5,13,20,12700,13088,11066,-2022
2019,5,13,21,13230,13441,11392,-2049
2019,5,13,22,13760,13893,11778,-2115
2019,5,13,23,13920,14185,12092,-2093
2019,5,14,0,13870,14165,12025,-2140
2019,5,14,1,13860,13910,11790,-2120
2019,5,14,2,13030,12978,11064,-1914
2019,5,14,3,11740,11743,9456,-2287
2019,5,14,4,10580,10667,8567,-2100
2019,5,14,5,9990,10431,8182,-2249
2019,5,14,6,9630,10428,7890,-2538
2019,5,14,7,9470,10269,7967,-2302
2019,5,14,8,9480,10270,8020,-2250
2019,5,14,9,9820,10532,8311,-2221
2019,5,14,10,10760,11218,8704,-2514
2019,5,14,11,12280,12244,10035,-2209
2019,5,14,12,13170,13153,11159,-1994
2019,5,14,13,13210,13213,11379,-1834
2019,5,14,14,13300,13156,10893,-2263
2019,5,14,15,13360,13124,10866,-2258
2019,5,14,16,13330,13119,11008,-2111
2019,5,14,17,13150,13066,10846,-2220
2019,5,14,18,13120,13050,10800,-2250
2019,5,14,19,13020,13002,10778,-2224
2019,5,14,20,13020,12986,10626,-2360
2019,5,14,21,13260,13360,11010,-2350
2019,5,14,22,13610,13846,11559,-2287
2019,5,14,23,13810,14008,11745,-2263
2019,5,15,0,13950,14076,11743,-2333
2019,5,15,1,13880,13991,11715,-2276
2019,5,15,2,13060,13161,10837,-2324
2019,5,15,3,11840,11928,9387,-2541
2019,5,15,4,10750,10797,8243,-2554
2019,5,15,5,10030,10084,7555,-2529
2019,5,15,6,9620,9898,7540,-2358
2019,5,15,7,9450,9962,7556,-2406
2019,5,15,8,9440,9933,7563,-2370
2019,5,15,9,9750,9963,7734,-2229
2019,5,15,10,10680,10641,8477,-2164
2019,5,15,11,12130,12083,9807,-2276
2019,5,15,12,12690,12687,10403,-2284
2019,5,15,13,12380,12390,10078,-2312
2019,5,15,14,12250,12256,9933,-2323
2019,5,15,15,12130,12251,9965,-2286
2019,5,15,16,11940,12179,9632,-2547
2019,5,15,17,11800,12047,9654,-2393
2019,5,15,18,11710,12057,9942,-2115
2019,5,15,19,11780,11901,10043,-1858
2019,5,15,20,12060,11891,9606,-2285
2019,5,15,21,12440,12066,10037,-2029
2019,5,15,22,12820,12503,10315,-2188
2019,5,15,23,13080,12901,10732,-2169
2019,5,16,0,13400,13219,11074,-2145
2019,5,16,1,13600,13417,11342,-2075
2019,5,16,2,12850,12712,10633,-2079
2019,5,16,3,11630,11487,9262,-2225
2019,5,16,4,10500,10561,7947,-2614
2019,5,16,5,9720,9912,7435,-2477
2019,5,16,6,9320,9652,7091,-2561
2019,5,16,7,9130,9579,6857,-2722
2019,5,16,8,9090,9548,6805,-2743
2019,5,16,9,9390,9611,6891,-2720
2019,5,16,10,10180,10183,7710,-2473
2019,5,16,11,11630,11555,9348,-2207
2019,5,16,12,12350,12122,9837,-2285
2019,5,16,13,12260,11875,9896,-1979
2019,5,16,14,11710,11667,9572,-2095
2019,5,16,15,11540,11751,9676,-2075
2019,5,16,16,11380,11828,9742,-2086
2019,5,16,17,11310,11763,9677,-2086
2019,5,16,18,11420,11633,9417,-2216
2019,5,16,19,11570,11479,9563,-1916
2019,5,16,20,11970,11598,9453,-2145
2019,5,16,21,12390,12157,9907,-2250
2019,5,16,22,12880,12607,10161,-2446
2019,5,16,23,13200,12852,10296,-2556
2019,5,17,0,13360,13027,10420,-2607
2019,5,17,1,13500,13175,10638,-2537
2019,5,17,2,12750,12568,10042,-2526
2019,5,17,3,11480,11396,8952,-2444
2019,5,17,4,10310,10272,7748,-2524
2019,5,17,5,9610,9684,7452,-2232
2019,5,17,6,9210,9617,7661,-1956
2019,5,17,7,9030,9629,7695,-1934
2019,5,17,8,8830,9608,7653,-1955
2019,5,17,9,9170,9844,7871,-1973
2019,5,17,10,10020,10425,8441,-1984
2019,5,17,11,11500,11541,9164,-2377
2019,5,17,12,12510,12491,9963,-2528
2019,5,17,13,12840,12912,10373,-2539
2019,5,17,14,12880,13016,10432,-2584
2019,5,17,15,12940,13019,10475,-2544
2019,5,17,16,12860,13028,10513,-2515
2019,5,17,17,12650,12886,10367,-2519
2019,5,17,18,12640,12900,10296,-2604
2019,5,17,19,12580,12902,10419,-2483
2019,5,17,20,12460,12759,10228,-2531
2019,5,17,21,12640,12638,10128,-2510
2019,5,17,22,12890,12678,10131,-2547
2019,5,17,23,12980,12811,10231,-2580
2019,5,18,0,12920,12852,10296,-2556
2019,5,18,1,13070,12994,10508,-2486
2019,5,18,2,12500,12494,9972,-2522
2019,5,18,3,11430,11637,9075,-2562
2019,5,18,4,10390,10501,8210,-2291
2019,5,18,5,9630,9712,6988,-2724
2019,5,18,6,9160,9712,6986,-2726
2019,5,18,7,8920,9812,7153,-2659
2019,5,18,8,8780,9845,7104,-2741
2019,5,18,9,8840,9908,7173,-2735
2019,5,18,10,9110,9739,7377,-2362
2019,5,18,11,9520,9746,7955,-1791
2019,5,18,12,10070,9928,7704,-2224
2019,5,18,13,10290,10068,7897,-2171
2019,5,18,14,9980,9966,8007,-1959
2019,5,18,15,9780,9911,8024,-1887
2019,5,18,16,9550,9875,7834,-2041
2019,5,18,17,9370,10068,8043,-2025
2019,5,18,18,9210,9683,7991,-1692
2019,5,18,19,9250,9666,8304,-1362
2019,5,18,20,9490,10039,8493,-1546
2019,5,18,21,10120,10485,9016,-1469
2019,5,18,22,10930,11074,9381,-1693
2019,5,18,23,11550,11630,9621,-2009
2019,5,19,0,11780,11798,9540,-2258
2019,5,19,1,12010,12016,9542,-2474
2019,5,19,2,11570,11660,8911,-2749
2019,5,19,3,10750,10829,8028,-2801
2019,5,19,4,9890,9922,7349,-2573
2019,5,19,5,9230,9738,6981,-2757
2019,5,19,6,8770,9601,6974,-2627
2019,5,19,7,8580,9321,6960,-2361
2019,5,19,8,8480,9687,7019,-2668
2019,5,19,9,8460,9540,7142,-2398
2019,5,19,10,8670,9345,7012,-2333
2019,5,19,11,9060,9584,7159,-2425
2019,5,19,12,9650,9909,7523,-2386
2019,5,19,13,10200,10607,8464,-2143
2019,5,19,14,10600,10964,8761,-2203
2019,5,19,15,10680,11094,8888,-2206
2019,5,19,16,10570,11096,8858,-2238
2019,5,19,17,10460,10818,8644,-2174
2019,5,19,18,10410,10459,8352,-2107
2019,5,19,19,10430,10348,8542,-1806
2019,5,19,20,10670,10622,8687,-1935
2019,5,19,21,11230,11353,9537,-1816
2019,5,19,22,12090,12093,9952,-2141
2019,5,19,23,12540,12724,10309,-2415
2019,5,20,0,12640,12962,10398,-2564
2019,5,20,1,12650,13107,10596,-2511
2019,5,20,2,11930,12350,9855,-2495
2019,5,20,3,10980,11317,8931,-2386
2019,5,20,4,10150,10638,8063,-2575
2019,5,20,5,10120,10207,7778,-2429
2019,5,20,6,9620,9802,7630,-2172
2019,5,20,7,9330,9721,7554,-2167
2019,5,20,8,9280,9851,7733,-2118
2019,5,20,9,9550,10068,7899,-2169
2019,5,20,10,10330,10783,8314,-2469
2019,5,20,11,12120,11727,9342,-2385
2019,5,20,12,13160,12897,10555,-2342
2019,5,20,13,13500,13249,10813,-2436
2019,5,20,14,13810,13357,11425,-1932
2019,5,20,15,13860,13424,11394,-2030
2019,5,20,16,13850,13426,11348,-2078
2019,5,20,17,13790,13512,11642,-1870
2019,5,20,18,13990,14008,12212,-1796
2019,5,20,19,14170,14399,12702,-1697
2019,5,20,20,14650,14612,12874,-1738
2019,5,20,21,15080,14861,13075,-1786
2019,5,20,22,15640,15307,13620,-1687
2019,5,20,23,15660,15356,13506,-1850
2019,5,21,0,15430,15281,13295,-1986
2019,5,21,1,15280,15230,13308,-1922
2019,5,21,2,14290,14397,12488,-1909
2019,5,21,3,12760,12924,11017,-1907
2019,5,21,4,11440,11569,9684,-1885
2019,5,21,5,10470,10990,8984,-2006
2019,5,21,6,9800,10362,8470,-1892
2019,5,21,7,9420,10213,8447,-1766
2019,5,21,8,9340,10084,8294,-1790
2019,5,21,9,9440,10224,8311,-1913
2019,5,21,10,10200,10608,8573,-2035
2019,5,21,11,11680,11352,9369,-1983
2019,5,21,12,12550,12085,9886,-2199
2019,5,21,13,12560,11971,9669,-2302
2019,5,21,14,11650,11834,9431,-2403
2019,5,21,15,11530,11737,9665,-2072
2019,5,21,16,11320,11610,9645,-1965
2019,5,21,17,11120,11304,9648,-1656
2019,5,21,18,11280,11330,9674,-1656
2019,5,21,19,11440,11419,9605,-1814
2019,5,21,20,11690,11698,10046,-1652
2019,5,21,21,12370,12195,10392,-1803
2019,5,21,22,13170,12732,10929,-1803
2019,5,21,23,13510,13170,11243,-1927
2019,5,22,0,13530,13219,11142,-2077
2019,5,22,1,13520,13382,11231,-2151
2019,5,22,2,12910,12752,10724,-2028
2019,5,22,3,11620,11444,9548,-1896
2019,5,22,4,10470,10487,8448,-2039
2019,5,22,5,9560,9965,7485,-2480
2019,5,22,6,9130,9804,7457,-2347
2019,5,22,7,8910,9670,7679,-1991
2019,5,22,8,8880,9603,7600,-2003
2019,5,22,9,9080,9777,7594,-2183
2019,5,22,10,9860,10083,7726,-2357
2019,5,22,11,11280,11189,8760,-2429
2019,5,22,12,12020,11818,9496,-2322
2019,5,22,13,11800,11562,9436,-2126
2019,5,22,14,11200,11229,9317,-1912
2019,5,22,15,11030,11073,9357,-1716
2019,5,22,16,10840,11043,9472,-1571
2019,5,22,17,10880,11288,9710,-1578
2019,5,22,18,11010,11486,9692,-1794
2019,5,22,19,11200,11650,9555,-2095
2019,5,22,20,11510,11867,9401,-2466
2019,5,22,21,12530,12077,9653,-2424
2019,5,22,22,13020,12710,10218,-2492
2019,5,22,23,13230,13097,10129,-2968
2019,5,23,0,13410,13241,10146,-3095
2019,5,23,1,13550,13418,10417,-3001
2019,5,23,2,12860,12738,9757,-2981
2019,5,23,3,11540,11478,8466,-3012
2019,5,23,4,10370,10372,7530,-2842
2019,5,23,5,9510,9885,7285,-2600
2019,5,23,6,9040,9730,7443,-2287
2019,5,23,7,8870,9667,7165,-2502
2019,5,23,8,8850,9647,7293,-2354
2019,5,23,9,9120,9904,7563,-2341
2019,5,23,10,9920,10389,7976,-2413
2019,5,23,11,11310,11271,8771,-2500
2019,5,23,12,12230,12214,9730,-2484
2019,5,23,13,12330,12317,10067,-2250
2019,5,23,14,12300,12309,10232,-2077
2019,5,23,15,12260,12410,10250,-2160
2019,5,23,16,12140,12269,10041,-2228
2019,5,23,17,11960,12197,9964,-2233
2019,5,23,18,12000,12194,9821,-2373
2019,5,23,19,12060,12405,9838,-2567
2019,5,23,20,12490,12935,10386,-2549
2019,5,23,21,13060,13220,10781,-2439
2019,5,23,22,13430,13393,10532,-2861
2019,5,23,23,13540,13338,10454,-2884
2019,5,24,0,13520,13379,10297,-3082
2019,5,24,1,13600,13456,10313,-3143
2019,5,24,2,12920,12816,9877,-2939
2019,5,24,3,11690,11704,9150,-2554
2019,5,24,4,10560,10770,8510,-2260
2019,5,24,5,9940,9988,7777,-2211
2019,5,24,6,9540,10267,7888,-2379
2019,5,24,7,9260,10189,8172,-2017
2019,5,24,8,9220,9885,7824,-2061
2019,5,24,9,9490,10044,8163,-1881
2019,5,24,10,10100,10736,8429,-2307
2019,5,24,11,11370,11367,8722,-2645
2019,5,24,12,12300,12151,9565,-2586
2019,5,24,13,12440,12404,9777,-2627
2019,5,24,14,12400,12506,9849,-2657
2019,5,24,15,12450,12684,10081,-2603
2019,5,24,16,12390,12626,10197,-2429
2019,5,24,17,12270,12281,9948,-2333
2019,5,24,18,12380,12398,10141,-2257
2019,5,24,19,12400,12421,10154,-2267
2019,5,24,20,12460,12484,10248,-2236
2019,5,24,21,12490,12670,10316,-2354
2019,5,24,22,12880,12880,10197,-2683
2019,5,24,23,12820,12885,10221,-2664
2019,5,25,0,12960,12815,10041,-2774
2019,5,25,1,13250,12847,10074,-2773
2019,5,25,2,12700,12334,9580,-2754
2019,5,25,3,11510,11336,8831,-2505
2019,5,25,4,10460,10522,8125,-2397
2019,5,25,5,9530,9801,7537,-2264
2019,5,25,6,9040,9351,7412,-1939
2019,5,25,7,8750,9293,7430,-1863
2019,5,25,8,8620,9168,7282,-1886
2019,5,25,9,8690,9442,7551,-1891
2019,5,25,10,8840,9460,7894,-1566
2019,5,25,11,9240,9522,8331,-1191
2019,5,25,12,9650,9645,8446,-1199
2019,5,25,13,9940,9926,8441,-1485
2019,5,25,14,9950,9946,8415,-1531
2019,5,25,15,9900,9924,8307,-1617
2019,5,25,16,9780,9918,8549,-1369
2019,5,25,17,9710,9954,8869,-1085
2019,5,25,18,9750,9958,8833,-1125
2019,5,25,19,9950,10024,8928,-1096
2019,5,25,20,10300,10404,9226,-1178
2019,5,25,21,10880,11056,9472,-1584
2019,5,25,22,11620,11609,9606,-2003
2019,5,25,23,11960,11870,9520,-2350
2019,5,26,0,12130,11982,9405,-2577
2019,5,26,1,12260,12130,9753,-2377
2019,5,26,2,11890,11686,9499,-2187
2019,5,26,3,11040,10860,9079,-1781
2019,5,26,4,10110,10101,8441,-1660
2019,5,26,5,9250,9508,8025,-1483
2019,5,26,6,8790,9149,7734,-1415
2019,5,26,7,8550,9267,7694,-1573
2019,5,26,8,8470,9155,7572,-1583
2019,5,26,9,8500,9282,7710,-1572
2019,5,26,10,8640,9409,7701,-1708
2019,5,26,11,8920,9363,7513,-1850
2019,5,26,12,9330,9317,7597,-1720
2019,5,26,13,9730,9724,8128,-1596
2019,5,26,14,10610,9992,8537,-1455
2019,5,26,15,10670,10252,8956,-1296
2019,5,26,16,10870,10540,9347,-1193
2019,5,26,17,10900,10906,9825,-1081
2019,5,26,18,11130,11319,10076,-1243
2019,5,26,19,11030,11664,10371,-1293
2019,5,26,20,11540,12167,10742,-1425
2019,5,26,21,12230,12739,11523,-1216
2019,5,26,22,12650,13376,11714,-1662
2019,5,26,23,13800,13595,11440,-2155
2019,5,27,0,13890,13606,11319,-2287
2019,5,27,1,14250,13683,11326,-2357
2019,5,27,2,13720,13247,10949,-2298
2019,5,27,3,12250,12305,10017,-2288
2019,5,27,4,11050,11245,8996,-2249
2019,5,27,5,10340,10355,8281,-2074
2019,5,27,6,9770,10017,8159,-1858
2019,5,27,7,9350,9681,7347,-2334
2019,5,27,8,9160,9694,7279,-2415
2019,5,27,9,9150,9697,7121,-2576
2019,5,27,10,9250,10236,7567,-2669
2019,5,27,11,9630,10409,8011,-2398
2019,5,27,12,10070,10843,8717,-2126
2019,5,27,13,10500,10585,8874,-1711
2019,5,27,14,10820,10731,9129,-1602
2019,5,27,15,11060,10883,9313,-1570
2019,5,27,16,11240,11070,9496,-1574
2019,5,27,17,11290,11219,9561,-1658
2019,5,27,18,11330,11350,9691,-1659
2019,5,27,19,11440,11788,10255,-1533
2019,5,27,20,11740,11972,10585,-1387
2019,5,27,21,12400,12667,11410,-1257
2019,5,27,22,13040,13399,11840,-1559
2019,5,27,23,13300,13728,11959,-1769
2019,5,28,0,13360,13772,11751,-2021
2019,5,28,1,13500,13794,11601,-2193
2019,5,28,2,12810,13115,11024,-2091
2019,5,28,3,11620,11798,9421,-2377
2019,5,28,4,10490,10561,7996,-2565
2019,5,28,5,9690,9719,7555,-2164
2019,5,28,6,9200,9573,7477,-2096
2019,5,28,7,8950,9422,7352,-2070
2019,5,28,8,8890,9179,7402,-1777
2019,5,28,9,9150,9408,7716,-1692
2019,5,28,10,9870,9850,7812,-2038
2019,5,28,11,11250,11216,8852,-2364
2019,5,28,12,12190,12189,9636,-2553
2019,5,28,13,12650,12463,9858,-2605
2019,5,28,14,12820,12618,10075,-2543
2019,5,28,15,13080,12871,10384,-2487
2019,5,28,16,13290,13315,10954,-2361
2019,5,28,17,13390,13415,10934,-2481
2019,5,28,18,13510,13456,10990,-2466
2019,5,28,19,13410,13427,11092,-2335
2019,5,28,20,13350,13386,11207,-2179
2019,5,28,21,13470,13636,11723,-1913
2019,5,28,22,13540,13957,11853,-2104
2019,5,28,23,13470,13970,11541,-2429
2019,5,29,0,13370,13738,11158,-2580
2019,5,29,1,13300,13436,10927,-2509
2019,5,29,2,12610,12549,10255,-2294
2019,5,29,3,11450,11337,9106,-2231
2019,5,29,4,10370,10269,7930,-2339
2019,5,29,5,9580,10014,7642,-2372
2019,5,29,6,9180,10218,7629,-2589
2019,5,29,7,8970,10021,7710,-2311
2019,5,29,8,8950,9996,7760,-2236
2019,5,29,9,9250,10165,7997,-2168
2019,5,29,10,10150,10401,8196,-2205
2019,5,29,11,11570,11657,9092,-2565
2019,5,29,12,12530,12576,9902,-2674
2019,5,29,13,12610,12690,10289,-2401
2019,5,29,14,12560,12717,10307,-2410
2019,5,29,15,12360,12668,10084,-2584
2019,5,29,16,12200,12633,10063,-2570
2019,5,29,17,12050,12549,10187,-2362
2019,5,29,18,12110,12529,10474,-2055
2019,5,29,19,12250,12439,10409,-2030
2019,5,29,20,12450,12473,10568,-1905
2019,5,29,21,12980,12710,10935,-1775
2019,5,29,22,13420,13221,11071,-2150
2019,5,29,23,13540,13530,11257,-2273
2019,5,30,0,13560,13535,11232,-2303
2019,5,30,1,13580,13402,11305,-2097
2019,5,30,2,12870,12660,10526,-2134
2019,5,30,3,11610,11460,9149,-2311
2019,5,30,4,10460,10581,8167,-2414
2019,5,30,5,9630,10033,7922,-2111
2019,5,30,6,9190,9944,7935,-2009
2019,5,30,7,8990,9741,7938,-1803
2019,5,30,8,8970,9905,8273,-1632
2019,5,30,9,9230,9915,8265,-1650
2019,5,30,10,10030,10386,8597,-1789
2019,5,30,11,11490,11400,9067,-2333
2019,5,30,12,12470,12388,9748,-2640
2019,5,30,13,12550,12599,9812,-2787
2019,5,30,14,12620,12630,10222,-2408
2019,5,30,15,12560,12640,10081,-2559
2019,5,30,16,12420,12557,10134,-2423
2019,5,30,17,12280,12482,10427,-2055
2019,5,30,18,12260,12478,10476,-2002
2019,5,30,19,12380,12525,10364,-2161
2019,5,30,20,12650,12659,10304,-2355
2019,5,30,21,13000,12725,10615,-2110
2019,5,30,22,13470,12914,10435,-2479
2019,5,30,23,13330,13208,10841,-2367
2019,5,31,0,13470,13410,11151,-2259
2019,5,31,1,13540,13467,11014,-2453
2019,5,31,2,12940,12760,10187,-2573
2019,5,31,3,11740,11883,9187,-2696
2019,5,31,4,10620,10898,8598,-2300
2019,5,31,5,9900,9762,7702,-2060
2019,5,31,6,9390,9494,7070,-2424
2019,5,31,7,9200,9281,6882,-2399
2019,5,31,8,9180,9472,6989,-2483
2019,5,31,9,9450,9580,7201,-2379
2019,5,31,10,10180,10188,7773,-2415
2019,5,31,11,11600,11292,8705,-2587
2019,5,31,12,12510,12192,9738,-2454
2019,5,31,13,12630,12366,9987,-2379
2019,5,31,14,12310,12327,10207,-2120
2019,5,31,15,12290,12431,10287,-2144
2019,5,31,16,12310,12477,10456,-2021
2019,5,31,17,12360,12426,10967,-1459
2019,5,31,18,12410,12546,11040,-1506
2019,5,31,19,12730,12601,10795,-1806
2019,5,31,20,13030,12774,10948,-1826
2019,5,31,21,13490,13183,11635,-1548
2019,5,31,22,13780,13493,11740,-1753
2019,5,31,23,13800,13570,11184,-2386
2019,6,1,0,13770,13491,10877,-2614
2019,6,1,1,13820,13541,10909,-2632
2019,6,1,2,13190,13034,10704,-2330
2019,6,1,3,12050,11960,9896,-2064
2019,6,1,4,10890,10847,9037,-1810
2019,6,1,5,10140,10004,8048,-1956
2019,6,1,6,9600,9457,7450,-2007
2019,6,1,7,9270,9506,7210,-2296
2019,6,1,8,9150,9518,7379,-2139
2019,6,1,9,9110,9529,7448,-2081
2019,6,1,10,9260,9548,7488,-2060
2019,6,1,11,9770,10026,8014,-2012
2019,6,1,12,10330,10412,8227,-2185
2019,6,1,13,10650,10959,8733,-2226
2019,6,1,14,10900,10999,8734,-2265
2019,6,1,15,11040,10850,8849,-2001
2019,6,1,16,11000,10863,8779,-2084
2019,6,1,17,11200,10889,8847,-2042
2019,6,1,18,11280,11002,9259,-1743
2019,6,1,19,11340,11263,9561,-1702
2019,6,1,20,11690,11571,9793,-1778
2019,6,1,21,12230,11966,9898,-2068
2019,6,1,22,12700,12326,10217,-2109
2019,6,1,23,12930,12537,10340,-2197
2019,6,2,0,12970,12569,10034,-2535
2019,6,2,1,12980,12682,10269,-2413
2019,6,2,2,12570,12307,9939,-2368
2019,6,2,3,11740,11450,8903,-2547
2019,6,2,4,10790,10508,7940,-2568
2019,6,2,5,9740,9987,7752,-2235
2019,6,2,6,9220,9537,7359,-2178
2019,6,2,7,8930,9533,7357,-2176
2019,6,2,8,8820,9600,7141,-2459
2019,6,2,9,8810,9861,7344,-2517
2019,6,2,10,8890,9695,7478,-2217
2019,6,2,11,9230,9908,7556,-2352
2019,6,2,12,9720,10070,8035,-2035
2019,6,2,13,10390,10632,8547,-2085
2019,6,2,14,10760,10814,8972,-1842
2019,6,2,15,10890,10967,8907,-2060
2019,6,2,16,11120,10887,9195,-1692
2019,6,2,17,11250,10865,9166,-1699
2019,6,2,18,11410,10975,9496,-1479
2019,6,2,19,11570,11253,9791,-1462
2019,6,2,20,11930,11703,9874,-1829
2019,6,2,21,12500,12312,10059,-2253
2019,6,2,22,13140,13016,10736,-2280
2019,6,2,23,13390,13380,11087,-2293
2019,6,3,0,13350,13428,10876,-2552
2019,6,3,1,13300,13419,10840,-2579
2019,6,3,2,12760,12815,10306,-2509
2019,6,3,3,11710,11630,9048,-2582
2019,6,3,4,10670,10725,8316,-2409
2019,6,3,5,9710,10121,7506,-2615
2019,6,3,6,9230,10015,7124,-2891
2019,6,3,7,8970,10031,7163,-2868
2019,6,3,8,8890,10144,7396,-2748
2019,6,3,9,9160,10339,7570,-2769
2019,6,3,10,9840,10470,7751,-2719
2019,6,3,11,11180,11156,8619,-2537
2019,6,3,12,11930,11925,9293,-2632
2019,6,3,13,11810,11811,9291,-2520
2019,6,3,14,11600,11596,9149,-2447
2019,6,3,15,11510,11514,9204,-2310
2019,6,3,16,11500,11557,9297,-2260
2019,6,3,17,11460,11544,9407,-2137
2019,6,3,18,11590,11698,9447,-2251
2019,6,3,19,11780,11762,9414,-2348
2019,6,3,20,11970,11944,9528,-2416
2019,6,3,21,12510,12509,10069,-2440
2019,6,3,22,13080,13053,10570,-2483
2019,6,3,23,13400,13397,10893,-2504
2019,6,4,0,13450,13397,10894,-2503
2019,6,4,1,13440,13357,10789,-2568
2019,6,4,2,12660,12738,10191,-2547
2019,6,4,3,11450,11525,8763,-2762
2019,6,4,4,10310,10576,7714,-2862
2019,6,4,5,9520,10037,7496,-2541
2019,6,4,6,9080,9999,7453,-2546
2019,6,4,7,8880,9982,7433,-2549
2019,6,4,8,8860,10164,7525,-2639
2019,6,4,9,9120,10306,7699,-2607
2019,6,4,10,9840,10398,8046,-2352
2019,6,4,11,11150,11127,8689,-2438
2019,6,4,12,11800,11780,9217,-2563
2019,6,4,13,11630,11642,9499,-2143
2019,6,4,14,11410,11452,9549,-1903
2019,6,4,15,11310,11686,9986,-1700
2019,6,4,16,11400,12196,10413,-1783
2019,6,4,17,11440,12301,10557,-1744
2019,6,4,18,11660,12306,10638,-1668
2019,6,4,19,11880,12401,10828,-1573
2019,6,4,20,12200,12552,11097,-1455
2019,6,4,21,12760,12578,11022,-1556
2019,6,4,22,13250,13029,11517,-1512
2019,6,4,23,13520,13299,11490,-1809
2019,6,5,0,13470,13351,11437,-1914
2019,6,5,1,13430,13440,11372,-2068
2019,6,5,2,12760,12834,10795,-2039
2019,6,5,3,11500,11651,9329,-2322
2019,6,5,4,10350,10713,8322,-2391
2019,6,5,5,9680,10194,7818,-2376
2019,6,5,6,9270,10065,7777,-2288
2019,6,5,7,9050,9885,7508,-2377
2019,6,5,8,9000,9818,7482,-2336
2019,6,5,9,9280,10060,7561,-2499
2019,6,5,10,10050,10317,7793,-2524
2019,6,5,11,11470,11447,8943,-2504
2019,6,5,12,12420,12418,9858,-2560
2019,6,5,13,12690,12675,10236,-2439
2019,6,5,14,12870,12751,10779,-1972
2019,6,5,15,12970,12725,10685,-2040
2019,6,5,16,13080,12754,10468,-2286
2019,6,5,17,13210,12941,10660,-2281
2019,6,5,18,13410,13434,11188,-2246
2019,6,5,19,13720,13845,12015,-1830
2019,6,5,20,13910,14203,12595,-1608
2019,6,5,21,14400,14601,12512,-2089
2019,6,5,22,14700,15000,12758,-2242
2019,6,5,23,14850,14973,12748,-2225
2019,6,6,0,14790,14907,12737,-2170
2019,6,6,1,14750,14900,12734,-2166
2019,6,6,2,14240,14196,11740,-2456
2019,6,6,3,12920,12892,10208,-2684
2019,6,6,4,11530,11753,9101,-2652
2019,6,6,5,10840,11177,8584,-2593
2019,6,6,6,10350,10580,8562,-2018
2019,6,6,7,10100,10405,8598,-1807
2019,6,6,8,9970,10499,8442,-2057
2019,6,6,9,10220,10743,8697,-2046
2019,6,6,10,11060,11260,9107,-2153
2019,6,6,11,12590,12545,10402,-2143
2019,6,6,12,13560,13705,11647,-2058
2019,6,6,13,13890,14236,12161,-2075
2019,6,6,14,14130,14366,12300,-2066
2019,6,6,15,14220,14296,12628,-1668
2019,6,6,16,14260,14252,12474,-1778
2019,6,6,17,14410,14293,12518,-1775
2019,6,6,18,14690,14483,13012,-1471
2019,6,6,19,14790,14580,12713,-1867
2019,6,6,20,14890,14777,13023,-1754
2019,6,6,21,15030,15119,13977,-1142
2019,6,6,22,15220,15509,13887,-1622
2019,6,6,23,15210,15619,13329,-2290
2019,6,7,0,15150,15472,13483,-1989
2019,6,7,1,15030,15314,13349,-1965
2019,6,7,2,14250,14679,12496,-2183
2019,6,7,3,12890,13308,11038,-2270
2019,6,7,4,11600,11905,9689,-2216
2019,6,7,5,10580,10873,8850,-2023
2019,6,7,6,10090,10496,8703,-1793
2019,6,7,7,9780,10382,8266,-2116
2019,6,7,8,9670,10213,7936,-2277
2019,6,7,9,9840,10338,7978,-2360
2019,6,7,10,10540,10658,8502,-2156
2019,6,7,11,11930,11729,9355,-2374
2019,6,7,12,12800,12642,10314,-2328
2019,6,7,13,13140,12848,10740,-2108
2019,6,7,14,13110,12891,10892,-1999
2019,6,7,15,13150,13106,11554,-1552
2019,6,7,16,13150,13279,11771,-1508
2019,6,7,17,13250,13419,11925,-1494
2019,6,7,18,13440,13691,12288,-1403
2019,6,7,19,13770,14018,12858,-1160
2019,6,7,20,14210,14363,12802,-1561
2019,6,7,21,14580,14709,12904,-1805
2019,6,7,22,14850,14873,12874,-1999
2019,6,7,23,14770,14838,12698,-2140
2019,6,8,0,14550,14592,12425,-2167
2019,6,8,1,14470,14424,12361,-2063
2019,6,8,2,13880,13973,11832,-2141
2019,6,8,3,12790,12869,10607,-2262
2019,6,8,4,11430,11604,9312,-2292
2019,6,8,5,10600,10615,8349,-2266
2019,6,8,6,9950,9959,7977,-1982
2019,6,8,7,9560,9800,7838,-1962
2019,6,8,8,9350,9606,7522,-2084
2019,6,8,9,9330,9705,7676,-2029
2019,6,8,10,9510,9912,7880,-2032
2019,6,8,11,10000,9943,7897,-2046
2019,6,8,12,10560,10459,8176,-2283
2019,6,8,13,10830,10938,8787,-2151
2019,6,8,14,11120,11136,9127,-2009
2019,6,8,15,11130,11208,9737,-1471
2019,6,8,16,11190,11280,9840,-1440
2019,6,8,17,11290,11370,10095,-1275
2019,6,8,18,11300,11467,10073,-1394
2019,6,8,19,11640,11703,10061,-1642
2019,6,8,20,12210,12141,10467,-1674
2019,6,8,21,12860,12812,10986,-1826
2019,6,8,22,13420,13520,11576,-1944
2019,6,8,23,13560,13896,11492,-2404
2019,6,9,0,13470,13692,11097,-2595
2019,6,9,1,13390,13422,10835,-2587
2019,6,9,2,12960,13013,10482,-2531
2019,6,9,3,12040,12010,9255,-2755
2019,6,9,4,10970,10901,8216,-2685
2019,6,9,5,9950,10234,7530,-2704
2019,6,9,6,9430,10172,7652,-2520
2019,6,9,7,9060,9902,7643,-2259
2019,6,9,8,8930,9939,7592,-2347
2019,6,9,9,8890,9970,7583,-2387
2019,6,9,10,8880,9945,7543,-2402
2019,6,9,11,9180,9953,7786,-2167
2019,6,9,12,9510,9862,7383,-2479
2019,6,9,13,10060,10002,7799,-2203
2019,6,9,14,10230,10315,8091,-2224
2019,6,9,15,10360,10480,8512,-1968
2019,6,9,16,10510,10688,8815,-1873
2019,6,9,17,10730,10878,8945,-1933
2019,6,9,18,10930,11047,9166,-1881
2019,6,9,19,11410,11316,9573,-1743
2019,6,9,20,11950,11822,9859,-1963
2019,6,9,21,12720,12595,10365,-2230
2019,6,9,22,13320,13463,10859,-2604
2019,6,9,23,13650,13920,11335,-2585
2019,6,10,0,13590,13818,11198,-2620
2019,6,10,1,13490,13708,10976,-2732
2019,6,10,2,12980,13190,10397,-2793
2019,6,10,3,11840,11971,9083,-2888
2019,6,10,4,10710,10792,8184,-2608
2019,6,10,5,9880,10539,7917,-2622
2019,6,10,6,9450,10416,7906,-2510
2019,6,10,7,9180,10269,7627,-2642
2019,6,10,8,9140,10335,7675,-2660
2019,6,10,9,9400,10339,7708,-2631
2019,6,10,10,10080,10615,8214,-2401
2019,6,10,11,11490,11320,8848,-2472
2019,6,10,12,12440,12266,9729,-2537
2019,6,10,13,12610,12483,10076,-2407
2019,6,10,14,12650,12651,10429,-2222
2019,6,10,15,12800,12892,10848,-2044
2019,6,10,16,13040,13139,11046,-2093
2019,6,10,17,13300,13352,11202,-2150
2019,6,10,18,13560,13662,11316,-2346
2019,6,10,19,13890,14033,11543,-2490
2019,6,10,20,14160,14537,12107,-2430
2019,6,10,21,14540,14930,12719,-2211
2019,6,10,22,14800,15401,12680,-2721
2019,6,10,23,14820,15548,12791,-2757
2019,6,11,0,14790,15364,12554,-2810
2019,6,11,1,14650,15244,12566,-2678
2019,6,11,2,13910,14525,11922,-2603
2019,6,11,3,12610,13180,10197,-2983
2019,6,11,4,11370,11961,9125,-2836
2019,6,11,5,11020,11342,8452,-2890
2019,6,11,6,10550,10943,8113,-2830
2019,6,11,7,10330,11115,8235,-2880
2019,6,11,8,10250,11058,8289,-2769
2019,6,11,9,10500,11047,8266,-2781
2019,6,11,10,11360,11612,9105,-2507
2019,6,11,11,12870,12839,10541,-2298
2019,6,11,12,14070,14058,11493,-2565
2019,6,11,13,14480,14533,11998,-2535
2019,6,11,14,14780,14792,12195,-2597
2019,6,11,15,14780,14916,12340,-2576
2019,6,11,16,14640,14490,11967,-2523
2019,6,11,17,14350,14077,11409,-2668
2019,6,11,18,14300,14251,11687,-2564
2019,6,11,19,14380,14192,11534,-2658
2019,6,11,20,14640,14199,11577,-2622
2019,6,11,21,15050,14576,11943,-2633
2019,6,11,22,15220,14834,12209,-2625
2019,6,11,23,15350,15084,12659,-2425
2019,6,12,0,14970,14854,12280,-2574
2019,6,12,1,14740,14528,12273,-2255
2019,6,12,2,13990,13877,11553,-2324
2019,6,12,3,12630,12535,10069,-2466
2019,6,12,4,11290,11207,8865,-2342
2019,6,12,5,10420,10761,8322,-2439
2019,6,12,6,9880,10667,8039,-2628
2019,6,12,7,9550,10678,7863,-2815
2019,6,12,8,9410,10851,7846,-3005
2019,6,12,9,9630,11034,8093,-2941
2019,6,12,10,10280,11629,8657,-2972
2019,6,12,11,11590,12062,9301,-2761
2019,6,12,12,12400,12272,9613,-2659
2019,6,12,13,12450,12535,9745,-2790
2019,6,12,14,12300,12511,9941,-2570
2019,6,12,15,12420,12520,9833,-2687
2019,6,12,16,12540,12401,10171,-2230
2019,6,12,17,12740,12550,10281,-2269
2019,6,12,18,13070,12830,10271,-2559
2019,6,12,19,13460,13014,10330,-2684
2019,6,12,20,13870,13392,10538,-2854
2019,6,12,21,14400,13964,11024,-2940
2019,6,12,22,14870,14481,11558,-2923
2019,6,12,23,14950,14708,11897,-2811
2019,6,13,0,14690,14518,11503,-3015
2019,6,13,1,14480,14227,11345,-2882
2019,6,13,2,13700,13624,10811,-2813
2019,6,13,3,12170,12347,9662,-2685
2019,6,13,4,10860,11142,8649,-2493
2019,6,13,5,10150,10361,7866,-2495
2019,6,13,6,9610,9608,7311,-2297
2019,6,13,7,9300,9408,7306,-2102
2019,6,13,8,9210,9453,7368,-2085
2019,6,13,9,9440,9657,7452,-2205
2019,6,13,10,10160,10138,7900,-2238
2019,6,13,11,11530,11493,9532,-1961
2019,6,13,12,12610,12587,10621,-1966
2019,6,13,13,13030,13023,11068,-1955
2019,6,13,14,13310,13280,11360,-1920
2019,6,13,15,13430,13507,11718,-1789
2019,6,13,16,13590,13656,11631,-2025
2019,6,13,17,13550,13623,11345,-2278
2019,6,13,18,13590,13441,11221,-2220
2019,6,13,19,13470,13212,11020,-2192
2019,6,13,20,13500,13160,11118,-2042
2019,6,13,21,13640,13264,11372,-1892
2019,6,13,22,13750,13486,11490,-1996
2019,6,13,23,13720,13504,11482,-2022
2019,6,14,0,13730,13334,11188,-2146
2019,6,14,1,13740,13242,11231,-2011
2019,6,14,2,13100,12691,10561,-2130
2019,6,14,3,11960,11579,9038,-2541
2019,6,14,4,10810,10503,7942,-2561
2019,6,14,5,9730,9747,6936,-2811
2019,6,14,6,9290,9390,6886,-2504
2019,6,14,7,9060,9432,6916,-2516
2019,6,14,8,9000,9659,6991,-2668
2019,6,14,9,9270,9734,6924,-2810
2019,6,14,10,10020,10090,7130,-2960
2019,6,14,11,11250,11400,8113,-3287
2019,6,14,12,12130,12120,8935,-3185
2019,6,14,13,12270,12277,9269,-3008
2019,6,14,14,12150,12172,9453,-2719
2019,6,14,15,12120,12454,10008,-2446
2019,6,14,16,12230,12753,10381,-2372
2019,6,14,17,12550,12915,10632,-2283
2019,6,14,18,12790,12909,10523,-2386
2019,6,14,19,12960,12843,10525,-2318
2019,6,14,20,13110,12874,10409,-2465
2019,6,14,21,13340,13095,10473,-2622
2019,6,14,22,13700,13215,10798,-2417
2019,6,14,23,13580,13176,10926,-2250
2019,6,15,0,13380,13071,10731,-2340
2019,6,15,1,13210,13023,10818,-2205
2019,6,15,2,12770,12681,10546,-2135
2019,6,15,3,11710,11697,9322,-2375
2019,6,15,4,10650,10619,8102,-2517
2019,6,15,5,9800,9811,7548,-2263
2019,6,15,6,9290,9558,7397,-2161
2019,6,15,7,9010,9594,7419,-2175
2019,6,15,8,8890,9588,7331,-2257
2019,6,15,9,8930,9717,7323,-2394
2019,6,15,10,9070,9839,7265,-2574
2019,6,15,11,9590,10118,7473,-2645
2019,6,15,12,10180,10349,7849,-2500
2019,6,15,13,10730,10729,8647,-2082
2019,6,15,14,11060,10899,8845,-2054
2019,6,15,15,11130,11012,9004,-2008
2019,6,15,16,11290,10974,9115,-1859
2019,6,15,17,11290,10956,8934,-2022
2019,6,15,18,11390,11250,9211,-2039
2019,6,15,19,11770,11671,9624,-2047
2019,6,15,20,12320,12137,10214,-1923
2019,6,15,21,13000,12632,10644,-1988
2019,6,15,22,13440,13007,10623,-2384
2019,6,15,23,13590,13337,10966,-2371
2019,6,16,0,13470,13286,10830,-2456
2019,6,16,1,13380,13295,10564,-2731
2019,6,16,2,13050,12981,10674,-2307
2019,6,16,3,12090,12137,9722,-2415
2019,6,16,4,11050,11182,8534,-2648
2019,6,16,5,10380,10398,8287,-2111
2019,6,16,6,9890,10101,7782,-2319
2019,6,16,7,9570,9679,7260,-2419
2019,6,16,8,9390,9389,7038,-2351
2019,6,16,9,9350,9349,7057,-2292
2019,6,16,10,9430,9427,7161,-2266
2019,6,16,11,9760,9746,7642,-2104
2019,6,16,12,10350,10329,7968,-2361
2019,6,16,13,11120,11106,8629,-2477
2019,6,16,14,11930,11853,9343,-2510
2019,6,16,15,12370,12455,10027,-2428
2019,6,16,16,12840,12691,10588,-2103
2019,6,16,17,13190,12872,10887,-1985
2019,6,16,18,13520,12834,10951,-1883
2019,6,16,19,13590,12963,11069,-1894
2019,6,16,20,13860,13027,11093,-1934
2019,6,16,21,14020,13245,10970,-2275
2019,6,16,22,14410,13517,11164,-2353
2019,6,16,23,14460,13635,11262,-2373
2019,6,17,0,14190,13617,11227,-2390
2019,6,17,1,14080,13616,11347,-2269
2019,6,17,2,13520,13156,10887,-2269
2019,6,17,3,12440,12147,9484,-2663
2019,6,17,4,11280,11115,8540,-2575
2019,6,17,5,10490,10394,7940,-2454
2019,6,17,6,9950,10400,7935,-2465
2019,6,17,7,9710,10419,7754,-2665
2019,6,17,8,9640,10426,7639,-2787
2019,6,17,9,9860,10663,7842,-2821
2019,6,17,10,10560,11020,8244,-2776
2019,6,17,11,11960,11965,9064,-2901
2019,6,17,12,12870,12929,10330,-2599
2019,6,17,13,13140,13198,10418,-2780
2019,6,17,14,13340,13297,10808,-2489
2019,6,17,15,13410,13574,11404,-2170
2019,6,17,16,13640,14003,12149,-1854
2019,6,17,17,13820,14186,12429,-1757
2019,6,17,18,14210,14387,12667,-1720
2019,6,17,19,14640,14515,12600,-1915
2019,6,17,20,14970,14620,12647,-1973
2019,6,17,21,15450,14883,12990,-1893
2019,6,17,22,15900,15334,13121,-2213
2019,6,17,23,16010,15608,13387,-2221
2019,6,18,0,15760,15494,13014,-2480
2019,6,18,1,15440,15315,12788,-2527
2019,6,18,2,14670,14780,12254,-2526
2019,6,18,3,13260,13412,10652,-2760
2019,6,18,4,11920,12074,9212,-2862
2019,6,18,5,10820,11089,8142,-2947
2019,6,18,6,10310,10773,8008,-2765
2019,6,18,7,10000,10476,8019,-2457
2019,6,18,8,10070,10351,7854,-2497
2019,6,18,9,10240,10541,7992,-2549
2019,6,18,10,11160,11211,8446,-2765
2019,6,18,11,12450,12239,9059,-3180
2019,6,18,12,13550,13291,10220,-3071
2019,6,18,13,14000,13922,11007,-2915
2019,6,18,14,14390,14291,11587,-2704
2019,6,18,15,14720,14495,11778,-2717
2019,6,18,16,14880,14701,12013,-2688
2019,6,18,17,14830,14929,12167,-2762
2019,6,18,18,14880,15047,12434,-2613
2019,6,18,19,14960,14876,12485,-2391
2019,6,18,20,15170,14766,12590,-2176
2019,6,18,21,15330,14849,12609,-2240
2019,6,18,22,15600,14975,12649,-2326
2019,6,18,23,15640,14935,12693,-2242
2019,6,19,0,15330,14776,12404,-2372
2019,6,19,1,15070,14589,12020,-2569
2019,6,19,2,14380,14012,11430,-2582
2019,6,19,3,13070,12831,10047,-2784
2019,6,19,4,11770,11632,8704,-2928
2019,6,19,5,10900,10790,7873,-2917
2019,6,19,6,10350,10381,7736,-2645
2019,6,19,7,10060,10240,7533,-2707
2019,6,19,8,9980,10150,7402,-2748
2019,6,19,9,10190,10378,7572,-2806
2019,6,19,10,10940,11093,8070,-3023
2019,6,19,11,12310,12156,9327,-2829
2019,6,19,12,13490,13170,10381,-2789
2019,6,19,13,13920,13763,11309,-2454
2019,6,19,14,14120,14130,11853,-2277
2019,6,19,15,14300,14441,12125,-2316
2019,6,19,16,14460,14596,12355,-2241
2019,6,19,17,14520,14616,11966,-2650
2019,6,19,18,14560,14814,12167,-2647
2019,6,19,19,14860,14957,12459,-2498
2019,6,19,20,14990,15080,12718,-2362
2019,6,19,21,15410,15356,12981,-2375
2019,6,19,22,15700,15483,12735,-2748
2019,6,19,23,15860,15399,12583,-2816
2019,6,20,0,15560,15270,12532,-2738
2019,6,20,1,15380,15189,12280,-2909
2019,6,20,2,14680,14631,11821,-2810
2019,6,20,3,13330,13454,10495,-2959
2019,6,20,4,11970,12212,9339,-2873
2019,6,20,5,11280,11155,8618,-2537
2019,6,20,6,10750,10693,8385,-2308
2019,6,20,7,10440,10778,8416,-2362
2019,6,20,8,10490,10972,8554,-2418
2019,6,20,9,10650,11085,8400,-2685
2019,6,20,10,11260,11360,8699,-2661
2019,6,20,11,12640,12435,9457,-2978
2019,6,20,12,13690,13480,10727,-2753
2019,6,20,13,14170,14187,11453,-2734
2019,6,20,14,14650,14667,11909,-2758
2019,6,20,15,14890,14984,12323,-2661
2019,6,20,16,15060,15162,12531,-2631
2019,6,20,17,15150,15208,12378,-2830
2019,6,20,18,15310,15284,12379,-2905
2019,6,20,19,15360,15199,12475,-2724
2019,6,20,20,15380,15147,12863,-2284
2019,6,20,21,15500,15312,12905,-2407
2019,6,20,22,15700,15434,13061,-2373
2019,6,20,23,15560,15447,13056,-2391
2019,6,21,0,15410,15354,12850,-2504
2019,6,21,1,15200,15224,12566,-2658
2019,6,21,2,14670,14663,12165,-2498
2019,6,21,3,13490,13509,10619,-2890
2019,6,21,4,12230,12330,9413,-2917
2019,6,21,5,11530,11862,8840,-3022
2019,6,21,6,10970,11773,8879,-2894
2019,6,21,7,10590,11570,8960,-2610
2019,6,21,8,10430,11615,8998,-2617
2019,6,21,9,10520,11676,9086,-2590
2019,6,21,10,11150,11831,9095,-2736
2019,6,21,11,12350,12489,9798,-2691
2019,6,21,12,13430,13249,10252,-2997
2019,6,21,13,13990,13865,10969,-2896
2019,6,21,14,14260,14278,11445,-2833
2019,6,21,15,14420,14410,11486,-2924
2019,6,21,16,14410,14361,11424,-2937
2019,6,21,17,14420,14312,11481,-2831
2019,6,21,18,14430,14382,11286,-3096
2019,6,21,19,14540,14322,11474,-2848
2019,6,21,20,14570,14290,11640,-2650
2019,6,21,21,14730,14303,12026,-2277
2019,6,21,22,14810,14308,11868,-2440
2019,6,21,23,14720,14205,11413,-2792
2019,6,22,0,14440,14011,11186,-2825
2019,6,22,1,14190,13914,10914,-3000
2019,6,22,2,13680,13548,10283,-3265
2019,6,22,3,12610,12521,9456,-3065
2019,6,22,4,11470,11367,8412,-2955
2019,6,22,5,10550,10920,7958,-2962
2019,6,22,6,9940,10393,7462,-2931
2019,6,22,7,9580,10235,7461,-2774
2019,6,22,8,9380,10353,7487,-2866
2019,6,22,9,9380,10373,7441,-2932
2019,6,22,10,9490,10498,7414,-3084
2019,6,22,11,9960,11021,7981,-3040
2019,6,22,12,10450,10439,7959,-2480
2019,6,22,13,10900,10894,8596,-2298
2019,6,22,14,11190,11191,8556,-2635
2019,6,22,15,11350,11361,8274,-3087
2019,6,22,16,11570,11496,8651,-2845
2019,6,22,17,11740,11801,8902,-2899
2019,6,22,18,11900,12234,9587,-2647
2019,6,22,19,12120,12381,9895,-2486
2019,6,22,20,12430,12567,10224,-2343
2019,6,22,21,12860,12647,10122,-2525
2019,6,22,22,13290,13171,10528,-2643
2019,6,22,23,13460,13491,10565,-2926
2019,6,23,0,13290,13350,10441,-2909
2019,6,23,1,13270,13244,10529,-2715
2019,6,23,2,12880,12980,10668,-2312
2019,6,23,3,11950,12099,9449,-2650
2019,6,23,4,10970,11082,8134,-2948
2019,6,23,5,10240,10309,7055,-3254
2019,6,23,6,9690,9958,6856,-3102
2019,6,23,7,9340,9601,6523,-3078
2019,6,23,8,9130,9386,6523,-2863
2019,6,23,9,9100,9591,6818,-2773
2019,6,23,10,9110,9493,6431,-3062
2019,6,23,11,9340,9600,6551,-3049
2019,6,23,12,9680,9775,7283,-2492
2019,6,23,13,10380,10255,7967,-2288
2019,6,23,14,10640,10628,8259,-2369
2019,6,23,15,10760,10942,8659,-2283
2019,6,23,16,11060,11265,9041,-2224
2019,6,23,17,11550,11568,8868,-2700
2019,6,23,18,11840,11892,9225,-2667
2019,6,23,19,12230,12310,9676,-2634
2019,6,23,20,12840,13007,10676,-2331
2019,6,23,21,13560,13926,11725,-2201
2019,6,23,22,14300,14859,12245,-2614
2019,6,23,23,14560,15383,12691,-2692
2019,6,24,0,14500,15341,12417,-2924
2019,6,24,1,14370,15095,12225,-2870
2019,6,24,2,13780,14692,11950,-2742
2019,6,24,3,12620,13514,10449,-3065
2019,6,24,4,11450,12189,8904,-3285
2019,6,24,5,11290,11175,7983,-3192
2019,6,24,6,10640,10743,7576,-3167
2019,6,24,7,10230,10571,7564,-3007
2019,6,24,8,10090,10486,7427,-3059
2019,6,24,9,10220,10624,7465,-3159
2019,6,24,10,10910,11164,8024,-3140
2019,6,24,11,12190,12054,8861,-3193
2019,6,24,12,13210,12921,9921,-3000
2019,6,24,13,13660,13448,10734,-2714
2019,6,24,14,13970,13781,11175,-2606
2019,6,24,15,14140,14179,11863,-2316
2019,6,24,16,14550,14582,12342,-2240
2019,6,24,17,14800,14927,12753,-2174
2019,6,24,18,15210,15442,13476,-1966
2019,6,24,19,15920,15912,13641,-2271
2019,6,24,20,16390,16402,14087,-2315
2019,6,24,21,16650,16791,14329,-2462
2019,6,24,22,16940,17112,14449,-2663
2019,6,24,23,16900,17050,14118,-2932
2019,6,25,0,16520,16636,13467,-3169
2019,6,25,1,16150,16336,13248,-3088
2019,6,25,2,15440,15624,12756,-2868
2019,6,25,3,13980,14138,11111,-3027
2019,6,25,4,12590,12681,9620,-3061
2019,6,25,5,11770,11792,8587,-3205
2019,6,25,6,11120,11435,8645,-2790
2019,6,25,7,10750,11138,8523,-2615
2019,6,25,8,10230,11374,8610,-2764
2019,6,25,9,10410,11438,8629,-2809
2019,6,25,10,11140,11581,9036,-2545
2019,6,25,11,12530,12624,9992,-2632
2019,6,25,12,13780,14027,11301,-2726
2019,6,25,13,14380,14811,12295,-2516
2019,6,25,14,14910,15228,12886,-2342
2019,6,25,15,15350,15586,13230,-2356
2019,6,25,16,15740,15826,13333,-2493
2019,6,25,17,15860,15957,13541,-2416
2019,6,25,18,16130,16079,13736,-2343
2019,6,25,19,16200,15926,13591,-2335
2019,6,25,20,16350,15704,13592,-2112
2019,6,25,21,16480,15692,13724,-1968
2019,6,25,22,16650,15907,14009,-1898
2019,6,25,23,16590,15909,14133,-1776
2019,6,26,0,16230,15700,13801,-1899
2019,6,26,1,15940,15506,13449,-2057
2019,6,26,2,15300,14955,12492,-2463
2019,6,26,3,14030,13760,11239,-2521
2019,6,26,4,12660,12521,10188,-2333
2019,6,26,5,11660,11907,9062,-2845
2019,6,26,6,11120,11877,9042,-2835
2019,6,26,7,10790,11853,8914,-2939
2019,6,26,8,10660,11734,8709,-3025
2019,6,26,9,10860,11922,8885,-3037
2019,6,26,10,11510,12292,9452,-2840
2019,6,26,11,12840,13164,10239,-2925
2019,6,26,12,14000,13987,11046,-2941
2019,6,26,13,14540,14533,11782,-2751
2019,6,26,14,14850,14834,12276,-2558
2019,6,26,15,15170,15164,13132,-2032
2019,6,26,16,15500,15499,13249,-2250
2019,6,26,17,15710,15700,13705,-1995
2019,6,26,18,16160,16152,14518,-1634
2019,6,26,19,16570,16574,14947,-1627
2019,6,26,20,17080,17070,15427,-1643
2019,6,26,21,17640,17626,16157,-1469
2019,6,26,22,18110,18089,16212,-1877
2019,6,26,23,17690,18114,16244,-1870
2019,6,27,0,17230,17706,15852,-1854
2019,6,27,1,16860,17215,15263,-1952
2019,6,27,2,16030,16452,14328,-2124
2019,6,27,3,14410,15106,12398,-2708
2019,6,27,4,12930,13518,10956,-2562
2019,6,27,5,12250,12278,9491,-2787
2019,6,27,6,11510,11622,9120,-2502
2019,6,27,7,11060,11354,8890,-2464
2019,6,27,8,10820,11102,8595,-2507
2019,6,27,9,10930,11448,8861,-2587
2019,6,27,10,11520,11831,9087,-2744
2019,6,27,11,12740,12983,9819,-3164
2019,6,27,12,13860,13847,11224,-2623
2019,6,27,13,14400,14406,12282,-2124
2019,6,27,14,14740,14739,12865,-1874
2019,6,27,15,15070,15226,13766,-1460
2019,6,27,16,15300,15765,14711,-1054
2019,6,27,17,15880,16255,15362,-893
2019,6,27,18,16200,16857,15697,-1160
2019,6,27,19,16870,17310,16122,-1188
2019,6,27,20,17690,17672,16501,-1171
2019,6,27,21,18120,18046,16887,-1159
2019,6,27,22,18330,18445,17082,-1363
2019,6,27,23,18500,18453,16787,-1666
2019,6,28,0,17670,18078,16294,-1784
2019,6,28,1,17210,17538,15802,-1736
2019,6,28,2,16340,16800,14843,-1957
2019,6,28,3,14900,15276,12543,-2733
2019,6,28,4,13230,13695,10764,-2931
2019,6,28,5,12470,12783,9874,-2909
2019,6,28,6,11690,12249,9378,-2871
2019,6,28,7,11170,11986,8920,-3066
2019,6,28,8,10930,12022,9013,-3009
2019,6,28,9,10990,12047,8753,-3294
2019,6,28,10,11470,12217,8897,-3320
2019,6,28,11,12660,12929,9626,-3303
2019,6,28,12,13810,14032,10860,-3172
2019,6,28,13,14480,14670,12024,-2646
2019,6,28,14,15120,15045,13251,-1794
2019,6,28,15,15630,15686,14066,-1620
2019,6,28,16,16260,16299,14881,-1418
2019,6,28,17,16880,16837,15536,-1301
2019,6,28,18,17530,17513,16269,-1244
2019,6,28,19,18240,18068,16793,-1275
2019,6,28,20,18460,18543,17604,-939
2019,6,28,21,18480,18998,17939,-1059
2019,6,28,22,19000,19408,17944,-1464
2019,6,28,23,18580,19323,17447,-1876
2019,6,29,0,18090,18847,16468,-2379
2019,6,29,1,17670,18140,15771,-2369
2019,6,29,2,16970,17416,15299,-2117
2019,6,29,3,15820,16000,13707,-2293
2019,6,29,4,14280,14506,11708,-2798
2019,6,29,5,13290,13561,11070,-2491
2019,6,29,6,12470,12753,10298,-2455
2019,6,29,7,11950,12374,9751,-2623
2019,6,29,8,11630,12469,9769,-2700
2019,6,29,9,11540,12217,9873,-2344
2019,6,29,10,11660,12247,9865,-2382
2019,6,29,11,12100,12490,10126,-2364
2019,6,29,12,12870,13127,11079,-2048
2019,6,29,13,13760,13903,12065,-1838
2019,6,29,14,14570,14551,12762,-1789
2019,6,29,15,15370,15183,13465,-1718
2019,6,29,16,16010,15624,13968,-1656
2019,6,29,17,16440,16021,14552,-1469
2019,6,29,18,16630,16613,15177,-1436
2019,6,29,19,16860,16868,15854,-1014
2019,6,29,20,17260,17041,15826,-1215
2019,6,29,21,17470,17062,16217,-845
2019,6,29,22,17750,17231,15947,-1284
2019,6,29,23,17500,17411,15507,-1904
2019,6,30,0,17150,17212,14954,-2258
2019,6,30,1,16830,16857,14636,-2221
2019,6,30,2,16360,16410,13962,-2448
2019,6,30,3,15260,15446,12586,-2860
2019,6,30,4,13950,14205,10851,-3354
2019,6,30,5,12930,13110,10563,-2547
2019,6,30,6,12160,12681,10273,-2408
2019,6,30,7,11570,12363,9387,-2976
2019,6,30,8,11170,12264,9357,-2907
2019,6,30,9,10950,12032,9204,-2828
2019,6,30,10,10810,11901,9062,-2839
2019,6,30,11,11110,11858,9282,-2576
2019,6,30,12,11690,12024,9463,-2561
2019,6,30,13,12500,12717,10656,-2061
2019,6,30,14,13350,13335,11510,-1825
2019,6,30,15,13840,13985,12435,-1550
2019,6,30,16,14160,14155,12192,-1963
2019,6,30,17,14420,13972,11875,-2097
2019,6,30,18,14490,14153,12055,-2098
2019,6,30,19,14420,14426,12296,-2130
2019,6,30,20,14460,14201,11944,-2257
2019,6,30,21,14690,14229,11849,-2380
2019,6,30,22,15030,14706,12616,-2090
2019,6,30,23,15250,14958,12857,-2101
2019,7,1,0,15110,14723,12768,-1955
2019,7,1,1,14870,14522,12279,-2243
2019,7,1,2,14360,14181,11637,-2544
2019,7,1,3,13240,13139,10514,-2625
2019,7,1,4,12070,12021,8720,-3301
2019,7,1,5,11350,11479,8268,-3211
2019,7,1,6,10730,11404,8279,-3125
2019,7,1,7,10330,11427,8302,-3125
2019,7,1,8,10190,11562,8215,-3347
2019,7,1,9,10370,11634,8522,-3112
2019,7,1,10,10990,11770,8442,-3328
2019,7,1,11,12210,12642,9137,-3505
2019,7,1,12,13270,13306,10073,-3233
2019,7,1,13,13770,13822,10645,-3177
2019,7,1,14,14010,14033,11125,-2908
2019,7,1,15,14350,14213,11674,-2539
2019,7,1,16,14890,14666,12373,-2293
2019,7,1,17,15490,15121,13232,-1889
2019,7,1,18,15730,15661,13627,-2034
2019,7,1,19,16020,16215,13933,-2282
2019,7,1,20,16600,16801,14664,-2137
2019,7,1,21,16930,17381,15539,-1842
2019,7,1,22,17630,18028,15945,-2083
2019,7,1,23,17800,18272,15732,-2540
2019,7,2,0,17580,17918,15207,-2711
2019,7,2,1,17070,17400,14761,-2639
2019,7,2,2,16230,16700,13960,-2740
2019,7,2,3,14790,15190,12156,-3034
2019,7,2,4,13300,13623,10816,-2807
2019,7,2,5,12490,12601,9405,-3196
2019,7,2,6,11800,12114,8981,-3133
2019,7,2,7,11350,11832,8753,-3079
2019,7,2,8,11140,11780,8787,-2993
2019,7,2,9,11170,11949,8846,-3103
2019,7,2,10,11760,12288,9083,-3205
2019,7,2,11,12960,13085,10142,-2943
2019,7,2,12,14120,13943,11276,-2667
2019,7,2,13,14700,14908,12269,-2639
2019,7,2,14,15140,15196,12920,-2276
2019,7,2,15,15670,15658,13813,-1845
2019,7,2,16,16110,16104,14446,-1658
2019,7,2,17,16370,16366,14737,-1629
2019,7,2,18,16650,16664,14756,-1908
2019,7,2,19,16660,16646,14852,-1794
2019,7,2,20,17540,17086,15213,-1873
2019,7,2,21,18120,17916,16337,-1579
2019,7,2,22,18960,18699,16819,-1880
2019,7,2,23,19120,18890,16707,-2183
2019,7,3,0,18670,18422,16335,-2087
2019,7,3,1,18230,18020,15669,-2351
2019,7,3,2,17470,17371,15239,-2132
2019,7,3,3,15880,15874,13501,-2373
2019,7,3,4,14270,14311,11704,-2607
2019,7,3,5,13060,13114,10397,-2717
2019,7,3,6,12270,12769,10146,-2623
2019,7,3,7,11740,12531,9786,-2745
2019,7,3,8,11460,12504,9842,-2662
2019,7,3,9,11500,12551,9974,-2577
2019,7,3,10,12140,13029,10524,-2505
2019,7,3,11,13510,14025,11163,-2862
2019,7,3,12,14880,15106,12250,-2856
2019,7,3,13,15560,15525,13055,-2470
2019,7,3,14,16160,16052,13917,-2135
2019,7,3,15,16790,16758,14727,-2031
2019,7,3,16,17460,17392,15286,-2106
2019,7,3,17,18100,17973,15755,-2218
2019,7,3,18,18550,18612,16398,-2214
2019,7,3,19,19210,19046,16823,-2223
2019,7,3,20,19700,19441,17513,-1928
2019,7,3,21,20160,19911,18009,-1902
2019,7,3,22,20480,20294,18217,-2077
2019,7,3,23,20310,20141,17849,-2292
2019,7,4,0,20020,19495,16824,-2671
2019,7,4,1,19620,18706,16079,-2627
2019,7,4,2,18630,17876,15451,-2425
2019,7,4,3,16990,16475,13706,-2769
2019,7,4,4,15370,14979,12132,-2847
2019,7,4,5,13420,13648,11214,-2434
2019,7,4,6,12550,12986,10499,-2487
2019,7,4,7,11970,12930,10367,-2563
2019,7,4,8,11580,12763,10208,-2555
2019,7,4,9,11570,12779,10239,-2540
2019,7,4,10,11550,12912,10292,-2620
2019,7,4,11,12160,13378,10709,-2669
2019,7,4,12,12900,13756,11381,-2375
2019,7,4,13,13680,14179,11966,-2213
2019,7,4,14,14850,14662,13097,-1565
2019,7,4,15,15630,15517,14093,-1424
2019,7,4,16,16250,16298,14817,-1481
2019,7,4,17,16830,16912,15446,-1466
2019,7,4,18,17390,17355,16006,-1349
2019,7,4,19,17860,17677,16160,-1517
2019,7,4,20,18420,18113,16151,-1962
2019,7,4,21,18940,18484,16771,-1713
2019,7,4,22,19310,18697,16851,-1846
2019,7,4,23,19080,18521,16606,-1915
2019,7,5,0,18480,18029,15902,-2127
2019,7,5,1,17890,17418,15301,-2117
2019,7,5,2,17090,16733,14845,-1888
2019,7,5,3,15970,15776,13651,-2125
2019,7,5,4,14690,14615,12127,-2488
2019,7,5,5,13370,13666,10683,-2983
2019,7,5,6,12430,13226,10185,-3041
2019,7,5,7,11860,12887,10018,-2869
2019,7,5,8,11600,12965,10107,-2858
2019,7,5,9,11650,12830,10074,-2756
2019,7,5,10,11990,12640,9776,-2864
2019,7,5,11,12920,13234,10320,-2914
2019,7,5,12,13910,14003,11553,-2450
2019,7,5,13,15150,14839,12779,-2060
2019,7,5,14,15790,15564,13321,-2243
2019,7,5,15,16550,16421,14379,-2042
2019,7,5,16,17170,17164,15112,-2052
2019,7,5,17,17620,17782,15448,-2334
2019,7,5,18,18250,18359,16161,-2198
2019,7,5,19,18550,18884,16831,-2053
2019,7,5,20,18850,19431,17348,-2083
2019,7,5,21,19300,19998,17786,-2212
2019,7,5,22,19650,20365,17966,-2399
2019,7,5,23,19350,20204,17194,-3010
2019,7,6,0,18790,19539,16049,-3490
2019,7,6,1,18170,18912,15835,-3077
2019,7,6,2,17520,18248,15100,-3148
2019,7,6,3,16360,16956,13766,-3190
2019,7,6,4,15080,15576,12978,-2598
2019,7,6,5,14630,14640,11994,-2646
2019,7,6,6,13760,13957,11226,-2731
2019,7,6,7,13280,13529,10965,-2564
2019,7,6,8,12900,13761,10847,-2914
2019,7,6,9,12850,13921,11072,-2849
2019,7,6,10,13000,14018,11094,-2924
2019,7,6,11,13420,14437,11661,-2776
2019,7,6,12,14480,14924,12669,-2255
2019,7,6,13,15670,15790,13843,-1947
2019,7,6,14,16820,16858,14943,-1915
2019,7,6,15,17590,17829,15436,-2393
2019,7,6,16,18220,18628,16405,-2223
2019,7,6,17,18630,19259,16760,-2499
2019,7,6,18,19150,19720,17129,-2591
2019,7,6,19,19550,20046,17188,-2858
2019,7,6,20,19980,20426,17565,-2861
2019,7,6,21,20070,20397,17432,-2965
2019,7,6,22,19920,19984,16799,-3185
2019,7,6,23,19330,19321,16144,-3177
2019,7,7,0,18600,18668,15460,-3208
2019,7,7,1,18220,18212,15149,-3063
2019,7,7,2,17670,17564,14826,-2738
2019,7,7,3,16600,16469,13717,-2752
2019,7,7,4,15230,15145,12869,-2276
2019,7,7,5,14020,14054,11430,-2624
2019,7,7,6,13280,13518,10776,-2742
2019,7,7,7,12760,13300,10354,-2946
2019,7,7,8,12420,13444,10234,-3210
2019,7,7,9,12210,13297,10125,-3172
2019,7,7,10,12020,13108,9811,-3297
2019,7,7,11,12060,13264,10127,-3137
2019,7,7,12,12320,13648,10833,-2815
2019,7,7,13,12730,13832,11196,-2636
2019,7,7,14,13120,13606,11079,-2527
2019,7,7,15,13480,13725,11426,-2299
2019,7,7,16,13710,13898,11656,-2242
2019,7,7,17,14020,13935,11989,-1946
2019,7,7,18,14250,14239,12337,-1902
2019,7,7,19,14520,14571,12522,-2049
2019,7,7,20,14960,15102,13078,-2024
2019,7,7,21,15550,15903,14325,-1578
2019,7,7,22,16150,16721,14661,-2060
2019,7,7,23,16520,17112,14711,-2401
2019,7,8,0,16020,16788,14246,-2542
2019,7,8,1,15480,16294,14105,-2189
2019,7,8,2,14750,15699,13582,-2117
2019,7,8,3,13410,14570,12169,-2401
2019,7,8,4,12150,13264,10681,-2583
2019,7,8,5,11710,12196,9601,-2595
2019,7,8,6,11080,11646,9110,-2536
2019,7,8,7,10750,11593,8982,-2611
2019,7,8,8,10590,11677,8986,-2691
2019,7,8,9,10760,11561,9144,-2417
2019,7,8,10,11350,11636,9221,-2415
2019,7,8,11,12520,12464,10165,-2299
2019,7,8,12,13410,13458,11243,-2215
2019,7,8,13,13860,13964,11820,-2144
2019,7,8,14,14470,14326,12323,-2003
2019,7,8,15,14780,14664,12903,-1761
2019,7,8,16,15290,14761,13232,-1529
2019,7,8,17,15710,14806,13355,-1451
2019,7,8,18,15980,15229,13666,-1563
2019,7,8,19,16280,15802,13752,-2050
2019,7,8,20,16830,16458,14384,-2074
2019,7,8,21,17260,17230,15585,-1645
2019,7,8,22,17700,17934,16290,-1644
2019,7,8,23,17640,18199,16196,-2003
2019,7,9,0,17300,17817,15359,-2458
2019,7,9,1,16760,17180,14627,-2553
2019,7,9,2,15900,16333,13954,-2379
2019,7,9,3,14460,14815,12494,-2321
2019,7,9,4,13010,13303,10376,-2927
2019,7,9,5,12220,12658,9859,-2799
2019,7,9,6,11570,12316,9616,-2700
2019,7,9,7,11090,12356,9819,-2537
2019,7,9,8,10890,12337,9670,-2667
2019,7,9,9,11000,12393,9816,-2577
2019,7,9,10,11520,12394,9800,-2594
2019,7,9,11,12680,12834,10175,-2659
2019,7,9,12,13840,13835,11549,-2286
2019,7,9,13,14430,14406,12222,-2184
2019,7,9,14,14780,14805,12780,-2025
2019,7,9,15,15370,15358,13186,-2172
2019,7,9,16,15940,15903,13822,-2081
2019,7,9,17,16390,16439,14432,-2007
2019,7,9,18,17220,17141,15183,-1958
2019,7,9,19,17790,17800,15981,-1819
2019,7,9,20,18540,18467,16415,-2052
2019,7,9,21,19230,19245,17189,-2056
2019,7,9,22,19720,19856,17731,-2125
2019,7,9,23,19600,19954,17232,-2722
2019,7,10,0,18990,19403,16459,-2944
2019,7,10,1,18430,18724,15731,-2993
2019,7,10,2,17580,17822,14886,-2936
2019,7,10,3,15950,16076,13192,-2884
2019,7,10,4,14260,14377,11480,-2897
2019,7,10,5,13100,13686,10895,-2791
2019,7,10,6,12310,13390,10550,-2840
2019,7,10,7,11770,13134,10546,-2588
2019,7,10,8,11510,13069,10453,-2616
2019,7,10,9,11570,13125,10453,-2672
2019,7,10,10,12120,13245,10512,-2733
2019,7,10,11,13230,13481,10720,-2761
2019,7,10,12,14410,14504,11850,-2654
2019,7,10,13,15140,15135,12333,-2802
2019,7,10,14,15840,15782,13313,-2469
2019,7,10,15,16590,16546,14351,-2195
2019,7,10,16,17200,17250,15081,-2169
2019,7,10,17,17780,17946,15858,-2088
2019,7,10,18,18580,18784,16341,-2443
2019,7,10,19,19350,19427,16826,-2601
2019,7,10,20,19870,19865,17236,-2629
2019,7,10,21,20340,20382,17720,-2662
2019,7,10,22,20660,20718,18167,-2551
2019,7,10,23,20490,20585,17860,-2725
2019,7,11,0,19880,20049,17117,-2932
2019,7,11,1,19260,19503,16567,-2936
2019,7,11,2,18340,18703,15536,-3167
2019,7,11,3,16780,17017,13887,-3130
2019,7,11,4,15140,15302,12378,-2924
2019,7,11,5,13880,14511,11296,-3215
2019,7,11,6,13170,13975,10737,-3238
2019,7,11,7,12610,13946,11050,-2896
2019,7,11,8,12330,13968,11020,-2948
2019,7,11,9,12370,14003,11016,-2987
2019,7,11,10,12930,14356,11309,-3047
2019,7,11,11,14230,14909,12139,-2770
2019,7,11,12,15440,15365,12324,-3041
2019,7,11,13,16160,16144,13386,-2758
2019,7,11,14,16680,16740,14172,-2568
2019,7,11,15,17300,17372,14572,-2800
2019,7,11,16,17800,18090,15102,-2988
2019,7,11,17,18420,18768,15889,-2879
2019,7,11,18,18930,19407,16378,-3029
2019,7,11,19,19430,19565,16326,-3239
2019,7,11,20,19550,19311,16178,-3133
2019,7,11,21,19290,19284,16128,-3156
2019,7,11,22,19590,19263,16494,-2769
2019,7,11,23,19150,18903,16060,-2843
2019,7,12,0,18780,18483,15416,-3067
2019,7,12,1,18180,18202,15181,-3021
2019,7,12,2,17450,17502,14626,-2876
2019,7,12,3,16100,16144,13210,-2934
2019,7,12,4,14680,14783,12108,-2675
2019,7,12,5,13690,14232,10922,-3310
2019,7,12,6,13040,13936,10698,-3238
2019,7,12,7,12570,14224,10885,-3339
2019,7,12,8,12430,14052,10657,-3395
2019,7,12,9,12600,14199,10785,-3414
2019,7,12,10,13200,14647,11263,-3384
2019,7,12,11,14450,15414,11790,-3624
2019,7,12,12,15770,15807,12397,-3410
2019,7,12,13,16690,16542,13381,-3161
2019,7,12,14,17200,17064,13894,-3170
2019,7,12,15,17860,17482,14254,-3228
2019,7,12,16,18360,18041,14807,-3234
2019,7,12,17,18790,18449,15268,-3181
2019,7,12,18,19440,19015,15953,-3062
2019,7,12,19,19880,19519,16203,-3316
2019,7,12,20,20380,19868,16755,-3113
2019,7,12,21,20790,20008,17103,-2905
2019,7,12,22,20990,20159,17162,-2997
2019,7,12,23,20630,19894,16681,-3213
2019,7,13,0,19840,19171,16021,-3150
2019,7,13,1,19160,18531,15363,-3168
2019,7,13,2,18330,17797,14608,-3189
2019,7,13,3,16810,16457,13365,-3092
2019,7,13,4,15170,14991,12193,-2798
2019,7,13,5,13720,13910,11153,-2757
2019,7,13,6,12940,13712,10914,-2798
2019,7,13,7,12350,13467,10718,-2749
2019,7,13,8,12010,13388,10707,-2681
2019,7,13,9,11860,13422,10671,-2751
2019,7,13,10,11890,13420,10546,-2874
2019,7,13,11,12300,13459,10699,-2760
2019,7,13,12,13060,13571,10701,-2870
2019,7,13,13,13880,14171,11692,-2479
2019,7,13,14,14690,14627,12016,-2611
2019,7,13,15,15340,15215,12720,-2495
2019,7,13,16,16040,15815,13254,-2561
2019,7,13,17,16550,16337,13567,-2770
2019,7,13,18,17090,16683,13765,-2918
2019,7,13,19,17700,17096,14266,-2830
2019,7,13,20,18340,17640,14578,-3062
2019,7,13,21,18990,18329,15206,-3123
2019,7,13,22,19470,18961,15729,-3232
2019,7,13,23,19410,19204,15841,-3363
2019,7,14,0,18760,18758,15532,-3226
2019,7,14,1,18400,18173,15035,-3138
2019,7,14,2,17800,17583,14552,-3031
2019,7,14,3,16510,16333,13309,-3024
2019,7,14,4,15050,14974,12173,-2801
2019,7,14,5,13690,13839,11796,-2043
2019,7,14,6,12960,13418,11532,-1886
2019,7,14,7,12390,12968,10933,-2035
2019,7,14,8,12040,12784,10695,-2089
2019,7,14,9,11930,12911,10669,-2242
2019,7,14,10,12010,12906,10658,-2248
2019,7,14,11,12350,12977,11025,-1952
2019,7,14,12,13140,13696,11585,-2111
2019,7,14,13,14050,14240,12255,-1985
2019,7,14,14,14910,15275,13042,-2233
2019,7,14,15,15710,16025,13560,-2465
2019,7,14,16,16540,16842,14263,-2579
2019,7,14,17,17060,17586,14744,-2842
2019,7,14,18,17620,17987,15104,-2883
2019,7,14,19,18090,18270,15388,-2882
2019,7,14,20,18630,18821,16062,-2759
2019,7,14,21,19390,19416,16612,-2804
2019,7,14,22,19840,19891,17199,-2692
2019,7,14,23,19730,20002,17255,-2747
2019,7,15,0,19140,19531,16552,-2979
2019,7,15,1,18530,19047,15906,-3141
2019,7,15,2,17750,18257,15268,-2989
2019,7,15,3,16190,16622,13833,-2789
2019,7,15,4,14620,15076,12224,-2852
2019,7,15,5,13630,14194,11524,-2670
2019,7,15,6,12790,14010,11438,-2572
2019,7,15,7,12200,13526,11033,-2493
2019,7,15,8,11870,13183,10730,-2453
2019,7,15,9,11920,13221,10679,-2542
2019,7,15,10,12420,13671,11282,-2389
2019,7,15,11,13560,14484,11888,-2596
2019,7,15,12,14730,15066,12527,-2539
2019,7,15,13,15320,15541,13299,-2242
2019,7,15,14,15710,15630,13405,-2225
2019,7,15,15,16090,16001,13908,-2093
2019,7,15,16,16490,16381,14174,-2207
2019,7,15,17,16880,16769,14657,-2112
2019,7,15,18,17400,17262,15061,-2201
2019,7,15,19,17960,17850,15747,-2103
2019,7,15,20,18520,18509,16375,-2134
2019,7,15,21,19100,19288,17051,-2237
2019,7,15,22,19510,19866,17245,-2621
2019,7,15,23,19560,19824,16655,-3169
2019,7,16,0,19230,19180,15730,-3450
2019,7,16,1,18530,18611,15276,-3335
2019,7,16,2,17580,17658,14397,-3261
2019,7,16,3,15930,15980,12969,-3011
2019,7,16,4,14340,14276,11018,-3258
2019,7,16,5,13130,13319,10414,-2905
2019,7,16,6,12360,13013,10021,-2992
2019,7,16,7,11860,12572,9420,-3152
2019,7,16,8,11560,12390,9254,-3136
2019,7,16,9,11550,12192,8977,-3215
2019,7,16,10,12100,12514,9326,-3188
2019,7,16,11,13300,13412,10179,-3233
2019,7,16,12,14480,14356,11137,-3219
2019,7,16,13,15200,15061,11808,-3253
2019,7,16,14,15650,15639,12550,-3089
2019,7,16,15,16310,16304,13916,-2388
2019,7,16,16,16910,17037,14659,-2378
2019,7,16,17,17690,17851,15478,-2373
2019,7,16,18,18540,18704,16348,-2356
2019,7,16,19,19270,19391,16817,-2574
2019,7,16,20,19910,20017,17155,-2862
2019,7,16,21,20500,20517,17696,-2821
2019,7,16,22,20710,20863,18087,-2776
2019,7,16,23,20590,20984,17882,-3102
2019,7,17,0,20090,20610,17369,-3241
2019,7,17,1,19760,20218,17064,-3154
2019,7,17,2,18940,19444,16411,-3033
2019,7,17,3,17440,17819,14656,-3163
2019,7,17,4,15780,16189,12856,-3333
2019,7,17,5,14890,15374,12025,-3349
2019,7,17,6,14010,14992,11723,-3269
2019,7,17,7,13560,14740,11423,-3317
2019,7,17,8,13300,14753,11518,-3235
2019,7,17,9,13570,14909,11684,-3225
2019,7,17,10,14270,15576,12252,-3324
2019,7,17,11,15470,16424,13174,-3250
2019,7,17,12,16810,17454,14239,-3215
2019,7,17,13,17650,18094,14973,-3121
2019,7,17,14,18330,18371,15708,-2663
2019,7,17,15,19140,19102,16408,-2694
2019,7,17,16,19770,19848,16940,-2908
2019,7,17,17,20310,20744,17827,-2917
2019,7,17,18,20950,21624,18563,-3061
2019,7,17,19,21580,22220,19175,-3045
2019,7,17,20,21820,22496,19412,-3084
2019,7,17,21,22110,22257,19490,-2767
2019,7,17,22,21990,21814,19017,-2797
2019,7,17,23,21630,21187,18203,-2984
2019,7,18,0,21220,20642,17502,-3140
2019,7,18,1,20920,20106,16966,-3140
2019,7,18,2,20130,19154,15978,-3176
2019,7,18,3,18350,17591,14214,-3377
2019,7,18,4,16660,16082,12216,-3866
2019,7,18,5,15100,15441,11659,-3782
2019,7,18,6,14430,15223,11772,-3451
2019,7,18,7,13930,15141,11567,-3574
2019,7,18,8,13650,14973,11443,-3530
2019,7,18,9,13850,15012,11574,-3438
2019,7,18,10,14410,15318,11683,-3635
2019,7,18,11,15560,16151,12437,-3714
2019,7,18,12,16660,16858,13048,-3810
2019,7,18,13,17120,16893,13279,-3614
2019,7,18,14,17540,17022,13357,-3665
2019,7,18,15,17820,17095,13634,-3461
2019,7,18,16,17990,17173,13989,-3184
2019,7,18,17,17860,17055,13899,-3156
2019,7,18,18,17880,16980,13804,-3176
2019,7,18,19,17680,16928,13809,-3119
2019,7,18,20,17630,16773,14029,-2744
2019,7,18,21,17710,17096,14526,-2570
2019,7,18,22,17660,17190,14717,-2473
2019,7,18,23,17490,17009,14471,-2538
2019,7,19,0,17200,16694,13846,-2848
2019,7,19,1,16980,16526,13579,-2947
2019,7,19,2,16310,15955,12887,-3068
2019,7,19,3,14930,14693,11091,-3602
2019,7,19,4,13570,13432,9609,-3823
2019,7,19,5,12390,12551,9109,-3442
2019,7,19,6,11840,12561,9058,-3503
2019,7,19,7,11600,12287,9124,-3163
2019,7,19,8,11450,11849,8866,-2983
2019,7,19,9,12000,11984,9150,-2834
2019,7,19,10,12250,12212,8981,-3231
2019,7,19,11,13360,13302,9983,-3319
2019,7,19,12,14490,14463,11219,-3244
2019,7,19,13,14970,15178,11976,-3202
2019,7,19,14,15830,15612,12538,-3074
2019,7,19,15,16560,16149,13386,-2763
2019,7,19,16,17650,17010,14513,-2497
2019,7,19,17,19010,17970,15415,-2555
2019,7,19,18,20170,19143,16208,-2935
2019,7,19,19,20590,20327,17154,-3173
2019,7,19,20,21220,21278,18212,-3066
2019,7,19,21,21770,21914,18816,-3098
2019,7,19,22,22280,22431,19163,-3268
2019,7,19,23,22180,22484,18899,-3585
2019,7,20,0,22030,22052,18534,-3518
2019,7,20,1,21640,21628,18203,-3425
2019,7,20,2,21170,20911,17569,-3342
2019,7,20,3,19570,19482,16169,-3313
2019,7,20,4,17860,17980,14611,-3369
2019,7,20,5,16190,16919,13544,-3375
2019,7,20,6,15360,16794,13479,-3315
2019,7,20,7,14810,16347,13052,-3295
2019,7,20,8,14820,16142,12876,-3266
2019,7,20,9,14620,15957,12697,-3260
2019,7,20,10,14630,15968,12682,-3286
2019,7,20,11,15230,16014,12821,-3193
2019,7,20,12,16440,16653,13400,-3253
2019,7,20,13,17780,18126,14947,-3179
2019,7,20,14,19210,19235,16109,-3126
2019,7,20,15,20540,20328,17407,-2921
2019,7,20,16,21710,21316,18471,-2845
2019,7,20,17,22650,21970,18601,-3369
2019,7,20,18,23340,22363,19086,-3277
2019,7,20,19,23800,22686,19211,-3475
2019,7,20,20,24160,22982,19646,-3336
2019,7,20,21,24330,23416,20057,-3359
2019,7,20,22,24530,23783,20437,-3346
2019,7,20,23,24340,23865,20349,-3516
2019,7,21,0,23730,23525,20049,-3476
2019,7,21,1,23230,23177,19690,-3487
2019,7,21,2,22000,22429,19065,-3364
2019,7,21,3,20700,21011,17500,-3511
2019,7,21,4,19210,19428,15831,-3597
2019,7,21,5,18030,18352,15138,-3214
2019,7,21,6,16990,17516,14271,-3245
2019,7,21,7,16230,17302,13875,-3427
2019,7,21,8,15640,17198,14032,-3166
2019,7,21,9,15280,16886,13664,-3222
2019,7,21,10,15120,16713,13584,-3129
2019,7,21,11,15430,16959,13781,-3178
2019,7,21,12,16490,17499,14322,-3177
2019,7,21,13,17930,18290,15286,-3004
2019,7,21,14,19180,19164,15739,-3425
2019,7,21,15,19700,19700,16669,-3031
2019,7,21,16,20230,20216,17058,-3158
2019,7,21,17,20900,20878,17787,-3091
2019,7,21,18,21580,21571,18359,-3212
2019,7,21,19,22430,22154,18641,-3513
2019,7,21,20,23050,22627,19082,-3545
2019,7,21,21,23520,23258,19743,-3515
2019,7,21,22,23890,23734,20284,-3450
2019,7,21,23,23670,23815,20310,-3505
2019,7,22,0,22670,23284,19672,-3612
2019,7,22,1,22440,22726,19230,-3496
2019,7,22,2,21730,21742,18156,-3586
2019,7,22,3,19930,19972,16518,-3454
2019,7,22,4,18100,18188,14721,-3467
2019,7,22,5,16740,16788,13461,-3327
2019,7,22,6,15790,16052,12752,-3300
2019,7,22,7,15090,15718,12508,-3210
2019,7,22,8,14660,15696,12542,-3154
2019,7,22,9,14600,15681,12504,-3177
2019,7,22,10,15000,16034,12917,-3117
2019,7,22,11,16000,16525,13339,-3186
2019,7,22,12,17200,17193,13915,-3278
2019,7,22,13,18020,18002,14794,-3208
2019,7,22,14,18690,18610,15414,-3196
2019,7,22,15,19420,18925,15771,-3154
2019,7,22,16,19870,19669,16663,-3006
2019,7,22,17,20050,20059,17003,-3056
2019,7,22,18,20210,20019,16837,-3182
2019,7,22,19,20470,20016,17078,-2938
2019,7,22,20,20620,19833,16952,-2881
2019,7,22,21,20460,19548,17289,-2259
2019,7,22,22,20210,19306,16691,-2615
2019,7,22,23,19620,18805,15797,-3008
2019,7,23,0,19180,18228,14882,-3346
2019,7,23,1,18730,17636,14168,-3468
2019,7,23,2,17680,16812,13364,-3448
2019,7,23,3,16210,15495,11824,-3671
2019,7,23,4,14770,14006,10784,-3222
2019,7,23,5,13000,13284,9979,-3305
2019,7,23,6,12370,12637,9766,-2871
2019,7,23,7,11970,12482,9599,-2883
2019,7,23,8,11750,12490,9490,-3000
2019,7,23,9,11880,12452,9557,-2895
2019,7,23,10,12550,13056,10102,-2954
2019,7,23,11,13660,13861,11069,-2792
2019,7,23,12,14650,14632,12184,-2448
2019,7,23,13,15260,15242,12604,-2638
2019,7,23,14,15520,15509,12992,-2517
2019,7,23,15,15620,15612,12909,-2703
2019,7,23,16,15580,15597,12864,-2733
2019,7,23,17,15060,15064,12378,-2686
2019,7,23,18,15080,15076,12568,-2508
2019,7,23,19,15160,14940,12468,-2472
2019,7,23,20,15560,15066,12749,-2317
2019,7,23,21,15760,15258,12928,-2330
2019,7,23,22,16250,15567,13102,-2465
2019,7,23,23,16500,15647,13224,-2423
2019,7,24,0,16180,15594,12842,-2752
2019,7,24,1,15960,15582,12785,-2797
2019,7,24,2,15210,14986,12422,-2564
2019,7,24,3,14020,13816,10789,-3027
2019,7,24,4,12880,12685,9610,-3075
2019,7,24,5,11740,12204,8898,-3306
2019,7,24,6,11200,11911,8501,-3410
2019,7,24,7,10890,11676,8191,-3485
2019,7,24,8,10750,11534,8039,-3495
2019,7,24,9,10960,11730,8192,-3538
2019,7,24,10,11640,12189,8681,-3508
2019,7,24,11,12790,13110,9443,-3667
2019,7,24,12,13840,13806,10084,-3722
2019,7,24,13,14350,14356,11030,-3326
2019,7,24,14,14560,14577,11405,-3172
2019,7,24,15,14680,14684,11713,-2971
2019,7,24,16,14910,15017,12359,-2658
2019,7,24,17,15180,15427,12662,-2765
2019,7,24,18,15600,15912,13232,-2680
2019,7,24,19,16220,16326,13533,-2793
2019,7,24,20,16600,16775,13994,-2781
2019,7,24,21,17010,17376,14444,-2932
2019,7,24,22,17500,17870,14894,-2976
2019,7,24,23,17300,17903,14814,-3089
2019,7,25,0,16870,17422,13994,-3428
2019,7,25,1,16660,16983,13508,-3475
2019,7,25,2,15930,16165,12891,-3274
2019,7,25,3,14530,14686,11280,-3406
2019,7,25,4,13130,13209,10159,-3050
2019,7,25,5,12100,12170,9245,-2925
2019,7,25,6,11420,12170,9194,-2976
2019,7,25,7,11000,12079,9000,-3079
2019,7,25,8,10790,12096,9009,-3087
2019,7,25,9,10940,12209,8900,-3309
2019,7,25,10,11530,12526,9244,-3282
2019,7,25,11,12630,12985,9568,-3417
2019,7,25,12,13620,13562,10505,-3057
2019,7,25,13,14020,14057,10963,-3094
2019,7,25,14,14410,14417,11527,-2890
2019,7,25,15,14790,14839,12102,-2737
2019,7,25,16,15250,15284,12735,-2549
2019,7,25,17,15730,15810,13261,-2549
2019,7,25,18,16240,16435,13732,-2703
2019,7,25,19,16820,16856,13900,-2956
2019,7,25,20,17460,17367,14551,-2816
2019,7,25,21,18030,17889,15214,-2675
2019,7,25,22,18270,18337,15569,-2768
2019,7,25,23,18160,18316,15052,-3264
2019,7,26,0,17560,17821,14356,-3465
2019,7,26,1,17340,17450,14005,-3445
2019,7,26,2,16600,16668,13167,-3501
2019,7,26,3,15180,15198,11823,-3375
2019,7,26,4,13680,13851,10717,-3134
2019,7,26,5,12520,12922,9761,-3161
2019,7,26,6,11810,12546,9421,-3125
2019,7,26,7,11340,12444,9427,-3017
2019,7,26,8,11110,12443,9367,-3076
2019,7,26,9,11230,12534,9462,-3072
2019,7,26,10,11750,12861,9825,-3036
2019,7,26,11,12820,13125,10196,-2929
2019,7,26,12,13970,14135,11071,-3064
2019,7,26,13,14630,14716,11688,-3028
2019,7,26,14,15120,15128,12504,-2624
2019,7,26,15,15670,15736,13266,-2470
2019,7,26,16,16210,16338,13998,-2340
2019,7,26,17,16760,16925,14424,-2501
2019,7,26,18,17450,17592,14950,-2642
2019,7,26,19,18090,18178,15312,-2866
2019,7,26,20,18570,18701,16055,-2646
2019,7,26,21,19040,19200,16485,-2715
2019,7,26,22,19220,19573,16608,-2965
2019,7,26,23,18920,19402,16365,-3037
2019,7,27,0,18250,18711,15512,-3199
2019,7,27,1,17840,18124,14858,-3266
2019,7,27,2,17080,17285,14177,-3108
2019,7,27,3,15830,15849,13014,-2835
2019,7,27,4,14350,14336,11518,-2818
2019,7,27,5,13120,13443,10553,-2890
2019,7,27,6,12290,12913,10170,-2743
2019,7,27,7,11760,12869,9968,-2901
2019,7,27,8,11410,12846,9871,-2975
2019,7,27,9,11380,12976,9800,-3176
2019,7,27,10,11490,13087,9709,-3378
2019,7,27,11,11800,13156,9491,-3665
2019,7,27,12,12540,13609,10297,-3312
2019,7,27,13,13450,13768,10883,-2885
2019,7,27,14,14050,14026,11716,-2310
2019,7,27,15,14740,14706,12540,-2166
2019,7,27,16,15280,15365,13316,-2049
2019,7,27,17,15580,15949,13591,-2358
2019,7,27,18,16020,16367,13840,-2527
2019,7,27,19,16480,16661,13943,-2718
2019,7,27,20,17060,17006,14356,-2650
2019,7,27,21,17490,17435,14787,-2648
2019,7,27,22,17750,17843,14966,-2877
2019,7,27,23,17630,17820,14552,-3268
2019,7,28,0,16980,17248,13860,-3388
2019,7,28,1,16760,16806,13521,-3285
2019,7,28,2,16240,16398,13057,-3341
2019,7,28,3,15090,15223,11995,-3228
2019,7,28,4,13770,13995,10751,-3244
2019,7,28,5,12670,13228,9642,-3586
2019,7,28,6,12000,12773,9332,-3441
2019,7,28,7,11500,12304,8771,-3533
2019,7,28,8,11250,12274,8626,-3648
2019,7,28,9,11220,12150,8550,-3600
2019,7,28,10,11210,12138,8565,-3573
2019,7,28,11,11380,11944,8386,-3558
2019,7,28,12,12130,12065,8863,-3202
2019,7,28,13,13040,12961,9931,-3030
2019,7,28,14,13910,14142,11181,-2961
2019,7,28,15,14780,14977,12534,-2443
2019,7,28,16,15720,16075,13547,-2528
2019,7,28,17,16660,17098,14278,-2820
2019,7,28,18,17430,17901,15032,-2869
2019,7,28,19,18090,18527,15399,-3128
2019,7,28,20,18890,19233,15913,-3320
2019,7,28,21,19770,19990,16718,-3272
2019,7,28,22,20320,20688,17472,-3216
2019,7,28,23,20330,20868,17564,-3304
2019,7,29,0,19700,20403,17104,-3299
2019,7,29,1,19310,20008,16410,-3598
2019,7,29,2,18500,19209,15931,-3278
2019,7,29,3,17100,17691,14392,-3299
2019,7,29,4,15600,16198,12828,-3370
2019,7,29,5,14980,15441,11955,-3486
2019,7,29,6,14200,15412,11921,-3491
2019,7,29,7,13680,15009,11756,-3253
2019,7,29,8,13400,14712,11315,-3397
2019,7,29,9,13500,14810,11302,-3508
2019,7,29,10,14060,15428,12050,-3378
2019,7,29,11,15160,15997,12773,-3224
2019,7,29,12,16440,17185,14081,-3104
2019,7,29,13,17240,17939,15026,-2913
2019,7,29,14,18420,18586,16020,-2566
2019,7,29,15,19310,19353,17055,-2298
2019,7,29,16,20230,20198,17565,-2633
2019,7,29,17,20850,21001,18265,-2736
2019,7,29,18,21470,21850,18795,-3055
2019,7,29,19,22120,22490,19274,-3216
2019,7,29,20,22640,22823,19729,-3094
2019,7,29,21,23020,23098,20102,-2996
2019,7,29,22,23260,23380,20507,-2873
2019,7,29,23,22910,23281,20111,-3170
2019,7,30,0,22080,22735,19347,-3388
2019,7,30,1,21550,22119,18614,-3505
2019,7,30,2,20330,20906,17319,-3587
2019,7,30,3,18510,19003,15446,-3557
2019,7,30,4,16780,17488,14176,-3312
2019,7,30,5,15750,16619,13165,-3454
2019,7,30,6,14950,16293,12932,-3361
2019,7,30,7,14350,15926,12658,-3268
2019,7,30,8,14040,15576,12382,-3194
2019,7,30,9,14090,15595,12359,-3236
2019,7,30,10,14750,15854,12680,-3174
2019,7,30,11,16210,16784,13673,-3111
2019,7,30,12,17610,18208,15170,-3038
2019,7,30,13,18690,18753,15746,-3007
2019,7,30,14,19480,19278,16382,-2896
2019,7,30,15,20500,20317,17008,-3309
2019,7,30,16,21450,21389,17808,-3581
2019,7,30,17,22210,22289,18577,-3712
2019,7,30,18,23090,23018,19692,-3326
2019,7,30,19,23650,23328,20033,-3295
2019,7,30,20,24060,23407,20097,-3310
2019,7,30,21,24480,23769,20449,-3320
2019,7,30,22,24500,23973,20617,-3356
2019,7,30,23,24100,23851,20581,-3270
2019,7,31,0,23240,23293,19775,-3518
2019,7,31,1,22580,22621,18965,-3656
2019,7,31,2,21350,21351,17780,-3571
2019,7,31,3,19420,19464,15744,-3720
2019,7,31,4,17650,17683,14097,-3586
2019,7,31,5,16340,16650,13183,-3467
2019,7,31,6,15340,16635,13290,-3345
2019,7,31,7,14700,16037,12642,-3395
2019,7,31,8,14310,15883,12293,-3590
2019,7,31,9,14350,15864,12338,-3526
2019,7,31,10,14890,16138,12586,-3552
2019,7,31,11,16160,16745,13216,-3529
2019,7,31,12,17460,17819,14284,-3535
2019,7,31,13,18280,18311,14922,-3389
2019,7,31,14,19010,19164,15492,-3672
2019,7,31,15,19650,20126,16273,-3853
2019,7,31,16,20520,20938,17028,-3910
2019,7,31,17,21040,21732,17883,-3849
2019,7,31,18,22460,22450,18599,-3851
2019,7,31,19,22780,22626,18895,-3731
2019,7,31,20,22900,22344,18847,-3497
2019,7,31,21,21100,21226,17642,-3584
2019,7,31,22,20820,20713,17054,-3659
2019,7,31,23,20200,20214,16341,-3873
2019,8,1,0,19500,19648,15641,-4007
2019,8,1,1,18740,19251,15367,-3884
2019,8,1,2,17630,18320,14723,-3597
2019,8,1,3,15990,16978,13405,-3573
2019,8,1,4,14300,15616,11983,-3633
2019,8,1,5,14190,14754,11290,-3464
2019,8,1,6,13450,14583,11227,-3356
2019,8,1,7,12960,14145,10737,-3408
2019,8,1,8,12700,13783,10304,-3479
2019,8,1,9,12780,13843,10321,-3522
2019,8,1,10,13400,14382,10888,-3494
2019,8,1,11,14490,15121,11586,-3535
2019,8,1,12,15600,15889,12532,-3357
2019,8,1,13,16220,16440,13127,-3313
2019,8,1,14,16640,16765,13664,-3101
2019,8,1,15,17010,17205,14207,-2998
2019,8,1,16,17620,17528,14580,-2948
2019,8,1,17,18270,17976,15057,-2919
2019,8,1,18,18990,18583,15596,-2987
2019,8,1,19,19190,19105,16193,-2912
2019,8,1,20,20140,19534,17179,-2355
2019,8,1,21,19900,20077,17438,-2639
2019,8,1,22,20050,20476,17709,-2767
2019,8,1,23,19900,20326,17024,-3302
2019,8,2,0,18970,19546,16168,-3378
2019,8,2,1,18660,18877,15354,-3523
2019,8,2,2,17610,17781,14190,-3591
2019,8,2,3,16150,16101,12637,-3464
2019,8,2,4,14410,14603,11567,-3036
2019,8,2,5,13170,13491,10302,-3189
2019,8,2,6,12350,12912,9934,-2978
2019,8,2,7,11800,12618,9557,-3061
2019,8,2,8,11490,12295,9308,-2987
2019,8,2,9,11520,12318,9348,-2970
2019,8,2,10,12040,12809,9769,-3040
2019,8,2,11,12970,13290,9972,-3318
2019,8,2,12,14010,14273,11119,-3154
2019,8,2,13,14560,14817,11977,-2840
2019,8,2,14,14980,14952,12337,-2615
2019,8,2,15,15510,15420,12945,-2475
2019,8,2,16,16110,15893,13659,-2234
2019,8,2,17,16750,16334,14042,-2292
2019,8,2,18,17340,16930,14433,-2497
2019,8,2,19,17950,17516,15029,-2487
2019,8,2,20,18460,18100,15717,-2383
2019,8,2,21,18790,18766,16710,-2056
2019,8,2,22,19000,19146,17077,-2069
2019,8,2,23,18710,18901,16239,-2662
2019,8,3,0,18150,18212,15132,-3080
2019,8,3,1,17840,17734,14534,-3200
2019,8,3,2,17060,16893,13788,-3105
2019,8,3,3,15800,15514,12944,-2570
2019,8,3,4,14440,14126,11581,-2545
2019,8,3,5,13020,13159,10234,-2925
2019,8,3,6,12280,12935,10099,-2836
2019,8,3,7,11800,12787,10058,-2729
2019,8,3,8,11520,12854,9802,-3052
2019,8,3,9,11450,12572,9959,-2613
2019,8,3,10,11600,12355,10031,-2324
2019,8,3,11,12000,12415,10232,-2183
2019,8,3,12,12840,13087,10834,-2253
2019,8,3,13,13800,13782,11781,-2001
2019,8,3,14,14560,14550,12772,-1778
2019,8,3,15,15170,15229,13416,-1813
2019,8,3,16,15760,15572,13321,-2251
2019,8,3,17,16260,16039,14071,-1968
2019,8,3,18,16720,16548,14523,-2025
2019,8,3,19,17230,17188,15069,-2119
2019,8,3,20,17800,17636,15422,-2214
2019,8,3,21,18140,18149,15770,-2379
2019,8,3,22,18500,18469,15985,-2484
2019,8,3,23,18300,18297,15750,-2547
2019,8,4,0,17810,17830,15167,-2663
2019,8,4,1,17660,17608,15152,-2456
2019,8,4,2,16960,16982,14468,-2514
2019,8,4,3,15890,15863,13330,-2533
2019,8,4,4,14620,14673,11762,-2911
2019,8,4,5,13650,14086,10720,-3366
2019,8,4,6,12930,13768,10429,-3339
2019,8,4,7,12420,13239,10213,-3026
2019,8,4,8,12070,13290,9962,-3328
2019,8,4,9,11880,13029,9841,-3188
2019,8,4,10,11830,12763,9655,-3108
2019,8,4,11,11970,13019,9894,-3125
2019,8,4,12,12580,13626,10354,-3272
2019,8,4,13,13370,14324,10959,-3365
2019,8,4,14,14020,14296,11686,-2610
2019,8,4,15,14590,14908,11873,-3035
2019,8,4,16,15200,15433,12589,-2844
2019,8,4,17,15760,16034,13278,-2756
2019,8,4,18,16350,16561,13464,-3097
2019,8,4,19,16810,17023,13575,-3448
2019,8,4,20,17290,17500,14070,-3430
2019,8,4,21,17760,18008,14616,-3392
2019,8,4,22,18500,18474,15074,-3400
2019,8,4,23,18350,18563,15038,-3525
2019,8,5,0,17730,18084,14633,-3451
2019,8,5,1,17270,17749,14324,-3425
2019,8,5,2,16210,16829,13531,-3298
2019,8,5,3,14710,15321,12069,-3252
2019,8,5,4,13350,14234,11111,-3123
2019,8,5,5,12680,13394,10358,-3036
2019,8,5,6,11880,12918,9914,-3004
2019,8,5,7,11380,12950,9512,-3438
2019,8,5,8,11070,12676,9101,-3575
2019,8,5,9,11150,12723,9278,-3445
2019,8,5,10,11690,13066,9911,-3155
2019,8,5,11,12640,13703,10399,-3304
2019,8,5,12,13580,14137,10669,-3468
2019,8,5,13,14030,14347,11260,-3087
2019,8,5,14,14300,14572,11943,-2629
2019,8,5,15,14650,14653,12484,-2169
2019,8,5,16,15070,15044,13114,-1930
2019,8,5,17,15470,15464,13513,-1951
2019,8,5,18,16040,16035,13930,-2105
2019,8,5,19,16760,16604,14482,-2122
2019,8,5,20,17120,17206,15032,-2174
2019,8,5,21,17660,17892,15695,-2197
2019,8,5,22,18250,18488,15882,-2606
2019,8,5,23,18230,18576,15625,-2951
2019,8,6,0,17880,18014,14782,-3232
2019,8,6,1,17430,17577,14332,-3245
2019,8,6,2,16470,16568,13779,-2789
2019,8,6,3,15040,15014,12467,-2547
2019,8,6,4,13550,13563,10821,-2742
2019,8,6,5,12360,12770,9743,-3027
2019,8,6,6,11770,12774,9623,-3151
2019,8,6,7,11400,12683,9691,-2992
2019,8,6,8,11220,12473,9454,-3019
2019,8,6,9,11420,12606,9485,-3121
2019,8,6,10,11960,12944,9681,-3263
2019,8,6,11,13130,13392,10495,-2897
2019,8,6,12,14240,14515,11460,-3055
2019,8,6,13,15030,14854,12155,-2699
2019,8,6,14,15580,15279,13040,-2239
2019,8,6,15,16080,15845,13840,-2005
2019,8,6,16,16570,16473,14497,-1976
2019,8,6,17,17100,16994,14938,-2056
2019,8,6,18,17560,17377,14968,-2409
2019,8,6,19,17960,17429,14812,-2617
2019,8,6,20,18350,17527,14877,-2650
2019,8,6,21,18120,17904,15701,-2203
2019,8,6,22,18400,18182,15592,-2590
2019,8,6,23,18710,18162,14997,-3165
2019,8,7,0,18360,17927,14827,-3100
2019,8,7,1,18140,17780,14612,-3168
2019,8,7,2,17240,16913,13781,-3132
2019,8,7,3,15770,15674,12583,-3091
2019,8,7,4,14330,14366,11330,-3036
2019,8,7,5,13080,13366,10341,-3025
2019,8,7,6,12440,13325,10425,-2900
2019,8,7,7,12060,13331,10396,-2935
2019,8,7,8,11890,13179,10247,-2932
2019,8,7,9,12040,13316,10257,-3059
2019,8,7,10,12800,13595,10560,-3035
2019,8,7,11,14080,14214,11104,-3110
2019,8,7,12,15290,15155,11879,-3276
2019,8,7,13,16070,16056,13155,-2901
2019,8,7,14,16640,16745,13780,-2965
2019,8,7,15,17220,17356,14200,-3156
2019,8,7,16,17810,17975,14640,-3335
2019,8,7,17,18300,18518,14973,-3545
2019,8,7,18,18780,19184,15697,-3487
2019,8,7,19,19310,19415,15989,-3426
2019,8,7,20,19550,19417,16024,-3393
2019,8,7,21,19830,19912,16439,-3473
2019,8,7,22,20010,20093,16490,-3603
2019,8,7,23,19720,19800,16035,-3765
2019,8,8,0,19330,19361,15579,-3782
2019,8,8,1,19060,18882,15115,-3767
2019,8,8,2,18070,17802,13951,-3851
2019,8,8,3,16560,16328,12492,-3836
2019,8,8,4,15100,14783,11267,-3516
2019,8,8,5,13710,13781,10559,-3222
2019,8,8,6,13010,13687,10256,-3431
2019,8,8,7,12590,13756,10072,-3684
2019,8,8,8,12380,13698,9781,-3917
2019,8,8,9,12500,13813,9893,-3920
2019,8,8,10,13210,14164,10209,-3955
2019,8,8,11,14450,14633,10766,-3867
2019,8,8,12,15420,15468,11520,-3948
2019,8,8,13,16000,16189,12315,-3874
2019,8,8,14,16410,16574,12847,-3727
2019,8,8,15,16770,16904,13412,-3492
2019,8,8,16,17240,17403,14013,-3390
2019,8,8,17,18050,17855,14081,-3774
2019,8,8,18,18360,18528,14656,-3872
2019,8,8,19,18980,19124,15433,-3691
2019,8,8,20,19480,19734,16397,-3337
2019,8,8,21,19930,20249,16591,-3658
2019,8,8,22,20260,20656,17090,-3566
2019,8,8,23,19900,20535,17009,-3526
2019,8,9,0,19370,19865,16263,-3602
2019,8,9,1,19060,19210,15558,-3652
2019,8,9,2,18010,18021,14425,-3596
2019,8,9,3,16450,16299,12747,-3552
2019,8,9,4,14890,14639,11413,-3226
2019,8,9,5,13420,13586,10402,-3184
2019,8,9,6,12620,13486,10398,-3088
2019,8,9,7,12100,13442,10245,-3197
2019,8,9,8,11800,13130,9823,-3307
2019,8,9,9,11920,13163,9846,-3317
2019,8,9,10,12510,13432,10208,-3224
2019,8,9,11,13590,13950,10308,-3642
2019,8,9,12,14700,14528,10911,-3617
2019,8,9,13,15320,15124,11737,-3387
2019,8,9,14,15500,15491,12403,-3088
2019,8,9,15,15820,15828,12852,-2976
2019,8,9,16,16180,16221,13149,-3072
2019,8,9,17,16610,16563,13519,-3044
2019,8,9,18,17170,17050,13800,-3250
2019,8,9,19,17640,17507,14068,-3439
2019,8,9,20,17970,17944,14528,-3416
2019,8,9,21,18390,18419,15028,-3391
2019,8,9,22,18500,18730,15117,-3613
2019,8,9,23,18050,18480,14780,-3700
2019,8,10,0,17360,17784,14015,-3769
2019,8,10,1,16980,17315,13696,-3619
2019,8,10,2,16130,16354,12904,-3450
2019,8,10,3,14790,14959,11595,-3364
2019,8,10,4,13410,13730,10474,-3256
2019,8,10,5,12340,12617,9614,-3003
2019,8,10,6,11630,11694,9003,-2691
2019,8,10,7,11130,11456,8661,-2795
2019,8,10,8,10800,11142,8622,-2520
2019,8,10,9,10760,11029,8474,-2555
2019,8,10,10,10890,11366,8396,-2970
2019,8,10,11,11050,11464,8889,-2575
2019,8,10,12,11690,12014,9342,-2672
2019,8,10,13,12260,12436,9753,-2683
2019,8,10,14,12670,13003,10077,-2926
2019,8,10,15,12860,13356,10517,-2839
2019,8,10,16,13030,13407,10755,-2652
2019,8,10,17,13240,13693,11094,-2599
2019,8,10,18,13460,13778,11220,-2558
2019,8,10,19,13680,14012,11375,-2637
2019,8,10,20,13900,14323,11490,-2833
2019,8,10,21,14240,14639,11961,-2678
2019,8,10,22,14690,14942,12203,-2739
2019,8,10,23,14670,15029,12292,-2737
2019,8,11,0,14360,14666,11729,-2937
2019,8,11,1,14210,14518,11657,-2861
2019,8,11,2,13780,13840,10882,-2958
2019,8,11,3,12810,12841,9966,-2875
2019,8,11,4,11760,11777,9064,-2713
2019,8,11,5,10860,10927,8302,-2625
2019,8,11,6,10340,10365,7650,-2715
2019,8,11,7,9910,10852,7388,-3464
2019,8,11,8,9750,10813,7422,-3391
2019,8,11,9,9760,10700,7516,-3184
2019,8,11,10,9740,10536,7548,-2988
2019,8,11,11,9720,10726,7332,-3394
2019,8,11,12,10200,11144,7806,-3338
2019,8,11,13,10760,11059,7932,-3127
2019,8,11,14,11060,11091,8095,-2996
2019,8,11,15,11250,11360,8648,-2712
2019,8,11,16,11620,11756,9419,-2337
2019,8,11,17,12080,12270,9981,-2289
2019,8,11,18,12470,12638,10393,-2245
2019,8,11,19,12880,12906,10418,-2488
2019,8,11,20,13470,13409,10460,-2949
2019,8,11,21,14260,14203,11181,-3022
2019,8,11,22,15140,15008,12088,-2920
2019,8,11,23,15290,15212,12471,-2741
2019,8,12,0,15060,15101,12226,-2875
2019,8,12,1,14980,15143,12313,-2830
2019,8,12,2,14330,14461,11740,-2721
2019,8,12,3,13270,13299,10096,-3203
2019,8,12,4,12150,12141,9312,-2829
2019,8,12,5,11300,11616,8432,-3184
2019,8,12,6,10760,11306,8299,-3007
2019,8,12,7,10410,11250,8062,-3188
2019,8,12,8,10300,11264,7960,-3304
2019,8,12,9,10470,11233,8210,-3023
2019,8,12,10,11140,11390,8224,-3166
2019,8,12,11,12180,12137,9216,-2921
2019,8,12,12,13210,13178,10086,-3092
2019,8,12,13,13720,13713,10655,-3058
2019,8,12,14,14060,14083,11256,-2827
2019,8,12,15,14550,14526,11903,-2623
2019,8,12,16,15150,15056,12610,-2446
2019,8,12,17,15790,15644,13294,-2350
2019,8,12,18,16370,16498,14149,-2349
2019,8,12,19,16990,17077,14703,-2374
2019,8,12,20,17720,17579,15358,-2221
2019,8,12,21,18330,18287,16099,-2188
2019,8,12,22,18870,18938,16619,-2319
2019,8,12,23,18730,18906,16119,-2787
2019,8,13,0,18290,18452,15401,-3051
2019,8,13,1,17980,18180,15205,-2975
2019,8,13,2,16960,17142,14009,-3133
2019,8,13,3,15400,15672,12422,-3250
2019,8,13,4,13970,14285,11281,-3004
2019,8,13,5,12920,13277,10640,-2637
2019,8,13,6,12240,13064,10318,-2746
2019,8,13,7,11920,13318,10411,-2907
2019,8,13,8,11790,13182,10215,-2967
2019,8,13,9,12010,13224,10297,-2927
2019,8,13,10,13020,13599,10753,-2846
2019,8,13,11,14160,14212,11988,-2224
2019,8,13,12,15310,15318,13044,-2274
2019,8,13,13,15960,16133,13750,-2383
2019,8,13,14,16800,16778,14254,-2524
2019,8,13,15,17190,17224,14438,-2786
2019,8,13,16,17700,17539,14790,-2749
2019,8,13,17,17950,17524,14685,-2839
2019,8,13,18,18320,17591,14483,-3108
2019,8,13,19,18610,17577,14422,-3155
2019,8,13,20,18690,17557,14534,-3023
2019,8,13,21,18790,17704,14687,-3017
2019,8,13,22,18910,18001,15124,-2877
2019,8,13,23,18660,17992,14861,-3131
2019,8,14,0,18340,17750,14414,-3336
2019,8,14,1,17980,17585,14305,-3280
2019,8,14,2,17020,16684,13377,-3307
2019,8,14,3,15560,15321,12195,-3126
2019,8,14,4,14180,14044,11173,-2871
2019,8,14,5,12980,13527,10628,-2899
2019,8,14,6,12340,13505,10432,-3073
2019,8,14,7,11940,13529,10403,-3126
2019,8,14,8,11760,13349,10283,-3066
2019,8,14,9,11920,13330,10196,-3134
2019,8,14,10,12570,13490,10650,-2840
2019,8,14,11,13630,14184,11402,-2782
2019,8,14,12,14570,14567,11787,-2780
2019,8,14,13,15110,15117,12732,-2385
2019,8,14,14,15370,15401,13168,-2233
2019,8,14,15,15680,15676,13559,-2117
2019,8,14,16,15840,15851,13990,-1861
2019,8,14,17,16180,15969,14311,-1658
2019,8,14,18,16520,16476,14828,-1648
2019,8,14,19,16870,16950,15210,-1740
2019,8,14,20,17210,17227,15504,-1723
2019,8,14,21,17610,17471,15486,-1985
2019,8,14,22,17830,17745,15715,-2030
2019,8,14,23,17660,17612,15457,-2155
2019,8,15,0,17270,17272,14806,-2466
2019,8,15,1,16990,17035,14585,-2450
2019,8,15,2,16040,16080,13712,-2368
2019,8,15,3,14620,14665,12075,-2590
2019,8,15,4,13250,13326,11019,-2307
2019,8,15,5,12290,12824,9934,-2890
2019,8,15,6,11650,12726,9432,-3294
2019,8,15,7,11250,12599,9342,-3257
2019,8,15,8,11050,12378,9040,-3338
2019,8,15,9,11200,12503,9024,-3479
2019,8,15,10,11880,13162,9698,-3464
2019,8,15,11,12910,13701,10392,-3309
2019,8,15,12,13900,13999,11033,-2966
2019,8,15,13,14390,14386,11848,-2538
2019,8,15,14,14560,14551,12418,-2133
2019,8,15,15,14880,14867,12928,-1939
2019,8,15,16,15290,15279,13438,-1841
2019,8,15,17,15730,15723,14242,-1481
2019,8,15,18,16390,16387,14620,-1767
2019,8,15,19,16940,16947,14761,-2186
2019,8,15,20,17390,17388,15131,-2257
2019,8,15,21,17900,17917,15518,-2399
2019,8,15,22,18320,18237,15419,-2818
2019,8,15,23,17950,18051,14930,-3121
2019,8,16,0,17420,17475,14295,-3180
2019,8,16,1,17080,17171,14247,-2924
2019,8,16,2,16100,16212,13479,-2733
2019,8,16,3,14730,14835,12080,-2755
2019,8,16,4,13370,13492,11080,-2412
2019,8,16,5,12470,12824,9999,-2825
2019,8,16,6,11810,12841,9666,-3175
2019,8,16,7,11410,12766,9774,-2992
2019,8,16,8,11220,12569,9486,-3083
2019,8,16,9,11330,12624,9615,-3009
2019,8,16,10,12000,13016,9777,-3239
2019,8,16,11,13010,13510,10664,-2846
2019,8,16,12,14010,14074,11223,-2851
2019,8,16,13,14680,14672,12126,-2546
2019,8,16,14,14940,14938,12448,-2490
2019,8,16,15,15250,15239,12972,-2267
2019,8,16,16,15640,15631,13722,-1909
2019,8,16,17,16010,16007,14113,-1894
2019,8,16,18,16540,16536,14300,-2236
2019,8,16,19,17130,17113,14905,-2208
2019,8,16,20,17590,17608,15001,-2607
2019,8,16,21,18090,18042,15367,-2675
2019,8,16,22,18390,18268,15443,-2825
2019,8,16,23,17910,17924,14779,-3145
2019,8,17,0,17400,17350,14354,-2996
2019,8,17,1,16930,17011,14038,-2973
2019,8,17,2,16080,16176,12987,-3189
2019,8,17,3,14800,14992,11667,-3325
2019,8,17,4,13480,13906,10665,-3241
2019,8,17,5,12760,13332,10202,-3130
2019,8,17,6,12140,12794,9938,-2856
2019,8,17,7,11750,12758,9869,-2889
2019,8,17,8,11530,12682,9803,-2879
2019,8,17,9,11520,12818,9835,-2983
2019,8,17,10,11770,12858,9976,-2882
2019,8,17,11,12150,13113,10184,-2929
2019,8,17,12,12790,13287,10619,-2668
2019,8,17,13,13650,14070,11480,-2590
2019,8,17,14,14330,14497,12027,-2470
2019,8,17,15,14750,14920,12738,-2182
2019,8,17,16,15120,15231,13207,-2024
2019,8,17,17,15360,15535,13467,-2068
2019,8,17,18,15620,15728,13587,-2141
2019,8,17,19,15940,16022,13976,-2046
2019,8,17,20,16270,16399,14204,-2195
2019,8,17,21,16770,16852,14546,-2306
2019,8,17,22,17150,17275,14724,-2551
2019,8,17,23,17090,17308,14576,-2732
2019,8,18,0,16810,17031,14221,-2810
2019,8,18,1,16620,16857,14020,-2837
2019,8,18,2,15900,16128,13357,-2771
2019,8,18,3,14860,15074,12320,-2754
2019,8,18,4,13740,14009,11263,-2746
2019,8,18,5,13030,13576,10774,-2802
2019,8,18,6,12390,13411,10420,-2991
2019,8,18,7,11970,13290,10372,-2918
2019,8,18,8,11690,13019,10033,-2986
2019,8,18,9,11580,12908,9900,-3008
2019,8,18,10,11640,13010,9993,-3017
2019,8,18,11,11890,13231,10252,-2979
2019,8,18,12,12460,13586,10667,-2919
2019,8,18,13,13350,13931,11204,-2727
2019,8,18,14,14160,14271,11779,-2492
2019,8,18,15,14900,14945,12625,-2320
2019,8,18,16,15650,15519,13584,-1935
2019,8,18,17,16430,16383,14709,-1674
2019,8,18,18,17140,17260,15422,-1838
2019,8,18,19,17760,18027,15864,-2163
2019,8,18,20,18440,18739,16731,-2008
2019,8,18,21,19150,19495,17202,-2293
2019,8,18,22,19730,20001,17380,-2621
2019,8,18,23,19740,19934,17080,-2854
2019,8,19,0,19440,19568,16480,-3088
2019,8,19,1,19130,19325,16278,-3047
2019,8,19,2,18150,18241,15149,-3092
2019,8,19,3,16710,16768,13572,-3196
2019,8,19,4,15280,15651,12323,-3328
2019,8,19,5,14260,15021,11677,-3344
2019,8,19,6,13500,14605,11425,-3180
2019,8,19,7,13110,14458,11392,-3066
2019,8,19,8,12940,14302,11222,-3080
2019,8,19,9,13090,14469,11423,-3046
2019,8,19,10,13810,14927,11984,-2943
2019,8,19,11,15040,15644,12984,-2660
2019,8,19,12,16280,16641,14126,-2515
2019,8,19,13,17130,17337,14851,-2486
2019,8,19,14,17840,17892,15463,-2429
2019,8,19,15,18710,18765,16255,-2510
2019,8,19,16,19600,19698,17130,-2568
2019,8,19,17,20520,20631,18114,-2517
2019,8,19,18,21390,21564,19162,-2402
2019,8,19,19,22010,22367,19922,-2445
2019,8,19,20,22450,22888,20368,-2520
2019,8,19,21,22910,22567,19822,-2745
2019,8,19,22,23000,22030,19229,-2801
2019,8,19,23,22530,21470,18522,-2948
2019,8,20,0,21920,20799,17788,-3011
2019,8,20,1,21100,20277,17195,-3082
2019,8,20,2,19710,18982,15796,-3186
2019,8,20,3,17880,17271,13889,-3382
2019,8,20,4,16260,15650,12322,-3328
2019,8,20,5,14670,14494,11497,-2997
2019,8,20,6,13740,14359,11248,-3111
2019,8,20,7,13190,14432,11166,-3266
2019,8,20,8,12830,14347,10964,-3383
2019,8,20,9,12790,14343,10933,-3410
2019,8,20,10,13350,14587,11170,-3417
2019,8,20,11,14400,14871,11324,-3547
2019,8,20,12,15470,15402,12005,-3397
2019,8,20,13,15900,15980,12657,-3323
2019,8,20,14,16390,16401,13188,-3213
2019,8,20,15,17030,16891,13681,-3210
2019,8,20,16,17900,17429,14501,-2928
2019,8,20,17,18540,17991,15175,-2816
2019,8,20,18,19230,18702,15930,-2772
2019,8,20,19,19620,19325,16579,-2746
2019,8,20,20,20140,19917,17064,-2853
2019,8,20,21,20770,20532,17814,-2718
2019,8,20,22,21060,20987,18192,-2795
2019,8,20,23,20740,20784,17555,-3229
2019,8,21,0,20190,20010,16571,-3439
2019,8,21,1,19710,19356,15862,-3494
2019,8,21,2,18380,18032,14519,-3513
2019,8,21,3,16640,16334,12778,-3556
2019,8,21,4,14970,14972,11298,-3674
2019,8,21,5,13560,14087,10516,-3571
2019,8,21,6,12790,13345,10091,-3254
2019,8,21,7,12310,12858,9626,-3232
2019,8,21,8,12070,12604,9312,-3292
2019,8,21,9,12230,12748,9390,-3358
2019,8,21,10,12990,13210,9885,-3325
2019,8,21,11,14380,14113,10990,-3123
2019,8,21,12,15670,15330,12230,-3100
2019,8,21,13,16560,16293,13355,-2938
2019,8,21,14,17320,17061,14211,-2850
2019,8,21,15,18060,17705,14657,-3048
2019,8,21,16,18850,18472,15216,-3256
2019,8,21,17,19690,19100,15877,-3223
2019,8,21,18,20010,19704,16464,-3240
2019,8,21,19,20590,19780,17043,-2737
2019,8,21,20,20820,19696,17109,-2587
2019,8,21,21,20870,19738,17686,-2052
2019,8,21,22,20830,19678,17258,-2420
2019,8,21,23,20490,19511,16262,-3249
2019,8,22,0,20140,19278,15945,-3333
2019,8,22,1,19710,18950,15366,-3584
2019,8,22,2,18540,17971,14239,-3732
2019,8,22,3,17030,16491,12869,-3622
2019,8,22,4,15580,14980,11526,-3454
2019,8,22,5,13890,14108,11013,-3095
2019,8,22,6,13180,14007,11031,-2976
2019,8,22,7,12730,13836,10970,-2866
2019,8,22,8,12550,13836,10925,-2911
2019,8,22,9,12720,14006,11090,-2916
2019,8,22,10,13480,14273,11386,-2887
2019,8,22,11,14710,14932,11944,-2988
2019,8,22,12,15920,15899,12670,-3229
2019,8,22,13,16810,16800,13533,-3267
2019,8,22,14,17410,17466,14368,-3098
2019,8,22,15,18190,18232,15123,-3109
2019,8,22,16,19200,19081,16055,-3026
2019,8,22,17,19990,19934,16850,-3084
2019,8,22,18,20840,20663,17488,-3175
2019,8,22,19,21090,21109,18072,-3037
2019,8,22,20,21710,21431,18394,-3037
2019,8,22,21,22000,21840,18781,-3059
2019,8,22,22,21940,21822,18835,-2987
2019,8,22,23,21380,21236,17983,-3253
2019,8,23,0,20530,20601,17262,-3339
2019,8,23,1,19700,20139,16670,-3469
2019,8,23,2,18280,18872,15355,-3517
2019,8,23,3,16590,17182,13998,-3184
2019,8,23,4,14800,15612,12498,-3114
2019,8,23,5,14330,14421,11178,-3243
2019,8,23,6,13450,14063,11005,-3058
2019,8,23,7,12880,13708,10673,-3035
2019,8,23,8,12500,13809,10404,-3405
2019,8,23,9,12440,13778,10312,-3466
2019,8,23,10,12960,14068,10776,-3292
2019,8,23,11,13950,14279,11247,-3032
2019,8,23,12,14760,14753,11702,-3051
2019,8,23,13,15240,15251,12375,-2876
2019,8,23,14,15480,15391,12303,-3088
2019,8,23,15,15680,15421,12355,-3066
2019,8,23,16,15930,15685,12663,-3022
2019,8,23,17,16050,15713,12671,-3042
2019,8,23,18,16350,15767,12452,-3315
2019,8,23,19,16520,15978,12539,-3439
2019,8,23,20,16770,16106,12667,-3439
2019,8,23,21,16920,16423,13031,-3392
2019,8,23,22,16960,16396,12887,-3509
2019,8,23,23,16680,16070,12491,-3579
2019,8,24,0,16280,15841,12220,-3621
2019,8,24,1,15900,15590,11879,-3711
2019,8,24,2,15030,14731,11146,-3585
2019,8,24,3,13820,13762,10350,-3412
2019,8,24,4,12570,12778,9597,-3181
2019,8,24,5,11320,11360,8071,-3289
2019,8,24,6,10650,10938,7744,-3194
2019,8,24,7,10240,10869,7786,-3083
2019,8,24,8,10000,10795,7771,-3024
2019,8,24,9,9940,10957,7655,-3302
2019,8,24,10,10120,10935,7715,-3220
2019,8,24,11,10480,11001,7717,-3284
2019,8,24,12,11000,11250,7813,-3437
2019,8,24,13,11450,11441,8072,-3369
2019,8,24,14,11650,11664,8366,-3298
2019,8,24,15,11750,11770,8736,-3034
2019,8,24,16,12020,11970,8915,-3055
2019,8,24,17,12220,12164,8702,-3462
2019,8,24,18,12500,12350,8880,-3470
2019,8,24,19,12780,12591,9436,-3155
2019,8,24,20,13160,12902,9604,-3298
2019,8,24,21,13770,13345,9695,-3650
2019,8,24,22,14260,13842,10203,-3639
2019,8,24,23,14340,14020,10478,-3542
2019,8,25,0,14260,13940,10340,-3600
2019,8,25,1,14160,13879,10296,-3583
2019,8,25,2,13470,13245,9885,-3360
2019,8,25,3,12550,12355,9171,-3184
2019,8,25,4,11590,11420,8191,-3229
2019,8,25,5,10670,10692,7443,-3249
2019,8,25,6,10140,10146,7389,-2757
2019,8,25,7,9840,9848,7069,-2779
2019,8,25,8,9630,9867,6900,-2967
2019,8,25,9,9600,9851,7113,-2738
2019,8,25,10,9720,9969,6857,-3112
2019,8,25,11,9940,10184,7157,-3027
2019,8,25,12,10370,10610,7410,-3200
2019,8,25,13,10900,10895,7839,-3056
2019,8,25,14,11240,11306,8121,-3185
2019,8,25,15,11540,11466,8526,-2940
2019,8,25,16,11830,11687,8710,-2977
2019,8,25,17,11950,11757,9260,-2497
2019,8,25,18,12020,11764,9341,-2423
2019,8,25,19,12110,11784,9173,-2611
2019,8,25,20,12410,12084,8968,-3116
2019,8,25,21,13050,12397,9213,-3184
2019,8,25,22,13750,13128,10235,-2893
2019,8,25,23,13920,13552,10322,-3230
2019,8,26,0,13890,13650,10449,-3201
2019,8,26,1,13740,13593,10635,-2958
2019,8,26,2,12960,12786,10143,-2643
2019,8,26,3,11890,11702,8774,-2928
2019,8,26,4,10840,10724,8116,-2608
2019,8,26,5,10000,10301,7263,-3038
2019,8,26,6,9560,10072,7173,-2899
2019,8,26,7,9330,10051,7085,-2966
2019,8,26,8,9270,10061,7230,-2831
2019,8,26,9,9530,10309,7252,-3057
2019,8,26,10,10310,10651,7524,-3127
2019,8,26,11,11430,11400,8185,-3215
2019,8,26,12,12240,12219,9006,-3213
2019,8,26,13,12430,12532,9276,-3256
2019,8,26,14,12490,12733,9674,-3059
2019,8,26,15,12450,12650,9836,-2814
2019,8,26,16,12560,12721,10097,-2624
2019,8,26,17,12670,12906,10232,-2674
2019,8,26,18,12830,13201,10744,-2457
2019,8,26,19,13130,13404,10339,-3065
2019,8,26,20,13480,13668,10561,-3107
2019,8,26,21,14060,14196,11209,-2987
2019,8,26,22,14700,14830,11830,-3000
2019,8,26,23,14880,15075,11956,-3119
2019,8,27,0,14760,14972,11592,-3380
2019,8,27,1,14550,14702,11253,-3449
2019,8,27,2,13560,13653,10184,-3469
2019,8,27,3,12260,12341,8796,-3545
2019,8,27,4,11110,11162,7982,-3180
2019,8,27,5,10360,10827,7245,-3582
2019,8,27,6,9870,10221,6943,-3278
2019,8,27,7,9640,10112,6973,-3139
2019,8,27,8,9550,10017,6831,-3186
2019,8,27,9,9750,10221,6899,-3322
2019,8,27,10,10550,10733,7406,-3327
2019,8,27,11,11720,11602,8453,-3149
2019,8,27,12,12480,12378,9100,-3278
2019,8,27,13,12600,12583,9355,-3228
2019,8,27,14,12510,12687,9337,-3350
2019,8,27,15,12570,12938,9856,-3082
2019,8,27,16,12820,13234,9828,-3406
2019,8,27,17,13110,13458,10288,-3170
2019,8,27,18,13510,13676,10307,-3369
2019,8,27,19,13820,13955,10591,-3364
2019,8,27,20,14100,14348,11142,-3206
2019,8,27,21,14550,14637,11594,-3043
2019,8,27,22,14990,14980,11976,-3004
2019,8,27,23,15250,15065,12084,-2981
2019,8,28,0,15040,15149,12114,-3035
2019,8,28,1,14870,14988,12013,-2975
2019,8,28,2,13950,14020,10962,-3058
2019,8,28,3,12650,12738,9550,-3188
2019,8,28,4,11480,11575,8866,-2709
2019,8,28,5,10830,11250,8167,-3083
2019,8,28,6,10420,11122,8163,-2959
2019,8,28,7,10160,10878,7987,-2891
2019,8,28,8,10080,10772,7819,-2953
2019,8,28,9,10350,10981,8019,-2962
2019,8,28,10,11210,11716,8502,-3214
2019,8,28,11,12530,12501,9151,-3350
2019,8,28,12,13460,13277,9878,-3399
2019,8,28,13,13820,13722,10806,-2916
2019,8,28,14,14040,14023,11295,-2728
2019,8,28,15,14230,14319,11824,-2495
2019,8,28,16,14600,14658,12388,-2270
2019,8,28,17,14830,15158,12869,-2289
2019,8,28,18,15160,15764,13276,-2488
2019,8,28,19,16000,15982,13262,-2720
2019,8,28,20,16220,16148,13823,-2325
2019,8,28,21,16520,16228,13910,-2318
2019,8,28,22,16710,16326,13636,-2690
2019,8,28,23,16660,16259,12984,-3275
2019,8,29,0,16640,16253,12994,-3259
2019,8,29,1,16340,15928,13084,-2844
2019,8,29,2,15280,15041,12129,-2912
2019,8,29,3,13980,13821,10760,-3061
2019,8,29,4,12750,12680,9352,-3328
2019,8,29,5,11890,12068,8585,-3483
2019,8,29,6,11410,12132,8710,-3422
2019,8,29,7,11100,11901,8424,-3477
2019,8,29,8,10940,11734,8226,-3508
2019,8,29,9,11100,11881,8527,-3354
2019,8,29,10,11910,12416,9079,-3337
2019,8,29,11,13320,13382,10264,-3118
2019,8,29,12,14220,14216,11070,-3146
2019,8,29,13,14500,14502,11465,-3037
2019,8,29,14,14670,14663,11617,-3046
2019,8,29,15,14980,14856,11824,-3032
2019,8,29,16,15500,15044,11999,-3045
2019,8,29,17,15950,15434,12251,-3183
2019,8,29,18,16550,15959,12553,-3406
2019,8,29,19,16960,16429,13155,-3274
2019,8,29,20,17340,16972,13706,-3266
2019,8,29,21,17810,17505,15080,-2425
2019,8,29,22,18050,17909,15631,-2278
2019,8,29,23,17800,17798,14697,-3101
2019,8,30,0,17350,17353,14388,-2965
2019,8,30,1,17000,16893,13931,-2962
2019,8,30,2,15850,15716,12647,-3069
2019,8,30,3,14390,14194,11128,-3066
2019,8,30,4,12960,12783,9727,-3056
2019,8,30,5,11790,12010,8751,-3259
2019,8,30,6,11160,11676,8401,-3275
2019,8,30,7,10770,11460,8053,-3407
2019,8,30,8,10570,11475,8063,-3412
2019,8,30,9,10730,11573,8221,-3352
2019,8,30,10,11370,11719,8402,-3317
2019,8,30,11,12420,12458,9262,-3196
2019,8,30,12,13300,13134,10058,-3076
2019,8,30,13,13720,13602,10491,-3111
2019,8,30,14,13900,13912,10986,-2926
2019,8,30,15,14230,14513,11638,-2875
2019,8,30,16,14860,14716,12372,-2344
2019,8,30,17,15420,15020,12513,-2507
2019,8,30,18,16190,15667,13208,-2459
2019,8,30,19,16820,16377,13630,-2747
2019,8,30,20,17320,17003,14550,-2453
2019,8,30,21,17890,17598,15025,-2573
2019,8,30,22,18100,17927,15299,-2628
2019,8,30,23,17640,17723,14976,-2747
2019,8,31,0,17180,17306,14019,-3287
2019,8,31,1,16640,16892,13734,-3158
2019,8,31,2,15570,15914,13040,-2874
2019,8,31,3,14230,14672,11858,-2814
2019,8,31,4,12860,13339,10400,-2939
2019,8,31,5,12190,12286,9585,-2701
2019,8,31,6,11350,11512,8747,-2765
2019,8,31,7,10890,11247,8381,-2866
2019,8,31,8,10560,11165,8256,-2909
2019,8,31,9,10420,11321,8310,-3011
2019,8,31,10,10600,11433,8387,-3046
2019,8,31,11,10830,11273,8562,-2711
2019,8,31,12,11410,11672,8586,-3086
2019,8,31,13,12270,11972,9002,-2970
2019,8,31,14,12250,12262,9332,-2930
2019,8,31,15,12450,12461,9572,-2889
2019,8,31,16,12600,12676,9719,-2957
2019,8,31,17,12690,12836,9956,-2880
2019,8,31,18,12910,12954,9944,-3010
2019,8,31,19,13260,13244,10168,-3076
2019,8,31,20,13510,13670,10560,-3110
2019,8,31,21,14030,13987,10920,-3067
2019,8,31,22,14450,14653,11605,-3048
2019,8,31,23,14500,14598,11450,-3148
2019,9,1,0,14350,14486,11334,-3152
2019,9,1,1,14240,14215,11004,-3211
2019,9,1,2,13560,13468,10375,-3093
2019,9,1,3,12610,12492,9477,-3015
2019,9,1,4,11570,11473,8582,-2891
2019,9,1,5,10570,10706,8079,-2627
2019,9,1,6,9970,10637,7887,-2750
2019,9,1,7,9700,10666,7775,-2891
2019,9,1,8,9530,10966,7852,-3114
2019,9,1,9,9430,11032,7917,-3115
2019,9,1,10,9570,11128,7927,-3201
2019,9,1,11,9710,11092,7986,-3106
2019,9,1,12,10050,11101,7924,-3177
2019,9,1,13,10540,11309,8315,-2994
2019,9,1,14,10890,11341,8532,-2809
2019,9,1,15,11040,11515,8729,-2786
2019,9,1,16,11220,11355,8953,-2402
2019,9,1,17,11530,11616,9140,-2476
2019,9,1,18,11660,11878,9257,-2621
2019,9,1,19,11950,12110,9248,-2862
2019,9,1,20,12390,12456,9598,-2858
2019,9,1,21,13040,12865,10071,-2794
2019,9,1,22,13630,13317,10632,-2685
2019,9,1,23,13930,13516,10784,-2732
2019,9,2,0,14210,13584,10761,-2823
2019,9,2,1,13960,13429,10496,-2933
2019,9,2,2,13020,12787,9843,-2944
2019,9,2,3,12010,11969,8913,-3056
2019,9,2,4,11050,11116,7931,-3185
2019,9,2,5,10400,10545,7626,-2919
2019,9,2,6,9850,10247,7435,-2812
2019,9,2,7,9700,10226,7534,-2692
2019,9,2,8,9550,10162,7301,-2861
2019,9,2,9,9630,10435,7494,-2941
2019,9,2,10,9780,10515,7591,-2924
2019,9,2,11,10050,10867,7593,-3274
2019,9,2,12,10480,11194,7869,-3325
2019,9,2,13,11290,11951,8782,-3169
2019,9,2,14,11880,12334,9724,-2610
2019,9,2,15,12350,12709,9958,-2751
2019,9,2,16,12810,13196,10457,-2739
2019,9,2,17,13150,13479,10392,-3087
2019,9,2,18,13260,13755,10546,-3209
2019,9,2,19,13990,13984,10889,-3095
2019,9,2,20,14320,14162,10992,-3170
2019,9,2,21,14620,14603,11659,-2944
2019,9,2,22,14830,15113,12120,-2993
2019,9,2,23,14900,15237,12250,-2987
2019,9,3,0,15060,15351,12344,-3007
2019,9,3,1,14850,15084,12029,-3055
2019,9,3,2,13960,14154,11284,-2870
2019,9,3,3,12830,12990,10024,-2966
2019,9,3,4,11760,11905,8990,-2915
2019,9,3,5,11240,11131,8507,-2624
2019,9,3,6,10700,11060,8268,-2792
2019,9,3,7,10440,10852,8057,-2795
2019,9,3,8,10240,10978,7935,-3043
2019,9,3,9,10340,11147,8002,-3145
2019,9,3,10,11190,11485,8594,-2891
2019,9,3,11,12520,12723,9828,-2895
2019,9,3,12,13430,13460,10550,-2910
2019,9,3,13,13640,13708,10906,-2802
2019,9,3,14,13750,13803,11359,-2444
2019,9,3,15,13910,13983,11926,-2057
2019,9,3,16,14130,14232,12316,-1916
2019,9,3,17,14560,14528,12796,-1732
2019,9,3,18,14990,14972,13359,-1613
2019,9,3,19,15280,15364,13706,-1658
2019,9,3,20,15900,15836,14011,-1825
2019,9,3,21,16660,16392,14245,-2147
2019,9,3,22,17000,16813,14385,-2428
2019,9,3,23,16840,16790,14003,-2787
2019,9,4,0,16870,16663,13602,-3061
2019,9,4,1,16310,16219,13086,-3133
2019,9,4,2,15080,15049,11748,-3301
2019,9,4,3,13610,13605,10262,-3343
2019,9,4,4,12270,12484,9460,-3024
2019,9,4,5,11420,11704,8781,-2923
2019,9,4,6,10920,11426,8418,-3008
2019,9,4,7,10620,11338,8222,-3116
2019,9,4,8,10520,11235,8141,-3094
2019,9,4,9,10820,11466,8393,-3073
2019,9,4,10,11690,11743,9229,-2514
2019,9,4,11,13180,13064,10679,-2385
2019,9,4,12,14170,14062,11533,-2529
2019,9,4,13,14680,14495,12055,-2440
2019,9,4,14,15040,14924,12597,-2327
2019,9,4,15,15290,15238,12818,-2420
2019,9,4,16,15500,15557,13269,-2288
2019,9,4,17,15970,15896,13838,-2058
2019,9,4,18,16330,16403,14251,-2152
2019,9,4,19,16730,16848,14593,-2255
2019,9,4,20,17050,17321,15576,-1745
2019,9,4,21,17250,17874,16200,-1674
2019,9,4,22,17520,18195,16652,-1543
2019,9,4,23,17360,18039,15852,-2187
2019,9,5,0,17500,17896,15344,-2552
2019,9,5,1,16810,17421,14288,-3133
2019,9,5,2,15620,16124,13048,-3076
2019,9,5,3,14220,14488,11038,-3450
2019,9,5,4,12790,12996,9561,-3435
2019,9,5,5,11890,12105,8773,-3332
2019,9,5,6,11160,11471,8583,-2888
2019,9,5,7,10680,11173,8231,-2942
2019,9,5,8,10430,11310,8152,-3158
2019,9,5,9,10500,11811,8442,-3369
2019,9,5,10,11190,11703,8683,-3020
2019,9,5,11,12450,12418,9382,-3036
2019,9,5,12,13080,13074,9969,-3105
2019,9,5,13,13030,13035,10107,-2928
2019,9,5,14,12920,12913,10280,-2633
2019,9,5,15,12950,12942,10113,-2829
2019,9,5,16,13050,13053,10348,-2705
2019,9,5,17,13140,13141,10750,-2391
2019,9,5,18,13380,13377,10803,-2574
2019,9,5,19,13660,13665,11123,-2542
2019,9,5,20,13890,13892,11127,-2765
2019,9,5,21,14310,14295,11687,-2608
2019,9,5,22,14650,14646,11592,-3054
2019,9,5,23,14720,14762,11643,-3119
2019,9,6,0,14760,14941,11559,-3382
2019,9,6,1,14540,14626,11416,-3210
2019,9,6,2,13670,13623,10349,-3274
2019,9,6,3,12470,12509,9284,-3225
2019,9,6,4,11320,11482,8124,-3358
2019,9,6,5,10400,10678,7694,-2984
2019,9,6,6,9910,10396,7400,-2996
2019,9,6,7,9650,10464,7757,-2707
2019,9,6,8,9570,10365,7532,-2833
2019,9,6,9,9780,10562,7739,-2823
2019,9,6,10,10610,11370,8186,-3184
2019,9,6,11,11960,12452,9094,-3358
2019,9,6,12,12730,12995,9638,-3357
2019,9,6,13,12990,12994,9803,-3191
2019,9,6,14,13070,13059,10318,-2741
2019,9,6,15,13140,13166,10482,-2684
2019,9,6,16,13300,13335,10807,-2528
2019,9,6,17,13390,13414,10914,-2500
2019,9,6,18,13560,13474,10915,-2559
2019,9,6,19,13760,13434,10860,-2574
2019,9,6,20,13910,13394,10763,-2631
2019,9,6,21,14040,13568,10593,-2975
2019,9,6,22,14150,13719,10515,-3204
2019,9,6,23,14160,13722,10354,-3368
2019,9,7,0,14250,13780,10225,-3555
2019,9,7,1,13790,13368,10071,-3297
2019,9,7,2,12990,12622,9528,-3094
2019,9,7,3,12030,11696,8391,-3305
2019,9,7,4,11030,10966,7557,-3409
2019,9,7,5,10000,10276,7010,-3266
2019,9,7,6,9550,9996,6959,-3037
2019,9,7,7,9300,9822,6940,-2882
2019,9,7,8,9130,9425,6774,-2651
2019,9,7,9,9160,9687,6798,-2889
2019,9,7,10,9450,10181,6970,-3211
2019,9,7,11,9990,10167,7299,-2868
2019,9,7,12,10620,10599,7497,-3102
2019,9,7,13,11210,11203,8005,-3198
2019,9,7,14,11600,11528,8383,-3145
2019,9,7,15,11710,11574,8461,-3113
2019,9,7,16,11770,11440,8368,-3072
2019,9,7,17,11700,11124,8031,-3093
2019,9,7,18,11570,11043,7918,-3125
2019,9,7,19,11400,11188,8005,-3183
2019,9,7,20,11650,11558,8283,-3275
2019,9,7,21,12090,12109,8589,-3520
2019,9,7,22,12610,12740,9320,-3420
2019,9,7,23,12750,13046,9604,-3442
2019,9,8,0,13000,13239,9719,-3520
2019,9,8,1,12820,12972,9387,-3585
2019,9,8,2,12210,12307,8814,-3493
2019,9,8,3,11380,11450,7762,-3688
2019,9,8,4,10540,10580,7170,-3410
2019,9,8,5,9930,10000,6817,-3183
2019,9,8,6,9490,9695,6392,-3303
2019,9,8,7,9200,9665,6529,-3136
2019,9,8,8,9070,9539,6512,-3027
2019,9,8,9,9050,9511,6419,-3092
2019,9,8,10,9230,9676,6412,-3264
2019,9,8,11,9500,9982,6745,-3237
2019,9,8,12,9910,10241,6793,-3448
2019,9,8,13,10410,10459,6778,-3681
2019,9,8,14,10730,10670,7074,-3596
2019,9,8,15,10860,10669,7478,-3191
2019,9,8,16,10980,10797,7763,-3034
2019,9,8,17,11120,11042,7969,-3073
2019,9,8,18,11280,11265,8272,-2993
2019,9,8,19,11650,11557,8472,-3085
2019,9,8,20,12180,12018,9023,-2995
2019,9,8,21,12910,12723,9555,-3168
2019,9,8,22,13430,13461,10027,-3434
2019,9,8,23,13520,13834,10214,-3620
2019,9,9,0,13750,14138,10612,-3526
2019,9,9,1,13470,13779,10225,-3554
2019,9,9,2,12740,12816,9190,-3626
2019,9,9,3,11650,11747,8155,-3592
2019,9,9,4,10660,10769,7200,-3569
2019,9,9,5,9920,10733,7590,-3143
2019,9,9,6,9490,10606,7569,-3037
2019,9,9,7,9280,10398,7402,-2996
2019,9,9,8,9230,10543,7427,-3116
2019,9,9,9,9470,10439,7272,-3167
2019,9,9,10,10330,10609,7764,-2845
2019,9,9,11,11770,11737,9096,-2641
2019,9,9,12,12550,12491,9856,-2635
2019,9,9,13,12620,12518,9898,-2620
2019,9,9,14,12340,12459,9727,-2732
2019,9,9,15,12340,12558,9806,-2752
2019,9,9,16,12490,12734,10299,-2435
2019,9,9,17,12670,13000,10550,-2450
2019,9,9,18,12830,13315,10649,-2666
2019,9,9,19,13040,13479,10495,-2984
2019,9,9,20,13350,13823,10817,-3006
2019,9,9,21,13890,14281,11269,-3012
2019,9,9,22,14440,14715,11796,-2919
2019,9,9,23,14650,14893,11707,-3186
2019,9,10,0,15000,15112,11843,-3269
2019,9,10,1,14410,14685,11414,-3271
2019,9,10,2,13350,13616,10453,-3163
2019,9,10,3,12050,12328,9302,-3026
2019,9,10,4,10920,11283,8369,-2914
2019,9,10,5,10430,10879,7812,-3067
2019,9,10,6,9960,10681,7639,-3042
2019,9,10,7,9700,10572,7444,-3128
2019,9,10,8,9640,10685,7507,-3178
2019,9,10,9,9860,10712,7448,-3264
2019,9,10,10,10820,11249,8048,-3201
2019,9,10,11,12310,12482,9290,-3192
2019,9,10,12,13170,13027,9892,-3135
2019,9,10,13,13350,13240,10008,-3232
2019,9,10,14,13380,13262,10012,-3250
2019,9,10,15,13460,13395,10363,-3032
2019,9,10,16,13590,13562,10616,-2946
2019,9,10,17,13820,13784,11202,-2582
2019,9,10,18,14110,13997,11435,-2562
2019,9,10,19,14260,14043,11293,-2750
2019,9,10,20,14500,14314,11421,-2893
2019,9,10,21,14980,14550,11673,-2877
2019,9,10,22,15330,14905,11922,-2983
2019,9,10,23,15460,15100,11824,-3276
2019,9,11,0,15570,15395,12077,-3318
2019,9,11,1,15140,14982,11648,-3334
2019,9,11,2,14070,13974,10627,-3347
2019,9,11,3,12770,12722,9262,-3460
2019,9,11,4,11600,11765,8514,-3251
2019,9,11,5,10940,11519,8315,-3204
2019,9,11,6,10520,11576,8344,-3232
2019,9,11,7,10320,11610,8263,-3347
2019,9,11,8,10280,11578,8266,-3312
2019,9,11,9,10510,11624,8220,-3404
2019,9,11,10,11580,11900,9415,-2485
2019,9,11,11,13140,13110,11168,-1942
2019,9,11,12,14110,14097,12124,-1973
2019,9,11,13,14470,14483,12446,-2037
2019,9,11,14,14670,14951,13122,-1829
2019,9,11,15,14900,15200,13384,-1816
2019,9,11,16,15210,14941,13340,-1601
2019,9,11,17,15610,15008,13255,-1753
2019,9,11,18,16160,15813,14219,-1594
2019,9,11,19,16620,16468,15303,-1165
2019,9,11,20,17140,17160,16196,-964
2019,9,11,21,17730,17910,16822,-1088
2019,9,11,22,18150,18452,17352,-1100
2019,9,11,23,18090,18426,16803,-1623
2019,9,12,0,18250,18493,16559,-1934
2019,9,12,1,17650,17945,15925,-2020
2019,9,12,2,16420,16691,14865,-1826
2019,9,12,3,14970,15106,13688,-1418
2019,9,12,4,13530,13716,11935,-1781
2019,9,12,5,12190,12930,10451,-2479
2019,9,12,6,11600,12451,10323,-2128
2019,9,12,7,11090,12067,10224,-1843
2019,9,12,8,10890,12082,10027,-2055
2019,9,12,9,11060,12171,10203,-1968
2019,9,12,10,11970,12462,10634,-1828
2019,9,12,11,13190,13592,11809,-1783
2019,9,12,12,14110,14481,12761,-1720
2019,9,12,13,14360,14857,13272,-1585
2019,9,12,14,14460,15043,13420,-1623
2019,9,12,15,14710,15047,13385,-1662
2019,9,12,16,14810,14938,13718,-1220
2019,9,12,17,14720,14624,13315,-1309
2019,9,12,18,14540,14317,12849,-1468
2019,9,12,19,14380,14008,12725,-1283
2019,9,12,20,13900,13949,12720,-1229
2019,9,12,21,14060,14111,12746,-1365
2019,9,12,22,14290,14299,12805,-1494
2019,9,12,23,14690,14395,12445,-1950
2019,9,13,0,15020,14550,12685,-1865
2019,9,13,1,14130,14084,12170,-1914
2019,9,13,2,12980,13106,10936,-2170
2019,9,13,3,11780,11868,9755,-2113
2019,9,13,4,10750,10983,8732,-2251
2019,9,13,5,10000,10531,8297,-2234
2019,9,13,6,9570,10675,8388,-2287
2019,9,13,7,9320,10630,8148,-2482
2019,9,13,8,9240,10542,8082,-2460
2019,9,13,9,9440,10724,8204,-2520
2019,9,13,10,10270,10920,8176,-2744
2019,9,13,11,11780,11675,9221,-2454
2019,9,13,12,12490,12380,9941,-2439
2019,9,13,13,12560,12280,10140,-2140
2019,9,13,14,12120,12020,10214,-1806
2019,9,13,15,11830,11917,10250,-1667
2019,9,13,16,11750,11941,10428,-1513
2019,9,13,17,11680,11880,10306,-1574
2019,9,13,18,11890,11883,10201,-1682
2019,9,13,19,12270,11903,10231,-1672
2019,9,13,20,12560,12137,10288,-1849
2019,9,13,21,13020,12684,10750,-1934
2019,9,13,22,13460,13237,10274,-2963
2019,9,13,23,13680,13414,10222,-3192
2019,9,14,0,13870,13558,10476,-3082
2019,9,14,1,13500,13144,10085,-3059
2019,9,14,2,12710,12411,9354,-3057
2019,9,14,3,11730,11446,8402,-3044
2019,9,14,4,10740,10661,7678,-2983
2019,9,14,5,9820,10176,7219,-2957
2019,9,14,6,9420,10078,7052,-3026
2019,9,14,7,9180,9851,6974,-2877
2019,9,14,8,9060,9755,6937,-2818
2019,9,14,9,9120,9786,6890,-2896
2019,9,14,10,9440,10128,6971,-3157
2019,9,14,11,10010,10151,7282,-2869
2019,9,14,12,10690,10567,7699,-2868
2019,9,14,13,11270,11289,8591,-2698
2019,9,14,14,11760,11761,9165,-2596
2019,9,14,15,11940,12085,9505,-2580
2019,9,14,16,12050,12265,9535,-2730
2019,9,14,17,12110,12397,9567,-2830
2019,9,14,18,12050,12490,9614,-2876
2019,9,14,19,12110,12473,9741,-2732
2019,9,14,20,12280,12511,9800,-2711
2019,9,14,21,12770,12767,10062,-2705
2019,9,14,22,13190,13140,10410,-2730
2019,9,14,23,13430,13414,10923,-2491
2019,9,15,0,13600,13590,11120,-2470
2019,9,15,1,13330,13210,10710,-2500
2019,9,15,2,12690,12600,10168,-2432
2019,9,15,3,11890,11809,9458,-2351
2019,9,15,4,11070,11020,8471,-2549
2019,9,15,5,10180,10366,8108,-2258
2019,9,15,6,9700,9946,7725,-2221
2019,9,15,7,9430,9966,7743,-2223
2019,9,15,8,9280,9805,7573,-2232
2019,9,15,9,9290,10047,7700,-2347
2019,9,15,10,9440,10233,7786,-2447
2019,9,15,11,9750,10549,8141,-2408
2019,9,15,12,10410,10834,8174,-2660
2019,9,15,13,10810,11052,8517,-2535
2019,9,15,14,10890,11035,8726,-2309
2019,9,15,15,11030,11153,8894,-2259
2019,9,15,16,11340,11343,9254,-2089
2019,9,15,17,11670,11631,9588,-2043
2019,9,15,18,11930,11908,9831,-2077
2019,9,15,19,12360,12282,9975,-2307
2019,9,15,20,13000,12844,10701,-2143
2019,9,15,21,13860,13765,12222,-1543
2019,9,15,22,14410,14584,12897,-1687
2019,9,15,23,14690,14827,12822,-2005
2019,9,16,0,14770,15039,13034,-2005
2019,9,16,1,14420,14515,12502,-2013
2019,9,16,2,13420,13479,11500,-1979
2019,9,16,3,12330,12271,10093,-2178
2019,9,16,4,11250,11486,9282,-2204
2019,9,16,5,10410,10729,8658,-2071
2019,9,16,6,9930,10231,8023,-2208
2019,9,16,7,9680,9983,7940,-2043
2019,9,16,8,9630,10158,7843,-2315
2019,9,16,9,9900,10533,7919,-2614
2019,9,16,10,10810,10952,8429,-2523
2019,9,16,11,12260,12245,9636,-2609
2019,9,16,12,13050,13048,10788,-2260
2019,9,16,13,12990,13002,11035,-1967
2019,9,16,14,12820,12809,10868,-1941
2019,9,16,15,12800,12739,11329,-1410
2019,9,16,16,12800,12783,11320,-1463
2019,9,16,17,12900,12754,11448,-1306
2019,9,16,18,13340,12920,11860,-1060
2019,9,16,19,13540,13071,12722,-349
2019,9,16,20,13880,13428,12941,-487
2019,9,16,21,14350,14025,13320,-705
2019,9,16,22,14820,14746,13672,-1074
2019,9,16,23,14970,15012,13484,-1528
2019,9,17,0,15120,15087,13292,-1795
2019,9,17,1,14340,14426,12839,-1587
2019,9,17,2,13240,13307,11646,-1661
2019,9,17,3,11910,12023,10160,-1863
2019,9,17,4,10730,11032,8562,-2470
2019,9,17,5,10090,10339,7742,-2597
2019,9,17,6,9680,9876,7354,-2522
2019,9,17,7,9420,9872,7207,-2665
2019,9,17,8,9350,9796,7172,-2624
2019,9,17,9,9610,10012,7385,-2627
2019,9,17,10,10470,10691,7971,-2720
2019,9,17,11,11930,12078,9415,-2663
2019,9,17,12,12550,12520,10069,-2451
2019,9,17,13,12320,12373,10208,-2165
2019,9,17,14,12090,12104,9835,-2269
2019,9,17,15,11930,11981,9880,-2101
2019,9,17,16,11990,12082,10201,-1881
2019,9,17,17,12080,12182,10487,-1695
2019,9,17,18,12390,12399,10729,-1670
2019,9,17,19,12570,12584,10813,-1771
2019,9,17,20,12960,12873,11218,-1655
2019,9,17,21,13510,13396,11897,-1499
2019,9,17,22,14100,14007,12254,-1753
2019,9,17,23,14520,14332,12166,-2166
2019,9,18,0,14770,14581,12195,-2386
2019,9,18,1,14110,13972,11445,-2527
2019,9,18,2,13100,12929,9645,-3284
2019,9,18,3,11830,11714,8777,-2937
2019,9,18,4,10720,10862,7799,-3063
2019,9,18,5,9910,10366,7414,-2952
2019,9,18,6,9500,9844,6867,-2977
2019,9,18,7,9320,10068,6938,-3130
2019,9,18,8,9280,9968,6903,-3065
2019,9,18,9,9510,10278,7238,-3040
2019,9,18,10,10370,10685,7573,-3112
2019,9,18,11,11860,11873,8739,-3134
2019,9,18,12,12580,12580,9690,-2890
2019,9,18,13,12500,12504,9921,-2583
2019,9,18,14,12170,12215,9649,-2566
2019,9,18,15,11980,12061,9437,-2624
2019,9,18,16,11950,11993,9487,-2506
2019,9,18,17,11940,11922,9364,-2558
2019,9,18,18,12030,11966,9156,-2810
2019,9,18,19,12130,11871,9181,-2690
2019,9,18,20,12340,12038,9485,-2553
2019,9,18,21,12830,12618,10063,-2555
2019,9,18,22,13450,13345,10698,-2647
2019,9,18,23,13820,13772,11411,-2361
2019,9,19,0,14200,14085,11626,-2459
2019,9,19,1,13620,13552,10781,-2771
2019,9,19,2,12660,12562,9765,-2797
2019,9,19,3,11470,11335,8468,-2867
2019,9,19,4,10380,10310,7327,-2983
2019,9,19,5,9740,9876,7064,-2812
2019,9,19,6,9350,9766,6658,-3108
2019,9,19,7,9160,9817,6504,-3313
2019,9,19,8,9160,9867,6620,-3247
2019,9,19,9,9440,9974,6700,-3274
2019,9,19,10,10390,10347,7157,-3190
2019,9,19,11,11930,11817,8629,-3188
2019,9,19,12,12520,12544,9249,-3295
2019,9,19,13,12230,12266,8939,-3327
2019,9,19,14,11760,11806,8528,-3278
2019,9,19,15,11570,11519,8451,-3068
2019,9,19,16,11460,11387,8336,-3051
2019,9,19,17,11400,11308,8376,-2932
2019,9,19,18,11550,11471,8682,-2789
2019,9,19,19,11740,11622,8821,-2801
2019,9,19,20,12150,12020,9358,-2662
2019,9,19,21,12710,12705,9777,-2928
2019,9,19,22,13390,13470,10194,-3276
2019,9,19,23,13770,13860,10415,-3445
2019,9,20,0,14150,14148,10715,-3433
2019,9,20,1,13590,13637,10086,-3551
2019,9,20,2,12630,12696,9077,-3619
2019,9,20,3,11510,11452,8082,-3370
2019,9,20,4,10430,10450,7151,-3299
2019,9,20,5,9670,10212,6862,-3350
2019,9,20,6,9250,10296,6871,-3425
2019,9,20,7,9060,10205,6868,-3337
2019,9,20,8,9070,10169,6814,-3355
2019,9,20,9,9300,10430,7064,-3366
2019,9,20,10,10170,11011,7762,-3249
2019,9,20,11,11630,11963,8766,-3197
2019,9,20,12,12240,12485,9240,-3245
2019,9,20,13,12060,12277,9206,-3071
2019,9,20,14,11770,11964,9351,-2613
2019,9,20,15,11740,11832,9162,-2670
2019,9,20,16,11730,11819,9491,-2328
2019,9,20,17,11860,11822,9624,-2198
2019,9,20,18,12260,12053,9770,-2283
2019,9,20,19,12550,12349,10132,-2217
2019,9,20,20,12920,12788,10304,-2484
2019,9,20,21,13460,13441,10847,-2594
2019,9,20,22,13980,14049,11222,-2827
2019,9,20,23,14200,14158,11255,-2903
2019,9,21,0,14480,14238,11185,-3053
2019,9,21,1,13770,13695,10746,-2949
2019,9,21,2,12910,13017,10085,-2932
2019,9,21,3,11900,12103,8875,-3228
2019,9,21,4,10880,11101,7870,-3231
2019,9,21,5,10080,10451,7194,-3257
2019,9,21,6,9580,10348,7083,-3265
2019,9,21,7,9310,10335,6805,-3530
2019,9,21,8,9160,10214,6749,-3465
2019,9,21,9,9190,10261,6632,-3629
2019,9,21,10,9560,10527,6817,-3710
2019,9,21,11,10160,10793,6980,-3813
2019,9,21,12,10640,10801,7202,-3599
2019,9,21,13,10940,11047,7836,-3211
2019,9,21,14,11170,11188,8163,-3025
2019,9,21,15,11360,11271,8453,-2818
2019,9,21,16,11560,11395,8934,-2461
2019,9,21,17,11880,11588,9053,-2535
2019,9,21,18,12160,11868,9559,-2309
2019,9,21,19,12590,12310,9866,-2444
2019,9,21,20,13180,12938,10361,-2577
2019,9,21,21,13980,13735,11186,-2549
2019,9,21,22,14470,14414,11713,-2701
2019,9,21,23,14640,14530,11480,-3050
2019,9,22,0,14770,14552,11695,-2857
2019,9,22,1,14120,13975,11080,-2895
2019,9,22,2,13310,13164,10266,-2898
2019,9,22,3,12260,12178,8860,-3318
2019,9,22,4,11200,11211,7760,-3451
2019,9,22,5,10410,10432,7151,-3281
2019,9,22,6,9890,10285,7057,-3228
2019,9,22,7,9540,10098,6768,-3330
2019,9,22,8,9360,10165,6674,-3491
2019,9,22,9,9370,10122,6406,-3716
2019,9,22,10,9510,10270,6458,-3812
2019,9,22,11,9920,10566,7020,-3546
2019,9,22,12,10320,10764,7414,-3350
2019,9,22,13,10710,10767,7494,-3273
2019,9,22,14,10990,11010,7774,-3236
2019,9,22,15,11260,11251,8482,-2769
2019,9,22,16,11720,11697,9156,-2541
2019,9,22,17,12380,12256,9792,-2464
2019,9,22,18,12920,12820,10322,-2498
2019,9,22,19,13390,13427,10871,-2556
2019,9,22,20,14160,14139,11354,-2785
2019,9,22,21,14980,14956,12193,-2763
2019,9,22,22,15610,15668,12719,-2949
2019,9,22,23,15870,15928,12797,-3131
2019,9,23,0,16050,16094,13003,-3091
2019,9,23,1,15390,15482,12455,-3027
2019,9,23,2,14400,14440,11527,-2913
2019,9,23,3,13290,13193,10038,-3155
2019,9,23,4,12180,12078,8781,-3297
2019,9,23,5,11290,11299,8010,-3289
2019,9,23,6,10900,11431,8159,-3272
2019,9,23,7,10620,11391,8197,-3194
2019,9,23,8,10640,11584,8176,-3408
2019,9,23,9,10910,11907,8436,-3471
2019,9,23,10,11990,12461,9136,-3325
2019,9,23,11,13610,13440,10269,-3171
2019,9,23,12,14590,14400,11546,-2854
2019,9,23,13,14940,14802,12146,-2656
2019,9,23,14,15290,15124,12180,-2944
2019,9,23,15,15620,15454,12402,-3052
2019,9,23,16,16140,15969,12939,-3030
2019,9,23,17,16690,16471,13925,-2546
2019,9,23,18,17370,17154,14457,-2697
2019,9,23,19,17890,17761,15260,-2501
2019,9,23,20,18440,18445,15652,-2793
2019,9,23,21,18910,18847,16144,-2703
2019,9,23,22,19220,18921,15956,-2965
2019,9,23,23,19150,18859,15744,-3115
2019,9,24,0,19170,18800,15991,-2809
2019,9,24,1,18160,17985,15030,-2955
2019,9,24,2,16760,16713,13728,-2985
2019,9,24,3,15110,15171,12038,-3133
2019,9,24,4,13630,13728,10719,-3009
2019,9,24,5,12470,12603,9839,-2764
2019,9,24,6,11740,12150,9172,-2978
2019,9,24,7,11370,11989,8966,-3023
2019,9,24,8,11170,11760,8743,-3017
2019,9,24,9,11250,11858,8807,-3051
2019,9,24,10,12030,12320,9249,-3071
2019,9,24,11,13500,13478,10369,-3109
2019,9,24,12,14230,14164,11095,-3069
2019,9,24,13,14330,14232,11227,-3005
2019,9,24,14,14230,14211,11260,-2951
2019,9,24,15,14240,14303,11640,-2663
2019,9,24,16,14390,14493,11707,-2786
2019,9,24,17,14470,14564,11741,-2823
2019,9,24,18,14790,14827,11703,-3124
2019,9,24,19,15040,15069,12102,-2967
2019,9,24,20,15450,15165,12274,-2891
2019,9,24,21,15830,15445,12871,-2574
2019,9,24,22,16080,15672,12820,-2852
2019,9,24,23,16100,15658,12671,-2987
2019,9,25,0,16120,15651,12847,-2804
2019,9,25,1,15240,14864,12225,-2639
2019,9,25,2,13990,13729,10855,-2874
2019,9,25,3,12590,12507,9539,-2968
2019,9,25,4,11360,11506,8389,-3117
2019,9,25,5,10470,11014,8010,-3004
2019,9,25,6,9950,10662,7565,-3097
2019,9,25,7,9650,10597,7254,-3343
2019,9,25,8,9560,10517,7141,-3376
2019,9,25,9,9820,10729,7341,-3388
2019,9,25,10,10660,10998,7911,-3087
2019,9,25,11,12200,12020,8754,-3266
2019,9,25,12,12860,12713,9412,-3301
2019,9,25,13,12630,12602,9455,-3147
2019,9,25,14,12400,12393,9487,-2906
2019,9,25,15,12290,12341,9835,-2506
2019,9,25,16,12350,12471,9996,-2475
2019,9,25,17,12460,12506,10014,-2492
2019,9,25,18,12820,12644,10305,-2339
2019,9,25,19,13130,12827,10539,-2288
2019,9,25,20,13610,13266,11063,-2203
2019,9,25,21,14180,13957,11969,-1988
2019,9,25,22,14780,14635,12651,-1984
2019,9,25,23,15020,14885,12463,-2422
2019,9,26,0,15180,14973,12303,-2670
2019,9,26,1,14550,14269,11404,-2865
2019,9,26,2,13470,13220,10500,-2720
2019,9,26,3,12170,11977,9200,-2777
2019,9,26,4,11030,10871,8226,-2645
2019,9,26,5,10110,10128,7461,-2667
2019,9,26,6,9640,10046,7168,-2878
2019,9,26,7,9420,9966,7039,-2927
2019,9,26,8,9360,9902,6939,-2963
2019,9,26,9,9620,9934,7023,-2911
2019,9,26,10,10520,10740,7789,-2951
2019,9,26,11,12040,12010,9093,-2917
2019,9,26,12,12880,12866,10249,-2617
2019,9,26,13,13010,13020,10372,-2648
2019,9,26,14,12800,12970,10461,-2509
2019,9,26,15,12920,13162,10472,-2690
2019,9,26,16,13090,13325,10559,-2766
2019,9,26,17,13340,13589,11315,-2274
2019,9,26,18,13690,14328,12203,-2125
2019,9,26,19,14050,14780,12472,-2308
2019,9,26,20,14430,15043,12396,-2647
2019,9,26,21,14700,15218,12303,-2915
2019,9,26,22,14960,15396,12491,-2905
2019,9,26,23,15220,15268,12429,-2839
2019,9,27,0,15290,14982,12247,-2735
2019,9,27,1,14520,14275,11667,-2608
2019,9,27,2,13410,13242,10442,-2800
2019,9,27,3,12130,12025,9247,-2778
2019,9,27,4,10950,10925,7871,-3054
2019,9,27,5,10120,10344,7325,-3019
2019,9,27,6,9680,10218,7057,-3161
2019,9,27,7,9420,10197,7113,-3084
2019,9,27,8,9340,10157,7002,-3155
2019,9,27,9,9580,10354,7064,-3290
2019,9,27,10,10450,10684,7317,-3367
2019,9,27,11,11950,11847,8766,-3081
2019,9,27,12,12590,12529,9698,-2831
2019,9,27,13,12430,12457,9684,-2773
2019,9,27,14,12130,12163,9553,-2610
2019,9,27,15,12030,11992,9266,-2726
2019,9,27,16,11970,11948,9277,-2671
2019,9,27,17,12000,11946,9283,-2663
2019,9,27,18,12230,12142,9640,-2502
2019,9,27,19,12510,12353,9925,-2428
2019,9,27,20,12990,12772,10224,-2548
2019,9,27,21,13550,13393,10946,-2447
2019,9,27,22,13960,13917,11082,-2835
2019,9,27,23,14120,14051,11170,-2881
2019,9,28,0,14230,14030,11178,-2852
2019,9,28,1,13640,13406,10495,-2911
2019,9,28,2,12780,12613,9820,-2793
2019,9,28,3,11770,11622,8767,-2855
2019,9,28,4,10760,10610,7841,-2769
2019,9,28,5,9880,9993,7401,-2592
2019,9,28,6,9400,9404,6895,-2509
2019,9,28,7,9150,9337,6724,-2613
2019,9,28,8,9020,9480,7032,-2448
2019,9,28,9,9080,9355,6884,-2471
2019,9,28,10,9410,9688,6859,-2829
2019,9,28,11,10010,9995,7409,-2586
2019,9,28,12,10640,10619,8156,-2463
2019,9,28,13,11150,11149,8484,-2665
2019,9,28,14,11340,11320,8605,-2715
2019,9,28,15,11320,11246,8842,-2404
2019,9,28,16,11350,11231,9095,-2136
2019,9,28,17,11390,11307,9037,-2270
2019,9,28,18,11560,11512,9380,-2132
2019,9,28,19,11860,11887,9760,-2127
2019,9,28,20,12320,12504,10448,-2056
2019,9,28,21,13110,13265,11136,-2129
2019,9,28,22,13620,13865,11609,-2256
2019,9,28,23,14110,14118,11782,-2336
2019,9,29,0,14210,14201,12076,-2125
2019,9,29,1,13710,13735,11564,-2171
2019,9,29,2,12910,13083,11023,-2060
2019,9,29,3,12050,12248,10255,-1993
2019,9,29,4,11290,11435,8909,-2526
2019,9,29,5,10760,10779,8096,-2683
2019,9,29,6,10270,10303,7780,-2523
2019,9,29,7,9960,9998,7648,-2350
2019,9,29,8,9770,9811,7528,-2283
2019,9,29,9,9720,9769,7475,-2294
2019,9,29,10,9900,9909,7521,-2388
2019,9,29,11,10240,10384,7839,-2545
2019,9,29,12,10630,10947,8445,-2502
2019,9,29,13,10980,11163,8924,-2239
2019,9,29,14,11030,11385,9017,-2368
2019,9,29,15,11040,11365,9022,-2343
2019,9,29,16,11090,11398,9123,-2275
2019,9,29,17,11270,11636,9000,-2636
2019,9,29,18,11450,11544,9215,-2329
2019,9,29,19,11550,11934,9608,-2326
2019,9,29,20,11970,12480,10136,-2344
2019,9,29,21,12580,13087,10560,-2527
2019,9,29,22,13270,13576,11027,-2549
2019,9,29,23,13660,13887,11310,-2577
2019,9,30,0,13810,13922,11446,-2476
2019,9,30,1,13200,13231,10659,-2572
2019,9,30,2,12240,12253,9568,-2685
2019,9,30,3,11220,11386,8906,-2480
2019,9,30,4,10200,10651,8061,-2590
2019,9,30,5,9600,10323,7759,-2564
2019,9,30,6,9230,9936,7398,-2538
2019,9,30,7,9050,9739,7372,-2367
2019,9,30,8,8900,9706,7318,-2388
2019,9,30,9,9220,9966,7749,-2217
2019,9,30,10,10140,10690,8765,-1925
2019,9,30,11,11710,11534,10337,-1197
2019,9,30,12,12390,12285,11302,-983
2019,9,30,13,12210,12267,11429,-838
2019,9,30,14,11920,11941,11275,-666
2019,9,30,15,11790,11854,11322,-532
2019,9,30,16,11780,11956,11516,-440
2019,9,30,17,11770,11985,11703,-282
2019,9,30,18,11920,12021,11578,-443
2019,9,30,19,12070,12118,11754,-364
2019,9,30,20,12530,12414,11996,-418
2019,9,30,21,13180,13029,12369,-660
2019,9,30,22,13870,13806,13098,-708
2019,9,30,23,14330,14328,13532,-796
2019,10,1,0,14500,14367,13664,-703
2019,10,1,1,13840,13657,12906,-751
2019,10,1,2,12760,12672,12011,-661
2019,10,1,3,11530,11472,10658,-814
2019,10,1,4,10460,10435,9622,-813
2019,10,1,5,9770,9766,8723,-1043
2019,10,1,6,9360,9657,8610,-1047
2019,10,1,7,9170,9469,8326,-1143
2019,10,1,8,9140,9437,8292,-1145
2019,10,1,9,9430,9706,8592,-1114
2019,10,1,10,10360,10621,9539,-1082
2019,10,1,11,11990,11946,10915,-1031
2019,10,1,12,13030,13015,11997,-1018
2019,10,1,13,13440,13454,12556,-898
2019,10,1,14,13620,13620,12763,-857
2019,10,1,15,13620,13698,12858,-840
2019,10,1,16,13600,13777,12924,-853
2019,10,1,17,13600,13616,12881,-735
2019,10,1,18,13600,13591,13069,-522
2019,10,1,19,13600,13607,13316,-291
2019,10,1,20,13660,13799,13683,-116
2019,10,1,21,14050,14140,14375,235
2019,10,1,22,14550,14667,14880,213
2019,10,1,23,15150,15053,14863,-190
2019,10,2,0,15100,15153,14821,-332
2019,10,2,1,14540,14575,13763,-812
2019,10,2,2,13560,13609,12959,-650
2019,10,2,3,12330,12644,11823,-821
2019,10,2,4,11310,11798,10940,-858
2019,10,2,5,10680,10806,9959,-847
2019,10,2,6,10300,10852,9782,-1070
2019,10,2,7,10110,10669,9405,-1264
2019,10,2,8,10130,10679,9386,-1293
2019,10,2,9,10440,10975,9694,-1281
2019,10,2,10,11420,11677,10446,-1231
2019,10,2,11,13150,13103,11949,-1154
2019,10,2,12,14170,14151,12894,-1257
2019,10,2,13,14450,14443,13665,-778
2019,10,2,14,14890,14884,14185,-699
2019,10,2,15,15320,15335,14665,-670
2019,10,2,16,15520,15510,14891,-619
2019,10,2,17,15480,15483,14979,-504
2019,10,2,18,15680,15691,15718,27
2019,10,2,19,15950,15950,16111,161
2019,10,2,20,15880,15825,15662,-163
2019,10,2,21,15900,15826,15519,-307
2019,10,2,22,15710,15877,15416,-461
2019,10,2,23,15520,15860,15151,-709
2019,10,3,0,15120,15552,14663,-889
2019,10,3,1,14230,14725,13752,-973
2019,10,3,2,13060,13581,12585,-996
2019,10,3,3,11760,12182,11143,-1039
2019,10,3,4,10540,10953,9851,-1102
2019,10,3,5,10080,10397,9272,-1125
2019,10,3,6,9630,10312,9310,-1002
2019,10,3,7,9440,10195,8946,-1249
2019,10,3,8,9390,10109,8779,-1330
2019,10,3,9,9690,10258,8856,-1402
2019,10,3,10,10610,10936,9607,-1329
2019,10,3,11,12280,11949,10858,-1091
2019,10,3,12,13110,12834,11779,-1055
2019,10,3,13,12980,12966,12078,-888
2019,10,3,14,12880,12862,11972,-890
2019,10,3,15,12870,12805,12076,-729
2019,10,3,16,12930,12827,12114,-713
2019,10,3,17,12990,12930,12222,-708
2019,10,3,18,13200,12985,12407,-578
2019,10,3,19,13140,12932,12166,-766
2019,10,3,20,13260,12938,12404,-534
2019,10,3,21,13550,13161,12636,-525
2019,10,3,22,13990,13681,12944,-737
2019,10,3,23,14550,14183,13358,-825
2019,10,4,0,14410,14108,13316,-792
2019,10,4,1,13750,13547,12712,-835
2019,10,4,2,12860,12661,11664,-997
2019,10,4,3,11700,11515,10474,-1041
2019,10,4,4,10680,10505,9570,-935
2019,10,4,5,9820,9825,8868,-957
2019,10,4,6,9410,9697,8738,-959
2019,10,4,7,9190,9747,8763,-984
2019,10,4,8,9150,9728,8781,-947
2019,10,4,9,9400,9964,9015,-949
2019,10,4,10,10270,10788,9941,-847
2019,10,4,11,11840,11902,11134,-768
2019,10,4,12,12690,12745,11794,-951
2019,10,4,13,12580,12720,11641,-1079
2019,10,4,14,12520,12532,11537,-995
2019,10,4,15,12250,12489,11690,-799
2019,10,4,16,11970,12425,11634,-791
2019,10,4,17,11730,12316,11533,-783
2019,10,4,18,11680,12195,11565,-630
2019,10,4,19,11600,11882,11227,-655
2019,10,4,20,11770,11769,11052,-717
2019,10,4,21,12250,12270,11417,-853
2019,10,4,22,12930,13004,11929,-1075
2019,10,4,23,13550,13532,12335,-1197
2019,10,5,0,13580,13587,12464,-1123
2019,10,5,1,13020,13076,12177,-899
2019,10,5,2,12330,12384,11440,-944
2019,10,5,3,11430,11450,10617,-833
2019,10,5,4,10490,10748,9591,-1157
2019,10,5,5,9890,9884,8765,-1119
2019,10,5,6,9470,9441,8457,-984
2019,10,5,7,9280,9516,8420,-1096
2019,10,5,8,9220,9469,8360,-1109
2019,10,5,9,9340,9569,8439,-1130
2019,10,5,10,9730,9965,8824,-1141
2019,10,5,11,10370,10373,9313,-1060
2019,10,5,12,10910,11044,9769,-1275
2019,10,5,13,11220,11206,9944,-1262
2019,10,5,14,10820,10835,9612,-1223
2019,10,5,15,10300,10553,9552,-1001
2019,10,5,16,9930,10320,9515,-805
2019,10,5,17,9700,10034,9264,-770
2019,10,5,18,9550,10055,9266,-789
2019,10,5,19,9610,10191,9616,-575
2019,10,5,20,10070,10503,9880,-623
2019,10,5,21,10840,11147,10395,-752
2019,10,5,22,11860,12090,11044,-1046
2019,10,5,23,12560,12630,11435,-1195
2019,10,6,0,12770,12789,11690,-1099
2019,10,6,1,12370,12377,11060,-1317
2019,10,6,2,11810,11808,10336,-1472
2019,10,6,3,11080,11057,9739,-1318
2019,10,6,4,10290,10268,8694,-1574
2019,10,6,5,9570,9667,8493,-1174
2019,10,6,6,9220,9301,8164,-1137
2019,10,6,7,9020,9346,8209,-1137
2019,10,6,8,8930,9271,7942,-1329
2019,10,6,9,8990,9439,8012,-1427
2019,10,6,10,9210,9775,8287,-1488
2019,10,6,11,9620,10107,8420,-1687
2019,10,6,12,10110,10648,9366,-1282
2019,10,6,13,10810,11075,9950,-1125
2019,10,6,14,11020,11042,9843,-1199
2019,10,6,15,11230,11379,9991,-1388
2019,10,6,16,11470,11871,10775,-1096
2019,10,6,17,11650,11990,10950,-1040
2019,10,6,18,11780,12183,11143,-1040
2019,10,6,19,11800,12250,11116,-1134
2019,10,6,20,11900,12425,10971,-1454
2019,10,6,21,12270,12835,11026,-1809
2019,10,6,22,12920,13324,11375,-1949
2019,10,6,23,13520,13755,11698,-2057
2019,10,7,0,13350,13673,11709,-1964
2019,10,7,1,12770,13091,11290,-1801
2019,10,7,2,11960,12194,10792,-1402
2019,10,7,3,10950,11265,9805,-1460
2019,10,7,4,10090,10538,9093,-1445
2019,10,7,5,9670,9996,8526,-1470
2019,10,7,6,9360,9872,8598,-1274
2019,10,7,7,9210,9730,8411,-1319
2019,10,7,8,9240,9745,8519,-1226
2019,10,7,9,9540,9811,8664,-1147
2019,10,7,10,10530,10622,9380,-1242
2019,10,7,11,12370,12160,10900,-1260
2019,10,7,12,13420,13230,11846,-1384
2019,10,7,13,13680,13473,11914,-1559
2019,10,7,14,13600,13561,12242,-1319
2019,10,7,15,13830,13604,12683,-921
2019,10,7,16,14040,13655,12589,-1066
2019,10,7,17,14140,13694,12725,-969
2019,10,7,18,14210,13927,12999,-928
2019,10,7,19,14250,13997,13024,-973
2019,10,7,20,14360,14173,12942,-1231
2019,10,7,21,14580,14499,12990,-1509
2019,10,7,22,15000,14928,13419,-1509
2019,10,7,23,15430,15311,13649,-1662
2019,10,8,0,15320,15081,13521,-1560
2019,10,8,1,14330,14280,12719,-1561
2019,10,8,2,13060,13192,11389,-1803
2019,10,8,3,11820,11941,10309,-1632
2019,10,8,4,10710,11004,9285,-1719
2019,10,8,5,10090,10636,8979,-1657
2019,10,8,6,9690,10067,8738,-1329
2019,10,8,7,9430,10111,8526,-1585
2019,10,8,8,9360,10112,8410,-1702
2019,10,8,9,9530,10325,8663,-1662
2019,10,8,10,10450,10578,8737,-1841
2019,10,8,11,12130,11999,10115,-1884
2019,10,8,12,13080,13006,11066,-1940
2019,10,8,13,13060,13230,11353,-1877
2019,10,8,14,13130,13158,11388,-1770
2019,10,8,15,13000,13070,11362,-1708
2019,10,8,16,12850,12987,11357,-1630
2019,10,8,17,12780,12758,11378,-1380
2019,10,8,18,12870,12678,11146,-1532
2019,10,8,19,13000,12712,11255,-1457
2019,10,8,20,13240,12872,11367,-1505
2019,10,8,21,13510,13214,11697,-1517
2019,10,8,22,14090,13705,12109,-1596
2019,10,8,23,14690,14275,12439,-1836
2019,10,9,0,14610,14194,12400,-1794
2019,10,9,1,13870,13523,11813,-1710
2019,10,9,2,12880,12590,10900,-1690
2019,10,9,3,11640,11450,9569,-1881
2019,10,9,4,10600,10689,8796,-1893
2019,10,9,5,9810,10023,8123,-1900
2019,10,9,6,9380,9880,7990,-1890
2019,10,9,7,9210,9671,7902,-1769
2019,10,9,8,9120,9635,7800,-1835
2019,10,9,9,9440,9912,8087,-1825
2019,10,9,10,10370,10333,8835,-1498
2019,10,9,11,12050,11853,10329,-1524
2019,10,9,12,12910,12820,11106,-1714
2019,10,9,13,12920,13059,11279,-1780
2019,10,9,14,13000,13126,11325,-1801
2019,10,9,15,12980,13266,11777,-1489
2019,10,9,16,12930,13357,11643,-1714
2019,10,9,17,12910,13366,11918,-1448
2019,10,9,18,12980,13381,11952,-1429
2019,10,9,19,12970,13329,11738,-1591
2019,10,9,20,13050,13353,11846,-1507
2019,10,9,21,13500,13652,12207,-1445
2019,10,9,22,14040,14099,12434,-1665
2019,10,9,23,14550,14544,12989,-1555
2019,10,10,0,14410,14345,12770,-1575
2019,10,10,1,13680,13702,12298,-1404
2019,10,10,2,12730,12775,11206,-1569
2019,10,10,3,11560,11573,10057,-1516
2019,10,10,4,10550,10532,8929,-1603
2019,10,10,5,9840,9980,8613,-1367
2019,10,10,6,9450,9867,8491,-1376
2019,10,10,7,9270,10005,8516,-1489
2019,10,10,8,9260,10030,8501,-1529
2019,10,10,9,9530,10113,8741,-1372
2019,10,10,10,10460,10575,9252,-1323
2019,10,10,11,12130,12088,10614,-1474
2019,10,10,12,13060,13059,11648,-1411
2019,10,10,13,13180,13181,11835,-1346
2019,10,10,14,13090,13095,11782,-1313
2019,10,10,15,13190,12981,11504,-1477
2019,10,10,16,13280,12857,11357,-1500
2019,10,10,17,13330,12759,11135,-1624
2019,10,10,18,13430,12821,11193,-1628
2019,10,10,19,13470,12854,11174,-1680
2019,10,10,20,13500,13016,11450,-1566
2019,10,10,21,13740,13345,11812,-1533
2019,10,10,22,14150,13835,12341,-1494
2019,10,10,23,14590,14371,12717,-1654
2019,10,11,0,14420,14300,12663,-1637
2019,10,11,1,13700,13684,12075,-1609
2019,10,11,2,12770,12773,11093,-1680
2019,10,11,3,11690,11708,9990,-1718
2019,10,11,4,10680,10717,8961,-1756
2019,10,11,5,9820,10171,8299,-1872
2019,10,11,6,9420,9870,7889,-1981
2019,10,11,7,9200,10075,8155,-1920
2019,10,11,8,9120,10034,8131,-1903
2019,10,11,9,9450,10297,8315,-1982
2019,10,11,10,10310,10700,8880,-1820
2019,10,11,11,11900,11924,10366,-1558
2019,10,11,12,12780,12913,11498,-1415
2019,10,11,13,13040,13156,11701,-1455
2019,10,11,14,13070,13084,11572,-1512
2019,10,11,15,12860,12970,11538,-1432
2019,10,11,16,12890,12970,11787,-1183
2019,10,11,17,12860,13221,11859,-1362
2019,10,11,18,12930,12950,11612,-1338
2019,10,11,19,12870,12874,11421,-1453
2019,10,11,20,12960,12888,11425,-1463
2019,10,11,21,13260,13091,11860,-1231
2019,10,11,22,13670,13504,11927,-1577
2019,10,11,23,13950,13936,12318,-1618
2019,10,12,0,13800,13766,12158,-1608
2019,10,12,1,13120,13245,11529,-1716
2019,10,12,2,12380,12520,10646,-1874
2019,10,12,3,11460,11568,9675,-1893
2019,10,12,4,10530,10611,8723,-1888
2019,10,12,5,9880,9928,7716,-2212
2019,10,12,6,9440,9759,7765,-1994
2019,10,12,7,9210,9757,7795,-1962
2019,10,12,8,9120,9639,7676,-1963
2019,10,12,9,9190,9707,7812,-1895
2019,10,12,10,9510,9777,8105,-1672
2019,10,12,11,10180,10424,9040,-1384
2019,10,12,12,10880,11141,9641,-1500
2019,10,12,13,11590,11935,10225,-1710
2019,10,12,14,11980,11953,10283,-1670
2019,10,12,15,11990,12063,10458,-1605
2019,10,12,16,11820,11917,10248,-1669
2019,10,12,17,11600,11697,10103,-1594
2019,10,12,18,11280,11827,10295,-1532
2019,10,12,19,11180,11522,10247,-1275
2019,10,12,20,11310,11512,10276,-1236
2019,10,12,21,11810,11901,10512,-1389
2019,10,12,22,12410,12431,10895,-1536
2019,10,12,23,13000,12945,11369,-1576
2019,10,13,0,12870,12831,11333,-1498
2019,10,13,1,12370,12412,10916,-1496
2019,10,13,2,11750,11806,10340,-1466
2019,10,13,3,10980,11038,9719,-1319
2019,10,13,4,10190,10221,8775,-1446
2019,10,13,5,9560,9937,8357,-1580
2019,10,13,6,9220,10046,8355,-1691
2019,10,13,7,8960,9788,8292,-1496
2019,10,13,8,8870,9689,8379,-1310
2019,10,13,9,8900,9915,8663,-1252
2019,10,13,10,9120,10099,8742,-1357
2019,10,13,11,9530,10104,8900,-1204
2019,10,13,12,10090,10532,9488,-1044
2019,10,13,13,10440,10615,9332,-1283
2019,10,13,14,10470,10483,9337,-1146
2019,10,13,15,10330,10587,9213,-1374
2019,10,13,16,10180,10142,9114,-1028
2019,10,13,17,10150,10143,9315,-828
2019,10,13,18,10220,10152,9262,-890
2019,10,13,19,10470,10317,9336,-981
2019,10,13,20,10950,10796,9817,-979
2019,10,13,21,11650,11386,10348,-1038
2019,10,13,22,12590,12241,10560,-1681
2019,10,13,23,13250,12964,10879,-2085
2019,10,14,0,13170,12883,10788,-2095
2019,10,14,1,12690,12365,10404,-1961
2019,10,14,2,11820,11744,9648,-2096
2019,10,14,3,10850,11059,9076,-1983
2019,10,14,4,9940,10270,8315,-1955
2019,10,14,5,9410,9713,7962,-1751
2019,10,14,6,9040,9338,7702,-1636
2019,10,14,7,8890,9368,7869,-1499
2019,10,14,8,8900,9439,8064,-1375
2019,10,14,9,9170,9692,8250,-1442
2019,10,14,10,9950,10109,8534,-1575
2019,10,14,11,11220,11231,9507,-1724
2019,10,14,12,12330,12193,10443,-1750
2019,10,14,13,12310,12427,11036,-1391
2019,10,14,14,12110,12355,10996,-1359
2019,10,14,15,12050,12264,10853,-1411
2019,10,14,16,11910,12104,10720,-1384
2019,10,14,17,11860,12066,10775,-1291
2019,10,14,18,12090,11992,10654,-1338
2019,10,14,19,12240,11996,10843,-1153
2019,10,14,20,12550,12372,11341,-1031
2019,10,14,21,13140,13026,11753,-1273
2019,10,14,22,13910,13851,12514,-1337
2019,10,14,23,14500,14408,12605,-1803
2019,10,15,0,14330,14206,12651,-1555
2019,10,15,1,13620,13527,11800,-1727
2019,10,15,2,12630,12532,10648,-1884
2019,10,15,3,11430,11341,9496,-1845
2019,10,15,4,10400,10330,8288,-2042
2019,10,15,5,9670,9624,7471,-2153
2019,10,15,6,9290,9480,7449,-2031
2019,10,15,7,9090,9328,7156,-2172
2019,10,15,8,9080,9290,7197,-2093
2019,10,15,9,9390,9584,7661,-1923
2019,10,15,10,10340,10227,8404,-1823
2019,10,15,11,12020,11929,9981,-1948
2019,10,15,12,12780,12820,10935,-1885
2019,10,15,13,12390,12549,10756,-1793
2019,10,15,14,11830,11951,10289,-1662
2019,10,15,15,11510,11453,10077,-1376
2019,10,15,16,11330,11288,9673,-1615
2019,10,15,17,11190,11156,9541,-1615
2019,10,15,18,11300,11233,9509,-1724
2019,10,15,19,11450,11398,9731,-1667
2019,10,15,20,11850,11795,9975,-1820
2019,10,15,21,12620,12502,10638,-1864
2019,10,15,22,13520,13447,11602,-1845
2019,10,15,23,14210,14234,12123,-2111
2019,10,16,0,14240,14162,12247,-1915
2019,10,16,1,13610,13512,11529,-1983
2019,10,16,2,12650,12573,10689,-1884
2019,10,16,3,11490,11413,9134,-2279
2019,10,16,4,10480,10504,7874,-2630
2019,10,16,5,9810,10111,7884,-2227
2019,10,16,6,9440,10020,8022,-1998
2019,10,16,7,9270,9854,7874,-1980
2019,10,16,8,9280,9855,7950,-1905
2019,10,16,9,9610,10164,8171,-1993
2019,10,16,10,10600,10754,8861,-1893
2019,10,16,11,12320,12342,10331,-2011
2019,10,16,12,13120,13238,11183,-2055
2019,10,16,13,12840,12942,10926,-2016
2019,10,16,14,12410,12424,10458,-1966
2019,10,16,15,12160,12161,10453,-1708
2019,10,16,16,12030,12296,10827,-1469
2019,10,16,17,11980,12485,11281,-1204
2019,10,16,18,12110,12635,11308,-1327
2019,10,16,19,12250,12922,11540,-1382
2019,10,16,20,13080,13213,11713,-1500
2019,10,16,21,13450,13667,12021,-1646
2019,10,16,22,13990,14284,12424,-1860
2019,10,16,23,14490,14736,12800,-1936
2019,10,17,0,14220,14427,12565,-1862
2019,10,17,1,13590,13772,12041,-1731
2019,10,17,2,12660,12807,11007,-1800
2019,10,17,3,11490,11631,9653,-1978
2019,10,17,4,10420,10574,8691,-1883
2019,10,17,5,9750,9948,8005,-1943
2019,10,17,6,9340,9705,7776,-1929
2019,10,17,7,9130,9660,7664,-1996
2019,10,17,8,9040,9684,7702,-1982
2019,10,17,9,9230,10008,7961,-2047
2019,10,17,10,10210,10280,8251,-2029
2019,10,17,11,11890,11672,9581,-2091
2019,10,17,12,12820,12302,10290,-2012
2019,10,17,13,12900,12512,10771,-1741
2019,10,17,14,12450,12453,10876,-1577
2019,10,17,15,12600,12432,10939,-1493
2019,10,17,16,12710,12623,11180,-1443
2019,10,17,17,12690,12696,11142,-1554
2019,10,17,18,12650,12807,11189,-1618
2019,10,17,19,12560,12828,11313,-1515
2019,10,17,20,13000,12848,11296,-1552
2019,10,17,21,13400,13101,11373,-1728
2019,10,17,22,14060,13628,11619,-2009
2019,10,17,23,14590,14178,12088,-2090
2019,10,18,0,14290,14000,12215,-1785
2019,10,18,1,13640,13434,11571,-1863
2019,10,18,2,12780,12532,10594,-1938
2019,10,18,3,11660,11664,9274,-2390
2019,10,18,4,10620,10708,8292,-2416
2019,10,18,5,9980,10084,7573,-2511
2019,10,18,6,9570,9928,7710,-2218
2019,10,18,7,9370,9853,7669,-2184
2019,10,18,8,9320,9978,7868,-2110
2019,10,18,9,9590,10218,8092,-2126
2019,10,18,10,10510,10355,8689,-1666
2019,10,18,11,12220,11924,9979,-1945
2019,10,18,12,13140,12890,11112,-1778
2019,10,18,13,12930,12957,11198,-1759
2019,10,18,14,12800,12834,11051,-1783
2019,10,18,15,12690,12623,11234,-1389
2019,10,18,16,12560,12347,10934,-1413
2019,10,18,17,12400,12044,10572,-1472
2019,10,18,18,12340,11937,10529,-1408
2019,10,18,19,12350,11907,10672,-1235
2019,10,18,20,12590,12079,10779,-1300
2019,10,18,21,13010,12558,10801,-1757
2019,10,18,22,13640,13184,11498,-1686
2019,10,18,23,13920,13767,12134,-1633
2019,10,19,0,13900,13573,11820,-1753
2019,10,19,1,13430,13060,11395,-1665
2019,10,19,2,12730,12394,10733,-1661
2019,10,19,3,11750,11463,9682,-1781
2019,10,19,4,10760,10534,8709,-1825
2019,10,19,5,9930,10034,8410,-1624
2019,10,19,6,9510,9782,8511,-1271
2019,10,19,7,9300,9568,8236,-1332
2019,10,19,8,9250,9914,8249,-1665
2019,10,19,9,9350,10142,8689,-1453
2019,10,19,10,9750,10085,8816,-1269
2019,10,19,11,10420,10536,9364,-1172
2019,10,19,12,11070,11249,10321,-928
2019,10,19,13,11200,11458,10273,-1185
2019,10,19,14,11050,11085,9798,-1287
2019,10,19,15,10600,10621,9648,-973
2019,10,19,16,10240,10632,9506,-1126
2019,10,19,17,9900,10602,9620,-982
2019,10,19,18,9760,10590,9508,-1082
2019,10,19,19,9810,10659,9482,-1177
2019,10,19,20,10310,10803,9636,-1167
2019,10,19,21,11100,11144,9957,-1187
2019,10,19,22,12070,12105,10694,-1411
2019,10,19,23,12830,12822,11324,-1498
2019,10,20,0,12760,12712,11321,-1391
2019,10,20,1,12350,12310,10726,-1584
2019,10,20,2,11770,11771,10168,-1603
2019,10,20,3,11090,11045,9505,-1540
2019,10,20,4,10330,10456,8649,-1807
2019,10,20,5,9710,10189,8115,-2074
2019,10,20,6,9320,10312,8261,-2051
2019,10,20,7,9140,10225,8491,-1734
2019,10,20,8,9060,10158,8286,-1872
2019,10,20,9,9150,10241,8203,-2038
2019,10,20,10,9410,10287,8259,-2028
2019,10,20,11,9950,10509,8673,-1836
2019,10,20,12,10440,10949,9032,-1917
2019,10,20,13,10880,11304,9393,-1911
2019,10,20,14,10940,11330,10024,-1306
2019,10,20,15,10970,11074,9958,-1116
2019,10,20,16,10910,10972,9906,-1066
2019,10,20,17,10960,10884,10019,-865
2019,10,20,18,11060,11185,10161,-1024
2019,10,20,19,11220,11495,10424,-1071
2019,10,20,20,11510,11857,10397,-1460
2019,10,20,21,12070,12435,10775,-1660
2019,10,20,22,12900,13163,11311,-1852
2019,10,20,23,13520,13745,11820,-1925
2019,10,21,0,13310,13446,11573,-1873
2019,10,21,1,12770,12822,10915,-1907
2019,10,21,2,11930,11946,10249,-1697
2019,10,21,3,10950,11152,9168,-1984
2019,10,21,4,10080,10218,8339,-1879
2019,10,21,5,9370,9377,7418,-1959
2019,10,21,6,9060,9630,7676,-1954
2019,10,21,7,8930,9732,7761,-1971
2019,10,21,8,8950,9727,7780,-1947
2019,10,21,9,9280,9816,7919,-1897
2019,10,21,10,10270,10284,8567,-1717
2019,10,21,11,12030,12010,10666,-1344
2019,10,21,12,13020,13007,11507,-1500
2019,10,21,13,12980,13003,11464,-1539
2019,10,21,14,12550,12586,11129,-1457
2019,10,21,15,12100,12029,10476,-1553
2019,10,21,16,11850,11655,10436,-1219
2019,10,21,17,11670,11446,10543,-903
2019,10,21,18,11710,11433,10572,-861
2019,10,21,19,11830,11520,10112,-1408
2019,10,21,20,12240,11947,10267,-1680
2019,10,21,21,12970,12714,10667,-2047
2019,10,21,22,13860,13593,11316,-2277
2019,10,21,23,14580,14332,12102,-2230
2019,10,22,0,14400,14105,11991,-2114
2019,10,22,1,13660,13452,11035,-2417
2019,10,22,2,12660,12492,10356,-2136
2019,10,22,3,11480,11664,9338,-2326
2019,10,22,4,10430,10920,8493,-2427
2019,10,22,5,9670,10205,7475,-2730
2019,10,22,6,9310,9932,7302,-2630
2019,10,22,7,9140,9911,7376,-2535
2019,10,22,8,9140,9905,7460,-2445
2019,10,22,9,9440,10197,7705,-2492
2019,10,22,10,10400,11143,8499,-2644
2019,10,22,11,12110,12307,9848,-2459
2019,10,22,12,13090,13079,10858,-2221
2019,10,22,13,13190,13206,11092,-2114
2019,10,22,14,13030,13060,11136,-1924
2019,10,22,15,12950,12913,11340,-1573
2019,10,22,16,12910,13025,11342,-1683
2019,10,22,17,12870,13146,11446,-1700
2019,10,22,18,12950,13314,11586,-1728
2019,10,22,19,13030,13313,11595,-1718
2019,10,22,20,13210,13381,11528,-1853
2019,10,22,21,13640,13680,11739,-1941
2019,10,22,22,14250,14305,11944,-2361
2019,10,22,23,14760,14682,12844,-1838
2019,10,23,0,14410,14333,12744,-1589
2019,10,23,1,13660,13673,11944,-1729
2019,10,23,2,12680,12694,10872,-1822
2019,10,23,3,11510,11553,9223,-2330
2019,10,23,4,10480,10717,8329,-2388
2019,10,23,5,9770,10284,7555,-2729
2019,10,23,6,9410,9869,7604,-2265
2019,10,23,7,9220,9489,7496,-1993
2019,10,23,8,9200,9450,7375,-2075
2019,10,23,9,9470,9711,7681,-2030
2019,10,23,10,10410,10501,8302,-2199
2019,10,23,11,12080,12049,9977,-2072
2019,10,23,12,13130,13119,10596,-2523
2019,10,23,13,13180,13197,10725,-2472
2019,10,23,14,12640,12763,10217,-2546
2019,10,23,15,12240,12312,9603,-2709
2019,10,23,16,11900,12122,9618,-2504
2019,10,23,17,11640,11829,9358,-2471
2019,10,23,18,11640,11836,9385,-2451
2019,10,23,19,11750,12083,9246,-2837
2019,10,23,20,12180,12144,9922,-2222
2019,10,23,21,12840,12766,9925,-2841
2019,10,23,22,13650,13563,10654,-2909
2019,10,23,23,14280,14213,11765,-2448
2019,10,24,0,14120,14026,11424,-2602
2019,10,24,1,13530,13406,10733,-2673
2019,10,24,2,12590,12494,9761,-2733
2019,10,24,3,11430,11333,8645,-2688
2019,10,24,4,10390,10328,8072,-2256
2019,10,24,5,9740,10016,7745,-2271
2019,10,24,6,9400,9852,7815,-2037
2019,10,24,7,9180,9648,7745,-1903
2019,10,24,8,9200,9426,7623,-1803
2019,10,24,9,9500,9493,7630,-1863
2019,10,24,10,10480,10479,8352,-2127
2019,10,24,11,12180,12272,9941,-2331
2019,10,24,12,12990,13209,10668,-2541
2019,10,24,13,12510,12924,10305,-2619
2019,10,24,14,11880,12263,9701,-2562
2019,10,24,15,11580,11821,9265,-2556
2019,10,24,16,11400,11475,9086,-2389
2019,10,24,17,11280,11290,9044,-2246
2019,10,24,18,11430,11417,9365,-2052
2019,10,24,19,11570,11619,9427,-2192
2019,10,24,20,11980,12054,9624,-2430
2019,10,24,21,12680,12767,10186,-2581
2019,10,24,22,13580,13524,10844,-2680
2019,10,24,23,14290,14199,11489,-2710
2019,10,25,0,14090,13993,11337,-2656
2019,10,25,1,13450,13403,10795,-2608
2019,10,25,2,12520,12503,9688,-2815
2019,10,25,3,11430,11381,8434,-2947
2019,10,25,4,10400,10486,7544,-2942
2019,10,25,5,9730,10313,7599,-2714
2019,10,25,6,9340,10082,7752,-2330
2019,10,25,7,9140,9903,7682,-2221
2019,10,25,8,9120,9878,7656,-2222
2019,10,25,9,9430,10151,7931,-2220
2019,10,25,10,10320,10853,8127,-2726
2019,10,25,11,11980,11917,9198,-2719
2019,10,25,12,12840,12898,10004,-2894
2019,10,25,13,12750,12952,10315,-2637
2019,10,25,14,12500,12797,10376,-2421
2019,10,25,15,12470,12679,10597,-2082
2019,10,25,16,12250,12414,10246,-2168
2019,10,25,17,12190,12355,10303,-2052
2019,10,25,18,12250,12519,10415,-2104
2019,10,25,19,12320,12516,10574,-1942
2019,10,25,20,12550,12634,10467,-2167
2019,10,25,21,12910,12970,10498,-2472
2019,10,25,22,13380,13464,10472,-2992
2019,10,25,23,13770,13761,11200,-2561
2019,10,26,0,13440,13397,10336,-3061
2019,10,26,1,12880,12873,10154,-2719
2019,10,26,2,12180,12202,9592,-2610
2019,10,26,3,11250,11283,8391,-2892
2019,10,26,4,10340,10370,7697,-2673
2019,10,26,5,9640,9691,6900,-2791
2019,10,26,6,9200,9615,6696,-2919
2019,10,26,7,8940,9475,6561,-2914
2019,10,26,8,8850,9384,6633,-2751
2019,10,26,9,8960,9459,6896,-2563
2019,10,26,10,9300,9596,6998,-2598
2019,10,26,11,10130,10239,7347,-2892
2019,10,26,12,10810,10743,7772,-2971
2019,10,26,13,11020,11150,8328,-2822
2019,10,26,14,10840,10920,8237,-2683
2019,10,26,15,10610,10509,7845,-2664
2019,10,26,16,10380,10244,7486,-2758
2019,10,26,17,10210,10143,7860,-2283
2019,10,26,18,10140,10087,7788,-2299
2019,10,26,19,10260,10411,7854,-2557
2019,10,26,20,10760,10776,8006,-2770
2019,10,26,21,11550,11366,8568,-2798
2019,10,26,22,12430,12173,9330,-2843
2019,10,26,23,13050,12813,9655,-3158
2019,10,27,0,12780,12519,9536,-2983
2019,10,27,1,12340,12102,9072,-3030
2019,10,27,2,11720,11554,8537,-3017
2019,10,27,3,10970,10825,8132,-2693
2019,10,27,4,10180,10085,7633,-2452
2019,10,27,5,9540,9483,7125,-2358
2019,10,27,6,9140,9234,6808,-2426
2019,10,27,7,8940,9414,6738,-2676
2019,10,27,8,8780,9334,6734,-2600
2019,10,27,9,8850,9352,6749,-2603
2019,10,27,10,9090,9575,6893,-2682
2019,10,27,11,9660,10076,7293,-2783
2019,10,27,12,10160,10491,7487,-3004
2019,10,27,13,10920,11295,8241,-3054
2019,10,27,14,11830,11928,9076,-2852
2019,10,27,15,12250,12535,9778,-2757
2019,10,27,16,12460,12955,10240,-2715
2019,10,27,17,13230,13248,10656,-2592
2019,10,27,18,13210,13333,10641,-2692
2019,10,27,19,13070,13331,10598,-2733
2019,10,27,20,12960,13365,10513,-2852
2019,10,27,21,13110,13551,10555,-2996
2019,10,27,22,13470,13793,10817,-2976
2019,10,27,23,13860,14044,11068,-2976
2019,10,28,0,13470,13589,10684,-2905
2019,10,28,1,12750,13016,10058,-2958
2019,10,28,2,11850,12093,9160,-2933
2019,10,28,3,10880,11191,8382,-2809
2019,10,28,4,9980,10461,7743,-2718
2019,10,28,5,9540,10223,7669,-2554
2019,10,28,6,9220,10399,7867,-2532
2019,10,28,7,9060,10066,8162,-1904
2019,10,28,8,9070,10018,8096,-1922
2019,10,28,9,9490,10356,8330,-2026
2019,10,28,10,10400,11149,9117,-2032
2019,10,28,11,12220,11997,9915,-2082
2019,10,28,12,13210,13071,11212,-1859
2019,10,28,13,13280,13325,11590,-1735
2019,10,28,14,13330,13310,11683,-1627
2019,10,28,15,13170,13172,11560,-1612
2019,10,28,16,13010,12956,11355,-1601
2019,10,28,17,12790,12901,11276,-1625
2019,10,28,18,12780,12994,11375,-1619
2019,10,28,19,12830,12943,11289,-1654
2019,10,28,20,13020,13032,11429,-1603
2019,10,28,21,13580,13432,11751,-1681
2019,10,28,22,14220,14109,12405,-1704
2019,10,28,23,14840,14574,12844,-1730
2019,10,29,0,14550,14237,12493,-1744
2019,10,29,1,13800,13576,11789,-1787
2019,10,29,2,12820,12604,10791,-1813
2019,10,29,3,11590,11420,8708,-2712
2019,10,29,4,10570,10850,7845,-3005
2019,10,29,5,9720,10262,7709,-2553
2019,10,29,6,9350,10372,7469,-2903
2019,10,29,7,9170,10312,7274,-3038
2019,10,29,8,9130,10424,7407,-3017
2019,10,29,9,9450,10447,7730,-2717
2019,10,29,10,10410,10904,8262,-2642
2019,10,29,11,12150,12177,9595,-2582
2019,10,29,12,13180,13130,10580,-2550
2019,10,29,13,13250,13261,10838,-2423
2019,10,29,14,13260,13236,10531,-2705
2019,10,29,15,13370,13254,10670,-2584
2019,10,29,16,13360,13196,10913,-2283
2019,10,29,17,13240,13085,10923,-2162
2019,10,29,18,13210,13068,10790,-2278
2019,10,29,19,13090,12995,10702,-2293
2019,10,29,20,13180,13084,10665,-2419
2019,10,29,21,13610,13463,10965,-2498
2019,10,29,22,14230,14152,11699,-2453
2019,10,29,23,14740,14642,12181,-2461
2019,10,30,0,14370,14295,11758,-2537
2019,10,30,1,13640,13646,10987,-2659
2019,10,30,2,12680,12682,10217,-2465
2019,10,30,3,11480,11509,8923,-2586
2019,10,30,4,10440,10499,7682,-2817
2019,10,30,5,9720,10145,7539,-2606
2019,10,30,6,9340,10143,7529,-2614
2019,10,30,7,9150,9956,7091,-2865
2019,10,30,8,9120,10109,7235,-2874
2019,10,30,9,9420,10445,7480,-2965
2019,10,30,10,10360,11031,8135,-2896
2019,10,30,11,12090,12053,9367,-2686
2019,10,30,12,13100,13101,10786,-2315
2019,10,30,13,13200,13207,10988,-2219
2019,10,30,14,13150,13110,10430,-2680
2019,10,30,15,13150,13009,10312,-2697
2019,10,30,16,13120,12927,10201,-2726
2019,10,30,17,13070,12956,10219,-2737
2019,10,30,18,13170,13129,10710,-2419
2019,10,30,19,13200,13164,10713,-2451
2019,10,30,20,13380,13223,10673,-2550
2019,10,30,21,13780,13537,10864,-2673
2019,10,30,22,14330,14193,11260,-2933
2019,10,30,23,14760,14575,11600,-2975
2019,10,31,0,14380,14270,11405,-2865
2019,10,31,1,13630,13609,10604,-3005
2019,10,31,2,12650,12666,9736,-2930
2019,10,31,3,11460,11565,8747,-2818
2019,10,31,4,10440,10542,7670,-2872
2019,10,31,5,9780,9925,7411,-2514
2019,10,31,6,9370,9658,7087,-2571
2019,10,31,7,9190,9691,6940,-2751
2019,10,31,8,9140,9671,6989,-2682
2019,10,31,9,9420,9941,7115,-2826
2019,10,31,10,10420,10772,7822,-2950
2019,10,31,11,12240,11978,9186,-2792
2019,10,31,12,13310,13152,10386,-2766
2019,10,31,13,13560,13492,10804,-2688
2019,10,31,14,13750,13767,11256,-2511
2019,10,31,15,14000,14015,11368,-2647
2019,10,31,16,14230,14154,11083,-3071
2019,10,31,17,14220,14196,11384,-2812
2019,10,31,18,14190,14195,11217,-2978
2019,10,31,19,14110,14085,11254,-2831
2019,10,31,20,14120,14072,11132,-2940
2019,10,31,21,14400,14222,11156,-3066
2019,10,31,22,14670,14482,11627,-2855
2019,10,31,23,15000,14434,12043,-2391
2019,11,1,0,14660,14052,11481,-2571
2019,11,1,1,14060,13627,10889,-2738
2019,11,1,2,13140,12895,10072,-2823
2019,11,1,3,12040,11878,8975,-2903
2019,11,1,4,11040,11128,8075,-3053
2019,11,1,5,10200,10227,7488,-2739
2019,11,1,6,9800,10059,7426,-2633
2019,11,1,7,9490,10159,7311,-2848
2019,11,1,8,9320,10383,7320,-3063
2019,11,1,9,9400,10296,7248,-3048
2019,11,1,10,9910,10648,7600,-3048
2019,11,1,11,11270,11288,8624,-2664
2019,11,1,12,12230,12212,9448,-2764
2019,11,1,13,12220,12244,9606,-2638
2019,11,1,14,11940,11799,9023,-2776
2019,11,1,15,11560,11425,8893,-2532
2019,11,1,16,11290,11114,8848,-2266
2019,11,1,17,11090,10946,8867,-2079
2019,11,1,18,11160,10969,8811,-2158
2019,11,1,19,11320,11293,8929,-2364
2019,11,1,20,11670,11486,8989,-2497
2019,11,1,21,12490,12238,9509,-2729
2019,11,1,22,13300,13104,10472,-2632
2019,11,1,23,13750,13693,10948,-2745
2019,11,2,0,13530,13423,10495,-2928
2019,11,2,1,13040,12953,10040,-2913
2019,11,2,2,12380,12316,9589,-2727
2019,11,2,3,11530,11480,8709,-2771
2019,11,2,4,10620,10777,8048,-2729
2019,11,2,5,9930,10270,7453,-2817
2019,11,2,6,9580,10329,7450,-2879
2019,11,2,7,9380,10197,7351,-2846
2019,11,2,8,9310,10124,7200,-2924
2019,11,2,9,9460,10252,7214,-3038
2019,11,2,10,9890,10528,7541,-2987
2019,11,2,11,10680,11040,8211,-2829
2019,11,2,12,11490,11472,8943,-2529
2019,11,2,13,11860,11869,8911,-2958
2019,11,2,14,11530,11516,8492,-3024
2019,11,2,15,11030,10991,8206,-2785
2019,11,2,16,10460,10549,7910,-2639
2019,11,2,17,10170,10227,7522,-2705
2019,11,2,18,10020,10299,7439,-2860
2019,11,2,19,10190,10719,7683,-3036
2019,11,2,20,10990,10949,7957,-2992
2019,11,2,21,11820,11664,8784,-2880
2019,11,2,22,12680,12689,9730,-2959
2019,11,2,23,13320,13331,10595,-2736
2019,11,3,0,13140,13077,10299,-2778
2019,11,3,1,12750,12676,9841,-2835
2019,11,3,2,12110,12117,9438,-2679
2019,11,3,3,11510,11368,8628,-2740
2019,11,3,4,10750,10828,8200,-2628
2019,11,3,5,9990,10140,7525,-2615
2019,11,3,6,9610,9786,7101,-2685
2019,11,3,7,9610,9756,7151,-2605
2019,11,3,8,9370,10193,7453,-2740
2019,11,3,9,9380,10197,7099,-3098
2019,11,3,10,9560,10222,7342,-2880
2019,11,3,11,9990,10533,7505,-3028
2019,11,3,12,10620,10906,7970,-2936
2019,11,3,13,11070,11077,8421,-2656
2019,11,3,14,11000,11163,8535,-2628
2019,11,3,15,10710,11135,8534,-2601
2019,11,3,16,10340,10977,8197,-2780
2019,11,3,17,10080,10906,8382,-2524
2019,11,3,18,10120,11079,8484,-2595
2019,11,3,19,10260,11407,8626,-2781
2019,11,3,20,10470,11707,8923,-2784
2019,11,3,21,11280,12134,9335,-2799
2019,11,3,22,12720,13227,10378,-2849
2019,11,3,23,13940,14253,11704,-2549
2019,11,4,0,13860,14087,11352,-2735
2019,11,4,1,13440,13651,10746,-2905
2019,11,4,2,13040,13032,10128,-2904
2019,11,4,3,12190,12124,9272,-2852
2019,11,4,4,11330,11240,8443,-2797
2019,11,4,5,10520,10437,8214,-2223
2019,11,4,6,9880,10163,8024,-2139
2019,11,4,7,9640,10432,8159,-2273
2019,11,4,8,9560,10354,8348,-2006
2019,11,4,9,9710,10496,8461,-2035
2019,11,4,10,10180,10962,8398,-2564
2019,11,4,11,11330,11899,9262,-2637
2019,11,4,12,13040,13190,10853,-2337
2019,11,4,13,13480,13508,11193,-2315
2019,11,4,14,12830,12872,10045,-2827
2019,11,4,15,12210,12350,9529,-2821
2019,11,4,16,11980,12145,9451,-2694
2019,11,4,17,11880,11991,9232,-2759
2019,11,4,18,11950,12015,9438,-2577
2019,11,4,19,12200,12050,9477,-2573
2019,11,4,20,12560,12596,9931,-2665
2019,11,4,21,13280,13208,10555,-2653
2019,11,4,22,14310,14161,11799,-2362
2019,11,4,23,15270,15161,12395,-2766
2019,11,5,0,15250,15017,12036,-2981
2019,11,5,1,14700,14520,11562,-2958
2019,11,5,2,13940,13800,10680,-3120
2019,11,5,3,12910,12768,9651,-3117
2019,11,5,4,11720,11593,8616,-2977
2019,11,5,5,10750,11025,8236,-2789
2019,11,5,6,10040,10741,7803,-2938
2019,11,5,7,9740,10519,7533,-2986
2019,11,5,8,9570,10355,7921,-2434
2019,11,5,9,9600,10371,8042,-2329
2019,11,5,10,9990,10591,7615,-2976
2019,11,5,11,11010,10995,7979,-3016
2019,11,5,12,12570,12548,9239,-3309
2019,11,5,13,13270,13278,10017,-3261
2019,11,5,14,13480,13473,10314,-3159
2019,11,5,15,13600,13605,10637,-2968
2019,11,5,16,13510,13633,10695,-2938
2019,11,5,17,13560,13779,10609,-3170
2019,11,5,18,13520,13907,10425,-3482
2019,11,5,19,13570,14298,10795,-3503
2019,11,5,20,13670,14314,10775,-3539
2019,11,5,21,13880,14331,11001,-3330
2019,11,5,22,14400,14689,11449,-3240
2019,11,5,23,15250,15190,11788,-3402
2019,11,6,0,14900,14977,11548,-3429
2019,11,6,1,14420,14450,10897,-3553
2019,11,6,2,13700,13705,10266,-3439
2019,11,6,3,12740,12732,9342,-3390
2019,11,6,4,11590,11719,8256,-3463
2019,11,6,5,10640,11061,7344,-3717
2019,11,6,6,10010,11027,7334,-3693
2019,11,6,7,9680,10734,7352,-3382
2019,11,6,8,9570,10620,6961,-3659
2019,11,6,9,9650,10687,7046,-3641
2019,11,6,10,10050,10882,7226,-3656
2019,11,6,11,11140,11398,8048,-3350
2019,11,6,12,12830,12822,9428,-3394
2019,11,6,13,13320,13341,9725,-3616
2019,11,6,14,12730,12757,9460,-3297
2019,11,6,15,12170,12189,9145,-3044
2019,11,6,16,11800,11823,9338,-2485
2019,11,6,17,11560,11629,9087,-2542
2019,11,6,18,11540,11556,9134,-2422
2019,11,6,19,11750,11967,9329,-2638
2019,11,6,20,12120,12468,10087,-2381
2019,11,6,21,12870,13011,10420,-2591
2019,11,6,22,14010,14034,11367,-2667
2019,11,6,23,15000,15093,12453,-2640
2019,11,7,0,14810,15038,12024,-3014
2019,11,7,1,14430,14688,11627,-3061
2019,11,7,2,13910,14128,11352,-2776
2019,11,7,3,13070,13196,10357,-2839
2019,11,7,4,11980,12085,9068,-3017
2019,11,7,5,11030,11159,7936,-3223
2019,11,7,6,10520,10870,7907,-2963
2019,11,7,7,10200,10731,7733,-2998
2019,11,7,8,10030,10752,7771,-2981
2019,11,7,9,10050,10821,7821,-3000
2019,11,7,10,10370,10851,7871,-2980
2019,11,7,11,11410,11382,8151,-3231
2019,11,7,12,13040,13002,9731,-3271
2019,11,7,13,13720,13734,10413,-3321
2019,11,7,14,13690,13704,10447,-3257
2019,11,7,15,13900,13852,10609,-3243
2019,11,7,16,13880,13922,10636,-3286
2019,11,7,17,13750,13945,10638,-3307
2019,11,7,18,13730,13779,10492,-3287
2019,11,7,19,13840,13839,10479,-3360
2019,11,7,20,13940,13901,10639,-3262
2019,11,7,21,14020,14095,10838,-3257
2019,11,7,22,14780,14725,11595,-3130
2019,11,7,23,15500,15257,12140,-3117
2019,11,8,0,15340,15096,12015,-3081
2019,11,8,1,14710,14699,11536,-3163
2019,11,8,2,13960,14077,10890,-3187
2019,11,8,3,13080,13173,9777,-3396
2019,11,8,4,12010,12092,8697,-3395
2019,11,8,5,11080,11583,8124,-3459
2019,11,8,6,10710,11706,8113,-3593
2019,11,8,7,10420,11567,7942,-3625
2019,11,8,8,10240,11435,7918,-3517
2019,11,8,9,10370,11506,8004,-3502
2019,11,8,10,10810,11917,8402,-3515
2019,11,8,11,11890,12569,8926,-3643
2019,11,8,12,13520,13413,9800,-3613
2019,11,8,13,14110,14002,10308,-3694
2019,11,8,14,13800,13759,10153,-3606
2019,11,8,15,13360,13595,10366,-3229
2019,11,8,16,12920,13267,9967,-3300
2019,11,8,17,13290,13270,10022,-3248
2019,11,8,18,13290,13287,10018,-3269
2019,11,8,19,13470,13480,9863,-3617
2019,11,8,20,13820,13793,10093,-3700
2019,11,8,21,14320,14401,10550,-3851
2019,11,8,22,15180,15355,11555,-3800
2019,11,8,23,15800,16181,12438,-3743
2019,11,9,0,15740,15942,12118,-3824
2019,11,9,1,15200,15474,11622,-3852
2019,11,9,2,14590,14948,11038,-3910
2019,11,9,3,13890,14221,10307,-3914
2019,11,9,4,13000,13282,9720,-3562
2019,11,9,5,12150,12591,9385,-3206
2019,11,9,6,11530,11814,8529,-3285
2019,11,9,7,11190,11381,8173,-3208
2019,11,9,8,11030,11463,8477,-2986
2019,11,9,9,11020,11438,8294,-3144
2019,11,9,10,11310,11430,8126,-3304
2019,11,9,11,11810,11789,8391,-3398
2019,11,9,12,12420,12501,9398,-3103
2019,11,9,13,12810,12965,9875,-3090
2019,11,9,14,12900,12882,9980,-2902
2019,11,9,15,12580,12542,9753,-2789
2019,11,9,16,12150,12122,9237,-2885
2019,11,9,17,11790,12042,8962,-3080
2019,11,9,18,11690,11848,8988,-2860
2019,11,9,19,11720,11906,8914,-2992
2019,11,9,20,12100,12346,9133,-3213
2019,11,9,21,12920,13107,10011,-3096
2019,11,9,22,14050,14081,10981,-3100
2019,11,9,23,14850,14967,11803,-3164
2019,11,10,0,14780,14807,11850,-2957
2019,11,10,1,14300,14402,11205,-3197
2019,11,10,2,13730,13960,11150,-2810
2019,11,10,3,13140,13341,10793,-2548
2019,11,10,4,12440,12546,10052,-2494
2019,11,10,5,11700,11807,9060,-2747
2019,11,10,6,11110,11254,8795,-2459
2019,11,10,7,10730,10881,8527,-2354
2019,11,10,8,10510,10917,8403,-2514
2019,11,10,9,10460,10877,8341,-2536
2019,11,10,10,10490,10933,8316,-2617
2019,11,10,11,10810,11224,8485,-2739
2019,11,10,12,11280,11490,8583,-2907
2019,11,10,13,11650,11833,9096,-2737
2019,11,10,14,11910,12261,9593,-2668
2019,11,10,15,11990,12287,9696,-2591
2019,11,10,16,11810,12004,8953,-3051
2019,11,10,17,11570,11638,8490,-3148
2019,11,10,18,11430,11610,8657,-2953
2019,11,10,19,11540,11981,9343,-2638
2019,11,10,20,11880,12411,9576,-2835
2019,11,10,21,12820,12807,9843,-2964
2019,11,10,22,14070,13780,10784,-2996
2019,11,10,23,14990,14593,11689,-2904
2019,11,11,0,14800,14366,11417,-2949
2019,11,11,1,14270,13885,11044,-2841
2019,11,11,2,13680,13350,10680,-2670
2019,11,11,3,12760,12577,9802,-2775
2019,11,11,4,11790,11719,8749,-2970
2019,11,11,5,10970,11379,8323,-3056
2019,11,11,6,10260,10851,8225,-2626
2019,11,11,7,9950,10786,8156,-2630
2019,11,11,8,9800,10895,8141,-2754
2019,11,11,9,9860,10917,8232,-2685
2019,11,11,10,10160,11237,8442,-2795
2019,11,11,11,11080,11761,9145,-2616
2019,11,11,12,12400,12771,9864,-2907
2019,11,11,13,13150,13407,10768,-2639
2019,11,11,14,13350,13610,10970,-2640
2019,11,11,15,13350,13538,10947,-2591
2019,11,11,16,13370,13451,10841,-2610
2019,11,11,17,13300,13271,10597,-2674
2019,11,11,18,13320,13398,10517,-2881
2019,11,11,19,13480,13595,10558,-3037
2019,11,11,20,13670,13754,10581,-3173
2019,11,11,21,14120,14038,10763,-3275
2019,11,11,22,15110,14856,11862,-2994
2019,11,11,23,15850,15517,12825,-2692
2019,11,12,0,15530,15231,12378,-2853
2019,11,12,1,14960,14700,11674,-3026
2019,11,12,2,14230,14003,10845,-3158
2019,11,12,3,13210,13032,9680,-3352
2019,11,12,4,12040,11921,8734,-3187
2019,11,12,5,11100,10976,7662,-3314
2019,11,12,6,10370,10830,7721,-3109
2019,11,12,7,10020,10796,7742,-3054
2019,11,12,8,9820,10862,7663,-3199
2019,11,12,9,9860,10639,7358,-3281
2019,11,12,10,10200,11010,7550,-3460
2019,11,12,11,11200,11507,8098,-3409
2019,11,12,12,12760,12833,9531,-3302
2019,11,12,13,13620,13775,10757,-3018
2019,11,12,14,13840,14141,11123,-3018
2019,11,12,15,14370,14364,11595,-2769
2019,11,12,16,14510,14625,11616,-3009
2019,11,12,17,14640,14767,11659,-3108
2019,11,12,18,14670,14828,11591,-3237
2019,11,12,19,14790,14992,11701,-3291
2019,11,12,20,14820,15087,11947,-3140
2019,11,12,21,15030,15360,12133,-3227
2019,11,12,22,15920,16103,12749,-3354
2019,11,12,23,16750,16758,13342,-3416
2019,11,13,0,16670,16652,13251,-3401
2019,11,13,1,16230,16308,12772,-3536
2019,11,13,2,15580,15712,12287,-3425
2019,11,13,3,14650,14833,11445,-3388
2019,11,13,4,13560,13735,10471,-3264
2019,11,13,5,12670,12979,9557,-3422
2019,11,13,6,12310,12414,9642,-2772
2019,11,13,7,11970,12502,9488,-3014
2019,11,13,8,11860,12682,9622,-3060
2019,11,13,9,12020,12841,9513,-3328
2019,11,13,10,12400,13035,9741,-3294
2019,11,13,11,13570,13584,10706,-2878
2019,11,13,12,15370,15287,12438,-2849
2019,11,13,13,15850,15920,12622,-3298
2019,11,13,14,15200,15381,12052,-3329
2019,11,13,15,14500,14715,11709,-3006
2019,11,13,16,13900,14306,11566,-2740
2019,11,13,17,13630,14036,11185,-2851
2019,11,13,18,13580,13860,11036,-2824
2019,11,13,19,13900,14051,11069,-2982
2019,11,13,20,14360,14535,11445,-3090
2019,11,13,21,15320,15369,12293,-3076
2019,11,13,22,16550,16515,13856,-2659
2019,11,13,23,17350,17409,14377,-3032
2019,11,14,0,17240,17323,14143,-3180
2019,11,14,1,16840,17015,13715,-3300
2019,11,14,2,16190,16428,13283,-3145
2019,11,14,3,15220,15489,12081,-3408
2019,11,14,4,14020,14370,11017,-3353
2019,11,14,5,12990,13570,10296,-3274
2019,11,14,6,12660,12683,9213,-3470
2019,11,14,7,12350,12565,8999,-3566
2019,11,14,8,12240,12545,8981,-3564
2019,11,14,9,12300,12551,9022,-3529
2019,11,14,10,12710,12697,9331,-3366
2019,11,14,11,13770,13757,10635,-3122
2019,11,14,12,15420,15379,12372,-3007
2019,11,14,13,15980,15990,13006,-2984
2019,11,14,14,15760,15780,12698,-3082
2019,11,14,15,15500,15541,12370,-3171
2019,11,14,16,15130,15346,12128,-3218
2019,11,14,17,14760,15218,11900,-3318
2019,11,14,18,14540,15151,11616,-3535
2019,11,14,19,14610,15262,11632,-3630
2019,11,14,20,14860,15539,11887,-3652
2019,11,14,21,15420,15686,12133,-3553
2019,11,14,22,16300,16200,12729,-3471
2019,11,14,23,16730,16719,13159,-3560
2019,11,15,0,16510,16543,12804,-3739
2019,11,15,1,16190,16091,12301,-3790
2019,11,15,2,15550,15498,11758,-3740
2019,11,15,3,14490,14562,10810,-3752
2019,11,15,4,13230,13391,9730,-3661
2019,11,15,5,12140,12690,9151,-3539
2019,11,15,6,11690,12504,9135,-3369
2019,11,15,7,11350,12396,9120,-3276
2019,11,15,8,11210,12301,8907,-3394
2019,11,15,9,11260,12320,8894,-3426
2019,11,15,10,11630,12349,9099,-3250
2019,11,15,11,12680,13204,9906,-3298
2019,11,15,12,14300,14359,11126,-3233
2019,11,15,13,14870,14888,11491,-3397
2019,11,15,14,14300,14328,11100,-3228
2019,11,15,15,13520,13780,10558,-3222
2019,11,15,16,13120,13270,10384,-2886
2019,11,15,17,12890,12915,10401,-2514
2019,11,15,18,12510,12715,10022,-2693
2019,11,15,19,12590,12937,10183,-2754
2019,11,15,20,12860,13551,10457,-3094
2019,11,15,21,13580,14024,10980,-3044
2019,11,15,22,14700,14979,11509,-3470
2019,11,15,23,15500,15682,12029,-3653
2019,11,16,0,15410,15462,12207,-3255
2019,11,16,1,14910,15042,11689,-3353
2019,11,16,2,14320,14551,11121,-3430
2019,11,16,3,13600,13864,10473,-3391
2019,11,16,4,12760,12982,10039,-2943
2019,11,16,5,11950,12379,9232,-3147
2019,11,16,6,11300,11843,8804,-3039
2019,11,16,7,10950,11505,8667,-2838
2019,11,16,8,10860,11406,8644,-2762
2019,11,16,9,10910,11353,8623,-2730
2019,11,16,10,11170,11458,8405,-3053
2019,11,16,11,11710,11742,8627,-3115
2019,11,16,12,12520,12520,9161,-3359
2019,11,16,13,13090,13102,9775,-3327
2019,11,16,14,13100,13124,9849,-3275
2019,11,16,15,12760,12787,9736,-3051
2019,11,16,16,12380,12455,9542,-2913
2019,11,16,17,11990,12208,9483,-2725
2019,11,16,18,11890,12075,9515,-2560
2019,11,16,19,11890,12167,9382,-2785
2019,11,16,20,12290,12725,9695,-3030
2019,11,16,21,13300,13680,10498,-3182
2019,11,16,22,14590,14877,11357,-3520
2019,11,16,23,15500,15651,12070,-3581
2019,11,17,0,15360,15483,11916,-3567
2019,11,17,1,14990,15129,11477,-3652
2019,11,17,2,14550,14730,11102,-3628
2019,11,17,3,14000,14183,10675,-3508
2019,11,17,4,13250,13411,9882,-3529
2019,11,17,5,12490,12674,9046,-3628
2019,11,17,6,12080,12122,8567,-3555
2019,11,17,7,11760,11778,8256,-3522
2019,11,17,8,11610,11828,8335,-3493
2019,11,17,9,11550,11821,8378,-3443
2019,11,17,10,11640,11905,8424,-3481
2019,11,17,11,11940,11954,8474,-3480
2019,11,17,12,12480,12493,9099,-3394
2019,11,17,13,13050,13041,9787,-3254
2019,11,17,14,13460,13470,10300,-3170
2019,11,17,15,13770,13772,10454,-3318
2019,11,17,16,13910,13867,10617,-3250
2019,11,17,17,13880,13934,10924,-3010
2019,11,17,18,13890,13995,10982,-3013
2019,11,17,19,13910,14042,10959,-3083
2019,11,17,20,14030,14160,10978,-3182
2019,11,17,21,14290,14555,11520,-3035
2019,11,17,22,15460,15469,12421,-3048
2019,11,17,23,15850,16047,13046,-3001
2019,11,18,0,15610,15838,12806,-3032
2019,11,18,1,15030,15248,12485,-2763
2019,11,18,2,14450,14746,11915,-2831
2019,11,18,3,13570,13761,10747,-3014
2019,11,18,4,12600,12669,9455,-3214
2019,11,18,5,11690,11740,8434,-3306
2019,11,18,6,11050,11645,8296,-3349
2019,11,18,7,10700,11661,8364,-3297
2019,11,18,8,10580,11791,8583,-3208
2019,11,18,9,10610,11821,8677,-3144
2019,11,18,10,11040,11782,8787,-2995
2019,11,18,11,12070,12231,9618,-2613
2019,11,18,12,13730,13864,11976,-1888
2019,11,18,13,14830,14798,12967,-1831
2019,11,18,14,15080,15026,13087,-1939
2019,11,18,15,15160,15125,13132,-1993
2019,11,18,16,15280,15197,13237,-1960
2019,11,18,17,15270,15219,13146,-2073
2019,11,18,18,15320,15109,13038,-2071
2019,11,18,19,15340,15034,13078,-1956
2019,11,18,20,15330,15013,12998,-2015
2019,11,18,21,15530,15202,13196,-2006
2019,11,18,22,16140,15970,13996,-1974
2019,11,18,23,16750,16525,14569,-1956
2019,11,19,0,16520,16238,14154,-2084
2019,11,19,1,15990,15692,13480,-2212
2019,11,19,2,15150,14975,12672,-2303
2019,11,19,3,14080,13929,11580,-2349
2019,11,19,4,12850,12724,10260,-2464
2019,11,19,5,11800,11793,9325,-2468
2019,11,19,6,11010,11301,8817,-2484
2019,11,19,7,10650,11162,8675,-2487
2019,11,19,8,10500,11241,8720,-2521
2019,11,19,9,10520,11297,8684,-2613
2019,11,19,10,10850,11404,8742,-2662
2019,11,19,11,11920,11954,9353,-2601
2019,11,19,12,13630,13484,11043,-2441
2019,11,19,13,14520,14372,12049,-2323
2019,11,19,14,14620,14506,12249,-2257
2019,11,19,15,14440,14494,12082,-2412
2019,11,19,16,14250,14532,12152,-2380
2019,11,19,17,14080,14506,12109,-2397
2019,11,19,18,13820,14380,11958,-2422
2019,11,19,19,13920,14343,12182,-2161
2019,11,19,20,14100,14383,12217,-2166
2019,11,19,21,14510,14642,12444,-2198
2019,11,19,22,15550,15443,13303,-2140
2019,11,19,23,16260,16042,14037,-2005
2019,11,20,0,16100,15855,13634,-2221
2019,11,20,1,15640,15372,13051,-2321
2019,11,20,2,14960,14721,12344,-2377
2019,11,20,3,13980,13749,11402,-2347
2019,11,20,4,12750,12576,10259,-2317
2019,11,20,5,11710,11564,9190,-2374
2019,11,20,6,10900,11251,8965,-2286
2019,11,20,7,10530,11359,9059,-2300
2019,11,20,8,10370,11470,9166,-2304
2019,11,20,9,10380,11470,8977,-2493
2019,11,20,10,10720,11601,9149,-2452
2019,11,20,11,11760,12073,9762,-2311
2019,11,20,12,13420,13475,11127,-2348
2019,11,20,13,14340,14404,11937,-2467
2019,11,20,14,14570,14647,12153,-2494
2019,11,20,15,14570,14751,12239,-2512
2019,11,20,16,14550,14808,12247,-2561
2019,11,20,17,14530,14801,12174,-2627
2019,11,20,18,14440,14717,11962,-2755
2019,11,20,19,14530,14761,12013,-2748
2019,11,20,20,14580,14755,12060,-2695
2019,11,20,21,14860,14941,12344,-2597
2019,11,20,22,15830,15770,13258,-2512
2019,11,20,23,16410,16363,13875,-2488
2019,11,21,0,16220,16159,13589,-2570
2019,11,21,1,15760,15716,13080,-2636
2019,11,21,2,15060,15085,12475,-2610
2019,11,21,3,14060,14133,11500,-2633
2019,11,21,4,12860,12914,10408,-2506
2019,11,21,5,11830,11921,9290,-2631
2019,11,21,6,11240,11760,9293,-2467
2019,11,21,7,10920,11734,9139,-2595
2019,11,21,8,10780,11852,9187,-2665
2019,11,21,9,10800,11172,8506,-2666
2019,11,21,10,11230,11755,9258,-2497
2019,11,21,11,12220,12274,9944,-2330
2019,11,21,12,13910,13943,11627,-2316
2019,11,21,13,14460,14659,12281,-2378
2019,11,21,14,13870,14117,11633,-2484
2019,11,21,15,13180,13550,11182,-2368
2019,11,21,16,12760,13058,10632,-2426
2019,11,21,17,12520,12742,10332,-2410
2019,11,21,18,12420,12412,10400,-2012
2019,11,21,19,12570,12616,10442,-2174
2019,11,21,20,12940,13090,10987,-2103
2019,11,21,21,13680,13825,11567,-2258
2019,11,21,22,14810,14959,12593,-2366
2019,11,21,23,15630,15738,13414,-2324
2019,11,22,0,15520,15660,13272,-2388
2019,11,22,1,15170,15307,12953,-2354
2019,11,22,2,14600,14748,12315,-2433
2019,11,22,3,13720,13850,11337,-2513
2019,11,22,4,12610,12662,10236,-2426
2019,11,22,5,11590,11666,9174,-2492
2019,11,22,6,10910,11476,9150,-2326
2019,11,22,7,10500,11323,9043,-2280
2019,11,22,8,10310,11374,8956,-2418
2019,11,22,9,10280,11344,8881,-2463
2019,11,22,10,10500,11402,9035,-2367
2019,11,22,11,11430,11625,9566,-2059
2019,11,22,12,12970,13058,11244,-1814
2019,11,22,13,13750,13951,11992,-1959
2019,11,22,14,13810,14184,12061,-2123
2019,11,22,15,14150,14167,12124,-2043
2019,11,22,16,14080,14222,12109,-2113
2019,11,22,17,14020,14190,11866,-2324
2019,11,22,18,13890,14270,11907,-2363
2019,11,22,19,13950,14425,12007,-2418
2019,11,22,20,14050,14431,11979,-2452
2019,11,22,21,14260,14566,12010,-2556
2019,11,22,22,14910,15131,12566,-2565
2019,11,22,23,15600,15542,13000,-2542
2019,11,23,0,15260,15288,12797,-2491
2019,11,23,1,14720,14840,12409,-2431
2019,11,23,2,14240,14354,12003,-2351
2019,11,23,3,13580,13701,11169,-2532
2019,11,23,4,12720,13064,10604,-2460
2019,11,23,5,11850,12469,9960,-2509
2019,11,23,6,11280,12128,9909,-2219
2019,11,23,7,10860,11778,9363,-2415
2019,11,23,8,10670,11610,9190,-2420
2019,11,23,9,10640,11553,8969,-2584
2019,11,23,10,10810,11467,9045,-2422
2019,11,23,11,11280,11684,9273,-2411
2019,11,23,12,11940,12167,9639,-2528
2019,11,23,13,12420,12785,10280,-2505
2019,11,23,14,12540,12820,10298,-2522
2019,11,23,15,12400,12388,10035,-2353
2019,11,23,16,11860,11967,9566,-2401
2019,11,23,17,11600,11849,9351,-2498
2019,11,23,18,11460,12057,9520,-2537
2019,11,23,19,11520,12319,9745,-2574
2019,11,23,20,11800,12996,10496,-2500
2019,11,23,21,12690,13230,10874,-2356
2019,11,23,22,13950,14205,11915,-2290
2019,11,23,23,14750,14861,12521,-2340
2019,11,24,0,14500,14640,12228,-2412
2019,11,24,1,14120,14225,11698,-2527
2019,11,24,2,13720,13769,11260,-2509
2019,11,24,3,13100,13178,10620,-2558
2019,11,24,4,12340,12371,9808,-2563
2019,11,24,5,11510,11623,9029,-2594
2019,11,24,6,10850,11470,8779,-2691
2019,11,24,7,10410,11312,8588,-2724
2019,11,24,8,10170,11276,8628,-2648
2019,11,24,9,10090,11279,8669,-2610
2019,11,24,10,10160,11347,8842,-2505
2019,11,24,11,10420,11613,9157,-2456
2019,11,24,12,10870,11894,9483,-2411
2019,11,24,13,11430,12056,9795,-2261
2019,11,24,14,12300,13041,10800,-2241
2019,11,24,15,13440,13780,11549,-2231
2019,11,24,16,13710,13930,11796,-2134
2019,11,24,17,14330,14231,12179,-2052
2019,11,24,18,14390,14414,12403,-2011
2019,11,24,19,14350,14458,12384,-2074
2019,11,24,20,14360,14471,12437,-2034
2019,11,24,21,14480,14674,12716,-1958
2019,11,24,22,14840,15334,13348,-1986
2019,11,24,23,15440,15609,13548,-2061
2019,11,25,0,15190,15302,13143,-2159
2019,11,25,1,14660,14766,12489,-2277
2019,11,25,2,14060,14243,12019,-2224
2019,11,25,3,13170,13313,10779,-2534
2019,11,25,4,12190,12431,9705,-2726
2019,11,25,5,11320,11879,9184,-2695
2019,11,25,6,10790,11577,9041,-2536
2019,11,25,7,10470,11269,8725,-2544
2019,11,25,8,10340,11137,8772,-2365
2019,11,25,9,10420,11179,8703,-2476
2019,11,25,10,10810,11327,9008,-2319
2019,11,25,11,11850,12069,9663,-2406
2019,11,25,12,13520,13495,11243,-2252
2019,11,25,13,14280,14290,12082,-2208
2019,11,25,14,14150,14174,11926,-2248
2019,11,25,15,13620,13705,11394,-2311
2019,11,25,16,13130,12918,10610,-2308
2019,11,25,17,12810,12609,10288,-2321
2019,11,25,18,12710,12539,10416,-2123
2019,11,25,19,12840,12692,10561,-2131
2019,11,25,20,13100,13181,10975,-2206
2019,11,25,21,13800,13872,11616,-2256
2019,11,25,22,14910,14883,12697,-2186
2019,11,25,23,15810,15672,13457,-2215
2019,11,26,0,15720,15552,13139,-2413
2019,11,26,1,15300,15150,12748,-2402
2019,11,26,2,14590,14550,12223,-2327
2019,11,26,3,13570,13632,11262,-2370
2019,11,26,4,12400,12450,10009,-2441
2019,11,26,5,11400,11435,8829,-2606
2019,11,26,6,10740,11018,8572,-2446
2019,11,26,7,10380,10687,8277,-2410
2019,11,26,8,10260,10546,7996,-2550
2019,11,26,9,10320,10602,8025,-2577
2019,11,26,10,10740,11009,8412,-2597
2019,11,26,11,11820,11796,9157,-2639
2019,11,26,12,13540,13511,10901,-2610
2019,11,26,13,14210,14226,11505,-2721
2019,11,26,14,13920,13949,11806,-2143
2019,11,26,15,13020,13102,11381,-1721
2019,11,26,16,12520,12523,10848,-1675
2019,11,26,17,12280,12264,10859,-1405
2019,11,26,18,12280,12215,11198,-1017
2019,11,26,19,12490,12508,11529,-979
2019,11,26,20,12710,12908,11827,-1081
2019,11,26,21,13400,13537,12105,-1432
2019,11,26,22,14600,14464,12595,-1869
2019,11,26,23,15440,15213,12936,-2277
2019,11,27,0,15280,15100,12627,-2473
2019,11,27,1,14850,14727,12405,-2322
2019,11,27,2,14200,14174,11831,-2343
2019,11,27,3,13200,13359,10905,-2454
2019,11,27,4,12070,12271,9814,-2457
2019,11,27,5,11050,11261,8949,-2312
2019,11,27,6,10600,11297,8746,-2551
2019,11,27,7,10250,11069,8376,-2693
2019,11,27,8,10120,10927,8117,-2810
2019,11,27,9,10170,10982,8180,-2802
2019,11,27,10,10560,11316,8519,-2797
2019,11,27,11,11530,11686,8957,-2729
2019,11,27,12,13030,12971,10492,-2479
2019,11,27,13,13920,13899,11289,-2610
2019,11,27,14,14140,14166,11673,-2493
2019,11,27,15,14170,14148,11664,-2484
2019,11,27,16,14040,14284,11879,-2405
2019,11,27,17,13890,14340,11955,-2385
2019,11,27,18,13900,14240,11834,-2406
2019,11,27,19,14030,14163,11823,-2340
2019,11,27,20,14110,14185,11942,-2243
2019,11,27,21,14400,14390,12246,-2144
2019,11,27,22,15150,15056,12887,-2169
2019,11,27,23,15810,15363,13189,-2174
2019,11,28,0,15480,15011,12822,-2189
2019,11,28,1,14910,14473,11818,-2655
2019,11,28,2,14230,13853,11055,-2798
2019,11,28,3,13160,13056,10264,-2792
2019,11,28,4,11940,11996,9199,-2797
2019,11,28,5,10870,11188,8411,-2777
2019,11,28,6,10150,10479,8481,-1998
2019,11,28,7,9580,10657,8275,-2382
2019,11,28,8,9450,10576,8215,-2361
2019,11,28,9,9320,10502,7995,-2507
2019,11,28,10,9540,10650,8195,-2455
2019,11,28,11,10130,11070,8537,-2533
2019,11,28,12,10660,11472,8893,-2579
2019,11,28,13,11410,12021,9530,-2491
2019,11,28,14,12320,12639,10062,-2577
2019,11,28,15,12740,13321,10571,-2750
2019,11,28,16,13040,13972,10806,-3166
2019,11,28,17,13330,14200,10822,-3378
2019,11,28,18,12960,13910,10491,-3419
2019,11,28,19,12320,13327,10016,-3311
2019,11,28,20,11930,12717,9844,-2873
2019,11,28,21,11940,12493,9704,-2789
2019,11,28,22,12710,12879,10152,-2727
2019,11,28,23,13150,13067,10236,-2831
2019,11,29,0,12940,12965,10367,-2598
2019,11,29,1,12510,12895,10284,-2611
2019,11,29,2,12190,12800,10058,-2742
2019,11,29,3,11960,12481,9902,-2579
2019,11,29,4,11440,11945,9364,-2581
2019,11,29,5,10840,11442,9025,-2417
2019,11,29,6,10660,11159,8865,-2294
2019,11,29,7,10370,11186,8808,-2378
2019,11,29,8,10290,11270,8766,-2504
2019,11,29,9,10510,11531,8871,-2660
2019,11,29,10,10780,11660,8990,-2670
2019,11,29,11,11350,11688,9217,-2471
2019,11,29,12,11990,12167,9598,-2569
2019,11,29,13,12410,12697,10017,-2680
2019,11,29,14,12530,12780,9917,-2863
2019,11,29,15,12260,12534,9687,-2847
2019,11,29,16,12060,12321,9688,-2633
2019,11,29,17,11940,12144,9428,-2716
2019,11,29,18,12000,12190,9554,-2636
2019,11,29,19,12140,12519,9943,-2576
2019,11,29,20,12570,12925,10373,-2552
2019,11,29,21,13350,13628,10884,-2744
2019,11,29,22,14410,14768,11761,-3007
2019,11,29,23,15040,15462,12475,-2987
2019,11,30,0,14930,15289,12003,-3286
2019,11,30,1,14690,14940,11612,-3328
2019,11,30,2,14340,14520,11080,-3440
2019,11,30,3,13760,13948,10501,-3447
2019,11,30,4,12960,13137,10097,-3040
2019,11,30,5,12180,12305,9486,-2819
2019,11,30,6,11670,11758,9344,-2414
2019,11,30,7,11290,11804,9040,-2764
2019,11,30,8,11100,11646,9070,-2576
2019,11,30,9,11070,11618,8952,-2666
2019,11,30,10,11240,11795,8825,-2970
2019,11,30,11,11530,12077,9509,-2568
2019,11,30,12,12190,12353,10049,-2304
2019,11,30,13,13120,12998,10556,-2442
2019,11,30,14,13020,13209,10447,-2762
2019,11,30,15,12650,12913,10078,-2835
2019,11,30,16,12370,12516,9922,-2594
2019,11,30,17,12170,12229,9650,-2579
2019,11,30,18,12090,12393,9868,-2525
2019,11,30,19,12110,12578,9935,-2643
2019,11,30,20,12590,12915,10204,-2711
2019,11,30,21,13680,13816,10949,-2867
2019,11,30,22,14820,15034,12320,-2714
2019,11,30,23,15620,15733,12931,-2802
2019,12,1,0,15420,15635,12636,-2999
2019,12,1,1,15050,15354,12392,-2962
2019,12,1,2,14630,14981,11935,-3046
2019,12,1,3,14080,14420,11281,-3139
2019,12,1,4,13270,13637,10745,-2892
2019,12,1,5,12540,13030,10284,-2746
2019,12,1,6,12160,12409,9619,-2790
2019,12,1,7,11780,12194,9188,-3006
2019,12,1,8,11600,12154,8940,-3214
2019,12,1,9,11570,12122,8813,-3309
2019,12,1,10,11620,12254,9043,-3211
2019,12,1,11,12020,12603,9373,-3230
2019,12,1,12,12580,12915,9978,-2937
2019,12,1,13,12930,13157,10241,-2916
2019,12,1,14,13280,13483,10482,-3001
2019,12,1,15,13740,13786,10902,-2884
2019,12,1,16,14170,14203,11240,-2963
2019,12,1,17,14480,14532,11598,-2934
2019,12,1,18,14580,14782,11882,-2900
2019,12,1,19,14710,15064,12046,-3018
2019,12,1,20,15120,15370,12390,-2980
2019,12,1,21,15550,15810,12954,-2856
2019,12,1,22,16980,16713,13880,-2833
2019,12,1,23,17020,17168,14481,-2687
2019,12,2,0,16700,16860,14159,-2701
2019,12,2,1,16160,16276,13431,-2845
2019,12,2,2,15520,15528,12711,-2817
2019,12,2,3,14660,14543,11581,-2962
2019,12,2,4,13510,13457,10261,-3196
2019,12,2,5,12550,12688,9412,-3276
2019,12,2,6,11710,12279,8994,-3285
2019,12,2,7,11260,12173,8843,-3330
2019,12,2,8,11140,12012,8720,-3292
2019,12,2,9,11160,12019,8773,-3246
2019,12,2,10,11610,12375,9112,-3263
2019,12,2,11,12610,13219,10380,-2839
2019,12,2,12,14220,14136,11104,-3032
2019,12,2,13,15160,14915,11781,-3134
2019,12,2,14,15430,15467,12356,-3111
2019,12,2,15,15800,15792,12669,-3123
2019,12,2,16,15960,16048,12958,-3090
2019,12,2,17,16010,16154,13041,-3113
2019,12,2,18,15880,16148,12728,-3420
2019,12,2,19,15900,16147,12748,-3399
2019,12,2,20,15960,16079,12762,-3317
2019,12,2,21,16210,16185,12836,-3349
2019,12,2,22,17290,16994,13783,-3211
2019,12,2,23,17890,17600,14643,-2957
2019,12,3,0,17740,17369,14143,-3226
2019,12,3,1,17190,16911,13509,-3402
2019,12,3,2,16450,16201,12717,-3484
2019,12,3,3,15400,15205,11378,-3827
2019,12,3,4,14090,13953,10200,-3753
2019,12,3,5,12920,12915,9349,-3566
2019,12,3,6,12210,12711,8948,-3763
2019,12,3,7,11830,12418,8851,-3567
2019,12,3,8,11680,12282,8599,-3683
2019,12,3,9,11720,12107,8426,-3681
2019,12,3,10,12090,12388,8634,-3754
2019,12,3,11,13060,13240,9598,-3642
2019,12,3,12,14590,14179,10792,-3387
2019,12,3,13,15450,15095,11939,-3156
2019,12,3,14,15850,15735,12637,-3098
2019,12,3,15,16050,16069,13006,-3063
2019,12,3,16,16050,16240,13158,-3082
2019,12,3,17,16260,16290,13089,-3201
2019,12,3,18,16220,16191,13267,-2924
2019,12,3,19,16030,16058,13264,-2794
2019,12,3,20,16060,15910,13140,-2770
2019,12,3,21,16490,15986,13209,-2777
2019,12,3,22,17130,16840,13989,-2851
2019,12,3,23,17400,17623,14703,-2920
2019,12,4,0,17210,17419,14525,-2894
2019,12,4,1,16740,16947,14078,-2869
2019,12,4,2,16190,16261,13365,-2896
2019,12,4,3,15260,15236,12141,-3095
2019,12,4,4,13960,14016,10693,-3323
2019,12,4,5,12860,12927,9570,-3357
2019,12,4,6,12240,12447,9168,-3279
2019,12,4,7,11890,12181,8844,-3337
2019,12,4,8,11740,12018,8670,-3348
2019,12,4,9,11750,12042,8707,-3335
2019,12,4,10,12050,12399,9015,-3384
2019,12,4,11,13120,13141,9904,-3237
2019,12,4,12,14740,14756,11761,-2995
2019,12,4,13,15720,15652,12643,-3009
2019,12,4,14,15780,15795,12695,-3100
2019,12,4,15,15760,15783,12679,-3104
2019,12,4,16,15530,15730,12697,-3033
2019,12,4,17,15340,15608,12478,-3130
2019,12,4,18,15290,15482,12336,-3146
2019,12,4,19,15280,15442,12345,-3097
2019,12,4,20,15320,15338,12346,-2992
2019,12,4,21,15470,15473,12543,-2930
2019,12,4,22,16660,16327,13429,-2898
2019,12,4,23,17500,16952,14125,-2827
2019,12,5,0,17270,16838,13713,-3125
2019,12,5,1,16790,16449,13259,-3190
2019,12,5,2,16120,15897,12682,-3215
2019,12,5,3,15060,14924,11696,-3228
2019,12,5,4,13750,13667,10417,-3250
2019,12,5,5,12570,12732,9197,-3535
2019,12,5,6,11850,12300,8940,-3360
2019,12,5,7,11480,12120,8965,-3155
2019,12,5,8,11300,12114,8975,-3139
2019,12,5,9,11340,12151,9083,-3068
2019,12,5,10,11740,12270,9285,-2985
2019,12,5,11,12770,12786,9960,-2826
2019,12,5,12,14480,14438,11684,-2754
2019,12,5,13,15330,15330,12667,-2663
2019,12,5,14,15270,15279,12599,-2680
2019,12,5,15,15090,14971,12303,-2668
2019,12,5,16,14630,14675,11873,-2802
2019,12,5,17,14470,14448,11553,-2895
2019,12,5,18,14300,14324,11399,-2925
2019,12,5,19,14330,14501,11611,-2890
2019,12,5,20,14570,14716,11847,-2869
2019,12,5,21,15030,15081,12309,-2772
2019,12,5,22,16210,16097,13438,-2659
2019,12,5,23,17000,16816,14107,-2709
2019,12,6,0,16920,16749,13967,-2782
2019,12,6,1,16530,16428,13539,-2889
2019,12,6,2,15980,15923,12956,-2967
2019,12,6,3,15050,15067,12005,-3062
2019,12,6,4,13730,13942,10913,-3029
2019,12,6,5,12610,13073,10121,-2952
2019,12,6,6,12120,12864,9808,-3056
2019,12,6,7,11780,12850,9794,-3056
2019,12,6,8,11620,12701,9564,-3137
2019,12,6,9,11680,12738,9494,-3244
2019,12,6,10,12060,13119,9896,-3223
2019,12,6,11,13100,13709,10611,-3098
2019,12,6,12,14770,14774,11999,-2775
2019,12,6,13,15650,15643,13492,-2151
2019,12,6,14,15830,15821,13577,-2244
2019,12,6,15,15800,15828,13440,-2388
2019,12,6,16,15740,15783,13416,-2367
2019,12,6,17,15700,15711,13265,-2446
2019,12,6,18,15500,15620,13100,-2520
2019,12,6,19,15460,15642,13036,-2606
2019,12,6,20,15340,15637,12885,-2752
2019,12,6,21,15530,15826,12563,-3263
2019,12,6,22,16470,16551,13333,-3218
2019,12,6,23,16910,16829,13272,-3557
2019,12,7,0,16590,16507,13005,-3502
2019,12,7,1,16120,15995,12440,-3555
2019,12,7,2,15540,15456,11956,-3500
2019,12,7,3,14750,14727,11377,-3350
2019,12,7,4,13740,13768,10512,-3256
2019,12,7,5,12650,12848,9636,-3212
2019,12,7,6,12100,12639,9466,-3173
2019,12,7,7,11710,12568,9127,-3441
2019,12,7,8,11530,12591,9144,-3447
2019,12,7,9,11530,12580,9189,-3391
2019,12,7,10,11740,12783,9480,-3303
2019,12,7,11,12240,13010,9751,-3259
2019,12,7,12,13080,13587,10294,-3293
2019,12,7,13,13890,14061,10880,-3181
2019,12,7,14,14400,14388,11273,-3115
2019,12,7,15,14350,14363,11286,-3077
2019,12,7,16,14220,14146,11140,-3006
2019,12,7,17,14110,13932,10877,-3055
2019,12,7,18,13960,13743,10589,-3154
2019,12,7,19,13830,13724,10523,-3201
2019,12,7,20,13940,14201,11017,-3184
2019,12,7,21,14620,14562,11391,-3171
2019,12,7,22,15470,15642,12609,-3033
2019,12,7,23,16390,16377,13323,-3054
2019,12,8,0,16190,16226,13102,-3124
2019,12,8,1,15690,15891,12668,-3223
2019,12,8,2,15160,15511,12355,-3156
2019,12,8,3,14620,14972,12040,-2932
2019,12,8,4,13830,14217,11157,-3060
2019,12,8,5,13080,13398,10480,-2918
2019,12,8,6,12740,12761,10084,-2677
2019,12,8,7,12390,12393,9507,-2886
2019,12,8,8,12230,12238,9284,-2954
2019,12,8,9,12220,12223,9398,-2825
2019,12,8,10,12380,12378,9586,-2792
2019,12,8,11,12750,12736,9845,-2891
2019,12,8,12,13410,13379,10436,-2943
2019,12,8,13,14080,14057,11239,-2818
2019,12,8,14,14470,14463,11720,-2743
2019,12,8,15,14400,14408,11547,-2861
2019,12,8,16,14370,14157,11093,-3064
2019,12,8,17,14410,13981,11005,-2976
2019,12,8,18,14510,13965,11051,-2914
2019,12,8,19,14660,14176,11256,-2920
2019,12,8,20,15010,14536,11615,-2921
2019,12,8,21,15590,15059,12147,-2912
2019,12,8,22,16580,16236,13405,-2831
2019,12,8,23,16980,16882,14034,-2848
2019,12,9,0,16700,16746,13807,-2939
2019,12,9,1,16220,16250,13328,-2922
2019,12,9,2,15540,15731,12626,-3105
2019,12,9,3,14550,14708,11634,-3074
2019,12,9,4,13420,13457,10143,-3314
2019,12,9,5,12400,12623,9161,-3462
2019,12,9,6,11660,12415,8922,-3493
2019,12,9,7,11240,12052,8519,-3533
2019,12,9,8,11050,11834,8278,-3556
2019,12,9,9,11000,11785,8225,-3560
2019,12,9,10,11350,12134,8619,-3515
2019,12,9,11,12360,12469,9007,-3462
2019,12,9,12,14060,14028,10685,-3343
2019,12,9,13,15030,15036,11788,-3248
2019,12,9,14,15300,15292,11978,-3314
2019,12,9,15,15380,15395,12061,-3334
2019,12,9,16,15400,15472,12285,-3187
2019,12,9,17,15360,15515,12342,-3173
2019,12,9,18,15200,15443,12296,-3147
2019,12,9,19,15100,15346,12286,-3060
2019,12,9,20,15140,15229,12178,-3051
2019,12,9,21,15470,15344,12220,-3124
2019,12,9,22,16310,16093,12936,-3157
2019,12,9,23,16750,16590,13399,-3191
2019,12,10,0,16460,16369,13022,-3347
2019,12,10,1,15850,15836,12669,-3167
2019,12,10,2,14990,15110,11832,-3278
2019,12,10,3,13990,14052,10887,-3165
2019,12,10,4,12700,12980,9799,-3181
2019,12,10,5,11630,12046,9087,-2959
2019,12,10,6,10850,11494,8646,-2848
2019,12,10,7,10300,10882,8319,-2563
2019,12,10,8,9950,10544,8243,-2301
2019,12,10,9,9960,10746,8385,-2361
2019,12,10,10,10230,10891,8530,-2361
2019,12,10,11,11120,11197,8775,-2422
2019,12,10,12,13010,12874,10079,-2795
2019,12,10,13,14090,13853,10981,-2872
2019,12,10,14,14090,13953,11213,-2740
2019,12,10,15,14070,13946,11259,-2687
2019,12,10,16,14000,13997,10776,-3221
2019,12,10,17,14010,14007,11003,-3004
2019,12,10,18,14100,14138,11396,-2742
2019,12,10,19,14210,14217,11382,-2835
2019,12,10,20,14250,14257,11268,-2989
2019,12,10,21,14510,14490,11183,-3307
2019,12,10,22,15400,15312,12208,-3104
2019,12,10,23,16250,15853,13132,-2721
2019,12,11,0,15920,15704,12716,-2988
2019,12,11,1,15420,15296,12299,-2997
2019,12,11,2,14810,14712,11873,-2839
2019,12,11,3,13920,13854,11138,-2716
2019,12,11,4,12760,12948,10003,-2945
2019,12,11,5,11710,12147,9067,-3080
2019,12,11,6,10940,11495,8810,-2685
2019,12,11,7,10640,10989,8508,-2481
2019,12,11,8,10600,10881,8644,-2237
2019,12,11,9,10730,11011,8802,-2209
2019,12,11,10,11190,11424,9027,-2397
2019,12,11,11,12250,12206,9564,-2642
2019,12,11,12,13900,13860,10925,-2935
2019,12,11,13,15050,15030,12279,-2751
2019,12,11,14,15540,15521,12549,-2972
2019,12,11,15,15860,15821,13046,-2775
2019,12,11,16,15980,15852,12688,-3164
2019,12,11,17,15750,15575,12338,-3237
2019,12,11,18,15710,15117,11888,-3229
2019,12,11,19,15650,14963,11676,-3287
2019,12,11,20,15620,15019,11805,-3214
2019,12,11,21,15870,15394,12232,-3162
2019,12,11,22,16400,16508,13411,-3097
2019,12,11,23,17250,17424,14590,-2834
2019,12,12,0,17140,17362,14409,-2953
2019,12,12,1,16710,17040,13970,-3070
2019,12,12,2,16080,16465,13340,-3125
2019,12,12,3,15170,15559,12289,-3270
2019,12,12,4,13860,14321,11002,-3319
2019,12,12,5,12730,13151,9794,-3357
2019,12,12,6,12420,12433,9138,-3295
2019,12,12,7,12080,12335,9274,-3061
2019,12,12,8,11950,12237,9159,-3078
2019,12,12,9,12030,12305,9171,-3134
2019,12,12,10,12470,12738,9506,-3232
2019,12,12,11,13590,13588,10442,-3146
2019,12,12,12,15430,15384,12298,-3086
2019,12,12,13,16380,16367,13226,-3141
2019,12,12,14,16350,16360,13075,-3285
2019,12,12,15,16050,16050,12719,-3331
2019,12,12,16,15870,15799,12273,-3526
2019,12,12,17,15690,15493,12175,-3318
2019,12,12,18,15480,15217,11819,-3398
2019,12,12,19,15340,15676,12346,-3330
2019,12,12,20,15490,15664,12572,-3092
2019,12,12,21,15900,15781,12781,-3000
2019,12,12,22,16920,16846,13800,-3046
2019,12,12,23,17500,17573,14744,-2829
2019,12,13,0,17300,17507,14579,-2928
2019,12,13,1,16980,17281,14301,-2980
2019,12,13,2,16450,16808,13721,-3087
2019,12,13,3,15530,15945,12793,-3152
2019,12,13,4,14280,14682,11801,-2881
2019,12,13,5,13150,13717,10528,-3189
2019,12,13,6,12720,13003,9848,-3155
2019,12,13,7,12330,12857,9779,-3078
2019,12,13,8,12140,12880,9985,-2895
2019,12,13,9,12140,12907,10062,-2845
2019,12,13,10,12480,13151,10386,-2765
2019,12,13,11,13460,13470,10845,-2625
2019,12,13,12,15140,15086,12510,-2576
2019,12,13,13,16050,16045,13486,-2559
2019,12,13,14,15910,16154,13101,-3053
2019,12,13,15,16070,16052,13318,-2734
2019,12,13,16,15930,15938,13064,-2874
2019,12,13,17,15800,15834,13029,-2805
2019,12,13,18,15730,15659,12843,-2816
2019,12,13,19,15760,15671,12811,-2860
2019,12,13,20,15740,15615,12768,-2847
2019,12,13,21,15900,15764,12960,-2804
2019,12,13,22,16580,16489,13807,-2682
2019,12,13,23,16730,16779,13883,-2896
2019,12,14,0,16360,16405,13434,-2971
2019,12,14,1,15870,15864,12812,-3052
2019,12,14,2,15270,15292,12176,-3116
2019,12,14,3,14450,14536,11498,-3038
2019,12,14,4,13400,13697,11027,-2670
2019,12,14,5,12370,12594,10076,-2518
2019,12,14,6,11590,11924,9502,-2422
2019,12,14,7,11070,11791,9174,-2617
2019,12,14,8,10780,11634,8729,-2905
2019,12,14,9,10650,11608,8527,-3081
2019,12,14,10,10720,11668,8706,-2962
2019,12,14,11,11080,12001,8994,-3007
2019,12,14,12,11790,12163,9633,-2530
2019,12,14,13,12680,12889,10248,-2641
2019,12,14,14,13410,13555,10825,-2730
2019,12,14,15,13900,13885,10810,-3075
2019,12,14,16,14160,14035,10733,-3302
2019,12,14,17,14080,13930,10573,-3357
2019,12,14,18,13980,13801,10402,-3399
2019,12,14,19,13910,13670,10231,-3439
2019,12,14,20,13950,13647,10156,-3491
2019,12,14,21,14100,13868,10362,-3506
2019,12,14,22,14970,14605,11138,-3467
2019,12,14,23,15180,14911,11374,-3537
2019,12,15,0,14880,14595,11044,-3551
2019,12,15,1,14260,14130,10722,-3408
2019,12,15,2,13720,13622,10270,-3352
2019,12,15,3,13080,13011,9721,-3290
2019,12,15,4,12350,12296,9129,-3167
2019,12,15,5,11310,11616,8490,-3126
2019,12,15,6,10620,11145,8130,-3015
2019,12,15,7,10180,10950,8222,-2728
2019,12,15,8,9990,10790,8054,-2736
2019,12,15,9,9960,10749,8030,-2719
2019,12,15,10,10100,11089,8233,-2856
2019,12,15,11,10390,11208,8284,-2924
2019,12,15,12,10970,11511,8718,-2793
2019,12,15,13,11640,11790,8862,-2928
2019,12,15,14,12340,12333,9240,-3093
2019,12,15,15,12600,12588,9485,-3103
2019,12,15,16,12480,12563,9187,-3376
2019,12,15,17,12330,12882,9581,-3301
2019,12,15,18,12480,13238,10042,-3196
2019,12,15,19,12710,13266,10151,-3115
2019,12,15,20,13010,13418,10088,-3330
2019,12,15,21,13800,13860,10603,-3257
2019,12,15,22,14970,15119,11650,-3469
2019,12,15,23,15860,16062,12680,-3382
2019,12,16,0,15800,16070,12676,-3394
2019,12,16,1,15450,15741,12323,-3418
2019,12,16,2,14880,15292,11875,-3417
2019,12,16,3,14080,14492,11238,-3254
2019,12,16,4,13000,13395,10191,-3204
2019,12,16,5,12040,12637,9323,-3314
2019,12,16,6,11720,12523,9454,-3069
2019,12,16,7,11370,11920,9026,-2894
2019,12,16,8,11270,11921,9250,-2671
2019,12,16,9,11360,12151,9215,-2936
2019,12,16,10,11800,12443,9498,-2945
2019,12,16,11,12930,13009,9789,-3220
2019,12,16,12,14740,14685,11563,-3122
2019,12,16,13,15740,15734,12607,-3127
2019,12,16,14,15840,15832,12571,-3261
2019,12,16,15,15770,15793,12638,-3155
2019,12,16,16,15570,15791,12536,-3255
2019,12,16,17,15580,15745,12417,-3328
2019,12,16,18,15590,15493,12199,-3294
2019,12,16,19,15580,15380,12024,-3356
2019,12,16,20,15660,15529,12213,-3316
2019,12,16,21,16010,15910,12787,-3123
2019,12,16,22,16660,17019,13895,-3124
2019,12,16,23,17490,17849,14682,-3167
2019,12,17,0,17400,17760,14562,-3198
2019,12,17,1,17200,17371,14137,-3234
2019,12,17,2,16540,16769,13538,-3231
2019,12,17,3,15500,15782,12576,-3206
2019,12,17,4,14150,14555,11233,-3322
2019,12,17,5,12940,13631,10206,-3425
2019,12,17,6,12410,13227,9907,-3320
2019,12,17,7,12020,13034,9519,-3515
2019,12,17,8,11820,12895,9413,-3482
2019,12,17,9,11850,12887,9419,-3468
2019,12,17,10,12230,13034,9812,-3222
2019,12,17,11,13240,13840,10814,-3026
2019,12,17,12,14970,14805,11815,-2990
2019,12,17,13,16040,15690,12698,-2992
2019,12,17,14,16310,16245,13059,-3186
2019,12,17,15,16650,16647,13418,-3229
2019,12,17,16,16620,16933,13708,-3225
2019,12,17,17,16570,17126,13503,-3623
2019,12,17,18,17130,17147,13528,-3619
2019,12,17,19,17180,17103,13670,-3433
2019,12,17,20,17110,16950,13544,-3406
2019,12,17,21,17210,17003,13737,-3266
2019,12,17,22,17460,17731,14533,-3198
2019,12,17,23,18120,18210,14951,-3259
2019,12,18,0,17850,17867,14504,-3363
2019,12,18,1,17320,17339,13901,-3438
2019,12,18,2,16590,16610,13128,-3482
2019,12,18,3,15620,15550,11918,-3632
2019,12,18,4,14340,14380,10660,-3720
2019,12,18,5,13220,13415,9906,-3509
2019,12,18,6,12490,13026,9339,-3687
2019,12,18,7,12070,12767,9270,-3497
2019,12,18,8,11920,12604,9086,-3518
2019,12,18,9,11940,12698,9225,-3473
2019,12,18,10,12370,13243,9780,-3463
2019,12,18,11,13540,14163,10914,-3249
2019,12,18,12,15510,15132,12177,-2955
2019,12,18,13,16470,15749,12829,-2920
2019,12,18,14,16050,15973,12932,-3041
2019,12,18,15,15760,15764,12747,-3017
2019,12,18,16,15470,15350,12357,-2993
2019,12,18,17,15360,14953,11947,-3006
2019,12,18,18,15300,14725,11733,-2992
2019,12,18,19,15440,15250,12263,-2987
2019,12,18,20,15830,15440,12620,-2820
2019,12,18,21,16450,15622,12896,-2726
2019,12,18,22,17170,16696,13978,-2718
2019,12,18,23,18080,17536,14757,-2779
2019,12,19,0,18110,17557,14674,-2883
2019,12,19,1,17920,17301,14409,-2892
2019,12,19,2,17450,16896,14022,-2874
2019,12,19,3,16650,16133,13123,-3010
2019,12,19,4,15410,15042,11852,-3190
2019,12,19,5,14300,14221,10802,-3419
2019,12,19,6,13300,13572,10025,-3547
2019,12,19,7,13030,13390,9803,-3587
2019,12,19,8,13000,13541,9899,-3642
2019,12,19,9,13130,13670,10056,-3614
2019,12,19,10,13580,13879,10412,-3467
2019,12,19,11,14710,14703,11595,-3108
2019,12,19,12,16540,16495,13559,-2936
2019,12,19,13,17520,17517,14596,-2921
2019,12,19,14,17480,17489,14161,-3328
2019,12,19,15,17110,17098,13376,-3722
2019,12,19,16,16790,16700,13203,-3497
2019,12,19,17,16650,16371,12947,-3424
2019,12,19,18,16460,16122,12679,-3443
2019,12,19,19,16460,16199,12678,-3521
2019,12,19,20,16680,16468,13042,-3426
2019,12,19,21,17230,16999,13715,-3284
2019,12,19,22,18340,18085,14885,-3200
2019,12,19,23,19200,18884,15720,-3164
2019,12,20,0,18980,18811,15482,-3329
2019,12,20,1,18660,18596,15405,-3191
2019,12,20,2,18110,18170,14851,-3319
2019,12,20,3,17190,17332,13853,-3479
2019,12,20,4,15970,16119,12519,-3600
2019,12,20,5,14840,14936,11393,-3543
2019,12,20,6,14120,14131,10516,-3615
2019,12,20,7,13660,13667,10012,-3655
2019,12,20,8,13490,13499,9828,-3671
2019,12,20,9,13510,13524,9823,-3701
2019,12,20,10,13920,13903,10195,-3708
2019,12,20,11,14890,14861,11337,-3524
2019,12,20,12,16560,16517,13022,-3495
2019,12,20,13,17460,17464,14642,-2822
2019,12,20,14,17330,17370,14152,-3218
2019,12,20,15,16840,16841,13245,-3596
2019,12,20,16,16410,16343,12726,-3617
2019,12,20,17,16050,15862,12168,-3694
2019,12,20,18,15850,15945,12250,-3695
2019,12,20,19,15770,15999,12316,-3683
2019,12,20,20,15980,16230,12549,-3681
2019,12,20,21,16470,16613,13051,-3562
2019,12,20,22,17360,17316,13871,-3445
2019,12,20,23,18150,18052,14536,-3516
2019,12,21,0,17870,17865,14335,-3530
2019,12,21,1,17460,17491,14012,-3479
2019,12,21,2,16940,17027,13542,-3485
2019,12,21,3,16220,16339,12742,-3597
2019,12,21,4,15210,15368,11753,-3615
2019,12,21,5,14170,14327,10861,-3466
2019,12,21,6,13530,13747,10257,-3490
2019,12,21,7,13100,13652,10038,-3614
2019,12,21,8,12890,13458,9794,-3664
2019,12,21,9,12850,13331,9750,-3581
2019,12,21,10,13030,13545,9992,-3553
2019,12,21,11,13470,13979,10425,-3554
2019,12,21,12,14220,14267,10861,-3406
2019,12,21,13,15010,14990,11678,-3312
2019,12,21,14,15530,15516,12231,-3285
2019,12,21,15,15520,15542,12246,-3296
2019,12,21,16,15290,15513,12409,-3104
2019,12,21,17,15130,15338,12383,-2955
2019,12,21,18,14840,15142,12002,-3140
2019,12,21,19,14830,15059,11983,-3076
2019,12,21,20,15030,15381,12247,-3134
2019,12,21,21,15390,15535,12454,-3081
2019,12,21,22,16460,16245,13260,-2985
2019,12,21,23,17050,16744,13808,-2936
2019,12,22,0,16830,16573,13626,-2947
2019,12,22,1,16390,16140,13159,-2981
2019,12,22,2,15870,15970,12939,-3031
2019,12,22,3,15270,15413,12339,-3074
2019,12,22,4,14350,14341,11277,-3064
2019,12,22,5,13430,13404,10194,-3210
2019,12,22,6,12710,12733,9338,-3395
2019,12,22,7,12250,12250,8749,-3501
2019,12,22,8,12030,12026,8580,-3446
2019,12,22,9,11950,11944,8541,-3403
2019,12,22,10,12040,12028,8663,-3365
2019,12,22,11,12370,12346,8956,-3390
2019,12,22,12,12960,12948,9665,-3283
2019,12,22,13,13600,13591,10391,-3200
2019,12,22,14,14090,14094,10863,-3231
2019,12,22,15,14200,14207,10973,-3234
2019,12,22,16,14140,14066,10745,-3321
2019,12,22,17,14010,13804,10455,-3349
2019,12,22,18,13930,13708,10313,-3395
2019,12,22,19,13890,13575,10188,-3387
2019,12,22,20,14070,13746,10343,-3403
2019,12,22,21,14460,14168,10858,-3310
2019,12,22,22,15260,15345,12076,-3269
2019,12,22,23,16200,16219,13070,-3149
2019,12,23,0,16070,16113,12715,-3398
2019,12,23,1,15760,15777,12183,-3594
2019,12,23,2,15190,15315,11574,-3741
2019,12,23,3,14420,14660,11054,-3606
2019,12,23,4,13420,13876,9992,-3884
2019,12,23,5,12410,12848,8988,-3860
2019,12,23,6,11770,12132,8268,-3864
2019,12,23,7,11300,12263,8381,-3882
2019,12,23,8,11200,12147,8274,-3873
2019,12,23,9,11270,12180,8396,-3784
2019,12,23,10,11640,12308,8546,-3762
2019,12,23,11,12630,12697,8971,-3726
2019,12,23,12,14300,13864,10240,-3624
2019,12,23,13,15270,14871,11280,-3591
2019,12,23,14,14980,15042,11424,-3618
2019,12,23,15,14360,14532,11032,-3500
2019,12,23,16,13950,13927,10537,-3390
2019,12,23,17,13590,13372,9946,-3426
2019,12,23,18,13260,13044,9858,-3186
2019,12,23,19,13310,13128,10086,-3042
2019,12,23,20,13590,13541,10359,-3182
2019,12,23,21,14300,14126,10977,-3149
2019,12,23,22,15520,15239,11976,-3263
2019,12,23,23,16500,16035,12734,-3301
2019,12,24,0,16380,15882,12561,-3321
2019,12,24,1,15980,15477,12155,-3322
2019,12,24,2,15380,14969,11760,-3209
2019,12,24,3,14430,14224,10776,-3448
2019,12,24,4,13270,13220,9816,-3404
2019,12,24,5,12180,12308,9128,-3180
2019,12,24,6,11230,12382,8979,-3403
2019,12,24,7,10690,12127,8587,-3540
2019,12,24,8,10490,11917,8272,-3645
2019,12,24,9,10470,11888,8252,-3636
2019,12,24,10,10870,11918,8592,-3326
2019,12,24,11,11510,12891,9234,-3657
2019,12,24,12,12600,13773,9976,-3797
2019,12,24,13,13320,13908,10537,-3371
2019,12,24,14,13440,14025,10617,-3408
2019,12,24,15,13240,13869,10425,-3444
2019,12,24,16,12930,13382,9876,-3506
2019,12,24,17,12770,13144,9672,-3472
2019,12,24,18,12540,12855,9639,-3216
2019,12,24,19,12630,12975,9811,-3164
2019,12,24,20,13040,13507,10165,-3342
2019,12,24,21,13710,14198,10958,-3240
2019,12,24,22,14750,14973,11614,-3359
2019,12,24,23,15120,15355,12358,-2997
2019,12,25,0,14510,14777,11770,-3007
2019,12,25,1,14090,14229,10978,-3251
2019,12,25,2,13810,13904,10637,-3267
2019,12,25,3,13540,13608,10148,-3460
2019,12,25,4,13090,13093,9672,-3421
2019,12,25,5,12450,12388,9034,-3354
2019,12,25,6,11720,11744,8449,-3295
2019,12,25,7,11290,11306,8248,-3058
2019,12,25,8,11070,11235,8025,-3210
2019,12,25,9,11020,11161,8061,-3100
2019,12,25,10,11140,11159,7926,-3233
2019,12,25,11,11500,11547,8000,-3547
2019,12,25,12,12070,12209,8466,-3743
2019,12,25,13,12730,12881,9501,-3380
2019,12,25,14,13300,13274,9771,-3503
2019,12,25,15,13150,13083,9289,-3794
2019,12,25,16,12800,12615,9016,-3599
2019,12,25,17,12630,12310,8934,-3376
2019,12,25,18,12520,12212,8971,-3241
2019,12,25,19,12530,12317,8961,-3356
2019,12,25,20,12600,12594,9267,-3327
2019,12,25,21,12900,12922,9498,-3424
2019,12,25,22,13660,13735,10269,-3466
2019,12,25,23,14140,14229,10566,-3663
2019,12,26,0,14080,14135,10510,-3625
2019,12,26,1,13940,14009,10392,-3617
2019,12,26,2,13660,13845,10247,-3598
2019,12,26,3,13320,13424,9659,-3765
2019,12,26,4,12600,12700,8884,-3816
2019,12,26,5,11810,11913,8245,-3668
2019,12,26,6,11280,11337,8109,-3228
2019,12,26,7,10800,10979,7947,-3032
2019,12,26,8,10650,10931,8088,-2843
2019,12,26,9,10690,11102,8299,-2803
2019,12,26,10,10970,11162,8308,-2854
2019,12,26,11,11760,11906,8791,-3115
2019,12,26,12,13040,13003,9584,-3419
2019,12,26,13,13930,13909,10636,-3273
2019,12,26,14,14350,14375,10997,-3378
2019,12,26,15,14280,14360,10745,-3615
2019,12,26,16,14290,14398,10779,-3619
2019,12,26,17,14250,14477,10871,-3606
2019,12,26,18,13980,14573,11044,-3529
2019,12,26,19,14180,14657,11132,-3525
2019,12,26,20,14390,14816,11235,-3581
2019,12,26,21,14710,15100,11367,-3733
2019,12,26,22,15740,16101,12581,-3520
2019,12,26,23,16430,16719,13248,-3471
2019,12,27,0,16360,16464,13029,-3435
2019,12,27,1,15960,15996,12577,-3419
2019,12,27,2,15360,15419,12202,-3217
2019,12,27,3,14430,14551,11296,-3255
2019,12,27,4,13200,13465,10097,-3368
2019,12,27,5,12080,12443,9146,-3297
2019,12,27,6,11470,11675,8743,-2932
2019,12,27,7,11050,11494,8537,-2957
2019,12,27,8,10850,11542,8321,-3221
2019,12,27,9,10850,11499,8295,-3204
2019,12,27,10,11170,11507,8363,-3144
2019,12,27,11,11930,11976,8872,-3104
2019,12,27,12,13090,12957,9659,-3298
2019,12,27,13,14100,13913,10449,-3464
2019,12,27,14,14580,14567,11170,-3397
2019,12,27,15,14990,14937,11578,-3359
2019,12,27,16,15270,15077,11678,-3399
2019,12,27,17,15360,15009,11684,-3325
2019,12,27,18,15260,14796,11500,-3296
2019,12,27,19,15180,14695,11421,-3274
2019,12,27,20,15050,14645,11396,-3249
2019,12,27,21,15060,14739,11512,-3227
2019,12,27,22,15580,15391,12094,-3297
2019,12,27,23,15690,15754,12414,-3340
2019,12,28,0,15540,15393,12018,-3375
2019,12,28,1,14990,14902,11430,-3472
2019,12,28,2,14390,14359,10879,-3480
2019,12,28,3,13610,13643,10270,-3373
2019,12,28,4,12600,12890,9593,-3297
2019,12,28,5,11570,12209,9116,-3093
2019,12,28,6,10940,11576,8583,-2993
2019,12,28,7,10450,11120,7821,-3299
2019,12,28,8,10220,10889,7725,-3164
2019,12,28,9,10200,10823,7809,-3014
2019,12,28,10,10350,11189,8045,-3144
2019,12,28,11,10710,11618,8263,-3355
2019,12,28,12,11340,12251,8682,-3569
2019,12,28,13,12100,12725,9312,-3413
2019,12,28,14,12610,12833,9436,-3397
2019,12,28,15,12540,12654,9432,-3222
2019,12,28,16,12230,12357,8981,-3376
2019,12,28,17,11980,12093,8867,-3226
2019,12,28,18,11800,11896,8959,-2937
2019,12,28,19,11740,11913,8768,-3145
2019,12,28,20,12110,12229,9054,-3175
2019,12,28,21,12870,12883,9985,-2898
2019,12,28,22,14010,14081,10510,-3571
2019,12,28,23,14770,14901,11229,-3672
2019,12,29,0,14840,14796,11166,-3630
2019,12,29,1,14460,14490,10921,-3569
2019,12,29,2,14060,14151,10630,-3521
2019,12,29,3,13480,13619,10054,-3565
2019,12,29,4,12670,12866,9348,-3518
2019,12,29,5,11830,12055,8675,-3380
2019,12,29,6,11140,11370,8102,-3268
2019,12,29,7,10670,10941,7713,-3228
2019,12,29,8,10530,10921,7540,-3381
2019,12,29,9,10400,10918,7348,-3570
2019,12,29,10,10490,10789,7168,-3621
2019,12,29,11,10770,11062,7482,-3580
2019,12,29,12,11270,11607,8032,-3575
2019,12,29,13,11930,12147,8337,-3810
2019,12,29,14,12540,12488,8659,-3829
2019,12,29,15,12480,12611,8804,-3807
2019,12,29,16,12650,12392,8598,-3794
2019,12,29,17,12170,12287,8741,-3546
2019,12,29,18,12350,12477,9229,-3248
2019,12,29,19,12620,12515,9190,-3325
2019,12,29,20,12960,13073,9574,-3499
2019,12,29,21,13600,13599,10115,-3484
2019,12,29,22,14890,14802,11363,-3439
2019,12,29,23,15650,15468,12033,-3435
2019,12,30,0,15540,15291,11945,-3346
2019,12,30,1,15130,14847,11392,-3455
2019,12,30,2,14620,14328,10633,-3695
2019,12,30,3,13710,13584,9792,-3792
2019,12,30,4,12670,12712,8831,-3881
2019,12,30,5,11680,12048,8317,-3731
2019,12,30,6,11130,11622,7918,-3704
2019,12,30,7,10770,11583,7843,-3740
2019,12,30,8,10630,11430,7660,-3770
2019,12,30,9,10680,11467,7772,-3695
2019,12,30,10,11020,11784,8075,-3709
2019,12,30,11,11820,11955,8752,-3203
2019,12,30,12,13000,12969,9798,-3171
2019,12,30,13,14030,14006,10741,-3265
2019,12,30,14,14760,14744,11199,-3545
2019,12,30,15,15350,15332,11723,-3609
2019,12,30,16,15650,15772,12181,-3591
2019,12,30,17,15730,16076,12552,-3524
2019,12,30,18,15600,16168,12749,-3419
2019,12,30,19,15420,16163,12842,-3321
2019,12,30,20,15440,16057,12805,-3252
2019,12,30,21,15670,16049,12696,-3353
2019,12,30,22,16640,16704,13468,-3236
2019,12,30,23,17150,17199,13976,-3223
2019,12,31,0,16900,16868,13620,-3248
2019,12,31,1,16470,16272,12797,-3475
2019,12,31,2,15740,15578,12038,-3540
2019,12,31,3,14740,14653,10963,-3690
2019,12,31,4,13520,13543,10017,-3526
2019,12,31,5,12360,12762,9341,-3421
2019,12,31,6,11770,12131,8860,-3271
2019,12,31,7,11250,11564,8343,-3221
2019,12,31,8,11010,11310,7962,-3348
2019,12,31,9,10950,11345,8144,-3201
2019,12,31,10,11170,11635,8397,-3238
2019,12,31,11,11870,12135,8735,-3400
2019,12,31,12,12930,12899,9351,-3548
2019,12,31,13,13710,13702,10192,-3510
2019,12,31,14,14260,14254,10706,-3548
2019,12,31,15,14520,14550,11159,-3391
2019,12,31,16,14460,14751,11399,-3352
2019,12,31,17,14400,14877,11537,-3340
2019,12,31,18,14130,14892,11586,-3306
2019,12,31,19,13990,14945,11683,-3262
2019,12,31,20,14040,14890,11701,-3189
2019,12,31,21,14380,14943,11878,-3065
2019,12,31,22,15260,15627,12312,-3315
2019,12,31,23,15840,16128,12803,-3325
2020,1,1,0,15420,15602,12109,-3493
2020,1,1,1,14840,14810,11240,-3570
2020,1,1,2,14140,14091,10515,-3576
2020,1,1,3,13460,13408,9920,-3488
2020,1,1,4,12750,12712,9202,-3510
2020,1,1,5,12120,12056,8774,-3282
2020,1,1,6,11350,11462,8751,-2711
2020,1,1,7,11020,11025,8397,-2628
2020,1,1,8,10710,10714,8056,-2658
2020,1,1,9,10580,10830,8047,-2783
2020,1,1,10,10680,10967,8167,-2800
2020,1,1,11,11020,11282,8217,-3065
2020,1,1,12,11500,11484,8429,-3055
2020,1,1,13,11810,11821,8405,-3416
2020,1,1,14,12040,12033,8590,-3443
2020,1,1,15,12130,12139,8759,-3380
2020,1,1,16,12250,12300,9111,-3189
2020,1,1,17,12400,12533,9345,-3188
2020,1,1,18,12470,12771,9485,-3286
2020,1,1,19,12680,12888,9904,-2984
2020,1,1,20,13020,13139,10237,-2902
2020,1,1,21,13530,13667,10811,-2856
2020,1,1,22,14650,14790,11845,-2945
2020,1,1,23,15560,15793,12738,-3055
2020,1,2,0,15370,15641,12457,-3184
2020,1,2,1,15000,15190,11928,-3262
2020,1,2,2,14510,14607,11305,-3302
2020,1,2,3,13720,13777,10602,-3175
2020,1,2,4,12740,12764,9800,-2964
2020,1,2,5,11850,12083,9289,-2794
2020,1,2,6,11230,11818,8808,-3010
2020,1,2,7,10910,11712,8594,-3118
2020,1,2,8,10790,11613,8506,-3107
2020,1,2,9,10860,11921,8664,-3257
2020,1,2,10,11220,12116,9039,-3077
2020,1,2,11,12260,12822,9660,-3162
2020,1,2,12,13890,13898,10812,-3086
2020,1,2,13,14890,14900,11482,-3418
2020,1,2,14,14690,14948,11509,-3439
2020,1,2,15,14520,14677,11180,-3497
2020,1,2,16,14110,14364,10941,-3423
2020,1,2,17,13820,13921,10518,-3403
2020,1,2,18,13640,13421,10016,-3405
2020,1,2,19,13690,13395,9969,-3426
2020,1,2,20,13850,13771,10382,-3389
2020,1,2,21,14250,14433,11127,-3306
2020,1,2,22,15480,15462,12218,-3244
2020,1,2,23,16100,16344,13543,-2801
2020,1,3,0,15960,16225,13151,-3074
2020,1,3,1,15560,15739,12626,-3113
2020,1,3,2,14960,15093,11821,-3272
2020,1,3,3,14030,14126,10821,-3305
2020,1,3,4,12870,12915,9802,-3113
2020,1,3,5,11840,12319,9198,-3121
2020,1,3,6,11160,11843,8795,-3048
2020,1,3,7,10720,11461,8510,-2951
2020,1,3,8,10540,11408,8355,-3053
2020,1,3,9,10450,11484,8457,-3027
2020,1,3,10,10760,11565,8608,-2957
2020,1,3,11,11760,12405,9592,-2813
2020,1,3,12,13330,13640,10743,-2897
2020,1,3,13,14330,14184,11088,-3096
2020,1,3,14,14570,14403,11618,-2785
2020,1,3,15,14610,14503,11782,-2721
2020,1,3,16,14710,14625,11810,-2815
2020,1,3,17,14700,14500,11655,-2845
2020,1,3,18,14570,14369,11585,-2784
2020,1,3,19,14560,14406,11656,-2750
2020,1,3,20,14520,14376,11567,-2809
2020,1,3,21,14700,14449,11423,-3026
2020,1,3,22,15420,15113,11968,-3145
2020,1,3,23,15920,15615,12721,-2894
2020,1,4,0,15570,15352,12498,-2854
2020,1,4,1,14970,14828,11917,-2911
2020,1,4,2,14340,14235,11236,-2999
2020,1,4,3,13550,13473,10482,-2991
2020,1,4,4,12590,12629,9899,-2730
2020,1,4,5,11640,11813,9252,-2561
2020,1,4,6,10910,11083,8602,-2481
2020,1,4,7,10400,10891,8293,-2598
2020,1,4,8,10150,10656,8121,-2535
2020,1,4,9,10110,10563,7936,-2627
2020,1,4,10,10260,10639,8056,-2583
2020,1,4,11,10670,10730,8049,-2681
2020,1,4,12,11340,11101,8370,-2731
2020,1,4,13,12090,11838,8918,-2920
2020,1,4,14,12830,12617,9801,-2816
2020,1,4,15,13430,13317,10326,-2991
2020,1,4,16,13760,13761,10519,-3242
2020,1,4,17,13950,14023,10719,-3304
2020,1,4,18,13920,14069,10775,-3294
2020,1,4,19,13880,13999,10735,-3264
2020,1,4,20,13730,13910,10614,-3296
2020,1,4,21,13910,14001,10867,-3134
2020,1,4,22,14760,14594,11518,-3076
2020,1,4,23,15250,15020,11950,-3070
2020,1,5,0,15000,14775,11768,-3007
2020,1,5,1,14400,14267,11240,-3027
2020,1,5,2,13850,13790,10982,-2808
2020,1,5,3,13190,13145,10265,-2880
2020,1,5,4,12390,12451,9700,-2751
2020,1,5,5,11600,11646,8960,-2686
2020,1,5,6,11020,11139,8600,-2539
2020,1,5,7,10590,11134,8436,-2698
2020,1,5,8,10410,11074,8414,-2660
2020,1,5,9,10290,11010,8168,-2842
2020,1,5,10,10450,11122,8308,-2814
2020,1,5,11,10840,11406,8501,-2905
2020,1,5,12,11430,11691,8814,-2877
2020,1,5,13,12150,12292,9151,-3141
2020,1,5,14,12800,12815,9820,-2995
2020,1,5,15,12960,12720,9700,-3020
2020,1,5,16,13020,12986,10011,-2975
2020,1,5,17,13020,13205,10190,-3015
2020,1,5,18,13040,13267,10347,-2920
2020,1,5,19,13030,13027,10153,-2874
2020,1,5,20,13190,13163,10190,-2973
2020,1,5,21,13710,13858,10927,-2931
2020,1,5,22,14940,15078,12019,-3059
2020,1,5,23,15810,16173,13268,-2905
2020,1,6,0,15800,16076,13014,-3062
2020,1,6,1,15450,15629,12433,-3196
2020,1,6,2,14950,15031,11947,-3084
2020,1,6,3,14170,14166,10830,-3336
2020,1,6,4,13220,13123,9977,-3146
2020,1,6,5,12330,12384,9368,-3016
2020,1,6,6,11680,12346,9327,-3019
2020,1,6,7,11360,12118,9040,-3078
2020,1,6,8,11260,12023,8760,-3263
2020,1,6,9,11330,12054,8862,-3192
2020,1,6,10,11770,12247,9230,-3017
2020,1,6,11,12890,13010,9872,-3138
2020,1,6,12,14660,14612,11721,-2891
2020,1,6,13,15670,15621,12729,-2892
2020,1,6,14,15660,15732,12811,-2921
2020,1,6,15,15580,15572,12664,-2908
2020,1,6,16,15460,15531,12651,-2880
2020,1,6,17,15410,15684,12749,-2935
2020,1,6,18,15260,15537,12633,-2904
2020,1,6,19,15170,15308,12167,-3141
2020,1,6,20,15210,15197,12025,-3172
2020,1,6,21,15570,15355,12457,-2898
2020,1,6,22,16510,16145,13190,-2955
2020,1,6,23,17310,17046,14090,-2956
2020,1,7,0,17040,16964,14081,-2883
2020,1,7,1,16540,16523,13576,-2947
2020,1,7,2,15890,15841,12910,-2931
2020,1,7,3,14940,14845,12038,-2807
2020,1,7,4,13690,13648,10736,-2912
2020,1,7,5,12620,12799,9567,-3232
2020,1,7,6,11920,12322,9601,-2721
2020,1,7,7,11500,12037,9368,-2669
2020,1,7,8,11380,11865,9222,-2643
2020,1,7,9,11460,12050,9298,-2752
2020,1,7,10,11760,12392,9625,-2767
2020,1,7,11,12830,13272,10087,-3185
2020,1,7,12,14630,14571,11348,-3223
2020,1,7,13,15440,15435,12267,-3168
2020,1,7,14,14940,15357,12499,-2858
2020,1,7,15,14520,14852,11915,-2937
2020,1,7,16,14220,14365,11247,-3118
2020,1,7,17,13970,13909,10681,-3228
2020,1,7,18,14030,13745,10514,-3231
2020,1,7,19,14270,14357,11449,-2908
2020,1,7,20,14570,14486,11479,-3007
2020,1,7,21,15090,14889,11927,-2962
2020,1,7,22,16250,15849,12775,-3074
2020,1,7,23,17220,16695,13706,-2989
2020,1,8,0,17090,16600,13624,-2976
2020,1,8,1,16610,16132,13164,-2968
2020,1,8,2,15880,15464,12241,-3223
2020,1,8,3,14800,14530,11591,-2939
2020,1,8,4,13540,13569,10411,-3158
2020,1,8,5,12530,12518,9586,-2932
2020,1,8,6,11550,11840,8976,-2864
2020,1,8,7,11190,11727,8725,-3002
2020,1,8,8,11040,11681,8734,-2947
2020,1,8,9,11080,11761,8967,-2794
2020,1,8,10,11530,11713,8987,-2726
2020,1,8,11,12690,12568,9445,-3123
2020,1,8,12,14430,14226,11092,-3134
2020,1,8,13,15370,15213,12172,-3041
2020,1,8,14,15220,15245,12489,-2756
2020,1,8,15,14910,14896,12098,-2798
2020,1,8,16,14680,14489,11410,-3079
2020,1,8,17,14470,14024,11007,-3017
2020,1,8,18,14380,13844,10783,-3061
2020,1,8,19,14470,14118,11080,-3038
2020,1,8,20,14710,14420,11411,-3009
2020,1,8,21,15140,14988,11994,-2994
2020,1,8,22,16130,15959,12880,-3079
2020,1,8,23,17170,16935,13888,-3047
2020,1,9,0,17150,16909,13730,-3179
2020,1,9,1,16800,16576,13436,-3140
2020,1,9,2,16220,16028,12892,-3136
2020,1,9,3,15300,15220,12007,-3213
2020,1,9,4,14150,14090,10747,-3343
2020,1,9,5,13140,13102,9877,-3225
2020,1,9,6,12490,12691,9709,-2982
2020,1,9,7,12220,12503,9631,-2872
2020,1,9,8,12140,12420,9533,-2887
2020,1,9,9,12220,12470,9626,-2844
2020,1,9,10,12660,12636,9885,-2751
2020,1,9,11,13760,13719,10902,-2817
2020,1,9,12,15550,15499,12885,-2614
2020,1,9,13,16450,16456,14132,-2324
2020,1,9,14,16180,16208,13670,-2538
2020,1,9,15,15430,15431,12866,-2565
2020,1,9,16,14960,14830,11945,-2885
2020,1,9,17,14730,14405,11836,-2569
2020,1,9,18,14620,14151,11462,-2689
2020,1,9,19,14760,14280,11729,-2551
2020,1,9,20,15010,14740,12404,-2336
2020,1,9,21,15590,15492,13133,-2359
2020,1,9,22,16520,16616,14183,-2433
2020,1,9,23,17520,17493,14558,-2935
2020,1,10,0,17420,17445,14390,-3055
2020,1,10,1,17030,17111,14087,-3024
2020,1,10,2,16470,16504,13449,-3055
2020,1,10,3,15560,15579,12662,-2917
2020,1,10,4,14360,14353,11632,-2721
2020,1,10,5,13290,13282,10545,-2737
2020,1,10,6,12600,12845,10454,-2391
2020,1,10,7,12220,12709,10507,-2202
2020,1,10,8,12010,12559,10380,-2179
2020,1,10,9,11990,12522,10356,-2166
2020,1,10,10,12290,12814,10625,-2189
2020,1,10,11,13200,13317,10871,-2446
2020,1,10,12,14810,14755,12155,-2600
2020,1,10,13,15670,15652,12959,-2693
2020,1,10,14,15580,15612,12716,-2896
2020,1,10,15,15310,15319,12744,-2575
2020,1,10,16,14870,15308,12650,-2658
2020,1,10,17,14670,15311,12476,-2835
2020,1,10,18,14520,15231,12272,-2959
2020,1,10,19,14530,15213,12202,-3011
2020,1,10,20,14570,14955,11922,-3033
2020,1,10,21,14770,14876,11761,-3115
2020,1,10,22,15500,15374,12354,-3020
2020,1,10,23,16220,15885,13008,-2877
2020,1,11,0,15860,15541,12565,-2976
2020,1,11,1,15290,14992,12061,-2931
2020,1,11,2,14650,14342,11515,-2827
2020,1,11,3,13840,13559,10785,-2774
2020,1,11,4,12780,12811,10278,-2533
2020,1,11,5,11820,12131,9598,-2533
2020,1,11,6,10860,11476,9189,-2287
2020,1,11,7,10400,11377,8961,-2416
2020,1,11,8,10130,11201,8871,-2330
2020,1,11,9,10010,11065,8681,-2384
2020,1,11,10,10090,11077,8797,-2280
2020,1,11,11,10450,11234,8889,-2345
2020,1,11,12,11090,11397,9387,-2010
2020,1,11,13,11790,11795,9724,-2071
2020,1,11,14,12400,12389,10169,-2220
2020,1,11,15,12590,12477,10420,-2057
2020,1,11,16,12550,12084,9883,-2201
2020,1,11,17,12560,11823,9591,-2232
2020,1,11,18,12590,11815,9614,-2201
2020,1,11,19,12600,11959,9655,-2304
2020,1,11,20,12610,12300,9904,-2396
2020,1,11,21,13010,12528,10360,-2168
2020,1,11,22,13670,13299,10729,-2570
2020,1,11,23,14540,13941,11175,-2766
2020,1,12,0,14130,13684,11196,-2488
2020,1,12,1,13570,13191,10933,-2258
2020,1,12,2,13010,12685,10293,-2392
2020,1,12,3,12300,12311,9763,-2548
2020,1,12,4,11570,11579,9167,-2412
2020,1,12,5,10750,10880,8664,-2216
2020,1,12,6,9870,10394,8092,-2302
2020,1,12,7,9450,10224,7812,-2412
2020,1,12,8,9200,9999,7638,-2361
2020,1,12,9,9110,9905,7415,-2490
2020,1,12,10,9160,9952,7447,-2505
2020,1,12,11,9410,10186,7374,-2812
2020,1,12,12,9870,10608,7878,-2730
2020,1,12,13,10470,10549,8269,-2280
2020,1,12,14,11200,11195,8824,-2371
2020,1,12,15,11660,11617,9320,-2297
2020,1,12,16,11610,11495,9080,-2415
2020,1,12,17,11700,11385,9030,-2355
2020,1,12,18,11750,11325,9162,-2163
2020,1,12,19,11800,11320,9080,-2240
2020,1,12,20,12050,11636,9256,-2380
2020,1,12,21,12400,12293,10036,-2257
2020,1,12,22,13190,13255,10774,-2481
2020,1,12,23,14460,14353,12013,-2340
2020,1,13,0,14500,14283,11843,-2440
2020,1,13,1,14130,13851,11364,-2487
2020,1,13,2,13590,13309,10873,-2436
2020,1,13,3,12780,12546,10332,-2214
2020,1,13,4,11880,11644,9506,-2138
2020,1,13,5,11090,11008,8633,-2375
2020,1,13,6,10330,10877,8428,-2449
2020,1,13,7,10090,10632,8084,-2548
2020,1,13,8,10040,10578,8053,-2525
2020,1,13,9,10170,10694,8233,-2461
2020,1,13,10,10630,11139,8575,-2564
2020,1,13,11,11770,11963,9383,-2580
2020,1,13,12,13600,13536,10829,-2707
2020,1,13,13,14710,14692,12162,-2530
2020,1,13,14,14910,14909,12526,-2383
2020,1,13,15,14990,15015,12445,-2570
2020,1,13,16,14950,15155,12498,-2657
2020,1,13,17,14960,15223,12550,-2673
2020,1,13,18,14900,15206,12607,-2599
2020,1,13,19,14900,15245,12542,-2703
2020,1,13,20,14890,15198,12584,-2614
2020,1,13,21,15040,15301,12772,-2529
2020,1,13,22,15840,15932,13136,-2796
2020,1,13,23,16690,16586,13847,-2739
2020,1,14,0,16520,16404,13651,-2753
2020,1,14,1,15980,15882,13150,-2732
2020,1,14,2,15290,15185,12416,-2769
2020,1,14,3,14260,14177,11379,-2798
2020,1,14,4,13010,13315,10611,-2704
2020,1,14,5,11960,12272,9716,-2556
2020,1,14,6,11150,11688,9387,-2301
2020,1,14,7,10780,11398,8931,-2467
2020,1,14,8,10650,11219,8635,-2584
2020,1,14,9,10700,11236,8612,-2624
2020,1,14,10,11080,11381,8937,-2444
2020,1,14,11,12120,12358,9651,-2707
2020,1,14,12,13840,13822,11078,-2744
2020,1,14,13,14780,14837,12037,-2800
2020,1,14,14,14930,14940,12154,-2786
2020,1,14,15,14810,14790,12113,-2677
2020,1,14,16,14460,14495,11749,-2746
2020,1,14,17,14190,14437,11848,-2589
2020,1,14,18,14100,14324,11640,-2684
2020,1,14,19,14170,14417,11687,-2730
2020,1,14,20,14370,14527,12146,-2381
2020,1,14,21,14760,14809,12397,-2412
2020,1,14,22,15680,15573,13219,-2354
2020,1,14,23,16600,16273,13737,-2536
2020,1,15,0,16440,16139,13342,-2797
2020,1,15,1,15870,15660,12905,-2755
2020,1,15,2,15160,14987,12318,-2669
2020,1,15,3,14140,14022,11225,-2797
2020,1,15,4,12890,12949,10148,-2801
2020,1,15,5,11820,12201,9553,-2648
2020,1,15,6,11090,11912,9509,-2403
2020,1,15,7,10670,11703,9357,-2346
2020,1,15,8,10490,11559,9275,-2284
2020,1,15,9,10520,11471,9027,-2444
2020,1,15,10,10870,11896,9413,-2483
2020,1,15,11,11880,12411,9841,-2570
2020,1,15,12,13580,13615,10999,-2616
2020,1,15,13,14440,14437,11785,-2652
2020,1,15,14,14170,14175,11573,-2602
2020,1,15,15,13570,13624,11188,-2436
2020,1,15,16,13210,13255,11059,-2196
2020,1,15,17,12890,13368,10974,-2394
2020,1,15,18,12800,13518,10932,-2586
2020,1,15,19,12910,13517,10815,-2702
2020,1,15,20,13300,13662,10704,-2958
2020,1,15,21,13910,13964,11364,-2600
2020,1,15,22,15060,14693,11803,-2890
2020,1,15,23,16000,15714,12722,-2992
2020,1,16,0,15990,15718,12722,-2996
2020,1,16,1,15650,15365,12283,-3082
2020,1,16,2,15030,14801,11768,-3033
2020,1,16,3,14070,13959,10988,-2971
2020,1,16,4,12920,13309,10175,-3134
2020,1,16,5,11860,12352,9385,-2967
2020,1,16,6,11220,11702,9255,-2447
2020,1,16,7,10830,11575,9172,-2403
2020,1,16,8,10670,11654,9261,-2393
2020,1,16,9,10710,11463,9187,-2276
2020,1,16,10,11100,11662,9242,-2420
2020,1,16,11,12070,11990,9571,-2419
2020,1,16,12,13750,13619,10843,-2776
2020,1,16,13,14730,14684,11801,-2883
2020,1,16,14,14650,14921,12300,-2621
2020,1,16,15,14910,14892,12307,-2585
2020,1,16,16,14610,14378,11730,-2648
2020,1,16,17,14430,13996,11078,-2918
2020,1,16,18,14270,13968,11063,-2905
2020,1,16,19,14310,14033,11126,-2907
2020,1,16,20,14320,14182,11236,-2946
2020,1,16,21,14730,14612,11789,-2823
2020,1,16,22,15580,15498,12562,-2936
2020,1,16,23,16650,16514,13427,-3087
2020,1,17,0,16600,16503,13459,-3044
2020,1,17,1,16180,16153,12959,-3194
2020,1,17,2,15630,15604,12265,-3339
2020,1,17,3,14760,14780,11329,-3451
2020,1,17,4,13640,13731,10308,-3423
2020,1,17,5,12690,13109,9528,-3581
2020,1,17,6,12350,12750,9081,-3669
2020,1,17,7,12080,12553,9032,-3521
2020,1,17,8,12040,12304,8999,-3305
2020,1,17,9,12190,12432,9269,-3163
2020,1,17,10,12680,12876,9447,-3429
2020,1,17,11,13760,13738,10308,-3430
2020,1,17,12,15500,15498,12214,-3284
2020,1,17,13,16480,16552,13277,-3275
2020,1,17,14,16300,16464,13202,-3262
2020,1,17,15,15850,15859,12655,-3204
2020,1,17,16,15540,15432,12035,-3397
2020,1,17,17,15240,15004,11920,-3084
2020,1,17,18,15050,14650,11507,-3143
2020,1,17,19,15110,14714,11659,-3055
2020,1,17,20,15410,15104,12130,-2974
2020,1,17,21,15940,15878,12975,-2903
2020,1,17,22,16870,16901,13599,-3302
2020,1,17,23,17800,17750,14366,-3384
2020,1,18,0,17750,17666,14196,-3470
2020,1,18,1,17370,17373,13744,-3629
2020,1,18,2,16840,16880,13365,-3515
2020,1,18,3,16110,16245,12775,-3470
2020,1,18,4,15200,15345,11951,-3394
2020,1,18,5,14260,14431,11313,-3118
2020,1,18,6,13770,13773,10541,-3232
2020,1,18,7,13380,13367,10361,-3006
2020,1,18,8,13160,13159,10150,-3009
2020,1,18,9,13110,13107,9969,-3138
2020,1,18,10,13200,13208,10024,-3184
2020,1,18,11,13620,13579,10516,-3063
2020,1,18,12,14330,14277,11062,-3215
2020,1,18,13,14970,15048,11955,-3093
2020,1,18,14,15480,15713,12669,-3044
2020,1,18,15,15860,15861,12803,-3058
2020,1,18,16,15760,15763,12734,-3029
2020,1,18,17,15720,15908,12875,-3033
2020,1,18,18,15580,15915,12827,-3088
2020,1,18,19,15590,15920,12661,-3259
2020,1,18,20,15690,16013,12761,-3252
2020,1,18,21,16060,16215,13177,-3038
2020,1,18,22,16550,16823,13871,-2952
2020,1,18,23,17020,17479,14597,-2882
2020,1,19,0,16800,17276,14371,-2905
2020,1,19,1,16290,16732,13617,-3115
2020,1,19,2,15540,16078,12889,-3189
2020,1,19,3,14700,15302,12107,-3195
2020,1,19,4,13820,14532,11329,-3203
2020,1,19,5,12910,13832,10813,-3019
2020,1,19,6,12540,13095,10624,-2471
2020,1,19,7,11990,12608,9948,-2660
2020,1,19,8,11760,12333,9615,-2718
2020,1,19,9,11660,12336,9437,-2899
2020,1,19,10,11790,12473,9534,-2939
2020,1,19,11,12000,12502,9635,-2867
2020,1,19,12,12470,12978,9804,-3174
2020,1,19,13,13030,13562,10389,-3173
2020,1,19,14,13570,14062,10969,-3093
2020,1,19,15,13590,14089,10777,-3312
2020,1,19,16,13500,13664,10433,-3231
2020,1,19,17,13420,13524,10191,-3333
2020,1,19,18,13470,13473,10065,-3408
2020,1,19,19,13570,13516,10111,-3405
2020,1,19,20,13650,13783,10457,-3326
2020,1,19,21,14180,14173,10804,-3369
2020,1,19,22,15090,14924,11722,-3202
2020,1,19,23,16230,15860,12671,-3189
2020,1,20,0,16210,15772,12482,-3290
2020,1,20,1,15820,15330,11861,-3469
2020,1,20,2,15270,14846,11292,-3554
2020,1,20,3,14570,14290,10719,-3571
2020,1,20,4,13670,13916,10283,-3633
2020,1,20,5,12900,13240,9658,-3582
2020,1,20,6,12230,12779,9314,-3465
2020,1,20,7,12040,13011,9609,-3402
2020,1,20,8,12000,13027,9721,-3306
2020,1,20,9,12140,13144,10033,-3111
2020,1,20,10,12520,13285,10230,-3055
2020,1,20,11,13280,13772,10550,-3222
2020,1,20,12,14400,14735,11801,-2934
2020,1,20,13,15330,15566,12759,-2807
2020,1,20,14,15920,16006,13252,-2754
2020,1,20,15,15850,15878,13002,-2876
2020,1,20,16,15930,15577,12833,-2744
2020,1,20,17,15850,15339,12440,-2899
2020,1,20,18,15600,15092,12208,-2884
2020,1,20,19,15460,15019,12120,-2899
2020,1,20,20,15450,15214,12321,-2893
2020,1,20,21,15790,15786,12937,-2849
2020,1,20,22,16840,16770,13878,-2892
2020,1,20,23,17920,17910,15008,-2902
2020,1,21,0,17850,17820,14980,-2840
2020,1,21,1,17390,17462,14491,-2971
2020,1,21,2,16810,16839,13934,-2905
2020,1,21,3,15840,15894,12828,-3066
2020,1,21,4,14660,14734,11697,-3037
2020,1,21,5,13750,13767,10738,-3029
2020,1,21,6,13250,13203,10596,-2607
2020,1,21,7,12900,12912,10444,-2468
2020,1,21,8,12820,12819,10379,-2440
2020,1,21,9,12880,13188,10433,-2755
2020,1,21,10,13310,13561,10806,-2755
2020,1,21,11,14430,14444,11805,-2639
2020,1,21,12,16230,16210,13978,-2232
2020,1,21,13,17130,17172,14834,-2338
2020,1,21,14,16720,16868,14413,-2455
2020,1,21,15,16130,16188,13432,-2756
2020,1,21,16,15730,15636,12825,-2811
2020,1,21,17,15430,15290,12603,-2687
2020,1,21,18,15220,15120,12650,-2470
2020,1,21,19,15260,15300,12761,-2539
2020,1,21,20,15420,15518,12688,-2830
2020,1,21,21,15870,15918,13105,-2813
2020,1,21,22,16770,16735,13988,-2747
2020,1,21,23,17950,17828,15286,-2542
2020,1,22,0,18050,17896,15478,-2418
2020,1,22,1,17620,17607,15171,-2436
2020,1,22,2,16990,17013,14649,-2364
2020,1,22,3,15960,16081,13505,-2576
2020,1,22,4,14750,14875,12277,-2598
2020,1,22,5,13740,13869,11202,-2667
2020,1,22,6,13150,13271,11197,-2074
2020,1,22,7,12820,12984,11010,-1974
2020,1,22,8,12670,12870,10893,-1977
2020,1,22,9,12760,12946,10987,-1959
2020,1,22,10,13170,13344,11143,-2201
2020,1,22,11,14260,14399,12047,-2352
2020,1,22,12,16000,16159,13937,-2222
2020,1,22,13,16840,17078,14719,-2359
2020,1,22,14,16340,16710,13776,-2934
2020,1,22,15,15630,15869,13086,-2783
2020,1,22,16,15030,15419,12863,-2556
2020,1,22,17,14570,14890,12388,-2502
2020,1,22,18,14270,14481,11801,-2680
2020,1,22,19,14290,14399,11453,-2946
2020,1,22,20,14450,14585,11759,-2826
2020,1,22,21,14770,14950,12268,-2682
2020,1,22,22,15810,15903,13359,-2544
2020,1,22,23,16950,17137,14761,-2376
2020,1,23,0,17070,17232,14803,-2429
2020,1,23,1,16650,16869,14538,-2331
2020,1,23,2,16030,16275,13881,-2394
2020,1,23,3,15030,15358,12952,-2406
2020,1,23,4,14010,14185,11616,-2569
2020,1,23,5,13000,13451,10652,-2799
2020,1,23,6,12620,12858,10794,-2064
2020,1,23,7,12250,12806,10708,-2098
2020,1,23,8,12120,12694,10346,-2348
2020,1,23,9,12220,12792,10497,-2295
2020,1,23,10,12640,12976,10718,-2258
2020,1,23,11,13710,13773,11294,-2479
2020,1,23,12,15460,15562,12708,-2854
2020,1,23,13,16200,16478,13516,-2962
2020,1,23,14,15660,16038,13245,-2793
2020,1,23,15,15070,15125,12572,-2553
2020,1,23,16,14690,14455,12142,-2313
2020,1,23,17,14320,14294,12024,-2270
2020,1,23,18,14120,14156,11996,-2160
2020,1,23,19,14250,14203,12018,-2185
2020,1,23,20,14330,14458,12000,-2458
2020,1,23,21,14760,14730,12164,-2566
2020,1,23,22,15590,15588,12717,-2871
2020,1,23,23,16600,16623,13752,-2871
2020,1,24,0,16540,16589,13764,-2825
2020,1,24,1,16170,16213,13167,-3046
2020,1,24,2,15620,15593,12651,-2942
2020,1,24,3,14730,14679,11686,-2993
2020,1,24,4,13580,13491,10706,-2785
2020,1,24,5,12570,12515,9655,-2860
2020,1,24,6,11850,12053,9549,-2504
2020,1,24,7,11530,11815,9227,-2588
2020,1,24,8,11370,11660,9061,-2599
2020,1,24,9,11420,11703,9180,-2523
2020,1,24,10,11830,12094,9417,-2677
2020,1,24,11,12850,12817,9988,-2829
2020,1,24,12,14590,14536,11571,-2965
2020,1,24,13,15500,15505,12517,-2988
2020,1,24,14,15130,15159,12321,-2838
2020,1,24,15,14230,14326,11709,-2617
2020,1,24,16,13770,13678,11096,-2582
2020,1,24,17,13490,13293,10702,-2591
2020,1,24,18,13370,13398,10758,-2640
2020,1,24,19,13500,13623,11019,-2604
2020,1,24,20,13730,13666,11068,-2598
2020,1,24,21,14210,14217,11355,-2862
2020,1,24,22,15220,14891,12035,-2856
2020,1,24,23,16100,15605,12657,-2948
2020,1,25,0,15910,15493,12694,-2799
2020,1,25,1,15490,15093,12298,-2795
2020,1,25,2,14880,14577,11618,-2959
2020,1,25,3,14150,13900,11132,-2768
2020,1,25,4,13240,13212,10625,-2587
2020,1,25,5,12330,12345,9692,-2653
2020,1,25,6,11400,11661,9353,-2308
2020,1,25,7,10990,11239,9188,-2051
2020,1,25,8,10760,11095,8962,-2133
2020,1,25,9,10710,11202,9108,-2094
2020,1,25,10,10820,11056,8940,-2116
2020,1,25,11,11200,11427,9232,-2195
2020,1,25,12,11870,12089,10000,-2089
2020,1,25,13,12600,12653,10578,-2075
2020,1,25,14,13340,13304,11380,-1924
2020,1,25,15,13940,13849,12144,-1705
2020,1,25,16,14060,14090,12352,-1738
2020,1,25,17,14040,14168,12308,-1860
2020,1,25,18,13910,14202,11963,-2239
2020,1,25,19,13790,14145,11762,-2383
2020,1,25,20,13710,14124,11716,-2408
2020,1,25,21,13920,14245,11888,-2357
2020,1,25,22,14580,14700,12100,-2600
2020,1,25,23,15250,15176,12463,-2713
2020,1,26,0,14980,14886,12292,-2594
2020,1,26,1,14390,14343,11810,-2533
2020,1,26,2,13800,13767,11305,-2462
2020,1,26,3,13110,13065,10608,-2457
2020,1,26,4,12320,12216,9834,-2382
2020,1,26,5,11510,11845,9276,-2569
2020,1,26,6,10720,11182,8314,-2868
2020,1,26,7,10320,10610,7801,-2809
2020,1,26,8,10110,10654,7968,-2686
2020,1,26,9,10060,10804,7852,-2952
2020,1,26,10,10120,10664,7733,-2931
2020,1,26,11,10420,10937,7993,-2944
2020,1,26,12,10980,11204,8321,-2883
2020,1,26,13,11560,11550,8845,-2705
2020,1,26,14,11930,11925,9202,-2723
2020,1,26,15,11770,11773,9075,-2698
2020,1,26,16,11560,11566,8715,-2851
2020,1,26,17,11480,11785,8728,-3057
2020,1,26,18,11580,11927,8962,-2965
2020,1,26,19,11850,11987,9083,-2904
2020,1,26,20,12200,12364,9434,-2930
2020,1,26,21,12750,12926,9851,-3075
2020,1,26,22,13720,13877,10722,-3155
2020,1,26,23,14820,15023,11880,-3143
2020,1,27,0,15000,15072,11980,-3092
2020,1,27,1,14510,14656,11643,-3013
2020,1,27,2,13940,14042,11005,-3037
2020,1,27,3,13070,13195,10077,-3118
2020,1,27,4,12190,12269,9472,-2797
2020,1,27,5,11350,11824,8979,-2845
2020,1,27,6,10740,11154,8592,-2562
2020,1,27,7,10460,11000,8436,-2564
2020,1,27,8,10370,11137,8409,-2728
2020,1,27,9,10460,11121,8386,-2735
2020,1,27,10,10870,11131,8571,-2560
2020,1,27,11,11920,12172,9366,-2806
2020,1,27,12,13700,13798,11021,-2777
2020,1,27,13,14600,14581,11812,-2769
2020,1,27,14,14490,14485,12014,-2471
2020,1,27,15,14310,14333,12126,-2207
2020,1,27,16,14020,14048,11854,-2194
2020,1,27,17,13710,13716,11605,-2111
2020,1,27,18,13520,13558,11415,-2143
2020,1,27,19,13500,13712,11448,-2264
2020,1,27,20,13740,14003,11697,-2306
2020,1,27,21,14210,14444,12041,-2403
2020,1,27,22,15030,15149,12671,-2478
2020,1,27,23,16130,16097,13541,-2556
2020,1,28,0,16400,16014,13454,-2560
2020,1,28,1,15900,15527,12813,-2714
2020,1,28,2,15200,14817,12196,-2621
2020,1,28,3,14210,13978,11660,-2318
2020,1,28,4,13010,12901,10587,-2314
2020,1,28,5,12010,11925,9557,-2368
2020,1,28,6,11050,11309,9012,-2297
2020,1,28,7,10710,11006,8575,-2431
2020,1,28,8,10560,11060,8257,-2803
2020,1,28,9,10610,11103,8383,-2720
2020,1,28,10,11120,11464,8742,-2722
2020,1,28,11,12180,12452,9531,-2921
2020,1,28,12,14050,13735,10668,-3067
2020,1,28,13,14900,14621,11448,-3173
2020,1,28,14,14530,14529,11334,-3195
2020,1,28,15,14090,14243,11319,-2924
2020,1,28,16,13830,14345,11511,-2834
2020,1,28,17,13720,14547,11696,-2851
2020,1,28,18,13710,14616,11796,-2820
2020,1,28,19,13880,14684,11644,-3040
2020,1,28,20,14140,14706,11789,-2917
2020,1,28,21,14510,14906,12125,-2781
2020,1,28,22,15380,15540,12519,-3021
2020,1,28,23,16440,16412,13231,-3181
2020,1,29,0,16570,16396,13299,-3097
2020,1,29,1,16120,15948,12784,-3164
2020,1,29,2,15470,15310,12394,-2916
2020,1,29,3,14500,14338,11855,-2483
2020,1,29,4,13330,13305,10641,-2664
2020,1,29,5,12340,12465,10127,-2338
2020,1,29,6,11550,11878,9788,-2090
2020,1,29,7,11200,11729,9270,-2459
2020,1,29,8,11090,11604,9140,-2464
2020,1,29,9,11130,11637,9146,-2491
2020,1,29,10,11450,11888,9315,-2573
2020,1,29,11,12840,12574,9966,-2608
2020,1,29,12,14680,14347,11279,-3068
2020,1,29,13,15510,15290,12607,-2683
2020,1,29,14,15060,14940,12533,-2407
2020,1,29,15,14390,13968,11803,-2165
2020,1,29,16,13780,13195,11139,-2056
2020,1,29,17,13390,12949,10621,-2328
2020,1,29,18,13170,12707,10333,-2374
2020,1,29,19,13270,12759,10527,-2232
2020,1,29,20,13580,13116,11040,-2076
2020,1,29,21,14130,13937,12194,-1743
2020,1,29,22,15100,15016,13313,-1703
2020,1,29,23,16360,16321,14557,-1764
2020,1,30,0,16680,16534,14514,-2020
2020,1,30,1,16360,16222,14460,-1762
2020,1,30,2,15880,15713,13998,-1715
2020,1,30,3,14940,14830,13169,-1661
2020,1,30,4,13910,13683,12028,-1655
2020,1,30,5,12930,12965,11226,-1739
2020,1,30,6,12240,12471,10742,-1729
2020,1,30,7,11900,12184,10339,-1845
2020,1,30,8,11800,12125,10238,-1887
2020,1,30,9,11960,12226,10338,-1888
2020,1,30,10,12320,12651,10748,-1903
2020,1,30,11,13430,13474,11531,-1943
2020,1,30,12,15020,15276,13540,-1736
2020,1,30,13,15900,16154,14405,-1749
2020,1,30,14,15400,15550,13933,-1617
2020,1,30,15,14370,14506,13008,-1498
2020,1,30,16,13850,13757,12460,-1297
2020,1,30,17,13200,13276,11932,-1344
2020,1,30,18,13050,12963,11595,-1368
2020,1,30,19,13260,12965,11430,-1535
2020,1,30,20,13790,13349,11801,-1548
2020,1,30,21,14400,14273,12675,-1598
2020,1,30,22,15390,15414,13563,-1851
2020,1,30,23,16590,16606,14709,-1897
2020,1,31,0,16850,16729,14882,-1847
2020,1,31,1,16450,16396,14491,-1905
2020,1,31,2,15850,15847,14006,-1841
2020,1,31,3,14900,14945,13114,-1831
2020,1,31,4,13820,13769,11766,-2003
2020,1,31,5,12840,12809,10628,-2181
2020,1,31,6,12210,12206,10067,-2139
2020,1,31,7,11890,11888,9745,-2143
2020,1,31,8,11790,11779,9610,-2169
2020,1,31,9,11810,11811,9676,-2135
2020,1,31,10,12200,12178,9982,-2196
2020,1,31,11,13210,13216,10938,-2278
2020,1,31,12,14800,14928,12654,-2274
2020,1,31,13,15580,15743,13670,-2073
2020,1,31,14,15160,15123,12974,-2149
2020,1,31,15,14230,14213,12496,-1717
2020,1,31,16,13810,13702,12297,-1405
2020,1,31,17,13490,13486,12136,-1350
2020,1,31,18,13460,13419,12116,-1303
2020,1,31,19,13630,13579,12156,-1423
2020,1,31,20,13910,13843,12343,-1500
2020,1,31,21,14310,14306,12518,-1788
2020,1,31,22,15080,14944,12899,-2045
2020,1,31,23,15960,15772,13590,-2182
2020,2,1,0,15820,15652,13369,-2283
2020,2,1,1,15300,15228,12876,-2352
2020,2,1,2,14690,14673,12338,-2335
2020,2,1,3,13950,13941,12022,-1919
2020,2,1,4,13070,12991,11293,-1698
2020,2,1,5,12180,12067,10191,-1876
2020,2,1,6,11420,11585,9721,-1864
2020,2,1,7,11030,11529,9503,-2026
2020,2,1,8,10840,11515,9545,-1970
2020,2,1,9,10800,11589,9616,-1973
2020,2,1,10,10970,11693,9794,-1899
2020,2,1,11,11430,11690,9886,-1804
2020,2,1,12,12120,12249,10389,-1860
2020,2,1,13,12780,12795,10998,-1797
2020,2,1,14,13470,13378,11562,-1816
2020,2,1,15,13750,13821,12123,-1698
2020,2,1,16,13740,14044,12373,-1671
2020,2,1,17,14120,14101,12215,-1886
2020,2,1,18,13880,14034,12115,-1919
2020,2,1,19,13780,13923,11979,-1944
2020,2,1,20,13710,13885,11924,-1961
2020,2,1,21,13780,13999,11936,-2063
2020,2,1,22,14000,14422,12315,-2107
2020,2,1,23,14920,15014,12946,-2068
2020,2,2,0,14890,14860,12767,-2093
2020,2,2,1,14430,14412,12336,-2076
2020,2,2,2,13880,13906,11965,-1941
2020,2,2,3,13230,13282,11319,-1963
2020,2,2,4,12520,12476,10385,-2091
2020,2,2,5,11820,11846,9622,-2224
2020,2,2,6,11340,11547,9355,-2192
2020,2,2,7,10940,11434,9100,-2334
2020,2,2,8,10700,11283,8836,-2447
2020,2,2,9,10610,11211,8771,-2440
2020,2,2,10,10630,11299,8832,-2467
2020,2,2,11,10910,11498,9097,-2401
2020,2,2,12,11450,11852,9480,-2372
2020,2,2,13,12000,12209,9753,-2456
2020,2,2,14,12490,12557,10151,-2406
2020,2,2,15,12570,12597,10231,-2366
2020,2,2,16,12400,12365,9931,-2434
2020,2,2,17,12310,12550,10199,-2351
2020,2,2,18,12240,12882,10494,-2388
2020,2,2,19,12200,13006,10694,-2312
2020,2,2,20,12350,13146,10831,-2315
2020,2,2,21,13700,13668,11321,-2347
2020,2,2,22,14630,14507,12105,-2402
2020,2,2,23,15330,15502,13078,-2424
2020,2,3,0,15300,15259,12921,-2338
2020,2,3,1,14870,14482,12168,-2314
2020,2,3,2,14260,13916,11669,-2247
2020,2,3,3,13450,13385,11096,-2289
2020,2,3,4,12530,12805,10563,-2242
2020,2,3,5,11740,12154,9788,-2366
2020,2,3,6,11100,11694,9264,-2430
2020,2,3,7,10790,11597,9087,-2510
2020,2,3,8,10690,11490,8928,-2562
2020,2,3,9,10770,11558,9025,-2533
2020,2,3,10,11190,11877,9433,-2444
2020,2,3,11,12220,12587,10228,-2359
2020,2,3,12,13900,13844,11389,-2455
2020,2,3,13,14780,14763,12288,-2475
2020,2,3,14,14430,14470,11927,-2543
2020,2,3,15,13710,13750,11290,-2460
2020,2,3,16,13230,13549,11129,-2420
2020,2,3,17,12890,13665,11264,-2401
2020,2,3,18,12700,13815,11379,-2436
2020,2,3,19,12740,13727,11286,-2441
2020,2,3,20,12820,13488,11101,-2387
2020,2,3,21,13340,13632,11095,-2537
2020,2,3,22,14260,14477,11832,-2645
2020,2,3,23,15580,15661,13056,-2605
2020,2,4,0,15860,15853,13321,-2532
2020,2,4,1,15490,15470,12981,-2489
2020,2,4,2,14840,14832,12415,-2417
2020,2,4,3,13850,13908,11373,-2535
2020,2,4,4,12730,12920,10389,-2531
2020,2,4,5,11790,12075,9377,-2698
2020,2,4,6,11210,11704,9132,-2572
2020,2,4,7,10920,11705,9192,-2513
2020,2,4,8,10780,11583,9078,-2505
2020,2,4,9,10810,11614,9127,-2487
2020,2,4,10,11200,11964,9505,-2459
2020,2,4,11,12190,12656,10286,-2370
2020,2,4,12,13890,13906,11665,-2241
2020,2,4,13,14740,14736,12561,-2175
2020,2,4,14,14810,14839,12618,-2221
2020,2,4,15,14630,14689,12521,-2168
2020,2,4,16,14600,14537,12429,-2108
2020,2,4,17,14530,14363,12311,-2052
2020,2,4,18,14320,14185,12309,-1876
2020,2,4,19,14250,14218,12133,-2085
2020,2,4,20,14170,13808,11967,-1841
2020,2,4,21,14260,13826,11742,-2084
2020,2,4,22,14860,14598,12438,-2160
2020,2,4,23,15860,15640,13469,-2171
2020,2,5,0,15910,15769,13626,-2143
2020,2,5,1,15410,15358,13429,-1929
2020,2,5,2,14740,14692,12586,-2106
2020,2,5,3,13760,13703,11568,-2135
2020,2,5,4,12600,12833,10528,-2305
2020,2,5,5,11610,12019,9915,-2104
2020,2,5,6,10830,11235,9100,-2135
2020,2,5,7,10470,10771,8653,-2118
2020,2,5,8,10360,10830,8685,-2145
2020,2,5,9,10370,10898,8844,-2054
2020,2,5,10,10760,11018,9002,-2016
2020,2,5,11,11800,11799,9676,-2123
2020,2,5,12,13550,13511,11172,-2339
2020,2,5,13,14420,14410,12036,-2374
2020,2,5,14,14380,14364,12078,-2286
2020,2,5,15,14220,14399,12241,-2158
2020,2,5,16,13830,14460,12498,-1962
2020,2,5,17,13480,14137,12298,-1839
2020,2,5,18,13210,13831,11830,-2001
2020,2,5,19,13390,13713,11536,-2177
2020,2,5,20,13730,13649,11568,-2081
2020,2,5,21,14070,14061,11888,-2173
2020,2,5,22,15050,14791,12474,-2317
2020,2,5,23,16270,15967,13659,-2308
2020,2,6,0,16470,16150,13821,-2329
2020,2,6,1,16020,15834,13520,-2314
2020,2,6,2,15390,15269,13018,-2251
2020,2,6,3,14450,14349,12134,-2215
2020,2,6,4,13330,13171,11058,-2113
2020,2,6,5,12350,12165,10037,-2128
2020,2,6,6,11570,11508,9826,-1682
2020,2,6,7,11180,11145,9352,-1793
2020,2,6,8,11020,11271,9398,-1873
2020,2,6,9,11070,11363,9646,-1717
2020,2,6,10,11480,11753,10135,-1618
2020,2,6,11,12470,12490,10775,-1715
2020,2,6,12,14070,14019,12123,-1896
2020,2,6,13,14960,15034,12964,-2070
2020,2,6,14,15230,15446,13353,-2093
2020,2,6,15,15350,15663,13669,-1994
2020,2,6,16,15490,15753,13667,-2086
2020,2,6,17,15540,15740,13756,-1984
2020,2,6,18,15440,15582,13749,-1833
2020,2,6,19,15310,15571,13791,-1780
2020,2,6,20,15200,15457,13600,-1857
2020,2,6,21,15230,15419,13433,-1986
2020,2,6,22,15610,15786,13734,-2052
2020,2,6,23,16370,16443,14432,-2011
2020,2,7,0,16270,16324,14372,-1952
2020,2,7,1,15760,15853,13853,-2000
2020,2,7,2,15080,15207,13295,-1912
2020,2,7,3,14110,14265,12115,-2150
2020,2,7,4,12960,13116,10930,-2186
2020,2,7,5,11970,12180,10121,-2059
2020,2,7,6,11370,11986,9844,-2142
2020,2,7,7,10990,11873,9591,-2282
2020,2,7,8,10800,11702,9435,-2267
2020,2,7,9,10840,11693,9290,-2403
2020,2,7,10,11170,12003,9776,-2227
2020,2,7,11,12100,12429,10243,-2186
2020,2,7,12,13800,13661,11472,-2189
2020,2,7,13,14730,14724,12531,-2193
2020,2,7,14,15120,15184,12897,-2287
2020,2,7,15,15240,15376,13120,-2256
2020,2,7,16,15310,15467,13201,-2266
2020,2,7,17,15240,15485,13195,-2290
2020,2,7,18,14860,15256,12918,-2338
2020,2,7,19,14630,15008,12606,-2402
2020,2,7,20,14340,14763,12344,-2419
2020,2,7,21,14360,14685,12307,-2378
2020,2,7,22,14740,14909,12487,-2422
2020,2,7,23,15610,15631,13109,-2522
2020,2,8,0,15800,15660,13151,-2509
2020,2,8,1,15460,15279,12776,-2503
2020,2,8,2,15020,14817,12338,-2479
2020,2,8,3,14460,14195,11796,-2399
2020,2,8,4,13630,13351,11059,-2292
2020,2,8,5,12750,12574,10188,-2386
2020,2,8,6,11980,12440,9895,-2545
2020,2,8,7,11660,12601,9923,-2678
2020,2,8,8,11520,12805,10079,-2726
2020,2,8,9,11520,12823,10155,-2668
2020,2,8,10,11810,12717,10086,-2631
2020,2,8,11,12280,12740,10146,-2594
2020,2,8,12,12990,13136,10529,-2607
2020,2,8,13,13680,13484,11001,-2483
2020,2,8,14,13790,13651,11189,-2462
2020,2,8,15,13630,13375,11050,-2325
2020,2,8,16,13200,13056,10724,-2332
2020,2,8,17,12950,12952,10695,-2257
2020,2,8,18,12900,13060,10723,-2337
2020,2,8,19,12900,13323,11054,-2269
2020,2,8,20,13200,13532,11183,-2349
2020,2,8,21,13810,13908,11307,-2601
2020,2,8,22,14580,14689,11346,-3343
2020,2,8,23,15730,15751,12417,-3334
2020,2,9,0,15910,15724,12404,-3320
2020,2,9,1,15400,15400,12013,-3387
2020,2,9,2,15000,14988,11584,-3404
2020,2,9,3,14500,14423,11030,-3393
2020,2,9,4,13800,13733,10391,-3342
2020,2,9,5,13120,13282,9790,-3492
2020,2,9,6,12420,12690,9438,-3252
2020,2,9,7,12100,12366,9179,-3187
2020,2,9,8,11950,12067,8907,-3160
2020,2,9,9,11910,12167,8931,-3236
2020,2,9,10,12060,12153,8981,-3172
2020,2,9,11,12410,12405,9285,-3120
2020,2,9,12,12970,12982,9842,-3140
2020,2,9,13,13470,13467,10364,-3103
2020,2,9,14,13940,13749,10889,-2860
2020,2,9,15,13710,13613,10749,-2864
2020,2,9,16,13600,13489,10522,-2967
2020,2,9,17,13510,13469,10360,-3109
2020,2,9,18,13730,13844,10736,-3108
2020,2,9,19,13980,13941,10733,-3208
2020,2,9,20,14020,14049,10836,-3213
2020,2,9,21,14350,14432,11348,-3084
2020,2,9,22,14990,15120,12148,-2972
2020,2,9,23,15990,16090,12982,-3108
2020,2,10,0,15930,16146,13120,-3026
2020,2,10,1,15410,15659,12540,-3119
2020,2,10,2,14730,14987,11941,-3046
2020,2,10,3,13790,14076,10912,-3164
2020,2,10,4,12800,13014,9861,-3153
2020,2,10,5,11930,12538,9449,-3089
2020,2,10,6,11440,11969,9263,-2706
2020,2,10,7,11060,11592,8719,-2873
2020,2,10,8,10910,11470,8452,-3018
2020,2,10,9,10940,11494,8402,-3092
2020,2,10,10,11320,11822,8810,-3012
2020,2,10,11,12280,12489,9366,-3123
2020,2,10,12,13920,13946,10769,-3177
2020,2,10,13,14810,14906,11749,-3157
2020,2,10,14,14980,15131,11933,-3198
2020,2,10,15,15310,15286,12034,-3252
2020,2,10,16,15340,15368,12024,-3344
2020,2,10,17,15330,15337,12018,-3319
2020,2,10,18,15130,15026,11678,-3348
2020,2,10,19,15010,15000,11494,-3506
2020,2,10,20,14880,14830,11346,-3484
2020,2,10,21,14930,14867,11479,-3388
2020,2,10,22,15380,15334,11955,-3379
2020,2,10,23,16250,16155,12910,-3245
2020,2,11,0,16240,16131,12908,-3223
2020,2,11,1,15750,15632,12352,-3280
2020,2,11,2,15060,14932,11725,-3207
2020,2,11,3,14040,13908,10389,-3519
2020,2,11,4,12870,12738,9219,-3519
2020,2,11,5,11900,11793,8499,-3294
2020,2,11,6,11140,11614,8399,-3215
2020,2,11,7,10770,11247,8034,-3213
2020,2,11,8,10620,11150,8112,-3038
2020,2,11,9,10660,11385,8450,-2935
2020,2,11,10,11010,11354,8418,-2936
2020,2,11,11,12040,12230,8968,-3262
2020,2,11,12,13700,13676,10054,-3622
2020,2,11,13,14700,14680,11009,-3671
2020,2,11,14,14990,14940,11302,-3638
2020,2,11,15,15020,15039,11421,-3618
2020,2,11,16,15110,15147,11459,-3688
2020,2,11,17,15100,15165,11496,-3669
2020,2,11,18,15000,15101,11550,-3551
2020,2,11,19,14920,15096,11467,-3629
2020,2,11,20,14780,14979,11389,-3590
2020,2,11,21,14860,14901,11384,-3517
2020,2,11,22,15290,15192,11872,-3320
2020,2,11,23,16190,15981,12468,-3513
2020,2,12,0,16180,16047,12567,-3480
2020,2,12,1,15620,15602,12245,-3357
2020,2,12,2,14980,14946,11733,-3213
2020,2,12,3,14020,14001,10682,-3319
2020,2,12,4,12890,12793,9374,-3419
2020,2,12,5,11900,12031,8987,-3044
2020,2,12,6,11170,11651,8489,-3162
2020,2,12,7,10830,11366,8200,-3166
2020,2,12,8,10710,11463,8226,-3237
2020,2,12,9,10780,11532,8302,-3230
2020,2,12,10,11130,11758,8561,-3197
2020,2,12,11,12190,12344,9210,-3134
2020,2,12,12,13920,13961,10816,-3145
2020,2,12,13,14580,14645,11432,-3213
2020,2,12,14,14370,14093,10783,-3310
2020,2,12,15,13490,13480,10228,-3252
2020,2,12,16,13150,13070,9734,-3336
2020,2,12,17,12910,12586,9307,-3279
2020,2,12,18,12700,12349,9302,-3047
2020,2,12,19,13000,12536,9642,-2894
2020,2,12,20,13410,13017,9902,-3115
2020,2,12,21,13850,13590,10225,-3365
2020,2,12,22,14740,14464,10965,-3499
2020,2,12,23,15880,15634,12147,-3487
2020,2,13,0,16070,15850,12446,-3404
2020,2,13,1,15620,15497,12133,-3364
2020,2,13,2,15000,14906,11518,-3388
2020,2,13,3,14030,13999,10697,-3302
2020,2,13,4,12900,12827,9432,-3395
2020,2,13,5,11910,12041,8753,-3288
2020,2,13,6,11210,11467,8180,-3287
2020,2,13,7,10890,11161,8302,-2859
2020,2,13,8,10780,11274,8294,-2980
2020,2,13,9,10860,11372,8287,-3085
2020,2,13,10,11220,11716,8629,-3087
2020,2,13,11,12180,12370,9257,-3113
2020,2,13,12,13720,13698,10865,-2833
2020,2,13,13,14710,14709,12006,-2703
2020,2,13,14,15130,15108,12470,-2638
2020,2,13,15,15230,15241,12656,-2585
2020,2,13,16,15170,15347,12257,-3090
2020,2,13,17,15180,15438,12309,-3129
2020,2,13,18,15040,15392,12200,-3192
2020,2,13,19,14960,15310,12310,-3000
2020,2,13,20,14860,15141,12213,-2928
2020,2,13,21,14870,15066,12102,-2964
2020,2,13,22,15250,15288,12158,-3130
2020,2,13,23,15980,15999,12875,-3124
2020,2,14,0,16050,16102,13065,-3037
2020,2,14,1,15590,15673,12632,-3041
2020,2,14,2,14960,15090,12231,-2859
2020,2,14,3,14030,14206,11431,-2775
2020,2,14,4,12950,13100,10257,-2843
2020,2,14,5,12000,12228,9316,-2912
2020,2,14,6,11500,11746,8816,-2930
2020,2,14,7,11150,11397,8415,-2982
2020,2,14,8,11030,11439,8454,-2985
2020,2,14,9,11110,11575,8548,-3027
2020,2,14,10,11520,11660,8912,-2748
2020,2,14,11,12580,12709,10030,-2679
2020,2,14,12,14290,14383,11876,-2507
2020,2,14,13,15080,15076,12508,-2568
2020,2,14,14,14910,14904,12318,-2586
2020,2,14,15,14400,14471,11816,-2655
2020,2,14,16,13980,13997,10858,-3139
2020,2,14,17,13560,13786,10786,-3000
2020,2,14,18,13340,13445,10893,-2552
2020,2,14,19,13550,13215,10761,-2454
2020,2,14,20,14060,13448,11178,-2270
2020,2,14,21,14710,14117,11823,-2294
2020,2,14,22,15610,15270,12753,-2517
2020,2,14,23,16940,16424,13551,-2873
2020,2,15,0,17250,16808,13940,-2868
2020,2,15,1,16930,16600,13879,-2721
2020,2,15,2,16300,16249,13624,-2625
2020,2,15,3,15680,15694,13108,-2586
2020,2,15,4,14860,14850,12519,-2331
2020,2,15,5,13970,14153,11548,-2605
2020,2,15,6,13490,13739,11174,-2565
2020,2,15,7,13170,13415,10868,-2547
2020,2,15,8,13030,13291,10877,-2414
2020,2,15,9,13040,13284,10855,-2429
2020,2,15,10,13220,13720,11135,-2585
2020,2,15,11,13650,13875,11267,-2608
2020,2,15,12,14390,14367,11679,-2688
2020,2,15,13,14860,14858,12237,-2621
2020,2,15,14,14730,14728,12080,-2648
2020,2,15,15,14360,14304,11701,-2603
2020,2,15,16,13990,13845,11315,-2530
2020,2,15,17,13430,13419,10833,-2586
2020,2,15,18,13330,13004,10375,-2629
2020,2,15,19,13200,12957,10211,-2746
2020,2,15,20,13460,13182,10412,-2770
2020,2,15,21,14090,13987,11282,-2705
2020,2,15,22,14920,14815,11975,-2840
2020,2,15,23,16000,15918,13030,-2888
2020,2,16,0,16250,16197,13510,-2687
2020,2,16,1,15750,15828,13190,-2638
2020,2,16,2,15190,15356,12734,-2622
2020,2,16,3,14560,14734,12261,-2473
2020,2,16,4,13780,13892,11456,-2436
2020,2,16,5,12960,13091,10488,-2603
2020,2,16,6,12460,12457,9799,-2658
2020,2,16,7,12050,12054,9301,-2753
2020,2,16,8,11780,11773,9015,-2758
2020,2,16,9,11650,11645,8857,-2788
2020,2,16,10,11690,11691,8764,-2927
2020,2,16,11,11920,11910,8819,-3091
2020,2,16,12,12390,12381,9225,-3156
2020,2,16,13,12840,12824,9725,-3099
2020,2,16,14,13180,13172,10241,-2931
2020,2,16,15,13150,13173,10262,-2911
2020,2,16,16,12980,13187,10178,-3009
2020,2,16,17,12740,13323,10337,-2986
2020,2,16,18,12740,13398,10470,-2928
2020,2,16,19,12790,13246,10023,-3223
2020,2,16,20,13080,13052,9872,-3180
2020,2,16,21,13300,13237,10025,-3212
2020,2,16,22,13920,13901,10782,-3119
2020,2,16,23,14920,14954,11992,-2962
2020,2,17,0,15340,15238,12287,-2951
2020,2,17,1,15000,14819,11981,-2838
2020,2,17,2,14460,14209,11292,-2917
2020,2,17,3,13650,13468,10279,-3189
2020,2,17,4,12740,12620,9491,-3129
2020,2,17,5,11940,11984,8898,-3086
2020,2,17,6,11350,11604,8664,-2940
2020,2,17,7,11070,11501,8486,-3015
2020,2,17,8,10970,11674,8785,-2889
2020,2,17,9,11060,11560,8556,-3004
2020,2,17,10,11420,11914,8945,-2969
2020,2,17,11,12210,12356,9302,-3054
2020,2,17,12,13350,13326,10236,-3090
2020,2,17,13,13890,13864,10667,-3197
2020,2,17,14,13450,13463,10296,-3167
2020,2,17,15,12740,13128,10218,-2910
2020,2,17,16,12370,12761,10143,-2618
2020,2,17,17,11990,12711,9867,-2844
2020,2,17,18,11990,12510,9413,-3097
2020,2,17,19,12330,12687,9487,-3200
2020,2,17,20,12780,12838,9528,-3310
2020,2,17,21,13430,13331,9945,-3386
2020,2,17,22,14330,14232,10740,-3492
2020,2,17,23,15630,15381,11768,-3613
2020,2,18,0,16110,15833,12357,-3476
2020,2,18,1,15790,15465,11913,-3552
2020,2,18,2,15140,14914,11473,-3441
2020,2,18,3,14320,14096,10653,-3443
2020,2,18,4,13320,13077,9771,-3306
2020,2,18,5,12470,12239,8977,-3262
2020,2,18,6,11670,11678,8490,-3188
2020,2,18,7,11370,11625,8523,-3102
2020,2,18,8,11270,11514,8453,-3061
2020,2,18,9,11330,11838,8793,-3045
2020,2,18,10,11700,12216,9354,-2862
2020,2,18,11,12670,12724,9958,-2766
2020,2,18,12,14130,14086,11367,-2719
2020,2,18,13,15020,14988,12190,-2798
2020,2,18,14,15290,15278,12553,-2725
2020,2,18,15,15310,15317,12570,-2747
2020,2,18,16,15540,15524,12932,-2592
2020,2,18,17,15680,15674,13039,-2635
2020,2,18,18,15680,15692,13046,-2646
2020,2,18,19,15780,15773,13147,-2626
2020,2,18,20,15710,15767,13124,-2643
2020,2,18,21,15760,15780,13063,-2717
2020,2,18,22,15870,16082,13367,-2715
2020,2,18,23,16020,16669,13973,-2696
2020,2,19,0,16250,16542,13730,-2812
2020,2,19,1,15570,16011,13216,-2795
2020,2,19,2,14840,15240,12381,-2859
2020,2,19,3,13840,14274,11329,-2945
2020,2,19,4,12660,13574,10314,-3260
2020,2,19,5,11700,13104,9793,-3311
2020,2,19,6,11410,12215,8935,-3280
2020,2,19,7,11020,11813,8531,-3282
2020,2,19,8,10830,11620,8408,-3212
2020,2,19,9,10820,11611,8401,-3210
2020,2,19,10,11170,11939,8779,-3160
2020,2,19,11,12120,12372,9282,-3090
2020,2,19,12,13650,13595,10514,-3081
2020,2,19,13,14370,14353,11209,-3144
2020,2,19,14,13890,13911,10675,-3236
2020,2,19,15,13190,13200,9852,-3348
2020,2,19,16,12700,12914,9652,-3262
2020,2,19,17,12360,12778,9556,-3222
2020,2,19,18,12310,12302,9235,-3067
2020,2,19,19,12610,12413,9272,-3141
2020,2,19,20,13130,12364,9657,-2707
2020,2,19,21,13700,13007,10456,-2551
2020,2,19,22,14610,14254,11363,-2891
2020,2,19,23,15860,15639,12671,-2968
2020,2,20,0,16300,16214,13235,-2979
2020,2,20,1,16040,15914,12841,-3073
2020,2,20,2,15560,15399,12329,-3070
2020,2,20,3,14720,14585,11514,-3071
2020,2,20,4,13640,13527,10456,-3071
2020,2,20,5,12730,12802,9771,-3031
2020,2,20,6,12010,12477,9594,-2883
2020,2,20,7,11710,12050,9464,-2586
2020,2,20,8,11620,11936,9463,-2473
2020,2,20,9,11710,12030,9644,-2386
2020,2,20,10,12090,12440,9938,-2502
2020,2,20,11,13130,13229,10411,-2818
2020,2,20,12,14770,14733,12043,-2690
2020,2,20,13,15390,15360,12929,-2431
2020,2,20,14,14910,14697,12383,-2314
2020,2,20,15,13950,13935,11624,-2311
2020,2,20,16,13470,13605,11293,-2312
2020,2,20,17,13090,13532,11583,-1949
2020,2,20,18,13010,13544,11558,-1986
2020,2,20,19,13220,13741,11615,-2126
2020,2,20,20,13530,14024,11907,-2117
2020,2,20,21,14070,14382,12010,-2372
2020,2,20,22,14950,15175,12342,-2833
2020,2,20,23,16080,16313,13463,-2850
2020,2,21,0,16690,16700,13844,-2856
2020,2,21,1,16420,16429,13789,-2640
2020,2,21,2,15970,16020,13474,-2546
2020,2,21,3,15180,15233,12997,-2236
2020,2,21,4,14150,14180,11995,-2185
2020,2,21,5,13310,13299,10912,-2387
2020,2,21,6,12840,12874,10559,-2315
2020,2,21,7,12550,12752,10454,-2298
2020,2,21,8,12480,12642,10105,-2537
2020,2,21,9,12560,12531,10162,-2369
2020,2,21,10,12980,12933,10454,-2479
2020,2,21,11,14020,13971,11439,-2532
2020,2,21,12,15500,15501,13075,-2426
2020,2,21,13,16080,16057,13699,-2358
2020,2,21,14,15450,15420,12953,-2467
2020,2,21,15,14630,14657,12339,-2318
2020,2,21,16,14020,14019,11472,-2547
2020,2,21,17,13480,13607,11285,-2322
2020,2,21,18,13180,13196,10803,-2393
2020,2,21,19,13040,13086,10662,-2424
2020,2,21,20,13230,13200,10637,-2563
2020,2,21,21,13880,13778,11152,-2626
2020,2,21,22,14720,14887,12294,-2593
2020,2,21,23,15790,16038,13452,-2586
2020,2,22,0,16320,16447,13930,-2517
2020,2,22,1,15980,16074,13405,-2669
2020,2,22,2,15450,15571,12806,-2765
2020,2,22,3,14800,14888,12134,-2754
2020,2,22,4,13920,13959,11175,-2784
2020,2,22,5,13010,13086,10215,-2871
2020,2,22,6,12480,12440,9865,-2575
2020,2,22,7,12080,12050,9776,-2274
2020,2,22,8,11890,11866,9347,-2519
2020,2,22,9,11890,11802,9175,-2627
2020,2,22,10,11890,11928,9263,-2665
2020,2,22,11,12370,12349,9783,-2566
2020,2,22,12,12950,13036,10543,-2493
2020,2,22,13,13320,13329,10681,-2648
2020,2,22,14,13010,12993,10308,-2685
2020,2,22,15,12480,12449,9720,-2729
2020,2,22,16,11970,12155,9764,-2391
2020,2,22,17,11510,12080,9626,-2454
2020,2,22,18,11230,11779,9235,-2544
2020,2,22,19,11020,11731,9081,-2650
2020,2,22,20,11020,11876,9208,-2668
2020,2,22,21,11740,12163,9511,-2652
2020,2,22,22,12850,12916,10075,-2841
2020,2,22,23,14090,14132,11297,-2835
2020,2,23,0,14710,14651,11767,-2884
2020,2,23,1,14330,14366,11443,-2923
2020,2,23,2,13910,13942,11126,-2816
2020,2,23,3,13400,13396,10731,-2665
2020,2,23,4,12720,12678,10184,-2494
2020,2,23,5,12040,11958,9252,-2706
2020,2,23,6,11480,11717,9244,-2473
2020,2,23,7,11160,11677,9165,-2512
2020,2,23,8,10990,11516,8839,-2677
2020,2,23,9,10970,11489,8794,-2695
2020,2,23,10,11060,11593,8918,-2675
2020,2,23,11,11370,11441,8869,-2572
2020,2,23,12,11720,11920,9373,-2547
2020,2,23,13,12020,12132,9563,-2569
2020,2,23,14,11790,11816,9402,-2414
2020,2,23,15,11320,11585,8946,-2639
2020,2,23,16,10960,11616,8975,-2641
2020,2,23,17,10610,11425,8635,-2790
2020,2,23,18,10440,11221,8448,-2773
2020,2,23,19,10400,11124,8346,-2778
2020,2,23,20,10560,11147,8534,-2613
2020,2,23,21,11300,11718,8957,-2761
2020,2,23,22,12340,12629,9588,-3041
2020,2,23,23,13810,13978,10882,-3096
2020,2,24,0,14420,14613,12003,-2610
2020,2,24,1,14140,14377,12121,-2256
2020,2,24,2,13600,13866,12370,-1496
2020,2,24,3,12930,13072,11483,-1589
2020,2,24,4,12030,12102,10050,-2052
2020,2,24,5,11290,11490,9143,-2347
2020,2,24,6,10720,11146,8417,-2729
2020,2,24,7,10470,11125,8326,-2799
2020,2,24,8,10410,11045,8367,-2678
2020,2,24,9,10520,11167,8532,-2635
2020,2,24,10,11020,11350,8790,-2560
2020,2,24,11,12120,12255,9429,-2826
2020,2,24,12,13650,13901,10912,-2989
2020,2,24,13,14110,14336,11282,-3054
2020,2,24,14,13440,13484,10475,-3009
2020,2,24,15,12610,12537,9703,-2834
2020,2,24,16,12010,11930,9198,-2732
2020,2,24,17,11670,11887,9328,-2559
2020,2,24,18,11540,11893,9194,-2699
2020,2,24,19,11750,11912,9204,-2708
2020,2,24,20,11960,12183,9330,-2853
2020,2,24,21,12430,12435,9779,-2656
2020,2,24,22,13320,13345,10566,-2779
2020,2,24,23,14530,14547,11607,-2940
2020,2,25,0,15190,15089,11953,-3136
2020,2,25,1,14720,14723,11570,-3153
2020,2,25,2,14080,14086,10842,-3244
2020,2,25,3,13110,13168,9971,-3197
2020,2,25,4,12030,12049,8885,-3164
2020,2,25,5,11080,11401,8420,-2981
2020,2,25,6,10470,11050,8421,-2629
2020,2,25,7,10130,10724,8185,-2539
2020,2,25,8,9990,10840,8228,-2612
2020,2,25,9,10040,10842,8137,-2705
2020,2,25,10,10370,10980,8451,-2529
2020,2,25,11,11390,11714,9137,-2577
2020,2,25,12,12980,13031,10350,-2681
2020,2,25,13,13620,13869,11400,-2469
2020,2,25,14,13610,13828,11573,-2255
2020,2,25,15,13320,13412,11063,-2349
2020,2,25,16,13070,13234,11138,-2096
2020,2,25,17,12860,13149,11070,-2079
2020,2,25,18,12810,12819,10829,-1990
2020,2,25,19,12910,12803,10795,-2008
2020,2,25,20,12950,13060,10858,-2202
2020,2,25,21,13060,13377,11143,-2234
2020,2,25,22,13670,13950,11538,-2412
2020,2,25,23,14690,14822,12064,-2758
2020,2,26,0,15260,15109,12311,-2798
2020,2,26,1,14730,14727,12234,-2493
2020,2,26,2,14030,14088,11608,-2480
2020,2,26,3,13090,13178,10937,-2241
2020,2,26,4,12010,12050,9830,-2220
2020,2,26,5,11090,11118,8740,-2378
2020,2,26,6,10590,10711,8078,-2633
2020,2,26,7,10230,10493,7903,-2590
2020,2,26,8,10070,10609,8031,-2578
2020,2,26,9,10090,10622,8154,-2468
2020,2,26,10,10420,10731,8303,-2428
2020,2,26,11,11400,11552,8923,-2629
2020,2,26,12,12910,12938,10454,-2484
2020,2,26,13,13740,13780,11274,-2506
2020,2,26,14,13900,13799,11380,-2419
2020,2,26,15,13660,13684,11329,-2355
2020,2,26,16,13590,13627,11181,-2446
2020,2,26,17,13560,13545,10987,-2558
2020,2,26,18,13480,13387,10792,-2595
2020,2,26,19,13490,13346,10808,-2538
2020,2,26,20,13510,13348,10860,-2488
2020,2,26,21,13650,13652,11085,-2567
2020,2,26,22,14190,14220,11876,-2344
2020,2,26,23,15100,15001,12479,-2522
2020,2,27,0,15600,15242,12693,-2549
2020,2,27,1,15030,14844,12199,-2645
2020,2,27,2,14320,14239,11703,-2536
2020,2,27,3,13380,13359,10526,-2833
2020,2,27,4,12250,12214,9525,-2689
2020,2,27,5,11300,11266,8420,-2846
2020,2,27,6,10640,10642,8065,-2577
2020,2,27,7,10310,10516,7987,-2529
2020,2,27,8,10170,10679,7896,-2783
2020,2,27,9,10190,10702,7833,-2869
2020,2,27,10,10570,11052,8233,-2819
2020,2,27,11,11520,11683,9096,-2587
2020,2,27,12,13110,13070,10472,-2598
2020,2,27,13,14060,14051,11345,-2706
2020,2,27,14,14280,14272,11544,-2728
2020,2,27,15,14050,14031,11148,-2883
2020,2,27,16,13540,13416,10563,-2853
2020,2,27,17,13090,13061,10186,-2875
2020,2,27,18,12780,13619,11087,-2532
2020,2,27,19,12610,13458,10888,-2570
2020,2,27,20,12590,13410,11040,-2370
2020,2,27,21,12830,13429,10555,-2874
2020,2,27,22,13590,14158,11279,-2879
2020,2,27,23,14810,15341,12492,-2849
2020,2,28,0,15520,15916,13095,-2821
2020,2,28,1,15260,15686,12845,-2841
2020,2,28,2,14770,15185,12350,-2835
2020,2,28,3,13950,14336,11439,-2897
2020,2,28,4,12910,13253,10568,-2685
2020,2,28,5,12040,12342,9745,-2597
2020,2,28,6,11680,12006,9331,-2675
2020,2,28,7,11340,11915,9406,-2509
2020,2,28,8,11210,11776,9302,-2474
2020,2,28,9,11270,11818,9307,-2511
2020,2,28,10,11660,12153,9569,-2584
2020,2,28,11,12680,12833,10202,-2631
2020,2,28,12,14220,14181,11456,-2725
2020,2,28,13,14600,14618,11833,-2785
2020,2,28,14,14040,14057,11352,-2705
2020,2,28,15,13350,13425,10895,-2530
2020,2,28,16,13020,12966,10801,-2165
2020,2,28,17,12640,12943,10824,-2119
2020,2,28,18,12480,12941,10707,-2234
2020,2,28,19,12520,13071,10923,-2148
2020,2,28,20,12990,13187,10914,-2273
2020,2,28,21,13680,13705,11253,-2452
2020,2,28,22,14380,14319,11598,-2721
2020,2,28,23,15300,15224,12205,-3019
2020,2,29,0,15700,15652,12716,-2936
2020,2,29,1,15320,15305,12391,-2914
2020,2,29,2,14760,14846,11985,-2861
2020,2,29,3,14090,14176,11421,-2755
2020,2,29,4,13220,13269,10896,-2373
2020,2,29,5,12340,12416,9904,-2512
2020,2,29,6,11800,11798,9565,-2233
2020,2,29,7,11450,11447,9233,-2214
2020,2,29,8,11270,11281,9043,-2238
2020,2,29,9,11250,11254,9072,-2182
2020,2,29,10,11430,11423,9189,-2234
2020,2,29,11,11870,11853,9586,-2267
2020,2,29,12,12490,12472,10164,-2308
2020,2,29,13,12820,12810,10082,-2728
2020,2,29,14,12720,12727,10118,-2609
2020,2,29,15,12370,12381,10053,-2328
2020,2,29,16,12290,12578,9859,-2719
2020,2,29,17,12260,12737,10153,-2584
2020,2,29,18,12280,12801,10208,-2593
2020,2,29,19,12390,12543,9861,-2682
2020,2,29,20,12600,12518,9782,-2736
2020,2,29,21,13010,12983,10336,-2647
2020,2,29,22,13690,13758,10972,-2786
2020,2,29,23,14800,14848,12016,-2832
2020,3,1,0,15250,15441,12680,-2761
2020,3,1,1,14940,15165,12330,-2835
2020,3,1,2,14560,14791,12196,-2595
2020,3,1,3,14040,14341,11796,-2545
2020,3,1,4,13330,14300,12307,-1993
2020,3,1,5,12630,14300,12276,-2024
2020,3,1,6,12240,13383,11297,-2086
2020,3,1,7,11890,11920,9666,-2254
2020,3,1,8,11730,12244,9723,-2521
2020,3,1,9,11700,12213,9751,-2462
2020,3,1,10,11830,12072,9771,-2301
2020,3,1,11,12150,12226,9958,-2268
2020,3,1,12,12620,12605,10555,-2050
2020,3,1,13,12750,12924,10522,-2402
2020,3,1,14,12670,12923,10706,-2217
2020,3,1,15,12570,12834,10546,-2288
2020,3,1,16,12330,12593,10442,-2151
2020,3,1,17,11840,12453,9690,-2763
2020,3,1,18,11410,12301,9859,-2442
2020,3,1,19,11350,12056,9660,-2396
2020,3,1,20,11660,12373,9728,-2645
2020,3,1,21,12420,12860,10140,-2720
2020,3,1,22,13640,13829,11230,-2599
2020,3,1,23,14990,15004,12079,-2925
2020,3,2,0,15350,15722,12801,-2921
2020,3,2,1,15140,15511,12605,-2906
2020,3,2,2,14630,15026,12085,-2941
2020,3,2,3,13840,14201,11060,-3141
2020,3,2,4,12900,13200,10102,-3098
2020,3,2,5,12080,12374,9364,-3010
2020,3,2,6,11830,11851,8888,-2963
2020,3,2,7,11540,11563,8553,-3010
2020,3,2,8,11430,11444,8599,-2845
2020,3,2,9,11480,11484,8727,-2757
2020,3,2,10,11850,11856,9210,-2646
2020,3,2,11,12930,12896,10860,-2036
2020,3,2,12,14500,14474,12310,-2164
2020,3,2,13,14880,14903,12350,-2553
2020,3,2,14,14350,14366,11903,-2463
2020,3,2,15,13890,13918,11743,-2175
2020,3,2,16,13430,13463,11697,-1766
2020,3,2,17,13110,13262,11732,-1530
2020,3,2,18,12650,12880,11275,-1605
2020,3,2,19,12100,12670,10955,-1715
2020,3,2,20,12230,12571,10785,-1786
2020,3,2,21,12670,12617,10997,-1620
2020,3,2,22,13530,13607,11933,-1674
2020,3,2,23,14680,14748,12827,-1921
2020,3,3,0,15370,15302,13363,-1939
2020,3,3,1,15080,14936,12818,-2118
2020,3,3,2,14440,14307,12294,-2013
2020,3,3,3,13460,13314,11330,-1984
2020,3,3,4,12290,12133,9912,-2221
2020,3,3,5,11320,11113,8915,-2198
2020,3,3,6,10570,10738,8330,-2408
2020,3,3,7,10240,10759,8305,-2454
2020,3,3,8,10090,10757,8258,-2499
2020,3,3,9,10080,10690,8225,-2465
2020,3,3,10,10390,10801,8248,-2553
2020,3,3,11,11420,11563,8941,-2622
2020,3,3,12,12930,12858,10359,-2499
2020,3,3,13,13400,13281,10820,-2461
2020,3,3,14,13060,12607,10363,-2244
2020,3,3,15,11980,11961,9612,-2349
2020,3,3,16,11750,11550,9547,-2003
2020,3,3,17,11480,11470,9469,-2001
2020,3,3,18,11410,11589,9803,-1786
2020,3,3,19,11670,11867,10182,-1685
2020,3,3,20,12110,12347,10703,-1644
2020,3,3,21,12650,12683,10877,-1806
2020,3,3,22,13400,13354,11568,-1786
2020,3,3,23,14260,14277,12293,-1984
2020,3,4,0,14850,14703,12762,-1941
2020,3,4,1,14500,14348,12412,-1936
2020,3,4,2,13850,13766,11878,-1888
2020,3,4,3,12850,12813,11285,-1528
2020,3,4,4,11720,11664,10309,-1355
2020,3,4,5,10750,10826,9452,-1374
2020,3,4,6,10060,10613,8851,-1762
2020,3,4,7,9750,10544,8471,-2073
2020,3,4,8,9620,10417,8243,-2174
2020,3,4,9,9660,10449,8360,-2089
2020,3,4,10,10050,10812,8831,-1981
2020,3,4,11,11110,11495,9684,-1811
2020,3,4,12,12670,12643,10886,-1757
2020,3,4,13,13150,13192,11768,-1424
2020,3,4,14,12830,12902,11682,-1220
2020,3,4,15,12600,12666,11557,-1109
2020,3,4,16,12170,12566,11549,-1017
2020,3,4,17,11990,12343,11335,-1008
2020,3,4,18,11880,12139,10829,-1310
2020,3,4,19,11870,12107,10256,-1851
2020,3,4,20,12060,11988,10562,-1426
2020,3,4,21,12490,12323,11187,-1136
2020,3,4,22,13340,13242,11971,-1271
2020,3,4,23,14410,14402,12896,-1506
2020,3,5,0,15070,15060,12696,-2364
2020,3,5,1,14720,14792,12633,-2159
2020,3,5,2,14140,14214,11993,-2221
2020,3,5,3,13250,13320,11286,-2034
2020,3,5,4,12140,12240,10291,-1949
2020,3,5,5,11160,11538,9381,-2157
2020,3,5,6,10370,11261,8487,-2774
2020,3,5,7,10060,11105,8317,-2788
2020,3,5,8,9930,10745,8425,-2320
2020,3,5,9,10040,10991,8407,-2584
2020,3,5,10,10220,11300,8733,-2567
2020,3,5,11,11330,11968,9658,-2310
2020,3,5,12,12840,13202,10590,-2612
2020,3,5,13,13350,13459,10837,-2622
2020,3,5,14,12750,12670,10283,-2387
2020,3,5,15,11960,11979,9830,-2149
2020,3,5,16,11490,11577,9513,-2064
2020,3,5,17,11290,11312,8834,-2478
2020,3,5,18,11100,11088,8971,-2117
2020,3,5,19,11050,11047,9117,-1930
2020,3,5,20,11120,11214,9330,-1884
2020,3,5,21,11600,11858,9547,-2311
2020,3,5,22,12570,12916,10235,-2681
2020,3,5,23,13770,14109,11060,-3049
2020,3,6,0,14850,14888,12165,-2723
2020,3,6,1,14430,14686,12052,-2634
2020,3,6,2,13920,14196,11777,-2419
2020,3,6,3,13110,13408,10813,-2595
2020,3,6,4,12100,12472,9597,-2875
2020,3,6,5,11130,11698,8571,-3127
2020,3,6,6,10630,11137,8577,-2560
2020,3,6,7,10260,10998,8443,-2555
2020,3,6,8,10110,10944,8393,-2551
2020,3,6,9,10130,10814,8301,-2513
2020,3,6,10,10460,11193,8464,-2729
2020,3,6,11,11340,12212,9316,-2896
2020,3,6,12,12530,13504,10688,-2816
2020,3,6,13,13110,13838,11065,-2773
2020,3,6,14,13060,13039,10771,-2268
2020,3,6,15,12970,12336,10500,-1836
2020,3,6,16,12980,12082,10464,-1618
2020,3,6,17,12960,12191,10438,-1753
2020,3,6,18,13020,12550,10991,-1559
2020,3,6,19,13240,13187,11418,-1769
2020,3,6,20,13420,13539,11747,-1792
2020,3,6,21,13640,13796,11887,-1909
2020,3,6,22,14000,14235,12393,-1842
2020,3,6,23,14670,14872,12626,-2246
2020,3,7,0,14990,15050,12566,-2484
2020,3,7,1,14590,14668,11901,-2767
2020,3,7,2,14050,14168,11365,-2803
2020,3,7,3,13360,13476,11041,-2435
2020,3,7,4,12500,12680,10296,-2384
2020,3,7,5,11690,11999,10014,-1985
2020,3,7,6,11140,11399,9382,-2017
2020,3,7,7,10810,11067,8995,-2072
2020,3,7,8,10700,11115,9213,-1902
2020,3,7,9,10630,11114,9085,-2029
2020,3,7,10,10820,11290,9369,-1921
2020,3,7,11,11260,11740,9703,-2037
2020,3,7,12,11890,12163,10011,-2152
2020,3,7,13,12340,12489,10471,-2018
2020,3,7,14,12530,12517,10474,-2043
2020,3,7,15,12180,12171,10059,-2112
2020,3,7,16,11600,12025,10161,-1864
2020,3,7,17,11090,11650,9941,-1709
2020,3,7,18,10750,11217,9417,-1800
2020,3,7,19,10440,10902,9224,-1678
2020,3,7,20,10620,11054,9203,-1851
2020,3,7,21,11220,11615,9513,-2102
2020,3,7,22,12370,12480,10339,-2141
2020,3,7,23,13390,13672,11464,-2208
2020,3,8,0,14320,14410,12290,-2120
2020,3,8,1,14130,14190,11968,-2222
2020,3,8,2,13800,13750,11632,-2118
2020,3,8,3,13300,13188,11012,-2176
2020,3,8,4,12590,12437,10321,-2116
2020,3,8,5,11870,11715,9811,-1904
2020,3,8,6,11280,11263,9155,-2108
2020,3,8,7,10810,11236,9123,-2113
2020,3,8,8,10790,11311,9065,-2246
2020,3,8,9,10800,11328,9052,-2276
2020,3,8,10,11030,11513,9301,-2212
2020,3,8,11,11420,11939,9787,-2152
2020,3,8,12,11740,12108,9875,-2233
2020,3,8,13,11840,11944,9678,-2266
2020,3,8,14,11500,11747,9431,-2316
2020,3,8,15,11020,11825,9350,-2475
2020,3,8,16,10570,11446,9291,-2155
2020,3,8,17,10180,10832,8693,-2139
2020,3,8,18,10020,10688,8623,-2065
2020,3,8,19,9890,10643,8426,-2217
2020,3,8,20,10230,10789,8411,-2378
2020,3,8,21,11070,11295,8726,-2569
2020,3,8,22,12170,12445,9640,-2805
2020,3,8,23,13140,13268,10526,-2742
2020,3,9,0,13700,13939,11213,-2726
2020,3,9,1,13400,13634,10927,-2707
2020,3,9,2,12690,12887,10010,-2877
2020,3,9,3,11790,12095,9214,-2881
2020,3,9,4,10930,11188,8622,-2566
2020,3,9,5,10300,10816,8148,-2668
2020,3,9,6,9960,10765,7915,-2850
2020,3,9,7,9790,10600,7598,-3002
2020,3,9,8,9820,10618,7652,-2966
2020,3,9,9,10170,10920,8060,-2860
2020,3,9,10,11130,11589,8843,-2746
2020,3,9,11,12850,12854,10192,-2662
2020,3,9,12,13780,13786,11128,-2658
2020,3,9,13,13330,13375,10551,-2824
2020,3,9,14,12550,12541,9917,-2624
2020,3,9,15,11890,12015,9515,-2500
2020,3,9,16,11020,11894,9001,-2893
2020,3,9,17,10540,11595,9056,-2539
2020,3,9,18,10410,11153,8762,-2391
2020,3,9,19,10220,11059,8530,-2529
2020,3,9,20,10670,11317,8891,-2426
2020,3,9,21,11380,11709,9295,-2414
2020,3,9,22,12530,12748,9976,-2772
2020,3,9,23,13450,13557,10567,-2990
2020,3,10,0,14100,14069,11108,-2961
2020,3,10,1,13460,13593,10809,-2784
2020,3,10,2,12570,12663,9796,-2867
2020,3,10,3,11490,11527,8691,-2836
2020,3,10,4,10510,10711,8099,-2612
2020,3,10,5,9760,10287,7571,-2716
2020,3,10,6,9380,9905,7400,-2505
2020,3,10,7,9200,9726,7432,-2294
2020,3,10,8,9200,9928,7627,-2301
2020,3,10,9,9510,10045,7902,-2143
2020,3,10,10,10440,10461,8316,-2145
2020,3,10,11,12140,12105,9232,-2873
2020,3,10,12,13120,13115,10015,-3100
2020,3,10,13,13130,13136,10171,-2965
2020,3,10,14,12890,12860,10288,-2572
2020,3,10,15,12640,12445,9917,-2528
2020,3,10,16,12430,12013,9426,-2587
2020,3,10,17,12300,11792,9148,-2644
2020,3,10,18,12270,12106,9678,-2428
2020,3,10,19,12230,12327,9880,-2447
2020,3,10,20,12410,12262,9684,-2578
2020,3,10,21,12800,12624,9920,-2704
2020,3,10,22,13220,13360,10510,-2850
2020,3,10,23,13820,13874,10902,-2972
2020,3,11,0,14210,14124,11093,-3031
2020,3,11,1,13510,13570,10563,-3007
2020,3,11,2,12590,12649,9715,-2934
2020,3,11,3,11470,11753,9043,-2710
2020,3,11,4,10490,10914,8565,-2349
2020,3,11,5,9770,10387,7367,-3020
2020,3,11,6,9380,10196,7434,-2762
2020,3,11,7,9200,9795,7354,-2441
2020,3,11,8,9170,9469,7315,-2154
2020,3,11,9,9510,10021,7570,-2451
2020,3,11,10,10460,10742,8248,-2494
2020,3,11,11,12200,12173,9643,-2530
2020,3,11,12,13130,13155,10488,-2667
2020,3,11,13,12740,12787,9838,-2949
2020,3,11,14,12000,11998,8992,-3006
2020,3,11,15,11630,11410,8917,-2493
2020,3,11,16,11370,11109,9019,-2090
2020,3,11,17,11340,10922,8891,-2031
2020,3,11,18,11440,11332,9202,-2130
2020,3,11,19,11560,11764,9247,-2517
2020,3,11,20,11860,12189,9623,-2566
2020,3,11,21,12280,12353,9617,-2736
2020,3,11,22,13030,13084,10191,-2893
2020,3,11,23,13770,13878,10851,-3027
2020,3,12,0,14350,14343,11305,-3038
2020,3,12,1,13920,13899,10969,-2930
2020,3,12,2,13060,13011,10308,-2703
2020,3,12,3,11970,11907,9561,-2346
2020,3,12,4,11080,10950,8521,-2429
2020,3,12,5,10260,10546,8234,-2312
2020,3,12,6,9960,10450,8044,-2406
2020,3,12,7,9850,10421,7843,-2578
2020,3,12,8,9910,10481,7915,-2566
2020,3,12,9,10280,10654,8070,-2584
2020,3,12,10,11280,11548,8894,-2654
2020,3,12,11,13020,12982,9946,-3036
2020,3,12,12,13920,13916,10800,-3116
2020,3,12,13,13850,13861,10856,-3005
2020,3,12,14,13650,13647,10817,-2830
2020,3,12,15,13380,13476,10700,-2776
2020,3,12,16,12950,13333,10427,-2906
2020,3,12,17,12700,13009,10069,-2940
2020,3,12,18,12670,12996,9951,-3045
2020,3,12,19,12740,12838,9949,-2889
2020,3,12,20,13030,12910,10031,-2879
2020,3,12,21,13250,13209,10527,-2682
2020,3,12,22,13440,13737,10980,-2757
2020,3,12,23,14110,14312,11490,-2822
2020,3,13,0,14330,14705,11948,-2757
2020,3,13,1,14090,14238,11449,-2789
2020,3,13,2,13250,13428,10550,-2878
2020,3,13,3,12060,12991,10078,-2913
2020,3,13,4,11030,12037,9521,-2516
2020,3,13,5,10530,11340,9182,-2158
2020,3,13,6,10130,11229,8887,-2342
2020,3,13,7,9950,11048,8462,-2586
2020,3,13,8,9940,11014,8475,-2539
2020,3,13,9,10220,11289,8783,-2506
2020,3,13,10,11060,12017,9390,-2627
2020,3,13,11,12480,12898,10263,-2635
2020,3,13,12,13560,13541,10909,-2632
2020,3,13,13,14040,14057,11596,-2461
2020,3,13,14,14170,14311,11918,-2393
2020,3,13,15,14530,14506,12058,-2448
2020,3,13,16,14240,14512,12065,-2447
2020,3,13,17,14010,14348,11832,-2516
2020,3,13,18,13740,14135,11433,-2702
2020,3,13,19,13270,13429,10580,-2849
2020,3,13,20,12850,12746,10112,-2634
2020,3,13,21,12520,12727,10131,-2596
2020,3,13,22,13010,13153,10411,-2742
2020,3,13,23,13450,13528,10699,-2829
2020,3,14,0,13840,13893,11023,-2870
2020,3,14,1,13590,13507,10861,-2646
2020,3,14,2,13010,12829,10130,-2699
2020,3,14,3,12240,12467,9782,-2685
2020,3,14,4,11370,11633,9072,-2561
2020,3,14,5,10410,10988,8340,-2648
2020,3,14,6,10000,10566,7884,-2682
2020,3,14,7,9780,10516,7761,-2755
2020,3,14,8,9740,10597,7746,-2851
2020,3,14,9,9920,10936,8070,-2866
2020,3,14,10,10410,10943,7992,-2951
2020,3,14,11,11010,11490,8676,-2814
2020,3,14,12,11610,11530,9173,-2357
2020,3,14,13,11710,11601,9007,-2594
2020,3,14,14,11390,11298,9084,-2214
2020,3,14,15,10770,10867,8726,-2141
2020,3,14,16,10400,10485,8483,-2002
2020,3,14,17,10210,10157,8216,-1941
2020,3,14,18,9860,10261,8316,-1945
2020,3,14,19,9790,10405,8484,-1921
2020,3,14,20,10180,10568,8395,-2173
2020,3,14,21,10940,11228,8720,-2508
2020,3,14,22,11820,12271,9322,-2949
2020,3,14,23,12750,13114,10200,-2914
2020,3,15,0,13140,13497,10594,-2903
2020,3,15,1,12900,13086,10327,-2759
2020,3,15,2,12410,12440,9295,-3145
2020,3,15,3,11730,11632,8690,-2942
2020,3,15,4,11010,10881,8287,-2594
2020,3,15,5,10360,10479,7837,-2642
2020,3,15,6,10000,10160,7664,-2496
2020,3,15,7,9820,9915,7436,-2479
2020,3,15,8,9770,9851,7285,-2566
2020,3,15,9,9850,9926,7330,-2596
2020,3,15,10,10130,10191,7575,-2616
2020,3,15,11,10660,10957,8158,-2799
2020,3,15,12,11240,11176,8445,-2731
2020,3,15,13,11160,11302,8735,-2567
2020,3,15,14,10910,11135,8856,-2279
2020,3,15,15,10390,10689,8578,-2111
2020,3,15,16,10110,10174,8072,-2102
2020,3,15,17,9910,9968,8032,-1936
2020,3,15,18,9660,9866,7729,-2137
2020,3,15,19,9580,9881,7570,-2311
2020,3,15,20,10020,9966,7767,-2199
2020,3,15,21,10950,10710,8405,-2305
2020,3,15,22,12120,11993,9229,-2764
2020,3,15,23,13160,13072,10074,-2998
2020,3,16,0,13880,13752,10743,-3009
2020,3,16,1,13620,13472,10510,-2962
2020,3,16,2,13050,12793,9859,-2934
2020,3,16,3,12160,11958,8858,-3100
2020,3,16,4,11230,11360,8736,-2624
2020,3,16,5,10730,10922,8513,-2409
2020,3,16,6,10490,10677,8395,-2282
2020,3,16,7,10430,10603,8268,-2335
2020,3,16,8,10570,10719,8482,-2237
2020,3,16,9,11000,11138,8999,-2139
2020,3,16,10,12080,11786,9597,-2189
2020,3,16,11,13650,13220,11248,-1972
2020,3,16,12,14580,14114,11828,-2286
2020,3,16,13,14140,13886,11493,-2393
2020,3,16,14,13020,13075,10876,-2199
2020,3,16,15,12480,12471,10739,-1732
2020,3,16,16,12070,12095,10478,-1617
2020,3,16,17,11820,11847,10338,-1509
2020,3,16,18,11680,11881,9940,-1941
2020,3,16,19,11800,11796,9762,-2034
2020,3,16,20,12280,12072,9766,-2306
2020,3,16,21,12980,12754,10259,-2495
2020,3,16,22,13870,13787,10942,-2845
2020,3,16,23,14530,14583,11597,-2986
2020,3,17,0,15010,15092,11900,-3192
2020,3,17,1,14580,14597,11282,-3315
2020,3,17,2,13700,13751,10395,-3356
2020,3,17,3,12560,12819,9544,-3275
2020,3,17,4,11550,11987,9058,-2929
2020,3,17,5,11130,11340,8613,-2727
2020,3,17,6,10770,11111,8427,-2684
2020,3,17,7,10600,11067,8416,-2651
2020,3,17,8,10610,11051,8390,-2661
2020,3,17,9,10900,11300,8547,-2753
2020,3,17,10,11790,11770,8988,-2782
2020,3,17,11,13230,12757,9898,-2859
2020,3,17,12,14190,13795,10586,-3209
2020,3,17,13,14550,14527,11347,-3180
2020,3,17,14,14860,14853,12059,-2794
2020,3,17,15,14920,15058,12100,-2958
2020,3,17,16,14720,15068,11957,-3111
2020,3,17,17,14520,14787,11751,-3036
2020,3,17,18,14360,14690,11610,-3080
2020,3,17,19,14020,14398,11285,-3113
2020,3,17,20,13780,13787,10723,-3064
2020,3,17,21,13750,13963,10733,-3230
2020,3,17,22,13950,14361,10993,-3368
2020,3,17,23,14420,14483,11157,-3326
2020,3,18,0,14750,14603,11345,-3258
2020,3,18,1,14370,14057,10891,-3166
2020,3,18,2,13460,13233,9979,-3254
2020,3,18,3,12260,12456,9336,-3120
2020,3,18,4,11240,11757,9096,-2661
2020,3,18,5,10680,11247,8986,-2261
2020,3,18,6,10350,10901,8536,-2365
2020,3,18,7,10230,10742,8326,-2416
2020,3,18,8,10240,10765,8349,-2416
2020,3,18,9,10560,11088,9013,-2075
2020,3,18,10,11450,11714,9378,-2336
2020,3,18,11,12950,12580,9954,-2626
2020,3,18,12,13520,13356,10573,-2783
2020,3,18,13,13080,13089,10336,-2753
2020,3,18,14,12230,12263,10061,-2202
2020,3,18,15,11590,11717,9880,-1837
2020,3,18,16,11040,11835,9771,-2064
2020,3,18,17,10780,11672,9480,-2192
2020,3,18,18,10710,11623,9456,-2167
2020,3,18,19,10770,11374,9270,-2104
2020,3,18,20,11200,11526,9253,-2273
2020,3,18,21,11940,12033,9526,-2507
2020,3,18,22,12880,13066,10374,-2692
2020,3,18,23,13540,13709,10855,-2854
2020,3,19,0,14120,14134,11140,-2994
2020,3,19,1,13890,13598,10711,-2887
2020,3,19,2,13110,12746,9982,-2764
2020,3,19,3,12060,11777,9032,-2745
2020,3,19,4,11110,11072,8644,-2428
2020,3,19,5,10270,10782,8743,-2039
2020,3,19,6,9930,10677,8552,-2125
2020,3,19,7,9760,10542,8433,-2109
2020,3,19,8,9770,10325,8462,-1863
2020,3,19,9,10070,10586,8767,-1819
2020,3,19,10,10820,11334,9269,-2065
2020,3,19,11,12030,11993,9441,-2552
2020,3,19,12,13090,13283,10286,-2997
2020,3,19,13,13830,13900,10903,-2997
2020,3,19,14,14240,14135,11071,-3064
2020,3,19,15,14310,14240,11429,-2811
2020,3,19,16,14170,14250,11502,-2748
2020,3,19,17,14050,14099,11347,-2752
2020,3,19,18,13980,13964,11360,-2604
2020,3,19,19,13800,13780,11240,-2540
2020,3,19,20,13790,13690,11259,-2431
2020,3,19,21,13930,13874,11149,-2725
2020,3,19,22,14180,14283,11442,-2841
2020,3,19,23,14400,14477,11411,-3066
2020,3,20,0,14640,14465,11192,-3273
2020,3,20,1,14210,13833,10491,-3342
2020,3,20,2,13320,12965,9795,-3170
2020,3,20,3,12200,12244,9208,-3036
2020,3,20,4,11200,11310,8654,-2656
2020,3,20,5,10390,10734,8000,-2734
2020,3,20,6,10020,10561,8077,-2484
2020,3,20,7,9830,10237,7898,-2339
2020,3,20,8,9760,10071,7695,-2376
2020,3,20,9,10010,10518,7976,-2542
2020,3,20,10,10690,10949,8017,-2932
2020,3,20,11,11800,11942,8712,-3230
2020,3,20,12,12730,12721,9140,-3581
2020,3,20,13,13300,13305,9645,-3660
2020,3,20,14,13490,13464,9727,-3737
2020,3,20,15,13350,13476,9817,-3659
2020,3,20,16,13100,13440,9861,-3579
2020,3,20,17,12760,13316,9758,-3558
2020,3,20,18,12680,12912,9446,-3466
2020,3,20,19,12500,12899,9584,-3315
2020,3,20,20,12540,12518,9196,-3322
2020,3,20,21,12640,12377,9060,-3317
2020,3,20,22,12950,12753,9402,-3351
2020,3,20,23,13240,13141,9857,-3284
2020,3,21,0,13500,13514,10410,-3104
2020,3,21,1,13010,13015,9728,-3287
2020,3,21,2,12260,12172,9208,-2964
2020,3,21,3,11390,12518,9671,-2847
2020,3,21,4,10500,10527,8210,-2317
2020,3,21,5,9620,9929,7863,-2066
2020,3,21,6,9240,9498,7684,-1814
2020,3,21,7,9040,9312,7340,-1972
2020,3,21,8,8990,9254,7400,-1854
2020,3,21,9,9130,9386,7621,-1765
2020,3,21,10,9490,9748,7608,-2140
2020,3,21,11,10110,10345,7788,-2557
2020,3,21,12,10650,10646,8400,-2246
2020,3,21,13,11000,11001,8438,-2563
2020,3,21,14,10800,10828,8116,-2712
2020,3,21,15,10350,10384,7797,-2587
2020,3,21,16,10000,10027,7896,-2131
2020,3,21,17,9720,9739,8048,-1691
2020,3,21,18,9400,9405,7806,-1599
2020,3,21,19,9230,9244,7731,-1513
2020,3,21,20,9500,9396,7716,-1680
2020,3,21,21,10100,10178,8063,-2115
2020,3,21,22,10780,11521,9159,-2362
2020,3,21,23,11760,12656,9920,-2736
2020,3,22,0,12870,13322,10315,-3007
2020,3,22,1,12710,13021,10259,-2762
2020,3,22,2,11960,12397,9498,-2899
2020,3,22,3,11480,11681,8821,-2860
2020,3,22,4,10940,10970,8562,-2408
2020,3,22,5,10440,10451,8172,-2279
2020,3,22,6,10140,10157,8058,-2099
2020,3,22,7,10030,10223,8267,-1956
2020,3,22,8,10020,10314,8354,-1960
2020,3,22,9,10150,10278,8206,-2072
2020,3,22,10,10450,10439,8282,-2157
2020,3,22,11,10910,10908,8679,-2229
2020,3,22,12,11220,11217,8944,-2273
2020,3,22,13,11060,11056,8638,-2418
2020,3,22,14,10620,10786,8486,-2300
2020,3,22,15,10240,10636,8640,-1996
2020,3,22,16,9910,10277,8589,-1688
2020,3,22,17,9710,10190,8627,-1563
2020,3,22,18,9510,9934,8307,-1627
2020,3,22,19,9720,10023,8296,-1727
2020,3,22,20,10330,10238,8107,-2131
2020,3,22,21,11220,11051,8638,-2413
2020,3,22,22,12380,12183,9384,-2799
2020,3,22,23,13280,13283,10163,-3120
2020,3,23,0,14200,14005,10663,-3342
2020,3,23,1,13830,13675,10467,-3208
2020,3,23,2,13050,12930,9700,-3230
2020,3,23,3,12140,12095,8935,-3160
2020,3,23,4,11310,11420,8405,-3015
2020,3,23,5,10730,11055,8237,-2818
2020,3,23,6,10450,10757,7803,-2954
2020,3,23,7,10360,10672,7897,-2775
2020,3,23,8,10380,10680,7811,-2869
2020,3,23,9,10680,10970,8168,-2802
2020,3,23,10,11450,11935,9046,-2889
2020,3,23,11,12630,12646,10084,-2562
2020,3,23,12,13540,13531,11055,-2476
2020,3,23,13,13980,13989,11541,-2448
2020,3,23,14,14150,14142,11353,-2789
2020,3,23,15,14150,14388,11860,-2528
2020,3,23,16,14170,14401,11973,-2428
2020,3,23,17,14090,14420,11831,-2589
2020,3,23,18,14060,14748,12109,-2639
2020,3,23,19,14110,14856,11984,-2872
2020,3,23,20,14140,14909,11857,-3052
2020,3,23,21,14430,15200,12206,-2994
2020,3,23,22,14950,15610,12335,-3275
2020,3,23,23,15270,15443,12015,-3428
2020,3,24,0,15580,15175,11704,-3471
2020,3,24,1,14790,14505,11350,-3155
2020,3,24,2,13710,13564,10352,-3212
2020,3,24,3,12670,12597,9491,-3106
2020,3,24,4,11650,11955,9130,-2825
2020,3,24,5,11050,11585,9193,-2392
2020,3,24,6,10670,11271,8918,-2353
2020,3,24,7,10480,11012,8730,-2282
2020,3,24,8,10420,10955,8647,-2308
2020,3,24,9,10650,11052,8677,-2375
2020,3,24,10,11290,11515,9041,-2474
2020,3,24,11,12340,12309,9279,-3030
2020,3,24,12,13150,13140,9579,-3561
2020,3,24,13,13520,13533,10117,-3416
2020,3,24,14,13160,13148,10083,-3065
2020,3,24,15,12460,12515,9402,-3113
2020,3,24,16,11950,12406,9713,-2693
2020,3,24,17,11700,12239,9843,-2396
2020,3,24,18,11600,12154,9603,-2551
2020,3,24,19,11610,12245,9704,-2541
2020,3,24,20,11810,12113,9603,-2510
2020,3,24,21,12270,12309,9539,-2770
2020,3,24,22,12900,13058,9808,-3250
2020,3,24,23,13580,13606,10249,-3357
2020,3,25,0,14400,14024,10556,-3468
2020,3,25,1,14080,13588,10224,-3364
2020,3,25,2,13150,12813,9448,-3365
2020,3,25,3,12140,11932,8757,-3175
2020,3,25,4,11260,11349,8588,-2761
2020,3,25,5,10540,11359,8817,-2542
2020,3,25,6,10240,11298,8736,-2562
2020,3,25,7,10090,11158,8526,-2632
2020,3,25,8,10080,11150,8397,-2753
2020,3,25,9,10320,11152,8558,-2594
2020,3,25,10,11000,11484,8963,-2521
2020,3,25,11,12060,12030,9201,-2829
2020,3,25,12,12870,12862,9434,-3428
2020,3,25,13,13350,13345,9850,-3495
2020,3,25,14,13440,13415,10361,-3054
2020,3,25,15,13260,13487,10592,-2895
2020,3,25,16,13090,13525,10694,-2831
2020,3,25,17,13020,13527,10824,-2703
2020,3,25,18,12970,13496,10768,-2728
2020,3,25,19,12920,13289,10677,-2612
2020,3,25,20,13020,13102,10307,-2795
2020,3,25,21,13370,13302,10362,-2940
2020,3,25,22,13870,13988,10548,-3440
2020,3,25,23,14440,14272,10849,-3423
2020,3,26,0,15000,14390,10924,-3466
2020,3,26,1,14330,13797,10624,-3173
2020,3,26,2,13500,12966,10031,-2935
2020,3,26,3,12390,12044,9138,-2906
2020,3,26,4,11420,11293,8522,-2771
2020,3,26,5,10700,10884,8020,-2864
2020,3,26,6,10400,10573,7565,-3008
2020,3,26,7,10250,10427,7699,-2728
2020,3,26,8,10270,10579,7529,-3050
2020,3,26,9,10590,10867,7824,-3043
2020,3,26,10,11490,11190,8349,-2841
2020,3,26,11,12890,12213,9117,-3096
2020,3,26,12,13520,12880,9451,-3429
2020,3,26,13,13230,12651,9408,-3243
2020,3,26,14,12030,11875,8891,-2984
2020,3,26,15,11290,11175,8141,-3034
2020,3,26,16,10850,10783,7954,-2829
2020,3,26,17,10500,10544,7844,-2700
2020,3,26,18,10440,10488,7620,-2868
2020,3,26,19,10480,10665,7615,-3050
2020,3,26,20,10980,10619,7910,-2709
2020,3,26,21,11590,11131,8228,-2903
2020,3,26,22,12640,12149,8707,-3442
2020,3,26,23,13490,12994,9569,-3425
2020,3,27,0,13970,13506,10378,-3128
2020,3,27,1,13740,13127,10348,-2779
2020,3,27,2,12970,12320,9351,-2969
2020,3,27,3,11890,11396,8450,-2946
2020,3,27,4,10950,10751,7961,-2790
2020,3,27,5,9930,10113,7712,-2401
2020,3,27,6,9550,9568,7295,-2273
2020,3,27,7,9370,9378,7267,-2111
2020,3,27,8,9310,9466,7376,-2090
2020,3,27,9,9530,9779,7688,-2091
2020,3,27,10,10130,10200,7773,-2427
2020,3,27,11,11120,11087,8345,-2742
2020,3,27,12,11820,11814,8871,-2943
2020,3,27,13,11800,11820,8867,-2953
2020,3,27,14,11000,11058,8348,-2710
2020,3,27,15,10400,10494,7874,-2620
2020,3,27,16,10120,10227,8067,-2160
2020,3,27,17,9720,10041,7903,-2138
2020,3,27,18,9620,9863,8056,-1807
2020,3,27,19,9670,9811,8059,-1752
2020,3,27,20,9830,9881,8136,-1745
2020,3,27,21,10310,10475,8172,-2303
2020,3,27,22,11180,11436,9003,-2433
2020,3,27,23,11920,12289,9340,-2949
2020,3,28,0,12490,12798,9599,-3199
2020,3,28,1,12300,12503,9381,-3122
2020,3,28,2,11710,11774,9024,-2750
2020,3,28,3,10990,10991,8257,-2734
2020,3,28,4,10210,10418,7575,-2843
2020,3,28,5,9650,9914,7337,-2577
2020,3,28,6,9340,9614,7303,-2311
2020,3,28,7,9220,9480,7354,-2126
2020,3,28,8,9220,9473,7047,-2426
2020,3,28,9,9380,9626,7190,-2436
2020,3,28,10,9740,9967,7435,-2532
2020,3,28,11,10270,10246,7474,-2772
2020,3,28,12,10540,10524,7354,-3170
2020,3,28,13,10470,10470,7665,-2805
2020,3,28,14,10360,10639,7905,-2734
2020,3,28,15,10470,10895,8187,-2708
2020,3,28,16,10470,10809,7996,-2813
2020,3,28,17,10450,11046,8138,-2908
2020,3,28,18,10600,11081,7970,-3111
2020,3,28,19,10800,11215,8146,-3069
2020,3,28,20,11030,11377,8134,-3243
2020,3,28,21,11420,12033,8836,-3197
2020,3,28,22,11870,12633,9430,-3203
2020,3,28,23,12300,12999,9767,-3232
2020,3,29,0,12400,13061,9810,-3251
2020,3,29,1,12180,12548,9380,-3168
2020,3,29,2,11720,11782,8583,-3199
2020,3,29,3,10990,11069,7965,-3104
2020,3,29,4,10260,10551,7524,-3027
2020,3,29,5,9670,10140,7437,-2703
2020,3,29,6,9300,9842,7242,-2600
2020,3,29,7,9110,9910,7234,-2676
2020,3,29,8,9020,9838,7288,-2550
2020,3,29,9,9050,9888,7421,-2467
2020,3,29,10,9260,10067,7832,-2235
2020,3,29,11,9660,10462,7830,-2632
2020,3,29,12,10140,10902,8012,-2890
2020,3,29,13,10860,11288,8637,-2651
2020,3,29,14,11620,11605,9184,-2421
2020,3,29,15,12220,12205,9796,-2409
2020,3,29,16,12850,12758,10225,-2533
2020,3,29,17,13050,13149,10212,-2937
2020,3,29,18,13040,13215,10250,-2965
2020,3,29,19,13000,13183,10050,-3133
2020,3,29,20,12950,13248,10115,-3133
2020,3,29,21,13190,13506,10337,-3169
2020,3,29,22,13390,13824,10554,-3270
2020,3,29,23,13670,13793,10530,-3263
2020,3,30,0,13880,13635,10450,-3185
2020,3,30,1,13480,13025,9990,-3035
2020,3,30,2,12390,12194,9172,-3022
2020,3,30,3,11220,11370,8302,-3068
2020,3,30,4,10380,10902,8099,-2803
2020,3,30,5,10150,10806,8173,-2633
2020,3,30,6,9850,10708,8231,-2477
2020,3,30,7,9650,10615,8059,-2556
2020,3,30,8,9570,10607,7680,-2927
2020,3,30,9,9820,10838,7967,-2871
2020,3,30,10,10630,11152,8356,-2796
2020,3,30,11,11800,11741,8995,-2746
2020,3,30,12,12610,12405,9572,-2833
2020,3,30,13,12990,13092,10395,-2697
2020,3,30,14,13160,13288,10553,-2735
2020,3,30,15,13030,13393,10666,-2727
2020,3,30,16,13060,13441,10578,-2863
2020,3,30,17,13540,13561,10540,-3021
2020,3,30,18,13450,13499,10396,-3103
2020,3,30,19,13360,13435,10237,-3198
2020,3,30,20,13360,13413,10272,-3141
2020,3,30,21,13450,13628,10386,-3242
2020,3,30,22,13700,14161,10967,-3194
2020,3,30,23,13960,14296,10934,-3362
2020,3,31,0,14390,14257,11011,-3246
2020,3,31,1,13880,13674,10258,-3416
2020,3,31,2,13140,12807,9421,-3386
2020,3,31,3,12170,12033,8925,-3108
2020,3,31,4,11280,11325,8451,-2874
2020,3,31,5,10490,10984,8339,-2645
2020,3,31,6,10140,10734,8143,-2591
2020,3,31,7,9960,10728,8277,-2451
2020,3,31,8,9910,10717,7905,-2812
2020,3,31,9,10190,10959,8045,-2914
2020,3,31,10,10900,11407,8442,-2965
2020,3,31,11,12000,12199,8979,-3220
2020,3,31,12,12730,12654,9299,-3355
2020,3,31,13,12970,12864,9586,-3278
2020,3,31,14,12800,12675,9329,-3346
2020,3,31,15,12380,12311,9123,-3188
2020,3,31,16,12060,11879,8988,-2891
2020,3,31,17,11830,11788,9014,-2774
2020,3,31,18,11690,11573,8897,-2676
2020,3,31,19,11630,11548,8904,-2644
2020,3,31,20,11810,11440,8684,-2756
2020,3,31,21,12180,11798,8759,-3039
2020,3,31,22,12900,12842,9335,-3507
2020,3,31,23,13560,13201,9769,-3432
2020,4,1,0,14000,13706,10302,-3404
2020,4,1,1,13690,13455,10186,-3269
2020,4,1,2,12950,12722,9443,-3279
2020,4,1,3,11970,11929,8683,-3246
2020,4,1,4,11120,11307,8085,-3222
2020,4,1,5,10570,10793,7457,-3336
2020,4,1,6,10240,10445,7206,-3239
2020,4,1,7,10110,10494,7353,-3141
2020,4,1,8,10130,10549,7455,-3094
2020,4,1,9,10440,10745,7641,-3104
2020,4,1,10,11180,11124,7981,-3143
2020,4,1,11,12230,11988,8855,-3133
2020,4,1,12,12850,12584,9318,-3266
2020,4,1,13,12900,12494,9231,-3263
2020,4,1,14,12200,11948,8787,-3161
2020,4,1,15,11840,11578,8475,-3103
2020,4,1,16,11580,11640,8798,-2842
2020,4,1,17,11510,11829,8962,-2867
2020,4,1,18,11570,11808,8808,-3000
2020,4,1,19,11660,11686,8720,-2966
2020,4,1,20,11880,11681,8689,-2992
2020,4,1,21,12340,12059,8422,-3637
2020,4,1,22,12990,12832,9231,-3601
2020,4,1,23,13470,13280,9638,-3642
2020,4,2,0,13900,13644,10094,-3550
2020,4,2,1,13600,13325,9727,-3598
2020,4,2,2,12820,12547,8806,-3741
2020,4,2,3,11800,11652,7892,-3760
2020,4,2,4,10910,11028,7485,-3543
2020,4,2,5,10210,10606,7040,-3566
2020,4,2,6,9880,10163,6613,-3550
2020,4,2,7,9740,10021,6586,-3435
2020,4,2,8,9730,10010,6461,-3549
2020,4,2,9,9990,10448,6588,-3860
2020,4,2,10,10620,10959,7099,-3860
2020,4,2,11,11620,11547,7808,-3739
2020,4,2,12,12390,12325,8507,-3818
2020,4,2,13,12780,12738,8836,-3902
2020,4,2,14,12640,12604,8682,-3922
2020,4,2,15,12690,12269,8471,-3798
2020,4,2,16,12720,11963,8145,-3818
2020,4,2,17,12690,12094,8363,-3731
2020,4,2,18,12740,12315,8762,-3553
2020,4,2,19,12810,12314,8785,-3529
2020,4,2,20,12960,12477,8560,-3917
2020,4,2,21,13210,12941,9105,-3836
2020,4,2,22,13500,13606,9810,-3796
2020,4,2,23,13680,13853,10111,-3742
2020,4,3,0,14050,13872,10212,-3660
2020,4,3,1,13730,13425,9832,-3593
2020,4,3,2,12920,12667,9048,-3619
2020,4,3,3,11890,11792,8227,-3565
2020,4,3,4,10940,11131,7684,-3447
2020,4,3,5,10310,11132,7743,-3389
2020,4,3,6,9930,10762,7381,-3381
2020,4,3,7,9740,10659,7366,-3293
2020,4,3,8,9680,10749,7475,-3274
2020,4,3,9,9860,10930,7539,-3391
2020,4,3,10,10470,11465,8154,-3311
2020,4,3,11,11400,12161,8910,-3251
2020,4,3,12,12260,12485,9243,-3242
2020,4,3,13,12930,12919,9465,-3454
2020,4,3,14,13300,13292,10067,-3225
2020,4,3,15,13540,13507,10250,-3257
2020,4,3,16,13540,13543,10467,-3076
2020,4,3,17,13420,13608,10539,-3069
2020,4,3,18,13310,13437,10342,-3095
2020,4,3,19,13230,13168,10006,-3162
2020,4,3,20,13220,12998,9920,-3078
2020,4,3,21,13170,13184,10087,-3097
2020,4,3,22,13270,13561,9993,-3568
2020,4,3,23,13380,13638,10161,-3477
2020,4,4,0,13600,13610,10336,-3274
2020,4,4,1,13190,13176,10014,-3162
2020,4,4,2,12470,12407,9198,-3209
2020,4,4,3,11650,11799,8524,-3275
2020,4,4,4,10770,10812,7761,-3051
2020,4,4,5,10140,10386,7040,-3346
2020,4,4,6,9730,9998,6677,-3321
2020,4,4,7,9520,9794,6542,-3252
2020,4,4,8,9420,9672,6353,-3319
2020,4,4,9,9500,9960,6457,-3503
2020,4,4,10,9770,9808,6369,-3439
2020,4,4,11,10220,10221,6681,-3540
2020,4,4,12,10650,10637,7010,-3627
2020,4,4,13,11100,11084,7401,-3683
2020,4,4,14,11400,11401,7775,-3626
2020,4,4,15,11360,11357,7766,-3591
2020,4,4,16,11100,11104,7527,-3577
2020,4,4,17,10590,10719,7095,-3624
2020,4,4,18,10040,10291,6819,-3472
2020,4,4,19,9960,10159,6691,-3468
2020,4,4,20,10170,10483,6783,-3700
2020,4,4,21,10920,10699,7093,-3606
2020,4,4,22,11820,11533,8147,-3386
2020,4,4,23,12400,12305,8765,-3540
2020,4,5,0,12750,12753,9288,-3465
2020,4,5,1,12220,12492,9005,-3487
2020,4,5,2,11580,11800,8344,-3456
2020,4,5,3,10890,11066,7666,-3400
2020,4,5,4,10200,10338,6802,-3536
2020,4,5,5,9750,9770,6385,-3385
2020,4,5,6,9340,9381,6090,-3291
2020,4,5,7,9130,9436,6106,-3330
2020,4,5,8,9030,9324,6027,-3297
2020,4,5,9,9080,9362,5983,-3379
2020,4,5,10,9300,9570,6113,-3457
2020,4,5,11,9640,9844,6527,-3317
2020,4,5,12,9940,10027,6662,-3365
2020,4,5,13,10330,10317,6873,-3444
2020,4,5,14,10570,10557,7057,-3500
2020,4,5,15,10110,10502,6949,-3553
2020,4,5,16,9850,10459,6805,-3654
2020,4,5,17,9760,10518,6917,-3601
2020,4,5,18,9870,10389,6844,-3545
2020,4,5,19,10070,10337,6779,-3558
2020,4,5,20,10400,10500,6876,-3624
2020,4,5,21,11120,11195,7641,-3554
2020,4,5,22,12110,12169,8594,-3575
2020,4,5,23,12680,12614,9092,-3522
2020,4,6,0,13000,12732,9149,-3583
2020,4,6,1,12440,12342,8787,-3555
2020,4,6,2,11500,11590,8063,-3527
2020,4,6,3,10640,10913,7454,-3459
2020,4,6,4,9840,10291,6848,-3443
2020,4,6,5,9590,9626,6709,-2917
2020,4,6,6,9270,9674,6487,-3187
2020,4,6,7,9090,9827,6418,-3409
2020,4,6,8,9090,9861,6323,-3538
2020,4,6,9,9430,9849,6673,-3176
2020,4,6,10,10130,10299,6779,-3520
2020,4,6,11,11140,10942,7586,-3356
2020,4,6,12,11660,11485,8512,-2973
2020,4,6,13,11460,11192,8132,-3060
2020,4,6,14,10820,10566,7486,-3080
2020,4,6,15,10290,10183,7125,-3058
2020,4,6,16,10000,10155,7304,-2851
2020,4,6,17,9860,10060,7287,-2773
2020,4,6,18,9780,9890,7219,-2671
2020,4,6,19,9790,9757,7244,-2513
2020,4,6,20,10090,9881,7072,-2809
2020,4,6,21,9930,10558,7536,-3022
2020,4,6,22,10790,11559,8253,-3306
2020,4,6,23,12090,12391,9059,-3332
2020,4,7,0,13000,12832,9676,-3156
2020,4,7,1,12830,12624,9394,-3230
2020,4,7,2,11780,11828,8640,-3188
2020,4,7,3,10900,10958,7659,-3299
2020,4,7,4,10110,10128,7004,-3124
2020,4,7,5,9560,9661,6423,-3238
2020,4,7,6,9220,9758,6483,-3275
2020,4,7,7,9060,9597,6468,-3129
2020,4,7,8,9050,9588,6376,-3212
2020,4,7,9,9280,9549,6562,-2987
2020,4,7,10,9990,10162,7021,-3141
2020,4,7,11,10890,10843,8090,-2753
2020,4,7,12,11380,11394,8593,-2801
2020,4,7,13,11280,11153,8269,-2884
2020,4,7,14,10560,10598,8114,-2484
2020,4,7,15,10090,10328,7841,-2487
2020,4,7,16,9930,10301,8088,-2213
2020,4,7,17,9840,10395,8092,-2303
2020,4,7,18,9780,10236,7863,-2373
2020,4,7,19,9800,10063,7477,-2586
2020,4,7,20,9960,10036,7535,-2501
2020,4,7,21,10720,10808,8041,-2767
2020,4,7,22,11740,11627,8586,-3041
2020,4,7,23,12520,12358,9245,-3113
2020,4,8,0,12950,12753,9796,-2957
2020,4,8,1,12620,12527,9537,-2990
2020,4,8,2,11880,11727,8725,-3002
2020,4,8,3,10900,10883,7687,-3196
2020,4,8,4,10070,10059,6958,-3101
2020,4,8,5,9480,9716,6424,-3292
2020,4,8,6,9140,9441,6304,-3137
2020,4,8,7,8950,9487,6370,-3117
2020,4,8,8,8920,9446,6355,-3091
2020,4,8,9,9240,9561,6532,-3029
2020,4,8,10,9880,9693,7056,-2637
2020,4,8,11,10980,10641,8116,-2525
2020,4,8,12,11890,11546,8855,-2691
2020,4,8,13,12210,12230,9404,-2826
2020,4,8,14,12450,12468,9572,-2896
2020,4,8,15,12410,12404,9668,-2736
2020,4,8,16,12310,12134,9392,-2742
2020,4,8,17,12200,11853,9006,-2847
2020,4,8,18,12030,11493,8709,-2784
2020,4,8,19,11850,11144,8589,-2555
2020,4,8,20,11830,11138,8461,-2677
2020,4,8,21,12150,11566,8532,-3034
2020,4,8,22,12920,12296,9227,-3069
2020,4,8,23,13270,12667,9629,-3038
2020,4,9,0,13430,12924,10038,-2886
2020,4,9,1,13050,12694,9751,-2943
2020,4,9,2,12210,11952,8911,-3041
2020,4,9,3,11220,11116,7960,-3156
2020,4,9,4,10320,10332,7190,-3142
2020,4,9,5,9730,9980,6739,-3241
2020,4,9,6,9380,9868,6504,-3364
2020,4,9,7,9230,9767,6396,-3371
2020,4,9,8,9210,9734,6550,-3184
2020,4,9,9,9500,9947,6700,-3247
2020,4,9,10,10210,10205,7137,-3068
2020,4,9,11,11220,10878,8194,-2684
2020,4,9,12,11910,11616,8682,-2934
2020,4,9,13,12300,12338,9303,-3035
2020,4,9,14,12580,12753,9751,-3002
2020,4,9,15,12760,13159,10225,-2934
2020,4,9,16,13260,13452,10526,-2926
2020,4,9,17,13220,13721,10673,-3048
2020,4,9,18,13920,13842,10654,-3188
2020,4,9,19,13790,13771,10645,-3126
2020,4,9,20,13770,13565,10553,-3012
2020,4,9,21,13830,13481,10521,-2960
2020,4,9,22,13890,13581,10462,-3119
2020,4,9,23,14070,13442,10181,-3261
2020,4,10,0,14160,13453,10138,-3315
2020,4,10,1,13850,13146,9782,-3364
2020,4,10,2,13020,12339,9051,-3288
2020,4,10,3,11960,11452,8113,-3339
2020,4,10,4,11000,10833,7476,-3357
2020,4,10,5,9990,10262,6707,-3555
2020,4,10,6,9630,10184,6582,-3602
2020,4,10,7,9450,10000,6585,-3415
2020,4,10,8,9450,10214,6662,-3552
2020,4,10,9,9770,10270,6834,-3436
2020,4,10,10,10170,10603,7236,-3367
2020,4,10,11,10580,10879,7357,-3522
2020,4,10,12,11020,11252,7806,-3446
2020,4,10,13,11490,11404,8018,-3386
2020,4,10,14,11000,11145,7941,-3204
2020,4,10,15,10700,11002,7958,-3044
2020,4,10,16,10590,11234,8321,-2913
2020,4,10,17,10670,11305,8674,-2631
2020,4,10,18,10780,11142,8610,-2532
2020,4,10,19,10970,11145,8393,-2752
2020,4,10,20,11200,11361,8490,-2871
2020,4,10,21,11460,11798,8771,-3027
2020,4,10,22,12260,12594,9281,-3313
2020,4,10,23,12820,13010,9730,-3280
2020,4,11,0,13080,13186,9908,-3278
2020,4,11,1,12880,12916,9676,-3240
2020,4,11,2,12190,12228,9108,-3120
2020,4,11,3,11370,11437,8341,-3096
2020,4,11,4,10560,10672,7630,-3042
2020,4,11,5,9990,10085,7479,-2606
2020,4,11,6,9640,9708,7265,-2443
2020,4,11,7,9470,9731,7027,-2704
2020,4,11,8,9450,9660,7054,-2606
2020,4,11,9,9580,9771,7309,-2462
2020,4,11,10,9860,9997,7553,-2444
2020,4,11,11,10220,10185,7868,-2317
2020,4,11,12,10500,10277,7623,-2654
2020,4,11,13,10590,10306,7352,-2954
2020,4,11,14,9960,10062,7402,-2660
2020,4,11,15,9470,10195,7308,-2887
2020,4,11,16,9150,10327,7481,-2846
2020,4,11,17,8960,10312,7369,-2943
2020,4,11,18,8900,10094,7090,-3004
2020,4,11,19,9000,9936,7070,-2866
2020,4,11,20,9360,9767,7116,-2651
2020,4,11,21,10050,10389,7451,-2938
2020,4,11,22,10930,11253,8233,-3020
2020,4,11,23,11600,12014,8933,-3081
2020,4,12,0,12180,12521,9318,-3203
2020,4,12,1,12220,12489,9416,-3073
2020,4,12,2,11910,11868,8739,-3129
2020,4,12,3,11230,11154,8338,-2816
2020,4,12,4,10500,10548,8006,-2542
2020,4,12,5,9930,10146,7737,-2409
2020,4,12,6,9570,10061,7542,-2519
2020,4,12,7,9400,9892,7582,-2310
2020,4,12,8,9320,9847,7615,-2232
2020,4,12,9,9460,9880,7622,-2258
2020,4,12,10,9740,9967,7444,-2523
2020,4,12,11,10040,10213,7489,-2724
2020,4,12,12,10230,9990,7037,-2953
2020,4,12,13,10230,9783,6963,-2820
2020,4,12,14,9530,9614,6933,-2681
2020,4,12,15,9450,9411,6810,-2601
2020,4,12,16,9680,9492,6955,-2537
2020,4,12,17,9670,9822,7463,-2359
2020,4,12,18,9650,9853,7502,-2351
2020,4,12,19,9400,9806,7326,-2480
2020,4,12,20,9450,10109,7556,-2553
2020,4,12,21,9870,10776,7989,-2787
2020,4,12,22,10430,11352,8520,-2832
2020,4,12,23,11150,11599,8420,-3179
2020,4,13,0,11970,11868,8736,-3132
2020,4,13,1,11930,11783,8751,-3032
2020,4,13,2,11280,11137,8284,-2853
2020,4,13,3,10310,10634,7548,-3086
2020,4,13,4,9480,9895,7292,-2603
2020,4,13,5,9090,9349,6968,-2381
2020,4,13,6,8740,9247,6740,-2507
2020,4,13,7,8560,9345,6737,-2608
2020,4,13,8,8530,9306,6895,-2411
2020,4,13,9,8740,9274,6986,-2288
2020,4,13,10,9370,9611,7184,-2427
2020,4,13,11,10310,10464,7895,-2569
2020,4,13,12,11270,11244,8506,-2738
2020,4,13,13,12170,12153,9245,-2908
2020,4,13,14,12670,12758,9835,-2923
2020,4,13,15,12980,13202,10375,-2827
2020,4,13,16,13270,13391,10618,-2773
2020,4,13,17,13280,13458,10636,-2822
2020,4,13,18,13110,13383,10603,-2780
2020,4,13,19,13050,13122,10425,-2697
2020,4,13,20,13030,12928,9983,-2945
2020,4,13,21,13090,13058,10106,-2952
2020,4,13,22,13670,13290,10574,-2716
2020,4,13,23,13730,13046,10001,-3045
2020,4,14,0,13700,12774,9712,-3062
2020,4,14,1,13060,12290,9338,-2952
2020,4,14,2,12080,11540,8492,-3048
2020,4,14,3,11060,10721,7362,-3359
2020,4,14,4,10180,9924,6590,-3334
2020,4,14,5,9340,9350,6100,-3250
2020,4,14,6,9000,9010,5865,-3145
2020,4,14,7,8830,8834,5648,-3186
2020,4,14,8,8820,8822,5561,-3261
2020,4,14,9,9060,9049,5909,-3140
2020,4,14,10,9710,9696,6638,-3058
2020,4,14,11,10550,10527,7245,-3282
2020,4,14,12,11050,11031,7716,-3315
2020,4,14,13,11010,11001,7643,-3358
2020,4,14,14,10710,10692,7341,-3351
2020,4,14,15,10430,10254,7352,-2902
2020,4,14,16,10210,10161,7371,-2790
2020,4,14,17,10080,10219,7392,-2827
2020,4,14,18,10030,10113,7229,-2884
2020,4,14,19,10100,10082,7161,-2921
2020,4,14,20,10670,10336,7335,-3001
2020,4,14,21,11480,10794,7913,-2881
2020,4,14,22,12480,11577,8509,-3068
2020,4,14,23,13040,12219,9282,-2937
2020,4,15,0,13060,12701,9489,-3212
2020,4,15,1,12670,12532,9425,-3107
2020,4,15,2,11870,11781,8645,-3136
2020,4,15,3,11000,10980,7511,-3469
2020,4,15,4,10140,10356,7408,-2948
2020,4,15,5,9530,9801,7106,-2695
2020,4,15,6,9190,9691,6902,-2789
2020,4,15,7,9020,9812,6881,-2931
2020,4,15,8,8990,9797,6881,-2916
2020,4,15,9,9220,9951,7164,-2787
2020,4,15,10,9860,10101,7491,-2610
2020,4,15,11,10780,10757,8328,-2429
2020,4,15,12,11610,11606,9000,-2606
2020,4,15,13,11990,12002,9269,-2733
2020,4,15,14,11690,11727,8959,-2768
2020,4,15,15,11190,11423,8657,-2766
2020,4,15,16,10710,11186,8440,-2746
2020,4,15,17,10450,10948,8266,-2682
2020,4,15,18,10270,10700,7968,-2732
2020,4,15,19,10230,10250,7693,-2557
2020,4,15,20,10610,10260,7677,-2583
2020,4,15,21,11220,10641,7938,-2703
2020,4,15,22,12010,11665,8846,-2819
2020,4,15,23,12620,12403,9748,-2655
2020,4,16,0,12990,12832,10185,-2647
2020,4,16,1,12940,12810,10518,-2292
2020,4,16,2,12320,12161,9871,-2290
2020,4,16,3,11440,11338,9163,-2175
2020,4,16,4,10600,10566,8604,-1962
2020,4,16,5,10020,10236,7907,-2329
2020,4,16,6,9680,10268,7759,-2509
2020,4,16,7,9510,10067,7460,-2607
2020,4,16,8,9510,10037,7425,-2612
2020,4,16,9,9760,10258,7277,-2981
2020,4,16,10,10430,10649,7685,-2964
2020,4,16,11,11370,11237,8462,-2775
2020,4,16,12,11950,11900,8932,-2968
2020,4,16,13,11850,11987,8998,-2989
2020,4,16,14,11540,11592,8861,-2731
2020,4,16,15,11490,11539,8792,-2747
2020,4,16,16,11330,11676,8990,-2686
2020,4,16,17,11340,12028,9389,-2639
2020,4,16,18,11020,11728,8869,-2859
2020,4,16,19,10980,11477,8452,-3025
2020,4,16,20,11130,11409,8420,-2989
2020,4,16,21,11450,11639,8678,-2961
2020,4,16,22,12240,12202,9210,-2992
2020,4,16,23,12910,12790,9751,-3039
2020,4,17,0,13370,13209,10173,-3036
2020,4,17,1,13180,13193,10177,-3016
2020,4,17,2,12460,12512,9468,-3044
2020,4,17,3,11530,11651,8708,-2943
2020,4,17,4,10680,11002,7981,-3021
2020,4,17,5,10330,10543,8092,-2451
2020,4,17,6,9910,10214,7851,-2363
2020,4,17,7,9800,10072,7632,-2440
2020,4,17,8,9830,10088,7577,-2511
2020,4,17,9,10190,10331,7888,-2443
2020,4,17,10,10980,10789,8482,-2307
2020,4,17,11,11990,11496,9072,-2424
2020,4,17,12,12450,11826,9463,-2363
2020,4,17,13,12000,11543,9108,-2435
2020,4,17,14,11340,11301,8683,-2618
2020,4,17,15,10970,11080,8513,-2567
2020,4,17,16,10700,10731,8154,-2577
2020,4,17,17,10540,10594,8148,-2446
2020,4,17,18,10510,10526,8096,-2430
2020,4,17,19,10770,10498,8125,-2373
2020,4,17,20,10800,10847,8454,-2393
2020,4,17,21,11420,11260,8865,-2395
2020,4,17,22,12240,12067,9482,-2585
2020,4,17,23,12630,12568,9736,-2832
2020,4,18,0,12870,12872,9790,-3082
2020,4,18,1,12810,12711,9809,-2902
2020,4,18,2,12140,12023,9113,-2910
2020,4,18,3,11330,11256,8666,-2590
2020,4,18,4,10520,10476,8018,-2458
2020,4,18,5,9910,9918,7798,-2120
2020,4,18,6,9570,9582,6758,-2824
2020,4,18,7,9420,9669,6835,-2834
2020,4,18,8,9390,9636,6848,-2788
2020,4,18,9,9510,9750,7061,-2689
2020,4,18,10,9810,10054,7252,-2802
2020,4,18,11,10250,10247,7399,-2848
2020,4,18,12,10850,10828,8255,-2573
2020,4,18,13,11560,11551,9193,-2358
2020,4,18,14,12060,12068,9553,-2515
2020,4,18,15,12330,12322,9738,-2584
2020,4,18,16,12570,12568,9891,-2677
2020,4,18,17,12650,12656,9847,-2809
2020,4,18,18,12540,12575,9767,-2808
2020,4,18,19,12450,12405,9396,-3009
2020,4,18,20,12330,12269,9306,-2963
2020,4,18,21,12440,12431,9506,-2925
2020,4,18,22,12630,12817,9953,-2864
2020,4,18,23,12720,12967,9951,-3016
2020,4,19,0,12760,13024,9956,-3068
2020,4,19,1,12700,12806,9767,-3039
2020,4,19,2,12120,12192,9073,-3119
2020,4,19,3,11430,11482,8539,-2943
2020,4,19,4,10720,10780,8019,-2761
2020,4,19,5,10210,10228,7922,-2306
2020,4,19,6,9860,9867,7573,-2294
2020,4,19,7,9660,9671,7394,-2277
2020,4,19,8,9610,9714,7316,-2398
2020,4,19,9,9700,10003,7481,-2522
2020,4,19,10,9940,9967,7571,-2396
2020,4,19,11,10140,10145,7489,-2656
2020,4,19,12,10070,10085,7360,-2725
2020,4,19,13,9800,9825,7320,-2505
2020,4,19,14,9400,9677,6948,-2729
2020,4,19,15,9060,9773,7194,-2579
2020,4,19,16,8840,9658,6938,-2720
2020,4,19,17,8630,9443,6838,-2605
2020,4,19,18,8370,9224,6662,-2562
2020,4,19,19,8510,9154,6508,-2646
2020,4,19,20,8970,9469,6973,-2496
2020,4,19,21,9880,10087,7602,-2485
2020,4,19,22,11120,10954,8380,-2574
2020,4,19,23,11940,11745,8700,-3045
2020,4,20,0,12470,12104,8981,-3123
2020,4,20,1,12270,11996,9117,-2879
2020,4,20,2,11430,11285,8287,-2998
2020,4,20,3,10590,10508,7552,-2956
2020,4,20,4,9810,9784,6915,-2869
2020,4,20,5,9180,9732,7060,-2672
2020,4,20,6,8880,9658,6748,-2910
2020,4,20,7,8710,9664,6844,-2820
2020,4,20,8,8740,9788,6927,-2861
2020,4,20,9,9050,10022,7410,-2612
2020,4,20,10,9670,10417,8296,-2121
2020,4,20,11,10460,10707,8034,-2673
2020,4,20,12,11090,10974,8362,-2612
2020,4,20,13,11360,11305,8477,-2828
2020,4,20,14,11300,11341,8680,-2661
2020,4,20,15,11030,11266,8502,-2764
2020,4,20,16,11050,11392,8825,-2567
2020,4,20,17,10950,11462,9042,-2420
2020,4,20,18,10860,11110,8694,-2416
2020,4,20,19,10970,10395,7906,-2489
2020,4,20,20,11160,10469,7907,-2562
2020,4,20,21,11750,10993,8470,-2523
2020,4,20,22,12490,11771,8929,-2842
2020,4,20,23,12990,12298,9300,-2998
2020,4,21,0,13370,12620,9544,-3076
2020,4,21,1,12990,12634,9620,-3014
2020,4,21,2,12080,11972,8983,-2989
2020,4,21,3,11150,11183,8101,-3082
2020,4,21,4,10380,10412,7388,-3024
2020,4,21,5,9890,9910,6723,-3187
2020,4,21,6,9570,9604,6651,-2953
2020,4,21,7,9430,9732,6853,-2879
2020,4,21,8,9440,9762,6912,-2850
2020,4,21,9,9730,10013,7140,-2873
2020,4,21,10,10380,10461,7570,-2891
2020,4,21,11,11180,11142,8423,-2719
2020,4,21,12,11630,11578,8743,-2835
2020,4,21,13,11580,11508,8530,-2978
2020,4,21,14,11420,11447,8491,-2956
2020,4,21,15,11590,11901,9114,-2787
2020,4,21,16,12540,12535,9842,-2693
2020,4,21,17,12890,12780,9700,-3080
2020,4,21,18,13010,12980,10044,-2936
2020,4,21,19,13120,12908,10213,-2695
2020,4,21,20,13210,13071,10066,-3005
2020,4,21,21,13420,13375,10285,-3090
2020,4,21,22,13690,13661,10495,-3166
2020,4,21,23,13660,13465,10245,-3220
2020,4,22,0,13710,13305,9953,-3352
2020,4,22,1,13400,13157,9713,-3444
2020,4,22,2,12550,12469,9098,-3371
2020,4,22,3,11710,11629,8410,-3219
2020,4,22,4,10820,10858,7872,-2986
2020,4,22,5,10280,10385,7494,-2891
2020,4,22,6,9960,10588,7430,-3158
2020,4,22,7,9810,10701,7523,-3178
2020,4,22,8,9830,10748,7552,-3196
2020,4,22,9,10110,10733,7624,-3109
2020,4,22,10,10780,11131,8229,-2902
2020,4,22,11,11640,12127,8875,-3252
2020,4,22,12,12060,12157,9018,-3139
2020,4,22,13,12000,12092,9014,-3078
2020,4,22,14,11960,11952,9196,-2756
2020,4,22,15,11640,11926,9270,-2656
2020,4,22,16,11480,11879,9276,-2603
2020,4,22,17,11380,11802,9163,-2639
2020,4,22,18,11220,11642,8894,-2748
2020,4,22,19,11260,11407,8427,-2980
2020,4,22,20,11340,11230,8234,-2996
2020,4,22,21,11500,11568,8558,-3010
2020,4,22,22,12360,12486,9339,-3147
2020,4,22,23,12880,13107,9831,-3276
2020,4,23,0,13370,13437,10203,-3234
2020,4,23,1,13290,13498,10280,-3218
2020,4,23,2,12640,12825,9620,-3205
2020,4,23,3,11600,11955,8809,-3146
2020,4,23,4,10890,11124,8021,-3103
2020,4,23,5,10550,10589,7333,-3256
2020,4,23,6,10220,10270,7196,-3074
2020,4,23,7,10070,10109,7328,-2781
2020,4,23,8,10100,10387,7455,-2932
2020,4,23,9,10380,10461,7673,-2788
2020,4,23,10,11060,11078,8002,-3076
2020,4,23,11,11910,11809,8775,-3034
2020,4,23,12,12210,12062,8951,-3111
2020,4,23,13,11890,11705,8710,-2995
2020,4,23,14,11160,11195,8564,-2631
2020,4,23,15,10620,11070,8706,-2364
2020,4,23,16,10290,10848,8705,-2143
2020,4,23,17,10140,10801,8632,-2169
2020,4,23,18,10240,10872,8744,-2128
2020,4,23,19,10360,10587,8451,-2136
2020,4,23,20,10800,10641,8030,-2611
2020,4,23,21,11360,11566,8655,-2911
2020,4,23,22,12170,12388,9399,-2989
2020,4,23,23,12700,12808,9655,-3153
2020,4,24,0,13230,13024,9816,-3208
2020,4,24,1,12960,12917,9799,-3118
2020,4,24,2,12270,12224,9061,-3163
2020,4,24,3,11360,11377,8036,-3341
2020,4,24,4,10590,10576,7597,-2979
2020,4,24,5,9970,10270,7152,-3118
2020,4,24,6,9600,10156,7097,-3059
2020,4,24,7,9410,9971,7105,-2866
2020,4,24,8,9400,9947,6904,-3043
2020,4,24,9,9620,10158,7147,-3011
2020,4,24,10,10160,10402,7184,-3218
2020,4,24,11,10980,10947,8069,-2878
2020,4,24,12,11790,11793,9136,-2657
2020,4,24,13,12430,12415,9853,-2562
2020,4,24,14,12650,12646,9834,-2812
2020,4,24,15,12810,12760,9841,-2919
2020,4,24,16,12790,12774,9967,-2807
2020,4,24,17,12690,12857,10195,-2662
2020,4,24,18,12630,12741,10085,-2656
2020,4,24,19,12600,12398,9594,-2804
2020,4,24,20,12530,12108,9087,-3021
2020,4,24,21,12480,12270,9144,-3126
2020,4,24,22,12660,12680,9650,-3030
2020,4,24,23,12850,12837,9800,-3037
2020,4,25,0,13100,12908,9834,-3074
2020,4,25,1,13050,12798,9754,-3044
2020,4,25,2,12500,12171,9025,-3146
2020,4,25,3,11620,11380,8318,-3062
2020,4,25,4,10730,10597,7684,-2913
2020,4,25,5,10000,10217,7134,-3083
2020,4,25,6,9650,9926,7131,-2795
2020,4,25,7,9440,9490,6745,-2745
2020,4,25,8,9410,9668,6800,-2868
2020,4,25,9,9520,9559,6753,-2806
2020,4,25,10,9790,9788,7010,-2778
2020,4,25,11,10070,10061,7224,-2837
2020,4,25,12,10210,10199,7144,-3055
2020,4,25,13,10230,10226,7335,-2891
2020,4,25,14,10020,9947,7282,-2665
2020,4,25,15,9380,9376,6775,-2601
2020,4,25,16,9060,9455,6745,-2710
2020,4,25,17,8930,9483,6596,-2887
2020,4,25,18,8820,9247,6576,-2671
2020,4,25,19,8870,9349,6551,-2798
2020,4,25,20,9220,9646,6969,-2677
2020,4,25,21,9900,9831,7254,-2577
2020,4,25,22,10910,10528,7852,-2676
2020,4,25,23,11580,11202,8519,-2683
2020,4,26,0,12100,11679,8834,-2845
2020,4,26,1,11840,11795,8907,-2888
2020,4,26,2,11340,11203,8254,-2949
2020,4,26,3,10670,10486,7640,-2846
2020,4,26,4,10050,10033,7266,-2767
2020,4,26,5,9260,9724,6805,-2919
2020,4,26,6,8890,9404,6588,-2816
2020,4,26,7,8720,9507,6542,-2965
2020,4,26,8,8690,9702,6386,-3316
2020,4,26,9,8740,9776,6487,-3289
2020,4,26,10,8940,9963,6642,-3321
2020,4,26,11,9150,10153,6960,-3193
2020,4,26,12,9500,10234,7006,-3228
2020,4,26,13,9970,10143,6916,-3227
2020,4,26,14,10550,10477,7387,-3090
2020,4,26,15,10770,10908,7940,-2968
2020,4,26,16,11030,11277,8247,-3030
2020,4,26,17,11250,11449,8457,-2992
2020,4,26,18,11350,11670,8608,-3062
2020,4,26,19,11390,11810,8874,-2936
2020,4,26,20,11520,11959,8957,-3002
2020,4,26,21,11970,12454,9446,-3008
2020,4,26,22,12640,13020,10034,-2986
2020,4,26,23,12910,13128,10249,-2879
2020,4,27,0,13030,13002,10039,-2963
2020,4,27,1,12770,12649,9742,-2907
2020,4,27,2,11940,11924,8849,-3075
2020,4,27,3,11070,11127,7828,-3299
2020,4,27,4,10280,10541,7458,-3083
2020,4,27,5,9830,10126,6861,-3265
2020,4,27,6,9490,9775,6646,-3129
2020,4,27,7,9320,9617,6570,-3047
2020,4,27,8,9330,9815,6781,-3034
2020,4,27,9,9570,10084,7017,-3067
2020,4,27,10,10210,10383,7580,-2803
2020,4,27,11,11170,11145,8272,-2873
2020,4,27,12,12140,12115,9272,-2843
2020,4,27,13,12940,12924,9704,-3220
2020,4,27,14,13320,13289,10021,-3268
2020,4,27,15,13590,13446,10248,-3198
2020,4,27,16,13700,13566,10392,-3174
2020,4,27,17,13660,13606,10358,-3248
2020,4,27,18,13590,13480,10120,-3360
2020,4,27,19,13550,13295,9965,-3330
2020,4,27,20,13540,13247,9823,-3424
2020,4,27,21,13620,13505,10060,-3445
2020,4,27,22,13900,13975,10517,-3458
2020,4,27,23,14080,13935,10502,-3433
2020,4,28,0,13990,13801,10337,-3464
2020,4,28,1,13720,13445,10012,-3433
2020,4,28,2,12800,12719,9332,-3387
2020,4,28,3,11780,11822,8435,-3387
2020,4,28,4,10870,10901,7602,-3299
2020,4,28,5,10250,10263,7360,-2903
2020,4,28,6,9870,9879,7300,-2579
2020,4,28,7,9670,9855,7365,-2490
2020,4,28,8,9650,9901,7226,-2675
2020,4,28,9,9870,9964,7056,-2908
2020,4,28,10,10470,10450,7623,-2827
2020,4,28,11,11300,11277,8353,-2924
2020,4,28,12,11920,11912,8877,-3035
2020,4,28,13,11950,11959,8568,-3391
2020,4,28,14,11560,11561,8307,-3254
2020,4,28,15,11380,11318,8521,-2797
2020,4,28,16,11150,11043,8045,-2998
2020,4,28,17,10970,10791,8163,-2628
2020,4,28,18,11040,10482,7889,-2593
2020,4,28,19,11180,10539,7900,-2639
2020,4,28,20,11410,10688,8043,-2645
2020,4,28,21,11890,11019,8128,-2891
2020,4,28,22,12680,11812,8519,-3293
2020,4,28,23,13150,12387,8988,-3399
2020,4,29,0,13350,12626,9308,-3318
2020,4,29,1,13200,12660,9482,-3178
2020,4,29,2,12450,12012,8763,-3249
2020,4,29,3,11470,11137,8192,-2945
2020,4,29,4,10660,10320,7365,-2955
2020,4,29,5,9750,9994,7025,-2969
2020,4,29,6,9440,9690,6727,-2963
2020,4,29,7,9260,9514,6902,-2612
2020,4,29,8,9290,9554,6570,-2984
2020,4,29,9,9560,9807,6932,-2875
2020,4,29,10,10220,10191,7180,-3011
2020,4,29,11,10950,10932,7941,-2991
2020,4,29,12,11240,11241,8115,-3126
2020,4,29,13,10920,10929,7864,-3065
2020,4,29,14,10430,10454,7579,-2875
2020,4,29,15,10080,10144,7489,-2655
2020,4,29,16,10010,10009,7469,-2540
2020,4,29,17,10070,10102,7684,-2418
2020,4,29,18,10220,10162,7690,-2472
2020,4,29,19,10470,10280,7559,-2721
2020,4,29,20,10830,10705,7844,-2861
2020,4,29,21,11530,11473,8478,-2995
2020,4,29,22,12280,12588,9378,-3210
2020,4,29,23,12730,12902,9646,-3256
2020,4,30,0,13000,12874,9609,-3265
2020,4,30,1,12790,12592,9428,-3164
2020,4,30,2,12240,11861,8686,-3175
2020,4,30,3,11310,10969,8153,-2816
2020,4,30,4,10400,10134,7525,-2609
2020,4,30,5,9660,9839,7210,-2629
2020,4,30,6,9310,9531,7009,-2522
2020,4,30,7,9140,9553,6788,-2765
2020,4,30,8,9120,9542,6800,-2742
2020,4,30,9,9400,9620,7141,-2479
2020,4,30,10,10260,9998,7532,-2466
2020,4,30,11,11470,10715,7870,-2845
2020,4,30,12,12330,11676,8686,-2990
2020,4,30,13,12860,12440,9465,-2975
2020,4,30,14,12980,12955,9840,-3115
2020,4,30,15,13070,13265,10082,-3183
2020,4,30,16,12910,13421,10149,-3272
2020,4,30,17,12840,13433,10145,-3288
2020,4,30,18,12780,13365,10009,-3356
2020,4,30,19,12650,12947,9555,-3392
2020,4,30,20,12530,12472,9223,-3249
2020,4,30,21,12760,12608,9359,-3249
2020,4,30,22,13100,13044,9967,-3077
2020,4,30,23,13280,13170,9971,-3199
2020,5,1,0,13420,13099,9913,-3186
2020,5,1,1,13230,12807,9766,-3041
2020,5,1,2,12210,12076,9054,-3022
2020,5,1,3,11100,11334,8262,-3072
2020,5,1,4,10100,10578,8126,-2452
2020,5,1,5,9430,10001,7207,-2794
2020,5,1,6,9020,9314,6982,-2332
2020,5,1,7,8820,9090,7012,-2078
2020,5,1,8,8770,9037,6925,-2112
2020,5,1,9,9070,9442,7196,-2246
2020,5,1,10,9660,9729,7182,-2547
2020,5,1,11,10550,10474,7851,-2623
2020,5,1,12,11410,11412,8938,-2474
2020,5,1,13,11850,12128,9759,-2369
2020,5,1,14,12250,12268,9718,-2550
2020,5,1,15,12210,12325,10066,-2259
2020,5,1,16,12110,12387,10331,-2056
2020,5,1,17,12050,12119,9985,-2134
2020,5,1,18,11870,11598,9453,-2145
2020,5,1,19,11720,11246,9128,-2118
2020,5,1,20,11670,11034,8704,-2330
2020,5,1,21,11650,11184,8538,-2646
2020,5,1,22,11810,11759,8978,-2781
2020,5,1,23,12050,12069,9126,-2943
2020,5,2,0,12140,12163,9211,-2952
2020,5,2,1,12320,12128,9224,-2904
2020,5,2,2,11790,11500,8657,-2843
2020,5,2,3,10950,10738,7912,-2826
2020,5,2,4,10020,9968,7465,-2503
2020,5,2,5,9310,9547,7176,-2371
2020,5,2,6,8920,9455,7066,-2389
2020,5,2,7,8650,8951,6828,-2123
2020,5,2,8,8580,8864,6623,-2241
2020,5,2,9,8650,8916,6622,-2294
2020,5,2,10,8880,9153,6827,-2326
2020,5,2,11,9140,9409,6884,-2525
2020,5,2,12,9110,9266,7122,-2144
2020,5,2,13,8870,9134,7412,-1722
2020,5,2,14,8570,9113,6976,-2137
2020,5,2,15,8310,8932,6964,-1968
2020,5,2,16,7970,8855,7288,-1567
2020,5,2,17,7770,8756,7449,-1307
2020,5,2,18,7510,8582,7226,-1356
2020,5,2,19,7400,8514,6944,-1570
2020,5,2,20,7970,8683,7113,-1570
2020,5,2,21,8930,9506,7665,-1841
2020,5,2,22,10030,10452,8362,-2090
2020,5,2,23,11140,11111,9068,-2043
2020,5,3,0,11790,11387,9097,-2290
2020,5,3,1,11170,11568,9292,-2276
2020,5,3,2,10920,11008,8390,-2618
2020,5,3,3,10300,10287,7687,-2600
2020,5,3,4,9490,9548,6749,-2799
2020,5,3,5,8760,9061,6152,-2909
2020,5,3,6,8530,8805,6348,-2457
2020,5,3,7,8330,8584,6292,-2292
2020,5,3,8,8290,8494,6042,-2452
2020,5,3,9,8280,9001,6358,-2643
2020,5,3,10,8440,8805,6418,-2387
2020,5,3,11,8720,8957,6191,-2766
2020,5,3,12,8820,9156,6649,-2507
2020,5,3,13,9450,9308,7055,-2253
2020,5,3,14,8760,9285,6855,-2430
2020,5,3,15,8660,9034,6665,-2369
2020,5,3,16,8470,9007,6634,-2373
2020,5,3,17,8300,9060,6712,-2348
2020,5,3,18,8210,9265,6967,-2298
2020,5,3,19,8150,9213,7063,-2150
2020,5,3,20,8340,9226,7169,-2057
2020,5,3,21,9180,9503,7230,-2273
2020,5,3,22,10170,10615,7996,-2619
2020,5,3,23,10990,11440,8946,-2494
2020,5,4,0,12090,11740,9098,-2642
2020,5,4,1,11810,11957,9238,-2719
2020,5,4,2,11190,11340,8550,-2790
2020,5,4,3,10200,10445,7658,-2787
2020,5,4,4,9420,9599,6933,-2666
2020,5,4,5,8950,9146,6474,-2672
2020,5,4,6,8590,9124,6480,-2644
2020,5,4,7,8360,8917,6508,-2409
2020,5,4,8,8320,8634,6735,-1899
2020,5,4,9,8480,8976,6944,-2032
2020,5,4,10,9000,9344,7015,-2329
2020,5,4,11,9750,9943,7548,-2395
2020,5,4,12,10270,10561,8061,-2500
2020,5,4,13,10310,10595,8194,-2401
2020,5,4,14,10080,10369,8189,-2180
2020,5,4,15,9940,9999,8037,-1962
2020,5,4,16,10210,10227,8347,-1880
2020,5,4,17,10900,10880,8991,-1889
2020,5,4,18,10860,11304,9118,-2186
2020,5,4,19,11150,11233,8816,-2417
2020,5,4,20,11310,11257,8708,-2549
2020,5,4,21,11410,11509,8886,-2623
2020,5,4,22,11930,12076,9251,-2825
2020,5,4,23,12300,12259,9726,-2533
2020,5,5,0,12490,12197,9965,-2232
2020,5,5,1,12360,12129,9594,-2535
2020,5,5,2,11720,11430,9107,-2323
2020,5,5,3,10660,10529,8288,-2241
2020,5,5,4,9790,9762,7720,-2042
2020,5,5,5,9110,9415,7215,-2200
2020,5,5,6,8780,9081,6920,-2161
2020,5,5,7,8590,8883,6924,-1959
2020,5,5,8,8600,9107,7043,-2064
2020,5,5,9,8810,9291,7157,-2134
2020,5,5,10,9370,9639,7614,-2025
2020,5,5,11,10140,10112,8115,-1997
2020,5,5,12,10570,10571,8719,-1852
2020,5,5,13,10450,10455,8511,-1944
2020,5,5,14,10000,10013,8262,-1751
2020,5,5,15,9790,9722,7933,-1789
2020,5,5,16,9660,9665,7922,-1743
2020,5,5,17,9630,9632,8014,-1618
2020,5,5,18,9570,9554,7974,-1580
2020,5,5,19,9450,9445,8054,-1391
2020,5,5,20,9540,9529,7987,-1542
2020,5,5,21,10160,10139,8456,-1683
2020,5,5,22,11180,11153,8838,-2315
2020,5,5,23,11940,11849,9382,-2467
2020,5,6,0,12330,12066,9485,-2581
2020,5,6,1,12270,12202,9671,-2531
2020,5,6,2,11640,11578,9298,-2280
2020,5,6,3,10710,10706,8425,-2281
2020,5,6,4,9800,9888,7698,-2190
2020,5,6,5,9360,9335,6715,-2620
2020,5,6,6,9040,9002,6746,-2256
2020,5,6,7,8860,9122,6722,-2400
2020,5,6,8,8880,9179,6646,-2533
2020,5,6,9,9130,9427,6986,-2441
2020,5,6,10,9750,9715,7181,-2534
2020,5,6,11,10560,10420,7992,-2428
2020,5,6,12,11130,10793,8321,-2472
2020,5,6,13,11120,10804,8473,-2331
2020,5,6,14,10740,10661,8276,-2385
2020,5,6,15,10520,10685,8451,-2234
2020,5,6,16,10520,10677,8606,-2071
2020,5,6,17,10490,10412,8378,-2034
2020,5,6,18,10550,10515,8544,-1971
2020,5,6,19,10680,10573,8532,-2041
2020,5,6,20,10930,10820,8601,-2219
2020,5,6,21,11520,11560,8822,-2738
2020,5,6,22,12250,12387,9525,-2862
2020,5,6,23,12630,12629,9676,-2953
2020,5,7,0,12800,12593,9663,-2930
2020,5,7,1,12720,12384,9565,-2819
2020,5,7,2,11960,11697,8921,-2776
2020,5,7,3,11000,10805,8327,-2478
2020,5,7,4,10090,9991,7781,-2210
2020,5,7,5,9410,9421,6911,-2510
2020,5,7,6,9080,9515,6810,-2705
2020,5,7,7,8890,9451,6681,-2770
2020,5,7,8,8890,9418,6700,-2718
2020,5,7,9,9150,9630,7048,-2582
2020,5,7,10,9710,9993,7415,-2578
2020,5,7,11,10410,10386,7990,-2396
2020,5,7,12,10790,10800,8426,-2374
2020,5,7,13,10540,10546,8346,-2200
2020,5,7,14,10020,10190,7857,-2333
2020,5,7,15,9640,10232,7978,-2254
2020,5,7,16,9450,10290,8275,-2015
2020,5,7,17,9440,10408,8374,-2034
2020,5,7,18,9510,10294,7992,-2302
2020,5,7,19,9470,10240,7786,-2454
2020,5,7,20,9690,10344,7881,-2463
2020,5,7,21,10290,10388,7988,-2400
2020,5,7,22,11200,11160,8671,-2489
2020,5,7,23,12020,11764,9188,-2576
2020,5,8,0,12410,11990,9380,-2610
2020,5,8,1,12490,12108,9557,-2551
2020,5,8,2,11860,11512,8919,-2593
2020,5,8,3,10860,10722,8214,-2508
2020,5,8,4,9940,10052,7614,-2438
2020,5,8,5,9190,9682,7277,-2405
2020,5,8,6,8860,9790,7017,-2773
2020,5,8,7,8650,9705,7184,-2521
2020,5,8,8,8650,9694,7075,-2619
2020,5,8,9,8850,9892,7205,-2687
2020,5,8,10,9380,10312,7516,-2796
2020,5,8,11,10060,10454,7873,-2581
2020,5,8,12,10440,10537,8077,-2460
2020,5,8,13,10390,10635,8482,-2153
2020,5,8,14,10310,10541,8359,-2182
2020,5,8,15,10200,10502,8382,-2120
2020,5,8,16,10230,10386,7872,-2514
2020,5,8,17,10320,10359,8136,-2223
2020,5,8,18,10420,10770,8875,-1895
2020,5,8,19,10610,11220,9247,-1973
2020,5,8,20,10860,11448,8705,-2743
2020,5,8,21,11300,11711,8652,-3059
2020,5,8,22,11900,12249,9284,-2965
2020,5,8,23,12240,12483,9429,-3054
2020,5,9,0,12350,12504,9346,-3158
2020,5,9,1,12160,12285,9200,-3085
2020,5,9,2,11640,11650,8706,-2944
2020,5,9,3,10900,10854,7766,-3088
2020,5,9,4,10050,10055,7424,-2631
2020,5,9,5,9520,9730,7042,-2688
2020,5,9,6,9170,9478,6886,-2592
2020,5,9,7,9010,9296,6919,-2377
2020,5,9,8,8980,9259,6971,-2288
2020,5,9,9,9070,9365,7246,-2119
2020,5,9,10,9390,9418,7249,-2169
2020,5,9,11,9780,9772,7541,-2231
2020,5,9,12,10250,10238,8373,-1865
2020,5,9,13,10710,10704,8398,-2306
2020,5,9,14,10800,10777,8408,-2369
2020,5,9,15,10750,10541,8087,-2454
2020,5,9,16,10740,10622,8190,-2432
2020,5,9,17,10660,10652,8446,-2206
2020,5,9,18,10730,10595,8426,-2169
2020,5,9,19,10720,10492,8193,-2299
2020,5,9,20,10880,10328,7864,-2464
2020,5,9,21,11260,10664,8299,-2365
2020,5,9,22,11680,11476,8798,-2678
2020,5,9,23,12100,12175,9228,-2947
2020,5,10,0,12370,12497,9568,-2929
2020,5,10,1,12500,12700,9682,-3018
2020,5,10,2,11930,12180,9376,-2804
2020,5,10,3,11130,11459,8648,-2811
2020,5,10,4,10350,10692,8161,-2531
2020,5,10,5,10130,10309,7711,-2598
2020,5,10,6,9730,9995,7888,-2107
2020,5,10,7,9510,9763,7727,-2036
2020,5,10,8,9440,9695,7573,-2122
2020,5,10,9,9490,9740,7457,-2283
2020,5,10,10,9640,9882,7477,-2405
2020,5,10,11,9770,10034,7801,-2233
2020,5,10,12,9830,10082,7791,-2291
2020,5,10,13,9710,10261,7751,-2510
2020,5,10,14,9510,10348,7708,-2640
2020,5,10,15,9390,10282,7613,-2669
2020,5,10,16,9180,10199,7678,-2521
2020,5,10,17,9090,10258,7612,-2646
2020,5,10,18,9080,9945,7108,-2837
2020,5,10,19,9060,9491,7183,-2308
2020,5,10,20,9290,9498,7560,-1938
2020,5,10,21,10050,9917,7543,-2374
2020,5,10,22,11100,10534,7796,-2738
2020,5,10,23,11750,11164,8325,-2839
2020,5,11,0,12050,11474,8706,-2768
2020,5,11,1,12150,11692,8623,-3069
2020,5,11,2,11350,11208,8131,-3077
2020,5,11,3,10520,10479,7598,-2881
2020,5,11,4,9800,10001,7096,-2905
2020,5,11,5,9170,9251,6512,-2739
2020,5,11,6,8860,9130,6555,-2575
2020,5,11,7,8730,8989,6364,-2625
2020,5,11,8,8780,9037,6684,-2353
2020,5,11,9,9060,9300,6591,-2709
2020,5,11,10,9650,9648,6806,-2842
2020,5,11,11,10390,10352,7924,-2428
2020,5,11,12,10740,10721,7921,-2800
2020,5,11,13,10680,10672,8222,-2450
2020,5,11,14,10500,10480,7901,-2579
2020,5,11,15,10840,10837,8299,-2538
2020,5,11,16,11430,11433,8698,-2735
2020,5,11,17,11750,12067,9100,-2967
2020,5,11,18,11780,12087,8770,-3317
2020,5,11,19,11730,11717,8315,-3402
2020,5,11,20,11760,11491,8191,-3300
2020,5,11,21,12020,11775,8545,-3230
2020,5,11,22,12330,12478,9046,-3432
2020,5,11,23,12690,12669,9257,-3412
2020,5,12,0,12830,12558,9353,-3205
2020,5,12,1,12900,12370,9077,-3293
2020,5,12,2,11920,11723,8410,-3313
2020,5,12,3,10970,10850,7900,-2950
2020,5,12,4,10070,10188,7405,-2783
2020,5,12,5,9490,9921,6926,-2995
2020,5,12,6,9140,9692,7060,-2632
2020,5,12,7,8990,9306,6593,-2713
2020,5,12,8,9020,9268,6365,-2903
2020,5,12,9,9270,9508,6629,-2879
2020,5,12,10,9850,10061,7538,-2523
2020,5,12,11,10620,10603,7819,-2784
2020,5,12,12,10980,10975,8001,-2974
2020,5,12,13,10890,10898,8070,-2828
2020,5,12,14,10670,10666,7849,-2817
2020,5,12,15,10680,10677,7825,-2852
2020,5,12,16,10570,10973,7804,-3169
2020,5,12,17,10490,10572,7680,-2892
2020,5,12,18,10380,10263,7312,-2951
2020,5,12,19,10390,10052,7612,-2440
2020,5,12,20,10520,10178,7506,-2672
2020,5,12,21,10880,10538,7951,-2587
2020,5,12,22,11900,11472,8693,-2779
2020,5,12,23,12510,12116,8978,-3138
2020,5,13,0,12630,12354,8968,-3386
2020,5,13,1,12620,12500,9106,-3394
2020,5,13,2,11970,11909,8785,-3124
2020,5,13,3,11030,11044,7720,-3324
2020,5,13,4,10190,10475,7572,-2903
2020,5,13,5,9670,9923,7032,-2891
2020,5,13,6,9350,9633,6930,-2703
2020,5,13,7,9240,9520,6732,-2788
2020,5,13,8,9290,9573,6732,-2841
2020,5,13,9,9570,9832,7048,-2784
2020,5,13,10,10150,10320,7568,-2752
2020,5,13,11,10900,10893,7822,-3071
2020,5,13,12,11170,11173,8299,-2874
2020,5,13,13,10950,10917,8155,-2762
2020,5,13,14,10300,10405,7810,-2595
2020,5,13,15,9950,10088,7714,-2374
2020,5,13,16,9720,9959,7660,-2299
2020,5,13,17,9640,9867,7684,-2183
2020,5,13,18,9620,9713,7593,-2120
2020,5,13,19,9620,9758,7304,-2454
2020,5,13,20,9820,9866,7551,-2315
2020,5,13,21,10500,10434,7938,-2496
2020,5,13,22,11610,11279,8402,-2877
2020,5,13,23,12270,11987,8786,-3201
2020,5,14,0,12390,12238,8743,-3495
2020,5,14,1,12350,12370,8739,-3631
2020,5,14,2,11690,11810,8434,-3376
2020,5,14,3,10800,10919,7901,-3018
2020,5,14,4,9950,10210,7373,-2837
2020,5,14,5,9550,9815,6772,-3043
2020,5,14,6,9200,9467,6621,-2846
2020,5,14,7,9070,9419,6460,-2959
2020,5,14,8,9090,9617,6536,-3081
2020,5,14,9,9370,9650,6645,-3005
2020,5,14,10,10000,10170,7061,-3109
2020,5,14,11,10700,10826,7425,-3401
2020,5,14,12,10910,10889,7693,-3196
2020,5,14,13,10700,10660,7832,-2828
2020,5,14,14,10270,10216,7670,-2546
2020,5,14,15,9990,9899,7616,-2283
2020,5,14,16,9850,9732,7624,-2108
2020,5,14,17,9940,9659,6930,-2729
2020,5,14,18,10000,9547,7027,-2520
2020,5,14,19,10030,9597,7103,-2494
2020,5,14,20,10240,9875,7466,-2409
2020,5,14,21,10810,10233,7647,-2586
2020,5,14,22,11600,11218,8431,-2787
2020,5,14,23,12170,11895,8743,-3152
2020,5,15,0,12220,12085,8860,-3225
2020,5,15,1,12200,12194,9090,-3104
2020,5,15,2,11520,11591,8503,-3088
2020,5,15,3,10590,10660,7582,-3078
2020,5,15,4,9720,9785,6997,-2788
2020,5,15,5,9160,9179,6411,-2768
2020,5,15,6,8770,9029,6489,-2540
2020,5,15,7,8570,8873,6313,-2560
2020,5,15,8,8540,8835,6200,-2635
2020,5,15,9,8680,8967,6255,-2712
2020,5,15,10,9150,9181,6642,-2539
2020,5,15,11,9910,9886,6986,-2900
2020,5,15,12,10690,10663,7685,-2978
2020,5,15,13,11130,11132,8269,-2863
2020,5,15,14,10960,10969,7864,-3105
2020,5,15,15,10610,10850,7730,-3120
2020,5,15,16,10440,10695,7802,-2893
2020,5,15,17,10530,10773,8367,-2406
2020,5,15,18,10760,10822,8537,-2285
2020,5,15,19,10870,10865,8552,-2313
2020,5,15,20,11250,11236,8816,-2420
2020,5,15,21,11770,11759,9142,-2617
2020,5,15,22,12470,12455,9250,-3205
2020,5,15,23,12700,12709,9461,-3248
2020,5,16,0,12640,12674,9692,-2982
2020,5,16,1,12520,12591,9676,-2915
2020,5,16,2,11770,11997,8779,-3218
2020,5,16,3,10900,11185,8305,-2880
2020,5,16,4,10250,10347,7992,-2355
2020,5,16,5,9640,9713,7279,-2434
2020,5,16,6,9210,9514,7030,-2484
2020,5,16,7,8900,9212,6696,-2516
2020,5,16,8,8760,9068,6471,-2597
2020,5,16,9,8750,9287,6888,-2399
2020,5,16,10,8800,9398,6944,-2454
2020,5,16,11,8900,9548,6755,-2793
2020,5,16,12,9140,9227,6808,-2419
2020,5,16,13,9360,9399,7121,-2278
2020,5,16,14,9630,9587,7439,-2148
2020,5,16,15,9420,9585,7479,-2106
2020,5,16,16,9210,9965,7489,-2476
2020,5,16,17,9500,9839,7736,-2103
2020,5,16,18,9500,9428,7485,-1943
2020,5,16,19,9540,9492,7296,-2196
2020,5,16,20,9800,9562,7266,-2296
2020,5,16,21,10270,10049,7574,-2475
2020,5,16,22,10750,10845,8137,-2708
2020,5,16,23,11290,11471,8638,-2833
2020,5,17,0,11400,11638,8864,-2774
2020,5,17,1,11460,11725,8795,-2930
2020,5,17,2,10980,11251,8470,-2781
2020,5,17,3,10190,10470,7997,-2473
2020,5,17,4,9490,9840,7599,-2241
2020,5,17,5,9060,9327,6966,-2361
2020,5,17,6,8640,8909,6730,-2179
2020,5,17,7,8390,8651,6658,-1993
2020,5,17,8,8360,8600,6402,-2198
2020,5,17,9,8370,8840,6368,-2472
2020,5,17,10,8360,8886,6389,-2497
2020,5,17,11,8510,9010,6539,-2471
2020,5,17,12,8720,9242,6877,-2365
2020,5,17,13,9020,9441,7497,-1944
2020,5,17,14,9250,9545,7386,-2159
2020,5,17,15,9340,9493,7306,-2187
2020,5,17,16,9500,9465,7253,-2212
2020,5,17,17,9600,9170,7057,-2113
2020,5,17,18,9650,9146,7040,-2106
2020,5,17,19,9670,9231,7183,-2048
2020,5,17,20,9880,9564,7332,-2232
2020,5,17,21,10360,10147,7670,-2477
2020,5,17,22,11130,11018,8203,-2815
2020,5,17,23,11680,11512,8621,-2891
2020,5,18,0,11850,11664,8801,-2863
2020,5,18,1,11730,11789,9078,-2711
2020,5,18,2,11190,11216,8440,-2776
2020,5,18,3,10370,10367,7224,-3143
2020,5,18,4,9420,9881,7032,-2849
2020,5,18,5,8920,9471,6484,-2987
2020,5,18,6,8540,9078,6036,-3042
2020,5,18,7,8350,8888,5964,-2924
2020,5,18,8,8310,9060,5973,-3087
2020,5,18,9,8500,9127,6422,-2705
2020,5,18,10,9030,9278,6799,-2479
2020,5,18,11,9880,10079,7471,-2608
2020,5,18,12,10810,10834,8611,-2223
2020,5,18,13,11480,11468,9200,-2268
2020,5,18,14,11740,11748,9480,-2268
2020,5,18,15,11600,11788,9309,-2479
2020,5,18,16,11620,11683,9107,-2576
2020,5,18,17,11540,11609,9010,-2599
2020,5,18,18,11560,11508,9024,-2484
2020,5,18,19,11480,11345,8855,-2490
2020,5,18,20,11450,11193,8648,-2545
2020,5,18,21,11650,11301,8738,-2563
2020,5,18,22,12370,11826,9158,-2668
2020,5,18,23,12670,12145,9532,-2613
2020,5,19,0,12680,12185,9585,-2600
2020,5,19,1,12440,12272,9587,-2685
2020,5,19,2,11850,11686,9156,-2530
2020,5,19,3,10850,10757,8188,-2569
2020,5,19,4,9830,9871,7717,-2154
2020,5,19,5,9220,9557,6980,-2577
2020,5,19,6,8840,9394,6817,-2577
2020,5,19,7,8620,9170,6595,-2575
2020,5,19,8,8550,9098,6788,-2310
2020,5,19,9,8770,9294,6845,-2449
2020,5,19,10,9210,9735,7401,-2334
2020,5,19,11,9920,10189,7877,-2312
2020,5,19,12,10340,10361,7861,-2500
2020,5,19,13,10280,10262,7892,-2370
2020,5,19,14,9920,9937,7658,-2279
2020,5,19,15,9910,9727,7517,-2210
2020,5,19,16,9830,9684,7452,-2232
2020,5,19,17,9890,9718,7408,-2310
2020,5,19,18,9810,9694,7425,-2269
2020,5,19,19,9770,9825,7317,-2508
2020,5,19,20,9810,9899,7324,-2575
2020,5,19,21,10350,10348,7662,-2686
2020,5,19,22,11320,11349,8456,-2893
2020,5,19,23,11980,11974,9136,-2838
2020,5,20,0,12330,12091,9223,-2868
2020,5,20,1,12410,12192,9282,-2910
2020,5,20,2,11700,11615,8708,-2907
2020,5,20,3,10740,10696,7775,-2921
2020,5,20,4,9850,9788,7112,-2676
2020,5,20,5,9180,9188,6504,-2684
2020,5,20,6,8800,8981,6310,-2671
2020,5,20,7,8620,8878,6425,-2453
2020,5,20,8,8600,8864,6271,-2593
2020,5,20,9,8820,9072,6527,-2545
2020,5,20,10,9290,9454,6928,-2526
2020,5,20,11,10000,9979,7432,-2547
2020,5,20,12,10410,10411,7841,-2570
2020,5,20,13,10360,10408,7947,-2461
2020,5,20,14,10040,10298,8042,-2256
2020,5,20,15,9710,10083,7812,-2271
2020,5,20,16,9570,10028,8089,-1939
2020,5,20,17,9500,10029,8355,-1674
2020,5,20,18,9440,10003,8386,-1617
2020,5,20,19,9430,9952,8312,-1640
2020,5,20,20,9590,10126,8241,-1885
2020,5,20,21,10320,10588,8652,-1936
2020,5,20,22,11290,11398,9169,-2229
2020,5,20,23,11980,12081,9622,-2459
2020,5,21,0,12220,12216,9760,-2456
2020,5,21,1,12270,12249,9772,-2477
2020,5,21,2,11670,11734,9102,-2632
2020,5,21,3,10680,10788,8130,-2658
2020,5,21,4,9780,9870,7497,-2373
2020,5,21,5,9240,9457,6787,-2670
2020,5,21,6,8890,9422,6648,-2774
2020,5,21,7,8730,9513,6818,-2695
2020,5,21,8,8700,9488,6841,-2647
2020,5,21,9,8920,9460,6869,-2591
2020,5,21,10,9410,9723,7183,-2540
2020,5,21,11,10130,10166,7714,-2452
2020,5,21,12,10500,10504,8003,-2501
2020,5,21,13,10460,10478,8030,-2448
2020,5,21,14,10170,10177,7839,-2338
2020,5,21,15,9990,10224,7959,-2265
2020,5,21,16,9990,10245,8101,-2144
2020,5,21,17,10020,10623,8275,-2348
2020,5,21,18,10040,10910,8142,-2768
2020,5,21,19,10060,10749,8073,-2676
2020,5,21,20,10290,10542,8141,-2401
2020,5,21,21,10840,10876,8150,-2726
2020,5,21,22,11580,11787,8862,-2925
2020,5,21,23,12150,12391,9458,-2933
2020,5,22,0,12180,12449,9475,-2974
2020,5,22,1,12230,12473,9477,-2996
2020,5,22,2,11660,11984,9048,-2936
2020,5,22,3,10690,11016,8126,-2890
2020,5,22,4,9790,10300,7449,-2851
2020,5,22,5,9180,9882,7228,-2654
2020,5,22,6,8780,9569,6945,-2624
2020,5,22,7,8590,9541,6934,-2607
2020,5,22,8,8600,9453,6805,-2648
2020,5,22,9,8740,9331,6738,-2593
2020,5,22,10,9170,9697,7148,-2549
2020,5,22,11,10170,10374,7914,-2460
2020,5,22,12,10480,10893,8357,-2536
2020,5,22,13,10780,10822,8438,-2384
2020,5,22,14,10460,10937,8486,-2451
2020,5,22,15,10270,10724,8471,-2253
2020,5,22,16,10330,10905,8684,-2221
2020,5,22,17,10390,10972,8968,-2004
2020,5,22,18,10480,10807,9020,-1787
2020,5,22,19,10790,11128,9116,-2012
2020,5,22,20,11140,11212,8964,-2248
2020,5,22,21,11810,11902,9783,-2119
2020,5,22,22,12450,12756,10453,-2303
2020,5,22,23,12890,13201,10607,-2594
2020,5,23,0,12870,13186,10652,-2534
2020,5,23,1,12780,13156,10691,-2465
2020,5,23,2,12150,12727,10193,-2534
2020,5,23,3,11300,11812,9174,-2638
2020,5,23,4,10390,10868,8493,-2375
2020,5,23,5,10090,10110,7895,-2215
2020,5,23,6,9580,9593,7476,-2117
2020,5,23,7,9280,9291,7167,-2124
2020,5,23,8,9110,9392,7240,-2152
2020,5,23,9,9100,9401,7203,-2198
2020,5,23,10,9160,9456,7037,-2419
2020,5,23,11,9430,9928,7426,-2502
2020,5,23,12,9880,10182,7782,-2400
2020,5,23,13,10270,10288,8034,-2254
2020,5,23,14,10430,10495,8282,-2213
2020,5,23,15,10650,10539,8345,-2194
2020,5,23,16,10730,10660,8450,-2210
2020,5,23,17,10700,10783,8535,-2248
2020,5,23,18,10590,10702,8524,-2178
2020,5,23,19,10520,10397,8560,-1837
2020,5,23,20,10500,10472,8406,-2066
2020,5,23,21,10590,10741,8862,-1879
2020,5,23,22,11320,11205,9026,-2179
2020,5,23,23,11700,11442,9319,-2123
2020,5,24,0,11850,11502,9364,-2138
2020,5,24,1,11830,11539,9410,-2129
2020,5,24,2,11380,11128,8899,-2229
2020,5,24,3,10480,10418,8316,-2102
2020,5,24,4,9650,10111,7954,-2157
2020,5,24,5,9000,9531,7470,-2061
2020,5,24,6,8590,9122,7087,-2035
2020,5,24,7,8360,9157,6933,-2224
2020,5,24,8,8250,9044,6769,-2275
2020,5,24,9,8260,9066,6802,-2264
2020,5,24,10,8300,9093,6764,-2329
2020,5,24,11,8440,9150,6832,-2318
2020,5,24,12,8530,9067,6825,-2242
2020,5,24,13,8520,8850,6928,-1922
2020,5,24,14,8460,8717,7002,-1715
2020,5,24,15,8380,8774,6947,-1827
2020,5,24,16,8360,8871,6998,-1873
2020,5,24,17,8360,8592,7029,-1563
2020,5,24,18,8410,8503,6904,-1599
2020,5,24,19,8380,8543,7242,-1301
2020,5,24,20,8780,8867,7473,-1394
2020,5,24,21,9510,9567,8013,-1554
2020,5,24,22,10560,10514,8790,-1724
2020,5,24,23,11350,11055,9131,-1924
2020,5,25,0,11670,11252,9311,-1941
2020,5,25,1,11740,11419,9220,-2199
2020,5,25,2,11160,11081,8845,-2236
2020,5,25,3,10210,10341,8125,-2216
2020,5,25,4,9470,9708,7182,-2526
2020,5,25,5,8970,9227,6838,-2389
2020,5,25,6,8560,8831,6713,-2118
2020,5,25,7,8310,8615,6427,-2188
2020,5,25,8,8230,8514,6306,-2208
2020,5,25,9,8300,8599,6638,-1961
2020,5,25,10,8420,8747,6697,-2050
2020,5,25,11,8680,9033,6816,-2217
2020,5,25,12,9070,9329,7272,-2057
2020,5,25,13,9610,9678,7779,-1899
2020,5,25,14,10110,10201,7893,-2308
2020,5,25,15,10370,10527,8327,-2200
2020,5,25,16,10710,10638,8304,-2334
2020,5,25,17,10790,10704,8383,-2321
2020,5,25,18,10700,10458,8117,-2341
2020,5,25,19,10530,10171,8043,-2128
2020,5,25,20,10760,10231,8090,-2141
2020,5,25,21,11110,10724,8756,-1968
2020,5,25,22,11600,11451,9683,-1768
2020,5,25,23,12010,11886,10011,-1875
2020,5,26,0,12120,11995,9992,-2003
2020,5,26,1,12220,12083,9965,-2118
2020,5,26,2,11470,11612,9436,-2176
2020,5,26,3,10330,10696,8615,-2081
2020,5,26,4,9690,9819,7531,-2288
2020,5,26,5,9200,9229,6407,-2822
2020,5,26,6,8790,8804,6438,-2366
2020,5,26,7,8590,8788,6670,-2118
2020,5,26,8,8530,8800,6785,-2015
2020,5,26,9,8770,9232,6832,-2400
2020,5,26,10,9360,9505,7147,-2358
2020,5,26,11,10260,10301,7939,-2362
2020,5,26,12,10890,11139,8837,-2302
2020,5,26,13,11290,11644,9493,-2151
2020,5,26,14,11260,11447,9081,-2366
2020,5,26,15,11240,11247,9212,-2035
2020,5,26,16,11370,11363,9591,-1772
2020,5,26,17,11570,11656,9926,-1730
2020,5,26,18,11810,12058,10518,-1540
2020,5,26,19,11930,12591,10866,-1725
2020,5,26,20,12110,13012,11121,-1891
2020,5,26,21,12740,13411,11483,-1928
2020,5,26,22,13510,14243,12151,-2092
2020,5,26,23,13990,14677,12141,-2536
2020,5,27,0,14140,14572,11909,-2663
2020,5,27,1,13950,14385,11561,-2824
2020,5,27,2,13050,13843,11038,-2805
2020,5,27,3,11910,12699,9802,-2897
2020,5,27,4,10850,11562,9096,-2466
2020,5,27,5,10630,10942,8191,-2751
2020,5,27,6,10070,10551,7855,-2696
2020,5,27,7,9730,10290,7605,-2685
2020,5,27,8,9570,10116,7428,-2688
2020,5,27,9,9700,10443,7768,-2675
2020,5,27,10,10370,10501,7895,-2606
2020,5,27,11,11240,11272,8739,-2533
2020,5,27,12,12150,12125,9247,-2878
2020,5,27,13,12320,12437,9793,-2644
2020,5,27,14,12200,12439,10078,-2361
2020,5,27,15,12590,12580,10514,-2066
2020,5,27,16,12960,12884,10873,-2011
2020,5,27,17,13490,13194,10976,-2218
2020,5,27,18,13850,13660,11414,-2246
2020,5,27,19,14500,14099,11692,-2407
2020,5,27,20,14890,14664,14355,-309
2020,5,27,21,15580,15317,15259,-58
2020,5,27,22,16120,15943,14960,-983
2020,5,27,23,16360,16081,14075,-2006
2020,5,28,0,16330,15770,13055,-2715
2020,5,28,1,16020,15503,12512,-2991
2020,5,28,2,15030,14792,11410,-3382
2020,5,28,3,13670,13583,10254,-3329
2020,5,28,4,12340,12467,9239,-3228
2020,5,28,5,11440,11740,8793,-2947
2020,5,28,6,10830,11399,8519,-2880
2020,5,28,7,10460,11270,8390,-2880
2020,5,28,8,10290,11090,8059,-3031
2020,5,28,9,10380,11268,8419,-2849
2020,5,28,10,10770,11353,8785,-2568
2020,5,28,11,11540,12261,9650,-2611
2020,5,28,12,12510,12988,10422,-2566
2020,5,28,13,13190,13621,10766,-2855
2020,5,28,14,13630,13754,10912,-2842
2020,5,28,15,13880,13994,11193,-2801
2020,5,28,16,14070,14253,11332,-2921
2020,5,28,17,14240,14600,11953,-2647
2020,5,28,18,14470,14894,12016,-2878
2020,5,28,19,14630,15002,12435,-2567
2020,5,28,20,14800,15137,12247,-2890
2020,5,28,21,14990,15380,12311,-3069
2020,5,28,22,15250,15737,12671,-3066
2020,5,28,23,15330,15707,12604,-3103
2020,5,29,0,15340,15498,12565,-2933
2020,5,29,1,15180,15291,12109,-3182
2020,5,29,2,14400,14648,11473,-3175
2020,5,29,3,13140,13541,10290,-3251
2020,5,29,4,12000,12565,9633,-2932
2020,5,29,5,11500,11956,9136,-2820
2020,5,29,6,11040,11844,9663,-2181
2020,5,29,7,10730,11542,9339,-2203
2020,5,29,8,10590,11402,9236,-2166
2020,5,29,9,10780,11484,9339,-2145
2020,5,29,10,11340,11569,9552,-2017
2020,5,29,11,12520,12044,9645,-2399
2020,5,29,12,13520,12958,10210,-2748
2020,5,29,13,14070,13717,10832,-2885
2020,5,29,14,14480,14341,11463,-2878
2020,5,29,15,14680,14679,12029,-2650
2020,5,29,16,14820,14869,12091,-2778
2020,5,29,17,14980,15161,12488,-2673
2020,5,29,18,15180,15368,12953,-2415
2020,5,29,19,15390,15571,13075,-2496
2020,5,29,20,15600,15799,13116,-2683
2020,5,29,21,15920,15974,13152,-2822
2020,5,29,22,16200,16272,13482,-2790
2020,5,29,23,16070,16248,13509,-2739
2020,5,30,0,15820,15882,13129,-2753
2020,5,30,1,15520,15534,13242,-2292
2020,5,30,2,14820,14889,13555,-1334
2020,5,30,3,13660,13870,12316,-1554
2020,5,30,4,12490,12787,11285,-1502
2020,5,30,5,11780,11679,10164,-1515
2020,5,30,6,11170,11051,9486,-1565
2020,5,30,7,10770,10810,9302,-1508
2020,5,30,8,10530,11077,9318,-1759
2020,5,30,9,10450,11084,9332,-1752
2020,5,30,10,10480,11301,9522,-1779
2020,5,30,11,10660,11291,9657,-1634
2020,5,30,12,11090,11415,9967,-1448
2020,5,30,13,11650,11574,10109,-1465
2020,5,30,14,12000,11981,10328,-1653
2020,5,30,15,11960,12203,10676,-1527
2020,5,30,16,11960,12395,10804,-1591
2020,5,30,17,11920,12517,10594,-1923
2020,5,30,18,11790,12364,9886,-2478
2020,5,30,19,11990,12398,10170,-2228
2020,5,30,20,12080,12768,10317,-2451
2020,5,30,21,12720,13408,10980,-2428
2020,5,30,22,13640,14334,11906,-2428
2020,5,30,23,14010,14749,12398,-2351
2020,5,31,0,14030,14487,12150,-2337
2020,5,31,1,13700,14097,11896,-2201
2020,5,31,2,12790,13553,11397,-2156
2020,5,31,3,12050,12489,10184,-2305
2020,5,31,4,11090,11456,9208,-2248
2020,5,31,5,10580,10600,8302,-2298
2020,5,31,6,9980,9994,7641,-2353
2020,5,31,7,9580,10237,7628,-2609
2020,5,31,8,9300,10132,7534,-2598
2020,5,31,9,9170,9988,7300,-2688
2020,5,31,10,9020,9849,6817,-3032
2020,5,31,11,9120,9672,6791,-2881
2020,5,31,12,9120,9412,6657,-2755
2020,5,31,13,9120,9412,6643,-2769
2020,5,31,14,9070,9412,6569,-2843
2020,5,31,15,9060,9620,6924,-2696
2020,5,31,16,8960,10083,7594,-2489
2020,5,31,17,8980,10184,7601,-2583
2020,5,31,18,8960,10232,7701,-2531
2020,5,31,19,9120,9867,7448,-2419
2020,5,31,20,9350,10206,7874,-2332
2020,5,31,21,10260,10933,8287,-2646
2020,5,31,22,11260,11528,8813,-2715
2020,5,31,23,11960,11993,9097,-2896
2020,6,1,0,12110,12045,8964,-3081
2020,6,1,1,12190,11995,8959,-3036
2020,6,1,2,11650,11553,8478,-3075
2020,6,1,3,10700,10667,7506,-3161
2020,6,1,4,9800,9819,6908,-2911
2020,6,1,5,9200,9204,6167,-3037
2020,6,1,6,8750,8754,5942,-2812
2020,6,1,7,8540,8538,5781,-2757
2020,6,1,8,8510,8504,5753,-2751
2020,6,1,9,8740,8727,6192,-2535
2020,6,1,10,9220,9202,6428,-2774
2020,6,1,11,10000,9977,7147,-2830
2020,6,1,12,10470,10468,7747,-2721
2020,6,1,13,10530,10526,7628,-2898
2020,6,1,14,10380,10425,7535,-2890
2020,6,1,15,10410,10538,7717,-2821
2020,6,1,16,10470,10897,8146,-2751
2020,6,1,17,10590,11146,8669,-2477
2020,6,1,18,10670,11141,8460,-2681
2020,6,1,19,10580,11059,8353,-2706
2020,6,1,20,10880,11114,8673,-2441
2020,6,1,21,11300,11505,9118,-2387
2020,6,1,22,12230,12329,9601,-2728
2020,6,1,23,12680,12651,9947,-2704
2020,6,2,0,12800,12527,9764,-2763
2020,6,2,1,12510,12419,9472,-2947
2020,6,2,2,11920,11887,8951,-2936
2020,6,2,3,10910,10947,7962,-2985
2020,6,2,4,9980,10169,7447,-2722
2020,6,2,5,9370,9805,7342,-2463
2020,6,2,6,8980,9516,7135,-2381
2020,6,2,7,8770,9303,7042,-2261
2020,6,2,8,8720,9231,7029,-2202
2020,6,2,9,8900,9410,7146,-2264
2020,6,2,10,9330,9838,7237,-2601
2020,6,2,11,10080,10577,7700,-2877
2020,6,2,12,10710,11222,8301,-2921
2020,6,2,13,11110,11615,8724,-2891
2020,6,2,14,11210,11575,8795,-2780
2020,6,2,15,11280,11488,9035,-2453
2020,6,2,16,11460,11578,9352,-2226
2020,6,2,17,11520,11285,9343,-1942
2020,6,2,18,11670,11308,9390,-1918
2020,6,2,19,11530,11547,9629,-1918
2020,6,2,20,11730,11657,9708,-1949
2020,6,2,21,12050,11949,9756,-2193
2020,6,2,22,12680,12497,9956,-2541
2020,6,2,23,13050,12827,10344,-2483
2020,6,3,0,12910,12874,10361,-2513
2020,6,3,1,12780,12736,10020,-2716
2020,6,3,2,12280,12115,9405,-2710
2020,6,3,3,11200,11185,8623,-2562
2020,6,3,4,10210,10508,8451,-2057
2020,6,3,5,9620,9898,7603,-2295
2020,6,3,6,9210,9514,7148,-2366
2020,6,3,7,8980,9494,7197,-2297
2020,6,3,8,8910,9417,7033,-2384
2020,6,3,9,9100,9563,7351,-2212
2020,6,3,10,9550,9788,7523,-2265
2020,6,3,11,10370,10511,7969,-2542
2020,6,3,12,11210,11185,8682,-2503
2020,6,3,13,11700,11684,9268,-2416
2020,6,3,14,11580,11616,9442,-2174
2020,6,3,15,11660,11774,9919,-1855
2020,6,3,16,12150,12321,10439,-1882
2020,6,3,17,12880,13271,11370,-1901
2020,6,3,18,13300,13856,11831,-2025
2020,6,3,19,13760,13573,11361,-2212
2020,6,3,20,14160,13375,11298,-2077
2020,6,3,21,14460,13771,11690,-2081
2020,6,3,22,14870,14556,12221,-2335
2020,6,3,23,15000,14903,12634,-2269
2020,6,4,0,14980,14739,12282,-2457
2020,6,4,1,14600,14627,12103,-2524
2020,6,4,2,13780,13992,11635,-2357
2020,6,4,3,12640,12883,10242,-2641
2020,6,4,4,11480,11746,9360,-2386
2020,6,4,5,10730,10861,8649,-2212
2020,6,4,6,10110,10500,8275,-2225
2020,6,4,7,9750,10119,7673,-2446
2020,6,4,8,9620,9944,7509,-2435
2020,6,4,9,9770,9987,7437,-2550
2020,6,4,10,10230,10140,7681,-2459
2020,6,4,11,11250,10998,8382,-2616
2020,6,4,12,12270,11885,9120,-2765
2020,6,4,13,12430,12407,9625,-2782
2020,6,4,14,12730,12675,9767,-2908
2020,6,4,15,13040,12969,10329,-2640
2020,6,4,16,13430,13444,11045,-2399
2020,6,4,17,13900,14073,11684,-2389
2020,6,4,18,14650,14703,12288,-2415
2020,6,4,19,15110,15154,13007,-2147
2020,6,4,20,15530,15603,13692,-1911
2020,6,4,21,16080,16203,13939,-2264
2020,6,4,22,16570,16759,14261,-2498
2020,6,4,23,16690,16751,13922,-2829
2020,6,5,0,16300,16432,13429,-3003
2020,6,5,1,16050,16159,12861,-3298
2020,6,5,2,15280,15505,12414,-3091
2020,6,5,3,13920,14266,10757,-3509
2020,6,5,4,12620,13011,9795,-3216
2020,6,5,5,12020,12047,9045,-3002
2020,6,5,6,11370,11388,8663,-2725
2020,6,5,7,10950,10950,8307,-2643
2020,6,5,8,10710,10967,8219,-2748
2020,6,5,9,10810,11042,8189,-2853
2020,6,5,10,11210,11440,8536,-2904
2020,6,5,11,12020,12047,8945,-3102
2020,6,5,12,12970,12956,9882,-3074
2020,6,5,13,13690,13672,10858,-2814
2020,6,5,14,14090,14087,11322,-2765
2020,6,5,15,14310,14307,11720,-2587
2020,6,5,16,14560,14559,12064,-2495
2020,6,5,17,14820,14807,12581,-2226
2020,6,5,18,14800,14805,12732,-2073
2020,6,5,19,15290,14835,12868,-1967
2020,6,5,20,15550,15194,13185,-2009
2020,6,5,21,15780,15766,13589,-2177
2020,6,5,22,16400,16388,13693,-2695
2020,6,5,23,16610,16549,13699,-2850
2020,6,6,0,16470,16275,13183,-3092
2020,6,6,1,15920,15949,12630,-3319
2020,6,6,2,15020,15419,12307,-3112
2020,6,6,3,14010,14356,11339,-3017
2020,6,6,4,12920,13221,10652,-2569
2020,6,6,5,12050,12271,9797,-2474
2020,6,6,6,11410,11594,9281,-2313
2020,6,6,7,11100,11161,8566,-2595
2020,6,6,8,10840,10882,8351,-2531
2020,6,6,9,10720,10785,8423,-2362
2020,6,6,10,11040,10840,8425,-2415
2020,6,6,11,11480,11127,8620,-2507
2020,6,6,12,12250,11696,9264,-2432
2020,6,6,13,12970,12385,10277,-2108
2020,6,6,14,13660,13184,10708,-2476
2020,6,6,15,13800,13697,11318,-2379
2020,6,6,16,14060,14253,11202,-3051
2020,6,6,17,14380,14910,11833,-3077
2020,6,6,18,14840,15483,12274,-3209
2020,6,6,19,15380,16057,13037,-3020
2020,6,6,20,15810,16072,13036,-3036
2020,6,6,21,16290,15670,12679,-2991
2020,6,6,22,16500,15945,12948,-2997
2020,6,6,23,16360,15975,12923,-3052
2020,6,7,0,15910,15550,13135,-2415
2020,6,7,1,15420,15069,12711,-2358
2020,6,7,2,14880,14413,11852,-2561
2020,6,7,3,13550,13113,10315,-2798
2020,6,7,4,12230,11881,9016,-2865
2020,6,7,5,10890,11056,8367,-2689
2020,6,7,6,10190,10473,7941,-2532
2020,6,7,7,9710,9772,7409,-2363
2020,6,7,8,9420,9669,7374,-2295
2020,6,7,9,9290,9561,7315,-2246
2020,6,7,10,9190,9462,7384,-2078
2020,6,7,11,9290,9785,7703,-2082
2020,6,7,12,9450,9981,7592,-2389
2020,6,7,13,10130,10086,7529,-2557
2020,6,7,14,10250,10294,7855,-2439
2020,6,7,15,10470,10805,8145,-2660
2020,6,7,16,10740,10920,8260,-2660
2020,6,7,17,10940,11179,8360,-2819
2020,6,7,18,11090,11177,8251,-2926
2020,6,7,19,11090,11106,8161,-2945
2020,6,7,20,11070,11098,8517,-2581
2020,6,7,21,11570,11466,9032,-2434
2020,6,7,22,12400,12173,9583,-2590
2020,6,7,23,13000,12622,9947,-2675
2020,6,8,0,12910,12657,9883,-2774
2020,6,8,1,12750,12621,9651,-2970
2020,6,8,2,12170,12224,9238,-2986
2020,6,8,3,11300,11330,8274,-3056
2020,6,8,4,10390,10400,7671,-2729
2020,6,8,5,9660,9917,7117,-2800
2020,6,8,6,9200,9745,6911,-2834
2020,6,8,7,8950,9742,6799,-2943
2020,6,8,8,8890,9627,6975,-2652
2020,6,8,9,9120,9774,7123,-2651
2020,6,8,10,9650,9960,7171,-2789
2020,6,8,11,10660,10583,7727,-2856
2020,6,8,12,11400,11008,8154,-2854
2020,6,8,13,11210,11270,8182,-3088
2020,6,8,14,11260,11248,8336,-2912
2020,6,8,15,11340,11279,8456,-2823
2020,6,8,16,11420,11647,8775,-2872
2020,6,8,17,11590,11951,8985,-2966
2020,6,8,18,11800,12206,9211,-2995
2020,6,8,19,12080,12437,9633,-2804
2020,6,8,20,12520,12833,9970,-2863
2020,6,8,21,13220,13370,10416,-2954
2020,6,8,22,14000,14300,11163,-3137
2020,6,8,23,14440,14749,11438,-3311
2020,6,9,0,14270,14540,11168,-3372
2020,6,9,1,14070,14145,10733,-3412
2020,6,9,2,13320,13550,10219,-3331
2020,6,9,3,12070,12404,8986,-3418
2020,6,9,4,10880,11399,8181,-3218
2020,6,9,5,10100,10775,7688,-3087
2020,6,9,6,9630,10656,7721,-2935
2020,6,9,7,9330,10402,7373,-3029
2020,6,9,8,9230,10265,7200,-3065
2020,6,9,9,9470,10398,7255,-3143
2020,6,9,10,10210,10633,7593,-3040
2020,6,9,11,11290,10959,8056,-2903
2020,6,9,12,12330,11785,8787,-2998
2020,6,9,13,12420,12597,9511,-3086
2020,6,9,14,12400,12528,9797,-2731
2020,6,9,15,12500,12665,10249,-2416
2020,6,9,16,12750,13028,10873,-2155
2020,6,9,17,13020,13173,11309,-1864
2020,6,9,18,13420,13199,11294,-1905
2020,6,9,19,13660,13528,11827,-1701
2020,6,9,20,14060,14215,12342,-1873
2020,6,9,21,14730,14933,12957,-1976
2020,6,9,22,15340,15642,13508,-2134
2020,6,9,23,15500,15742,13413,-2329
2020,6,10,0,15270,15454,13232,-2222
2020,6,10,1,15080,15102,12723,-2379
2020,6,10,2,14370,14502,11828,-2674
2020,6,10,3,13050,13339,10767,-2572
2020,6,10,4,11750,12146,9425,-2721
2020,6,10,5,11050,11553,8973,-2580
2020,6,10,6,10440,11465,8575,-2890
2020,6,10,7,10230,11291,8429,-2862
2020,6,10,8,10090,11065,8287,-2778
2020,6,10,9,10150,11134,8428,-2706
2020,6,10,10,10720,11494,8614,-2880
2020,6,10,11,11560,12043,9379,-2664
2020,6,10,12,12520,12800,9966,-2834
2020,6,10,13,12890,12774,10081,-2693
2020,6,10,14,13010,12754,10106,-2648
2020,6,10,15,13140,12919,10564,-2355
2020,6,10,16,13350,13197,10941,-2256
2020,6,10,17,13610,13586,11583,-2003
2020,6,10,18,14040,14030,11754,-2276
2020,6,10,19,14100,14502,12379,-2123
2020,6,10,20,14380,14937,12817,-2120
2020,6,10,21,14770,15452,13555,-1897
2020,6,10,22,15300,15895,13710,-2185
2020,6,10,23,15280,15784,12986,-2798
2020,6,11,0,15170,15437,12520,-2917
2020,6,11,1,15020,15119,12330,-2789
2020,6,11,2,14240,14527,11703,-2824
2020,6,11,3,13180,13426,10805,-2621
2020,6,11,4,12000,12497,9608,-2889
2020,6,11,5,11540,12004,9136,-2868
2020,6,11,6,11020,11585,8839,-2746
2020,6,11,7,10730,11497,8669,-2828
2020,6,11,8,10590,11399,8414,-2985
2020,6,11,9,10730,11526,8486,-3040
2020,6,11,10,11200,11714,8637,-3077
2020,6,11,11,12160,12251,9199,-3052
2020,6,11,12,13240,13212,10166,-3046
2020,6,11,13,14100,14076,11238,-2838
2020,6,11,14,14650,14642,12056,-2586
2020,6,11,15,14900,15041,12322,-2719
2020,6,11,16,15230,15233,12423,-2810
2020,6,11,17,15350,15383,12684,-2699
2020,6,11,18,15430,15450,12571,-2879
2020,6,11,19,15360,15403,12451,-2952
2020,6,11,20,15380,15299,12633,-2666
2020,6,11,21,15450,15377,12664,-2713
2020,6,11,22,15850,15620,12828,-2792
2020,6,11,23,15700,15484,12765,-2719
2020,6,12,0,15540,15136,12673,-2463
2020,6,12,1,15320,14829,12542,-2287
2020,6,12,2,14760,14342,11919,-2423
2020,6,12,3,13650,13411,10968,-2443
2020,6,12,4,12440,12578,9976,-2602
2020,6,12,5,11520,12162,9583,-2579
2020,6,12,6,10950,11759,9330,-2429
2020,6,12,7,10600,11497,8978,-2519
2020,6,12,8,10430,11481,8714,-2767
2020,6,12,9,10480,11526,8746,-2780
2020,6,12,10,10880,11821,8869,-2952
2020,6,12,11,11710,12192,9111,-3081
2020,6,12,12,12650,12857,9739,-3118
2020,6,12,13,13250,13231,10443,-2788
2020,6,12,14,13540,13539,11283,-2256
2020,6,12,15,13840,13786,11631,-2155
2020,6,12,16,14150,14092,11788,-2304
2020,6,12,17,14400,14356,12423,-1933
2020,6,12,18,14830,14656,12635,-2021
2020,6,12,19,15130,14950,12892,-2058
2020,6,12,20,15420,15282,13400,-1882
2020,6,12,21,15880,15743,13695,-2048
2020,6,12,22,16300,16168,13906,-2262
2020,6,12,23,16200,16293,13902,-2391
2020,6,13,0,15690,15835,13363,-2472
2020,6,13,1,15430,15239,12790,-2449
2020,6,13,2,14840,14618,12103,-2515
2020,6,13,3,13630,13407,10839,-2568
2020,6,13,4,12320,12152,9654,-2498
2020,6,13,5,11100,11135,8810,-2325
2020,6,13,6,10370,10387,8119,-2268
2020,6,13,7,9870,9883,7697,-2186
2020,6,13,8,9560,9563,7618,-1945
2020,6,13,9,9440,9442,7612,-1830
2020,6,13,10,9360,9363,7371,-1992
2020,6,13,11,9600,9592,7202,-2390
2020,6,13,12,9870,9869,7338,-2531
2020,6,13,13,10110,10096,7834,-2262
2020,6,13,14,10220,10224,7962,-2262
2020,6,13,15,10290,10519,8185,-2334
2020,6,13,16,10450,10707,8455,-2252
2020,6,13,17,10590,10846,8555,-2291
2020,6,13,18,10640,10951,8704,-2247
2020,6,13,19,10710,11128,8706,-2422
2020,6,13,20,10980,11374,8933,-2441
2020,6,13,21,11470,11780,9185,-2595
2020,6,13,22,12000,12442,9603,-2839
2020,6,13,23,12500,12791,9703,-3088
2020,6,14,0,12400,12640,9512,-3128
2020,6,14,1,12220,12447,9314,-3133
2020,6,14,2,11900,12099,9093,-3006
2020,6,14,3,11350,11246,8363,-2883
2020,6,14,4,10380,10439,7509,-2930
2020,6,14,5,9610,9878,7295,-2583
2020,6,14,6,9110,9131,6838,-2293
2020,6,14,7,8790,8805,6899,-1906
2020,6,14,8,8640,8638,6732,-1906
2020,6,14,9,8600,8604,6665,-1939
2020,6,14,10,8570,8793,6771,-2022
2020,6,14,11,8690,8952,6885,-2067
2020,6,14,12,8850,9326,6852,-2474
2020,6,14,13,9050,9553,7012,-2541
2020,6,14,14,9280,9521,7205,-2316
2020,6,14,15,9490,9672,7476,-2196
2020,6,14,16,9650,9870,7518,-2352
2020,6,14,17,9920,10002,7813,-2189
2020,6,14,18,10110,10180,8030,-2150
2020,6,14,19,10260,10327,8326,-2001
2020,6,14,20,10560,10607,8388,-2219
2020,6,14,21,11080,11244,8563,-2681
2020,6,14,22,12050,12171,9384,-2787
2020,6,14,23,12350,12680,9807,-2873
2020,6,15,0,12500,12682,9762,-2920
2020,6,15,1,12370,12589,9503,-3086
2020,6,15,2,11990,12203,9170,-3033
2020,6,15,3,11060,11268,8287,-2981
2020,6,15,4,10140,10320,8069,-2251
2020,6,15,5,9610,9917,7253,-2664
2020,6,15,6,9180,9478,7021,-2457
2020,6,15,7,8960,9469,6700,-2769
2020,6,15,8,8900,9436,7102,-2334
2020,6,15,9,9100,9616,7484,-2132
2020,6,15,10,9570,9843,7664,-2179
2020,6,15,11,10420,10511,8022,-2489
2020,6,15,12,11170,11156,8593,-2563
2020,6,15,13,11460,11471,8686,-2785
2020,6,15,14,11420,11422,9056,-2366
2020,6,15,15,11460,11459,9537,-1922
2020,6,15,16,11670,11658,9510,-2148
2020,6,15,17,12020,12012,9914,-2098
2020,6,15,18,12290,12351,10153,-2198
2020,6,15,19,12390,12462,10374,-2088
2020,6,15,20,12490,12574,10576,-1998
2020,6,15,21,12870,12917,10531,-2386
2020,6,15,22,13630,13500,10991,-2509
2020,6,15,23,14000,13815,11277,-2538
2020,6,16,0,13800,13677,10985,-2692
2020,6,16,1,13500,13443,10535,-2908
2020,6,16,2,12870,12972,10089,-2883
2020,6,16,3,11710,11886,8801,-3085
2020,6,16,4,10610,10863,8282,-2581
2020,6,16,5,10000,10461,7892,-2569
2020,6,16,6,9510,10296,7659,-2637
2020,6,16,7,9250,10264,7594,-2670
2020,6,16,8,9140,10192,7436,-2756
2020,6,16,9,9270,10081,7289,-2792
2020,6,16,10,9670,10433,7569,-2864
2020,6,16,11,10560,10811,8041,-2770
2020,6,16,12,11290,11480,8635,-2845
2020,6,16,13,11410,11812,8909,-2903
2020,6,16,14,11230,11848,9366,-2482
2020,6,16,15,11260,11901,9751,-2150
2020,6,16,16,11400,12049,9969,-2080
2020,6,16,17,11600,12001,10032,-1969
2020,6,16,18,11990,12261,10159,-2102
2020,6,16,19,12310,12482,10265,-2217
2020,6,16,20,12700,12916,10622,-2294
2020,6,16,21,13300,13609,11167,-2442
2020,6,16,22,14140,14458,11943,-2515
2020,6,16,23,14440,14847,11976,-2871
2020,6,17,0,14230,14603,11635,-2968
2020,6,17,1,13980,14145,11410,-2735
2020,6,17,2,13340,13595,10463,-3132
2020,6,17,3,12130,12447,9263,-3184
2020,6,17,4,10960,11266,8566,-2700
2020,6,17,5,10370,10416,7868,-2548
2020,6,17,6,9820,10048,7293,-2755
2020,6,17,7,9490,9977,6976,-3001
2020,6,17,8,9320,9843,7132,-2711
2020,6,17,9,9440,9707,7162,-2545
2020,6,17,10,9890,10097,7542,-2555
2020,6,17,11,11040,10923,8011,-2912
2020,6,17,12,11800,11682,8658,-3024
2020,6,17,13,11930,12089,9385,-2704
2020,6,17,14,11910,12007,9388,-2619
2020,6,17,15,12100,12119,9599,-2520
2020,6,17,16,12270,12419,10381,-2038
2020,6,17,17,12550,12752,10587,-2165
2020,6,17,18,13010,13161,11103,-2058
2020,6,17,19,13530,13581,11683,-1898
2020,6,17,20,14060,14164,11902,-2262
2020,6,17,21,14820,15007,12386,-2621
2020,6,17,22,15490,15916,12820,-3096
2020,6,17,23,15790,16292,12932,-3360
2020,6,18,0,15400,15977,12650,-3327
2020,6,18,1,15120,15412,12221,-3191
2020,6,18,2,14330,14845,11559,-3286
2020,6,18,3,13000,13642,10308,-3334
2020,6,18,4,11730,12512,9732,-2780
2020,6,18,5,11250,11728,9134,-2594
2020,6,18,6,10630,11345,8705,-2640
2020,6,18,7,10270,11183,8579,-2604
2020,6,18,8,10110,11031,8663,-2368
2020,6,18,9,10280,11117,8869,-2248
2020,6,18,10,10790,11519,9143,-2376
2020,6,18,11,11880,11977,9545,-2432
2020,6,18,12,13010,12807,9751,-3056
2020,6,18,13,13420,13221,10300,-2921
2020,6,18,14,13570,13491,10964,-2527
2020,6,18,15,14030,13880,11482,-2398
2020,6,18,16,14590,14510,12173,-2337
2020,6,18,17,15120,15166,13011,-2155
2020,6,18,18,16210,15938,13636,-2302
2020,6,18,19,16970,16541,13900,-2641
2020,6,18,20,17490,17183,14174,-3009
2020,6,18,21,18040,17882,14715,-3167
2020,6,18,22,18780,18561,15328,-3233
2020,6,18,23,18710,18766,15478,-3288
2020,6,19,0,18230,18353,14934,-3419
2020,6,19,1,17490,17722,14302,-3420
2020,6,19,2,16760,17042,13673,-3369
2020,6,19,3,15240,15672,12244,-3428
2020,6,19,4,13710,14359,11321,-3038
2020,6,19,5,13080,14037,10813,-3224
2020,6,19,6,12300,13611,10563,-3048
2020,6,19,7,11820,13139,10089,-3050
2020,6,19,8,11550,12858,9772,-3086
2020,6,19,9,11590,12896,9823,-3073
2020,6,19,10,12050,13103,10042,-3061
2020,6,19,11,13310,13403,10337,-3066
2020,6,19,12,14480,14005,10767,-3238
2020,6,19,13,15220,14843,11634,-3209
2020,6,19,14,15470,15315,12812,-2503
2020,6,19,15,16090,15805,13773,-2032
2020,6,19,16,16630,16387,13971,-2416
2020,6,19,17,17210,17028,14377,-2651
2020,6,19,18,18120,17624,14710,-2914
2020,6,19,19,18750,18037,15241,-2796
2020,6,19,20,19070,18411,15497,-2914
2020,6,19,21,19560,18831,15993,-2838
2020,6,19,22,19900,19233,16318,-2915
2020,6,19,23,19680,19223,15812,-3411
2020,6,20,0,18890,18678,15244,-3434
2020,6,20,1,18190,17910,14766,-3144
2020,6,20,2,17490,17237,14260,-2977
2020,6,20,3,15960,15883,12814,-3069
2020,6,20,4,14540,14491,11276,-3215
2020,6,20,5,13320,13379,10296,-3083
2020,6,20,6,12490,12932,9648,-3284
2020,6,20,7,11930,12738,9546,-3192
2020,6,20,8,11560,12355,9082,-3273
2020,6,20,9,11380,12181,8797,-3384
2020,6,20,10,11270,12264,8932,-3332
2020,6,20,11,11670,12791,9367,-3424
2020,6,20,12,12490,13488,10223,-3265
2020,6,20,13,13510,13928,10988,-2940
2020,6,20,14,14560,14368,11733,-2635
2020,6,20,15,15250,15097,12650,-2447
2020,6,20,16,16140,15950,13746,-2204
2020,6,20,17,16940,16668,14340,-2328
2020,6,20,18,17650,17156,14750,-2406
2020,6,20,19,18280,17670,15171,-2499
2020,6,20,20,18850,18230,15505,-2725
2020,6,20,21,19180,18873,15884,-2989
2020,6,20,22,19590,19487,16298,-3189
2020,6,20,23,19620,19647,16395,-3252
2020,6,21,0,19060,19133,15852,-3281
2020,6,21,1,18360,18466,15063,-3403
2020,6,21,2,17640,17835,14447,-3388
2020,6,21,3,16260,16536,13128,-3408
2020,6,21,4,14920,15137,11793,-3344
2020,6,21,5,13890,13993,10451,-3542
2020,6,21,6,13020,13332,9810,-3522
2020,6,21,7,12380,13062,9511,-3551
2020,6,21,8,11860,12770,9249,-3521
2020,6,21,9,11660,12510,9079,-3431
2020,6,21,10,11460,12320,8834,-3486
2020,6,21,11,11620,12560,9057,-3503
2020,6,21,12,12130,13212,9687,-3525
2020,6,21,13,12940,13518,10364,-3154
2020,6,21,14,13590,14275,11447,-2828
2020,6,21,15,15140,15175,12382,-2793
2020,6,21,16,15970,16096,13095,-3001
2020,6,21,17,16800,16810,13552,-3258
2020,6,21,18,17410,17319,14128,-3191
2020,6,21,19,17990,17746,14524,-3222
2020,6,21,20,18610,18244,15036,-3208
2020,6,21,21,19070,18710,15464,-3246
2020,6,21,22,19530,19047,15830,-3217
2020,6,21,23,19800,19108,15933,-3175
2020,6,22,0,19240,18806,15571,-3235
2020,6,22,1,18710,18358,15025,-3333
2020,6,22,2,18010,17752,14286,-3466
2020,6,22,3,16550,16331,12984,-3347
2020,6,22,4,15060,15121,11543,-3578
2020,6,22,5,13740,14209,10788,-3421
2020,6,22,6,12950,13940,10352,-3588
2020,6,22,7,12430,13607,10161,-3446
2020,6,22,8,12170,13469,10048,-3421
2020,6,22,9,12230,13494,10061,-3433
2020,6,22,10,12600,13626,10259,-3367
2020,6,22,11,13560,14247,11117,-3130
2020,6,22,12,14590,14998,11942,-3056
2020,6,22,13,15430,15749,12922,-2827
2020,6,22,14,15950,16052,13936,-2116
2020,6,22,15,16520,16446,14618,-1828
2020,6,22,16,17450,17014,15464,-1550
2020,6,22,17,17970,17566,15915,-1651
2020,6,22,18,18480,18081,16537,-1544
2020,6,22,19,19110,18546,17057,-1489
2020,6,22,20,19610,19027,17347,-1680
2020,6,22,21,19740,19558,17571,-1987
2020,6,22,22,20230,20062,17684,-2378
2020,6,22,23,20300,19911,16987,-2924
2020,6,23,0,19900,19300,16307,-2993
2020,6,23,1,18970,18566,15694,-2872
2020,6,23,2,17830,17722,14846,-2876
2020,6,23,3,16210,16517,13562,-2955
2020,6,23,4,14610,15229,12533,-2696
2020,6,23,5,13510,14133,11038,-3095
2020,6,23,6,12730,13548,10604,-2944
2020,6,23,7,12220,13130,10167,-2963
2020,6,23,8,11940,12991,9813,-3178
2020,6,23,9,11990,13015,9868,-3147
2020,6,23,10,12370,12750,9542,-3208
2020,6,23,11,13380,13329,10117,-3212
2020,6,23,12,14440,14400,11129,-3271
2020,6,23,13,15290,15245,12264,-2981
2020,6,23,14,15900,15876,13420,-2456
2020,6,23,15,16850,16676,14679,-1997
2020,6,23,16,17570,17679,15989,-1690
2020,6,23,17,18240,18597,16642,-1955
2020,6,23,18,19160,19327,16928,-2399
2020,6,23,19,19690,19812,17067,-2745
2020,6,23,20,20150,20241,17337,-2904
2020,6,23,21,20670,20701,17668,-3033
2020,6,23,22,21000,21094,18216,-2878
2020,6,23,23,20740,20986,18049,-2937
2020,6,24,0,19960,20382,17102,-3280
2020,6,24,1,19340,19519,16171,-3348
2020,6,24,2,18320,18635,15325,-3310
2020,6,24,3,16680,17308,14400,-2908
2020,6,24,4,15110,15739,13031,-2708
2020,6,24,5,14220,14549,12168,-2381
2020,6,24,6,13440,13770,11235,-2535
2020,6,24,7,12970,13540,10860,-2680
2020,6,24,8,12740,13527,10777,-2750
2020,6,24,9,12840,13558,10810,-2748
2020,6,24,10,13310,13836,11135,-2701
2020,6,24,11,14330,14420,11782,-2638
2020,6,24,12,15460,15443,12435,-3008
2020,6,24,13,16410,16377,13391,-2986
2020,6,24,14,16950,17011,14436,-2575
2020,6,24,15,17380,17570,14951,-2619
2020,6,24,16,17990,17910,15130,-2780
2020,6,24,17,18270,18242,15476,-2766
2020,6,24,18,18710,18841,16113,-2728
2020,6,24,19,18970,18968,16779,-2189
2020,6,24,20,19190,19101,16708,-2393
2020,6,24,21,19410,19691,17344,-2347
2020,6,24,22,19640,20323,18177,-2146
2020,6,24,23,19510,20200,18106,-2094
2020,6,25,0,18650,19513,17169,-2344
2020,6,25,1,18120,18501,16099,-2402
2020,6,25,2,17280,17487,15150,-2337
2020,6,25,3,15550,15878,13215,-2663
2020,6,25,4,13900,14283,12036,-2247
2020,6,25,5,13100,13347,11186,-2161
2020,6,25,6,12240,12759,10698,-2061
2020,6,25,7,11600,12462,10270,-2192
2020,6,25,8,11290,12341,10233,-2108
2020,6,25,9,11300,12356,10259,-2097
2020,6,25,10,11720,12403,10269,-2134
2020,6,25,11,12740,13158,11042,-2116
2020,6,25,12,13690,13777,11375,-2402
2020,6,25,13,14040,14631,12180,-2451
2020,6,25,14,14490,14531,12344,-2187
2020,6,25,15,14870,15179,13160,-2019
2020,6,25,16,15390,15579,13714,-1865
2020,6,25,17,15820,16009,13976,-2033
2020,6,25,18,16450,16420,14246,-2174
2020,6,25,19,16810,16826,14833,-1993
2020,6,25,20,17230,17308,15241,-2067
2020,6,25,21,17650,17924,15646,-2278
2020,6,25,22,18100,18519,15653,-2866
2020,6,25,23,17950,18674,15735,-2939
2020,6,26,0,17580,18135,15296,-2839
2020,6,26,1,17110,17380,14630,-2750
2020,6,26,2,16350,16679,14049,-2630
2020,6,26,3,14910,15290,12264,-3026
2020,6,26,4,13480,13871,11046,-2825
2020,6,26,5,12770,13062,10536,-2526
2020,6,26,6,12000,12555,10048,-2507
2020,6,26,7,11480,12029,9244,-2785
2020,6,26,8,11210,11740,8927,-2813
2020,6,26,9,11190,11723,8918,-2805
2020,6,26,10,11520,12034,9267,-2767
2020,6,26,11,12420,12646,10068,-2578
2020,6,26,12,13440,13657,11097,-2560
2020,6,26,13,14180,14300,11861,-2439
2020,6,26,14,14680,14670,12609,-2061
2020,6,26,15,15250,15232,13289,-1943
2020,6,26,16,15950,15862,13844,-2018
2020,6,26,17,16440,16425,14491,-1934
2020,6,26,18,16790,16961,15099,-1862
2020,6,26,19,17110,17252,15014,-2238
2020,6,26,20,17480,17512,15179,-2333
2020,6,26,21,18050,17796,15662,-2134
2020,6,26,22,18550,18177,15825,-2352
2020,6,26,23,18610,18351,15789,-2562
2020,6,27,0,17920,17810,15052,-2758
2020,6,27,1,17010,17052,14154,-2898
2020,6,27,2,16320,16415,13792,-2623
2020,6,27,3,15130,15142,12243,-2899
2020,6,27,4,13830,13744,10803,-2941
2020,6,27,5,12560,12604,9527,-3077
2020,6,27,6,11750,11771,8992,-2779
2020,6,27,7,11160,11390,8486,-2904
2020,6,27,8,10810,11356,8299,-3057
2020,6,27,9,10650,11193,8240,-2953
2020,6,27,10,10590,11192,8381,-2811
2020,6,27,11,10970,11737,8840,-2897
2020,6,27,12,11540,12252,9081,-3171
2020,6,27,13,12350,12830,9973,-2857
2020,6,27,14,13210,13185,10197,-2988
2020,6,27,15,14010,13992,11037,-2955
2020,6,27,16,14920,14907,11936,-2971
2020,6,27,17,15640,15638,12905,-2733
2020,6,27,18,15650,15677,13009,-2668
2020,6,27,19,15480,15481,12476,-3005
2020,6,27,20,15340,15296,12132,-3164
2020,6,27,21,15170,15232,12105,-3127
2020,6,27,22,15460,15357,12284,-3073
2020,6,27,23,15590,15340,12194,-3146
2020,6,28,0,15400,15075,11843,-3232
2020,6,28,1,15160,14859,11857,-3002
2020,6,28,2,14810,14493,11791,-2702
2020,6,28,3,13860,13629,10918,-2711
2020,6,28,4,12900,12659,9899,-2760
2020,6,28,5,11800,11823,9253,-2570
2020,6,28,6,11180,11195,9046,-2149
2020,6,28,7,10760,11014,8877,-2137
2020,6,28,8,10490,11018,8554,-2464
2020,6,28,9,10370,10915,8629,-2286
2020,6,28,10,10280,10830,8583,-2247
2020,6,28,11,10530,11065,8879,-2186
2020,6,28,12,11050,11533,9100,-2433
2020,6,28,13,11760,11813,9652,-2161
2020,6,28,14,12630,12610,10576,-2034
2020,6,28,15,13550,13526,11516,-2010
2020,6,28,16,14540,14636,12624,-2012
2020,6,28,17,15540,15577,13611,-1966
2020,6,28,18,15810,16047,13691,-2356
2020,6,28,19,15960,16383,13641,-2742
2020,6,28,20,16290,16736,13986,-2750
2020,6,28,21,16830,17038,14371,-2667
2020,6,28,22,17550,17253,14657,-2596
2020,6,28,23,17880,16955,14065,-2890
2020,6,29,0,17550,16336,13551,-2785
2020,6,29,1,17040,15844,13079,-2765
2020,6,29,2,16430,15222,12672,-2550
2020,6,29,3,15140,14145,11763,-2382
2020,6,29,4,13800,13070,10402,-2668
2020,6,29,5,11970,12262,9783,-2479
2020,6,29,6,11440,12116,9625,-2491
2020,6,29,7,11070,12269,9472,-2797
2020,6,29,8,10930,12120,9225,-2895
2020,6,29,9,11150,12265,9621,-2644
2020,6,29,10,11720,12529,9660,-2869
2020,6,29,11,12890,12818,10203,-2615
2020,6,29,12,14010,13788,11206,-2582
2020,6,29,13,14520,14612,12160,-2452
2020,6,29,14,15250,15185,13062,-2123
2020,6,29,15,15520,15494,13472,-2022
2020,6,29,16,15980,15795,13737,-2058
2020,6,29,17,16070,16170,14417,-1753
2020,6,29,18,16200,16390,14416,-1974
2020,6,29,19,16410,16524,14479,-2045
2020,6,29,20,16600,16432,14436,-1996
2020,6,29,21,16810,16139,14425,-1714
2020,6,29,22,17200,16188,14695,-1493
2020,6,29,23,17130,16068,14297,-1771
2020,6,30,0,16780,15689,13712,-1977
2020,6,30,1,16250,15291,13031,-2260
2020,6,30,2,15520,14648,12518,-2130
2020,6,30,3,14150,13579,11361,-2218
2020,6,30,4,12850,12479,10354,-2125
2020,6,30,5,11650,11930,10008,-1922
2020,6,30,6,11150,11679,9400,-2279
2020,6,30,7,10810,11809,9288,-2521
2020,6,30,8,10660,11855,9074,-2781
2020,6,30,9,10840,11980,9036,-2944
2020,6,30,10,11400,12126,9179,-2947
2020,6,30,11,12470,12234,9724,-2510
2020,6,30,12,13460,13079,10188,-2891
2020,6,30,13,14090,13834,11127,-2707
2020,6,30,14,14390,14198,11786,-2412
2020,6,30,15,14590,14440,12141,-2299
2020,6,30,16,14790,14682,12640,-2042
2020,6,30,17,14900,14844,12759,-2085
2020,6,30,18,15120,14897,12965,-1932
2020,6,30,19,15160,14945,12954,-1991
2020,6,30,20,15250,15072,12953,-2119
2020,6,30,21,15380,15415,13472,-1943
2020,6,30,22,15750,15792,13687,-2105
2020,6,30,23,15700,15742,13444,-2298
2020,7,1,0,15490,15373,12969,-2404
2020,7,1,1,15200,15044,12696,-2348
2020,7,1,2,14640,14523,12186,-2337
2020,7,1,3,13390,13475,11096,-2379
2020,7,1,4,12210,12389,10223,-2166
2020,7,1,5,11530,11555,9418,-2137
2020,7,1,6,10970,11014,8739,-2275
2020,7,1,7,10620,10871,8246,-2625
2020,7,1,8,10470,10712,8053,-2659
2020,7,1,9,10620,10832,8021,-2811
2020,7,1,10,11160,11200,8195,-3005
2020,7,1,11,12230,11921,8986,-2935
2020,7,1,12,13190,12823,10131,-2692
2020,7,1,13,13790,13589,11756,-1833
2020,7,1,14,14130,14108,12121,-1987
2020,7,1,15,14410,14468,12701,-1767
2020,7,1,16,14760,14805,12994,-1811
2020,7,1,17,15040,15171,13491,-1680
2020,7,1,18,15340,15689,14064,-1625
2020,7,1,19,15670,16056,14440,-1616
2020,7,1,20,15900,16253,14434,-1819
2020,7,1,21,16160,16461,14737,-1724
2020,7,1,22,16590,16741,15031,-1710
2020,7,1,23,16550,16605,14620,-1985
2020,7,2,0,16300,16148,14131,-2017
2020,7,2,1,16040,15756,13498,-2258
2020,7,2,2,15320,15201,13064,-2137
2020,7,2,3,14050,14049,11824,-2225
2020,7,2,4,12770,12806,10595,-2211
2020,7,2,5,11820,11842,9428,-2414
2020,7,2,6,11180,11251,8637,-2614
2020,7,2,7,10770,11023,8832,-2191
2020,7,2,8,10570,10767,8554,-2213
2020,7,2,9,10630,10608,8459,-2149
2020,7,2,10,11020,11004,8496,-2508
2020,7,2,11,11900,11845,9547,-2298
2020,7,2,12,12860,12821,10807,-2014
2020,7,2,13,14160,13526,11735,-1791
2020,7,2,14,14480,14054,12153,-1901
2020,7,2,15,15140,14684,13202,-1482
2020,7,2,16,15780,15483,14138,-1345
2020,7,2,17,16480,16283,14877,-1406
2020,7,2,18,17390,17135,15581,-1554
2020,7,2,19,18050,17918,16189,-1729
2020,7,2,20,18630,18729,17083,-1646
2020,7,2,21,19370,19582,17955,-1627
2020,7,2,22,19910,20323,18447,-1876
2020,7,2,23,19840,20413,17882,-2531
2020,7,3,0,19280,19777,17155,-2622
2020,7,3,1,18710,19047,16557,-2490
2020,7,3,2,17900,18164,15763,-2401
2020,7,3,3,16420,16697,14209,-2488
2020,7,3,4,14870,15226,12631,-2595
2020,7,3,5,14030,14056,11241,-2815
2020,7,3,6,13210,13221,10482,-2739
2020,7,3,7,12690,12695,9873,-2822
2020,7,3,8,12360,12589,9592,-2997
2020,7,3,9,12290,12582,9671,-2911
2020,7,3,10,12440,12726,9754,-2972
2020,7,3,11,12920,13139,10104,-3035
2020,7,3,12,13450,13507,10598,-2909
2020,7,3,13,14120,14086,11448,-2638
2020,7,3,14,14680,14639,12419,-2220
2020,7,3,15,15100,15012,13074,-1938
2020,7,3,16,15270,15374,13515,-1859
2020,7,3,17,15180,15507,13774,-1733
2020,7,3,18,15160,15514,13810,-1704
2020,7,3,19,15300,15676,13995,-1681
2020,7,3,20,15640,15652,14209,-1443
2020,7,3,21,16040,15641,14798,-843
2020,7,3,22,16300,15638,14509,-1129
2020,7,3,23,15950,15358,14044,-1314
2020,7,4,0,15390,14881,13440,-1441
2020,7,4,1,14890,14542,12929,-1613
2020,7,4,2,14420,14092,12508,-1584
2020,7,4,3,13580,13197,11645,-1552
2020,7,4,4,12510,12220,10354,-1866
2020,7,4,5,11390,11570,9577,-1993
2020,7,4,6,10780,11168,9152,-2016
2020,7,4,7,10390,11145,9161,-1984
2020,7,4,8,10170,10997,9462,-1535
2020,7,4,9,10100,11159,9239,-1920
2020,7,4,10,10120,11182,8886,-2296
2020,7,4,11,10330,11191,9117,-2074
2020,7,4,12,10780,11593,9391,-2202
2020,7,4,13,11350,12112,9895,-2217
2020,7,4,14,11800,12052,9961,-2091
2020,7,4,15,12370,12351,10528,-1823
2020,7,4,16,12680,12583,11077,-1506
2020,7,4,17,12920,12902,11603,-1299
2020,7,4,18,12930,13234,12188,-1046
2020,7,4,19,13360,13660,12583,-1077
2020,7,4,20,14000,14206,12923,-1283
2020,7,4,21,14790,14876,13648,-1228
2020,7,4,22,15340,15589,14318,-1271
2020,7,4,23,15470,15918,14376,-1542
2020,7,5,0,15260,15574,13878,-1696
2020,7,5,1,14930,15114,13126,-1988
2020,7,5,2,14640,14657,12605,-2052
2020,7,5,3,13830,13924,11702,-2222
2020,7,5,4,12800,12982,10658,-2324
2020,7,5,5,12040,12078,9959,-2119
2020,7,5,6,11390,11670,9229,-2441
2020,7,5,7,10940,11510,9072,-2438
2020,7,5,8,10670,11488,9003,-2485
2020,7,5,9,10550,11365,8895,-2470
2020,7,5,10,10510,11328,8879,-2449
2020,7,5,11,10670,11591,8861,-2730
2020,7,5,12,11070,12020,9511,-2509
2020,7,5,13,11670,12430,10056,-2374
2020,7,5,14,12220,12597,10201,-2396
2020,7,5,15,12860,12965,10833,-2132
2020,7,5,16,13570,13439,11803,-1636
2020,7,5,17,14190,13988,12557,-1431
2020,7,5,18,14630,14639,13034,-1605
2020,7,5,19,15120,15343,14052,-1291
2020,7,5,20,16070,16168,14566,-1602
2020,7,5,21,16890,17015,15663,-1352
2020,7,5,22,17710,17754,16093,-1661
2020,7,5,23,18000,17979,15982,-1997
2020,7,6,0,17630,17607,15491,-2116
2020,7,6,1,17320,17203,14911,-2292
2020,7,6,2,16450,16614,14356,-2258
2020,7,6,3,15180,15374,12998,-2376
2020,7,6,4,13830,13987,11586,-2401
2020,7,6,5,12860,13083,10534,-2549
2020,7,6,6,12100,12452,10022,-2430
2020,7,6,7,11650,12210,9681,-2529
2020,7,6,8,11390,11945,9427,-2518
2020,7,6,9,11460,12010,9541,-2469
2020,7,6,10,11870,12410,9698,-2712
2020,7,6,11,12770,13284,10866,-2418
2020,7,6,12,13730,14001,11451,-2550
2020,7,6,13,14450,14710,12835,-1875
2020,7,6,14,14970,14955,13442,-1513
2020,7,6,15,15460,15449,14194,-1255
2020,7,6,16,15920,15922,14987,-935
2020,7,6,17,16390,16384,15481,-903
2020,7,6,18,16820,16791,16035,-756
2020,7,6,19,17060,17056,16129,-927
2020,7,6,20,17470,17454,16942,-512
2020,7,6,21,17940,17935,17579,-356
2020,7,6,22,18550,18355,17543,-812
2020,7,6,23,18210,18263,17019,-1244
2020,7,7,0,17700,17577,16142,-1435
2020,7,7,1,16990,16821,15385,-1436
2020,7,7,2,16250,16068,14567,-1501
2020,7,7,3,14720,14725,13093,-1632
2020,7,7,4,13350,13380,11556,-1824
2020,7,7,5,12310,12341,10669,-1672
2020,7,7,6,11640,12047,10035,-2012
2020,7,7,7,11200,11983,9531,-2452
2020,7,7,8,10960,11755,9398,-2357
2020,7,7,9,11030,11819,9711,-2108
2020,7,7,10,11480,12223,10030,-2193
2020,7,7,11,12340,12626,10541,-2085
2020,7,7,12,13170,13167,11238,-1929
2020,7,7,13,13730,13711,12121,-1590
2020,7,7,14,13900,13896,12561,-1335
2020,7,7,15,14080,14104,13130,-974
2020,7,7,16,14280,14422,13373,-1049
2020,7,7,17,14630,14811,14003,-808
2020,7,7,18,15160,15264,14688,-576
2020,7,7,19,15630,15513,15123,-390
2020,7,7,20,16370,15850,15466,-384
2020,7,7,21,16830,16306,15912,-394
2020,7,7,22,17400,16731,15903,-828
2020,7,7,23,17280,16706,15585,-1121
2020,7,8,0,16440,16298,15104,-1194
2020,7,8,1,16040,15967,14707,-1260
2020,7,8,2,15450,15421,13899,-1522
2020,7,8,3,14290,14319,12792,-1527
2020,7,8,4,12980,13159,11297,-1862
2020,7,8,5,12290,12300,10435,-1865
2020,7,8,6,11730,11910,9939,-1971
2020,7,8,7,11390,11679,9710,-1969
2020,7,8,8,11270,11764,9624,-2140
2020,7,8,9,11430,11739,9487,-2252
2020,7,8,10,12040,12295,10171,-2124
2020,7,8,11,13040,13273,10859,-2414
2020,7,8,12,14210,14173,12073,-2100
2020,7,8,13,15130,15111,13482,-1629
2020,7,8,14,15800,15768,14198,-1570
2020,7,8,15,16360,16423,14875,-1548
2020,7,8,16,16920,17093,15832,-1261
2020,7,8,17,17500,17681,16412,-1269
2020,7,8,18,18080,18399,16613,-1786
2020,7,8,19,18570,19057,17551,-1506
2020,7,8,20,18840,19214,17265,-1949
2020,7,8,21,19160,19370,17592,-1778
2020,7,8,22,19900,19780,17803,-1977
2020,7,8,23,19500,19574,17325,-2249
2020,7,9,0,19050,18920,16527,-2393
2020,7,9,1,18530,18340,16096,-2244
2020,7,9,2,17690,17655,15331,-2324
2020,7,9,3,16270,16266,13760,-2506
2020,7,9,4,14790,14862,12295,-2567
2020,7,9,5,14000,14152,11597,-2555
2020,7,9,6,13320,13630,10813,-2817
2020,7,9,7,12550,13165,10314,-2851
2020,7,9,8,12410,12930,10144,-2786
2020,7,9,9,12550,13004,10320,-2684
2020,7,9,10,13180,13372,10758,-2614
2020,7,9,11,14360,14103,11794,-2309
2020,7,9,12,15430,15244,13056,-2188
2020,7,9,13,16200,16255,14225,-2030
2020,7,9,14,16980,16963,15195,-1768
2020,7,9,15,17910,17768,16170,-1598
2020,7,9,16,18800,18692,17340,-1352
2020,7,9,17,19540,19625,17967,-1658
2020,7,9,18,20530,20418,19257,-1161
2020,7,9,19,20840,20963,19531,-1432
2020,7,9,20,21390,21414,20089,-1325
2020,7,9,21,21990,21766,20529,-1237
2020,7,9,22,22500,22231,20779,-1452
2020,7,9,23,22130,22230,20405,-1825
2020,7,10,0,21300,21710,19756,-1954
2020,7,10,1,20580,20878,18906,-1972
2020,7,10,2,19520,19926,17807,-2119
2020,7,10,3,17850,18229,15896,-2333
2020,7,10,4,16160,16526,14166,-2360
2020,7,10,5,14780,15418,12806,-2612
2020,7,10,6,13870,14771,12197,-2574
2020,7,10,7,13520,14408,11694,-2714
2020,7,10,8,13140,14104,11519,-2585
2020,7,10,9,13150,14099,11395,-2704
2020,7,10,10,13650,14224,11632,-2592
2020,7,10,11,14450,15100,12572,-2528
2020,7,10,12,15610,15943,13628,-2315
2020,7,10,13,16480,16525,14583,-1942
2020,7,10,14,17090,17167,15518,-1649
2020,7,10,15,17580,17883,16350,-1533
2020,7,10,16,18340,18658,17042,-1616
2020,7,10,17,18810,19250,17790,-1460
2020,7,10,18,19350,19642,17903,-1739
2020,7,10,19,19690,19646,17886,-1760
2020,7,10,20,19720,19595,17764,-1831
2020,7,10,21,19750,19580,17761,-1819
2020,7,10,22,19630,19514,17461,-2053
2020,7,10,23,19140,19193,17190,-2003
2020,7,11,0,18540,18726,16503,-2223
2020,7,11,1,17920,18319,15761,-2558
2020,7,11,2,17350,17682,15355,-2327
2020,7,11,3,16220,16817,14376,-2441
2020,7,11,4,14950,15606,13006,-2600
2020,7,11,5,14100,14624,12033,-2591
2020,7,11,6,13450,14112,11351,-2761
2020,7,11,7,12880,13905,11182,-2723
2020,7,11,8,12710,13657,10874,-2783
2020,7,11,9,12710,13571,10802,-2769
2020,7,11,10,12720,13683,10927,-2756
2020,7,11,11,13150,13997,11024,-2973
2020,7,11,12,13990,14704,11750,-2954
2020,7,11,13,14890,15119,12433,-2686
2020,7,11,14,15730,15833,13819,-2014
2020,7,11,15,16620,16561,14772,-1789
2020,7,11,16,17310,17516,15714,-1802
2020,7,11,17,17920,18294,16316,-1978
2020,7,11,18,18570,18776,16493,-2283
2020,7,11,19,19110,19235,16663,-2572
2020,7,11,20,19670,19630,16546,-3084
2020,7,11,21,20190,20084,17177,-2907
2020,7,11,22,20460,20352,17450,-2902
2020,7,11,23,20510,20287,17223,-3064
2020,7,12,0,19860,19744,16505,-3239
2020,7,12,1,19170,19256,16154,-3102
2020,7,12,2,18390,18621,15597,-3024
2020,7,12,3,17140,17421,14381,-3040
2020,7,12,4,15790,16142,12841,-3301
2020,7,12,5,14740,15072,11514,-3558
2020,7,12,6,13990,14473,10965,-3508
2020,7,12,7,13380,14011,10585,-3426
2020,7,12,8,13000,14003,10632,-3371
2020,7,12,9,12710,13947,10608,-3339
2020,7,12,10,12560,13774,10472,-3302
2020,7,12,11,12780,13929,10704,-3225
2020,7,12,12,13400,14059,11320,-2739
2020,7,12,13,14180,14336,11596,-2740
2020,7,12,14,14980,15158,12631,-2527
2020,7,12,15,15830,16028,13560,-2468
2020,7,12,16,16530,16694,14518,-2176
2020,7,12,17,17190,17314,14908,-2406
2020,7,12,18,17610,17677,14993,-2684
2020,7,12,19,18110,18057,15693,-2364
2020,7,12,20,18620,18668,16143,-2525
2020,7,12,21,19470,19474,17121,-2353
2020,7,12,22,20050,20412,17801,-2611
2020,7,12,23,20100,20773,17867,-2906
2020,7,13,0,19570,20348,17324,-3024
2020,7,13,1,19000,19689,16772,-2917
2020,7,13,2,18180,18894,16090,-2804
2020,7,13,3,16850,17371,14545,-2826
2020,7,13,4,15420,15838,12721,-3117
2020,7,13,5,14840,14885,11565,-3320
2020,7,13,6,14000,14319,11238,-3081
2020,7,13,7,13390,14058,11315,-2743
2020,7,13,8,13140,14019,11100,-2919
2020,7,13,9,13300,14034,11060,-2974
2020,7,13,10,13720,14080,10971,-3109
2020,7,13,11,14720,14404,11621,-2783
2020,7,13,12,15780,15430,12428,-3002
2020,7,13,13,16560,16283,13567,-2716
2020,7,13,14,17350,16816,14016,-2800
2020,7,13,15,17910,17268,14877,-2391
2020,7,13,16,18750,18034,15589,-2445
2020,7,13,17,19250,18947,16580,-2367
2020,7,13,18,19610,19540,16527,-3013
2020,7,13,19,20170,19526,16441,-3085
2020,7,13,20,20550,19671,16729,-2942
2020,7,13,21,20690,20152,17626,-2526
2020,7,13,22,20840,20632,17744,-2888
2020,7,13,23,20790,20479,17394,-3085
2020,7,14,0,20340,19757,16542,-3215
2020,7,14,1,19530,18982,16002,-2980
2020,7,14,2,18370,18063,15214,-2849
2020,7,14,3,16820,16560,13904,-2656
2020,7,14,4,15030,15076,12056,-3020
2020,7,14,5,13890,13918,10597,-3321
2020,7,14,6,13110,13569,10209,-3360
2020,7,14,7,12570,13370,10106,-3264
2020,7,14,8,12260,13288,10042,-3246
2020,7,14,9,12250,13311,9798,-3513
2020,7,14,10,12650,13690,10268,-3422
2020,7,14,11,13580,14530,11189,-3341
2020,7,14,12,14670,14779,11947,-2832
2020,7,14,13,15410,15399,12785,-2614
2020,7,14,14,15830,15814,13596,-2218
2020,7,14,15,16220,16210,14184,-2026
2020,7,14,16,16620,16610,14303,-2307
2020,7,14,17,17220,17216,14829,-2387
2020,7,14,18,17750,17747,15168,-2579
2020,7,14,19,17820,17823,15288,-2535
2020,7,14,20,18000,17981,15573,-2408
2020,7,14,21,18260,18251,15839,-2412
2020,7,14,22,18270,18278,15939,-2339
2020,7,14,23,18090,18036,15288,-2748
2020,7,15,0,17420,17463,15075,-2388
2020,7,15,1,16930,16913,14475,-2438
2020,7,15,2,16170,16173,13894,-2279
2020,7,15,3,14880,14892,12230,-2662
2020,7,15,4,13470,13883,11191,-2692
2020,7,15,5,12620,12932,10373,-2559
2020,7,15,6,11960,12278,9769,-2509
2020,7,15,7,11530,12324,9689,-2635
2020,7,15,8,11320,12122,9787,-2335
2020,7,15,9,11390,11968,9889,-2079
2020,7,15,10,11850,12177,10048,-2129
2020,7,15,11,12710,12951,10834,-2117
2020,7,15,12,13600,13634,11677,-1957
2020,7,15,13,14250,14238,12382,-1856
2020,7,15,14,14570,14562,12766,-1796
2020,7,15,15,14800,14786,13098,-1688
2020,7,15,16,14980,14978,13314,-1664
2020,7,15,17,15130,15125,13785,-1340
2020,7,15,18,15370,15365,13890,-1475
2020,7,15,19,15400,15399,14131,-1268
2020,7,15,20,15530,15516,14591,-925
2020,7,15,21,15990,15986,14890,-1096
2020,7,15,22,16540,16614,15105,-1509
2020,7,15,23,16560,16823,14868,-1955
2020,7,16,0,16240,16406,14274,-2132
2020,7,16,1,15810,15913,13918,-1995
2020,7,16,2,15170,15302,13013,-2289
2020,7,16,3,14000,14135,11836,-2299
2020,7,16,4,12810,13125,10631,-2494
2020,7,16,5,11910,12419,9850,-2569
2020,7,16,6,11280,12342,9648,-2694
2020,7,16,7,10870,11928,9028,-2900
2020,7,16,8,10650,11703,9267,-2436
2020,7,16,9,10750,11762,9104,-2658
2020,7,16,10,11170,11925,9241,-2684
2020,7,16,11,12050,12455,9708,-2747
2020,7,16,12,12910,13047,10571,-2476
2020,7,16,13,13310,13298,10948,-2350
2020,7,16,14,13440,13435,11802,-1633
2020,7,16,15,13730,13607,12134,-1473
2020,7,16,16,14020,13854,12391,-1463
2020,7,16,17,14390,14277,13021,-1256
2020,7,16,18,14800,14691,13348,-1343
2020,7,16,19,14990,15092,13277,-1815
2020,7,16,20,15210,15449,13832,-1617
2020,7,16,21,15470,15922,14102,-1820
2020,7,16,22,15900,16215,14343,-1872
2020,7,16,23,15740,16096,13995,-2101
2020,7,17,0,15620,15586,13380,-2206
2020,7,17,1,15420,15228,13038,-2190
2020,7,17,2,14850,14631,12115,-2516
2020,7,17,3,13620,13476,10807,-2669
2020,7,17,4,12420,12331,9935,-2396
2020,7,17,5,11390,11455,9415,-2040
2020,7,17,6,10860,11056,8910,-2146
2020,7,17,7,10520,10750,8712,-2038
2020,7,17,8,10360,10594,8728,-1866
2020,7,17,9,10450,10636,8584,-2052
2020,7,17,10,11070,10987,8931,-2056
2020,7,17,11,11910,11867,9873,-1994
2020,7,17,12,12800,12844,10516,-2328
2020,7,17,13,13490,13631,11396,-2235
2020,7,17,14,14150,14110,12040,-2070
2020,7,17,15,14350,14468,12266,-2202
2020,7,17,16,14610,14678,12638,-2040
2020,7,17,17,14770,14744,12690,-2054
2020,7,17,18,15000,14729,12745,-1984
2020,7,17,19,15190,14664,12819,-1845
2020,7,17,20,15300,14664,12670,-1994
2020,7,17,21,15550,14838,13450,-1388
2020,7,17,22,16100,15256,13842,-1414
2020,7,17,23,15970,15550,13783,-1767
2020,7,18,0,15880,15515,13636,-1879
2020,7,18,1,15700,15401,13257,-2144
2020,7,18,2,15290,15078,12784,-2294
2020,7,18,3,14530,14128,11748,-2380
2020,7,18,4,13700,13074,10616,-2458
2020,7,18,5,12180,12340,9702,-2638
2020,7,18,6,11580,11941,9845,-2096
2020,7,18,7,11200,11620,9815,-1805
2020,7,18,8,10950,10956,9559,-1397
2020,7,18,9,10900,10960,9436,-1524
2020,7,18,10,10970,11215,9581,-1634
2020,7,18,11,11340,11469,9739,-1730
2020,7,18,12,12050,12033,10209,-1824
2020,7,18,13,12900,12891,11212,-1679
2020,7,18,14,13800,13770,12165,-1605
2020,7,18,15,14610,14679,12960,-1719
2020,7,18,16,15450,15625,14221,-1404
2020,7,18,17,16590,16399,14976,-1423
2020,7,18,18,17240,17032,15477,-1555
2020,7,18,19,18160,17630,15801,-1829
2020,7,18,20,18750,18369,16341,-2028
2020,7,18,21,19490,19208,17146,-2062
2020,7,18,22,20080,20012,17830,-2182
2020,7,18,23,20250,20269,17850,-2419
2020,7,19,0,19630,19698,17023,-2675
2020,7,19,1,19270,18977,16149,-2828
2020,7,19,2,18480,18236,15559,-2677
2020,7,19,3,17140,16892,14215,-2677
2020,7,19,4,15690,15485,12449,-3036
2020,7,19,5,13940,14296,11075,-3221
2020,7,19,6,13390,13639,10684,-2955
2020,7,19,7,12740,13243,10400,-2843
2020,7,19,8,12230,12803,10326,-2477
2020,7,19,9,11930,12561,10146,-2415
2020,7,19,10,11870,12196,10093,-2103
2020,7,19,11,12050,12625,10317,-2308
2020,7,19,12,12720,13338,10926,-2412
2020,7,19,13,13920,13892,11445,-2447
2020,7,19,14,15270,14974,13142,-1832
2020,7,19,15,16630,16200,14345,-1855
2020,7,19,16,17540,17469,15658,-1811
2020,7,19,17,18640,18539,16654,-1885
2020,7,19,18,19490,19328,17395,-1933
2020,7,19,19,20110,19991,17891,-2100
2020,7,19,20,20730,20749,18322,-2427
2020,7,19,21,21460,21570,18846,-2724
2020,7,19,22,22000,22339,19443,-2896
2020,7,19,23,22150,22340,18937,-3403
2020,7,20,0,21510,21757,18553,-3204
2020,7,20,1,20970,21215,18047,-3168
2020,7,20,2,20160,20293,17344,-2949
2020,7,20,3,18490,18688,15545,-3143
2020,7,20,4,16810,17398,14269,-3129
2020,7,20,5,15860,16230,12989,-3241
2020,7,20,6,15060,15878,12566,-3312
2020,7,20,7,14530,15644,12309,-3335
2020,7,20,8,14300,15377,11979,-3398
2020,7,20,9,14390,15456,12101,-3355
2020,7,20,10,14910,15687,12494,-3193
2020,7,20,11,15990,16113,13140,-2973
2020,7,20,12,17260,17252,14287,-2965
2020,7,20,13,18370,18346,15826,-2520
2020,7,20,14,18940,18941,16373,-2568
2020,7,20,15,19550,19556,17435,-2121
2020,7,20,16,20360,20378,17824,-2554
2020,7,20,17,20940,21301,18783,-2518
2020,7,20,18,21880,22225,19389,-2836
2020,7,20,19,22440,22783,19640,-3143
2020,7,20,20,22810,23105,19754,-3351
2020,7,20,21,23350,23357,19797,-3560
2020,7,20,22,24500,23838,20320,-3518
2020,7,20,23,24080,23824,20641,-3183
2020,7,21,0,23350,23283,20103,-3180
2020,7,21,1,22530,22373,19225,-3148
2020,7,21,2,21310,21122,17909,-3213
2020,7,21,3,19300,19211,16021,-3190
2020,7,21,4,17430,17358,14000,-3358
2020,7,21,5,15880,15969,12990,-2979
2020,7,21,6,14820,15321,12361,-2960
2020,7,21,7,14060,14774,11862,-2912
2020,7,21,8,13600,14575,11697,-2878
2020,7,21,9,13470,14508,11480,-3028
2020,7,21,10,13750,14518,11472,-3046
2020,7,21,11,14670,15286,12366,-2920
2020,7,21,12,15820,16182,13151,-3031
2020,7,21,13,16710,16696,14116,-2580
2020,7,21,14,17520,17339,15046,-2293
2020,7,21,15,18290,18324,16628,-1696
2020,7,21,16,18940,19027,17187,-1840
2020,7,21,17,19700,19750,18001,-1749
2020,7,21,18,20460,20519,18743,-1776
2020,7,21,19,20790,20956,18715,-2241
2020,7,21,20,21030,21446,19261,-2185
2020,7,21,21,21610,21983,20091,-1892
2020,7,21,22,21710,22556,20316,-2240
2020,7,21,23,21540,22561,19425,-3136
2020,7,22,0,20820,21855,18391,-3464
2020,7,22,1,20350,20906,17558,-3348
2020,7,22,2,19230,19725,16935,-2790
2020,7,22,3,17670,17918,14901,-3017
2020,7,22,4,15770,16238,12955,-3283
2020,7,22,5,14940,14960,11990,-2970
2020,7,22,6,14050,14262,11295,-2967
2020,7,22,7,13430,13997,11214,-2783
2020,7,22,8,13120,13893,11377,-2516
2020,7,22,9,13140,14145,11333,-2812
2020,7,22,10,13680,14642,11815,-2827
2020,7,22,11,14750,15340,12492,-2848
2020,7,22,12,15800,16322,13193,-3129
2020,7,22,13,16300,16587,13769,-2818
2020,7,22,14,17000,16674,14210,-2464
2020,7,22,15,17340,17085,14825,-2260
2020,7,22,16,17940,17559,15244,-2315
2020,7,22,17,18500,18026,15849,-2177
2020,7,22,18,19020,18539,16246,-2293
2020,7,22,19,19440,19044,16893,-2151
2020,7,22,20,19840,19773,17705,-2068
2020,7,22,21,20250,20445,18299,-2146
2020,7,22,22,20550,20960,18671,-2289
2020,7,22,23,20350,20656,17881,-2775
2020,7,23,0,19950,20062,17208,-2854
2020,7,23,1,19380,19487,16323,-3164
2020,7,23,2,18460,18418,15424,-2994
2020,7,23,3,17000,16953,14080,-2873
2020,7,23,4,15550,15744,12875,-2869
2020,7,23,5,14530,15074,12075,-2999
2020,7,23,6,13830,14460,11715,-2745
2020,7,23,7,13390,14146,11139,-3007
2020,7,23,8,13170,14165,11524,-2641
2020,7,23,9,13260,14305,11808,-2497
2020,7,23,10,13990,14868,11926,-2942
2020,7,23,11,15040,15642,12848,-2794
2020,7,23,12,16040,16137,13289,-2848
2020,7,23,13,16720,16807,13922,-2885
2020,7,23,14,17510,17384,14778,-2606
2020,7,23,15,18240,18294,15824,-2470
2020,7,23,16,19760,19585,17088,-2497
2020,7,23,17,20530,20616,17375,-3241
2020,7,23,18,21070,21312,17660,-3652
2020,7,23,19,21380,21335,17845,-3490
2020,7,23,20,21730,21617,18506,-3111
2020,7,23,21,21950,21481,18875,-2606
2020,7,23,22,22010,21130,18244,-2886
2020,7,23,23,21710,20700,17489,-3211
2020,7,24,0,20930,20119,16941,-3178
2020,7,24,1,20280,19584,16697,-2887
2020,7,24,2,19250,18642,15829,-2813
2020,7,24,3,17660,17197,14379,-2818
2020,7,24,4,16080,15995,13053,-2942
2020,7,24,5,14610,15140,12313,-2827
2020,7,24,6,13820,14557,11847,-2710
2020,7,24,7,13280,14351,11735,-2616
2020,7,24,8,13000,14043,11411,-2632
2020,7,24,9,12960,14035,11531,-2504
2020,7,24,10,13600,14255,11936,-2319
2020,7,24,11,14620,14645,12346,-2299
2020,7,24,12,15710,15329,13086,-2243
2020,7,24,13,16530,15774,13748,-2026
2020,7,24,14,16190,16250,14310,-1940
2020,7,24,15,16630,16583,14532,-2051
2020,7,24,16,17130,17461,15133,-2328
2020,7,24,17,17730,18001,15659,-2342
2020,7,24,18,18140,18291,15876,-2415
2020,7,24,19,18580,18663,16183,-2480
2020,7,24,20,19030,18985,16607,-2378
2020,7,24,21,19330,19265,16754,-2511
2020,7,24,22,19700,19501,16827,-2674
2020,7,24,23,19530,19315,16496,-2819
2020,7,25,0,18930,18817,15956,-2861
2020,7,25,1,18170,18303,15685,-2618
2020,7,25,2,17420,17561,15144,-2417
2020,7,25,3,16070,16219,13529,-2690
2020,7,25,4,14700,14819,12314,-2505
2020,7,25,5,13660,13932,11052,-2880
2020,7,25,6,12850,13471,10833,-2638
2020,7,25,7,12280,13299,10529,-2770
2020,7,25,8,11910,12973,10299,-2674
2020,7,25,9,11750,12792,10187,-2605
2020,7,25,10,11750,12786,10204,-2582
2020,7,25,11,12080,13105,10322,-2783
2020,7,25,12,12840,13564,11181,-2383
2020,7,25,13,13760,13988,11748,-2240
2020,7,25,14,14640,14603,12485,-2118
2020,7,25,15,15520,15508,13381,-2127
2020,7,25,16,16520,16486,14361,-2125
2020,7,25,17,17330,17316,15088,-2228
2020,7,25,18,17830,17824,15436,-2388
2020,7,25,19,18330,18332,16163,-2169
2020,7,25,20,18910,18896,16347,-2549
2020,7,25,21,19550,19537,16827,-2710
2020,7,25,22,20170,20180,17350,-2830
2020,7,25,23,20090,20251,17195,-3056
2020,7,26,0,19370,19788,16551,-3237
2020,7,26,1,18630,19211,16301,-2910
2020,7,26,2,17930,18425,15772,-2653
2020,7,26,3,16670,17095,14646,-2449
2020,7,26,4,15390,15717,13013,-2704
2020,7,26,5,14590,14612,11651,-2961
2020,7,26,6,13800,13937,11116,-2821
2020,7,26,7,13250,14001,11031,-2970
2020,7,26,8,12890,13687,10784,-2903
2020,7,26,9,12670,13688,10615,-3073
2020,7,26,10,12590,13615,10504,-3111
2020,7,26,11,12760,13542,10391,-3151
2020,7,26,12,13400,13914,10957,-2957
2020,7,26,13,14350,14430,11602,-2828
2020,7,26,14,15290,15267,12578,-2689
2020,7,26,15,16290,16261,13726,-2535
2020,7,26,16,17240,17209,14927,-2282
2020,7,26,17,17920,17904,15361,-2543
2020,7,26,18,18550,18536,15776,-2760
2020,7,26,19,19220,19220,16193,-3027
2020,7,26,20,20170,20141,16984,-3157
2020,7,26,21,20920,20899,17611,-3288
2020,7,26,22,21550,21342,17793,-3549
2020,7,26,23,21600,21424,17787,-3637
2020,7,27,0,21080,20991,17409,-3582
2020,7,27,1,20480,20557,17189,-3368
2020,7,27,2,19530,19686,16518,-3168
2020,7,27,3,17960,18110,14738,-3372
2020,7,27,4,16420,16582,13258,-3324
2020,7,27,5,15340,15554,12487,-3067
2020,7,27,6,14530,15052,12324,-2728
2020,7,27,7,13980,14524,11788,-2736
2020,7,27,8,13690,14369,11419,-2950
2020,7,27,9,13730,14509,11467,-3042
2020,7,27,10,14400,14712,11862,-2850
2020,7,27,11,15430,15492,12623,-2869
2020,7,27,12,16750,16608,13678,-2930
2020,7,27,13,17980,17765,15006,-2759
2020,7,27,14,18830,18740,16185,-2555
2020,7,27,15,19990,19769,17040,-2729
2020,7,27,16,21480,20831,17665,-3166
2020,7,27,17,22490,21870,18349,-3521
2020,7,27,18,23420,22761,19093,-3668
2020,7,27,19,23980,23413,19954,-3459
2020,7,27,20,24540,23897,20338,-3559
2020,7,27,21,24930,24125,20678,-3447
2020,7,27,22,25350,24697,21524,-3173
2020,7,27,23,25500,24659,21452,-3207
2020,7,28,0,24330,24158,20865,-3293
2020,7,28,1,23630,23412,19582,-3830
2020,7,28,2,22320,22295,18486,-3809
2020,7,28,3,20330,20573,16801,-3772
2020,7,28,4,18500,19078,15795,-3283
2020,7,28,5,17480,18052,14543,-3509
2020,7,28,6,16570,17616,14233,-3383
2020,7,28,7,15930,17012,13892,-3120
2020,7,28,8,15580,16616,13473,-3143
2020,7,28,9,15530,16569,13488,-3081
2020,7,28,10,15950,16974,13891,-3083
2020,7,28,11,16970,17963,14771,-3192
2020,7,28,12,18430,19015,15833,-3182
2020,7,28,13,19710,19796,16519,-3277
2020,7,28,14,20520,20757,17500,-3257
2020,7,28,15,21590,21731,18347,-3384
2020,7,28,16,22580,22538,19234,-3304
2020,7,28,17,23290,23198,19848,-3350
2020,7,28,18,23890,23766,20404,-3362
2020,7,28,19,24090,23946,20619,-3327
2020,7,28,20,24180,23992,20476,-3516
2020,7,28,21,24300,24049,20696,-3353
2020,7,28,22,24140,24174,20420,-3754
2020,7,28,23,23840,23961,20137,-3824
2020,7,29,0,23010,23072,19189,-3883
2020,7,29,1,22270,22020,18083,-3937
2020,7,29,2,21120,20737,17120,-3617
2020,7,29,3,19080,19140,15653,-3487
2020,7,29,4,17290,17813,14461,-3352
2020,7,29,5,15710,16553,13284,-3269
2020,7,29,6,14710,15541,12617,-2924
2020,7,29,7,14000,14820,12036,-2784
2020,7,29,8,13530,14455,11501,-2954
2020,7,29,9,13380,14428,11596,-2832
2020,7,29,10,13690,14716,11921,-2795
2020,7,29,11,14460,15050,12252,-2798
2020,7,29,12,15530,15989,13174,-2815
2020,7,29,13,16390,16376,13755,-2621
2020,7,29,14,17080,17090,14444,-2646
2020,7,29,15,18090,17863,15667,-2196
2020,7,29,16,18860,18913,16984,-1929
2020,7,29,17,19770,19834,17944,-1890
2020,7,29,18,20510,20571,17989,-2582
2020,7,29,19,21230,21143,18698,-2445
2020,7,29,20,21870,21474,18680,-2794
2020,7,29,21,22280,22011,19419,-2592
2020,7,29,22,22620,22592,19814,-2778
2020,7,29,23,22800,22550,19147,-3403
2020,7,30,0,21760,21775,18334,-3441
2020,7,30,1,21310,21028,17876,-3152
2020,7,30,2,20130,19963,17189,-2774
2020,7,30,3,18300,18337,15475,-2862
2020,7,30,4,16620,16781,13851,-2930
2020,7,30,5,15310,15624,12862,-2762
2020,7,30,6,14440,15104,12479,-2625
2020,7,30,7,13850,14811,11934,-2877
2020,7,30,8,13880,14687,11878,-2809
2020,7,30,9,13880,14696,11961,-2735
2020,7,30,10,14330,15186,12234,-2952
2020,7,30,11,15240,15555,12942,-2613
2020,7,30,12,16340,16391,13464,-2927
2020,7,30,13,17070,17095,14240,-2855
2020,7,30,14,17820,17624,14970,-2654
2020,7,30,15,18510,18481,16171,-2310
2020,7,30,16,19170,19538,16896,-2642
2020,7,30,17,19910,20563,17856,-2707
2020,7,30,18,20750,21106,18456,-2650
2020,7,30,19,21130,21647,18566,-3081
2020,7,30,20,21760,22013,18746,-3267
2020,7,30,21,22030,22078,18917,-3161
2020,7,30,22,22240,22033,18724,-3309
2020,7,30,23,22020,21457,18069,-3388
2020,7,31,0,21220,20727,17359,-3368
2020,7,31,1,20430,20215,17127,-3088
2020,7,31,2,19380,19222,16291,-2931
2020,7,31,3,17760,17681,14569,-3112
2020,7,31,4,16180,16159,12925,-3234
2020,7,31,5,14850,15038,11911,-3127
2020,7,31,6,14040,14730,11522,-3208
2020,7,31,7,13370,14394,11162,-3232
2020,7,31,8,13190,14258,11251,-3007
2020,7,31,9,13150,14196,11292,-2904
2020,7,31,10,13530,14317,11114,-3203
2020,7,31,11,14320,14868,11734,-3134
2020,7,31,12,15290,15384,12286,-3098
2020,7,31,13,15860,15811,12993,-2818
2020,7,31,14,16470,16160,13346,-2814
2020,7,31,15,16910,16467,13563,-2904
2020,7,31,16,17480,16939,14260,-2679
2020,7,31,17,18070,17353,14828,-2525
2020,7,31,18,18610,17949,15317,-2632
2020,7,31,19,18990,18444,15994,-2450
2020,7,31,20,19320,19035,16410,-2625
2020,7,31,21,19550,19713,17124,-2589
2020,7,31,22,19800,20283,17651,-2632
2020,7,31,23,19650,20271,17211,-3060
2020,8,1,0,19130,19563,16430,-3133
2020,8,1,1,18510,18848,15724,-3124
2020,8,1,2,17670,17958,14893,-3065
2020,8,1,3,16310,16548,13397,-3151
2020,8,1,4,14940,15113,12014,-3099
2020,8,1,5,13910,13940,10701,-3239
2020,8,1,6,13070,13414,10232,-3182
2020,8,1,7,12450,13215,10099,-3116
2020,8,1,8,12060,13128,10248,-2880
2020,8,1,9,11910,12960,10036,-2924
2020,8,1,10,11900,12960,9957,-3003
2020,8,1,11,12220,13264,10205,-3059
2020,8,1,12,12920,13721,11089,-2632
2020,8,1,13,13650,13976,11089,-2887
2020,8,1,14,14400,14379,11414,-2965
2020,8,1,15,15170,15148,12258,-2890
2020,8,1,16,16010,15996,13087,-2909
2020,8,1,17,16810,16788,13944,-2844
2020,8,1,18,17350,17428,14359,-3069
2020,8,1,19,17760,18020,14533,-3487
2020,8,1,20,18310,18651,14939,-3712
2020,8,1,21,18890,19367,15825,-3542
2020,8,1,22,19250,20009,16862,-3147
2020,8,1,23,19120,20162,16751,-3411
2020,8,2,0,18560,19510,16135,-3375
2020,8,2,1,18370,18958,15067,-3891
2020,8,2,2,17490,18222,14399,-3823
2020,8,2,3,16260,17023,13608,-3415
2020,8,2,4,15080,15713,12847,-2866
2020,8,2,5,14530,14595,12059,-2536
2020,8,2,6,13720,14121,11691,-2430
2020,8,2,7,13180,14013,11461,-2552
2020,8,2,8,12810,13876,10861,-3015
2020,8,2,9,12600,13702,10454,-3248
2020,8,2,10,12460,13652,10387,-3265
2020,8,2,11,12590,13851,10664,-3187
2020,8,2,12,13090,14437,11485,-2952
2020,8,2,13,13680,15135,12036,-3099
2020,8,2,14,14460,15640,12523,-3117
2020,8,2,15,15270,16306,13207,-3099
2020,8,2,16,16130,16699,13658,-3041
2020,8,2,17,16920,17391,14169,-3222
2020,8,2,18,17490,17497,14400,-3097
2020,8,2,19,17990,17927,14811,-3116
2020,8,2,20,18490,18482,15292,-3190
2020,8,2,21,19170,18852,15710,-3142
2020,8,2,22,19850,19183,16138,-3045
2020,8,2,23,20040,19236,16117,-3119
2020,8,3,0,19640,19081,15902,-3179
2020,8,3,1,19320,19024,15873,-3151
2020,8,3,2,18440,18479,15170,-3309
2020,8,3,3,17100,17454,14173,-3281
2020,8,3,4,15790,16649,13533,-3116
2020,8,3,5,15460,16267,12949,-3318
2020,8,3,6,14870,15769,12535,-3234
2020,8,3,7,14510,15575,12311,-3264
2020,8,3,8,14330,15393,12281,-3112
2020,8,3,9,14500,15507,12389,-3118
2020,8,3,10,14660,16079,12848,-3231
2020,8,3,11,15680,16925,13653,-3272
2020,8,3,12,16880,17604,14274,-3330
2020,8,3,13,17660,18246,14706,-3540
2020,8,3,14,18210,18790,15276,-3514
2020,8,3,15,18970,19309,15792,-3517
2020,8,3,16,19740,19865,16251,-3614
2020,8,3,17,20350,20431,16847,-3584
2020,8,3,18,20980,21009,17460,-3549
2020,8,3,19,21500,21423,18323,-3100
2020,8,3,20,22080,21899,19055,-2844
2020,8,3,21,22690,22324,19532,-2792
2020,8,3,22,23170,22824,19888,-2936
2020,8,3,23,22720,22716,19508,-3208
2020,8,4,0,21970,22015,18572,-3443
2020,8,4,1,21420,21296,17651,-3645
2020,8,4,2,20180,20107,16735,-3372
2020,8,4,3,18420,18369,14702,-3667
2020,8,4,4,16760,16915,13301,-3614
2020,8,4,5,14990,15784,11984,-3800
2020,8,4,6,14170,15181,11754,-3427
2020,8,4,7,13740,15052,11732,-3320
2020,8,4,8,13520,14822,11568,-3254
2020,8,4,9,13590,14861,11540,-3321
2020,8,4,10,14140,15170,11941,-3229
2020,8,4,11,15350,15539,12434,-3105
2020,8,4,12,16460,16326,13151,-3175
2020,8,4,13,17210,17234,13965,-3269
2020,8,4,14,17670,17883,14660,-3223
2020,8,4,15,18280,18657,15477,-3180
2020,8,4,16,18670,19404,15869,-3535
2020,8,4,17,19240,19745,16176,-3569
2020,8,4,18,19330,20005,16318,-3687
2020,8,4,19,19280,19545,15961,-3584
2020,8,4,20,19120,18803,15260,-3543
2020,8,4,21,17800,17843,14738,-3105
2020,8,4,22,17470,17131,14039,-3092
2020,8,4,23,14620,16489,13621,-2868
2020,8,5,0,14730,15757,12864,-2893
2020,8,5,1,14420,15299,12243,-3056
2020,8,5,2,13580,14694,11784,-2910
2020,8,5,3,12420,13710,10749,-2961
2020,8,5,4,11590,12742,9740,-3002
2020,8,5,5,11940,12461,9449,-3012
2020,8,5,6,11440,12248,9107,-3141
2020,8,5,7,11110,12129,9149,-2980
2020,8,5,8,10980,12021,9206,-2815
2020,8,5,9,11100,12139,9235,-2904
2020,8,5,10,11580,12329,9127,-3202
2020,8,5,11,12540,12968,9729,-3239
2020,8,5,12,13650,13784,10388,-3396
2020,8,5,13,14500,14476,11022,-3454
2020,8,5,14,15190,15167,11744,-3423
2020,8,5,15,15950,15937,12731,-3206
2020,8,5,16,16850,16825,13704,-3121
2020,8,5,17,17490,17483,14540,-2943
2020,8,5,18,18060,18032,14970,-3062
2020,8,5,19,18440,18438,15460,-2978
2020,8,5,20,19000,18831,15713,-3118
2020,8,5,21,19200,19295,16432,-2863
2020,8,5,22,19490,19704,16583,-3121
2020,8,5,23,19250,19573,16525,-3048
2020,8,6,0,18560,18827,15612,-3215
2020,8,6,1,18010,18182,14814,-3368
2020,8,6,2,17120,17108,13697,-3411
2020,8,6,3,15580,15640,12155,-3485
2020,8,6,4,14050,14313,11072,-3241
2020,8,6,5,12880,13162,10190,-2972
2020,8,6,6,12060,12554,9679,-2875
2020,8,6,7,11500,12219,9233,-2986
2020,8,6,8,11140,11887,8611,-3276
2020,8,6,9,11100,11839,8595,-3244
2020,8,6,10,11480,12196,8775,-3421
2020,8,6,11,12230,12613,9769,-2844
2020,8,6,12,13120,13084,10109,-2975
2020,8,6,13,13700,13659,10671,-2988
2020,8,6,14,14070,14054,10687,-3367
2020,8,6,15,14850,14517,11242,-3275
2020,8,6,16,15320,15098,11728,-3370
2020,8,6,17,15800,15535,12305,-3230
2020,8,6,18,16340,16058,12629,-3429
2020,8,6,19,16610,16245,12776,-3469
2020,8,6,20,17210,16521,13150,-3371
2020,8,6,21,17710,16918,13556,-3362
2020,8,6,22,18020,17522,14274,-3248
2020,8,6,23,18000,17639,14030,-3609
2020,8,7,0,17450,17134,13540,-3594
2020,8,7,1,17110,16721,13071,-3650
2020,8,7,2,16220,15902,12314,-3588
2020,8,7,3,14860,14535,11095,-3440
2020,8,7,4,13480,13262,10185,-3077
2020,8,7,5,12380,12297,9353,-2944
2020,8,7,6,11690,11892,9440,-2452
2020,8,7,7,11260,11711,9269,-2442
2020,8,7,8,11020,11487,9168,-2319
2020,8,7,9,11090,11541,9394,-2147
2020,8,7,10,11610,12004,9653,-2351
2020,8,7,11,12400,12640,9685,-2955
2020,8,7,12,13290,13075,10020,-3055
2020,8,7,13,13930,13829,10748,-3081
2020,8,7,14,14380,14265,11302,-2963
2020,8,7,15,14630,14457,11535,-2922
2020,8,7,16,14860,14525,11590,-2935
2020,8,7,17,15210,14944,12297,-2647
2020,8,7,18,15710,15531,13212,-2319
2020,8,7,19,16070,15894,13005,-2889
2020,8,7,20,16300,16066,13727,-2339
2020,8,7,21,16640,16353,13972,-2381
2020,8,7,22,16910,16706,14054,-2652
2020,8,7,23,16950,16698,13752,-2946
2020,8,8,0,16300,16314,13490,-2824
2020,8,8,1,16010,16067,13314,-2753
2020,8,8,2,15360,15382,12499,-2883
2020,8,8,3,14310,14250,11302,-2948
2020,8,8,4,13160,13143,10340,-2803
2020,8,8,5,12250,12479,10075,-2404
2020,8,8,6,11610,11921,9611,-2310
2020,8,8,7,11220,11765,9186,-2579
2020,8,8,8,10980,11525,9183,-2342
2020,8,8,9,10910,11449,9272,-2177
2020,8,8,10,11060,11605,9487,-2118
2020,8,8,11,11360,12124,9804,-2320
2020,8,8,12,11850,12254,9708,-2546
2020,8,8,13,12560,12821,10160,-2661
2020,8,8,14,13200,13322,10703,-2619
2020,8,8,15,13630,13623,10968,-2655
2020,8,8,16,13820,13818,11144,-2674
2020,8,8,17,14250,14233,12050,-2183
2020,8,8,18,14860,14844,12507,-2337
2020,8,8,19,15570,15550,13199,-2351
2020,8,8,20,16330,16300,13377,-2923
2020,8,8,21,16930,17092,13936,-3156
2020,8,8,22,17570,17769,14822,-2947
2020,8,8,23,18000,17968,14912,-3056
2020,8,9,0,17450,17438,14128,-3310
2020,8,9,1,17010,17071,13694,-3377
2020,8,9,2,16110,16338,12863,-3475
2020,8,9,3,14940,15238,12028,-3210
2020,8,9,4,13900,14318,11431,-2887
2020,8,9,5,13090,13525,10392,-3133
2020,8,9,6,12400,13197,10115,-3082
2020,8,9,7,11900,12978,9880,-3098
2020,8,9,8,11610,12660,10154,-2506
2020,8,9,9,11460,12514,9629,-2885
2020,8,9,10,11480,12534,9627,-2907
2020,8,9,11,11660,12690,9713,-2977
2020,8,9,12,12180,13199,10461,-2738
2020,8,9,13,12970,13628,11124,-2504
2020,8,9,14,13780,13974,11657,-2317
2020,8,9,15,14800,14770,12493,-2277
2020,8,9,16,16080,16063,14036,-2027
2020,8,9,17,17210,17191,14731,-2460
2020,8,9,18,17800,17793,14943,-2850
2020,8,9,19,18210,18223,15371,-2852
2020,8,9,20,18920,18892,16174,-2718
2020,8,9,21,19670,19630,16839,-2791
2020,8,9,22,20290,20321,17596,-2725
2020,8,9,23,20570,20409,17240,-3169
2020,8,10,0,20040,19904,16707,-3197
2020,8,10,1,19730,19518,16094,-3424
2020,8,10,2,18610,18595,15311,-3284
2020,8,10,3,17000,17153,14056,-3097
2020,8,10,4,15360,15724,12589,-3135
2020,8,10,5,14610,15310,11896,-3414
2020,8,10,6,13840,14940,11762,-3178
2020,8,10,7,13350,14425,11126,-3299
2020,8,10,8,13090,14166,10939,-3227
2020,8,10,9,13150,14201,11211,-2990
2020,8,10,10,13680,14707,11549,-3158
2020,8,10,11,14600,15444,12343,-3101
2020,8,10,12,15820,16346,13025,-3321
2020,8,10,13,16820,16943,13818,-3125
2020,8,10,14,17700,17665,14879,-2786
2020,8,10,15,18560,18648,15706,-2942
2020,8,10,16,19470,19742,16802,-2940
2020,8,10,17,20320,20807,17735,-3072
2020,8,10,18,21320,21619,18580,-3039
2020,8,10,19,21960,22122,19417,-2705
2020,8,10,20,22530,22634,19976,-2658
2020,8,10,21,22910,23145,20567,-2578
2020,8,10,22,23500,23696,20893,-2803
2020,8,10,23,23240,23473,20170,-3303
2020,8,11,0,22530,22745,19248,-3497
2020,8,11,1,21880,22079,18310,-3769
2020,8,11,2,20450,20750,17047,-3703
2020,8,11,3,18650,19613,15846,-3767
2020,8,11,4,17050,18161,14487,-3674
2020,8,11,5,15730,17168,13912,-3256
2020,8,11,6,15050,16337,13040,-3297
2020,8,11,7,14410,15694,12260,-3434
2020,8,11,8,14130,15304,11839,-3465
2020,8,11,9,14190,15286,12110,-3176
2020,8,11,10,14710,15743,12417,-3326
2020,8,11,11,15730,16638,13417,-3221
2020,8,11,12,17020,17687,14575,-3112
2020,8,11,13,17910,18511,15465,-3046
2020,8,11,14,19040,19179,16469,-2710
2020,8,11,15,19990,20090,17249,-2841
2020,8,11,16,20960,21186,18147,-3039
2020,8,11,17,21780,22122,18731,-3391
2020,8,11,18,22500,22616,19054,-3562
2020,8,11,19,22940,23023,19602,-3421
2020,8,11,20,23210,23422,20024,-3398
2020,8,11,21,23540,23611,20469,-3142
2020,8,11,22,24100,23970,20952,-3018
2020,8,11,23,23760,23730,20446,-3284
2020,8,12,0,23110,23104,19335,-3769
2020,8,12,1,22320,22395,18631,-3764
2020,8,12,2,20950,21067,17443,-3624
2020,8,12,3,19200,19621,16017,-3604
2020,8,12,4,17400,18160,14580,-3580
2020,8,12,5,16670,17535,13715,-3820
2020,8,12,6,15900,16986,13200,-3786
2020,8,12,7,15370,16447,12938,-3509
2020,8,12,8,15090,16161,12632,-3529
2020,8,12,9,15130,16177,12714,-3463
2020,8,12,10,15640,16654,13177,-3477
2020,8,12,11,16530,17200,13882,-3318
2020,8,12,12,17600,17578,14388,-3190
2020,8,12,13,18530,18515,15312,-3203
2020,8,12,14,19250,19252,16040,-3212
2020,8,12,15,19880,20026,16733,-3293
2020,8,12,16,20600,20797,17272,-3525
2020,8,12,17,21660,21638,17901,-3737
2020,8,12,18,22240,22543,18911,-3632
2020,8,12,19,22750,22995,19631,-3364
2020,8,12,20,23060,23181,19721,-3460
2020,8,12,21,23200,23538,20294,-3244
2020,8,12,22,23400,23886,20297,-3589
2020,8,12,23,23390,23783,20181,-3602
2020,8,13,0,22620,23035,19125,-3910
2020,8,13,1,21930,22271,18397,-3874
2020,8,13,2,20660,20876,16985,-3891
2020,8,13,3,18890,19037,15141,-3896
2020,8,13,4,17210,17303,13587,-3716
2020,8,13,5,15770,16225,12757,-3468
2020,8,13,6,14770,15627,12149,-3478
2020,8,13,7,14140,15282,11935,-3347
2020,8,13,8,13820,14994,11543,-3451
2020,8,13,9,13800,14865,11432,-3433
2020,8,13,10,14210,15194,11985,-3209
2020,8,13,11,15210,15558,12430,-3128
2020,8,13,12,16230,15958,12819,-3139
2020,8,13,13,16690,16764,13711,-3053
2020,8,13,14,17470,17489,14607,-2882
2020,8,13,15,17930,18133,14733,-3400
2020,8,13,16,18550,18839,15463,-3376
2020,8,13,17,19420,19492,15961,-3531
2020,8,13,18,19940,20051,16531,-3520
2020,8,13,19,20420,20263,16941,-3322
2020,8,13,20,20660,20481,17265,-3216
2020,8,13,21,20920,20606,17489,-3117
2020,8,13,22,21250,20601,17342,-3259
2020,8,13,23,20800,20272,16974,-3298
2020,8,14,0,19770,19753,16056,-3697
2020,8,14,1,19190,19383,15688,-3695
2020,8,14,2,18200,18328,14685,-3643
2020,8,14,3,16630,16835,13118,-3717
2020,8,14,4,15070,15595,12065,-3530
2020,8,14,5,14110,14932,11406,-3526
2020,8,14,6,13380,14462,11052,-3410
2020,8,14,7,12730,13890,10401,-3489
2020,8,14,8,12440,13559,10602,-2957
2020,8,14,9,12620,13556,10697,-2859
2020,8,14,10,13140,13956,10993,-2963
2020,8,14,11,14100,14689,11704,-2985
2020,8,14,12,15070,15622,12363,-3259
2020,8,14,13,15610,15879,12590,-3289
2020,8,14,14,16240,15816,13092,-2724
2020,8,14,15,16650,16434,13980,-2454
2020,8,14,16,17160,17202,14761,-2441
2020,8,14,17,17600,17713,15185,-2528
2020,8,14,18,18520,18366,15596,-2770
2020,8,14,19,18850,18887,16183,-2704
2020,8,14,20,19240,19259,16199,-3060
2020,8,14,21,19420,19567,16676,-2891
2020,8,14,22,19600,19807,16729,-3078
2020,8,14,23,19270,19417,15939,-3478
2020,8,15,0,18570,18668,15068,-3600
2020,8,15,1,18000,18109,14747,-3362
2020,8,15,2,17000,17023,14137,-2886
2020,8,15,3,15550,15635,12801,-2834
2020,8,15,4,14240,14504,11327,-3177
2020,8,15,5,12780,13399,10164,-3235
2020,8,15,6,12170,12625,9733,-2892
2020,8,15,7,11550,12069,9144,-2925
2020,8,15,8,11110,11977,8995,-2982
2020,8,15,9,10950,11874,8846,-3028
2020,8,15,10,10990,12000,8762,-3238
2020,8,15,11,11120,12124,8998,-3126
2020,8,15,12,11500,12801,9547,-3254
2020,8,15,13,12390,13017,10149,-2868
2020,8,15,14,12990,13365,10517,-2848
2020,8,15,15,13380,13823,10990,-2833
2020,8,15,16,13710,14133,11234,-2899
2020,8,15,17,13840,14264,11282,-2982
2020,8,15,18,14010,14231,11605,-2626
2020,8,15,19,14010,14116,11737,-2379
2020,8,15,20,14200,14135,11858,-2277
2020,8,15,21,14740,14418,12091,-2327
2020,8,15,22,15200,14782,12312,-2470
2020,8,15,23,15150,14886,12086,-2800
2020,8,16,0,14830,14757,11719,-3038
2020,8,16,1,14730,14650,11558,-3092
2020,8,16,2,14150,14055,11156,-2899
2020,8,16,3,13230,13210,10628,-2582
2020,8,16,4,12410,12323,9869,-2454
2020,8,16,5,11600,11870,9474,-2396
2020,8,16,6,11020,11361,9433,-1928
2020,8,16,7,10640,11017,9139,-1878
2020,8,16,8,10350,10887,8954,-1933
2020,8,16,9,10310,11077,9077,-2000
2020,8,16,10,10430,11640,9384,-2256
2020,8,16,11,10410,11797,9585,-2212
2020,8,16,12,10860,11731,9838,-1893
2020,8,16,13,11520,11972,10640,-1332
2020,8,16,14,12030,12493,10761,-1732
2020,8,16,15,12490,12985,10881,-2104
2020,8,16,16,12840,13370,11165,-2205
2020,8,16,17,13050,13584,11302,-2282
2020,8,16,18,13230,13639,11180,-2459
2020,8,16,19,13550,13573,10866,-2707
2020,8,16,20,13850,13592,10927,-2665
2020,8,16,21,13900,13872,11243,-2629
2020,8,16,22,14540,14215,11496,-2719
2020,8,16,23,14780,14261,11681,-2580
2020,8,17,0,14750,14184,11410,-2774
2020,8,17,1,14640,14057,11494,-2563
2020,8,17,2,13900,13410,11015,-2395
2020,8,17,3,12860,12516,10606,-1910
2020,8,17,4,11940,11681,9679,-2002
2020,8,17,5,10990,11530,9127,-2403
2020,8,17,6,10550,11106,9298,-1808
2020,8,17,7,10300,11081,8831,-2250
2020,8,17,8,10210,10993,8550,-2443
2020,8,17,9,10400,11162,8603,-2559
2020,8,17,10,11200,11529,8892,-2637
2020,8,17,11,12350,12383,9763,-2620
2020,8,17,12,13310,13067,10435,-2632
2020,8,17,13,13780,13826,11300,-2526
2020,8,17,14,13440,13763,11207,-2556
2020,8,17,15,13670,13764,11352,-2412
2020,8,17,16,13880,13972,11835,-2137
2020,8,17,17,14220,14322,12479,-1843
2020,8,17,18,14650,14779,12659,-2120
2020,8,17,19,14950,15192,13167,-2025
2020,8,17,20,15410,15698,13641,-2057
2020,8,17,21,16140,16237,14092,-2145
2020,8,17,22,16810,16828,14189,-2639
2020,8,17,23,16680,16807,13733,-3074
2020,8,18,0,16470,16380,13425,-2955
2020,8,18,1,16190,16034,12993,-3041
2020,8,18,2,15010,15123,11982,-3141
2020,8,18,3,13700,13984,10845,-3139
2020,8,18,4,12500,12942,10059,-2883
2020,8,18,5,12110,12133,9377,-2756
2020,8,18,6,11570,11583,9244,-2339
2020,8,18,7,11240,11485,8919,-2566
2020,8,18,8,11070,11338,9030,-2308
2020,8,18,9,11220,11227,9144,-2083
2020,8,18,10,11800,11745,9343,-2402
2020,8,18,11,12830,12618,10105,-2513
2020,8,18,12,13720,13721,10715,-3006
2020,8,18,13,14080,14208,11069,-3139
2020,8,18,14,14310,14515,11746,-2769
2020,8,18,15,14620,14928,11953,-2975
2020,8,18,16,15070,15388,12170,-3218
2020,8,18,17,15560,15971,12846,-3125
2020,8,18,18,16040,16564,13415,-3149
2020,8,18,19,16540,17004,13730,-3274
2020,8,18,20,17120,17185,13868,-3317
2020,8,18,21,17750,17752,14536,-3216
2020,8,18,22,18200,18223,14894,-3329
2020,8,18,23,17920,18208,15108,-3100
2020,8,19,0,17500,17556,14415,-3141
2020,8,19,1,17110,17044,13524,-3520
2020,8,19,2,15990,15923,12436,-3487
2020,8,19,3,14500,14495,11085,-3410
2020,8,19,4,13140,13201,9947,-3254
2020,8,19,5,12160,12221,9486,-2735
2020,8,19,6,11470,12034,9405,-2629
2020,8,19,7,11060,12104,9274,-2830
2020,8,19,8,10770,11832,9250,-2582
2020,8,19,9,10810,11855,9397,-2458
2020,8,19,10,11270,12173,9328,-2845
2020,8,19,11,12050,12820,9625,-3195
2020,8,19,12,12900,13604,10543,-3061
2020,8,19,13,13390,13421,10751,-2670
2020,8,19,14,13610,13608,11006,-2602
2020,8,19,15,13980,13968,11080,-2888
2020,8,19,16,14680,14668,11935,-2733
2020,8,19,17,15160,15164,12266,-2898
2020,8,19,18,15540,15537,12186,-3351
2020,8,19,19,15360,15365,11919,-3446
2020,8,19,20,15130,15132,11527,-3605
2020,8,19,21,15380,15364,11797,-3567
2020,8,19,22,15920,15880,12359,-3521
2020,8,19,23,15920,15908,12574,-3334
2020,8,20,0,15880,15592,12186,-3406
2020,8,20,1,15690,15327,11918,-3409
2020,8,20,2,14730,14465,11058,-3407
2020,8,20,3,13380,13434,10214,-3220
2020,8,20,4,12140,12467,9613,-2854
2020,8,20,5,11310,11885,9417,-2468
2020,8,20,6,10730,11330,8896,-2434
2020,8,20,7,10350,11325,8803,-2522
2020,8,20,8,10150,11207,8830,-2377
2020,8,20,9,10230,11265,8875,-2390
2020,8,20,10,10750,11693,8958,-2735
2020,8,20,11,11550,12294,9495,-2799
2020,8,20,12,12340,12869,9941,-2928
2020,8,20,13,12650,12949,10137,-2812
2020,8,20,14,12700,12710,10284,-2426
2020,8,20,15,13060,12828,10362,-2466
2020,8,20,16,13540,13125,10443,-2682
2020,8,20,17,14010,13508,10813,-2695
2020,8,20,18,14340,13890,11231,-2659
2020,8,20,19,14450,14297,11488,-2809
2020,8,20,20,14800,14804,11787,-3017
2020,8,20,21,15240,15542,12479,-3063
2020,8,20,22,15740,16294,12913,-3381
2020,8,20,23,15830,16443,12876,-3567
2020,8,21,0,15470,15971,12254,-3717
2020,8,21,1,15260,15629,11921,-3708
2020,8,21,2,14540,14733,11186,-3547
2020,8,21,3,13350,13738,10450,-3288
2020,8,21,4,12240,12619,9490,-3129
2020,8,21,5,11470,11746,8998,-2748
2020,8,21,6,10900,11309,8794,-2515
2020,8,21,7,10580,11202,8779,-2423
2020,8,21,8,10380,11110,8916,-2194
2020,8,21,9,10510,10997,8735,-2262
2020,8,21,10,11020,11280,8835,-2445
2020,8,21,11,11860,12119,9415,-2704
2020,8,21,12,12730,12708,9702,-3006
2020,8,21,13,13290,13280,10198,-3082
2020,8,21,14,13630,13639,10742,-2897
2020,8,21,15,14040,14018,11165,-2853
2020,8,21,16,14640,14614,11699,-2915
2020,8,21,17,15400,15374,12502,-2872
2020,8,21,18,16220,16202,13329,-2873
2020,8,21,19,16940,16958,13967,-2991
2020,8,21,20,17710,17687,14514,-3173
2020,8,21,21,18330,18442,15375,-3067
2020,8,21,22,18850,18954,15506,-3448
2020,8,21,23,18190,18860,15114,-3746
2020,8,22,0,17610,18244,14586,-3658
2020,8,22,1,17070,17814,14228,-3586
2020,8,22,2,16340,16808,13564,-3244
2020,8,22,3,15230,15528,12483,-3045
2020,8,22,4,13960,14259,11485,-2774
2020,8,22,5,13200,13247,10852,-2395
2020,8,22,6,12470,12550,10125,-2425
2020,8,22,7,11980,12253,10046,-2207
2020,8,22,8,11640,12176,9712,-2464
2020,8,22,9,11500,12179,9872,-2307
2020,8,22,10,11610,12410,9807,-2603
2020,8,22,11,11830,12633,10027,-2606
2020,8,22,12,12390,13012,10581,-2431
2020,8,22,13,13150,13485,11135,-2350
2020,8,22,14,13820,14028,11497,-2531
2020,8,22,15,14380,14561,11875,-2686
2020,8,22,16,15010,15224,12854,-2370
2020,8,22,17,15740,15750,13332,-2418
2020,8,22,18,16310,16468,14103,-2365
2020,8,22,19,17030,17073,14585,-2488
2020,8,22,20,17530,17369,14809,-2560
2020,8,22,21,18100,17786,15204,-2582
2020,8,22,22,18300,18260,15589,-2671
2020,8,22,23,18200,18247,15325,-2922
2020,8,23,0,17660,17716,14571,-3145
2020,8,23,1,17360,17288,14151,-3137
2020,8,23,2,16600,16361,13544,-2817
2020,8,23,3,15460,15196,12342,-2854
2020,8,23,4,14290,14178,11166,-3012
2020,8,23,5,13000,13268,10580,-2688
2020,8,23,6,12260,12734,10275,-2459
2020,8,23,7,11740,12552,9923,-2629
2020,8,23,8,11360,12429,9851,-2578
2020,8,23,9,11190,12240,9547,-2693
2020,8,23,10,11190,12217,9487,-2730
2020,8,23,11,11300,12310,9329,-2981
2020,8,23,12,11740,12456,9590,-2866
2020,8,23,13,12480,12717,9846,-2871
2020,8,23,14,13280,13249,10430,-2819
2020,8,23,15,14160,14106,11373,-2733
2020,8,23,16,15200,15141,12762,-2379
2020,8,23,17,16030,16182,14182,-2000
2020,8,23,18,17130,17151,14483,-2668
2020,8,23,19,17810,17906,14896,-3010
2020,8,23,20,18630,18608,15659,-2949
2020,8,23,21,19350,19180,16138,-3042
2020,8,23,22,20250,19307,16696,-2611
2020,8,23,23,19750,19039,16430,-2609
2020,8,24,0,19270,18369,15405,-2964
2020,8,24,1,18780,17797,14539,-3258
2020,8,24,2,16530,16759,13896,-2863
2020,8,24,3,15580,15508,12453,-3055
2020,8,24,4,14580,14543,11261,-3282
2020,8,24,5,13340,13902,10440,-3462
2020,8,24,6,12720,13645,10354,-3291
2020,8,24,7,12340,13384,10266,-3118
2020,8,24,8,12160,13213,10326,-2887
2020,8,24,9,12340,13352,10340,-3012
2020,8,24,10,13000,14003,10597,-3406
2020,8,24,11,14010,14627,11299,-3328
2020,8,24,12,15070,15455,11909,-3546
2020,8,24,13,16000,16020,13090,-2930
2020,8,24,14,16640,16649,13821,-2828
2020,8,24,15,17520,17470,14843,-2627
2020,8,24,16,18430,18478,15633,-2845
2020,8,24,17,19520,19453,16659,-2794
2020,8,24,18,20320,20359,17670,-2689
2020,8,24,19,21010,20954,18120,-2834
2020,8,24,20,21530,21225,18023,-3202
2020,8,24,21,21900,21326,17820,-3506
2020,8,24,22,22250,21515,18069,-3446
2020,8,24,23,21780,21415,17800,-3615
2020,8,25,0,21140,20802,16788,-4014
2020,8,25,1,20510,20165,16173,-3992
2020,8,25,2,19140,18857,14980,-3877
2020,8,25,3,17390,17301,13671,-3630
2020,8,25,4,15840,15834,12351,-3483
2020,8,25,5,14690,14987,11588,-3399
2020,8,25,6,13900,14433,10916,-3517
2020,8,25,7,13360,14152,10913,-3239
2020,8,25,8,13050,13846,10845,-3001
2020,8,25,9,13090,13873,10648,-3225
2020,8,25,10,13640,14420,11067,-3353
2020,8,25,11,14600,15116,11627,-3489
2020,8,25,12,15670,15848,12533,-3315
2020,8,25,13,16640,16618,13596,-3022
2020,8,25,14,17500,17460,14329,-3131
2020,8,25,15,18320,17972,14809,-3163
2020,8,25,16,18980,18583,15308,-3275
2020,8,25,17,19620,19047,15718,-3329
2020,8,25,18,20030,19703,16724,-2979
2020,8,25,19,20560,20361,17710,-2651
2020,8,25,20,20810,20942,18129,-2813
2020,8,25,21,20870,21359,19238,-2121
2020,8,25,22,21000,21249,18627,-2622
2020,8,25,23,20400,20583,17297,-3286
2020,8,26,0,19540,19663,15976,-3687
2020,8,26,1,18800,18848,15363,-3485
2020,8,26,2,17300,17434,13710,-3724
2020,8,26,3,15500,15777,12167,-3610
2020,8,26,4,13900,14207,10679,-3528
2020,8,26,5,12960,13011,9998,-3013
2020,8,26,6,12130,12687,9706,-2981
2020,8,26,7,11540,12358,9642,-2716
2020,8,26,8,11120,11947,9469,-2478
2020,8,26,9,11100,11901,9302,-2599
2020,8,26,10,11530,12292,9922,-2370
2020,8,26,11,12250,12773,10184,-2589
2020,8,26,12,12930,12955,9877,-3078
2020,8,26,13,12980,13033,9901,-3132
2020,8,26,14,12900,12915,10315,-2600
2020,8,26,15,12930,13041,10572,-2469
2020,8,26,16,13130,13068,10767,-2301
2020,8,26,17,13220,12876,10650,-2226
2020,8,26,18,13530,13089,10918,-2171
2020,8,26,19,13790,13255,11182,-2073
2020,8,26,20,14220,13741,11583,-2158
2020,8,26,21,14970,14487,11830,-2657
2020,8,26,22,15750,15251,12506,-2745
2020,8,26,23,15480,15327,12276,-3051
2020,8,27,0,15200,15045,11681,-3364
2020,8,27,1,14860,14700,11473,-3227
2020,8,27,2,13950,13819,11074,-2745
2020,8,27,3,12770,12892,10311,-2581
2020,8,27,4,11710,11841,9540,-2301
2020,8,27,5,10820,11349,9162,-2187
2020,8,27,6,10400,10857,9173,-1684
2020,8,27,7,10080,11007,9629,-1378
2020,8,27,8,9870,10920,9480,-1440
2020,8,27,9,10050,11084,9610,-1474
2020,8,27,10,10790,11394,9368,-2026
2020,8,27,11,11780,11897,9813,-2084
2020,8,27,12,12650,12764,10203,-2561
2020,8,27,13,13130,13200,10797,-2403
2020,8,27,14,13360,13479,11125,-2354
2020,8,27,15,13940,13854,11487,-2367
2020,8,27,16,14190,13768,11452,-2316
2020,8,27,17,14320,13935,12004,-1931
2020,8,27,18,15000,14789,12820,-1969
2020,8,27,19,15160,15284,12979,-2305
2020,8,27,20,15300,15463,13075,-2388
2020,8,27,21,15460,15317,12809,-2508
2020,8,27,22,15500,15259,13211,-2048
2020,8,27,23,15480,15117,12926,-2191
2020,8,28,0,15360,14977,12634,-2343
2020,8,28,1,15080,14554,12187,-2367
2020,8,28,2,14060,13732,11264,-2468
2020,8,28,3,12830,12738,10063,-2675
2020,8,28,4,11760,12147,9727,-2420
2020,8,28,5,11060,11619,9675,-1944
2020,8,28,6,10590,11178,9518,-1660
2020,8,28,7,10330,11380,9516,-1864
2020,8,28,8,10210,11260,9226,-2034
2020,8,28,9,10360,11433,8995,-2438
2020,8,28,10,10740,12008,9437,-2571
2020,8,28,11,11670,12365,9844,-2521
2020,8,28,12,12570,12992,10326,-2666
2020,8,28,13,13050,13330,10782,-2548
2020,8,28,14,13420,13518,11134,-2384
2020,8,28,15,13680,13689,11444,-2245
2020,8,28,16,14030,14239,12312,-1927
2020,8,28,17,14430,14591,12432,-2159
2020,8,28,18,14940,14768,12434,-2334
2020,8,28,19,15410,15084,12794,-2290
2020,8,28,20,15840,15580,13194,-2386
2020,8,28,21,16330,16178,13799,-2379
2020,8,28,22,16600,16675,14032,-2643
2020,8,28,23,16520,16638,13558,-3080
2020,8,29,0,16190,16325,13210,-3115
2020,8,29,1,15900,15898,12779,-3119
2020,8,29,2,14950,14996,12090,-2906
2020,8,29,3,13830,14097,11083,-3014
2020,8,29,4,12720,13101,10047,-3054
2020,8,29,5,11930,12126,9434,-2692
2020,8,29,6,11320,11486,9301,-2185
2020,8,29,7,10950,11218,9187,-2031
2020,8,29,8,10740,11007,8849,-2158
2020,8,29,9,10740,11236,8911,-2325
2020,8,29,10,11000,11312,9252,-2060
2020,8,29,11,11490,11973,9693,-2280
2020,8,29,12,12160,12372,10043,-2329
2020,8,29,13,13100,13067,10808,-2259
2020,8,29,14,13930,13913,11549,-2364
2020,8,29,15,14620,14614,12226,-2388
2020,8,29,16,15070,15048,12249,-2799
2020,8,29,17,15210,15213,12476,-2737
2020,8,29,18,15220,15214,12266,-2948
2020,8,29,19,15190,15191,12199,-2992
2020,8,29,20,15080,15054,11950,-3104
2020,8,29,21,15410,15391,12696,-2695
2020,8,29,22,15990,15978,13289,-2689
2020,8,29,23,16240,16279,13362,-2917
2020,8,30,0,16110,16294,13332,-2962
2020,8,30,1,15730,16026,13208,-2818
2020,8,30,2,14900,15253,12345,-2908
2020,8,30,3,13880,14263,11403,-2860
2020,8,30,4,12870,13199,10435,-2764
2020,8,30,5,12170,12245,9468,-2777
2020,8,30,6,11390,11657,9087,-2570
2020,8,30,7,10840,11485,8807,-2678
2020,8,30,8,10460,11300,8932,-2368
2020,8,30,9,10260,11079,9125,-1954
2020,8,30,10,10260,11095,9434,-1661
2020,8,30,11,10400,11225,9574,-1651
2020,8,30,12,10760,11588,9711,-1877
2020,8,30,13,11110,11977,10106,-1871
2020,8,30,14,11570,12321,10101,-2220
2020,8,30,15,11880,12243,9964,-2279
2020,8,30,16,12230,12159,10322,-1837
2020,8,30,17,12550,12065,10156,-1909
2020,8,30,18,12180,12041,10231,-1810
2020,8,30,19,12410,12122,10567,-1555
2020,8,30,20,12870,12727,10894,-1833
2020,8,30,21,13650,13215,11536,-1679
2020,8,30,22,14230,14029,12135,-1894
2020,8,30,23,14300,14333,12338,-1995
2020,8,31,0,14210,14178,11702,-2476
2020,8,31,1,14030,13885,11744,-2141
2020,8,31,2,13240,13006,10768,-2238
2020,8,31,3,12210,11962,9416,-2546
2020,8,31,4,11200,10966,8950,-2016
2020,8,31,5,10220,10729,9077,-1652
2020,8,31,6,9760,10560,9470,-1090
2020,8,31,7,9500,10440,9198,-1242
2020,8,31,8,9390,10279,9170,-1109
2020,8,31,9,9590,10334,9349,-985
2020,8,31,10,10210,10455,9364,-1091
2020,8,31,11,11170,11292,9827,-1465
2020,8,31,12,11920,11878,9848,-2030
2020,8,31,13,12120,12100,10038,-2062
2020,8,31,14,12140,12114,10252,-1862
2020,8,31,15,12240,12178,10463,-1715
2020,8,31,16,12570,12459,10677,-1782
2020,8,31,17,12800,12953,10959,-1994
2020,8,31,18,13180,13365,11070,-2295
2020,8,31,19,13440,13636,11141,-2495
2020,8,31,20,13750,13795,11176,-2619
2020,8,31,21,14260,14184,11465,-2719
2020,8,31,22,14750,14715,11886,-2829
2020,8,31,23,15070,14904,11887,-3017
2020,9,1,0,14810,14922,11878,-3044
2020,9,1,1,14600,14566,11733,-2833
2020,9,1,2,13550,13638,11140,-2498
2020,9,1,3,12390,12548,9945,-2603
2020,9,1,4,11320,11516,9540,-1976
2020,9,1,5,10740,10788,9370,-1418
2020,9,1,6,10270,10292,9083,-1209
2020,9,1,7,9980,9998,8687,-1311
2020,9,1,8,9870,9873,8661,-1212
2020,9,1,9,10010,10019,8693,-1326
2020,9,1,10,10680,10664,9228,-1436
2020,9,1,11,11650,11614,9697,-1917
2020,9,1,12,12490,12453,10632,-1821
2020,9,1,13,12940,12927,11156,-1771
2020,9,1,14,13150,13135,11123,-2012
2020,9,1,15,13240,13208,11273,-1935
2020,9,1,16,13400,13421,11255,-2166
2020,9,1,17,13580,13695,11530,-2165
2020,9,1,18,13870,13994,11840,-2154
2020,9,1,19,14040,14305,11996,-2309
2020,9,1,20,14320,14691,12297,-2394
2020,9,1,21,14750,15223,12681,-2542
2020,9,1,22,15140,15730,13134,-2596
2020,9,1,23,15250,15769,13063,-2706
2020,9,2,0,15400,15565,12663,-2902
2020,9,2,1,14870,15137,12269,-2868
2020,9,2,2,13920,14161,11328,-2833
2020,9,2,3,12680,12978,10478,-2500
2020,9,2,4,11520,12151,9731,-2420
2020,9,2,5,11140,11670,9063,-2607
2020,9,2,6,10640,11445,9153,-2292
2020,9,2,7,10360,11159,9244,-1915
2020,9,2,8,10230,11010,9525,-1485
2020,9,2,9,10420,11192,9369,-1823
2020,9,2,10,11100,11604,9793,-1811
2020,9,2,11,12250,12681,10473,-2208
2020,9,2,12,13290,13546,11178,-2368
2020,9,2,13,14100,14143,11643,-2500
2020,9,2,14,14570,14560,11606,-2954
2020,9,2,15,14860,14882,12009,-2873
2020,9,2,16,15150,15114,12047,-3067
2020,9,2,17,15230,15295,12198,-3097
2020,9,2,18,15430,15383,12264,-3119
2020,9,2,19,15520,15266,12160,-3106
2020,9,2,20,15550,15203,12070,-3133
2020,9,2,21,15830,15347,12454,-2893
2020,9,2,22,15960,15728,12818,-2910
2020,9,2,23,16100,15809,13154,-2655
2020,9,3,0,16200,15818,13335,-2483
2020,9,3,1,15840,15472,13042,-2430
2020,9,3,2,14930,14739,12413,-2326
2020,9,3,3,13790,13854,11416,-2438
2020,9,3,4,12720,13408,10667,-2741
2020,9,3,5,12180,12729,9944,-2785
2020,9,3,6,11750,12282,9778,-2504
2020,9,3,7,11500,12034,9557,-2477
2020,9,3,8,11420,12168,9673,-2495
2020,9,3,9,11640,12205,9764,-2441
2020,9,3,10,12340,12641,10128,-2513
2020,9,3,11,13490,13458,10585,-2873
2020,9,3,12,14540,14520,11204,-3316
2020,9,3,13,15290,15274,12263,-3011
2020,9,3,14,15690,15687,12671,-3016
2020,9,3,15,15780,15778,12747,-3031
2020,9,3,16,15950,15957,13001,-2956
2020,9,3,17,16060,16060,13317,-2743
2020,9,3,18,16210,16215,13591,-2624
2020,9,3,19,16400,16395,14039,-2356
2020,9,3,20,16800,16786,14637,-2149
2020,9,3,21,17250,17230,15260,-1970
2020,9,3,22,17510,17487,15006,-2481
2020,9,3,23,17440,17259,14217,-3042
2020,9,4,0,17000,17171,13878,-3293
2020,9,4,1,16620,16730,13538,-3192
2020,9,4,2,15660,15724,12595,-3129
2020,9,4,3,14380,14526,11345,-3181
2020,9,4,4,13170,13364,10505,-2859
2020,9,4,5,12440,12515,9793,-2722
2020,9,4,6,11860,12489,9772,-2717
2020,9,4,7,11460,12275,9938,-2337
2020,9,4,8,11270,12069,9909,-2160
2020,9,4,9,11360,12140,9979,-2161
2020,9,4,10,11930,12490,10301,-2189
2020,9,4,11,12850,13073,10285,-2788
2020,9,4,12,13850,13785,10891,-2894
2020,9,4,13,14500,14359,11529,-2830
2020,9,4,14,14780,14756,11970,-2786
2020,9,4,15,15060,15117,12157,-2960
2020,9,4,16,15430,15605,13055,-2550
2020,9,4,17,15690,16095,13386,-2709
2020,9,4,18,16240,16497,13605,-2892
2020,9,4,19,16660,16760,13796,-2964
2020,9,4,20,17420,17048,13835,-3213
2020,9,4,21,18090,17313,13907,-3406
2020,9,4,22,18040,17601,14303,-3298
2020,9,4,23,17420,17233,13983,-3250
2020,9,5,0,17040,16545,13365,-3180
2020,9,5,1,16260,15818,12596,-3222
2020,9,5,2,15170,14718,11670,-3048
2020,9,5,3,13750,13506,10428,-3078
2020,9,5,4,12480,12320,9560,-2760
2020,9,5,5,11170,11375,8653,-2722
2020,9,5,6,10580,10703,8338,-2365
2020,9,5,7,10130,10220,8179,-2041
2020,9,5,8,9910,9946,8311,-1635
2020,9,5,9,9780,9837,8307,-1530
2020,9,5,10,9950,9960,8223,-1737
2020,9,5,11,10290,10213,8591,-1622
2020,9,5,12,10690,10564,8373,-2191
2020,9,5,13,10770,10805,8865,-1940
2020,9,5,14,10850,10869,8785,-2084
2020,9,5,15,10930,10871,8715,-2156
2020,9,5,16,11000,11033,9165,-1868
2020,9,5,17,11010,11279,9357,-1922
2020,9,5,18,11060,11547,9611,-1936
2020,9,5,19,11400,11970,9718,-2252
2020,9,5,20,12010,12604,10260,-2344
2020,9,5,21,12810,13331,10860,-2471
2020,9,5,22,13580,14126,11610,-2516
2020,9,5,23,13730,14333,11534,-2799
2020,9,6,0,13830,14150,11244,-2906
2020,9,6,1,13530,13758,10869,-2889
2020,9,6,2,12670,13014,10301,-2713
2020,9,6,3,11870,12156,9782,-2374
2020,9,6,4,11020,11279,9020,-2259
2020,9,6,5,10560,10589,8416,-2173
2020,9,6,6,10070,10301,7903,-2398
2020,9,6,7,9750,10214,7804,-2410
2020,9,6,8,9580,10373,7913,-2460
2020,9,6,9,9560,10366,7979,-2387
2020,9,6,10,9690,10723,8225,-2498
2020,9,6,11,9920,10759,8441,-2318
2020,9,6,12,10270,11066,8528,-2538
2020,9,6,13,10630,11159,8902,-2257
2020,9,6,14,10640,11200,8948,-2252
2020,9,6,15,10700,11263,8855,-2408
2020,9,6,16,11000,11361,9233,-2128
2020,9,6,17,11390,11840,9677,-2163
2020,9,6,18,11700,12155,9533,-2622
2020,9,6,19,12120,12511,9681,-2830
2020,9,6,20,12750,13068,9980,-3088
2020,9,6,21,13520,13744,10672,-3072
2020,9,6,22,14170,14429,11329,-3100
2020,9,6,23,14340,14631,11596,-3035
2020,9,7,0,14400,14636,11569,-3067
2020,9,7,1,14180,14282,11448,-2834
2020,9,7,2,13270,13502,10676,-2826
2020,9,7,3,12280,12634,9685,-2949
2020,9,7,4,11290,11722,8838,-2884
2020,9,7,5,10970,10994,8158,-2836
2020,9,7,6,10470,10966,8036,-2930
2020,9,7,7,10140,10954,8178,-2776
2020,9,7,8,10000,10999,8012,-2987
2020,9,7,9,10040,11088,8151,-2937
2020,9,7,10,10290,11115,8428,-2687
2020,9,7,11,10590,11240,8655,-2585
2020,9,7,12,10980,11735,8779,-2956
2020,9,7,13,11830,11848,9034,-2814
2020,9,7,14,11950,12166,9391,-2775
2020,9,7,15,12230,12411,9606,-2805
2020,9,7,16,12600,12502,9745,-2757
2020,9,7,17,12960,12788,10071,-2717
2020,9,7,18,13280,13295,10473,-2822
2020,9,7,19,13590,13707,10868,-2839
2020,9,7,20,13920,14206,11340,-2866
2020,9,7,21,14610,14957,12114,-2843
2020,9,7,22,15480,15497,12613,-2884
2020,9,7,23,15560,15572,12609,-2963
2020,9,8,0,15600,15666,12667,-2999
2020,9,8,1,15090,15224,12109,-3115
2020,9,8,2,14070,14263,11047,-3216
2020,9,8,3,13080,13114,9955,-3159
2020,9,8,4,12060,12053,8913,-3140
2020,9,8,5,11300,11530,8594,-2936
2020,9,8,6,10820,11234,8573,-2661
2020,9,8,7,10580,11281,8667,-2614
2020,9,8,8,10510,11396,8748,-2648
2020,9,8,9,10750,11577,8706,-2871
2020,9,8,10,11630,12287,9303,-2984
2020,9,8,11,13070,13023,10111,-2912
2020,9,8,12,14060,13589,10608,-2981
2020,9,8,13,14590,14090,11129,-2961
2020,9,8,14,14920,14304,11341,-2963
2020,9,8,15,15120,14441,11713,-2728
2020,9,8,16,15170,14787,12426,-2361
2020,9,8,17,15490,15429,13395,-2034
2020,9,8,18,16320,16252,13796,-2456
2020,9,8,19,17050,17023,14254,-2769
2020,9,8,20,17720,17738,14692,-3046
2020,9,8,21,18330,18381,15402,-2979
2020,9,8,22,18790,18857,15928,-2929
2020,9,8,23,19100,18538,15652,-2886
2020,9,9,0,19070,18294,15393,-2901
2020,9,9,1,18270,17582,14659,-2923
2020,9,9,2,16780,16327,13417,-2910
2020,9,9,3,14950,15135,11993,-3142
2020,9,9,4,13540,14305,11368,-2937
2020,9,9,5,12240,13676,10567,-3109
2020,9,9,6,11620,13006,10002,-3004
2020,9,9,7,11250,12587,9680,-2907
2020,9,9,8,11090,12362,9482,-2880
2020,9,9,9,11250,12469,9548,-2921
2020,9,9,10,12010,13125,10194,-2931
2020,9,9,11,13220,14124,11261,-2863
2020,9,9,12,14100,14533,11789,-2744
2020,9,9,13,14590,14816,12304,-2512
2020,9,9,14,14850,15061,12779,-2282
2020,9,9,15,15270,15276,13295,-1981
2020,9,9,16,15640,15571,13508,-2063
2020,9,9,17,16130,15995,13912,-2083
2020,9,9,18,16780,16557,14263,-2294
2020,9,9,19,17340,16902,14521,-2381
2020,9,9,20,17580,17297,15056,-2241
2020,9,9,21,17900,17604,15356,-2248
2020,9,9,22,18180,17820,15460,-2360
2020,9,9,23,17940,17793,15188,-2605
2020,9,10,0,17850,17794,14756,-3038
2020,9,10,1,17100,17183,14096,-3087
2020,9,10,2,15900,16107,12999,-3108
2020,9,10,3,14720,14911,11838,-3073
2020,9,10,4,13500,14102,11106,-2996
2020,9,10,5,12810,13816,10705,-3111
2020,9,10,6,12240,13304,10199,-3105
2020,9,10,7,11860,12935,9836,-3099
2020,9,10,8,11710,12762,9614,-3148
2020,9,10,9,11890,12925,9827,-3098
2020,9,10,10,12640,13657,10672,-2985
2020,9,10,11,13950,14533,11709,-2824
2020,9,10,12,15010,15180,12320,-2860
2020,9,10,13,15790,15782,12924,-2858
2020,9,10,14,16270,16266,13371,-2895
2020,9,10,15,16730,16720,13912,-2808
2020,9,10,16,17150,17139,14267,-2872
2020,9,10,17,17600,17589,14620,-2969
2020,9,10,18,18090,18075,15046,-3029
2020,9,10,19,18520,18516,15479,-3037
2020,9,10,20,18800,18780,15744,-3036
2020,9,10,21,19020,18950,15936,-3014
2020,9,10,22,19310,19111,16269,-2842
2020,9,10,23,19190,18931,16017,-2914
2020,9,11,0,19130,18837,15904,-2933
2020,9,11,1,18420,18155,15149,-3006
2020,9,11,2,17170,17115,13967,-3148
2020,9,11,3,15810,15845,12708,-3137
2020,9,11,4,14580,14690,11600,-3090
2020,9,11,5,13300,14103,11006,-3097
2020,9,11,6,12620,13795,10605,-3190
2020,9,11,7,12110,13437,10481,-2956
2020,9,11,8,11820,13120,10312,-2808
2020,9,11,9,11860,13094,10393,-2701
2020,9,11,10,12410,13553,10683,-2870
2020,9,11,11,13510,13769,10931,-2838
2020,9,11,12,14210,14207,11264,-2943
2020,9,11,13,14490,14543,11581,-2962
2020,9,11,14,14440,14558,11581,-2977
2020,9,11,15,14260,14395,11575,-2820
2020,9,11,16,14080,14216,11660,-2556
2020,9,11,17,13870,13993,11370,-2623
2020,9,11,18,13830,13795,11372,-2423
2020,9,11,19,13810,13642,11390,-2252
2020,9,11,20,13960,13603,11392,-2211
2020,9,11,21,13800,13908,11378,-2530
2020,9,11,22,14190,14448,11701,-2747
2020,9,11,23,14470,14522,11631,-2891
2020,9,12,0,14800,14432,11642,-2790
2020,9,12,1,14110,13879,11093,-2786
2020,9,12,2,13200,12990,10091,-2899
2020,9,12,3,12190,12010,9189,-2821
2020,9,12,4,11190,11049,8224,-2825
2020,9,12,5,10280,10291,7582,-2709
2020,9,12,6,9760,10039,7373,-2666
2020,9,12,7,9440,9955,7093,-2862
2020,9,12,8,9270,10016,7160,-2856
2020,9,12,9,9270,10036,7375,-2661
2020,9,12,10,9510,10209,7693,-2516
2020,9,12,11,9910,10566,8058,-2508
2020,9,12,12,10240,10855,8375,-2480
2020,9,12,13,10390,10721,8561,-2160
2020,9,12,14,10350,10628,8700,-1928
2020,9,12,15,10260,10362,8741,-1621
2020,9,12,16,10270,10482,8880,-1602
2020,9,12,17,10220,10497,8823,-1674
2020,9,12,18,10190,10471,8900,-1571
2020,9,12,19,10610,10546,8817,-1729
2020,9,12,20,11070,10969,9011,-1958
2020,9,12,21,11780,11799,9776,-2023
2020,9,12,22,12480,12575,10302,-2273
2020,9,12,23,12780,12961,10404,-2557
2020,9,13,0,12940,13104,10485,-2619
2020,9,13,1,12620,12668,9951,-2717
2020,9,13,2,12010,11929,9481,-2448
2020,9,13,3,11210,11108,8678,-2430
2020,9,13,4,10410,10284,8019,-2265
2020,9,13,5,9650,9667,7775,-1892
2020,9,13,6,9230,9468,7596,-1872
2020,9,13,7,8970,9495,7537,-1958
2020,9,13,8,8850,9393,7405,-1988
2020,9,13,9,8860,9400,7383,-2017
2020,9,13,10,9050,9559,7495,-2064
2020,9,13,11,9360,9627,7660,-1967
2020,9,13,12,9680,9818,7769,-2049
2020,9,13,13,10070,10068,8071,-1997
2020,9,13,14,10320,10322,8354,-1968
2020,9,13,15,10500,10500,8295,-2205
2020,9,13,16,10710,10710,8924,-1786
2020,9,13,17,11010,11015,9485,-1530
2020,9,13,18,11200,11198,9555,-1643
2020,9,13,19,11540,11539,9498,-2041
2020,9,13,20,12050,12054,9746,-2308
2020,9,13,21,12940,12870,10121,-2749
2020,9,13,22,13560,13700,10689,-3011
2020,9,13,23,13830,14086,10989,-3097
2020,9,14,0,14000,14266,11179,-3087
2020,9,14,1,13720,13882,11205,-2677
2020,9,14,2,12990,13078,10281,-2797
2020,9,14,3,12010,12165,9503,-2662
2020,9,14,4,11100,11582,8809,-2773
2020,9,14,5,10520,11011,8219,-2792
2020,9,14,6,10130,10623,7970,-2653
2020,9,14,7,9960,10439,8242,-2197
2020,9,14,8,9910,10402,8365,-2037
2020,9,14,9,10170,10687,8857,-1830
2020,9,14,10,11140,11246,9347,-1899
2020,9,14,11,12670,12352,10620,-1732
2020,9,14,12,13520,13243,11576,-1667
2020,9,14,13,13430,13575,11945,-1630
2020,9,14,14,13300,13486,11857,-1629
2020,9,14,15,13390,13286,11772,-1514
2020,9,14,16,13390,13184,11815,-1369
2020,9,14,17,13330,13251,11922,-1329
2020,9,14,18,13480,13302,11755,-1547
2020,9,14,19,13660,13410,11846,-1564
2020,9,14,20,14050,13740,12210,-1530
2020,9,14,21,14410,14296,12869,-1427
2020,9,14,22,14820,14794,13322,-1472
2020,9,14,23,14790,14815,13242,-1573
2020,9,15,0,14870,14738,13030,-1708
2020,9,15,1,14280,13951,12315,-1636
2020,9,15,2,13170,12864,11076,-1788
2020,9,15,3,11850,11661,9740,-1921
2020,9,15,4,10640,10631,8619,-2012
2020,9,15,5,9900,10210,8863,-1347
2020,9,15,6,9450,9996,8923,-1073
2020,9,15,7,9200,9990,8731,-1259
2020,9,15,8,9130,9917,8545,-1372
2020,9,15,9,9330,9838,8458,-1380
2020,9,15,10,10010,10083,8652,-1431
2020,9,15,11,11220,11188,9726,-1462
2020,9,15,12,11990,11974,10363,-1611
2020,9,15,13,12120,12131,10552,-1579
2020,9,15,14,11760,11786,10417,-1369
2020,9,15,15,11470,11419,10383,-1036
2020,9,15,16,11400,11253,10250,-1003
2020,9,15,17,11390,11258,10364,-894
2020,9,15,18,11400,11380,10475,-905
2020,9,15,19,11540,11393,10505,-888
2020,9,15,20,11910,11776,10974,-802
2020,9,15,21,12630,12649,11538,-1111
2020,9,15,22,13510,13379,12083,-1296
2020,9,15,23,13970,13792,12319,-1473
2020,9,16,0,14170,13956,12517,-1439
2020,9,16,1,13570,13295,11889,-1406
2020,9,16,2,12610,12320,10664,-1656
2020,9,16,3,11450,11231,9550,-1681
2020,9,16,4,10440,10272,8486,-1786
2020,9,16,5,9650,9933,8311,-1622
2020,9,16,6,9260,9748,8350,-1398
2020,9,16,7,9070,9602,8132,-1470
2020,9,16,8,9000,9550,8148,-1402
2020,9,16,9,9250,9777,8307,-1470
2020,9,16,10,9980,10263,8894,-1369
2020,9,16,11,11210,11174,9912,-1262
2020,9,16,12,12060,12048,10668,-1380
2020,9,16,13,12210,12241,10717,-1524
2020,9,16,14,11890,11963,10379,-1584
2020,9,16,15,11720,11786,10164,-1622
2020,9,16,16,11590,11670,10063,-1607
2020,9,16,17,11640,11644,10043,-1601
2020,9,16,18,11830,11758,10258,-1500
2020,9,16,19,12160,12034,10350,-1684
2020,9,16,20,12680,12471,10789,-1682
2020,9,16,21,13450,13144,11429,-1715
2020,9,16,22,14160,13844,12106,-1738
2020,9,16,23,14440,14166,12332,-1834
2020,9,17,0,14750,14334,12473,-1861
2020,9,17,1,13990,13728,11873,-1855
2020,9,17,2,13030,12791,10885,-1906
2020,9,17,3,11840,11724,9899,-1825
2020,9,17,4,10810,10933,9048,-1885
2020,9,17,5,10090,10556,9069,-1487
2020,9,17,6,9700,10211,8709,-1502
2020,9,17,7,9460,10270,8723,-1547
2020,9,17,8,9410,10216,8721,-1495
2020,9,17,9,9630,10396,8801,-1595
2020,9,17,10,10360,10684,9050,-1634
2020,9,17,11,11670,11486,9786,-1700
2020,9,17,12,12470,12348,10834,-1514
2020,9,17,13,12550,12673,11186,-1487
2020,9,17,14,12670,12643,11432,-1211
2020,9,17,15,12700,12596,11653,-943
2020,9,17,16,12800,12705,11627,-1078
2020,9,17,17,13020,12874,11904,-970
2020,9,17,18,13200,13153,12018,-1135
2020,9,17,19,13450,13566,12394,-1172
2020,9,17,20,13880,13913,12721,-1192
2020,9,17,21,14320,14288,13138,-1150
2020,9,17,22,14780,14695,13506,-1189
2020,9,17,23,14930,14904,13642,-1262
2020,9,18,0,15000,14969,13708,-1261
2020,9,18,1,14430,14313,13122,-1191
2020,9,18,2,13460,13353,11995,-1358
2020,9,18,3,12080,12225,10755,-1470
2020,9,18,4,10960,11185,9714,-1471
2020,9,18,5,10220,10462,9118,-1344
2020,9,18,6,9720,10248,9009,-1239
2020,9,18,7,9510,9974,8646,-1328
2020,9,18,8,9430,9857,8489,-1368
2020,9,18,9,9580,9997,8506,-1491
2020,9,18,10,10310,10357,9065,-1292
2020,9,18,11,11640,11522,10253,-1269
2020,9,18,12,12420,12440,11141,-1299
2020,9,18,13,12590,12775,11470,-1305
2020,9,18,14,12520,12790,11440,-1350
2020,9,18,15,12420,12725,11445,-1280
2020,9,18,16,12280,12612,11239,-1373
2020,9,18,17,12200,12412,11231,-1181
2020,9,18,18,12070,12070,11164,-906
2020,9,18,19,11720,11812,11145,-667
2020,9,18,20,11820,11987,11246,-741
2020,9,18,21,12090,12467,11502,-965
2020,9,18,22,12860,13062,11860,-1202
2020,9,18,23,13180,13329,12099,-1230
2020,9,19,0,13450,13425,12193,-1232
2020,9,19,1,12880,12863,11428,-1435
2020,9,19,2,12190,12088,10704,-1384
2020,9,19,3,11260,11160,9930,-1230
2020,9,19,4,10350,10266,9047,-1219
2020,9,19,5,9570,9584,8784,-800
2020,9,19,6,9140,9391,8267,-1124
2020,9,19,7,8890,9191,8064,-1127
2020,9,19,8,8800,9086,7965,-1121
2020,9,19,9,8860,9144,7980,-1164
2020,9,19,10,9160,9438,8264,-1174
2020,9,19,11,9700,9973,8912,-1061
2020,9,19,12,10120,10114,9230,-884
2020,9,19,13,10220,10195,9507,-688
2020,9,19,14,9920,9907,9280,-627
2020,9,19,15,9450,9572,9084,-488
2020,9,19,16,9170,9664,8824,-840
2020,9,19,17,8990,9988,9183,-805
2020,9,19,18,8810,9968,9113,-855
2020,9,19,19,8780,10277,9444,-833
2020,9,19,20,9230,10632,9838,-794
2020,9,19,21,10360,10860,10061,-799
2020,9,19,22,11420,11619,10761,-858
2020,9,19,23,12150,12277,11349,-928
2020,9,20,0,12450,12543,11290,-1253
2020,9,20,1,12070,12113,10855,-1258
2020,9,20,2,11450,11465,10231,-1234
2020,9,20,3,10720,10702,9617,-1085
2020,9,20,4,10000,10177,9065,-1112
2020,9,20,5,9470,9874,8918,-956
2020,9,20,6,9070,9533,8533,-1000
2020,9,20,7,8920,9437,8500,-937
2020,9,20,8,8850,9413,8509,-904
2020,9,20,9,8920,9279,8378,-901
2020,9,20,10,9130,9480,8591,-889
2020,9,20,11,9450,9903,9080,-823
2020,9,20,12,9690,9842,9340,-502
2020,9,20,13,9920,9877,9387,-490
2020,9,20,14,9750,9792,9415,-377
2020,9,20,15,9520,9721,9300,-421
2020,9,20,16,9360,9831,9227,-604
2020,9,20,17,9300,9960,9375,-585
2020,9,20,18,9270,9960,9208,-752
2020,9,20,19,9400,10051,9274,-777
2020,9,20,20,9750,10122,9377,-745
2020,9,20,21,10600,10873,10084,-789
2020,9,20,22,11780,12037,10780,-1257
2020,9,20,23,12540,12809,11396,-1413
2020,9,21,0,12920,13107,11659,-1448
2020,9,21,1,12430,12581,11131,-1450
2020,9,21,2,11650,11708,10240,-1468
2020,9,21,3,10730,10775,9315,-1460
2020,9,21,4,9910,10151,8857,-1294
2020,9,21,5,9360,9876,8626,-1250
2020,9,21,6,9010,9823,8464,-1359
2020,9,21,7,8880,9712,8327,-1385
2020,9,21,8,8930,9750,8340,-1410
2020,9,21,9,9250,10069,8536,-1533
2020,9,21,10,10130,10589,9199,-1390
2020,9,21,11,11600,11499,10489,-1010
2020,9,21,12,12340,12397,11314,-1083
2020,9,21,13,11880,12390,11164,-1226
2020,9,21,14,11740,11869,10917,-952
2020,9,21,15,11360,11417,10650,-767
2020,9,21,16,11040,11155,10691,-464
2020,9,21,17,10960,10990,10690,-300
2020,9,21,18,10970,10942,10591,-351
2020,9,21,19,11040,10983,10592,-391
2020,9,21,20,11610,11342,10925,-417
2020,9,21,21,12280,12093,11397,-696
2020,9,21,22,13160,13148,12175,-973
2020,9,21,23,13620,13745,12999,-746
2020,9,22,0,13860,13948,13182,-766
2020,9,22,1,13270,13251,12198,-1053
2020,9,22,2,12300,12263,11351,-912
2020,9,22,3,11180,11203,10107,-1096
2020,9,22,4,10220,10388,9415,-973
2020,9,22,5,9710,10180,9220,-960
2020,9,22,6,9360,9973,8899,-1074
2020,9,22,7,9180,10000,8910,-1090
2020,9,22,8,9200,9992,8928,-1064
2020,9,22,9,9510,10013,8861,-1152
2020,9,22,10,10500,10345,9320,-1025
2020,9,22,11,12080,11667,10631,-1036
2020,9,22,12,12560,12674,11492,-1182
2020,9,22,13,12350,12781,11543,-1238
2020,9,22,14,12260,12397,11216,-1181
2020,9,22,15,11980,12001,11120,-881
2020,9,22,16,11750,11747,11037,-710
2020,9,22,17,11710,11617,10922,-695
2020,9,22,18,11840,11662,10753,-909
2020,9,22,19,11970,11821,10998,-823
2020,9,22,20,12250,11987,11222,-765
2020,9,22,21,12770,12478,11482,-996
2020,9,22,22,13440,13263,12003,-1260
2020,9,22,23,13880,13793,12320,-1473
2020,9,23,0,13910,13967,12531,-1436
2020,9,23,1,13340,13257,11871,-1386
2020,9,23,2,12400,12272,11148,-1124
2020,9,23,3,11290,11174,10130,-1044
2020,9,23,4,10290,10484,9232,-1252
2020,9,23,5,9610,10171,9119,-1052
2020,9,23,6,9240,9802,8794,-1008
2020,9,23,7,9050,9597,8631,-966
2020,9,23,8,9000,9546,8629,-917
2020,9,23,9,9180,9774,8801,-973
2020,9,23,10,10040,10283,9245,-1038
2020,9,23,11,11410,11516,10268,-1248
2020,9,23,12,12100,12089,10918,-1171
2020,9,23,13,11990,12106,11039,-1067
2020,9,23,14,11700,11720,10612,-1108
2020,9,23,15,11620,11522,10766,-756
2020,9,23,16,11600,11472,10594,-878
2020,9,23,17,11690,11708,10747,-961
2020,9,23,18,11890,11934,11178,-756
2020,9,23,19,12080,12264,11166,-1098
2020,9,23,20,12600,12588,11464,-1124
2020,9,23,21,13290,13283,12219,-1064
2020,9,23,22,14020,14030,12734,-1296
2020,9,23,23,14330,14377,13034,-1343
2020,9,24,0,14500,14512,13071,-1441
2020,9,24,1,13840,13784,12387,-1397
2020,9,24,2,12880,12765,11346,-1419
2020,9,24,3,11690,11691,10521,-1170
2020,9,24,4,10670,10740,9942,-798
2020,9,24,5,9980,10302,9548,-754
2020,9,24,6,9550,10117,9356,-761
2020,9,24,7,9300,10107,9143,-964
2020,9,24,8,9220,10017,8812,-1205
2020,9,24,9,9430,10207,9146,-1061
2020,9,24,10,10090,10412,9275,-1137
2020,9,24,11,11340,11293,10332,-961
2020,9,24,12,12120,12119,11069,-1050
2020,9,24,13,12290,12292,11300,-992
2020,9,24,14,12160,12190,11333,-857
2020,9,24,15,12180,12207,11575,-632
2020,9,24,16,12350,12404,11728,-676
2020,9,24,17,12640,12630,11977,-653
2020,9,24,18,13060,13050,12390,-660
2020,9,24,19,13370,13429,12605,-824
2020,9,24,20,13650,13730,12878,-852
2020,9,24,21,13980,13989,13109,-880
2020,9,24,22,14460,14397,13335,-1062
2020,9,24,23,14650,14716,13395,-1321
2020,9,25,0,14800,14762,13419,-1343
2020,9,25,1,14170,14050,12998,-1052
2020,9,25,2,13150,13087,11833,-1254
2020,9,25,3,12010,11981,10672,-1309
2020,9,25,4,10920,10981,9596,-1385
2020,9,25,5,10260,10541,9515,-1026
2020,9,25,6,9770,10343,9514,-829
2020,9,25,7,9480,10286,9547,-739
2020,9,25,8,9420,10168,9279,-889
2020,9,25,9,9630,10335,9393,-942
2020,9,25,10,10350,10583,9479,-1104
2020,9,25,11,11690,11333,10328,-1005
2020,9,25,12,12400,12190,11230,-960
2020,9,25,13,12450,12415,11697,-718
2020,9,25,14,12230,12295,11718,-577
2020,9,25,15,12280,12249,11690,-559
2020,9,25,16,12460,12324,11745,-579
2020,9,25,17,12730,12460,11879,-581
2020,9,25,18,13160,12719,12065,-654
2020,9,25,19,13550,13068,12391,-677
2020,9,25,20,14030,13464,12772,-692
2020,9,25,21,14550,13976,13219,-757
2020,9,25,22,14950,14392,13351,-1041
2020,9,25,23,15100,14507,13417,-1090
2020,9,26,0,14920,14467,13431,-1036
2020,9,26,1,14260,13786,12866,-920
2020,9,26,2,13310,12937,11891,-1046
2020,9,26,3,12270,12013,11128,-885
2020,9,26,4,11250,11032,9670,-1362
2020,9,26,5,10290,10313,9594,-719
2020,9,26,6,9810,9876,9132,-744
2020,9,26,7,9500,9819,9014,-805
2020,9,26,8,9360,9897,8720,-1177
2020,9,26,9,9400,9941,8731,-1210
2020,9,26,10,9660,10188,8995,-1193
2020,9,26,11,10200,10462,9459,-1003
2020,9,26,12,10750,10894,9681,-1213
2020,9,26,13,11340,11327,10136,-1191
2020,9,26,14,11600,11544,10001,-1543
2020,9,26,15,11720,11369,9784,-1585
2020,9,26,16,11780,11153,9513,-1640
2020,9,26,17,11820,10979,9597,-1382
2020,9,26,18,11790,11096,9644,-1452
2020,9,26,19,11900,11571,10144,-1427
2020,9,26,20,12290,12122,10522,-1600
2020,9,26,21,13060,12850,10904,-1946
2020,9,26,22,13620,13478,11222,-2256
2020,9,26,23,14140,13872,11655,-2217
2020,9,27,0,14250,13971,11640,-2331
2020,9,27,1,13440,13448,11335,-2113
2020,9,27,2,12740,12765,11017,-1748
2020,9,27,3,11970,12004,10266,-1738
2020,9,27,4,11130,11191,9431,-1760
2020,9,27,5,10530,10549,8927,-1622
2020,9,27,6,10110,10157,8681,-1476
2020,9,27,7,9850,10139,8626,-1513
2020,9,27,8,9710,9997,8454,-1543
2020,9,27,9,9700,9989,8491,-1498
2020,9,27,10,9880,10150,8446,-1704
2020,9,27,11,10260,10533,8800,-1733
2020,9,27,12,10740,10752,9080,-1672
2020,9,27,13,11450,11438,9629,-1809
2020,9,27,14,12070,12025,10082,-1943
2020,9,27,15,12350,12369,10504,-1865
2020,9,27,16,12590,12599,10421,-2178
2020,9,27,17,12810,12847,10677,-2170
2020,9,27,18,13120,13120,10677,-9999
2020,9,27,19,13360,13305,11177,-2128
2020,9,27,20,13800,13602,11514,-2088
2020,9,27,21,14300,14188,12026,-2162
2020,9,27,22,15050,14917,12668,-2249
2020,9,27,23,15440,15410,12964,-2446
2020,9,28,0,15750,15574,12978,-2596
2020,9,28,1,14930,14979,12398,-2581
2020,9,28,2,13860,14107,11547,-2560
2020,9,28,3,12830,13086,10723,-2363
2020,9,28,4,11860,12145,9864,-2281
2020,9,28,5,11400,11692,9539,-2153
2020,9,28,6,10950,11237,9385,-1852
2020,9,28,7,10710,11068,9243,-1825
2020,9,28,8,10650,11191,9058,-2133
2020,9,28,9,10920,11275,9120,-2155
2020,9,28,10,11700,11952,9626,-2326
2020,9,28,11,12990,13013,10630,-2383
2020,9,28,12,13930,13919,11392,-2527
2020,9,28,13,14470,14447,12040,-2407
2020,9,28,14,14750,14752,12283,-2469
2020,9,28,15,14990,15028,12640,-2388
2020,9,28,16,15310,15323,12663,-2660
2020,9,28,17,15550,15565,12621,-2944
2020,9,28,18,15650,15658,12607,-3051
2020,9,28,19,15750,15745,12808,-2937
2020,9,28,20,15760,15800,12875,-2925
2020,9,28,21,16060,16113,13403,-2710
2020,9,28,22,16340,16512,14075,-2437
2020,9,28,23,16640,16694,14052,-2642
2020,9,29,0,16460,16593,13774,-2819
2020,9,29,1,15680,15708,12625,-3083
2020,9,29,2,14510,14610,11666,-2944
2020,9,29,3,13230,13387,10842,-2545
2020,9,29,4,12050,12266,9829,-2437
2020,9,29,5,11410,11637,9696,-1941
2020,9,29,6,10910,11437,9430,-2007
2020,9,29,7,10600,11339,9545,-1794
2020,9,29,8,10470,11274,9340,-1934
2020,9,29,9,10630,11416,9435,-1981
2020,9,29,10,11350,11843,9703,-2140
2020,9,29,11,12680,12891,10617,-2274
2020,9,29,12,13640,13872,11361,-2511
2020,9,29,13,14090,14050,11994,-2056
2020,9,29,14,14060,14027,11573,-2454
2020,9,29,15,14170,14105,11665,-2440
2020,9,29,16,14370,14369,11916,-2453
2020,9,29,17,14640,14910,12350,-2560
2020,9,29,18,15100,15330,12845,-2485
2020,9,29,19,15320,15524,12747,-2777
2020,9,29,20,15600,15623,12905,-2718
2020,9,29,21,15860,15942,13073,-2869
2020,9,29,22,16180,16315,13387,-2928
2020,9,29,23,16300,16568,13663,-2905
2020,9,30,0,16360,16388,13320,-3068
2020,9,30,1,15690,15644,12629,-3015
2020,9,30,2,14630,14586,11592,-2994
2020,9,30,3,13380,13632,10897,-2735
2020,9,30,4,12270,12850,10565,-2285
2020,9,30,5,12010,12229,9486,-2743
2020,9,30,6,11520,12046,9414,-2632
2020,9,30,7,11260,11822,9766,-2056
2020,9,30,8,11180,11730,9820,-1910
2020,9,30,9,11470,11993,9958,-2035
2020,9,30,10,12270,12508,10100,-2408
2020,9,30,11,13460,13437,10790,-2647
2020,9,30,12,14480,14413,11189,-3224
2020,9,30,13,14820,14770,11388,-3382
2020,9,30,14,14740,14784,11309,-3475
2020,9,30,15,14370,14641,11260,-3381
2020,9,30,16,13800,14091,10666,-3425
2020,9,30,17,13450,13750,10624,-3126
2020,9,30,18,13270,13345,10488,-2857
2020,9,30,19,13340,13104,10406,-2698
2020,9,30,20,13630,13308,10710,-2598
2020,9,30,21,13940,13777,10935,-2842
2020,9,30,22,14390,14387,11407,-2980
2020,9,30,23,14580,14602,11405,-3197
2020,10,1,0,14650,14531,11594,-2937
2020,10,1,1,14140,13752,11077,-2675
2020,10,1,2,13080,12768,10227,-2541
2020,10,1,3,11790,11811,9385,-2426
2020,10,1,4,10650,10946,8596,-2350
2020,10,1,5,10000,10394,8213,-2181
2020,10,1,6,9590,10135,8192,-1943
2020,10,1,7,9350,9872,7871,-2001
2020,10,1,8,9300,9810,7837,-1973
2020,10,1,9,9440,10009,8047,-1962
2020,10,1,10,10270,10697,8714,-1983
2020,10,1,11,11660,11657,9276,-2381
2020,10,1,12,12470,12480,9593,-2887
2020,10,1,13,12390,12593,9650,-2943
2020,10,1,14,12140,12337,9631,-2706
2020,10,1,15,11990,12026,9274,-2752
2020,10,1,16,12000,12230,9465,-2765
2020,10,1,17,12160,12566,10095,-2471
2020,10,1,18,12370,12690,10180,-2510
2020,10,1,19,12690,12770,9798,-2972
2020,10,1,20,13080,13068,10111,-2957
2020,10,1,21,13680,13363,10320,-3043
2020,10,1,22,14260,13987,10925,-3062
2020,10,1,23,14620,14500,11309,-3191
2020,10,2,0,14550,14446,11524,-2922
2020,10,2,1,14000,13773,10573,-3200
2020,10,2,2,13010,12884,9715,-3169
2020,10,2,3,11870,11852,8820,-3032
2020,10,2,4,10820,10855,8332,-2523
2020,10,2,5,9910,10369,7979,-2390
2020,10,2,6,9420,10245,7928,-2317
2020,10,2,7,9270,10021,7754,-2267
2020,10,2,8,9170,10050,7773,-2277
2020,10,2,9,9400,10250,7982,-2268
2020,10,2,10,10240,10729,8036,-2693
2020,10,2,11,11650,11428,8804,-2624
2020,10,2,12,12570,12413,9535,-2878
2020,10,2,13,12930,12998,9873,-3125
2020,10,2,14,13100,13172,10150,-3022
2020,10,2,15,13160,13346,10202,-3144
2020,10,2,16,13090,13634,10484,-3150
2020,10,2,17,13630,13650,10574,-3076
2020,10,2,18,13420,13355,10217,-3138
2020,10,2,19,13330,12919,9754,-3165
2020,10,2,20,13240,12623,9361,-3262
2020,10,2,21,13240,12581,9249,-3332
2020,10,2,22,13400,13115,9874,-3241
2020,10,2,23,13900,13537,10348,-3189
2020,10,3,0,13600,13498,10089,-3409
2020,10,3,1,12970,13011,9620,-3391
2020,10,3,2,12290,12367,9408,-2959
2020,10,3,3,11390,11472,8369,-3103
2020,10,3,4,10460,10816,7723,-3093
2020,10,3,5,9670,10067,6934,-3133
2020,10,3,6,9250,9553,6757,-2796
2020,10,3,7,9030,9534,7077,-2457
2020,10,3,8,8930,9452,6896,-2556
2020,10,3,9,9010,9526,6841,-2685
2020,10,3,10,9300,9834,6764,-3070
2020,10,3,11,9870,10158,6890,-3268
2020,10,3,12,10400,10408,7202,-3206
2020,10,3,13,10760,10627,7280,-3347
2020,10,3,14,10520,10458,7195,-3263
2020,10,3,15,10290,10166,7099,-3067
2020,10,3,16,10090,9978,7322,-2656
2020,10,3,17,10030,10067,7529,-2538
2020,10,3,18,9960,10200,7489,-2711
2020,10,3,19,10100,10222,7473,-2749
2020,10,3,20,10470,10545,7549,-2996
2020,10,3,21,11110,11164,8079,-3085
2020,10,3,22,11930,12042,9008,-3034
2020,10,3,23,12570,12651,9648,-3003
2020,10,4,0,12550,12711,9369,-3342
2020,10,4,1,12090,12183,8973,-3210
2020,10,4,2,11490,11549,8574,-2975
2020,10,4,3,10780,10792,7741,-3051
2020,10,4,4,10020,10031,6685,-3346
2020,10,4,5,9390,9447,6407,-3040
2020,10,4,6,8980,9397,6226,-3171
2020,10,4,7,8800,9819,6328,-3491
2020,10,4,8,8770,9838,6413,-3425
2020,10,4,9,8730,9901,6395,-3506
2020,10,4,10,8910,10110,6634,-3476
2020,10,4,11,9300,10283,6876,-3407
2020,10,4,12,9600,10575,7258,-3317
2020,10,4,13,9870,10880,7609,-3271
2020,10,4,14,10080,10761,7608,-3153
2020,10,4,15,9900,10682,7770,-2912
2020,10,4,16,9810,10555,7774,-2781
2020,10,4,17,9810,10186,7727,-2459
2020,10,4,18,9890,9833,7455,-2378
2020,10,4,19,10060,10102,7782,-2320
2020,10,4,20,10440,10701,8216,-2485
2020,10,4,21,11240,11531,8506,-3025
2020,10,4,22,12180,12462,9181,-3281
2020,10,4,23,12880,13107,9859,-3248
2020,10,5,0,12870,13140,9799,-3341
2020,10,5,1,12300,12504,9111,-3393
2020,10,5,2,11480,11676,8227,-3449
2020,10,5,3,10590,10905,7435,-3470
2020,10,5,4,9790,10059,6581,-3478
2020,10,5,5,9370,9630,6236,-3394
2020,10,5,6,9050,9533,6150,-3383
2020,10,5,7,8930,9708,6187,-3521
2020,10,5,8,8950,9734,6425,-3309
2020,10,5,9,9230,10005,6725,-3280
2020,10,5,10,10010,10205,7064,-3141
2020,10,5,11,11390,11350,8345,-3005
2020,10,5,12,12470,12450,9417,-3033
2020,10,5,13,12910,12919,9676,-3243
2020,10,5,14,12860,12857,9645,-3212
2020,10,5,15,12570,12677,9598,-3079
2020,10,5,16,12300,12524,9329,-3195
2020,10,5,17,12210,12346,9199,-3147
2020,10,5,18,12170,12171,9055,-3116
2020,10,5,19,12210,12027,8896,-3131
2020,10,5,20,12400,12295,9169,-3126
2020,10,5,21,12940,12936,9817,-3119
2020,10,5,22,13640,13729,10643,-3086
2020,10,5,23,14200,14255,11121,-3134
2020,10,6,0,14190,14100,10919,-3181
2020,10,6,1,13450,13326,10061,-3265
2020,10,6,2,12510,12378,9096,-3282
2020,10,6,3,11350,11503,8195,-3308
2020,10,6,4,10360,10914,7784,-3130
2020,10,6,5,9720,10284,7236,-3048
2020,10,6,6,9330,9878,7048,-2830
2020,10,6,7,9130,9900,6606,-3294
2020,10,6,8,9120,9917,6691,-3226
2020,10,6,9,9380,10163,6957,-3206
2020,10,6,10,10150,10728,7383,-3345
2020,10,6,11,11490,11693,8554,-3139
2020,10,6,12,12410,12407,9501,-2906
2020,10,6,13,12560,12570,9749,-2821
2020,10,6,14,12350,12379,9544,-2835
2020,10,6,15,12160,12349,9218,-3131
2020,10,6,16,12130,12292,9244,-3048
2020,10,6,17,12150,12042,9122,-2920
2020,10,6,18,12200,12139,9094,-3045
2020,10,6,19,12350,12143,9124,-3019
2020,10,6,20,12710,12376,9291,-3085
2020,10,6,21,13150,12975,9975,-3000
2020,10,6,22,13760,13704,10589,-3115
2020,10,6,23,14180,14236,11186,-3050
2020,10,7,0,14140,14103,10949,-3154
2020,10,7,1,13460,13366,10178,-3188
2020,10,7,2,12530,12425,9133,-3292
2020,10,7,3,11400,11424,8086,-3338
2020,10,7,4,10410,10739,7701,-3038
2020,10,7,5,9800,10458,7245,-3213
2020,10,7,6,9410,10244,7025,-3219
2020,10,7,7,9240,10315,7031,-3284
2020,10,7,8,9210,10275,7038,-3237
2020,10,7,9,9470,10268,7107,-3161
2020,10,7,10,10210,10600,7499,-3101
2020,10,7,11,11470,11509,8441,-3068
2020,10,7,12,12410,12384,9396,-2988
2020,10,7,13,12560,12571,9609,-2962
2020,10,7,14,12210,12229,9386,-2843
2020,10,7,15,12060,12072,9235,-2837
2020,10,7,16,12040,12041,9286,-2755
2020,10,7,17,12550,12529,9760,-2769
2020,10,7,18,13290,13277,10506,-2771
2020,10,7,19,13540,13542,10861,-2681
2020,10,7,20,13460,13470,10681,-2789
2020,10,7,21,13590,13610,10817,-2793
2020,10,7,22,13920,13916,11528,-2388
2020,10,7,23,13840,13840,11586,-2254
2020,10,8,0,13390,13391,11270,-2121
2020,10,8,1,12720,12731,10574,-2157
2020,10,8,2,12010,11877,9691,-2186
2020,10,8,3,11080,11007,8821,-2186
2020,10,8,4,10260,10415,8129,-2286
2020,10,8,5,9560,10223,8054,-2169
2020,10,8,6,9180,10235,8170,-2065
2020,10,8,7,8990,10053,7888,-2165
2020,10,8,8,8960,10022,7731,-2291
2020,10,8,9,9220,10263,7847,-2416
2020,10,8,10,9960,10813,8500,-2313
2020,10,8,11,11250,11317,9030,-2287
2020,10,8,12,12050,12086,9525,-2561
2020,10,8,13,12090,12109,9508,-2601
2020,10,8,14,11580,11596,9161,-2435
2020,10,8,15,11220,11224,8823,-2401
2020,10,8,16,10970,11009,8711,-2298
2020,10,8,17,10870,10996,8544,-2452
2020,10,8,18,10880,11161,8670,-2491
2020,10,8,19,10880,11280,8951,-2329
2020,10,8,20,11370,11409,9062,-2347
2020,10,8,21,12100,12174,9596,-2578
2020,10,8,22,13080,13176,10536,-2640
2020,10,8,23,13860,13854,11217,-2637
2020,10,9,0,13840,13817,11260,-2557
2020,10,9,1,13320,13130,10534,-2596
2020,10,9,2,12500,12268,9473,-2795
2020,10,9,3,11410,11497,8497,-3000
2020,10,9,4,10460,10845,7982,-2863
2020,10,9,5,9690,10485,7833,-2652
2020,10,9,6,9360,10420,7799,-2621
2020,10,9,7,9220,10287,7685,-2602
2020,10,9,8,9220,10275,7815,-2460
2020,10,9,9,9510,10550,7885,-2665
2020,10,9,10,10280,11039,8076,-2963
2020,10,9,11,11600,11836,8911,-2925
2020,10,9,12,12480,12500,9243,-3257
2020,10,9,13,12370,12412,9309,-3103
2020,10,9,14,11730,11787,8915,-2872
2020,10,9,15,11390,11465,8949,-2516
2020,10,9,16,10900,11243,8900,-2343
2020,10,9,17,10650,11080,8916,-2164
2020,10,9,18,10710,11034,8865,-2169
2020,10,9,19,10780,11087,8865,-2222
2020,10,9,20,11140,11428,9075,-2353
2020,10,9,21,11750,11996,9401,-2595
2020,10,9,22,12600,12932,10002,-2930
2020,10,9,23,13250,13538,10448,-3090
2020,10,10,0,13190,13436,10095,-3341
2020,10,10,1,12600,12857,9732,-3125
2020,10,10,2,11870,12122,9173,-2949
2020,10,10,3,11100,11212,8271,-2941
2020,10,10,4,10260,10340,7443,-2897
2020,10,10,5,9690,9720,6784,-2936
2020,10,10,6,9290,9325,6560,-2765
2020,10,10,7,9040,9363,6576,-2787
2020,10,10,8,8940,9243,6732,-2511
2020,10,10,9,9010,9316,6823,-2493
2020,10,10,10,9310,9589,7067,-2522
2020,10,10,11,9840,10418,7581,-2837
2020,10,10,12,10450,10715,7703,-3012
2020,10,10,13,10820,10863,7962,-2901
2020,10,10,14,10630,10879,7694,-3185
2020,10,10,15,10480,10543,7437,-3106
2020,10,10,16,10440,10491,7511,-2980
2020,10,10,17,10390,10545,7929,-2616
2020,10,10,18,10380,10610,8069,-2541
2020,10,10,19,10540,10871,8119,-2752
2020,10,10,20,11130,10933,8007,-2926
2020,10,10,21,11850,11759,8548,-3211
2020,10,10,22,12700,12605,9243,-3362
2020,10,10,23,13130,13215,9960,-3255
2020,10,11,0,13080,13068,9910,-3158
2020,10,11,1,12620,12496,9328,-3168
2020,10,11,2,11960,11855,8754,-3101
2020,10,11,3,11270,11116,7997,-3119
2020,10,11,4,10540,10382,7436,-2946
2020,10,11,5,9800,10072,6945,-3127
2020,10,11,6,9370,9931,7102,-2829
2020,10,11,7,9140,9680,6825,-2855
2020,10,11,8,8980,9529,6792,-2737
2020,10,11,9,8930,9469,6756,-2713
2020,10,11,10,9040,9575,6618,-2957
2020,10,11,11,9390,9908,6727,-3181
2020,10,11,12,9810,10255,7116,-3139
2020,10,11,13,9850,10179,7139,-3040
2020,10,11,14,9750,9999,7035,-2964
2020,10,11,15,9450,9763,7109,-2654
2020,10,11,16,9380,9661,7218,-2443
2020,10,11,17,9420,9519,7300,-2219
2020,10,11,18,9620,9594,7417,-2177
2020,10,11,19,9870,9702,7406,-2296
2020,10,11,20,10440,10307,7819,-2488
2020,10,11,21,11370,11226,8525,-2701
2020,10,11,22,12350,12173,9221,-2952
2020,10,11,23,13230,12912,9955,-2957
2020,10,12,0,13030,12744,9605,-3139
2020,10,12,1,12430,12173,9062,-3111
2020,10,12,2,11680,11443,8380,-3063
2020,10,12,3,10690,10618,7572,-3046
2020,10,12,4,9840,9860,6907,-2953
2020,10,12,5,9300,9626,6769,-2857
2020,10,12,6,8980,9749,6771,-2978
2020,10,12,7,8830,9615,6740,-2875
2020,10,12,8,8810,9594,6772,-2822
2020,10,12,9,9050,9796,6738,-3058
2020,10,12,10,9670,9817,6788,-3029
2020,10,12,11,10680,10649,7670,-2979
2020,10,12,12,11610,11577,8678,-2899
2020,10,12,13,12300,12298,9478,-2820
2020,10,12,14,12670,12671,9885,-2786
2020,10,12,15,12860,12861,10145,-2716
2020,10,12,16,12840,12854,10261,-2593
2020,10,12,17,12640,12652,10113,-2539
2020,10,12,18,12430,12442,9878,-2564
2020,10,12,19,12390,12391,9828,-2563
2020,10,12,20,12570,12555,9988,-2567
2020,10,12,21,13100,13082,10478,-2604
2020,10,12,22,13870,13825,11132,-2693
2020,10,12,23,14480,14206,11660,-2546
2020,10,13,0,14120,13841,11260,-2581
2020,10,13,1,13280,13179,10489,-2690
2020,10,13,2,12350,12246,9494,-2752
2020,10,13,3,11230,11237,8489,-2748
2020,10,13,4,10300,10817,8072,-2745
2020,10,13,5,9670,10379,7624,-2755
2020,10,13,6,9320,10401,7541,-2860
2020,10,13,7,9150,10232,7407,-2825
2020,10,13,8,9150,10217,7359,-2858
2020,10,13,9,9420,10475,7747,-2728
2020,10,13,10,10190,11164,8595,-2569
2020,10,13,11,11530,12066,9558,-2508
2020,10,13,12,12690,12677,10067,-2610
2020,10,13,13,13360,13339,10717,-2622
2020,10,13,14,13650,13613,10966,-2647
2020,10,13,15,13740,13739,11084,-2655
2020,10,13,16,13800,13979,11202,-2777
2020,10,13,17,13780,14030,11121,-2909
2020,10,13,18,13690,13991,11053,-2938
2020,10,13,19,13530,13864,10927,-2937
2020,10,13,20,13600,13772,10820,-2952
2020,10,13,21,13860,13943,10979,-2964
2020,10,13,22,14280,14427,11504,-2923
2020,10,13,23,14600,14557,11704,-2853
2020,10,14,0,14340,14065,11187,-2878
2020,10,14,1,13540,13349,10581,-2768
2020,10,14,2,12540,12387,9811,-2576
2020,10,14,3,11370,11568,8464,-3104
2020,10,14,4,10400,11204,7777,-3427
2020,10,14,5,9770,10872,7747,-3125
2020,10,14,6,9420,10497,7454,-3043
2020,10,14,7,9230,10300,7130,-3170
2020,10,14,8,9190,10256,7131,-3125
2020,10,14,9,9440,10488,7303,-3185
2020,10,14,10,10220,11007,8072,-2935
2020,10,14,11,11540,11696,8934,-2762
2020,10,14,12,12460,12451,9682,-2769
2020,10,14,13,12370,12396,9544,-2852
2020,10,14,14,11800,11808,9178,-2630
2020,10,14,15,11510,11336,8711,-2625
2020,10,14,16,11270,11252,8740,-2512
2020,10,14,17,11230,11497,8816,-2681
2020,10,14,18,11410,11640,8973,-2667
2020,10,14,19,11580,11848,9096,-2752
2020,10,14,20,12030,12023,9309,-2714
2020,10,14,21,12790,12498,9644,-2854
2020,10,14,22,13530,13418,10166,-3252
2020,10,14,23,14090,14088,11175,-2913
2020,10,15,0,14030,13860,10740,-3120
2020,10,15,1,13360,13130,9953,-3177
2020,10,15,2,12440,12206,8923,-3283
2020,10,15,3,11320,11454,8276,-3178
2020,10,15,4,10330,10762,7882,-2880
2020,10,15,5,9630,10006,7365,-2641
2020,10,15,6,9310,9828,7179,-2649
2020,10,15,7,9130,9674,7046,-2628
2020,10,15,8,9130,9876,7041,-2835
2020,10,15,9,9390,10068,6946,-3122
2020,10,15,10,10130,10226,7146,-3080
2020,10,15,11,11540,11497,8540,-2957
2020,10,15,12,12510,12505,9437,-3068
2020,10,15,13,12520,12538,9585,-2953
2020,10,15,14,11980,12013,8969,-3044
2020,10,15,15,11700,11621,8623,-2998
2020,10,15,16,11490,11493,8771,-2722
2020,10,15,17,11530,11339,8889,-2450
2020,10,15,18,11700,11404,9019,-2385
2020,10,15,19,11840,11501,9075,-2426
2020,10,15,20,12230,12189,9501,-2688
2020,10,15,21,12820,12804,9868,-2936
2020,10,15,22,13570,13582,10453,-3129
2020,10,15,23,14150,14203,11274,-2929
2020,10,16,0,13970,14013,10983,-3030
2020,10,16,1,13370,13375,10341,-3034
2020,10,16,2,12460,12442,9507,-2935
2020,10,16,3,11370,11602,8650,-2952
2020,10,16,4,10430,10780,8361,-2419
2020,10,16,5,9880,10068,7878,-2190
2020,10,16,6,9540,9628,7424,-2204
2020,10,16,7,9350,9608,7207,-2401
2020,10,16,8,9250,9515,6801,-2714
2020,10,16,9,9500,9737,7198,-2539
2020,10,16,10,10180,10398,7683,-2715
2020,10,16,11,11530,11536,8717,-2819
2020,10,16,12,12670,12650,9439,-3211
2020,10,16,13,13260,13279,10267,-3012
2020,10,16,14,13560,13566,10792,-2774
2020,10,16,15,13750,13768,10776,-2992
2020,10,16,16,13890,13982,11019,-2963
2020,10,16,17,13950,14049,10832,-3217
2020,10,16,18,13970,13899,10623,-3276
2020,10,16,19,13860,13668,10440,-3228
2020,10,16,20,13880,13555,10379,-3176
2020,10,16,21,13970,13638,10361,-3277
2020,10,16,22,14300,13951,10646,-3305
2020,10,16,23,14400,13997,10914,-3083
2020,10,17,0,13860,13480,10264,-3216
2020,10,17,1,13180,12813,10021,-2792
2020,10,17,2,12330,12063,9097,-2966
2020,10,17,3,11440,11183,7990,-3193
2020,10,17,4,10520,10358,7337,-3021
2020,10,17,5,9700,9708,7020,-2688
2020,10,17,6,9350,9525,7200,-2325
2020,10,17,7,9130,9391,6997,-2394
2020,10,17,8,9020,9353,6920,-2433
2020,10,17,9,9080,9624,7098,-2526
2020,10,17,10,9390,9682,7087,-2595
2020,10,17,11,10000,10262,7613,-2649
2020,10,17,12,10720,10941,8060,-2881
2020,10,17,13,11270,11312,8760,-2552
2020,10,17,14,11350,11343,8777,-2566
2020,10,17,15,10760,10769,8219,-2550
2020,10,17,16,10360,10521,7642,-2879
2020,10,17,17,9950,10220,7433,-2787
2020,10,17,18,9670,10011,7475,-2536
2020,10,17,19,9750,10188,7744,-2444
2020,10,17,20,10260,10687,8055,-2632
2020,10,17,21,11060,11197,8480,-2717
2020,10,17,22,12150,12299,9063,-3236
2020,10,17,23,13000,13048,10030,-3018
2020,10,18,0,12720,12925,9995,-2930
2020,10,18,1,12270,12445,9481,-2964
2020,10,18,2,11760,11863,8893,-2970
2020,10,18,3,11050,11396,8359,-3037
2020,10,18,4,10310,10503,7657,-2846
2020,10,18,5,9780,9806,7183,-2623
2020,10,18,6,9450,9929,7377,-2552
2020,10,18,7,9260,9822,7199,-2623
2020,10,18,8,9160,9702,6965,-2737
2020,10,18,9,9210,9749,7045,-2704
2020,10,18,10,9460,9820,7191,-2629
2020,10,18,11,9980,9965,7398,-2567
2020,10,18,12,10530,10518,7757,-2761
2020,10,18,13,10820,10819,8255,-2564
2020,10,18,14,10570,10583,8066,-2517
2020,10,18,15,10250,10256,7954,-2302
2020,10,18,16,10040,10042,7695,-2347
2020,10,18,17,9840,9997,7558,-2439
2020,10,18,18,9730,9990,7593,-2397
2020,10,18,19,9990,10259,7777,-2482
2020,10,18,20,10530,10834,8331,-2503
2020,10,18,21,11390,11486,8844,-2642
2020,10,18,22,12460,12580,10032,-2548
2020,10,18,23,13200,13451,10763,-2688
2020,10,19,0,13040,13196,10354,-2842
2020,10,19,1,12510,12572,9865,-2707
2020,10,19,2,11700,11779,9304,-2475
2020,10,19,3,10760,10873,8214,-2659
2020,10,19,4,9940,10304,7558,-2746
2020,10,19,5,9480,9783,7020,-2763
2020,10,19,6,9180,9508,6643,-2865
2020,10,19,7,9060,9603,6709,-2894
2020,10,19,8,9100,9671,6899,-2772
2020,10,19,9,9350,10182,7309,-2873
2020,10,19,10,10330,10554,8002,-2552
2020,10,19,11,11900,11681,9780,-1901
2020,10,19,12,12860,12818,11287,-1531
2020,10,19,13,12900,12934,11478,-1456
2020,10,19,14,12500,12513,10984,-1529
2020,10,19,15,12330,12175,10559,-1616
2020,10,19,16,12200,12112,10264,-1848
2020,10,19,17,12180,12081,10085,-1996
2020,10,19,18,12190,12169,10432,-1737
2020,10,19,19,12320,12145,10168,-1977
2020,10,19,20,12500,12410,10377,-2033
2020,10,19,21,13060,12943,10778,-2165
2020,10,19,22,13820,13816,11760,-2056
2020,10,19,23,14400,14397,12536,-1861
2020,10,20,0,14070,13954,12160,-1794
2020,10,20,1,13350,13213,10994,-2219
2020,10,20,2,12380,12253,9797,-2456
2020,10,20,3,11260,11201,8771,-2430
2020,10,20,4,10290,10359,8036,-2323
2020,10,20,5,9610,9905,7631,-2274
2020,10,20,6,9270,9782,7752,-2030
2020,10,20,7,9100,9623,7666,-1957
2020,10,20,8,9090,9605,7598,-2007
2020,10,20,9,9360,9845,7973,-1872
2020,10,20,10,10130,10358,8704,-1654
2020,10,20,11,11530,11487,10049,-1438
2020,10,20,12,12620,12618,10932,-1686
2020,10,20,13,13130,13118,11305,-1813
2020,10,20,14,13250,13255,11407,-1848
2020,10,20,15,13220,13250,11257,-1993
2020,10,20,16,13190,13108,10934,-2174
2020,10,20,17,13210,13229,10740,-2489
2020,10,20,18,13200,13179,10863,-2316
2020,10,20,19,13250,13123,11079,-2044
2020,10,20,20,13330,13187,10844,-2343
2020,10,20,21,13540,13505,11025,-2480
2020,10,20,22,14050,14145,11802,-2343
2020,10,20,23,14600,14528,12365,-2163
2020,10,21,0,14260,14112,12071,-2041
2020,10,21,1,13510,13386,10956,-2430
2020,10,21,2,12560,12429,10001,-2428
2020,10,21,3,11440,11389,8973,-2416
2020,10,21,4,10460,10543,8098,-2445
2020,10,21,5,9880,10382,7878,-2504
2020,10,21,6,9520,10298,7849,-2449
2020,10,21,7,9340,10138,7715,-2423
2020,10,21,8,9240,10019,7856,-2163
2020,10,21,9,9430,10192,8238,-1954
2020,10,21,10,10150,10415,8672,-1743
2020,10,21,11,11430,11387,9718,-1669
2020,10,21,12,12570,12557,11004,-1553
2020,10,21,13,13100,13093,11489,-1604
2020,10,21,14,13160,13196,11618,-1578
2020,10,21,15,13140,13207,11533,-1674
2020,10,21,16,13130,13263,11492,-1771
2020,10,21,17,13110,13125,12040,-1085
2020,10,21,18,13150,12895,11132,-1763
2020,10,21,19,13170,12753,10976,-1777
2020,10,21,20,13260,13024,10895,-2129
2020,10,21,21,13680,13564,10991,-2573
2020,10,21,22,14270,14237,11580,-2657
2020,10,21,23,14750,14631,11954,-2677
2020,10,22,0,14410,14281,11578,-2703
2020,10,22,1,13760,13646,11005,-2641
2020,10,22,2,12870,12768,10133,-2635
2020,10,22,3,11760,11785,9067,-2718
2020,10,22,4,10770,10905,8187,-2718
2020,10,22,5,10180,10368,7660,-2708
2020,10,22,6,9750,10138,7500,-2638
2020,10,22,7,9520,10247,7392,-2855
2020,10,22,8,9440,10190,7334,-2856
2020,10,22,9,9640,10374,7522,-2852
2020,10,22,10,10490,10683,7962,-2721
2020,10,22,11,11940,11556,8874,-2682
2020,10,22,12,12860,12610,9865,-2745
2020,10,22,13,12790,12821,10252,-2569
2020,10,22,14,12510,12514,10083,-2431
2020,10,22,15,12220,12233,10176,-2057
2020,10,22,16,12150,12122,10046,-2076
2020,10,22,17,12230,12138,9932,-2206
2020,10,22,18,12410,12347,10248,-2099
2020,10,22,19,12690,12673,10292,-2381
2020,10,22,20,13070,13029,10567,-2462
2020,10,22,21,13590,13554,10982,-2572
2020,10,22,22,14150,14174,11473,-2701
2020,10,22,23,14750,14585,11866,-2719
2020,10,23,0,14310,14230,11583,-2647
2020,10,23,1,13650,13601,10813,-2788
2020,10,23,2,12680,12621,9908,-2713
2020,10,23,3,11550,11638,8922,-2716
2020,10,23,4,10540,10819,8153,-2666
2020,10,23,5,10040,10302,7567,-2735
2020,10,23,6,9560,10286,7608,-2678
2020,10,23,7,9360,10151,7333,-2818
2020,10,23,8,9320,10040,7331,-2709
2020,10,23,9,9510,10235,7533,-2702
2020,10,23,10,10320,10417,7906,-2511
2020,10,23,11,11660,11356,9128,-2228
2020,10,23,12,12810,12482,9928,-2554
2020,10,23,13,13080,12994,10588,-2406
2020,10,23,14,13100,13079,10654,-2425
2020,10,23,15,13060,12938,10431,-2507
2020,10,23,16,12890,12723,10245,-2478
2020,10,23,17,12730,12530,9966,-2564
2020,10,23,18,12730,12476,9859,-2617
2020,10,23,19,12710,12489,9892,-2597
2020,10,23,20,12850,12632,9964,-2668
2020,10,23,21,13200,13042,10586,-2456
2020,10,23,22,13720,13646,10844,-2802
2020,10,23,23,14050,14013,11193,-2820
2020,10,24,0,13680,13566,10990,-2576
2020,10,24,1,12980,12909,10112,-2797
2020,10,24,2,12270,12145,9387,-2758
2020,10,24,3,11340,11274,8595,-2679
2020,10,24,4,10480,10522,7900,-2622
2020,10,24,5,9940,10108,7562,-2546
2020,10,24,6,9400,10105,7510,-2595
2020,10,24,7,9200,9876,7318,-2558
2020,10,24,8,9040,9744,7343,-2401
2020,10,24,9,9100,9771,7163,-2608
2020,10,24,10,9320,10059,7388,-2671
2020,10,24,11,9860,10518,7722,-2796
2020,10,24,12,10710,10825,8055,-2770
2020,10,24,13,11220,11210,8413,-2797
2020,10,24,14,11660,11388,8658,-2730
2020,10,24,15,11760,11614,8924,-2690
2020,10,24,16,11840,11911,9236,-2675
2020,10,24,17,11780,11947,9222,-2725
2020,10,24,18,11940,11973,9200,-2773
2020,10,24,19,12030,11884,9160,-2724
2020,10,24,20,12110,11760,9082,-2678
2020,10,24,21,12190,12093,9352,-2741
2020,10,24,22,12550,12731,9927,-2804
2020,10,24,23,12990,13138,10392,-2746
2020,10,25,0,12650,12715,9959,-2756
2020,10,25,1,12050,12122,9390,-2732
2020,10,25,2,11420,11462,8838,-2624
2020,10,25,3,10710,10725,8027,-2698
2020,10,25,4,9980,9967,7408,-2559
2020,10,25,5,9530,9539,6938,-2601
2020,10,25,6,9130,9705,7012,-2693
2020,10,25,7,8950,9599,6853,-2746
2020,10,25,8,8870,9515,6800,-2715
2020,10,25,9,8970,9573,6796,-2777
2020,10,25,10,9270,9832,6963,-2869
2020,10,25,11,9780,10062,7221,-2841
2020,10,25,12,10410,10613,7777,-2836
2020,10,25,13,10810,10869,8199,-2670
2020,10,25,14,10900,11043,8516,-2527
2020,10,25,15,10720,10866,8343,-2523
2020,10,25,16,10570,11012,8382,-2630
2020,10,25,17,10530,10915,8249,-2666
2020,10,25,18,10520,10942,8240,-2702
2020,10,25,19,10600,10961,8211,-2750
2020,10,25,20,10950,11373,8711,-2662
2020,10,25,21,11790,11911,9464,-2447
2020,10,25,22,12840,12995,10468,-2527
2020,10,25,23,13640,13701,11185,-2516
2020,10,26,0,13490,13355,10638,-2717
2020,10,26,1,12930,12718,9996,-2722
2020,10,26,2,12090,11924,9237,-2687
2020,10,26,3,11130,10994,8304,-2690
2020,10,26,4,10290,10137,7490,-2647
2020,10,26,5,9560,9700,7196,-2504
2020,10,26,6,9230,9552,7090,-2462
2020,10,26,7,9100,9696,7134,-2562
2020,10,26,8,9120,9871,7472,-2399
2020,10,26,9,9450,10019,7648,-2371
2020,10,26,10,10430,10513,8136,-2377
2020,10,26,11,12090,11833,9480,-2353
2020,10,26,12,13200,12872,10467,-2405
2020,10,26,13,13490,13545,11069,-2476
2020,10,26,14,13790,13865,11470,-2395
2020,10,26,15,13910,14049,11643,-2406
2020,10,26,16,14010,14119,11682,-2437
2020,10,26,17,13990,14057,11592,-2465
2020,10,26,18,13960,14005,11734,-2271
2020,10,26,19,13870,13809,11466,-2343
2020,10,26,20,13870,13789,11511,-2278
2020,10,26,21,14040,14039,11773,-2266
2020,10,26,22,14450,14635,12502,-2133
2020,10,26,23,14950,14742,12907,-1835
2020,10,27,0,14420,14211,11964,-2247
2020,10,27,1,13620,13457,10960,-2497
2020,10,27,2,12600,12511,10015,-2496
2020,10,27,3,11460,11457,8979,-2478
2020,10,27,4,10480,10687,8387,-2300
2020,10,27,5,9690,10355,8172,-2183
2020,10,27,6,9360,10130,7991,-2139
2020,10,27,7,9190,10054,7547,-2507
2020,10,27,8,9140,10006,7487,-2519
2020,10,27,9,9430,10245,7735,-2510
2020,10,27,10,10350,10483,8433,-2050
2020,10,27,11,12010,11580,9679,-1901
2020,10,27,12,13010,12742,10341,-2401
2020,10,27,13,13100,13289,10766,-2523
2020,10,27,14,13270,13346,10977,-2369
2020,10,27,15,13200,13172,10766,-2406
2020,10,27,16,13100,12781,10194,-2587
2020,10,27,17,13040,12429,9768,-2661
2020,10,27,18,12010,11969,9731,-2238
2020,10,27,19,12080,11961,9584,-2377
2020,10,27,20,12380,12539,10234,-2305
2020,10,27,21,13080,13162,10803,-2359
2020,10,27,22,13960,14107,11603,-2504
2020,10,27,23,14610,14545,12310,-2235
2020,10,28,0,14270,14066,11669,-2397
2020,10,28,1,13580,13358,11016,-2342
2020,10,28,2,12660,12518,10058,-2460
2020,10,28,3,11530,11697,9432,-2265
2020,10,28,4,10580,10803,8330,-2473
2020,10,28,5,9920,10190,7954,-2236
2020,10,28,6,9550,10058,7937,-2121
2020,10,28,7,9350,10123,8097,-2026
2020,10,28,8,9340,10116,8036,-2080
2020,10,28,9,9570,10136,8193,-1943
2020,10,28,10,10530,10811,8807,-2004
2020,10,28,11,12150,11822,9878,-1944
2020,10,28,12,13230,13015,11115,-1900
2020,10,28,13,13480,13685,11620,-2065
2020,10,28,14,13990,13961,12158,-1803
2020,10,28,15,14000,14154,12180,-1974
2020,10,28,16,13960,14217,12203,-2014
2020,10,28,17,13900,14224,12192,-2032
2020,10,28,18,13890,14042,11982,-2060
2020,10,28,19,13830,13807,11549,-2258
2020,10,28,20,13840,13765,11495,-2270
2020,10,28,21,13930,14007,11783,-2224
2020,10,28,22,14240,14606,12319,-2287
2020,10,28,23,14700,14834,12544,-2290
2020,10,29,0,14420,14296,12005,-2291
2020,10,29,1,13690,13551,11280,-2271
2020,10,29,2,12780,12668,10410,-2258
2020,10,29,3,11670,11883,9656,-2227
2020,10,29,4,10700,11239,9012,-2227
2020,10,29,5,10030,10817,8596,-2221
2020,10,29,6,9650,10425,8327,-2098
2020,10,29,7,9450,10224,8018,-2206
2020,10,29,8,9450,10206,7952,-2254
2020,10,29,9,9720,10473,8136,-2337
2020,10,29,10,10540,11270,8869,-2401
2020,10,29,11,11930,12626,10289,-2337
2020,10,29,12,13090,13310,10911,-2399
2020,10,29,13,13630,13627,11213,-2414
2020,10,29,14,13900,13889,11518,-2371
2020,10,29,15,14090,14094,11874,-2220
2020,10,29,16,14220,14223,11939,-2284
2020,10,29,17,14280,14286,11988,-2298
2020,10,29,18,14240,14249,11904,-2345
2020,10,29,19,14150,14165,11853,-2312
2020,10,29,20,14160,14180,11900,-2280
2020,10,29,21,14240,14441,12090,-2351
2020,10,29,22,14630,14975,12673,-2302
2020,10,29,23,15000,15024,12716,-2308
2020,10,30,0,14620,14620,12266,-2354
2020,10,30,1,13930,13900,10919,-2981
2020,10,30,2,13040,13072,10039,-3033
2020,10,30,3,11960,12195,9151,-3044
2020,10,30,4,11020,11263,8216,-3047
2020,10,30,5,10370,11059,8040,-3019
2020,10,30,6,10010,10774,8042,-2732
2020,10,30,7,9830,10596,8050,-2546
2020,10,30,8,9870,10606,8005,-2601
2020,10,30,9,10140,10883,8280,-2603
2020,10,30,10,10970,11594,8887,-2707
2020,10,30,11,12350,12412,9700,-2712
2020,10,30,12,13690,13880,10799,-3081
2020,10,30,13,14550,14558,11523,-3035
2020,10,30,14,15000,15024,12012,-3012
2020,10,30,15,15080,15306,12227,-3079
2020,10,30,16,15000,15434,12227,-3207
2020,10,30,17,14920,15344,12118,-3226
2020,10,30,18,14880,15202,11880,-3322
2020,10,30,19,14880,14930,11558,-3372
2020,10,30,20,14920,14681,11363,-3318
2020,10,30,21,15100,14740,11530,-3210
2020,10,30,22,15530,15142,11984,-3158
2020,10,30,23,16000,15501,12409,-3092
2020,10,31,0,15560,15560,12409,-9999
2020,10,31,1,14520,14541,11433,-3108
2020,10,31,2,13810,13785,10760,-3025
2020,10,31,3,12860,13023,9853,-3170
2020,10,31,4,12010,12248,9174,-3074
2020,10,31,5,11370,11391,8395,-2996
2020,10,31,6,11000,11296,8584,-2712
2020,10,31,7,10780,11331,8689,-2642
2020,10,31,8,10750,11287,8870,-2417
2020,10,31,9,10870,11405,8850,-2555
2020,10,31,10,11280,11652,9035,-2617
2020,10,31,11,11940,11926,9340,-2586
2020,10,31,12,12700,12678,10352,-2326
2020,10,31,13,13310,13305,10964,-2341
2020,10,31,14,13450,13395,10937,-2458
2020,10,31,15,13440,13157,10608,-2549
2020,10,31,16,13130,12674,10082,-2592
2020,10,31,17,12760,12097,9347,-2750
2020,10,31,18,12550,11604,8814,-2790
2020,10,31,19,12510,11373,8689,-2684
2020,10,31,20,12520,11660,8964,-2696
2020,10,31,21,12660,12522,9955,-2567
2020,10,31,22,13510,13510,10960,-2550
2020,10,31,23,14500,14074,11583,-2491
2020,11,1,0,14170,13828,11353,-2475
2020,11,1,1,13760,13448,11141,-2307
2020,11,1,2,13220,12916,10603,-2313
2020,11,1,3,12530,12201,9918,-2283
2020,11,1,4,11810,11479,9149,-2330
2020,11,1,5,10920,10915,8583,-2332
2020,11,1,6,10700,10829,8496,-2333
2020,11,1,7,10700,10913,8747,-2166
2020,11,1,8,10190,11120,8805,-2315
2020,11,1,9,10090,11136,8827,-2309
2020,11,1,10,10210,10967,8528,-2439
2020,11,1,11,10520,11031,8520,-2511
2020,11,1,12,11000,11262,8753,-2509
2020,11,1,13,11460,11451,8922,-2529
2020,11,1,14,11880,11865,9238,-2627
2020,11,1,15,12120,12117,9631,-2486
2020,11,1,16,12340,12346,9833,-2513
2020,11,1,17,12440,12433,9918,-2515
2020,11,1,18,12580,12587,10075,-2512
2020,11,1,19,12930,12910,10575,-2335
2020,11,1,20,13240,13259,10998,-2261
2020,11,1,21,13550,13543,11069,-2474
2020,11,1,22,14070,14267,11733,-2534
2020,11,1,23,14600,14682,12173,-2509
2020,11,2,0,14380,14207,11629,-2578
2020,11,2,1,13650,13517,10816,-2701
2020,11,2,2,13100,12992,10257,-2735
2020,11,2,3,12290,12179,9449,-2730
2020,11,2,4,11430,11317,8715,-2602
2020,11,2,5,10690,11002,8477,-2525
2020,11,2,6,9920,10720,7976,-2744
2020,11,2,7,9710,10497,7625,-2872
2020,11,2,8,9670,10652,7859,-2793
2020,11,2,9,9810,10708,8000,-2708
2020,11,2,10,10240,11008,8323,-2685
2020,11,2,11,11240,11840,9209,-2631
2020,11,2,12,12650,12638,10360,-2278
2020,11,2,13,13390,13367,10722,-2645
2020,11,2,14,13340,13352,10529,-2823
2020,11,2,15,13360,13370,10526,-2844
2020,11,2,16,13410,13468,10758,-2710
2020,11,2,17,13400,13529,10813,-2716
2020,11,2,18,13340,13517,10876,-2641
2020,11,2,19,13110,13286,10660,-2626
2020,11,2,20,13490,13390,10832,-2558
2020,11,2,21,14280,14099,11469,-2630
2020,11,2,22,15030,15276,12535,-2741
2020,11,2,23,16100,16324,13627,-2697
2020,11,3,0,16040,16011,13117,-2894
2020,11,3,1,15580,15410,12564,-2846
2020,11,3,2,14680,14614,11788,-2826
2020,11,3,3,13720,13670,11029,-2641
2020,11,3,4,12530,12609,10039,-2570
2020,11,3,5,11600,11736,9281,-2455
2020,11,3,6,11130,11545,9016,-2529
2020,11,3,7,10750,11306,8751,-2555
2020,11,3,8,10580,11126,8511,-2615
2020,11,3,9,10580,11117,8544,-2573
2020,11,3,10,10930,11437,8850,-2587
2020,11,3,11,11800,12066,9497,-2569
2020,11,3,12,13040,13000,10562,-2438
2020,11,3,13,13800,13799,11364,-2435
2020,11,3,14,13700,13715,11322,-2393
2020,11,3,15,13390,13391,10999,-2392
2020,11,3,16,12940,12955,10606,-2349
2020,11,3,17,12560,12636,10241,-2395
2020,11,3,18,12480,12550,10177,-2373
2020,11,3,19,12560,12889,10516,-2373
2020,11,3,20,12920,13173,10688,-2485
2020,11,3,21,13630,13935,11501,-2434
2020,11,3,22,14720,14970,12383,-2587
2020,11,3,23,15800,15965,13361,-2604
2020,11,4,0,15680,15774,13086,-2688
2020,11,4,1,15250,15201,12458,-2743
2020,11,4,2,14550,14508,11748,-2760
2020,11,4,3,13650,13685,10905,-2780
2020,11,4,4,12570,12708,9930,-2778
2020,11,4,5,11670,11886,9398,-2488
2020,11,4,6,11260,11532,9078,-2454
2020,11,4,7,10910,11430,9034,-2396
2020,11,4,8,10710,11507,9212,-2295
2020,11,4,9,10680,11455,9081,-2374
2020,11,4,10,10950,11480,9142,-2338
2020,11,4,11,11920,11909,9724,-2185
2020,11,4,12,13460,13166,11022,-2144
2020,11,4,13,13950,13815,11575,-2240
2020,11,4,14,13150,13343,11165,-2178
2020,11,4,15,12540,12676,10451,-2225
2020,11,4,16,12030,12234,10090,-2144
2020,11,4,17,11680,12478,10319,-2159
2020,11,4,18,11590,12474,10167,-2307
2020,11,4,19,11790,12681,10525,-2156
2020,11,4,20,12200,12805,10617,-2188
2020,11,4,21,12940,13438,11136,-2302
2020,11,4,22,13940,14267,11906,-2361
2020,11,4,23,14940,15322,13036,-2286
2020,11,5,0,14740,15025,12812,-2213
2020,11,5,1,14290,14366,12035,-2331
2020,11,5,2,13630,13609,11088,-2521
2020,11,5,3,12720,12667,10178,-2489
2020,11,5,4,11630,11878,9556,-2322
2020,11,5,5,10750,11414,9015,-2399
2020,11,5,6,10150,10717,8383,-2334
2020,11,5,7,9810,10389,8037,-2352
2020,11,5,8,9660,10234,7859,-2375
2020,11,5,9,9700,10250,7777,-2473
2020,11,5,10,9950,10556,8205,-2351
2020,11,5,11,10870,11336,8925,-2411
2020,11,5,12,12340,12156,9807,-2349
2020,11,5,13,12870,12725,10216,-2509
2020,11,5,14,12370,12496,9835,-2661
2020,11,5,15,11900,12039,9299,-2740
2020,11,5,16,11710,11773,9260,-2513
2020,11,5,17,11660,11912,9394,-2518
2020,11,5,18,11720,11979,9444,-2535
2020,11,5,19,11960,12042,9736,-2306
2020,11,5,20,12290,12541,9905,-2636
2020,11,5,21,12970,12989,10347,-2642
2020,11,5,22,13800,13868,11054,-2814
2020,11,5,23,14650,14788,12054,-2734
2020,11,6,0,14410,14504,11711,-2793
2020,11,6,1,13920,13872,11087,-2785
2020,11,6,2,13290,13165,10340,-2825
2020,11,6,3,12300,12264,9481,-2783
2020,11,6,4,11250,11435,8838,-2597
2020,11,6,5,10330,11150,8815,-2335
2020,11,6,6,9650,10886,8255,-2631
2020,11,6,7,9440,10505,8009,-2496
2020,11,6,8,9160,10062,7847,-2215
2020,11,6,9,9230,10011,7792,-2219
2020,11,6,10,9430,10153,7878,-2275
2020,11,6,11,10430,10453,8027,-2426
2020,11,6,12,11650,11474,8940,-2534
2020,11,6,13,12300,12317,9635,-2682
2020,11,6,14,12310,12471,9835,-2636
2020,11,6,15,12040,12017,9466,-2551
2020,11,6,16,11870,11530,9156,-2374
2020,11,6,17,11670,11325,8931,-2394
2020,11,6,18,11440,11333,8940,-2393
2020,11,6,19,11550,11647,9205,-2442
2020,11,6,20,11820,12125,9684,-2441
2020,11,6,21,12720,12752,10171,-2581
2020,11,6,22,13440,13442,10826,-2616
2020,11,6,23,14170,14232,11692,-2540
2020,11,7,0,13790,13874,11259,-2615
2020,11,7,1,13270,13260,10587,-2673
2020,11,7,2,12580,12599,10007,-2592
2020,11,7,3,11860,11875,9142,-2733
2020,11,7,4,10980,11021,8216,-2805
2020,11,7,5,10190,10210,7454,-2756
2020,11,7,6,9640,9654,7322,-2332
2020,11,7,7,9280,9447,7091,-2356
2020,11,7,8,9100,9334,6847,-2487
2020,11,7,9,9020,9499,6975,-2524
2020,11,7,10,9120,9625,7220,-2405
2020,11,7,11,9460,9770,7463,-2307
2020,11,7,12,10010,10307,8111,-2196
2020,11,7,13,10210,10380,8156,-2224
2020,11,7,14,10480,10382,8168,-2214
2020,11,7,15,10280,10246,8121,-2125
2020,11,7,16,10090,10417,8280,-2137
2020,11,7,17,9980,10374,8270,-2104
2020,11,7,18,9970,10479,8404,-2075
2020,11,7,19,10130,10690,8640,-2050
2020,11,7,20,10630,11018,8941,-2077
2020,11,7,21,11450,11661,9695,-1966
2020,11,7,22,12490,12546,10219,-2327
2020,11,7,23,13200,13387,11143,-2244
2020,11,8,0,12760,13099,10829,-2270
2020,11,8,1,12320,12549,10238,-2311
2020,11,8,2,11950,11909,9624,-2285
2020,11,8,3,11200,11324,9067,-2257
2020,11,8,4,10530,10815,8618,-2197
2020,11,8,5,9810,10142,7829,-2313
2020,11,8,6,9370,9595,7443,-2152
2020,11,8,7,8940,9291,7242,-2049
2020,11,8,8,8730,9327,7335,-1992
2020,11,8,9,8650,9257,7272,-1985
2020,11,8,10,8740,9331,7315,-2016
2020,11,8,11,9060,9603,7625,-1978
2020,11,8,12,9460,10041,7841,-2200
2020,11,8,13,9690,10182,8280,-1902
2020,11,8,14,9850,10172,8243,-1929
2020,11,8,15,9600,10179,8320,-1859
2020,11,8,16,9380,9716,7931,-1785
2020,11,8,17,9370,9804,7966,-1838
2020,11,8,18,9470,10013,8172,-1841
2020,11,8,19,9800,10322,8347,-1975
2020,11,8,20,10290,10877,8865,-2012
2020,11,8,21,11490,11751,9583,-2168
2020,11,8,22,12780,12775,10517,-2258
2020,11,8,23,13590,13766,11443,-2323
2020,11,9,0,13260,13459,10986,-2473
2020,11,9,1,12890,12860,10418,-2442
2020,11,9,2,12350,12190,9718,-2472
2020,11,9,3,11370,11434,9048,-2386
2020,11,9,4,10540,11017,8619,-2398
2020,11,9,5,9760,10493,8061,-2432
2020,11,9,6,9280,10095,7657,-2438
2020,11,9,7,9020,9816,7498,-2318
2020,11,9,8,8900,9935,7438,-2497
2020,11,9,9,8960,9844,7621,-2223
2020,11,9,10,9300,10078,7869,-2209
2020,11,9,11,10200,10779,8372,-2407
2020,11,9,12,11540,11606,9097,-2509
2020,11,9,13,12290,12283,9798,-2485
2020,11,9,14,12040,12063,9751,-2312
2020,11,9,15,11400,11598,9373,-2225
2020,11,9,16,11210,11470,9418,-2052
2020,11,9,17,11070,11459,9379,-2080
2020,11,9,18,11150,11625,9531,-2094
2020,11,9,19,11510,11966,9959,-2007
2020,11,9,20,11950,12472,10247,-2225
2020,11,9,21,12910,13138,10893,-2245
2020,11,9,22,13950,13922,11437,-2485
2020,11,9,23,14620,14886,12339,-2547
2020,11,10,0,14470,14520,11876,-2644
2020,11,10,1,13990,13835,11202,-2633
2020,11,10,2,13280,13005,10441,-2564
2020,11,10,3,12200,12092,9498,-2594
2020,11,10,4,11120,11098,8729,-2369
2020,11,10,5,10190,10426,8390,-2036
2020,11,10,6,9640,10189,7837,-2352
2020,11,10,7,9290,9845,7821,-2024
2020,11,10,8,9150,9936,7840,-2096
2020,11,10,9,9170,9964,7823,-2141
2020,11,10,10,9470,10083,7899,-2184
2020,11,10,11,10320,10730,8071,-2659
2020,11,10,12,11630,11882,9034,-2848
2020,11,10,13,12350,12461,9695,-2766
2020,11,10,14,12130,12146,9226,-2920
2020,11,10,15,11700,11795,9057,-2738
2020,11,10,16,11490,11688,8990,-2698
2020,11,10,17,11430,11742,9216,-2526
2020,11,10,18,11660,11854,9159,-2695
2020,11,10,19,11960,11998,9345,-2653
2020,11,10,20,12330,12579,9939,-2640
2020,11,10,21,12980,13280,10372,-2908
2020,11,10,22,13950,14003,11093,-2910
2020,11,10,23,14740,14918,12035,-2883
2020,11,11,0,14530,14545,11601,-2944
2020,11,11,1,14050,13840,10899,-2941
2020,11,11,2,13410,13047,10086,-2961
2020,11,11,3,12330,12137,9303,-2834
2020,11,11,4,11220,11176,8449,-2727
2020,11,11,5,10300,10584,8047,-2537
2020,11,11,6,9730,10529,7986,-2543
2020,11,11,7,9380,10458,7645,-2813
2020,11,11,8,9180,10243,7715,-2528
2020,11,11,9,9150,10183,7608,-2575
2020,11,11,10,9390,10326,8013,-2313
2020,11,11,11,10080,10848,8109,-2739
2020,11,11,12,11150,11895,8964,-2931
2020,11,11,13,11980,12638,9735,-2903
2020,11,11,14,12520,12703,9748,-2955
2020,11,11,15,12680,12717,9715,-3002
2020,11,11,16,12750,12994,9922,-3072
2020,11,11,17,12840,13162,10008,-3154
2020,11,11,18,13040,13440,10188,-3252
2020,11,11,19,13270,13732,10315,-3417
2020,11,11,20,13610,13836,10329,-3507
2020,11,11,21,13790,13984,10408,-3576
2020,11,11,22,14410,14664,11031,-3633
2020,11,11,23,15130,15275,11725,-3550
2020,11,12,0,14610,14893,11361,-3532
2020,11,12,1,14040,14181,10636,-3545
2020,11,12,2,13390,13403,9841,-3562
2020,11,12,3,12420,12493,9093,-3400
2020,11,12,4,11370,11552,8155,-3397
2020,11,12,5,10490,11150,7768,-3382
2020,11,12,6,10000,10560,7473,-3087
2020,11,12,7,9670,10410,7294,-3116
2020,11,12,8,9480,10541,7643,-2898
2020,11,12,9,9420,10211,7474,-2737
2020,11,12,10,9650,10429,7690,-2739
2020,11,12,11,10350,10665,7985,-2680
2020,11,12,12,11580,11914,9294,-2620
2020,11,12,13,12650,12627,9941,-2686
2020,11,12,14,13060,13183,10491,-2692
2020,11,12,15,13410,13464,10749,-2715
2020,11,12,16,13480,13604,10866,-2738
2020,11,12,17,13510,13681,10608,-3073
2020,11,12,18,13500,13664,10455,-3209
2020,11,12,19,13580,13641,10452,-3189
2020,11,12,20,13650,13539,10249,-3290
2020,11,12,21,13760,13636,10521,-3115
2020,11,12,22,14380,14274,11130,-3144
2020,11,12,23,15160,14862,11818,-3044
2020,11,13,0,14970,14528,11536,-2992
2020,11,13,1,14400,13889,10897,-2992
2020,11,13,2,13630,13160,10192,-2968
2020,11,13,3,12710,12267,9482,-2785
2020,11,13,4,11310,11344,8503,-2841
2020,11,13,5,10410,11015,7975,-3040
2020,11,13,6,9860,10679,7844,-2835
2020,11,13,7,9530,10575,7861,-2714
2020,11,13,8,9340,10393,7367,-3026
2020,11,13,9,9360,10398,7477,-2921
2020,11,13,10,9640,10666,7675,-2991
2020,11,13,11,10460,11035,8349,-2686
2020,11,13,12,11770,11762,9491,-2271
2020,11,13,13,12850,12835,10118,-2717
2020,11,13,14,13490,13496,10588,-2908
2020,11,13,15,13680,13826,10751,-3075
2020,11,13,16,13790,14108,10916,-3192
2020,11,13,17,13790,14284,11158,-3126
2020,11,13,18,13760,14281,11159,-3122
2020,11,13,19,13830,14246,11050,-3196
2020,11,13,20,13820,14119,10922,-3197
2020,11,13,21,13990,14135,10893,-3242
2020,11,13,22,14590,14590,11294,-3296
2020,11,13,23,15010,15120,11878,-3242
2020,11,14,0,14630,14754,11425,-3329
2020,11,14,1,14020,14139,10827,-3312
2020,11,14,2,13370,13458,10409,-3049
2020,11,14,3,12640,12690,9939,-2751
2020,11,14,4,11740,11774,9122,-2652
2020,11,14,5,10940,10940,8292,-2648
2020,11,14,6,10340,10352,7760,-2592
2020,11,14,7,9970,10232,7659,-2573
2020,11,14,8,9790,10056,7415,-2641
2020,11,14,9,9750,10010,7342,-2668
2020,11,14,10,9880,10143,7623,-2520
2020,11,14,11,10290,10309,7969,-2340
2020,11,14,12,10920,10914,8586,-2328
2020,11,14,13,11350,11349,8903,-2446
2020,11,14,14,11440,11436,8886,-2550
2020,11,14,15,11190,11197,8540,-2657
2020,11,14,16,11220,11210,8456,-2754
2020,11,14,17,11620,11890,9030,-2860
2020,11,14,18,11700,11920,9069,-2851
2020,11,14,19,11310,11922,8787,-3135
2020,11,14,20,11810,12024,8921,-3103
2020,11,14,21,12580,12470,9379,-3091
2020,11,14,22,13430,13528,10321,-3207
2020,11,14,23,14220,14458,11062,-3396
2020,11,15,0,13900,14239,10821,-3418
2020,11,15,1,13470,13751,10608,-3143
2020,11,15,2,12960,13269,10227,-3042
2020,11,15,3,12380,12637,9809,-2828
2020,11,15,4,11710,11997,9106,-2891
2020,11,15,5,11030,11465,8366,-3099
2020,11,15,6,10690,11368,8514,-2854
2020,11,15,7,10370,11192,8983,-2209
2020,11,15,8,10230,11206,9152,-2054
2020,11,15,9,10200,11277,9048,-2229
2020,11,15,10,10330,11138,8686,-2452
2020,11,15,11,10670,11215,8854,-2361
2020,11,15,12,11160,11516,9115,-2401
2020,11,15,13,11430,11823,9184,-2639
2020,11,15,14,11360,11931,9250,-2681
2020,11,15,15,11440,11988,9600,-2388
2020,11,15,16,11470,11972,9782,-2190
2020,11,15,17,11670,12299,10118,-2181
2020,11,15,18,11910,12460,10232,-2228
2020,11,15,19,12220,12830,10881,-1949
2020,11,15,20,12550,13002,10927,-2075
2020,11,15,21,13000,13399,11167,-2232
2020,11,15,22,13850,14357,11754,-2603
2020,11,15,23,14520,14940,12098,-2842
2020,11,16,0,14170,14537,11992,-2545
2020,11,16,1,13550,13847,11483,-2364
2020,11,16,2,12810,13123,10959,-2164
2020,11,16,3,11870,12240,9944,-2296
2020,11,16,4,10970,11380,9139,-2241
2020,11,16,5,10250,10887,8281,-2606
2020,11,16,6,9850,10564,8348,-2216
2020,11,16,7,9550,10245,8088,-2157
2020,11,16,8,9430,10123,8098,-2025
2020,11,16,9,9470,10140,8005,-2135
2020,11,16,10,9820,10678,8469,-2209
2020,11,16,11,10750,11007,8404,-2603
2020,11,16,12,12280,11960,9178,-2782
2020,11,16,13,12990,12744,9739,-3005
2020,11,16,14,12760,12602,9545,-3057
2020,11,16,15,12350,12161,9092,-3069
2020,11,16,16,12100,12081,9448,-2633
2020,11,16,17,12400,12396,9880,-2516
2020,11,16,18,12600,12759,10263,-2496
2020,11,16,19,12850,13130,10674,-2456
2020,11,16,20,12970,13360,10615,-2745
2020,11,16,21,13660,13686,10782,-2904
2020,11,16,22,14720,14581,11583,-2998
2020,11,16,23,15600,15488,12389,-3099
2020,11,17,0,15500,15205,11882,-3323
2020,11,17,1,14930,14546,11359,-3187
2020,11,17,2,14190,13798,10999,-2799
2020,11,17,3,13250,12906,10477,-2429
2020,11,17,4,12130,11903,9717,-2186
2020,11,17,5,11180,11468,9159,-2309
2020,11,17,6,10490,11035,9103,-1932
2020,11,17,7,10170,10944,8812,-2132
2020,11,17,8,10060,10824,8689,-2135
2020,11,17,9,10130,10877,8728,-2149
2020,11,17,10,10490,11227,8837,-2390
2020,11,17,11,11440,12102,9515,-2587
2020,11,17,12,12910,12773,10071,-2702
2020,11,17,13,13640,13632,10707,-2925
2020,11,17,14,13590,13638,10569,-3069
2020,11,17,15,13250,13261,10468,-2793
2020,11,17,16,13000,13287,10619,-2668
2020,11,17,17,12880,13229,10358,-2871
2020,11,17,18,12900,13168,10328,-2840
2020,11,17,19,13120,13422,10594,-2828
2020,11,17,20,13420,13712,10921,-2791
2020,11,17,21,14000,14158,11265,-2893
2020,11,17,22,15020,15115,11992,-3123
2020,11,17,23,15950,15944,12758,-3186
2020,11,18,0,15720,15646,12461,-3185
2020,11,18,1,15120,15062,11863,-3199
2020,11,18,2,14490,14358,11357,-3001
2020,11,18,3,13640,13464,10693,-2771
2020,11,18,4,12570,12489,9801,-2688
2020,11,18,5,11690,12306,9461,-2845
2020,11,18,6,11040,11841,9109,-2732
2020,11,18,7,10750,11761,9010,-2751
2020,11,18,8,10650,11682,9025,-2657
2020,11,18,9,10730,11728,9097,-2631
2020,11,18,10,11130,11873,9151,-2722
2020,11,18,11,12100,12289,9564,-2725
2020,11,18,12,13580,13505,10830,-2675
2020,11,18,13,14430,14439,11550,-2889
2020,11,18,14,13890,14321,11409,-2912
2020,11,18,15,13680,13735,10776,-2959
2020,11,18,16,13290,13526,10668,-2858
2020,11,18,17,13060,13534,10566,-2968
2020,11,18,18,13010,13508,10519,-2989
2020,11,18,19,13190,13634,10663,-2971
2020,11,18,20,13690,14114,11082,-3032
2020,11,18,21,14440,14950,11872,-3078
2020,11,18,22,15720,16148,13022,-3126
2020,11,18,23,16750,17030,13871,-3159
2020,11,19,0,16610,16787,13675,-3112
2020,11,19,1,16170,16308,13102,-3206
2020,11,19,2,15550,15643,12465,-3178
2020,11,19,3,14650,14716,11681,-3035
2020,11,19,4,13570,13650,10747,-2903
2020,11,19,5,12600,12781,9696,-3085
2020,11,19,6,12200,12208,9387,-2821
2020,11,19,7,11890,11941,8854,-3087
2020,11,19,8,11780,12045,8940,-3105
2020,11,19,9,11830,12096,9100,-2996
2020,11,19,10,12130,12168,9266,-2902
2020,11,19,11,13010,12993,10051,-2942
2020,11,19,12,14410,14378,11368,-3010
2020,11,19,13,15150,15150,12052,-3098
2020,11,19,14,14920,14941,11886,-3055
2020,11,19,15,14630,14555,11636,-2919
2020,11,19,16,14120,14044,11099,-2945
2020,11,19,17,13870,13708,10798,-2910
2020,11,19,18,13670,13671,11026,-2645
2020,11,19,19,13790,14090,11670,-2420
2020,11,19,20,14060,14382,12028,-2354
2020,11,19,21,14630,14874,12460,-2414
2020,11,19,22,15620,15784,13162,-2622
2020,11,19,23,16230,16489,13675,-2814
2020,11,20,0,16010,16127,13480,-2647
2020,11,20,1,15520,15500,12904,-2596
2020,11,20,2,14820,14704,12157,-2547
2020,11,20,3,13880,13896,11253,-2643
2020,11,20,4,12770,12854,10272,-2582
2020,11,20,5,11780,12055,9098,-2957
2020,11,20,6,10930,11512,9062,-2450
2020,11,20,7,10520,11324,9025,-2299
2020,11,20,8,10280,11095,8990,-2105
2020,11,20,9,10270,11069,9112,-1957
2020,11,20,10,10550,11344,9367,-1977
2020,11,20,11,11320,11638,9614,-2024
2020,11,20,12,12620,12610,10630,-1980
2020,11,20,13,13390,13381,11558,-1823
2020,11,20,14,13320,13323,11608,-1715
2020,11,20,15,12860,12896,11230,-1666
2020,11,20,16,12510,12509,10677,-1832
2020,11,20,17,12320,12318,10859,-1459
2020,11,20,18,12200,12291,10668,-1623
2020,11,20,19,12230,12453,10684,-1769
2020,11,20,20,12550,12720,10764,-1956
2020,11,20,21,13200,13219,11077,-2142
2020,11,20,22,14190,14074,11614,-2460
2020,11,20,23,15000,14804,12428,-2376
2020,11,21,0,14430,14491,12206,-2285
2020,11,21,1,13950,13933,11909,-2024
2020,11,21,2,13360,13266,11346,-1920
2020,11,21,3,12650,12519,10649,-1870
2020,11,21,4,11800,11602,9926,-1676
2020,11,21,5,10940,11190,9195,-1995
2020,11,21,6,10160,10691,8466,-2225
2020,11,21,7,9780,10575,8327,-2248
2020,11,21,8,9590,10635,8396,-2239
2020,11,21,9,9550,10618,8429,-2189
2020,11,21,10,9680,10479,8306,-2173
2020,11,21,11,10080,10875,8457,-2418
2020,11,21,12,10700,11309,8711,-2598
2020,11,21,13,11160,11502,8771,-2731
2020,11,21,14,11340,11668,8813,-2855
2020,11,21,15,11120,11503,8781,-2722
2020,11,21,16,10900,11241,8638,-2603
2020,11,21,17,10710,11191,8648,-2543
2020,11,21,18,10760,11124,8697,-2427
2020,11,21,19,10750,11375,8834,-2541
2020,11,21,20,11180,11759,9288,-2471
2020,11,21,21,12050,12273,9805,-2468
2020,11,21,22,13160,13311,10721,-2590
2020,11,21,23,14000,14092,11417,-2675
2020,11,22,0,13640,13822,11129,-2693
2020,11,22,1,13260,13278,10661,-2617
2020,11,22,2,12780,12713,10297,-2416
2020,11,22,3,12210,12058,9624,-2434
2020,11,22,4,11530,11316,9040,-2276
2020,11,22,5,10810,10876,8522,-2354
2020,11,22,6,10100,10130,8196,-1934
2020,11,22,7,9820,10070,8057,-2013
2020,11,22,8,9680,9950,8143,-1807
2020,11,22,9,9710,9963,8140,-1823
2020,11,22,10,9870,10100,8196,-1904
2020,11,22,11,10220,10223,8059,-2164
2020,11,22,12,10800,10794,8392,-2402
2020,11,22,13,11300,11453,9018,-2435
2020,11,22,14,11590,11840,9697,-2143
2020,11,22,15,11830,11931,9784,-2147
2020,11,22,16,12410,12410,10268,-2142
2020,11,22,17,13000,13005,10732,-2273
2020,11,22,18,13510,13477,11037,-2440
2020,11,22,19,13810,13716,11129,-2587
2020,11,22,20,13990,13821,10998,-2823
2020,11,22,21,14380,14085,11218,-2867
2020,11,22,22,14930,14899,12167,-2732
2020,11,22,23,15500,15346,12563,-2783
2020,11,23,0,14870,14910,12245,-2665
2020,11,23,1,14220,14227,11524,-2703
2020,11,23,2,13590,13501,10491,-3010
2020,11,23,3,12690,12611,9868,-2743
2020,11,23,4,11710,11752,9129,-2623
2020,11,23,5,10860,11035,8562,-2473
2020,11,23,6,10180,10760,8048,-2712
2020,11,23,7,9840,10656,7854,-2802
2020,11,23,8,9690,10715,7886,-2829
2020,11,23,9,9700,10731,7911,-2820
2020,11,23,10,10010,10767,8000,-2767
2020,11,23,11,10790,11296,8393,-2903
2020,11,23,12,12130,12148,9247,-2901
2020,11,23,13,13280,13260,10429,-2831
2020,11,23,14,14060,14070,11148,-2922
2020,11,23,15,14480,14504,11550,-2954
2020,11,23,16,14540,14769,11465,-3304
2020,11,23,17,14450,14890,11416,-3474
2020,11,23,18,14310,14617,11103,-3514
2020,11,23,19,14210,14190,10813,-3377
2020,11,23,20,14250,14085,10633,-3452
2020,11,23,21,14460,14314,11205,-3109
2020,11,23,22,14980,15160,12055,-3105
2020,11,23,23,15850,16066,13126,-2940
2020,11,24,0,15670,15794,12825,-2969
2020,11,24,1,15100,15235,12196,-3039
2020,11,24,2,14350,14522,11640,-2882
2020,11,24,3,13420,13647,10353,-3294
2020,11,24,4,12360,12940,9786,-3154
2020,11,24,5,11430,12409,9174,-3235
2020,11,24,6,10970,12154,8926,-3228
2020,11,24,7,10610,11843,8734,-3109
2020,11,24,8,10510,11697,8874,-2823
2020,11,24,9,10570,11729,8985,-2744
2020,11,24,10,10940,12078,9342,-2736
2020,11,24,11,11940,12511,9665,-2846
2020,11,24,12,13620,13530,10398,-3132
2020,11,24,13,14500,14114,10804,-3310
2020,11,24,14,13940,14010,10846,-3164
2020,11,24,15,13220,13352,10243,-3109
2020,11,24,16,12760,13071,9808,-3263
2020,11,24,17,12510,12885,9821,-3064
2020,11,24,18,12470,12781,9961,-2820
2020,11,24,19,12630,13032,10240,-2792
2020,11,24,20,13140,13327,10358,-2969
2020,11,24,21,14030,14192,10960,-3232
2020,11,24,22,15300,15365,11923,-3442
2020,11,24,23,16250,16289,13138,-3151
2020,11,25,0,16080,16109,12501,-3608
2020,11,25,1,15820,15643,12022,-3621
2020,11,25,2,15200,15010,11311,-3699
2020,11,25,3,14320,14171,10534,-3637
2020,11,25,4,13240,13130,9548,-3582
2020,11,25,5,12310,12236,8516,-3720
2020,11,25,6,11560,11765,8214,-3551
2020,11,25,7,11210,11517,8284,-3233
2020,11,25,8,11040,11329,8147,-3182
2020,11,25,9,11000,11295,8153,-3142
2020,11,25,10,11280,11570,8372,-3198
2020,11,25,11,12050,12329,9292,-3037
2020,11,25,12,13250,13221,10487,-2734
2020,11,25,13,14210,14208,11542,-2666
2020,11,25,14,14730,14750,11935,-2815
2020,11,25,15,14820,14845,12000,-2845
2020,11,25,16,14630,14778,11830,-2948
2020,11,25,17,14420,14691,11773,-2918
2020,11,25,18,14200,14435,11652,-2783
2020,11,25,19,14150,14499,11730,-2769
2020,11,25,20,14240,14571,11955,-2616
2020,11,25,21,14520,14746,12043,-2703
2020,11,25,22,15420,15412,12678,-2734
2020,11,25,23,16000,15776,12833,-2943
2020,11,26,0,15710,15391,12330,-3061
2020,11,26,1,15220,14790,11815,-2975
2020,11,26,2,14530,14099,10848,-3251
2020,11,26,3,13580,13266,9897,-3369
2020,11,26,4,12410,12236,9078,-3158
2020,11,26,5,11410,11238,8227,-3011
2020,11,26,6,10470,10770,7568,-3202
2020,11,26,7,9990,10409,7175,-3234
2020,11,26,8,9690,10555,7033,-3522
2020,11,26,9,9600,10662,7234,-3428
2020,11,26,10,9690,10490,7298,-3192
2020,11,26,11,10040,10830,7428,-3402
2020,11,26,12,10650,11413,7928,-3485
2020,11,26,13,11420,11914,8505,-3409
2020,11,26,14,12510,12662,9229,-3433
2020,11,26,15,13540,13539,9993,-3546
2020,11,26,16,14290,14289,10702,-3587
2020,11,26,17,14720,14739,11043,-3696
2020,11,26,18,14800,14850,11051,-3799
2020,11,26,19,14380,14396,10391,-4005
2020,11,26,20,13710,13737,9966,-3771
2020,11,26,21,13460,13302,9765,-3537
2020,11,26,22,13710,13334,9760,-3574
2020,11,26,23,13930,13210,9350,-3860
2020,11,27,0,13520,12730,9417,-3313
2020,11,27,1,13120,12467,9374,-3093
2020,11,27,2,12670,12197,9328,-2869
2020,11,27,3,12100,11709,8877,-2832
2020,11,27,4,11330,11041,8590,-2451
2020,11,27,5,10440,10385,8473,-1912
2020,11,27,6,9620,10129,7947,-2182
2020,11,27,7,9300,9845,7674,-2171
2020,11,27,8,9150,9630,7479,-2151
2020,11,27,9,9130,9417,7453,-1964
2020,11,27,10,9340,9624,7447,-2177
2020,11,27,11,9880,10157,7796,-2361
2020,11,27,12,10640,10911,8000,-2911
2020,11,27,13,11190,11231,8410,-2821
2020,11,27,14,11640,11643,8801,-2842
2020,11,27,15,12030,12060,8996,-3064
2020,11,27,16,12180,12236,9018,-3218
2020,11,27,17,12220,12278,9094,-3184
2020,11,27,18,12380,12424,9177,-3247
2020,11,27,19,12450,12454,9406,-3048
2020,11,27,20,12620,12540,9482,-3058
2020,11,27,21,12940,12840,9637,-3203
2020,11,27,22,13740,13628,10326,-3302
2020,11,27,23,14210,14132,10990,-3142
2020,11,28,0,13760,13815,10858,-2957
2020,11,28,1,13280,13318,10211,-3107
2020,11,28,2,12760,12738,9949,-2789
2020,11,28,3,12120,12041,9291,-2750
2020,11,28,4,11420,11229,8460,-2769
2020,11,28,5,10590,10417,8065,-2352
2020,11,28,6,9810,10104,7825,-2279
2020,11,28,7,9430,9965,7918,-2047
2020,11,28,8,9220,9743,7859,-1884
2020,11,28,9,9160,9675,7712,-1963
2020,11,28,10,9290,9798,7822,-1976
2020,11,28,11,9610,9893,7756,-2137
2020,11,28,12,10200,10182,7997,-2185
2020,11,28,13,10630,10777,8590,-2187
2020,11,28,14,11430,11383,8967,-2416
2020,11,28,15,11720,11729,9125,-2604
2020,11,28,16,11560,11637,8833,-2804
2020,11,28,17,11370,11413,8485,-2928
2020,11,28,18,11270,11594,8543,-3051
2020,11,28,19,11320,11772,8474,-3298
2020,11,28,20,11670,12034,8653,-3381
2020,11,28,21,12330,12556,8952,-3604
2020,11,28,22,13190,13529,10149,-3380
2020,11,28,23,13880,14282,10767,-3515
2020,11,29,0,13580,14083,10624,-3459
2020,11,29,1,13160,13648,10225,-3423
2020,11,29,2,12680,13172,9910,-3262
2020,11,29,3,12140,12543,9590,-2953
2020,11,29,4,11470,11798,8703,-3095
2020,11,29,5,10780,11025,8054,-2971
2020,11,29,6,10440,10647,7808,-2839
2020,11,29,7,10100,10344,7804,-2540
2020,11,29,8,9910,10160,8013,-2147
2020,11,29,9,9850,10101,7735,-2366
2020,11,29,10,9960,10106,7863,-2243
2020,11,29,11,10190,10268,7679,-2589
2020,11,29,12,10600,10794,8310,-2484
2020,11,29,13,11150,11213,8439,-2774
2020,11,29,14,11190,11217,8212,-3005
2020,11,29,15,10950,10896,7949,-2947
2020,11,29,16,10830,10586,7807,-2779
2020,11,29,17,10760,10476,7709,-2767
2020,11,29,18,10860,10574,7734,-2840
2020,11,29,19,11010,10846,8038,-2808
2020,11,29,20,11350,11470,8485,-2985
2020,11,29,21,12250,12385,9131,-3254
2020,11,29,22,13420,13839,10633,-3206
2020,11,29,23,14340,14819,11673,-3146
2020,11,30,0,14190,14650,11500,-3150
2020,11,30,1,13810,14178,10951,-3227
2020,11,30,2,13280,13572,10396,-3176
2020,11,30,3,12460,12740,9579,-3161
2020,11,30,4,11610,11744,8903,-2841
2020,11,30,5,10810,11310,8471,-2839
2020,11,30,6,10340,11105,7819,-3286
2020,11,30,7,10050,10832,7541,-3291
2020,11,30,8,9940,10723,7510,-3213
2020,11,30,9,10000,10784,7885,-2899
2020,11,30,10,10370,10840,8017,-2823
2020,11,30,11,11240,11493,8728,-2765
2020,11,30,12,12600,12592,9838,-2754
2020,11,30,13,13650,13634,10553,-3081
2020,11,30,14,14240,14233,10988,-3245
2020,11,30,15,14470,14465,11358,-3107
2020,11,30,16,14740,14740,11477,-3263
2020,11,30,17,14970,14977,11722,-3255
2020,11,30,18,15090,15085,11737,-3348
2020,11,30,19,15150,15146,11619,-3527
2020,11,30,20,15060,15072,11142,-3930
2020,11,30,21,15030,15042,11164,-3878
2020,11,30,22,15560,15534,12025,-3509
2020,11,30,23,15880,15886,12286,-3600
2020,12,1,0,15430,15366,11925,-3441
2020,12,1,1,14550,14658,11448,-3210
2020,12,1,2,13920,13791,10734,-3057
2020,12,1,3,12910,12797,9793,-3004
2020,12,1,4,11720,11704,8958,-2746
2020,12,1,5,10710,11014,8549,-2465
2020,12,1,6,10210,10611,7371,-3240
2020,12,1,7,9670,10235,7310,-2925
2020,12,1,8,9470,10250,7247,-3003
2020,12,1,9,9460,10226,7243,-2983
2020,12,1,10,9850,10308,7454,-2854
2020,12,1,11,10670,10622,7777,-2845
2020,12,1,12,11980,11631,8904,-2727
2020,12,1,13,12950,12608,9505,-3103
2020,12,1,14,13290,13107,9799,-3308
2020,12,1,15,13180,13159,9868,-3291
2020,12,1,16,13130,13083,9705,-3378
2020,12,1,17,13070,13168,10035,-3133
2020,12,1,18,13010,13142,10044,-3098
2020,12,1,19,12940,13021,9986,-3035
2020,12,1,20,13230,13302,10298,-3004
2020,12,1,21,13590,13439,10414,-3025
2020,12,1,22,14720,14515,11341,-3174
2020,12,1,23,15750,15437,12266,-3171
2020,12,2,0,15480,15216,11674,-3542
2020,12,2,1,14930,14662,11161,-3501
2020,12,2,2,14220,13940,10794,-3146
2020,12,2,3,13330,13081,9870,-3211
2020,12,2,4,12150,12031,8802,-3229
2020,12,2,5,11160,11115,8154,-2961
2020,12,2,6,10460,10807,7765,-3042
2020,12,2,7,10140,10693,7864,-2829
2020,12,2,8,10020,10646,7569,-3077
2020,12,2,9,10050,10854,7777,-3077
2020,12,2,10,10480,10991,7956,-3035
2020,12,2,11,11510,11461,8268,-3193
2020,12,2,12,13050,12629,9546,-3083
2020,12,2,13,13910,13661,10468,-3193
2020,12,2,14,13840,13827,10752,-3075
2020,12,2,15,13640,13483,10523,-2960
2020,12,2,16,13590,13380,10563,-2817
2020,12,2,17,13530,13898,10802,-3096
2020,12,2,18,13560,14076,11058,-3018
2020,12,2,19,13750,14230,11103,-3127
2020,12,2,20,14160,14441,11075,-3366
2020,12,2,21,14780,14781,11492,-3289
2020,12,2,22,15770,15783,12591,-3192
2020,12,2,23,16450,16511,13209,-3302
2020,12,3,0,16080,16231,12859,-3372
2020,12,3,1,15610,15631,12251,-3380
2020,12,3,2,15080,14892,11625,-3267
2020,12,3,3,14160,13939,10637,-3302
2020,12,3,4,12970,12804,9346,-3458
2020,12,3,5,11940,11962,8652,-3310
2020,12,3,6,11110,11417,8510,-2907
2020,12,3,7,10770,11072,8445,-2627
2020,12,3,8,10640,10947,8258,-2689
2020,12,3,9,10700,10981,8297,-2684
2020,12,3,10,11080,11348,8628,-2720
2020,12,3,11,12000,12231,9396,-2835
2020,12,3,12,13360,13339,10677,-2662
2020,12,3,13,14290,14282,11667,-2615
2020,12,3,14,14050,14088,11280,-2808
2020,12,3,15,13270,13263,10513,-2750
2020,12,3,16,12890,12854,10248,-2606
2020,12,3,17,12600,12633,9886,-2747
2020,12,3,18,12530,12666,9664,-3002
2020,12,3,19,12630,12865,9942,-2923
2020,12,3,20,13070,13543,10540,-3003
2020,12,3,21,13800,13940,10895,-3045
2020,12,3,22,14980,15178,12148,-3030
2020,12,3,23,15950,16126,13091,-3035
2020,12,4,0,15760,15959,12799,-3160
2020,12,4,1,15340,15382,12313,-3069
2020,12,4,2,14840,14667,11523,-3144
2020,12,4,3,13930,13697,10683,-3014
2020,12,4,4,12800,12536,9760,-2776
2020,12,4,5,11740,11817,9232,-2585
2020,12,4,6,10820,11605,8818,-2787
2020,12,4,7,10410,11498,8721,-2777
2020,12,4,8,10250,11306,8457,-2849
2020,12,4,9,10240,11283,8462,-2821
2020,12,4,10,10550,11589,8663,-2926
2020,12,4,11,11350,11909,8798,-3111
2020,12,4,12,12620,12843,9689,-3154
2020,12,4,13,13580,13738,10653,-3085
2020,12,4,14,13870,13877,10780,-3097
2020,12,4,15,13550,13642,10488,-3154
2020,12,4,16,13500,13333,10178,-3155
2020,12,4,17,13500,13416,10241,-3175
2020,12,4,18,13570,12736,9705,-3031
2020,12,4,19,13710,12934,10012,-2922
2020,12,4,20,14080,13360,10422,-2938
2020,12,4,21,14690,13840,10792,-3048
2020,12,4,22,15620,14803,11514,-3289
2020,12,4,23,16000,15411,12054,-3357
2020,12,5,0,15540,15115,11692,-3423
2020,12,5,1,14970,14566,11155,-3411
2020,12,5,2,14390,13929,10707,-3222
2020,12,5,3,13660,13140,10153,-2987
2020,12,5,4,12700,12141,9237,-2904
2020,12,5,5,11760,11536,8661,-2875
2020,12,5,6,10480,11266,7947,-3319
2020,12,5,7,10050,10891,7735,-3156
2020,12,5,8,9800,10861,7736,-3125
2020,12,5,9,9720,10764,7681,-3083
2020,12,5,10,9820,10827,7873,-2954
2020,12,5,11,10180,10875,7883,-2992
2020,12,5,12,10870,11372,8302,-3070
2020,12,5,13,11690,11917,9086,-2831
2020,12,5,14,12660,12878,9874,-3004
2020,12,5,15,13520,13504,10334,-3170
2020,12,5,16,14160,14149,10911,-3238
2020,12,5,17,14630,14623,11392,-3231
2020,12,5,18,14950,14941,11686,-3255
2020,12,5,19,15070,15009,11719,-3290
2020,12,5,20,14970,15018,11654,-3364
2020,12,5,21,15190,15170,11868,-3302
2020,12,5,22,15880,15857,12543,-3314
2020,12,5,23,16250,16231,12833,-3398
2020,12,6,0,15750,15766,12308,-3458
2020,12,6,1,15200,15055,11498,-3557
2020,12,6,2,14480,14371,10794,-3577
2020,12,6,3,13670,13614,9937,-3677
2020,12,6,4,12860,12893,9267,-3626
2020,12,6,5,12030,12299,8838,-3461
2020,12,6,6,11130,11686,8284,-3402
2020,12,6,7,10730,11278,8117,-3161
2020,12,6,8,10520,11048,8055,-2993
2020,12,6,9,10460,11036,7966,-3070
2020,12,6,10,10580,11344,8237,-3107
2020,12,6,11,10860,11390,8216,-3174
2020,12,6,12,11390,11706,8495,-3211
2020,12,6,13,11920,12101,8683,-3418
2020,12,6,14,12420,12399,8855,-3544
2020,12,6,15,12650,12611,9104,-3507
2020,12,6,16,12430,12563,9205,-3358
2020,12,6,17,12270,12575,9100,-3475
2020,12,6,18,12280,12689,9138,-3551
2020,12,6,19,12400,12918,9440,-3478
2020,12,6,20,12780,13381,10004,-3377
2020,12,6,21,13600,14133,10865,-3268
2020,12,6,22,15020,15473,12053,-3420
2020,12,6,23,16000,16336,12911,-3425
2020,12,7,0,15880,16167,12804,-3363
2020,12,7,1,15510,15668,12280,-3388
2020,12,7,2,15000,15051,11639,-3412
2020,12,7,3,14290,14182,10743,-3439
2020,12,7,4,13320,13153,9679,-3474
2020,12,7,5,12410,12564,9032,-3532
2020,12,7,6,11660,12200,8847,-3353
2020,12,7,7,11280,12044,8808,-3236
2020,12,7,8,11200,11926,8807,-3119
2020,12,7,9,11270,11994,9029,-2965
2020,12,7,10,11660,12579,9497,-3082
2020,12,7,11,12730,13225,9819,-3406
2020,12,7,12,14380,14151,10954,-3197
2020,12,7,13,15240,14928,11615,-3313
2020,12,7,14,15000,15097,11837,-3260
2020,12,7,15,14790,14813,11746,-3067
2020,12,7,16,14370,14637,11142,-3495
2020,12,7,17,14100,14746,11208,-3538
2020,12,7,18,13970,14889,11321,-3568
2020,12,7,19,14160,14892,11305,-3587
2020,12,7,20,14470,14966,11360,-3606
2020,12,7,21,15060,15457,11997,-3460
2020,12,7,22,16290,16639,13252,-3387
2020,12,7,23,17250,17506,14109,-3397
2020,12,8,0,17060,17241,13742,-3499
2020,12,8,1,16630,16701,13149,-3552
2020,12,8,2,16020,15970,12380,-3590
2020,12,8,3,15080,14983,11475,-3508
2020,12,8,4,13900,13746,10088,-3658
2020,12,8,5,12810,12780,9420,-3360
2020,12,8,6,11980,12230,9142,-3088
2020,12,8,7,11580,12204,9116,-3088
2020,12,8,8,11420,12392,9301,-3091
2020,12,8,9,11480,12509,9408,-3101
2020,12,8,10,11810,12583,9686,-2897
2020,12,8,11,12660,13268,10292,-2976
2020,12,8,12,14080,14177,11253,-2924
2020,12,8,13,14810,15157,12735,-2422
2020,12,8,14,15730,15716,13240,-2476
2020,12,8,15,15770,15850,13332,-2518
2020,12,8,16,15560,15903,13293,-2610
2020,12,8,17,15320,15887,13218,-2669
2020,12,8,18,15080,15769,13050,-2719
2020,12,8,19,15150,15819,13079,-2740
2020,12,8,20,15300,15957,13231,-2726
2020,12,8,21,15700,16200,13535,-2665
2020,12,8,22,16780,17048,14427,-2621
2020,12,8,23,17500,17747,15073,-2674
2020,12,9,0,17350,17535,14716,-2819
2020,12,9,1,16920,17017,14161,-2856
2020,12,9,2,16310,16295,13416,-2879
2020,12,9,3,15390,15287,12315,-2972
2020,12,9,4,14150,14083,11211,-2872
2020,12,9,5,13090,13261,10564,-2697
2020,12,9,6,12370,12895,10247,-2648
2020,12,9,7,12000,12786,10045,-2741
2020,12,9,8,11870,12666,9985,-2681
2020,12,9,9,11900,12692,9992,-2700
2020,12,9,10,12250,12776,10156,-2620
2020,12,9,11,13270,13497,10941,-2556
2020,12,9,12,14780,14428,12054,-2374
2020,12,9,13,15670,15473,13040,-2433
2020,12,9,14,15700,15924,13323,-2601
2020,12,9,15,15790,15890,13318,-2572
2020,12,9,16,15660,15805,13275,-2530
2020,12,9,17,15470,15701,13178,-2523
2020,12,9,18,15310,15648,13040,-2608
2020,12,9,19,15360,15635,13002,-2633
2020,12,9,20,15500,15763,13311,-2452
2020,12,9,21,15720,15985,13628,-2357
2020,12,9,22,16780,16867,14506,-2361
2020,12,9,23,17400,17477,15249,-2228
2020,12,10,0,17170,17189,15014,-2175
2020,12,10,1,16730,16587,14321,-2266
2020,12,10,2,16100,15811,13486,-2325
2020,12,10,3,15130,14777,12195,-2582
2020,12,10,4,13880,13517,10996,-2521
2020,12,10,5,12760,12747,10508,-2239
2020,12,10,6,11710,12512,10127,-2385
2020,12,10,7,11320,12123,9779,-2344
2020,12,10,8,11100,11904,9429,-2475
2020,12,10,9,11090,11883,9584,-2299
2020,12,10,10,11380,11938,9669,-2269
2020,12,10,11,12280,12218,9928,-2290
2020,12,10,12,14240,13601,11394,-2207
2020,12,10,13,15030,14619,12361,-2258
2020,12,10,14,14710,14795,12446,-2349
2020,12,10,15,14190,14469,12184,-2285
2020,12,10,16,13960,14100,11744,-2356
2020,12,10,17,13840,13934,11415,-2519
2020,12,10,18,13810,13864,11301,-2563
2020,12,10,19,13930,13840,11303,-2537
2020,12,10,20,14210,14269,11759,-2510
2020,12,10,21,14810,14675,12354,-2321
2020,12,10,22,15710,15810,13601,-2209
2020,12,10,23,16660,16825,14614,-2211
2020,12,11,0,16530,16607,14254,-2353
2020,12,11,1,16100,16110,13571,-2539
2020,12,11,2,15460,15492,12827,-2665
2020,12,11,3,14640,14582,11830,-2752
2020,12,11,4,13490,13475,10564,-2911
2020,12,11,5,12430,12680,9645,-3035
2020,12,11,6,11720,12240,9382,-2858
2020,12,11,7,11340,11907,9347,-2560
2020,12,11,8,11200,11761,9280,-2481
2020,12,11,9,11250,11805,9346,-2459
2020,12,11,10,11560,12143,9704,-2439
2020,12,11,11,12370,12572,10091,-2481
2020,12,11,12,13800,13823,10987,-2836
2020,12,11,13,14680,14827,11782,-3045
2020,12,11,14,14560,14863,11748,-3115
2020,12,11,15,14140,14214,11177,-3037
2020,12,11,16,13850,13850,11177,-9999
2020,12,11,17,13610,13500,10597,-2903
2020,12,11,18,13510,13547,10657,-2890
2020,12,11,19,13630,13760,10774,-2986
2020,12,11,20,13870,14082,11045,-3037
2020,12,11,21,14310,14243,11313,-2930
2020,12,11,22,15250,15345,12439,-2906
2020,12,11,23,15900,16091,13083,-3008
2020,12,12,0,15500,15800,12678,-3122
2020,12,12,1,14990,15253,12170,-3083
2020,12,12,2,14430,14616,11654,-2962
2020,12,12,3,13720,13807,10696,-3111
2020,12,12,4,12740,12820,10021,-2799
2020,12,12,5,11770,12321,9489,-2832
2020,12,12,6,11180,11634,9084,-2550
2020,12,12,7,10750,11681,9046,-2635
2020,12,12,8,10540,11537,9088,-2449
2020,12,12,9,10490,11480,9115,-2365
2020,12,12,10,10650,11623,9202,-2421
2020,12,12,11,11100,11752,9280,-2472
2020,12,12,12,11680,11995,9572,-2423
2020,12,12,13,12440,12797,10118,-2679
2020,12,12,14,13130,12975,10226,-2749
2020,12,12,15,13420,13461,10799,-2662
2020,12,12,16,13560,13858,11279,-2579
2020,12,12,17,13610,14184,11679,-2505
2020,12,12,18,14260,14353,11870,-2483
2020,12,12,19,14320,14407,11739,-2668
2020,12,12,20,14350,14434,11610,-2824
2020,12,12,21,14500,14612,11895,-2717
2020,12,12,22,15000,15350,12711,-2639
2020,12,12,23,15500,15723,12899,-2824
2020,12,13,0,14910,15358,12594,-2764
2020,12,13,1,14340,14773,12067,-2706
2020,12,13,2,13760,14106,11263,-2843
2020,12,13,3,13090,13338,10349,-2989
2020,12,13,4,12240,12435,9482,-2953
2020,12,13,5,11340,11955,9020,-2935
2020,12,13,6,10610,11240,8429,-2811
2020,12,13,7,10210,10795,8062,-2733
2020,12,13,8,9960,10626,7746,-2880
2020,12,13,9,9850,10709,7634,-3075
2020,12,13,10,9920,10752,8051,-2701
2020,12,13,11,10060,10762,7979,-2783
2020,12,13,12,10470,11258,8241,-3017
2020,12,13,13,11020,11819,8633,-3186
2020,12,13,14,11540,11950,8608,-3342
2020,12,13,15,12130,12022,8730,-3292
2020,12,13,16,12300,11814,8537,-3277
2020,12,13,17,12290,11860,8677,-3183
2020,12,13,18,12360,12124,8908,-3216
2020,12,13,19,12490,12367,9077,-3290
2020,12,13,20,12770,12582,9324,-3258
2020,12,13,21,13300,13100,9883,-3217
2020,12,13,22,14170,14503,11403,-3100
2020,12,13,23,14950,15344,12090,-3254
2020,12,14,0,14770,15107,11761,-3346
2020,12,14,1,14320,14582,11297,-3285
2020,12,14,2,13710,13975,10750,-3225
2020,12,14,3,12920,13161,9818,-3343
2020,12,14,4,11950,12135,8843,-3292
2020,12,14,5,11090,11691,8370,-3321
2020,12,14,6,10650,11056,7913,-3143
2020,12,14,7,10360,10877,7608,-3269
2020,12,14,8,10270,10813,7648,-3165
2020,12,14,9,10370,11104,7825,-3279
2020,12,14,10,10730,11310,8136,-3174
2020,12,14,11,11620,12134,8834,-3300
2020,12,14,12,13090,13492,10289,-3203
2020,12,14,13,14360,14614,11398,-3216
2020,12,14,14,15110,15122,11728,-3394
2020,12,14,15,15480,15498,12202,-3296
2020,12,14,16,15710,15579,12365,-3214
2020,12,14,17,15810,15673,12301,-3372
2020,12,14,18,15820,15702,12297,-3405
2020,12,14,19,15920,15768,12381,-3387
2020,12,14,20,15940,15768,12422,-3346
2020,12,14,21,16180,15929,12628,-3301
2020,12,14,22,16870,16777,13415,-3362
2020,12,14,23,17430,17443,14066,-3377
2020,12,15,0,17040,17117,13700,-3417
2020,12,15,1,16540,16487,13155,-3332
2020,12,15,2,15870,15755,12454,-3301
2020,12,15,3,14880,14774,11595,-3179
2020,12,15,4,13670,13582,10304,-3278
2020,12,15,5,12570,12675,9368,-3307
2020,12,15,6,11800,12521,9499,-3022
2020,12,15,7,11440,12413,9712,-2701
2020,12,15,8,11320,12377,9604,-2773
2020,12,15,9,11390,12425,9722,-2703
2020,12,15,10,11760,12785,9964,-2821
2020,12,15,11,12660,13377,10316,-3061
2020,12,15,12,14140,14283,11138,-3145
2020,12,15,13,15200,15189,12115,-3074
2020,12,15,14,15190,15210,11922,-3288
2020,12,15,15,14450,14600,11479,-3121
2020,12,15,16,14050,14062,10987,-3075
2020,12,15,17,13870,13936,10686,-3250
2020,12,15,18,13780,13748,10239,-3509
2020,12,15,19,13940,13885,10470,-3415
2020,12,15,20,14420,14578,11166,-3412
2020,12,15,21,15170,15487,12092,-3395
2020,12,15,22,16610,16921,13479,-3442
2020,12,15,23,17700,17961,14648,-3313
2020,12,16,0,17550,17835,14449,-3386
2020,12,16,1,17180,17372,13904,-3468
2020,12,16,2,16590,16711,13183,-3528
2020,12,16,3,15690,15779,12392,-3387
2020,12,16,4,14530,14593,11113,-3480
2020,12,16,5,13460,13687,10287,-3400
2020,12,16,6,12860,13128,10152,-2976
2020,12,16,7,12520,12986,10047,-2939
2020,12,16,8,12380,12897,10130,-2767
2020,12,16,9,12460,12935,10177,-2758
2020,12,16,10,12840,13080,10480,-2600
2020,12,16,11,13750,13727,10986,-2741
2020,12,16,12,15200,15166,12628,-2538
2020,12,16,13,16260,16251,13743,-2508
2020,12,16,14,16350,16361,13960,-2401
2020,12,16,15,16230,16246,13780,-2466
2020,12,16,16,16330,16339,13704,-2635
2020,12,16,17,16300,16270,13391,-2879
2020,12,16,18,16390,16249,13528,-2721
2020,12,16,19,16370,16459,13712,-2747
2020,12,16,20,16380,16767,13867,-2900
2020,12,16,21,16540,17112,13974,-3138
2020,12,16,22,17580,18119,15154,-2965
2020,12,16,23,18360,18648,15655,-2993
2020,12,17,0,18090,18424,15237,-3187
2020,12,17,1,17680,17916,14783,-3133
2020,12,17,2,16990,17142,14050,-3092
2020,12,17,3,16010,16177,13175,-3002
2020,12,17,4,14710,14983,11799,-3184
2020,12,17,5,13570,14098,11072,-3026
2020,12,17,6,13170,13864,10744,-3120
2020,12,17,7,12750,13385,10568,-2817
2020,12,17,8,12530,13310,10301,-3009
2020,12,17,9,12500,12500,10301,-9999
2020,12,17,10,12660,12660,10480,-9999
2020,12,17,11,13530,13530,10986,-9999
2020,12,17,12,14640,14640,12628,-9999
2020,12,17,13,15450,15210,12596,-2614
2020,12,17,14,16300,16054,13646,-2408
2020,12,17,15,16630,16605,14029,-2576
2020,12,17,16,16990,16973,14825,-2148
2020,12,17,17,17080,17190,15080,-2110
2020,12,17,18,17000,17261,14383,-2878
2020,12,17,19,16930,17082,14444,-2638
2020,12,17,20,16910,16876,13977,-2899
2020,12,17,21,17040,16919,13957,-2962
2020,12,17,22,17940,17855,14800,-3055
2020,12,17,23,18600,18740,16122,-2618
2020,12,18,0,18300,18394,15509,-2885
2020,12,18,1,17990,17758,14649,-3109
2020,12,18,2,17310,16941,13956,-2985
2020,12,18,3,16320,15897,13282,-2615
2020,12,18,4,14990,14811,11857,-2954
2020,12,18,5,13960,13929,10783,-3146
2020,12,18,6,13060,13203,10458,-2745
2020,12,18,7,12650,12983,10433,-2550
2020,12,18,8,12460,13436,10858,-2578
2020,12,18,9,12450,13481,10995,-2486
2020,12,18,10,12710,13792,11381,-2411
2020,12,18,11,13570,14333,11850,-2483
2020,12,18,12,14970,15114,13203,-1911
2020,12,18,13,15990,15933,13939,-1994
2020,12,18,14,16470,16653,14453,-2200
2020,12,18,15,16830,16907,14502,-2405
2020,12,18,16,16610,17001,14562,-2439
2020,12,18,17,16290,16956,14484,-2472
2020,12,18,18,15890,16707,13882,-2825
2020,12,18,19,15640,16441,13663,-2778
2020,12,18,20,15600,16197,13432,-2765
2020,12,18,21,15850,16290,13528,-2762
2020,12,18,22,16910,17293,14626,-2667
2020,12,18,23,17850,18178,15346,-2832
2020,12,19,0,17400,17961,14927,-3034
2020,12,19,1,17030,17497,14722,-2775
2020,12,19,2,16540,16909,14395,-2514
2020,12,19,3,15880,16115,13719,-2396
2020,12,19,4,14960,15094,12426,-2668
2020,12,19,5,13980,14094,11318,-2776
2020,12,19,6,13420,13664,10721,-2943
2020,12,19,7,13000,13112,10343,-2769
2020,12,19,8,12800,12814,9927,-2887
2020,12,19,9,12830,12789,9937,-2852
2020,12,19,10,12980,12972,10076,-2896
2020,12,19,11,13380,13415,10580,-2835
2020,12,19,12,14090,14174,11333,-2841
2020,12,19,13,14850,15008,12294,-2714
2020,12,19,14,15700,15697,13021,-2676
2020,12,19,15,15890,15845,13212,-2633
2020,12,19,16,15800,15705,12955,-2750
2020,12,19,17,15580,15423,12501,-2922
2020,12,19,18,15400,15145,12379,-2766
2020,12,19,19,15220,15139,12356,-2783
2020,12,19,20,15270,15309,12482,-2827
2020,12,19,21,15580,15470,12574,-2896
2020,12,19,22,16560,16614,13595,-3019
2020,12,19,23,17180,17417,14320,-3097
2020,12,20,0,16850,17176,14048,-3128
2020,12,20,1,16330,16681,13585,-3096
2020,12,20,2,15850,16152,13066,-3086
2020,12,20,3,15240,15448,12404,-3044
2020,12,20,4,14390,14478,11427,-3051
2020,12,20,5,13460,13525,10430,-3095
2020,12,20,6,12770,13009,10195,-2814
2020,12,20,7,12270,12611,9795,-2816
2020,12,20,8,12010,12565,9634,-2931
2020,12,20,9,11920,12452,9466,-2986
2020,12,20,10,11940,12505,9379,-3126
2020,12,20,11,12250,12546,9544,-3002
2020,12,20,12,12770,12832,10084,-2748
2020,12,20,13,13430,13466,10796,-2670
2020,12,20,14,14250,14249,11717,-2532
2020,12,20,15,14890,14908,12404,-2504
2020,12,20,16,15240,15295,12565,-2730
2020,12,20,17,15540,15483,12579,-2904
2020,12,20,18,15510,15544,12903,-2641
2020,12,20,19,15420,15511,12843,-2668
2020,12,20,20,15410,15544,12873,-2671
2020,12,20,21,15910,15804,13195,-2609
2020,12,20,22,16970,16751,14102,-2649
2020,12,20,23,17460,17393,14625,-2768
2020,12,21,0,17070,17069,14215,-2854
2020,12,21,1,16630,16451,13672,-2779
2020,12,21,2,15850,15760,12769,-2991
2020,12,21,3,14820,14830,11895,-2935
2020,12,21,4,13660,13722,10486,-3236
2020,12,21,5,12640,13083,9673,-3410
2020,12,21,6,11950,12799,9462,-3337
2020,12,21,7,11600,12418,8949,-3469
2020,12,21,8,11440,12260,8864,-3396
2020,12,21,9,11460,12261,8644,-3617
2020,12,21,10,11780,12573,9017,-3556
2020,12,21,11,12590,12887,9804,-3083
2020,12,21,12,13900,13872,10873,-2999
2020,12,21,13,15020,15023,11907,-3116
2020,12,21,14,15520,15690,12532,-3158
2020,12,21,15,15930,15960,12817,-3143
2020,12,21,16,16010,16027,12855,-3172
2020,12,21,17,15900,16031,12775,-3256
2020,12,21,18,15730,15872,12776,-3096
2020,12,21,19,15650,15636,12625,-3011
2020,12,21,20,15660,15409,12471,-2938
2020,12,21,21,15910,15553,12687,-2866
2020,12,21,22,16920,16554,13537,-3017
2020,12,21,23,17740,17479,14346,-3133
2020,12,22,0,17450,17255,14051,-3204
2020,12,22,1,16870,16672,13552,-3120
2020,12,22,2,16160,15979,12782,-3197
2020,12,22,3,15160,15041,11693,-3348
2020,12,22,4,13880,13849,10378,-3471
2020,12,22,5,12770,12718,9463,-3255
2020,12,22,6,11920,12364,8886,-3478
2020,12,22,7,11530,12301,8817,-3484
2020,12,22,8,11330,12326,8794,-3532
2020,12,22,9,11350,12087,8490,-3597
2020,12,22,10,11670,12404,8965,-3439
2020,12,22,11,12570,12718,9395,-3323
2020,12,22,12,14010,13818,10611,-3207
2020,12,22,13,15020,14908,11740,-3168
2020,12,22,14,15340,15316,12079,-3237
2020,12,22,15,15070,15075,11813,-3262
2020,12,22,16,14750,14738,11519,-3219
2020,12,22,17,14340,14435,11120,-3315
2020,12,22,18,14130,14262,10963,-3299
2020,12,22,19,14240,14469,11205,-3264
2020,12,22,20,14480,14845,11582,-3263
2020,12,22,21,15030,15231,12118,-3113
2020,12,22,22,16490,16251,13160,-3091
2020,12,22,23,17400,17091,13835,-3256
2020,12,23,0,17040,16911,13639,-3272
2020,12,23,1,16430,16400,13082,-3318
2020,12,23,2,15680,15756,12494,-3262
2020,12,23,3,14750,14898,11451,-3447
2020,12,23,4,13580,13768,10074,-3694
2020,12,23,5,12550,12904,9560,-3344
2020,12,23,6,11960,12498,9407,-3091
2020,12,23,7,11590,12292,9350,-2942
2020,12,23,8,11430,12215,9203,-3012
2020,12,23,9,11470,12231,9328,-2903
2020,12,23,10,11870,12324,9400,-2924
2020,12,23,11,12850,12946,9882,-3064
2020,12,23,12,14440,13954,10950,-3004
2020,12,23,13,15330,14946,11731,-3215
2020,12,23,14,15190,15200,12001,-3199
2020,12,23,15,14710,14748,11582,-3166
2020,12,23,16,14340,14304,11290,-3014
2020,12,23,17,14140,14159,11097,-3062
2020,12,23,18,14110,14136,11029,-3107
2020,12,23,19,14310,14203,11089,-3114
2020,12,23,20,14820,14531,11491,-3040
2020,12,23,21,15460,15045,12001,-3044
2020,12,23,22,16740,16187,13041,-3146
2020,12,23,23,17500,17085,14037,-3048
2020,12,24,0,17240,16935,13871,-3064
2020,12,24,1,16500,16497,13481,-3016
2020,12,24,2,15880,15920,12993,-2927
2020,12,24,3,14960,15103,12196,-2907
2020,12,24,4,13740,13980,10784,-3196
2020,12,24,5,12610,12868,9739,-3129
2020,12,24,6,12040,12061,9142,-2919
2020,12,24,7,11520,11529,8724,-2805
2020,12,24,8,11230,11517,8745,-2772
2020,12,24,9,11150,11456,8651,-2805
2020,12,24,10,11310,11602,8836,-2766
2020,12,24,11,11830,11878,8941,-2937
2020,12,24,12,12670,12662,9665,-2997
2020,12,24,13,13420,13413,10399,-3014
2020,12,24,14,13800,13810,10636,-3174
2020,12,24,15,13800,13680,10401,-3279
2020,12,24,16,13870,13393,10058,-3335
2020,12,24,17,13880,13343,9794,-3549
2020,12,24,18,13890,13450,9896,-3554
2020,12,24,19,13970,13664,10177,-3487
2020,12,24,20,14110,13966,10546,-3420
2020,12,24,21,14300,14280,10872,-3408
2020,12,24,22,15060,15150,11741,-3409
2020,12,24,23,15230,15468,11935,-3533
2020,12,25,0,14390,14828,11411,-3417
2020,12,25,1,13650,14087,10853,-3234
2020,12,25,2,13090,13481,10089,-3392
2020,12,25,3,12570,13101,9727,-3374
2020,12,25,4,11950,12581,9390,-3191
2020,12,25,5,11240,11973,9014,-2959
2020,12,25,6,10440,11257,8566,-2691
2020,12,25,7,9940,10749,8368,-2381
2020,12,25,8,9650,10431,7723,-2708
2020,12,25,9,9520,10313,7657,-2656
2020,12,25,10,9550,10326,7672,-2654
2020,12,25,11,9810,10542,7718,-2824
2020,12,25,12,10300,10656,7648,-3008
2020,12,25,13,11020,11169,8074,-3095
2020,12,25,14,11840,11825,8791,-3034
2020,12,25,15,12510,12490,9339,-3151
2020,12,25,16,12860,12857,9798,-3059
2020,12,25,17,13080,13088,10173,-2915
2020,12,25,18,13270,13277,10642,-2635
2020,12,25,19,13290,13315,10561,-2754
2020,12,25,20,13270,13267,10358,-2909
2020,12,25,21,13330,13333,10276,-3057
2020,12,25,22,13710,13741,10774,-2967
2020,12,25,23,14070,13909,11066,-2843
2020,12,26,0,13980,13581,10597,-2984
2020,12,26,1,13670,13164,10398,-2766
2020,12,26,2,13250,12795,10077,-2718
2020,12,26,3,12720,12353,9809,-2544
2020,12,26,4,12040,11880,9405,-2475
2020,12,26,5,11180,11324,8686,-2638
2020,12,26,6,10640,10829,8162,-2667
2020,12,26,7,10320,10642,8180,-2462
2020,12,26,8,10210,10933,8316,-2617
2020,12,26,9,10180,10845,8205,-2640
2020,12,26,10,10450,10893,8325,-2568
2020,12,26,11,10910,11017,8143,-2874
2020,12,26,12,11470,11474,8454,-3020
2020,12,26,13,12230,12198,9203,-2995
2020,12,26,14,12770,12657,9390,-3267
2020,12,26,15,12730,12733,9332,-3401
2020,12,26,16,12650,12754,9569,-3185
2020,12,26,17,12580,12695,9398,-3297
2020,12,26,18,12530,12677,9395,-3282
2020,12,26,19,12680,12750,9727,-3023
2020,12,26,20,13130,13279,10265,-3014
2020,12,26,21,14150,14129,11010,-3119
2020,12,26,22,15530,15420,12131,-3289
2020,12,26,23,16370,16359,12911,-3448
2020,12,27,0,15920,16233,12720,-3513
2020,12,27,1,15240,15811,12200,-3611
2020,12,27,2,14680,15303,11665,-3638
2020,12,27,3,14160,14570,11078,-3492
2020,12,27,4,13290,13705,10340,-3365
2020,12,27,5,12420,12861,9419,-3442
2020,12,27,6,12190,12316,8921,-3395
2020,12,27,7,11800,12356,9006,-3350
2020,12,27,8,11600,12404,9023,-3381
2020,12,27,9,11530,12327,8986,-3341
2020,12,27,10,11640,12644,9399,-3245
2020,12,27,11,11940,12788,9565,-3223
2020,12,27,12,12450,12773,9559,-3214
2020,12,27,13,12910,12905,9579,-3326
2020,12,27,14,13120,13123,9881,-3242
2020,12,27,15,12910,12922,9555,-3367
2020,12,27,16,12780,12816,9418,-3398
2020,12,27,17,12720,12681,9297,-3384
2020,12,27,18,12790,12463,9091,-3372
2020,12,27,19,12920,12617,9319,-3298
2020,12,27,20,13370,13184,9875,-3309
2020,12,27,21,14110,14048,10735,-3313
2020,12,27,22,15540,15414,12158,-3256
2020,12,27,23,16410,16437,13134,-3303
2020,12,28,0,16310,16292,12938,-3354
2020,12,28,1,15780,15821,12476,-3345
2020,12,28,2,15230,15243,12115,-3128
2020,12,28,3,14410,14453,11116,-3337
2020,12,28,4,13430,13498,10204,-3294
2020,12,28,5,12490,12911,9581,-3330
2020,12,28,6,12010,12524,9305,-3219
2020,12,28,7,11640,12594,9509,-3085
2020,12,28,8,11460,12523,9284,-3239
2020,12,28,9,11490,12521,9252,-3269
2020,12,28,10,11740,12494,9372,-3122
2020,12,28,11,12390,12688,9742,-2946
2020,12,28,12,13410,13666,11098,-2568
2020,12,28,13,14280,14417,11903,-2514
2020,12,28,14,14780,14764,11930,-2834
2020,12,28,15,15050,15020,12168,-2852
2020,12,28,16,15010,15273,12472,-2801
2020,12,28,17,14910,15295,12427,-2868
2020,12,28,18,14840,15118,12204,-2914
2020,12,28,19,14820,14726,11827,-2899
2020,12,28,20,14810,14424,11360,-3064
2020,12,28,21,15070,14656,11493,-3163
2020,12,28,22,16170,15650,12361,-3289
2020,12,28,23,17200,16573,13385,-3188
2020,12,29,0,17100,16318,12787,-3531
2020,12,29,1,16640,15687,12149,-3538
2020,12,29,2,15630,14969,11262,-3707
2020,12,29,3,14680,14089,10354,-3735
2020,12,29,4,13400,13123,9343,-3780
2020,12,29,5,12320,12262,8580,-3682
2020,12,29,6,11300,11825,8106,-3719
2020,12,29,7,10910,11449,7912,-3537
2020,12,29,8,10800,11326,7745,-3581
2020,12,29,9,10840,11369,7931,-3438
2020,12,29,10,11200,11689,8390,-3299
2020,12,29,11,11950,11974,8719,-3255
2020,12,29,12,13080,13047,9793,-3254
2020,12,29,13,14000,13978,10444,-3534
2020,12,29,14,14220,14224,10619,-3605
2020,12,29,15,13840,13905,10262,-3643
2020,12,29,16,13620,13733,10151,-3582
2020,12,29,17,13590,13726,10140,-3586
2020,12,29,18,13670,13739,10089,-3650
2020,12,29,19,13960,13953,10221,-3732
2020,12,29,20,14590,14543,10815,-3728
2020,12,29,21,15540,15344,11754,-3590
2020,12,29,22,17040,16613,13086,-3527
2020,12,29,23,18250,17655,14220,-3435
2020,12,30,0,17970,17487,14064,-3423
2020,12,30,1,17230,16959,13494,-3465
2020,12,30,2,16480,16269,12777,-3492
2020,12,30,3,15440,15415,11821,-3594
2020,12,30,4,14270,14337,10740,-3597
2020,12,30,5,13230,13371,9972,-3399
2020,12,30,6,12730,12744,9302,-3442
2020,12,30,7,12380,12385,8863,-3522
2020,12,30,8,12210,12216,8692,-3524
2020,12,30,9,12240,12238,8809,-3429
2020,12,30,10,12510,12498,9128,-3370
2020,12,30,11,13200,13178,9894,-3284
2020,12,30,12,14260,14232,11399,-2833
2020,12,30,13,15110,15090,12214,-2876
2020,12,30,14,15460,15444,12314,-3130
2020,12,30,15,15550,15513,12322,-3191
2020,12,30,16,15370,15424,12145,-3279
2020,12,30,17,15110,15276,11968,-3308
2020,12,30,18,14960,15257,11994,-3263
2020,12,30,19,14970,15145,11981,-3164
2020,12,30,20,15140,15212,12119,-3093
2020,12,30,21,15680,15569,12512,-3057
2020,12,30,22,16870,16534,13359,-3175
2020,12,30,23,17500,17340,14163,-3177
2020,12,31,0,17170,16986,13792,-3194
2020,12,31,1,16580,16336,13117,-3219
2020,12,31,2,15750,15573,12147,-3426
2020,12,31,3,14670,14623,11147,-3476
2020,12,31,4,13440,13700,10297,-3403
2020,12,31,5,12330,12654,9176,-3478
2020,12,31,6,11600,12141,8573,-3568
2020,12,31,7,11110,11675,8151,-3524
2020,12,31,8,10830,11475,7911,-3564
2020,12,31,9,10740,11530,7839,-3691
2020,12,31,10,10950,11602,7946,-3656
2020,12,31,11,11500,12024,8437,-3587
2020,12,31,12,12390,12704,9445,-3259
2020,12,31,13,13180,13234,9900,-3334
2020,12,31,14,13820,13802,10368,-3434
2020,12,31,15,14180,14181,10718,-3463
2020,12,31,16,14210,14426,11036,-3390
2020,12,31,17,14180,14480,10991,-3489
2020,12,31,18,14200,14430,10827,-3603
2020,12,31,19,14300,14496,10857,-3639
2020,12,31,20,14380,14569,10899,-3670
2020,12,31,21,14640,14841,11274,-3567
2020,12,31,22,15580,15749,12256,-3493
2020,12,31,23,16200,16348,12878,-3470
2021,1,1,0,15630,15907,12464,-3443
2021,1,1,1,14840,14840,12464,-9999
2021,1,1,2,14050,14544,11002,-3542
2021,1,1,3,13490,13928,10436,-3492
2021,1,1,4,12930,13237,9944,-3293
2021,1,1,5,12350,12571,9528,-3043
2021,1,1,6,12030,12030,9528,-9999
2021,1,1,7,11550,12373,9428,-2945
2021,1,1,8,11300,12148,9180,-2968
2021,1,1,9,11230,12271,9244,-3027
2021,1,1,10,11340,12373,9398,-2975
2021,1,1,11,11680,12212,9337,-2875
2021,1,1,12,12190,12363,9722,-2641
2021,1,1,13,12560,12562,9842,-2720
2021,1,1,14,12570,12569,9508,-3061
2021,1,1,15,12260,12561,9395,-3166
2021,1,1,16,12050,12561,9444,-3117
2021,1,1,17,12320,12624,9648,-2976
2021,1,1,18,12750,12767,9887,-2880
2021,1,1,19,13180,13380,10476,-2904
2021,1,1,20,13540,13732,10571,-3161
2021,1,1,21,13910,14336,11206,-3130
2021,1,1,22,14920,15229,12344,-2885
2021,1,1,23,15570,15885,12832,-3053
2021,1,2,0,15460,15596,12456,-3140
2021,1,2,1,14910,15053,11877,-3176
2021,1,2,2,14320,14469,11416,-3053
2021,1,2,3,13730,13780,10490,-3290
2021,1,2,4,13020,12956,9539,-3417
2021,1,2,5,12270,12345,9014,-3331
2021,1,2,6,11510,11704,8661,-3043
2021,1,2,7,11060,11380,8385,-2995
2021,1,2,8,10800,11351,8427,-2924
2021,1,2,9,10670,11202,8174,-3028
2021,1,2,10,10710,11245,8205,-3040
2021,1,2,11,10980,11503,8504,-2999
2021,1,2,12,11470,11986,9227,-2759
2021,1,2,13,12040,12556,9856,-2700
2021,1,2,14,12730,13042,10305,-2737
2021,1,2,15,13270,13500,10540,-2960
2021,1,2,16,13430,13432,10622,-2810
2021,1,2,17,13330,13358,10440,-2918
2021,1,2,18,12720,12728,9734,-2994
2021,1,2,19,12640,12770,10053,-2717
2021,1,2,20,12990,13186,10488,-2698
2021,1,2,21,13560,13691,10892,-2799
2021,1,2,22,14470,14575,11632,-2943
2021,1,2,23,15280,15534,12509,-3025
2021,1,3,0,15030,15392,12279,-3113
2021,1,3,1,14500,14916,11672,-3244
2021,1,3,2,13940,14358,11279,-3079
2021,1,3,3,13460,13735,10484,-3251
2021,1,3,4,12820,12979,9412,-3567
2021,1,3,5,12110,12299,8681,-3618
2021,1,3,6,11570,12076,10217,-1859
2021,1,3,7,11190,11972,10138,-1834
2021,1,3,8,11000,11793,10092,-1701
2021,1,3,9,10960,11746,10009,-1737
2021,1,3,10,11050,11834,9909,-1925
2021,1,3,11,11330,11887,9827,-2060
2021,1,3,12,11810,12078,9876,-2202
2021,1,3,13,12210,12601,10322,-2279
2021,1,3,14,12950,12983,10655,-2328
2021,1,3,15,13640,13606,11200,-2406
2021,1,3,16,14060,14113,11599,-2514
2021,1,3,17,14290,14508,12016,-2492
2021,1,3,18,14470,14765,12318,-2447
2021,1,3,19,14670,14823,12331,-2492
2021,1,3,20,14780,14977,12533,-2444
2021,1,3,21,15060,15204,12369,-2835
2021,1,3,22,15920,16056,13209,-2847
2021,1,3,23,16700,16684,14200,-2484
2021,1,4,0,16390,16379,13538,-2841
2021,1,4,1,15810,15733,13271,-2462
2021,1,4,2,15020,14997,12511,-2486
2021,1,4,3,14150,14075,11745,-2330
2021,1,4,4,13120,13053,10683,-2370
2021,1,4,5,12120,12152,9862,-2290
2021,1,4,6,11460,11790,8475,-3315
2021,1,4,7,11110,11711,8551,-3160
2021,1,4,8,10980,11724,8585,-3139
2021,1,4,9,11040,11852,8758,-3094
2021,1,4,10,11360,12073,8869,-3204
2021,1,4,11,12270,12497,9309,-3188
2021,1,4,12,13760,13547,10562,-2985
2021,1,4,13,14900,14698,11605,-3093
2021,1,4,14,15430,15299,12232,-3067
2021,1,4,15,15580,15417,12288,-3129
2021,1,4,16,15580,15247,12477,-2770
2021,1,4,17,15570,15020,12233,-2787
2021,1,4,18,15000,14644,11998,-2646
2021,1,4,19,14190,14533,11904,-2629
2021,1,4,20,14560,14541,12037,-2504
2021,1,4,21,15220,15022,12488,-2534
2021,1,4,22,16670,15926,13079,-2847
2021,1,4,23,17470,16831,13689,-3142
2021,1,5,0,17210,16633,13591,-3042
2021,1,5,1,16600,16086,12983,-3103
2021,1,5,2,15820,15352,12135,-3217
2021,1,5,3,14840,14429,11147,-3282
2021,1,5,4,13630,13366,9894,-3472
2021,1,5,5,12600,12571,9342,-3229
2021,1,5,6,11760,12024,8827,-3197
2021,1,5,7,11390,11651,8635,-3016
2021,1,5,8,11230,11488,8321,-3167
2021,1,5,9,11230,11513,8458,-3055
2021,1,5,10,11620,11844,8881,-2963
2021,1,5,11,12590,12411,9447,-2964
2021,1,5,12,14210,13669,10860,-2809
2021,1,5,13,15200,14767,12068,-2699
2021,1,5,14,15260,15269,12345,-2924
2021,1,5,15,15130,15231,12330,-2901
2021,1,5,16,14980,15126,12305,-2821
2021,1,5,17,14910,15138,12090,-3048
2021,1,5,18,14900,15149,12208,-2941
2021,1,5,19,15050,15198,11962,-3236
2021,1,5,20,15190,15287,12025,-3262
2021,1,5,21,15510,15552,12291,-3261
2021,1,5,22,16370,16359,13117,-3242
2021,1,5,23,17350,17105,13653,-3452
2021,1,6,0,17060,16835,13404,-3431
2021,1,6,1,16480,16219,12780,-3439
2021,1,6,2,15650,15429,11965,-3464
2021,1,6,3,14700,14462,11077,-3385
2021,1,6,4,13530,13369,9867,-3502
2021,1,6,5,12580,12418,8903,-3515
2021,1,6,6,11790,11870,8267,-3603
2021,1,6,7,11420,11921,8513,-3408
2021,1,6,8,11280,11797,8537,-3260
2021,1,6,9,11230,11792,8539,-3253
2021,1,6,10,11650,12339,9118,-3221
2021,1,6,11,12520,12749,9740,-3009
2021,1,6,12,13950,13868,11154,-2714
2021,1,6,13,14760,14975,12068,-2907
2021,1,6,14,14920,15366,12492,-2874
2021,1,6,15,14580,14953,12349,-2604
2021,1,6,16,14330,14535,11932,-2603
2021,1,6,17,14120,14153,11677,-2476
2021,1,6,18,13970,14092,11450,-2642
2021,1,6,19,14050,14161,11632,-2529
2021,1,6,20,14280,14442,11767,-2675
2021,1,6,21,14840,14968,12410,-2558
2021,1,6,22,15890,16012,13332,-2680
2021,1,6,23,16950,17038,14036,-3002
2021,1,7,0,16840,16806,13900,-2906
2021,1,7,1,16370,16246,13314,-2932
2021,1,7,2,15710,15519,12689,-2830
2021,1,7,3,14850,14632,11625,-3007
2021,1,7,4,13710,13583,10558,-3025
2021,1,7,5,12690,12793,9861,-2932
2021,1,7,6,12040,12243,9336,-2907
2021,1,7,7,11670,12125,9226,-2899
2021,1,7,8,11510,11979,9037,-2942
2021,1,7,9,11520,12008,9022,-2986
2021,1,7,10,11810,12329,9305,-3024
2021,1,7,11,12690,12655,9908,-2747
2021,1,7,12,14160,13916,11302,-2614
2021,1,7,13,14910,15000,12414,-2586
2021,1,7,14,14860,15114,12409,-2705
2021,1,7,15,14360,14522,12117,-2405
2021,1,7,16,13920,14045,11830,-2215
2021,1,7,17,13670,13910,11810,-2100
2021,1,7,18,13560,13970,11694,-2276
2021,1,7,19,13690,13975,11481,-2494
2021,1,7,20,13950,14597,11905,-2692
2021,1,7,21,14580,15094,12349,-2745
2021,1,7,22,15700,15853,13139,-2714
2021,1,7,23,16650,16889,14102,-2787
2021,1,8,0,16550,16763,13835,-2928
2021,1,8,1,16080,16259,13601,-2658
2021,1,8,2,15570,15591,12778,-2813
2021,1,8,3,14750,14736,11814,-2922
2021,1,8,4,13720,13854,10795,-3059
2021,1,8,5,12790,13273,10358,-2915
2021,1,8,6,12180,12982,10411,-2571
2021,1,8,7,11850,12670,10172,-2498
2021,1,8,8,11700,12516,10098,-2418
2021,1,8,9,11760,12565,10086,-2479
2021,1,8,10,12110,12678,10288,-2390
2021,1,8,11,12920,13443,10976,-2467
2021,1,8,12,14250,14391,11985,-2406
2021,1,8,13,15290,15283,12974,-2309
2021,1,8,14,15350,15365,13079,-2286
2021,1,8,15,14700,14640,12795,-1845
2021,1,8,16,14240,13919,12351,-1568
2021,1,8,17,13790,13485,11965,-1520
2021,1,8,18,13590,13537,11946,-1591
2021,1,8,19,13640,13719,12109,-1610
2021,1,8,20,13920,14136,12445,-1691
2021,1,8,21,14490,14738,12751,-1987
2021,1,8,22,15560,15745,13747,-1998
2021,1,8,23,16500,16647,14332,-2315
2021,1,9,0,16230,16464,14167,-2297
2021,1,9,1,15810,15974,13640,-2334
2021,1,9,2,15320,15401,13166,-2235
2021,1,9,3,14600,14677,12343,-2334
2021,1,9,4,13750,13821,11566,-2255
2021,1,9,5,12890,13208,10801,-2407
2021,1,9,6,12250,12584,10285,-2299
2021,1,9,7,11880,12197,9802,-2395
2021,1,9,8,11670,12008,9377,-2631
2021,1,9,9,11640,11829,9342,-2487
2021,1,9,10,11710,11845,9515,-2330
2021,1,9,11,12120,12248,9955,-2293
2021,1,9,12,12800,12905,10953,-1952
2021,1,9,13,13650,13547,11527,-2020
2021,1,9,14,13880,13863,11630,-2233
2021,1,9,15,13700,13675,11573,-2102
2021,1,9,16,13410,13429,11343,-2086
2021,1,9,17,13190,13165,11148,-2017
2021,1,9,18,13150,13110,11055,-2055
2021,1,9,19,13170,13326,10877,-2449
2021,1,9,20,13540,13768,11224,-2544
2021,1,9,21,14210,14405,12060,-2345
2021,1,9,22,15100,15378,13073,-2305
2021,1,9,23,16250,16217,13531,-2686
2021,1,10,0,16040,16000,13391,-2609
2021,1,10,1,15480,15471,12909,-2562
2021,1,10,2,14880,14866,12290,-2576
2021,1,10,3,14220,14378,11654,-2724
2021,1,10,4,13450,13587,10984,-2603
2021,1,10,5,12710,12769,10208,-2561
2021,1,10,6,11990,11907,9436,-2471
2021,1,10,7,11620,11699,9020,-2679
2021,1,10,8,11400,11616,8991,-2625
2021,1,10,9,11340,11562,8736,-2826
2021,1,10,10,11430,11674,8963,-2711
2021,1,10,11,11730,11974,9163,-2811
2021,1,10,12,12240,12226,9622,-2604
2021,1,10,13,12760,12767,9902,-2865
2021,1,10,14,13090,13004,10063,-2941
2021,1,10,15,12790,12757,9904,-2853
2021,1,10,16,12690,12336,9623,-2713
2021,1,10,17,12670,12131,9465,-2666
2021,1,10,18,12700,12179,9644,-2535
2021,1,10,19,12810,12321,9693,-2628
2021,1,10,20,13150,12754,10066,-2688
2021,1,10,21,13870,13622,10872,-2750
2021,1,10,22,15210,14958,12412,-2546
2021,1,10,23,16250,16179,13522,-2657
2021,1,11,0,16060,16090,13313,-2777
2021,1,11,1,15560,15591,12793,-2798
2021,1,11,2,14940,15010,12194,-2816
2021,1,11,3,14140,14244,11593,-2651
2021,1,11,4,13270,13355,10587,-2768
2021,1,11,5,12470,12578,9712,-2866
2021,1,11,6,12010,12209,9612,-2597
2021,1,11,7,11760,12283,9615,-2668
2021,1,11,8,11720,12262,9692,-2570
2021,1,11,9,11840,12381,9889,-2492
2021,1,11,10,12260,12483,10086,-2397
2021,1,11,11,13220,13189,10823,-2366
2021,1,11,12,14670,14656,12290,-2366
2021,1,11,13,15780,15778,13330,-2448
2021,1,11,14,16150,16161,13490,-2671
2021,1,11,15,16140,16141,13646,-2495
2021,1,11,16,16060,16052,13344,-2708
2021,1,11,17,16080,16099,13470,-2629
2021,1,11,18,15990,16013,13316,-2697
2021,1,11,19,15920,15987,13323,-2664
2021,1,11,20,15880,15930,13266,-2664
2021,1,11,21,16320,16031,13160,-2871
2021,1,11,22,17140,16664,13902,-2762
2021,1,11,23,17840,17412,14564,-2848
2021,1,12,0,17460,17092,14296,-2796
2021,1,12,1,16890,16493,13589,-2904
2021,1,12,2,16070,15693,12757,-2936
2021,1,12,3,15120,14745,11804,-2941
2021,1,12,4,13910,13698,10755,-2943
2021,1,12,5,12860,12882,10032,-2850
2021,1,12,6,12150,12689,9822,-2867
2021,1,12,7,11850,12718,9823,-2895
2021,1,12,8,11730,12812,9916,-2896
2021,1,12,9,11800,12866,9995,-2871
2021,1,12,10,12130,12924,10051,-2873
2021,1,12,11,13060,13347,10591,-2756
2021,1,12,12,14630,14383,11716,-2667
2021,1,12,13,15470,15434,12612,-2822
2021,1,12,14,15380,15632,12822,-2810
2021,1,12,15,15280,15247,12475,-2772
2021,1,12,16,14780,14667,12053,-2614
2021,1,12,17,14440,14142,11671,-2471
2021,1,12,18,14130,14255,11656,-2599
2021,1,12,19,14140,14569,11838,-2731
2021,1,12,20,14330,14800,11871,-2929
2021,1,12,21,14820,15124,12012,-3112
2021,1,12,22,15930,15924,12768,-3156
2021,1,12,23,17060,16925,13706,-3219
2021,1,13,0,16930,16703,13482,-3221
2021,1,13,1,16430,16060,12766,-3294
2021,1,13,2,15730,15311,12118,-3193
2021,1,13,3,14790,14387,11475,-2912
2021,1,13,4,13670,13455,10552,-2903
2021,1,13,5,12690,12581,9610,-2971
2021,1,13,6,11780,11951,8975,-2976
2021,1,13,7,11430,11777,8847,-2930
2021,1,13,8,11280,11676,8756,-2920
2021,1,13,9,11340,11704,8845,-2859
2021,1,13,10,11640,11929,9100,-2829
2021,1,13,11,12590,12488,9687,-2801
2021,1,13,12,14070,13850,10981,-2869
2021,1,13,13,15040,14947,12190,-2757
2021,1,13,14,15180,15077,12973,-2104
2021,1,13,15,14580,14531,12832,-1699
2021,1,13,16,14090,13953,12285,-1668
2021,1,13,17,13850,13831,12136,-1695
2021,1,13,18,13760,14008,12021,-1987
2021,1,13,19,14000,14338,12051,-2287
2021,1,13,20,14250,14901,12172,-2729
2021,1,13,21,14860,15166,12366,-2800
2021,1,13,22,15810,15862,12966,-2896
2021,1,13,23,16920,16700,13832,-2868
2021,1,14,0,16700,16426,13547,-2879
2021,1,14,1,16170,15814,12937,-2877
2021,1,14,2,15450,15042,12082,-2960
2021,1,14,3,14560,14119,11196,-2923
2021,1,14,4,13470,13042,9989,-3053
2021,1,14,5,12510,12402,9358,-3044
2021,1,14,6,11500,12177,9115,-3062
2021,1,14,7,11190,12045,8997,-3048
2021,1,14,8,11030,12089,9103,-2986
2021,1,14,9,11060,12091,9116,-2975
2021,1,14,10,11360,12153,9164,-2989
2021,1,14,11,12190,12704,9809,-2895
2021,1,14,12,13440,13784,10925,-2859
2021,1,14,13,14610,14678,11740,-2938
2021,1,14,14,15080,15145,12149,-2996
2021,1,14,15,15110,15129,12289,-2840
2021,1,14,16,15030,14998,11914,-3084
2021,1,14,17,14930,14952,11879,-3073
2021,1,14,18,14820,14814,11708,-3106
2021,1,14,19,14890,14950,11737,-3213
2021,1,14,20,14930,14980,11943,-3037
2021,1,14,21,15240,15240,11943,-9999
2021,1,14,22,15990,15701,12412,-3289
2021,1,14,23,16740,16533,13216,-3317
2021,1,15,0,16510,16306,12948,-3358
2021,1,15,1,15870,15649,12188,-3461
2021,1,15,2,15140,14923,11688,-3235
2021,1,15,3,14330,13991,11003,-2988
2021,1,15,4,13180,12914,9952,-2962
2021,1,15,5,12180,11966,9053,-2913
2021,1,15,6,11330,11629,8677,-2952
2021,1,15,7,10960,11507,8519,-2988
2021,1,15,8,10800,11448,8382,-3066
2021,1,15,9,10830,11611,8499,-3112
2021,1,15,10,11140,11496,8398,-3098
2021,1,15,11,11980,11964,8929,-3035
2021,1,15,12,13370,13244,10435,-2809
2021,1,15,13,14580,14380,11435,-2945
2021,1,15,14,14730,14697,11653,-3044
2021,1,15,15,14530,14402,11371,-3031
2021,1,15,16,14370,14098,11183,-2915
2021,1,15,17,14340,14174,11310,-2864
2021,1,15,18,14200,14322,11508,-2814
2021,1,15,19,14320,14310,11479,-2831
2021,1,15,20,14450,14411,11585,-2826
2021,1,15,21,14820,14592,11892,-2700
2021,1,15,22,15620,15299,12382,-2917
2021,1,15,23,16400,15982,12892,-3090
2021,1,16,0,15870,15740,12894,-2846
2021,1,16,1,15270,15167,12126,-3041
2021,1,16,2,14570,14551,11536,-3015
2021,1,16,3,13800,13787,10991,-2796
2021,1,16,4,12840,12860,9734,-3126
2021,1,16,5,11970,12325,9180,-3145
2021,1,16,6,11300,11335,8660,-2675
2021,1,16,7,10890,11084,8317,-2767
2021,1,16,8,10680,10892,8285,-2607
2021,1,16,9,10620,10818,8267,-2551
2021,1,16,10,10740,11140,8543,-2597
2021,1,16,11,11100,11281,8605,-2676
2021,1,16,12,11760,11580,8818,-2762
2021,1,16,13,12440,12304,9489,-2815
2021,1,16,14,13190,13157,10193,-2964
2021,1,16,15,13710,13847,10595,-3252
2021,1,16,16,14420,14262,10962,-3300
2021,1,16,17,14450,14282,10991,-3291
2021,1,16,18,14420,13962,10678,-3284
2021,1,16,19,13740,13585,10273,-3312
2021,1,16,20,13690,13380,10033,-3347
2021,1,16,21,13950,13669,10325,-3344
2021,1,16,22,14350,14374,11028,-3346
2021,1,16,23,15250,15075,11900,-3175
2021,1,17,0,14780,14962,11739,-3223
2021,1,17,1,14210,14337,11389,-2948
2021,1,17,2,13670,13742,10798,-2944
2021,1,17,3,13050,13075,10187,-2888
2021,1,17,4,12320,12354,9745,-2609
2021,1,17,5,11610,11604,8905,-2699
2021,1,17,6,11020,11036,8262,-2774
2021,1,17,7,10630,10677,7873,-2804
2021,1,17,8,10430,10514,7776,-2738
2021,1,17,9,10360,10434,7771,-2663
2021,1,17,10,10480,10539,8008,-2531
2021,1,17,11,10680,10834,8209,-2625
2021,1,17,12,11160,11300,8842,-2458
2021,1,17,13,11590,11851,9194,-2657
2021,1,17,14,11990,12172,9732,-2440
2021,1,17,15,12080,12138,9749,-2389
2021,1,17,16,12050,12275,9679,-2596
2021,1,17,17,12170,12264,9806,-2458
2021,1,17,18,12440,12613,10091,-2522
2021,1,17,19,12620,12928,10149,-2779
2021,1,17,20,12910,13148,10358,-2790
2021,1,17,21,13580,13627,10843,-2784
2021,1,17,22,14600,14519,11987,-2532
2021,1,17,23,15800,15444,12842,-2602
2021,1,18,0,15350,15272,12520,-2752
2021,1,18,1,14790,14659,11944,-2715
2021,1,18,2,14150,14030,11190,-2840
2021,1,18,3,13300,13185,10310,-2875
2021,1,18,4,12350,12325,9496,-2829
2021,1,18,5,11540,11500,8649,-2851
2021,1,18,6,10910,11193,8454,-2739
2021,1,18,7,10540,10834,8212,-2622
2021,1,18,8,10380,10759,8202,-2557
2021,1,18,9,10420,10870,8370,-2500
2021,1,18,10,10720,10980,8511,-2469
2021,1,18,11,11450,11429,8948,-2481
2021,1,18,12,12540,12511,9770,-2741
2021,1,18,13,13400,13377,10701,-2676
2021,1,18,14,13520,13528,10936,-2592
2021,1,18,15,13120,13152,10442,-2710
2021,1,18,16,13050,12927,10096,-2831
2021,1,18,17,13100,13156,10410,-2746
2021,1,18,18,13260,13477,10685,-2792
2021,1,18,19,13650,13651,10824,-2827
2021,1,18,20,13940,13855,11164,-2691
2021,1,18,21,14490,14295,11667,-2628
2021,1,18,22,15530,15257,12483,-2774
2021,1,18,23,16430,16389,13625,-2764
2021,1,19,0,16190,16193,13362,-2831
2021,1,19,1,15700,15585,12724,-2861
2021,1,19,2,14950,14910,12060,-2850
2021,1,19,3,14090,14048,11071,-2977
2021,1,19,4,13070,13081,9978,-3103
2021,1,19,5,12190,12227,9171,-3056
2021,1,19,6,11660,11960,8881,-3079
2021,1,19,7,11410,11928,8704,-3224
2021,1,19,8,11320,11875,8646,-3229
2021,1,19,9,11400,11920,8771,-3149
2021,1,19,10,11790,12055,8989,-3066
2021,1,19,11,12700,12796,9892,-2904
2021,1,19,12,14160,14128,11390,-2738
2021,1,19,13,15210,15207,12468,-2739
2021,1,19,14,15210,15232,12561,-2671
2021,1,19,15,14560,14552,12007,-2545
2021,1,19,16,14040,14040,12007,-9999
2021,1,19,17,13910,13910,10410,-9999
2021,1,19,18,13820,14028,11212,-2816
2021,1,19,19,14040,14159,11399,-2760
2021,1,19,20,14420,14538,11794,-2744
2021,1,19,21,14650,15020,12393,-2627
2021,1,19,22,15580,15580,12393,-9999
2021,1,19,23,16630,16774,14234,-2540
2021,1,20,0,16510,16589,14060,-2529
2021,1,20,1,16000,15980,13240,-2740
2021,1,20,2,15260,15235,12560,-2675
2021,1,20,3,14320,14313,11579,-2734
2021,1,20,4,13240,13289,10520,-2769
2021,1,20,5,12300,12413,9589,-2824
2021,1,20,6,11830,11825,9130,-2695
2021,1,20,7,11500,11500,8872,-2628
2021,1,20,8,11350,11345,8720,-2625
2021,1,20,9,11370,11357,8798,-2559
2021,1,20,10,11700,11674,9221,-2453
2021,1,20,11,12520,12482,10113,-2369
2021,1,20,12,13860,13817,11508,-2309
2021,1,20,13,14990,14970,12720,-2250
2021,1,20,14,15420,15410,12966,-2444
2021,1,20,15,15480,15429,13128,-2301
2021,1,20,16,15150,14950,12747,-2203
2021,1,20,17,14910,14512,12348,-2164
2021,1,20,18,14780,14194,11849,-2345
2021,1,20,19,14750,14361,11983,-2378
2021,1,20,20,14860,14697,12449,-2248
2021,1,20,21,15340,15109,12850,-2259
2021,1,20,22,16340,15960,13684,-2276
2021,1,20,23,17600,17007,14504,-2503
2021,1,21,0,17270,16990,14451,-2539
2021,1,21,1,16610,16479,13938,-2541
2021,1,21,2,15870,15818,13298,-2520
2021,1,21,3,15220,14939,12457,-2482
2021,1,21,4,14100,13931,11362,-2569
2021,1,21,5,13130,13300,10723,-2577
2021,1,21,6,12480,13027,10562,-2465
2021,1,21,7,12190,12747,10341,-2406
2021,1,21,8,12100,12647,10495,-2152
2021,1,21,9,12150,12406,10376,-2030
2021,1,21,10,12510,12741,10557,-2184
2021,1,21,11,13420,13387,11287,-2100
2021,1,21,12,14850,14813,12652,-2161
2021,1,21,13,15890,15890,12652,-9999
2021,1,21,14,16120,16116,13936,-2180
2021,1,21,15,16050,16062,13951,-2111
2021,1,21,16,16110,16109,13937,-2172
2021,1,21,17,16140,16143,13977,-2166
2021,1,21,18,16060,16058,13900,-2158
2021,1,21,19,16220,16235,13991,-2244
2021,1,21,20,15780,16048,13790,-2258
2021,1,21,21,16120,15986,13723,-2263
2021,1,21,22,16900,16482,14262,-2220
2021,1,21,23,17750,17259,14998,-2261
2021,1,22,0,17600,17076,14850,-2226
2021,1,22,1,16970,16549,14342,-2207
2021,1,22,2,16160,15813,13635,-2178
2021,1,22,3,15170,14814,12686,-2128
2021,1,22,4,13980,13722,11529,-2193
2021,1,22,5,13150,13175,10948,-2227
2021,1,22,6,12040,12846,10740,-2106
2021,1,22,7,11670,12476,10629,-1847
2021,1,22,8,11500,12281,10419,-1862
2021,1,22,9,11500,12547,10640,-1907
2021,1,22,10,11820,12739,10726,-2013
2021,1,22,11,12660,13020,11099,-1921
2021,1,22,12,14040,14091,12058,-2033
2021,1,22,13,15060,14975,12812,-2163
2021,1,22,14,15290,15321,13133,-2188
2021,1,22,15,14940,14943,12847,-2096
2021,1,22,16,14240,14687,12586,-2101
2021,1,22,17,13960,14640,12435,-2205
2021,1,22,18,13830,14643,12531,-2112
2021,1,22,19,13960,14651,12663,-1988
2021,1,22,20,14060,14856,12855,-2001
2021,1,22,21,14500,14974,12956,-2018
2021,1,22,22,15320,15487,13410,-2077
2021,1,22,23,16380,16103,13971,-2132
2021,1,23,0,16050,15931,13822,-2109
2021,1,23,1,15510,15464,13327,-2137
2021,1,23,2,14900,15075,12847,-2228
2021,1,23,3,14220,14358,12161,-2197
2021,1,23,4,13360,13640,11328,-2312
2021,1,23,5,12550,12864,10680,-2184
2021,1,23,6,11750,12510,10244,-2266
2021,1,23,7,11390,11920,9707,-2213
2021,1,23,8,11240,11751,9514,-2237
2021,1,23,9,11230,11742,9456,-2286
2021,1,23,10,11410,11892,9830,-2062
2021,1,23,11,11850,12098,9941,-2157
2021,1,23,12,12550,12824,10816,-2008
2021,1,23,13,13330,13277,11108,-2169
2021,1,23,14,13770,13624,11395,-2229
2021,1,23,15,13490,13428,11237,-2191
2021,1,23,16,13110,13126,10880,-2246
2021,1,23,17,13040,12937,10697,-2240
2021,1,23,18,13080,12787,10441,-2346
2021,1,23,19,13050,12832,10498,-2334
2021,1,23,20,13340,13258,10881,-2377
2021,1,23,21,14310,14218,11550,-2668
2021,1,23,22,15730,15536,12966,-2570
2021,1,23,23,16750,16786,14059,-2727
2021,1,24,0,16670,16795,14079,-2716
2021,1,24,1,16310,16368,13696,-2672
2021,1,24,2,15700,15841,13183,-2658
2021,1,24,3,15060,15199,12566,-2633
2021,1,24,4,14280,14396,11707,-2689
2021,1,24,5,13640,13689,10962,-2727
2021,1,24,6,13130,13150,10643,-2507
2021,1,24,7,12800,13053,10496,-2557
2021,1,24,8,12630,12887,10350,-2537
2021,1,24,9,12600,12843,10306,-2537
2021,1,24,10,12720,12961,10433,-2528
2021,1,24,11,13010,13243,10763,-2480
2021,1,24,12,13480,13517,10925,-2592
2021,1,24,13,14050,14021,11434,-2587
2021,1,24,14,14370,14107,11789,-2318
2021,1,24,15,14250,13726,11348,-2378
2021,1,24,16,13860,13385,11012,-2373
2021,1,24,17,13500,13459,11137,-2322
2021,1,24,18,13340,13441,11109,-2332
2021,1,24,19,13460,13477,11165,-2312
2021,1,24,20,13790,13710,11326,-2384
2021,1,24,21,14550,14730,12383,-2347
2021,1,24,22,15700,15961,13573,-2388
2021,1,24,23,17000,17103,14708,-2395
2021,1,25,0,16820,17068,14571,-2497
2021,1,25,1,16360,16664,13925,-2739
2021,1,25,2,15760,15979,13267,-2712
2021,1,25,3,14930,15123,12473,-2650
2021,1,25,4,14100,14119,11342,-2777
2021,1,25,5,13320,13320,10488,-2832
2021,1,25,6,12770,13222,10394,-2828
2021,1,25,7,12490,13263,10335,-2928
2021,1,25,8,12410,13208,10360,-2848
2021,1,25,9,12490,13280,10501,-2779
2021,1,25,10,12900,13415,10691,-2724
2021,1,25,11,13810,14072,11462,-2610
2021,1,25,12,15260,15197,12540,-2657
2021,1,25,13,16280,16281,13474,-2807
2021,1,25,14,16110,16140,13570,-2570
2021,1,25,15,15180,15219,12955,-2264
2021,1,25,16,14640,14482,12208,-2274
2021,1,25,17,14220,14378,12046,-2332
2021,1,25,18,14070,14344,11833,-2511
2021,1,25,19,14110,14282,11881,-2401
2021,1,25,20,14370,14728,12286,-2442
2021,1,25,21,15150,15064,12618,-2446
2021,1,25,22,16200,16241,13629,-2612
2021,1,25,23,17450,17478,14816,-2662
2021,1,26,0,17390,17367,14696,-2671
2021,1,26,1,16900,16817,14141,-2676
2021,1,26,2,16150,16044,13429,-2615
2021,1,26,3,15170,15097,12427,-2670
2021,1,26,4,14010,13994,11399,-2595
2021,1,26,5,13090,13254,10529,-2725
2021,1,26,6,12440,12999,10633,-2366
2021,1,26,7,12120,13019,10382,-2637
2021,1,26,8,12040,13081,10396,-2685
2021,1,26,9,12110,12891,10484,-2407
2021,1,26,10,12450,13021,10690,-2331
2021,1,26,11,13340,13474,10994,-2480
2021,1,26,12,14770,14728,12165,-2563
2021,1,26,13,15770,15761,13153,-2608
2021,1,26,14,15780,15796,13319,-2477
2021,1,26,15,15090,15112,12647,-2465
2021,1,26,16,14830,14841,12351,-2490
2021,1,26,17,14950,14941,12445,-2496
2021,1,26,18,15450,15440,13126,-2314
2021,1,26,19,15850,15835,13340,-2495
2021,1,26,20,16000,16051,13564,-2487
2021,1,26,21,16290,16265,13689,-2576
2021,1,26,22,16790,16796,14116,-2680
2021,1,26,23,17490,17595,14905,-2690
2021,1,27,0,17280,17391,14771,-2620
2021,1,27,1,16590,16753,14121,-2632
2021,1,27,2,15640,15940,13301,-2639
2021,1,27,3,14660,14950,12240,-2710
2021,1,27,4,13530,13801,10985,-2816
2021,1,27,5,12610,13104,10274,-2830
2021,1,27,6,12260,12797,10022,-2775
2021,1,27,7,11890,12450,9785,-2665
2021,1,27,8,11740,12453,9786,-2667
2021,1,27,9,11770,12560,9963,-2597
2021,1,27,10,12110,12689,10176,-2513
2021,1,27,11,12920,13199,10845,-2354
2021,1,27,12,14170,14138,11722,-2416
2021,1,27,13,15220,15204,12705,-2499
2021,1,27,14,15840,15819,13389,-2430
2021,1,27,15,16070,16058,13818,-2240
2021,1,27,16,16020,16141,13888,-2253
2021,1,27,17,15920,16064,13841,-2223
2021,1,27,18,15750,15931,13580,-2351
2021,1,27,19,15610,15829,13436,-2393
2021,1,27,20,15560,15719,13412,-2307
2021,1,27,21,15610,15769,13476,-2293
2021,1,27,22,16260,16231,13902,-2329
2021,1,27,23,16950,17151,14713,-2438
2021,1,28,0,16700,16976,14531,-2445
2021,1,28,1,16100,16346,13958,-2388
2021,1,28,2,15330,15693,13183,-2510
2021,1,28,3,14560,14893,12309,-2584
2021,1,28,4,13430,13807,11238,-2569
2021,1,28,5,12540,13141,10579,-2562
2021,1,28,6,12020,12579,10009,-2570
2021,1,28,7,11680,12469,9940,-2529
2021,1,28,8,11520,12576,10029,-2547
2021,1,28,9,11560,12602,10022,-2580
2021,1,28,10,11900,11900,10022,-9999
2021,1,28,11,12760,13152,10615,-2537
2021,1,28,12,14190,14222,11757,-2465
2021,1,28,13,15350,15340,12913,-2427
2021,1,28,14,15980,15969,13480,-2489
2021,1,28,15,16230,16210,13727,-2483
2021,1,28,16,16100,16277,13790,-2487
2021,1,28,17,15930,16215,13730,-2485
2021,1,28,18,15770,16003,13466,-2537
2021,1,28,19,15780,15787,13268,-2519
2021,1,28,20,15680,15679,13181,-2498
2021,1,28,21,15850,15815,13241,-2574
2021,1,28,22,16510,16469,13899,-2570
2021,1,28,23,17500,17624,15115,-2509
2021,1,29,0,17470,17704,15197,-2507
2021,1,29,1,16910,17289,14839,-2450
2021,1,29,2,16320,16665,14157,-2508
2021,1,29,3,15540,15847,13364,-2483
2021,1,29,4,14500,15114,12582,-2532
2021,1,29,5,13830,14555,12056,-2499
2021,1,29,6,13560,14333,12012,-2321
2021,1,29,7,13310,14328,11910,-2418
2021,1,29,8,13210,14162,11777,-2385
2021,1,29,9,13300,14310,11671,-2639
2021,1,29,10,13720,14241,11747,-2494
2021,1,29,11,14680,14962,12751,-2211
2021,1,29,12,16180,16138,14076,-2062
2021,1,29,13,17310,17302,15162,-2140
2021,1,29,14,17730,17736,15789,-1947
2021,1,29,15,17630,17627,15952,-1675
2021,1,29,16,17370,17407,15578,-1829
2021,1,29,17,17100,17188,15345,-1843
2021,1,29,18,16710,17014,15195,-1819
2021,1,29,19,16680,16969,15214,-1755
2021,1,29,20,16690,16984,15494,-1490
2021,1,29,21,16940,17178,15791,-1387
2021,1,29,22,17740,17740,16186,-1554
2021,1,29,23,18650,18654,16910,-1744
2021,1,30,0,18390,18628,16987,-1641
2021,1,30,1,17880,18187,16624,-1563
2021,1,30,2,17230,17525,16092,-1433
2021,1,30,3,16460,16758,15278,-1480
2021,1,30,4,15520,15811,14494,-1317
2021,1,30,5,14680,14954,13606,-1348
2021,1,30,6,14350,14457,13125,-1332
2021,1,30,7,14020,14555,13085,-1470
2021,1,30,8,13840,14635,13040,-1595
2021,1,30,9,13810,14532,12811,-1721
2021,1,30,10,13960,14501,12874,-1627
2021,1,30,11,14350,14635,13228,-1407
2021,1,30,12,15010,15278,13879,-1399
2021,1,30,13,15660,15700,14095,-1605
2021,1,30,14,16020,16020,14396,-1624
2021,1,30,15,15990,15994,14291,-1703
2021,1,30,16,15790,15793,14269,-1524
2021,1,30,17,15530,15538,14118,-1420
2021,1,30,18,15220,15362,13927,-1435
2021,1,30,19,14970,15220,13890,-1330
2021,1,30,20,15230,15369,13959,-1410
2021,1,30,21,15740,15657,13827,-1830
2021,1,30,22,16750,16439,14488,-1951
2021,1,30,23,17830,17647,15751,-1896
2021,1,31,0,17780,17738,15786,-1952
2021,1,31,1,17240,17249,15271,-1978
2021,1,31,2,16690,16718,14904,-1814
2021,1,31,3,15970,16062,14291,-1771
2021,1,31,4,15160,15261,13802,-1459
2021,1,31,5,14400,14547,12970,-1577
2021,1,31,6,14000,14227,12697,-1530
2021,1,31,7,13680,14182,12592,-1590
2021,1,31,8,13560,14077,12356,-1721
2021,1,31,9,13550,14058,12189,-1869
2021,1,31,10,13690,14204,12218,-1986
2021,1,31,11,14020,14272,12463,-1809
2021,1,31,12,14580,14568,12456,-2112
2021,1,31,13,15130,15130,13237,-1893
2021,1,31,14,15510,15515,13728,-1787
2021,1,31,15,15710,15692,14097,-1595
2021,1,31,16,15570,15745,14301,-1444
2021,1,31,17,15570,15766,14150,-1616
2021,1,31,18,15530,15564,14112,-1452
2021,1,31,19,15530,15455,14257,-1198
2021,1,31,20,15570,15395,14166,-1229
2021,1,31,21,15860,15725,14330,-1395
2021,1,31,22,16530,16617,14941,-1676
2021,1,31,23,17750,17807,15583,-2224
2021,2,1,0,17680,17768,15380,-2388
2021,2,1,1,16970,17204,14558,-2646
2021,2,1,2,16230,16500,14054,-2446
2021,2,1,3,15370,15648,13245,-2403
2021,2,1,4,14340,14667,12104,-2563
2021,2,1,5,13490,13816,11315,-2501
2021,2,1,6,13240,13257,10847,-2410
2021,2,1,7,12920,12943,10912,-2031
2021,2,1,8,12790,12930,10884,-2046
2021,2,1,9,12850,13140,11126,-2014
2021,2,1,10,13180,13456,11231,-2225
2021,2,1,11,13960,14030,11560,-2470
2021,2,1,12,15210,15179,12561,-2618
2021,2,1,13,16290,16268,13882,-2386
2021,2,1,14,16890,16890,14267,-2623
2021,2,1,15,17010,17139,14586,-2553
2021,2,1,16,17110,17305,14634,-2671
2021,2,1,17,17160,17403,14771,-2632
2021,2,1,18,17170,17412,14828,-2584
2021,2,1,19,17170,17332,14938,-2394
2021,2,1,20,17240,17138,14740,-2398
2021,2,1,21,17420,17032,14584,-2448
2021,2,1,22,17800,17352,14724,-2628
2021,2,1,23,18500,18016,15297,-2719
2021,2,2,0,18230,17725,14997,-2728
2021,2,2,1,17380,17034,14426,-2608
2021,2,2,2,16380,16165,13556,-2609
2021,2,2,3,15300,15184,12450,-2734
2021,2,2,4,14120,14152,11271,-2881
2021,2,2,5,13190,13440,10476,-2964
2021,2,2,6,12530,12826,9908,-2918
2021,2,2,7,12140,12463,9772,-2691
2021,2,2,8,11960,12563,9783,-2780
2021,2,2,9,12010,12559,9667,-2892
2021,2,2,10,12290,12781,10034,-2747
2021,2,2,11,13060,13039,10488,-2551
2021,2,2,12,14280,13852,11215,-2637
2021,2,2,13,15350,14787,12035,-2752
2021,2,2,14,16090,15555,12660,-2895
2021,2,2,15,16330,15950,13028,-2922
2021,2,2,16,16510,16188,13359,-2829
2021,2,2,17,16610,16369,13819,-2550
2021,2,2,18,16600,16429,13864,-2565
2021,2,2,19,16480,16280,13742,-2538
2021,2,2,20,16410,16131,13418,-2713
2021,2,2,21,16550,16329,13680,-2649
2021,2,2,22,17070,16714,13896,-2818
2021,2,2,23,18000,17451,14601,-2850
2021,2,3,0,17480,17278,14375,-2903
2021,2,3,1,16680,16600,13628,-2972
2021,2,3,2,15780,15777,12785,-2992
2021,2,3,3,14800,14803,11927,-2876
2021,2,3,4,13720,13774,10531,-3243
2021,2,3,5,12820,13102,9806,-3296
2021,2,3,6,12130,12511,9302,-3209
2021,2,3,7,11780,12121,9046,-3075
2021,2,3,8,11630,12256,9114,-3142
2021,2,3,9,11700,12290,9152,-3138
2021,2,3,10,12070,12230,9091,-3139
2021,2,3,11,12920,12914,9679,-3235
2021,2,3,12,14250,14274,11190,-3084
2021,2,3,13,15250,15315,12403,-2912
2021,2,3,14,15780,15820,12824,-2996
2021,2,3,15,16030,15744,12658,-3086
2021,2,3,16,16140,15579,12284,-3295
2021,2,3,17,16160,15570,12320,-3250
2021,2,3,18,16060,15600,12360,-3240
2021,2,3,19,15880,15589,12391,-3198
2021,2,3,20,15790,15599,12382,-3217
2021,2,3,21,15850,15724,12535,-3189
2021,2,3,22,16310,16184,13136,-3048
2021,2,3,23,17250,17146,14108,-3038
2021,2,4,0,17070,17089,14153,-2936
2021,2,4,1,16410,16453,13497,-2956
2021,2,4,2,15630,15630,13497,-9999
2021,2,4,3,14620,14775,11796,-2979
2021,2,4,4,13540,13765,10691,-3074
2021,2,4,5,12620,12906,9829,-3077
2021,2,4,6,12050,-9999,-9999,-9999
2021,2,4,7,11700,-9999,-9999,-9999
2021,2,4,8,11560,-9999,-9999,-9999
2021,2,4,9,11690,-9999,-9999,-9999
2021,2,4,10,12060,-9999,-9999,-9999
2021,2,4,11,12940,-9999,-9999,-9999
2021,2,4,12,14260,-9999,-9999,-9999
2021,2,4,13,15140,-9999,-9999,-9999
2021,2,4,14,15450,-9999,-9999,-9999
2021,2,4,15,15160,-9999,-9999,-9999
2021,2,4,16,14820,-9999,-9999,-9999
2021,2,4,17,14550,-9999,-9999,-9999
2021,2,4,18,14400,-9999,-9999,-9999
2021,2,4,19,14370,-9999,-9999,-9999
2021,2,4,20,14380,-9999,-9999,-9999
2021,2,4,21,14660,-9999,-9999,-9999
2021,2,4,22,15700,-9999,-9999,-9999
2021,2,4,23,17000,-9999,-9999,-9999
2021,2,5,0,16870,-9999,-9999,-9999
2021,2,5,1,16420,-9999,-9999,-9999
2021,2,5,2,15490,-9999,-9999,-9999
2021,2,5,3,14680,-9999,-9999,-9999
2021,2,5,4,13680,-9999,-9999,-9999
2021,2,5,5,12820,-9999,-9999,-9999
