Year,Month,Day,Hour,Forecast_Demand_MWh,Adjusted_Demand_MWh,Adjusted_Generation_MWh,Adjusted_Interchange_MWh
2015,7,1,7,1235,1309,2872,1563
2015,7,1,8,1210,1226,2825,1599
2015,7,1,9,1185,1188,2756,1568
2015,7,1,10,1155,1169,2733,1564
2015,7,1,11,1145,1187,2775,1588
2015,7,1,12,1180,1198,2792,1594
2015,7,1,13,1265,1275,2764,1489
2015,7,1,14,1350,1362,2566,1204
2015,7,1,15,1445,1456,2626,1170
2015,7,1,16,1505,1510,2652,1142
2015,7,1,17,1560,1576,2813,1237
2015,7,1,18,1610,1633,2845,1212
2015,7,1,19,1660,1676,2886,1210
2015,7,1,20,1690,1704,2815,1111
2015,7,1,21,1705,1736,2881,1145
2015,7,1,22,1710,1758,2863,1105
2015,7,1,23,1715,1772,2914,1142
2015,7,2,0,1700,1746,2939,1193
2015,7,2,1,1695,1701,2894,1193
2015,7,2,2,1665,1659,2889,1230
2015,7,2,3,1595,1609,2893,1284
2015,7,2,4,1520,1580,2910,1330
2015,7,2,5,1425,1493,2895,1402
2015,7,2,6,1320,1373,2896,1523
2015,7,2,7,1250,1292,2872,1580
2015,7,2,8,1185,1245,2817,1572
2015,7,2,9,1150,1190,2786,1596
2015,7,2,10,1130,1180,2780,1600
2015,7,2,11,1140,1182,2731,1549
2015,7,2,12,1165,1203,2661,1458
2015,7,2,13,1245,1256,2580,1324
2015,7,2,14,1340,1366,2500,1134
2015,7,2,15,1435,1436,2522,1086
2015,7,2,16,1485,1503,2551,1048
2015,7,2,17,1530,1535,2604,1069
2015,7,2,18,1595,1594,2583,989
2015,7,2,19,1640,1625,2538,913
2015,7,2,20,1670,1659,2512,853
2015,7,2,21,1705,1679,2486,807
2015,7,2,22,1725,1699,2454,755
2015,7,2,23,1725,1712,2480,768
2015,7,3,0,1725,1696,2492,796
2015,7,3,1,1705,1693,2505,812
2015,7,3,2,1660,1624,2481,857
2015,7,3,3,1630,1575,2442,867
2015,7,3,4,1580,1537,2434,897
2015,7,3,5,1500,1462,2438,976
2015,7,3,6,1335,1341,2469,1128
2015,7,3,7,1235,1261,2461,1200
2015,7,3,8,1180,1220,2436,1216
2015,7,3,9,1145,1165,2361,1196
2015,7,3,10,1125,1145,2346,1201
2015,7,3,11,1145,1150,2351,1201
2015,7,3,12,1160,1148,2357,1209
2015,7,3,13,1230,1180,2352,1172
2015,7,3,14,1330,1238,2237,999
2015,7,3,15,1405,1324,2327,1003
2015,7,3,16,1450,1382,2339,957
2015,7,3,17,1505,1456,2347,891
2015,7,3,18,1585,1494,2346,852
2015,7,3,19,1605,1539,2343,804
2015,7,3,20,1635,1591,2374,783
2015,7,3,21,1675,1626,2399,773
2015,7,3,22,1695,1647,2414,767
2015,7,3,23,1700,1686,2402,716
2015,7,4,0,1695,1684,2453,769
2015,7,4,1,1685,1658,2407,749
2015,7,4,2,1645,1633,2424,791
2015,7,4,3,1595,1586,2408,822
2015,7,4,4,1525,1528,2381,853
2015,7,4,5,1425,1468,2411,943
2015,7,4,6,1315,1364,2464,1100
2015,7,4,7,1215,1280,2460,1180
2015,7,4,8,1165,1216,2331,1115
2015,7,4,9,1135,1170,2055,885
2015,7,4,10,1115,1141,1993,852
2015,7,4,11,1125,1137,1930,793
2015,7,4,12,1150,1115,1975,860
2015,7,4,13,1170,1146,2015,869
2015,7,4,14,1250,1191,1852,661
2015,7,4,15,1295,1280,1842,562
2015,7,4,16,1365,1365,2000,635
2015,7,4,17,1420,1414,2048,634
2015,7,4,18,1470,1452,2131,679
2015,7,4,19,1505,1506,2164,658
2015,7,4,20,1535,1530,2344,814
2015,7,4,21,1560,1564,2396,832
2015,7,4,22,1575,1577,2449,872
2015,7,4,23,1595,1607,2385,778
2015,7,5,0,1600,1609,2369,760
2015,7,5,1,1570,1585,2313,728
2015,7,5,2,1540,1555,2302,747
2015,7,5,3,1505,1506,2095,589
2015,7,5,4,1465,1470,2048,578
2015,7,5,5,1425,1419,2107,688
2015,7,5,6,1315,1352,2138,786
2015,7,5,7,1215,1261,2101,840
2015,7,5,8,1165,1202,2058,856
2015,7,5,9,1130,1153,2120,967
2015,7,5,10,1110,1128,1985,857
2015,7,5,11,1135,1115,1983,868
2015,7,5,12,1145,1114,2001,887
2015,7,5,13,1185,1115,2003,888
2015,7,5,14,1210,1140,1973,833
2015,7,5,15,1295,1191,2029,838
2015,7,5,16,1375,1241,2123,882
2015,7,5,17,1425,1259,2297,1038
2015,7,5,18,1480,1276,2284,1008
2015,7,5,19,1510,1256,2316,1060
2015,7,5,20,1540,1284,2337,1053
2015,7,5,21,1555,1282,2362,1080
2015,7,5,22,1575,1281,2332,1051
2015,7,5,23,1580,1307,2360,1053
2015,7,6,0,1565,1316,2407,1091
2015,7,6,1,1535,1314,2422,1108
2015,7,6,2,1505,1307,2392,1085
2015,7,6,3,1485,1286,2349,1063
2015,7,6,4,1395,1296,2369,1073
2015,7,6,5,1365,1244,2404,1160
2015,7,6,6,1290,1164,2395,1231
2015,7,6,7,1210,1110,2394,1284
2015,7,6,8,1165,1093,2350,1257
2015,7,6,9,1130,1048,2166,1118
2015,7,6,10,1110,1053,2160,1107
2015,7,6,11,1135,1073,2182,1109
2015,7,6,12,1160,1104,2241,1137
2015,7,6,13,1200,1169,2351,1182
2015,7,6,14,1280,1255,2307,1052
2015,7,6,15,1355,1297,2294,997
2015,7,6,16,1400,1331,2302,971
2015,7,6,17,1440,1361,2333,972
2015,7,6,18,1505,1389,2366,977
2015,7,6,19,1545,1399,2355,956
2015,7,6,20,1575,1434,2342,908
2015,7,6,21,1595,1443,2293,850
2015,7,6,22,1610,1467,2381,914
2015,7,6,23,1610,1502,2423,921
2015,7,7,0,1590,1496,2406,910
2015,7,7,1,1565,1484,2402,918
2015,7,7,2,1525,1446,2356,910
2015,7,7,3,1485,1419,2319,900
2015,7,7,4,1365,1398,2317,919
2015,7,7,5,1305,1353,2349,996
2015,7,7,6,1260,1235,2368,1133
2015,7,7,7,1085,1177,2351,1174
2015,7,7,8,1060,1125,2413,1288
2015,7,7,9,1030,1094,2413,1319
2015,7,7,10,1025,1093,2383,1290
2015,7,7,11,1050,1102,2253,1151
2015,7,7,12,1080,1131,2187,1056
2015,7,7,13,1150,1201,2298,1097
2015,7,7,14,1240,1299,2393,1094
2015,7,7,15,1295,1336,2388,1052
2015,7,7,16,1325,1383,2442,1059
2015,7,7,17,1375,1432,2534,1102
2015,7,7,18,1420,1454,2644,1190
2015,7,7,19,1435,1465,2709,1244
2015,7,7,20,1465,1478,2728,1250
2015,7,7,21,1475,1510,2762,1252
2015,7,7,22,1495,1519,2793,1274
2015,7,7,23,1510,1525,2845,1320
2015,7,8,0,1505,1500,2851,1351
2015,7,8,1,1485,1470,2784,1314
2015,7,8,2,1465,1440,2761,1321
2015,7,8,3,1385,1409,2767,1358
2015,7,8,4,1255,1397,2784,1387
2015,7,8,5,1225,1325,2744,1419
2015,7,8,6,1190,1234,2773,1539
2015,7,8,7,1150,1167,2718,1551
2015,7,8,8,1110,1119,2634,1515
2015,7,8,9,1085,1111,2476,1365
2015,7,8,10,1075,1087,2481,1394
2015,7,8,11,1080,1099,2494,1395
2015,7,8,12,1105,1130,2457,1327
2015,7,8,13,1175,1198,2520,1322
2015,7,8,14,1300,1264,2474,1210
2015,7,8,15,1330,1335,2677,1342
2015,7,8,16,1365,1378,2705,1327
2015,7,8,17,1395,1430,2742,1312
2015,7,8,18,1410,1453,2748,1295
2015,7,8,19,1425,1469,2777,1308
2015,7,8,20,1445,1490,2788,1298
2015,7,8,21,1475,1518,2809,1291
2015,7,8,22,1495,1542,2827,1285
2015,7,8,23,1495,1571,2823,1252
2015,7,9,0,1485,1556,2819,1263
2015,7,9,1,1465,1574,2821,1247
2015,7,9,2,1430,1533,2778,1245
2015,7,9,3,1405,1498,2751,1253
2015,7,9,4,1395,1479,2761,1282
2015,7,9,5,1330,1401,2726,1325
2015,7,9,6,1225,1308,2791,1483
2015,7,9,7,1130,1206,2703,1497
2015,7,9,8,1080,1164,2675,1511
2015,7,9,9,1070,1158,2666,1508
2015,7,9,10,1050,1133,2660,1527
2015,7,9,11,1065,1133,2685,1552
2015,7,9,12,1105,1168,2758,1590
2015,7,9,13,1190,1234,2765,1531
2015,7,9,14,1300,1311,2608,1297
2015,7,9,15,1310,1378,2624,1246
2015,7,9,16,1355,1442,2762,1320
2015,7,9,17,1400,1498,2781,1283
2015,7,9,18,1420,1536,2742,1206
2015,7,9,19,1435,1568,2782,1214
2015,7,9,20,1445,1619,2816,1197
2015,7,9,21,1470,1636,2821,1185
2015,7,9,22,1485,1671,2785,1114
2015,7,9,23,1490,1685,2793,1108
2015,7,10,0,1465,1676,2800,1124
2015,7,10,1,1425,1656,2776,1120
2015,7,10,2,1405,1613,2776,1163
2015,7,10,3,1365,1550,2733,1183
2015,7,10,4,1360,1523,2754,1231
2015,7,10,5,1295,1427,2767,1340
2015,7,10,6,1200,1316,2778,1462
2015,7,10,7,1160,1235,2765,1530
2015,7,10,8,1130,1177,2718,1541
2015,7,10,9,1110,1171,2706,1535
2015,7,10,10,1090,1139,2719,1580
2015,7,10,11,1095,1140,2700,1560
2015,7,10,12,1130,1166,2706,1540
2015,7,10,13,1195,1219,2731,1512
2015,7,10,14,1295,1299,2508,1209
2015,7,10,15,1310,1385,2588,1203
2015,7,10,16,1335,1442,2736,1294
2015,7,10,17,1380,1497,2760,1263
2015,7,10,18,1425,1545,2750,1205
2015,7,10,19,1440,1569,2751,1182
2015,7,10,20,1455,1598,2783,1185
2015,7,10,21,1480,1613,2781,1168
2015,7,10,22,1495,1621,2767,1146
2015,7,10,23,1535,1601,2798,1197
2015,7,11,0,1525,1518,2759,1241
2015,7,11,1,1510,1468,2758,1290
2015,7,11,2,1500,1415,2720,1305
2015,7,11,3,1465,1369,2697,1328
2015,7,11,4,1445,1369,2697,1328
2015,7,11,5,1360,1321,2733,1412
2015,7,11,6,1260,1243,2743,1500
2015,7,11,7,1135,1178,2753,1575
2015,7,11,8,1095,1145,2744,1599
2015,7,11,9,1085,1116,2558,1442
2015,7,11,10,1075,1108,2470,1362
2015,7,11,11,1070,1104,2472,1368
2015,7,11,12,1075,1120,2515,1395
2015,7,11,13,1100,1132,2494,1362
2015,7,11,14,1145,1174,2460,1286
2015,7,11,15,1195,1251,2572,1321
2015,7,11,16,1210,1310,2812,1502
2015,7,11,17,1235,1357,2915,1558
2015,7,11,18,1265,1365,2930,1565
2015,7,11,19,1280,1377,2886,1509
2015,7,11,20,1320,1394,2903,1509
2015,7,11,21,1340,1400,2897,1497
2015,7,11,22,1340,1410,2928,1518
2015,7,11,23,1335,1441,2918,1477
2015,7,12,0,1325,1409,2878,1469
2015,7,12,1,1295,1395,2856,1461
2015,7,12,2,1270,1366,2832,1466
2015,7,12,3,1255,1330,2798,1468
2015,7,12,4,1210,1314,2794,1480
2015,7,12,5,1185,1268,2558,1290
2015,7,12,6,1150,1203,2578,1375
2015,7,12,7,1130,1151,2558,1407
2015,7,12,8,1105,1123,2501,1378
2015,7,12,9,1095,1098,2548,1450
2015,7,12,10,1085,1088,2509,1421
2015,7,12,11,1075,1086,2436,1350
2015,7,12,12,1085,1067,2469,1402
2015,7,12,13,1110,1067,2644,1577
2015,7,12,14,1195,1136,2640,1504
2015,7,12,15,1215,1199,2732,1533
2015,7,12,16,1250,1263,2803,1540
2015,7,12,17,1275,1320,2887,1567
2015,7,12,18,1300,1357,2899,1542
2015,7,12,19,1310,1376,2911,1535
2015,7,12,20,1335,1373,2933,1560
2015,7,12,21,1345,1382,2936,1554
2015,7,12,22,1360,1400,2904,1504
2015,7,12,23,1360,1431,2861,1430
2015,7,13,0,1350,1461,2871,1410
2015,7,13,1,1310,1471,2877,1406
2015,7,13,2,1290,1456,2843,1387
2015,7,13,3,1275,1434,2849,1415
2015,7,13,4,1265,1402,2780,1378
2015,7,13,5,1200,1332,2761,1429
2015,7,13,6,1150,1238,2763,1525
2015,7,13,7,1140,1160,2707,1547
2015,7,13,8,1105,1112,2654,1542
2015,7,13,9,1095,1087,2564,1477
2015,7,13,10,1090,1069,2410,1341
2015,7,13,11,1100,1084,2435,1351
2015,7,13,12,1130,1104,2396,1292
2015,7,13,13,1165,1181,2464,1283
2015,7,13,14,1200,1256,2490,1234
2015,7,13,15,1245,1343,2686,1343
2015,7,13,16,1300,1382,2733,1351
2015,7,13,17,1340,1437,2781,1344
2015,7,13,18,1380,1483,2851,1368
2015,7,13,19,1410,1501,2848,1347
2015,7,13,20,1440,1527,2855,1328
2015,7,13,21,1460,1545,2863,1318
2015,7,13,22,1490,1557,2770,1213
2015,7,13,23,1500,1566,2785,1219
2015,7,14,0,1490,1543,2772,1229
2015,7,14,1,1470,1514,2744,1230
2015,7,14,2,1435,1498,2738,1240
2015,7,14,3,1385,1441,2715,1274
2015,7,14,4,1295,1433,2833,1400
2015,7,14,5,1265,1346,2848,1502
2015,7,14,6,1160,1216,2804,1588
2015,7,14,7,1115,1144,2726,1582
2015,7,14,8,1085,1104,2673,1569
2015,7,14,9,1060,1084,2649,1565
2015,7,14,10,1075,1067,2640,1573
2015,7,14,11,1100,1066,2635,1569
2015,7,14,12,1175,1113,2689,1576
2015,7,14,13,1265,1158,2703,1545
2015,7,14,14,1285,1254,2521,1267
2015,7,14,15,1310,1314,2535,1221
2015,7,14,16,1335,1355,2709,1354
2015,7,14,17,1350,1405,2783,1378
2015,7,14,18,1395,1450,2778,1328
2015,7,14,19,1415,1467,2779,1312
2015,7,14,20,1430,1493,2783,1290
2015,7,14,21,1445,1521,2799,1278
2015,7,14,22,1465,1548,2824,1276
2015,7,14,23,1480,1531,2801,1270
2015,7,15,0,1485,1525,2745,1220
2015,7,15,1,1460,1507,2759,1252
2015,7,15,2,1410,1480,2814,1334
2015,7,15,3,1395,1429,2804,1375
2015,7,15,4,1365,1402,2776,1374
2015,7,15,5,1320,1326,2731,1405
2015,7,15,6,1215,1211,2664,1453
2015,7,15,7,1095,1151,2674,1523
2015,7,15,8,1065,1109,2627,1518
2015,7,15,9,1030,1086,2610,1524
2015,7,15,10,1015,1082,2620,1538
2015,7,15,11,1020,1073,2609,1536
2015,7,15,12,1075,1107,2192,1085
2015,7,15,13,1130,1182,1954,772
2015,7,15,14,1230,1272,1947,675
2015,7,15,15,1300,1323,1979,656
2015,7,15,16,1340,1343,2018,675
2015,7,15,17,1395,1360,1979,619
2015,7,15,18,1440,1384,1996,612
2015,7,15,19,1450,1381,1995,614
2015,7,15,20,1495,1398,2045,647
2015,7,15,21,1505,1421,2061,640
2015,7,15,22,1520,1426,1997,571
2015,7,15,23,1530,1431,2006,575
2015,7,16,0,1515,1427,2020,593
2015,7,16,1,1485,1401,2024,623
2015,7,16,2,1460,1380,2015,635
2015,7,16,3,1395,1341,1986,645
2015,7,16,4,1395,1337,1993,656
2015,7,16,5,1300,1268,2001,733
2015,7,16,6,1165,1166,2023,857
2015,7,16,7,1110,1101,2011,910
2015,7,16,8,1080,1066,1969,903
2015,7,16,9,1050,1048,1919,871
2015,7,16,10,1035,1036,1833,797
2015,7,16,11,1035,1048,1673,625
2015,7,16,12,1080,1076,1748,672
2015,7,16,13,1135,1149,1728,579
2015,7,16,14,1250,1226,1739,513
2015,7,16,15,1275,1299,1708,409
2015,7,16,16,1325,1342,1765,423
2015,7,16,17,1370,1381,1780,399
2015,7,16,18,1415,1408,1807,399
2015,7,16,19,1425,1422,1816,394
2015,7,16,20,1450,1436,1814,378
2015,7,16,21,1485,1443,1815,372
2015,7,16,22,1505,1463,1821,358
2015,7,16,23,1490,1437,1796,359
2015,7,17,0,1485,1405,1791,386
2015,7,17,1,1475,1364,1812,448
2015,7,17,2,1430,1335,1795,460
2015,7,17,3,1375,1323,1781,458
2015,7,17,4,1360,1332,1786,454
2015,7,17,5,1295,1273,1792,519
2015,7,17,6,1160,1176,1771,595
2015,7,17,7,1115,1114,1752,638
2015,7,17,8,1065,1084,1737,653
2015,7,17,9,1045,1071,1654,583
2015,7,17,10,1030,1057,1643,586
2015,7,17,11,1030,1076,1625,549
2015,7,17,12,1070,1105,1683,578
2015,7,17,13,1145,1135,1699,564
2015,7,17,14,1250,1213,1708,495
2015,7,17,15,1320,1283,1958,675
2015,7,17,16,1360,1320,2104,784
2015,7,17,17,1385,1358,2228,870
2015,7,17,18,1415,1369,2321,952
2015,7,17,19,1445,1369,2457,1088
2015,7,17,20,1465,1387,2538,1151
2015,7,17,21,1495,1393,2577,1184
2015,7,17,22,1495,1402,2568,1166
2015,7,17,23,1490,1401,2578,1177
2015,7,18,0,1475,1376,2574,1198
2015,7,18,1,1440,1362,2570,1208
2015,7,18,2,1405,1342,2566,1224
2015,7,18,3,1375,1295,2516,1221
2015,7,18,4,1335,1292,2446,1154
2015,7,18,5,1295,1235,2386,1151
2015,7,18,6,1185,1187,2435,1248
2015,7,18,7,1100,1142,2422,1280
2015,7,18,8,1070,1083,2445,1362
2015,7,18,9,1040,1052,2459,1407
2015,7,18,10,1015,1070,2461,1391
2015,7,18,11,1025,1061,2375,1314
2015,7,18,12,1040,1070,2354,1284
2015,7,18,13,1065,1071,2332,1261
2015,7,18,14,1110,1103,2036,933
2015,7,18,15,1190,1166,2151,985
2015,7,18,16,1240,1215,2380,1165
2015,7,18,17,1280,1246,2448,1202
2015,7,18,18,1305,1265,2561,1296
2015,7,18,19,1325,1273,2627,1354
2015,7,18,20,1330,1274,2589,1315
2015,7,18,21,1340,1276,2582,1306
2015,7,18,22,1360,1283,2581,1298
2015,7,18,23,1370,1295,2587,1292
2015,7,19,0,1350,1317,2666,1349
2015,7,19,1,1325,1333,2659,1326
2015,7,19,2,1305,1326,2668,1342
2015,7,19,3,1275,1303,2702,1399
2015,7,19,4,1255,1278,2691,1413
2015,7,19,5,1215,1253,2711,1458
2015,7,19,6,1140,1180,2731,1551
2015,7,19,7,1115,1121,2703,1582
2015,7,19,8,1080,1096,2667,1571
2015,7,19,9,1065,1083,2658,1575
2015,7,19,10,1050,1076,2628,1552
2015,7,19,11,1035,1091,2664,1573
2015,7,19,12,1030,1077,2652,1575
2015,7,19,13,1020,1072,2473,1401
2015,7,19,14,1095,1109,2464,1355
2015,7,19,15,1145,1170,2615,1445
2015,7,19,16,1210,1223,2649,1426
2015,7,19,17,1255,1262,2772,1510
2015,7,19,18,1310,1301,2770,1469
2015,7,19,19,1320,1339,2794,1455
2015,7,19,20,1335,1361,2770,1409
2015,7,19,21,1345,1372,2774,1402
2015,7,19,22,1390,1400,2792,1392
2015,7,19,23,1405,1426,2762,1336
2015,7,20,0,1420,1453,2763,1310
2015,7,20,1,1430,1447,2781,1334
2015,7,20,2,1400,1432,2770,1338
2015,7,20,3,1385,1428,2748,1320
2015,7,20,4,1375,1410,2768,1358
2015,7,20,5,1300,1335,2727,1392
2015,7,20,6,1195,1227,2625,1398
2015,7,20,7,1125,1157,2608,1451
2015,7,20,8,1075,1098,2569,1471
2015,7,20,9,1060,1078,2467,1389
2015,7,20,10,1025,1060,2166,1106
2015,7,20,11,1050,1076,2189,1113
2015,7,20,12,1075,1104,2192,1088
2015,7,20,13,1145,1168,2307,1139
2015,7,20,14,1230,1261,2379,1118
2015,7,20,15,1300,1323,2462,1139
2015,7,20,16,1340,1383,2540,1157
2015,7,20,17,1400,1438,2711,1273
2015,7,20,18,1455,1459,2718,1259
2015,7,20,19,1495,1517,2742,1225
2015,7,20,20,1500,1578,2734,1156
2015,7,20,21,1510,1610,2748,1138
2015,7,20,22,1525,1626,2722,1096
2015,7,20,23,1525,1617,2717,1100
2015,7,21,0,1515,1599,2737,1138
2015,7,21,1,1480,1583,2754,1171
2015,7,21,2,1455,1566,2763,1197
2015,7,21,3,1395,1527,2710,1183
2015,7,21,4,1360,1489,2616,1127
2015,7,21,5,1300,1398,2629,1231
2015,7,21,6,1175,1257,2555,1298
2015,7,21,7,1125,1173,2414,1241
2015,7,21,8,1075,1118,2365,1247
2015,7,21,9,1050,1117,2371,1254
2015,7,21,10,1045,1096,2291,1195
2015,7,21,11,1050,1097,2241,1144
2015,7,21,12,1085,1122,2201,1079
2015,7,21,13,1145,1177,2382,1205
2015,7,21,14,1265,1287,2495,1208
2015,7,21,15,1310,1363,2648,1285
2015,7,21,16,1360,1423,2657,1234
2015,7,21,17,1400,1478,2683,1205
2015,7,21,18,1435,1521,2691,1170
2015,7,21,19,1460,1565,2670,1105
2015,7,21,20,1485,1584,2679,1095
2015,7,21,21,1505,1595,2671,1076
2015,7,21,22,1530,1573,2637,1064
2015,7,21,23,1540,1564,2603,1039
2015,7,22,0,1540,1569,2708,1139
2015,7,22,1,1515,1549,2645,1096
2015,7,22,2,1490,1516,2624,1108
2015,7,22,3,1460,1481,2625,1144
2015,7,22,4,1395,1449,2620,1171
2015,7,22,5,1355,1359,2602,1243
2015,7,22,6,1260,1254,2530,1276
2015,7,22,7,1145,1153,2401,1248
2015,7,22,8,1090,1105,2296,1191
2015,7,22,9,1085,1055,2052,997
2015,7,22,10,1065,1042,1968,926
2015,7,22,11,1075,1050,1981,931
2015,7,22,12,1100,1083,2103,1020
2015,7,22,13,1150,1159,2244,1085
2015,7,22,14,1265,1263,2391,1128
2015,7,22,15,1310,1310,2525,1215
2015,7,22,16,1355,1349,2559,1210
2015,7,22,17,1400,1384,2598,1214
2015,7,22,18,1430,1431,2639,1208
2015,7,22,19,1475,1465,2627,1162
2015,7,22,20,1510,1500,2637,1137
2015,7,22,21,1540,1534,2670,1136
2015,7,22,22,1545,1558,2640,1082
2015,7,22,23,1550,1564,2622,1058
2015,7,23,0,1545,1535,2555,1020
2015,7,23,1,1525,1509,2602,1093
2015,7,23,2,1505,1465,2579,1114
2015,7,23,3,1470,1427,2579,1152
2015,7,23,4,1435,1400,2577,1177
2015,7,23,5,1365,1332,2557,1225
2015,7,23,6,1240,1214,2554,1340
2015,7,23,7,1125,1162,2541,1379
2015,7,23,8,1075,1115,2548,1433
2015,7,23,9,1055,1089,2587,1498
2015,7,23,10,1045,1086,2517,1431
2015,7,23,11,1030,1102,2497,1395
2015,7,23,12,1070,1133,2538,1405
2015,7,23,13,1120,1204,2605,1401
2015,7,23,14,1255,1261,2461,1200
2015,7,23,15,1280,1323,2588,1265
2015,7,23,16,1330,1348,2551,1203
2015,7,23,17,1375,1364,2547,1183
2015,7,23,18,1395,1380,2519,1139
2015,7,23,19,1435,1399,2468,1069
2015,7,23,20,1450,1397,2463,1066
2015,7,23,21,1455,1399,2526,1127
2015,7,23,22,1480,1423,2513,1090
2015,7,23,23,1465,1411,2429,1018
2015,7,24,0,1445,1400,2465,1065
2015,7,24,1,1415,1373,2480,1107
2015,7,24,2,1380,1344,2575,1231
2015,7,24,3,1330,1337,2554,1217
2015,7,24,4,1315,1302,2534,1232
2015,7,24,5,1260,1254,2561,1307
2015,7,24,6,1160,1169,2591,1422
2015,7,24,7,1125,1106,2611,1505
2015,7,24,8,1075,1071,2620,1549
2015,7,24,9,1055,1050,2578,1528
2015,7,24,10,1045,1035,2471,1436
2015,7,24,11,1035,1045,2498,1453
2015,7,24,12,1080,1079,2549,1470
2015,7,24,13,1165,1131,2556,1425
2015,7,24,14,1245,1217,2507,1290
2015,7,24,15,1335,1294,2601,1307
2015,7,24,16,1385,1325,2632,1307
2015,7,24,17,1440,1377,2624,1247
2015,7,24,18,1495,1404,2657,1253
2015,7,24,19,1505,1436,2699,1263
2015,7,24,20,1515,1463,2739,1276
2015,7,24,21,1525,1491,2753,1262
2015,7,24,22,1530,1503,2754,1251
2015,7,24,23,1530,1502,2753,1251
2015,7,25,0,1485,1500,2762,1262
2015,7,25,1,1420,1463,2728,1265
2015,7,25,2,1370,1427,2669,1242
2015,7,25,3,1335,1379,2643,1264
2015,7,25,4,1320,1362,2706,1344
2015,7,25,5,1285,1294,2679,1385
2015,7,25,6,1175,1203,2666,1463
2015,7,25,7,1095,1132,2631,1499
2015,7,25,8,1050,1109,2628,1519
2015,7,25,9,1015,1075,2535,1460
2015,7,25,10,1010,1058,2566,1508
2015,7,25,11,1015,1039,2452,1413
2015,7,25,12,1040,1048,2541,1493
2015,7,25,13,1095,1045,2468,1423
2015,7,25,14,1165,1101,2225,1124
2015,7,25,15,1230,1177,2316,1139
2015,7,25,16,1280,1242,2347,1105
2015,7,25,17,1300,1297,2301,1004
2015,7,25,18,1310,1330,2303,973
2015,7,25,19,1330,1363,2297,934
2015,7,25,20,1325,1400,2307,907
2015,7,25,21,1330,1418,2270,852
2015,7,25,22,1345,1433,2261,828
2015,7,25,23,1350,1460,2261,801
2015,7,26,0,1340,1468,2282,814
2015,7,26,1,1330,1461,2285,824
2015,7,26,2,1320,1431,2251,820
2015,7,26,3,1295,1386,2320,934
2015,7,26,4,1285,1374,2319,945
2015,7,26,5,1240,1309,2316,1007
2015,7,26,6,1155,1210,2299,1089
2015,7,26,7,1105,1148,2516,1368
2015,7,26,8,1060,1101,2432,1331
2015,7,26,9,1040,1057,2174,1117
2015,7,26,10,1035,1033,2178,1145
2015,7,26,11,1030,1027,2073,1046
2015,7,26,12,1050,1036,2105,1069
2015,7,26,13,1090,1039,2255,1216
2015,7,26,14,1155,1079,2159,1080
2015,7,26,15,1215,1153,2301,1148
2015,7,26,16,1270,1206,2278,1072
2015,7,26,17,1290,1252,2282,1030
2015,7,26,18,1320,1288,2293,1005
2015,7,26,19,1340,1331,2332,1001
2015,7,26,20,1350,1356,2365,1009
2015,7,26,21,1355,1381,2380,999
2015,7,26,22,1380,1428,2390,962
2015,7,26,23,1400,1446,2380,934
2015,7,27,0,1405,1460,2379,919
2015,7,27,1,1395,1450,2402,952
2015,7,27,2,1370,1424,2406,982
2015,7,27,3,1360,1398,2453,1055
2015,7,27,4,1335,1394,2513,1119
2015,7,27,5,1280,1302,2542,1240
2015,7,27,6,1180,1204,2524,1320
2015,7,27,7,1120,1125,2363,1238
2015,7,27,8,1065,1074,2264,1190
2015,7,27,9,1050,1057,2422,1365
2015,7,27,10,1030,1054,2441,1387
2015,7,27,11,1040,1047,2387,1340
2015,7,27,12,1075,1107,2511,1404
2015,7,27,13,1135,1163,2494,1331
2015,7,27,14,1200,1246,2488,1242
2015,7,27,15,1265,1290,2624,1334
2015,7,27,16,1310,1322,2652,1330
2015,7,27,17,1340,1345,2667,1322
2015,7,27,18,1365,1356,2695,1339
2015,7,27,19,1395,1361,2708,1347
2015,7,27,20,1420,1374,2677,1303
2015,7,27,21,1435,1364,2661,1297
2015,7,27,22,1455,1349,2641,1292
2015,7,27,23,1450,1314,2632,1318
2015,7,28,0,1440,1292,2614,1322
2015,7,28,1,1410,1270,2603,1333
2015,7,28,2,1385,1240,2663,1423
2015,7,28,3,1350,1234,2602,1368
2015,7,28,4,1335,1252,2604,1352
2015,7,28,5,1260,1195,2723,1528
2015,7,28,6,1145,1116,2724,1608
2015,7,28,7,1085,1079,2766,1687
2015,7,28,8,1045,1049,2600,1551
2015,7,28,9,1025,1038,2602,1564
2015,7,28,10,1010,1033,2568,1535
2015,7,28,11,1010,1051,2572,1521
2015,7,28,12,1050,1084,2612,1528
2015,7,28,13,1105,1145,2611,1466
2015,7,28,14,1200,1221,2523,1302
2015,7,28,15,1260,1271,2716,1445
2015,7,28,16,1310,1293,2731,1438
2015,7,28,17,1355,1325,2719,1394
2015,7,28,18,1405,1312,2765,1453
2015,7,28,19,1430,1303,2728,1425
2015,7,28,20,1450,1311,2756,1445
2015,7,28,21,1475,1310,2733,1423
2015,7,28,22,1490,1309,2734,1425
2015,7,28,23,1480,1329,2763,1434
2015,7,29,0,1480,1312,2733,1421
2015,7,29,1,1450,1315,2722,1407
2015,7,29,2,1405,1302,2718,1416
2015,7,29,3,1365,1282,2722,1440
2015,7,29,4,1340,1299,2736,1437
2015,7,29,5,1270,1222,2672,1450
2015,7,29,6,1160,1137,2633,1496
2015,7,29,7,1080,1097,2732,1635
2015,7,29,8,1050,1060,2744,1684
2015,7,29,9,1025,1055,2785,1730
2015,7,29,10,1015,1030,2741,1711
2015,7,29,11,1010,1045,2725,1680
2015,7,29,12,1055,1099,2730,1631
2015,7,29,13,1145,1145,2704,1559
2015,7,29,14,1290,1223,2704,1481
2015,7,29,15,1325,1251,2700,1449
2015,7,29,16,1365,1252,2650,1398
2015,7,29,17,1395,1301,2657,1356
2015,7,29,18,1430,1324,2702,1378
2015,7,29,19,1435,1326,2789,1463
2015,7,29,20,1460,1358,2750,1392
2015,7,29,21,1480,1377,2739,1362
2015,7,29,22,1500,1398,2748,1350
2015,7,29,23,1495,1425,2790,1365
2015,7,30,0,1475,1427,2783,1356
2015,7,30,1,1450,1443,2775,1332
2015,7,30,2,1410,1430,2767,1337
2015,7,30,3,1380,1387,2740,1353
2015,7,30,4,1360,1376,2736,1360
2015,7,30,5,1305,1305,2690,1385
2015,7,30,6,1185,1189,2623,1434
2015,7,30,7,1060,1121,2669,1548
2015,7,30,8,1040,1080,2521,1441
2015,7,30,9,1020,1047,2466,1419
2015,7,30,10,1005,1043,2450,1407
2015,7,30,11,1005,1050,2499,1449
2015,7,30,12,1050,1086,2652,1566
2015,7,30,13,1160,1146,2686,1540
2015,7,30,14,1260,1210,2512,1302
2015,7,30,15,1315,1268,2491,1223
2015,7,30,16,1365,1330,2660,1330
2015,7,30,17,1385,1364,2691,1327
2015,7,30,18,1400,1392,2622,1230
2015,7,30,19,1415,1430,2706,1276
2015,7,30,20,1410,1471,2724,1253
2015,7,30,21,1410,1510,2717,1207
2015,7,30,22,1430,1528,2692,1164
2015,7,30,23,1410,1558,2705,1147
2015,7,31,0,1390,1549,2674,1125
2015,7,31,1,1365,1546,2653,1107
2015,7,31,2,1330,1521,2676,1155
2015,7,31,3,1315,1472,2671,1199
2015,7,31,4,1300,1431,2678,1247
2015,7,31,5,1250,1337,2690,1353
2015,7,31,6,1160,1219,2628,1409
2015,7,31,7,1065,1141,2635,1494
2015,7,31,8,1035,1105,2646,1541
2015,7,31,9,1020,1064,2599,1535
2015,7,31,10,1005,1053,2590,1537
2015,7,31,11,1015,1059,2582,1523
2015,7,31,12,1045,1078,2629,1551
2015,7,31,13,1135,1142,2640,1498
2015,7,31,14,1245,1214,2591,1377
2015,7,31,15,1310,1275,2587,1312
2015,7,31,16,1350,1320,2494,1174
2015,7,31,17,1400,1364,2532,1168
2015,7,31,18,1430,1410,2563,1153
2015,7,31,19,1430,1461,2642,1181
2015,7,31,20,1455,1493,2735,1242
2015,7,31,21,1470,1536,2760,1224
2015,7,31,22,1475,1569,2767,1198
2015,7,31,23,1480,1588,2721,1133
2015,8,1,0,1475,1578,2711,1133
2015,8,1,1,1440,1566,2724,1158
2015,8,1,2,1405,1551,2723,1172
2015,8,1,3,1360,1494,2680,1186
2015,8,1,4,1345,1450,2648,1198
2015,8,1,5,1285,1372,2652,1280
2015,8,1,6,1200,1260,2630,1370
2015,8,1,7,1075,1179,2628,1449
2015,8,1,8,1055,1118,2459,1341
2015,8,1,9,1030,1082,2426,1344
2015,8,1,10,995,1066,2429,1363
2015,8,1,11,995,1060,2412,1352
2015,8,1,12,1010,1061,2223,1162
2015,8,1,13,1060,1071,2215,1144
2015,8,1,14,1140,1102,2066,964
2015,8,1,15,1205,1180,2211,1031
2015,8,1,16,1265,1241,2325,1084
2015,8,1,17,1310,1307,2565,1258
2015,8,1,18,1335,1354,2612,1258
2015,8,1,19,1375,1423,2710,1287
2015,8,1,20,1405,1483,2712,1229
2015,8,1,21,1425,1535,2733,1198
2015,8,1,22,1440,1558,2754,1196
2015,8,1,23,1470,1568,2531,963
2015,8,2,0,1475,1579,2461,882
2015,8,2,1,1470,1569,2433,864
2015,8,2,2,1445,1532,2408,876
2015,8,2,3,1405,1476,2364,888
2015,8,2,4,1385,1447,2341,894
2015,8,2,5,1310,1361,2353,992
2015,8,2,6,1210,1242,2343,1101
2015,8,2,7,1090,1149,2260,1111
2015,8,2,8,1050,1106,2150,1044
2015,8,2,9,1015,1066,2080,1014
2015,8,2,10,1010,1054,2096,1042
2015,8,2,11,1010,1048,2099,1051
2015,8,2,12,1025,1061,2160,1099
2015,8,2,13,1060,1049,2176,1127
2015,8,2,14,1130,1093,2076,983
2015,8,2,15,1180,1155,2239,1084
2015,8,2,16,1240,1231,2214,983
2015,8,2,17,1275,1269,2194,925
2015,8,2,18,1310,1332,2386,1054
2015,8,2,19,1340,1367,2416,1049
2015,8,2,20,1345,1424,2426,1002
2015,8,2,21,1360,1456,2430,974
2015,8,2,22,1395,1484,2383,899
2015,8,2,23,1405,1532,2420,888
2015,8,3,0,1415,1558,2425,867
2015,8,3,1,1395,1553,2421,868
2015,8,3,2,1365,1528,2379,851
2015,8,3,3,1360,1480,2352,872
2015,8,3,4,1340,1454,2385,931
2015,8,3,5,1270,1375,2463,1088
2015,8,3,6,1170,1240,2471,1231
2015,8,3,7,1070,1164,2450,1286
2015,8,3,8,1055,1121,2377,1256
2015,8,3,9,1050,1091,2281,1190
2015,8,3,10,1050,1077,2143,1066
2015,8,3,11,1060,1074,2039,965
2015,8,3,12,1095,1112,2066,954
2015,8,3,13,1170,1185,2380,1195
2015,8,3,14,1265,1259,2283,1024
2015,8,3,15,1325,1336,2467,1131
2015,8,3,16,1385,1397,2659,1262
2015,8,3,17,1425,1442,2672,1230
2015,8,3,18,1450,1476,2673,1197
2015,8,3,19,1500,1518,2679,1161
2015,8,3,20,1545,1581,2703,1122
2015,8,3,21,1575,1618,2724,1106
2015,8,3,22,1590,1644,2704,1060
2015,8,3,23,1585,1660,2711,1051
2015,8,4,0,1575,1649,2761,1112
2015,8,4,1,1555,1633,2745,1112
2015,8,4,2,1530,1585,2692,1107
2015,8,4,3,1500,1553,2654,1101
2015,8,4,4,1450,1534,2703,1169
2015,8,4,5,1370,1447,2732,1285
2015,8,4,6,1235,1323,2734,1411
2015,8,4,7,1150,1242,2704,1462
2015,8,4,8,1105,1198,2707,1509
2015,8,4,9,1095,1163,2660,1497
2015,8,4,10,1080,1139,2460,1321
2015,8,4,11,1090,1151,2484,1333
2015,8,4,12,1120,1192,2542,1350
2015,8,4,13,1185,1254,2578,1324
2015,8,4,14,1290,1321,2421,1100
2015,8,4,15,1350,1377,2394,1017
2015,8,4,16,1395,1454,2669,1215
2015,8,4,17,1445,1492,2675,1183
2015,8,4,18,1480,1514,2674,1160
2015,8,4,19,1500,1520,2634,1114
2015,8,4,20,1520,1520,2681,1161
2015,8,4,21,1530,1516,2671,1155
2015,8,4,22,1530,1540,2668,1128
2015,8,4,23,1535,1544,2658,1114
2015,8,5,0,1530,1546,2710,1164
2015,8,5,1,1510,1518,2675,1157
2015,8,5,2,1460,1492,2715,1223
2015,8,5,3,1435,1445,1809,364
2015,8,5,4,1410,1419,1745,326
2015,8,5,5,1325,1313,2020,707
2015,8,5,6,1225,1210,2198,988
2015,8,5,7,1135,1158,2480,1322
2015,8,5,8,1095,1122,2643,1521
2015,8,5,9,1085,1096,2623,1527
2015,8,5,10,1070,1088,2380,1292
2015,8,5,11,1095,1088,2350,1262
2015,8,5,12,1120,1120,2384,1264
2015,8,5,13,1195,1175,2462,1287
2015,8,5,14,1245,1272,2485,1213
2015,8,5,15,1325,1318,2625,1307
2015,8,5,16,1335,1352,2676,1324
2015,8,5,17,1355,1380,2651,1271
2015,8,5,18,1365,1394,2684,1290
2015,8,5,19,1375,1417,2694,1277
2015,8,5,20,1420,1433,2702,1269
2015,8,5,21,1435,1440,2675,1235
2015,8,5,22,1470,1465,2753,1288
2015,8,5,23,1490,1465,2727,1262
2015,8,6,0,1480,1458,2658,1200
2015,8,6,1,1470,1424,2696,1272
2015,8,6,2,1435,1384,2719,1335
2015,8,6,3,1395,1364,2718,1354
2015,8,6,4,1365,1352,2723,1371
2015,8,6,5,1315,1285,2740,1455
2015,8,6,6,1185,1205,2729,1524
2015,8,6,7,1110,1148,2710,1562
2015,8,6,8,1075,1109,2519,1410
2015,8,6,9,1055,1084,2482,1398
2015,8,6,10,1040,1065,2361,1296
2015,8,6,11,1045,1066,2377,1311
2015,8,6,12,1085,1124,2697,1573
2015,8,6,13,1155,1188,2674,1486
2015,8,6,14,1235,1249,2486,1237
2015,8,6,15,1295,1291,2482,1191
2015,8,6,16,1355,1330,2585,1255
2015,8,6,17,1385,1377,2641,1264
2015,8,6,18,1410,1396,2704,1308
2015,8,6,19,1425,1412,2728,1316
2015,8,6,20,1435,1439,2745,1306
2015,8,6,21,1445,1457,2744,1287
2015,8,6,22,1450,1490,2785,1295
2015,8,6,23,1445,1488,2795,1307
2015,8,7,0,1435,1470,2771,1301
2015,8,7,1,1415,1459,2705,1246
2015,8,7,2,1395,1427,2688,1261
2015,8,7,3,1375,1383,2670,1287
2015,8,7,4,1355,1379,2670,1291
2015,8,7,5,1250,1293,2656,1363
2015,8,7,6,1145,1216,2675,1459
2015,8,7,7,1115,1145,2602,1457
2015,8,7,8,1075,1109,2563,1454
2015,8,7,9,1045,1081,2606,1525
2015,8,7,10,1030,1068,2589,1521
2015,8,7,11,1040,1068,2567,1499
2015,8,7,12,1090,1088,2574,1486
2015,8,7,13,1150,1148,2561,1413
2015,8,7,14,1250,1217,2535,1318
2015,8,7,15,1285,1262,2523,1261
2015,8,7,16,1325,1285,2536,1251
2015,8,7,17,1365,1319,2588,1269
2015,8,7,18,1385,1342,2614,1272
2015,8,7,19,1415,1377,2636,1259
2015,8,7,20,1450,1409,2665,1256
2015,8,7,21,1470,1414,2629,1215
2015,8,7,22,1490,1434,2601,1167
2015,8,7,23,1500,1461,2614,1153
2015,8,8,0,1500,1454,2625,1171
2015,8,8,1,1470,1439,2644,1205
2015,8,8,2,1435,1410,2648,1238
2015,8,8,3,1390,1373,2641,1268
2015,8,8,4,1340,1349,2661,1312
2015,8,8,5,1285,1281,2588,1307
2015,8,8,6,1175,1199,2609,1410
2015,8,8,7,1095,1139,2607,1468
2015,8,8,8,1070,1090,2587,1497
2015,8,8,9,1040,1070,2583,1513
2015,8,8,10,1000,1055,2584,1529
2015,8,8,11,995,1061,2549,1488
2015,8,8,12,1010,1077,2555,1478
2015,8,8,13,1035,1100,2560,1460
2015,8,8,14,1095,1142,2295,1153
2015,8,8,15,1155,1192,2307,1115
2015,8,8,16,1220,1242,2525,1283
2015,8,8,17,1270,1260,2557,1297
2015,8,8,18,1300,1263,2531,1268
2015,8,8,19,1375,1281,2561,1280
2015,8,8,20,1395,1266,2552,1286
2015,8,8,21,1405,1269,2554,1285
2015,8,8,22,1440,1267,2566,1299
2015,8,8,23,1445,1276,2546,1270
2015,8,9,0,1445,1284,2550,1266
2015,8,9,1,1435,1279,2547,1268
2015,8,9,2,1415,1276,2556,1280
2015,8,9,3,1370,1263,2549,1286
2015,8,9,4,1355,1273,2557,1284
2015,8,9,5,1285,1224,2585,1361
2015,8,9,6,1175,1157,2589,1432
2015,8,9,7,1125,1103,2572,1469
2015,8,9,8,1065,1067,2167,1100
2015,8,9,9,1015,1033,2176,1143
2015,8,9,10,1005,1024,2116,1092
2015,8,9,11,1000,1009,2104,1095
2015,8,9,12,1005,1025,2113,1088
2015,8,9,13,1025,1035,2355,1320
2015,8,9,14,1085,1080,2279,1199
2015,8,9,15,1130,1142,2402,1260
2015,8,9,16,1190,1211,2562,1351
2015,8,9,17,1235,1228,2583,1355
2015,8,9,18,1280,1264,2578,1314
2015,8,9,19,1330,1299,2569,1270
2015,8,9,20,1375,1330,2563,1233
2015,8,9,21,1400,1354,2586,1232
2015,8,9,22,1445,1386,2594,1208
2015,8,9,23,1460,1416,2631,1215
2015,8,10,0,1470,1446,2631,1185
2015,8,10,1,1455,1443,2623,1180
2015,8,10,2,1415,1413,2602,1189
2015,8,10,3,1395,1391,2565,1174
2015,8,10,4,1360,1383,2621,1238
2015,8,10,5,1275,1286,2629,1343
2015,8,10,6,1175,1188,2604,1416
2015,8,10,7,1135,1122,2587,1465
2015,8,10,8,1065,1070,2545,1475
2015,8,10,9,1055,1043,2540,1497
2015,8,10,10,1045,1044,2562,1518
2015,8,10,11,1050,1035,2550,1515
2015,8,10,12,1085,1070,2567,1497
2015,8,10,13,1145,1145,2570,1425
2015,8,10,14,1240,1223,2522,1299
2015,8,10,15,1310,1301,2550,1249
2015,8,10,16,1345,1343,2570,1227
2015,8,10,17,1395,1380,2576,1196
2015,8,10,18,1425,1428,2599,1171
2015,8,10,19,1485,1488,2621,1133
2015,8,10,20,1565,1531,2627,1096
2015,8,10,21,1580,1552,2598,1046
2015,8,10,22,1595,1594,2587,993
2015,8,10,23,1585,1619,2596,977
2015,8,11,0,1575,1599,2615,1016
2015,8,11,1,1550,1528,2576,1048
2015,8,11,2,1530,1469,2569,1100
2015,8,11,3,1495,1456,2565,1109
2015,8,11,4,1450,1413,2579,1166
2015,8,11,5,1370,1320,2540,1220
2015,8,11,6,1235,1215,2568,1353
2015,8,11,7,1095,1172,2562,1390
2015,8,11,8,1055,1131,2569,1438
2015,8,11,9,1030,1117,2589,1472
2015,8,11,10,1010,1083,2411,1328
2015,8,11,11,1015,1075,2487,1412
2015,8,11,12,1045,1119,2573,1454
2015,8,11,13,1130,1187,2555,1368
2015,8,11,14,1210,1243,2106,863
2015,8,11,15,1295,1343,2222,879
2015,8,11,16,1395,1383,2248,865
2015,8,11,17,1430,1418,2262,844
2015,8,11,18,1450,1478,2268,790
2015,8,11,19,1470,1540,2323,783
2015,8,11,20,1480,1585,2332,747
2015,8,11,21,1495,1640,2331,691
2015,8,11,22,1510,1675,2315,640
2015,8,11,23,1530,1724,2302,578
2015,8,12,0,1540,1710,2292,582
2015,8,12,1,1530,1693,2263,570
2015,8,12,2,1495,1637,2238,601
2015,8,12,3,1445,1584,2226,642
2015,8,12,4,1370,1543,2258,715
2015,8,12,5,1320,1429,2255,826
2015,8,12,6,1250,1301,2241,940
2015,8,12,7,1125,1231,2245,1014
2015,8,12,8,1095,1174,2239,1065
2015,8,12,9,1065,1134,2222,1088
2015,8,12,10,1045,1131,2205,1074
2015,8,12,11,1050,1132,2207,1075
2015,8,12,12,1085,1166,2214,1048
2015,8,12,13,1175,1235,2276,1041
2015,8,12,14,1220,1290,2181,891
2015,8,12,15,1305,1356,2201,845
2015,8,12,16,1360,1384,2191,807
2015,8,12,17,1375,1442,2175,733
2015,8,12,18,1425,1491,2290,799
2015,8,12,19,1490,1501,2229,728
2015,8,12,20,1535,1543,2320,777
2015,8,12,21,1550,1584,2312,728
2015,8,12,22,1570,1593,2300,707
2015,8,12,23,1595,1611,2245,634
2015,8,13,0,1595,1605,2240,635
2015,8,13,1,1545,1596,2210,614
2015,8,13,2,1490,1549,2193,644
2015,8,13,3,1450,1510,2202,692
2015,8,13,4,1385,1476,2236,760
2015,8,13,5,1250,1364,2276,912
2015,8,13,6,1175,1266,2298,1032
2015,8,13,7,1180,1201,2300,1099
2015,8,13,8,1155,1142,2256,1114
2015,8,13,9,1105,1108,2206,1098
2015,8,13,10,1090,1093,2093,1000
2015,8,13,11,1095,1088,2054,966
2015,8,13,12,1135,1126,2125,999
2015,8,13,13,1205,1216,2305,1089
2015,8,13,14,1270,1282,2273,991
2015,8,13,15,1350,1355,2226,871
2015,8,13,16,1410,1413,2345,932
2015,8,13,17,1445,1441,2364,923
2015,8,13,18,1475,1534,2374,840
2015,8,13,19,1520,1573,2386,813
2015,8,13,20,1560,1633,2368,735
2015,8,13,21,1595,1681,2395,714
2015,8,13,22,1630,1724,2402,678
2015,8,13,23,1650,1763,2422,659
2015,8,14,0,1650,1729,2405,676
2015,8,14,1,1640,1688,2332,644
2015,8,14,2,1610,1655,2352,697
2015,8,14,3,1565,1602,2340,738
2015,8,14,4,1515,1570,2372,802
2015,8,14,5,1395,1446,2344,898
2015,8,14,6,1280,1327,2380,1053
2015,8,14,7,1140,1254,2503,1249
2015,8,14,8,1125,1191,2503,1312
2015,8,14,9,1085,1154,2427,1273
2015,8,14,10,1065,1132,2350,1218
2015,8,14,11,1055,1141,2390,1249
2015,8,14,12,1095,1179,2346,1167
2015,8,14,13,1205,1239,2508,1269
2015,8,14,14,1270,1319,2515,1196
2015,8,14,15,1320,1395,2599,1204
2015,8,14,16,1365,1446,2620,1174
2015,8,14,17,1425,1506,2485,979
2015,8,14,18,1465,1554,2366,812
2015,8,14,19,1485,1589,2504,915
2015,8,14,20,1500,1645,2625,980
2015,8,14,21,1535,1698,2673,975
2015,8,14,22,1545,1704,2710,1006
2015,8,14,23,1545,1707,2689,982
2015,8,15,0,1540,1645,2675,1030
2015,8,15,1,1530,1602,2681,1079
2015,8,15,2,1495,1552,2712,1160
2015,8,15,3,1465,1492,2571,1079
2015,8,15,4,1435,1470,2550,1080
2015,8,15,5,1340,1374,2516,1142
2015,8,15,6,1215,1304,2563,1259
2015,8,15,7,1095,1226,2443,1217
2015,8,15,8,1070,1167,2301,1134
2015,8,15,9,1050,1141,2149,1008
2015,8,15,10,1015,1120,2049,929
2015,8,15,11,1000,1118,2084,966
2015,8,15,12,1020,1131,2177,1046
2015,8,15,13,1055,1148,2189,1041
2015,8,15,14,1085,1183,1987,804
2015,8,15,15,1145,1250,1891,641
2015,8,15,16,1205,1350,2382,1032
2015,8,15,17,1240,1416,2639,1223
2015,8,15,18,1280,1462,2823,1361
2015,8,15,19,1325,1470,2815,1345
2015,8,15,20,1355,1475,2781,1306
2015,8,15,21,1375,1456,2755,1299
2015,8,15,22,1400,1472,2743,1271
2015,8,15,23,1420,1468,2753,1285
2015,8,16,0,1415,1474,2760,1286
2015,8,16,1,1390,1437,2777,1340
2015,8,16,2,1375,1387,2775,1388
2015,8,16,3,1345,1363,2757,1394
2015,8,16,4,1315,1348,2571,1223
2015,8,16,5,1230,1269,2475,1206
2015,8,16,6,1135,1205,2495,1290
2015,8,16,7,1075,1149,2581,1432
2015,8,16,8,1045,1103,2560,1457
2015,8,16,9,1020,1069,2302,1233
2015,8,16,10,1000,1038,2050,1012
2015,8,16,11,995,1040,1985,945
2015,8,16,12,1015,1050,1994,944
2015,8,16,13,1010,1051,2052,1001
2015,8,16,14,1030,1088,1981,893
2015,8,16,15,1085,1136,2092,956
2015,8,16,16,1145,1207,2509,1302
2015,8,16,17,1160,1238,2604,1366
2015,8,16,18,1215,1268,2617,1349
2015,8,16,19,1250,1276,2641,1365
2015,8,16,20,1295,1286,2667,1381
2015,8,16,21,1330,1306,2679,1373
2015,8,16,22,1365,1333,2688,1355
2015,8,16,23,1395,1331,2689,1358
2015,8,17,0,1400,1347,2670,1323
2015,8,17,1,1385,1354,2714,1360
2015,8,17,2,1355,1321,2694,1373
2015,8,17,3,1325,1324,2705,1381
2015,8,17,4,1285,1317,2728,1411
2015,8,17,5,1200,1232,2690,1458
2015,8,17,6,1090,1149,2699,1550
2015,8,17,7,1095,1093,2693,1600
2015,8,17,8,1065,1067,2690,1623
2015,8,17,9,1035,1033,2596,1563
2015,8,17,10,1025,1028,2599,1571
2015,8,17,11,1020,1046,2602,1556
2015,8,17,12,1060,1082,2666,1584
2015,8,17,13,1115,1162,2662,1500
2015,8,17,14,1160,1229,2628,1399
2015,8,17,15,1225,1271,2623,1352
2015,8,17,16,1280,1294,2629,1335
2015,8,17,17,1310,1314,2625,1311
2015,8,17,18,1365,1315,2619,1304
2015,8,17,19,1415,1325,2652,1327
2015,8,17,20,1470,1341,2695,1354
2015,8,17,21,1505,1350,2770,1420
2015,8,17,22,1535,1358,2717,1359
2015,8,17,23,1560,1351,2662,1311
2015,8,18,0,1545,1339,2660,1321
2015,8,18,1,1500,1325,2683,1358
2015,8,18,2,1455,1286,2673,1387
2015,8,18,3,1425,1295,2656,1361
2015,8,18,4,1370,1298,2705,1407
2015,8,18,5,1290,1208,2689,1481
2015,8,18,6,1175,1131,2679,1548
2015,8,18,7,1045,1077,2663,1586
2015,8,18,8,1015,1062,2647,1585
2015,8,18,9,1005,1028,2488,1460
2015,8,18,10,995,1017,2413,1396
2015,8,18,11,1005,1023,2255,1232
2015,8,18,12,1035,1063,2236,1173
2015,8,18,13,1125,1147,2427,1280
2015,8,18,14,1195,1194,2369,1175
2015,8,18,15,1240,1210,2360,1150
2015,8,18,16,1255,1251,2449,1198
2015,8,18,17,1275,1267,2578,1311
2015,8,18,18,1295,1295,2586,1291
2015,8,18,19,1305,1301,2725,1424
2015,8,18,20,1315,1296,2673,1377
2015,8,18,21,1335,1300,2662,1362
2015,8,18,22,1340,1301,2665,1364
2015,8,18,23,1340,1325,2665,1340
2015,8,19,0,1350,1318,2719,1401
2015,8,19,1,1345,1308,2712,1404
2015,8,19,2,1310,1286,2709,1423
2015,8,19,3,1295,1307,2653,1346
2015,8,19,4,1240,1298,2699,1401
2015,8,19,5,1095,1199,2677,1478
2015,8,19,6,1080,1124,2668,1544
2015,8,19,7,1030,1061,2633,1572
2015,8,19,8,1015,1044,2522,1478
2015,8,19,9,990,1026,2602,1576
2015,8,19,10,985,1024,2643,1619
2015,8,19,11,990,1047,2517,1470
2015,8,19,12,1045,1086,2601,1515
2015,8,19,13,1120,1158,2625,1467
2015,8,19,14,1170,1213,2536,1323
2015,8,19,15,1245,1254,2695,1441
2015,8,19,16,1255,1280,2718,1438
2015,8,19,17,1290,1302,2709,1407
2015,8,19,18,1305,1321,2687,1366
2015,8,19,19,1315,1329,2690,1361
2015,8,19,20,1355,1355,2710,1355
2015,8,19,21,1375,1368,2732,1364
2015,8,19,22,1390,1387,2733,1346
2015,8,19,23,1405,1400,2721,1321
2015,8,20,0,1390,1405,2736,1331
2015,8,20,1,1375,1391,2779,1388
2015,8,20,2,1305,1369,2723,1354
2015,8,20,3,1285,1363,2706,1343
2015,8,20,4,1255,1344,2548,1204
2015,8,20,5,1175,1248,2514,1266
2015,8,20,6,1100,1154,2556,1402
2015,8,20,7,1030,1084,2461,1377
2015,8,20,8,1015,1065,2388,1323
2015,8,20,9,1005,1033,1991,958
2015,8,20,10,995,1010,2050,1040
2015,8,20,11,995,1018,1992,974
2015,8,20,12,1045,1063,2148,1085
2015,8,20,13,1140,1150,2474,1324
2015,8,20,14,1195,1201,2391,1190
2015,8,20,15,1210,1251,2431,1180
2015,8,20,16,1255,1284,2416,1132
2015,8,20,17,1295,1336,2660,1324
2015,8,20,18,1315,1347,2606,1259
2015,8,20,19,1355,1373,2583,1210
2015,8,20,20,1380,1396,2507,1111
2015,8,20,21,1405,1429,2527,1098
2015,8,20,22,1435,1455,2583,1128
2015,8,20,23,1450,1471,2598,1127
2015,8,21,0,1445,1452,2531,1079
2015,8,21,1,1420,1443,2570,1127
2015,8,21,2,1375,1395,2526,1131
2015,8,21,3,1370,1397,2530,1133
2015,8,21,4,1315,1367,2482,1115
2015,8,21,5,1245,1272,2452,1180
2015,8,21,6,1160,1181,2454,1273
2015,8,21,7,1050,1101,2451,1350
2015,8,21,8,1035,1067,2194,1127
2015,8,21,9,1015,1049,2110,1061
2015,8,21,10,985,1029,2071,1042
2015,8,21,11,1000,1034,1954,920
2015,8,21,12,1050,1072,2051,979
2015,8,21,13,1130,1144,2219,1075
2015,8,21,14,1175,1192,2205,1013
2015,8,21,15,1215,1233,2189,956
2015,8,21,16,1240,1283,2282,999
2015,8,21,17,1275,1317,2305,988
2015,8,21,18,1295,1340,2319,979
2015,8,21,19,1300,1349,2285,936
2015,8,21,20,1325,1389,2245,856
2015,8,21,21,1370,1427,2353,926
2015,8,21,22,1380,1461,2431,970
2015,8,21,23,1400,1445,2214,769
2015,8,22,0,1385,1404,2018,614
2015,8,22,1,1330,1377,2126,749
2015,8,22,2,1315,1351,2209,858
2015,8,22,3,1305,1345,2468,1123
2015,8,22,4,1285,1333,2541,1208
2015,8,22,5,1205,1252,2643,1391
2015,8,22,6,1120,1167,2707,1540
2015,8,22,7,1060,1138,2683,1545
2015,8,22,8,1035,1098,2721,1623
2015,8,22,9,1025,1095,2744,1649
2015,8,22,10,1000,1067,2736,1669
2015,8,22,11,1015,1073,2779,1706
2015,8,22,12,1035,1077,2787,1710
2015,8,22,13,1030,1096,2766,1670
2015,8,22,14,1060,1126,2602,1476
2015,8,22,15,1095,1178,2712,1534
2015,8,22,16,1115,1215,2721,1506
2015,8,22,17,1175,1231,2722,1491
2015,8,22,18,1205,1217,2740,1523
2015,8,22,19,1215,1218,2793,1575
2015,8,22,20,1220,1216,2784,1568
2015,8,22,21,1225,1216,2765,1549
2015,8,22,22,1225,1228,2740,1512
2015,8,22,23,1230,1235,2743,1508
2015,8,23,0,1220,1235,2714,1479
2015,8,23,1,1200,1235,2701,1466
2015,8,23,2,1185,1226,2711,1485
2015,8,23,3,1175,1227,2680,1453
2015,8,23,4,1115,1234,2667,1433
2015,8,23,5,1085,1173,2672,1499
2015,8,23,6,1035,1115,2632,1517
2015,8,23,7,1045,1060,2630,1570
2015,8,23,8,1020,1037,2611,1574
2015,8,23,9,995,1017,2474,1457
2015,8,23,10,970,992,2339,1347
2015,8,23,11,980,998,2350,1352
2015,8,23,12,1000,1006,2357,1351
2015,8,23,13,1045,1022,2349,1327
2015,8,23,14,1105,1047,2072,1025
2015,8,23,15,1155,1087,2162,1075
2015,8,23,16,1200,1148,2471,1323
2015,8,23,17,1235,1194,2643,1449
2015,8,23,18,1260,1202,2603,1401
2015,8,23,19,1285,1214,2626,1412
2015,8,23,20,1305,1225,2607,1382
2015,8,23,21,1330,1241,2590,1349
2015,8,23,22,1355,1259,2645,1386
2015,8,23,23,1375,1291,2672,1381
2015,8,24,0,1380,1309,2678,1369
2015,8,24,1,1375,1319,2688,1369
2015,8,24,2,1340,1298,2677,1379
2015,8,24,3,1335,1311,2685,1374
2015,8,24,4,1295,1294,2658,1364
2015,8,24,5,1230,1212,2640,1428
2015,8,24,6,1130,1113,2583,1470
2015,8,24,7,1050,1063,2648,1585
2015,8,24,8,1020,1032,2667,1635
2015,8,24,9,995,1028,2598,1570
2015,8,24,10,985,998,2436,1438
2015,8,24,11,1005,1009,2331,1322
2015,8,24,12,1035,1062,2380,1318
2015,8,24,13,1135,1135,2419,1284
2015,8,24,14,1195,1223,2598,1375
2015,8,24,15,1270,1243,2545,1302
2015,8,24,16,1315,1275,2501,1226
2015,8,24,17,1355,1311,2486,1175
2015,8,24,18,1395,1336,2547,1211
2015,8,24,19,1435,1351,2569,1218
2015,8,24,20,1475,1386,2583,1197
2015,8,24,21,1490,1398,2560,1162
2015,8,24,22,1515,1441,2590,1149
2015,8,24,23,1540,1464,2619,1155
2015,8,25,0,1515,1472,2623,1151
2015,8,25,1,1475,1465,2626,1161
2015,8,25,2,1430,1429,2575,1146
2015,8,25,3,1425,1414,2565,1151
2015,8,25,4,1370,1373,2582,1209
2015,8,25,5,1310,1256,2532,1276
2015,8,25,6,1205,1152,2519,1367
2015,8,25,7,1035,1085,2504,1419
2015,8,25,8,1010,1041,2339,1298
2015,8,25,9,990,1021,2257,1236
2015,8,25,10,980,1012,2317,1305
2015,8,25,11,990,1018,2322,1304
2015,8,25,12,1040,1069,2327,1258
2015,8,25,13,1105,1165,2427,1262
2015,8,25,14,1200,1224,2421,1197
2015,8,25,15,1300,1270,2536,1266
2015,8,25,16,1360,1305,2549,1244
2015,8,25,17,1390,1331,2529,1198
2015,8,25,18,1410,1379,2563,1184
2015,8,25,19,1435,1401,2579,1178
2015,8,25,20,1450,1431,2592,1161
2015,8,25,21,1485,1457,2594,1137
2015,8,25,22,1495,1508,2616,1108
2015,8,25,23,1520,1543,2611,1068
2015,8,26,0,1515,1555,2617,1062
2015,8,26,1,1485,1534,2614,1080
2015,8,26,2,1465,1507,2614,1107
2015,8,26,3,1405,1490,2636,1146
2015,8,26,4,1395,1441,2622,1181
2015,8,26,5,1315,1309,2553,1244
2015,8,26,6,1215,1202,2517,1315
2015,8,26,7,1050,1136,2550,1414
2015,8,26,8,1005,1100,2548,1448
2015,8,26,9,995,1081,2513,1432
2015,8,26,10,990,1064,2494,1430
2015,8,26,11,990,1067,2456,1389
2015,8,26,12,1050,1108,2475,1367
2015,8,26,13,1140,1212,2559,1347
2015,8,26,14,1200,1262,2552,1290
2015,8,26,15,1235,1313,2600,1287
2015,8,26,16,1270,1321,2647,1326
2015,8,26,17,1310,1376,2709,1333
2015,8,26,18,1340,1413,2739,1326
2015,8,26,19,1385,1438,2695,1257
2015,8,26,20,1400,1484,2725,1241
2015,8,26,21,1435,1516,2722,1206
2015,8,26,22,1465,1551,2678,1127
2015,8,26,23,1485,1569,2712,1143
2015,8,27,0,1510,1554,2669,1115
2015,8,27,1,1495,1530,2663,1133
2015,8,27,2,1420,1510,2694,1184
2015,8,27,3,1385,1508,2722,1214
2015,8,27,4,1350,1444,2712,1268
2015,8,27,5,1230,1327,2652,1325
2015,8,27,6,1135,1216,2644,1428
2015,8,27,7,1090,1164,2668,1504
2015,8,27,8,1065,1117,2552,1435
2015,8,27,9,1045,1083,2420,1337
2015,8,27,10,1020,1098,2472,1374
2015,8,27,11,1035,1084,2387,1303
2015,8,27,12,1070,1127,2379,1252
2015,8,27,13,1170,1243,2592,1349
2015,8,27,14,1240,1304,2619,1315
2015,8,27,15,1295,1312,2552,1240
2015,8,27,16,1320,1374,2595,1221
2015,8,27,17,1345,1332,2600,1268
2015,8,27,18,1370,1418,2645,1227
2015,8,27,19,1410,1437,2617,1180
2015,8,27,20,1445,1468,2679,1211
2015,8,27,21,1480,1465,2701,1236
2015,8,27,22,1510,1484,2780,1296
2015,8,27,23,1515,1531,2765,1234
2015,8,28,0,1510,1482,2748,1266
2015,8,28,1,1490,1465,2722,1257
2015,8,28,2,1475,1447,2733,1286
2015,8,28,3,1450,1449,2735,1286
2015,8,28,4,1395,1399,2722,1323
2015,8,28,5,1280,1286,2690,1404
2015,8,28,6,1165,1198,2713,1515
2015,8,28,7,1120,1151,2723,1572
2015,8,28,8,1085,1121,2595,1474
2015,8,28,9,1045,1099,2541,1442
2015,8,28,10,1060,1067,2429,1362
2015,8,28,11,1055,1072,2460,1388
2015,8,28,12,1110,1124,2499,1375
2015,8,28,13,1200,1196,2500,1304
2015,8,28,14,1275,1262,2548,1286
2015,8,28,15,1285,1296,2646,1350
2015,8,28,16,1295,1319,2648,1329
2015,8,28,17,1340,1364,2653,1289
2015,8,28,18,1385,1386,2630,1244
2015,8,28,19,1410,1405,2663,1258
2015,8,28,20,1445,1444,2696,1252
2015,8,28,21,1475,1476,2710,1234
2015,8,28,22,1520,1500,2697,1197
2015,8,28,23,1530,1509,2714,1205
2015,8,29,0,1515,1487,2707,1220
2015,8,29,1,1495,1477,2705,1228
2015,8,29,2,1445,1451,2701,1250
2015,8,29,3,1440,1444,2660,1216
2015,8,29,4,1400,1376,2625,1249
2015,8,29,5,1295,1305,2629,1324
2015,8,29,6,1170,1188,2459,1271
2015,8,29,7,1100,1140,2136,996
2015,8,29,8,1055,1102,2001,899
2015,8,29,9,1030,1111,1951,840
2015,8,29,10,1010,1080,1975,895
2015,8,29,11,1035,1065,1955,890
2015,8,29,12,1095,1092,1967,875
2015,8,29,13,1130,1121,1958,837
2015,8,29,14,1170,1148,1847,699
2015,8,29,15,1230,1230,1853,623
2015,8,29,16,1290,1257,1862,605
2015,8,29,17,1310,1279,1841,562
2015,8,29,18,1375,1329,1873,544
2015,8,29,19,1405,1339,1867,528
2015,8,29,20,1415,1381,1893,512
2015,8,29,21,1425,1368,1624,256
2015,8,29,22,1435,1395,1653,258
2015,8,29,23,1450,1425,1733,308
2015,8,30,0,1415,1424,1980,556
2015,8,30,1,1405,1403,2009,606
2015,8,30,2,1355,1383,2028,645
2015,8,30,3,1315,1390,2043,653
2015,8,30,4,1295,1374,2056,682
2015,8,30,5,1235,1296,1921,625
2015,8,30,6,1180,1215,1970,755
2015,8,30,7,1070,1149,1927,778
2015,8,30,8,1040,1113,1878,765
2015,8,30,9,1010,1073,1781,708
2015,8,30,10,1000,1063,1660,597
2015,8,30,11,1005,1104,1651,547
2015,8,30,12,1030,1099,1669,570
2015,8,30,13,1075,1117,1676,559
2015,8,30,14,1120,1149,1749,600
2015,8,30,15,1145,1209,2031,822
2015,8,30,16,1200,1252,2019,767
2015,8,30,17,1210,1287,2058,771
2015,8,30,18,1255,1336,2103,767
2015,8,30,19,1260,1366,2056,690
2015,8,30,20,1280,1391,2057,666
2015,8,30,21,1285,1411,1987,576
2015,8,30,22,1310,1431,2027,596
2015,8,30,23,1325,1424,2019,595
2015,8,31,0,1310,1435,1992,557
2015,8,31,1,1315,1426,1944,518
2015,8,31,2,1295,1399,1963,564
2015,8,31,3,1305,1414,2074,660
2015,8,31,4,1265,1348,2220,872
2015,8,31,5,1195,1241,2228,987
2015,8,31,6,1105,1155,2476,1321
2015,8,31,7,1045,1098,2340,1242
2015,8,31,8,1010,1044,2085,1041
2015,8,31,9,985,1031,2031,1000
2015,8,31,10,985,1023,2096,1073
2015,8,31,11,1005,1020,2238,1218
2015,8,31,12,1035,1075,2319,1244
2015,8,31,13,1125,1174,2437,1263
2015,8,31,14,1190,1277,2704,1427
2015,8,31,15,1245,1289,2736,1447
2015,8,31,16,1255,1323,2769,1446
2015,8,31,17,1275,1343,2782,1439
2015,8,31,18,1285,1362,2836,1474
2015,8,31,19,1295,1376,2848,1472
2015,8,31,20,1310,1374,2788,1414
2015,8,31,21,1315,1397,2776,1379
2015,8,31,22,1325,1418,2753,1335
2015,8,31,23,1350,1425,2751,1326
2015,9,1,0,1335,1428,2782,1354
2015,9,1,1,1315,1402,2725,1323
2015,9,1,2,1275,1376,2698,1322
2015,9,1,3,1260,1385,2678,1293
2015,9,1,4,1200,1338,2666,1328
2015,9,1,5,1160,1224,2595,1371
2015,9,1,6,1070,1128,2623,1495
2015,9,1,7,1065,1052,2180,1128
2015,9,1,8,1030,1022,2100,1078
2015,9,1,9,1020,1009,2102,1093
2015,9,1,10,1005,1003,1997,994
2015,9,1,11,1010,1024,2025,1001
2015,9,1,12,1055,1069,2174,1105
2015,9,1,13,1150,1178,2269,1091
2015,9,1,14,1250,1245,2548,1303
2015,9,1,15,1295,1281,2694,1413
2015,9,1,16,1345,1302,2730,1428
2015,9,1,17,1370,1336,2764,1428
2015,9,1,18,1400,1359,2765,1406
2015,9,1,19,1420,1381,2771,1390
2015,9,1,20,1440,1442,2823,1381
2015,9,1,21,1465,1461,2798,1337
2015,9,1,22,1495,1498,2819,1321
2015,9,1,23,1510,1520,2775,1255
2015,9,2,0,1515,1522,2788,1266
2015,9,2,1,1505,1508,2740,1232
2015,9,2,2,1470,1476,2716,1240
2015,9,2,3,1450,1488,2716,1228
2015,9,2,4,1395,1394,2658,1264
2015,9,2,5,1295,1284,2649,1365
2015,9,2,6,1140,1182,2625,1443
2015,9,2,7,1035,1108,2618,1510
2015,9,2,8,1000,1071,2490,1419
2015,9,2,9,985,1048,2426,1378
2015,9,2,10,980,1034,2416,1382
2015,9,2,11,995,1069,2508,1439
2015,9,2,12,1030,1103,2539,1436
2015,9,2,13,1150,1209,2535,1326
2015,9,2,14,1225,1261,2387,1126
2015,9,2,15,1255,1297,2521,1224
2015,9,2,16,1295,1325,2576,1251
2015,9,2,17,1310,1363,2597,1234
2015,9,2,18,1325,1396,2624,1228
2015,9,2,19,1350,1442,2699,1257
2015,9,2,20,1355,1458,2711,1253
2015,9,2,21,1375,1473,2736,1263
2015,9,2,22,1395,1496,2755,1259
2015,9,2,23,1435,1524,2761,1237
2015,9,3,0,1450,1513,2840,1327
2015,9,3,1,1425,1492,2753,1261
2015,9,3,2,1390,1472,2737,1265
2015,9,3,3,1385,1472,2759,1287
2015,9,3,4,1320,1389,2761,1372
2015,9,3,5,1270,1283,2752,1469
2015,9,3,6,1140,1178,2742,1564
2015,9,3,7,1030,1121,2719,1598
2015,9,3,8,1000,1072,2383,1311
2015,9,3,9,990,1043,2203,1160
2015,9,3,10,985,1019,2131,1112
2015,9,3,11,990,1033,2161,1128
2015,9,3,12,1030,1079,2155,1076
2015,9,3,13,1100,1181,2249,1068
2015,9,3,14,1135,1270,2428,1158
2015,9,3,15,1155,1279,2559,1280
2015,9,3,16,1185,1295,2612,1317
2015,9,3,17,1205,1312,2740,1428
2015,9,3,18,1235,1323,2690,1367
2015,9,3,19,1255,1340,2544,1204
2015,9,3,20,1275,1321,2494,1173
2015,9,3,21,1285,1334,2584,1250
2015,9,3,22,1310,1352,2665,1313
2015,9,3,23,1335,1337,2659,1322
2015,9,4,0,1315,1329,2643,1314
2015,9,4,1,1295,1315,2654,1339
2015,9,4,2,1280,1291,2694,1403
2015,9,4,3,1265,1323,2754,1431
2015,9,4,4,1245,1264,2742,1478
2015,9,4,5,1155,1176,2692,1516
2015,9,4,6,1080,1106,2731,1625
2015,9,4,7,1060,1067,2719,1652
2015,9,4,8,1030,1044,2699,1655
2015,9,4,9,1010,1025,2721,1696
2015,9,4,10,995,1022,2723,1701
2015,9,4,11,1005,1027,2742,1715
2015,9,4,12,1045,1075,2751,1676
2015,9,4,13,1140,1173,2744,1571
2015,9,4,14,1190,1252,2744,1492
2015,9,4,15,1210,1266,2715,1449
2015,9,4,16,1240,1286,2683,1397
2015,9,4,17,1265,1297,2660,1363
2015,9,4,18,1285,1286,2653,1367
2015,9,4,19,1310,1280,2680,1400
2015,9,4,20,1325,1285,2673,1388
2015,9,4,21,1340,1263,2697,1434
2015,9,4,22,1355,1263,2732,1469
2015,9,4,23,1360,1263,2728,1465
2015,9,5,0,1355,1262,2758,1496
2015,9,5,1,1335,1227,2779,1552
2015,9,5,2,1310,1242,2799,1557
2015,9,5,3,1290,1258,2655,1397
2015,9,5,4,1235,1225,2603,1378
2015,9,5,5,1145,1160,2568,1408
2015,9,5,6,1080,1097,2525,1428
2015,9,5,7,1010,1055,2644,1589
2015,9,5,8,995,1035,2585,1550
2015,9,5,9,985,1013,2441,1428
2015,9,5,10,980,1001,2414,1413
2015,9,5,11,985,1005,2321,1316
2015,9,5,12,1015,1026,2334,1308
2015,9,5,13,1055,1065,2437,1372
2015,9,5,14,1090,1098,2457,1359
2015,9,5,15,1135,1168,1641,473
2015,9,5,16,1155,1221,1127,-94
2015,9,5,17,1170,1233,1089,-144
2015,9,5,18,1185,1237,1072,-165
2015,9,5,19,1190,1239,1067,-172
2015,9,5,20,1195,1236,1092,-144
2015,9,5,21,1195,1210,1139,-71
2015,9,5,22,1205,1182,1280,98
2015,9,5,23,1205,1199,1516,317
2015,9,6,0,1195,1206,1565,359
2015,9,6,1,1190,1205,1612,407
2015,9,6,2,1175,1218,1650,432
2015,9,6,3,1180,1222,1812,590
2015,9,6,4,1165,1184,2013,829
2015,9,6,5,1100,1121,2204,1083
2015,9,6,6,1050,1078,2373,1295
2015,9,6,7,1030,1045,2382,1337
2015,9,6,8,1010,1015,2379,1364
2015,9,6,9,990,991,2398,1407
2015,9,6,10,980,987,2525,1538
2015,9,6,11,995,999,2519,1520
2015,9,6,12,1015,1015,2558,1543
2015,9,6,13,1030,1046,2708,1662
2015,9,6,14,1050,1069,2780,1711
2015,9,6,15,1080,1135,2853,1718
2015,9,6,16,1110,1159,2862,1703
2015,9,6,17,1135,1167,2832,1665
2015,9,6,18,1155,1170,2824,1654
2015,9,6,19,1170,1193,2828,1635
2015,9,6,20,1175,1206,2840,1634
2015,9,6,21,1190,1197,2826,1629
2015,9,6,22,1210,1223,2817,1594
2015,9,6,23,1210,1223,2801,1578
2015,9,7,0,1210,1231,2819,1588
2015,9,7,1,1205,1228,2802,1574
2015,9,7,2,1195,1227,2766,1539
2015,9,7,3,1175,1237,2724,1487
2015,9,7,4,1155,1220,2735,1515
2015,9,7,5,1080,1130,2707,1577
2015,9,7,6,1030,1062,2728,1666
2015,9,7,7,1010,1015,2698,1683
2015,9,7,8,1000,989,2636,1647
2015,9,7,9,990,969,2565,1596
2015,9,7,10,980,965,2573,1608
2015,9,7,11,990,979,2600,1621
2015,9,7,12,1035,1001,2619,1618
2015,9,7,13,1065,1028,2674,1646
2015,9,7,14,1105,1051,2682,1631
2015,9,7,15,1120,1117,2740,1623
2015,9,7,16,1140,1176,2836,1660
2015,9,7,17,1155,1190,2840,1650
2015,9,7,18,1175,1210,2843,1633
2015,9,7,19,1185,1212,2803,1591
2015,9,7,20,1195,1212,2802,1590
2015,9,7,21,1205,1211,2811,1600
2015,9,7,22,1225,1243,2840,1597
2015,9,7,23,1225,1274,2852,1578
2015,9,8,0,1230,1286,2871,1585
2015,9,8,1,1210,1269,2802,1533
2015,9,8,2,1190,1272,2790,1518
2015,9,8,3,1185,1313,2765,1452
2015,9,8,4,1150,1250,2744,1494
2015,9,8,5,1060,1132,2701,1569
2015,9,8,6,1030,1071,2631,1560
2015,9,8,7,1015,1033,2643,1610
2015,9,8,8,1005,1016,2522,1506
2015,9,8,9,1000,1000,2403,1403
2015,9,8,10,985,997,2388,1391
2015,9,8,11,995,1016,2534,1518
2015,9,8,12,1020,1089,2592,1503
2015,9,8,13,1120,1183,2673,1490
2015,9,8,14,1185,1253,2745,1492
2015,9,8,15,1200,1266,2715,1449
2015,9,8,16,1210,1278,2755,1477
2015,9,8,17,1230,1292,2786,1494
2015,9,8,18,1240,1295,2801,1506
2015,9,8,19,1255,1302,2815,1513
2015,9,8,20,1265,1338,2843,1505
2015,9,8,21,1270,1317,2834,1517
2015,9,8,22,1280,1328,2852,1524
2015,9,8,23,1285,1333,2844,1511
2015,9,9,0,1265,1326,2772,1446
2015,9,9,1,1255,1316,2734,1418
2015,9,9,2,1245,1319,2806,1487
2015,9,9,3,1255,1333,2789,1456
2015,9,9,4,1170,1282,2777,1495
2015,9,9,5,1105,1165,2690,1525
2015,9,9,6,1015,1090,2710,1620
2015,9,9,7,1040,1061,2701,1640
2015,9,9,8,1010,1048,2735,1687
2015,9,9,9,1000,1022,2567,1545
2015,9,9,10,975,1020,2549,1529
2015,9,9,11,990,1039,2565,1526
2015,9,9,12,1030,1098,2640,1542
2015,9,9,13,1140,1196,2814,1618
2015,9,9,14,1220,1256,2772,1516
2015,9,9,15,1250,1266,2751,1485
2015,9,9,16,1260,1277,2721,1444
2015,9,9,17,1285,1283,2781,1498
2015,9,9,18,1320,1294,2796,1502
2015,9,9,19,1345,1290,2816,1526
2015,9,9,20,1360,1307,2861,1554
2015,9,9,21,1370,1322,2847,1525
2015,9,9,22,1395,1327,2830,1503
2015,9,9,23,1405,1348,2826,1478
2015,9,10,0,1390,1327,2812,1485
2015,9,10,1,1370,1342,2821,1479
2015,9,10,2,1350,1341,2801,1460
2015,9,10,3,1360,1356,2761,1405
2015,9,10,4,1220,1300,2757,1457
2015,9,10,5,1195,1214,2712,1498
2015,9,10,6,1100,1127,2692,1565
2015,9,10,7,1035,1063,2669,1606
2015,9,10,8,1005,1038,2509,1471
2015,9,10,9,980,1034,2481,1447
2015,9,10,10,975,1038,2405,1367
2015,9,10,11,980,1051,2359,1308
2015,9,10,12,1045,1118,2358,1240
2015,9,10,13,1150,1220,2398,1178
2015,9,10,14,1240,1261,2361,1100
2015,9,10,15,1250,1279,2353,1074
2015,9,10,16,1275,1297,2349,1052
2015,9,10,17,1265,1315,2367,1052
2015,9,10,18,1295,1320,2400,1080
2015,9,10,19,1305,1327,2399,1072
2015,9,10,20,1325,1348,2417,1069
2015,9,10,21,1310,1379,2436,1057
2015,9,10,22,1325,1385,2444,1059
2015,9,10,23,1335,1370,2432,1062
2015,9,11,0,1315,1376,2421,1045
2015,9,11,1,1305,1354,2398,1044
2015,9,11,2,1285,1349,2450,1101
2015,9,11,3,1305,1379,2476,1097
2015,9,11,4,1240,1316,2450,1134
2015,9,11,5,1160,1223,2402,1179
2015,9,11,6,1070,1129,2370,1241
2015,9,11,7,1035,1069,2355,1286
2015,9,11,8,1020,1040,2335,1295
2015,9,11,9,1000,1014,2328,1314
2015,9,11,10,1005,1018,2346,1328
2015,9,11,11,1020,1025,2341,1316
2015,9,11,12,1075,1070,2329,1259
2015,9,11,13,1165,1176,2369,1193
2015,9,11,14,1245,1231,2380,1149
2015,9,11,15,1265,1251,2399,1148
2015,9,11,16,1280,1274,2394,1120
2015,9,11,17,1290,1286,2381,1095
2015,9,11,18,1295,1294,2383,1089
2015,9,11,19,1295,1306,2393,1087
2015,9,11,20,1300,1325,2410,1085
2015,9,11,21,1315,1367,2423,1056
2015,9,11,22,1310,1360,2415,1055
2015,9,11,23,1320,1384,2411,1027
2015,9,12,0,1320,1392,2406,1014
2015,9,12,1,1325,1347,2362,1015
2015,9,12,2,1315,1312,2343,1031
2015,9,12,3,1325,1320,2349,1029
2015,9,12,4,1280,1295,2378,1083
2015,9,12,5,1200,1195,2373,1178
2015,9,12,6,1100,1127,2405,1278
2015,9,12,7,1065,1090,2448,1358
2015,9,12,8,1040,1039,2481,1442
2015,9,12,9,1025,1011,2491,1480
2015,9,12,10,1010,1015,2507,1492
2015,9,12,11,1015,1026,2599,1573
2015,9,12,12,1040,1047,2652,1605
2015,9,12,13,1125,1093,2673,1580
2015,9,12,14,1210,1134,2673,1539
2015,9,12,15,1295,1169,2676,1507
2015,9,12,16,1345,1207,2683,1476
2015,9,12,17,1375,1227,2703,1476
2015,9,12,18,1380,1252,2723,1471
2015,9,12,19,1385,1287,2736,1449
2015,9,12,20,1390,1319,2740,1421
2015,9,12,21,1380,1351,2746,1395
2015,9,12,22,1380,1371,2750,1379
2015,9,12,23,1380,1415,2758,1343
2015,9,13,0,1385,1436,2766,1330
2015,9,13,1,1365,1420,2710,1290
2015,9,13,2,1380,1380,2698,1318
2015,9,13,3,1375,1370,2670,1300
2015,9,13,4,1320,1306,2681,1375
2015,9,13,5,1275,1223,2697,1474
2015,9,13,6,1210,1145,2659,1514
2015,9,13,7,1055,1082,2509,1427
2015,9,13,8,1025,1079,2510,1431
2015,9,13,9,1010,1060,2571,1511
2015,9,13,10,995,1043,2611,1568
2015,9,13,11,1015,1037,2504,1467
2015,9,13,12,1020,1052,2527,1475
2015,9,13,13,1080,1082,2541,1459
2015,9,13,14,1130,1083,2390,1307
2015,9,13,15,1200,1137,2512,1375
2015,9,13,16,1245,1189,2585,1396
2015,9,13,17,1270,1237,2730,1493
2015,9,13,18,1275,1278,2829,1551
2015,9,13,19,1300,1307,2794,1487
2015,9,13,20,1315,1339,2815,1476
2015,9,13,21,1320,1369,2805,1436
2015,9,13,22,1355,1403,2773,1370
2015,9,13,23,1375,1428,2769,1341
2015,9,14,0,1375,1438,2705,1267
2015,9,14,1,1365,1422,2732,1310
2015,9,14,2,1350,1420,2751,1331
2015,9,14,3,1375,1434,2769,1335
2015,9,14,4,1315,1320,2706,1386
2015,9,14,5,1235,1228,2639,1411
2015,9,14,6,1150,1148,2627,1479
2015,9,14,7,1030,1081,2477,1396
2015,9,14,8,1005,1045,2441,1396
2015,9,14,9,995,1023,2399,1376
2015,9,14,10,990,1009,2401,1392
2015,9,14,11,1000,1035,2562,1527
2015,9,14,12,1060,1077,2683,1606
2015,9,14,13,1155,1200,2687,1487
2015,9,14,14,1230,1268,2675,1407
2015,9,14,15,1250,1266,2668,1402
2015,9,14,16,1270,1295,2710,1415
2015,9,14,17,1280,1329,2681,1352
2015,9,14,18,1280,1339,2696,1357
2015,9,14,19,1295,1357,2713,1356
2015,9,14,20,1310,1387,2729,1342
2015,9,14,21,1310,1425,2722,1297
2015,9,14,22,1325,1452,2725,1273
2015,9,14,23,1330,1469,2741,1272
2015,9,15,0,1340,1450,2727,1277
2015,9,15,1,1315,1429,2755,1326
2015,9,15,2,1300,1419,2745,1326
2015,9,15,3,1305,1404,2744,1340
2015,9,15,4,1245,1328,2715,1387
2015,9,15,5,1165,1225,2656,1431
2015,9,15,6,1065,1139,2669,1530
2015,9,15,7,1015,1090,2637,1547
2015,9,15,8,990,1053,2488,1435
2015,9,15,9,975,1019,2452,1433
2015,9,15,10,970,1011,2404,1393
2015,9,15,11,985,1016,2500,1484
2015,9,15,12,1040,1063,2519,1456
2015,9,15,13,1120,1191,2663,1472
2015,9,15,14,1190,1290,2677,1387
2015,9,15,15,1200,1278,2689,1411
2015,9,15,16,1220,1282,2750,1468
2015,9,15,17,1230,1279,2730,1451
2015,9,15,18,1235,1277,2744,1467
2015,9,15,19,1245,1264,2722,1458
2015,9,15,20,1275,1263,2745,1482
2015,9,15,21,1265,1264,2765,1501
2015,9,15,22,1290,1259,2719,1460
2015,9,15,23,1300,1260,2736,1476
2015,9,16,0,1300,1249,2755,1506
2015,9,16,1,1280,1247,2721,1474
2015,9,16,2,1265,1275,2685,1410
2015,9,16,3,1280,1288,2683,1395
2015,9,16,4,1240,1235,2639,1404
2015,9,16,5,1130,1141,2622,1481
2015,9,16,6,1035,1077,2597,1520
2015,9,16,7,1040,1040,2546,1506
2015,9,16,8,1020,1016,2520,1504
2015,9,16,9,990,994,2514,1520
2015,9,16,10,990,998,2528,1530
2015,9,16,11,1010,1013,2564,1551
2015,9,16,12,1055,1055,2618,1563
2015,9,16,13,1175,1186,2695,1509
2015,9,16,14,1265,1274,2702,1428
2015,9,16,15,1275,1286,2700,1414
2015,9,16,16,1290,1297,2740,1443
2015,9,16,17,1310,1279,2741,1462
2015,9,16,18,1315,1275,2730,1455
2015,9,16,19,1315,1269,2726,1457
2015,9,16,20,1325,1257,2650,1393
2015,9,16,21,1340,1252,2670,1418
2015,9,16,22,1355,1254,2698,1444
2015,9,16,23,1360,1266,2749,1483
2015,9,17,0,1350,1257,2754,1497
2015,9,17,1,1345,1246,2785,1539
2015,9,17,2,1330,1279,2777,1498
2015,9,17,3,1350,1302,2779,1477
2015,9,17,4,1295,1239,2736,1497
2015,9,17,5,1195,1149,2628,1479
2015,9,17,6,1105,1094,2649,1555
2015,9,17,7,1010,1037,2600,1563
2015,9,17,8,995,1020,2654,1634
2015,9,17,9,970,1009,2701,1692
2015,9,17,10,955,1018,2721,1703
2015,9,17,11,970,1030,2705,1675
2015,9,17,12,1020,1076,2712,1636
2015,9,17,13,1155,1180,2719,1539
2015,9,17,14,1245,1274,2755,1481
2015,9,17,15,1245,1262,2713,1451
2015,9,17,16,1250,1257,2699,1442
2015,9,17,17,1250,1261,2689,1428
2015,9,17,18,1250,1264,2676,1412
2015,9,17,19,1260,1243,2633,1390
2015,9,17,20,1260,1254,2616,1362
2015,9,17,21,1260,1242,2631,1389
2015,9,17,22,1255,1250,2678,1428
2015,9,17,23,1260,1241,2723,1482
2015,9,18,0,1255,1238,2710,1472
2015,9,18,1,1250,1229,2714,1485
2015,9,18,2,1265,1253,2703,1450
2015,9,18,3,1275,1273,2704,1431
2015,9,18,4,1235,1229,2708,1479
2015,9,18,5,1130,1134,2699,1565
2015,9,18,6,1055,1076,2652,1576
2015,9,18,7,1000,1033,2677,1644
2015,9,18,8,975,1010,2525,1515
2015,9,18,9,955,1020,2527,1507
2015,9,18,10,980,1021,2487,1466
2015,9,18,11,995,1039,2486,1447
2015,9,18,12,1030,1094,2612,1518
2015,9,18,13,1135,1219,2780,1561
2015,9,18,14,1235,1299,2785,1486
2015,9,18,15,1245,1285,2761,1476
2015,9,18,16,1255,1286,2765,1479
2015,9,18,17,1235,1292,2814,1522
2015,9,18,18,1225,1282,2814,1532
2015,9,18,19,1210,1263,2800,1537
2015,9,18,20,1205,1258,2825,1567
2015,9,18,21,1225,1261,2822,1561
2015,9,18,22,1240,1256,2765,1509
2015,9,18,23,1260,1261,2816,1555
2015,9,19,0,1255,1224,2791,1567
2015,9,19,1,1235,1228,2824,1596
2015,9,19,2,1210,1229,2764,1535
2015,9,19,3,1185,1240,2765,1525
2015,9,19,4,1155,1219,2727,1508
2015,9,19,5,1110,1160,2757,1597
2015,9,19,6,1055,1106,2719,1613
2015,9,19,7,1000,1061,2568,1507
2015,9,19,8,985,1028,2468,1440
2015,9,19,9,965,1011,2458,1447
2015,9,19,10,975,1006,2470,1464
2015,9,19,11,985,1011,2623,1612
2015,9,19,12,1015,1031,2661,1630
2015,9,19,13,1090,1064,2708,1644
2015,9,19,14,1170,1118,2745,1627
2015,9,19,15,1195,1167,2730,1563
2015,9,19,16,1215,1181,2715,1534
2015,9,19,17,1225,1206,2752,1546
2015,9,19,18,1230,1218,2765,1547
2015,9,19,19,1230,1215,2757,1542
2015,9,19,20,1235,1209,2758,1549
2015,9,19,21,1230,1219,2761,1542
2015,9,19,22,1235,1212,2769,1557
2015,9,19,23,1250,1220,2776,1556
2015,9,20,0,1260,1219,2777,1558
2015,9,20,1,1240,1213,2751,1538
2015,9,20,2,1255,1233,2735,1502
2015,9,20,3,1270,1245,2699,1454
2015,9,20,4,1210,1196,2678,1482
2015,9,20,5,1130,1131,2616,1485
2015,9,20,6,1060,1073,2607,1534
2015,9,20,7,990,1042,2631,1589
2015,9,20,8,970,1020,2690,1670
2015,9,20,9,965,1005,2662,1657
2015,9,20,10,960,991,2561,1570
2015,9,20,11,960,996,2511,1515
2015,9,20,12,975,1009,2521,1512
2015,9,20,13,1010,1044,2615,1571
2015,9,20,14,1025,1070,2700,1630
2015,9,20,15,1075,1126,2757,1631
2015,9,20,16,1105,1156,2768,1612
2015,9,20,17,1135,1181,2741,1560
2015,9,20,18,1145,1214,2739,1525
2015,9,20,19,1150,1211,2735,1524
2015,9,20,20,1155,1217,2738,1521
2015,9,20,21,1160,1231,2740,1509
2015,9,20,22,1190,1254,2754,1500
2015,9,20,23,1220,1299,2806,1507
2015,9,21,0,1220,1299,2755,1456
2015,9,21,1,1210,1290,2736,1446
2015,9,21,2,1210,1296,2695,1399
2015,9,21,3,1235,1311,2685,1374
2015,9,21,4,1200,1234,2689,1455
2015,9,21,5,1085,1160,2680,1520
2015,9,21,6,1015,1091,2722,1631
2015,9,21,7,1035,1046,2605,1559
2015,9,21,8,1000,1008,2547,1539
2015,9,21,9,985,995,2510,1515
2015,9,21,10,980,992,2444,1452
2015,9,21,11,1000,1000,2405,1405
2015,9,21,12,1025,1053,2485,1432
2015,9,21,13,1145,1180,2579,1399
2015,9,21,14,1230,1251,2643,1392
2015,9,21,15,1260,1259,2701,1442
2015,9,21,16,1295,1267,2690,1423
2015,9,21,17,1325,1299,2722,1423
2015,9,21,18,1330,1317,2739,1422
2015,9,21,19,1335,1320,2729,1409
2015,9,21,20,1345,1334,2725,1391
2015,9,21,21,1360,1345,2704,1359
2015,9,21,22,1400,1350,2718,1368
2015,9,21,23,1425,1358,2686,1328
2015,9,22,0,1415,1349,2639,1290
2015,9,22,1,1390,1324,2720,1396
2015,9,22,2,1395,1327,2666,1339
2015,9,22,3,1410,1326,2550,1224
2015,9,22,4,1310,1250,2468,1218
2015,9,22,5,1210,1177,2479,1302
2015,9,22,6,1140,1086,2440,1354
2015,9,22,7,1020,1040,2435,1395
2015,9,22,8,995,1004,2385,1381
2015,9,22,9,970,985,2410,1425
2015,9,22,10,965,982,2404,1422
2015,9,22,11,975,995,2427,1432
2015,9,22,12,1035,1042,2439,1397
2015,9,22,13,1175,1156,2423,1267
2015,9,22,14,1295,1229,2411,1182
2015,9,22,15,1300,1249,2506,1257
2015,9,22,16,1305,1257,2503,1246
2015,9,22,17,1300,1273,2498,1225
2015,9,22,18,1290,1269,2503,1234
2015,9,22,19,1295,1279,2511,1232
2015,9,22,20,1310,1288,2521,1233
2015,9,22,21,1290,1301,2535,1234
2015,9,22,22,1300,1302,2551,1249
2015,9,22,23,1310,1324,2549,1225
2015,9,23,0,1305,1317,2531,1214
2015,9,23,1,1295,1310,2542,1232
2015,9,23,2,1300,1322,2649,1327
2015,9,23,3,1315,1352,2701,1349
2015,9,23,4,1295,1270,2710,1440
2015,9,23,5,1170,1178,2663,1485
2015,9,23,6,1085,1081,2568,1487
2015,9,23,7,1005,1043,2588,1545
2015,9,23,8,985,1019,2580,1561
2015,9,23,9,945,999,2562,1563
2015,9,23,10,955,1012,2559,1547
2015,9,23,11,975,1034,2573,1539
2015,9,23,12,1035,1072,2565,1493
2015,9,23,13,1170,1195,2589,1394
2015,9,23,14,1275,1258,2581,1323
2015,9,23,15,1285,1270,2625,1355
2015,9,23,16,1300,1286,2646,1360
2015,9,23,17,1310,1259,2632,1373
2015,9,23,18,1305,1283,2675,1392
2015,9,23,19,1305,1294,2692,1398
2015,9,23,20,1305,1313,2697,1384
2015,9,23,21,1315,1331,2738,1407
2015,9,23,22,1320,1349,2741,1392
2015,9,23,23,1330,1383,2743,1360
2015,9,24,0,1325,1382,2746,1364
2015,9,24,1,1310,1347,2709,1362
2015,9,24,2,1315,1358,2716,1358
2015,9,24,3,1330,1364,2740,1376
2015,9,24,4,1285,1298,2695,1397
2015,9,24,5,1190,1186,2667,1481
2015,9,24,6,1100,1073,2537,1464
2015,9,24,7,1000,1035,2528,1493
2015,9,24,8,975,1007,2486,1479
2015,9,24,9,960,1000,2235,1235
2015,9,24,10,960,1011,2273,1262
2015,9,24,11,980,1019,2283,1264
2015,9,24,12,1040,1062,2231,1169
2015,9,24,13,1175,1164,2237,1073
2015,9,24,14,1275,1240,2249,1009
2015,9,24,15,1290,1245,2251,1006
2015,9,24,16,1295,1248,2282,1034
2015,9,24,17,1300,1251,2289,1038
2015,9,24,18,1300,1267,2285,1018
2015,9,24,19,1300,1281,2309,1028
2015,9,24,20,1310,1313,2317,1004
2015,9,24,21,1315,1337,2348,1011
2015,9,24,22,1325,1353,2349,996
2015,9,24,23,1330,1375,2322,947
2015,9,25,0,1325,1370,2313,943
2015,9,25,1,1315,1333,2319,986
2015,9,25,2,1325,1353,2338,985
2015,9,25,3,1350,1347,2376,1029
2015,9,25,4,1275,1264,2359,1095
2015,9,25,5,1185,1151,2325,1174
2015,9,25,6,1095,1074,2254,1180
2015,9,25,7,1020,1027,2229,1202
2015,9,25,8,1000,1021,2206,1185
2015,9,25,9,985,995,2158,1163
2015,9,25,10,995,990,2159,1169
2015,9,25,11,1015,996,2176,1180
2015,9,25,12,1060,1035,2202,1167
2015,9,25,13,1215,1149,2244,1095
2015,9,25,14,1330,1183,2236,1053
2015,9,25,15,1345,1293,2283,990
2015,9,25,16,1350,1246,2289,1043
2015,9,25,17,1345,1268,2300,1032
2015,9,25,18,1340,1287,2280,993
2015,9,25,19,1340,1301,2281,980
2015,9,25,20,1350,1342,2318,976
2015,9,25,21,1370,1359,2328,969
2015,9,25,22,1370,1394,2365,971
2015,9,25,23,1395,1408,2382,974
2015,9,26,0,1380,1401,2313,912
2015,9,26,1,1365,1365,2296,931
2015,9,26,2,1355,1360,2321,961
2015,9,26,3,1380,1353,2343,990
2015,9,26,4,1330,1301,2352,1051
2015,9,26,5,1210,1193,2352,1159
2015,9,26,6,1130,1116,2352,1236
2015,9,26,7,1010,1060,2356,1296
2015,9,26,8,970,1025,2350,1325
2015,9,26,9,955,989,2330,1341
2015,9,26,10,950,973,2254,1281
2015,9,26,11,955,963,2007,1044
2015,9,26,12,975,983,1975,992
2015,9,26,13,1050,1021,2056,1035
2015,9,26,14,1130,1074,1989,915
2015,9,26,15,1190,1123,2069,946
2015,9,26,16,1215,1169,2104,935
2015,9,26,17,1235,1191,2091,900
2015,9,26,18,1245,1210,2095,885
2015,9,26,19,1260,1229,2195,966
2015,9,26,20,1270,1257,2217,960
2015,9,26,21,1270,1251,2188,937
2015,9,26,22,1260,1292,2235,943
2015,9,26,23,1285,1320,2236,916
2015,9,27,0,1300,1337,2314,977
2015,9,27,1,1275,1332,2363,1031
2015,9,27,2,1285,1329,2440,1111
2015,9,27,3,1290,1302,2346,1044
2015,9,27,4,1225,1248,2362,1114
2015,9,27,5,1170,1176,2319,1143
2015,9,27,6,1105,1106,2345,1239
2015,9,27,7,980,1059,2373,1314
2015,9,27,8,965,1039,2408,1369
2015,9,27,9,960,1013,2381,1368
2015,9,27,10,950,1000,2368,1368
2015,9,27,11,950,999,2327,1328
2015,9,27,12,965,1009,2350,1341
2015,9,27,13,1000,1032,2308,1276
2015,9,27,14,1020,1068,2305,1237
2015,9,27,15,1065,1132,2311,1179
2015,9,27,16,1105,1167,2329,1162
2015,9,27,17,1145,1169,2381,1212
2015,9,27,18,1165,1189,2520,1331
2015,9,27,19,1175,1211,2636,1425
2015,9,27,20,1180,1227,2647,1420
2015,9,27,21,1190,1226,2644,1418
2015,9,27,22,1215,1250,2671,1421
2015,9,27,23,1260,1264,2705,1441
2015,9,28,0,1265,1304,2752,1448
2015,9,28,1,1255,1268,2727,1459
2015,9,28,2,1245,1281,2714,1433
2015,9,28,3,1270,1273,2696,1423
2015,9,28,4,1200,1207,2684,1477
2015,9,28,5,1115,1125,2644,1519
2015,9,28,6,1035,1036,2613,1577
2015,9,28,7,995,1008,2606,1598
2015,9,28,8,950,998,2608,1610
2015,9,28,9,940,974,2605,1631
2015,9,28,10,945,968,2611,1643
2015,9,28,11,955,989,2607,1618
2015,9,28,12,1005,1051,2601,1550
2015,9,28,13,1115,1165,2620,1455
2015,9,28,14,1180,1240,2590,1350
2015,9,28,15,1180,1247,2573,1326
2015,9,28,16,1200,1272,2613,1341
2015,9,28,17,1230,1274,2647,1373
2015,9,28,18,1240,1263,2623,1360
2015,9,28,19,1240,1271,2629,1358
2015,9,28,20,1255,1284,2632,1348
2015,9,28,21,1275,1274,2615,1341
2015,9,28,22,1305,1282,2591,1309
2015,9,28,23,1320,1278,2579,1301
2015,9,29,0,1305,1278,2589,1311
2015,9,29,1,1280,1269,2630,1361
2015,9,29,2,1285,1294,2638,1344
2015,9,29,3,1280,1285,2654,1369
2015,9,29,4,1215,1208,2569,1361
2015,9,29,5,1105,1124,2537,1413
2015,9,29,6,1025,1055,2501,1446
2015,9,29,7,985,1009,2490,1481
2015,9,29,8,950,986,2485,1499
2015,9,29,9,935,986,2543,1557
2015,9,29,10,925,978,2561,1583
2015,9,29,11,935,983,2544,1561
2015,9,29,12,995,1044,2558,1514
2015,9,29,13,1135,1159,2631,1472
2015,9,29,14,1235,1244,2645,1401
2015,9,29,15,1255,1241,2602,1361
2015,9,29,16,1245,1243,2627,1384
2015,9,29,17,1250,1255,2694,1439
2015,9,29,18,1255,1277,2772,1495
2015,9,29,19,1265,1272,2742,1470
2015,9,29,20,1280,1268,2727,1459
2015,9,29,21,1285,1294,2744,1450
2015,9,29,22,1295,1299,2744,1445
2015,9,29,23,1315,1313,2756,1443
2015,9,30,0,1310,1298,2775,1477
2015,9,30,1,1300,1290,2718,1428
2015,9,30,2,1310,1303,2665,1362
2015,9,30,3,1325,1296,2654,1358
2015,9,30,4,1245,1225,2530,1305
2015,9,30,5,1140,1126,2479,1353
2015,9,30,6,1055,1072,2497,1425
2015,9,30,7,985,1036,2510,1474
2015,9,30,8,975,1001,2442,1441
2015,9,30,9,945,1000,2450,1450
2015,9,30,10,950,992,2452,1460
2015,9,30,11,970,1011,2464,1453
2015,9,30,12,1020,1058,2521,1463
2015,9,30,13,1165,1169,2505,1336
2015,9,30,14,1270,1239,2478,1239
2015,9,30,15,1280,1230,2474,1244
2015,9,30,16,1285,1225,2526,1301
2015,9,30,17,1270,1254,2622,1368
2015,9,30,18,1270,1257,2632,1375
2015,9,30,19,1280,1275,2655,1380
2015,9,30,20,1295,1301,2680,1379
2015,9,30,21,1285,1327,2662,1335
2015,9,30,22,1295,1340,2655,1315
2015,9,30,23,1290,1360,2646,1286
2015,10,1,0,1295,1342,2636,1294
2015,10,1,1,1290,1330,2647,1317
2015,10,1,2,1315,1345,2684,1339
2015,10,1,3,1300,1328,2753,1425
2015,10,1,4,1210,1262,2574,1312
2015,10,1,5,1110,1152,2486,1334
2015,10,1,6,1050,1072,2438,1366
2015,10,1,7,985,1037,2423,1386
2015,10,1,8,975,1008,2474,1466
2015,10,1,9,965,1008,2449,1441
2015,10,1,10,950,992,2463,1471
2015,10,1,11,970,1007,2459,1452
2015,10,1,12,1025,1057,2528,1471
2015,10,1,13,1135,1176,2541,1365
2015,10,1,14,1225,1250,2501,1251
2015,10,1,15,1215,1260,2502,1242
2015,10,1,16,1210,1264,2505,1241
2015,10,1,17,1200,1273,2537,1264
2015,10,1,18,1220,1264,2567,1303
2015,10,1,19,1240,1260,2729,1469
2015,10,1,20,1250,1266,2714,1448
2015,10,1,21,1245,1259,2668,1409
2015,10,1,22,1255,1262,2691,1429
2015,10,1,23,1265,1254,2696,1442
2015,10,2,0,1280,1237,2689,1452
2015,10,2,1,1250,1237,2713,1476
2015,10,2,2,1240,1278,2719,1441
2015,10,2,3,1255,1253,2721,1468
2015,10,2,4,1265,1216,2726,1510
2015,10,2,5,1185,1121,2724,1603
2015,10,2,6,1095,1056,2698,1642
2015,10,2,7,1000,1003,2691,1688
2015,10,2,8,970,964,2485,1521
2015,10,2,9,965,957,2482,1525
2015,10,2,10,955,942,2482,1540
2015,10,2,11,970,956,2418,1462
2015,10,2,12,1025,1016,2521,1505
2015,10,2,13,1135,1117,2528,1411
2015,10,2,14,1235,1221,2660,1439
2015,10,2,15,1215,1240,2641,1401
2015,10,2,16,1200,1252,2660,1408
2015,10,2,17,1210,1260,2688,1428
2015,10,2,18,1215,1250,2675,1425
2015,10,2,19,1235,1236,2569,1333
2015,10,2,20,1245,1253,2588,1335
2015,10,2,21,1260,1240,2691,1451
2015,10,2,22,1275,1222,2682,1460
2015,10,2,23,1275,1209,2650,1441
2015,10,3,0,1265,1189,2615,1426
2015,10,3,1,1260,1192,2620,1428
2015,10,3,2,1255,1225,2613,1388
2015,10,3,3,1220,1207,2606,1399
2015,10,3,4,1195,1164,2586,1422
2015,10,3,5,1110,1092,2535,1443
2015,10,3,6,1035,1042,2521,1479
2015,10,3,7,955,996,2491,1495
2015,10,3,8,935,976,2463,1487
2015,10,3,9,925,992,2451,1459
2015,10,3,10,915,1008,2373,1365
2015,10,3,11,920,1003,2387,1384
2015,10,3,12,960,1031,2444,1413
2015,10,3,13,1040,1069,2558,1489
2015,10,3,14,1100,1133,2634,1501
2015,10,3,15,1125,1191,2772,1581
2015,10,3,16,1135,1230,2771,1541
2015,10,3,17,1150,1249,2838,1589
2015,10,3,18,1160,1252,2679,1427
2015,10,3,19,1155,1255,2668,1413
2015,10,3,20,1170,1245,2657,1412
2015,10,3,21,1165,1236,2639,1403
2015,10,3,22,1175,1232,2639,1407
2015,10,3,23,1180,1226,2679,1453
2015,10,4,0,1180,1234,2885,1651
2015,10,4,1,1170,1239,2894,1655
2015,10,4,2,1200,1276,2909,1633
2015,10,4,3,1185,1258,2853,1595
2015,10,4,4,1120,1210,2831,1621
2015,10,4,5,1060,1142,2839,1697
2015,10,4,6,995,1092,2844,1752
2015,10,4,7,955,1055,2831,1776
2015,10,4,8,935,1025,2829,1804
2015,10,4,9,925,1015,2844,1829
2015,10,4,10,915,1000,2839,1839
2015,10,4,11,920,1020,2837,1817
2015,10,4,12,960,1027,2828,1801
2015,10,4,13,1030,1049,2824,1775
2015,10,4,14,1075,1100,2818,1718
2015,10,4,15,1105,1162,2830,1668
2015,10,4,16,1125,1202,2835,1633
2015,10,4,17,1140,1215,2797,1582
2015,10,4,18,1145,1222,2746,1524
2015,10,4,19,1145,1210,2714,1504
2015,10,4,20,1150,1195,2694,1499
2015,10,4,21,1155,1188,2666,1478
2015,10,4,22,1165,1170,2677,1507
2015,10,4,23,1180,1188,2666,1478
2015,10,5,0,1185,1210,2683,1473
2015,10,5,1,1170,1230,2687,1457
2015,10,5,2,1200,1278,2667,1389
2015,10,5,3,1195,1264,2682,1418
2015,10,5,4,1075,1214,2693,1479
2015,10,5,5,1050,1128,2475,1347
2015,10,5,6,980,1048,2374,1326
2015,10,5,7,960,1019,2357,1338
2015,10,5,8,935,981,2316,1335
2015,10,5,9,925,986,2240,1254
2015,10,5,10,920,972,2263,1291
2015,10,5,11,930,982,2278,1296
2015,10,5,12,990,1055,2374,1319
2015,10,5,13,1095,1184,2406,1222
2015,10,5,14,1195,1281,2422,1141
2015,10,5,15,1210,1281,2395,1114
2015,10,5,16,1220,1281,2388,1107
2015,10,5,17,1225,1273,2373,1100
2015,10,5,18,1225,1270,2395,1125
2015,10,5,19,1210,1245,2379,1134
2015,10,5,20,1215,1240,2369,1129
2015,10,5,21,1215,1243,2398,1155
2015,10,5,22,1195,1240,2402,1162
2015,10,5,23,1185,1238,2375,1137
2015,10,6,0,1225,1244,2375,1131
2015,10,6,1,1245,1251,2414,1163
2015,10,6,2,1250,1315,2422,1107
2015,10,6,3,1225,1299,2404,1105
2015,10,6,4,1185,1225,2394,1169
2015,10,6,5,1075,1111,2305,1194
2015,10,6,6,1000,1041,2296,1255
2015,10,6,7,985,1003,2325,1322
2015,10,6,8,950,979,2318,1339
2015,10,6,9,955,972,2304,1332
2015,10,6,10,940,976,2325,1349
2015,10,6,11,950,999,2342,1343
2015,10,6,12,1010,1061,2374,1313
2015,10,6,13,1130,1195,2381,1186
2015,10,6,14,1230,1278,2360,1082
2015,10,6,15,1215,1271,2328,1057
2015,10,6,16,1200,1253,2263,1010
2015,10,6,17,1220,1253,2334,1081
2015,10,6,18,1210,1248,2331,1083
2015,10,6,19,1235,1236,2348,1112
2015,10,6,20,1245,1239,2373,1134
2015,10,6,21,1255,1239,2397,1158
2015,10,6,22,1260,1202,2356,1154
2015,10,6,23,1280,1205,2355,1150
2015,10,7,0,1250,1241,2360,1119
2015,10,7,1,1235,1250,2317,1067
2015,10,7,2,1210,1299,2314,1015
2015,10,7,3,1255,1276,2322,1046
2015,10,7,4,1190,1215,2298,1083
2015,10,7,5,1095,1122,2328,1206
2015,10,7,6,1040,1048,2383,1335
2015,10,7,7,970,1037,2401,1364
2015,10,7,8,950,990,2364,1374
2015,10,7,9,940,962,2351,1389
2015,10,7,10,935,980,2360,1380
2015,10,7,11,965,984,2373,1389
2015,10,7,12,1035,1028,2373,1345
2015,10,7,13,1155,1144,2434,1290
2015,10,7,14,1250,1229,2443,1214
2015,10,7,15,1235,1209,2425,1216
2015,10,7,16,1250,1229,2464,1235
2015,10,7,17,1215,1232,2484,1252
2015,10,7,18,1210,1234,2496,1262
2015,10,7,19,1205,1227,2483,1256
2015,10,7,20,1195,1236,2438,1202
2015,10,7,21,1185,1221,2466,1245
2015,10,7,22,1180,1235,2479,1244
2015,10,7,23,1210,1238,2472,1234
2015,10,8,0,1215,1213,2439,1226
2015,10,8,1,1245,1244,2435,1191
2015,10,8,2,1260,1271,2411,1140
2015,10,8,3,1255,1261,2412,1151
2015,10,8,4,1195,1190,2391,1201
2015,10,8,5,1070,1105,2409,1304
2015,10,8,6,995,1030,2396,1366
2015,10,8,7,970,1009,2359,1350
2015,10,8,8,965,978,2310,1332
2015,10,8,9,925,981,2288,1307
2015,10,8,10,950,969,2333,1364
2015,10,8,11,930,988,2350,1362
2015,10,8,12,1000,1019,2357,1338
2015,10,8,13,1120,1134,2335,1201
2015,10,8,14,1225,1217,2340,1123
2015,10,8,15,1235,1219,2361,1142
2015,10,8,16,1225,1230,2355,1125
2015,10,8,17,1215,1231,2354,1123
2015,10,8,18,1205,1231,2355,1124
2015,10,8,19,1195,1244,2371,1127
2015,10,8,20,1195,1241,2342,1101
2015,10,8,21,1200,1246,2315,1069
2015,10,8,22,1175,1255,2318,1063
2015,10,8,23,1165,1246,2280,1034
2015,10,9,0,1205,1216,2010,794
2015,10,9,1,1215,1233,1983,750
2015,10,9,2,1260,1266,2022,756
2015,10,9,3,1245,1252,2029,777
2015,10,9,4,1190,1196,2020,824
2015,10,9,5,1070,1111,2006,895
2015,10,9,6,1005,1029,2020,991
2015,10,9,7,970,990,2003,1013
2015,10,9,8,935,977,2003,1026
2015,10,9,9,945,969,2005,1036
2015,10,9,10,925,985,2017,1032
2015,10,9,11,945,1012,2162,1150
2015,10,9,12,990,1056,2319,1263
2015,10,9,13,1105,1183,2434,1251
2015,10,9,14,1200,1265,2443,1178
2015,10,9,15,1195,1261,2429,1168
2015,10,9,16,1195,1282,2451,1169
2015,10,9,17,1200,1269,2468,1199
2015,10,9,18,1210,1286,2546,1260
2015,10,9,19,1215,1307,2553,1246
2015,10,9,20,1235,1313,2539,1226
2015,10,9,21,1255,1305,2531,1226
2015,10,9,22,1275,1315,2519,1204
2015,10,9,23,1300,1293,2510,1217
2015,10,10,0,1275,1270,2502,1232
2015,10,10,1,1265,1265,2363,1098
2015,10,10,2,1290,1281,2363,1082
2015,10,10,3,1235,1243,2317,1074
2015,10,10,4,1170,1209,2353,1144
2015,10,10,5,1070,1148,2354,1206
2015,10,10,6,1000,1081,2400,1319
2015,10,10,7,960,1055,2412,1357
2015,10,10,8,945,990,2467,1477
2015,10,10,9,920,966,2489,1523
2015,10,10,10,915,988,2538,1550
2015,10,10,11,945,988,2574,1586
2015,10,10,12,970,1001,2631,1630
2015,10,10,13,1040,1047,2649,1602
2015,10,10,14,1040,1100,2644,1544
2015,10,10,15,1100,1147,2639,1492
2015,10,10,16,1140,1172,2606,1434
2015,10,10,17,1165,1195,2624,1429
2015,10,10,18,1190,1203,2620,1417
2015,10,10,19,1200,1227,2615,1388
2015,10,10,20,1235,1232,2670,1438
2015,10,10,21,1225,1260,2744,1484
2015,10,10,22,1245,1275,2787,1512
2015,10,10,23,1260,1280,2748,1468
2015,10,11,0,1270,1280,2699,1419
2015,10,11,1,1285,1250,2660,1410
2015,10,11,2,1275,1278,2637,1359
2015,10,11,3,1210,1263,2609,1346
2015,10,11,4,1180,1196,2602,1406
2015,10,11,5,1120,1130,2599,1469
2015,10,11,6,1020,1060,2519,1459
2015,10,11,7,960,1004,2088,1084
2015,10,11,8,935,982,2025,1043
2015,10,11,9,930,966,1842,876
2015,10,11,10,915,959,1840,881
2015,10,11,11,925,954,1783,829
2015,10,11,12,950,976,1895,919
2015,10,11,13,1020,1010,1954,944
2015,10,11,14,1095,1062,2153,1091
2015,10,11,15,1130,1107,2368,1261
2015,10,11,16,1160,1158,2612,1454
2015,10,11,17,1155,1167,2602,1435
2015,10,11,18,1165,1185,2569,1384
2015,10,11,19,1170,1161,2641,1480
2015,10,11,20,1170,1150,2619,1469
2015,10,11,21,1175,1159,2720,1561
2015,10,11,22,1165,1167,2739,1572
2015,10,11,23,1175,1198,2765,1567
2015,10,12,0,1185,1215,2774,1559
2015,10,12,1,1190,1245,2785,1540
2015,10,12,2,1230,1282,2775,1493
2015,10,12,3,1205,1273,2772,1499
2015,10,12,4,1095,1209,2735,1526
2015,10,12,5,1060,1135,2745,1610
2015,10,12,6,990,1069,2737,1668
2015,10,12,7,985,1031,2713,1682
2015,10,12,8,950,1011,2631,1620
2015,10,12,9,935,980,2519,1539
2015,10,12,10,920,987,2529,1542
2015,10,12,11,945,993,2579,1586
2015,10,12,12,1000,1033,2603,1570
2015,10,12,13,1130,1132,2738,1606
2015,10,12,14,1215,1224,2757,1533
2015,10,12,15,1220,1218,2741,1523
2015,10,12,16,1235,1235,2753,1518
2015,10,12,17,1215,1256,2758,1502
2015,10,12,18,1210,1239,2780,1541
2015,10,12,19,1200,1244,2772,1528
2015,10,12,20,1195,1251,2779,1528
2015,10,12,21,1175,1269,2781,1512
2015,10,12,22,1215,1272,2792,1520
2015,10,12,23,1230,1278,2787,1509
2015,10,13,0,1245,1272,2761,1489
2015,10,13,1,1265,1271,2730,1459
2015,10,13,2,1250,1322,2743,1421
2015,10,13,3,1245,1287,2749,1462
2015,10,13,4,1200,1231,2763,1532
2015,10,13,5,1135,1140,2756,1616
2015,10,13,6,1005,1044,2677,1633
2015,10,13,7,970,1000,2558,1558
2015,10,13,8,960,980,2578,1598
2015,10,13,9,940,969,2575,1606
2015,10,13,10,935,963,2532,1569
2015,10,13,11,945,979,2492,1513
2015,10,13,12,990,1044,2610,1566
2015,10,13,13,1095,1161,2714,1553
2015,10,13,14,1195,1254,2699,1445
2015,10,13,15,1215,1230,2686,1456
2015,10,13,16,1200,1238,2646,1408
2015,10,13,17,1205,1232,2655,1423
2015,10,13,18,1195,1247,2661,1414
2015,10,13,19,1185,1271,2662,1391
2015,10,13,20,1175,1292,2600,1308
2015,10,13,21,1165,1276,2639,1363
2015,10,13,22,1170,1279,2611,1332
2015,10,13,23,1205,1311,2580,1269
2015,10,14,0,1215,1272,2552,1280
2015,10,14,1,1250,1255,2538,1283
2015,10,14,2,1245,1300,2766,1466
2015,10,14,3,1210,1278,2752,1474
2015,10,14,4,1190,1213,2710,1497
2015,10,14,5,1090,1137,2742,1605
2015,10,14,6,1005,1057,2752,1695
2015,10,14,7,980,1022,2743,1721
2015,10,14,8,965,1002,2716,1714
2015,10,14,9,935,983,2688,1705
2015,10,14,10,945,989,2672,1683
2015,10,14,11,950,992,2629,1637
2015,10,14,12,995,1059,2666,1607
2015,10,14,13,1110,1175,2669,1494
2015,10,14,14,1205,1249,2631,1382
2015,10,14,15,1185,1225,2678,1453
2015,10,14,16,1200,1226,2688,1462
2015,10,14,17,1205,1223,2681,1458
2015,10,14,18,1195,1234,2669,1435
2015,10,14,19,1195,1229,2667,1438
2015,10,14,20,1220,1235,2719,1484
2015,10,14,21,1220,1225,2714,1489
2015,10,14,22,1230,1258,2754,1496
2015,10,14,23,1225,1249,2757,1508
2015,10,15,0,1210,1242,2776,1534
2015,10,15,1,1230,1234,2765,1531
2015,10,15,2,1270,1273,2728,1455
2015,10,15,3,1250,1240,2678,1438
2015,10,15,4,1205,1201,2677,1476
2015,10,15,5,1080,1114,2643,1529
2015,10,15,6,995,1059,2652,1593
2015,10,15,7,965,1022,2493,1471
2015,10,15,8,940,988,2298,1310
2015,10,15,9,935,985,2347,1362
2015,10,15,10,925,967,2367,1400
2015,10,15,11,940,994,2379,1385
2015,10,15,12,995,1060,2423,1363
2015,10,15,13,1095,1146,2413,1267
2015,10,15,14,1205,1231,2412,1181
2015,10,15,15,1205,1240,2385,1145
2015,10,15,16,1210,1238,2411,1173
2015,10,15,17,1210,1242,2404,1162
2015,10,15,18,1205,1242,2373,1131
2015,10,15,19,1220,1220,2374,1154
2015,10,15,20,1225,1233,2417,1184
2015,10,15,21,1215,1223,2431,1208
2015,10,15,22,1225,1217,2426,1209
2015,10,15,23,1240,1215,2409,1194
2015,10,16,0,1200,1214,2409,1195
2015,10,16,1,1205,1239,2436,1197
2015,10,16,2,1250,1275,2457,1182
2015,10,16,3,1225,1249,2444,1195
2015,10,16,4,1205,1218,2440,1222
2015,10,16,5,1085,1133,2413,1280
2015,10,16,6,1000,1060,2368,1308
2015,10,16,7,970,1020,2334,1314
2015,10,16,8,955,1008,2323,1315
2015,10,16,9,945,993,2255,1262
2015,10,16,10,955,994,2258,1264
2015,10,16,11,965,1005,2263,1258
2015,10,16,12,1015,1054,2325,1271
2015,10,16,13,1125,1131,2325,1194
2015,10,16,14,1220,1222,2355,1133
2015,10,16,15,1220,1253,2388,1135
2015,10,16,16,1225,1248,2360,1112
2015,10,16,17,1210,1243,2383,1140
2015,10,16,18,1230,1240,2400,1160
2015,10,16,19,1235,1225,2406,1181
2015,10,16,20,1240,1218,2417,1199
2015,10,16,21,1225,1215,2406,1191
2015,10,16,22,1235,1202,2374,1172
2015,10,16,23,1220,1194,2377,1183
2015,10,17,0,1200,1171,2357,1186
2015,10,17,1,1190,1190,2379,1189
2015,10,17,2,1225,1234,2395,1161
2015,10,17,3,1200,1210,2296,1086
2015,10,17,4,1200,1160,2290,1130
2015,10,17,5,1090,1115,2277,1162
2015,10,17,6,1030,1060,2247,1187
2015,10,17,7,970,1034,2218,1184
2015,10,17,8,950,1001,2221,1220
2015,10,17,9,945,990,2242,1252
2015,10,17,10,940,981,2254,1273
2015,10,17,11,955,990,2218,1228
2015,10,17,12,990,992,1812,820
2015,10,17,13,1015,1040,1777,737
2015,10,17,14,1050,1093,1797,704
2015,10,17,15,1105,1130,1774,644
2015,10,17,16,1135,1156,1809,653
2015,10,17,17,1160,1168,2178,1010
2015,10,17,18,1175,1168,2242,1074
2015,10,17,19,1195,1156,2244,1088
2015,10,17,20,1185,1144,2236,1092
2015,10,17,21,1170,1154,2235,1081
2015,10,17,22,1180,1131,2237,1106
2015,10,17,23,1180,1135,2232,1097
2015,10,18,0,1185,1145,2229,1084
2015,10,18,1,1200,1173,2254,1081
2015,10,18,2,1210,1213,2263,1050
2015,10,18,3,1200,1187,2247,1060
2015,10,18,4,1165,1144,2238,1094
2015,10,18,5,1080,1100,2278,1178
2015,10,18,6,1000,1045,2278,1233
2015,10,18,7,975,998,2250,1252
2015,10,18,8,950,982,2229,1247
2015,10,18,9,955,956,2208,1252
2015,10,18,10,940,953,2161,1208
2015,10,18,11,950,961,2165,1204
2015,10,18,12,990,971,2255,1284
2015,10,18,13,1030,1024,2371,1347
2015,10,18,14,1090,1078,2447,1369
2015,10,18,15,1120,1121,2463,1342
2015,10,18,16,1150,1151,2438,1287
2015,10,18,17,1165,1179,2459,1280
2015,10,18,18,1175,1180,2437,1257
2015,10,18,19,1180,1180,2395,1215
2015,10,18,20,1175,1174,2440,1266
2015,10,18,21,1185,1160,2397,1237
2015,10,18,22,1175,1165,2422,1257
2015,10,18,23,1195,1174,2407,1233
2015,10,19,0,1200,1187,2443,1256
2015,10,19,1,1215,1229,2569,1340
2015,10,19,2,1220,1253,2571,1318
2015,10,19,3,1200,1227,2548,1321
2015,10,19,4,1165,1161,2495,1334
2015,10,19,5,1075,1078,2468,1390
2015,10,19,6,1000,992,2451,1459
2015,10,19,7,980,961,2441,1480
2015,10,19,8,960,938,2314,1376
2015,10,19,9,955,933,2332,1399
2015,10,19,10,940,925,2320,1395
2015,10,19,11,950,951,2413,1462
2015,10,19,12,1010,1005,2420,1415
2015,10,19,13,1145,1120,2541,1421
2015,10,19,14,1220,1222,2529,1307
2015,10,19,15,1235,1208,2521,1313
2015,10,19,16,1210,1219,2532,1313
2015,10,19,17,1205,1225,2599,1374
2015,10,19,18,1200,1216,2604,1388
2015,10,19,19,1180,1220,2599,1379
2015,10,19,20,1175,1214,2553,1339
2015,10,19,21,1185,1227,2510,1283
2015,10,19,22,1190,1213,2489,1276
2015,10,19,23,1195,1232,2505,1273
2015,10,20,0,1210,1238,2550,1312
2015,10,20,1,1225,1275,2560,1285
2015,10,20,2,1255,1300,2565,1265
2015,10,20,3,1235,1269,2512,1243
2015,10,20,4,1195,1202,2480,1278
2015,10,20,5,1080,1131,2534,1403
2015,10,20,6,1005,1058,2492,1434
2015,10,20,7,945,1012,2321,1309
2015,10,20,8,925,996,2360,1364
2015,10,20,9,925,986,2278,1292
2015,10,20,10,915,980,2088,1108
2015,10,20,11,940,1006,2053,1047
2015,10,20,12,1000,1060,2368,1308
2015,10,20,13,1090,1198,2623,1425
2015,10,20,14,1195,1287,2641,1354
2015,10,20,15,1205,1283,2639,1356
2015,10,20,16,1200,1269,2552,1283
2015,10,20,17,1200,1311,2636,1325
2015,10,20,18,1190,1255,2646,1391
2015,10,20,19,1190,1249,2692,1443
2015,10,20,20,1195,1234,2674,1440
2015,10,20,21,1190,1225,2709,1484
2015,10,20,22,1190,1217,2676,1459
2015,10,20,23,1200,1223,2637,1414
2015,10,21,0,1175,1223,2638,1415
2015,10,21,1,1180,1263,2628,1365
2015,10,21,2,1225,1301,2645,1344
2015,10,21,3,1190,1269,2633,1364
2015,10,21,4,1145,1217,2583,1366
2015,10,21,5,1060,1134,2562,1428
2015,10,21,6,980,1059,2544,1485
2015,10,21,7,975,1013,2512,1499
2015,10,21,8,950,1010,2564,1554
2015,10,21,9,945,1014,2557,1543
2015,10,21,10,945,1006,2548,1542
2015,10,21,11,955,1035,2538,1503
2015,10,21,12,1020,1096,2567,1471
2015,10,21,13,1140,1221,2608,1387
2015,10,21,14,1205,1298,2608,1310
2015,10,21,15,1200,1290,2541,1251
2015,10,21,16,1200,1270,2567,1297
2015,10,21,17,1200,1254,2562,1308
2015,10,21,18,1195,1235,2565,1330
2015,10,21,19,1185,1235,2585,1350
2015,10,21,20,1190,1230,2540,1310
2015,10,21,21,1195,1226,2527,1301
2015,10,21,22,1200,1207,2533,1326
2015,10,21,23,1195,1216,2549,1333
2015,10,22,0,1180,1214,2573,1359
2015,10,22,1,1220,1265,2592,1327
2015,10,22,2,1255,1318,2608,1290
2015,10,22,3,1220,1304,2601,1297
2015,10,22,4,1180,1227,2549,1322
2015,10,22,5,1085,1163,2520,1357
2015,10,22,6,1015,1118,2550,1432
2015,10,22,7,970,1051,2602,1551
2015,10,22,8,950,1028,2582,1554
2015,10,22,9,955,1016,2567,1551
2015,10,22,10,945,1030,2513,1483
2015,10,22,11,970,1034,2516,1482
2015,10,22,12,1030,1117,2567,1450
2015,10,22,13,1145,1236,2587,1351
2015,10,22,14,1205,1350,2720,1370
2015,10,22,15,1220,1289,2705,1416
2015,10,22,16,1215,1270,2685,1415
2015,10,22,17,1250,1259,2715,1456
2015,10,22,18,1210,1253,2696,1443
2015,10,22,19,1215,1240,2672,1432
2015,10,22,20,1190,1234,2654,1420
2015,10,22,21,1180,1229,2631,1402
2015,10,22,22,1195,1223,2672,1449
2015,10,22,23,1195,1229,2705,1476
2015,10,23,0,1185,1218,2718,1500
2015,10,23,1,1215,1269,2728,1459
2015,10,23,2,1255,1310,2760,1450
2015,10,23,3,1220,1297,2738,1441
2015,10,23,4,1195,1238,2711,1473
2015,10,23,5,1095,1154,2727,1573
2015,10,23,6,1020,1093,2724,1631
2015,10,23,7,985,1043,2720,1677
2015,10,23,8,965,1051,2736,1685
2015,10,23,9,960,1044,2719,1675
2015,10,23,10,960,1053,2687,1634
2015,10,23,11,980,1072,2741,1669
2015,10,23,12,1040,1118,2732,1614
2015,10,23,13,1155,1223,2711,1488
2015,10,23,14,1255,1323,2738,1415
2015,10,23,15,1260,1306,2711,1405
2015,10,23,16,1250,1271,2697,1426
2015,10,23,17,1235,1254,2670,1416
2015,10,23,18,1220,1250,2642,1392
2015,10,23,19,1225,1225,2627,1402
2015,10,23,20,1215,1221,2656,1435
2015,10,23,21,1215,1209,2657,1448
2015,10,23,22,1200,1210,2632,1422
2015,10,23,23,1205,1195,2618,1423
2015,10,24,0,1190,1199,2621,1422
2015,10,24,1,1210,1238,2621,1383
2015,10,24,2,1255,1271,2638,1367
2015,10,24,3,1245,1269,2625,1356
2015,10,24,4,1195,1231,2620,1389
2015,10,24,5,1120,1183,2644,1461
2015,10,24,6,1060,1121,2634,1513
2015,10,24,7,995,1066,2661,1595
2015,10,24,8,955,1040,2652,1612
2015,10,24,9,950,1037,2699,1662
2015,10,24,10,955,1031,2704,1673
2015,10,24,11,960,1042,2705,1663
2015,10,24,12,975,1049,2707,1658
2015,10,24,13,1035,1085,2704,1619
2015,10,24,14,1105,1165,2657,1492
2015,10,24,15,1165,1190,2612,1422
2015,10,24,16,1190,1220,2617,1397
2015,10,24,17,1205,1203,2642,1439
2015,10,24,18,1210,1187,2662,1475
2015,10,24,19,1210,1174,2653,1479
2015,10,24,20,1205,1154,2651,1497
2015,10,24,21,1205,1144,2700,1556
2015,10,24,22,1205,1141,2723,1582
2015,10,24,23,1205,1157,2691,1534
2015,10,25,0,1210,1177,2702,1525
2015,10,25,1,1215,1227,2740,1513
2015,10,25,2,1240,1236,2759,1523
2015,10,25,3,1220,1215,2716,1501
2015,10,25,4,1150,1177,2708,1531
2015,10,25,5,1110,1115,2682,1567
2015,10,25,6,1050,1061,2701,1640
2015,10,25,7,990,1025,2699,1674
2015,10,25,8,965,994,2654,1660
2015,10,25,9,955,968,2638,1670
2015,10,25,10,950,966,2607,1641
2015,10,25,11,955,968,2574,1606
2015,10,25,12,975,998,2658,1660
2015,10,25,13,1015,1043,2672,1629
2015,10,25,14,1065,1099,2667,1568
2015,10,25,15,1115,1144,2676,1532
2015,10,25,16,1160,1167,2667,1500
2015,10,25,17,1165,1190,2688,1498
2015,10,25,18,1175,1175,2676,1501
2015,10,25,19,1165,1169,2666,1497
2015,10,25,20,1155,1174,2677,1503
2015,10,25,21,1155,1170,2681,1511
2015,10,25,22,1155,1187,2679,1492
2015,10,25,23,1175,1195,2657,1462
2015,10,26,0,1180,1229,2706,1477
2015,10,26,1,1220,1278,2737,1459
2015,10,26,2,1250,1319,2786,1467
2015,10,26,3,1235,1275,2773,1498
2015,10,26,4,1180,1210,2723,1513
2015,10,26,5,1095,1127,2640,1513
2015,10,26,6,1000,1056,2608,1552
2015,10,26,7,990,1024,2620,1596
2015,10,26,8,975,982,2422,1440
2015,10,26,9,960,982,2390,1408
2015,10,26,10,965,972,2265,1293
2015,10,26,11,980,979,2057,1078
2015,10,26,12,1045,1031,2075,1044
2015,10,26,13,1150,1185,2356,1171
2015,10,26,14,1260,1306,2614,1308
2015,10,26,15,1225,1308,2586,1278
2015,10,26,16,1210,1311,2594,1283
2015,10,26,17,1195,1299,2605,1306
2015,10,26,18,1185,1285,2667,1382
2015,10,26,19,1190,1270,2687,1417
2015,10,26,20,1185,1266,2682,1416
2015,10,26,21,1195,1250,2638,1388
2015,10,26,22,1195,1241,2607,1366
2015,10,26,23,1195,1254,2636,1382
2015,10,27,0,1185,1252,2654,1402
2015,10,27,1,1235,1316,2672,1356
2015,10,27,2,1265,1331,2668,1337
2015,10,27,3,1240,1299,2623,1324
2015,10,27,4,1195,1247,2631,1384
2015,10,27,5,1090,1156,2674,1518
2015,10,27,6,1015,1087,2709,1622
2015,10,27,7,985,1046,2699,1653
2015,10,27,8,965,1023,2679,1656
2015,10,27,9,950,1011,2598,1587
2015,10,27,10,950,1023,2616,1593
2015,10,27,11,970,1038,2602,1564
2015,10,27,12,1020,1086,2626,1540
2015,10,27,13,1160,1212,2722,1510
2015,10,27,14,1265,1325,2762,1437
2015,10,27,15,1240,1338,2770,1432
2015,10,27,16,1220,1310,2757,1447
2015,10,27,17,1235,1299,2821,1522
2015,10,27,18,1215,1290,2840,1550
2015,10,27,19,1225,1260,2855,1595
2015,10,27,20,1215,1268,2824,1556
2015,10,27,21,1200,1253,2799,1546
2015,10,27,22,1210,1239,2783,1544
2015,10,27,23,1245,1248,2800,1552
2015,10,28,0,1255,1248,2752,1504
2015,10,28,1,1265,1316,2765,1449
2015,10,28,2,1275,1335,2752,1417
2015,10,28,3,1245,1318,2752,1434
2015,10,28,4,1200,1259,2714,1455
2015,10,28,5,1105,1175,2702,1527
2015,10,28,6,1020,1101,2710,1609
2015,10,28,7,990,1060,2679,1619
2015,10,28,8,975,1035,2699,1664
2015,10,28,9,990,1032,2714,1682
2015,10,28,10,975,1030,2673,1643
2015,10,28,11,995,1050,2684,1634
2015,10,28,12,1050,1117,2711,1594
2015,10,28,13,1170,1236,2707,1471
2015,10,28,14,1270,1344,2723,1379
2015,10,28,15,1275,1326,2715,1389
2015,10,28,16,1260,1310,2694,1384
2015,10,28,17,1250,1286,2706,1420
2015,10,28,18,1230,1264,2714,1450
2015,10,28,19,1225,1250,2708,1458
2015,10,28,20,1220,1233,2688,1455
2015,10,28,21,1215,1227,2699,1472
2015,10,28,22,1210,1215,2687,1472
2015,10,28,23,1210,1225,2681,1456
2015,10,29,0,1210,1236,2671,1435
2015,10,29,1,1255,1287,2735,1448
2015,10,29,2,1300,1309,2752,1443
2015,10,29,3,1275,1284,2691,1407
2015,10,29,4,1200,1217,2662,1445
2015,10,29,5,1130,1140,2648,1508
2015,10,29,6,1070,1068,2640,1572
2015,10,29,7,1000,1033,2643,1610
2015,10,29,8,985,1004,2623,1619
2015,10,29,9,975,997,2579,1582
2015,10,29,10,985,1003,2428,1425
2015,10,29,11,995,1017,2450,1433
2015,10,29,12,1065,1079,2580,1501
2015,10,29,13,1185,1221,2665,1444
2015,10,29,14,1285,1317,2669,1352
2015,10,29,15,1285,1318,2666,1348
2015,10,29,16,1270,1318,2722,1404
2015,10,29,17,1250,1326,2755,1429
2015,10,29,18,1240,1309,2783,1474
2015,10,29,19,1220,1311,2707,1396
2015,10,29,20,1225,1292,2634,1342
2015,10,29,21,1220,1297,2598,1301
2015,10,29,22,1210,1265,2380,1115
2015,10,29,23,1215,1301,2412,1111
2015,10,30,0,1210,1299,2577,1278
2015,10,30,1,1270,1368,2823,1455
2015,10,30,2,1305,1359,2785,1426
2015,10,30,3,1275,1347,2766,1419
2015,10,30,4,1205,1264,2704,1440
2015,10,30,5,1135,1193,2700,1507
2015,10,30,6,1065,1127,2700,1573
2015,10,30,7,990,1086,2677,1591
2015,10,30,8,985,1053,2563,1510
2015,10,30,9,980,1040,2395,1355
2015,10,30,10,985,1023,2327,1304
2015,10,30,11,995,1051,2421,1370
2015,10,30,12,1055,1102,2570,1468
2015,10,30,13,1175,1240,2639,1399
2015,10,30,14,1300,1319,2634,1315
2015,10,30,15,1290,1339,2798,1459
2015,10,30,16,1270,1325,2679,1354
2015,10,30,17,1255,1314,2653,1339
2015,10,30,18,1245,1306,2655,1349
2015,10,30,19,1220,1292,2674,1382
2015,10,30,20,1215,1280,2665,1385
2015,10,30,21,1205,1272,2682,1410
2015,10,30,22,1195,1292,2835,1543
2015,10,30,23,1200,1290,2800,1510
2015,10,31,0,1200,1298,2836,1538
2015,10,31,1,1225,1335,2822,1487
2015,10,31,2,1270,1318,2790,1472
2015,10,31,3,1255,1276,2760,1484
2015,10,31,4,1200,1221,2720,1499
2015,10,31,5,1140,1155,2717,1562
2015,10,31,6,1075,1091,2729,1638
2015,10,31,7,995,1065,2681,1616
2015,10,31,8,955,1031,2651,1620
2015,10,31,9,950,1012,2607,1595
2015,10,31,10,950,986,2483,1497
2015,10,31,11,960,1003,2443,1440
2015,10,31,12,970,1013,2428,1415
2015,10,31,13,1035,1061,2415,1354
2015,10,31,14,1115,1115,2242,1127
2015,10,31,15,1170,1162,2312,1150
2015,10,31,16,1200,1224,2522,1298
2015,10,31,17,1195,1225,2561,1336
2015,10,31,18,1200,1238,2563,1325
2015,10,31,19,1200,1227,2696,1469
2015,10,31,20,1195,1205,2698,1493
2015,10,31,21,1195,1200,2687,1487
2015,10,31,22,1195,1195,2672,1477
2015,10,31,23,1190,1196,2726,1530
2015,11,1,0,1200,1221,2741,1520
2015,11,1,1,1215,1225,2723,1498
2015,11,1,2,1240,1218,2738,1520
2015,11,1,3,1210,1209,2745,1536
2015,11,1,4,1130,1180,2755,1575
2015,11,1,5,1110,1141,2732,1591
2015,11,1,6,1050,1087,2684,1597
2015,11,1,7,990,1065,2654,1589
2015,11,1,8,960,1020,2258,1238
2015,11,1,9,960,1007,2172,1165
2015,11,1,10,950,993,2165,1172
2015,11,1,11,940,986,2179,1193
2015,11,1,12,945,1000,2104,1104
2015,11,1,13,965,1019,2124,1105
2015,11,1,14,1005,1060,2179,1119
2015,11,1,15,1050,1103,2165,1062
2015,11,1,16,1110,1180,2317,1137
2015,11,1,17,1150,1211,2507,1296
2015,11,1,18,1150,1207,2544,1337
2015,11,1,19,1150,1224,2624,1400
2015,11,1,20,1150,1210,2618,1408
2015,11,1,21,1145,1216,2610,1394
2015,11,1,22,1140,1204,2622,1418
2015,11,1,23,1150,1209,2541,1332
2015,11,2,0,1165,1252,2631,1379
2015,11,2,1,1185,1335,2790,1455
2015,11,2,2,1230,1345,2776,1431
2015,11,2,3,1270,1327,2755,1428
2015,11,2,4,1230,1275,2721,1446
2015,11,2,5,1155,1227,2652,1425
2015,11,2,6,1085,1134,2534,1400
2015,11,2,7,1005,1064,2561,1497
2015,11,2,8,975,1023,2382,1359
2015,11,2,9,950,1006,2376,1370
2015,11,2,10,950,990,2374,1384
2015,11,2,11,950,979,2460,1481
2015,11,2,12,975,999,2451,1452
2015,11,2,13,1025,1070,2519,1449
2015,11,2,14,1165,1211,2562,1351
2015,11,2,15,1285,1291,2559,1268
2015,11,2,16,1280,1301,2548,1247
2015,11,2,17,1270,1290,2547,1257
2015,11,2,18,1270,1285,2569,1284
2015,11,2,19,1250,1280,2561,1281
2015,11,2,20,1260,1254,2529,1275
2015,11,2,21,1250,1251,2506,1255
2015,11,2,22,1240,1238,2437,1199
2015,11,2,23,1240,1248,2391,1143
2015,11,3,0,1240,1287,2515,1228
2015,11,3,1,1235,1348,2529,1181
2015,11,3,2,1300,1372,2539,1167
2015,11,3,3,1325,1364,2503,1139
2015,11,3,4,1290,1343,2494,1151
2015,11,3,5,1215,1281,2474,1193
2015,11,3,6,1135,1200,2465,1265
2015,11,3,7,1075,1129,2451,1322
2015,11,3,8,1025,1107,2429,1322
2015,11,3,9,1000,1080,2147,1067
2015,11,3,10,990,1070,2136,1066
2015,11,3,11,1005,1069,2226,1157
2015,11,3,12,1025,1114,2273,1159
2015,11,3,13,1080,1176,2431,1255
2015,11,3,14,1215,1320,2531,1211
2015,11,3,15,1310,1401,2553,1152
2015,11,3,16,1320,1406,2540,1134
2015,11,3,17,1305,1401,2577,1176
2015,11,3,18,1300,1391,2580,1189
2015,11,3,19,1280,1395,2562,1167
2015,11,3,20,1260,1386,2565,1179
2015,11,3,21,1270,1368,2540,1172
2015,11,3,22,1265,1367,2523,1156
2015,11,3,23,1240,1402,2539,1137
2015,11,4,0,1255,1447,2592,1145
2015,11,4,1,1255,1494,2562,1068
2015,11,4,2,1320,1494,2578,1084
2015,11,4,3,1350,1461,2586,1125
2015,11,4,4,1320,1431,2590,1159
2015,11,4,5,1245,1369,2566,1197
2015,11,4,6,1170,1258,2485,1227
2015,11,4,7,1095,1187,2476,1289
2015,11,4,8,1035,1167,2477,1310
2015,11,4,9,1020,1135,2477,1342
2015,11,4,10,1025,1117,2480,1363
2015,11,4,11,1020,1124,2503,1379
2015,11,4,12,1065,1123,2476,1353
2015,11,4,13,1120,1180,2454,1274
2015,11,4,14,1265,1303,2447,1144
2015,11,4,15,1345,1382,2499,1117
2015,11,4,16,1365,1370,2507,1137
2015,11,4,17,1350,1353,2507,1154
2015,11,4,18,1335,1335,2501,1166
2015,11,4,19,1325,1311,2514,1203
2015,11,4,20,1315,1287,2496,1209
2015,11,4,21,1305,1291,2516,1225
2015,11,4,22,1295,1289,2542,1253
2015,11,4,23,1285,1298,2532,1234
2015,11,5,0,1295,1344,2554,1210
2015,11,5,1,1330,1400,2577,1177
2015,11,5,2,1370,1415,2590,1175
2015,11,5,3,1385,1389,2597,1208
2015,11,5,4,1355,1372,2633,1261
2015,11,5,5,1300,1311,2543,1232
2015,11,5,6,1240,1218,2481,1263
2015,11,5,7,1160,1153,2364,1211
2015,11,5,8,1075,1124,2367,1243
2015,11,5,9,1065,1100,2334,1234
2015,11,5,10,1060,1096,2330,1234
2015,11,5,11,1050,1094,2306,1212
2015,11,5,12,1070,1111,2376,1265
2015,11,5,13,1130,1172,2504,1332
2015,11,5,14,1260,1307,2555,1248
2015,11,5,15,1345,1374,2635,1261
2015,11,5,16,1325,1381,2620,1239
2015,11,5,17,1325,1385,2654,1269
2015,11,5,18,1320,1367,2632,1265
2015,11,5,19,1330,1352,2649,1297
2015,11,5,20,1315,1334,2666,1332
2015,11,5,21,1300,1339,2697,1358
2015,11,5,22,1295,1335,2691,1356
2015,11,5,23,1315,1343,2704,1361
2015,11,6,0,1350,1375,2671,1296
2015,11,6,1,1410,1457,2831,1374
2015,11,6,2,1405,1457,2878,1421
2015,11,6,3,1385,1428,2836,1408
2015,11,6,4,1340,1391,2815,1424
2015,11,6,5,1280,1315,2760,1445
2015,11,6,6,1200,1248,2755,1507
2015,11,6,7,1110,1188,2735,1547
2015,11,6,8,1075,1147,2747,1600
2015,11,6,9,1055,1140,2746,1606
2015,11,6,10,1070,1118,2681,1563
2015,11,6,11,1060,1119,2691,1572
2015,11,6,12,1085,1128,2710,1582
2015,11,6,13,1135,1162,2721,1559
2015,11,6,14,1270,1296,2680,1384
2015,11,6,15,1340,1349,2757,1408
2015,11,6,16,1325,1359,2692,1333
2015,11,6,17,1310,1342,2742,1400
2015,11,6,18,1295,1323,2763,1440
2015,11,6,19,1285,1308,2735,1427
2015,11,6,20,1265,1295,2742,1447
2015,11,6,21,1250,1287,2399,1112
2015,11,6,22,1255,1279,2577,1298
2015,11,6,23,1255,1290,2599,1309
2015,11,7,0,1295,1312,2780,1468
2015,11,7,1,1340,1395,2827,1432
2015,11,7,2,1380,1400,2846,1446
2015,11,7,3,1350,1361,2817,1456
2015,11,7,4,1340,1327,2806,1479
2015,11,7,5,1280,1279,2631,1352
2015,11,7,6,1180,1226,2672,1446
2015,11,7,7,1105,1178,2842,1664
2015,11,7,8,1050,1139,2813,1674
2015,11,7,9,1030,1120,2624,1504
2015,11,7,10,1025,1115,2640,1525
2015,11,7,11,1020,1109,2635,1526
2015,11,7,12,1040,1113,2643,1530
2015,11,7,13,1060,1155,2827,1672
2015,11,7,14,1165,1196,2831,1635
2015,11,7,15,1250,1234,2657,1423
2015,11,7,16,1280,1260,2641,1381
2015,11,7,17,1300,1284,2652,1368
2015,11,7,18,1285,1270,2779,1509
2015,11,7,19,1280,1267,2782,1515
2015,11,7,20,1275,1244,2760,1516
2015,11,7,21,1265,1208,2630,1422
2015,11,7,22,1255,1185,2597,1412
2015,11,7,23,1250,1178,2623,1445
2015,11,8,0,1275,1215,2648,1433
2015,11,8,1,1340,1320,2775,1455
2015,11,8,2,1340,1346,2822,1476
2015,11,8,3,1330,1325,2819,1494
2015,11,8,4,1310,1282,2804,1522
2015,11,8,5,1250,1240,2775,1535
2015,11,8,6,1185,1195,2755,1560
2015,11,8,7,1115,1125,2792,1667
2015,11,8,8,1070,1093,2794,1701
2015,11,8,9,1040,1089,2768,1679
2015,11,8,10,1025,1070,2733,1663
2015,11,8,11,1015,1067,2653,1586
2015,11,8,12,1030,1071,2663,1592
2015,11,8,13,1060,1084,2612,1528
2015,11,8,14,1120,1121,2623,1502
2015,11,8,15,1165,1175,2689,1514
2015,11,8,16,1205,1207,2690,1483
2015,11,8,17,1225,1228,2714,1486
2015,11,8,18,1220,1229,2715,1486
2015,11,8,19,1215,1230,2729,1499
2015,11,8,20,1200,1205,2715,1510
2015,11,8,21,1195,1202,2691,1489
2015,11,8,22,1190,1216,2219,1003
2015,11,8,23,1200,1218,2056,838
2015,11,9,0,1230,1234,2048,814
2015,11,9,1,1290,1359,2025,666
2015,11,9,2,1330,1369,2027,658
2015,11,9,3,1320,1357,2021,664
2015,11,9,4,1270,1316,2096,780
2015,11,9,5,1165,1236,2172,936
2015,11,9,6,1130,1131,2187,1056
2015,11,9,7,1055,1078,2314,1236
2015,11,9,8,1035,1042,2450,1408
2015,11,9,9,1020,1032,2540,1508
2015,11,9,10,1020,1014,2566,1552
2015,11,9,11,1015,1032,2625,1593
2015,11,9,12,1035,1045,2632,1587
2015,11,9,13,1090,1117,2614,1497
2015,11,9,14,1245,1246,2686,1440
2015,11,9,15,1350,1337,2672,1335
2015,11,9,16,1350,1326,2651,1325
2015,11,9,17,1345,1340,2671,1331
2015,11,9,18,1335,1329,2710,1381
2015,11,9,19,1325,1327,2716,1389
2015,11,9,20,1310,1323,2717,1394
2015,11,9,21,1305,1322,2705,1383
2015,11,9,22,1295,1302,2674,1372
2015,11,9,23,1305,1315,2675,1360
2015,11,10,0,1340,1349,2786,1437
2015,11,10,1,1420,1427,2807,1380
2015,11,10,2,1425,1454,2868,1414
2015,11,10,3,1395,1412,2859,1447
2015,11,10,4,1365,1383,2803,1420
2015,11,10,5,1350,1320,2802,1482
2015,11,10,6,1210,1242,2801,1559
2015,11,10,7,1140,1167,2787,1620
2015,11,10,8,1055,1144,2763,1619
2015,11,10,9,1055,1131,2638,1507
2015,11,10,10,1050,1135,2760,1625
2015,11,10,11,1050,1138,2758,1620
2015,11,10,12,1070,1171,2795,1624
2015,11,10,13,1115,1221,2763,1542
2015,11,10,14,1240,1353,2829,1476
2015,11,10,15,1335,1424,2869,1445
2015,11,10,16,1345,1416,2855,1439
2015,11,10,17,1345,1398,2828,1430
2015,11,10,18,1335,1396,2803,1407
2015,11,10,19,1345,1353,2809,1456
2015,11,10,20,1335,1336,2811,1475
2015,11,10,21,1325,1329,2771,1442
2015,11,10,22,1330,1312,2722,1410
2015,11,10,23,1335,1330,2701,1371
2015,11,11,0,1360,1361,2690,1329
2015,11,11,1,1450,1429,2679,1250
2015,11,11,2,1470,1436,2692,1256
2015,11,11,3,1450,1403,2664,1261
2015,11,11,4,1400,1374,2720,1346
2015,11,11,5,1335,1323,2772,1449
2015,11,11,6,1235,1226,2640,1414
2015,11,11,7,1155,1158,2664,1506
2015,11,11,8,1100,1126,2623,1497
2015,11,11,9,1075,1134,2565,1431
2015,11,11,10,1070,1140,2546,1406
2015,11,11,11,1075,1145,2499,1354
2015,11,11,12,1095,1167,2512,1345
2015,11,11,13,1160,1230,2664,1434
2015,11,11,14,1290,1350,2814,1464
2015,11,11,15,1395,1411,2850,1439
2015,11,11,16,1370,1390,2728,1338
2015,11,11,17,1355,1387,2523,1136
2015,11,11,18,1345,1370,2497,1127
2015,11,11,19,1335,1343,2500,1157
2015,11,11,20,1325,1322,2507,1185
2015,11,11,21,1325,1320,2497,1177
2015,11,11,22,1310,1320,2509,1189
2015,11,11,23,1315,1313,2468,1155
2015,11,12,0,1360,1373,2441,1068
2015,11,12,1,1410,1467,2771,1304
2015,11,12,2,1430,1472,2789,1317
2015,11,12,3,1405,1454,2797,1343
2015,11,12,4,1390,1418,2832,1414
2015,11,12,5,1395,1352,2827,1475
2015,11,12,6,1235,1253,2761,1508
2015,11,12,7,1155,1192,2766,1574
2015,11,12,8,1080,1153,2711,1558
2015,11,12,9,1060,1135,2550,1415
2015,11,12,10,1060,1136,2556,1420
2015,11,12,11,1065,1131,2544,1413
2015,11,12,12,1090,1144,2571,1427
2015,11,12,13,1135,1218,2778,1560
2015,11,12,14,1310,1353,2873,1520
2015,11,12,15,1425,1414,2872,1458
2015,11,12,16,1410,1397,2882,1485
2015,11,12,17,1410,1398,2866,1468
2015,11,12,18,1400,1387,2891,1504
2015,11,12,19,1375,1364,2845,1481
2015,11,12,20,1375,1349,2814,1465
2015,11,12,21,1370,1353,2820,1467
2015,11,12,22,1365,1328,2823,1495
2015,11,12,23,1365,1330,2809,1479
2015,11,13,0,1405,1353,2796,1443
2015,11,13,1,1465,1464,2827,1363
2015,11,13,2,1470,1471,2848,1377
2015,11,13,3,1450,1441,2846,1405
2015,11,13,4,1425,1412,2857,1445
2015,11,13,5,1425,1353,2863,1510
2015,11,13,6,1265,1275,2835,1560
2015,11,13,7,1185,1206,2813,1607
2015,11,13,8,1075,1157,2614,1457
2015,11,13,9,1075,1139,2363,1224
2015,11,13,10,1070,1121,2286,1165
2015,11,13,11,1075,1114,2288,1174
2015,11,13,12,1095,1130,2312,1182
2015,11,13,13,1140,1187,2347,1160
2015,11,13,14,1250,1302,2537,1235
2015,11,13,15,1310,1396,2665,1269
2015,11,13,16,1305,1387,2604,1217
2015,11,13,17,1290,1388,2543,1155
2015,11,13,18,1285,1381,2471,1090
2015,11,13,19,1265,1352,2476,1124
2015,11,13,20,1250,1316,2227,911
2015,11,13,21,1240,1354,1907,553
2015,11,13,22,1240,1353,1890,537
2015,11,13,23,1250,1354,1875,521
2015,11,14,0,1285,1366,1896,530
2015,11,14,1,1350,1444,2031,587
2015,11,14,2,1350,1417,1981,564
2015,11,14,3,1335,1381,1983,602
2015,11,14,4,1295,1351,1967,616
2015,11,14,5,1310,1311,1990,679
2015,11,14,6,1160,1226,1978,752
2015,11,14,7,1095,1145,1970,825
2015,11,14,8,1010,1093,1992,899
2015,11,14,9,1005,1073,1900,827
2015,11,14,10,1000,1077,1917,840
2015,11,14,11,1000,1071,1967,896
2015,11,14,12,1015,1078,2071,993
2015,11,14,13,1050,1111,2077,966
2015,11,14,14,1125,1149,2104,955
2015,11,14,15,1185,1197,2068,871
2015,11,14,16,1195,1236,1991,755
2015,11,14,17,1210,1249,1990,741
2015,11,14,18,1195,1233,1974,741
2015,11,14,19,1190,1213,1934,721
2015,11,14,20,1175,1197,1924,727
2015,11,14,21,1165,1184,1947,763
2015,11,14,22,1150,1191,1985,794
2015,11,14,23,1135,1169,1948,779
2015,11,15,0,1185,1214,1978,764
2015,11,15,1,1260,1299,1960,661
2015,11,15,2,1270,1300,1974,674
2015,11,15,3,1255,1283,1934,651
2015,11,15,4,1215,1232,1895,663
2015,11,15,5,1185,1194,1910,716
2015,11,15,6,1100,1142,1940,798
2015,11,15,7,1045,1088,1980,892
2015,11,15,8,1040,1052,1980,928
2015,11,15,9,1030,1028,1929,901
2015,11,15,10,1025,1031,1942,911
2015,11,15,11,1020,1031,1926,895
2015,11,15,12,1035,1036,1951,915
2015,11,15,13,1070,1064,1967,903
2015,11,15,14,1145,1093,1973,880
2015,11,15,15,1200,1151,1974,823
2015,11,15,16,1215,1178,1935,757
2015,11,15,17,1240,1214,1962,748
2015,11,15,18,1230,1226,1958,732
2015,11,15,19,1230,1214,1941,727
2015,11,15,20,1210,1199,1915,716
2015,11,15,21,1205,1195,1765,570
2015,11,15,22,1210,1185,1752,567
2015,11,15,23,1225,1195,1766,571
2015,11,16,0,1245,1256,1800,544
2015,11,16,1,1345,1360,1946,586
2015,11,16,2,1360,1381,1975,594
2015,11,16,3,1335,1354,1960,606
2015,11,16,4,1295,1326,2020,694
2015,11,16,5,1200,1265,2020,755
2015,11,16,6,1150,1186,1925,739
2015,11,16,7,1085,1130,1865,735
2015,11,16,8,1100,1100,1739,639
2015,11,16,9,1080,1083,1620,537
2015,11,16,10,1075,1083,1573,490
2015,11,16,11,1080,1088,1593,505
2015,11,16,12,1095,1127,1737,610
2015,11,16,13,1160,1176,1964,788
2015,11,16,14,1265,1313,2032,719
2015,11,16,15,1330,1392,2170,778
2015,11,16,16,1305,1382,2135,753
2015,11,16,17,1310,1376,2277,901
2015,11,16,18,1305,1385,2503,1118
2015,11,16,19,1285,1377,2584,1207
2015,11,16,20,1270,1359,2617,1258
2015,11,16,21,1275,1353,2713,1360
2015,11,16,22,1260,1335,2728,1393
2015,11,16,23,1275,1350,2736,1386
2015,11,17,0,1310,1392,2803,1411
2015,11,17,1,1385,1468,2787,1319
2015,11,17,2,1400,1475,2772,1297
2015,11,17,3,1365,1468,2771,1303
2015,11,17,4,1340,1438,2735,1297
2015,11,17,5,1330,1371,2680,1309
2015,11,17,6,1205,1281,2641,1360
2015,11,17,7,1125,1223,2678,1455
2015,11,17,8,1005,1199,2636,1437
2015,11,17,9,990,1158,2339,1181
2015,11,17,10,990,1144,2261,1117
2015,11,17,11,995,1157,2230,1073
2015,11,17,12,1010,1165,2272,1107
2015,11,17,13,1045,1228,2521,1293
2015,11,17,14,1170,1358,2690,1332
2015,11,17,15,1275,1462,2646,1184
2015,11,17,16,1270,1416,2623,1207
2015,11,17,17,1280,1407,2512,1105
2015,11,17,18,1285,1382,2476,1094
2015,11,17,19,1275,1362,2357,995
2015,11,17,20,1260,1333,2217,884
2015,11,17,21,1250,1240,2237,997
2015,11,17,22,1240,1285,2497,1212
2015,11,17,23,1255,1336,2524,1188
2015,11,18,0,1310,1374,2554,1180
2015,11,18,1,1385,1441,2763,1322
2015,11,18,2,1400,1440,2824,1384
2015,11,18,3,1370,1403,2813,1410
2015,11,18,4,1340,1383,2751,1368
2015,11,18,5,1275,1306,2527,1221
2015,11,18,6,1190,1224,2470,1246
2015,11,18,7,1120,1156,2350,1194
2015,11,18,8,1065,1116,2038,922
2015,11,18,9,1060,1071,2032,961
2015,11,18,10,1055,1077,2034,957
2015,11,18,11,1055,1075,1999,924
2015,11,18,12,1080,1096,2021,925
2015,11,18,13,1145,1143,2069,926
2015,11,18,14,1270,1298,2520,1222
2015,11,18,15,1345,1389,2639,1250
2015,11,18,16,1325,1380,2628,1248
2015,11,18,17,1315,1388,2584,1196
2015,11,18,18,1300,1374,2638,1264
2015,11,18,19,1285,1380,2667,1287
2015,11,18,20,1265,1357,2665,1308
2015,11,18,21,1265,1339,2210,871
2015,11,18,22,1260,1332,2091,759
2015,11,18,23,1260,1355,2320,965
2015,11,19,0,1310,1395,2308,913
2015,11,19,1,1380,1493,2710,1217
2015,11,19,2,1390,1490,2689,1199
2015,11,19,3,1375,1466,2674,1208
2015,11,19,4,1345,1446,2581,1135
2015,11,19,5,1345,1371,2608,1237
2015,11,19,6,1185,1278,2648,1370
2015,11,19,7,1120,1224,2788,1564
2015,11,19,8,1095,1175,2709,1534
2015,11,19,9,1065,1153,2777,1624
2015,11,19,10,1060,1158,2782,1624
2015,11,19,11,1070,1164,2822,1658
2015,11,19,12,1095,1195,2800,1605
2015,11,19,13,1155,1241,2809,1568
2015,11,19,14,1320,1359,2805,1446
2015,11,19,15,1440,1444,2800,1356
2015,11,19,16,1415,1416,2791,1375
2015,11,19,17,1415,1421,2817,1396
2015,11,19,18,1400,1403,2802,1399
2015,11,19,19,1375,1395,2874,1479
2015,11,19,20,1360,1378,2873,1495
2015,11,19,21,1315,1367,2853,1486
2015,11,19,22,1325,1368,2852,1484
2015,11,19,23,1345,1364,2840,1476
2015,11,20,0,1395,1413,2780,1367
2015,11,20,1,1470,1495,2782,1287
2015,11,20,2,1465,1503,2756,1253
2015,11,20,3,1430,1469,2752,1283
2015,11,20,4,1410,1451,2786,1335
2015,11,20,5,1440,1374,2759,1385
2015,11,20,6,1265,1317,2701,1384
2015,11,20,7,1185,1230,2688,1458
2015,11,20,8,1095,1198,2715,1517
2015,11,20,9,1075,1168,2657,1489
2015,11,20,10,1075,1157,2653,1496
2015,11,20,11,1070,1157,2568,1411
2015,11,20,12,1085,1175,2606,1431
2015,11,20,13,1145,1225,2640,1415
2015,11,20,14,1250,1364,2689,1325
2015,11,20,15,1315,1452,2716,1264
2015,11,20,16,1310,1437,2754,1317
2015,11,20,17,1305,1454,2786,1332
2015,11,20,18,1295,1454,2792,1338
2015,11,20,19,1290,1425,2703,1278
2015,11,20,20,1270,1402,2687,1285
2015,11,20,21,1270,1385,2651,1266
2015,11,20,22,1270,1358,2638,1280
2015,11,20,23,1285,1361,2650,1289
2015,11,21,0,1315,1412,2664,1252
2015,11,21,1,1385,1489,2676,1187
2015,11,21,2,1370,1491,2641,1150
2015,11,21,3,1345,1467,2660,1193
2015,11,21,4,1325,1467,2685,1218
2015,11,21,5,1315,1423,2684,1261
2015,11,21,6,1190,1368,2675,1307
2015,11,21,7,1120,1300,2696,1396
2015,11,21,8,1170,1265,2705,1440
2015,11,21,9,1155,1234,2713,1479
2015,11,21,10,1155,1248,2705,1457
2015,11,21,11,1150,1241,2698,1457
2015,11,21,12,1165,1265,2712,1447
2015,11,21,13,1210,1290,2691,1401
2015,11,21,14,1265,1326,2733,1407
2015,11,21,15,1330,1392,2817,1425
2015,11,21,16,1330,1417,2820,1403
2015,11,21,17,1345,1441,2772,1331
2015,11,21,18,1345,1427,2774,1347
2015,11,21,19,1315,1400,2768,1368
2015,11,21,20,1305,1382,2768,1386
2015,11,21,21,1290,1339,2762,1423
2015,11,21,22,1280,1325,2768,1443
2015,11,21,23,1270,1325,2769,1444
2015,11,22,0,1310,1385,2872,1487
2015,11,22,1,1400,1492,2961,1469
2015,11,22,2,1420,1481,2907,1426
2015,11,22,3,1390,1458,2908,1450
2015,11,22,4,1345,1438,2904,1466
2015,11,22,5,1330,1384,2855,1471
2015,11,22,6,1235,1339,2858,1519
2015,11,22,7,1165,1270,2863,1593
2015,11,22,8,1105,1239,2876,1637
2015,11,22,9,1090,1222,2756,1534
2015,11,22,10,1080,1215,2722,1507
2015,11,22,11,1090,1204,2704,1500
2015,11,22,12,1100,1228,2827,1599
2015,11,22,13,1130,1232,2819,1587
2015,11,22,14,1185,1271,2823,1552
2015,11,22,15,1245,1316,2864,1548
2015,11,22,16,1250,1348,2881,1533
2015,11,22,17,1265,1363,2898,1535
2015,11,22,18,1265,1354,2908,1554
2015,11,22,19,1245,1339,2897,1558
2015,11,22,20,1245,1331,2889,1558
2015,11,22,21,1230,1310,2870,1560
2015,11,22,22,1225,1304,2841,1537
2015,11,22,23,1230,1301,2827,1526
2015,11,23,0,1275,1355,2862,1507
2015,11,23,1,1365,1460,2926,1466
2015,11,23,2,1380,1450,2774,1324
2015,11,23,3,1345,1428,2823,1395
2015,11,23,4,1310,1394,2793,1399
2015,11,23,5,1245,1321,2757,1436
2015,11,23,6,1175,1236,2793,1557
2015,11,23,7,1110,1175,2778,1603
2015,11,23,8,1060,1146,2721,1575
2015,11,23,9,1045,1126,2727,1601
2015,11,23,10,1040,1117,2734,1617
2015,11,23,11,1040,1127,2717,1590
2015,11,23,12,1065,1167,2705,1538
2015,11,23,13,1130,1208,2696,1488
2015,11,23,14,1260,1339,2719,1380
2015,11,23,15,1365,1448,2699,1251
2015,11,23,16,1340,1421,2665,1244
2015,11,23,17,1335,1408,2669,1261
2015,11,23,18,1330,1375,2667,1292
2015,11,23,19,1310,1360,2700,1340
2015,11,23,20,1300,1339,2693,1354
2015,11,23,21,1295,1334,2705,1371
2015,11,23,22,1290,1312,2699,1387
2015,11,23,23,1285,1308,2706,1398
2015,11,24,0,1330,1352,2710,1358
2015,11,24,1,1405,1434,2735,1301
2015,11,24,2,1420,1465,2756,1291
2015,11,24,3,1390,1443,2758,1315
2015,11,24,4,1360,1406,2752,1346
2015,11,24,5,1365,1354,2747,1393
2015,11,24,6,1220,1265,2712,1447
2015,11,24,7,1145,1181,2624,1443
2015,11,24,8,1125,1160,2713,1553
2015,11,24,9,1110,1146,2712,1566
2015,11,24,10,1100,1143,2662,1519
2015,11,24,11,1115,1160,2692,1532
2015,11,24,12,1130,1195,2726,1531
2015,11,24,13,1165,1267,2740,1473
2015,11,24,14,1265,1350,2739,1389
2015,11,24,15,1350,1442,2730,1288
2015,11,24,16,1335,1435,2729,1294
2015,11,24,17,1335,1453,2789,1336
2015,11,24,18,1325,1442,2798,1356
2015,11,24,19,1310,1450,2835,1385
2015,11,24,20,1300,1439,2848,1409
2015,11,24,21,1265,1449,2866,1417
2015,11,24,22,1270,1449,2830,1381
2015,11,24,23,1280,1459,2832,1373
2015,11,25,0,1330,1503,2862,1359
2015,11,25,1,1405,1571,2867,1296
2015,11,25,2,1410,1570,2875,1305
2015,11,25,3,1370,1538,2865,1327
2015,11,25,4,1355,1504,2834,1330
2015,11,25,5,1350,1458,2842,1384
2015,11,25,6,1200,1375,2809,1434
2015,11,25,7,1135,1327,2810,1483
2015,11,25,8,1195,1272,2800,1528
2015,11,25,9,1160,1238,2711,1473
2015,11,25,10,1165,1235,2712,1477
2015,11,25,11,1170,1243,2680,1437
2015,11,25,12,1200,1267,2694,1427
2015,11,25,13,1260,1323,2744,1421
2015,11,25,14,1385,1423,2752,1329
2015,11,25,15,1485,1497,2790,1293
2015,11,25,16,1455,1531,2826,1295
2015,11,25,17,1460,1543,2837,1294
2015,11,25,18,1425,1533,2802,1269
2015,11,25,19,1405,1513,2797,1284
2015,11,25,20,1390,1487,2745,1258
2015,11,25,21,1385,1476,2722,1246
2015,11,25,22,1370,1458,2517,1059
2015,11,25,23,1380,1451,2503,1052
2015,11,26,0,1435,1493,2530,1037
2015,11,26,1,1515,1572,2726,1154
2015,11,26,2,1520,1574,2754,1180
2015,11,26,3,1495,1554,2712,1158
2015,11,26,4,1465,1530,2710,1180
2015,11,26,5,1485,1485,2729,1244
2015,11,26,6,1305,1417,2724,1307
2015,11,26,7,1230,1351,2701,1350
2015,11,26,8,1225,1309,2710,1401
2015,11,26,9,1205,1290,2642,1352
2015,11,26,10,1205,1285,2657,1372
2015,11,26,11,1215,1282,2655,1373
2015,11,26,12,1240,1291,2657,1366
2015,11,26,13,1305,1336,2701,1365
2015,11,26,14,1350,1376,2714,1338
2015,11,26,15,1400,1440,2711,1271
2015,11,26,16,1375,1500,2737,1237
2015,11,26,17,1380,1515,2754,1239
2015,11,26,18,1365,1520,2765,1245
2015,11,26,19,1345,1500,2754,1254
2015,11,26,20,1335,1472,2705,1233
2015,11,26,21,1335,1420,2722,1302
2015,11,26,22,1335,1364,2713,1349
2015,11,26,23,1335,1330,2714,1384
2015,11,27,0,1385,1363,2688,1325
2015,11,27,1,1455,1416,2669,1253
2015,11,27,2,1465,1436,2640,1204
2015,11,27,3,1430,1445,2624,1179
2015,11,27,4,1390,1451,2672,1221
2015,11,27,5,1400,1435,2691,1256
2015,11,27,6,1260,1388,2654,1266
2015,11,27,7,1190,1343,2687,1344
2015,11,27,8,1310,1320,2701,1381
2015,11,27,9,1295,1291,2729,1438
2015,11,27,10,1290,1302,2711,1409
2015,11,27,11,1300,1297,2678,1381
2015,11,27,12,1330,1321,2707,1386
2015,11,27,13,1395,1362,2728,1366
2015,11,27,14,1460,1412,2703,1291
2015,11,27,15,1505,1481,2710,1229
2015,11,27,16,1490,1500,2705,1205
2015,11,27,17,1485,1498,2711,1213
2015,11,27,18,1475,1492,2668,1176
2015,11,27,19,1460,1479,2629,1150
2015,11,27,20,1440,1440,2624,1184
2015,11,27,21,1450,1415,2647,1232
2015,11,27,22,1445,1388,2631,1243
2015,11,27,23,1445,1394,2651,1257
2015,11,28,0,1490,1449,2668,1219
2015,11,28,1,1570,1546,2717,1171
2015,11,28,2,1565,1546,2732,1186
2015,11,28,3,1540,1543,2753,1210
2015,11,28,4,1505,1517,2749,1232
2015,11,28,5,1505,1479,2715,1236
2015,11,28,6,1380,1434,2742,1308
2015,11,28,7,1305,1365,2736,1371
2015,11,28,8,1275,1344,2751,1407
2015,11,28,9,1260,1316,2739,1423
2015,11,28,10,1265,1314,2729,1415
2015,11,28,11,1270,1309,2728,1419
2015,11,28,12,1295,1315,2723,1408
2015,11,28,13,1345,1349,2709,1360
2015,11,28,14,1370,1389,2724,1335
2015,11,28,15,1415,1444,2742,1298
2015,11,28,16,1430,1469,2722,1253
2015,11,28,17,1455,1490,2709,1219
2015,11,28,18,1445,1473,2686,1213
2015,11,28,19,1430,1443,2685,1242
2015,11,28,20,1410,1422,2687,1265
2015,11,28,21,1400,1378,2684,1306
2015,11,28,22,1400,1378,2706,1328
2015,11,28,23,1395,1372,2754,1382
2015,11,29,0,1450,1438,2786,1348
2015,11,29,1,1535,1543,2823,1280
2015,11,29,2,1540,1543,2804,1261
2015,11,29,3,1515,1530,2726,1196
2015,11,29,4,1475,1509,2744,1235
2015,11,29,5,1415,1465,2716,1251
2015,11,29,6,1350,1394,2701,1307
2015,11,29,7,1285,1336,2703,1367
2015,11,29,8,1210,1308,2735,1427
2015,11,29,9,1195,1286,2727,1441
2015,11,29,10,1190,1304,2730,1426
2015,11,29,11,1200,1303,2699,1396
2015,11,29,12,1220,1318,2771,1453
2015,11,29,13,1255,1340,2779,1439
2015,11,29,14,1315,1389,2761,1372
2015,11,29,15,1390,1440,2740,1300
2015,11,29,16,1405,1465,2727,1262
2015,11,29,17,1425,1481,2696,1215
2015,11,29,18,1420,1480,2717,1237
2015,11,29,19,1420,1460,2708,1248
2015,11,29,20,1400,1440,2751,1311
2015,11,29,21,1410,1418,2744,1326
2015,11,29,22,1400,1416,2810,1394
2015,11,29,23,1410,1420,2808,1388
2015,11,30,0,1465,1489,2836,1347
2015,11,30,1,1555,1601,2803,1202
2015,11,30,2,1560,1613,2802,1189
2015,11,30,3,1525,1590,2765,1175
2015,11,30,4,1490,1549,2759,1210
2015,11,30,5,1390,1482,2728,1246
2015,11,30,6,1335,1406,2732,1326
2015,11,30,7,1270,1323,2756,1433
2015,11,30,8,1195,1289,2733,1444
2015,11,30,9,1160,1274,2727,1453
2015,11,30,10,1160,1274,2756,1482
2015,11,30,11,1170,1284,2765,1481
2015,11,30,12,1210,1300,2764,1464
2015,11,30,13,1255,1355,2754,1399
2015,11,30,14,1335,1495,2737,1242
2015,11,30,15,1390,1590,2750,1160
2015,11,30,16,1365,1576,2698,1122
2015,11,30,17,1360,1564,2686,1122
2015,11,30,18,1330,1551,2661,1110
2015,11,30,19,1305,1526,2706,1180
2015,11,30,20,1285,1502,2718,1216
2015,11,30,21,1290,1486,2693,1207
2015,11,30,22,1265,1463,2709,1246
2015,11,30,23,1270,1471,2706,1235
2015,12,1,0,1315,1528,2720,1192
2015,12,1,1,1395,1636,2755,1119
2015,12,1,2,1420,1648,2772,1124
2015,12,1,3,1395,1635,2779,1144
2015,12,1,4,1365,1595,2805,1210
2015,12,1,5,1390,1527,2791,1264
2015,12,1,6,1210,1432,2784,1352
2015,12,1,7,1135,1380,2801,1421
2015,12,1,8,1180,1337,2806,1469
2015,12,1,9,1160,1337,2763,1426
2015,12,1,10,1170,1342,2761,1419
2015,12,1,11,1185,1338,2798,1460
2015,12,1,12,1205,1368,2885,1517
2015,12,1,13,1255,1418,2890,1472
2015,12,1,14,1360,1556,2937,1381
2015,12,1,15,1455,1631,2922,1291
2015,12,1,16,1455,1602,2870,1268
2015,12,1,17,1465,1578,2867,1289
2015,12,1,18,1445,1550,2864,1314
2015,12,1,19,1435,1522,2862,1340
2015,12,1,20,1410,1510,2856,1346
2015,12,1,21,1390,1479,2615,1136
2015,12,1,22,1400,1466,2591,1125
2015,12,1,23,1410,1464,2564,1100
2015,12,2,0,1470,1514,2520,1006
2015,12,2,1,1545,1614,2592,978
2015,12,2,2,1560,1623,2573,950
2015,12,2,3,1535,1611,2580,969
2015,12,2,4,1500,1574,2636,1062
2015,12,2,5,1455,1508,2605,1097
2015,12,2,6,1350,1412,2601,1189
2015,12,2,7,1270,1351,2615,1264
2015,12,2,8,1230,1300,2692,1392
2015,12,2,9,1210,1297,2767,1470
2015,12,2,10,1200,1282,2805,1523
2015,12,2,11,1205,1285,2777,1492
2015,12,2,12,1230,1309,2793,1484
2015,12,2,13,1280,1360,2775,1415
2015,12,2,14,1420,1497,2812,1315
2015,12,2,15,1520,1580,2862,1282
2015,12,2,16,1510,1552,2846,1294
2015,12,2,17,1515,1544,2844,1300
2015,12,2,18,1500,1522,2846,1324
2015,12,2,19,1480,1511,2893,1382
2015,12,2,20,1465,1502,2862,1360
2015,12,2,21,1455,1498,2589,1091
2015,12,2,22,1445,1486,2048,562
2015,12,2,23,1450,1499,1944,445
2015,12,3,0,1500,1570,1982,412
2015,12,3,1,1590,1621,1994,373
2015,12,3,2,1590,1614,1994,380
2015,12,3,3,1565,1581,1986,405
2015,12,3,4,1535,1541,1985,444
2015,12,3,5,1520,1472,2005,533
2015,12,3,6,1395,1392,1990,598
2015,12,3,7,1315,1313,1989,676
2015,12,3,8,1140,1286,1927,641
2015,12,3,9,1135,1254,1900,646
2015,12,3,10,1140,1259,1935,676
2015,12,3,11,1140,1252,2027,775
2015,12,3,12,1155,1264,2039,775
2015,12,3,13,1215,1314,2036,722
2015,12,3,14,1390,1445,2083,638
2015,12,3,15,1550,1550,2089,539
2015,12,3,16,1545,1534,2050,516
2015,12,3,17,1535,1518,2045,527
2015,12,3,18,1520,1478,2029,551
2015,12,3,19,1490,1445,2030,585
2015,12,3,20,1475,1411,2029,618
2015,12,3,21,1445,1398,1991,593
2015,12,3,22,1415,1388,1991,603
2015,12,3,23,1415,1403,1986,583
2015,12,4,0,1470,1470,2020,550
2015,12,4,1,1540,1532,2074,542
2015,12,4,2,1555,1536,2049,513
2015,12,4,3,1530,1516,2024,508
2015,12,4,4,1515,1471,2032,561
2015,12,4,5,1550,1417,2048,631
2015,12,4,6,1380,1320,2019,699
2015,12,4,7,1315,1257,2008,751
2015,12,4,8,1085,1212,2008,796
2015,12,4,9,1070,1167,1848,681
2015,12,4,10,1065,1159,1806,647
2015,12,4,11,1065,1160,1851,691
2015,12,4,12,1085,1197,1854,657
2015,12,4,13,1135,1251,1889,638
2015,12,4,14,1240,1384,2079,695
2015,12,4,15,1320,1466,2056,590
2015,12,4,16,1295,1437,2135,698
2015,12,4,17,1295,1420,2131,711
2015,12,4,18,1280,1398,2069,671
2015,12,4,19,1270,1383,2105,722
2015,12,4,20,1250,1371,2087,716
2015,12,4,21,1240,1364,1946,582
2015,12,4,22,1225,1350,1772,422
2015,12,4,23,1245,1362,1788,426
2015,12,5,0,1290,1402,1840,438
2015,12,5,1,1355,1484,2140,656
2015,12,5,2,1360,1450,2109,659
2015,12,5,3,1335,1413,2028,615
2015,12,5,4,1305,1388,2079,691
2015,12,5,5,1320,1356,2067,711
2015,12,5,6,1205,1274,2035,761
2015,12,5,7,1130,1218,2077,859
2015,12,5,8,1085,1173,2037,864
2015,12,5,9,1065,1148,2038,890
2015,12,5,10,1075,1142,2059,917
2015,12,5,11,1065,1165,2082,917
2015,12,5,12,1075,1179,2088,909
2015,12,5,13,1105,1213,2101,888
2015,12,5,14,1215,1268,2112,844
2015,12,5,15,1330,1336,2103,767
2015,12,5,16,1335,1366,2099,733
2015,12,5,17,1350,1380,2097,717
2015,12,5,18,1325,1373,2102,729
2015,12,5,19,1295,1363,2094,731
2015,12,5,20,1275,1347,2114,767
2015,12,5,21,1250,1321,2134,813
2015,12,5,22,1235,1292,2136,844
2015,12,5,23,1250,1293,2255,962
2015,12,6,0,1310,1343,2316,973
2015,12,6,1,1345,1425,2442,1017
2015,12,6,2,1355,1426,2508,1082
2015,12,6,3,1325,1415,2458,1043
2015,12,6,4,1295,1405,2172,767
2015,12,6,5,1330,1371,2048,677
2015,12,6,6,1215,1323,2037,714
2015,12,6,7,1155,1254,2015,761
2015,12,6,8,1100,1215,1926,711
2015,12,6,9,1080,1201,1843,642
2015,12,6,10,1090,1174,1689,515
2015,12,6,11,1090,1160,1699,539
2015,12,6,12,1095,1162,1664,502
2015,12,6,13,1120,1174,1741,567
2015,12,6,14,1230,1209,1724,515
2015,12,6,15,1345,1273,1786,513
2015,12,6,16,1360,1323,1942,619
2015,12,6,17,1365,1361,1971,610
2015,12,6,18,1345,1366,1987,621
2015,12,6,19,1335,1358,1982,624
2015,12,6,20,1305,1363,1994,631
2015,12,6,21,1290,1357,2030,673
2015,12,6,22,1285,1361,2076,715
2015,12,6,23,1300,1373,2084,711
2015,12,7,0,1355,1426,2108,682
2015,12,7,1,1395,1501,2135,634
2015,12,7,2,1410,1498,2105,607
2015,12,7,3,1380,1468,2083,615
2015,12,7,4,1340,1438,2099,661
2015,12,7,5,1345,1370,2068,698
2015,12,7,6,1230,1271,2068,797
2015,12,7,7,1165,1200,2057,857
2015,12,7,8,1090,1154,2028,874
2015,12,7,9,1065,1131,2008,877
2015,12,7,10,1065,1126,1934,808
2015,12,7,11,1075,1126,1849,723
2015,12,7,12,1090,1147,1859,712
2015,12,7,13,1130,1208,2085,877
2015,12,7,14,1295,1346,2132,786
2015,12,7,15,1440,1449,2095,646
2015,12,7,16,1425,1425,1997,572
2015,12,7,17,1420,1424,1995,571
2015,12,7,18,1395,1416,1980,564
2015,12,7,19,1365,1414,2015,601
2015,12,7,20,1345,1402,2002,600
2015,12,7,21,1330,1400,2037,637
2015,12,7,22,1315,1415,2074,659
2015,12,7,23,1325,1416,2123,707
2015,12,8,0,1385,1486,2172,686
2015,12,8,1,1420,1494,2167,673
2015,12,8,2,1430,1489,2215,726
2015,12,8,3,1405,1462,2403,941
2015,12,8,4,1360,1427,2539,1112
2015,12,8,5,1440,1364,2441,1077
2015,12,8,6,1260,1254,2177,923
2015,12,8,7,1195,1175,2216,1041
2015,12,8,8,1035,1141,2440,1299
2015,12,8,9,1030,1126,2380,1254
2015,12,8,10,1025,1118,2347,1229
2015,12,8,11,1020,1120,2325,1205
2015,12,8,12,1035,1139,2397,1258
2015,12,8,13,1070,1214,2613,1399
2015,12,8,14,1170,1336,2752,1416
2015,12,8,15,1265,1418,2773,1355
2015,12,8,16,1265,1390,2773,1383
2015,12,8,17,1275,1371,2570,1199
2015,12,8,18,1265,1344,2352,1008
2015,12,8,19,1255,1345,2245,900
2015,12,8,20,1250,1330,2242,912
2015,12,8,21,1245,1333,2186,853
2015,12,8,22,1240,1330,2118,788
2015,12,8,23,1250,1337,2078,741
2015,12,9,0,1300,1400,2061,661
2015,12,9,1,1365,1462,2208,746
2015,12,9,2,1370,1470,2334,864
2015,12,9,3,1345,1458,2465,1007
2015,12,9,4,1315,1431,2511,1080
2015,12,9,5,1265,1360,2335,975
2015,12,9,6,1170,1256,2233,977
2015,12,9,7,1105,1169,2204,1035
2015,12,9,8,1035,1126,2093,967
2015,12,9,9,1030,1079,1865,786
2015,12,9,10,1025,1075,1701,626
2015,12,9,11,1020,1060,1699,639
2015,12,9,12,1040,1077,1738,661
2015,12,9,13,1130,1132,1909,777
2015,12,9,14,1240,1257,1984,727
2015,12,9,15,1360,1360,1956,596
2015,12,9,16,1335,1346,1971,625
2015,12,9,17,1330,1344,1996,652
2015,12,9,18,1315,1354,2094,740
2015,12,9,19,1320,1355,2103,748
2015,12,9,20,1300,1348,2321,973
2015,12,9,21,1300,1352,2347,995
2015,12,9,22,1310,1341,2326,985
2015,12,9,23,1320,1361,2190,829
2015,12,10,0,1370,1416,2195,779
2015,12,10,1,1410,1470,2231,761
2015,12,10,2,1410,1480,2296,816
2015,12,10,3,1390,1457,2474,1017
2015,12,10,4,1370,1438,2574,1136
2015,12,10,5,1360,1371,2595,1224
2015,12,10,6,1205,1288,2470,1182
2015,12,10,7,1125,1212,2444,1232
2015,12,10,8,1145,1181,2404,1223
2015,12,10,9,1135,1155,2258,1103
2015,12,10,10,1130,1146,2226,1080
2015,12,10,11,1120,1133,1932,799
2015,12,10,12,1120,1161,2015,854
2015,12,10,13,1175,1216,2300,1084
2015,12,10,14,1315,1331,2474,1143
2015,12,10,15,1430,1425,2436,1011
2015,12,10,16,1415,1423,2368,945
2015,12,10,17,1410,1444,2336,892
2015,12,10,18,1400,1469,2298,829
2015,12,10,19,1385,1478,2311,833
2015,12,10,20,1360,1478,2350,872
2015,12,10,21,1350,1447,2205,758
2015,12,10,22,1340,1407,1867,460
2015,12,10,23,1340,1400,1792,392
2015,12,11,0,1395,1464,1910,446
2015,12,11,1,1435,1507,2084,577
2015,12,11,2,1440,1520,2347,827
2015,12,11,3,1425,1506,2444,938
2015,12,11,4,1400,1451,2448,997
2015,12,11,5,1430,1380,2356,976
2015,12,11,6,1280,1298,2356,1058
2015,12,11,7,1205,1216,2347,1131
2015,12,11,8,1150,1187,2357,1170
2015,12,11,9,1140,1161,2369,1208
2015,12,11,10,1145,1144,2337,1193
2015,12,11,11,1120,1155,2327,1172
2015,12,11,12,1135,1174,2286,1112
2015,12,11,13,1190,1226,2314,1088
2015,12,11,14,1255,1343,2405,1062
2015,12,11,15,1325,1448,2534,1086
2015,12,11,16,1310,1435,2475,1040
2015,12,11,17,1290,1412,2480,1068
2015,12,11,18,1290,1399,2457,1058
2015,12,11,19,1290,1378,2451,1073
2015,12,11,20,1270,1347,2446,1099
2015,12,11,21,1255,1324,2449,1125
2015,12,11,22,1245,1320,2442,1122
2015,12,11,23,1270,1306,2425,1119
2015,12,12,0,1310,1362,2154,792
2015,12,12,1,1380,1434,1858,424
2015,12,12,2,1375,1420,1836,416
2015,12,12,3,1340,1384,1837,453
2015,12,12,4,1310,1361,1844,483
2015,12,12,5,1325,1321,1828,507
2015,12,12,6,1195,1262,1839,577
2015,12,12,7,1120,1189,1789,600
2015,12,12,8,1175,1171,1809,638
2015,12,12,9,1160,1147,1852,705
2015,12,12,10,1150,1133,1844,711
2015,12,12,11,1150,1130,1830,700
2015,12,12,12,1165,1147,1831,684
2015,12,12,13,1205,1173,1826,653
2015,12,12,14,1255,1216,1804,588
2015,12,12,15,1315,1281,1620,339
2015,12,12,16,1325,1333,1638,305
2015,12,12,17,1335,1355,1847,492
2015,12,12,18,1350,1332,1821,489
2015,12,12,19,1335,1307,1846,539
2015,12,12,20,1325,1278,1842,564
2015,12,12,21,1305,1258,1823,565
2015,12,12,22,1280,1256,1829,573
2015,12,12,23,1285,1270,1861,591
2015,12,13,0,1335,1342,1879,537
2015,12,13,1,1405,1441,1896,455
2015,12,13,2,1415,1422,1836,414
2015,12,13,3,1385,1394,1832,438
2015,12,13,4,1360,1369,1837,468
2015,12,13,5,1315,1323,1726,403
2015,12,13,6,1245,1275,1776,501
2015,12,13,7,1175,1212,1903,691
2015,12,13,8,1180,1164,1913,749
2015,12,13,9,1160,1140,1936,796
2015,12,13,10,1155,1130,2077,947
2015,12,13,11,1150,1130,2066,936
2015,12,13,12,1165,1135,1937,802
2015,12,13,13,1185,1158,2018,860
2015,12,13,14,1210,1212,2219,1007
2015,12,13,15,1265,1286,2325,1039
2015,12,13,16,1280,1316,2332,1016
2015,12,13,17,1290,1347,2361,1014
2015,12,13,18,1310,1331,2363,1032
2015,12,13,19,1310,1334,2405,1071
2015,12,13,20,1300,1319,2462,1143
2015,12,13,21,1295,1314,2484,1170
2015,12,13,22,1285,1309,2479,1170
2015,12,13,23,1290,1325,2454,1129
2015,12,14,0,1340,1399,2535,1136
2015,12,14,1,1410,1493,2572,1079
2015,12,14,2,1420,1480,2517,1037
2015,12,14,3,1400,1464,2537,1073
2015,12,14,4,1360,1437,2315,878
2015,12,14,5,1265,1390,2294,904
2015,12,14,6,1210,1291,2243,952
2015,12,14,7,1135,1224,2401,1177
2015,12,14,8,1140,1177,2283,1106
2015,12,14,9,1120,1159,2248,1089
2015,12,14,10,1120,1149,2292,1143
2015,12,14,11,1120,1149,2317,1168
2015,12,14,12,1150,1183,2349,1166
2015,12,14,13,1195,1255,2491,1236
2015,12,14,14,1335,1398,2499,1101
2015,12,14,15,1460,1475,2555,1080
2015,12,14,16,1450,1471,2576,1105
2015,12,14,17,1445,1461,2589,1128
2015,12,14,18,1450,1461,2637,1176
2015,12,14,19,1450,1463,2610,1147
2015,12,14,20,1425,1463,2560,1097
2015,12,14,21,1420,1471,2603,1132
2015,12,14,22,1415,1435,2597,1162
2015,12,14,23,1410,1447,2582,1135
2015,12,15,0,1470,1527,2627,1100
2015,12,15,1,1530,1624,2698,1074
2015,12,15,2,1535,1619,2686,1067
2015,12,15,3,1515,1598,2672,1074
2015,12,15,4,1480,1560,2699,1139
2015,12,15,5,1460,1506,2708,1202
2015,12,15,6,1310,1392,2669,1277
2015,12,15,7,1225,1315,2656,1341
2015,12,15,8,1260,1270,2632,1362
2015,12,15,9,1245,1248,2672,1424
2015,12,15,10,1235,1237,2675,1438
2015,12,15,11,1245,1223,2652,1429
2015,12,15,12,1260,1233,2567,1334
2015,12,15,13,1290,1297,2576,1279
2015,12,15,14,1380,1398,2623,1225
2015,12,15,15,1455,1503,2674,1171
2015,12,15,16,1455,1481,2611,1130
2015,12,15,17,1460,1473,2583,1110
2015,12,15,18,1435,1460,2608,1148
2015,12,15,19,1440,1447,2562,1115
2015,12,15,20,1420,1418,2430,1012
2015,12,15,21,1410,1419,2460,1041
2015,12,15,22,1405,1377,2449,1072
2015,12,15,23,1415,1398,2419,1021
2015,12,16,0,1480,1463,2498,1035
2015,12,16,1,1575,1567,2633,1066
2015,12,16,2,1570,1561,2654,1093
2015,12,16,3,1545,1547,2669,1122
2015,12,16,4,1520,1527,2647,1120
2015,12,16,5,1455,1478,2611,1133
2015,12,16,6,1345,1380,2604,1224
2015,12,16,7,1270,1283,2679,1396
2015,12,16,8,1305,1244,2530,1286
2015,12,16,9,1280,1209,2182,973
2015,12,16,10,1270,1208,2162,954
2015,12,16,11,1260,1207,2162,955
2015,12,16,12,1280,1217,2153,936
2015,12,16,13,1350,1276,2143,867
2015,12,16,14,1465,1411,2155,744
2015,12,16,15,1545,1502,2199,697
2015,12,16,16,1530,1499,2476,977
2015,12,16,17,1510,1492,2519,1027
2015,12,16,18,1500,1509,2573,1064
2015,12,16,19,1495,1479,2559,1080
2015,12,16,20,1490,1481,2499,1018
2015,12,16,21,1485,1466,2499,1033
2015,12,16,22,1470,1455,2510,1055
2015,12,16,23,1500,1470,2506,1036
2015,12,17,0,1560,1532,2581,1049
2015,12,17,1,1645,1608,2667,1059
2015,12,17,2,1645,1607,2679,1072
2015,12,17,3,1615,1571,2638,1067
2015,12,17,4,1570,1534,2624,1090
2015,12,17,5,1545,1479,2647,1168
2015,12,17,6,1405,1380,2598,1218
2015,12,17,7,1315,1298,2578,1280
2015,12,17,8,1235,1254,2554,1300
2015,12,17,9,1210,1236,2413,1177
2015,12,17,10,1210,1228,2406,1178
2015,12,17,11,1200,1247,2386,1139
2015,12,17,12,1220,1282,2495,1213
2015,12,17,13,1285,1330,2512,1182
2015,12,17,14,1390,1463,2565,1102
2015,12,17,15,1505,1568,2586,1018
2015,12,17,16,1485,1540,2554,1014
2015,12,17,17,1470,1514,2649,1135
2015,12,17,18,1470,1510,2620,1110
2015,12,17,19,1455,1475,2593,1118
2015,12,17,20,1430,1450,2598,1148
2015,12,17,21,1425,1447,2614,1167
2015,12,17,22,1395,1450,2643,1193
2015,12,17,23,1415,1462,2640,1178
2015,12,18,0,1475,1546,2687,1141
2015,12,18,1,1540,1609,2721,1112
2015,12,18,2,1550,1623,2711,1088
2015,12,18,3,1530,1597,2690,1093
2015,12,18,4,1490,1570,2775,1205
2015,12,18,5,1505,1515,2773,1258
2015,12,18,6,1350,1418,2731,1313
2015,12,18,7,1265,1337,2726,1389
2015,12,18,8,1165,1296,2756,1460
2015,12,18,9,1125,1269,2762,1493
2015,12,18,10,1120,1263,2738,1475
2015,12,18,11,1125,1262,2689,1427
2015,12,18,12,1150,1275,2687,1412
2015,12,18,13,1210,1332,2692,1360
2015,12,18,14,1325,1451,2674,1223
2015,12,18,15,1390,1538,2643,1105
2015,12,18,16,1380,1518,2581,1063
2015,12,18,17,1355,1483,2216,733
2015,12,18,18,1355,1477,2164,687
2015,12,18,19,1345,1441,2121,680
2015,12,18,20,1325,1413,2092,679
2015,12,18,21,1310,1399,2102,703
2015,12,18,22,1300,1380,2126,746
2015,12,18,23,1305,1386,2164,778
2015,12,19,0,1355,1440,2353,913
2015,12,19,1,1445,1525,2515,990
2015,12,19,2,1435,1532,2663,1131
2015,12,19,3,1395,1496,2654,1158
2015,12,19,4,1375,1461,2634,1173
2015,12,19,5,1390,1419,2469,1050
2015,12,19,6,1245,1350,2452,1102
2015,12,19,7,1180,1285,2629,1344
2015,12,19,8,1230,1232,2617,1385
2015,12,19,9,1200,1228,2651,1423
2015,12,19,10,1185,1213,2680,1467
2015,12,19,11,1195,1197,2665,1468
2015,12,19,12,1210,1203,2670,1467
2015,12,19,13,1255,1235,2710,1475
2015,12,19,14,1320,1287,2681,1394
2015,12,19,15,1370,1346,2531,1185
2015,12,19,16,1385,1377,2570,1193
2015,12,19,17,1385,1402,2729,1327
2015,12,19,18,1380,1412,2735,1323
2015,12,19,19,1365,1392,2675,1283
2015,12,19,20,1350,1379,2667,1288
2015,12,19,21,1335,1379,2692,1313
2015,12,19,22,1320,1392,2678,1286
2015,12,19,23,1335,1417,2664,1247
2015,12,20,0,1390,1464,2629,1165
2015,12,20,1,1475,1534,2318,784
2015,12,20,2,1480,1513,2163,650
2015,12,20,3,1450,1468,2060,592
2015,12,20,4,1420,1446,2035,589
2015,12,20,5,1370,1390,2015,625
2015,12,20,6,1300,1338,2016,678
2015,12,20,7,1225,1272,2217,945
2015,12,20,8,1165,1232,2428,1196
2015,12,20,9,1150,1219,2662,1443
2015,12,20,10,1135,1201,2687,1486
2015,12,20,11,1150,1203,2715,1512
2015,12,20,12,1155,1217,2656,1439
2015,12,20,13,1185,1230,2509,1279
2015,12,20,14,1245,1284,2505,1221
2015,12,20,15,1320,1365,2508,1143
2015,12,20,16,1330,1394,2576,1182
2015,12,20,17,1330,1432,2641,1209
2015,12,20,18,1325,1430,2632,1202
2015,12,20,19,1320,1407,2597,1190
2015,12,20,20,1305,1395,2581,1186
2015,12,20,21,1295,1381,2635,1254
2015,12,20,22,1295,1369,2674,1305
2015,12,20,23,1320,1367,2720,1353
2015,12,21,0,1385,1429,2736,1307
2015,12,21,1,1460,1541,2832,1291
2015,12,21,2,1460,1556,2828,1272
2015,12,21,3,1435,1554,2846,1292
2015,12,21,4,1410,1507,2804,1297
2015,12,21,5,1320,1463,2800,1337
2015,12,21,6,1255,1384,2780,1396
2015,12,21,7,1175,1299,2672,1373
2015,12,21,8,1155,1266,2620,1354
2015,12,21,9,1135,1241,2608,1367
2015,12,21,10,1125,1229,2582,1353
2015,12,21,11,1135,1218,2642,1424
2015,12,21,12,1155,1233,2704,1471
2015,12,21,13,1210,1295,2770,1475
2015,12,21,14,1380,1421,2774,1353
2015,12,21,15,1520,1511,2793,1282
2015,12,21,16,1510,1513,2779,1266
2015,12,21,17,1485,1505,2769,1264
2015,12,21,18,1475,1493,2733,1240
2015,12,21,19,1460,1494,2777,1283
2015,12,21,20,1440,1450,2712,1262
2015,12,21,21,1440,1445,2692,1247
2015,12,21,22,1440,1444,2626,1182
2015,12,21,23,1450,1435,2644,1209
2015,12,22,0,1525,1505,2641,1136
2015,12,22,1,1600,1589,2628,1039
2015,12,22,2,1600,1593,2661,1068
2015,12,22,3,1580,1566,2673,1107
2015,12,22,4,1540,1512,2611,1099
2015,12,22,5,1520,1442,2593,1151
2015,12,22,6,1370,1347,2459,1112
2015,12,22,7,1275,1260,2426,1166
2015,12,22,8,1165,1214,2381,1167
2015,12,22,9,1150,1189,2401,1212
2015,12,22,10,1140,1186,2393,1207
2015,12,22,11,1130,1192,2481,1289
2015,12,22,12,1140,1219,2538,1319
2015,12,22,13,1195,1283,2751,1468
2015,12,22,14,1320,1387,2741,1354
2015,12,22,15,1445,1479,2772,1293
2015,12,22,16,1450,1497,2797,1300
2015,12,22,17,1455,1496,2815,1319
2015,12,22,18,1450,1500,2820,1320
2015,12,22,19,1435,1489,2819,1330
2015,12,22,20,1415,1463,2787,1324
2015,12,22,21,1405,1446,2762,1316
2015,12,22,22,1385,1441,2738,1297
2015,12,22,23,1400,1434,2580,1146
2015,12,23,0,1465,1488,2562,1074
2015,12,23,1,1575,1573,2743,1170
2015,12,23,2,1570,1602,2781,1179
2015,12,23,3,1555,1566,2794,1228
2015,12,23,4,1520,1528,2754,1226
2015,12,23,5,1445,1466,2712,1246
2015,12,23,6,1375,1400,2717,1317
2015,12,23,7,1280,1317,2712,1395
2015,12,23,8,1225,1270,2699,1429
2015,12,23,9,1190,1259,2673,1414
2015,12,23,10,1185,1226,2475,1249
2015,12,23,11,1180,1246,2476,1230
2015,12,23,12,1195,1264,2488,1224
2015,12,23,13,1260,1318,2520,1202
2015,12,23,14,1395,1415,2525,1110
2015,12,23,15,1485,1517,2487,970
2015,12,23,16,1470,1528,2619,1091
2015,12,23,17,1465,1535,2651,1116
2015,12,23,18,1460,1523,2526,1003
2015,12,23,19,1450,1491,2517,1026
2015,12,23,20,1420,1480,2510,1030
2015,12,23,21,1415,1459,2515,1056
2015,12,23,22,1410,1448,2479,1031
2015,12,23,23,1425,1449,2528,1079
2015,12,24,0,1480,1509,2695,1186
2015,12,24,1,1565,1589,2727,1138
2015,12,24,2,1570,1581,2713,1132
2015,12,24,3,1545,1563,2692,1129
2015,12,24,4,1505,1548,2552,1004
2015,12,24,5,1485,1513,2614,1101
2015,12,24,6,1340,1425,2606,1181
2015,12,24,7,1260,1353,2709,1356
2015,12,24,8,1160,1299,2702,1403
2015,12,24,9,1145,1260,2501,1241
2015,12,24,10,1140,1238,2336,1098
2015,12,24,11,1160,1240,2377,1137
2015,12,24,12,1170,1255,2522,1267
2015,12,24,13,1220,1272,2520,1248
2015,12,24,14,1300,1349,2523,1174
2015,12,24,15,1410,1424,2530,1106
2015,12,24,16,1390,1482,2723,1241
2015,12,24,17,1385,1498,2754,1256
2015,12,24,18,1400,1491,2596,1105
2015,12,24,19,1390,1463,2622,1159
2015,12,24,20,1365,1414,2599,1185
2015,12,24,21,1355,1392,2609,1217
2015,12,24,22,1345,1366,2577,1211
2015,12,24,23,1345,1373,2552,1179
2015,12,25,0,1405,1418,2548,1130
2015,12,25,1,1475,1486,2681,1195
2015,12,25,2,1485,1469,2639,1170
2015,12,25,3,1460,1441,2615,1174
2015,12,25,4,1430,1431,2618,1187
2015,12,25,5,1405,1407,2484,1077
2015,12,25,6,1320,1354,2495,1141
2015,12,25,7,1240,1303,2529,1226
2015,12,25,8,1200,1269,2548,1279
2015,12,25,9,1185,1246,2717,1471
2015,12,25,10,1175,1225,2711,1486
2015,12,25,11,1185,1222,2723,1501
2015,12,25,12,1210,1244,2734,1490
2015,12,25,13,1265,1278,2740,1462
2015,12,25,14,1345,1334,2707,1373
2015,12,25,15,1440,1389,2506,1117
2015,12,25,16,1420,1437,2503,1066
2015,12,25,17,1435,1444,2501,1057
2015,12,25,18,1440,1435,2568,1133
2015,12,25,19,1435,1400,2698,1298
2015,12,25,20,1420,1400,2672,1272
2015,12,25,21,1395,1368,2523,1155
2015,12,25,22,1380,1336,2482,1146
2015,12,25,23,1350,1351,2420,1069
2015,12,26,0,1435,1396,2433,1037
2015,12,26,1,1510,1464,2586,1122
2015,12,26,2,1500,1469,2621,1152
2015,12,26,3,1465,1462,2642,1180
2015,12,26,4,1440,1465,2656,1191
2015,12,26,5,1420,1432,2634,1202
2015,12,26,6,1325,1372,2638,1266
2015,12,26,7,1250,1325,2641,1316
2015,12,26,8,1255,1289,2630,1341
2015,12,26,9,1235,1276,2609,1333
2015,12,26,10,1220,1273,2600,1327
2015,12,26,11,1215,1279,2609,1330
2015,12,26,12,1235,1296,2644,1348
2015,12,26,13,1270,1320,2655,1335
2015,12,26,14,1320,1358,2658,1300
2015,12,26,15,1390,1421,2551,1130
2015,12,26,16,1425,1458,2601,1143
2015,12,26,17,1445,1481,2623,1142
2015,12,26,18,1425,1457,2610,1153
2015,12,26,19,1405,1441,2593,1152
2015,12,26,20,1390,1414,2589,1175
2015,12,26,21,1360,1388,2600,1212
2015,12,26,22,1360,1366,2608,1242
2015,12,26,23,1365,1370,2613,1243
2015,12,27,0,1435,1445,2640,1195
2015,12,27,1,1520,1558,2672,1114
2015,12,27,2,1520,1574,2687,1113
2015,12,27,3,1485,1557,2799,1242
2015,12,27,4,1455,1537,2806,1269
2015,12,27,5,1400,1505,2775,1270
2015,12,27,6,1345,1419,2758,1339
2015,12,27,7,1265,1390,2761,1371
2015,12,27,8,1235,1333,2775,1442
2015,12,27,9,1225,1300,2765,1465
2015,12,27,10,1215,1291,2662,1371
2015,12,27,11,1235,1298,2648,1350
2015,12,27,12,1240,1317,2703,1386
2015,12,27,13,1290,1333,2638,1305
2015,12,27,14,1320,1371,2652,1281
2015,12,27,15,1365,1423,2665,1242
2015,12,27,16,1390,1465,2660,1195
2015,12,27,17,1405,1494,2679,1185
2015,12,27,18,1405,1493,2668,1175
2015,12,27,19,1395,1485,2685,1200
2015,12,27,20,1375,1487,2703,1216
2015,12,27,21,1355,1456,2680,1224
2015,12,27,22,1360,1460,2628,1168
2015,12,27,23,1355,1464,2637,1173
2015,12,28,0,1430,1508,2677,1169
2015,12,28,1,1520,1613,2803,1190
2015,12,28,2,1520,1607,2784,1177
2015,12,28,3,1490,1582,2859,1277
2015,12,28,4,1460,1545,2842,1297
2015,12,28,5,1410,1480,2835,1355
2015,12,28,6,1325,1394,2782,1388
2015,12,28,7,1235,1321,2735,1414
2015,12,28,8,1235,1288,2723,1435
2015,12,28,9,1215,1246,2511,1265
2015,12,28,10,1200,1239,2489,1250
2015,12,28,11,1205,1252,2473,1221
2015,12,28,12,1235,1277,2467,1190
2015,12,28,13,1310,1330,2634,1304
2015,12,28,14,1390,1406,2685,1279
2015,12,28,15,1465,1504,2736,1232
2015,12,28,16,1465,1519,2743,1224
2015,12,28,17,1470,1537,2760,1223
2015,12,28,18,1465,1536,2763,1227
2015,12,28,19,1445,1537,2771,1234
2015,12,28,20,1415,1523,2820,1297
2015,12,28,21,1405,1515,2828,1313
2015,12,28,22,1410,1498,2812,1314
2015,12,28,23,1400,1502,2804,1302
2015,12,29,0,1475,1547,2837,1290
2015,12,29,1,1555,1656,2880,1224
2015,12,29,2,1560,1657,2862,1205
2015,12,29,3,1530,1624,2839,1215
2015,12,29,4,1490,1592,2830,1238
2015,12,29,5,1465,1541,2820,1279
2015,12,29,6,1350,1449,2756,1307
2015,12,29,7,1260,1381,2761,1380
2015,12,29,8,1225,1325,2741,1416
2015,12,29,9,1200,1314,2717,1403
2015,12,29,10,1190,1304,2730,1426
2015,12,29,11,1180,1324,2752,1428
2015,12,29,12,1220,1350,2754,1404
2015,12,29,13,1265,1404,2775,1371
2015,12,29,14,1345,1491,2767,1276
2015,12,29,15,1445,1566,2753,1187
2015,12,29,16,1460,1566,2782,1216
2015,12,29,17,1470,1566,2811,1245
2015,12,29,18,1470,1571,2817,1246
2015,12,29,19,1450,1554,2806,1252
2015,12,29,20,1435,1544,2770,1226
2015,12,29,21,1410,1537,2751,1214
2015,12,29,22,1415,1514,2718,1204
2015,12,29,23,1415,1515,2695,1180
2015,12,30,0,1480,1571,2699,1128
2015,12,30,1,1580,1648,2689,1041
2015,12,30,2,1575,1653,2683,1030
2015,12,30,3,1540,1622,2679,1057
2015,12,30,4,1510,1594,2706,1112
2015,12,30,5,1445,1530,2701,1171
2015,12,30,6,1360,1440,2694,1254
2015,12,30,7,1270,1365,2691,1326
2015,12,30,8,1260,1337,2737,1400
2015,12,30,9,1235,1311,2766,1455
2015,12,30,10,1225,1302,2745,1443
2015,12,30,11,1250,1293,2740,1447
2015,12,30,12,1275,1326,2757,1431
2015,12,30,13,1315,1371,2773,1402
2015,12,30,14,1425,1462,2741,1279
2015,12,30,15,1515,1550,2732,1182
2015,12,30,16,1510,1583,2752,1169
2015,12,30,17,1515,1590,2769,1179
2015,12,30,18,1500,1582,2777,1195
2015,12,30,19,1495,1579,2768,1189
2015,12,30,20,1490,1539,2716,1177
2015,12,30,21,1485,1536,2780,1244
2015,12,30,22,1475,1521,2769,1248
2015,12,30,23,1515,1532,2692,1160
2015,12,31,0,1540,1561,2659,1098
2015,12,31,1,1600,1654,2678,1024
2015,12,31,2,1600,1646,2664,1018
2015,12,31,3,1580,1630,2670,1040
2015,12,31,4,1535,1584,2647,1063
2015,12,31,5,1490,1549,2677,1128
2015,12,31,6,1400,1457,2641,1184
2015,12,31,7,1330,1385,2687,1302
2015,12,31,8,1240,1350,2674,1324
2015,12,31,9,1210,1331,2659,1328
2015,12,31,10,1195,1314,2681,1367
2015,12,31,11,1215,1310,2677,1367
2015,12,31,12,1240,1309,2706,1397
2015,12,31,13,1270,1365,2787,1422
2015,12,31,14,1390,1427,2736,1309
2015,12,31,15,1510,1514,2685,1171
2015,12,31,16,1515,1546,2699,1153
2015,12,31,17,1515,1564,2719,1155
2015,12,31,18,1515,1543,2723,1180
2015,12,31,19,1490,1523,2697,1174
2015,12,31,20,1465,1491,2736,1245
2015,12,31,21,1445,1467,2719,1252
2015,12,31,22,1430,1442,2669,1227
2015,12,31,23,1440,1440,2486,1046
2016,1,1,0,1505,1486,2505,1019
2016,1,1,1,1580,1588,2740,1152
2016,1,1,2,1570,1597,2779,1182
2016,1,1,3,1545,1553,2783,1230
2016,1,1,4,1520,1516,2746,1230
2016,1,1,5,1510,1500,2590,1090
2016,1,1,6,1395,1448,2549,1101
2016,1,1,7,1325,1398,2512,1114
2016,1,1,8,1285,1361,2529,1168
2016,1,1,9,1255,1335,2501,1166
2016,1,1,10,1235,1325,2513,1188
2016,1,1,11,1240,1314,2494,1180
2016,1,1,12,1265,1305,2482,1177
2016,1,1,13,1305,1339,2443,1104
2016,1,1,14,1410,1365,2424,1059
2016,1,1,15,1515,1401,2427,1026
2016,1,1,16,1520,1429,2413,984
2016,1,1,17,1520,1446,2403,957
2016,1,1,18,1515,1446,2398,952
2016,1,1,19,1495,1441,2402,961
2016,1,1,20,1480,1419,2393,974
2016,1,1,21,1460,1393,2383,990
2016,1,1,22,1450,1370,2356,986
2016,1,1,23,1450,1364,2348,984
2016,1,2,0,1500,1422,2376,954
2016,1,2,1,1580,1531,2427,896
2016,1,2,2,1575,1542,2411,869
2016,1,2,3,1555,1526,2371,845
2016,1,2,4,1530,1491,2376,885
2016,1,2,5,1515,1466,2386,920
2016,1,2,6,1410,1384,2370,986
2016,1,2,7,1340,1334,2387,1053
2016,1,2,8,1260,1293,2395,1102
2016,1,2,9,1250,1275,2467,1192
2016,1,2,10,1235,1266,2450,1184
2016,1,2,11,1235,1264,2432,1168
2016,1,2,12,1255,1272,2396,1124
2016,1,2,13,1290,1298,2416,1118
2016,1,2,14,1330,1330,2390,1060
2016,1,2,15,1390,1400,2392,992
2016,1,2,16,1430,1436,2398,962
2016,1,2,17,1445,1465,2416,951
2016,1,2,18,1435,1471,2426,955
2016,1,2,19,1430,1448,2407,959
2016,1,2,20,1405,1432,2386,954
2016,1,2,21,1385,1402,2388,986
2016,1,2,22,1375,1378,2384,1006
2016,1,2,23,1385,1372,2390,1018
2016,1,3,0,1435,1436,2363,927
2016,1,3,1,1530,1547,2423,876
2016,1,3,2,1530,1572,2434,862
2016,1,3,3,1500,1551,2384,833
2016,1,3,4,1465,1522,2373,851
2016,1,3,5,1390,1483,2409,926
2016,1,3,6,1350,1426,2409,983
2016,1,3,7,1290,1351,2403,1052
2016,1,3,8,1280,1329,2436,1107
2016,1,3,9,1260,1304,2463,1159
2016,1,3,10,1245,1290,2445,1155
2016,1,3,11,1240,1281,2445,1164
2016,1,3,12,1265,1289,2451,1162
2016,1,3,13,1305,1309,2444,1135
2016,1,3,14,1350,1355,2430,1075
2016,1,3,15,1405,1409,2440,1031
2016,1,3,16,1445,1432,2456,1024
2016,1,3,17,1465,1468,2439,971
2016,1,3,18,1465,1463,2420,957
2016,1,3,19,1460,1450,2423,973
2016,1,3,20,1440,1431,2391,960
2016,1,3,21,1420,1421,2371,950
2016,1,3,22,1415,1414,2341,927
2016,1,3,23,1430,1415,2352,937
2016,1,4,0,1470,1470,2363,893
2016,1,4,1,1585,1567,2396,829
2016,1,4,2,1575,1597,2410,813
2016,1,4,3,1545,1555,2208,653
2016,1,4,4,1510,1513,2182,669
2016,1,4,5,1405,1456,2245,789
2016,1,4,6,1370,1379,2336,957
2016,1,4,7,1290,1311,2409,1098
2016,1,4,8,1270,1274,2430,1156
2016,1,4,9,1245,1250,2426,1176
2016,1,4,10,1235,1248,2411,1163
2016,1,4,11,1245,1248,2416,1168
2016,1,4,12,1260,1266,2428,1162
2016,1,4,13,1320,1329,2416,1087
2016,1,4,14,1415,1444,2434,990
2016,1,4,15,1500,1544,2413,869
2016,1,4,16,1510,1526,2382,856
2016,1,4,17,1520,1531,2398,867
2016,1,4,18,1505,1507,2416,909
2016,1,4,19,1505,1480,2411,931
2016,1,4,20,1470,1461,2442,981
2016,1,4,21,1460,1445,2456,1011
2016,1,4,22,1450,1431,2461,1030
2016,1,4,23,1465,1433,2462,1029
2016,1,5,0,1505,1470,2444,974
2016,1,5,1,1600,1566,2426,860
2016,1,5,2,1595,1582,2417,835
2016,1,5,3,1570,1540,2401,861
2016,1,5,4,1520,1505,2423,918
2016,1,5,5,1500,1436,2414,978
2016,1,5,6,1380,1350,2411,1061
2016,1,5,7,1310,1270,2398,1128
2016,1,5,8,1190,1232,2363,1131
2016,1,5,9,1175,1219,2365,1146
2016,1,5,10,1155,1212,2395,1183
2016,1,5,11,1160,1209,2383,1174
2016,1,5,12,1180,1236,2370,1134
2016,1,5,13,1210,1286,2429,1143
2016,1,5,14,1320,1419,2440,1021
2016,1,5,15,1430,1522,2421,899
2016,1,5,16,1440,1511,2438,927
2016,1,5,17,1455,1499,2432,933
2016,1,5,18,1455,1477,2434,957
2016,1,5,19,1435,1445,2410,965
2016,1,5,20,1420,1414,2390,976
2016,1,5,21,1400,1407,2423,1016
2016,1,5,22,1400,1407,2443,1036
2016,1,5,23,1405,1395,2443,1048
2016,1,6,0,1460,1450,2412,962
2016,1,6,1,1545,1536,2411,875
2016,1,6,2,1560,1567,2391,824
2016,1,6,3,1525,1543,2393,850
2016,1,6,4,1495,1503,2423,920
2016,1,6,5,1430,1444,2392,948
2016,1,6,6,1350,1341,2363,1022
2016,1,6,7,1265,1279,2515,1236
2016,1,6,8,1200,1250,2545,1295
2016,1,6,9,1195,1231,2604,1373
2016,1,6,10,1185,1244,2676,1432
2016,1,6,11,1185,1233,2687,1454
2016,1,6,12,1195,1265,2682,1417
2016,1,6,13,1265,1319,2731,1412
2016,1,6,14,1375,1440,2723,1283
2016,1,6,15,1465,1534,2704,1170
2016,1,6,16,1465,1519,2674,1155
2016,1,6,17,1460,1516,2638,1122
2016,1,6,18,1445,1506,2684,1178
2016,1,6,19,1430,1483,2681,1198
2016,1,6,20,1400,1462,2680,1218
2016,1,6,21,1390,1458,2671,1213
2016,1,6,22,1375,1438,2546,1108
2016,1,6,23,1385,1440,2532,1092
2016,1,7,0,1420,1480,2617,1137
2016,1,7,1,1505,1572,2644,1072
2016,1,7,2,1515,1587,2643,1056
2016,1,7,3,1485,1554,2635,1081
2016,1,7,4,1450,1527,2646,1119
2016,1,7,5,1465,1452,2645,1193
2016,1,7,6,1315,1373,2676,1303
2016,1,7,7,1240,1288,2722,1434
2016,1,7,8,1215,1266,2691,1425
2016,1,7,9,1205,1248,2656,1408
2016,1,7,10,1200,1264,2657,1393
2016,1,7,11,1195,1266,2673,1407
2016,1,7,12,1215,1297,2707,1410
2016,1,7,13,1265,1360,2726,1366
2016,1,7,14,1385,1490,2763,1273
2016,1,7,15,1520,1593,2814,1221
2016,1,7,16,1530,1567,2811,1244
2016,1,7,17,1535,1545,2793,1248
2016,1,7,18,1515,1552,2776,1224
2016,1,7,19,1490,1530,2787,1257
2016,1,7,20,1465,1490,2674,1184
2016,1,7,21,1445,1486,2725,1239
2016,1,7,22,1425,1490,2746,1256
2016,1,7,23,1425,1511,2826,1315
2016,1,8,0,1475,1539,2813,1274
2016,1,8,1,1570,1623,2816,1193
2016,1,8,2,1585,1610,2799,1189
2016,1,8,3,1550,1590,2794,1204
2016,1,8,4,1515,1554,2805,1251
2016,1,8,5,1520,1488,2850,1362
2016,1,8,6,1385,1394,2843,1449
2016,1,8,7,1325,1340,2831,1491
2016,1,8,8,1330,1283,2831,1548
2016,1,8,9,1315,1253,2845,1592
2016,1,8,10,1305,1245,2830,1585
2016,1,8,11,1290,1253,2708,1455
2016,1,8,12,1305,1262,2705,1443
2016,1,8,13,1355,1323,2780,1457
2016,1,8,14,1430,1442,2770,1328
2016,1,8,15,1510,1530,2737,1207
2016,1,8,16,1515,1532,2715,1183
2016,1,8,17,1510,1531,2723,1192
2016,1,8,18,1505,1530,2701,1171
2016,1,8,19,1480,1513,2685,1172
2016,1,8,20,1470,1501,2684,1183
2016,1,8,21,1455,1478,2690,1212
2016,1,8,22,1440,1467,2694,1227
2016,1,8,23,1440,1467,2714,1247
2016,1,9,0,1485,1506,2726,1220
2016,1,9,1,1590,1585,2778,1193
2016,1,9,2,1590,1579,2755,1176
2016,1,9,3,1565,1549,2728,1179
2016,1,9,4,1535,1522,2710,1188
2016,1,9,5,1510,1473,2716,1243
2016,1,9,6,1410,1397,2747,1350
2016,1,9,7,1330,1354,2775,1421
2016,1,9,8,1260,1303,2752,1449
2016,1,9,9,1240,1293,2740,1447
2016,1,9,10,1245,1275,2738,1463
2016,1,9,11,1240,1278,2746,1468
2016,1,9,12,1255,1283,2727,1444
2016,1,9,13,1290,1296,2727,1431
2016,1,9,14,1370,1347,2718,1371
2016,1,9,15,1450,1411,2715,1304
2016,1,9,16,1475,1454,2690,1236
2016,1,9,17,1480,1482,2729,1247
2016,1,9,18,1485,1475,2735,1260
2016,1,9,19,1460,1474,2721,1247
2016,1,9,20,1430,1443,2702,1259
2016,1,9,21,1425,1407,2707,1300
2016,1,9,22,1410,1389,2712,1323
2016,1,9,23,1420,1403,2759,1356
2016,1,10,0,1465,1442,2759,1317
2016,1,10,1,1565,1527,2770,1243
2016,1,10,2,1570,1532,2766,1234
2016,1,10,3,1550,1505,2799,1294
2016,1,10,4,1510,1483,2810,1327
2016,1,10,5,1450,1424,2823,1399
2016,1,10,6,1375,1378,2857,1479
2016,1,10,7,1315,1322,2861,1539
2016,1,10,8,1230,1266,2809,1543
2016,1,10,9,1210,1256,2772,1516
2016,1,10,10,1205,1251,2759,1508
2016,1,10,11,1200,1267,2765,1498
2016,1,10,12,1215,1262,2804,1542
2016,1,10,13,1250,1292,2842,1550
2016,1,10,14,1335,1336,2857,1521
2016,1,10,15,1405,1392,2871,1479
2016,1,10,16,1430,1439,2885,1446
2016,1,10,17,1440,1466,2856,1390
2016,1,10,18,1450,1468,2867,1399
2016,1,10,19,1430,1456,2844,1388
2016,1,10,20,1405,1440,2839,1399
2016,1,10,21,1400,1406,2836,1430
2016,1,10,22,1400,1410,2847,1437
2016,1,10,23,1410,1409,2831,1422
2016,1,11,0,1455,1453,2847,1394
2016,1,11,1,1550,1563,2858,1295
2016,1,11,2,1560,1582,2883,1301
2016,1,11,3,1525,1568,2866,1298
2016,1,11,4,1485,1529,2891,1362
2016,1,11,5,1405,1474,2895,1421
2016,1,11,6,1335,1384,2884,1500
2016,1,11,7,1265,1328,2850,1522
2016,1,11,8,1215,1285,2750,1465
2016,1,11,9,1200,1275,2704,1429
2016,1,11,10,1205,1263,2601,1338
2016,1,11,11,1205,1253,2619,1366
2016,1,11,12,1220,1296,2744,1448
2016,1,11,13,1285,1367,2811,1444
2016,1,11,14,1420,1497,2875,1378
2016,1,11,15,1550,1600,2921,1321
2016,1,11,16,1545,1574,2868,1294
2016,1,11,17,1540,1566,2872,1306
2016,1,11,18,1525,1521,2858,1337
2016,1,11,19,1515,1522,2889,1367
2016,1,11,20,1475,1496,2880,1384
2016,1,11,21,1475,1471,2897,1426
2016,1,11,22,1465,1445,2871,1426
2016,1,11,23,1475,1445,2891,1446
2016,1,12,0,1515,1487,2910,1423
2016,1,12,1,1605,1582,2889,1307
2016,1,12,2,1605,1610,2895,1285
2016,1,12,3,1575,1588,2877,1289
2016,1,12,4,1530,1555,2835,1280
2016,1,12,5,1550,1481,2829,1348
2016,1,12,6,1370,1400,2885,1485
2016,1,12,7,1305,1348,2899,1551
2016,1,12,8,1180,1316,2871,1555
2016,1,12,9,1170,1295,2867,1572
2016,1,12,10,1165,1283,2849,1566
2016,1,12,11,1175,1272,2828,1556
2016,1,12,12,1185,1290,2840,1550
2016,1,12,13,1230,1352,2845,1493
2016,1,12,14,1330,1476,2863,1387
2016,1,12,15,1440,1582,2902,1320
2016,1,12,16,1450,1560,2931,1371
2016,1,12,17,1460,1520,2882,1362
2016,1,12,18,1455,1514,2779,1265
2016,1,12,19,1440,1478,2742,1264
2016,1,12,20,1415,1468,2745,1277
2016,1,12,21,1395,1458,2769,1311
2016,1,12,22,1395,1436,2852,1416
2016,1,12,23,1395,1444,2838,1394
2016,1,13,0,1440,1474,2847,1373
2016,1,13,1,1525,1557,2870,1313
2016,1,13,2,1555,1568,2897,1329
2016,1,13,3,1530,1542,2863,1321
2016,1,13,4,1495,1520,2830,1310
2016,1,13,5,1440,1462,2821,1359
2016,1,13,6,1340,1353,2809,1456
2016,1,13,7,1270,1281,2803,1522
2016,1,13,8,1155,1260,2817,1557
2016,1,13,9,1145,1244,2768,1524
2016,1,13,10,1150,1213,2658,1445
2016,1,13,11,1140,1212,2643,1431
2016,1,13,12,1170,1226,2615,1389
2016,1,13,13,1235,1303,2655,1352
2016,1,13,14,1335,1423,2800,1377
2016,1,13,15,1430,1513,2815,1302
2016,1,13,16,1420,1517,2812,1295
2016,1,13,17,1410,1482,2845,1363
2016,1,13,18,1385,1469,2827,1358
2016,1,13,19,1365,1442,2770,1328
2016,1,13,20,1350,1424,2815,1391
2016,1,13,21,1335,1422,2809,1387
2016,1,13,22,1320,1412,2859,1447
2016,1,13,23,1325,1384,2682,1298
2016,1,14,0,1360,1414,2549,1135
2016,1,14,1,1445,1491,2496,1005
2016,1,14,2,1460,1505,2506,1001
2016,1,14,3,1440,1491,2510,1019
2016,1,14,4,1405,1449,2525,1076
2016,1,14,5,1430,1387,2452,1065
2016,1,14,6,1270,1281,2353,1072
2016,1,14,7,1190,1232,2309,1077
2016,1,14,8,1170,1192,2277,1085
2016,1,14,9,1160,1151,1948,797
2016,1,14,10,1160,1127,1890,763
2016,1,14,11,1150,1126,1893,767
2016,1,14,12,1160,1138,1955,817
2016,1,14,13,1225,1200,2047,847
2016,1,14,14,1375,1346,2585,1239
2016,1,14,15,1530,1463,2830,1367
2016,1,14,16,1525,1470,2859,1389
2016,1,14,17,1495,1448,2776,1328
2016,1,14,18,1485,1441,2828,1387
2016,1,14,19,1470,1449,2842,1393
2016,1,14,20,1440,1422,2839,1417
2016,1,14,21,1440,1431,2814,1383
2016,1,14,22,1415,1421,2824,1403
2016,1,14,23,1425,1412,2821,1409
2016,1,15,0,1455,1441,2847,1406
2016,1,15,1,1550,1505,2892,1387
2016,1,15,2,1535,1511,2921,1410
2016,1,15,3,1525,1494,2888,1394
2016,1,15,4,1490,1459,2858,1399
2016,1,15,5,1530,1402,2847,1445
2016,1,15,6,1345,1333,2853,1520
2016,1,15,7,1285,1259,2818,1559
2016,1,15,8,1225,1243,2829,1586
2016,1,15,9,1215,1195,2738,1543
2016,1,15,10,1205,1200,2631,1431
2016,1,15,11,1200,1197,2619,1422
2016,1,15,12,1220,1220,2621,1401
2016,1,15,13,1280,1274,2588,1314
2016,1,15,14,1365,1414,2616,1202
2016,1,15,15,1455,1499,2663,1164
2016,1,15,16,1455,1505,2668,1163
2016,1,15,17,1440,1491,2692,1201
2016,1,15,18,1435,1489,2714,1225
2016,1,15,19,1415,1470,2648,1178
2016,1,15,20,1395,1451,2687,1236
2016,1,15,21,1385,1424,2734,1310
2016,1,15,22,1365,1400,2792,1392
2016,1,15,23,1360,1395,2781,1386
2016,1,16,0,1395,1426,2773,1347
2016,1,16,1,1490,1481,2758,1277
2016,1,16,2,1490,1480,2755,1275
2016,1,16,3,1465,1451,2733,1282
2016,1,16,4,1430,1425,2706,1281
2016,1,16,5,1455,1389,2745,1356
2016,1,16,6,1290,1327,2767,1440
2016,1,16,7,1240,1262,2775,1513
2016,1,16,8,1255,1233,2766,1533
2016,1,16,9,1230,1215,2709,1494
2016,1,16,10,1210,1209,2709,1500
2016,1,16,11,1205,1201,2712,1511
2016,1,16,12,1220,1222,2721,1499
2016,1,16,13,1260,1244,2738,1494
2016,1,16,14,1310,1285,2428,1143
2016,1,16,15,1360,1357,2411,1054
2016,1,16,16,1385,1400,2408,1008
2016,1,16,17,1400,1437,2468,1031
2016,1,16,18,1395,1454,2464,1010
2016,1,16,19,1395,1441,2435,994
2016,1,16,20,1360,1441,2464,1023
2016,1,16,21,1350,1426,2493,1067
2016,1,16,22,1340,1449,2497,1048
2016,1,16,23,1340,1450,2491,1041
2016,1,17,0,1380,1483,2480,997
2016,1,17,1,1450,1573,2487,914
2016,1,17,2,1465,1575,2416,841
2016,1,17,3,1445,1529,2413,884
2016,1,17,4,1415,1505,2598,1093
2016,1,17,5,1360,1467,2739,1272
2016,1,17,6,1300,1380,2719,1339
2016,1,17,7,1225,1307,2686,1379
2016,1,17,8,1220,1265,2692,1427
2016,1,17,9,1200,1242,2683,1441
2016,1,17,10,1180,1227,2665,1438
2016,1,17,11,1180,1231,2697,1466
2016,1,17,12,1190,1229,2713,1484
2016,1,17,13,1235,1250,2721,1471
2016,1,17,14,1305,1295,2725,1430
2016,1,17,15,1370,1339,2597,1258
2016,1,17,16,1395,1374,2616,1242
2016,1,17,17,1420,1399,2608,1209
2016,1,17,18,1415,1392,2602,1210
2016,1,17,19,1410,1380,2587,1207
2016,1,17,20,1390,1365,2588,1223
2016,1,17,21,1380,1340,2574,1234
2016,1,17,22,1375,1332,2600,1268
2016,1,17,23,1370,1337,2606,1269
2016,1,18,0,1410,1379,2624,1245
2016,1,18,1,1490,1485,2653,1168
2016,1,18,2,1510,1510,2640,1130
2016,1,18,3,1490,1488,2713,1225
2016,1,18,4,1455,1443,2718,1275
2016,1,18,5,1370,1383,2721,1338
2016,1,18,6,1310,1310,2705,1395
2016,1,18,7,1240,1238,2700,1462
2016,1,18,8,1240,1184,2533,1349
2016,1,18,9,1220,1161,2491,1330
2016,1,18,10,1205,1169,2496,1327
2016,1,18,11,1200,1170,2566,1396
2016,1,18,12,1225,1200,2589,1389
2016,1,18,13,1280,1262,2798,1536
2016,1,18,14,1390,1386,2834,1448
2016,1,18,15,1490,1454,2808,1354
2016,1,18,16,1480,1462,2881,1419
2016,1,18,17,1475,1480,2869,1389
2016,1,18,18,1450,1472,2875,1403
2016,1,18,19,1455,1454,2880,1426
2016,1,18,20,1415,1425,2874,1449
2016,1,18,21,1410,1407,2857,1450
2016,1,18,22,1390,1396,2873,1477
2016,1,18,23,1390,1389,2826,1437
2016,1,19,0,1430,1402,2812,1410
2016,1,19,1,1505,1490,2729,1239
2016,1,19,2,1530,1501,2520,1019
2016,1,19,3,1510,1470,2499,1029
2016,1,19,4,1470,1433,2413,980
2016,1,19,5,1490,1380,2424,1044
2016,1,19,6,1320,1284,2465,1181
2016,1,19,7,1250,1223,2491,1268
2016,1,19,8,1280,1184,2501,1317
2016,1,19,9,1265,1174,2499,1325
2016,1,19,10,1255,1179,2461,1282
2016,1,19,11,1260,1178,2470,1292
2016,1,19,12,1275,1200,2474,1274
2016,1,19,13,1320,1248,2517,1269
2016,1,19,14,1405,1382,2472,1090
2016,1,19,15,1490,1494,2509,1015
2016,1,19,16,1500,1482,2438,956
2016,1,19,17,1485,1474,2466,992
2016,1,19,18,1470,1459,2488,1029
2016,1,19,19,1460,1421,2520,1099
2016,1,19,20,1445,1396,2522,1126
2016,1,19,21,1420,1382,2539,1157
2016,1,19,22,1410,1367,2522,1155
2016,1,19,23,1415,1365,2450,1085
2016,1,20,0,1460,1405,2419,1014
2016,1,20,1,1550,1481,2448,967
2016,1,20,2,1570,1493,2426,933
2016,1,20,3,1550,1468,2422,954
2016,1,20,4,1515,1430,2382,952
2016,1,20,5,1490,1378,2380,1002
2016,1,20,6,1355,1297,2395,1098
2016,1,20,7,1280,1210,2388,1178
2016,1,20,8,1170,1181,2391,1210
2016,1,20,9,1150,1167,2007,840
2016,1,20,10,1150,1155,1947,792
2016,1,20,11,1150,1175,1969,794
2016,1,20,12,1180,1188,1967,779
2016,1,20,13,1240,1232,2083,851
2016,1,20,14,1355,1383,2316,933
2016,1,20,15,1430,1476,2373,897
2016,1,20,16,1435,1474,2423,949
2016,1,20,17,1425,1452,2367,915
2016,1,20,18,1415,1443,2370,927
2016,1,20,19,1385,1435,2389,954
2016,1,20,20,1365,1436,2407,971
2016,1,20,21,1350,1403,2397,994
2016,1,20,22,1345,1406,2376,970
2016,1,20,23,1340,1405,2360,955
2016,1,21,0,1365,1419,2330,911
2016,1,21,1,1455,1496,2402,906
2016,1,21,2,1470,1502,2448,946
2016,1,21,3,1440,1493,2443,950
2016,1,21,4,1415,1456,2476,1020
2016,1,21,5,1430,1401,2483,1082
2016,1,21,6,1255,1320,2470,1150
2016,1,21,7,1185,1246,2527,1281
2016,1,21,8,1150,1226,2495,1269
2016,1,21,9,1135,1205,2519,1314
2016,1,21,10,1130,1192,1266,74
2016,1,21,11,1130,1190,1092,-98
2016,1,21,12,1150,1206,1069,-137
2016,1,21,13,1205,1265,1065,-200
2016,1,21,14,1335,1399,974,-425
2016,1,21,15,1435,1491,1045,-446
2016,1,21,16,1430,1475,1034,-441
2016,1,21,17,1425,1461,1024,-437
2016,1,21,18,1410,1456,1034,-422
2016,1,21,19,1390,1432,1040,-392
2016,1,21,20,1365,1405,1132,-273
2016,1,21,21,1355,1395,1110,-285
2016,1,21,22,1345,1404,1104,-300
2016,1,21,23,1340,1405,1094,-311
2016,1,22,0,1380,1419,1099,-320
2016,1,22,1,1450,1482,1104,-378
2016,1,22,2,1470,1519,1164,-355
2016,1,22,3,1450,1463,1256,-207
2016,1,22,4,1410,1421,1576,155
2016,1,22,5,1435,1381,1647,266
2016,1,22,6,1260,1306,1734,428
2016,1,22,7,1180,1247,1886,639
2016,1,22,8,1195,1214,1913,699
2016,1,22,9,1175,1208,1972,764
2016,1,22,10,1160,1188,1904,716
2016,1,22,11,1170,1167,1882,715
2016,1,22,12,1190,1165,1893,728
2016,1,22,13,1245,1230,1957,727
2016,1,22,14,1375,1347,2337,990
2016,1,22,15,1455,1468,2433,965
2016,1,22,16,1440,1469,2461,992
2016,1,22,17,1420,1475,2475,1000
2016,1,22,18,1420,1437,2542,1105
2016,1,22,19,1405,1426,2488,1062
2016,1,22,20,1400,1386,2345,959
2016,1,22,21,1370,1371,2323,952
2016,1,22,22,1365,1350,2290,940
2016,1,22,23,1360,1346,2315,969
2016,1,23,0,1385,1372,2333,961
2016,1,23,1,1450,1426,2440,1014
2016,1,23,2,1460,1459,2641,1182
2016,1,23,3,1435,1428,2576,1148
2016,1,23,4,1410,1393,2529,1136
2016,1,23,5,1455,1325,2532,1207
2016,1,23,6,1285,1291,2536,1245
2016,1,23,7,1215,1247,2571,1324
2016,1,23,8,1160,1195,2587,1392
2016,1,23,9,1145,1177,2633,1456
2016,1,23,10,1140,1163,2433,1270
2016,1,23,11,1145,1137,2172,1035
2016,1,23,12,1160,1142,2180,1038
2016,1,23,13,1190,1151,2215,1064
2016,1,23,14,1270,1220,2444,1224
2016,1,23,15,1330,1286,2487,1201
2016,1,23,16,1340,1330,2600,1270
2016,1,23,17,1350,1362,2770,1408
2016,1,23,18,1345,1359,2761,1402
2016,1,23,19,1330,1350,2741,1391
2016,1,23,20,1315,1327,2733,1406
2016,1,23,21,1295,1308,2619,1311
2016,1,23,22,1295,1292,2646,1354
2016,1,23,23,1305,1313,2628,1315
2016,1,24,0,1340,1330,2607,1277
2016,1,24,1,1400,1415,2629,1214
2016,1,24,2,1420,1430,2670,1240
2016,1,24,3,1380,1390,2527,1137
2016,1,24,4,1345,1375,2520,1145
2016,1,24,5,1330,1312,2249,937
2016,1,24,6,1240,1248,2210,962
2016,1,24,7,1170,1196,2107,911
2016,1,24,8,1140,1139,2014,875
2016,1,24,9,1120,1122,2088,966
2016,1,24,10,1120,1111,1933,822
2016,1,24,11,1125,1105,1913,808
2016,1,24,12,1140,1112,1898,786
2016,1,24,13,1170,1135,1847,712
2016,1,24,14,1275,1177,1926,749
2016,1,24,15,1355,1247,2063,816
2016,1,24,16,1365,1280,2125,845
2016,1,24,17,1375,1307,2348,1041
2016,1,24,18,1370,1346,2647,1301
2016,1,24,19,1355,1333,2629,1296
2016,1,24,20,1345,1339,2649,1310
2016,1,24,21,1325,1327,2837,1510
2016,1,24,22,1325,1320,2830,1510
2016,1,24,23,1330,1330,2765,1435
2016,1,25,0,1365,1343,2747,1404
2016,1,25,1,1425,1443,2767,1324
2016,1,25,2,1460,1474,2774,1300
2016,1,25,3,1425,1435,2789,1354
2016,1,25,4,1385,1405,2803,1398
2016,1,25,5,1355,1317,2785,1468
2016,1,25,6,1255,1245,2792,1547
2016,1,25,7,1185,1190,2734,1544
2016,1,25,8,1200,1148,2520,1372
2016,1,25,9,1180,1125,2501,1376
2016,1,25,10,1190,1124,2527,1403
2016,1,25,11,1190,1128,2518,1390
2016,1,25,12,1220,1152,2478,1326
2016,1,25,13,1275,1223,2652,1429
2016,1,25,14,1410,1361,2644,1283
2016,1,25,15,1480,1473,2713,1240
2016,1,25,16,1465,1456,2716,1260
2016,1,25,17,1465,1461,2738,1277
2016,1,25,18,1450,1445,2761,1316
2016,1,25,19,1425,1433,2788,1355
2016,1,25,20,1400,1402,2797,1395
2016,1,25,21,1385,1383,2768,1385
2016,1,25,22,1380,1366,2697,1331
2016,1,25,23,1390,1366,2701,1335
2016,1,26,0,1410,1385,2700,1315
2016,1,26,1,1485,1459,2784,1325
2016,1,26,2,1510,1498,2786,1288
2016,1,26,3,1470,1484,2811,1327
2016,1,26,4,1435,1451,2772,1321
2016,1,26,5,1480,1402,2815,1413
2016,1,26,6,1295,1332,2828,1496
2016,1,26,7,1215,1260,2786,1526
2016,1,26,8,1160,1220,2599,1379
2016,1,26,9,1150,1196,2504,1308
2016,1,26,10,1145,1189,2605,1416
2016,1,26,11,1140,1215,2645,1430
2016,1,26,12,1155,1233,2703,1470
2016,1,26,13,1210,1281,2751,1470
2016,1,26,14,1295,1414,2767,1353
2016,1,26,15,1385,1515,2797,1282
2016,1,26,16,1395,1496,2806,1310
2016,1,26,17,1385,1484,2810,1326
2016,1,26,18,1390,1454,2709,1255
2016,1,26,19,1375,1447,2708,1261
2016,1,26,20,1360,1411,2694,1283
2016,1,26,21,1345,1391,2687,1296
2016,1,26,22,1335,1381,2690,1309
2016,1,26,23,1330,1376,2700,1324
2016,1,27,0,1365,1397,2701,1304
2016,1,27,1,1460,1471,2737,1266
2016,1,27,2,1485,1509,2744,1235
2016,1,27,3,1450,1484,2719,1235
2016,1,27,4,1420,1440,2726,1286
2016,1,27,5,1385,1386,2696,1310
2016,1,27,6,1255,1292,2680,1388
2016,1,27,7,1180,1223,2641,1418
2016,1,27,8,1165,1190,2578,1388
2016,1,27,9,1155,1165,2531,1366
2016,1,27,10,1140,1167,2507,1340
2016,1,27,11,1155,1179,2508,1329
2016,1,27,12,1175,1182,2538,1356
2016,1,27,13,1230,1245,2554,1309
2016,1,27,14,1335,1369,2683,1314
2016,1,27,15,1425,1467,2704,1237
2016,1,27,16,1415,1466,2779,1313
2016,1,27,17,1390,1446,2776,1330
2016,1,27,18,1380,1418,2714,1296
2016,1,27,19,1360,1406,2725,1319
2016,1,27,20,1345,1382,2702,1320
2016,1,27,21,1330,1362,2595,1233
2016,1,27,22,1320,1367,2589,1222
2016,1,27,23,1320,1343,2548,1205
2016,1,28,0,1345,1354,2545,1191
2016,1,28,1,1410,1433,2664,1231
2016,1,28,2,1440,1459,2712,1253
2016,1,28,3,1430,1437,2732,1295
2016,1,28,4,1400,1408,2695,1287
2016,1,28,5,1425,1348,2664,1316
2016,1,28,6,1250,1267,2668,1401
2016,1,28,7,1180,1198,2647,1449
2016,1,28,8,1145,1163,2660,1497
2016,1,28,9,1120,1121,2481,1360
2016,1,28,10,1120,1113,2479,1366
2016,1,28,11,1125,1126,2487,1361
2016,1,28,12,1155,1143,2488,1345
2016,1,28,13,1205,1208,2559,1351
2016,1,28,14,1350,1339,2550,1211
2016,1,28,15,1445,1436,2629,1193
2016,1,28,16,1415,1404,2602,1198
2016,1,28,17,1400,1377,2546,1169
2016,1,28,18,1385,1369,2563,1194
2016,1,28,19,1370,1363,2575,1212
2016,1,28,20,1350,1336,2577,1241
2016,1,28,21,1335,1331,2577,1246
2016,1,28,22,1335,1323,2430,1107
2016,1,28,23,1340,1315,2406,1091
2016,1,29,0,1360,1339,2398,1059
2016,1,29,1,1415,1408,2468,1060
2016,1,29,2,1455,1437,2594,1157
2016,1,29,3,1430,1406,2582,1176
2016,1,29,4,1385,1378,2536,1158
2016,1,29,5,1445,1326,2536,1210
2016,1,29,6,1250,1253,2510,1257
2016,1,29,7,1165,1177,2612,1435
2016,1,29,8,1145,1136,2529,1393
2016,1,29,9,1125,1124,2399,1275
2016,1,29,10,1120,1100,2149,1049
2016,1,29,11,1120,1095,2145,1050
2016,1,29,12,1130,1134,2408,1274
2016,1,29,13,1190,1205,2672,1467
2016,1,29,14,1320,1321,2795,1474
2016,1,29,15,1420,1404,2672,1268
2016,1,29,16,1400,1410,2784,1374
2016,1,29,17,1395,1407,2800,1393
2016,1,29,18,1365,1374,2789,1415
2016,1,29,19,1350,1370,2802,1432
2016,1,29,20,1340,1350,2775,1425
2016,1,29,21,1310,1344,2750,1406
2016,1,29,22,1300,1330,2462,1132
2016,1,29,23,1295,1335,2358,1023
2016,1,30,0,1315,1335,2097,762
2016,1,30,1,1370,1370,2092,722
2016,1,30,2,1395,1375,2172,797
2016,1,30,3,1370,1346,2209,863
2016,1,30,4,1340,1315,2349,1034
2016,1,30,5,1420,1291,2368,1077
2016,1,30,6,1220,1223,2339,1116
2016,1,30,7,1155,1178,2255,1077
2016,1,30,8,1170,1145,2132,987
2016,1,30,9,1155,1132,2194,1062
2016,1,30,10,1145,1139,2113,974
2016,1,30,11,1145,1126,2051,925
2016,1,30,12,1165,1139,2056,917
2016,1,30,13,1195,1171,2158,987
2016,1,30,14,1260,1208,2195,987
2016,1,30,15,1320,1283,2298,1015
2016,1,30,16,1330,1309,2323,1014
2016,1,30,17,1320,1337,2456,1119
2016,1,30,18,1325,1356,2597,1241
2016,1,30,19,1320,1349,2604,1255
2016,1,30,20,1300,1323,2593,1270
2016,1,30,21,1295,1284,2342,1058
2016,1,30,22,1280,1265,2056,791
2016,1,30,23,1285,1253,1959,706
2016,1,31,0,1315,1282,2027,745
2016,1,31,1,1380,1349,2330,981
2016,1,31,2,1410,1409,2720,1311
2016,1,31,3,1370,1380,2700,1320
2016,1,31,4,1340,1364,2742,1378
2016,1,31,5,1320,1320,2515,1195
2016,1,31,6,1230,1267,2516,1249
2016,1,31,7,1160,1209,2417,1208
2016,1,31,8,1170,1169,2388,1219
2016,1,31,9,1150,1163,2369,1206
2016,1,31,10,1135,1144,2336,1192
2016,1,31,11,1140,1140,2310,1170
2016,1,31,12,1155,1143,2331,1188
2016,1,31,13,1200,1166,2321,1155
2016,1,31,14,1265,1200,2326,1126
2016,1,31,15,1330,1259,2386,1127
2016,1,31,16,1340,1316,2595,1279
2016,1,31,17,1330,1343,2721,1378
2016,1,31,18,1345,1349,2741,1392
2016,1,31,19,1335,1334,2753,1419
2016,1,31,20,1325,1338,2757,1419
2016,1,31,21,1315,1317,2741,1424
2016,1,31,22,1305,1311,2747,1436
2016,1,31,23,1300,1304,2754,1450
2016,2,1,0,1340,1340,2760,1420
2016,2,1,1,1415,1411,2721,1310
2016,2,1,2,1455,1463,2730,1267
2016,2,1,3,1420,1445,2672,1227
2016,2,1,4,1380,1407,2682,1275
2016,2,1,5,1330,1351,2672,1321
2016,2,1,6,1240,1268,2664,1396
2016,2,1,7,1165,1199,2645,1446
2016,2,1,8,1165,1160,2498,1338
2016,2,1,9,1145,1144,2492,1348
2016,2,1,10,1140,1145,2480,1335
2016,2,1,11,1150,1159,2497,1338
2016,2,1,12,1180,1180,2489,1309
2016,2,1,13,1245,1253,2608,1355
2016,2,1,14,1380,1370,2612,1242
2016,2,1,15,1485,1482,2663,1181
2016,2,1,16,1465,1457,2662,1205
2016,2,1,17,1445,1446,2664,1218
2016,2,1,18,1440,1446,2699,1253
2016,2,1,19,1420,1421,2673,1252
2016,2,1,20,1395,1413,2652,1239
2016,2,1,21,1385,1383,2606,1223
2016,2,1,22,1370,1363,2456,1093
2016,2,1,23,1370,1376,2511,1135
2016,2,2,0,1395,1385,2342,957
2016,2,2,1,1465,1451,2382,931
2016,2,2,2,1500,1516,2515,999
2016,2,2,3,1475,1494,2624,1130
2016,2,2,4,1440,1472,2625,1153
2016,2,2,5,1485,1417,2598,1181
2016,2,2,6,1305,1319,2582,1263
2016,2,2,7,1220,1252,2593,1341
2016,2,2,8,1215,1216,2457,1241
2016,2,2,9,1190,1193,2446,1253
2016,2,2,10,1185,1187,2428,1241
2016,2,2,11,1195,1186,2441,1255
2016,2,2,12,1215,1213,2467,1254
2016,2,2,13,1260,1282,2604,1322
2016,2,2,14,1390,1399,2624,1225
2016,2,2,15,1500,1503,2639,1136
2016,2,2,16,1510,1497,2663,1166
2016,2,2,17,1510,1469,2659,1190
2016,2,2,18,1495,1450,2688,1238
2016,2,2,19,1480,1428,2704,1276
2016,2,2,20,1470,1404,2691,1287
2016,2,2,21,1440,1404,2687,1283
2016,2,2,22,1430,1395,2660,1265
2016,2,2,23,1425,1391,2676,1285
2016,2,3,0,1460,1414,2663,1249
2016,2,3,1,1530,1467,2655,1188
2016,2,3,2,1580,1527,2688,1161
2016,2,3,3,1565,1502,2687,1185
2016,2,3,4,1515,1468,2693,1225
2016,2,3,5,1500,1430,2711,1281
2016,2,3,6,1360,1334,2688,1354
2016,2,3,7,1275,1268,2692,1424
2016,2,3,8,1225,1241,2672,1431
2016,2,3,9,1210,1229,2699,1470
2016,2,3,10,1200,1222,2705,1483
2016,2,3,11,1215,1225,2736,1511
2016,2,3,12,1235,1245,2745,1500
2016,2,3,13,1305,1306,2674,1368
2016,2,3,14,1440,1444,2740,1296
2016,2,3,15,1545,1536,2753,1217
2016,2,3,16,1520,1505,2760,1255
2016,2,3,17,1495,1486,2766,1280
2016,2,3,18,1490,1465,2746,1281
2016,2,3,19,1470,1435,2746,1311
2016,2,3,20,1460,1417,2753,1336
2016,2,3,21,1430,1413,2620,1207
2016,2,3,22,1435,1397,2599,1202
2016,2,3,23,1425,1397,2579,1182
2016,2,4,0,1450,1374,2618,1244
2016,2,4,1,1530,1500,2779,1279
2016,2,4,2,1560,1540,2809,1269
2016,2,4,3,1535,1525,2812,1287
2016,2,4,4,1510,1485,2797,1312
2016,2,4,5,1545,1431,2767,1336
2016,2,4,6,1345,1340,2761,1421
2016,2,4,7,1270,1272,2758,1486
2016,2,4,8,1205,1236,2720,1484
2016,2,4,9,1180,1214,2585,1371
2016,2,4,10,1180,1211,2581,1370
2016,2,4,11,1185,1208,2520,1312
2016,2,4,12,1205,1236,2518,1282
2016,2,4,13,1275,1310,2650,1340
2016,2,4,14,1410,1430,2727,1297
2016,2,4,15,1510,1518,2754,1236
2016,2,4,16,1490,1515,2776,1261
2016,2,4,17,1460,1509,2779,1270
2016,2,4,18,1450,1490,2791,1301
2016,2,4,19,1430,1475,2801,1326
2016,2,4,20,1410,1455,2806,1351
2016,2,4,21,1395,1476,2836,1360
2016,2,4,22,1385,1416,2797,1381
2016,2,4,23,1390,1423,2778,1355
2016,2,5,0,1425,1436,2794,1358
2016,2,5,1,1480,1481,2800,1319
2016,2,5,2,1530,1527,2784,1257
2016,2,5,3,1490,1500,2802,1302
2016,2,5,4,1450,1480,2808,1328
2016,2,5,5,1510,1419,2813,1394
2016,2,5,6,1315,1342,2782,1440
2016,2,5,7,1235,1267,2798,1531
2016,2,5,8,1175,1243,2802,1559
2016,2,5,9,1165,1198,2619,1421
2016,2,5,10,1160,1195,2590,1395
2016,2,5,11,1155,1198,2618,1420
2016,2,5,12,1175,1230,2694,1464
2016,2,5,13,1225,1285,2730,1445
2016,2,5,14,1365,1401,2797,1396
2016,2,5,15,1460,1477,2725,1248
2016,2,5,16,1445,1474,2771,1297
2016,2,5,17,1435,1457,2761,1304
2016,2,5,18,1390,1437,2786,1349
2016,2,5,19,1380,1423,2793,1370
2016,2,5,20,1365,1384,2781,1397
2016,2,5,21,1355,1375,2762,1387
2016,2,5,22,1340,1344,2715,1371
2016,2,5,23,1350,1331,2716,1385
2016,2,6,0,1355,1347,2735,1388
2016,2,6,1,1410,1381,2742,1361
2016,2,6,2,1440,1429,2760,1331
2016,2,6,3,1430,1414,2738,1324
2016,2,6,4,1390,1399,2766,1367
2016,2,6,5,1460,1340,2524,1184
2016,2,6,6,1260,1282,2572,1290
2016,2,6,7,1200,1222,2495,1273
2016,2,6,8,1125,1194,2463,1269
2016,2,6,9,1110,1145,2451,1306
2016,2,6,10,1110,1140,2434,1294
2016,2,6,11,1105,1136,2469,1333
2016,2,6,12,1120,1157,2401,1244
2016,2,6,13,1165,1173,2459,1286
2016,2,6,14,1230,1223,2492,1269
2016,2,6,15,1295,1296,2545,1249
2016,2,6,16,1310,1328,2533,1205
2016,2,6,17,1320,1345,2429,1084
2016,2,6,18,1315,1317,2435,1118
2016,2,6,19,1295,1330,2660,1330
2016,2,6,20,1280,1316,2602,1286
2016,2,6,21,1280,1300,2434,1134
2016,2,6,22,1250,1308,2457,1149
2016,2,6,23,1260,1303,2517,1214
2016,2,7,0,1280,1339,2536,1197
2016,2,7,1,1330,1407,2641,1234
2016,2,7,2,1370,1436,2658,1222
2016,2,7,3,1345,1430,2627,1197
2016,2,7,4,1320,1394,2605,1211
2016,2,7,5,1295,1346,2655,1309
2016,2,7,6,1210,1298,2745,1447
2016,2,7,7,1150,1230,2712,1482
2016,2,7,8,1130,1187,2651,1464
2016,2,7,9,1115,1161,2589,1428
2016,2,7,10,1105,1149,2481,1332
2016,2,7,11,1100,1142,2471,1329
2016,2,7,12,1115,1143,2405,1262
2016,2,7,13,1165,1171,2426,1255
2016,2,7,14,1255,1228,2629,1401
2016,2,7,15,1350,1276,2690,1414
2016,2,7,16,1380,1319,2684,1365
2016,2,7,17,1390,1325,2642,1317
2016,2,7,18,1385,1320,2611,1291
2016,2,7,19,1370,1301,2579,1278
2016,2,7,20,1360,1291,2562,1271
2016,2,7,21,1360,1283,2645,1362
2016,2,7,22,1335,1264,2463,1199
2016,2,7,23,1335,1252,2532,1280
2016,2,8,0,1365,1249,2495,1246
2016,2,8,1,1435,1264,2540,1276
2016,2,8,2,1470,1326,2706,1380
2016,2,8,3,1445,1314,2666,1352
2016,2,8,4,1415,1297,2641,1344
2016,2,8,5,1350,1314,2637,1323
2016,2,8,6,1270,1232,2612,1380
2016,2,8,7,1205,1157,2583,1426
2016,2,8,8,1120,1128,2574,1446
2016,2,8,9,1100,1112,2591,1479
2016,2,8,10,1100,1114,2618,1504
2016,2,8,11,1105,1126,2554,1428
2016,2,8,12,1130,1157,2570,1413
2016,2,8,13,1200,1224,2740,1516
2016,2,8,14,1310,1357,2777,1420
2016,2,8,15,1400,1422,2790,1368
2016,2,8,16,1390,1417,2793,1376
2016,2,8,17,1380,1419,2798,1379
2016,2,8,18,1370,1400,2776,1376
2016,2,8,19,1345,1394,2791,1397
2016,2,8,20,1330,1362,2746,1384
2016,2,8,21,1330,1361,2728,1367
2016,2,8,22,1305,1334,2658,1324
2016,2,8,23,1310,1335,2673,1338
2016,2,9,0,1335,1321,2688,1367
2016,2,9,1,1390,1377,2772,1395
2016,2,9,2,1430,1460,2795,1335
2016,2,9,3,1405,1449,2785,1336
2016,2,9,4,1385,1418,2735,1317
2016,2,9,5,1400,1351,2749,1398
2016,2,9,6,1240,1265,2696,1431
2016,2,9,7,1180,1209,2738,1529
2016,2,9,8,1095,1173,2720,1547
2016,2,9,9,1075,1153,2708,1555
2016,2,9,10,1065,1148,2720,1572
2016,2,9,11,1070,1157,2733,1576
2016,2,9,12,1085,1164,2741,1577
2016,2,9,13,1135,1226,2762,1536
2016,2,9,14,1275,1365,2778,1413
2016,2,9,15,1390,1444,2774,1330
2016,2,9,16,1405,1419,2763,1344
2016,2,9,17,1390,1396,2740,1344
2016,2,9,18,1380,1368,2762,1394
2016,2,9,19,1355,1339,2668,1329
2016,2,9,20,1340,1302,2593,1291
2016,2,9,21,1335,1303,2605,1302
2016,2,9,22,1320,1299,2538,1239
2016,2,9,23,1310,1315,2579,1264
2016,2,10,0,1320,1311,2539,1228
2016,2,10,1,1365,1350,2706,1356
2016,2,10,2,1420,1430,2783,1353
2016,2,10,3,1400,1422,2822,1400
2016,2,10,4,1365,1399,2764,1365
2016,2,10,5,1390,1344,2725,1381
2016,2,10,6,1265,1272,2697,1425
2016,2,10,7,1185,1196,2677,1481
2016,2,10,8,1110,1160,2661,1501
2016,2,10,9,1095,1147,2676,1529
2016,2,10,10,1100,1147,2665,1518
2016,2,10,11,1105,1157,2700,1543
2016,2,10,12,1125,1178,2710,1532
2016,2,10,13,1175,1233,2775,1542
2016,2,10,14,1320,1358,2782,1424
2016,2,10,15,1415,1438,2785,1347
2016,2,10,16,1390,1403,2784,1381
2016,2,10,17,1380,1392,2796,1404
2016,2,10,18,1350,1374,2789,1415
2016,2,10,19,1340,1343,2783,1440
2016,2,10,20,1320,1315,2753,1438
2016,2,10,21,1315,1307,2767,1460
2016,2,10,22,1295,1300,2728,1428
2016,2,10,23,1295,1423,2815,1392
2016,2,11,0,1300,1317,2660,1343
2016,2,11,1,1370,1363,2731,1368
2016,2,11,2,1420,1420,2731,1311
2016,2,11,3,1400,1415,2707,1292
2016,2,11,4,1370,1381,2674,1293
2016,2,11,5,1415,1336,2656,1320
2016,2,11,6,1230,1260,2599,1339
2016,2,11,7,1165,1197,2511,1314
2016,2,11,8,1085,1145,2511,1366
2016,2,11,9,1070,1126,2498,1372
2016,2,11,10,1070,1104,2443,1339
2016,2,11,11,1070,1106,2437,1331
2016,2,11,12,1100,1127,2454,1327
2016,2,11,13,1165,1182,2525,1343
2016,2,11,14,1315,1312,2530,1218
2016,2,11,15,1425,1408,2619,1211
2016,2,11,16,1405,1374,2620,1246
2016,2,11,17,1385,1379,2681,1302
2016,2,11,18,1370,1336,2660,1324
2016,2,11,19,1345,1317,2624,1307
2016,2,11,20,1225,1279,2634,1355
2016,2,11,21,1220,1279,2670,1391
2016,2,11,22,1210,1259,2656,1397
2016,2,11,23,1315,1261,2661,1400
2016,2,12,0,1335,1268,2633,1365
2016,2,12,1,1380,1305,2604,1299
2016,2,12,2,1430,1369,2626,1257
2016,2,12,3,1405,1352,2607,1255
2016,2,12,4,1380,1326,2620,1294
2016,2,12,5,1425,1266,2591,1325
2016,2,12,6,1250,1187,2572,1385
2016,2,12,7,1175,1135,2523,1388
2016,2,12,8,1080,1090,2517,1427
2016,2,12,9,1060,1062,2499,1437
2016,2,12,10,1065,1059,2488,1429
2016,2,12,11,1065,1067,2485,1418
2016,2,12,12,1095,1090,2459,1369
2016,2,12,13,1150,1145,2465,1320
2016,2,12,14,1295,1247,2399,1152
2016,2,12,15,1400,1358,2415,1057
2016,2,12,16,1385,1350,2526,1176
2016,2,12,17,1365,1344,2530,1186
2016,2,12,18,1345,1339,2527,1188
2016,2,12,19,1325,1312,2514,1202
2016,2,12,20,1200,1286,2450,1164
2016,2,12,21,1190,1274,2456,1182
2016,2,12,22,1180,1253,2454,1201
2016,2,12,23,1275,1259,2452,1193
2016,2,13,0,1295,1242,2455,1213
2016,2,13,1,1330,1266,2237,971
2016,2,13,2,1370,1320,2284,964
2016,2,13,3,1360,1322,2490,1168
2016,2,13,4,1330,1300,2507,1207
2016,2,13,5,1400,1256,2508,1252
2016,2,13,6,1215,1190,2395,1205
2016,2,13,7,1160,1133,2295,1162
2016,2,13,8,1130,1087,2289,1202
2016,2,13,9,1105,1057,2101,1044
2016,2,13,10,1080,1051,2034,983
2016,2,13,11,1080,1061,1917,856
2016,2,13,12,1100,1082,1813,731
2016,2,13,13,1140,1119,1846,727
2016,2,13,14,1230,1180,1873,693
2016,2,13,15,1325,1240,1800,560
2016,2,13,16,1330,1269,1880,611
2016,2,13,17,1340,1328,2305,977
2016,2,13,18,1320,1357,2545,1188
2016,2,13,19,1305,1348,2559,1211
2016,2,13,20,1275,1334,2518,1184
2016,2,13,21,1270,1316,2496,1180
2016,2,13,22,1260,1285,2468,1183
2016,2,13,23,1265,1293,2505,1212
2016,2,14,0,1285,1284,2496,1212
2016,2,14,1,1330,1327,2550,1223
2016,2,14,2,1390,1391,2662,1271
2016,2,14,3,1370,1382,2618,1236
2016,2,14,4,1345,1345,2530,1185
2016,2,14,5,1325,1305,2486,1181
2016,2,14,6,1230,1249,2370,1121
2016,2,14,7,1160,1198,2044,846
2016,2,14,8,1140,1169,1869,700
2016,2,14,9,1125,1155,1854,699
2016,2,14,10,1100,1143,1679,536
2016,2,14,11,1105,1135,1563,428
2016,2,14,12,1115,1141,1551,410
2016,2,14,13,1160,1164,1550,386
2016,2,14,14,1285,1199,1601,402
2016,2,14,15,1400,1252,1567,315
2016,2,14,16,1410,1276,1920,644
2016,2,14,17,1415,1301,1919,618
2016,2,14,18,1405,1303,1967,664
2016,2,14,19,1385,1303,1954,651
2016,2,14,20,1360,1295,1895,600
2016,2,14,21,1350,1270,1884,614
2016,2,14,22,1330,1258,1837,579
2016,2,14,23,1320,1259,1813,554
2016,2,15,0,1335,1282,1821,539
2016,2,15,1,1375,1329,1748,419
2016,2,15,2,1440,1377,1813,436
2016,2,15,3,1425,1338,1752,414
2016,2,15,4,1400,1311,1750,439
2016,2,15,5,1400,1268,1750,482
2016,2,15,6,1275,1202,1705,503
2016,2,15,7,1200,1129,1627,498
2016,2,15,8,1090,1101,1513,412
2016,2,15,9,1080,1077,1550,473
2016,2,15,10,1060,1068,1654,586
2016,2,15,11,1070,1057,1646,589
2016,2,15,12,1090,1081,1622,541
2016,2,15,13,1150,1119,1675,556
2016,2,15,14,1275,1223,1716,493
2016,2,15,15,1365,1307,1732,425
2016,2,15,16,1340,1330,1788,458
2016,2,15,17,1335,1356,1807,451
2016,2,15,18,1315,1366,1820,454
2016,2,15,19,1295,1356,1804,448
2016,2,15,20,1265,1339,1777,438
2016,2,15,21,1260,1338,1823,485
2016,2,15,22,1240,1327,1846,519
2016,2,15,23,1245,1325,1854,529
2016,2,16,0,1255,1349,1857,508
2016,2,16,1,1305,1378,1886,508
2016,2,16,2,1370,1430,1987,557
2016,2,16,3,1350,1411,1964,553
2016,2,16,4,1320,1363,1933,570
2016,2,16,5,1365,1288,1903,615
2016,2,16,6,1180,1204,1867,663
2016,2,16,7,1125,1135,1859,724
2016,2,16,8,1045,1093,1828,735
2016,2,16,9,1020,1073,1821,748
2016,2,16,10,1020,1070,1820,750
2016,2,16,11,1035,1072,1834,762
2016,2,16,12,1050,1091,1833,742
2016,2,16,13,1090,1151,1851,700
2016,2,16,14,1210,1277,1854,577
2016,2,16,15,1305,1384,1932,548
2016,2,16,16,1305,1380,1968,588
2016,2,16,17,1310,1379,2030,651
2016,2,16,18,1285,1389,1955,566
2016,2,16,19,1280,1373,1920,547
2016,2,16,20,1255,1349,1990,641
2016,2,16,21,1240,1343,1963,620
2016,2,16,22,1235,1334,1970,636
2016,2,16,23,1240,1327,1930,603
2016,2,17,0,1260,1326,1894,568
2016,2,17,1,1295,1351,1991,640
2016,2,17,2,1360,1426,1998,572
2016,2,17,3,1340,1418,1987,569
2016,2,17,4,1315,1382,1950,568
2016,2,17,5,1305,1310,2027,717
2016,2,17,6,1180,1226,2006,780
2016,2,17,7,1115,1144,1854,710
2016,2,17,8,1075,1099,1843,744
2016,2,17,9,1060,1083,1921,838
2016,2,17,10,1055,1064,1831,767
2016,2,17,11,1055,1075,1894,819
2016,2,17,12,1080,1100,1896,796
2016,2,17,13,1120,1162,1885,723
2016,2,17,14,1255,1292,1864,572
2016,2,17,15,1340,1395,1944,549
2016,2,17,16,1330,1379,1925,546
2016,2,17,17,1330,1371,1897,526
2016,2,17,18,1320,1364,1986,622
2016,2,17,19,1300,1327,1998,671
2016,2,17,20,1220,1310,2131,821
2016,2,17,21,1210,1305,2192,887
2016,2,17,22,1205,1312,2266,954
2016,2,17,23,1280,1301,2280,979
2016,2,18,0,1300,1322,2315,993
2016,2,18,1,1335,1347,2417,1070
2016,2,18,2,1380,1399,2495,1096
2016,2,18,3,1370,1399,2569,1170
2016,2,18,4,1340,1360,2543,1183
2016,2,18,5,1340,1307,2536,1229
2016,2,18,6,1190,1208,2399,1191
2016,2,18,7,1110,1136,2331,1195
2016,2,18,8,1140,1098,2117,1019
2016,2,18,9,1115,1073,1934,861
2016,2,18,10,1100,1046,1799,753
2016,2,18,11,1105,1055,1711,656
2016,2,18,12,1125,1084,1798,714
2016,2,18,13,1195,1134,1851,717
2016,2,18,14,1320,1265,2084,819
2016,2,18,15,1420,1364,2344,980
2016,2,18,16,1405,1369,2394,1025
2016,2,18,17,1410,1350,2398,1048
2016,2,18,18,1390,1356,2427,1071
2016,2,18,19,1365,1353,2459,1106
2016,2,18,20,1330,1332,2389,1057
2016,2,18,21,1335,1329,2002,673
2016,2,18,22,1320,1325,2279,954
2016,2,18,23,1320,1353,2341,988
2016,2,19,0,1330,1366,2388,1022
2016,2,19,1,1370,1367,2382,1015
2016,2,19,2,1430,1412,2383,971
2016,2,19,3,1405,1394,2410,1016
2016,2,19,4,1385,1372,2421,1049
2016,2,19,5,1420,1338,2474,1136
2016,2,19,6,1230,1246,2399,1153
2016,2,19,7,1150,1177,2329,1152
2016,2,19,8,1030,1159,2272,1113
2016,2,19,9,1000,1116,1873,757
2016,2,19,10,990,1106,1776,670
2016,2,19,11,1005,1096,1734,638
2016,2,19,12,1030,1121,1767,646
2016,2,19,13,1085,1176,2045,869
2016,2,19,14,1210,1309,2351,1042
2016,2,19,15,1305,1389,2475,1086
2016,2,19,16,1295,1391,2554,1163
2016,2,19,17,1285,1391,2438,1047
2016,2,19,18,1280,1368,2444,1076
2016,2,19,19,1245,1341,2458,1117
2016,2,19,20,1225,1334,2464,1130
2016,2,19,21,1220,1315,2481,1166
2016,2,19,22,1210,1290,2406,1116
2016,2,19,23,1205,1271,2385,1114
2016,2,20,0,1210,1262,2285,1023
2016,2,20,1,1240,1266,2127,861
2016,2,20,2,1290,1328,2174,846
2016,2,20,3,1280,1333,2165,832
2016,2,20,4,1245,1286,2143,857
2016,2,20,5,1305,1239,2068,829
2016,2,20,6,1125,1173,2096,923
2016,2,20,7,1065,1110,1976,866
2016,2,20,8,1155,1073,1796,723
2016,2,20,9,1125,1057,1710,653
2016,2,20,10,1105,1054,1714,660
2016,2,20,11,1100,1059,1719,660
2016,2,20,12,1150,1076,1734,658
2016,2,20,13,1190,1103,1762,659
2016,2,20,14,1260,1165,1975,810
2016,2,20,15,1310,1222,1957,735
2016,2,20,16,1330,1250,1689,439
2016,2,20,17,1340,1297,1794,497
2016,2,20,18,1350,1310,2080,770
2016,2,20,19,1330,1284,2007,723
2016,2,20,20,1320,1271,1670,399
2016,2,20,21,1320,1248,1644,396
2016,2,20,22,1310,1224,1470,246
2016,2,20,23,1330,1220,1449,229
2016,2,21,0,1335,1233,1472,239
2016,2,21,1,1365,1279,1960,681
2016,2,21,2,1415,1360,2305,945
2016,2,21,3,1400,1344,2436,1092
2016,2,21,4,1360,1331,2482,1151
2016,2,21,5,1310,1289,2283,994
2016,2,21,6,1260,1217,2248,1031
2016,2,21,7,1185,1167,2184,1017
2016,2,21,8,1175,1140,2143,1003
2016,2,21,9,1155,1127,2257,1130
2016,2,21,10,1150,1138,2159,1021
2016,2,21,11,1155,1137,2217,1080
2016,2,21,12,1160,1145,2207,1062
2016,2,21,13,1205,1170,2269,1099
2016,2,21,14,1260,1207,2259,1052
2016,2,21,15,1305,1242,2316,1074
2016,2,21,16,1335,1291,2397,1106
2016,2,21,17,1355,1303,2411,1108
2016,2,21,18,1350,1287,2420,1133
2016,2,21,19,1335,1285,2400,1115
2016,2,21,20,1320,1254,2430,1176
2016,2,21,21,1315,1235,2397,1162
2016,2,21,22,1305,1203,2354,1151
2016,2,21,23,1295,1197,2163,966
2016,2,22,0,1305,1223,2168,945
2016,2,22,1,1350,1291,2272,981
2016,2,22,2,1410,1366,2383,1017
2016,2,22,3,1390,1382,2386,1004
2016,2,22,4,1365,1333,2233,900
2016,2,22,5,1305,1291,2210,919
2016,2,22,6,1225,1203,2024,821
2016,2,22,7,1145,1152,1850,698
2016,2,22,8,1165,1119,1792,673
2016,2,22,9,1145,1101,1740,639
2016,2,22,10,1130,1092,1659,567
2016,2,22,11,1135,1103,1670,567
2016,2,22,12,1175,1114,1832,718
2016,2,22,13,1225,1183,2027,844
2016,2,22,14,1330,1318,2248,930
2016,2,22,15,1390,1400,2366,966
2016,2,22,16,1390,1390,2384,994
2016,2,22,17,1385,1389,2434,1045
2016,2,22,18,1385,1377,2364,987
2016,2,22,19,1370,1360,2240,880
2016,2,22,20,1365,1330,2135,805
2016,2,22,21,1360,1323,2166,843
2016,2,22,22,1350,1300,2252,952
2016,2,22,23,1370,1328,2225,897
2016,2,23,0,1380,1324,2252,928
2016,2,23,1,1405,1368,2353,985
2016,2,23,2,1460,1427,2417,990
2016,2,23,3,1440,1423,2424,1001
2016,2,23,4,1405,1403,2405,1002
2016,2,23,5,1390,1334,2404,1070
2016,2,23,6,1255,1247,2373,1126
2016,2,23,7,1180,1180,2319,1139
2016,2,23,8,1135,1151,2293,1142
2016,2,23,9,1110,1140,2263,1123
2016,2,23,10,1110,1131,2251,1120
2016,2,23,11,1115,1143,2263,1120
2016,2,23,12,1135,1160,2267,1107
2016,2,23,13,1185,1231,2284,1053
2016,2,23,14,1310,1347,2308,961
2016,2,23,15,1405,1433,2387,954
2016,2,23,16,1415,1416,2396,980
2016,2,23,17,1420,1400,2432,1032
2016,2,23,18,1405,1373,2430,1057
2016,2,23,19,1395,1344,2402,1058
2016,2,23,20,1360,1323,2404,1081
2016,2,23,21,1335,1314,2429,1115
2016,2,23,22,1325,1301,2432,1131
2016,2,23,23,1330,1303,2430,1127
2016,2,24,0,1345,1325,2426,1101
2016,2,24,1,1390,1338,2400,1062
2016,2,24,2,1470,1417,2488,1071
2016,2,24,3,1460,1437,2504,1067
2016,2,24,4,1435,1409,2471,1062
2016,2,24,5,1405,1340,2445,1105
2016,2,24,6,1285,1266,2452,1186
2016,2,24,7,1215,1199,2329,1130
2016,2,24,8,1180,1167,2172,1005
2016,2,24,9,1155,1148,2163,1015
2016,2,24,10,1140,1154,2105,951
2016,2,24,11,1150,1149,2099,950
2016,2,24,12,1175,1161,2159,998
2016,2,24,13,1235,1223,2275,1052
2016,2,24,14,1370,1342,2366,1024
2016,2,24,15,1460,1427,2453,1026
2016,2,24,16,1445,1410,2486,1076
2016,2,24,17,1425,1383,2522,1139
2016,2,24,18,1425,1373,2483,1110
2016,2,24,19,1380,1331,2481,1150
2016,2,24,20,1320,1305,2432,1127
2016,2,24,21,1320,1285,2371,1086
2016,2,24,22,1315,1265,2316,1051
2016,2,24,23,1350,1268,2377,1109
2016,2,25,0,1360,1272,2380,1108
2016,2,25,1,1405,1290,2425,1135
2016,2,25,2,1475,1360,2434,1074
2016,2,25,3,1460,1377,2514,1137
2016,2,25,4,1420,1347,2479,1132
2016,2,25,5,1460,1279,2435,1156
2016,2,25,6,1275,1191,2447,1256
2016,2,25,7,1200,1144,2427,1283
2016,2,25,8,1135,1116,2410,1294
2016,2,25,9,1110,1109,2441,1332
2016,2,25,10,1090,1114,2443,1329
2016,2,25,11,1105,1106,2436,1330
2016,2,25,12,1135,1136,2460,1324
2016,2,25,13,1195,1198,2471,1273
2016,2,25,14,1330,1333,2565,1232
2016,2,25,15,1410,1410,2674,1264
2016,2,25,16,1400,1404,2664,1260
2016,2,25,17,1380,1378,2532,1154
2016,2,25,18,1370,1351,2576,1225
2016,2,25,19,1345,1336,2577,1241
2016,2,25,20,1325,1299,2492,1193
2016,2,25,21,1320,1279,2466,1187
2016,2,25,22,1305,1274,2486,1212
2016,2,25,23,1315,1260,2466,1206
2016,2,26,0,1325,1225,2464,1239
2016,2,26,1,1345,1281,2458,1177
2016,2,26,2,1415,1359,2519,1160
2016,2,26,3,1415,1358,2543,1185
2016,2,26,4,1390,1332,2491,1159
2016,2,26,5,1420,1279,2445,1166
2016,2,26,6,1250,1206,2382,1176
2016,2,26,7,1180,1141,2361,1220
2016,2,26,8,1115,1108,2348,1240
2016,2,26,9,1100,1097,2271,1174
2016,2,26,10,1115,1091,2218,1127
2016,2,26,11,1110,1109,2212,1103
2016,2,26,12,1115,1129,2232,1103
2016,2,26,13,1170,1181,2294,1113
2016,2,26,14,1300,1305,2439,1134
2016,2,26,15,1390,1385,2539,1154
2016,2,26,16,1360,1370,2555,1185
2016,2,26,17,1350,1344,2553,1209
2016,2,26,18,1330,1342,2578,1236
2016,2,26,19,1310,1308,2522,1214
2016,2,26,20,1285,1294,2457,1163
2016,2,26,21,1260,1266,2383,1117
2016,2,26,22,1245,1240,2376,1136
2016,2,26,23,1250,1234,2392,1158
2016,2,27,0,1250,1233,2430,1197
2016,2,27,1,1265,1237,2423,1186
2016,2,27,2,1320,1300,2559,1259
2016,2,27,3,1320,1291,2505,1214
2016,2,27,4,1295,1266,2385,1119
2016,2,27,5,1295,1212,2244,1032
2016,2,27,6,1165,1150,2135,985
2016,2,27,7,1115,1099,2151,1052
2016,2,27,8,1005,1075,2170,1095
2016,2,27,9,985,1055,2144,1089
2016,2,27,10,985,1058,2156,1098
2016,2,27,11,980,1049,2153,1104
2016,2,27,12,1015,1047,2094,1047
2016,2,27,13,1055,1067,2045,978
2016,2,27,14,1180,1121,2044,923
2016,2,27,15,1290,1158,1648,490
2016,2,27,16,1305,1205,1665,460
2016,2,27,17,1320,1243,1699,456
2016,2,27,18,1325,1266,1944,678
2016,2,27,19,1305,1263,1907,644
2016,2,27,20,1270,1249,1852,603
2016,2,27,21,1250,1228,1816,588
2016,2,27,22,1240,1207,1743,536
2016,2,27,23,1240,1189,1699,510
2016,2,28,0,1220,1217,1730,513
2016,2,28,1,1270,1249,1927,678
2016,2,28,2,1340,1303,1939,636
2016,2,28,3,1340,1294,2068,774
2016,2,28,4,1300,1265,2013,748
2016,2,28,5,1250,1220,1959,739
2016,2,28,6,1190,1163,2018,855
2016,2,28,7,1150,1116,2070,954
2016,2,28,8,1090,1073,2043,970
2016,2,28,9,1080,1053,1917,864
2016,2,28,10,1085,1044,1836,792
2016,2,28,11,1080,1036,1861,825
2016,2,28,12,1105,1046,1887,841
2016,2,28,13,1145,1082,1916,834
2016,2,28,14,1235,1132,1951,819
2016,2,28,15,1305,1170,1778,608
2016,2,28,16,1325,1216,1918,702
2016,2,28,17,1325,1239,2016,777
2016,2,28,18,1315,1239,2188,949
2016,2,28,19,1315,1238,2240,1002
2016,2,28,20,1275,1217,2211,994
2016,2,28,21,1245,1191,2133,942
2016,2,28,22,1240,1172,1879,707
2016,2,28,23,1235,1176,1847,671
2016,2,29,0,1235,1211,1871,660
2016,2,29,1,1280,1259,1905,646
2016,2,29,2,1350,1307,1948,641
2016,2,29,3,1360,1299,1847,548
2016,2,29,4,1340,1255,1907,652
2016,2,29,5,1260,1219,1924,705
2016,2,29,6,1210,1138,1627,489
2016,2,29,7,1150,1086,1530,444
2016,2,29,8,1040,1055,1599,544
2016,2,29,9,1020,1032,1372,340
2016,2,29,10,1015,1030,1456,426
2016,2,29,11,1020,1036,1451,415
2016,2,29,12,1035,1051,1466,415
2016,2,29,13,1095,1130,1738,608
2016,2,29,14,1280,1273,2217,944
2016,2,29,15,1415,1359,2633,1274
2016,2,29,16,1410,1345,2632,1287
2016,2,29,17,1400,1353,2623,1270
2016,2,29,18,1395,1366,2615,1249
2016,2,29,19,1370,1371,2604,1233
2016,2,29,20,1340,1352,2524,1172
2016,2,29,21,1325,1346,2314,968
2016,2,29,22,1325,1338,2288,950
2016,2,29,23,1320,1337,2255,918
2016,3,1,0,1310,1356,2266,910
2016,3,1,1,1350,1367,2444,1077
2016,3,1,2,1420,1451,2537,1086
2016,3,1,3,1415,1447,2579,1132
2016,3,1,4,1385,1425,2557,1132
2016,3,1,5,1300,1362,2563,1201
2016,3,1,6,1240,1268,2500,1232
2016,3,1,7,1175,1193,2189,996
2016,3,1,8,1130,1149,1989,840
2016,3,1,9,1105,1142,1893,751
2016,3,1,10,1100,1130,1887,757
2016,3,1,11,1110,1129,1850,721
2016,3,1,12,1125,1143,1758,615
2016,3,1,13,1180,1192,1831,639
2016,3,1,14,1280,1323,2055,732
2016,3,1,15,1345,1405,2394,989
2016,3,1,16,1365,1403,2382,979
2016,3,1,17,1370,1383,2406,1023
2016,3,1,18,1365,1383,2407,1024
2016,3,1,19,1350,1373,2441,1068
2016,3,1,20,1325,1351,2326,975
2016,3,1,21,1310,1345,2301,956
2016,3,1,22,1290,1322,2265,943
2016,3,1,23,1285,1307,2239,932
2016,3,2,0,1310,1319,2205,886
2016,3,2,1,1350,1350,2130,780
2016,3,2,2,1410,1395,2079,684
2016,3,2,3,1415,1394,2018,624
2016,3,2,4,1390,1341,1695,354
2016,3,2,5,1315,1281,1824,543
2016,3,2,6,1235,1193,1665,472
2016,3,2,7,1160,1126,1620,494
2016,3,2,8,1050,1086,1389,303
2016,3,2,9,1030,1086,1308,222
2016,3,2,10,1015,1076,1283,207
2016,3,2,11,1020,1085,1305,220
2016,3,2,12,1045,1111,1376,265
2016,3,2,13,1115,1169,1435,266
2016,3,2,14,1260,1300,1677,377
2016,3,2,15,1355,1399,2189,790
2016,3,2,16,1330,1408,2444,1036
2016,3,2,17,1325,1389,2181,792
2016,3,2,18,1320,1384,2059,675
2016,3,2,19,1300,1375,2082,707
2016,3,2,20,1285,1341,1768,427
2016,3,2,21,1275,1333,1963,630
2016,3,2,22,1270,1330,2015,685
2016,3,2,23,1270,1316,2037,721
2016,3,3,0,1280,1327,2230,903
2016,3,3,1,1300,1333,2311,978
2016,3,3,2,1365,1401,2331,930
2016,3,3,3,1370,1427,2349,922
2016,3,3,4,1345,1399,2403,1004
2016,3,3,5,1315,1332,2409,1077
2016,3,3,6,1200,1240,2280,1040
2016,3,3,7,1130,1174,1980,806
2016,3,3,8,1065,1116,1702,586
2016,3,3,9,1055,1080,1658,578
2016,3,3,10,1045,1060,1630,570
2016,3,3,11,1045,1067,1403,336
2016,3,3,12,1070,1087,1397,310
2016,3,3,13,1125,1150,1463,313
2016,3,3,14,1265,1286,1768,482
2016,3,3,15,1355,1357,1945,588
2016,3,3,16,1345,1380,2136,756
2016,3,3,17,1325,1373,2068,695
2016,3,3,18,1320,1373,2044,671
2016,3,3,19,1310,1356,1919,563
2016,3,3,20,1285,1342,1794,452
2016,3,3,21,1270,1342,1830,488
2016,3,3,22,1260,1319,1649,330
2016,3,3,23,1260,1314,1695,381
2016,3,4,0,1255,1314,1706,392
2016,3,4,1,1290,1323,1706,383
2016,3,4,2,1340,1374,1841,467
2016,3,4,3,1340,1396,2013,617
2016,3,4,4,1310,1367,2262,895
2016,3,4,5,1245,1323,2247,924
2016,3,4,6,1175,1225,2081,856
2016,3,4,7,1110,1169,2002,833
2016,3,4,8,1060,1133,2001,868
2016,3,4,9,1040,1098,1716,618
2016,3,4,10,1035,1090,1719,629
2016,3,4,11,1050,1093,1793,700
2016,3,4,12,1075,1109,1816,707
2016,3,4,13,1125,1172,2055,883
2016,3,4,14,1260,1306,2327,1021
2016,3,4,15,1355,1358,2416,1058
2016,3,4,16,1345,1361,2445,1084
2016,3,4,17,1330,1347,2369,1022
2016,3,4,18,1320,1320,2317,997
2016,3,4,19,1305,1294,2232,938
2016,3,4,20,1285,1254,2127,873
2016,3,4,21,1265,1246,2153,907
2016,3,4,22,1250,1224,2165,941
2016,3,4,23,1245,1210,2160,950
2016,3,5,0,1245,1200,2115,915
2016,3,5,1,1255,1204,2128,924
2016,3,5,2,1300,1271,2202,931
2016,3,5,3,1310,1293,2287,994
2016,3,5,4,1275,1274,2062,788
2016,3,5,5,1200,1228,1979,751
2016,3,5,6,1160,1175,1926,751
2016,3,5,7,1130,1116,1849,733
2016,3,5,8,1025,1088,1689,601
2016,3,5,9,1000,1056,1693,637
2016,3,5,10,990,1052,1693,641
2016,3,5,11,995,1038,1621,583
2016,3,5,12,1010,1056,1632,576
2016,3,5,13,1030,1078,1593,515
2016,3,5,14,1150,1133,1574,441
2016,3,5,15,1170,1166,1552,386
2016,3,5,16,1205,1217,1565,348
2016,3,5,17,1230,1245,1532,287
2016,3,5,18,1225,1242,1769,527
2016,3,5,19,1210,1239,1743,504
2016,3,5,20,1200,1232,1746,514
2016,3,5,21,1200,1177,1675,498
2016,3,5,22,1180,1157,1697,540
2016,3,5,23,1175,1174,1624,450
2016,3,6,0,1190,1170,1551,381
2016,3,6,1,1210,1190,1511,321
2016,3,6,2,1250,1244,1796,552
2016,3,6,3,1260,1243,1852,609
2016,3,6,4,1225,1212,1744,532
2016,3,6,5,1175,1160,1664,504
2016,3,6,6,1120,1106,1631,525
2016,3,6,7,1060,1060,1590,530
2016,3,6,8,1020,1024,1658,634
2016,3,6,9,1000,1003,1444,441
2016,3,6,10,995,998,1360,362
2016,3,6,11,1000,1000,1349,349
2016,3,6,12,1015,1017,1294,277
2016,3,6,13,1045,1029,1251,222
2016,3,6,14,1095,1065,1277,212
2016,3,6,15,1140,1100,1316,216
2016,3,6,16,1200,1158,1309,151
2016,3,6,17,1210,1180,1305,125
2016,3,6,18,1210,1182,1311,129
2016,3,6,19,1205,1191,1361,170
2016,3,6,20,1195,1202,1409,207
2016,3,6,21,1185,1183,1350,167
2016,3,6,22,1150,1202,1383,181
2016,3,6,23,1150,1207,1408,201
2016,3,7,0,1175,1234,1411,177
2016,3,7,1,1205,1268,1611,343
2016,3,7,2,1240,1325,1978,653
2016,3,7,3,1265,1329,2193,864
2016,3,7,4,1235,1301,2339,1038
2016,3,7,5,1150,1251,2259,1008
2016,3,7,6,1105,1157,2088,931
2016,3,7,7,1045,1099,2012,913
2016,3,7,8,1100,1072,1800,728
2016,3,7,9,1080,1038,1699,661
2016,3,7,10,1055,1027,1664,637
2016,3,7,11,1070,1015,1489,474
2016,3,7,12,1090,1037,1485,448
2016,3,7,13,1150,1096,1430,334
2016,3,7,14,1300,1255,1732,477
2016,3,7,15,1375,1347,2115,768
2016,3,7,16,1380,1313,2029,716
2016,3,7,17,1370,1297,1969,672
2016,3,7,18,1375,1299,1930,631
2016,3,7,19,1350,1267,1889,622
2016,3,7,20,1345,1249,1842,593
2016,3,7,21,1350,1247,1716,469
2016,3,7,22,1330,1222,1648,426
2016,3,7,23,1335,1215,1653,438
2016,3,8,0,1335,1232,1673,441
2016,3,8,1,1350,1257,1733,476
2016,3,8,2,1400,1327,1781,454
2016,3,8,3,1415,1330,1852,522
2016,3,8,4,1385,1310,1803,493
2016,3,8,5,1350,1255,1713,458
2016,3,8,6,1245,1168,1700,532
2016,3,8,7,1175,1101,1635,534
2016,3,8,8,1110,1070,1287,217
2016,3,8,9,1085,1049,1294,245
2016,3,8,10,1080,1048,1282,234
2016,3,8,11,1090,1058,1278,220
2016,3,8,12,1105,1070,1280,210
2016,3,8,13,1155,1141,1336,195
2016,3,8,14,1245,1273,1784,511
2016,3,8,15,1325,1350,2244,894
2016,3,8,16,1340,1353,2545,1192
2016,3,8,17,1345,1347,2503,1156
2016,3,8,18,1340,1326,2391,1065
2016,3,8,19,1330,1307,2308,1001
2016,3,8,20,1320,1291,2207,916
2016,3,8,21,1315,1277,2176,899
2016,3,8,22,1305,1264,2193,929
2016,3,8,23,1300,1255,2079,824
2016,3,9,0,1315,1258,2140,882
2016,3,9,1,1350,1299,2410,1111
2016,3,9,2,1400,1375,2563,1188
2016,3,9,3,1395,1402,2682,1280
2016,3,9,4,1375,1366,2650,1284
2016,3,9,5,1305,1298,2536,1238
2016,3,9,6,1230,1203,2318,1115
2016,3,9,7,1160,1131,2197,1066
2016,3,9,8,1085,1104,2070,966
2016,3,9,9,1075,1080,1897,817
2016,3,9,10,1060,1085,1901,816
2016,3,9,11,1050,1072,1807,735
2016,3,9,12,1075,1111,1846,735
2016,3,9,13,1135,1178,1970,792
2016,3,9,14,1280,1298,2338,1040
2016,3,9,15,1370,1379,2638,1259
2016,3,9,16,1350,1377,2655,1278
2016,3,9,17,1330,1364,2628,1264
2016,3,9,18,1320,1339,2483,1144
2016,3,9,19,1310,1331,2406,1075
2016,3,9,20,1290,1300,2271,971
2016,3,9,21,1265,1305,2258,953
2016,3,9,22,1255,1293,2246,953
2016,3,9,23,1250,1275,2169,894
2016,3,10,0,1260,1273,2143,870
2016,3,10,1,1270,1290,2365,1075
2016,3,10,2,1335,1366,2552,1186
2016,3,10,3,1340,1404,2615,1211
2016,3,10,4,1320,1372,2564,1192
2016,3,10,5,1255,1298,2443,1145
2016,3,10,6,1185,1200,2196,996
2016,3,10,7,1120,1127,1854,727
2016,3,10,8,1045,1090,1699,609
2016,3,10,9,1025,1067,1465,398
2016,3,10,10,1020,1045,1308,263
2016,3,10,11,1025,1044,1308,264
2016,3,10,12,1050,1063,1346,283
2016,3,10,13,1100,1132,1365,233
2016,3,10,14,1235,1251,1698,447
2016,3,10,15,1310,1328,1923,595
2016,3,10,16,1305,1316,1854,538
2016,3,10,17,1290,1309,1829,520
2016,3,10,18,1280,1313,1790,477
2016,3,10,19,1260,1289,1548,259
2016,3,10,20,1250,1259,1442,183
2016,3,10,21,1245,1252,1465,213
2016,3,10,22,1230,1239,1455,216
2016,3,10,23,1220,1225,1452,227
2016,3,11,0,1215,1245,1448,203
2016,3,11,1,1235,1263,1482,219
2016,3,11,2,1300,1324,1863,539
2016,3,11,3,1320,1346,1901,555
2016,3,11,4,1295,1331,1916,585
2016,3,11,5,1225,1262,1957,695
2016,3,11,6,1150,1194,1909,715
2016,3,11,7,1090,1108,1786,678
2016,3,11,8,1075,1074,1784,710
2016,3,11,9,1055,1055,1816,761
2016,3,11,10,1050,1052,1801,749
2016,3,11,11,1060,1046,1763,717
2016,3,11,12,1085,1060,1803,743
2016,3,11,13,1145,1124,1947,823
2016,3,11,14,1260,1232,2133,901
2016,3,11,15,1335,1328,2511,1183
2016,3,11,16,1325,1321,2562,1241
2016,3,11,17,1310,1306,2391,1085
2016,3,11,18,1295,1291,2272,981
2016,3,11,19,1275,1274,2252,978
2016,3,11,20,1235,1243,2229,986
2016,3,11,21,1235,1234,2263,1029
2016,3,11,22,1225,1218,2284,1066
2016,3,11,23,1210,1225,2105,880
2016,3,12,0,1195,1215,2147,932
2016,3,12,1,1200,1231,2373,1142
2016,3,12,2,1255,1266,2442,1176
2016,3,12,3,1275,1283,2536,1253
2016,3,12,4,1250,1260,2523,1263
2016,3,12,5,1210,1213,2425,1212
2016,3,12,6,1145,1153,2364,1211
2016,3,12,7,1090,1081,2190,1109
2016,3,12,8,1050,1041,2103,1062
2016,3,12,9,1025,1010,1791,781
2016,3,12,10,1020,1000,1618,618
2016,3,12,11,1015,1003,1560,557
2016,3,12,12,1030,1018,1484,466
2016,3,12,13,1070,1034,1473,439
2016,3,12,14,1140,1079,1357,278
2016,3,12,15,1135,1135,1395,260
2016,3,12,16,1160,1164,1301,137
2016,3,12,17,1215,1183,1429,246
2016,3,12,18,1220,1195,1628,433
2016,3,12,19,1205,1195,1761,566
2016,3,12,20,1185,1173,1538,365
2016,3,12,21,1165,1170,1566,396
2016,3,12,22,1150,1138,1526,388
2016,3,12,23,1145,1131,1419,288
2016,3,13,0,1160,1148,1390,242
2016,3,13,1,1170,1169,1464,295
2016,3,13,2,1215,1197,1421,224
2016,3,13,3,1225,1226,1455,229
2016,3,13,4,1210,1203,1548,345
2016,3,13,5,1150,1171,1477,306
2016,3,13,6,1090,1114,1360,246
2016,3,13,7,1030,1064,1353,289
2016,3,13,8,1000,1035,1473,438
2016,3,13,9,980,966,1658,692
2016,3,13,10,985,1011,1733,722
2016,3,13,11,1000,1018,1739,721
2016,3,13,12,1040,1032,1778,746
2016,3,13,13,1135,1077,1782,705
2016,3,13,14,1210,1125,1810,685
2016,3,13,15,1220,1152,1679,527
2016,3,13,16,1235,1165,1684,519
2016,3,13,17,1270,1187,1810,623
2016,3,13,18,1270,1200,1855,655
2016,3,13,19,1245,1189,1783,594
2016,3,13,20,1235,1167,1739,572
2016,3,13,21,1225,1161,1695,534
2016,3,13,22,1215,1149,1744,595
2016,3,13,23,1245,1157,1488,331
2016,3,14,0,1265,1158,1380,222
2016,3,14,1,1315,1173,1345,172
2016,3,14,2,1320,1231,1357,126
2016,3,14,3,1310,1247,1560,313
2016,3,14,4,1225,1206,1470,264
2016,3,14,5,1165,1154,1553,399
2016,3,14,6,1090,1086,1727,641
2016,3,14,7,1010,1045,1684,639
2016,3,14,8,1000,1037,1700,663
2016,3,14,9,985,1029,1780,751
2016,3,14,10,975,1017,1627,610
2016,3,14,11,1005,1047,1358,311
2016,3,14,12,1070,1111,1668,557
2016,3,14,13,1210,1235,1917,682
2016,3,14,14,1310,1365,2286,921
2016,3,14,15,1295,1364,2344,980
2016,3,14,16,1275,1357,2223,866
2016,3,14,17,1290,1347,2066,719
2016,3,14,18,1275,1329,2035,706
2016,3,14,19,1255,1301,1927,626
2016,3,14,20,1240,1298,1886,588
2016,3,14,21,1225,1301,1900,599
2016,3,14,22,1215,1284,1826,542
2016,3,14,23,1235,1294,1851,557
2016,3,15,0,1240,1307,1803,496
2016,3,15,1,1300,1316,1835,519
2016,3,15,2,1310,1351,2089,738
2016,3,15,3,1305,1365,2334,969
2016,3,15,4,1240,1314,2308,994
2016,3,15,5,1160,1232,2337,1105
2016,3,15,6,1080,1167,2108,941
2016,3,15,7,1090,1120,1972,852
2016,3,15,8,1045,1108,1910,802
2016,3,15,9,1050,1099,1908,809
2016,3,15,10,1055,1108,1912,804
2016,3,15,11,1065,1109,1886,777
2016,3,15,12,1115,1170,2024,854
2016,3,15,13,1225,1306,2210,904
2016,3,15,14,1305,1402,2277,875
2016,3,15,15,1320,1404,2418,1014
2016,3,15,16,1325,1396,2255,859
2016,3,15,17,1330,1395,2205,810
2016,3,15,18,1335,1373,2321,948
2016,3,15,19,1320,1351,2257,906
2016,3,15,20,1310,1336,2098,762
2016,3,15,21,1290,1323,2111,788
2016,3,15,22,1270,1311,2136,825
2016,3,15,23,1290,1311,1908,597
2016,3,16,0,1295,1314,1902,588
2016,3,16,1,1335,1321,1952,631
2016,3,16,2,1370,1362,2071,709
2016,3,16,3,1370,1381,2119,738
2016,3,16,4,1290,1341,1974,633
2016,3,16,5,1230,1251,1926,675
2016,3,16,6,1160,1189,1976,787
2016,3,16,7,1120,1146,1824,678
2016,3,16,8,1080,1124,1863,739
2016,3,16,9,1085,1110,1662,552
2016,3,16,10,1090,1115,1617,502
2016,3,16,11,1110,1133,1821,688
2016,3,16,12,1160,1197,2045,848
2016,3,16,13,1250,1328,2252,924
2016,3,16,14,1320,1439,2639,1200
2016,3,16,15,1340,1437,2654,1217
2016,3,16,16,1345,1408,2568,1160
2016,3,16,17,1350,1410,2516,1106
2016,3,16,18,1350,1380,2450,1070
2016,3,16,19,1325,1339,2347,1008
2016,3,16,20,1320,1330,2347,1017
2016,3,16,21,1305,1309,2346,1037
2016,3,16,22,1290,1312,2342,1030
2016,3,16,23,1300,1318,2348,1030
2016,3,17,0,1295,1299,2117,818
2016,3,17,1,1335,1303,2096,793
2016,3,17,2,1375,1318,2094,776
2016,3,17,3,1370,1365,2182,817
2016,3,17,4,1305,1333,2285,952
2016,3,17,5,1245,1246,2061,815
2016,3,17,6,1170,1160,1751,591
2016,3,17,7,1170,1124,1654,530
2016,3,17,8,1150,1117,1686,569
2016,3,17,9,1140,1098,1703,605
2016,3,17,10,1145,1107,1703,596
2016,3,17,11,1165,1134,1836,702
2016,3,17,12,1225,1210,2045,835
2016,3,17,13,1365,1361,2351,990
2016,3,17,14,1470,1455,2608,1153
2016,3,17,15,1465,1468,2622,1154
2016,3,17,16,1445,1456,2630,1174
2016,3,17,17,1450,1437,2580,1143
2016,3,17,18,1420,1412,2590,1178
2016,3,17,19,1400,1407,2531,1124
2016,3,17,20,1395,1377,2510,1133
2016,3,17,21,1370,1353,2356,1003
2016,3,17,22,1360,1350,2328,978
2016,3,17,23,1370,1350,2394,1044
2016,3,18,0,1380,1330,2382,1052
2016,3,18,1,1405,1303,2222,919
2016,3,18,2,1435,1332,2210,878
2016,3,18,3,1435,1362,2365,1003
2016,3,18,4,1360,1335,2378,1043
2016,3,18,5,1285,1264,2302,1038
2016,3,18,6,1225,1198,2149,951
2016,3,18,7,1105,1165,1878,713
2016,3,18,8,1090,1143,1928,785
2016,3,18,9,1085,1139,1996,857
2016,3,18,10,1100,1144,1986,842
2016,3,18,11,1125,1170,1933,763
2016,3,18,12,1195,1229,2152,923
2016,3,18,13,1325,1336,2302,966
2016,3,18,14,1420,1438,2398,960
2016,3,18,15,1400,1449,2462,1013
2016,3,18,16,1385,1428,2449,1021
2016,3,18,17,1380,1429,2418,989
2016,3,18,18,1355,1393,2367,974
2016,3,18,19,1320,1366,2439,1073
2016,3,18,20,1305,1341,2319,978
2016,3,18,21,1285,1309,2089,780
2016,3,18,22,1290,1285,1855,570
2016,3,18,23,1295,1264,1647,383
2016,3,19,0,1265,1256,1699,443
2016,3,19,1,1275,1243,1907,664
2016,3,19,2,1295,1297,2099,802
2016,3,19,3,1330,1343,2170,827
2016,3,19,4,1295,1318,2219,901
2016,3,19,5,1205,1255,2236,981
2016,3,19,6,1145,1210,2204,994
2016,3,19,7,1110,1161,2135,974
2016,3,19,8,1095,1149,2047,898
2016,3,19,9,1080,1123,1835,712
2016,3,19,10,1090,1133,1804,671
2016,3,19,11,1110,1149,1831,682
2016,3,19,12,1120,1165,1832,667
2016,3,19,13,1220,1225,1830,605
2016,3,19,14,1300,1287,1892,605
2016,3,19,15,1340,1317,1870,553
2016,3,19,16,1370,1328,1804,476
2016,3,19,17,1370,1318,1774,456
2016,3,19,18,1355,1288,1728,440
2016,3,19,19,1345,1260,1829,569
2016,3,19,20,1325,1228,1677,449
2016,3,19,21,1295,1190,1563,373
2016,3,19,22,1295,1174,1396,222
2016,3,19,23,1295,1163,1353,190
2016,3,20,0,1310,1161,1322,161
2016,3,20,1,1325,1170,1492,322
2016,3,20,2,1345,1212,1588,376
2016,3,20,3,1345,1264,1825,561
2016,3,20,4,1290,1254,1897,643
2016,3,20,5,1235,1196,1911,715
2016,3,20,6,1175,1141,1901,760
2016,3,20,7,1035,1103,1838,735
2016,3,20,8,1005,1087,1746,659
2016,3,20,9,1000,1076,1763,687
2016,3,20,10,1010,1074,1753,679
2016,3,20,11,1025,1081,1719,638
2016,3,20,12,1050,1114,1758,644
2016,3,20,13,1120,1140,1632,492
2016,3,20,14,1190,1196,1599,403
2016,3,20,15,1235,1221,1652,431
2016,3,20,16,1250,1249,1678,429
2016,3,20,17,1260,1221,1728,507
2016,3,20,18,1265,1212,1662,450
2016,3,20,19,1255,1180,1641,461
2016,3,20,20,1245,1149,1642,493
2016,3,20,21,1225,1142,1637,495
2016,3,20,22,1220,1136,1638,502
2016,3,20,23,1240,1134,1471,337
2016,3,21,0,1240,1152,1595,443
2016,3,21,1,1220,1176,1724,548
2016,3,21,2,1250,1204,1725,521
2016,3,21,3,1265,1256,1798,542
2016,3,21,4,1210,1208,1720,512
2016,3,21,5,1165,1118,1767,649
2016,3,21,6,1115,1051,1728,677
2016,3,21,7,1065,1012,1638,626
2016,3,21,8,1050,995,1581,586
2016,3,21,9,1035,986,1495,509
2016,3,21,10,1020,988,1461,473
2016,3,21,11,1045,1031,1510,479
2016,3,21,12,1115,1090,1636,546
2016,3,21,13,1260,1217,1905,688
2016,3,21,14,1380,1324,2336,1012
2016,3,21,15,1365,1330,2418,1088
2016,3,21,16,1365,1331,2389,1058
2016,3,21,17,1370,1322,2329,1007
2016,3,21,18,1350,1311,2272,961
2016,3,21,19,1330,1298,2224,926
2016,3,21,20,1315,1297,2191,894
2016,3,21,21,1300,1272,2183,911
2016,3,21,22,1295,1255,2127,872
2016,3,21,23,1300,1246,2041,795
2016,3,22,0,1300,1240,1956,716
2016,3,22,1,1320,1243,2162,919
2016,3,22,2,1340,1267,2351,1084
2016,3,22,3,1340,1295,2313,1018
2016,3,22,4,1290,1228,2154,926
2016,3,22,5,1225,1142,1997,855
2016,3,22,6,1155,1068,1681,613
2016,3,22,7,1060,1032,1559,527
2016,3,22,8,1050,1013,1534,521
2016,3,22,9,1040,1009,1261,252
2016,3,22,10,1040,1010,1279,269
2016,3,22,11,1050,1033,1365,332
2016,3,22,12,1105,1093,1512,419
2016,3,22,13,1225,1236,2034,798
2016,3,22,14,1345,1336,2275,939
2016,3,22,15,1345,1334,2272,938
2016,3,22,16,1355,1352,2292,940
2016,3,22,17,1345,1357,2181,824
2016,3,22,18,1320,1345,2024,679
2016,3,22,19,1290,1332,1908,576
2016,3,22,20,1270,1316,1630,314
2016,3,22,21,1255,1297,1450,153
2016,3,22,22,1250,1292,1381,89
2016,3,22,23,1240,1314,1548,234
2016,3,23,0,1260,1334,1545,211
2016,3,23,1,1295,1336,1637,301
2016,3,23,2,1320,1357,1774,417
2016,3,23,3,1350,1362,1826,464
2016,3,23,4,1280,1320,1850,530
2016,3,23,5,1210,1228,1806,578
2016,3,23,6,1150,1143,1728,585
2016,3,23,7,1075,1106,1517,411
2016,3,23,8,1060,1090,1187,97
2016,3,23,9,1050,1077,1191,114
2016,3,23,10,1055,1061,1150,89
2016,3,23,11,1075,1081,1159,78
2016,3,23,12,1140,1130,1267,137
2016,3,23,13,1250,1264,1714,450
2016,3,23,14,1340,1352,1798,446
2016,3,23,15,1330,1367,1872,505
2016,3,23,16,1320,1354,1883,529
2016,3,23,17,1320,1327,1853,526
2016,3,23,18,1295,1302,1600,298
2016,3,23,19,1275,1271,1626,355
2016,3,23,20,1265,1244,1606,362
2016,3,23,21,1255,1254,1610,356
2016,3,23,22,1250,1246,1673,427
2016,3,23,23,1240,1249,1730,481
2016,3,24,0,1225,1250,1851,601
2016,3,24,1,1255,1256,1924,668
2016,3,24,2,1275,1293,2002,709
2016,3,24,3,1285,1350,2257,907
2016,3,24,4,1220,1310,2248,938
2016,3,24,5,1155,1219,2144,925
2016,3,24,6,1085,1159,2142,983
2016,3,24,7,1040,1114,1962,848
2016,3,24,8,1025,1093,1916,823
2016,3,24,9,1030,1058,1539,481
2016,3,24,10,1035,1058,1427,369
2016,3,24,11,1055,1091,1360,269
2016,3,24,12,1115,1141,1316,175
2016,3,24,13,1280,1270,1525,255
2016,3,24,14,1400,1341,1585,244
2016,3,24,15,1395,1367,1826,459
2016,3,24,16,1390,1360,1621,261
2016,3,24,17,1390,1353,1591,238
2016,3,24,18,1380,1329,1530,201
2016,3,24,19,1355,1309,1292,-17
2016,3,24,20,1345,1292,1291,-1
2016,3,24,21,1335,1279,1240,-39
2016,3,24,22,1330,1265,1222,-43
2016,3,24,23,1340,1280,1334,54
2016,3,25,0,1340,1271,1324,53
2016,3,25,1,1350,1276,1411,135
2016,3,25,2,1365,1306,1546,240
2016,3,25,3,1380,1332,1610,278
2016,3,25,4,1310,1280,1526,246
2016,3,25,5,1240,1201,1532,331
2016,3,25,6,1155,1121,1474,353
2016,3,25,7,1045,1087,1406,319
2016,3,25,8,1030,1067,1255,188
2016,3,25,9,1035,1052,1197,145
2016,3,25,10,1040,1053,1200,147
2016,3,25,11,1050,1067,1193,126
2016,3,25,12,1105,1119,1364,245
2016,3,25,13,1230,1224,1685,461
2016,3,25,14,1335,1301,1774,473
2016,3,25,15,1340,1326,2012,686
2016,3,25,16,1320,1329,2029,700
2016,3,25,17,1315,1329,1910,581
2016,3,25,18,1290,1302,1885,583
2016,3,25,19,1275,1278,1731,453
2016,3,25,20,1255,1278,1653,375
2016,3,25,21,1240,1262,1671,409
2016,3,25,22,1225,1264,1797,533
2016,3,25,23,1215,1264,1810,546
2016,3,26,0,1205,1259,1904,645
2016,3,26,1,1225,1251,1827,576
2016,3,26,2,1250,1275,1966,691
2016,3,26,3,1275,1295,1988,693
2016,3,26,4,1220,1257,2141,884
2016,3,26,5,1155,1203,2091,888
2016,3,26,6,1110,1133,2010,877
2016,3,26,7,1030,1104,2026,922
2016,3,26,8,1015,1075,1951,876
2016,3,26,9,1000,1061,1866,805
2016,3,26,10,1010,1055,1818,763
2016,3,26,11,1020,1065,1845,780
2016,3,26,12,1050,1093,1861,768
2016,3,26,13,1145,1145,1843,698
2016,3,26,14,1225,1211,1948,737
2016,3,26,15,1260,1274,2105,831
2016,3,26,16,1270,1299,2233,934
2016,3,26,17,1255,1287,2300,1013
2016,3,26,18,1240,1246,2201,955
2016,3,26,19,1230,1209,2106,897
2016,3,26,20,1200,1173,1785,612
2016,3,26,21,1175,1153,1623,470
2016,3,26,22,1165,1137,1364,227
2016,3,26,23,1175,1128,1369,241
2016,3,27,0,1185,1135,1399,264
2016,3,27,1,1190,1162,1683,521
2016,3,27,2,1225,1192,1760,568
2016,3,27,3,1240,1253,2169,916
2016,3,27,4,1215,1234,2203,969
2016,3,27,5,1125,1172,2180,1008
2016,3,27,6,1060,1114,2038,924
2016,3,27,7,1030,1063,1808,745
2016,3,27,8,1005,1045,1661,616
2016,3,27,9,995,1024,1529,505
2016,3,27,10,990,1028,1153,125
2016,3,27,11,1000,1038,1136,98
2016,3,27,12,1030,1068,1156,88
2016,3,27,13,1140,1123,1170,47
2016,3,27,14,1220,1166,1170,4
2016,3,27,15,1250,1202,1174,-28
2016,3,27,16,1290,1222,1204,-18
2016,3,27,17,1280,1192,1257,65
2016,3,27,18,1275,1183,1266,83
2016,3,27,19,1255,1169,1288,119
2016,3,27,20,1235,1148,1286,138
2016,3,27,21,1220,1129,1230,101
2016,3,27,22,1210,1128,1240,112
2016,3,27,23,1220,1136,1198,62
2016,3,28,0,1220,1142,1212,70
2016,3,28,1,1240,1152,1185,33
2016,3,28,2,1275,1191,1282,91
2016,3,28,3,1235,1239,1382,143
2016,3,28,4,1240,1209,1546,337
2016,3,28,5,1170,1131,1587,456
2016,3,28,6,1085,1075,1337,262
2016,3,28,7,1010,1044,1253,209
2016,3,28,8,995,1022,1159,137
2016,3,28,9,980,1024,1173,149
2016,3,28,10,970,1031,1170,139
2016,3,28,11,990,1038,1190,152
2016,3,28,12,1060,1085,1354,269
2016,3,28,13,1205,1204,1760,556
2016,3,28,14,1335,1311,2134,823
2016,3,28,15,1340,1326,2178,852
2016,3,28,16,1340,1357,2337,980
2016,3,28,17,1325,1358,2256,898
2016,3,28,18,1310,1337,2062,725
2016,3,28,19,1295,1309,1966,657
2016,3,28,20,1275,1287,2019,732
2016,3,28,21,1270,1283,2079,796
2016,3,28,22,1255,1258,2046,788
2016,3,28,23,1260,1257,2098,841
2016,3,29,0,1250,1256,2277,1021
2016,3,29,1,1270,1257,2306,1049
2016,3,29,2,1300,1296,2323,1027
2016,3,29,3,1305,1328,2401,1073
2016,3,29,4,1240,1274,2401,1127
2016,3,29,5,1170,1198,2405,1207
2016,3,29,6,1090,1113,2377,1264
2016,3,29,7,995,1074,2098,1024
2016,3,29,8,980,1056,1808,752
2016,3,29,9,975,1032,1459,427
2016,3,29,10,980,1039,1391,352
2016,3,29,11,995,1054,1523,469
2016,3,29,12,1035,1144,2111,967
2016,3,29,13,1170,1263,2342,1079
2016,3,29,14,1295,1365,2446,1081
2016,3,29,15,1300,1365,2430,1065
2016,3,29,16,1315,1370,2394,1024
2016,3,29,17,1305,1366,2349,983
2016,3,29,18,1300,1375,2332,957
2016,3,29,19,1270,1354,2378,1024
2016,3,29,20,1255,1350,1979,629
2016,3,29,21,1240,1324,1606,282
2016,3,29,22,1235,1324,1573,249
2016,3,29,23,1240,1336,1503,167
2016,3,30,0,1250,1320,1379,59
2016,3,30,1,1270,1322,1431,109
2016,3,30,2,1290,1335,1500,165
2016,3,30,3,1325,1341,1625,284
2016,3,30,4,1250,1307,2085,778
2016,3,30,5,1180,1215,2114,899
2016,3,30,6,1115,1136,2005,869
2016,3,30,7,1030,1089,1812,723
2016,3,30,8,1020,1071,1934,863
2016,3,30,9,1020,1061,1812,751
2016,3,30,10,1025,1073,1926,853
2016,3,30,11,1045,1097,2013,916
2016,3,30,12,1085,1150,2194,1044
2016,3,30,13,1220,1282,2266,984
2016,3,30,14,1330,1353,2273,920
2016,3,30,15,1330,1330,2244,914
2016,3,30,16,1315,1308,2275,967
2016,3,30,17,1315,1291,2324,1033
2016,3,30,18,1295,1275,2301,1026
2016,3,30,19,1280,1229,2230,1001
2016,3,30,20,1255,1207,2194,987
2016,3,30,21,1250,1261,2306,1045
2016,3,30,22,1230,1251,2257,1006
2016,3,30,23,1235,1267,2263,996
2016,3,31,0,1230,1266,2283,1017
2016,3,31,1,1250,1275,2260,985
2016,3,31,2,1265,1307,2291,984
2016,3,31,3,1295,1332,2351,1019
2016,3,31,4,1240,1293,2334,1041
2016,3,31,5,1170,1204,2213,1009
2016,3,31,6,1100,1118,1909,791
2016,3,31,7,1075,1093,1668,575
2016,3,31,8,1055,1072,1557,485
2016,3,31,9,1040,1075,1542,467
2016,3,31,10,1050,1088,1571,483
2016,3,31,11,1060,1103,1533,430
2016,3,31,12,1130,1157,1588,431
2016,3,31,13,1260,1281,1598,317
2016,3,31,14,1365,1357,1606,249
2016,3,31,15,1360,1353,1644,291
2016,3,31,16,1355,1361,1655,294
2016,3,31,17,1340,1341,1475,134
2016,3,31,18,1335,1330,1542,212
2016,3,31,19,1315,1307,1513,206
2016,3,31,20,1305,1304,1540,236
2016,3,31,21,1285,1278,1608,330
2016,3,31,22,1285,1265,1631,366
2016,3,31,23,1305,1275,1661,386
2016,4,1,0,1290,1266,1640,374
2016,4,1,1,1300,1259,1631,372
2016,4,1,2,1325,1279,1682,403
2016,4,1,3,1330,1317,1662,345
2016,4,1,4,1270,1282,1651,369
2016,4,1,5,1200,1188,1633,445
2016,4,1,6,1120,1125,1649,524
2016,4,1,7,1050,1092,1604,512
2016,4,1,8,1020,1077,1486,409
2016,4,1,9,1005,1069,1478,409
2016,4,1,10,1020,1072,1497,425
2016,4,1,11,1055,1079,1495,416
2016,4,1,12,1100,1140,1612,472
2016,4,1,13,1265,1250,1611,361
2016,4,1,14,1395,1326,1622,296
2016,4,1,15,1390,1347,1670,323
2016,4,1,16,1370,1344,1682,338
2016,4,1,17,1360,1330,1719,389
2016,4,1,18,1340,1314,1724,410
2016,4,1,19,1315,1246,1732,486
2016,4,1,20,1295,1225,1788,563
2016,4,1,21,1295,1205,1887,682
2016,4,1,22,1295,1189,1908,719
2016,4,1,23,1300,1170,1991,821
2016,4,2,0,1295,1167,1998,831
2016,4,2,1,1295,1156,2047,891
2016,4,2,2,1310,1168,2122,954
2016,4,2,3,1340,1225,2157,932
2016,4,2,4,1280,1199,2118,919
2016,4,2,5,1215,1137,1956,819
2016,4,2,6,1145,1075,1864,789
2016,4,2,7,1025,1030,1763,733
2016,4,2,8,1005,1015,1605,590
2016,4,2,9,1000,1013,1605,592
2016,4,2,10,1015,1015,1597,582
2016,4,2,11,1025,1034,1574,540
2016,4,2,12,1060,1035,1537,502
2016,4,2,13,1100,1101,1560,459
2016,4,2,14,1140,1149,1652,503
2016,4,2,15,1180,1191,1663,472
2016,4,2,16,1200,1196,1657,461
2016,4,2,17,1195,1204,1677,473
2016,4,2,18,1180,1189,1666,477
2016,4,2,19,1160,1167,1620,453
2016,4,2,20,1140,1156,1524,368
2016,4,2,21,1115,1136,1478,342
2016,4,2,22,1110,1124,1279,155
2016,4,2,23,1110,1130,1267,137
2016,4,3,0,1115,1133,1281,148
2016,4,3,1,1110,1126,1303,177
2016,4,3,2,1135,1136,1372,236
2016,4,3,3,1170,1185,1468,283
2016,4,3,4,1125,1158,1389,231
2016,4,3,5,1075,1104,1359,255
2016,4,3,6,1020,1039,1547,508
2016,4,3,7,995,1002,1419,417
2016,4,3,8,985,980,1470,490
2016,4,3,9,975,970,1441,471
2016,4,3,10,985,964,1442,478
2016,4,3,11,995,968,1600,632
2016,4,3,12,1030,979,1638,659
2016,4,3,13,1105,1013,1627,614
2016,4,3,14,1170,1048,1551,503
2016,4,3,15,1185,1098,1689,591
2016,4,3,16,1195,1130,1707,577
2016,4,3,17,1190,1144,1667,523
2016,4,3,18,1185,1139,1645,506
2016,4,3,19,1160,1137,1717,580
2016,4,3,20,1150,1132,1725,593
2016,4,3,21,1130,1115,1708,593
2016,4,3,22,1120,1115,1715,600
2016,4,3,23,1130,1125,1655,530
2016,4,4,0,1130,1134,1640,506
2016,4,4,1,1145,1151,1707,556
2016,4,4,2,1155,1164,1814,650
2016,4,4,3,1200,1216,2054,838
2016,4,4,4,1145,1195,2139,944
2016,4,4,5,1085,1103,2054,951
2016,4,4,6,1020,1040,1759,719
2016,4,4,7,970,995,1567,572
2016,4,4,8,950,985,1489,504
2016,4,4,9,950,975,1403,428
2016,4,4,10,965,959,1269,310
2016,4,4,11,980,977,1146,169
2016,4,4,12,1035,1043,1306,263
2016,4,4,13,1180,1162,1470,308
2016,4,4,14,1290,1242,1697,455
2016,4,4,15,1285,1249,1745,496
2016,4,4,16,1275,1261,1659,398
2016,4,4,17,1275,1253,1590,337
2016,4,4,18,1270,1250,1596,346
2016,4,4,19,1255,1244,1606,362
2016,4,4,20,1235,1239,1716,477
2016,4,4,21,1225,1238,1723,485
2016,4,4,22,1210,1251,1637,386
2016,4,4,23,1210,1267,1540,273
2016,4,5,0,1205,1275,1399,124
2016,4,5,1,1205,1281,1526,245
2016,4,5,2,1220,1268,1583,315
2016,4,5,3,1250,1288,1566,278
2016,4,5,4,1190,1251,1635,384
2016,4,5,5,1125,1178,1658,480
2016,4,5,6,1055,1095,1553,458
2016,4,5,7,990,1062,1363,301
2016,4,5,8,970,1043,1297,254
2016,4,5,9,960,1041,1301,260
2016,4,5,10,970,1035,1295,260
2016,4,5,11,980,1051,1295,244
2016,4,5,12,1020,1109,1337,228
2016,4,5,13,1130,1232,1715,483
2016,4,5,14,1230,1327,1998,671
2016,4,5,15,1240,1332,2072,740
2016,4,5,16,1255,1350,2068,718
2016,4,5,17,1260,1330,1890,560
2016,4,5,18,1260,1322,1767,445
2016,4,5,19,1245,1311,1676,365
2016,4,5,20,1240,1280,1767,487
2016,4,5,21,1220,1260,1968,708
2016,4,5,22,1225,1233,1948,715
2016,4,5,23,1230,1269,1936,667
2016,4,6,0,1240,1270,1937,667
2016,4,6,1,1250,1278,2070,792
2016,4,6,2,1275,1298,2239,941
2016,4,6,3,1290,1343,2425,1082
2016,4,6,4,1220,1308,2470,1162
2016,4,6,5,1165,1213,2448,1235
2016,4,6,6,1100,1126,2431,1305
2016,4,6,7,1045,1089,2220,1131
2016,4,6,8,1030,1061,1842,781
2016,4,6,9,1020,1063,1818,755
2016,4,6,10,1025,1067,2052,985
2016,4,6,11,1050,1076,2074,998
2016,4,6,12,1100,1130,2258,1128
2016,4,6,13,1230,1283,2443,1160
2016,4,6,14,1325,1346,2429,1083
2016,4,6,15,1320,1362,2495,1133
2016,4,6,16,1305,1358,2473,1115
2016,4,6,17,1290,1332,2428,1096
2016,4,6,18,1280,1313,2362,1049
2016,4,6,19,1260,1295,2294,999
2016,4,6,20,1240,1297,2309,1012
2016,4,6,21,1245,1277,2236,959
2016,4,6,22,1240,1274,2246,972
2016,4,6,23,1265,1261,2239,978
2016,4,7,0,1280,1250,2293,1043
2016,4,7,1,1270,1243,2295,1052
2016,4,7,2,1275,1250,2258,1008
2016,4,7,3,1305,1278,2272,994
2016,4,7,4,1295,1255,2351,1096
2016,4,7,5,1180,1147,2194,1047
2016,4,7,6,1105,1064,2003,939
2016,4,7,7,1030,1027,1967,940
2016,4,7,8,1010,1000,2093,1093
2016,4,7,9,1010,982,2104,1122
2016,4,7,10,1015,992,2028,1036
2016,4,7,11,1030,1014,1787,773
2016,4,7,12,1090,1083,1923,840
2016,4,7,13,1215,1193,2195,1002
2016,4,7,14,1300,1263,2335,1072
2016,4,7,15,1290,1256,2365,1109
2016,4,7,16,1280,1241,2386,1145
2016,4,7,17,1265,1238,2285,1047
2016,4,7,18,1275,1227,2220,993
2016,4,7,19,1260,1214,2189,975
2016,4,7,20,1250,1207,2198,991
2016,4,7,21,1225,1195,2220,1025
2016,4,7,22,1200,1199,2316,1117
2016,4,7,23,1220,1189,2329,1140
2016,4,8,0,1215,1176,2343,1167
2016,4,8,1,1210,1163,2296,1133
2016,4,8,2,1235,1164,2184,1020
2016,4,8,3,1260,1213,2194,981
2016,4,8,4,1210,1194,2181,987
2016,4,8,5,1145,1101,2190,1089
2016,4,8,6,1065,1041,2178,1137
2016,4,8,7,990,992,1902,910
2016,4,8,8,975,962,1837,875
2016,4,8,9,975,982,1935,953
2016,4,8,10,975,977,1900,923
2016,4,8,11,990,990,1815,825
2016,4,8,12,1040,1048,1835,787
2016,4,8,13,1185,1160,1936,776
2016,4,8,14,1275,1228,1980,752
2016,4,8,15,1270,1202,1854,652
2016,4,8,16,1265,1202,1766,564
2016,4,8,17,1255,1190,1597,407
2016,4,8,18,1240,1192,1575,383
2016,4,8,19,1210,1186,1838,652
2016,4,8,20,1200,1197,1960,763
2016,4,8,21,1180,1177,2001,824
2016,4,8,22,1175,1178,2015,837
2016,4,8,23,1160,1179,2032,853
2016,4,9,0,1145,1168,2048,880
2016,4,9,1,1135,1150,1977,827
2016,4,9,2,1145,1161,2028,867
2016,4,9,3,1170,1205,2038,833
2016,4,9,4,1145,1186,2007,821
2016,4,9,5,1080,1108,2009,901
2016,4,9,6,1020,1037,2066,1029
2016,4,9,7,975,1009,2009,1000
2016,4,9,8,950,989,1971,982
2016,4,9,9,940,981,1955,974
2016,4,9,10,945,977,1858,881
2016,4,9,11,965,972,1658,686
2016,4,9,12,990,997,1587,590
2016,4,9,13,1065,1035,1443,408
2016,4,9,14,1135,1063,1287,224
2016,4,9,15,1145,1119,1394,275
2016,4,9,16,1160,1153,1561,408
2016,4,9,17,1160,1173,1795,622
2016,4,9,18,1150,1156,1886,730
2016,4,9,19,1130,1139,1878,739
2016,4,9,20,1110,1137,1880,743
2016,4,9,21,1095,1120,1963,843
2016,4,9,22,1100,1105,1951,846
2016,4,9,23,1095,1103,1864,761
2016,4,10,0,1085,1094,1944,850
2016,4,10,1,1095,1091,1943,852
2016,4,10,2,1115,1081,1867,786
2016,4,10,3,1150,1123,1798,675
2016,4,10,4,1110,1110,1637,527
2016,4,10,5,1065,1049,1581,532
2016,4,10,6,990,990,1740,750
2016,4,10,7,970,965,1692,727
2016,4,10,8,950,947,1459,512
2016,4,10,9,930,939,1331,392
2016,4,10,10,940,942,1240,298
2016,4,10,11,955,938,1256,318
2016,4,10,12,975,955,1251,296
2016,4,10,13,1055,978,1242,264
2016,4,10,14,1120,1026,1283,257
2016,4,10,15,1145,1080,1278,198
2016,4,10,16,1160,1133,1446,313
2016,4,10,17,1160,1148,1644,496
2016,4,10,18,1155,1149,1527,378
2016,4,10,19,1145,1148,1625,477
2016,4,10,20,1135,1136,1875,739
2016,4,10,21,1115,1133,2032,899
2016,4,10,22,1115,1110,1991,881
2016,4,10,23,1115,1119,2047,928
2016,4,11,0,1105,1136,2123,987
2016,4,11,1,1115,1151,2178,1027
2016,4,11,2,1130,1169,2174,1005
2016,4,11,3,1180,1219,2402,1183
2016,4,11,4,1110,1199,2262,1063
2016,4,11,5,1080,1100,1891,791
2016,4,11,6,1010,1033,1671,638
2016,4,11,7,985,983,1450,467
2016,4,11,8,960,964,1151,187
2016,4,11,9,950,961,1139,178
2016,4,11,10,955,974,1136,162
2016,4,11,11,975,997,1118,121
2016,4,11,12,1035,1049,1143,94
2016,4,11,13,1180,1178,1260,82
2016,4,11,14,1295,1263,1534,271
2016,4,11,15,1285,1276,1530,254
2016,4,11,16,1270,1269,1488,219
2016,4,11,17,1270,1252,1361,109
2016,4,11,18,1255,1239,1244,5
2016,4,11,19,1250,1219,1166,-53
2016,4,11,20,1230,1219,1221,2
2016,4,11,21,1225,1203,1261,58
2016,4,11,22,1220,1212,1284,72
2016,4,11,23,1230,1201,1448,247
2016,4,12,0,1225,1185,1399,214
2016,4,12,1,1225,1181,1458,277
2016,4,12,2,1230,1163,1387,224
2016,4,12,3,1270,1217,1583,366
2016,4,12,4,1215,1185,1630,445
2016,4,12,5,1155,1086,1378,292
2016,4,12,6,1070,1003,1244,241
2016,4,12,7,985,971,1281,310
2016,4,12,8,970,965,1277,312
2016,4,12,9,960,948,1297,349
2016,4,12,10,980,944,1327,383
2016,4,12,11,985,961,1393,432
2016,4,12,12,1035,1029,1535,506
2016,4,12,13,1125,1157,1660,503
2016,4,12,14,1200,1236,1831,595
2016,4,12,15,1220,1257,2151,894
2016,4,12,16,1235,1250,2041,791
2016,4,12,17,1235,1236,1811,575
2016,4,12,18,1240,1247,1776,529
2016,4,12,19,1235,1223,1491,268
2016,4,12,20,1225,1238,1535,297
2016,4,12,21,1210,1237,1715,478
2016,4,12,22,1195,1226,1753,527
2016,4,12,23,1210,1238,1748,510
2016,4,13,0,1215,1227,1612,385
2016,4,13,1,1225,1249,1799,550
2016,4,13,2,1245,1268,2183,915
2016,4,13,3,1275,1307,2379,1072
2016,4,13,4,1180,1263,2329,1066
2016,4,13,5,1155,1158,2297,1139
2016,4,13,6,1080,1068,2031,963
2016,4,13,7,1065,1001,1483,482
2016,4,13,8,1045,978,1197,219
2016,4,13,9,1040,969,1197,228
2016,4,13,10,1050,969,1233,264
2016,4,13,11,1080,997,1214,217
2016,4,13,12,1125,1039,1255,216
2016,4,13,13,1265,1163,1341,178
2016,4,13,14,1345,1263,1544,281
2016,4,13,15,1345,1310,2123,813
2016,4,13,16,1330,1315,1996,681
2016,4,13,17,1315,1304,1929,625
2016,4,13,18,1305,1296,1858,562
2016,4,13,19,1290,1267,1782,515
2016,4,13,20,1290,1260,1661,401
2016,4,13,21,1275,1238,1634,396
2016,4,13,22,1270,1243,1687,444
2016,4,13,23,1270,1239,1697,458
2016,4,14,0,1255,1217,1749,532
2016,4,14,1,1265,1217,1932,715
2016,4,14,2,1250,1233,2148,915
2016,4,14,3,1290,1281,2228,947
2016,4,14,4,1230,1250,2352,1102
2016,4,14,5,1160,1154,2102,948
2016,4,14,6,1075,1069,2023,954
2016,4,14,7,1035,996,1687,691
2016,4,14,8,1020,989,1503,514
2016,4,14,9,1010,964,1471,507
2016,4,14,10,1020,966,1360,394
2016,4,14,11,1035,988,1416,428
2016,4,14,12,1095,1059,1473,414
2016,4,14,13,1230,1189,1466,277
2016,4,14,14,1315,1279,1638,359
2016,4,14,15,1305,1288,1707,419
2016,4,14,16,1300,1286,1717,431
2016,4,14,17,1290,1297,1668,371
2016,4,14,18,1290,1299,1639,340
2016,4,14,19,1275,1289,1687,398
2016,4,14,20,1265,1291,1683,392
2016,4,14,21,1260,1283,1530,247
2016,4,14,22,1260,1266,1276,10
2016,4,14,23,1260,1283,1345,62
2016,4,15,0,1250,1278,1632,354
2016,4,15,1,1250,1267,1618,351
2016,4,15,2,1260,1257,1508,251
2016,4,15,3,1315,1306,1571,265
2016,4,15,4,1250,1277,1558,281
2016,4,15,5,1170,1181,1598,417
2016,4,15,6,1085,1122,1510,388
2016,4,15,7,990,1081,1216,135
2016,4,15,8,970,1055,1178,123
2016,4,15,9,975,1062,1161,99
2016,4,15,10,975,1052,1170,118
2016,4,15,11,1000,1072,1192,120
2016,4,15,12,1050,1104,1212,108
2016,4,15,13,1185,1208,1384,176
2016,4,15,14,1270,1274,1644,370
2016,4,15,15,1255,1279,1645,366
2016,4,15,16,1260,1285,1555,270
2016,4,15,17,1250,1286,1273,-13
2016,4,15,18,1245,1278,1288,10
2016,4,15,19,1225,1261,1338,77
2016,4,15,20,1225,1242,1310,68
2016,4,15,21,1205,1219,1302,83
2016,4,15,22,1200,1196,1294,98
2016,4,15,23,1200,1189,1300,111
2016,4,16,0,1180,1167,1306,139
2016,4,16,1,1165,1165,1299,134
2016,4,16,2,1170,1169,1375,206
2016,4,16,3,1215,1215,1379,164
2016,4,16,4,1270,1213,1598,385
2016,4,16,5,1110,1152,1487,335
2016,4,16,6,1050,1117,1341,224
2016,4,16,7,1005,1073,1198,125
2016,4,16,8,990,1050,1147,97
2016,4,16,9,980,1036,1100,64
2016,4,16,10,970,1037,1115,78
2016,4,16,11,990,1060,1271,211
2016,4,16,12,1020,1095,1496,401
2016,4,16,13,1120,1102,1533,431
2016,4,16,14,1205,1143,1612,469
2016,4,16,15,1245,1188,1874,686
2016,4,16,16,1250,1195,1957,762
2016,4,16,17,1260,1179,2092,913
2016,4,16,18,1240,1155,1803,648
2016,4,16,19,1210,1147,1664,517
2016,4,16,20,1200,1111,1338,227
2016,4,16,21,1200,1087,1284,197
2016,4,16,22,1220,1083,1216,133
2016,4,16,23,1215,1082,1186,104
2016,4,17,0,1200,1083,1224,141
2016,4,17,1,1205,1089,1189,100
2016,4,17,2,1195,1085,1202,117
2016,4,17,3,1230,1139,1552,413
2016,4,17,4,1190,1149,1799,650
2016,4,17,5,1150,1099,1781,682
2016,4,17,6,1085,1048,1628,580
2016,4,17,7,945,996,1413,417
2016,4,17,8,935,978,1311,333
2016,4,17,9,915,967,1213,246
2016,4,17,10,930,965,1213,248
2016,4,17,11,940,987,1214,227
2016,4,17,12,975,1005,1283,278
2016,4,17,13,1020,1039,1408,369
2016,4,17,14,1090,1070,1417,347
2016,4,17,15,1145,1107,1467,360
2016,4,17,16,1165,1131,1888,757
2016,4,17,17,1170,1132,1938,806
2016,4,17,18,1165,1131,1780,649
2016,4,17,19,1160,1114,1710,596
2016,4,17,20,1150,1083,1562,479
2016,4,17,21,1155,1081,1367,286
2016,4,17,22,1145,1070,1309,239
2016,4,17,23,1145,1077,1256,179
2016,4,18,0,1140,1110,1575,465
2016,4,18,1,1160,1121,1810,689
2016,4,18,2,1160,1141,2103,962
2016,4,18,3,1180,1187,2266,1079
2016,4,18,4,1090,1182,2379,1197
2016,4,18,5,1090,1099,2332,1233
2016,4,18,6,1045,1037,2171,1134
2016,4,18,7,965,974,1749,775
2016,4,18,8,950,959,1389,430
2016,4,18,9,935,939,1258,319
2016,4,18,10,940,947,1230,283
2016,4,18,11,965,976,1268,292
2016,4,18,12,1020,1030,1568,538
2016,4,18,13,1145,1166,2161,995
2016,4,18,14,1235,1233,2098,865
2016,4,18,15,1245,1269,2336,1067
2016,4,18,16,1235,1267,2279,1012
2016,4,18,17,1230,1250,2273,1023
2016,4,18,18,1220,1259,2286,1027
2016,4,18,19,1210,1257,2266,1009
2016,4,18,20,1210,1252,2247,995
2016,4,18,21,1205,1244,2304,1060
2016,4,18,22,1200,1226,2312,1086
2016,4,18,23,1210,1219,2314,1095
2016,4,19,0,1190,1201,2349,1148
2016,4,19,1,1200,1204,2406,1202
2016,4,19,2,1180,1217,2430,1213
2016,4,19,3,1210,1253,2493,1240
2016,4,19,4,1160,1241,2521,1280
2016,4,19,5,1105,1119,2451,1332
2016,4,19,6,1040,1055,2417,1362
2016,4,19,7,950,1019,2143,1124
2016,4,19,8,945,974,1757,783
2016,4,19,9,940,980,1695,715
2016,4,19,10,940,977,1552,575
2016,4,19,11,960,991,1430,439
2016,4,19,12,1000,1056,1567,511
2016,4,19,13,1130,1164,1758,594
2016,4,19,14,1230,1257,2025,768
2016,4,19,15,1245,1264,2187,923
2016,4,19,16,1250,1240,2003,763
2016,4,19,17,1250,1239,2112,873
2016,4,19,18,1255,1233,2101,868
2016,4,19,19,1245,1205,2049,844
2016,4,19,20,1240,1226,2066,840
2016,4,19,21,1225,1205,2175,970
2016,4,19,22,1210,1208,2240,1032
2016,4,19,23,1220,1214,2292,1078
2016,4,20,0,1230,1198,2310,1112
2016,4,20,1,1235,1188,2301,1113
2016,4,20,2,1245,1189,2293,1104
2016,4,20,3,1285,1229,2354,1125
2016,4,20,4,1230,1214,2279,1065
2016,4,20,5,1170,1117,2209,1092
2016,4,20,6,1090,1048,2202,1154
2016,4,20,7,1010,966,1654,688
2016,4,20,8,1000,946,1538,592
2016,4,20,9,990,936,1482,546
2016,4,20,10,990,929,1466,537
2016,4,20,11,1015,955,1414,459
2016,4,20,12,1065,1000,1477,477
2016,4,20,13,1200,1128,1831,703
2016,4,20,14,1275,1212,1788,576
2016,4,20,15,1290,1234,1928,694
2016,4,20,16,1285,1224,1863,639
2016,4,20,17,1275,1230,1848,618
2016,4,20,18,1270,1221,1933,712
2016,4,20,19,1265,1212,1962,750
2016,4,20,20,1270,1210,1941,731
2016,4,20,21,1260,1199,2002,803
2016,4,20,22,1245,1207,2110,903
2016,4,20,23,1235,1214,2236,1022
2016,4,21,0,1215,1193,2286,1093
2016,4,21,1,1210,1195,2289,1094
2016,4,21,2,1215,1173,2102,929
2016,4,21,3,1250,1209,2015,806
2016,4,21,4,1200,1191,1839,648
2016,4,21,5,1135,1099,1738,639
2016,4,21,6,1060,1009,1518,509
2016,4,21,7,950,963,1277,314
2016,4,21,8,925,953,1352,399
2016,4,21,9,910,939,1177,238
2016,4,21,10,910,937,1187,250
2016,4,21,11,935,946,1251,305
2016,4,21,12,995,1007,1260,253
2016,4,21,13,1110,1100,1405,305
2016,4,21,14,1210,1187,1690,503
2016,4,21,15,1210,1209,2087,878
2016,4,21,16,1190,1213,1922,709
2016,4,21,17,1190,1208,1584,376
2016,4,21,18,1180,1202,1528,326
2016,4,21,19,1160,1213,1876,663
2016,4,21,20,1165,1232,2113,881
2016,4,21,21,1160,1251,2165,914
2016,4,21,22,1160,1245,2133,888
2016,4,21,23,1160,1254,2167,913
2016,4,22,0,1130,1236,2205,969
2016,4,22,1,1140,1219,2244,1025
2016,4,22,2,1135,1211,2284,1073
2016,4,22,3,1170,1244,2339,1095
2016,4,22,4,1140,1216,2344,1128
2016,4,22,5,1075,1117,2196,1079
2016,4,22,6,1010,1033,1950,917
2016,4,22,7,920,983,1626,643
2016,4,22,8,895,945,1535,590
2016,4,22,9,900,931,1428,497
2016,4,22,10,890,926,1302,376
2016,4,22,11,910,938,1170,232
2016,4,22,12,955,985,1284,299
2016,4,22,13,1080,1089,1561,472
2016,4,22,14,1165,1164,1623,459
2016,4,22,15,1170,1202,1599,397
2016,4,22,16,1170,1219,1909,690
2016,4,22,17,1165,1230,1935,705
2016,4,22,18,1160,1238,1787,549
2016,4,22,19,1145,1233,1551,318
2016,4,22,20,1145,1231,1560,329
2016,4,22,21,1135,1237,1683,446
2016,4,22,22,1130,1219,1691,472
2016,4,22,23,1130,1214,1657,443
2016,4,23,0,1110,1183,1344,161
2016,4,23,1,1105,1165,1303,138
2016,4,23,2,1105,1135,1286,151
2016,4,23,3,1130,1183,1222,39
2016,4,23,4,1090,1164,1159,-5
2016,4,23,5,1045,1100,1210,110
2016,4,23,6,980,1043,1292,249
2016,4,23,7,1005,1011,1252,241
2016,4,23,8,995,986,1247,261
2016,4,23,9,980,963,1219,256
2016,4,23,10,980,958,1193,235
2016,4,23,11,995,952,1154,202
2016,4,23,12,1030,954,1164,210
2016,4,23,13,1090,967,1104,137
2016,4,23,14,1150,1035,1168,133
2016,4,23,15,1185,1106,1180,74
2016,4,23,16,1200,1144,1170,26
2016,4,23,17,1195,1148,1170,22
2016,4,23,18,1180,1158,1204,46
2016,4,23,19,1170,1148,1199,51
2016,4,23,20,1165,1144,1148,4
2016,4,23,21,1160,1138,1184,46
2016,4,23,22,1160,1147,1189,42
2016,4,23,23,1160,1153,1195,42
2016,4,24,0,1165,1168,1186,18
2016,4,24,1,1160,1162,1205,43
2016,4,24,2,1135,1158,1197,39
2016,4,24,3,1165,1170,1147,-23
2016,4,24,4,1130,1164,1168,4
2016,4,24,5,1095,1092,1153,61
2016,4,24,6,1025,1021,1111,90
2016,4,24,7,935,986,1084,98
2016,4,24,8,930,972,1086,114
2016,4,24,9,920,944,1069,125
2016,4,24,10,925,939,1079,140
2016,4,24,11,940,952,1084,132
2016,4,24,12,970,967,1103,136
2016,4,24,13,1030,995,1107,112
2016,4,24,14,1115,1057,1139,82
2016,4,24,15,1140,1108,1144,36
2016,4,24,16,1180,1159,1168,9
2016,4,24,17,1185,1179,1175,-4
2016,4,24,18,1180,1193,1176,-17
2016,4,24,19,1180,1194,1173,-21
2016,4,24,20,1185,1180,1183,3
2016,4,24,21,1185,1167,1163,-4
2016,4,24,22,1170,1162,1156,-6
2016,4,24,23,1165,1170,1136,-34
2016,4,25,0,1180,1184,1110,-74
2016,4,25,1,1185,1193,1102,-91
2016,4,25,2,1175,1187,1069,-118
2016,4,25,3,1210,1209,1277,68
2016,4,25,4,1125,1184,1426,242
2016,4,25,5,1110,1098,1350,252
2016,4,25,6,1040,1027,1179,152
2016,4,25,7,970,982,1101,119
2016,4,25,8,965,972,1059,87
2016,4,25,9,950,955,1053,98
2016,4,25,10,955,952,1054,102
2016,4,25,11,980,985,1065,80
2016,4,25,12,1035,1032,1226,194
2016,4,25,13,1160,1162,1656,494
2016,4,25,14,1255,1245,1832,587
2016,4,25,15,1275,1256,1946,690
2016,4,25,16,1275,1266,2028,762
2016,4,25,17,1270,1268,2042,774
2016,4,25,18,1260,1260,2058,798
2016,4,25,19,1260,1243,2038,795
2016,4,25,20,1275,1232,2049,817
2016,4,25,21,1270,1211,1961,750
2016,4,25,22,1255,1203,1793,590
2016,4,25,23,1255,1210,1422,212
2016,4,26,0,1240,1209,1276,67
2016,4,26,1,1240,1207,1270,63
2016,4,26,2,1220,1216,1242,26
2016,4,26,3,1255,1235,1364,129
2016,4,26,4,1200,1201,1464,263
2016,4,26,5,1130,1125,1426,301
2016,4,26,6,1055,1046,1477,431
2016,4,26,7,1050,1012,1262,250
2016,4,26,8,1040,990,1312,322
2016,4,26,9,1025,968,1277,309
2016,4,26,10,1020,956,1239,283
2016,4,26,11,1045,979,1312,333
2016,4,26,12,1080,1045,1517,472
2016,4,26,13,1170,1172,2083,911
2016,4,26,14,1250,1236,1696,460
2016,4,26,15,1280,1255,2141,886
2016,4,26,16,1290,1274,2177,903
2016,4,26,17,1300,1265,2088,823
2016,4,26,18,1300,1268,2046,778
2016,4,26,19,1285,1247,2065,818
2016,4,26,20,1290,1249,2113,864
2016,4,26,21,1280,1237,2127,890
2016,4,26,22,1275,1225,2106,881
2016,4,26,23,1290,1229,2109,880
2016,4,27,0,1285,1214,2068,854
2016,4,27,1,1285,1231,2162,931
2016,4,27,2,1285,1233,2208,975
2016,4,27,3,1320,1268,2103,835
2016,4,27,4,1230,1246,2078,832
2016,4,27,5,1190,1157,1948,791
2016,4,27,6,1110,1071,1974,903
2016,4,27,7,1015,1034,1643,609
2016,4,27,8,1005,1008,1344,336
2016,4,27,9,1000,1011,1174,163
2016,4,27,10,990,1007,1174,167
2016,4,27,11,1025,1016,1253,237
2016,4,27,12,1075,1087,1462,375
2016,4,27,13,1210,1204,2000,796
2016,4,27,14,1300,1265,1806,541
2016,4,27,15,1300,1277,1999,722
2016,4,27,16,1310,1278,2031,753
2016,4,27,17,1310,1289,1892,603
2016,4,27,18,1300,1268,1818,550
2016,4,27,19,1290,1254,1808,554
2016,4,27,20,1285,1241,1896,655
2016,4,27,21,1275,1223,1905,682
2016,4,27,22,1270,1226,1914,688
2016,4,27,23,1265,1230,1976,746
2016,4,28,0,1250,1227,1882,655
2016,4,28,1,1260,1227,1753,526
2016,4,28,2,1260,1235,1750,515
2016,4,28,3,1280,1266,1770,504
2016,4,28,4,1230,1246,1824,578
2016,4,28,5,1170,1169,1732,563
2016,4,28,6,1090,1111,1784,673
2016,4,28,7,970,1071,1584,513
2016,4,28,8,970,1045,1545,500
2016,4,28,9,950,1040,1567,527
2016,4,28,10,940,1049,1526,477
2016,4,28,11,975,1084,1666,582
2016,4,28,12,1040,1159,1802,643
2016,4,28,13,1155,1276,1879,603
2016,4,28,14,1265,1331,1720,389
2016,4,28,15,1280,1335,2069,734
2016,4,28,16,1280,1320,2069,749
2016,4,28,17,1280,1291,1862,571
2016,4,28,18,1270,1285,2056,771
2016,4,28,19,1255,1262,1975,713
2016,4,28,20,1265,1258,1967,709
2016,4,28,21,1260,1242,2060,818
2016,4,28,22,1255,1229,1962,733
2016,4,28,23,1260,1224,1768,544
2016,4,29,0,1240,1209,1511,302
2016,4,29,1,1245,1199,1626,427
2016,4,29,2,1235,1190,1310,120
2016,4,29,3,1260,1226,1248,22
2016,4,29,4,1215,1215,1313,98
2016,4,29,5,1155,1127,1235,108
2016,4,29,6,1085,1061,1499,438
2016,4,29,7,1010,1013,1356,343
2016,4,29,8,980,1001,1681,680
2016,4,29,9,985,991,1619,628
2016,4,29,10,990,983,1531,548
2016,4,29,11,1000,998,1383,385
2016,4,29,12,1055,1045,1455,410
2016,4,29,13,1155,1176,1947,771
2016,4,29,14,1220,1254,2162,908
2016,4,29,15,1240,1273,2304,1031
2016,4,29,16,1230,1262,2321,1059
2016,4,29,17,1240,1263,2334,1071
2016,4,29,18,1235,1236,2209,973
2016,4,29,19,1230,1210,2206,996
2016,4,29,20,1230,1191,2177,986
2016,4,29,21,1215,1178,2213,1035
2016,4,29,22,1205,1166,2189,1023
2016,4,29,23,1190,1160,2161,1001
2016,4,30,0,1185,1122,1925,803
2016,4,30,1,1175,1138,2075,937
2016,4,30,2,1170,1142,1987,845
2016,4,30,3,1195,1163,1942,779
2016,4,30,4,1150,1172,2040,868
2016,4,30,5,1115,1106,1898,792
2016,4,30,6,1045,1044,2185,1141
2016,4,30,7,1015,1002,2137,1135
2016,4,30,8,1000,976,2078,1102
2016,4,30,9,975,972,2048,1076
2016,4,30,10,980,962,2088,1126
2016,4,30,11,995,969,2055,1086
2016,4,30,12,1015,961,1926,965
2016,4,30,13,1070,1032,1945,913
2016,4,30,14,1110,1074,1589,515
2016,4,30,15,1190,1124,1693,569
2016,4,30,16,1190,1160,1989,829
2016,4,30,17,1190,1176,2092,916
2016,4,30,18,1185,1171,2123,952
2016,4,30,19,1160,1158,2141,983
2016,4,30,20,1145,1132,2191,1059
2016,4,30,21,1135,1120,2164,1044
2016,4,30,22,1135,1115,2100,985
2016,4,30,23,1140,1115,1981,866
2016,5,1,0,1140,1123,1995,872
2016,5,1,1,1140,1119,2108,989
2016,5,1,2,1130,1140,2234,1094
2016,5,1,3,1155,1155,2251,1096
2016,5,1,4,1125,1166,2295,1129
2016,5,1,5,1090,1115,2284,1169
2016,5,1,6,1005,1043,1958,915
2016,5,1,7,935,999,1911,912
2016,5,1,8,940,985,1990,1005
2016,5,1,9,920,972,1889,917
2016,5,1,10,905,976,1760,784
2016,5,1,11,935,981,1789,808
2016,5,1,12,975,1006,1830,824
2016,5,1,13,1040,1024,2003,979
2016,5,1,14,1110,1063,2084,1021
2016,5,1,15,1150,1100,2183,1083
2016,5,1,16,1175,1127,2277,1150
2016,5,1,17,1185,1114,2253,1139
2016,5,1,18,1180,1121,2075,954
2016,5,1,19,1170,1092,1964,872
2016,5,1,20,1160,1078,1848,770
2016,5,1,21,1150,1067,1737,670
2016,5,1,22,1145,1068,1542,474
2016,5,1,23,1155,1089,1623,534
2016,5,2,0,1150,1120,2014,894
2016,5,2,1,1165,1125,2106,981
2016,5,2,2,1165,1131,2276,1145
2016,5,2,3,1195,1165,2335,1170
2016,5,2,4,1110,1181,2361,1180
2016,5,2,5,1095,1103,2316,1213
2016,5,2,6,1025,1020,2252,1232
2016,5,2,7,970,990,2201,1211
2016,5,2,8,965,955,2079,1124
2016,5,2,9,950,945,1840,895
2016,5,2,10,960,977,1848,871
2016,5,2,11,985,969,1838,869
2016,5,2,12,1040,1061,1876,815
2016,5,2,13,1155,1170,2203,1033
2016,5,2,14,1230,1217,1994,777
2016,5,2,15,1250,1234,2213,979
2016,5,2,16,1245,1220,2223,1003
2016,5,2,17,1245,1219,2241,1022
2016,5,2,18,1235,1212,2231,1019
2016,5,2,19,1210,1210,2251,1041
2016,5,2,20,1210,1219,2313,1094
2016,5,2,21,1200,1209,2316,1107
2016,5,2,22,1185,1204,2312,1108
2016,5,2,23,1180,1214,2372,1158
2016,5,3,0,1165,1200,2335,1135
2016,5,3,1,1175,1200,2359,1159
2016,5,3,2,1175,1203,2357,1154
2016,5,3,3,1195,1222,2321,1099
2016,5,3,4,1150,1244,2302,1058
2016,5,3,5,1090,1127,2167,1040
2016,5,3,6,1025,1045,2287,1242
2016,5,3,7,935,1003,2204,1201
2016,5,3,8,935,971,2211,1240
2016,5,3,9,920,958,1962,1004
2016,5,3,10,910,951,1875,924
2016,5,3,11,940,963,1717,754
2016,5,3,12,990,1023,1762,739
2016,5,3,13,1095,1111,2083,972
2016,5,3,14,1205,1198,2116,918
2016,5,3,15,1230,1229,2215,986
2016,5,3,16,1235,1218,2217,999
2016,5,3,17,1230,1253,2234,981
2016,5,3,18,1225,1238,2254,1016
2016,5,3,19,1200,1230,2260,1030
2016,5,3,20,1195,1235,2295,1060
2016,5,3,21,1185,1249,2314,1065
2016,5,3,22,1180,1258,2349,1091
2016,5,3,23,1195,1276,2366,1090
2016,5,4,0,1190,1248,2346,1098
2016,5,4,1,1200,1252,2315,1063
2016,5,4,2,1205,1251,2346,1095
2016,5,4,3,1240,1237,2087,850
2016,5,4,4,1195,1248,2027,779
2016,5,4,5,1150,1170,1910,740
2016,5,4,6,1065,1082,1887,805
2016,5,4,7,955,1020,1599,579
2016,5,4,8,935,995,1269,274
2016,5,4,9,930,964,1121,157
2016,5,4,10,935,965,1106,141
2016,5,4,11,945,984,1202,218
2016,5,4,12,1020,1038,1823,785
2016,5,4,13,1140,1128,2112,984
2016,5,4,14,1230,1203,2023,820
2016,5,4,15,1230,1208,2110,902
2016,5,4,16,1215,1227,2127,900
2016,5,4,17,1220,1235,2207,972
2016,5,4,18,1210,1260,2236,976
2016,5,4,19,1200,1259,2212,953
2016,5,4,20,1210,1281,2165,884
2016,5,4,21,1200,1291,2159,868
2016,5,4,22,1200,1321,2162,841
2016,5,4,23,1200,1317,2143,826
2016,5,5,0,1190,1308,2220,912
2016,5,5,1,1185,1301,2341,1040
2016,5,5,2,1175,1282,2233,951
2016,5,5,3,1195,1287,2156,869
2016,5,5,4,1160,1271,2169,898
2016,5,5,5,1110,1173,2064,891
2016,5,5,6,1025,1068,1756,688
2016,5,5,7,930,1016,1623,607
2016,5,5,8,915,988,1546,558
2016,5,5,9,900,953,1501,548
2016,5,5,10,905,954,1477,523
2016,5,5,11,930,965,1377,412
2016,5,5,12,980,1013,1728,715
2016,5,5,13,1085,1112,2038,926
2016,5,5,14,1170,1202,2148,946
2016,5,5,15,1185,1227,2254,1027
2016,5,5,16,1180,1251,2192,941
2016,5,5,17,1190,1284,2253,969
2016,5,5,18,1180,1295,2291,996
2016,5,5,19,1165,1311,2306,995
2016,5,5,20,1170,1330,2282,952
2016,5,5,21,1170,1337,2197,860
2016,5,5,22,1165,1347,2106,759
2016,5,5,23,1175,1337,1948,611
2016,5,6,0,1160,1329,1812,483
2016,5,6,1,1165,1313,1830,517
2016,5,6,2,1150,1299,1855,556
2016,5,6,3,1165,1307,1838,531
2016,5,6,4,1125,1314,1865,551
2016,5,6,5,1080,1234,1795,561
2016,5,6,6,1000,1142,1718,576
2016,5,6,7,930,1081,1530,449
2016,5,6,8,915,1048,1398,350
2016,5,6,9,900,1022,1250,228
2016,5,6,10,905,1022,1217,195
2016,5,6,11,930,1035,1349,314
2016,5,6,12,980,1065,1488,423
2016,5,6,13,1085,1138,1652,514
2016,5,6,14,1170,1217,1611,394
2016,5,6,15,1185,1245,1660,415
2016,5,6,16,1180,1258,1672,414
2016,5,6,17,1190,1258,1677,419
2016,5,6,18,1180,1264,1660,396
2016,5,6,19,1165,1230,1651,421
2016,5,6,20,1170,1222,1642,420
2016,5,6,21,1170,1216,1615,399
2016,5,6,22,1165,1188,1582,394
2016,5,6,23,1175,1190,1579,389
2016,5,7,0,1160,1173,1548,375
2016,5,7,1,1165,1159,1561,402
2016,5,7,2,1150,1145,1557,412
2016,5,7,3,1165,1166,1571,405
2016,5,7,4,1125,1167,1594,427
2016,5,7,5,1080,1108,1588,480
2016,5,7,6,1000,1041,1496,455
2016,5,7,7,960,995,1478,483
2016,5,7,8,945,969,1436,467
2016,5,7,9,940,948,1295,347
2016,5,7,10,930,948,1194,246
2016,5,7,11,940,953,1138,185
2016,5,7,12,970,974,1156,182
2016,5,7,13,1010,999,1134,135
2016,5,7,14,1060,1047,1105,58
2016,5,7,15,1100,1104,1206,102
2016,5,7,16,1115,1128,1211,83
2016,5,7,17,1115,1135,1445,310
2016,5,7,18,1120,1134,1568,434
2016,5,7,19,1115,1137,1529,392
2016,5,7,20,1115,1132,1520,388
2016,5,7,21,1135,1129,1542,413
2016,5,7,22,1135,1138,1551,413
2016,5,7,23,1120,1154,1567,413
2016,5,8,0,1125,1165,1585,420
2016,5,8,1,1125,1169,1583,414
2016,5,8,2,1130,1155,1462,307
2016,5,8,3,1155,1161,1359,198
2016,5,8,4,1070,1192,1283,91
2016,5,8,5,1080,1116,1250,134
2016,5,8,6,990,1054,1223,169
2016,5,8,7,975,984,1104,120
2016,5,8,8,970,969,1031,62
2016,5,8,9,955,946,1018,72
2016,5,8,10,950,945,1015,70
2016,5,8,11,965,949,1023,74
2016,5,8,12,1005,961,1017,56
2016,5,8,13,1050,976,1019,43
2016,5,8,14,1105,1026,1049,23
2016,5,8,15,1150,1096,1014,-82
2016,5,8,16,1175,1129,1039,-90
2016,5,8,17,1175,1142,1022,-120
2016,5,8,18,1185,1145,1008,-137
2016,5,8,19,1180,1156,1015,-141
2016,5,8,20,1175,1148,1019,-129
2016,5,8,21,1195,1154,1017,-137
2016,5,8,22,1205,1168,1024,-144
2016,5,8,23,1195,1186,1021,-165
2016,5,9,0,1200,1196,1021,-175
2016,5,9,1,1205,1196,1037,-159
2016,5,9,2,1215,1209,1036,-173
2016,5,9,3,1240,1216,1021,-195
2016,5,9,4,1120,1227,1046,-181
2016,5,9,5,1150,1146,1012,-134
2016,5,9,6,1055,1072,1038,-34
2016,5,9,7,990,998,1052,54
2016,5,9,8,970,988,1045,57
2016,5,9,9,965,964,1062,98
2016,5,9,10,975,965,1100,135
2016,5,9,11,980,967,1094,127
2016,5,9,12,1060,1010,1110,100
2016,5,9,13,1170,1115,1149,34
2016,5,9,14,1250,1210,1280,70
2016,5,9,15,1250,1247,1201,-46
2016,5,9,16,1240,1279,1227,-52
2016,5,9,17,1245,1304,1198,-106
2016,5,9,18,1240,1318,1199,-119
2016,5,9,19,1245,1332,1199,-133
2016,5,9,20,1255,1353,1194,-159
2016,5,9,21,1270,1361,1293,-68
2016,5,9,22,1275,1349,1302,-47
2016,5,9,23,1250,1346,1364,18
2016,5,10,0,1245,1317,1358,41
2016,5,10,1,1250,1317,1425,108
2016,5,10,2,1255,1303,1417,114
2016,5,10,3,1275,1323,1658,335
2016,5,10,4,1225,1305,1717,412
2016,5,10,5,1170,1192,1726,534
2016,5,10,6,1075,1118,1511,393
2016,5,10,7,970,1082,1490,408
2016,5,10,8,965,1061,1477,416
2016,5,10,9,950,1058,1395,337
2016,5,10,10,940,1048,1381,333
2016,5,10,11,960,1056,1438,382
2016,5,10,12,1005,1125,1593,468
2016,5,10,13,1080,1233,1767,534
2016,5,10,14,1170,1327,1781,454
2016,5,10,15,1210,1283,1819,536
2016,5,10,16,1220,1335,1826,491
2016,5,10,17,1235,1321,1750,429
2016,5,10,18,1235,1329,1779,450
2016,5,10,19,1225,1315,1803,488
2016,5,10,20,1225,1307,1827,520
2016,5,10,21,1225,1294,1828,534
2016,5,10,22,1240,1284,1904,620
2016,5,10,23,1255,1286,1932,646
2016,5,11,0,1245,1292,1893,601
2016,5,11,1,1260,1286,1862,576
2016,5,11,2,1260,1267,1919,652
2016,5,11,3,1260,1270,1907,637
2016,5,11,4,1170,1268,1927,659
2016,5,11,5,1175,1172,1897,725
2016,5,11,6,1095,1101,1934,833
2016,5,11,7,1015,1042,1756,714
2016,5,11,8,1000,1040,1484,444
2016,5,11,9,990,1017,1359,342
2016,5,11,10,990,1009,1374,365
2016,5,11,11,1000,1031,1386,355
2016,5,11,12,1055,1076,1430,354
2016,5,11,13,1190,1181,1697,516
2016,5,11,14,1225,1241,1799,558
2016,5,11,15,1260,1250,1914,664
2016,5,11,16,1265,1252,1943,691
2016,5,11,17,1275,1239,1891,652
2016,5,11,18,1285,1223,1902,679
2016,5,11,19,1280,1208,1921,713
2016,5,11,20,1285,1211,1880,669
2016,5,11,21,1300,1185,1886,701
2016,5,11,22,1305,1178,1927,749
2016,5,11,23,1300,1190,1961,771
2016,5,12,0,1290,1169,1994,825
2016,5,12,1,1290,1151,1975,824
2016,5,12,2,1280,1162,1973,811
2016,5,12,3,1290,1176,1947,771
2016,5,12,4,1225,1203,1952,749
2016,5,12,5,1205,1124,1869,745
2016,5,12,6,1075,1041,1800,759
2016,5,12,7,975,1012,1648,636
2016,5,12,8,960,992,1526,534
2016,5,12,9,955,978,1419,441
2016,5,12,10,955,965,1323,358
2016,5,12,11,970,988,1342,354
2016,5,12,12,1045,1051,1406,355
2016,5,12,13,1150,1136,1558,422
2016,5,12,14,1240,1204,1548,344
2016,5,12,15,1240,1214,1569,355
2016,5,12,16,1245,1211,1601,390
2016,5,12,17,1235,1232,1617,385
2016,5,12,18,1250,1230,1546,316
2016,5,12,19,1250,1218,1517,299
2016,5,12,20,1245,1220,1680,460
2016,5,12,21,1255,1208,1677,469
2016,5,12,22,1265,1204,1756,552
2016,5,12,23,1250,1215,1826,611
2016,5,13,0,1245,1197,1827,630
2016,5,13,1,1230,1178,1581,403
2016,5,13,2,1230,1160,1510,350
2016,5,13,3,1250,1205,1531,326
2016,5,13,4,1200,1182,1515,333
2016,5,13,5,1140,1121,1520,399
2016,5,13,6,1055,1040,1497,457
2016,5,13,7,995,1008,1344,336
2016,5,13,8,985,992,1178,186
2016,5,13,9,970,980,1116,136
2016,5,13,10,960,994,1089,95
2016,5,13,11,980,1009,1077,68
2016,5,13,12,1025,1052,1122,70
2016,5,13,13,1150,1148,1319,171
2016,5,13,14,1250,1222,1303,81
2016,5,13,15,1260,1250,1396,146
2016,5,13,16,1255,1259,1435,176
2016,5,13,17,1250,1249,1301,52
2016,5,13,18,1245,1238,1237,-1
2016,5,13,19,1215,1235,1200,-35
2016,5,13,20,1210,1224,1015,-209
2016,5,13,21,1200,1247,809,-438
2016,5,13,22,1185,1242,745,-497
2016,5,13,23,1175,1238,760,-478
2016,5,14,0,1145,1220,755,-465
2016,5,14,1,1140,1216,813,-403
2016,5,14,2,1155,1205,814,-391
2016,5,14,3,1170,1214,764,-450
2016,5,14,4,1150,1230,776,-454
2016,5,14,5,1105,1175,811,-364
2016,5,14,6,1040,1064,798,-266
2016,5,14,7,965,1029,759,-270
2016,5,14,8,930,1008,728,-280
2016,5,14,9,920,993,745,-248
2016,5,14,10,920,992,748,-244
2016,5,14,11,935,1003,753,-250
2016,5,14,12,970,1020,758,-262
2016,5,14,13,1005,1044,742,-302
2016,5,14,14,1060,1095,723,-372
2016,5,14,15,1095,1144,737,-407
2016,5,14,16,1130,1184,757,-427
2016,5,14,17,1135,1177,751,-426
2016,5,14,18,1125,1167,759,-408
2016,5,14,19,1110,1145,756,-389
2016,5,14,20,1115,1141,781,-360
2016,5,14,21,1110,1128,777,-351
2016,5,14,22,1095,1121,773,-348
2016,5,14,23,1105,1129,786,-343
2016,5,15,0,1105,1132,806,-326
2016,5,15,1,1105,1134,817,-317
2016,5,15,2,1105,1135,816,-319
2016,5,15,3,1125,1150,837,-313
2016,5,15,4,1080,1177,860,-317
2016,5,15,5,1060,1111,858,-253
2016,5,15,6,985,1059,869,-190
2016,5,15,7,980,1022,858,-164
2016,5,15,8,960,985,862,-123
2016,5,15,9,950,979,839,-140
2016,5,15,10,940,960,814,-146
2016,5,15,11,955,978,780,-198
2016,5,15,12,995,999,774,-225
2016,5,15,13,1025,1010,770,-240
2016,5,15,14,1090,1068,758,-310
2016,5,15,15,1135,1106,764,-342
2016,5,15,16,1165,1152,766,-386
2016,5,15,17,1165,1175,794,-381
2016,5,15,18,1160,1188,824,-364
2016,5,15,19,1155,1178,815,-363
2016,5,15,20,1155,1187,832,-355
2016,5,15,21,1155,1179,838,-341
2016,5,15,22,1150,1176,833,-343
2016,5,15,23,1165,1190,818,-372
2016,5,16,0,1165,1207,802,-405
2016,5,16,1,1175,1218,800,-418
2016,5,16,2,1175,1220,793,-427
2016,5,16,3,1190,1223,795,-428
2016,5,16,4,1100,1201,770,-431
2016,5,16,5,1115,1118,749,-369
2016,5,16,6,1040,1045,723,-322
2016,5,16,7,985,1005,720,-285
2016,5,16,8,960,994,729,-265
2016,5,16,9,950,980,731,-249
2016,5,16,10,950,975,729,-246
2016,5,16,11,965,1009,741,-268
2016,5,16,12,1040,1029,729,-300
2016,5,16,13,1150,1150,761,-389
2016,5,16,14,1245,1231,764,-467
2016,5,16,15,1255,1244,777,-467
2016,5,16,16,1270,1246,776,-470
2016,5,16,17,1265,1241,841,-400
2016,5,16,18,1255,1240,881,-359
2016,5,16,19,1250,1249,888,-361
2016,5,16,20,1265,1243,902,-341
2016,5,16,21,1265,1247,894,-353
2016,5,16,22,1245,1241,892,-349
2016,5,16,23,1260,1242,901,-341
2016,5,17,0,1240,1231,894,-337
2016,5,17,1,1240,1201,854,-347
2016,5,17,2,1230,1199,853,-346
2016,5,17,3,1250,1201,818,-383
2016,5,17,4,1205,1208,812,-396
2016,5,17,5,1155,1136,823,-313
2016,5,17,6,1075,1070,832,-238
2016,5,17,7,975,1018,859,-159
2016,5,17,8,950,977,931,-46
2016,5,17,9,945,971,929,-42
2016,5,17,10,940,975,962,-13
2016,5,17,11,960,987,948,-39
2016,5,17,12,1010,1036,951,-85
2016,5,17,13,1085,1122,938,-184
2016,5,17,14,1180,1214,947,-267
2016,5,17,15,1190,1207,973,-234
2016,5,17,16,1220,1227,1000,-227
2016,5,17,17,1225,1227,1030,-197
2016,5,17,18,1245,1216,1044,-172
2016,5,17,19,1230,1233,1062,-171
2016,5,17,20,1230,1215,1069,-146
2016,5,17,21,1230,1222,1065,-157
2016,5,17,22,1225,1232,1059,-173
2016,5,17,23,1235,1227,1044,-183
2016,5,18,0,1235,1222,1034,-188
2016,5,18,1,1230,1207,1032,-175
2016,5,18,2,1230,1198,1053,-145
2016,5,18,3,1245,1207,1069,-138
2016,5,18,4,1200,1225,1054,-171
2016,5,18,5,1135,1154,1059,-95
2016,5,18,6,1055,1077,1083,6
2016,5,18,7,995,1035,1044,9
2016,5,18,8,995,1004,1046,42
2016,5,18,9,980,999,1044,45
2016,5,18,10,975,986,1031,45
2016,5,18,11,1000,992,1036,44
2016,5,18,12,1035,1032,1061,29
2016,5,18,13,1210,1115,1072,-43
2016,5,18,14,1295,1203,1062,-141
2016,5,18,15,1320,1209,1039,-170
2016,5,18,16,1320,1213,1084,-129
2016,5,18,17,1310,1239,1048,-191
2016,5,18,18,1310,1242,1066,-176
2016,5,18,19,1275,1250,1061,-189
2016,5,18,20,1325,1252,1028,-224
2016,5,18,21,1305,1237,1060,-177
2016,5,18,22,1300,1246,1091,-155
2016,5,18,23,1305,1256,1101,-155
2016,5,19,0,1290,1222,1087,-135
2016,5,19,1,1265,1204,1095,-109
2016,5,19,2,1260,1192,1085,-107
2016,5,19,3,1265,1190,1102,-88
2016,5,19,4,1240,1199,1099,-100
2016,5,19,5,1215,1131,1100,-31
2016,5,19,6,1110,1055,1109,54
2016,5,19,7,980,994,1055,61
2016,5,19,8,945,970,1047,77
2016,5,19,9,935,948,1050,102
2016,5,19,10,930,942,1051,109
2016,5,19,11,950,960,1062,102
2016,5,19,12,1015,993,1024,31
2016,5,19,13,1115,1088,1059,-29
2016,5,19,14,1215,1184,1064,-120
2016,5,19,15,1210,1209,1072,-137
2016,5,19,16,1230,1246,1049,-197
2016,5,19,17,1225,1253,1031,-222
2016,5,19,18,1215,1270,1081,-189
2016,5,19,19,1220,1264,1243,-21
2016,5,19,20,1220,1267,1250,-17
2016,5,19,21,1230,1255,1292,37
2016,5,19,22,1225,1270,1389,119
2016,5,19,23,1230,1280,1307,27
2016,5,20,0,1220,1230,1319,89
2016,5,20,1,1210,1223,1275,52
2016,5,20,2,1210,1227,1208,-19
2016,5,20,3,1220,1193,1274,81
2016,5,20,4,1190,1191,1262,71
2016,5,20,5,1145,1120,1267,147
2016,5,20,6,1060,1041,1254,213
2016,5,20,7,1060,997,1293,296
2016,5,20,8,1035,971,1102,131
2016,5,20,9,1030,953,1078,125
2016,5,20,10,1035,971,1084,113
2016,5,20,11,1045,980,1127,147
2016,5,20,12,1085,1014,1151,137
2016,5,20,13,1170,1112,1192,80
2016,5,20,14,1250,1204,1249,45
2016,5,20,15,1260,1195,1264,69
2016,5,20,16,1260,1221,1314,93
2016,5,20,17,1275,1211,1322,111
2016,5,20,18,1265,1218,1346,128
2016,5,20,19,1260,1199,1324,125
2016,5,20,20,1255,1220,1322,102
2016,5,20,21,1255,1208,1326,118
2016,5,20,22,1250,1218,1341,123
2016,5,20,23,1250,1221,1332,111
2016,5,21,0,1210,1195,1258,63
2016,5,21,1,1225,1177,1252,75
2016,5,21,2,1220,1175,1124,-51
2016,5,21,3,1225,1166,1099,-67
2016,5,21,4,1245,1176,1102,-74
2016,5,21,5,1200,1112,1099,-13
2016,5,21,6,1080,1034,1167,133
2016,5,21,7,970,989,1117,128
2016,5,21,8,945,970,1073,103
2016,5,21,9,930,954,1073,119
2016,5,21,10,925,961,1071,110
2016,5,21,11,940,963,1084,121
2016,5,21,12,960,979,1082,103
2016,5,21,13,1040,1007,1084,77
2016,5,21,14,1140,1069,1044,-25
2016,5,21,15,1175,1131,1075,-56
2016,5,21,16,1195,1164,1107,-57
2016,5,21,17,1205,1175,1058,-117
2016,5,21,18,1210,1188,1082,-106
2016,5,21,19,1195,1180,1085,-95
2016,5,21,20,1195,1172,1065,-107
2016,5,21,21,1190,1169,1072,-97
2016,5,21,22,1200,1152,1037,-115
2016,5,21,23,1205,1138,1001,-137
2016,5,22,0,1170,1137,973,-164
2016,5,22,1,1190,1138,979,-159
2016,5,22,2,1180,1123,908,-215
2016,5,22,3,1180,1121,912,-209
2016,5,22,4,1140,1143,976,-167
2016,5,22,5,1125,1094,943,-151
2016,5,22,6,1050,1021,954,-67
2016,5,22,7,950,982,953,-29
2016,5,22,8,935,952,1006,54
2016,5,22,9,920,940,1043,103
2016,5,22,10,910,941,1059,118
2016,5,22,11,925,946,1084,138
2016,5,22,12,950,967,1095,128
2016,5,22,13,995,988,1061,73
2016,5,22,14,1065,1028,1011,-17
2016,5,22,15,1100,1084,1043,-41
2016,5,22,16,1140,1115,1068,-47
2016,5,22,17,1155,1122,1111,-11
2016,5,22,18,1170,1142,1126,-16
2016,5,22,19,1165,1129,1124,-5
2016,5,22,20,1165,1143,1174,31
2016,5,22,21,1160,1131,1165,34
2016,5,22,22,1180,1128,1154,26
2016,5,22,23,1190,1146,1116,-30
2016,5,23,0,1150,1165,1123,-42
2016,5,23,1,1170,1160,1108,-52
2016,5,23,2,1165,1169,1110,-59
2016,5,23,3,1170,1177,1100,-77
2016,5,23,4,1080,1175,1088,-87
2016,5,23,5,1090,1087,1079,-8
2016,5,23,6,1015,1009,1063,54
2016,5,23,7,1020,966,1036,70
2016,5,23,8,1030,942,1042,100
2016,5,23,9,1010,925,1060,135
2016,5,23,10,1010,934,1105,171
2016,5,23,11,1025,951,1105,154
2016,5,23,12,1070,1008,1155,147
2016,5,23,13,1170,1103,1138,35
2016,5,23,14,1255,1207,1114,-93
2016,5,23,15,1270,1226,1096,-130
2016,5,23,16,1275,1253,1123,-130
2016,5,23,17,1290,1255,1127,-128
2016,5,23,18,1290,1251,1133,-118
2016,5,23,19,1270,1231,1119,-112
2016,5,23,20,1305,1233,1254,21
2016,5,23,21,1295,1226,1277,51
2016,5,23,22,1305,1237,1134,-103
2016,5,23,23,1310,1238,1122,-116
2016,5,24,0,1260,1227,1078,-149
2016,5,24,1,1270,1227,1072,-155
2016,5,24,2,1250,1235,1084,-151
2016,5,24,3,1245,1216,1077,-139
2016,5,24,4,1215,1237,1119,-118
2016,5,24,5,1175,1141,1108,-33
2016,5,24,6,1090,1076,1114,38
2016,5,24,7,1010,1037,1077,40
2016,5,24,8,990,1030,976,-54
2016,5,24,9,975,1014,964,-50
2016,5,24,10,970,1006,950,-56
2016,5,24,11,975,1027,949,-78
2016,5,24,12,1025,1078,938,-140
2016,5,24,13,1090,1155,928,-227
2016,5,24,14,1180,1231,1044,-187
2016,5,24,15,1210,1237,1064,-173
2016,5,24,16,1235,1238,1065,-173
2016,5,24,17,1235,1231,1030,-201
2016,5,24,18,1235,1218,1003,-215
2016,5,24,19,1185,1218,992,-226
2016,5,24,20,1240,1221,999,-222
2016,5,24,21,1240,1229,1006,-223
2016,5,24,22,1240,1214,1059,-155
2016,5,24,23,1250,1223,1053,-170
2016,5,25,0,1260,1199,1108,-91
2016,5,25,1,1245,1183,1060,-123
2016,5,25,2,1235,1165,1003,-162
2016,5,25,3,1240,1170,947,-223
2016,5,25,4,1180,1199,956,-243
2016,5,25,5,1030,1102,1086,-16
2016,5,25,6,1080,1006,1166,160
2016,5,25,7,990,977,1133,156
2016,5,25,8,970,951,1116,165
2016,5,25,9,960,931,1151,220
2016,5,25,10,965,937,1156,219
2016,5,25,11,970,954,1176,222
2016,5,25,12,1015,1013,1268,255
2016,5,25,13,1125,1110,1475,365
2016,5,25,14,1240,1207,1587,380
2016,5,25,15,1245,1213,1732,519
2016,5,25,16,1250,1221,1756,535
2016,5,25,17,1260,1220,1756,536
2016,5,25,18,1255,1225,1721,496
2016,5,25,19,1250,1211,1690,479
2016,5,25,20,1250,1213,1735,522
2016,5,25,21,1245,1214,1733,519
2016,5,25,22,1245,1214,1725,511
2016,5,25,23,1260,1202,1624,422
2016,5,26,0,1225,1196,1711,515
2016,5,26,1,1230,1174,1643,469
2016,5,26,2,1235,1164,1596,432
2016,5,26,3,1225,1165,1552,387
2016,5,26,4,1230,1172,1384,212
2016,5,26,5,1150,1103,1414,311
2016,5,26,6,1070,1017,1470,453
2016,5,26,7,970,969,1296,327
2016,5,26,8,955,945,1223,278
2016,5,26,9,945,927,1200,273
2016,5,26,10,935,928,1263,335
2016,5,26,11,960,935,1199,264
2016,5,26,12,1015,988,1204,216
2016,5,26,13,1140,1072,1362,290
2016,5,26,14,1270,1171,1386,215
2016,5,26,15,1280,1186,1548,362
2016,5,26,16,1290,1207,1572,365
2016,5,26,17,1295,1212,1603,391
2016,5,26,18,1290,1205,1620,415
2016,5,26,19,1275,1204,1664,460
2016,5,26,20,1280,1206,1596,390
2016,5,26,21,1280,1200,1556,356
2016,5,26,22,1275,1190,1585,395
2016,5,26,23,1285,1193,1567,374
2016,5,27,0,1260,1178,1409,231
2016,5,27,1,1250,1167,1381,214
2016,5,27,2,1225,1161,1371,210
2016,5,27,3,1235,1143,1271,128
2016,5,27,4,1215,1162,1250,88
2016,5,27,5,1170,1086,1281,195
2016,5,27,6,1070,1014,1427,413
2016,5,27,7,955,971,1323,352
2016,5,27,8,930,956,1205,249
2016,5,27,9,920,937,1180,243
2016,5,27,10,935,932,1167,235
2016,5,27,11,940,944,1157,213
2016,5,27,12,990,978,1176,198
2016,5,27,13,1095,1055,1343,288
2016,5,27,14,1210,1139,1250,111
2016,5,27,15,1205,1172,1355,183
2016,5,27,16,1210,1170,1433,263
2016,5,27,17,1205,1188,1504,316
2016,5,27,18,1205,1198,1487,289
2016,5,27,19,1185,1190,1581,391
2016,5,27,20,1190,1190,1480,290
2016,5,27,21,1185,1196,1439,243
2016,5,27,22,1185,1196,1335,139
2016,5,27,23,1180,1184,1376,192
2016,5,28,0,1185,1168,1332,164
2016,5,28,1,1170,1150,1314,164
2016,5,28,2,1150,1141,1485,344
2016,5,28,3,1175,1133,1466,333
2016,5,28,4,1150,1139,1465,326
2016,5,28,5,1095,1104,1498,394
2016,5,28,6,1020,1037,1521,484
2016,5,28,7,985,1013,1415,402
2016,5,28,8,950,997,1407,410
2016,5,28,9,935,976,1340,364
2016,5,28,10,930,968,1288,320
2016,5,28,11,940,966,1302,336
2016,5,28,12,970,971,1379,408
2016,5,28,13,1005,988,1506,518
2016,5,28,14,1090,1038,1480,442
2016,5,28,15,1110,1083,1508,425
2016,5,28,16,1160,1127,1696,569
2016,5,28,17,1170,1128,1753,625
2016,5,28,18,1180,1126,1716,590
2016,5,28,19,1165,1105,1717,612
2016,5,28,20,1160,1106,1609,503
2016,5,28,21,1155,1095,1713,618
2016,5,28,22,1130,1089,1719,630
2016,5,28,23,1130,1090,1725,635
2016,5,29,0,1130,1110,1743,633
2016,5,29,1,1110,1104,1789,685
2016,5,29,2,1110,1124,1813,689
2016,5,29,3,1110,1119,1821,702
2016,5,29,4,1100,1141,1822,681
2016,5,29,5,1085,1114,1787,673
2016,5,29,6,1015,1031,1762,731
2016,5,29,7,935,984,1681,697
2016,5,29,8,915,955,1640,685
2016,5,29,9,895,943,1670,727
2016,5,29,10,880,936,1657,721
2016,5,29,11,885,942,1612,670
2016,5,29,12,920,938,1502,564
2016,5,29,13,960,943,1360,417
2016,5,29,14,1020,993,1365,372
2016,5,29,15,1050,1045,1430,385
2016,5,29,16,1085,1074,1471,397
2016,5,29,17,1090,1075,1470,395
2016,5,29,18,1105,1084,1514,430
2016,5,29,19,1055,1076,1460,384
2016,5,29,20,1105,1090,1436,346
2016,5,29,21,1100,1092,1428,336
2016,5,29,22,1095,1084,1451,367
2016,5,29,23,1110,1102,1412,310
2016,5,30,0,1110,1113,1386,273
2016,5,30,1,1100,1128,1333,205
2016,5,30,2,1085,1111,1390,279
2016,5,30,3,1095,1104,1586,482
2016,5,30,4,1030,1124,1589,465
2016,5,30,5,1020,1081,1537,456
2016,5,30,6,960,1012,1477,465
2016,5,30,7,930,958,1443,485
2016,5,30,8,910,946,1510,564
2016,5,30,9,890,922,1494,572
2016,5,30,10,890,907,1491,584
2016,5,30,11,900,937,1527,590
2016,5,30,12,945,946,1633,687
2016,5,30,13,1050,965,1552,587
2016,5,30,14,1150,1025,1683,658
2016,5,30,15,1160,1078,1738,660
2016,5,30,16,1180,1118,1737,619
2016,5,30,17,1180,1157,1855,698
2016,5,30,18,1185,1169,1852,683
2016,5,30,19,1170,1153,1829,676
2016,5,30,20,1180,1148,1920,772
2016,5,30,21,1175,1141,1915,774
2016,5,30,22,1175,1141,1936,795
2016,5,30,23,1175,1154,1936,782
2016,5,31,0,1160,1163,1959,796
2016,5,31,1,1140,1172,1983,811
2016,5,31,2,1145,1151,1962,811
2016,5,31,3,1140,1143,1953,810
2016,5,31,4,1160,1158,1953,795
2016,5,31,5,1070,1089,1973,884
2016,5,31,6,1000,1012,1926,914
2016,5,31,7,1015,971,1801,830
2016,5,31,8,995,956,1713,757
2016,5,31,9,980,956,1622,666
2016,5,31,10,975,952,1578,626
2016,5,31,11,990,982,1643,661
2016,5,31,12,1045,1016,1649,633
2016,5,31,13,1115,1118,1800,682
2016,5,31,14,1210,1208,1912,704
2016,5,31,15,1215,1222,1943,721
2016,5,31,16,1225,1240,1964,724
2016,5,31,17,1230,1249,1962,713
2016,5,31,18,1230,1236,1978,742
2016,5,31,19,1215,1226,1987,761
2016,5,31,20,1210,1232,1975,743
2016,5,31,21,1215,1222,1972,750
2016,5,31,22,1210,1218,1991,773
2016,5,31,23,1215,1212,1985,773
2016,6,1,0,1215,1200,1984,784
2016,6,1,1,1180,1202,1979,777
2016,6,1,2,1160,1201,1921,720
2016,6,1,3,1170,1187,1879,692
2016,6,1,4,1150,1202,1870,668
2016,6,1,5,1110,1149,1928,779
2016,6,1,6,1025,1078,1877,799
2016,6,1,7,1060,1016,1798,782
2016,6,1,8,1040,974,1584,610
2016,6,1,9,1025,963,1585,622
2016,6,1,10,1020,961,1566,605
2016,6,1,11,1035,971,1565,594
2016,6,1,12,1080,1015,1578,563
2016,6,1,13,1155,1102,1627,525
2016,6,1,14,1260,1170,1691,521
2016,6,1,15,1285,1191,1701,510
2016,6,1,16,1295,1198,1762,564
2016,6,1,17,1335,1210,1777,567
2016,6,1,18,1340,1216,1806,590
2016,6,1,19,1330,1212,1809,597
2016,6,1,20,1320,1226,1822,596
2016,6,1,21,1320,1233,1847,614
2016,6,1,22,1315,1247,1864,617
2016,6,1,23,1330,1271,1887,616
2016,6,2,0,1320,1261,1885,624
2016,6,2,1,1320,1241,1856,615
2016,6,2,2,1290,1236,1832,596
2016,6,2,3,1295,1219,1711,492
2016,6,2,4,1250,1235,1707,472
2016,6,2,5,1225,1158,1739,581
2016,6,2,6,1145,1055,1654,599
2016,6,2,7,1000,1007,1590,583
2016,6,2,8,985,975,1431,456
2016,6,2,9,965,962,1328,366
2016,6,2,10,960,929,1293,364
2016,6,2,11,980,986,1308,322
2016,6,2,12,1025,1020,1356,336
2016,6,2,13,1115,1113,1560,447
2016,6,2,14,1215,1199,1769,570
2016,6,2,15,1225,1227,1860,633
2016,6,2,16,1240,1266,1837,571
2016,6,2,17,1250,1274,1762,488
2016,6,2,18,1250,1315,1825,510
2016,6,2,19,1245,1308,1794,486
2016,6,2,20,1235,1314,1759,445
2016,6,2,21,1235,1314,1712,398
2016,6,2,22,1245,1323,1672,349
2016,6,2,23,1240,1313,1613,300
2016,6,3,0,1215,1287,1592,305
2016,6,3,1,1215,1272,1567,295
2016,6,3,2,1200,1272,1552,280
2016,6,3,3,1195,1249,1518,269
2016,6,3,4,1165,1255,1679,424
2016,6,3,5,1140,1185,1589,404
2016,6,3,6,1065,1092,1672,580
2016,6,3,7,980,1035,1626,591
2016,6,3,8,955,997,1362,365
2016,6,3,9,940,986,1351,365
2016,6,3,10,950,972,1354,382
2016,6,3,11,955,983,1388,405
2016,6,3,12,1000,1020,1397,377
2016,6,3,13,1115,1096,1569,473
2016,6,3,14,1220,1190,1663,473
2016,6,3,15,1230,1228,1762,534
2016,6,3,16,1235,1249,1855,606
2016,6,3,17,1250,1260,1915,655
2016,6,3,18,1250,1269,1912,643
2016,6,3,19,1245,1257,1914,657
2016,6,3,20,1235,1273,1799,526
2016,6,3,21,1240,1285,1907,622
2016,6,3,22,1250,1298,1912,614
2016,6,3,23,1260,1304,1914,610
2016,6,4,0,1250,1297,1923,626
2016,6,4,1,1225,1265,1939,674
2016,6,4,2,1225,1263,1933,670
2016,6,4,3,1225,1238,1889,651
2016,6,4,4,1190,1237,1865,628
2016,6,4,5,1160,1208,1873,665
2016,6,4,6,1065,1103,1799,696
2016,6,4,7,985,1049,1799,750
2016,6,4,8,960,1016,1688,672
2016,6,4,9,950,991,1683,692
2016,6,4,10,940,993,1681,688
2016,6,4,11,965,974,1657,683
2016,6,4,12,985,987,1675,688
2016,6,4,13,1040,1005,1620,615
2016,6,4,14,1110,1073,1571,498
2016,6,4,15,1150,1126,1530,404
2016,6,4,16,1215,1161,1498,337
2016,6,4,17,1235,1189,1745,556
2016,6,4,18,1250,1204,1844,640
2016,6,4,19,1225,1218,1892,674
2016,6,4,20,1225,1235,2020,785
2016,6,4,21,1225,1244,2024,780
2016,6,4,22,1230,1275,2052,777
2016,6,4,23,1225,1295,2099,804
2016,6,5,0,1220,1328,2122,794
2016,6,5,1,1215,1325,2052,727
2016,6,5,2,1210,1328,2102,774
2016,6,5,3,1190,1303,2113,810
2016,6,5,4,1110,1291,2103,812
2016,6,5,5,1110,1222,2083,861
2016,6,5,6,1080,1108,2030,922
2016,6,5,7,975,1045,1996,951
2016,6,5,8,945,1015,1800,785
2016,6,5,9,940,1000,1770,770
2016,6,5,10,925,982,1757,775
2016,6,5,11,950,979,1763,784
2016,6,5,12,975,975,1644,669
2016,6,5,13,1055,988,1632,644
2016,6,5,14,1155,1047,1462,415
2016,6,5,15,1205,1111,1490,379
2016,6,5,16,1240,1174,1639,465
2016,6,5,17,1270,1223,1769,546
2016,6,5,18,1290,1254,1926,672
2016,6,5,19,1260,1285,1899,614
2016,6,5,20,1285,1302,1955,653
2016,6,5,21,1295,1320,2004,684
2016,6,5,22,1310,1339,2031,692
2016,6,5,23,1310,1366,2123,757
2016,6,6,0,1295,1394,2137,743
2016,6,6,1,1290,1402,2163,761
2016,6,6,2,1285,1393,2168,775
2016,6,6,3,1260,1369,2064,695
2016,6,6,4,1155,1338,2027,689
2016,6,6,5,1200,1267,2019,752
2016,6,6,6,1130,1146,2081,935
2016,6,6,7,1030,1087,2046,959
2016,6,6,8,1005,1044,1941,897
2016,6,6,9,990,1006,1806,800
2016,6,6,10,980,1001,1743,742
2016,6,6,11,1015,1008,1765,757
2016,6,6,12,1060,1036,1775,739
2016,6,6,13,1200,1123,1772,649
2016,6,6,14,1330,1233,1753,520
2016,6,6,15,1375,1294,1901,607
2016,6,6,16,1405,1345,2040,695
2016,6,6,17,1445,1372,2050,678
2016,6,6,18,1480,1413,2085,672
2016,6,6,19,1465,1430,2091,661
2016,6,6,20,1455,1466,2083,617
2016,6,6,21,1460,1500,2095,595
2016,6,6,22,1475,1523,2091,568
2016,6,6,23,1465,1545,2093,548
2016,6,7,0,1445,1539,2109,570
2016,6,7,1,1450,1530,2105,575
2016,6,7,2,1430,1511,2108,597
2016,6,7,3,1405,1480,2123,643
2016,6,7,4,1315,1426,2124,698
2016,6,7,5,1310,1329,2079,750
2016,6,7,6,1235,1217,2045,828
2016,6,7,7,1045,1138,1815,677
2016,6,7,8,1030,1099,1715,616
2016,6,7,9,1015,1060,1728,668
2016,6,7,10,1005,1039,1661,622
2016,6,7,11,1015,1042,1483,441
2016,6,7,12,1050,1065,1511,446
2016,6,7,13,1200,1152,1651,499
2016,6,7,14,1380,1253,1688,435
2016,6,7,15,1425,1322,1958,636
2016,6,7,16,1460,1353,2006,653
2016,6,7,17,1495,1393,2024,631
2016,6,7,18,1500,1450,2046,596
2016,6,7,19,1505,1490,2035,545
2016,6,7,20,1515,1531,2066,535
2016,6,7,21,1515,1548,2037,489
2016,6,7,22,1525,1558,2026,468
2016,6,7,23,1535,1556,2100,544
2016,6,8,0,1550,1536,2122,586
2016,6,8,1,1545,1521,2106,585
2016,6,8,2,1530,1492,2077,585
2016,6,8,3,1515,1460,2078,618
2016,6,8,4,1380,1392,1933,541
2016,6,8,5,1350,1284,1919,635
2016,6,8,6,1310,1177,1868,691
2016,6,8,7,1165,1108,1796,688
2016,6,8,8,1125,1069,1669,600
2016,6,8,9,1090,1059,1629,570
2016,6,8,10,1095,1049,1602,553
2016,6,8,11,1100,1074,1644,570
2016,6,8,12,1155,1093,1645,552
2016,6,8,13,1325,1163,1642,479
2016,6,8,14,1510,1281,1766,485
2016,6,8,15,1545,1322,1842,520
2016,6,8,16,1575,1375,1853,478
2016,6,8,17,1590,1437,1873,436
2016,6,8,18,1610,1478,1889,411
2016,6,8,19,1610,1525,1931,406
2016,6,8,20,1630,1562,1890,328
2016,6,8,21,1645,1604,2010,406
2016,6,8,22,1665,1614,1869,255
2016,6,8,23,1675,1633,1860,227
2016,6,9,0,1680,1610,1881,271
2016,6,9,1,1645,1574,1887,313
2016,6,9,2,1625,1535,1888,353
2016,6,9,3,1620,1482,1880,398
2016,6,9,4,1510,1447,1745,298
2016,6,9,5,1505,1361,1656,295
2016,6,9,6,1360,1228,1468,240
2016,6,9,7,1060,1153,1357,204
2016,6,9,8,1035,1106,1253,147
2016,6,9,9,1015,1080,1370,290
2016,6,9,10,1000,1060,1412,352
2016,6,9,11,1025,1064,1297,233
2016,6,9,12,1070,1087,1340,253
2016,6,9,13,1175,1161,1417,256
2016,6,9,14,1280,1254,1520,266
2016,6,9,15,1320,1304,1564,260
2016,6,9,16,1330,1356,1769,413
2016,6,9,17,1370,1410,1779,369
2016,6,9,18,1410,1437,1771,334
2016,6,9,19,1415,1469,1773,304
2016,6,9,20,1425,1500,1778,278
2016,6,9,21,1435,1517,1773,256
2016,6,9,22,1450,1525,1695,170
2016,6,9,23,1450,1537,1742,205
2016,6,10,0,1425,1520,1833,313
2016,6,10,1,1400,1484,1809,325
2016,6,10,2,1375,1435,1881,446
2016,6,10,3,1355,1384,1828,444
2016,6,10,4,1280,1348,1779,431
2016,6,10,5,1220,1270,1722,452
2016,6,10,6,1165,1162,1726,564
2016,6,10,7,1065,1096,1701,605
2016,6,10,8,1040,1073,1713,640
2016,6,10,9,1025,1038,1707,669
2016,6,10,10,1020,1035,1723,688
2016,6,10,11,1025,1047,1728,681
2016,6,10,12,1060,1042,1709,667
2016,6,10,13,1155,1114,1728,614
2016,6,10,14,1275,1210,1707,497
2016,6,10,15,1315,1276,1731,455
2016,6,10,16,1335,1313,1698,385
2016,6,10,17,1365,1355,1731,376
2016,6,10,18,1395,1383,1731,348
2016,6,10,19,1405,1402,1737,335
2016,6,10,20,1425,1450,1772,322
2016,6,10,21,1440,1470,1796,326
2016,6,10,22,1450,1484,1783,299
2016,6,10,23,1460,1505,1838,333
2016,6,11,0,1455,1431,1819,388
2016,6,11,1,1420,1422,1835,413
2016,6,11,2,1395,1434,1827,393
2016,6,11,3,1365,1331,1740,409
2016,6,11,4,1275,1354,1752,398
2016,6,11,5,1225,1285,1719,434
2016,6,11,6,1175,1185,1699,514
2016,6,11,7,1000,1120,1698,578
2016,6,11,8,970,1071,1671,600
2016,6,11,9,955,1043,1509,466
2016,6,11,10,940,1030,1471,441
2016,6,11,11,940,1029,1502,473
2016,6,11,12,955,1027,1524,497
2016,6,11,13,950,1044,1529,485
2016,6,11,14,995,1103,1579,476
2016,6,11,15,1040,1157,1641,484
2016,6,11,16,1080,1228,1748,520
2016,6,11,17,1120,1252,1725,473
2016,6,11,18,1125,1267,1810,543
2016,6,11,19,1145,1283,1755,472
2016,6,11,20,1160,1280,1746,466
2016,6,11,21,1160,1264,1731,467
2016,6,11,22,1180,1268,1826,558
2016,6,11,23,1190,1280,1834,554
2016,6,12,0,1190,1281,1844,563
2016,6,12,1,1185,1274,1833,559
2016,6,12,2,1170,1269,1817,548
2016,6,12,3,1140,1259,1844,585
2016,6,12,4,1100,1247,1790,543
2016,6,12,5,1065,1204,1807,603
2016,6,12,6,980,1136,1738,602
2016,6,12,7,1035,1075,1650,575
2016,6,12,8,1005,1039,1642,603
2016,6,12,9,995,1025,1634,609
2016,6,12,10,980,1022,1671,649
2016,6,12,11,980,1028,1705,677
2016,6,12,12,995,1023,1671,648
2016,6,12,13,1000,1015,1777,762
2016,6,12,14,1030,1071,1846,775
2016,6,12,15,1080,1126,1870,744
2016,6,12,16,1120,1189,1967,778
2016,6,12,17,1175,1208,1983,775
2016,6,12,18,1195,1232,2046,814
2016,6,12,19,1210,1227,2068,841
2016,6,12,20,1225,1249,2071,822
2016,6,12,21,1230,1259,2148,889
2016,6,12,22,1255,1271,2156,885
2016,6,12,23,1270,1288,2180,892
2016,6,13,0,1270,1306,2178,872
2016,6,13,1,1265,1319,2191,872
2016,6,13,2,1245,1315,2162,847
2016,6,13,3,1215,1293,2125,832
2016,6,13,4,1040,1297,2112,815
2016,6,13,5,1130,1236,2147,911
2016,6,13,6,1025,1140,2125,985
2016,6,13,7,1035,1065,1944,879
2016,6,13,8,1005,1032,1701,669
2016,6,13,9,980,1012,1729,717
2016,6,13,10,970,1014,1738,724
2016,6,13,11,980,1023,1742,719
2016,6,13,12,1015,1052,1746,694
2016,6,13,13,1035,1128,1736,608
2016,6,13,14,1095,1217,1915,698
2016,6,13,15,1140,1270,1859,589
2016,6,13,16,1175,1305,1836,531
2016,6,13,17,1220,1322,1798,476
2016,6,13,18,1245,1344,1706,362
2016,6,13,19,1260,1354,1704,350
2016,6,13,20,1275,1368,1721,353
2016,6,13,21,1280,1354,1673,319
2016,6,13,22,1305,1356,1644,288
2016,6,13,23,1315,1371,1645,274
2016,6,14,0,1300,1364,1727,363
2016,6,14,1,1285,1347,1677,330
2016,6,14,2,1260,1313,1656,343
2016,6,14,3,1235,1286,1632,346
2016,6,14,4,1095,1284,1631,347
2016,6,14,5,1060,1227,1621,394
2016,6,14,6,1030,1122,1534,412
2016,6,14,7,1065,1072,1541,469
2016,6,14,8,1045,1043,1559,516
2016,6,14,9,1025,1031,1548,517
2016,6,14,10,1020,1028,1563,535
2016,6,14,11,1035,1031,1549,518
2016,6,14,12,1045,1039,1556,517
2016,6,14,13,1055,1114,1575,461
2016,6,14,14,1110,1212,1715,503
2016,6,14,15,1155,1263,1817,554
2016,6,14,16,1190,1281,1874,593
2016,6,14,17,1215,1305,1914,609
2016,6,14,18,1240,1340,1765,425
2016,6,14,19,1250,1350,1844,494
2016,6,14,20,1270,1348,1880,532
2016,6,14,21,1290,1350,1991,641
2016,6,14,22,1300,1351,1852,501
2016,6,14,23,1295,1354,1768,414
2016,6,15,0,1310,1336,1729,393
2016,6,15,1,1290,1326,1742,416
2016,6,15,2,1280,1299,1681,382
2016,6,15,3,1260,1265,1639,374
2016,6,15,4,1110,1260,1746,486
2016,6,15,5,1100,1203,1857,654
2016,6,15,6,1085,1122,1926,804
2016,6,15,7,1065,1070,1855,785
2016,6,15,8,1035,1026,1698,672
2016,6,15,9,1020,991,1685,694
2016,6,15,10,1020,988,1734,746
2016,6,15,11,1030,1014,1801,787
2016,6,15,12,1050,1060,1873,813
2016,6,15,13,1080,1161,1876,715
2016,6,15,14,1130,1233,2002,769
2016,6,15,15,1165,1274,2064,790
2016,6,15,16,1190,1281,2095,814
2016,6,15,17,1200,1286,2099,813
2016,6,15,18,1230,1276,1994,718
2016,6,15,19,1255,1278,2020,742
2016,6,15,20,1270,1266,2048,782
2016,6,15,21,1270,1277,2075,798
2016,6,15,22,1285,1280,2072,792
2016,6,15,23,1300,1280,2070,790
2016,6,16,0,1285,1242,2028,786
2016,6,16,1,1265,1247,2038,791
2016,6,16,2,1240,1237,1902,665
2016,6,16,3,1210,1235,1779,544
2016,6,16,4,1130,1236,1766,530
2016,6,16,5,1140,1174,1762,588
2016,6,16,6,1040,1091,1664,573
2016,6,16,7,1040,1045,1656,611
2016,6,16,8,1010,1020,1682,662
2016,6,16,9,995,1003,1619,616
2016,6,16,10,990,982,1607,625
2016,6,16,11,1005,1005,1623,618
2016,6,16,12,1035,1032,1772,740
2016,6,16,13,1100,1119,1832,713
2016,6,16,14,1190,1202,2085,883
2016,6,16,15,1230,1255,2124,869
2016,6,16,16,1260,1282,2150,868
2016,6,16,17,1280,1304,2160,856
2016,6,16,18,1325,1318,2179,861
2016,6,16,19,1345,1322,2148,826
2016,6,16,20,1355,1340,2128,788
2016,6,16,21,1355,1366,2176,810
2016,6,16,22,1370,1350,1974,624
2016,6,16,23,1380,1324,1948,624
2016,6,17,0,1355,1318,2073,755
2016,6,17,1,1345,1307,2062,755
2016,6,17,2,1310,1290,2036,746
2016,6,17,3,1265,1250,1985,735
2016,6,17,4,1190,1255,2004,749
2016,6,17,5,1185,1215,2017,802
2016,6,17,6,1090,1114,1929,815
2016,6,17,7,1075,1056,1903,847
2016,6,17,8,1035,1026,1921,895
2016,6,17,9,1020,1013,1973,960
2016,6,17,10,1020,1000,1960,960
2016,6,17,11,1040,1027,1930,903
2016,6,17,12,1070,1050,1914,864
2016,6,17,13,1150,1102,1962,860
2016,6,17,14,1260,1180,2083,903
2016,6,17,15,1305,1217,2057,840
2016,6,17,16,1325,1240,2080,840
2016,6,17,17,1320,1254,2093,839
2016,6,17,18,1330,1265,2102,837
2016,6,17,19,1335,1252,2085,833
2016,6,17,20,1355,1263,2088,825
2016,6,17,21,1365,1261,2091,830
2016,6,17,22,1370,1273,2108,835
2016,6,17,23,1375,1274,2118,844
2016,6,18,0,1345,1268,2110,842
2016,6,18,1,1335,1247,2116,869
2016,6,18,2,1325,1224,2116,892
2016,6,18,3,1285,1205,2087,882
2016,6,18,4,1240,1193,2116,923
2016,6,18,5,1225,1172,2174,1002
2016,6,18,6,1130,1086,2179,1093
2016,6,18,7,1075,1038,2155,1117
2016,6,18,8,1040,1007,2179,1172
2016,6,18,9,1020,981,2155,1174
2016,6,18,10,1010,981,2136,1155
2016,6,18,11,1020,983,2070,1087
2016,6,18,12,1030,987,2063,1076
2016,6,18,13,1100,1004,1928,924
2016,6,18,14,1200,1072,1885,813
2016,6,18,15,1250,1115,1936,821
2016,6,18,16,1290,1177,2033,856
2016,6,18,17,1300,1196,2070,874
2016,6,18,18,1320,1221,2092,871
2016,6,18,19,1310,1241,2114,873
2016,6,18,20,1315,1264,2089,825
2016,6,18,21,1350,1291,2100,809
2016,6,18,22,1340,1338,2117,779
2016,6,18,23,1325,1333,2027,694
2016,6,19,0,1320,1335,2031,696
2016,6,19,1,1300,1324,2059,735
2016,6,19,2,1280,1318,2095,777
2016,6,19,3,1250,1295,2060,765
2016,6,19,4,1200,1278,1981,703
2016,6,19,5,1180,1250,2028,778
2016,6,19,6,1150,1174,1889,715
2016,6,19,7,1030,1107,1862,755
2016,6,19,8,1000,1054,1887,833
2016,6,19,9,990,1041,1811,770
2016,6,19,10,975,1026,1748,722
2016,6,19,11,990,1017,1815,798
2016,6,19,12,995,1018,1871,853
2016,6,19,13,1035,1046,1912,866
2016,6,19,14,1115,1105,1985,880
2016,6,19,15,1160,1167,2046,879
2016,6,19,16,1215,1206,2054,848
2016,6,19,17,1235,1226,2068,842
2016,6,19,18,1250,1243,2189,946
2016,6,19,19,1250,1266,2220,954
2016,6,19,20,1265,1272,2202,930
2016,6,19,21,1290,1262,2194,932
2016,6,19,22,1290,1271,2201,930
2016,6,19,23,1290,1291,2193,902
2016,6,20,0,1305,1322,2165,843
2016,6,20,1,1300,1317,2122,805
2016,6,20,2,1285,1301,2108,807
2016,6,20,3,1250,1278,2078,800
2016,6,20,4,1115,1275,2080,805
2016,6,20,5,1110,1216,2058,842
2016,6,20,6,1100,1099,2036,937
2016,6,20,7,1070,1021,2023,1002
2016,6,20,8,1035,993,1963,970
2016,6,20,9,1010,974,1944,970
2016,6,20,10,1000,985,1956,971
2016,6,20,11,1020,997,1973,976
2016,6,20,12,1055,1027,1971,944
2016,6,20,13,1145,1120,1955,835
2016,6,20,14,1240,1202,1913,711
2016,6,20,15,1280,1250,1942,692
2016,6,20,16,1315,1286,1947,661
2016,6,20,17,1340,1318,1993,675
2016,6,20,18,1355,1337,1994,657
2016,6,20,19,1360,1355,1986,631
2016,6,20,20,1365,1387,1988,601
2016,6,20,21,1380,1423,2001,578
2016,6,20,22,1375,1460,1991,531
2016,6,20,23,1380,1487,1991,504
2016,6,21,0,1365,1503,2009,506
2016,6,21,1,1355,1509,2037,528
2016,6,21,2,1325,1498,2034,536
2016,6,21,3,1290,1460,2046,586
2016,6,21,4,1230,1427,2075,648
2016,6,21,5,1230,1354,2025,671
2016,6,21,6,1120,1240,2044,804
2016,6,21,7,1080,1144,1995,851
2016,6,21,8,1050,1078,1822,744
2016,6,21,9,1030,1063,1746,683
2016,6,21,10,1015,1035,1646,611
2016,6,21,11,1010,1037,1616,579
2016,6,21,12,1035,1071,1645,574
2016,6,21,13,1130,1134,1747,613
2016,6,21,14,1275,1248,1717,469
2016,6,21,15,1345,1301,1748,447
2016,6,21,16,1375,1355,1911,556
2016,6,21,17,1385,1395,1952,557
2016,6,21,18,1420,1447,1943,496
2016,6,21,19,1450,1472,1960,488
2016,6,21,20,1470,1504,2010,506
2016,6,21,21,1465,1539,2036,497
2016,6,21,22,1470,1556,2047,491
2016,6,21,23,1485,1563,2037,474
2016,6,22,0,1490,1532,2034,502
2016,6,22,1,1475,1498,1995,497
2016,6,22,2,1455,1488,2034,546
2016,6,22,3,1425,1444,2005,561
2016,6,22,4,1275,1407,2063,656
2016,6,22,5,1250,1328,2068,740
2016,6,22,6,1205,1210,2053,843
2016,6,22,7,985,1142,2022,880
2016,6,22,8,985,1093,2030,937
2016,6,22,9,960,1062,1959,897
2016,6,22,10,965,1040,1917,877
2016,6,22,11,990,1050,1908,858
2016,6,22,12,1025,1068,1895,827
2016,6,22,13,1155,1143,1896,753
2016,6,22,14,1275,1237,1888,651
2016,6,22,15,1315,1277,1874,597
2016,6,22,16,1340,1305,1865,560
2016,6,22,17,1375,1343,1881,538
2016,6,22,18,1390,1366,1946,580
2016,6,22,19,1405,1377,1976,599
2016,6,22,20,1420,1399,1979,580
2016,6,22,21,1440,1438,1981,543
2016,6,22,22,1460,1474,2004,530
2016,6,22,23,1475,1491,2008,517
2016,6,23,0,1465,1499,1979,480
2016,6,23,1,1470,1500,1975,475
2016,6,23,2,1455,1479,1980,501
2016,6,23,3,1420,1444,1979,535
2016,6,23,4,1400,1405,1943,538
2016,6,23,5,1395,1331,1972,641
2016,6,23,6,1205,1215,1901,686
2016,6,23,7,1085,1148,1854,706
2016,6,23,8,1045,1086,1853,767
2016,6,23,9,1040,1059,1738,679
2016,6,23,10,1020,1054,1717,663
2016,6,23,11,1030,1056,1578,522
2016,6,23,12,1070,1081,1598,517
2016,6,23,13,1150,1152,1693,541
2016,6,23,14,1250,1244,1728,484
2016,6,23,15,1290,1300,1779,479
2016,6,23,16,1335,1346,1815,469
2016,6,23,17,1385,1389,1834,445
2016,6,23,18,1415,1416,1843,427
2016,6,23,19,1425,1455,1877,422
2016,6,23,20,1460,1503,1861,358
2016,6,23,21,1480,1550,1870,320
2016,6,23,22,1490,1580,1878,298
2016,6,23,23,1490,1605,1871,266
2016,6,24,0,1475,1601,1874,273
2016,6,24,1,1450,1569,1809,240
2016,6,24,2,1420,1556,1840,284
2016,6,24,3,1375,1514,1789,275
2016,6,24,4,1370,1473,1887,414
2016,6,24,5,1320,1398,1925,527
2016,6,24,6,1165,1275,1871,596
2016,6,24,7,1045,1185,1708,523
2016,6,24,8,1020,1140,1577,437
2016,6,24,9,1000,1105,1550,445
2016,6,24,10,990,1084,1497,413
2016,6,24,11,1000,1094,1513,419
2016,6,24,12,1030,1109,1488,379
2016,6,24,13,1065,1173,1519,346
2016,6,24,14,1125,1260,1538,278
2016,6,24,15,1155,1331,1619,288
2016,6,24,16,1180,1376,1558,182
2016,6,24,17,1215,1400,1507,107
2016,6,24,18,1235,1422,1566,144
2016,6,24,19,1230,1423,1628,205
2016,6,24,20,1255,1440,1647,207
2016,6,24,21,1265,1442,1692,250
2016,6,24,22,1290,1456,1687,231
2016,6,24,23,1300,1455,1556,101
2016,6,25,0,1300,1426,1461,35
2016,6,25,1,1285,1383,1508,125
2016,6,25,2,1270,1356,1483,127
2016,6,25,3,1245,1299,1470,171
2016,6,25,4,1135,1299,1435,136
2016,6,25,5,1125,1258,1431,173
2016,6,25,6,1090,1176,1501,325
2016,6,25,7,1065,1127,1592,465
2016,6,25,8,1025,1099,1481,382
2016,6,25,9,995,1036,1477,441
2016,6,25,10,990,1065,1582,517
2016,6,25,11,995,1066,1577,511
2016,6,25,12,1015,1063,1585,522
2016,6,25,13,1020,1086,1576,490
2016,6,25,14,1070,1146,1686,540
2016,6,25,15,1120,1206,1756,550
2016,6,25,16,1145,1232,1837,605
2016,6,25,17,1180,1257,1881,624
2016,6,25,18,1200,1253,1874,621
2016,6,25,19,1220,1249,1873,624
2016,6,25,20,1245,1261,1883,622
2016,6,25,21,1270,1247,1882,635
2016,6,25,22,1295,1257,1881,624
2016,6,25,23,1310,1279,1895,616
2016,6,26,0,1305,1292,1894,602
2016,6,26,1,1295,1305,1886,581
2016,6,26,2,1285,1288,1851,563
2016,6,26,3,1260,1271,1800,529
2016,6,26,4,1255,1263,1746,483
2016,6,26,5,1245,1229,1717,488
2016,6,26,6,1200,1156,1702,546
2016,6,26,7,1090,1096,1748,652
2016,6,26,8,1050,1061,1691,630
2016,6,26,9,1030,1049,1670,621
2016,6,26,10,1020,1036,1664,628
2016,6,26,11,1020,1025,1647,622
2016,6,26,12,1035,1011,1648,637
2016,6,26,13,1030,1024,1647,623
2016,6,26,14,1080,1078,1615,537
2016,6,26,15,1135,1142,1624,482
2016,6,26,16,1170,1190,1629,439
2016,6,26,17,1190,1217,1632,415
2016,6,26,18,1215,1243,1663,420
2016,6,26,19,1235,1257,1667,410
2016,6,26,20,1265,1271,1686,415
2016,6,26,21,1280,1292,1695,403
2016,6,26,22,1295,1328,1724,396
2016,6,26,23,1320,1374,1751,377
2016,6,27,0,1335,1371,1786,415
2016,6,27,1,1320,1430,1785,355
2016,6,27,2,1315,1413,1790,377
2016,6,27,3,1310,1397,1795,398
2016,6,27,4,1290,1352,1792,440
2016,6,27,5,1215,1276,1768,492
2016,6,27,6,1190,1176,1744,568
2016,6,27,7,1040,1097,1704,607
2016,6,27,8,1015,1068,1747,679
2016,6,27,9,1015,1050,1824,774
2016,6,27,10,1015,1043,1804,761
2016,6,27,11,1015,1058,1823,765
2016,6,27,12,1040,1081,1829,748
2016,6,27,13,1135,1166,1827,661
2016,6,27,14,1240,1263,1847,584
2016,6,27,15,1290,1322,1851,529
2016,6,27,16,1310,1377,1942,565
2016,6,27,17,1350,1407,1942,535
2016,6,27,18,1380,1447,1943,496
2016,6,27,19,1400,1471,1935,464
2016,6,27,20,1430,1504,1950,446
2016,6,27,21,1460,1546,1990,444
2016,6,27,22,1480,1587,1990,403
2016,6,27,23,1505,1632,1986,354
2016,6,28,0,1495,1578,1994,416
2016,6,28,1,1490,1619,1990,371
2016,6,28,2,1475,1603,2002,399
2016,6,28,3,1435,1550,2022,472
2016,6,28,4,1420,1476,2055,579
2016,6,28,5,1400,1403,2098,695
2016,6,28,6,1210,1266,2071,805
2016,6,28,7,1075,1203,2025,822
2016,6,28,8,1035,1132,1969,837
2016,6,28,9,1025,1110,1949,839
2016,6,28,10,1015,1091,1974,883
2016,6,28,11,1010,1104,1959,855
2016,6,28,12,1025,1126,1899,773
2016,6,28,13,1115,1205,1900,695
2016,6,28,14,1250,1279,1812,533
2016,6,28,15,1310,1341,1982,641
2016,6,28,16,1355,1390,1981,591
2016,6,28,17,1390,1424,1979,555
2016,6,28,18,1420,1465,1984,519
2016,6,28,19,1440,1499,1933,434
2016,6,28,20,1460,1538,1900,362
2016,6,28,21,1480,1571,1946,375
2016,6,28,22,1505,1615,1929,314
2016,6,28,23,1535,1648,1929,281
2016,6,29,0,1525,1679,1978,299
2016,6,29,1,1535,1666,1962,296
2016,6,29,2,1510,1645,1969,324
2016,6,29,3,1475,1608,1976,368
2016,6,29,4,1425,1561,1967,406
2016,6,29,5,1370,1469,1989,520
2016,6,29,6,1240,1351,1990,639
2016,6,29,7,1170,1270,1975,705
2016,6,29,8,1120,1197,1883,686
2016,6,29,9,1100,1158,1816,658
2016,6,29,10,1100,1141,1830,689
2016,6,29,11,1100,1135,1827,692
2016,6,29,12,1110,1160,1894,734
2016,6,29,13,1225,1236,1904,668
2016,6,29,14,1355,1311,1933,622
2016,6,29,15,1405,1366,1954,588
2016,6,29,16,1440,1410,2046,636
2016,6,29,17,1480,1461,2103,642
2016,6,29,18,1500,1549,2204,655
2016,6,29,19,1515,1541,2218,677
2016,6,29,20,1530,1576,2296,720
2016,6,29,21,1560,1596,2287,691
2016,6,29,22,1595,1640,2301,661
2016,6,29,23,1620,1657,2311,654
2016,6,30,0,1595,1650,2270,620
2016,6,30,1,1615,1612,2258,646
2016,6,30,2,1595,1597,2281,684
2016,6,30,3,1565,1562,2259,697
2016,6,30,4,1490,1503,2283,780
2016,6,30,5,1435,1427,2285,858
2016,6,30,6,1300,1304,2281,977
2016,6,30,7,1220,1212,2282,1070
2016,6,30,8,1160,1180,2217,1037
2016,6,30,9,1120,1139,2039,900
2016,6,30,10,1100,1122,1907,785
2016,6,30,11,1160,1112,1868,756
2016,6,30,12,1120,1141,1842,701
2016,6,30,13,1250,1211,1949,738
2016,6,30,14,1345,1313,1952,639
2016,6,30,15,1420,1385,2060,675
2016,6,30,16,1460,1432,2030,598
2016,6,30,17,1490,1473,2051,578
2016,6,30,18,1520,1505,2099,594
2016,6,30,19,1550,1539,2230,691
2016,6,30,20,1575,1584,2305,721
2016,6,30,21,1630,1627,2361,734
2016,6,30,22,1680,1641,2481,840
2016,6,30,23,1700,1636,2482,846
2016,7,1,0,1690,1639,2449,810
2016,7,1,1,1655,1611,2321,710
2016,7,1,2,1620,1591,2389,798
2016,7,1,3,1610,1534,2308,774
2016,7,1,4,1550,1497,2343,846
2016,7,1,5,1490,1412,2290,878
2016,7,1,6,1380,1297,2344,1047
2016,7,1,7,1210,1198,2348,1150
2016,7,1,8,1150,1151,2366,1215
2016,7,1,9,1105,1104,2156,1052
2016,7,1,10,1105,1079,2040,961
2016,7,1,11,1105,1088,2093,1005
2016,7,1,12,1145,1113,2283,1170
2016,7,1,13,1255,1179,2408,1229
2016,7,1,14,1380,1263,2337,1074
2016,7,1,15,1435,1349,2422,1073
2016,7,1,16,1475,1402,2425,1023
2016,7,1,17,1510,1451,2483,1032
2016,7,1,18,1560,1491,2483,992
2016,7,1,19,1565,1528,2487,959
2016,7,1,20,1580,1561,2413,852
2016,7,1,21,1600,1601,2204,603
2016,7,1,22,1635,1590,2172,582
2016,7,1,23,1640,1581,2290,709
2016,7,2,0,1615,1571,2373,802
2016,7,2,1,1585,1561,2482,921
2016,7,2,2,1555,1531,2505,974
2016,7,2,3,1510,1492,2497,1005
2016,7,2,4,1480,1448,2501,1053
2016,7,2,5,1410,1387,2521,1134
2016,7,2,6,1290,1278,2500,1222
2016,7,2,7,1150,1200,2480,1280
2016,7,2,8,1110,1147,2393,1246
2016,7,2,9,1060,1126,2473,1347
2016,7,2,10,1070,1095,2467,1372
2016,7,2,11,1070,1085,2477,1392
2016,7,2,12,1090,1096,2480,1384
2016,7,2,13,1190,1107,2445,1338
2016,7,2,14,1345,1161,2366,1205
2016,7,2,15,1400,1227,2407,1180
2016,7,2,16,1445,1295,2558,1263
2016,7,2,17,1480,1356,2572,1216
2016,7,2,18,1490,1394,2585,1191
2016,7,2,19,1520,1425,2605,1180
2016,7,2,20,1535,1465,2604,1139
2016,7,2,21,1560,1483,2663,1180
2016,7,2,22,1580,1495,2661,1166
2016,7,2,23,1595,1497,2681,1184
2016,7,3,0,1600,1491,2689,1198
2016,7,3,1,1585,1485,2687,1202
2016,7,3,2,1575,1457,2692,1235
2016,7,3,3,1530,1423,2679,1256
2016,7,3,4,1490,1387,2607,1220
2016,7,3,5,1435,1348,2664,1316
2016,7,3,6,1330,1267,2639,1372
2016,7,3,7,1165,1198,2638,1440
2016,7,3,8,1125,1153,2579,1426
2016,7,3,9,1100,1128,2537,1409
2016,7,3,10,1095,1083,2454,1371
2016,7,3,11,1080,1095,2461,1366
2016,7,3,12,1090,1091,2536,1445
2016,7,3,13,1160,1091,2395,1304
2016,7,3,14,1275,1157,2360,1203
2016,7,3,15,1350,1238,2439,1201
2016,7,3,16,1400,1325,2431,1106
2016,7,3,17,1425,1364,2375,1011
2016,7,3,18,1440,1374,2597,1223
2016,7,3,19,1470,1407,2752,1345
2016,7,3,20,1500,1420,2710,1290
2016,7,3,21,1525,1438,2680,1242
2016,7,3,22,1555,1434,2686,1252
2016,7,3,23,1580,1437,2660,1223
2016,7,4,0,1590,1416,2620,1204
2016,7,4,1,1590,1409,2642,1233
2016,7,4,2,1585,1401,2670,1269
2016,7,4,3,1545,1363,2634,1271
2016,7,4,4,1490,1358,2757,1399
2016,7,4,5,1415,1288,2615,1327
2016,7,4,6,1280,1199,2506,1307
2016,7,4,7,1110,1129,2536,1407
2016,7,4,8,1075,1065,2362,1297
2016,7,4,9,1050,1040,2351,1311
2016,7,4,10,1050,1043,2398,1355
2016,7,4,11,1060,1034,2380,1346
2016,7,4,12,1080,1026,2306,1280
2016,7,4,13,1170,1049,2316,1267
2016,7,4,14,1260,1113,2443,1330
2016,7,4,15,1325,1190,2491,1301
2016,7,4,16,1360,1263,2645,1382
2016,7,4,17,1395,1307,2667,1360
2016,7,4,18,1425,1346,2668,1322
2016,7,4,19,1455,1375,2723,1348
2016,7,4,20,1485,1364,2736,1372
2016,7,4,21,1520,1371,2736,1365
2016,7,4,22,1545,1376,2732,1356
2016,7,4,23,1570,1404,2716,1312
2016,7,5,0,1555,1407,2671,1264
2016,7,5,1,1555,1376,2653,1277
2016,7,5,2,1550,1371,2741,1370
2016,7,5,3,1495,1342,2706,1364
2016,7,5,4,1420,1315,2520,1205
2016,7,5,5,1355,1259,2386,1127
2016,7,5,6,1225,1197,2296,1099
2016,7,5,7,1140,1138,2318,1180
2016,7,5,8,1100,1110,2614,1504
2016,7,5,9,1100,1069,2457,1388
2016,7,5,10,1090,1074,2441,1367
2016,7,5,11,1100,1061,2391,1330
2016,7,5,12,1100,1094,2442,1348
2016,7,5,13,1190,1168,2476,1308
2016,7,5,14,1285,1253,2544,1291
2016,7,5,15,1350,1324,2640,1316
2016,7,5,16,1380,1380,2687,1307
2016,7,5,17,1395,1389,2652,1263
2016,7,5,18,1430,1442,2656,1214
2016,7,5,19,1460,1437,2630,1193
2016,7,5,20,1495,1465,2650,1185
2016,7,5,21,1535,1486,2638,1152
2016,7,5,22,1565,1488,2614,1126
2016,7,5,23,1575,1500,2592,1092
2016,7,6,0,1580,1482,2594,1112
2016,7,6,1,1545,1472,2581,1109
2016,7,6,2,1530,1455,2575,1120
2016,7,6,3,1500,1419,2632,1213
2016,7,6,4,1480,1409,2653,1244
2016,7,6,5,1380,1327,2639,1312
2016,7,6,6,1290,1231,2574,1343
2016,7,6,7,1095,1161,2559,1398
2016,7,6,8,1045,1119,2575,1456
2016,7,6,9,1005,1090,2587,1497
2016,7,6,10,1000,1098,2595,1497
2016,7,6,11,1005,1102,2591,1489
2016,7,6,12,1025,1167,2653,1486
2016,7,6,13,1055,1202,2613,1411
2016,7,6,14,1105,1284,2585,1301
2016,7,6,15,1160,1333,2608,1275
2016,7,6,16,1285,1373,2719,1346
2016,7,6,17,1295,1413,2741,1328
2016,7,6,18,1310,1438,2747,1309
2016,7,6,19,1350,1433,2729,1296
2016,7,6,20,1350,1444,2741,1297
2016,7,6,21,1360,1447,2729,1282
2016,7,6,22,1370,1473,2802,1329
2016,7,6,23,1390,1456,2807,1351
2016,7,7,0,1360,1426,2764,1338
2016,7,7,1,1345,1399,2730,1331
2016,7,7,2,1335,1356,2727,1371
2016,7,7,3,1310,1334,2728,1394
2016,7,7,4,1290,1324,2721,1397
2016,7,7,5,1205,1272,2717,1445
2016,7,7,6,1100,1190,2667,1477
2016,7,7,7,1100,1140,2647,1507
2016,7,7,8,1070,1116,2610,1494
2016,7,7,9,1040,1103,2608,1505
2016,7,7,10,1035,1086,2639,1553
2016,7,7,11,1040,1095,2657,1562
2016,7,7,12,1120,1122,2654,1532
2016,7,7,13,1160,1200,2635,1435
2016,7,7,14,1240,1268,2602,1334
2016,7,7,15,1285,1303,2597,1294
2016,7,7,16,1325,1325,2500,1175
2016,7,7,17,1345,1348,2456,1108
2016,7,7,18,1385,1386,2650,1264
2016,7,7,19,1400,1386,2641,1255
2016,7,7,20,1440,1408,2647,1239
2016,7,7,21,1465,1431,2659,1228
2016,7,7,22,1475,1467,2675,1208
2016,7,7,23,1485,1470,2662,1192
2016,7,8,0,1475,1469,2672,1203
2016,7,8,1,1460,1446,2642,1196
2016,7,8,2,1440,1422,2626,1204
2016,7,8,3,1405,1395,2621,1226
2016,7,8,4,1350,1393,2597,1204
2016,7,8,5,1295,1340,2628,1288
2016,7,8,6,1185,1241,2614,1373
2016,7,8,7,1125,1172,2634,1462
2016,7,8,8,1085,1134,2612,1478
2016,7,8,9,1060,1087,2601,1514
2016,7,8,10,1050,1091,2573,1482
2016,7,8,11,1070,1096,2615,1519
2016,7,8,12,1090,1127,2606,1479
2016,7,8,13,1190,1179,2586,1407
2016,7,8,14,1315,1269,2607,1338
2016,7,8,15,1375,1324,2598,1274
2016,7,8,16,1420,1363,2605,1242
2016,7,8,17,1450,1400,2621,1221
2016,7,8,18,1480,1439,2644,1205
2016,7,8,19,1490,1491,2695,1204
2016,7,8,20,1515,1520,2690,1170
2016,7,8,21,1535,1544,2687,1143
2016,7,8,22,1560,1570,2679,1109
2016,7,8,23,1545,1593,2686,1093
2016,7,9,0,1520,1545,2681,1136
2016,7,9,1,1490,1523,2730,1207
2016,7,9,2,1445,1477,2692,1215
2016,7,9,3,1415,1434,2657,1223
2016,7,9,4,1380,1397,2632,1235
2016,7,9,5,1320,1339,2630,1291
2016,7,9,6,1215,1244,2655,1411
2016,7,9,7,1120,1176,2552,1376
2016,7,9,8,1080,1131,2609,1478
2016,7,9,9,1080,1096,2626,1530
2016,7,9,10,1040,1097,2629,1532
2016,7,9,11,1030,1096,2658,1562
2016,7,9,12,1045,1071,2612,1541
2016,7,9,13,1095,1068,2514,1446
2016,7,9,14,1185,1135,2464,1329
2016,7,9,15,1240,1197,2486,1289
2016,7,9,16,1275,1267,2548,1281
2016,7,9,17,1305,1317,2617,1300
2016,7,9,18,1335,1355,2631,1276
2016,7,9,19,1350,1385,2669,1284
2016,7,9,20,1370,1394,2665,1271
2016,7,9,21,1390,1409,2671,1262
2016,7,9,22,1410,1418,2671,1253
2016,7,9,23,1420,1440,2710,1270
2016,7,10,0,1420,1427,2707,1280
2016,7,10,1,1405,1407,2748,1341
2016,7,10,2,1375,1384,2731,1347
2016,7,10,3,1350,1353,2753,1400
2016,7,10,4,1300,1326,2727,1401
2016,7,10,5,1290,1270,2715,1445
2016,7,10,6,1200,1180,2647,1467
2016,7,10,7,1120,1116,2486,1370
2016,7,10,8,1100,1087,2332,1245
2016,7,10,9,1030,1081,2308,1227
2016,7,10,10,1000,1072,2312,1240
2016,7,10,11,1010,1062,2312,1250
2016,7,10,12,1015,1066,2217,1151
2016,7,10,13,1035,1072,2291,1219
2016,7,10,14,1090,1106,2294,1188
2016,7,10,15,1150,1164,2281,1117
2016,7,10,16,1205,1195,2280,1085
2016,7,10,17,1225,1209,2295,1086
2016,7,10,18,1240,1223,2279,1056
2016,7,10,19,1260,1228,2281,1053
2016,7,10,20,1270,1230,2285,1055
2016,7,10,21,1290,1225,2282,1057
2016,7,10,22,1310,1237,2299,1062
2016,7,10,23,1325,1245,2314,1069
2016,7,11,0,1315,1266,2369,1103
2016,7,11,1,1320,1248,2357,1109
2016,7,11,2,1305,1234,2361,1127
2016,7,11,3,1300,1223,2318,1095
2016,7,11,4,1250,1223,2333,1110
2016,7,11,5,1200,1175,2326,1151
2016,7,11,6,1115,1102,2334,1232
2016,7,11,7,1070,1057,2307,1250
2016,7,11,8,1035,1028,2242,1214
2016,7,11,9,1020,1014,2249,1235
2016,7,11,10,1010,1025,2263,1238
2016,7,11,11,1080,1046,2311,1265
2016,7,11,12,1090,1077,2327,1250
2016,7,11,13,1100,1152,2340,1188
2016,7,11,14,1160,1246,2615,1369
2016,7,11,15,1230,1297,2612,1315
2016,7,11,16,1255,1314,2606,1292
2016,7,11,17,1285,1339,2694,1355
2016,7,11,18,1305,1361,2733,1372
2016,7,11,19,1330,1333,2706,1373
2016,7,11,20,1340,1348,2776,1428
2016,7,11,21,1355,1335,2776,1441
2016,7,11,22,1385,1332,2785,1453
2016,7,11,23,1390,1317,2794,1477
2016,7,12,0,1385,1287,2789,1502
2016,7,12,1,1385,1293,2811,1518
2016,7,12,2,1370,1274,2820,1546
2016,7,12,3,1330,1243,2797,1554
2016,7,12,4,1310,1252,2794,1542
2016,7,12,5,1250,1192,2749,1557
2016,7,12,6,1150,1132,2718,1586
2016,7,12,7,1060,1071,2591,1520
2016,7,12,8,1035,1038,2530,1492
2016,7,12,9,1015,1008,2454,1446
2016,7,12,10,1000,999,2464,1465
2016,7,12,11,1010,1014,2475,1461
2016,7,12,12,1040,1047,2474,1427
2016,7,12,13,1130,1110,2562,1452
2016,7,12,14,1250,1189,2483,1294
2016,7,12,15,1280,1226,2614,1388
2016,7,12,16,1325,1262,2604,1342
2016,7,12,17,1335,1281,2635,1354
2016,7,12,18,1355,1216,2657,1441
2016,7,12,19,1350,1240,2689,1449
2016,7,12,20,1365,1259,2705,1446
2016,7,12,21,1385,1264,2683,1419
2016,7,12,22,1405,1260,2675,1415
2016,7,12,23,1405,1283,2673,1390
2016,7,13,0,1410,1241,2661,1420
2016,7,13,1,1400,1238,2625,1387
2016,7,13,2,1380,1288,2614,1326
2016,7,13,3,1360,1271,2560,1289
2016,7,13,4,1300,1253,2581,1328
2016,7,13,5,1285,1214,2577,1363
2016,7,13,6,1190,1127,2459,1332
2016,7,13,7,1105,1072,2465,1393
2016,7,13,8,1065,1031,2425,1394
2016,7,13,9,1040,1022,2417,1395
2016,7,13,10,1045,1002,2428,1426
2016,7,13,11,1055,1029,2458,1429
2016,7,13,12,1105,1066,2543,1477
2016,7,13,13,1190,1128,2562,1434
2016,7,13,14,1285,1207,2572,1365
2016,7,13,15,1325,1256,2678,1422
2016,7,13,16,1355,1219,2734,1515
2016,7,13,17,1380,1392,2779,1387
2016,7,13,18,1405,1337,2783,1446
2016,7,13,19,1400,1331,2795,1464
2016,7,13,20,1415,1356,2777,1421
2016,7,13,21,1420,1362,2792,1430
2016,7,13,22,1430,1367,2760,1393
2016,7,13,23,1420,1375,2756,1381
2016,7,14,0,1400,1370,2763,1393
2016,7,14,1,1350,1354,2737,1383
2016,7,14,2,1320,1350,2756,1406
2016,7,14,3,1350,1322,2714,1392
2016,7,14,4,1285,1307,2739,1432
2016,7,14,5,1260,1251,2711,1460
2016,7,14,6,1165,1139,2616,1477
2016,7,14,7,1040,1072,2598,1526
2016,7,14,8,995,1040,2568,1528
2016,7,14,9,990,1014,2560,1546
2016,7,14,10,985,1013,2570,1557
2016,7,14,11,1000,1020,2549,1529
2016,7,14,12,1035,1055,2574,1519
2016,7,14,13,1135,1110,2557,1447
2016,7,14,14,1225,1213,2644,1431
2016,7,14,15,1260,1265,2649,1384
2016,7,14,16,1280,1290,2664,1374
2016,7,14,17,1295,1319,2681,1362
2016,7,14,18,1320,1364,2720,1356
2016,7,14,19,1310,1380,2735,1355
2016,7,14,20,1305,1418,2746,1328
2016,7,14,21,1330,1436,2807,1371
2016,7,14,22,1340,1456,2792,1336
2016,7,14,23,1365,1478,2834,1356
2016,7,15,0,1340,1462,2854,1392
2016,7,15,1,1300,1446,2841,1395
2016,7,15,2,1285,1419,2833,1414
2016,7,15,3,1240,1379,2660,1281
2016,7,15,4,1210,1365,2765,1400
2016,7,15,5,1195,1299,2745,1446
2016,7,15,6,1110,1187,2658,1471
2016,7,15,7,1050,1113,2639,1526
2016,7,15,8,1010,1073,2643,1570
2016,7,15,9,1000,1061,2567,1506
2016,7,15,10,1000,1029,2507,1478
2016,7,15,11,1005,1050,2532,1482
2016,7,15,12,1040,1083,2704,1621
2016,7,15,13,1100,1142,2706,1564
2016,7,15,14,1190,1223,2674,1451
2016,7,15,15,1235,1274,2763,1489
2016,7,15,16,1235,1319,2762,1443
2016,7,15,17,1325,1340,2772,1432
2016,7,15,18,1315,1369,2805,1436
2016,7,15,19,1340,1388,2819,1431
2016,7,15,20,1370,1419,2791,1372
2016,7,15,21,1380,1461,2842,1381
2016,7,15,22,1390,1461,2853,1392
2016,7,15,23,1390,1483,2877,1394
2016,7,16,0,1380,1469,2908,1439
2016,7,16,1,1370,1445,2828,1383
2016,7,16,2,1345,1404,2746,1342
2016,7,16,3,1300,1349,2645,1296
2016,7,16,4,1280,1318,2774,1456
2016,7,16,5,1230,1248,2690,1442
2016,7,16,6,1120,1168,2690,1522
2016,7,16,7,1100,1104,2627,1523
2016,7,16,8,1060,1065,2666,1601
2016,7,16,9,1030,1025,2536,1511
2016,7,16,10,1030,1026,2450,1424
2016,7,16,11,1040,1013,2474,1461
2016,7,16,12,1020,1031,2557,1526
2016,7,16,13,1020,1042,2545,1503
2016,7,16,14,1050,1100,2513,1413
2016,7,16,15,1100,1170,2567,1397
2016,7,16,16,1145,1208,2646,1438
2016,7,16,17,1180,1237,2643,1406
2016,7,16,18,1210,1266,2679,1413
2016,7,16,19,1240,1267,2686,1419
2016,7,16,20,1270,1272,2685,1413
2016,7,16,21,1290,1288,2711,1423
2016,7,16,22,1315,1292,2744,1452
2016,7,16,23,1330,1303,2840,1537
2016,7,17,0,1320,1301,2836,1535
2016,7,17,1,1305,1294,2819,1525
2016,7,17,2,1280,1276,2816,1540
2016,7,17,3,1245,1256,2800,1544
2016,7,17,4,1210,1273,2882,1609
2016,7,17,5,1160,1235,2851,1616
2016,7,17,6,1070,1164,2779,1615
2016,7,17,7,1080,1099,2761,1662
2016,7,17,8,1070,1061,2743,1682
2016,7,17,9,1070,1042,2764,1722
2016,7,17,10,1040,1031,2745,1714
2016,7,17,11,1055,1028,2742,1714
2016,7,17,12,1060,1036,2749,1713
2016,7,17,13,1060,1048,2743,1695
2016,7,17,14,1100,1081,2704,1623
2016,7,17,15,1150,1153,2757,1604
2016,7,17,16,1200,1206,2775,1569
2016,7,17,17,1225,1224,2799,1575
2016,7,17,18,1240,1251,2793,1542
2016,7,17,19,1260,1282,2765,1483
2016,7,17,20,1275,1302,2675,1373
2016,7,17,21,1285,1336,2754,1418
2016,7,17,22,1300,1364,2761,1397
2016,7,17,23,1320,1399,2757,1358
2016,7,18,0,1320,1423,2716,1293
2016,7,18,1,1310,1414,2792,1378
2016,7,18,2,1285,1394,2810,1416
2016,7,18,3,1260,1358,2752,1394
2016,7,18,4,1220,1339,2726,1387
2016,7,18,5,1200,1294,2726,1432
2016,7,18,6,1105,1201,2742,1541
2016,7,18,7,1100,1169,2755,1586
2016,7,18,8,1080,1127,2760,1633
2016,7,18,9,1040,1118,2772,1654
2016,7,18,10,1040,1103,2742,1639
2016,7,18,11,1015,1101,2728,1627
2016,7,18,12,1055,1138,2755,1617
2016,7,18,13,1160,1196,2753,1557
2016,7,18,14,1290,1236,2698,1462
2016,7,18,15,1340,1301,2704,1403
2016,7,18,16,1380,1353,2719,1366
2016,7,18,17,1415,1405,2732,1327
2016,7,18,18,1445,1438,2786,1348
2016,7,18,19,1465,1471,2785,1314
2016,7,18,20,1485,1513,2796,1283
2016,7,18,21,1495,1567,2796,1229
2016,7,18,22,1500,1605,2798,1193
2016,7,18,23,1500,1650,2840,1190
2016,7,19,0,1500,1638,2806,1168
2016,7,19,1,1485,1629,2816,1187
2016,7,19,2,1460,1607,2857,1250
2016,7,19,3,1430,1593,2847,1254
2016,7,19,4,1360,1560,2810,1250
2016,7,19,5,1345,1419,2852,1433
2016,7,19,6,1240,1385,2874,1489
2016,7,19,7,1170,1305,2853,1548
2016,7,19,8,1120,1248,2597,1349
2016,7,19,9,1080,1208,2597,1389
2016,7,19,10,1060,1197,2583,1386
2016,7,19,11,1070,1201,2707,1506
2016,7,19,12,1100,1240,2822,1582
2016,7,19,13,1220,1272,2815,1543
2016,7,19,14,1400,1421,2738,1317
2016,7,19,15,1470,1480,2808,1328
2016,7,19,16,1520,1542,2818,1276
2016,7,19,17,1535,1500,2728,1228
2016,7,19,18,1540,1555,2786,1231
2016,7,19,19,1570,1599,2794,1195
2016,7,19,20,1595,1636,2792,1156
2016,7,19,21,1620,1683,2800,1117
2016,7,19,22,1635,1707,2794,1087
2016,7,19,23,1665,1702,2774,1072
2016,7,20,0,1670,1668,2790,1122
2016,7,20,1,1655,1646,2798,1152
2016,7,20,2,1650,1613,2803,1190
2016,7,20,3,1615,1549,2770,1221
2016,7,20,4,1400,1491,2744,1253
2016,7,20,5,1350,1409,2728,1319
2016,7,20,6,1290,1292,2797,1505
2016,7,20,7,1230,1212,2755,1543
2016,7,20,8,1200,1168,2716,1548
2016,7,20,9,1160,1073,2703,1630
2016,7,20,10,1170,1032,2707,1675
2016,7,20,11,1160,1070,2719,1649
2016,7,20,12,1200,1092,2731,1639
2016,7,20,13,1250,1152,2711,1559
2016,7,20,14,1390,1268,2735,1467
2016,7,20,15,1415,1282,2697,1415
2016,7,20,16,1435,1386,2731,1345
2016,7,20,17,1515,1437,2717,1280
2016,7,20,18,1515,1467,2718,1251
2016,7,20,19,1530,1507,2761,1254
2016,7,20,20,1560,1565,2774,1209
2016,7,20,21,1585,1617,2826,1209
2016,7,20,22,1615,1657,2853,1196
2016,7,20,23,1640,1682,2870,1188
2016,7,21,0,1635,1687,2908,1221
2016,7,21,1,1605,1679,2918,1239
2016,7,21,2,1580,1651,2921,1270
2016,7,21,3,1545,1601,2871,1270
2016,7,21,4,1530,1559,2839,1280
2016,7,21,5,1410,1459,2821,1362
2016,7,21,6,1330,1335,2908,1573
2016,7,21,7,1160,1250,2875,1625
2016,7,21,8,1130,1243,2861,1618
2016,7,21,9,1050,1156,2834,1678
2016,7,21,10,1020,1139,2806,1667
2016,7,21,11,1020,1148,2807,1659
2016,7,21,12,1080,1164,2791,1627
2016,7,21,13,1200,1229,2809,1580
2016,7,21,14,1355,1331,2812,1481
2016,7,21,15,1415,1397,2794,1397
2016,7,21,16,1460,907,2065,1158
2016,7,21,17,1465,1491,1368,-123
2016,7,21,18,1500,1539,1377,-162
2016,7,21,19,1530,1585,1402,-183
2016,7,21,20,1555,1626,1443,-183
2016,7,21,21,1590,1671,1444,-227
2016,7,21,22,1625,1704,1403,-301
2016,7,21,23,1630,1719,1383,-336
2016,7,22,0,1605,1719,1346,-373
2016,7,22,1,1590,1731,1400,-331
2016,7,22,2,1560,1690,1388,-302
2016,7,22,3,1515,1637,1384,-253
2016,7,22,4,1450,1566,1431,-135
2016,7,22,5,1370,1469,1455,-14
2016,7,22,6,1270,1320,1575,255
2016,7,22,7,1220,1237,1536,299
2016,7,22,8,1210,1202,1804,602
2016,7,22,9,1120,1180,1932,752
2016,7,22,10,1100,1160,1950,790
2016,7,22,11,1100,1151,1971,820
2016,7,22,12,1130,1175,1961,786
2016,7,22,13,1195,1227,1946,719
2016,7,22,14,1285,1317,1952,635
2016,7,22,15,1335,1374,1954,580
2016,7,22,16,1395,1438,1992,554
2016,7,22,17,1435,1480,2057,577
2016,7,22,18,1465,1513,2132,619
2016,7,22,19,1505,1537,2205,668
2016,7,22,20,1540,1588,2260,672
2016,7,22,21,1580,1602,2384,782
2016,7,22,22,1605,1619,2453,834
2016,7,22,23,1630,1655,2092,437
2016,7,23,0,1620,1640,2080,440
2016,7,23,1,1585,1613,2088,475
2016,7,23,2,1540,1552,2053,501
2016,7,23,3,1505,1512,1502,-10
2016,7,23,4,1450,1466,1440,-26
2016,7,23,5,1300,1396,1443,47
2016,7,23,6,1265,1295,1424,129
2016,7,23,7,1210,1222,1419,197
2016,7,23,8,1200,1163,1440,277
2016,7,23,9,1100,1130,1422,292
2016,7,23,10,1100,1118,1454,336
2016,7,23,11,1100,1103,1517,414
2016,7,23,12,1130,1107,1617,510
2016,7,23,13,1180,1126,1766,640
2016,7,23,14,1250,1183,1863,680
2016,7,23,15,1175,1277,1986,709
2016,7,23,16,1235,1311,2021,710
2016,7,23,17,1270,1322,1954,632
2016,7,23,18,1305,1347,1920,573
2016,7,23,19,1335,1370,1924,554
2016,7,23,20,1340,1381,1978,597
2016,7,23,21,1370,1406,2018,612
2016,7,23,22,1395,1436,2016,580
2016,7,23,23,1410,1476,2026,550
2016,7,24,0,1405,1484,2035,551
2016,7,24,1,1395,1475,2007,532
2016,7,24,2,1370,1443,2028,585
2016,7,24,3,1345,1401,2047,646
2016,7,24,4,1290,1379,2052,673
2016,7,24,5,1240,1322,2042,720
2016,7,24,6,1180,1218,2033,815
2016,7,24,7,1125,1133,2039,906
2016,7,24,8,1095,1083,2039,956
2016,7,24,9,1050,1064,2098,1034
2016,7,24,10,1035,1056,2147,1091
2016,7,24,11,1040,1048,2175,1127
2016,7,24,12,1055,1070,2015,945
2016,7,24,13,1045,1073,1939,866
2016,7,24,14,1075,1125,1907,782
2016,7,24,15,1130,1187,1898,711
2016,7,24,16,1190,1242,1894,652
2016,7,24,17,1220,1281,1971,690
2016,7,24,18,1245,1303,1790,487
2016,7,24,19,1280,1351,1973,622
2016,7,24,20,1300,1391,2039,648
2016,7,24,21,1325,1418,2074,656
2016,7,24,22,1360,1431,2213,782
2016,7,24,23,1385,1493,2380,887
2016,7,25,0,1400,1533,2527,994
2016,7,25,1,1385,1548,2543,995
2016,7,25,2,1365,1539,2610,1071
2016,7,25,3,1340,1508,2661,1153
2016,7,25,4,1075,1491,2691,1200
2016,7,25,5,1245,1387,2684,1297
2016,7,25,6,1150,1278,2684,1406
2016,7,25,7,1230,1194,2637,1443
2016,7,25,8,1200,1138,2647,1509
2016,7,25,9,1150,1115,2648,1533
2016,7,25,10,1170,1092,2635,1543
2016,7,25,11,1160,1108,2634,1526
2016,7,25,12,1200,1129,2579,1450
2016,7,25,13,1250,1202,2637,1435
2016,7,25,14,1290,1305,2713,1408
2016,7,25,15,1350,1371,2707,1336
2016,7,25,16,1415,1424,2701,1277
2016,7,25,17,1450,1483,2671,1188
2016,7,25,18,1485,1523,2582,1059
2016,7,25,19,1525,1570,2449,879
2016,7,25,20,1555,1622,2460,838
2016,7,25,21,1590,1683,2520,837
2016,7,25,22,1630,1719,2524,805
2016,7,25,23,1650,1765,2577,812
2016,7,26,0,1640,1760,2582,822
2016,7,26,1,1620,1747,2567,820
2016,7,26,2,1600,1693,2522,829
2016,7,26,3,1530,1641,2488,847
2016,7,26,4,1460,1601,2465,864
2016,7,26,5,1410,1497,2455,958
2016,7,26,6,1300,1337,2415,1078
2016,7,26,7,1240,1272,2451,1179
2016,7,26,8,1200,1186,2397,1211
2016,7,26,9,1160,1151,2333,1182
2016,7,26,10,1170,1120,2217,1097
2016,7,26,11,1160,1129,2131,1002
2016,7,26,12,1200,1139,2189,1050
2016,7,26,13,1255,1204,2159,955
2016,7,26,14,1380,1289,2169,880
2016,7,26,15,1450,1355,2192,837
2016,7,26,16,1480,1427,2357,930
2016,7,26,17,1475,1492,2396,904
2016,7,26,18,1505,1548,2398,850
2016,7,26,19,1535,1590,2458,868
2016,7,26,20,1560,1634,2458,824
2016,7,26,21,1595,1673,2449,776
2016,7,26,22,1615,1693,2439,746
2016,7,26,23,1655,1732,2424,692
2016,7,27,0,1645,1669,2532,863
2016,7,27,1,1630,1630,2534,904
2016,7,27,2,1620,1571,2481,910
2016,7,27,3,1575,1499,2409,910
2016,7,27,4,1470,1473,2431,958
2016,7,27,5,1375,1373,2464,1091
2016,7,27,6,1325,1253,2458,1205
2016,7,27,7,1200,1186,2405,1219
2016,7,27,8,1130,1156,2407,1251
2016,7,27,9,1130,1118,2389,1271
2016,7,27,10,1070,1096,2389,1293
2016,7,27,11,1080,1099,2382,1283
2016,7,27,12,1100,1126,2386,1260
2016,7,27,13,1200,1192,2377,1185
2016,7,27,14,1330,1270,2367,1097
2016,7,27,15,1390,1338,2364,1026
2016,7,27,16,1425,1396,2367,971
2016,7,27,17,1500,1430,2374,944
2016,7,27,18,1520,1484,2415,931
2016,7,27,19,1565,1539,2453,914
2016,7,27,20,1600,1574,2472,898
2016,7,27,21,1645,1603,2537,934
2016,7,27,22,1685,1643,2568,925
2016,7,27,23,1705,1650,2566,916
2016,7,28,0,1705,1639,2550,911
2016,7,28,1,1680,1605,2562,957
2016,7,28,2,1640,1573,2541,968
2016,7,28,3,1600,1540,2533,993
2016,7,28,4,1550,1499,2489,990
2016,7,28,5,1475,1411,2433,1022
2016,7,28,6,1300,1308,2427,1119
2016,7,28,7,1215,1216,2397,1181
2016,7,28,8,1155,1190,2423,1233
2016,7,28,9,1125,1152,2457,1305
2016,7,28,10,1100,1125,2404,1279
2016,7,28,11,1080,1133,2398,1265
2016,7,28,12,1120,1163,2398,1235
2016,7,28,13,1200,1211,2389,1178
2016,7,28,14,1325,1312,2366,1054
2016,7,28,15,1385,1372,2363,991
2016,7,28,16,1450,1434,2401,967
2016,7,28,17,1490,1458,2426,968
2016,7,28,18,1530,1485,2421,936
2016,7,28,19,1575,1516,2420,904
2016,7,28,20,1605,1555,2434,879
2016,7,28,21,1655,1586,2425,839
2016,7,28,22,1680,1617,2422,805
2016,7,28,23,1700,1647,2525,878
2016,7,29,0,1670,1637,2532,895
2016,7,29,1,1640,1604,2522,918
2016,7,29,2,1600,1581,2535,954
2016,7,29,3,1545,1528,2518,990
2016,7,29,4,1445,1484,2524,1040
2016,7,29,5,1420,1379,2522,1143
2016,7,29,6,1290,1274,2537,1263
2016,7,29,7,1200,1202,2536,1334
2016,7,29,8,1135,1170,2469,1299
2016,7,29,9,1120,1129,2374,1245
2016,7,29,10,1100,1114,2382,1268
2016,7,29,11,1100,1124,2380,1256
2016,7,29,12,1130,1145,2402,1257
2016,7,29,13,1195,1203,2391,1188
2016,7,29,14,1290,1272,2345,1073
2016,7,29,15,1340,1353,2431,1078
2016,7,29,16,1390,1411,2555,1144
2016,7,29,17,1430,1463,2665,1202
2016,7,29,18,1465,1495,2622,1127
2016,7,29,19,1495,1544,2506,962
2016,7,29,20,1535,1589,2522,933
2016,7,29,21,1580,1615,2572,957
2016,7,29,22,1585,1644,2564,920
2016,7,29,23,1610,1659,2499,840
2016,7,30,0,1580,1651,2498,847
2016,7,30,1,1550,1621,2511,890
2016,7,30,2,1500,1581,2503,922
2016,7,30,3,1450,1540,2471,931
2016,7,30,4,1290,1494,2458,964
2016,7,30,5,1340,1422,2455,1033
2016,7,30,6,1220,1309,2471,1162
2016,7,30,7,1200,1231,2445,1214
2016,7,30,8,1160,1162,2402,1240
2016,7,30,9,1135,1131,2392,1261
2016,7,30,10,1115,1093,2368,1275
2016,7,30,11,1110,1096,2364,1268
2016,7,30,12,1135,1095,2362,1267
2016,7,30,13,1175,1105,2353,1248
2016,7,30,14,1255,1153,2259,1106
2016,7,30,15,1330,1217,2294,1077
2016,7,30,16,1375,1311,2357,1046
2016,7,30,17,1395,1370,2384,1014
2016,7,30,18,1425,1419,2384,965
2016,7,30,19,1455,1465,2385,920
2016,7,30,20,1480,1511,2388,877
2016,7,30,21,1510,1553,2465,912
2016,7,30,22,1540,1578,2465,887
2016,7,30,23,1560,1616,2447,831
2016,7,31,0,1555,1626,2388,762
2016,7,31,1,1535,1614,2350,736
2016,7,31,2,1510,1576,2348,772
2016,7,31,3,1465,1526,2337,811
2016,7,31,4,1390,1489,2326,837
2016,7,31,5,1350,1402,2312,910
2016,7,31,6,1240,1315,2387,1072
2016,7,31,7,1120,1229,2392,1163
2016,7,31,8,1100,1178,2405,1227
2016,7,31,9,1085,1135,2409,1274
2016,7,31,10,1065,1098,2210,1112
2016,7,31,11,1065,1085,2311,1226
2016,7,31,12,1100,1092,2471,1379
2016,7,31,13,1130,1070,2427,1357
2016,7,31,14,1205,1116,2403,1287
2016,7,31,15,1260,1193,2426,1233
2016,7,31,16,1320,1266,2353,1087
2016,7,31,17,1350,1328,2342,1014
2016,7,31,18,1385,1377,2356,979
2016,7,31,19,1415,1430,2414,984
2016,7,31,20,1445,1471,2540,1069
2016,7,31,21,1475,1500,2534,1034
2016,7,31,22,1505,1536,2492,956
2016,7,31,23,1545,1567,2509,942
2016,8,1,0,1545,1589,2528,939
2016,8,1,1,1530,1578,2577,999
2016,8,1,2,1515,1524,2527,1003
2016,8,1,3,1480,1475,2475,1000
2016,8,1,4,1400,1452,2450,998
2016,8,1,5,1355,1353,2419,1066
2016,8,1,6,1245,1234,2386,1152
2016,8,1,7,1175,1156,2384,1228
2016,8,1,8,1130,1118,2342,1224
2016,8,1,9,1105,1079,2341,1262
2016,8,1,10,1070,1072,2362,1290
2016,8,1,11,1085,1071,2375,1304
2016,8,1,12,1120,1118,2384,1266
2016,8,1,13,1200,1199,2373,1174
2016,8,1,14,1305,1284,2350,1066
2016,8,1,15,1370,1357,2385,1028
2016,8,1,16,1410,1411,2398,987
2016,8,1,17,1460,1465,2416,951
2016,8,1,18,1505,1488,2407,919
2016,8,1,19,1540,1526,2441,915
2016,8,1,20,1585,1551,2522,971
2016,8,1,21,1645,1582,2513,931
2016,8,1,22,1690,1612,2508,896
2016,8,1,23,1715,1635,2505,870
2016,8,2,0,1710,1630,2497,867
2016,8,2,1,1690,1635,2535,900
2016,8,2,2,1635,1585,2522,937
2016,8,2,3,1590,1542,2508,966
2016,8,2,4,1550,1494,2496,1002
2016,8,2,5,1450,1396,2447,1051
2016,8,2,6,1305,1270,2510,1240
2016,8,2,7,1220,1191,2491,1300
2016,8,2,8,1130,1149,2386,1237
2016,8,2,9,1130,1139,2398,1259
2016,8,2,10,1090,1111,2405,1294
2016,8,2,11,1080,1111,2419,1308
2016,8,2,12,1110,1138,2481,1343
2016,8,2,13,1190,1206,2610,1404
2016,8,2,14,1315,1291,2612,1321
2016,8,2,15,1390,1387,2409,1022
2016,8,2,16,1455,1410,1943,533
2016,8,2,17,1475,1460,1934,474
2016,8,2,18,1525,1490,1975,485
2016,8,2,19,1570,1532,1991,459
2016,8,2,20,1615,1589,2004,415
2016,8,2,21,1660,1664,2085,421
2016,8,2,22,1680,1713,2215,502
2016,8,2,23,1700,1766,2485,719
2016,8,3,0,1670,1794,2676,882
2016,8,3,1,1640,1779,2764,985
2016,8,3,2,1560,1736,2786,1050
2016,8,3,3,1480,1674,2789,1115
2016,8,3,4,1450,1641,2819,1178
2016,8,3,5,1370,1517,2815,1298
2016,8,3,6,1245,1413,2764,1351
2016,8,3,7,1115,1271,2742,1471
2016,8,3,8,1090,1234,2708,1474
2016,8,3,9,1045,1203,2704,1501
2016,8,3,10,1010,1168,2675,1507
2016,8,3,11,1020,1167,2650,1483
2016,8,3,12,1070,1194,2719,1525
2016,8,3,13,1150,1264,2800,1536
2016,8,3,14,1210,1332,2756,1424
2016,8,3,15,1265,1358,2649,1291
2016,8,3,16,1280,1412,2716,1304
2016,8,3,17,1355,1458,2744,1286
2016,8,3,18,1405,1488,2815,1327
2016,8,3,19,1435,1516,2853,1337
2016,8,3,20,1465,1521,2869,1348
2016,8,3,21,1500,1546,2888,1342
2016,8,3,22,1510,1568,2898,1330
2016,8,3,23,1525,1553,2891,1338
2016,8,4,0,1515,1544,2903,1359
2016,8,4,1,1485,1523,2888,1365
2016,8,4,2,1450,1488,2856,1368
2016,8,4,3,1420,1442,2856,1414
2016,8,4,4,1365,1427,2862,1435
2016,8,4,5,1295,1321,2834,1513
2016,8,4,6,1230,1215,2780,1565
2016,8,4,7,1100,1151,2728,1577
2016,8,4,8,1070,1106,2679,1573
2016,8,4,9,1050,1090,2657,1567
2016,8,4,10,1020,1087,2670,1583
2016,8,4,11,1025,1091,2667,1576
2016,8,4,12,1055,1126,2669,1543
2016,8,4,13,1100,1183,2663,1480
2016,8,4,14,1175,1252,2612,1360
2016,8,4,15,1235,1313,2639,1326
2016,8,4,16,1280,1339,2645,1306
2016,8,4,17,1310,1367,2627,1260
2016,8,4,18,1340,1407,2676,1269
2016,8,4,19,1375,1416,2682,1266
2016,8,4,20,1410,1448,2666,1218
2016,8,4,21,1455,1483,2668,1185
2016,8,4,22,1490,1490,2705,1215
2016,8,4,23,1500,1519,2711,1192
2016,8,5,0,1500,1524,2700,1176
2016,8,5,1,1485,1524,2693,1169
2016,8,5,2,1465,1492,2690,1198
2016,8,5,3,1415,1458,2682,1224
2016,8,5,4,1350,1446,2706,1260
2016,8,5,5,1280,1329,2426,1097
2016,8,5,6,1165,1253,2212,959
2016,8,5,7,1080,1180,2077,897
2016,8,5,8,1040,1138,2010,872
2016,8,5,9,1080,1121,1988,867
2016,8,5,10,1045,1100,1977,877
2016,8,5,11,1070,1096,1960,864
2016,8,5,12,1100,1123,1964,841
2016,8,5,13,1160,1158,1950,792
2016,8,5,14,1275,1245,1901,656
2016,8,5,15,1325,1280,1933,653
2016,8,5,16,1365,1321,1940,619
2016,8,5,17,1415,1356,1943,587
2016,8,5,18,1445,1406,1958,552
2016,8,5,19,1480,1442,1979,537
2016,8,5,20,1515,1481,2011,530
2016,8,5,21,1545,1522,2015,493
2016,8,5,22,1565,1550,2042,492
2016,8,5,23,1580,1563,2037,474
2016,8,6,0,1560,1549,1973,424
2016,8,6,1,1530,1518,1965,447
2016,8,6,2,1480,1496,1960,464
2016,8,6,3,1455,1462,1984,522
2016,8,6,4,1400,1456,2041,585
2016,8,6,5,1345,1379,2044,665
2016,8,6,6,1220,1263,2038,775
2016,8,6,7,1135,1187,2000,813
2016,8,6,8,1090,1151,1818,667
2016,8,6,9,1050,1128,1771,643
2016,8,6,10,1035,1104,1766,662
2016,8,6,11,1035,1081,1746,665
2016,8,6,12,1040,1091,1943,852
2016,8,6,13,1085,1106,1946,840
2016,8,6,14,1175,1138,1892,754
2016,8,6,15,1240,1209,1896,687
2016,8,6,16,1300,1253,1904,651
2016,8,6,17,1335,1288,1931,643
2016,8,6,18,1380,1332,1934,602
2016,8,6,19,1420,1353,1929,576
2016,8,6,20,1455,1384,1978,594
2016,8,6,21,1495,1418,1972,554
2016,8,6,22,1525,1442,1982,540
2016,8,6,23,1555,1426,1970,544
2016,8,7,0,1550,1422,1962,540
2016,8,7,1,1550,1412,1968,556
2016,8,7,2,1500,1383,1993,610
2016,8,7,3,1500,1349,1927,578
2016,8,7,4,1420,1310,1941,631
2016,8,7,5,1340,1256,1922,666
2016,8,7,6,1265,1177,1922,745
2016,8,7,7,1170,1113,1864,751
2016,8,7,8,1105,1080,1705,625
2016,8,7,9,1090,1060,1711,651
2016,8,7,10,1040,1053,1718,665
2016,8,7,11,1050,1048,1700,652
2016,8,7,12,1075,1061,1715,654
2016,8,7,13,1080,1031,1785,754
2016,8,7,14,1130,1083,1830,747
2016,8,7,15,1200,1149,1893,744
2016,8,7,16,1260,1194,2129,935
2016,8,7,17,1305,1288,2182,894
2016,8,7,18,1345,1194,2243,1049
2016,8,7,19,1380,1276,2322,1046
2016,8,7,20,1410,1298,2376,1078
2016,8,7,21,1435,1307,2324,1017
2016,8,7,22,1460,1319,2267,948
2016,8,7,23,1515,1326,2323,997
2016,8,8,0,1530,1331,2456,1125
2016,8,8,1,1515,1322,2480,1158
2016,8,8,2,1475,1310,2479,1169
2016,8,8,3,1400,1297,2497,1200
2016,8,8,4,1390,1310,2555,1245
2016,8,8,5,1300,1220,2501,1281
2016,8,8,6,1200,1122,2470,1348
2016,8,8,7,1125,1068,2396,1328
2016,8,8,8,1090,1033,2408,1375
2016,8,8,9,1060,1016,2381,1365
2016,8,8,10,1030,1013,2322,1309
2016,8,8,11,1020,1027,2357,1330
2016,8,8,12,1090,1078,2465,1387
2016,8,8,13,1170,1145,2523,1378
2016,8,8,14,1275,1216,2503,1287
2016,8,8,15,1345,1275,2459,1184
2016,8,8,16,1390,1333,2501,1168
2016,8,8,17,1440,1369,2481,1112
2016,8,8,18,1480,1395,2472,1077
2016,8,8,19,1505,1423,2516,1093
2016,8,8,20,1530,1451,2512,1061
2016,8,8,21,1565,1478,2501,1023
2016,8,8,22,1600,1511,2530,1019
2016,8,8,23,1630,1527,2538,1011
2016,8,9,0,1625,1517,2502,985
2016,8,9,1,1610,1506,2540,1034
2016,8,9,2,1550,1459,2574,1115
2016,8,9,3,1520,1436,2520,1084
2016,8,9,4,1460,1393,2543,1150
2016,8,9,5,1360,1302,2539,1237
2016,8,9,6,1255,1212,2476,1264
2016,8,9,7,1100,1136,2364,1228
2016,8,9,8,1060,1095,2464,1369
2016,8,9,9,1050,1068,2538,1470
2016,8,9,10,1035,1057,2589,1532
2016,8,9,11,1070,1068,2578,1510
2016,8,9,12,1090,1084,2565,1481
2016,8,9,13,1150,1162,2622,1460
2016,8,9,14,1230,1225,2604,1379
2016,8,9,15,1280,1293,2596,1303
2016,8,9,16,1320,1336,2601,1265
2016,8,9,17,1390,1352,2641,1289
2016,8,9,18,1360,1390,2709,1319
2016,8,9,19,1425,1429,2744,1315
2016,8,9,20,1460,1459,2692,1233
2016,8,9,21,1505,1482,2668,1186
2016,8,9,22,1530,1490,2682,1192
2016,8,9,23,1540,1492,2690,1198
2016,8,10,0,1525,1470,2700,1230
2016,8,10,1,1510,1435,2663,1228
2016,8,10,2,1450,1397,2628,1231
2016,8,10,3,1420,1389,2611,1222
2016,8,10,4,1400,1376,2732,1356
2016,8,10,5,1300,1284,2697,1413
2016,8,10,6,1200,1181,2742,1561
2016,8,10,7,1090,1127,2753,1626
2016,8,10,8,1040,1091,2769,1678
2016,8,10,9,1040,1070,2699,1629
2016,8,10,10,1030,1044,2626,1582
2016,8,10,11,1025,1073,2678,1605
2016,8,10,12,1050,1104,2730,1626
2016,8,10,13,1160,1162,2683,1521
2016,8,10,14,1220,1233,2660,1427
2016,8,10,15,1280,1280,2703,1423
2016,8,10,16,1325,1330,2779,1449
2016,8,10,17,1375,1351,2803,1452
2016,8,10,18,1415,1375,2821,1446
2016,8,10,19,1440,1391,2862,1471
2016,8,10,20,1450,1408,2863,1455
2016,8,10,21,1475,1421,2854,1433
2016,8,10,22,1500,1438,2868,1430
2016,8,10,23,1495,1468,2899,1431
2016,8,11,0,1495,1456,2907,1451
2016,8,11,1,1465,1443,2899,1456
2016,8,11,2,1420,1406,2851,1445
2016,8,11,3,1390,1402,2748,1346
2016,8,11,4,1360,1382,2725,1343
2016,8,11,5,1275,1298,2703,1405
2016,8,11,6,1170,1187,2710,1523
2016,8,11,7,1080,1141,2716,1575
2016,8,11,8,1035,1094,2675,1581
2016,8,11,9,1010,1073,2653,1580
2016,8,11,10,1000,1061,2623,1562
2016,8,11,11,1020,1077,2615,1538
2016,8,11,12,1065,1093,2606,1513
2016,8,11,13,1140,1155,2649,1494
2016,8,11,14,1215,1242,2647,1405
2016,8,11,15,1275,1295,2647,1352
2016,8,11,16,1305,1330,2619,1289
2016,8,11,17,1335,1351,2708,1357
2016,8,11,18,1375,1374,2727,1353
2016,8,11,19,1390,1386,2720,1334
2016,8,11,20,1420,1425,2738,1313
2016,8,11,21,1425,1434,2745,1311
2016,8,11,22,1430,1459,2757,1298
2016,8,11,23,1460,1492,2801,1309
2016,8,12,0,1460,1475,2761,1286
2016,8,12,1,1410,1458,2743,1285
2016,8,12,2,1370,1410,2715,1305
2016,8,12,3,1365,1397,2705,1308
2016,8,12,4,1360,1408,2712,1304
2016,8,12,5,1250,1310,2730,1420
2016,8,12,6,1130,1206,2716,1510
2016,8,12,7,1090,1138,2700,1562
2016,8,12,8,1045,1100,2643,1543
2016,8,12,9,1025,1077,2635,1558
2016,8,12,10,1000,1072,2644,1572
2016,8,12,11,1025,1076,2633,1557
2016,8,12,12,1045,1110,2662,1552
2016,8,12,13,1110,1168,2651,1483
2016,8,12,14,1185,1233,2663,1430
2016,8,12,15,1235,1295,2658,1363
2016,8,12,16,1275,1333,2667,1334
2016,8,12,17,1310,1383,2622,1239
2016,8,12,18,1340,1403,2586,1183
2016,8,12,19,1365,1409,2724,1315
2016,8,12,20,1385,1471,2763,1292
2016,8,12,21,1410,1477,2770,1293
2016,8,12,22,1435,1485,2757,1272
2016,8,12,23,1440,1483,2756,1273
2016,8,13,0,1440,1466,2732,1266
2016,8,13,1,1415,1425,2746,1321
2016,8,13,2,1380,1408,2769,1361
2016,8,13,3,1365,1372,2699,1327
2016,8,13,4,1335,1364,2727,1363
2016,8,13,5,1280,1290,2678,1388
2016,8,13,6,1150,1194,2675,1481
2016,8,13,7,1090,1135,2663,1528
2016,8,13,8,1050,1111,2633,1522
2016,8,13,9,1030,1078,2611,1533
2016,8,13,10,1030,1077,2636,1559
2016,8,13,11,1030,1058,2624,1566
2016,8,13,12,1060,1081,2638,1557
2016,8,13,13,1080,1089,2617,1528
2016,8,13,14,1135,1144,2597,1453
2016,8,13,15,1205,1200,2617,1417
2016,8,13,16,1240,1266,2652,1386
2016,8,13,17,1270,1300,2650,1350
2016,8,13,18,1295,1358,2673,1315
2016,8,13,19,1315,1377,2702,1325
2016,8,13,20,1350,1407,2702,1295
2016,8,13,21,1370,1421,2689,1268
2016,8,13,22,1395,1449,2672,1223
2016,8,13,23,1420,1468,2682,1214
2016,8,14,0,1415,1489,2695,1206
2016,8,14,1,1360,1485,2707,1222
2016,8,14,2,1330,1444,2706,1262
2016,8,14,3,1315,1421,2685,1264
2016,8,14,4,1315,1407,2732,1325
2016,8,14,5,1235,1317,2739,1422
2016,8,14,6,1140,1212,2711,1499
2016,8,14,7,1145,1134,2630,1496
2016,8,14,8,1090,1106,2590,1484
2016,8,14,9,1055,1057,2553,1496
2016,8,14,10,1025,1058,2516,1458
2016,8,14,11,1045,1038,2513,1475
2016,8,14,12,1065,1067,2520,1453
2016,8,14,13,1090,1060,2523,1463
2016,8,14,14,1175,1092,2502,1410
2016,8,14,15,1255,1151,2507,1356
2016,8,14,16,1305,1214,2570,1356
2016,8,14,17,1360,1256,2610,1354
2016,8,14,18,1340,1305,2626,1321
2016,8,14,19,1395,1356,2630,1274
2016,8,14,20,1425,1402,2657,1255
2016,8,14,21,1440,1420,2668,1248
2016,8,14,22,1470,1448,2702,1254
2016,8,14,23,1500,1488,2705,1217
2016,8,15,0,1475,1522,2679,1157
2016,8,15,1,1450,1525,2664,1139
2016,8,15,2,1425,1513,2246,733
2016,8,15,3,1410,1460,2034,574
2016,8,15,4,1400,1421,2115,694
2016,8,15,5,1315,1306,2010,704
2016,8,15,6,1195,1209,1912,703
2016,8,15,7,1135,1124,1927,803
2016,8,15,8,1100,1100,1966,866
2016,8,15,9,1070,1075,1942,867
2016,8,15,10,1025,1058,1922,864
2016,8,15,11,1030,1069,1909,840
2016,8,15,12,1100,1097,1912,815
2016,8,15,13,1185,1187,1923,736
2016,8,15,14,1280,1260,1891,631
2016,8,15,15,1355,1326,1878,552
2016,8,15,16,1415,1376,1917,541
2016,8,15,17,1450,1400,1965,565
2016,8,15,18,1475,1407,2026,619
2016,8,15,19,1510,1467,2147,680
2016,8,15,20,1535,1538,2170,632
2016,8,15,21,1565,1574,2172,598
2016,8,15,22,1595,1598,2205,607
2016,8,15,23,1620,1623,2196,573
2016,8,16,0,1615,1614,2227,613
2016,8,16,1,1600,1599,2233,634
2016,8,16,2,1550,1545,2289,744
2016,8,16,3,1515,1502,2459,957
2016,8,16,4,1485,1445,2512,1067
2016,8,16,5,1380,1345,2621,1276
2016,8,16,6,1255,1234,2638,1404
2016,8,16,7,1140,1166,2587,1421
2016,8,16,8,1090,1115,2583,1468
2016,8,16,9,1095,1086,2562,1476
2016,8,16,10,1075,1069,2566,1497
2016,8,16,11,1080,1083,2570,1487
2016,8,16,12,1100,1107,2577,1470
2016,8,16,13,1190,1161,2595,1434
2016,8,16,14,1290,1244,2613,1369
2016,8,16,15,1370,1307,2604,1297
2016,8,16,16,1395,1357,2607,1250
2016,8,16,17,1445,1409,2656,1247
2016,8,16,18,1490,1454,2648,1194
2016,8,16,19,1535,1500,2628,1128
2016,8,16,20,1575,1559,2636,1077
2016,8,16,21,1615,1615,2644,1029
2016,8,16,22,1645,1651,2630,979
2016,8,16,23,1670,1667,2640,973
2016,8,17,0,1700,1648,2666,1018
2016,8,17,1,1700,1632,2694,1062
2016,8,17,2,1690,1612,2716,1104
2016,8,17,3,1640,1568,2748,1180
2016,8,17,4,1570,1516,2737,1221
2016,8,17,5,1450,1391,2675,1284
2016,8,17,6,1340,1263,2640,1377
2016,8,17,7,1130,1176,2590,1414
2016,8,17,8,1065,1133,2585,1452
2016,8,17,9,1060,1090,2540,1450
2016,8,17,10,1040,1075,2520,1445
2016,8,17,11,1055,1106,2500,1394
2016,8,17,12,1090,1158,2524,1366
2016,8,17,13,1180,1234,2578,1344
2016,8,17,14,1300,1277,2590,1313
2016,8,17,15,1375,1325,2608,1283
2016,8,17,16,1425,1359,2628,1269
2016,8,17,17,1485,1410,2672,1262
2016,8,17,18,1525,1461,2740,1279
2016,8,17,19,1550,1498,2754,1256
2016,8,17,20,1560,1558,2769,1211
2016,8,17,21,1580,1609,2803,1194
2016,8,17,22,1600,1649,2773,1124
2016,8,17,23,1620,1672,2761,1089
2016,8,18,0,1620,1655,2785,1130
2016,8,18,1,1600,1623,2776,1153
2016,8,18,2,1565,1587,2752,1165
2016,8,18,3,1530,1571,2758,1187
2016,8,18,4,1510,1524,2805,1281
2016,8,18,5,1410,1417,2754,1337
2016,8,18,6,1240,1289,2745,1456
2016,8,18,7,1120,1204,2701,1497
2016,8,18,8,1080,1154,2657,1503
2016,8,18,9,1050,1129,2699,1570
2016,8,18,10,1030,1104,2680,1576
2016,8,18,11,1050,1121,2780,1659
2016,8,18,12,1075,1146,2796,1650
2016,8,18,13,1120,1221,2753,1532
2016,8,18,14,1195,1277,2734,1457
2016,8,18,15,1250,1314,2706,1392
2016,8,18,16,1275,1340,2683,1343
2016,8,18,17,1295,1349,2747,1398
2016,8,18,18,1310,1369,2719,1350
2016,8,18,19,1325,1361,2729,1368
2016,8,18,20,1365,1376,2732,1356
2016,8,18,21,1375,1392,2659,1267
2016,8,18,22,1400,1405,2656,1251
2016,8,18,23,1445,1439,2700,1261
2016,8,19,0,1420,1411,2762,1351
2016,8,19,1,1415,1349,2685,1336
2016,8,19,2,1355,1284,2161,877
2016,8,19,3,1335,1286,2158,872
2016,8,19,4,1310,1282,2348,1066
2016,8,19,5,1250,1213,2516,1303
2016,8,19,6,1140,1151,2622,1471
2016,8,19,7,1090,1090,2580,1490
2016,8,19,8,1040,1075,2618,1543
2016,8,19,9,1010,1035,2583,1548
2016,8,19,10,1000,1028,2568,1540
2016,8,19,11,1010,1034,2377,1343
2016,8,19,12,1040,1056,2537,1481
2016,8,19,13,1100,1121,2674,1553
2016,8,19,14,1210,1181,2654,1473
2016,8,19,15,1200,1220,2662,1442
2016,8,19,16,1240,1240,2676,1436
2016,8,19,17,1240,1263,2747,1484
2016,8,19,18,1260,1262,2737,1475
2016,8,19,19,1240,1265,2781,1516
2016,8,19,20,1250,1279,2778,1499
2016,8,19,21,1240,1271,2762,1491
2016,8,19,22,1285,1287,2767,1480
2016,8,19,23,1290,1279,2742,1463
2016,8,20,0,1270,1269,2698,1429
2016,8,20,1,1270,1251,2692,1441
2016,8,20,2,1240,1236,2627,1391
2016,8,20,3,1225,1227,2655,1428
2016,8,20,4,1200,1233,2673,1440
2016,8,20,5,1150,1171,2664,1493
2016,8,20,6,1070,1105,2686,1581
2016,8,20,7,1040,1046,2671,1625
2016,8,20,8,1000,1021,2657,1636
2016,8,20,9,990,1001,2638,1637
2016,8,20,10,990,996,2634,1638
2016,8,20,11,1010,995,2621,1626
2016,8,20,12,1030,1011,2645,1634
2016,8,20,13,1070,1027,2597,1570
2016,8,20,14,1160,1065,2514,1449
2016,8,20,15,1215,1126,2660,1534
2016,8,20,16,1255,1163,2654,1491
2016,8,20,17,1275,1176,2653,1477
2016,8,20,18,1305,1186,2653,1467
2016,8,20,19,1325,1190,2653,1463
2016,8,20,20,1340,1205,2663,1458
2016,8,20,21,1350,1226,2670,1444
2016,8,20,22,1360,1246,2681,1435
2016,8,20,23,1380,1285,2680,1395
2016,8,21,0,1375,1303,2704,1401
2016,8,21,1,1350,1306,2655,1349
2016,8,21,2,1315,1288,2644,1356
2016,8,21,3,1310,1262,2662,1400
2016,8,21,4,1280,1264,2678,1414
2016,8,21,5,1210,1184,2689,1505
2016,8,21,6,1125,1115,2692,1577
2016,8,21,7,1090,1050,2645,1595
2016,8,21,8,1060,1004,2387,1383
2016,8,21,9,1020,988,2356,1368
2016,8,21,10,1030,983,2356,1373
2016,8,21,11,1000,982,2368,1386
2016,8,21,12,1035,997,2528,1531
2016,8,21,13,1030,1010,2509,1499
2016,8,21,14,1070,1050,2392,1342
2016,8,21,15,1140,1099,2490,1391
2016,8,21,16,1190,1150,2493,1343
2016,8,21,17,1250,1180,2544,1364
2016,8,21,18,1290,1214,2588,1374
2016,8,21,19,1340,1246,2614,1368
2016,8,21,20,1370,1296,2626,1330
2016,8,21,21,1390,1332,2619,1287
2016,8,21,22,1415,1388,2629,1241
2016,8,21,23,1460,1427,2636,1209
2016,8,22,0,1460,1463,2629,1166
2016,8,22,1,1450,1466,2599,1133
2016,8,22,2,1475,1434,2592,1158
2016,8,22,3,1410,1410,2574,1164
2016,8,22,4,1380,1376,2568,1192
2016,8,22,5,1260,1252,2492,1240
2016,8,22,6,1185,1147,2478,1331
2016,8,22,7,1105,1095,2465,1370
2016,8,22,8,1065,1052,2386,1334
2016,8,22,9,1060,1023,2315,1292
2016,8,22,10,1050,1010,2290,1280
2016,8,22,11,1055,1023,2294,1271
2016,8,22,12,1085,1068,2375,1307
2016,8,22,13,1180,1142,2489,1347
2016,8,22,14,1270,1209,2490,1281
2016,8,22,15,1330,1260,2535,1275
2016,8,22,16,1360,1303,2618,1315
2016,8,22,17,1410,1352,2691,1339
2016,8,22,18,1415,1384,2674,1290
2016,8,22,19,1445,1424,2673,1249
2016,8,22,20,1510,1452,2681,1229
2016,8,22,21,1525,1479,2686,1207
2016,8,22,22,1570,1495,2701,1206
2016,8,22,23,1590,1514,2718,1204
2016,8,23,0,1575,1500,2680,1180
2016,8,23,1,1560,1472,2736,1264
2016,8,23,2,1510,1430,2740,1310
2016,8,23,3,1475,1420,2740,1320
2016,8,23,4,1420,1381,2717,1336
2016,8,23,5,1310,1289,2723,1434
2016,8,23,6,1190,1186,2717,1531
2016,8,23,7,1060,1120,2671,1551
2016,8,23,8,1005,1077,2608,1531
2016,8,23,9,1000,1060,2602,1542
2016,8,23,10,990,1052,2619,1567
2016,8,23,11,990,1033,2608,1575
2016,8,23,12,1005,1094,2697,1603
2016,8,23,13,1100,1158,2702,1544
2016,8,23,14,1140,1216,2699,1483
2016,8,23,15,1195,1253,2715,1462
2016,8,23,16,1225,1279,2789,1510
2016,8,23,17,1250,1310,2762,1452
2016,8,23,18,1285,1327,2762,1435
2016,8,23,19,1315,1339,2778,1439
2016,8,23,20,1335,1372,2794,1422
2016,8,23,21,1355,1368,2781,1413
2016,8,23,22,1370,1381,2792,1411
2016,8,23,23,1390,1396,2819,1423
2016,8,24,0,1400,1377,2826,1449
2016,8,24,1,1360,1373,2831,1458
2016,8,24,2,1330,1353,2826,1473
2016,8,24,3,1320,1360,2821,1461
2016,8,24,4,1315,1312,2768,1456
2016,8,24,5,1200,1226,2746,1520
2016,8,24,6,1090,1128,2697,1569
2016,8,24,7,1060,1084,2672,1588
2016,8,24,8,1020,1048,2619,1571
2016,8,24,9,1025,1044,2617,1573
2016,8,24,10,1025,1036,2651,1615
2016,8,24,11,995,1030,2615,1585
2016,8,24,12,1050,1080,2711,1631
2016,8,24,13,1130,1144,2559,1415
2016,8,24,14,1175,1205,2459,1254
2016,8,24,15,1220,1237,2434,1197
2016,8,24,16,1260,1250,2421,1171
2016,8,24,17,1300,1266,2467,1201
2016,8,24,18,1310,1275,2472,1197
2016,8,24,19,1315,1269,2472,1203
2016,8,24,20,1335,1272,2470,1198
2016,8,24,21,1350,1277,2480,1203
2016,8,24,22,1360,1262,2474,1212
2016,8,24,23,1385,1288,2508,1220
2016,8,25,0,1390,1247,2490,1243
2016,8,25,1,1365,1235,2481,1246
2016,8,25,2,1315,1220,2448,1228
2016,8,25,3,1310,1239,2441,1202
2016,8,25,4,1300,1227,2419,1192
2016,8,25,5,1225,1137,2383,1246
2016,8,25,6,1115,1069,2371,1302
2016,8,25,7,1020,1043,2363,1320
2016,8,25,8,990,1014,2315,1301
2016,8,25,9,985,994,2300,1306
2016,8,25,10,1010,989,2273,1284
2016,8,25,11,1025,997,2270,1273
2016,8,25,12,1050,1047,2322,1275
2016,8,25,13,1115,1133,2332,1199
2016,8,25,14,1180,1193,2330,1137
2016,8,25,15,1210,1234,2330,1096
2016,8,25,16,1240,1247,2324,1077
2016,8,25,17,1250,1260,2332,1072
2016,8,25,18,1265,1276,2335,1059
2016,8,25,19,1280,1278,2333,1055
2016,8,25,20,1295,1294,2334,1040
2016,8,25,21,1295,1296,2345,1049
2016,8,25,22,1310,1305,2349,1044
2016,8,25,23,1335,1321,2370,1049
2016,8,26,0,1310,1302,2358,1056
2016,8,26,1,1275,1280,2343,1063
2016,8,26,2,1235,1275,2330,1055
2016,8,26,3,1250,1281,2153,872
2016,8,26,4,1220,1258,2128,870
2016,8,26,5,1140,1174,2119,945
2016,8,26,6,1055,1088,2106,1018
2016,8,26,7,995,1061,2276,1215
2016,8,26,8,980,1035,2236,1201
2016,8,26,9,970,1008,2249,1241
2016,8,26,10,975,1001,2257,1256
2016,8,26,11,975,1010,2313,1303
2016,8,26,12,1015,1055,2337,1282
2016,8,26,13,1100,1134,2360,1226
2016,8,26,14,1160,1197,2391,1194
2016,8,26,15,1175,1221,2407,1186
2016,8,26,16,1190,1248,2366,1118
2016,8,26,17,1200,1256,2407,1151
2016,8,26,18,1210,1269,2374,1105
2016,8,26,19,1215,1267,2345,1078
2016,8,26,20,1220,1283,2374,1091
2016,8,26,21,1215,1282,2353,1071
2016,8,26,22,1230,1289,2356,1067
2016,8,26,23,1230,1303,2365,1062
2016,8,27,0,1220,1295,2369,1074
2016,8,27,1,1205,1267,2344,1077
2016,8,27,2,1190,1259,2354,1095
2016,8,27,3,1180,1262,2361,1099
2016,8,27,4,1170,1244,2415,1171
2016,8,27,5,1115,1160,2463,1303
2016,8,27,6,1040,1086,2510,1424
2016,8,27,7,980,1033,2456,1423
2016,8,27,8,990,1016,2569,1553
2016,8,27,9,985,995,2520,1525
2016,8,27,10,985,985,2518,1533
2016,8,27,11,980,980,2578,1598
2016,8,27,12,1000,1009,2592,1583
2016,8,27,13,1025,1036,2592,1556
2016,8,27,14,1065,1066,2426,1360
2016,8,27,15,1120,1117,2413,1296
2016,8,27,16,1155,1164,2348,1184
2016,8,27,17,1180,1216,2447,1231
2016,8,27,18,1180,1238,2444,1206
2016,8,27,19,1185,1256,2459,1203
2016,8,27,20,1200,1281,2494,1213
2016,8,27,21,1215,1304,2507,1203
2016,8,27,22,1220,1318,2514,1196
2016,8,27,23,1255,1325,2477,1152
2016,8,28,0,1255,1330,2532,1202
2016,8,28,1,1265,1317,2501,1184
2016,8,28,2,1250,1309,2536,1227
2016,8,28,3,1235,1326,2597,1271
2016,8,28,4,1230,1297,2608,1311
2016,8,28,5,1135,1225,2613,1388
2016,8,28,6,1060,1149,2603,1454
2016,8,28,7,995,1101,2599,1498
2016,8,28,8,960,1077,2603,1526
2016,8,28,9,955,1035,2584,1549
2016,8,28,10,950,1018,2562,1544
2016,8,28,11,940,1025,2565,1540
2016,8,28,12,955,1037,2591,1554
2016,8,28,13,985,1053,2659,1606
2016,8,28,14,1025,1064,2418,1354
2016,8,28,15,1080,1122,2467,1345
2016,8,28,16,1125,1192,2587,1395
2016,8,28,17,1185,1243,2611,1368
2016,8,28,18,1215,1275,2620,1345
2016,8,28,19,1225,1306,2642,1336
2016,8,28,20,1245,1328,2651,1323
2016,8,28,21,1265,1351,2662,1311
2016,8,28,22,1320,1383,2706,1323
2016,8,28,23,1380,1406,2714,1308
2016,8,29,0,1415,1421,2744,1323
2016,8,29,1,1420,1402,2781,1379
2016,8,29,2,1385,1385,2717,1332
2016,8,29,3,1370,1392,2732,1340
2016,8,29,4,1340,1349,2735,1386
2016,8,29,5,1215,1241,2727,1486
2016,8,29,6,1110,1147,2685,1538
2016,8,29,7,1065,1090,2664,1574
2016,8,29,8,1030,1061,2593,1532
2016,8,29,9,1010,1042,2585,1543
2016,8,29,10,1000,1032,2594,1562
2016,8,29,11,1000,1029,2578,1549
2016,8,29,12,1025,1077,2580,1503
2016,8,29,13,1130,1161,2561,1400
2016,8,29,14,1215,1228,2546,1318
2016,8,29,15,1250,1263,2530,1267
2016,8,29,16,1275,1314,2596,1282
2016,8,29,17,1350,1345,2667,1322
2016,8,29,18,1360,1380,2628,1248
2016,8,29,19,1390,1400,2622,1222
2016,8,29,20,1425,1435,2662,1227
2016,8,29,21,1480,1478,2672,1194
2016,8,29,22,1500,1518,2674,1156
2016,8,29,23,1520,1537,2698,1161
2016,8,30,0,1480,1536,2713,1177
2016,8,30,1,1465,1518,2723,1205
2016,8,30,2,1420,1496,2761,1265
2016,8,30,3,1400,1501,2723,1222
2016,8,30,4,1360,1421,2687,1266
2016,8,30,5,1250,1279,2594,1315
2016,8,30,6,1150,1195,2547,1352
2016,8,30,7,1110,1123,2518,1395
2016,8,30,8,1060,1088,2344,1256
2016,8,30,9,1045,1060,2323,1263
2016,8,30,10,1025,1044,2314,1270
2016,8,30,11,1040,1069,2330,1261
2016,8,30,12,1065,1099,2340,1241
2016,8,30,13,1145,1209,2475,1266
2016,8,30,14,1220,1274,2480,1206
2016,8,30,15,1280,1295,2469,1174
2016,8,30,16,1320,1328,2471,1143
2016,8,30,17,1375,1358,2503,1145
2016,8,30,18,1410,1377,2531,1154
2016,8,30,19,1465,1429,2534,1105
2016,8,30,20,1515,1487,2556,1069
2016,8,30,21,1565,1523,2613,1090
2016,8,30,22,1605,1557,2616,1059
2016,8,30,23,1620,1568,2591,1023
2016,8,31,0,1605,1554,2574,1020
2016,8,31,1,1580,1536,2602,1066
2016,8,31,2,1555,1496,2549,1053
2016,8,31,3,1530,1506,2524,1018
2016,8,31,4,1480,1430,2543,1113
2016,8,31,5,1355,1319,2586,1267
2016,8,31,6,1200,1203,2613,1410
2016,8,31,7,1100,1137,2601,1464
2016,8,31,8,1040,1103,2630,1527
2016,8,31,9,1030,1090,2614,1524
2016,8,31,10,1020,1070,2541,1471
2016,8,31,11,1030,1075,2563,1488
2016,8,31,12,1070,1113,2600,1487
2016,8,31,13,1190,1221,2623,1402
2016,8,31,14,1260,1264,2558,1294
2016,8,31,15,1315,1305,2568,1263
2016,8,31,16,1350,1319,2562,1243
2016,8,31,17,1385,1376,2613,1237
2016,8,31,18,1425,1411,2625,1214
2016,8,31,19,1460,1459,2662,1203
2016,8,31,20,1510,1518,2674,1156
2016,8,31,21,1565,1542,2675,1133
2016,8,31,22,1615,1582,2690,1108
2016,8,31,23,1620,1588,2716,1128
2016,9,1,0,1615,1568,2705,1137
2016,9,1,1,1570,1541,2675,1134
2016,9,1,2,1550,1507,2641,1134
2016,9,1,3,1535,1504,2658,1154
2016,9,1,4,1490,1436,2669,1233
2016,9,1,5,1360,1322,2671,1349
2016,9,1,6,1245,1230,2677,1447
2016,9,1,7,1120,1170,2664,1494
2016,9,1,8,1080,1119,2476,1357
2016,9,1,9,1065,1088,2408,1320
2016,9,1,10,1050,1071,2428,1357
2016,9,1,11,1070,1076,2484,1408
2016,9,1,12,1090,1121,2562,1441
2016,9,1,13,1215,1223,2561,1338
2016,9,1,14,1280,1283,2616,1333
2016,9,1,15,1330,1295,2586,1291
2016,9,1,16,1355,1345,2586,1241
2016,9,1,17,1335,1419,2673,1254
2016,9,1,18,1400,1457,2676,1219
2016,9,1,19,1440,1494,2686,1192
2016,9,1,20,1460,1539,2682,1143
2016,9,1,21,1500,1565,2658,1093
2016,9,1,22,1545,1577,2643,1066
2016,9,1,23,1560,1572,2631,1059
2016,9,2,0,1560,1551,2614,1063
2016,9,2,1,1525,1515,2624,1109
2016,9,2,2,1480,1490,2706,1216
2016,9,2,3,1480,1487,2669,1182
2016,9,2,4,1410,1422,2685,1263
2016,9,2,5,1300,1302,2618,1316
2016,9,2,6,1160,1186,2588,1402
2016,9,2,7,1020,1125,2533,1408
2016,9,2,8,1010,1092,2534,1442
2016,9,2,9,990,1071,2516,1445
2016,9,2,10,990,1057,2482,1425
2016,9,2,11,1000,1063,2481,1418
2016,9,2,12,1035,1125,2500,1375
2016,9,2,13,1105,1215,2502,1287
2016,9,2,14,1165,1265,2519,1254
2016,9,2,15,1180,1295,2535,1240
2016,9,2,16,1205,1342,2549,1207
2016,9,2,17,1225,1368,2573,1205
2016,9,2,18,1240,1412,2573,1161
2016,9,2,19,1245,1437,2577,1140
2016,9,2,20,1270,1453,2604,1151
2016,9,2,21,1270,1461,2630,1169
2016,9,2,22,1290,1450,2703,1253
2016,9,2,23,1290,1444,2702,1258
2016,9,3,0,1285,1398,2671,1273
2016,9,3,1,1260,1387,2693,1306
2016,9,3,2,1245,1349,2764,1415
2016,9,3,3,1240,1334,2756,1422
2016,9,3,4,1220,1294,2693,1399
2016,9,3,5,1145,1219,2645,1426
2016,9,3,6,1070,1146,2591,1445
2016,9,3,7,1005,1093,2532,1439
2016,9,3,8,990,1064,2501,1437
2016,9,3,9,980,1038,2444,1406
2016,9,3,10,975,1009,2389,1380
2016,9,3,11,970,1022,2421,1399
2016,9,3,12,990,1034,2403,1369
2016,9,3,13,985,1064,2419,1355
2016,9,3,14,985,1103,2498,1395
2016,9,3,15,1040,1150,2552,1402
2016,9,3,16,1075,1193,2550,1357
2016,9,3,17,1100,1223,2590,1367
2016,9,3,18,1105,1228,2553,1325
2016,9,3,19,1115,1220,2537,1317
2016,9,3,20,1135,1224,2535,1311
2016,9,3,21,1150,1238,2534,1296
2016,9,3,22,1160,1246,2531,1285
2016,9,3,23,1190,1247,2542,1295
2016,9,4,0,1205,1266,2532,1266
2016,9,4,1,1210,1239,2524,1285
2016,9,4,2,1200,1231,2531,1300
2016,9,4,3,1185,1250,2566,1316
2016,9,4,4,1185,1225,2625,1400
2016,9,4,5,1090,1152,2599,1447
2016,9,4,6,1015,1086,2544,1458
2016,9,4,7,1035,1051,2537,1486
2016,9,4,8,1010,1009,2448,1439
2016,9,4,9,990,1008,2470,1462
2016,9,4,10,970,1009,2590,1581
2016,9,4,11,970,1032,2592,1560
2016,9,4,12,990,1040,2574,1534
2016,9,4,13,940,1064,2584,1520
2016,9,4,14,905,1100,2567,1467
2016,9,4,15,955,1142,2595,1453
2016,9,4,16,1000,1187,2580,1393
2016,9,4,17,1045,1197,2589,1392
2016,9,4,18,1070,1220,2595,1375
2016,9,4,19,1110,1203,2436,1233
2016,9,4,20,1120,1209,2443,1234
2016,9,4,21,1135,1190,2428,1238
2016,9,4,22,1175,1203,2438,1235
2016,9,4,23,1200,1205,2398,1193
2016,9,5,0,1215,1214,2425,1211
2016,9,5,1,1205,1199,2468,1269
2016,9,5,2,1160,1200,2465,1265
2016,9,5,3,1155,1206,2447,1241
2016,9,5,4,1165,1170,2539,1369
2016,9,5,5,1040,1111,2555,1444
2016,9,5,6,955,1047,2549,1502
2016,9,5,7,1000,1026,2490,1464
2016,9,5,8,970,998,2547,1549
2016,9,5,9,960,1003,2599,1596
2016,9,5,10,950,1005,2590,1585
2016,9,5,11,950,1017,2580,1563
2016,9,5,12,975,1021,2575,1554
2016,9,5,13,990,1071,2531,1460
2016,9,5,14,985,1097,2508,1411
2016,9,5,15,1025,1148,2489,1341
2016,9,5,16,1040,1187,2472,1285
2016,9,5,17,1075,1209,2509,1300
2016,9,5,18,1095,1230,2510,1280
2016,9,5,19,1125,1208,2495,1287
2016,9,5,20,1160,1216,2519,1303
2016,9,5,21,1190,1188,2520,1332
2016,9,5,22,1220,1194,2544,1350
2016,9,5,23,1240,1211,2546,1335
2016,9,6,0,1220,1209,2544,1335
2016,9,6,1,1205,1206,2536,1330
2016,9,6,2,1170,1224,2549,1325
2016,9,6,3,1170,1252,2591,1339
2016,9,6,4,1110,1214,2569,1355
2016,9,6,5,1025,1138,2553,1415
2016,9,6,6,945,1056,2523,1467
2016,9,6,7,1025,1004,2491,1487
2016,9,6,8,990,991,2518,1527
2016,9,6,9,990,969,2515,1546
2016,9,6,10,980,983,2506,1523
2016,9,6,11,960,984,2470,1486
2016,9,6,12,1030,1049,2528,1479
2016,9,6,13,1100,1165,2560,1395
2016,9,6,14,1140,1249,2592,1343
2016,9,6,15,1165,1261,2589,1328
2016,9,6,16,1190,1271,2595,1324
2016,9,6,17,1225,1275,2577,1302
2016,9,6,18,1235,1275,2538,1263
2016,9,6,19,1255,1283,2520,1237
2016,9,6,20,1290,1282,2540,1258
2016,9,6,21,1295,1290,2541,1251
2016,9,6,22,1325,1288,2600,1312
2016,9,6,23,1345,1307,2601,1294
2016,9,7,0,1320,1288,2615,1327
2016,9,7,1,1295,1297,2584,1287
2016,9,7,2,1275,1298,2555,1257
2016,9,7,3,1275,1310,2555,1245
2016,9,7,4,1245,1266,2680,1414
2016,9,7,5,1140,1175,2619,1444
2016,9,7,6,1035,1096,2651,1555
2016,9,7,7,1000,1057,2587,1530
2016,9,7,8,975,1033,2597,1564
2016,9,7,9,960,1012,2522,1510
2016,9,7,10,965,1020,2527,1507
2016,9,7,11,975,1032,2577,1545
2016,9,7,12,1020,1075,2548,1473
2016,9,7,13,1110,1187,2452,1265
2016,9,7,14,1200,1269,2593,1324
2016,9,7,15,1210,1285,2589,1304
2016,9,7,16,1240,1291,2641,1350
2016,9,7,17,1265,1295,2654,1359
2016,9,7,18,1275,1286,2672,1386
2016,9,7,19,1255,1281,2702,1421
2016,9,7,20,1245,1287,2672,1385
2016,9,7,21,1245,1300,2637,1337
2016,9,7,22,1235,1315,2639,1324
2016,9,7,23,1255,1309,2663,1354
2016,9,8,0,1230,1294,2636,1342
2016,9,8,1,1220,1258,2605,1347
2016,9,8,2,1195,1256,2577,1321
2016,9,8,3,1215,1305,2592,1287
2016,9,8,4,1210,1241,2579,1338
2016,9,8,5,1100,1158,2565,1407
2016,9,8,6,1035,1074,2530,1456
2016,9,8,7,995,1030,2479,1449
2016,9,8,8,995,1007,2388,1381
2016,9,8,9,980,997,2406,1409
2016,9,8,10,990,972,2356,1384
2016,9,8,11,1040,1006,2389,1383
2016,9,8,12,1045,1053,2415,1362
2016,9,8,13,1140,1164,2532,1368
2016,9,8,14,1200,1242,2595,1353
2016,9,8,15,1190,1262,2567,1305
2016,9,8,16,1190,1261,2516,1255
2016,9,8,17,1215,1293,2595,1302
2016,9,8,18,1230,1324,2662,1338
2016,9,8,19,1230,1327,2683,1356
2016,9,8,20,1240,1308,2676,1368
2016,9,8,21,1245,1285,2653,1368
2016,9,8,22,1260,1281,2660,1379
2016,9,8,23,1270,1281,2663,1382
2016,9,9,0,1250,1261,2674,1413
2016,9,9,1,1230,1245,2624,1379
2016,9,9,2,1220,1230,2577,1347
2016,9,9,3,1235,1274,2579,1305
2016,9,9,4,1225,1247,2617,1370
2016,9,9,5,1120,1161,2572,1411
2016,9,9,6,1025,1091,2567,1476
2016,9,9,7,995,1057,2533,1476
2016,9,9,8,965,1015,2344,1329
2016,9,9,9,970,1002,2333,1331
2016,9,9,10,975,998,2321,1323
2016,9,9,11,990,1018,2444,1426
2016,9,9,12,1005,1079,2539,1460
2016,9,9,13,1110,1172,2518,1346
2016,9,9,14,1160,1249,2547,1298
2016,9,9,15,1160,1246,2621,1375
2016,9,9,16,1165,1257,2643,1386
2016,9,9,17,1175,1255,2667,1412
2016,9,9,18,1195,1242,2669,1427
2016,9,9,19,1190,1253,2677,1424
2016,9,9,20,1210,1245,2662,1417
2016,9,9,21,1215,1254,2670,1416
2016,9,9,22,1225,1245,2665,1420
2016,9,9,23,1225,1248,2664,1416
2016,9,10,0,1210,1233,2646,1413
2016,9,10,1,1190,1224,2655,1431
2016,9,10,2,1170,1208,2641,1433
2016,9,10,3,1170,1234,2674,1440
2016,9,10,4,1165,1211,2668,1457
2016,9,10,5,1070,1156,2619,1463
2016,9,10,6,1000,1094,2615,1521
2016,9,10,7,1005,1056,2531,1475
2016,9,10,8,980,1016,2382,1366
2016,9,10,9,970,1021,2421,1400
2016,9,10,10,955,1016,2433,1417
2016,9,10,11,950,1036,2481,1445
2016,9,10,12,980,1043,2476,1433
2016,9,10,13,1020,1086,2451,1365
2016,9,10,14,1045,1132,2513,1381
2016,9,10,15,1095,1186,2610,1424
2016,9,10,16,1135,1215,2639,1424
2016,9,10,17,1185,1211,2632,1421
2016,9,10,18,1190,1218,2660,1442
2016,9,10,19,1190,1219,2705,1486
2016,9,10,20,1220,1220,2640,1420
2016,9,10,21,1230,1218,2643,1425
2016,9,10,22,1245,1247,2670,1423
2016,9,10,23,1255,1253,2650,1397
2016,9,11,0,1245,1273,2667,1394
2016,9,11,1,1210,1260,2590,1330
2016,9,11,2,1215,1244,2518,1274
2016,9,11,3,1235,1264,2545,1281
2016,9,11,4,1230,1212,2541,1329
2016,9,11,5,1145,1154,2556,1402
2016,9,11,6,1065,1070,2475,1405
2016,9,11,7,1055,1031,2443,1412
2016,9,11,8,1025,997,2400,1403
2016,9,11,9,1010,987,2431,1444
2016,9,11,10,985,986,2445,1459
2016,9,11,11,1000,1014,2395,1381
2016,9,11,12,1025,1025,2279,1254
2016,9,11,13,1005,1056,2290,1234
2016,9,11,14,1005,1078,2308,1230
2016,9,11,15,1050,1121,2378,1257
2016,9,11,16,1095,1165,2462,1297
2016,9,11,17,1130,1199,2542,1343
2016,9,11,18,1160,1218,2578,1360
2016,9,11,19,1185,1209,2553,1344
2016,9,11,20,1180,1224,2619,1395
2016,9,11,21,1190,1227,2632,1405
2016,9,11,22,1225,1241,2635,1394
2016,9,11,23,1245,1250,2628,1378
2016,9,12,0,1260,1261,2634,1373
2016,9,12,1,1250,1264,2657,1393
2016,9,12,2,1205,1277,2643,1366
2016,9,12,3,1210,1274,2660,1386
2016,9,12,4,1205,1232,2590,1358
2016,9,12,5,1100,1136,2556,1420
2016,9,12,6,1015,1066,2501,1435
2016,9,12,7,990,1038,2452,1414
2016,9,12,8,960,1006,2442,1436
2016,9,12,9,970,993,2351,1358
2016,9,12,10,950,989,2362,1373
2016,9,12,11,965,1003,2381,1378
2016,9,12,12,995,1046,2407,1361
2016,9,12,13,1065,1174,2526,1352
2016,9,12,14,1130,1264,2644,1380
2016,9,12,15,1165,1292,2643,1351
2016,9,12,16,1200,1290,2672,1382
2016,9,12,17,1220,1286,2703,1417
2016,9,12,18,1260,1279,2689,1410
2016,9,12,19,1245,1277,2692,1415
2016,9,12,20,1240,1275,2699,1424
2016,9,12,21,1230,1267,2671,1404
2016,9,12,22,1245,1260,2680,1420
2016,9,12,23,1260,1258,2673,1415
2016,9,13,0,1250,1246,2651,1405
2016,9,13,1,1250,1256,2643,1387
2016,9,13,2,1230,1287,2636,1349
2016,9,13,3,1255,1297,2616,1319
2016,9,13,4,1225,1250,2580,1330
2016,9,13,5,1140,1152,2562,1410
2016,9,13,6,1065,1086,2535,1449
2016,9,13,7,980,1039,2484,1445
2016,9,13,8,960,1028,2458,1430
2016,9,13,9,925,1019,2460,1441
2016,9,13,10,935,1008,2433,1425
2016,9,13,11,935,1032,2457,1425
2016,9,13,12,990,1098,2526,1428
2016,9,13,13,1115,1222,2571,1349
2016,9,13,14,1215,1299,2573,1274
2016,9,13,15,1195,1313,2569,1256
2016,9,13,16,1205,1311,2574,1263
2016,9,13,17,1210,1289,2580,1291
2016,9,13,18,1215,1271,2578,1307
2016,9,13,19,1220,1246,2558,1312
2016,9,13,20,1215,1244,2572,1328
2016,9,13,21,1220,1223,2565,1342
2016,9,13,22,1235,1220,2572,1352
2016,9,13,23,1250,1223,2576,1353
2016,9,14,0,1235,1207,2574,1367
2016,9,14,1,1240,1217,2566,1349
2016,9,14,2,1230,1240,2557,1317
2016,9,14,3,1245,1277,2416,1139
2016,9,14,4,1225,1225,2399,1174
2016,9,14,5,1120,1135,2371,1236
2016,9,14,6,1030,1070,2374,1304
2016,9,14,7,990,1019,2215,1196
2016,9,14,8,985,1000,2215,1215
2016,9,14,9,960,991,2215,1224
2016,9,14,10,970,977,2211,1234
2016,9,14,11,1010,1016,2359,1343
2016,9,14,12,1030,1080,2500,1420
2016,9,14,13,1125,1184,2526,1342
2016,9,14,14,1235,1270,2560,1290
2016,9,14,15,1260,1274,2559,1285
2016,9,14,16,1255,1266,2558,1292
2016,9,14,17,1255,1270,2567,1297
2016,9,14,18,1245,1266,2588,1322
2016,9,14,19,1225,1245,2586,1341
2016,9,14,20,1225,1264,2593,1329
2016,9,14,21,1220,1246,2585,1339
2016,9,14,22,1235,1247,2577,1330
2016,9,14,23,1235,1246,2582,1336
2016,9,15,0,1210,1236,2596,1360
2016,9,15,1,1195,1228,2624,1396
2016,9,15,2,1205,1249,2658,1409
2016,9,15,3,1235,1269,2663,1394
2016,9,15,4,1235,1197,2612,1415
2016,9,15,5,1110,1129,2615,1486
2016,9,15,6,1035,1052,2559,1507
2016,9,15,7,995,1001,2440,1439
2016,9,15,8,960,983,2376,1393
2016,9,15,9,965,968,2337,1369
2016,9,15,10,935,974,2331,1357
2016,9,15,11,980,996,2461,1465
2016,9,15,12,1045,1062,2531,1469
2016,9,15,13,1145,1190,2563,1373
2016,9,15,14,1260,1258,2620,1362
2016,9,15,15,1270,1258,2648,1390
2016,9,15,16,1255,1261,2614,1353
2016,9,15,17,1275,1254,2613,1359
2016,9,15,18,1315,1252,2620,1368
2016,9,15,19,1290,1243,2618,1375
2016,9,15,20,1270,1264,2609,1345
2016,9,15,21,1255,1287,2587,1300
2016,9,15,22,1255,1279,2608,1329
2016,9,15,23,1255,1255,2584,1329
2016,9,16,0,1240,1222,2585,1363
2016,9,16,1,1230,1211,2585,1374
2016,9,16,2,1215,1240,2579,1339
2016,9,16,3,1245,1257,2599,1342
2016,9,16,4,1245,1218,2596,1378
2016,9,16,5,1130,1124,2558,1434
2016,9,16,6,1055,1037,2238,1201
2016,9,16,7,975,995,2125,1130
2016,9,16,8,945,984,2178,1194
2016,9,16,9,925,978,2179,1201
2016,9,16,10,925,979,2224,1245
2016,9,16,11,970,1008,2475,1467
2016,9,16,12,1040,1057,2494,1437
2016,9,16,13,1170,1173,2554,1381
2016,9,16,14,1250,1243,2568,1325
2016,9,16,15,1265,1243,2569,1326
2016,9,16,16,1280,1244,2578,1334
2016,9,16,17,1265,1242,2614,1372
2016,9,16,18,1275,1240,2644,1404
2016,9,16,19,1275,1239,2642,1403
2016,9,16,20,1280,1243,2628,1385
2016,9,16,21,1270,1238,2627,1389
2016,9,16,22,1265,1249,2611,1362
2016,9,16,23,1270,1255,2599,1344
2016,9,17,0,1260,1244,2567,1323
2016,9,17,1,1255,1237,2567,1330
2016,9,17,2,1240,1234,2573,1339
2016,9,17,3,1250,1233,2584,1351
2016,9,17,4,1240,1198,2578,1380
2016,9,17,5,1125,1138,2553,1415
2016,9,17,6,1065,1067,2520,1453
2016,9,17,7,1015,1024,2473,1449
2016,9,17,8,980,1005,2457,1452
2016,9,17,9,985,989,2465,1476
2016,9,17,10,980,974,2429,1455
2016,9,17,11,1010,980,2375,1395
2016,9,17,12,1010,1003,2389,1386
2016,9,17,13,1060,1051,2352,1301
2016,9,17,14,1110,1079,2448,1369
2016,9,17,15,1175,1139,2482,1343
2016,9,17,16,1190,1182,2612,1430
2016,9,17,17,1205,1202,2593,1391
2016,9,17,18,1210,1210,2530,1320
2016,9,17,19,1210,1202,2559,1357
2016,9,17,20,1205,1207,2566,1359
2016,9,17,21,1205,1214,2567,1353
2016,9,17,22,1215,1199,2565,1366
2016,9,17,23,1210,1202,2536,1334
2016,9,18,0,1225,1213,2492,1279
2016,9,18,1,1230,1186,2425,1239
2016,9,18,2,1210,1224,2551,1327
2016,9,18,3,1240,1229,2530,1301
2016,9,18,4,1200,1198,2586,1388
2016,9,18,5,1135,1142,2536,1394
2016,9,18,6,1060,1080,2500,1420
2016,9,18,7,1005,1045,2396,1351
2016,9,18,8,980,1004,2166,1162
2016,9,18,9,990,991,2250,1259
2016,9,18,10,985,988,2227,1239
2016,9,18,11,1020,985,2289,1304
2016,9,18,12,1000,1009,2290,1281
2016,9,18,13,1075,1040,2343,1303
2016,9,18,14,1105,1061,2386,1325
2016,9,18,15,1125,1114,2496,1382
2016,9,18,16,1165,1187,2597,1410
2016,9,18,17,1185,1198,2610,1412
2016,9,18,18,1210,1239,2631,1392
2016,9,18,19,1200,1243,2631,1388
2016,9,18,20,1200,1246,2626,1380
2016,9,18,21,1210,1256,2606,1350
2016,9,18,22,1215,1249,2599,1350
2016,9,18,23,1220,1262,2586,1324
2016,9,19,0,1225,1275,2657,1382
2016,9,19,1,1225,1266,2623,1357
2016,9,19,2,1220,1283,2584,1301
2016,9,19,3,1225,1289,2574,1285
2016,9,19,4,1175,1228,2589,1361
2016,9,19,5,1105,1145,2605,1460
2016,9,19,6,1035,1063,2584,1521
2016,9,19,7,1025,1019,2475,1456
2016,9,19,8,1005,1002,2431,1429
2016,9,19,9,985,975,2337,1362
2016,9,19,10,980,986,2358,1372
2016,9,19,11,1005,1004,2422,1418
2016,9,19,12,1075,1059,2511,1452
2016,9,19,13,1185,1172,2558,1386
2016,9,19,14,1265,1245,2604,1359
2016,9,19,15,1270,1245,2566,1321
2016,9,19,16,1270,1253,2577,1324
2016,9,19,17,1270,1259,2577,1318
2016,9,19,18,1265,1269,2593,1324
2016,9,19,19,1270,1284,2575,1291
2016,9,19,20,1285,1293,2560,1267
2016,9,19,21,1280,1300,2543,1243
2016,9,19,22,1285,1339,2519,1180
2016,9,19,23,1275,1329,2554,1225
2016,9,20,0,1275,1317,2564,1247
2016,9,20,1,1265,1297,2617,1320
2016,9,20,2,1290,1303,2575,1272
2016,9,20,3,1270,1307,2581,1274
2016,9,20,4,1230,1232,2563,1331
2016,9,20,5,1120,1139,2487,1348
2016,9,20,6,1045,1058,2496,1438
2016,9,20,7,985,1009,2390,1381
2016,9,20,8,970,984,2343,1359
2016,9,20,9,920,977,2451,1474
2016,9,20,10,925,976,2377,1401
2016,9,20,11,940,995,2438,1443
2016,9,20,12,1010,1037,2457,1420
2016,9,20,13,1120,1159,2482,1323
2016,9,20,14,1205,1251,2535,1284
2016,9,20,15,1245,1232,2553,1321
2016,9,20,16,1250,1238,2549,1311
2016,9,20,17,1245,1241,2522,1281
2016,9,20,18,1240,1248,2523,1275
2016,9,20,19,1245,1234,2513,1279
2016,9,20,20,1240,1268,2544,1276
2016,9,20,21,1245,1270,2562,1292
2016,9,20,22,1255,1272,2562,1290
2016,9,20,23,1270,1277,2586,1309
2016,9,21,0,1250,1271,2630,1359
2016,9,21,1,1250,1274,2691,1417
2016,9,21,2,1245,1302,2663,1361
2016,9,21,3,1275,1299,2701,1402
2016,9,21,4,1250,1235,2650,1415
2016,9,21,5,1140,1149,2620,1471
2016,9,21,6,1050,1090,2549,1459
2016,9,21,7,965,1035,2430,1395
2016,9,21,8,935,1020,2359,1339
2016,9,21,9,930,1000,2401,1401
2016,9,21,10,930,1004,2385,1381
2016,9,21,11,970,1013,2410,1397
2016,9,21,12,1020,1078,2492,1414
2016,9,21,13,1160,1190,2467,1277
2016,9,21,14,1260,1296,2512,1216
2016,9,21,15,1255,1284,2510,1226
2016,9,21,16,1265,1282,2511,1229
2016,9,21,17,1255,1281,2513,1232
2016,9,21,18,1255,1339,2529,1190
2016,9,21,19,1235,1266,2538,1272
2016,9,21,20,1250,1259,2537,1278
2016,9,21,21,1245,1251,2606,1355
2016,9,21,22,1255,1261,2623,1362
2016,9,21,23,1255,1260,2595,1335
2016,9,22,0,1255,1255,2619,1364
2016,9,22,1,1245,1276,2605,1329
2016,9,22,2,1255,1292,2615,1323
2016,9,22,3,1260,1277,2626,1349
2016,9,22,4,1180,1220,2593,1373
2016,9,22,5,1110,1140,2515,1375
2016,9,22,6,1030,1092,2455,1363
2016,9,22,7,970,1046,2370,1324
2016,9,22,8,955,1032,2404,1372
2016,9,22,9,955,1005,2419,1414
2016,9,22,10,935,1010,2439,1429
2016,9,22,11,955,1030,2426,1396
2016,9,22,12,1015,1072,2430,1358
2016,9,22,13,1145,1184,2430,1246
2016,9,22,14,1225,1269,2451,1182
2016,9,22,15,1205,1206,2367,1161
2016,9,22,16,1190,1222,2357,1135
2016,9,22,17,1210,1246,2363,1117
2016,9,22,18,1235,1256,2342,1086
2016,9,22,19,1225,1250,2350,1100
2016,9,22,20,1220,1232,2339,1107
2016,9,22,21,1220,1249,2340,1091
2016,9,22,22,1215,1239,2360,1121
2016,9,22,23,1220,1251,2378,1127
2016,9,23,0,1210,1285,2443,1158
2016,9,23,1,1200,1246,2525,1279
2016,9,23,2,1190,1285,2551,1266
2016,9,23,3,1205,1283,2559,1276
2016,9,23,4,1200,1219,2516,1297
2016,9,23,5,1090,1118,2472,1354
2016,9,23,6,1010,1067,2525,1458
2016,9,23,7,980,1037,2444,1407
2016,9,23,8,980,1005,2316,1311
2016,9,23,9,965,988,2280,1292
2016,9,23,10,960,964,2225,1261
2016,9,23,11,975,990,2222,1232
2016,9,23,12,1020,1031,2247,1216
2016,9,23,13,1140,1143,2406,1263
2016,9,23,14,1230,1230,2521,1291
2016,9,23,15,1240,1241,2565,1324
2016,9,23,16,1235,1250,2535,1285
2016,9,23,17,1240,1247,2523,1276
2016,9,23,18,1250,1238,2526,1288
2016,9,23,19,1255,1227,2555,1328
2016,9,23,20,1235,1222,2510,1288
2016,9,23,21,1225,1218,2558,1340
2016,9,23,22,1210,1207,2520,1313
2016,9,23,23,1215,1206,2522,1316
2016,9,24,0,1215,1190,2454,1264
2016,9,24,1,1215,1194,2427,1233
2016,9,24,2,1190,1207,2438,1231
2016,9,24,3,1200,1223,2447,1224
2016,9,24,4,1210,1179,2420,1241
2016,9,24,5,1200,1109,2388,1279
2016,9,24,6,1095,1062,2404,1342
2016,9,24,7,985,1018,2397,1379
2016,9,24,8,965,987,2350,1363
2016,9,24,9,945,973,2331,1358
2016,9,24,10,940,962,2320,1358
2016,9,24,11,970,973,2348,1375
2016,9,24,12,1000,990,2405,1415
2016,9,24,13,1020,1049,2393,1344
2016,9,24,14,1055,1111,2432,1321
2016,9,24,15,1085,1164,2489,1325
2016,9,24,16,1115,1190,2594,1404
2016,9,24,17,1145,1211,2598,1387
2016,9,24,18,1140,1204,2564,1360
2016,9,24,19,1135,1196,2496,1300
2016,9,24,20,1140,1166,2506,1340
2016,9,24,21,1145,1158,2509,1351
2016,9,24,22,1150,1135,2513,1378
2016,9,24,23,1145,1142,2509,1367
2016,9,25,0,1175,1144,2527,1383
2016,9,25,1,1150,1127,2450,1323
2016,9,25,2,1160,1160,2484,1324
2016,9,25,3,1165,1188,2548,1360
2016,9,25,4,1140,1143,2507,1364
2016,9,25,5,1070,1107,2516,1409
2016,9,25,6,1010,1056,2518,1462
2016,9,25,7,965,1033,2531,1498
2016,9,25,8,930,1022,2578,1556
2016,9,25,9,940,1005,2531,1526
2016,9,25,10,930,1001,2515,1514
2016,9,25,11,960,1006,2515,1509
2016,9,25,12,955,1014,2530,1516
2016,9,25,13,1010,1054,2552,1498
2016,9,25,14,1060,1099,2566,1467
2016,9,25,15,1085,1139,2558,1419
2016,9,25,16,1130,1162,2602,1440
2016,9,25,17,1145,1184,2666,1482
2016,9,25,18,1180,1182,2678,1496
2016,9,25,19,1175,1166,2660,1494
2016,9,25,20,1175,1204,2702,1498
2016,9,25,21,1180,1149,2680,1531
2016,9,25,22,1190,1136,2651,1515
2016,9,25,23,1200,1241,2717,1476
2016,9,26,0,1215,1195,2643,1448
2016,9,26,1,1205,1200,2616,1416
2016,9,26,2,1210,1237,2592,1355
2016,9,26,3,1215,1265,2637,1372
2016,9,26,4,1185,1215,2642,1427
2016,9,26,5,1085,1128,2639,1511
2016,9,26,6,1010,1044,2609,1565
2016,9,26,7,950,1017,2522,1505
2016,9,26,8,935,979,2488,1509
2016,9,26,9,920,972,2404,1432
2016,9,26,10,935,977,2467,1490
2016,9,26,11,955,989,2488,1499
2016,9,26,12,1010,1042,2521,1479
2016,9,26,13,1160,1166,2524,1358
2016,9,26,14,1240,1253,2613,1360
2016,9,26,15,1250,1256,2610,1354
2016,9,26,16,1250,1279,2600,1321
2016,9,26,17,1270,1274,2661,1387
2016,9,26,18,1265,1256,2728,1472
2016,9,26,19,1260,1265,2740,1475
2016,9,26,20,1260,1257,2731,1474
2016,9,26,21,1270,1270,2664,1394
2016,9,26,22,1305,1282,2660,1378
2016,9,26,23,1295,1291,2620,1329
2016,9,27,0,1290,1243,2631,1388
2016,9,27,1,1285,1278,2652,1374
2016,9,27,2,1295,1288,2606,1318
2016,9,27,3,1300,1294,2630,1336
2016,9,27,4,1240,1245,2222,977
2016,9,27,5,1130,1163,1962,799
2016,9,27,6,1060,1073,1960,887
2016,9,27,7,990,1035,2038,1003
2016,9,27,8,960,1004,2217,1213
2016,9,27,9,980,991,2345,1354
2016,9,27,10,980,981,2369,1388
2016,9,27,11,990,988,2368,1380
2016,9,27,12,1040,1051,2410,1359
2016,9,27,13,1150,1155,2413,1258
2016,9,27,14,1235,1236,2615,1379
2016,9,27,15,1250,1229,2644,1415
2016,9,27,16,1245,1237,2632,1395
2016,9,27,17,1250,1245,2703,1458
2016,9,27,18,1255,1253,2713,1460
2016,9,27,19,1270,1267,2718,1451
2016,9,27,20,1270,1287,2698,1411
2016,9,27,21,1280,1333,2705,1372
2016,9,27,22,1285,1345,2713,1368
2016,9,27,23,1310,1347,2675,1328
2016,9,28,0,1295,1316,2611,1295
2016,9,28,1,1285,1303,2567,1264
2016,9,28,2,1300,1330,2596,1266
2016,9,28,3,1320,1319,2620,1301
2016,9,28,4,1235,1233,2386,1153
2016,9,28,5,1145,1136,2335,1199
2016,9,28,6,1065,1056,2430,1374
2016,9,28,7,1005,995,2445,1450
2016,9,28,8,980,995,2460,1465
2016,9,28,9,965,980,2375,1395
2016,9,28,10,965,970,2414,1444
2016,9,28,11,985,983,2435,1452
2016,9,28,12,1040,1019,2431,1412
2016,9,28,13,1155,1144,2475,1331
2016,9,28,14,1225,1225,2658,1433
2016,9,28,15,1250,1221,2618,1397
2016,9,28,16,1265,1221,2614,1393
2016,9,28,17,1275,1234,2635,1401
2016,9,28,18,1260,1239,2653,1414
2016,9,28,19,1250,1238,2651,1413
2016,9,28,20,1240,1276,2608,1332
2016,9,28,21,1270,1293,2625,1332
2016,9,28,22,1270,1293,2659,1366
2016,9,28,23,1285,1315,2673,1358
2016,9,29,0,1245,1316,2677,1361
2016,9,29,1,1295,1292,2680,1388
2016,9,29,2,1285,1319,2687,1368
2016,9,29,3,1295,1299,2675,1376
2016,9,29,4,1255,1222,2390,1168
2016,9,29,5,1175,1133,2360,1227
2016,9,29,6,1070,1051,2327,1276
2016,9,29,7,980,996,2317,1321
2016,9,29,8,965,983,2340,1357
2016,9,29,9,950,962,2327,1365
2016,9,29,10,945,957,2324,1367
2016,9,29,11,965,972,2331,1359
2016,9,29,12,1000,1029,2360,1331
2016,9,29,13,1140,1141,2401,1260
2016,9,29,14,1220,1224,2622,1398
2016,9,29,15,1240,1220,2645,1425
2016,9,29,16,1225,1230,2445,1215
2016,9,29,17,1255,1235,2557,1322
2016,9,29,18,1280,1249,2566,1317
2016,9,29,19,1265,1248,2581,1333
2016,9,29,20,1260,1261,2596,1335
2016,9,29,21,1275,1277,2590,1313
2016,9,29,22,1270,1279,2577,1298
2016,9,29,23,1275,1281,2568,1287
2016,9,30,0,1260,1263,2586,1323
2016,9,30,1,1245,1251,2608,1357
2016,9,30,2,1230,1280,2601,1321
2016,9,30,3,1245,1277,2602,1325
2016,9,30,4,1240,1217,2484,1267
2016,9,30,5,1120,1129,2480,1351
2016,9,30,6,1040,1050,2485,1435
2016,9,30,7,960,999,2460,1461
2016,9,30,8,960,980,2572,1592
2016,9,30,9,935,970,2507,1537
2016,9,30,10,920,955,2482,1527
2016,9,30,11,980,975,2473,1498
2016,9,30,12,1015,1016,2589,1573
2016,9,30,13,1140,1130,2614,1484
2016,9,30,14,1205,1188,2646,1458
2016,9,30,15,1225,1208,2679,1471
2016,9,30,16,1210,1212,2679,1467
2016,9,30,17,1215,1252,2698,1446
2016,9,30,18,1225,1249,2715,1466
2016,9,30,19,1220,1257,2664,1407
2016,9,30,20,1205,1280,2626,1346
2016,9,30,21,1220,1292,2635,1343
2016,9,30,22,1240,1296,2583,1287
2016,9,30,23,1245,1313,2606,1293
2016,10,1,0,1235,1271,2530,1259
2016,10,1,1,1225,1247,2546,1299
2016,10,1,2,1225,1245,2565,1320
2016,10,1,3,1235,1226,2554,1328
2016,10,1,4,1190,1186,2558,1372
2016,10,1,5,1100,1115,2551,1436
2016,10,1,6,1035,1055,2547,1492
2016,10,1,7,970,1010,2493,1483
2016,10,1,8,960,993,2557,1564
2016,10,1,9,935,979,2475,1496
2016,10,1,10,925,955,2486,1531
2016,10,1,11,965,957,2516,1559
2016,10,1,12,1005,985,2544,1559
2016,10,1,13,1035,1021,2505,1484
2016,10,1,14,1075,1066,2501,1435
2016,10,1,15,1105,1102,2458,1356
2016,10,1,16,1150,1137,2485,1348
2016,10,1,17,1175,1154,2533,1379
2016,10,1,18,1155,1161,2545,1384
2016,10,1,19,1165,1153,2551,1398
2016,10,1,20,1170,1168,2589,1421
2016,10,1,21,1175,1173,2560,1387
2016,10,1,22,1165,1191,2588,1397
2016,10,1,23,1170,1186,2585,1399
2016,10,2,0,1175,1173,2651,1478
2016,10,2,1,1155,1164,2635,1471
2016,10,2,2,1190,1192,2622,1430
2016,10,2,3,1185,1179,2599,1420
2016,10,2,4,1170,1151,2594,1443
2016,10,2,5,1100,1097,2659,1562
2016,10,2,6,1035,1040,2708,1668
2016,10,2,7,975,1014,2755,1741
2016,10,2,8,985,980,2663,1683
2016,10,2,9,985,962,2642,1680
2016,10,2,10,970,950,2672,1722
2016,10,2,11,975,954,2651,1697
2016,10,2,12,985,960,2637,1677
2016,10,2,13,1025,995,2587,1592
2016,10,2,14,1070,1039,2552,1513
2016,10,2,15,1110,1082,2543,1461
2016,10,2,16,1145,1116,2547,1431
2016,10,2,17,1145,1150,2577,1427
2016,10,2,18,1145,1149,2570,1421
2016,10,2,19,1135,1164,2588,1424
2016,10,2,20,1150,1165,2612,1447
2016,10,2,21,1125,1158,2626,1468
2016,10,2,22,1120,1162,2653,1491
2016,10,2,23,1190,1174,2641,1467
2016,10,3,0,1185,1191,2631,1440
2016,10,3,1,1175,1220,2630,1410
2016,10,3,2,1190,1266,2650,1384
2016,10,3,3,1220,1255,2627,1372
2016,10,3,4,1180,1175,2550,1375
2016,10,3,5,1080,1097,2536,1439
2016,10,3,6,985,1033,2529,1496
2016,10,3,7,1010,990,2529,1539
2016,10,3,8,990,961,2545,1584
2016,10,3,9,965,963,2496,1533
2016,10,3,10,975,950,2486,1536
2016,10,3,11,970,958,2498,1540
2016,10,3,12,1025,1013,2595,1582
2016,10,3,13,1150,1125,2615,1490
2016,10,3,14,1260,1241,2659,1418
2016,10,3,15,1310,1263,2655,1392
2016,10,3,16,1305,1278,2666,1388
2016,10,3,17,1300,1277,2642,1365
2016,10,3,18,1290,1271,2640,1369
2016,10,3,19,1280,1279,2679,1400
2016,10,3,20,1280,1268,2665,1397
2016,10,3,21,1285,1263,2679,1416
2016,10,3,22,1285,1257,2718,1461
2016,10,3,23,1280,1293,2716,1423
2016,10,4,0,1265,1172,2711,1539
2016,10,4,1,1270,1447,2717,1270
2016,10,4,2,1285,1321,2695,1374
2016,10,4,3,1295,1288,2648,1360
2016,10,4,4,1255,1231,2660,1429
2016,10,4,5,1160,1136,2671,1535
2016,10,4,6,1090,1063,2682,1619
2016,10,4,7,965,1033,2673,1640
2016,10,4,8,955,1005,2662,1657
2016,10,4,9,950,974,2606,1632
2016,10,4,10,920,993,2610,1617
2016,10,4,11,950,996,2624,1628
2016,10,4,12,1035,1051,2668,1617
2016,10,4,13,1150,1182,2729,1547
2016,10,4,14,1230,1273,2734,1461
2016,10,4,15,1265,1295,2715,1420
2016,10,4,16,1260,1304,2711,1407
2016,10,4,17,1235,1302,2694,1392
2016,10,4,18,1220,1301,2706,1405
2016,10,4,19,1210,1290,2733,1443
2016,10,4,20,1200,1272,2724,1452
2016,10,4,21,1195,1253,2706,1453
2016,10,4,22,1195,1244,2673,1429
2016,10,4,23,1195,1241,2663,1422
2016,10,5,0,1180,1236,2632,1396
2016,10,5,1,1190,1264,2633,1369
2016,10,5,2,1205,1297,2648,1351
2016,10,5,3,1240,1278,2649,1371
2016,10,5,4,1190,1224,2652,1428
2016,10,5,5,1110,1141,2666,1525
2016,10,5,6,1035,1070,2649,1579
2016,10,5,7,980,1030,2633,1603
2016,10,5,8,940,1022,2601,1579
2016,10,5,9,925,1009,2588,1579
2016,10,5,10,925,1010,2588,1578
2016,10,5,11,930,1031,2621,1590
2016,10,5,12,1000,1086,2650,1564
2016,10,5,13,1125,1219,2652,1433
2016,10,5,14,1215,1293,2648,1355
2016,10,5,15,1240,1292,2655,1363
2016,10,5,16,1245,1302,2655,1353
2016,10,5,17,1230,1324,2667,1343
2016,10,5,18,1250,1321,2706,1385
2016,10,5,19,1220,1293,2712,1419
2016,10,5,20,1215,1268,2707,1439
2016,10,5,21,1220,1258,2682,1424
2016,10,5,22,1215,1258,2725,1467
2016,10,5,23,1215,1253,2730,1477
2016,10,6,0,1160,1255,2719,1464
2016,10,6,1,1320,1280,2722,1442
2016,10,6,2,1255,1339,2719,1380
2016,10,6,3,1225,1315,2675,1360
2016,10,6,4,1215,1261,2661,1400
2016,10,6,5,1090,1164,2637,1473
2016,10,6,6,1030,1095,2627,1532
2016,10,6,7,1005,1063,2411,1348
2016,10,6,8,985,1046,1966,920
2016,10,6,9,965,1033,1969,936
2016,10,6,10,970,990,2069,1079
2016,10,6,11,985,1016,2139,1123
2016,10,6,12,1045,1072,2311,1239
2016,10,6,13,1195,1209,2552,1343
2016,10,6,14,1290,1307,2655,1348
2016,10,6,15,1300,1302,2646,1344
2016,10,6,16,1300,1304,2650,1346
2016,10,6,17,1300,1309,2602,1293
2016,10,6,18,1285,1271,2568,1297
2016,10,6,19,1295,1142,2580,1438
2016,10,6,20,1280,1256,2595,1339
2016,10,6,21,1275,1255,2634,1379
2016,10,6,22,1260,1247,2639,1392
2016,10,6,23,1265,1241,2645,1404
2016,10,7,0,1250,1232,2606,1374
2016,10,7,1,1310,1250,2603,1353
2016,10,7,2,1335,1311,2639,1328
2016,10,7,3,1315,1299,2651,1352
2016,10,7,4,1275,1228,2624,1396
2016,10,7,5,1160,1167,2616,1449
2016,10,7,6,1095,1093,2652,1559
2016,10,7,7,1020,1062,2641,1579
2016,10,7,8,1010,1039,2633,1594
2016,10,7,9,1000,1025,2620,1595
2016,10,7,10,985,1035,2630,1595
2016,10,7,11,1015,1046,2640,1594
2016,10,7,12,1055,1090,2666,1576
2016,10,7,13,1180,1203,2656,1453
2016,10,7,14,1270,1298,2636,1338
2016,10,7,15,1285,1298,2589,1291
2016,10,7,16,1265,1312,2667,1355
2016,10,7,17,1260,1302,2630,1328
2016,10,7,18,1250,1286,2636,1350
2016,10,7,19,1230,1258,2635,1377
2016,10,7,20,1215,1244,2646,1402
2016,10,7,21,1205,1232,2645,1413
2016,10,7,22,1200,1221,2641,1420
2016,10,7,23,1200,1216,2591,1375
2016,10,8,0,1195,1221,2403,1182
2016,10,8,1,1225,1230,2352,1122
2016,10,8,2,1270,1264,2366,1102
2016,10,8,3,1250,1258,2389,1131
2016,10,8,4,1210,1207,2404,1197
2016,10,8,5,1140,1136,2381,1245
2016,10,8,6,1080,1064,2360,1296
2016,10,8,7,970,1026,2386,1360
2016,10,8,8,945,1008,2426,1418
2016,10,8,9,935,985,2420,1435
2016,10,8,10,920,979,2428,1449
2016,10,8,11,940,993,2443,1450
2016,10,8,12,960,1008,2391,1383
2016,10,8,13,1035,1049,2378,1329
2016,10,8,14,1130,1111,2351,1240
2016,10,8,15,1155,1145,2346,1201
2016,10,8,16,1190,1176,2337,1161
2016,10,8,17,1215,1179,2348,1169
2016,10,8,18,1190,1172,2347,1175
2016,10,8,19,1170,1159,2347,1188
2016,10,8,20,1160,1137,2338,1201
2016,10,8,21,1155,1129,2358,1229
2016,10,8,22,1140,1129,2372,1243
2016,10,8,23,1145,1136,2396,1260
2016,10,9,0,1140,1144,2419,1275
2016,10,9,1,1120,1158,2435,1277
2016,10,9,2,1155,1195,2457,1262
2016,10,9,3,1180,1181,2433,1252
2016,10,9,4,1130,1153,2395,1242
2016,10,9,5,1080,1086,2393,1307
2016,10,9,6,1025,1027,2369,1342
2016,10,9,7,985,998,2369,1371
2016,10,9,8,965,971,2370,1399
2016,10,9,9,950,954,2356,1402
2016,10,9,10,945,955,2350,1395
2016,10,9,11,960,962,2402,1440
2016,10,9,12,965,966,2403,1437
2016,10,9,13,1010,999,2413,1414
2016,10,9,14,1060,1047,2417,1370
2016,10,9,15,1105,1081,2402,1321
2016,10,9,16,1135,1138,2406,1268
2016,10,9,17,1145,1124,2391,1267
2016,10,9,18,1150,1144,2406,1262
2016,10,9,19,1130,1155,2431,1276
2016,10,9,20,1145,1159,2505,1346
2016,10,9,21,1130,1138,2512,1374
2016,10,9,22,1140,1151,2512,1361
2016,10,9,23,1180,1155,2465,1310
2016,10,10,0,1180,1172,2453,1281
2016,10,10,1,1200,1195,2490,1295
2016,10,10,2,1230,1228,2506,1278
2016,10,10,3,1235,1204,2512,1308
2016,10,10,4,1175,1152,2486,1334
2016,10,10,5,1095,1074,2499,1425
2016,10,10,6,1005,1005,2482,1477
2016,10,10,7,930,975,2471,1496
2016,10,10,8,925,950,2425,1475
2016,10,10,9,915,946,2360,1414
2016,10,10,10,895,944,2372,1428
2016,10,10,11,915,976,2363,1387
2016,10,10,12,990,1008,2360,1352
2016,10,10,13,1140,1127,2378,1251
2016,10,10,14,1245,1238,2363,1125
2016,10,10,15,1265,1254,2347,1093
2016,10,10,16,1275,1275,2345,1070
2016,10,10,17,1270,1275,2343,1068
2016,10,10,18,1260,1274,2370,1096
2016,10,10,19,1260,1259,2469,1210
2016,10,10,20,1245,1245,2500,1255
2016,10,10,21,1250,1238,2492,1254
2016,10,10,22,1235,1236,2501,1265
2016,10,10,23,1230,1250,2518,1268
2016,10,11,0,1170,1217,2512,1295
2016,10,11,1,1340,1307,2467,1160
2016,10,11,2,1290,1350,2499,1149
2016,10,11,3,1255,1342,2543,1201
2016,10,11,4,1225,1300,2534,1234
2016,10,11,5,1115,1235,2438,1203
2016,10,11,6,1050,1181,2407,1226
2016,10,11,7,1050,1138,2374,1236
2016,10,11,8,1030,1120,2449,1329
2016,10,11,9,1040,1078,2515,1437
2016,10,11,10,1060,1098,2668,1570
2016,10,11,11,1090,1109,2749,1640
2016,10,11,12,1120,1175,2762,1587
2016,10,11,13,1230,1310,2793,1483
2016,10,11,14,1310,1398,2827,1429
2016,10,11,15,1295,1396,2785,1389
2016,10,11,16,1305,1398,2783,1385
2016,10,11,17,1300,1361,2767,1406
2016,10,11,18,1275,1281,2759,1478
2016,10,11,19,1285,1285,2784,1499
2016,10,11,20,1290,1281,2770,1489
2016,10,11,21,1265,1274,2731,1457
2016,10,11,22,1270,1273,2737,1464
2016,10,11,23,1310,1270,2713,1443
2016,10,12,0,1355,1269,2700,1431
2016,10,12,1,1370,1304,2694,1390
2016,10,12,2,1355,1349,2695,1346
2016,10,12,3,1335,1327,2667,1340
2016,10,12,4,1280,1298,2666,1368
2016,10,12,5,1180,1202,2652,1450
2016,10,12,6,1105,1139,2676,1537
2016,10,12,7,1045,1111,2682,1571
2016,10,12,8,1035,1090,2654,1564
2016,10,12,9,1015,1096,2649,1553
2016,10,12,10,1015,1092,2661,1569
2016,10,12,11,1040,1106,2660,1554
2016,10,12,12,1090,1174,2675,1501
2016,10,12,13,1205,1304,2731,1427
2016,10,12,14,1275,1392,2758,1366
2016,10,12,15,1275,1383,2738,1355
2016,10,12,16,1280,1354,2739,1385
2016,10,12,17,1280,1352,2804,1452
2016,10,12,18,1275,1317,2769,1452
2016,10,12,19,1270,1285,2770,1485
2016,10,12,20,1240,1281,2791,1510
2016,10,12,21,1235,1258,2785,1527
2016,10,12,22,1225,1248,2778,1530
2016,10,12,23,1225,1235,2756,1521
2016,10,13,0,1210,1237,2753,1516
2016,10,13,1,1265,1263,2745,1482
2016,10,13,2,1310,1315,2730,1415
2016,10,13,3,1275,1297,2671,1374
2016,10,13,4,1230,1246,2687,1441
2016,10,13,5,1145,1168,2715,1547
2016,10,13,6,1080,1106,2728,1622
2016,10,13,7,1000,1071,2711,1640
2016,10,13,8,985,1056,2671,1615
2016,10,13,9,980,1054,2678,1624
2016,10,13,10,960,1053,2669,1616
2016,10,13,11,995,1071,2692,1621
2016,10,13,12,1030,1130,2766,1636
2016,10,13,13,1125,1252,2757,1505
2016,10,13,14,1195,1338,2739,1401
2016,10,13,15,1200,1329,2684,1355
2016,10,13,16,1205,1320,2661,1341
2016,10,13,17,1205,1309,2636,1327
2016,10,13,18,1185,1295,2648,1353
2016,10,13,19,1125,1282,2674,1392
2016,10,13,20,1170,1148,2681,1533
2016,10,13,21,1165,1265,2679,1414
2016,10,13,22,1160,1250,2673,1423
2016,10,13,23,1160,1255,2673,1418
2016,10,14,0,1130,1252,2672,1420
2016,10,14,1,1180,1287,2696,1409
2016,10,14,2,1225,1315,2707,1392
2016,10,14,3,1195,1279,2702,1423
2016,10,14,4,1135,1236,2691,1455
2016,10,14,5,1095,1145,2695,1550
2016,10,14,6,1025,1080,2662,1582
2016,10,14,7,1005,1042,2609,1567
2016,10,14,8,990,1007,2210,1203
2016,10,14,9,985,973,1909,936
2016,10,14,10,985,983,2068,1085
2016,10,14,11,1000,992,1967,975
2016,10,14,12,1055,1032,1959,927
2016,10,14,13,1180,1148,2350,1202
2016,10,14,14,1265,1252,2465,1213
2016,10,14,15,1270,1261,2474,1213
2016,10,14,16,1265,1270,2532,1262
2016,10,14,17,1260,1294,2672,1378
2016,10,14,18,1230,1289,2685,1396
2016,10,14,19,1200,1243,2516,1273
2016,10,14,20,1200,1232,2337,1105
2016,10,14,21,1190,1221,2332,1111
2016,10,14,22,1180,1208,2252,1044
2016,10,14,23,1175,1208,2259,1051
2016,10,15,0,1185,1210,2254,1044
2016,10,15,1,1200,1231,2265,1034
2016,10,15,2,1230,1240,2341,1101
2016,10,15,3,1210,1220,2265,1045
2016,10,15,4,1175,1173,2205,1032
2016,10,15,5,1085,1115,2295,1180
2016,10,15,6,1025,1055,2280,1225
2016,10,15,7,970,1018,2235,1217
2016,10,15,8,950,989,2183,1194
2016,10,15,9,935,983,2217,1234
2016,10,15,10,925,981,2231,1250
2016,10,15,11,940,975,2142,1167
2016,10,15,12,960,1008,2230,1222
2016,10,15,13,990,1071,2335,1264
2016,10,15,14,1030,1136,2435,1299
2016,10,15,15,1060,1178,2555,1377
2016,10,15,16,1090,1202,2589,1387
2016,10,15,17,1190,1220,2644,1424
2016,10,15,18,1095,1220,2719,1499
2016,10,15,19,1085,1206,2754,1548
2016,10,15,20,1045,1180,2730,1550
2016,10,15,21,1050,1174,2595,1421
2016,10,15,22,1030,1167,2541,1374
2016,10,15,23,1040,1160,2394,1234
2016,10,16,0,1045,1172,2514,1342
2016,10,16,1,1035,1221,2482,1261
2016,10,16,2,1070,1225,2532,1307
2016,10,16,3,1085,1198,2341,1143
2016,10,16,4,1030,1160,2196,1036
2016,10,16,5,985,1096,2113,1017
2016,10,16,6,940,1039,1864,825
2016,10,16,7,965,988,1881,893
2016,10,16,8,930,974,1743,769
2016,10,16,9,905,944,1723,779
2016,10,16,10,910,951,1737,786
2016,10,16,11,930,972,1860,888
2016,10,16,12,935,987,1986,999
2016,10,16,13,965,1039,2195,1156
2016,10,16,14,1020,1111,2333,1222
2016,10,16,15,1060,1165,2594,1429
2016,10,16,16,1095,1212,2674,1462
2016,10,16,17,1215,1216,2674,1458
2016,10,16,18,1115,1218,2670,1452
2016,10,16,19,1115,1225,2676,1451
2016,10,16,20,1110,1215,2618,1403
2016,10,16,21,1110,1208,2656,1448
2016,10,16,22,1125,1197,2650,1453
2016,10,16,23,1135,1213,2624,1411
2016,10,17,0,1165,1222,2586,1364
2016,10,17,1,1200,1258,2587,1329
2016,10,17,2,1225,1309,2703,1394
2016,10,17,3,1205,1270,2620,1350
2016,10,17,4,1140,1212,2586,1374
2016,10,17,5,1065,1141,2562,1421
2016,10,17,6,980,1071,2564,1493
2016,10,17,7,945,1035,2463,1428
2016,10,17,8,935,1010,2403,1393
2016,10,17,9,930,997,2373,1376
2016,10,17,10,920,997,2305,1308
2016,10,17,11,950,1009,2300,1291
2016,10,17,12,1010,1061,2376,1315
2016,10,17,13,1080,1210,2557,1347
2016,10,17,14,1130,1316,2610,1294
2016,10,17,15,1155,1324,2669,1345
2016,10,17,16,1170,1333,2627,1294
2016,10,17,17,1310,1337,2670,1333
2016,10,17,18,1145,1337,2672,1335
2016,10,17,19,1150,1303,2608,1305
2016,10,17,20,1125,1310,2648,1338
2016,10,17,21,1140,1292,2634,1342
2016,10,17,22,1125,1279,2648,1369
2016,10,17,23,1130,1269,2572,1303
2016,10,18,0,1060,1257,2431,1174
2016,10,18,1,1235,1303,2566,1263
2016,10,18,2,1195,1333,2713,1380
2016,10,18,3,1160,1309,2712,1403
2016,10,18,4,1130,1241,2645,1404
2016,10,18,5,1045,1161,2615,1454
2016,10,18,6,980,1086,2562,1476
2016,10,18,7,990,1049,2499,1450
2016,10,18,8,955,1026,2395,1369
2016,10,18,9,925,1018,2384,1366
2016,10,18,10,930,1032,2397,1365
2016,10,18,11,945,1043,2413,1370
2016,10,18,12,995,1091,2492,1401
2016,10,18,13,1105,1227,2658,1431
2016,10,18,14,1200,1321,2715,1394
2016,10,18,15,1225,1293,2698,1405
2016,10,18,16,1250,1281,2701,1420
2016,10,18,17,1245,1285,2723,1438
2016,10,18,18,1225,1264,2716,1452
2016,10,18,19,1225,1261,2701,1440
2016,10,18,20,1215,1267,2708,1441
2016,10,18,21,1200,1241,2710,1469
2016,10,18,22,1190,1244,2697,1453
2016,10,18,23,1180,1258,2659,1401
2016,10,19,0,1180,1249,2607,1358
2016,10,19,1,1205,1288,2472,1184
2016,10,19,2,1255,1320,2383,1063
2016,10,19,3,1235,1288,2278,990
2016,10,19,4,1200,1235,2332,1097
2016,10,19,5,1105,1157,2332,1175
2016,10,19,6,1040,1090,2229,1139
2016,10,19,7,1015,1048,2082,1034
2016,10,19,8,1000,1042,2145,1103
2016,10,19,9,985,1036,2179,1143
2016,10,19,10,985,1022,2308,1286
2016,10,19,11,1005,1036,2385,1349
2016,10,19,12,1055,1088,2495,1407
2016,10,19,13,1215,1212,2518,1306
2016,10,19,14,1310,1317,2495,1178
2016,10,19,15,1320,1310,2557,1247
2016,10,19,16,1320,1304,2607,1303
2016,10,19,17,1325,1286,2622,1336
2016,10,19,18,1315,1309,2641,1332
2016,10,19,19,1295,1273,2648,1375
2016,10,19,20,1275,1255,2647,1392
2016,10,19,21,1275,1238,2637,1399
2016,10,19,22,1265,1231,2632,1401
2016,10,19,23,1260,1227,2650,1423
2016,10,20,0,1255,1227,2637,1410
2016,10,20,1,1280,1264,2632,1368
2016,10,20,2,1315,1298,2613,1315
2016,10,20,3,1285,1270,2620,1350
2016,10,20,4,1280,1217,2567,1350
2016,10,20,5,1135,1145,2560,1415
2016,10,20,6,1080,1098,2596,1498
2016,10,20,7,1005,1072,2590,1518
2016,10,20,8,995,1064,2611,1547
2016,10,20,9,990,1059,2597,1538
2016,10,20,10,995,1070,2598,1528
2016,10,20,11,1030,1074,2538,1464
2016,10,20,12,1085,1128,2581,1453
2016,10,20,13,1195,1220,2619,1399
2016,10,20,14,1195,1311,2610,1299
2016,10,20,15,1260,1313,2585,1272
2016,10,20,16,1270,1320,2605,1285
2016,10,20,17,1280,1321,2657,1336
2016,10,20,18,1250,1311,2624,1313
2016,10,20,19,1250,1290,2660,1370
2016,10,20,20,1155,1267,2702,1435
2016,10,20,21,1230,1268,2697,1429
2016,10,20,22,1230,1263,2699,1436
2016,10,20,23,1240,1263,2638,1375
2016,10,21,0,1215,1263,2684,1421
2016,10,21,1,1250,1291,2711,1420
2016,10,21,2,1290,1316,2788,1472
2016,10,21,3,1270,1298,2775,1477
2016,10,21,4,1230,1248,2636,1388
2016,10,21,5,1135,1162,2523,1361
2016,10,21,6,1055,1105,2560,1455
2016,10,21,7,990,1072,2513,1441
2016,10,21,8,980,1030,2454,1424
2016,10,21,9,980,1022,2457,1435
2016,10,21,10,1015,1021,2444,1423
2016,10,21,11,1025,1029,2499,1470
2016,10,21,12,1075,1093,2575,1482
2016,10,21,13,1175,1184,2633,1449
2016,10,21,14,1270,1274,2636,1362
2016,10,21,15,1290,1277,2642,1365
2016,10,21,16,1280,1274,2619,1345
2016,10,21,17,1260,1265,2613,1348
2016,10,21,18,1265,1256,2630,1374
2016,10,21,19,1225,1240,2649,1409
2016,10,21,20,1190,1231,2631,1400
2016,10,21,21,1175,1229,2628,1399
2016,10,21,22,1175,1217,2653,1436
2016,10,21,23,1180,1198,2601,1403
2016,10,22,0,1185,1194,2577,1383
2016,10,22,1,1205,1227,2569,1342
2016,10,22,2,1225,1239,2567,1328
2016,10,22,3,1190,1222,2561,1339
2016,10,22,4,1150,1181,2502,1321
2016,10,22,5,1070,1118,2517,1399
2016,10,22,6,1015,1068,2426,1358
2016,10,22,7,1000,1021,2410,1389
2016,10,22,8,965,988,2257,1269
2016,10,22,9,960,987,2206,1219
2016,10,22,10,975,978,2047,1069
2016,10,22,11,980,996,1993,997
2016,10,22,12,1000,1000,1990,990
2016,10,22,13,1085,1042,1999,957
2016,10,22,14,1125,1115,2062,947
2016,10,22,15,1145,1140,2196,1056
2016,10,22,16,1165,1183,2481,1298
2016,10,22,17,1200,1163,2549,1386
2016,10,22,18,1205,1154,2596,1442
2016,10,22,19,1170,1155,2701,1546
2016,10,22,20,1140,1149,2696,1547
2016,10,22,21,1135,1133,2589,1456
2016,10,22,22,1140,1123,2584,1461
2016,10,22,23,1140,1143,2580,1437
2016,10,23,0,1145,1148,2557,1409
2016,10,23,1,1195,1194,2615,1421
2016,10,23,2,1210,1221,2614,1393
2016,10,23,3,1185,1211,2685,1474
2016,10,23,4,1155,1165,2658,1493
2016,10,23,5,1085,1126,2618,1492
2016,10,23,6,1035,1069,2595,1526
2016,10,23,7,965,1047,2588,1541
2016,10,23,8,935,1026,2584,1558
2016,10,23,9,920,1025,2594,1569
2016,10,23,10,925,1023,2589,1566
2016,10,23,11,960,1021,2574,1553
2016,10,23,12,990,1040,2555,1515
2016,10,23,13,1025,1086,2563,1477
2016,10,23,14,1110,1142,2567,1425
2016,10,23,15,1165,1185,2553,1368
2016,10,23,16,1200,1210,2562,1352
2016,10,23,17,1200,1199,2583,1384
2016,10,23,18,1195,1194,2600,1406
2016,10,23,19,1195,1183,2591,1408
2016,10,23,20,1190,1162,2580,1418
2016,10,23,21,1195,1152,2635,1483
2016,10,23,22,1175,1133,2625,1492
2016,10,23,23,1200,1173,2674,1501
2016,10,24,0,1200,1190,2675,1485
2016,10,24,1,1205,1257,2690,1433
2016,10,24,2,1260,1278,2680,1402
2016,10,24,3,1215,1256,2677,1421
2016,10,24,4,1190,1215,2680,1465
2016,10,24,5,1100,1132,2683,1551
2016,10,24,6,1040,1064,2679,1615
2016,10,24,7,935,1044,2687,1643
2016,10,24,8,915,1013,2620,1607
2016,10,24,9,900,1007,2600,1593
2016,10,24,10,900,1025,2629,1604
2016,10,24,11,930,1032,2653,1621
2016,10,24,12,970,1096,2692,1596
2016,10,24,13,1110,1230,2683,1453
2016,10,24,14,1230,1337,2714,1377
2016,10,24,15,1235,1331,2702,1371
2016,10,24,16,1240,1340,2697,1357
2016,10,24,17,1225,1327,2655,1328
2016,10,24,18,1220,1331,2680,1349
2016,10,24,19,1205,1301,2678,1377
2016,10,24,20,1205,1301,2682,1381
2016,10,24,21,1215,1281,2689,1408
2016,10,24,22,1210,1277,2692,1415
2016,10,24,23,1210,1291,2668,1377
2016,10,25,0,1195,1302,2675,1373
2016,10,25,1,1220,1350,2682,1332
2016,10,25,2,1250,1354,2680,1326
2016,10,25,3,1235,1335,2679,1344
2016,10,25,4,1230,1270,2672,1402
2016,10,25,5,1070,1183,2638,1455
2016,10,25,6,1015,1099,2382,1283
2016,10,25,7,1010,1071,2399,1328
2016,10,25,8,970,1049,2612,1563
2016,10,25,9,975,1039,2629,1590
2016,10,25,10,995,1049,2715,1666
2016,10,25,11,995,1066,2717,1651
2016,10,25,12,1035,1115,2764,1649
2016,10,25,13,1175,1239,2806,1567
2016,10,25,14,1280,1335,2799,1464
2016,10,25,15,1255,1340,2775,1435
2016,10,25,16,1250,1328,2732,1404
2016,10,25,17,1245,1319,2775,1456
2016,10,25,18,1225,1321,2808,1487
2016,10,25,19,1220,1308,2801,1493
2016,10,25,20,1215,1313,2812,1499
2016,10,25,21,1185,1310,2846,1536
2016,10,25,22,1205,1300,2810,1510
2016,10,25,23,1210,1306,2781,1475
2016,10,26,0,1210,1295,2774,1479
2016,10,26,1,1255,1346,2740,1394
2016,10,26,2,1285,1359,2746,1387
2016,10,26,3,1280,1315,2727,1412
2016,10,26,4,1220,1253,2731,1478
2016,10,26,5,1140,1158,2773,1615
2016,10,26,6,1055,1088,2768,1680
2016,10,26,7,1015,1056,2759,1703
2016,10,26,8,995,1021,2537,1516
2016,10,26,9,985,1008,2393,1385
2016,10,26,10,995,1002,2328,1326
2016,10,26,11,1005,1025,2253,1228
2016,10,26,12,1020,1087,2299,1212
2016,10,26,13,1200,1206,2491,1285
2016,10,26,14,1295,1317,2634,1317
2016,10,26,15,1305,1317,2651,1334
2016,10,26,16,1295,1308,2655,1347
2016,10,26,17,1280,1302,2654,1352
2016,10,26,18,1265,1299,2668,1369
2016,10,26,19,1240,1280,2657,1377
2016,10,26,20,1225,1282,2677,1395
2016,10,26,21,1215,1271,2697,1426
2016,10,26,22,1230,1267,2692,1425
2016,10,26,23,1240,1268,2692,1424
2016,10,27,0,1245,1279,2702,1423
2016,10,27,1,1265,1311,2691,1380
2016,10,27,2,1275,1323,2679,1356
2016,10,27,3,1290,1303,2680,1377
2016,10,27,4,1285,1247,2684,1437
2016,10,27,5,1125,1165,2675,1510
2016,10,27,6,1065,1090,2575,1485
2016,10,27,7,1005,1047,2498,1451
2016,10,27,8,970,1034,2314,1280
2016,10,27,9,965,1002,2191,1189
2016,10,27,10,975,1017,2207,1190
2016,10,27,11,995,1015,2202,1187
2016,10,27,12,1035,1073,2195,1122
2016,10,27,13,1155,1199,2394,1195
2016,10,27,14,1270,1309,2610,1301
2016,10,27,15,1290,1304,2607,1303
2016,10,27,16,1255,1287,2683,1396
2016,10,27,17,1265,1292,2680,1388
2016,10,27,18,1270,1277,2660,1383
2016,10,27,19,1240,1256,2390,1134
2016,10,27,20,1255,1252,2240,988
2016,10,27,21,1240,1249,2182,933
2016,10,27,22,1235,1248,2177,929
2016,10,27,23,1245,1257,2124,867
2016,10,28,0,1250,1249,2013,764
2016,10,28,1,1285,1289,2003,714
2016,10,28,2,1290,1290,2068,778
2016,10,28,3,1260,1268,1985,717
2016,10,28,4,1215,1200,2012,812
2016,10,28,5,1125,1124,2031,907
2016,10,28,6,1045,1089,1782,693
2016,10,28,7,1015,1047,1615,568
2016,10,28,8,995,1028,1531,503
2016,10,28,9,975,1021,1473,452
2016,10,28,10,955,1021,1505,484
2016,10,28,11,995,1016,1508,492
2016,10,28,12,1045,1069,1591,522
2016,10,28,13,1165,1183,1766,583
2016,10,28,14,1270,1221,1786,565
2016,10,28,15,1290,1282,1764,482
2016,10,28,16,1285,1289,1735,446
2016,10,28,17,1270,1284,1709,425
2016,10,28,18,1250,1278,1689,411
2016,10,28,19,1235,1251,1694,443
2016,10,28,20,1235,1231,1669,438
2016,10,28,21,1225,1207,1657,450
2016,10,28,22,1220,1207,1645,438
2016,10,28,23,1225,1201,1581,380
2016,10,29,0,1255,1217,1617,400
2016,10,29,1,1270,1249,1625,376
2016,10,29,2,1285,1254,1608,354
2016,10,29,3,1255,1225,1510,285
2016,10,29,4,1200,1185,1432,247
2016,10,29,5,1120,1130,1427,297
2016,10,29,6,1040,1069,1411,342
2016,10,29,7,985,1031,1484,453
2016,10,29,8,955,1026,1410,384
2016,10,29,9,960,1009,1281,272
2016,10,29,10,955,1000,1272,272
2016,10,29,11,975,1024,1268,244
2016,10,29,12,1000,1027,1412,385
2016,10,29,13,1060,1079,1473,394
2016,10,29,14,1125,1146,1409,263
2016,10,29,15,1145,1178,1498,320
2016,10,29,16,1170,1216,1514,298
2016,10,29,17,1155,1231,1460,229
2016,10,29,18,1130,1221,1458,237
2016,10,29,19,1135,1200,1473,273
2016,10,29,20,1125,1170,1444,274
2016,10,29,21,1115,1151,1420,269
2016,10,29,22,1100,1148,1408,260
2016,10,29,23,1110,1162,1402,240
2016,10,30,0,1115,1181,1402,221
2016,10,30,1,1160,1234,1461,227
2016,10,30,2,1205,1233,1516,283
2016,10,30,3,1185,1211,1433,222
2016,10,30,4,1140,1174,1455,281
2016,10,30,5,1065,1122,1502,380
2016,10,30,6,1015,1056,1521,465
2016,10,30,7,950,1025,1435,410
2016,10,30,8,920,997,1339,342
2016,10,30,9,905,997,1345,348
2016,10,30,10,905,984,1350,366
2016,10,30,11,935,998,1345,347
2016,10,30,12,960,1003,1371,368
2016,10,30,13,1005,1040,1424,384
2016,10,30,14,1095,1094,1429,335
2016,10,30,15,1150,1144,1503,359
2016,10,30,16,1185,1157,1563,406
2016,10,30,17,1180,1163,1580,417
2016,10,30,18,1180,1161,1668,507
2016,10,30,19,1175,1162,1654,492
2016,10,30,20,1165,1136,1605,469
2016,10,30,21,1170,1137,1594,457
2016,10,30,22,1160,1141,1568,427
2016,10,30,23,1180,1166,1663,497
2016,10,31,0,1185,1204,1686,482
2016,10,31,1,1200,1273,1738,465
2016,10,31,2,1250,1264,1762,498
2016,10,31,3,1205,1250,1742,492
2016,10,31,4,1180,1189,1757,568
2016,10,31,5,1090,1116,1710,594
2016,10,31,6,1030,1037,1676,639
2016,10,31,7,985,996,1582,586
2016,10,31,8,965,969,1248,279
2016,10,31,9,945,959,1219,260
2016,10,31,10,955,964,1238,274
2016,10,31,11,985,985,1269,284
2016,10,31,12,1015,1047,1380,333
2016,10,31,13,1165,1179,1631,452
2016,10,31,14,1275,1294,1628,334
2016,10,31,15,1290,1295,1822,527
2016,10,31,16,1295,1299,1843,544
2016,10,31,17,1275,1294,1758,464
2016,10,31,18,1270,1290,1741,451
2016,10,31,19,1245,1278,1863,585
2016,10,31,20,1250,1269,1876,607
2016,10,31,21,1255,1271,1882,611
2016,10,31,22,1245,1273,1830,557
2016,10,31,23,1245,1282,1846,564
2016,11,1,0,1240,1269,1840,571
2016,11,1,1,1275,1300,1855,555
2016,11,1,2,1290,1279,1813,534
2016,11,1,3,1275,1268,1819,551
2016,11,1,4,1195,1236,1877,641
2016,11,1,5,1110,1153,1848,695
2016,11,1,6,1055,1088,1698,610
2016,11,1,7,1000,1060,1616,556
2016,11,1,8,990,1043,1729,686
2016,11,1,9,980,1045,1672,627
2016,11,1,10,970,1044,1746,702
2016,11,1,11,1005,1068,1860,792
2016,11,1,12,1080,1082,1945,863
2016,11,1,13,1200,1205,1961,756
2016,11,1,14,1290,1317,2120,803
2016,11,1,15,1255,1296,2304,1008
2016,11,1,16,1240,1304,2443,1139
2016,11,1,17,1240,1301,2499,1198
2016,11,1,18,1220,1282,2476,1194
2016,11,1,19,1220,1261,2421,1160
2016,11,1,20,1210,1260,2421,1161
2016,11,1,21,1180,1246,2343,1097
2016,11,1,22,1210,1227,2312,1085
2016,11,1,23,1210,1236,2405,1169
2016,11,2,0,1205,1256,2523,1267
2016,11,2,1,1250,1327,2593,1266
2016,11,2,2,1280,1347,2640,1293
2016,11,2,3,1275,1319,2633,1314
2016,11,2,4,1190,1259,2596,1337
2016,11,2,5,1135,1157,2538,1381
2016,11,2,6,1045,1105,2544,1439
2016,11,2,7,1035,1056,2417,1361
2016,11,2,8,1005,1044,2357,1313
2016,11,2,9,990,1040,2387,1347
2016,11,2,10,1000,1036,2420,1384
2016,11,2,11,1020,1053,2403,1350
2016,11,2,12,1085,1113,2445,1332
2016,11,2,13,1190,1247,2573,1326
2016,11,2,14,1250,1348,2709,1361
2016,11,2,15,1270,1342,2669,1327
2016,11,2,16,1270,1314,2676,1362
2016,11,2,17,1240,1308,2742,1434
2016,11,2,18,1250,1273,2738,1465
2016,11,2,19,1230,1261,2682,1421
2016,11,2,20,1210,1267,2661,1394
2016,11,2,21,1200,1259,2659,1400
2016,11,2,22,1200,1244,2632,1388
2016,11,2,23,1215,1242,2654,1412
2016,11,3,0,1215,1245,2723,1478
2016,11,3,1,1235,1333,2739,1406
2016,11,3,2,1250,1325,2704,1379
2016,11,3,3,1225,1317,2709,1392
2016,11,3,4,1150,1263,2648,1385
2016,11,3,5,1100,1175,2505,1330
2016,11,3,6,1045,1106,2467,1361
2016,11,3,7,1020,1054,2387,1333
2016,11,3,8,1000,1041,2253,1212
2016,11,3,9,1010,1030,2110,1080
2016,11,3,10,1000,1046,2078,1032
2016,11,3,11,1010,1056,2106,1050
2016,11,3,12,1075,1143,2282,1139
2016,11,3,13,1210,1263,2459,1196
2016,11,3,14,1300,1364,2563,1199
2016,11,3,15,1285,1360,2647,1287
2016,11,3,16,1275,1334,2711,1377
2016,11,3,17,1275,1311,2690,1379
2016,11,3,18,1245,1289,2659,1370
2016,11,3,19,1235,1267,2659,1392
2016,11,3,20,1175,1260,2607,1347
2016,11,3,21,1225,1250,2641,1391
2016,11,3,22,1205,1234,2555,1321
2016,11,3,23,1225,1215,2578,1363
2016,11,4,0,1205,1216,2570,1354
2016,11,4,1,1245,1303,2647,1344
2016,11,4,2,1285,1335,2669,1334
2016,11,4,3,1255,1299,2643,1344
2016,11,4,4,1215,1207,2635,1428
2016,11,4,5,1120,1163,2594,1431
2016,11,4,6,1050,1086,2504,1418
2016,11,4,7,1020,1041,2429,1388
2016,11,4,8,1000,1022,2304,1282
2016,11,4,9,1005,1023,2261,1238
2016,11,4,10,1005,1027,2204,1177
2016,11,4,11,1020,1032,2228,1196
2016,11,4,12,1120,1096,2310,1214
2016,11,4,13,1235,1222,2530,1308
2016,11,4,14,1315,1324,2662,1338
2016,11,4,15,1310,1321,2673,1352
2016,11,4,16,1295,1304,2658,1354
2016,11,4,17,1300,1282,2619,1337
2016,11,4,18,1290,1274,2625,1351
2016,11,4,19,1255,1245,2580,1335
2016,11,4,20,1240,1236,2645,1409
2016,11,4,21,1230,1214,2627,1413
2016,11,4,22,1225,1208,2610,1402
2016,11,4,23,1240,1220,2651,1431
2016,11,5,0,1255,1207,2658,1451
2016,11,5,1,1295,1267,2732,1465
2016,11,5,2,1285,1282,2699,1417
2016,11,5,3,1280,1254,2652,1398
2016,11,5,4,1240,1218,2609,1391
2016,11,5,5,1160,1162,2555,1393
2016,11,5,6,1090,1100,2324,1224
2016,11,5,7,985,1053,2283,1230
2016,11,5,8,975,1042,2274,1232
2016,11,5,9,975,1040,2200,1160
2016,11,5,10,965,1034,2114,1080
2016,11,5,11,985,1051,2103,1052
2016,11,5,12,1010,1068,2088,1020
2016,11,5,13,1055,1106,2138,1032
2016,11,5,14,1105,1187,2429,1242
2016,11,5,15,1130,1226,2333,1107
2016,11,5,16,1160,1247,2507,1260
2016,11,5,17,1155,1223,2553,1330
2016,11,5,18,1140,1225,2558,1333
2016,11,5,19,1145,1201,2537,1336
2016,11,5,20,1125,1164,2516,1352
2016,11,5,21,1100,1145,2418,1273
2016,11,5,22,1085,1129,2204,1075
2016,11,5,23,1090,1127,2110,983
2016,11,6,0,1100,1148,2115,967
2016,11,6,1,1150,1220,2343,1123
2016,11,6,2,1185,1245,2528,1283
2016,11,6,3,1165,1235,2558,1323
2016,11,6,4,1125,1202,2537,1335
2016,11,6,5,1060,1137,2432,1295
2016,11,6,6,1005,1080,2385,1305
2016,11,6,7,1025,729,1925,1196
2016,11,6,8,1000,970,1871,901
2016,11,6,9,985,1041,1873,832
2016,11,6,10,1000,1097,1920,823
2016,11,6,11,995,1065,1966,901
2016,11,6,12,1010,1043,1827,784
2016,11,6,13,1030,1061,1784,723
2016,11,6,14,1075,1096,1825,729
2016,11,6,15,1130,1165,1811,646
2016,11,6,16,1170,1230,2060,830
2016,11,6,17,1175,1252,2144,892
2016,11,6,18,1170,1263,2290,1027
2016,11,6,19,1165,1233,2176,943
2016,11,6,20,1160,1221,2190,969
2016,11,6,21,1135,1203,2050,847
2016,11,6,22,1125,1197,2104,907
2016,11,6,23,1120,1189,2113,924
2016,11,7,0,1140,1229,2273,1044
2016,11,7,1,1180,1329,2471,1142
2016,11,7,2,1240,1353,2626,1273
2016,11,7,3,1255,1317,2592,1275
2016,11,7,4,1215,1272,2557,1285
2016,11,7,5,1170,1195,2590,1395
2016,11,7,6,1090,1121,2520,1399
2016,11,7,7,1010,909,2296,1387
2016,11,7,8,1005,1027,2295,1268
2016,11,7,9,990,1007,1972,965
2016,11,7,10,980,1004,1947,943
2016,11,7,11,995,1015,1916,901
2016,11,7,12,995,1030,1946,916
2016,11,7,13,1065,1111,2191,1080
2016,11,7,14,1205,1252,2410,1158
2016,11,7,15,1320,1339,2708,1369
2016,11,7,16,1315,1323,2707,1384
2016,11,7,17,1325,1318,2670,1352
2016,11,7,18,1305,1309,2711,1402
2016,11,7,19,1290,1312,2710,1398
2016,11,7,20,1260,1292,2764,1472
2016,11,7,21,1260,1279,2644,1365
2016,11,7,22,1250,1275,2719,1444
2016,11,7,23,1245,1259,2654,1395
2016,11,8,0,1250,1263,2730,1467
2016,11,8,1,1260,1345,2712,1367
2016,11,8,2,1305,1380,2686,1306
2016,11,8,3,1320,1347,2667,1320
2016,11,8,4,1300,1301,2669,1368
2016,11,8,5,1300,1232,2596,1364
2016,11,8,6,1155,1140,2471,1331
2016,11,8,7,1085,1068,2301,1233
2016,11,8,8,1020,1029,2215,1186
2016,11,8,9,980,1031,2279,1248
2016,11,8,10,990,1015,2204,1189
2016,11,8,11,1005,1017,2089,1072
2016,11,8,12,1020,1055,2130,1075
2016,11,8,13,1095,1129,2412,1283
2016,11,8,14,1220,1268,2652,1384
2016,11,8,15,1300,1349,2635,1286
2016,11,8,16,1310,1337,2628,1291
2016,11,8,17,1285,1322,2677,1355
2016,11,8,18,1280,1313,2674,1361
2016,11,8,19,1275,1300,2664,1364
2016,11,8,20,1260,1272,2630,1358
2016,11,8,21,1285,1278,2597,1319
2016,11,8,22,1280,1282,2575,1293
2016,11,8,23,1255,1260,2594,1334
2016,11,9,0,1260,1284,2671,1387
2016,11,9,1,1255,1340,2696,1356
2016,11,9,2,1310,1359,2690,1331
2016,11,9,3,1315,1342,2685,1343
2016,11,9,4,1285,1287,2619,1332
2016,11,9,5,1225,1235,2597,1362
2016,11,9,6,1135,1160,2509,1349
2016,11,9,7,1060,1100,2338,1238
2016,11,9,8,1015,1053,2192,1139
2016,11,9,9,1025,1029,2231,1202
2016,11,9,10,1000,1027,2078,1051
2016,11,9,11,1010,1037,2298,1261
2016,11,9,12,1035,1056,2180,1124
2016,11,9,13,1095,1130,2415,1285
2016,11,9,14,1225,1266,2478,1212
2016,11,9,15,1310,1350,2698,1348
2016,11,9,16,1315,1322,2730,1408
2016,11,9,17,1295,1288,2707,1419
2016,11,9,18,1275,1299,2688,1389
2016,11,9,19,1270,1281,2485,1204
2016,11,9,20,1255,1258,2419,1161
2016,11,9,21,1245,1248,2385,1137
2016,11,9,22,1230,1263,2398,1135
2016,11,9,23,1230,1263,2337,1074
2016,11,10,0,1245,1276,2375,1099
2016,11,10,1,1275,1352,2438,1086
2016,11,10,2,1300,1356,2370,1014
2016,11,10,3,1305,1331,2361,1030
2016,11,10,4,1275,1280,2313,1033
2016,11,10,5,1225,1219,2240,1021
2016,11,10,6,1135,1146,2258,1112
2016,11,10,7,1055,1081,2282,1201
2016,11,10,8,1015,1043,2210,1167
2016,11,10,9,985,1034,2198,1164
2016,11,10,10,985,1029,1991,962
2016,11,10,11,1005,1028,1975,947
2016,11,10,12,1010,1043,1960,917
2016,11,10,13,1090,1111,2193,1082
2016,11,10,14,1235,1247,2327,1080
2016,11,10,15,1350,1316,2343,1027
2016,11,10,16,1345,1297,2311,1014
2016,11,10,17,1320,1285,2306,1021
2016,11,10,18,1295,1275,2266,991
2016,11,10,19,1265,1258,2285,1027
2016,11,10,20,1260,1249,2296,1047
2016,11,10,21,1235,1240,2288,1048
2016,11,10,22,1230,1221,2297,1076
2016,11,10,23,1210,1224,2300,1076
2016,11,11,0,1205,1242,2309,1067
2016,11,11,1,1235,1331,2331,1000
2016,11,11,2,1290,1337,2321,984
2016,11,11,3,1305,1327,2319,992
2016,11,11,4,1270,1285,2326,1041
2016,11,11,5,1190,1223,2265,1042
2016,11,11,6,1140,1142,2259,1117
2016,11,11,7,1075,1096,2245,1149
2016,11,11,8,1015,1058,2110,1052
2016,11,11,9,1015,1029,2049,1020
2016,11,11,10,1005,1042,2054,1012
2016,11,11,11,990,1043,2024,981
2016,11,11,12,1005,1067,2047,980
2016,11,11,13,1060,1113,2153,1040
2016,11,11,14,1195,1230,2247,1017
2016,11,11,15,1290,1296,2307,1011
2016,11,11,16,1305,1300,2291,991
2016,11,11,17,1280,1279,2319,1040
2016,11,11,18,1270,1280,2311,1031
2016,11,11,19,1260,1265,2310,1045
2016,11,11,20,1225,1246,2323,1077
2016,11,11,21,1210,1235,2326,1091
2016,11,11,22,1190,1207,2291,1084
2016,11,11,23,1185,1201,2285,1084
2016,11,12,0,1195,1226,2310,1084
2016,11,12,1,1210,1292,2313,1021
2016,11,12,2,1250,1294,2332,1038
2016,11,12,3,1255,1267,2307,1040
2016,11,12,4,1215,1253,2322,1069
2016,11,12,5,1185,1200,2206,1006
2016,11,12,6,1110,1147,2236,1089
2016,11,12,7,1055,1086,2107,1021
2016,11,12,8,990,1043,2071,1028
2016,11,12,9,995,1029,2038,1009
2016,11,12,10,990,1008,1845,837
2016,11,12,11,985,1005,1845,840
2016,11,12,12,1010,1031,1913,882
2016,11,12,13,1030,1047,1900,853
2016,11,12,14,1100,1099,1945,846
2016,11,12,15,1175,1148,2054,906
2016,11,12,16,1210,1191,2183,992
2016,11,12,17,1210,1198,2148,950
2016,11,12,18,1200,1195,2315,1120
2016,11,12,19,1180,1192,2395,1203
2016,11,12,20,1170,1197,2238,1041
2016,11,12,21,1145,1171,2028,857
2016,11,12,22,1130,1153,2018,865
2016,11,12,23,1120,1173,2031,858
2016,11,13,0,1120,1194,1929,735
2016,11,13,1,1160,1258,1965,707
2016,11,13,2,1200,1250,2012,762
2016,11,13,3,1215,1219,1964,745
2016,11,13,4,1195,1204,1952,748
2016,11,13,5,1150,1141,1957,816
2016,11,13,6,1100,1098,1917,819
2016,11,13,7,1050,1042,1870,828
2016,11,13,8,1020,1012,1852,840
2016,11,13,9,995,988,1950,962
2016,11,13,10,990,993,1905,912
2016,11,13,11,980,980,1914,934
2016,11,13,12,1000,1001,1982,981
2016,11,13,13,1020,1014,2055,1041
2016,11,13,14,1085,1070,2289,1219
2016,11,13,15,1135,1110,2407,1297
2016,11,13,16,1165,1150,2483,1333
2016,11,13,17,1165,1178,2491,1313
2016,11,13,18,1160,1171,2502,1331
2016,11,13,19,1165,1176,2533,1357
2016,11,13,20,1165,1181,2576,1395
2016,11,13,21,1135,1175,2636,1461
2016,11,13,22,1125,1188,2640,1452
2016,11,13,23,1130,1181,2624,1443
2016,11,14,0,1155,1230,2643,1413
2016,11,14,1,1220,1319,2684,1365
2016,11,14,2,1265,1316,2641,1325
2016,11,14,3,1260,1290,2599,1309
2016,11,14,4,1210,1241,2335,1094
2016,11,14,5,1150,1176,2117,941
2016,11,14,6,1080,1097,2078,981
2016,11,14,7,995,1036,2051,1015
2016,11,14,8,970,1010,2030,1020
2016,11,14,9,985,974,1861,887
2016,11,14,10,990,972,1804,832
2016,11,14,11,1000,980,1766,786
2016,11,14,12,1020,992,1740,748
2016,11,14,13,1090,1067,2130,1063
2016,11,14,14,1220,1214,2461,1247
2016,11,14,15,1310,1310,2606,1296
2016,11,14,16,1290,1313,2593,1280
2016,11,14,17,1285,1308,2525,1217
2016,11,14,18,1280,1302,2419,1117
2016,11,14,19,1270,1294,2451,1157
2016,11,14,20,1245,1301,2584,1283
2016,11,14,21,1235,1307,2576,1269
2016,11,14,22,1225,1305,2588,1283
2016,11,14,23,1230,1312,2644,1332
2016,11,15,0,1235,1336,2649,1313
2016,11,15,1,1280,1414,2779,1365
2016,11,15,2,1310,1399,2744,1345
2016,11,15,3,1310,1364,2674,1310
2016,11,15,4,1285,1307,2381,1074
2016,11,15,5,1185,1240,2229,989
2016,11,15,6,1130,1148,2213,1065
2016,11,15,7,1065,1093,2252,1159
2016,11,15,8,1015,1045,2177,1132
2016,11,15,9,980,1006,2123,1117
2016,11,15,10,950,997,2168,1171
2016,11,15,11,955,1007,2130,1123
2016,11,15,12,985,1036,2155,1119
2016,11,15,13,1050,1109,2425,1316
2016,11,15,14,1190,1256,2559,1303
2016,11,15,15,1300,1314,2631,1317
2016,11,15,16,1295,1313,2626,1313
2016,11,15,17,1300,1291,2480,1189
2016,11,15,18,1280,1279,2361,1082
2016,11,15,19,1255,1298,2338,1040
2016,11,15,20,1240,1274,2097,823
2016,11,15,21,1230,1291,2121,830
2016,11,15,22,1220,1280,1925,645
2016,11,15,23,1205,1276,1852,576
2016,11,16,0,1230,1322,2008,686
2016,11,16,1,1265,1393,2325,932
2016,11,16,2,1300,1399,2548,1149
2016,11,16,3,1300,1369,2385,1016
2016,11,16,4,1260,1329,2033,704
2016,11,16,5,1205,1263,2012,749
2016,11,16,6,1120,1187,1960,773
2016,11,16,7,1065,1109,1864,755
2016,11,16,8,1050,1081,1831,750
2016,11,16,9,1035,1076,1817,741
2016,11,16,10,1030,1061,1843,782
2016,11,16,11,1050,1061,1835,774
2016,11,16,12,1060,1090,1937,847
2016,11,16,13,1110,1176,2286,1110
2016,11,16,14,1230,1278,2486,1208
2016,11,16,15,1295,1355,2660,1305
2016,11,16,16,1275,1348,2646,1298
2016,11,16,17,1255,1341,2604,1263
2016,11,16,18,1265,1324,2564,1240
2016,11,16,19,1255,1313,2583,1270
2016,11,16,20,1240,1317,2546,1229
2016,11,16,21,1240,1305,2567,1262
2016,11,16,22,1235,1315,2613,1298
2016,11,16,23,1235,1327,2602,1275
2016,11,17,0,1275,1369,2664,1295
2016,11,17,1,1335,1428,2673,1245
2016,11,17,2,1345,1435,2673,1238
2016,11,17,3,1305,1423,2651,1228
2016,11,17,4,1290,1376,2304,928
2016,11,17,5,1220,1307,2232,925
2016,11,17,6,1120,1234,2228,994
2016,11,17,7,1055,1170,2156,986
2016,11,17,8,1060,1132,2139,1007
2016,11,17,9,1050,1118,2135,1017
2016,11,17,10,1045,1118,2125,1007
2016,11,17,11,1050,1132,2133,1001
2016,11,17,12,1070,1153,2133,980
2016,11,17,13,1130,1221,2480,1259
2016,11,17,14,1285,1351,2624,1273
2016,11,17,15,1350,1424,2711,1287
2016,11,17,16,1355,1410,2709,1299
2016,11,17,17,1340,1418,2684,1266
2016,11,17,18,1310,1405,2690,1285
2016,11,17,19,1320,1397,2656,1259
2016,11,17,20,1295,1373,2608,1235
2016,11,17,21,1305,1367,2581,1214
2016,11,17,22,1310,1380,2606,1226
2016,11,17,23,1310,1371,2604,1233
2016,11,18,0,1350,1408,2607,1199
2016,11,18,1,1440,1476,2651,1175
2016,11,18,2,1435,1465,2617,1152
2016,11,18,3,1385,1457,2615,1158
2016,11,18,4,1360,1424,2628,1204
2016,11,18,5,1310,1357,2617,1260
2016,11,18,6,1225,1276,2606,1330
2016,11,18,7,1145,1202,2434,1232
2016,11,18,8,1090,1175,2413,1238
2016,11,18,9,1080,1147,2234,1087
2016,11,18,10,1070,1145,2250,1105
2016,11,18,11,1075,1150,2223,1073
2016,11,18,12,1110,1175,2263,1088
2016,11,18,13,1170,1246,2366,1120
2016,11,18,14,1295,1353,2494,1141
2016,11,18,15,1365,1427,2531,1104
2016,11,18,16,1340,1418,2498,1080
2016,11,18,17,1320,1412,2498,1086
2016,11,18,18,1315,1391,2510,1119
2016,11,18,19,1295,1368,2508,1140
2016,11,18,20,1295,1351,2498,1147
2016,11,18,21,1285,1336,2499,1163
2016,11,18,22,1290,1319,2507,1188
2016,11,18,23,1295,1329,2485,1156
2016,11,19,0,1325,1369,2507,1138
2016,11,19,1,1395,1436,2540,1104
2016,11,19,2,1415,1420,2539,1119
2016,11,19,3,1385,1402,2527,1125
2016,11,19,4,1355,1358,2422,1064
2016,11,19,5,1290,1316,2367,1051
2016,11,19,6,1240,1257,2386,1129
2016,11,19,7,1160,1194,2427,1233
2016,11,19,8,1100,1160,2406,1246
2016,11,19,9,1095,1132,2348,1216
2016,11,19,10,1085,1123,2389,1266
2016,11,19,11,1075,1119,2387,1268
2016,11,19,12,1085,1137,2395,1258
2016,11,19,13,1130,1162,2377,1215
2016,11,19,14,1180,1222,2363,1141
2016,11,19,15,1230,1272,2431,1159
2016,11,19,16,1250,1311,2475,1164
2016,11,19,17,1250,1344,2545,1201
2016,11,19,18,1230,1341,2548,1207
2016,11,19,19,1230,1314,2529,1215
2016,11,19,20,1215,1286,2522,1236
2016,11,19,21,1205,1264,2523,1259
2016,11,19,22,1180,1260,2525,1265
2016,11,19,23,1175,1254,2534,1280
2016,11,20,0,1205,1318,2554,1236
2016,11,20,1,1300,1395,2557,1162
2016,11,20,2,1320,1389,2608,1219
2016,11,20,3,1300,1359,2638,1279
2016,11,20,4,1260,1325,2642,1317
2016,11,20,5,1220,1279,2667,1388
2016,11,20,6,1155,1216,2666,1450
2016,11,20,7,1080,1170,2621,1451
2016,11,20,8,1040,1117,2598,1481
2016,11,20,9,1035,1109,2560,1451
2016,11,20,10,1030,1087,2487,1400
2016,11,20,11,1020,1080,2481,1401
2016,11,20,12,1030,1090,2506,1416
2016,11,20,13,1075,1106,2453,1347
2016,11,20,14,1160,1164,2577,1413
2016,11,20,15,1245,1205,2478,1273
2016,11,20,16,1265,1250,2583,1333
2016,11,20,17,1275,1275,2589,1314
2016,11,20,18,1245,1280,2603,1323
2016,11,20,19,1245,1260,2596,1336
2016,11,20,20,1220,1271,2593,1322
2016,11,20,21,1210,1247,2613,1366
2016,11,20,22,1185,1249,2624,1375
2016,11,20,23,1175,1256,2560,1304
2016,11,21,0,1205,1321,2548,1227
2016,11,21,1,1310,1394,2645,1251
2016,11,21,2,1340,1395,2664,1269
2016,11,21,3,1325,1370,2616,1246
2016,11,21,4,1275,1334,2619,1285
2016,11,21,5,1205,1281,2605,1324
2016,11,21,6,1175,1196,2471,1275
2016,11,21,7,1090,1133,2443,1310
2016,11,21,8,1080,1088,2248,1160
2016,11,21,9,1065,1077,1985,908
2016,11,21,10,1055,1062,1988,926
2016,11,21,11,1050,1109,2079,970
2016,11,21,12,1080,1136,2232,1096
2016,11,21,13,1155,1199,2463,1264
2016,11,21,14,1300,1327,2587,1260
2016,11,21,15,1355,1404,2597,1193
2016,11,21,16,1375,1392,2626,1234
2016,11,21,17,1305,1390,2614,1224
2016,11,21,18,1305,1388,2624,1236
2016,11,21,19,1300,1374,2624,1250
2016,11,21,20,1280,1378,2568,1190
2016,11,21,21,1285,1376,2566,1190
2016,11,21,22,1275,1367,2440,1073
2016,11,21,23,1275,1350,2500,1150
2016,11,22,0,1310,1380,2520,1140
2016,11,22,1,1385,1456,2723,1267
2016,11,22,2,1390,1454,2726,1272
2016,11,22,3,1375,1434,2696,1262
2016,11,22,4,1345,1376,2673,1297
2016,11,22,5,1285,1325,2665,1340
2016,11,22,6,1180,1247,2591,1344
2016,11,22,7,1120,1177,2467,1290
2016,11,22,8,1090,1137,2328,1191
2016,11,22,9,1080,1121,2380,1259
2016,11,22,10,1080,1108,2444,1336
2016,11,22,11,1115,1109,2462,1353
2016,11,22,12,1135,1137,2484,1347
2016,11,22,13,1195,1205,2485,1280
2016,11,22,14,1300,1339,2619,1280
2016,11,22,15,1375,1428,2702,1274
2016,11,22,16,1345,1405,2734,1329
2016,11,22,17,1330,1389,2700,1311
2016,11,22,18,1310,1371,2670,1299
2016,11,22,19,1295,1351,2681,1330
2016,11,22,20,1300,1335,2661,1326
2016,11,22,21,1245,1314,2550,1236
2016,11,22,22,1275,1299,2558,1259
2016,11,22,23,1290,1315,2638,1323
2016,11,23,0,1335,1340,2617,1277
2016,11,23,1,1390,1429,2621,1192
2016,11,23,2,1405,1425,2616,1191
2016,11,23,3,1365,1424,2622,1198
2016,11,23,4,1350,1409,2637,1228
2016,11,23,5,1280,1349,2548,1199
2016,11,23,6,1200,1271,2532,1261
2016,11,23,7,1125,1210,2454,1244
2016,11,23,8,1090,1182,2452,1270
2016,11,23,9,1085,1159,2498,1339
2016,11,23,10,1070,1147,2492,1345
2016,11,23,11,1085,1140,2488,1348
2016,11,23,12,1115,1164,2567,1403
2016,11,23,13,1185,1196,2577,1381
2016,11,23,14,1275,1307,2581,1274
2016,11,23,15,1345,1390,2626,1236
2016,11,23,16,1335,1412,2644,1232
2016,11,23,17,1320,1417,2640,1223
2016,11,23,18,1305,1410,2682,1272
2016,11,23,19,1290,1387,2671,1284
2016,11,23,20,1305,1375,2690,1315
2016,11,23,21,1285,1366,2687,1321
2016,11,23,22,1300,1364,2718,1354
2016,11,23,23,1300,1353,2648,1295
2016,11,24,0,1335,1385,2647,1262
2016,11,24,1,1395,1464,2685,1221
2016,11,24,2,1410,1431,2659,1228
2016,11,24,3,1370,1425,2663,1238
2016,11,24,4,1340,1411,2683,1272
2016,11,24,5,1290,1357,2684,1327
2016,11,24,6,1205,1280,2528,1248
2016,11,24,7,1120,1217,2459,1242
2016,11,24,8,1130,1180,2422,1242
2016,11,24,9,1090,1143,2363,1220
2016,11,24,10,1095,1135,2351,1216
2016,11,24,11,1095,1147,2383,1236
2016,11,24,12,1115,1153,2409,1256
2016,11,24,13,1145,1170,2525,1355
2016,11,24,14,1205,1213,2537,1324
2016,11,24,15,1270,1278,2651,1373
2016,11,24,16,1295,1323,2654,1331
2016,11,24,17,1305,1353,2645,1292
2016,11,24,18,1305,1378,2755,1377
2016,11,24,19,1290,1374,2803,1429
2016,11,24,20,1265,1363,2755,1392
2016,11,24,21,1235,1292,2651,1359
2016,11,24,22,1230,1247,2586,1339
2016,11,24,23,1230,1226,2583,1357
2016,11,25,0,1280,1232,2509,1277
2016,11,25,1,1360,1263,2482,1219
2016,11,25,2,1355,1268,2497,1229
2016,11,25,3,1335,1269,2487,1218
2016,11,25,4,1310,1273,2446,1173
2016,11,25,5,1270,1240,2332,1092
2016,11,25,6,1185,1203,2295,1092
2016,11,25,7,1125,1160,2190,1030
2016,11,25,8,1100,1127,1948,821
2016,11,25,9,1080,1098,1832,734
2016,11,25,10,1070,1088,1521,433
2016,11,25,11,1075,1092,1495,403
2016,11,25,12,1095,1095,1497,402
2016,11,25,13,1115,1145,1831,686
2016,11,25,14,1190,1202,2105,903
2016,11,25,15,1245,1274,2370,1096
2016,11,25,16,1270,1302,2563,1261
2016,11,25,17,1285,1323,2534,1211
2016,11,25,18,1285,1313,2528,1215
2016,11,25,19,1270,1304,2562,1258
2016,11,25,20,1260,1276,2581,1305
2016,11,25,21,1235,1281,2591,1310
2016,11,25,22,1225,1256,2455,1199
2016,11,25,23,1235,1254,2499,1245
2016,11,26,0,1295,1315,2555,1240
2016,11,26,1,1360,1389,2748,1359
2016,11,26,2,1360,1367,2638,1271
2016,11,26,3,1340,1349,2720,1371
2016,11,26,4,1315,1315,2639,1324
2016,11,26,5,1275,1279,2618,1339
2016,11,26,6,1185,1209,2572,1363
2016,11,26,7,1120,1157,2554,1397
2016,11,26,8,1130,1132,2532,1400
2016,11,26,9,1090,1108,2519,1411
2016,11,26,10,1095,1093,2492,1399
2016,11,26,11,1095,1108,2489,1381
2016,11,26,12,1115,1105,2466,1361
2016,11,26,13,1140,1136,2496,1360
2016,11,26,14,1205,1193,2481,1288
2016,11,26,15,1260,1230,2473,1243
2016,11,26,16,1285,1263,2482,1219
2016,11,26,17,1295,1283,2538,1255
2016,11,26,18,1295,1276,2608,1332
2016,11,26,19,1280,1260,2615,1355
2016,11,26,20,1255,1244,2621,1377
2016,11,26,21,1230,1225,2557,1332
2016,11,26,22,1220,1227,2559,1332
2016,11,26,23,1220,1225,2526,1301
2016,11,27,0,1270,1282,2540,1258
2016,11,27,1,1350,1380,2674,1294
2016,11,27,2,1345,1363,2655,1292
2016,11,27,3,1325,1348,2645,1297
2016,11,27,4,1300,1323,2636,1313
2016,11,27,5,1260,1280,2544,1264
2016,11,27,6,1180,1225,2566,1341
2016,11,27,7,1120,1161,2529,1368
2016,11,27,8,1100,1124,2269,1145
2016,11,27,9,1105,1100,2184,1084
2016,11,27,10,1080,1083,2002,919
2016,11,27,11,1085,1088,1997,909
2016,11,27,12,1110,1089,1966,877
2016,11,27,13,1125,1113,1883,770
2016,11,27,14,1200,1162,1919,757
2016,11,27,15,1245,1215,1961,746
2016,11,27,16,1270,1250,1967,717
2016,11,27,17,1290,1276,2062,786
2016,11,27,18,1295,1275,1980,705
2016,11,27,19,1275,1262,1939,677
2016,11,27,20,1285,1271,2031,760
2016,11,27,21,1255,1279,2247,968
2016,11,27,22,1245,1283,2316,1033
2016,11,27,23,1260,1298,2530,1232
2016,11,28,0,1330,1361,2547,1186
2016,11,28,1,1385,1457,2654,1197
2016,11,28,2,1395,1454,2659,1205
2016,11,28,3,1380,1418,2655,1237
2016,11,28,4,1345,1379,2620,1241
2016,11,28,5,1295,1329,2589,1260
2016,11,28,6,1205,1242,2542,1300
2016,11,28,7,1140,1172,2498,1326
2016,11,28,8,1110,1133,2228,1095
2016,11,28,9,1100,1108,2030,922
2016,11,28,10,1080,1097,1948,851
2016,11,28,11,1110,1101,1954,853
2016,11,28,12,1140,1112,1976,864
2016,11,28,13,1210,1173,2090,917
2016,11,28,14,1320,1326,2369,1043
2016,11,28,15,1410,1438,2675,1237
2016,11,28,16,1415,1426,2673,1247
2016,11,28,17,1390,1431,2630,1199
2016,11,28,18,1405,1417,2675,1258
2016,11,28,19,1395,1412,2695,1283
2016,11,28,20,1385,1401,2715,1314
2016,11,28,21,1365,1418,2706,1288
2016,11,28,22,1360,1408,2692,1284
2016,11,28,23,1360,1422,2704,1282
2016,11,29,0,1395,1467,2802,1335
2016,11,29,1,1470,1544,2811,1267
2016,11,29,2,1465,1538,2809,1271
2016,11,29,3,1425,1508,2778,1270
2016,11,29,4,1395,1473,2795,1322
2016,11,29,5,1355,1392,2738,1346
2016,11,29,6,1240,1300,2645,1345
2016,11,29,7,1165,1225,2708,1483
2016,11,29,8,1125,1179,2720,1541
2016,11,29,9,1115,1171,2683,1512
2016,11,29,10,1130,1167,2688,1521
2016,11,29,11,1140,1155,2683,1528
2016,11,29,12,1155,1178,2695,1517
2016,11,29,13,1205,1238,2734,1496
2016,11,29,14,1335,1353,2718,1365
2016,11,29,15,1400,1462,2721,1259
2016,11,29,16,1405,1431,2725,1294
2016,11,29,17,1395,1430,2717,1287
2016,11,29,18,1400,1427,2733,1306
2016,11,29,19,1395,1399,2715,1316
2016,11,29,20,1375,1388,2726,1338
2016,11,29,21,1360,1388,2726,1338
2016,11,29,22,1370,1386,2734,1348
2016,11,29,23,1395,1396,2733,1337
2016,11,30,0,1415,1376,2676,1300
2016,11,30,1,1435,1532,2723,1191
2016,11,30,2,1450,1529,2696,1167
2016,11,30,3,1420,1509,2657,1148
2016,11,30,4,1385,1473,2670,1197
2016,11,30,5,1320,1410,2655,1245
2016,11,30,6,1255,1327,2663,1336
2016,11,30,7,1200,1254,2668,1414
2016,11,30,8,1140,1289,2733,1444
2016,11,30,9,1120,1274,2727,1453
2016,11,30,10,1100,1274,2756,1482
2016,11,30,11,1120,1284,2765,1481
2016,11,30,12,1150,1300,2764,1464
2016,11,30,13,1205,1355,2754,1399
2016,11,30,14,1320,1495,2737,1242
2016,11,30,15,1440,1590,2750,1160
2016,11,30,16,1450,1576,2698,1122
2016,11,30,17,1440,1564,2686,1122
2016,11,30,18,1415,1551,2661,1110
2016,11,30,19,1400,1526,2706,1180
2016,11,30,20,1395,1502,2718,1216
2016,11,30,21,1395,1486,2693,1207
2016,11,30,22,1395,1463,2709,1246
2016,11,30,23,1400,1471,2706,1235
2016,12,1,0,1440,1528,2720,1192
2016,12,1,1,1510,1636,2755,1119
2016,12,1,2,1510,1648,2772,1124
2016,12,1,3,1490,1635,2779,1144
2016,12,1,4,1465,1595,2805,1210
2016,12,1,5,1390,1527,2791,1264
2016,12,1,6,1315,1432,2784,1352
2016,12,1,7,1230,1380,2801,1421
2016,12,1,8,1180,1337,2806,1469
2016,12,1,9,1160,1337,2763,1426
2016,12,1,10,1170,1342,2761,1419
2016,12,1,11,1185,1338,2798,1460
2016,12,1,12,1205,1368,2885,1517
2016,12,1,13,1255,1418,2890,1472
2016,12,1,14,1360,1556,2937,1381
2016,12,1,15,1455,1631,2922,1291
2016,12,1,16,1455,1602,2870,1268
2016,12,1,17,1465,1578,2867,1289
2016,12,1,18,1445,1550,2864,1314
2016,12,1,19,1435,1522,2862,1340
2016,12,1,20,1410,1510,2856,1346
2016,12,1,21,1390,1479,2615,1136
2016,12,1,22,1400,1466,2591,1125
2016,12,1,23,1410,1464,2564,1100
2016,12,2,0,1470,1514,2520,1006
2016,12,2,1,1545,1614,2592,978
2016,12,2,2,1560,1623,2573,950
2016,12,2,3,1535,1611,2580,969
2016,12,2,4,1500,1574,2636,1062
2016,12,2,5,1455,1508,2605,1097
2016,12,2,6,1350,1412,2601,1189
2016,12,2,7,1270,1351,2615,1264
2016,12,2,8,1230,1300,2692,1392
2016,12,2,9,1210,1297,2767,1470
2016,12,2,10,1200,1282,2805,1523
2016,12,2,11,1205,1285,2777,1492
2016,12,2,12,1230,1309,2793,1484
2016,12,2,13,1280,1360,2775,1415
2016,12,2,14,1420,1497,2812,1315
2016,12,2,15,1520,1580,2862,1282
2016,12,2,16,1510,1552,2846,1294
2016,12,2,17,1515,1544,2844,1300
2016,12,2,18,1500,1522,2846,1324
2016,12,2,19,1480,1511,2893,1382
2016,12,2,20,1465,1502,2862,1360
2016,12,2,21,1455,1498,2589,1091
2016,12,2,22,1445,1486,2048,562
2016,12,2,23,1450,1499,1944,445
2016,12,3,0,1500,1570,1982,412
2016,12,3,1,1590,1621,1994,373
2016,12,3,2,1590,1614,1994,380
2016,12,3,3,1565,1581,1986,405
2016,12,3,4,1535,1541,1985,444
2016,12,3,5,1520,1472,2005,533
2016,12,3,6,1395,1392,1990,598
2016,12,3,7,1315,1313,1989,676
2016,12,3,8,1140,1224,2582,1358
2016,12,3,9,1135,1216,2550,1334
2016,12,3,10,1140,1195,2556,1361
2016,12,3,11,1140,1200,2530,1330
2016,12,3,12,1155,1202,2527,1325
2016,12,3,13,1215,1229,2632,1403
2016,12,3,14,1390,1279,2606,1327
2016,12,3,15,1550,1331,2595,1264
2016,12,3,16,1545,1374,2615,1241
2016,12,3,17,1535,1396,2611,1215
2016,12,3,18,1520,1392,2577,1185
2016,12,3,19,1490,1386,2535,1149
2016,12,3,20,1475,1371,2511,1140
2016,12,3,21,1445,1346,2505,1159
2016,12,3,22,1415,1340,2505,1165
2016,12,3,23,1415,1349,2417,1068
2016,12,4,0,1470,1405,2527,1122
2016,12,4,1,1540,1479,2694,1215
2016,12,4,2,1555,1472,2717,1245
2016,12,4,3,1530,1448,2729,1281
2016,12,4,4,1515,1429,2749,1320
2016,12,4,5,1550,1372,2696,1324
2016,12,4,6,1380,1316,2675,1359
2016,12,4,7,1315,1257,2599,1342
2016,12,4,8,1100,1205,2484,1279
2016,12,4,9,1085,1169,2370,1201
2016,12,4,10,1065,1158,2348,1190
2016,12,4,11,1070,1151,2260,1109
2016,12,4,12,1090,1162,2283,1121
2016,12,4,13,1120,1182,2308,1126
2016,12,4,14,1185,1222,2319,1097
2016,12,4,15,1270,1283,2375,1092
2016,12,4,16,1295,1335,2584,1249
2016,12,4,17,1300,1376,2602,1226
2016,12,4,18,1290,1386,2712,1326
2016,12,4,19,1290,1384,2684,1300
2016,12,4,20,1295,1378,2716,1338
2016,12,4,21,1290,1374,2678,1304
2016,12,4,22,1285,1354,2590,1236
2016,12,4,23,1275,1377,2528,1151
2016,12,5,0,1350,1437,2520,1083
2016,12,5,1,1430,1532,2665,1133
2016,12,5,2,1445,1535,2811,1276
2016,12,5,3,1405,1521,2861,1340
2016,12,5,4,1365,1469,2817,1348
2016,12,5,5,1315,1398,2782,1384
2016,12,5,6,1215,1316,2722,1406
2016,12,5,7,1165,1246,2694,1448
2016,12,5,8,1220,1210,2713,1503
2016,12,5,9,1200,1182,2355,1173
2016,12,5,10,1210,1181,2270,1089
2016,12,5,11,1200,1201,2367,1166
2016,12,5,12,1230,1226,2465,1239
2016,12,5,13,1300,1289,2580,1291
2016,12,5,14,1420,1450,2904,1454
2016,12,5,15,1485,1534,2899,1365
2016,12,5,16,1480,1548,2970,1422
2016,12,5,17,1470,1549,2952,1403
2016,12,5,18,1450,1549,2956,1407
2016,12,5,19,1430,1510,2913,1403
2016,12,5,20,1420,1512,2938,1426
2016,12,5,21,1410,1499,2949,1450
2016,12,5,22,1410,1498,2941,1443
2016,12,5,23,1410,1495,2968,1473
2016,12,6,0,1470,1557,2955,1398
2016,12,6,1,1550,1647,2973,1326
2016,12,6,2,1545,1653,2977,1324
2016,12,6,3,1510,1638,2951,1313
2016,12,6,4,1470,1607,2962,1355
2016,12,6,5,1420,1516,2925,1409
2016,12,6,6,1330,1427,2913,1486
2016,12,6,7,1240,1363,2927,1564
2016,12,6,8,1200,1320,2918,1598
2016,12,6,9,1175,1311,2917,1606
2016,12,6,10,1170,1296,2908,1612
2016,12,6,11,1190,1307,2904,1597
2016,12,6,12,1220,1347,2909,1562
2016,12,6,13,1260,1396,2891,1495
2016,12,6,14,1410,1515,2895,1380
2016,12,6,15,1465,1621,2907,1286
2016,12,6,16,1460,1622,2918,1296
2016,12,6,17,1465,1615,2924,1309
2016,12,6,18,1455,1609,2878,1269
2016,12,6,19,1435,1587,2909,1322
2016,12,6,20,1430,1591,2899,1308
2016,12,6,21,1425,1572,2891,1319
2016,12,6,22,1420,1573,2897,1324
2016,12,6,23,1425,1585,2903,1318
2016,12,7,0,1455,1652,2909,1257
2016,12,7,1,1570,1726,2928,1202
2016,12,7,2,1570,1724,2898,1174
2016,12,7,3,1550,1681,2857,1176
2016,12,7,4,1510,1656,2825,1169
2016,12,7,5,1450,1587,2909,1322
2016,12,7,6,1365,1500,2912,1412
2016,12,7,7,1290,1430,2906,1476
2016,12,7,8,1330,1367,2910,1543
2016,12,7,9,1295,1363,2913,1550
2016,12,7,10,1290,1348,2911,1563
2016,12,7,11,1315,1362,2904,1542
2016,12,7,12,1345,1385,2769,1384
2016,12,7,13,1395,1447,2596,1149
2016,12,7,14,1500,1569,2623,1054
2016,12,7,15,1540,1653,2613,960
2016,12,7,16,1555,1637,2580,943
2016,12,7,17,1540,1614,2561,947
2016,12,7,18,1520,1608,2550,942
2016,12,7,19,1490,1597,2544,947
2016,12,7,20,1495,1575,2546,971
2016,12,7,21,1500,1555,2545,990
2016,12,7,22,1465,1545,2549,1004
2016,12,7,23,1465,1554,2546,992
2016,12,8,0,1545,1625,2505,880
2016,12,8,1,1635,1704,2472,768
2016,12,8,2,1640,1716,2495,779
2016,12,8,3,1605,1686,2471,785
2016,12,8,4,1575,1659,2455,796
2016,12,8,5,1525,1595,2359,764
2016,12,8,6,1415,1491,2345,854
2016,12,8,7,1340,1419,2400,981
2016,12,8,8,1365,1379,2473,1094
2016,12,8,9,1355,1363,2477,1114
2016,12,8,10,1325,1364,2450,1086
2016,12,8,11,1335,1360,2447,1087
2016,12,8,12,1380,1402,2490,1088
2016,12,8,13,1435,1455,2476,1021
2016,12,8,14,1520,1582,2499,917
2016,12,8,15,1600,1684,2489,805
2016,12,8,16,1585,1669,2501,832
2016,12,8,17,1580,1659,2475,816
2016,12,8,18,1565,1632,2473,841
2016,12,8,19,1545,1621,2442,821
2016,12,8,20,1545,1580,2425,845
2016,12,8,21,1525,1555,2452,897
2016,12,8,22,1535,1543,2449,906
2016,12,8,23,1535,1558,2459,901
2016,12,9,0,1610,1639,2470,831
2016,12,9,1,1680,1719,2536,817
2016,12,9,2,1675,1719,2550,831
2016,12,9,3,1625,1696,2543,847
2016,12,9,4,1620,1671,2461,790
2016,12,9,5,1545,1616,2465,849
2016,12,9,6,1470,1520,2457,937
2016,12,9,7,1385,1437,2457,1020
2016,12,9,8,1315,1406,2460,1054
2016,12,9,9,1295,1394,2447,1053
2016,12,9,10,1280,1384,2436,1052
2016,12,9,11,1285,1413,2459,1046
2016,12,9,12,1315,1441,2461,1020
2016,12,9,13,1395,1489,2478,989
2016,12,9,14,1500,1578,2475,897
2016,12,9,15,1585,1680,2516,836
2016,12,9,16,1565,1683,2515,832
2016,12,9,17,1535,1670,2515,845
2016,12,9,18,1520,1650,2533,883
2016,12,9,19,1500,1597,2521,924
2016,12,9,20,1500,1575,2493,918
2016,12,9,21,1475,1567,2507,940
2016,12,9,22,1475,1561,2498,937
2016,12,9,23,1485,1579,2498,919
2016,12,10,0,1545,1631,2504,873
2016,12,10,1,1620,1699,2510,811
2016,12,10,2,1625,1682,2492,810
2016,12,10,3,1600,1636,2426,790
2016,12,10,4,1570,1604,2440,836
2016,12,10,5,1490,1565,2504,939
2016,12,10,6,1435,1488,2147,659
2016,12,10,7,1355,1424,1741,317
2016,12,10,8,1275,1369,1679,310
2016,12,10,9,1255,1348,1706,358
2016,12,10,10,1240,1330,1693,363
2016,12,10,11,1245,1320,1696,376
2016,12,10,12,1255,1330,1775,445
2016,12,10,13,1300,1353,1842,489
2016,12,10,14,1360,1392,1844,452
2016,12,10,15,1425,1457,1908,451
2016,12,10,16,1445,1483,1913,430
2016,12,10,17,1450,1522,1920,398
2016,12,10,18,1435,1529,1933,404
2016,12,10,19,1420,1496,1958,462
2016,12,10,20,1405,1479,1978,499
2016,12,10,21,1370,1466,1992,526
2016,12,10,22,1370,1453,2018,565
2016,12,10,23,1390,1458,2059,601
2016,12,11,0,1455,1520,2092,572
2016,12,11,1,1540,1607,2146,539
2016,12,11,2,1530,1590,2204,614
2016,12,11,3,1505,1559,2160,601
2016,12,11,4,1485,1539,2194,655
2016,12,11,5,1430,1497,2179,682
2016,12,11,6,1350,1432,2133,701
2016,12,11,7,1300,1361,2125,764
2016,12,11,8,1215,1336,2165,829
2016,12,11,9,1190,1311,1882,571
2016,12,11,10,1190,1297,1753,456
2016,12,11,11,1175,1302,1798,496
2016,12,11,12,1200,1316,1765,449
2016,12,11,13,1220,1325,1774,449
2016,12,11,14,1265,1380,1816,436
2016,12,11,15,1335,1443,1835,392
2016,12,11,16,1380,1469,1859,390
2016,12,11,17,1400,1508,1857,349
2016,12,11,18,1385,1504,1878,374
2016,12,11,19,1375,1485,1925,440
2016,12,11,20,1375,1461,1901,440
2016,12,11,21,1375,1450,1911,461
2016,12,11,22,1355,1439,1902,463
2016,12,11,23,1370,1449,1902,453
2016,12,12,0,1430,1509,1960,451
2016,12,12,1,1520,1621,2094,473
2016,12,12,2,1530,1622,2183,561
2016,12,12,3,1520,1597,2183,586
2016,12,12,4,1475,1561,2168,607
2016,12,12,5,1410,1506,2143,637
2016,12,12,6,1315,1416,2164,748
2016,12,12,7,1250,1343,2172,829
2016,12,12,8,1225,1301,2194,893
2016,12,12,9,1205,1275,2077,802
2016,12,12,10,1190,1271,2060,789
2016,12,12,11,1205,1270,2062,792
2016,12,12,12,1235,1295,2055,760
2016,12,12,13,1310,1359,2128,769
2016,12,12,14,1465,1481,2130,649
2016,12,12,15,1570,1580,2106,526
2016,12,12,16,1565,1566,2129,563
2016,12,12,17,1540,1554,2130,576
2016,12,12,18,1525,1554,2134,580
2016,12,12,19,1500,1543,2146,603
2016,12,12,20,1510,1525,2114,589
2016,12,12,21,1495,1513,2121,608
2016,12,12,22,1475,1504,2102,598
2016,12,12,23,1480,1509,2100,591
2016,12,13,0,1555,1575,2118,543
2016,12,13,1,1630,1675,2148,473
2016,12,13,2,1640,1664,2120,456
2016,12,13,3,1620,1652,2103,451
2016,12,13,4,1590,1622,2088,466
2016,12,13,5,1540,1548,2076,528
2016,12,13,6,1440,1444,2066,622
2016,12,13,7,1360,1373,2032,659
2016,12,13,8,1290,1324,1984,660
2016,12,13,9,1285,1304,1789,485
2016,12,13,10,1250,1289,1794,505
2016,12,13,11,1265,1286,1812,526
2016,12,13,12,1310,1314,1817,503
2016,12,13,13,1355,1377,1952,575
2016,12,13,14,1445,1512,1950,438
2016,12,13,15,1560,1599,1956,357
2016,12,13,16,1535,1591,1948,357
2016,12,13,17,1540,1587,1941,354
2016,12,13,18,1535,1573,1965,392
2016,12,13,19,1520,1542,2002,460
2016,12,13,20,1520,1525,2018,493
2016,12,13,21,1500,1514,2014,500
2016,12,13,22,1505,1519,2038,519
2016,12,13,23,1510,1504,2015,511
2016,12,14,0,1580,1585,2036,451
2016,12,14,1,1645,1659,2041,382
2016,12,14,2,1635,1671,2110,439
2016,12,14,3,1590,1641,2110,469
2016,12,14,4,1590,1616,2133,517
2016,12,14,5,1540,1552,2118,566
2016,12,14,6,1450,1478,2124,646
2016,12,14,7,1365,1409,2090,681
2016,12,14,8,1345,1370,2072,702
2016,12,14,9,1320,1351,2044,693
2016,12,14,10,1310,1347,2038,691
2016,12,14,11,1310,1353,2022,669
2016,12,14,12,1340,1372,2019,647
2016,12,14,13,1415,1438,2025,587
2016,12,14,14,1495,1568,2039,471
2016,12,14,15,1575,1669,2029,360
2016,12,14,16,1565,1663,1972,309
2016,12,14,17,1535,1651,1940,289
2016,12,14,18,1520,1637,1948,311
2016,12,14,19,1505,1603,2001,398
2016,12,14,20,1495,1586,2001,415
2016,12,14,21,1480,1571,1993,422
2016,12,14,22,1480,1585,1975,390
2016,12,14,23,1495,1600,1998,398
2016,12,15,0,1555,1653,2027,374
2016,12,15,1,1640,1726,2081,355
2016,12,15,2,1635,1724,2028,304
2016,12,15,3,1615,1699,1990,291
2016,12,15,4,1585,1667,2024,357
2016,12,15,5,1540,1604,2057,453
2016,12,15,6,1425,1520,2041,521
2016,12,15,7,1360,1422,2011,589
2016,12,15,8,1295,1377,2075,698
2016,12,15,9,1285,1381,1988,607
2016,12,15,10,1265,1372,1954,582
2016,12,15,11,1265,1385,1923,538
2016,12,15,12,1310,1413,1926,513
2016,12,15,13,1355,1461,1873,412
2016,12,15,14,1490,1586,1911,325
2016,12,15,15,1605,1679,1910,231
2016,12,15,16,1600,1648,1957,309
2016,12,15,17,1585,1639,1919,280
2016,12,15,18,1560,1642,1937,295
2016,12,15,19,1535,1631,1953,322
2016,12,15,20,1500,1633,2018,385
2016,12,15,21,1475,1618,2032,414
2016,12,15,22,1465,1616,2051,435
2016,12,15,23,1480,1630,2080,450
2016,12,16,0,1570,1674,2055,381
2016,12,16,1,1645,1764,2078,314
2016,12,16,2,1645,1748,2073,325
2016,12,16,3,1620,1722,2074,352
2016,12,16,4,1595,1691,2077,386
2016,12,16,5,1535,1615,2098,483
2016,12,16,6,1440,1529,2109,580
2016,12,16,7,1360,1441,2110,669
2016,12,16,8,1410,1405,2206,801
2016,12,16,9,1400,1385,2174,789
2016,12,16,10,1400,1371,2165,794
2016,12,16,11,1415,1381,2158,777
2016,12,16,12,1440,1410,2159,749
2016,12,16,13,1510,1463,2153,690
2016,12,16,14,1585,1573,2140,567
2016,12,16,15,1670,1659,2157,498
2016,12,16,16,1670,1677,2181,504
2016,12,16,17,1650,1686,2203,517
2016,12,16,18,1625,1699,2200,501
2016,12,16,19,1590,1696,2218,522
2016,12,16,20,1585,1682,2199,517
2016,12,16,21,1565,1657,2196,539
2016,12,16,22,1575,1656,2194,538
2016,12,16,23,1590,1664,2191,527
2016,12,17,0,1655,1705,2186,481
2016,12,17,1,1725,1789,2194,405
2016,12,17,2,1720,1771,2187,416
2016,12,17,3,1680,1749,2163,414
2016,12,17,4,1645,1709,2146,437
2016,12,17,5,1570,1651,2122,471
2016,12,17,6,1505,1583,2102,519
2016,12,17,7,1420,1532,2092,560
2016,12,17,8,1380,1488,2086,598
2016,12,17,9,1360,1475,2097,622
2016,12,17,10,1350,1456,2083,627
2016,12,17,11,1355,1467,2090,623
2016,12,17,12,1370,1479,2101,622
2016,12,17,13,1400,1531,2092,561
2016,12,17,14,1470,1586,2118,532
2016,12,17,15,1545,1655,2120,465
2016,12,17,16,1565,1712,2148,436
2016,12,17,17,1585,1733,2156,423
2016,12,17,18,1580,1756,2165,409
2016,12,17,19,1555,1708,2150,442
2016,12,17,20,1535,1697,2182,485
2016,12,17,21,1535,1664,2174,510
2016,12,17,22,1540,1654,2181,527
2016,12,17,23,1545,1678,2189,511
2016,12,18,0,1590,1728,2179,451
2016,12,18,1,1685,1831,2199,368
2016,12,18,2,1660,1807,2217,410
2016,12,18,3,1635,1783,2182,399
2016,12,18,4,1605,1766,2201,435
2016,12,18,5,1555,1714,2205,491
2016,12,18,6,1465,1654,2202,548
2016,12,18,7,1415,1590,2251,661
2016,12,18,8,1360,1511,2329,818
2016,12,18,9,1325,1464,2223,759
2016,12,18,10,1315,1467,2315,848
2016,12,18,11,1330,1462,2433,971
2016,12,18,12,1360,1480,2525,1045
2016,12,18,13,1375,1495,2673,1178
2016,12,18,14,1430,1536,2661,1125
2016,12,18,15,1475,1587,2654,1067
2016,12,18,16,1490,1633,2697,1064
2016,12,18,17,1520,1654,2762,1108
2016,12,18,18,1520,1651,2759,1108
2016,12,18,19,1515,1631,2750,1119
2016,12,18,20,1495,1631,2800,1169
2016,12,18,21,1470,1618,2789,1171
2016,12,18,22,1465,1599,2773,1174
2016,12,18,23,1465,1608,2781,1173
2016,12,19,0,1525,1689,2820,1131
2016,12,19,1,1640,1783,2914,1131
2016,12,19,2,1630,1775,2865,1090
2016,12,19,3,1615,1741,2810,1069
2016,12,19,4,1580,1706,2824,1118
2016,12,19,5,1540,1650,2832,1182
2016,12,19,6,1425,1554,2786,1232
2016,12,19,7,1350,1478,2772,1294
2016,12,19,8,1270,1458,2758,1300
2016,12,19,9,1245,1414,2616,1202
2016,12,19,10,1250,1402,2533,1131
2016,12,19,11,1255,1395,2576,1181
2016,12,19,12,1285,1411,2579,1168
2016,12,19,13,1335,1480,2711,1231
2016,12,19,14,1420,1583,2749,1166
2016,12,19,15,1510,1659,2811,1152
2016,12,19,16,1515,1647,2800,1153
2016,12,19,17,1495,1636,2815,1179
2016,12,19,18,1480,1637,2784,1147
2016,12,19,19,1465,1613,2778,1165
2016,12,19,20,1455,1600,2814,1214
2016,12,19,21,1435,1593,2799,1206
2016,12,19,22,1445,1588,2793,1205
2016,12,19,23,1460,1590,2800,1210
2016,12,20,0,1510,1649,2760,1111
2016,12,20,1,1610,1711,2695,984
2016,12,20,2,1600,1715,2740,1025
2016,12,20,3,1580,1662,2720,1058
2016,12,20,4,1545,1633,2795,1162
2016,12,20,5,1475,1560,2793,1233
2016,12,20,6,1380,1441,2776,1335
2016,12,20,7,1315,1353,2739,1386
2016,12,20,8,1310,1324,2782,1458
2016,12,20,9,1295,1289,2734,1445
2016,12,20,10,1290,1291,2744,1453
2016,12,20,11,1290,1284,2747,1463
2016,12,20,12,1315,1294,2707,1413
2016,12,20,13,1355,1331,2659,1328
2016,12,20,14,1420,1453,2712,1259
2016,12,20,15,1455,1542,2797,1255
2016,12,20,16,1460,1537,2785,1248
2016,12,20,17,1455,1515,2769,1254
2016,12,20,18,1450,1513,2793,1280
2016,12,20,19,1430,1509,2823,1314
2016,12,20,20,1410,1499,2922,1423
2016,12,20,21,1400,1498,2941,1443
2016,12,20,22,1395,1491,2856,1365
2016,12,20,23,1395,1493,2872,1379
2016,12,21,0,1435,1534,2902,1368
2016,12,21,1,1555,1630,2888,1258
2016,12,21,2,1555,1619,2877,1258
2016,12,21,3,1530,1616,2894,1278
2016,12,21,4,1495,1562,2702,1140
2016,12,21,5,1430,1497,2732,1235
2016,12,21,6,1355,1404,2702,1298
2016,12,21,7,1285,1339,2681,1342
2016,12,21,8,1340,1279,2572,1293
2016,12,21,9,1310,1271,2903,1632
2016,12,21,10,1310,1254,2834,1580
2016,12,21,11,1320,1272,2853,1581
2016,12,21,12,1315,1284,2892,1608
2016,12,21,13,1385,1338,2913,1575
2016,12,21,14,1520,1473,2899,1426
2016,12,21,15,1580,1560,2890,1330
2016,12,21,16,1640,1562,2944,1382
2016,12,21,17,1630,1528,2888,1360
2016,12,21,18,1615,1508,2915,1407
2016,12,21,19,1585,1482,2921,1439
2016,12,21,20,1575,1439,2896,1457
2016,12,21,21,1565,1427,2941,1514
2016,12,21,22,1560,1420,2992,1572
2016,12,21,23,1570,1430,2985,1555
2016,12,22,0,1630,1478,2996,1518
2016,12,22,1,1705,1588,3010,1422
2016,12,22,2,1720,1599,3071,1472
2016,12,22,3,1660,1585,3034,1449
2016,12,22,4,1625,1568,3019,1451
2016,12,22,5,1555,1521,3077,1556
2016,12,22,6,1445,1444,3080,1636
2016,12,22,7,1330,1353,3050,1697
2016,12,22,8,1245,1312,3001,1689
2016,12,22,9,1220,1301,2992,1691
2016,12,22,10,1220,1302,2989,1687
2016,12,22,11,1235,1300,2987,1687
2016,12,22,12,1245,1321,2974,1653
2016,12,22,13,1295,1367,2921,1554
2016,12,22,14,1395,1479,2945,1466
2016,12,22,15,1480,1578,2920,1342
2016,12,22,16,1500,1585,2919,1334
2016,12,22,17,1415,1589,2896,1307
2016,12,22,18,1415,1518,2871,1353
2016,12,22,19,1410,1496,2849,1353
2016,12,22,20,1410,1454,2785,1331
2016,12,22,21,1390,1434,2743,1309
2016,12,22,22,1385,1420,2716,1296
2016,12,22,23,1395,1444,2704,1260
2016,12,23,0,1445,1503,2721,1218
2016,12,23,1,1535,1597,2804,1207
2016,12,23,2,1520,1593,2879,1286
2016,12,23,3,1515,1586,2892,1306
2016,12,23,4,1475,1589,2910,1321
2016,12,23,5,1395,1541,2915,1374
2016,12,23,6,1320,1478,2956,1478
2016,12,23,7,1245,1412,2913,1501
2016,12,23,8,1265,1350,2509,1159
2016,12,23,9,1240,1348,2177,829
2016,12,23,10,1240,1333,2129,796
2016,12,23,11,1250,1323,2150,827
2016,12,23,12,1260,1326,2224,898
2016,12,23,13,1310,1370,2226,856
2016,12,23,14,1395,1449,2139,690
2016,12,23,15,1465,1523,2160,637
2016,12,23,16,1460,1535,2073,538
2016,12,23,17,1440,1520,2062,542
2016,12,23,18,1435,1525,2041,516
2016,12,23,19,1415,1503,2038,535
2016,12,23,20,1395,1475,2041,566
2016,12,23,21,1380,1457,2046,589
2016,12,23,22,1380,1447,2043,596
2016,12,23,23,1385,1450,2054,604
2016,12,24,0,1430,1495,2062,567
2016,12,24,1,1505,1556,2168,612
2016,12,24,2,1505,1542,2157,615
2016,12,24,3,1480,1522,2161,639
2016,12,24,4,1455,1502,2082,580
2016,12,24,5,1410,1476,2068,592
2016,12,24,6,1340,1401,2060,659
2016,12,24,7,1300,1351,2068,717
2016,12,24,8,1245,1286,2060,774
2016,12,24,9,1215,1261,2061,800
2016,12,24,10,1205,1239,2057,818
2016,12,24,11,1215,1227,2042,815
2016,12,24,12,1230,1234,2043,809
2016,12,24,13,1250,1264,2044,780
2016,12,24,14,1300,1312,2026,714
2016,12,24,15,1360,1362,2032,670
2016,12,24,16,1400,1418,2045,627
2016,12,24,17,1410,1466,2058,592
2016,12,24,18,1415,1489,2056,567
2016,12,24,19,1395,1487,2047,560
2016,12,24,20,1360,1465,2048,583
2016,12,24,21,1345,1447,2055,608
2016,12,24,22,1340,1435,2040,605
2016,12,24,23,1350,1438,2032,594
2016,12,25,0,1395,1465,2033,568
2016,12,25,1,1470,1520,2039,519
2016,12,25,2,1440,1506,2040,534
2016,12,25,3,1420,1511,2047,536
2016,12,25,4,1405,1511,2048,537
2016,12,25,5,1360,1491,2078,587
2016,12,25,6,1305,1447,2086,639
2016,12,25,7,1265,1390,2091,701
2016,12,25,8,1245,1344,2095,751
2016,12,25,9,1205,1313,2155,842
2016,12,25,10,1185,1295,2257,962
2016,12,25,11,1180,1261,2260,999
2016,12,25,12,1200,1276,2374,1098
2016,12,25,13,1215,1301,2474,1173
2016,12,25,14,1270,1352,2690,1338
2016,12,25,15,1310,1415,2879,1464
2016,12,25,16,1340,1473,2921,1448
2016,12,25,17,1365,1483,2901,1418
2016,12,25,18,1365,1497,2910,1413
2016,12,25,19,1355,1478,2851,1373
2016,12,25,20,1345,1472,2919,1447
2016,12,25,21,1320,1456,2924,1468
2016,12,25,22,1300,1438,2735,1297
2016,12,25,23,1305,1447,2780,1333
2016,12,26,0,1360,1497,2874,1377
2016,12,26,1,1450,1558,2928,1370
2016,12,26,2,1445,1553,2933,1380
2016,12,26,3,1435,1535,2937,1402
2016,12,26,4,1410,1515,2920,1405
2016,12,26,5,1400,1484,2946,1462
2016,12,26,6,1295,1418,2935,1517
2016,12,26,7,1235,1356,2893,1537
2016,12,26,8,1300,1322,2872,1550
2016,12,26,9,1265,1275,2902,1627
2016,12,26,10,1260,1281,2931,1650
2016,12,26,11,1265,1284,2935,1651
2016,12,26,12,1290,1306,2942,1636
2016,12,26,13,1335,1345,2936,1591
2016,12,26,14,1395,1404,2959,1555
2016,12,26,15,1470,1459,2967,1508
2016,12,26,16,1490,1500,2960,1460
2016,12,26,17,1485,1518,2940,1422
2016,12,26,18,1470,1519,2760,1241
2016,12,26,19,1455,1487,2641,1154
2016,12,26,20,1430,1458,2633,1175
2016,12,26,21,1420,1430,2665,1235
2016,12,26,22,1410,1417,2701,1284
2016,12,26,23,1415,1424,2857,1433
2016,12,27,0,1480,1505,2929,1424
2016,12,27,1,1570,1627,2969,1342
2016,12,27,2,1580,1645,2986,1341
2016,12,27,3,1545,1608,2962,1354
2016,12,27,4,1515,1592,2964,1372
2016,12,27,5,1495,1534,2965,1431
2016,12,27,6,1365,1450,2953,1503
2016,12,27,7,1295,1382,2876,1494
2016,12,27,8,1270,1338,2868,1530
2016,12,27,9,1255,1308,2763,1455
2016,12,27,10,1235,1313,2775,1462
2016,12,27,11,1245,1303,2772,1469
2016,12,27,12,1260,1315,2779,1464
2016,12,27,13,1300,1359,2915,1556
2016,12,27,14,1420,1459,2907,1448
2016,12,27,15,1490,1522,2915,1393
2016,12,27,16,1480,1556,2937,1381
2016,12,27,17,1450,1563,2930,1367
2016,12,27,18,1440,1567,2842,1275
2016,12,27,19,1430,1566,2888,1322
2016,12,27,20,1410,1539,2890,1351
2016,12,27,21,1405,1531,2907,1376
2016,12,27,22,1395,1524,2928,1404
2016,12,27,23,1390,1534,2912,1378
2016,12,28,0,1445,1581,2926,1345
2016,12,28,1,1525,1660,2920,1260
2016,12,28,2,1530,1665,2929,1264
2016,12,28,3,1525,1618,2919,1301
2016,12,28,4,1490,1595,2918,1323
2016,12,28,5,1420,1526,2810,1284
2016,12,28,6,1350,1444,2804,1360
2016,12,28,7,1275,1367,2668,1301
2016,12,28,8,1265,1327,2659,1332
2016,12,28,9,1235,1316,2737,1421
2016,12,28,10,1240,1303,2618,1315
2016,12,28,11,1235,1304,2650,1346
2016,12,28,12,1255,1320,2648,1328
2016,12,28,13,1295,1365,2778,1413
2016,12,28,14,1425,1469,2873,1404
2016,12,28,15,1550,1542,2894,1352
2016,12,28,16,1550,1574,2904,1330
2016,12,28,17,1515,1569,2903,1334
2016,12,28,18,1490,1566,2898,1332
2016,12,28,19,1465,1564,2903,1339
2016,12,28,20,1435,1537,2908,1371
2016,12,28,21,1425,1527,2914,1387
2016,12,28,22,1420,1520,2916,1396
2016,12,28,23,1430,1523,2921,1398
2016,12,29,0,1470,1572,2934,1362
2016,12,29,1,1565,1666,2929,1263
2016,12,29,2,1585,1657,2972,1315
2016,12,29,3,1575,1630,2889,1259
2016,12,29,4,1560,1597,2646,1049
2016,12,29,5,1510,1531,2557,1026
2016,12,29,6,1425,1450,2564,1114
2016,12,29,7,1335,1391,2550,1159
2016,12,29,8,1280,1345,2571,1226
2016,12,29,9,1265,1336,2620,1284
2016,12,29,10,1255,1324,2722,1398
2016,12,29,11,1255,1339,2742,1403
2016,12,29,12,1270,1338,2728,1390
2016,12,29,13,1320,1387,2832,1445
2016,12,29,14,1430,1466,2796,1330
2016,12,29,15,1525,1542,2822,1280
2016,12,29,16,1555,1566,2781,1215
2016,12,29,17,1540,1582,2768,1186
2016,12,29,18,1485,1549,2701,1152
2016,12,29,19,1480,1522,2691,1169
2016,12,29,20,1430,1485,2679,1194
2016,12,29,21,1405,1453,2701,1248
2016,12,29,22,1405,1452,2745,1293
2016,12,29,23,1435,1458,2837,1379
2016,12,30,0,1480,1520,2881,1361
2016,12,30,1,1570,1606,2861,1255
2016,12,30,2,1560,1620,2895,1275
2016,12,30,3,1555,1621,2866,1245
2016,12,30,4,1545,1566,2723,1157
2016,12,30,5,1505,1524,2750,1226
2016,12,30,6,1415,1449,2793,1344
2016,12,30,7,1330,1373,2800,1427
2016,12,30,8,1300,1323,2733,1410
2016,12,30,9,1295,1285,2674,1389
2016,12,30,10,1285,1257,2534,1277
2016,12,30,11,1280,1249,2577,1328
2016,12,30,12,1290,1258,2642,1384
2016,12,30,13,1335,1301,2727,1426
2016,12,30,14,1430,1387,2701,1314
2016,12,30,15,1520,1454,2723,1269
2016,12,30,16,1515,1486,2725,1239
2016,12,30,17,1500,1493,2822,1329
2016,12,30,18,1510,1512,2827,1315
2016,12,30,19,1490,1507,2831,1324
2016,12,30,20,1465,1491,2803,1312
2016,12,30,21,1450,1471,2788,1317
2016,12,30,22,1440,1453,2750,1297
2016,12,30,23,1455,1455,2717,1262
2016,12,31,0,1495,1499,2725,1226
2016,12,31,1,1565,1571,2727,1156
2016,12,31,2,1555,1573,2731,1158
2016,12,31,3,1530,1546,2737,1191
2016,12,31,4,1520,1530,2732,1202
2016,12,31,5,1480,1495,2783,1288
2016,12,31,6,1385,1435,2799,1364
2016,12,31,7,1330,1381,2841,1460
2016,12,31,8,1290,1340,2835,1495
2016,12,31,9,1265,1319,2851,1532
2016,12,31,10,1230,1319,2854,1535
2016,12,31,11,1255,1310,2824,1514
2016,12,31,12,1265,1330,2816,1486
2016,12,31,13,1310,1356,2808,1452
2016,12,31,14,1365,1379,2805,1426
2016,12,31,15,1420,1451,2820,1369
2016,12,31,16,1455,1486,2821,1335
2016,12,31,17,1465,1501,2808,1307
2016,12,31,18,1475,1491,2807,1316
2016,12,31,19,1485,1476,2823,1347
2016,12,31,20,1460,1441,2823,1382
2016,12,31,21,1445,1409,2840,1431
2016,12,31,22,1475,1388,2848,1460
2016,12,31,23,1495,1391,2841,1450
2017,1,1,0,1545,1453,2858,1405
2017,1,1,1,1550,1549,2844,1295
2017,1,1,2,1535,1539,2797,1258
2017,1,1,3,1530,1514,2657,1143
2017,1,1,4,1510,1472,2577,1105
2017,1,1,5,1465,1436,2535,1099
2017,1,1,6,1390,1399,2551,1152
2017,1,1,7,1360,1356,2516,1160
2017,1,1,8,1330,1312,2518,1206
2017,1,1,9,1285,1298,2503,1205
2017,1,1,10,1270,1286,2488,1202
2017,1,1,11,1275,1286,2489,1203
2017,1,1,12,1310,1287,2541,1254
2017,1,1,13,1315,1315,2530,1215
2017,1,1,14,1385,1362,2530,1168
2017,1,1,15,1425,1414,2526,1112
2017,1,1,16,1445,1477,2536,1059
2017,1,1,17,1495,1514,2581,1067
2017,1,1,18,1500,1524,2578,1054
2017,1,1,19,1505,1541,2588,1047
2017,1,1,20,1495,1521,2626,1105
2017,1,1,21,1485,1521,2605,1084
2017,1,1,22,1475,1509,2614,1105
2017,1,1,23,1495,1530,2672,1142
2017,1,2,0,1540,1583,2727,1144
2017,1,2,1,1595,1666,2712,1046
2017,1,2,2,1585,1670,2759,1089
2017,1,2,3,1580,1633,2751,1118
2017,1,2,4,1555,1604,2737,1133
2017,1,2,5,1495,1552,2712,1160
2017,1,2,6,1440,1484,2728,1244
2017,1,2,7,1370,1418,2714,1296
2017,1,2,8,1320,1374,2740,1366
2017,1,2,9,1310,1349,2729,1380
2017,1,2,10,1295,1345,2730,1385
2017,1,2,11,1295,1348,2727,1379
2017,1,2,12,1320,1367,2749,1382
2017,1,2,13,1360,1403,2753,1350
2017,1,2,14,1485,1464,2742,1278
2017,1,2,15,1545,1543,2742,1199
2017,1,2,16,1565,1583,2752,1169
2017,1,2,17,1585,1618,2732,1114
2017,1,2,18,1560,1636,2696,1060
2017,1,2,19,1510,1633,2693,1060
2017,1,2,20,1495,1632,2708,1076
2017,1,2,21,1500,1602,2692,1090
2017,1,2,22,1495,1609,2708,1099
2017,1,2,23,1525,1615,2693,1078
2017,1,3,0,1595,1665,2683,1018
2017,1,3,1,1685,1777,2656,879
2017,1,3,2,1650,1791,2648,857
2017,1,3,3,1644,1748,2617,869
2017,1,3,4,1600,1716,2601,885
2017,1,3,5,1540,1635,2598,963
2017,1,3,6,1440,1551,2594,1043
2017,1,3,7,1365,1487,2584,1097
2017,1,3,8,1320,1451,2584,1133
2017,1,3,9,1330,1436,2586,1150
2017,1,3,10,1330,1443,2591,1148
2017,1,3,11,1345,1447,2587,1140
2017,1,3,12,1365,1467,2351,884
2017,1,3,13,1440,1521,2276,755
2017,1,3,14,1545,1632,2278,646
2017,1,3,15,1655,1726,2300,574
2017,1,3,16,1660,1716,2289,573
2017,1,3,17,1635,1715,2279,564
2017,1,3,18,1600,1701,2319,618
2017,1,3,19,1575,1670,2279,609
2017,1,3,20,1575,1652,2282,630
2017,1,3,21,1560,1617,2290,673
2017,1,3,22,1570,1601,2286,685
2017,1,3,23,1590,1615,2314,699
2017,1,4,0,1650,1653,2296,643
2017,1,4,1,1715,1762,2354,592
2017,1,4,2,1720,1779,2334,555
2017,1,4,3,1690,1774,2377,603
2017,1,4,4,1655,1759,2409,650
2017,1,4,5,1585,1678,2405,727
2017,1,4,6,1495,1592,2380,788
2017,1,4,7,1400,1530,2362,832
2017,1,4,8,1420,1517,2383,866
2017,1,4,9,1400,1479,2402,923
2017,1,4,10,1390,1470,2404,934
2017,1,4,11,1415,1472,2401,929
2017,1,4,12,1435,1491,2419,928
2017,1,4,13,1485,1559,2420,861
2017,1,4,14,1575,1655,2459,804
2017,1,4,15,1635,1752,2400,648
2017,1,4,16,1670,1730,2404,674
2017,1,4,17,1675,1721,2362,641
2017,1,4,18,1690,1699,2351,652
2017,1,4,19,1690,1664,2345,681
2017,1,4,20,1670,1647,2372,725
2017,1,4,21,1635,1614,2354,740
2017,1,4,22,1645,1620,2378,758
2017,1,4,23,1650,1617,2382,765
2017,1,5,0,1700,1673,2381,708
2017,1,5,1,1780,1785,2437,652
2017,1,5,2,1770,1790,2499,709
2017,1,5,3,1750,1768,2503,735
2017,1,5,4,1715,1753,2494,741
2017,1,5,5,1650,1672,2476,804
2017,1,5,6,1585,1591,2474,883
2017,1,5,7,1520,1529,2474,945
2017,1,5,8,1440,1487,2478,991
2017,1,5,9,1420,1465,2437,972
2017,1,5,10,1420,1463,2413,950
2017,1,5,11,1420,1481,2402,921
2017,1,5,12,1445,1507,2386,879
2017,1,5,13,1510,1570,2435,865
2017,1,5,14,1635,1680,2438,758
2017,1,5,15,1755,1769,2437,668
2017,1,5,16,1755,1771,2458,687
2017,1,5,17,1750,1760,2447,687
2017,1,5,18,1705,1735,2403,668
2017,1,5,19,1680,1707,2333,626
2017,1,5,20,1655,1681,2343,662
2017,1,5,21,1625,1648,2328,680
2017,1,5,22,1620,1632,2382,750
2017,1,5,23,1630,1644,2438,794
2017,1,6,0,1665,1695,2461,766
2017,1,6,1,1765,1788,2450,662
2017,1,6,2,1790,1791,2457,666
2017,1,6,3,1785,1777,2442,665
2017,1,6,4,1770,1749,2468,719
2017,1,6,5,1680,1678,2464,786
2017,1,6,6,1585,1579,2466,887
2017,1,6,7,1530,1532,2515,983
2017,1,6,8,1430,1489,2539,1050
2017,1,6,9,1400,1460,2514,1054
2017,1,6,10,1400,1460,2497,1037
2017,1,6,11,1405,1454,2478,1024
2017,1,6,12,1430,1468,2435,967
2017,1,6,13,1495,1528,2439,911
2017,1,6,14,1580,1613,2409,796
2017,1,6,15,1670,1709,2454,745
2017,1,6,16,1660,1722,2481,759
2017,1,6,17,1660,1686,2458,772
2017,1,6,18,1640,1667,2443,776
2017,1,6,19,1610,1636,2481,845
2017,1,6,20,1600,1611,2455,844
2017,1,6,21,1570,1586,2451,865
2017,1,6,22,1570,1556,2447,891
2017,1,6,23,1575,1562,2423,861
2017,1,7,0,1610,1593,2377,784
2017,1,7,1,1710,1684,2385,701
2017,1,7,2,1720,1706,2420,714
2017,1,7,3,1705,1681,2421,740
2017,1,7,4,1685,1666,2396,730
2017,1,7,5,1625,1623,2408,785
2017,1,7,6,1520,1551,2482,931
2017,1,7,7,1465,1501,2532,1031
2017,1,7,8,1375,1465,2479,1014
2017,1,7,9,1360,1449,2539,1090
2017,1,7,10,1350,1455,2619,1164
2017,1,7,11,1370,1451,2659,1208
2017,1,7,12,1385,1468,2667,1199
2017,1,7,13,1420,1493,2680,1187
2017,1,7,14,1415,1530,2672,1142
2017,1,7,15,1435,1593,2655,1062
2017,1,7,16,1475,1628,2660,1032
2017,1,7,17,1465,1659,2670,1011
2017,1,7,18,1470,1650,2669,1019
2017,1,7,19,1470,1626,2641,1015
2017,1,7,20,1440,1585,2627,1042
2017,1,7,21,1400,1577,2642,1065
2017,1,7,22,1730,1564,2648,1084
2017,1,7,23,1410,1573,2645,1072
2017,1,8,0,1455,1623,2719,1096
2017,1,8,1,1545,1702,2733,1031
2017,1,8,2,1530,1704,2720,1016
2017,1,8,3,1510,1685,2649,964
2017,1,8,4,1495,1649,2639,990
2017,1,8,5,1445,1617,2673,1056
2017,1,8,6,1385,1531,2668,1137
2017,1,8,7,1340,1468,2613,1145
2017,1,8,8,1370,1403,2505,1102
2017,1,8,9,1335,1368,2432,1064
2017,1,8,10,1335,1372,2463,1091
2017,1,8,11,1325,1361,2468,1107
2017,1,8,12,1335,1359,2492,1133
2017,1,8,13,1375,1383,2485,1102
2017,1,8,14,1445,1421,2468,1047
2017,1,8,15,1500,1479,2459,980
2017,1,8,16,1530,1515,2455,940
2017,1,8,17,1545,1543,2481,938
2017,1,8,18,1555,1551,2428,877
2017,1,8,19,1540,1538,2384,846
2017,1,8,20,1525,1535,2364,829
2017,1,8,21,1500,1530,2359,829
2017,1,8,22,1485,1521,2356,835
2017,1,8,23,1500,1527,2356,829
2017,1,9,0,1565,1583,2417,834
2017,1,9,1,1665,1677,2430,753
2017,1,9,2,1670,1703,2436,733
2017,1,9,3,1635,1672,2425,753
2017,1,9,4,1595,1624,2379,755
2017,1,9,5,1550,1554,2377,823
2017,1,9,6,1445,1459,2370,911
2017,1,9,7,1390,1371,2325,954
2017,1,9,8,1325,1336,2290,954
2017,1,9,9,1295,1317,2317,1000
2017,1,9,10,1290,1296,2315,1019
2017,1,9,11,1305,1296,2316,1020
2017,1,9,12,1320,1309,2305,996
2017,1,9,13,1385,1355,2318,963
2017,1,9,14,1490,1481,2337,856
2017,1,9,15,1585,1579,2324,745
2017,1,9,16,1585,1573,2355,782
2017,1,9,17,1590,1565,2352,787
2017,1,9,18,1580,1558,2344,786
2017,1,9,19,1560,1539,2343,804
2017,1,9,20,1545,1528,2370,842
2017,1,9,21,1535,1519,2404,885
2017,1,9,22,1525,1537,2447,910
2017,1,9,23,1530,1532,2431,899
2017,1,10,0,1585,1576,2370,794
2017,1,10,1,1665,1646,2421,775
2017,1,10,2,1680,1651,2448,797
2017,1,10,3,1630,1625,2414,789
2017,1,10,4,1595,1582,2449,867
2017,1,10,5,1525,1515,2469,954
2017,1,10,6,1430,1437,2473,1036
2017,1,10,7,1340,1379,2486,1107
2017,1,10,8,1295,1347,2491,1144
2017,1,10,9,1270,1330,2476,1146
2017,1,10,10,1260,1310,2448,1138
2017,1,10,11,1275,1302,2384,1082
2017,1,10,12,1295,1329,2355,1026
2017,1,10,13,1355,1394,2372,978
2017,1,10,14,1480,1499,2358,859
2017,1,10,15,1595,1595,2375,780
2017,1,10,16,1610,1601,2327,726
2017,1,10,17,1610,1592,2306,714
2017,1,10,18,1575,1578,2339,761
2017,1,10,19,1565,1567,2310,743
2017,1,10,20,1545,1550,2316,766
2017,1,10,21,1540,1536,2317,781
2017,1,10,22,1540,1548,2320,772
2017,1,10,23,1535,1554,2391,837
2017,1,11,0,1570,1591,2433,842
2017,1,11,1,1670,1670,2426,756
2017,1,11,2,1690,1691,2399,708
2017,1,11,3,1665,1668,2400,732
2017,1,11,4,1635,1645,2445,800
2017,1,11,5,1555,1578,2444,866
2017,1,11,6,1455,1503,2437,934
2017,1,11,7,1395,1433,2416,983
2017,1,11,8,1320,1397,2364,967
2017,1,11,9,1310,1364,2323,959
2017,1,11,10,1315,1356,2255,899
2017,1,11,11,1325,1368,2195,827
2017,1,11,12,1385,1408,2281,873
2017,1,11,13,1445,1484,2274,790
2017,1,11,14,1540,1610,2319,709
2017,1,11,15,1640,1681,2324,643
2017,1,11,16,1665,1678,2320,642
2017,1,11,17,1650,1672,2278,606
2017,1,11,18,1615,1642,2279,637
2017,1,11,19,1590,1635,2303,668
2017,1,11,20,1595,1601,2308,707
2017,1,11,21,1575,1597,2329,732
2017,1,11,22,1590,1586,2307,721
2017,1,11,23,1595,1583,2261,678
2017,1,12,0,1655,1629,2326,697
2017,1,12,1,1725,1704,2330,626
2017,1,12,2,1730,1723,2321,598
2017,1,12,3,1700,1702,2332,630
2017,1,12,4,1670,1683,2350,667
2017,1,12,5,1595,1562,2289,727
2017,1,12,6,1505,1528,2348,820
2017,1,12,7,1420,1478,2342,864
2017,1,12,8,1390,1490,2433,943
2017,1,12,9,1370,1423,2399,976
2017,1,12,10,1380,1406,2378,972
2017,1,12,11,1400,1407,2426,1019
2017,1,12,12,1425,1430,2499,1069
2017,1,12,13,1475,1484,2453,969
2017,1,12,14,1570,1593,2372,779
2017,1,12,15,1650,1669,2363,694
2017,1,12,16,1650,1674,2320,646
2017,1,12,17,1645,1666,2281,615
2017,1,12,18,1635,1652,2281,629
2017,1,12,19,1610,1623,2314,691
2017,1,12,20,1610,1591,2345,754
2017,1,12,21,1570,1552,2369,817
2017,1,12,22,1575,1537,2485,948
2017,1,12,23,1595,1554,2550,996
2017,1,13,0,1650,1585,2549,964
2017,1,13,1,1755,1690,2642,952
2017,1,13,2,1745,1717,2656,939
2017,1,13,3,1720,1696,2690,994
2017,1,13,4,1680,1670,2753,1083
2017,1,13,5,1595,1632,2756,1124
2017,1,13,6,1515,1549,2751,1202
2017,1,13,7,1430,1486,2781,1295
2017,1,13,8,1390,1446,2815,1369
2017,1,13,9,1320,1438,2804,1366
2017,1,13,10,1320,1435,2829,1394
2017,1,13,11,1340,1443,2827,1384
2017,1,13,12,1355,1455,2805,1350
2017,1,13,13,1390,1510,2789,1279
2017,1,13,14,1495,1614,2803,1189
2017,1,13,15,1565,1704,2801,1097
2017,1,13,16,1540,1698,2782,1084
2017,1,13,17,1520,1683,2769,1086
2017,1,13,18,1520,1644,2761,1117
2017,1,13,19,1500,1606,2768,1162
2017,1,13,20,1470,1572,2764,1192
2017,1,13,21,1455,1540,2769,1229
2017,1,13,22,1445,1520,2743,1223
2017,1,13,23,1455,1518,2740,1222
2017,1,14,0,1505,1543,2709,1166
2017,1,14,1,1570,1630,2693,1063
2017,1,14,2,1570,1652,2724,1072
2017,1,14,3,1550,1635,2734,1099
2017,1,14,4,1535,1619,2748,1129
2017,1,14,5,1495,1571,2737,1166
2017,1,14,6,1405,1525,2773,1248
2017,1,14,7,1350,1476,2803,1327
2017,1,14,8,1380,1429,2815,1386
2017,1,14,9,1370,1413,2684,1271
2017,1,14,10,1375,1406,2657,1251
2017,1,14,11,1375,1411,2687,1276
2017,1,14,12,1395,1428,2701,1273
2017,1,14,13,1410,1455,2792,1337
2017,1,14,14,1445,1520,2719,1199
2017,1,14,15,1525,1571,2570,999
2017,1,14,16,1545,1611,2523,912
2017,1,14,17,1570,1630,2521,891
2017,1,14,18,1565,1615,2621,1006
2017,1,14,19,1550,1578,2715,1137
2017,1,14,20,1515,1550,2722,1172
2017,1,14,21,1490,1520,2799,1279
2017,1,14,22,1465,1503,2821,1318
2017,1,14,23,1475,1506,2833,1327
2017,1,15,0,1520,1526,2819,1293
2017,1,15,1,1610,1626,2840,1214
2017,1,15,2,1630,1654,2850,1196
2017,1,15,3,1590,1630,2857,1227
2017,1,15,4,1570,1604,2841,1237
2017,1,15,5,1530,1572,2827,1255
2017,1,15,6,1445,1508,2833,1325
2017,1,15,7,1370,1459,2826,1367
2017,1,15,8,1350,1411,2837,1426
2017,1,15,9,1345,1393,2826,1433
2017,1,15,10,1345,1396,2824,1428
2017,1,15,11,1325,1391,2831,1440
2017,1,15,12,1315,1414,2852,1438
2017,1,15,13,1345,1434,2844,1410
2017,1,15,14,1370,1467,2829,1362
2017,1,15,15,1415,1544,2840,1296
2017,1,15,16,1445,1579,2830,1251
2017,1,15,17,1485,1590,2799,1209
2017,1,15,18,1495,1589,2801,1212
2017,1,15,19,1485,1561,2822,1261
2017,1,15,20,1485,1548,2814,1266
2017,1,15,21,1465,1526,2826,1300
2017,1,15,22,1460,1509,2818,1309
2017,1,15,23,1475,1506,2818,1312
2017,1,16,0,1525,1536,2773,1237
2017,1,16,1,1605,1636,2770,1134
2017,1,16,2,1635,1668,2801,1133
2017,1,16,3,1600,1651,2806,1155
2017,1,16,4,1545,1624,2801,1177
2017,1,16,5,1465,1566,2767,1201
2017,1,16,6,1380,1489,2750,1261
2017,1,16,7,1315,1433,2714,1281
2017,1,16,8,1315,1417,2764,1347
2017,1,16,9,1305,1379,2760,1381
2017,1,16,10,1285,1376,2637,1261
2017,1,16,11,1295,1373,2436,1063
2017,1,16,12,1310,1394,2446,1052
2017,1,16,13,1360,1459,2468,1009
2017,1,16,14,1470,1550,2552,1002
2017,1,16,15,1550,1644,2662,1018
2017,1,16,16,1545,1683,2738,1055
2017,1,16,17,1555,1664,2712,1048
2017,1,16,18,1540,1653,2728,1075
2017,1,16,19,1530,1625,2728,1103
2017,1,16,20,1530,1587,2720,1133
2017,1,16,21,1505,1561,2749,1188
2017,1,16,22,1525,1498,2743,1245
2017,1,16,23,1490,1537,2693,1156
2017,1,17,0,1530,1577,2689,1112
2017,1,17,1,1615,1676,2703,1027
2017,1,17,2,1625,1698,2752,1054
2017,1,17,3,1595,1683,2770,1087
2017,1,17,4,1575,1648,2768,1120
2017,1,17,5,1500,1580,2762,1182
2017,1,17,6,1420,1502,2761,1259
2017,1,17,7,1355,1446,2769,1323
2017,1,17,8,1305,1414,2612,1198
2017,1,17,9,1280,1393,2597,1204
2017,1,17,10,1285,1386,2593,1207
2017,1,17,11,1280,1381,2593,1212
2017,1,17,12,1300,1409,2736,1327
2017,1,17,13,1335,1463,2790,1327
2017,1,17,14,1415,1583,2805,1222
2017,1,17,15,1490,1679,2804,1125
2017,1,17,16,1520,1666,2807,1141
2017,1,17,17,1530,1630,2795,1165
2017,1,17,18,1500,1601,2775,1174
2017,1,17,19,1500,1568,2715,1147
2017,1,17,20,1475,1539,2689,1150
2017,1,17,21,1490,1521,2693,1172
2017,1,17,22,1485,1494,2688,1194
2017,1,17,23,1475,1485,2701,1216
2017,1,18,0,1515,1518,2709,1191
2017,1,18,1,1615,1607,2699,1092
2017,1,18,2,1630,1639,2711,1072
2017,1,18,3,1590,1593,2704,1111
2017,1,18,4,1555,1570,2704,1134
2017,1,18,5,1475,1498,2681,1183
2017,1,18,6,1390,1408,2723,1315
2017,1,18,7,1320,1335,2743,1408
2017,1,18,8,1330,1309,2755,1446
2017,1,18,9,1320,1283,2755,1472
2017,1,18,10,1295,1280,2712,1432
2017,1,18,11,1295,1283,2720,1437
2017,1,18,12,1335,1312,2732,1420
2017,1,18,13,1415,1374,2768,1394
2017,1,18,14,1500,1483,2740,1257
2017,1,18,15,1580,1562,2738,1176
2017,1,18,16,1620,1556,2709,1153
2017,1,18,17,1555,1526,2678,1152
2017,1,18,18,1540,1508,2715,1207
2017,1,18,19,1515,1512,2782,1270
2017,1,18,20,1480,1476,2747,1271
2017,1,18,21,1450,1468,2742,1274
2017,1,18,22,1390,1439,2739,1300
2017,1,18,23,1445,1438,2706,1268
2017,1,19,0,1505,1467,2726,1259
2017,1,19,1,1580,1554,2795,1241
2017,1,19,2,1610,1566,2801,1235
2017,1,19,3,1600,1538,2784,1246
2017,1,19,4,1550,1501,2789,1288
2017,1,19,5,1490,1436,2766,1330
2017,1,19,6,1410,1358,2745,1387
2017,1,19,7,1355,1298,2698,1400
2017,1,19,8,1260,1266,2695,1429
2017,1,19,9,1260,1221,2681,1460
2017,1,19,10,1245,1212,2606,1394
2017,1,19,11,1255,1206,2425,1219
2017,1,19,12,1270,1232,2423,1191
2017,1,19,13,1350,1298,2402,1104
2017,1,19,14,1460,1427,2049,622
2017,1,19,15,1585,1513,1989,476
2017,1,19,16,1585,1516,2019,503
2017,1,19,17,1565,1509,2015,506
2017,1,19,18,1545,1502,2075,573
2017,1,19,19,1525,1472,2082,610
2017,1,19,20,1500,1452,2086,634
2017,1,19,21,1480,1437,2061,624
2017,1,19,22,1475,1427,2047,620
2017,1,19,23,1460,1422,2045,623
2017,1,20,0,1475,1435,1987,552
2017,1,20,1,1560,1506,1958,452
2017,1,20,2,1590,1522,1980,458
2017,1,20,3,1570,1512,1987,475
2017,1,20,4,1540,1474,1982,508
2017,1,20,5,1460,1411,1947,536
2017,1,20,6,1395,1321,2008,687
2017,1,20,7,1315,1269,2016,747
2017,1,20,8,1175,1241,2065,824
2017,1,20,9,1160,1241,768,-473
2017,1,20,10,1150,1239,820,-419
2017,1,20,11,1155,1250,837,-413
2017,1,20,12,1170,1218,957,-261
2017,1,20,13,1245,1282,1061,-221
2017,1,20,14,1385,1381,1055,-326
2017,1,20,15,1500,1481,1025,-456
2017,1,20,16,1475,1480,1013,-467
2017,1,20,17,1465,1464,978,-486
2017,1,20,18,1455,1435,995,-440
2017,1,20,19,1450,1417,1273,-144
2017,1,20,20,1415,1398,1531,133
2017,1,20,21,1400,1368,1521,153
2017,1,20,22,1380,1360,1561,201
2017,1,20,23,1365,1357,1577,220
2017,1,21,0,1390,1374,1567,193
2017,1,21,1,1470,1445,1574,129
2017,1,21,2,1480,1464,1603,139
2017,1,21,3,1450,1441,1665,224
2017,1,21,4,1420,1392,1694,302
2017,1,21,5,1370,1369,1740,371
2017,1,21,6,1270,1328,1922,594
2017,1,21,7,1205,1259,1926,667
2017,1,21,8,1240,1239,1879,640
2017,1,21,9,1225,1229,1868,639
2017,1,21,10,1205,1227,1862,635
2017,1,21,11,1205,1232,1865,633
2017,1,21,12,1225,1245,1853,608
2017,1,21,13,1265,1271,1834,563
2017,1,21,14,1340,1330,1870,540
2017,1,21,15,1415,1403,1851,448
2017,1,21,16,1445,1444,1844,400
2017,1,21,17,1455,1467,1840,373
2017,1,21,18,1450,1478,1845,367
2017,1,21,19,1445,1452,1840,388
2017,1,21,20,1420,1409,1845,436
2017,1,21,21,1395,1388,1848,460
2017,1,21,22,1375,1367,1689,322
2017,1,21,23,1375,1371,1751,380
2017,1,22,0,1420,1356,1705,349
2017,1,22,1,1495,1474,1899,425
2017,1,22,2,1480,1515,1911,396
2017,1,22,3,1465,1487,1909,422
2017,1,22,4,1445,1454,2048,594
2017,1,22,5,1405,1397,2069,672
2017,1,22,6,1345,1341,2123,782
2017,1,22,7,1305,1290,2238,948
2017,1,22,8,1240,1245,2180,935
2017,1,22,9,1230,1227,2233,1006
2017,1,22,10,1200,1209,2242,1033
2017,1,22,11,1215,1212,2272,1060
2017,1,22,12,1230,1218,2228,1010
2017,1,22,13,1255,1238,2184,946
2017,1,22,14,1295,1284,2189,905
2017,1,22,15,1335,1337,2083,746
2017,1,22,16,1375,1391,2243,852
2017,1,22,17,1390,1427,2404,977
2017,1,22,18,1375,1421,2535,1114
2017,1,22,19,1365,1398,2594,1196
2017,1,22,20,1355,1398,2589,1191
2017,1,22,21,1325,1377,2550,1173
2017,1,22,22,1320,1367,2552,1185
2017,1,22,23,1315,1382,2554,1172
2017,1,23,0,1370,1420,2560,1140
2017,1,23,1,1455,1532,2614,1082
2017,1,23,2,1490,1548,2616,1068
2017,1,23,3,1460,1518,2580,1062
2017,1,23,4,1415,1493,2574,1081
2017,1,23,5,1455,1430,2526,1096
2017,1,23,6,1280,1352,2590,1238
2017,1,23,7,1210,1287,2584,1297
2017,1,23,8,1220,1256,2573,1317
2017,1,23,9,1230,1243,2565,1322
2017,1,23,10,1230,1243,2577,1334
2017,1,23,11,1260,1256,2531,1275
2017,1,23,12,1240,1272,2455,1183
2017,1,23,13,1300,1336,2454,1118
2017,1,23,14,1415,1461,2486,1025
2017,1,23,15,1500,1569,2586,1017
2017,1,23,16,1510,1578,2597,1019
2017,1,23,17,1525,1576,2606,1030
2017,1,23,18,1505,1567,2626,1059
2017,1,23,19,1475,1556,2619,1063
2017,1,23,20,1445,1516,2633,1117
2017,1,23,21,1420,1496,2636,1140
2017,1,23,22,1420,1486,2654,1168
2017,1,23,23,1415,1497,2677,1180
2017,1,24,0,1425,1534,2638,1104
2017,1,24,1,1520,1602,2643,1041
2017,1,24,2,1535,1628,2647,1019
2017,1,24,3,1510,1592,2678,1086
2017,1,24,4,1475,1567,2705,1138
2017,1,24,5,1425,1492,2673,1181
2017,1,24,6,1330,1398,2586,1188
2017,1,24,7,1245,1332,2570,1238
2017,1,24,8,1225,1291,2538,1247
2017,1,24,9,1210,1281,2556,1275
2017,1,24,10,1205,1289,2574,1285
2017,1,24,11,1220,1280,2559,1279
2017,1,24,12,1270,1313,2571,1258
2017,1,24,13,1340,1370,2559,1189
2017,1,24,14,1440,1492,2567,1075
2017,1,24,15,1535,1581,2618,1037
2017,1,24,16,1535,1578,2596,1018
2017,1,24,17,1530,1570,2590,1020
2017,1,24,18,1510,1582,2602,1020
2017,1,24,19,1495,1529,2615,1086
2017,1,24,20,1470,1496,2596,1100
2017,1,24,21,1435,1474,2606,1132
2017,1,24,22,1430,1447,2577,1130
2017,1,24,23,1465,1439,2590,1151
2017,1,25,0,1490,1468,2570,1102
2017,1,25,1,1560,1557,2605,1048
2017,1,25,2,1590,1600,2676,1076
2017,1,25,3,1575,1594,2660,1066
2017,1,25,4,1545,1558,2644,1086
2017,1,25,5,1495,1501,2643,1142
2017,1,25,6,1415,1424,2623,1199
2017,1,25,7,1335,1365,2613,1248
2017,1,25,8,1240,1311,2606,1295
2017,1,25,9,1225,1295,2570,1275
2017,1,25,10,1215,1297,2556,1259
2017,1,25,11,1230,1299,2554,1255
2017,1,25,12,1270,1317,2543,1226
2017,1,25,13,1335,1370,2594,1224
2017,1,25,14,1450,1506,2594,1088
2017,1,25,15,1535,1604,2649,1045
2017,1,25,16,1550,1599,2610,1011
2017,1,25,17,1530,1592,2588,996
2017,1,25,18,1510,1593,2619,1026
2017,1,25,19,1505,1540,2625,1085
2017,1,25,20,1470,1519,2620,1101
2017,1,25,21,1455,1482,2607,1125
2017,1,25,22,1445,1473,2618,1145
2017,1,25,23,1450,1461,2613,1152
2017,1,26,0,1495,1492,2598,1106
2017,1,26,1,1560,1552,2666,1114
2017,1,26,2,1580,1597,2665,1068
2017,1,26,3,1550,1587,2642,1055
2017,1,26,4,1505,1562,2648,1086
2017,1,26,5,1435,1494,2604,1110
2017,1,26,6,1350,1410,2570,1160
2017,1,26,7,1300,1340,2546,1206
2017,1,26,8,1270,1290,2542,1252
2017,1,26,9,1230,1275,2447,1172
2017,1,26,10,1235,1271,2435,1164
2017,1,26,11,1245,1269,2433,1164
2017,1,26,12,1270,1293,2479,1186
2017,1,26,13,1325,1363,2577,1214
2017,1,26,14,1445,1490,2618,1128
2017,1,26,15,1545,1557,2611,1054
2017,1,26,16,1540,1546,2638,1092
2017,1,26,17,1525,1541,2635,1094
2017,1,26,18,1530,1524,2632,1108
2017,1,26,19,1490,1501,2647,1146
2017,1,26,20,1460,1469,2666,1197
2017,1,26,21,1435,1447,2667,1220
2017,1,26,22,1415,1447,2665,1218
2017,1,26,23,1410,1462,2662,1200
2017,1,27,0,1435,1480,2666,1186
2017,1,27,1,1510,1570,2724,1154
2017,1,27,2,1545,1603,2740,1137
2017,1,27,3,1530,1598,2737,1139
2017,1,27,4,1510,1566,2753,1187
2017,1,27,5,1435,1513,2783,1270
2017,1,27,6,1370,1439,2787,1348
2017,1,27,7,1325,1364,2738,1374
2017,1,27,8,1250,1336,2735,1399
2017,1,27,9,1210,1313,2598,1285
2017,1,27,10,1205,1307,2621,1314
2017,1,27,11,1220,1330,2655,1325
2017,1,27,12,1255,1330,2651,1321
2017,1,27,13,1330,1401,2806,1405
2017,1,27,14,1450,1504,2832,1328
2017,1,27,15,1525,1609,2812,1203
2017,1,27,16,1520,1605,2796,1191
2017,1,27,17,1500,1579,2794,1215
2017,1,27,18,1485,1526,2780,1254
2017,1,27,19,1460,1509,2744,1235
2017,1,27,20,1435,1460,2719,1259
2017,1,27,21,1395,1453,2695,1242
2017,1,27,22,1380,1420,2666,1246
2017,1,27,23,1385,1424,2655,1231
2017,1,28,0,1410,1469,2726,1257
2017,1,28,1,1475,1541,2752,1211
2017,1,28,2,1500,1571,2753,1182
2017,1,28,3,1480,1553,2765,1212
2017,1,28,4,1450,1525,2770,1245
2017,1,28,5,1430,1493,2781,1288
2017,1,28,6,1335,1423,2775,1352
2017,1,28,7,1265,1365,2741,1376
2017,1,28,8,1195,1317,2728,1411
2017,1,28,9,1185,1307,2727,1420
2017,1,28,10,1185,1290,2733,1443
2017,1,28,11,1195,1301,2740,1439
2017,1,28,12,1210,1294,2708,1414
2017,1,28,13,1230,1332,2711,1379
2017,1,28,14,1265,1379,2719,1340
2017,1,28,15,1345,1443,2778,1335
2017,1,28,16,1380,1478,2787,1309
2017,1,28,17,1395,1504,2821,1317
2017,1,28,18,1400,1495,2824,1329
2017,1,28,19,1370,1490,2824,1334
2017,1,28,20,1355,1441,2812,1371
2017,1,28,21,1330,1408,2810,1402
2017,1,28,22,1320,1402,2793,1391
2017,1,28,23,1325,1381,2680,1299
2017,1,29,0,1340,1411,2675,1264
2017,1,29,1,1435,1491,2777,1286
2017,1,29,2,1465,1521,2783,1262
2017,1,29,3,1435,1493,2779,1286
2017,1,29,4,1415,1476,2781,1305
2017,1,29,5,1365,1428,2751,1323
2017,1,29,6,1280,1371,2563,1192
2017,1,29,7,1215,1316,2499,1183
2017,1,29,8,1200,1272,2462,1190
2017,1,29,9,1185,1257,2475,1218
2017,1,29,10,1180,1243,2461,1218
2017,1,29,11,1190,1253,2478,1225
2017,1,29,12,1210,1253,2510,1257
2017,1,29,13,1220,1265,2533,1268
2017,1,29,14,1255,1309,2565,1256
2017,1,29,15,1320,1361,2559,1198
2017,1,29,16,1370,1396,2546,1150
2017,1,29,17,1385,1406,2549,1143
2017,1,29,18,1390,1411,2556,1145
2017,1,29,19,1360,1415,2582,1167
2017,1,29,20,1350,1395,2591,1196
2017,1,29,21,1320,1367,2575,1208
2017,1,29,22,1315,1347,2565,1218
2017,1,29,23,1325,1343,2552,1209
2017,1,30,0,1355,1364,2553,1189
2017,1,30,1,1455,1455,2548,1093
2017,1,30,2,1480,1524,2567,1043
2017,1,30,3,1450,1492,2559,1067
2017,1,30,4,1425,1449,2612,1163
2017,1,30,5,1360,1393,2582,1189
2017,1,30,6,1280,1324,2522,1198
2017,1,30,7,1220,1266,2532,1266
2017,1,30,8,1205,1223,2551,1328
2017,1,30,9,1180,1222,2559,1337
2017,1,30,10,1170,1210,2569,1359
2017,1,30,11,1185,1221,2567,1346
2017,1,30,12,1230,1242,2563,1321
2017,1,30,13,1295,1295,2543,1248
2017,1,30,14,1400,1410,2552,1142
2017,1,30,15,1465,1521,2604,1083
2017,1,30,16,1480,1498,2619,1121
2017,1,30,17,1465,1458,2583,1125
2017,1,30,18,1450,1450,2582,1132
2017,1,30,19,1435,1425,2585,1160
2017,1,30,20,1410,1405,2585,1180
2017,1,30,21,1380,1383,2570,1187
2017,1,30,22,1365,1367,2574,1207
2017,1,30,23,1385,1367,2558,1191
2017,1,31,0,1425,1403,2551,1148
2017,1,31,1,1495,1471,2537,1066
2017,1,31,2,1515,1523,2585,1062
2017,1,31,3,1490,1502,2530,1028
2017,1,31,4,1445,1465,2503,1038
2017,1,31,5,1365,1402,2474,1072
2017,1,31,6,1305,1319,2493,1174
2017,1,31,7,1250,1250,2496,1246
2017,1,31,8,1230,1214,2512,1298
2017,1,31,9,1220,1204,2574,1370
2017,1,31,10,1190,1190,2617,1427
2017,1,31,11,1220,1227,2706,1479
2017,1,31,12,1240,1259,2744,1485
2017,1,31,13,1290,1322,2751,1429
2017,1,31,14,1400,1442,2800,1358
2017,1,31,15,1535,1537,2814,1277
2017,1,31,16,1530,1539,2848,1309
2017,1,31,17,1515,1542,2809,1267
2017,1,31,18,1515,1536,2793,1257
2017,1,31,19,1485,1536,2774,1238
2017,1,31,20,1455,1526,2741,1215
2017,1,31,21,1430,1503,2666,1163
2017,1,31,22,1415,1498,2668,1170
2017,1,31,23,1405,1509,2641,1132
2017,2,1,0,1425,1538,2632,1094
2017,2,1,1,1495,1597,2700,1103
2017,2,1,2,1535,1643,2758,1115
2017,2,1,3,1510,1617,2778,1161
2017,2,1,4,1485,1600,2778,1178
2017,2,1,5,1415,1525,2719,1194
2017,2,1,6,1340,1431,2731,1300
2017,2,1,7,1285,1374,2709,1335
2017,2,1,8,1260,1332,2742,1410
2017,2,1,9,1265,1308,2729,1421
2017,2,1,10,1235,1302,2777,1475
2017,2,1,11,1260,1305,2791,1486
2017,2,1,12,1280,1333,2806,1473
2017,2,1,13,1335,1387,2774,1387
2017,2,1,14,1465,1507,2804,1297
2017,2,1,15,1590,1609,2828,1219
2017,2,1,16,1590,1600,2845,1245
2017,2,1,17,1560,1596,2833,1237
2017,2,1,18,1550,1578,2778,1200
2017,2,1,19,1520,1563,2796,1233
2017,2,1,20,1495,1540,2780,1240
2017,2,1,21,1445,1515,2783,1268
2017,2,1,22,1425,1513,2758,1245
2017,2,1,23,1430,1497,2717,1220
2017,2,2,0,1480,1537,2753,1216
2017,2,2,1,1535,1621,2825,1204
2017,2,2,2,1575,1683,2828,1145
2017,2,2,3,1565,1678,2781,1103
2017,2,2,4,1535,1661,2791,1130
2017,2,2,5,1475,1589,2748,1159
2017,2,2,6,1390,1508,2742,1234
2017,2,2,7,1315,1444,2697,1253
2017,2,2,8,1285,1405,2648,1243
2017,2,2,9,1285,1397,2622,1225
2017,2,2,10,1305,1398,2627,1229
2017,2,2,11,1305,1395,2624,1229
2017,2,2,12,1315,1423,2644,1221
2017,2,2,13,1360,1470,2648,1178
2017,2,2,14,1480,1588,2650,1062
2017,2,2,15,1575,1675,2727,1052
2017,2,2,16,1590,1662,2666,1004
2017,2,2,17,1580,1650,2593,943
2017,2,2,18,1560,1633,2606,973
2017,2,2,19,1545,1602,2608,1006
2017,2,2,20,1535,1570,2603,1033
2017,2,2,21,1495,1544,2614,1070
2017,2,2,22,1475,1530,2624,1094
2017,2,2,23,1495,1520,2614,1094
2017,2,3,0,1535,1530,2623,1093
2017,2,3,1,1620,1605,2639,1034
2017,2,3,2,1650,1681,2694,1013
2017,2,3,3,1630,1687,2665,978
2017,2,3,4,1605,1665,2674,1009
2017,2,3,5,1560,1628,2645,1017
2017,2,3,6,1455,1537,2658,1121
2017,2,3,7,1375,1471,2633,1162
2017,2,3,8,1360,1443,2638,1195
2017,2,3,9,1365,1420,2517,1097
2017,2,3,10,1375,1413,2493,1080
2017,2,3,11,1380,1408,2509,1101
2017,2,3,12,1395,1424,2516,1092
2017,2,3,13,1460,1485,2652,1167
2017,2,3,14,1560,1608,2646,1038
2017,2,3,15,1620,1682,2673,991
2017,2,3,16,1620,1674,2681,1007
2017,2,3,17,1600,1664,2681,1017
2017,2,3,18,1560,1631,2686,1055
2017,2,3,19,1535,1618,2694,1076
2017,2,3,20,1510,1592,2696,1104
2017,2,3,21,1465,1573,2714,1141
2017,2,3,22,1450,1544,2684,1140
2017,2,3,23,1455,1531,2665,1134
2017,2,4,0,1485,1546,2699,1153
2017,2,4,1,1580,1600,2703,1103
2017,2,4,2,1605,1630,2695,1065
2017,2,4,3,1580,1611,2728,1117
2017,2,4,4,1570,1572,2678,1106
2017,2,4,5,1510,1530,2730,1200
2017,2,4,6,1445,1455,2715,1260
2017,2,4,7,1385,1382,2650,1268
2017,2,4,8,1275,1333,2602,1269
2017,2,4,9,1260,1327,2600,1273
2017,2,4,10,1260,1296,2579,1283
2017,2,4,11,1270,1301,2564,1263
2017,2,4,12,1280,1297,2591,1294
2017,2,4,13,1315,1331,2626,1295
2017,2,4,14,1365,1365,2639,1274
2017,2,4,15,1455,1425,2602,1177
2017,2,4,16,1480,1463,2652,1189
2017,2,4,17,1485,1491,2693,1202
2017,2,4,18,1485,1484,2664,1180
2017,2,4,19,1470,1466,2570,1104
2017,2,4,20,1430,1441,2516,1075
2017,2,4,21,1395,1436,2500,1064
2017,2,4,22,1390,1407,2473,1066
2017,2,4,23,1380,1404,2467,1063
2017,2,5,0,1395,1411,2472,1061
2017,2,5,1,1495,1477,2550,1073
2017,2,5,2,1515,1538,2577,1039
2017,2,5,3,1490,1512,2554,1042
2017,2,5,4,1475,1490,2560,1070
2017,2,5,5,1425,1443,2561,1118
2017,2,5,6,1360,1368,2422,1054
2017,2,5,7,1295,1303,2415,1112
2017,2,5,8,1250,1267,2401,1134
2017,2,5,9,1235,1236,2340,1104
2017,2,5,10,1235,1238,2465,1227
2017,2,5,11,1250,1237,2495,1258
2017,2,5,12,1265,1244,2506,1262
2017,2,5,13,1275,1266,2520,1254
2017,2,5,14,1280,1301,2511,1210
2017,2,5,15,1325,1344,2183,839
2017,2,5,16,1365,1390,2409,1019
2017,2,5,17,1380,1422,2456,1034
2017,2,5,18,1380,1432,2642,1210
2017,2,5,19,1365,1431,2638,1207
2017,2,5,20,1360,1427,2666,1239
2017,2,5,21,1330,1413,2684,1271
2017,2,5,22,1320,1393,2710,1317
2017,2,5,23,1320,1394,2712,1318
2017,2,6,0,1355,1395,2661,1266
2017,2,6,1,1450,1404,2631,1227
2017,2,6,2,1490,1443,2710,1267
2017,2,6,3,1475,1440,2700,1260
2017,2,6,4,1415,1420,2707,1287
2017,2,6,5,1375,1421,2712,1291
2017,2,6,6,1285,1346,2680,1334
2017,2,6,7,1235,1291,2656,1365
2017,2,6,8,1215,1254,2616,1362
2017,2,6,9,1205,1244,2548,1304
2017,2,6,10,1190,1236,2400,1164
2017,2,6,11,1210,1237,2345,1108
2017,2,6,12,1250,1264,2333,1069
2017,2,6,13,1310,1323,2392,1069
2017,2,6,14,1430,1454,2466,1012
2017,2,6,15,1545,1546,2542,996
2017,2,6,16,1555,1544,2551,1007
2017,2,6,17,1525,1542,2550,1008
2017,2,6,18,1510,1512,2548,1036
2017,2,6,19,1495,1502,2514,1012
2017,2,6,20,1460,1470,2503,1033
2017,2,6,21,1435,1455,2564,1109
2017,2,6,22,1415,1450,2608,1158
2017,2,6,23,1425,1459,2637,1178
2017,2,7,0,1475,1480,2666,1186
2017,2,7,1,1535,1540,2549,1009
2017,2,7,2,1570,1599,2653,1054
2017,2,7,3,1545,1584,2666,1082
2017,2,7,4,1500,1539,2593,1054
2017,2,7,5,1420,1479,2579,1100
2017,2,7,6,1350,1400,2575,1175
2017,2,7,7,1290,1333,2565,1232
2017,2,7,8,1230,1292,2404,1112
2017,2,7,9,1215,1275,2358,1083
2017,2,7,10,1225,1267,2402,1135
2017,2,7,11,1230,1270,2493,1223
2017,2,7,12,1255,1302,2665,1363
2017,2,7,13,1325,1365,2708,1343
2017,2,7,14,1440,1487,2718,1231
2017,2,7,15,1535,1561,2734,1173
2017,2,7,16,1540,1559,2708,1149
2017,2,7,17,1535,1565,2667,1102
2017,2,7,18,1540,1564,2583,1019
2017,2,7,19,1510,1543,2478,935
2017,2,7,20,1485,1533,2446,913
2017,2,7,21,1465,1525,2446,921
2017,2,7,22,1445,1521,2436,915
2017,2,7,23,1445,1537,2448,911
2017,2,8,0,1465,1571,2441,870
2017,2,8,1,1530,1621,2498,877
2017,2,8,2,1570,1666,2597,931
2017,2,8,3,1555,1686,2559,873
2017,2,8,4,1530,1654,2501,847
2017,2,8,5,1460,1588,2497,909
2017,2,8,6,1390,1507,2500,993
2017,2,8,7,1340,1430,2414,984
2017,2,8,8,1270,1374,2334,960
2017,2,8,9,1255,1345,2313,968
2017,2,8,10,1265,1334,2315,981
2017,2,8,11,1290,1330,2304,974
2017,2,8,12,1300,1353,2310,957
2017,2,8,13,1370,1412,2404,992
2017,2,8,14,1480,1547,2537,990
2017,2,8,15,1535,1623,2603,980
2017,2,8,16,1545,1617,2627,1010
2017,2,8,17,1530,1595,2618,1023
2017,2,8,18,1525,1581,2597,1016
2017,2,8,19,1495,1556,2592,1036
2017,2,8,20,1475,1544,2675,1131
2017,2,8,21,1420,1530,2676,1146
2017,2,8,22,1425,1525,2682,1157
2017,2,8,23,1420,1529,2641,1112
2017,2,9,0,1460,1553,2641,1088
2017,2,9,1,1505,1608,2637,1029
2017,2,9,2,1555,1671,2634,963
2017,2,9,3,1550,1633,2666,1033
2017,2,9,4,1510,1606,2653,1047
2017,2,9,5,1450,1521,2612,1091
2017,2,9,6,1370,1444,2582,1138
2017,2,9,7,1305,1353,2554,1201
2017,2,9,8,1240,1304,2561,1257
2017,2,9,9,1230,1287,2561,1274
2017,2,9,10,1225,1275,2559,1284
2017,2,9,11,1220,1277,2577,1300
2017,2,9,12,1245,1290,2592,1302
2017,2,9,13,1305,1331,2599,1268
2017,2,9,14,1420,1453,2664,1211
2017,2,9,15,1485,1524,2711,1187
2017,2,9,16,1510,1522,2718,1196
2017,2,9,17,1495,1522,2713,1191
2017,2,9,18,1490,1502,2703,1201
2017,2,9,19,1455,1467,2658,1191
2017,2,9,20,1430,1429,2613,1184
2017,2,9,21,1420,1430,2662,1232
2017,2,9,22,1400,1436,2691,1255
2017,2,9,23,1410,1449,2699,1250
2017,2,10,0,1420,1443,2720,1277
2017,2,10,1,1495,1486,2737,1251
2017,2,10,2,1520,1509,2735,1226
2017,2,10,3,1520,1488,2750,1262
2017,2,10,4,1465,1457,2742,1285
2017,2,10,5,1415,1394,2642,1248
2017,2,10,6,1340,1328,2628,1300
2017,2,10,7,1270,1262,2401,1139
2017,2,10,8,1165,1207,2259,1052
2017,2,10,9,1170,1185,2328,1143
2017,2,10,10,1170,1165,2199,1034
2017,2,10,11,1190,1159,2200,1041
2017,2,10,12,1170,1181,2282,1101
2017,2,10,13,1225,1218,2322,1104
2017,2,10,14,1350,1341,2608,1267
2017,2,10,15,1470,1424,2727,1303
2017,2,10,16,1465,1430,2648,1218
2017,2,10,17,1440,1427,2618,1191
2017,2,10,18,1420,1443,2641,1198
2017,2,10,19,1405,1420,2674,1254
2017,2,10,20,1385,1419,2709,1290
2017,2,10,21,1360,1400,2714,1314
2017,2,10,22,1340,1385,2567,1182
2017,2,10,23,1340,1381,2587,1206
2017,2,11,0,1360,1378,2561,1183
2017,2,11,1,1425,1413,2679,1266
2017,2,11,2,1450,1458,2666,1208
2017,2,11,3,1420,1449,2632,1183
2017,2,11,4,1390,1406,2575,1169
2017,2,11,5,1370,1392,2474,1082
2017,2,11,6,1290,1324,2368,1044
2017,2,11,7,1205,1284,2385,1101
2017,2,11,8,1250,1213,2318,1105
2017,2,11,9,1245,1190,2363,1173
2017,2,11,10,1230,1181,2321,1140
2017,2,11,11,1240,1173,2232,1059
2017,2,11,12,1235,1193,2246,1053
2017,2,11,13,1275,1205,2312,1107
2017,2,11,14,1340,1274,2429,1155
2017,2,11,15,1430,1361,2613,1252
2017,2,11,16,1460,1391,2635,1244
2017,2,11,17,1475,1407,2620,1213
2017,2,11,18,1470,1395,2690,1295
2017,2,11,19,1460,1388,2729,1341
2017,2,11,20,1420,1349,2429,1080
2017,2,11,21,1385,1323,2260,937
2017,2,11,22,1380,1319,2223,904
2017,2,11,23,1370,1323,2243,920
2017,2,12,0,1400,1345,2445,1100
2017,2,12,1,1470,1399,2452,1053
2017,2,12,2,1505,1467,2545,1078
2017,2,12,3,1485,1462,2558,1096
2017,2,12,4,1455,1436,2534,1098
2017,2,12,5,1415,1400,2539,1139
2017,2,12,6,1360,1354,2584,1230
2017,2,12,7,1295,1305,2657,1352
2017,2,12,8,1240,1254,2633,1379
2017,2,12,9,1220,1226,2412,1186
2017,2,12,10,1225,1230,2386,1156
2017,2,12,11,1220,1230,2352,1122
2017,2,12,12,1235,1257,2474,1217
2017,2,12,13,1250,1301,2614,1313
2017,2,12,14,1280,1358,2710,1352
2017,2,12,15,1330,1406,2789,1383
2017,2,12,16,1360,1444,2795,1351
2017,2,12,17,1385,1450,2779,1329
2017,2,12,18,1400,1450,2786,1336
2017,2,12,19,1390,1449,2785,1336
2017,2,12,20,1385,1408,2790,1382
2017,2,12,21,1380,1383,2714,1331
2017,2,12,22,1360,1347,2635,1288
2017,2,12,23,1355,1342,2497,1155
2017,2,13,0,1365,1350,2413,1063
2017,2,13,1,1390,1428,2592,1164
2017,2,13,2,1455,1517,2781,1264
2017,2,13,3,1445,1507,2809,1302
2017,2,13,4,1390,1488,2793,1305
2017,2,13,5,1380,1439,2753,1314
2017,2,13,6,1285,1355,2668,1313
2017,2,13,7,1225,1292,2673,1381
2017,2,13,8,1190,1258,2600,1342
2017,2,13,9,1180,1234,2555,1321
2017,2,13,10,1190,1232,2489,1257
2017,2,13,11,1200,1224,2455,1231
2017,2,13,12,1230,1254,2553,1299
2017,2,13,13,1295,1326,2690,1364
2017,2,13,14,1390,1459,2782,1323
2017,2,13,15,1505,1557,2744,1187
2017,2,13,16,1505,1530,2763,1233
2017,2,13,17,1470,1481,2721,1240
2017,2,13,18,1455,1446,2696,1250
2017,2,13,19,1430,1413,2655,1242
2017,2,13,20,1405,1382,2602,1220
2017,2,13,21,1380,1348,2298,950
2017,2,13,22,1365,1312,2112,800
2017,2,13,23,1370,1316,2189,873
2017,2,14,0,1415,1332,2218,886
2017,2,14,1,1460,1382,2312,930
2017,2,14,2,1520,1476,2589,1113
2017,2,14,3,1510,1476,2585,1109
2017,2,14,4,1450,1466,2608,1142
2017,2,14,5,1405,1407,2580,1173
2017,2,14,6,1320,1324,2570,1246
2017,2,14,7,1235,1263,2595,1332
2017,2,14,8,1230,1220,2553,1333
2017,2,14,9,1200,1208,2480,1272
2017,2,14,10,1200,1207,2113,906
2017,2,14,11,1210,1222,1953,731
2017,2,14,12,1230,1238,1934,696
2017,2,14,13,1320,1311,1932,621
2017,2,14,14,1430,1427,2000,573
2017,2,14,15,1530,1514,1966,452
2017,2,14,16,1500,1494,1966,472
2017,2,14,17,1490,1457,1948,491
2017,2,14,18,1470,1442,1957,515
2017,2,14,19,1440,1397,1931,534
2017,2,14,20,1425,1370,1930,560
2017,2,14,21,1410,1342,1891,549
2017,2,14,22,1395,1320,1890,570
2017,2,14,23,1400,1308,1726,418
2017,2,15,0,1410,1322,1738,416
2017,2,15,1,1485,1384,1931,547
2017,2,15,2,1510,1459,1944,485
2017,2,15,3,1510,1456,1955,499
2017,2,15,4,1455,1438,1988,550
2017,2,15,5,1375,1395,2042,647
2017,2,15,6,1325,1314,2034,720
2017,2,15,7,1260,1263,2018,755
2017,2,15,8,1195,1220,1976,756
2017,2,15,9,1185,1200,1978,778
2017,2,15,10,1195,1196,1966,770
2017,2,15,11,1200,1194,1958,764
2017,2,15,12,1230,1217,1998,781
2017,2,15,13,1300,1281,2045,764
2017,2,15,14,1415,1408,2103,695
2017,2,15,15,1520,1506,2122,616
2017,2,15,16,1500,1460,2102,642
2017,2,15,17,1465,1440,2026,586
2017,2,15,18,1440,1395,1954,559
2017,2,15,19,1415,1375,1748,373
2017,2,15,20,1380,1338,1722,384
2017,2,15,21,1355,1329,1753,424
2017,2,15,22,1330,1316,1782,466
2017,2,15,23,1325,1329,1871,542
2017,2,16,0,1340,1346,1986,640
2017,2,16,1,1405,1386,2028,642
2017,2,16,2,1460,1447,2054,607
2017,2,16,3,1440,1445,2065,620
2017,2,16,4,1415,1413,2039,626
2017,2,16,5,1355,1355,2045,690
2017,2,16,6,1275,1274,1996,722
2017,2,16,7,1205,1197,1954,757
2017,2,16,8,1160,1148,1753,605
2017,2,16,9,1155,1147,1925,778
2017,2,16,10,1160,1162,1930,768
2017,2,16,11,1170,1163,1898,735
2017,2,16,12,1185,1190,1982,792
2017,2,16,13,1245,1246,2010,764
2017,2,16,14,1380,1359,2063,704
2017,2,16,15,1495,1430,2051,621
2017,2,16,16,1475,1399,1966,567
2017,2,16,17,1445,1398,1916,518
2017,2,16,18,1410,1380,1819,439
2017,2,16,19,1385,1374,1820,446
2017,2,16,20,1340,1344,1751,407
2017,2,16,21,1315,1348,1771,423
2017,2,16,22,1295,1339,1807,468
2017,2,16,23,1285,1342,1755,413
2017,2,17,0,1295,1374,1820,446
2017,2,17,1,1310,1409,1916,507
2017,2,17,2,1415,1436,2040,604
2017,2,17,3,1425,1428,2077,649
2017,2,17,4,1410,1406,2058,652
2017,2,17,5,1355,1325,1933,608
2017,2,17,6,1285,1265,1899,634
2017,2,17,7,1215,1176,1858,682
2017,2,17,8,1140,1134,1678,544
2017,2,17,9,1130,1120,1621,501
2017,2,17,10,1150,1101,1517,416
2017,2,17,11,1170,1100,1493,393
2017,2,17,12,1190,1127,1582,455
2017,2,17,13,1290,1183,1907,724
2017,2,17,14,1365,1295,2308,1013
2017,2,17,15,1430,1383,2521,1138
2017,2,17,16,1395,1381,2509,1128
2017,2,17,17,1385,1393,2521,1128
2017,2,17,18,1395,1385,2570,1185
2017,2,17,19,1360,1381,2585,1204
2017,2,17,20,1345,1350,2588,1238
2017,2,17,21,1335,1318,2492,1174
2017,2,17,22,1320,1282,2205,923
2017,2,17,23,1325,1253,2160,907
2017,2,18,0,1325,1257,2083,826
2017,2,18,1,1360,1296,2344,1048
2017,2,18,2,1410,1357,2586,1229
2017,2,18,3,1405,1344,2585,1241
2017,2,18,4,1370,1332,2589,1257
2017,2,18,5,1350,1289,2582,1293
2017,2,18,6,1250,1226,2597,1371
2017,2,18,7,1195,1174,2526,1352
2017,2,18,8,1160,1142,2402,1260
2017,2,18,9,1150,1104,2203,1099
2017,2,18,10,1145,1096,1997,901
2017,2,18,11,1125,1097,2026,929
2017,2,18,12,1135,1098,1965,867
2017,2,18,13,1160,1118,1968,850
2017,2,18,14,1250,1184,2179,995
2017,2,18,15,1355,1243,2298,1055
2017,2,18,16,1360,1289,2236,947
2017,2,18,17,1365,1329,2280,951
2017,2,18,18,1355,1314,2417,1103
2017,2,18,19,1345,1281,2333,1052
2017,2,18,20,1310,1265,2313,1048
2017,2,18,21,1300,1247,2239,992
2017,2,18,22,1295,1223,2230,1007
2017,2,18,23,1290,1229,2221,992
2017,2,19,0,1315,1244,2315,1071
2017,2,19,1,1365,1294,2465,1171
2017,2,19,2,1420,1354,2612,1258
2017,2,19,3,1405,1323,2605,1282
2017,2,19,4,1380,1314,2620,1306
2017,2,19,5,1340,1254,2470,1216
2017,2,19,6,1285,1212,2390,1178
2017,2,19,7,1225,1154,2332,1178
2017,2,19,8,1140,1118,2128,1010
2017,2,19,9,1120,1093,2080,987
2017,2,19,10,1135,1081,1977,896
2017,2,19,11,1140,1077,2000,923
2017,2,19,12,1170,1093,1948,855
2017,2,19,13,1225,1107,1988,881
2017,2,19,14,1295,1159,2062,903
2017,2,19,15,1360,1215,2122,907
2017,2,19,16,1385,1272,2300,1028
2017,2,19,17,1395,1296,2253,957
2017,2,19,18,1380,1311,2270,959
2017,2,19,19,1390,1304,2189,885
2017,2,19,20,1350,1272,2083,811
2017,2,19,21,1335,1235,2109,874
2017,2,19,22,1290,1218,1951,733
2017,2,19,23,1280,1222,1827,605
2017,2,20,0,1300,1246,1878,632
2017,2,20,1,1370,1314,2346,1032
2017,2,20,2,1435,1373,2483,1110
2017,2,20,3,1420,1369,2544,1175
2017,2,20,4,1400,1353,2629,1276
2017,2,20,5,1355,1306,2618,1312
2017,2,20,6,1270,1244,2466,1222
2017,2,20,7,1205,1188,2282,1094
2017,2,20,8,1190,1152,2028,876
2017,2,20,9,1170,1130,1927,797
2017,2,20,10,1160,1117,1894,777
2017,2,20,11,1180,1113,1959,846
2017,2,20,12,1200,1126,1989,863
2017,2,20,13,1265,1178,1979,801
2017,2,20,14,1385,1289,2256,967
2017,2,20,15,1495,1372,2456,1084
2017,2,20,16,1470,1382,2502,1120
2017,2,20,17,1435,1391,2466,1075
2017,2,20,18,1415,1384,2401,1017
2017,2,20,19,1390,1362,2461,1099
2017,2,20,20,1360,1367,2494,1127
2017,2,20,21,1335,1362,2537,1175
2017,2,20,22,1305,1348,2385,1037
2017,2,20,23,1310,1332,2180,848
2017,2,21,0,1345,1339,2140,801
2017,2,21,1,1395,1365,2218,853
2017,2,21,2,1450,1439,2503,1064
2017,2,21,3,1435,1425,2600,1175
2017,2,21,4,1400,1398,2701,1303
2017,2,21,5,1355,1322,2719,1397
2017,2,21,6,1275,1260,2724,1464
2017,2,21,7,1195,1204,2690,1486
2017,2,21,8,1090,1175,2604,1429
2017,2,21,9,1070,1114,2068,954
2017,2,21,10,1060,1108,1965,857
2017,2,21,11,1065,1115,2040,925
2017,2,21,12,1075,1124,2063,939
2017,2,21,13,1140,1175,2424,1249
2017,2,21,14,1270,1301,2513,1212
2017,2,21,15,1370,1398,2552,1154
2017,2,21,16,1375,1364,2598,1234
2017,2,21,17,1375,1370,2608,1238
2017,2,21,18,1375,1364,2627,1263
2017,2,21,19,1350,1345,2606,1261
2017,2,21,20,1325,1330,2643,1313
2017,2,21,21,1330,1315,2598,1283
2017,2,21,22,1315,1311,2589,1278
2017,2,21,23,1305,1296,2425,1129
2017,2,22,0,1305,1296,2351,1055
2017,2,22,1,1345,1339,2472,1133
2017,2,22,2,1400,1421,2689,1268
2017,2,22,3,1385,1411,2693,1282
2017,2,22,4,1360,1385,2631,1246
2017,2,22,5,1290,1321,2572,1251
2017,2,22,6,1200,1219,2277,1058
2017,2,22,7,1115,1151,2070,919
2017,2,22,8,1180,1112,1798,686
2017,2,22,9,1140,1087,1707,620
2017,2,22,10,1135,1096,1692,596
2017,2,22,11,1140,1095,1663,568
2017,2,22,12,1165,1111,1746,635
2017,2,22,13,1210,1188,2220,1032
2017,2,22,14,1360,1347,2555,1208
2017,2,22,15,1480,1419,2594,1175
2017,2,22,16,1460,1433,2559,1126
2017,2,22,17,1460,1417,2578,1161
2017,2,22,18,1440,1420,2562,1142
2017,2,22,19,1415,1399,2507,1108
2017,2,22,20,1395,1369,2443,1074
2017,2,22,21,1380,1350,2332,982
2017,2,22,22,1365,1341,2355,1014
2017,2,22,23,1365,1339,2277,938
2017,2,23,0,1380,1353,2316,963
2017,2,23,1,1435,1411,2576,1165
2017,2,23,2,1500,1480,2613,1133
2017,2,23,3,1480,1470,2602,1132
2017,2,23,4,1460,1452,2643,1191
2017,2,23,5,1370,1395,2570,1175
2017,2,23,6,1295,1311,2553,1242
2017,2,23,7,1225,1238,2484,1246
2017,2,23,8,1160,1198,2412,1214
2017,2,23,9,1120,1179,2446,1267
2017,2,23,10,1120,1190,2459,1269
2017,2,23,11,1110,1200,2444,1244
2017,2,23,12,1130,1211,2468,1257
2017,2,23,13,1200,1267,2535,1268
2017,2,23,14,1370,1399,2637,1238
2017,2,23,15,1470,1480,2654,1174
2017,2,23,16,1460,1489,2719,1230
2017,2,23,17,1470,1484,2640,1156
2017,2,23,18,1470,1465,2477,1012
2017,2,23,19,1450,1428,2406,978
2017,2,23,20,1425,1430,2100,670
2017,2,23,21,1405,1406,1753,347
2017,2,23,22,1405,1411,1767,356
2017,2,23,23,1400,1398,1770,372
2017,2,24,0,1405,1409,1804,395
2017,2,24,1,1450,1482,2448,966
2017,2,24,2,1505,1541,2550,1009
2017,2,24,3,1490,1535,2590,1055
2017,2,24,4,1460,1496,2626,1130
2017,2,24,5,1370,1441,2577,1136
2017,2,24,6,1310,1343,2474,1131
2017,2,24,7,1235,1277,2414,1137
2017,2,24,8,1190,1249,2260,1011
2017,2,24,9,1180,1213,1996,783
2017,2,24,10,1160,1203,1771,568
2017,2,24,11,1165,1207,1736,529
2017,2,24,12,1175,1218,1805,587
2017,2,24,13,1240,1277,2249,972
2017,2,24,14,1360,1405,2567,1162
2017,2,24,15,1470,1490,2615,1125
2017,2,24,16,1475,1485,2634,1149
2017,2,24,17,1440,1475,2606,1131
2017,2,24,18,1410,1453,2423,970
2017,2,24,19,1390,1404,2106,702
2017,2,24,20,1360,1388,2087,699
2017,2,24,21,1335,1353,1954,601
2017,2,24,22,1315,1337,1812,475
2017,2,24,23,1320,1328,1723,395
2017,2,25,0,1355,1337,1787,450
2017,2,25,1,1420,1369,2101,732
2017,2,25,2,1460,1431,2456,1025
2017,2,25,3,1440,1444,2526,1082
2017,2,25,4,1415,1413,2546,1133
2017,2,25,5,1385,1372,2571,1199
2017,2,25,6,1295,1304,2544,1240
2017,2,25,7,1235,1258,2583,1325
2017,2,25,8,1220,1214,2453,1239
2017,2,25,9,1200,1208,2446,1238
2017,2,25,10,1195,1193,2440,1247
2017,2,25,11,1180,1208,2455,1247
2017,2,25,12,1185,1212,2472,1260
2017,2,25,13,1195,1248,2546,1298
2017,2,25,14,1270,1313,2625,1312
2017,2,25,15,1370,1344,2523,1179
2017,2,25,16,1395,1383,2598,1215
2017,2,25,17,1420,1389,2458,1069
2017,2,25,18,1395,1407,2460,1053
2017,2,25,19,1380,1380,2088,708
2017,2,25,20,1355,1357,1929,572
2017,2,25,21,1335,1341,1818,477
2017,2,25,22,1325,1326,1683,357
2017,2,25,23,1320,1318,1537,219
2017,2,26,0,1345,1325,1536,211
2017,2,26,1,1395,1367,1627,260
2017,2,26,2,1460,1444,1926,482
2017,2,26,3,1445,1444,2060,616
2017,2,26,4,1420,1423,2003,580
2017,2,26,5,1380,1374,1979,605
2017,2,26,6,1325,1308,1912,604
2017,2,26,7,1265,1270,1979,709
2017,2,26,8,1185,1222,1878,656
2017,2,26,9,1165,1187,1766,579
2017,2,26,10,1180,1168,1728,560
2017,2,26,11,1175,1165,1790,625
2017,2,26,12,1200,1175,1895,720
2017,2,26,13,1240,1208,2242,1034
2017,2,26,14,1295,1277,2428,1151
2017,2,26,15,1345,1316,2327,1011
2017,2,26,16,1395,1363,2297,934
2017,2,26,17,1405,1383,2347,964
2017,2,26,18,1395,1384,2492,1108
2017,2,26,19,1405,1385,2406,1021
2017,2,26,20,1375,1356,2065,709
2017,2,26,21,1350,1336,1955,619
2017,2,26,22,1295,1341,1927,586
2017,2,26,23,1290,1328,1902,574
2017,2,27,0,1310,1381,2107,726
2017,2,27,1,1385,1439,2613,1174
2017,2,27,2,1455,1521,2755,1234
2017,2,27,3,1440,1511,2724,1213
2017,2,27,4,1430,1489,2637,1148
2017,2,27,5,1385,1407,2626,1219
2017,2,27,6,1290,1328,2609,1281
2017,2,27,7,1240,1268,2608,1340
2017,2,27,8,1175,1233,2442,1209
2017,2,27,9,1160,1212,2437,1225
2017,2,27,10,1165,1215,2433,1218
2017,2,27,11,1170,1228,2405,1177
2017,2,27,12,1195,1250,2455,1205
2017,2,27,13,1265,1317,2510,1193
2017,2,27,14,1385,1437,2633,1196
2017,2,27,15,1480,1527,2620,1093
2017,2,27,16,1490,1515,2590,1075
2017,2,27,17,1470,1492,2590,1098
2017,2,27,18,1455,1473,2578,1105
2017,2,27,19,1425,1452,2535,1083
2017,2,27,20,1415,1437,2539,1102
2017,2,27,21,1390,1402,2474,1072
2017,2,27,22,1400,1394,2392,998
2017,2,27,23,1395,1378,2473,1095
2017,2,28,0,1415,1402,2509,1107
2017,2,28,1,1460,1440,2605,1165
2017,2,28,2,1530,1515,2624,1109
2017,2,28,3,1530,1526,2664,1138
2017,2,28,4,1460,1510,2672,1162
2017,2,28,5,1400,1425,2576,1151
2017,2,28,6,1335,1328,2504,1176
2017,2,28,7,1255,1262,2505,1243
2017,2,28,8,1215,1224,2467,1243
2017,2,28,9,1185,1205,2387,1182
2017,2,28,10,1200,1207,2331,1124
2017,2,28,11,1215,1205,2203,998
2017,2,28,12,1225,1222,2340,1118
2017,2,28,13,1290,1294,2542,1248
2017,2,28,14,1410,1412,2618,1206
2017,2,28,15,1525,1475,2647,1172
2017,2,28,16,1525,1472,2642,1170
2017,2,28,17,1505,1454,2582,1128
2017,2,28,18,1490,1449,2596,1147
2017,2,28,19,1475,1412,2294,882
2017,2,28,20,1470,1404,2333,929
2017,2,28,21,1450,1392,2196,804
2017,2,28,22,1440,1369,2004,635
2017,2,28,23,1445,1365,1972,607
2017,3,1,0,1465,1394,1989,595
2017,3,1,1,1525,1418,2119,701
2017,3,1,2,1585,1510,2408,898
2017,3,1,3,1570,1520,2578,1058
2017,3,1,4,1545,1511,2635,1124
2017,3,1,5,1365,1440,2635,1195
2017,3,1,6,1380,1336,2473,1137
2017,3,1,7,1305,1280,2214,934
2017,3,1,8,1170,1255,2162,907
2017,3,1,9,1150,1246,1991,745
2017,3,1,10,1150,1217,1821,604
2017,3,1,11,1160,1224,1859,635
2017,3,1,12,1200,1241,1889,648
2017,3,1,13,1260,1307,2172,865
2017,3,1,14,1370,1450,2734,1284
2017,3,1,15,1460,1527,2763,1236
2017,3,1,16,1455,1508,2730,1222
2017,3,1,17,1430,1496,2656,1160
2017,3,1,18,1385,1442,2076,634
2017,3,1,19,1365,1424,1915,491
2017,3,1,20,1350,1396,1815,419
2017,3,1,21,1325,1358,1662,304
2017,3,1,22,1330,1341,1627,286
2017,3,1,23,1320,1343,1623,280
2017,3,2,0,1335,1358,1644,286
2017,3,2,1,1380,1381,1761,380
2017,3,2,2,1440,1462,2324,862
2017,3,2,3,1435,1482,2628,1146
2017,3,2,4,1420,1449,2528,1079
2017,3,2,5,1350,1383,2430,1047
2017,3,2,6,1260,1292,1962,670
2017,3,2,7,1190,1204,1846,642
2017,3,2,8,1180,1158,1718,560
2017,3,2,9,1165,1145,1711,566
2017,3,2,10,1155,1132,1756,624
2017,3,2,11,1170,1145,1840,695
2017,3,2,12,1200,1155,1871,716
2017,3,2,13,1280,1236,2365,1129
2017,3,2,14,1380,1383,2584,1201
2017,3,2,15,1445,1438,2582,1144
2017,3,2,16,1420,1433,2583,1150
2017,3,2,17,1415,1409,2546,1137
2017,3,2,18,1400,1376,2245,869
2017,3,2,19,1390,1344,1878,534
2017,3,2,20,1370,1322,1678,356
2017,3,2,21,1365,1315,1698,383
2017,3,2,22,1355,1305,1701,396
2017,3,2,23,1345,1307,1677,370
2017,3,3,0,1375,1317,1721,404
2017,3,3,1,1420,1339,1893,554
2017,3,3,2,1460,1435,2307,872
2017,3,3,3,1445,1433,2464,1031
2017,3,3,4,1415,1422,2582,1160
2017,3,3,5,1360,1360,2491,1131
2017,3,3,6,1285,1269,2251,982
2017,3,3,7,1210,1202,2150,948
2017,3,3,8,1100,1167,1978,811
2017,3,3,9,1125,1146,1956,810
2017,3,3,10,1110,1144,1883,739
2017,3,3,11,1115,1139,1847,708
2017,3,3,12,1115,1157,1930,773
2017,3,3,13,1190,1211,2164,953
2017,3,3,14,1295,1336,2438,1102
2017,3,3,15,1380,1390,2425,1035
2017,3,3,16,1360,1374,2486,1112
2017,3,3,17,1350,1349,2467,1118
2017,3,3,18,1340,1315,2383,1068
2017,3,3,19,1330,1299,2274,975
2017,3,3,20,1300,1282,2169,887
2017,3,3,21,1275,1262,2097,835
2017,3,3,22,1250,1251,1990,739
2017,3,3,23,1220,1227,1913,686
2017,3,4,0,1255,1227,1836,609
2017,3,4,1,1280,1254,2095,841
2017,3,4,2,1320,1297,2330,1033
2017,3,4,3,1315,1305,2344,1039
2017,3,4,4,1295,1292,2305,1013
2017,3,4,5,1260,1252,2102,850
2017,3,4,6,1180,1165,1748,583
2017,3,4,7,1120,1130,1830,700
2017,3,4,8,1090,1090,1677,587
2017,3,4,9,1070,1074,1661,587
2017,3,4,10,1065,1058,1616,558
2017,3,4,11,1065,1062,1619,557
2017,3,4,12,1070,1076,1683,607
2017,3,4,13,1100,1110,1797,687
2017,3,4,14,1185,1179,1951,772
2017,3,4,15,1245,1219,1959,740
2017,3,4,16,1275,1245,1943,698
2017,3,4,17,1330,1282,2012,730
2017,3,4,18,1295,1297,2128,831
2017,3,4,19,1265,1266,1841,575
2017,3,4,20,1250,1239,1642,403
2017,3,4,21,1235,1221,1694,473
2017,3,4,22,1205,1200,1707,507
2017,3,4,23,1215,1197,1716,519
2017,3,5,0,1225,1213,1728,515
2017,3,5,1,1270,1250,2204,954
2017,3,5,2,1330,1337,2459,1122
2017,3,5,3,1305,1338,2589,1251
2017,3,5,4,1300,1320,2569,1249
2017,3,5,5,1250,1293,2618,1325
2017,3,5,6,1190,1221,2429,1208
2017,3,5,7,1130,1163,2590,1427
2017,3,5,8,1100,1133,2465,1332
2017,3,5,9,1080,1104,2245,1141
2017,3,5,10,1065,1078,2037,959
2017,3,5,11,1070,1083,1983,900
2017,3,5,12,1080,1093,1954,861
2017,3,5,13,1105,1126,1815,689
2017,3,5,14,1160,1169,1784,615
2017,3,5,15,1210,1198,1443,245
2017,3,5,16,1270,1249,1827,578
2017,3,5,17,1300,1279,2187,908
2017,3,5,18,1290,1289,2265,976
2017,3,5,19,1285,1291,2167,876
2017,3,5,20,1280,1270,1954,684
2017,3,5,21,1240,1276,1928,652
2017,3,5,22,1215,1255,1900,645
2017,3,5,23,1225,1270,1868,598
2017,3,6,0,1250,1292,1848,556
2017,3,6,1,1300,1340,2229,889
2017,3,6,2,1355,1380,2287,907
2017,3,6,3,1340,1403,2367,964
2017,3,6,4,1350,1372,2365,993
2017,3,6,5,1290,1302,2405,1103
2017,3,6,6,1210,1240,2401,1161
2017,3,6,7,1170,1173,2328,1155
2017,3,6,8,1175,1140,2189,1049
2017,3,6,9,1150,1111,1902,791
2017,3,6,10,1130,1092,1699,607
2017,3,6,11,1135,1113,1694,581
2017,3,6,12,1145,1142,1739,597
2017,3,6,13,1195,1215,2125,910
2017,3,6,14,1345,1378,2684,1306
2017,3,6,15,1445,1444,2722,1278
2017,3,6,16,1450,1443,2696,1253
2017,3,6,17,1445,1445,2736,1291
2017,3,6,18,1425,1433,2766,1333
2017,3,6,19,1405,1415,2655,1240
2017,3,6,20,1405,1419,2723,1304
2017,3,6,21,1385,1391,2536,1145
2017,3,6,22,1370,1379,2302,923
2017,3,6,23,1360,1378,2152,774
2017,3,7,0,1370,1378,2189,811
2017,3,7,1,1420,1424,2483,1059
2017,3,7,2,1495,1488,2751,1263
2017,3,7,3,1475,1498,2752,1254
2017,3,7,4,1460,1478,2763,1285
2017,3,7,5,1370,1411,2737,1326
2017,3,7,6,1295,1341,2751,1410
2017,3,7,7,1230,1247,2599,1352
2017,3,7,8,1140,1206,2541,1335
2017,3,7,9,1110,1187,2175,988
2017,3,7,10,1120,1184,2157,973
2017,3,7,11,1130,1192,2211,1019
2017,3,7,12,1150,1222,2274,1052
2017,3,7,13,1215,1297,2550,1253
2017,3,7,14,1360,1431,2686,1255
2017,3,7,15,1415,1480,2768,1288
2017,3,7,16,1415,1484,2769,1285
2017,3,7,17,1400,1467,2746,1279
2017,3,7,18,1375,1440,2484,1044
2017,3,7,19,1380,1439,2643,1204
2017,3,7,20,1370,1416,2663,1247
2017,3,7,21,1360,1408,2687,1279
2017,3,7,22,1330,1399,2673,1274
2017,3,7,23,1335,1382,2707,1325
2017,3,8,0,1370,1410,2734,1324
2017,3,8,1,1410,1414,2672,1258
2017,3,8,2,1460,1487,2672,1185
2017,3,8,3,1460,1493,2654,1161
2017,3,8,4,1445,1477,2678,1201
2017,3,8,5,1405,1407,2630,1223
2017,3,8,6,1305,1314,2218,904
2017,3,8,7,1235,1257,2307,1050
2017,3,8,8,1130,1219,2143,924
2017,3,8,9,1115,1174,1673,499
2017,3,8,10,1105,1155,1536,381
2017,3,8,11,1115,1160,1541,381
2017,3,8,12,1155,1171,1598,427
2017,3,8,13,1225,1250,1953,703
2017,3,8,14,1330,1396,2416,1020
2017,3,8,15,1450,1471,2569,1098
2017,3,8,16,1440,1457,2580,1123
2017,3,8,17,1405,1441,2567,1126
2017,3,8,18,1405,1422,2425,1003
2017,3,8,19,1390,1394,2358,964
2017,3,8,20,1375,1367,2402,1035
2017,3,8,21,1345,1364,2310,946
2017,3,8,22,1340,1366,2315,949
2017,3,8,23,1325,1370,2365,995
2017,3,9,0,1345,1404,2422,1018
2017,3,9,1,1375,1463,2650,1187
2017,3,9,2,1440,1519,2690,1171
2017,3,9,3,1445,1525,2672,1147
2017,3,9,4,1415,1501,1113,-388
2017,3,9,5,1450,1444,985,-459
2017,3,9,6,1275,1368,874,-494
2017,3,9,7,1190,1282,920,-362
2017,3,9,8,1170,1232,917,-315
2017,3,9,9,1150,1219,976,-243
2017,3,9,10,1140,1211,944,-267
2017,3,9,11,1145,1219,982,-237
2017,3,9,12,1170,1246,979,-267
2017,3,9,13,1245,1305,1001,-304
2017,3,9,14,1380,1424,954,-470
2017,3,9,15,1465,1481,941,-540
2017,3,9,16,1470,1484,940,-544
2017,3,9,17,1435,1473,930,-543
2017,3,9,18,1425,1450,926,-524
2017,3,9,19,1405,1425,867,-558
2017,3,9,20,1400,1403,826,-577
2017,3,9,21,1395,1404,826,-578
2017,3,9,22,1385,1402,842,-560
2017,3,9,23,1365,1423,849,-574
2017,3,10,0,1385,1448,842,-606
2017,3,10,1,1420,1471,889,-582
2017,3,10,2,1480,1529,942,-587
2017,3,10,3,1480,1571,1172,-399
2017,3,10,4,1455,1556,1172,-384
2017,3,10,5,1400,1488,1121,-367
2017,3,10,6,1305,1396,1086,-310
2017,3,10,7,1235,1327,1102,-225
2017,3,10,8,1205,1272,1091,-181
2017,3,10,9,1200,1237,1033,-204
2017,3,10,10,1190,1226,930,-296
2017,3,10,11,1175,1227,872,-355
2017,3,10,12,1195,1242,875,-367
2017,3,10,13,1235,1297,919,-378
2017,3,10,14,1385,1397,1013,-384
2017,3,10,15,1435,1476,1069,-407
2017,3,10,16,1425,1451,1050,-401
2017,3,10,17,1400,1459,964,-495
2017,3,10,18,1375,1413,940,-473
2017,3,10,19,1365,1377,1013,-364
2017,3,10,20,1340,1342,1054,-288
2017,3,10,21,1340,1334,1039,-295
2017,3,10,22,1325,1324,1071,-253
2017,3,10,23,1330,1310,1077,-233
2017,3,11,0,1360,1305,1082,-223
2017,3,11,1,1400,1313,1244,-69
2017,3,11,2,1410,1359,1270,-89
2017,3,11,3,1375,1385,1429,44
2017,3,11,4,1360,1386,1455,69
2017,3,11,5,1240,1331,1287,-44
2017,3,11,6,1210,1280,1267,-13
2017,3,11,7,1185,1239,1492,253
2017,3,11,8,1110,1187,1455,268
2017,3,11,9,1095,1173,1479,306
2017,3,11,10,1095,1170,1533,363
2017,3,11,11,1100,1170,1476,306
2017,3,11,12,1100,1192,1494,302
2017,3,11,13,1130,1226,1570,344
2017,3,11,14,1195,1292,1596,304
2017,3,11,15,1255,1360,1734,374
2017,3,11,16,1280,1384,1726,342
2017,3,11,17,1315,1404,1757,353
2017,3,11,18,1300,1372,1595,223
2017,3,11,19,1285,1351,1620,269
2017,3,11,20,1275,1315,1565,250
2017,3,11,21,1255,1295,1475,180
2017,3,11,22,1230,1288,1424,136
2017,3,11,23,1225,1291,1466,175
2017,3,12,0,1250,1301,1298,-3
2017,3,12,1,1280,1340,1336,-4
2017,3,12,2,1355,1376,1724,348
2017,3,12,3,1315,1369,1814,445
2017,3,12,4,1305,1344,1779,435
2017,3,12,5,1285,1296,1777,481
2017,3,12,6,1205,1226,1348,122
2017,3,12,7,1145,1184,1432,248
2017,3,12,8,1080,1148,1366,218
2017,3,12,9,1060,1133,1398,265
2017,3,12,10,1050,1121,1418,297
2017,3,12,11,1045,1115,1420,305
2017,3,12,12,1075,1120,1443,323
2017,3,12,13,1135,1161,1463,302
2017,3,12,14,1190,1216,1439,223
2017,3,12,15,1240,1252,1349,97
2017,3,12,16,1280,1270,1337,67
2017,3,12,17,1275,1281,1334,53
2017,3,12,18,1270,1292,1363,71
2017,3,12,19,1250,1286,1372,86
2017,3,12,20,1245,1275,1434,159
2017,3,12,21,1215,1263,1448,185
2017,3,12,22,1225,1239,1407,168
2017,3,12,23,1260,1246,1388,142
2017,3,13,0,1315,1260,1426,166
2017,3,13,1,1335,1305,1902,597
2017,3,13,2,1360,1367,2339,972
2017,3,13,3,1355,1360,2443,1083
2017,3,13,4,1265,1339,2367,1028
2017,3,13,5,1215,1259,2177,918
2017,3,13,6,1155,1193,2156,963
2017,3,13,7,1125,1157,1960,803
2017,3,13,8,1095,1129,1633,504
2017,3,13,9,1095,1115,1481,366
2017,3,13,10,1100,1113,1568,455
2017,3,13,11,1115,1122,1569,447
2017,3,13,12,1185,1190,1754,564
2017,3,13,13,1300,1325,2228,903
2017,3,13,14,1370,1424,2396,972
2017,3,13,15,1370,1426,2389,963
2017,3,13,16,1350,1436,2421,985
2017,3,13,17,1335,1415,2378,963
2017,3,13,18,1320,1390,2396,1006
2017,3,13,19,1315,1349,2402,1053
2017,3,13,20,1300,1331,2343,1012
2017,3,13,21,1290,1323,2330,1007
2017,3,13,22,1290,1324,2379,1055
2017,3,13,23,1305,1311,2351,1040
2017,3,14,0,1350,1335,2363,1028
2017,3,14,1,1410,1335,2381,1046
2017,3,14,2,1400,1375,2432,1057
2017,3,14,3,1380,1380,2459,1079
2017,3,14,4,1290,1330,2653,1323
2017,3,14,5,1240,1256,2664,1408
2017,3,14,6,1170,1185,2481,1296
2017,3,14,7,1130,1148,2393,1245
2017,3,14,8,1110,1118,2319,1201
2017,3,14,9,1100,1080,2016,936
2017,3,14,10,1105,1069,1927,858
2017,3,14,11,1120,1073,1907,834
2017,3,14,12,1170,1142,1994,852
2017,3,14,13,1285,1266,2345,1079
2017,3,14,14,1380,1376,2599,1223
2017,3,14,15,1345,1385,2609,1224
2017,3,14,16,1335,1387,2586,1199
2017,3,14,17,1330,1377,2587,1210
2017,3,14,18,1325,1354,2389,1035
2017,3,14,19,1315,1320,2260,940
2017,3,14,20,1285,1302,2055,753
2017,3,14,21,1280,1288,1957,669
2017,3,14,22,1270,1267,1788,521
2017,3,14,23,1275,1266,1602,336
2017,3,15,0,1305,1263,1786,523
2017,3,15,1,1380,1271,1891,620
2017,3,15,2,1370,1315,2232,917
2017,3,15,3,1350,1346,2552,1206
2017,3,15,4,1280,1306,2582,1276
2017,3,15,5,1195,1207,2552,1345
2017,3,15,6,1140,1127,2215,1088
2017,3,15,7,1095,1081,2042,961
2017,3,15,8,1060,1061,1699,638
2017,3,15,9,1040,1053,1476,423
2017,3,15,10,1060,1048,1430,382
2017,3,15,11,1105,1076,1442,366
2017,3,15,12,1150,1124,1662,538
2017,3,15,13,1280,1278,2506,1228
2017,3,15,14,1365,1375,2669,1294
2017,3,15,15,1350,1369,2668,1299
2017,3,15,16,1325,1361,2708,1347
2017,3,15,17,1295,1324,2590,1266
2017,3,15,18,1280,1318,2202,884
2017,3,15,19,1235,1294,2114,820
2017,3,15,20,1215,1277,1984,707
2017,3,15,21,1245,1269,1926,657
2017,3,15,22,1235,1263,1843,580
2017,3,15,23,1255,1266,1824,558
2017,3,16,0,1260,1266,1877,611
2017,3,16,1,1275,1274,2037,763
2017,3,16,2,1295,1306,2223,917
2017,3,16,3,1320,1325,2460,1135
2017,3,16,4,1280,1275,2294,1019
2017,3,16,5,1170,1175,1760,585
2017,3,16,6,1090,1101,1573,472
2017,3,16,7,1100,1053,1423,370
2017,3,16,8,1120,1042,1382,340
2017,3,16,9,1090,1041,1380,339
2017,3,16,10,1090,1036,1359,323
2017,3,16,11,1075,1059,1380,321
2017,3,16,12,1145,1104,1559,455
2017,3,16,13,1290,1221,1597,376
2017,3,16,14,1380,1330,1861,531
2017,3,16,15,1380,1350,2419,1069
2017,3,16,16,1355,1345,2467,1122
2017,3,16,17,1340,1363,2403,1040
2017,3,16,18,1310,1331,1927,596
2017,3,16,19,1300,1320,1867,547
2017,3,16,20,1290,1295,1604,309
2017,3,16,21,1280,1293,1616,323
2017,3,16,22,1265,1278,1655,377
2017,3,16,23,1260,1261,1688,427
2017,3,17,0,1285,1252,1841,589
2017,3,17,1,1340,1272,2257,985
2017,3,17,2,1345,1305,2429,1124
2017,3,17,3,1345,1360,2636,1276
2017,3,17,4,1285,1315,2624,1309
2017,3,17,5,1195,1250,2617,1367
2017,3,17,6,1125,1175,2381,1206
2017,3,17,7,1020,1122,2194,1072
2017,3,17,8,1000,1092,1890,798
2017,3,17,9,990,1098,1897,799
2017,3,17,10,1020,1084,1905,821
2017,3,17,11,1095,1099,1902,803
2017,3,17,12,1200,1149,2096,947
2017,3,17,13,1275,1268,2532,1264
2017,3,17,14,1340,1358,2707,1349
2017,3,17,15,1340,1372,2679,1307
2017,3,17,16,1325,1354,2654,1300
2017,3,17,17,1300,1346,2647,1301
2017,3,17,18,1285,1297,2489,1192
2017,3,17,19,1260,1279,2451,1172
2017,3,17,20,1250,1254,2378,1124
2017,3,17,21,1240,1227,2105,878
2017,3,17,22,1235,1220,2155,935
2017,3,17,23,1225,1216,2217,1001
2017,3,18,0,1230,1205,2340,1135
2017,3,18,1,1255,1229,2566,1337
2017,3,18,2,1280,1248,2597,1349
2017,3,18,3,1260,1261,2523,1262
2017,3,18,4,1225,1225,2386,1161
2017,3,18,5,1145,1136,1889,753
2017,3,18,6,1075,1083,2050,967
2017,3,18,7,1055,1045,1761,716
2017,3,18,8,1025,1024,1472,448
2017,3,18,9,1015,1026,1428,402
2017,3,18,10,1000,1014,1397,383
2017,3,18,11,1020,1025,1390,365
2017,3,18,12,1055,1046,1398,352
2017,3,18,13,1140,1089,1395,306
2017,3,18,14,1205,1140,1348,208
2017,3,18,15,1235,1178,1364,186
2017,3,18,16,1255,1208,1401,193
2017,3,18,17,1255,1203,1426,223
2017,3,18,18,1240,1202,1563,361
2017,3,18,19,1245,1186,1424,238
2017,3,18,20,1200,1177,1373,196
2017,3,18,21,1180,1171,1353,182
2017,3,18,22,1190,1176,1364,188
2017,3,18,23,1180,1176,1411,235
2017,3,19,0,1185,1189,1412,223
2017,3,19,1,1240,1201,1428,227
2017,3,19,2,1240,1214,1459,245
2017,3,19,3,1220,1235,1523,288
2017,3,19,4,1160,1201,1503,302
2017,3,19,5,1105,1133,1451,318
2017,3,19,6,1065,1076,1413,337
2017,3,19,7,1015,1028,1419,391
2017,3,19,8,990,1005,1405,400
2017,3,19,9,985,983,1488,505
2017,3,19,10,995,975,1426,451
2017,3,19,11,1005,973,1401,428
2017,3,19,12,1045,1006,1512,506
2017,3,19,13,1065,1042,1543,501
2017,3,19,14,1100,1109,1641,532
2017,3,19,15,1145,1178,2101,923
2017,3,19,16,1170,1205,2523,1318
2017,3,19,17,1175,1217,2686,1469
2017,3,19,18,1170,1230,2632,1402
2017,3,19,19,1180,1211,2417,1206
2017,3,19,20,1165,1201,1947,746
2017,3,19,21,1165,1179,1648,469
2017,3,19,22,1160,1173,1536,363
2017,3,19,23,1185,1171,1475,304
2017,3,20,0,1225,1206,1478,272
2017,3,20,1,1265,1225,1644,419
2017,3,20,2,1250,1262,1810,548
2017,3,20,3,1235,1282,1970,688
2017,3,20,4,1185,1241,1913,672
2017,3,20,5,1115,1156,1905,749
2017,3,20,6,1055,1098,1817,719
2017,3,20,7,1075,1067,1566,499
2017,3,20,8,1055,1061,1499,438
2017,3,20,9,1040,1044,1362,318
2017,3,20,10,1030,1053,1362,309
2017,3,20,11,1045,1062,1365,303
2017,3,20,12,1125,1117,1601,484
2017,3,20,13,1270,1251,1803,552
2017,3,20,14,1375,1351,2046,695
2017,3,20,15,1390,1348,2058,710
2017,3,20,16,1370,1358,2038,680
2017,3,20,17,1385,1357,1918,561
2017,3,20,18,1370,1337,1818,481
2017,3,20,19,1330,1302,1611,309
2017,3,20,20,1295,1305,1423,118
2017,3,20,21,1280,1287,1315,28
2017,3,20,22,1280,1288,1313,25
2017,3,20,23,1275,1305,1302,-3
2017,3,21,0,1285,1312,1455,143
2017,3,21,1,1295,1338,1536,198
2017,3,21,2,1320,1383,1744,361
2017,3,21,3,1340,1396,2032,636
2017,3,21,4,1290,1338,2041,703
2017,3,21,5,1220,1232,1740,508
2017,3,21,6,1150,1187,1694,507
2017,3,21,7,1100,1149,1412,263
2017,3,21,8,1095,1130,1416,286
2017,3,21,9,1090,1100,1296,196
2017,3,21,10,1085,1105,1280,175
2017,3,21,11,1095,1110,1275,165
2017,3,21,12,1165,1168,1603,435
2017,3,21,13,1285,1287,1899,612
2017,3,21,14,1380,1409,2042,633
2017,3,21,15,1380,1400,2047,647
2017,3,21,16,1360,1402,1986,584
2017,3,21,17,1355,1387,1988,601
2017,3,21,18,1335,1381,1992,611
2017,3,21,19,1305,1354,1985,631
2017,3,21,20,1310,1326,1800,474
2017,3,21,21,1305,1319,1573,254
2017,3,21,22,1285,1309,1513,204
2017,3,21,23,1290,1315,1433,118
2017,3,22,0,1295,1320,1497,177
2017,3,22,1,1325,1337,1519,182
2017,3,22,2,1340,1340,1520,180
2017,3,22,3,1340,1363,1608,245
2017,3,22,4,1290,1303,1587,284
2017,3,22,5,1200,1206,1388,182
2017,3,22,6,1140,1142,1494,352
2017,3,22,7,1055,1103,1266,163
2017,3,22,8,1060,1086,1016,-70
2017,3,22,9,1050,1075,985,-90
2017,3,22,10,1050,1083,1002,-81
2017,3,22,11,1055,1096,1057,-39
2017,3,22,12,1100,1148,1165,17
2017,3,22,13,1250,1286,1536,250
2017,3,22,14,1355,1388,1817,429
2017,3,22,15,1355,1354,1819,465
2017,3,22,16,1355,1301,1698,397
2017,3,22,17,1325,1310,1728,418
2017,3,22,18,1320,1291,1761,470
2017,3,22,19,1295,1277,1645,368
2017,3,22,20,1300,1258,1626,368
2017,3,22,21,1290,1247,1513,266
2017,3,22,22,1290,1233,1384,151
2017,3,22,23,1300,1229,1389,160
2017,3,23,0,1275,1219,1390,171
2017,3,23,1,1285,1218,1468,250
2017,3,23,2,1315,1256,1398,142
2017,3,23,3,1315,1276,1341,65
2017,3,23,4,1285,1214,1216,2
2017,3,23,5,1185,1145,1166,21
2017,3,23,6,1120,1080,1075,-5
2017,3,23,7,1070,1045,1014,-31
2017,3,23,8,1065,1023,992,-31
2017,3,23,9,1045,1020,996,-24
2017,3,23,10,1025,1022,1010,-12
2017,3,23,11,1050,1042,1216,174
2017,3,23,12,1120,1108,1317,209
2017,3,23,13,1240,1244,1583,339
2017,3,23,14,1330,1330,1577,247
2017,3,23,15,1330,1312,1642,330
2017,3,23,16,1345,1310,1693,383
2017,3,23,17,1360,1319,1575,256
2017,3,23,18,1340,1288,1519,231
2017,3,23,19,1325,1274,1343,69
2017,3,23,20,1280,1247,1260,13
2017,3,23,21,1285,1250,1259,9
2017,3,23,22,1280,1225,1266,41
2017,3,23,23,1285,1215,1241,26
2017,3,24,0,1280,1211,1303,92
2017,3,24,1,1280,1220,1285,65
2017,3,24,2,1290,1246,1609,363
2017,3,24,3,1325,1301,1732,431
2017,3,24,4,1285,1264,1733,469
2017,3,24,5,1215,1182,1605,423
2017,3,24,6,1135,1122,1638,516
2017,3,24,7,1030,1089,1391,302
2017,3,24,8,1010,1069,1358,289
2017,3,24,9,1050,1070,1223,153
2017,3,24,10,1015,1077,1159,82
2017,3,24,11,1040,1106,1184,78
2017,3,24,12,1095,1146,1481,335
2017,3,24,13,1230,1262,1767,505
2017,3,24,14,1310,1325,1920,595
2017,3,24,15,1305,1322,2021,699
2017,3,24,16,1280,1312,2041,729
2017,3,24,17,1275,1291,2068,777
2017,3,24,18,1270,1283,2126,843
2017,3,24,19,1250,1270,2187,917
2017,3,24,20,1225,1233,2098,865
2017,3,24,21,1195,1214,1743,529
2017,3,24,22,1195,1190,1651,461
2017,3,24,23,1190,1187,1588,401
2017,3,25,0,1180,1179,1603,424
2017,3,25,1,1190,1177,1713,536
2017,3,25,2,1200,1220,1965,745
2017,3,25,3,1215,1252,1976,724
2017,3,25,4,1175,1217,1806,589
2017,3,25,5,1090,1138,1767,629
2017,3,25,6,1030,1075,1872,797
2017,3,25,7,1030,1033,1792,759
2017,3,25,8,1030,1020,1634,614
2017,3,25,9,1030,1010,1565,555
2017,3,25,10,1025,1018,1503,485
2017,3,25,11,1025,1027,1536,509
2017,3,25,12,1050,1049,1556,507
2017,3,25,13,1130,1098,1795,697
2017,3,25,14,1210,1139,1732,593
2017,3,25,15,1235,1206,1896,690
2017,3,25,16,1255,1232,2115,883
2017,3,25,17,1255,1238,2178,940
2017,3,25,18,1260,1210,1788,578
2017,3,25,19,1250,1191,1511,320
2017,3,25,20,1230,1176,1538,362
2017,3,25,21,1220,1152,1488,336
2017,3,25,22,1215,1145,1487,342
2017,3,25,23,1240,1135,1470,335
2017,3,26,0,1250,1137,1442,305
2017,3,26,1,1305,1149,1435,286
2017,3,26,2,1275,1172,1520,348
2017,3,26,3,1280,1209,1665,456
2017,3,26,4,1250,1189,1866,677
2017,3,26,5,1175,1133,1915,782
2017,3,26,6,1110,1087,2089,1002
2017,3,26,7,1050,1071,1911,840
2017,3,26,8,1040,1016,1528,512
2017,3,26,9,1010,1003,1482,479
2017,3,26,10,1010,1000,1427,427
2017,3,26,11,1020,1013,1434,421
2017,3,26,12,1050,1032,1490,458
2017,3,26,13,1055,1079,1480,401
2017,3,26,14,1100,1129,1512,383
2017,3,26,15,1175,1171,1670,499
2017,3,26,16,1160,1182,1779,597
2017,3,26,17,1175,1180,1900,720
2017,3,26,18,1190,1180,1961,781
2017,3,26,19,1205,1163,1983,820
2017,3,26,20,1205,1153,1952,799
2017,3,26,21,1180,1127,1574,447
2017,3,26,22,1145,1121,1448,327
2017,3,26,23,1140,1142,1451,309
2017,3,27,0,1175,1160,1587,427
2017,3,27,1,1195,1195,1992,797
2017,3,27,2,1220,1243,2429,1186
2017,3,27,3,1255,1276,2572,1296
2017,3,27,4,1225,1228,2551,1323
2017,3,27,5,1125,1141,2465,1324
2017,3,27,6,1050,1060,2302,1242
2017,3,27,7,1050,990,1679,689
2017,3,27,8,1035,981,1366,385
2017,3,27,9,1030,964,1308,344
2017,3,27,10,1035,977,1319,342
2017,3,27,11,1060,990,1325,335
2017,3,27,12,1125,1047,1335,288
2017,3,27,13,1280,1185,1620,435
2017,3,27,14,1395,1295,2472,1177
2017,3,27,15,1400,1306,2614,1308
2017,3,27,16,1400,1297,2582,1285
2017,3,27,17,1395,1274,2240,966
2017,3,27,18,1360,1270,1804,534
2017,3,27,19,1345,1250,1466,216
2017,3,27,20,1330,1247,1360,113
2017,3,27,21,1315,1230,1394,164
2017,3,27,22,1300,1214,1376,162
2017,3,27,23,1305,1209,1382,173
2017,3,28,0,1310,1228,1401,173
2017,3,28,1,1310,1245,1410,165
2017,3,28,2,1340,1257,1748,491
2017,3,28,3,1370,1287,1944,657
2017,3,28,4,1310,1246,1860,614
2017,3,28,5,1225,1151,1506,355
2017,3,28,6,1165,1078,1281,203
2017,3,28,7,1020,1052,1295,243
2017,3,28,8,1015,1030,1300,270
2017,3,28,9,1005,1022,1287,265
2017,3,28,10,1000,1023,1297,274
2017,3,28,11,1000,1074,1148,74
2017,3,28,12,1050,1161,1154,-7
2017,3,28,13,1210,1266,1113,-153
2017,3,28,14,1365,1313,1046,-267
2017,3,28,15,1360,1324,949,-375
2017,3,28,16,1360,1308,974,-334
2017,3,28,17,1355,1302,960,-342
2017,3,28,18,1340,1284,861,-423
2017,3,28,19,1300,1278,975,-303
2017,3,28,20,1290,1279,1104,-175
2017,3,28,21,1285,1266,1109,-157
2017,3,28,22,1295,1259,1143,-116
2017,3,28,23,1285,1244,1118,-126
2017,3,29,0,1280,1222,1132,-90
2017,3,29,1,1285,1225,1188,-37
2017,3,29,2,1305,1239,1365,126
2017,3,29,3,1320,1287,1670,383
2017,3,29,4,1270,1254,1863,609
2017,3,29,5,1170,1182,1812,630
2017,3,29,6,1100,1105,1804,699
2017,3,29,7,1025,1074,1729,655
2017,3,29,8,1020,1048,1235,187
2017,3,29,9,1010,1035,1105,70
2017,3,29,10,1015,1015,1132,117
2017,3,29,11,1025,1043,1190,147
2017,3,29,12,1090,1101,1640,539
2017,3,29,13,1260,1253,1987,734
2017,3,29,14,1395,1329,1945,616
2017,3,29,15,1375,1312,2100,788
2017,3,29,16,1325,1317,2111,794
2017,3,29,17,1320,1494,2054,560
2017,3,29,18,1325,1342,1995,653
2017,3,29,19,1300,1278,1911,633
2017,3,29,20,1295,1246,1840,594
2017,3,29,21,1280,1230,1528,298
2017,3,29,22,1260,1201,1280,79
2017,3,29,23,1260,1205,1310,105
2017,3,30,0,1240,1202,1277,75
2017,3,30,1,1240,1216,1258,42
2017,3,30,2,1290,1274,1292,18
2017,3,30,3,1315,1302,1465,163
2017,3,30,4,1230,1237,1495,258
2017,3,30,5,1165,1152,1312,160
2017,3,30,6,1095,1082,1326,244
2017,3,30,7,1040,1035,1141,106
2017,3,30,8,1030,1028,1227,199
2017,3,30,9,990,1029,1244,215
2017,3,30,10,995,1014,1216,202
2017,3,30,11,1035,1016,1175,159
2017,3,30,12,1100,1081,1175,94
2017,3,30,13,1260,1217,1307,90
2017,3,30,14,1335,1318,1547,229
2017,3,30,15,1330,1311,1866,555
2017,3,30,16,1320,1294,1559,265
2017,3,30,17,1340,1285,1470,185
2017,3,30,18,1300,1280,1461,181
2017,3,30,19,1290,1253,1342,89
2017,3,30,20,1280,1240,1306,66
2017,3,30,21,1270,1235,1309,74
2017,3,30,22,1245,1224,1360,136
2017,3,30,23,1245,1224,1409,185
2017,3,31,0,1240,1203,1342,139
2017,3,31,1,1230,1226,1536,310
2017,3,31,2,1265,1245,1582,337
2017,3,31,3,1290,1298,1957,659
2017,3,31,4,1250,1267,2005,738
2017,3,31,5,1170,1176,1684,508
2017,3,31,6,1105,1105,1803,698
2017,3,31,7,1045,1049,1634,585
2017,3,31,8,1030,1025,1357,332
2017,3,31,9,1045,1020,1322,302
2017,3,31,10,1035,1017,1338,321
2017,3,31,11,1090,1034,1367,333
2017,3,31,12,1200,1075,1460,385
2017,3,31,13,1270,1200,2279,1079
2017,3,31,14,1330,1317,2526,1209
2017,3,31,15,1330,1324,2699,1375
2017,3,31,16,1325,1317,2714,1397
2017,3,31,17,1350,1315,2699,1384
2017,3,31,18,1315,1291,2424,1133
2017,3,31,19,1280,1271,2243,972
2017,3,31,20,1260,1236,1847,611
2017,3,31,21,1230,1215,1636,421
2017,3,31,22,1235,1209,1523,314
2017,3,31,23,1230,1181,1509,328
2017,4,1,0,1215,1184,1501,317
2017,4,1,1,1225,1172,1480,308
2017,4,1,2,1240,1180,1630,450
2017,4,1,3,1255,1217,1845,628
2017,4,1,4,1215,1212,1955,743
2017,4,1,5,1125,1143,1611,468
2017,4,1,6,1065,1039,1612,573
2017,4,1,7,1030,1039,1612,573
2017,4,1,8,1015,1026,1494,468
2017,4,1,9,1020,1016,1445,429
2017,4,1,10,1025,1014,1484,470
2017,4,1,11,1035,1033,1441,408
2017,4,1,12,1055,1062,1543,481
2017,4,1,13,1135,1105,1626,521
2017,4,1,14,1195,1155,1835,680
2017,4,1,15,1215,1185,1865,680
2017,4,1,16,1220,1188,1832,644
2017,4,1,17,1215,1185,1833,648
2017,4,1,18,1205,1175,1712,537
2017,4,1,19,1190,1153,1646,493
2017,4,1,20,1165,1142,1492,350
2017,4,1,21,1145,1126,1403,277
2017,4,1,22,1150,1121,1382,261
2017,4,1,23,1150,1132,1401,269
2017,4,2,0,1145,1144,1422,278
2017,4,2,1,1150,1148,1439,291
2017,4,2,2,1170,1168,1465,297
2017,4,2,3,1195,1195,1454,259
2017,4,2,4,1165,1170,1515,345
2017,4,2,5,1110,1105,1491,386
2017,4,2,6,1035,1062,1467,405
2017,4,2,7,1025,985,1378,393
2017,4,2,8,1000,983,1461,478
2017,4,2,9,985,963,1388,425
2017,4,2,10,980,968,1386,418
2017,4,2,11,995,967,1378,411
2017,4,2,12,1020,999,1406,407
2017,4,2,13,1050,1019,1372,353
2017,4,2,14,1120,1077,1390,313
2017,4,2,15,1185,1126,1426,300
2017,4,2,16,1180,1165,1332,167
2017,4,2,17,1185,1182,1346,164
2017,4,2,18,1190,1181,1360,179
2017,4,2,19,1185,1177,1364,187
2017,4,2,20,1180,1172,1400,228
2017,4,2,21,1155,1158,1393,235
2017,4,2,22,1135,1170,1431,261
2017,4,2,23,1150,1179,1415,236
2017,4,3,0,1175,1184,1433,249
2017,4,3,1,1200,1199,1422,223
2017,4,3,2,1235,1232,1431,199
2017,4,3,3,1265,1269,1863,594
2017,4,3,4,1225,1240,2058,818
2017,4,3,5,1140,1161,1801,640
2017,4,3,6,1060,1086,1447,361
2017,4,3,7,1035,1038,1356,318
2017,4,3,8,1030,1030,1391,361
2017,4,3,9,1030,1023,1329,306
2017,4,3,10,1025,1027,1339,312
2017,4,3,11,1030,1051,1431,380
2017,4,3,12,1090,1133,1893,760
2017,4,3,13,1220,1271,2388,1117
2017,4,3,14,1320,1370,2552,1182
2017,4,3,15,1325,1380,2645,1265
2017,4,3,16,1315,1351,2642,1291
2017,4,3,17,1290,1350,2655,1305
2017,4,3,18,1285,1325,2170,845
2017,4,3,19,1275,1295,1978,683
2017,4,3,20,1275,1292,2081,789
2017,4,3,21,1255,1276,1853,577
2017,4,3,22,1240,1268,1667,399
2017,4,3,23,1255,1277,1666,389
2017,4,4,0,1255,1282,1670,388
2017,4,4,1,1280,1316,2075,759
2017,4,4,2,1290,1348,2398,1050
2017,4,4,3,1315,1388,2584,1196
2017,4,4,4,1275,1350,2602,1252
2017,4,4,5,1175,1275,2463,1188
2017,4,4,6,1105,1199,2409,1210
2017,4,4,7,1065,1177,2336,1159
2017,4,4,8,1055,1123,1737,614
2017,4,4,9,1050,1103,1572,469
2017,4,4,10,1050,1110,1588,478
2017,4,4,11,1085,1137,1621,484
2017,4,4,12,1160,1187,1957,770
2017,4,4,13,1265,1339,2493,1154
2017,4,4,14,1340,1440,2646,1206
2017,4,4,15,1325,1420,2636,1216
2017,4,4,16,1305,1385,2528,1143
2017,4,4,17,1320,1344,2518,1174
2017,4,4,18,1300,1338,2505,1167
2017,4,4,19,1275,1287,2263,976
2017,4,4,20,1275,1264,1902,638
2017,4,4,21,1255,1245,1720,475
2017,4,4,22,1255,1228,1598,370
2017,4,4,23,1250,1226,1641,415
2017,4,5,0,1235,1214,1752,538
2017,4,5,1,1240,1255,2381,1126
2017,4,5,2,1265,1277,2572,1295
2017,4,5,3,1275,1331,2648,1317
2017,4,5,4,1225,1311,2623,1312
2017,4,5,5,1140,1232,2530,1298
2017,4,5,6,1075,1139,2313,1174
2017,4,5,7,1070,1103,1924,821
2017,4,5,8,1060,1084,1602,518
2017,4,5,9,1040,1080,1599,519
2017,4,5,10,1045,1085,1649,564
2017,4,5,11,1075,1112,1711,599
2017,4,5,12,1135,1158,1803,645
2017,4,5,13,1290,1299,2267,968
2017,4,5,14,1405,1393,2653,1260
2017,4,5,15,1380,1367,2692,1325
2017,4,5,16,1325,1356,2642,1286
2017,4,5,17,1370,1342,2563,1221
2017,4,5,18,1345,1316,2744,1428
2017,4,5,19,1310,1306,2743,1437
2017,4,5,20,1295,1281,2688,1407
2017,4,5,21,1275,1279,2663,1384
2017,4,5,22,1265,1263,2658,1395
2017,4,5,23,1265,1252,2488,1236
2017,4,6,0,1250,1237,2419,1182
2017,4,6,1,1250,1246,2598,1352
2017,4,6,2,1305,1265,2532,1267
2017,4,6,3,1345,1325,2666,1341
2017,4,6,4,1260,1288,2590,1302
2017,4,6,5,1185,1213,2363,1150
2017,4,6,6,1115,1118,2240,1122
2017,4,6,7,1065,1068,1878,810
2017,4,6,8,1025,1072,1774,702
2017,4,6,9,1025,1031,1679,648
2017,4,6,10,1055,1044,1490,446
2017,4,6,11,1030,1063,1485,422
2017,4,6,12,1085,1133,1820,687
2017,4,6,13,1195,1288,2443,1155
2017,4,6,14,1270,1354,2545,1191
2017,4,6,15,1245,1345,2677,1332
2017,4,6,16,1225,1340,2688,1348
2017,4,6,17,1210,1324,2630,1306
2017,4,6,18,1200,1314,2495,1181
2017,4,6,19,1185,1298,2483,1185
2017,4,6,20,1175,1301,2490,1189
2017,4,6,21,1165,1182,2305,1123
2017,4,6,22,1170,1261,2352,1091
2017,4,6,23,1155,1250,2166,916
2017,4,7,0,1125,1265,2210,945
2017,4,7,1,1155,1260,2232,972
2017,4,7,2,1170,1302,2249,947
2017,4,7,3,1220,1339,2347,1008
2017,4,7,4,1180,1310,2367,1057
2017,4,7,5,1110,1207,2068,861
2017,4,7,6,1015,1104,1876,772
2017,4,7,7,1025,1047,1549,502
2017,4,7,8,1020,1033,1393,360
2017,4,7,9,1020,1014,1265,251
2017,4,7,10,1030,1009,1250,241
2017,4,7,11,1055,1027,1408,381
2017,4,7,12,1100,1073,1614,541
2017,4,7,13,1215,1178,1622,444
2017,4,7,14,1300,1281,1756,475
2017,4,7,15,1295,1310,1668,358
2017,4,7,16,1295,1305,1549,244
2017,4,7,17,1275,1282,1483,201
2017,4,7,18,1255,1248,1453,205
2017,4,7,19,1230,1227,1435,208
2017,4,7,20,1210,1233,1375,142
2017,4,7,21,1190,1218,1451,233
2017,4,7,22,1170,1218,1289,71
2017,4,7,23,1165,1239,1310,71
2017,4,8,0,1155,1239,1347,108
2017,4,8,1,1150,1220,1290,70
2017,4,8,2,1165,1221,1385,164
2017,4,8,3,1200,1249,1442,193
2017,4,8,4,1185,1224,1644,420
2017,4,8,5,1115,1175,1745,570
2017,4,8,6,1050,1113,1703,590
2017,4,8,7,1035,1071,1434,363
2017,4,8,8,1020,1065,1358,293
2017,4,8,9,1005,1040,1167,127
2017,4,8,10,1015,1017,1144,127
2017,4,8,11,1045,1027,1171,144
2017,4,8,12,1055,1055,1256,201
2017,4,8,13,1100,1121,1542,421
2017,4,8,14,1145,1163,1566,403
2017,4,8,15,1190,1225,1617,392
2017,4,8,16,1205,1253,1797,544
2017,4,8,17,1205,1213,1867,654
2017,4,8,18,1185,1184,1512,328
2017,4,8,19,1170,1154,1448,294
2017,4,8,20,1165,1145,1138,-7
2017,4,8,21,1140,1133,1087,-46
2017,4,8,22,1130,1145,1115,-30
2017,4,8,23,1130,1171,1105,-66
2017,4,9,0,1145,1200,1124,-76
2017,4,9,1,1150,1204,1125,-79
2017,4,9,2,1165,1222,1192,-30
2017,4,9,3,1205,1243,1295,52
2017,4,9,4,1180,1218,1511,293
2017,4,9,5,1120,1159,1354,195
2017,4,9,6,1065,1102,1357,255
2017,4,9,7,1065,1070,1164,94
2017,4,9,8,1035,1070,1201,131
2017,4,9,9,1010,1065,1206,141
2017,4,9,10,1015,1069,1276,207
2017,4,9,11,1040,1059,1281,222
2017,4,9,12,1055,1075,1327,252
2017,4,9,13,1085,1125,1592,467
2017,4,9,14,1160,1194,1922,728
2017,4,9,15,1220,1244,2147,903
2017,4,9,16,1240,1308,2296,988
2017,4,9,17,1250,1329,2309,980
2017,4,9,18,1250,1310,2242,932
2017,4,9,19,1240,1298,2043,745
2017,4,9,20,1220,1285,1685,400
2017,4,9,21,1205,1268,1536,268
2017,4,9,22,1210,1254,1408,154
2017,4,9,23,1235,1252,1426,174
2017,4,10,0,1240,1264,1411,147
2017,4,10,1,1270,1270,1922,652
2017,4,10,2,1295,1293,2149,856
2017,4,10,3,1330,1325,2170,845
2017,4,10,4,1285,1305,2164,859
2017,4,10,5,1215,1236,2129,893
2017,4,10,6,1120,1150,1818,668
2017,4,10,7,1070,1106,1639,533
2017,4,10,8,1080,1079,1419,340
2017,4,10,9,1055,1072,1104,32
2017,4,10,10,1065,1084,1092,8
2017,4,10,11,1095,1097,1090,-7
2017,4,10,12,1130,1151,1517,366
2017,4,10,13,1250,1307,2027,720
2017,4,10,14,1330,1377,2037,660
2017,4,10,15,1335,1388,2158,770
2017,4,10,16,1315,1383,2111,728
2017,4,10,17,1300,1370,2114,744
2017,4,10,18,1290,1318,1938,620
2017,4,10,19,1270,1289,1750,461
2017,4,10,20,1275,1280,1589,309
2017,4,10,21,1235,1266,1446,180
2017,4,10,22,1255,1254,1348,94
2017,4,10,23,1260,1264,1418,154
2017,4,11,0,1265,1277,1586,309
2017,4,11,1,1270,1288,1415,127
2017,4,11,2,1290,1307,1889,582
2017,4,11,3,1320,1354,2152,798
2017,4,11,4,1275,1318,2171,853
2017,4,11,5,1205,1240,2231,991
2017,4,11,6,1110,1153,1970,817
2017,4,11,7,1090,1119,1874,755
2017,4,11,8,1065,1104,1655,551
2017,4,11,9,1060,1107,1642,535
2017,4,11,10,1080,1107,1676,569
2017,4,11,11,1085,1128,1571,443
2017,4,11,12,1155,1177,1998,821
2017,4,11,13,1280,1306,2085,779
2017,4,11,14,1355,1360,2122,762
2017,4,11,15,1340,1347,2169,822
2017,4,11,16,1310,1334,2203,869
2017,4,11,17,1290,1307,2162,855
2017,4,11,18,1280,1288,2203,915
2017,4,11,19,1245,1249,2057,808
2017,4,11,20,1245,1248,1900,652
2017,4,11,21,1230,1217,1688,471
2017,4,11,22,1220,1209,1558,349
2017,4,11,23,1200,1202,1529,327
2017,4,12,0,1195,1186,1742,556
2017,4,12,1,1205,1192,1997,805
2017,4,12,2,1235,1231,1992,761
2017,4,12,3,1255,1292,2064,772
2017,4,12,4,1225,1258,2067,809
2017,4,12,5,1160,1186,2068,882
2017,4,12,6,1080,1118,2044,926
2017,4,12,7,1090,1095,1909,814
2017,4,12,8,1070,1072,1669,597
2017,4,12,9,1060,1056,1280,224
2017,4,12,10,1085,1051,1194,143
2017,4,12,11,1090,1041,1186,145
2017,4,12,12,1140,1094,1594,500
2017,4,12,13,1265,1218,1875,657
2017,4,12,14,1360,1295,1881,586
2017,4,12,15,1335,1274,1955,681
2017,4,12,16,1345,1256,2024,768
2017,4,12,17,1365,1224,1872,648
2017,4,12,18,1295,1217,1773,556
2017,4,12,19,1265,1192,1638,446
2017,4,12,20,1245,1197,1794,597
2017,4,12,21,1245,1185,1783,598
2017,4,12,22,1245,1187,1752,565
2017,4,12,23,1230,1178,1740,562
2017,4,13,0,1235,1160,1642,482
2017,4,13,1,1235,1172,1785,613
2017,4,13,2,1250,1198,1925,727
2017,4,13,3,1305,1239,2128,889
2017,4,13,4,1280,1207,2099,892
2017,4,13,5,1180,1127,2001,874
2017,4,13,6,1090,1061,2046,985
2017,4,13,7,1055,1027,1679,652
2017,4,13,8,1045,1005,1457,452
2017,4,13,9,1040,1000,1275,275
2017,4,13,10,1030,1004,1107,103
2017,4,13,11,1050,1019,1080,61
2017,4,13,12,1120,1075,1200,125
2017,4,13,13,1245,1198,1790,592
2017,4,13,14,1340,1260,2042,782
2017,4,13,15,1330,1272,2039,767
2017,4,13,16,1310,1274,2061,787
2017,4,13,17,1280,1264,2043,779
2017,4,13,18,1270,1259,1975,716
2017,4,13,19,1240,1248,1987,739
2017,4,13,20,1250,1253,1863,610
2017,4,13,21,1170,1255,1852,597
2017,4,13,22,1235,1258,1707,449
2017,4,13,23,1235,1262,1833,571
2017,4,14,0,1235,1248,1727,479
2017,4,14,1,1220,1254,1866,612
2017,4,14,2,1245,1262,2050,788
2017,4,14,3,1285,1306,2169,863
2017,4,14,4,1270,1288,2142,854
2017,4,14,5,1180,1203,1954,751
2017,4,14,6,1070,1135,1961,826
2017,4,14,7,1015,1104,1566,462
2017,4,14,8,995,1073,1431,358
2017,4,14,9,1000,1058,1233,175
2017,4,14,10,1005,1055,1159,104
2017,4,14,11,1015,1058,1200,142
2017,4,14,12,1085,1111,1331,220
2017,4,14,13,1195,1214,1961,747
2017,4,14,14,1310,1282,2145,863
2017,4,14,15,1310,1316,2154,838
2017,4,14,16,1295,1318,2159,841
2017,4,14,17,1280,1325,2090,765
2017,4,14,18,1260,1282,1763,481
2017,4,14,19,1230,1263,1766,503
2017,4,14,20,1215,1247,1450,203
2017,4,14,21,1200,1231,1308,77
2017,4,14,22,1195,1215,1454,239
2017,4,14,23,1175,1224,1472,248
2017,4,15,0,1180,1216,1445,229
2017,4,15,1,1170,1213,1442,229
2017,4,15,2,1170,1247,1484,237
2017,4,15,3,1210,1285,1731,446
2017,4,15,4,1200,1281,1904,623
2017,4,15,5,1130,1195,1580,385
2017,4,15,6,1055,1137,1772,635
2017,4,15,7,1040,1099,1565,466
2017,4,15,8,1050,1073,1407,334
2017,4,15,9,1015,1062,1331,269
2017,4,15,10,1005,1058,1313,255
2017,4,15,11,1035,1076,1286,210
2017,4,15,12,1050,1090,1439,349
2017,4,15,13,1120,1139,1654,515
2017,4,15,14,1180,1193,1551,358
2017,4,15,15,1245,1252,1833,581
2017,4,15,16,1255,1278,1958,680
2017,4,15,17,1235,1271,1827,556
2017,4,15,18,1220,1248,1574,326
2017,4,15,19,1185,1222,1527,305
2017,4,15,20,1190,1200,1453,253
2017,4,15,21,1160,1178,1350,172
2017,4,15,22,1165,1169,1304,135
2017,4,15,23,1180,1166,1279,113
2017,4,16,0,1200,1183,1513,330
2017,4,16,1,1200,1194,1696,502
2017,4,16,2,1215,1190,1864,674
2017,4,16,3,1250,1242,2101,859
2017,4,16,4,1240,1239,2122,883
2017,4,16,5,1165,1163,2044,881
2017,4,16,6,1105,1103,2184,1081
2017,4,16,7,1065,1039,1775,736
2017,4,16,8,1050,1022,1543,521
2017,4,16,9,1015,1019,1289,270
2017,4,16,10,1025,1014,1282,268
2017,4,16,11,1050,1019,1281,262
2017,4,16,12,1055,1067,1307,240
2017,4,16,13,1040,1113,1409,296
2017,4,16,14,1065,1158,1658,500
2017,4,16,15,1125,1199,1879,680
2017,4,16,16,1155,1196,1876,680
2017,4,16,17,1170,1190,1991,801
2017,4,16,18,1170,1164,1931,767
2017,4,16,19,1165,1143,1547,404
2017,4,16,20,1150,1111,1268,157
2017,4,16,21,1135,1093,1207,114
2017,4,16,22,1145,1069,1134,65
2017,4,16,23,1160,1079,1119,40
2017,4,17,0,1165,1060,1142,82
2017,4,17,1,1190,1086,1292,206
2017,4,17,2,1205,1114,1496,382
2017,4,17,3,1240,1172,1932,760
2017,4,17,4,1195,1185,2116,931
2017,4,17,5,1135,1114,1856,742
2017,4,17,6,1045,1029,1534,505
2017,4,17,7,1055,977,1304,327
2017,4,17,8,1035,956,1070,114
2017,4,17,9,1030,955,1075,120
2017,4,17,10,1050,959,1059,100
2017,4,17,11,1060,974,1060,86
2017,4,17,12,1125,1027,1141,114
2017,4,17,13,1245,1125,1334,209
2017,4,17,14,1325,1199,1319,120
2017,4,17,15,1345,1262,1574,312
2017,4,17,16,1325,1275,1651,376
2017,4,17,17,1315,1270,1540,270
2017,4,17,18,1285,1265,1533,268
2017,4,17,19,1260,1235,1599,214
2017,4,17,20,1255,1216,1682,573
2017,4,17,21,1245,1235,1790,555
2017,4,17,22,1245,1225,1866,641
2017,4,17,23,1250,1218,1925,707
2017,4,18,0,1255,1210,1931,721
2017,4,18,1,1275,1222,2032,810
2017,4,18,2,1295,1249,2099,850
2017,4,18,3,1340,1282,2111,829
2017,4,18,4,1280,1243,2144,901
2017,4,18,5,1205,1146,2005,859
2017,4,18,6,1115,1082,2061,979
2017,4,18,7,1020,1040,1768,728
2017,4,18,8,970,1020,1481,461
2017,4,18,9,980,1015,1426,411
2017,4,18,10,1010,1015,1456,441
2017,4,18,11,1040,1041,1368,327
2017,4,18,12,1095,1084,1442,358
2017,4,18,13,1230,1213,1902,689
2017,4,18,14,1320,1299,2037,738
2017,4,18,15,1325,1295,2175,880
2017,4,18,16,1305,1299,2179,880
2017,4,18,17,1265,1270,2191,921
2017,4,18,18,1260,1265,2043,778
2017,4,18,19,1225,1244,1840,596
2017,4,18,20,1220,1224,1533,309
2017,4,18,21,1210,1217,1269,52
2017,4,18,22,1205,1214,1337,123
2017,4,18,23,1200,1216,1453,237
2017,4,19,0,1190,1213,1355,142
2017,4,19,1,1205,1212,1526,314
2017,4,19,2,1225,1229,1556,327
2017,4,19,3,1265,1280,1938,658
2017,4,19,4,1225,1207,2023,816
2017,4,19,5,1160,1096,1708,612
2017,4,19,6,1085,1037,1774,737
2017,4,19,7,1065,1011,1509,498
2017,4,19,8,1025,976,1275,299
2017,4,19,9,1020,981,1237,256
2017,4,19,10,1015,974,1179,205
2017,4,19,11,1030,1001,1357,356
2017,4,19,12,1090,1053,1506,453
2017,4,19,13,1190,1182,1900,718
2017,4,19,14,1285,1270,2149,879
2017,4,19,15,1260,1248,2148,900
2017,4,19,16,1245,1258,2072,814
2017,4,19,17,1215,1219,2006,787
2017,4,19,18,1200,1204,2016,812
2017,4,19,19,1175,1213,2037,824
2017,4,19,20,1165,1201,1820,619
2017,4,19,21,1155,1187,1863,676
2017,4,19,22,1160,1173,1908,735
2017,4,19,23,1150,1177,1789,612
2017,4,20,0,1145,1160,1763,603
2017,4,20,1,1170,1146,1945,799
2017,4,20,2,1170,1150,2089,939
2017,4,20,3,1210,1211,2140,929
2017,4,20,4,1175,1190,2155,965
2017,4,20,5,1100,1123,2077,954
2017,4,20,6,1020,1054,2061,1007
2017,4,20,7,1005,1013,1740,727
2017,4,20,8,995,984,1497,513
2017,4,20,9,990,969,1342,373
2017,4,20,10,975,978,1198,220
2017,4,20,11,1005,994,1084,90
2017,4,20,12,1050,1066,1094,28
2017,4,20,13,1205,1184,1479,295
2017,4,20,14,1305,1256,1922,666
2017,4,20,15,1305,1259,2002,743
2017,4,20,16,1295,1250,1859,609
2017,4,20,17,1265,1246,1556,310
2017,4,20,18,1255,1211,1415,204
2017,4,20,19,1230,1208,1343,135
2017,4,20,20,1230,1208,1255,47
2017,4,20,21,1190,1206,1217,15
2017,4,20,22,1235,1201,1202,5
2017,4,20,23,1225,1202,1207,5
2017,4,21,0,1225,1201,1252,51
2017,4,21,1,1225,1231,1315,84
2017,4,21,2,1250,1273,1409,136
2017,4,21,3,1290,1285,1436,151
2017,4,21,4,1220,1260,1498,238
2017,4,21,5,1135,1179,1356,177
2017,4,21,6,1050,1084,1216,132
2017,4,21,7,1010,1042,1106,64
2017,4,21,8,985,1032,1130,98
2017,4,21,9,985,1015,1185,170
2017,4,21,10,980,1009,1165,156
2017,4,21,11,995,1032,1236,204
2017,4,21,12,1050,1081,1352,271
2017,4,21,13,1190,1204,2009,805
2017,4,21,14,1300,1308,2161,853
2017,4,21,15,1300,1316,2200,884
2017,4,21,16,1295,1331,2276,945
2017,4,21,17,1275,1322,2232,910
2017,4,21,18,1260,1317,2289,972
2017,4,21,19,1255,1302,2225,923
2017,4,21,20,1240,1296,2143,847
2017,4,21,21,1230,1277,2067,790
2017,4,21,22,1195,1272,2073,801
2017,4,21,23,1210,1249,1938,689
2017,4,22,0,1205,1226,1862,636
2017,4,22,1,1210,1202,1856,654
2017,4,22,2,1225,1209,1655,446
2017,4,22,3,1250,1221,1559,338
2017,4,22,4,1230,1202,1628,426
2017,4,22,5,1165,1145,1498,353
2017,4,22,6,1115,1085,1759,674
2017,4,22,7,1040,1032,1664,632
2017,4,22,8,1015,1024,1680,656
2017,4,22,9,1005,1007,1613,606
2017,4,22,10,1020,998,1528,530
2017,4,22,11,1050,1013,1544,531
2017,4,22,12,1060,1038,1586,548
2017,4,22,13,1090,1078,1575,497
2017,4,22,14,1130,1118,1437,319
2017,4,22,15,1170,1151,1680,529
2017,4,22,16,1180,1153,1745,592
2017,4,22,17,1180,1148,2024,876
2017,4,22,18,1175,1127,1887,760
2017,4,22,19,1150,1125,1800,675
2017,4,22,20,1140,1098,1921,823
2017,4,22,21,1105,1089,1696,607
2017,4,22,22,1095,1080,1571,491
2017,4,22,23,1100,1066,1391,325
2017,4,23,0,1125,1084,1542,458
2017,4,23,1,1120,1094,1459,365
2017,4,23,2,1130,1106,1559,453
2017,4,23,3,1160,1133,1857,724
2017,4,23,4,1145,1125,1891,766
2017,4,23,5,1100,1085,1856,771
2017,4,23,6,1045,1025,1684,659
2017,4,23,7,1000,986,1518,532
2017,4,23,8,1000,979,1592,613
2017,4,23,9,990,958,1420,462
2017,4,23,10,995,947,1464,517
2017,4,23,11,975,954,1382,428
2017,4,23,12,1005,981,1390,409
2017,4,23,13,1070,1012,1362,350
2017,4,23,14,1120,1054,1473,419
2017,4,23,15,1150,1100,1391,291
2017,4,23,16,1170,1142,1766,624
2017,4,23,17,1180,1152,1879,727
2017,4,23,18,1155,1155,1837,682
2017,4,23,19,1115,1153,1649,496
2017,4,23,20,1105,1136,1777,641
2017,4,23,21,1075,1131,1792,661
2017,4,23,22,1070,1136,1941,805
2017,4,23,23,1085,1150,1945,795
2017,4,24,0,1090,1143,1952,809
2017,4,24,1,1105,1152,1815,663
2017,4,24,2,1125,1152,1950,798
2017,4,24,3,1155,1196,2214,1018
2017,4,24,4,1145,1180,2335,1155
2017,4,24,5,1090,1110,2253,1143
2017,4,24,6,1015,1004,1994,990
2017,4,24,7,1005,973,1576,603
2017,4,24,8,970,951,1452,501
2017,4,24,9,975,967,1315,348
2017,4,24,10,995,963,1314,351
2017,4,24,11,1025,995,1371,376
2017,4,24,12,1085,1063,1624,561
2017,4,24,13,1190,1190,2335,1145
2017,4,24,14,1260,1273,2488,1215
2017,4,24,15,1270,1260,2478,1218
2017,4,24,16,1260,1253,2409,1156
2017,4,24,17,1235,1248,2383,1135
2017,4,24,18,1225,1235,2389,1154
2017,4,24,19,1195,1220,2376,1156
2017,4,24,20,1140,1215,2389,1174
2017,4,24,21,1210,1210,2359,1149
2017,4,24,22,1195,1201,2383,1182
2017,4,24,23,1185,1189,2188,999
2017,4,25,0,1170,1193,2079,886
2017,4,25,1,1185,1206,2336,1130
2017,4,25,2,1215,1220,2440,1220
2017,4,25,3,1240,1245,2338,1093
2017,4,25,4,1220,1220,2067,847
2017,4,25,5,1125,1119,1605,486
2017,4,25,6,1045,1047,1558,511
2017,4,25,7,995,1008,1529,521
2017,4,25,8,970,981,1340,359
2017,4,25,9,950,977,1352,375
2017,4,25,10,940,996,1302,306
2017,4,25,11,975,1022,1279,257
2017,4,25,12,1045,1060,1290,230
2017,4,25,13,1255,1190,1691,501
2017,4,25,14,1315,1262,1780,518
2017,4,25,15,1320,1282,1954,672
2017,4,25,16,1310,1280,1908,628
2017,4,25,17,1275,1282,1904,622
2017,4,25,18,1265,1256,1903,647
2017,4,25,19,1220,1232,1893,661
2017,4,25,20,1210,1230,1850,620
2017,4,25,21,1200,1200,1832,632
2017,4,25,22,1205,1219,1812,593
2017,4,25,23,1195,1199,1714,515
2017,4,26,0,1190,1193,1601,408
2017,4,26,1,1205,1205,1928,723
2017,4,26,2,1230,1196,2184,988
2017,4,26,3,1270,1246,2510,1264
2017,4,26,4,1195,1226,2493,1267
2017,4,26,5,1110,1138,2405,1267
2017,4,26,6,1050,1083,2422,1339
2017,4,26,7,975,1027,1926,899
2017,4,26,8,960,1008,1549,541
2017,4,26,9,965,998,1415,417
2017,4,26,10,985,1000,1458,458
2017,4,26,11,1025,1035,1437,402
2017,4,26,12,1070,1075,1442,367
2017,4,26,13,1185,1214,1786,572
2017,4,26,14,1285,1294,2077,783
2017,4,26,15,1260,1279,2426,1147
2017,4,26,16,1245,1301,2379,1078
2017,4,26,17,1225,1269,2215,946
2017,4,26,18,1210,1268,2030,762
2017,4,26,19,1195,1243,2060,817
2017,4,26,20,1195,1240,1990,750
2017,4,26,21,1185,1232,1937,705
2017,4,26,22,1175,1231,1855,624
2017,4,26,23,1175,1224,1823,599
2017,4,27,0,1170,1208,1665,457
2017,4,27,1,1180,1216,1618,402
2017,4,27,2,1180,1211,1662,451
2017,4,27,3,1210,1235,1724,489
2017,4,27,4,1165,1211,1660,449
2017,4,27,5,1105,1128,1514,386
2017,4,27,6,1030,1072,1347,275
2017,4,27,7,1005,1034,1433,399
2017,4,27,8,995,1000,1322,322
2017,4,27,9,1005,1014,1315,301
2017,4,27,10,995,1006,1309,303
2017,4,27,11,1020,1017,1310,293
2017,4,27,12,1065,1085,1480,395
2017,4,27,13,1195,1187,1810,623
2017,4,27,14,1300,1267,2255,988
2017,4,27,15,1310,1269,2276,1007
2017,4,27,16,1300,1277,2180,903
2017,4,27,17,1285,1262,1725,463
2017,4,27,18,1260,1234,1466,232
2017,4,27,19,1255,1233,1459,226
2017,4,27,20,1255,1229,1482,253
2017,4,27,21,1250,1215,1465,250
2017,4,27,22,1245,1215,1493,278
2017,4,27,23,1240,1200,1447,247
2017,4,28,0,1235,1190,1482,292
2017,4,28,1,1245,1184,1545,361
2017,4,28,2,1255,1195,1624,429
2017,4,28,3,1290,1217,1560,343
2017,4,28,4,1240,1211,1762,551
2017,4,28,5,1170,1137,1629,492
2017,4,28,6,1095,1065,1464,399
2017,4,28,7,1005,1030,1507,477
2017,4,28,8,990,1010,1405,395
2017,4,28,9,1010,1008,1451,443
2017,4,28,10,1000,1004,1400,396
2017,4,28,11,1010,1029,1408,379
2017,4,28,12,1070,1089,1465,376
2017,4,28,13,1165,1190,1874,684
2017,4,28,14,1275,1281,2173,892
2017,4,28,15,1285,1307,2509,1202
2017,4,28,16,1300,1304,2465,1161
2017,4,28,17,1285,1268,2034,766
2017,4,28,18,1285,1265,1905,640
2017,4,28,19,1270,1230,1909,679
2017,4,28,20,1260,1208,1825,617
2017,4,28,21,1240,1206,1740,534
2017,4,28,22,1225,1195,1677,482
2017,4,28,23,1235,1191,1612,421
2017,4,29,0,1220,1166,1549,383
2017,4,29,1,1185,1168,1514,346
2017,4,29,2,1195,1167,1538,371
2017,4,29,3,1210,1186,1524,338
2017,4,29,4,1200,1210,1677,467
2017,4,29,5,1130,1146,1653,507
2017,4,29,6,1065,1070,1730,660
2017,4,29,7,1025,1029,1693,664
2017,4,29,8,1010,1011,1484,473
2017,4,29,9,985,1000,1549,549
2017,4,29,10,980,986,1535,549
2017,4,29,11,1005,1007,1501,494
2017,4,29,12,1025,1037,1569,532
2017,4,29,13,1060,1072,1815,743
2017,4,29,14,1125,1125,2142,1017
2017,4,29,15,1185,1166,2399,1233
2017,4,29,16,1190,1165,2228,1063
2017,4,29,17,1190,1142,2104,962
2017,4,29,18,1170,1126,2111,985
2017,4,29,19,1165,1098,1892,794
2017,4,29,20,1135,1083,1634,551
2017,4,29,21,1125,1070,1477,407
2017,4,29,22,1125,1068,1442,374
2017,4,29,23,1120,1073,1480,407
2017,4,30,0,1140,1076,1456,380
2017,4,30,1,1170,1093,1539,446
2017,4,30,2,1170,1112,1910,798
2017,4,30,3,1185,1130,1752,622
2017,4,30,4,1170,1132,1922,790
2017,4,30,5,1115,1081,1694,613
2017,4,30,6,1040,1046,1709,663
2017,4,30,7,970,1001,1427,426
2017,4,30,8,970,963,1322,359
2017,4,30,9,960,976,1351,375
2017,4,30,10,955,981,1350,369
2017,4,30,11,960,979,1363,384
2017,4,30,12,995,995,1370,375
2017,4,30,13,1040,1017,1386,369
2017,4,30,14,1080,1049,1428,379
2017,4,30,15,1120,1105,1459,354
2017,4,30,16,1150,1150,1566,416
2017,4,30,17,1155,1151,1620,469
2017,4,30,18,1160,1141,1637,496
2017,4,30,19,1140,1135,1662,527
2017,4,30,20,1115,1116,1608,492
2017,4,30,21,1080,1118,1543,425
2017,4,30,22,1105,1119,1563,444
2017,4,30,23,1110,1123,1568,445
2017,5,1,0,1125,1136,1581,445
2017,5,1,1,1130,1151,1600,449
2017,5,1,2,1130,1149,1659,510
2017,5,1,3,1160,1157,1555,398
2017,5,1,4,1145,1156,1648,492
2017,5,1,5,1090,1069,1625,556
2017,5,1,6,1005,1002,1434,432
2017,5,1,7,995,984,1414,430
2017,5,1,8,970,955,1445,490
2017,5,1,9,950,947,1394,447
2017,5,1,10,950,956,1408,452
2017,5,1,11,980,970,1468,498
2017,5,1,12,1045,1038,1632,594
2017,5,1,13,1150,1175,2099,924
2017,5,1,14,1265,1233,2448,1215
2017,5,1,15,1255,1240,2448,1208
2017,5,1,16,1250,1253,2490,1237
2017,5,1,17,1235,1259,2520,1261
2017,5,1,18,1225,1262,2519,1257
2017,5,1,19,1205,1231,2430,1199
2017,5,1,20,1195,1210,2347,1137
2017,5,1,21,1200,1198,2320,1122
2017,5,1,22,1195,1184,2202,1018
2017,5,1,23,1180,1179,2184,1005
2017,5,2,0,1180,1162,2202,1040
2017,5,2,1,1185,1164,2414,1250
2017,5,2,2,1200,1196,2435,1239
2017,5,2,3,1220,1234,2464,1230
2017,5,2,4,1195,1232,2463,1231
2017,5,2,5,1100,1153,2409,1256
2017,5,2,6,1020,1052,2329,1277
2017,5,2,7,980,1015,1994,979
2017,5,2,8,950,1008,1665,657
2017,5,2,9,945,1017,1511,494
2017,5,2,10,950,1024,1449,425
2017,5,2,11,980,1033,1349,316
2017,5,2,12,1065,1095,1973,878
2017,5,2,13,1190,1202,2329,1127
2017,5,2,14,1275,1272,2385,1113
2017,5,2,15,1285,1272,2343,1071
2017,5,2,16,1285,1269,2355,1086
2017,5,2,17,1255,1264,2451,1187
2017,5,2,18,1240,1244,2419,1175
2017,5,2,19,1215,1234,2258,1024
2017,5,2,20,1200,1198,2077,879
2017,5,2,21,1195,1194,1971,777
2017,5,2,22,1210,1180,1875,695
2017,5,2,23,1190,1166,1991,825
2017,5,3,0,1185,1154,2048,894
2017,5,3,1,1200,1149,2268,1119
2017,5,3,2,1220,1161,2394,1233
2017,5,3,3,1255,1193,2411,1218
2017,5,3,4,1155,1209,2429,1220
2017,5,3,5,1080,1129,2407,1278
2017,5,3,6,1015,1052,2220,1168
2017,5,3,7,995,1020,2161,1141
2017,5,3,8,985,1014,1830,816
2017,5,3,9,985,988,1680,692
2017,5,3,10,990,1005,1539,534
2017,5,3,11,1005,1028,1554,526
2017,5,3,12,1065,1094,1697,603
2017,5,3,13,1175,1211,2311,1100
2017,5,3,14,1260,1259,2142,883
2017,5,3,15,1230,1253,2160,907
2017,5,3,16,1230,1246,2335,1089
2017,5,3,17,1220,1214,2299,1085
2017,5,3,18,1200,1208,2395,1187
2017,5,3,19,1195,1205,2389,1184
2017,5,3,20,1190,1204,2354,1150
2017,5,3,21,1180,1187,2323,1136
2017,5,3,22,1160,1192,2420,1228
2017,5,3,23,1165,1191,2414,1223
2017,5,4,0,1155,1184,2433,1249
2017,5,4,1,1155,1168,2462,1294
2017,5,4,2,1160,1160,2443,1283
2017,5,4,3,1190,1178,2434,1256
2017,5,4,4,1180,1202,2472,1270
2017,5,4,5,1110,1128,2410,1282
2017,5,4,6,1030,1052,2360,1308
2017,5,4,7,960,981,1959,978
2017,5,4,8,960,970,1681,711
2017,5,4,9,940,949,1458,509
2017,5,4,10,955,955,1397,442
2017,5,4,11,980,976,1484,508
2017,5,4,12,1045,1046,1654,608
2017,5,4,13,1150,1116,1970,854
2017,5,4,14,1215,1187,1832,645
2017,5,4,15,1235,1182,1946,764
2017,5,4,16,1220,1183,1714,531
2017,5,4,17,1245,1185,1773,588
2017,5,4,18,1230,1170,1811,641
2017,5,4,19,1220,1181,1891,710
2017,5,4,20,1220,1185,1946,761
2017,5,4,21,1225,1203,1966,763
2017,5,4,22,1220,1222,1944,722
2017,5,4,23,1235,1219,1968,749
2017,5,5,0,1215,1211,1948,737
2017,5,5,1,1230,1196,1938,742
2017,5,5,2,1225,1193,1979,786
2017,5,5,3,1235,1202,1961,759
2017,5,5,4,1245,1211,1912,701
2017,5,5,5,1145,1131,1587,456
2017,5,5,6,1055,1053,1679,626
2017,5,5,7,940,1031,1691,660
2017,5,5,8,940,999,1367,368
2017,5,5,9,930,978,1197,219
2017,5,5,10,940,985,1171,186
2017,5,5,11,965,990,1229,239
2017,5,5,12,1030,1026,1250,224
2017,5,5,13,1105,1102,1423,321
2017,5,5,14,1180,1163,1374,211
2017,5,5,15,1245,1183,1396,213
2017,5,5,16,1255,1203,1244,41
2017,5,5,17,1255,1224,1214,-10
2017,5,5,18,1255,1232,1263,31
2017,5,5,19,1265,1242,1296,54
2017,5,5,20,1285,1260,1301,41
2017,5,5,21,1280,1261,1331,70
2017,5,5,22,1280,1292,1270,-22
2017,5,5,23,1280,1263,1307,44
2017,5,6,0,1270,1241,1310,69
2017,5,6,1,1235,1231,1334,103
2017,5,6,2,1220,1205,1369,164
2017,5,6,3,1210,1199,1269,70
2017,5,6,4,1220,1200,1369,169
2017,5,6,5,1160,1128,1335,207
2017,5,6,6,1075,1041,1414,373
2017,5,6,7,990,984,1289,305
2017,5,6,8,945,956,1204,248
2017,5,6,9,930,944,1198,254
2017,5,6,10,950,930,1230,300
2017,5,6,11,955,936,1324,388
2017,5,6,12,985,951,1334,383
2017,5,6,13,1025,964,1277,313
2017,5,6,14,1100,1014,1272,258
2017,5,6,15,1150,1064,1355,291
2017,5,6,16,1165,1103,1538,435
2017,5,6,17,1165,1125,1343,218
2017,5,6,18,1160,1130,1462,332
2017,5,6,19,1135,1147,1390,243
2017,5,6,20,1145,1151,1335,184
2017,5,6,21,1145,1166,1351,185
2017,5,6,22,1140,1168,1294,126
2017,5,6,23,1140,1189,1289,100
2017,5,7,0,1150,1193,1226,33
2017,5,7,1,1160,1184,1267,83
2017,5,7,2,1165,1161,1286,125
2017,5,7,3,1180,1154,1351,197
2017,5,7,4,1195,1172,1427,255
2017,5,7,5,1115,1104,1466,362
2017,5,7,6,1045,1035,1658,623
2017,5,7,7,960,976,1578,602
2017,5,7,8,935,947,1383,436
2017,5,7,9,935,931,1382,451
2017,5,7,10,950,927,1356,429
2017,5,7,11,935,937,1366,429
2017,5,7,12,960,937,1432,495
2017,5,7,13,1010,954,1413,459
2017,5,7,14,1070,998,1391,393
2017,5,7,15,1115,1043,1431,388
2017,5,7,16,1150,1093,1625,532
2017,5,7,17,1155,1145,1803,658
2017,5,7,18,1165,1142,1754,612
2017,5,7,19,1145,1164,1666,502
2017,5,7,20,1120,1164,1583,419
2017,5,7,21,1130,1171,1559,388
2017,5,7,22,1150,1183,1569,386
2017,5,7,23,1135,1198,1595,397
2017,5,8,0,1150,1198,1866,668
2017,5,8,1,1155,1196,2117,921
2017,5,8,2,1155,1183,2166,983
2017,5,8,3,1165,1181,2272,1091
2017,5,8,4,1170,1168,2254,1086
2017,5,8,5,1090,1093,2232,1139
2017,5,8,6,1015,1007,2102,1095
2017,5,8,7,995,960,1656,696
2017,5,8,8,995,939,1473,534
2017,5,8,9,980,929,1321,392
2017,5,8,10,980,936,1287,351
2017,5,8,11,1005,955,1353,398
2017,5,8,12,1035,1020,1770,750
2017,5,8,13,1150,1120,1907,787
2017,5,8,14,1225,1178,1931,753
2017,5,8,15,1235,1182,1948,766
2017,5,8,16,1235,1203,1996,793
2017,5,8,17,1230,1198,1958,760
2017,5,8,18,1230,1193,1949,756
2017,5,8,19,1180,1180,1922,742
2017,5,8,20,1270,1165,1810,645
2017,5,8,21,1235,1172,1889,717
2017,5,8,22,1230,1166,1836,670
2017,5,8,23,1235,1166,1825,659
2017,5,9,0,1220,1154,1809,655
2017,5,9,1,1190,1154,1861,707
2017,5,9,2,1185,1167,1919,752
2017,5,9,3,1185,1176,1946,770
2017,5,9,4,1180,1198,2022,824
2017,5,9,5,1135,1103,1935,832
2017,5,9,6,1070,1027,1841,814
2017,5,9,7,965,966,1479,513
2017,5,9,8,945,948,1312,364
2017,5,9,9,945,936,1227,291
2017,5,9,10,950,939,1220,281
2017,5,9,11,970,955,1235,280
2017,5,9,12,1030,1013,1423,410
2017,5,9,13,1130,1099,1618,519
2017,5,9,14,1205,1182,1712,530
2017,5,9,15,1200,1190,1787,597
2017,5,9,16,1215,1197,1864,667
2017,5,9,17,1225,1190,1866,676
2017,5,9,18,1210,1204,1801,597
2017,5,9,19,1210,1195,1869,674
2017,5,9,20,1200,1196,1872,676
2017,5,9,21,1210,1181,1861,680
2017,5,9,22,1215,1188,1881,693
2017,5,9,23,1230,1205,2009,804
2017,5,10,0,1220,1176,1986,810
2017,5,10,1,1220,1177,1956,779
2017,5,10,2,1215,1173,1968,795
2017,5,10,3,1215,1184,2026,842
2017,5,10,4,1230,1199,2006,807
2017,5,10,5,1145,1110,1804,694
2017,5,10,6,1060,1027,1681,654
2017,5,10,7,955,993,1575,582
2017,5,10,8,940,959,1297,338
2017,5,10,9,925,946,1252,306
2017,5,10,10,940,951,1263,312
2017,5,10,11,960,971,1273,302
2017,5,10,12,1025,1015,1383,368
2017,5,10,13,1145,1115,1741,626
2017,5,10,14,1230,1179,1802,623
2017,5,10,15,1225,1187,1950,763
2017,5,10,16,1215,1199,1919,720
2017,5,10,17,1195,1198,1921,723
2017,5,10,18,1185,1195,1936,741
2017,5,10,19,1180,1193,1943,750
2017,5,10,20,1180,1202,1939,737
2017,5,10,21,1165,1192,1937,745
2017,5,10,22,1170,1209,1910,701
2017,5,10,23,1165,1220,1920,700
2017,5,11,0,1155,1211,1959,748
2017,5,11,1,1145,1208,1965,757
2017,5,11,2,1145,1208,1975,767
2017,5,11,3,1155,1210,1930,720
2017,5,11,4,1230,1216,1956,740
2017,5,11,5,1105,1116,1869,753
2017,5,11,6,1030,1038,1467,429
2017,5,11,7,975,974,1374,400
2017,5,11,8,950,951,1296,345
2017,5,11,9,950,938,1377,439
2017,5,11,10,960,936,1247,311
2017,5,11,11,980,947,1239,292
2017,5,11,12,1025,984,1259,275
2017,5,11,13,1135,1066,1369,303
2017,5,11,14,1240,1147,1319,172
2017,5,11,15,1230,1180,1601,421
2017,5,11,16,1235,1209,1812,603
2017,5,11,17,1235,1197,1650,453
2017,5,11,18,1230,1221,1655,434
2017,5,11,19,1230,1215,1706,491
2017,5,11,20,1235,1229,1613,384
2017,5,11,21,1245,1248,1756,508
2017,5,11,22,1265,1256,1677,421
2017,5,11,23,1265,1278,1605,327
2017,5,12,0,1250,1250,1514,264
2017,5,12,1,1240,1234,1495,261
2017,5,12,2,1235,1215,1492,277
2017,5,12,3,1245,1226,1417,191
2017,5,12,4,1255,1211,1372,161
2017,5,12,5,1180,1141,1348,207
2017,5,12,6,1095,1026,1186,160
2017,5,12,7,965,995,1217,222
2017,5,12,8,945,955,1158,203
2017,5,12,9,930,944,1160,216
2017,5,12,10,935,936,1196,260
2017,5,12,11,945,960,1182,222
2017,5,12,12,985,991,1170,179
2017,5,12,13,1085,1065,1275,210
2017,5,12,14,1160,1167,1797,630
2017,5,12,15,1165,1177,1920,743
2017,5,12,16,1180,1203,1963,760
2017,5,12,17,1195,1210,1943,733
2017,5,12,18,1200,1220,1925,705
2017,5,12,19,1210,1240,1929,689
2017,5,12,20,1220,1261,1903,642
2017,5,12,21,1220,1276,1804,528
2017,5,12,22,1250,1301,1748,447
2017,5,12,23,1225,1286,1645,359
2017,5,13,0,1205,1264,1625,361
2017,5,13,1,1200,1258,1593,335
2017,5,13,2,1180,1250,1681,431
2017,5,13,3,1175,1251,1709,458
2017,5,13,4,1175,1224,1747,523
2017,5,13,5,1100,1169,1974,805
2017,5,13,6,1015,1079,1864,785
2017,5,13,7,955,1016,1686,670
2017,5,13,8,935,985,1508,523
2017,5,13,9,935,954,1341,387
2017,5,13,10,925,955,1378,423
2017,5,13,11,945,986,1379,393
2017,5,13,12,975,1003,1388,385
2017,5,13,13,1045,1019,1445,426
2017,5,13,14,1140,1066,1444,378
2017,5,13,15,1185,1104,1656,552
2017,5,13,16,1190,1127,1741,614
2017,5,13,17,1185,1125,1752,627
2017,5,13,18,1150,1125,1616,491
2017,5,13,19,1135,1114,1536,422
2017,5,13,20,1135,1100,1489,389
2017,5,13,21,1115,1089,1375,286
2017,5,13,22,1120,1092,1322,230
2017,5,13,23,1130,1086,1315,229
2017,5,14,0,1120,1096,1439,343
2017,5,14,1,1135,1097,1347,250
2017,5,14,2,1150,1086,1356,270
2017,5,14,3,1170,1090,1334,244
2017,5,14,4,1140,1116,1357,241
2017,5,14,5,1145,1066,1348,282
2017,5,14,6,1055,1034,1590,556
2017,5,14,7,975,984,1495,511
2017,5,14,8,945,972,1300,328
2017,5,14,9,935,954,1256,302
2017,5,14,10,940,953,1267,314
2017,5,14,11,940,964,1339,375
2017,5,14,12,945,970,1254,284
2017,5,14,13,975,982,1267,285
2017,5,14,14,1025,1029,1296,267
2017,5,14,15,1070,1077,1309,232
2017,5,14,16,1115,1091,1299,208
2017,5,14,17,1145,1102,1367,265
2017,5,14,18,1150,1091,1382,291
2017,5,14,19,1160,1090,1384,294
2017,5,14,20,1150,1062,1398,336
2017,5,14,21,1150,1061,1352,291
2017,5,14,22,1170,1051,1354,303
2017,5,14,23,1170,1069,1376,307
2017,5,15,0,1180,1088,1368,280
2017,5,15,1,1180,1099,1359,260
2017,5,15,2,1170,1108,1400,292
2017,5,15,3,1170,1124,1498,374
2017,5,15,4,1155,1138,1846,708
2017,5,15,5,1085,1073,1773,700
2017,5,15,6,1005,995,1622,627
2017,5,15,7,950,953,1377,424
2017,5,15,8,935,924,1220,296
2017,5,15,9,930,921,1213,292
2017,5,15,10,935,907,1188,281
2017,5,15,11,950,937,1189,252
2017,5,15,12,1015,990,1294,304
2017,5,15,13,1110,1108,1814,706
2017,5,15,14,1165,1198,1982,784
2017,5,15,15,1170,1186,2003,817
2017,5,15,16,1190,1193,1986,793
2017,5,15,17,1185,1189,2009,820
2017,5,15,18,1180,1183,1970,787
2017,5,15,19,1165,1182,1917,735
2017,5,15,20,1155,1182,1918,736
2017,5,15,21,1160,1180,1908,728
2017,5,15,22,1155,1169,1897,728
2017,5,15,23,1155,1178,1895,717
2017,5,16,0,1145,1165,1885,720
2017,5,16,1,1140,1155,1823,668
2017,5,16,2,1155,1148,1919,771
2017,5,16,3,1165,1154,1958,804
2017,5,16,4,1175,1169,1979,810
2017,5,16,5,1090,1090,1964,874
2017,5,16,6,1015,1019,1831,812
2017,5,16,7,975,977,1733,756
2017,5,16,8,960,947,1465,518
2017,5,16,9,965,925,1334,409
2017,5,16,10,960,930,1282,352
2017,5,16,11,985,946,1219,273
2017,5,16,12,1035,996,1430,434
2017,5,16,13,1180,1085,1652,567
2017,5,16,14,1280,1164,1631,467
2017,5,16,15,1260,1169,1642,473
2017,5,16,16,1265,1180,1656,476
2017,5,16,17,1260,1181,1619,438
2017,5,16,18,1245,1184,1636,452
2017,5,16,19,1235,1182,1656,474
2017,5,16,20,1235,1194,1554,360
2017,5,16,21,1210,1175,1552,377
2017,5,16,22,1210,1165,1502,337
2017,5,16,23,1225,1180,1229,49
2017,5,17,0,1210,1170,1101,-69
2017,5,17,1,1210,1156,1204,48
2017,5,17,2,1210,1166,1425,259
2017,5,17,3,1230,1158,1485,327
2017,5,17,4,1210,1177,1627,450
2017,5,17,5,1120,1110,1446,336
2017,5,17,6,1055,1051,1314,263
2017,5,17,7,995,1007,1207,200
2017,5,17,8,980,983,1171,188
2017,5,17,9,985,984,1105,121
2017,5,17,10,975,984,1194,210
2017,5,17,11,1005,1012,1284,272
2017,5,17,12,1055,1080,1422,342
2017,5,17,13,1180,1196,1676,480
2017,5,17,14,1270,1242,1816,574
2017,5,17,15,1250,1287,1857,570
2017,5,17,16,1255,1300,1892,592
2017,5,17,17,1245,1322,1926,604
2017,5,17,18,1230,1322,1915,593
2017,5,17,19,1225,1339,1591,252
2017,5,17,20,1220,1327,1445,118
2017,5,17,21,1200,1323,1407,84
2017,5,17,22,1195,1320,1493,173
2017,5,17,23,1210,1337,1540,203
2017,5,18,0,1195,1320,1544,224
2017,5,18,1,1195,1294,1547,253
2017,5,18,2,1190,1286,1647,361
2017,5,18,3,1205,1263,1829,566
2017,5,18,4,1185,1235,1881,646
2017,5,18,5,1110,1159,1761,602
2017,5,18,6,1045,1082,1809,727
2017,5,18,7,975,1027,1656,629
2017,5,18,8,955,990,1416,426
2017,5,18,9,955,980,1381,401
2017,5,18,10,960,970,1321,351
2017,5,18,11,980,981,1370,389
2017,5,18,12,1040,1045,1565,520
2017,5,18,13,1160,1145,1922,777
2017,5,18,14,1200,1222,1927,705
2017,5,18,15,1205,1244,2063,819
2017,5,18,16,1215,1239,2021,782
2017,5,18,17,1210,1223,1988,765
2017,5,18,18,1210,1218,2003,785
2017,5,18,19,1210,1193,2004,811
2017,5,18,20,1220,1189,1987,798
2017,5,18,21,1215,1176,1982,806
2017,5,18,22,1215,1163,1905,742
2017,5,18,23,1230,1149,1821,672
2017,5,19,0,1215,1136,1905,769
2017,5,19,1,1205,1129,1809,680
2017,5,19,2,1200,1124,1793,669
2017,5,19,3,1200,1136,1824,688
2017,5,19,4,1215,1166,1844,678
2017,5,19,5,1135,1098,1606,508
2017,5,19,6,1055,1029,1680,651
2017,5,19,7,1010,987,1519,532
2017,5,19,8,990,969,1494,525
2017,5,19,9,985,961,1418,457
2017,5,19,10,975,956,1372,416
2017,5,19,11,985,978,1385,407
2017,5,19,12,1045,1022,1449,427
2017,5,19,13,1140,1107,1565,458
2017,5,19,14,1175,1192,1646,454
2017,5,19,15,1200,1196,1884,688
2017,5,19,16,1205,1191,1802,611
2017,5,19,17,1195,1182,1898,716
2017,5,19,18,1190,1168,1831,663
2017,5,19,19,1185,1161,1918,757
2017,5,19,20,1170,1146,1921,775
2017,5,19,21,1165,1142,1849,707
2017,5,19,22,1150,1130,1875,745
2017,5,19,23,1155,1120,1867,747
2017,5,20,0,1145,1100,1776,676
2017,5,20,1,1130,1088,1818,730
2017,5,20,2,1140,1090,1777,687
2017,5,20,3,1140,1080,1693,613
2017,5,20,4,1125,1102,1652,550
2017,5,20,5,1060,1070,1678,608
2017,5,20,6,990,998,1755,757
2017,5,20,7,980,957,1338,381
2017,5,20,8,965,940,1289,349
2017,5,20,9,955,922,1262,340
2017,5,20,10,945,920,1259,339
2017,5,20,11,970,939,1275,336
2017,5,20,12,995,942,1264,322
2017,5,20,13,1045,968,1253,285
2017,5,20,14,1120,1009,1314,305
2017,5,20,15,1170,1061,1337,276
2017,5,20,16,1165,1074,1280,206
2017,5,20,17,1155,1080,1399,319
2017,5,20,18,1120,1081,1293,212
2017,5,20,19,1105,1076,1379,303
2017,5,20,20,1085,1080,1536,456
2017,5,20,21,1070,1080,1635,555
2017,5,20,22,1070,1082,1597,515
2017,5,20,23,1065,1082,1653,571
2017,5,21,0,1075,1090,1620,530
2017,5,21,1,1100,1087,1779,692
2017,5,21,2,1105,1094,1871,777
2017,5,21,3,1125,1085,1983,898
2017,5,21,4,1110,1116,2020,904
2017,5,21,5,1070,1074,2062,988
2017,5,21,6,1010,999,1888,889
2017,5,21,7,965,955,1750,795
2017,5,21,8,940,930,1452,522
2017,5,21,9,925,922,1303,381
2017,5,21,10,930,923,1340,417
2017,5,21,11,930,925,1312,387
2017,5,21,12,935,940,1279,339
2017,5,21,13,950,959,1282,323
2017,5,21,14,990,1004,1283,279
2017,5,21,15,1030,1043,1325,282
2017,5,21,16,1075,1073,1364,291
2017,5,21,17,1110,1074,1492,418
2017,5,21,18,1115,1090,1622,532
2017,5,21,19,1125,1086,1913,827
2017,5,21,20,1120,1078,1927,849
2017,5,21,21,1120,1070,1984,914
2017,5,21,22,1140,1074,1916,842
2017,5,21,23,1145,1093,2006,913
2017,5,22,0,1150,1112,2003,891
2017,5,22,1,1145,1132,2121,989
2017,5,22,2,1135,1115,2117,1002
2017,5,22,3,1135,1111,2129,1018
2017,5,22,4,1120,1124,2154,1030
2017,5,22,5,1055,1064,2160,1096
2017,5,22,6,975,980,2078,1098
2017,5,22,7,955,930,1952,1022
2017,5,22,8,925,899,1431,532
2017,5,22,9,925,880,1254,374
2017,5,22,10,910,886,1291,405
2017,5,22,11,940,903,1359,456
2017,5,22,12,990,957,1352,395
2017,5,22,13,1090,1048,1438,390
2017,5,22,14,1175,1131,1493,362
2017,5,22,15,1170,1169,1822,653
2017,5,22,16,1175,1183,1861,678
2017,5,22,17,1170,1187,1919,732
2017,5,22,18,1165,1195,1991,796
2017,5,22,19,1160,1202,2038,836
2017,5,22,20,1155,1205,2005,800
2017,5,22,21,1155,1195,2002,807
2017,5,22,22,1150,1206,2075,869
2017,5,22,23,1150,1197,2068,871
2017,5,23,0,1140,1186,2060,874
2017,5,23,1,1130,1184,2091,907
2017,5,23,2,1120,1177,2105,928
2017,5,23,3,1125,1168,2096,928
2017,5,23,4,1140,1173,2095,922
2017,5,23,5,1065,1117,2086,969
2017,5,23,6,995,1029,2046,1017
2017,5,23,7,970,971,2026,1055
2017,5,23,8,945,958,2022,1064
2017,5,23,9,930,936,1918,982
2017,5,23,10,930,936,1642,706
2017,5,23,11,945,944,1586,642
2017,5,23,12,985,993,1800,807
2017,5,23,13,1075,1086,2031,945
2017,5,23,14,1165,1170,1972,802
2017,5,23,15,1190,1174,2004,830
2017,5,23,16,1210,1201,2013,812
2017,5,23,17,1205,1199,1982,783
2017,5,23,18,1225,1208,1988,780
2017,5,23,19,1220,1204,1998,794
2017,5,23,20,1235,1227,2023,796
2017,5,23,21,1240,1224,2072,848
2017,5,23,22,1250,1242,2147,905
2017,5,23,23,1270,1250,2107,857
2017,5,24,0,1245,1245,2021,776
2017,5,24,1,1230,1240,2044,804
2017,5,24,2,1215,1232,2050,818
2017,5,24,3,1225,1214,1785,571
2017,5,24,4,1215,1215,1602,387
2017,5,24,5,1145,1144,1547,403
2017,5,24,6,1040,1058,1389,331
2017,5,24,7,950,996,1364,368
2017,5,24,8,940,956,1321,365
2017,5,24,9,920,945,1321,376
2017,5,24,10,930,937,1316,379
2017,5,24,11,955,963,1356,393
2017,5,24,12,1015,1002,1354,352
2017,5,24,13,1140,1079,1357,278
2017,5,24,14,1220,1160,1356,196
2017,5,24,15,1225,1184,1448,264
2017,5,24,16,1220,1218,1484,266
2017,5,24,17,1205,1233,1525,292
2017,5,24,18,1200,1241,1535,294
2017,5,24,19,1200,1246,1569,323
2017,5,24,20,1205,1228,1587,359
2017,5,24,21,1190,1224,1528,304
2017,5,24,22,1195,1215,1533,318
2017,5,24,23,1195,1217,1543,326
2017,5,25,0,1185,1208,1526,318
2017,5,25,1,1175,1190,1555,365
2017,5,25,2,1170,1195,1605,410
2017,5,25,3,1175,1183,1649,466
2017,5,25,4,1180,1189,1711,522
2017,5,25,5,1120,1130,1834,704
2017,5,25,6,1040,1055,1843,788
2017,5,25,7,980,1009,1793,784
2017,5,25,8,950,990,1512,522
2017,5,25,9,940,980,1476,496
2017,5,25,10,935,1000,1625,625
2017,5,25,11,945,1012,1537,525
2017,5,25,12,1005,1063,1519,456
2017,5,25,13,1095,1159,1512,353
2017,5,25,14,1175,1251,1608,357
2017,5,25,15,1195,1259,1773,514
2017,5,25,16,1200,1252,1745,493
2017,5,25,17,1190,1254,1625,371
2017,5,25,18,1190,1243,1661,418
2017,5,25,19,1175,1213,1691,478
2017,5,25,20,1175,1230,1540,310
2017,5,25,21,1165,1218,1500,282
2017,5,25,22,1165,1210,1490,280
2017,5,25,23,1160,1211,1485,274
2017,5,26,0,1145,1206,1468,262
2017,5,26,1,1140,1182,1571,389
2017,5,26,2,1130,1166,1655,489
2017,5,26,3,1140,1168,1748,580
2017,5,26,4,1170,1195,1720,525
2017,5,26,5,1090,1146,1703,557
2017,5,26,6,1015,1079,1845,766
2017,5,26,7,970,1036,1798,762
2017,5,26,8,945,1004,1459,455
2017,5,26,9,940,988,1319,331
2017,5,26,10,935,985,1320,335
2017,5,26,11,960,994,1295,301
2017,5,26,12,1000,1025,1416,391
2017,5,26,13,1100,1093,1578,485
2017,5,26,14,1195,1165,1518,353
2017,5,26,15,1200,1196,1756,560
2017,5,26,16,1205,1196,1857,661
2017,5,26,17,1200,1196,1723,527
2017,5,26,18,1190,1193,1659,466
2017,5,26,19,1185,1180,1569,389
2017,5,26,20,1165,1181,1616,435
2017,5,26,21,1165,1180,1793,613
2017,5,26,22,1150,1171,1918,747
2017,5,26,23,1145,1172,1950,778
2017,5,27,0,1125,1154,1847,693
2017,5,27,1,1110,1146,1885,739
2017,5,27,2,1115,1141,1982,841
2017,5,27,3,1105,1142,1922,780
2017,5,27,4,1125,1155,1820,665
2017,5,27,5,1090,1108,1675,567
2017,5,27,6,1010,1043,1806,763
2017,5,27,7,1020,1006,1756,750
2017,5,27,8,985,990,1545,555
2017,5,27,9,970,976,1405,429
2017,5,27,10,975,981,1224,243
2017,5,27,11,970,981,1215,234
2017,5,27,12,980,1000,1237,237
2017,5,27,13,1030,1025,1229,204
2017,5,27,14,1110,1060,1208,148
2017,5,27,15,1170,1098,1296,198
2017,5,27,16,1225,1122,1305,183
2017,5,27,17,1230,1138,1302,164
2017,5,27,18,1240,1132,1297,165
2017,5,27,19,1240,1136,1298,162
2017,5,27,20,1215,1122,1311,189
2017,5,27,21,1215,1107,1332,225
2017,5,27,22,1235,1113,1366,253
2017,5,27,23,1220,1131,1359,228
2017,5,28,0,1230,1136,1483,347
2017,5,28,1,1235,1149,1660,511
2017,5,28,2,1230,1155,1925,770
2017,5,28,3,1235,1152,2001,849
2017,5,28,4,1245,1180,2046,866
2017,5,28,5,1170,1128,2039,911
2017,5,28,6,1095,1060,2037,977
2017,5,28,7,1035,1019,1688,669
2017,5,28,8,1015,975,1280,305
2017,5,28,9,995,961,1222,261
2017,5,28,10,985,943,1242,299
2017,5,28,11,995,960,1248,288
2017,5,28,12,995,960,1232,272
2017,5,28,13,1015,978,1287,309
2017,5,28,14,1085,1022,1253,231
2017,5,28,15,1145,1065,1267,202
2017,5,28,16,1210,1099,1272,173
2017,5,28,17,1215,1114,1335,221
2017,5,28,18,1225,1117,1274,157
2017,5,28,19,1245,1126,1299,173
2017,5,28,20,1235,1129,1324,195
2017,5,28,21,1230,1130,1408,278
2017,5,28,22,1245,1135,1433,298
2017,5,28,23,1240,1152,1646,494
2017,5,29,0,1245,1163,1818,655
2017,5,29,1,1240,1153,1780,627
2017,5,29,2,1230,1142,2003,861
2017,5,29,3,1230,1138,1979,841
2017,5,29,4,1230,1158,2061,903
2017,5,29,5,1175,1109,1989,880
2017,5,29,6,1105,1038,1893,855
2017,5,29,7,995,987,1673,686
2017,5,29,8,980,979,1502,523
2017,5,29,9,965,954,1411,457
2017,5,29,10,960,954,1339,385
2017,5,29,11,985,969,1328,359
2017,5,29,12,1030,967,1314,347
2017,5,29,13,1095,978,1296,318
2017,5,29,14,1155,1036,1272,236
2017,5,29,15,1190,1081,1300,219
2017,5,29,16,1215,1131,1258,127
2017,5,29,17,1245,1168,1265,97
2017,5,29,18,1250,1190,1424,234
2017,5,29,19,1240,1182,1582,400
2017,5,29,20,1220,1193,1495,302
2017,5,29,21,1220,1206,1384,178
2017,5,29,22,1215,1216,1423,207
2017,5,29,23,1225,1241,1514,273
2017,5,30,0,1220,1261,1661,400
2017,5,30,1,1225,1248,1711,463
2017,5,30,2,1215,1258,1923,665
2017,5,30,3,1215,1256,1954,698
2017,5,30,4,1230,1257,1976,719
2017,5,30,5,1155,1173,1910,737
2017,5,30,6,1075,1095,1786,691
2017,5,30,7,995,1031,1579,548
2017,5,30,8,980,993,1368,375
2017,5,30,9,960,982,1298,316
2017,5,30,10,965,977,1271,294
2017,5,30,11,980,981,1270,289
2017,5,30,12,1035,1022,1295,273
2017,5,30,13,1140,1128,1312,184
2017,5,30,14,1245,1205,1442,237
2017,5,30,15,1260,1253,1693,440
2017,5,30,16,1280,1278,1716,438
2017,5,30,17,1280,1297,1673,376
2017,5,30,18,1285,1299,1611,312
2017,5,30,19,1280,1326,1769,443
2017,5,30,20,1295,1354,1763,409
2017,5,30,21,1285,1366,1900,534
2017,5,30,22,1295,1387,1868,481
2017,5,30,23,1300,1397,1832,435
2017,5,31,0,1295,1386,1834,448
2017,5,31,1,1285,1370,1785,415
2017,5,31,2,1275,1352,1679,327
2017,5,31,3,1265,1323,1498,175
2017,5,31,4,1280,1314,1449,135
2017,5,31,5,1210,1233,1441,208
2017,5,31,6,1115,1124,1372,248
2017,5,31,7,1020,1070,1270,200
2017,5,31,8,995,1037,1285,248
2017,5,31,9,980,1015,1275,260
2017,5,31,10,980,1012,1267,255
2017,5,31,11,1000,1032,1351,319
2017,5,31,12,1025,1063,1364,301
2017,5,31,13,1080,1144,1398,254
2017,5,31,14,1145,1235,1319,84
2017,5,31,15,1185,1270,1839,569
2017,5,31,16,1225,1311,2013,702
2017,5,31,17,1250,1315,2045,730
2017,5,31,18,1260,1349,2031,682
2017,5,31,19,1260,1369,2076,707
2017,5,31,20,1255,1400,2095,695
2017,5,31,21,1260,1418,2115,697
2017,5,31,22,1260,1429,2132,703
2017,5,31,23,1275,1457,2128,671
2017,6,1,0,1280,1442,2134,692
2017,6,1,1,1260,1429,2110,681
2017,6,1,2,1270,1401,2120,719
2017,6,1,3,1260,1378,2086,708
2017,6,1,4,1265,1347,1968,621
2017,6,1,5,1180,1272,1862,590
2017,6,1,6,1100,1157,1757,600
2017,6,1,7,1060,1090,1552,462
2017,6,1,8,1030,1060,1257,197
2017,6,1,9,1000,1050,1232,182
2017,6,1,10,1000,1036,1307,271
2017,6,1,11,1015,1043,1236,193
2017,6,1,12,1040,1082,1264,182
2017,6,1,13,1140,1115,1334,219
2017,6,1,14,1220,1248,1313,65
2017,6,1,15,1255,1284,1461,177
2017,6,1,16,1275,1302,1695,393
2017,6,1,17,1280,1310,1699,389
2017,6,1,18,1290,1341,1639,298
2017,6,1,19,1290,1369,1754,385
2017,6,1,20,1310,1387,1655,268
2017,6,1,21,1320,1415,1701,286
2017,6,1,22,1335,1412,1739,327
2017,6,1,23,1350,1402,1755,353
2017,6,2,0,1330,1348,1721,373
2017,6,2,1,1315,1325,1804,479
2017,6,2,2,1295,1284,1725,441
2017,6,2,3,1295,1259,1692,433
2017,6,2,4,1285,1250,1531,281
2017,6,2,5,1210,1214,1552,338
2017,6,2,6,1100,1134,1429,295
2017,6,2,7,1055,1077,1367,290
2017,6,2,8,1020,1059,1360,301
2017,6,2,9,1005,1041,1368,327
2017,6,2,10,1000,1046,1354,308
2017,6,2,11,1020,1053,1347,294
2017,6,2,12,1050,1090,1396,306
2017,6,2,13,1130,1160,1613,453
2017,6,2,14,1230,1242,1513,271
2017,6,2,15,1250,1250,1657,407
2017,6,2,16,1265,1279,1791,512
2017,6,2,17,1270,1300,2028,728
2017,6,2,18,1285,1299,2062,763
2017,6,2,19,1295,1327,2085,758
2017,6,2,20,1310,1336,2104,768
2017,6,2,21,1320,1337,2213,876
2017,6,2,22,1335,1347,2204,857
2017,6,2,23,1330,1348,2178,830
2017,6,3,0,1315,1337,2180,843
2017,6,3,1,1305,1351,2190,839
2017,6,3,2,1290,1328,2169,841
2017,6,3,3,1285,1327,2180,853
2017,6,3,4,1260,1304,2139,835
2017,6,3,5,1205,1252,2114,862
2017,6,3,6,1115,1165,1903,738
2017,6,3,7,1040,1124,1704,580
2017,6,3,8,1020,1053,1403,350
2017,6,3,9,1005,1029,1176,147
2017,6,3,10,995,1016,1114,98
2017,6,3,11,990,1010,1109,99
2017,6,3,12,1000,1000,1114,114
2017,6,3,13,1030,1021,1128,107
2017,6,3,14,1105,1062,1187,125
2017,6,3,15,1165,1135,1192,57
2017,6,3,16,1210,1170,1164,-6
2017,6,3,17,1250,1199,1195,-4
2017,6,3,18,1265,1205,1221,16
2017,6,3,19,1290,1250,1251,1
2017,6,3,20,1290,1277,1416,139
2017,6,3,21,1290,1291,1612,321
2017,6,3,22,1315,1321,1619,298
2017,6,3,23,1340,1326,1509,183
2017,6,4,0,1365,1354,1577,223
2017,6,4,1,1375,1349,1511,162
2017,6,4,2,1370,1332,1534,202
2017,6,4,3,1350,1306,1520,214
2017,6,4,4,1345,1295,1333,38
2017,6,4,5,1280,1239,1359,120
2017,6,4,6,1160,1164,1200,36
2017,6,4,7,1065,1102,1099,-3
2017,6,4,8,1035,1061,1100,39
2017,6,4,9,1020,1053,1109,56
2017,6,4,10,1000,1038,1106,68
2017,6,4,11,1005,1029,1107,78
2017,6,4,12,1005,1026,1080,54
2017,6,4,13,1035,1039,1078,39
2017,6,4,14,1110,1083,1073,-10
2017,6,4,15,1175,1152,1112,-40
2017,6,4,16,1225,1215,1133,-82
2017,6,4,17,1265,1255,1105,-150
2017,6,4,18,1280,1298,1094,-204
2017,6,4,19,1305,1334,1130,-204
2017,6,4,20,1320,1370,1154,-216
2017,6,4,21,1320,1389,1149,-240
2017,6,4,22,1350,1408,1240,-168
2017,6,4,23,1375,1419,1167,-252
2017,6,5,0,1400,1429,1265,-164
2017,6,5,1,1400,1407,1339,-68
2017,6,5,2,1390,1359,1373,14
2017,6,5,3,1370,1341,1328,-13
2017,6,5,4,1355,1308,1300,-8
2017,6,5,5,1295,1257,1333,76
2017,6,5,6,1175,1155,1330,175
2017,6,5,7,1060,1110,1346,236
2017,6,5,8,1035,1079,1324,245
2017,6,5,9,1015,1039,1312,273
2017,6,5,10,1010,1030,1299,269
2017,6,5,11,1025,1039,1321,282
2017,6,5,12,1055,1083,1366,283
2017,6,5,13,1110,1170,1420,250
2017,6,5,14,1215,1258,1505,247
2017,6,5,15,1250,1302,1801,499
2017,6,5,16,1280,1328,1936,608
2017,6,5,17,1295,1342,2000,658
2017,6,5,18,1325,1357,2063,706
2017,6,5,19,1340,1348,1997,649
2017,6,5,20,1365,1380,2051,671
2017,6,5,21,1385,1386,2055,669
2017,6,5,22,1390,1388,2034,646
2017,6,5,23,1405,1398,2041,643
2017,6,6,0,1380,1376,2051,675
2017,6,6,1,1365,1361,2036,675
2017,6,6,2,1335,1342,2006,664
2017,6,6,3,1320,1326,2013,687
2017,6,6,4,1295,1313,2070,757
2017,6,6,5,1235,1239,2026,787
2017,6,6,6,1140,1143,1846,703
2017,6,6,7,1040,1078,1716,638
2017,6,6,8,1015,1023,1337,314
2017,6,6,9,1000,1015,1236,221
2017,6,6,10,995,1018,1256,238
2017,6,6,11,1000,1031,1242,211
2017,6,6,12,1040,1057,1255,198
2017,6,6,13,1135,1143,1460,317
2017,6,6,14,1210,1227,1646,419
2017,6,6,15,1250,1270,1954,684
2017,6,6,16,1280,1285,1829,544
2017,6,6,17,1295,1310,2017,707
2017,6,6,18,1305,1314,2038,724
2017,6,6,19,1325,1325,2038,713
2017,6,6,20,1350,1313,2013,700
2017,6,6,21,1355,1343,2046,703
2017,6,6,22,1380,1365,2087,722
2017,6,6,23,1390,1381,2115,734
2017,6,7,0,1380,1415,2125,710
2017,6,7,1,1370,1394,2107,713
2017,6,7,2,1350,1386,2115,729
2017,6,7,3,1330,1360,2086,726
2017,6,7,4,1320,1359,2066,707
2017,6,7,5,1245,1297,2036,739
2017,6,7,6,1140,1154,1852,698
2017,6,7,7,1080,1087,1837,750
2017,6,7,8,1045,1043,1537,494
2017,6,7,9,1020,1019,1275,256
2017,6,7,10,1015,1021,1188,167
2017,6,7,11,1035,1032,1191,159
2017,6,7,12,1075,1051,1218,167
2017,6,7,13,1170,1149,1489,340
2017,6,7,14,1275,1224,1612,388
2017,6,7,15,1305,1270,1799,529
2017,6,7,16,1340,1303,1752,449
2017,6,7,17,1350,1329,1800,471
2017,6,7,18,1375,1362,1996,634
2017,6,7,19,1380,1391,2008,617
2017,6,7,20,1400,1421,2014,593
2017,6,7,21,1410,1452,2034,582
2017,6,7,22,1415,1491,2039,548
2017,6,7,23,1430,1512,2044,532
2017,6,8,0,1415,1505,2064,559
2017,6,8,1,1400,1507,2070,563
2017,6,8,2,1380,1477,2056,579
2017,6,8,3,1365,1445,2058,613
2017,6,8,4,1335,1405,1989,584
2017,6,8,5,1270,1333,1806,473
2017,6,8,6,1165,1220,1607,387
2017,6,8,7,1085,1155,1324,169
2017,6,8,8,1050,1120,1339,219
2017,6,8,9,1040,1087,1337,250
2017,6,8,10,1040,1072,1318,246
2017,6,8,11,1055,1079,1251,172
2017,6,8,12,1090,1108,1247,139
2017,6,8,13,1200,1191,1274,83
2017,6,8,14,1355,1278,1400,122
2017,6,8,15,1385,1322,1438,116
2017,6,8,16,1400,1377,1444,67
2017,6,8,17,1415,1384,1820,436
2017,6,8,18,1425,1423,1808,385
2017,6,8,19,1440,1467,2082,615
2017,6,8,20,1445,1478,2023,545
2017,6,8,21,1470,1512,1765,253
2017,6,8,22,1475,1528,1644,116
2017,6,8,23,1475,1541,1624,83
2017,6,9,0,1465,1529,1582,53
2017,6,9,1,1440,1397,1633,236
2017,6,9,2,1415,1453,1591,138
2017,6,9,3,1395,1434,1596,162
2017,6,9,4,1380,1410,1513,103
2017,6,9,5,1340,1350,1495,145
2017,6,9,6,1230,1222,1368,146
2017,6,9,7,1095,1141,1383,242
2017,6,9,8,1065,1114,1445,331
2017,6,9,9,1040,1077,1339,262
2017,6,9,10,1035,1061,1336,275
2017,6,9,11,1045,1073,1330,257
2017,6,9,12,1065,1096,1361,265
2017,6,9,13,1160,1166,1406,240
2017,6,9,14,1260,1272,1397,125
2017,6,9,15,1295,1340,1439,99
2017,6,9,16,1330,1375,1635,260
2017,6,9,17,1355,1381,1534,153
2017,6,9,18,1375,1393,1681,288
2017,6,9,19,1390,1403,1600,197
2017,6,9,20,1405,1399,1612,213
2017,6,9,21,1415,1399,1644,245
2017,6,9,22,1440,1391,1590,199
2017,6,9,23,1435,1371,1390,19
2017,6,10,0,1425,1348,1408,60
2017,6,10,1,1410,1308,1386,78
2017,6,10,2,1380,1266,1353,87
2017,6,10,3,1345,1228,1352,124
2017,6,10,4,1320,1220,1316,96
2017,6,10,5,1265,1188,1342,154
2017,6,10,6,1175,1127,1334,207
2017,6,10,7,1100,1096,1394,298
2017,6,10,8,1050,1069,1341,272
2017,6,10,9,1030,1038,1255,217
2017,6,10,10,1025,1043,1280,237
2017,6,10,11,1025,1044,1356,312
2017,6,10,12,1015,1045,1338,293
2017,6,10,13,1020,1054,1270,216
2017,6,10,14,1080,1113,1319,206
2017,6,10,15,1145,1177,1394,217
2017,6,10,16,1205,1227,1388,161
2017,6,10,17,1220,1222,1412,190
2017,6,10,18,1235,1227,1417,190
2017,6,10,19,1260,1226,1442,216
2017,6,10,20,1285,1223,1451,228
2017,6,10,21,1295,1221,1455,234
2017,6,10,22,1320,1212,1426,214
2017,6,10,23,1315,1237,1458,221
2017,6,11,0,1365,1220,1474,254
2017,6,11,1,1355,1223,1403,180
2017,6,11,2,1345,1220,1433,213
2017,6,11,3,1320,1203,1342,139
2017,6,11,4,1305,1198,1431,233
2017,6,11,5,1260,1183,1509,326
2017,6,11,6,1170,1111,1597,486
2017,6,11,7,1085,1068,1537,469
2017,6,11,8,1045,1034,1394,360
2017,6,11,9,1035,1037,1345,308
2017,6,11,10,1025,1049,1354,305
2017,6,11,11,1030,1053,1351,298
2017,6,11,12,1020,1054,1415,361
2017,6,11,13,1010,1065,1398,333
2017,6,11,14,1070,1091,1389,298
2017,6,11,15,1130,1126,1347,221
2017,6,11,16,1205,1147,1395,248
2017,6,11,17,1225,1149,1452,303
2017,6,11,18,1255,1165,1449,284
2017,6,11,19,1275,1167,1427,260
2017,6,11,20,1305,1175,1414,239
2017,6,11,21,1320,1170,1395,225
2017,6,11,22,1335,1185,1315,130
2017,6,11,23,1335,1188,1277,89
2017,6,12,0,1375,1211,1332,121
2017,6,12,1,1360,1215,1516,301
2017,6,12,2,1330,1214,1899,685
2017,6,12,3,1310,1212,1925,713
2017,6,12,4,1290,1213,1918,705
2017,6,12,5,1240,1184,1910,726
2017,6,12,6,1140,1110,1700,590
2017,6,12,7,1090,1046,1560,514
2017,6,12,8,1055,1027,1287,260
2017,6,12,9,1025,1004,1269,265
2017,6,12,10,1020,1006,1256,250
2017,6,12,11,1035,1016,1243,227
2017,6,12,12,1075,1054,1279,225
2017,6,12,13,1150,1133,1274,141
2017,6,12,14,1230,1191,1262,71
2017,6,12,15,1270,1233,1311,78
2017,6,12,16,1300,1268,1500,232
2017,6,12,17,1310,1288,1428,140
2017,6,12,18,1325,1299,1314,15
2017,6,12,19,1335,1305,1307,2
2017,6,12,20,1355,1317,1285,-32
2017,6,12,21,1365,1327,1330,3
2017,6,12,22,1375,1341,1422,81
2017,6,12,23,1380,1354,1439,85
2017,6,13,0,1365,1358,1464,106
2017,6,13,1,1320,1362,1472,110
2017,6,13,2,1320,1322,1467,145
2017,6,13,3,1305,1279,1409,130
2017,6,13,4,1290,1233,1435,202
2017,6,13,5,1230,1179,1376,197
2017,6,13,6,1125,1106,1348,242
2017,6,13,7,1040,1043,1246,203
2017,6,13,8,1010,1025,1316,291
2017,6,13,9,1000,1026,1271,245
2017,6,13,10,1000,1011,1273,262
2017,6,13,11,1010,1032,1222,190
2017,6,13,12,1045,1068,1222,154
2017,6,13,13,1080,1139,1221,82
2017,6,13,14,1105,1219,1287,68
2017,6,13,15,1130,1256,1304,48
2017,6,13,16,1150,1277,1262,-15
2017,6,13,17,1155,1291,1237,-54
2017,6,13,18,1160,1288,1288,0
2017,6,13,19,1170,1273,1262,-11
2017,6,13,20,1185,1278,1263,-15
2017,6,13,21,1180,1274,1325,51
2017,6,13,22,1190,1260,1309,49
2017,6,13,23,1200,1265,1377,112
2017,6,14,0,1195,1248,1408,160
2017,6,14,1,1185,1244,1386,142
2017,6,14,2,1180,1234,1373,139
2017,6,14,3,1165,1239,1393,154
2017,6,14,4,1155,1226,1413,187
2017,6,14,5,1105,1178,1421,243
2017,6,14,6,1030,1096,1336,240
2017,6,14,7,1045,1042,1308,266
2017,6,14,8,1015,1028,1293,265
2017,6,14,9,1005,1018,1308,290
2017,6,14,10,1000,1018,1298,280
2017,6,14,11,1020,1039,1314,275
2017,6,14,12,1065,1093,1360,267
2017,6,14,13,1125,1157,1429,272
2017,6,14,14,1195,1228,1431,203
2017,6,14,15,1240,1255,1691,436
2017,6,14,16,1250,1285,1776,491
2017,6,14,17,1305,1280,1730,450
2017,6,14,18,1295,1289,1649,360
2017,6,14,19,1300,1272,1622,350
2017,6,14,20,1305,1264,1710,446
2017,6,14,21,1310,1287,1787,500
2017,6,14,22,1310,1282,1762,480
2017,6,14,23,1320,1280,1852,572
2017,6,15,0,1320,1268,1880,612
2017,6,15,1,1300,1269,1848,579
2017,6,15,2,1290,1243,1772,529
2017,6,15,3,1260,1246,1758,512
2017,6,15,4,1235,1250,1804,554
2017,6,15,5,1185,1215,1958,743
2017,6,15,6,1095,1118,1888,770
2017,6,15,7,1050,1066,1742,676
2017,6,15,8,1025,1045,1489,444
2017,6,15,9,1015,1033,1364,331
2017,6,15,10,1010,1016,1384,368
2017,6,15,11,1025,1013,1408,395
2017,6,15,12,1050,1065,1409,344
2017,6,15,13,1120,1129,1410,281
2017,6,15,14,1245,1202,1470,268
2017,6,15,15,1290,1238,1780,542
2017,6,15,16,1310,1256,1937,681
2017,6,15,17,1310,1281,1978,697
2017,6,15,18,1335,1285,1989,704
2017,6,15,19,1355,1285,1909,624
2017,6,15,20,1370,1310,2050,740
2017,6,15,21,1370,1311,2067,756
2017,6,15,22,1365,1281,1940,659
2017,6,15,23,1370,1282,2050,768
2017,6,16,0,1335,1295,2193,898
2017,6,16,1,1325,1271,2087,816
2017,6,16,2,1290,1246,2067,821
2017,6,16,3,1265,1238,1952,714
2017,6,16,4,1250,1241,1701,460
2017,6,16,5,1215,1184,1487,303
2017,6,16,6,1125,1147,1394,247
2017,6,16,7,1070,1091,1202,111
2017,6,16,8,1050,1072,1044,-28
2017,6,16,9,1020,1073,1032,-41
2017,6,16,10,1015,1055,1046,-9
2017,6,16,11,1025,1071,1084,13
2017,6,16,12,1060,1096,1073,-23
2017,6,16,13,1140,1160,1034,-126
2017,6,16,14,1245,1228,997,-231
2017,6,16,15,1285,1273,1040,-233
2017,6,16,16,1315,1268,952,-316
2017,6,16,17,1320,1292,1070,-222
2017,6,16,18,1325,1282,1103,-179
2017,6,16,19,1335,1275,1112,-163
2017,6,16,20,1335,1285,1107,-178
2017,6,16,21,1340,1293,1118,-175
2017,6,16,22,1335,1289,1108,-181
2017,6,16,23,1330,1280,1085,-195
2017,6,17,0,1310,1257,1075,-182
2017,6,17,1,1295,1230,1093,-137
2017,6,17,2,1260,1192,1003,-189
2017,6,17,3,1245,1180,1014,-166
2017,6,17,4,1235,1196,1072,-124
2017,6,17,5,1195,1155,1060,-95
2017,6,17,6,1120,1103,1087,-16
2017,6,17,7,1080,1054,1123,69
2017,6,17,8,1045,1031,1062,31
2017,6,17,9,1015,1005,1090,85
2017,6,17,10,1015,993,1155,162
2017,6,17,11,1020,1001,1113,112
2017,6,17,12,1020,983,1073,90
2017,6,17,13,1060,1002,1010,8
2017,6,17,14,1155,1053,1048,-5
2017,6,17,15,1220,1093,995,-98
2017,6,17,16,1285,1165,1185,20
2017,6,17,17,1285,1158,1145,-13
2017,6,17,18,1290,1165,1156,-9
2017,6,17,19,1300,1162,1128,-34
2017,6,17,20,1290,1150,1159,9
2017,6,17,21,1285,1144,1000,-144
2017,6,17,22,1290,1155,995,-160
2017,6,17,23,1295,1158,981,-177
2017,6,18,0,1285,1159,968,-191
2017,6,18,1,1285,1159,971,-188
2017,6,18,2,1285,1148,988,-160
2017,6,18,3,1270,1141,945,-196
2017,6,18,4,1255,1154,1027,-127
2017,6,18,5,1235,1127,1056,-71
2017,6,18,6,1160,1060,1061,1
2017,6,18,7,1050,1009,1034,25
2017,6,18,8,1015,980,980,0
2017,6,18,9,1010,952,965,13
2017,6,18,10,1015,966,989,23
2017,6,18,11,1025,966,1051,85
2017,6,18,12,1020,981,1113,132
2017,6,18,13,1040,985,1104,119
2017,6,18,14,1120,1026,1006,-20
2017,6,18,15,1165,1082,1031,-51
2017,6,18,16,1220,1121,1141,20
2017,6,18,17,1220,1135,1171,36
2017,6,18,18,1240,1148,1190,42
2017,6,18,19,1240,1151,1186,35
2017,6,18,20,1255,1159,1156,-3
2017,6,18,21,1260,1152,1190,38
2017,6,18,22,1275,1163,1178,15
2017,6,18,23,1270,1198,1178,-20
2017,6,19,0,1320,1214,1178,-36
2017,6,19,1,1315,1209,1176,-33
2017,6,19,2,1310,1202,1208,6
2017,6,19,3,1295,1221,1354,133
2017,6,19,4,1290,1201,1300,99
2017,6,19,5,1250,1182,1375,193
2017,6,19,6,1165,1099,1293,194
2017,6,19,7,1080,1046,1246,200
2017,6,19,8,1055,1010,1067,57
2017,6,19,9,1015,997,1047,50
2017,6,19,10,1015,1002,1080,78
2017,6,19,11,1025,996,1190,194
2017,6,19,12,1050,1014,1251,237
2017,6,19,13,1090,1097,1238,141
2017,6,19,14,1155,1181,1404,223
2017,6,19,15,1205,1251,1592,341
2017,6,19,16,1260,1274,1750,476
2017,6,19,17,1295,1300,1805,505
2017,6,19,18,1305,1329,1873,544
2017,6,19,19,1330,1338,2042,704
2017,6,19,20,1335,1380,2061,681
2017,6,19,21,1340,1380,2103,723
2017,6,19,22,1350,1414,2099,685
2017,6,19,23,1355,1447,2175,728
2017,6,20,0,1350,1437,2168,731
2017,6,20,1,1340,1421,2118,697
2017,6,20,2,1320,1429,2175,746
2017,6,20,3,1285,1400,2172,772
2017,6,20,4,1255,1363,2017,654
2017,6,20,5,1195,1289,1710,421
2017,6,20,6,1130,1175,1608,433
2017,6,20,7,1050,1114,1461,347
2017,6,20,8,1010,1073,1324,251
2017,6,20,9,1000,1051,1300,249
2017,6,20,10,1000,1041,1297,256
2017,6,20,11,1005,1051,1284,233
2017,6,20,12,1040,1069,1279,210
2017,6,20,13,1145,1141,1283,142
2017,6,20,14,1230,1233,1298,65
2017,6,20,15,1280,1285,1320,35
2017,6,20,16,1305,1326,1338,12
2017,6,20,17,1325,1361,1560,199
2017,6,20,18,1330,1386,1844,458
2017,6,20,19,1350,1438,1937,499
2017,6,20,20,1360,1479,1921,442
2017,6,20,21,1375,1500,2006,506
2017,6,20,22,1395,1548,2049,501
2017,6,20,23,1415,1578,2075,497
2017,6,21,0,1420,1577,2064,487
2017,6,21,1,1405,1558,2029,471
2017,6,21,2,1390,1526,1964,438
2017,6,21,3,1370,1484,1856,372
2017,6,21,4,1360,1437,1635,198
2017,6,21,5,1290,1360,1715,355
2017,6,21,6,1165,1259,1873,614
2017,6,21,7,1080,1182,1568,386
2017,6,21,8,1045,1131,1424,293
2017,6,21,9,1025,1103,1423,320
2017,6,21,10,1025,1090,1457,367
2017,6,21,11,1040,1074,1469,395
2017,6,21,12,1065,1068,1462,394
2017,6,21,13,1155,1144,1468,324
2017,6,21,14,1240,1234,1598,364
2017,6,21,15,1280,1300,1664,364
2017,6,21,16,1315,1329,1853,524
2017,6,21,17,1335,1364,1893,529
2017,6,21,18,1355,1403,2084,681
2017,6,21,19,1370,1424,2140,716
2017,6,21,20,1395,1452,1904,452
2017,6,21,21,1420,1440,1791,351
2017,6,21,22,1450,1485,1738,253
2017,6,21,23,1465,1491,1701,210
2017,6,22,0,1455,1473,1715,242
2017,6,22,1,1455,1460,1644,184
2017,6,22,2,1435,1443,1627,184
2017,6,22,3,1410,1409,1561,152
2017,6,22,4,1370,1373,1589,216
2017,6,22,5,1315,1315,1740,425
2017,6,22,6,1205,1204,1668,464
2017,6,22,7,1095,1135,1455,320
2017,6,22,8,1055,1081,1341,260
2017,6,22,9,1035,1050,1318,268
2017,6,22,10,1030,1035,1377,342
2017,6,22,11,1040,1037,1319,282
2017,6,22,12,1065,1069,1349,280
2017,6,22,13,1130,1141,1399,258
2017,6,22,14,1195,1210,1531,321
2017,6,22,15,1235,1263,1748,485
2017,6,22,16,1275,1303,1758,455
2017,6,22,17,1290,1333,1853,520
2017,6,22,18,1305,1349,1869,520
2017,6,22,19,1335,1334,1880,546
2017,6,22,20,1345,1366,2079,713
2017,6,22,21,1375,1352,2101,749
2017,6,22,22,1400,1364,2119,755
2017,6,22,23,1415,1355,2070,715
2017,6,23,0,1425,1333,2054,721
2017,6,23,1,1365,1306,2077,771
2017,6,23,2,1375,1274,2039,765
2017,6,23,3,1350,1257,2061,804
2017,6,23,4,1330,1243,1994,751
2017,6,23,5,1270,1211,1873,662
2017,6,23,6,1145,1110,1692,582
2017,6,23,7,1085,1056,1628,572
2017,6,23,8,1060,1030,1445,415
2017,6,23,9,1030,998,1309,311
2017,6,23,10,1025,992,1315,323
2017,6,23,11,1030,1007,1338,331
2017,6,23,12,1050,1023,1381,358
2017,6,23,13,1125,1091,1519,428
2017,6,23,14,1220,1178,1662,484
2017,6,23,15,1260,1219,1738,519
2017,6,23,16,1290,1267,1847,580
2017,6,23,17,1305,1274,1832,558
2017,6,23,18,1315,1281,1898,617
2017,6,23,19,1335,1281,1975,694
2017,6,23,20,1345,1295,1975,680
2017,6,23,21,1340,1286,1961,675
2017,6,23,22,1350,1308,1956,648
2017,6,23,23,1345,1307,1968,661
2017,6,24,0,1325,1302,1963,661
2017,6,24,1,1315,1272,2033,761
2017,6,24,2,1285,1252,2081,829
2017,6,24,3,1265,1236,2078,842
2017,6,24,4,1245,1234,2011,777
2017,6,24,5,1200,1201,1956,755
2017,6,24,6,1120,1116,1884,768
2017,6,24,7,1065,1058,1813,755
2017,6,24,8,1040,1035,1560,525
2017,6,24,9,1010,1028,1452,424
2017,6,24,10,1005,1025,1345,320
2017,6,24,11,1010,1024,1304,280
2017,6,24,12,1000,1028,1315,287
2017,6,24,13,1065,1046,1286,240
2017,6,24,14,1175,1102,1381,279
2017,6,24,15,1230,1160,1388,228
2017,6,24,16,1300,1215,1408,193
2017,6,24,17,1295,1240,1640,400
2017,6,24,18,1300,1265,1806,541
2017,6,24,19,1295,1251,1766,515
2017,6,24,20,1285,1262,1780,518
2017,6,24,21,1285,1280,1846,566
2017,6,24,22,1285,1303,2053,750
2017,6,24,23,1300,1320,2121,801
2017,6,25,0,1290,1338,2218,880
2017,6,25,1,1290,1322,2207,885
2017,6,25,2,1285,1308,2176,868
2017,6,25,3,1270,1268,2107,839
2017,6,25,4,1260,1248,2053,805
2017,6,25,5,1255,1208,2010,802
2017,6,25,6,1175,1134,1939,805
2017,6,25,7,1070,1087,1795,708
2017,6,25,8,1035,1047,1541,494
2017,6,25,9,1015,1022,1369,347
2017,6,25,10,1015,1011,1299,288
2017,6,25,11,1010,1012,1301,289
2017,6,25,12,1020,1007,1298,291
2017,6,25,13,1040,1033,1311,278
2017,6,25,14,1100,1074,1287,213
2017,6,25,15,1165,1142,1289,147
2017,6,25,16,1220,1194,1429,235
2017,6,25,17,1245,1230,1481,251
2017,6,25,18,1275,1260,1509,249
2017,6,25,19,1290,1287,1656,369
2017,6,25,20,1315,1317,1723,406
2017,6,25,21,1320,1332,1876,544
2017,6,25,22,1335,1366,1959,593
2017,6,25,23,1360,1406,2042,636
2017,6,26,0,1375,1440,2050,610
2017,6,26,1,1360,1457,2013,556
2017,6,26,2,1335,1434,2041,607
2017,6,26,3,1335,1429,2062,633
2017,6,26,4,1315,1391,1997,606
2017,6,26,5,1270,1393,2023,630
2017,6,26,6,1175,1238,1958,720
2017,6,26,7,1135,1163,1873,710
2017,6,26,8,1090,1114,1819,705
2017,6,26,9,1070,1081,1653,572
2017,6,26,10,1060,1067,1466,399
2017,6,26,11,1055,1076,1432,356
2017,6,26,12,1060,1100,1442,342
2017,6,26,13,1145,1174,1513,339
2017,6,26,14,1240,1271,1643,372
2017,6,26,15,1305,1334,1778,444
2017,6,26,16,1335,1392,1927,535
2017,6,26,17,1360,1431,2017,586
2017,6,26,18,1395,1479,2007,528
2017,6,26,19,1410,1521,2037,516
2017,6,26,20,1450,1575,2019,444
2017,6,26,21,1440,1613,2081,468
2017,6,26,22,1485,1647,2046,399
2017,6,26,23,1500,1673,2109,436
2017,6,27,0,1490,1671,2107,436
2017,6,27,1,1475,1668,2117,449
2017,6,27,2,1470,1610,1912,302
2017,6,27,3,1435,1584,1733,149
2017,6,27,4,1395,1518,1729,211
2017,6,27,5,1335,1436,1718,282
2017,6,27,6,1215,1315,1536,221
2017,6,27,7,1085,1225,1518,293
2017,6,27,8,1040,1189,1584,395
2017,6,27,9,1025,1170,1477,307
2017,6,27,10,1020,1167,1739,572
2017,6,27,11,1030,1172,1776,604
2017,6,27,12,1045,1211,1788,577
2017,6,27,13,1120,1235,1786,551
2017,6,27,14,1200,1313,1677,364
2017,6,27,15,1250,1352,1640,288
2017,6,27,16,1285,1379,1644,265
2017,6,27,17,1315,1393,1688,295
2017,6,27,18,1330,1391,1734,343
2017,6,27,19,1360,1408,1892,484
2017,6,27,20,1375,1442,2222,780
2017,6,27,21,1400,1463,2421,958
2017,6,27,22,1430,1488,2561,1073
2017,6,27,23,1460,1483,2521,1038
2017,6,28,0,1480,1463,2601,1138
2017,6,28,1,1465,1445,2558,1113
2017,6,28,2,1445,1443,2589,1146
2017,6,28,3,1420,1428,2634,1206
2017,6,28,4,1380,1393,2506,1113
2017,6,28,5,1340,1340,2418,1078
2017,6,28,6,1205,1227,2481,1254
2017,6,28,7,1100,1145,2215,1070
2017,6,28,8,1065,1109,2151,1042
2017,6,28,9,1040,1082,1932,850
2017,6,28,10,1035,1063,1729,666
2017,6,28,11,1035,1066,1694,628
2017,6,28,12,1060,1091,1715,624
2017,6,28,13,1180,1150,1793,643
2017,6,28,14,1315,1225,1675,450
2017,6,28,15,1365,1275,1605,330
2017,6,28,16,1395,1308,1741,433
2017,6,28,17,1410,1352,1993,641
2017,6,28,18,1440,1407,2278,871
2017,6,28,19,1450,1410,2104,694
2017,6,28,20,1465,1420,1972,552
2017,6,28,21,1470,1370,1931,561
2017,6,28,22,1495,1409,1899,490
2017,6,28,23,1500,1396,2016,620
2017,6,29,0,1485,1371,1879,508
2017,6,29,1,1480,1368,1968,600
2017,6,29,2,1455,1318,2082,764
2017,6,29,3,1440,1315,1827,512
2017,6,29,4,1405,1321,1860,539
2017,6,29,5,1360,1261,1830,569
2017,6,29,6,1245,1177,1991,814
2017,6,29,7,1075,1110,1936,826
2017,6,29,8,1050,1079,1693,614
2017,6,29,9,1040,1062,1819,757
2017,6,29,10,1025,1055,1773,718
2017,6,29,11,1025,1070,1787,717
2017,6,29,12,1075,1090,1839,749
2017,6,29,13,1130,1157,1995,838
2017,6,29,14,1245,1233,1900,667
2017,6,29,15,1275,1267,2020,753
2017,6,29,16,1295,1291,2009,718
2017,6,29,17,1310,1295,2002,707
2017,6,29,18,1325,1325,2215,890
2017,6,29,19,1340,1336,2308,972
2017,6,29,20,1360,1361,2433,1072
2017,6,29,21,1375,1357,2405,1048
2017,6,29,22,1365,1364,2479,1115
2017,6,29,23,1360,1363,2534,1171
2017,6,30,0,1340,1346,2622,1276
2017,6,30,1,1315,1333,2628,1295
2017,6,30,2,1290,1315,2650,1335
2017,6,30,3,1275,1305,2618,1313
2017,6,30,4,1265,1304,2596,1292
2017,6,30,5,1220,1258,2600,1342
2017,6,30,6,1155,1166,2412,1246
2017,6,30,7,1085,1111,2430,1319
2017,6,30,8,1060,1075,2449,1374
2017,6,30,9,1035,1056,2321,1265
2017,6,30,10,1035,1046,2234,1188
2017,6,30,11,1045,1059,2214,1155
2017,6,30,12,1075,1085,2303,1218
2017,6,30,13,1175,1144,2225,1081
2017,6,30,14,1290,1202,2004,802
2017,6,30,15,1315,1269,2249,980
2017,6,30,16,1350,1321,2533,1212
2017,6,30,17,1375,1339,2613,1274
2017,6,30,18,1385,1405,2664,1259
2017,6,30,19,1400,1433,2736,1303
2017,6,30,20,1415,1460,2773,1313
2017,6,30,21,1400,1460,2612,1152
2017,6,30,22,1420,1442,2638,1196
2017,6,30,23,1420,1433,2796,1363
2017,7,1,0,1400,1432,2832,1400
2017,7,1,1,1400,1437,2827,1390
2017,7,1,2,1370,1436,2798,1362
2017,7,1,3,1365,1405,2874,1469
2017,7,1,4,1350,1388,2848,1460
2017,7,1,5,1305,1328,2713,1385
2017,7,1,6,1210,1224,2585,1361
2017,7,1,7,1090,1158,2214,1056
2017,7,1,8,1055,1130,1943,813
2017,7,1,9,1030,1103,1904,801
2017,7,1,10,1015,1078,1877,799
2017,7,1,11,1020,1081,1866,785
2017,7,1,12,1010,1075,1858,783
2017,7,1,13,1085,1096,1862,766
2017,7,1,14,1185,1157,1823,666
2017,7,1,15,1245,1233,1827,594
2017,7,1,16,1310,1276,1844,568
2017,7,1,17,1330,1321,1844,523
2017,7,1,18,1350,1349,1910,561
2017,7,1,19,1365,1386,2049,663
2017,7,1,20,1375,1411,2113,702
2017,7,1,21,1380,1445,2082,637
2017,7,1,22,1405,1487,2075,588
2017,7,1,23,1435,1521,2072,551
2017,7,2,0,1455,1532,2104,572
2017,7,2,1,1465,1530,2106,576
2017,7,2,2,1445,1507,2056,549
2017,7,2,3,1440,1442,2115,673
2017,7,2,4,1420,1399,2055,656
2017,7,2,5,1410,1361,2313,952
2017,7,2,6,1280,1257,2317,1060
2017,7,2,7,1080,1192,2350,1158
2017,7,2,8,1045,1138,2000,862
2017,7,2,9,1015,1132,1945,813
2017,7,2,10,1015,1092,1857,765
2017,7,2,11,1015,1073,1782,709
2017,7,2,12,1020,1048,1821,773
2017,7,2,13,1085,1074,1813,739
2017,7,2,14,1175,1127,1785,658
2017,7,2,15,1245,1193,1639,446
2017,7,2,16,1295,1264,1933,669
2017,7,2,17,1325,1325,2145,820
2017,7,2,18,1350,1365,2174,809
2017,7,2,19,1370,1417,2361,944
2017,7,2,20,1390,1466,2606,1140
2017,7,2,21,1395,1495,2688,1193
2017,7,2,22,1420,1527,2715,1188
2017,7,2,23,1460,1543,2683,1140
2017,7,3,0,1490,1558,2733,1175
2017,7,3,1,1500,1533,2743,1210
2017,7,3,2,1480,1509,2723,1214
2017,7,3,3,1485,1487,2741,1254
2017,7,3,4,1450,1428,2584,1156
2017,7,3,5,1445,1372,2596,1224
2017,7,3,6,1305,1270,2470,1200
2017,7,3,7,1155,1181,2154,973
2017,7,3,8,1115,1122,1889,767
2017,7,3,9,1090,1093,1708,615
2017,7,3,10,1080,1073,1563,490
2017,7,3,11,1090,1086,1692,606
2017,7,3,12,1115,1094,1724,630
2017,7,3,13,1225,1154,1832,678
2017,7,3,14,1345,1254,1902,648
2017,7,3,15,1410,1370,1868,498
2017,7,3,16,1450,1432,2080,648
2017,7,3,17,1480,1485,2019,534
2017,7,3,18,1515,1540,2029,489
2017,7,3,19,1545,1591,2167,576
2017,7,3,20,1590,1618,2135,517
2017,7,3,21,1610,1647,2169,522
2017,7,3,22,1640,1666,2159,493
2017,7,3,23,1660,1686,2159,473
2017,7,4,0,1655,1681,2161,480
2017,7,4,1,1645,1666,2182,516
2017,7,4,2,1615,1655,2118,463
2017,7,4,3,1590,1610,2156,546
2017,7,4,4,1525,1552,2145,593
2017,7,4,5,1465,1488,2122,634
2017,7,4,6,1345,1378,1867,489
2017,7,4,7,1125,1288,1857,569
2017,7,4,8,1080,1240,1916,676
2017,7,4,9,1040,1189,1839,650
2017,7,4,10,1025,1162,1897,735
2017,7,4,11,1025,1139,1997,858
2017,7,4,12,1010,1110,1955,845
2017,7,4,13,1040,1111,1930,819
2017,7,4,14,1120,1168,1953,785
2017,7,4,15,1185,1251,1944,693
2017,7,4,16,1270,1330,2016,686
2017,7,4,17,1330,1375,2083,708
2017,7,4,18,1350,1410,2243,833
2017,7,4,19,1395,1454,2350,896
2017,7,4,20,1410,1500,2450,950
2017,7,4,21,1420,1533,2555,1022
2017,7,4,22,1445,1565,2551,986
2017,7,4,23,1450,1595,2568,973
2017,7,5,0,1445,1600,2640,1040
2017,7,5,1,1430,1594,2722,1128
2017,7,5,2,1425,1584,2344,760
2017,7,5,3,1395,1531,2064,533
2017,7,5,4,1345,1486,2073,587
2017,7,5,5,1295,1399,1977,578
2017,7,5,6,1215,1322,1900,578
2017,7,5,7,1165,1251,1849,598
2017,7,5,8,1120,1199,1903,704
2017,7,5,9,1090,1140,2086,946
2017,7,5,10,1075,1121,1995,874
2017,7,5,11,1085,1124,2146,1022
2017,7,5,12,1110,1150,2298,1148
2017,7,5,13,1200,1228,2542,1314
2017,7,5,14,1315,1329,2582,1253
2017,7,5,15,1375,1408,2657,1249
2017,7,5,16,1430,1480,2622,1142
2017,7,5,17,1470,1532,2637,1105
2017,7,5,18,1515,1599,2720,1121
2017,7,5,19,1555,1651,2742,1091
2017,7,5,20,1605,1714,2822,1108
2017,7,5,21,1620,1764,2828,1064
2017,7,5,22,1660,1810,2866,1056
2017,7,5,23,1675,1818,2857,1039
2017,7,6,0,1670,1763,2750,987
2017,7,6,1,1665,1749,2815,1066
2017,7,6,2,1610,1721,2821,1100
2017,7,6,3,1590,1655,2773,1118
2017,7,6,4,1525,1602,2761,1159
2017,7,6,5,1455,1522,2756,1234
2017,7,6,6,1335,1385,2628,1243
2017,7,6,7,1195,1268,2600,1332
2017,7,6,8,1145,1176,2579,1403
2017,7,6,9,1115,1131,2626,1495
2017,7,6,10,1100,1108,2663,1555
2017,7,6,11,1105,1106,2582,1476
2017,7,6,12,1125,1127,2462,1335
2017,7,6,13,1230,1188,2514,1326
2017,7,6,14,1370,1301,2763,1462
2017,7,6,15,1430,1367,2592,1225
2017,7,6,16,1455,1446,2714,1268
2017,7,6,17,1495,1527,2878,1351
2017,7,6,18,1525,1583,2868,1285
2017,7,6,19,1560,1624,2857,1233
2017,7,6,20,1605,1689,2883,1194
2017,7,6,21,1635,1718,2875,1157
2017,7,6,22,1660,1742,2886,1144
2017,7,6,23,1680,1755,2831,1076
2017,7,7,0,1665,1688,2877,1189
2017,7,7,1,1645,1650,2798,1148
2017,7,7,2,1635,1625,2818,1193
2017,7,7,3,1600,1588,2877,1289
2017,7,7,4,1550,1541,2904,1363
2017,7,7,5,1495,1465,2870,1405
2017,7,7,6,1375,1322,2684,1362
2017,7,7,7,1185,1224,2619,1395
2017,7,7,8,1145,1166,2618,1452
2017,7,7,9,1110,1121,2613,1492
2017,7,7,10,1100,1113,2647,1534
2017,7,7,11,1120,1108,2645,1537
2017,7,7,12,1145,1133,2671,1538
2017,7,7,13,1305,1201,2697,1496
2017,7,7,14,1490,1300,2781,1481
2017,7,7,15,1555,1381,2798,1417
2017,7,7,16,1610,1443,2849,1406
2017,7,7,17,1630,1500,2839,1339
2017,7,7,18,1680,1570,2814,1244
2017,7,7,19,1700,1621,2803,1182
2017,7,7,20,1730,1672,2744,1072
2017,7,7,21,1735,1698,2740,1042
2017,7,7,22,1740,1717,2740,1023
2017,7,7,23,1730,1717,2559,842
2017,7,8,0,1720,1718,2472,754
2017,7,8,1,1705,1689,2463,774
2017,7,8,2,1685,1636,2417,781
2017,7,8,3,1655,1594,2449,855
2017,7,8,4,1630,1549,2447,898
2017,7,8,5,1580,1486,2387,901
2017,7,8,6,1460,1365,2411,1046
2017,7,8,7,1140,1269,2459,1190
2017,7,8,8,1110,1197,2367,1170
2017,7,8,9,1090,1161,2356,1195
2017,7,8,10,1075,1134,2358,1224
2017,7,8,11,1080,1126,2373,1247
2017,7,8,12,1075,1124,2386,1262
2017,7,8,13,1160,1166,2473,1307
2017,7,8,14,1285,1212,2411,1199
2017,7,8,15,1365,1292,2436,1144
2017,7,8,16,1415,1374,2443,1069
2017,7,8,17,1460,1442,2542,1100
2017,7,8,18,1490,1498,2546,1048
2017,7,8,19,1505,1546,2516,970
2017,7,8,20,1525,1595,2539,944
2017,7,8,21,1555,1637,2524,887
2017,7,8,22,1595,1675,2508,833
2017,7,8,23,1625,1698,2544,846
2017,7,9,0,1640,1714,2552,838
2017,7,9,1,1630,1706,2521,815
2017,7,9,2,1610,1653,2530,877
2017,7,9,3,1545,1601,2534,933
2017,7,9,4,1500,1562,2530,968
2017,7,9,5,1460,1501,2547,1046
2017,7,9,6,1350,1369,2426,1057
2017,7,9,7,1190,1278,2455,1177
2017,7,9,8,1145,1208,2350,1142
2017,7,9,9,1130,1167,2315,1148
2017,7,9,10,1105,1146,2268,1122
2017,7,9,11,1090,1124,2275,1151
2017,7,9,12,1075,1115,2293,1178
2017,7,9,13,1120,1136,2297,1161
2017,7,9,14,1190,1191,2286,1095
2017,7,9,15,1265,1285,2367,1082
2017,7,9,16,1330,1375,2396,1021
2017,7,9,17,1380,1456,2508,1052
2017,7,9,18,1420,1520,2506,986
2017,7,9,19,1460,1576,2503,927
2017,7,9,20,1500,1607,2485,878
2017,7,9,21,1525,1632,2479,847
2017,7,9,22,1555,1652,2493,841
2017,7,9,23,1585,1662,2508,846
2017,7,10,0,1610,1644,2513,869
2017,7,10,1,1605,1613,2492,879
2017,7,10,2,1580,1589,2557,968
2017,7,10,3,1560,1540,2522,982
2017,7,10,4,1510,1500,2378,878
2017,7,10,5,1470,1438,2458,1020
2017,7,10,6,1340,1291,2414,1123
2017,7,10,7,1185,1193,2375,1182
2017,7,10,8,1130,1144,2200,1056
2017,7,10,9,1100,1122,2202,1080
2017,7,10,10,1080,1138,2243,1105
2017,7,10,11,1090,1152,2287,1135
2017,7,10,12,1105,1176,2242,1066
2017,7,10,13,1155,1237,2145,908
2017,7,10,14,1250,1343,2280,937
2017,7,10,15,1340,1420,2629,1209
2017,7,10,16,1400,1481,2665,1184
2017,7,10,17,1455,1523,2675,1152
2017,7,10,18,1505,1578,2696,1118
2017,7,10,19,1550,1617,2792,1175
2017,7,10,20,1595,1643,2808,1165
2017,7,10,21,1625,1660,2858,1198
2017,7,10,22,1650,1668,2832,1164
2017,7,10,23,1670,1635,2774,1139
2017,7,11,0,1655,1608,2747,1139
2017,7,11,1,1640,1575,2711,1136
2017,7,11,2,1610,1516,2713,1197
2017,7,11,3,1575,1474,2640,1166
2017,7,11,4,1525,1446,2677,1231
2017,7,11,5,1445,1362,2582,1220
2017,7,11,6,1325,1267,2497,1230
2017,7,11,7,1135,1173,2346,1173
2017,7,11,8,1095,1115,2032,917
2017,7,11,9,1070,1088,1942,854
2017,7,11,10,1090,1079,1985,906
2017,7,11,11,1090,1080,1954,874
2017,7,11,12,1125,1107,1949,842
2017,7,11,13,1180,1188,2134,946
2017,7,11,14,1275,1272,2242,970
2017,7,11,15,1325,1352,2472,1120
2017,7,11,16,1360,1403,2560,1157
2017,7,11,17,1390,1462,2706,1244
2017,7,11,18,1405,1494,2723,1229
2017,7,11,19,1445,1514,2740,1226
2017,7,11,20,1480,1570,2785,1215
2017,7,11,21,1500,1594,2785,1191
2017,7,11,22,1540,1628,2797,1169
2017,7,11,23,1560,1611,2779,1168
2017,7,12,0,1550,1583,2781,1198
2017,7,12,1,1530,1564,2812,1248
2017,7,12,2,1510,1541,2771,1230
2017,7,12,3,1480,1503,2821,1318
2017,7,12,4,1440,1467,2813,1346
2017,7,12,5,1360,1392,2804,1412
2017,7,12,6,1255,1263,2583,1320
2017,7,12,7,1145,1185,2410,1225
2017,7,12,8,1095,1132,2344,1212
2017,7,12,9,1070,1108,2310,1202
2017,7,12,10,1075,1095,2272,1177
2017,7,12,11,1070,1107,2257,1150
2017,7,12,12,1085,1130,2307,1177
2017,7,12,13,1210,1212,2367,1155
2017,7,12,14,1370,1305,2477,1172
2017,7,12,15,1440,1362,2598,1236
2017,7,12,16,1480,1397,2615,1218
2017,7,12,17,1515,1446,2626,1180
2017,7,12,18,1555,1486,2623,1137
2017,7,12,19,1580,1523,2637,1114
2017,7,12,20,1615,1552,2648,1096
2017,7,12,21,1620,1595,2713,1118
2017,7,12,22,1645,1640,2692,1052
2017,7,12,23,1635,1684,2726,1042
2017,7,13,0,1610,1672,2707,1035
2017,7,13,1,1590,1661,2696,1035
2017,7,13,2,1555,1641,2678,1037
2017,7,13,3,1520,1606,2693,1087
2017,7,13,4,1480,1572,2732,1160
2017,7,13,5,1415,1479,2717,1238
2017,7,13,6,1300,1343,2581,1238
2017,7,13,7,1245,1263,2417,1154
2017,7,13,8,1155,1191,2389,1198
2017,7,13,9,1110,1170,2380,1210
2017,7,13,10,1090,1127,2349,1222
2017,7,13,11,1090,1137,2313,1176
2017,7,13,12,1115,1159,2307,1148
2017,7,13,13,1180,1224,2391,1167
2017,7,13,14,1285,1347,2595,1248
2017,7,13,15,1360,1417,2471,1054
2017,7,13,16,1430,1473,2613,1140
2017,7,13,17,1505,1535,2638,1103
2017,7,13,18,1560,1593,2640,1047
2017,7,13,19,1600,1649,2623,974
2017,7,13,20,1665,1701,2619,918
2017,7,13,21,1700,1750,2624,874
2017,7,13,22,1715,1810,2634,824
2017,7,13,23,1730,1830,2639,809
2017,7,14,0,1665,1833,2634,801
2017,7,14,1,1625,1791,2620,829
2017,7,14,2,1600,1777,2619,842
2017,7,14,3,1565,1721,2627,906
2017,7,14,4,1515,1679,2645,966
2017,7,14,5,1435,1589,2643,1054
2017,7,14,6,1300,1449,2522,1073
2017,7,14,7,1195,1350,2377,1027
2017,7,14,8,1140,1275,2429,1154
2017,7,14,9,1100,1230,2486,1256
2017,7,14,10,1085,1211,2487,1276
2017,7,14,11,1080,1188,2464,1276
2017,7,14,12,1105,1217,2513,1296
2017,7,14,13,1160,1279,2516,1237
2017,7,14,14,1280,1379,2659,1280
2017,7,14,15,1355,1474,2665,1191
2017,7,14,16,1415,1532,2636,1104
2017,7,14,17,1475,1606,2630,1024
2017,7,14,18,1545,1663,2653,990
2017,7,14,19,1595,1704,2624,920
2017,7,14,20,1645,1744,2590,846
2017,7,14,21,1670,1768,2602,834
2017,7,14,22,1695,1790,2588,798
2017,7,14,23,1705,1814,2560,746
2017,7,15,0,1705,1782,2613,831
2017,7,15,1,1675,1742,2594,852
2017,7,15,2,1625,1696,2566,870
2017,7,15,3,1585,1646,2529,883
2017,7,15,4,1550,1610,2537,927
2017,7,15,5,1470,1545,2571,1026
2017,7,15,6,1350,1417,2501,1084
2017,7,15,7,1230,1340,2422,1082
2017,7,15,8,1155,1257,2425,1168
2017,7,15,9,1125,1227,2412,1185
2017,7,15,10,1090,1203,2334,1131
2017,7,15,11,1090,1189,2356,1167
2017,7,15,12,1090,1185,2326,1141
2017,7,15,13,1140,1191,2161,970
2017,7,15,14,1205,1252,2220,968
2017,7,15,15,1285,1344,2270,926
2017,7,15,16,1365,1419,2507,1088
2017,7,15,17,1430,1498,2526,1028
2017,7,15,18,1485,1548,2533,985
2017,7,15,19,1535,1611,2551,940
2017,7,15,20,1590,1649,2550,901
2017,7,15,21,1625,1679,2550,871
2017,7,15,22,1675,1696,2557,861
2017,7,15,23,1695,1694,2581,887
2017,7,16,0,1710,1663,2674,1011
2017,7,16,1,1690,1596,2534,938
2017,7,16,2,1645,1553,2313,760
2017,7,16,3,1595,1508,1892,384
2017,7,16,4,1555,1489,1934,445
2017,7,16,5,1480,1418,2000,582
2017,7,16,6,1355,1305,2038,733
2017,7,16,7,1230,1258,2095,837
2017,7,16,8,1165,1198,1965,767
2017,7,16,9,1130,1162,1928,766
2017,7,16,10,1100,1153,1958,805
2017,7,16,11,1090,1146,1971,825
2017,7,16,12,1085,1163,1964,801
2017,7,16,13,1100,1168,1998,830
2017,7,16,14,1160,1220,2132,912
2017,7,16,15,1245,1296,2206,910
2017,7,16,16,1325,1400,2498,1098
2017,7,16,17,1405,1481,2601,1120
2017,7,16,18,1465,1530,2609,1079
2017,7,16,19,1520,1561,2605,1044
2017,7,16,20,1550,1620,2622,1002
2017,7,16,21,1580,1648,2739,1091
2017,7,16,22,1610,1634,2718,1084
2017,7,16,23,1620,1646,2703,1057
2017,7,17,0,1605,1653,2712,1059
2017,7,17,1,1575,1637,2711,1074
2017,7,17,2,1550,1615,2699,1084
2017,7,17,3,1500,1569,2724,1155
2017,7,17,4,1565,1535,2667,1132
2017,7,17,5,1395,1434,2636,1202
2017,7,17,6,1250,1316,2543,1227
2017,7,17,7,1140,1232,2409,1177
2017,7,17,8,1095,1182,2401,1219
2017,7,17,9,1070,1141,2388,1247
2017,7,17,10,1075,1137,2380,1243
2017,7,17,11,1085,1135,2363,1228
2017,7,17,12,1115,1163,2392,1229
2017,7,17,13,1190,1230,2377,1147
2017,7,17,14,1310,1326,2506,1180
2017,7,17,15,1380,1384,2529,1145
2017,7,17,16,1440,1450,2590,1140
2017,7,17,17,1485,1465,2567,1102
2017,7,17,18,1545,1523,2587,1064
2017,7,17,19,1580,1547,2587,1040
2017,7,17,20,1615,1566,2600,1034
2017,7,17,21,1635,1596,2629,1033
2017,7,17,22,1650,1618,2625,1007
2017,7,17,23,1630,1643,2627,984
2017,7,18,0,1605,1640,2650,1010
2017,7,18,1,1575,1622,2632,1010
2017,7,18,2,1525,1572,2610,1038
2017,7,18,3,1480,1537,2614,1077
2017,7,18,4,1450,1504,2649,1145
2017,7,18,5,1365,1419,2617,1198
2017,7,18,6,1255,1311,2532,1221
2017,7,18,7,1195,1226,2520,1294
2017,7,18,8,1145,1202,2588,1386
2017,7,18,9,1110,1173,2502,1329
2017,7,18,10,1090,1154,2500,1346
2017,7,18,11,1080,1161,2536,1375
2017,7,18,12,1080,1193,2502,1309
2017,7,18,13,1135,1243,2495,1252
2017,7,18,14,1225,1342,2577,1235
2017,7,18,15,1305,1399,2517,1118
2017,7,18,16,1375,1444,2331,887
2017,7,18,17,1435,1483,2312,829
2017,7,18,18,1470,1532,2302,770
2017,7,18,19,1500,1544,2323,779
2017,7,18,20,1550,1596,2381,785
2017,7,18,21,1580,1627,2399,772
2017,7,18,22,1605,1670,2399,729
2017,7,18,23,1610,1700,2405,705
2017,7,19,0,1605,1707,2403,696
2017,7,19,1,1590,1703,2401,698
2017,7,19,2,1575,1667,2399,732
2017,7,19,3,1530,1617,2336,719
2017,7,19,4,1500,1586,2320,734
2017,7,19,5,1405,1487,2312,825
2017,7,19,6,1295,1354,2281,927
2017,7,19,7,1180,1264,2312,1048
2017,7,19,8,1150,1230,2355,1125
2017,7,19,9,1130,1206,2390,1184
2017,7,19,10,1110,1180,2399,1219
2017,7,19,11,1115,1190,2331,1141
2017,7,19,12,1130,1213,2387,1174
2017,7,19,13,1180,1278,2403,1125
2017,7,19,14,1295,1365,2364,999
2017,7,19,15,1360,1431,2329,898
2017,7,19,16,1410,1482,2363,881
2017,7,19,17,1450,1547,2368,821
2017,7,19,18,1500,1611,2379,768
2017,7,19,19,1535,1653,2361,708
2017,7,19,20,1565,1695,2412,717
2017,7,19,21,1605,1732,2430,698
2017,7,19,22,1645,1756,2392,636
2017,7,19,23,1675,1784,2363,579
2017,7,20,0,1665,1780,2363,583
2017,7,20,1,1650,1782,2375,593
2017,7,20,2,1620,1752,2321,569
2017,7,20,3,1580,1690,2342,652
2017,7,20,4,1550,1640,2349,709
2017,7,20,5,1450,1534,2356,822
2017,7,20,6,1325,1393,2350,957
2017,7,20,7,1215,1308,2376,1068
2017,7,20,8,1145,1242,2191,949
2017,7,20,9,1115,1211,2167,956
2017,7,20,10,1085,1182,2153,971
2017,7,20,11,1090,1192,2134,942
2017,7,20,12,1115,1220,2323,1103
2017,7,20,13,1185,1284,2307,1023
2017,7,20,14,1300,1380,2316,936
2017,7,20,15,1370,1465,2308,843
2017,7,20,16,1430,1528,2316,788
2017,7,20,17,1495,1565,2321,756
2017,7,20,18,1550,1616,2340,724
2017,7,20,19,1595,1649,2362,713
2017,7,20,20,1650,1686,2376,690
2017,7,20,21,1690,1734,2390,656
2017,7,20,22,1730,1788,2432,644
2017,7,20,23,1750,1806,2449,643
2017,7,21,0,1725,1769,2414,645
2017,7,21,1,1690,1737,2430,693
2017,7,21,2,1665,1679,2396,717
2017,7,21,3,1620,1638,2449,811
2017,7,21,4,1575,1607,2462,855
2017,7,21,5,1485,1503,2471,968
2017,7,21,6,1350,1404,2508,1104
2017,7,21,7,1220,1319,2493,1174
2017,7,21,8,1165,1270,2338,1068
2017,7,21,9,1125,1208,2308,1100
2017,7,21,10,1110,1203,2329,1126
2017,7,21,11,1100,1177,2318,1141
2017,7,21,12,1125,1203,2409,1206
2017,7,21,13,1180,1247,2447,1200
2017,7,21,14,1275,1337,2510,1173
2017,7,21,15,1350,1416,2543,1127
2017,7,21,16,1410,1465,2673,1208
2017,7,21,17,1475,1537,2735,1198
2017,7,21,18,1535,1545,2735,1190
2017,7,21,19,1580,1573,2752,1179
2017,7,21,20,1625,1618,2776,1158
2017,7,21,21,1650,1648,2800,1152
2017,7,21,22,1675,1677,2805,1128
2017,7,21,23,1690,1703,2792,1089
2017,7,22,0,1675,1703,2798,1095
2017,7,22,1,1650,1664,2788,1124
2017,7,22,2,1605,1629,2740,1111
2017,7,22,3,1560,1558,2692,1134
2017,7,22,4,1520,1527,2715,1188
2017,7,22,5,1445,1445,2733,1288
2017,7,22,6,1320,1330,2620,1290
2017,7,22,7,1190,1248,2583,1335
2017,7,22,8,1140,1202,2604,1402
2017,7,22,9,1110,1166,2543,1377
2017,7,22,10,1090,1155,2536,1381
2017,7,22,11,1085,1142,2452,1310
2017,7,22,12,1085,1144,2457,1313
2017,7,22,13,1100,1153,2466,1313
2017,7,22,14,1150,1205,2498,1293
2017,7,22,15,1235,1264,2559,1295
2017,7,22,16,1285,1324,2564,1240
2017,7,22,17,1340,1366,2570,1204
2017,7,22,18,1380,1397,2537,1140
2017,7,22,19,1420,1416,2563,1147
2017,7,22,20,1450,1456,2614,1158
2017,7,22,21,1485,1486,2636,1150
2017,7,22,22,1520,1538,2685,1147
2017,7,22,23,1535,1573,2665,1092
2017,7,23,0,1520,1603,2706,1103
2017,7,23,1,1490,1607,2711,1104
2017,7,23,2,1455,1612,2742,1130
2017,7,23,3,1410,1561,2717,1156
2017,7,23,4,1390,1528,2720,1192
2017,7,23,5,1315,1460,2704,1244
2017,7,23,6,1210,1336,2601,1265
2017,7,23,7,1230,1261,2592,1331
2017,7,23,8,1170,1211,2521,1310
2017,7,23,9,1130,1169,2558,1389
2017,7,23,10,1115,1153,2526,1373
2017,7,23,11,1100,1143,2554,1411
2017,7,23,12,1105,1139,2545,1406
2017,7,23,13,1125,1141,2499,1358
2017,7,23,14,1190,1197,2533,1336
2017,7,23,15,1275,1258,2570,1312
2017,7,23,16,1365,1304,2560,1256
2017,7,23,17,1450,1376,2593,1217
2017,7,23,18,1505,1423,2588,1165
2017,7,23,19,1550,1489,2605,1116
2017,7,23,20,1595,1534,2607,1073
2017,7,23,21,1620,1596,2650,1054
2017,7,23,22,1625,1643,2648,1005
2017,7,23,23,1635,1689,2690,1001
2017,7,24,0,1625,1725,2702,977
2017,7,24,1,1605,1749,2711,962
2017,7,24,2,1580,1750,2782,1032
2017,7,24,3,1530,1686,2717,1031
2017,7,24,4,1500,1655,2739,1084
2017,7,24,5,1415,1529,2641,1112
2017,7,24,6,1280,1388,2565,1177
2017,7,24,7,1185,1295,2557,1262
2017,7,24,8,1130,1245,2532,1287
2017,7,24,9,1105,1223,2592,1369
2017,7,24,10,1100,1199,2602,1403
2017,7,24,11,1110,1205,2597,1392
2017,7,24,12,1130,1202,2601,1399
2017,7,24,13,1200,1258,2574,1316
2017,7,24,14,1305,1350,2617,1267
2017,7,24,15,1400,1429,2672,1243
2017,7,24,16,1460,1483,2647,1164
2017,7,24,17,1505,1549,2668,1119
2017,7,24,18,1565,1617,2655,1038
2017,7,24,19,1605,1661,2648,987
2017,7,24,20,1635,1698,2602,904
2017,7,24,21,1660,1732,2630,898
2017,7,24,22,1680,1756,2630,874
2017,7,24,23,1680,1786,2652,866
2017,7,25,0,1660,1802,2652,850
2017,7,25,1,1635,1769,2632,863
2017,7,25,2,1595,1728,2685,957
2017,7,25,3,1550,1676,2636,960
2017,7,25,4,1520,1638,2642,1004
2017,7,25,5,1430,1510,2650,1140
2017,7,25,6,1325,1383,2612,1229
2017,7,25,7,1195,1287,2481,1194
2017,7,25,8,1155,1231,2507,1276
2017,7,25,9,1130,1188,2506,1318
2017,7,25,10,1110,1171,2524,1353
2017,7,25,11,1115,1176,2506,1330
2017,7,25,12,1135,1195,2519,1324
2017,7,25,13,1195,1264,2593,1329
2017,7,25,14,1285,1354,2602,1248
2017,7,25,15,1355,1410,2534,1124
2017,7,25,16,1405,1439,2525,1086
2017,7,25,17,1455,1466,2594,1128
2017,7,25,18,1500,1490,2563,1073
2017,7,25,19,1530,1501,2546,1045
2017,7,25,20,1580,1526,2543,1017
2017,7,25,21,1615,1548,2540,992
2017,7,25,22,1655,1564,2561,997
2017,7,25,23,1670,1586,2613,1027
2017,7,26,0,1675,1580,2642,1062
2017,7,26,1,1665,1571,2684,1113
2017,7,26,2,1645,1548,2651,1103
2017,7,26,3,1595,1522,2668,1146
2017,7,26,4,1565,1495,2677,1182
2017,7,26,5,1460,1411,2697,1286
2017,7,26,6,1325,1300,2613,1313
2017,7,26,7,1205,1225,2528,1303
2017,7,26,8,1160,1181,2428,1247
2017,7,26,9,1135,1155,2384,1229
2017,7,26,10,1120,1136,2370,1234
2017,7,26,11,1125,1143,2380,1237
2017,7,26,12,1145,1181,2398,1217
2017,7,26,13,1230,1237,2475,1238
2017,7,26,14,1330,1342,2580,1238
2017,7,26,15,1395,1387,2579,1192
2017,7,26,16,1440,1433,2576,1143
2017,7,26,17,1500,1480,2590,1110
2017,7,26,18,1555,1527,2593,1066
2017,7,26,19,1595,1576,2666,1090
2017,7,26,20,1635,1628,2664,1036
2017,7,26,21,1675,1675,2600,925
2017,7,26,22,1710,1726,2611,885
2017,7,26,23,1740,1734,2642,908
2017,7,27,0,1740,1711,2685,974
2017,7,27,1,1725,1684,2699,1015
2017,7,27,2,1700,1624,2670,1046
2017,7,27,3,1650,1596,2663,1067
2017,7,27,4,1600,1565,2561,996
2017,7,27,5,1500,1464,2544,1080
2017,7,27,6,1360,1342,2582,1240
2017,7,27,7,1290,1263,2408,1145
2017,7,27,8,1230,1226,2402,1176
2017,7,27,9,1195,1191,2336,1145
2017,7,27,10,1165,1184,2332,1148
2017,7,27,11,1175,1191,2343,1152
2017,7,27,12,1200,1226,2365,1139
2017,7,27,13,1260,1281,2397,1116
2017,7,27,14,1360,1373,2455,1082
2017,7,27,15,1435,1425,2437,1012
2017,7,27,16,1485,1487,2425,938
2017,7,27,17,1530,1535,2465,930
2017,7,27,18,1580,1612,2465,853
2017,7,27,19,1615,1656,2493,837
2017,7,27,20,1655,1709,2496,787
2017,7,27,21,1695,1743,2579,836
2017,7,27,22,1745,1780,2585,805
2017,7,27,23,1765,1776,2553,777
2017,7,28,0,1745,1745,2554,809
2017,7,28,1,1715,1702,2557,855
2017,7,28,2,1675,1651,2567,916
2017,7,28,3,1630,1605,2533,928
2017,7,28,4,1600,1574,2516,942
2017,7,28,5,1500,1486,2545,1059
2017,7,28,6,1385,1368,2539,1171
2017,7,28,7,1225,1298,2476,1178
2017,7,28,8,1200,1247,2491,1244
2017,7,28,9,1150,1212,2526,1314
2017,7,28,10,1140,1204,2521,1317
2017,7,28,11,1120,1198,2489,1291
2017,7,28,12,1150,1238,2508,1270
2017,7,28,13,1200,1276,2494,1218
2017,7,28,14,1295,1351,2455,1104
2017,7,28,15,1370,1431,2503,1072
2017,7,28,16,1420,1485,2556,1071
2017,7,28,17,1490,1547,2607,1060
2017,7,28,18,1520,1595,2549,954
2017,7,28,19,1560,1645,2564,919
2017,7,28,20,1600,1678,2576,898
2017,7,28,21,1635,1714,2560,846
2017,7,28,22,1665,1735,2587,852
2017,7,28,23,1685,1747,2565,818
2017,7,29,0,1665,1730,2571,841
2017,7,29,1,1630,1676,2563,887
2017,7,29,2,1585,1620,2561,941
2017,7,29,3,1535,1577,2545,968
2017,7,29,4,1505,1549,2547,998
2017,7,29,5,1425,1467,2531,1064
2017,7,29,6,1305,1354,2540,1186
2017,7,29,7,1260,1284,2524,1240
2017,7,29,8,1195,1244,2527,1283
2017,7,29,9,1160,1206,2493,1287
2017,7,29,10,1135,1181,2471,1290
2017,7,29,11,1125,1169,2470,1301
2017,7,29,12,1120,1179,2469,1290
2017,7,29,13,1150,1183,2450,1267
2017,7,29,14,1225,1246,2399,1153
2017,7,29,15,1300,1316,2433,1117
2017,7,29,16,1360,1382,2477,1095
2017,7,29,17,1440,1450,2495,1045
2017,7,29,18,1485,1481,2491,1010
2017,7,29,19,1555,1532,2528,996
2017,7,29,20,1595,1578,2566,988
2017,7,29,21,1645,1619,2622,1003
2017,7,29,22,1675,1633,2613,980
2017,7,29,23,1700,1663,2611,948
2017,7,30,0,1700,1679,2613,934
2017,7,30,1,1675,1659,2599,940
2017,7,30,2,1660,1637,2577,940
2017,7,30,3,1610,1577,2580,1003
2017,7,30,4,1580,1543,2547,1004
2017,7,30,5,1480,1465,2575,1110
2017,7,30,6,1350,1351,2574,1223
2017,7,30,7,1245,1280,2579,1299
2017,7,30,8,1185,1224,2521,1297
2017,7,30,9,1150,1180,2498,1318
2017,7,30,10,1135,1162,2479,1317
2017,7,30,11,1125,1157,2498,1341
2017,7,30,12,1135,1169,2483,1314
2017,7,30,13,1160,1172,2479,1307
2017,7,30,14,1235,1227,2434,1207
2017,7,30,15,1305,1284,2341,1057
2017,7,30,16,1380,1344,2337,993
2017,7,30,17,1460,1411,2395,984
2017,7,30,18,1510,1470,2466,996
2017,7,30,19,1560,1547,2510,963
2017,7,30,20,1615,1594,2527,933
2017,7,30,21,1665,1648,2540,892
2017,7,30,22,1680,1679,2581,902
2017,7,30,23,1710,1735,2596,861
2017,7,31,0,1730,1762,2602,840
2017,7,31,1,1735,1761,2596,835
2017,7,31,2,1725,1730,2586,856
2017,7,31,3,1665,1668,2568,900
2017,7,31,4,1630,1631,2576,945
2017,7,31,5,1510,1518,2552,1034
2017,7,31,6,1375,1394,2633,1239
2017,7,31,7,1250,1318,2591,1273
2017,7,31,8,1200,1258,2550,1292
2017,7,31,9,1165,1223,2592,1369
2017,7,31,10,1155,1210,2572,1362
2017,7,31,11,1155,1210,2603,1393
2017,7,31,12,1170,1235,2623,1388
2017,7,31,13,1260,1301,2648,1347
2017,7,31,14,1380,1370,2693,1323
2017,7,31,15,1445,1447,2714,1267
2017,7,31,16,1505,1504,2679,1175
2017,7,31,17,1555,1553,2646,1093
2017,7,31,18,1625,1609,2623,1014
2017,7,31,19,1660,1659,2595,936
2017,7,31,20,1695,1709,2630,921
2017,7,31,21,1730,1762,2675,913
2017,7,31,22,1760,1801,2661,860
2017,7,31,23,1780,1831,2696,865
2017,8,1,0,1780,1823,2665,842
2017,8,1,1,1750,1812,2661,849
2017,8,1,2,1700,1777,2650,873
2017,8,1,3,1655,1709,2651,942
2017,8,1,4,1615,1665,2672,1007
2017,8,1,5,1505,1548,2660,1112
2017,8,1,6,1380,1407,2631,1224
2017,8,1,7,1235,1323,2689,1366
2017,8,1,8,1190,1268,2611,1343
2017,8,1,9,1155,1232,2592,1360
2017,8,1,10,1135,1207,2539,1332
2017,8,1,11,1140,1219,2565,1346
2017,8,1,12,1165,1256,2631,1375
2017,8,1,13,1240,1305,2597,1292
2017,8,1,14,1360,1385,2519,1134
2017,8,1,15,1420,1436,2522,1086
2017,8,1,16,1470,1479,2570,1091
2017,8,1,17,1510,1533,2635,1102
2017,8,1,18,1560,1580,2639,1059
2017,8,1,19,1585,1622,2657,1035
2017,8,1,20,1630,1689,2624,935
2017,8,1,21,1665,1729,2683,954
2017,8,1,22,1695,1790,2704,914
2017,8,1,23,1730,1804,2692,888
2017,8,2,0,1740,1797,2703,906
2017,8,2,1,1730,1792,2701,909
2017,8,2,2,1700,1745,2653,908
2017,8,2,3,1650,1693,2653,960
2017,8,2,4,1625,1650,2674,1024
2017,8,2,5,1515,1531,2728,1197
2017,8,2,6,1385,1406,2754,1348
2017,8,2,7,1190,1296,2637,1341
2017,8,2,8,1150,1252,2632,1380
2017,8,2,9,1120,1216,2650,1434
2017,8,2,10,1105,1201,2653,1452
2017,8,2,11,1110,1206,2720,1514
2017,8,2,12,1140,1244,2724,1480
2017,8,2,13,1175,1294,2712,1418
2017,8,2,14,1235,1377,2664,1287
2017,8,2,15,1290,1423,2679,1256
2017,8,2,16,1335,1438,2655,1217
2017,8,2,17,1385,1447,2611,1164
2017,8,2,18,1440,1466,2612,1146
2017,8,2,19,1480,1468,2632,1164
2017,8,2,20,1530,1498,2645,1147
2017,8,2,21,1570,1515,2636,1121
2017,8,2,22,1605,1532,2654,1122
2017,8,2,23,1625,1527,2661,1134
2017,8,3,0,1610,1521,2678,1157
2017,8,3,1,1595,1507,2678,1171
2017,8,3,2,1555,1482,2683,1201
2017,8,3,3,1515,1457,2685,1228
2017,8,3,4,1480,1445,2710,1265
2017,8,3,5,1375,1364,2687,1323
2017,8,3,6,1250,1276,2639,1363
2017,8,3,7,1220,1215,2630,1415
2017,8,3,8,1170,1171,2590,1419
2017,8,3,9,1135,1145,2544,1399
2017,8,3,10,1120,1139,2534,1395
2017,8,3,11,1130,1153,2551,1398
2017,8,3,12,1160,1199,2559,1360
2017,8,3,13,1225,1247,2559,1312
2017,8,3,14,1325,1344,2557,1213
2017,8,3,15,1385,1388,2526,1138
2017,8,3,16,1445,1424,2577,1153
2017,8,3,17,1485,1467,2651,1184
2017,8,3,18,1550,1488,2652,1164
2017,8,3,19,1590,1521,2665,1144
2017,8,3,20,1635,1529,2667,1138
2017,8,3,21,1675,1573,2692,1119
2017,8,3,22,1725,1594,2690,1096
2017,8,3,23,1730,1619,2665,1046
2017,8,4,0,1705,1622,2668,1046
2017,8,4,1,1670,1633,2701,1068
2017,8,4,2,1620,1600,2699,1099
2017,8,4,3,1575,1555,2649,1094
2017,8,4,4,1545,1531,2593,1062
2017,8,4,5,1440,1440,2582,1142
2017,8,4,6,1330,1332,2505,1173
2017,8,4,7,1230,1241,2463,1222
2017,8,4,8,1180,1189,2437,1248
2017,8,4,9,1130,1164,2445,1281
2017,8,4,10,1120,1153,2440,1287
2017,8,4,11,1110,1158,2450,1292
2017,8,4,12,1145,1174,2467,1293
2017,8,4,13,1225,1256,2475,1219
2017,8,4,14,1345,1328,2560,1232
2017,8,4,15,1425,1396,2553,1157
2017,8,4,16,1460,1425,2545,1120
2017,8,4,17,1520,1459,2588,1129
2017,8,4,18,1545,1497,2613,1116
2017,8,4,19,1580,1521,2633,1112
2017,8,4,20,1615,1587,2720,1133
2017,8,4,21,1645,1603,2643,1040
2017,8,4,22,1670,1641,2635,994
2017,8,4,23,1685,1680,2627,947
2017,8,5,0,1675,1653,2711,1058
2017,8,5,1,1635,1603,2700,1097
2017,8,5,2,1590,1557,2712,1155
2017,8,5,3,1540,1508,2712,1204
2017,8,5,4,1510,1482,2707,1225
2017,8,5,5,1430,1399,2696,1297
2017,8,5,6,1320,1313,2687,1374
2017,8,5,7,1205,1245,2675,1430
2017,8,5,8,1170,1194,2621,1427
2017,8,5,9,1135,1156,2580,1424
2017,8,5,10,1120,1147,2592,1445
2017,8,5,11,1110,1154,2544,1390
2017,8,5,12,1115,1161,2565,1404
2017,8,5,13,1115,1178,2561,1383
2017,8,5,14,1120,1217,2519,1302
2017,8,5,15,1125,1265,2395,1130
2017,8,5,16,1150,1297,2424,1127
2017,8,5,17,1190,1342,2600,1258
2017,8,5,18,1215,1358,2618,1260
2017,8,5,19,1245,1371,2634,1263
2017,8,5,20,1280,1379,2666,1287
2017,8,5,21,1310,1370,2573,1203
2017,8,5,22,1345,1386,2574,1188
2017,8,5,23,1375,1418,2647,1229
2017,8,6,0,1400,1405,2634,1229
2017,8,6,1,1395,1404,2639,1235
2017,8,6,2,1390,1384,2627,1243
2017,8,6,3,1345,1364,2619,1255
2017,8,6,4,1315,1362,2629,1267
2017,8,6,5,1250,1303,2581,1278
2017,8,6,6,1145,1229,2568,1339
2017,8,6,7,1170,1180,2572,1392
2017,8,6,8,1125,1140,2555,1415
2017,8,6,9,1095,1125,2543,1418
2017,8,6,10,1075,1105,2547,1442
2017,8,6,11,1070,1107,2542,1435
2017,8,6,12,1075,1114,2532,1418
2017,8,6,13,990,1131,2525,1394
2017,8,6,14,950,1162,2465,1303
2017,8,6,15,1000,1169,2280,1111
2017,8,6,16,1040,1254,2503,1249
2017,8,6,17,1100,1288,2531,1243
2017,8,6,18,1140,1314,2574,1260
2017,8,6,19,1200,1352,2599,1247
2017,8,6,20,1235,1365,2587,1222
2017,8,6,21,1285,1387,2607,1220
2017,8,6,22,1315,1396,2620,1224
2017,8,6,23,1355,1440,2639,1199
2017,8,7,0,1380,1462,2652,1190
2017,8,7,1,1390,1463,2662,1199
2017,8,7,2,1380,1448,2670,1222
2017,8,7,3,1330,1423,2678,1255
2017,8,7,4,1295,1418,2710,1292
2017,8,7,5,1200,1327,2664,1337
2017,8,7,6,1090,1227,2642,1415
2017,8,7,7,1150,1167,2592,1425
2017,8,7,8,1100,1134,2543,1409
2017,8,7,9,1065,1103,2537,1434
2017,8,7,10,1060,1091,2526,1435
2017,8,7,11,1060,1095,2517,1422
2017,8,7,12,1090,1139,2525,1386
2017,8,7,13,1165,1203,2537,1334
2017,8,7,14,1260,1276,2513,1237
2017,8,7,15,1320,1333,2560,1227
2017,8,7,16,1370,1382,2562,1180
2017,8,7,17,1400,1427,2556,1129
2017,8,7,18,1450,1446,2532,1086
2017,8,7,19,1485,1467,2554,1087
2017,8,7,20,1505,1495,2549,1054
2017,8,7,21,1545,1531,2562,1031
2017,8,7,22,1570,1550,2577,1027
2017,8,7,23,1595,1591,2586,995
2017,8,8,0,1590,1598,2590,992
2017,8,8,1,1585,1585,2565,980
2017,8,8,2,1540,1551,2575,1024
2017,8,8,3,1500,1500,2547,1047
2017,8,8,4,1455,1465,2509,1044
2017,8,8,5,1365,1359,2504,1145
2017,8,8,6,1255,1259,2536,1277
2017,8,8,7,1185,1193,2457,1264
2017,8,8,8,1135,1149,2455,1306
2017,8,8,9,1100,1128,2494,1366
2017,8,8,10,1080,1115,2488,1373
2017,8,8,11,1085,1216,1182,-34
2017,8,8,12,1110,1185,1004,-181
2017,8,8,13,1170,1240,1092,-148
2017,8,8,14,1250,1291,1042,-249
2017,8,8,15,1295,1327,1044,-283
2017,8,8,16,1335,1366,1082,-284
2017,8,8,17,1370,1383,1087,-296
2017,8,8,18,1405,1404,1015,-389
2017,8,8,19,1425,1421,1172,-249
2017,8,8,20,1460,1477,1531,54
2017,8,8,21,1485,1516,1719,203
2017,8,8,22,1510,1558,1862,304
2017,8,8,23,1535,1565,1902,337
2017,8,9,0,1535,1576,1932,356
2017,8,9,1,1530,1553,1997,444
2017,8,9,2,1505,1479,2059,580
2017,8,9,3,1470,1444,2131,687
2017,8,9,4,1440,1435,2223,788
2017,8,9,5,1350,1348,2342,994
2017,8,9,6,1240,1235,2291,1056
2017,8,9,7,1160,1172,2364,1192
2017,8,9,8,1120,1136,2211,1075
2017,8,9,9,1090,1102,2184,1082
2017,8,9,10,1070,1094,2287,1193
2017,8,9,11,1075,1098,2284,1186
2017,8,9,12,1120,1139,2333,1194
2017,8,9,13,1185,1203,2357,1154
2017,8,9,14,1275,1297,2433,1136
2017,8,9,15,1330,1339,2437,1098
2017,8,9,16,1360,1383,2426,1043
2017,8,9,17,1395,1418,2429,1011
2017,8,9,18,1420,1434,2354,920
2017,8,9,19,1430,1457,2445,988
2017,8,9,20,1465,1486,2451,965
2017,8,9,21,1490,1519,2473,954
2017,8,9,22,1515,1545,2470,925
2017,8,9,23,1530,1563,2499,936
2017,8,10,0,1520,1565,2525,960
2017,8,10,1,1510,1523,2531,1008
2017,8,10,2,1470,1483,2556,1073
2017,8,10,3,1445,1462,2618,1156
2017,8,10,4,1420,1440,2632,1192
2017,8,10,5,1335,1344,2638,1294
2017,8,10,6,1235,1240,2554,1314
2017,8,10,7,1135,1176,2481,1305
2017,8,10,8,1095,1131,2556,1425
2017,8,10,9,1070,1121,2595,1474
2017,8,10,10,1050,1091,2571,1480
2017,8,10,11,1085,1106,2577,1471
2017,8,10,12,1115,1147,2594,1447
2017,8,10,13,1195,1203,2569,1366
2017,8,10,14,1310,1266,2541,1275
2017,8,10,15,1355,1308,2542,1234
2017,8,10,16,1405,1353,2552,1199
2017,8,10,17,1435,1397,2594,1197
2017,8,10,18,1460,1410,2616,1206
2017,8,10,19,1485,1433,2624,1191
2017,8,10,20,1515,1482,2638,1156
2017,8,10,21,1555,1511,2638,1127
2017,8,10,22,1585,1551,2628,1077
2017,8,10,23,1600,1569,2631,1062
2017,8,11,0,1600,1562,2622,1060
2017,8,11,1,1585,1532,2609,1077
2017,8,11,2,1550,1498,2624,1126
2017,8,11,3,1505,1472,2635,1163
2017,8,11,4,1480,1442,2651,1209
2017,8,11,5,1380,1356,2649,1293
2017,8,11,6,1265,1254,2514,1260
2017,8,11,7,1175,1185,2481,1296
2017,8,11,8,1125,1148,2400,1252
2017,8,11,9,1090,1137,2398,1261
2017,8,11,10,1080,1123,2408,1285
2017,8,11,11,1075,1129,2414,1285
2017,8,11,12,1100,1162,2449,1287
2017,8,11,13,1190,1228,2521,1293
2017,8,11,14,1290,1298,2461,1163
2017,8,11,15,1355,1333,2452,1119
2017,8,11,16,1390,1365,2452,1087
2017,8,11,17,1440,1400,2470,1070
2017,8,11,18,1460,1415,2467,1052
2017,8,11,19,1485,1445,2480,1035
2017,8,11,20,1540,1488,2507,1019
2017,8,11,21,1565,1520,2550,1030
2017,8,11,22,1595,1549,2580,1031
2017,8,11,23,1625,1565,2615,1050
2017,8,12,0,1615,1549,2625,1076
2017,8,12,1,1570,1530,2628,1098
2017,8,12,2,1525,1481,2617,1136
2017,8,12,3,1475,1456,2571,1115
2017,8,12,4,1450,1415,2506,1091
2017,8,12,5,1360,1333,2497,1164
2017,8,12,6,1265,1249,2536,1287
2017,8,12,7,1170,1187,2488,1301
2017,8,12,8,1120,1103,2495,1392
2017,8,12,9,1080,1129,2505,1376
2017,8,12,10,1065,1102,2493,1391
2017,8,12,11,1065,1103,2471,1368
2017,8,12,12,1070,1105,2414,1309
2017,8,12,13,1135,1125,2470,1345
2017,8,12,14,1235,1146,2370,1224
2017,8,12,15,1290,1206,2335,1129
2017,8,12,16,1345,1257,2351,1094
2017,8,12,17,1385,1295,2455,1160
2017,8,12,18,1410,1328,2472,1144
2017,8,12,19,1430,1372,2490,1118
2017,8,12,20,1455,1392,2487,1095
2017,8,12,21,1470,1432,2486,1054
2017,8,12,22,1510,1467,2495,1028
2017,8,12,23,1545,1495,2492,997
2017,8,13,0,1560,1505,2495,990
2017,8,13,1,1560,1481,2492,1011
2017,8,13,2,1550,1450,2492,1042
2017,8,13,3,1510,1430,2513,1083
2017,8,13,4,1480,1410,2585,1175
2017,8,13,5,1425,1327,2585,1258
2017,8,13,6,1315,1244,2530,1286
2017,8,13,7,1180,1164,2452,1288
2017,8,13,8,1135,1111,2151,1040
2017,8,13,9,1110,1085,2075,990
2017,8,13,10,1090,1079,2176,1097
2017,8,13,11,1085,1074,2116,1042
2017,8,13,12,1090,1087,2266,1179
2017,8,13,13,1120,1093,2392,1299
2017,8,13,14,1190,1121,2226,1105
2017,8,13,15,1225,1181,2324,1143
2017,8,13,16,1295,1227,2464,1237
2017,8,13,17,1340,1275,2469,1194
2017,8,13,18,1365,1309,2470,1161
2017,8,13,19,1395,1335,2459,1124
2017,8,13,20,1425,1352,2464,1112
2017,8,13,21,1450,1358,2460,1102
2017,8,13,22,1485,1376,2460,1084
2017,8,13,23,1525,1409,2492,1083
2017,8,14,0,1555,1428,2467,1039
2017,8,14,1,1560,1408,2515,1107
2017,8,14,2,1555,1354,2442,1088
2017,8,14,3,1510,1353,2452,1099
2017,8,14,4,1480,1341,2570,1229
2017,8,14,5,1410,1278,2584,1306
2017,8,14,6,1295,1202,2432,1230
2017,8,14,7,1175,1160,2424,1264
2017,8,14,8,1135,1115,2087,972
2017,8,14,9,1105,1084,2035,951
2017,8,14,10,1090,1088,2102,1014
2017,8,14,11,1100,1085,2189,1104
2017,8,14,12,1135,1145,2485,1340
2017,8,14,13,1190,1209,2488,1279
2017,8,14,14,1250,1265,2505,1240
2017,8,14,15,1300,1311,2493,1182
2017,8,14,16,1335,1341,2469,1128
2017,8,14,17,1360,1359,2497,1138
2017,8,14,18,1380,1381,2488,1107
2017,8,14,19,1395,1385,2533,1148
2017,8,14,20,1430,1385,2496,1111
2017,8,14,21,1455,1408,2495,1087
2017,8,14,22,1475,1424,2500,1076
2017,8,14,23,1495,1440,2518,1078
2017,8,15,0,1490,1439,2533,1094
2017,8,15,1,1475,1439,2554,1115
2017,8,15,2,1445,1429,2531,1102
2017,8,15,3,1415,1404,2523,1119
2017,8,15,4,1380,1376,2508,1132
2017,8,15,5,1295,1281,2524,1243
2017,8,15,6,1205,1200,2513,1313
2017,8,15,7,1140,1124,2488,1364
2017,8,15,8,1095,1105,2453,1348
2017,8,15,9,1065,1083,2451,1368
2017,8,15,10,1050,1088,2508,1420
2017,8,15,11,1110,1092,2459,1367
2017,8,15,12,1110,1128,2542,1414
2017,8,15,13,1175,1192,2524,1332
2017,8,15,14,1260,1263,2584,1321
2017,8,15,15,1305,1301,2567,1266
2017,8,15,16,1345,1317,2534,1217
2017,8,15,17,1370,1355,2507,1152
2017,8,15,18,1395,1372,2506,1134
2017,8,15,19,1410,1401,2490,1089
2017,8,15,20,1445,1424,2477,1053
2017,8,15,21,1470,1443,2487,1044
2017,8,15,22,1495,1475,2501,1026
2017,8,15,23,1515,1502,2518,1016
2017,8,16,0,1520,1494,2507,1013
2017,8,16,1,1500,1497,2545,1048
2017,8,16,2,1450,1460,2556,1096
2017,8,16,3,1425,1428,2551,1123
2017,8,16,4,1410,1394,2557,1163
2017,8,16,5,1325,1285,2529,1244
2017,8,16,6,1215,1196,2497,1301
2017,8,16,7,1125,1141,2467,1326
2017,8,16,8,1090,1103,2468,1365
2017,8,16,9,1055,1090,2449,1359
2017,8,16,10,1050,1069,2423,1354
2017,8,16,11,1055,1088,2429,1341
2017,8,16,12,1095,1129,2449,1320
2017,8,16,13,1165,1207,2460,1253
2017,8,16,14,1245,1267,2441,1174
2017,8,16,15,1295,1330,2548,1218
2017,8,16,16,1330,1357,2563,1206
2017,8,16,17,1370,1407,2587,1180
2017,8,16,18,1390,1435,2607,1172
2017,8,16,19,1405,1466,2580,1114
2017,8,16,20,1430,1492,2567,1075
2017,8,16,21,1465,1526,2576,1050
2017,8,16,22,1485,1557,2605,1048
2017,8,16,23,1510,1582,2613,1031
2017,8,17,0,1510,1566,2612,1046
2017,8,17,1,1490,1546,2589,1043
2017,8,17,2,1460,1501,2575,1074
2017,8,17,3,1425,1489,2575,1086
2017,8,17,4,1405,1449,2571,1122
2017,8,17,5,1300,1352,2571,1219
2017,8,17,6,1200,1243,2463,1220
2017,8,17,7,1115,1182,2417,1235
2017,8,17,8,1075,1146,2423,1277
2017,8,17,9,1060,1126,2431,1305
2017,8,17,10,1045,1118,2453,1335
2017,8,17,11,1060,1143,2481,1338
2017,8,17,12,1100,1175,2466,1291
2017,8,17,13,1170,1254,2502,1248
2017,8,17,14,1255,1308,2498,1190
2017,8,17,15,1295,1350,2505,1155
2017,8,17,16,1325,1377,2494,1117
2017,8,17,17,1365,1415,2532,1117
2017,8,17,18,1380,1442,2533,1091
2017,8,17,19,1410,1481,2539,1058
2017,8,17,20,1445,1492,2524,1032
2017,8,17,21,1475,1525,2599,1074
2017,8,17,22,1505,1563,2577,1014
2017,8,17,23,1530,1579,2581,1002
2017,8,18,0,1520,1572,2574,1002
2017,8,18,1,1510,1548,2577,1029
2017,8,18,2,1475,1511,2576,1065
2017,8,18,3,1445,1480,2567,1087
2017,8,18,4,1415,1446,2499,1053
2017,8,18,5,1320,1347,2473,1126
2017,8,18,6,1220,1250,2484,1234
2017,8,18,7,1120,1190,2430,1240
2017,8,18,8,1080,1140,2450,1310
2017,8,18,9,1065,1135,2456,1321
2017,8,18,10,1055,1118,2440,1322
2017,8,18,11,1060,1135,2462,1327
2017,8,18,12,1100,1179,2490,1311
2017,8,18,13,1170,1241,2470,1229
2017,8,18,14,1250,1317,2533,1216
2017,8,18,15,1295,1363,2516,1153
2017,8,18,16,1325,1391,2551,1160
2017,8,18,17,1365,1422,2564,1142
2017,8,18,18,1390,1455,2595,1140
2017,8,18,19,1430,1487,2590,1103
2017,8,18,20,1470,1519,2586,1067
2017,8,18,21,1500,1545,2606,1061
2017,8,18,22,1530,1593,2644,1051
2017,8,18,23,1550,1630,2669,1039
2017,8,19,0,1525,1648,2685,1037
2017,8,19,1,1500,1608,2627,1019
2017,8,19,2,1455,1537,2606,1069
2017,8,19,3,1410,1507,2577,1070
2017,8,19,4,1370,1475,2571,1096
2017,8,19,5,1300,1386,2539,1153
2017,8,19,6,1200,1285,2312,1027
2017,8,19,7,1165,1219,2254,1035
2017,8,19,8,1095,1177,2102,925
2017,8,19,9,1095,1134,1936,802
2017,8,19,10,1075,1118,1941,823
2017,8,19,11,1080,1115,1928,813
2017,8,19,12,1085,1135,1973,838
2017,8,19,13,1115,1159,2156,997
2017,8,19,14,1155,1183,2290,1107
2017,8,19,15,1215,1231,2300,1069
2017,8,19,16,1265,1274,2281,1007
2017,8,19,17,1295,1315,2272,957
2017,8,19,18,1325,1344,2280,936
2017,8,19,19,1360,1370,2307,937
2017,8,19,20,1375,1402,2369,967
2017,8,19,21,1400,1394,2380,986
2017,8,19,22,1435,1427,2425,998
2017,8,19,23,1460,1446,2522,1076
2017,8,20,0,1465,1462,2571,1109
2017,8,20,1,1450,1444,2601,1157
2017,8,20,2,1415,1406,2611,1205
2017,8,20,3,1400,1384,2576,1192
2017,8,20,4,1380,1375,2634,1259
2017,8,20,5,1305,1284,2582,1298
2017,8,20,6,1225,1208,2519,1311
2017,8,20,7,1130,1153,2530,1377
2017,8,20,8,1085,1113,2485,1372
2017,8,20,9,1070,1090,2463,1373
2017,8,20,10,1050,1068,2467,1399
2017,8,20,11,1050,1074,2472,1398
2017,8,20,12,1060,1085,2499,1414
2017,8,20,13,1070,1096,2509,1413
2017,8,20,14,1110,1134,2529,1395
2017,8,20,15,1145,1187,2518,1331
2017,8,20,16,1205,1231,2568,1337
2017,8,20,17,1245,1278,2558,1280
2017,8,20,18,1280,1308,2562,1254
2017,8,20,19,1305,1329,2607,1278
2017,8,20,20,1325,1373,2659,1286
2017,8,20,21,1335,1389,2660,1271
2017,8,20,22,1350,1422,2689,1267
2017,8,20,23,1385,1436,2657,1221
2017,8,21,0,1410,1473,2712,1239
2017,8,21,1,1400,1464,2679,1215
2017,8,21,2,1365,1425,2628,1203
2017,8,21,3,1350,1417,2627,1210
2017,8,21,4,1330,1393,2619,1226
2017,8,21,5,1265,1282,2562,1280
2017,8,21,6,1180,1198,2614,1416
2017,8,21,7,1120,1139,2575,1436
2017,8,21,8,1085,1104,2582,1478
2017,8,21,9,1055,1101,2586,1485
2017,8,21,10,1050,1100,2575,1475
2017,8,21,11,1060,1124,2532,1408
2017,8,21,12,1100,1166,2531,1365
2017,8,21,13,1200,1239,2530,1291
2017,8,21,14,1290,1291,2569,1278
2017,8,21,15,1340,1348,2598,1250
2017,8,21,16,1380,1373,2601,1228
2017,8,21,17,1410,1385,2607,1222
2017,8,21,18,1435,1339,2581,1242
2017,8,21,19,1455,1344,2563,1219
2017,8,21,20,1470,1393,2600,1207
2017,8,21,21,1500,1447,2640,1193
2017,8,21,22,1520,1492,2634,1142
2017,8,21,23,1550,1519,2647,1128
2017,8,22,0,1550,1526,2641,1115
2017,8,22,1,1540,1510,2620,1110
2017,8,22,2,1510,1481,2639,1158
2017,8,22,3,1475,1463,2646,1183
2017,8,22,4,1445,1436,2659,1223
2017,8,22,5,1340,1320,2644,1324
2017,8,22,6,1240,1216,2645,1429
2017,8,22,7,1120,1152,2638,1486
2017,8,22,8,1080,1146,2575,1429
2017,8,22,9,1060,1122,2537,1415
2017,8,22,10,1045,1107,2517,1410
2017,8,22,11,1060,1103,2489,1386
2017,8,22,12,1085,1123,2507,1384
2017,8,22,13,1180,1194,2566,1372
2017,8,22,14,1285,1226,2520,1294
2017,8,22,15,1335,1221,2470,1249
2017,8,22,16,1370,1353,2454,1101
2017,8,22,17,1420,1400,2453,1053
2017,8,22,18,1450,1441,2473,1032
2017,8,22,19,1490,1467,2482,1015
2017,8,22,20,1530,1491,2474,983
2017,8,22,21,1565,1548,2552,1004
2017,8,22,22,1605,1592,2531,939
2017,8,22,23,1625,1610,2504,894
2017,8,23,0,1625,1618,2510,892
2017,8,23,1,1610,1606,2502,896
2017,8,23,2,1580,1565,2529,964
2017,8,23,3,1550,1539,2551,1012
2017,8,23,4,1520,1499,2544,1045
2017,8,23,5,1385,1375,2512,1137
2017,8,23,6,1265,1266,2509,1243
2017,8,23,7,1165,1197,2496,1299
2017,8,23,8,1125,1160,2550,1390
2017,8,23,9,1100,1139,2549,1410
2017,8,23,10,1080,1121,2532,1411
2017,8,23,11,1085,1128,2506,1378
2017,8,23,12,1130,1159,2512,1353
2017,8,23,13,1210,1257,2549,1292
2017,8,23,14,1315,1305,2555,1250
2017,8,23,15,1365,1343,2558,1215
2017,8,23,16,1405,1385,2573,1188
2017,8,23,17,1455,1414,2571,1157
2017,8,23,18,1490,1466,2652,1186
2017,8,23,19,1525,1504,2645,1141
2017,8,23,20,1575,1562,2658,1096
2017,8,23,21,1620,1623,2669,1046
2017,8,23,22,1660,1644,2654,1010
2017,8,23,23,1675,1651,2617,966
2017,8,24,0,1655,1655,2633,978
2017,8,24,1,1625,1642,2623,981
2017,8,24,2,1575,1598,2625,1027
2017,8,24,3,1550,1565,2602,1037
2017,8,24,4,1515,1516,2541,1025
2017,8,24,5,1420,1409,2589,1180
2017,8,24,6,1295,1284,2548,1264
2017,8,24,7,1180,1228,2569,1341
2017,8,24,8,1145,1178,2608,1430
2017,8,24,9,1125,1147,2497,1350
2017,8,24,10,1110,1135,2496,1361
2017,8,24,11,1125,1139,2492,1353
2017,8,24,12,1160,1184,2543,1359
2017,8,24,13,1205,1257,2552,1295
2017,8,24,14,1240,1314,2550,1236
2017,8,24,15,1270,1366,2565,1199
2017,8,24,16,1320,1406,2615,1209
2017,8,24,17,1365,1447,2591,1144
2017,8,24,18,1390,1486,2592,1106
2017,8,24,19,1420,1520,2583,1063
2017,8,24,20,1450,1557,2613,1056
2017,8,24,21,1485,1605,2609,1004
2017,8,24,22,1525,1627,2646,1019
2017,8,24,23,1545,1610,2632,1022
2017,8,25,0,1540,1554,2610,1056
2017,8,25,1,1515,1514,2661,1147
2017,8,25,2,1480,1485,2604,1119
2017,8,25,3,1450,1474,2598,1124
2017,8,25,4,1420,1437,2616,1179
2017,8,25,5,1315,1333,2636,1303
2017,8,25,6,1215,1253,2675,1422
2017,8,25,7,1145,1190,2677,1487
2017,8,25,8,1100,1164,2662,1498
2017,8,25,9,1090,1134,2642,1508
2017,8,25,10,1075,1127,2606,1479
2017,8,25,11,1085,1143,2653,1510
2017,8,25,12,1120,1167,2630,1463
2017,8,25,13,1185,1235,2575,1340
2017,8,25,14,1260,1312,2576,1264
2017,8,25,15,1305,1336,2546,1210
2017,8,25,16,1330,1390,2570,1180
2017,8,25,17,1360,1413,2580,1167
2017,8,25,18,1385,1450,2618,1168
2017,8,25,19,1415,1498,2651,1153
2017,8,25,20,1455,1514,2637,1123
2017,8,25,21,1485,1541,2651,1110
2017,8,25,22,1520,1577,2650,1073
2017,8,25,23,1540,1579,2638,1059
2017,8,26,0,1545,1548,2636,1088
2017,8,26,1,1515,1508,2634,1126
2017,8,26,2,1460,1491,2659,1168
2017,8,26,3,1430,1490,2680,1190
2017,8,26,4,1395,1446,2650,1204
2017,8,26,5,1305,1346,2631,1285
2017,8,26,6,1220,1246,2501,1255
2017,8,26,7,1140,1191,2457,1266
2017,8,26,8,1070,1145,2364,1219
2017,8,26,9,1080,1116,2356,1240
2017,8,26,10,1060,1087,2352,1265
2017,8,26,11,1055,1101,2354,1253
2017,8,26,12,1060,1136,2520,1384
2017,8,26,13,1105,1154,2546,1392
2017,8,26,14,1140,1198,2646,1448
2017,8,26,15,1200,1264,2583,1319
2017,8,26,16,1250,1309,2587,1278
2017,8,26,17,1285,1353,2654,1301
2017,8,26,18,1315,1398,2654,1256
2017,8,26,19,1355,1426,2669,1243
2017,8,26,20,1380,1458,2655,1197
2017,8,26,21,1405,1494,2651,1157
2017,8,26,22,1440,1541,2651,1110
2017,8,26,23,1465,1560,2670,1110
2017,8,27,0,1475,1578,2679,1101
2017,8,27,1,1455,1559,2664,1105
2017,8,27,2,1415,1526,2656,1130
2017,8,27,3,1395,1478,2660,1182
2017,8,27,4,1380,1432,2629,1197
2017,8,27,5,1295,1344,2626,1282
2017,8,27,6,1210,1271,2547,1276
2017,8,27,7,1130,1204,2504,1300
2017,8,27,8,1095,1159,2505,1346
2017,8,27,9,1065,1142,2440,1298
2017,8,27,10,1040,1115,2454,1339
2017,8,27,11,1040,1115,2442,1327
2017,8,27,12,1045,1124,2457,1333
2017,8,27,13,1085,1118,2454,1336
2017,8,27,14,1175,1146,2421,1275
2017,8,27,15,1230,1213,2476,1263
2017,8,27,16,1295,1250,2522,1272
2017,8,27,17,1340,1279,2537,1258
2017,8,27,18,1375,1318,2523,1205
2017,8,27,19,1405,1354,2548,1194
2017,8,27,20,1445,1431,2565,1134
2017,8,27,21,1480,1477,2614,1137
2017,8,27,22,1510,1522,2620,1098
2017,8,27,23,1545,1563,2626,1063
2017,8,28,0,1580,1614,2621,1007
2017,8,28,1,1585,1623,2596,973
2017,8,28,2,1550,1577,2411,834
2017,8,28,3,1535,1540,2383,843
2017,8,28,4,1510,1479,2374,895
2017,8,28,5,1410,1351,2382,1031
2017,8,28,6,1285,1256,2457,1201
2017,8,28,7,1190,1200,2452,1252
2017,8,28,8,1145,1148,2442,1294
2017,8,28,9,1115,1124,2438,1314
2017,8,28,10,1095,1115,2427,1312
2017,8,28,11,1105,1122,2446,1324
2017,8,28,12,1140,1175,2488,1313
2017,8,28,13,1235,1252,2511,1259
2017,8,28,14,1305,1326,2608,1282
2017,8,28,15,1360,1373,2605,1232
2017,8,28,16,1395,1390,2637,1247
2017,8,28,17,1445,1416,2667,1251
2017,8,28,18,1490,1478,2676,1198
2017,8,28,19,1530,1505,2666,1161
2017,8,28,20,1585,1565,2674,1109
2017,8,28,21,1645,1596,2659,1063
2017,8,28,22,1680,1641,2668,1027
2017,8,28,23,1690,1694,2677,983
2017,8,29,0,1680,1694,2653,959
2017,8,29,1,1660,1679,2683,1004
2017,8,29,2,1605,1632,2680,1048
2017,8,29,3,1570,1611,2689,1078
2017,8,29,4,1535,1530,2658,1128
2017,8,29,5,1420,1390,2596,1206
2017,8,29,6,1290,1279,2549,1270
2017,8,29,7,1185,1217,2598,1381
2017,8,29,8,1145,1172,2589,1417
2017,8,29,9,1120,1138,2504,1366
2017,8,29,10,1100,1138,2508,1370
2017,8,29,11,1110,1152,2531,1379
2017,8,29,12,1145,1185,2540,1355
2017,8,29,13,1195,1274,2553,1279
2017,8,29,14,1245,1349,2603,1254
2017,8,29,15,1275,1367,2619,1252
2017,8,29,16,1350,1399,2592,1193
2017,8,29,17,1400,1441,2600,1159
2017,8,29,18,1445,1474,2597,1123
2017,8,29,19,1485,1506,2599,1093
2017,8,29,20,1535,1531,2576,1045
2017,8,29,21,1585,1581,2630,1049
2017,8,29,22,1635,1612,2630,1018
2017,8,29,23,1650,1656,2653,997
2017,8,30,0,1645,1648,2608,960
2017,8,30,1,1635,1637,2673,1036
2017,8,30,2,1595,1625,2691,1066
2017,8,30,3,1560,1609,2701,1092
2017,8,30,4,1520,1533,2658,1125
2017,8,30,5,1390,1406,2606,1200
2017,8,30,6,1265,1273,2581,1308
2017,8,30,7,1170,1209,2535,1326
2017,8,30,8,1125,1179,2497,1318
2017,8,30,9,1105,1154,2545,1391
2017,8,30,10,1090,1128,2528,1400
2017,8,30,11,1100,1135,2515,1380
2017,8,30,12,1140,1181,2535,1354
2017,8,30,13,1225,1288,2559,1271
2017,8,30,14,1280,1347,2540,1193
2017,8,30,15,1325,1374,2532,1158
2017,8,30,16,1355,1411,2543,1132
2017,8,30,17,1385,1436,2567,1131
2017,8,30,18,1440,1476,2576,1100
2017,8,30,19,1470,1511,2588,1077
2017,8,30,20,1530,1554,2604,1050
2017,8,30,21,1575,1560,2628,1068
2017,8,30,22,1610,1642,2648,1006
2017,8,30,23,1630,1670,2694,1024
2017,8,31,0,1635,1668,2697,1029
2017,8,31,1,1620,1630,2726,1096
2017,8,31,2,1575,1592,2630,1038
2017,8,31,3,1545,1591,2618,1027
2017,8,31,4,1500,1521,2594,1073
2017,8,31,5,1365,1405,2569,1164
2017,8,31,6,1250,1292,2531,1239
2017,8,31,7,1170,1229,2576,1347
2017,8,31,8,1130,1188,2599,1411
2017,8,31,9,1100,1166,2533,1367
2017,8,31,10,1090,1146,2497,1351
2017,8,31,11,1095,1163,2454,1291
2017,8,31,12,1135,1210,2547,1337
2017,8,31,13,1215,1303,2529,1226
2017,8,31,14,1270,1361,2587,1226
2017,8,31,15,1290,1397,2618,1221
2017,8,31,16,1365,1446,2621,1175
2017,8,31,17,1410,1477,2683,1206
2017,8,31,18,1445,1522,2676,1154
2017,8,31,19,1480,1574,2678,1104
2017,8,31,20,1515,1612,2713,1101
2017,8,31,21,1570,1641,2716,1075
2017,8,31,22,1600,1678,2732,1054
2017,8,31,23,1610,1692,2775,1083
2017,9,1,0,1590,1671,2787,1116
2017,9,1,1,1565,1626,2778,1152
2017,9,1,2,1535,1596,2780,1184
2017,9,1,3,1515,1589,2732,1143
2017,9,1,4,1475,1505,2722,1217
2017,9,1,5,1350,1397,2681,1284
2017,9,1,6,1245,1302,2694,1392
2017,9,1,7,1140,1229,2640,1411
2017,9,1,8,1105,1194,2587,1393
2017,9,1,9,1080,1156,2573,1417
2017,9,1,10,1070,1154,2615,1461
2017,9,1,11,1085,1145,2595,1450
2017,9,1,12,1115,1196,2609,1413
2017,9,1,13,1195,1293,2622,1329
2017,9,1,14,1270,1350,2658,1308
2017,9,1,15,1305,1387,2618,1231
2017,9,1,16,1350,1441,2630,1189
2017,9,1,17,1375,1471,2690,1219
2017,9,1,18,1410,1516,2710,1194
2017,9,1,19,1455,1510,2704,1194
2017,9,1,20,1475,1551,2710,1159
2017,9,1,21,1500,1560,2712,1152
2017,9,1,22,1545,1602,2689,1087
2017,9,1,23,1555,1607,2735,1128
2017,9,2,0,1540,1626,2729,1103
2017,9,2,1,1495,1585,2767,1182
2017,9,2,2,1470,1521,2710,1189
2017,9,2,3,1460,1510,2684,1174
2017,9,2,4,1415,1431,2649,1218
2017,9,2,5,1315,1341,2630,1289
2017,9,2,6,1215,1244,2639,1395
2017,9,2,7,1185,1193,2617,1424
2017,9,2,8,1125,1170,2553,1383
2017,9,2,9,1095,1154,2558,1404
2017,9,2,10,1085,1131,2557,1426
2017,9,2,11,1080,1127,2564,1437
2017,9,2,12,1095,1136,2571,1435
2017,9,2,13,1180,1159,2576,1417
2017,9,2,14,1270,1191,2569,1378
2017,9,2,15,1320,1254,2582,1328
2017,9,2,16,1375,1301,2644,1343
2017,9,2,17,1430,1352,2665,1313
2017,9,2,18,1470,1377,2658,1281
2017,9,2,19,1515,1424,2713,1289
2017,9,2,20,1545,1474,2755,1281
2017,9,2,21,1575,1527,2757,1230
2017,9,2,22,1600,1589,2760,1171
2017,9,2,23,1620,1629,2735,1106
2017,9,3,0,1605,1645,2713,1068
2017,9,3,1,1575,1636,2695,1059
2017,9,3,2,1545,1581,2661,1080
2017,9,3,3,1525,1553,2681,1128
2017,9,3,4,1480,1483,2627,1144
2017,9,3,5,1380,1373,2603,1230
2017,9,3,6,1265,1294,2675,1381
2017,9,3,7,1240,1237,2702,1465
2017,9,3,8,1180,1171,2604,1433
2017,9,3,9,1150,1171,2649,1478
2017,9,3,10,1125,1143,2615,1472
2017,9,3,11,1115,1150,2610,1460
2017,9,3,12,1110,1148,2617,1469
2017,9,3,13,1105,1168,2648,1480
2017,9,3,14,1145,1179,2633,1454
2017,9,3,15,1220,1226,2648,1422
2017,9,3,16,1280,1271,2684,1413
2017,9,3,17,1350,1322,2737,1415
2017,9,3,18,1405,1349,2700,1351
2017,9,3,19,1460,1384,2675,1291
2017,9,3,20,1505,1441,2679,1238
2017,9,3,21,1550,1488,2665,1177
2017,9,3,22,1585,1529,2658,1129
2017,9,3,23,1615,1560,2625,1065
2017,9,4,0,1630,1585,2628,1043
2017,9,4,1,1630,1559,2665,1106
2017,9,4,2,1610,1523,2645,1122
2017,9,4,3,1560,1500,2659,1159
2017,9,4,4,1500,1444,2666,1222
2017,9,4,5,1415,1350,2667,1317
2017,9,4,6,1280,1268,2662,1394
2017,9,4,7,1145,1197,2680,1483
2017,9,4,8,1110,1160,2656,1496
2017,9,4,9,1090,1144,2665,1521
2017,9,4,10,1080,1128,2680,1552
2017,9,4,11,1100,1133,2678,1545
2017,9,4,12,1135,1135,2661,1526
2017,9,4,13,1195,1162,2606,1444
2017,9,4,14,1235,1168,2574,1406
2017,9,4,15,1285,1216,2611,1395
2017,9,4,16,1320,1262,2641,1379
2017,9,4,17,1355,1291,2632,1341
2017,9,4,18,1350,1313,2690,1377
2017,9,4,19,1370,1323,2692,1369
2017,9,4,20,1410,1340,2673,1333
2017,9,4,21,1450,1353,2659,1306
2017,9,4,22,1485,1372,2644,1272
2017,9,4,23,1515,1407,2657,1250
2017,9,5,0,1510,1419,2672,1253
2017,9,5,1,1495,1436,2674,1238
2017,9,5,2,1465,1419,2659,1240
2017,9,5,3,1435,1437,2662,1225
2017,9,5,4,1400,1353,2636,1283
2017,9,5,5,1285,1240,2572,1332
2017,9,5,6,1185,1156,2561,1405
2017,9,5,7,1105,1121,2533,1412
2017,9,5,8,1080,1082,2447,1365
2017,9,5,9,1060,1070,2474,1404
2017,9,5,10,1050,1085,2520,1435
2017,9,5,11,1060,1073,2511,1438
2017,9,5,12,1095,1127,2469,1342
2017,9,5,13,1155,1222,2527,1305
2017,9,5,14,1205,1290,2535,1245
2017,9,5,15,1225,1311,2553,1242
2017,9,5,16,1285,1338,2545,1207
2017,9,5,17,1325,1352,2321,969
2017,9,5,18,1350,1363,2348,985
2017,9,5,19,1385,1370,2371,1001
2017,9,5,20,1415,1394,2380,986
2017,9,5,21,1455,1417,2395,978
2017,9,5,22,1490,1447,2469,1022
2017,9,5,23,1510,1463,2478,1015
2017,9,6,0,1505,1466,2461,995
2017,9,6,1,1495,1444,2428,984
2017,9,6,2,1455,1435,2418,983
2017,9,6,3,1430,1434,2468,1034
2017,9,6,4,1395,1377,2472,1095
2017,9,6,5,1275,1266,2425,1159
2017,9,6,6,1180,1172,2386,1214
2017,9,6,7,1110,1126,2320,1194
2017,9,6,8,1075,1097,2167,1070
2017,9,6,9,1055,1075,2150,1075
2017,9,6,10,1035,1079,2165,1086
2017,9,6,11,1045,1075,2147,1072
2017,9,6,12,1080,1137,2215,1078
2017,9,6,13,1195,1239,2233,994
2017,9,6,14,1255,1292,2193,901
2017,9,6,15,1290,1296,2284,988
2017,9,6,16,1325,1322,2339,1017
2017,9,6,17,1355,1344,2355,1011
2017,9,6,18,1400,1365,2350,985
2017,9,6,19,1435,1382,2370,988
2017,9,6,20,1490,1402,2393,991
2017,9,6,21,1520,1430,2376,946
2017,9,6,22,1570,1454,2379,925
2017,9,6,23,1585,1488,2404,916
2017,9,7,0,1585,1496,2438,942
2017,9,7,1,1565,1480,2437,957
2017,9,7,2,1525,1467,2420,953
2017,9,7,3,1500,1468,2391,923
2017,9,7,4,1485,1388,2375,987
2017,9,7,5,1335,1285,2362,1077
2017,9,7,6,1220,1187,2292,1105
2017,9,7,7,1150,1133,2237,1104
2017,9,7,8,1100,1113,2289,1176
2017,9,7,9,1080,1108,2279,1171
2017,9,7,10,1070,1097,2289,1192
2017,9,7,11,1075,1100,2257,1157
2017,9,7,12,1125,1150,2301,1151
2017,9,7,13,1250,1261,2333,1072
2017,9,7,14,1340,1306,2340,1034
2017,9,7,15,1385,1320,2383,1063
2017,9,7,16,1425,1340,2320,980
2017,9,7,17,1460,1350,2328,978
2017,9,7,18,1495,1394,2342,948
2017,9,7,19,1530,1417,2330,913
2017,9,7,20,1565,1445,2348,903
2017,9,7,21,1605,1477,2352,875
2017,9,7,22,1635,1517,2357,840
2017,9,7,23,1640,1547,2475,928
2017,9,8,0,1610,1538,2458,920
2017,9,8,1,1570,1520,2411,891
2017,9,8,2,1545,1501,2486,985
2017,9,8,3,1535,1502,2470,968
2017,9,8,4,1465,1423,2447,1024
2017,9,8,5,1360,1305,2263,958
2017,9,8,6,1265,1215,2299,1084
2017,9,8,7,1100,1145,2253,1108
2017,9,8,8,1065,1117,2212,1095
2017,9,8,9,1035,1105,2198,1093
2017,9,8,10,1035,1092,2185,1093
2017,9,8,11,1030,1109,2209,1100
2017,9,8,12,1065,1148,2306,1158
2017,9,8,13,1195,1233,2320,1087
2017,9,8,14,1280,1298,2355,1057
2017,9,8,15,1295,1312,2334,1022
2017,9,8,16,1315,1331,2284,953
2017,9,8,17,1345,1350,2294,944
2017,9,8,18,1380,1370,2306,936
2017,9,8,19,1390,1394,2315,921
2017,9,8,20,1430,1426,2343,917
2017,9,8,21,1455,1446,2363,917
2017,9,8,22,1495,1485,2363,878
2017,9,8,23,1510,1499,2383,884
2017,9,9,0,1505,1496,2380,884
2017,9,9,1,1480,1454,2366,912
2017,9,9,2,1455,1443,2360,917
2017,9,9,3,1450,1448,2384,936
2017,9,9,4,1360,1392,2375,983
2017,9,9,5,1250,1304,2235,931
2017,9,9,6,1165,1232,2231,999
2017,9,9,7,1135,1179,2177,998
2017,9,9,8,1105,1136,2114,978
2017,9,9,9,1085,1121,2134,1013
2017,9,9,10,1065,1102,2118,1016
2017,9,9,11,1070,1111,2076,965
2017,9,9,12,1095,1123,2147,1024
2017,9,9,13,1100,1155,2160,1005
2017,9,9,14,1095,1182,2097,915
2017,9,9,15,1145,1241,2124,883
2017,9,9,16,1180,1303,2295,992
2017,9,9,17,1220,1350,2411,1061
2017,9,9,18,1250,1373,2418,1045
2017,9,9,19,1280,1427,2421,994
2017,9,9,20,1315,1460,2453,993
2017,9,9,21,1355,1507,2459,952
2017,9,9,22,1395,1539,2457,918
2017,9,9,23,1425,1560,2446,886
2017,9,10,0,1440,1573,2484,911
2017,9,10,1,1425,1540,2465,925
2017,9,10,2,1395,1513,2478,965
2017,9,10,3,1365,1501,2402,901
2017,9,10,4,1335,1442,2451,1009
2017,9,10,5,1210,1339,2410,1071
2017,9,10,6,1135,1272,2345,1073
2017,9,10,7,1140,1203,2293,1090
2017,9,10,8,1090,1163,2252,1089
2017,9,10,9,1075,1147,2242,1095
2017,9,10,10,1060,1123,2213,1090
2017,9,10,11,1060,1124,2234,1110
2017,9,10,12,1065,1130,2258,1128
2017,9,10,13,1060,1142,2254,1112
2017,9,10,14,1070,1169,2317,1148
2017,9,10,15,1125,1222,2368,1146
2017,9,10,16,1160,1289,2424,1135
2017,9,10,17,1210,1339,2459,1120
2017,9,10,18,1240,1379,2459,1080
2017,9,10,19,1270,1417,2488,1071
2017,9,10,20,1300,1456,2542,1086
2017,9,10,21,1320,1496,2493,997
2017,9,10,22,1345,1527,2516,989
2017,9,10,23,1375,1563,2496,933
2017,9,11,0,1400,1574,2502,928
2017,9,11,1,1380,1557,2489,932
2017,9,11,2,1335,1534,2477,943
2017,9,11,3,1325,1525,2478,953
2017,9,11,4,1295,1437,2474,1037
2017,9,11,5,1220,1328,2315,987
2017,9,11,6,1145,1230,2306,1076
2017,9,11,7,1110,1162,2260,1098
2017,9,11,8,1090,1127,2224,1097
2017,9,11,9,1075,1092,2189,1097
2017,9,11,10,1060,1092,2274,1182
2017,9,11,11,1070,1110,2265,1155
2017,9,11,12,1110,1166,2351,1185
2017,9,11,13,1185,1263,2420,1157
2017,9,11,14,1215,1318,2429,1111
2017,9,11,15,1250,1337,2473,1136
2017,9,11,16,1275,1376,2461,1085
2017,9,11,17,1310,1398,2446,1048
2017,9,11,18,1330,1397,2456,1059
2017,9,11,19,1350,1462,2499,1037
2017,9,11,20,1390,1507,2516,1009
2017,9,11,21,1425,1550,2520,970
2017,9,11,22,1455,1599,2523,924
2017,9,11,23,1475,1631,2556,925
2017,9,12,0,1460,1627,2553,926
2017,9,12,1,1430,1605,2533,928
2017,9,12,2,1405,1566,2595,1029
2017,9,12,3,1400,1548,2570,1022
2017,9,12,4,1340,1462,2482,1020
2017,9,12,5,1225,1339,2381,1042
2017,9,12,6,1135,1243,2328,1085
2017,9,12,7,1115,1150,2281,1131
2017,9,12,8,1080,1126,2329,1203
2017,9,12,9,1055,1100,2291,1191
2017,9,12,10,1050,1077,2247,1170
2017,9,12,11,1055,1093,2235,1142
2017,9,12,12,1095,1148,2300,1152
2017,9,12,13,1190,1234,2345,1111
2017,9,12,14,1260,1294,2414,1120
2017,9,12,15,1270,1323,2469,1146
2017,9,12,16,1340,1355,2417,1062
2017,9,12,17,1375,1391,2470,1079
2017,9,12,18,1405,1418,2507,1089
2017,9,12,19,1435,1422,2458,1036
2017,9,12,20,1460,1479,2378,899
2017,9,12,21,1510,1537,2451,914
2017,9,12,22,1545,1565,2509,944
2017,9,12,23,1575,1584,2560,976
2017,9,13,0,1575,1589,2496,907
2017,9,13,1,1560,1543,2460,917
2017,9,13,2,1540,1513,2432,919
2017,9,13,3,1520,1502,2466,964
2017,9,13,4,1465,1433,2492,1059
2017,9,13,5,1340,1319,2449,1130
2017,9,13,6,1225,1200,2337,1137
2017,9,13,7,1110,1149,2121,972
2017,9,13,8,1080,1122,2020,898
2017,9,13,9,1055,1118,2084,966
2017,9,13,10,1045,1104,2124,1020
2017,9,13,11,1055,1100,2136,1036
2017,9,13,12,1110,1162,2186,1024
2017,9,13,13,1200,1247,2215,968
2017,9,13,14,1245,1337,2415,1078
2017,9,13,15,1260,1323,2436,1113
2017,9,13,16,1295,1348,2408,1060
2017,9,13,17,1315,1354,2413,1059
2017,9,13,18,1325,1379,2411,1032
2017,9,13,19,1365,1414,2471,1057
2017,9,13,20,1400,1459,2516,1057
2017,9,13,21,1420,1491,2486,995
2017,9,13,22,1460,1498,2476,978
2017,9,13,23,1490,1519,2489,970
2017,9,14,0,1495,1499,2503,1004
2017,9,14,1,1475,1462,2478,1016
2017,9,14,2,1445,1437,2477,1040
2017,9,14,3,1435,1433,2483,1050
2017,9,14,4,1395,1339,2388,1049
2017,9,14,5,1255,1238,2379,1141
2017,9,14,6,1165,1146,2340,1194
2017,9,14,7,1070,1102,2285,1183
2017,9,14,8,1050,1071,2100,1029
2017,9,14,9,1045,1055,2113,1058
2017,9,14,10,1035,1042,1974,932
2017,9,14,11,1040,1056,1990,934
2017,9,14,12,1090,1090,2020,930
2017,9,14,13,1165,1215,2233,1018
2017,9,14,14,1195,1289,2320,1031
2017,9,14,15,1200,1297,2321,1024
2017,9,14,16,1215,1310,2387,1077
2017,9,14,17,1235,1324,2403,1079
2017,9,14,18,1250,1330,2419,1089
2017,9,14,19,1255,1329,2353,1024
2017,9,14,20,1270,1326,2320,994
2017,9,14,21,1285,1326,2348,1022
2017,9,14,22,1305,1326,2395,1069
2017,9,14,23,1320,1335,2354,1019
2017,9,15,0,1310,1329,2319,990
2017,9,15,1,1305,1337,2281,944
2017,9,15,2,1300,1353,2371,1018
2017,9,15,3,1290,1345,2363,1018
2017,9,15,4,1250,1284,2390,1106
2017,9,15,5,1145,1207,3306,-289
2017,9,15,6,1055,1140,771,-369
2017,9,15,7,1045,1080,688,-392
2017,9,15,8,1025,1059,648,-411
2017,9,15,9,1010,1052,623,-429
2017,9,15,10,1000,1057,625,-432
2017,9,15,11,1005,1071,640,-431
2017,9,15,12,1050,1113,656,-457
2017,9,15,13,1125,1226,667,-559
2017,9,15,14,1180,1330,697,-633
2017,9,15,15,1180,1376,731,-645
2017,9,15,16,1200,1388,747,-641
2017,9,15,17,1215,1394,744,-650
2017,9,15,18,1235,1396,762,-634
2017,9,15,19,1250,1389,815,-574
2017,9,15,20,1280,1378,896,-482
2017,9,15,21,1300,1342,1042,-300
2017,9,15,22,1320,1331,1324,-7
2017,9,15,23,1330,1342,1522,180
2017,9,16,0,1325,1343,1574,231
2017,9,16,1,1295,1343,1734,391
2017,9,16,2,1270,1357,1634,277
2017,9,16,3,1275,1349,1570,221
2017,9,16,4,1235,1291,1615,324
2017,9,16,5,1120,1237,1682,445
2017,9,16,6,1045,1168,1609,441
2017,9,16,7,1110,1128,1683,555
2017,9,16,8,1060,1106,1700,594
2017,9,16,9,1055,1094,1697,603
2017,9,16,10,1040,1095,1676,581
2017,9,16,11,1050,1088,1686,598
2017,9,16,12,1060,1113,1692,579
2017,9,16,13,1040,1166,1693,527
2017,9,16,14,1010,1209,1795,586
2017,9,16,15,1080,1231,1782,551
2017,9,16,16,1130,1257,1799,542
2017,9,16,17,1165,1232,1763,531
2017,9,16,18,1175,1221,1784,563
2017,9,16,19,1185,1198,1782,584
2017,9,16,20,1185,1176,1779,603
2017,9,16,21,1195,1168,1778,610
2017,9,16,22,1200,1150,1784,634
2017,9,16,23,1200,1146,1798,652
2017,9,17,0,1210,1155,1877,722
2017,9,17,1,1190,1140,1977,837
2017,9,17,2,1200,1163,1956,793
2017,9,17,3,1205,1197,1976,779
2017,9,17,4,1160,1182,2026,844
2017,9,17,5,1105,1122,2078,956
2017,9,17,6,1045,1079,1944,865
2017,9,17,7,1080,1037,1910,873
2017,9,17,8,1055,1022,1943,921
2017,9,17,9,1045,1015,1944,929
2017,9,17,10,1035,1014,1932,918
2017,9,17,11,1035,1020,1932,912
2017,9,17,12,1045,1025,1942,917
2017,9,17,13,1035,1070,2008,938
2017,9,17,14,1025,1100,2119,1019
2017,9,17,15,1075,1133,2141,1008
2017,9,17,16,1120,1160,2128,968
2017,9,17,17,1145,1168,2133,965
2017,9,17,18,1150,1165,2099,934
2017,9,17,19,1170,1168,2094,926
2017,9,17,20,1180,1146,2100,954
2017,9,17,21,1195,1159,2124,965
2017,9,17,22,1195,1160,2160,1000
2017,9,17,23,1215,1172,2193,1021
2017,9,18,0,1215,1184,2150,966
2017,9,18,1,1215,1198,2184,986
2017,9,18,2,1210,1234,2160,926
2017,9,18,3,1235,1253,2138,885
2017,9,18,4,1170,1197,2132,935
2017,9,18,5,1115,1095,2060,965
2017,9,18,6,1035,1035,1993,958
2017,9,18,7,1090,990,1976,986
2017,9,18,8,1060,979,2013,1034
2017,9,18,9,1045,971,2024,1053
2017,9,18,10,1030,986,1996,1010
2017,9,18,11,1045,1018,2060,1042
2017,9,18,12,1060,1068,2055,987
2017,9,18,13,1070,1173,2044,871
2017,9,18,14,1065,1251,2150,899
2017,9,18,15,1115,1243,2142,899
2017,9,18,16,1165,1266,2139,873
2017,9,18,17,1180,1275,2146,871
2017,9,18,18,1195,1281,2197,916
2017,9,18,19,1195,1285,2195,910
2017,9,18,20,1205,1275,2187,912
2017,9,18,21,1205,1270,2196,926
2017,9,18,22,1225,1301,2205,904
2017,9,18,23,1250,1288,2186,898
2017,9,19,0,1260,1309,2207,898
2017,9,19,1,1255,1323,2243,920
2017,9,19,2,1265,1354,2244,890
2017,9,19,3,1275,1320,2361,1041
2017,9,19,4,1195,1269,2381,1112
2017,9,19,5,1075,1179,2360,1181
2017,9,19,6,1055,1115,2222,1107
2017,9,19,7,1005,1088,2141,1053
2017,9,19,8,985,1058,2106,1048
2017,9,19,9,975,1063,2118,1055
2017,9,19,10,970,1065,2163,1098
2017,9,19,11,980,1061,2036,975
2017,9,19,12,1010,1116,2066,950
2017,9,19,13,1110,1229,2155,926
2017,9,19,14,1180,1298,2231,933
2017,9,19,15,1210,1283,2242,959
2017,9,19,16,1230,1291,2257,966
2017,9,19,17,1245,1295,2287,992
2017,9,19,18,1250,1309,2337,1028
2017,9,19,19,1255,1278,2347,1069
2017,9,19,20,1260,1268,2185,917
2017,9,19,21,1285,1256,2249,993
2017,9,19,22,1295,1273,2280,1007
2017,9,19,23,1310,1275,2233,958
2017,9,20,0,1310,1278,2268,990
2017,9,20,1,1305,1288,2264,976
2017,9,20,2,1320,1325,2280,955
2017,9,20,3,1325,1335,2315,980
2017,9,20,4,1275,1270,2321,1051
2017,9,20,5,1160,1185,2309,1124
2017,9,20,6,1075,1110,2168,1058
2017,9,20,7,1065,1066,2140,1074
2017,9,20,8,1050,1052,2163,1111
2017,9,20,9,1040,1045,2178,1133
2017,9,20,10,1050,1033,2235,1202
2017,9,20,11,1070,1053,2279,1226
2017,9,20,12,1130,1110,2292,1182
2017,9,20,13,1205,1223,2281,1058
2017,9,20,14,1250,1300,2315,1015
2017,9,20,15,1245,1279,2289,1010
2017,9,20,16,1270,1294,1782,488
2017,9,20,17,1280,1299,1609,310
2017,9,20,18,1290,1312,1634,322
2017,9,20,19,1300,1292,1685,393
2017,9,20,20,1300,1281,1678,397
2017,9,20,21,1300,1285,1679,394
2017,9,20,22,1325,1281,1649,368
2017,9,20,23,1325,1293,1687,394
2017,9,21,0,1340,1295,1677,382
2017,9,21,1,1345,1306,1714,408
2017,9,21,2,1360,1320,1730,410
2017,9,21,3,1335,1294,1736,442
2017,9,21,4,1275,1239,1784,545
2017,9,21,5,1185,1156,1912,756
2017,9,21,6,1110,1094,2061,967
2017,9,21,7,1100,1061,2129,1068
2017,9,21,8,1065,1026,2120,1094
2017,9,21,9,1070,1021,2106,1085
2017,9,21,10,1055,1020,2111,1091
2017,9,21,11,1065,1047,2146,1099
2017,9,21,12,1105,1099,2166,1067
2017,9,21,13,1210,1214,2162,948
2017,9,21,14,1265,1313,2237,924
2017,9,21,15,1265,1322,2241,919
2017,9,21,16,1275,1329,2232,903
2017,9,21,17,1280,1315,2233,918
2017,9,21,18,1295,1302,2254,952
2017,9,21,19,1285,1290,2245,955
2017,9,21,20,1280,1291,2240,949
2017,9,21,21,1280,1272,2227,955
2017,9,21,22,1290,1287,2241,954
2017,9,21,23,1295,1292,2251,959
2017,9,22,0,1290,1278,2234,956
2017,9,22,1,1295,1291,2240,949
2017,9,22,2,1320,1323,2258,935
2017,9,22,3,1315,1348,2273,925
2017,9,22,4,1255,1285,2271,986
2017,9,22,5,1060,1227,2297,1070
2017,9,22,6,1120,1159,2224,1065
2017,9,22,7,1115,1146,2202,1056
2017,9,22,8,1100,1120,2177,1057
2017,9,22,9,1085,1110,2169,1059
2017,9,22,10,1085,1093,2149,1056
2017,9,22,11,1100,1093,2135,1042
2017,9,22,12,1145,1142,2176,1034
2017,9,22,13,1240,1240,2204,964
2017,9,22,14,1315,1321,2272,951
2017,9,22,15,1335,1365,2283,918
2017,9,22,16,1355,1354,2263,909
2017,9,22,17,1360,1364,2270,906
2017,9,22,18,1370,1345,2277,932
2017,9,22,19,1365,1337,2249,912
2017,9,22,20,1355,1335,2238,903
2017,9,22,21,1335,1307,2227,920
2017,9,22,22,1335,1297,2240,943
2017,9,22,23,1335,1301,2226,925
2017,9,23,0,1335,1275,2222,947
2017,9,23,1,1330,1287,2226,939
2017,9,23,2,1340,1314,2201,887
2017,9,23,3,1330,1312,2210,898
2017,9,23,4,1315,1263,2229,966
2017,9,23,5,1205,1201,2243,1042
2017,9,23,6,1135,1150,2188,1038
2017,9,23,7,1095,1111,2181,1070
2017,9,23,8,1080,1101,2200,1099
2017,9,23,9,1055,1072,2181,1109
2017,9,23,10,1055,1059,2179,1120
2017,9,23,11,1060,1062,2158,1096
2017,9,23,12,1085,1081,2164,1083
2017,9,23,13,1135,1122,2191,1069
2017,9,23,14,1175,1180,2226,1046
2017,9,23,15,1200,1221,2215,994
2017,9,23,16,1225,1259,2233,974
2017,9,23,17,1215,1251,2249,998
2017,9,23,18,1210,1230,2241,1011
2017,9,23,19,1195,1206,2218,1012
2017,9,23,20,1180,1201,2199,998
2017,9,23,21,1170,1182,2193,1011
2017,9,23,22,1170,1175,2211,1036
2017,9,23,23,1165,1187,2210,1023
2017,9,24,0,1170,1207,2237,1030
2017,9,24,1,1160,1206,2277,1071
2017,9,24,2,1185,1226,2273,1047
2017,9,24,3,1215,1229,2275,1046
2017,9,24,4,1190,1201,2296,1095
2017,9,24,5,1115,1152,2289,1137
2017,9,24,6,1060,1087,2278,1191
2017,9,24,7,1060,1049,2271,1222
2017,9,24,8,1040,1034,2229,1195
2017,9,24,9,1020,1018,2219,1201
2017,9,24,10,1020,1021,2210,1189
2017,9,24,11,1025,1021,2192,1171
2017,9,24,12,1055,1041,2189,1148
2017,9,24,13,1125,1079,2220,1141
2017,9,24,14,1185,1122,2209,1087
2017,9,24,15,1210,1166,2204,1038
2017,9,24,16,1230,1203,2218,1015
2017,9,24,17,1220,1202,2226,1024
2017,9,24,18,1210,1199,2245,1046
2017,9,24,19,1200,1189,2198,1009
2017,9,24,20,1185,1174,2199,1025
2017,9,24,21,1175,1169,2200,1031
2017,9,24,22,1175,1171,2200,1029
2017,9,24,23,1175,1174,2232,1058
2017,9,25,0,1180,1199,2256,1057
2017,9,25,1,1180,1213,2254,1041
2017,9,25,2,1210,1242,2259,1017
2017,9,25,3,1235,1256,2285,1029
2017,9,25,4,1185,1201,2260,1059
2017,9,25,5,1120,1107,2216,1109
2017,9,25,6,1060,1049,2186,1137
2017,9,25,7,1075,1006,2202,1196
2017,9,25,8,1050,1005,2225,1220
2017,9,25,9,1040,988,2219,1231
2017,9,25,10,1035,986,2138,1152
2017,9,25,11,1055,1011,2225,1214
2017,9,25,12,1110,1069,2235,1166
2017,9,25,13,1200,1192,2284,1092
2017,9,25,14,1255,1277,2284,1007
2017,9,25,15,1250,1300,2276,976
2017,9,25,16,1275,1308,2275,967
2017,9,25,17,1275,1290,2244,954
2017,9,25,18,1275,1288,2255,967
2017,9,25,19,1270,1260,2249,989
2017,9,25,20,1275,1277,2253,976
2017,9,25,21,1275,1259,2273,1014
2017,9,25,22,1285,1256,2280,1024
2017,9,25,23,1295,1267,2276,1009
2017,9,26,0,1290,1258,2258,1000
2017,9,26,1,1295,1274,2266,992
2017,9,26,2,1310,1301,2272,971
2017,9,26,3,1305,1306,2276,970
2017,9,26,4,1245,1247,2269,1022
2017,9,26,5,1160,1161,2242,1081
2017,9,26,6,1090,1090,2217,1127
2017,9,26,7,990,1051,2213,1162
2017,9,26,8,975,1028,2212,1184
2017,9,26,9,965,1029,2202,1173
2017,9,26,10,970,1022,2204,1182
2017,9,26,11,990,1041,2232,1191
2017,9,26,12,1035,1099,2260,1161
2017,9,26,13,1120,1208,2275,1067
2017,9,26,14,1190,1293,2296,1003
2017,9,26,15,1210,1298,2280,982
2017,9,26,16,1235,1295,2293,998
2017,9,26,17,1245,1295,2307,1012
2017,9,26,18,1250,1276,2309,1033
2017,9,26,19,1250,1259,2300,1041
2017,9,26,20,1245,1253,2295,1042
2017,9,26,21,1250,1250,2275,1025
2017,9,26,22,1280,1242,2269,1027
2017,9,26,23,1285,1250,2304,1054
2017,9,27,0,1285,1227,2309,1082
2017,9,27,1,1285,1234,2313,1079
2017,9,27,2,1315,1272,2311,1039
2017,9,27,3,1325,1277,2338,1061
2017,9,27,4,1280,1222,2329,1107
2017,9,27,5,1180,1133,2304,1171
2017,9,27,6,1100,1070,2274,1204
2017,9,27,7,985,1033,2222,1189
2017,9,27,8,970,1015,2218,1203
2017,9,27,9,965,1017,2259,1242
2017,9,27,10,965,1001,2233,1232
2017,9,27,11,990,1013,2236,1223
2017,9,27,12,1050,1044,2236,1192
2017,9,27,13,1170,1177,2248,1071
2017,9,27,14,1255,1251,2253,1002
2017,9,27,15,1250,1248,2248,1000
2017,9,27,16,1270,1245,2249,1004
2017,9,27,17,1275,1235,2242,1007
2017,9,27,18,1280,1232,2265,1033
2017,9,27,19,1270,1216,2263,1047
2017,9,27,20,1270,1218,2258,1040
2017,9,27,21,1260,1221,2266,1045
2017,9,27,22,1265,1222,2274,1052
2017,9,27,23,1270,1226,2264,1038
2017,9,28,0,1275,1218,2257,1039
2017,9,28,1,1290,1221,2274,1053
2017,9,28,2,1315,1244,2302,1058
2017,9,28,3,1295,1233,2315,1082
2017,9,28,4,1245,1185,2323,1138
2017,9,28,5,1150,1099,2308,1209
2017,9,28,6,1080,1037,2256,1219
2017,9,28,7,975,1010,2229,1219
2017,9,28,8,945,1003,2224,1221
2017,9,28,9,930,999,2195,1196
2017,9,28,10,930,991,2190,1199
2017,9,28,11,960,1018,2197,1179
2017,9,28,12,1025,1067,2228,1161
2017,9,28,13,1155,1191,2243,1052
2017,9,28,14,1250,1280,2237,957
2017,9,28,15,1250,1272,2225,953
2017,9,28,16,1235,1272,2224,952
2017,9,28,17,1240,1261,2247,986
2017,9,28,18,1225,1257,2255,998
2017,9,28,19,1215,1251,2262,1011
2017,9,28,20,1215,1249,2266,1017
2017,9,28,21,1225,1252,2266,1014
2017,9,28,22,1215,1249,2283,1034
2017,9,28,23,1215,1255,2265,1010
2017,9,29,0,1200,1232,2275,1043
2017,9,29,1,1200,1208,2270,1062
2017,9,29,2,1215,1260,2366,1106
2017,9,29,3,1230,1260,2354,1094
2017,9,29,4,1190,1195,2312,1117
2017,9,29,5,1105,1115,2318,1203
2017,9,29,6,1035,1050,2297,1247
2017,9,29,7,960,998,2281,1283
2017,9,29,8,945,979,2266,1287
2017,9,29,9,950,972,2268,1296
2017,9,29,10,950,977,2262,1285
2017,9,29,11,965,996,2251,1255
2017,9,29,12,1015,1046,2298,1252
2017,9,29,13,1155,1153,2313,1160
2017,9,29,14,1245,1239,2314,1075
2017,9,29,15,1245,1242,2321,1079
2017,9,29,16,1230,1240,2328,1088
2017,9,29,17,1235,1231,2329,1098
2017,9,29,18,1240,1234,2268,1034
2017,9,29,19,1230,1228,2279,1051
2017,9,29,20,1210,1217,2281,1064
2017,9,29,21,1210,1213,2276,1063
2017,9,29,22,1230,1215,2282,1067
2017,9,29,23,1230,1231,2286,1055
2017,9,30,0,1220,1209,2294,1085
2017,9,30,1,1215,1192,2287,1095
2017,9,30,2,1225,1227,2287,1060
2017,9,30,3,1230,1212,2261,1049
2017,9,30,4,1180,1171,2232,1061
2017,9,30,5,1100,1108,2249,1141
2017,9,30,6,1035,1054,2280,1226
2017,9,30,7,975,1004,2274,1270
2017,9,30,8,1060,981,2231,1250
2017,9,30,9,1035,980,2210,1230
2017,9,30,10,1030,964,2194,1230
2017,9,30,11,1030,985,2244,1259
2017,9,30,12,1055,1006,2270,1264
2017,9,30,13,1135,1047,2227,1180
2017,9,30,14,1205,1101,2216,1115
2017,9,30,15,1235,1135,2206,1071
2017,9,30,16,1260,1181,2243,1062
2017,9,30,17,1250,1186,2300,1114
2017,9,30,18,1245,1197,2326,1129
2017,9,30,19,1220,1196,2286,1090
2017,9,30,20,1210,1178,2270,1092
2017,9,30,21,1200,1168,2252,1084
2017,9,30,22,1190,1182,2258,1076
2017,9,30,23,1190,1178,2291,1113
2017,10,1,0,1195,1191,2307,1116
2017,10,1,1,1185,1215,2325,1110
2017,10,1,2,1215,1247,2357,1110
2017,10,1,3,1230,1228,2297,1069
2017,10,1,4,1205,1188,2237,1049
2017,10,1,5,1135,1135,2236,1101
2017,10,1,6,1080,1076,2262,1186
2017,10,1,7,1035,1046,2242,1196
2017,10,1,8,1015,1021,2291,1270
2017,10,1,9,1010,1003,2268,1265
2017,10,1,10,1005,991,2247,1256
2017,10,1,11,1015,994,2153,1159
2017,10,1,12,1030,1011,2203,1192
2017,10,1,13,1085,1059,2275,1216
2017,10,1,14,1125,1097,2356,1259
2017,10,1,15,1155,1164,2364,1200
2017,10,1,16,1175,1209,2359,1150
2017,10,1,17,1180,1211,2362,1151
2017,10,1,18,1180,1223,2347,1124
2017,10,1,19,1170,1212,2339,1127
2017,10,1,20,1155,1220,2415,1195
2017,10,1,21,1155,1214,2458,1244
2017,10,1,22,1160,1208,2482,1274
2017,10,1,23,1165,1217,2461,1244
2017,10,2,0,1175,1240,2459,1219
2017,10,2,1,1190,1262,2428,1166
2017,10,2,2,1220,1295,2390,1095
2017,10,2,3,1235,1296,2392,1096
2017,10,2,4,1170,1216,2362,1146
2017,10,2,5,1085,1148,2347,1199
2017,10,2,6,1020,1088,2342,1254
2017,10,2,7,1040,1059,2341,1282
2017,10,2,8,1025,1039,2355,1316
2017,10,2,9,1020,1037,2303,1266
2017,10,2,10,1020,1039,2338,1299
2017,10,2,11,1045,1061,2361,1300
2017,10,2,12,1095,1115,2370,1255
2017,10,2,13,1200,1242,2390,1148
2017,10,2,14,1270,1318,2372,1054
2017,10,2,15,1270,1332,2395,1063
2017,10,2,16,1275,1323,2351,1028
2017,10,2,17,1270,1331,2339,1008
2017,10,2,18,1275,1330,2359,1029
2017,10,2,19,1260,1337,2402,1065
2017,10,2,20,1265,1317,2389,1072
2017,10,2,21,1255,1316,2391,1075
2017,10,2,22,1260,1317,2392,1075
2017,10,2,23,1265,1333,2399,1066
2017,10,3,0,1265,1355,2425,1070
2017,10,3,1,1275,1376,2445,1069
2017,10,3,2,1305,1428,2452,1024
2017,10,3,3,1295,1412,2450,1038
2017,10,3,4,1245,1350,2434,1084
2017,10,3,5,1150,1256,2392,1136
2017,10,3,6,1075,1184,2327,1143
2017,10,3,7,1055,1150,2350,1200
2017,10,3,8,1035,1128,2233,1105
2017,10,3,9,1010,1121,2284,1163
2017,10,3,10,1030,1123,2365,1242
2017,10,3,11,1045,1144,2383,1239
2017,10,3,12,1100,1189,2387,1198
2017,10,3,13,1220,1322,2397,1075
2017,10,3,14,1315,1407,2414,1007
2017,10,3,15,1305,1391,2388,997
2017,10,3,16,1320,1385,2365,980
2017,10,3,17,1315,1372,2377,1005
2017,10,3,18,1255,1363,2380,1017
2017,10,3,19,1255,1344,2374,1030
2017,10,3,20,1255,1321,2370,1049
2017,10,3,21,1255,1292,2344,1052
2017,10,3,22,1230,1279,2327,1048
2017,10,3,23,1235,1273,2291,1018
2017,10,4,0,1240,1259,2296,1037
2017,10,4,1,1265,1297,2290,993
2017,10,4,2,1310,1347,2284,937
2017,10,4,3,1300,1365,2285,920
2017,10,4,4,1250,1294,2263,969
2017,10,4,5,1160,1221,2269,1048
2017,10,4,6,1100,1142,2283,1141
2017,10,4,7,1060,1115,2276,1161
2017,10,4,8,1045,1100,2275,1175
2017,10,4,9,1045,1091,2262,1171
2017,10,4,10,1030,1096,2248,1152
2017,10,4,11,1050,1114,2251,1137
2017,10,4,12,1120,1180,2292,1112
2017,10,4,13,1175,1299,2285,986
2017,10,4,14,1190,1395,2294,899
2017,10,4,15,1205,1371,2283,912
2017,10,4,16,1210,1364,2290,926
2017,10,4,17,1200,1348,2262,914
2017,10,4,18,1200,1332,2279,947
2017,10,4,19,1205,1315,2271,956
2017,10,4,20,1195,1303,2269,966
2017,10,4,21,1195,1292,2283,991
2017,10,4,22,1190,1297,2273,976
2017,10,4,23,1200,1293,2261,968
2017,10,5,0,1160,1296,2271,975
2017,10,5,1,1290,1326,2303,977
2017,10,5,2,1265,1371,2315,944
2017,10,5,3,1235,1355,2332,977
2017,10,5,4,1185,1298,2315,1017
2017,10,5,5,1100,1211,2266,1055
2017,10,5,6,1030,1144,2271,1127
2017,10,5,7,1020,1097,2253,1156
2017,10,5,8,1010,1084,2208,1124
2017,10,5,9,1000,1064,2204,1140
2017,10,5,10,1000,1063,2209,1146
2017,10,5,11,1020,1086,2241,1155
2017,10,5,12,1075,1146,2253,1107
2017,10,5,13,1190,1260,2301,1041
2017,10,5,14,1265,1346,2327,981
2017,10,5,15,1275,1328,2251,923
2017,10,5,16,1285,1324,2270,946
2017,10,5,17,1265,1311,2284,973
2017,10,5,18,1285,1293,2294,1001
2017,10,5,19,1260,1270,2277,1007
2017,10,5,20,1230,1272,2307,1035
2017,10,5,21,1220,1256,2292,1036
2017,10,5,22,1220,1240,2281,1041
2017,10,5,23,1230,1255,2274,1019
2017,10,6,0,1230,1228,2270,1042
2017,10,6,1,1245,1237,2280,1043
2017,10,6,2,1280,1292,2301,1009
2017,10,6,3,1250,1297,2278,981
2017,10,6,4,1200,1244,2131,887
2017,10,6,5,1105,1154,1948,794
2017,10,6,6,1055,1106,1787,681
2017,10,6,7,1030,1070,1689,619
2017,10,6,8,1010,1075,1695,620
2017,10,6,9,995,1058,1688,630
2017,10,6,10,995,1056,1704,648
2017,10,6,11,1010,1084,1706,622
2017,10,6,12,1050,1144,1728,584
2017,10,6,13,1150,1258,1729,471
2017,10,6,14,1235,1344,1710,366
2017,10,6,15,1245,1323,1688,365
2017,10,6,16,1265,1321,1692,371
2017,10,6,17,1255,1279,1677,398
2017,10,6,18,1250,1264,1699,435
2017,10,6,19,1245,1245,1707,462
2017,10,6,20,1255,1251,1732,481
2017,10,6,21,1220,1237,1761,524
2017,10,6,22,1220,1231,1754,523
2017,10,6,23,1225,1228,1739,511
2017,10,7,0,1240,1208,1733,525
2017,10,7,1,1270,1220,1724,504
2017,10,7,2,1305,1263,1716,453
2017,10,7,3,1280,1250,1679,429
2017,10,7,4,1235,1216,1696,480
2017,10,7,5,1150,1154,1687,533
2017,10,7,6,1075,1100,1682,582
2017,10,7,7,1000,1067,1680,613
2017,10,7,8,980,1038,1674,636
2017,10,7,9,970,1027,1680,653
2017,10,7,10,975,1036,1639,603
2017,10,7,11,975,1026,1593,567
2017,10,7,12,995,1049,1626,577
2017,10,7,13,1060,1096,1602,506
2017,10,7,14,1130,1144,1615,471
2017,10,7,15,1170,1171,1618,447
2017,10,7,16,1205,1178,1657,479
2017,10,7,17,1210,1189,1704,515
2017,10,7,18,1205,1204,1699,495
2017,10,7,19,1195,1179,1684,505
2017,10,7,20,1180,1180,1706,526
2017,10,7,21,1170,1174,1711,537
2017,10,7,22,1165,1177,1705,528
2017,10,7,23,1165,1163,1686,523
2017,10,8,0,1170,1184,1704,520
2017,10,8,1,1175,1221,1692,471
2017,10,8,2,1205,1240,1628,388
2017,10,8,3,1220,1222,1659,437
2017,10,8,4,1170,1180,1627,447
2017,10,8,5,1105,1134,1596,462
2017,10,8,6,1050,1066,1597,531
2017,10,8,7,1025,1033,1565,532
2017,10,8,8,1005,1020,1574,554
2017,10,8,9,990,1002,1565,563
2017,10,8,10,975,997,1529,532
2017,10,8,11,980,1018,1533,515
2017,10,8,12,1005,1015,1554,539
2017,10,8,13,1050,1077,1561,484
2017,10,8,14,1100,1122,1550,428
2017,10,8,15,1155,1169,1570,401
2017,10,8,16,1200,1203,1576,373
2017,10,8,17,1200,1243,1624,381
2017,10,8,18,1190,1240,1634,394
2017,10,8,19,1175,1231,1636,405
2017,10,8,20,1170,1213,1682,469
2017,10,8,21,1160,1209,1666,457
2017,10,8,22,1145,1212,1665,453
2017,10,8,23,1160,1213,1648,435
2017,10,9,0,1180,1224,1617,393
2017,10,9,1,1195,1258,1627,369
2017,10,9,2,1230,1300,1605,305
2017,10,9,3,1225,1296,1640,344
2017,10,9,4,1160,1244,1528,284
2017,10,9,5,1110,1184,1516,332
2017,10,9,6,1035,1110,1550,440
2017,10,9,7,1030,1077,1601,524
2017,10,9,8,1010,1063,1608,545
2017,10,9,9,1000,1060,1619,559
2017,10,9,10,1005,1078,1658,580
2017,10,9,11,1035,1108,1651,543
2017,10,9,12,1075,1164,1630,466
2017,10,9,13,1170,1279,1625,346
2017,10,9,14,1240,1367,1640,273
2017,10,9,15,1265,1353,1614,261
2017,10,9,16,1270,1332,1602,270
2017,10,9,17,1255,1328,1653,325
2017,10,9,18,1255,1319,1675,356
2017,10,9,19,1245,1293,1664,371
2017,10,9,20,1235,1285,1671,386
2017,10,9,21,1235,1274,1663,389
2017,10,9,22,1220,1265,1679,414
2017,10,9,23,1230,1269,1777,508
2017,10,10,0,1215,1255,1854,599
2017,10,10,1,1270,1282,1847,565
2017,10,10,2,1300,1350,2053,703
2017,10,10,3,1275,1330,2138,808
2017,10,10,4,1215,1269,2228,959
2017,10,10,5,1135,1183,2305,1122
2017,10,10,6,1075,1101,2171,1070
2017,10,10,7,1015,1061,1906,845
2017,10,10,8,1000,1043,2055,1012
2017,10,10,9,1000,1044,2061,1017
2017,10,10,10,1005,1051,2077,1026
2017,10,10,11,1030,1062,2101,1039
2017,10,10,12,1095,1118,2061,943
2017,10,10,13,1200,1257,2082,825
2017,10,10,14,1280,1338,2044,706
2017,10,10,15,1275,1315,1995,680
2017,10,10,16,1270,1297,1976,679
2017,10,10,17,1275,1268,1992,724
2017,10,10,18,1250,1259,1987,728
2017,10,10,19,1235,1240,1987,747
2017,10,10,20,1185,1226,2008,782
2017,10,10,21,1230,1213,2236,1023
2017,10,10,22,1220,1204,2277,1073
2017,10,10,23,1230,1201,2275,1074
2017,10,11,0,1210,1212,2288,1076
2017,10,11,1,1235,1241,2290,1049
2017,10,11,2,1285,1320,2280,960
2017,10,11,3,1255,1303,2246,943
2017,10,11,4,1195,1228,2217,989
2017,10,11,5,1130,1165,2243,1078
2017,10,11,6,1065,1089,2262,1173
2017,10,11,7,1040,1043,2241,1198
2017,10,11,8,1025,1034,2187,1153
2017,10,11,9,1020,1015,2151,1136
2017,10,11,10,1025,1015,2153,1138
2017,10,11,11,1045,1031,2160,1129
2017,10,11,12,1105,1091,2148,1057
2017,10,11,13,1215,1209,2132,923
2017,10,11,14,1290,1321,2198,877
2017,10,11,15,1270,1304,2184,880
2017,10,11,16,1275,1302,2175,873
2017,10,11,17,1275,1286,2208,922
2017,10,11,18,1275,1273,2222,949
2017,10,11,19,1255,1254,2218,964
2017,10,11,20,1250,1241,2245,1004
2017,10,11,21,1240,1262,2250,988
2017,10,11,22,1235,1247,2279,1032
2017,10,11,23,1240,1255,2275,1020
2017,10,12,0,1235,1271,2349,1078
2017,10,12,1,1255,1301,2336,1035
2017,10,12,2,1295,1334,2298,964
2017,10,12,3,1270,1307,2270,963
2017,10,12,4,1225,1256,2282,1026
2017,10,12,5,1125,1187,2273,1086
2017,10,12,6,1055,1110,2182,1072
2017,10,12,7,1060,1079,2164,1085
2017,10,12,8,1045,1058,2162,1104
2017,10,12,9,1030,1056,2155,1099
2017,10,12,10,1030,1057,2152,1095
2017,10,12,11,1055,1064,2168,1104
2017,10,12,12,1110,1124,2185,1061
2017,10,12,13,1245,1257,2213,956
2017,10,12,14,1340,1358,2216,858
2017,10,12,15,1325,1341,2249,908
2017,10,12,16,1315,1312,2207,895
2017,10,12,17,1300,1314,2254,940
2017,10,12,18,1290,1289,2276,987
2017,10,12,19,1270,1274,2297,1023
2017,10,12,20,1265,1280,2325,1045
2017,10,12,21,1260,1262,2316,1054
2017,10,12,22,1245,1268,2354,1086
2017,10,12,23,1260,1251,2317,1066
2017,10,13,0,1245,1250,2260,1010
2017,10,13,1,1245,1276,2202,926
2017,10,13,2,1300,1336,2205,869
2017,10,13,3,1305,1336,2287,951
2017,10,13,4,1255,1291,2273,982
2017,10,13,5,1160,1198,2278,1080
2017,10,13,6,1105,1134,2267,1133
2017,10,13,7,1080,1095,2249,1154
2017,10,13,8,1060,1074,2175,1101
2017,10,13,9,1045,1065,2174,1109
2017,10,13,10,1040,1057,2197,1140
2017,10,13,11,1050,1078,2200,1122
2017,10,13,12,1110,1128,2232,1104
2017,10,13,13,1205,1243,2228,985
2017,10,13,14,1280,1358,2267,909
2017,10,13,15,1295,1337,2223,886
2017,10,13,16,1290,1332,2227,895
2017,10,13,17,1285,1329,2245,916
2017,10,13,18,1265,1309,2248,939
2017,10,13,19,1250,1300,2300,1000
2017,10,13,20,1245,1289,2307,1018
2017,10,13,21,1230,1276,2258,982
2017,10,13,22,1225,1250,2276,1026
2017,10,13,23,1230,1263,2281,1018
2017,10,14,0,1215,1260,2294,1034
2017,10,14,1,1230,1282,2270,988
2017,10,14,2,1260,1326,2293,967
2017,10,14,3,1250,1304,2257,953
2017,10,14,4,1215,1265,2281,1016
2017,10,14,5,1145,1196,2304,1108
2017,10,14,6,1090,1140,2307,1167
2017,10,14,7,1090,1099,2286,1187
2017,10,14,8,1075,1079,2301,1222
2017,10,14,9,1050,1057,2298,1241
2017,10,14,10,1045,1063,2270,1207
2017,10,14,11,1045,1067,2269,1202
2017,10,14,12,1070,1102,2256,1154
2017,10,14,13,1120,1156,2267,1111
2017,10,14,14,1170,1224,2282,1058
2017,10,14,15,1200,1279,2339,1060
2017,10,14,16,1230,1296,2393,1097
2017,10,14,17,1220,1279,2407,1128
2017,10,14,18,1210,1277,2433,1156
2017,10,14,19,1190,1259,2410,1151
2017,10,14,20,1175,1248,2447,1199
2017,10,14,21,1160,1224,2443,1219
2017,10,14,22,1155,1209,2448,1239
2017,10,14,23,1155,1231,2461,1230
2017,10,15,0,1165,1227,2461,1234
2017,10,15,1,1160,1263,2438,1175
2017,10,15,2,1185,1306,2429,1123
2017,10,15,3,1200,1288,2416,1128
2017,10,15,4,1170,1254,2420,1166
2017,10,15,5,1120,1195,2420,1225
2017,10,15,6,1060,1153,2416,1263
2017,10,15,7,1025,1114,2446,1332
2017,10,15,8,1010,1100,2422,1322
2017,10,15,9,1000,1092,2407,1315
2017,10,15,10,995,1088,2418,1330
2017,10,15,11,1010,1081,2423,1342
2017,10,15,12,1015,1103,2412,1309
2017,10,15,13,1040,1148,2395,1247
2017,10,15,14,1065,1193,2388,1195
2017,10,15,15,1110,1228,2399,1171
2017,10,15,16,1140,1233,2395,1162
2017,10,15,17,1160,1240,2403,1163
2017,10,15,18,1155,1231,2401,1170
2017,10,15,19,1150,1218,2407,1189
2017,10,15,20,1135,1211,2414,1203
2017,10,15,21,1125,1196,2419,1223
2017,10,15,22,1130,1195,2421,1226
2017,10,15,23,1135,1211,2426,1215
2017,10,16,0,1145,1229,2428,1199
2017,10,16,1,1175,1274,2420,1146
2017,10,16,2,1205,1325,2408,1083
2017,10,16,3,1215,1295,2328,1033
2017,10,16,4,1065,1233,2350,1117
2017,10,16,5,1080,1166,2364,1198
2017,10,16,6,1020,1096,2338,1242
2017,10,16,7,985,1071,2395,1324
2017,10,16,8,975,1063,2410,1347
2017,10,16,9,970,1041,2300,1259
2017,10,16,10,975,1049,2258,1209
2017,10,16,11,1000,1068,2289,1221
2017,10,16,12,1065,1134,2402,1268
2017,10,16,13,1170,1264,2420,1156
2017,10,16,14,1250,1360,2409,1049
2017,10,16,15,1255,1334,2365,1031
2017,10,16,16,1265,1310,2395,1085
2017,10,16,17,1265,1315,2421,1106
2017,10,16,18,1270,1300,2431,1131
2017,10,16,19,1255,1290,2433,1143
2017,10,16,20,1260,1277,2435,1158
2017,10,16,21,1250,1267,2433,1166
2017,10,16,22,1255,1253,2432,1179
2017,10,16,23,1260,1245,2432,1187
2017,10,17,0,1265,1243,2514,1271
2017,10,17,1,1280,1261,2421,1160
2017,10,17,2,1310,1306,2441,1135
2017,10,17,3,1295,1291,2409,1118
2017,10,17,4,1250,1236,2350,1114
2017,10,17,5,1150,1149,2327,1178
2017,10,17,6,1080,1088,2321,1233
2017,10,17,7,1070,1044,2210,1166
2017,10,17,8,1050,1029,2270,1241
2017,10,17,9,1040,1026,2249,1223
2017,10,17,10,1045,1030,2307,1277
2017,10,17,11,1060,1055,2365,1310
2017,10,17,12,1120,1122,2394,1272
2017,10,17,13,1240,1247,2410,1163
2017,10,17,14,1320,1332,2389,1057
2017,10,17,15,1315,1297,2358,1061
2017,10,17,16,1315,1278,2357,1079
2017,10,17,17,1295,1262,2342,1080
2017,10,17,18,1285,1236,2374,1138
2017,10,17,19,1280,1237,2384,1147
2017,10,17,20,1285,1249,2423,1174
2017,10,17,21,1270,1233,2407,1174
2017,10,17,22,1270,1221,2413,1192
2017,10,17,23,1275,1223,2435,1212
2017,10,18,0,1275,1223,2407,1184
2017,10,18,1,1270,1242,2399,1157
2017,10,18,2,1320,1319,2418,1099
2017,10,18,3,1310,1282,2424,1142
2017,10,18,4,1235,1247,2429,1182
2017,10,18,5,1165,1157,2407,1250
2017,10,18,6,1085,1082,2383,1301
2017,10,18,7,980,1047,2382,1335
2017,10,18,8,975,1037,2415,1378
2017,10,18,9,960,1022,2381,1359
2017,10,18,10,960,1022,2368,1346
2017,10,18,11,975,1030,2310,1280
2017,10,18,12,1015,1055,2323,1268
2017,10,18,13,1115,1187,2325,1138
2017,10,18,14,1205,1291,2329,1038
2017,10,18,15,1210,1270,2284,1014
2017,10,18,16,1215,1274,2323,1049
2017,10,18,17,1215,1242,2336,1094
2017,10,18,18,1205,1237,2310,1073
2017,10,18,19,1190,1232,2340,1108
2017,10,18,20,1180,1220,2330,1110
2017,10,18,21,1175,1202,2333,1131
2017,10,18,22,1170,1244,2411,1167
2017,10,18,23,1175,1252,2438,1186
2017,10,19,0,1185,1248,2408,1160
2017,10,19,1,1205,1270,2381,1111
2017,10,19,2,1240,1318,2364,1046
2017,10,19,3,1235,1299,2372,1073
2017,10,19,4,1185,1252,2361,1109
2017,10,19,5,1100,1158,2334,1176
2017,10,19,6,1030,1087,2337,1250
2017,10,19,7,1020,1049,2321,1272
2017,10,19,8,995,1053,2319,1266
2017,10,19,9,990,1028,2278,1250
2017,10,19,10,995,1036,2279,1243
2017,10,19,11,1010,1040,2271,1231
2017,10,19,12,1075,1094,2281,1187
2017,10,19,13,1180,1201,2337,1136
2017,10,19,14,1270,1279,2331,1052
2017,10,19,15,1250,1290,2331,1041
2017,10,19,16,1235,1277,2338,1061
2017,10,19,17,1230,1234,2313,1079
2017,10,19,18,1210,1222,2308,1086
2017,10,19,19,1220,1203,2313,1110
2017,10,19,20,1235,1210,2300,1090
2017,10,19,21,1225,1227,2352,1125
2017,10,19,22,1215,1225,2349,1124
2017,10,19,23,1235,1230,2363,1133
2017,10,20,0,1210,1208,2305,1097
2017,10,20,1,1225,1242,2323,1081
2017,10,20,2,1280,1253,2272,1019
2017,10,20,3,1250,1225,2263,1038
2017,10,20,4,1210,1165,2263,1098
2017,10,20,5,1115,1102,2298,1196
2017,10,20,6,1035,1044,2291,1247
2017,10,20,7,1025,1017,2321,1304
2017,10,20,8,1005,982,2283,1301
2017,10,20,9,995,975,2255,1280
2017,10,20,10,995,964,2201,1237
2017,10,20,11,1015,983,2246,1263
2017,10,20,12,1050,1033,2265,1232
2017,10,20,13,1175,1119,2252,1133
2017,10,20,14,1285,1208,2271,1063
2017,10,20,15,1280,1229,2295,1066
2017,10,20,16,1280,1251,2280,1029
2017,10,20,17,1260,1262,2276,1014
2017,10,20,18,1240,1259,2297,1038
2017,10,20,19,1225,1264,2260,996
2017,10,20,20,1210,1279,2353,1074
2017,10,20,21,1200,1277,2336,1059
2017,10,20,22,1200,1283,2402,1119
2017,10,20,23,1200,1289,2414,1125
2017,10,21,0,1210,1269,2422,1153
2017,10,21,1,1235,1296,2336,1040
2017,10,21,2,1265,1303,2337,1034
2017,10,21,3,1245,1279,2404,1125
2017,10,21,4,1205,1238,2361,1123
2017,10,21,5,1135,1164,2343,1179
2017,10,21,6,1065,1119,2409,1290
2017,10,21,7,1000,1086,2369,1283
2017,10,21,8,980,1063,2344,1281
2017,10,21,9,970,1062,2272,1210
2017,10,21,10,960,1052,2348,1296
2017,10,21,11,965,1054,2352,1298
2017,10,21,12,995,1073,2330,1257
2017,10,21,13,1060,1122,2348,1226
2017,10,21,14,1140,1165,2330,1165
2017,10,21,15,1200,1191,2320,1129
2017,10,21,16,1220,1222,2334,1112
2017,10,21,17,1220,1237,2353,1116
2017,10,21,18,1210,1229,2347,1118
2017,10,21,19,1195,1213,2355,1142
2017,10,21,20,1190,1205,2350,1145
2017,10,21,21,1185,1189,2367,1178
2017,10,21,22,1180,1193,2377,1184
2017,10,21,23,1190,1201,2361,1160
2017,10,22,0,1200,1217,2340,1123
2017,10,22,1,1235,1263,2311,1048
2017,10,22,2,1255,1271,2340,1069
2017,10,22,3,1235,1261,2327,1066
2017,10,22,4,1195,1226,2401,1175
2017,10,22,5,1150,1169,2425,1256
2017,10,22,6,1085,1104,2405,1301
2017,10,22,7,1030,1054,2350,1296
2017,10,22,8,1015,1019,2282,1263
2017,10,22,9,1005,1006,2198,1192
2017,10,22,10,1000,1001,2136,1135
2017,10,22,11,1005,1015,2052,1037
2017,10,22,12,1030,1033,2056,1023
2017,10,22,13,1090,1080,2045,965
2017,10,22,14,1145,1140,2143,1003
2017,10,22,15,1185,1196,2195,999
2017,10,22,16,1195,1226,2180,954
2017,10,22,17,1215,1244,2231,987
2017,10,22,18,1210,1239,2226,987
2017,10,22,19,1190,1209,2209,1000
2017,10,22,20,1180,1212,2306,1094
2017,10,22,21,1170,1188,2380,1192
2017,10,22,22,1175,1182,2322,1140
2017,10,22,23,1180,1212,2310,1098
2017,10,23,0,1195,1235,2348,1113
2017,10,23,1,1235,1291,2383,1092
2017,10,23,2,1280,1313,2413,1100
2017,10,23,3,1260,1291,2402,1111
2017,10,23,4,1200,1233,2420,1187
2017,10,23,5,1130,1160,2432,1272
2017,10,23,6,1050,1092,2416,1324
2017,10,23,7,1015,1065,2411,1346
2017,10,23,8,1010,1044,2295,1251
2017,10,23,9,1000,1031,2278,1247
2017,10,23,10,1015,1042,2322,1280
2017,10,23,11,1040,1061,2374,1313
2017,10,23,12,1100,1117,2425,1308
2017,10,23,13,1225,1225,2414,1189
2017,10,23,14,1330,1320,2427,1107
2017,10,23,15,1310,1316,2430,1114
2017,10,23,16,1290,1294,2418,1124
2017,10,23,17,1290,1300,2420,1120
2017,10,23,18,1280,1290,2390,1100
2017,10,23,19,1255,1260,2404,1144
2017,10,23,20,1250,1255,2405,1150
2017,10,23,21,1240,1251,2405,1154
2017,10,23,22,1235,1238,2403,1165
2017,10,23,23,1225,1258,2398,1140
2017,10,24,0,1215,1277,2399,1122
2017,10,24,1,1230,1310,2352,1042
2017,10,24,2,1275,1347,2366,1019
2017,10,24,3,1255,1304,2360,1056
2017,10,24,4,1205,1234,2122,888
2017,10,24,5,1125,1151,1972,821
2017,10,24,6,1055,1085,1704,619
2017,10,24,7,1035,1051,1545,494
2017,10,24,8,1015,1034,1526,492
2017,10,24,9,1015,1043,1574,531
2017,10,24,10,1020,1040,1565,525
2017,10,24,11,1035,1076,1579,503
2017,10,24,12,1090,1133,1620,487
2017,10,24,13,1220,1257,1798,541
2017,10,24,14,1305,1374,2232,858
2017,10,24,15,1290,1359,2325,966
2017,10,24,16,1275,1333,2322,989
2017,10,24,17,1250,1319,2382,1063
2017,10,24,18,1240,1308,2373,1065
2017,10,24,19,1225,1277,2328,1051
2017,10,24,20,1220,1271,2317,1046
2017,10,24,21,1200,1275,2322,1047
2017,10,24,22,1185,1250,2356,1106
2017,10,24,23,1190,1239,2364,1125
2017,10,25,0,1200,1259,2365,1106
2017,10,25,1,1230,1281,2370,1089
2017,10,25,2,1300,1306,2126,820
2017,10,25,3,1280,1275,1894,619
2017,10,25,4,1205,1216,1824,608
2017,10,25,5,1140,1123,1658,535
2017,10,25,6,1065,1063,1628,565
2017,10,25,7,1005,1027,1600,573
2017,10,25,8,990,1022,1585,563
2017,10,25,9,980,1007,1583,576
2017,10,25,10,975,1017,1571,554
2017,10,25,11,995,1038,1551,513
2017,10,25,12,1015,1092,1551,459
2017,10,25,13,1140,1227,1729,502
2017,10,25,14,1225,1328,2217,889
2017,10,25,15,1210,1323,2375,1052
2017,10,25,16,1205,1293,2399,1106
2017,10,25,17,1190,1286,2405,1119
2017,10,25,18,1185,1267,2377,1110
2017,10,25,19,1175,1256,2411,1155
2017,10,25,20,1170,1252,2434,1182
2017,10,25,21,1160,1244,2453,1209
2017,10,25,22,1185,1230,2422,1192
2017,10,25,23,1190,1253,2478,1225
2017,10,26,0,1180,1259,2443,1184
2017,10,26,1,1195,1298,2444,1146
2017,10,26,2,1230,1309,2177,868
2017,10,26,3,1215,1268,1951,683
2017,10,26,4,1165,1198,1834,636
2017,10,26,5,1080,1127,1670,543
2017,10,26,6,1010,1072,1618,546
2017,10,26,7,1045,1034,1592,558
2017,10,26,8,1025,1018,1590,572
2017,10,26,9,1020,1009,1586,577
2017,10,26,10,1020,1007,1556,549
2017,10,26,11,1035,1006,1528,522
2017,10,26,12,1095,1081,1531,450
2017,10,26,13,1230,1200,1714,514
2017,10,26,14,1335,1319,2164,845
2017,10,26,15,1320,1315,2275,960
2017,10,26,16,1295,1297,2149,852
2017,10,26,17,1290,1287,2024,737
2017,10,26,18,1270,1285,1980,695
2017,10,26,19,1250,1263,1985,722
2017,10,26,20,1250,1252,1983,731
2017,10,26,21,1240,1231,1963,732
2017,10,26,22,1230,1224,1975,751
2017,10,26,23,1225,1223,1977,754
2017,10,27,0,1230,1230,1985,755
2017,10,27,1,1245,1296,2019,723
2017,10,27,2,1300,1328,2049,721
2017,10,27,3,1300,1310,1991,681
2017,10,27,4,1255,1248,2008,760
2017,10,27,5,1160,1157,1991,834
2017,10,27,6,1100,1087,1985,898
2017,10,27,7,1070,1048,1974,926
2017,10,27,8,1050,1035,1951,916
2017,10,27,9,1035,1042,1953,911
2017,10,27,10,1030,1051,1956,905
2017,10,27,11,1050,1065,1968,903
2017,10,27,12,1105,1117,2015,898
2017,10,27,13,1190,1231,1980,749
2017,10,27,14,1270,1324,1998,674
2017,10,27,15,1275,1331,2041,710
2017,10,27,16,1280,1321,2063,742
2017,10,27,17,1275,1307,2045,738
2017,10,27,18,1265,1271,1995,724
2017,10,27,19,1265,1248,2001,753
2017,10,27,20,1270,1234,1983,749
2017,10,27,21,1265,1215,1991,776
2017,10,27,22,1260,1214,2071,857
2017,10,27,23,1275,1212,2098,886
2017,10,28,0,1260,1217,2098,881
2017,10,28,1,1290,1250,2073,823
2017,10,28,2,1305,1259,2049,790
2017,10,28,3,1280,1253,2060,807
2017,10,28,4,1240,1192,2036,844
2017,10,28,5,1160,1139,2036,897
2017,10,28,6,1110,1079,1837,758
2017,10,28,7,1055,1044,1838,794
2017,10,28,8,1035,1005,1919,914
2017,10,28,9,1030,1011,1918,907
2017,10,28,10,1030,1016,1922,906
2017,10,28,11,1020,1038,1897,859
2017,10,28,12,1040,1051,1921,870
2017,10,28,13,1075,1096,1934,838
2017,10,28,14,1100,1172,2057,885
2017,10,28,15,1125,1206,2094,888
2017,10,28,16,1145,1220,2121,901
2017,10,28,17,1155,1206,2062,856
2017,10,28,18,1165,1183,1929,746
2017,10,28,19,1140,1153,1570,417
2017,10,28,20,1135,1171,1340,169
2017,10,28,21,1125,1163,1385,222
2017,10,28,22,1130,1170,1403,233
2017,10,28,23,1125,1174,1414,240
2017,10,29,0,1145,1199,1397,198
2017,10,29,1,1185,1250,1411,161
2017,10,29,2,1200,1258,1357,99
2017,10,29,3,1185,1242,1351,109
2017,10,29,4,1140,1201,1314,113
2017,10,29,5,1095,1142,1340,198
2017,10,29,6,1035,1095,1356,261
2017,10,29,7,1020,1041,1273,232
2017,10,29,8,1005,1030,1350,320
2017,10,29,9,990,1022,1378,356
2017,10,29,10,985,1024,1382,358
2017,10,29,11,1000,1013,1418,405
2017,10,29,12,1010,1038,1473,435
2017,10,29,13,1060,1067,1531,464
2017,10,29,14,1105,1133,1608,475
2017,10,29,15,1155,1171,1606,435
2017,10,29,16,1180,1218,1626,408
2017,10,29,17,1210,1248,1655,407
2017,10,29,18,1200,1262,1664,402
2017,10,29,19,1190,1252,1653,401
2017,10,29,20,1175,1269,1674,405
2017,10,29,21,1165,1263,1651,388
2017,10,29,22,1165,1258,1629,371
2017,10,29,23,1175,1289,1631,342
2017,10,30,0,1190,1320,1625,305
2017,10,30,1,1230,1340,1613,273
2017,10,30,2,1270,1338,1585,247
2017,10,30,3,1260,1304,1591,287
2017,10,30,4,1200,1234,1585,351
2017,10,30,5,1135,1147,1585,438
2017,10,30,6,1070,1079,1572,493
2017,10,30,7,1045,1035,1558,523
2017,10,30,8,1030,1023,1569,546
2017,10,30,9,1025,1015,1547,532
2017,10,30,10,1035,1026,1521,495
2017,10,30,11,1055,1039,1497,458
2017,10,30,12,1115,1115,1529,414
2017,10,30,13,1260,1230,1522,292
2017,10,30,14,1370,1342,1536,194
2017,10,30,15,1365,1351,1534,183
2017,10,30,16,1345,1333,1494,161
2017,10,30,17,1345,1308,1506,198
2017,10,30,18,1340,1296,1505,209
2017,10,30,19,1325,1271,1485,214
2017,10,30,20,1315,1259,1485,226
2017,10,30,21,1305,1228,1481,253
2017,10,30,22,1300,1215,1479,264
2017,10,30,23,1310,1225,1496,271
2017,10,31,0,1310,1247,1499,252
2017,10,31,1,1345,1330,1511,181
2017,10,31,2,1400,1354,1499,145
2017,10,31,3,1375,1342,1509,167
2017,10,31,4,1310,1306,1559,253
2017,10,31,5,1220,1223,1581,358
2017,10,31,6,1135,1165,1579,414
2017,10,31,7,1060,1128,1659,531
2017,10,31,8,1045,1098,1605,507
2017,10,31,9,1040,1099,1636,537
2017,10,31,10,1045,1103,1681,578
2017,10,31,11,1055,1128,1726,598
2017,10,31,12,1110,1192,1728,536
2017,10,31,13,1235,1314,1795,481
2017,10,31,14,1335,1446,1930,484
2017,10,31,15,1310,1429,1881,452
2017,10,31,16,1295,1408,1882,474
2017,10,31,17,1285,1394,1877,483
2017,10,31,18,1280,1385,1913,528
2017,10,31,19,1255,1366,1939,573
2017,10,31,20,1225,1381,1995,614
2017,10,31,21,1220,1312,1972,660
2017,10,31,22,1210,1338,1949,611
2017,10,31,23,1215,1346,1956,610
2017,11,1,0,1225,1344,1941,597
2017,11,1,1,1270,1351,1907,556
2017,11,1,2,1310,1347,1877,530
2017,11,1,3,1290,1340,1974,634
2017,11,1,4,1230,1271,2089,818
2017,11,1,5,1125,1197,2177,980
2017,11,1,6,1085,1114,2145,1031
2017,11,1,7,1025,1085,2086,1001
2017,11,1,8,1015,1065,2097,1032
2017,11,1,9,1005,1061,2220,1159
2017,11,1,10,1010,1059,2260,1201
2017,11,1,11,1030,1087,2253,1166
2017,11,1,12,1095,1162,2340,1178
2017,11,1,13,1220,1303,2447,1144
2017,11,1,14,1320,1410,2550,1140
2017,11,1,15,1305,1433,2606,1173
2017,11,1,16,1290,1431,2604,1173
2017,11,1,17,1275,1454,2613,1159
2017,11,1,18,1255,1420,2607,1187
2017,11,1,19,1240,1330,2540,1210
2017,11,1,20,1230,1405,2644,1239
2017,11,1,21,1215,1415,2644,1229
2017,11,1,22,1210,1404,2626,1222
2017,11,1,23,1220,1404,2600,1196
2017,11,2,0,1225,1415,2599,1184
2017,11,2,1,1270,1477,2620,1143
2017,11,2,2,1305,1470,2596,1126
2017,11,2,3,1285,1410,2564,1154
2017,11,2,4,1235,1366,2557,1191
2017,11,2,5,1150,1301,2540,1239
2017,11,2,6,1085,1214,2469,1255
2017,11,2,7,1085,1152,2474,1322
2017,11,2,8,1070,1138,2464,1326
2017,11,2,9,1070,1138,2471,1333
2017,11,2,10,1075,1142,2459,1317
2017,11,2,11,1095,1146,2451,1305
2017,11,2,12,1140,1225,2432,1207
2017,11,2,13,1280,1355,2436,1081
2017,11,2,14,1360,1446,2483,1037
2017,11,2,15,1350,1463,2449,986
2017,11,2,16,1345,1460,2441,981
2017,11,2,17,1330,1423,2441,1018
2017,11,2,18,1310,1401,2455,1054
2017,11,2,19,1305,1388,2469,1081
2017,11,2,20,1300,1371,2467,1096
2017,11,2,21,1290,1390,2490,1100
2017,11,2,22,1295,1378,2501,1123
2017,11,2,23,1330,1391,2507,1116
2017,11,3,0,1400,1441,2510,1069
2017,11,3,1,1400,1497,2518,1021
2017,11,3,2,1385,1497,2539,1042
2017,11,3,3,1360,1458,2541,1083
2017,11,3,4,1300,1405,2490,1085
2017,11,3,5,1205,1331,2485,1154
2017,11,3,6,1125,1258,2475,1217
2017,11,3,7,1060,1227,2483,1256
2017,11,3,8,1060,1205,2463,1258
2017,11,3,9,1055,1194,2439,1245
2017,11,3,10,1060,1191,2426,1235
2017,11,3,11,1070,1229,2448,1219
2017,11,3,12,1115,1277,2437,1160
2017,11,3,13,1260,1386,2460,1074
2017,11,3,14,1355,1471,2466,995
2017,11,3,15,1365,1450,2437,987
2017,11,3,16,1330,1458,2431,973
2017,11,3,17,1335,1452,2430,978
2017,11,3,18,1305,1429,2426,997
2017,11,3,19,1280,1413,2202,789
2017,11,3,20,1270,1418,2354,936
2017,11,3,21,1265,1383,2398,1015
2017,11,3,22,1290,1402,2419,1017
2017,11,3,23,1300,1403,2446,1043
2017,11,4,0,1345,1406,2460,1054
2017,11,4,1,1365,1448,2502,1054
2017,11,4,2,1350,1450,2504,1054
2017,11,4,3,1320,1434,2477,1043
2017,11,4,4,1285,1381,2420,1039
2017,11,4,5,1210,1345,2444,1099
2017,11,4,6,1145,1288,2502,1214
2017,11,4,7,1150,1252,2543,1291
2017,11,4,8,1130,1221,2545,1324
2017,11,4,9,1120,1210,2525,1315
2017,11,4,10,1125,1195,2484,1289
2017,11,4,11,1130,1189,2474,1285
2017,11,4,12,1185,1211,2461,1250
2017,11,4,13,1270,1253,2454,1201
2017,11,4,14,1375,1318,2531,1213
2017,11,4,15,1375,1355,2530,1175
2017,11,4,16,1360,1378,2538,1160
2017,11,4,17,1350,1387,2524,1137
2017,11,4,18,1340,1367,2523,1156
2017,11,4,19,1330,1354,2493,1139
2017,11,4,20,1320,1329,2461,1132
2017,11,4,21,1325,1312,2491,1179
2017,11,4,22,1325,1303,2413,1110
2017,11,4,23,1340,1331,2455,1124
2017,11,5,0,1370,1366,2435,1069
2017,11,5,1,1405,1427,2473,1046
2017,11,5,2,1410,1434,2472,1038
2017,11,5,3,1370,1407,2463,1056
2017,11,5,4,1340,1358,2456,1098
2017,11,5,5,1250,1301,2411,1110
2017,11,5,6,1180,1257,2427,1170
2017,11,5,7,1175,1209,2428,1219
2017,11,5,8,1155,1128,2407,1279
2017,11,5,9,1155,1167,2402,1235
2017,11,5,10,1140,1163,2373,1210
2017,11,5,11,1145,1189,2408,1219
2017,11,5,12,1155,1195,2427,1232
2017,11,5,13,1205,1221,2422,1201
2017,11,5,14,1300,1287,2420,1133
2017,11,5,15,1350,1338,2419,1081
2017,11,5,16,1385,1376,2425,1049
2017,11,5,17,1395,1397,2416,1019
2017,11,5,18,1395,1376,2456,1080
2017,11,5,19,1370,1361,2481,1120
2017,11,5,20,1360,1374,2500,1126
2017,11,5,21,1365,1358,2497,1139
2017,11,5,22,1375,1353,2492,1139
2017,11,5,23,1385,1386,2508,1122
2017,11,6,0,1395,1449,2503,1054
2017,11,6,1,1410,1537,2508,971
2017,11,6,2,1460,1544,2513,969
2017,11,6,3,1450,1525,2492,967
2017,11,6,4,1415,1482,2493,1011
2017,11,6,5,1345,1429,2476,1047
2017,11,6,6,1260,1354,2485,1131
2017,11,6,7,1190,1281,2492,1211
2017,11,6,8,1170,1243,2500,1257
2017,11,6,9,1155,1233,2540,1307
2017,11,6,10,1140,1228,2546,1318
2017,11,6,11,1145,1252,2545,1293
2017,11,6,12,1160,1282,2529,1247
2017,11,6,13,1200,1349,2540,1191
2017,11,6,14,1360,1463,2551,1088
2017,11,6,15,1400,1539,2601,1062
2017,11,6,16,1425,1516,2617,1101
2017,11,6,17,1440,1516,2594,1078
2017,11,6,18,1445,1514,2626,1112
2017,11,6,19,1435,1486,2614,1128
2017,11,6,20,1420,1462,2595,1133
2017,11,6,21,1400,1439,2565,1126
2017,11,6,22,1410,1434,2502,1068
2017,11,6,23,1395,1438,2501,1063
2017,11,7,0,1410,1464,2493,1029
2017,11,7,1,1440,1551,2525,974
2017,11,7,2,1490,1575,2595,1020
2017,11,7,3,1500,1550,2559,1009
2017,11,7,4,1470,1528,2561,1033
2017,11,7,5,1405,1448,2529,1081
2017,11,7,6,1315,1372,2530,1158
2017,11,7,7,1250,1325,2567,1242
2017,11,7,8,1165,1244,2550,1306
2017,11,7,9,1145,1203,2535,1332
2017,11,7,10,1140,1212,2561,1349
2017,11,7,11,1155,1226,2554,1328
2017,11,7,12,1170,1233,2578,1345
2017,11,7,13,1215,1303,2583,1280
2017,11,7,14,1370,1434,2602,1168
2017,11,7,15,1495,1503,2653,1150
2017,11,7,16,1475,1473,2627,1154
2017,11,7,17,1470,1457,2611,1154
2017,11,7,18,1460,1416,2621,1205
2017,11,7,19,1435,1368,2599,1231
2017,11,7,20,1410,1340,2643,1303
2017,11,7,21,1405,1315,2642,1327
2017,11,7,22,1385,1317,2635,1318
2017,11,7,23,1400,1321,2625,1304
2017,11,8,0,1455,1350,2609,1259
2017,11,8,1,1535,2723,3912,1189
2017,11,8,2,1550,1533,2668,1135
2017,11,8,3,1535,1524,2654,1130
2017,11,8,4,1505,1500,2628,1128
2017,11,8,5,1430,1439,2647,1208
2017,11,8,6,1340,1348,2641,1293
2017,11,8,7,1270,1292,2595,1303
2017,11,8,8,1180,1246,2524,1278
2017,11,8,9,1150,1236,2654,1418
2017,11,8,10,1155,1231,2691,1460
2017,11,8,11,1160,1237,2697,1460
2017,11,8,12,1175,1250,2688,1438
2017,11,8,13,1240,1297,2660,1363
2017,11,8,14,1360,1431,2655,1224
2017,11,8,15,1440,1485,2627,1142
2017,11,8,16,1430,1461,2646,1185
2017,11,8,17,1425,1448,2637,1189
2017,11,8,18,1405,1451,2638,1187
2017,11,8,19,1395,1438,2676,1238
2017,11,8,20,1360,1413,2628,1215
2017,11,8,21,1365,1408,2623,1215
2017,11,8,22,1360,1401,2583,1182
2017,11,8,23,1365,1423,2580,1157
2017,11,9,0,1415,1451,2570,1119
2017,11,9,1,1485,1519,2519,1000
2017,11,9,2,1505,1532,2519,987
2017,11,9,3,1440,1498,2482,984
2017,11,9,4,1420,1476,2484,1008
2017,11,9,5,1370,1410,2511,1101
2017,11,9,6,1275,1326,2491,1165
2017,11,9,7,1215,1264,2496,1232
2017,11,9,8,1120,1227,2509,1282
2017,11,9,9,1105,1211,2519,1308
2017,11,9,10,1100,1205,2531,1326
2017,11,9,11,1105,1204,2529,1325
2017,11,9,12,1135,1225,2521,1296
2017,11,9,13,1200,1287,2522,1235
2017,11,9,14,1300,1418,2524,1106
2017,11,9,15,1365,1488,2559,1071
2017,11,9,16,1360,1485,2561,1076
2017,11,9,17,1360,1476,2561,1085
2017,11,9,18,1345,1457,2572,1115
2017,11,9,19,1335,1439,2581,1142
2017,11,9,20,1320,1410,2588,1178
2017,11,9,21,1325,1388,2571,1183
2017,11,9,22,1335,1378,2557,1179
2017,11,9,23,1335,1389,2568,1179
2017,11,10,0,1365,1424,2576,1152
2017,11,10,1,1420,1479,2566,1087
2017,11,10,2,1440,1496,2525,1029
2017,11,10,3,1420,1473,2537,1064
2017,11,10,4,1385,1454,2565,1111
2017,11,10,5,1320,1396,2561,1165
2017,11,10,6,1240,1314,2575,1261
2017,11,10,7,1180,1255,2596,1341
2017,11,10,8,1140,1240,2653,1413
2017,11,10,9,1130,1212,2660,1448
2017,11,10,10,1120,1199,2596,1397
2017,11,10,11,1110,1213,2632,1419
2017,11,10,12,1115,1226,2621,1395
2017,11,10,13,1155,1270,2632,1362
2017,11,10,14,1275,1361,2638,1277
2017,11,10,15,1360,1432,2648,1216
2017,11,10,16,1360,1429,2655,1226
2017,11,10,17,1355,1400,2690,1290
2017,11,10,18,1335,1380,2711,1331
2017,11,10,19,1315,1363,2686,1323
2017,11,10,20,1300,1340,2670,1330
2017,11,10,21,1295,1337,2699,1362
2017,11,10,22,1275,1317,2675,1358
2017,11,10,23,1285,1308,2644,1336
2017,11,11,0,1330,1348,2654,1306
2017,11,11,1,1405,1406,2657,1251
2017,11,11,2,1375,1411,2660,1249
2017,11,11,3,1375,1369,2616,1247
2017,11,11,4,1325,1361,2584,1223
2017,11,11,5,1275,1303,2560,1257
2017,11,11,6,1200,1243,2535,1292
2017,11,11,7,1140,1213,2573,1360
2017,11,11,8,1105,1207,2606,1399
2017,11,11,9,1085,1175,2573,1398
2017,11,11,10,1070,1147,2559,1412
2017,11,11,11,1070,1154,2554,1400
2017,11,11,12,1075,1158,2554,1396
2017,11,11,13,1115,1175,2558,1383
2017,11,11,14,1235,1227,2552,1325
2017,11,11,15,1355,1278,2484,1206
2017,11,11,16,1380,1317,2531,1214
2017,11,11,17,1390,1342,2558,1216
2017,11,11,18,1385,1325,2599,1274
2017,11,11,19,1370,1312,2593,1281
2017,11,11,20,1360,1281,2598,1317
2017,11,11,21,1330,1258,2564,1306
2017,11,11,22,1325,1233,2546,1313
2017,11,11,23,1335,1245,2598,1353
2017,11,12,0,1380,1292,2586,1294
2017,11,12,1,1445,1371,2648,1277
2017,11,12,2,1465,1373,2599,1226
2017,11,12,3,1450,1357,2588,1231
2017,11,12,4,1420,1341,2611,1270
2017,11,12,5,1355,1301,2607,1306
2017,11,12,6,1295,1241,2604,1363
2017,11,12,7,1250,1200,2594,1394
2017,11,12,8,1175,1164,2594,1430
2017,11,12,9,1140,1145,2536,1391
2017,11,12,10,1140,1138,2516,1378
2017,11,12,11,1135,1148,2511,1363
2017,11,12,12,1150,1150,2527,1377
2017,11,12,13,1175,1171,2548,1377
2017,11,12,14,1235,1225,2573,1348
2017,11,12,15,1305,1274,2625,1351
2017,11,12,16,1350,1311,2620,1309
2017,11,12,17,1375,1337,2633,1296
2017,11,12,18,1360,1327,2639,1312
2017,11,12,19,1350,1304,2633,1329
2017,11,12,20,1355,1289,2642,1353
2017,11,12,21,1350,1279,2656,1377
2017,11,12,22,1335,1266,2663,1397
2017,11,12,23,1350,1290,2639,1349
2017,11,13,0,1400,1342,2643,1301
2017,11,13,1,1485,1439,2646,1207
2017,11,13,2,1500,1444,2640,1196
2017,11,13,3,1490,1420,2637,1217
2017,11,13,4,1440,1399,2643,1244
2017,11,13,5,1370,1315,2625,1310
2017,11,13,6,1295,1240,2626,1386
2017,11,13,7,1230,1180,2580,1400
2017,11,13,8,1020,1149,2569,1420
2017,11,13,9,1010,1140,2551,1411
2017,11,13,10,1005,1136,2543,1407
2017,11,13,11,1015,1149,2565,1416
2017,11,13,12,1030,1175,2583,1408
2017,11,13,13,1095,1236,2576,1340
2017,11,13,14,1220,1357,2593,1236
2017,11,13,15,1320,1425,2656,1231
2017,11,13,16,1320,1397,2639,1242
2017,11,13,17,1310,1388,2656,1268
2017,11,13,18,1290,1358,2657,1299
2017,11,13,19,1275,1333,2641,1308
2017,11,13,20,1250,1314,2612,1298
2017,11,13,21,1235,1301,2619,1318
2017,11,13,22,1220,1295,2607,1312
2017,11,13,23,1210,1295,2617,1322
2017,11,14,0,1230,1349,2614,1265
2017,11,14,1,1275,1449,2664,1215
2017,11,14,2,1330,1456,2697,1241
2017,11,14,3,1330,1437,2695,1258
2017,11,14,4,1315,1396,2698,1302
2017,11,14,5,1275,1331,2630,1299
2017,11,14,6,1190,1260,2598,1338
2017,11,14,7,1135,1163,2284,1121
2017,11,14,8,1105,1140,2219,1079
2017,11,14,9,1080,1154,2431,1277
2017,11,14,10,1080,1140,2495,1355
2017,11,14,11,1090,1155,2453,1298
2017,11,14,12,1105,1162,2542,1380
2017,11,14,13,1165,1226,2617,1391
2017,11,14,14,1325,1358,2658,1300
2017,11,14,15,1475,1437,2745,1308
2017,11,14,16,1465,1433,2768,1335
2017,11,14,17,1455,1441,2719,1278
2017,11,14,18,1435,1428,2682,1254
2017,11,14,19,1415,1411,2687,1276
2017,11,14,20,1390,1382,2789,1407
2017,11,14,21,1390,1362,2776,1414
2017,11,14,22,1350,1363,2797,1434
2017,11,14,23,1375,1347,2769,1422
2017,11,15,0,1395,1388,2767,1379
2017,11,15,1,1445,1478,2793,1315
2017,11,15,2,1455,1482,2798,1316
2017,11,15,3,1440,1465,2769,1304
2017,11,15,4,1425,1443,2752,1309
2017,11,15,5,1390,1374,2737,1363
2017,11,15,6,1265,1300,2723,1423
2017,11,15,7,1190,1236,2703,1467
2017,11,15,8,1085,1205,2692,1487
2017,11,15,9,1070,1183,2641,1458
2017,11,15,10,1060,1177,2612,1435
2017,11,15,11,1065,1175,2606,1431
2017,11,15,12,1085,1200,2623,1423
2017,11,15,13,1140,1269,2632,1363
2017,11,15,14,1270,1391,2632,1241
2017,11,15,15,1360,1478,2670,1192
2017,11,15,16,1355,1456,2628,1172
2017,11,15,17,1345,1452,2621,1169
2017,11,15,18,1355,1437,2645,1208
2017,11,15,19,1335,1405,2641,1236
2017,11,15,20,1280,1391,2674,1283
2017,11,15,21,1320,1373,2651,1278
2017,11,15,22,1320,1370,2649,1279
2017,11,15,23,1325,1355,2629,1274
2017,11,16,0,1350,1406,2628,1222
2017,11,16,1,1385,1473,2626,1153
2017,11,16,2,1425,1488,2640,1152
2017,11,16,3,1405,1467,2629,1162
2017,11,16,4,1365,1425,2631,1206
2017,11,16,5,1305,1370,2660,1290
2017,11,16,6,1225,1279,2644,1365
2017,11,16,7,1155,1201,2487,1286
2017,11,16,8,1015,1167,2478,1311
2017,11,16,9,1000,1151,2485,1334
2017,11,16,10,995,1148,2497,1349
2017,11,16,11,1000,1142,2600,1458
2017,11,16,12,1005,1171,2612,1441
2017,11,16,13,1070,1218,2561,1343
2017,11,16,14,1195,1348,2602,1254
2017,11,16,15,1295,1424,2614,1190
2017,11,16,16,1290,1424,2624,1200
2017,11,16,17,1280,1421,2703,1282
2017,11,16,18,1270,1434,2695,1261
2017,11,16,19,1260,1401,2659,1258
2017,11,16,20,1235,1385,2709,1324
2017,11,16,21,1225,1389,2734,1345
2017,11,16,22,1210,1368,2289,921
2017,11,16,23,1210,1373,2085,712
2017,11,17,0,1225,1412,2011,599
2017,11,17,1,1255,1476,2049,573
2017,11,17,2,1295,1473,2035,562
2017,11,17,3,1305,1464,2043,579
2017,11,17,4,1285,1435,2020,585
2017,11,17,5,1225,1358,2092,734
2017,11,17,6,1145,1267,2150,883
2017,11,17,7,1080,1205,2325,1120
2017,11,17,8,1135,1183,2480,1297
2017,11,17,9,1110,1158,2651,1493
2017,11,17,10,1100,1163,2694,1531
2017,11,17,11,1110,1155,2708,1553
2017,11,17,12,1125,1165,2724,1559
2017,11,17,13,1180,1217,2703,1486
2017,11,17,14,1305,1335,2636,1301
2017,11,17,15,1405,1418,2689,1271
2017,11,17,16,1395,1434,2779,1345
2017,11,17,17,1380,1430,2789,1359
2017,11,17,18,1360,1443,2835,1392
2017,11,17,19,1340,1417,2833,1416
2017,11,17,20,1320,1407,2846,1439
2017,11,17,21,1315,1402,2733,1331
2017,11,17,22,1295,1400,2190,790
2017,11,17,23,1290,1397,2121,724
2017,11,18,0,1325,1446,2095,649
2017,11,18,1,1385,1516,2122,606
2017,11,18,2,1400,1513,2114,601
2017,11,18,3,1370,1486,2149,663
2017,11,18,4,1350,1450,2151,701
2017,11,18,5,1310,1409,2120,711
2017,11,18,6,1220,1322,2120,798
2017,11,18,7,1165,1258,2124,866
2017,11,18,8,1145,1227,2136,909
2017,11,18,9,1120,1203,2122,919
2017,11,18,10,1110,1201,2127,926
2017,11,18,11,1110,1207,2151,944
2017,11,18,12,1125,1205,2131,926
2017,11,18,13,1150,1232,2117,885
2017,11,18,14,1215,1289,2092,803
2017,11,18,15,1265,1335,2136,801
2017,11,18,16,1290,1375,2135,760
2017,11,18,17,1305,1382,2143,761
2017,11,18,18,1300,1381,2143,762
2017,11,18,19,1285,1375,2162,787
2017,11,18,20,1260,1351,2135,784
2017,11,18,21,1245,1326,2130,804
2017,11,18,22,1230,1325,2139,814
2017,11,18,23,1240,1323,2132,809
2017,11,19,0,1280,1362,2139,777
2017,11,19,1,1350,1451,2153,702
2017,11,19,2,1355,1448,2074,626
2017,11,19,3,1350,1428,2202,774
2017,11,19,4,1320,1382,2277,895
2017,11,19,5,1280,1344,2466,1122
2017,11,19,6,1200,1294,2552,1258
2017,11,19,7,1150,1248,2570,1322
2017,11,19,8,1130,1216,2555,1339
2017,11,19,9,1110,1183,2611,1428
2017,11,19,10,1105,1180,2764,1584
2017,11,19,11,1115,1182,2752,1570
2017,11,19,12,1125,1193,2784,1591
2017,11,19,13,1155,1215,2803,1588
2017,11,19,14,1220,1277,2834,1557
2017,11,19,15,1265,1334,2781,1447
2017,11,19,16,1290,1370,2786,1416
2017,11,19,17,1300,1387,2805,1418
2017,11,19,18,1295,1391,2805,1414
2017,11,19,19,1275,1373,2808,1435
2017,11,19,20,1260,1364,2807,1443
2017,11,19,21,1255,1337,2806,1469
2017,11,19,22,1245,1336,2789,1453
2017,11,19,23,1265,1334,2777,1443
2017,11,20,0,1315,1388,2805,1417
2017,11,20,1,1395,1492,2820,1328
2017,11,20,2,1400,1491,2780,1289
2017,11,20,3,1380,1464,2813,1349
2017,11,20,4,1355,1408,2823,1415
2017,11,20,5,1265,1359,2800,1441
2017,11,20,6,1200,1263,2740,1477
2017,11,20,7,1135,1211,2805,1594
2017,11,20,8,1045,1158,2695,1537
2017,11,20,9,1030,1125,2493,1368
2017,11,20,10,1025,1127,2485,1358
2017,11,20,11,1035,1125,2492,1367
2017,11,20,12,1055,1129,2458,1329
2017,11,20,13,1115,1201,2493,1292
2017,11,20,14,1235,1333,2531,1198
2017,11,20,15,1335,1423,2535,1112
2017,11,20,16,1335,1396,2523,1127
2017,11,20,17,1320,1405,2581,1176
2017,11,20,18,1300,1394,2582,1188
2017,11,20,19,1285,1393,2578,1185
2017,11,20,20,1260,1373,2560,1187
2017,11,20,21,1255,1370,2557,1187
2017,11,20,22,1235,1369,2563,1194
2017,11,20,23,1230,1379,2552,1173
2017,11,21,0,1255,1418,2522,1104
2017,11,21,1,1300,1471,2486,1015
2017,11,21,2,1350,1461,2472,1011
2017,11,21,3,1355,1464,2505,1041
2017,11,21,4,1335,1439,2525,1086
2017,11,21,5,1295,1371,2512,1141
2017,11,21,6,1200,1267,2520,1253
2017,11,21,7,1135,1197,2484,1287
2017,11,21,8,1115,1159,2447,1288
2017,11,21,9,1090,1134,2369,1235
2017,11,21,10,1085,1134,2327,1193
2017,11,21,11,1090,1136,2325,1189
2017,11,21,12,1100,1163,2379,1216
2017,11,21,13,1145,1214,2420,1206
2017,11,21,14,1260,1340,2425,1085
2017,11,21,15,1350,1419,2468,1049
2017,11,21,16,1370,1407,2470,1063
2017,11,21,17,1375,1402,2452,1050
2017,11,21,18,1375,1369,2480,1111
2017,11,21,19,1355,1352,2503,1151
2017,11,21,20,1345,1336,2511,1175
2017,11,21,21,1320,1328,2553,1225
2017,11,21,22,1310,1336,2615,1279
2017,11,21,23,1310,1362,2732,1370
2017,11,22,0,1355,1408,2768,1360
2017,11,22,1,1435,1459,2787,1328
2017,11,22,2,1440,1465,2753,1288
2017,11,22,3,1415,1448,2736,1288
2017,11,22,4,1380,1424,2737,1313
2017,11,22,5,1310,1358,2747,1389
2017,11,22,6,1235,1275,2759,1484
2017,11,22,7,1170,1195,2649,1454
2017,11,22,8,995,1152,2635,1483
2017,11,22,9,970,1139,2635,1496
2017,11,22,10,980,1125,2617,1492
2017,11,22,11,970,1123,2609,1486
2017,11,22,12,985,1143,2624,1481
2017,11,22,13,1045,1189,2617,1428
2017,11,22,14,1205,1284,2613,1329
2017,11,22,15,1330,1369,2677,1308
2017,11,22,16,1325,1387,2670,1283
2017,11,22,17,1295,1394,2663,1269
2017,11,22,18,1295,1387,2661,1274
2017,11,22,19,1270,1371,2628,1257
2017,11,22,20,1250,1354,2654,1300
2017,11,22,21,1245,1333,2642,1309
2017,11,22,22,1235,1325,2636,1311
2017,11,22,23,1240,1313,2639,1326
2017,11,23,0,1270,1352,2716,1364
2017,11,23,1,1295,1411,2772,1361
2017,11,23,2,1330,1388,2779,1391
2017,11,23,3,1315,1371,2767,1396
2017,11,23,4,1305,1346,2780,1434
2017,11,23,5,1250,1277,2765,1488
2017,11,23,6,1155,1224,2782,1558
2017,11,23,7,1085,1166,2555,1389
2017,11,23,8,1015,1113,2474,1361
2017,11,23,9,1005,1100,2470,1370
2017,11,23,10,1000,1099,2420,1321
2017,11,23,11,990,1090,2370,1280
2017,11,23,12,1010,1086,2388,1302
2017,11,23,13,1065,1086,2429,1343
2017,11,23,14,1205,1125,2417,1292
2017,11,23,15,1270,1200,2476,1276
2017,11,23,16,1255,1247,2479,1232
2017,11,23,17,1250,1310,2573,1263
2017,11,23,18,1250,1332,2579,1247
2017,11,23,19,1230,1337,2690,1353
2017,11,23,20,1215,1329,2671,1342
2017,11,23,21,1205,1278,2662,1384
2017,11,23,22,1195,1253,2646,1393
2017,11,23,23,1210,1217,2599,1382
2017,11,24,0,1230,1214,2561,1347
2017,11,24,1,1295,1220,2375,1155
2017,11,24,2,1300,1196,2282,1086
2017,11,24,3,1285,1194,2401,1207
2017,11,24,4,1260,1180,2377,1197
2017,11,24,5,1215,1184,2287,1103
2017,11,24,6,1125,1115,2227,1112
2017,11,24,7,1065,1077,2170,1093
2017,11,24,8,1130,1061,2099,1038
2017,11,24,9,1105,1065,2158,1093
2017,11,24,10,1100,1047,2149,1102
2017,11,24,11,1100,1043,2058,1015
2017,11,24,12,1115,1054,2226,1172
2017,11,24,13,1170,1102,2292,1190
2017,11,24,14,1310,1152,2351,1199
2017,11,24,15,1410,1221,2456,1235
2017,11,24,16,1410,1231,2501,1270
2017,11,24,17,1410,1242,2625,1383
2017,11,24,18,1395,1249,2672,1423
2017,11,24,19,1375,1237,2487,1250
2017,11,24,20,1360,1226,2444,1218
2017,11,24,21,1360,1223,2451,1228
2017,11,24,22,1365,1212,2487,1275
2017,11,24,23,1370,1227,2601,1374
2017,11,25,0,1420,1256,2654,1398
2017,11,25,1,1485,1351,2692,1341
2017,11,25,2,1485,1350,2658,1308
2017,11,25,3,1460,1337,2679,1342
2017,11,25,4,1430,1314,2694,1380
2017,11,25,5,1400,1276,2661,1385
2017,11,25,6,1300,1220,2665,1445
2017,11,25,7,1225,1176,2716,1540
2017,11,25,8,1220,1133,2677,1544
2017,11,25,9,1200,1111,2480,1369
2017,11,25,10,1190,1110,2513,1403
2017,11,25,11,1195,1128,2553,1425
2017,11,25,12,1200,1133,2525,1392
2017,11,25,13,1230,1164,2715,1551
2017,11,25,14,1230,1214,2725,1511
2017,11,25,15,1220,1273,2742,1469
2017,11,25,16,1245,1316,2736,1420
2017,11,25,17,1255,1333,2735,1402
2017,11,25,18,1245,1316,2732,1416
2017,11,25,19,1235,1303,2742,1439
2017,11,25,20,1210,1293,2736,1443
2017,11,25,21,1190,1271,2717,1446
2017,11,25,22,1180,1240,2665,1425
2017,11,25,23,1190,1249,2625,1376
2017,11,26,0,1230,1313,2604,1291
2017,11,26,1,1305,1394,2629,1235
2017,11,26,2,1305,1390,2613,1223
2017,11,26,3,1290,1349,2571,1222
2017,11,26,4,1265,1329,2566,1237
2017,11,26,5,1220,1274,2578,1304
2017,11,26,6,1160,1197,2568,1371
2017,11,26,7,1115,1140,2539,1399
2017,11,26,8,1015,1101,2522,1421
2017,11,26,9,990,1079,2494,1415
2017,11,26,10,985,1073,2561,1488
2017,11,26,11,975,1072,2597,1525
2017,11,26,12,995,1086,2599,1513
2017,11,26,13,1005,1125,2599,1474
2017,11,26,14,1085,1155,2593,1438
2017,11,26,15,1135,1201,2556,1355
2017,11,26,16,1170,1235,2570,1335
2017,11,26,17,1175,1272,2598,1326
2017,11,26,18,1175,1271,2602,1331
2017,11,26,19,1170,1266,2594,1328
2017,11,26,20,1160,1274,2622,1348
2017,11,26,21,1150,1273,2634,1361
2017,11,26,22,1165,1267,2639,1372
2017,11,26,23,1165,1273,2643,1370
2017,11,27,0,1210,1342,2637,1295
2017,11,27,1,1300,1413,2668,1255
2017,11,27,2,1300,1409,2660,1251
2017,11,27,3,1275,1370,2647,1277
2017,11,27,4,1240,1350,2717,1367
2017,11,27,5,1180,1291,2751,1460
2017,11,27,6,1105,1204,2709,1505
2017,11,27,7,1045,1137,2528,1391
2017,11,27,8,1130,1094,2483,1389
2017,11,27,9,1110,1064,2432,1368
2017,11,27,10,1110,1052,2244,1192
2017,11,27,11,1110,1041,2217,1176
2017,11,27,12,1130,1072,2293,1221
2017,11,27,13,1190,1128,2535,1407
2017,11,27,14,1330,1269,2667,1398
2017,11,27,15,1415,1355,2729,1374
2017,11,27,16,1395,1359,2688,1329
2017,11,27,17,1395,1381,2732,1351
2017,11,27,18,1375,1398,2746,1348
2017,11,27,19,1355,1388,2747,1359
2017,11,27,20,1340,1392,2748,1356
2017,11,27,21,1335,1389,2782,1393
2017,11,27,22,1335,1382,2786,1404
2017,11,27,23,1340,1379,2710,1331
2017,11,28,0,1390,1428,2714,1286
2017,11,28,1,1455,1500,2687,1187
2017,11,28,2,1455,1508,2742,1234
2017,11,28,3,1435,1465,2727,1262
2017,11,28,4,1410,1423,2698,1275
2017,11,28,5,1350,1357,2458,1101
2017,11,28,6,1250,1255,2278,1023
2017,11,28,7,1175,1210,2224,1014
2017,11,28,8,1105,1167,2125,958
2017,11,28,9,1085,1153,2273,1120
2017,11,28,10,1080,1149,2309,1160
2017,11,28,11,1085,1148,2299,1151
2017,11,28,12,1105,1174,2318,1144
2017,11,28,13,1155,1241,2307,1066
2017,11,28,14,1255,1382,2385,1003
2017,11,28,15,1330,1482,2725,1243
2017,11,28,16,1330,1458,2748,1290
2017,11,28,17,1340,1427,2740,1313
2017,11,28,18,1320,1425,2781,1356
2017,11,28,19,1305,1389,2774,1385
2017,11,28,20,1295,1359,2773,1414
2017,11,28,21,1290,1341,2766,1425
2017,11,28,22,1295,1325,2735,1410
2017,11,28,23,1305,1324,2686,1362
2017,11,29,0,1360,1376,2661,1285
2017,11,29,1,1420,1457,2701,1244
2017,11,29,2,1425,1475,2690,1215
2017,11,29,3,1400,1464,2672,1208
2017,11,29,4,1375,1433,2410,977
2017,11,29,5,1315,1355,2195,840
2017,11,29,6,1230,1272,2180,908
2017,11,29,7,1155,1208,2151,943
2017,11,29,8,1140,1170,2043,873
2017,11,29,9,1115,1151,2065,914
2017,11,29,10,1105,1137,2131,994
2017,11,29,11,1105,1134,2033,899
2017,11,29,12,1130,1181,2228,1047
2017,11,29,13,1190,1238,2302,1064
2017,11,29,14,1305,1386,2401,1015
2017,11,29,15,1395,1482,2719,1237
2017,11,29,16,1390,1481,2769,1288
2017,11,29,17,1390,1473,2792,1319
2017,11,29,18,1390,1449,2767,1318
2017,11,29,19,1360,1418,2767,1349
2017,11,29,20,1345,1398,2766,1368
2017,11,29,21,1335,1391,2803,1412
2017,11,29,22,1325,1402,2820,1418
2017,11,29,23,1320,1403,2843,1440
2017,11,30,0,1360,1456,2805,1349
2017,11,30,1,1430,1533,2799,1266
2017,11,30,2,1430,1527,2771,1244
2017,11,30,3,1405,1510,2801,1291
2017,11,30,4,1370,1483,2698,1215
2017,11,30,5,1300,1407,2390,983
2017,11,30,6,1230,1306,2278,972
2017,11,30,7,1165,1249,2285,1036
2017,11,30,8,1125,1220,2270,1050
2017,11,30,9,1100,1205,2274,1069
2017,11,30,10,1100,1190,2269,1079
2017,11,30,11,1100,1206,2282,1076
2017,11,30,12,1125,1220,2289,1069
2017,11,30,13,1180,1283,2327,1044
2017,11,30,14,1315,1401,2345,944
2017,11,30,15,1400,1524,2704,1180
2017,11,30,16,1385,1489,2733,1244
2017,11,30,17,1375,1471,2726,1255
2017,11,30,18,1355,1472,2775,1303
2017,11,30,19,1335,1444,2770,1326
2017,11,30,20,1310,1428,2768,1340
2017,11,30,21,1305,1398,2752,1354
2017,11,30,22,1305,1384,2761,1377
2017,11,30,23,1320,1405,2757,1352
2017,12,1,0,1370,1456,2769,1313
2017,12,1,1,1430,1526,2784,1258
2017,12,1,2,1435,1514,2746,1232
2017,12,1,3,1420,1495,2748,1253
2017,12,1,4,1395,1466,2795,1329
2017,12,1,5,1335,1385,2695,1310
2017,12,1,6,1245,1295,2709,1414
2017,12,1,7,1170,1246,2727,1481
2017,12,1,8,1135,1186,2702,1516
2017,12,1,9,1120,1171,2712,1541
2017,12,1,10,1105,1166,2705,1539
2017,12,1,11,1105,1158,2648,1490
2017,12,1,12,1120,1193,2602,1409
2017,12,1,13,1175,1240,2705,1465
2017,12,1,14,1285,1359,2737,1378
2017,12,1,15,1380,1462,2782,1320
2017,12,1,16,1385,1461,2730,1269
2017,12,1,17,1390,1441,2700,1259
2017,12,1,18,1385,1405,2732,1327
2017,12,1,19,1365,1396,2871,1475
2017,12,1,20,1355,1367,2879,1512
2017,12,1,21,1350,1357,2871,1514
2017,12,1,22,1355,1343,2876,1533
2017,12,1,23,1355,1344,2647,1303
2017,12,2,0,1405,1365,2553,1188
2017,12,2,1,1485,1452,2579,1127
2017,12,2,2,1485,1431,2611,1180
2017,12,2,3,1460,1419,2709,1290
2017,12,2,4,1430,1402,2786,1384
2017,12,2,5,1400,1349,2766,1417
2017,12,2,6,1305,1282,2796,1514
2017,12,2,7,1245,1242,2796,1554
2017,12,2,8,1155,1180,2776,1596
2017,12,2,9,1135,1149,2825,1676
2017,12,2,10,1130,1143,2803,1660
2017,12,2,11,1140,1146,2789,1643
2017,12,2,12,1140,1145,2726,1581
2017,12,2,13,1175,1181,2717,1536
2017,12,2,14,1245,1254,2701,1447
2017,12,2,15,1320,1336,2689,1353
2017,12,2,16,1335,1364,2603,1239
2017,12,2,17,1340,1386,2588,1202
2017,12,2,18,1335,1369,2591,1222
2017,12,2,19,1325,1370,2617,1247
2017,12,2,20,1305,1365,2638,1273
2017,12,2,21,1285,1335,2632,1297
2017,12,2,22,1275,1326,2603,1277
2017,12,2,23,1275,1346,2579,1233
2017,12,3,0,1325,1384,2588,1204
2017,12,3,1,1405,1419,2698,1279
2017,12,3,2,1400,1419,2683,1264
2017,12,3,3,1375,1400,2657,1257
2017,12,3,4,1340,1388,2651,1263
2017,12,3,5,1300,1337,2643,1306
2017,12,3,6,1225,1263,2636,1373
2017,12,3,7,1170,1196,2589,1393
2017,12,3,8,1165,1181,2654,1473
2017,12,3,9,1145,1170,2657,1487
2017,12,3,10,1135,1178,2644,1466
2017,12,3,11,1150,1153,2624,1471
2017,12,3,12,1150,1159,2638,1479
2017,12,3,13,1185,1155,2624,1469
2017,12,3,14,1245,1216,2610,1394
2017,12,3,15,1300,1302,2673,1371
2017,12,3,16,1315,1344,2682,1338
2017,12,3,17,1325,1347,2667,1320
2017,12,3,18,1320,1370,2671,1301
2017,12,3,19,1300,1400,2714,1314
2017,12,3,20,1285,1398,2760,1362
2017,12,3,21,1265,1382,2791,1409
2017,12,3,22,1255,1386,2731,1345
2017,12,3,23,1270,1406,2722,1316
2017,12,4,0,1325,1490,2778,1288
2017,12,4,1,1415,1591,2842,1251
2017,12,4,2,1415,1574,2819,1245
2017,12,4,3,1390,1522,2798,1276
2017,12,4,4,1365,1482,2866,1384
2017,12,4,5,1285,1420,2859,1439
2017,12,4,6,1205,1329,2856,1527
2017,12,4,7,1150,1248,2757,1509
2017,12,4,8,1180,1211,2715,1504
2017,12,4,9,1160,1190,2668,1478
2017,12,4,10,1140,1164,2663,1499
2017,12,4,11,1150,1160,2656,1496
2017,12,4,12,1170,1199,2728,1529
2017,12,4,13,1235,1265,2683,1418
2017,12,4,14,1345,1396,2731,1335
2017,12,4,15,1450,1503,2780,1277
2017,12,4,16,1440,1497,2786,1289
2017,12,4,17,1440,1500,2772,1272
2017,12,4,18,1420,1481,2746,1265
2017,12,4,19,1395,1474,2776,1302
2017,12,4,20,1385,1450,2758,1308
2017,12,4,21,1380,1433,2760,1327
2017,12,4,22,1370,1424,2777,1353
2017,12,4,23,1385,1438,2791,1353
2017,12,5,0,1440,1520,2826,1306
2017,12,5,1,1515,1608,2875,1267
2017,12,5,2,1510,1606,2871,1265
2017,12,5,3,1485,1574,2854,1280
2017,12,5,4,1450,1547,2835,1288
2017,12,5,5,1390,1464,2869,1405
2017,12,5,6,1295,1375,2888,1513
2017,12,5,7,1220,1293,2871,1578
2017,12,5,8,1180,1251,2798,1547
2017,12,5,9,1165,1234,2893,1659
2017,12,5,10,1155,1224,2930,1706
2017,12,5,11,1155,1227,2912,1685
2017,12,5,12,1170,1256,2911,1655
2017,12,5,13,1220,1330,2912,1582
2017,12,5,14,1320,1440,2923,1483
2017,12,5,15,1420,1534,2956,1422
2017,12,5,16,1405,1529,2974,1445
2017,12,5,17,1400,1501,2961,1460
2017,12,5,18,1405,1483,2980,1497
2017,12,5,19,1390,1468,2975,1507
2017,12,5,20,1380,1445,2928,1483
2017,12,5,21,1355,1415,2918,1503
2017,12,5,22,1345,1412,2874,1462
2017,12,5,23,1365,1430,2849,1419
2017,12,6,0,1425,1481,2858,1377
2017,12,6,1,1510,1578,2853,1275
2017,12,6,2,1495,1578,2843,1265
2017,12,6,3,1470,1574,2859,1285
2017,12,6,4,1440,1539,2888,1349
2017,12,6,5,1360,1468,2940,1472
2017,12,6,6,1275,1362,2928,1566
2017,12,6,7,1210,1294,2915,1621
2017,12,6,8,1145,1251,2912,1661
2017,12,6,9,1125,1246,2881,1635
2017,12,6,10,1105,1241,2883,1642
2017,12,6,11,1105,1244,2891,1647
2017,12,6,12,1145,1282,2939,1657
2017,12,6,13,1205,1328,2912,1584
2017,12,6,14,1340,1458,2905,1447
2017,12,6,15,1435,1552,2955,1403
2017,12,6,16,1430,1543,2959,1416
2017,12,6,17,1430,1511,2962,1451
2017,12,6,18,1410,1470,2945,1475
2017,12,6,19,1390,1447,2923,1476
2017,12,6,20,1375,1414,2919,1505
2017,12,6,21,1360,1410,2923,1513
2017,12,6,22,1360,1394,2879,1485
2017,12,6,23,1365,1409,2886,1477
2017,12,7,0,1435,1472,2885,1413
2017,12,7,1,1515,1438,2744,1306
2017,12,7,2,1510,1565,2923,1358
2017,12,7,3,1490,1558,2959,1401
2017,12,7,4,1460,1518,2919,1401
2017,12,7,5,1380,1456,2883,1427
2017,12,7,6,1295,1375,2904,1529
2017,12,7,7,1220,1299,2864,1565
2017,12,7,8,1215,1253,2882,1629
2017,12,7,9,1205,1241,2827,1586
2017,12,7,10,1200,1233,2854,1621
2017,12,7,11,1205,1228,2853,1625
2017,12,7,12,1250,1258,2873,1615
2017,12,7,13,1290,1310,2883,1573
2017,12,7,14,1395,1436,2942,1506
2017,12,7,15,1475,1529,2996,1467
2017,12,7,16,1465,1536,2958,1422
2017,12,7,17,1455,1515,2967,1452
2017,12,7,18,1450,1484,2967,1483
2017,12,7,19,1435,1447,2954,1507
2017,12,7,20,1415,1433,2981,1548
2017,12,7,21,1385,1414,2980,1566
2017,12,7,22,1370,1388,2975,1587
2017,12,7,23,1380,1390,2963,1573
2017,12,8,0,1430,1329,2873,1544
2017,12,8,1,1500,1437,2898,1461
2017,12,8,2,1490,1426,2864,1438
2017,12,8,3,1480,1426,2866,1440
2017,12,8,4,1450,1403,2859,1456
2017,12,8,5,1370,1468,2997,1529
2017,12,8,6,1290,1388,2956,1568
2017,12,8,7,1230,1307,2896,1589
2017,12,8,8,1190,1274,2895,1621
2017,12,8,9,1180,1264,2934,1670
2017,12,8,10,1175,1253,2918,1665
2017,12,8,11,1185,1255,2952,1697
2017,12,8,12,1220,1267,2944,1677
2017,12,8,13,1275,1324,2963,1639
2017,12,8,14,1350,1443,3023,1580
2017,12,8,15,1435,1534,3009,1475
2017,12,8,16,1440,1518,2931,1413
2017,12,8,17,1430,1494,2969,1475
2017,12,8,18,1415,1467,2936,1469
2017,12,8,19,1395,1447,2973,1526
2017,12,8,20,1375,1410,2956,1546
2017,12,8,21,1375,1405,2957,1552
2017,12,8,22,1370,1393,2968,1575
2017,12,8,23,1375,1393,2967,1574
2017,12,9,0,1425,1458,2952,1494
2017,12,9,1,1475,1555,2987,1432
2017,12,9,2,1495,1548,2982,1434
2017,12,9,3,1475,1524,2936,1412
2017,12,9,4,1440,1506,2962,1456
2017,12,9,5,1410,1444,2947,1503
2017,12,9,6,1315,1394,2986,1592
2017,12,9,7,1250,1312,2927,1615
2017,12,9,8,1150,1294,2944,1650
2017,12,9,9,1135,1276,2951,1675
2017,12,9,10,1120,1275,2926,1651
2017,12,9,11,1125,1257,2936,1679
2017,12,9,12,1130,1277,2969,1692
2017,12,9,13,1160,1291,2976,1685
2017,12,9,14,1260,1354,2975,1621
2017,12,9,15,1355,1422,3020,1598
2017,12,9,16,1380,1459,3027,1568
2017,12,9,17,1385,1471,3021,1550
2017,12,9,18,1375,1465,3027,1562
2017,12,9,19,1370,1445,3010,1565
2017,12,9,20,1350,1412,3001,1589
2017,12,9,21,1325,1390,3000,1610
2017,12,9,22,1315,1373,3002,1629
2017,12,9,23,1320,1385,2996,1611
2017,12,10,0,1350,1463,3006,1543
2017,12,10,1,1420,1554,3038,1484
2017,12,10,2,1415,1552,3024,1472
2017,12,10,3,1400,1525,3020,1495
2017,12,10,4,1365,1504,3030,1526
2017,12,10,5,1325,1474,3053,1579
2017,12,10,6,1275,1406,3050,1644
2017,12,10,7,1215,1352,3013,1661
2017,12,10,8,1205,1310,2971,1661
2017,12,10,9,1175,1272,2959,1687
2017,12,10,10,1165,1262,2948,1686
2017,12,10,11,1175,1268,2956,1688
2017,12,10,12,1180,1275,2958,1683
2017,12,10,13,1200,1300,2935,1635
2017,12,10,14,1245,1346,2948,1602
2017,12,10,15,1285,1393,2931,1538
2017,12,10,16,1315,1438,2915,1477
2017,12,10,17,1330,1458,2909,1451
2017,12,10,18,1335,1464,2913,1449
2017,12,10,19,1320,1455,2917,1462
2017,12,10,20,1320,1441,2928,1487
2017,12,10,21,1295,1418,2946,1528
2017,12,10,22,1290,1390,2948,1558
2017,12,10,23,1300,1402,2942,1540
2017,12,11,0,1345,1483,2948,1465
2017,12,11,1,1445,1569,2938,1369
2017,12,11,2,1435,1578,2927,1349
2017,12,11,3,1405,1541,2916,1375
2017,12,11,4,1365,1538,2920,1382
2017,12,11,5,1285,1461,2915,1454
2017,12,11,6,1240,1353,2873,1520
2017,12,11,7,1175,1265,2840,1575
2017,12,11,8,1135,1234,2876,1642
2017,12,11,9,1115,1209,2877,1668
2017,12,11,10,1105,1213,2863,1650
2017,12,11,11,1110,1209,2837,1628
2017,12,11,12,1125,1233,2839,1606
2017,12,11,13,1190,1306,2798,1492
2017,12,11,14,1335,1443,2820,1377
2017,12,11,15,1450,1544,2916,1372
2017,12,11,16,1435,1527,2953,1426
2017,12,11,17,1435,1532,2936,1404
2017,12,11,18,1415,1463,2450,987
2017,12,11,19,1400,1416,1853,437
2017,12,11,20,1385,1390,1811,421
2017,12,11,21,1380,1376,1864,488
2017,12,11,22,1370,1361,1866,505
2017,12,11,23,1375,1357,1878,521
2017,12,12,0,1400,1432,1895,463
2017,12,12,1,1475,1535,1914,379
2017,12,12,2,1465,1545,1936,391
2017,12,12,3,1455,1543,1952,409
2017,12,12,4,1430,1526,2490,964
2017,12,12,5,1360,1482,2836,1354
2017,12,12,6,1300,1397,2958,1561
2017,12,12,7,1225,1323,2978,1655
2017,12,12,8,1170,1289,2955,1666
2017,12,12,9,1150,1265,2985,1720
2017,12,12,10,1145,1262,2984,1722
2017,12,12,11,1145,1276,3044,1768
2017,12,12,12,1170,1274,3047,1773
2017,12,12,13,1235,1344,3037,1693
2017,12,12,14,1365,1467,3012,1545
2017,12,12,15,1465,1554,3026,1472
2017,12,12,16,1455,1537,3027,1490
2017,12,12,17,1435,1509,3023,1514
2017,12,12,18,1430,1487,2995,1508
2017,12,12,19,1405,1473,2985,1512
2017,12,12,20,1380,1446,2951,1505
2017,12,12,21,1355,1441,2925,1484
2017,12,12,22,1340,1425,2919,1494
2017,12,12,23,1350,1441,2947,1506
2017,12,13,0,1405,1519,2973,1454
2017,12,13,1,1495,1570,2960,1390
2017,12,13,2,1505,1565,2959,1394
2017,12,13,3,1495,1535,2959,1424
2017,12,13,4,1465,1515,2946,1431
2017,12,13,5,1395,1440,2923,1483
2017,12,13,6,1300,1332,2897,1565
2017,12,13,7,1230,1254,2877,1623
2017,12,13,8,1190,1200,2844,1644
2017,12,13,9,1170,1190,2827,1637
2017,12,13,10,1160,1172,2791,1619
2017,12,13,11,1160,1199,2798,1599
2017,12,13,12,1200,1202,2799,1597
2017,12,13,13,1260,1257,2797,1540
2017,12,13,14,1400,1391,2853,1462
2017,12,13,15,1490,1484,2813,1329
2017,12,13,16,1480,1483,2811,1328
2017,12,13,17,1470,1487,2809,1322
2017,12,13,18,1440,1487,2786,1299
2017,12,13,19,1405,1494,2802,1308
2017,12,13,20,1385,1465,2785,1320
2017,12,13,21,1375,1431,2760,1329
2017,12,13,22,1375,1443,2789,1346
2017,12,13,23,1380,1464,2827,1363
2017,12,14,0,1440,1520,2831,1311
2017,12,14,1,1500,1599,2882,1283
2017,12,14,2,1525,1582,2780,1198
2017,12,14,3,1510,1572,2635,1063
2017,12,14,4,1485,1524,2462,938
2017,12,14,5,1415,1470,2504,1034
2017,12,14,6,1325,1364,2498,1134
2017,12,14,7,1260,1291,2616,1325
2017,12,14,8,1195,1246,2712,1466
2017,12,14,9,1185,1226,2816,1590
2017,12,14,10,1180,1234,2935,1701
2017,12,14,11,1185,1230,2927,1697
2017,12,14,12,1205,1244,2919,1675
2017,12,14,13,1265,1293,2920,1627
2017,12,14,14,1410,1421,2908,1487
2017,12,14,15,1525,1520,2903,1383
2017,12,14,16,1515,1492,2642,1150
2017,12,14,17,1495,1475,2529,1054
2017,12,14,18,1470,1454,2486,1032
2017,12,14,19,1440,1425,2563,1138
2017,12,14,20,1420,1392,2536,1144
2017,12,14,21,1405,1377,2413,1036
2017,12,14,22,1380,1379,2424,1045
2017,12,14,23,1390,1382,2439,1057
2017,12,15,0,1385,1472,2681,1209
2017,12,15,1,1475,1549,2779,1230
2017,12,15,2,1465,1555,2917,1362
2017,12,15,3,1455,1568,2981,1413
2017,12,15,4,1430,1566,3021,1455
2017,12,15,5,1395,1496,3027,1531
2017,12,15,6,1340,1421,3029,1608
2017,12,15,7,1265,1324,2955,1631
2017,12,15,8,1195,1281,2904,1623
2017,12,15,9,1180,1263,2860,1597
2017,12,15,10,1170,1241,2848,1607
2017,12,15,11,1175,1240,2837,1597
2017,12,15,12,1190,1275,2861,1586
2017,12,15,13,1245,1315,2865,1550
2017,12,15,14,1380,1447,2947,1500
2017,12,15,15,1480,1550,3009,1459
2017,12,15,16,1475,1553,3030,1477
2017,12,15,17,1450,1548,3028,1480
2017,12,15,18,1430,1538,3012,1474
2017,12,15,19,1415,1509,3023,1514
2017,12,15,20,1385,1499,2989,1490
2017,12,15,21,1370,1465,2927,1462
2017,12,15,22,1365,1471,3001,1530
2017,12,15,23,1375,1458,2966,1508
2017,12,16,0,1430,1494,2932,1438
2017,12,16,1,1520,1541,2970,1429
2017,12,16,2,1510,1523,2943,1420
2017,12,16,3,1490,1486,2901,1415
2017,12,16,4,1465,1462,2912,1450
2017,12,16,5,1405,1401,2905,1504
2017,12,16,6,1335,1335,2887,1552
2017,12,16,7,1265,1270,2778,1508
2017,12,16,8,1230,1227,2758,1531
2017,12,16,9,1215,1202,2734,1532
2017,12,16,10,1200,1260,2730,1470
2017,12,16,11,1195,1268,2713,1445
2017,12,16,12,1195,1251,2729,1478
2017,12,16,13,1225,1244,2712,1468
2017,12,16,14,1285,1289,2705,1416
2017,12,16,15,1345,1391,2834,1443
2017,12,16,16,1390,1415,2824,1409
2017,12,16,17,1410,1422,2824,1402
2017,12,16,18,1410,1422,2828,1406
2017,12,16,19,1390,1413,2826,1413
2017,12,16,20,1370,1414,2851,1437
2017,12,16,21,1350,1386,2842,1456
2017,12,16,22,1330,1379,2833,1454
2017,12,16,23,1340,1402,2832,1430
2017,12,17,0,1415,1451,2839,1388
2017,12,17,1,1525,1530,2884,1354
2017,12,17,2,1520,1515,2883,1368
2017,12,17,3,1500,1489,2884,1395
2017,12,17,4,1470,1470,2887,1417
2017,12,17,5,1440,1418,2878,1460
2017,12,17,6,1350,1385,2904,1519
2017,12,17,7,1270,1310,2865,1555
2017,12,17,8,1235,1276,2822,1546
2017,12,17,9,1205,1255,2710,1455
2017,12,17,10,1200,1249,2661,1412
2017,12,17,11,1205,1261,2683,1422
2017,12,17,12,1220,1283,2696,1413
2017,12,17,13,1230,1305,2628,1323
2017,12,17,14,1270,1355,2685,1330
2017,12,17,15,1325,1425,2693,1268
2017,12,17,16,1380,1476,2708,1232
2017,12,17,17,1400,1481,2729,1248
2017,12,17,18,1405,1474,2704,1230
2017,12,17,19,1390,1447,2703,1256
2017,12,17,20,1385,1463,2725,1262
2017,12,17,21,1360,1454,2735,1281
2017,12,17,22,1345,1430,2739,1309
2017,12,17,23,1360,1469,2732,1263
2017,12,18,0,1425,1527,2737,1210
2017,12,18,1,1515,1603,2735,1132
2017,12,18,2,1530,1592,2721,1129
2017,12,18,3,1500,1554,2728,1174
2017,12,18,4,1480,1528,2739,1211
2017,12,18,5,1425,1468,2722,1254
2017,12,18,6,1310,1369,2686,1317
2017,12,18,7,1235,1297,2708,1411
2017,12,18,8,1195,1241,2553,1312
2017,12,18,9,1160,1221,2640,1419
2017,12,18,10,1140,1207,2427,1220
2017,12,18,11,1150,1208,2601,1393
2017,12,18,12,1185,1226,2616,1390
2017,12,18,13,1250,1298,2693,1395
2017,12,18,14,1360,1411,2707,1296
2017,12,18,15,1455,1518,2701,1183
2017,12,18,16,1445,1489,2626,1137
2017,12,18,17,1450,1485,2585,1100
2017,12,18,18,1420,1469,2608,1139
2017,12,18,19,1400,1309,2506,1197
2017,12,18,20,1375,1284,2535,1251
2017,12,18,21,1370,1418,2696,1278
2017,12,18,22,1360,1392,2696,1304
2017,12,18,23,1360,1396,2704,1308
2017,12,19,0,1425,1452,2676,1224
2017,12,19,1,1515,1512,2675,1163
2017,12,19,2,1525,1508,2648,1140
2017,12,19,3,1510,1488,2635,1147
2017,12,19,4,1480,1472,2637,1165
2017,12,19,5,1425,1404,2640,1236
2017,12,19,6,1335,1318,2606,1288
2017,12,19,7,1255,1245,2522,1277
2017,12,19,8,1160,1205,2529,1324
2017,12,19,9,1140,1171,2501,1330
2017,12,19,10,1135,1162,2484,1322
2017,12,19,11,1145,1170,2472,1302
2017,12,19,12,1155,1175,2480,1305
2017,12,19,13,1215,1246,2536,1290
2017,12,19,14,1360,1366,2564,1198
2017,12,19,15,1475,1468,2582,1114
2017,12,19,16,1475,1473,2558,1085
2017,12,19,17,1450,1459,2563,1104
2017,12,19,18,1435,1470,2570,1100
2017,12,19,19,1415,1450,2581,1131
2017,12,19,20,1400,1437,2569,1132
2017,12,19,21,1390,1445,2571,1126
2017,12,19,22,1375,1438,2568,1130
2017,12,19,23,1400,1456,2551,1095
2017,12,20,0,1465,1495,2524,1029
2017,12,20,1,1530,1554,2547,993
2017,12,20,2,1525,1545,2613,1068
2017,12,20,3,1500,1522,2616,1094
2017,12,20,4,1470,1500,2587,1087
2017,12,20,5,1395,1436,2570,1134
2017,12,20,6,1295,1347,2565,1218
2017,12,20,7,1225,1259,2488,1229
2017,12,20,8,1240,1216,2492,1276
2017,12,20,9,1225,1202,2504,1302
2017,12,20,10,1220,1192,2506,1314
2017,12,20,11,1225,1205,2501,1296
2017,12,20,12,1250,1233,2516,1283
2017,12,20,13,1305,1317,2562,1245
2017,12,20,14,1420,1437,2585,1148
2017,12,20,15,1500,1547,2698,1151
2017,12,20,16,1490,1542,2727,1185
2017,12,20,17,1470,1531,2709,1178
2017,12,20,18,1450,1546,2744,1198
2017,12,20,19,1405,1524,2712,1188
2017,12,20,20,1380,1509,2699,1190
2017,12,20,21,1395,1535,2734,1199
2017,12,20,22,1390,1548,2766,1218
2017,12,20,23,1410,1554,2710,1156
2017,12,21,0,1475,1598,2738,1140
2017,12,21,1,1495,1665,2722,1057
2017,12,21,2,1545,1676,2700,1024
2017,12,21,3,1535,1650,2689,1039
2017,12,21,4,1500,1615,2697,1082
2017,12,21,5,1435,1559,2672,1113
2017,12,21,6,1345,1475,2673,1198
2017,12,21,7,1265,1376,2642,1266
2017,12,21,8,1240,1340,2702,1362
2017,12,21,9,1215,1312,2729,1417
2017,12,21,10,1205,1319,2737,1418
2017,12,21,11,1200,1324,2759,1435
2017,12,21,12,1225,1347,2772,1425
2017,12,21,13,1290,1409,2880,1471
2017,12,21,14,1415,1532,2932,1400
2017,12,21,15,1505,1625,2948,1323
2017,12,21,16,1490,1620,2952,1332
2017,12,21,17,1475,1624,2855,1231
2017,12,21,18,1455,1595,2882,1287
2017,12,21,19,1440,1577,2929,1352
2017,12,21,20,1420,1540,2903,1363
2017,12,21,21,1405,1518,2877,1359
2017,12,21,22,1415,1519,2905,1386
2017,12,21,23,1410,1521,2923,1402
2017,12,22,0,1485,1579,2928,1349
2017,12,22,1,1570,1650,2940,1290
2017,12,22,2,1560,1651,2923,1272
2017,12,22,3,1535,1644,2943,1299
2017,12,22,4,1510,1609,2959,1350
2017,12,22,5,1440,1544,2939,1395
2017,12,22,6,1360,1481,2902,1421
2017,12,22,7,1270,1407,2862,1455
2017,12,22,8,1295,1357,2870,1513
2017,12,22,9,1280,1344,2872,1528
2017,12,22,10,1265,1342,2881,1539
2017,12,22,11,1270,1339,2886,1547
2017,12,22,12,1300,1350,2863,1513
2017,12,22,13,1365,1388,2850,1462
2017,12,22,14,1490,1492,2905,1413
2017,12,22,15,1615,1570,2795,1225
2017,12,22,16,1605,1580,2810,1230
2017,12,22,17,1595,1592,2868,1276
2017,12,22,18,1590,1579,2848,1269
2017,12,22,19,1555,1562,2826,1264
2017,12,22,20,1540,1555,2863,1308
2017,12,22,21,1520,1542,2842,1300
2017,12,22,22,1525,1536,2842,1306
2017,12,22,23,1530,1535,2830,1295
2017,12,23,0,1585,1580,2808,1228
2017,12,23,1,1655,1666,2840,1174
2017,12,23,2,1640,1647,2774,1127
2017,12,23,3,1590,1624,2765,1141
2017,12,23,4,1560,1598,2758,1160
2017,12,23,5,1500,1557,2753,1196
2017,12,23,6,1430,1481,2764,1283
2017,12,23,7,1360,1419,2775,1356
2017,12,23,8,1310,1361,2760,1399
2017,12,23,9,1300,1357,2765,1408
2017,12,23,10,1310,1332,2742,1410
2017,12,23,11,1315,1333,2729,1396
2017,12,23,12,1335,1334,2744,1410
2017,12,23,13,1370,1365,2734,1369
2017,12,23,14,1395,1431,2753,1322
2017,12,23,15,1435,1466,2745,1279
2017,12,23,16,1465,1521,2805,1284
2017,12,23,17,1495,1565,2840,1275
2017,12,23,18,1555,1545,2820,1275
2017,12,23,19,1595,1522,2769,1247
2017,12,23,20,1565,1504,2771,1267
2017,12,23,21,1540,1462,2760,1298
2017,12,23,22,1530,1470,2784,1314
2017,12,23,23,1545,1493,2801,1308
2017,12,24,0,1600,1562,2908,1346
2017,12,24,1,1640,1663,2941,1278
2017,12,24,2,1695,1675,2936,1261
2017,12,24,3,1655,1652,2942,1290
2017,12,24,4,1630,1635,2939,1304
2017,12,24,5,1585,1607,3002,1395
2017,12,24,6,1500,1546,3001,1455
2017,12,24,7,1410,1487,3019,1532
2017,12,24,8,1350,1427,2971,1544
2017,12,24,9,1330,1407,2973,1566
2017,12,24,10,1330,1396,2944,1548
2017,12,24,11,1340,1384,2948,1564
2017,12,24,12,1360,1397,2969,1572
2017,12,24,13,1410,1409,2969,1560
2017,12,24,14,1535,1449,2926,1477
2017,12,24,15,1625,1530,2869,1339
2017,12,24,16,1650,1588,2830,1242
2017,12,24,17,1670,1607,2863,1256
2017,12,24,18,1655,1582,2893,1311
2017,12,24,19,1655,1564,2882,1318
2017,12,24,20,1610,1536,2885,1349
2017,12,24,21,1595,1506,2889,1383
2017,12,24,22,1580,1495,2932,1437
2017,12,24,23,1595,1493,2960,1467
2017,12,25,0,1665,1534,2867,1333
2017,12,25,1,1750,1609,2855,1246
2017,12,25,2,1750,1578,2841,1263
2017,12,25,3,1725,1562,2915,1353
2017,12,25,4,1685,1545,2904,1359
2017,12,25,5,1640,1523,2916,1393
2017,12,25,6,1520,1479,2913,1434
2017,12,25,7,1440,1428,2947,1519
2017,12,25,8,1340,1369,2841,1472
2017,12,25,9,1310,1338,2827,1489
2017,12,25,10,1315,1325,2846,1521
2017,12,25,11,1315,1340,2837,1497
2017,12,25,12,1335,1358,2840,1482
2017,12,25,13,1410,1396,2837,1441
2017,12,25,14,1555,1440,2808,1368
2017,12,25,15,1620,1504,2745,1241
2017,12,25,16,1650,1552,2770,1218
2017,12,25,17,1665,1575,2825,1250
2017,12,25,18,1635,1555,2837,1282
2017,12,25,19,1565,1548,2842,1294
2017,12,25,20,1530,1526,2825,1299
2017,12,25,21,1555,1520,2842,1322
2017,12,25,22,1545,1501,2847,1346
2017,12,25,23,1550,1516,2839,1323
2017,12,26,0,1615,1539,2819,1280
2017,12,26,1,1695,1600,2822,1222
2017,12,26,2,1700,1596,2842,1246
2017,12,26,3,1675,1578,2859,1281
2017,12,26,4,1645,1578,2866,1288
2017,12,26,5,1585,1537,2828,1291
2017,12,26,6,1500,1474,2781,1307
2017,12,26,7,1415,1420,2829,1409
2017,12,26,8,1370,1393,2784,1391
2017,12,26,9,1340,1358,2787,1429
2017,12,26,10,1340,1355,2800,1445
2017,12,26,11,1345,1367,2815,1448
2017,12,26,12,1360,1385,2826,1441
2017,12,26,13,1435,1420,2817,1397
2017,12,26,14,1580,1491,2826,1335
2017,12,26,15,1700,1573,2825,1252
2017,12,26,16,1695,1608,2833,1225
2017,12,26,17,1690,1643,2837,1194
2017,12,26,18,1670,1620,2844,1224
2017,12,26,19,1645,1589,2853,1264
2017,12,26,20,1615,1569,2849,1280
2017,12,26,21,1600,1552,2838,1286
2017,12,26,22,1595,1544,2849,1305
2017,12,26,23,1610,1554,2859,1305
2017,12,27,0,1670,1610,2900,1290
2017,12,27,1,1745,1700,2932,1232
2017,12,27,2,1745,1700,2917,1217
2017,12,27,3,1725,1687,2922,1235
2017,12,27,4,1690,1659,2895,1236
2017,12,27,5,1655,1588,2852,1264
2017,12,27,6,1530,1506,2870,1364
2017,12,27,7,1440,1427,2830,1403
2017,12,27,8,1365,1390,2807,1417
2017,12,27,9,1340,1358,2804,1446
2017,12,27,10,1340,1348,2810,1462
2017,12,27,11,1350,1343,2830,1487
2017,12,27,12,1370,1364,2860,1496
2017,12,27,13,1445,1398,2867,1469
2017,12,27,14,1575,1489,2902,1413
2017,12,27,15,1685,1566,2910,1344
2017,12,27,16,1680,1601,2919,1318
2017,12,27,17,1675,1615,2914,1299
2017,12,27,18,1660,1614,2948,1334
2017,12,27,19,1640,1611,2962,1351
2017,12,27,20,1610,1602,2979,1377
2017,12,27,21,1600,1578,2962,1384
2017,12,27,22,1600,1572,2970,1398
2017,12,27,23,1615,1582,2973,1391
2017,12,28,0,1675,1630,2994,1364
2017,12,28,1,1750,1694,2967,1273
2017,12,28,2,1755,1699,2915,1216
2017,12,28,3,1740,1681,2886,1205
2017,12,28,4,1700,1648,2862,1214
2017,12,28,5,1685,1584,2899,1315
2017,12,28,6,1545,1497,2913,1416
2017,12,28,7,1455,1410,2854,1444
2017,12,28,8,1330,1356,2878,1522
2017,12,28,9,1305,1335,2915,1580
2017,12,28,10,1295,1317,2927,1610
2017,12,28,11,1300,1327,2931,1604
2017,12,28,12,1315,1334,2922,1588
2017,12,28,13,1350,1380,2847,1467
2017,12,28,14,1440,1473,2812,1339
2017,12,28,15,1515,1546,2821,1275
2017,12,28,16,1535,1589,2836,1247
2017,12,28,17,1540,1602,2818,1216
2017,12,28,18,1565,1611,2839,1228
2017,12,28,19,1540,1591,2846,1255
2017,12,28,20,1510,1580,2828,1248
2017,12,28,21,1495,1558,2792,1234
2017,12,28,22,1485,1549,2781,1232
2017,12,28,23,1525,1549,2787,1238
2017,12,29,0,1565,1604,2799,1195
2017,12,29,1,1600,1668,2866,1198
2017,12,29,2,1590,1652,2892,1240
2017,12,29,3,1585,1618,2816,1198
2017,12,29,4,1560,1582,2820,1238
2017,12,29,5,1525,1524,2787,1263
2017,12,29,6,1420,1445,2784,1339
2017,12,29,7,1335,1367,2798,1431
2017,12,29,8,1330,1329,2871,1542
2017,12,29,9,1310,1317,2892,1575
2017,12,29,10,1305,1308,2904,1596
2017,12,29,11,1295,1315,2901,1586
2017,12,29,12,1315,1332,2906,1574
2017,12,29,13,1350,1374,2897,1523
2017,12,29,14,1450,1460,2910,1450
2017,12,29,15,1525,1540,2905,1365
2017,12,29,16,1545,1583,2896,1313
2017,12,29,17,1560,1604,2882,1278
2017,12,29,18,1550,1610,2867,1257
2017,12,29,19,1535,1614,2840,1226
2017,12,29,20,1525,1599,2830,1231
2017,12,29,21,1505,1587,2817,1230
2017,12,29,22,1500,1593,2814,1221
2017,12,29,23,1505,1596,2802,1206
2017,12,30,0,1550,1650,2835,1185
2017,12,30,1,1625,1729,2848,1119
2017,12,30,2,1615,1722,2849,1127
2017,12,30,3,1595,1685,2855,1170
2017,12,30,4,1565,1650,2851,1201
2017,12,30,5,1515,1600,2806,1206
2017,12,30,6,1430,1527,2795,1268
2017,12,30,7,1365,1465,2827,1362
2017,12,30,8,1305,1430,2825,1395
2017,12,30,9,1295,1406,2647,1241
2017,12,30,10,1280,1381,2738,1357
2017,12,30,11,1285,1378,2752,1374
2017,12,30,12,1290,1374,2756,1382
2017,12,30,13,1320,1406,2778,1372
2017,12,30,14,1385,1444,2780,1336
2017,12,30,15,1440,1523,2782,1259
2017,12,30,16,1485,1548,2770,1222
2017,12,30,17,1520,1585,2778,1193
2017,12,30,18,1510,1604,2790,1186
2017,12,30,19,1490,1598,2803,1205
2017,12,30,20,1480,1562,2714,1152
2017,12,30,21,1440,1546,2773,1227
2017,12,30,22,1445,1523,2702,1179
2017,12,30,23,1460,1518,2676,1158
2017,12,31,0,1525,1553,2193,640
2017,12,31,1,1615,1649,2015,366
2017,12,31,2,1615,1650,2117,467
2017,12,31,3,1590,1638,2300,662
2017,12,31,4,1565,1595,2445,850
2017,12,31,5,1535,1557,2654,1097
2017,12,31,6,1460,1475,2098,623
2017,12,31,7,1390,1419,1763,344
2017,12,31,8,1355,1373,2185,812
2017,12,31,9,1340,1360,2169,809
2017,12,31,10,1325,1349,2239,890
2017,12,31,11,1320,1352,2222,870
2017,12,31,12,1330,1365,2211,846
2017,12,31,13,1355,1409,2226,817
2017,12,31,14,1410,1486,2232,746
2017,12,31,15,1490,1554,2221,667
2017,12,31,16,1540,1601,2135,534
2017,12,31,17,1560,1631,2127,496
2017,12,31,18,1545,1628,2174,546
2017,12,31,19,1525,1613,2203,590
2017,12,31,20,1505,1594,2184,590
2017,12,31,21,1485,1573,2141,568
2017,12,31,22,1470,1565,2120,555
2017,12,31,23,1470,1568,2117,549
2018,1,1,0,1520,1613,2117,504
2018,1,1,1,1595,1700,2126,426
2018,1,1,2,1570,1689,2124,435
2018,1,1,3,1545,1664,2121,457
2018,1,1,4,1520,1642,2125,483
2018,1,1,5,1500,1614,2143,529
2018,1,1,6,1425,1581,2152,571
2018,1,1,7,-9999,1545,2163,618
2018,1,1,8,1335,1512,2185,673
2018,1,1,9,1305,1492,2209,717
2018,1,1,10,1300,1488,2216,728
2018,1,1,11,1290,1519,2298,779
2018,1,1,12,1305,1494,2264,770
2018,1,1,13,1335,1508,2262,754
2018,1,1,14,1410,1531,2243,712
2018,1,1,15,1485,1580,2252,672
2018,1,1,16,1515,1606,2250,644
2018,1,1,17,1525,1636,2229,593
2018,1,1,18,1545,1652,2265,613
2018,1,1,19,1540,1652,2256,604
2018,1,1,20,1515,1638,2254,616
2018,1,1,21,1510,1627,2256,629
2018,1,1,22,1495,1611,2260,649
2018,1,1,23,1500,1614,2276,662
2018,1,2,0,1540,1631,2371,740
2018,1,2,1,1605,1698,2369,671
2018,1,2,2,1605,1699,2401,702
2018,1,2,3,1580,1673,2419,746
2018,1,2,4,1555,1632,2543,911
2018,1,2,5,1485,1596,2647,1051
2018,1,2,6,1435,1507,2309,802
2018,1,2,7,1370,1444,2361,917
2018,1,2,8,1310,1356,2452,1096
2018,1,2,9,1285,1402,2607,1205
2018,1,2,10,1280,1398,2715,1317
2018,1,2,11,1270,1393,2707,1314
2018,1,2,12,1285,1412,2679,1267
2018,1,2,13,1315,1464,2732,1268
2018,1,2,14,1380,1575,2762,1187
2018,1,2,15,1455,1650,2756,1106
2018,1,2,16,1490,1649,2752,1103
2018,1,2,17,1510,1637,2749,1112
2018,1,2,18,1520,1644,2750,1106
2018,1,2,19,1515,1618,2746,1128
2018,1,2,20,1500,1583,2741,1158
2018,1,2,21,1475,1561,2755,1194
2018,1,2,22,1480,1555,2754,1199
2018,1,2,23,1485,1554,2771,1217
2018,1,3,0,1535,1598,2801,1203
2018,1,3,1,1615,1679,2809,1130
2018,1,3,2,1620,1695,2834,1139
2018,1,3,3,1600,1680,2825,1145
2018,1,3,4,1570,1630,2841,1211
2018,1,3,5,1455,1576,2898,1322
2018,1,3,6,1435,1492,2890,1398
2018,1,3,7,1365,1409,2729,1320
2018,1,3,8,1385,1368,2704,1336
2018,1,3,9,1360,1351,2757,1406
2018,1,3,10,1365,1331,2758,1427
2018,1,3,11,1380,1339,2895,1556
2018,1,3,12,1380,1355,2908,1553
2018,1,3,13,1410,1433,2942,1509
2018,1,3,14,1480,1532,2949,1417
2018,1,3,15,1565,1608,2960,1352
2018,1,3,16,1595,1614,2973,1359
2018,1,3,17,1610,1609,2979,1370
2018,1,3,18,1620,1592,2992,1400
2018,1,3,19,1615,1568,3001,1433
2018,1,3,20,1595,1557,2997,1440
2018,1,3,21,1580,1543,2985,1442
2018,1,3,22,1570,1538,2975,1437
2018,1,3,23,1575,1548,2979,1431
2018,1,4,0,1605,1578,3002,1424
2018,1,4,1,1670,1648,2994,1346
2018,1,4,2,1665,1637,2966,1329
2018,1,4,3,1640,1626,3000,1374
2018,1,4,4,1600,1596,2986,1390
2018,1,4,5,1565,1535,3008,1473
2018,1,4,6,1475,1464,3059,1595
2018,1,4,7,1405,1389,3022,1633
2018,1,4,8,1290,1360,2796,1436
2018,1,4,9,1310,1336,2796,1460
2018,1,4,10,1300,1335,2828,1493
2018,1,4,11,1300,1334,2816,1482
2018,1,4,12,1320,1369,2829,1460
2018,1,4,13,1365,1424,2835,1411
2018,1,4,14,1495,1543,2861,1318
2018,1,4,15,1590,1645,2987,1342
2018,1,4,16,1595,1614,2949,1335
2018,1,4,17,1585,1590,2929,1339
2018,1,4,18,1590,1583,2948,1365
2018,1,4,19,1565,1546,2954,1408
2018,1,4,20,1535,1512,2939,1427
2018,1,4,21,1520,1501,2866,1365
2018,1,4,22,1510,1473,2787,1314
2018,1,4,23,1510,1480,2804,1324
2018,1,5,0,1560,1537,2810,1273
2018,1,5,1,1640,1621,2771,1150
2018,1,5,2,1650,1659,2779,1120
2018,1,5,3,1630,1674,2828,1154
2018,1,5,4,1595,1640,2831,1191
2018,1,5,5,1590,1570,2820,1250
2018,1,5,6,1460,1486,2810,1324
2018,1,5,7,1385,1409,2730,1321
2018,1,5,8,1310,1285,2722,1437
2018,1,5,9,1295,1263,2684,1421
2018,1,5,10,1280,1267,2694,1427
2018,1,5,11,1280,1272,2725,1453
2018,1,5,12,1300,1283,2734,1451
2018,1,5,13,1345,1339,2783,1444
2018,1,5,14,1445,1446,2817,1371
2018,1,5,15,1530,1548,2917,1369
2018,1,5,16,1540,1555,2941,1386
2018,1,5,17,1540,1558,2898,1340
2018,1,5,18,1535,1546,2924,1378
2018,1,5,19,1525,1537,2936,1399
2018,1,5,20,1500,1492,2900,1408
2018,1,5,21,1475,1482,2921,1439
2018,1,5,22,1480,1455,2907,1452
2018,1,5,23,1440,1453,2876,1423
2018,1,6,0,1515,1476,2870,1394
2018,1,6,1,1575,1554,2875,1321
2018,1,6,2,1565,1539,2861,1322
2018,1,6,3,1525,1514,2868,1354
2018,1,6,4,1500,1490,2831,1341
2018,1,6,5,1440,1439,2912,1473
2018,1,6,6,1365,1385,2938,1553
2018,1,6,7,1295,1321,2832,1511
2018,1,6,8,1320,1288,2845,1557
2018,1,6,9,1305,1264,2782,1518
2018,1,6,10,1295,1257,2760,1503
2018,1,6,11,1290,1246,2831,1585
2018,1,6,12,1310,1237,2845,1608
2018,1,6,13,1335,1277,2809,1532
2018,1,6,14,1400,1311,2813,1502
2018,1,6,15,1465,1370,2869,1499
2018,1,6,16,1480,1410,2934,1524
2018,1,6,17,1485,1446,2914,1468
2018,1,6,18,1480,1453,2882,1429
2018,1,6,19,1460,1464,2899,1435
2018,1,6,20,1425,1448,2854,1406
2018,1,6,21,1410,1422,2857,1435
2018,1,6,22,1390,1408,2858,1450
2018,1,6,23,1400,1417,2884,1467
2018,1,7,0,1465,1446,2900,1454
2018,1,7,1,1555,1522,2877,1355
2018,1,7,2,1565,1540,2857,1317
2018,1,7,3,1555,1505,2863,1358
2018,1,7,4,1525,1461,2803,1342
2018,1,7,5,1495,1406,2761,1355
2018,1,7,6,1405,1347,2791,1444
2018,1,7,7,1345,1287,2737,1450
2018,1,7,8,1275,1242,2682,1440
2018,1,7,9,1250,1223,2742,1519
2018,1,7,10,1240,1201,2735,1534
2018,1,7,11,1245,1204,2734,1530
2018,1,7,12,1270,1218,2748,1530
2018,1,7,13,1300,1229,2752,1523
2018,1,7,14,1365,1276,2776,1500
2018,1,7,15,1435,1341,2787,1446
2018,1,7,16,1470,1376,2782,1406
2018,1,7,17,1470,1398,2785,1387
2018,1,7,18,1470,1410,2818,1408
2018,1,7,19,1445,1407,2828,1421
2018,1,7,20,1440,1391,2815,1424
2018,1,7,21,1430,1381,2819,1438
2018,1,7,22,1405,1376,2829,1453
2018,1,7,23,1430,1389,2771,1382
2018,1,8,0,1500,1432,2785,1353
2018,1,8,1,1580,1533,2786,1253
2018,1,8,2,1580,1527,2843,1316
2018,1,8,3,1555,1517,2890,1373
2018,1,8,4,1530,1482,2910,1428
2018,1,8,5,1470,1413,2876,1463
2018,1,8,6,1365,1333,2864,1531
2018,1,8,7,1290,1273,2865,1592
2018,1,8,8,1310,1232,2831,1599
2018,1,8,9,1290,1224,2810,1586
2018,1,8,10,1285,1229,2801,1572
2018,1,8,11,1280,1229,2827,1598
2018,1,8,12,1305,1279,2889,1610
2018,1,8,13,1375,1331,2912,1581
2018,1,8,14,1475,1435,2901,1466
2018,1,8,15,1560,1524,2979,1455
2018,1,8,16,1535,1511,2980,1469
2018,1,8,17,1525,1517,2977,1460
2018,1,8,18,1500,1504,2928,1424
2018,1,8,19,1395,1490,2946,1456
2018,1,8,20,1370,1460,2965,1505
2018,1,8,21,1430,1434,2987,1553
2018,1,8,22,1415,1431,2951,1520
2018,1,8,23,1415,1419,2929,1510
2018,1,9,0,1480,1458,2935,1477
2018,1,9,1,1555,1554,2937,1383
2018,1,9,2,1565,1570,2937,1367
2018,1,9,3,1555,1522,2918,1396
2018,1,9,4,1530,1508,2916,1408
2018,1,9,5,1460,1430,2851,1421
2018,1,9,6,1380,1334,2774,1440
2018,1,9,7,1295,1256,2637,1381
2018,1,9,8,1215,1215,2728,1513
2018,1,9,9,1190,1205,2702,1497
2018,1,9,10,1180,1195,2703,1508
2018,1,9,11,1185,1197,2718,1521
2018,1,9,12,1195,1218,2715,1497
2018,1,9,13,1245,1269,2780,1511
2018,1,9,14,1340,1384,2779,1395
2018,1,9,15,1425,1490,2805,1315
2018,1,9,16,1430,1468,2851,1383
2018,1,9,17,1425,1467,2853,1386
2018,1,9,18,1425,1454,2860,1406
2018,1,9,19,1410,1450,2883,1433
2018,1,9,20,1395,1453,2885,1432
2018,1,9,21,1390,1443,2890,1447
2018,1,9,22,1380,1443,2904,1461
2018,1,9,23,1400,1438,2850,1412
2018,1,10,0,1455,1473,2717,1244
2018,1,10,1,1525,1523,2508,985
2018,1,10,2,1515,1545,2595,1050
2018,1,10,3,1495,1536,2638,1102
2018,1,10,4,1465,1504,2558,1054
2018,1,10,5,1405,1439,2544,1105
2018,1,10,6,1310,1350,2487,1137
2018,1,10,7,1230,1282,2467,1185
2018,1,10,8,1325,1238,2303,1065
2018,1,10,9,1305,1222,2113,891
2018,1,10,10,1290,1228,2087,859
2018,1,10,11,1290,1265,2069,804
2018,1,10,12,1300,1296,2177,881
2018,1,10,13,1345,1364,2388,1024
2018,1,10,14,1435,1475,2516,1041
2018,1,10,15,1525,1567,2526,959
2018,1,10,16,1535,1569,2520,951
2018,1,10,17,1545,1552,2514,962
2018,1,10,18,1540,1540,2513,973
2018,1,10,19,1545,1525,2513,988
2018,1,10,20,1510,1532,2526,994
2018,1,10,21,1490,1507,2521,1014
2018,1,10,22,1480,1505,2524,1019
2018,1,10,23,1405,1526,2534,1008
2018,1,11,0,1520,1555,2521,966
2018,1,11,1,1600,1646,2501,855
2018,1,11,2,1600,1655,2455,800
2018,1,11,3,1575,1642,2408,766
2018,1,11,4,1545,1615,2430,815
2018,1,11,5,1485,1531,2442,911
2018,1,11,6,1390,1439,2400,961
2018,1,11,7,1320,1376,2383,1007
2018,1,11,8,1220,1354,2378,1024
2018,1,11,9,1195,1336,2383,1047
2018,1,11,10,1195,1322,2401,1079
2018,1,11,11,1200,1331,2425,1094
2018,1,11,12,1225,1342,2447,1105
2018,1,11,13,1285,1419,2448,1029
2018,1,11,14,1440,1536,2417,881
2018,1,11,15,1575,1608,2432,824
2018,1,11,16,1560,1622,2418,796
2018,1,11,17,1555,1626,2449,823
2018,1,11,18,1530,1603,2437,834
2018,1,11,19,1505,1582,2431,849
2018,1,11,20,1475,1567,2443,876
2018,1,11,21,1465,1545,2433,888
2018,1,11,22,1450,1544,2380,836
2018,1,11,23,1455,1557,2372,815
2018,1,12,0,1515,1597,2364,767
2018,1,12,1,1585,1667,2390,723
2018,1,12,2,1605,1677,2405,728
2018,1,12,3,1605,1667,2383,716
2018,1,12,4,1570,1645,2380,735
2018,1,12,5,1510,1563,2382,819
2018,1,12,6,1425,1469,2375,906
2018,1,12,7,1350,1403,2345,942
2018,1,12,8,1265,1365,2351,986
2018,1,12,9,1245,1342,2397,1055
2018,1,12,10,1245,1314,2410,1096
2018,1,12,11,1250,1338,2442,1104
2018,1,12,12,1265,1345,2477,1132
2018,1,12,13,1310,1381,2521,1140
2018,1,12,14,1420,1476,2486,1010
2018,1,12,15,1525,1582,2571,989
2018,1,12,16,1545,1579,2572,993
2018,1,12,17,1555,1575,2562,987
2018,1,12,18,1555,1563,2535,972
2018,1,12,19,1555,1544,2518,974
2018,1,12,20,1530,1523,2499,976
2018,1,12,21,1520,1507,2557,1050
2018,1,12,22,1510,1500,2559,1059
2018,1,12,23,1510,1502,2564,1062
2018,1,13,0,1555,1536,2585,1049
2018,1,13,1,1635,1594,2573,979
2018,1,13,2,1625,1586,2595,1009
2018,1,13,3,1600,1561,2663,1102
2018,1,13,4,1570,1545,2619,1074
2018,1,13,5,1525,1492,2672,1180
2018,1,13,6,1445,1420,2628,1208
2018,1,13,7,1380,1356,2735,1379
2018,1,13,8,1270,1297,2673,1376
2018,1,13,9,1245,1281,2667,1386
2018,1,13,10,1235,1268,2617,1349
2018,1,13,11,1235,1277,2706,1429
2018,1,13,12,1240,1267,2695,1428
2018,1,13,13,1285,1293,2752,1459
2018,1,13,14,1325,1339,2776,1437
2018,1,13,15,1380,1411,2764,1353
2018,1,13,16,1410,1431,2747,1316
2018,1,13,17,1430,1442,2757,1315
2018,1,13,18,1435,1445,2764,1319
2018,1,13,19,1435,1443,2763,1320
2018,1,13,20,1430,1423,2762,1339
2018,1,13,21,1405,1405,2797,1392
2018,1,13,22,1395,1379,2776,1397
2018,1,13,23,1400,1371,2716,1345
2018,1,14,0,1430,1404,2701,1297
2018,1,14,1,1520,1481,2766,1285
2018,1,14,2,1530,1500,2780,1280
2018,1,14,3,1500,1469,2791,1322
2018,1,14,4,1465,1436,2750,1314
2018,1,14,5,1405,1396,2602,1206
2018,1,14,6,1335,1330,2503,1173
2018,1,14,7,1275,1277,2602,1325
2018,1,14,8,1255,1261,2572,1311
2018,1,14,9,1235,1224,2590,1366
2018,1,14,10,1225,1223,2579,1356
2018,1,14,11,1230,1223,2567,1344
2018,1,14,12,1250,1235,2578,1343
2018,1,14,13,1285,1267,2596,1329
2018,1,14,14,1335,1308,2759,1451
2018,1,14,15,1395,1361,2796,1435
2018,1,14,16,1435,1399,2811,1412
2018,1,14,17,1440,1410,2822,1412
2018,1,14,18,1435,1401,2774,1373
2018,1,14,19,1415,1394,2799,1405
2018,1,14,20,1415,1375,2812,1437
2018,1,14,21,1405,1365,2813,1448
2018,1,14,22,1390,1364,2793,1429
2018,1,14,23,1420,1375,2782,1407
2018,1,15,0,1470,1422,2823,1401
2018,1,15,1,1545,1491,2823,1332
2018,1,15,2,1540,1517,2809,1292
2018,1,15,3,1510,1502,2803,1301
2018,1,15,4,1485,1464,2777,1313
2018,1,15,5,1415,1411,2728,1317
2018,1,15,6,1330,1363,2754,1391
2018,1,15,7,1260,1293,2742,1449
2018,1,15,8,1250,1262,2748,1486
2018,1,15,9,1240,1245,2719,1474
2018,1,15,10,1230,1243,2648,1405
2018,1,15,11,1230,1262,2662,1400
2018,1,15,12,1250,1270,2657,1387
2018,1,15,13,1310,1319,2626,1307
2018,1,15,14,1465,1418,2639,1221
2018,1,15,15,1595,1531,2682,1151
2018,1,15,16,1590,1552,2684,1132
2018,1,15,17,1590,1566,2681,1115
2018,1,15,18,1580,1571,2703,1132
2018,1,15,19,1580,1531,2501,970
2018,1,15,20,1535,1498,2391,893
2018,1,15,21,1510,1483,2518,1035
2018,1,15,22,1505,1487,2533,1046
2018,1,15,23,1415,1489,2608,1119
2018,1,16,0,1535,1522,2659,1137
2018,1,16,1,1610,1621,2650,1029
2018,1,16,2,1620,1646,2737,1091
2018,1,16,3,1585,1635,2756,1121
2018,1,16,4,1560,1615,2768,1153
2018,1,16,5,1490,1542,2686,1144
2018,1,16,6,1400,1477,2681,1204
2018,1,16,7,1330,1408,2676,1268
2018,1,16,8,1270,1370,2679,1309
2018,1,16,9,1245,1366,2687,1321
2018,1,16,10,1235,1373,2701,1328
2018,1,16,11,1240,1381,2690,1309
2018,1,16,12,1250,1402,2694,1292
2018,1,16,13,1310,1458,2694,1236
2018,1,16,14,1385,1587,2685,1098
2018,1,16,15,1455,1678,2735,1057
2018,1,16,16,1455,1661,2760,1099
2018,1,16,17,1450,1628,2797,1169
2018,1,16,18,1450,1593,2766,1173
2018,1,16,19,1435,1539,2707,1168
2018,1,16,20,1425,1520,2706,1186
2018,1,16,21,1420,1488,2724,1236
2018,1,16,22,1420,1481,2694,1213
2018,1,16,23,1430,1478,2688,1210
2018,1,17,0,1475,1525,2691,1166
2018,1,17,1,1540,1595,2740,1145
2018,1,17,2,1545,1608,2702,1094
2018,1,17,3,1525,1598,2559,961
2018,1,17,4,1495,1569,2579,1010
2018,1,17,5,1435,1475,2575,1100
2018,1,17,6,1350,1396,2579,1183
2018,1,17,7,1270,1334,2585,1251
2018,1,17,8,1240,1299,2525,1226
2018,1,17,9,1220,1285,2582,1297
2018,1,17,10,1210,1282,2598,1316
2018,1,17,11,1230,1272,2568,1296
2018,1,17,12,1255,1293,2553,1260
2018,1,17,13,1320,1348,2575,1227
2018,1,17,14,1405,1461,2580,1119
2018,1,17,15,1485,1563,2575,1012
2018,1,17,16,1490,1557,2543,986
2018,1,17,17,1485,1542,2540,998
2018,1,17,18,1480,1528,2561,1033
2018,1,17,19,1460,1497,2552,1055
2018,1,17,20,1455,1464,2500,1036
2018,1,17,21,1450,1446,2524,1078
2018,1,17,22,1450,1436,2547,1111
2018,1,17,23,1465,1438,2500,1062
2018,1,18,0,1500,1461,2508,1047
2018,1,18,1,1590,1558,2552,994
2018,1,18,2,1595,1571,2592,1021
2018,1,18,3,1580,1527,2557,1030
2018,1,18,4,1550,1501,2553,1052
2018,1,18,5,1465,1431,2543,1112
2018,1,18,6,1395,1357,2558,1201
2018,1,18,7,1320,1281,2557,1276
2018,1,18,8,1220,1245,2546,1301
2018,1,18,9,1215,1230,2550,1320
2018,1,18,10,1205,1215,2535,1320
2018,1,18,11,1210,1211,2509,1298
2018,1,18,12,1225,1225,2506,1281
2018,1,18,13,1285,1278,2498,1220
2018,1,18,14,1395,1389,2466,1077
2018,1,18,15,1485,1500,2509,1009
2018,1,18,16,1470,1472,2464,992
2018,1,18,17,1465,1456,2449,993
2018,1,18,18,1445,1445,2464,1019
2018,1,18,19,1430,1437,2471,1034
2018,1,18,20,1420,1419,2460,1041
2018,1,18,21,1405,1407,2432,1025
2018,1,18,22,1400,1409,2421,1012
2018,1,18,23,1400,1417,2429,1012
2018,1,19,0,1445,1441,2445,1004
2018,1,19,1,1500,1483,2574,1091
2018,1,19,2,1515,1503,2598,1095
2018,1,19,3,1505,1496,2695,1199
2018,1,19,4,1475,1483,2700,1217
2018,1,19,5,1400,1441,2705,1264
2018,1,19,6,1325,1360,2736,1376
2018,1,19,7,1255,1310,2610,1300
2018,1,19,8,1260,1270,2594,1324
2018,1,19,9,1240,1279,2604,1325
2018,1,19,10,1240,1254,2595,1341
2018,1,19,11,1250,1264,2596,1332
2018,1,19,12,1260,1275,2642,1367
2018,1,19,13,1305,1335,2562,1227
2018,1,19,14,1405,1426,2540,1114
2018,1,19,15,1505,1550,2607,1057
2018,1,19,16,1510,1537,2631,1094
2018,1,19,17,1515,1529,2651,1122
2018,1,19,18,1510,1516,2635,1119
2018,1,19,19,1495,1488,2618,1130
2018,1,19,20,1455,1476,2708,1232
2018,1,19,21,1440,1464,2756,1292
2018,1,19,22,1425,1435,2706,1271
2018,1,19,23,1425,1418,2632,1214
2018,1,20,0,1455,1443,2640,1197
2018,1,20,1,1535,1508,2736,1228
2018,1,20,2,1530,1509,2750,1241
2018,1,20,3,1510,1496,2777,1281
2018,1,20,4,1485,1457,2709,1252
2018,1,20,5,1435,1416,2711,1295
2018,1,20,6,1365,1364,2686,1322
2018,1,20,7,1300,1306,2711,1405
2018,1,20,8,1250,1274,2718,1444
2018,1,20,9,1225,1252,2687,1435
2018,1,20,10,1210,1238,2677,1439
2018,1,20,11,1205,1224,2632,1408
2018,1,20,12,1210,1237,2628,1391
2018,1,20,13,1255,1262,2632,1370
2018,1,20,14,1340,1310,2616,1306
2018,1,20,15,1420,1391,2760,1369
2018,1,20,16,1440,1432,2798,1366
2018,1,20,17,1455,1456,2829,1373
2018,1,20,18,1460,1434,2812,1378
2018,1,20,19,1450,1437,2839,1402
2018,1,20,20,1430,1418,2847,1429
2018,1,20,21,1410,1387,2797,1410
2018,1,20,22,1400,1368,2746,1378
2018,1,20,23,1405,1380,2761,1381
2018,1,21,0,1440,1403,2799,1396
2018,1,21,1,1515,1477,2816,1339
2018,1,21,2,1505,1497,2803,1306
2018,1,21,3,1480,1482,2804,1322
2018,1,21,4,1460,1453,2787,1334
2018,1,21,5,1420,1422,2785,1363
2018,1,21,6,1345,1358,2796,1438
2018,1,21,7,1280,1307,2696,1389
2018,1,21,8,1240,1277,2694,1417
2018,1,21,9,1215,1253,2692,1439
2018,1,21,10,1210,1249,2612,1363
2018,1,21,11,1205,1249,2703,1454
2018,1,21,12,1220,1246,2667,1421
2018,1,21,13,1260,1280,2657,1377
2018,1,21,14,1325,1322,2661,1339
2018,1,21,15,1400,1378,2718,1340
2018,1,21,16,1420,1428,2798,1370
2018,1,21,17,1425,1441,2776,1335
2018,1,21,18,1415,1415,2773,1358
2018,1,21,19,1400,1409,2775,1366
2018,1,21,20,1380,1394,2752,1358
2018,1,21,21,1365,1375,2754,1379
2018,1,21,22,1360,1363,2749,1386
2018,1,21,23,1370,1361,2745,1384
2018,1,22,0,1410,1409,2749,1340
2018,1,22,1,1495,1513,2773,1260
2018,1,22,2,1510,1540,2834,1294
2018,1,22,3,1485,1524,2871,1347
2018,1,22,4,1450,1498,2859,1361
2018,1,22,5,1380,1442,2832,1390
2018,1,22,6,1330,1361,2802,1441
2018,1,22,7,1255,1309,2790,1481
2018,1,22,8,1215,1292,2785,1493
2018,1,22,9,1195,1266,2732,1466
2018,1,22,10,1195,1271,2740,1469
2018,1,22,11,1200,1265,2726,1461
2018,1,22,12,1220,1280,2716,1436
2018,1,22,13,1270,1338,2773,1435
2018,1,22,14,1380,1465,2800,1335
2018,1,22,15,1495,1549,2839,1290
2018,1,22,16,1495,1543,2827,1284
2018,1,22,17,1500,1529,2819,1290
2018,1,22,18,1490,1518,2813,1295
2018,1,22,19,1470,1503,2816,1313
2018,1,22,20,1445,1482,2824,1342
2018,1,22,21,1430,1404,2815,1411
2018,1,22,22,1430,1460,2827,1367
2018,1,22,23,1435,1471,2795,1324
2018,1,23,0,1465,1482,2777,1295
2018,1,23,1,1545,1580,2798,1218
2018,1,23,2,1560,1573,2818,1245
2018,1,23,3,1545,1545,2777,1232
2018,1,23,4,1520,1509,2740,1231
2018,1,23,5,1450,1461,2767,1306
2018,1,23,6,1375,1378,2775,1397
2018,1,23,7,1310,1324,2738,1414
2018,1,23,8,1245,1285,2669,1384
2018,1,23,9,1225,1285,2804,1519
2018,1,23,10,1220,1266,2789,1523
2018,1,23,11,1215,1276,2812,1536
2018,1,23,12,1225,1290,2811,1521
2018,1,23,13,1275,1334,2789,1455
2018,1,23,14,1370,1461,2814,1353
2018,1,23,15,1465,1563,2846,1283
2018,1,23,16,1465,1542,2820,1278
2018,1,23,17,1460,1531,2815,1284
2018,1,23,18,1445,1513,2790,1277
2018,1,23,19,1435,1484,2816,1332
2018,1,23,20,1420,1452,2813,1361
2018,1,23,21,1405,1437,2822,1385
2018,1,23,22,1405,1417,2839,1422
2018,1,23,23,1405,1427,2835,1408
2018,1,24,0,1440,1450,2808,1358
2018,1,24,1,1510,1528,2816,1288
2018,1,24,2,1525,1546,2791,1245
2018,1,24,3,1510,1546,2784,1238
2018,1,24,4,1485,1519,2801,1282
2018,1,24,5,1435,1457,2766,1309
2018,1,24,6,1345,1378,2753,1375
2018,1,24,7,1285,1309,2702,1393
2018,1,24,8,1245,1270,2688,1418
2018,1,24,9,1225,1255,2682,1427
2018,1,24,10,1220,1232,2749,1517
2018,1,24,11,1220,1242,2764,1522
2018,1,24,12,1240,1262,2656,1394
2018,1,24,13,1295,1312,2723,1411
2018,1,24,14,1400,1438,2731,1293
2018,1,24,15,1480,1542,2757,1215
2018,1,24,16,1475,1519,2763,1244
2018,1,24,17,1465,1500,2718,1218
2018,1,24,18,1450,1464,2821,1357
2018,1,24,19,1425,1447,2798,1351
2018,1,24,20,1405,1411,2792,1381
2018,1,24,21,1365,1407,2829,1422
2018,1,24,22,1380,1399,2843,1444
2018,1,24,23,1385,1396,2821,1425
2018,1,25,0,1405,1425,2802,1377
2018,1,25,1,1500,1494,2744,1250
2018,1,25,2,1505,1526,2765,1239
2018,1,25,3,1475,1503,2702,1199
2018,1,25,4,1445,1465,2712,1247
2018,1,25,5,1480,1413,2716,1303
2018,1,25,6,1410,1321,2702,1381
2018,1,25,7,1240,1257,2681,1424
2018,1,25,8,1235,1216,2662,1446
2018,1,25,9,1225,1204,2509,1305
2018,1,25,10,1210,1189,2510,1321
2018,1,25,11,1210,1193,2540,1347
2018,1,25,12,1225,1214,2577,1363
2018,1,25,13,1280,1272,2621,1349
2018,1,25,14,1415,1395,2656,1261
2018,1,25,15,1535,1502,2695,1193
2018,1,25,16,1515,1488,2721,1233
2018,1,25,17,1505,1482,2682,1200
2018,1,25,18,1490,1490,2713,1223
2018,1,25,19,1470,1462,2695,1233
2018,1,25,20,1445,1446,2661,1215
2018,1,25,21,1430,1432,2642,1210
2018,1,25,22,1425,1420,2408,988
2018,1,25,23,1435,1437,2410,973
2018,1,26,0,1460,1439,2429,990
2018,1,26,1,1520,1496,2713,1217
2018,1,26,2,1535,1551,2819,1268
2018,1,26,3,1520,1524,2755,1231
2018,1,26,4,1500,1506,2855,1349
2018,1,26,5,1450,1442,2857,1415
2018,1,26,6,1355,1360,2717,1357
2018,1,26,7,1290,1275,2700,1425
2018,1,26,8,1215,1248,2687,1439
2018,1,26,9,1210,1232,2736,1504
2018,1,26,10,1185,1232,2740,1508
2018,1,26,11,1195,1220,2700,1480
2018,1,26,12,1205,1246,2679,1433
2018,1,26,13,1260,1297,2638,1341
2018,1,26,14,1370,1416,2627,1211
2018,1,26,15,1495,1522,2641,1119
2018,1,26,16,1485,1522,2692,1170
2018,1,26,17,1480,1508,2725,1217
2018,1,26,18,1465,1491,2730,1239
2018,1,26,19,1445,1457,2739,1282
2018,1,26,20,1425,1433,2737,1304
2018,1,26,21,1415,1427,2749,1322
2018,1,26,22,1400,1423,2743,1320
2018,1,26,23,1390,1430,2745,1315
2018,1,27,0,1415,1440,2735,1295
2018,1,27,1,1485,1501,2725,1224
2018,1,27,2,1495,1535,2748,1213
2018,1,27,3,1475,1514,2738,1224
2018,1,27,4,1445,1468,2711,1243
2018,1,27,5,1395,1426,2750,1324
2018,1,27,6,1330,1362,2746,1384
2018,1,27,7,1265,1314,2742,1428
2018,1,27,8,1240,1287,2761,1474
2018,1,27,9,1220,1258,2723,1465
2018,1,27,10,1210,1253,2636,1383
2018,1,27,11,1205,1245,2529,1284
2018,1,27,12,1220,1257,2505,1248
2018,1,27,13,1255,1277,2517,1240
2018,1,27,14,1325,1333,2521,1188
2018,1,27,15,1410,1407,2514,1107
2018,1,27,16,1425,1430,2450,1020
2018,1,27,17,1435,1453,2431,978
2018,1,27,18,1430,1461,2395,934
2018,1,27,19,1420,1448,2381,933
2018,1,27,20,1400,1423,2524,1101
2018,1,27,21,1380,1402,2535,1133
2018,1,27,22,1365,1383,2518,1135
2018,1,27,23,1375,1392,2360,968
2018,1,28,0,1390,1421,2231,810
2018,1,28,1,1460,1492,2179,687
2018,1,28,2,1490,1514,2214,700
2018,1,28,3,1470,1479,2225,746
2018,1,28,4,1445,1451,2264,813
2018,1,28,5,1415,1402,2251,849
2018,1,28,6,1330,1345,2257,912
2018,1,28,7,1265,1286,2273,987
2018,1,28,8,1220,1240,2255,1015
2018,1,28,9,1195,1214,2269,1055
2018,1,28,10,1195,1226,2393,1167
2018,1,28,11,1190,1230,2363,1133
2018,1,28,12,1200,1239,2421,1182
2018,1,28,13,1240,1248,2411,1163
2018,1,28,14,1315,1288,2407,1119
2018,1,28,15,1385,1330,2403,1073
2018,1,28,16,1410,1369,2387,1018
2018,1,28,17,1415,1403,2372,969
2018,1,28,18,1405,1404,2330,926
2018,1,28,19,1390,1414,2295,881
2018,1,28,20,1370,1410,2250,840
2018,1,28,21,1360,1400,2237,837
2018,1,28,22,1355,1396,2226,830
2018,1,28,23,1360,1408,2230,822
2018,1,29,0,1390,1429,2213,784
2018,1,29,1,1470,1510,2211,701
2018,1,29,2,1505,1531,2249,718
2018,1,29,3,1490,1523,2215,692
2018,1,29,4,1460,1479,2219,740
2018,1,29,5,1400,1403,2238,835
2018,1,29,6,1330,1321,2256,935
2018,1,29,7,1260,1250,2265,1015
2018,1,29,8,1200,1212,2338,1126
2018,1,29,9,1185,1198,2401,1203
2018,1,29,10,1185,1186,2397,1211
2018,1,29,11,1190,1205,2410,1205
2018,1,29,12,1220,1215,2404,1189
2018,1,29,13,1275,1266,2392,1126
2018,1,29,14,1375,1398,2399,1001
2018,1,29,15,1455,1480,2381,901
2018,1,29,16,1450,1462,2363,901
2018,1,29,17,1450,1468,2363,895
2018,1,29,18,1445,1463,2399,936
2018,1,29,19,1425,1446,2417,971
2018,1,29,20,1400,1421,2437,1016
2018,1,29,21,1385,1396,2418,1022
2018,1,29,22,1380,1380,2411,1031
2018,1,29,23,1385,1394,2411,1017
2018,1,30,0,1405,1400,2394,994
2018,1,30,1,1485,1447,2362,915
2018,1,30,2,1510,1483,2373,890
2018,1,30,3,1480,1478,2376,898
2018,1,30,4,1460,1420,2370,950
2018,1,30,5,1385,1361,2398,1037
2018,1,30,6,1305,1280,2428,1148
2018,1,30,7,1230,1211,2355,1144
2018,1,30,8,1180,1167,2289,1122
2018,1,30,9,1170,1122,2229,1107
2018,1,30,10,1160,1138,2175,1037
2018,1,30,11,1165,1161,2287,1126
2018,1,30,12,1180,1169,2334,1165
2018,1,30,13,1220,1239,2473,1234
2018,1,30,14,1335,1351,2517,1166
2018,1,30,15,1440,1448,2519,1071
2018,1,30,16,1430,1453,2537,1084
2018,1,30,17,1430,1439,2488,1049
2018,1,30,18,1420,1435,2521,1086
2018,1,30,19,1410,1428,2460,1032
2018,1,30,20,1400,1434,2468,1034
2018,1,30,21,1395,1434,2383,949
2018,1,30,22,1385,1434,2345,911
2018,1,30,23,1390,1442,2392,950
2018,1,31,0,1425,1451,2381,930
2018,1,31,1,1485,1496,2454,958
2018,1,31,2,1505,1548,2444,896
2018,1,31,3,1495,1518,2495,977
2018,1,31,4,1465,1490,2522,1032
2018,1,31,5,1405,1431,2485,1054
2018,1,31,6,1320,1344,2529,1185
2018,1,31,7,1245,1286,2550,1264
2018,1,31,8,1200,1385,2096,711
2018,1,31,9,1185,1357,2164,807
2018,1,31,10,1180,1351,2197,846
2018,1,31,11,1180,1368,2189,821
2018,1,31,12,1200,1375,2152,777
2018,1,31,13,1255,1436,2134,698
2018,1,31,14,1390,1551,2118,567
2018,1,31,15,1500,1651,2169,518
2018,1,31,16,1490,1628,2177,549
2018,1,31,17,1485,1604,2154,550
2018,1,31,18,1470,1575,2187,612
2018,1,31,19,1440,1570,2192,622
2018,1,31,20,1415,1529,2130,601
2018,1,31,21,1400,1503,2117,614
2018,1,31,22,1390,1477,2123,646
2018,1,31,23,1395,1462,2092,630
2018,2,1,0,1410,1487,2173,686
2018,2,1,1,1480,1522,2215,693
2018,2,1,2,1505,1557,2217,660
2018,2,1,3,1480,1558,2228,670
2018,2,1,4,1440,1542,2218,676
2018,2,1,5,1390,1473,2193,720
2018,2,1,6,1315,1412,2216,804
2018,2,1,7,-9999,1353,2214,861
2018,2,1,8,1335,1277,2478,1201
2018,2,1,9,1320,1259,2538,1279
2018,2,1,10,1330,1253,2520,1267
2018,2,1,11,1335,1264,2523,1259
2018,2,1,12,1350,1297,2538,1241
2018,2,1,13,1400,1348,2547,1199
2018,2,1,14,1525,1493,2598,1105
2018,2,1,15,1640,1572,2721,1149
2018,2,1,16,1620,1561,2714,1153
2018,2,1,17,1605,1535,2672,1137
2018,2,1,18,1590,1521,2658,1137
2018,2,1,19,1585,1468,2683,1215
2018,2,1,20,1545,1458,2726,1268
2018,2,1,21,1530,1428,2617,1189
2018,2,1,22,1515,1430,2557,1127
2018,2,1,23,1500,1430,2541,1111
2018,2,2,0,1520,1457,2552,1095
2018,2,2,1,1570,1513,2703,1190
2018,2,2,2,1585,1539,2741,1202
2018,2,2,3,1560,1509,2734,1225
2018,2,2,4,1535,1488,2749,1261
2018,2,2,5,1490,1428,2785,1357
2018,2,2,6,1460,1345,2801,1456
2018,2,2,7,1390,1285,2760,1475
2018,2,2,8,1210,1247,2771,1524
2018,2,2,9,1200,1221,2623,1402
2018,2,2,10,1190,1224,2534,1310
2018,2,2,11,1190,1225,2551,1326
2018,2,2,12,1210,1246,2490,1244
2018,2,2,13,1265,1295,2460,1165
2018,2,2,14,1370,1416,2494,1078
2018,2,2,15,1480,1512,2621,1109
2018,2,2,16,1480,1521,2682,1161
2018,2,2,17,1470,1386,2597,1211
2018,2,2,18,1455,1487,2739,1252
2018,2,2,19,1435,1449,2668,1219
2018,2,2,20,1420,1424,2637,1213
2018,2,2,21,1415,1392,2441,1049
2018,2,2,22,1400,1371,2175,804
2018,2,2,23,1400,1366,2034,668
2018,2,3,0,1415,1378,2036,658
2018,2,3,1,1480,1431,2053,622
2018,2,3,2,1500,1463,2176,713
2018,2,3,3,1480,1445,2291,846
2018,2,3,4,1445,1405,2192,787
2018,2,3,5,1395,1365,2236,871
2018,2,3,6,1335,1274,2055,781
2018,2,3,7,1280,1228,1960,732
2018,2,3,8,1235,1179,1578,399
2018,2,3,9,1215,1152,1556,404
2018,2,3,10,1205,1139,1558,419
2018,2,3,11,1205,1145,1551,406
2018,2,3,12,1225,1152,1555,403
2018,2,3,13,1255,1175,1557,382
2018,2,3,14,1345,1227,1543,316
2018,2,3,15,1425,1293,1592,299
2018,2,3,16,1440,1343,1595,252
2018,2,3,17,1445,1386,1612,226
2018,2,3,18,1440,1395,1698,303
2018,2,3,19,1420,1384,1504,120
2018,2,3,20,1395,1383,1357,-26
2018,2,3,21,1375,1378,1347,-31
2018,2,3,22,1360,1376,1373,-3
2018,2,3,23,1370,1371,1370,-1
2018,2,4,0,1400,1399,1348,-51
2018,2,4,1,1465,1474,1439,-35
2018,2,4,2,1485,1510,1860,350
2018,2,4,3,1455,1502,1888,386
2018,2,4,4,1430,1469,1649,180
2018,2,4,5,1480,1434,1496,62
2018,2,4,6,1310,1372,1477,105
2018,2,4,7,1255,1338,1509,171
2018,2,4,8,1225,1314,1429,115
2018,2,4,9,1200,1289,1415,126
2018,2,4,10,1205,1289,1362,73
2018,2,4,11,1205,1294,1403,109
2018,2,4,12,1215,1294,1426,132
2018,2,4,13,1240,1302,1392,90
2018,2,4,14,1305,1354,1380,26
2018,2,4,15,1360,1419,1388,-31
2018,2,4,16,1395,1465,1462,-3
2018,2,4,17,1410,1486,1408,-78
2018,2,4,18,1400,1506,1484,-22
2018,2,4,19,1390,1477,1407,-70
2018,2,4,20,1380,1480,1335,-145
2018,2,4,21,1370,1451,1333,-118
2018,2,4,22,1365,1446,1352,-94
2018,2,4,23,1370,1439,1345,-94
2018,2,5,0,1400,1447,1306,-141
2018,2,5,1,1485,1486,1515,29
2018,2,5,2,1505,1522,1817,295
2018,2,5,3,1490,1480,1770,290
2018,2,5,4,1455,1466,1892,426
2018,2,5,5,1365,1438,2082,644
2018,2,5,6,1310,1343,1799,456
2018,2,5,7,1240,1281,1748,467
2018,2,5,8,1210,1246,1490,244
2018,2,5,9,1190,1230,1437,207
2018,2,5,10,1190,1220,1445,225
2018,2,5,11,1195,1222,1448,226
2018,2,5,12,1210,1257,1429,172
2018,2,5,13,1265,1337,1445,108
2018,2,5,14,1390,1466,1850,384
2018,2,5,15,1490,1577,2179,602
2018,2,5,16,1485,1596,2452,856
2018,2,5,17,1475,1592,2464,872
2018,2,5,18,1470,1595,2344,749
2018,2,5,19,1445,1553,2121,568
2018,2,5,20,1425,1528,2022,494
2018,2,5,21,1375,1518,1971,453
2018,2,5,22,1400,1505,2031,526
2018,2,5,23,1410,1514,1990,476
2018,2,6,0,1430,1531,2074,543
2018,2,6,1,1520,1587,2208,621
2018,2,6,2,1525,1638,2385,747
2018,2,6,3,1505,1629,2451,822
2018,2,6,4,1475,1571,2358,787
2018,2,6,5,1425,1493,2273,780
2018,2,6,6,1340,1393,1981,588
2018,2,6,7,1280,1337,1814,477
2018,2,6,8,1245,1284,1450,166
2018,2,6,9,1235,1262,1425,163
2018,2,6,10,1225,1259,1459,200
2018,2,6,11,1230,1254,1441,187
2018,2,6,12,1245,1269,1450,181
2018,2,6,13,1280,1330,1448,118
2018,2,6,14,1395,1462,1775,313
2018,2,6,15,1500,1556,2448,892
2018,2,6,16,1510,1556,2693,1137
2018,2,6,17,1505,1552,2715,1163
2018,2,6,18,1500,1540,2688,1148
2018,2,6,19,1470,1514,2624,1110
2018,2,6,20,1455,1474,2505,1031
2018,2,6,21,1430,1476,2408,932
2018,2,6,22,1420,1481,2352,871
2018,2,6,23,1425,1467,2293,826
2018,2,7,0,1445,1498,2236,738
2018,2,7,1,1500,1557,2570,1013
2018,2,7,2,1525,1611,2617,1006
2018,2,7,3,1510,1590,2532,942
2018,2,7,4,1485,1545,2494,949
2018,2,7,5,1425,1469,2226,757
2018,2,7,6,1350,1360,1711,351
2018,2,7,7,1280,1307,1451,144
2018,2,7,8,1225,1265,1365,100
2018,2,7,9,1210,1243,1334,91
2018,2,7,10,1195,1236,1361,125
2018,2,7,11,1205,1233,1445,212
2018,2,7,12,1220,1256,1474,218
2018,2,7,13,1275,1307,1643,336
2018,2,7,14,1385,1444,2270,826
2018,2,7,15,1480,1541,2660,1119
2018,2,7,16,1470,1515,2826,1311
2018,2,7,17,1455,1500,2857,1357
2018,2,7,18,1440,1480,2628,1148
2018,2,7,19,1415,1449,2348,899
2018,2,7,20,1385,1427,2116,689
2018,2,7,21,1375,1392,2077,685
2018,2,7,22,1370,1402,1974,572
2018,2,7,23,1365,1403,2003,600
2018,2,8,0,1395,1410,2130,720
2018,2,8,1,1455,1474,2342,868
2018,2,8,2,1495,1521,2567,1046
2018,2,8,3,1470,1508,2674,1166
2018,2,8,4,1435,1467,2487,1020
2018,2,8,5,1385,1403,2402,999
2018,2,8,6,1290,1312,1893,581
2018,2,8,7,1225,1249,1625,376
2018,2,8,8,1205,1202,1442,240
2018,2,8,9,1190,1186,1416,230
2018,2,8,10,1185,1196,1451,255
2018,2,8,11,1190,1197,1456,259
2018,2,8,12,1210,1227,1485,258
2018,2,8,13,1265,1264,1668,404
2018,2,8,14,1405,1377,2177,800
2018,2,8,15,1495,1479,2553,1074
2018,2,8,16,1490,1472,2648,1176
2018,2,8,17,1475,1472,2557,1085
2018,2,8,18,1460,1464,2431,967
2018,2,8,19,1430,1441,2354,913
2018,2,8,20,1405,1437,2083,646
2018,2,8,21,1395,1439,2065,626
2018,2,8,22,1395,1436,2050,614
2018,2,8,23,1395,1431,2063,632
2018,2,9,0,1420,1468,2080,612
2018,2,9,1,1475,1530,2526,996
2018,2,9,2,1510,1587,2667,1080
2018,2,9,3,1485,1575,2694,1119
2018,2,9,4,1455,1587,2655,1068
2018,2,9,5,1395,1508,2543,1035
2018,2,9,6,1305,1431,2433,1002
2018,2,9,7,1245,1364,1868,504
2018,2,9,8,1265,1324,1658,334
2018,2,9,9,1245,1313,1582,269
2018,2,9,10,1245,1313,1525,212
2018,2,9,11,1245,1316,1506,190
2018,2,9,12,1265,1351,1542,191
2018,2,9,13,1310,1423,1839,416
2018,2,9,14,1440,1545,2545,1000
2018,2,9,15,1555,1642,2774,1132
2018,2,9,16,1570,1637,2802,1165
2018,2,9,17,1535,1638,2732,1094
2018,2,9,18,1565,1631,2576,945
2018,2,9,19,1550,1590,2582,992
2018,2,9,20,1535,1591,2656,1065
2018,2,9,21,1515,1577,2486,909
2018,2,9,22,1515,1560,2371,811
2018,2,9,23,1515,1552,2337,785
2018,2,10,0,1545,1557,2336,779
2018,2,10,1,1615,1618,2546,928
2018,2,10,2,1630,1667,2675,1008
2018,2,10,3,1605,1650,2669,1019
2018,2,10,4,1565,1620,2652,1032
2018,2,10,5,1525,1587,2661,1074
2018,2,10,6,1430,1524,2633,1109
2018,2,10,7,1370,1455,2513,1058
2018,2,10,8,1275,1416,2478,1062
2018,2,10,9,1250,1389,2262,873
2018,2,10,10,1230,1370,2272,902
2018,2,10,11,1235,1368,2218,850
2018,2,10,12,1250,1367,2182,815
2018,2,10,13,1285,1397,2258,861
2018,2,10,14,1370,1467,2422,955
2018,2,10,15,1475,1536,2512,976
2018,2,10,16,1495,1576,2435,859
2018,2,10,17,1530,1568,2434,866
2018,2,10,18,1535,1528,2447,919
2018,2,10,19,1520,1516,2386,870
2018,2,10,20,1510,1482,2376,894
2018,2,10,21,1490,1436,2210,774
2018,2,10,22,1470,1403,1916,513
2018,2,10,23,1475,1399,1796,397
2018,2,11,0,1490,1413,1812,399
2018,2,11,1,1550,1426,2097,671
2018,2,11,2,1575,1559,2408,849
2018,2,11,3,1550,1556,2565,1009
2018,2,11,4,1540,1523,2503,980
2018,2,11,5,1490,1333,2571,1238
2018,2,11,6,1405,1443,2645,1202
2018,2,11,7,1345,1381,2540,1159
2018,2,11,8,1270,1336,2250,914
2018,2,11,9,1245,1307,2080,773
2018,2,11,10,1250,1284,1918,634
2018,2,11,11,1250,1296,1921,625
2018,2,11,12,1260,1300,2144,844
2018,2,11,13,1280,1338,2255,917
2018,2,11,14,1330,1383,2478,1095
2018,2,11,15,1390,1437,2629,1192
2018,2,11,16,1420,1479,2691,1212
2018,2,11,17,1445,1508,2769,1261
2018,2,11,18,1460,1513,2797,1284
2018,2,11,19,1440,1505,2783,1278
2018,2,11,20,1445,1497,2756,1259
2018,2,11,21,1430,1481,2631,1150
2018,2,11,22,1425,1486,2665,1179
2018,2,11,23,1425,1517,2711,1194
2018,2,12,0,1440,1554,2750,1196
2018,2,12,1,1485,1625,2767,1142
2018,2,12,2,1520,1672,2789,1117
2018,2,12,3,1495,1660,2801,1141
2018,2,12,4,1475,1635,2807,1172
2018,2,12,5,1450,1575,2791,1216
2018,2,12,6,1340,1510,2758,1248
2018,2,12,7,1275,1450,2704,1254
2018,2,12,8,1260,1403,2438,1035
2018,2,12,9,1245,1403,2203,800
2018,2,12,10,1250,1388,2040,652
2018,2,12,11,1265,1402,2067,665
2018,2,12,12,1280,1301,1994,693
2018,2,12,13,1330,1483,2396,913
2018,2,12,14,1435,1604,2647,1043
2018,2,12,15,1530,1693,2745,1052
2018,2,12,16,1515,1693,2765,1072
2018,2,12,17,1505,1676,2772,1096
2018,2,12,18,1510,1644,2751,1107
2018,2,12,19,1495,1615,2706,1091
2018,2,12,20,1485,1577,2686,1109
2018,2,12,21,1470,1564,2626,1062
2018,2,12,22,1465,1533,2666,1133
2018,2,12,23,1480,1524,2648,1124
2018,2,13,0,1505,1544,2669,1125
2018,2,13,1,1560,1602,2752,1150
2018,2,13,2,1610,1690,2810,1120
2018,2,13,3,1590,1679,2824,1145
2018,2,13,4,1565,1665,2861,1196
2018,2,13,5,1515,1610,2893,1283
2018,2,13,6,1415,1521,2880,1359
2018,2,13,7,1340,1465,2834,1369
2018,2,13,8,1315,1433,2743,1310
2018,2,13,9,1295,1418,2695,1277
2018,2,13,10,1285,1403,2687,1284
2018,2,13,11,1290,1433,2729,1296
2018,2,13,12,1300,1448,2850,1402
2018,2,13,13,1345,1508,2910,1402
2018,2,13,14,1420,1632,2911,1279
2018,2,13,15,1480,1694,2954,1260
2018,2,13,16,1490,1678,2901,1223
2018,2,13,17,1490,1632,2884,1252
2018,2,13,18,1480,1596,2835,1239
2018,2,13,19,1465,1540,2848,1308
2018,2,13,20,1440,1519,2846,1327
2018,2,13,21,1440,1497,2861,1364
2018,2,13,22,1435,1480,2871,1391
2018,2,13,23,1445,1457,2778,1321
2018,2,14,0,1475,1479,2705,1226
2018,2,14,1,1540,1507,2743,1236
2018,2,14,2,1585,1587,2740,1153
2018,2,14,3,1570,1585,2752,1167
2018,2,14,4,1535,1551,2759,1208
2018,2,14,5,1460,1502,2760,1258
2018,2,14,6,1385,1419,2679,1260
2018,2,14,7,1335,1346,2603,1257
2018,2,14,8,1300,1316,2495,1179
2018,2,14,9,1290,1287,2428,1141
2018,2,14,10,1280,1282,2399,1117
2018,2,14,11,1285,1284,2466,1182
2018,2,14,12,1260,1297,2399,1102
2018,2,14,13,1350,1358,2485,1127
2018,2,14,14,1435,1488,2713,1225
2018,2,14,15,1495,1544,2707,1163
2018,2,14,16,1490,1534,2729,1195
2018,2,14,17,1490,1506,2709,1203
2018,2,14,18,1475,1491,2675,1184
2018,2,14,19,1455,1459,2602,1143
2018,2,14,20,1425,1430,2519,1089
2018,2,14,21,1410,1427,2560,1133
2018,2,14,22,1395,1426,2565,1139
2018,2,14,23,1390,1429,2469,1040
2018,2,15,0,1420,1461,2474,1013
2018,2,15,1,1485,1502,2667,1165
2018,2,15,2,1545,1559,2720,1161
2018,2,15,3,1530,1550,2729,1179
2018,2,15,4,1490,1523,2731,1208
2018,2,15,5,1435,1454,2691,1237
2018,2,15,6,1360,1385,2630,1245
2018,2,15,7,1300,1339,2404,1065
2018,2,15,8,1325,1292,2285,993
2018,2,15,9,1305,1264,1973,709
2018,2,15,10,1305,1251,1813,562
2018,2,15,11,1310,1262,1643,381
2018,2,15,12,1330,1280,1735,455
2018,2,15,13,1385,1342,1761,419
2018,2,15,14,1500,1467,2509,1042
2018,2,15,15,1585,1554,2692,1138
2018,2,15,16,1575,1552,2691,1139
2018,2,15,17,1560,1544,2665,1121
2018,2,15,18,1540,1531,2650,1119
2018,2,15,19,1510,1518,2570,1052
2018,2,15,20,1490,1484,2367,883
2018,2,15,21,1485,1461,2300,839
2018,2,15,22,1480,1449,2292,843
2018,2,15,23,1470,1445,2316,871
2018,2,16,0,1500,1460,2344,884
2018,2,16,1,1550,1511,2511,1000
2018,2,16,2,1610,1594,2574,980
2018,2,16,3,1595,1613,2603,990
2018,2,16,4,1565,1595,2657,1062
2018,2,16,5,1490,1540,2664,1124
2018,2,16,6,1405,1450,2316,866
2018,2,16,7,1350,1385,2074,689
2018,2,16,8,1260,1344,1833,489
2018,2,16,9,1245,1324,1728,404
2018,2,16,10,1240,1320,1625,305
2018,2,16,11,1240,1324,1633,309
2018,2,16,12,1265,1327,1650,323
2018,2,16,13,1325,1383,2059,676
2018,2,16,14,1425,1509,2702,1193
2018,2,16,15,1515,1575,2865,1290
2018,2,16,16,1515,1567,2871,1304
2018,2,16,17,1505,1568,2849,1281
2018,2,16,18,1505,1545,2759,1214
2018,2,16,19,1475,1538,2711,1173
2018,2,16,20,1450,1516,2679,1163
2018,2,16,21,1445,1498,2572,1074
2018,2,16,22,1435,1459,2404,945
2018,2,16,23,1445,1444,2277,833
2018,2,17,0,1460,1454,2238,784
2018,2,17,1,1510,1493,2378,885
2018,2,17,2,1550,1537,2528,991
2018,2,17,3,1535,1525,2761,1236
2018,2,17,4,1490,1500,2771,1271
2018,2,17,5,1420,1445,2578,1133
2018,2,17,6,1355,1377,2513,1136
2018,2,17,7,1295,1309,2077,768
2018,2,17,8,1260,1260,1917,657
2018,2,17,9,1235,1251,2011,760
2018,2,17,10,1230,1212,1854,642
2018,2,17,11,1235,1212,1725,513
2018,2,17,12,1245,1232,1918,686
2018,2,17,13,1275,1265,2092,827
2018,2,17,14,1345,1337,2242,905
2018,2,17,15,1420,1405,2501,1096
2018,2,17,16,1440,1451,2648,1197
2018,2,17,17,1460,1460,2670,1210
2018,2,17,18,1470,1459,2694,1235
2018,2,17,19,1455,1445,2694,1249
2018,2,17,20,1435,1428,2517,1089
2018,2,17,21,1415,1414,2443,1029
2018,2,17,22,1400,1418,2189,771
2018,2,17,23,1400,1412,1841,429
2018,2,18,0,1425,1443,1870,427
2018,2,18,1,1480,1506,2308,802
2018,2,18,2,1515,1574,2640,1066
2018,2,18,3,1490,1549,2600,1051
2018,2,18,4,1470,1501,2502,1001
2018,2,18,5,1420,1446,2364,918
2018,2,18,6,1350,1376,2149,773
2018,2,18,7,1290,1316,1981,665
2018,2,18,8,1300,1280,1780,500
2018,2,18,9,1275,1245,1523,278
2018,2,18,10,1260,1252,1503,251
2018,2,18,11,1270,1252,1483,231
2018,2,18,12,1275,1267,1501,234
2018,2,18,13,1310,1299,1515,216
2018,2,18,14,1385,1357,1937,580
2018,2,18,15,1455,1420,2211,791
2018,2,18,16,1495,1471,2067,596
2018,2,18,17,1515,1528,2497,969
2018,2,18,18,1525,1534,2425,891
2018,2,18,19,1510,1531,2512,981
2018,2,18,20,1505,1533,2396,863
2018,2,18,21,1485,1511,2083,572
2018,2,18,22,1485,1503,2029,526
2018,2,18,23,1495,1507,1999,492
2018,2,19,0,1520,1533,2217,684
2018,2,19,1,1570,1617,2700,1083
2018,2,19,2,1620,1682,2822,1140
2018,2,19,3,1605,1662,2799,1137
2018,2,19,4,1580,1622,2683,1061
2018,2,19,5,1530,1572,2751,1179
2018,2,19,6,1455,1484,2522,1038
2018,2,19,7,1395,1440,2406,966
2018,2,19,8,1385,1410,2421,1011
2018,2,19,9,1380,1386,2380,994
2018,2,19,10,1370,1373,2334,961
2018,2,19,11,1380,1379,2378,999
2018,2,19,12,1340,1405,2393,988
2018,2,19,13,1465,1448,2473,1025
2018,2,19,14,1575,1548,2566,1018
2018,2,19,15,1660,1618,2671,1053
2018,2,19,16,1660,1642,2680,1038
2018,2,19,17,1650,1647,2664,1017
2018,2,19,18,1635,1655,2661,1006
2018,2,19,19,1615,1620,2646,1026
2018,2,19,20,1580,1593,2622,1029
2018,2,19,21,1565,1583,2655,1072
2018,2,19,22,1545,1572,2647,1075
2018,2,19,23,1540,1576,2659,1083
2018,2,20,0,1560,1591,2651,1060
2018,2,20,1,1615,1626,2575,949
2018,2,20,2,1695,1694,2666,972
2018,2,20,3,1690,1697,2678,981
2018,2,20,4,1670,1665,2669,1004
2018,2,20,5,1610,1602,2641,1039
2018,2,20,6,1515,1521,2619,1098
2018,2,20,7,1455,1471,2625,1154
2018,2,20,8,1430,1458,2620,1162
2018,2,20,9,1425,1449,2671,1222
2018,2,20,10,1415,1451,2684,1233
2018,2,20,11,1430,1467,2671,1204
2018,2,20,12,1385,1489,2693,1204
2018,2,20,13,1495,1537,2674,1137
2018,2,20,14,1570,1664,2710,1046
2018,2,20,15,1610,1738,2715,977
2018,2,20,16,1610,1726,2726,1000
2018,2,20,17,1605,1700,2683,983
2018,2,20,18,1580,1677,2756,1079
2018,2,20,19,1555,1642,2715,1073
2018,2,20,20,1530,1609,2706,1097
2018,2,20,21,1515,1599,2686,1087
2018,2,20,22,1495,1579,2624,1045
2018,2,20,23,1485,1571,2647,1076
2018,2,21,0,1505,1582,2625,1043
2018,2,21,1,1560,1617,2633,1016
2018,2,21,2,1640,1701,2692,991
2018,2,21,3,1630,1720,2711,991
2018,2,21,4,1605,1703,2691,988
2018,2,21,5,1555,1630,2644,1014
2018,2,21,6,1465,1555,2638,1083
2018,2,21,7,1410,1497,2626,1129
2018,2,21,8,1350,1469,2623,1154
2018,2,21,9,1335,1439,2601,1162
2018,2,21,10,1325,1451,2614,1163
2018,2,21,11,1330,1460,2627,1167
2018,2,21,12,1355,1467,2638,1171
2018,2,21,13,1405,1521,2633,1112
2018,2,21,14,1500,1647,2641,994
2018,2,21,15,1575,1716,2652,936
2018,2,21,16,1580,1714,2668,954
2018,2,21,17,1580,1679,2674,995
2018,2,21,18,1580,1643,2674,1031
2018,2,21,19,1545,1614,2698,1084
2018,2,21,20,1535,1590,2695,1105
2018,2,21,21,1520,1564,2687,1123
2018,2,21,22,1510,1541,2687,1146
2018,2,21,23,1510,1530,2710,1180
2018,2,22,0,1525,1545,2684,1139
2018,2,22,1,1570,1590,2673,1083
2018,2,22,2,1625,1672,2732,1060
2018,2,22,3,1620,1686,2751,1065
2018,2,22,4,1590,1662,2746,1084
2018,2,22,5,1535,1607,2718,1111
2018,2,22,6,1465,1513,2651,1138
2018,2,22,7,1405,1452,2651,1199
2018,2,22,8,1405,1439,2656,1217
2018,2,22,9,1390,1419,2646,1227
2018,2,22,10,1385,1410,2613,1203
2018,2,22,11,1400,1420,2610,1190
2018,2,22,12,1420,1447,2622,1175
2018,2,22,13,1465,1495,2638,1143
2018,2,22,14,1555,1632,2708,1076
2018,2,22,15,1615,1703,2694,991
2018,2,22,16,1615,1680,2684,1004
2018,2,22,17,1605,1620,2647,1027
2018,2,22,18,1590,1608,2582,974
2018,2,22,19,1560,1582,2660,1078
2018,2,22,20,1535,1558,2663,1105
2018,2,22,21,1525,1532,2659,1127
2018,2,22,22,1515,1519,2666,1147
2018,2,22,23,1510,1521,2688,1167
2018,2,23,0,1530,1542,2725,1183
2018,2,23,1,1565,1575,2713,1138
2018,2,23,2,1635,1642,2726,1084
2018,2,23,3,1645,1661,2622,961
2018,2,23,4,1625,1642,2591,949
2018,2,23,5,1555,1577,2538,961
2018,2,23,6,1480,1515,2555,1040
2018,2,23,7,1425,1453,2561,1108
2018,2,23,8,1410,1429,2550,1121
2018,2,23,9,1390,1413,2545,1132
2018,2,23,10,1395,1416,2577,1161
2018,2,23,11,1400,1426,2586,1160
2018,2,23,12,1420,1447,2598,1151
2018,2,23,13,1470,1500,2657,1157
2018,2,23,14,1595,1594,2675,1081
2018,2,23,15,1675,1688,2696,1008
2018,2,23,16,1670,1650,2678,1028
2018,2,23,17,1655,1642,2720,1078
2018,2,23,18,1630,1624,2785,1161
2018,2,23,19,1595,1600,2776,1176
2018,2,23,20,1585,1558,2783,1225
2018,2,23,21,1565,1549,2749,1200
2018,2,23,22,1540,1511,2724,1213
2018,2,23,23,1530,1496,2700,1204
2018,2,24,0,1545,1505,2700,1195
2018,2,24,1,1590,1540,2787,1247
2018,2,24,2,1660,1618,2783,1165
2018,2,24,3,1655,1618,2792,1174
2018,2,24,4,1630,1596,2800,1204
2018,2,24,5,1580,1547,2794,1247
2018,2,24,6,1500,1481,2784,1303
2018,2,24,7,1435,1423,2639,1216
2018,2,24,8,1305,1379,2578,1199
2018,2,24,9,1285,1352,2586,1234
2018,2,24,10,1270,1354,2634,1280
2018,2,24,11,1265,1363,2677,1314
2018,2,24,12,1275,1381,2699,1318
2018,2,24,13,1305,1395,2730,1335
2018,2,24,14,1395,1449,2776,1327
2018,2,24,15,1475,1485,2768,1283
2018,2,24,16,1515,1514,2741,1227
2018,2,24,17,1510,1517,2629,1112
2018,2,24,18,1495,1505,2435,930
2018,2,24,19,1480,1469,2302,833
2018,2,24,20,1455,1443,2241,798
2018,2,24,21,1430,1384,1882,498
2018,2,24,22,1415,1365,1800,435
2018,2,24,23,1415,1380,1860,480
2018,2,25,0,1435,1413,1688,275
2018,2,25,1,1465,1457,1868,411
2018,2,25,2,1555,1539,2482,943
2018,2,25,3,1545,1544,2562,1018
2018,2,25,4,1510,1540,2553,1013
2018,2,25,5,1450,1474,2170,696
2018,2,25,6,1410,1404,1962,558
2018,2,25,7,1345,1362,2042,680
2018,2,25,8,1285,1324,2089,765
2018,2,25,9,1255,1303,1976,673
2018,2,25,10,1245,1290,1854,564
2018,2,25,11,1250,1297,1858,561
2018,2,25,12,1260,1298,1903,605
2018,2,25,13,1285,1307,1965,658
2018,2,25,14,1380,1352,2126,774
2018,2,25,15,1475,1390,2231,841
2018,2,25,16,1510,1424,2216,792
2018,2,25,17,1530,1450,2384,934
2018,2,25,18,1545,1445,2350,905
2018,2,25,19,1520,1449,2169,720
2018,2,25,20,1520,1420,1779,359
2018,2,25,21,1495,1406,1706,300
2018,2,25,22,1495,1398,1626,228
2018,2,25,23,1500,1400,1626,226
2018,2,26,0,1520,1416,1617,201
2018,2,26,1,1565,1478,2148,670
2018,2,26,2,1605,1581,2641,1060
2018,2,26,3,1580,1592,2657,1065
2018,2,26,4,1560,1552,2749,1197
2018,2,26,5,1540,1477,2709,1232
2018,2,26,6,1435,1394,2548,1154
2018,2,26,7,1375,1324,2408,1084
2018,2,26,8,1245,1274,2195,921
2018,2,26,9,1235,1279,2241,962
2018,2,26,10,1225,1263,2304,1041
2018,2,26,11,1230,1276,2341,1065
2018,2,26,12,1230,1304,2302,998
2018,2,26,13,1315,1343,2409,1066
2018,2,26,14,1455,1475,2595,1120
2018,2,26,15,1575,1549,2684,1135
2018,2,26,16,1575,1528,2689,1161
2018,2,26,17,1555,1533,2749,1216
2018,2,26,18,1555,1516,2726,1210
2018,2,26,19,1525,1471,2613,1142
2018,2,26,20,1500,1471,2629,1158
2018,2,26,21,1485,1435,2569,1134
2018,2,26,22,1470,1439,2587,1148
2018,2,26,23,1475,1427,2583,1156
2018,2,27,0,1490,1450,2567,1117
2018,2,27,1,1540,1476,2621,1145
2018,2,27,2,1595,1560,2700,1140
2018,2,27,3,1585,1561,2686,1125
2018,2,27,4,1560,1544,2662,1118
2018,2,27,5,1575,1502,2677,1175
2018,2,27,6,1410,1413,2650,1237
2018,2,27,7,1350,1351,2399,1048
2018,2,27,8,1295,1307,2302,995
2018,2,27,9,1275,1326,2619,1293
2018,2,27,10,1270,1322,2588,1266
2018,2,27,11,1275,1335,2591,1256
2018,2,27,12,1290,1355,2537,1182
2018,2,27,13,1330,1420,2463,1043
2018,2,27,14,1445,1550,2637,1087
2018,2,27,15,1530,1628,2683,1055
2018,2,27,16,1535,1589,2751,1162
2018,2,27,17,1530,1576,2733,1157
2018,2,27,18,1510,1545,2728,1183
2018,2,27,19,1490,1522,2754,1232
2018,2,27,20,1460,1492,2743,1251
2018,2,27,21,1455,1495,2670,1175
2018,2,27,22,1445,1460,2694,1234
2018,2,27,23,1440,1454,2593,1139
2018,2,28,0,1460,1459,2672,1213
2018,2,28,1,1510,1494,2674,1180
2018,2,28,2,1585,1574,2750,1176
2018,2,28,3,1580,1583,2763,1180
2018,2,28,4,1540,1567,2755,1188
2018,2,28,5,1490,1510,2746,1236
2018,2,28,6,1385,1422,2644,1222
2018,2,28,7,1325,1346,2542,1196
2018,2,28,8,1265,1309,2177,868
2018,2,28,9,1285,1268,1993,725
2018,2,28,10,1275,1270,1989,719
2018,2,28,11,1285,1280,2059,779
2018,2,28,12,1295,1287,2133,846
2018,2,28,13,1345,1362,2549,1187
2018,2,28,14,1475,1475,2657,1182
2018,2,28,15,1545,1536,2742,1206
2018,2,28,16,1530,1509,2736,1227
2018,2,28,17,1510,1472,2756,1284
2018,2,28,18,1505,1455,2746,1291
2018,2,28,19,1465,1420,2680,1260
2018,2,28,20,1440,1388,2736,1348
2018,2,28,21,1430,1375,2701,1326
2018,2,28,22,1430,1348,2601,1253
2018,2,28,23,1430,1356,2572,1216
2018,3,1,0,1455,1362,2583,1221
2018,3,1,1,1495,1400,2699,1299
2018,3,1,2,1560,1461,2682,1221
2018,3,1,3,1550,1498,2702,1204
2018,3,1,4,1520,1506,2754,1248
2018,3,1,5,1465,1463,2779,1316
2018,3,1,6,1385,1376,2754,1378
2018,3,1,7,-9999,1317,2582,1265
2018,3,1,8,1270,1289,2604,1315
2018,3,1,9,1270,1258,2367,1109
2018,3,1,10,1265,1266,2280,1014
2018,3,1,11,1275,1266,2286,1020
2018,3,1,12,1295,1285,2299,1014
2018,3,1,13,1350,1366,2648,1282
2018,3,1,14,1445,1491,2695,1204
2018,3,1,15,1515,1557,2746,1189
2018,3,1,16,1495,1563,2715,1152
2018,3,1,17,1490,1552,2735,1183
2018,3,1,18,1475,1521,2725,1204
2018,3,1,19,1460,1495,2711,1216
2018,3,1,20,1440,1449,2660,1211
2018,3,1,21,1435,1435,2643,1208
2018,3,1,22,1420,1427,2658,1231
2018,3,1,23,1415,1419,2662,1243
2018,3,2,0,1435,1407,2645,1238
2018,3,2,1,1480,1439,2650,1211
2018,3,2,2,1550,1506,2629,1123
2018,3,2,3,1555,1512,2687,1175
2018,3,2,4,1540,1502,2650,1148
2018,3,2,5,1470,1437,2671,1234
2018,3,2,6,1395,1383,2703,1320
2018,3,2,7,1330,1308,2660,1352
2018,3,2,8,1255,1272,2632,1360
2018,3,2,9,1245,1267,2647,1380
2018,3,2,10,1235,1269,2649,1380
2018,3,2,11,1245,1268,2642,1374
2018,3,2,12,1260,1287,2664,1377
2018,3,2,13,1310,1326,2702,1376
2018,3,2,14,1435,1444,2711,1267
2018,3,2,15,1515,1510,2719,1209
2018,3,2,16,1495,1511,2713,1202
2018,3,2,17,1485,1498,2672,1174
2018,3,2,18,1470,1482,2680,1198
2018,3,2,19,1435,1451,2688,1237
2018,3,2,20,1420,1421,2692,1271
2018,3,2,21,1395,1410,2679,1269
2018,3,2,22,1385,1409,2703,1294
2018,3,2,23,1375,1414,2708,1294
2018,3,3,0,1395,1420,2706,1286
2018,3,3,1,1425,1439,2675,1236
2018,3,3,2,1490,1471,2687,1216
2018,3,3,3,1500,1478,2724,1246
2018,3,3,4,1485,1463,2724,1261
2018,3,3,5,1435,1419,2709,1290
2018,3,3,6,1355,1363,2744,1381
2018,3,3,7,1295,1298,2552,1254
2018,3,3,8,1235,1278,2504,1226
2018,3,3,9,1215,1266,2454,1188
2018,3,3,10,1205,1277,2432,1155
2018,3,3,11,1210,1263,2417,1154
2018,3,3,12,1225,1281,2579,1298
2018,3,3,13,1265,1311,2638,1327
2018,3,3,14,1370,1366,2693,1327
2018,3,3,15,1450,1410,2677,1267
2018,3,3,16,1480,1447,2666,1219
2018,3,3,17,1485,1459,2678,1219
2018,3,3,18,1470,1456,2676,1220
2018,3,3,19,1450,1442,2716,1274
2018,3,3,20,1420,1408,2711,1303
2018,3,3,21,1400,1387,2702,1315
2018,3,3,22,1395,1383,2697,1314
2018,3,3,23,1395,1375,2692,1317
2018,3,4,0,1415,1391,2703,1312
2018,3,4,1,1460,1427,2689,1262
2018,3,4,2,1520,1489,2672,1183
2018,3,4,3,1510,1494,2677,1183
2018,3,4,4,1490,1465,2674,1209
2018,3,4,5,1430,1433,2700,1267
2018,3,4,6,1370,1386,2714,1328
2018,3,4,7,1305,1332,2690,1358
2018,3,4,8,1265,1301,2668,1367
2018,3,4,9,1245,1294,2663,1369
2018,3,4,10,1245,1284,2655,1371
2018,3,4,11,1250,1284,2647,1363
2018,3,4,12,1260,1301,2670,1369
2018,3,4,13,1290,1324,2815,1491
2018,3,4,14,1360,1361,2823,1462
2018,3,4,15,1410,1405,2820,1415
2018,3,4,16,1445,1461,2796,1335
2018,3,4,17,1470,1496,2810,1314
2018,3,4,18,1460,1499,2815,1316
2018,3,4,19,1460,1490,2811,1321
2018,3,4,20,1440,1492,2754,1262
2018,3,4,21,1425,1466,2664,1198
2018,3,4,22,1420,1438,2349,911
2018,3,4,23,1420,1439,2270,831
2018,3,5,0,1430,1463,2437,974
2018,3,5,1,1485,1512,2625,1113
2018,3,5,2,1560,1578,2781,1203
2018,3,5,3,1560,1581,2873,1292
2018,3,5,4,1525,1538,2824,1286
2018,3,5,5,1445,1480,2816,1336
2018,3,5,6,1390,1414,2799,1385
2018,3,5,7,1330,1344,2680,1336
2018,3,5,8,1255,1307,2590,1283
2018,3,5,9,1250,1286,2496,1210
2018,3,5,10,1240,1281,2483,1202
2018,3,5,11,1250,1293,2519,1226
2018,3,5,12,1270,1323,2578,1255
2018,3,5,13,1320,1368,2629,1261
2018,3,5,14,1455,1495,2683,1188
2018,3,5,15,1535,1571,2880,1309
2018,3,5,16,1530,1556,2711,1155
2018,3,5,17,1525,1541,2629,1088
2018,3,5,18,1505,1528,2672,1144
2018,3,5,19,1470,1513,2634,1121
2018,3,5,20,1450,1473,2516,1043
2018,3,5,21,1425,1446,2445,999
2018,3,5,22,1425,1412,2421,1009
2018,3,5,23,1415,1431,2397,966
2018,3,6,0,1430,1418,2356,938
2018,3,6,1,1455,1461,2470,1009
2018,3,6,2,1535,1540,2751,1211
2018,3,6,3,1535,1561,2735,1174
2018,3,6,4,1520,1520,2716,1196
2018,3,6,5,1470,1459,2540,1081
2018,3,6,6,1390,1373,2546,1173
2018,3,6,7,1325,1321,2462,1141
2018,3,6,8,1240,1280,2484,1204
2018,3,6,9,1230,1268,2414,1146
2018,3,6,10,1230,1264,2505,1241
2018,3,6,11,1235,1271,2520,1249
2018,3,6,12,1250,1277,2497,1220
2018,3,6,13,1305,1339,2482,1143
2018,3,6,14,1425,1457,2489,1032
2018,3,6,15,1505,1528,2688,1160
2018,3,6,16,1510,1509,2677,1168
2018,3,6,17,1515,1494,2681,1187
2018,3,6,18,1495,1470,2673,1203
2018,3,6,19,1475,1442,2616,1174
2018,3,6,20,1450,1412,2577,1165
2018,3,6,21,1435,1396,2518,1122
2018,3,6,22,1415,1376,2506,1130
2018,3,6,23,1410,1369,2512,1143
2018,3,7,0,1415,1373,2483,1110
2018,3,7,1,1455,1403,2511,1108
2018,3,7,2,1525,1474,2508,1034
2018,3,7,3,1530,1513,2542,1029
2018,3,7,4,1510,1511,2542,1031
2018,3,7,5,1440,1455,2547,1092
2018,3,7,6,1380,1395,2553,1158
2018,3,7,7,1305,1329,2493,1164
2018,3,7,8,1270,1298,2467,1169
2018,3,7,9,1240,1278,2472,1194
2018,3,7,10,1240,1287,2548,1261
2018,3,7,11,1250,1298,2597,1299
2018,3,7,12,1265,1312,2566,1254
2018,3,7,13,1320,1384,2619,1235
2018,3,7,14,1440,1507,2685,1178
2018,3,7,15,1505,1574,2749,1175
2018,3,7,16,1490,1551,2754,1203
2018,3,7,17,1465,1511,2736,1225
2018,3,7,18,1455,1479,2744,1265
2018,3,7,19,1425,1458,2672,1214
2018,3,7,20,1390,1418,2667,1249
2018,3,7,21,1375,1398,2654,1256
2018,3,7,22,1350,1376,2553,1177
2018,3,7,23,1360,1358,2537,1179
2018,3,8,0,1365,1367,2598,1231
2018,3,8,1,1400,1385,2607,1222
2018,3,8,2,1470,1453,2571,1118
2018,3,8,3,1490,1480,2571,1091
2018,3,8,4,1470,1463,2572,1109
2018,3,8,5,1410,1414,2615,1201
2018,3,8,6,1335,1322,2552,1230
2018,3,8,7,1275,1276,2515,1239
2018,3,8,8,1225,1239,2387,1148
2018,3,8,9,1205,1210,2260,1050
2018,3,8,10,1210,1216,2333,1117
2018,3,8,11,1215,1213,2358,1145
2018,3,8,12,1225,1228,2348,1120
2018,3,8,13,1290,1289,2361,1072
2018,3,8,14,1415,1426,2609,1183
2018,3,8,15,1485,1490,2607,1117
2018,3,8,16,1485,1493,2625,1132
2018,3,8,17,1470,1487,2641,1154
2018,3,8,18,1445,1467,2643,1176
2018,3,8,19,1425,1438,2525,1087
2018,3,8,20,1385,1422,2528,1106
2018,3,8,21,1370,1405,2523,1118
2018,3,8,22,1355,1405,2526,1121
2018,3,8,23,1350,1404,2531,1127
2018,3,9,0,1350,1400,2545,1145
2018,3,9,1,1380,1415,2723,1308
2018,3,9,2,1455,1470,2747,1277
2018,3,9,3,1475,1502,2812,1310
2018,3,9,4,1465,1468,2810,1342
2018,3,9,5,1415,1417,2755,1338
2018,3,9,6,1345,1332,2602,1270
2018,3,9,7,1275,1257,2448,1191
2018,3,9,8,1220,1216,2142,926
2018,3,9,9,1205,1185,1913,728
2018,3,9,10,1210,1190,1903,713
2018,3,9,11,1215,1198,1890,692
2018,3,9,12,1235,1223,2102,879
2018,3,9,13,1290,1280,2242,962
2018,3,9,14,1430,1410,2549,1139
2018,3,9,15,1530,1487,2859,1372
2018,3,9,16,1515,1492,2846,1354
2018,3,9,17,1490,1466,2719,1253
2018,3,9,18,1470,1449,2595,1146
2018,3,9,19,1440,1399,2426,1027
2018,3,9,20,1410,1378,2237,859
2018,3,9,21,1395,1362,2206,844
2018,3,9,22,1375,1353,1976,623
2018,3,9,23,1370,1346,2047,701
2018,3,10,0,1375,1365,2021,656
2018,3,10,1,1400,1384,2274,890
2018,3,10,2,1455,1460,2678,1218
2018,3,10,3,1470,1470,2792,1322
2018,3,10,4,1455,1457,2826,1369
2018,3,10,5,1405,1420,2772,1352
2018,3,10,6,1330,1360,2749,1389
2018,3,10,7,1280,1312,2704,1392
2018,3,10,8,1220,1268,2623,1355
2018,3,10,9,1195,1238,2621,1383
2018,3,10,10,1200,1233,2625,1392
2018,3,10,11,1200,1230,2652,1422
2018,3,10,12,1215,1240,2695,1455
2018,3,10,13,1255,1270,2781,1511
2018,3,10,14,1375,1322,2710,1388
2018,3,10,15,1465,1363,2803,1440
2018,3,10,16,1485,1401,2806,1405
2018,3,10,17,1490,1409,2770,1361
2018,3,10,18,1475,1412,2787,1375
2018,3,10,19,1450,1380,2755,1375
2018,3,10,20,1430,1343,2716,1373
2018,3,10,21,1395,1320,2719,1399
2018,3,10,22,1385,1289,2569,1280
2018,3,10,23,1385,1288,2569,1281
2018,3,11,0,1400,1305,2553,1248
2018,3,11,1,1430,1321,2490,1169
2018,3,11,2,1495,1376,2496,1120
2018,3,11,3,1505,1417,2687,1270
2018,3,11,4,1490,1402,2710,1308
2018,3,11,5,1410,1368,2712,1344
2018,3,11,6,1365,1314,2705,1391
2018,3,11,7,1305,1271,2714,1443
2018,3,11,8,1205,1233,2678,1445
2018,3,11,9,1185,1166,2419,1253
2018,3,11,10,1185,1214,2467,1253
2018,3,11,11,1185,1227,2513,1286
2018,3,11,12,1195,1241,2598,1357
2018,3,11,13,1225,1282,2658,1376
2018,3,11,14,1335,1330,2741,1411
2018,3,11,15,1410,1368,2709,1341
2018,3,11,16,1435,1390,2665,1275
2018,3,11,17,1450,1391,2666,1275
2018,3,11,18,1440,1389,2673,1284
2018,3,11,19,1430,1364,2680,1316
2018,3,11,20,1415,1346,2692,1346
2018,3,11,21,1400,1323,2694,1371
2018,3,11,22,1390,1309,2659,1350
2018,3,11,23,1395,1312,2709,1397
2018,3,12,0,1400,1328,2720,1392
2018,3,12,1,1435,1371,2752,1381
2018,3,12,2,1505,1415,2749,1334
2018,3,12,3,1525,1444,2758,1314
2018,3,12,4,1485,1403,2760,1357
2018,3,12,5,1405,1332,2731,1399
2018,3,12,6,1345,1246,2586,1340
2018,3,12,7,1200,1220,2569,1349
2018,3,12,8,1180,1202,2579,1377
2018,3,12,9,1185,1214,2653,1439
2018,3,12,10,1190,1215,2653,1438
2018,3,12,11,1210,1239,2679,1440
2018,3,12,12,1270,1289,2656,1367
2018,3,12,13,1425,1407,2676,1269
2018,3,12,14,1515,1511,2790,1279
2018,3,12,15,1505,1509,2745,1236
2018,3,12,16,1480,1494,2738,1244
2018,3,12,17,1460,1460,2717,1257
2018,3,12,18,1440,1439,2673,1234
2018,3,12,19,1405,1397,2669,1272
2018,3,12,20,1385,1376,2663,1287
2018,3,12,21,1370,1354,2662,1308
2018,3,12,22,1365,1331,2661,1330
2018,3,12,23,1365,1321,2650,1329
2018,3,13,0,1385,1300,2640,1340
2018,3,13,1,1450,1322,2642,1320
2018,3,13,2,1480,1384,2650,1266
2018,3,13,3,1450,1418,2655,1237
2018,3,13,4,1390,1375,2637,1262
2018,3,13,5,1310,1305,2614,1309
2018,3,13,6,1255,1230,2407,1177
2018,3,13,7,1200,1196,2298,1102
2018,3,13,8,1180,1193,2512,1319
2018,3,13,9,1180,1197,2556,1359
2018,3,13,10,1180,1218,2653,1435
2018,3,13,11,1190,1230,2657,1427
2018,3,13,12,1245,1281,2665,1384
2018,3,13,13,1365,1416,2684,1268
2018,3,13,14,1430,1504,2728,1224
2018,3,13,15,1430,1496,2727,1231
2018,3,13,16,1425,1461,2698,1237
2018,3,13,17,1405,1423,2687,1264
2018,3,13,18,1380,1404,2707,1303
2018,3,13,19,1360,1366,2716,1350
2018,3,13,20,1340,1357,2725,1368
2018,3,13,21,1330,1320,2715,1395
2018,3,13,22,1325,1307,2713,1406
2018,3,13,23,1325,1298,2707,1409
2018,3,14,0,1345,1293,2701,1408
2018,3,14,1,1405,1309,2705,1396
2018,3,14,2,1440,1359,2718,1359
2018,3,14,3,1425,1384,2726,1342
2018,3,14,4,1365,1349,2719,1370
2018,3,14,5,1305,1284,2703,1419
2018,3,14,6,1240,1202,2627,1425
2018,3,14,7,1185,1174,2663,1489
2018,3,14,8,1170,1165,2619,1454
2018,3,14,9,1175,1158,2610,1452
2018,3,14,10,1180,1170,2630,1460
2018,3,14,11,1200,1187,2609,1422
2018,3,14,12,1260,1250,2658,1408
2018,3,14,13,1380,1368,2684,1316
2018,3,14,14,1475,1459,2741,1282
2018,3,14,15,1465,1450,2724,1274
2018,3,14,16,1440,1430,2737,1307
2018,3,14,17,1405,1416,2719,1303
2018,3,14,18,1385,1396,2707,1311
2018,3,14,19,1345,1371,2711,1340
2018,3,14,20,1325,1354,2707,1353
2018,3,14,21,1305,1346,2539,1193
2018,3,14,22,1285,1338,2519,1181
2018,3,14,23,1285,1346,2508,1162
2018,3,15,0,1280,1345,2504,1159
2018,3,15,1,1325,1355,2667,1312
2018,3,15,2,1370,1402,2708,1306
2018,3,15,3,1385,1413,2725,1312
2018,3,15,4,1335,1353,2683,1330
2018,3,15,5,1260,1271,2682,1411
2018,3,15,6,1200,1208,2606,1398
2018,3,15,7,1145,1177,2637,1460
2018,3,15,8,1130,1194,2640,1446
2018,3,15,9,1135,1186,2674,1488
2018,3,15,10,1140,1219,2578,1359
2018,3,15,11,1155,1231,2537,1306
2018,3,15,12,1210,1290,2555,1265
2018,3,15,13,1365,1377,1738,361
2018,3,15,14,1465,1475,1730,255
2018,3,15,15,1460,1479,1789,310
2018,3,15,16,1440,1457,1786,329
2018,3,15,17,1410,1428,1697,269
2018,3,15,18,1385,1426,1723,297
2018,3,15,19,1360,1385,1703,318
2018,3,15,20,1345,1405,1723,318
2018,3,15,21,1325,1380,1742,362
2018,3,15,22,1315,1375,1789,414
2018,3,15,23,1305,1361,1810,449
2018,3,16,0,1310,1352,1786,434
2018,3,16,1,1345,1377,1940,563
2018,3,16,2,1385,1365,2151,786
2018,3,16,3,1385,1409,2197,788
2018,3,16,4,1340,1364,2337,973
2018,3,16,5,1270,1297,2377,1080
2018,3,16,6,1195,1234,2443,1209
2018,3,16,7,1140,1217,2538,1321
2018,3,16,8,1125,1185,1700,515
2018,3,16,9,1125,1179,1730,551
2018,3,16,10,1130,1144,1866,722
2018,3,16,11,1150,1165,1837,672
2018,3,16,12,1210,1229,1731,502
2018,3,16,13,1350,1357,1774,417
2018,3,16,14,1445,1448,2133,685
2018,3,16,15,1440,1457,2151,694
2018,3,16,16,1415,1466,2408,942
2018,3,16,17,1405,1450,2573,1123
2018,3,16,18,1375,1443,2667,1224
2018,3,16,19,1355,1403,2664,1261
2018,3,16,20,1340,1358,2657,1299
2018,3,16,21,1335,1322,2631,1309
2018,3,16,22,1330,1315,2651,1336
2018,3,16,23,1340,1318,2640,1322
2018,3,17,0,1345,1311,2650,1339
2018,3,17,1,1380,1317,2642,1325
2018,3,17,2,1405,1350,2676,1326
2018,3,17,3,1405,1395,2707,1312
2018,3,17,4,1335,1363,2736,1373
2018,3,17,5,1280,1303,2721,1418
2018,3,17,6,1220,1250,2598,1348
2018,3,17,7,1130,1221,2540,1319
2018,3,17,8,1115,1196,2589,1393
2018,3,17,9,1110,1191,2586,1395
2018,3,17,10,1115,1192,2587,1395
2018,3,17,11,1125,1210,2570,1360
2018,3,17,12,1165,1222,2559,1337
2018,3,17,13,1280,1275,2568,1293
2018,3,17,14,1375,1350,2702,1352
2018,3,17,15,1400,1384,2691,1307
2018,3,17,16,1395,1426,2704,1278
2018,3,17,17,1390,1434,2710,1276
2018,3,17,18,1370,1426,2718,1292
2018,3,17,19,1330,1399,2751,1352
2018,3,17,20,1320,1361,2690,1329
2018,3,17,21,1300,1340,2685,1345
2018,3,17,22,1300,1337,2690,1353
2018,3,17,23,1305,1339,2674,1335
2018,3,18,0,1315,1346,2670,1324
2018,3,18,1,1365,1345,2557,1212
2018,3,18,2,1375,1376,2483,1107
2018,3,18,3,1380,1425,2645,1220
2018,3,18,4,1340,1381,2511,1130
2018,3,18,5,1285,1330,2541,1211
2018,3,18,6,1230,1274,2447,1173
2018,3,18,7,1150,1239,2411,1172
2018,3,18,8,1130,1210,2144,934
2018,3,18,9,1125,1180,2061,881
2018,3,18,10,1130,1189,2080,891
2018,3,18,11,1145,1205,2088,883
2018,3,18,12,1180,1220,2113,893
2018,3,18,13,1290,1260,2427,1167
2018,3,18,14,1380,1321,2587,1266
2018,3,18,15,1410,1362,2606,1244
2018,3,18,16,1410,1383,2556,1173
2018,3,18,17,1405,1398,2594,1196
2018,3,18,18,1385,1375,2609,1234
2018,3,18,19,1350,1357,2604,1247
2018,3,18,20,1340,1359,2678,1319
2018,3,18,21,1320,1325,2728,1403
2018,3,18,22,1315,1328,2734,1406
2018,3,18,23,1320,1326,2695,1369
2018,3,19,0,1335,1347,2753,1406
2018,3,19,1,1380,1369,2730,1361
2018,3,19,2,1395,1416,2816,1400
2018,3,19,3,1395,1441,2784,1343
2018,3,19,4,1355,1402,2786,1384
2018,3,19,5,1295,1307,2707,1400
2018,3,19,6,1240,1234,2654,1420
2018,3,19,7,1140,1189,2643,1454
2018,3,19,8,1130,1162,2427,1265
2018,3,19,9,1125,1167,2461,1294
2018,3,19,10,1135,1168,2461,1293
2018,3,19,11,1155,1211,2668,1457
2018,3,19,12,1210,1273,2696,1423
2018,3,19,13,1335,1384,2742,1358
2018,3,19,14,1435,1482,2759,1277
2018,3,19,15,1430,1482,2792,1310
2018,3,19,16,1415,1465,2714,1249
2018,3,19,17,1385,1446,2765,1319
2018,3,19,18,1370,1418,2839,1421
2018,3,19,19,1335,1392,2840,1448
2018,3,19,20,1320,1378,2773,1395
2018,3,19,21,1305,1365,2740,1375
2018,3,19,22,1290,1356,2722,1366
2018,3,19,23,1290,1346,2711,1365
2018,3,20,0,1280,1339,2730,1391
2018,3,20,1,1295,1343,2695,1352
2018,3,20,2,1330,1373,2708,1335
2018,3,20,3,1360,1409,2701,1292
2018,3,20,4,1290,1376,2695,1319
2018,3,20,5,1240,1291,2733,1442
2018,3,20,6,1170,1225,2737,1512
2018,3,20,7,1150,1200,2783,1583
2018,3,20,8,1140,1191,2709,1518
2018,3,20,9,1130,1175,2706,1531
2018,3,20,10,1145,1185,2701,1516
2018,3,20,11,1160,1212,2699,1487
2018,3,20,12,1200,1275,2757,1482
2018,3,20,13,1330,1403,2838,1435
2018,3,20,14,1435,1487,2769,1282
2018,3,20,15,1445,1468,2753,1285
2018,3,20,16,1430,1447,2770,1323
2018,3,20,17,1410,1409,2772,1363
2018,3,20,18,1390,1379,2766,1387
2018,3,20,19,1355,1357,2723,1366
2018,3,20,20,1355,1352,2660,1308
2018,3,20,21,1325,1330,2444,1114
2018,3,20,22,1320,1330,2425,1095
2018,3,20,23,1310,1325,2383,1058
2018,3,21,0,1315,1318,2397,1079
2018,3,21,1,1335,1304,2359,1055
2018,3,21,2,1365,1336,2383,1047
2018,3,21,3,1395,1379,2396,1017
2018,3,21,4,1355,1339,2369,1030
2018,3,21,5,1275,1238,2354,1116
2018,3,21,6,1205,1187,2333,1146
2018,3,21,7,1145,1159,2355,1196
2018,3,21,8,1135,1162,2399,1237
2018,3,21,9,1130,1154,2418,1264
2018,3,21,10,1135,1159,2424,1265
2018,3,21,11,1165,1170,2417,1247
2018,3,21,12,1225,1244,2433,1189
2018,3,21,13,1340,1373,2455,1082
2018,3,21,14,1425,1470,2401,931
2018,3,21,15,1415,1441,2403,962
2018,3,21,16,1400,1423,2443,1020
2018,3,21,17,1380,1409,2368,959
2018,3,21,18,1355,1382,2361,979
2018,3,21,19,1330,1342,2355,1013
2018,3,21,20,1315,1326,2339,1013
2018,3,21,21,1305,1305,2339,1034
2018,3,21,22,1295,1292,2317,1025
2018,3,21,23,1295,1290,2356,1066
2018,3,22,0,1295,1255,2355,1100
2018,3,22,1,1305,1277,2384,1107
2018,3,22,2,1340,1305,2379,1074
2018,3,22,3,1365,1347,2428,1081
2018,3,22,4,1325,1322,2417,1095
2018,3,22,5,1235,1257,2436,1179
2018,3,22,6,1170,1189,2433,1244
2018,3,22,7,1130,1152,2408,1256
2018,3,22,8,1125,1128,2247,1119
2018,3,22,9,1115,1124,2238,1114
2018,3,22,10,1130,1127,2243,1116
2018,3,22,11,1145,1144,2263,1119
2018,3,22,12,1205,1200,2372,1172
2018,3,22,13,1340,1311,2368,1057
2018,3,22,14,1425,1412,2304,892
2018,3,22,15,1415,1412,2408,996
2018,3,22,16,1395,1409,2337,928
2018,3,22,17,1365,1381,2325,944
2018,3,22,18,1345,1369,2354,985
2018,3,22,19,1315,1338,2351,1013
2018,3,22,20,1315,1345,2332,987
2018,3,22,21,1300,1331,2274,943
2018,3,22,22,1300,1326,2270,944
2018,3,22,23,1295,1328,2276,948
2018,3,23,0,1290,1313,2138,825
2018,3,23,1,1300,1318,2209,891
2018,3,23,2,1310,1358,2293,935
2018,3,23,3,1345,1372,2390,1018
2018,3,23,4,1295,1336,2374,1038
2018,3,23,5,1220,1267,2365,1098
2018,3,23,6,1160,1204,2386,1182
2018,3,23,7,1140,1171,2378,1207
2018,3,23,8,1135,1147,2433,1286
2018,3,23,9,1130,1132,2495,1363
2018,3,23,10,1115,1136,2598,1462
2018,3,23,11,1130,1153,2700,1547
2018,3,23,12,1200,1209,2727,1518
2018,3,23,13,1335,1327,2756,1429
2018,3,23,14,1440,1417,2732,1315
2018,3,23,15,1425,1411,2674,1263
2018,3,23,16,1410,1401,2692,1291
2018,3,23,17,1400,1380,2665,1285
2018,3,23,18,1375,1358,2655,1297
2018,3,23,19,1340,1315,2612,1297
2018,3,23,20,1310,1313,2566,1253
2018,3,23,21,1285,1300,2577,1277
2018,3,23,22,1275,1275,2358,1083
2018,3,23,23,1280,1262,2332,1070
2018,3,24,0,1260,1256,2341,1085
2018,3,24,1,1280,1259,2420,1161
2018,3,24,2,1310,1296,2627,1331
2018,3,24,3,1345,1320,2664,1344
2018,3,24,4,1310,1310,2701,1391
2018,3,24,5,1250,1249,2667,1418
2018,3,24,6,1195,1193,2677,1484
2018,3,24,7,1180,1162,2686,1524
2018,3,24,8,1150,1139,2608,1469
2018,3,24,9,1150,1146,2645,1499
2018,3,24,10,1145,1147,2633,1486
2018,3,24,11,1160,1141,2366,1225
2018,3,24,12,1185,1178,2258,1080
2018,3,24,13,1255,1221,2419,1198
2018,3,24,14,1330,1288,2476,1188
2018,3,24,15,1355,1339,2475,1136
2018,3,24,16,1375,1352,2441,1089
2018,3,24,17,1375,1347,2426,1079
2018,3,24,18,1355,1316,2185,869
2018,3,24,19,1325,1279,2072,793
2018,3,24,20,1300,1263,2033,770
2018,3,24,21,1280,1236,1797,561
2018,3,24,22,1280,1240,1699,459
2018,3,24,23,1285,1241,1635,394
2018,3,25,0,1295,1252,1865,613
2018,3,25,1,1315,1268,2104,836
2018,3,25,2,1355,1319,2508,1189
2018,3,25,3,1365,1355,2710,1355
2018,3,25,4,1325,1324,2653,1329
2018,3,25,5,1275,1277,2679,1402
2018,3,25,6,1220,1243,2665,1422
2018,3,25,7,1185,1201,2659,1458
2018,3,25,8,1145,1179,2528,1349
2018,3,25,9,1150,1170,2531,1361
2018,3,25,10,1160,1166,2522,1356
2018,3,25,11,1190,1172,2541,1369
2018,3,25,12,1225,1198,2596,1398
2018,3,25,13,1290,1239,2629,1390
2018,3,25,14,1360,1307,2664,1357
2018,3,25,15,1380,1346,2677,1331
2018,3,25,16,1385,1353,2631,1278
2018,3,25,17,1380,1341,2580,1239
2018,3,25,18,1360,1329,2379,1050
2018,3,25,19,1335,1294,2327,1033
2018,3,25,20,1330,1248,1836,588
2018,3,25,21,1315,1232,1635,403
2018,3,25,22,1320,1239,1632,393
2018,3,25,23,1335,1237,1622,385
2018,3,26,0,1360,1255,1635,380
2018,3,26,1,1380,1276,1734,458
2018,3,26,2,1395,1314,1853,539
2018,3,26,3,1385,1357,2108,751
2018,3,26,4,1340,1312,1933,621
2018,3,26,5,1275,1238,1925,687
2018,3,26,6,1230,1177,2018,841
2018,3,26,7,1135,1159,1998,839
2018,3,26,8,1130,1131,1784,653
2018,3,26,9,1125,1131,1648,517
2018,3,26,10,1130,1136,1629,493
2018,3,26,11,1155,1168,1697,529
2018,3,26,12,1215,1231,2050,819
2018,3,26,13,1335,1358,2440,1082
2018,3,26,14,1435,1471,2697,1226
2018,3,26,15,1420,1452,2716,1264
2018,3,26,16,1405,1450,2743,1293
2018,3,26,17,1385,1422,2713,1291
2018,3,26,18,1355,1409,2666,1257
2018,3,26,19,1325,1371,2288,917
2018,3,26,20,1305,1347,2060,713
2018,3,26,21,1290,1336,1842,506
2018,3,26,22,1275,1323,1798,475
2018,3,26,23,1270,1305,1812,507
2018,3,27,0,1250,1320,2016,696
2018,3,27,1,1270,1340,2306,966
2018,3,27,2,1305,1369,2484,1115
2018,3,27,3,1345,1405,2609,1204
2018,3,27,4,1310,1364,2496,1132
2018,3,27,5,1235,1274,2309,1035
2018,3,27,6,1170,1216,2469,1253
2018,3,27,7,1150,1168,1988,820
2018,3,27,8,1130,1152,2147,995
2018,3,27,9,1125,1151,2148,997
2018,3,27,10,1130,1148,2215,1067
2018,3,27,11,1145,1180,2306,1126
2018,3,27,12,1195,1243,2531,1288
2018,3,27,13,1295,1359,2755,1396
2018,3,27,14,1385,1445,2896,1451
2018,3,27,15,1385,1442,2899,1457
2018,3,27,16,1380,1421,2827,1406
2018,3,27,17,1350,1392,2757,1365
2018,3,27,18,1335,1379,2774,1395
2018,3,27,19,1305,1340,2491,1151
2018,3,27,20,1300,1315,2470,1155
2018,3,27,21,1285,1293,2366,1073
2018,3,27,22,1290,1294,2296,1002
2018,3,27,23,1290,1310,2431,1121
2018,3,28,0,1290,1331,2549,1218
2018,3,28,1,1290,1355,2615,1260
2018,3,28,2,1325,1381,2662,1281
2018,3,28,3,1350,1408,2776,1368
2018,3,28,4,1300,1356,2737,1381
2018,3,28,5,1230,1267,2767,1500
2018,3,28,6,1170,1197,2681,1484
2018,3,28,7,1115,1163,2610,1447
2018,3,28,8,1110,1122,2155,1033
2018,3,28,9,1105,1120,2004,884
2018,3,28,10,1115,1124,2027,903
2018,3,28,11,1130,1145,2123,978
2018,3,28,12,1195,1215,2381,1166
2018,3,28,13,1325,1334,2590,1256
2018,3,28,14,1425,1402,2737,1335
2018,3,28,15,1405,1431,2730,1299
2018,3,28,16,1390,1409,2720,1311
2018,3,28,17,1375,1384,2588,1204
2018,3,28,18,1350,1370,2470,1100
2018,3,28,19,1325,1341,2301,960
2018,3,28,20,1305,1323,2268,945
2018,3,28,21,1290,1314,2247,933
2018,3,28,22,1280,1305,2245,940
2018,3,28,23,1280,1310,2282,972
2018,3,29,0,1270,1303,2425,1122
2018,3,29,1,1285,1299,2440,1141
2018,3,29,2,1315,1331,2633,1302
2018,3,29,3,1345,1373,2643,1270
2018,3,29,4,1295,1323,2547,1224
2018,3,29,5,1225,1256,2544,1288
2018,3,29,6,1160,1201,2391,1190
2018,3,29,7,1150,1182,2333,1151
2018,3,29,8,1130,1141,2079,938
2018,3,29,9,1130,1143,2051,908
2018,3,29,10,1130,1146,2180,1034
2018,3,29,11,1155,1178,2348,1170
2018,3,29,12,1210,1236,2455,1219
2018,3,29,13,1325,1355,2458,1103
2018,3,29,14,1425,1431,2541,1110
2018,3,29,15,1420,1432,2500,1068
2018,3,29,16,1410,1412,2490,1078
2018,3,29,17,1385,1413,2492,1079
2018,3,29,18,1370,1407,2498,1091
2018,3,29,19,1335,1368,2525,1157
2018,3,29,20,1330,1337,2567,1230
2018,3,29,21,1310,1307,2521,1214
2018,3,29,22,1315,1302,2519,1217
2018,3,29,23,1320,1281,2509,1228
2018,3,30,0,1325,1281,2516,1235
2018,3,30,1,1335,1286,2536,1250
2018,3,30,2,1370,1321,2549,1228
2018,3,30,3,1385,1340,2528,1188
2018,3,30,4,1335,1316,2544,1228
2018,3,30,5,1260,1243,2543,1300
2018,3,30,6,1185,1193,2475,1282
2018,3,30,7,1130,1160,2459,1299
2018,3,30,8,1115,1149,2396,1247
2018,3,30,9,1110,1144,2429,1285
2018,3,30,10,1115,1131,2278,1147
2018,3,30,11,1135,1149,2247,1098
2018,3,30,12,1195,1180,2215,1035
2018,3,30,13,1310,1272,2358,1086
2018,3,30,14,1395,1343,2358,1015
2018,3,30,15,1395,1374,2353,979
2018,3,30,16,1380,1356,2226,870
2018,3,30,17,1365,1355,1850,495
2018,3,30,18,1345,1346,1871,525
2018,3,30,19,1315,1335,1904,569
2018,3,30,20,1305,1298,1792,494
2018,3,30,21,1290,1274,1760,486
2018,3,30,22,1280,1282,1617,335
2018,3,30,23,1270,1274,1624,350
2018,3,31,0,1265,1275,1593,318
2018,3,31,1,1270,1271,1648,377
2018,3,31,2,1300,1275,1686,411
2018,3,31,3,1335,1318,1973,655
2018,3,31,4,1295,1300,2071,771
2018,3,31,5,1235,1248,2135,887
2018,3,31,6,1175,1204,2360,1156
2018,3,31,7,1155,1183,2319,1136
2018,3,31,8,1130,1167,2274,1107
2018,3,31,9,1135,1159,2265,1106
2018,3,31,10,1130,1166,2262,1096
2018,3,31,11,1145,1164,2281,1117
2018,3,31,12,1175,1205,2317,1112
2018,3,31,13,1260,1256,2260,1004
2018,3,31,14,1345,1325,2276,951
2018,3,31,15,1375,1373,2277,904
2018,3,31,16,1400,1410,2268,858
2018,3,31,17,1400,1422,2247,825
2018,3,31,18,1390,1415,2262,847
2018,3,31,19,1355,1384,2271,887
2018,3,31,20,1325,1352,2239,887
2018,3,31,21,1305,1336,2215,879
2018,3,31,22,1305,1326,2119,793
2018,3,31,23,1300,1327,2035,708
2018,4,1,0,1305,1340,2041,701
2018,4,1,1,1315,1355,2153,798
2018,4,1,2,1350,1375,2182,807
2018,4,1,3,1385,1428,2202,774
2018,4,1,4,1345,1411,2212,801
2018,4,1,5,1290,1341,2202,861
2018,4,1,6,-9999,1284,2198,914
2018,4,1,7,1160,1244,2198,954
2018,4,1,8,1135,1236,2210,974
2018,4,1,9,1125,1209,2128,919
2018,4,1,10,1125,1217,2135,918
2018,4,1,11,1135,1229,2136,907
2018,4,1,12,1170,1253,2153,900
2018,4,1,13,1250,1304,2185,881
2018,4,1,14,1335,1345,2184,839
2018,4,1,15,1370,1391,2186,795
2018,4,1,16,1375,1394,2186,792
2018,4,1,17,1370,1363,2054,691
2018,4,1,18,1360,1342,1899,557
2018,4,1,19,1330,1305,1899,594
2018,4,1,20,1305,1284,1731,447
2018,4,1,21,1285,1250,1691,441
2018,4,1,22,1285,1240,1646,406
2018,4,1,23,1280,1249,1785,536
2018,4,2,0,1295,1249,1832,583
2018,4,2,1,1310,1270,1930,660
2018,4,2,2,1355,1308,2126,818
2018,4,2,3,1385,1361,2184,823
2018,4,2,4,1335,1329,2186,857
2018,4,2,5,1260,1278,2149,871
2018,4,2,6,1200,1231,2118,887
2018,4,2,7,1150,1196,2019,823
2018,4,2,8,1125,1183,2015,832
2018,4,2,9,1125,1193,1909,716
2018,4,2,10,1130,1208,1959,751
2018,4,2,11,1160,1213,2021,808
2018,4,2,12,1220,1261,2156,895
2018,4,2,13,1340,1366,2181,815
2018,4,2,14,1440,1457,2341,884
2018,4,2,15,1430,1464,2317,853
2018,4,2,16,1420,1475,2339,864
2018,4,2,17,1405,1490,2349,859
2018,4,2,18,1390,1474,2338,864
2018,4,2,19,1360,1465,2317,852
2018,4,2,20,1335,1450,2137,687
2018,4,2,21,1325,1439,1933,494
2018,4,2,22,1315,1422,1895,473
2018,4,2,23,1300,1449,1922,473
2018,4,3,0,1300,1462,2174,712
2018,4,3,1,1315,1484,2244,760
2018,4,3,2,1345,1468,2312,844
2018,4,3,3,1375,1509,2325,816
2018,4,3,4,1320,1474,2238,764
2018,4,3,5,1255,1373,2231,858
2018,4,3,6,1195,1303,2149,846
2018,4,3,7,1170,1268,2068,800
2018,4,3,8,1165,1251,2133,882
2018,4,3,9,1150,1264,2146,882
2018,4,3,10,1170,1260,2141,881
2018,4,3,11,1180,1277,2205,928
2018,4,3,12,1230,1326,2202,876
2018,4,3,13,1355,1440,2239,799
2018,4,3,14,1435,1518,2272,754
2018,4,3,15,1440,1510,2260,750
2018,4,3,16,1425,1481,2266,785
2018,4,3,17,1395,1450,2286,836
2018,4,3,18,1380,1431,2365,934
2018,4,3,19,1340,1399,2395,996
2018,4,3,20,1340,1379,2421,1042
2018,4,3,21,1320,1345,2388,1043
2018,4,3,22,1315,1334,2361,1027
2018,4,3,23,1310,1331,2349,1018
2018,4,4,0,1305,1321,2277,956
2018,4,4,1,1315,1353,2295,942
2018,4,4,2,1325,1368,2249,881
2018,4,4,3,1370,1416,2267,851
2018,4,4,4,1330,1372,2265,893
2018,4,4,5,1250,1286,2255,969
2018,4,4,6,1190,1222,2254,1032
2018,4,4,7,1135,1175,2174,999
2018,4,4,8,1115,1175,2205,1030
2018,4,4,9,1115,1158,2000,842
2018,4,4,10,1120,1160,1915,755
2018,4,4,11,1140,1174,1931,757
2018,4,4,12,1205,1238,2101,863
2018,4,4,13,1320,1366,2185,819
2018,4,4,14,1395,1424,2276,852
2018,4,4,15,1400,1433,2253,820
2018,4,4,16,1385,1426,2226,800
2018,4,4,17,1365,1400,2256,856
2018,4,4,18,1355,1380,2244,864
2018,4,4,19,1330,1342,2234,892
2018,4,4,20,1305,1331,2229,898
2018,4,4,21,1300,1323,2234,911
2018,4,4,22,1285,1320,2252,932
2018,4,4,23,1280,1318,2231,913
2018,4,5,0,1275,1323,2229,906
2018,4,5,1,1285,1342,2231,889
2018,4,5,2,1310,1354,2222,868
2018,4,5,3,1350,1391,2242,851
2018,4,5,4,1305,1343,2258,915
2018,4,5,5,1230,1271,2273,1002
2018,4,5,6,1170,1213,2262,1049
2018,4,5,7,1200,1197,2125,928
2018,4,5,8,1185,1183,2135,952
2018,4,5,9,1185,1172,2175,1003
2018,4,5,10,1195,1186,2222,1036
2018,4,5,11,1210,1195,2216,1021
2018,4,5,12,1265,1263,2316,1053
2018,4,5,13,1400,1378,2289,911
2018,4,5,14,1480,1452,2316,864
2018,4,5,15,1480,1446,2251,805
2018,4,5,16,1460,1441,2199,758
2018,4,5,17,1430,1452,2222,770
2018,4,5,18,1415,1428,2200,772
2018,4,5,19,1385,1402,2195,793
2018,4,5,20,1375,1388,2248,860
2018,4,5,21,1355,1377,2214,837
2018,4,5,22,1350,1368,2208,840
2018,4,5,23,1340,1381,2214,833
2018,4,6,0,1340,1402,2231,829
2018,4,6,1,1375,1415,2242,827
2018,4,6,2,1385,1441,2261,820
2018,4,6,3,1410,1473,2318,845
2018,4,6,4,1365,1440,2341,901
2018,4,6,5,1280,1348,2305,957
2018,4,6,6,1210,1298,2291,993
2018,4,6,7,1140,1270,2239,969
2018,4,6,8,1135,1242,2016,774
2018,4,6,9,1125,1251,1848,597
2018,4,6,10,1115,1264,1823,559
2018,4,6,11,1130,1285,1912,627
2018,4,6,12,1195,1354,2041,687
2018,4,6,13,1345,1454,2202,748
2018,4,6,14,1445,1534,2228,694
2018,4,6,15,1435,1535,2229,694
2018,4,6,16,1430,1532,2230,698
2018,4,6,17,1410,1525,2221,696
2018,4,6,18,1390,1496,2237,741
2018,4,6,19,1350,1447,2181,734
2018,4,6,20,1330,1430,2185,755
2018,4,6,21,1305,1401,2190,789
2018,4,6,22,1300,1385,2205,820
2018,4,6,23,1300,1373,2195,822
2018,4,7,0,1285,1366,2190,824
2018,4,7,1,1305,1360,2178,818
2018,4,7,2,1330,1377,2181,804
2018,4,7,3,1370,1420,2174,754
2018,4,7,4,1330,1380,2077,697
2018,4,7,5,1265,1332,2080,748
2018,4,7,6,1205,1276,2014,738
2018,4,7,7,1215,1253,1994,741
2018,4,7,8,1185,1220,1799,579
2018,4,7,9,1180,1222,1801,579
2018,4,7,10,1180,1220,1826,606
2018,4,7,11,1190,1217,1846,629
2018,4,7,12,1215,1236,1892,656
2018,4,7,13,1250,1285,2045,760
2018,4,7,14,1295,1333,2028,695
2018,4,7,15,1335,1402,2142,740
2018,4,7,16,1350,1421,2174,753
2018,4,7,17,1360,1420,2191,771
2018,4,7,18,1330,1407,2174,767
2018,4,7,19,1300,1375,2061,686
2018,4,7,20,1285,1337,2020,683
2018,4,7,21,1260,1303,1851,548
2018,4,7,22,1265,1306,1738,432
2018,4,7,23,1270,1299,1705,406
2018,4,8,0,1285,1329,1737,408
2018,4,8,1,1315,1352,1874,522
2018,4,8,2,1360,1343,1935,592
2018,4,8,3,1370,1380,1973,593
2018,4,8,4,1295,1339,2180,841
2018,4,8,5,1270,1293,2151,858
2018,4,8,6,1220,1219,1914,695
2018,4,8,7,1190,1175,1864,689
2018,4,8,8,1170,1145,1606,461
2018,4,8,9,1150,1138,1381,243
2018,4,8,10,1155,1134,1367,233
2018,4,8,11,1165,1149,1382,233
2018,4,8,12,1185,1161,1361,200
2018,4,8,13,1245,1214,1427,213
2018,4,8,14,1315,1247,1457,210
2018,4,8,15,1365,1311,1638,327
2018,4,8,16,1370,1340,1719,379
2018,4,8,17,1360,1328,1721,393
2018,4,8,18,1350,1320,1639,319
2018,4,8,19,1315,1301,1482,181
2018,4,8,20,1295,1293,1428,135
2018,4,8,21,1270,1268,1376,108
2018,4,8,22,1270,1274,1366,92
2018,4,8,23,1275,1273,1398,125
2018,4,9,0,1290,1288,1477,189
2018,4,9,1,1305,1306,1622,316
2018,4,9,2,1350,1316,1665,349
2018,4,9,3,1385,1365,1887,522
2018,4,9,4,1315,1318,1910,592
2018,4,9,5,1260,1236,1612,376
2018,4,9,6,1195,1177,1602,425
2018,4,9,7,1160,1127,1531,404
2018,4,9,8,1140,1115,1437,322
2018,4,9,9,1140,1120,1464,344
2018,4,9,10,1150,1108,1476,368
2018,4,9,11,1170,1139,1579,440
2018,4,9,12,1225,1174,1725,551
2018,4,9,13,1315,1310,2215,905
2018,4,9,14,1380,1386,2375,989
2018,4,9,15,1385,1388,2380,992
2018,4,9,16,1385,1384,2374,990
2018,4,9,17,1375,1363,2346,983
2018,4,9,18,1365,1344,2364,1020
2018,4,9,19,1345,1332,2334,1002
2018,4,9,20,1325,1306,2325,1019
2018,4,9,21,1320,1271,2228,957
2018,4,9,22,1310,1261,2233,972
2018,4,9,23,1310,1232,2201,969
2018,4,10,0,1315,1234,2187,953
2018,4,10,1,1325,1267,2243,976
2018,4,10,2,1340,1248,2093,845
2018,4,10,3,1375,1290,2076,786
2018,4,10,4,1315,1271,2049,778
2018,4,10,5,1250,1174,1871,697
2018,4,10,6,1190,1128,1650,522
2018,4,10,7,1135,1085,1636,551
2018,4,10,8,1110,1076,1628,552
2018,4,10,9,1115,1071,1672,601
2018,4,10,10,1115,1084,1669,585
2018,4,10,11,1140,1098,1698,600
2018,4,10,12,1195,1165,1878,713
2018,4,10,13,1320,1291,2160,869
2018,4,10,14,1410,1366,2240,874
2018,4,10,15,1405,1331,2192,861
2018,4,10,16,1385,1308,2206,898
2018,4,10,17,1370,1311,2232,921
2018,4,10,18,1360,1296,2246,950
2018,4,10,19,1325,1291,2294,1003
2018,4,10,20,1300,1288,2293,1005
2018,4,10,21,1275,1288,2318,1030
2018,4,10,22,1270,1277,2389,1112
2018,4,10,23,1265,1278,2329,1051
2018,4,11,0,1270,1261,2239,978
2018,4,11,1,1285,1247,2247,1000
2018,4,11,2,1315,1270,2142,872
2018,4,11,3,1345,1300,1984,684
2018,4,11,4,1295,1256,1991,735
2018,4,11,5,1220,1181,2005,824
2018,4,11,6,1160,1107,1990,883
2018,4,11,7,1105,1075,1902,827
2018,4,11,8,1090,1049,1673,624
2018,4,11,9,1090,1039,1661,622
2018,4,11,10,1085,1031,1538,507
2018,4,11,11,1105,1049,1536,487
2018,4,11,12,1150,1115,1735,620
2018,4,11,13,1265,1254,2125,871
2018,4,11,14,1330,1334,2255,921
2018,4,11,15,1350,1345,2259,914
2018,4,11,16,1340,1341,2267,926
2018,4,11,17,1325,1301,2274,973
2018,4,11,18,1315,1292,2255,963
2018,4,11,19,1295,1261,2255,994
2018,4,11,20,1275,1244,2226,982
2018,4,11,21,1250,1234,2184,950
2018,4,11,22,1245,1234,2204,970
2018,4,11,23,1235,1232,2259,1027
2018,4,12,0,1230,1227,2228,1001
2018,4,12,1,1240,1238,2232,994
2018,4,12,2,1250,1251,2240,989
2018,4,12,3,1290,1287,2261,974
2018,4,12,4,1255,1259,2266,1007
2018,4,12,5,1180,1174,2249,1075
2018,4,12,6,1135,1115,2220,1105
2018,4,12,7,1080,1072,2135,1063
2018,4,12,8,1065,1051,1932,881
2018,4,12,9,1055,1047,1690,643
2018,4,12,10,1065,1039,1592,553
2018,4,12,11,1080,1068,1615,547
2018,4,12,12,1145,1122,1731,609
2018,4,12,13,1285,1263,2111,848
2018,4,12,14,1385,1345,2176,831
2018,4,12,15,1370,1397,2204,807
2018,4,12,16,1360,1399,2215,816
2018,4,12,17,1365,1421,2220,799
2018,4,12,18,1350,1436,2062,626
2018,4,12,19,1330,1433,2029,596
2018,4,12,20,1315,1462,2117,655
2018,4,12,21,1305,1468,2108,640
2018,4,12,22,1290,1456,1887,431
2018,4,12,23,1295,1440,1816,376
2018,4,13,0,1295,1430,1974,544
2018,4,13,1,1300,1429,2126,697
2018,4,13,2,1325,1432,2239,807
2018,4,13,3,1355,1446,2321,875
2018,4,13,4,1310,1397,2333,936
2018,4,13,5,1240,1335,2247,912
2018,4,13,6,1175,1258,2075,817
2018,4,13,7,1090,1208,1971,763
2018,4,13,8,1080,1192,1764,572
2018,4,13,9,1075,1174,1757,583
2018,4,13,10,1080,1188,1909,721
2018,4,13,11,1095,1193,1909,716
2018,4,13,12,1145,1252,2142,890
2018,4,13,13,1270,1348,2194,846
2018,4,13,14,1360,1401,2252,851
2018,4,13,15,1370,1398,2248,850
2018,4,13,16,1360,1419,2272,853
2018,4,13,17,1355,1404,2253,849
2018,4,13,18,1335,1345,2030,685
2018,4,13,19,1310,1322,1982,660
2018,4,13,20,1290,1316,1910,594
2018,4,13,21,1270,1291,1812,521
2018,4,13,22,1270,1269,1793,524
2018,4,13,23,1260,1244,1726,482
2018,4,14,0,1260,1244,1753,509
2018,4,14,1,1265,1226,1767,541
2018,4,14,2,1275,1251,1880,629
2018,4,14,3,1315,1277,1774,497
2018,4,14,4,1285,1276,1654,378
2018,4,14,5,1220,1222,1659,437
2018,4,14,6,1170,1152,1742,590
2018,4,14,7,1125,1132,1592,460
2018,4,14,8,1100,1100,1683,583
2018,4,14,9,1100,1100,1633,533
2018,4,14,10,1095,1093,1700,607
2018,4,14,11,1100,1103,1731,628
2018,4,14,12,1130,1121,1751,630
2018,4,14,13,1205,1175,1722,547
2018,4,14,14,1275,1215,1829,614
2018,4,14,15,1325,1261,1820,559
2018,4,14,16,1335,1279,1924,645
2018,4,14,17,1335,1277,1933,656
2018,4,14,18,1325,1236,1877,641
2018,4,14,19,1300,1236,1895,659
2018,4,14,20,1280,1186,1891,705
2018,4,14,21,1265,1200,1893,693
2018,4,14,22,1270,1182,1837,655
2018,4,14,23,1265,1159,1840,681
2018,4,15,0,1275,1175,1822,647
2018,4,15,1,1290,1156,1806,650
2018,4,15,2,1305,1183,1995,812
2018,4,15,3,1335,1214,2052,838
2018,4,15,4,1275,1192,1981,789
2018,4,15,5,1230,1134,1963,829
2018,4,15,6,1160,1081,1942,861
2018,4,15,7,1130,1052,1887,835
2018,4,15,8,1110,1028,1675,647
2018,4,15,9,1105,1030,1567,537
2018,4,15,10,1100,1035,1611,576
2018,4,15,11,1110,1041,1608,567
2018,4,15,12,1135,1069,1613,544
2018,4,15,13,1185,1098,1666,568
2018,4,15,14,1230,1133,1753,620
2018,4,15,15,1280,1200,1748,548
2018,4,15,16,1295,1208,1687,479
2018,4,15,17,1290,1226,1716,490
2018,4,15,18,1280,1209,1727,518
2018,4,15,19,1260,1202,1758,556
2018,4,15,20,1245,1183,1656,473
2018,4,15,21,1230,1173,1656,483
2018,4,15,22,1240,1166,1653,487
2018,4,15,23,1235,1156,1649,493
2018,4,16,0,1250,1172,1807,635
2018,4,16,1,1265,1181,2029,848
2018,4,16,2,1285,1175,2025,850
2018,4,16,3,1320,1242,2152,910
2018,4,16,4,1265,1195,2162,967
2018,4,16,5,1200,1137,2188,1051
2018,4,16,6,1140,1039,2142,1103
2018,4,16,7,1110,1003,1900,897
2018,4,16,8,1090,1020,1801,781
2018,4,16,9,1095,996,1691,695
2018,4,16,10,1090,1021,1712,691
2018,4,16,11,1115,1012,1670,658
2018,4,16,12,1165,1084,1876,792
2018,4,16,13,1280,1223,2159,936
2018,4,16,14,1360,1275,2260,985
2018,4,16,15,1355,1287,2260,973
2018,4,16,16,1355,1277,2172,895
2018,4,16,17,1330,1283,2205,922
2018,4,16,18,1315,1305,2168,863
2018,4,16,19,1290,1281,2187,906
2018,4,16,20,1270,1283,2210,927
2018,4,16,21,1250,1283,2143,860
2018,4,16,22,1240,1256,2220,964
2018,4,16,23,1220,1297,2177,880
2018,4,17,0,1225,1282,2234,952
2018,4,17,1,1250,1293,2243,950
2018,4,17,2,1255,1331,2341,1010
2018,4,17,3,1290,1325,2354,1029
2018,4,17,4,1265,1271,2284,1013
2018,4,17,5,1170,1214,2308,1094
2018,4,17,6,1120,1120,2113,993
2018,4,17,7,1035,1083,1853,770
2018,4,17,8,1020,1049,1623,574
2018,4,17,9,1020,1048,1516,468
2018,4,17,10,1025,1051,1428,377
2018,4,17,11,1045,1068,1413,345
2018,4,17,12,1095,1124,1442,318
2018,4,17,13,1235,1256,1794,538
2018,4,17,14,1320,1326,2239,913
2018,4,17,15,1330,1354,2420,1066
2018,4,17,16,1310,1334,2335,1001
2018,4,17,17,1315,1323,2105,782
2018,4,17,18,1310,1319,2013,694
2018,4,17,19,1300,1294,1842,548
2018,4,17,20,1295,1301,1728,427
2018,4,17,21,1295,1276,1570,294
2018,4,17,22,1290,1254,1547,293
2018,4,17,23,1285,1268,1575,307
2018,4,18,0,1275,1253,1806,553
2018,4,18,1,1275,1271,2075,804
2018,4,18,2,1290,1264,2100,836
2018,4,18,3,1315,1303,2308,1005
2018,4,18,4,1265,1312,2399,1087
2018,4,18,5,1195,1202,2319,1117
2018,4,18,6,1125,1158,2158,1000
2018,4,18,7,1060,1096,1981,885
2018,4,18,8,1055,1093,1855,762
2018,4,18,9,1040,1092,1772,680
2018,4,18,10,1045,1087,1739,652
2018,4,18,11,1060,1109,1763,654
2018,4,18,12,1115,1186,2105,919
2018,4,18,13,1255,1288,2225,937
2018,4,18,14,1345,1348,2305,957
2018,4,18,15,1350,1344,2334,990
2018,4,18,16,1350,1309,2317,1008
2018,4,18,17,1325,1327,2283,956
2018,4,18,18,1300,1310,2265,955
2018,4,18,19,1270,1266,2242,976
2018,4,18,20,1265,1280,2242,962
2018,4,18,21,1245,1228,2028,800
2018,4,18,22,1240,1223,1691,468
2018,4,18,23,1230,1232,1574,342
2018,4,19,0,1230,1197,1599,402
2018,4,19,1,1235,1219,1766,547
2018,4,19,2,1245,1207,2075,868
2018,4,19,3,1285,1247,2220,973
2018,4,19,4,1250,1263,2266,1003
2018,4,19,5,1185,1153,2163,1010
2018,4,19,6,1125,1110,2183,1073
2018,4,19,7,1040,1046,1809,763
2018,4,19,8,1025,1029,1548,519
2018,4,19,9,1020,1042,1433,391
2018,4,19,10,1020,1035,1440,405
2018,4,19,11,1045,1076,1493,417
2018,4,19,12,1100,1130,1935,805
2018,4,19,13,1215,1249,2154,905
2018,4,19,14,1285,1329,2284,955
2018,4,19,15,1305,1305,2285,980
2018,4,19,16,1300,1293,2302,1009
2018,4,19,17,1310,1281,2286,1005
2018,4,19,18,1300,1276,2290,1014
2018,4,19,19,1290,1244,2246,1002
2018,4,19,20,1290,1241,2022,781
2018,4,19,21,1285,1210,1804,594
2018,4,19,22,1275,1206,1666,460
2018,4,19,23,1275,1214,1814,600
2018,4,20,0,1270,1168,1851,683
2018,4,20,1,1275,1192,2109,917
2018,4,20,2,1280,1206,2110,904
2018,4,20,3,1310,1260,2207,947
2018,4,20,4,1270,1232,2212,980
2018,4,20,5,1200,1170,2202,1032
2018,4,20,6,1135,1079,1914,835
2018,4,20,7,1055,1036,1646,610
2018,4,20,8,1055,1026,1423,397
2018,4,20,9,1045,1032,1332,300
2018,4,20,10,1055,1039,1316,277
2018,4,20,11,1070,1052,1291,239
2018,4,20,12,1125,1112,1661,549
2018,4,20,13,1250,1226,1943,717
2018,4,20,14,1330,1269,2218,949
2018,4,20,15,1320,1275,2255,980
2018,4,20,16,1320,1275,2268,993
2018,4,20,17,1315,1239,2124,885
2018,4,20,18,1300,1242,1993,751
2018,4,20,19,1265,1195,1654,459
2018,4,20,20,1265,1194,1435,241
2018,4,20,21,1240,1166,1401,235
2018,4,20,22,1230,1168,1399,231
2018,4,20,23,1225,1161,1457,296
2018,4,21,0,1210,1144,1656,512
2018,4,21,1,1215,1156,2058,902
2018,4,21,2,1220,1149,2266,1117
2018,4,21,3,1255,1191,2333,1142
2018,4,21,4,1240,1167,2292,1125
2018,4,21,5,1170,1134,2263,1129
2018,4,21,6,1100,1067,2158,1091
2018,4,21,7,1080,1035,1901,866
2018,4,21,8,1055,1012,1759,747
2018,4,21,9,1055,991,1476,485
2018,4,21,10,1055,1003,1271,268
2018,4,21,11,1055,1001,1270,269
2018,4,21,12,1080,1025,1276,251
2018,4,21,13,1115,1069,1272,203
2018,4,21,14,1160,1115,1250,135
2018,4,21,15,1210,1151,1287,136
2018,4,21,16,1230,1191,1418,227
2018,4,21,17,1230,1176,1768,592
2018,4,21,18,1210,1182,1637,455
2018,4,21,19,1195,1146,1370,224
2018,4,21,20,1160,1143,1336,193
2018,4,21,21,1155,1129,1375,246
2018,4,21,22,1145,1129,1404,275
2018,4,21,23,1135,1110,1440,330
2018,4,22,0,1145,1126,1793,667
2018,4,22,1,1150,1144,1960,816
2018,4,22,2,1150,1133,2047,914
2018,4,22,3,1190,1162,2204,1042
2018,4,22,4,1160,1154,2316,1162
2018,4,22,5,1105,1114,2326,1212
2018,4,22,6,1045,1047,2314,1267
2018,4,22,7,1040,1016,2273,1257
2018,4,22,8,1025,999,2107,1108
2018,4,22,9,1020,986,2007,1021
2018,4,22,10,1020,993,2034,1041
2018,4,22,11,1030,996,2048,1052
2018,4,22,12,1050,1031,2208,1177
2018,4,22,13,1105,1042,2203,1161
2018,4,22,14,1160,1104,2192,1088
2018,4,22,15,1215,1142,2187,1045
2018,4,22,16,1235,1173,2262,1089
2018,4,22,17,1235,1174,2265,1091
2018,4,22,18,1220,1157,2255,1098
2018,4,22,19,1205,1166,2244,1078
2018,4,22,20,1190,1133,2229,1096
2018,4,22,21,1175,1158,2246,1088
2018,4,22,22,1170,1137,2217,1080
2018,4,22,23,1160,1143,2242,1099
2018,4,23,0,1180,1173,2298,1125
2018,4,23,1,1185,1183,2332,1149
2018,4,23,2,1185,1208,2380,1172
2018,4,23,3,1230,1244,2374,1130
2018,4,23,4,1200,1209,2333,1124
2018,4,23,5,1125,1147,2372,1225
2018,4,23,6,1060,1059,2217,1158
2018,4,23,7,1055,1025,2018,993
2018,4,23,8,1055,1004,1817,813
2018,4,23,9,1050,996,1813,817
2018,4,23,10,1055,1007,1859,852
2018,4,23,11,1065,1024,1840,816
2018,4,23,12,1125,1115,2133,1018
2018,4,23,13,1250,1259,2269,1010
2018,4,23,14,1325,1351,2265,914
2018,4,23,15,1320,1366,2238,872
2018,4,23,16,1330,1375,2237,862
2018,4,23,17,1320,1381,2284,903
2018,4,23,18,1305,1386,2286,900
2018,4,23,19,1290,1363,2246,883
2018,4,23,20,1285,1337,2190,853
2018,4,23,21,1255,1321,2142,821
2018,4,23,22,1245,1287,2074,787
2018,4,23,23,1245,1297,2116,819
2018,4,24,0,1245,1282,2114,832
2018,4,24,1,1255,1276,2142,866
2018,4,24,2,1265,1276,2143,867
2018,4,24,3,1290,1278,2127,849
2018,4,24,4,1235,1266,2119,853
2018,4,24,5,1180,1171,2069,898
2018,4,24,6,1120,1122,2164,1042
2018,4,24,7,1035,1080,2157,1077
2018,4,24,8,1025,1090,2216,1126
2018,4,24,9,1025,1079,2135,1056
2018,4,24,10,1030,1081,2122,1041
2018,4,24,11,1055,1116,2120,1004
2018,4,24,12,1115,1160,2170,1010
2018,4,24,13,1235,1283,2240,957
2018,4,24,14,1305,1328,2216,888
2018,4,24,15,1295,1323,2183,860
2018,4,24,16,1280,1288,2194,906
2018,4,24,17,1280,1279,2221,942
2018,4,24,18,1265,1260,2193,933
2018,4,24,19,1255,1218,2093,875
2018,4,24,20,1245,1223,1990,767
2018,4,24,21,1235,1190,1874,684
2018,4,24,22,1220,1200,2070,870
2018,4,24,23,1230,1183,2029,846
2018,4,25,0,1205,1177,2176,999
2018,4,25,1,1205,1183,2207,1024
2018,4,25,2,1225,1171,2157,986
2018,4,25,3,1265,1216,2169,953
2018,4,25,4,1240,1221,2218,997
2018,4,25,5,1155,1128,2201,1073
2018,4,25,6,1090,1077,2277,1200
2018,4,25,7,1005,1030,2269,1239
2018,4,25,8,995,1022,1980,958
2018,4,25,9,995,1004,1730,726
2018,4,25,10,995,1013,1567,554
2018,4,25,11,1015,1022,1599,577
2018,4,25,12,1075,1089,1922,833
2018,4,25,13,1190,1213,2174,961
2018,4,25,14,1255,1288,2279,991
2018,4,25,15,1250,1266,2264,998
2018,4,25,16,1245,1278,2204,926
2018,4,25,17,1220,1270,2212,942
2018,4,25,18,1220,1242,2078,836
2018,4,25,19,1185,1237,2066,829
2018,4,25,20,1175,1214,2009,795
2018,4,25,21,1155,1216,2046,830
2018,4,25,22,1155,1223,2078,855
2018,4,25,23,1150,1219,2169,950
2018,4,26,0,1140,1217,2198,981
2018,4,26,1,1145,1195,2283,1088
2018,4,26,2,1145,1208,2243,1035
2018,4,26,3,1180,1223,2239,1016
2018,4,26,4,1150,1224,2214,990
2018,4,26,5,1095,1140,2183,1043
2018,4,26,6,1040,1077,2109,1032
2018,4,26,7,1010,1033,2109,1076
2018,4,26,8,1000,1007,1711,704
2018,4,26,9,1000,1027,1673,646
2018,4,26,10,1005,1036,1624,588
2018,4,26,11,1035,1045,1580,535
2018,4,26,12,1085,1115,1721,606
2018,4,26,13,1205,1228,1967,739
2018,4,26,14,1265,1292,2140,848
2018,4,26,15,1255,1260,2097,837
2018,4,26,16,1235,1270,2074,804
2018,4,26,17,1230,1227,2057,830
2018,4,26,18,1215,1236,2176,940
2018,4,26,19,1190,1213,1922,709
2018,4,26,20,1180,1193,1795,602
2018,4,26,21,1165,1214,1848,634
2018,4,26,22,1160,1189,1864,675
2018,4,26,23,1160,1203,1947,744
2018,4,27,0,1135,1196,2044,848
2018,4,27,1,1140,1199,1971,772
2018,4,27,2,1150,1197,2131,934
2018,4,27,3,1185,1218,2144,926
2018,4,27,4,1160,1230,2152,922
2018,4,27,5,1100,1128,2029,901
2018,4,27,6,1030,1063,1968,905
2018,4,27,7,995,1004,1654,650
2018,4,27,8,985,989,1453,464
2018,4,27,9,990,980,1550,570
2018,4,27,10,990,978,1425,447
2018,4,27,11,1005,989,1422,433
2018,4,27,12,1070,1053,1559,506
2018,4,27,13,1155,1148,1938,790
2018,4,27,14,1190,1205,2121,916
2018,4,27,15,1185,1227,2179,952
2018,4,27,16,1185,1197,2170,973
2018,4,27,17,1180,1216,2182,966
2018,4,27,18,1175,1207,2170,963
2018,4,27,19,1150,1186,2155,969
2018,4,27,20,1140,1209,2151,942
2018,4,27,21,1125,1187,2091,904
2018,4,27,22,1115,1195,1950,755
2018,4,27,23,1115,1176,1774,598
2018,4,28,0,1105,1165,1591,426
2018,4,28,1,1100,1154,1582,428
2018,4,28,2,1100,1149,1634,485
2018,4,28,3,1125,1148,1451,303
2018,4,28,4,1110,1155,1315,160
2018,4,28,5,1050,1127,1295,168
2018,4,28,6,995,1051,1284,233
2018,4,28,7,1005,1009,1097,88
2018,4,28,8,980,985,983,-2
2018,4,28,9,970,970,949,-21
2018,4,28,10,965,963,943,-20
2018,4,28,11,975,977,935,-42
2018,4,28,12,985,993,959,-34
2018,4,28,13,1025,1030,986,-44
2018,4,28,14,1080,1067,970,-97
2018,4,28,15,1120,1152,821,-331
2018,4,28,16,1155,1178,739,-439
2018,4,28,17,1150,1173,721,-452
2018,4,28,18,1150,1175,788,-387
2018,4,28,19,1140,1130,880,-250
2018,4,28,20,1130,1124,934,-190
2018,4,28,21,1130,1123,936,-187
2018,4,28,22,1130,1138,969,-169
2018,4,28,23,1125,1136,990,-146
2018,4,29,0,1130,1138,1030,-108
2018,4,29,1,1130,1168,1055,-113
2018,4,29,2,1125,1165,1056,-109
2018,4,29,3,1135,1170,1190,20
2018,4,29,4,1110,1161,1134,-27
2018,4,29,5,1090,1086,1189,103
2018,4,29,6,1030,1037,1149,112
2018,4,29,7,980,990,1168,178
2018,4,29,8,960,977,1260,283
2018,4,29,9,960,959,1177,218
2018,4,29,10,965,942,1074,132
2018,4,29,11,965,945,1051,106
2018,4,29,12,985,956,1074,118
2018,4,29,13,1025,983,1054,71
2018,4,29,14,1080,1024,1078,54
2018,4,29,15,1130,1080,1046,-34
2018,4,29,16,1155,1111,1052,-59
2018,4,29,17,1160,1114,1049,-65
2018,4,29,18,1160,1145,1091,-54
2018,4,29,19,1145,1138,1055,-83
2018,4,29,20,1125,1148,1042,-106
2018,4,29,21,1130,1156,1025,-131
2018,4,29,22,1125,1164,1000,-164
2018,4,29,23,1130,1182,1004,-178
2018,4,30,0,1145,1200,999,-201
2018,4,30,1,1160,1186,1044,-142
2018,4,30,2,1165,1187,1015,-172
2018,4,30,3,1195,1210,1097,-113
2018,4,30,4,1160,1195,1232,37
2018,4,30,5,1095,1132,1228,96
2018,4,30,6,1015,1041,1036,-5
2018,4,30,7,950,1020,1043,23
2018,4,30,8,940,988,1039,51
2018,4,30,9,935,984,1039,55
2018,4,30,10,945,988,1045,57
2018,4,30,11,955,1015,1061,46
2018,4,30,12,1025,1077,1130,53
2018,4,30,13,1175,1193,1309,116
2018,4,30,14,1275,1254,1382,128
2018,4,30,15,1270,1272,1445,173
2018,4,30,16,1285,1253,1361,108
2018,4,30,17,1285,1307,928,-379
2018,4,30,18,1280,1291,913,-378
2018,4,30,19,1270,1277,854,-423
2018,4,30,20,1255,1266,900,-366
2018,4,30,21,1245,1217,1017,-200
2018,4,30,22,1235,1213,1113,-100
2018,4,30,23,1250,1214,1127,-87
2018,5,1,0,1245,1219,1158,-61
2018,5,1,1,1235,1210,1371,161
2018,5,1,2,1245,1219,1406,187
2018,5,1,3,1260,1230,1366,136
2018,5,1,4,1235,1206,1335,129
2018,5,1,5,1150,1129,1358,229
2018,5,1,6,1085,1066,1282,216
2018,5,1,7,1020,1045,1108,63
2018,5,1,8,1010,1024,1127,103
2018,5,1,9,1010,1028,1050,22
2018,5,1,10,1020,1035,1030,-5
2018,5,1,11,1040,1057,1056,-1
2018,5,1,12,1100,1104,1276,172
2018,5,1,13,1240,1197,1464,267
2018,5,1,14,1320,1278,1499,221
2018,5,1,15,1310,1272,1496,224
2018,5,1,16,1295,1269,1463,194
2018,5,1,17,1280,1274,1510,236
2018,5,1,18,1265,1263,1546,283
2018,5,1,19,1245,1253,1533,280
2018,5,1,20,1240,1246,1546,300
2018,5,1,21,1230,1235,1531,296
2018,5,1,22,1220,1231,1458,227
2018,5,1,23,1215,1218,1551,333
2018,5,2,0,1210,1206,1581,375
2018,5,2,1,1205,1208,1551,343
2018,5,2,2,1205,1212,1530,318
2018,5,2,3,1245,1234,1483,249
2018,5,2,4,1235,1207,1478,271
2018,5,2,5,1150,1139,1468,329
2018,5,2,6,1090,1063,1438,375
2018,5,2,7,1000,1034,1392,358
2018,5,2,8,985,1000,1271,271
2018,5,2,9,975,1009,1174,165
2018,5,2,10,985,996,1224,228
2018,5,2,11,1005,1006,1199,193
2018,5,2,12,1060,1049,1335,286
2018,5,2,13,1185,1154,1601,447
2018,5,2,14,1255,1232,1899,667
2018,5,2,15,1250,1210,1931,721
2018,5,2,16,1245,1220,2069,849
2018,5,2,17,1255,1195,2181,986
2018,5,2,18,1245,1193,2172,979
2018,5,2,19,1225,1186,2189,1003
2018,5,2,20,1215,1168,2140,972
2018,5,2,21,1195,1207,1611,404
2018,5,2,22,1195,1178,1538,360
2018,5,2,23,1195,1181,1670,489
2018,5,3,0,1190,1162,1722,560
2018,5,3,1,1175,1181,1920,739
2018,5,3,2,1180,1189,2060,871
2018,5,3,3,1205,1222,2063,841
2018,5,3,4,1195,1212,1966,754
2018,5,3,5,1115,1123,1895,772
2018,5,3,6,1045,1059,1912,853
2018,5,3,7,990,1001,1622,621
2018,5,3,8,975,995,1400,405
2018,5,3,9,985,988,1321,333
2018,5,3,10,990,988,1301,313
2018,5,3,11,1010,1007,1380,373
2018,5,3,12,1070,1053,1445,392
2018,5,3,13,1185,1157,1881,724
2018,5,3,14,1250,1225,2078,853
2018,5,3,15,1240,1230,2190,960
2018,5,3,16,1235,1223,2046,823
2018,5,3,17,1220,1217,2023,806
2018,5,3,18,1215,1230,1919,689
2018,5,3,19,1195,1197,1837,640
2018,5,3,20,1185,1200,1866,666
2018,5,3,21,1185,1207,1985,778
2018,5,3,22,1175,1208,2042,834
2018,5,3,23,1175,1217,2056,839
2018,5,4,0,1160,1200,2079,879
2018,5,4,1,1165,1205,2137,932
2018,5,4,2,1165,1195,2154,959
2018,5,4,3,1195,1202,2152,950
2018,5,4,4,1195,1208,2006,798
2018,5,4,5,1105,1118,1684,566
2018,5,4,6,1030,1046,1602,556
2018,5,4,7,970,986,1464,478
2018,5,4,8,950,972,1215,243
2018,5,4,9,950,957,1201,244
2018,5,4,10,945,966,1217,251
2018,5,4,11,955,982,1252,270
2018,5,4,12,1010,1032,1285,253
2018,5,4,13,1120,1114,1317,203
2018,5,4,14,1190,1189,1400,211
2018,5,4,15,1190,1213,1836,623
2018,5,4,16,1180,1220,1821,601
2018,5,4,17,1170,1230,1905,675
2018,5,4,18,1165,1240,2099,859
2018,5,4,19,1150,1230,2144,914
2018,5,4,20,1155,1235,2239,1004
2018,5,4,21,1160,1216,2216,1000
2018,5,4,22,1155,1218,2268,1050
2018,5,4,23,1145,1220,2264,1044
2018,5,5,0,1135,1204,2233,1029
2018,5,5,1,1135,1185,2200,1015
2018,5,5,2,1130,1162,2203,1041
2018,5,5,3,1145,1158,2244,1086
2018,5,5,4,1145,1178,2233,1055
2018,5,5,5,1100,1096,2081,985
2018,5,5,6,1025,1021,1797,776
2018,5,5,7,985,981,1560,579
2018,5,5,8,960,944,1254,310
2018,5,5,9,950,933,1167,234
2018,5,5,10,945,930,1146,216
2018,5,5,11,950,929,1148,219
2018,5,5,12,970,950,1190,240
2018,5,5,13,1020,983,1231,248
2018,5,5,14,1075,1032,1283,251
2018,5,5,15,1135,1103,1635,532
2018,5,5,16,1170,1122,1662,540
2018,5,5,17,1160,1135,1610,475
2018,5,5,18,1170,1137,1566,429
2018,5,5,19,1135,1143,1497,354
2018,5,5,20,1135,1142,1555,413
2018,5,5,21,1130,1133,1564,431
2018,5,5,22,1140,1143,1752,609
2018,5,5,23,1135,1148,1781,633
2018,5,6,0,1140,1166,1869,703
2018,5,6,1,1160,1154,1975,821
2018,5,6,2,1160,1153,2161,1008
2018,5,6,3,1170,1155,2149,994
2018,5,6,4,1165,1165,2153,988
2018,5,6,5,1090,1112,2139,1027
2018,5,6,6,1035,1047,2122,1075
2018,5,6,7,985,1007,1786,779
2018,5,6,8,965,967,1278,311
2018,5,6,9,955,958,1241,283
2018,5,6,10,940,949,1237,288
2018,5,6,11,950,952,1237,285
2018,5,6,12,960,966,1228,262
2018,5,6,13,970,977,1212,235
2018,5,6,14,1000,1023,1199,176
2018,5,6,15,1050,1069,1196,127
2018,5,6,16,1080,1117,1193,76
2018,5,6,17,1085,1137,1436,299
2018,5,6,18,1100,1147,1228,81
2018,5,6,19,1095,1151,1326,175
2018,5,6,20,1095,1155,1272,117
2018,5,6,21,1100,1186,1393,207
2018,5,6,22,1095,1190,1434,244
2018,5,6,23,1115,1207,1400,193
2018,5,7,0,1130,1223,1425,202
2018,5,7,1,1130,1221,1669,448
2018,5,7,2,1130,1213,1963,750
2018,5,7,3,1150,1220,2070,850
2018,5,7,4,1130,1203,1895,692
2018,5,7,5,1070,1105,1556,451
2018,5,7,6,990,1025,1398,373
2018,5,7,7,970,978,1326,348
2018,5,7,8,945,942,1122,180
2018,5,7,9,940,932,1165,233
2018,5,7,10,935,935,1132,197
2018,5,7,11,960,944,1116,172
2018,5,7,12,1010,1004,1139,135
2018,5,7,13,1105,1097,1165,68
2018,5,7,14,1175,1173,1314,141
2018,5,7,15,1190,1202,1668,466
2018,5,7,16,1185,1213,1495,282
2018,5,7,17,1220,1226,1510,284
2018,5,7,18,1215,1230,1627,397
2018,5,7,19,1205,1247,1789,542
2018,5,7,20,1200,1251,1974,723
2018,5,7,21,1175,1232,2028,796
2018,5,7,22,1170,1230,2098,868
2018,5,7,23,1170,1228,2111,883
2018,5,8,0,1165,1203,2152,949
2018,5,8,1,1155,1205,2176,971
2018,5,8,2,1155,1206,2164,958
2018,5,8,3,1160,1198,1874,676
2018,5,8,4,1135,1190,1699,509
2018,5,8,5,1090,1123,1666,543
2018,5,8,6,1025,1035,1593,558
2018,5,8,7,985,999,1498,499
2018,5,8,8,970,983,1439,456
2018,5,8,9,970,984,1317,333
2018,5,8,10,975,974,1258,284
2018,5,8,11,995,980,1175,195
2018,5,8,12,1040,1037,1357,320
2018,5,8,13,1130,1120,1644,524
2018,5,8,14,1195,1228,2108,880
2018,5,8,15,1185,1243,2157,914
2018,5,8,16,1180,1245,2150,905
2018,5,8,17,1180,1239,2145,906
2018,5,8,18,1175,1254,2143,889
2018,5,8,19,1155,1233,2129,896
2018,5,8,20,1150,1238,2186,948
2018,5,8,21,1145,1243,2200,957
2018,5,8,22,1145,1249,2197,948
2018,5,8,23,1140,1252,2186,934
2018,5,9,0,1125,1245,2174,929
2018,5,9,1,1130,1266,2218,952
2018,5,9,2,1125,1248,2209,961
2018,5,9,3,1145,1225,1863,638
2018,5,9,4,1120,1220,1691,471
2018,5,9,5,1065,1131,1665,534
2018,5,9,6,995,1044,1593,549
2018,5,9,7,970,989,1422,433
2018,5,9,8,945,968,1305,337
2018,5,9,9,940,948,1174,226
2018,5,9,10,940,956,1248,292
2018,5,9,11,950,965,1241,276
2018,5,9,12,1000,1005,1214,209
2018,5,9,13,1105,1102,1373,271
2018,5,9,14,1180,1194,1709,515
2018,5,9,15,1190,1214,1800,586
2018,5,9,16,1195,1220,1519,299
2018,5,9,17,1195,1210,1348,138
2018,5,9,18,1190,1224,1427,203
2018,5,9,19,1190,1222,1335,113
2018,5,9,20,1190,1238,1306,68
2018,5,9,21,1190,1237,1281,44
2018,5,9,22,1185,1251,1391,140
2018,5,9,23,1180,1246,1445,199
2018,5,10,0,1160,1230,1367,137
2018,5,10,1,1160,1224,1735,511
2018,5,10,2,1160,1242,1744,502
2018,5,10,3,1170,1285,1060,-225
2018,5,10,4,1160,1272,1057,-215
2018,5,10,5,1095,1177,995,-182
2018,5,10,6,1020,1075,1056,-19
2018,5,10,7,985,1023,1071,48
2018,5,10,8,970,989,1184,195
2018,5,10,9,975,968,1072,104
2018,5,10,10,970,962,1077,115
2018,5,10,11,985,973,1099,126
2018,5,10,12,1035,1016,1179,163
2018,5,10,13,1135,1104,1417,313
2018,5,10,14,1225,1198,1666,468
2018,5,10,15,1225,1212,1741,529
2018,5,10,16,1230,1228,1735,507
2018,5,10,17,1220,1220,1623,403
2018,5,10,18,1230,1214,1479,265
2018,5,10,19,1210,1212,1434,222
2018,5,10,20,1210,1191,1298,107
2018,5,10,21,1210,1200,1225,25
2018,5,10,22,1215,1214,1334,120
2018,5,10,23,1220,1222,1305,83
2018,5,11,0,1210,1225,1354,129
2018,5,11,1,1220,1219,1410,191
2018,5,11,2,1210,1219,1351,132
2018,5,11,3,1210,1231,1467,236
2018,5,11,4,1210,1212,1529,317
2018,5,11,5,1125,1159,1318,159
2018,5,11,6,1040,1107,1226,119
2018,5,11,7,975,1062,1117,55
2018,5,11,8,960,1062,968,-94
2018,5,11,9,950,1057,938,-119
2018,5,11,10,955,1030,942,-88
2018,5,11,11,965,1049,944,-105
2018,5,11,12,1015,1079,947,-132
2018,5,11,13,1150,1161,967,-194
2018,5,11,14,1260,1246,1130,-116
2018,5,11,15,1270,1270,1340,70
2018,5,11,16,1275,1262,1299,37
2018,5,11,17,1275,1272,1164,-108
2018,5,11,18,1275,1270,1067,-203
2018,5,11,19,1265,1269,1132,-137
2018,5,11,20,1260,1262,1229,-33
2018,5,11,21,1265,1261,1301,40
2018,5,11,22,1255,1232,1176,-56
2018,5,11,23,1255,1230,1206,-24
2018,5,12,0,1240,1217,1334,117
2018,5,12,1,1225,1223,1531,308
2018,5,12,2,1215,1218,1592,374
2018,5,12,3,1225,1216,1553,337
2018,5,12,4,1225,1209,1545,336
2018,5,12,5,1150,1148,1528,380
2018,5,12,6,1075,1084,1549,465
2018,5,12,7,1060,1046,1454,408
2018,5,12,8,1035,1026,1254,228
2018,5,12,9,1025,1011,1124,113
2018,5,12,10,1015,999,1114,115
2018,5,12,11,1020,1010,1120,110
2018,5,12,12,1040,1032,1129,97
2018,5,12,13,1085,1056,1114,58
2018,5,12,14,1145,1115,1074,-41
2018,5,12,15,1200,1163,1129,-34
2018,5,12,16,1225,1194,1097,-97
2018,5,12,17,1230,1191,1075,-116
2018,5,12,18,1225,1187,1032,-155
2018,5,12,19,1220,1171,981,-190
2018,5,12,20,1205,1140,960,-180
2018,5,12,21,1205,1122,935,-187
2018,5,12,22,1200,1116,880,-236
2018,5,12,23,1205,1111,936,-175
2018,5,13,0,1220,1116,954,-162
2018,5,13,1,1210,1123,1019,-104
2018,5,13,2,1215,1117,1290,173
2018,5,13,3,1235,1133,1400,267
2018,5,13,4,1215,1143,1425,282
2018,5,13,5,1155,1093,1416,323
2018,5,13,6,1090,1039,1421,382
2018,5,13,7,1035,999,1227,228
2018,5,13,8,1010,974,1000,26
2018,5,13,9,995,968,964,-4
2018,5,13,10,985,963,955,-8
2018,5,13,11,985,965,941,-24
2018,5,13,12,1005,986,947,-39
2018,5,13,13,1010,1001,936,-65
2018,5,13,14,1045,1057,982,-75
2018,5,13,15,1100,1104,962,-142
2018,5,13,16,1135,1131,982,-149
2018,5,13,17,1145,1120,991,-129
2018,5,13,18,1165,1119,999,-120
2018,5,13,19,1165,1112,984,-128
2018,5,13,20,1170,1107,989,-118
2018,5,13,21,1180,1103,957,-146
2018,5,13,22,1180,1104,970,-134
2018,5,13,23,1200,1114,1000,-114
2018,5,14,0,1215,1130,1119,-11
2018,5,14,1,1210,1139,1235,96
2018,5,14,2,1205,1151,1457,306
2018,5,14,3,1215,1161,1456,295
2018,5,14,4,1285,1170,1458,288
2018,5,14,5,1120,1104,1484,380
2018,5,14,6,1045,1013,1423,410
2018,5,14,7,1000,986,1250,264
2018,5,14,8,970,965,1080,115
2018,5,14,9,960,964,1022,58
2018,5,14,10,960,964,1023,59
2018,5,14,11,980,984,1027,43
2018,5,14,12,1030,1040,1079,39
2018,5,14,13,1130,1126,1354,228
2018,5,14,14,1205,1216,1425,209
2018,5,14,15,1225,1214,1407,193
2018,5,14,16,1230,1214,1403,189
2018,5,14,17,1255,1228,1409,181
2018,5,14,18,1255,1229,1357,128
2018,5,14,19,1255,1226,1380,154
2018,5,14,20,1255,1234,1386,152
2018,5,14,21,1225,1236,1389,153
2018,5,14,22,1225,1235,1431,196
2018,5,14,23,1225,1242,1430,188
2018,5,15,0,1210,1242,1430,188
2018,5,15,1,1205,1235,1419,184
2018,5,15,2,1210,1230,1419,189
2018,5,15,3,1230,1211,1403,192
2018,5,15,4,1210,1228,1425,197
2018,5,15,5,1130,1134,1413,279
2018,5,15,6,1055,1058,1419,361
2018,5,15,7,1005,1013,1399,386
2018,5,15,8,980,988,1415,427
2018,5,15,9,980,967,1306,339
2018,5,15,10,975,986,1231,245
2018,5,15,11,985,994,1184,190
2018,5,15,12,1035,1036,1244,208
2018,5,15,13,1115,1125,1410,285
2018,5,15,14,1200,1180,1509,329
2018,5,15,15,1215,1200,1477,277
2018,5,15,16,1220,1213,1444,231
2018,5,15,17,1215,1212,1427,215
2018,5,15,18,1220,1214,1482,268
2018,5,15,19,1205,1181,1381,200
2018,5,15,20,1205,1207,1524,317
2018,5,15,21,1205,1211,1552,341
2018,5,15,22,1210,1253,1788,535
2018,5,15,23,1215,1274,1983,709
2018,5,16,0,1210,1278,2036,758
2018,5,16,1,1220,1273,2096,823
2018,5,16,2,1210,1257,2108,851
2018,5,16,3,1205,1245,2020,775
2018,5,16,4,1200,1245,2004,759
2018,5,16,5,1120,1150,1844,694
2018,5,16,6,1050,1041,1650,609
2018,5,16,7,970,1001,1451,450
2018,5,16,8,955,975,1299,324
2018,5,16,9,940,959,1256,297
2018,5,16,10,945,937,1251,314
2018,5,16,11,960,964,1157,193
2018,5,16,12,1010,991,1164,173
2018,5,16,13,1105,1088,1350,262
2018,5,16,14,1200,1164,1247,83
2018,5,16,15,1210,1197,1668,471
2018,5,16,16,1220,1224,1762,538
2018,5,16,17,1220,1225,1589,364
2018,5,16,18,1230,1237,1640,403
2018,5,16,19,1225,1246,1831,585
2018,5,16,20,1235,1261,2021,760
2018,5,16,21,1235,1250,2051,801
2018,5,16,22,1240,1287,2076,789
2018,5,16,23,1240,1297,1979,682
2018,5,17,0,1225,1285,1966,681
2018,5,17,1,1215,1297,2091,794
2018,5,17,2,1215,1247,1975,728
2018,5,17,3,1235,1237,1960,723
2018,5,17,4,1215,1233,2095,862
2018,5,17,5,1140,1138,1880,742
2018,5,17,6,1055,1056,1678,622
2018,5,17,7,990,1013,1343,330
2018,5,17,8,960,987,1306,319
2018,5,17,9,945,968,1158,190
2018,5,17,10,950,972,1141,169
2018,5,17,11,960,994,1185,191
2018,5,17,12,1005,1031,1229,198
2018,5,17,13,1105,1120,1409,289
2018,5,17,14,1195,1201,1370,169
2018,5,17,15,1210,1225,1407,182
2018,5,17,16,1220,1230,1360,130
2018,5,17,17,1215,1246,1348,102
2018,5,17,18,1215,1248,1366,118
2018,5,17,19,1205,1255,1298,43
2018,5,17,20,1200,1269,1419,150
2018,5,17,21,1205,1279,1578,299
2018,5,17,22,1220,1275,1701,426
2018,5,17,23,1230,1256,1601,345
2018,5,18,0,1230,1250,1813,563
2018,5,18,1,1220,1227,1649,422
2018,5,18,2,1215,1225,1929,704
2018,5,18,3,1215,1235,2046,811
2018,5,18,4,1215,1209,1946,737
2018,5,18,5,1145,1150,1923,773
2018,5,18,6,1075,1069,1592,523
2018,5,18,7,985,1030,1360,330
2018,5,18,8,975,1010,1313,303
2018,5,18,9,965,995,1248,253
2018,5,18,10,950,1005,1223,218
2018,5,18,11,975,1025,1311,286
2018,5,18,12,1005,1065,1345,280
2018,5,18,13,1105,1161,1602,441
2018,5,18,14,1200,1247,1787,540
2018,5,18,15,1225,1267,1856,589
2018,5,18,16,1230,1267,1877,610
2018,5,18,17,1240,1278,2011,733
2018,5,18,18,1245,1273,2043,770
2018,5,18,19,1245,1266,2081,815
2018,5,18,20,1245,1253,2133,880
2018,5,18,21,1235,1247,2172,925
2018,5,18,22,1225,1228,2173,945
2018,5,18,23,1240,1223,2080,857
2018,5,19,0,1225,1225,2123,898
2018,5,19,1,1225,1227,2118,891
2018,5,19,2,1205,1214,2127,913
2018,5,19,3,1200,1216,2069,853
2018,5,19,4,1190,1200,1942,742
2018,5,19,5,1120,1158,2030,872
2018,5,19,6,1050,1095,1975,880
2018,5,19,7,1025,1061,1943,882
2018,5,19,8,1005,1036,1747,711
2018,5,19,9,995,1003,1396,393
2018,5,19,10,985,1008,1274,266
2018,5,19,11,995,1015,1318,303
2018,5,19,12,1015,1032,1344,312
2018,5,19,13,1035,1075,1299,224
2018,5,19,14,1095,1122,1353,231
2018,5,19,15,1150,1182,1379,197
2018,5,19,16,1175,1216,1391,175
2018,5,19,17,1175,1219,1482,263
2018,5,19,18,1170,1219,1520,301
2018,5,19,19,1160,1193,1528,335
2018,5,19,20,1145,1170,1525,355
2018,5,19,21,1130,1152,1523,371
2018,5,19,22,1130,1146,1506,360
2018,5,19,23,1130,1135,1501,366
2018,5,20,0,1140,1144,1479,335
2018,5,20,1,1145,1152,1530,378
2018,5,20,2,1145,1150,1845,695
2018,5,20,3,1155,1155,2057,902
2018,5,20,4,1155,1170,2063,893
2018,5,20,5,1110,1133,2054,921
2018,5,20,6,1040,1068,1954,886
2018,5,20,7,1000,1027,1611,584
2018,5,20,8,980,991,1196,205
2018,5,20,9,970,980,1092,112
2018,5,20,10,960,985,1057,72
2018,5,20,11,965,983,1044,61
2018,5,20,12,985,986,1038,52
2018,5,20,13,1020,1001,1046,45
2018,5,20,14,1090,1051,1138,87
2018,5,20,15,1140,1088,1145,57
2018,5,20,16,1175,1115,1156,41
2018,5,20,17,1175,1122,1153,31
2018,5,20,18,1180,1125,1185,60
2018,5,20,19,1175,1133,1217,84
2018,5,20,20,1170,1135,1265,130
2018,5,20,21,1170,1132,1280,148
2018,5,20,22,1175,1129,1290,161
2018,5,20,23,1185,1141,1439,298
2018,5,21,0,1195,1161,1481,320
2018,5,21,1,1200,1165,1707,542
2018,5,21,2,1200,1179,1935,756
2018,5,21,3,1210,1175,1925,750
2018,5,21,4,1210,1196,1879,683
2018,5,21,5,1130,1129,1688,559
2018,5,21,6,1050,1052,1613,561
2018,5,21,7,985,990,1227,237
2018,5,21,8,965,973,1125,152
2018,5,21,9,955,953,1025,72
2018,5,21,10,950,953,994,41
2018,5,21,11,970,971,1062,91
2018,5,21,12,1020,1019,1072,53
2018,5,21,13,1110,1102,1327,225
2018,5,21,14,1195,1183,1265,82
2018,5,21,15,1210,1216,1619,403
2018,5,21,16,1225,1225,1889,664
2018,5,21,17,1235,1240,1786,546
2018,5,21,18,1240,1263,2011,748
2018,5,21,19,1245,1264,2102,838
2018,5,21,20,1250,1276,2119,843
2018,5,21,21,1240,1290,2117,827
2018,5,21,22,1240,1303,2119,816
2018,5,21,23,1260,1308,2201,893
2018,5,22,0,1250,1288,2145,857
2018,5,22,1,1250,1265,2094,829
2018,5,22,2,1230,1239,2090,851
2018,5,22,3,1220,1220,2081,861
2018,5,22,4,1205,1206,2070,864
2018,5,22,5,1135,1140,2033,893
2018,5,22,6,1055,1054,2025,971
2018,5,22,7,1000,1003,1957,954
2018,5,22,8,980,976,1494,518
2018,5,22,9,960,970,1281,311
2018,5,22,10,970,958,1178,220
2018,5,22,11,985,963,1180,217
2018,5,22,12,1030,1000,1285,285
2018,5,22,13,1120,1093,1508,415
2018,5,22,14,1200,1187,1716,529
2018,5,22,15,1220,1209,1870,661
2018,5,22,16,1230,1238,2044,806
2018,5,22,17,1230,1241,2089,848
2018,5,22,18,1235,1245,2146,901
2018,5,22,19,1220,1268,2218,950
2018,5,22,20,1240,1270,2223,953
2018,5,22,21,1245,1282,2216,934
2018,5,22,22,1260,1283,2215,932
2018,5,22,23,1265,1288,2206,918
2018,5,23,0,1255,1271,2152,881
2018,5,23,1,1250,1244,2166,922
2018,5,23,2,1240,1229,2129,900
2018,5,23,3,1235,1229,2095,866
2018,5,23,4,1230,1212,2087,875
2018,5,23,5,1145,1143,2092,949
2018,5,23,6,1050,1072,2074,1002
2018,5,23,7,985,1018,2019,1001
2018,5,23,8,965,983,1920,937
2018,5,23,9,950,963,1697,734
2018,5,23,10,945,962,1467,505
2018,5,23,11,960,983,1397,414
2018,5,23,12,1000,1022,1571,549
2018,5,23,13,1085,1140,1905,765
2018,5,23,14,1160,1210,1770,560
2018,5,23,15,1185,1235,1772,537
2018,5,23,16,1200,1254,2010,756
2018,5,23,17,1195,1271,2094,823
2018,5,23,18,1210,1251,2126,875
2018,5,23,19,1215,1254,2141,887
2018,5,23,20,1230,1262,2131,869
2018,5,23,21,1225,1257,2133,876
2018,5,23,22,1235,1277,2137,860
2018,5,23,23,1250,1271,2096,825
2018,5,24,0,1235,1250,2051,801
2018,5,24,1,1230,1241,2099,858
2018,5,24,2,1215,1223,2107,884
2018,5,24,3,1225,1236,2111,875
2018,5,24,4,1210,1233,2049,816
2018,5,24,5,1125,1166,2114,948
2018,5,24,6,1035,1087,2093,1006
2018,5,24,7,985,1018,1666,648
2018,5,24,8,965,984,1302,318
2018,5,24,9,950,979,1205,226
2018,5,24,10,955,969,1145,176
2018,5,24,11,965,989,1175,186
2018,5,24,12,1005,1030,1245,215
2018,5,24,13,1095,1115,1216,101
2018,5,24,14,1180,1189,1296,107
2018,5,24,15,1200,1216,1225,9
2018,5,24,16,1220,1247,1339,92
2018,5,24,17,1220,1256,1449,193
2018,5,24,18,1225,1247,1603,356
2018,5,24,19,1225,1266,1505,239
2018,5,24,20,1240,1282,1589,307
2018,5,24,21,1250,1296,1602,306
2018,5,24,22,1255,1307,1783,476
2018,5,24,23,1255,1325,1943,618
2018,5,25,0,1240,1321,2051,730
2018,5,25,1,1220,1320,2192,872
2018,5,25,2,1215,1306,2198,892
2018,5,25,3,1215,1291,2188,897
2018,5,25,4,1200,1298,2181,883
2018,5,25,5,1130,1207,1843,636
2018,5,25,6,1045,1107,1841,734
2018,5,25,7,1030,1033,1456,423
2018,5,25,8,1020,1003,1279,276
2018,5,25,9,1005,1005,1267,262
2018,5,25,10,1010,981,1184,203
2018,5,25,11,1025,992,1194,202
2018,5,25,12,1055,1020,1222,202
2018,5,25,13,1110,1086,1212,126
2018,5,25,14,1150,1181,1272,91
2018,5,25,15,1175,1205,1330,125
2018,5,25,16,1195,1240,1421,181
2018,5,25,17,1210,1271,1602,331
2018,5,25,18,1215,1271,1546,275
2018,5,25,19,1230,1291,1387,96
2018,5,25,20,1245,1303,1446,143
2018,5,25,21,1250,1314,1396,82
2018,5,25,22,1280,1325,1366,41
2018,5,25,23,1260,1342,1407,65
2018,5,26,0,1235,1338,1559,221
2018,5,26,1,1230,1307,1483,176
2018,5,26,2,1210,1265,1345,80
2018,5,26,3,1210,1224,1201,-23
2018,5,26,4,1205,1227,1225,-2
2018,5,26,5,1130,1188,1231,43
2018,5,26,6,1045,1106,1152,46
2018,5,26,7,1020,1055,1123,68
2018,5,26,8,1005,1027,1136,109
2018,5,26,9,995,998,1115,117
2018,5,26,10,1000,992,1115,123
2018,5,26,11,1000,981,1099,118
2018,5,26,12,1025,1001,1128,127
2018,5,26,13,1045,1027,1115,88
2018,5,26,14,1070,1080,1170,90
2018,5,26,15,1110,1128,1185,57
2018,5,26,16,1135,1173,1218,45
2018,5,26,17,1150,1180,1231,51
2018,5,26,18,1140,1218,1258,40
2018,5,26,19,1145,1236,1226,-10
2018,5,26,20,1130,1246,1253,7
2018,5,26,21,1120,1244,1270,26
2018,5,26,22,1125,1223,1249,26
2018,5,26,23,1135,1228,1284,56
2018,5,27,0,1140,1216,1289,73
2018,5,27,1,1150,1212,1308,96
2018,5,27,2,1150,1205,1286,81
2018,5,27,3,1150,1203,1410,207
2018,5,27,4,1170,1195,1397,202
2018,5,27,5,1120,1144,1323,179
2018,5,27,6,1050,1063,1252,189
2018,5,27,7,1020,1023,1218,195
2018,5,27,8,990,983,1236,253
2018,5,27,9,985,992,1248,256
2018,5,27,10,980,975,1262,287
2018,5,27,11,980,992,1275,283
2018,5,27,12,990,977,1206,229
2018,5,27,13,1010,977,1224,247
2018,5,27,14,1070,1033,1177,144
2018,5,27,15,1110,1077,1169,92
2018,5,27,16,1145,1117,1089,-28
2018,5,27,17,1155,1135,1078,-57
2018,5,27,18,1155,1154,1104,-50
2018,5,27,19,1160,1159,1097,-62
2018,5,27,20,1160,1173,1122,-51
2018,5,27,21,1165,1171,1098,-73
2018,5,27,22,1165,1195,1218,23
2018,5,27,23,1180,1209,1229,20
2018,5,28,0,1195,1232,1432,200
2018,5,28,1,1200,1246,1823,577
2018,5,28,2,1200,1229,1961,732
2018,5,28,3,1205,1224,1946,722
2018,5,28,4,1210,1227,1927,700
2018,5,28,5,1135,1192,1877,685
2018,5,28,6,1055,1116,1785,669
2018,5,28,7,1005,1049,1452,403
2018,5,28,8,985,1025,1184,159
2018,5,28,9,970,993,1143,150
2018,5,28,10,965,993,1135,142
2018,5,28,11,985,1000,1141,141
2018,5,28,12,1030,1003,1141,138
2018,5,28,13,1120,1023,1206,183
2018,5,28,14,1205,1058,1056,-2
2018,5,28,15,1230,1111,1029,-82
2018,5,28,16,1240,1164,1055,-109
2018,5,28,17,1235,1197,1073,-124
2018,5,28,18,1265,1221,1081,-140
2018,5,28,19,1270,1227,1077,-150
2018,5,28,20,1275,1232,1090,-142
2018,5,28,21,1280,1238,1129,-109
2018,5,28,22,1290,1244,1150,-94
2018,5,28,23,1305,1272,1139,-133
2018,5,29,0,1290,1279,1138,-141
2018,5,29,1,1280,1276,1157,-119
2018,5,29,2,1250,1271,1176,-95
2018,5,29,3,1230,1249,1156,-93
2018,5,29,4,1220,1232,1226,-6
2018,5,29,5,1150,1157,1017,-140
2018,5,29,6,1065,1058,1023,-35
2018,5,29,7,990,1024,1034,10
2018,5,29,8,970,991,1036,45
2018,5,29,9,960,979,1056,77
2018,5,29,10,965,985,1058,73
2018,5,29,11,970,988,1070,82
2018,5,29,12,1010,1040,1071,31
2018,5,29,13,1105,1116,1063,-53
2018,5,29,14,1185,1229,1185,-44
2018,5,29,15,1205,1266,1448,182
2018,5,29,16,1225,1289,1442,153
2018,5,29,17,1225,1291,1429,138
2018,5,29,18,1230,1296,1523,227
2018,5,29,19,1225,1308,1581,273
2018,5,29,20,1240,1304,1570,266
2018,5,29,21,1245,1327,1674,347
2018,5,29,22,1265,1320,1482,162
2018,5,29,23,1275,1346,1308,-38
2018,5,30,0,1265,1351,1370,19
2018,5,30,1,1245,1356,1367,11
2018,5,30,2,1235,1336,1349,13
2018,5,30,3,1225,1306,1284,-22
2018,5,30,4,1215,1297,1263,-34
2018,5,30,5,1140,1218,1211,-7
2018,5,30,6,1050,1114,1144,30
2018,5,30,7,1040,1050,997,-53
2018,5,30,8,1010,1022,1022,0
2018,5,30,9,995,1002,1019,17
2018,5,30,10,990,991,1023,32
2018,5,30,11,1005,1008,1024,16
2018,5,30,12,1035,1042,1098,56
2018,5,30,13,1110,1141,1599,458
2018,5,30,14,1160,1240,1800,560
2018,5,30,15,1210,1267,2024,757
2018,5,30,16,1240,1282,1946,664
2018,5,30,17,1265,1286,1629,343
2018,5,30,18,1260,1293,1572,279
2018,5,30,19,1275,1321,1623,302
2018,5,30,20,1280,1346,1629,283
2018,5,30,21,1285,1347,1706,359
2018,5,30,22,1300,1369,1782,413
2018,5,30,23,1310,1391,1808,417
2018,5,31,0,1300,1376,1906,530
2018,5,31,1,1285,1341,1888,547
2018,5,31,2,1260,1305,1869,564
2018,5,31,3,1245,1289,1828,539
2018,5,31,4,1230,1270,1766,496
2018,5,31,5,1185,1204,1796,592
2018,5,31,6,1100,1119,1747,628
2018,5,31,7,1015,1077,1605,528
2018,5,31,8,985,1028,1182,154
2018,5,31,9,975,1019,1094,75
2018,5,31,10,975,1013,1097,84
2018,5,31,11,990,1028,1102,74
2018,5,31,12,1035,1068,1103,35
2018,5,31,13,1105,1133,1377,244
2018,5,31,14,1190,1223,1662,439
2018,5,31,15,1215,1258,1909,651
2018,5,31,16,1235,1278,1551,273
2018,5,31,17,1245,1295,1512,217
2018,5,31,18,1240,1310,1265,-45
2018,5,31,19,1255,1305,1177,-128
2018,5,31,20,1265,1320,1181,-139
2018,5,31,21,1275,1319,1159,-160
2018,5,31,22,1275,1325,1159,-166
2018,5,31,23,1285,1322,1153,-169
2018,6,1,0,1280,1314,1192,-122
2018,6,1,1,1275,1293,1226,-67
2018,6,1,2,1265,1282,1218,-64
2018,6,1,3,1250,1293,1165,-128
2018,6,1,4,1245,1256,1219,-37
2018,6,1,5,1165,1188,1243,55
2018,6,1,6,1075,1105,1113,8
2018,6,1,7,1020,1051,1078,27
2018,6,1,8,995,1012,1052,40
2018,6,1,9,975,1011,1065,54
2018,6,1,10,970,1009,1054,45
2018,6,1,11,985,1016,1064,48
2018,6,1,12,1005,1044,1065,21
2018,6,1,13,1065,1124,1066,-58
2018,6,1,14,1115,1205,1162,-43
2018,6,1,15,1165,1226,1196,-30
2018,6,1,16,1200,1253,1372,119
2018,6,1,17,1225,1250,1249,-1
2018,6,1,18,1225,1250,1244,-6
2018,6,1,19,1240,1256,1289,33
2018,6,1,20,1245,1236,1252,16
2018,6,1,21,1250,1230,1267,37
2018,6,1,22,1265,1221,1225,4
2018,6,1,23,1275,1214,1242,28
2018,6,2,0,1270,1196,1239,43
2018,6,2,1,1255,1192,1249,57
2018,6,2,2,1235,1192,1257,65
2018,6,2,3,1220,1187,1294,107
2018,6,2,4,1220,1213,1342,129
2018,6,2,5,1155,1180,1427,247
2018,6,2,6,1070,1133,1686,553
2018,6,2,7,1050,1080,1400,320
2018,6,2,8,1020,1057,1368,311
2018,6,2,9,1000,1046,1357,311
2018,6,2,10,1000,1044,1348,304
2018,6,2,11,995,1045,1353,308
2018,6,2,12,1015,1051,1343,292
2018,6,2,13,1045,1074,1317,243
2018,6,2,14,1095,1128,1322,194
2018,6,2,15,1160,1156,1315,159
2018,6,2,16,1185,1186,1501,315
2018,6,2,17,1200,1202,1833,631
2018,6,2,18,1215,1194,1929,735
2018,6,2,19,1225,1196,1983,787
2018,6,2,20,1225,1175,1856,681
2018,6,2,21,1215,1179,1943,764
2018,6,2,22,1215,1167,1999,832
2018,6,2,23,1220,1180,2033,853
2018,6,3,0,1230,1189,2055,866
2018,6,3,1,1220,1203,2022,819
2018,6,3,2,1215,1209,1972,763
2018,6,3,3,1215,1201,1878,677
2018,6,3,4,1215,1200,1929,729
2018,6,3,5,1160,1159,1890,731
2018,6,3,6,1090,1093,1872,779
2018,6,3,7,1030,1034,1742,708
2018,6,3,8,995,1007,1321,314
2018,6,3,9,995,991,1072,81
2018,6,3,10,980,991,1068,77
2018,6,3,11,990,994,1068,74
2018,6,3,12,995,977,1070,93
2018,6,3,13,1000,1004,1096,92
2018,6,3,14,1050,1049,1093,44
2018,6,3,15,1095,1119,1132,13
2018,6,3,16,1145,1148,1157,9
2018,6,3,17,1165,1164,1250,86
2018,6,3,18,1175,1195,1560,365
2018,6,3,19,1185,1204,1830,626
2018,6,3,20,1190,1218,1991,773
2018,6,3,21,1205,1241,2019,778
2018,6,3,22,1220,1273,2001,728
2018,6,3,23,1240,1309,1943,634
2018,6,4,0,1255,1338,1822,484
2018,6,4,1,1255,1334,1732,398
2018,6,4,2,1240,1340,1850,510
2018,6,4,3,1240,1307,1744,437
2018,6,4,4,1235,1292,1353,61
2018,6,4,5,1155,1220,1182,-38
2018,6,4,6,1080,1121,1117,-4
2018,6,4,7,1015,1065,1111,46
2018,6,4,8,985,1034,1134,100
2018,6,4,9,970,1012,1021,9
2018,6,4,10,975,991,1047,56
2018,6,4,11,980,1008,1033,25
2018,6,4,12,1035,1037,1041,4
2018,6,4,13,1120,1120,1047,-73
2018,6,4,14,1240,1216,1208,-8
2018,6,4,15,1275,1265,1588,323
2018,6,4,16,1290,1301,1547,246
2018,6,4,17,1295,1343,1462,119
2018,6,4,18,1305,1374,1180,-194
2018,6,4,19,1315,1395,1116,-279
2018,6,4,20,1315,1435,1217,-218
2018,6,4,21,1335,1439,1229,-210
2018,6,4,22,1335,1480,1605,125
2018,6,4,23,1355,1462,1713,251
2018,6,5,0,1350,1460,1869,409
2018,6,5,1,1350,1457,1883,426
2018,6,5,2,1330,1411,1755,344
2018,6,5,3,1305,1389,1751,362
2018,6,5,4,1295,1352,1774,422
2018,6,5,5,1215,1273,1771,498
2018,6,5,6,1115,1163,1683,520
2018,6,5,7,1040,1092,1453,361
2018,6,5,8,1005,1050,1235,185
2018,6,5,9,995,1025,1188,163
2018,6,5,10,995,1009,1175,166
2018,6,5,11,1005,1028,1164,136
2018,6,5,12,1050,1053,1204,151
2018,6,5,13,1130,1134,1570,436
2018,6,5,14,1235,1237,1776,539
2018,6,5,15,1270,1284,1971,687
2018,6,5,16,1295,1302,2006,704
2018,6,5,17,1300,1322,2015,693
2018,6,5,18,1310,1336,2022,686
2018,6,5,19,1320,1342,1980,638
2018,6,5,20,1320,1361,1909,548
2018,6,5,21,1335,1355,1755,400
2018,6,5,22,1335,1361,1712,351
2018,6,5,23,1345,1357,1700,343
2018,6,6,0,1340,1361,1730,369
2018,6,6,1,1325,1344,1731,387
2018,6,6,2,1310,1328,1587,259
2018,6,6,3,1300,1308,1621,313
2018,6,6,4,1290,1301,1622,321
2018,6,6,5,1210,1235,1615,380
2018,6,6,6,1115,1151,1710,559
2018,6,6,7,1030,1102,1604,502
2018,6,6,8,995,1064,1224,160
2018,6,6,9,980,1038,1101,63
2018,6,6,10,970,1033,1066,33
2018,6,6,11,990,1050,1073,23
2018,6,6,12,1025,1078,1282,204
2018,6,6,13,1140,1174,1618,444
2018,6,6,14,1235,1263,1829,566
2018,6,6,15,1270,1304,1913,609
2018,6,6,16,1290,1315,1666,351
2018,6,6,17,1300,1333,1618,285
2018,6,6,18,1305,1342,1630,288
2018,6,6,19,1320,1361,1642,281
2018,6,6,20,1340,1367,1624,257
2018,6,6,21,1340,1399,1625,226
2018,6,6,22,1360,1410,1616,206
2018,6,6,23,1370,1432,1659,227
2018,6,7,0,1355,1436,1798,362
2018,6,7,1,1330,1402,1904,502
2018,6,7,2,1300,1382,1906,524
2018,6,7,3,1290,1358,1909,551
2018,6,7,4,1270,1347,1930,583
2018,6,7,5,1210,1284,1824,540
2018,6,7,6,1120,1185,1727,542
2018,6,7,7,1075,1128,1620,492
2018,6,7,8,1035,1088,1390,302
2018,6,7,9,1020,1047,1089,42
2018,6,7,10,1010,1040,1057,17
2018,6,7,11,1030,1039,1070,31
2018,6,7,12,1060,1073,1084,11
2018,6,7,13,1140,1158,1270,112
2018,6,7,14,1235,1243,1409,166
2018,6,7,15,1275,1299,1568,269
2018,6,7,16,1295,1340,1657,317
2018,6,7,17,1315,1367,1693,326
2018,6,7,18,1325,1398,1734,336
2018,6,7,19,1330,1428,1857,429
2018,6,7,20,1345,1441,1859,418
2018,6,7,21,1350,1470,1872,402
2018,6,7,22,1355,1462,1926,464
2018,6,7,23,1355,1439,1965,526
2018,6,8,0,1345,1404,1977,573
2018,6,8,1,1330,1379,1990,611
2018,6,8,2,1320,1340,1986,646
2018,6,8,3,1310,1323,1884,561
2018,6,8,4,1295,1281,1601,320
2018,6,8,5,1225,1214,1286,72
2018,6,8,6,1135,1130,1004,-126
2018,6,8,7,1055,1091,999,-92
2018,6,8,8,1025,1062,991,-71
2018,6,8,9,1005,1058,989,-69
2018,6,8,10,990,1042,985,-57
2018,6,8,11,1010,1045,990,-55
2018,6,8,12,1035,1078,1070,-8
2018,6,8,13,1140,1131,1284,153
2018,6,8,14,1260,1209,1255,46
2018,6,8,15,1295,1267,1554,287
2018,6,8,16,1315,1295,1470,175
2018,6,8,17,1330,1332,1759,427
2018,6,8,18,1340,1365,1997,632
2018,6,8,19,1360,1360,1991,631
2018,6,8,20,1380,1395,1966,571
2018,6,8,21,1385,1410,1952,542
2018,6,8,22,1395,1435,1945,510
2018,6,8,23,1405,1440,2002,562
2018,6,9,0,1400,1435,1988,553
2018,6,9,1,1375,1423,2006,583
2018,6,9,2,1345,1403,1987,584
2018,6,9,3,1320,1355,1849,494
2018,6,9,4,1290,1316,1602,286
2018,6,9,5,1250,1256,1610,354
2018,6,9,6,1160,1184,1526,342
2018,6,9,7,1020,1123,1347,224
2018,6,9,8,1000,1081,1251,170
2018,6,9,9,985,1054,1137,83
2018,6,9,10,980,1033,1122,89
2018,6,9,11,980,1037,1137,100
2018,6,9,12,980,1039,1182,143
2018,6,9,13,1055,1068,1289,221
2018,6,9,14,1150,1112,1273,161
2018,6,9,15,1200,1189,1366,177
2018,6,9,16,1235,1233,1511,278
2018,6,9,17,1250,1278,1616,338
2018,6,9,18,1265,1310,1556,246
2018,6,9,19,1270,1346,1471,125
2018,6,9,20,1265,1378,1439,61
2018,6,9,21,1275,1402,1378,-24
2018,6,9,22,1285,1415,1442,27
2018,6,9,23,1305,1439,1373,-66
2018,6,10,0,1320,1434,1364,-70
2018,6,10,1,1325,1412,1347,-65
2018,6,10,2,1330,1380,1309,-71
2018,6,10,3,1315,1336,1308,-28
2018,6,10,4,1300,1313,1373,60
2018,6,10,5,1250,1238,1353,115
2018,6,10,6,1160,1164,1291,127
2018,6,10,7,1010,1103,1182,79
2018,6,10,8,985,1062,1208,146
2018,6,10,9,980,1050,1195,145
2018,6,10,10,970,1025,1194,169
2018,6,10,11,980,1016,1144,128
2018,6,10,12,970,998,1131,133
2018,6,10,13,1025,1027,1146,119
2018,6,10,14,1115,1060,1175,115
2018,6,10,15,1170,1129,1334,205
2018,6,10,16,1200,1185,1378,193
2018,6,10,17,1220,1207,1374,167
2018,6,10,18,1230,1214,1282,68
2018,6,10,19,1235,1230,1285,55
2018,6,10,20,1235,1215,1283,68
2018,6,10,21,1245,1207,1294,87
2018,6,10,22,1265,1214,1299,85
2018,6,10,23,1285,1226,1278,52
2018,6,11,0,1310,1247,1294,47
2018,6,11,1,1315,1242,1274,32
2018,6,11,2,1315,1222,1362,140
2018,6,11,3,1295,1212,1474,262
2018,6,11,4,1280,1218,1692,474
2018,6,11,5,1240,1191,1756,565
2018,6,11,6,1155,1132,1771,639
2018,6,11,7,1070,1068,1622,554
2018,6,11,8,1035,1039,1406,367
2018,6,11,9,1015,1036,1307,271
2018,6,11,10,1005,1026,1290,264
2018,6,11,11,1020,1047,1276,229
2018,6,11,12,1055,1079,1379,300
2018,6,11,13,1115,1166,1560,394
2018,6,11,14,1190,1261,1459,198
2018,6,11,15,1215,1281,1565,284
2018,6,11,16,1240,1310,1385,75
2018,6,11,17,1255,1333,1496,163
2018,6,11,18,1270,1328,1478,150
2018,6,11,19,1275,1339,1499,160
2018,6,11,20,1285,1316,1564,248
2018,6,11,21,1285,1275,1663,388
2018,6,11,22,1300,1253,1681,428
2018,6,11,23,1305,1261,1847,586
2018,6,12,0,1295,1266,1994,728
2018,6,12,1,1305,1271,2181,910
2018,6,12,2,1290,1260,2068,808
2018,6,12,3,1285,1229,1910,681
2018,6,12,4,1255,1252,1996,744
2018,6,12,5,1180,1204,1989,785
2018,6,12,6,1085,1130,1716,586
2018,6,12,7,1075,1089,1650,561
2018,6,12,8,1035,1060,1412,352
2018,6,12,9,1015,1040,1303,263
2018,6,12,10,1005,1050,1373,323
2018,6,12,11,1015,1072,1391,319
2018,6,12,12,1050,1088,1497,409
2018,6,12,13,1145,1178,1826,648
2018,6,12,14,1260,1251,2036,785
2018,6,12,15,1305,1280,2120,840
2018,6,12,16,1325,1281,2136,855
2018,6,12,17,1350,1302,2143,841
2018,6,12,18,1365,1299,2101,802
2018,6,12,19,1380,1293,2096,803
2018,6,12,20,1395,1297,2107,810
2018,6,12,21,1405,1306,2135,829
2018,6,12,22,1405,1302,2135,833
2018,6,12,23,1400,1330,2124,794
2018,6,13,0,1395,1332,2089,757
2018,6,13,1,1380,1339,2096,757
2018,6,13,2,1360,1326,2038,712
2018,6,13,3,1335,1292,1993,701
2018,6,13,4,1320,1293,1932,639
2018,6,13,5,1245,1236,1946,710
2018,6,13,6,1155,1154,1911,757
2018,6,13,7,1080,1092,1664,572
2018,6,13,8,1045,1050,1730,680
2018,6,13,9,1035,1033,1704,671
2018,6,13,10,1025,1028,1500,472
2018,6,13,11,1045,1051,1520,469
2018,6,13,12,1075,1083,1586,503
2018,6,13,13,1205,1156,1742,586
2018,6,13,14,1335,1242,1963,721
2018,6,13,15,1365,1272,1979,707
2018,6,13,16,1390,1297,1929,632
2018,6,13,17,1405,1327,1984,657
2018,6,13,18,1410,1331,1938,607
2018,6,13,19,1425,1369,1996,627
2018,6,13,20,1420,1377,1986,609
2018,6,13,21,1420,1403,2019,616
2018,6,13,22,1420,1408,1994,586
2018,6,13,23,1435,1453,2009,556
2018,6,14,0,1435,1455,2052,597
2018,6,14,1,1410,1448,2069,621
2018,6,14,2,1390,1431,2041,610
2018,6,14,3,1370,1426,2021,595
2018,6,14,4,1360,1377,1944,567
2018,6,14,5,1310,1305,1995,690
2018,6,14,6,1215,1193,1839,646
2018,6,14,7,1090,1130,1344,214
2018,6,14,8,1055,1096,1305,209
2018,6,14,9,1035,1069,1305,236
2018,6,14,10,1035,1050,1195,145
2018,6,14,11,1045,1058,1211,153
2018,6,14,12,1075,1089,1246,157
2018,6,14,13,1145,1153,1202,49
2018,6,14,14,1210,1258,1643,385
2018,6,14,15,1245,1308,1957,649
2018,6,14,16,1265,1328,1960,632
2018,6,14,17,1290,1361,2085,724
2018,6,14,18,1300,1369,2076,707
2018,6,14,19,1310,1401,2132,731
2018,6,14,20,1315,1397,2113,716
2018,6,14,21,1330,1410,2097,687
2018,6,14,22,1325,1430,2080,650
2018,6,14,23,1330,1421,2096,675
2018,6,15,0,1315,1394,2063,669
2018,6,15,1,1305,1361,2079,718
2018,6,15,2,1280,1322,2064,742
2018,6,15,3,1265,1312,2048,736
2018,6,15,4,1260,1299,2038,739
2018,6,15,5,1185,1260,2005,745
2018,6,15,6,1105,1166,1950,784
2018,6,15,7,1065,1093,1715,622
2018,6,15,8,1030,1066,1707,641
2018,6,15,9,1020,1052,1580,528
2018,6,15,10,1015,1039,1606,567
2018,6,15,11,1025,1051,1745,694
2018,6,15,12,1055,1075,1760,685
2018,6,15,13,1110,1139,1856,717
2018,6,15,14,1180,1231,1864,633
2018,6,15,15,1215,1261,1866,605
2018,6,15,16,1245,1283,1873,590
2018,6,15,17,1265,1295,1871,576
2018,6,15,18,1285,1315,1875,560
2018,6,15,19,1295,1309,2008,699
2018,6,15,20,1310,1317,2009,692
2018,6,15,21,1325,1295,1997,702
2018,6,15,22,1340,1303,2001,698
2018,6,15,23,1355,1302,2007,705
2018,6,16,0,1350,1285,1991,706
2018,6,16,1,1340,1266,2012,746
2018,6,16,2,1330,1258,2003,745
2018,6,16,3,1305,1259,1888,629
2018,6,16,4,1275,1262,1857,595
2018,6,16,5,1215,1209,1850,641
2018,6,16,6,1135,1143,1769,626
2018,6,16,7,1110,1113,1799,686
2018,6,16,8,1075,1084,1683,599
2018,6,16,9,1055,1069,1587,518
2018,6,16,10,1040,1054,1580,526
2018,6,16,11,1035,1061,1649,588
2018,6,16,12,1030,1098,1795,697
2018,6,16,13,1035,1120,1743,623
2018,6,16,14,1050,1169,1656,487
2018,6,16,15,1115,1243,1771,528
2018,6,16,16,1155,1283,1840,557
2018,6,16,17,1185,1304,1941,637
2018,6,16,18,1200,1312,1942,630
2018,6,16,19,1225,1298,1998,700
2018,6,16,20,1225,1278,2012,734
2018,6,16,21,1235,1259,1970,711
2018,6,16,22,1240,1214,1901,687
2018,6,16,23,1255,1209,1895,686
2018,6,17,0,1265,1218,1933,715
2018,6,17,1,1255,1217,1945,728
2018,6,17,2,1235,1211,1987,776
2018,6,17,3,1210,1201,1990,789
2018,6,17,4,1190,1214,2011,797
2018,6,17,5,1155,1173,1964,791
2018,6,17,6,1090,1124,2005,881
2018,6,17,7,1100,1077,1952,875
2018,6,17,8,1065,1041,1745,704
2018,6,17,9,1045,1030,1713,683
2018,6,17,10,1025,1033,1745,712
2018,6,17,11,1025,1039,1665,626
2018,6,17,12,1015,1046,1695,649
2018,6,17,13,1015,1057,1718,661
2018,6,17,14,1030,1115,1695,580
2018,6,17,15,1095,1180,1561,381
2018,6,17,16,1140,1213,1647,434
2018,6,17,17,1170,1228,1879,651
2018,6,17,18,1190,1239,1845,606
2018,6,17,19,1210,1246,1877,631
2018,6,17,20,1215,1239,1905,666
2018,6,17,21,1225,1229,1749,520
2018,6,17,22,1240,1216,1648,432
2018,6,17,23,1255,1244,1663,419
2018,6,18,0,1270,1245,1671,426
2018,6,18,1,1260,1244,1723,479
2018,6,18,2,1240,1238,1841,603
2018,6,18,3,1210,1247,2107,860
2018,6,18,4,1205,1265,2138,873
2018,6,18,5,1155,1211,2196,985
2018,6,18,6,1085,1138,2263,1125
2018,6,18,7,1075,1088,2275,1187
2018,6,18,8,1040,1062,2224,1162
2018,6,18,9,1030,1048,2100,1052
2018,6,18,10,1020,1034,1875,841
2018,6,18,11,1040,1055,1778,723
2018,6,18,12,1075,1085,1800,715
2018,6,18,13,1165,1176,1927,751
2018,6,18,14,1270,1240,1854,614
2018,6,18,15,1295,1302,2071,769
2018,6,18,16,1330,1330,2251,921
2018,6,18,17,1350,1340,2258,918
2018,6,18,18,1360,1347,2267,920
2018,6,18,19,1375,1357,2217,860
2018,6,18,20,1370,1351,2225,874
2018,6,18,21,1365,1343,2214,871
2018,6,18,22,1365,1336,2296,960
2018,6,18,23,1370,1350,2290,940
2018,6,19,0,1375,1338,2258,920
2018,6,19,1,1370,1322,2248,926
2018,6,19,2,1350,1311,2257,946
2018,6,19,3,1335,1291,2191,900
2018,6,19,4,1305,1286,2251,965
2018,6,19,5,1260,1227,2238,1011
2018,6,19,6,1165,1154,2153,999
2018,6,19,7,1105,1087,1950,863
2018,6,19,8,1070,1071,1996,925
2018,6,19,9,1045,1053,1977,924
2018,6,19,10,1040,1052,1980,928
2018,6,19,11,1055,1065,1994,929
2018,6,19,12,1080,1097,2017,920
2018,6,19,13,1165,1175,2126,951
2018,6,19,14,1260,1253,2126,873
2018,6,19,15,1295,1281,2174,893
2018,6,19,16,1305,1299,2197,898
2018,6,19,17,1335,1309,2148,839
2018,6,19,18,1335,1310,2147,837
2018,6,19,19,1350,1321,2185,864
2018,6,19,20,1355,1313,2191,878
2018,6,19,21,1360,1324,2222,898
2018,6,19,22,1370,1318,2226,908
2018,6,19,23,1375,1320,2240,920
2018,6,20,0,1370,1303,2198,895
2018,6,20,1,1350,1276,2175,899
2018,6,20,2,1330,1260,2190,930
2018,6,20,3,1305,1301,2213,912
2018,6,20,4,1295,1256,2219,963
2018,6,20,5,1250,1211,2227,1016
2018,6,20,6,1160,1129,2178,1049
2018,6,20,7,1080,1076,2172,1096
2018,6,20,8,1045,1061,2155,1094
2018,6,20,9,1030,1025,2054,1029
2018,6,20,10,1025,1020,2109,1089
2018,6,20,11,1045,1016,2116,1100
2018,6,20,12,1080,1056,2157,1101
2018,6,20,13,1145,1131,2175,1044
2018,6,20,14,1200,1208,2236,1028
2018,6,20,15,1240,1235,2218,983
2018,6,20,16,1270,1244,2239,995
2018,6,20,17,1280,1241,2207,966
2018,6,20,18,1295,1269,2237,968
2018,6,20,19,1310,1254,2247,993
2018,6,20,20,1315,1275,2257,982
2018,6,20,21,1325,1301,2240,939
2018,6,20,22,1330,1300,2245,945
2018,6,20,23,1350,1306,2264,958
2018,6,21,0,1345,1308,2269,961
2018,6,21,1,1335,1287,2078,791
2018,6,21,2,1320,1278,2177,899
2018,6,21,3,1305,1273,2283,1010
2018,6,21,4,1270,1264,2299,1035
2018,6,21,5,1220,1235,2287,1052
2018,6,21,6,1130,1141,2038,897
2018,6,21,7,1110,1093,2002,909
2018,6,21,8,1070,1036,1584,548
2018,6,21,9,1040,1008,1533,525
2018,6,21,10,1030,990,1230,240
2018,6,21,11,1030,1009,1226,217
2018,6,21,12,1065,1025,1282,257
2018,6,21,13,1150,1122,1707,585
2018,6,21,14,1245,1210,1847,637
2018,6,21,15,1295,1264,2064,800
2018,6,21,16,1330,1302,2176,874
2018,6,21,17,1365,1331,2250,919
2018,6,21,18,1390,1353,2180,827
2018,6,21,19,1415,1376,2217,841
2018,6,21,20,1425,1402,2286,884
2018,6,21,21,1450,1402,2275,873
2018,6,21,22,1445,1412,2275,863
2018,6,21,23,1425,1408,2262,854
2018,6,22,0,1395,1204,2096,892
2018,6,22,1,1360,1088,2004,916
2018,6,22,2,1325,1674,2551,877
2018,6,22,3,1310,1033,1846,813
2018,6,22,4,1275,1016,1716,700
2018,6,22,5,1225,984,1635,651
2018,6,22,6,1140,1071,1479,408
2018,6,22,7,1045,1091,1385,294
2018,6,22,8,1025,1084,1469,385
2018,6,22,9,1000,1033,1310,277
2018,6,22,10,990,1020,1265,245
2018,6,22,11,990,1032,1249,217
2018,6,22,12,1025,1068,1303,235
2018,6,22,13,1100,1122,1503,381
2018,6,22,14,1195,1264,1962,698
2018,6,22,15,1225,1282,2164,882
2018,6,22,16,1240,1295,2089,794
2018,6,22,17,1245,1305,2086,781
2018,6,22,18,1270,1317,2045,728
2018,6,22,19,1255,1300,2079,779
2018,6,22,20,1275,1326,2306,980
2018,6,22,21,1280,1304,2246,942
2018,6,22,22,1290,1315,2274,959
2018,6,22,23,1290,1311,2301,990
2018,6,23,0,1285,1296,2269,973
2018,6,23,1,1270,1290,2177,887
2018,6,23,2,1260,1287,2016,729
2018,6,23,3,1250,1271,1906,635
2018,6,23,4,1240,1268,1821,553
2018,6,23,5,1205,1237,1647,410
2018,6,23,6,1125,1154,1559,405
2018,6,23,7,1110,1090,1384,294
2018,6,23,8,1070,1060,1215,155
2018,6,23,9,1045,1045,1200,155
2018,6,23,10,1035,1032,1212,180
2018,6,23,11,1040,1036,1184,148
2018,6,23,12,1055,1046,1168,122
2018,6,23,13,1095,1061,1155,94
2018,6,23,14,1150,1099,1295,196
2018,6,23,15,1215,1138,1248,110
2018,6,23,16,1255,1190,1475,285
2018,6,23,17,1285,1218,1579,361
2018,6,23,18,1305,1216,1384,168
2018,6,23,19,1320,1231,1454,223
2018,6,23,20,1325,1238,1564,326
2018,6,23,21,1330,1216,1605,389
2018,6,23,22,1315,1215,1574,359
2018,6,23,23,1315,1232,1835,603
2018,6,24,0,1310,1231,1789,558
2018,6,24,1,1290,1228,1891,663
2018,6,24,2,1275,1219,2005,786
2018,6,24,3,1255,1211,1985,774
2018,6,24,4,1245,1211,1906,695
2018,6,24,5,1195,1184,1805,621
2018,6,24,6,1135,1125,1731,606
2018,6,24,7,1065,1077,1589,512
2018,6,24,8,1035,1031,1340,309
2018,6,24,9,1020,1026,1157,131
2018,6,24,10,1020,1017,1242,225
2018,6,24,11,1025,1032,1248,216
2018,6,24,12,1015,1038,1360,322
2018,6,24,13,1040,1043,1294,251
2018,6,24,14,1100,1089,1204,115
2018,6,24,15,1170,1133,1181,48
2018,6,24,16,1200,1191,1304,113
2018,6,24,17,1220,1206,1497,291
2018,6,24,18,1240,1236,1735,499
2018,6,24,19,1245,1244,1971,727
2018,6,24,20,1245,1247,2030,783
2018,6,24,21,1250,1257,2030,773
2018,6,24,22,1260,1261,2021,760
2018,6,24,23,1290,1289,2046,757
2018,6,25,0,1310,1299,2076,777
2018,6,25,1,1310,1315,2130,815
2018,6,25,2,1300,1304,2113,809
2018,6,25,3,1285,1297,2099,802
2018,6,25,4,1285,1282,2082,800
2018,6,25,5,1230,1245,2072,827
2018,6,25,6,1145,1140,1966,826
2018,6,25,7,1065,1073,1784,711
2018,6,25,8,1045,1047,1409,362
2018,6,25,9,1020,1012,1316,304
2018,6,25,10,1010,1006,1182,176
2018,6,25,11,1025,1013,1200,187
2018,6,25,12,1060,1026,1200,174
2018,6,25,13,1155,1109,1224,115
2018,6,25,14,1250,1193,1373,180
2018,6,25,15,1290,1259,1456,197
2018,6,25,16,1310,1314,1485,171
2018,6,25,17,1315,1345,1522,177
2018,6,25,18,1330,1376,1558,182
2018,6,25,19,1330,1400,1609,209
2018,6,25,20,1330,1450,1783,333
2018,6,25,21,1335,1459,1687,228
2018,6,25,22,1335,1482,1797,315
2018,6,25,23,1340,1535,1803,268
2018,6,26,0,1335,1534,1849,315
2018,6,26,1,1325,1533,1957,424
2018,6,26,2,1315,1490,1981,491
2018,6,26,3,1300,1428,1914,486
2018,6,26,4,1290,1376,1766,390
2018,6,26,5,1245,1307,1797,490
2018,6,26,6,1165,1191,1449,258
2018,6,26,7,1070,1108,1304,196
2018,6,26,8,1035,1083,1242,159
2018,6,26,9,1020,1061,1255,194
2018,6,26,10,1015,1053,1290,237
2018,6,26,11,1030,1074,1303,229
2018,6,26,12,1055,1112,1576,464
2018,6,26,13,1180,1182,1757,575
2018,6,26,14,1300,1280,1808,528
2018,6,26,15,1330,1317,1934,617
2018,6,26,16,1350,1330,2022,692
2018,6,26,17,1375,1345,2140,795
2018,6,26,18,1375,1379,2353,974
2018,6,26,19,1390,1397,2429,1032
2018,6,26,20,1390,1425,2453,1028
2018,6,26,21,1400,1435,2508,1073
2018,6,26,22,1400,1446,2492,1046
2018,6,26,23,1405,1450,2505,1055
2018,6,27,0,1385,1449,2416,967
2018,6,27,1,1365,1422,2300,878
2018,6,27,2,1350,1401,2437,1036
2018,6,27,3,1350,1380,2462,1082
2018,6,27,4,1310,1355,2446,1091
2018,6,27,5,1275,1296,2318,1022
2018,6,27,6,1195,1199,2102,903
2018,6,27,7,1085,1120,2038,918
2018,6,27,8,1060,1075,1710,635
2018,6,27,9,1030,1034,1505,471
2018,6,27,10,1025,1041,1490,449
2018,6,27,11,1035,1045,1447,402
2018,6,27,12,1060,1090,1655,565
2018,6,27,13,1155,1162,1921,759
2018,6,27,14,1255,1256,2188,932
2018,6,27,15,1300,1300,2379,1079
2018,6,27,16,1335,1334,2388,1054
2018,6,27,17,1350,1354,2400,1046
2018,6,27,18,1375,1371,2410,1039
2018,6,27,19,1385,1385,2439,1054
2018,6,27,20,1420,1403,2447,1044
2018,6,27,21,1440,1434,2450,1016
2018,6,27,22,1455,1459,2458,999
2018,6,27,23,1485,1475,2447,972
2018,6,28,0,1485,1483,2474,991
2018,6,28,1,1475,1497,2453,956
2018,6,28,2,1450,1470,2430,960
2018,6,28,3,1425,1435,2427,992
2018,6,28,4,1405,1400,2307,907
2018,6,28,5,1325,1334,2121,787
2018,6,28,6,1215,1198,1578,380
2018,6,28,7,1080,1130,1388,258
2018,6,28,8,1040,1099,1525,426
2018,6,28,9,1015,1068,1459,391
2018,6,28,10,1000,1055,1370,315
2018,6,28,11,1015,1058,1417,359
2018,6,28,12,1040,1090,1657,567
2018,6,28,13,1130,1168,1693,525
2018,6,28,14,1230,1250,1831,581
2018,6,28,15,1275,1305,1997,692
2018,6,28,16,1300,1339,2070,731
2018,6,28,17,1325,1352,2097,745
2018,6,28,18,1340,1379,2167,788
2018,6,28,19,1370,1391,2243,852
2018,6,28,20,1380,1414,2280,866
2018,6,28,21,1390,1429,2299,870
2018,6,28,22,1400,1426,2291,865
2018,6,28,23,1395,1429,2309,880
2018,6,29,0,1365,1427,2347,920
2018,6,29,1,1330,1415,2313,898
2018,6,29,2,1305,1382,2243,861
2018,6,29,3,1290,1344,2219,875
2018,6,29,4,1230,1319,2067,748
2018,6,29,5,1235,1244,2014,770
2018,6,29,6,1150,1181,1680,499
2018,6,29,7,1070,1128,1575,447
2018,6,29,8,1035,1115,1271,156
2018,6,29,9,1000,1091,1262,171
2018,6,29,10,1000,1101,1225,124
2018,6,29,11,1005,1140,1274,134
2018,6,29,12,1040,1119,1454,335
2018,6,29,13,1125,1187,1510,323
2018,6,29,14,1245,1267,1531,264
2018,6,29,15,1275,1313,1672,359
2018,6,29,16,1300,1354,1568,214
2018,6,29,17,1315,1362,1647,285
2018,6,29,18,1335,1284,1645,361
2018,6,29,19,1335,1309,1720,411
2018,6,29,20,1350,1304,1722,418
2018,6,29,21,1355,1298,1675,377
2018,6,29,22,1375,1292,1735,443
2018,6,29,23,1385,1293,1753,460
2018,6,30,0,1380,1275,1697,422
2018,6,30,1,1385,1261,1682,421
2018,6,30,2,1370,1225,1601,376
2018,6,30,3,1345,1216,1512,296
2018,6,30,4,1315,1219,1436,217
2018,6,30,5,1280,1185,1362,177
2018,6,30,6,1175,1149,1143,-6
2018,6,30,7,1090,1113,1064,-49
2018,6,30,8,1055,1093,1028,-65
2018,6,30,9,1045,1079,989,-90
2018,6,30,10,1035,1062,988,-74
2018,6,30,11,1040,1079,999,-80
2018,6,30,12,1055,1077,992,-85
2018,6,30,13,1080,1109,975,-134
2018,6,30,14,1135,1163,953,-210
2018,6,30,15,1185,1207,977,-230
2018,6,30,16,1235,1244,1088,-156
2018,6,30,17,1260,1248,1107,-141
2018,6,30,18,1265,1253,1106,-147
2018,6,30,19,1275,1250,1103,-147
2018,6,30,20,1280,1244,1104,-140
2018,6,30,21,1265,1255,1188,-67
2018,6,30,22,1265,1265,1213,-52
2018,6,30,23,1275,1286,1242,-44
2018,7,1,0,1285,1301,1222,-79
2018,7,1,1,1285,1289,1193,-96
2018,7,1,2,1275,1280,1143,-137
2018,7,1,3,1270,1280,1108,-172
2018,7,1,4,1270,1274,1107,-167
2018,7,1,5,1230,1235,1105,-130
2018,7,1,6,1150,1172,1051,-121
2018,7,1,7,1080,1124,1056,-68
2018,7,1,8,1040,1106,1097,-9
2018,7,1,9,1035,1079,1147,68
2018,7,1,10,1025,1075,1157,82
2018,7,1,11,1035,1079,1239,160
2018,7,1,12,1040,1081,1191,110
2018,7,1,13,1070,1062,1178,116
2018,7,1,14,1135,1111,1229,118
2018,7,1,15,1180,1179,1237,58
2018,7,1,16,1235,1225,1171,-54
2018,7,1,17,1250,1248,1180,-68
2018,7,1,18,1265,1266,1279,13
2018,7,1,19,1275,1279,1186,-93
2018,7,1,20,1275,1277,1173,-104
2018,7,1,21,1270,1288,1173,-115
2018,7,1,22,1270,1319,1164,-155
2018,7,1,23,1295,1325,1194,-131
2018,7,2,0,1300,1333,1171,-162
2018,7,2,1,1305,1333,1121,-212
2018,7,2,2,1295,1311,1059,-252
2018,7,2,3,1290,1279,1040,-239
2018,7,2,4,1280,1265,1108,-157
2018,7,2,5,1250,1220,1245,25
2018,7,2,6,1155,1140,1068,-72
2018,7,2,7,1080,1073,1048,-25
2018,7,2,8,1050,1050,1124,74
2018,7,2,9,1020,1026,1111,85
2018,7,2,10,1020,1027,1142,115
2018,7,2,11,1025,1040,1099,59
2018,7,2,12,1055,1068,1111,43
2018,7,2,13,1135,1146,1158,12
2018,7,2,14,1215,1229,1188,-41
2018,7,2,15,1270,1283,1385,102
2018,7,2,16,1315,1314,1389,75
2018,7,2,17,1340,1339,1415,76
2018,7,2,18,1360,1355,1437,82
2018,7,2,19,1380,1369,1460,91
2018,7,2,20,1405,1384,1460,76
2018,7,2,21,1425,1396,1447,51
2018,7,2,22,1440,1393,1422,29
2018,7,2,23,1475,1385,1423,38
2018,7,3,0,1475,1391,1481,90
2018,7,3,1,1475,1382,1448,66
2018,7,3,2,1445,1354,1409,55
2018,7,3,3,1395,1314,1302,-12
2018,7,3,4,1335,1291,1312,21
2018,7,3,5,1295,1241,1398,157
2018,7,3,6,1185,1144,1365,221
2018,7,3,7,1095,1092,1180,88
2018,7,3,8,1070,1044,1117,73
2018,7,3,9,1050,1024,1228,204
2018,7,3,10,1040,1008,1124,116
2018,7,3,11,1050,1024,1170,146
2018,7,3,12,1085,1056,1261,205
2018,7,3,13,1145,1131,1281,150
2018,7,3,14,1225,1202,1306,104
2018,7,3,15,1260,1246,1311,65
2018,7,3,16,1280,1270,1299,29
2018,7,3,17,1295,1282,1304,22
2018,7,3,18,1315,1288,1306,18
2018,7,3,19,1325,1299,1329,30
2018,7,3,20,1345,1298,1328,30
2018,7,3,21,1355,1308,1345,37
2018,7,3,22,1360,1304,1371,67
2018,7,3,23,1360,1293,1453,160
2018,7,4,0,1350,1273,1432,159
2018,7,4,1,1335,1262,1445,183
2018,7,4,2,1310,1223,1388,165
2018,7,4,3,1300,1209,1392,183
2018,7,4,4,1270,1203,1402,199
2018,7,4,5,1210,1175,1411,236
2018,7,4,6,1135,1112,1378,266
2018,7,4,7,1085,1067,1318,251
2018,7,4,8,1055,1044,1304,260
2018,7,4,9,1025,1036,1344,308
2018,7,4,10,1025,1033,1290,257
2018,7,4,11,1035,1030,1273,243
2018,7,4,12,1070,1035,1258,223
2018,7,4,13,1145,1056,1259,203
2018,7,4,14,1230,1093,1248,155
2018,7,4,15,1275,1147,1252,105
2018,7,4,16,1300,1170,1251,81
2018,7,4,17,1320,1168,1316,148
2018,7,4,18,1340,1183,1328,145
2018,7,4,19,1350,1187,1325,138
2018,7,4,20,1365,1181,1326,145
2018,7,4,21,1385,1185,1325,140
2018,7,4,22,1395,1200,1335,135
2018,7,4,23,1400,1218,1335,117
2018,7,5,0,1405,1233,1342,109
2018,7,5,1,1405,1206,1274,68
2018,7,5,2,1380,1199,1349,150
2018,7,5,3,1345,1187,1332,145
2018,7,5,4,1315,1184,1311,127
2018,7,5,5,1270,1141,1335,194
2018,7,5,6,1160,1122,1388,266
2018,7,5,7,1115,1075,1267,192
2018,7,5,8,1085,1041,1390,349
2018,7,5,9,1055,1020,1384,364
2018,7,5,10,1045,1016,1380,364
2018,7,5,11,1060,1031,1364,333
2018,7,5,12,1090,1057,1353,296
2018,7,5,13,1175,1119,1333,214
2018,7,5,14,1275,1203,1333,130
2018,7,5,15,1315,1252,1330,78
2018,7,5,16,1340,1296,1343,47
2018,7,5,17,1360,1333,1345,12
2018,7,5,18,1380,1362,1359,-3
2018,7,5,19,1400,1401,1365,-36
2018,7,5,20,1420,1419,1350,-69
2018,7,5,21,1435,1455,1358,-97
2018,7,5,22,1440,1482,1364,-118
2018,7,5,23,1440,1520,1389,-131
2018,7,6,0,1430,1542,1391,-151
2018,7,6,1,1410,1549,1378,-171
2018,7,6,2,1385,1535,1376,-159
2018,7,6,3,1355,1483,1349,-134
2018,7,6,4,1330,1453,1337,-116
2018,7,6,5,1270,1388,1322,-66
2018,7,6,6,1195,1283,1273,-10
2018,7,6,7,1105,1198,1248,50
2018,7,6,8,1080,1152,1307,155
2018,7,6,9,1045,1115,1298,183
2018,7,6,10,1055,1088,1294,206
2018,7,6,11,1085,1108,1302,194
2018,7,6,12,1090,1118,1316,198
2018,7,6,13,1225,1180,1344,164
2018,7,6,14,1390,1276,1325,49
2018,7,6,15,1435,1361,1310,-51
2018,7,6,16,1475,1422,1314,-108
2018,7,6,17,1485,1478,1322,-156
2018,7,6,18,1455,1534,1359,-175
2018,7,6,19,1465,1591,1379,-212
2018,7,6,20,1475,1636,1403,-233
2018,7,6,21,1480,1672,1421,-251
2018,7,6,22,1485,1701,1412,-289
2018,7,6,23,1495,1704,1391,-313
2018,7,7,0,1480,1696,1403,-293
2018,7,7,1,1480,1649,1398,-251
2018,7,7,2,1455,1603,1362,-241
2018,7,7,3,1430,1554,1337,-217
2018,7,7,4,1425,1524,1345,-179
2018,7,7,5,1375,1448,1377,-71
2018,7,7,6,1295,1359,1475,116
2018,7,7,7,1175,1269,1472,203
2018,7,7,8,1145,1195,1410,215
2018,7,7,9,1120,1156,1329,173
2018,7,7,10,1095,1130,1173,43
2018,7,7,11,1100,1122,1166,44
2018,7,7,12,1095,1131,1177,46
2018,7,7,13,1130,1129,1254,125
2018,7,7,14,1200,1194,1263,69
2018,7,7,15,1280,1262,1267,5
2018,7,7,16,1315,1336,1342,6
2018,7,7,17,1360,1406,1348,-58
2018,7,7,18,1390,1441,1357,-84
2018,7,7,19,1415,1477,1377,-100
2018,7,7,20,1440,1499,1384,-115
2018,7,7,21,1470,1521,1383,-138
2018,7,7,22,1510,1552,1379,-173
2018,7,7,23,1545,1570,1371,-199
2018,7,8,0,1555,1587,1414,-173
2018,7,8,1,1550,1591,1403,-188
2018,7,8,2,1525,1568,1375,-193
2018,7,8,3,1465,1537,1347,-190
2018,7,8,4,1425,1486,1340,-146
2018,7,8,5,1380,1464,1407,-57
2018,7,8,6,1280,1325,1175,-150
2018,7,8,7,1140,1249,1188,-61
2018,7,8,8,1100,1187,1154,-33
2018,7,8,9,1095,1115,1244,129
2018,7,8,10,1060,1096,1196,100
2018,7,8,11,1040,1083,1387,304
2018,7,8,12,1025,1080,1405,325
2018,7,8,13,1070,1095,1522,427
2018,7,8,14,1140,1163,1792,629
2018,7,8,15,1205,1231,1920,689
2018,7,8,16,1270,1297,2042,745
2018,7,8,17,1315,1344,2039,695
2018,7,8,18,1355,1375,2043,668
2018,7,8,19,1395,1425,2047,622
2018,7,8,20,1425,1443,2041,598
2018,7,8,21,1455,1478,2049,571
2018,7,8,22,1480,1504,2072,568
2018,7,8,23,1500,1536,2082,546
2018,7,9,0,1510,1558,2122,564
2018,7,9,1,1490,1575,2133,558
2018,7,9,2,1465,1544,2112,568
2018,7,9,3,1440,1498,2092,594
2018,7,9,4,1390,1459,2063,604
2018,7,9,5,1340,1387,2047,660
2018,7,9,6,1255,1270,2013,743
2018,7,9,7,1180,1184,1989,805
2018,7,9,8,1135,1128,1941,813
2018,7,9,9,1105,1118,1951,833
2018,7,9,10,1090,1099,1941,842
2018,7,9,11,1100,1109,1956,847
2018,7,9,12,1120,1136,1923,787
2018,7,9,13,1180,1202,1916,714
2018,7,9,14,1265,1309,1977,668
2018,7,9,15,1340,1380,1979,599
2018,7,9,16,1395,1431,1987,556
2018,7,9,17,1440,1491,2024,533
2018,7,9,18,1490,1563,2074,511
2018,7,9,19,1530,1591,2076,485
2018,7,9,20,1580,1658,2080,422
2018,7,9,21,1615,1714,2082,368
2018,7,9,22,1650,1736,2091,355
2018,7,9,23,1670,1759,2111,352
2018,7,10,0,1670,1729,2109,380
2018,7,10,1,1660,1713,2118,405
2018,7,10,2,1620,1680,2128,448
2018,7,10,3,1590,1647,2129,482
2018,7,10,4,1530,1616,2106,490
2018,7,10,5,1445,1540,2102,562
2018,7,10,6,1325,1383,2022,639
2018,7,10,7,1130,1297,1864,567
2018,7,10,8,1085,1229,1747,518
2018,7,10,9,1060,1188,1734,546
2018,7,10,10,1050,1171,1724,553
2018,7,10,11,1070,1160,1739,579
2018,7,10,12,1100,1188,1708,520
2018,7,10,13,1225,1259,1861,602
2018,7,10,14,1360,1351,1924,573
2018,7,10,15,1405,1442,1981,539
2018,7,10,16,1440,1509,2023,514
2018,7,10,17,1465,1572,2068,496
2018,7,10,18,1490,1634,2060,426
2018,7,10,19,1515,1671,2074,403
2018,7,10,20,1525,1691,1873,182
2018,7,10,21,1550,1757,1620,-137
2018,7,10,22,1560,1786,1528,-258
2018,7,10,23,1575,1756,1492,-264
2018,7,11,0,1575,1708,1438,-270
2018,7,11,1,1570,1690,1403,-287
2018,7,11,2,1540,1641,1437,-204
2018,7,11,3,1505,1595,1457,-138
2018,7,11,4,1475,1553,1496,-57
2018,7,11,5,1430,1474,1488,14
2018,7,11,6,1335,1342,1476,134
2018,7,11,7,1155,1272,1484,212
2018,7,11,8,1110,1203,1450,247
2018,7,11,9,1095,1175,1446,271
2018,7,11,10,1085,1151,1383,232
2018,7,11,11,1090,1154,1329,175
2018,7,11,12,1110,1179,1334,155
2018,7,11,13,1235,1253,1344,91
2018,7,11,14,1390,1330,1337,7
2018,7,11,15,1460,1385,1341,-44
2018,7,11,16,1500,1418,1354,-64
2018,7,11,17,1530,1442,1402,-40
2018,7,11,18,1575,1473,1412,-61
2018,7,11,19,1595,1508,1425,-83
2018,7,11,20,1620,1536,1438,-98
2018,7,11,21,1655,1580,1429,-151
2018,7,11,22,1675,1593,1417,-176
2018,7,11,23,1700,1619,1403,-216
2018,7,12,0,1695,1628,1418,-210
2018,7,12,1,1675,1618,1429,-189
2018,7,12,2,1650,1590,1451,-139
2018,7,12,3,1625,1544,1479,-65
2018,7,12,4,1600,1500,1428,-72
2018,7,12,5,1535,1419,1432,13
2018,7,12,6,1435,1306,1434,128
2018,7,12,7,1110,1233,1423,190
2018,7,12,8,1070,1185,1145,-40
2018,7,12,9,1050,1161,1127,-34
2018,7,12,10,1040,1144,1139,-5
2018,7,12,11,1050,1134,1127,-7
2018,7,12,12,1075,1163,1288,125
2018,7,12,13,1135,1238,1334,96
2018,7,12,14,1220,1316,1299,-17
2018,7,12,15,1275,1379,1305,-74
2018,7,12,16,1320,1416,1300,-116
2018,7,12,17,1365,1465,1308,-157
2018,7,12,18,1410,1508,1327,-181
2018,7,12,19,1440,1551,1351,-200
2018,7,12,20,1475,1597,1380,-217
2018,7,12,21,1515,1628,1424,-204
2018,7,12,22,1535,1658,1428,-230
2018,7,12,23,1560,1690,1430,-260
2018,7,13,0,1555,1697,1403,-294
2018,7,13,1,1550,1679,1312,-367
2018,7,13,2,1525,1650,1236,-414
2018,7,13,3,1485,1596,1231,-365
2018,7,13,4,1450,1572,1253,-319
2018,7,13,5,1385,1492,1241,-251
2018,7,13,6,1270,1365,1249,-116
2018,7,13,7,1250,1282,1244,-38
2018,7,13,8,1190,1226,1188,-38
2018,7,13,9,1165,1196,1183,-13
2018,7,13,10,1140,1189,1181,-8
2018,7,13,11,1150,1190,1187,-3
2018,7,13,12,1170,1210,1183,-27
2018,7,13,13,1245,1267,1173,-94
2018,7,13,14,1345,1368,1139,-229
2018,7,13,15,1415,1435,1142,-293
2018,7,13,16,1470,1502,1157,-345
2018,7,13,17,1515,1553,1189,-364
2018,7,13,18,1570,1618,1244,-374
2018,7,13,19,1615,1657,1264,-393
2018,7,13,20,1665,1692,1369,-323
2018,7,13,21,1710,1708,1455,-253
2018,7,13,22,1735,1738,1475,-263
2018,7,13,23,1750,1759,1601,-158
2018,7,14,0,1740,1775,1732,-43
2018,7,14,1,1715,1750,1766,16
2018,7,14,2,1675,1728,1806,78
2018,7,14,3,1630,1680,1845,165
2018,7,14,4,1600,1616,1854,238
2018,7,14,5,1515,1526,1863,337
2018,7,14,6,1390,1420,1923,503
2018,7,14,7,1255,1329,1886,557
2018,7,14,8,1195,1278,1811,533
2018,7,14,9,1145,1236,1814,578
2018,7,14,10,1125,1219,1858,639
2018,7,14,11,1120,1221,1898,677
2018,7,14,12,1120,1215,1902,687
2018,7,14,13,1140,1205,1840,635
2018,7,14,14,1215,1267,1851,584
2018,7,14,15,1275,1335,1932,597
2018,7,14,16,1345,1409,2029,620
2018,7,14,17,1390,1459,2078,619
2018,7,14,18,1415,1484,2096,612
2018,7,14,19,1450,1506,2013,507
2018,7,14,20,1465,1515,1994,479
2018,7,14,21,1490,1530,2089,559
2018,7,14,22,1515,1540,2118,578
2018,7,14,23,1540,1548,2152,604
2018,7,15,0,1560,1541,2130,589
2018,7,15,1,1565,1536,2151,615
2018,7,15,2,1540,1508,2055,547
2018,7,15,3,1510,1461,2105,644
2018,7,15,4,1450,1431,2076,645
2018,7,15,5,1425,1376,2043,667
2018,7,15,6,1310,1288,2072,784
2018,7,15,7,1215,1211,2055,844
2018,7,15,8,1160,1159,1983,824
2018,7,15,9,1105,1132,1915,783
2018,7,15,10,1090,1116,1918,802
2018,7,15,11,1080,1118,1904,786
2018,7,15,12,1080,1112,1905,793
2018,7,15,13,1100,1127,1905,778
2018,7,15,14,1180,1181,1869,688
2018,7,15,15,1245,1235,1920,685
2018,7,15,16,1315,1297,1926,629
2018,7,15,17,1360,1336,1901,565
2018,7,15,18,1390,1382,1901,519
2018,7,15,19,1430,1420,1906,486
2018,7,15,20,1445,1458,1948,490
2018,7,15,21,1470,1499,1997,498
2018,7,15,22,1500,1550,2073,523
2018,7,15,23,1525,1591,2104,513
2018,7,16,0,1540,1636,2129,493
2018,7,16,1,1550,1645,2124,479
2018,7,16,2,1520,1632,2115,483
2018,7,16,3,1485,1583,2066,483
2018,7,16,4,1445,1539,2081,542
2018,7,16,5,1395,1446,2041,595
2018,7,16,6,1275,1319,2035,716
2018,7,16,7,1175,1240,1955,715
2018,7,16,8,1115,1183,1912,729
2018,7,16,9,1095,1167,1917,750
2018,7,16,10,1080,1140,1905,765
2018,7,16,11,1090,1139,1930,791
2018,7,16,12,1115,1177,1944,767
2018,7,16,13,1240,1254,1960,706
2018,7,16,14,1380,1351,1885,534
2018,7,16,15,1445,1418,1881,463
2018,7,16,16,1490,1482,1934,452
2018,7,16,17,1535,1540,1983,443
2018,7,16,18,1580,1593,2065,472
2018,7,16,19,1610,1626,2095,469
2018,7,16,20,1660,1664,2066,402
2018,7,16,21,1705,1712,2097,385
2018,7,16,22,1720,1727,2085,358
2018,7,16,23,1735,1748,2077,329
2018,7,17,0,1725,1745,2087,342
2018,7,17,1,1710,1730,2085,355
2018,7,17,2,1675,1689,2097,408
2018,7,17,3,1635,1632,2082,450
2018,7,17,4,1600,1570,2003,433
2018,7,17,5,1525,1468,1981,513
2018,7,17,6,1385,1369,1997,628
2018,7,17,7,1250,1284,1943,659
2018,7,17,8,1195,1222,1918,696
2018,7,17,9,1165,1190,1912,722
2018,7,17,10,1145,1178,1902,724
2018,7,17,11,1140,1174,1886,712
2018,7,17,12,1170,1211,1939,728
2018,7,17,13,1255,1263,1981,718
2018,7,17,14,1350,1366,1931,565
2018,7,17,15,1420,1427,1929,502
2018,7,17,16,1465,1476,1947,471
2018,7,17,17,1515,1530,1988,458
2018,7,17,18,1560,1582,2040,458
2018,7,17,19,1595,1582,2163,581
2018,7,17,20,1625,1593,2182,589
2018,7,17,21,1670,1631,2257,626
2018,7,17,22,1695,1654,2430,776
2018,7,17,23,1695,1645,2384,739
2018,7,18,0,1675,1613,2406,793
2018,7,18,1,1660,1598,2529,931
2018,7,18,2,1620,1575,2605,1030
2018,7,18,3,1575,1545,2487,942
2018,7,18,4,1535,1487,2213,726
2018,7,18,5,1475,1315,2067,752
2018,7,18,6,1350,1168,1994,826
2018,7,18,7,1245,1269,1936,667
2018,7,18,8,1180,1221,1909,688
2018,7,18,9,1155,1179,1898,719
2018,7,18,10,1135,1179,1904,725
2018,7,18,11,1135,1182,1976,794
2018,7,18,12,1165,1205,1958,753
2018,7,18,13,1265,1274,1934,660
2018,7,18,14,1385,1374,1909,535
2018,7,18,15,1450,1422,1943,521
2018,7,18,16,1510,1481,1976,495
2018,7,18,17,1555,1524,1994,470
2018,7,18,18,1610,1578,2059,481
2018,7,18,19,1645,1619,2040,421
2018,7,18,20,1680,1668,2031,363
2018,7,18,21,1720,1709,2030,321
2018,7,18,22,1740,1747,2008,261
2018,7,18,23,1760,1760,1999,239
2018,7,19,0,1765,1731,2012,281
2018,7,19,1,1750,1695,1974,279
2018,7,19,2,1715,1667,1960,293
2018,7,19,3,1660,1609,1954,345
2018,7,19,4,1620,1566,1988,422
2018,7,19,5,1510,1463,1925,462
2018,7,19,6,1400,1342,1904,562
2018,7,19,7,1240,1267,1938,671
2018,7,19,8,1190,1210,1915,705
2018,7,19,9,1160,1181,1910,729
2018,7,19,10,1145,1173,1959,786
2018,7,19,11,1145,1154,2003,849
2018,7,19,12,1175,1194,2024,830
2018,7,19,13,1250,1246,1997,751
2018,7,19,14,1350,1343,1945,602
2018,7,19,15,1410,1407,1937,530
2018,7,19,16,1455,1464,1914,450
2018,7,19,17,1505,1496,1856,360
2018,7,19,18,1550,1539,1869,330
2018,7,19,19,1575,1572,1899,327
2018,7,19,20,1605,1623,1926,303
2018,7,19,21,1640,1672,1967,295
2018,7,19,22,1665,1695,1969,274
2018,7,19,23,1685,1723,1914,191
2018,7,20,0,1675,1731,1786,55
2018,7,20,1,1660,1722,1825,103
2018,7,20,2,1635,1679,1929,250
2018,7,20,3,1590,1581,1867,286
2018,7,20,4,1560,1568,1902,334
2018,7,20,5,1440,1470,1871,401
2018,7,20,6,1305,1339,1894,555
2018,7,20,7,1270,1248,1865,617
2018,7,20,8,1215,1219,1837,618
2018,7,20,9,1190,1175,1812,637
2018,7,20,10,1170,1168,1718,550
2018,7,20,11,1170,1177,1705,528
2018,7,20,12,1200,1193,1747,554
2018,7,20,13,1250,1256,1801,545
2018,7,20,14,1330,1338,1848,510
2018,7,20,15,1400,1408,1851,443
2018,7,20,16,1465,1469,1855,386
2018,7,20,17,1520,1509,1877,368
2018,7,20,18,1580,1558,1877,319
2018,7,20,19,1620,1595,1915,320
2018,7,20,20,1655,1647,1961,314
2018,7,20,21,1690,1683,1977,294
2018,7,20,22,1710,1694,1739,45
2018,7,20,23,1730,1747,1391,-356
2018,7,21,0,1730,1738,1318,-420
2018,7,21,1,1705,1747,1310,-437
2018,7,21,2,1670,1727,1301,-426
2018,7,21,3,1620,1670,1268,-402
2018,7,21,4,1560,1617,1297,-320
2018,7,21,5,1470,1529,1286,-243
2018,7,21,6,1370,1413,1270,-143
2018,7,21,7,1260,1305,1253,-52
2018,7,21,8,1205,1256,1270,14
2018,7,21,9,1170,1226,1267,41
2018,7,21,10,1155,1195,1274,79
2018,7,21,11,1155,1191,1384,193
2018,7,21,12,1150,1202,1376,174
2018,7,21,13,1145,1200,1363,163
2018,7,21,14,1195,1253,1321,68
2018,7,21,15,1260,1316,1304,-12
2018,7,21,16,1330,1376,1292,-84
2018,7,21,17,1375,1412,1276,-136
2018,7,21,18,1410,1448,1250,-198
2018,7,21,19,1445,1463,1295,-168
2018,7,21,20,1465,1492,1300,-192
2018,7,21,21,1490,1507,1308,-199
2018,7,21,22,1520,1562,1342,-220
2018,7,21,23,1540,1609,1359,-250
2018,7,22,0,1555,1633,1343,-290
2018,7,22,1,1560,1642,1377,-265
2018,7,22,2,1540,1600,1366,-234
2018,7,22,3,1495,1540,1274,-266
2018,7,22,4,1465,1510,1241,-269
2018,7,22,5,1390,1422,1224,-198
2018,7,22,6,1280,1352,1268,-84
2018,7,22,7,1200,1283,1398,115
2018,7,22,8,1145,1218,1400,182
2018,7,22,9,1115,1192,1382,190
2018,7,22,10,1100,1162,1351,189
2018,7,22,11,1095,1172,1354,182
2018,7,22,12,1105,1166,1341,175
2018,7,22,13,1140,1161,1349,188
2018,7,22,14,1205,1232,1345,113
2018,7,22,15,1265,1287,1318,31
2018,7,22,16,1330,1337,1316,-21
2018,7,22,17,1375,1378,1303,-75
2018,7,22,18,1425,1415,1325,-90
2018,7,22,19,1460,1444,1321,-123
2018,7,22,20,1495,1465,1309,-156
2018,7,22,21,1540,1496,1314,-182
2018,7,22,22,1570,1542,1324,-218
2018,7,22,23,1600,1569,1321,-248
2018,7,23,0,1620,1609,1338,-271
2018,7,23,1,1625,1619,1306,-313
2018,7,23,2,1595,1597,1339,-258
2018,7,23,3,1545,1561,1347,-214
2018,7,23,4,1505,1521,1338,-183
2018,7,23,5,1405,1440,1331,-109
2018,7,23,6,1290,1344,1333,-11
2018,7,23,7,1190,1253,1335,82
2018,7,23,8,1140,1180,1464,284
2018,7,23,9,1115,1165,1464,299
2018,7,23,10,1100,1146,1629,483
2018,7,23,11,1100,1139,1657,518
2018,7,23,12,1130,1178,1671,493
2018,7,23,13,1210,1255,1876,621
2018,7,23,14,1310,1348,1943,595
2018,7,23,15,1370,1404,1934,530
2018,7,23,16,1430,1434,1932,498
2018,7,23,17,1480,1484,1955,471
2018,7,23,18,1535,1521,1938,417
2018,7,23,19,1570,1554,1985,431
2018,7,23,20,1615,1597,1996,399
2018,7,23,21,1665,1647,1998,351
2018,7,23,22,1690,1682,2019,337
2018,7,23,23,1705,1712,2065,353
2018,7,24,0,1685,1717,2092,375
2018,7,24,1,1665,1732,2055,323
2018,7,24,2,1630,1721,2098,377
2018,7,24,3,1580,1668,2047,379
2018,7,24,4,1525,1621,2065,444
2018,7,24,5,1430,1493,2085,592
2018,7,24,6,1320,1367,2061,694
2018,7,24,7,1250,1282,1983,701
2018,7,24,8,1190,1244,1892,648
2018,7,24,9,1160,1213,1885,672
2018,7,24,10,1145,1184,1904,720
2018,7,24,11,1135,1188,1901,713
2018,7,24,12,1175,1221,1888,667
2018,7,24,13,1255,1277,1943,666
2018,7,24,14,1380,1363,2041,678
2018,7,24,15,1450,1429,2115,686
2018,7,24,16,1505,1491,2188,697
2018,7,24,17,1555,1524,2178,654
2018,7,24,18,1605,1564,2189,625
2018,7,24,19,1625,1595,2172,577
2018,7,24,20,1660,1642,2147,505
2018,7,24,21,1705,1655,2114,459
2018,7,24,22,1730,1705,2103,398
2018,7,24,23,1735,1732,2110,378
2018,7,25,0,1715,1746,2126,380
2018,7,25,1,1700,1728,2108,380
2018,7,25,2,1665,1709,2095,386
2018,7,25,3,1600,1661,2104,443
2018,7,25,4,1550,1635,2119,484
2018,7,25,5,1435,1537,2117,580
2018,7,25,6,1295,1397,2021,624
2018,7,25,7,1260,1310,1968,658
2018,7,25,8,1200,1282,1952,670
2018,7,25,9,1170,1248,2171,923
2018,7,25,10,1155,1219,2136,917
2018,7,25,11,1155,1231,2237,1006
2018,7,25,12,1185,1248,2267,1019
2018,7,25,13,1250,1313,2241,928
2018,7,25,14,1330,1406,2519,1113
2018,7,25,15,1385,1434,2659,1225
2018,7,25,16,1425,1488,2443,955
2018,7,25,17,1470,1542,2338,796
2018,7,25,18,1510,1586,2288,702
2018,7,25,19,1550,1605,2216,611
2018,7,25,20,1590,1625,2239,614
2018,7,25,21,1635,1653,2332,679
2018,7,25,22,1670,1669,2329,660
2018,7,25,23,1690,1710,2111,401
2018,7,26,0,1680,1723,2037,314
2018,7,26,1,1670,1722,2045,323
2018,7,26,2,1645,1706,2035,329
2018,7,26,3,1595,1647,2028,381
2018,7,26,4,1545,1604,2022,418
2018,7,26,5,1440,1493,2035,542
2018,7,26,6,1320,1371,2040,669
2018,7,26,7,1255,1316,2000,684
2018,7,26,8,1210,1256,1975,719
2018,7,26,9,1180,1227,1925,698
2018,7,26,10,1160,1218,1919,701
2018,7,26,11,1155,1236,1916,680
2018,7,26,12,1190,1260,1933,673
2018,7,26,13,1245,1318,1941,623
2018,7,26,14,1330,1382,1916,534
2018,7,26,15,1395,1433,1940,507
2018,7,26,16,1450,1467,2013,546
2018,7,26,17,1490,1506,2068,562
2018,7,26,18,1530,1552,2108,556
2018,7,26,19,1565,1566,2111,545
2018,7,26,20,1610,1599,2123,524
2018,7,26,21,1645,1640,2176,536
2018,7,26,22,1680,1636,2121,485
2018,7,26,23,1710,1676,2114,438
2018,7,27,0,1720,1624,1781,157
2018,7,27,1,1705,1615,1453,-162
2018,7,27,2,1675,1581,1389,-192
2018,7,27,3,1600,1533,1400,-133
2018,7,27,4,1570,1493,1424,-69
2018,7,27,5,1485,1427,1379,-48
2018,7,27,6,1350,1338,1395,57
2018,7,27,7,1280,1275,1366,91
2018,7,27,8,1245,1216,1158,-58
2018,7,27,9,1205,1196,1129,-67
2018,7,27,10,1190,1202,1093,-109
2018,7,27,11,1200,1213,1134,-79
2018,7,27,12,1215,1240,1266,26
2018,7,27,13,1255,1291,1291,0
2018,7,27,14,1315,1370,1374,4
2018,7,27,15,1365,1387,1541,154
2018,7,27,16,1425,1419,1648,229
2018,7,27,17,1470,1471,1676,205
2018,7,27,18,1515,1487,1687,200
2018,7,27,19,1545,1509,1706,197
2018,7,27,20,1585,1541,1745,204
2018,7,27,21,1610,1548,1760,212
2018,7,27,22,1625,1558,1764,206
2018,7,27,23,1675,1530,1533,3
2018,7,28,0,1680,1518,1374,-144
2018,7,28,1,1680,1500,1373,-127
2018,7,28,2,1660,1468,1392,-76
2018,7,28,3,1605,1450,1369,-81
2018,7,28,4,1555,1417,1343,-74
2018,7,28,5,1460,1328,1307,-21
2018,7,28,6,1345,1285,1362,77
2018,7,28,7,1290,1224,1257,33
2018,7,28,8,1235,1196,1230,34
2018,7,28,9,1205,1176,1255,79
2018,7,28,10,1175,1161,1244,83
2018,7,28,11,1180,1161,1264,103
2018,7,28,12,1180,1165,1265,100
2018,7,28,13,1170,1175,1270,95
2018,7,28,14,1230,1219,1266,47
2018,7,28,15,1290,1284,1240,-44
2018,7,28,16,1350,1297,1234,-63
2018,7,28,17,1390,1318,1239,-79
2018,7,28,18,1420,1345,1291,-54
2018,7,28,19,1445,1377,1313,-64
2018,7,28,20,1470,1390,1329,-61
2018,7,28,21,1485,1417,1338,-79
2018,7,28,22,1530,1450,1353,-97
2018,7,28,23,1565,1468,1397,-71
2018,7,29,0,1590,1294,1384,90
2018,7,29,1,1595,1617,1347,-270
2018,7,29,2,1565,1414,1344,-70
2018,7,29,3,1515,1393,1387,-6
2018,7,29,4,1485,1383,1335,-48
2018,7,29,5,1405,1320,1329,9
2018,7,29,6,1320,1239,1326,87
2018,7,29,7,1255,1191,1180,-11
2018,7,29,8,1200,1141,1152,11
2018,7,29,9,1175,1123,1096,-27
2018,7,29,10,1145,1119,1059,-60
2018,7,29,11,1150,1118,1197,79
2018,7,29,12,1150,1107,1201,94
2018,7,29,13,1155,1107,1193,86
2018,7,29,14,1220,1152,1210,58
2018,7,29,15,1275,1208,1224,16
2018,7,29,16,1330,1245,1219,-26
2018,7,29,17,1370,1288,1261,-27
2018,7,29,18,1410,1328,1288,-40
2018,7,29,19,1430,1342,1309,-33
2018,7,29,20,1460,1383,1329,-54
2018,7,29,21,1485,1421,1356,-65
2018,7,29,22,1535,1449,1366,-83
2018,7,29,23,1570,1492,1376,-116
2018,7,30,0,1605,1526,1375,-151
2018,7,30,1,1615,1526,1371,-155
2018,7,30,2,1585,1509,1381,-128
2018,7,30,3,1540,1467,1352,-115
2018,7,30,4,1500,1441,1333,-108
2018,7,30,5,1420,1339,1320,-19
2018,7,30,6,1325,1233,1299,66
2018,7,30,7,1235,1171,1296,125
2018,7,30,8,1180,1130,1270,140
2018,7,30,9,1155,1119,1272,153
2018,7,30,10,1130,1108,1267,159
2018,7,30,11,1130,1130,1274,144
2018,7,30,12,1160,1166,1289,123
2018,7,30,13,1250,1215,1280,65
2018,7,30,14,1355,1302,1286,-16
2018,7,30,15,1400,1360,1292,-68
2018,7,30,16,1450,1400,1280,-120
2018,7,30,17,1500,1448,1276,-172
2018,7,30,18,1545,1489,1282,-207
2018,7,30,19,1575,1522,1276,-246
2018,7,30,20,1605,1574,1280,-294
2018,7,30,21,1645,1618,1305,-313
2018,7,30,22,1670,1649,1345,-304
2018,7,30,23,1710,1688,1322,-366
2018,7,31,0,1715,1697,1308,-389
2018,7,31,1,1720,1703,1320,-383
2018,7,31,2,1700,1667,1313,-354
2018,7,31,3,1645,1594,1295,-299
2018,7,31,4,1595,1544,1298,-246
2018,7,31,5,1480,1425,1283,-142
2018,7,31,6,1360,1295,1166,-129
2018,7,31,7,1265,1265,1166,-9999
2018,7,31,8,1210,1210,1270,-9999
2018,7,31,9,1180,1180,1272,-9999
2018,7,31,10,1160,1160,1267,-9999
2018,7,31,11,1170,1170,1274,-9999
2018,7,31,12,1200,1200,1289,-9999
2018,7,31,13,1280,1280,1280,-9999
2018,7,31,14,1380,1380,1286,-9999
2018,7,31,15,1440,1440,1292,-9999
2018,7,31,16,1490,1490,1280,-9999
2018,7,31,17,1530,1530,1276,-9999
2018,7,31,18,1570,1570,1282,-9999
2018,7,31,19,1595,1595,1276,-9999
2018,7,31,20,1630,1630,1280,-9999
2018,7,31,21,1655,1655,1305,-9999
2018,7,31,22,1685,1685,1345,-9999
2018,7,31,23,1710,1710,1322,-9999
2018,8,1,0,1690,1690,1308,-9999
2018,8,1,1,1675,1675,1320,-9999
2018,8,1,2,1650,1650,1313,-9999
2018,8,1,3,1605,1605,1295,-9999
2018,8,1,4,1575,1575,1298,-9999
2018,8,1,5,1470,1470,1283,-9999
2018,8,1,6,1350,1350,1166,-9999
2018,8,1,7,1265,1277,1284,7
2018,8,1,8,1230,1222,1300,78
2018,8,1,9,1200,1190,1268,78
2018,8,1,10,1180,1164,1246,82
2018,8,1,11,1195,1175,1355,180
2018,8,1,12,1220,1217,1495,278
2018,8,1,13,1275,1285,1563,278
2018,8,1,14,1360,1354,1648,294
2018,8,1,15,1400,1422,1653,231
2018,8,1,16,1455,1460,1705,245
2018,8,1,17,1505,1510,1698,188
2018,8,1,18,1545,1565,1706,141
2018,8,1,19,1580,1616,1712,96
2018,8,1,20,1615,1669,1762,93
2018,8,1,21,1650,1723,1777,54
2018,8,1,22,1680,1755,1884,129
2018,8,1,23,1720,1770,1965,195
2018,8,2,0,1725,1760,1963,203
2018,8,2,1,1720,1754,1928,174
2018,8,2,2,1695,1720,1925,205
2018,8,2,3,1630,1660,1905,245
2018,8,2,4,1590,1616,1824,208
2018,8,2,5,1470,1498,1793,295
2018,8,2,6,1340,1363,1747,384
2018,8,2,7,1245,1301,1730,429
2018,8,2,8,1190,1252,1688,436
2018,8,2,9,1175,1209,1714,505
2018,8,2,10,1160,1205,1694,489
2018,8,2,11,1175,1211,1671,460
2018,8,2,12,1210,1240,1974,734
2018,8,2,13,1270,1300,1960,660
2018,8,2,14,1360,1374,2085,711
2018,8,2,15,1415,1450,2082,632
2018,8,2,16,1460,1502,2051,549
2018,8,2,17,1500,1558,2078,520
2018,8,2,18,1545,1604,2081,477
2018,8,2,19,1570,1646,2067,421
2018,8,2,20,1615,1675,2063,388
2018,8,2,21,1660,1715,2091,376
2018,8,2,22,1680,1740,2049,309
2018,8,2,23,1715,1760,1903,143
2018,8,3,0,1700,1758,1732,-26
2018,8,3,1,1700,1722,1735,13
2018,8,3,2,1665,1660,1665,5
2018,8,3,3,1595,1627,1623,-4
2018,8,3,4,1555,1569,1490,-79
2018,8,3,5,1460,1466,1555,89
2018,8,3,6,1345,1336,1603,267
2018,8,3,7,1230,1254,1699,445
2018,8,3,8,1175,1189,1696,507
2018,8,3,9,1145,1161,1648,487
2018,8,3,10,1135,1148,1644,496
2018,8,3,11,1145,1162,1543,381
2018,8,3,12,1175,1204,1990,786
2018,8,3,13,1280,1263,2075,812
2018,8,3,14,1405,1324,2139,815
2018,8,3,15,1450,1398,2232,834
2018,8,3,16,1490,1442,2245,803
2018,8,3,17,1540,1496,2306,810
2018,8,3,18,1580,1551,2291,740
2018,8,3,19,1620,1573,2281,708
2018,8,3,20,1665,1609,2311,702
2018,8,3,21,1695,1637,2310,673
2018,8,3,22,1715,1620,2286,666
2018,8,3,23,1720,1597,2226,629
2018,8,4,0,1710,1539,2162,623
2018,8,4,1,1700,1515,2086,571
2018,8,4,2,1665,1515,2021,506
2018,8,4,3,1625,1469,1610,141
2018,8,4,4,1575,1441,1417,-24
2018,8,4,5,1480,1316,1388,72
2018,8,4,6,1380,1221,1420,199
2018,8,4,7,1230,1166,1451,285
2018,8,4,8,1185,1135,1444,309
2018,8,4,9,1165,1107,1477,370
2018,8,4,10,1155,1091,1313,222
2018,8,4,11,1160,1096,1343,247
2018,8,4,12,1175,1114,1609,495
2018,8,4,13,1225,1168,1773,605
2018,8,4,14,1315,1225,1832,607
2018,8,4,15,1360,1279,1881,602
2018,8,4,16,1390,1333,1873,540
2018,8,4,17,1425,1331,1900,569
2018,8,4,18,1450,1344,1911,567
2018,8,4,19,1480,1414,1964,550
2018,8,4,20,1500,1433,2057,624
2018,8,4,21,1515,1445,2007,562
2018,8,4,22,1545,1461,2024,563
2018,8,4,23,1550,1498,2011,513
2018,8,5,0,1470,1513,2019,506
2018,8,5,1,1610,1512,2029,517
2018,8,5,2,1500,1486,2029,543
2018,8,5,3,1475,1447,1747,300
2018,8,5,4,1465,1413,1589,176
2018,8,5,5,1370,1355,1603,248
2018,8,5,6,1305,1263,1506,243
2018,8,5,7,1230,1206,1491,285
2018,8,5,8,1185,1161,1392,231
2018,8,5,9,1165,1146,1376,230
2018,8,5,10,1155,1166,1401,235
2018,8,5,11,1155,1123,1434,311
2018,8,5,12,1150,1142,1706,564
2018,8,5,13,1140,1146,1765,619
2018,8,5,14,1175,1189,1776,587
2018,8,5,15,1235,1234,1816,582
2018,8,5,16,1265,1282,1844,562
2018,8,5,17,1300,1309,1877,568
2018,8,5,18,1335,1355,1903,548
2018,8,5,19,1355,1368,1908,540
2018,8,5,20,1385,1391,1916,525
2018,8,5,21,1415,1418,1973,555
2018,8,5,22,1450,1439,2032,593
2018,8,5,23,1480,1453,2038,585
2018,8,6,0,1435,1466,2103,637
2018,8,6,1,1560,1436,1844,408
2018,8,6,2,1470,1392,1575,183
2018,8,6,3,1440,1380,1520,140
2018,8,6,4,1410,1383,1482,99
2018,8,6,5,1335,1308,1468,160
2018,8,6,6,1240,1223,1471,248
2018,8,6,7,1195,1132,1559,427
2018,8,6,8,1145,1100,1460,360
2018,8,6,9,1125,1076,1433,357
2018,8,6,10,1105,1087,1485,398
2018,8,6,11,1120,1116,2160,1044
2018,8,6,12,1155,1177,2388,1211
2018,8,6,13,1220,1245,2474,1229
2018,8,6,14,1310,1337,2572,1235
2018,8,6,15,1370,1378,2621,1243
2018,8,6,16,1405,1417,2647,1230
2018,8,6,17,1455,1449,2678,1229
2018,8,6,18,1500,1485,2691,1206
2018,8,6,19,1540,1501,2648,1147
2018,8,6,20,1590,1539,2716,1177
2018,8,6,21,1635,1556,2715,1159
2018,8,6,22,1670,1611,2788,1177
2018,8,6,23,1695,1607,2812,1205
2018,8,7,0,1695,1631,2836,1205
2018,8,7,1,1700,1613,2472,859
2018,8,7,2,1665,1568,1863,295
2018,8,7,3,1605,1518,1707,189
2018,8,7,4,1555,1476,1740,264
2018,8,7,5,1440,1373,1747,374
2018,8,7,6,1310,1268,1638,370
2018,8,7,7,1220,1197,1620,423
2018,8,7,8,1180,1156,1674,518
2018,8,7,9,1145,1136,1688,552
2018,8,7,10,1135,1132,1627,495
2018,8,7,11,1145,1146,1856,710
2018,8,7,12,1170,1182,2078,896
2018,8,7,13,1240,1234,2103,869
2018,8,7,14,1325,1331,2192,861
2018,8,7,15,1395,1369,2160,791
2018,8,7,16,1440,1421,2176,755
2018,8,7,17,1490,1453,2125,672
2018,8,7,18,1530,1502,2221,719
2018,8,7,19,1570,1526,2153,627
2018,8,7,20,1615,1579,2275,696
2018,8,7,21,1660,1623,2308,685
2018,8,7,22,1690,1654,2294,640
2018,8,7,23,1710,1686,2282,596
2018,8,8,0,1705,1693,2229,536
2018,8,8,1,1680,1677,1806,129
2018,8,8,2,1635,1667,1360,-307
2018,8,8,3,1605,1599,1316,-283
2018,8,8,4,1580,1564,1431,-133
2018,8,8,5,1460,1431,1370,-61
2018,8,8,6,1340,1318,1317,-1
2018,8,8,7,1220,1248,1320,72
2018,8,8,8,1180,1204,1484,280
2018,8,8,9,1145,1174,1491,317
2018,8,8,10,1135,1159,1485,326
2018,8,8,11,1150,1174,1764,590
2018,8,8,12,1190,1216,1869,653
2018,8,8,13,1280,1281,1905,624
2018,8,8,14,1385,1356,1911,555
2018,8,8,15,1435,1415,1921,506
2018,8,8,16,1480,1454,1935,481
2018,8,8,17,1525,1501,1940,439
2018,8,8,18,1570,1539,1974,435
2018,8,8,19,1605,1587,1994,407
2018,8,8,20,1650,1641,2000,359
2018,8,8,21,1685,1694,1993,299
2018,8,8,22,1725,1749,1739,-10
2018,8,8,23,1735,1776,1531,-245
2018,8,9,0,1745,1767,1523,-244
2018,8,9,1,1740,1768,1534,-234
2018,8,9,2,1710,1722,1513,-209
2018,8,9,3,1650,1676,1507,-169
2018,8,9,4,1610,1620,1512,-108
2018,8,9,5,1490,1494,1512,18
2018,8,9,6,1370,1366,1511,145
2018,8,9,7,1270,1288,1507,219
2018,8,9,8,1225,1223,1500,277
2018,8,9,9,1185,1187,1490,303
2018,8,9,10,1180,1168,1504,336
2018,8,9,11,1190,1170,1506,336
2018,8,9,12,1215,1225,1756,531
2018,8,9,13,1295,1286,1934,648
2018,8,9,14,1395,1358,1978,620
2018,8,9,15,1460,1417,1996,579
2018,8,9,16,1510,1457,1981,524
2018,8,9,17,1560,1514,2002,488
2018,8,9,18,1605,1567,1988,421
2018,8,9,19,1640,1619,1980,361
2018,8,9,20,1680,1685,1976,291
2018,8,9,21,1720,1735,1968,233
2018,8,9,22,1745,1785,1994,209
2018,8,9,23,1775,1841,2013,172
2018,8,10,0,1770,1849,2014,165
2018,8,10,1,1750,1826,1758,-68
2018,8,10,2,1710,1777,1618,-159
2018,8,10,3,1660,1693,1553,-140
2018,8,10,4,1605,1650,1581,-69
2018,8,10,5,1500,1494,1535,41
2018,8,10,6,1375,1382,1540,158
2018,8,10,7,1255,1294,1503,209
2018,8,10,8,1190,1259,1522,263
2018,8,10,9,1160,1224,1514,290
2018,8,10,10,1150,1203,1480,277
2018,8,10,11,1165,1192,1722,530
2018,8,10,12,1200,1230,1922,692
2018,8,10,13,1315,1280,1977,697
2018,8,10,14,1440,1351,1996,645
2018,8,10,15,1500,1410,2012,602
2018,8,10,16,1550,1488,2026,538
2018,8,10,17,1605,1530,2014,484
2018,8,10,18,1650,1610,2011,401
2018,8,10,19,1690,1658,1995,337
2018,8,10,20,1730,1740,1990,250
2018,8,10,21,1770,1785,1946,161
2018,8,10,22,1785,1834,1926,92
2018,8,10,23,1785,1854,1907,53
2018,8,11,0,1750,1856,1945,89
2018,8,11,1,1735,1819,1743,-76
2018,8,11,2,1710,1754,1546,-208
2018,8,11,3,1675,1715,1564,-151
2018,8,11,4,1645,1631,1554,-77
2018,8,11,5,1500,1525,1517,-8
2018,8,11,6,1390,1407,1535,128
2018,8,11,7,1310,1320,1529,209
2018,8,11,8,1270,1257,1492,235
2018,8,11,9,1240,1216,1474,258
2018,8,11,10,1215,1182,1437,255
2018,8,11,11,1215,1180,1550,370
2018,8,11,12,1225,1182,1547,365
2018,8,11,13,1240,1189,1543,354
2018,8,11,14,1295,1227,1501,274
2018,8,11,15,1360,1285,1499,214
2018,8,11,16,1410,1359,1495,136
2018,8,11,17,1430,1467,1535,68
2018,8,11,18,1460,1530,1534,4
2018,8,11,19,1500,1558,1385,-173
2018,8,11,20,1525,1610,1402,-208
2018,8,11,21,1540,1684,1299,-385
2018,8,11,22,1580,1756,1296,-460
2018,8,11,23,1620,1774,1322,-452
2018,8,12,0,1610,1791,1329,-462
2018,8,12,1,1665,1778,1348,-430
2018,8,12,2,1605,1724,1287,-437
2018,8,12,3,1555,1679,1298,-381
2018,8,12,4,1520,1650,1454,-196
2018,8,12,5,1450,1500,1531,31
2018,8,12,6,1365,1387,1507,120
2018,8,12,7,1255,1345,1506,161
2018,8,12,8,1195,1291,1476,185
2018,8,12,9,1170,1250,1292,42
2018,8,12,10,1165,1225,1215,-10
2018,8,12,11,1150,1209,1147,-62
2018,8,12,12,1150,1216,1138,-78
2018,8,12,13,1175,1221,1173,-48
2018,8,12,14,1260,1246,1152,-94
2018,8,12,15,1315,1320,1168,-152
2018,8,12,16,1365,1387,1219,-168
2018,8,12,17,1400,1450,1328,-122
2018,8,12,18,1445,1520,1463,-57
2018,8,12,19,1465,1555,1509,-46
2018,8,12,20,1490,1605,1549,-56
2018,8,12,21,1525,1642,1529,-113
2018,8,12,22,1560,1664,1529,-135
2018,8,12,23,1585,1686,1478,-208
2018,8,13,0,1615,1684,1447,-237
2018,8,13,1,1610,1665,1468,-197
2018,8,13,2,1580,1641,1478,-163
2018,8,13,3,1555,1604,1550,-54
2018,8,13,4,1510,1576,1559,-17
2018,8,13,5,1445,1446,1524,78
2018,8,13,6,1345,1342,1393,51
2018,8,13,7,1195,1280,1318,38
2018,8,13,8,1160,1207,1290,83
2018,8,13,9,1135,1196,1254,58
2018,8,13,10,1130,1180,1269,89
2018,8,13,11,1145,1185,1535,350
2018,8,13,12,1190,1227,1728,501
2018,8,13,13,1260,1294,1702,408
2018,8,13,14,1350,1350,1700,350
2018,8,13,15,1400,1404,1644,240
2018,8,13,16,1440,1428,1625,197
2018,8,13,17,1485,1470,1635,165
2018,8,13,18,1520,1499,1663,164
2018,8,13,19,1555,1513,1694,181
2018,8,13,20,1600,1562,1661,99
2018,8,13,21,1635,1574,1610,36
2018,8,13,22,1690,1602,1554,-48
2018,8,13,23,1705,1608,1510,-98
2018,8,14,0,1715,1595,1496,-99
2018,8,14,1,1715,1565,1305,-260
2018,8,14,2,1675,1525,1270,-255
2018,8,14,3,1625,1498,1296,-202
2018,8,14,4,1585,1443,1306,-137
2018,8,14,5,1455,1353,1277,-76
2018,8,14,6,1335,1261,1236,-25
2018,8,14,7,1200,1234,1182,-52
2018,8,14,8,1160,1197,1167,-30
2018,8,14,9,1140,1156,1211,55
2018,8,14,10,1130,1126,1294,168
2018,8,14,11,1145,1141,1664,523
2018,8,14,12,1165,1181,1777,596
2018,8,14,13,1220,1261,1964,703
2018,8,14,14,1305,1340,2081,741
2018,8,14,15,1360,1388,2218,830
2018,8,14,16,1405,1423,2268,845
2018,8,14,17,1445,1446,2341,895
2018,8,14,18,1485,1211,2073,862
2018,8,14,19,1525,1508,2341,833
2018,8,14,20,1570,1551,2321,770
2018,8,14,21,1620,1566,2325,759
2018,8,14,22,1655,1570,2290,720
2018,8,14,23,1675,1598,2290,692
2018,8,15,0,1675,1597,2275,678
2018,8,15,1,1655,1570,1676,106
2018,8,15,2,1630,1520,1389,-131
2018,8,15,3,1585,1486,1413,-73
2018,8,15,4,1545,1452,1426,-26
2018,8,15,5,1430,1349,1420,71
2018,8,15,6,1320,1247,1377,130
2018,8,15,7,1235,1180,1360,180
2018,8,15,8,1180,1154,1335,181
2018,8,15,9,1155,1136,1291,155
2018,8,15,10,1135,1115,1295,180
2018,8,15,11,1140,1143,1801,658
2018,8,15,12,1185,1201,2204,1003
2018,8,15,13,1285,1266,2204,938
2018,8,15,14,1390,1329,2265,936
2018,8,15,15,1450,1362,2273,911
2018,8,15,16,1485,1060,1910,850
2018,8,15,17,1530,792,1642,850
2018,8,15,18,1565,1283,2110,827
2018,8,15,19,1605,1503,2322,819
2018,8,15,20,1660,1574,2364,790
2018,8,15,21,1700,1614,2359,745
2018,8,15,22,1750,1652,2384,732
2018,8,15,23,1765,1684,2355,671
2018,8,16,0,1755,1700,2364,664
2018,8,16,1,1745,1675,1866,191
2018,8,16,2,1700,1603,1388,-215
2018,8,16,3,1660,1561,1386,-175
2018,8,16,4,1595,1527,1412,-115
2018,8,16,5,1485,1395,1389,-6
2018,8,16,6,1365,1298,1476,178
2018,8,16,7,1230,1211,1549,338
2018,8,16,8,1185,1161,1582,421
2018,8,16,9,1140,1144,1622,478
2018,8,16,10,1125,1132,1630,498
2018,8,16,11,1130,1153,2051,898
2018,8,16,12,1165,1219,2507,1288
2018,8,16,13,1255,1294,2541,1247
2018,8,16,14,1360,1339,2552,1213
2018,8,16,15,1425,1374,2534,1160
2018,8,16,16,1470,1424,2527,1103
2018,8,16,17,1515,1472,2525,1053
2018,8,16,18,1560,1512,2547,1035
2018,8,16,19,1600,1533,2541,1008
2018,8,16,20,1640,1594,2540,946
2018,8,16,21,1675,1648,2545,897
2018,8,16,22,1695,1681,2585,904
2018,8,16,23,1725,1708,2620,912
2018,8,17,0,1730,1713,2644,931
2018,8,17,1,1700,1662,2126,464
2018,8,17,2,1650,1601,1702,101
2018,8,17,3,1610,1562,1649,87
2018,8,17,4,1360,1525,1644,119
2018,8,17,5,1445,1426,1583,157
2018,8,17,6,1325,1319,1637,318
2018,8,17,7,1205,1247,1629,382
2018,8,17,8,1170,1192,1611,419
2018,8,17,9,1145,1166,1609,443
2018,8,17,10,1125,1155,1623,468
2018,8,17,11,1130,1175,2067,892
2018,8,17,12,1175,1218,2522,1304
2018,8,17,13,1235,1288,2585,1297
2018,8,17,14,1300,1356,2535,1179
2018,8,17,15,1345,1402,2567,1165
2018,8,17,16,1395,1443,2575,1132
2018,8,17,17,1435,1499,2586,1087
2018,8,17,18,1475,1545,2596,1051
2018,8,17,19,1520,1576,2555,979
2018,8,17,20,1590,1632,2596,964
2018,8,17,21,1630,1666,2593,927
2018,8,17,22,1660,1705,2655,950
2018,8,17,23,1680,1713,2656,943
2018,8,18,0,1680,1691,2652,961
2018,8,18,1,1660,1634,2319,685
2018,8,18,2,1605,1555,1848,293
2018,8,18,3,1570,1527,1562,35
2018,8,18,4,1530,1511,1490,-21
2018,8,18,5,1400,1443,1464,21
2018,8,18,6,1295,1362,1518,156
2018,8,18,7,1210,1284,1492,208
2018,8,18,8,1165,1237,1513,276
2018,8,18,9,1140,1199,1501,302
2018,8,18,10,1130,1184,1525,341
2018,8,18,11,1120,1177,1533,356
2018,8,18,12,1130,1183,1591,408
2018,8,18,13,1130,1232,1518,286
2018,8,18,14,1150,1272,1494,222
2018,8,18,15,1205,1326,1450,124
2018,8,18,16,1260,1349,1450,101
2018,8,18,17,1290,1373,1459,86
2018,8,18,18,1320,1394,1509,115
2018,8,18,19,1365,1386,1543,157
2018,8,18,20,1395,1403,1558,155
2018,8,18,21,1425,1412,1563,151
2018,8,18,22,1450,1422,1580,158
2018,8,18,23,1475,1425,1558,133
2018,8,19,0,1490,1428,1553,125
2018,8,19,1,1480,1415,1574,159
2018,8,19,2,1445,1395,1561,166
2018,8,19,3,1415,1390,1514,124
2018,8,19,4,1385,1355,1544,189
2018,8,19,5,1315,1295,1552,257
2018,8,19,6,1225,1225,1543,318
2018,8,19,7,1195,1150,1449,299
2018,8,19,8,1150,1109,1284,175
2018,8,19,9,1130,1092,1251,159
2018,8,19,10,1135,1081,1218,137
2018,8,19,11,1115,1081,1220,139
2018,8,19,12,1120,1094,1328,234
2018,8,19,13,1130,1106,1331,225
2018,8,19,14,1170,1151,1366,215
2018,8,19,15,1220,1189,1355,166
2018,8,19,16,1265,1241,1361,120
2018,8,19,17,1290,1255,1358,103
2018,8,19,18,1320,1291,1368,77
2018,8,19,19,1350,1304,1376,72
2018,8,19,20,1380,1333,1402,69
2018,8,19,21,1405,1352,1432,80
2018,8,19,22,1425,1384,1460,76
2018,8,19,23,1455,1400,1471,71
2018,8,20,0,1470,1435,1505,70
2018,8,20,1,1460,1431,1482,51
2018,8,20,2,1430,1426,1497,71
2018,8,20,3,1405,1423,1463,40
2018,8,20,4,1395,1385,1491,106
2018,8,20,5,1315,1312,1468,156
2018,8,20,6,1225,1215,1445,230
2018,8,20,7,1230,1148,1406,258
2018,8,20,8,1185,1130,1388,258
2018,8,20,9,1170,1115,1400,285
2018,8,20,10,1165,1098,1415,317
2018,8,20,11,1175,1116,1555,439
2018,8,20,12,1220,1142,1585,443
2018,8,20,13,1250,1231,1679,448
2018,8,20,14,1285,1297,1641,344
2018,8,20,15,1325,1337,1660,323
2018,8,20,16,1360,1355,1633,278
2018,8,20,17,1395,1381,1593,212
2018,8,20,18,1420,1366,1601,235
2018,8,20,19,1445,1371,1627,256
2018,8,20,20,1490,1413,1640,227
2018,8,20,21,1510,1391,1646,255
2018,8,20,22,1550,1376,1651,275
2018,8,20,23,1550,1387,1657,270
2018,8,21,0,1560,1388,1655,267
2018,8,21,1,1545,1371,1476,105
2018,8,21,2,1510,1364,1445,81
2018,8,21,3,1470,1365,1412,47
2018,8,21,4,1415,1321,1387,66
2018,8,21,5,1325,1228,1387,159
2018,8,21,6,1230,1161,1406,245
2018,8,21,7,1185,1114,1394,280
2018,8,21,8,1145,1091,1409,318
2018,8,21,9,1120,1081,1397,316
2018,8,21,10,1100,1060,1407,347
2018,8,21,11,1110,1090,1593,503
2018,8,21,12,1140,1135,1870,735
2018,8,21,13,1180,1206,1988,782
2018,8,21,14,1230,1285,2058,773
2018,8,21,15,1270,1331,2289,958
2018,8,21,16,1305,1363,2415,1052
2018,8,21,17,1330,1379,2444,1065
2018,8,21,18,1370,1368,2504,1136
2018,8,21,19,1395,1368,2477,1109
2018,8,21,20,1440,1375,2485,1110
2018,8,21,21,1465,1356,2478,1122
2018,8,21,22,1480,1351,2478,1127
2018,8,21,23,1505,1349,2475,1126
2018,8,22,0,1510,1350,2455,1105
2018,8,22,1,1495,1322,2094,772
2018,8,22,2,1470,1291,1627,336
2018,8,22,3,1425,1309,1590,281
2018,8,22,4,1385,1292,1600,308
2018,8,22,5,1285,1210,1599,389
2018,8,22,6,1190,1152,1602,450
2018,8,22,7,1160,1103,1609,506
2018,8,22,8,1125,1067,1606,539
2018,8,22,9,1110,1052,1605,553
2018,8,22,10,1090,1055,1609,554
2018,8,22,11,1105,1075,1965,890
2018,8,22,12,1145,1157,2429,1272
2018,8,22,13,1245,1231,2470,1239
2018,8,22,14,1330,1297,2473,1176
2018,8,22,15,1370,1314,2484,1170
2018,8,22,16,1400,1342,2560,1218
2018,8,22,17,1430,1372,2543,1171
2018,8,22,18,1440,1327,2554,1227
2018,8,22,19,1465,1367,2562,1195
2018,8,22,20,1525,1391,2561,1170
2018,8,22,21,1535,1412,2570,1158
2018,8,22,22,1550,1429,2496,1067
2018,8,22,23,1565,1432,2500,1068
2018,8,23,0,1570,1442,2511,1069
2018,8,23,1,1555,1415,2157,742
2018,8,23,2,1515,1378,1685,307
2018,8,23,3,1495,1373,1579,206
2018,8,23,4,1455,1340,1586,246
2018,8,23,5,1340,1250,1600,350
2018,8,23,6,1255,1173,1686,513
2018,8,23,7,1140,1122,1686,564
2018,8,23,8,1105,1086,1668,582
2018,8,23,9,1090,1072,1636,564
2018,8,23,10,1070,1056,1614,558
2018,8,23,11,1090,1095,2044,949
2018,8,23,12,1135,1154,2408,1254
2018,8,23,13,1225,1251,2487,1236
2018,8,23,14,1305,1306,2513,1207
2018,8,23,15,1345,1326,2535,1209
2018,8,23,16,1380,1358,2550,1192
2018,8,23,17,1415,1390,2559,1169
2018,8,23,18,1425,1395,2593,1198
2018,8,23,19,1440,1399,2572,1173
2018,8,23,20,1470,1440,2571,1131
2018,8,23,21,1485,1454,2581,1127
2018,8,23,22,1500,1460,2607,1147
2018,8,23,23,1510,1483,2611,1128
2018,8,24,0,1515,1474,2610,1136
2018,8,24,1,1485,1429,2109,680
2018,8,24,2,1450,1397,1695,298
2018,8,24,3,1440,1390,1685,295
2018,8,24,4,1400,1356,1694,338
2018,8,24,5,1320,1259,1662,403
2018,8,24,6,1235,1184,1597,413
2018,8,24,7,1090,1117,1547,430
2018,8,24,8,1050,1077,1416,339
2018,8,24,9,1035,1060,1400,340
2018,8,24,10,1030,1051,1408,357
2018,8,24,11,1040,1090,1825,735
2018,8,24,12,1095,1133,2296,1163
2018,8,24,13,1175,1223,2364,1141
2018,8,24,14,1250,1268,2391,1123
2018,8,24,15,1275,1303,2431,1128
2018,8,24,16,1305,1331,2424,1093
2018,8,24,17,1340,1352,2517,1165
2018,8,24,18,1325,1380,2573,1193
2018,8,24,19,1355,1397,2580,1183
2018,8,24,20,1385,1421,2549,1128
2018,8,24,21,1405,1441,2495,1054
2018,8,24,22,1420,1464,2501,1037
2018,8,24,23,1425,1485,2474,989
2018,8,25,0,1425,1460,2441,981
2018,8,25,1,1405,1398,2107,709
2018,8,25,2,1370,1342,1599,257
2018,8,25,3,1365,1348,1426,78
2018,8,25,4,1320,1324,1397,73
2018,8,25,5,1250,1246,1454,208
2018,8,25,6,1175,1165,1438,273
2018,8,25,7,1155,1105,1444,339
2018,8,25,8,1110,1085,1441,356
2018,8,25,9,1085,1061,1437,376
2018,8,25,10,1070,1049,1424,375
2018,8,25,11,1070,1052,1626,574
2018,8,25,12,1080,1076,1834,758
2018,8,25,13,1100,1102,1823,721
2018,8,25,14,1135,1140,1786,646
2018,8,25,15,1175,1185,1777,592
2018,8,25,16,1220,1232,1789,557
2018,8,25,17,1245,1234,1779,545
2018,8,25,18,1280,1248,1787,539
2018,8,25,19,1290,1250,1766,516
2018,8,25,20,1315,1270,1793,523
2018,8,25,21,1340,1273,1794,521
2018,8,25,22,1365,1294,1793,499
2018,8,25,23,1380,1312,1795,483
2018,8,26,0,1400,1328,1799,471
2018,8,26,1,1390,1304,1582,278
2018,8,26,2,1380,1278,1375,97
2018,8,26,3,1370,1291,1389,98
2018,8,26,4,1335,1264,1409,145
2018,8,26,5,1260,1205,1370,165
2018,8,26,6,1175,1138,1337,199
2018,8,26,7,1150,1083,1344,261
2018,8,26,8,1110,1060,1157,97
2018,8,26,9,1085,1053,1133,80
2018,8,26,10,1070,1038,1174,136
2018,8,26,11,1065,1052,1406,354
2018,8,26,12,1075,1060,1780,720
2018,8,26,13,1105,1093,1841,748
2018,8,26,14,1150,1127,1866,739
2018,8,26,15,1190,1182,1866,684
2018,8,26,16,1230,1226,1862,636
2018,8,26,17,1255,1247,1909,662
2018,8,26,18,1290,1264,1775,511
2018,8,26,19,1295,1276,1812,536
2018,8,26,20,1320,1271,1795,524
2018,8,26,21,1340,1277,1779,502
2018,8,26,22,1360,1286,1922,636
2018,8,26,23,1375,1311,1896,585
2018,8,27,0,1390,1335,1873,538
2018,8,27,1,1380,1334,1689,355
2018,8,27,2,1370,1318,1480,162
2018,8,27,3,1360,1325,1439,114
2018,8,27,4,1320,1309,1435,126
2018,8,27,5,1255,1230,1417,187
2018,8,27,6,1170,1157,1416,259
2018,8,27,7,1130,1100,1524,424
2018,8,27,8,1100,1044,1611,567
2018,8,27,9,1085,1034,1804,770
2018,8,27,10,1075,1042,2004,962
2018,8,27,11,1085,1081,2258,1177
2018,8,27,12,1130,1155,2512,1357
2018,8,27,13,1210,1250,2547,1297
2018,8,27,14,1275,1325,2581,1256
2018,8,27,15,1305,1352,2588,1236
2018,8,27,16,1330,1365,2572,1207
2018,8,27,17,1360,1377,2611,1234
2018,8,27,18,1340,1389,2635,1246
2018,8,27,19,1360,1378,2637,1259
2018,8,27,20,1390,1366,2642,1276
2018,8,27,21,1390,1363,2635,1272
2018,8,27,22,1395,1369,2669,1300
2018,8,27,23,1400,1349,2671,1322
2018,8,28,0,1400,1337,2672,1335
2018,8,28,1,1385,1302,2252,950
2018,8,28,2,1365,1268,1755,487
2018,8,28,3,1360,1277,1695,418
2018,8,28,4,1320,1234,1668,434
2018,8,28,5,1230,1156,1650,494
2018,8,28,6,1160,1083,1639,556
2018,8,28,7,1070,1045,1630,585
2018,8,28,8,1040,1027,1594,567
2018,8,28,9,1025,1015,1574,559
2018,8,28,10,1005,1024,1771,747
2018,8,28,11,1030,1047,2064,1017
2018,8,28,12,1070,1098,2288,1190
2018,8,28,13,1165,1202,2375,1173
2018,8,28,14,1250,1286,2436,1150
2018,8,28,15,1280,1289,2448,1159
2018,8,28,16,1310,1287,2470,1183
2018,8,28,17,1330,1296,2487,1191
2018,8,28,18,1330,1302,2477,1175
2018,8,28,19,1340,1303,2541,1238
2018,8,28,20,1360,1320,2567,1247
2018,8,28,21,1360,1309,2572,1263
2018,8,28,22,1360,1329,2568,1239
2018,8,28,23,1370,1330,2560,1230
2018,8,29,0,1370,1311,2457,1146
2018,8,29,1,1345,1288,2109,821
2018,8,29,2,1320,1272,1636,364
2018,8,29,3,1325,1296,1556,260
2018,8,29,4,1300,1271,1572,301
2018,8,29,5,1210,1182,1584,402
2018,8,29,6,1140,1105,1655,550
2018,8,29,7,1075,1064,1614,550
2018,8,29,8,1030,1024,1566,542
2018,8,29,9,1015,1014,1567,553
2018,8,29,10,1015,1018,1731,713
2018,8,29,11,1035,1039,2057,1018
2018,8,29,12,1100,1093,2299,1206
2018,8,29,13,1200,1215,2371,1156
2018,8,29,14,1290,1281,2434,1153
2018,8,29,15,1310,1290,2394,1104
2018,8,29,16,1335,1293,2404,1111
2018,8,29,17,1360,1295,2464,1169
2018,8,29,18,1345,1307,2466,1159
2018,8,29,19,1365,1330,2458,1128
2018,8,29,20,1385,1348,2470,1122
2018,8,29,21,1400,1362,2487,1125
2018,8,29,22,1415,1390,2492,1102
2018,8,29,23,1410,1422,2497,1075
2018,8,30,0,1415,1418,2454,1036
2018,8,30,1,1400,1407,2137,730
2018,8,30,2,1365,1371,1717,346
2018,8,30,3,1365,1358,1635,277
2018,8,30,4,1330,1312,1609,297
2018,8,30,5,1235,1218,1645,427
2018,8,30,6,1155,1122,1648,526
2018,8,30,7,1060,1068,1595,527
2018,8,30,8,1040,1045,1610,565
2018,8,30,9,1025,1023,1599,576
2018,8,30,10,1020,1026,1605,579
2018,8,30,11,1040,1038,1632,594
2018,8,30,12,1085,1093,1994,901
2018,8,30,13,1175,1200,2258,1058
2018,8,30,14,1240,1263,2277,1014
2018,8,30,15,1250,1284,2261,977
2018,8,30,16,1265,1310,2252,942
2018,8,30,17,1285,1333,2282,949
2018,8,30,18,1295,1336,2300,964
2018,8,30,19,1300,1340,2319,979
2018,8,30,20,1325,1352,2329,977
2018,8,30,21,1330,1354,2323,969
2018,8,30,22,1345,1367,2296,929
2018,8,30,23,1355,1395,2280,885
2018,8,31,0,1345,1376,2253,877
2018,8,31,1,1325,1351,1814,463
2018,8,31,2,1305,1343,1614,271
2018,8,31,3,1315,1348,1607,259
2018,8,31,4,1295,1305,1682,377
2018,8,31,5,1195,1225,1658,433
2018,8,31,6,1115,1148,1675,527
2018,8,31,7,1070,1070,1675,-9999
2018,8,31,8,1035,1035,1610,-9999
2018,8,31,9,1020,1020,1599,-9999
2018,8,31,10,1015,1015,1605,-9999
2018,8,31,11,1035,1035,1632,-9999
2018,8,31,12,1070,1070,1994,-9999
2018,8,31,13,1140,1140,2258,-9999
2018,8,31,14,1175,1175,2277,-9999
2018,8,31,15,1195,1195,2261,-9999
2018,8,31,16,1220,1220,2252,-9999
2018,8,31,17,1235,1235,2282,-9999
2018,8,31,18,1255,1255,2300,-9999
2018,8,31,19,1275,1275,2319,-9999
2018,8,31,20,1300,1300,2329,-9999
2018,8,31,21,1320,1320,2323,-9999
2018,8,31,22,1345,1345,2296,-9999
2018,8,31,23,1365,1365,2280,-9999
2018,9,1,0,1350,1350,2253,-9999
2018,9,1,1,1325,1325,1814,-9999
2018,9,1,2,1280,1280,1614,-9999
2018,9,1,3,1280,1280,1607,-9999
2018,9,1,4,1250,1250,1682,-9999
2018,9,1,5,1175,1175,1658,-9999
2018,9,1,6,1095,1095,1675,-9999
2018,9,1,7,1100,1084,1637,553
2018,9,1,8,1075,1066,1438,372
2018,9,1,9,1055,1021,1374,353
2018,9,1,10,1040,1032,1383,351
2018,9,1,11,1045,1027,1697,670
2018,9,1,12,1055,1065,2166,1101
2018,9,1,13,1090,1112,2386,1274
2018,9,1,14,1130,1140,2396,1256
2018,9,1,15,1180,1198,2381,1183
2018,9,1,16,1220,1234,2473,1239
2018,9,1,17,1235,1253,2513,1260
2018,9,1,18,1250,1267,2543,1276
2018,9,1,19,1255,1283,2528,1245
2018,9,1,20,1265,1273,2505,1232
2018,9,1,21,1270,1275,2471,1196
2018,9,1,22,1285,1280,2493,1213
2018,9,1,23,1305,1294,2473,1179
2018,9,2,0,1320,1287,2083,796
2018,9,2,1,1310,1263,1704,441
2018,9,2,2,1290,1235,1644,409
2018,9,2,3,1300,1239,1656,417
2018,9,2,4,1270,1214,1678,464
2018,9,2,5,1205,1158,1598,440
2018,9,2,6,1135,1089,1566,477
2018,9,2,7,1075,1045,1498,453
2018,9,2,8,1050,1012,1403,391
2018,9,2,9,1035,1008,1414,406
2018,9,2,10,1020,998,1419,421
2018,9,2,11,1030,1007,1715,708
2018,9,2,12,1035,1033,2094,1061
2018,9,2,13,1085,1058,2176,1118
2018,9,2,14,1135,1101,2211,1110
2018,9,2,15,1190,1137,2236,1099
2018,9,2,16,1235,1184,2252,1068
2018,9,2,17,1250,1192,2251,1059
2018,9,2,18,1270,1214,2271,1057
2018,9,2,19,1280,1222,2277,1055
2018,9,2,20,1290,1231,2271,1040
2018,9,2,21,1295,1239,2288,1049
2018,9,2,22,1310,1263,2316,1053
2018,9,2,23,1330,1286,2344,1058
2018,9,3,0,1355,1319,2323,1004
2018,9,3,1,1350,1296,1883,587
2018,9,3,2,1335,1271,1582,311
2018,9,3,3,1340,1270,1605,335
2018,9,3,4,1325,1237,1585,348
2018,9,3,5,1240,1150,1517,367
2018,9,3,6,1165,1085,1475,390
2018,9,3,7,1070,1034,1460,426
2018,9,3,8,1020,1013,1479,466
2018,9,3,9,1010,1001,1428,427
2018,9,3,10,1010,999,1415,416
2018,9,3,11,1035,1009,1595,586
2018,9,3,12,1090,1038,1829,791
2018,9,3,13,1205,1073,1889,816
2018,9,3,14,1290,1104,1919,815
2018,9,3,15,1310,1153,1926,773
2018,9,3,16,1325,1202,1950,748
2018,9,3,17,1335,1243,1997,754
2018,9,3,18,1340,1264,2034,770
2018,9,3,19,1345,1281,2029,748
2018,9,3,20,1350,1319,2033,714
2018,9,3,21,1350,1336,2014,678
2018,9,3,22,1360,1378,2084,706
2018,9,3,23,1360,1413,2087,674
2018,9,4,0,1350,1439,2105,666
2018,9,4,1,1335,1430,1855,425
2018,9,4,2,1315,1373,1654,281
2018,9,4,3,1320,1352,1651,299
2018,9,4,4,1315,1294,1608,314
2018,9,4,5,1185,1182,1557,375
2018,9,4,6,1105,1105,1551,446
2018,9,4,7,1005,1043,1544,501
2018,9,4,8,985,1025,1539,514
2018,9,4,9,970,1007,1539,532
2018,9,4,10,970,1004,1551,547
2018,9,4,11,990,1025,1663,638
2018,9,4,12,1030,1082,1839,757
2018,9,4,13,1160,1195,1911,716
2018,9,4,14,1270,1262,1877,615
2018,9,4,15,1285,1268,1880,612
2018,9,4,16,1295,1286,1897,611
2018,9,4,17,1310,1302,1965,663
2018,9,4,18,1310,1297,1952,655
2018,9,4,19,1315,1295,1905,610
2018,9,4,20,1325,1311,1931,620
2018,9,4,21,1315,1313,1938,625
2018,9,4,22,1330,1323,1939,616
2018,9,4,23,1340,1341,1935,594
2018,9,5,0,1330,1325,1901,576
2018,9,5,1,1310,1337,1716,379
2018,9,5,2,1300,1315,1526,211
2018,9,5,3,1320,1335,1642,307
2018,9,5,4,1300,1304,1706,402
2018,9,5,5,1200,1206,1663,457
2018,9,5,6,1130,1131,1648,517
2018,9,5,7,1040,1083,1615,532
2018,9,5,8,1005,1057,1538,481
2018,9,5,9,995,1043,1503,460
2018,9,5,10,995,1039,1569,530
2018,9,5,11,1005,1059,1808,749
2018,9,5,12,1045,1117,2086,969
2018,9,5,13,1125,1223,2210,987
2018,9,5,14,1170,1282,2208,926
2018,9,5,15,1195,1282,2290,1008
2018,9,5,16,1215,1302,2323,1021
2018,9,5,17,1235,1335,2349,1014
2018,9,5,18,1240,1312,2327,1015
2018,9,5,19,1260,1328,2328,1000
2018,9,5,20,1285,1347,2296,949
2018,9,5,21,1300,1357,2270,913
2018,9,5,22,1335,1396,2271,875
2018,9,5,23,1360,1413,2292,879
2018,9,6,0,1370,1413,2291,878
2018,9,6,1,1365,1399,2070,671
2018,9,6,2,1330,1389,2054,665
2018,9,6,3,1315,1392,2073,681
2018,9,6,4,1275,1344,2043,699
2018,9,6,5,1170,1247,2026,779
2018,9,6,6,1090,1155,1994,839
2018,9,6,7,1055,1122,1973,851
2018,9,6,8,1030,1090,1889,799
2018,9,6,9,1015,1078,1904,826
2018,9,6,10,1010,1066,1889,823
2018,9,6,11,1030,1094,2126,1032
2018,9,6,12,1080,1135,2258,1123
2018,9,6,13,1195,1254,2297,1043
2018,9,6,14,1270,1307,2177,870
2018,9,6,15,1280,1316,2237,921
2018,9,6,16,1305,1339,2265,926
2018,9,6,17,1330,1358,2353,995
2018,9,6,18,1330,1382,2371,989
2018,9,6,19,1330,1394,2334,940
2018,9,6,20,1345,1422,2287,865
2018,9,6,21,1350,1461,2284,823
2018,9,6,22,1365,1485,2281,796
2018,9,6,23,1385,1509,2283,774
2018,9,7,0,1370,1492,2262,770
2018,9,7,1,1365,1463,1990,527
2018,9,7,2,1350,1443,1830,387
2018,9,7,3,1360,1448,1757,309
2018,9,7,4,1315,1385,1779,394
2018,9,7,5,1230,1287,1840,553
2018,9,7,6,1155,1180,1736,556
2018,9,7,7,1105,1141,1786,645
2018,9,7,8,1065,1100,1891,791
2018,9,7,9,1050,1090,1928,838
2018,9,7,10,1035,1079,2088,1009
2018,9,7,11,1050,1097,2244,1147
2018,9,7,12,1090,1135,2314,1179
2018,9,7,13,1230,1234,2374,1140
2018,9,7,14,1320,1295,2353,1058
2018,9,7,15,1350,1310,2362,1052
2018,9,7,16,1375,1340,2313,973
2018,9,7,17,1400,1375,2376,1001
2018,9,7,18,1400,1414,2391,977
2018,9,7,19,1410,1431,2380,949
2018,9,7,20,1425,1479,2378,899
2018,9,7,21,1430,1528,2382,854
2018,9,7,22,1460,1556,2419,863
2018,9,7,23,1465,1585,2412,827
2018,9,8,0,1460,1565,2436,871
2018,9,8,1,1435,1528,2202,674
2018,9,8,2,1395,1482,1871,389
2018,9,8,3,1395,1462,1930,468
2018,9,8,4,1375,1398,1903,505
2018,9,8,5,1295,1309,1807,498
2018,9,8,6,1200,1221,1925,704
2018,9,8,7,1085,1156,1812,656
2018,9,8,8,1055,1103,1797,694
2018,9,8,9,1035,1087,1791,704
2018,9,8,10,1030,1090,1764,674
2018,9,8,11,1030,1093,1773,680
2018,9,8,12,1055,1118,1790,672
2018,9,8,13,1080,1148,1806,658
2018,9,8,14,1110,1171,1816,645
2018,9,8,15,1155,1219,1749,530
2018,9,8,16,1200,1273,1728,455
2018,9,8,17,1210,1298,1736,438
2018,9,8,18,1225,1312,1805,493
2018,9,8,19,1235,1339,1811,472
2018,9,8,20,1240,1374,1889,515
2018,9,8,21,1245,1394,1876,482
2018,9,8,22,1270,1427,1889,462
2018,9,8,23,1285,1431,1920,489
2018,9,9,0,1305,1434,1961,527
2018,9,9,1,1295,1408,1976,568
2018,9,9,2,1270,1372,1903,531
2018,9,9,3,1275,1370,1894,524
2018,9,9,4,1240,1320,1903,583
2018,9,9,5,1175,1253,2007,754
2018,9,9,6,1105,1186,1938,752
2018,9,9,7,1060,1128,1880,752
2018,9,9,8,1025,1100,1849,749
2018,9,9,9,1020,1066,1806,740
2018,9,9,10,1010,1067,1803,736
2018,9,9,11,1010,1079,1810,731
2018,9,9,12,1030,1077,1774,697
2018,9,9,13,1035,1106,1767,661
2018,9,9,14,1060,1140,1746,606
2018,9,9,15,1095,1186,1736,550
2018,9,9,16,1135,1228,1747,519
2018,9,9,17,1150,1251,1755,504
2018,9,9,18,1170,1279,1841,562
2018,9,9,19,1180,1297,1838,541
2018,9,9,20,1195,1313,1834,521
2018,9,9,21,1200,1327,1812,485
2018,9,9,22,1230,1359,1868,509
2018,9,9,23,1250,1400,1900,500
2018,9,10,0,1280,1430,1884,454
2018,9,10,1,1275,1431,1877,446
2018,9,10,2,1255,1419,1881,462
2018,9,10,3,1255,1413,1898,485
2018,9,10,4,1225,1345,1863,518
2018,9,10,5,1140,1239,1809,570
2018,9,10,6,1075,1144,1828,684
2018,9,10,7,1080,1092,1667,575
2018,9,10,8,1030,1062,1609,547
2018,9,10,9,1020,1056,1608,552
2018,9,10,10,1010,1044,1605,561
2018,9,10,11,1015,1068,1801,733
2018,9,10,12,1050,1128,2078,950
2018,9,10,13,1155,1234,2110,876
2018,9,10,14,1240,1295,2073,778
2018,9,10,15,1285,1303,2057,754
2018,9,10,16,1315,1321,1969,648
2018,9,10,17,1350,1345,2079,734
2018,9,10,18,1375,1362,2093,731
2018,9,10,19,1390,1399,2137,738
2018,9,10,20,1430,1436,2160,724
2018,9,10,21,1450,1455,2152,697
2018,9,10,22,1485,1487,2192,705
2018,9,10,23,1500,1506,2210,704
2018,9,11,0,1500,1494,2219,725
2018,9,11,1,1480,1472,2178,706
2018,9,11,2,1440,1452,2155,703
2018,9,11,3,1425,1464,2163,699
2018,9,11,4,1370,1380,2218,838
2018,9,11,5,1265,1283,2237,954
2018,9,11,6,1180,1185,2255,1070
2018,9,11,7,1055,1138,2257,1119
2018,9,11,8,1035,1106,2238,1132
2018,9,11,9,1020,1085,2248,1163
2018,9,11,10,1020,1087,2248,1161
2018,9,11,11,1040,1080,2219,1139
2018,9,11,12,1090,1130,2187,1057
2018,9,11,13,1200,1221,2156,935
2018,9,11,14,1275,1303,2118,815
2018,9,11,15,1285,1308,2103,795
2018,9,11,16,1290,1335,2153,818
2018,9,11,17,1300,1340,2151,811
2018,9,11,18,1305,1340,2157,817
2018,9,11,19,1300,1348,2166,818
2018,9,11,20,1320,1366,2191,825
2018,9,11,21,1310,1376,2166,790
2018,9,11,22,1330,1385,2163,778
2018,9,11,23,1335,1391,2137,746
2018,9,12,0,1320,1386,2184,798
2018,9,12,1,1315,1376,2157,781
2018,9,12,2,1305,1384,2186,802
2018,9,12,3,1330,1387,2194,807
2018,9,12,4,1300,1327,2184,857
2018,9,12,5,1205,1240,2229,989
2018,9,12,6,1125,1151,2237,1086
2018,9,12,7,1070,1113,2258,1145
2018,9,12,8,1035,1092,2190,1098
2018,9,12,9,1020,1079,2161,1082
2018,9,12,10,1020,1080,2106,1026
2018,9,12,11,1030,1084,2140,1056
2018,9,12,12,1090,1140,2220,1080
2018,9,12,13,1165,1256,2230,974
2018,9,12,14,1225,1316,2187,871
2018,9,12,15,1240,1327,2189,862
2018,9,12,16,1270,1342,2249,907
2018,9,12,17,1300,1337,2252,915
2018,9,12,18,1265,1337,2230,893
2018,9,12,19,1295,1344,2253,909
2018,9,12,20,1320,1348,2239,891
2018,9,12,21,1335,1354,2280,926
2018,9,12,22,1360,1358,2325,967
2018,9,12,23,1365,1372,2337,965
2018,9,13,0,1375,1373,2342,969
2018,9,13,1,1365,1371,2296,925
2018,9,13,2,1340,1370,2336,966
2018,9,13,3,1340,1389,2326,937
2018,9,13,4,1305,1343,2291,948
2018,9,13,5,1205,1263,2273,1010
2018,9,13,6,1130,1171,2177,1006
2018,9,13,7,1040,1136,2176,1040
2018,9,13,8,1015,1106,2042,936
2018,9,13,9,1000,1097,2004,907
2018,9,13,10,995,1100,2012,912
2018,9,13,11,1000,1113,2108,995
2018,9,13,12,1045,1182,2250,1068
2018,9,13,13,1145,1287,2226,939
2018,9,13,14,1210,1354,2213,859
2018,9,13,15,1220,1361,2218,857
2018,9,13,16,1245,1362,2237,875
2018,9,13,17,1255,1367,2237,870
2018,9,13,18,1265,1372,2241,869
2018,9,13,19,1270,1364,2231,867
2018,9,13,20,1290,1377,2262,885
2018,9,13,21,1305,1368,2260,892
2018,9,13,22,1320,1357,2258,901
2018,9,13,23,1335,1361,2256,895
2018,9,14,0,1325,1341,2254,913
2018,9,14,1,1310,1337,2256,919
2018,9,14,2,1310,1358,2241,883
2018,9,14,3,1315,1375,2244,869
2018,9,14,4,1250,1330,2242,912
2018,9,14,5,1170,1252,2235,983
2018,9,14,6,1085,1177,2270,1093
2018,9,14,7,1080,1124,2282,1158
2018,9,14,8,1045,1106,2301,1195
2018,9,14,9,1035,1093,2303,1210
2018,9,14,10,1025,1088,2297,1209
2018,9,14,11,1035,1109,2295,1186
2018,9,14,12,1075,1151,2356,1205
2018,9,14,13,1165,1256,2349,1093
2018,9,14,14,1205,1333,2299,966
2018,9,14,15,1220,1343,2282,939
2018,9,14,16,1240,1339,2284,945
2018,9,14,17,1255,1334,2280,946
2018,9,14,18,1265,1336,2263,927
2018,9,14,19,1280,1332,2269,937
2018,9,14,20,1300,1330,2296,966
2018,9,14,21,1320,1330,2302,972
2018,9,14,22,1340,1333,2307,974
2018,9,14,23,1355,1343,2310,967
2018,9,15,0,1345,1328,2325,997
2018,9,15,1,1330,1316,2334,1018
2018,9,15,2,1315,1331,2341,1010
2018,9,15,3,1310,1326,2330,1004
2018,9,15,4,1265,1306,2218,912
2018,9,15,5,1185,1249,2165,916
2018,9,15,6,1100,1151,2126,975
2018,9,15,7,1070,1120,2146,1026
2018,9,15,8,1045,1099,2176,1077
2018,9,15,9,1010,1095,2140,1045
2018,9,15,10,1015,1074,2127,1053
2018,9,15,11,1015,1091,2138,1047
2018,9,15,12,1035,1091,2145,1054
2018,9,15,13,1055,1146,2150,1004
2018,9,15,14,1065,1184,2081,897
2018,9,15,15,1115,1218,2068,850
2018,9,15,16,1150,1257,2089,832
2018,9,15,17,1175,1249,2119,870
2018,9,15,18,1190,1246,2095,849
2018,9,15,19,1205,1252,2090,838
2018,9,15,20,1215,1247,2077,830
2018,9,15,21,1230,1236,2063,827
2018,9,15,22,1245,1248,2080,832
2018,9,15,23,1265,1257,2091,834
2018,9,16,0,1270,1262,2083,821
2018,9,16,1,1260,1270,2106,836
2018,9,16,2,1235,1287,2077,790
2018,9,16,3,1235,1300,2085,785
2018,9,16,4,1185,1279,2090,811
2018,9,16,5,1125,1227,2269,1042
2018,9,16,6,1055,1155,2337,1182
2018,9,16,7,1075,1110,2305,1195
2018,9,16,8,1040,1081,2317,1236
2018,9,16,9,1025,1068,2459,1391
2018,9,16,10,1020,1062,2301,1239
2018,9,16,11,1025,1069,2114,1045
2018,9,16,12,1040,1081,1853,772
2018,9,16,13,1045,1126,2011,885
2018,9,16,14,1055,1160,2029,869
2018,9,16,15,1095,1199,2019,820
2018,9,16,16,1140,1259,2066,807
2018,9,16,17,1155,1270,2074,804
2018,9,16,18,1175,1295,2096,801
2018,9,16,19,1190,1301,2090,789
2018,9,16,20,1205,1319,2108,789
2018,9,16,21,1220,1320,2104,784
2018,9,16,22,1250,1345,2117,772
2018,9,16,23,1270,1356,2129,773
2018,9,17,0,1290,1364,2101,737
2018,9,17,1,1280,1374,2091,717
2018,9,17,2,1260,1381,2146,765
2018,9,17,3,1260,1393,2175,782
2018,9,17,4,1200,1327,2158,831
2018,9,17,5,1130,1240,2157,917
2018,9,17,6,1060,1172,2161,989
2018,9,17,7,1075,1126,2149,1023
2018,9,17,8,1050,1108,2158,1050
2018,9,17,9,1040,1086,2156,1070
2018,9,17,10,1035,1071,2160,1089
2018,9,17,11,1045,1098,2151,1053
2018,9,17,12,1085,1138,2125,987
2018,9,17,13,1150,1258,2114,856
2018,9,17,14,1180,1341,2055,714
2018,9,17,15,1210,1342,2046,704
2018,9,17,16,1240,1339,2026,687
2018,9,17,17,1265,1349,2067,718
2018,9,17,18,1280,1343,2069,726
2018,9,17,19,1305,1342,2067,725
2018,9,17,20,1340,1349,2059,710
2018,9,17,21,1355,1347,2072,725
2018,9,17,22,1390,1359,2073,714
2018,9,17,23,1415,1365,2073,708
2018,9,18,0,1420,1355,2084,729
2018,9,18,1,1410,1365,2130,765
2018,9,18,2,1380,1376,2147,771
2018,9,18,3,1375,1395,2086,691
2018,9,18,4,1295,1322,2068,746
2018,9,18,5,1205,1235,2064,829
2018,9,18,6,1115,1155,2151,996
2018,9,18,7,1100,1111,2132,1021
2018,9,18,8,1070,1091,2061,970
2018,9,18,9,1055,1092,2192,1100
2018,9,18,10,1055,1091,2198,1107
2018,9,18,11,1060,1101,2195,1094
2018,9,18,12,1120,1155,2244,1089
2018,9,18,13,1225,1255,2289,1034
2018,9,18,14,1305,1340,2238,898
2018,9,18,15,1310,1331,2193,862
2018,9,18,16,1325,1348,2224,876
2018,9,18,17,1330,1348,2230,882
2018,9,18,18,1335,1349,2239,890
2018,9,18,19,1335,1350,2265,915
2018,9,18,20,1345,1367,2264,897
2018,9,18,21,1350,1365,2254,889
2018,9,18,22,1350,1365,2265,900
2018,9,18,23,1360,1379,2347,968
2018,9,19,0,1345,1361,2390,1029
2018,9,19,1,1345,1369,2442,1073
2018,9,19,2,1350,1364,2441,1077
2018,9,19,3,1365,1378,2421,1043
2018,9,19,4,1300,1317,2407,1090
2018,9,19,5,1220,1244,2424,1180
2018,9,19,6,1145,1181,2370,1189
2018,9,19,7,1080,1125,2377,1252
2018,9,19,8,1060,1111,2336,1225
2018,9,19,9,1050,1096,2361,1265
2018,9,19,10,1045,1100,2343,1243
2018,9,19,11,1060,1111,2338,1227
2018,9,19,12,1105,1166,2322,1156
2018,9,19,13,1220,1284,2324,1040
2018,9,19,14,1290,1354,2294,940
2018,9,19,15,1300,1367,2283,916
2018,9,19,16,1305,1372,2283,911
2018,9,19,17,1305,1367,2329,962
2018,9,19,18,1305,1353,2360,1007
2018,9,19,19,1305,1360,2506,1146
2018,9,19,20,1310,1357,2499,1142
2018,9,19,21,1315,1362,2544,1182
2018,9,19,22,1320,1364,2552,1188
2018,9,19,23,1335,1383,2561,1178
2018,9,20,0,1330,1376,2576,1200
2018,9,20,1,1320,1379,2575,1196
2018,9,20,2,1330,1394,2595,1201
2018,9,20,3,1335,1392,2591,1199
2018,9,20,4,1285,1327,2573,1246
2018,9,20,5,1225,1265,2553,1288
2018,9,20,6,1130,1200,2524,1324
2018,9,20,7,1085,1165,2461,1296
2018,9,20,8,1065,1131,2418,1287
2018,9,20,9,1055,1114,2407,1293
2018,9,20,10,1055,1123,2430,1307
2018,9,20,11,1065,1126,2450,1324
2018,9,20,12,1120,1181,2503,1322
2018,9,20,13,1220,1298,2530,1232
2018,9,20,14,1280,1374,2485,1111
2018,9,20,15,1280,1378,2506,1128
2018,9,20,16,1290,1381,2517,1136
2018,9,20,17,1295,1383,2599,1216
2018,9,20,18,1300,1384,2586,1202
2018,9,20,19,1300,1373,2575,1202
2018,9,20,20,1315,1379,2530,1151
2018,9,20,21,1315,1366,2527,1161
2018,9,20,22,1310,1378,2579,1201
2018,9,20,23,1320,1377,2556,1179
2018,9,21,0,1305,1285,2598,1313
2018,9,21,1,1305,1368,2602,1234
2018,9,21,2,1310,1390,2613,1223
2018,9,21,3,1325,1412,2610,1198
2018,9,21,4,1275,1345,2484,1139
2018,9,21,5,1190,1268,2470,1202
2018,9,21,6,1120,1209,2498,1289
2018,9,21,7,1090,1179,2504,1325
2018,9,21,8,1070,1160,2514,1354
2018,9,21,9,1060,1148,2518,1370
2018,9,21,10,1055,1148,2495,1347
2018,9,21,11,1075,1175,2519,1344
2018,9,21,12,1115,1192,2551,1359
2018,9,21,13,1225,1263,2535,1272
2018,9,21,14,1295,1339,2478,1139
2018,9,21,15,1305,1363,2465,1102
2018,9,21,16,1310,1363,2457,1094
2018,9,21,17,1310,1378,2489,1111
2018,9,21,18,1310,1399,2518,1119
2018,9,21,19,1310,1384,2523,1139
2018,9,21,20,1315,1385,2518,1133
2018,9,21,21,1320,1399,2549,1150
2018,9,21,22,1325,1390,2552,1162
2018,9,21,23,1340,1407,2599,1192
2018,9,22,0,1330,1377,2549,1172
2018,9,22,1,1320,1346,2530,1184
2018,9,22,2,1330,1367,2493,1126
2018,9,22,3,1325,1359,2488,1129
2018,9,22,4,1310,1307,2451,1144
2018,9,22,5,1210,1256,2483,1227
2018,9,22,6,1130,1195,2478,1283
2018,9,22,7,1100,1165,2474,1309
2018,9,22,8,1070,1141,2465,1324
2018,9,22,9,1060,1127,2447,1320
2018,9,22,10,1050,1125,2460,1335
2018,9,22,11,1060,1135,2485,1350
2018,9,22,12,1075,1149,2497,1348
2018,9,22,13,1110,1188,2527,1339
2018,9,22,14,1140,1229,2541,1312
2018,9,22,15,1175,1267,2510,1243
2018,9,22,16,1220,1310,2502,1192
2018,9,22,17,1225,1314,2519,1205
2018,9,22,18,1235,1312,2463,1151
2018,9,22,19,1245,1318,2472,1154
2018,9,22,20,1255,1315,2479,1164
2018,9,22,21,1250,1329,2517,1188
2018,9,22,22,1270,1333,2508,1175
2018,9,22,23,1280,1338,2485,1147
2018,9,23,0,1285,1316,2437,1121
2018,9,23,1,1290,1304,2509,1205
2018,9,23,2,1295,1324,2486,1162
2018,9,23,3,1305,1315,2429,1114
2018,9,23,4,1280,1280,2502,1222
2018,9,23,5,1190,1217,2487,1270
2018,9,23,6,1115,1166,2438,1272
2018,9,23,7,1075,1125,2420,1295
2018,9,23,8,1055,1099,2406,1307
2018,9,23,9,1040,1083,2358,1275
2018,9,23,10,1030,1080,2335,1255
2018,9,23,11,1040,1078,2321,1243
2018,9,23,12,1050,1104,2336,1232
2018,9,23,13,1095,1130,2339,1209
2018,9,23,14,1135,1160,2310,1150
2018,9,23,15,1170,1218,2275,1057
2018,9,23,16,1220,1266,2301,1035
2018,9,23,17,1225,1280,2349,1069
2018,9,23,18,1235,1284,2374,1090
2018,9,23,19,1245,1294,2394,1100
2018,9,23,20,1250,1301,2357,1056
2018,9,23,21,1250,1289,2389,1100
2018,9,23,22,1270,1302,2365,1063
2018,9,23,23,1285,1302,2456,1154
2018,9,24,0,1295,1333,2453,1120
2018,9,24,1,1300,1320,2444,1124
2018,9,24,2,1310,1351,2444,1093
2018,9,24,3,1320,1359,2506,1147
2018,9,24,4,1250,1293,2506,1213
2018,9,24,5,1190,1226,2508,1282
2018,9,24,6,1115,1158,2449,1291
2018,9,24,7,1085,1125,2465,1340
2018,9,24,8,1070,1112,2518,1406
2018,9,24,9,1055,1106,2522,1416
2018,9,24,10,1045,1110,2537,1427
2018,9,24,11,1065,1119,2577,1458
2018,9,24,12,1110,1177,2578,1401
2018,9,24,13,1215,1286,2562,1276
2018,9,24,14,1265,1353,2427,1074
2018,9,24,15,1275,1382,2466,1084
2018,9,24,16,1280,1406,2481,1075
2018,9,24,17,1285,1388,2453,1065
2018,9,24,18,1275,1389,2466,1077
2018,9,24,19,1280,1380,2455,1075
2018,9,24,20,1290,1380,2494,1114
2018,9,24,21,1290,1370,2503,1133
2018,9,24,22,1300,1371,2472,1101
2018,9,24,23,1315,1365,2491,1126
2018,9,25,0,1305,1361,2498,1137
2018,9,25,1,1310,1376,2468,1092
2018,9,25,2,1315,1405,2443,1038
2018,9,25,3,1325,1400,2442,1042
2018,9,25,4,1250,1331,2439,1108
2018,9,25,5,1175,1254,2447,1193
2018,9,25,6,1100,1179,2385,1206
2018,9,25,7,1095,1145,2391,1246
2018,9,25,8,1070,1126,2438,1312
2018,9,25,9,1060,1129,2505,1376
2018,9,25,10,1065,1130,2496,1366
2018,9,25,11,1070,1139,2494,1355
2018,9,25,12,1125,1176,2466,1290
2018,9,25,13,1210,1301,2464,1163
2018,9,25,14,1275,1382,2425,1043
2018,9,25,15,1270,1385,2400,1015
2018,9,25,16,1285,1364,2241,877
2018,9,25,17,1285,1345,2197,852
2018,9,25,18,1285,1336,2213,877
2018,9,25,19,1280,1328,2371,1043
2018,9,25,20,1295,1332,2415,1083
2018,9,25,21,1285,1335,2427,1092
2018,9,25,22,1290,1326,2431,1105
2018,9,25,23,1295,1327,2361,1034
2018,9,26,0,1255,1313,2339,1026
2018,9,26,1,1290,1322,2265,943
2018,9,26,2,1295,1364,2248,884
2018,9,26,3,1315,1373,2257,884
2018,9,26,4,1245,1327,2353,1026
2018,9,26,5,1175,1255,2456,1201
2018,9,26,6,1110,1186,2474,1288
2018,9,26,7,1105,1140,2441,1301
2018,9,26,8,1090,1133,2488,1355
2018,9,26,9,1080,1135,2503,1368
2018,9,26,10,1080,1123,2507,1384
2018,9,26,11,1095,1154,2477,1323
2018,9,26,12,1140,1219,2581,1362
2018,9,26,13,1245,1339,2596,1257
2018,9,26,14,1320,1399,2627,1228
2018,9,26,15,1340,1383,2637,1254
2018,9,26,16,1350,1353,2612,1259
2018,9,26,17,1345,1361,2665,1304
2018,9,26,18,1345,1351,2645,1294
2018,9,26,19,1340,1339,2626,1287
2018,9,26,20,1340,1334,2593,1259
2018,9,26,21,1340,1337,2656,1319
2018,9,26,22,1335,1327,2667,1340
2018,9,26,23,1345,1356,2718,1362
2018,9,27,0,1335,1386,2703,1317
2018,9,27,1,1330,1364,2614,1250
2018,9,27,2,1355,1401,2670,1269
2018,9,27,3,1350,1404,2666,1262
2018,9,27,4,1285,1341,2602,1261
2018,9,27,5,1215,1256,2593,1337
2018,9,27,6,1150,1188,2538,1350
2018,9,27,7,1125,1142,2458,1316
2018,9,27,8,1100,1129,2494,1365
2018,9,27,9,1090,1124,2523,1399
2018,9,27,10,1095,1119,2506,1387
2018,9,27,11,1105,1121,2512,1391
2018,9,27,12,1155,1162,2548,1386
2018,9,27,13,1270,1296,2569,1273
2018,9,27,14,1345,1378,2527,1149
2018,9,27,15,1345,1362,2502,1140
2018,9,27,16,1340,1359,2476,1117
2018,9,27,17,1330,1376,2506,1130
2018,9,27,18,1330,1366,2508,1142
2018,9,27,19,1320,1351,2507,1156
2018,9,27,20,1325,1361,2508,1147
2018,9,27,21,1320,1350,2534,1184
2018,9,27,22,1320,1364,2628,1264
2018,9,27,23,1320,1374,2634,1260
2018,9,28,0,1275,1367,2603,1236
2018,9,28,1,1310,1383,2633,1250
2018,9,28,2,1345,1430,2573,1143
2018,9,28,3,1360,1409,2533,1124
2018,9,28,4,1310,1357,2542,1185
2018,9,28,5,1225,1278,2536,1258
2018,9,28,6,1155,1223,2571,1348
2018,9,28,7,1100,1185,2544,1359
2018,9,28,8,1090,1176,2543,1367
2018,9,28,9,1080,1163,2538,1375
2018,9,28,10,1075,1181,2554,1373
2018,9,28,11,1105,1170,2542,1372
2018,9,28,12,1145,1227,2574,1347
2018,9,28,13,1260,1334,2577,1243
2018,9,28,14,1340,1418,2567,1149
2018,9,28,15,1345,1423,2539,1116
2018,9,28,16,1330,1429,2552,1123
2018,9,28,17,1340,1419,2536,1117
2018,9,28,18,1350,1404,2550,1146
2018,9,28,19,1335,1384,2538,1154
2018,9,28,20,1335,1379,2555,1176
2018,9,28,21,1340,1358,2570,1212
2018,9,28,22,1330,1354,2558,1204
2018,9,28,23,1350,1349,2543,1194
2018,9,29,0,1350,1354,2555,1201
2018,9,29,1,1325,1357,2541,1184
2018,9,29,2,1355,1385,2528,1143
2018,9,29,3,1350,1373,2522,1149
2018,9,29,4,1290,1328,2518,1190
2018,9,29,5,1225,1259,2530,1271
2018,9,29,6,1155,1211,2537,1326
2018,9,29,7,1140,1152,2518,1366
2018,9,29,8,1110,1137,2522,1385
2018,9,29,9,1105,1119,2514,1395
2018,9,29,10,1095,1121,2518,1397
2018,9,29,11,1105,1121,2515,1394
2018,9,29,12,1115,1143,2516,1373
2018,9,29,13,1170,1196,2523,1327
2018,9,29,14,1220,1257,2523,1266
2018,9,29,15,1260,1289,2517,1228
2018,9,29,16,1300,1341,2533,1192
2018,9,29,17,1310,1340,2538,1198
2018,9,29,18,1305,1346,2548,1202
2018,9,29,19,1315,1335,2542,1207
2018,9,29,20,1310,1334,2531,1197
2018,9,29,21,1315,1335,2544,1209
2018,9,29,22,1325,1329,2568,1239
2018,9,29,23,1330,1344,2591,1247
2018,9,30,0,1330,1351,2613,1262
2018,9,30,1,1325,1368,2632,1264
2018,9,30,2,1350,1398,2637,1239
2018,9,30,3,1350,1371,2602,1231
2018,9,30,4,1310,1332,2599,1267
2018,9,30,5,1240,1279,2580,1301
2018,9,30,6,1175,1224,2581,1357
2018,9,30,7,1145,1181,2569,1388
2018,9,30,8,1115,1173,2588,1415
2018,9,30,9,1100,1157,2582,1425
2018,9,30,10,1100,1156,2592,1436
2018,9,30,11,1105,1156,2588,1432
2018,9,30,12,1125,1185,2588,1403
2018,9,30,13,1160,1219,2586,1367
2018,9,30,14,1205,1283,2589,1306
2018,9,30,15,1250,1345,2588,1243
2018,9,30,16,1300,1399,2591,1192
2018,9,30,17,1315,1420,2616,1196
2018,9,30,18,1320,1429,2609,1180
2018,9,30,19,1330,1457,2630,1173
2018,9,30,20,1335,1416,2582,1166
2018,9,30,21,1335,1389,2556,1167
2018,9,30,22,1350,1390,2552,1162
2018,9,30,23,1355,1402,2550,1148
2018,10,1,0,1370,1419,2591,1172
2018,10,1,1,1365,1427,2601,1174
2018,10,1,2,1385,1453,2598,1145
2018,10,1,3,1390,1443,2592,1149
2018,10,1,4,1320,1376,2597,1221
2018,10,1,5,1250,1284,2562,1278
2018,10,1,6,1185,1208,2564,1356
2018,10,1,7,1115,1175,2558,1383
2018,10,1,8,1100,1160,2539,1379
2018,10,1,9,1090,1147,2542,1395
2018,10,1,10,1085,1158,2610,1452
2018,10,1,11,1105,1179,2642,1463
2018,10,1,12,1160,1227,2640,1413
2018,10,1,13,1275,1357,2724,1367
2018,10,1,14,1340,1447,2688,1241
2018,10,1,15,1355,1425,2654,1229
2018,10,1,16,1350,1418,2627,1209
2018,10,1,17,1345,1397,2619,1222
2018,10,1,18,1345,1374,2640,1266
2018,10,1,19,1340,1360,2658,1298
2018,10,1,20,1340,1354,2687,1333
2018,10,1,21,1335,1361,2714,1353
2018,10,1,22,1335,1348,2741,1393
2018,10,1,23,1340,1340,2685,1345
2018,10,2,0,1345,1323,2645,1322
2018,10,2,1,1350,1352,2631,1279
2018,10,2,2,1375,1392,2590,1198
2018,10,2,3,1380,1379,2590,1211
2018,10,2,4,1310,1312,2559,1247
2018,10,2,5,1225,1236,2543,1307
2018,10,2,6,1150,1163,2545,1382
2018,10,2,7,1105,1133,2559,1426
2018,10,2,8,1090,1109,2564,1455
2018,10,2,9,1085,1104,2565,1461
2018,10,2,10,1085,1104,2566,1462
2018,10,2,11,1095,1123,2578,1455
2018,10,2,12,1135,1169,2566,1397
2018,10,2,13,1275,1269,2594,1325
2018,10,2,14,1370,1373,2620,1247
2018,10,2,15,1365,1380,2605,1225
2018,10,2,16,1360,1367,2621,1254
2018,10,2,17,1355,1378,2456,1078
2018,10,2,18,1345,1349,2033,684
2018,10,2,19,1335,1355,1993,638
2018,10,2,20,1345,1359,1983,624
2018,10,2,21,1340,1360,1971,611
2018,10,2,22,1340,1358,1961,603
2018,10,2,23,1345,1369,1957,588
2018,10,3,0,1340,1371,1980,609
2018,10,3,1,1350,1386,1973,587
2018,10,3,2,1385,1416,1957,541
2018,10,3,3,1385,1395,2027,632
2018,10,3,4,1335,1335,2025,690
2018,10,3,5,1250,1239,2117,878
2018,10,3,6,1180,1188,2096,908
2018,10,3,7,1120,1144,2094,950
2018,10,3,8,1110,1132,2097,965
2018,10,3,9,1095,1129,2148,1019
2018,10,3,10,1100,1128,2296,1168
2018,10,3,11,1115,1147,2268,1121
2018,10,3,12,1165,1207,2456,1249
2018,10,3,13,1290,1316,2419,1103
2018,10,3,14,1355,1398,2438,1040
2018,10,3,15,1360,1397,2386,989
2018,10,3,16,1365,1383,2378,995
2018,10,3,17,1355,1379,2413,1034
2018,10,3,18,1340,1357,2392,1035
2018,10,3,19,1335,1343,2378,1035
2018,10,3,20,1330,1337,2379,1042
2018,10,3,21,1335,1327,2359,1032
2018,10,3,22,1335,1324,2360,1036
2018,10,3,23,1345,1309,2343,1034
2018,10,4,0,1340,1313,2330,1017
2018,10,4,1,1345,1329,2369,1040
2018,10,4,2,1370,1386,2401,1015
2018,10,4,3,1360,1394,2395,1001
2018,10,4,4,1290,1331,2386,1055
2018,10,4,5,1225,1252,2309,1057
2018,10,4,6,1160,1194,2268,1074
2018,10,4,7,1150,1165,2251,1086
2018,10,4,8,1130,1155,2239,1084
2018,10,4,9,1120,1147,2232,1085
2018,10,4,10,1120,1144,2236,1092
2018,10,4,11,1135,1168,2240,1072
2018,10,4,12,1190,1220,2279,1059
2018,10,4,13,1285,1329,2268,939
2018,10,4,14,1380,1421,2269,848
2018,10,4,15,1380,1431,2273,842
2018,10,4,16,1370,1433,2281,848
2018,10,4,17,1380,1438,2287,849
2018,10,4,18,1365,1421,2283,862
2018,10,4,19,1360,1407,2294,887
2018,10,4,20,1365,1398,2271,873
2018,10,4,21,1355,1392,2232,840
2018,10,4,22,1350,1385,2170,785
2018,10,4,23,1360,1390,2262,872
2018,10,5,0,1365,1399,2282,883
2018,10,5,1,1395,1430,2290,860
2018,10,5,2,1425,1463,2281,818
2018,10,5,3,1400,1452,2270,818
2018,10,5,4,1340,1408,2245,837
2018,10,5,5,1240,1309,2217,908
2018,10,5,6,1180,1241,2240,999
2018,10,5,7,1120,1189,2247,1058
2018,10,5,8,1105,1176,2271,1095
2018,10,5,9,1100,1156,2282,1126
2018,10,5,10,1110,1155,2283,1128
2018,10,5,11,1110,1168,2276,1108
2018,10,5,12,1170,1240,2308,1068
2018,10,5,13,1285,1333,2296,963
2018,10,5,14,1375,1421,2306,885
2018,10,5,15,1380,1423,2313,890
2018,10,5,16,1380,1409,2353,944
2018,10,5,17,1370,1384,2369,985
2018,10,5,18,1355,1357,2363,1006
2018,10,5,19,1340,1346,2367,1021
2018,10,5,20,1335,1339,2344,1005
2018,10,5,21,1315,1325,2363,1038
2018,10,5,22,1310,1315,2334,1019
2018,10,5,23,1305,1313,2319,1006
2018,10,6,0,1305,1308,2349,1041
2018,10,6,1,1315,1309,2377,1068
2018,10,6,2,1350,1353,2465,1112
2018,10,6,3,1345,1340,2435,1095
2018,10,6,4,1285,1301,2438,1137
2018,10,6,5,1225,1257,2508,1251
2018,10,6,6,1165,1205,2464,1259
2018,10,6,7,1115,1161,2451,1290
2018,10,6,8,1105,1140,2484,1344
2018,10,6,9,1085,1133,2484,1351
2018,10,6,10,1085,1131,2483,1352
2018,10,6,11,1095,1144,2485,1341
2018,10,6,12,1120,1168,2471,1303
2018,10,6,13,1190,1221,2531,1310
2018,10,6,14,1255,1271,2543,1272
2018,10,6,15,1285,1313,2571,1258
2018,10,6,16,1325,1348,2578,1230
2018,10,6,17,1330,1343,2572,1229
2018,10,6,18,1325,1338,2586,1248
2018,10,6,19,1320,1322,2587,1265
2018,10,6,20,1315,1310,2571,1261
2018,10,6,21,1315,1290,2572,1282
2018,10,6,22,1305,1283,2574,1291
2018,10,6,23,1315,1291,2590,1299
2018,10,7,0,1325,1297,2597,1300
2018,10,7,1,1345,1313,2592,1279
2018,10,7,2,1370,1350,2581,1231
2018,10,7,3,1350,1335,2577,1242
2018,10,7,4,1300,1292,2556,1264
2018,10,7,5,1240,1240,2534,1294
2018,10,7,6,1190,1180,2488,1308
2018,10,7,7,1125,1135,2484,1349
2018,10,7,8,1120,1126,2515,1389
2018,10,7,9,1105,1115,2521,1406
2018,10,7,10,1105,1114,2532,1418
2018,10,7,11,1110,1122,2546,1424
2018,10,7,12,1140,1147,2556,1409
2018,10,7,13,1180,1180,2577,1397
2018,10,7,14,1245,1236,2619,1383
2018,10,7,15,1290,1273,2626,1353
2018,10,7,16,1330,1307,2593,1286
2018,10,7,17,1345,1320,2586,1266
2018,10,7,18,1355,1319,2575,1256
2018,10,7,19,1370,1304,2560,1256
2018,10,7,20,1345,1292,2545,1253
2018,10,7,21,1325,1278,2535,1257
2018,10,7,22,1325,1278,2542,1264
2018,10,7,23,1340,1286,2533,1247
2018,10,8,0,1350,1300,2520,1220
2018,10,8,1,1365,1327,2504,1177
2018,10,8,2,1390,1368,2525,1157
2018,10,8,3,1375,1369,2524,1155
2018,10,8,4,1315,1312,2524,1212
2018,10,8,5,1230,1249,2513,1264
2018,10,8,6,1155,1175,2480,1305
2018,10,8,7,1135,1137,2434,1297
2018,10,8,8,1120,1119,2401,1282
2018,10,8,9,1115,1113,2402,1289
2018,10,8,10,1110,1114,2396,1282
2018,10,8,11,1135,1128,2400,1272
2018,10,8,12,1190,1194,2401,1207
2018,10,8,13,1310,1304,2405,1101
2018,10,8,14,1395,1399,2495,1096
2018,10,8,15,1400,1399,2494,1095
2018,10,8,16,1390,1410,2497,1087
2018,10,8,17,1390,1410,2543,1133
2018,10,8,18,1365,1403,2570,1167
2018,10,8,19,1350,1373,2530,1157
2018,10,8,20,1340,1362,2523,1161
2018,10,8,21,1330,1340,2503,1163
2018,10,8,22,1330,1343,2517,1174
2018,10,8,23,1320,1327,2507,1180
2018,10,9,0,1325,1339,2533,1194
2018,10,9,1,1345,1373,2538,1165
2018,10,9,2,1395,1425,2559,1134
2018,10,9,3,1395,1400,2563,1163
2018,10,9,4,1325,1343,2558,1215
2018,10,9,5,1255,1266,2531,1265
2018,10,9,6,1190,1203,2446,1243
2018,10,9,7,1090,1162,2421,1259
2018,10,9,8,1075,1166,2494,1328
2018,10,9,9,1065,1141,2493,1352
2018,10,9,10,1065,1160,2503,1343
2018,10,9,11,1085,1166,2520,1354
2018,10,9,12,1130,1217,2525,1308
2018,10,9,13,1255,1368,2564,1196
2018,10,9,14,1360,1461,2532,1071
2018,10,9,15,1365,1465,2524,1059
2018,10,9,16,1355,1469,2579,1110
2018,10,9,17,1360,1481,2563,1082
2018,10,9,18,1340,1478,2552,1074
2018,10,9,19,1340,1488,2585,1097
2018,10,9,20,1335,1465,2604,1139
2018,10,9,21,1335,1464,2634,1170
2018,10,9,22,1330,1463,2651,1188
2018,10,9,23,1335,1465,2625,1160
2018,10,10,0,1335,1467,2655,1188
2018,10,10,1,1350,1499,2656,1157
2018,10,10,2,1385,1516,2650,1134
2018,10,10,3,1375,1491,2674,1183
2018,10,10,4,1315,1415,2681,1266
2018,10,10,5,1230,1326,2663,1337
2018,10,10,6,1170,1276,2644,1368
2018,10,10,7,1135,1242,2612,1370
2018,10,10,8,1120,1215,2593,1378
2018,10,10,9,1115,1221,2573,1352
2018,10,10,10,1110,1212,2564,1352
2018,10,10,11,1130,1217,2545,1328
2018,10,10,12,1195,1272,2543,1271
2018,10,10,13,1320,1406,2543,1137
2018,10,10,14,1410,1486,2570,1084
2018,10,10,15,1405,1475,2558,1083
2018,10,10,16,1400,1472,2514,1042
2018,10,10,17,1400,1463,2488,1025
2018,10,10,18,1385,1461,2539,1078
2018,10,10,19,1365,1438,2529,1091
2018,10,10,20,1355,1427,2532,1105
2018,10,10,21,1340,1406,2520,1114
2018,10,10,22,1340,1417,2539,1122
2018,10,10,23,1330,1410,2537,1127
2018,10,11,0,1345,1428,2551,1123
2018,10,11,1,1360,1455,2542,1087
2018,10,11,2,1415,1501,2538,1037
2018,10,11,3,1410,1476,2534,1058
2018,10,11,4,1340,1416,2524,1108
2018,10,11,5,1265,1334,2516,1182
2018,10,11,6,1195,1284,2550,1266
2018,10,11,7,1155,1211,2552,1341
2018,10,11,8,1150,1191,2102,911
2018,10,11,9,1135,1194,1775,581
2018,10,11,10,1140,1198,1832,634
2018,10,11,11,1155,1190,1935,745
2018,10,11,12,1200,1237,2067,830
2018,10,11,13,1320,1365,2064,699
2018,10,11,14,1400,1487,2384,897
2018,10,11,15,1405,1505,2512,1007
2018,10,11,16,1405,1487,2541,1054
2018,10,11,17,1415,1469,2516,1047
2018,10,11,18,1400,1447,2576,1129
2018,10,11,19,1400,1417,2597,1180
2018,10,11,20,1385,1396,2588,1192
2018,10,11,21,1385,1386,2588,1202
2018,10,11,22,1380,1383,2603,1220
2018,10,11,23,1385,1369,2601,1232
2018,10,12,0,1390,1360,2584,1224
2018,10,12,1,1415,1379,2573,1194
2018,10,12,2,1440,1419,2562,1143
2018,10,12,3,1420,1416,2577,1161
2018,10,12,4,1380,1352,2597,1245
2018,10,12,5,1275,1280,2611,1331
2018,10,12,6,1215,1213,2587,1374
2018,10,12,7,1120,1241,2661,1420
2018,10,12,8,1105,1180,2680,1500
2018,10,12,9,1100,1195,2677,1482
2018,10,12,10,1100,1187,2639,1452
2018,10,12,11,1105,1200,2598,1398
2018,10,12,12,1170,1262,2672,1410
2018,10,12,13,1285,1386,2718,1332
2018,10,12,14,1375,1457,2752,1295
2018,10,12,15,1375,1459,2802,1343
2018,10,12,16,1370,1444,2814,1370
2018,10,12,17,1355,1416,2803,1387
2018,10,12,18,1340,1409,2812,1403
2018,10,12,19,1325,1394,2815,1421
2018,10,12,20,1320,1377,2793,1416
2018,10,12,21,1295,1359,2795,1436
2018,10,12,22,1295,1347,2800,1453
2018,10,12,23,1295,1335,2801,1466
2018,10,13,0,1295,1331,2814,1483
2018,10,13,1,1305,1350,2815,1465
2018,10,13,2,1345,1373,2777,1404
2018,10,13,3,1330,1351,2739,1388
2018,10,13,4,1295,1320,2744,1424
2018,10,13,5,1220,1268,2770,1502
2018,10,13,6,1170,1219,2728,1509
2018,10,13,7,1150,1190,2765,1575
2018,10,13,8,1135,1181,2758,1577
2018,10,13,9,1120,1171,2744,1573
2018,10,13,10,1120,1169,2745,1576
2018,10,13,11,1130,1160,2736,1576
2018,10,13,12,1150,1199,2745,1546
2018,10,13,13,1195,1262,2740,1478
2018,10,13,14,1245,1348,2817,1469
2018,10,13,15,1285,1384,2806,1422
2018,10,13,16,1320,1411,2808,1397
2018,10,13,17,1325,1431,2837,1406
2018,10,13,18,1320,1436,2830,1394
2018,10,13,19,1310,1398,2820,1422
2018,10,13,20,1300,1381,2798,1417
2018,10,13,21,1285,1372,2820,1448
2018,10,13,22,1285,1374,2828,1454
2018,10,13,23,1290,1391,2818,1427
2018,10,14,0,1300,1397,2784,1387
2018,10,14,1,1320,1436,2816,1380
2018,10,14,2,1355,1450,2767,1317
2018,10,14,3,1340,1423,2697,1274
2018,10,14,4,1280,1391,2690,1299
2018,10,14,5,1235,1328,2663,1335
2018,10,14,6,1175,1268,2554,1286
2018,10,14,7,1170,1237,2443,1206
2018,10,14,8,1155,1216,2387,1171
2018,10,14,9,1145,1197,2360,1163
2018,10,14,10,1145,1197,2363,1166
2018,10,14,11,1150,1215,2387,1172
2018,10,14,12,1175,1236,2364,1128
2018,10,14,13,1205,1268,2348,1080
2018,10,14,14,1255,1310,2363,1053
2018,10,14,15,1300,1359,2410,1051
2018,10,14,16,1340,1391,2404,1013
2018,10,14,17,1350,1382,2386,1004
2018,10,14,18,1350,1365,2393,1028
2018,10,14,19,1345,1362,2412,1050
2018,10,14,20,1330,1335,2416,1081
2018,10,14,21,1310,1311,2405,1094
2018,10,14,22,1310,1314,2443,1129
2018,10,14,23,1320,1318,2460,1142
2018,10,15,0,1335,1354,2456,1102
2018,10,15,1,1355,1393,2463,1070
2018,10,15,2,1390,1450,2437,987
2018,10,15,3,1380,1420,2429,1009
2018,10,15,4,1320,1375,2448,1073
2018,10,15,5,1255,1326,2483,1157
2018,10,15,6,1185,1258,2506,1248
2018,10,15,7,1140,1229,2524,1295
2018,10,15,8,1120,1218,2546,1328
2018,10,15,9,1115,1211,2559,1348
2018,10,15,10,1115,1215,2560,1345
2018,10,15,11,1130,1233,2563,1330
2018,10,15,12,1190,1290,2558,1268
2018,10,15,13,1305,1417,2563,1146
2018,10,15,14,1390,1494,2584,1090
2018,10,15,15,1385,1493,2572,1079
2018,10,15,16,1385,1486,2574,1088
2018,10,15,17,1375,1478,2563,1085
2018,10,15,18,1370,1454,2553,1099
2018,10,15,19,1340,1418,2556,1138
2018,10,15,20,1335,1412,2525,1113
2018,10,15,21,1320,1376,2518,1142
2018,10,15,22,1320,1355,2520,1165
2018,10,15,23,1310,1346,2524,1178
2018,10,16,0,1320,1361,2560,1199
2018,10,16,1,1345,1384,2551,1167
2018,10,16,2,1390,1450,2566,1116
2018,10,16,3,1365,1433,2551,1118
2018,10,16,4,1305,1384,2535,1151
2018,10,16,5,1230,1299,2501,1202
2018,10,16,6,1165,1225,2470,1245
2018,10,16,7,1175,1204,2488,1284
2018,10,16,8,1170,1190,2505,1315
2018,10,16,9,1155,1140,2482,1342
2018,10,16,10,1165,1145,2453,1308
2018,10,16,11,1170,1148,2424,1276
2018,10,16,12,1215,1213,2412,1199
2018,10,16,13,1310,1335,2381,1046
2018,10,16,14,1380,1457,2373,916
2018,10,16,15,1385,1441,2335,894
2018,10,16,16,1380,1421,2324,903
2018,10,16,17,1390,1386,2328,942
2018,10,16,18,1375,1356,2335,979
2018,10,16,19,1375,1334,2355,1021
2018,10,16,20,1365,1329,2357,1028
2018,10,16,21,1360,1324,2366,1042
2018,10,16,22,1355,1304,2350,1046
2018,10,16,23,1355,1300,2441,1141
2018,10,17,0,1355,1309,2501,1192
2018,10,17,1,1380,1349,2583,1234
2018,10,17,2,1405,1405,2615,1210
2018,10,17,3,1385,1376,2633,1257
2018,10,17,4,1310,1326,2613,1287
2018,10,17,5,1235,1235,2597,1362
2018,10,17,6,1180,1179,2604,1425
2018,10,17,7,1165,1145,2591,1446
2018,10,17,8,1145,1124,2599,1475
2018,10,17,9,1145,1120,2597,1477
2018,10,17,10,1140,1108,2582,1474
2018,10,17,11,1155,1118,2528,1410
2018,10,17,12,1215,1188,2601,1413
2018,10,17,13,1350,1323,2617,1294
2018,10,17,14,1440,1408,2649,1241
2018,10,17,15,1435,1382,2649,1267
2018,10,17,16,1430,1359,2602,1243
2018,10,17,17,1425,1354,2631,1277
2018,10,17,18,1415,1324,2636,1312
2018,10,17,19,1385,1296,2614,1318
2018,10,17,20,1375,1288,2617,1329
2018,10,17,21,1355,1278,2575,1297
2018,10,17,22,1355,1264,2597,1333
2018,10,17,23,1345,1255,2622,1367
2018,10,18,0,1360,1244,2610,1366
2018,10,18,1,1380,1292,2647,1355
2018,10,18,2,1435,1346,2660,1314
2018,10,18,3,1440,1323,2665,1342
2018,10,18,4,1380,1267,2652,1385
2018,10,18,5,1280,1198,2645,1447
2018,10,18,6,1215,1147,2624,1477
2018,10,18,7,1140,1112,2634,1522
2018,10,18,8,1130,1102,2647,1545
2018,10,18,9,1110,1121,2671,1550
2018,10,18,10,1115,1135,2649,1514
2018,10,18,11,1115,1158,2645,1487
2018,10,18,12,1170,1203,2667,1464
2018,10,18,13,1300,1310,2710,1400
2018,10,18,14,1425,1384,2742,1358
2018,10,18,15,1425,1388,2766,1378
2018,10,18,16,1410,1368,2734,1366
2018,10,18,17,1390,1349,2721,1372
2018,10,18,18,1365,1304,2691,1387
2018,10,18,19,1340,1296,2678,1382
2018,10,18,20,1325,1284,2676,1392
2018,10,18,21,1320,1276,2695,1419
2018,10,18,22,1310,1270,2690,1420
2018,10,18,23,1300,1269,2727,1458
2018,10,19,0,1300,1269,2715,1446
2018,10,19,1,1330,1303,2716,1413
2018,10,19,2,1375,1346,2659,1313
2018,10,19,3,1355,1332,2641,1309
2018,10,19,4,1295,1280,2631,1351
2018,10,19,5,1220,1213,2660,1447
2018,10,19,6,1160,1165,2673,1508
2018,10,19,7,1185,1120,2648,1528
2018,10,19,8,1150,1110,2615,1505
2018,10,19,9,1150,1101,2627,1526
2018,10,19,10,1145,1098,2610,1512
2018,10,19,11,1155,1133,2597,1464
2018,10,19,12,1225,1170,2592,1422
2018,10,19,13,1320,1271,2560,1289
2018,10,19,14,1375,1392,2574,1182
2018,10,19,15,1365,1388,2554,1166
2018,10,19,16,1345,1381,2618,1237
2018,10,19,17,1325,1370,2630,1260
2018,10,19,18,1310,1358,2634,1276
2018,10,19,19,1290,1335,2627,1292
2018,10,19,20,1280,1317,2624,1307
2018,10,19,21,1260,1319,2630,1311
2018,10,19,22,1250,1296,2662,1366
2018,10,19,23,1240,1297,2706,1409
2018,10,20,0,1235,1295,2703,1408
2018,10,20,1,1260,1295,2703,1408
2018,10,20,2,1305,1338,2666,1328
2018,10,20,3,1280,1307,2611,1304
2018,10,20,4,1240,1266,2593,1327
2018,10,20,5,1185,1205,2604,1399
2018,10,20,6,1130,1153,2597,1444
2018,10,20,7,1100,1134,2569,1435
2018,10,20,8,1095,1117,2526,1409
2018,10,20,9,1080,1112,2566,1454
2018,10,20,10,1070,1125,2513,1388
2018,10,20,11,1075,1107,2184,1077
2018,10,20,12,1100,1141,2120,979
2018,10,20,13,1150,1165,2133,968
2018,10,20,14,1220,1229,2157,928
2018,10,20,15,1260,1282,2157,875
2018,10,20,16,1290,1308,2178,870
2018,10,20,17,1300,1300,2211,911
2018,10,20,18,1295,1305,2294,989
2018,10,20,19,1275,1288,2265,977
2018,10,20,20,1255,1276,2263,987
2018,10,20,21,1240,1257,2251,994
2018,10,20,22,1245,1233,2287,1054
2018,10,20,23,1250,1255,2298,1043
2018,10,21,0,1270,1265,2292,1027
2018,10,21,1,1300,1294,2484,1190
2018,10,21,2,1335,1340,2590,1250
2018,10,21,3,1310,1298,2553,1255
2018,10,21,4,1275,1270,2621,1351
2018,10,21,5,1220,1191,2609,1418
2018,10,21,6,1160,1134,2586,1452
2018,10,21,7,1105,1107,2612,1505
2018,10,21,8,1100,1086,2643,1557
2018,10,21,9,1085,1077,2641,1564
2018,10,21,10,1075,1083,2602,1519
2018,10,21,11,1080,1071,2239,1168
2018,10,21,12,1105,1074,2080,1006
2018,10,21,13,1155,1117,2111,994
2018,10,21,14,1230,1168,2081,913
2018,10,21,15,1265,1213,2074,861
2018,10,21,16,1300,1247,2117,870
2018,10,21,17,1310,1250,2119,869
2018,10,21,18,1305,1229,2126,897
2018,10,21,19,1290,1226,2124,898
2018,10,21,20,1265,1232,2139,907
2018,10,21,21,1250,1230,2140,910
2018,10,21,22,1255,1224,2127,903
2018,10,21,23,1265,1228,2144,916
2018,10,22,0,1280,1240,2198,958
2018,10,22,1,1315,1309,2416,1107
2018,10,22,2,1355,1356,2540,1184
2018,10,22,3,1330,1329,2656,1327
2018,10,22,4,1285,1266,2620,1354
2018,10,22,5,1235,1177,2596,1419
2018,10,22,6,1175,1110,2586,1476
2018,10,22,7,1095,1086,2599,1513
2018,10,22,8,1080,1065,2555,1490
2018,10,22,9,1070,1074,2552,1478
2018,10,22,10,1070,1069,2525,1456
2018,10,22,11,1085,1104,2456,1352
2018,10,22,12,1150,1152,2496,1344
2018,10,22,13,1295,1278,2535,1257
2018,10,22,14,1395,1386,2545,1159
2018,10,22,15,1385,1378,2539,1161
2018,10,22,16,1375,1382,2541,1159
2018,10,22,17,1365,1356,2544,1188
2018,10,22,18,1345,1335,2574,1239
2018,10,22,19,1310,1333,2585,1252
2018,10,22,20,1305,1304,2568,1264
2018,10,22,21,1280,1296,2571,1275
2018,10,22,22,1265,1294,2576,1282
2018,10,22,23,1255,1302,2594,1292
2018,10,23,0,1260,1310,2599,1289
2018,10,23,1,1295,1364,2683,1319
2018,10,23,2,1355,1402,2690,1288
2018,10,23,3,1330,1374,2691,1317
2018,10,23,4,1280,1324,2687,1363
2018,10,23,5,1205,1244,2678,1434
2018,10,23,6,1140,1171,2619,1448
2018,10,23,7,1085,1153,2628,1475
2018,10,23,8,1075,1129,2555,1426
2018,10,23,9,1060,1118,2550,1432
2018,10,23,10,1070,1124,2553,1429
2018,10,23,11,1085,1136,2417,1281
2018,10,23,12,1140,1193,2441,1248
2018,10,23,13,1255,1324,2421,1097
2018,10,23,14,1350,1394,2421,1027
2018,10,23,15,1345,1382,2356,974
2018,10,23,16,1330,1364,2354,990
2018,10,23,17,1310,1353,2365,1012
2018,10,23,18,1275,1332,2369,1037
2018,10,23,19,1270,1319,2371,1052
2018,10,23,20,1255,1308,2364,1056
2018,10,23,21,1250,1298,2414,1116
2018,10,23,22,1240,1296,2433,1137
2018,10,23,23,1240,1290,2414,1124
2018,10,24,0,1240,1293,2428,1135
2018,10,24,1,1275,1353,2585,1232
2018,10,24,2,1320,1382,2636,1254
2018,10,24,3,1295,1359,2662,1303
2018,10,24,4,1245,1292,2644,1352
2018,10,24,5,1165,1216,2643,1427
2018,10,24,6,1115,1164,2713,1549
2018,10,24,7,1065,1131,2755,1624
2018,10,24,8,1045,1124,2720,1596
2018,10,24,9,1045,1113,2726,1613
2018,10,24,10,1040,1129,2745,1616
2018,10,24,11,1060,1150,2522,1372
2018,10,24,12,1120,1190,2497,1307
2018,10,24,13,1260,1318,2501,1183
2018,10,24,14,1365,1399,2536,1137
2018,10,24,15,1350,1377,2511,1134
2018,10,24,16,1340,1380,2500,1120
2018,10,24,17,1325,1369,2521,1152
2018,10,24,18,1305,1351,2570,1219
2018,10,24,19,1285,1354,2592,1238
2018,10,24,20,1270,1336,2560,1224
2018,10,24,21,1260,1326,2576,1250
2018,10,24,22,1255,1318,2550,1232
2018,10,24,23,1250,1311,2509,1198
2018,10,25,0,1255,1308,2436,1128
2018,10,25,1,1295,1359,2551,1192
2018,10,25,2,1345,1390,2609,1219
2018,10,25,3,1315,1367,2621,1254
2018,10,25,4,1265,1311,2648,1337
2018,10,25,5,1190,1236,2656,1420
2018,10,25,6,1130,1169,2634,1465
2018,10,25,7,1075,1129,2571,1442
2018,10,25,8,1060,1133,2600,1467
2018,10,25,9,1065,1129,2613,1484
2018,10,25,10,1075,1125,2630,1505
2018,10,25,11,1090,1121,2410,1289
2018,10,25,12,1145,1195,2381,1186
2018,10,25,13,1275,1298,2353,1055
2018,10,25,14,1370,1386,2389,1003
2018,10,25,15,1370,1386,2445,1059
2018,10,25,16,1350,1378,2467,1089
2018,10,25,17,1335,1367,2478,1111
2018,10,25,18,1300,1366,2489,1123
2018,10,25,19,1290,1362,2507,1145
2018,10,25,20,1275,1354,2478,1124
2018,10,25,21,1265,1332,2477,1145
2018,10,25,22,1260,1317,2436,1119
2018,10,25,23,1255,1324,2508,1184
2018,10,26,0,1255,1328,2506,1178
2018,10,26,1,1300,1381,2660,1279
2018,10,26,2,1335,1406,2790,1384
2018,10,26,3,1315,1402,2865,1463
2018,10,26,4,1270,1338,2877,1539
2018,10,26,5,1185,1244,2825,1581
2018,10,26,6,1130,1193,2777,1584
2018,10,26,7,1095,1155,2780,1625
2018,10,26,8,1075,1157,2826,1669
2018,10,26,9,1070,1140,2786,1646
2018,10,26,10,1080,1149,2824,1675
2018,10,26,11,1105,1156,2805,1649
2018,10,26,12,1150,1214,2841,1627
2018,10,26,13,1275,1293,2831,1538
2018,10,26,14,1370,1400,2860,1460
2018,10,26,15,1360,1391,2846,1455
2018,10,26,16,1355,1387,2775,1388
2018,10,26,17,1340,1388,2831,1443
2018,10,26,18,1325,1377,2859,1482
2018,10,26,19,1315,1361,2886,1525
2018,10,26,20,1300,1357,2888,1531
2018,10,26,21,1290,1344,2889,1545
2018,10,26,22,1275,1332,2866,1534
2018,10,26,23,1270,1326,2901,1575
2018,10,27,0,1270,1321,2887,1566
2018,10,27,1,1290,1351,2808,1457
2018,10,27,2,1325,1351,2851,1500
2018,10,27,3,1300,1337,2847,1510
2018,10,27,4,1240,1320,2894,1574
2018,10,27,5,1190,1257,2814,1557
2018,10,27,6,1130,1201,2800,1599
2018,10,27,7,1130,1155,2782,1627
2018,10,27,8,1115,1132,2810,1678
2018,10,27,9,1105,1126,2811,1685
2018,10,27,10,1110,1118,2827,1709
2018,10,27,11,1105,1113,2809,1696
2018,10,27,12,1130,1137,2902,1765
2018,10,27,13,1170,1158,2895,1737
2018,10,27,14,1235,1236,2874,1638
2018,10,27,15,1280,1262,2837,1575
2018,10,27,16,1315,1296,2814,1518
2018,10,27,17,1315,1299,2779,1480
2018,10,27,18,1305,1303,2759,1456
2018,10,27,19,1295,1319,2790,1471
2018,10,27,20,1290,1294,2781,1487
2018,10,27,21,1275,1269,2828,1559
2018,10,27,22,1260,1261,2892,1631
2018,10,27,23,1280,1263,2892,1629
2018,10,28,0,1285,1276,2905,1629
2018,10,28,1,1330,1323,2879,1556
2018,10,28,2,1365,1319,2811,1492
2018,10,28,3,1330,1299,2788,1489
2018,10,28,4,1300,1270,2748,1478
2018,10,28,5,1205,1219,2721,1502
2018,10,28,6,1140,1173,2692,1519
2018,10,28,7,1140,1140,2650,1510
2018,10,28,8,1120,1131,2625,1494
2018,10,28,9,1110,1118,2619,1501
2018,10,28,10,1115,1115,2598,1483
2018,10,28,11,1120,1124,2598,1474
2018,10,28,12,1135,1146,2599,1453
2018,10,28,13,1165,1188,2612,1424
2018,10,28,14,1205,1230,2589,1359
2018,10,28,15,1250,1262,2520,1258
2018,10,28,16,1280,1280,2426,1146
2018,10,28,17,1280,1292,2343,1051
2018,10,28,18,1265,1282,2247,965
2018,10,28,19,1260,1270,2293,1023
2018,10,28,20,1250,1263,2410,1147
2018,10,28,21,1235,1292,2523,1231
2018,10,28,22,1225,1303,2602,1299
2018,10,28,23,1240,1342,2716,1374
2018,10,29,0,1255,1365,2788,1423
2018,10,29,1,1305,1408,2767,1359
2018,10,29,2,1350,1404,2721,1317
2018,10,29,3,1320,1370,2796,1426
2018,10,29,4,1250,1324,2782,1458
2018,10,29,5,1195,1246,2760,1514
2018,10,29,6,1130,1184,2696,1512
2018,10,29,7,1150,1163,2719,1556
2018,10,29,8,1135,1141,2716,1575
2018,10,29,9,1130,1139,2702,1563
2018,10,29,10,1135,1125,2732,1607
2018,10,29,11,1165,1145,2737,1592
2018,10,29,12,1215,1201,2734,1533
2018,10,29,13,1345,1319,2697,1378
2018,10,29,14,1430,1419,2756,1337
2018,10,29,15,1420,1425,2685,1260
2018,10,29,16,1425,1422,2626,1204
2018,10,29,17,1405,1415,2715,1300
2018,10,29,18,1385,1396,2663,1267
2018,10,29,19,1365,1382,2700,1318
2018,10,29,20,1345,1392,2754,1362
2018,10,29,21,1330,1407,2793,1386
2018,10,29,22,1320,1393,2842,1449
2018,10,29,23,1320,1404,2829,1425
2018,10,30,0,1330,1413,2758,1345
2018,10,30,1,1370,1470,2784,1314
2018,10,30,2,1415,1489,2780,1291
2018,10,30,3,1390,1466,2786,1320
2018,10,30,4,1340,1411,2785,1374
2018,10,30,5,1260,1346,2831,1485
2018,10,30,6,1180,1282,2730,1448
2018,10,30,7,1120,1219,2650,1431
2018,10,30,8,1110,1202,2703,1501
2018,10,30,9,1095,1202,2705,1503
2018,10,30,10,1095,1202,2710,1508
2018,10,30,11,1105,1224,2703,1479
2018,10,30,12,1175,1271,2729,1458
2018,10,30,13,1315,1390,2793,1403
2018,10,30,14,1420,1492,2858,1366
2018,10,30,15,1410,1490,2849,1359
2018,10,30,16,1405,1459,2817,1358
2018,10,30,17,1385,1458,2834,1376
2018,10,30,18,1370,1434,2822,1388
2018,10,30,19,1355,1424,2812,1388
2018,10,30,20,1345,1415,2828,1413
2018,10,30,21,1330,1417,2884,1467
2018,10,30,22,1320,1429,2903,1474
2018,10,30,23,1320,1441,2879,1438
2018,10,31,0,1325,1437,2876,1439
2018,10,31,1,1375,1499,2896,1397
2018,10,31,2,1405,1508,2846,1338
2018,10,31,3,1385,1491,2844,1353
2018,10,31,4,1320,1441,2837,1396
2018,10,31,5,1230,1352,2697,1345
2018,10,31,6,1175,1286,2535,1249
2018,10,31,7,1165,1231,2433,1202
2018,10,31,8,1150,1219,2390,1171
2018,10,31,9,1140,1207,2407,1200
2018,10,31,10,1145,1215,2416,1201
2018,10,31,11,1155,1233,2433,1200
2018,10,31,12,1215,1276,2452,1176
2018,10,31,13,1345,1393,2520,1127
2018,10,31,14,1430,1502,2535,1033
2018,10,31,15,1415,1464,2436,972
2018,10,31,16,1415,1448,2276,828
2018,10,31,17,1405,1446,2057,611
2018,10,31,18,1385,1434,2039,605
2018,10,31,19,1375,1436,2066,630
2018,10,31,20,1370,1438,2138,700
2018,10,31,21,1365,1446,2403,957
2018,10,31,22,1355,1444,2471,1027
2018,10,31,23,1355,1449,2653,1204
2018,11,1,0,1355,1464,2781,1317
2018,11,1,1,1410,1459,2763,1304
2018,11,1,2,1440,1446,2755,1309
2018,11,1,3,1415,1440,2805,1365
2018,11,1,4,1350,1409,2773,1364
2018,11,1,5,1280,1351,2782,1431
2018,11,1,6,1215,1278,2697,1419
2018,11,1,7,1155,1186,2595,1409
2018,11,1,8,1150,1185,2662,1477
2018,11,1,9,1150,1204,2686,1482
2018,11,1,10,1150,1206,2708,1502
2018,11,1,11,1170,1216,2706,1490
2018,11,1,12,1230,1264,2678,1414
2018,11,1,13,1355,1370,2746,1376
2018,11,1,14,1455,1460,2799,1339
2018,11,1,15,1455,1461,2786,1325
2018,11,1,16,1445,1438,2742,1304
2018,11,1,17,1430,1443,2737,1294
2018,11,1,18,1415,1439,2749,1310
2018,11,1,19,1400,1416,2723,1307
2018,11,1,20,1390,1406,2715,1309
2018,11,1,21,1380,1369,2710,1341
2018,11,1,22,1375,1372,2710,1338
2018,11,1,23,1385,1381,2717,1336
2018,11,2,0,1395,1390,2670,1280
2018,11,2,1,1440,1445,2731,1286
2018,11,2,2,1460,1442,2699,1257
2018,11,2,3,1450,1408,2646,1238
2018,11,2,4,1390,1366,2606,1240
2018,11,2,5,1300,1291,2560,1269
2018,11,2,6,1240,1225,2492,1267
2018,11,2,7,1150,1186,2484,1298
2018,11,2,8,1150,1160,2573,1413
2018,11,2,9,1130,1140,2598,1458
2018,11,2,10,1140,1143,2655,1512
2018,11,2,11,1155,1161,2611,1450
2018,11,2,12,1205,1219,2660,1441
2018,11,2,13,1305,1322,2692,1370
2018,11,2,14,1425,1411,2756,1345
2018,11,2,15,1405,1434,2812,1378
2018,11,2,16,1395,1395,2777,1382
2018,11,2,17,1400,1410,2778,1368
2018,11,2,18,1385,1416,2832,1416
2018,11,2,19,1380,1414,2879,1465
2018,11,2,20,1370,1401,2830,1429
2018,11,2,21,1365,1393,2804,1411
2018,11,2,22,1350,1394,2829,1435
2018,11,2,23,1345,1399,2836,1437
2018,11,3,0,1345,1392,2803,1411
2018,11,3,1,1360,1416,2823,1407
2018,11,3,2,1365,1404,2825,1421
2018,11,3,3,1355,1390,2791,1401
2018,11,3,4,1330,1367,2765,1398
2018,11,3,5,1275,1294,2739,1445
2018,11,3,6,1200,1250,2690,1440
2018,11,3,7,1105,1196,2645,1449
2018,11,3,8,1085,1167,2659,1492
2018,11,3,9,1085,1160,2701,1541
2018,11,3,10,1080,1168,2661,1493
2018,11,3,11,1075,1167,2699,1532
2018,11,3,12,1095,1179,2645,1466
2018,11,3,13,1145,1218,2618,1400
2018,11,3,14,1220,1286,2608,1322
2018,11,3,15,1255,1333,2649,1316
2018,11,3,16,1285,1352,2689,1337
2018,11,3,17,1290,1370,2720,1350
2018,11,3,18,1290,1368,2754,1386
2018,11,3,19,1290,1354,2759,1405
2018,11,3,20,1275,1347,2788,1441
2018,11,3,21,1265,1339,2754,1415
2018,11,3,22,1265,1340,2717,1377
2018,11,3,23,1285,1353,2692,1339
2018,11,4,0,1295,1377,2825,1448
2018,11,4,1,1340,1415,2851,1436
2018,11,4,2,1345,1418,2823,1405
2018,11,4,3,1315,1376,2833,1457
2018,11,4,4,1245,1343,2840,1497
2018,11,4,5,1205,1282,2751,1469
2018,11,4,6,1155,1233,2738,1505
2018,11,4,7,1100,1191,2730,1539
2018,11,4,8,1080,1176,2799,1623
2018,11,4,9,1080,1158,2769,1611
2018,11,4,10,1070,1156,2710,1554
2018,11,4,11,1070,1160,2654,1494
2018,11,4,12,1090,1166,2642,1476
2018,11,4,13,1160,1199,2677,1478
2018,11,4,14,1260,1255,2726,1471
2018,11,4,15,1295,1319,2785,1466
2018,11,4,16,1325,1364,2809,1445
2018,11,4,17,1335,1390,2736,1346
2018,11,4,18,1330,1393,2797,1404
2018,11,4,19,1330,1392,2855,1463
2018,11,4,20,1315,1393,2894,1501
2018,11,4,21,1310,1384,2869,1485
2018,11,4,22,1315,1371,2866,1495
2018,11,4,23,1335,1382,2895,1513
2018,11,5,0,1350,1411,2890,1479
2018,11,5,1,1400,1473,2818,1345
2018,11,5,2,1405,1473,2795,1322
2018,11,5,3,1375,1426,2786,1360
2018,11,5,4,1330,1362,2579,1217
2018,11,5,5,1255,1304,2646,1342
2018,11,5,6,1200,1227,2511,1284
2018,11,5,7,1170,1181,2474,1293
2018,11,5,8,1130,1156,2465,1309
2018,11,5,9,1110,1127,2580,1453
2018,11,5,10,1110,1124,2541,1417
2018,11,5,11,1100,1147,2570,1423
2018,11,5,12,1120,1155,2609,1454
2018,11,5,13,1180,1233,2711,1478
2018,11,5,14,1325,1352,2698,1346
2018,11,5,15,1460,1454,2694,1240
2018,11,5,16,1450,1428,2683,1255
2018,11,5,17,1445,1432,2711,1279
2018,11,5,18,1435,1416,2696,1280
2018,11,5,19,1420,1411,2722,1311
2018,11,5,20,1415,1391,2692,1301
2018,11,5,21,1410,1382,2652,1270
2018,11,5,22,1410,1388,2611,1223
2018,11,5,23,1405,1399,2642,1243
2018,11,6,0,1410,1449,2702,1253
2018,11,6,1,1420,1498,2734,1236
2018,11,6,2,1450,1510,2727,1217
2018,11,6,3,1465,1492,2706,1214
2018,11,6,4,1450,1453,2673,1220
2018,11,6,5,1300,1393,2672,1279
2018,11,6,6,1345,1327,2628,1301
2018,11,6,7,1260,1297,2602,1305
2018,11,6,8,1185,1286,2574,1288
2018,11,6,9,1175,1252,2586,1334
2018,11,6,10,1185,1259,2578,1319
2018,11,6,11,1185,1267,2606,1339
2018,11,6,12,1200,1290,2660,1370
2018,11,6,13,1250,1365,2632,1267
2018,11,6,14,1375,1464,2662,1198
2018,11,6,15,1470,1523,2702,1179
2018,11,6,16,1465,1527,2705,1178
2018,11,6,17,1445,1545,2680,1135
2018,11,6,18,1445,1519,2682,1163
2018,11,6,19,1425,1503,2701,1198
2018,11,6,20,1410,1477,2662,1185
2018,11,6,21,1400,1491,2653,1162
2018,11,6,22,1380,1478,2634,1156
2018,11,6,23,1385,1479,2676,1197
2018,11,7,0,1395,1509,2714,1205
2018,11,7,1,1415,1553,2707,1154
2018,11,7,2,1460,1565,2709,1144
2018,11,7,3,1465,1550,2702,1152
2018,11,7,4,1440,1501,2647,1146
2018,11,7,5,1390,1437,2607,1170
2018,11,7,6,1305,1354,2607,1253
2018,11,7,7,1235,1297,2613,1316
2018,11,7,8,1240,1282,2606,1324
2018,11,7,9,1220,1244,2402,1158
2018,11,7,10,1210,1241,2367,1126
2018,11,7,11,1225,1248,2377,1129
2018,11,7,12,1240,1269,2403,1134
2018,11,7,13,1310,1318,2446,1128
2018,11,7,14,1410,1479,2650,1171
2018,11,7,15,1500,1549,2704,1155
2018,11,7,16,1470,1541,2682,1141
2018,11,7,17,1465,1542,2709,1167
2018,11,7,18,1460,1525,2684,1159
2018,11,7,19,1450,1511,2706,1195
2018,11,7,20,1450,1505,2723,1218
2018,11,7,21,1435,1495,2736,1241
2018,11,7,22,1435,1504,2729,1225
2018,11,7,23,1435,1510,2726,1216
2018,11,8,0,1450,1551,2755,1204
2018,11,8,1,1475,1622,2764,1142
2018,11,8,2,1485,1637,2737,1100
2018,11,8,3,1475,1607,2716,1109
2018,11,8,4,1460,1578,2715,1137
2018,11,8,5,1425,1501,2630,1129
2018,11,8,6,1350,1396,2597,1201
2018,11,8,7,1270,1344,2658,1314
2018,11,8,8,1215,1309,2654,1345
2018,11,8,9,1210,1290,2498,1208
2018,11,8,10,1225,1286,2451,1165
2018,11,8,11,1230,1292,2455,1163
2018,11,8,12,1245,1317,2504,1187
2018,11,8,13,1305,1372,2636,1264
2018,11,8,14,1415,1503,2709,1206
2018,11,8,15,1500,1571,2845,1274
2018,11,8,16,1500,1565,2838,1273
2018,11,8,17,1500,1548,2842,1294
2018,11,8,18,1490,1522,2858,1336
2018,11,8,19,1480,1496,2847,1351
2018,11,8,20,1460,1476,2851,1375
2018,11,8,21,1460,1475,2831,1356
2018,11,8,22,1435,1456,2791,1335
2018,11,8,23,1430,1462,2800,1338
2018,11,9,0,1450,1499,2823,1324
2018,11,9,1,1475,1574,2853,1279
2018,11,9,2,1515,1596,2861,1265
2018,11,9,3,1510,1568,2837,1269
2018,11,9,4,1475,1552,2799,1247
2018,11,9,5,1430,1480,2724,1244
2018,11,9,6,1325,1415,2684,1269
2018,11,9,7,1265,1362,2605,1243
2018,11,9,8,1245,1317,2605,1288
2018,11,9,9,1225,1323,2607,1284
2018,11,9,10,1210,1328,2617,1289
2018,11,9,11,1215,1329,2632,1303
2018,11,9,12,1235,1346,2663,1317
2018,11,9,13,1290,1393,2750,1357
2018,11,9,14,1400,1513,2783,1270
2018,11,9,15,1480,1593,2852,1259
2018,11,9,16,1485,1579,2758,1179
2018,11,9,17,1470,1587,2853,1266
2018,11,9,18,1475,1567,2873,1306
2018,11,9,19,1470,1551,2863,1312
2018,11,9,20,1465,1524,2862,1338
2018,11,9,21,1450,1520,2847,1327
2018,11,9,22,1455,1530,2868,1338
2018,11,9,23,1450,1532,2874,1342
2018,11,10,0,1465,1559,2866,1307
2018,11,10,1,1490,1578,2809,1231
2018,11,10,2,1515,1560,2828,1268
2018,11,10,3,1495,1519,2824,1305
2018,11,10,4,1475,1499,2886,1387
2018,11,10,5,1445,1435,2599,1164
2018,11,10,6,1350,1364,2672,1308
2018,11,10,7,1295,1332,2658,1326
2018,11,10,8,1220,1283,2378,1095
2018,11,10,9,1195,1244,2207,963
2018,11,10,10,1185,1245,2316,1071
2018,11,10,11,1190,1240,2258,1018
2018,11,10,12,1190,1239,2379,1140
2018,11,10,13,1210,1286,2614,1328
2018,11,10,14,1250,1338,2646,1308
2018,11,10,15,1320,1405,2756,1351
2018,11,10,16,1360,1433,2790,1357
2018,11,10,17,1390,1469,2819,1350
2018,11,10,18,1400,1488,2870,1382
2018,11,10,19,1400,1458,2907,1449
2018,11,10,20,1400,1446,2915,1469
2018,11,10,21,1385,1429,2896,1467
2018,11,10,22,1375,1413,2866,1453
2018,11,10,23,1380,1432,2839,1407
2018,11,11,0,1395,1456,2825,1369
2018,11,11,1,1435,1525,2847,1322
2018,11,11,2,1460,1533,2816,1283
2018,11,11,3,1440,1503,2785,1282
2018,11,11,4,1395,1470,2756,1286
2018,11,11,5,1350,1420,2464,1044
2018,11,11,6,1280,1356,2327,971
2018,11,11,7,1235,1306,2361,1055
2018,11,11,8,1255,1276,2383,1107
2018,11,11,9,1235,1256,2115,859
2018,11,11,10,1220,1264,2129,865
2018,11,11,11,1225,1253,2138,885
2018,11,11,12,1230,1272,2335,1063
2018,11,11,13,1255,1302,2479,1177
2018,11,11,14,1295,1360,2515,1155
2018,11,11,15,1355,1417,2625,1208
2018,11,11,16,1400,1474,2665,1191
2018,11,11,17,1430,1493,2675,1182
2018,11,11,18,1440,1499,2684,1185
2018,11,11,19,1435,1489,2659,1170
2018,11,11,20,1430,1497,2708,1211
2018,11,11,21,1420,1489,2750,1261
2018,11,11,22,1415,1490,2728,1238
2018,11,11,23,1425,1504,2813,1309
2018,11,12,0,1445,1560,2882,1322
2018,11,12,1,1490,1640,2869,1229
2018,11,12,2,1515,1619,2852,1233
2018,11,12,3,1495,1585,2736,1151
2018,11,12,4,1440,1545,2528,983
2018,11,12,5,1380,1487,2491,1004
2018,11,12,6,1315,1400,2364,964
2018,11,12,7,1265,1335,2404,1069
2018,11,12,8,1225,1308,2405,1097
2018,11,12,9,1200,1307,2436,1129
2018,11,12,10,1195,1306,2458,1152
2018,11,12,11,1200,1303,2428,1125
2018,11,12,12,1215,1334,2490,1156
2018,11,12,13,1285,1385,2525,1140
2018,11,12,14,1390,1515,2576,1061
2018,11,12,15,1455,1584,2607,1023
2018,11,12,16,1440,1583,2596,1013
2018,11,12,17,1440,1569,2596,1027
2018,11,12,18,1430,1568,2601,1033
2018,11,12,19,1420,1545,2589,1044
2018,11,12,20,1405,1530,2608,1078
2018,11,12,21,1400,1499,2593,1094
2018,11,12,22,1405,1481,2591,1110
2018,11,12,23,1410,1503,2603,1100
2018,11,13,0,1450,1543,2612,1069
2018,11,13,1,1500,1619,2608,989
2018,11,13,2,1520,1618,2612,994
2018,11,13,3,1500,1597,2614,1017
2018,11,13,4,1470,1577,2627,1050
2018,11,13,5,1410,1501,2629,1128
2018,11,13,6,1320,1420,2632,1212
2018,11,13,7,1270,1353,2638,1285
2018,11,13,8,1280,1320,2636,1316
2018,11,13,9,1265,1307,2641,1334
2018,11,13,10,1270,1307,2652,1345
2018,11,13,11,1280,1310,2653,1343
2018,11,13,12,1300,1339,2639,1300
2018,11,13,13,1355,1375,2595,1220
2018,11,13,14,1430,1514,2594,1080
2018,11,13,15,1470,1588,2598,1010
2018,11,13,16,1470,1557,2592,1035
2018,11,13,17,1465,1550,2592,1042
2018,11,13,18,1455,1538,2597,1059
2018,11,13,19,1440,1517,2598,1081
2018,11,13,20,1425,1490,2600,1110
2018,11,13,21,1420,1470,2598,1128
2018,11,13,22,1410,1466,2622,1156
2018,11,13,23,1410,1459,2623,1164
2018,11,14,0,1435,1499,2621,1122
2018,11,14,1,1470,1585,2675,1090
2018,11,14,2,1500,1596,2674,1078
2018,11,14,3,1495,1577,2680,1103
2018,11,14,4,1460,1534,2674,1140
2018,11,14,5,1390,1460,2661,1201
2018,11,14,6,1320,1377,2665,1288
2018,11,14,7,1255,1331,2671,1340
2018,11,14,8,1245,1294,2657,1363
2018,11,14,9,1230,1287,2645,1358
2018,11,14,10,1225,1289,2647,1358
2018,11,14,11,1230,1285,2623,1338
2018,11,14,12,1250,1309,2603,1294
2018,11,14,13,1300,1362,2625,1263
2018,11,14,14,1410,1483,2597,1114
2018,11,14,15,1465,1544,2569,1025
2018,11,14,16,1450,1508,2602,1094
2018,11,14,17,1440,1512,2682,1170
2018,11,14,18,1435,1468,2638,1170
2018,11,14,19,1425,1485,2678,1193
2018,11,14,20,1415,1441,2718,1277
2018,11,14,21,1395,1430,2710,1280
2018,11,14,22,1395,1414,2731,1317
2018,11,14,23,1405,1416,2707,1291
2018,11,15,0,1440,1460,2677,1217
2018,11,15,1,1495,1538,2655,1117
2018,11,15,2,1505,1541,2599,1058
2018,11,15,3,1480,1541,2665,1124
2018,11,15,4,1460,1507,2733,1226
2018,11,15,5,1385,1444,2717,1273
2018,11,15,6,1320,1369,2808,1439
2018,11,15,7,1260,1301,2828,1527
2018,11,15,8,1250,1253,2833,1580
2018,11,15,9,1230,1245,2781,1536
2018,11,15,10,1235,1249,2793,1544
2018,11,15,11,1240,1260,2794,1534
2018,11,15,12,1270,1284,2824,1540
2018,11,15,13,1320,1337,2822,1485
2018,11,15,14,1440,1439,2847,1408
2018,11,15,15,1515,1522,2925,1403
2018,11,15,16,1500,1512,2945,1433
2018,11,15,17,1500,1491,2884,1393
2018,11,15,18,1485,1466,2849,1383
2018,11,15,19,1465,1463,2889,1426
2018,11,15,20,1445,1433,2959,1526
2018,11,15,21,1435,1409,2933,1524
2018,11,15,22,1425,1409,2932,1523
2018,11,15,23,1420,1409,2922,1513
2018,11,16,0,1455,1449,2953,1504
2018,11,16,1,1525,1507,2961,1454
2018,11,16,2,1540,1529,2918,1389
2018,11,16,3,1520,1506,2931,1425
2018,11,16,4,1480,1493,2941,1448
2018,11,16,5,1410,1429,2855,1426
2018,11,16,6,1330,1357,2864,1507
2018,11,16,7,1285,1310,2825,1515
2018,11,16,8,1210,1258,2805,1547
2018,11,16,9,1205,1203,2850,1647
2018,11,16,10,1205,1239,2924,1685
2018,11,16,11,1210,1243,2912,1669
2018,11,16,12,1230,1216,2899,1683
2018,11,16,13,1275,1308,2904,1596
2018,11,16,14,1405,1428,2910,1482
2018,11,16,15,1495,1509,2919,1410
2018,11,16,16,1480,1538,2961,1423
2018,11,16,17,1475,1557,2933,1376
2018,11,16,18,1450,1557,2949,1392
2018,11,16,19,1450,1561,2970,1409
2018,11,16,20,1420,1559,2991,1432
2018,11,16,21,1410,1550,2994,1444
2018,11,16,22,1405,1532,2978,1446
2018,11,16,23,1410,1525,2966,1441
2018,11,17,0,1440,1563,2948,1385
2018,11,17,1,1485,1615,2915,1300
2018,11,17,2,1485,1618,2890,1272
2018,11,17,3,1465,1590,2841,1251
2018,11,17,4,1440,1560,2830,1270
2018,11,17,5,1380,1534,2818,1284
2018,11,17,6,1320,1491,2814,1323
2018,11,17,7,1260,1412,2762,1350
2018,11,17,8,1290,1365,2678,1313
2018,11,17,9,1260,1353,2671,1318
2018,11,17,10,1265,1340,2686,1346
2018,11,17,11,1255,1339,2704,1365
2018,11,17,12,1260,1351,2720,1369
2018,11,17,13,1295,1366,2750,1384
2018,11,17,14,1320,1422,2758,1336
2018,11,17,15,1355,1474,2770,1296
2018,11,17,16,1395,1520,2788,1268
2018,11,17,17,1420,1526,2758,1232
2018,11,17,18,1435,1528,2758,1230
2018,11,17,19,1415,1528,2780,1252
2018,11,17,20,1410,1489,2757,1268
2018,11,17,21,1395,1457,2716,1259
2018,11,17,22,1390,1439,2786,1347
2018,11,17,23,1405,1436,2810,1374
2018,11,18,0,1440,1495,2870,1375
2018,11,18,1,1515,1587,2971,1384
2018,11,18,2,1510,1582,2958,1376
2018,11,18,3,1480,1573,2979,1406
2018,11,18,4,1445,1567,3002,1435
2018,11,18,5,1400,1518,2988,1470
2018,11,18,6,1335,1452,2945,1493
2018,11,18,7,1280,1396,2902,1506
2018,11,18,8,1260,1374,2906,1532
2018,11,18,9,1240,1367,2935,1568
2018,11,18,10,1245,1374,2938,1564
2018,11,18,11,1240,1367,2973,1606
2018,11,18,12,1255,1373,2983,1610
2018,11,18,13,1280,1403,2998,1595
2018,11,18,14,1325,1443,2984,1541
2018,11,18,15,1355,1485,2946,1461
2018,11,18,16,1395,1527,2947,1420
2018,11,18,17,1415,1551,2977,1426
2018,11,18,18,1420,1536,2972,1436
2018,11,18,19,1415,1511,2972,1461
2018,11,18,20,1415,1484,2974,1490
2018,11,18,21,1410,1459,2961,1502
2018,11,18,22,1400,1432,2777,1345
2018,11,18,23,1420,1444,2704,1260
2018,11,19,0,1470,1492,2733,1241
2018,11,19,1,1550,1580,2772,1192
2018,11,19,2,1535,1573,2738,1165
2018,11,19,3,1505,1541,2740,1199
2018,11,19,4,1475,1501,2732,1231
2018,11,19,5,1425,1447,2722,1275
2018,11,19,6,1335,1351,2722,1371
2018,11,19,7,1275,1306,2737,1431
2018,11,19,8,1270,1261,2727,1466
2018,11,19,9,1265,1253,2714,1461
2018,11,19,10,1260,1241,2708,1467
2018,11,19,11,1260,1243,2717,1474
2018,11,19,12,1290,1265,2725,1460
2018,11,19,13,1335,1322,2718,1396
2018,11,19,14,1435,1464,2716,1252
2018,11,19,15,1480,1545,2716,1171
2018,11,19,16,1470,1525,2734,1209
2018,11,19,17,1455,1525,2748,1223
2018,11,19,18,1450,1498,2803,1305
2018,11,19,19,1430,1482,2840,1358
2018,11,19,20,1410,1448,2869,1421
2018,11,19,21,1385,1440,2887,1447
2018,11,19,22,1370,1416,2833,1417
2018,11,19,23,1385,1089,2486,1397
2018,11,20,0,1430,1555,2808,1253
2018,11,20,1,1510,1557,2832,1275
2018,11,20,2,1510,1570,2823,1253
2018,11,20,3,1490,1562,2810,1248
2018,11,20,4,1465,1524,2813,1289
2018,11,20,5,1395,1478,2859,1381
2018,11,20,6,1315,1393,2870,1477
2018,11,20,7,1260,1338,2860,1522
2018,11,20,8,1280,1297,2850,1553
2018,11,20,9,1255,1276,2743,1467
2018,11,20,10,1255,1263,2688,1425
2018,11,20,11,1255,1280,2696,1416
2018,11,20,12,1285,1315,2750,1435
2018,11,20,13,1330,1367,2788,1421
2018,11,20,14,1450,1488,2810,1322
2018,11,20,15,1525,1577,2838,1261
2018,11,20,16,1505,1552,2779,1227
2018,11,20,17,1490,1531,2792,1261
2018,11,20,18,1480,1501,2808,1307
2018,11,20,19,1455,1484,2807,1323
2018,11,20,20,1435,1445,2796,1351
2018,11,20,21,1420,1439,2771,1332
2018,11,20,22,1415,1420,2757,1337
2018,11,20,23,1415,1428,2793,1365
2018,11,21,0,1450,1451,2841,1390
2018,11,21,1,1520,1549,2858,1309
2018,11,21,2,1540,1563,2895,1332
2018,11,21,3,1525,1548,2914,1366
2018,11,21,4,1495,1517,2925,1408
2018,11,21,5,1425,1467,2899,1432
2018,11,21,6,1345,1405,2887,1482
2018,11,21,7,1300,1352,2872,1520
2018,11,21,8,1255,1315,2867,1552
2018,11,21,9,1245,1299,2912,1613
2018,11,21,10,1240,1283,2904,1621
2018,11,21,11,1245,1287,2849,1562
2018,11,21,12,1265,1321,2882,1561
2018,11,21,13,1320,1368,2873,1505
2018,11,21,14,1445,1493,2900,1407
2018,11,21,15,1510,1549,2909,1360
2018,11,21,16,1480,1546,2866,1320
2018,11,21,17,1480,1539,2828,1289
2018,11,21,18,1445,1536,2888,1352
2018,11,21,19,1445,1504,2847,1343
2018,11,21,20,1405,1484,2875,1391
2018,11,21,21,1395,1462,2844,1382
2018,11,21,22,1375,1446,2841,1395
2018,11,21,23,1255,1436,2799,1363
2018,11,22,0,1465,1479,2761,1282
2018,11,22,1,1515,1544,2771,1227
2018,11,22,2,1520,1544,2727,1183
2018,11,22,3,1515,1528,2694,1166
2018,11,22,4,1480,1510,2779,1269
2018,11,22,5,1350,1458,2817,1359
2018,11,22,6,1350,1405,2705,1300
2018,11,22,7,1275,1340,2707,1367
2018,11,22,8,1245,1285,2713,1428
2018,11,22,9,1225,1270,2707,1437
2018,11,22,10,1205,1254,2729,1475
2018,11,22,11,1220,1249,2735,1486
2018,11,22,12,1230,1248,2735,1487
2018,11,22,13,1265,1259,2731,1472
2018,11,22,14,1305,1313,2772,1459
2018,11,22,15,1350,1358,2697,1339
2018,11,22,16,1355,1419,2765,1346
2018,11,22,17,1380,1469,2778,1309
2018,11,22,18,1385,1485,2832,1347
2018,11,22,19,1370,1503,2851,1348
2018,11,22,20,1360,1489,2867,1378
2018,11,22,21,1330,1454,2810,1356
2018,11,22,22,1300,1438,2863,1425
2018,11,22,23,1295,1386,2793,1407
2018,11,23,0,1300,1382,2810,1428
2018,11,23,1,1325,1405,2803,1398
2018,11,23,2,1350,1392,2774,1382
2018,11,23,3,1345,1383,2798,1415
2018,11,23,4,1340,1378,2791,1413
2018,11,23,5,1300,1362,2788,1426
2018,11,23,6,1245,1324,2746,1422
2018,11,23,7,1190,1292,2742,1450
2018,11,23,8,1225,1258,2782,1524
2018,11,23,9,1205,1230,2669,1439
2018,11,23,10,1215,1209,2663,1454
2018,11,23,11,1225,1225,2720,1495
2018,11,23,12,1230,1244,2756,1512
2018,11,23,13,1295,1284,2730,1446
2018,11,23,14,1330,1330,2791,1461
2018,11,23,15,1385,1395,2901,1506
2018,11,23,16,1395,1413,2901,1488
2018,11,23,17,1390,1433,2910,1477
2018,11,23,18,1365,1429,2921,1492
2018,11,23,19,1340,1423,2916,1493
2018,11,23,20,1330,1414,2923,1509
2018,11,23,21,1320,1392,2904,1512
2018,11,23,22,1300,1385,2899,1514
2018,11,23,23,1285,1385,2874,1489
2018,11,24,0,1325,1414,2821,1407
2018,11,24,1,1400,1472,2844,1372
2018,11,24,2,1375,1468,2798,1330
2018,11,24,3,1405,1444,2759,1315
2018,11,24,4,1355,1420,2691,1271
2018,11,24,5,1315,1393,2684,1291
2018,11,24,6,1225,1349,2672,1323
2018,11,24,7,1155,1326,2656,1330
2018,11,24,8,1235,1308,2632,1324
2018,11,24,9,1205,1279,2627,1348
2018,11,24,10,1205,1287,2634,1347
2018,11,24,11,1200,1298,2684,1386
2018,11,24,12,1200,1300,2691,1391
2018,11,24,13,1240,1332,2711,1379
2018,11,24,14,1305,1362,2783,1421
2018,11,24,15,1385,1407,2841,1434
2018,11,24,16,1420,1431,2877,1446
2018,11,24,17,1445,1458,2948,1490
2018,11,24,18,1455,1473,2956,1483
2018,11,24,19,1435,1473,2974,1501
2018,11,24,20,1415,1462,2972,1510
2018,11,24,21,1395,1429,2918,1489
2018,11,24,22,1385,1430,2906,1476
2018,11,24,23,1390,1443,2864,1421
2018,11,25,0,1430,1472,2847,1375
2018,11,25,1,1505,1533,2820,1287
2018,11,25,2,1505,1534,2761,1227
2018,11,25,3,1480,1504,2751,1247
2018,11,25,4,1455,1480,2790,1310
2018,11,25,5,1415,1444,2765,1321
2018,11,25,6,1355,1387,2744,1357
2018,11,25,7,1305,1326,2745,1419
2018,11,25,8,1280,1291,2781,1490
2018,11,25,9,1270,1267,2705,1438
2018,11,25,10,1275,1280,2681,1401
2018,11,25,11,1265,1282,2666,1384
2018,11,25,12,1275,1299,2707,1408
2018,11,25,13,1305,1344,2833,1489
2018,11,25,14,1360,1372,2860,1488
2018,11,25,15,1415,1416,2878,1462
2018,11,25,16,1460,1435,2856,1421
2018,11,25,17,1485,1458,2845,1387
2018,11,25,18,1480,1452,2888,1436
2018,11,25,19,1460,1429,2872,1443
2018,11,25,20,1445,1433,2840,1407
2018,11,25,21,1425,1411,2839,1428
2018,11,25,22,1410,1402,2787,1385
2018,11,25,23,1425,1416,2800,1384
2018,11,26,0,1475,1446,2755,1309
2018,11,26,1,1560,1554,2781,1227
2018,11,26,2,1550,1586,2804,1218
2018,11,26,3,1515,1577,2812,1235
2018,11,26,4,1480,1542,2821,1279
2018,11,26,5,1430,1493,2807,1314
2018,11,26,6,1335,1412,2819,1407
2018,11,26,7,1280,1356,2860,1504
2018,11,26,8,1260,1324,2886,1562
2018,11,26,9,1255,1303,2870,1567
2018,11,26,10,1245,1306,2852,1546
2018,11,26,11,1245,1317,2851,1534
2018,11,26,12,1275,1348,2860,1512
2018,11,26,13,1330,1411,2875,1464
2018,11,26,14,1470,1529,2914,1385
2018,11,26,15,1550,1619,2952,1333
2018,11,26,16,1535,1625,2958,1333
2018,11,26,17,1530,1607,2941,1334
2018,11,26,18,1510,1605,2965,1360
2018,11,26,19,1495,1572,2976,1404
2018,11,26,20,1465,1565,2993,1428
2018,11,26,21,1445,1545,2975,1430
2018,11,26,22,1425,1547,2988,1441
2018,11,26,23,1450,1530,2972,1442
2018,11,27,0,1535,1600,3005,1405
2018,11,27,1,1575,1581,2924,1343
2018,11,27,2,1580,1662,2994,1332
2018,11,27,3,1565,1629,3001,1372
2018,11,27,4,1535,1591,2978,1387
2018,11,27,5,1475,1522,2965,1443
2018,11,27,6,1390,1447,2963,1516
2018,11,27,7,1330,1386,2955,1569
2018,11,27,8,1230,1347,2879,1532
2018,11,27,9,1210,1304,2876,1572
2018,11,27,10,1200,1301,2857,1556
2018,11,27,11,1215,1309,2860,1551
2018,11,27,12,1250,1335,2850,1515
2018,11,27,13,1300,1379,2880,1501
2018,11,27,14,1450,1511,2914,1403
2018,11,27,15,1560,1594,2933,1339
2018,11,27,16,1535,1562,2920,1358
2018,11,27,17,1515,1544,2893,1349
2018,11,27,18,1485,1553,2890,1337
2018,11,27,19,1465,1539,2858,1319
2018,11,27,20,1430,1532,2889,1357
2018,11,27,21,1420,1532,2876,1344
2018,11,27,22,1400,1505,2879,1374
2018,11,27,23,1405,1510,2893,1383
2018,11,28,0,1435,1562,2902,1340
2018,11,28,1,1530,1605,2864,1259
2018,11,28,2,1545,1595,2829,1234
2018,11,28,3,1530,1579,2854,1275
2018,11,28,4,1495,1541,2786,1245
2018,11,28,5,1445,1465,2853,1388
2018,11,28,6,1380,1388,2872,1484
2018,11,28,7,1325,1320,2854,1534
2018,11,28,8,1255,1291,2901,1610
2018,11,28,9,1240,1272,2835,1563
2018,11,28,10,1240,1261,2792,1531
2018,11,28,11,1250,1270,2852,1582
2018,11,28,12,1275,1285,2882,1597
2018,11,28,13,1330,1338,2866,1528
2018,11,28,14,1455,1433,2865,1432
2018,11,28,15,1535,1482,2847,1365
2018,11,28,16,1515,1480,2837,1357
2018,11,28,17,1515,1445,2815,1370
2018,11,28,18,1475,1448,2871,1423
2018,11,28,19,1470,1441,2938,1497
2018,11,28,20,1440,1438,2950,1512
2018,11,28,21,1430,1409,2907,1498
2018,11,28,22,1420,1400,2894,1494
2018,11,28,23,1420,1393,2839,1446
2018,11,29,0,1475,1446,2862,1416
2018,11,29,1,1515,1518,2857,1339
2018,11,29,2,1550,1530,2872,1342
2018,11,29,3,1540,1506,2819,1313
2018,11,29,4,1500,1472,2809,1337
2018,11,29,5,1435,1424,2819,1395
2018,11,29,6,1365,1340,2835,1495
2018,11,29,7,1285,1276,2811,1535
2018,11,29,8,1290,1232,2819,1587
2018,11,29,9,1250,1229,2809,1580
2018,11,29,10,1250,1219,2781,1562
2018,11,29,11,1255,1221,2783,1562
2018,11,29,12,1285,1246,2766,1520
2018,11,29,13,1325,1309,2793,1484
2018,11,29,14,1480,1430,2801,1371
2018,11,29,15,1585,1515,2801,1286
2018,11,29,16,1550,1491,2756,1265
2018,11,29,17,1540,1472,2769,1297
2018,11,29,18,1540,1451,2743,1292
2018,11,29,19,1520,1436,2789,1353
2018,11,29,20,1505,1410,2813,1403
2018,11,29,21,1495,1382,2846,1464
2018,11,29,22,1485,1380,2792,1412
2018,11,29,23,1480,1380,2740,1360
2018,11,30,0,1525,1439,2716,1277
2018,11,30,1,1595,1528,2762,1234
2018,11,30,2,1590,1527,2757,1230
2018,11,30,3,1570,1504,2672,1168
2018,11,30,4,1530,1487,2708,1221
2018,11,30,5,1460,1419,2722,1303
2018,11,30,6,1375,1364,2734,1370
2018,11,30,7,1315,1282,2690,1408
2018,11,30,8,1275,1259,2712,1453
2018,11,30,9,1250,1236,2735,1499
2018,11,30,10,1240,1223,2719,1496
2018,11,30,11,1250,1227,2725,1498
2018,11,30,12,1260,1240,2716,1476
2018,11,30,13,1315,1296,2653,1357
2018,11,30,14,1370,1418,2676,1258
2018,11,30,15,1405,1526,2699,1173
2018,11,30,16,1415,1515,2701,1186
2018,11,30,17,1420,1514,2725,1211
2018,11,30,18,1420,1498,2721,1223
2018,11,30,19,1410,1487,2713,1226
2018,11,30,20,1405,1463,2691,1228
2018,11,30,21,1385,1447,2711,1264
2018,11,30,22,1375,1438,2728,1290
2018,11,30,23,1370,1446,2732,1286
2018,12,1,0,1410,1493,2729,1236
2018,12,1,1,1475,1537,2732,1195
2018,12,1,2,1480,1516,2733,1217
2018,12,1,3,1455,1507,2821,1314
2018,12,1,4,1425,1486,2805,1319
2018,12,1,5,1395,1444,2804,1360
2018,12,1,6,1325,1375,2844,1469
2018,12,1,7,1275,1306,2854,1548
2018,12,1,8,1255,1264,2862,1598
2018,12,1,9,1230,1240,2886,1646
2018,12,1,10,1240,1238,2894,1656
2018,12,1,11,1245,1224,2871,1647
2018,12,1,12,1250,1230,2882,1652
2018,12,1,13,1285,1253,2903,1650
2018,12,1,14,1320,1288,2867,1579
2018,12,1,15,1370,1349,2813,1464
2018,12,1,16,1395,1392,2823,1431
2018,12,1,17,1420,1421,2887,1466
2018,12,1,18,1425,1418,2889,1471
2018,12,1,19,1420,1398,2895,1497
2018,12,1,20,1410,1382,2899,1517
2018,12,1,21,1380,1372,2916,1544
2018,12,1,22,1380,1369,2904,1535
2018,12,1,23,1390,1376,2862,1486
2018,12,2,0,1425,1427,2883,1456
2018,12,2,1,1510,1490,2902,1412
2018,12,2,2,1520,1485,2827,1342
2018,12,2,3,1500,1459,2818,1359
2018,12,2,4,1475,1450,2831,1381
2018,12,2,5,1435,1409,2832,1423
2018,12,2,6,1365,1356,2824,1468
2018,12,2,7,1305,1305,2850,1545
2018,12,2,8,1255,1265,2842,1577
2018,12,2,9,1230,1243,2634,1391
2018,12,2,10,1240,1234,2617,1383
2018,12,2,11,1245,1239,2616,1377
2018,12,2,12,1250,1236,2636,1400
2018,12,2,13,1290,1259,2713,1454
2018,12,2,14,1345,1307,2715,1408
2018,12,2,15,1410,1363,2719,1356
2018,12,2,16,1440,1407,2720,1313
2018,12,2,17,1465,1443,2779,1336
2018,12,2,18,1470,1441,2850,1409
2018,12,2,19,1455,1432,2842,1410
2018,12,2,20,1450,1423,2848,1425
2018,12,2,21,1420,1405,2829,1424
2018,12,2,22,1415,1405,2802,1397
2018,12,2,23,1430,1418,2811,1393
2018,12,3,0,1465,1487,2860,1373
2018,12,3,1,1550,1567,2867,1300
2018,12,3,2,1565,1573,2865,1292
2018,12,3,3,1540,1538,2851,1313
2018,12,3,4,1510,1506,2846,1340
2018,12,3,5,1470,1439,2838,1399
2018,12,3,6,1390,1360,2788,1428
2018,12,3,7,1330,1281,2843,1562
2018,12,3,8,1290,1253,2847,1594
2018,12,3,9,1270,1237,2831,1594
2018,12,3,10,1265,1226,2839,1613
2018,12,3,11,1275,1226,2838,1612
2018,12,3,12,1300,1253,2849,1596
2018,12,3,13,1360,1311,2855,1544
2018,12,3,14,1490,1445,2866,1421
2018,12,3,15,1575,1522,2887,1365
2018,12,3,16,1570,1531,2888,1357
2018,12,3,17,1560,1531,2894,1363
2018,12,3,18,1540,1527,2907,1380
2018,12,3,19,1515,1497,2889,1392
2018,12,3,20,1505,1474,2879,1405
2018,12,3,21,1485,1458,2907,1449
2018,12,3,22,1480,1442,2912,1470
2018,12,3,23,1475,1460,2927,1467
2018,12,4,0,1550,1521,2915,1394
2018,12,4,1,1570,1589,2917,1328
2018,12,4,2,1620,1576,2912,1336
2018,12,4,3,1595,1563,2938,1375
2018,12,4,4,1555,1545,2984,1439
2018,12,4,5,1470,1465,2973,1508
2018,12,4,6,1405,1383,2929,1546
2018,12,4,7,1345,1308,2792,1484
2018,12,4,8,1215,1273,2786,1513
2018,12,4,9,1190,1254,2758,1504
2018,12,4,10,1185,1270,2871,1601
2018,12,4,11,1195,1267,2861,1594
2018,12,4,12,1220,1282,2877,1595
2018,12,4,13,1270,1335,2874,1539
2018,12,4,14,1405,1466,2908,1442
2018,12,4,15,1500,1565,2958,1393
2018,12,4,16,1475,1537,2980,1443
2018,12,4,17,1450,1515,3030,1515
2018,12,4,18,1445,1493,3019,1526
2018,12,4,19,1430,1470,3038,1568
2018,12,4,20,1410,1459,3038,1579
2018,12,4,21,1395,1444,3032,1588
2018,12,4,22,1385,1455,3058,1603
2018,12,4,23,1385,1457,3054,1597
2018,12,5,0,1435,1515,2930,1415
2018,12,5,1,1505,1597,2995,1398
2018,12,5,2,1505,1606,3044,1438
2018,12,5,3,1490,1602,3063,1461
2018,12,5,4,1460,1553,3003,1450
2018,12,5,5,1385,1494,2967,1473
2018,12,5,6,1325,1413,2969,1556
2018,12,5,7,1255,1336,2932,1596
2018,12,5,8,1315,1300,2916,1616
2018,12,5,9,1300,1280,2914,1634
2018,12,5,10,1285,1287,2935,1648
2018,12,5,11,1285,1291,2934,1643
2018,12,5,12,1315,1308,2899,1591
2018,12,5,13,1370,1379,2865,1486
2018,12,5,14,1470,1508,2968,1460
2018,12,5,15,1515,1617,3042,1425
2018,12,5,16,1520,1584,2984,1400
2018,12,5,17,1510,1546,2993,1447
2018,12,5,18,1505,1515,2968,1453
2018,12,5,19,1480,1495,2963,1468
2018,12,5,20,1460,1476,2973,1497
2018,12,5,21,1445,1458,2969,1511
2018,12,5,22,1430,1451,2991,1540
2018,12,5,23,1450,1456,2958,1502
2018,12,6,0,1510,1523,2966,1443
2018,12,6,1,1575,1599,2963,1364
2018,12,6,2,1570,1623,2966,1343
2018,12,6,3,1550,1608,2925,1317
2018,12,6,4,1530,1574,2826,1252
2018,12,6,5,1455,1518,2841,1323
2018,12,6,6,1370,1440,2861,1421
2018,12,6,7,1295,1373,2835,1462
2018,12,6,8,1245,1340,2834,1494
2018,12,6,9,1230,1334,2800,1466
2018,12,6,10,1235,1329,2800,1471
2018,12,6,11,1235,1342,2820,1478
2018,12,6,12,1255,1348,2802,1454
2018,12,6,13,1300,1412,2794,1382
2018,12,6,14,1440,1559,2884,1325
2018,12,6,15,1540,1647,2907,1260
2018,12,6,16,1530,1625,2933,1308
2018,12,6,17,1515,1591,2929,1338
2018,12,6,18,1500,1542,2677,1135
2018,12,6,19,1490,1516,2665,1149
2018,12,6,20,1470,1489,2744,1255
2018,12,6,21,1440,1465,2750,1285
2018,12,6,22,1445,1463,2754,1291
2018,12,6,23,1440,1468,2732,1264
2018,12,7,0,1490,1538,2721,1183
2018,12,7,1,1570,1491,2637,1146
2018,12,7,2,1570,1637,2842,1205
2018,12,7,3,1560,1638,2843,1205
2018,12,7,4,1530,1610,2802,1192
2018,12,7,5,1460,1554,2789,1235
2018,12,7,6,1410,1481,2798,1317
2018,12,7,7,1330,1406,2801,1395
2018,12,7,8,1285,1377,2814,1437
2018,12,7,9,1265,1369,2740,1371
2018,12,7,10,1250,1360,2728,1368
2018,12,7,11,1255,1369,2773,1404
2018,12,7,12,1275,1383,2751,1368
2018,12,7,13,1330,1435,2812,1377
2018,12,7,14,1435,1551,2859,1308
2018,12,7,15,1510,1639,2877,1238
2018,12,7,16,1510,1626,2847,1221
2018,12,7,17,1510,1618,2861,1243
2018,12,7,18,1500,1572,2843,1271
2018,12,7,19,1485,1545,2765,1220
2018,12,7,20,1465,1510,2769,1259
2018,12,7,21,1445,1496,2786,1290
2018,12,7,22,1435,1473,2816,1343
2018,12,7,23,1450,1482,2889,1407
2018,12,8,0,1500,1554,2930,1376
2018,12,8,1,1555,1606,2903,1297
2018,12,8,2,1545,1613,2838,1225
2018,12,8,3,1525,1593,2852,1259
2018,12,8,4,1500,1572,2860,1288
2018,12,8,5,1510,1524,2916,1392
2018,12,8,6,1370,1462,2886,1424
2018,12,8,7,1300,1400,2924,1524
2018,12,8,8,1280,1361,2897,1536
2018,12,8,9,1255,1341,2956,1615
2018,12,8,10,1255,1328,2954,1626
2018,12,8,11,1250,1334,2937,1603
2018,12,8,12,1250,1343,2936,1593
2018,12,8,13,1280,1364,2940,1576
2018,12,8,14,1295,1415,2947,1532
2018,12,8,15,1330,1474,2940,1466
2018,12,8,16,1370,1515,2936,1421
2018,12,8,17,1400,1514,2928,1414
2018,12,8,18,1405,1496,2914,1418
2018,12,8,19,1390,1458,2872,1414
2018,12,8,20,1380,1443,2885,1442
2018,12,8,21,1365,1402,2878,1476
2018,12,8,22,1365,1400,2875,1475
2018,12,8,23,1375,1407,2859,1452
2018,12,9,0,1430,1436,2833,1397
2018,12,9,1,1500,1557,2879,1322
2018,12,9,2,1500,1567,2878,1311
2018,12,9,3,1470,1547,2840,1293
2018,12,9,4,1445,1520,2881,1361
2018,12,9,5,1400,1475,2911,1436
2018,12,9,6,1330,1418,2875,1457
2018,12,9,7,1270,1357,2866,1509
2018,12,9,8,1245,1330,2862,1532
2018,12,9,9,1235,1311,2858,1547
2018,12,9,10,1230,1294,2844,1550
2018,12,9,11,1235,1300,2855,1555
2018,12,9,12,1240,1311,2894,1583
2018,12,9,13,1280,1335,2945,1610
2018,12,9,14,1365,1375,2932,1557
2018,12,9,15,1430,1411,2939,1528
2018,12,9,16,1440,1483,2912,1429
2018,12,9,17,1450,1489,2913,1424
2018,12,9,18,1430,1470,2840,1370
2018,12,9,19,1415,1439,2885,1446
2018,12,9,20,1400,1447,2898,1451
2018,12,9,21,1380,1420,2874,1454
2018,12,9,22,1380,1402,2880,1478
2018,12,9,23,1390,1425,2869,1444
2018,12,10,0,1455,1504,2744,1240
2018,12,10,1,1485,1602,2762,1160
2018,12,10,2,1550,1617,2767,1150
2018,12,10,3,1535,1600,2756,1156
2018,12,10,4,1505,1561,2712,1151
2018,12,10,5,1440,1501,2711,1210
2018,12,10,6,1365,1417,2639,1222
2018,12,10,7,1290,1341,2733,1392
2018,12,10,8,1245,1292,2789,1497
2018,12,10,9,1230,1294,2816,1522
2018,12,10,10,1225,1276,2840,1564
2018,12,10,11,1230,1292,2841,1549
2018,12,10,12,1260,1318,2857,1539
2018,12,10,13,1320,1374,2862,1488
2018,12,10,14,1425,1493,2880,1387
2018,12,10,15,1495,1601,2821,1220
2018,12,10,16,1495,1583,2834,1251
2018,12,10,17,1485,1603,2848,1245
2018,12,10,18,1465,1594,2870,1276
2018,12,10,19,1440,1558,2841,1283
2018,12,10,20,1425,1545,2857,1312
2018,12,10,21,1410,1524,2831,1307
2018,12,10,22,1405,1515,2832,1317
2018,12,10,23,1405,1531,2843,1312
2018,12,11,0,1470,1581,2866,1285
2018,12,11,1,1500,1667,2914,1247
2018,12,11,2,1535,1653,2900,1247
2018,12,11,3,1515,1630,2912,1282
2018,12,11,4,1485,1591,2943,1352
2018,12,11,5,1425,1518,2953,1435
2018,12,11,6,1335,1424,2941,1517
2018,12,11,7,1270,1332,2843,1511
2018,12,11,8,1265,1297,2843,1546
2018,12,11,9,1240,1279,2880,1601
2018,12,11,10,1240,1281,2869,1588
2018,12,11,11,1245,1288,2885,1597
2018,12,11,12,1255,1307,2891,1584
2018,12,11,13,1290,1363,2842,1479
2018,12,11,14,1390,1477,2904,1427
2018,12,11,15,1460,1573,2929,1356
2018,12,11,16,1480,1565,2952,1387
2018,12,11,17,1465,1552,2953,1401
2018,12,11,18,1450,1536,2950,1414
2018,12,11,19,1425,1514,2951,1437
2018,12,11,20,1425,1497,2967,1470
2018,12,11,21,1405,1494,2982,1488
2018,12,11,22,1400,1492,2985,1493
2018,12,11,23,1410,1507,2992,1485
2018,12,12,0,1475,1551,3014,1463
2018,12,12,1,1565,1646,3017,1371
2018,12,12,2,1570,1621,2932,1311
2018,12,12,3,1555,1582,2702,1120
2018,12,12,4,1515,1544,2561,1017
2018,12,12,5,1460,1481,2698,1217
2018,12,12,6,1375,1394,2808,1414
2018,12,12,7,1295,1319,2953,1634
2018,12,12,8,1250,1272,2933,1661
2018,12,12,9,1240,1248,2893,1645
2018,12,12,10,1230,1236,2897,1661
2018,12,12,11,1240,1249,2911,1662
2018,12,12,12,1260,1265,2914,1649
2018,12,12,13,1320,1321,2917,1596
2018,12,12,14,1435,1448,2911,1463
2018,12,12,15,1530,1574,2990,1416
2018,12,12,16,1505,1550,2968,1418
2018,12,12,17,1495,1560,2970,1410
2018,12,12,18,1475,1539,2835,1296
2018,12,12,19,1450,1503,2685,1182
2018,12,12,20,1440,1486,2515,1029
2018,12,12,21,1415,1486,2634,1148
2018,12,12,22,1410,1522,2846,1324
2018,12,12,23,1415,1531,2899,1368
2018,12,13,0,1475,1571,2886,1315
2018,12,13,1,1550,1641,2934,1293
2018,12,13,2,1560,1652,2947,1295
2018,12,13,3,1535,1615,2873,1258
2018,12,13,4,1505,1592,2844,1252
2018,12,13,5,1450,1532,2880,1348
2018,12,13,6,1360,1452,2888,1436
2018,12,13,7,1285,1376,2820,1444
2018,12,13,8,1235,1329,2810,1481
2018,12,13,9,1225,1316,2810,1494
2018,12,13,10,1225,1304,2822,1518
2018,12,13,11,1235,1310,2798,1488
2018,12,13,12,1245,1333,2783,1450
2018,12,13,13,1310,1388,2754,1366
2018,12,13,14,1460,1521,2776,1255
2018,12,13,15,1570,1606,2877,1271
2018,12,13,16,1555,1587,2800,1213
2018,12,13,17,1530,1594,2774,1180
2018,12,13,18,1500,1566,2704,1138
2018,12,13,19,1480,1555,2793,1238
2018,12,13,20,1450,1527,2723,1196
2018,12,13,21,1435,1506,2723,1217
2018,12,13,22,1435,1511,2737,1226
2018,12,13,23,1440,1513,2759,1246
2018,12,14,0,1505,1565,2795,1230
2018,12,14,1,1535,1627,2798,1171
2018,12,14,2,1590,1617,2575,958
2018,12,14,3,1575,1583,2324,741
2018,12,14,4,1545,1560,2293,733
2018,12,14,5,1478,1480,2274,794
2018,12,14,6,1405,1407,2266,859
2018,12,14,7,1325,1352,2179,827
2018,12,14,8,1265,1304,2070,766
2018,12,14,9,1245,1291,2033,742
2018,12,14,10,1235,1304,1924,620
2018,12,14,11,1250,1295,1849,554
2018,12,14,12,1260,1324,2008,684
2018,12,14,13,1315,1371,2040,669
2018,12,14,14,1470,1480,2016,536
2018,12,14,15,1605,1568,1988,420
2018,12,14,16,1585,1558,1995,437
2018,12,14,17,1585,1545,1990,445
2018,12,14,18,1555,1525,1988,463
2018,12,14,19,1530,1499,1973,474
2018,12,14,20,1505,1483,2035,552
2018,12,14,21,1495,1461,2030,569
2018,12,14,22,1495,1438,2059,621
2018,12,14,23,1500,1431,2083,652
2018,12,15,0,1560,1477,2085,608
2018,12,15,1,1620,1528,2180,652
2018,12,15,2,1625,1511,2273,762
2018,12,15,3,1595,1502,2248,746
2018,12,15,4,1575,1468,2222,754
2018,12,15,5,1525,1415,2163,748
2018,12,15,6,1450,1363,2190,827
2018,12,15,7,1375,1293,2161,868
2018,12,15,8,1260,1242,2123,881
2018,12,15,9,1240,1229,2159,930
2018,12,15,10,1225,1216,2180,964
2018,12,15,11,1230,1218,2217,999
2018,12,15,12,1235,1213,2285,1072
2018,12,15,13,1260,1234,2305,1071
2018,12,15,14,1335,1288,2293,1005
2018,12,15,15,1415,1352,2332,980
2018,12,15,16,1470,1398,2332,934
2018,12,15,17,1475,1415,2314,899
2018,12,15,18,1460,1424,2304,880
2018,12,15,19,1425,1406,2299,893
2018,12,15,20,1415,1386,2328,942
2018,12,15,21,1390,1366,2354,988
2018,12,15,22,1380,1365,2372,1007
2018,12,15,23,1395,1373,2372,999
2018,12,16,0,1445,1430,2352,922
2018,12,16,1,1555,1512,2361,849
2018,12,16,2,1565,1506,2334,828
2018,12,16,3,1545,1475,2337,862
2018,12,16,4,1515,1457,2326,869
2018,12,16,5,1475,1406,2340,934
2018,12,16,6,1400,1356,2230,874
2018,12,16,7,1330,1296,2199,903
2018,12,16,8,1295,1254,2174,920
2018,12,16,9,1275,1226,2121,895
2018,12,16,10,1260,1228,2108,880
2018,12,16,11,1270,1231,2111,880
2018,12,16,12,1270,1229,2123,894
2018,12,16,13,1295,1260,2137,877
2018,12,16,14,1340,1303,2154,851
2018,12,16,15,1390,1368,2165,797
2018,12,16,16,1445,1399,2137,738
2018,12,16,17,1455,1439,2135,696
2018,12,16,18,1445,1424,2122,698
2018,12,16,19,1420,1408,2122,714
2018,12,16,20,1410,1396,2127,731
2018,12,16,21,1390,1361,2121,760
2018,12,16,22,1380,1353,2108,755
2018,12,16,23,1395,1359,2109,750
2018,12,17,0,1455,1432,2177,745
2018,12,17,1,1560,1525,2187,662
2018,12,17,2,1570,1532,2196,664
2018,12,17,3,1545,1523,2221,698
2018,12,17,4,1510,1481,2234,753
2018,12,17,5,1450,1422,2250,828
2018,12,17,6,1380,1341,2297,956
2018,12,17,7,1305,1269,2281,1012
2018,12,17,8,1300,1225,2200,975
2018,12,17,9,1285,1223,2070,847
2018,12,17,10,1270,1207,1971,764
2018,12,17,11,1280,1204,1978,774
2018,12,17,12,1305,1221,1974,753
2018,12,17,13,1360,1268,2115,847
2018,12,17,14,1455,1391,2134,743
2018,12,17,15,1525,1484,2175,691
2018,12,17,16,1510,1504,2175,671
2018,12,17,17,1515,1473,2142,669
2018,12,17,18,1510,1453,2131,678
2018,12,17,19,1480,1435,2134,699
2018,12,17,20,1465,1424,2123,699
2018,12,17,21,1450,1421,2146,725
2018,12,17,22,1450,1403,2157,754
2018,12,17,23,1465,1429,2188,759
2018,12,18,0,1515,1461,2167,706
2018,12,18,1,1585,1538,2194,656
2018,12,18,2,1585,1543,2189,646
2018,12,18,3,1555,1524,2179,655
2018,12,18,4,1530,1501,2184,683
2018,12,18,5,1460,1430,2174,744
2018,12,18,6,1370,1350,2152,802
2018,12,18,7,1290,1295,2138,843
2018,12,18,8,1240,1244,2128,884
2018,12,18,9,1215,1234,2252,1018
2018,12,18,10,1220,1223,2239,1016
2018,12,18,11,1225,1229,2302,1073
2018,12,18,12,1235,1260,2341,1081
2018,12,18,13,1280,1321,2331,1010
2018,12,18,14,1360,1440,2340,900
2018,12,18,15,1435,1532,2347,815
2018,12,18,16,1445,1527,2364,837
2018,12,18,17,1450,1506,2334,828
2018,12,18,18,1430,1484,2305,821
2018,12,18,19,1415,1467,2312,845
2018,12,18,20,1400,1458,2330,872
2018,12,18,21,1380,1467,2349,882
2018,12,18,22,1380,1469,2398,929
2018,12,18,23,1385,1470,2386,916
2018,12,19,0,1445,1523,2399,876
2018,12,19,1,1540,1585,2411,826
2018,12,19,2,1530,1580,2425,845
2018,12,19,3,1515,1551,2419,868
2018,12,19,4,1475,1531,2147,616
2018,12,19,5,1405,1480,1681,201
2018,12,19,6,1330,1359,1423,64
2018,12,19,7,1255,1276,1369,93
2018,12,19,8,1220,1239,1315,76
2018,12,19,9,1205,1216,1317,101
2018,12,19,10,1195,1210,1323,113
2018,12,19,11,1200,1198,1343,145
2018,12,19,12,1220,1215,1352,137
2018,12,19,13,1270,1275,1353,78
2018,12,19,14,1370,1395,1367,-28
2018,12,19,15,1460,1507,1419,-88
2018,12,19,16,1450,1503,1419,-84
2018,12,19,17,1435,1504,1353,-151
2018,12,19,18,1420,1483,1406,-77
2018,12,19,19,1395,1472,1557,85
2018,12,19,20,1385,1470,1576,106
2018,12,19,21,1380,1463,1649,186
2018,12,19,22,1385,1460,1765,305
2018,12,19,23,1395,1477,1753,276
2018,12,20,0,1435,1531,1879,348
2018,12,20,1,1510,1611,2045,434
2018,12,20,2,1520,1615,2159,544
2018,12,20,3,1490,1594,2196,602
2018,12,20,4,1470,1565,2286,721
2018,12,20,5,1400,1506,2290,784
2018,12,20,6,1330,1423,2288,865
2018,12,20,7,1265,1328,2168,840
2018,12,20,8,1215,1279,2125,846
2018,12,20,9,1210,1239,2114,875
2018,12,20,10,1200,1256,2203,947
2018,12,20,11,1205,1254,2379,1125
2018,12,20,12,1225,1294,2511,1217
2018,12,20,13,1270,1340,2535,1195
2018,12,20,14,1400,1459,2538,1079
2018,12,20,15,1480,1579,2469,890
2018,12,20,16,1475,1591,2441,850
2018,12,20,17,1465,1561,2283,722
2018,12,20,18,1440,1542,2276,734
2018,12,20,19,1425,1531,2367,836
2018,12,20,20,1400,1512,2366,854
2018,12,20,21,1390,1485,2297,812
2018,12,20,22,1380,1469,2292,823
2018,12,20,23,1395,1479,2305,826
2018,12,21,0,1440,1537,2316,779
2018,12,21,1,1490,1586,2177,591
2018,12,21,2,1510,1571,2073,502
2018,12,21,3,1495,1547,2071,524
2018,12,21,4,1470,1523,2159,636
2018,12,21,5,1390,1487,2332,845
2018,12,21,6,1325,1400,2337,937
2018,12,21,7,1270,1343,2398,1055
2018,12,21,8,1240,1293,2368,1075
2018,12,21,9,1225,1275,2454,1179
2018,12,21,10,1225,1273,2496,1223
2018,12,21,11,1220,1273,2516,1243
2018,12,21,12,1240,1301,2647,1346
2018,12,21,13,1295,1334,2641,1307
2018,12,21,14,1425,1442,2661,1219
2018,12,21,15,1540,1555,2691,1136
2018,12,21,16,1535,1568,2694,1126
2018,12,21,17,1525,1562,2696,1134
2018,12,21,18,1500,1542,2686,1144
2018,12,21,19,1480,1534,2667,1133
2018,12,21,20,1470,1507,2687,1180
2018,12,21,21,1455,1505,2690,1185
2018,12,21,22,1435,1498,2708,1210
2018,12,21,23,1445,1509,2720,1211
2018,12,22,0,1495,1562,2765,1203
2018,12,22,1,1560,1626,2756,1130
2018,12,22,2,1555,1604,2737,1133
2018,12,22,3,1535,1575,2724,1149
2018,12,22,4,1510,1565,2729,1164
2018,12,22,5,1470,1522,2755,1233
2018,12,22,6,1385,1454,2706,1252
2018,12,22,7,1305,1390,2692,1302
2018,12,22,8,1245,1345,2683,1338
2018,12,22,9,1225,1303,2651,1348
2018,12,22,10,1220,1277,2627,1350
2018,12,22,11,1210,1280,2635,1355
2018,12,22,12,1220,1283,2621,1338
2018,12,22,13,1250,1300,2609,1309
2018,12,22,14,1315,1353,2588,1235
2018,12,22,15,1400,1423,2590,1167
2018,12,22,16,1440,1472,2605,1133
2018,12,22,17,1460,1502,2636,1134
2018,12,22,18,1455,1494,2694,1200
2018,12,22,19,1435,1481,2722,1241
2018,12,22,20,1415,1471,2721,1250
2018,12,22,21,1405,1442,2712,1270
2018,12,22,22,1400,1429,2683,1254
2018,12,22,23,1405,1433,2696,1263
2018,12,23,0,1465,1490,2701,1211
2018,12,23,1,1535,1597,2725,1128
2018,12,23,2,1530,1589,2705,1116
2018,12,23,3,1500,1577,2729,1152
2018,12,23,4,1485,1560,2741,1181
2018,12,23,5,1400,1520,2768,1248
2018,12,23,6,1380,1457,2741,1284
2018,12,23,7,1320,1398,2704,1306
2018,12,23,8,1235,1332,2773,1441
2018,12,23,9,1205,1316,2737,1421
2018,12,23,10,1210,1302,2737,1435
2018,12,23,11,1210,1298,2744,1446
2018,12,23,12,1220,1296,2712,1416
2018,12,23,13,1260,1321,2809,1488
2018,12,23,14,1330,1380,2821,1441
2018,12,23,15,1415,1435,2801,1366
2018,12,23,16,1445,1492,2838,1346
2018,12,23,17,1460,1533,2826,1293
2018,12,23,18,1440,1527,2927,1400
2018,12,23,19,1425,1489,2950,1461
2018,12,23,20,1410,1493,3022,1529
2018,12,23,21,1380,1478,3004,1526
2018,12,23,22,1370,1459,2982,1523
2018,12,23,23,1380,1469,2933,1464
2018,12,24,0,1445,1520,2887,1367
2018,12,24,1,1530,1598,2893,1295
2018,12,24,2,1530,1599,2966,1367
2018,12,24,3,1515,1576,2949,1373
2018,12,24,4,1480,1533,2951,1418
2018,12,24,5,1415,1486,2918,1432
2018,12,24,6,1340,1401,2849,1448
2018,12,24,7,1275,1343,2865,1522
2018,12,24,8,1245,1289,2730,1441
2018,12,24,9,1230,1269,2758,1489
2018,12,24,10,1225,1265,2769,1504
2018,12,24,11,1225,1239,2742,1503
2018,12,24,12,1250,1270,2758,1488
2018,12,24,13,1300,1295,2731,1436
2018,12,24,14,1405,1370,2713,1343
2018,12,24,15,1500,1456,2742,1286
2018,12,24,16,1510,1504,2795,1291
2018,12,24,17,1490,1544,2784,1240
2018,12,24,18,1470,1544,2773,1229
2018,12,24,19,1450,1506,2756,1250
2018,12,24,20,1440,1477,2778,1301
2018,12,24,21,1425,1478,2796,1318
2018,12,24,22,1410,1443,2787,1344
2018,12,24,23,1425,1442,2795,1353
2018,12,25,0,1470,1458,2798,1340
2018,12,25,1,1540,1502,2804,1302
2018,12,25,2,1535,1468,2786,1318
2018,12,25,3,1515,1443,2767,1324
2018,12,25,4,1490,1427,2771,1344
2018,12,25,5,1430,1420,2784,1364
2018,12,25,6,1345,1381,2804,1423
2018,12,25,7,1285,1320,2824,1504
2018,12,25,8,1235,1278,2817,1539
2018,12,25,9,1215,1262,2779,1517
2018,12,25,10,1215,1256,2787,1531
2018,12,25,11,1215,1233,2765,1532
2018,12,25,12,1245,1263,2790,1527
2018,12,25,13,1305,1288,2806,1518
2018,12,25,14,1410,1343,2834,1491
2018,12,25,15,1500,1396,2831,1435
2018,12,25,16,1505,1444,2839,1395
2018,12,25,17,1480,1454,2820,1366
2018,12,25,18,1460,1480,2835,1355
2018,12,25,19,1445,1474,2808,1334
2018,12,25,20,1430,1448,2787,1339
2018,12,25,21,1425,1440,2778,1338
2018,12,25,22,1420,1427,2775,1348
2018,12,25,23,1425,1426,2761,1335
2018,12,26,0,1480,1452,2793,1341
2018,12,26,1,1545,1516,2835,1319
2018,12,26,2,1535,1525,2841,1316
2018,12,26,3,1505,1530,2829,1299
2018,12,26,4,1485,1521,2813,1292
2018,12,26,5,1415,1503,2830,1327
2018,12,26,6,1340,1460,2838,1378
2018,12,26,7,1265,1403,2799,1396
2018,12,26,8,1255,1362,2805,1443
2018,12,26,9,1225,1324,2819,1495
2018,12,26,10,1225,1325,2830,1505
2018,12,26,11,1220,1308,2837,1529
2018,12,26,12,1245,1324,2855,1531
2018,12,26,13,1300,1352,2869,1517
2018,12,26,14,1400,1431,2881,1450
2018,12,26,15,1500,1503,2900,1397
2018,12,26,16,1500,1546,2886,1340
2018,12,26,17,1495,1561,2845,1284
2018,12,26,18,1475,1571,2787,1216
2018,12,26,19,1460,1565,2831,1266
2018,12,26,20,1450,1528,2818,1290
2018,12,26,21,1435,1502,2777,1275
2018,12,26,22,1430,1501,2777,1276
2018,12,26,23,1445,1498,2766,1268
2018,12,27,0,1495,1545,2785,1240
2018,12,27,1,1565,1630,2807,1177
2018,12,27,2,1565,1627,2598,971
2018,12,27,3,1540,1622,2529,907
2018,12,27,4,1515,1581,2517,936
2018,12,27,5,1450,1513,2430,917
2018,12,27,6,1375,1442,2440,998
2018,12,27,7,1300,1384,2439,1055
2018,12,27,8,1245,1347,2424,1077
2018,12,27,9,1235,1330,2447,1117
2018,12,27,10,1240,1343,2425,1082
2018,12,27,11,1235,1352,2411,1059
2018,12,27,12,1265,1374,2426,1052
2018,12,27,13,1320,1418,2443,1025
2018,12,27,14,1415,1497,2430,933
2018,12,27,15,1505,1582,2440,858
2018,12,27,16,1515,1624,2441,817
2018,12,27,17,1505,1652,2429,777
2018,12,27,18,1490,1651,2443,792
2018,12,27,19,1480,1631,2420,789
2018,12,27,20,1455,1603,2412,809
2018,12,27,21,1435,1585,2408,823
2018,12,27,22,1425,1575,2420,845
2018,12,27,23,1430,1584,2439,855
2018,12,28,0,1485,1624,2472,848
2018,12,28,1,1540,1693,2474,781
2018,12,28,2,1530,1692,2440,748
2018,12,28,3,1510,1672,2434,762
2018,12,28,4,1490,1628,2250,622
2018,12,28,5,1505,1551,2001,450
2018,12,28,6,1365,1493,1868,375
2018,12,28,7,1310,1425,1747,322
2018,12,28,8,1305,1388,1755,367
2018,12,28,9,1285,1357,1751,394
2018,12,28,10,1285,1347,1759,412
2018,12,28,11,1280,1356,1754,398
2018,12,28,12,1305,1368,1772,404
2018,12,28,13,1340,1415,1781,366
2018,12,28,14,1425,1503,1783,280
2018,12,28,15,1495,1581,1795,214
2018,12,28,16,1520,1597,1795,198
2018,12,28,17,1520,1600,1802,202
2018,12,28,18,1520,1596,1817,221
2018,12,28,19,1505,1574,1860,286
2018,12,28,20,1480,1548,1843,295
2018,12,28,21,1465,1545,1849,304
2018,12,28,22,1455,1522,1844,322
2018,12,28,23,1460,1522,1869,347
2018,12,29,0,1510,1572,1947,375
2018,12,29,1,1580,1650,1958,308
2018,12,29,2,1575,1660,1963,303
2018,12,29,3,1560,1645,1971,326
2018,12,29,4,1535,1623,1955,332
2018,12,29,5,1495,1565,1949,384
2018,12,29,6,1410,1515,1918,403
2018,12,29,7,1345,1446,1958,512
2018,12,29,8,1260,1403,1999,596
2018,12,29,9,1230,1368,2000,632
2018,12,29,10,1210,1370,2106,736
2018,12,29,11,1215,1363,2127,764
2018,12,29,12,1215,1363,2139,776
2018,12,29,13,1235,1386,2124,738
2018,12,29,14,1290,1435,2102,667
2018,12,29,15,1370,1481,2113,632
2018,12,29,16,1415,1510,2109,599
2018,12,29,17,1440,1538,2147,609
2018,12,29,18,1440,1563,2202,639
2018,12,29,19,1425,1555,2166,611
2018,12,29,20,1410,1531,2133,602
2018,12,29,21,1385,1517,2071,554
2018,12,29,22,1375,1503,2137,634
2018,12,29,23,1385,1512,2178,666
2018,12,30,0,1440,1550,2199,649
2018,12,30,1,1535,1617,2226,609
2018,12,30,2,1530,1622,2236,614
2018,12,30,3,1510,1583,2254,671
2018,12,30,4,1495,1551,2315,764
2018,12,30,5,1450,1489,2251,762
2018,12,30,6,1395,1421,2289,868
2018,12,30,7,1330,1364,2314,950
2018,12,30,8,1305,1320,2275,955
2018,12,30,9,1285,1299,2248,949
2018,12,30,10,1275,1281,2253,972
2018,12,30,11,1270,1269,2231,962
2018,12,30,12,1270,1271,2170,899
2018,12,30,13,1295,1269,2142,873
2018,12,30,14,1350,1312,2212,900
2018,12,30,15,1400,1387,2275,888
2018,12,30,16,1455,1422,2254,832
2018,12,30,17,1495,1478,2242,764
2018,12,30,18,1485,1490,2210,720
2018,12,30,19,1455,1497,2239,742
2018,12,30,20,1450,1513,2325,812
2018,12,30,21,1435,1500,2306,806
2018,12,30,22,1420,1518,2326,808
2018,12,30,23,1425,1538,2352,814
2018,12,31,0,1480,1562,2343,781
2018,12,31,1,1565,1636,2363,727
2018,12,31,2,1565,1651,2353,702
2018,12,31,3,1545,1614,2337,723
2018,12,31,4,1505,1595,2340,745
2018,12,31,5,1450,1545,2336,791
2018,12,31,6,1365,1480,2331,851
2018,12,31,7,1310,1420,2314,894
2018,12,31,8,1340,1373,2185,812
2018,12,31,9,1320,1360,2169,809
2018,12,31,10,1315,1349,2239,890
2018,12,31,11,1305,1352,2222,870
2018,12,31,12,1335,1365,2211,846
2018,12,31,13,1370,1409,2226,817
2018,12,31,14,1470,1486,2232,746
2018,12,31,15,1575,1554,2221,667
2018,12,31,16,1620,1601,2135,534
2018,12,31,17,1650,1631,2127,496
2018,12,31,18,1655,1628,2174,546
2018,12,31,19,1630,1613,2203,590
2018,12,31,20,1600,1594,2184,590
2018,12,31,21,1590,1573,2141,568
2018,12,31,22,1570,1565,2120,555
2018,12,31,23,1575,1568,2117,549
2019,1,1,0,1605,1613,2117,504
2019,1,1,1,1665,1700,2126,426
2019,1,1,2,1645,1689,2124,435
2019,1,1,3,1620,1664,2121,457
2019,1,1,4,1590,1642,2125,483
2019,1,1,5,1560,1614,2143,529
2019,1,1,6,1500,1581,2152,571
2019,1,1,7,-9999,1545,2163,618
2019,1,1,8,1335,0,2163,0
2019,1,1,9,1305,0,2169,0
2019,1,1,10,1300,0,2239,0
2019,1,1,11,1290,0,2222,0
2019,1,1,12,1305,0,2211,0
2019,1,1,13,1335,0,2226,0
2019,1,1,14,1410,0,2232,0
2019,1,1,15,1485,0,2221,0
2019,1,1,16,1515,0,2135,0
2019,1,1,17,1525,0,2127,0
2019,1,1,18,1545,0,2174,0
2019,1,1,19,1540,0,2203,0
2019,1,1,20,1515,0,2184,0
2019,1,1,21,1510,0,2141,0
2019,1,1,22,1495,0,2120,0
2019,1,1,23,1500,0,2117,0
2019,1,2,0,1540,0,2117,0
2019,1,2,1,1605,0,2126,0
2019,1,2,2,1605,0,2124,0
2019,1,2,3,1580,0,2121,0
2019,1,2,4,1555,0,2125,0
2019,1,2,5,1485,0,2143,0
2019,1,2,6,1435,0,2152,0
2019,1,2,7,1370,0,2163,0
2019,1,2,8,1310,0,0,0
2019,1,2,9,1285,0,0,0
2019,1,2,10,1280,0,0,0
2019,1,2,11,1270,0,0,0
2019,1,2,12,1285,0,0,0
2019,1,2,13,1315,0,0,0
2019,1,2,14,1380,0,0,0
2019,1,2,15,1455,0,0,0
2019,1,2,16,1490,0,0,0
2019,1,2,17,1510,0,0,0
2019,1,2,18,1520,0,0,0
2019,1,2,19,1515,0,0,0
2019,1,2,20,1500,0,0,0
2019,1,2,21,1475,0,0,0
2019,1,2,22,1480,0,0,0
2019,1,2,23,1485,0,0,0
2019,1,3,0,1535,0,0,0
2019,1,3,1,1615,0,0,0
2019,1,3,2,1620,0,0,0
2019,1,3,3,1600,0,0,0
2019,1,3,4,1570,0,0,0
2019,1,3,5,1455,0,0,0
2019,1,3,6,1435,0,0,0
2019,1,3,7,1365,0,0,0
2019,1,3,8,1325,1368,2704,1336
2019,1,3,9,1300,1351,2757,1406
2019,1,3,10,1310,1331,2758,1427
2019,1,3,11,1305,1339,2895,1556
2019,1,3,12,1330,1355,2908,1553
2019,1,3,13,1375,1433,2942,1509
2019,1,3,14,1450,1532,2949,1417
2019,1,3,15,1535,1608,2960,1352
2019,1,3,16,1565,1614,2973,1359
2019,1,3,17,1575,1609,2979,1370
2019,1,3,18,1575,1592,2992,1400
2019,1,3,19,1565,1568,3001,1433
2019,1,3,20,1545,1557,2997,1440
2019,1,3,21,1525,1543,2985,1442
2019,1,3,22,1515,1538,2975,1437
2019,1,3,23,1525,1548,2979,1431
2019,1,4,0,1570,1578,3002,1424
2019,1,4,1,1635,1648,2994,1346
2019,1,4,2,1630,1637,2966,1329
2019,1,4,3,1605,1626,3000,1374
2019,1,4,4,1570,1596,2986,1390
2019,1,4,5,1535,1535,3008,1473
2019,1,4,6,1440,1464,3059,1595
2019,1,4,7,1375,1389,3022,1633
2019,1,4,8,1290,1353,3045,1692
2019,1,4,9,1310,1320,2993,1673
2019,1,4,10,1300,1323,2940,1617
2019,1,4,11,1300,1304,2964,1660
2019,1,4,12,1320,1339,2960,1621
2019,1,4,13,1365,1383,2987,1604
2019,1,4,14,1495,1498,2958,1460
2019,1,4,15,1590,1573,2908,1335
2019,1,4,16,1595,1584,2908,1324
2019,1,4,17,1585,1575,2955,1380
2019,1,4,18,1590,1553,2928,1375
2019,1,4,19,1565,1541,2936,1395
2019,1,4,20,1535,1514,2973,1459
2019,1,4,21,1520,1514,2998,1484
2019,1,4,22,1510,1515,2971,1456
2019,1,4,23,1510,1496,2949,1453
2019,1,5,0,1560,1535,2969,1434
2019,1,5,1,1640,1580,3001,1421
2019,1,5,2,1650,1584,2976,1392
2019,1,5,3,1630,1558,2990,1432
2019,1,5,4,1595,1526,3008,1482
2019,1,5,5,1590,1490,2998,1508
2019,1,5,6,1460,1428,3016,1588
2019,1,5,7,1385,1359,2950,1591
2019,1,5,8,1285,1312,2908,1596
2019,1,5,9,1250,1289,2833,1544
2019,1,5,10,1240,1270,2802,1532
2019,1,5,11,1240,1278,2796,1518
2019,1,5,12,1245,1288,2618,1330
2019,1,5,13,1285,1302,2476,1174
2019,1,5,14,1370,1355,2462,1107
2019,1,5,15,1455,1415,2448,1033
2019,1,5,16,1480,1446,2441,995
2019,1,5,17,1500,1486,2476,990
2019,1,5,18,1505,1478,2473,995
2019,1,5,19,1495,1457,2471,1014
2019,1,5,20,1470,1440,2464,1024
2019,1,5,21,1455,1410,2465,1055
2019,1,5,22,1445,1406,2461,1055
2019,1,5,23,1455,1424,2477,1053
2019,1,6,0,1495,1479,2500,1021
2019,1,6,1,1570,1558,2537,979
2019,1,6,2,1570,1547,2537,990
2019,1,6,3,1545,1518,2531,1013
2019,1,6,4,1515,1492,2530,1038
2019,1,6,5,1455,1437,2454,1017
2019,1,6,6,1395,1378,2441,1063
2019,1,6,7,1330,1322,2447,1125
2019,1,6,8,1285,1280,2487,1207
2019,1,6,9,1265,1248,2516,1268
2019,1,6,10,1250,1241,2563,1322
2019,1,6,11,1245,1227,2519,1292
2019,1,6,12,1250,1240,2432,1192
2019,1,6,13,1280,1270,2418,1148
2019,1,6,14,1335,1322,2610,1288
2019,1,6,15,1400,1389,2650,1261
2019,1,6,16,1430,1425,2601,1176
2019,1,6,17,1460,1451,2575,1124
2019,1,6,18,1460,1462,2617,1155
2019,1,6,19,1450,1484,2695,1211
2019,1,6,20,1455,1474,2757,1283
2019,1,6,21,1440,1455,2772,1317
2019,1,6,22,1435,1462,2775,1313
2019,1,6,23,1450,1475,2778,1303
2019,1,7,0,1485,1522,2783,1261
2019,1,7,1,1560,1596,2730,1134
2019,1,7,2,1560,1594,2648,1054
2019,1,7,3,1540,1572,2669,1097
2019,1,7,4,1510,1535,2698,1163
2019,1,7,5,1400,1467,2676,1209
2019,1,7,6,1385,1389,2659,1270
2019,1,7,7,1330,1337,2605,1268
2019,1,7,8,1250,1288,2427,1139
2019,1,7,9,1280,1270,2394,1124
2019,1,7,10,1265,1250,2353,1103
2019,1,7,11,1260,1264,2335,1071
2019,1,7,12,1280,1284,2519,1235
2019,1,7,13,1325,1344,2545,1201
2019,1,7,14,1460,1470,2601,1131
2019,1,7,15,1565,1558,2580,1022
2019,1,7,16,1580,1566,2632,1066
2019,1,7,17,1580,1570,2577,1007
2019,1,7,18,1590,1555,2700,1145
2019,1,7,19,1560,1545,2625,1080
2019,1,7,20,1530,1547,2734,1187
2019,1,7,21,1510,1555,2717,1162
2019,1,7,22,1500,1547,2725,1178
2019,1,7,23,1500,1556,2745,1189
2019,1,8,0,1545,1596,2735,1139
2019,1,8,1,1620,1675,2811,1136
2019,1,8,2,1625,1683,2871,1188
2019,1,8,3,1605,1660,2952,1292
2019,1,8,4,1565,1624,3007,1383
2019,1,8,5,1500,1560,3014,1454
2019,1,8,6,1450,1479,2973,1494
2019,1,8,7,1375,1413,2909,1496
2019,1,8,8,1255,1362,2899,1537
2019,1,8,9,1255,1349,2966,1617
2019,1,8,10,1250,1340,2974,1634
2019,1,8,11,1235,1350,2973,1623
2019,1,8,12,1265,1380,2978,1598
2019,1,8,13,1305,1429,2995,1566
2019,1,8,14,1440,1546,3024,1478
2019,1,8,15,1545,1640,3002,1362
2019,1,8,16,1560,1611,2917,1306
2019,1,8,17,1550,1617,2911,1294
2019,1,8,18,1550,1583,2899,1316
2019,1,8,19,1530,1561,2897,1336
2019,1,8,20,1505,1539,2897,1358
2019,1,8,21,1490,1514,2837,1323
2019,1,8,22,1485,1515,2798,1283
2019,1,8,23,1480,1517,2797,1280
2019,1,9,0,1520,1584,2846,1262
2019,1,9,1,1580,1706,2938,1232
2019,1,9,2,1590,1730,2920,1190
2019,1,9,3,1570,1717,2865,1148
2019,1,9,4,1535,1673,2858,1185
2019,1,9,5,1475,1608,2697,1089
2019,1,9,6,1420,1505,2572,1067
2019,1,9,7,1350,1429,2271,842
2019,1,9,8,1280,1380,2109,729
2019,1,9,9,1295,1350,2057,707
2019,1,9,10,1280,1331,2027,696
2019,1,9,11,1280,1328,2065,737
2019,1,9,12,1300,1344,2068,724
2019,1,9,13,1350,1396,2109,713
2019,1,9,14,1465,1521,2134,613
2019,1,9,15,1550,1555,2155,600
2019,1,9,16,1560,1541,2120,579
2019,1,9,17,1555,1573,2110,537
2019,1,9,18,1560,1556,2118,562
2019,1,9,19,1540,1528,2127,599
2019,1,9,20,1520,1488,2130,642
2019,1,9,21,1505,1477,2127,650
2019,1,9,22,1500,1468,2099,631
2019,1,9,23,1500,1463,2101,638
2019,1,10,0,1550,1521,2174,653
2019,1,10,1,1625,1599,2224,625
2019,1,10,2,1640,1608,2223,615
2019,1,10,3,1620,1603,2214,611
2019,1,10,4,1575,1571,2234,663
2019,1,10,5,1505,1510,2223,713
2019,1,10,6,1435,1449,2183,734
2019,1,10,7,1365,1374,2310,936
2019,1,10,8,1315,1350,2310,960
2019,1,10,9,1300,1341,2320,979
2019,1,10,10,1290,1347,2509,1162
2019,1,10,11,1295,1366,2696,1330
2019,1,10,12,1320,1384,2730,1346
2019,1,10,13,1380,1445,2740,1295
2019,1,10,14,1500,1558,2718,1160
2019,1,10,15,1595,1648,2761,1113
2019,1,10,16,1590,1643,2861,1218
2019,1,10,17,1600,1636,2872,1236
2019,1,10,18,1570,1611,2853,1242
2019,1,10,19,1550,1595,2858,1263
2019,1,10,20,1530,1580,2909,1329
2019,1,10,21,1510,1579,2966,1387
2019,1,10,22,1510,1574,3013,1439
2019,1,10,23,1515,1562,3005,1443
2019,1,11,0,1565,1599,3003,1404
2019,1,11,1,1665,1675,3002,1327
2019,1,11,2,1670,1688,2998,1310
2019,1,11,3,1655,1664,2984,1320
2019,1,11,4,1615,1622,3014,1392
2019,1,11,5,1550,1541,2992,1451
2019,1,11,6,1470,1468,2918,1450
2019,1,11,7,1400,1402,2892,1490
2019,1,11,8,1330,1384,2813,1429
2019,1,11,9,1295,1366,2781,1415
2019,1,11,10,1295,1367,2788,1421
2019,1,11,11,1280,1371,2797,1426
2019,1,11,12,1315,1383,2813,1430
2019,1,11,13,1360,1444,2809,1365
2019,1,11,14,1490,1555,2844,1289
2019,1,11,15,1585,1655,2840,1185
2019,1,11,16,1590,1638,2820,1182
2019,1,11,17,1590,1608,2783,1175
2019,1,11,18,1575,1615,2805,1190
2019,1,11,19,1550,1578,2819,1241
2019,1,11,20,1525,1551,2824,1273
2019,1,11,21,1520,1525,2796,1271
2019,1,11,22,1515,1517,2783,1266
2019,1,11,23,1505,1511,2784,1273
2019,1,12,0,1550,1537,2804,1267
2019,1,12,1,1605,1627,2874,1247
2019,1,12,2,1615,1638,2900,1262
2019,1,12,3,1590,1619,2903,1284
2019,1,12,4,1565,1602,2879,1277
2019,1,12,5,1495,1547,2887,1340
2019,1,12,6,1455,1503,2854,1351
2019,1,12,7,1380,1443,2845,1402
2019,1,12,8,1305,1426,2860,1434
2019,1,12,9,1285,1405,2884,1479
2019,1,12,10,1270,1398,2899,1501
2019,1,12,11,1275,1394,2918,1524
2019,1,12,12,1290,1391,2880,1489
2019,1,12,13,1315,1428,2876,1448
2019,1,12,14,1380,1477,2874,1397
2019,1,12,15,1455,1546,2865,1319
2019,1,12,16,1480,1573,2851,1278
2019,1,12,17,1510,1609,2857,1248
2019,1,12,18,1505,1605,2842,1237
2019,1,12,19,1485,1576,2816,1240
2019,1,12,20,1465,1546,2821,1275
2019,1,12,21,1445,1527,2758,1231
2019,1,12,22,1435,1502,2740,1238
2019,1,12,23,1450,1495,2723,1228
2019,1,13,0,1500,1536,2766,1230
2019,1,13,1,1580,1626,2853,1227
2019,1,13,2,1575,1643,2854,1211
2019,1,13,3,1545,1622,2832,1210
2019,1,13,4,1515,1584,2838,1254
2019,1,13,5,1455,1553,2835,1282
2019,1,13,6,1390,1494,2827,1333
2019,1,13,7,1330,1434,2818,1384
2019,1,13,8,1300,1404,2824,1420
2019,1,13,9,1270,1385,2788,1403
2019,1,13,10,1265,1379,2812,1433
2019,1,13,11,1255,1372,2808,1436
2019,1,13,12,1270,1387,2790,1403
2019,1,13,13,1305,1403,2781,1378
2019,1,13,14,1335,1449,2771,1322
2019,1,13,15,1380,1524,2802,1278
2019,1,13,16,1410,1558,2792,1234
2019,1,13,17,1435,1595,2809,1214
2019,1,13,18,1440,1581,2799,1218
2019,1,13,19,1455,1580,2805,1225
2019,1,13,20,1445,1563,2786,1223
2019,1,13,21,1430,1536,2764,1228
2019,1,13,22,1435,1521,2765,1244
2019,1,13,23,1445,1514,2780,1266
2019,1,14,0,1490,1558,2803,1245
2019,1,14,1,1565,1663,2826,1163
2019,1,14,2,1570,1702,2843,1141
2019,1,14,3,1545,1681,2833,1152
2019,1,14,4,1510,1657,2833,1176
2019,1,14,5,1380,1586,2837,1251
2019,1,14,6,1370,1505,2846,1341
2019,1,14,7,1315,1444,2845,1401
2019,1,14,8,1295,1412,2818,1406
2019,1,14,9,1280,1405,2812,1407
2019,1,14,10,1270,1404,2810,1406
2019,1,14,11,1285,1406,2809,1403
2019,1,14,12,1300,1435,2836,1401
2019,1,14,13,1360,1480,2840,1360
2019,1,14,14,1465,1607,2813,1206
2019,1,14,15,1550,1718,2832,1114
2019,1,14,16,1555,1720,2840,1120
2019,1,14,17,1560,1695,2824,1129
2019,1,14,18,1540,1689,2806,1117
2019,1,14,19,1530,1647,2768,1121
2019,1,14,20,1520,1619,2779,1160
2019,1,14,21,1525,1611,2828,1217
2019,1,14,22,1515,1587,2844,1257
2019,1,14,23,1515,1566,2836,1270
2019,1,15,0,1555,1597,2834,1237
2019,1,15,1,1630,1676,2866,1190
2019,1,15,2,1640,1716,2845,1129
2019,1,15,3,1615,1703,2819,1116
2019,1,15,4,1575,1682,2822,1140
2019,1,15,5,1510,1631,2829,1198
2019,1,15,6,1445,1527,2856,1329
2019,1,15,7,1385,1469,2852,1383
2019,1,15,8,1375,1439,2886,1447
2019,1,15,9,1360,1408,2832,1424
2019,1,15,10,1350,1420,2877,1457
2019,1,15,11,1360,1416,2889,1473
2019,1,15,12,1380,1437,2861,1424
2019,1,15,13,1420,1485,2848,1363
2019,1,15,14,1505,1616,2799,1183
2019,1,15,15,1580,1735,2798,1063
2019,1,15,16,1570,1725,2783,1058
2019,1,15,17,1585,1700,2768,1068
2019,1,15,18,1560,1680,2763,1083
2019,1,15,19,1545,1648,2757,1109
2019,1,15,20,1525,1615,2744,1129
2019,1,15,21,1505,1612,2750,1138
2019,1,15,22,1500,1615,2774,1159
2019,1,15,23,1500,1615,2784,1169
2019,1,16,0,1560,1655,2812,1157
2019,1,16,1,1670,1721,2827,1106
2019,1,16,2,1690,1726,2857,1131
2019,1,16,3,1670,1705,2863,1158
2019,1,16,4,1630,1668,2894,1226
2019,1,16,5,1580,1605,2881,1276
2019,1,16,6,1480,1517,2881,1364
2019,1,16,7,1410,1473,2911,1438
2019,1,16,8,1385,1426,2918,1492
2019,1,16,9,1380,1409,2913,1504
2019,1,16,10,1370,1412,2911,1499
2019,1,16,11,1370,1417,2909,1492
2019,1,16,12,1395,1432,2912,1480
2019,1,16,13,1445,1505,2910,1405
2019,1,16,14,1580,1630,2906,1276
2019,1,16,15,1675,1735,2938,1203
2019,1,16,16,1665,1727,2985,1258
2019,1,16,17,1660,1696,2978,1282
2019,1,16,18,1650,1683,2938,1255
2019,1,16,19,1615,1628,2948,1320
2019,1,16,20,1585,1613,2992,1379
2019,1,16,21,1570,1597,3014,1417
2019,1,16,22,1550,1584,2989,1405
2019,1,16,23,1535,1587,2953,1366
2019,1,17,0,1585,1620,2918,1298
2019,1,17,1,1660,1697,2915,1218
2019,1,17,2,1690,1726,2918,1192
2019,1,17,3,1680,1699,2903,1204
2019,1,17,4,1650,1662,2921,1259
2019,1,17,5,1600,1602,2928,1326
2019,1,17,6,1505,1526,2849,1323
2019,1,17,7,1430,1464,2859,1395
2019,1,17,8,1390,1427,2848,1421
2019,1,17,9,1365,1417,2850,1433
2019,1,17,10,1365,1395,2826,1431
2019,1,17,11,1370,1406,2848,1442
2019,1,17,12,1395,1409,2840,1431
2019,1,17,13,1450,1481,2850,1369
2019,1,17,14,1575,1602,2889,1287
2019,1,17,15,1690,1710,2851,1141
2019,1,17,16,1685,1736,2829,1093
2019,1,17,17,1665,1745,2833,1088
2019,1,17,18,1640,1749,2829,1080
2019,1,17,19,1615,1739,2834,1095
2019,1,17,20,1590,1718,2830,1112
2019,1,17,21,1585,1689,2764,1075
2019,1,17,22,1585,1669,2750,1081
2019,1,17,23,1585,1663,2737,1074
2019,1,18,0,1620,1692,2802,1110
2019,1,18,1,1695,1748,2816,1068
2019,1,18,2,1695,1768,2844,1076
2019,1,18,3,1680,1766,2852,1086
2019,1,18,4,1640,1727,2817,1090
2019,1,18,5,1570,1655,2804,1149
2019,1,18,6,1485,1572,2750,1178
2019,1,18,7,1430,1496,2813,1317
2019,1,18,8,1360,1449,2739,1290
2019,1,18,9,1345,1436,2716,1280
2019,1,18,10,1345,1443,2752,1309
2019,1,18,11,1345,1446,2758,1312
2019,1,18,12,1365,1451,2767,1316
2019,1,18,13,1425,1495,2786,1291
2019,1,18,14,1550,1595,2788,1193
2019,1,18,15,1655,1690,2817,1127
2019,1,18,16,1640,1687,2839,1152
2019,1,18,17,1615,1672,2843,1171
2019,1,18,18,1615,1662,2861,1199
2019,1,18,19,1575,1650,2888,1238
2019,1,18,20,1555,1610,2878,1268
2019,1,18,21,1530,1588,2945,1357
2019,1,18,22,1520,1590,2983,1393
2019,1,18,23,1515,1571,2992,1421
2019,1,19,0,1550,1600,3022,1422
2019,1,19,1,1630,1651,3083,1432
2019,1,19,2,1645,1666,3099,1433
2019,1,19,3,1620,1650,3074,1424
2019,1,19,4,1600,1601,3047,1446
2019,1,19,5,1530,1573,3081,1508
2019,1,19,6,1485,1532,3042,1510
2019,1,19,7,1425,1484,3041,1557
2019,1,19,8,1395,1437,3021,1584
2019,1,19,9,1370,1425,3003,1578
2019,1,19,10,1365,1408,2964,1556
2019,1,19,11,1365,1400,2931,1531
2019,1,19,12,1365,1408,2924,1516
2019,1,19,13,1410,1424,2925,1501
2019,1,19,14,1470,1473,3022,1549
2019,1,19,15,1545,1539,3062,1523
2019,1,19,16,1575,1577,3086,1509
2019,1,19,17,1600,1611,3089,1478
2019,1,19,18,1600,1613,3109,1496
2019,1,19,19,1575,1596,3065,1469
2019,1,19,20,1550,1584,3018,1434
2019,1,19,21,1530,1561,2979,1418
2019,1,19,22,1505,1553,2981,1428
2019,1,19,23,1505,1550,3014,1464
2019,1,20,0,1545,1575,2995,1420
2019,1,20,1,1625,1645,3055,1410
2019,1,20,2,1640,1636,3012,1376
2019,1,20,3,1620,1621,3068,1447
2019,1,20,4,1585,1596,3104,1508
2019,1,20,5,1545,1543,3085,1542
2019,1,20,6,1475,1479,3058,1579
2019,1,20,7,1410,1412,3000,1588
2019,1,20,8,1380,1384,3000,1616
2019,1,20,9,1360,1358,3012,1654
2019,1,20,10,1355,1340,2964,1624
2019,1,20,11,1350,1333,2875,1542
2019,1,20,12,1360,1336,2895,1559
2019,1,20,13,1395,1345,2910,1565
2019,1,20,14,1425,1375,2876,1501
2019,1,20,15,1475,1447,2843,1396
2019,1,20,16,1505,1486,2837,1351
2019,1,20,17,1530,1535,2837,1302
2019,1,20,18,1525,1528,2841,1313
2019,1,20,19,1530,1537,2841,1304
2019,1,20,20,1510,1544,2862,1318
2019,1,20,21,1485,1533,2861,1328
2019,1,20,22,1475,1522,2858,1336
2019,1,20,23,1475,1532,2870,1338
2019,1,21,0,1510,1576,2889,1313
2019,1,21,1,1595,1637,2888,1251
2019,1,21,2,1625,1643,2930,1287
2019,1,21,3,1605,1601,2855,1254
2019,1,21,4,1580,1579,2833,1254
2019,1,21,5,1475,1523,2823,1300
2019,1,21,6,1430,1454,2816,1362
2019,1,21,7,1370,1399,2816,1417
2019,1,21,8,1385,1364,2816,1452
2019,1,21,9,1375,1352,2824,1472
2019,1,21,10,1365,1348,2840,1492
2019,1,21,11,1370,1344,2880,1536
2019,1,21,12,1395,1380,2930,1550
2019,1,21,13,1445,1455,3042,1587
2019,1,21,14,1565,1527,3086,1559
2019,1,21,15,1665,1600,3041,1441
2019,1,21,16,1665,1597,3030,1433
2019,1,21,17,1650,1568,2990,1422
2019,1,21,18,1640,1606,3047,1441
2019,1,21,19,1615,1608,3066,1458
2019,1,21,20,1590,1587,3021,1434
2019,1,21,21,1580,1598,3040,1442
2019,1,21,22,1560,1580,3013,1433
2019,1,21,23,1545,1586,3020,1434
2019,1,22,0,1585,1618,3033,1415
2019,1,22,1,1655,1676,3022,1346
2019,1,22,2,1685,1696,3026,1330
2019,1,22,3,1670,1644,3023,1379
2019,1,22,4,1645,1612,2959,1347
2019,1,22,5,1560,1574,2930,1356
2019,1,22,6,1495,1490,2904,1414
2019,1,22,7,1430,1428,2883,1455
2019,1,22,8,1380,1384,2718,1334
2019,1,22,9,1350,1389,2711,1322
2019,1,22,10,1350,1376,2705,1329
2019,1,22,11,1350,1388,2724,1336
2019,1,22,12,1370,1411,2852,1441
2019,1,22,13,1415,1495,2978,1483
2019,1,22,14,1525,1619,3088,1469
2019,1,22,15,1630,1717,3106,1389
2019,1,22,16,1625,1708,3027,1319
2019,1,22,17,1615,1679,3008,1329
2019,1,22,18,1590,1663,2988,1325
2019,1,22,19,1570,1645,3006,1361
2019,1,22,20,1545,1618,3020,1402
2019,1,22,21,1535,1621,3037,1416
2019,1,22,22,1535,1620,3054,1434
2019,1,22,23,1540,1608,2990,1382
2019,1,23,0,1585,1640,2971,1331
2019,1,23,1,1655,1706,2975,1269
2019,1,23,2,1660,1742,3017,1275
2019,1,23,3,1640,1726,3032,1306
2019,1,23,4,1605,1675,3060,1385
2019,1,23,5,1540,1612,3073,1461
2019,1,23,6,1460,1531,3014,1483
2019,1,23,7,1405,1477,2985,1508
2019,1,23,8,1380,1428,2844,1416
2019,1,23,9,1365,1405,2821,1416
2019,1,23,10,1360,1412,2936,1524
2019,1,23,11,1360,1433,2957,1524
2019,1,23,12,1380,1441,2952,1511
2019,1,23,13,1450,1491,2950,1459
2019,1,23,14,1565,1601,3029,1428
2019,1,23,15,1645,1651,2991,1340
2019,1,23,16,1635,1651,2953,1302
2019,1,23,17,1615,1638,2900,1262
2019,1,23,18,1610,1653,2867,1214
2019,1,23,19,1570,1671,2919,1248
2019,1,23,20,1550,1664,2921,1257
2019,1,23,21,1540,1686,2971,1285
2019,1,23,22,1530,1672,2947,1275
2019,1,23,23,1530,1649,2916,1267
2019,1,24,0,1570,1692,2961,1269
2019,1,24,1,1645,1749,3000,1251
2019,1,24,2,1670,1772,3005,1233
2019,1,24,3,1640,1737,2998,1261
2019,1,24,4,1605,1697,2969,1272
2019,1,24,5,1560,1616,2978,1362
2019,1,24,6,1475,1532,2975,1443
2019,1,24,7,1405,1478,2912,1434
2019,1,24,8,1395,1441,2895,1454
2019,1,24,9,1390,1427,2814,1387
2019,1,24,10,1375,1416,2773,1357
2019,1,24,11,1385,1418,2771,1353
2019,1,24,12,1400,1455,2830,1375
2019,1,24,13,1470,1508,2868,1360
2019,1,24,14,1575,1642,2897,1255
2019,1,24,15,1655,1730,2926,1196
2019,1,24,16,1660,1703,2861,1158
2019,1,24,17,1650,1699,2864,1165
2019,1,24,18,1640,1684,2886,1202
2019,1,24,19,1630,1664,2856,1192
2019,1,24,20,1605,1661,2757,1096
2019,1,24,21,1595,1653,2779,1126
2019,1,24,22,1585,1636,2815,1179
2019,1,24,23,1580,1620,2836,1216
2019,1,25,0,1610,1631,2895,1264
2019,1,25,1,1675,1685,2912,1227
2019,1,25,2,1695,1714,2905,1191
2019,1,25,3,1680,1708,2841,1133
2019,1,25,4,1640,1665,2877,1212
2019,1,25,5,1570,1608,2859,1251
2019,1,25,6,1490,1542,2945,1403
2019,1,25,7,1420,1453,2949,1496
2019,1,25,8,1380,1419,2955,1536
2019,1,25,9,1360,1394,2877,1483
2019,1,25,10,1360,1413,2886,1473
2019,1,25,11,1365,1417,2885,1468
2019,1,25,12,1380,1425,2907,1482
2019,1,25,13,1425,1484,2938,1454
2019,1,25,14,1545,1599,2982,1383
2019,1,25,15,1650,1700,3018,1318
2019,1,25,16,1645,1682,3005,1323
2019,1,25,17,1630,1682,2987,1305
2019,1,25,18,1625,1659,2965,1306
2019,1,25,19,1610,1642,2980,1338
2019,1,25,20,1580,1604,2926,1322
2019,1,25,21,1560,1590,2874,1284
2019,1,25,22,1560,1572,2878,1306
2019,1,25,23,1545,1558,2826,1268
2019,1,26,0,1575,1570,2926,1356
2019,1,26,1,1635,1624,2919,1295
2019,1,26,2,1650,1637,2906,1269
2019,1,26,3,1630,1609,2933,1324
2019,1,26,4,1590,1588,2957,1369
2019,1,26,5,1540,1559,2950,1391
2019,1,26,6,1500,1523,2947,1424
2019,1,26,7,1445,1451,2948,1497
2019,1,26,8,1375,1426,2945,1519
2019,1,26,9,1360,1407,2955,1548
2019,1,26,10,1350,1381,2951,1570
2019,1,26,11,1340,1384,2960,1576
2019,1,26,12,1350,1367,2954,1587
2019,1,26,13,1375,1401,2966,1565
2019,1,26,14,1445,1444,2979,1535
2019,1,26,15,1525,1509,3028,1519
2019,1,26,16,1555,1547,3032,1485
2019,1,26,17,1585,1570,2984,1414
2019,1,26,18,1585,1588,2978,1390
2019,1,26,19,1565,1572,2979,1407
2019,1,26,20,1550,1557,3029,1472
2019,1,26,21,1530,1527,3035,1508
2019,1,26,22,1525,1508,3037,1529
2019,1,26,23,1515,1513,3040,1527
2019,1,27,0,1540,1530,3033,1503
2019,1,27,1,1610,1587,3038,1451
2019,1,27,2,1610,1615,3036,1421
2019,1,27,3,1595,1583,3029,1446
2019,1,27,4,1565,1561,3025,1464
2019,1,27,5,1525,1520,3025,1505
2019,1,27,6,1455,1476,3012,1536
2019,1,27,7,1385,1410,2978,1568
2019,1,27,8,1365,1382,2961,1579
2019,1,27,9,1335,1343,2823,1480
2019,1,27,10,1325,1334,2789,1455
2019,1,27,11,1320,1330,2744,1414
2019,1,27,12,1325,1336,2756,1420
2019,1,27,13,1340,1355,2743,1388
2019,1,27,14,1375,1419,2835,1416
2019,1,27,15,1435,1481,2918,1437
2019,1,27,16,1465,1514,2893,1379
2019,1,27,17,1490,1529,2919,1390
2019,1,27,18,1495,1549,2934,1385
2019,1,27,19,1500,1532,2893,1361
2019,1,27,20,1500,1536,2931,1395
2019,1,27,21,1490,1541,2929,1388
2019,1,27,22,1480,1554,2966,1412
2019,1,27,23,1485,1566,2978,1412
2019,1,28,0,1525,1557,2966,1409
2019,1,28,1,1585,1629,3013,1384
2019,1,28,2,1600,1663,3000,1337
2019,1,28,3,1565,1637,2939,1302
2019,1,28,4,1540,1619,2937,1318
2019,1,28,5,1435,1575,2953,1378
2019,1,28,6,1415,1505,2925,1420
2019,1,28,7,1355,1444,2926,1482
2019,1,28,8,1350,1397,2878,1481
2019,1,28,9,1335,1379,2827,1448
2019,1,28,10,1330,1370,2829,1459
2019,1,28,11,1330,1380,2852,1472
2019,1,28,12,1360,1406,2837,1431
2019,1,28,13,1435,1475,2859,1384
2019,1,28,14,1535,1594,2892,1298
2019,1,28,15,1620,1691,2881,1190
2019,1,28,16,1615,1677,2835,1158
2019,1,28,17,1590,1657,2853,1196
2019,1,28,18,1620,1641,2858,1217
2019,1,28,19,1615,1614,2850,1236
2019,1,28,20,1590,1594,2848,1254
2019,1,28,21,1600,1568,2878,1310
2019,1,28,22,1580,1561,2881,1320
2019,1,28,23,1580,1559,2873,1314
2019,1,29,0,1615,1571,2864,1293
2019,1,29,1,1675,1652,2860,1208
2019,1,29,2,1695,1707,2864,1157
2019,1,29,3,1655,1686,2844,1158
2019,1,29,4,1625,1651,2829,1178
2019,1,29,5,1570,1609,2809,1200
2019,1,29,6,1495,1529,2833,1304
2019,1,29,7,1430,1477,2884,1407
2019,1,29,8,1415,1443,2875,1432
2019,1,29,9,1410,1417,2703,1286
2019,1,29,10,1400,1416,2672,1256
2019,1,29,11,1410,1416,2667,1251
2019,1,29,12,1425,1443,2704,1261
2019,1,29,13,1500,1502,2704,1202
2019,1,29,14,1600,1639,2823,1184
2019,1,29,15,1675,1756,2828,1072
2019,1,29,16,1675,1741,2813,1072
2019,1,29,17,1655,1722,2806,1084
2019,1,29,18,1635,1681,2773,1092
2019,1,29,19,1615,1650,2781,1131
2019,1,29,20,1590,1607,2743,1136
2019,1,29,21,1590,1588,2722,1134
2019,1,29,22,1595,1572,2696,1124
2019,1,29,23,1585,1575,2696,1121
2019,1,30,0,1615,1604,2688,1084
2019,1,30,1,1690,1668,2771,1103
2019,1,30,2,1715,1729,2791,1062
2019,1,30,3,1695,1719,2818,1099
2019,1,30,4,1650,1687,2797,1110
2019,1,30,5,1590,1632,2790,1158
2019,1,30,6,1505,1555,2781,1226
2019,1,30,7,1450,1494,2861,1367
2019,1,30,8,1415,1498,2893,1395
2019,1,30,9,1390,1492,2944,1452
2019,1,30,10,1390,1488,2946,1458
2019,1,30,11,1410,1488,2961,1473
2019,1,30,12,1420,1516,2970,1454
2019,1,30,13,1470,1558,2965,1407
2019,1,30,14,1580,1696,2971,1275
2019,1,30,15,1630,1789,2955,1166
2019,1,30,16,1630,1775,2932,1157
2019,1,30,17,1615,1752,2937,1185
2019,1,30,18,1615,1736,2922,1186
2019,1,30,19,1605,1721,2921,1200
2019,1,30,20,1595,1689,2910,1221
2019,1,30,21,1600,1675,2923,1248
2019,1,30,22,1595,1648,2899,1251
2019,1,30,23,1590,1640,2911,1271
2019,1,31,0,1625,1662,2895,1233
2019,1,31,1,1690,1709,2904,1195
2019,1,31,2,1720,1747,2952,1205
2019,1,31,3,1685,1723,2960,1237
2019,1,31,4,1650,1683,2889,1206
2019,1,31,5,1570,1626,2896,1270
2019,1,31,6,1490,1515,2597,1082
2019,1,31,7,1430,1422,2274,852
2019,1,31,8,1420,1420,2274,-9999
2019,1,31,9,1410,1410,2944,-9999
2019,1,31,10,1400,1400,2946,-9999
2019,1,31,11,1405,1405,2961,-9999
2019,1,31,12,1430,1430,2970,-9999
2019,1,31,13,1490,1490,2965,-9999
2019,1,31,14,1605,1605,2971,-9999
2019,1,31,15,1685,1685,2955,-9999
2019,1,31,16,1675,1675,2932,-9999
2019,1,31,17,1665,1665,2937,-9999
2019,1,31,18,1645,1645,2922,-9999
2019,1,31,19,1625,1625,2921,-9999
2019,1,31,20,1610,1610,2910,-9999
2019,1,31,21,1595,1595,2923,-9999
2019,1,31,22,1580,1580,2899,-9999
2019,1,31,23,1570,1570,2911,-9999
2019,2,1,0,1585,1585,2895,-9999
2019,2,1,1,1645,1645,2904,-9999
2019,2,1,2,1680,1680,2952,-9999
2019,2,1,3,1675,1675,2960,-9999
2019,2,1,4,1635,1635,2889,-9999
2019,2,1,5,1535,1535,2896,-9999
2019,2,1,6,1505,1505,2597,-9999
2019,2,1,7,-9999,1422,2274,-9999
2019,2,1,8,1335,1301,2022,721
2019,2,1,9,1320,1281,1939,658
2019,2,1,10,1330,1264,1896,632
2019,2,1,11,1335,1278,1908,630
2019,2,1,12,1350,1290,2078,788
2019,2,1,13,1400,1357,2138,781
2019,2,1,14,1525,1449,2145,696
2019,2,1,15,1640,1549,2189,640
2019,2,1,16,1620,1553,2151,598
2019,2,1,17,1605,1525,2175,650
2019,2,1,18,1590,1485,2108,623
2019,2,1,19,1585,1457,2115,658
2019,2,1,20,1545,1435,2147,712
2019,2,1,21,1530,1420,2152,732
2019,2,1,22,1515,1408,2124,716
2019,2,1,23,1500,1392,2071,679
2019,2,2,0,1520,1410,2090,680
2019,2,2,1,1570,1461,2138,677
2019,2,2,2,1585,1482,2127,645
2019,2,2,3,1560,1467,2134,667
2019,2,2,4,1535,1437,2089,652
2019,2,2,5,1490,1395,2105,710
2019,2,2,6,1460,1348,2096,748
2019,2,2,7,1390,1291,2112,821
2019,2,2,8,1280,1257,2126,869
2019,2,2,9,1260,1227,1937,710
2019,2,2,10,1235,1210,1899,689
2019,2,2,11,1250,1210,1872,662
2019,2,2,12,1235,1210,1823,613
2019,2,2,13,1265,1241,1920,679
2019,2,2,14,1350,1281,2022,741
2019,2,2,15,1460,1343,2038,695
2019,2,2,16,1490,1394,2039,645
2019,2,2,17,1510,1418,2080,662
2019,2,2,18,1520,1411,2132,721
2019,2,2,19,1505,1409,2135,726
2019,2,2,20,1485,1408,2168,760
2019,2,2,21,1460,1400,2234,834
2019,2,2,22,1445,1389,2222,833
2019,2,2,23,1445,1381,2193,812
2019,2,3,0,1460,1393,2190,797
2019,2,3,1,1520,1451,2207,756
2019,2,3,2,1540,1488,2143,655
2019,2,3,3,1515,1457,2148,691
2019,2,3,4,1495,1441,2117,676
2019,2,3,5,1460,1405,2070,665
2019,2,3,6,1405,1356,2111,755
2019,2,3,7,1335,1337,2186,849
2019,2,3,8,1285,1333,2216,883
2019,2,3,9,1250,1300,2167,867
2019,2,3,10,1240,1295,2125,830
2019,2,3,11,1240,1289,2114,825
2019,2,3,12,1245,1308,2118,810
2019,2,3,13,1265,1336,2121,785
2019,2,3,14,1380,1400,2108,708
2019,2,3,15,1490,1467,2120,653
2019,2,3,16,1520,1547,2127,580
2019,2,3,17,1535,1606,2110,504
2019,2,3,18,1550,1647,2100,453
2019,2,3,19,1535,1644,2106,462
2019,2,3,20,1535,1671,2131,460
2019,2,3,21,1535,1674,2099,425
2019,2,3,22,1540,1679,2112,433
2019,2,3,23,1545,1676,2093,417
2019,2,4,0,1550,1692,2077,385
2019,2,4,1,1620,1703,2084,381
2019,2,4,2,1650,1729,2074,345
2019,2,4,3,1625,1706,2083,377
2019,2,4,4,1600,1716,2058,342
2019,2,4,5,1490,1686,2057,371
2019,2,4,6,1485,1601,2013,412
2019,2,4,7,1425,1534,2040,506
2019,2,4,8,1440,1500,2027,527
2019,2,4,9,1420,1466,1996,530
2019,2,4,10,1415,1471,1994,523
2019,2,4,11,1425,1477,1983,506
2019,2,4,12,1455,1511,1974,463
2019,2,4,13,1525,1554,1895,341
2019,2,4,14,1625,1673,1880,207
2019,2,4,15,1705,1788,1880,92
2019,2,4,16,1700,1800,1869,69
2019,2,4,17,1670,1819,1865,46
2019,2,4,18,1660,1815,1864,49
2019,2,4,19,1640,1798,1852,54
2019,2,4,20,1620,1778,1845,67
2019,2,4,21,1595,1762,1831,69
2019,2,4,22,1590,1759,1831,72
2019,2,4,23,1585,1749,1915,166
2019,2,5,0,1605,1776,2004,228
2019,2,5,1,1675,1821,2110,289
2019,2,5,2,1730,1878,2127,249
2019,2,5,3,1705,1868,2152,284
2019,2,5,4,1670,1836,2229,393
2019,2,5,5,1575,1776,2274,498
2019,2,5,6,1545,1713,2371,658
2019,2,5,7,1480,1621,2463,842
2019,2,5,8,1470,1618,2584,966
2019,2,5,9,1455,1585,2574,989
2019,2,5,10,1450,1603,2590,987
2019,2,5,11,1450,1599,2572,973
2019,2,5,12,1475,1617,2558,941
2019,2,5,13,1540,1659,2560,901
2019,2,5,14,1655,1771,2520,749
2019,2,5,15,1755,1844,2444,600
2019,2,5,16,1755,1838,2449,611
2019,2,5,17,1740,1839,2456,617
2019,2,5,18,1710,1846,2556,710
2019,2,5,19,1680,1819,2564,745
2019,2,5,20,1650,1802,2564,762
2019,2,5,21,1630,1781,2522,741
2019,2,5,22,1620,1784,2522,738
2019,2,5,23,1620,1798,2513,715
2019,2,6,0,1650,1823,2491,668
2019,2,6,1,1715,1897,2571,674
2019,2,6,2,1770,1961,2608,647
2019,2,6,3,1755,1935,2584,649
2019,2,6,4,1725,1889,2556,667
2019,2,6,5,1630,1840,2566,726
2019,2,6,6,1585,1742,2555,813
2019,2,6,7,1520,1675,2585,910
2019,2,6,8,1570,1640,2632,992
2019,2,6,9,1540,1613,2622,1009
2019,2,6,10,1545,1612,2648,1036
2019,2,6,11,1550,1597,2634,1037
2019,2,6,12,1580,1618,2704,1086
2019,2,6,13,1620,1682,2725,1043
2019,2,6,14,1710,1785,2737,952
2019,2,6,15,1795,1890,2730,840
2019,2,6,16,1790,1877,2719,842
2019,2,6,17,1790,1882,2709,827
2019,2,6,18,1785,1879,2703,824
2019,2,6,19,1775,1826,2689,863
2019,2,6,20,1755,1792,2711,919
2019,2,6,21,1745,1774,2715,941
2019,2,6,22,1735,1758,2759,1001
2019,2,6,23,1725,1758,2771,1013
2019,2,7,0,1755,1790,2736,946
2019,2,7,1,1800,1840,2699,859
2019,2,7,2,1850,1913,2642,729
2019,2,7,3,1835,1892,2518,626
2019,2,7,4,1795,1816,1991,175
2019,2,7,5,1770,1753,1730,-23
2019,2,7,6,1650,1667,1724,57
2019,2,7,7,1560,1590,1689,99
2019,2,7,8,1600,1561,1694,133
2019,2,7,9,1570,1552,1620,68
2019,2,7,10,1580,1543,1589,46
2019,2,7,11,1580,1558,1460,-98
2019,2,7,12,1600,1590,1795,205
2019,2,7,13,1655,1667,2211,544
2019,2,7,14,1790,1815,2489,674
2019,2,7,15,1860,1903,2542,639
2019,2,7,16,1850,1893,2533,640
2019,2,7,17,1850,1850,2442,592
2019,2,7,18,1840,1822,2519,697
2019,2,7,19,1835,1793,2550,757
2019,2,7,20,1810,1761,2619,858
2019,2,7,21,1790,1748,2709,961
2019,2,7,22,1780,1728,2753,1025
2019,2,7,23,1780,1729,2756,1027
2019,2,8,0,1800,1748,2752,1004
2019,2,8,1,1855,1795,2745,950
2019,2,8,2,1900,1855,2759,904
2019,2,8,3,1885,1857,2757,900
2019,2,8,4,1850,1828,2778,950
2019,2,8,5,1750,1752,2704,952
2019,2,8,6,1700,1695,2822,1127
2019,2,8,7,1625,1636,2879,1243
2019,2,8,8,1550,1614,2933,1319
2019,2,8,9,1520,1600,2879,1279
2019,2,8,10,1530,1577,2658,1081
2019,2,8,11,1525,1590,2571,981
2019,2,8,12,1550,1597,2606,1009
2019,2,8,13,1595,1650,2793,1143
2019,2,8,14,1685,1752,2799,1047
2019,2,8,15,1760,1847,2792,945
2019,2,8,16,1755,1825,2751,926
2019,2,8,17,1765,1808,2701,893
2019,2,8,18,1770,1790,2710,920
2019,2,8,19,1740,1785,2708,923
2019,2,8,20,1720,1748,2752,1004
2019,2,8,21,1700,1741,2819,1078
2019,2,8,22,1695,1725,2836,1111
2019,2,8,23,1700,1715,2845,1130
2019,2,9,0,1725,1744,2871,1127
2019,2,9,1,1775,1783,2900,1117
2019,2,9,2,1830,1830,2885,1055
2019,2,9,3,1815,1814,2915,1101
2019,2,9,4,1770,1782,2890,1108
2019,2,9,5,1715,1728,2911,1183
2019,2,9,6,1630,1684,2939,1255
2019,2,9,7,1550,1654,2960,1306
2019,2,9,8,1590,1620,2946,1326
2019,2,9,9,1560,1616,2839,1223
2019,2,9,10,1540,1601,2827,1226
2019,2,9,11,1545,1604,2834,1230
2019,2,9,12,1545,1617,2905,1288
2019,2,9,13,1585,1644,2902,1258
2019,2,9,14,1615,1687,2910,1223
2019,2,9,15,1670,1748,2912,1164
2019,2,9,16,1720,1792,2908,1116
2019,2,9,17,1745,1832,2911,1079
2019,2,9,18,1740,1838,2909,1071
2019,2,9,19,1730,1839,2962,1123
2019,2,9,20,1725,1811,2946,1135
2019,2,9,21,1710,1782,2942,1160
2019,2,9,22,1690,1776,2926,1150
2019,2,9,23,1685,1773,2900,1127
2019,2,10,0,1705,1797,2912,1115
2019,2,10,1,1770,1845,2868,1023
2019,2,10,2,1815,1902,2912,1010
2019,2,10,3,1785,1891,2893,1002
2019,2,10,4,1760,1858,2863,1005
2019,2,10,5,1670,1811,2860,1049
2019,2,10,6,1650,1757,2859,1102
2019,2,10,7,1605,1696,2906,1210
2019,2,10,8,1580,1666,2894,1228
2019,2,10,9,1550,1628,2785,1157
2019,2,10,10,1545,1632,2801,1169
2019,2,10,11,1545,1645,2748,1103
2019,2,10,12,1560,1656,2746,1090
2019,2,10,13,1595,1663,2739,1076
2019,2,10,14,1590,1712,2754,1042
2019,2,10,15,1590,1770,2770,1000
2019,2,10,16,1660,1811,2833,1022
2019,2,10,17,1705,1857,2832,975
2019,2,10,18,1740,1845,2800,955
2019,2,10,19,1735,1831,2789,958
2019,2,10,20,1760,1815,2787,972
2019,2,10,21,1760,1797,2848,1051
2019,2,10,22,1760,1777,2820,1043
2019,2,10,23,1765,1768,2796,1028
2019,2,11,0,1775,1790,2799,1009
2019,2,11,1,1800,1844,2865,1021
2019,2,11,2,1835,1896,2895,999
2019,2,11,3,1810,1889,2868,979
2019,2,11,4,1805,1868,2904,1036
2019,2,11,5,1720,1794,2901,1107
2019,2,11,6,1685,1705,2903,1198
2019,2,11,7,1620,1650,2931,1281
2019,2,11,8,1570,1617,2880,1263
2019,2,11,9,1540,1587,2866,1279
2019,2,11,10,1540,1584,2827,1243
2019,2,11,11,1550,1577,2829,1252
2019,2,11,12,1580,1606,2845,1239
2019,2,11,13,1630,1657,2887,1230
2019,2,11,14,1730,1794,2940,1146
2019,2,11,15,1805,1867,2936,1069
2019,2,11,16,1815,1860,2899,1039
2019,2,11,17,1820,1841,2837,996
2019,2,11,18,1815,1821,2810,989
2019,2,11,19,1800,1792,2847,1055
2019,2,11,20,1775,1766,2897,1131
2019,2,11,21,1760,1748,2953,1205
2019,2,11,22,1755,1728,2879,1151
2019,2,11,23,1745,1729,2862,1133
2019,2,12,0,1775,1745,2840,1095
2019,2,12,1,1825,1777,2830,1053
2019,2,12,2,1880,1835,2808,973
2019,2,12,3,1870,1815,2833,1018
2019,2,12,4,1830,1794,2839,1045
2019,2,12,5,1805,1714,2821,1107
2019,2,12,6,1690,1627,2807,1180
2019,2,12,7,1605,1556,2679,1123
2019,2,12,8,1425,1512,2619,1107
2019,2,12,9,1405,1500,2612,1112
2019,2,12,10,1405,1509,2600,1091
2019,2,12,11,1405,1513,2689,1176
2019,2,12,12,1425,1541,2750,1209
2019,2,12,13,1480,1589,2757,1168
2019,2,12,14,1620,1691,2799,1108
2019,2,12,15,1735,1776,2877,1101
2019,2,12,16,1730,1753,2876,1123
2019,2,12,17,1720,1747,2857,1110
2019,2,12,18,1690,1720,2822,1102
2019,2,12,19,1660,1707,2836,1129
2019,2,12,20,1630,1682,2853,1171
2019,2,12,21,1610,1642,2818,1176
2019,2,12,22,1595,1631,2808,1177
2019,2,12,23,1605,1628,2806,1178
2019,2,13,0,1630,1653,2846,1193
2019,2,13,1,1695,1704,2860,1156
2019,2,13,2,1750,1756,2873,1117
2019,2,13,3,1735,1748,2868,1120
2019,2,13,4,1670,1715,2916,1201
2019,2,13,5,1590,1646,2956,1310
2019,2,13,6,1520,1575,2943,1368
2019,2,13,7,1450,1501,2927,1426
2019,2,13,8,1455,1469,2919,1450
2019,2,13,9,1435,1436,2681,1245
2019,2,13,10,1435,1423,2522,1099
2019,2,13,11,1430,1428,2537,1109
2019,2,13,12,1450,1438,2522,1084
2019,2,13,13,1510,1508,2670,1162
2019,2,13,14,1615,1624,2789,1165
2019,2,13,15,1710,1714,2875,1161
2019,2,13,16,1700,1698,2856,1158
2019,2,13,17,1695,1699,2893,1194
2019,2,13,18,1690,1670,2889,1219
2019,2,13,19,1655,1668,2892,1224
2019,2,13,20,1625,1637,2899,1262
2019,2,13,21,1610,1622,2884,1262
2019,2,13,22,1595,1613,2891,1278
2019,2,13,23,1595,1623,2903,1280
2019,2,14,0,1620,1643,3004,1361
2019,2,14,1,1660,1701,2992,1291
2019,2,14,2,1720,1754,2969,1215
2019,2,14,3,1705,1749,3007,1258
2019,2,14,4,1655,1713,2976,1263
2019,2,14,5,1550,1665,2941,1276
2019,2,14,6,1515,1589,2850,1261
2019,2,14,7,1440,1529,2752,1223
2019,2,14,8,1415,1489,2682,1193
2019,2,14,9,1405,1469,2612,1143
2019,2,14,10,1400,1468,2606,1138
2019,2,14,11,1410,1464,2602,1138
2019,2,14,12,1430,1478,2615,1137
2019,2,14,13,1490,1542,2734,1192
2019,2,14,14,1610,1659,2806,1147
2019,2,14,15,1700,1734,2797,1063
2019,2,14,16,1680,1709,2796,1087
2019,2,14,17,1660,1700,2811,1111
2019,2,14,18,1635,1685,2809,1124
2019,2,14,19,1615,1670,2819,1149
2019,2,14,20,1585,1645,2826,1181
2019,2,14,21,1560,1634,2851,1217
2019,2,14,22,1545,1624,2846,1222
2019,2,14,23,1540,1659,2862,1203
2019,2,15,0,1565,1697,2871,1174
2019,2,15,1,1610,1740,2904,1164
2019,2,15,2,1655,1777,2907,1130
2019,2,15,3,1655,1761,2899,1138
2019,2,15,4,1625,1728,2864,1136
2019,2,15,5,1520,1689,2879,1190
2019,2,15,6,1495,1604,2855,1251
2019,2,15,7,1430,1544,2835,1291
2019,2,15,8,1430,1522,2803,1281
2019,2,15,9,1415,1484,2648,1164
2019,2,15,10,1400,1480,2614,1134
2019,2,15,11,1410,1488,2599,1111
2019,2,15,12,1420,1505,2597,1092
2019,2,15,13,1470,1540,2703,1163
2019,2,15,14,1570,1634,2765,1131
2019,2,15,15,1670,1729,2758,1029
2019,2,15,16,1655,1708,2744,1036
2019,2,15,17,1645,1546,2647,1101
2019,2,15,18,1620,1825,2534,709
2019,2,15,19,1610,1636,2542,906
2019,2,15,20,1580,1612,2547,935
2019,2,15,21,1570,1593,2577,984
2019,2,15,22,1555,1569,2556,987
2019,2,15,23,1550,1564,2539,975
2019,2,16,0,1570,1591,2529,938
2019,2,16,1,1615,1630,2548,918
2019,2,16,2,1650,1685,2555,870
2019,2,16,3,1635,1676,2567,891
2019,2,16,4,1605,1651,2552,901
2019,2,16,5,1540,1610,2509,899
2019,2,16,6,1510,1553,2557,1004
2019,2,16,7,1470,1493,2586,1093
2019,2,16,8,1460,1451,2538,1087
2019,2,16,9,1450,1431,2520,1089
2019,2,16,10,1440,1415,2532,1117
2019,2,16,11,1440,1420,2518,1098
2019,2,16,12,1450,1422,2554,1132
2019,2,16,13,1490,1450,2563,1113
2019,2,16,14,1520,1503,2569,1066
2019,2,16,15,1555,1561,2579,1018
2019,2,16,16,1585,1610,2635,1025
2019,2,16,17,1615,1619,2631,1012
2019,2,16,18,1610,1624,2652,1028
2019,2,16,19,1605,1607,2663,1056
2019,2,16,20,1590,1573,2631,1058
2019,2,16,21,1565,1560,2583,1023
2019,2,16,22,1560,1547,2536,989
2019,2,16,23,1565,1559,2509,950
2019,2,17,0,1585,1574,2503,929
2019,2,17,1,1635,1627,2541,914
2019,2,17,2,1680,1686,2547,861
2019,2,17,3,1660,1676,2534,858
2019,2,17,4,1635,1651,2526,875
2019,2,17,5,1555,1630,2533,903
2019,2,17,6,1535,1575,2560,985
2019,2,17,7,1480,1524,2589,1065
2019,2,17,8,1495,1490,2591,1101
2019,2,17,9,1465,1475,2592,1117
2019,2,17,10,1470,1480,2592,1112
2019,2,17,11,1475,1486,2593,1107
2019,2,17,12,1485,1503,2613,1110
2019,2,17,13,1510,1519,2614,1095
2019,2,17,14,1570,1577,2620,1043
2019,2,17,15,1630,1645,2634,989
2019,2,17,16,1660,1696,2634,938
2019,2,17,17,1690,1721,2614,893
2019,2,17,18,1690,1719,2610,891
2019,2,17,19,1680,1699,2607,908
2019,2,17,20,1670,1685,2620,935
2019,2,17,21,1655,1668,2604,936
2019,2,17,22,1640,1651,2608,957
2019,2,17,23,1645,1665,2581,916
2019,2,18,0,1660,1682,2573,891
2019,2,18,1,1705,1738,2564,826
2019,2,18,2,1750,1797,2570,773
2019,2,18,3,1735,1791,2545,754
2019,2,18,4,1720,1755,2501,746
2019,2,18,5,1630,1705,2478,773
2019,2,18,6,1580,1633,2454,821
2019,2,18,7,1525,1564,2432,868
2019,2,18,8,1515,1534,2462,928
2019,2,18,9,1485,1530,2487,957
2019,2,18,10,1485,1536,2498,962
2019,2,18,11,1490,1536,2506,970
2019,2,18,12,1505,1557,2531,974
2019,2,18,13,1535,1594,2515,921
2019,2,18,14,1650,1698,2515,817
2019,2,18,15,1745,1762,2549,787
2019,2,18,16,1765,1785,2544,759
2019,2,18,17,1780,1801,2555,754
2019,2,18,18,1765,1787,2566,779
2019,2,18,19,1745,1773,2577,804
2019,2,18,20,1725,1749,2566,817
2019,2,18,21,1705,1728,2558,830
2019,2,18,22,1685,1710,2565,855
2019,2,18,23,1690,1717,2569,852
2019,2,19,0,1700,1725,2571,846
2019,2,19,1,1745,1785,2576,791
2019,2,19,2,1800,1853,2580,727
2019,2,19,3,1785,1860,2594,734
2019,2,19,4,1765,1814,2583,769
2019,2,19,5,1650,1758,2586,828
2019,2,19,6,1610,1682,2597,915
2019,2,19,7,1550,1620,2610,990
2019,2,19,8,1545,1598,2595,997
2019,2,19,9,1525,1590,2608,1018
2019,2,19,10,1535,1597,2604,1007
2019,2,19,11,1535,1595,2617,1022
2019,2,19,12,1550,1610,2622,1012
2019,2,19,13,1605,1679,2646,967
2019,2,19,14,1700,1795,2673,878
2019,2,19,15,1765,1890,2696,806
2019,2,19,16,1745,1867,2644,777
2019,2,19,17,1745,1815,2623,808
2019,2,19,18,1730,1718,2673,955
2019,2,19,19,1710,1697,2726,1029
2019,2,19,20,1685,1731,2791,1060
2019,2,19,21,1660,1710,2874,1164
2019,2,19,22,1655,1696,2892,1196
2019,2,19,23,1665,1693,2952,1259
2019,2,20,0,1690,1717,2948,1231
2019,2,20,1,1745,1752,2988,1236
2019,2,20,2,1790,1819,3018,1199
2019,2,20,3,1780,1802,3028,1226
2019,2,20,4,1740,1784,3041,1257
2019,2,20,5,1675,1707,2971,1264
2019,2,20,6,1600,1618,2910,1292
2019,2,20,7,1525,1574,2943,1369
2019,2,20,8,1505,1542,2923,1381
2019,2,20,9,1485,1534,2938,1404
2019,2,20,10,1480,1529,2909,1380
2019,2,20,11,1480,1524,2892,1368
2019,2,20,12,1495,1547,2907,1360
2019,2,20,13,1550,1624,2904,1280
2019,2,20,14,1640,1726,2882,1156
2019,2,20,15,1715,1825,2884,1059
2019,2,20,16,1705,1798,2856,1058
2019,2,20,17,1710,1761,2847,1086
2019,2,20,18,1690,1733,2804,1071
2019,2,20,19,1680,1699,2867,1168
2019,2,20,20,1645,1638,2869,1231
2019,2,20,21,1630,1654,2888,1234
2019,2,20,22,1620,1632,2901,1269
2019,2,20,23,1630,1656,2988,1332
2019,2,21,0,1645,1668,2999,1331
2019,2,21,1,1700,1698,2971,1273
2019,2,21,2,1760,1779,2955,1176
2019,2,21,3,1755,1784,2956,1172
2019,2,21,4,1710,1770,2945,1175
2019,2,21,5,1610,1718,2950,1232
2019,2,21,6,1580,1631,2887,1256
2019,2,21,7,1515,1574,2897,1323
2019,2,21,8,1525,1549,2902,1353
2019,2,21,9,1510,1548,2781,1233
2019,2,21,10,1515,1552,2755,1203
2019,2,21,11,1515,1548,2778,1230
2019,2,21,12,1530,1577,2791,1214
2019,2,21,13,1600,1632,2938,1306
2019,2,21,14,1735,1763,3016,1253
2019,2,21,15,1825,1814,3083,1269
2019,2,21,16,1805,1813,3040,1227
2019,2,21,17,1780,1782,2982,1200
2019,2,21,18,1745,1758,2969,1211
2019,2,21,19,1730,1722,2757,1035
2019,2,21,20,1715,1695,2698,1003
2019,2,21,21,1695,1641,2653,1012
2019,2,21,22,1685,1623,2619,996
2019,2,21,23,1705,1618,2621,1003
2019,2,22,0,1735,1638,2789,1151
2019,2,22,1,1780,1685,2844,1159
2019,2,22,2,1830,1772,2889,1117
2019,2,22,3,1820,1811,2918,1107
2019,2,22,4,1790,1797,2903,1106
2019,2,22,5,1680,1734,2890,1156
2019,2,22,6,1645,1664,2838,1174
2019,2,22,7,1580,1621,2914,1293
2019,2,22,8,1550,1601,2770,1169
2019,2,22,9,1535,1591,2721,1130
2019,2,22,10,1520,1601,2666,1065
2019,2,22,11,1525,1610,2708,1098
2019,2,22,12,1540,1638,2730,1092
2019,2,22,13,1590,1703,2839,1136
2019,2,22,14,1720,1821,2913,1092
2019,2,22,15,1850,1908,2946,1038
2019,2,22,16,1835,1896,2900,1004
2019,2,22,17,1795,1841,2867,1026
2019,2,22,18,1790,1801,2898,1097
2019,2,22,19,1780,1777,2894,1117
2019,2,22,20,1740,1748,2878,1130
2019,2,22,21,1735,1695,2895,1200
2019,2,22,22,1715,1657,2891,1234
2019,2,22,23,1710,1672,2899,1227
2019,2,23,0,1735,1675,2893,1218
2019,2,23,1,1755,1701,2799,1098
2019,2,23,2,1800,1760,2817,1057
2019,2,23,3,1795,1751,2862,1111
2019,2,23,4,1760,1715,2836,1121
2019,2,23,5,1710,1673,2881,1208
2019,2,23,6,1675,1613,2941,1328
2019,2,23,7,1635,1569,2898,1329
2019,2,23,8,1445,1540,2959,1419
2019,2,23,9,1430,1507,2854,1347
2019,2,23,10,1415,1516,2940,1424
2019,2,23,11,1420,1497,2905,1408
2019,2,23,12,1425,1506,2849,1343
2019,2,23,13,1465,1531,2933,1402
2019,2,23,14,1520,1584,2946,1362
2019,2,23,15,1585,1650,3028,1378
2019,2,23,16,1630,1701,2969,1268
2019,2,23,17,1640,1732,3026,1294
2019,2,23,18,1640,1683,2996,1313
2019,2,23,19,1620,1622,2984,1362
2019,2,23,20,1590,1599,2971,1372
2019,2,23,21,1570,1561,2958,1397
2019,2,23,22,1560,1553,2928,1375
2019,2,23,23,1565,1543,2951,1408
2019,2,24,0,1580,1598,2953,1355
2019,2,24,1,1630,1612,2991,1379
2019,2,24,2,1695,1677,2981,1304
2019,2,24,3,1690,1684,2989,1305
2019,2,24,4,1665,1660,2977,1317
2019,2,24,5,1585,1624,2957,1333
2019,2,24,6,1580,1568,2938,1370
2019,2,24,7,1525,1524,2885,1361
2019,2,24,8,1465,1511,2887,1376
2019,2,24,9,1450,1474,2794,1320
2019,2,24,10,1450,1480,2797,1317
2019,2,24,11,1455,1473,2768,1295
2019,2,24,12,1475,1504,2782,1278
2019,2,24,13,1495,1530,2890,1360
2019,2,24,14,1565,1568,2849,1281
2019,2,24,15,1640,1587,2807,1220
2019,2,24,16,1680,1641,2818,1177
2019,2,24,17,1700,1675,2860,1185
2019,2,24,18,1700,1671,2853,1182
2019,2,24,19,1680,1692,2862,1170
2019,2,24,20,1665,1698,2854,1156
2019,2,24,21,1640,1689,2844,1155
2019,2,24,22,1620,1682,2835,1153
2019,2,24,23,1635,1687,2827,1140
2019,2,25,0,1650,1712,2848,1136
2019,2,25,1,1705,1768,2892,1124
2019,2,25,2,1765,1812,2868,1056
2019,2,25,3,1765,1814,2842,1028
2019,2,25,4,1735,1770,2814,1044
2019,2,25,5,1640,1718,2820,1102
2019,2,25,6,1605,1629,2809,1180
2019,2,25,7,1545,1570,2805,1235
2019,2,25,8,1485,1534,2795,1261
2019,2,25,9,1480,1529,2795,1266
2019,2,25,10,1485,1532,2798,1266
2019,2,25,11,1480,1531,2829,1298
2019,2,25,12,1505,1542,2827,1285
2019,2,25,13,1550,1588,2821,1233
2019,2,25,14,1685,1686,2843,1157
2019,2,25,15,1790,1777,2822,1045
2019,2,25,16,1800,1812,2787,975
2019,2,25,17,1795,1813,2787,974
2019,2,25,18,1765,1800,2793,993
2019,2,25,19,1745,1801,2824,1023
2019,2,25,20,1735,1781,2804,1023
2019,2,25,21,1710,1772,2823,1051
2019,2,25,22,1695,1759,2821,1062
2019,2,25,23,1695,1759,2826,1067
2019,2,26,0,1715,1776,2819,1043
2019,2,26,1,1765,1820,2844,1024
2019,2,26,2,1830,1873,2843,970
2019,2,26,3,1825,1867,2847,980
2019,2,26,4,1790,1816,2850,1034
2019,2,26,5,1690,1745,2844,1099
2019,2,26,6,1645,1659,2833,1174
2019,2,26,7,1580,1583,2818,1235
2019,2,26,8,1515,1566,2780,1214
2019,2,26,9,1500,1568,2776,1208
2019,2,26,10,1505,1563,2770,1207
2019,2,26,11,1500,1567,2803,1236
2019,2,26,12,1525,1590,2801,1211
2019,2,26,13,1575,1639,2843,1204
2019,2,26,14,1685,1723,2880,1157
2019,2,26,15,1770,1780,2915,1135
2019,2,26,16,1770,1802,2917,1115
2019,2,26,17,1745,1814,2873,1059
2019,2,26,18,1685,1802,2866,1064
2019,2,26,19,1670,1789,2878,1089
2019,2,26,20,1685,1766,2884,1118
2019,2,26,21,1665,1741,2907,1166
2019,2,26,22,1655,1730,2922,1192
2019,2,26,23,1650,1728,2924,1196
2019,2,27,0,1680,1744,2885,1141
2019,2,27,1,1725,1780,2864,1084
2019,2,27,2,1780,1835,2907,1072
2019,2,27,3,1765,1831,2894,1063
2019,2,27,4,1740,1797,2844,1047
2019,2,27,5,1620,1721,2806,1085
2019,2,27,6,1580,1649,2799,1150
2019,2,27,7,1525,1625,2844,1219
2019,2,27,8,1530,1595,2841,1246
2019,2,27,9,1515,1559,2616,1057
2019,2,27,10,1515,1545,2588,1043
2019,2,27,11,1520,1535,2584,1049
2019,2,27,12,1535,1557,2658,1101
2019,2,27,13,1595,1594,2791,1197
2019,2,27,14,1675,1698,2828,1130
2019,2,27,15,1750,1766,2817,1051
2019,2,27,16,1760,1763,2816,1053
2019,2,27,17,1755,1751,2806,1055
2019,2,27,18,1740,1750,2803,1053
2019,2,27,19,1730,1719,2809,1090
2019,2,27,20,1700,1712,2795,1083
2019,2,27,21,1695,1696,2775,1079
2019,2,27,22,1680,1695,2752,1057
2019,2,27,23,1690,1709,2750,1041
2019,2,28,0,1710,1713,2755,1042
2019,2,28,1,1750,1727,2774,1047
2019,2,28,2,1810,1806,2798,992
2019,2,28,3,1805,1802,2817,1015
2019,2,28,4,1765,1744,2827,1083
2019,2,28,5,1640,1665,2820,1155
2019,2,28,6,1610,1590,2795,1205
2019,2,28,7,1545,1521,2802,1281
2019,2,28,8,1465,1482,2771,1289
2019,2,28,9,1460,1490,2807,1317
2019,2,28,10,1460,1507,2800,1293
2019,2,28,11,1460,1492,2768,1276
2019,2,28,12,1485,1515,2783,1268
2019,2,28,13,1535,1562,2821,1259
2019,2,28,14,1640,1673,2825,1152
2019,2,28,15,1710,1731,2821,1090
2019,2,28,16,1720,1726,2814,1088
2019,2,28,17,1725,1729,2809,1080
2019,2,28,18,1705,1723,2824,1101
2019,2,28,19,1690,1703,2810,1107
2019,2,28,20,1670,1668,2627,959
2019,2,28,21,1640,1646,2571,925
2019,2,28,22,1630,1647,2583,936
2019,2,28,23,1630,1636,2617,981
2019,3,1,0,1650,1667,2700,1033
2019,3,1,1,1690,1701,2671,970
2019,3,1,2,1750,1766,2696,930
2019,3,1,3,1750,1763,2743,980
2019,3,1,4,1725,1736,2740,1004
2019,3,1,5,1615,1664,2755,1091
2019,3,1,6,1575,1603,2783,1180
2019,3,1,7,-9999,1538,2834,1296
2019,3,1,8,1490,1515,2886,1371
2019,3,1,9,1475,1519,2756,1237
2019,3,1,10,1480,1526,2717,1191
2019,3,1,11,1480,1534,2686,1152
2019,3,1,12,1505,1554,2710,1156
2019,3,1,13,1555,1607,2870,1263
2019,3,1,14,1660,1722,2902,1180
2019,3,1,15,1740,1791,2901,1110
2019,3,1,16,1730,1792,2856,1064
2019,3,1,17,1680,1786,2850,1064
2019,3,1,18,1695,1759,2843,1084
2019,3,1,19,1645,1743,2855,1112
2019,3,1,20,1625,1707,2845,1138
2019,3,1,21,1585,1681,2949,1268
2019,3,1,22,1555,1657,2930,1273
2019,3,1,23,1565,1653,2941,1288
2019,3,2,0,1570,1671,2955,1284
2019,3,2,1,1600,1704,2954,1250
2019,3,2,2,1660,1764,2973,1209
2019,3,2,3,1655,1797,2953,1156
2019,3,2,4,1615,1763,2917,1154
2019,3,2,5,1560,1720,2893,1173
2019,3,2,6,1510,1680,2893,1213
2019,3,2,7,1455,1642,2865,1223
2019,3,2,8,1470,1591,2748,1157
2019,3,2,9,1475,1585,2674,1089
2019,3,2,10,1480,1588,2691,1103
2019,3,2,11,1485,1595,2659,1064
2019,3,2,12,1500,1592,2792,1200
2019,3,2,13,1535,1618,2836,1218
2019,3,2,14,1535,1669,2817,1148
2019,3,2,15,1550,1695,2796,1101
2019,3,2,16,1595,1737,2819,1082
2019,3,2,17,1625,1756,2827,1071
2019,3,2,18,1620,1765,2808,1043
2019,3,2,19,1615,1742,2814,1072
2019,3,2,20,1615,1705,2820,1115
2019,3,2,21,1620,1684,2823,1139
2019,3,2,22,1620,1666,2834,1168
2019,3,2,23,1640,1651,2847,1196
2019,3,3,0,1680,1681,2877,1196
2019,3,3,1,1710,1725,2893,1168
2019,3,3,2,1740,1792,2882,1090
2019,3,3,3,1735,1812,2855,1043
2019,3,3,4,1710,1781,2833,1052
2019,3,3,5,1670,1752,2815,1063
2019,3,3,6,1570,1697,2809,1112
2019,3,3,7,1520,1657,2838,1181
2019,3,3,8,1550,1632,2857,1225
2019,3,3,9,1520,1609,2788,1179
2019,3,3,10,1525,1611,2734,1123
2019,3,3,11,1520,1628,2852,1224
2019,3,3,12,1545,1631,2850,1219
2019,3,3,13,1570,1649,2804,1155
2019,3,3,14,1595,1689,2776,1087
2019,3,3,15,1605,1728,2801,1073
2019,3,3,16,1650,1773,2815,1042
2019,3,3,17,1675,1798,2910,1112
2019,3,3,18,1675,1772,2776,1004
2019,3,3,19,1680,1758,2771,1013
2019,3,3,20,1670,1737,2780,1043
2019,3,3,21,1665,1709,2768,1059
2019,3,3,22,1660,1689,2767,1078
2019,3,3,23,1670,1683,2769,1086
2019,3,4,0,1690,1697,2752,1055
2019,3,4,1,1740,1747,2745,998
2019,3,4,2,1790,1827,2795,968
2019,3,4,3,1790,1860,2801,941
2019,3,4,4,1745,1829,2801,972
2019,3,4,5,1605,1782,2788,1006
2019,3,4,6,1600,1715,2770,1055
2019,3,4,7,1540,1661,2769,1108
2019,3,4,8,1525,1643,2794,1151
2019,3,4,9,1510,1641,2787,1146
2019,3,4,10,1510,1630,2798,1168
2019,3,4,11,1515,1658,2810,1152
2019,3,4,12,1535,1662,2808,1146
2019,3,4,13,1580,1730,2817,1087
2019,3,4,14,1665,1816,2838,1022
2019,3,4,15,1735,1894,2883,989
2019,3,4,16,1765,1889,2842,953
2019,3,4,17,1765,1878,2816,938
2019,3,4,18,1755,1855,2867,1012
2019,3,4,19,1750,1825,2904,1079
2019,3,4,20,1735,1781,2821,1040
2019,3,4,21,1725,1738,2782,1044
2019,3,4,22,1710,1727,2776,1049
2019,3,4,23,1715,1712,2792,1080
2019,3,5,0,1730,1717,2783,1066
2019,3,5,1,1770,1732,2792,1060
2019,3,5,2,1830,1818,2816,998
2019,3,5,3,1825,1848,2842,994
2019,3,5,4,1780,1826,2889,1063
2019,3,5,5,1735,1774,2878,1104
2019,3,5,6,1620,1691,2907,1216
2019,3,5,7,1545,1644,2894,1250
2019,3,5,8,1530,1626,2837,1211
2019,3,5,9,1520,1599,2770,1171
2019,3,5,10,1525,1614,2730,1116
2019,3,5,11,1520,1634,2747,1113
2019,3,5,12,1540,1651,2681,1030
2019,3,5,13,1595,1710,2830,1120
2019,3,5,14,1715,1818,2854,1036
2019,3,5,15,1810,1859,2848,989
2019,3,5,16,1810,1854,2819,965
2019,3,5,17,1790,1821,2773,952
2019,3,5,18,1720,1772,2754,982
2019,3,5,19,1700,1748,2732,984
2019,3,5,20,1715,1710,2726,1016
2019,3,5,21,1690,1646,2649,1003
2019,3,5,22,1675,1662,2637,975
2019,3,5,23,1670,1629,2670,1041
2019,3,6,0,1695,1653,2700,1047
2019,3,6,1,1730,1690,2720,1030
2019,3,6,2,1795,1771,2785,1014
2019,3,6,3,1785,1805,2774,969
2019,3,6,4,1765,1781,2763,982
2019,3,6,5,1810,1722,2756,1034
2019,3,6,6,1605,1634,2748,1114
2019,3,6,7,1555,1584,2767,1183
2019,3,6,8,1495,1553,2774,1221
2019,3,6,9,1485,1519,2781,1262
2019,3,6,10,1480,1525,2789,1264
2019,3,6,11,1480,1540,2763,1223
2019,3,6,12,1500,1558,2759,1201
2019,3,6,13,1565,1604,2745,1141
2019,3,6,14,1670,1693,2741,1048
2019,3,6,15,1770,1759,2735,976
2019,3,6,16,1755,1753,2726,973
2019,3,6,17,1730,1741,2736,995
2019,3,6,18,1710,1720,2731,1011
2019,3,6,19,1670,1690,2733,1043
2019,3,6,20,1625,1659,2699,1040
2019,3,6,21,1625,1638,2689,1051
2019,3,6,22,1610,1624,2703,1079
2019,3,6,23,1620,1645,2704,1059
2019,3,7,0,1635,1664,2765,1101
2019,3,7,1,1660,1678,2751,1073
2019,3,7,2,1740,1729,2718,989
2019,3,7,3,1745,1744,2678,934
2019,3,7,4,1720,1726,2665,939
2019,3,7,5,1630,1649,2642,993
2019,3,7,6,1580,1574,2645,1071
2019,3,7,7,1520,1525,2646,1121
2019,3,7,8,1460,1484,2654,1170
2019,3,7,9,1450,1471,2604,1133
2019,3,7,10,1455,1470,2595,1125
2019,3,7,11,1450,1456,2559,1103
2019,3,7,12,1475,1485,2574,1089
2019,3,7,13,1530,1538,2587,1049
2019,3,7,14,1650,1647,2585,938
2019,3,7,15,1705,1708,2596,888
2019,3,7,16,1705,1700,2593,893
2019,3,7,17,1690,1672,2615,943
2019,3,7,18,1670,1652,2635,983
2019,3,7,19,1640,1625,2611,986
2019,3,7,20,1615,1607,2573,966
2019,3,7,21,1575,1601,2588,987
2019,3,7,22,1565,1577,2622,1045
2019,3,7,23,1560,1587,2625,1038
2019,3,8,0,1575,1589,2638,1049
2019,3,8,1,1610,1590,2615,1025
2019,3,8,2,1690,1665,2631,966
2019,3,8,3,1715,1681,2616,935
2019,3,8,4,1690,1697,2653,956
2019,3,8,5,1580,1656,2748,1092
2019,3,8,6,1550,1542,2747,1205
2019,3,8,7,1495,1481,2706,1225
2019,3,8,8,1395,1447,2688,1241
2019,3,8,9,1390,1425,2524,1099
2019,3,8,10,1395,1416,2488,1072
2019,3,8,11,1395,1423,2502,1079
2019,3,8,12,1420,1437,2527,1090
2019,3,8,13,1465,1498,2712,1214
2019,3,8,14,1575,1596,2706,1110
2019,3,8,15,1655,1677,2666,989
2019,3,8,16,1650,1666,2657,991
2019,3,8,17,1630,1641,2644,1003
2019,3,8,18,1600,1629,2669,1040
2019,3,8,19,1580,1598,2666,1068
2019,3,8,20,1550,1562,2662,1100
2019,3,8,21,1520,1562,2663,1101
2019,3,8,22,1490,1539,2634,1095
2019,3,8,23,1500,1539,2626,1087
2019,3,9,0,1510,1547,2655,1108
2019,3,9,1,1535,1565,2682,1117
2019,3,9,2,1590,1605,2677,1072
2019,3,9,3,1595,1619,2692,1073
2019,3,9,4,1570,1598,2701,1103
2019,3,9,5,1520,1566,2656,1090
2019,3,9,6,1465,1506,2633,1127
2019,3,9,7,1425,1445,2662,1217
2019,3,9,8,1380,1426,2665,1239
2019,3,9,9,1370,1400,2661,1261
2019,3,9,10,1375,1391,2637,1246
2019,3,9,11,1370,1397,2640,1243
2019,3,9,12,1380,1409,2652,1243
2019,3,9,13,1415,1445,2689,1244
2019,3,9,14,1500,1500,2720,1220
2019,3,9,15,1570,1535,2720,1185
2019,3,9,16,1600,1581,2746,1165
2019,3,9,17,1610,1570,2727,1157
2019,3,9,18,1600,1562,2677,1115
2019,3,9,19,1570,1528,2662,1134
2019,3,9,20,1540,1510,2684,1174
2019,3,9,21,1520,1477,2713,1236
2019,3,9,22,1510,1462,2713,1251
2019,3,9,23,1500,1449,2664,1215
2019,3,10,0,1525,1458,2698,1240
2019,3,10,1,1550,1483,2629,1146
2019,3,10,2,1615,1559,2656,1097
2019,3,10,3,1630,1576,2647,1071
2019,3,10,4,1615,1580,2668,1088
2019,3,10,5,1570,1545,2669,1124
2019,3,10,6,1520,1490,2678,1188
2019,3,10,7,1470,1449,2699,1250
2019,3,10,8,1405,1434,2725,1291
2019,3,10,9,1385,1321,2684,1363
2019,3,10,10,1390,1381,2756,1375
2019,3,10,11,1390,1448,2754,1306
2019,3,10,12,1405,1471,2785,1314
2019,3,10,13,1435,1510,2795,1285
2019,3,10,14,1500,1567,2789,1222
2019,3,10,15,1550,1601,2757,1156
2019,3,10,16,1580,1618,2751,1133
2019,3,10,17,1595,1592,2710,1118
2019,3,10,18,1570,1574,2702,1128
2019,3,10,19,1560,1555,2718,1163
2019,3,10,20,1545,1515,2718,1203
2019,3,10,21,1525,1480,2707,1227
2019,3,10,22,1510,1472,2716,1244
2019,3,10,23,1510,1459,2718,1259
2019,3,11,0,1525,1476,2721,1245
2019,3,11,1,1555,1499,2747,1248
2019,3,11,2,1625,1567,2794,1227
2019,3,11,3,1645,1623,2797,1174
2019,3,11,4,1630,1578,2812,1234
2019,3,11,5,1550,1520,2789,1269
2019,3,11,6,1510,1459,2811,1352
2019,3,11,7,1460,1428,2847,1419
2019,3,11,8,1390,1417,2741,1324
2019,3,11,9,1390,1420,2787,1367
2019,3,11,10,1400,1437,2791,1354
2019,3,11,11,1415,1465,2790,1325
2019,3,11,12,1475,1532,2877,1345
2019,3,11,13,1585,1656,2890,1234
2019,3,11,14,1680,1768,2883,1115
2019,3,11,15,1680,1751,2891,1140
2019,3,11,16,1665,1711,2882,1171
2019,3,11,17,1645,1680,2876,1196
2019,3,11,18,1620,1654,2894,1240
2019,3,11,19,1590,1600,2909,1309
2019,3,11,20,1565,1574,2856,1282
2019,3,11,21,1550,1539,2850,1311
2019,3,11,22,1545,1514,2873,1359
2019,3,11,23,1555,1502,2871,1369
2019,3,12,0,1565,1496,2853,1357
2019,3,12,1,1640,1531,2892,1361
2019,3,12,2,1660,1582,2903,1321
2019,3,12,3,1645,1626,2891,1265
2019,3,12,4,1575,1582,2892,1310
2019,3,12,5,1510,1499,2892,1393
2019,3,12,6,1455,1466,2898,1432
2019,3,12,7,1370,1403,2888,1485
2019,3,12,8,1350,1390,2743,1353
2019,3,12,9,1360,1393,2707,1314
2019,3,12,10,1370,1391,2721,1330
2019,3,12,11,1385,1416,2739,1323
2019,3,12,12,1440,1481,2907,1426
2019,3,12,13,1565,1606,2923,1317
2019,3,12,14,1640,1708,2910,1202
2019,3,12,15,1640,1657,2856,1199
2019,3,12,16,1620,1650,2804,1154
2019,3,12,17,1580,1624,2834,1210
2019,3,12,18,1560,1566,2831,1265
2019,3,12,19,1530,1531,2813,1282
2019,3,12,20,1485,1484,2727,1243
2019,3,12,21,1490,1489,2728,1239
2019,3,12,22,1470,1462,2612,1150
2019,3,12,23,1490,1464,2640,1176
2019,3,13,0,1525,1461,2532,1071
2019,3,13,1,1590,1490,2544,1054
2019,3,13,2,1615,1551,2603,1052
2019,3,13,3,1590,1572,2640,1068
2019,3,13,4,1480,1533,2642,1109
2019,3,13,5,1455,1446,2671,1225
2019,3,13,6,1405,1394,2649,1255
2019,3,13,7,1345,1364,2624,1260
2019,3,13,8,1320,1333,2472,1139
2019,3,13,9,1320,1334,2514,1180
2019,3,13,10,1330,1345,2528,1183
2019,3,13,11,1350,1369,2563,1194
2019,3,13,12,1405,1434,2715,1281
2019,3,13,13,1520,1558,2783,1225
2019,3,13,14,1615,1652,2779,1127
2019,3,13,15,1605,1660,2761,1101
2019,3,13,16,1585,1653,2721,1068
2019,3,13,17,1565,1633,2734,1101
2019,3,13,18,1535,1617,2764,1147
2019,3,13,19,1500,1586,2758,1172
2019,3,13,20,1485,1546,2772,1226
2019,3,13,21,1460,1527,2742,1215
2019,3,13,22,1460,1513,2765,1252
2019,3,13,23,1465,1523,2827,1304
2019,3,14,0,1470,1512,2783,1271
2019,3,14,1,1520,1532,2797,1265
2019,3,14,2,1550,1576,2774,1198
2019,3,14,3,1560,1602,2816,1214
2019,3,14,4,1540,1556,2753,1197
2019,3,14,5,1415,1472,2744,1272
2019,3,14,6,1365,1411,2715,1304
2019,3,14,7,1305,1368,2671,1303
2019,3,14,8,1295,1342,2665,1323
2019,3,14,9,1295,1340,2671,1331
2019,3,14,10,1290,1345,2668,1323
2019,3,14,11,1315,1359,2687,1328
2019,3,14,12,1370,1420,2707,1287
2019,3,14,13,1495,1544,2725,1181
2019,3,14,14,1590,1647,2716,1069
2019,3,14,15,1560,1637,2680,1043
2019,3,14,16,1550,1613,2657,1044
2019,3,14,17,1530,1588,2655,1067
2019,3,14,18,1480,1532,2655,1123
2019,3,14,19,1455,1511,2658,1147
2019,3,14,20,1420,1500,2635,1135
2019,3,14,21,1420,1470,2638,1168
2019,3,14,22,1405,1446,2674,1228
2019,3,14,23,1405,1447,2721,1274
2019,3,15,0,1410,1438,2690,1252
2019,3,15,1,1455,1461,2679,1218
2019,3,15,2,1495,1520,2648,1128
2019,3,15,3,1505,1563,2696,1133
2019,3,15,4,1450,1537,2758,1221
2019,3,15,5,1375,1468,2667,1199
2019,3,15,6,1320,1406,2669,1263
2019,3,15,7,1300,1389,2685,1296
2019,3,15,8,1285,1383,2718,1335
2019,3,15,9,1280,1381,2697,1316
2019,3,15,10,1290,1387,2709,1322
2019,3,15,11,1305,1404,2694,1290
2019,3,15,12,1355,1445,2687,1242
2019,3,15,13,1475,1555,2713,1158
2019,3,15,14,1570,1649,2669,1020
2019,3,15,15,1565,1639,2665,1026
2019,3,15,16,1550,1628,2698,1070
2019,3,15,17,1530,1577,2654,1077
2019,3,15,18,1510,1554,2654,1100
2019,3,15,19,1475,1500,2602,1102
2019,3,15,20,1460,1459,2533,1074
2019,3,15,21,1440,1430,2512,1082
2019,3,15,22,1440,1403,2462,1059
2019,3,15,23,1445,1390,2505,1115
2019,3,16,0,1465,1385,2507,1122
2019,3,16,1,1500,1387,2517,1130
2019,3,16,2,1520,1437,2510,1073
2019,3,16,3,1510,1467,2464,997
2019,3,16,4,1460,1450,2430,980
2019,3,16,5,1415,1395,2430,1035
2019,3,16,6,1355,1347,2424,1077
2019,3,16,7,1310,1319,2416,1097
2019,3,16,8,1285,1307,2406,1099
2019,3,16,9,1280,1294,2395,1101
2019,3,16,10,1285,1297,2430,1133
2019,3,16,11,1295,1311,2441,1130
2019,3,16,12,1335,1337,2443,1106
2019,3,16,13,1425,1387,2438,1051
2019,3,16,14,1500,1443,2438,995
2019,3,16,15,1535,1480,2383,903
2019,3,16,16,1530,1487,2385,898
2019,3,16,17,1520,1469,2379,910
2019,3,16,18,1485,1450,2392,942
2019,3,16,19,1465,1414,2442,1028
2019,3,16,20,1435,1392,2443,1051
2019,3,16,21,1420,1362,2425,1063
2019,3,16,22,1405,1342,2324,982
2019,3,16,23,1415,1330,2271,941
2019,3,17,0,1440,1357,2428,1071
2019,3,17,1,1505,1371,2420,1049
2019,3,17,2,1530,1415,2468,1053
2019,3,17,3,1535,1450,2521,1071
2019,3,17,4,1500,1436,2518,1082
2019,3,17,5,1450,1380,2548,1168
2019,3,17,6,1400,1337,2585,1248
2019,3,17,7,1300,1308,2589,1281
2019,3,17,8,1275,1298,2566,1268
2019,3,17,9,1270,1290,2550,1260
2019,3,17,10,1275,1291,2568,1277
2019,3,17,11,1290,1300,2574,1274
2019,3,17,12,1325,1319,2575,1256
2019,3,17,13,1415,1370,2587,1217
2019,3,17,14,1490,1418,2492,1074
2019,3,17,15,1525,1458,2532,1074
2019,3,17,16,1520,1493,2621,1128
2019,3,17,17,1505,1476,2629,1153
2019,3,17,18,1475,1449,2620,1171
2019,3,17,19,1455,1422,2581,1159
2019,3,17,20,1425,1388,2473,1085
2019,3,17,21,1410,1364,2464,1100
2019,3,17,22,1395,1356,2468,1112
2019,3,17,23,1405,1360,2479,1119
2019,3,18,0,1430,1388,2561,1173
2019,3,18,1,1495,1397,2568,1171
2019,3,18,2,1520,1442,2584,1142
2019,3,18,3,1525,1481,2615,1134
2019,3,18,4,1490,1443,2594,1151
2019,3,18,5,1435,1386,2570,1184
2019,3,18,6,1390,1320,2564,1244
2019,3,18,7,1295,1295,2561,1266
2019,3,18,8,1270,1279,2561,1282
2019,3,18,9,1270,1286,2589,1303
2019,3,18,10,1280,1296,2600,1304
2019,3,18,11,1300,1319,2606,1287
2019,3,18,12,1360,1376,2596,1220
2019,3,18,13,1480,1506,2668,1162
2019,3,18,14,1570,1597,2719,1122
2019,3,18,15,1570,1588,2741,1153
2019,3,18,16,1565,1565,2720,1155
2019,3,18,17,1545,1549,2698,1149
2019,3,18,18,1520,1506,2696,1190
2019,3,18,19,1490,1483,2676,1193
2019,3,18,20,1460,1448,2662,1214
2019,3,18,21,1440,1447,2695,1248
2019,3,18,22,1430,1431,2757,1326
2019,3,18,23,1435,1409,2738,1329
2019,3,19,0,1430,1404,2770,1366
2019,3,19,1,1460,1428,2713,1285
2019,3,19,2,1500,1444,2678,1234
2019,3,19,3,1525,1492,2681,1189
2019,3,19,4,1570,1455,2655,1200
2019,3,19,5,1400,1383,2623,1240
2019,3,19,6,1340,1318,2604,1286
2019,3,19,7,1275,1291,2571,1280
2019,3,19,8,1265,1283,2592,1309
2019,3,19,9,1265,1288,2615,1327
2019,3,19,10,1270,1294,2629,1335
2019,3,19,11,1285,1323,2625,1302
2019,3,19,12,1340,1381,2639,1258
2019,3,19,13,1460,1500,2728,1228
2019,3,19,14,1555,1582,2734,1152
2019,3,19,15,1530,1573,2714,1141
2019,3,19,16,1525,1541,2669,1128
2019,3,19,17,1500,1517,2654,1137
2019,3,19,18,1455,1477,2613,1136
2019,3,19,19,1420,1449,2592,1143
2019,3,19,20,1375,1419,2591,1172
2019,3,19,21,1380,1399,2590,1191
2019,3,19,22,1355,1377,2583,1206
2019,3,19,23,1360,1362,2579,1217
2019,3,20,0,1370,1363,2576,1213
2019,3,20,1,1400,1372,2568,1196
2019,3,20,2,1455,1404,2563,1159
2019,3,20,3,1470,1460,2578,1118
2019,3,20,4,1490,1435,2600,1165
2019,3,20,5,1355,1361,2607,1246
2019,3,20,6,1300,1304,2633,1329
2019,3,20,7,1255,1263,2611,1348
2019,3,20,8,1230,1256,2636,1380
2019,3,20,9,1230,1264,2651,1387
2019,3,20,10,1240,1248,2632,1384
2019,3,20,11,1260,1282,2631,1349
2019,3,20,12,1315,1338,2630,1292
2019,3,20,13,1435,1456,2663,1207
2019,3,20,14,1525,1541,2660,1119
2019,3,20,15,1525,1529,2652,1123
2019,3,20,16,1520,1511,2613,1102
2019,3,20,17,1495,1481,2600,1119
2019,3,20,18,1475,1464,2600,1136
2019,3,20,19,1445,1421,2575,1154
2019,3,20,20,1415,1399,2573,1174
2019,3,20,21,1405,1348,2569,1221
2019,3,20,22,1395,1379,2574,1195
2019,3,20,23,1395,1361,2577,1216
2019,3,21,0,1395,1361,2583,1222
2019,3,21,1,1420,1364,2578,1214
2019,3,21,2,1450,1404,2580,1176
2019,3,21,3,1475,1436,2567,1131
2019,3,21,4,1440,1404,2561,1157
2019,3,21,5,1350,1338,2578,1240
2019,3,21,6,1280,1278,2586,1308
2019,3,21,7,1215,1251,2592,1341
2019,3,21,8,1205,1238,2575,1337
2019,3,21,9,1210,1243,2567,1324
2019,3,21,10,1215,1257,2572,1315
2019,3,21,11,1235,1261,2573,1312
2019,3,21,12,1290,1331,2618,1287
2019,3,21,13,1415,1443,2669,1226
2019,3,21,14,1505,1535,2646,1111
2019,3,21,15,1495,1528,2654,1126
2019,3,21,16,1470,1498,2647,1149
2019,3,21,17,1445,1479,2616,1137
2019,3,21,18,1405,1458,2595,1137
2019,3,21,19,1380,1436,2596,1160
2019,3,21,20,1360,1408,2595,1187
2019,3,21,21,1335,1395,2603,1208
2019,3,21,22,1320,1387,2609,1222
2019,3,21,23,1310,1375,2622,1247
2019,3,22,0,1310,1366,2647,1281
2019,3,22,1,1330,1372,2653,1281
2019,3,22,2,1365,1413,2668,1255
2019,3,22,3,1410,1442,2712,1270
2019,3,22,4,1380,1409,2705,1296
2019,3,22,5,1310,1346,2681,1335
2019,3,22,6,1255,1281,2615,1334
2019,3,22,7,1210,1246,2595,1349
2019,3,22,8,1205,1235,2585,1350
2019,3,22,9,1205,1235,2582,1347
2019,3,22,10,1200,1254,2585,1331
2019,3,22,11,1230,1275,2584,1309
2019,3,22,12,1280,1318,2572,1254
2019,3,22,13,1400,1433,2569,1136
2019,3,22,14,1485,1511,2569,1058
2019,3,22,15,1470,1512,2592,1080
2019,3,22,16,1455,1496,2583,1087
2019,3,22,17,1420,1465,2456,991
2019,3,22,18,1405,1442,2475,1033
2019,3,22,19,1360,1396,2457,1061
2019,3,22,20,1335,1381,2455,1074
2019,3,22,21,1290,1351,2452,1101
2019,3,22,22,1310,1334,2459,1125
2019,3,22,23,1290,1327,2461,1134
2019,3,23,0,1290,1316,2406,1090
2019,3,23,1,1295,1320,2460,1140
2019,3,23,2,1335,1349,2464,1115
2019,3,23,3,1370,1384,2524,1140
2019,3,23,4,1340,1357,2577,1220
2019,3,23,5,1275,1318,2603,1285
2019,3,23,6,1215,1265,2568,1303
2019,3,23,7,1220,1239,2666,1427
2019,3,23,8,1205,1220,2653,1433
2019,3,23,9,1200,1208,2651,1443
2019,3,23,10,1200,1218,2643,1425
2019,3,23,11,1210,1242,2683,1441
2019,3,23,12,1235,1263,2714,1451
2019,3,23,13,1305,1320,2714,1394
2019,3,23,14,1370,1359,2493,1134
2019,3,23,15,1405,1391,2437,1046
2019,3,23,16,1415,1407,2447,1040
2019,3,23,17,1405,1403,2474,1071
2019,3,23,18,1380,1382,2478,1096
2019,3,23,19,1350,1362,2458,1096
2019,3,23,20,1320,1334,2410,1076
2019,3,23,21,1300,1312,2388,1076
2019,3,23,22,1290,1295,2345,1050
2019,3,23,23,1285,1283,2323,1040
2019,3,24,0,1310,1289,2275,986
2019,3,24,1,1330,1300,2274,974
2019,3,24,2,1370,1312,2264,952
2019,3,24,3,1400,1361,2270,909
2019,3,24,4,1385,1327,2247,920
2019,3,24,5,1320,1284,2240,956
2019,3,24,6,1270,1231,2229,998
2019,3,24,7,1240,1209,2234,1025
2019,3,24,8,1225,1208,2482,1274
2019,3,24,9,1220,1220,2550,1330
2019,3,24,10,1220,1227,2628,1401
2019,3,24,11,1230,1241,2641,1400
2019,3,24,12,1255,1252,2629,1377
2019,3,24,13,1320,1301,2638,1337
2019,3,24,14,1385,1341,2619,1278
2019,3,24,15,1425,1391,2634,1243
2019,3,24,16,1440,1403,2622,1219
2019,3,24,17,1425,1399,2599,1200
2019,3,24,18,1405,1391,2626,1235
2019,3,24,19,1375,1389,2653,1264
2019,3,24,20,1350,1358,2633,1275
2019,3,24,21,1325,1347,2612,1265
2019,3,24,22,1315,1327,2628,1301
2019,3,24,23,1315,1345,2678,1333
2019,3,25,0,1340,1362,2664,1302
2019,3,25,1,1365,1387,2647,1260
2019,3,25,2,1405,1349,1397,48
2019,3,25,3,1430,1351,1175,-176
2019,3,25,4,1395,1300,1107,-193
2019,3,25,5,1345,1214,1047,-167
2019,3,25,6,1290,1156,1032,-124
2019,3,25,7,1200,1124,1029,-95
2019,3,25,8,1185,1105,977,-128
2019,3,25,9,1185,1092,949,-143
2019,3,25,10,1195,1094,904,-190
2019,3,25,11,1220,1129,946,-183
2019,3,25,12,1280,1193,966,-227
2019,3,25,13,1410,1298,1029,-269
2019,3,25,14,1515,1397,1035,-362
2019,3,25,15,1500,1401,1039,-362
2019,3,25,16,1480,1406,998,-408
2019,3,25,17,1450,1387,1002,-385
2019,3,25,18,1425,1338,1046,-292
2019,3,25,19,1390,1321,1106,-215
2019,3,25,20,1365,1298,1365,67
2019,3,25,21,1340,1272,1489,217
2019,3,25,22,1340,1283,1685,402
2019,3,25,23,1320,1288,1882,594
2019,3,26,0,1320,1298,2074,776
2019,3,26,1,1335,1315,2215,900
2019,3,26,2,1365,1363,2499,1136
2019,3,26,3,1405,1406,2674,1268
2019,3,26,4,1390,1377,2695,1318
2019,3,26,5,1300,1300,2674,1374
2019,3,26,6,1225,1204,2471,1267
2019,3,26,7,1100,1166,2372,1206
2019,3,26,8,1090,1165,2458,1293
2019,3,26,9,1095,1168,2502,1334
2019,3,26,10,1100,1179,2500,1321
2019,3,26,11,1125,1198,2513,1315
2019,3,26,12,1165,1258,2563,1305
2019,3,26,13,1305,1364,2560,1196
2019,3,26,14,1410,1446,2638,1192
2019,3,26,15,1415,1454,2672,1218
2019,3,26,16,1400,1440,2638,1198
2019,3,26,17,1380,1439,2597,1158
2019,3,26,18,1345,1421,2562,1141
2019,3,26,19,1325,1391,2562,1171
2019,3,26,20,1295,1395,2598,1203
2019,3,26,21,1285,1384,2616,1232
2019,3,26,22,1260,1373,2712,1339
2019,3,26,23,1260,1380,2754,1374
2019,3,27,0,1265,1384,2790,1406
2019,3,27,1,1280,1397,2802,1405
2019,3,27,2,1305,1396,2741,1345
2019,3,27,3,1340,1424,2687,1263
2019,3,27,4,1290,1366,2651,1285
2019,3,27,5,1230,1273,2628,1355
2019,3,27,6,1175,1212,2592,1380
2019,3,27,7,1165,1176,2506,1330
2019,3,27,8,1145,1158,2411,1253
2019,3,27,9,1140,1161,2417,1256
2019,3,27,10,1140,1158,2513,1355
2019,3,27,11,1175,1183,2520,1337
2019,3,27,12,1235,1244,2595,1351
2019,3,27,13,1340,1359,2618,1259
2019,3,27,14,1425,1437,2558,1121
2019,3,27,15,1425,1452,2522,1070
2019,3,27,16,1420,1448,2513,1065
2019,3,27,17,1400,1446,2500,1054
2019,3,27,18,1365,1433,2442,1009
2019,3,27,19,1340,1416,2378,962
2019,3,27,20,1315,1416,2334,918
2019,3,27,21,1280,1402,2327,925
2019,3,27,22,1290,1398,2326,928
2019,3,27,23,1285,1398,2338,940
2019,3,28,0,1290,1408,2348,940
2019,3,28,1,1300,1418,2363,945
2019,3,28,2,1340,1443,2388,945
2019,3,28,3,1380,1478,2407,929
2019,3,28,4,1330,1440,2449,1009
2019,3,28,5,1270,1347,2399,1052
2019,3,28,6,1190,1283,2387,1104
2019,3,28,7,1160,1262,2396,1134
2019,3,28,8,1150,1232,2399,1167
2019,3,28,9,1155,1236,2393,1157
2019,3,28,10,1165,1231,2364,1133
2019,3,28,11,1175,1239,2378,1139
2019,3,28,12,1235,1295,2407,1112
2019,3,28,13,1355,1405,2418,1013
2019,3,28,14,1450,1494,2411,917
2019,3,28,15,1450,1508,2411,903
2019,3,28,16,1425,1523,2406,883
2019,3,28,17,1415,1521,2419,898
2019,3,28,18,1390,1517,2431,914
2019,3,28,19,1365,1505,2410,905
2019,3,28,20,1350,1496,2379,883
2019,3,28,21,1335,1483,2383,900
2019,3,28,22,1325,1488,2386,898
2019,3,28,23,1320,1480,2363,883
2019,3,29,0,1320,1478,2405,927
2019,3,29,1,1330,1483,2384,901
2019,3,29,2,1355,1496,2380,884
2019,3,29,3,1385,1515,2361,846
2019,3,29,4,1330,1466,2350,884
2019,3,29,5,1270,1394,2346,952
2019,3,29,6,1210,1321,2332,1011
2019,3,29,7,1190,1283,2331,1048
2019,3,29,8,1180,1259,2310,1051
2019,3,29,9,1180,1262,2299,1037
2019,3,29,10,1190,1261,2281,1020
2019,3,29,11,1210,1274,2281,1007
2019,3,29,12,1260,1319,2312,993
2019,3,29,13,1370,1437,2330,893
2019,3,29,14,1440,1512,2329,817
2019,3,29,15,1445,1526,2267,741
2019,3,29,16,1435,1510,2270,760
2019,3,29,17,1415,1494,2256,762
2019,3,29,18,1395,1461,2173,712
2019,3,29,19,1360,1432,2135,703
2019,3,29,20,1345,1415,1996,581
2019,3,29,21,1325,1392,1943,551
2019,3,29,22,1315,1372,1881,509
2019,3,29,23,1310,1372,1959,587
2019,3,30,0,1305,1376,2012,636
2019,3,30,1,1315,1376,2122,746
2019,3,30,2,1340,1382,2100,718
2019,3,30,3,1375,1415,2093,678
2019,3,30,4,1345,1373,2087,714
2019,3,30,5,1280,1320,2074,754
2019,3,30,6,1220,1263,2061,798
2019,3,30,7,1175,1229,2045,816
2019,3,30,8,1155,1204,2039,835
2019,3,30,9,1150,1211,2047,836
2019,3,30,10,1150,1204,2049,845
2019,3,30,11,1165,1227,2051,824
2019,3,30,12,1200,1247,2063,816
2019,3,30,13,1290,1308,2075,767
2019,3,30,14,1360,1349,2071,722
2019,3,30,15,1390,1388,2098,710
2019,3,30,16,1400,1402,2109,707
2019,3,30,17,1395,1398,2104,706
2019,3,30,18,1385,1362,2096,734
2019,3,30,19,1365,1343,2097,754
2019,3,30,20,1345,1307,2094,787
2019,3,30,21,1325,1292,2090,798
2019,3,30,22,1320,1269,2086,817
2019,3,30,23,1310,1266,2073,807
2019,3,31,0,1315,1261,2037,776
2019,3,31,1,1325,1266,2075,809
2019,3,31,2,1345,1291,2149,858
2019,3,31,3,1375,1329,2194,865
2019,3,31,4,1360,1330,2189,859
2019,3,31,5,1280,1282,2160,878
2019,3,31,6,1225,1242,2153,911
2019,3,31,7,1165,1208,2132,924
2019,3,31,8,1145,1190,2119,929
2019,3,31,9,1145,1193,2146,953
2019,3,31,10,1145,1178,2146,968
2019,3,31,11,1160,1187,2156,969
2019,3,31,12,1190,1211,2108,897
2019,3,31,13,1280,1249,2175,926
2019,3,31,14,1355,1303,2162,859
2019,3,31,15,1390,1330,2153,823
2019,3,31,16,1400,1351,2095,744
2019,3,31,17,1395,1344,2102,758
2019,3,31,18,1385,1325,2056,731
2019,3,31,19,1370,1330,2065,735
2019,3,31,20,1355,1291,2055,764
2019,3,31,21,1335,1291,2068,777
2019,3,31,22,1330,1291,2057,766
2019,3,31,23,1335,1285,2056,771
2019,4,1,0,1345,1305,2059,754
2019,4,1,1,1355,1310,2076,766
2019,4,1,2,1375,1332,2099,767
2019,4,1,3,1395,1363,2098,735
2019,4,1,4,1355,1329,2084,755
2019,4,1,5,1270,1258,2074,816
2019,4,1,6,-9999,1200,2079,879
2019,4,1,7,1170,1176,2052,876
2019,4,1,8,1145,1155,2051,896
2019,4,1,9,1140,1150,2059,909
2019,4,1,10,1145,1173,2077,904
2019,4,1,11,1170,1173,2089,916
2019,4,1,12,1235,1237,2110,873
2019,4,1,13,1335,1373,2184,811
2019,4,1,14,1425,1467,2207,740
2019,4,1,15,1425,1471,2208,737
2019,4,1,16,1430,1449,2079,630
2019,4,1,17,1415,1411,1443,32
2019,4,1,18,1375,1373,1156,-217
2019,4,1,19,1355,1375,1566,191
2019,4,1,20,1335,1372,1889,517
2019,4,1,21,1310,1352,1895,543
2019,4,1,22,1315,1370,1948,578
2019,4,1,23,1310,1351,1962,611
2019,4,2,0,1315,1341,2027,686
2019,4,2,1,1325,1352,2009,657
2019,4,2,2,1360,1365,2107,742
2019,4,2,3,1395,1401,2139,738
2019,4,2,4,1370,1370,2157,787
2019,4,2,5,1285,1286,2122,836
2019,4,2,6,1195,1232,2100,868
2019,4,2,7,1170,1194,2053,859
2019,4,2,8,1160,1180,2047,867
2019,4,2,9,1165,1190,2047,857
2019,4,2,10,1170,1195,2052,857
2019,4,2,11,1185,1214,2055,841
2019,4,2,12,1235,1275,2083,808
2019,4,2,13,1335,1407,2098,691
2019,4,2,14,1415,1478,2051,573
2019,4,2,15,1425,1457,2046,589
2019,4,2,16,1415,1448,2053,605
2019,4,2,17,1415,1417,2060,643
2019,4,2,18,1385,1414,2063,649
2019,4,2,19,1365,1380,2070,690
2019,4,2,20,1355,1360,2062,702
2019,4,2,21,1345,1349,2062,713
2019,4,2,22,1330,1338,2064,726
2019,4,2,23,1335,1339,2075,736
2019,4,3,0,1340,1333,2091,758
2019,4,3,1,1350,1328,2112,784
2019,4,3,2,1360,1344,2151,807
2019,4,3,3,1390,1405,2195,790
2019,4,3,4,1330,1363,2182,819
2019,4,3,5,1255,1286,2183,897
2019,4,3,6,1195,1233,2201,968
2019,4,3,7,1165,1198,2156,958
2019,4,3,8,1150,1152,2044,892
2019,4,3,9,1150,1148,1963,815
2019,4,3,10,1155,1147,1914,767
2019,4,3,11,1175,1181,1898,717
2019,4,3,12,1235,1234,1942,708
2019,4,3,13,1350,1359,1957,598
2019,4,3,14,1420,1430,1953,523
2019,4,3,15,1430,1432,1962,530
2019,4,3,16,1425,1422,1903,481
2019,4,3,17,1410,1414,1952,538
2019,4,3,18,1395,1389,1951,562
2019,4,3,19,1375,1364,1940,576
2019,4,3,20,1365,1359,1938,579
2019,4,3,21,1350,1361,1983,622
2019,4,3,22,1355,1347,2012,665
2019,4,3,23,1345,1347,1991,644
2019,4,4,0,1350,1350,1938,588
2019,4,4,1,1360,1367,2029,662
2019,4,4,2,1385,1368,2027,659
2019,4,4,3,1390,1401,2136,735
2019,4,4,4,1340,1369,2153,784
2019,4,4,5,1290,1279,2218,939
2019,4,4,6,1225,1212,2218,1006
2019,4,4,7,1130,1188,2149,961
2019,4,4,8,1105,1156,2159,1003
2019,4,4,9,1110,1154,2105,951
2019,4,4,10,1110,1158,2152,994
2019,4,4,11,1125,1181,2156,975
2019,4,4,12,1175,1227,2172,945
2019,4,4,13,1300,1373,2239,866
2019,4,4,14,1395,1422,2092,670
2019,4,4,15,1400,1416,1853,437
2019,4,4,16,1400,1435,2150,715
2019,4,4,17,1390,1421,2222,801
2019,4,4,18,1385,1415,2258,843
2019,4,4,19,1365,1402,2256,854
2019,4,4,20,1355,1379,2268,889
2019,4,4,21,1340,1372,2244,872
2019,4,4,22,1340,1347,2217,870
2019,4,4,23,1325,1356,2255,899
2019,4,5,0,1330,1339,2198,859
2019,4,5,1,1335,1330,2154,824
2019,4,5,2,1350,1329,2115,786
2019,4,5,3,1380,1373,2087,714
2019,4,5,4,1350,1325,2068,743
2019,4,5,5,1260,1260,2087,827
2019,4,5,6,1200,1183,2113,930
2019,4,5,7,1155,1153,2050,897
2019,4,5,8,1125,1140,2032,892
2019,4,5,9,1130,1135,2026,891
2019,4,5,10,1130,1153,2018,865
2019,4,5,11,1150,1176,2031,855
2019,4,5,12,1200,1222,2053,831
2019,4,5,13,1320,1323,2131,808
2019,4,5,14,1400,1395,2130,735
2019,4,5,15,1405,1419,2143,724
2019,4,5,16,1395,1419,2089,670
2019,4,5,17,1380,1397,2087,690
2019,4,5,18,1355,1379,2098,719
2019,4,5,19,1325,1372,2098,726
2019,4,5,20,1315,1360,2085,725
2019,4,5,21,1300,1353,2091,738
2019,4,5,22,1285,1339,2086,747
2019,4,5,23,1285,1338,2125,787
2019,4,6,0,1285,1327,2136,809
2019,4,6,1,1290,1302,1990,688
2019,4,6,2,1300,1320,2086,766
2019,4,6,3,1335,1350,2152,802
2019,4,6,4,1290,1308,2135,827
2019,4,6,5,1230,1248,2039,791
2019,4,6,6,1175,1202,2159,957
2019,4,6,7,1115,1157,2217,1060
2019,4,6,8,1090,1141,2113,972
2019,4,6,9,1095,1135,2090,955
2019,4,6,10,1090,1135,2146,1011
2019,4,6,11,1115,1142,2136,994
2019,4,6,12,1140,1179,2080,901
2019,4,6,13,1230,1218,2062,844
2019,4,6,14,1290,1291,2187,896
2019,4,6,15,1315,1345,2284,939
2019,4,6,16,1330,1369,2282,913
2019,4,6,17,1325,1360,2286,926
2019,4,6,18,1300,1340,2208,868
2019,4,6,19,1280,1341,2182,841
2019,4,6,20,1250,1321,2185,864
2019,4,6,21,1230,1308,2210,902
2019,4,6,22,1215,1315,2044,729
2019,4,6,23,1210,1310,1952,642
2019,4,7,0,1205,1322,1945,623
2019,4,7,1,1210,1323,2039,716
2019,4,7,2,1230,1335,2202,867
2019,4,7,3,1265,1368,2290,922
2019,4,7,4,1240,1351,2276,925
2019,4,7,5,1205,1295,2326,1031
2019,4,7,6,1155,1251,2258,1007
2019,4,7,7,1110,1210,2193,983
2019,4,7,8,1090,1181,2115,934
2019,4,7,9,1095,1172,2123,951
2019,4,7,10,1085,1183,2170,987
2019,4,7,11,1100,1189,2216,1027
2019,4,7,12,1125,1202,2149,947
2019,4,7,13,1210,1225,2035,810
2019,4,7,14,1280,1271,2019,748
2019,4,7,15,1310,1300,1826,526
2019,4,7,16,1325,1343,1753,410
2019,4,7,17,1320,1326,1584,258
2019,4,7,18,1305,1313,1480,167
2019,4,7,19,1300,1319,1479,160
2019,4,7,20,1270,1312,1533,221
2019,4,7,21,1265,1306,1543,237
2019,4,7,22,1255,1302,1576,274
2019,4,7,23,1260,1322,1589,267
2019,4,8,0,1270,1334,1599,265
2019,4,8,1,1275,1366,1875,509
2019,4,8,2,1290,1382,2010,628
2019,4,8,3,1320,1415,2094,679
2019,4,8,4,1280,1361,2175,814
2019,4,8,5,1205,1300,2088,788
2019,4,8,6,1140,1223,2059,836
2019,4,8,7,1125,1180,2028,848
2019,4,8,8,1095,1165,1958,793
2019,4,8,9,1090,1175,1972,797
2019,4,8,10,1100,1166,1940,774
2019,4,8,11,1120,1176,1918,742
2019,4,8,12,1180,1240,1935,695
2019,4,8,13,1310,1357,2008,651
2019,4,8,14,1400,1417,1967,550
2019,4,8,15,1405,1416,1704,288
2019,4,8,16,1395,1409,1601,192
2019,4,8,17,1380,1417,1615,198
2019,4,8,18,1345,1427,1880,453
2019,4,8,19,1330,1406,1956,550
2019,4,8,20,1320,1389,1976,587
2019,4,8,21,1305,1379,1994,615
2019,4,8,22,1305,1371,1980,609
2019,4,8,23,1300,1395,2014,619
2019,4,9,0,1300,1391,1983,592
2019,4,9,1,1315,1406,1975,569
2019,4,9,2,1325,1425,1997,572
2019,4,9,3,1365,1456,2108,652
2019,4,9,4,1335,1402,2096,694
2019,4,9,5,1245,1323,2084,761
2019,4,9,6,1175,1243,2075,832
2019,4,9,7,1165,1222,2024,802
2019,4,9,8,1145,1208,1781,573
2019,4,9,9,1155,1206,1743,537
2019,4,9,10,1160,1220,1753,533
2019,4,9,11,1175,1178,1167,-11
2019,4,9,12,1225,1209,929,-280
2019,4,9,13,1340,1315,944,-371
2019,4,9,14,1410,1407,974,-433
2019,4,9,15,1410,1427,1067,-360
2019,4,9,16,1405,1416,1159,-257
2019,4,9,17,1385,1442,1408,-34
2019,4,9,18,1375,1430,1511,81
2019,4,9,19,1350,1420,1659,239
2019,4,9,20,1335,1415,1619,204
2019,4,9,21,1325,1426,1563,137
2019,4,9,22,1315,1425,1557,132
2019,4,9,23,1320,1433,1637,204
2019,4,10,0,1320,1427,1698,271
2019,4,10,1,1325,1448,1706,258
2019,4,10,2,1340,1469,1818,349
2019,4,10,3,1385,1506,1908,402
2019,4,10,4,1350,1449,1883,434
2019,4,10,5,1260,1364,1717,353
2019,4,10,6,1205,1271,1214,-57
2019,4,10,7,1200,1226,1061,-165
2019,4,10,8,1165,1208,1063,-145
2019,4,10,9,1165,1194,1065,-129
2019,4,10,10,1165,1212,1066,-146
2019,4,10,11,1195,1242,1073,-169
2019,4,10,12,1250,1301,1086,-215
2019,4,10,13,1370,1413,1125,-288
2019,4,10,14,1435,1519,1400,-119
2019,4,10,15,1440,1539,1922,383
2019,4,10,16,1435,1554,2195,641
2019,4,10,17,1430,1532,1964,432
2019,4,10,18,1410,1505,1952,447
2019,4,10,19,1390,1476,1886,410
2019,4,10,20,1380,1454,1783,329
2019,4,10,21,1375,1441,1705,264
2019,4,10,22,1365,1444,1687,243
2019,4,10,23,1370,1430,1696,266
2019,4,11,0,1375,1419,1721,302
2019,4,11,1,1390,1438,1648,210
2019,4,11,2,1395,1463,1975,512
2019,4,11,3,1430,1505,2101,596
2019,4,11,4,1380,1448,2114,666
2019,4,11,5,1295,1375,2103,728
2019,4,11,6,1225,1300,2056,756
2019,4,11,7,1195,1262,2003,741
2019,4,11,8,1170,1241,1739,498
2019,4,11,9,1160,1237,1449,212
2019,4,11,10,1165,1239,1474,235
2019,4,11,11,1170,1268,1566,298
2019,4,11,12,1220,1326,1734,408
2019,4,11,13,1340,1456,2096,640
2019,4,11,14,1420,1512,2125,613
2019,4,11,15,1430,1512,2115,603
2019,4,11,16,1430,1495,2103,608
2019,4,11,17,1435,1489,2088,599
2019,4,11,18,1430,1473,2074,601
2019,4,11,19,1415,1443,1988,545
2019,4,11,20,1410,1446,2055,609
2019,4,11,21,1410,1431,2037,606
2019,4,11,22,1405,1426,2087,661
2019,4,11,23,1405,1415,2078,663
2019,4,12,0,1400,1414,2083,669
2019,4,12,1,1405,1418,2113,695
2019,4,12,2,1420,1434,2120,686
2019,4,12,3,1450,1463,2109,646
2019,4,12,4,1380,1454,2136,682
2019,4,12,5,1315,1380,2195,815
2019,4,12,6,1230,1315,2142,827
2019,4,12,7,1215,1282,2127,845
2019,4,12,8,1200,1268,2112,844
2019,4,12,9,1195,1272,2133,861
2019,4,12,10,1210,1287,2145,858
2019,4,12,11,1235,1303,2125,822
2019,4,12,12,1285,1342,2123,781
2019,4,12,13,1390,1450,2137,687
2019,4,12,14,1460,1511,2115,604
2019,4,12,15,1480,1505,2112,607
2019,4,12,16,1485,1501,2122,621
2019,4,12,17,1465,1469,2119,650
2019,4,12,18,1440,1454,2126,672
2019,4,12,19,1430,1421,2127,706
2019,4,12,20,1420,1406,2138,732
2019,4,12,21,1410,1378,2133,755
2019,4,12,22,1400,1364,2083,719
2019,4,12,23,1390,1347,2104,757
2019,4,13,0,1385,1348,2115,767
2019,4,13,1,1375,1344,2117,773
2019,4,13,2,1385,1363,2122,759
2019,4,13,3,1420,1396,2119,723
2019,4,13,4,1390,1387,2123,736
2019,4,13,5,1310,1343,2087,744
2019,4,13,6,1255,1291,2147,856
2019,4,13,7,1175,1260,2154,894
2019,4,13,8,1155,1250,2093,843
2019,4,13,9,1155,1242,2077,835
2019,4,13,10,1155,1245,2085,840
2019,4,13,11,1165,1260,2162,902
2019,4,13,12,1205,1285,2177,892
2019,4,13,13,1250,1325,2206,881
2019,4,13,14,1305,1367,2206,839
2019,4,13,15,1345,1405,2238,833
2019,4,13,16,1360,1419,2316,897
2019,4,13,17,1355,1407,2331,924
2019,4,13,18,1335,1393,2371,978
2019,4,13,19,1325,1370,2315,945
2019,4,13,20,1310,1357,2348,991
2019,4,13,21,1295,1339,2366,1027
2019,4,13,22,1300,1328,2278,950
2019,4,13,23,1295,1314,2230,916
2019,4,14,0,1300,1333,2195,862
2019,4,14,1,1300,1348,2232,884
2019,4,14,2,1315,1370,2246,876
2019,4,14,3,1345,1394,2225,831
2019,4,14,4,1305,1364,2197,833
2019,4,14,5,1270,1319,2216,897
2019,4,14,6,1225,1271,2237,966
2019,4,14,7,1155,1218,2218,1000
2019,4,14,8,1125,1188,2082,894
2019,4,14,9,1125,1178,1845,667
2019,4,14,10,1130,1163,1929,766
2019,4,14,11,1140,1158,1852,694
2019,4,14,12,1165,1192,2093,901
2019,4,14,13,1215,1226,2159,933
2019,4,14,14,1265,1285,2166,881
2019,4,14,15,1295,1358,2231,873
2019,4,14,16,1325,1381,2158,777
2019,4,14,17,1315,1398,2239,841
2019,4,14,18,1300,1398,2152,754
2019,4,14,19,1300,1399,2162,763
2019,4,14,20,1290,1365,2095,730
2019,4,14,21,1280,1348,2074,726
2019,4,14,22,1280,1348,2088,740
2019,4,14,23,1290,1361,2185,824
2019,4,15,0,1300,1395,2223,828
2019,4,15,1,1315,1399,2285,886
2019,4,15,2,1325,1400,2296,896
2019,4,15,3,1350,1450,2287,837
2019,4,15,4,1265,1406,2258,852
2019,4,15,5,1240,1333,2214,881
2019,4,15,6,1175,1271,2208,937
2019,4,15,7,1165,1231,2180,949
2019,4,15,8,1150,1214,2147,933
2019,4,15,9,1155,1212,2154,942
2019,4,15,10,1155,1221,2144,923
2019,4,15,11,1170,1248,2193,945
2019,4,15,12,1230,1308,2227,919
2019,4,15,13,1360,1410,2280,870
2019,4,15,14,1430,1485,2313,828
2019,4,15,15,1435,1471,2301,830
2019,4,15,16,1430,1463,2349,886
2019,4,15,17,1425,1451,2318,867
2019,4,15,18,1425,1425,2295,870
2019,4,15,19,1400,1408,2340,932
2019,4,15,20,1385,1409,2303,894
2019,4,15,21,1375,1391,2256,865
2019,4,15,22,1375,1374,2225,851
2019,4,15,23,1385,1387,2233,846
2019,4,16,0,1380,1371,2210,839
2019,4,16,1,1390,1377,2210,833
2019,4,16,2,1405,1379,2184,805
2019,4,16,3,1430,1420,2176,756
2019,4,16,4,1380,1396,2235,839
2019,4,16,5,1305,1312,2216,904
2019,4,16,6,1230,1237,2151,914
2019,4,16,7,1195,1203,2119,916
2019,4,16,8,1175,1170,2059,889
2019,4,16,9,1175,1173,2048,875
2019,4,16,10,1180,1168,2035,867
2019,4,16,11,1180,1200,2063,863
2019,4,16,12,1240,1263,2110,847
2019,4,16,13,1350,1404,2142,738
2019,4,16,14,1430,1476,2132,656
2019,4,16,15,1440,1488,2108,620
2019,4,16,16,1435,1494,2087,593
2019,4,16,17,1435,1475,2086,611
2019,4,16,18,1425,1448,2047,599
2019,4,16,19,1405,1437,2058,621
2019,4,16,20,1390,1435,2107,672
2019,4,16,21,1390,1427,2157,730
2019,4,16,22,1380,1410,2187,777
2019,4,16,23,1385,1398,2189,791
2019,4,17,0,1385,1389,2192,803
2019,4,17,1,1390,1378,2164,786
2019,4,17,2,1405,1390,2156,766
2019,4,17,3,1420,1421,2127,706
2019,4,17,4,1410,1387,2087,700
2019,4,17,5,1320,1322,2037,715
2019,4,17,6,1250,1252,2109,857
2019,4,17,7,1185,1225,2092,867
2019,4,17,8,1155,1212,2096,884
2019,4,17,9,1145,1206,2055,849
2019,4,17,10,1155,1210,1979,769
2019,4,17,11,1180,1217,1861,644
2019,4,17,12,1235,1282,1940,658
2019,4,17,13,1350,1400,2038,638
2019,4,17,14,1425,1473,2116,643
2019,4,17,15,1430,1441,1955,514
2019,4,17,16,1430,1453,1848,395
2019,4,17,17,1420,1448,1865,417
2019,4,17,18,1395,1423,1823,400
2019,4,17,19,1375,1399,1506,107
2019,4,17,20,1365,1380,1404,24
2019,4,17,21,1360,1374,1393,19
2019,4,17,22,1355,1358,1371,13
2019,4,17,23,1350,1346,1377,31
2019,4,18,0,1350,1341,1365,24
2019,4,18,1,1360,1346,1506,160
2019,4,18,2,1370,1351,1559,208
2019,4,18,3,1405,1393,1783,390
2019,4,18,4,1360,1389,1911,522
2019,4,18,5,1280,1314,1815,501
2019,4,18,6,1215,1241,1775,534
2019,4,18,7,1165,1213,1725,512
2019,4,18,8,1145,1197,1798,601
2019,4,18,9,1140,1176,1713,537
2019,4,18,10,1140,1166,1694,528
2019,4,18,11,1170,1181,1740,559
2019,4,18,12,1225,1254,1847,593
2019,4,18,13,1355,1371,1981,610
2019,4,18,14,1415,1442,2201,759
2019,4,18,15,1420,1436,2281,845
2019,4,18,16,1415,1450,2344,894
2019,4,18,17,1405,1435,2331,896
2019,4,18,18,1390,1412,2276,864
2019,4,18,19,1370,1370,2295,925
2019,4,18,20,1365,1383,2269,886
2019,4,18,21,1355,1379,2279,900
2019,4,18,22,1340,1373,2207,834
2019,4,18,23,1335,1369,2274,905
2019,4,19,0,1330,1355,2319,964
2019,4,19,1,1330,1344,2258,914
2019,4,19,2,1345,1348,2285,937
2019,4,19,3,1375,1386,2344,958
2019,4,19,4,1340,1378,2364,986
2019,4,19,5,1285,1296,2275,979
2019,4,19,6,1215,1227,2281,1054
2019,4,19,7,1130,1183,2189,1006
2019,4,19,8,1120,1173,2188,1015
2019,4,19,9,1120,1162,2156,994
2019,4,19,10,1125,1151,2174,1023
2019,4,19,11,1140,1151,2102,951
2019,4,19,12,1185,1197,2118,921
2019,4,19,13,1320,1290,2201,911
2019,4,19,14,1405,1357,2286,929
2019,4,19,15,1400,1385,2250,865
2019,4,19,16,1405,1403,2248,845
2019,4,19,17,1385,1384,2274,890
2019,4,19,18,1365,1375,2339,964
2019,4,19,19,1345,1381,2370,989
2019,4,19,20,1330,1371,2243,872
2019,4,19,21,1315,1365,2258,893
2019,4,19,22,1300,1338,2203,865
2019,4,19,23,1285,1341,2195,854
2019,4,20,0,1285,1328,2192,864
2019,4,20,1,1280,1325,2280,955
2019,4,20,2,1290,1334,2250,916
2019,4,20,3,1325,1340,2235,895
2019,4,20,4,1300,1331,2208,877
2019,4,20,5,1255,1267,2181,914
2019,4,20,6,1200,1186,2144,958
2019,4,20,7,1130,1152,2145,993
2019,4,20,8,1120,1123,2054,931
2019,4,20,9,1110,1119,2042,923
2019,4,20,10,1110,1108,1990,882
2019,4,20,11,1125,1105,1944,839
2019,4,20,12,1160,1117,1974,857
2019,4,20,13,1245,1170,2042,872
2019,4,20,14,1330,1208,2099,891
2019,4,20,15,1365,1280,2077,797
2019,4,20,16,1380,1325,2046,721
2019,4,20,17,1370,1359,2064,705
2019,4,20,18,1355,1359,2110,751
2019,4,20,19,1330,1337,2100,763
2019,4,20,20,1320,1320,2112,792
2019,4,20,21,1305,1327,2144,817
2019,4,20,22,1305,1303,2133,830
2019,4,20,23,1295,1308,2072,764
2019,4,21,0,1305,1317,1997,680
2019,4,21,1,1310,1318,1955,637
2019,4,21,2,1325,1329,1994,665
2019,4,21,3,1350,1341,1933,592
2019,4,21,4,1330,1330,2089,759
2019,4,21,5,1275,1262,2084,822
2019,4,21,6,1225,1212,2047,835
2019,4,21,7,1160,1149,1881,732
2019,4,21,8,1135,1117,1665,548
2019,4,21,9,1125,1121,1668,547
2019,4,21,10,1115,1113,1645,532
2019,4,21,11,1115,1146,1710,564
2019,4,21,12,1155,1165,1749,584
2019,4,21,13,1200,1204,1754,550
2019,4,21,14,1265,1262,1750,488
2019,4,21,15,1315,1306,1666,360
2019,4,21,16,1340,1334,1640,306
2019,4,21,17,1345,1340,1598,258
2019,4,21,18,1340,1330,1481,151
2019,4,21,19,1330,1320,1392,72
2019,4,21,20,1315,1295,1405,110
2019,4,21,21,1310,1289,1431,142
2019,4,21,22,1305,1275,1432,157
2019,4,21,23,1310,1265,1476,211
2019,4,22,0,1335,1259,1468,209
2019,4,22,1,1335,1254,1440,186
2019,4,22,2,1335,1260,1442,182
2019,4,22,3,1375,1310,1501,191
2019,4,22,4,1265,1309,1588,279
2019,4,22,5,1265,1246,1505,259
2019,4,22,6,1200,1180,1467,287
2019,4,22,7,1135,1148,1463,315
2019,4,22,8,1125,1128,1490,362
2019,4,22,9,1120,1128,1481,353
2019,4,22,10,1120,1129,1427,298
2019,4,22,11,1140,1144,1440,296
2019,4,22,12,1205,1198,1514,316
2019,4,22,13,1320,1306,1649,343
2019,4,22,14,1400,1388,1766,378
2019,4,22,15,1390,1390,1760,370
2019,4,22,16,1385,1404,1704,300
2019,4,22,17,1380,1377,1406,29
2019,4,22,18,1360,1367,1332,-35
2019,4,22,19,1335,1358,1349,-9
2019,4,22,20,1330,1349,1352,3
2019,4,22,21,1325,1346,1364,18
2019,4,22,22,1310,1347,1394,47
2019,4,22,23,1320,1336,1400,64
2019,4,23,0,1310,1333,1425,92
2019,4,23,1,1310,1345,1547,202
2019,4,23,2,1315,1343,1652,309
2019,4,23,3,1355,1368,1650,282
2019,4,23,4,1320,1345,1622,277
2019,4,23,5,1245,1265,1549,284
2019,4,23,6,1175,1170,1529,359
2019,4,23,7,1135,1151,1525,374
2019,4,23,8,1105,1132,1627,495
2019,4,23,9,1105,1118,1656,538
2019,4,23,10,1100,1120,1630,510
2019,4,23,11,1125,1140,1654,514
2019,4,23,12,1165,1187,1656,469
2019,4,23,13,1270,1290,1637,347
2019,4,23,14,1340,1359,1594,235
2019,4,23,15,1360,1390,1600,210
2019,4,23,16,1370,1389,1629,240
2019,4,23,17,1370,1397,1606,209
2019,4,23,18,1355,1383,1644,261
2019,4,23,19,1345,1376,1635,259
2019,4,23,20,1335,1373,1583,210
2019,4,23,21,1335,1358,1604,246
2019,4,23,22,1320,1344,1587,243
2019,4,23,23,1315,1351,1580,229
2019,4,24,0,1305,1334,1560,226
2019,4,24,1,1300,1343,1580,237
2019,4,24,2,1315,1332,1548,216
2019,4,24,3,1345,1357,1564,207
2019,4,24,4,1300,1309,1497,188
2019,4,24,5,1255,1227,1439,212
2019,4,24,6,1170,1150,1445,295
2019,4,24,7,1125,1127,1424,297
2019,4,24,8,1110,1109,1354,245
2019,4,24,9,1105,1083,1360,277
2019,4,24,10,1110,1059,1367,308
2019,4,24,11,1125,1066,1391,325
2019,4,24,12,1180,1116,1425,309
2019,4,24,13,1280,1223,1413,190
2019,4,24,14,1355,1293,1367,74
2019,4,24,15,1340,1324,1543,219
2019,4,24,16,1355,1314,1417,103
2019,4,24,17,1345,1319,1470,151
2019,4,24,18,1325,1323,1471,148
2019,4,24,19,1315,1310,1492,182
2019,4,24,20,1300,1296,1489,193
2019,4,24,21,1290,1303,1549,246
2019,4,24,22,1285,1292,1509,217
2019,4,24,23,1275,1298,1555,257
2019,4,25,0,1270,1283,1598,315
2019,4,25,1,1275,1297,1629,332
2019,4,25,2,1280,1284,1594,310
2019,4,25,3,1315,1320,1643,323
2019,4,25,4,1280,1309,1622,313
2019,4,25,5,1225,1251,1687,436
2019,4,25,6,1155,1183,1463,280
2019,4,25,7,1115,1166,1484,318
2019,4,25,8,1100,1152,1619,467
2019,4,25,9,1085,1146,1592,446
2019,4,25,10,1080,1154,1595,441
2019,4,25,11,1095,1164,1698,534
2019,4,25,12,1155,1234,1737,503
2019,4,25,13,1255,1332,1833,501
2019,4,25,14,1310,1414,1962,548
2019,4,25,15,1315,1422,1951,529
2019,4,25,16,1320,1409,1917,508
2019,4,25,17,1315,1392,1800,408
2019,4,25,18,1295,1371,1811,440
2019,4,25,19,1270,1370,1820,450
2019,4,25,20,1275,1361,1820,459
2019,4,25,21,1265,1343,1816,473
2019,4,25,22,1260,1332,1816,484
2019,4,25,23,1255,1322,1816,494
2019,4,26,0,1245,1303,1840,537
2019,4,26,1,1240,1297,1856,559
2019,4,26,2,1245,1314,1881,567
2019,4,26,3,1275,1353,1908,555
2019,4,26,4,1230,1347,1926,579
2019,4,26,5,1180,1269,1900,631
2019,4,26,6,1110,1178,1676,498
2019,4,26,7,1190,1147,1589,442
2019,4,26,8,1175,1114,1505,391
2019,4,26,9,1165,1112,1494,382
2019,4,26,10,1150,1118,1489,371
2019,4,26,11,1155,1145,1494,349
2019,4,26,12,1205,1181,1480,299
2019,4,26,13,1305,1272,1475,203
2019,4,26,14,1375,1354,1500,146
2019,4,26,15,1400,1381,1658,277
2019,4,26,16,1410,1382,1653,271
2019,4,26,17,1395,1372,1640,268
2019,4,26,18,1390,1379,1519,140
2019,4,26,19,1385,1373,1520,147
2019,4,26,20,1370,1370,1543,173
2019,4,26,21,1365,1358,1582,224
2019,4,26,22,1345,1373,1599,226
2019,4,26,23,1345,1377,1599,222
2019,4,27,0,1330,1354,1673,319
2019,4,27,1,1335,1346,1627,281
2019,4,27,2,1340,1329,1615,286
2019,4,27,3,1355,1350,1623,273
2019,4,27,4,1320,1356,1629,273
2019,4,27,5,1280,1301,1590,289
2019,4,27,6,1215,1249,1627,378
2019,4,27,7,1115,1204,1603,399
2019,4,27,8,1100,1185,1457,272
2019,4,27,9,1090,1178,1426,248
2019,4,27,10,1090,1167,1390,223
2019,4,27,11,1100,1190,1457,267
2019,4,27,12,1140,1192,1412,220
2019,4,27,13,1200,1232,1396,164
2019,4,27,14,1265,1277,1481,204
2019,4,27,15,1300,1321,1407,86
2019,4,27,16,1315,1331,1424,93
2019,4,27,17,1315,1337,1400,63
2019,4,27,18,1305,1329,1336,7
2019,4,27,19,1290,1294,1245,-49
2019,4,27,20,1280,1297,1100,-197
2019,4,27,21,1270,1296,1022,-274
2019,4,27,22,1260,1307,1000,-307
2019,4,27,23,1255,1333,1041,-292
2019,4,28,0,1250,1335,1003,-332
2019,4,28,1,1255,1347,1010,-337
2019,4,28,2,1265,1336,1111,-225
2019,4,28,3,1285,1373,1196,-177
2019,4,28,4,1265,1353,1162,-191
2019,4,28,5,1210,1314,1169,-145
2019,4,28,6,1145,1261,1162,-99
2019,4,28,7,1175,1233,1222,-11
2019,4,28,8,1150,1206,1227,21
2019,4,28,9,1145,1178,1204,26
2019,4,28,10,1140,1178,1243,65
2019,4,28,11,1150,1180,1215,35
2019,4,28,12,1190,1193,1217,24
2019,4,28,13,1250,1235,1172,-63
2019,4,28,14,1315,1272,1150,-122
2019,4,28,15,1355,1344,1202,-142
2019,4,28,16,1370,1409,1240,-169
2019,4,28,17,1370,1412,1216,-196
2019,4,28,18,1360,1429,1233,-196
2019,4,28,19,1355,1432,1225,-207
2019,4,28,20,1340,1424,1236,-188
2019,4,28,21,1330,1403,1217,-186
2019,4,28,22,1320,1410,1282,-128
2019,4,28,23,1315,1420,1323,-97
2019,4,29,0,1315,1421,1288,-133
2019,4,29,1,1315,1418,1326,-92
2019,4,29,2,1320,1408,1324,-84
2019,4,29,3,1365,1423,1345,-78
2019,4,29,4,1315,1427,1340,-87
2019,4,29,5,1275,1353,1292,-61
2019,4,29,6,1195,1289,1278,-11
2019,4,29,7,1220,1255,1286,31
2019,4,29,8,1205,1242,1161,-81
2019,4,29,9,1200,1244,1141,-103
2019,4,29,10,1205,1244,1156,-88
2019,4,29,11,1220,1269,1144,-125
2019,4,29,12,1290,1334,1171,-163
2019,4,29,13,1385,1443,1142,-301
2019,4,29,14,1460,1512,1197,-315
2019,4,29,15,1460,1507,1222,-285
2019,4,29,16,1460,1503,1235,-268
2019,4,29,17,1450,1488,1239,-249
2019,4,29,18,1430,1465,1250,-215
2019,4,29,19,1425,1445,1258,-187
2019,4,29,20,1415,1431,1274,-157
2019,4,29,21,1405,1424,1285,-139
2019,4,29,22,1395,1410,1309,-101
2019,4,29,23,1390,1408,1327,-81
2019,4,30,0,1380,1419,1312,-107
2019,4,30,1,1385,1428,1324,-104
2019,4,30,2,1385,1442,1343,-99
2019,4,30,3,1420,1453,1333,-120
2019,4,30,4,1380,1432,1309,-123
2019,4,30,5,1320,1362,1252,-110
2019,4,30,6,1230,1282,1298,16
2019,4,30,7,1250,1261,1319,58
2019,4,30,8,1230,1243,1267,24
2019,4,30,9,1215,1238,1269,31
2019,4,30,10,1210,1236,1244,8
2019,4,30,11,1225,1258,1257,-1
2019,4,30,12,1280,1322,1314,-8
2019,4,30,13,1380,1429,1342,-87
2019,4,30,14,1440,1501,1316,-185
2019,4,30,15,1465,1495,1285,-210
2019,4,30,16,1465,1486,1284,-202
2019,4,30,17,1470,1489,1331,-158
2019,4,30,18,1460,1476,1314,-162
2019,4,30,19,1450,1451,1295,-156
2019,4,30,20,1445,1438,1280,-158
2019,4,30,21,1435,1424,1253,-171
2019,4,30,22,1420,1415,1246,-169
2019,4,30,23,1425,1430,1254,-176
2019,5,1,0,1410,1422,1240,-182
2019,5,1,1,1415,1417,1251,-166
2019,5,1,2,1410,1421,1240,-181
2019,5,1,3,1440,1445,1266,-179
2019,5,1,4,1400,1433,1274,-159
2019,5,1,5,1320,1349,1239,-110
2019,5,1,6,1240,1279,1256,-23
2019,5,1,7,1270,1249,1256,7
2019,5,1,8,1260,1241,1264,23
2019,5,1,9,1245,1247,1282,35
2019,5,1,10,1235,1265,1269,4
2019,5,1,11,1250,1277,1261,-16
2019,5,1,12,1310,1335,1257,-78
2019,5,1,13,1380,1438,1261,-177
2019,5,1,14,1410,1492,1262,-230
2019,5,1,15,1420,1462,1225,-237
2019,5,1,16,1415,1460,1232,-228
2019,5,1,17,1410,1459,1294,-165
2019,5,1,18,1400,1425,1256,-169
2019,5,1,19,1385,1404,1254,-150
2019,5,1,20,1370,1409,1260,-149
2019,5,1,21,1370,1385,1302,-83
2019,5,1,22,1355,1384,1318,-66
2019,5,1,23,1355,1386,1310,-76
2019,5,2,0,1350,1366,1328,-38
2019,5,2,1,1360,1370,1317,-53
2019,5,2,2,1360,1376,1313,-63
2019,5,2,3,1390,1412,1279,-133
2019,5,2,4,1380,1392,1282,-110
2019,5,2,5,1310,1307,1225,-82
2019,5,2,6,1235,1251,1261,10
2019,5,2,7,1185,1223,1353,130
2019,5,2,8,1170,1199,1238,39
2019,5,2,9,1160,1204,1254,50
2019,5,2,10,1160,1213,1250,37
2019,5,2,11,1175,1237,1244,7
2019,5,2,12,1245,1296,1267,-29
2019,5,2,13,1350,1383,1293,-90
2019,5,2,14,1425,1449,1274,-175
2019,5,2,15,1425,1449,1318,-131
2019,5,2,16,1420,1434,1416,-18
2019,5,2,17,1410,1435,1483,48
2019,5,2,18,1390,1432,1478,46
2019,5,2,19,1375,1413,1433,20
2019,5,2,20,1370,1409,1451,42
2019,5,2,21,1355,1393,1460,67
2019,5,2,22,1345,1386,1448,62
2019,5,2,23,1345,1376,1398,22
2019,5,3,0,1330,1356,1377,21
2019,5,3,1,1325,1347,1355,8
2019,5,3,2,1335,1359,1361,2
2019,5,3,3,1370,1375,1333,-42
2019,5,3,4,1360,1386,1292,-94
2019,5,3,5,1280,1328,1249,-79
2019,5,3,6,1200,1271,1264,-7
2019,5,3,7,1210,1226,1287,61
2019,5,3,8,1195,1210,1332,122
2019,5,3,9,1190,1216,1346,130
2019,5,3,10,1190,1226,1336,110
2019,5,3,11,1205,1243,1355,112
2019,5,3,12,1250,1292,1378,86
2019,5,3,13,1340,1378,1388,10
2019,5,3,14,1395,1448,1417,-31
2019,5,3,15,1410,1444,1492,48
2019,5,3,16,1415,1435,1495,60
2019,5,3,17,1405,1419,1532,113
2019,5,3,18,1395,1394,1477,83
2019,5,3,19,1385,1372,1462,90
2019,5,3,20,1385,1361,1471,110
2019,5,3,21,1370,1344,1481,137
2019,5,3,22,1365,1328,1479,151
2019,5,3,23,1365,1320,1454,134
2019,5,4,0,1345,1298,1444,146
2019,5,4,1,1345,1276,1384,108
2019,5,4,2,1345,1269,1314,45
2019,5,4,3,1365,1296,1300,4
2019,5,4,4,1360,1311,1320,9
2019,5,4,5,1285,1276,1299,23
2019,5,4,6,1225,1200,1274,74
2019,5,4,7,1125,1169,1259,90
2019,5,4,8,1105,1150,1266,116
2019,5,4,9,1105,1138,1262,124
2019,5,4,10,1100,1134,1254,120
2019,5,4,11,1120,1146,1249,103
2019,5,4,12,1135,1168,1288,120
2019,5,4,13,1200,1204,1287,83
2019,5,4,14,1260,1259,1281,22
2019,5,4,15,1300,1299,1229,-70
2019,5,4,16,1310,1303,1224,-79
2019,5,4,17,1315,1317,1239,-78
2019,5,4,18,1310,1300,1251,-49
2019,5,4,19,1285,1288,1264,-24
2019,5,4,20,1285,1279,1305,26
2019,5,4,21,1280,1278,1323,45
2019,5,4,22,1285,1266,1307,41
2019,5,4,23,1295,1263,1308,45
2019,5,5,0,1295,1277,1336,59
2019,5,5,1,1300,1296,1315,19
2019,5,5,2,1295,1271,1314,43
2019,5,5,3,1320,1305,1346,41
2019,5,5,4,1260,1307,1376,69
2019,5,5,5,1260,1263,1364,101
2019,5,5,6,1210,1195,1336,141
2019,5,5,7,1125,1151,1300,149
2019,5,5,8,1100,1137,1267,130
2019,5,5,9,1085,1130,1232,102
2019,5,5,10,1085,1129,1220,91
2019,5,5,11,1095,1121,1027,-94
2019,5,5,12,1120,1131,1026,-105
2019,5,5,13,1170,1164,1074,-90
2019,5,5,14,1210,1220,1106,-114
2019,5,5,15,1260,1273,1121,-152
2019,5,5,16,1300,1311,1148,-163
2019,5,5,17,1300,1328,1166,-162
2019,5,5,18,1310,1354,1161,-193
2019,5,5,19,1305,1356,1101,-255
2019,5,5,20,1295,1351,1079,-272
2019,5,5,21,1280,1314,1026,-288
2019,5,5,22,1280,1326,1026,-300
2019,5,5,23,1285,1325,1004,-321
2019,5,6,0,1280,1326,999,-327
2019,5,6,1,1275,1323,1042,-281
2019,5,6,2,1270,1334,1054,-280
2019,5,6,3,1290,1350,1050,-300
2019,5,6,4,1210,1343,1045,-298
2019,5,6,5,1235,1266,1048,-218
2019,5,6,6,1175,1198,1047,-151
2019,5,6,7,1130,1161,1037,-124
2019,5,6,8,1115,1144,994,-150
2019,5,6,9,1115,1136,986,-150
2019,5,6,10,1120,1143,992,-151
2019,5,6,11,1140,1165,993,-172
2019,5,6,12,1200,1222,986,-236
2019,5,6,13,1320,1331,1037,-294
2019,5,6,14,1410,1412,1025,-387
2019,5,6,15,1410,1426,1051,-375
2019,5,6,16,1405,1424,1048,-376
2019,5,6,17,1395,1423,1045,-378
2019,5,6,18,1380,1395,1026,-369
2019,5,6,19,1360,1394,1036,-358
2019,5,6,20,1350,1398,1047,-351
2019,5,6,21,1340,1383,1036,-347
2019,5,6,22,1330,1376,1039,-337
2019,5,6,23,1325,1371,1024,-347
2019,5,7,0,1330,1355,1013,-342
2019,5,7,1,1335,1363,1012,-351
2019,5,7,2,1340,1361,1009,-352
2019,5,7,3,1355,1365,1002,-363
2019,5,7,4,1310,1376,1027,-349
2019,5,7,5,1280,1297,1021,-276
2019,5,7,6,1205,1230,1022,-208
2019,5,7,7,1155,1174,1064,-110
2019,5,7,8,1140,1131,1125,-6
2019,5,7,9,1130,1127,1190,63
2019,5,7,10,1130,1137,1386,249
2019,5,7,11,1145,1186,1628,442
2019,5,7,12,1190,1233,1809,576
2019,5,7,13,1300,1331,1915,584
2019,5,7,14,1380,1418,1944,526
2019,5,7,15,1395,1428,2042,614
2019,5,7,16,1395,1441,2090,649
2019,5,7,17,1400,1431,2076,645
2019,5,7,18,1395,1412,2066,654
2019,5,7,19,1380,1399,2080,681
2019,5,7,20,1370,1385,2084,699
2019,5,7,21,1355,1386,2135,749
2019,5,7,22,1350,1380,2153,773
2019,5,7,23,1360,1377,2097,720
2019,5,8,0,1350,1385,2060,675
2019,5,8,1,1350,1375,2074,699
2019,5,8,2,1355,1385,2098,713
2019,5,8,3,1375,1391,2120,729
2019,5,8,4,1340,1394,2115,721
2019,5,8,5,1280,1301,1936,635
2019,5,8,6,1210,1213,1829,616
2019,5,8,7,1145,1183,1803,620
2019,5,8,8,1135,1160,1881,721
2019,5,8,9,1130,1171,1966,795
2019,5,8,10,1135,1157,1947,790
2019,5,8,11,1150,1188,1943,755
2019,5,8,12,1210,1244,1984,740
2019,5,8,13,1335,1338,2079,741
2019,5,8,14,1420,1411,2023,612
2019,5,8,15,1410,1406,2051,645
2019,5,8,16,1410,1419,2028,609
2019,5,8,17,1410,1388,2047,659
2019,5,8,18,1385,1423,2174,751
2019,5,8,19,1370,1394,2238,844
2019,5,8,20,1370,1384,2255,871
2019,5,8,21,1355,1405,2229,824
2019,5,8,22,1350,1393,2168,775
2019,5,8,23,1350,1403,2168,765
2019,5,9,0,1335,1406,2167,761
2019,5,9,1,1340,1391,2140,749
2019,5,9,2,1340,1388,2140,752
2019,5,9,3,1365,1396,2126,730
2019,5,9,4,1320,1420,2143,723
2019,5,9,5,1280,1338,2130,792
2019,5,9,6,1215,1251,2088,837
2019,5,9,7,1170,1225,2028,803
2019,5,9,8,1145,1201,1913,712
2019,5,9,9,1145,1204,1932,728
2019,5,9,10,1155,1202,1917,715
2019,5,9,11,1180,1226,1937,711
2019,5,9,12,1235,1273,1972,699
2019,5,9,13,1330,1376,2019,643
2019,5,9,14,1400,1447,2106,659
2019,5,9,15,1405,1424,2076,652
2019,5,9,16,1395,1420,2034,614
2019,5,9,17,1390,1387,1984,597
2019,5,9,18,1380,1365,1957,592
2019,5,9,19,1365,1346,1962,616
2019,5,9,20,1365,1331,1964,633
2019,5,9,21,1345,1366,2038,672
2019,5,9,22,1340,1373,2047,674
2019,5,9,23,1330,1371,2058,687
2019,5,10,0,1315,1334,2058,724
2019,5,10,1,1310,1332,2011,679
2019,5,10,2,1320,1323,2001,678
2019,5,10,3,1340,1347,1984,637
2019,5,10,4,1320,1348,2052,704
2019,5,10,5,1280,1291,2015,724
2019,5,10,6,1215,1230,2004,774
2019,5,10,7,1165,1170,1955,785
2019,5,10,8,1150,1171,1924,753
2019,5,10,9,1155,1158,1936,778
2019,5,10,10,1160,1180,1955,775
2019,5,10,11,1180,1203,2004,801
2019,5,10,12,1230,1283,2210,927
2019,5,10,13,1325,1379,2347,968
2019,5,10,14,1395,1440,2257,817
2019,5,10,15,1400,1468,2324,856
2019,5,10,16,1395,1422,2199,777
2019,5,10,17,1380,1426,2214,788
2019,5,10,18,1365,1408,2265,857
2019,5,10,19,1345,1398,2249,851
2019,5,10,20,1340,1412,2343,931
2019,5,10,21,1325,1403,2321,918
2019,5,10,22,1320,1378,2327,949
2019,5,10,23,1310,1377,2323,946
2019,5,11,0,1300,1338,2271,933
2019,5,11,1,1285,1342,2283,941
2019,5,11,2,1275,1325,2265,940
2019,5,11,3,1295,1343,2375,1032
2019,5,11,4,1270,1360,2410,1050
2019,5,11,5,1265,1282,2286,1004
2019,5,11,6,1195,1234,2195,961
2019,5,11,7,1110,1174,2157,983
2019,5,11,8,1095,1166,2132,966
2019,5,11,9,1080,1158,2069,911
2019,5,11,10,1080,1136,2012,876
2019,5,11,11,1095,1152,2014,862
2019,5,11,12,1120,1172,2091,919
2019,5,11,13,1190,1225,2115,890
2019,5,11,14,1275,1256,1900,644
2019,5,11,15,1300,1279,1841,562
2019,5,11,16,1305,1295,1774,479
2019,5,11,17,1310,1282,1801,519
2019,5,11,18,1290,1283,1830,547
2019,5,11,19,1280,1269,1828,559
2019,5,11,20,1265,1261,1837,576
2019,5,11,21,1275,1255,1820,565
2019,5,11,22,1270,1255,1850,595
2019,5,11,23,1270,1279,1978,699
2019,5,12,0,1275,1278,1988,710
2019,5,12,1,1285,1282,1961,679
2019,5,12,2,1265,1271,2013,742
2019,5,12,3,1300,1287,2138,851
2019,5,12,4,1275,1284,2000,716
2019,5,12,5,1250,1246,1846,600
2019,5,12,6,1185,1180,1823,643
2019,5,12,7,1085,1120,1741,621
2019,5,12,8,1065,1092,1489,397
2019,5,12,9,1060,1082,1410,328
2019,5,12,10,1060,1087,1433,346
2019,5,12,11,1060,1095,1440,345
2019,5,12,12,1080,1109,1352,243
2019,5,12,13,1125,1126,1380,254
2019,5,12,14,1180,1173,1376,203
2019,5,12,15,1220,1230,1381,151
2019,5,12,16,1250,1244,1416,172
2019,5,12,17,1255,1259,1397,138
2019,5,12,18,1270,1251,1501,250
2019,5,12,19,1265,1255,1498,243
2019,5,12,20,1260,1242,1379,137
2019,5,12,21,1250,1246,1325,79
2019,5,12,22,1255,1260,1343,83
2019,5,12,23,1255,1274,1351,77
2019,5,13,0,1250,1295,1361,66
2019,5,13,1,1245,1315,1593,278
2019,5,13,2,1250,1311,1664,353
2019,5,13,3,1265,1326,1763,437
2019,5,13,4,1180,1341,1931,590
2019,5,13,5,1195,1304,1951,647
2019,5,13,6,1135,1219,1816,597
2019,5,13,7,1080,1157,1647,490
2019,5,13,8,1065,1142,1514,372
2019,5,13,9,1060,1117,1356,239
2019,5,13,10,1065,1121,1372,251
2019,5,13,11,1085,1099,1298,199
2019,5,13,12,1140,1141,1416,275
2019,5,13,13,1230,1228,1715,487
2019,5,13,14,1295,1323,1925,602
2019,5,13,15,1300,1381,2223,842
2019,5,13,16,1295,1370,2203,833
2019,5,13,17,1290,1373,1967,594
2019,5,13,18,1265,1361,1882,521
2019,5,13,19,1260,1388,1902,514
2019,5,13,20,1255,1366,1885,519
2019,5,13,21,1255,1396,1927,531
2019,5,13,22,1250,1402,1854,452
2019,5,13,23,1245,1412,1995,583
2019,5,14,0,1230,1399,1986,587
2019,5,14,1,1235,1403,2029,626
2019,5,14,2,1235,1402,2050,648
2019,5,14,3,1245,1369,1969,600
2019,5,14,4,1220,1368,1894,526
2019,5,14,5,1180,1286,2030,744
2019,5,14,6,1115,1191,1868,677
2019,5,14,7,1150,1141,1620,479
2019,5,14,8,1115,1107,1399,292
2019,5,14,9,1110,1101,1353,252
2019,5,14,10,1120,1094,1343,249
2019,5,14,11,1150,1105,1341,236
2019,5,14,12,1185,1147,1351,204
2019,5,14,13,1245,1244,1695,451
2019,5,14,14,1295,1351,1942,591
2019,5,14,15,1315,1381,2155,774
2019,5,14,16,1320,1399,2111,712
2019,5,14,17,1315,1409,2078,669
2019,5,14,18,1305,1432,2113,681
2019,5,14,19,1290,1438,2171,733
2019,5,14,20,1285,1424,2153,729
2019,5,14,21,1280,1449,2090,641
2019,5,14,22,1275,1446,2082,636
2019,5,14,23,1285,1450,2068,618
2019,5,15,0,1285,1439,2051,612
2019,5,15,1,1290,1441,1967,526
2019,5,15,2,1290,1423,1997,574
2019,5,15,3,1305,1432,2060,628
2019,5,15,4,1295,1406,2059,653
2019,5,15,5,1230,1319,1923,604
2019,5,15,6,1155,1231,1885,654
2019,5,15,7,1120,1194,1849,655
2019,5,15,8,1105,1170,1781,611
2019,5,15,9,1105,1130,1773,643
2019,5,15,10,1105,1146,1892,746
2019,5,15,11,1120,1152,1900,748
2019,5,15,12,1170,1202,1919,717
2019,5,15,13,1285,1280,2091,811
2019,5,15,14,1375,1349,2196,847
2019,5,15,15,1375,1381,2281,900
2019,5,15,16,1380,1390,2262,872
2019,5,15,17,1365,1418,2306,888
2019,5,15,18,1370,1431,2327,896
2019,5,15,19,1355,1422,2317,895
2019,5,15,20,1355,1442,2293,851
2019,5,15,21,1355,1430,2250,820
2019,5,15,22,1355,1452,2279,827
2019,5,15,23,1360,1459,2313,854
2019,5,16,0,1355,1412,2234,822
2019,5,16,1,1355,1416,2242,826
2019,5,16,2,1345,1405,2253,848
2019,5,16,3,1360,1403,2208,805
2019,5,16,4,1335,1385,2223,838
2019,5,16,5,1285,1315,2195,880
2019,5,16,6,1205,1232,2172,940
2019,5,16,7,1145,1180,2072,892
2019,5,16,8,1125,1139,1901,762
2019,5,16,9,1120,1114,1786,672
2019,5,16,10,1120,1129,1804,675
2019,5,16,11,1135,1124,1889,765
2019,5,16,12,1185,1190,1936,746
2019,5,16,13,1300,1276,2125,849
2019,5,16,14,1405,1354,2080,726
2019,5,16,15,1420,1350,1929,579
2019,5,16,16,1415,1343,1477,134
2019,5,16,17,1415,1373,1256,-117
2019,5,16,18,1415,1376,1113,-263
2019,5,16,19,1410,1381,1098,-283
2019,5,16,20,1400,1360,1107,-253
2019,5,16,21,1420,1371,1132,-239
2019,5,16,22,1420,1368,1119,-249
2019,5,16,23,1420,1362,1106,-256
2019,5,17,0,1400,1372,1130,-242
2019,5,17,1,1395,1351,1082,-269
2019,5,17,2,1390,1349,1096,-253
2019,5,17,3,1400,1357,1116,-241
2019,5,17,4,1360,1341,1127,-214
2019,5,17,5,1315,1263,1125,-138
2019,5,17,6,1245,1195,1123,-72
2019,5,17,7,1150,1146,1072,-74
2019,5,17,8,1135,1122,1065,-57
2019,5,17,9,1125,1111,1048,-63
2019,5,17,10,1135,1103,1032,-71
2019,5,17,11,1160,1112,1017,-95
2019,5,17,12,1220,1171,1021,-150
2019,5,17,13,1280,1261,1043,-218
2019,5,17,14,1340,1344,1040,-304
2019,5,17,15,1370,1379,1040,-339
2019,5,17,16,1410,1394,1064,-330
2019,5,17,17,1410,1408,1055,-353
2019,5,17,18,1400,1404,1071,-333
2019,5,17,19,1395,1395,1099,-296
2019,5,17,20,1395,1378,1092,-286
2019,5,17,21,1390,1382,1100,-282
2019,5,17,22,1385,1370,1095,-275
2019,5,17,23,1375,1363,1108,-255
2019,5,18,0,1345,1362,1121,-241
2019,5,18,1,1335,1347,1113,-234
2019,5,18,2,1330,1334,1109,-225
2019,5,18,3,1335,1339,1086,-253
2019,5,18,4,1300,1345,1064,-281
2019,5,18,5,1280,1291,1045,-246
2019,5,18,6,1215,1231,1069,-162
2019,5,18,7,1165,1187,1058,-129
2019,5,18,8,1140,1170,1058,-112
2019,5,18,9,1125,1165,1073,-92
2019,5,18,10,1125,1179,1052,-127
2019,5,18,11,1130,1189,1035,-154
2019,5,18,12,1170,1231,1039,-192
2019,5,18,13,1240,1251,1051,-200
2019,5,18,14,1310,1307,1051,-256
2019,5,18,15,1330,1353,1079,-274
2019,5,18,16,1340,1381,1082,-299
2019,5,18,17,1350,1373,1077,-296
2019,5,18,18,1350,1358,1116,-242
2019,5,18,19,1340,1340,1112,-228
2019,5,18,20,1325,1314,1123,-191
2019,5,18,21,1330,1307,1100,-207
2019,5,18,22,1325,1288,1156,-132
2019,5,18,23,1330,1307,1190,-117
2019,5,19,0,1335,1309,1175,-134
2019,5,19,1,1330,1304,1116,-188
2019,5,19,2,1330,1317,1129,-188
2019,5,19,3,1335,1332,1128,-204
2019,5,19,4,1310,1334,1125,-209
2019,5,19,5,1270,1292,1140,-152
2019,5,19,6,1200,1224,1135,-89
2019,5,19,7,1180,1202,1079,-123
2019,5,19,8,1150,1169,1043,-126
2019,5,19,9,1140,1164,1041,-123
2019,5,19,10,1140,1155,1027,-128
2019,5,19,11,1145,1160,1032,-128
2019,5,19,12,1175,1171,1027,-144
2019,5,19,13,1210,1193,999,-194
2019,5,19,14,1255,1241,1003,-238
2019,5,19,15,1285,1291,1014,-277
2019,5,19,16,1305,1321,1049,-272
2019,5,19,17,1320,1333,1062,-271
2019,5,19,18,1325,1342,1105,-237
2019,5,19,19,1330,1344,1120,-224
2019,5,19,20,1315,1329,1170,-159
2019,5,19,21,1325,1334,1174,-160
2019,5,19,22,1325,1322,1178,-144
2019,5,19,23,1330,1343,1129,-214
2019,5,20,0,1340,1356,1122,-234
2019,5,20,1,1340,1364,1113,-251
2019,5,20,2,1340,1360,1105,-255
2019,5,20,3,1345,1356,1107,-249
2019,5,20,4,1255,1362,1101,-261
2019,5,20,5,1275,1297,1084,-213
2019,5,20,6,1195,1231,1103,-128
2019,5,20,7,1190,1195,1113,-82
2019,5,20,8,1165,1182,1112,-70
2019,5,20,9,1145,1168,1105,-63
2019,5,20,10,1150,1163,1085,-78
2019,5,20,11,1145,1197,1095,-102
2019,5,20,12,1195,1242,1093,-149
2019,5,20,13,1295,1335,1083,-252
2019,5,20,14,1385,1416,1055,-361
2019,5,20,15,1410,1426,1010,-416
2019,5,20,16,1410,1454,1026,-428
2019,5,20,17,1420,1444,1025,-419
2019,5,20,18,1420,1441,1070,-371
2019,5,20,19,1430,1420,1081,-339
2019,5,20,20,1415,1426,1100,-326
2019,5,20,21,1430,1413,1103,-310
2019,5,20,22,1430,1404,1100,-304
2019,5,20,23,1435,1415,1127,-288
2019,5,21,0,1425,1408,1101,-307
2019,5,21,1,1425,1408,1076,-332
2019,5,21,2,1415,1400,1122,-278
2019,5,21,3,1405,1367,1250,-117
2019,5,21,4,1385,1351,1289,-62
2019,5,21,5,1315,1273,1279,6
2019,5,21,6,1230,1197,1224,27
2019,5,21,7,1190,1142,1086,-56
2019,5,21,8,1160,1114,1010,-104
2019,5,21,9,1155,1134,1032,-102
2019,5,21,10,1150,1124,1025,-99
2019,5,21,11,1165,1153,1032,-121
2019,5,21,12,1220,1189,1038,-151
2019,5,21,13,1300,1302,1224,-78
2019,5,21,14,1380,1362,1160,-202
2019,5,21,15,1385,1363,1152,-211
2019,5,21,16,1385,1372,1224,-148
2019,5,21,17,1395,1364,1244,-120
2019,5,21,18,1405,1353,1230,-123
2019,5,21,19,1405,1330,1230,-100
2019,5,21,20,1400,1352,1206,-146
2019,5,21,21,1410,1340,1287,-53
2019,5,21,22,1405,1345,1251,-94
2019,5,21,23,1415,1355,1390,35
2019,5,22,0,1415,1356,1481,125
2019,5,22,1,1415,1346,1507,161
2019,5,22,2,1405,1343,1553,210
2019,5,22,3,1410,1343,1602,259
2019,5,22,4,1330,1341,1519,178
2019,5,22,5,1315,1275,1447,172
2019,5,22,6,1235,1201,1414,213
2019,5,22,7,1170,1167,1341,174
2019,5,22,8,1155,1144,1398,254
2019,5,22,9,1135,1141,1404,263
2019,5,22,10,1135,1140,1379,239
2019,5,22,11,1155,1151,1398,247
2019,5,22,12,1205,1193,1540,347
2019,5,22,13,1285,1300,1566,266
2019,5,22,14,1355,1372,1606,234
2019,5,22,15,1365,1370,1673,303
2019,5,22,16,1385,1358,1668,310
2019,5,22,17,1385,1360,1707,347
2019,5,22,18,1395,1343,1684,341
2019,5,22,19,1380,1290,1635,345
2019,5,22,20,1390,1323,1666,343
2019,5,22,21,1385,1299,1635,336
2019,5,22,22,1385,1317,1625,308
2019,5,22,23,1390,1324,1605,281
2019,5,23,0,1375,1300,1586,286
2019,5,23,1,1370,1306,1580,274
2019,5,23,2,1365,1289,1549,260
2019,5,23,3,1350,1282,1533,251
2019,5,23,4,1320,1268,1521,253
2019,5,23,5,1265,1215,1505,290
2019,5,23,6,1190,1166,1499,333
2019,5,23,7,1160,1112,1487,375
2019,5,23,8,1130,1106,1488,382
2019,5,23,9,1125,1091,1474,383
2019,5,23,10,1130,1101,1483,382
2019,5,23,11,1140,1113,1479,366
2019,5,23,12,1195,1161,1485,324
2019,5,23,13,1295,1256,1480,224
2019,5,23,14,1365,1312,1455,143
2019,5,23,15,1365,1327,1452,125
2019,5,23,16,1365,1306,1460,154
2019,5,23,17,1375,1307,1525,218
2019,5,23,18,1370,1310,1547,237
2019,5,23,19,1365,1297,1582,285
2019,5,23,20,1355,1307,1590,283
2019,5,23,21,1365,1296,1601,305
2019,5,23,22,1365,1297,1644,347
2019,5,23,23,1365,1289,1635,346
2019,5,24,0,1365,1286,1601,315
2019,5,24,1,1350,1264,1599,335
2019,5,24,2,1345,1272,1609,337
2019,5,24,3,1350,1287,1571,284
2019,5,24,4,1320,1268,1498,230
2019,5,24,5,1265,1223,1473,250
2019,5,24,6,1195,1149,1424,275
2019,5,24,7,1145,1108,1399,291
2019,5,24,8,1125,1090,1377,287
2019,5,24,9,1125,1098,1310,212
2019,5,24,10,1120,1100,1228,128
2019,5,24,11,1135,1112,1156,44
2019,5,24,12,1185,1148,1082,-66
2019,5,24,13,1275,1214,1156,-58
2019,5,24,14,1350,1299,1121,-178
2019,5,24,15,1355,1304,1222,-82
2019,5,24,16,1350,1303,1107,-196
2019,5,24,17,1355,1309,1115,-194
2019,5,24,18,1340,1284,1117,-167
2019,5,24,19,1310,1268,1103,-165
2019,5,24,20,1320,1258,1088,-170
2019,5,24,21,1310,1256,1047,-209
2019,5,24,22,1315,1253,1004,-249
2019,5,24,23,1310,1257,1000,-257
2019,5,25,0,1295,1243,1001,-242
2019,5,25,1,1295,1234,995,-239
2019,5,25,2,1280,1216,1042,-174
2019,5,25,3,1280,1215,1150,-65
2019,5,25,4,1270,1235,1164,-71
2019,5,25,5,1225,1194,1166,-28
2019,5,25,6,1165,1135,1166,31
2019,5,25,7,1105,1096,1040,-56
2019,5,25,8,1085,1076,983,-93
2019,5,25,9,1080,1066,987,-79
2019,5,25,10,1085,1078,981,-97
2019,5,25,11,1090,1087,976,-111
2019,5,25,12,1125,1093,992,-101
2019,5,25,13,1175,1114,986,-128
2019,5,25,14,1230,1167,1012,-155
2019,5,25,15,1265,1210,1012,-198
2019,5,25,16,1280,1222,1009,-213
2019,5,25,17,1280,1237,995,-242
2019,5,25,18,1275,1222,994,-228
2019,5,25,19,1260,1214,1025,-189
2019,5,25,20,1250,1205,1137,-68
2019,5,25,21,1240,1206,1190,-16
2019,5,25,22,1230,1205,1223,18
2019,5,25,23,1240,1212,1224,12
2019,5,26,0,1240,1222,1164,-58
2019,5,26,1,1235,1233,1212,-21
2019,5,26,2,1240,1224,1207,-17
2019,5,26,3,1255,1224,1343,119
2019,5,26,4,1230,1235,1436,201
2019,5,26,5,1205,1193,1436,243
2019,5,26,6,1140,1140,1345,205
2019,5,26,7,1120,1090,1242,152
2019,5,26,8,1095,1069,1199,130
2019,5,26,9,1090,1063,1205,142
2019,5,26,10,1085,1064,1218,154
2019,5,26,11,1095,1067,1208,141
2019,5,26,12,1115,1073,1217,144
2019,5,26,13,1150,1100,1216,116
2019,5,26,14,1200,1143,1176,33
2019,5,26,15,1240,1199,1219,20
2019,5,26,16,1255,1215,1224,9
2019,5,26,17,1265,1218,1236,18
2019,5,26,18,1270,1225,1247,22
2019,5,26,19,1270,1232,1229,-3
2019,5,26,20,1260,1221,1179,-42
2019,5,26,21,1260,1220,1147,-73
2019,5,26,22,1255,1216,1166,-50
2019,5,26,23,1270,1230,1169,-61
2019,5,27,0,1280,1231,1097,-134
2019,5,27,1,1280,1226,1185,-41
2019,5,27,2,1280,1237,1195,-42
2019,5,27,3,1285,1221,1185,-36
2019,5,27,4,1200,1217,1360,143
2019,5,27,5,1230,1178,1443,265
2019,5,27,6,1160,1114,1362,248
2019,5,27,7,1135,1078,1363,285
2019,5,27,8,1110,1044,1304,260
2019,5,27,9,1105,1046,1257,211
2019,5,27,10,1100,1036,1158,122
2019,5,27,11,1105,1038,1154,116
2019,5,27,12,1130,1059,1172,113
2019,5,27,13,1175,1076,1185,109
2019,5,27,14,1225,1128,1039,-89
2019,5,27,15,1265,1198,1059,-139
2019,5,27,16,1275,1234,1195,-39
2019,5,27,17,1285,1261,1234,-27
2019,5,27,18,1290,1269,1229,-40
2019,5,27,19,1295,1265,1208,-57
2019,5,27,20,1285,1253,1174,-79
2019,5,27,21,1285,1247,1095,-152
2019,5,27,22,1280,1255,1099,-156
2019,5,27,23,1295,1265,1094,-171
2019,5,28,0,1300,1289,1105,-184
2019,5,28,1,1300,1296,1179,-117
2019,5,28,2,1295,1287,1351,64
2019,5,28,3,1295,1306,1422,116
2019,5,28,4,1225,1298,1441,143
2019,5,28,5,1235,1233,1391,158
2019,5,28,6,1160,1151,1285,134
2019,5,28,7,1130,1124,1245,121
2019,5,28,8,1105,1091,1114,23
2019,5,28,9,1110,1093,1030,-63
2019,5,28,10,1110,1098,1021,-77
2019,5,28,11,1130,1120,1023,-97
2019,5,28,12,1170,1162,1157,-5
2019,5,28,13,1265,1258,1280,22
2019,5,28,14,1320,1356,1365,9
2019,5,28,15,1330,1364,1350,-14
2019,5,28,16,1330,1378,1336,-42
2019,5,28,17,1330,1363,1335,-28
2019,5,28,18,1325,1359,1426,67
2019,5,28,19,1310,1331,1418,87
2019,5,28,20,1320,1353,1540,187
2019,5,28,21,1315,1342,1538,196
2019,5,28,22,1320,1336,1549,213
2019,5,28,23,1320,1332,1612,280
2019,5,29,0,1320,1328,1500,172
2019,5,29,1,1310,1309,1442,133
2019,5,29,2,1305,1311,1526,215
2019,5,29,3,1310,1302,1586,284
2019,5,29,4,1290,1315,1578,263
2019,5,29,5,1235,1239,1544,305
2019,5,29,6,1160,1176,1482,306
2019,5,29,7,1120,1117,1396,279
2019,5,29,8,1090,1109,1323,214
2019,5,29,9,1090,1105,1191,86
2019,5,29,10,1085,1119,1188,69
2019,5,29,11,1095,1121,1175,54
2019,5,29,12,1135,1171,1149,-22
2019,5,29,13,1235,1262,1169,-93
2019,5,29,14,1325,1333,1172,-161
2019,5,29,15,1335,1343,1218,-125
2019,5,29,16,1340,1347,1313,-34
2019,5,29,17,1350,1351,1331,-20
2019,5,29,18,1340,1343,1392,49
2019,5,29,19,1310,1338,1351,13
2019,5,29,20,1325,1340,1356,16
2019,5,29,21,1315,1363,1530,167
2019,5,29,22,1325,1366,1556,190
2019,5,29,23,1335,1385,1721,336
2019,5,30,0,1320,1376,1856,480
2019,5,30,1,1325,1354,1791,437
2019,5,30,2,1310,1348,1760,412
2019,5,30,3,1305,1325,1764,439
2019,5,30,4,1280,1330,1758,428
2019,5,30,5,1240,1268,1707,439
2019,5,30,6,1175,1158,1571,413
2019,5,30,7,1155,1131,1525,394
2019,5,30,8,1135,1092,1434,342
2019,5,30,9,1115,1098,1395,297
2019,5,30,10,1120,1084,1365,281
2019,5,30,11,1135,1110,1438,328
2019,5,30,12,1185,1150,1476,326
2019,5,30,13,1275,1245,1633,388
2019,5,30,14,1360,1326,1634,308
2019,5,30,15,1370,1343,1645,302
2019,5,30,16,1380,1359,1608,249
2019,5,30,17,1385,1375,1636,261
2019,5,30,18,1395,1376,1571,195
2019,5,30,19,1385,1374,1614,240
2019,5,30,20,1400,1378,1637,259
2019,5,30,21,1395,1400,1756,356
2019,5,30,22,1395,1394,1756,362
2019,5,30,23,1400,1409,1812,403
2019,5,31,0,1375,1398,1891,493
2019,5,31,1,1365,1387,1842,455
2019,5,31,2,1365,1388,1853,465
2019,5,31,3,1360,1374,1918,544
2019,5,31,4,1320,1392,1956,564
2019,5,31,5,1285,1362,1930,568
2019,5,31,6,1210,1214,1706,492
2019,5,31,7,1105,1142,1647,505
2019,5,31,8,1090,1112,1539,427
2019,5,31,9,1090,1103,1534,431
2019,5,31,10,1095,1097,1612,515
2019,5,31,11,1105,1110,1574,464
2019,5,31,12,1150,1141,1626,485
2019,5,31,13,1250,1223,1604,381
2019,5,31,14,1345,1317,1695,378
2019,5,31,15,1365,1336,1766,430
2019,5,31,16,1365,1355,1624,269
2019,5,31,17,1375,1349,1553,204
2019,5,31,18,1355,1354,1517,163
2019,5,31,19,1345,1347,1529,182
2019,5,31,20,1335,1370,1749,379
2019,5,31,21,1335,1384,1853,469
2019,5,31,22,1335,1376,1887,511
2019,5,31,23,1340,1388,1899,511
2019,6,1,0,1330,1370,1872,502
2019,6,1,1,1315,1351,1942,591
2019,6,1,2,1300,1322,2016,694
2019,6,1,3,1300,1316,1973,657
2019,6,1,4,1280,1322,1974,652
2019,6,1,5,1265,1253,1683,430
2019,6,1,6,1190,1217,1812,595
2019,6,1,7,1100,1144,1636,492
2019,6,1,8,1080,1127,1426,299
2019,6,1,9,1075,1102,1396,294
2019,6,1,10,1070,1105,1405,300
2019,6,1,11,1080,1093,1393,300
2019,6,1,12,1100,1125,1408,283
2019,6,1,13,1170,1141,1402,261
2019,6,1,14,1245,1206,1446,240
2019,6,1,15,1280,1254,1478,224
2019,6,1,16,1290,1278,1390,112
2019,6,1,17,1290,1310,1387,77
2019,6,1,18,1280,1302,1382,80
2019,6,1,19,1275,1313,1372,59
2019,6,1,20,1260,1314,1364,50
2019,6,1,21,1265,1336,1390,54
2019,6,1,22,1260,1354,1372,18
2019,6,1,23,1275,1367,1365,-2
2019,6,2,0,1285,1382,1459,77
2019,6,2,1,1280,1382,1460,78
2019,6,2,2,1280,1364,1472,108
2019,6,2,3,1280,1356,1458,102
2019,6,2,4,1245,1339,1450,111
2019,6,2,5,1250,1305,1570,265
2019,6,2,6,1180,1223,1583,360
2019,6,2,7,1100,1179,1492,313
2019,6,2,8,1070,1145,1507,362
2019,6,2,9,1065,1125,1510,385
2019,6,2,10,1060,1117,1532,415
2019,6,2,11,1070,1105,1551,446
2019,6,2,12,1080,1103,1550,447
2019,6,2,13,1130,1112,1517,405
2019,6,2,14,1205,1165,1237,72
2019,6,2,15,1260,1219,1219,0
2019,6,2,16,1280,1272,1451,179
2019,6,2,17,1290,1304,1439,135
2019,6,2,18,1300,1330,1368,38
2019,6,2,19,1305,1357,1370,13
2019,6,2,20,1290,1377,1458,81
2019,6,2,21,1295,1401,1451,50
2019,6,2,22,1285,1428,1543,115
2019,6,2,23,1305,1444,1560,116
2019,6,3,0,1310,1473,1494,21
2019,6,3,1,1315,1458,1534,76
2019,6,3,2,1315,1479,1744,265
2019,6,3,3,1310,1442,1744,302
2019,6,3,4,1205,1436,1663,227
2019,6,3,5,1255,1346,1641,295
2019,6,3,6,1185,1245,1571,326
2019,6,3,7,1140,1197,1568,371
2019,6,3,8,1115,1152,1311,159
2019,6,3,9,1105,1128,1262,134
2019,6,3,10,1105,1119,1271,152
2019,6,3,11,1095,1133,1318,185
2019,6,3,12,1130,1170,1367,197
2019,6,3,13,1215,1236,1340,104
2019,6,3,14,1305,1354,1384,30
2019,6,3,15,1360,1413,1657,244
2019,6,3,16,1370,1442,1665,223
2019,6,3,17,1380,1485,1744,259
2019,6,3,18,1380,1508,1705,197
2019,6,3,19,1390,1532,1614,82
2019,6,3,20,1380,1533,1578,45
2019,6,3,21,1395,1571,1807,236
2019,6,3,22,1400,1573,1810,237
2019,6,3,23,1415,1594,1830,236
2019,6,4,0,1405,1568,1955,387
2019,6,4,1,1415,1553,2030,477
2019,6,4,2,1405,1540,2023,483
2019,6,4,3,1395,1478,1971,493
2019,6,4,4,1305,1453,1882,429
2019,6,4,5,1315,1367,1777,410
2019,6,4,6,1215,1275,1721,446
2019,6,4,7,1135,1211,1520,309
2019,6,4,8,1105,1176,1380,204
2019,6,4,9,1115,1159,1381,222
2019,6,4,10,1115,1123,1243,120
2019,6,4,11,1140,1144,1212,68
2019,6,4,12,1180,1176,1311,135
2019,6,4,13,1300,1262,1667,405
2019,6,4,14,1385,1347,1792,445
2019,6,4,15,1390,1394,1794,400
2019,6,4,16,1400,1396,1704,308
2019,6,4,17,1395,1433,1782,349
2019,6,4,18,1385,1446,1797,351
2019,6,4,19,1360,1472,1758,286
2019,6,4,20,1380,1489,1771,282
2019,6,4,21,1375,1506,1802,296
2019,6,4,22,1375,1549,1796,247
2019,6,4,23,1380,1547,1776,229
2019,6,5,0,1375,1559,1800,241
2019,6,5,1,1365,1553,1869,316
2019,6,5,2,1360,1528,1827,299
2019,6,5,3,1360,1512,1814,302
2019,6,5,4,1320,1468,1723,255
2019,6,5,5,1290,1403,1622,219
2019,6,5,6,1210,1289,1530,241
2019,6,5,7,1145,1233,1480,247
2019,6,5,8,1125,1199,1522,323
2019,6,5,9,1120,1174,1523,349
2019,6,5,10,1125,1153,1552,399
2019,6,5,11,1135,1105,1505,400
2019,6,5,12,1185,1182,1511,329
2019,6,5,13,1345,1264,1567,303
2019,6,5,14,1500,1350,1562,212
2019,6,5,15,1520,1382,1634,252
2019,6,5,16,1530,1395,1492,97
2019,6,5,17,1540,1444,1484,40
2019,6,5,18,1540,1451,1460,9
2019,6,5,19,1530,1473,1460,-13
2019,6,5,20,1545,1481,1489,8
2019,6,5,21,1560,1527,1798,271
2019,6,5,22,1570,1545,1952,407
2019,6,5,23,1585,1576,2052,476
2019,6,6,0,1565,1580,2015,435
2019,6,6,1,1550,1549,1953,404
2019,6,6,2,1535,1542,1700,158
2019,6,6,3,1510,1483,1722,239
2019,6,6,4,1480,1451,1620,169
2019,6,6,5,1425,1401,1692,291
2019,6,6,6,1320,1316,1671,355
2019,6,6,7,1180,1243,1573,330
2019,6,6,8,1155,1200,1510,310
2019,6,6,9,1135,1183,1518,335
2019,6,6,10,1115,1172,1493,321
2019,6,6,11,1135,1188,1486,298
2019,6,6,12,1175,1203,1483,280
2019,6,6,13,1315,1286,1484,198
2019,6,6,14,1435,1372,1523,151
2019,6,6,15,1465,1415,1570,155
2019,6,6,16,1475,1445,1685,240
2019,6,6,17,1500,1467,1731,264
2019,6,6,18,1510,1499,1828,329
2019,6,6,19,1520,1517,1845,328
2019,6,6,20,1535,1531,1762,231
2019,6,6,21,1555,1565,1753,188
2019,6,6,22,1575,1570,1730,160
2019,6,6,23,1580,1594,1802,208
2019,6,7,0,1580,1557,1800,243
2019,6,7,1,1565,1528,1742,214
2019,6,7,2,1555,1501,1656,155
2019,6,7,3,1545,1468,1751,283
2019,6,7,4,1480,1446,1647,201
2019,6,7,5,1460,1375,1478,103
2019,6,7,6,1340,1289,1610,321
2019,6,7,7,1165,1218,1341,123
2019,6,7,8,1150,1198,1310,112
2019,6,7,9,1145,1179,1314,135
2019,6,7,10,1150,1168,1240,72
2019,6,7,11,1160,1178,1261,83
2019,6,7,12,1200,1206,1448,242
2019,6,7,13,1280,1287,1855,568
2019,6,7,14,1375,1357,1976,619
2019,6,7,15,1390,1413,2117,704
2019,6,7,16,1395,1440,2085,645
2019,6,7,17,1400,1428,1981,553
2019,6,7,18,1380,1473,1992,519
2019,6,7,19,1370,1495,1793,298
2019,6,7,20,1370,1491,1769,278
2019,6,7,21,1365,1409,1799,390
2019,6,7,22,1365,1429,1835,406
2019,6,7,23,1370,1424,1814,390
2019,6,8,0,1360,1396,1804,408
2019,6,8,1,1340,1390,1862,472
2019,6,8,2,1320,1367,1829,462
2019,6,8,3,1315,1361,1668,307
2019,6,8,4,1300,1364,1686,322
2019,6,8,5,1285,1325,1782,457
2019,6,8,6,1225,1269,1967,698
2019,6,8,7,1155,1216,1639,423
2019,6,8,8,1130,1194,1425,231
2019,6,8,9,1120,1170,1295,125
2019,6,8,10,1125,1166,1361,195
2019,6,8,11,1125,1175,1368,193
2019,6,8,12,1155,1181,1354,173
2019,6,8,13,1190,1216,1428,212
2019,6,8,14,1250,1290,1459,169
2019,6,8,15,1300,1335,1600,265
2019,6,8,16,1330,1374,1675,301
2019,6,8,17,1340,1375,1654,279
2019,6,8,18,1335,1367,1668,301
2019,6,8,19,1325,1364,1704,340
2019,6,8,20,1315,1332,1639,307
2019,6,8,21,1315,1340,1797,457
2019,6,8,22,1310,1343,1831,488
2019,6,8,23,1330,1329,1828,499
2019,6,9,0,1330,1330,1844,514
2019,6,9,1,1325,1324,1951,627
2019,6,9,2,1320,1320,1992,672
2019,6,9,3,1330,1316,2028,712
2019,6,9,4,1300,1330,2005,675
2019,6,9,5,1280,1314,2045,731
2019,6,9,6,1205,1246,2050,804
2019,6,9,7,1160,1215,2012,797
2019,6,9,8,1125,1179,2054,875
2019,6,9,9,1115,1186,2096,910
2019,6,9,10,1105,1177,2066,889
2019,6,9,11,1105,1171,2089,918
2019,6,9,12,1105,1188,2021,833
2019,6,9,13,1090,1198,2027,829
2019,6,9,14,1105,1253,1996,743
2019,6,9,15,1155,1289,2037,748
2019,6,9,16,1195,1314,2017,703
2019,6,9,17,1210,1315,2032,717
2019,6,9,18,1235,1311,1800,489
2019,6,9,19,1250,1315,1798,483
2019,6,9,20,1265,1300,1830,530
2019,6,9,21,1275,1303,1906,603
2019,6,9,22,1290,1292,2006,714
2019,6,9,23,1310,1325,2048,723
2019,6,10,0,1320,1336,2168,832
2019,6,10,1,1310,1352,2171,819
2019,6,10,2,1320,1358,2181,823
2019,6,10,3,1295,1329,1912,583
2019,6,10,4,1250,1307,1466,159
2019,6,10,5,1215,1259,1409,150
2019,6,10,6,1135,1183,1392,209
2019,6,10,7,1145,1137,1377,240
2019,6,10,8,1120,1108,1288,180
2019,6,10,9,1090,1099,1285,186
2019,6,10,10,1090,1093,1288,195
2019,6,10,11,1105,1086,1294,208
2019,6,10,12,1135,1130,1317,187
2019,6,10,13,1180,1196,1386,190
2019,6,10,14,1245,1305,1402,97
2019,6,10,15,1280,1309,1367,58
2019,6,10,16,1305,1337,1384,47
2019,6,10,17,1330,1355,1395,40
2019,6,10,18,1350,1355,1428,73
2019,6,10,19,1365,1372,1513,141
2019,6,10,20,1375,1355,1542,187
2019,6,10,21,1390,1376,1566,190
2019,6,10,22,1400,1381,1523,142
2019,6,10,23,1410,1380,1522,142
2019,6,11,0,1380,1394,1536,142
2019,6,11,1,1370,1387,1527,140
2019,6,11,2,1350,1380,1507,127
2019,6,11,3,1325,1355,1548,193
2019,6,11,4,1280,1351,1511,160
2019,6,11,5,1235,1292,1500,208
2019,6,11,6,1150,1218,1483,265
2019,6,11,7,1160,1136,1406,270
2019,6,11,8,1135,1122,1469,347
2019,6,11,9,1125,1112,1454,342
2019,6,11,10,1110,1099,1420,321
2019,6,11,11,1120,1119,1453,334
2019,6,11,12,1160,1147,1455,308
2019,6,11,13,1225,1212,1451,239
2019,6,11,14,1295,1289,1396,107
2019,6,11,15,1330,1310,1366,56
2019,6,11,16,1340,1331,1431,100
2019,6,11,17,1360,1343,1462,119
2019,6,11,18,1375,1362,1511,149
2019,6,11,19,1385,1370,1498,128
2019,6,11,20,1385,1370,1489,119
2019,6,11,21,1405,1391,1480,89
2019,6,11,22,1420,1402,1471,69
2019,6,11,23,1420,1416,1496,80
2019,6,12,0,1420,1393,1505,112
2019,6,12,1,1410,1399,1515,116
2019,6,12,2,1400,1399,1482,83
2019,6,12,3,1395,1371,1445,74
2019,6,12,4,1375,1366,1411,45
2019,6,12,5,1285,1307,1413,106
2019,6,12,6,1200,1198,1399,201
2019,6,12,7,1190,1141,1368,227
2019,6,12,8,1160,1119,1291,172
2019,6,12,9,1145,1092,1359,267
2019,6,12,10,1130,1101,1349,248
2019,6,12,11,1105,1095,1344,249
2019,6,12,12,1165,1123,1369,246
2019,6,12,13,1290,1207,1400,193
2019,6,12,14,1410,1294,1323,29
2019,6,12,15,1435,1337,1397,60
2019,6,12,16,1455,1356,1403,47
2019,6,12,17,1480,1403,1427,24
2019,6,12,18,1495,1432,1460,28
2019,6,12,19,1505,1435,1444,9
2019,6,12,20,1510,1467,1439,-28
2019,6,12,21,1535,1489,1442,-47
2019,6,12,22,1560,1524,1455,-69
2019,6,12,23,1570,1537,1459,-78
2019,6,13,0,1575,1538,1446,-92
2019,6,13,1,1555,1532,1436,-96
2019,6,13,2,1545,1520,1439,-81
2019,6,13,3,1505,1473,1438,-35
2019,6,13,4,1470,1458,1456,-2
2019,6,13,5,1430,1372,1379,7
2019,6,13,6,1330,1268,1414,146
2019,6,13,7,1200,1216,1392,176
2019,6,13,8,1170,1174,1377,203
2019,6,13,9,1160,1149,1400,251
2019,6,13,10,1150,1131,1422,291
2019,6,13,11,1165,1137,1369,232
2019,6,13,12,1200,1155,1419,264
2019,6,13,13,1305,1226,1406,180
2019,6,13,14,1420,1313,1397,84
2019,6,13,15,1450,1357,1431,74
2019,6,13,16,1465,1411,1467,56
2019,6,13,17,1490,1434,1443,9
2019,6,13,18,1505,1467,1455,-12
2019,6,13,19,1515,1498,1456,-42
2019,6,13,20,1520,1525,1416,-109
2019,6,13,21,1545,1556,1400,-156
2019,6,13,22,1560,1571,1412,-159
2019,6,13,23,1570,1581,1455,-126
2019,6,14,0,1550,1534,1359,-175
2019,6,14,1,1540,1495,1388,-107
2019,6,14,2,1530,1465,1391,-74
2019,6,14,3,1505,1433,1425,-8
2019,6,14,4,1470,1422,1389,-33
2019,6,14,5,1440,1359,1377,18
2019,6,14,6,1310,1269,1425,156
2019,6,14,7,1185,1219,1349,130
2019,6,14,8,1165,1175,1254,79
2019,6,14,9,1140,1154,1263,109
2019,6,14,10,1140,1144,1294,150
2019,6,14,11,1140,1150,1297,147
2019,6,14,12,1175,1174,1311,137
2019,6,14,13,1270,1253,1289,36
2019,6,14,14,1375,1352,1328,-24
2019,6,14,15,1415,1417,1522,105
2019,6,14,16,1440,1448,1542,94
2019,6,14,17,1460,1470,1630,160
2019,6,14,18,1490,1501,1720,219
2019,6,14,19,1505,1493,1728,235
2019,6,14,20,1520,1534,1856,322
2019,6,14,21,1500,1545,2037,492
2019,6,14,22,1515,1556,2019,463
2019,6,14,23,1520,1544,2012,468
2019,6,15,0,1510,1531,2045,514
2019,6,15,1,1495,1518,2141,623
2019,6,15,2,1480,1473,2160,687
2019,6,15,3,1455,1444,2133,689
2019,6,15,4,1410,1423,2117,694
2019,6,15,5,1385,1388,1979,591
2019,6,15,6,1305,1302,1728,426
2019,6,15,7,1150,1229,1608,379
2019,6,15,8,1125,1206,1590,384
2019,6,15,9,1105,1173,1547,374
2019,6,15,10,1100,1153,1394,241
2019,6,15,11,1100,1151,1368,217
2019,6,15,12,1115,1147,1384,237
2019,6,15,13,1165,1181,1413,232
2019,6,15,14,1240,1231,1395,164
2019,6,15,15,1290,1299,1457,158
2019,6,15,16,1325,1343,1438,95
2019,6,15,17,1345,1360,1438,78
2019,6,15,18,1350,1367,1430,63
2019,6,15,19,1355,1376,1429,53
2019,6,15,20,1355,1403,1449,46
2019,6,15,21,1365,1413,1466,53
2019,6,15,22,1380,1428,1468,40
2019,6,15,23,1385,1449,1489,40
2019,6,16,0,1380,1446,1499,53
2019,6,16,1,1375,1445,1494,49
2019,6,16,2,1355,1421,1454,33
2019,6,16,3,1340,1389,1467,78
2019,6,16,4,1320,1399,1467,68
2019,6,16,5,1300,1358,1455,97
2019,6,16,6,1230,1272,1511,239
2019,6,16,7,1150,1221,1482,261
2019,6,16,8,1115,1174,1407,233
2019,6,16,9,1105,1164,1387,223
2019,6,16,10,1095,1153,1408,255
2019,6,16,11,1095,1145,1396,251
2019,6,16,12,1095,1144,1394,250
2019,6,16,13,1120,1184,1420,236
2019,6,16,14,1170,1215,1410,195
2019,6,16,15,1220,1289,1533,244
2019,6,16,16,1260,1319,1705,386
2019,6,16,17,1275,1360,1711,351
2019,6,16,18,1295,1382,1777,395
2019,6,16,19,1310,1410,1891,481
2019,6,16,20,1325,1432,2015,583
2019,6,16,21,1330,1442,2104,662
2019,6,16,22,1345,1482,2214,732
2019,6,16,23,1365,1498,2323,825
2019,6,17,0,1370,1486,2289,803
2019,6,17,1,1365,1499,2275,776
2019,6,17,2,1365,1472,2240,768
2019,6,17,3,1340,1477,2247,770
2019,6,17,4,1300,1448,2227,779
2019,6,17,5,1260,1407,2224,817
2019,6,17,6,1175,1312,2189,877
2019,6,17,7,1175,1262,2186,924
2019,6,17,8,1140,1223,2152,929
2019,6,17,9,1120,1205,2131,926
2019,6,17,10,1110,1206,2129,923
2019,6,17,11,1120,1212,2129,917
2019,6,17,12,1150,1244,2166,922
2019,6,17,13,1210,1316,2167,851
2019,6,17,14,1305,1423,2183,760
2019,6,17,15,1340,1465,2198,733
2019,6,17,16,1370,1500,2194,694
2019,6,17,17,1400,1544,2217,673
2019,6,17,18,1420,1549,2202,653
2019,6,17,19,1435,1585,2226,641
2019,6,17,20,1440,1611,2234,623
2019,6,17,21,1465,1600,2209,609
2019,6,17,22,1475,1632,2231,599
2019,6,17,23,1480,1609,2206,597
2019,6,18,0,1465,1602,2198,596
2019,6,18,1,1450,1593,2210,617
2019,6,18,2,1435,1535,2175,640
2019,6,18,3,1400,1528,2181,653
2019,6,18,4,1360,1491,2143,652
2019,6,18,5,1315,1449,2192,743
2019,6,18,6,1225,1351,2188,837
2019,6,18,7,1200,1282,2146,864
2019,6,18,8,1170,1256,2195,939
2019,6,18,9,1155,1224,2173,949
2019,6,18,10,1140,1225,2188,963
2019,6,18,11,1150,1230,2213,983
2019,6,18,12,1170,1256,2236,980
2019,6,18,13,1255,1333,2287,954
2019,6,18,14,1340,1428,2309,881
2019,6,18,15,1385,1462,2304,842
2019,6,18,16,1410,1499,2324,825
2019,6,18,17,1440,1490,2288,798
2019,6,18,18,1455,1534,2380,846
2019,6,18,19,1475,1537,2282,745
2019,6,18,20,1485,1543,2295,752
2019,6,18,21,1505,1567,2344,777
2019,6,18,22,1530,1582,2295,713
2019,6,18,23,1540,1571,2312,741
2019,6,19,0,1530,1561,2265,704
2019,6,19,1,1535,1523,2242,719
2019,6,19,2,1520,1534,2271,737
2019,6,19,3,1505,1506,2254,748
2019,6,19,4,1470,1482,2217,735
2019,6,19,5,1430,1431,2199,768
2019,6,19,6,1320,1345,2239,894
2019,6,19,7,1225,1283,2216,933
2019,6,19,8,1195,1238,2196,958
2019,6,19,9,1180,1229,2221,992
2019,6,19,10,1175,1205,2214,1009
2019,6,19,11,1170,1236,2282,1046
2019,6,19,12,1205,1249,2315,1066
2019,6,19,13,1265,1321,2307,986
2019,6,19,14,1335,1399,2297,898
2019,6,19,15,1380,1448,2287,839
2019,6,19,16,1405,1468,2321,853
2019,6,19,17,1445,1493,2365,872
2019,6,19,18,1470,1518,2406,888
2019,6,19,19,1480,1526,2373,847
2019,6,19,20,1510,1548,2339,791
2019,6,19,21,1525,1557,2368,811
2019,6,19,22,1555,1547,2330,783
2019,6,19,23,1560,1555,2382,827
2019,6,20,0,1555,1526,2298,772
2019,6,20,1,1545,1499,2316,817
2019,6,20,2,1520,1476,2337,861
2019,6,20,3,1485,1428,2316,888
2019,6,20,4,1430,1430,2296,866
2019,6,20,5,1390,1373,2281,908
2019,6,20,6,1295,1293,2249,956
2019,6,20,7,1240,1234,2193,959
2019,6,20,8,1205,1199,2130,931
2019,6,20,9,1180,1210,1968,758
2019,6,20,10,1170,1182,1940,758
2019,6,20,11,1185,1212,1949,737
2019,6,20,12,1200,1220,1945,725
2019,6,20,13,1245,1306,1995,689
2019,6,20,14,1305,1379,2040,661
2019,6,20,15,1345,1427,2172,745
2019,6,20,16,1375,1436,2143,707
2019,6,20,17,1395,1439,2141,702
2019,6,20,18,1420,1450,2064,614
2019,6,20,19,1435,1439,2061,622
2019,6,20,20,1455,1456,2101,645
2019,6,20,21,1470,1450,2133,683
2019,6,20,22,1490,1452,2147,695
2019,6,20,23,1490,1453,2147,694
2019,6,21,0,1465,1449,2116,667
2019,6,21,1,1430,1434,2090,656
2019,6,21,2,1420,1398,1980,582
2019,6,21,3,1400,1416,1971,555
2019,6,21,4,1370,1416,2064,648
2019,6,21,5,1330,1353,2070,717
2019,6,21,6,1235,1299,2016,717
2019,6,21,7,1210,1240,2031,791
2019,6,21,8,1185,1236,2171,935
2019,6,21,9,1165,1232,2160,928
2019,6,21,10,1155,1206,2081,875
2019,6,21,11,1160,1223,2143,920
2019,6,21,12,1190,1247,2147,900
2019,6,21,13,1250,1315,2184,869
2019,6,21,14,1325,1390,2242,852
2019,6,21,15,1375,1439,2237,798
2019,6,21,16,1400,1451,2232,781
2019,6,21,17,1415,1425,2126,701
2019,6,21,18,1440,1429,2029,600
2019,6,21,19,1465,1417,2144,727
2019,6,21,20,1470,1389,2143,754
2019,6,21,21,1430,1393,2217,824
2019,6,21,22,1440,1379,2081,702
2019,6,21,23,1430,1362,2107,745
2019,6,22,0,1415,1387,2297,910
2019,6,22,1,1395,1350,2167,817
2019,6,22,2,1375,1368,2199,831
2019,6,22,3,1350,1358,2199,841
2019,6,22,4,1325,1360,2210,850
2019,6,22,5,1305,1338,2195,857
2019,6,22,6,1235,1289,2200,911
2019,6,22,7,1210,1227,2181,954
2019,6,22,8,1185,1220,2271,1051
2019,6,22,9,1170,1201,2270,1069
2019,6,22,10,1160,1196,2276,1080
2019,6,22,11,1170,1203,2288,1085
2019,6,22,12,1175,1208,2289,1081
2019,6,22,13,1200,1253,2303,1050
2019,6,22,14,1250,1298,2167,869
2019,6,22,15,1300,1358,2130,772
2019,6,22,16,1335,1392,2147,755
2019,6,22,17,1345,1389,2112,723
2019,6,22,18,1350,1386,1944,558
2019,6,22,19,1345,1370,1894,524
2019,6,22,20,1345,1339,1879,540
2019,6,22,21,1345,1338,1923,585
2019,6,22,22,1345,1326,1886,560
2019,6,22,23,1350,1338,1935,597
2019,6,23,0,1345,1315,1835,520
2019,6,23,1,1340,1321,1895,574
2019,6,23,2,1325,1315,1846,531
2019,6,23,3,1315,1304,1798,494
2019,6,23,4,1300,1317,1697,380
2019,6,23,5,1290,1297,1743,446
2019,6,23,6,1230,1237,1734,497
2019,6,23,7,1200,1204,1733,529
2019,6,23,8,1170,1168,1770,602
2019,6,23,9,1160,1167,1802,635
2019,6,23,10,1155,1154,1741,587
2019,6,23,11,1155,1141,1559,418
2019,6,23,12,1165,1148,1570,422
2019,6,23,13,1200,1164,1547,383
2019,6,23,14,1250,1229,1579,350
2019,6,23,15,1295,1267,1688,421
2019,6,23,16,1320,1315,1827,512
2019,6,23,17,1330,1341,1882,541
2019,6,23,18,1340,1349,1881,532
2019,6,23,19,1350,1358,1866,508
2019,6,23,20,1350,1360,1862,502
2019,6,23,21,1350,1352,1871,519
2019,6,23,22,1350,1340,1974,634
2019,6,23,23,1365,1357,2006,649
2019,6,24,0,1375,1362,1944,582
2019,6,24,1,1380,1375,1915,540
2019,6,24,2,1370,1382,1978,596
2019,6,24,3,1365,1355,1924,569
2019,6,24,4,1310,1356,1876,520
2019,6,24,5,1295,1291,1866,575
2019,6,24,6,1225,1235,1859,624
2019,6,24,7,1215,1175,1762,587
2019,6,24,8,1185,1153,1766,613
2019,6,24,9,1180,1147,1725,578
2019,6,24,10,1170,1134,1731,597
2019,6,24,11,1180,1167,1742,575
2019,6,24,12,1210,1199,1800,601
2019,6,24,13,1255,1267,1848,581
2019,6,24,14,1330,1344,1890,546
2019,6,24,15,1355,1379,2053,674
2019,6,24,16,1380,1391,2143,752
2019,6,24,17,1400,1409,2209,800
2019,6,24,18,1410,1416,2205,789
2019,6,24,19,1420,1426,2308,882
2019,6,24,20,1420,1454,2362,908
2019,6,24,21,1430,1435,2260,825
2019,6,24,22,1440,1448,2332,884
2019,6,24,23,1435,1460,2346,886
2019,6,25,0,1440,1472,2389,917
2019,6,25,1,1425,1468,2303,835
2019,6,25,2,1405,1435,2247,812
2019,6,25,3,1390,1429,2225,796
2019,6,25,4,1330,1415,2128,713
2019,6,25,5,1325,1349,2103,754
2019,6,25,6,1245,1290,2178,888
2019,6,25,7,1200,1231,2181,950
2019,6,25,8,1165,1220,2136,916
2019,6,25,9,1150,1203,2076,873
2019,6,25,10,1140,1189,1993,804
2019,6,25,11,1150,1203,2003,800
2019,6,25,12,1165,1236,2114,878
2019,6,25,13,1255,1329,2227,898
2019,6,25,14,1370,1402,2153,751
2019,6,25,15,1410,1436,2199,763
2019,6,25,16,1440,1452,2191,739
2019,6,25,17,1455,1479,2202,723
2019,6,25,18,1480,1485,2234,749
2019,6,25,19,1480,1483,2208,725
2019,6,25,20,1495,1509,2224,715
2019,6,25,21,1495,1499,2273,774
2019,6,25,22,1510,1517,2225,708
2019,6,25,23,1510,1495,2259,764
2019,6,26,0,1500,1470,2341,871
2019,6,26,1,1490,1437,2332,895
2019,6,26,2,1490,1442,2293,851
2019,6,26,3,1475,1439,2331,892
2019,6,26,4,1430,1433,2358,925
2019,6,26,5,1400,1398,2369,971
2019,6,26,6,1310,1292,2382,1090
2019,6,26,7,1235,1251,2381,1130
2019,6,26,8,1205,1238,2432,1194
2019,6,26,9,1190,1200,2410,1210
2019,6,26,10,1180,1209,2432,1223
2019,6,26,11,1200,1182,2384,1202
2019,6,26,12,1225,1220,2437,1217
2019,6,26,13,1295,1291,2354,1063
2019,6,26,14,1375,1355,2346,991
2019,6,26,15,1415,1406,2365,959
2019,6,26,16,1430,1417,2346,929
2019,6,26,17,1465,1444,2358,914
2019,6,26,18,1475,1443,2364,921
2019,6,26,19,1495,1469,2387,918
2019,6,26,20,1510,1498,2401,903
2019,6,26,21,1520,1491,2410,919
2019,6,26,22,1525,1486,2443,957
2019,6,26,23,1530,1463,2443,980
2019,6,27,0,1520,1456,2452,996
2019,6,27,1,1495,1430,2402,972
2019,6,27,2,1475,1428,2356,928
2019,6,27,3,1440,1382,2320,938
2019,6,27,4,1400,1384,2258,874
2019,6,27,5,1375,1343,2317,974
2019,6,27,6,1285,1253,2216,963
2019,6,27,7,1245,1213,2194,981
2019,6,27,8,1210,1178,2255,1077
2019,6,27,9,1190,1184,2314,1130
2019,6,27,10,1180,1173,2308,1135
2019,6,27,11,1195,1169,2372,1203
2019,6,27,12,1215,1225,2403,1178
2019,6,27,13,1285,1280,2421,1141
2019,6,27,14,1370,1394,2485,1091
2019,6,27,15,1410,1423,2498,1075
2019,6,27,16,1440,1436,2483,1047
2019,6,27,17,1450,1471,2518,1047
2019,6,27,18,1475,1479,2453,974
2019,6,27,19,1485,1500,2499,999
2019,6,27,20,1505,1530,2507,977
2019,6,27,21,1510,1540,2507,967
2019,6,27,22,1530,1574,2520,946
2019,6,27,23,1520,1564,2510,946
2019,6,28,0,1495,1563,2548,985
2019,6,28,1,1470,1539,2569,1030
2019,6,28,2,1465,1544,2606,1062
2019,6,28,3,1450,1508,2589,1081
2019,6,28,4,1400,1499,2559,1060
2019,6,28,5,1385,1441,2532,1091
2019,6,28,6,1285,1315,2497,1182
2019,6,28,7,1190,1264,2515,1251
2019,6,28,8,1160,1203,2416,1213
2019,6,28,9,1145,1204,2421,1217
2019,6,28,10,1135,1182,2427,1245
2019,6,28,11,1135,1205,2434,1229
2019,6,28,12,1165,1220,2500,1280
2019,6,28,13,1245,1297,2521,1224
2019,6,28,14,1345,1388,2415,1027
2019,6,28,15,1400,1421,2447,1026
2019,6,28,16,1420,1456,2461,1005
2019,6,28,17,1435,1467,2464,997
2019,6,28,18,1445,1493,2502,1009
2019,6,28,19,1440,1489,2495,1006
2019,6,28,20,1460,1503,2495,992
2019,6,28,21,1460,1513,2498,985
2019,6,28,22,1465,1555,2537,982
2019,6,28,23,1450,1561,2534,973
2019,6,29,0,1445,1537,2523,986
2019,6,29,1,1425,1524,2615,1091
2019,6,29,2,1405,1496,2551,1055
2019,6,29,3,1375,1486,2649,1163
2019,6,29,4,1345,1450,2669,1219
2019,6,29,5,1335,1430,2638,1208
2019,6,29,6,1260,1346,2635,1289
2019,6,29,7,1220,1259,2608,1349
2019,6,29,8,1195,1256,2578,1322
2019,6,29,9,1170,1201,2521,1320
2019,6,29,10,1155,1211,2520,1309
2019,6,29,11,1155,1204,2453,1249
2019,6,29,12,1165,1220,2468,1248
2019,6,29,13,1205,1216,2457,1241
2019,6,29,14,1270,1301,2452,1151
2019,6,29,15,1330,1346,2473,1127
2019,6,29,16,1370,1367,2498,1131
2019,6,29,17,1390,1410,2521,1111
2019,6,29,18,1390,1416,2539,1123
2019,6,29,19,1395,1458,2567,1109
2019,6,29,20,1405,1457,2559,1102
2019,6,29,21,1410,1482,2599,1117
2019,6,29,22,1420,1486,2594,1108
2019,6,29,23,1435,1520,2608,1088
2019,6,30,0,1430,1535,2580,1045
2019,6,30,1,1425,1518,2448,930
2019,6,30,2,1410,1513,2476,963
2019,6,30,3,1390,1453,2447,994
2019,6,30,4,1370,1454,2423,969
2019,6,30,5,1355,1393,2348,955
2019,6,30,6,1275,1315,2318,1003
2019,6,30,7,1225,1261,2346,1085
2019,6,30,8,1185,1216,2331,1115
2019,6,30,9,1175,1201,2319,1118
2019,6,30,10,1165,1188,2308,1120
2019,6,30,11,1160,1179,2303,1124
2019,6,30,12,1165,1197,2440,1243
2019,6,30,13,1190,1205,2483,1278
2019,6,30,14,1230,1270,2529,1259
2019,6,30,15,1290,1334,2548,1214
2019,6,30,16,1320,1370,2570,1200
2019,6,30,17,1355,1424,2621,1197
2019,6,30,18,1375,1443,2632,1189
2019,6,30,19,1395,1474,2650,1176
2019,6,30,20,1410,1514,2655,1141
2019,6,30,21,1415,1516,2643,1127
2019,6,30,22,1435,1551,2693,1142
2019,6,30,23,1445,1530,2664,1134
2019,7,1,0,1445,1534,2676,1142
2019,7,1,1,1450,1539,2684,1145
2019,7,1,2,1440,1515,2664,1149
2019,7,1,3,1430,1514,2624,1110
2019,7,1,4,1390,1474,2572,1098
2019,7,1,5,1360,1436,2616,1180
2019,7,1,6,1280,1325,2564,1239
2019,7,1,7,1220,1275,2531,1256
2019,7,1,8,1185,1223,2512,1289
2019,7,1,9,1180,1216,2459,1243
2019,7,1,10,1170,1200,2555,1355
2019,7,1,11,1190,1191,2495,1304
2019,7,1,12,1215,1240,2594,1354
2019,7,1,13,1290,1302,2634,1332
2019,7,1,14,1380,1409,2678,1269
2019,7,1,15,1425,1444,2660,1216
2019,7,1,16,1445,1500,2625,1125
2019,7,1,17,1480,1536,2599,1063
2019,7,1,18,1490,1551,2622,1071
2019,7,1,19,1510,1580,2571,991
2019,7,1,20,1535,1614,2607,993
2019,7,1,21,1535,1646,2682,1036
2019,7,1,22,1550,1661,2828,1167
2019,7,1,23,1550,1711,2853,1142
2019,7,2,0,1540,1672,2742,1070
2019,7,2,1,1530,1660,2720,1060
2019,7,2,2,1490,1628,2730,1102
2019,7,2,3,1475,1588,2690,1102
2019,7,2,4,1420,1554,2657,1103
2019,7,2,5,1400,1494,2659,1165
2019,7,2,6,1310,1377,2739,1362
2019,7,2,7,1220,1298,2735,1437
2019,7,2,8,1190,1252,2586,1334
2019,7,2,9,1170,1208,2458,1250
2019,7,2,10,1165,1207,2526,1319
2019,7,2,11,1170,1203,2574,1371
2019,7,2,12,1200,1240,2590,1350
2019,7,2,13,1275,1306,2588,1282
2019,7,2,14,1375,1397,2628,1231
2019,7,2,15,1410,1448,2658,1210
2019,7,2,16,1440,1482,2659,1177
2019,7,2,17,1460,1511,2675,1164
2019,7,2,18,1475,1514,2680,1166
2019,7,2,19,1485,1512,2732,1220
2019,7,2,20,1505,1512,2759,1247
2019,7,2,21,1510,1511,2793,1282
2019,7,2,22,1525,1512,2782,1270
2019,7,2,23,1515,1507,2751,1244
2019,7,3,0,1485,1496,2731,1235
2019,7,3,1,1470,1476,2759,1283
2019,7,3,2,1465,1440,2624,1184
2019,7,3,3,1455,1427,2750,1323
2019,7,3,4,1425,1411,2717,1306
2019,7,3,5,1395,1355,2516,1161
2019,7,3,6,1300,1264,2455,1191
2019,7,3,7,1235,1208,2385,1177
2019,7,3,8,1210,1208,2510,1302
2019,7,3,9,1185,1177,2489,1312
2019,7,3,10,1180,1176,2374,1198
2019,7,3,11,1175,1178,2336,1158
2019,7,3,12,1205,1217,2346,1129
2019,7,3,13,1260,1283,2465,1182
2019,7,3,14,1325,1381,2621,1240
2019,7,3,15,1365,1430,2639,1209
2019,7,3,16,1390,1452,2660,1208
2019,7,3,17,1420,1462,2657,1195
2019,7,3,18,1430,1453,2659,1206
2019,7,3,19,1450,1441,2668,1227
2019,7,3,20,1480,1441,2678,1237
2019,7,3,21,1495,1433,2672,1239
2019,7,3,22,1485,1430,2727,1297
2019,7,3,23,1495,1427,2717,1290
2019,7,4,0,1470,1419,2701,1282
2019,7,4,1,1455,1405,2672,1267
2019,7,4,2,1435,1379,2663,1284
2019,7,4,3,1400,1375,2669,1294
2019,7,4,4,1375,1366,2676,1310
2019,7,4,5,1335,1341,2673,1332
2019,7,4,6,1245,1272,2653,1381
2019,7,4,7,1205,1227,2634,1407
2019,7,4,8,1170,1201,2535,1334
2019,7,4,9,1150,1156,2497,1341
2019,7,4,10,1140,1160,2499,1339
2019,7,4,11,1140,1161,2501,1340
2019,7,4,12,1165,1173,2543,1370
2019,7,4,13,1180,1195,2575,1380
2019,7,4,14,1235,1231,2600,1369
2019,7,4,15,1280,1286,2628,1342
2019,7,4,16,1315,1334,2646,1312
2019,7,4,17,1345,1355,2654,1299
2019,7,4,18,1365,1350,2653,1303
2019,7,4,19,1380,1355,2656,1301
2019,7,4,20,1405,1362,2641,1279
2019,7,4,21,1415,1372,2651,1279
2019,7,4,22,1430,1400,2700,1300
2019,7,4,23,1425,1397,2683,1286
2019,7,5,0,1415,1407,2700,1293
2019,7,5,1,1410,1399,2691,1292
2019,7,5,2,1390,1355,2667,1312
2019,7,5,3,1380,1335,2630,1295
2019,7,5,4,1340,1318,2466,1148
2019,7,5,5,1305,1279,2376,1097
2019,7,5,6,1210,1251,2334,1083
2019,7,5,7,1210,1193,2307,1114
2019,7,5,8,1170,1167,2296,1129
2019,7,5,9,1155,1149,2329,1180
2019,7,5,10,1145,1137,2286,1149
2019,7,5,11,1155,1145,2401,1256
2019,7,5,12,1185,1157,2497,1340
2019,7,5,13,1260,1204,2512,1308
2019,7,5,14,1365,1251,2506,1255
2019,7,5,15,1410,1307,2501,1194
2019,7,5,16,1435,1364,2554,1190
2019,7,5,17,1445,1383,2522,1139
2019,7,5,18,1455,1399,2622,1223
2019,7,5,19,1450,1406,2725,1319
2019,7,5,20,1455,1419,2741,1322
2019,7,5,21,1460,1343,2648,1305
2019,7,5,22,1470,1429,2728,1299
2019,7,5,23,1470,1453,2711,1258
2019,7,6,0,1460,1461,2726,1265
2019,7,6,1,1440,1461,2682,1221
2019,7,6,2,1425,1461,2710,1249
2019,7,6,3,1405,1427,2692,1265
2019,7,6,4,1365,1416,2708,1292
2019,7,6,5,1355,1380,2631,1251
2019,7,6,6,1280,1301,2638,1337
2019,7,6,7,1180,1235,2603,1368
2019,7,6,8,1160,1181,2384,1203
2019,7,6,9,1130,1154,2245,1091
2019,7,6,10,1135,1133,2071,938
2019,7,6,11,1135,1134,1996,862
2019,7,6,12,1150,1129,1987,858
2019,7,6,13,1205,1146,1987,841
2019,7,6,14,1300,1204,1980,776
2019,7,6,15,1355,1261,2026,765
2019,7,6,16,1390,1316,2066,750
2019,7,6,17,1410,1350,2147,797
2019,7,6,18,1410,1361,2154,793
2019,7,6,19,1410,1376,2061,685
2019,7,6,20,1395,1393,2049,656
2019,7,6,21,1395,1409,2056,647
2019,7,6,22,1400,1426,2150,724
2019,7,6,23,1410,1458,2293,835
2019,7,7,0,1405,1463,2358,895
2019,7,7,1,1400,1425,2217,792
2019,7,7,2,1390,1400,2168,768
2019,7,7,3,1370,1388,2169,781
2019,7,7,4,1350,1365,2134,769
2019,7,7,5,1345,1316,2106,790
2019,7,7,6,1275,1228,2080,852
2019,7,7,7,1200,1176,2049,873
2019,7,7,8,1170,1148,1991,843
2019,7,7,9,1155,1109,1795,686
2019,7,7,10,1145,1099,1741,642
2019,7,7,11,1140,1109,1731,622
2019,7,7,12,1145,1116,1734,618
2019,7,7,13,1190,1115,1721,606
2019,7,7,14,1270,1173,1728,555
2019,7,7,15,1320,1243,1751,508
2019,7,7,16,1365,1303,2061,758
2019,7,7,17,1395,1328,2117,789
2019,7,7,18,1415,1365,2072,707
2019,7,7,19,1420,1400,2191,791
2019,7,7,20,1435,1426,2201,775
2019,7,7,21,1430,1446,2221,775
2019,7,7,22,1440,1465,2213,748
2019,7,7,23,1440,1482,2172,690
2019,7,8,0,1445,1473,1913,440
2019,7,8,1,1450,1470,1875,405
2019,7,8,2,1445,1414,1817,403
2019,7,8,3,1425,1386,1796,410
2019,7,8,4,1380,1361,1773,412
2019,7,8,5,1360,1325,2130,805
2019,7,8,6,1290,1241,2172,931
2019,7,8,7,1195,1177,2155,978
2019,7,8,8,1170,1142,1692,550
2019,7,8,9,1155,1128,1608,480
2019,7,8,10,1145,1130,1641,511
2019,7,8,11,1165,1135,1594,459
2019,7,8,12,1195,1171,1650,479
2019,7,8,13,1240,1237,1722,485
2019,7,8,14,1285,1315,1695,380
2019,7,8,15,1330,1350,1695,345
2019,7,8,16,1345,1381,1723,342
2019,7,8,17,1375,1401,1716,315
2019,7,8,18,1375,1432,1806,374
2019,7,8,19,1395,1459,1923,464
2019,7,8,20,1415,1497,2060,563
2019,7,8,21,1420,1511,2120,609
2019,7,8,22,1425,1492,2134,642
2019,7,8,23,1450,1495,2132,637
2019,7,9,0,1445,1462,2050,588
2019,7,9,1,1440,1433,2073,640
2019,7,9,2,1410,1411,2071,660
2019,7,9,3,1385,1400,2070,670
2019,7,9,4,1350,1390,2061,671
2019,7,9,5,1315,1327,2004,677
2019,7,9,6,1240,1238,2021,783
2019,7,9,7,1225,1196,1960,764
2019,7,9,8,1185,1170,1913,743
2019,7,9,9,1155,1153,1969,816
2019,7,9,10,1150,1160,2043,883
2019,7,9,11,1155,1168,2012,844
2019,7,9,12,1185,1205,2052,847
2019,7,9,13,1250,1263,2049,786
2019,7,9,14,1350,1317,1728,411
2019,7,9,15,1400,1340,1607,267
2019,7,9,16,1435,1376,1655,279
2019,7,9,17,1455,1557,1835,278
2019,7,9,18,1470,1408,1678,270
2019,7,9,19,1480,1411,1674,263
2019,7,9,20,1485,1422,1647,225
2019,7,9,21,1485,1425,1638,213
2019,7,9,22,1495,1439,1638,199
2019,7,9,23,1490,1446,1673,227
2019,7,10,0,1470,1446,1674,228
2019,7,10,1,1460,1451,1678,227
2019,7,10,2,1425,1374,1681,307
2019,7,10,3,1410,1438,1699,261
2019,7,10,4,1350,1431,1717,286
2019,7,10,5,1345,1365,1691,326
2019,7,10,6,1255,1268,1709,441
2019,7,10,7,1205,1165,1789,624
2019,7,10,8,1180,1160,1946,786
2019,7,10,9,1160,1157,2175,1018
2019,7,10,10,1160,1153,2195,1042
2019,7,10,11,1160,1133,1728,595
2019,7,10,12,1200,1149,1751,602
2019,7,10,13,1285,1225,1860,635
2019,7,10,14,1390,1320,2069,749
2019,7,10,15,1430,1383,2281,898
2019,7,10,16,1455,1422,2410,988
2019,7,10,17,1490,1462,2502,1040
2019,7,10,18,1515,1489,2526,1037
2019,7,10,19,1525,1516,2538,1022
2019,7,10,20,1555,1555,2530,975
2019,7,10,21,1570,1589,2515,926
2019,7,10,22,1580,1633,2547,914
2019,7,10,23,1590,1646,2599,953
2019,7,11,0,1575,1663,2620,957
2019,7,11,1,1560,1661,2611,950
2019,7,11,2,1545,1643,2644,1001
2019,7,11,3,1515,1616,2659,1043
2019,7,11,4,1455,1586,2612,1026
2019,7,11,5,1425,1515,2588,1073
2019,7,11,6,1330,1381,2499,1118
2019,7,11,7,1225,1314,2448,1134
2019,7,11,8,1190,1278,2504,1226
2019,7,11,9,1155,1230,2512,1282
2019,7,11,10,1150,1210,2521,1311
2019,7,11,11,1155,1225,2614,1389
2019,7,11,12,1175,1249,2708,1459
2019,7,11,13,1265,1314,2719,1405
2019,7,11,14,1375,1409,2794,1385
2019,7,11,15,1420,1444,2784,1340
2019,7,11,16,1470,1493,2808,1315
2019,7,11,17,1525,1579,2784,1205
2019,7,11,18,1515,1603,2732,1129
2019,7,11,19,1530,1633,2711,1078
2019,7,11,20,1555,1692,2726,1034
2019,7,11,21,1575,1721,2727,1006
2019,7,11,22,1595,1734,2732,998
2019,7,11,23,1600,1752,2777,1025
2019,7,12,0,1580,1720,2799,1079
2019,7,12,1,1550,1685,2717,1032
2019,7,12,2,1510,1639,2781,1142
2019,7,12,3,1490,1612,2725,1113
2019,7,12,4,1450,1577,2782,1205
2019,7,12,5,1425,1502,2772,1270
2019,7,12,6,1345,1384,2657,1273
2019,7,12,7,1175,1313,2657,1344
2019,7,12,8,1160,1278,2589,1311
2019,7,12,9,1145,1242,2562,1320
2019,7,12,10,1140,1241,2575,1334
2019,7,12,11,1135,1247,2542,1295
2019,7,12,12,1150,1279,2574,1295
2019,7,12,13,1220,1329,2591,1262
2019,7,12,14,1300,1450,2654,1204
2019,7,12,15,1360,1510,2720,1210
2019,7,12,16,1395,1559,2723,1164
2019,7,12,17,1425,1596,2741,1145
2019,7,12,18,1455,1632,2714,1082
2019,7,12,19,1480,1645,2708,1063
2019,7,12,20,1515,1708,2725,1017
2019,7,12,21,1515,1727,2725,998
2019,7,12,22,1565,1752,2747,995
2019,7,12,23,1595,1775,2756,981
2019,7,13,0,1630,1772,2798,1026
2019,7,13,1,1835,1727,2810,1083
2019,7,13,2,1595,1699,2798,1099
2019,7,13,3,1580,1659,2850,1191
2019,7,13,4,1550,1588,2768,1180
2019,7,13,5,1475,1515,2870,1355
2019,7,13,6,1340,1399,2739,1340
2019,7,13,7,1320,1328,2720,1392
2019,7,13,8,1275,1294,2709,1415
2019,7,13,9,1240,1259,2691,1432
2019,7,13,10,1210,1243,2703,1460
2019,7,13,11,1210,1249,2695,1446
2019,7,13,12,1225,1244,2690,1446
2019,7,13,13,1230,1258,2681,1423
2019,7,13,14,1280,1332,2628,1296
2019,7,13,15,1335,1407,2677,1270
2019,7,13,16,1390,1480,2685,1205
2019,7,13,17,1440,1524,2677,1153
2019,7,13,18,1475,1565,2682,1117
2019,7,13,19,1495,1612,2687,1075
2019,7,13,20,1530,1648,2685,1037
2019,7,13,21,1550,1660,2681,1021
2019,7,13,22,1590,1662,2734,1072
2019,7,13,23,1630,1632,2709,1077
2019,7,14,0,1640,1602,2719,1117
2019,7,14,1,1635,1574,2782,1208
2019,7,14,2,1595,1556,2765,1209
2019,7,14,3,1540,1528,2731,1203
2019,7,14,4,1510,1502,2762,1260
2019,7,14,5,1425,1444,2712,1268
2019,7,14,6,1340,1353,2700,1347
2019,7,14,7,1310,1296,2580,1284
2019,7,14,8,1255,1253,2523,1270
2019,7,14,9,1225,1243,2535,1292
2019,7,14,10,1195,1212,2510,1298
2019,7,14,11,1205,1209,2555,1346
2019,7,14,12,1210,1213,2602,1389
2019,7,14,13,1210,1218,2620,1402
2019,7,14,14,1270,1271,2695,1424
2019,7,14,15,1320,1323,2657,1334
2019,7,14,16,1370,1399,2686,1287
2019,7,14,17,1425,1451,2670,1219
2019,7,14,18,1455,1517,2683,1166
2019,7,14,19,1485,1555,2706,1151
2019,7,14,20,1515,1583,2701,1118
2019,7,14,21,1550,1611,2702,1091
2019,7,14,22,1585,1653,2715,1062
2019,7,14,23,1610,1657,2707,1050
2019,7,15,0,1630,1662,2748,1086
2019,7,15,1,1625,1667,2786,1119
2019,7,15,2,1595,1623,2780,1157
2019,7,15,3,1565,1565,2688,1123
2019,7,15,4,1530,1506,2647,1141
2019,7,15,5,1445,1438,2682,1244
2019,7,15,6,1340,1338,2700,1362
2019,7,15,7,1230,1266,2698,1432
2019,7,15,8,1205,1225,2553,1328
2019,7,15,9,1195,1194,2523,1329
2019,7,15,10,1180,1194,2596,1402
2019,7,15,11,1180,1208,2657,1449
2019,7,15,12,1205,1238,2659,1421
2019,7,15,13,1250,1313,2648,1335
2019,7,15,14,1315,1399,2635,1236
2019,7,15,15,1370,1452,2630,1178
2019,7,15,16,1405,1498,2620,1122
2019,7,15,17,1445,1538,2617,1079
2019,7,15,18,1470,1566,2629,1063
2019,7,15,19,1495,1614,2658,1044
2019,7,15,20,1530,1639,2685,1046
2019,7,15,21,1545,1658,2683,1025
2019,7,15,22,1575,1680,2682,1002
2019,7,15,23,1610,1687,2692,1005
2019,7,16,0,1615,1662,2713,1051
2019,7,16,1,1730,1608,2668,1060
2019,7,16,2,1580,1565,2606,1041
2019,7,16,3,1555,1534,2603,1069
2019,7,16,4,1525,1497,2613,1116
2019,7,16,5,1450,1426,2597,1171
2019,7,16,6,1330,1333,2496,1163
2019,7,16,7,1200,1275,2532,1257
2019,7,16,8,1165,1247,2594,1347
2019,7,16,9,1145,1212,2524,1312
2019,7,16,10,1145,1225,2560,1335
2019,7,16,11,1150,1226,2593,1367
2019,7,16,12,1185,1253,2673,1420
2019,7,16,13,1270,1311,2686,1375
2019,7,16,14,1370,1392,2695,1303
2019,7,16,15,1405,1448,2710,1262
2019,7,16,16,1450,1486,2692,1206
2019,7,16,17,1590,1511,2682,1171
2019,7,16,18,1500,1530,2673,1143
2019,7,16,19,1510,1565,2703,1138
2019,7,16,20,1520,1592,2740,1148
2019,7,16,21,1530,1598,2752,1154
2019,7,16,22,1550,1611,2800,1189
2019,7,16,23,1555,1600,2797,1197
2019,7,17,0,1555,1577,2757,1180
2019,7,17,1,1555,1567,2701,1134
2019,7,17,2,1485,1532,2720,1188
2019,7,17,3,1515,1504,2710,1206
2019,7,17,4,1440,1492,2696,1204
2019,7,17,5,1425,1418,2698,1280
2019,7,17,6,1330,1317,2639,1322
2019,7,17,7,1185,1268,2663,1395
2019,7,17,8,1165,1217,2582,1365
2019,7,17,9,1150,1199,2520,1321
2019,7,17,10,1145,1203,2543,1340
2019,7,17,11,1145,1194,2547,1353
2019,7,17,12,1165,1238,2606,1368
2019,7,17,13,1250,1318,2624,1306
2019,7,17,14,1340,1396,2677,1281
2019,7,17,15,1400,1441,2659,1218
2019,7,17,16,1435,1480,2665,1185
2019,7,17,17,1470,1507,2689,1182
2019,7,17,18,1495,1552,2727,1175
2019,7,17,19,1520,1561,2752,1191
2019,7,17,20,1550,1590,2840,1250
2019,7,17,21,1550,1603,2803,1200
2019,7,17,22,1590,1617,2787,1170
2019,7,17,23,1610,1605,2780,1175
2019,7,18,0,1625,1584,2566,982
2019,7,18,1,1610,1534,2138,604
2019,7,18,2,1580,1480,1856,376
2019,7,18,3,1560,1502,1623,121
2019,7,18,4,1490,1476,1640,164
2019,7,18,5,1460,1413,1616,203
2019,7,18,6,1340,1334,1638,304
2019,7,18,7,1240,1252,1656,404
2019,7,18,8,1205,1227,1566,339
2019,7,18,9,1170,1207,1614,407
2019,7,18,10,1165,1189,1618,429
2019,7,18,11,1175,1179,1590,411
2019,7,18,12,1190,1217,1595,378
2019,7,18,13,1240,1290,1568,278
2019,7,18,14,1310,1365,1547,182
2019,7,18,15,1355,1427,1540,113
2019,7,18,16,1395,1461,1549,88
2019,7,18,17,1450,1505,1613,108
2019,7,18,18,1465,1520,1657,137
2019,7,18,19,1495,1526,1697,171
2019,7,18,20,1535,1560,1716,156
2019,7,18,21,1555,1583,1714,131
2019,7,18,22,1565,1596,1817,221
2019,7,18,23,1570,1628,1864,236
2019,7,19,0,1545,1628,1868,240
2019,7,19,1,1520,1611,1832,221
2019,7,19,2,1485,1583,1831,248
2019,7,19,3,1455,1540,1795,255
2019,7,19,4,1400,1507,1763,256
2019,7,19,5,1365,1445,1731,286
2019,7,19,6,1265,1323,1754,431
2019,7,19,7,1230,1267,1776,509
2019,7,19,8,1200,1204,1756,552
2019,7,19,9,1170,1183,1702,519
2019,7,19,10,1170,1155,1695,540
2019,7,19,11,1175,1182,1733,551
2019,7,19,12,1200,1187,1705,518
2019,7,19,13,1225,1254,1739,485
2019,7,19,14,1295,1330,1733,403
2019,7,19,15,1345,1393,1753,360
2019,7,19,16,1390,1429,1775,346
2019,7,19,17,1420,1469,1831,362
2019,7,19,18,1450,1493,1845,352
2019,7,19,19,1460,1487,1833,346
2019,7,19,20,1510,1500,1853,353
2019,7,19,21,1510,1531,1877,346
2019,7,19,22,1540,1545,1893,348
2019,7,19,23,1555,1560,1949,389
2019,7,20,0,1555,1557,1954,397
2019,7,20,1,1515,1520,1912,392
2019,7,20,2,1485,1494,1884,390
2019,7,20,3,1460,1459,1913,454
2019,7,20,4,1430,1445,1880,435
2019,7,20,5,1355,1406,1905,499
2019,7,20,6,1255,1314,1838,524
2019,7,20,7,1215,1262,1861,599
2019,7,20,8,1180,1219,1762,543
2019,7,20,9,1160,1175,1786,611
2019,7,20,10,1140,1173,1806,633
2019,7,20,11,1145,1161,1670,509
2019,7,20,12,1150,1180,1664,484
2019,7,20,13,1160,1201,1646,445
2019,7,20,14,1210,1269,1564,295
2019,7,20,15,1270,1314,1584,270
2019,7,20,16,1325,1341,1684,343
2019,7,20,17,1365,1355,1670,315
2019,7,20,18,1390,1366,1668,302
2019,7,20,19,1425,1372,1667,295
2019,7,20,20,1460,1389,1698,309
2019,7,20,21,1470,1388,1704,316
2019,7,20,22,1480,1425,1717,292
2019,7,20,23,1475,1442,1716,274
2019,7,21,0,1460,1454,1706,252
2019,7,21,1,1430,1493,1727,234
2019,7,21,2,1410,1470,1740,270
2019,7,21,3,1385,1436,1728,292
2019,7,21,4,1355,1411,1764,353
2019,7,21,5,1305,1346,1793,447
2019,7,21,6,1215,1276,1857,581
2019,7,21,7,1225,1223,1830,607
2019,7,21,8,1185,1183,1800,617
2019,7,21,9,1170,1164,1800,636
2019,7,21,10,1150,1157,1777,620
2019,7,21,11,1145,1153,1748,595
2019,7,21,12,1155,1148,1604,456
2019,7,21,13,1175,1163,1560,397
2019,7,21,14,1225,1223,1583,360
2019,7,21,15,1285,1277,1606,329
2019,7,21,16,1340,1315,1622,307
2019,7,21,17,1385,1344,1610,266
2019,7,21,18,1425,1366,1619,253
2019,7,21,19,1460,1390,1619,229
2019,7,21,20,1490,1405,1617,212
2019,7,21,21,1515,1440,1615,175
2019,7,21,22,1545,1474,1616,142
2019,7,21,23,1560,1515,1624,109
2019,7,22,0,1560,1557,1654,97
2019,7,22,1,1560,1561,1655,94
2019,7,22,2,1515,1568,1683,115
2019,7,22,3,1470,1541,1704,163
2019,7,22,4,1400,1533,1694,161
2019,7,22,5,1360,1450,1673,223
2019,7,22,6,1260,1346,1591,245
2019,7,22,7,1240,1284,1562,278
2019,7,22,8,1205,1238,1600,362
2019,7,22,9,1180,1186,1675,489
2019,7,22,10,1170,1172,1773,601
2019,7,22,11,1175,1183,1830,647
2019,7,22,12,1215,1224,2092,868
2019,7,22,13,1335,1290,2196,906
2019,7,22,14,1465,1383,2142,759
2019,7,22,15,1525,1465,2510,1045
2019,7,22,16,1565,1518,2661,1143
2019,7,22,17,1610,1560,2765,1205
2019,7,22,18,1635,1600,2811,1211
2019,7,22,19,1670,1640,2836,1196
2019,7,22,20,1705,1692,2824,1132
2019,7,22,21,1725,1732,2842,1110
2019,7,22,22,1740,1769,2816,1047
2019,7,22,23,1750,1787,2817,1030
2019,7,23,0,1725,1791,2815,1024
2019,7,23,1,1680,1794,2798,1004
2019,7,23,2,1650,1754,2783,1029
2019,7,23,3,1610,1715,2842,1127
2019,7,23,4,1570,1679,2829,1150
2019,7,23,5,1505,1601,2772,1171
2019,7,23,6,1390,1458,2703,1245
2019,7,23,7,1260,1384,2719,1335
2019,7,23,8,1220,1344,2743,1399
2019,7,23,9,1190,1306,2717,1411
2019,7,23,10,1200,1303,2705,1402
2019,7,23,11,1205,1306,2679,1373
2019,7,23,12,1220,1342,2712,1370
2019,7,23,13,1365,1406,2758,1352
2019,7,23,14,1440,1494,2714,1220
2019,7,23,15,1510,1564,2711,1147
2019,7,23,16,1560,1618,2704,1086
2019,7,23,17,1590,1681,2728,1047
2019,7,23,18,1620,1731,2743,1012
2019,7,23,19,1650,1789,2767,978
2019,7,23,20,1680,1858,2794,936
2019,7,23,21,1700,1894,2772,878
2019,7,23,22,1740,1906,2748,842
2019,7,23,23,1770,1912,2728,816
2019,7,24,0,1760,1882,2682,800
2019,7,24,1,1750,1837,2696,859
2019,7,24,2,1715,1789,2776,987
2019,7,24,3,1700,1737,2734,997
2019,7,24,4,1660,1702,2720,1018
2019,7,24,5,1605,1601,2675,1074
2019,7,24,6,1490,1472,2652,1180
2019,7,24,7,1310,1413,2685,1272
2019,7,24,8,1285,1366,2535,1169
2019,7,24,9,1270,1323,2499,1176
2019,7,24,10,1270,1317,2509,1192
2019,7,24,11,1260,1312,2514,1202
2019,7,24,12,1285,1353,2634,1281
2019,7,24,13,1360,1423,2672,1249
2019,7,24,14,1450,1513,2706,1193
2019,7,24,15,1510,1573,2694,1121
2019,7,24,16,1550,1653,2788,1135
2019,7,24,17,1585,1700,2801,1101
2019,7,24,18,1625,1734,2816,1082
2019,7,24,19,1645,1770,2901,1131
2019,7,24,20,1680,1820,2928,1108
2019,7,24,21,1680,1862,2879,1017
2019,7,24,22,1725,1876,2899,1023
2019,7,24,23,1745,1884,2871,987
2019,7,25,0,1770,1844,2871,1027
2019,7,25,1,1755,1808,2866,1058
2019,7,25,2,1715,1776,2856,1080
2019,7,25,3,1715,1700,2879,1179
2019,7,25,4,1650,1656,2832,1176
2019,7,25,5,1600,1568,2832,1264
2019,7,25,6,1470,1476,2822,1346
2019,7,25,7,1290,1399,2816,1417
2019,7,25,8,1255,1347,2735,1388
2019,7,25,9,1220,1325,2707,1382
2019,7,25,10,1210,1305,2562,1257
2019,7,25,11,1210,1307,2618,1311
2019,7,25,12,1245,1336,2653,1317
2019,7,25,13,1320,1399,2696,1297
2019,7,25,14,1415,1478,2684,1206
2019,7,25,15,1475,1520,2651,1131
2019,7,25,16,1525,1550,2634,1084
2019,7,25,17,1585,1605,2711,1106
2019,7,25,18,1620,1631,2730,1099
2019,7,25,19,1660,1654,2703,1049
2019,7,25,20,1720,1692,2731,1039
2019,7,25,21,1750,1724,2758,1034
2019,7,25,22,1765,1770,2766,996
2019,7,25,23,1780,1809,2770,961
2019,7,26,0,1755,1804,2840,1036
2019,7,26,1,1720,1804,2838,1034
2019,7,26,2,1675,1800,2798,998
2019,7,26,3,1630,1749,2772,1023
2019,7,26,4,1580,1682,2757,1075
2019,7,26,5,1510,1572,2720,1148
2019,7,26,6,1385,1450,2697,1247
2019,7,26,7,1360,1391,2654,1263
2019,7,26,8,1300,1323,2516,1193
2019,7,26,9,1270,1299,2507,1208
2019,7,26,10,1250,1288,2476,1188
2019,7,26,11,1270,1282,2471,1189
2019,7,26,12,1285,1269,2535,1266
2019,7,26,13,1390,1360,2584,1224
2019,7,26,14,1515,1449,2606,1157
2019,7,26,15,1585,1509,2604,1095
2019,7,26,16,1635,1533,2603,1070
2019,7,26,17,1680,1570,2623,1053
2019,7,26,18,1710,1606,2661,1055
2019,7,26,19,1715,1640,2702,1062
2019,7,26,20,1745,1673,2713,1040
2019,7,26,21,1780,1700,2729,1029
2019,7,26,22,1795,1725,2738,1013
2019,7,26,23,1815,1740,2727,987
2019,7,27,0,1800,1747,2739,992
2019,7,27,1,1760,1722,2726,1004
2019,7,27,2,1730,1690,2724,1034
2019,7,27,3,1680,1635,2674,1039
2019,7,27,4,1640,1595,2690,1095
2019,7,27,5,1595,1515,2659,1144
2019,7,27,6,1480,1409,2612,1203
2019,7,27,7,1340,1347,2583,1236
2019,7,27,8,1295,1314,2580,1266
2019,7,27,9,1260,1279,2573,1294
2019,7,27,10,1245,1263,2587,1324
2019,7,27,11,1250,1260,2604,1344
2019,7,27,12,1255,1262,2583,1321
2019,7,27,13,1290,1290,2566,1276
2019,7,27,14,1380,1336,2546,1210
2019,7,27,15,1440,1400,2577,1177
2019,7,27,16,1495,1487,2725,1238
2019,7,27,17,1540,1554,2845,1291
2019,7,27,18,1565,1593,2870,1277
2019,7,27,19,1610,1641,2924,1283
2019,7,27,20,1645,1651,2845,1194
2019,7,27,21,1655,1658,2765,1107
2019,7,27,22,1675,1662,2790,1128
2019,7,27,23,1660,1687,2776,1089
2019,7,28,0,1645,1731,2841,1110
2019,7,28,1,1630,1719,2864,1145
2019,7,28,2,1615,1693,2827,1134
2019,7,28,3,1580,1640,2888,1248
2019,7,28,4,1520,1606,2857,1251
2019,7,28,5,1480,1543,2894,1351
2019,7,28,6,1390,1449,2815,1366
2019,7,28,7,1295,1380,2837,1457
2019,7,28,8,1250,1350,2816,1466
2019,7,28,9,1235,1317,2709,1392
2019,7,28,10,1215,1303,2697,1394
2019,7,28,11,1210,1301,2734,1433
2019,7,28,12,1215,1295,2658,1363
2019,7,28,13,1215,1304,2654,1350
2019,7,28,14,1255,1348,2704,1356
2019,7,28,15,1310,1402,2684,1282
2019,7,28,16,1370,1461,2713,1252
2019,7,28,17,1415,1507,2718,1211
2019,7,28,18,1455,1528,2737,1209
2019,7,28,19,1495,1574,2771,1197
2019,7,28,20,1525,1592,2780,1188
2019,7,28,21,1555,1630,2786,1156
2019,7,28,22,1595,1648,2770,1122
2019,7,28,23,1610,1687,2763,1076
2019,7,29,0,1625,1718,2755,1037
2019,7,29,1,1630,1739,2756,1017
2019,7,29,2,1600,1701,2757,1056
2019,7,29,3,1550,1658,2749,1091
2019,7,29,4,1500,1624,2772,1148
2019,7,29,5,1430,1532,2722,1190
2019,7,29,6,1330,1429,2715,1286
2019,7,29,7,1305,1356,2724,1368
2019,7,29,8,1260,1315,2684,1369
2019,7,29,9,1215,1300,2694,1394
2019,7,29,10,1200,1272,2667,1395
2019,7,29,11,1210,1287,2664,1377
2019,7,29,12,1245,1312,2640,1328
2019,7,29,13,1305,1370,2662,1292
2019,7,29,14,1390,1446,2615,1169
2019,7,29,15,1455,1509,2627,1118
2019,7,29,16,1500,1545,2627,1082
2019,7,29,17,1545,1606,2634,1028
2019,7,29,18,1575,1646,2660,1014
2019,7,29,19,1615,1666,2653,987
2019,7,29,20,1665,1719,2657,938
2019,7,29,21,1700,1779,2662,883
2019,7,29,22,1735,1802,2651,849
2019,7,29,23,1750,1830,2634,804
2019,7,30,0,1745,1834,2674,840
2019,7,30,1,1735,1832,2717,885
2019,7,30,2,1695,1769,2767,998
2019,7,30,3,1655,1720,2748,1028
2019,7,30,4,1580,1667,2699,1032
2019,7,30,5,1535,1567,2533,966
2019,7,30,6,1400,1459,2608,1149
2019,7,30,7,1335,1376,2400,1024
2019,7,30,8,1295,1326,2335,1009
2019,7,30,9,1265,1290,2131,841
2019,7,30,10,1260,1276,2070,794
2019,7,30,11,1260,1277,2068,791
2019,7,30,12,1285,1305,2091,786
2019,7,30,13,1360,1379,2223,844
2019,7,30,14,1460,1452,2171,719
2019,7,30,15,1525,1529,2333,804
2019,7,30,16,1580,1600,2583,983
2019,7,30,17,1640,1639,2649,1010
2019,7,30,18,1680,1705,2667,962
2019,7,30,19,1730,1738,2650,912
2019,7,30,20,1785,1784,2693,909
2019,7,30,21,1815,1803,2706,903
2019,7,30,22,1835,1826,2755,929
2019,7,30,23,1845,1851,2727,876
2019,7,31,0,1825,1832,2721,889
2019,7,31,1,1800,1795,2683,888
2019,7,31,2,1750,1742,2649,907
2019,7,31,3,1705,1689,2652,963
2019,7,31,4,1660,1628,2535,907
2019,7,31,5,1570,1529,2530,1001
2019,7,31,6,1450,1420,2563,1143
2019,7,31,7,1350,1362,2546,1184
2019,7,31,8,1305,1303,2557,1254
2019,7,31,9,1270,1295,2561,1266
2019,7,31,10,1260,1286,2542,1256
2019,7,31,11,1260,1295,2519,1224
2019,7,31,12,1295,1339,2571,1232
2019,7,31,13,1400,1396,2588,1192
2019,7,31,14,1515,1478,2474,996
2019,7,31,15,1575,1548,2551,1003
2019,7,31,16,1640,1587,2535,948
2019,7,31,17,1685,1652,2536,884
2019,7,31,18,1730,1692,2539,847
2019,7,31,19,1755,1746,2574,828
2019,7,31,20,1810,1789,2567,778
2019,7,31,21,1850,1855,2582,727
2019,7,31,22,1865,1885,2600,715
2019,7,31,23,1875,1921,2599,678
2019,8,1,0,1845,1891,2589,698
2019,8,1,1,1815,1839,2592,753
2019,8,1,2,1775,1806,2632,826
2019,8,1,3,1715,1743,2648,905
2019,8,1,4,1670,1709,2641,932
2019,8,1,5,1585,1593,2564,971
2019,8,1,6,1480,1491,2654,1163
2019,8,1,7,1350,1421,2612,1191
2019,8,1,8,1300,1384,2606,1222
2019,8,1,9,1280,1358,2571,1213
2019,8,1,10,1260,1337,2598,1261
2019,8,1,11,1260,1346,2617,1271
2019,8,1,12,1295,1369,2615,1246
2019,8,1,13,1405,1418,2656,1238
2019,8,1,14,1520,1502,2558,1056
2019,8,1,15,1575,1569,2555,986
2019,8,1,16,1615,1631,2588,957
2019,8,1,17,1670,1688,2633,945
2019,8,1,18,1700,1753,2662,909
2019,8,1,19,1725,1798,2662,864
2019,8,1,20,1765,1831,2644,813
2019,8,1,21,1795,1879,2649,770
2019,8,1,22,1835,1894,2714,820
2019,8,1,23,1870,1893,2688,795
2019,8,2,0,1865,1858,2726,868
2019,8,2,1,1855,1787,2687,900
2019,8,2,2,1835,1743,2636,893
2019,8,2,3,1780,1693,2685,992
2019,8,2,4,1670,1650,2654,1004
2019,8,2,5,1610,1574,2684,1110
2019,8,2,6,1485,1459,2689,1230
2019,8,2,7,1370,1403,2701,1298
2019,8,2,8,1305,1359,2697,1338
2019,8,2,9,1280,1337,2703,1366
2019,8,2,10,1260,1328,2693,1365
2019,8,2,11,1265,1322,2672,1350
2019,8,2,12,1260,1361,2697,1336
2019,8,2,13,1380,1399,2767,1368
2019,8,2,14,1500,1493,2743,1250
2019,8,2,15,1570,1552,2744,1192
2019,8,2,16,1605,1611,2715,1104
2019,8,2,17,1645,1680,2678,998
2019,8,2,18,1685,1712,2660,948
2019,8,2,19,1715,1760,2715,955
2019,8,2,20,1750,1827,2751,924
2019,8,2,21,1780,1862,2746,884
2019,8,2,22,1805,1878,2728,850
2019,8,2,23,1815,1886,2748,862
2019,8,3,0,1820,1858,2745,887
2019,8,3,1,1790,1824,2780,956
2019,8,3,2,1750,1759,2761,1002
2019,8,3,3,1700,1717,2763,1046
2019,8,3,4,1640,1668,2704,1036
2019,8,3,5,1570,1577,2737,1160
2019,8,3,6,1460,1481,2819,1338
2019,8,3,7,1360,1422,2841,1419
2019,8,3,8,1325,1357,2683,1326
2019,8,3,9,1290,1356,2805,1449
2019,8,3,10,1270,1338,2789,1451
2019,8,3,11,1270,1325,2790,1465
2019,8,3,12,1280,1340,2828,1488
2019,8,3,13,1305,1348,2812,1464
2019,8,3,14,1355,1399,2754,1355
2019,8,3,15,1415,1449,2707,1258
2019,8,3,16,1490,1529,2737,1208
2019,8,3,17,1545,1569,2664,1095
2019,8,3,18,1585,1628,2693,1065
2019,8,3,19,1625,1668,2740,1072
2019,8,3,20,1645,1701,2784,1083
2019,8,3,21,1655,1744,2818,1074
2019,8,3,22,1665,1777,2819,1042
2019,8,3,23,1690,1798,2819,1021
2019,8,4,0,1710,1817,2788,971
2019,8,4,1,1700,1812,2772,960
2019,8,4,2,1665,1772,2745,973
2019,8,4,3,1620,1733,2743,1010
2019,8,4,4,1570,1688,2791,1103
2019,8,4,5,1515,1593,2750,1157
2019,8,4,6,1415,1488,2748,1260
2019,8,4,7,1340,1417,2753,1336
2019,8,4,8,1305,1344,2583,1239
2019,8,4,9,1280,1323,2457,1134
2019,8,4,10,1260,1287,2438,1151
2019,8,4,11,1260,1297,2464,1167
2019,8,4,12,1260,1305,2604,1299
2019,8,4,13,1280,1327,2644,1317
2019,8,4,14,1335,1353,2583,1230
2019,8,4,15,1390,1423,2572,1149
2019,8,4,16,1445,1493,2574,1081
2019,8,4,17,1495,1558,2669,1111
2019,8,4,18,1525,1611,2726,1115
2019,8,4,19,1565,1657,2750,1093
2019,8,4,20,1585,1704,2759,1055
2019,8,4,21,1625,1751,2759,1008
2019,8,4,22,1645,1797,2762,965
2019,8,4,23,1680,1845,2775,930
2019,8,5,0,1700,1855,2799,944
2019,8,5,1,1695,1843,2817,974
2019,8,5,2,1670,1817,2830,1013
2019,8,5,3,1625,1769,2820,1051
2019,8,5,4,1560,1721,2825,1104
2019,8,5,5,1505,1610,2816,1206
2019,8,5,6,1395,1482,2766,1284
2019,8,5,7,1350,1420,2750,1330
2019,8,5,8,1310,1359,2742,1383
2019,8,5,9,1285,1336,2747,1411
2019,8,5,10,1260,1322,2723,1401
2019,8,5,11,1280,1319,2664,1345
2019,8,5,12,1305,1358,2688,1330
2019,8,5,13,1360,1417,2752,1335
2019,8,5,14,1440,1523,2715,1192
2019,8,5,15,1510,1581,2682,1101
2019,8,5,16,1550,1636,2709,1073
2019,8,5,17,1610,1687,2729,1042
2019,8,5,18,1655,1746,2731,985
2019,8,5,19,1680,1787,2743,956
2019,8,5,20,1735,1840,2762,922
2019,8,5,21,1790,1880,2767,887
2019,8,5,22,1810,1919,2771,852
2019,8,5,23,1835,1934,2752,818
2019,8,6,0,1830,1937,2763,826
2019,8,6,1,1815,1924,2759,835
2019,8,6,2,1760,1899,2754,855
2019,8,6,3,1710,1826,2771,945
2019,8,6,4,1660,1762,2774,1012
2019,8,6,5,1565,1632,2738,1106
2019,8,6,6,1445,1499,2643,1144
2019,8,6,7,1340,1414,2681,1267
2019,8,6,8,1295,1373,2574,1201
2019,8,6,9,1265,1329,2504,1175
2019,8,6,10,1250,1312,2427,1115
2019,8,6,11,1255,1316,2403,1087
2019,8,6,12,1285,1354,2583,1229
2019,8,6,13,1355,1426,2672,1246
2019,8,6,14,1445,1494,2638,1144
2019,8,6,15,1515,1546,2614,1068
2019,8,6,16,1575,1569,2559,990
2019,8,6,17,1630,1624,2549,925
2019,8,6,18,1685,1689,2586,897
2019,8,6,19,1730,1722,2620,898
2019,8,6,20,1780,1785,2648,863
2019,8,6,21,1810,1836,2662,826
2019,8,6,22,1830,1867,2650,783
2019,8,6,23,1845,1896,2677,781
2019,8,7,0,1815,1885,2689,804
2019,8,7,1,1770,1864,2660,796
2019,8,7,2,1720,1830,2718,888
2019,8,7,3,1665,1812,2765,953
2019,8,7,4,1615,1745,2752,1007
2019,8,7,5,1520,1630,2751,1121
2019,8,7,6,1405,1517,2779,1262
2019,8,7,7,1350,1437,2742,1305
2019,8,7,8,1290,1375,2667,1292
2019,8,7,9,1275,1340,2615,1275
2019,8,7,10,1270,1329,2601,1272
2019,8,7,11,1270,1328,2616,1288
2019,8,7,12,1315,1371,2633,1262
2019,8,7,13,1375,1445,2662,1217
2019,8,7,14,1455,1506,2595,1089
2019,8,7,15,1520,1561,2594,1033
2019,8,7,16,1570,1590,2614,1024
2019,8,7,17,1630,1632,2642,1010
2019,8,7,18,1675,1672,2677,1005
2019,8,7,19,1725,1707,2714,1007
2019,8,7,20,1770,1763,2738,975
2019,8,7,21,1825,1797,2731,934
2019,8,7,22,1855,1840,2734,894
2019,8,7,23,1880,1880,2749,869
2019,8,8,0,1855,1863,2739,876
2019,8,8,1,1815,1849,2735,886
2019,8,8,2,1780,1821,2767,946
2019,8,8,3,1720,1744,2721,977
2019,8,8,4,1650,1719,2720,1001
2019,8,8,5,1560,1610,2678,1068
2019,8,8,6,1450,1500,2669,1169
2019,8,8,7,1365,1418,2491,1073
2019,8,8,8,1330,1358,2473,1115
2019,8,8,9,1300,1327,2467,1140
2019,8,8,10,1280,1321,2465,1144
2019,8,8,11,1290,1321,2460,1139
2019,8,8,12,1315,1361,2542,1181
2019,8,8,13,1385,1429,2560,1131
2019,8,8,14,1475,1500,2544,1044
2019,8,8,15,1540,1569,2570,1001
2019,8,8,16,1585,1612,2594,982
2019,8,8,17,1645,1670,2613,943
2019,8,8,18,1705,1707,2602,895
2019,8,8,19,1740,1746,2597,851
2019,8,8,20,1785,1817,2659,842
2019,8,8,21,1830,1862,2712,850
2019,8,8,22,1855,1888,2670,782
2019,8,8,23,1865,1885,2660,775
2019,8,9,0,1840,1846,2676,830
2019,8,9,1,1790,1798,2671,873
2019,8,9,2,1750,1747,2623,876
2019,8,9,3,1700,1706,2614,908
2019,8,9,4,1640,1648,2620,972
2019,8,9,5,1565,1568,2624,1056
2019,8,9,6,1445,1480,2671,1191
2019,8,9,7,1370,1408,2643,1235
2019,8,9,8,1325,1391,2639,1248
2019,8,9,9,1300,1348,2640,1292
2019,8,9,10,1290,1336,2634,1298
2019,8,9,11,1285,1342,2637,1295
2019,8,9,12,1310,1378,2691,1313
2019,8,9,13,1325,1441,2717,1276
2019,8,9,14,1370,1501,2722,1221
2019,8,9,15,1425,1539,2698,1159
2019,8,9,16,1470,1583,2721,1138
2019,8,9,17,1525,1616,2735,1119
2019,8,9,18,1555,1649,2737,1088
2019,8,9,19,1600,1671,2752,1081
2019,8,9,20,1655,1708,2733,1025
2019,8,9,21,1685,1716,2739,1023
2019,8,9,22,1705,1743,2759,1016
2019,8,9,23,1720,1694,2751,1057
2019,8,10,0,1700,1694,2763,1069
2019,8,10,1,1675,1668,2783,1115
2019,8,10,2,1625,1615,2735,1120
2019,8,10,3,1575,1573,2671,1098
2019,8,10,4,1505,1545,2651,1106
2019,8,10,5,1445,1484,2651,1167
2019,8,10,6,1350,1394,2653,1259
2019,8,10,7,1355,1346,2644,1298
2019,8,10,8,1305,1308,2678,1370
2019,8,10,9,1295,1277,2666,1389
2019,8,10,10,1280,1258,2661,1403
2019,8,10,11,1270,1257,2654,1397
2019,8,10,12,1285,1266,2686,1420
2019,8,10,13,1265,1294,2653,1359
2019,8,10,14,1270,1327,2607,1280
2019,8,10,15,1320,1396,2639,1243
2019,8,10,16,1390,1436,2649,1213
2019,8,10,17,1435,1482,2661,1179
2019,8,10,18,1485,1504,2606,1102
2019,8,10,19,1520,1529,2679,1150
2019,8,10,20,1555,1565,2688,1123
2019,8,10,21,1585,1578,2737,1159
2019,8,10,22,1615,1605,2778,1173
2019,8,10,23,1630,1601,2817,1216
2019,8,11,0,1640,1551,2820,1269
2019,8,11,1,1630,1534,2805,1271
2019,8,11,2,1590,1516,2743,1227
2019,8,11,3,1555,1475,2760,1285
2019,8,11,4,1500,1463,2755,1292
2019,8,11,5,1425,1391,2682,1291
2019,8,11,6,1335,1323,2779,1456
2019,8,11,7,1350,1298,2733,1435
2019,8,11,8,1295,1255,2629,1374
2019,8,11,9,1275,1242,2617,1375
2019,8,11,10,1250,1227,2531,1304
2019,8,11,11,1260,1230,2529,1299
2019,8,11,12,1265,1236,2533,1297
2019,8,11,13,1225,1260,2525,1265
2019,8,11,14,1205,1299,2547,1248
2019,8,11,15,1260,1349,2564,1215
2019,8,11,16,1320,1390,2561,1171
2019,8,11,17,1370,1402,2573,1171
2019,8,11,18,1410,1441,2585,1144
2019,8,11,19,1450,1485,2625,1140
2019,8,11,20,1495,1486,2640,1154
2019,8,11,21,1535,1495,2686,1191
2019,8,11,22,1570,1510,2688,1178
2019,8,11,23,1600,1524,2711,1187
2019,8,12,0,1605,1523,2784,1261
2019,8,12,1,1595,1510,2795,1285
2019,8,12,2,1560,1452,2746,1294
2019,8,12,3,1520,1417,2672,1255
2019,8,12,4,1480,1416,2748,1332
2019,8,12,5,1380,1329,2669,1340
2019,8,12,6,1280,1274,2725,1451
2019,8,12,7,1315,1241,2728,1487
2019,8,12,8,1265,1224,2679,1455
2019,8,12,9,1240,1205,2698,1493
2019,8,12,10,1230,1209,2635,1426
2019,8,12,11,1235,1214,2659,1445
2019,8,12,12,1265,1265,2772,1507
2019,8,12,13,1275,1342,2840,1498
2019,8,12,14,1315,1418,2899,1481
2019,8,12,15,1370,1414,2887,1473
2019,8,12,16,1415,1411,2925,1514
2019,8,12,17,1465,1432,2950,1518
2019,8,12,18,1510,1463,2961,1498
2019,8,12,19,1545,1475,2956,1481
2019,8,12,20,1600,1475,2917,1442
2019,8,12,21,1635,1491,2909,1418
2019,8,12,22,1665,1488,2882,1394
2019,8,12,23,1680,1514,2890,1376
2019,8,13,0,1670,1514,2902,1388
2019,8,13,1,1655,1522,2875,1353
2019,8,13,2,1625,1499,2805,1306
2019,8,13,3,1565,1461,2757,1296
2019,8,13,4,1480,1459,2775,1316
2019,8,13,5,1405,1393,2714,1321
2019,8,13,6,1300,1320,2690,1370
2019,8,13,7,1250,1266,2656,1390
2019,8,13,8,1215,1243,2680,1437
2019,8,13,9,1185,1222,2618,1396
2019,8,13,10,1170,1222,2594,1372
2019,8,13,11,1175,1223,2596,1373
2019,8,13,12,1200,1280,2626,1346
2019,8,13,13,1245,1349,2682,1333
2019,8,13,14,1295,1400,2624,1224
2019,8,13,15,1345,1411,2558,1147
2019,8,13,16,1380,1446,2583,1137
2019,8,13,17,1420,1450,2571,1121
2019,8,13,18,1470,1493,2602,1109
2019,8,13,19,1505,1511,2614,1103
2019,8,13,20,1550,1549,2611,1062
2019,8,13,21,1585,1576,2630,1054
2019,8,13,22,1605,1610,2657,1047
2019,8,13,23,1630,1655,2695,1040
2019,8,14,0,1620,1655,2714,1059
2019,8,14,1,1600,1661,2735,1074
2019,8,14,2,1555,1621,2771,1150
2019,8,14,3,1530,1616,2862,1246
2019,8,14,4,1480,1552,2843,1291
2019,8,14,5,1385,1460,2849,1389
2019,8,14,6,1295,1362,2857,1495
2019,8,14,7,1270,1306,2673,1367
2019,8,14,8,1220,1284,2677,1393
2019,8,14,9,1200,1252,2657,1405
2019,8,14,10,1190,1247,2693,1446
2019,8,14,11,1195,1246,2697,1451
2019,8,14,12,1235,1291,2674,1383
2019,8,14,13,1285,1356,2669,1313
2019,8,14,14,1330,1420,2637,1217
2019,8,14,15,1370,1448,2521,1073
2019,8,14,16,1390,1480,2499,1019
2019,8,14,17,1425,1516,2507,991
2019,8,14,18,1460,1539,2528,989
2019,8,14,19,1490,1575,2600,1025
2019,8,14,20,1530,1622,2632,1010
2019,8,14,21,1560,1647,2652,1005
2019,8,14,22,1585,1686,2627,941
2019,8,14,23,1620,1715,2617,902
2019,8,15,0,1605,1707,2697,990
2019,8,15,1,1595,1700,2701,1001
2019,8,15,2,1570,1672,2618,946
2019,8,15,3,1510,1654,2655,1001
2019,8,15,4,1470,1584,2653,1069
2019,8,15,5,1395,1485,2652,1167
2019,8,15,6,1305,1393,2696,1303
2019,8,15,7,1295,1328,2687,1359
2019,8,15,8,1255,1288,2717,1429
2019,8,15,9,1225,1277,2733,1456
2019,8,15,10,1220,1252,2661,1409
2019,8,15,11,1220,1265,2610,1345
2019,8,15,12,1255,1303,2604,1301
2019,8,15,13,1285,1372,2671,1299
2019,8,15,14,1320,1437,2665,1228
2019,8,15,15,1365,1478,2599,1121
2019,8,15,16,1405,1511,2594,1083
2019,8,15,17,1450,1552,2627,1075
2019,8,15,18,1490,1573,2586,1013
2019,8,15,19,1520,1592,2649,1057
2019,8,15,20,1575,1630,2650,1020
2019,8,15,21,1610,1639,2599,960
2019,8,15,22,1635,1668,2600,932
2019,8,15,23,1645,1673,2612,939
2019,8,16,0,1615,1669,2617,948
2019,8,16,1,1580,1638,2642,1004
2019,8,16,2,1535,1602,2604,1002
2019,8,16,3,1505,1563,2614,1051
2019,8,16,4,1470,1531,2538,1007
2019,8,16,5,1375,1440,2543,1103
2019,8,16,6,1290,1342,2555,1213
2019,8,16,7,1275,1281,2574,1293
2019,8,16,8,1250,1254,2612,1358
2019,8,16,9,1215,1233,2555,1322
2019,8,16,10,1210,1232,2538,1306
2019,8,16,11,1210,1238,2536,1298
2019,8,16,12,1245,1272,2558,1286
2019,8,16,13,1295,1329,2572,1243
2019,8,16,14,1350,1390,2589,1199
2019,8,16,15,1385,1444,2612,1168
2019,8,16,16,1425,1481,2670,1189
2019,8,16,17,1465,1503,2712,1209
2019,8,16,18,1490,1534,2678,1144
2019,8,16,19,1520,1541,2725,1184
2019,8,16,20,1560,1555,2697,1142
2019,8,16,21,1575,1580,2703,1123
2019,8,16,22,1600,1594,2727,1133
2019,8,16,23,1575,1623,2804,1181
2019,8,17,0,1570,1622,2793,1171
2019,8,17,1,1545,1594,2751,1157
2019,8,17,2,1505,1530,2717,1187
2019,8,17,3,1470,1526,2734,1208
2019,8,17,4,1430,1497,2705,1208
2019,8,17,5,1360,1430,2703,1273
2019,8,17,6,1275,1360,2650,1290
2019,8,17,7,1275,1315,2550,1235
2019,8,17,8,1235,1276,2555,1279
2019,8,17,9,1210,1257,2543,1286
2019,8,17,10,1195,1248,2494,1246
2019,8,17,11,1195,1237,2466,1229
2019,8,17,12,1210,1255,2448,1193
2019,8,17,13,1230,1281,2490,1209
2019,8,17,14,1260,1315,2468,1153
2019,8,17,15,1320,1370,2464,1094
2019,8,17,16,1360,1397,2468,1071
2019,8,17,17,1400,1423,2474,1051
2019,8,17,18,1430,1413,2457,1044
2019,8,17,19,1455,1404,2464,1060
2019,8,17,20,1490,1395,2474,1079
2019,8,17,21,1500,1386,2479,1093
2019,8,17,22,1530,1399,2472,1073
2019,8,17,23,1530,1400,2464,1064
2019,8,18,0,1500,1401,2466,1065
2019,8,18,1,1480,1390,2463,1073
2019,8,18,2,1455,1382,2463,1081
2019,8,18,3,1420,1394,2438,1044
2019,8,18,4,1380,1391,2448,1057
2019,8,18,5,1330,1353,2443,1090
2019,8,18,6,1250,1272,2430,1158
2019,8,18,7,1290,1237,2396,1159
2019,8,18,8,1235,1198,2255,1057
2019,8,18,9,1220,1182,2240,1058
2019,8,18,10,1190,1177,2222,1045
2019,8,18,11,1205,1182,2233,1051
2019,8,18,12,1205,1195,2238,1043
2019,8,18,13,1230,1234,2349,1115
2019,8,18,14,1265,1254,2352,1098
2019,8,18,15,1320,1312,2365,1053
2019,8,18,16,1380,1342,2395,1053
2019,8,18,17,1420,1381,2521,1140
2019,8,18,18,1465,1409,2576,1167
2019,8,18,19,1505,1432,2607,1175
2019,8,18,20,1540,1439,2580,1141
2019,8,18,21,1570,1468,2598,1130
2019,8,18,22,1605,1499,2580,1081
2019,8,18,23,1635,1554,2545,991
2019,8,19,0,1640,1576,2544,968
2019,8,19,1,1630,1603,2500,897
2019,8,19,2,1590,1584,2499,915
2019,8,19,3,1550,1577,2513,936
2019,8,19,4,1370,1553,2506,953
2019,8,19,5,1415,1436,2455,1019
2019,8,19,6,1320,1351,2393,1042
2019,8,19,7,1300,1276,2303,1027
2019,8,19,8,1255,1244,2235,991
2019,8,19,9,1230,1236,2239,1003
2019,8,19,10,1220,1217,2251,1034
2019,8,19,11,1225,1229,2320,1091
2019,8,19,12,1265,1269,2344,1075
2019,8,19,13,1365,1353,2332,979
2019,8,19,14,1480,1425,2270,845
2019,8,19,15,1525,1477,2332,855
2019,8,19,16,1560,1532,2330,798
2019,8,19,17,1600,1571,2418,847
2019,8,19,18,1650,1613,2431,818
2019,8,19,19,1680,1668,2495,827
2019,8,19,20,1720,1720,2551,831
2019,8,19,21,1750,1765,2544,779
2019,8,19,22,1775,1809,2513,704
2019,8,19,23,1795,1843,2478,635
2019,8,20,0,1790,1847,2463,616
2019,8,20,1,1785,1839,2472,633
2019,8,20,2,1755,1795,2526,731
2019,8,20,3,1695,1738,2570,832
2019,8,20,4,1640,1694,2578,884
2019,8,20,5,1545,1575,2553,978
2019,8,20,6,1430,1469,2616,1147
2019,8,20,7,1290,1392,2556,1164
2019,8,20,8,1255,1353,2611,1258
2019,8,20,9,1220,1326,2632,1306
2019,8,20,10,1210,1302,2623,1321
2019,8,20,11,1210,1307,2611,1304
2019,8,20,12,1250,1344,2640,1296
2019,8,20,13,1350,1409,2666,1257
2019,8,20,14,1445,1469,2654,1185
2019,8,20,15,1485,1516,2621,1105
2019,8,20,16,1520,1559,2630,1071
2019,8,20,17,1560,1592,2644,1052
2019,8,20,18,1615,1618,2667,1049
2019,8,20,19,1645,1652,2674,1022
2019,8,20,20,1695,1703,2705,1002
2019,8,20,21,1740,1772,2775,1003
2019,8,20,22,1775,1780,2782,1002
2019,8,20,23,1810,1802,2792,990
2019,8,21,0,1805,1802,2777,975
2019,8,21,1,1795,1777,2765,988
2019,8,21,2,1755,1741,2775,1034
2019,8,21,3,1745,1706,2786,1080
2019,8,21,4,1640,1659,2800,1141
2019,8,21,5,1565,1536,2687,1151
2019,8,21,6,1455,1441,2622,1181
2019,8,21,7,1370,1374,2626,1252
2019,8,21,8,1315,1340,2599,1259
2019,8,21,9,1285,1299,2579,1280
2019,8,21,10,1275,1286,2568,1282
2019,8,21,11,1275,1281,2563,1282
2019,8,21,12,1320,1322,2588,1266
2019,8,21,13,1415,1399,2646,1247
2019,8,21,14,1500,1456,2505,1049
2019,8,21,15,1550,1513,2601,1088
2019,8,21,16,1585,1568,2621,1053
2019,8,21,17,1625,1604,2619,1015
2019,8,21,18,1660,1646,2624,978
2019,8,21,19,1700,1698,2631,933
2019,8,21,20,1755,1742,2681,939
2019,8,21,21,1790,1814,2738,924
2019,8,21,22,1830,1869,2773,904
2019,8,21,23,1870,1895,2810,915
2019,8,22,0,1855,1898,2821,923
2019,8,22,1,1845,1886,2790,904
2019,8,22,2,1810,1827,2716,889
2019,8,22,3,1750,1777,2740,963
2019,8,22,4,1370,1695,2665,970
2019,8,22,5,1595,1619,2747,1128
2019,8,22,6,1485,1490,2689,1199
2019,8,22,7,1325,1411,2626,1215
2019,8,22,8,1280,1377,2547,1170
2019,8,22,9,1265,1341,2513,1172
2019,8,22,10,1245,1300,2479,1179
2019,8,22,11,1255,1233,2429,1196
2019,8,22,12,1290,1383,2589,1206
2019,8,22,13,1330,1434,2617,1183
2019,8,22,14,1365,1478,2586,1108
2019,8,22,15,1410,1567,2693,1126
2019,8,22,16,1445,1560,2651,1091
2019,8,22,17,1485,1633,2785,1152
2019,8,22,18,1510,1651,2838,1187
2019,8,22,19,1535,1667,2799,1132
2019,8,22,20,1580,1706,2823,1117
2019,8,22,21,1600,1715,2810,1095
2019,8,22,22,1630,1712,2819,1107
2019,8,22,23,1635,1703,2823,1120
2019,8,23,0,1625,1655,2811,1156
2019,8,23,1,1595,1621,2759,1138
2019,8,23,2,1555,1558,2777,1219
2019,8,23,3,1520,1534,2724,1190
2019,8,23,4,1440,1492,2719,1227
2019,8,23,5,1390,1412,2587,1175
2019,8,23,6,1295,1329,2617,1288
2019,8,23,7,1240,1275,2541,1266
2019,8,23,8,1210,1246,2648,1402
2019,8,23,9,1190,1262,2693,1431
2019,8,23,10,1185,1232,2593,1361
2019,8,23,11,1190,1243,2603,1360
2019,8,23,12,1220,1280,2648,1368
2019,8,23,13,1270,1352,2718,1366
2019,8,23,14,1315,1413,2662,1249
2019,8,23,15,1365,1441,2649,1208
2019,8,23,16,1405,1466,2656,1190
2019,8,23,17,1430,1464,2648,1184
2019,8,23,18,1465,1504,2689,1185
2019,8,23,19,1475,1511,2698,1187
2019,8,23,20,1500,1546,2707,1161
2019,8,23,21,1530,1579,2717,1138
2019,8,23,22,1550,1597,2775,1178
2019,8,23,23,1565,1629,2782,1153
2019,8,24,0,1565,1627,2747,1120
2019,8,24,1,1540,1600,2710,1110
2019,8,24,2,1485,1580,2746,1166
2019,8,24,3,1465,1558,2766,1208
2019,8,24,4,1420,1519,2762,1243
2019,8,24,5,1365,1448,2698,1250
2019,8,24,6,1285,1354,2596,1242
2019,8,24,7,1275,1295,2534,1239
2019,8,24,8,1235,1239,2443,1204
2019,8,24,9,1205,1239,2455,1216
2019,8,24,10,1190,1235,2590,1355
2019,8,24,11,1180,1227,2597,1370
2019,8,24,12,1205,1231,2615,1384
2019,8,24,13,1265,1271,2652,1381
2019,8,24,14,1335,1307,2562,1255
2019,8,24,15,1400,1349,2592,1243
2019,8,24,16,1435,1408,2601,1193
2019,8,24,17,1475,1452,2686,1234
2019,8,24,18,1495,1488,2720,1232
2019,8,24,19,1510,1492,2779,1287
2019,8,24,20,1535,1509,2766,1257
2019,8,24,21,1540,1530,2778,1248
2019,8,24,22,1560,1572,2781,1209
2019,8,24,23,1555,1612,2755,1143
2019,8,25,0,1520,1610,2719,1109
2019,8,25,1,1500,1594,2723,1129
2019,8,25,2,1480,1570,2724,1154
2019,8,25,3,1455,1561,2726,1165
2019,8,25,4,1410,1531,2744,1213
2019,8,25,5,1385,1440,2729,1289
2019,8,25,6,1305,1369,2719,1350
2019,8,25,7,1245,1298,2647,1349
2019,8,25,8,1205,1260,2557,1297
2019,8,25,9,1190,1226,2536,1310
2019,8,25,10,1170,1191,2476,1285
2019,8,25,11,1170,1207,2476,1269
2019,8,25,12,1190,1195,2474,1279
2019,8,25,13,1220,1220,2506,1286
2019,8,25,14,1250,1253,2542,1289
2019,8,25,15,1305,1322,2602,1280
2019,8,25,16,1340,1376,2615,1239
2019,8,25,17,1365,1391,2697,1306
2019,8,25,18,1400,1431,2734,1303
2019,8,25,19,1430,1469,2821,1352
2019,8,25,20,1440,1482,2842,1360
2019,8,25,21,1450,1486,2848,1362
2019,8,25,22,1470,1508,2925,1417
2019,8,25,23,1490,1503,2919,1416
2019,8,26,0,1490,1526,2972,1446
2019,8,26,1,1485,1504,2937,1433
2019,8,26,2,1435,1483,2955,1472
2019,8,26,3,1410,1463,2925,1462
2019,8,26,4,1370,1437,2863,1426
2019,8,26,5,1310,1346,2791,1445
2019,8,26,6,1245,1252,2679,1427
2019,8,26,7,1200,1204,2559,1355
2019,8,26,8,1180,1174,2451,1277
2019,8,26,9,1160,1160,2437,1277
2019,8,26,10,1155,1158,2424,1266
2019,8,26,11,1155,1179,2425,1246
2019,8,26,12,1210,1227,2483,1256
2019,8,26,13,1280,1321,2559,1238
2019,8,26,14,1345,1390,2617,1227
2019,8,26,15,1365,1412,2630,1218
2019,8,26,16,1370,1447,2671,1224
2019,8,26,17,1395,1480,2732,1252
2019,8,26,18,1430,1486,2757,1271
2019,8,26,19,1450,1487,2737,1250
2019,8,26,20,1465,1504,2726,1222
2019,8,26,21,1490,1510,2729,1219
2019,8,26,22,1495,1540,2735,1195
2019,8,26,23,1520,1538,2720,1182
2019,8,27,0,1515,1549,2756,1207
2019,8,27,1,1520,1549,2755,1206
2019,8,27,2,1485,1519,2776,1257
2019,8,27,3,1445,1521,2817,1296
2019,8,27,4,1400,1497,2892,1395
2019,8,27,5,1355,1380,2818,1438
2019,8,27,6,1275,1279,2725,1446
2019,8,27,7,1210,1227,2680,1453
2019,8,27,8,1175,1204,2653,1449
2019,8,27,9,1150,1198,2636,1438
2019,8,27,10,1130,1194,2636,1442
2019,8,27,11,1135,1195,2620,1425
2019,8,27,12,1160,1250,2654,1404
2019,8,27,13,1235,1336,2725,1389
2019,8,27,14,1310,1390,2614,1224
2019,8,27,15,1350,1423,2556,1133
2019,8,27,16,1395,1390,2523,1133
2019,8,27,17,1420,1451,2559,1108
2019,8,27,18,1450,1469,2596,1127
2019,8,27,19,1480,1484,2609,1125
2019,8,27,20,1520,1496,2628,1132
2019,8,27,21,1560,1513,2670,1157
2019,8,27,22,1580,1547,2679,1132
2019,8,27,23,1600,1570,2690,1120
2019,8,28,0,1600,1572,2682,1110
2019,8,28,1,1580,1585,2685,1100
2019,8,28,2,1550,1545,2698,1153
2019,8,28,3,1525,1529,2684,1155
2019,8,28,4,1450,1486,2670,1184
2019,8,28,5,1375,1382,2637,1255
2019,8,28,6,1280,1291,2648,1357
2019,8,28,7,1215,1244,2626,1382
2019,8,28,8,1180,1204,2598,1394
2019,8,28,9,1145,1203,2606,1403
2019,8,28,10,1140,1187,2610,1423
2019,8,28,11,1145,1193,2586,1393
2019,8,28,12,1185,1233,2599,1366
2019,8,28,13,1335,1318,2660,1342
2019,8,28,14,1460,1388,2631,1243
2019,8,28,15,1500,1409,2645,1236
2019,8,28,16,1545,1423,2607,1184
2019,8,28,17,1585,1454,2673,1219
2019,8,28,18,1615,1493,2685,1192
2019,8,28,19,1660,1525,2704,1179
2019,8,28,20,1700,1557,2742,1185
2019,8,28,21,1750,1597,2770,1173
2019,8,28,22,1800,1648,2806,1158
2019,8,28,23,1820,1687,2827,1140
2019,8,29,0,1820,1713,2842,1129
2019,8,29,1,1810,1703,2826,1123
2019,8,29,2,1765,1685,2844,1159
2019,8,29,3,1730,1637,2861,1224
2019,8,29,4,1650,1578,2801,1223
2019,8,29,5,1560,1448,2755,1307
2019,8,29,6,1440,1340,2713,1373
2019,8,29,7,1300,1271,2744,1473
2019,8,29,8,1270,1243,2717,1474
2019,8,29,9,1245,1209,2634,1425
2019,8,29,10,1215,1175,2173,998
2019,8,29,11,1175,1144,2011,867
2019,8,29,12,1285,1222,2405,1183
2019,8,29,13,1340,1328,2573,1245
2019,8,29,14,1380,1407,2617,1210
2019,8,29,15,1450,1430,2576,1146
2019,8,29,16,1440,1448,2580,1132
2019,8,29,17,1505,1488,2611,1123
2019,8,29,18,1525,1511,2642,1131
2019,8,29,19,1540,1533,2643,1110
2019,8,29,20,1570,1561,2657,1096
2019,8,29,21,1580,1567,2672,1105
2019,8,29,22,1590,1550,2670,1120
2019,8,29,23,1590,1557,2673,1116
2019,8,30,0,1565,1543,2682,1139
2019,8,30,1,1540,1517,2684,1167
2019,8,30,2,1490,1507,2641,1134
2019,8,30,3,1465,1516,2633,1117
2019,8,30,4,1420,1450,2657,1207
2019,8,30,5,1340,1369,2639,1270
2019,8,30,6,1255,1296,2692,1396
2019,8,30,7,1180,1241,2682,1441
2019,8,30,8,1145,1209,2632,1423
2019,8,30,9,1145,1196,2621,1425
2019,8,30,10,1130,1184,2630,1446
2019,8,30,11,1135,1190,2618,1428
2019,8,30,12,1175,1236,2620,1384
2019,8,30,13,1240,1310,2662,1352
2019,8,30,14,1295,1384,2661,1277
2019,8,30,15,1320,1414,2645,1231
2019,8,30,16,1340,1451,2651,1200
2019,8,30,17,1360,1460,2692,1232
2019,8,30,18,1395,1463,2737,1274
2019,8,30,19,1415,1477,2732,1255
2019,8,30,20,1445,1504,2729,1225
2019,8,30,21,1475,1517,2564,1047
2019,8,30,22,1510,1538,2444,906
2019,8,30,23,1545,1556,2444,888
2019,8,31,0,1555,1548,2444,896
2019,8,31,1,1540,1529,2444,915
2019,8,31,2,1515,1505,2448,943
2019,8,31,3,1485,1494,2477,983
2019,8,31,4,1440,1450,2505,1055
2019,8,31,5,1340,1376,2461,1085
2019,8,31,6,1245,1295,2410,1115
2019,8,31,7,1220,1237,2415,1178
2019,8,31,8,1170,1193,2343,1150
2019,8,31,9,1160,1183,2302,1119
2019,8,31,10,1150,1177,2307,1130
2019,8,31,11,1140,1164,2312,1148
2019,8,31,12,1155,1172,2326,1154
2019,8,31,13,1240,1197,2335,1138
2019,8,31,14,1315,1234,2321,1087
2019,8,31,15,1355,1281,2310,1029
2019,8,31,16,1405,1327,2324,997
2019,8,31,17,1445,1344,2345,1001
2019,8,31,18,1465,1392,2391,999
2019,8,31,19,1475,1421,2442,1021
2019,8,31,20,1490,1455,2486,1031
2019,8,31,21,1505,1492,2484,992
2019,8,31,22,1530,1519,2473,954
2019,8,31,23,1560,1555,2458,903
2019,9,1,0,1560,1576,2447,871
2019,9,1,1,1540,1577,2445,868
2019,9,1,2,1520,1553,2484,931
2019,9,1,3,1515,1518,2434,916
2019,9,1,4,1470,1463,2395,932
2019,9,1,5,1400,1380,2381,1001
2019,9,1,6,1325,1322,2408,1086
2019,9,1,7,1230,1272,2401,1129
2019,9,1,8,1195,1226,2320,1094
2019,9,1,9,1170,1208,2320,1112
2019,9,1,10,1160,1194,2326,1132
2019,9,1,11,1160,1187,2321,1134
2019,9,1,12,1180,1194,2320,1126
2019,9,1,13,1235,1221,2319,1098
2019,9,1,14,1285,1242,2346,1104
2019,9,1,15,1340,1309,2386,1077
2019,9,1,16,1370,1349,2376,1027
2019,9,1,17,1405,1389,2383,994
2019,9,1,18,1435,1435,2423,988
2019,9,1,19,1460,1458,2457,999
2019,9,1,20,1475,1515,2464,949
2019,9,1,21,1495,1556,2466,910
2019,9,1,22,1520,1594,2472,878
2019,9,1,23,1560,1636,2457,821
2019,9,2,0,1570,1654,2480,826
2019,9,2,1,1580,1658,2538,880
2019,9,2,2,1565,1610,2555,945
2019,9,2,3,1555,1574,2538,964
2019,9,2,4,1500,1525,2576,1051
2019,9,2,5,1415,1448,2511,1063
2019,9,2,6,1325,1361,2479,1118
2019,9,2,7,1225,1273,2447,1174
2019,9,2,8,1195,1239,2433,1194
2019,9,2,9,1180,1213,2512,1299
2019,9,2,10,1170,1200,2542,1342
2019,9,2,11,1170,1204,2601,1397
2019,9,2,12,1210,1227,2654,1427
2019,9,2,13,1265,1248,2641,1393
2019,9,2,14,1300,1278,2666,1388
2019,9,2,15,1340,1346,2636,1290
2019,9,2,16,1380,1402,2672,1270
2019,9,2,17,1410,1458,2725,1267
2019,9,2,18,1440,1522,2776,1254
2019,9,2,19,1475,1563,2851,1288
2019,9,2,20,1515,1611,2912,1301
2019,9,2,21,1540,1648,2883,1235
2019,9,2,22,1575,1688,2916,1228
2019,9,2,23,1595,1728,2884,1156
2019,9,3,0,1595,1752,2942,1190
2019,9,3,1,1585,1746,2887,1141
2019,9,3,2,1550,1706,2862,1156
2019,9,3,3,1520,1666,2859,1193
2019,9,3,4,1400,1590,2856,1266
2019,9,3,5,1370,1454,2775,1321
2019,9,3,6,1275,1342,2720,1378
2019,9,3,7,1205,1282,2627,1345
2019,9,3,8,1175,1241,2583,1342
2019,9,3,9,1160,1226,2597,1371
2019,9,3,10,1155,1196,2579,1383
2019,9,3,11,1150,1190,2560,1370
2019,9,3,12,1205,1233,2588,1355
2019,9,3,13,1305,1336,2661,1325
2019,9,3,14,1385,1410,2704,1294
2019,9,3,15,1415,1425,2717,1292
2019,9,3,16,1405,1474,2734,1260
2019,9,3,17,1455,1522,2738,1216
2019,9,3,18,1475,1555,2730,1175
2019,9,3,19,1495,1597,2731,1134
2019,9,3,20,1515,1639,2737,1098
2019,9,3,21,1535,1674,2737,1063
2019,9,3,22,1560,1560,631,1033
2019,9,3,23,1580,1755,2736,981
2019,9,4,0,1580,1781,2747,966
2019,9,4,1,1580,1761,2716,955
2019,9,4,2,1545,1719,2734,1015
2019,9,4,3,1530,1682,2716,1034
2019,9,4,4,1445,1598,2663,1065
2019,9,4,5,1375,1465,2639,1174
2019,9,4,6,1285,1351,2633,1282
2019,9,4,7,1275,1296,2602,1306
2019,9,4,8,1235,1258,2597,1339
2019,9,4,9,1210,1237,2620,1383
2019,9,4,10,1195,1224,2632,1408
2019,9,4,11,1200,1251,2654,1403
2019,9,4,12,1235,1290,2681,1391
2019,9,4,13,1340,1395,2769,1374
2019,9,4,14,1430,1451,2789,1338
2019,9,4,15,1470,1486,2812,1326
2019,9,4,16,1515,1528,2770,1242
2019,9,4,17,1555,1584,2752,1168
2019,9,4,18,1595,1649,2834,1185
2019,9,4,19,1645,1706,2897,1191
2019,9,4,20,1695,1772,2853,1081
2019,9,4,21,1750,1801,2847,1046
2019,9,4,22,1805,1834,2883,1049
2019,9,4,23,1835,1849,2878,1029
2019,9,5,0,1845,1846,2866,1020
2019,9,5,1,1835,1815,2796,981
2019,9,5,2,1790,1777,2803,1026
2019,9,5,3,1740,1742,2848,1106
2019,9,5,4,1680,1634,2880,1246
2019,9,5,5,1555,1505,2755,1250
2019,9,5,6,1430,1396,2688,1292
2019,9,5,7,1285,1317,2633,1316
2019,9,5,8,1240,1268,2610,1342
2019,9,5,9,1205,1251,2596,1345
2019,9,5,10,1200,1218,2591,1373
2019,9,5,11,1190,1221,2593,1372
2019,9,5,12,1235,1265,2632,1367
2019,9,5,13,1360,1358,2660,1302
2019,9,5,14,1475,1432,2651,1219
2019,9,5,15,1525,1466,2671,1205
2019,9,5,16,1560,1492,2699,1207
2019,9,5,17,1620,1522,2696,1174
2019,9,5,18,1650,1548,2710,1162
2019,9,5,19,1685,1576,2712,1136
2019,9,5,20,1745,1624,2716,1092
2019,9,5,21,1775,1668,2733,1065
2019,9,5,22,1785,1703,2770,1067
2019,9,5,23,1800,1742,2782,1040
2019,9,6,0,1765,1735,2752,1017
2019,9,6,1,1730,1746,2800,1054
2019,9,6,2,1690,1714,2771,1057
2019,9,6,3,1665,1700,2765,1065
2019,9,6,4,1600,1583,2754,1171
2019,9,6,5,1510,1461,2697,1236
2019,9,6,6,1420,1369,2702,1333
2019,9,6,7,1235,1307,2682,1375
2019,9,6,8,1205,1268,2681,1413
2019,9,6,9,1205,1261,2671,1410
2019,9,6,10,1185,1249,2646,1397
2019,9,6,11,1195,1258,2642,1384
2019,9,6,12,1230,1297,2671,1374
2019,9,6,13,1285,1388,2763,1375
2019,9,6,14,1330,1455,2760,1305
2019,9,6,15,1360,1479,2758,1279
2019,9,6,16,1385,1500,2734,1234
2019,9,6,17,1390,1511,2743,1232
2019,9,6,18,1420,1516,2734,1218
2019,9,6,19,1430,1515,2729,1214
2019,9,6,20,1465,1530,2749,1219
2019,9,6,21,1495,1529,2740,1211
2019,9,6,22,1510,1517,2679,1162
2019,9,6,23,1540,1520,2720,1200
2019,9,7,0,1530,1486,2701,1215
2019,9,7,1,1510,1485,2708,1223
2019,9,7,2,1490,1479,2741,1262
2019,9,7,3,1470,1475,2744,1269
2019,9,7,4,1430,1433,2819,1386
2019,9,7,5,1355,1354,2805,1451
2019,9,7,6,1265,1305,2763,1458
2019,9,7,7,1160,1251,2770,1519
2019,9,7,8,1125,1223,2796,1573
2019,9,7,9,1100,1206,2798,1592
2019,9,7,10,1090,1213,2795,1582
2019,9,7,11,1085,1215,2767,1552
2019,9,7,12,1095,1235,2799,1564
2019,9,7,13,1120,1265,2826,1561
2019,9,7,14,1155,1302,2784,1482
2019,9,7,15,1215,1347,2755,1408
2019,9,7,16,1250,1378,2730,1352
2019,9,7,17,1280,1399,2710,1311
2019,9,7,18,1310,1399,2672,1273
2019,9,7,19,1335,1399,2675,1276
2019,9,7,20,1370,1408,2662,1254
2019,9,7,21,1385,1381,2688,1307
2019,9,7,22,1410,1407,2694,1287
2019,9,7,23,1420,1413,2703,1290
2019,9,8,0,1395,1418,2696,1278
2019,9,8,1,1385,1415,2700,1285
2019,9,8,2,1365,1393,2712,1319
2019,9,8,3,1335,1407,2681,1274
2019,9,8,4,1300,1386,2659,1273
2019,9,8,5,1235,1331,2673,1342
2019,9,8,6,1170,1261,2638,1377
2019,9,8,7,1170,1226,2607,1381
2019,9,8,8,1135,1182,2508,1326
2019,9,8,9,1110,1163,2475,1312
2019,9,8,10,1080,1159,2486,1327
2019,9,8,11,1090,1149,2505,1356
2019,9,8,12,1085,1177,2508,1331
2019,9,8,13,1110,1190,2513,1323
2019,9,8,14,1140,1225,2539,1314
2019,9,8,15,1200,1277,2594,1317
2019,9,8,16,1245,1313,2629,1316
2019,9,8,17,1270,1347,2688,1341
2019,9,8,18,1305,1359,2700,1341
2019,9,8,19,1330,1371,2714,1343
2019,9,8,20,1360,1373,2715,1342
2019,9,8,21,1370,1381,2715,1334
2019,9,8,22,1400,1389,2707,1318
2019,9,8,23,1410,1405,2698,1293
2019,9,9,0,1425,1425,2714,1289
2019,9,9,1,1415,1437,2737,1300
2019,9,9,2,1390,1439,2729,1290
2019,9,9,3,1365,1451,2731,1280
2019,9,9,4,1300,1412,2738,1326
2019,9,9,5,1250,1343,2732,1389
2019,9,9,6,1165,1243,2639,1396
2019,9,9,7,1135,1195,2556,1361
2019,9,9,8,1110,1170,2570,1400
2019,9,9,9,1095,1156,2555,1399
2019,9,9,10,1090,1161,2556,1395
2019,9,9,11,1100,1174,2580,1406
2019,9,9,12,1135,1222,2636,1414
2019,9,9,13,1180,1344,2731,1387
2019,9,9,14,1210,1393,2673,1280
2019,9,9,15,1240,1392,2611,1219
2019,9,9,16,1275,1412,2625,1213
2019,9,9,17,1305,1422,2641,1219
2019,9,9,18,1325,1439,2691,1252
2019,9,9,19,1340,1388,2059,671
2019,9,9,20,1360,1368,1855,487
2019,9,9,21,1380,1378,1883,505
2019,9,9,22,1410,1374,1870,496
2019,9,9,23,1415,1385,1811,426
2019,9,10,0,1430,1370,1813,443
2019,9,10,1,1430,1370,1781,411
2019,9,10,2,1400,1377,1768,391
2019,9,10,3,1390,1381,1755,374
2019,9,10,4,1340,1333,1767,434
2019,9,10,5,1235,1257,1720,463
2019,9,10,6,1145,1178,1723,545
2019,9,10,7,1180,1136,1734,598
2019,9,10,8,1140,1108,1561,453
2019,9,10,9,1130,1091,1679,588
2019,9,10,10,1120,1105,1762,657
2019,9,10,11,1120,1134,2025,891
2019,9,10,12,1155,1207,2529,1322
2019,9,10,13,1255,1335,2701,1366
2019,9,10,14,1335,1404,2625,1221
2019,9,10,15,1360,1430,2611,1181
2019,9,10,16,1385,1431,2622,1191
2019,9,10,17,1410,1439,2611,1172
2019,9,10,18,1420,1437,2591,1154
2019,9,10,19,1430,1437,2583,1146
2019,9,10,20,1440,1448,2609,1161
2019,9,10,21,1450,1451,2638,1187
2019,9,10,22,1430,1443,2636,1193
2019,9,10,23,1460,1452,2641,1189
2019,9,11,0,1445,1436,2655,1219
2019,9,11,1,1440,1444,2688,1244
2019,9,11,2,1430,1447,2611,1164
2019,9,11,3,1415,1440,2479,1039
2019,9,11,4,1335,1390,2428,1038
2019,9,11,5,1285,1311,2410,1099
2019,9,11,6,1220,1244,2410,1166
2019,9,11,7,1130,1213,2510,1297
2019,9,11,8,1110,1195,2599,1404
2019,9,11,9,1095,1196,2618,1422
2019,9,11,10,1095,1184,2608,1424
2019,9,11,11,1110,1195,2614,1419
2019,9,11,12,1150,1257,2665,1408
2019,9,11,13,1240,1380,2722,1342
2019,9,11,14,1275,1473,2747,1274
2019,9,11,15,1280,1465,2732,1267
2019,9,11,16,1300,1462,2734,1272
2019,9,11,17,1320,1477,2732,1255
2019,9,11,18,1350,1482,2748,1266
2019,9,11,19,1335,1464,2752,1288
2019,9,11,20,1340,1452,2743,1291
2019,9,11,21,1355,1457,2741,1284
2019,9,11,22,1365,1471,2781,1310
2019,9,11,23,1380,1466,2766,1300
2019,9,12,0,1375,1457,2741,1284
2019,9,12,1,1370,1463,2739,1276
2019,9,12,2,1365,1466,2728,1262
2019,9,12,3,1355,1480,2753,1273
2019,9,12,4,1275,1421,2725,1304
2019,9,12,5,1215,1322,2561,1239
2019,9,12,6,1130,1258,2553,1295
2019,9,12,7,1175,1221,2541,1320
2019,9,12,8,1145,1207,2560,1353
2019,9,12,9,1125,1210,2554,1344
2019,9,12,10,1125,1207,2594,1387
2019,9,12,11,1135,1227,2625,1398
2019,9,12,12,1190,1269,2669,1400
2019,9,12,13,1285,1389,2715,1326
2019,9,12,14,1340,1446,2707,1261
2019,9,12,15,1365,1438,2669,1231
2019,9,12,16,1375,1429,2674,1245
2019,9,12,17,1390,1427,2688,1261
2019,9,12,18,1400,1427,2715,1288
2019,9,12,19,1405,1429,2711,1282
2019,9,12,20,1430,1434,2714,1280
2019,9,12,21,1440,1426,2726,1300
2019,9,12,22,1445,1445,2735,1290
2019,9,12,23,1460,1448,2700,1252
2019,9,13,0,1450,1452,2694,1242
2019,9,13,1,1455,1445,2663,1218
2019,9,13,2,1445,1467,2646,1179
2019,9,13,3,1445,1471,2622,1151
2019,9,13,4,1340,1422,2624,1202
2019,9,13,5,1290,1334,2631,1297
2019,9,13,6,1215,1271,2652,1381
2019,9,13,7,1185,1220,2633,1413
2019,9,13,8,1155,1199,2679,1480
2019,9,13,9,1160,1194,2659,1465
2019,9,13,10,1140,1183,2681,1498
2019,9,13,11,1145,1206,2705,1499
2019,9,13,12,1190,1249,2684,1435
2019,9,13,13,1270,1359,2718,1359
2019,9,13,14,1340,1436,2761,1325
2019,9,13,15,1360,1415,2618,1203
2019,9,13,16,1375,1419,2678,1259
2019,9,13,17,1385,1435,2661,1226
2019,9,13,18,1405,1446,2677,1231
2019,9,13,19,1410,1457,2751,1294
2019,9,13,20,1430,1470,2785,1315
2019,9,13,21,1450,1470,2772,1302
2019,9,13,22,1455,1492,2775,1283
2019,9,13,23,1475,1497,2797,1300
2019,9,14,0,1460,1478,2726,1248
2019,9,14,1,1450,1439,2673,1234
2019,9,14,2,1435,1454,2692,1238
2019,9,14,3,1420,1462,2678,1216
2019,9,14,4,1340,1417,2687,1270
2019,9,14,5,1310,1359,2700,1341
2019,9,14,6,1235,1283,2630,1347
2019,9,14,7,1210,1237,2577,1340
2019,9,14,8,1175,1223,2643,1420
2019,9,14,9,1155,1195,2573,1378
2019,9,14,10,1130,1196,2603,1407
2019,9,14,11,1145,1194,2672,1478
2019,9,14,12,1145,1201,2659,1458
2019,9,14,13,1200,1235,2637,1402
2019,9,14,14,1260,1280,2643,1363
2019,9,14,15,1310,1322,2638,1316
2019,9,14,16,1350,1355,2651,1296
2019,9,14,17,1370,1393,2734,1341
2019,9,14,18,1390,1397,2721,1324
2019,9,14,19,1415,1403,2695,1292
2019,9,14,20,1430,1415,2690,1275
2019,9,14,21,1425,1434,2713,1279
2019,9,14,22,1445,1447,2653,1206
2019,9,14,23,1445,1481,2675,1194
2019,9,15,0,1460,1500,2737,1237
2019,9,15,1,1450,1490,2763,1273
2019,9,15,2,1430,1463,2671,1208
2019,9,15,3,1420,1466,2704,1238
2019,9,15,4,1380,1415,2657,1242
2019,9,15,5,1310,1346,2586,1240
2019,9,15,6,1225,1285,2572,1287
2019,9,15,7,1220,1245,2593,1348
2019,9,15,8,1175,1206,2620,1414
2019,9,15,9,1160,1196,2635,1439
2019,9,15,10,1145,1191,2637,1446
2019,9,15,11,1145,1182,2631,1449
2019,9,15,12,1160,1192,2644,1452
2019,9,15,13,1200,1216,2579,1363
2019,9,15,14,1230,1242,2477,1235
2019,9,15,15,1290,1305,2484,1179
2019,9,15,16,1320,1349,2509,1160
2019,9,15,17,1355,1382,2582,1200
2019,9,15,18,1390,1410,2530,1120
2019,9,15,19,1405,1438,2501,1063
2019,9,15,20,1440,1468,2573,1105
2019,9,15,21,1470,1500,2577,1077
2019,9,15,22,1495,1529,2633,1104
2019,9,15,23,1525,1586,2711,1125
2019,9,16,0,1545,1608,2747,1139
2019,9,16,1,1550,1607,2787,1180
2019,9,16,2,1520,1560,2702,1142
2019,9,16,3,1505,1567,2715,1148
2019,9,16,4,1430,1488,2720,1232
2019,9,16,5,1375,1390,2677,1287
2019,9,16,6,1290,1300,2666,1366
2019,9,16,7,1205,1248,2627,1379
2019,9,16,8,1175,1218,2664,1446
2019,9,16,9,1155,1212,2691,1479
2019,9,16,10,1150,1192,2651,1459
2019,9,16,11,1160,1204,2638,1434
2019,9,16,12,1190,1237,2654,1417
2019,9,16,13,1255,1350,2754,1404
2019,9,16,14,1300,1408,2724,1316
2019,9,16,15,1340,1432,2686,1254
2019,9,16,16,1375,1461,2680,1219
2019,9,16,17,1415,1472,2698,1226
2019,9,16,18,1460,1487,2706,1219
2019,9,16,19,1470,1510,2722,1212
2019,9,16,20,1500,1546,2708,1162
2019,9,16,21,1525,1551,2734,1183
2019,9,16,22,1550,1572,2723,1151
2019,9,16,23,1575,1593,2748,1155
2019,9,17,0,1585,1590,2830,1240
2019,9,17,1,1585,1584,2703,1119
2019,9,17,2,1560,1557,2770,1213
2019,9,17,3,1540,1539,2700,1161
2019,9,17,4,1440,1480,2736,1256
2019,9,17,5,1360,1400,2699,1299
2019,9,17,6,1265,1310,2676,1366
2019,9,17,7,1185,1263,2622,1359
2019,9,17,8,1160,1215,2612,1397
2019,9,17,9,1140,1195,2587,1392
2019,9,17,10,1145,1185,2520,1335
2019,9,17,11,1160,1205,2642,1437
2019,9,17,12,1205,1259,2563,1304
2019,9,17,13,1265,1371,2672,1301
2019,9,17,14,1285,1455,2723,1268
2019,9,17,15,1310,1445,2603,1158
2019,9,17,16,1325,1447,2588,1141
2019,9,17,17,1340,1459,2625,1166
2019,9,17,18,1350,1480,2785,1305
2019,9,17,19,1360,1469,2729,1260
2019,9,17,20,1380,1474,2747,1273
2019,9,17,21,1390,1476,2818,1342
2019,9,17,22,1375,1482,2867,1385
2019,9,17,23,1415,1482,2841,1359
2019,9,18,0,1415,1472,2797,1325
2019,9,18,1,1415,1466,2790,1324
2019,9,18,2,1405,1477,2890,1413
2019,9,18,3,1400,1483,2894,1411
2019,9,18,4,1340,1430,2883,1453
2019,9,18,5,1260,1357,2805,1448
2019,9,18,6,1180,1281,2694,1413
2019,9,18,7,1185,1255,2687,1432
2019,9,18,8,1160,1228,2659,1431
2019,9,18,9,1150,1202,2604,1402
2019,9,18,10,1140,1192,2530,1338
2019,9,18,11,1155,1215,2574,1359
2019,9,18,12,1205,1261,2623,1362
2019,9,18,13,1310,1356,2723,1367
2019,9,18,14,1370,1413,2680,1267
2019,9,18,15,1380,1409,2646,1237
2019,9,18,16,1385,1423,2656,1233
2019,9,18,17,1400,1419,2654,1235
2019,9,18,18,1415,1420,2669,1249
2019,9,18,19,1415,1419,2675,1256
2019,9,18,20,1425,1427,2633,1206
2019,9,18,21,1430,1439,2636,1197
2019,9,18,22,1445,1456,2669,1213
2019,9,18,23,1450,1471,2654,1183
2019,9,19,0,1440,1463,2670,1207
2019,9,19,1,1445,1459,2694,1235
2019,9,19,2,1435,1478,2725,1247
2019,9,19,3,1435,1469,2722,1253
2019,9,19,4,1370,1407,2707,1300
2019,9,19,5,1280,1320,2688,1368
2019,9,19,6,1205,1265,2654,1389
2019,9,19,7,1210,1223,2616,1393
2019,9,19,8,1165,1210,2635,1425
2019,9,19,9,1155,1210,2690,1480
2019,9,19,10,1145,1120,1914,794
2019,9,19,11,1160,1138,1880,742
2019,9,19,12,1210,1182,1912,730
2019,9,19,13,1310,1307,2077,770
2019,9,19,14,1380,1385,2143,758
2019,9,19,15,1380,1389,2284,895
2019,9,19,16,1380,1420,2440,1020
2019,9,19,17,1390,1447,2597,1150
2019,9,19,18,1405,1447,2606,1159
2019,9,19,19,1400,1448,2602,1154
2019,9,19,20,1410,1442,2601,1159
2019,9,19,21,1415,1433,2626,1193
2019,9,19,22,1425,1439,2640,1201
2019,9,19,23,1430,1447,2648,1201
2019,9,20,0,1425,1433,2640,1207
2019,9,20,1,1425,1427,2619,1192
2019,9,20,2,1430,1438,2638,1200
2019,9,20,3,1435,1446,2664,1218
2019,9,20,4,1380,1399,2672,1273
2019,9,20,5,1290,1318,2606,1288
2019,9,20,6,1215,1250,2517,1267
2019,9,20,7,1160,1210,2541,1331
2019,9,20,8,1135,1188,2525,1337
2019,9,20,9,1125,1180,2469,1289
2019,9,20,10,1120,1174,2456,1282
2019,9,20,11,1135,1190,2471,1281
2019,9,20,12,1180,1237,2491,1254
2019,9,20,13,1290,1331,2597,1266
2019,9,20,14,1365,1424,2583,1159
2019,9,20,15,1360,1437,2550,1113
2019,9,20,16,1365,1437,2544,1107
2019,9,20,17,1375,1459,2564,1105
2019,9,20,18,1380,1461,2574,1113
2019,9,20,19,1390,1439,2554,1115
2019,9,20,20,1400,1446,2572,1126
2019,9,20,21,1400,1451,2572,1121
2019,9,20,22,1415,1435,2567,1132
2019,9,20,23,1420,1449,2551,1102
2019,9,21,0,1405,1475,2594,1119
2019,9,21,1,1380,1468,2627,1159
2019,9,21,2,1390,1462,2705,1243
2019,9,21,3,1395,1466,2676,1210
2019,9,21,4,1365,1423,2673,1250
2019,9,21,5,1275,1367,2702,1335
2019,9,21,6,1210,1334,2713,1379
2019,9,21,7,1175,1290,2718,1428
2019,9,21,8,1155,1253,2718,1465
2019,9,21,9,1135,1226,2639,1413
2019,9,21,10,1135,1229,2604,1375
2019,9,21,11,1140,1209,2616,1407
2019,9,21,12,1160,1207,2599,1392
2019,9,21,13,1195,1264,2602,1338
2019,9,21,14,1235,1329,2619,1290
2019,9,21,15,1275,1370,2640,1270
2019,9,21,16,1310,1387,2665,1278
2019,9,21,17,1330,1391,2708,1317
2019,9,21,18,1335,1394,2723,1329
2019,9,21,19,1335,1395,2711,1316
2019,9,21,20,1345,1383,2665,1282
2019,9,21,21,1335,1376,2693,1317
2019,9,21,22,1355,1370,2692,1322
2019,9,21,23,1365,1373,2709,1336
2019,9,22,0,1375,1390,2684,1294
2019,9,22,1,1370,1395,2736,1341
2019,9,22,2,1350,1428,2691,1263
2019,9,22,3,1360,1427,2675,1248
2019,9,22,4,1320,1393,2691,1298
2019,9,22,5,1270,1343,2690,1347
2019,9,22,6,1200,1293,2738,1445
2019,9,22,7,1205,1258,2676,1418
2019,9,22,8,1170,1249,2770,1521
2019,9,22,9,1155,1222,2726,1504
2019,9,22,10,1145,1219,2714,1495
2019,9,22,11,1140,1232,2763,1531
2019,9,22,12,1160,1234,2773,1539
2019,9,22,13,1170,1280,2799,1519
2019,9,22,14,1180,1301,2748,1447
2019,9,22,15,1230,1332,2725,1393
2019,9,22,16,1265,1368,2790,1422
2019,9,22,17,1295,1386,2837,1451
2019,9,22,18,1310,1387,2840,1453
2019,9,22,19,1330,1397,2852,1455
2019,9,22,20,1335,1387,2783,1396
2019,9,22,21,1350,1387,2750,1363
2019,9,22,22,1360,1396,2770,1374
2019,9,22,23,1390,1415,2796,1381
2019,9,23,0,1405,1439,2789,1350
2019,9,23,1,1410,1448,2767,1319
2019,9,23,2,1400,1480,2760,1280
2019,9,23,3,1400,1465,2746,1281
2019,9,23,4,1350,1408,2752,1344
2019,9,23,5,1270,1318,2715,1397
2019,9,23,6,1185,1248,2697,1449
2019,9,23,7,1180,1213,2653,1440
2019,9,23,8,1155,1190,2634,1444
2019,9,23,9,1145,1186,2659,1473
2019,9,23,10,1140,1202,2663,1461
2019,9,23,11,1155,1207,2644,1437
2019,9,23,12,1200,1259,2638,1379
2019,9,23,13,1315,1379,2758,1379
2019,9,23,14,1370,1462,2803,1341
2019,9,23,15,1375,1460,2799,1339
2019,9,23,16,1395,1480,2804,1324
2019,9,23,17,1405,1483,2764,1281
2019,9,23,18,1425,1469,2761,1292
2019,9,23,19,1405,1450,2733,1283
2019,9,23,20,1405,1474,2791,1317
2019,9,23,21,1410,1471,2740,1269
2019,9,23,22,1420,1475,2754,1279
2019,9,23,23,1430,1476,2673,1197
2019,9,24,0,1415,1478,2818,1340
2019,9,24,1,1415,1478,2799,1321
2019,9,24,2,1415,1499,2708,1209
2019,9,24,3,1415,1504,2733,1229
2019,9,24,4,1370,1450,2734,1284
2019,9,24,5,1280,1363,2687,1324
2019,9,24,6,1200,1289,2697,1408
2019,9,24,7,1200,1251,2690,1439
2019,9,24,8,1155,1232,2706,1474
2019,9,24,9,1140,1237,2770,1533
2019,9,24,10,1135,1233,2807,1574
2019,9,24,11,1155,1259,2847,1588
2019,9,24,12,1195,1295,2897,1602
2019,9,24,13,1305,1420,2931,1511
2019,9,24,14,1370,1494,2933,1439
2019,9,24,15,1380,1460,2873,1413
2019,9,24,16,1390,1472,2856,1384
2019,9,24,17,1400,1497,2888,1391
2019,9,24,18,1410,1490,2931,1441
2019,9,24,19,1405,1508,2956,1448
2019,9,24,20,1405,1489,2884,1395
2019,9,24,21,1410,1492,2878,1386
2019,9,24,22,1410,1481,2855,1374
2019,9,24,23,1415,1473,2887,1414
2019,9,25,0,1415,1474,2921,1447
2019,9,25,1,1410,1471,2922,1451
2019,9,25,2,1425,1491,2904,1413
2019,9,25,3,1430,1478,2856,1378
2019,9,25,4,1370,1422,2820,1398
2019,9,25,5,1295,1319,2725,1406
2019,9,25,6,1220,1273,2775,1502
2019,9,25,7,1185,1234,2819,1585
2019,9,25,8,1160,1222,2747,1525
2019,9,25,9,1145,1194,2661,1467
2019,9,25,10,1145,1195,2589,1394
2019,9,25,11,1160,1217,2656,1439
2019,9,25,12,1210,1264,2715,1451
2019,9,25,13,1320,1377,2752,1375
2019,9,25,14,1395,1459,2797,1338
2019,9,25,15,1390,1446,2767,1321
2019,9,25,16,1405,1450,2763,1313
2019,9,25,17,1405,1438,2774,1336
2019,9,25,18,1400,1421,2796,1375
2019,9,25,19,1390,1431,2811,1380
2019,9,25,20,1400,1421,2796,1375
2019,9,25,21,1405,1419,2781,1362
2019,9,25,22,1420,1431,2785,1354
2019,9,25,23,1425,1415,2774,1359
2019,9,26,0,1415,1418,2765,1347
2019,9,26,1,1420,1422,2790,1368
2019,9,26,2,1435,1442,2766,1324
2019,9,26,3,1435,1444,2755,1311
2019,9,26,4,1435,1391,2702,1311
2019,9,26,5,1290,1299,2695,1396
2019,9,26,6,1220,1237,2718,1481
2019,9,26,7,1175,1207,2709,1502
2019,9,26,8,1155,1186,2701,1515
2019,9,26,9,1160,1183,2680,1497
2019,9,26,10,1125,1188,2631,1443
2019,9,26,11,1145,1207,2712,1505
2019,9,26,12,1190,1254,2747,1493
2019,9,26,13,1325,1379,2781,1402
2019,9,26,14,1410,1454,2748,1294
2019,9,26,15,1400,1448,2758,1310
2019,9,26,16,1405,1457,2744,1287
2019,9,26,17,1425,1474,2811,1337
2019,9,26,18,1425,1477,2824,1347
2019,9,26,19,1430,1479,2856,1377
2019,9,26,20,1425,1491,2854,1363
2019,9,26,21,1420,1464,2798,1334
2019,9,26,22,1425,1463,2893,1430
2019,9,26,23,1425,1462,2843,1381
2019,9,27,0,1420,1476,2926,1450
2019,9,27,1,1415,1486,2919,1433
2019,9,27,2,1435,1547,2891,1344
2019,9,27,3,1430,1518,2797,1279
2019,9,27,4,1380,1430,2732,1302
2019,9,27,5,1290,1417,2792,1375
2019,9,27,6,1230,1322,2821,1499
2019,9,27,7,1170,1240,2770,1530
2019,9,27,8,1150,1201,2701,1500
2019,9,27,9,1135,1199,2694,1495
2019,9,27,10,1135,1193,2612,1419
2019,9,27,11,1150,1209,2656,1447
2019,9,27,12,1200,1272,2695,1423
2019,9,27,13,1315,1345,2672,1327
2019,9,27,14,1410,1450,2662,1212
2019,9,27,15,1405,1451,2653,1202
2019,9,27,16,1410,1459,2635,1176
2019,9,27,17,1410,1458,2633,1175
2019,9,27,18,1410,1452,2636,1184
2019,9,27,19,1405,1432,2639,1207
2019,9,27,20,1405,1443,2640,1197
2019,9,27,21,1410,1427,2653,1226
2019,9,27,22,1405,1416,2635,1219
2019,9,27,23,1410,1418,2630,1212
2019,9,28,0,1420,1414,2657,1243
2019,9,28,1,1410,1421,2660,1239
2019,9,28,2,1420,1448,2678,1230
2019,9,28,3,1425,1435,2695,1260
2019,9,28,4,1385,1416,2758,1342
2019,9,28,5,1305,1357,2769,1412
2019,9,28,6,1250,1302,2736,1434
2019,9,28,7,1230,1280,2747,1467
2019,9,28,8,1205,1269,2790,1521
2019,9,28,9,1175,1256,2746,1490
2019,9,28,10,1175,1252,2583,1331
2019,9,28,11,1170,1248,2554,1306
2019,9,28,12,1175,1274,2621,1347
2019,9,28,13,1240,1327,2617,1290
2019,9,28,14,1310,1398,2622,1224
2019,9,28,15,1350,1446,2600,1154
2019,9,28,16,1375,1493,2542,1049
2019,9,28,17,1390,1521,2605,1084
2019,9,28,18,1390,1535,2546,1011
2019,9,28,19,1395,1546,2622,1076
2019,9,28,20,1395,1550,2624,1074
2019,9,28,21,1395,1530,2550,1020
2019,9,28,22,1390,1535,2548,1013
2019,9,28,23,1405,1544,2533,989
2019,9,29,0,1425,1552,2523,971
2019,9,29,1,1430,1567,2514,947
2019,9,29,2,1450,1576,2544,968
2019,9,29,3,1450,1574,2686,1112
2019,9,29,4,1415,1517,2709,1192
2019,9,29,5,1335,1466,2700,1234
2019,9,29,6,1275,1427,2724,1297
2019,9,29,7,1170,1402,2721,1319
2019,9,29,8,1150,1386,2700,1314
2019,9,29,9,1125,1391,2685,1294
2019,9,29,10,1120,1372,2683,1311
2019,9,29,11,1125,1391,2706,1315
2019,9,29,12,1125,1424,2707,1283
2019,9,29,13,1205,1475,2729,1254
2019,9,29,14,1270,1521,2752,1231
2019,9,29,15,1310,1569,2750,1181
2019,9,29,16,1345,1594,2737,1143
2019,9,29,17,1360,1596,2771,1175
2019,9,29,18,1365,1541,2143,602
2019,9,29,19,1380,1547,1627,80
2019,9,29,20,1375,1520,1597,77
2019,9,29,21,1385,1502,1609,107
2019,9,29,22,1390,1483,1585,102
2019,9,29,23,1410,1523,1585,62
2019,9,30,0,1435,1550,1582,32
2019,9,30,1,1440,1545,1583,38
2019,9,30,2,1455,1561,1585,24
2019,9,30,3,1450,1526,1597,71
2019,9,30,4,1395,1467,1604,137
2019,9,30,5,1310,1368,1602,234
2019,9,30,6,1240,1281,1529,248
2019,9,30,7,1230,1261,1643,382
2019,9,30,8,1205,1237,1682,445
2019,9,30,9,1195,1242,1690,448
2019,9,30,10,1200,1240,1689,449
2019,9,30,11,1210,1268,1671,403
2019,9,30,12,1260,1343,1683,340
2019,9,30,13,1395,1451,1690,239
2019,9,30,14,1490,1534,1670,136
2019,9,30,15,1490,1541,1664,123
2019,9,30,16,1510,1536,1651,115
2019,9,30,17,1510,1521,1651,130
2019,9,30,18,1500,1505,1660,155
2019,9,30,19,1495,1497,1652,155
2019,9,30,20,1515,1487,1666,179
2019,9,30,21,1515,1465,1683,218
2019,9,30,22,1530,1450,1700,250
2019,9,30,23,1530,1444,1700,256
2019,10,1,0,1525,1452,1698,246
2019,10,1,1,1530,1478,1694,216
2019,10,1,2,1540,1513,1691,178
2019,10,1,3,1535,1513,1664,151
2019,10,1,4,1480,1456,1623,167
2019,10,1,5,1390,1376,1609,233
2019,10,1,6,1305,1315,1596,281
2019,10,1,7,1320,1274,1602,328
2019,10,1,8,1295,1270,1560,290
2019,10,1,9,1295,1261,1540,279
2019,10,1,10,1280,1260,1537,277
2019,10,1,11,1305,1284,1531,247
2019,10,1,12,1340,1343,1605,262
2019,10,1,13,1445,1458,1626,168
2019,10,1,14,1510,1547,1619,72
2019,10,1,15,1530,1554,1608,54
2019,10,1,16,1535,1552,1581,29
2019,10,1,17,1535,1549,1583,34
2019,10,1,18,1530,1527,1612,85
2019,10,1,19,1525,1509,1594,85
2019,10,1,20,1520,1479,1535,56
2019,10,1,21,1520,1454,1516,62
2019,10,1,22,1545,1449,1501,52
2019,10,1,23,1560,1458,1514,56
2019,10,2,0,1580,1454,1511,57
2019,10,2,1,1590,1480,1529,49
2019,10,2,2,1580,1506,1587,81
2019,10,2,3,1570,1510,1568,58
2019,10,2,4,1535,1441,1554,113
2019,10,2,5,1410,1383,1520,137
2019,10,2,6,1335,1339,1546,207
2019,10,2,7,1325,1292,1403,111
2019,10,2,8,1310,1277,1453,176
2019,10,2,9,1295,1293,1484,191
2019,10,2,10,1285,1301,1482,181
2019,10,2,11,1305,1321,1474,153
2019,10,2,12,1345,1389,1483,94
2019,10,2,13,1420,1504,1484,-20
2019,10,2,14,1485,1581,1459,-122
2019,10,2,15,1500,1552,1423,-129
2019,10,2,16,1525,1530,1436,-94
2019,10,2,17,1520,1518,1455,-63
2019,10,2,18,1500,1488,1453,-35
2019,10,2,19,1510,1450,1419,-31
2019,10,2,20,1500,1434,1467,33
2019,10,2,21,1495,1418,1473,55
2019,10,2,22,1495,1310,1360,50
2019,10,2,23,1505,1403,1504,101
2019,10,3,0,1515,1409,1529,120
2019,10,3,1,1520,1422,1529,107
2019,10,3,2,1540,1478,1571,93
2019,10,3,3,1525,1487,1516,29
2019,10,3,4,1485,1433,1479,46
2019,10,3,5,1370,1353,1486,133
2019,10,3,6,1290,1270,1622,352
2019,10,3,7,1275,1239,1678,439
2019,10,3,8,1260,1250,2104,854
2019,10,3,9,1255,1281,2414,1133
2019,10,3,10,1245,1288,2455,1167
2019,10,3,11,1270,1313,2485,1172
2019,10,3,12,1320,1369,2575,1206
2019,10,3,13,1435,1493,2630,1137
2019,10,3,14,1510,1592,2688,1096
2019,10,3,15,1510,1548,2597,1049
2019,10,3,16,1515,1524,2616,1092
2019,10,3,17,1520,1502,2556,1054
2019,10,3,18,1510,1465,2549,1084
2019,10,3,19,1500,1460,2546,1086
2019,10,3,20,1485,1446,2585,1139
2019,10,3,21,1465,1427,2551,1124
2019,10,3,22,1460,1429,2511,1082
2019,10,3,23,1470,1419,2498,1079
2019,10,4,0,1470,1421,2478,1057
2019,10,4,1,1485,1421,2531,1110
2019,10,4,2,1500,1465,2563,1098
2019,10,4,3,1495,1445,2476,1031
2019,10,4,4,1480,1406,2512,1106
2019,10,4,5,1390,1333,2518,1185
2019,10,4,6,1325,1265,2491,1226
2019,10,4,7,1235,1239,2480,1241
2019,10,4,8,1205,1219,2590,1371
2019,10,4,9,1205,1225,2597,1372
2019,10,4,10,1205,1225,2536,1311
2019,10,4,11,1215,1230,2522,1292
2019,10,4,12,1275,1281,2641,1360
2019,10,4,13,1350,1392,2677,1285
2019,10,4,14,1435,1483,2669,1186
2019,10,4,15,1435,1503,2687,1184
2019,10,4,16,1435,1479,2654,1175
2019,10,4,17,1435,1463,2640,1177
2019,10,4,18,1425,1463,2647,1184
2019,10,4,19,1405,1444,2645,1201
2019,10,4,20,1405,1426,2564,1138
2019,10,4,21,1400,1418,2540,1122
2019,10,4,22,1370,1412,2531,1119
2019,10,4,23,1390,1437,2585,1148
2019,10,5,0,1390,1386,2311,925
2019,10,5,1,1395,1412,2211,799
2019,10,5,2,1425,1436,2251,815
2019,10,5,3,1420,1425,2224,799
2019,10,5,4,1400,1397,2189,792
2019,10,5,5,1325,1329,2213,884
2019,10,5,6,1260,1275,2202,927
2019,10,5,7,1180,1249,2319,1070
2019,10,5,8,1170,1232,2390,1158
2019,10,5,9,1165,1208,2375,1167
2019,10,5,10,1160,1215,2374,1159
2019,10,5,11,1165,1224,2400,1176
2019,10,5,12,1190,1246,2389,1143
2019,10,5,13,1245,1285,2409,1124
2019,10,5,14,1305,1347,2479,1132
2019,10,5,15,1330,1428,2508,1080
2019,10,5,16,1360,1422,2528,1106
2019,10,5,17,1370,1424,2536,1112
2019,10,5,18,1370,1430,2543,1113
2019,10,5,19,1375,1421,2537,1116
2019,10,5,20,1370,1412,2534,1122
2019,10,5,21,1355,1404,2523,1119
2019,10,5,22,1350,1404,2537,1133
2019,10,5,23,1360,1410,2533,1123
2019,10,6,0,1365,1407,2530,1123
2019,10,6,1,1375,1428,2533,1105
2019,10,6,2,1395,1457,2531,1074
2019,10,6,3,1385,1436,2523,1087
2019,10,6,4,1305,1404,2501,1097
2019,10,6,5,1285,1335,2499,1164
2019,10,6,6,1240,1311,2667,1356
2019,10,6,7,1185,1297,2797,1500
2019,10,6,8,1175,1279,2863,1584
2019,10,6,9,1175,1266,2871,1605
2019,10,6,10,1165,1256,2852,1596
2019,10,6,11,1185,1269,2847,1578
2019,10,6,12,1205,1294,2835,1541
2019,10,6,13,1250,1330,2814,1484
2019,10,6,14,1290,1386,2808,1422
2019,10,6,15,1320,1413,2805,1392
2019,10,6,16,1340,1447,2874,1427
2019,10,6,17,1350,1437,2880,1443
2019,10,6,18,1320,1421,2875,1454
2019,10,6,19,1330,1407,2886,1479
2019,10,6,20,1315,1404,2893,1489
2019,10,6,21,1310,1390,2883,1493
2019,10,6,22,1295,1376,2863,1487
2019,10,6,23,1315,1390,2893,1503
2019,10,7,0,1330,1407,2870,1463
2019,10,7,1,1335,1430,2828,1398
2019,10,7,2,1360,1470,2819,1349
2019,10,7,3,1340,1463,2840,1377
2019,10,7,4,1290,1407,2837,1430
2019,10,7,5,1205,1328,2809,1481
2019,10,7,6,1130,1268,2790,1522
2019,10,7,7,1175,1242,2797,1555
2019,10,7,8,1165,1246,2842,1596
2019,10,7,9,1175,1235,2849,1614
2019,10,7,10,1180,1232,2826,1594
2019,10,7,11,1200,1250,2809,1559
2019,10,7,12,1255,1324,2843,1519
2019,10,7,13,1370,1437,2891,1454
2019,10,7,14,1460,1521,2801,1280
2019,10,7,15,1440,1521,2881,1360
2019,10,7,16,1435,1525,2887,1362
2019,10,7,17,1425,1507,2849,1342
2019,10,7,18,1400,1487,2850,1363
2019,10,7,19,1390,1469,2863,1394
2019,10,7,20,1385,1450,2840,1390
2019,10,7,21,1375,1443,2817,1374
2019,10,7,22,1370,1432,2847,1415
2019,10,7,23,1370,1435,2825,1390
2019,10,8,0,1370,1437,2770,1333
2019,10,8,1,1375,1434,2783,1349
2019,10,8,2,1415,1476,2781,1305
2019,10,8,3,1405,1463,2825,1362
2019,10,8,4,1360,1397,2752,1355
2019,10,8,5,1285,1326,2781,1455
2019,10,8,6,1215,1258,2761,1503
2019,10,8,7,1225,1214,2702,1488
2019,10,8,8,1210,1200,2463,1263
2019,10,8,9,1205,1183,2377,1194
2019,10,8,10,1200,1169,2412,1243
2019,10,8,11,1220,1191,2532,1341
2019,10,8,12,1270,1253,2620,1367
2019,10,8,13,1380,1361,2621,1260
2019,10,8,14,1475,1457,2573,1116
2019,10,8,15,1480,1447,2614,1167
2019,10,8,16,1485,1462,2609,1147
2019,10,8,17,1485,1473,2614,1141
2019,10,8,18,1465,1460,2582,1122
2019,10,8,19,1460,1450,2592,1142
2019,10,8,20,1435,1445,2637,1192
2019,10,8,21,1420,1448,2664,1216
2019,10,8,22,1410,1450,2688,1238
2019,10,8,23,1420,1450,2703,1253
2019,10,9,0,1420,1472,2716,1244
2019,10,9,1,1440,1488,2721,1233
2019,10,9,2,1470,1540,2718,1178
2019,10,9,3,1470,1536,2808,1272
2019,10,9,4,1440,1481,2780,1299
2019,10,9,5,1335,1412,2797,1385
2019,10,9,6,1285,1357,2808,1451
2019,10,9,7,1290,1321,2637,1316
2019,10,9,8,1285,1306,2677,1371
2019,10,9,9,1280,1308,2673,1365
2019,10,9,10,1280,1303,2673,1370
2019,10,9,11,1300,1333,2669,1336
2019,10,9,12,1370,1392,2628,1236
2019,10,9,13,1490,1524,2705,1181
2019,10,9,14,1585,1599,2663,1064
2019,10,9,15,1575,1600,2669,1069
2019,10,9,16,1570,1602,2679,1077
2019,10,9,17,1555,1642,2749,1107
2019,10,9,18,1535,1618,2734,1116
2019,10,9,19,1515,1599,2734,1135
2019,10,9,20,1495,1596,2645,1049
2019,10,9,21,1485,1586,2618,1032
2019,10,9,22,1450,1584,2592,1008
2019,10,9,23,1480,1599,2609,1010
2019,10,10,0,1480,1622,2710,1088
2019,10,10,1,1485,1660,2790,1130
2019,10,10,2,1530,1672,2745,1073
2019,10,10,3,1525,1656,2729,1073
2019,10,10,4,1470,1589,2712,1123
2019,10,10,5,1380,1501,2531,1030
2019,10,10,6,1300,1431,2525,1094
2019,10,10,7,1325,1371,2488,1117
2019,10,10,8,1310,1351,2468,1117
2019,10,10,9,1305,1351,2436,1085
2019,10,10,10,1300,1348,2520,1172
2019,10,10,11,1325,1383,2540,1157
2019,10,10,12,1385,1422,2527,1105
2019,10,10,13,1490,1541,2543,1002
2019,10,10,14,1575,1627,2609,982
2019,10,10,15,1575,1625,2662,1037
2019,10,10,16,1575,1614,2645,1031
2019,10,10,17,1580,1595,2648,1053
2019,10,10,18,1560,1567,2636,1069
2019,10,10,19,1550,1531,2624,1093
2019,10,10,20,1530,1514,2598,1084
2019,10,10,21,1510,1477,2551,1074
2019,10,10,22,1510,1487,2569,1082
2019,10,10,23,1515,1480,2591,1111
2019,10,11,0,1520,1477,2594,1117
2019,10,11,1,1540,1522,2632,1110
2019,10,11,2,1580,1580,2630,1050
2019,10,11,3,1575,1583,2627,1044
2019,10,11,4,1530,1528,2620,1092
2019,10,11,5,1445,1469,2662,1193
2019,10,11,6,1385,1400,2677,1277
2019,10,11,7,1320,1381,2735,1354
2019,10,11,8,1300,1377,2761,1384
2019,10,11,9,1305,1369,2762,1393
2019,10,11,10,1310,1372,2743,1371
2019,10,11,11,1320,1381,2743,1362
2019,10,11,12,1375,1440,2736,1296
2019,10,11,13,1465,1551,2712,1161
2019,10,11,14,1540,1636,2651,1015
2019,10,11,15,1550,1629,2644,1015
2019,10,11,16,1535,1606,2640,1034
2019,10,11,17,1535,1581,2637,1056
2019,10,11,18,1530,1554,2615,1061
2019,10,11,19,1510,1525,2603,1078
2019,10,11,20,1500,1499,2604,1105
2019,10,11,21,1490,1476,2590,1114
2019,10,11,22,1485,1452,2620,1168
2019,10,11,23,1500,1446,2576,1130
2019,10,12,0,1475,1447,2644,1197
2019,10,12,1,1505,1463,2615,1152
2019,10,12,2,1525,1508,2620,1112
2019,10,12,3,1515,1501,2625,1124
2019,10,12,4,1540,1459,2673,1214
2019,10,12,5,1405,1419,2675,1256
2019,10,12,6,1345,1359,2681,1322
2019,10,12,7,1295,1332,2723,1391
2019,10,12,8,1285,1316,2739,1423
2019,10,12,9,1265,1310,2767,1457
2019,10,12,10,1270,1314,2771,1457
2019,10,12,11,1280,1330,2779,1449
2019,10,12,12,1310,1352,2781,1429
2019,10,12,13,1325,1404,2776,1372
2019,10,12,14,1350,1449,2759,1310
2019,10,12,15,1410,1477,2770,1293
2019,10,12,16,1410,1440,2789,1349
2019,10,12,17,1410,1412,2769,1357
2019,10,12,18,1415,1388,2764,1376
2019,10,12,19,1405,1352,2773,1421
2019,10,12,20,1395,1311,2711,1400
2019,10,12,21,1375,1290,2692,1402
2019,10,12,22,1380,1251,2417,1166
2019,10,12,23,1385,1229,2106,877
2019,10,13,0,1380,1230,1841,611
2019,10,13,1,1405,1278,1553,275
2019,10,13,2,1440,1361,1304,-57
2019,10,13,3,1425,1381,1287,-94
2019,10,13,4,1350,1353,1290,-63
2019,10,13,5,1320,1297,1293,-4
2019,10,13,6,1280,1251,1300,49
2019,10,13,7,1255,1226,1284,58
2019,10,13,8,1235,1186,1153,-33
2019,10,13,9,1230,1172,1127,-45
2019,10,13,10,1220,1166,1104,-62
2019,10,13,11,1235,1179,1097,-82
2019,10,13,12,1265,1197,1091,-106
2019,10,13,13,1315,1251,932,-319
2019,10,13,14,1365,1292,731,-561
2019,10,13,15,1395,1323,714,-609
2019,10,13,16,1415,1332,740,-592
2019,10,13,17,1410,1325,761,-564
2019,10,13,18,1390,1309,764,-545
2019,10,13,19,1375,1294,782,-512
2019,10,13,20,1365,1262,734,-528
2019,10,13,21,1350,1265,742,-523
2019,10,13,22,1340,1247,719,-528
2019,10,13,23,1350,1261,714,-547
2019,10,14,0,1360,1271,737,-534
2019,10,14,1,1390,1318,724,-594
2019,10,14,2,1430,1348,697,-651
2019,10,14,3,1420,1305,665,-640
2019,10,14,4,1365,1244,644,-600
2019,10,14,5,1290,1183,644,-539
2019,10,14,6,1230,1143,643,-500
2019,10,14,7,1225,1098,646,-452
2019,10,14,8,1215,1090,722,-368
2019,10,14,9,1210,1086,726,-360
2019,10,14,10,1210,1094,746,-348
2019,10,14,11,1235,1105,780,-325
2019,10,14,12,1295,1158,758,-400
2019,10,14,13,1425,1254,758,-496
2019,10,14,14,1530,1334,836,-498
2019,10,14,15,1530,1342,849,-493
2019,10,14,16,1525,1330,830,-500
2019,10,14,17,1510,1320,876,-444
2019,10,14,18,1490,1311,921,-390
2019,10,14,19,1470,1298,879,-419
2019,10,14,20,1450,1284,874,-410
2019,10,14,21,1435,168,874,-406
2019,10,14,22,1430,138,719,-390
2019,10,14,23,1430,156,714,-421
2019,10,15,0,1430,148,737,-414
2019,10,15,1,1445,176,724,-448
2019,10,15,2,1490,238,697,-483
2019,10,15,3,1480,218,665,-484
2019,10,15,4,1430,205,644,-478
2019,10,15,5,1345,94,644,-434
2019,10,15,6,1275,67,643,-391
2019,10,15,7,1180,1093,690,-403
2019,10,15,8,1150,1083,676,-407
2019,10,15,9,1140,1089,649,-440
2019,10,15,10,1130,1094,635,-459
2019,10,15,11,1150,1117,674,-443
2019,10,15,12,1185,1173,699,-474
2019,10,15,13,1310,1304,686,-618
2019,10,15,14,1425,1392,694,-698
2019,10,15,15,1445,1398,697,-701
2019,10,15,16,1450,1354,691,-663
2019,10,15,17,1450,1328,694,-634
2019,10,15,18,1430,1310,703,-607
2019,10,15,19,1420,1274,648,-626
2019,10,15,20,1395,1267,654,-613
2019,10,15,21,1390,1255,638,-617
2019,10,15,22,1380,1236,629,-607
2019,10,15,23,1390,1253,640,-613
2019,10,16,0,1400,1251,652,-599
2019,10,16,1,1440,1297,677,-620
2019,10,16,2,1475,1327,699,-628
2019,10,16,3,1445,1313,722,-591
2019,10,16,4,1425,1253,707,-546
2019,10,16,5,1315,1170,640,-530
2019,10,16,6,1270,1111,623,-488
2019,10,16,7,1150,1088,625,-463
2019,10,16,8,1140,1075,692,-383
2019,10,16,9,1130,1070,725,-345
2019,10,16,10,1130,1067,714,-353
2019,10,16,11,1155,1090,746,-344
2019,10,16,12,1205,1131,738,-393
2019,10,16,13,1330,1247,716,-531
2019,10,16,14,1420,1336,735,-601
2019,10,16,15,1420,1320,768,-552
2019,10,16,16,1425,1291,790,-501
2019,10,16,17,1430,1272,777,-495
2019,10,16,18,1415,1263,767,-496
2019,10,16,19,1405,1240,793,-447
2019,10,16,20,1400,1241,816,-425
2019,10,16,21,1305,1234,824,-410
2019,10,16,22,1305,1236,817,-419
2019,10,16,23,1310,1235,806,-429
2019,10,17,0,1315,1236,794,-442
2019,10,17,1,1340,1264,724,-540
2019,10,17,2,1360,1291,711,-580
2019,10,17,3,1350,1262,700,-562
2019,10,17,4,1280,1198,679,-519
2019,10,17,5,1210,1123,633,-490
2019,10,17,6,1150,1078,616,-462
2019,10,17,7,1085,1050,601,-449
2019,10,17,8,1075,1038,638,-400
2019,10,17,9,1080,1034,650,-384
2019,10,17,10,1085,1035,646,-389
2019,10,17,11,1110,1050,629,-421
2019,10,17,12,1155,1105,626,-479
2019,10,17,13,1285,1192,637,-555
2019,10,17,14,1380,1282,698,-584
2019,10,17,15,1380,1309,722,-587
2019,10,17,16,1345,1303,709,-594
2019,10,17,17,1325,1304,719,-585
2019,10,17,18,1305,1246,701,-545
2019,10,17,19,1275,1240,652,-588
2019,10,17,20,1265,1267,673,-594
2019,10,17,21,1245,1296,792,-504
2019,10,17,22,1235,1304,821,-483
2019,10,17,23,1245,1315,838,-477
2019,10,18,0,1245,1302,847,-455
2019,10,18,1,1280,1325,845,-480
2019,10,18,2,1320,1351,782,-569
2019,10,18,3,1310,1332,865,-467
2019,10,18,4,1280,1290,896,-394
2019,10,18,5,1185,1232,850,-382
2019,10,18,6,1125,1176,881,-295
2019,10,18,7,1085,1150,858,-292
2019,10,18,8,1075,1129,815,-314
2019,10,18,9,1070,1123,804,-319
2019,10,18,10,1075,1131,783,-348
2019,10,18,11,1085,1145,817,-328
2019,10,18,12,1135,1169,797,-372
2019,10,18,13,1275,1265,805,-460
2019,10,18,14,1390,1347,767,-580
2019,10,18,15,1385,1380,773,-607
2019,10,18,16,1360,1383,787,-596
2019,10,18,17,1340,1398,861,-537
2019,10,18,18,1320,1388,893,-495
2019,10,18,19,1300,1370,893,-477
2019,10,18,20,1285,1362,891,-471
2019,10,18,21,1265,1353,878,-475
2019,10,18,22,1255,1346,850,-496
2019,10,18,23,1255,1331,897,-434
2019,10,19,0,1245,1330,940,-390
2019,10,19,1,1265,1352,969,-383
2019,10,19,2,1300,1368,1056,-312
2019,10,19,3,1290,1353,1083,-270
2019,10,19,4,1270,1313,1065,-248
2019,10,19,5,1200,1266,1038,-228
2019,10,19,6,1150,1210,1055,-155
2019,10,19,7,1070,1163,1040,-123
2019,10,19,8,1055,1163,1037,-126
2019,10,19,9,1045,1142,1036,-106
2019,10,19,10,1045,1138,1005,-133
2019,10,19,11,1060,1151,1012,-139
2019,10,19,12,1095,1174,1022,-152
2019,10,19,13,1195,1221,1012,-209
2019,10,19,14,1300,1282,1024,-258
2019,10,19,15,1335,1312,992,-320
2019,10,19,16,1310,1326,912,-414
2019,10,19,17,1290,1325,952,-373
2019,10,19,18,1265,1327,976,-351
2019,10,19,19,1240,1308,897,-411
2019,10,19,20,1225,1312,879,-433
2019,10,19,21,1215,1298,819,-479
2019,10,19,22,1195,1300,824,-476
2019,10,19,23,1190,1316,819,-497
2019,10,20,0,1190,1327,841,-486
2019,10,20,1,1235,1357,814,-543
2019,10,20,2,1295,1372,789,-583
2019,10,20,3,1300,1363,852,-511
2019,10,20,4,1300,1279,976,-303
2019,10,20,5,1215,1249,1058,-191
2019,10,20,6,1170,1192,1262,70
2019,10,20,7,1100,1173,1328,155
2019,10,20,8,1070,1148,1348,200
2019,10,20,9,1055,1144,1482,338
2019,10,20,10,1050,1149,1520,371
2019,10,20,11,1065,1147,1501,354
2019,10,20,12,1090,1165,1520,355
2019,10,20,13,1205,1213,1519,306
2019,10,20,14,1315,1260,1488,228
2019,10,20,15,1345,1291,1515,224
2019,10,20,16,1355,1343,1504,161
2019,10,20,17,1350,1336,1460,124
2019,10,20,18,1325,1336,1458,122
2019,10,20,19,1310,1329,1454,125
2019,10,20,20,1295,1334,1475,141
2019,10,20,21,1300,1338,1544,206
2019,10,20,22,1290,1336,1678,342
2019,10,20,23,1305,1383,1842,459
2019,10,21,0,1310,1403,1882,479
2019,10,21,1,1350,1439,1873,434
2019,10,21,2,1380,1467,1908,441
2019,10,21,3,1345,1464,2071,607
2019,10,21,4,1315,1413,2054,641
2019,10,21,5,1225,1333,2047,714
2019,10,21,6,1185,1262,2015,753
2019,10,21,7,1100,1230,1979,749
2019,10,21,8,1090,1220,2027,807
2019,10,21,9,1085,1230,2073,843
2019,10,21,10,1090,1250,2175,925
2019,10,21,11,1105,1279,2249,970
2019,10,21,12,1160,1332,2305,973
2019,10,21,13,1275,1447,2317,870
2019,10,21,14,1375,1540,2282,742
2019,10,21,15,1385,1526,2265,739
2019,10,21,16,1375,1509,2246,737
2019,10,21,17,1370,1520,2285,765
2019,10,21,18,1345,1498,2327,829
2019,10,21,19,1335,1491,2304,813
2019,10,21,20,1335,1484,2358,874
2019,10,21,21,1330,1477,2354,877
2019,10,21,22,1320,1484,2385,901
2019,10,21,23,1325,1480,2403,923
2019,10,22,0,1320,1486,2381,895
2019,10,22,1,1355,1541,2373,832
2019,10,22,2,1390,1545,2400,855
2019,10,22,3,1365,1516,2372,856
2019,10,22,4,1360,1453,2398,945
2019,10,22,5,1245,1361,2338,977
2019,10,22,6,1175,1312,2408,1096
2019,10,22,7,1140,1262,2377,1115
2019,10,22,8,1125,1241,2385,1144
2019,10,22,9,1125,1227,2331,1104
2019,10,22,10,1125,1229,2359,1130
2019,10,22,11,1145,1266,2373,1107
2019,10,22,12,1195,1299,2374,1075
2019,10,22,13,1315,1427,2392,965
2019,10,22,14,1400,1525,2420,895
2019,10,22,15,1410,1504,2427,923
2019,10,22,16,1390,1520,2364,844
2019,10,22,17,1375,1515,2411,896
2019,10,22,18,1360,1491,2415,924
2019,10,22,19,1335,1456,2361,905
2019,10,22,20,1330,1419,2381,962
2019,10,22,21,1320,1409,2290,881
2019,10,22,22,1310,1401,2328,927
2019,10,22,23,1330,1421,2294,873
2019,10,23,0,1335,1422,2343,921
2019,10,23,1,1375,1469,2253,784
2019,10,23,2,1410,1492,2373,881
2019,10,23,3,1395,1465,2335,870
2019,10,23,4,1350,1385,2313,928
2019,10,23,5,1255,1326,2366,1040
2019,10,23,6,1190,1269,2345,1076
2019,10,23,7,1200,1223,2297,1074
2019,10,23,8,1190,1203,2281,1078
2019,10,23,9,1190,1210,2265,1055
2019,10,23,10,1190,1214,2363,1149
2019,10,23,11,1220,1232,2369,1137
2019,10,23,12,1270,1299,2374,1075
2019,10,23,13,1410,1413,2410,997
2019,10,23,14,1515,1515,2480,965
2019,10,23,15,1510,1500,2505,1005
2019,10,23,16,1495,1487,2505,1018
2019,10,23,17,1500,1493,2520,1027
2019,10,23,18,1485,1478,2595,1117
2019,10,23,19,1470,1462,2615,1153
2019,10,23,20,1470,1448,2667,1219
2019,10,23,21,1460,1440,2618,1178
2019,10,23,22,1465,1443,2573,1130
2019,10,23,23,1465,1442,2527,1085
2019,10,24,0,1475,1453,2495,1042
2019,10,24,1,1520,1498,2503,1005
2019,10,24,2,1530,1530,2520,990
2019,10,24,3,1500,1513,2537,1024
2019,10,24,4,1450,1476,2505,1029
2019,10,24,5,1350,1394,2437,1043
2019,10,24,6,1295,1332,2502,1170
2019,10,24,7,1225,1313,2508,1195
2019,10,24,8,1210,1281,2486,1205
2019,10,24,9,1205,1304,2506,1202
2019,10,24,10,1205,1290,2536,1246
2019,10,24,11,1225,1317,2610,1293
2019,10,24,12,1280,1364,2562,1198
2019,10,24,13,1365,1505,2669,1164
2019,10,24,14,1445,1593,2665,1072
2019,10,24,15,1460,1597,2690,1093
2019,10,24,16,1455,1575,2618,1043
2019,10,24,17,1455,1556,2691,1135
2019,10,24,18,1405,1524,2709,1185
2019,10,24,19,1385,1467,2696,1229
2019,10,24,20,1395,1496,2643,1147
2019,10,24,21,1410,1498,2672,1174
2019,10,24,22,1415,1474,2697,1223
2019,10,24,23,1425,1494,2723,1229
2019,10,25,0,1415,1481,2741,1260
2019,10,25,1,1450,1518,2721,1203
2019,10,25,2,1480,1528,2732,1204
2019,10,25,3,1460,1510,2747,1237
2019,10,25,4,1445,1447,2747,1300
2019,10,25,5,1345,1391,2744,1353
2019,10,25,6,1285,1316,2731,1415
2019,10,25,7,1150,1278,2718,1440
2019,10,25,8,1130,1259,2736,1477
2019,10,25,9,1130,1252,2742,1490
2019,10,25,10,1140,1256,2753,1497
2019,10,25,11,1150,1265,2750,1485
2019,10,25,12,1185,1313,2786,1473
2019,10,25,13,1285,1421,2782,1361
2019,10,25,14,1370,1515,2772,1257
2019,10,25,15,1385,1514,2790,1276
2019,10,25,16,1380,1490,2779,1289
2019,10,25,17,1390,1468,2780,1312
2019,10,25,18,1375,1440,2765,1325
2019,10,25,19,1360,1419,2793,1374
2019,10,25,20,1345,1411,2766,1355
2019,10,25,21,1335,1395,2731,1336
2019,10,25,22,1330,1390,2720,1330
2019,10,25,23,1320,1398,2764,1366
2019,10,26,0,1320,1382,2719,1337
2019,10,26,1,1345,1417,2672,1255
2019,10,26,2,1365,1426,2676,1250
2019,10,26,3,1350,1411,2641,1230
2019,10,26,4,1310,1365,2679,1314
2019,10,26,5,1260,1322,2709,1387
2019,10,26,6,1205,1278,2712,1434
2019,10,26,7,1275,1232,2684,1452
2019,10,26,8,1265,1210,2697,1487
2019,10,26,9,1255,1197,2530,1333
2019,10,26,10,1250,1218,2633,1415
2019,10,26,11,1265,1247,2644,1397
2019,10,26,12,1295,1269,2583,1314
2019,10,26,13,1350,1331,2607,1276
2019,10,26,14,1405,1408,2705,1297
2019,10,26,15,1430,1457,2732,1275
2019,10,26,16,1430,1484,2721,1237
2019,10,26,17,1420,1500,2730,1230
2019,10,26,18,1410,1500,2727,1227
2019,10,26,19,1380,1503,2731,1228
2019,10,26,20,1385,1475,2719,1244
2019,10,26,21,1370,1462,2731,1269
2019,10,26,22,1365,1479,2751,1272
2019,10,26,23,1375,1488,2730,1242
2019,10,27,0,1380,1498,2714,1216
2019,10,27,1,1420,1533,2692,1159
2019,10,27,2,1445,1544,2738,1194
2019,10,27,3,1440,1517,2731,1214
2019,10,27,4,1405,1488,2759,1271
2019,10,27,5,1320,1444,2764,1320
2019,10,27,6,1255,1387,2748,1361
2019,10,27,7,1325,1347,2723,1376
2019,10,27,8,1305,1332,2639,1307
2019,10,27,9,1310,1327,2624,1297
2019,10,27,10,1295,1327,2607,1280
2019,10,27,11,1315,1339,2612,1273
2019,10,27,12,1335,1362,2661,1299
2019,10,27,13,1390,1423,2659,1236
2019,10,27,14,1440,1469,2656,1187
2019,10,27,15,1485,1500,2633,1133
2019,10,27,16,1515,1542,2671,1129
2019,10,27,17,1520,1544,2647,1103
2019,10,27,18,1495,1523,2646,1123
2019,10,27,19,1495,1511,2661,1150
2019,10,27,20,1490,1515,2701,1186
2019,10,27,21,1480,1488,2698,1210
2019,10,27,22,1465,1482,2681,1199
2019,10,27,23,1495,1483,2674,1191
2019,10,28,0,1510,1517,2649,1132
2019,10,28,1,1525,1617,2675,1058
2019,10,28,2,1550,1626,2692,1066
2019,10,28,3,1525,1604,2670,1066
2019,10,28,4,1440,1562,2706,1144
2019,10,28,5,1375,1485,2745,1260
2019,10,28,6,1290,1426,2756,1330
2019,10,28,7,1345,1381,2676,1295
2019,10,28,8,1330,1355,2560,1205
2019,10,28,9,1330,1354,2655,1301
2019,10,28,10,1335,1351,2654,1303
2019,10,28,11,1355,1357,2593,1236
2019,10,28,12,1415,1438,2603,1165
2019,10,28,13,1520,1580,2629,1049
2019,10,28,14,1595,1685,2733,1048
2019,10,28,15,1600,1680,2753,1073
2019,10,28,16,1585,1694,2779,1085
2019,10,28,17,1575,1694,2770,1076
2019,10,28,18,1560,1695,2863,1168
2019,10,28,19,1540,1673,2854,1181
2019,10,28,20,1540,1647,2828,1181
2019,10,28,21,1530,1659,2836,1177
2019,10,28,22,1510,1669,2840,1171
2019,10,28,23,1520,1678,2839,1161
2019,10,29,0,1515,1710,2876,1166
2019,10,29,1,1565,1763,2870,1107
2019,10,29,2,1600,1767,2837,1070
2019,10,29,3,1570,1733,2832,1099
2019,10,29,4,1530,1669,2803,1134
2019,10,29,5,1420,1556,2616,1060
2019,10,29,6,1340,1502,2597,1095
2019,10,29,7,1390,1470,2590,1120
2019,10,29,8,1365,1457,2497,1040
2019,10,29,9,1360,1460,2582,1122
2019,10,29,10,1360,1450,2615,1165
2019,10,29,11,1395,1479,2650,1171
2019,10,29,12,1435,1533,2700,1167
2019,10,29,13,1570,1659,2758,1099
2019,10,29,14,1670,1748,2774,1026
2019,10,29,15,1665,1753,2726,973
2019,10,29,16,1675,1736,2660,924
2019,10,29,17,1670,1731,2677,946
2019,10,29,18,1645,1687,2670,983
2019,10,29,19,1605,1658,2666,1008
2019,10,29,20,1580,1635,2679,1044
2019,10,29,21,1565,1608,2697,1089
2019,10,29,22,1555,1600,2697,1097
2019,10,29,23,1570,1601,2688,1087
2019,10,30,0,1580,1632,2686,1054
2019,10,30,1,1645,1718,2720,1002
2019,10,30,2,1665,1740,2655,915
2019,10,30,3,1635,1712,2615,903
2019,10,30,4,1580,1665,2723,1058
2019,10,30,5,1485,1598,2797,1199
2019,10,30,6,1420,1531,2779,1248
2019,10,30,7,1430,1520,2806,1286
2019,10,30,8,1405,1499,2774,1275
2019,10,30,9,1415,1517,2793,1276
2019,10,30,10,1420,1514,2850,1336
2019,10,30,11,1435,1539,2845,1306
2019,10,30,12,1510,1600,2844,1244
2019,10,30,13,1605,1714,2837,1123
2019,10,30,14,1705,1807,2858,1051
2019,10,30,15,1685,1798,2862,1064
2019,10,30,16,1670,1769,2799,1030
2019,10,30,17,1655,1739,2850,1111
2019,10,30,18,1640,1699,2834,1135
2019,10,30,19,1620,1658,2838,1180
2019,10,30,20,1605,1627,2795,1168
2019,10,30,21,1605,1603,2853,1250
2019,10,30,22,1605,1598,2834,1236
2019,10,30,23,1610,1611,2820,1209
2019,10,31,0,1625,1623,2840,1217
2019,10,31,1,1675,1710,2889,1179
2019,10,31,2,1680,1731,2861,1130
2019,10,31,3,1675,1703,2836,1133
2019,10,31,4,1640,1658,2880,1222
2019,10,31,5,1525,1569,2867,1298
2019,10,31,6,1465,1505,2848,1343
2019,10,31,7,1355,1467,2702,1235
2019,10,31,8,1330,1447,2819,1372
2019,10,31,9,1340,1462,2814,1352
2019,10,31,10,1335,1443,2749,1306
2019,10,31,11,1360,1459,2737,1278
2019,10,31,12,1415,1534,2747,1213
2019,10,31,13,1530,1645,2768,1123
2019,10,31,14,1605,1724,2779,1055
2019,10,31,15,1615,1717,2785,1068
2019,10,31,16,1595,1705,2767,1062
2019,10,31,17,1580,1710,2808,1098
2019,10,31,18,1545,1696,2814,1118
2019,10,31,19,1500,1661,2791,1130
2019,10,31,20,1520,1639,2819,1180
2019,10,31,21,1520,1617,2775,1158
2019,10,31,22,1500,1613,2727,1114
2019,10,31,23,1520,1610,2722,1112
2019,11,1,0,1510,1593,2722,1129
2019,11,1,1,1565,1618,2704,1086
2019,11,1,2,1585,1638,2736,1098
2019,11,1,3,1565,1644,2711,1067
2019,11,1,4,1500,1603,2729,1126
2019,11,1,5,1440,1512,2715,1203
2019,11,1,6,1365,1439,2712,1273
2019,11,1,7,1345,1402,2748,1346
2019,11,1,8,1320,1393,2768,1375
2019,11,1,9,1320,1391,2804,1413
2019,11,1,10,1325,1408,2817,1409
2019,11,1,11,1340,1413,2827,1414
2019,11,1,12,1390,1466,2773,1307
2019,11,1,13,1510,1565,2809,1244
2019,11,1,14,1620,1676,2820,1144
2019,11,1,15,1620,1677,2822,1145
2019,11,1,16,1600,1661,2813,1152
2019,11,1,17,1580,1630,2829,1199
2019,11,1,18,1555,1608,2856,1248
2019,11,1,19,1525,1562,2824,1262
2019,11,1,20,1520,1538,2821,1283
2019,11,1,21,1500,1520,2883,1363
2019,11,1,22,1490,1519,2881,1362
2019,11,1,23,1495,1517,2835,1318
2019,11,2,0,1485,1527,2845,1318
2019,11,2,1,1535,1592,2821,1229
2019,11,2,2,1545,1629,2893,1264
2019,11,2,3,1525,1603,2848,1245
2019,11,2,4,1480,1564,2916,1352
2019,11,2,5,1420,1518,2881,1363
2019,11,2,6,1370,1465,2897,1432
2019,11,2,7,1225,0,2897,0
2019,11,2,8,1210,0,2768,0
2019,11,2,9,1200,0,2804,0
2019,11,2,10,1205,0,2817,0
2019,11,2,11,1225,0,2827,0
2019,11,2,12,1255,0,2773,0
2019,11,2,13,1325,0,2809,0
2019,11,2,14,1400,0,2820,0
2019,11,2,15,1435,0,2822,0
2019,11,2,16,1455,0,2813,0
2019,11,2,17,1465,0,2829,0
2019,11,2,18,1460,0,2856,0
2019,11,2,19,1450,0,2824,0
2019,11,2,20,1435,0,2821,0
2019,11,2,21,1420,0,2883,0
2019,11,2,22,1430,0,2881,0
2019,11,2,23,1440,0,2835,0
2019,11,3,0,1450,0,2845,0
2019,11,3,1,1495,0,2821,0
2019,11,3,2,1510,0,2893,0
2019,11,3,3,1485,0,2848,0
2019,11,3,4,1400,0,2916,0
2019,11,3,5,1395,0,2881,0
2019,11,3,6,1335,0,2897,0
2019,11,3,7,1205,1288,2801,1513
2019,11,3,8,1185,1288,2849,1561
2019,11,3,9,1185,1241,2749,1508
2019,11,3,10,1185,1358,2825,1467
2019,11,3,11,1195,1313,2808,1495
2019,11,3,12,1225,1318,2771,1453
2019,11,3,13,1310,1352,2795,1443
2019,11,3,14,1385,1395,2768,1373
2019,11,3,15,1405,1458,2760,1302
2019,11,3,16,1430,1506,2722,1216
2019,11,3,17,1430,1527,2699,1172
2019,11,3,18,1410,1515,2670,1155
2019,11,3,19,1395,1514,2710,1196
2019,11,3,20,1395,1500,2702,1202
2019,11,3,21,1375,1498,2721,1223
2019,11,3,22,1370,1491,2713,1222
2019,11,3,23,1375,1517,2740,1223
2019,11,4,0,1400,1546,2729,1183
2019,11,4,1,1485,1637,2785,1148
2019,11,4,2,1500,1627,2776,1149
2019,11,4,3,1480,1605,2756,1151
2019,11,4,4,1420,1558,2754,1196
2019,11,4,5,1360,1492,2714,1222
2019,11,4,6,1305,1427,2636,1209
2019,11,4,7,0,1365,2608,1243
2019,11,4,8,1230,1343,2631,1288
2019,11,4,9,1205,1321,2532,1211
2019,11,4,10,1210,1312,2560,1248
2019,11,4,11,1210,1329,2540,1211
2019,11,4,12,1225,1344,2550,1206
2019,11,4,13,1290,1400,2606,1206
2019,11,4,14,1420,1544,2698,1154
2019,11,4,15,1525,1618,2678,1060
2019,11,4,16,1525,1609,2636,1027
2019,11,4,17,1520,1615,2649,1034
2019,11,4,18,1515,1603,2668,1065
2019,11,4,19,1505,1606,2647,1041
2019,11,4,20,1485,1577,2605,1028
2019,11,4,21,1470,1569,2588,1019
2019,11,4,22,1470,1551,2584,1033
2019,11,4,23,1475,1544,2579,1035
2019,11,5,0,1485,1581,2598,1017
2019,11,5,1,1505,1644,2659,1015
2019,11,5,2,1560,1648,2670,1022
2019,11,5,3,1570,1621,2696,1075
2019,11,5,4,1540,1567,2697,1130
2019,11,5,5,1490,1505,2706,1201
2019,11,5,6,1390,1411,2654,1243
2019,11,5,7,1335,1358,2633,1275
2019,11,5,8,1375,1343,2774,1431
2019,11,5,9,1365,1306,2671,1365
2019,11,5,10,1350,1296,2665,1369
2019,11,5,11,1360,1312,2678,1366
2019,11,5,12,1385,1317,2660,1343
2019,11,5,13,1430,1390,2808,1418
2019,11,5,14,1545,1529,2847,1318
2019,11,5,15,1625,1565,2805,1240
2019,11,5,16,1635,1552,2719,1167
2019,11,5,17,1635,1535,2720,1185
2019,11,5,18,1625,1516,2743,1227
2019,11,5,19,1595,1486,2685,1199
2019,11,5,20,1570,1475,2729,1254
2019,11,5,21,1550,1476,2741,1265
2019,11,5,22,1525,1463,2745,1282
2019,11,5,23,1525,1449,2724,1275
2019,11,6,0,1540,1473,2718,1245
2019,11,6,1,1570,1555,2741,1186
2019,11,6,2,1635,1605,2757,1152
2019,11,6,3,1650,1581,2747,1166
2019,11,6,4,1620,1545,2716,1171
2019,11,6,5,1570,1482,2667,1185
2019,11,6,6,1490,1421,2681,1260
2019,11,6,7,1430,1379,2667,1288
2019,11,6,8,1365,1340,2628,1288
2019,11,6,9,1340,1333,2631,1298
2019,11,6,10,1345,1336,2603,1267
2019,11,6,11,1355,1349,2601,1252
2019,11,6,12,1375,1383,2615,1232
2019,11,6,13,1435,1450,2646,1196
2019,11,6,14,1565,1581,2615,1034
2019,11,6,15,1650,1658,2563,905
2019,11,6,16,1640,1659,2557,898
2019,11,6,17,1635,1645,2592,947
2019,11,6,18,1625,1627,2565,938
2019,11,6,19,1610,1606,2541,935
2019,11,6,20,1585,1578,2587,1009
2019,11,6,21,1570,1562,2573,1011
2019,11,6,22,1555,1545,2567,1022
2019,11,6,23,1550,1556,2568,1012
2019,11,7,0,1575,1585,2575,990
2019,11,7,1,1615,1661,2636,975
2019,11,7,2,1650,1685,2668,983
2019,11,7,3,1645,1669,2673,1004
2019,11,7,4,1605,1646,2676,1030
2019,11,7,5,1550,1580,2607,1027
2019,11,7,6,1455,1515,2613,1098
2019,11,7,7,1395,1446,2616,1170
2019,11,7,8,1385,1420,2624,1204
2019,11,7,9,1350,1414,2659,1245
2019,11,7,10,1350,1413,2674,1261
2019,11,7,11,1355,1437,2723,1286
2019,11,7,12,1365,1457,2743,1286
2019,11,7,13,1435,1526,2740,1214
2019,11,7,14,1565,1639,2714,1075
2019,11,7,15,1615,1696,2722,1026
2019,11,7,16,1610,1675,2679,1004
2019,11,7,17,1590,1641,2686,1045
2019,11,7,18,1575,1622,2707,1085
2019,11,7,19,1550,1578,2721,1143
2019,11,7,20,1520,1546,2684,1138
2019,11,7,21,1525,1536,2769,1233
2019,11,7,22,1510,1516,2783,1267
2019,11,7,23,1495,1495,2800,0
2019,11,8,0,1515,1562,2765,1203
2019,11,8,1,1555,1665,2841,1176
2019,11,8,2,1600,1665,2827,1162
2019,11,8,3,1590,1655,2854,1199
2019,11,8,4,1565,1626,2866,1240
2019,11,8,5,1500,1570,2868,1298
2019,11,8,6,1435,1491,2858,1367
2019,11,8,7,1375,1424,2876,1452
2019,11,8,8,1290,1393,2874,1481
2019,11,8,9,1285,1378,2882,1504
2019,11,8,10,1280,1391,2891,1500
2019,11,8,11,1290,1383,2892,1509
2019,11,8,12,1305,1414,2901,1487
2019,11,8,13,1355,1455,2919,1464
2019,11,8,14,1440,1552,2936,1384
2019,11,8,15,1520,1626,2937,1311
2019,11,8,16,1520,1607,2860,1253
2019,11,8,17,1505,1587,2831,1244
2019,11,8,18,1480,1566,2813,1247
2019,11,8,19,1460,1534,2797,1263
2019,11,8,20,1420,1500,2799,1299
2019,11,8,21,1410,1491,2795,1304
2019,11,8,22,1385,1461,2780,1319
2019,11,8,23,1390,1461,2740,1279
2019,11,9,0,1395,1498,2778,1280
2019,11,9,1,1410,1548,2856,1308
2019,11,9,2,1465,1560,2865,1305
2019,11,9,3,1480,1527,2850,1323
2019,11,9,4,1460,1506,2836,1330
2019,11,9,5,1420,1465,2842,1377
2019,11,9,6,1370,1405,2839,1434
2019,11,9,7,1320,1359,2799,1440
2019,11,9,8,1305,1332,2801,1469
2019,11,9,9,1290,1301,2770,1469
2019,11,9,10,1275,1312,2787,1475
2019,11,9,11,1285,1295,2776,1481
2019,11,9,12,1290,1309,2815,1506
2019,11,9,13,1320,1347,2805,1458
2019,11,9,14,1370,1390,2800,1410
2019,11,9,15,1410,1449,2706,1257
2019,11,9,16,1445,1473,2722,1249
2019,11,9,17,1455,1482,2729,1247
2019,11,9,18,1460,1497,2737,1240
2019,11,9,19,1455,1469,2764,1295
2019,11,9,20,1435,1466,2756,1290
2019,11,9,21,1405,1441,2711,1270
2019,11,9,22,1390,1416,2668,1252
2019,11,9,23,1400,1417,2638,1221
2019,11,10,0,1410,1459,2672,1213
2019,11,10,1,1445,1535,2724,1189
2019,11,10,2,1485,1529,2732,1203
2019,11,10,3,1485,1501,2717,1216
2019,11,10,4,1460,1471,2699,1228
2019,11,10,5,1410,1425,2657,1232
2019,11,10,6,1365,1367,2626,1259
2019,11,10,7,1310,1321,2587,1266
2019,11,10,8,1370,1286,2536,1250
2019,11,10,9,1360,1278,2540,1262
2019,11,10,10,1340,1274,2543,1269
2019,11,10,11,1375,1271,2563,1292
2019,11,10,12,1385,1283,2625,1342
2019,11,10,13,1420,1331,2669,1338
2019,11,10,14,1440,1369,2667,1298
2019,11,10,15,1455,1436,2601,1165
2019,11,10,16,1490,1471,2481,1010
2019,11,10,17,1510,1535,2599,1064
2019,11,10,18,1505,1567,2599,1032
2019,11,10,19,1490,1574,2583,1009
2019,11,10,20,1480,1601,2534,933
2019,11,10,21,1480,1583,2536,953
2019,11,10,22,1465,1599,2540,941
2019,11,10,23,1475,1605,2563,958
2019,11,11,0,1490,1666,2607,941
2019,11,11,1,1550,1744,2629,885
2019,11,11,2,1595,1763,2661,898
2019,11,11,3,1585,1724,2677,953
2019,11,11,4,1555,1678,2650,972
2019,11,11,5,1480,1620,2613,993
2019,11,11,6,1425,1547,2599,1052
2019,11,11,7,1365,1501,2568,1067
2019,11,11,8,1300,1459,2537,1078
2019,11,11,9,1280,1458,2514,1056
2019,11,11,10,1275,1448,2514,1066
2019,11,11,11,1290,1466,2529,1063
2019,11,11,12,1310,1497,2536,1039
2019,11,11,13,1370,1555,2554,999
2019,11,11,14,1520,1680,2592,912
2019,11,11,15,1605,1732,2625,893
2019,11,11,16,1595,1738,2630,892
2019,11,11,17,1600,1719,2654,935
2019,11,11,18,1585,1681,2681,1000
2019,11,11,19,1580,1652,2684,1032
2019,11,11,20,1555,1629,2709,1080
2019,11,11,21,1545,1622,2728,1106
2019,11,11,22,1530,1608,2784,1176
2019,11,11,23,1530,1600,2795,1195
2019,11,12,0,1565,1654,2827,1173
2019,11,12,1,1635,1739,2829,1090
2019,11,12,2,1640,1748,2835,1087
2019,11,12,3,1615,1723,2828,1105
2019,11,12,4,1565,1697,2839,1142
2019,11,12,5,1605,1625,2794,1169
2019,11,12,6,1410,1558,2864,1306
2019,11,12,7,1355,1494,2858,1364
2019,11,12,8,1285,1458,2807,1349
2019,11,12,9,1260,1442,2830,1388
2019,11,12,10,1250,1433,2835,1402
2019,11,12,11,1255,1421,2820,1399
2019,11,12,12,1265,1457,2837,1380
2019,11,12,13,1325,1496,2835,1339
2019,11,12,14,1430,1611,2857,1246
2019,11,12,15,1460,1670,2845,1175
2019,11,12,16,1465,1658,2853,1195
2019,11,12,17,1460,1633,2850,1217
2019,11,12,18,1450,1611,2851,1240
2019,11,12,19,1430,1589,2877,1288
2019,11,12,20,1420,1574,2833,1259
2019,11,12,21,1415,1561,2770,1209
2019,11,12,22,1410,1569,2723,1154
2019,11,12,23,1400,1572,2712,1140
2019,11,13,0,1430,1608,2761,1153
2019,11,13,1,1495,1647,2790,1143
2019,11,13,2,1540,1635,2783,1148
2019,11,13,3,1520,1617,2840,1223
2019,11,13,4,1485,1576,2857,1281
2019,11,13,5,1460,1535,2769,1234
2019,11,13,6,1365,1462,2803,1341
2019,11,13,7,1320,1392,2783,1391
2019,11,13,8,1365,1350,2738,1388
2019,11,13,9,1360,1323,2643,1320
2019,11,13,10,1360,1309,2608,1299
2019,11,13,11,1370,1305,2611,1306
2019,11,13,12,1395,1342,2652,1310
2019,11,13,13,1460,1375,2672,1297
2019,11,13,14,1550,1517,2664,1147
2019,11,13,15,1595,1599,2667,1068
2019,11,13,16,1590,1563,2659,1096
2019,11,13,17,1580,1561,2697,1136
2019,11,13,18,1560,1551,2783,1232
2019,11,13,19,1540,1540,2779,1239
2019,11,13,20,1510,1512,2763,1251
2019,11,13,21,1495,1490,2773,1283
2019,11,13,22,1475,1490,2697,1207
2019,11,13,23,1485,1504,2656,1152
2019,11,14,0,1515,1527,2652,1125
2019,11,14,1,1585,1602,2557,955
2019,11,14,2,1615,1617,2513,896
2019,11,14,3,1600,1592,2468,876
2019,11,14,4,1575,1571,2412,841
2019,11,14,5,1520,1510,2401,891
2019,11,14,6,1450,1442,2369,927
2019,11,14,7,1380,1393,2377,984
2019,11,14,8,1350,1366,2394,1028
2019,11,14,9,1335,1350,2407,1057
2019,11,14,10,1335,1338,2410,1072
2019,11,14,11,1330,1336,2359,1023
2019,11,14,12,1355,1355,2339,984
2019,11,14,13,1410,1427,2415,988
2019,11,14,14,1525,1539,2560,1021
2019,11,14,15,1600,1623,2618,995
2019,11,14,16,1590,1590,2584,994
2019,11,14,17,1560,1585,2600,1015
2019,11,14,18,1545,1562,2592,1030
2019,11,14,19,1520,1532,2556,1024
2019,11,14,20,1500,1509,2562,1053
2019,11,14,21,1485,1493,2581,1088
2019,11,14,22,1485,1485,2579,1094
2019,11,14,23,1490,1485,2583,1098
2019,11,15,0,1520,1508,2573,1065
2019,11,15,1,1565,1587,2610,1023
2019,11,15,2,1560,1599,2605,1006
2019,11,15,3,1545,1592,2629,1037
2019,11,15,4,1515,1568,2659,1091
2019,11,15,5,1470,1512,2625,1113
2019,11,15,6,1390,1455,2753,1298
2019,11,15,7,1325,1405,2805,1400
2019,11,15,8,1310,1373,2825,1452
2019,11,15,9,1295,1358,2804,1446
2019,11,15,10,1300,1353,2839,1486
2019,11,15,11,1300,1363,2838,1475
2019,11,15,12,1325,1385,2811,1426
2019,11,15,13,1365,1425,2751,1326
2019,11,15,14,1475,1533,2807,1274
2019,11,15,15,1560,1598,2848,1250
2019,11,15,16,1545,1579,2781,1202
2019,11,15,17,1530,1574,2834,1260
2019,11,15,18,1525,1572,2819,1247
2019,11,15,19,1480,1557,2805,1248
2019,11,15,20,1450,1527,2808,1281
2019,11,15,21,1435,1507,2809,1302
2019,11,15,22,1410,1486,2794,1308
2019,11,15,23,1415,1480,2733,1253
2019,11,16,0,1445,1532,2707,1175
2019,11,16,1,1495,1580,2744,1164
2019,11,16,2,1510,1567,2733,1166
2019,11,16,3,1490,1556,2767,1211
2019,11,16,4,1475,1521,2830,1309
2019,11,16,5,1420,1481,2777,1296
2019,11,16,6,1365,1429,2741,1312
2019,11,16,7,1320,1374,2674,1300
2019,11,16,8,1305,1344,2693,1349
2019,11,16,9,1285,1325,2674,1349
2019,11,16,10,1270,1304,2632,1328
2019,11,16,11,1270,1285,2569,1284
2019,11,16,12,1270,1305,2655,1350
2019,11,16,13,1305,1314,2731,1417
2019,11,16,14,1385,1355,2718,1363
2019,11,16,15,1470,1408,2746,1338
2019,11,16,16,1500,1465,2743,1278
2019,11,16,17,1510,1471,2719,1248
2019,11,16,18,1510,1474,2673,1199
2019,11,16,19,1500,1467,2676,1209
2019,11,16,20,1475,1451,2646,1195
2019,11,16,21,1445,1430,2668,1238
2019,11,16,22,1430,1425,2749,1324
2019,11,16,23,1425,1440,2804,1364
2019,11,17,0,1445,1495,2827,1332
2019,11,17,1,1485,1568,2808,1240
2019,11,17,2,1525,1573,2799,1226
2019,11,17,3,1515,1540,2793,1253
2019,11,17,4,1490,1518,2789,1271
2019,11,17,5,1470,1482,2815,1333
2019,11,17,6,1390,1435,2815,1380
2019,11,17,7,1335,1378,2801,1423
2019,11,17,8,1275,1354,2776,1422
2019,11,17,9,1250,1331,2709,1378
2019,11,17,10,1250,1325,2677,1352
2019,11,17,11,1250,1322,2711,1389
2019,11,17,12,1265,1323,2761,1438
2019,11,17,13,1305,1348,2870,1522
2019,11,17,14,1355,1383,2877,1494
2019,11,17,15,1410,1423,2824,1401
2019,11,17,16,1430,1479,2818,1339
2019,11,17,17,1440,1497,2832,1335
2019,11,17,18,1445,1527,2841,1314
2019,11,17,19,1420,1528,2856,1328
2019,11,17,20,1415,1534,2874,1340
2019,11,17,21,1395,1524,2858,1334
2019,11,17,22,1380,1534,2820,1286
2019,11,17,23,1380,1531,2808,1277
2019,11,18,0,1420,1578,2747,1169
2019,11,18,1,1495,1603,2771,1168
2019,11,18,2,1490,1587,2798,1211
2019,11,18,3,1465,1550,2756,1206
2019,11,18,4,1435,1522,2756,1234
2019,11,18,5,1410,1465,2811,1346
2019,11,18,6,1325,1378,2765,1387
2019,11,18,7,1275,1311,2709,1398
2019,11,18,8,1255,1295,2679,1384
2019,11,18,9,1235,1290,2669,1379
2019,11,18,10,1230,1290,2676,1386
2019,11,18,11,1240,1289,2686,1397
2019,11,18,12,1260,1311,2706,1395
2019,11,18,13,1315,1362,2765,1403
2019,11,18,14,1440,1499,2859,1360
2019,11,18,15,1505,1574,2893,1319
2019,11,18,16,1495,1555,2877,1322
2019,11,18,17,1500,1547,2875,1328
2019,11,18,18,1485,1537,2894,1357
2019,11,18,19,1475,1530,2885,1355
2019,11,18,20,1450,1520,2870,1350
2019,11,18,21,1445,1493,2876,1383
2019,11,18,22,1430,1481,2860,1379
2019,11,18,23,1430,1470,2837,1367
2019,11,19,0,1465,1513,2809,1296
2019,11,19,1,1530,1578,2752,1174
2019,11,19,2,1535,1577,2781,1204
2019,11,19,3,1510,1552,2709,1157
2019,11,19,4,1470,1512,2689,1177
2019,11,19,5,1430,1458,2655,1197
2019,11,19,6,1335,1375,2568,1193
2019,11,19,7,1280,1326,2577,1251
2019,11,19,8,1340,1296,2565,1269
2019,11,19,9,1320,1292,2567,1275
2019,11,19,10,1315,1286,2590,1304
2019,11,19,11,1305,1292,2554,1262
2019,11,19,12,1330,1309,2558,1249
2019,11,19,13,1370,1372,2546,1174
2019,11,19,14,1490,1486,2537,1051
2019,11,19,15,1555,1577,2614,1037
2019,11,19,16,1560,1590,2636,1046
2019,11,19,17,1545,1606,2639,1033
2019,11,19,18,1530,1646,2621,975
2019,11,19,19,1515,1638,2610,972
2019,11,19,20,1505,1625,2597,972
2019,11,19,21,1490,1520,2587,1067
2019,11,19,22,1500,1546,2579,1033
2019,11,19,23,1500,1763,2632,869
2019,11,20,0,1535,1584,2709,1125
2019,11,20,1,1580,1675,2792,1117
2019,11,20,2,1575,1672,2799,1127
2019,11,20,3,1550,1633,2771,1138
2019,11,20,4,1510,1598,2819,1221
2019,11,20,5,1470,1549,2776,1227
2019,11,20,6,1385,1474,2806,1332
2019,11,20,7,1320,1420,2781,1361
2019,11,20,8,1320,1386,2784,1398
2019,11,20,9,1310,1367,2772,1405
2019,11,20,10,1305,1349,2772,1423
2019,11,20,11,1310,1357,2793,1436
2019,11,20,12,1340,1368,2762,1394
2019,11,20,13,1400,1411,2767,1356
2019,11,20,14,1520,1542,2743,1201
2019,11,20,15,1590,1635,2692,1057
2019,11,20,16,1580,1605,2687,1082
2019,11,20,17,1575,1612,2706,1094
2019,11,20,18,1560,1603,2719,1116
2019,11,20,19,1550,1609,2741,1132
2019,11,20,20,1520,1602,2728,1126
2019,11,20,21,1505,1580,2682,1102
2019,11,20,22,1490,1585,2677,1092
2019,11,20,23,1500,1601,2680,1079
2019,11,21,0,1535,1686,2685,999
2019,11,21,1,1610,1703,2711,1008
2019,11,21,2,1630,1714,2723,1009
2019,11,21,3,1610,1677,2664,987
2019,11,21,4,1580,1649,2663,1014
2019,11,21,5,1530,1596,2638,1042
2019,11,21,6,1450,1507,2567,1060
2019,11,21,7,1385,1452,2610,1158
2019,11,21,8,1335,1420,2597,1177
2019,11,21,9,1325,1401,2464,1063
2019,11,21,10,1325,1414,2478,1064
2019,11,21,11,1335,1406,2487,1081
2019,11,21,12,1355,1423,2514,1091
2019,11,21,13,1425,1496,2613,1117
2019,11,21,14,1545,1599,2709,1110
2019,11,21,15,1620,1685,2728,1043
2019,11,21,16,1600,1663,2748,1085
2019,11,21,17,1580,1639,2701,1062
2019,11,21,18,1565,1629,2714,1085
2019,11,21,19,1530,1589,2692,1103
2019,11,21,20,1500,1563,2667,1104
2019,11,21,21,1480,1545,2658,1113
2019,11,21,22,1470,1538,2657,1119
2019,11,21,23,1495,1548,2660,1112
2019,11,22,0,1510,1588,2644,1056
2019,11,22,1,1605,1664,2673,1009
2019,11,22,2,1610,1678,2673,995
2019,11,22,3,1595,1668,2658,990
2019,11,22,4,1565,1632,2559,927
2019,11,22,5,1500,1582,2514,932
2019,11,22,6,1435,1511,2552,1041
2019,11,22,7,1375,1433,2532,1099
2019,11,22,8,1335,1396,2533,1137
2019,11,22,9,1325,1396,2592,1196
2019,11,22,10,1320,1400,2645,1245
2019,11,22,11,1335,1400,2684,1284
2019,11,22,12,1345,1432,2720,1288
2019,11,22,13,1395,1485,2717,1232
2019,11,22,14,1515,1599,2732,1133
2019,11,22,15,1635,1674,2763,1089
2019,11,22,16,1630,1668,2747,1079
2019,11,22,17,1620,1637,2761,1124
2019,11,22,18,1590,1613,2761,1148
2019,11,22,19,1570,1587,2764,1177
2019,11,22,20,1535,1554,2749,1195
2019,11,22,21,1515,1511,2680,1169
2019,11,22,22,1500,1493,2691,1198
2019,11,22,23,1500,1492,2641,1149
2019,11,23,0,1515,1528,2676,1148
2019,11,23,1,1530,1606,2700,1094
2019,11,23,2,1580,1630,2641,1011
2019,11,23,3,1605,1617,2636,1019
2019,11,23,4,1580,1611,2681,1070
2019,11,23,5,1540,1558,2677,1119
2019,11,23,6,1480,1519,2722,1203
2019,11,23,7,1430,1477,2667,1190
2019,11,23,8,1370,1438,2633,1195
2019,11,23,9,1350,1423,2626,1203
2019,11,23,10,1345,1416,2634,1218
2019,11,23,11,1330,1408,2629,1221
2019,11,23,12,1345,1423,2604,1181
2019,11,23,13,1375,1447,2632,1185
2019,11,23,14,1405,1485,2658,1173
2019,11,23,15,1450,1533,2674,1141
2019,11,23,16,1485,1572,2662,1090
2019,11,23,17,1485,1588,2659,1071
2019,11,23,18,1490,1597,2692,1095
2019,11,23,19,1475,1578,2713,1135
2019,11,23,20,1460,1533,2703,1170
2019,11,23,21,1440,1509,2691,1182
2019,11,23,22,1430,1485,2706,1221
2019,11,23,23,1440,1497,2703,1206
2019,11,24,0,1490,1538,2709,1171
2019,11,24,1,1565,1613,2759,1146
2019,11,24,2,1570,1606,2740,1134
2019,11,24,3,1545,1594,2685,1091
2019,11,24,4,1515,1545,2643,1098
2019,11,24,5,1450,1501,2655,1154
2019,11,24,6,1425,1446,2627,1181
2019,11,24,7,1360,1377,2603,1226
2019,11,24,8,1340,1332,2578,1246
2019,11,24,9,1325,1331,2511,1180
2019,11,24,10,1325,1306,2483,1177
2019,11,24,11,1320,1304,2481,1177
2019,11,24,12,1325,1313,2444,1131
2019,11,24,13,1360,1334,2488,1154
2019,11,24,14,1380,1383,2479,1096
2019,11,24,15,1405,1436,2582,1146
2019,11,24,16,1440,1487,2631,1144
2019,11,24,17,1455,1510,2643,1133
2019,11,24,18,1480,1518,2623,1105
2019,11,24,19,1470,1509,2607,1098
2019,11,24,20,1475,1509,2598,1089
2019,11,24,21,1460,1496,2579,1083
2019,11,24,22,1470,1503,2557,1054
2019,11,24,23,1470,1504,2592,1088
2019,11,25,0,1515,1564,2640,1076
2019,11,25,1,1560,1651,2654,1003
2019,11,25,2,1550,1642,2661,1019
2019,11,25,3,1520,1624,2660,1036
2019,11,25,4,1495,1576,2634,1058
2019,11,25,5,1405,1520,2609,1089
2019,11,25,6,1360,1429,2604,1175
2019,11,25,7,1295,1379,2580,1201
2019,11,25,8,1355,1338,2480,1142
2019,11,25,9,1350,1335,2496,1161
2019,11,25,10,1340,1333,2463,1130
2019,11,25,11,1350,1343,2411,1068
2019,11,25,12,1375,1374,2437,1063
2019,11,25,13,1430,1419,2403,984
2019,11,25,14,1555,1539,2392,853
2019,11,25,15,1630,1626,2395,769
2019,11,25,16,1620,1609,2396,787
2019,11,25,17,1610,1607,2374,767
2019,11,25,18,1585,1589,2373,784
2019,11,25,19,1565,1582,2357,775
2019,11,25,20,1545,1562,2308,746
2019,11,25,21,1535,1549,2295,746
2019,11,25,22,1525,1546,2310,764
2019,11,25,23,1525,1553,2356,803
2019,11,26,0,1585,1610,2353,743
2019,11,26,1,1650,1693,2350,657
2019,11,26,2,1660,1700,2416,716
2019,11,26,3,1635,1678,2438,760
2019,11,26,4,1610,1646,2430,784
2019,11,26,5,1550,1574,2427,853
2019,11,26,6,1470,1501,2372,871
2019,11,26,7,1410,1444,2377,933
2019,11,26,8,1355,1414,2375,961
2019,11,26,9,1340,1385,2360,975
2019,11,26,10,1330,1388,2355,967
2019,11,26,11,1315,1395,2349,954
2019,11,26,12,1350,1414,2365,951
2019,11,26,13,1385,1474,2402,928
2019,11,26,14,1500,1587,2416,829
2019,11,26,15,1575,1663,2424,761
2019,11,26,16,1585,1661,2436,775
2019,11,26,17,1560,1649,2422,773
2019,11,26,18,1545,1628,2391,763
2019,11,26,19,1525,1613,2390,777
2019,11,26,20,1515,1576,2393,817
2019,11,26,21,1500,1566,2322,756
2019,11,26,22,1515,1560,2287,727
2019,11,26,23,1515,1566,2286,720
2019,11,27,0,1555,1612,2295,683
2019,11,27,1,1605,1706,2373,667
2019,11,27,2,1590,1714,2386,672
2019,11,27,3,1570,1699,2392,693
2019,11,27,4,1530,1673,2336,663
2019,11,27,5,1475,1621,2289,668
2019,11,27,6,1400,1532,2297,765
2019,11,27,7,1340,1471,2342,871
2019,11,27,8,1415,1443,2384,941
2019,11,27,9,1405,1426,2400,974
2019,11,27,10,1395,1428,2441,1013
2019,11,27,11,1410,1425,2459,1034
2019,11,27,12,1435,1465,2491,1026
2019,11,27,13,1495,1520,2516,996
2019,11,27,14,1585,1625,2489,864
2019,11,27,15,1630,1696,2484,788
2019,11,27,16,1620,1705,2467,762
2019,11,27,17,1615,1732,2496,764
2019,11,27,18,1600,1749,2498,749
2019,11,27,19,1595,1744,2515,771
2019,11,27,20,1570,1741,2541,800
2019,11,27,21,1555,1722,2546,824
2019,11,27,22,1545,1719,2584,865
2019,11,27,23,1560,1711,2593,882
2019,11,28,0,1605,1741,2603,862
2019,11,28,1,1665,1802,2684,882
2019,11,28,2,1690,1789,2744,955
2019,11,28,3,1665,1767,2776,1009
2019,11,28,4,1635,1741,2752,1011
2019,11,28,5,1550,1689,2722,1033
2019,11,28,6,1505,1612,2700,1088
2019,11,28,7,1435,1558,2721,1163
2019,11,28,8,1415,1530,2725,1195
2019,11,28,9,1400,1504,2645,1141
2019,11,28,10,1405,1502,2607,1105
2019,11,28,11,1400,1500,2624,1124
2019,11,28,12,1415,1545,2700,1155
2019,11,28,13,1455,1544,2715,1171
2019,11,28,14,1515,1577,2697,1120
2019,11,28,15,1570,1635,2770,1135
2019,11,28,16,1580,1689,2730,1041
2019,11,28,17,1600,1746,2772,1026
2019,11,28,18,1600,1761,2789,1028
2019,11,28,19,1575,1751,2819,1068
2019,11,28,20,1555,1722,2799,1077
2019,11,28,21,1550,1672,2781,1109
2019,11,28,22,1535,1631,2775,1144
2019,11,28,23,1535,1608,2753,1145
2019,11,29,0,1550,1611,2683,1072
2019,11,29,1,1595,1638,2712,1074
2019,11,29,2,1670,1622,2674,1052
2019,11,29,3,1675,1617,2673,1056
2019,11,29,4,1645,1608,2671,1063
2019,11,29,5,1570,1590,2664,1074
2019,11,29,6,1520,1543,2616,1073
2019,11,29,7,1450,1485,2533,1048
2019,11,29,8,1420,1481,2635,1154
2019,11,29,9,1405,1457,2632,1175
2019,11,29,10,1405,1462,2638,1176
2019,11,29,11,1405,1467,2646,1179
2019,11,29,12,1425,1488,2641,1153
2019,11,29,13,1460,1534,2644,1110
2019,11,29,14,1525,1594,2615,1021
2019,11,29,15,1575,1650,2531,881
2019,11,29,16,1590,1700,2588,888
2019,11,29,17,1610,1712,2595,883
2019,11,29,18,1605,1716,2483,767
2019,11,29,19,1580,1682,1779,97
2019,11,29,20,1560,1693,1511,-182
2019,11,29,21,1555,1666,1522,-144
2019,11,29,22,1530,1660,1572,-88
2019,11,29,23,1530,1681,1610,-71
2019,11,30,0,1540,1732,1640,-92
2019,11,30,1,1590,1780,1650,-130
2019,11,30,2,1665,1753,1544,-209
2019,11,30,3,1670,1723,1514,-209
2019,11,30,4,1650,1692,1517,-175
2019,11,30,5,1575,1652,1536,-116
2019,11,30,6,1530,1579,1530,-49
2019,11,30,7,1475,1540,1546,6
2019,11,30,8,1415,1496,1652,156
2019,11,30,9,1395,1467,1696,229
2019,11,30,10,1395,1437,1739,302
2019,11,30,11,1390,1458,1765,307
2019,11,30,12,1405,1487,1799,312
2019,11,30,13,1435,1505,1786,281
2019,11,30,14,1505,1531,1775,244
2019,11,30,15,1565,1581,1782,201
2019,11,30,16,1590,1623,1788,165
2019,11,30,17,1625,1642,1780,138
2019,11,30,18,1630,1637,1767,130
2019,11,30,19,1605,1606,1776,170
2019,11,30,20,1585,1578,1740,162
2019,11,30,21,1585,1549,1678,129
2019,11,30,22,1555,1536,1651,115
2019,11,30,23,1555,1551,1651,100
2019,12,1,0,1570,1593,1663,70
2019,12,1,1,1620,1674,1733,59
2019,12,1,2,1690,1685,1779,94
2019,12,1,3,1690,1659,1807,148
2019,12,1,4,1660,1651,1838,187
2019,12,1,5,1565,1615,1858,243
2019,12,1,6,1535,1559,1887,328
2019,12,1,7,1470,1497,1866,369
2019,12,1,8,1435,1438,1906,468
2019,12,1,9,1425,1412,1923,511
2019,12,1,10,1415,1403,1936,533
2019,12,1,11,1410,1400,1948,548
2019,12,1,12,1425,1424,1965,541
2019,12,1,13,1450,1421,1919,498
2019,12,1,14,1475,1485,1921,436
2019,12,1,15,1500,1525,1866,341
2019,12,1,16,1535,1562,1816,254
2019,12,1,17,1560,1578,1841,263
2019,12,1,18,1565,1584,1879,295
2019,12,1,19,1550,1563,1872,309
2019,12,1,20,1540,1551,1872,321
2019,12,1,21,1535,1529,1875,346
2019,12,1,22,1525,1523,1884,361
2019,12,1,23,1525,1526,1889,363
2019,12,2,0,1540,1569,1853,284
2019,12,2,1,1595,1639,1862,223
2019,12,2,2,1660,1627,1808,181
2019,12,2,3,1660,1602,1792,190
2019,12,2,4,1630,1572,1813,241
2019,12,2,5,1500,1516,1874,358
2019,12,2,6,1495,1448,1884,436
2019,12,2,7,1435,1359,1890,531
2019,12,2,8,1365,1323,1884,561
2019,12,2,9,1365,1292,1841,549
2019,12,2,10,1360,1304,1858,554
2019,12,2,11,1360,1302,1901,599
2019,12,2,12,1390,1314,1920,606
2019,12,2,13,1440,1376,1933,557
2019,12,2,14,1570,1503,1936,433
2019,12,2,15,1640,1573,1922,349
2019,12,2,16,1620,1566,1923,357
2019,12,2,17,1610,1543,1887,344
2019,12,2,18,1600,1528,1884,356
2019,12,2,19,1590,1488,1934,446
2019,12,2,20,1575,1482,1907,425
2019,12,2,21,1550,1460,1917,457
2019,12,2,22,1545,1459,1928,469
2019,12,2,23,1540,1455,1919,464
2019,12,3,0,1590,1501,1925,424
2019,12,3,1,1660,1563,1952,389
2019,12,3,2,1660,1574,1961,387
2019,12,3,3,1640,1553,1960,407
2019,12,3,4,1600,1504,1921,417
2019,12,3,5,1540,1444,1925,481
2019,12,3,6,1455,1365,1929,564
2019,12,3,7,1400,1303,1924,621
2019,12,3,8,1290,1248,1906,658
2019,12,3,9,1260,1248,1781,533
2019,12,3,10,1260,1236,1769,533
2019,12,3,11,1265,1242,1768,526
2019,12,3,12,1280,1236,1813,577
2019,12,3,13,1330,1293,1937,644
2019,12,3,14,1425,1406,1937,531
2019,12,3,15,1495,1494,1929,435
2019,12,3,16,1500,1472,1907,435
2019,12,3,17,1500,1475,1937,462
2019,12,3,18,1495,1445,1906,461
2019,12,3,19,1480,1424,1929,505
2019,12,3,20,1450,1420,1937,517
2019,12,3,21,1430,1445,1938,493
2019,12,3,22,1430,1402,1918,516
2019,12,3,23,1460,1422,1947,525
2019,12,4,0,1475,1469,1959,490
2019,12,4,1,1560,1552,1958,406
2019,12,4,2,1560,1546,1975,429
2019,12,4,3,1540,1529,1963,434
2019,12,4,4,1515,1482,1947,465
2019,12,4,5,1495,1423,1778,355
2019,12,4,6,1385,1340,1719,379
2019,12,4,7,1325,1278,1724,446
2019,12,4,8,1255,1233,1726,493
2019,12,4,9,1240,1207,1727,520
2019,12,4,10,1235,1207,1742,535
2019,12,4,11,1235,1219,1735,516
2019,12,4,12,1260,1231,1701,470
2019,12,4,13,1310,1281,1690,409
2019,12,4,14,1420,1417,1715,298
2019,12,4,15,1490,1499,1672,173
2019,12,4,16,1490,1481,1655,174
2019,12,4,17,1505,1470,1658,188
2019,12,4,18,1510,1462,1707,245
2019,12,4,19,1500,1453,1732,279
2019,12,4,20,1495,1417,1897,480
2019,12,4,21,1475,1403,2070,667
2019,12,4,22,1475,1427,2435,1008
2019,12,4,23,1470,1438,2446,1008
2019,12,5,0,1510,1499,2473,974
2019,12,5,1,1555,1547,2615,1068
2019,12,5,2,1555,1587,2783,1196
2019,12,5,3,1530,1558,2770,1212
2019,12,5,4,1495,1536,2738,1202
2019,12,5,5,1460,1467,2766,1299
2019,12,5,6,1375,1405,2755,1350
2019,12,5,7,1325,1334,2810,1476
2019,12,5,8,1220,1281,2771,1490
2019,12,5,9,1220,1267,2778,1511
2019,12,5,10,1210,1247,2781,1534
2019,12,5,11,1210,1199,2193,994
2019,12,5,12,1215,1212,2064,852
2019,12,5,13,1265,1278,2007,729
2019,12,5,14,1405,1404,2001,597
2019,12,5,15,1530,1495,1941,446
2019,12,5,16,1515,1491,1894,403
2019,12,5,17,1515,1475,1701,226
2019,12,5,18,1495,1450,1355,-95
2019,12,5,19,1475,1407,1290,-117
2019,12,5,20,1465,1383,1299,-84
2019,12,5,21,1480,1371,1383,12
2019,12,5,22,1440,1358,1653,295
2019,12,5,23,1450,1377,1818,441
2019,12,6,0,1495,1418,1804,386
2019,12,6,1,1575,1491,1836,345
2019,12,6,2,1570,1486,1836,350
2019,12,6,3,1555,1469,1862,393
2019,12,6,4,1510,1444,1867,423
2019,12,6,5,1530,1379,1894,515
2019,12,6,6,1380,1289,1912,623
2019,12,6,7,1320,1244,1976,732
2019,12,6,8,1280,1211,2035,824
2019,12,6,9,1270,1182,2026,844
2019,12,6,10,1275,1177,2068,891
2019,12,6,11,1275,1192,2099,907
2019,12,6,12,1300,1212,2100,888
2019,12,6,13,1350,1281,2113,832
2019,12,6,14,1460,1391,2140,749
2019,12,6,15,1540,1478,2151,673
2019,12,6,16,1540,1474,2151,677
2019,12,6,17,1520,1441,2148,707
2019,12,6,18,1500,1426,2107,681
2019,12,6,19,1475,1392,2139,747
2019,12,6,20,1455,1375,2133,758
2019,12,6,21,1430,1351,2149,798
2019,12,6,22,1410,1341,2102,761
2019,12,6,23,1410,1343,2090,747
2019,12,7,0,1450,1403,2078,675
2019,12,7,1,1515,1454,2059,605
2019,12,7,2,1525,1429,2048,619
2019,12,7,3,1515,1418,2044,626
2019,12,7,4,1495,1398,1998,600
2019,12,7,5,1450,1350,2002,652
2019,12,7,6,1395,1295,1989,694
2019,12,7,7,1350,1251,2065,814
2019,12,7,8,1170,1207,2064,857
2019,12,7,9,1155,1183,2085,902
2019,12,7,10,1145,1183,2059,876
2019,12,7,11,1140,1186,2030,844
2019,12,7,12,1155,1192,2102,910
2019,12,7,13,1185,1217,2146,929
2019,12,7,14,1270,1267,2124,857
2019,12,7,15,1340,1330,2101,771
2019,12,7,16,1375,1373,2096,723
2019,12,7,17,1390,1399,2103,704
2019,12,7,18,1390,1406,2151,745
2019,12,7,19,1370,1384,2145,761
2019,12,7,20,1345,1370,2095,725
2019,12,7,21,1330,1347,2140,793
2019,12,7,22,1300,1342,2181,839
2019,12,7,23,1310,1329,2115,786
2019,12,8,0,1345,1360,2132,772
2019,12,8,1,1415,1436,2141,705
2019,12,8,2,1415,1412,2120,708
2019,12,8,3,1395,1394,2097,703
2019,12,8,4,1365,1368,2090,722
2019,12,8,5,1340,1322,2014,692
2019,12,8,6,1275,1266,2017,751
2019,12,8,7,1215,1204,1970,766
2019,12,8,8,1230,1169,1967,798
2019,12,8,9,1225,1139,1944,805
2019,12,8,10,1215,1145,1952,807
2019,12,8,11,1195,1129,1998,869
2019,12,8,12,1210,1135,1938,803
2019,12,8,13,1230,1159,2056,897
2019,12,8,14,1280,1197,2031,834
2019,12,8,15,1315,1259,2089,830
2019,12,8,16,1365,1328,2217,889
2019,12,8,17,1370,1375,2207,832
2019,12,8,18,1370,1390,2192,802
2019,12,8,19,1355,1397,2236,839
2019,12,8,20,1355,1409,2251,842
2019,12,8,21,1340,1412,2241,829
2019,12,8,22,1355,1386,2181,795
2019,12,8,23,1350,1387,2108,721
2019,12,9,0,1395,1445,2108,663
2019,12,9,1,1470,1535,2077,542
2019,12,9,2,1460,1517,2000,483
2019,12,9,3,1440,1508,1911,403
2019,12,9,4,1405,1463,1881,418
2019,12,9,5,1315,1427,1939,512
2019,12,9,6,1275,1347,1937,590
2019,12,9,7,1225,1279,1968,689
2019,12,9,8,1240,1244,1992,748
2019,12,9,9,1230,1232,2019,787
2019,12,9,10,1230,1227,2036,809
2019,12,9,11,1230,1240,2127,887
2019,12,9,12,1255,1260,2134,874
2019,12,9,13,1310,1319,2162,843
2019,12,9,14,1415,1439,2121,682
2019,12,9,15,1495,1528,2091,563
2019,12,9,16,1480,1530,2150,620
2019,12,9,17,1470,1528,2192,664
2019,12,9,18,1455,1502,2175,673
2019,12,9,19,1435,1478,2189,711
2019,12,9,20,1420,1445,2189,744
2019,12,9,21,1405,1430,2188,758
2019,12,9,22,1400,1419,2176,757
2019,12,9,23,1405,1428,2113,685
2019,12,10,0,1455,1503,2134,631
2019,12,10,1,1520,1579,2158,579
2019,12,10,2,1525,1565,2175,610
2019,12,10,3,1510,1555,2142,587
2019,12,10,4,1475,1511,2092,581
2019,12,10,5,1450,1436,2067,631
2019,12,10,6,1340,1347,2004,657
2019,12,10,7,1285,1267,1994,727
2019,12,10,8,1215,1230,2002,772
2019,12,10,9,1205,1211,1958,747
2019,12,10,10,1200,1205,1965,760
2019,12,10,11,1200,1216,2020,804
2019,12,10,12,1200,1249,2082,833
2019,12,10,13,1250,1312,2090,778
2019,12,10,14,1335,1437,2114,677
2019,12,10,15,1405,1525,2142,617
2019,12,10,16,1405,1514,2121,607
2019,12,10,17,1410,1495,2134,639
2019,12,10,18,1395,1475,2152,677
2019,12,10,19,1380,1463,2158,695
2019,12,10,20,1375,1440,2164,724
2019,12,10,21,1390,1433,2173,740
2019,12,10,22,1360,1405,2133,728
2019,12,10,23,1370,1415,2173,758
2019,12,11,0,1420,1468,2318,850
2019,12,11,1,1505,1563,2329,766
2019,12,11,2,1495,1583,2458,875
2019,12,11,3,1480,1571,2454,883
2019,12,11,4,1440,1543,2564,1021
2019,12,11,5,1405,1482,2643,1161
2019,12,11,6,1310,1403,2625,1222
2019,12,11,7,1250,1347,2781,1434
2019,12,11,8,1195,1313,2733,1420
2019,12,11,9,1170,1266,2716,1450
2019,12,11,10,1170,1288,2720,1432
2019,12,11,11,1180,1277,2709,1432
2019,12,11,12,1195,1309,2731,1422
2019,12,11,13,1245,1359,2733,1374
2019,12,11,14,1380,1482,2759,1277
2019,12,11,15,1470,1572,2766,1194
2019,12,11,16,1460,1569,2784,1215
2019,12,11,17,1455,1563,2780,1217
2019,12,11,18,1445,1568,2781,1213
2019,12,11,19,1435,1543,2781,1238
2019,12,11,20,1405,1524,2794,1270
2019,12,11,21,1385,1536,2913,1377
2019,12,11,22,1400,1514,2882,1368
2019,12,11,23,1400,1523,2917,1394
2019,12,12,0,1460,1584,2898,1314
2019,12,12,1,1505,1619,2825,1206
2019,12,12,2,1530,1587,2523,936
2019,12,12,3,1500,1551,2510,959
2019,12,12,4,1480,1524,2495,971
2019,12,12,5,1470,1457,2509,1052
2019,12,12,6,1345,1393,2676,1283
2019,12,12,7,1275,1324,2756,1432
2019,12,12,8,1250,1294,2785,1491
2019,12,12,9,1230,1274,2767,1493
2019,12,12,10,1220,1270,2750,1480
2019,12,12,11,1220,1256,2768,1512
2019,12,12,12,1245,1276,2815,1539
2019,12,12,13,1305,1323,2779,1456
2019,12,12,14,1430,1453,2802,1349
2019,12,12,15,1520,1534,2735,1201
2019,12,12,16,1520,1528,2831,1303
2019,12,12,17,1515,1523,2819,1296
2019,12,12,18,1495,1497,2859,1362
2019,12,12,19,1480,1516,2947,1431
2019,12,12,20,1460,1489,2930,1441
2019,12,12,21,1440,1483,2941,1458
2019,12,12,22,1415,1484,2959,1475
2019,12,12,23,1420,1486,2948,1462
2019,12,13,0,1465,1535,2964,1429
2019,12,13,1,1540,1602,2953,1351
2019,12,13,2,1550,1600,2944,1344
2019,12,13,3,1535,1584,2936,1352
2019,12,13,4,1510,1561,2891,1330
2019,12,13,5,1470,1508,2834,1326
2019,12,13,6,1375,1414,2818,1404
2019,12,13,7,1320,1322,2809,1487
2019,12,13,8,1235,1266,2815,1549
2019,12,13,9,1205,1252,2855,1603
2019,12,13,10,1205,1250,2825,1575
2019,12,13,11,1220,1241,2821,1580
2019,12,13,12,1235,1270,2869,1599
2019,12,13,13,1300,1323,2843,1520
2019,12,13,14,1435,1425,2798,1373
2019,12,13,15,1545,1532,2791,1259
2019,12,13,16,1545,1548,2787,1239
2019,12,13,17,1525,1548,2803,1255
2019,12,13,18,1515,1542,2823,1281
2019,12,13,19,1485,1545,2842,1297
2019,12,13,20,1475,1500,2898,1398
2019,12,13,21,1450,1498,2887,1389
2019,12,13,22,1440,1491,2892,1401
2019,12,13,23,1445,1491,2866,1375
2019,12,14,0,1505,1548,2797,1249
2019,12,14,1,1555,1583,2762,1179
2019,12,14,2,1530,1581,2771,1190
2019,12,14,3,1510,1564,2707,1143
2019,12,14,4,1485,1541,2653,1112
2019,12,14,5,1450,1494,2646,1152
2019,12,14,6,1370,1449,2654,1205
2019,12,14,7,1330,1390,2760,1370
2019,12,14,8,1270,1342,2686,1344
2019,12,14,9,1245,1316,2670,1354
2019,12,14,10,1240,1301,2679,1378
2019,12,14,11,1245,1313,2673,1360
2019,12,14,12,1255,1318,2649,1331
2019,12,14,13,1285,1337,2649,1312
2019,12,14,14,1375,1394,2649,1255
2019,12,14,15,1465,1467,2673,1206
2019,12,14,16,1500,1510,2651,1141
2019,12,14,17,1530,1543,2661,1118
2019,12,14,18,1525,1559,2646,1087
2019,12,14,19,1515,1552,2658,1106
2019,12,14,20,1490,1522,2674,1152
2019,12,14,21,1475,1507,2675,1168
2019,12,14,22,1460,1484,2677,1193
2019,12,14,23,1455,1496,2684,1188
2019,12,15,0,1495,1536,2683,1147
2019,12,15,1,1575,1594,2668,1074
2019,12,15,2,1555,1577,2656,1079
2019,12,15,3,1540,1560,2663,1103
2019,12,15,4,1515,1521,2577,1056
2019,12,15,5,1465,1481,2607,1126
2019,12,15,6,1400,1421,2657,1236
2019,12,15,7,1325,1371,2733,1362
2019,12,15,8,1270,1329,2737,1408
2019,12,15,9,1240,1297,2632,1335
2019,12,15,10,1240,1297,2621,1324
2019,12,15,11,1230,1293,2626,1333
2019,12,15,12,1240,1296,2624,1328
2019,12,15,13,1270,1327,2737,1410
2019,12,15,14,1315,1373,2784,1411
2019,12,15,15,1365,1427,2805,1378
2019,12,15,16,1415,1480,2813,1333
2019,12,15,17,1445,1504,2807,1303
2019,12,15,18,1445,1519,2794,1275
2019,12,15,19,1455,1507,2838,1331
2019,12,15,20,1455,1485,2854,1369
2019,12,15,21,1455,1474,2832,1358
2019,12,15,22,1440,1463,2834,1371
2019,12,15,23,1440,1485,2846,1361
2019,12,16,0,1495,1553,2874,1321
2019,12,16,1,1580,1628,2898,1270
2019,12,16,2,1570,1633,2883,1250
2019,12,16,3,1555,1617,2889,1272
2019,12,16,4,1515,1590,2862,1272
2019,12,16,5,1480,1549,2878,1329
2019,12,16,6,1390,1470,2875,1405
2019,12,16,7,1315,1396,2856,1460
2019,12,16,8,1285,1366,2872,1506
2019,12,16,9,1265,1344,2887,1543
2019,12,16,10,1260,1344,2904,1560
2019,12,16,11,1270,1340,2906,1566
2019,12,16,12,1290,1370,2911,1541
2019,12,16,13,1350,1424,2914,1490
2019,12,16,14,1505,1551,2960,1409
2019,12,16,15,1615,1641,2965,1324
2019,12,16,16,1610,1626,2943,1317
2019,12,16,17,1605,1632,2936,1304
2019,12,16,18,1580,1617,2939,1322
2019,12,16,19,1565,1593,2925,1332
2019,12,16,20,1535,1573,2928,1355
2019,12,16,21,1515,1543,2925,1382
2019,12,16,22,1510,1535,2936,1401
2019,12,16,23,1515,1548,2935,1387
2019,12,17,0,1585,1597,2948,1351
2019,12,17,1,1660,1698,2974,1276
2019,12,17,2,1650,1700,2969,1269
2019,12,17,3,1640,1685,2966,1281
2019,12,17,4,1595,1667,2949,1282
2019,12,17,5,1540,1602,2914,1312
2019,12,17,6,1430,1513,2874,1361
2019,12,17,7,1340,1439,2879,1440
2019,12,17,8,1315,1407,2901,1494
2019,12,17,9,1295,1374,2912,1538
2019,12,17,10,1290,1369,2909,1540
2019,12,17,11,1300,1369,2911,1542
2019,12,17,12,1320,1378,2911,1533
2019,12,17,13,1380,1436,2964,1528
2019,12,17,14,1465,1555,2977,1422
2019,12,17,15,1520,1649,2972,1323
2019,12,17,16,1525,1637,2943,1306
2019,12,17,17,1515,1627,2930,1303
2019,12,17,18,1500,1604,2925,1321
2019,12,17,19,1485,1584,2733,1149
2019,12,17,20,1470,1558,1795,237
2019,12,17,21,1465,1526,1750,224
2019,12,17,22,1435,1516,1731,215
2019,12,17,23,1450,1530,1728,198
2019,12,18,0,1505,1606,1744,138
2019,12,18,1,1595,1650,1811,161
2019,12,18,2,1605,1637,2083,446
2019,12,18,3,1590,1625,2363,738
2019,12,18,4,1560,1617,2649,1032
2019,12,18,5,1520,1586,2902,1316
2019,12,18,6,1415,1502,2922,1420
2019,12,18,7,1350,1433,2906,1473
2019,12,18,8,1335,1365,2864,1499
2019,12,18,9,1310,1353,2876,1523
2019,12,18,10,1315,1351,2906,1555
2019,12,18,11,1310,1348,2882,1534
2019,12,18,12,1335,1371,2891,1520
2019,12,18,13,1390,1413,2920,1507
2019,12,18,14,1505,1570,2976,1406
2019,12,18,15,1580,1684,2969,1285
2019,12,18,16,1565,1631,2899,1268
2019,12,18,17,1565,1603,2848,1245
2019,12,18,18,1555,1595,2848,1253
2019,12,18,19,1535,1552,2774,1222
2019,12,18,20,1510,1521,2748,1227
2019,12,18,21,1490,1525,2780,1255
2019,12,18,22,1485,1525,2815,1290
2019,12,18,23,1495,1528,2825,1297
2019,12,19,0,1550,1597,2826,1229
2019,12,19,1,1630,1651,2822,1171
2019,12,19,2,1630,1647,2743,1096
2019,12,19,3,1605,1619,2712,1093
2019,12,19,4,1585,1595,2734,1139
2019,12,19,5,1510,1553,2760,1207
2019,12,19,6,1440,1457,2744,1287
2019,12,19,7,1365,1396,2788,1392
2019,12,19,8,1345,1366,2864,1498
2019,12,19,9,1320,1365,2860,1495
2019,12,19,10,1310,1364,2854,1490
2019,12,19,11,1305,1368,2884,1516
2019,12,19,12,1320,1382,2864,1482
2019,12,19,13,1375,1430,2846,1416
2019,12,19,14,1500,1555,2923,1368
2019,12,19,15,1585,1626,2896,1270
2019,12,19,16,1575,1620,2888,1268
2019,12,19,17,1570,1612,2862,1250
2019,12,19,18,1540,1584,2876,1292
2019,12,19,19,1545,1548,2884,1336
2019,12,19,20,1520,1535,2892,1357
2019,12,19,21,1510,1514,2906,1392
2019,12,19,22,1505,1516,2900,1384
2019,12,19,23,1510,1513,2893,1380
2019,12,20,0,1570,1557,2873,1316
2019,12,20,1,1635,1621,2877,1256
2019,12,20,2,1625,1608,2882,1274
2019,12,20,3,1615,1591,2854,1263
2019,12,20,4,1585,1571,2809,1238
2019,12,20,5,1500,1507,2811,1304
2019,12,20,6,1435,1421,2766,1345
2019,12,20,7,1355,1348,2756,1408
2019,12,20,8,1270,1298,2768,1470
2019,12,20,9,1255,1280,2749,1469
2019,12,20,10,1255,1279,2811,1532
2019,12,20,11,1250,1273,2780,1507
2019,12,20,12,1280,1300,2846,1546
2019,12,20,13,1330,1366,2805,1439
2019,12,20,14,1440,1468,2825,1357
2019,12,20,15,1540,1543,2779,1236
2019,12,20,16,1540,1541,2796,1255
2019,12,20,17,1530,1530,2753,1223
2019,12,20,18,1520,1502,2776,1274
2019,12,20,19,1505,1481,2805,1324
2019,12,20,20,1475,1461,2767,1306
2019,12,20,21,1465,1450,2724,1274
2019,12,20,22,1465,1440,2745,1305
2019,12,20,23,1460,1429,2736,1307
2019,12,21,0,1520,1488,2731,1243
2019,12,21,1,1565,1533,2724,1191
2019,12,21,2,1560,1524,2719,1195
2019,12,21,3,1540,1498,2762,1264
2019,12,21,4,1520,1481,2743,1262
2019,12,21,5,1470,1452,2746,1294
2019,12,21,6,1410,1391,2770,1379
2019,12,21,7,1355,1327,2720,1393
2019,12,21,8,1275,1274,2711,1437
2019,12,21,9,1255,1252,2722,1470
2019,12,21,10,1240,1234,2742,1508
2019,12,21,11,1250,1224,2738,1514
2019,12,21,12,1260,1240,2762,1522
2019,12,21,13,1280,1249,2736,1487
2019,12,21,14,1340,1301,2723,1422
2019,12,21,15,1400,1361,2713,1352
2019,12,21,16,1435,1404,2693,1289
2019,12,21,17,1455,1437,2672,1235
2019,12,21,18,1460,1454,2688,1234
2019,12,21,19,1445,1440,2705,1265
2019,12,21,20,1425,1401,2710,1309
2019,12,21,21,1410,1390,2718,1328
2019,12,21,22,1390,1400,2712,1312
2019,12,21,23,1395,1412,2720,1308
2019,12,22,0,1440,1448,2730,1282
2019,12,22,1,1495,1512,2752,1240
2019,12,22,2,1480,1499,2762,1263
2019,12,22,3,1460,1493,2797,1304
2019,12,22,4,1435,1478,2799,1321
2019,12,22,5,1400,1424,2809,1385
2019,12,22,6,1330,1371,2825,1454
2019,12,22,7,1270,1307,2824,1517
2019,12,22,8,1275,1266,2861,1595
2019,12,22,9,1255,1240,2719,1479
2019,12,22,10,1255,1235,2707,1472
2019,12,22,11,1250,1227,2681,1454
2019,12,22,12,1255,1205,2651,1446
2019,12,22,13,1285,1227,2730,1503
2019,12,22,14,1320,1286,2798,1512
2019,12,22,15,1345,1336,2784,1448
2019,12,22,16,1390,1402,2771,1369
2019,12,22,17,1405,1419,2735,1316
2019,12,22,18,1410,1413,2714,1301
2019,12,22,19,1395,1404,2719,1315
2019,12,22,20,1385,1386,2683,1297
2019,12,22,21,1370,1383,2701,1318
2019,12,22,22,1365,1367,2717,1350
2019,12,22,23,1380,1375,2690,1315
2019,12,23,0,1440,1424,2690,1266
2019,12,23,1,1510,1508,2730,1222
2019,12,23,2,1505,1514,2754,1240
2019,12,23,3,1490,1484,2756,1272
2019,12,23,4,1465,1474,2740,1266
2019,12,23,5,1400,1425,2743,1318
2019,12,23,6,1345,1362,2674,1312
2019,12,23,7,1275,1294,2585,1291
2019,12,23,8,1275,1214,1983,769
2019,12,23,9,1260,1203,1506,303
2019,12,23,10,1255,1204,1459,255
2019,12,23,11,1255,1210,1486,276
2019,12,23,12,1280,1228,1511,283
2019,12,23,13,1335,1282,1589,307
2019,12,23,14,1450,1375,1589,214
2019,12,23,15,1530,1474,1624,150
2019,12,23,16,1520,1509,1631,122
2019,12,23,17,1520,1516,1625,109
2019,12,23,18,1500,1480,1592,112
2019,12,23,19,1475,1462,1608,146
2019,12,23,20,1455,1451,1779,328
2019,12,23,21,1430,1433,1808,375
2019,12,23,22,1425,1427,1884,457
2019,12,23,23,1435,1424,1874,450
2019,12,24,0,1485,1462,1874,412
2019,12,24,1,1570,1531,1789,258
2019,12,24,2,1565,1527,1700,173
2019,12,24,3,1550,1485,1491,6
2019,12,24,4,1530,1466,1479,13
2019,12,24,5,1470,1413,1488,75
2019,12,24,6,1380,1335,1454,119
2019,12,24,7,1305,1283,1446,163
2019,12,24,8,1220,1231,1357,126
2019,12,24,9,1195,1198,1327,129
2019,12,24,10,1190,1197,1350,153
2019,12,24,11,1185,1199,1396,197
2019,12,24,12,1180,1190,1477,287
2019,12,24,13,1210,1203,1597,394
2019,12,24,14,1310,1277,1614,337
2019,12,24,15,1405,1393,1773,380
2019,12,24,16,1445,1484,2165,681
2019,12,24,17,1455,1517,2293,776
2019,12,24,18,1445,1535,2505,970
2019,12,24,19,1430,1529,2515,986
2019,12,24,20,1415,1505,2514,1009
2019,12,24,21,1410,1480,2513,1033
2019,12,24,22,1385,1451,2515,1064
2019,12,24,23,1405,1458,2506,1048
2019,12,25,0,1455,1482,2494,1012
2019,12,25,1,1540,1539,2500,961
2019,12,25,2,1540,1512,2439,927
2019,12,25,3,1515,1459,2382,923
2019,12,25,4,1500,1449,2378,929
2019,12,25,5,1405,1416,2512,1096
2019,12,25,6,1380,1392,2549,1157
2019,12,25,7,1315,1360,2580,1220
2019,12,25,8,1245,1294,2521,1227
2019,12,25,9,1220,1263,2580,1317
2019,12,25,10,1215,1246,2575,1329
2019,12,25,11,1210,1247,2560,1313
2019,12,25,12,1205,1261,2571,1310
2019,12,25,13,1230,1299,2594,1295
2019,12,25,14,1335,1333,2580,1247
2019,12,25,15,1425,1340,2592,1252
2019,12,25,16,1460,1442,2607,1165
2019,12,25,17,1470,1456,2638,1182
2019,12,25,18,1465,1467,2635,1168
2019,12,25,19,1445,1445,2625,1180
2019,12,25,20,1430,1403,2645,1242
2019,12,25,21,1425,1411,2677,1266
2019,12,25,22,1410,1411,2687,1276
2019,12,25,23,1425,1396,2611,1215
2019,12,26,0,1475,1429,2613,1184
2019,12,26,1,1555,1480,2689,1209
2019,12,26,2,1555,1458,2671,1213
2019,12,26,3,1520,1457,2646,1189
2019,12,26,4,1510,1441,2671,1230
2019,12,26,5,1425,1413,2672,1259
2019,12,26,6,1385,1359,2651,1292
2019,12,26,7,1315,1310,2618,1308
2019,12,26,8,1255,1267,2596,1329
2019,12,26,9,1245,1254,2565,1311
2019,12,26,10,1240,1258,2599,1341
2019,12,26,11,1240,1253,2588,1335
2019,12,26,12,1255,1283,2602,1319
2019,12,26,13,1290,1326,2603,1277
2019,12,26,14,1435,1404,2611,1207
2019,12,26,15,1535,1483,2608,1125
2019,12,26,16,1540,1528,2608,1080
2019,12,26,17,1535,1543,2612,1069
2019,12,26,18,1515,1539,2622,1083
2019,12,26,19,1490,1519,2673,1154
2019,12,26,20,1475,1498,2725,1227
2019,12,26,21,1455,1471,2731,1260
2019,12,26,22,1455,1481,2818,1337
2019,12,26,23,1460,1473,2801,1328
2019,12,27,0,1505,1540,2817,1277
2019,12,27,1,1575,1622,2824,1202
2019,12,27,2,1565,1640,2887,1247
2019,12,27,3,1550,1612,2850,1238
2019,12,27,4,1530,1598,2924,1326
2019,12,27,5,1480,1559,2917,1358
2019,12,27,6,1385,1497,2899,1402
2019,12,27,7,1310,1432,2924,1492
2019,12,27,8,1335,1414,2941,1527
2019,12,27,9,1320,1396,2940,1544
2019,12,27,10,1315,1397,2938,1541
2019,12,27,11,1315,1384,2922,1538
2019,12,27,12,1345,1411,2930,1519
2019,12,27,13,1400,1433,2919,1486
2019,12,27,14,1480,1523,2925,1402
2019,12,27,15,1555,1580,2886,1306
2019,12,27,16,1560,1629,2875,1246
2019,12,27,17,1555,1625,2887,1262
2019,12,27,18,1545,1626,2895,1269
2019,12,27,19,1540,1588,2882,1294
2019,12,27,20,1505,1563,2882,1319
2019,12,27,21,1495,1545,2889,1344
2019,12,27,22,1490,1192,2743,1551
2019,12,27,23,1490,1549,2887,1338
2019,12,28,0,1550,1599,2905,1306
2019,12,28,1,1590,1649,2899,1250
2019,12,28,2,1580,1634,2795,1161
2019,12,28,3,1565,1600,2745,1145
2019,12,28,4,1545,1575,2753,1178
2019,12,28,5,1495,1529,2696,1167
2019,12,28,6,1440,1473,2656,1183
2019,12,28,7,1385,1414,2639,1225
2019,12,28,8,1305,1388,2657,1269
2019,12,28,9,1280,1355,2574,1219
2019,12,28,10,1265,1350,2575,1225
2019,12,28,11,1270,1337,2577,1240
2019,12,28,12,1285,1334,2565,1231
2019,12,28,13,1305,1353,2576,1223
2019,12,28,14,1360,1392,2598,1206
2019,12,28,15,1425,1450,2587,1137
2019,12,28,16,1470,1491,2543,1052
2019,12,28,17,1500,1516,2561,1045
2019,12,28,18,1515,1543,2591,1048
2019,12,28,19,1500,1529,2600,1071
2019,12,28,20,1470,1490,2605,1115
2019,12,28,21,1460,1478,2612,1134
2019,12,28,22,1445,1472,2612,1140
2019,12,28,23,1455,1460,2596,1136
2019,12,29,0,1500,1512,2581,1069
2019,12,29,1,1560,1601,2614,1013
2019,12,29,2,1550,1603,2626,1023
2019,12,29,3,1535,1560,2551,991
2019,12,29,4,1505,1538,2481,943
2019,12,29,5,1425,1508,2481,973
2019,12,29,6,1405,1451,2478,1027
2019,12,29,7,1345,1394,2516,1122
2019,12,29,8,1300,1355,2512,1157
2019,12,29,9,1275,1347,2504,1157
2019,12,29,10,1275,1344,2520,1176
2019,12,29,11,1270,1337,2539,1202
2019,12,29,12,1270,1345,2563,1218
2019,12,29,13,1300,1357,2588,1231
2019,12,29,14,1330,1397,2566,1169
2019,12,29,15,1360,1440,2548,1108
2019,12,29,16,1415,1484,2522,1038
2019,12,29,17,1430,1520,2531,1011
2019,12,29,18,1440,1528,2515,987
2019,12,29,19,1425,1514,2531,1017
2019,12,29,20,1410,1511,2542,1031
2019,12,29,21,1395,1495,2478,983
2019,12,29,22,1385,1482,2482,1000
2019,12,29,23,1405,1499,2486,987
2019,12,30,0,1465,1545,2555,1010
2019,12,30,1,1545,1642,2618,976
2019,12,30,2,1550,1633,2640,1007
2019,12,30,3,1530,1603,2629,1026
2019,12,30,4,1510,1569,2613,1044
2019,12,30,5,1460,1517,2602,1085
2019,12,30,6,1395,1451,2535,1084
2019,12,30,7,1325,1391,2544,1153
2019,12,30,8,1300,1357,2564,1207
2019,12,30,9,1290,1343,2572,1229
2019,12,30,10,1290,1328,2579,1251
2019,12,30,11,1285,1337,2620,1283
2019,12,30,12,1310,1355,2654,1299
2019,12,30,13,1365,1404,2691,1287
2019,12,30,14,1475,1481,2695,1214
2019,12,30,15,1565,1569,2696,1127
2019,12,30,16,1570,1597,2741,1144
2019,12,30,17,1575,1606,2708,1102
2019,12,30,18,1555,1599,2681,1082
2019,12,30,19,1535,1581,2689,1108
2019,12,30,20,1515,1554,2709,1155
2019,12,30,21,1490,1528,2707,1179
2019,12,30,22,1480,1526,2700,1174
2019,12,30,23,1490,1527,2694,1167
2019,12,31,0,1540,1579,2726,1147
2019,12,31,1,1635,1663,2755,1092
2019,12,31,2,1635,1663,2777,1114
2019,12,31,3,1615,1637,2784,1147
2019,12,31,4,1595,1606,2790,1184
2019,12,31,5,1565,1549,2787,1238
2019,12,31,6,1455,1494,2878,1384
2019,12,31,7,1380,1435,2821,1386
2019,12,31,8,1235,1391,2816,1425
2019,12,31,9,1205,1387,2879,1492
2019,12,31,10,1200,1374,2863,1489
2019,12,31,11,1200,1367,2841,1474
2019,12,31,12,1205,1367,2774,1407
2019,12,31,13,1245,1399,2758,1359
2019,12,31,14,1355,1485,2765,1280
2019,12,31,15,1460,1544,2762,1218
2019,12,31,16,1470,1583,2769,1186
2019,12,31,17,1480,1578,2733,1155
2019,12,31,18,1460,1596,2745,1149
2019,12,31,19,1450,1589,2721,1132
2019,12,31,20,1445,1564,2704,1140
2019,12,31,21,1420,1561,2738,1177
2019,12,31,22,1405,1547,2782,1235
2019,12,31,23,1420,1558,2801,1243
2020,1,1,0,1470,1591,2807,1216
2020,1,1,1,1525,1636,2806,1170
2020,1,1,2,1505,1616,2816,1200
2020,1,1,3,1475,1568,2778,1210
2020,1,1,4,1460,1534,2761,1227
2020,1,1,5,1400,1489,2762,1273
2020,1,1,6,1360,1432,2770,1338
2020,1,1,7,1305,1389,2733,1344
2020,1,1,8,1220,1347,2718,1371
2020,1,1,9,1195,1294,2564,1270
2020,1,1,10,1190,1272,2422,1150
2020,1,1,11,1185,1272,2394,1122
2020,1,1,12,1200,1274,2472,1198
2020,1,1,13,1235,1283,2504,1221
2020,1,1,14,1295,1297,2379,1082
2020,1,1,15,1330,1335,2402,1067
2020,1,1,16,1395,1384,2514,1130
2020,1,1,17,1405,1419,2532,1113
2020,1,1,18,1410,1434,2525,1091
2020,1,1,19,1385,1444,2577,1133
2020,1,1,20,1315,1434,2562,1128
2020,1,1,21,1350,1418,2548,1130
2020,1,1,22,1355,1418,2562,1144
2020,1,1,23,1340,1428,2553,1125
2020,1,2,0,1390,1457,2573,1116
2020,1,2,1,1440,1528,2576,1048
2020,1,2,2,1425,1510,2560,1050
2020,1,2,3,1415,1485,2550,1065
2020,1,2,4,1400,1453,2569,1116
2020,1,2,5,1380,1416,2553,1137
2020,1,2,6,1370,1329,2536,1207
2020,1,2,7,1300,1300,2498,1198
2020,1,2,8,1265,1259,2495,1236
2020,1,2,9,1255,1246,2516,1270
2020,1,2,10,1250,1246,2456,1210
2020,1,2,11,1255,1268,2505,1237
2020,1,2,12,1275,1251,2354,1103
2020,1,2,13,1320,1305,2477,1172
2020,1,2,14,1380,1413,2586,1173
2020,1,2,15,1435,1510,2566,1056
2020,1,2,16,1465,1545,2613,1068
2020,1,2,17,1475,1550,2572,1022
2020,1,2,18,1470,1545,2544,999
2020,1,2,19,1450,1538,2555,1017
2020,1,2,20,1430,1531,2606,1075
2020,1,2,21,1400,1526,2577,1051
2020,1,2,22,1410,1519,2553,1034
2020,1,2,23,1405,1496,2515,1019
2020,1,3,0,1460,1532,2500,968
2020,1,3,1,1540,1604,2496,892
2020,1,3,2,1550,1596,2483,887
2020,1,3,3,1525,1571,2436,865
2020,1,3,4,1510,1528,2403,875
2020,1,3,5,1435,1470,2365,895
2020,1,3,6,1400,1402,2357,955
2020,1,3,7,1335,1338,2393,1055
2020,1,3,8,1295,1309,2430,1121
2020,1,3,9,1285,1291,2502,1211
2020,1,3,10,1285,1281,2498,1217
2020,1,3,11,1265,1278,2479,1201
2020,1,3,12,1285,1284,2459,1175
2020,1,3,13,1310,1329,2420,1091
2020,1,3,14,1385,1418,2482,1064
2020,1,3,15,1435,1519,2539,1020
2020,1,3,16,1470,1545,2537,992
2020,1,3,17,1475,1551,2566,1015
2020,1,3,18,1475,1556,2567,1011
2020,1,3,19,1450,1543,2571,1028
2020,1,3,20,1435,1527,2474,947
2020,1,3,21,1415,1504,2409,905
2020,1,3,22,1195,1480,2410,930
2020,1,3,23,1415,1491,2419,928
2020,1,4,0,1460,1533,2487,954
2020,1,4,1,1515,1579,2487,908
2020,1,4,2,1500,1572,2433,861
2020,1,4,3,1475,1544,2373,829
2020,1,4,4,1450,1514,2398,884
2020,1,4,5,1435,1459,2357,898
2020,1,4,6,1345,1386,2276,890
2020,1,4,7,1290,1317,2240,923
2020,1,4,8,1240,1287,2179,892
2020,1,4,9,1210,1264,2191,927
2020,1,4,10,1210,1255,2166,911
2020,1,4,11,1200,1246,2126,880
2020,1,4,12,1200,1252,2130,878
2020,1,4,13,1225,1290,2156,866
2020,1,4,14,1285,1333,2166,833
2020,1,4,15,1360,1399,2162,763
2020,1,4,16,1395,1437,2167,730
2020,1,4,17,1420,1477,2198,721
2020,1,4,18,1440,1490,2193,703
2020,1,4,19,1425,1494,2327,833
2020,1,4,20,1395,1478,2280,802
2020,1,4,21,1385,1454,2267,813
2020,1,4,22,1385,1443,2266,823
2020,1,4,23,1375,1447,2264,817
2020,1,5,0,1420,1495,2328,833
2020,1,5,1,1495,1567,2366,799
2020,1,5,2,1495,1585,2334,749
2020,1,5,3,1465,1564,2320,756
2020,1,5,4,1440,1531,2312,781
2020,1,5,5,1360,1496,2367,871
2020,1,5,6,1350,1430,2340,910
2020,1,5,7,1285,1370,2355,985
2020,1,5,8,1225,1333,2327,994
2020,1,5,9,1210,1307,2242,935
2020,1,5,10,1210,1290,2242,952
2020,1,5,11,1205,1293,2232,939
2020,1,5,12,1210,1280,2217,937
2020,1,5,13,1225,1304,2168,864
2020,1,5,14,1295,1340,2223,883
2020,1,5,15,1360,1408,2232,824
2020,1,5,16,1405,1457,2244,787
2020,1,5,17,1425,1506,2243,737
2020,1,5,18,1430,1502,2184,682
2020,1,5,19,1420,1501,2224,723
2020,1,5,20,1415,1496,2295,799
2020,1,5,21,1405,1474,2303,829
2020,1,5,22,1390,1457,2281,824
2020,1,5,23,1405,1473,2187,714
2020,1,6,0,1440,1521,2174,653
2020,1,6,1,1530,1597,2143,546
2020,1,6,2,1525,1604,2130,526
2020,1,6,3,1495,1584,2158,574
2020,1,6,4,1470,1545,2211,666
2020,1,6,5,1390,1482,2201,719
2020,1,6,6,1355,1396,2193,797
2020,1,6,7,1295,1326,2164,838
2020,1,6,8,1270,1310,2148,838
2020,1,6,9,1260,1289,2060,771
2020,1,6,10,1250,1281,2008,727
2020,1,6,11,1260,1295,2066,771
2020,1,6,12,1270,1312,2173,861
2020,1,6,13,1320,1362,2171,809
2020,1,6,14,1415,1471,2196,725
2020,1,6,15,1510,1568,2261,693
2020,1,6,16,1545,1564,2225,661
2020,1,6,17,1550,1538,2191,653
2020,1,6,18,1540,1544,2175,631
2020,1,6,19,1525,1546,2159,613
2020,1,6,20,1505,1545,2125,580
2020,1,6,21,1485,1532,2170,638
2020,1,6,22,1480,1513,2170,657
2020,1,6,23,1475,1530,2201,671
2020,1,7,0,1525,1560,2216,656
2020,1,7,1,1600,1629,2308,679
2020,1,7,2,1600,1616,2314,698
2020,1,7,3,1570,1593,2337,744
2020,1,7,4,1540,1549,2317,768
2020,1,7,5,1510,1470,2201,731
2020,1,7,6,1420,1392,2192,800
2020,1,7,7,1360,1308,2187,879
2020,1,7,8,1260,1290,2174,884
2020,1,7,9,1245,1265,2160,895
2020,1,7,10,1240,1252,2168,916
2020,1,7,11,1255,1250,2167,917
2020,1,7,12,1245,1272,2185,913
2020,1,7,13,1280,1325,2189,864
2020,1,7,14,1350,1442,2207,765
2020,1,7,15,1430,1529,2129,600
2020,1,7,16,1470,1519,2191,672
2020,1,7,17,1490,1524,2251,727
2020,1,7,18,1490,1540,2241,701
2020,1,7,19,1490,1517,2149,632
2020,1,7,20,1475,1511,2134,623
2020,1,7,21,1465,1486,2159,673
2020,1,7,22,1455,1483,2230,747
2020,1,7,23,1445,1490,2233,743
2020,1,8,0,1480,1527,2196,669
2020,1,8,1,1550,1589,2215,626
2020,1,8,2,1540,1586,2227,641
2020,1,8,3,1510,1555,2201,646
2020,1,8,4,1480,1509,2218,709
2020,1,8,5,1430,1463,2163,700
2020,1,8,6,1360,1365,2142,777
2020,1,8,7,1295,1305,2155,850
2020,1,8,8,1295,1266,2123,857
2020,1,8,9,1270,1261,2078,817
2020,1,8,10,1260,1256,2094,838
2020,1,8,11,1270,1266,2135,869
2020,1,8,12,1280,1270,2123,853
2020,1,8,13,1325,1341,2232,891
2020,1,8,14,1420,1446,2278,832
2020,1,8,15,1500,1537,2340,803
2020,1,8,16,1525,1555,2352,797
2020,1,8,17,1515,1540,2354,814
2020,1,8,18,1525,1521,2328,807
2020,1,8,19,1525,1508,2316,808
2020,1,8,20,1500,1489,2294,805
2020,1,8,21,1500,1487,2297,810
2020,1,8,22,1490,1483,2275,792
2020,1,8,23,1500,1485,2224,739
2020,1,9,0,1535,1513,2317,804
2020,1,9,1,1600,1585,2352,767
2020,1,9,2,1580,1586,2335,749
2020,1,9,3,1560,1574,2310,736
2020,1,9,4,1525,1544,2340,796
2020,1,9,5,1500,1481,2305,824
2020,1,9,6,1380,1396,2333,937
2020,1,9,7,1305,1334,2305,971
2020,1,9,8,1325,1296,2330,1034
2020,1,9,9,1310,1276,2154,878
2020,1,9,10,1300,1275,2150,875
2020,1,9,11,1305,1266,2170,904
2020,1,9,12,1315,1285,2148,863
2020,1,9,13,1370,1358,2148,790
2020,1,9,14,1475,1482,2187,705
2020,1,9,15,1560,1564,2159,595
2020,1,9,16,1570,1585,2156,571
2020,1,9,17,1580,1588,2188,600
2020,1,9,18,1585,1580,2207,627
2020,1,9,19,1570,1577,2227,650
2020,1,9,20,1560,1554,2217,663
2020,1,9,21,1535,1562,2232,670
2020,1,9,22,1535,1549,2246,697
2020,1,9,23,1535,1586,2258,672
2020,1,10,0,1575,1606,2262,656
2020,1,10,1,1650,1671,2278,607
2020,1,10,2,1650,1693,2283,590
2020,1,10,3,1615,1664,2238,574
2020,1,10,4,1575,1628,2199,571
2020,1,10,5,1480,1576,2146,570
2020,1,10,6,1435,1512,2154,642
2020,1,10,7,1370,1446,2199,753
2020,1,10,8,1305,1394,2203,809
2020,1,10,9,1290,1393,2140,747
2020,1,10,10,1285,1384,2114,730
2020,1,10,11,1280,1400,2107,707
2020,1,10,12,1295,1435,2123,688
2020,1,10,13,1340,1476,2153,677
2020,1,10,14,1445,1584,2208,624
2020,1,10,15,1555,1689,2205,516
2020,1,10,16,1585,1704,2206,502
2020,1,10,17,1585,1681,2164,483
2020,1,10,18,1580,1657,2195,538
2020,1,10,19,1565,1626,2178,552
2020,1,10,20,1550,1598,2191,593
2020,1,10,21,1530,1566,2179,613
2020,1,10,22,1460,1554,2069,515
2020,1,10,23,1520,1575,2124,549
2020,1,11,0,1560,1612,2166,554
2020,1,11,1,1615,1661,2258,597
2020,1,11,2,1610,1664,2228,564
2020,1,11,3,1580,1627,2214,587
2020,1,11,4,1555,1594,2158,564
2020,1,11,5,1500,1555,2118,563
2020,1,11,6,1420,1492,2142,650
2020,1,11,7,1350,1421,2183,762
2020,1,11,8,1310,1379,2205,826
2020,1,11,9,1285,1353,2198,845
2020,1,11,10,1275,1341,2170,829
2020,1,11,11,1275,1337,2178,841
2020,1,11,12,1270,1333,2191,858
2020,1,11,13,1305,1367,2205,838
2020,1,11,14,1350,1405,2226,821
2020,1,11,15,1415,1473,2240,767
2020,1,11,16,1450,1509,2255,746
2020,1,11,17,1490,1552,2290,738
2020,1,11,18,1485,1557,2306,749
2020,1,11,19,1485,1557,2315,758
2020,1,11,20,1470,1529,2285,756
2020,1,11,21,1455,1517,2307,790
2020,1,11,22,1445,1506,2273,767
2020,1,11,23,1460,1508,2231,723
2020,1,12,0,1500,1531,2263,732
2020,1,12,1,1575,1603,2279,676
2020,1,12,2,1585,1607,2278,671
2020,1,12,3,1560,1571,2288,717
2020,1,12,4,1525,1532,2260,728
2020,1,12,5,1460,1482,2231,749
2020,1,12,6,1390,1441,2251,810
2020,1,12,7,1325,1386,2256,870
2020,1,12,8,1340,1328,2147,819
2020,1,12,9,1320,1315,2157,842
2020,1,12,10,1305,1289,2146,857
2020,1,12,11,1310,1299,2092,793
2020,1,12,12,1305,1308,2088,780
2020,1,12,13,1335,1332,2119,787
2020,1,12,14,1375,1389,2140,751
2020,1,12,15,1430,1462,2213,751
2020,1,12,16,1470,1513,2207,694
2020,1,12,17,1505,1537,2156,619
2020,1,12,18,1500,1555,2145,590
2020,1,12,19,1500,1551,2109,558
2020,1,12,20,1490,1568,2129,561
2020,1,12,21,1480,1563,2119,556
2020,1,12,22,1460,1546,2137,591
2020,1,12,23,1485,1566,2110,544
2020,1,13,0,1525,1609,2086,477
2020,1,13,1,1600,1685,2087,402
2020,1,13,2,1610,1697,2063,366
2020,1,13,3,1585,1678,2065,387
2020,1,13,4,1550,1650,2059,409
2020,1,13,5,1470,1591,2054,463
2020,1,13,6,1410,1520,2063,543
2020,1,13,7,1345,1458,2056,598
2020,1,13,8,1405,1424,2041,617
2020,1,13,9,1390,1418,1995,577
2020,1,13,10,1380,1428,2004,576
2020,1,13,11,1385,1439,2012,573
2020,1,13,12,1400,1453,2059,606
2020,1,13,13,1460,1510,2098,588
2020,1,13,14,1535,1768,2300,532
2020,1,13,15,1605,1757,2224,467
2020,1,13,16,1635,1746,2204,458
2020,1,13,17,1635,1744,2187,443
2020,1,13,18,1630,1734,2171,437
2020,1,13,19,1615,1709,2160,451
2020,1,13,20,1590,1675,2150,475
2020,1,13,21,1575,1656,2154,498
2020,1,13,22,1565,1638,2161,523
2020,1,13,23,1580,1650,2150,500
2020,1,14,0,1625,1684,2138,454
2020,1,14,1,1705,1755,2153,398
2020,1,14,2,1710,1767,2163,396
2020,1,14,3,1685,1742,2167,425
2020,1,14,4,1650,1714,2164,450
2020,1,14,5,1605,1645,2134,489
2020,1,14,6,1520,1562,2099,537
2020,1,14,7,1455,1499,2103,604
2020,1,14,8,1490,1464,2095,631
2020,1,14,9,1470,1466,2103,637
2020,1,14,10,1455,1460,2124,664
2020,1,14,11,1450,1465,2111,646
2020,1,14,12,1465,1484,2109,625
2020,1,14,13,1525,1539,2100,561
2020,1,14,14,1635,1644,1653,9
2020,1,14,15,1715,1718,1224,-494
2020,1,14,16,1720,1729,1211,-518
2020,1,14,17,1725,1734,1208,-526
2020,1,14,18,1735,1721,1212,-509
2020,1,14,19,1720,1711,1267,-444
2020,1,14,20,1705,1711,1848,137
2020,1,14,21,1685,1716,1941,225
2020,1,14,22,1680,1685,1890,205
2020,1,14,23,1690,1699,1842,143
2020,1,15,0,1730,1729,1899,170
2020,1,15,1,1775,1802,1956,154
2020,1,15,2,1770,1821,2088,267
2020,1,15,3,1720,1791,2115,324
2020,1,15,4,1705,1764,2084,320
2020,1,15,5,1640,1703,2081,378
2020,1,15,6,1555,1628,2082,454
2020,1,15,7,1490,1562,2096,534
2020,1,15,8,1450,1518,2091,573
2020,1,15,9,1435,1487,2098,611
2020,1,15,10,1430,1496,2117,621
2020,1,15,11,1440,1500,2139,639
2020,1,15,12,1440,1504,2145,641
2020,1,15,13,1505,1559,2173,614
2020,1,15,14,1610,1683,2283,600
2020,1,15,15,1645,1780,2276,496
2020,1,15,16,1665,1798,2304,506
2020,1,15,17,1660,1767,2235,468
2020,1,15,18,1650,1732,2249,517
2020,1,15,19,1640,1688,2183,495
2020,1,15,20,1620,1659,2173,514
2020,1,15,21,1610,1633,2156,523
2020,1,15,22,1605,1614,2168,554
2020,1,15,23,1615,1617,2171,554
2020,1,16,0,1645,1667,2201,534
2020,1,16,1,1725,1761,2224,463
2020,1,16,2,1725,1768,2247,479
2020,1,16,3,1705,1753,2263,510
2020,1,16,4,1675,1720,2206,486
2020,1,16,5,1645,1657,2195,538
2020,1,16,6,1510,1561,2140,579
2020,1,16,7,1445,1489,2168,679
2020,1,16,8,1285,1470,2146,676
2020,1,16,9,1270,1453,2165,712
2020,1,16,10,1270,1441,2173,732
2020,1,16,11,1270,1447,2158,711
2020,1,16,12,1280,1467,2163,696
2020,1,16,13,1345,1518,2177,659
2020,1,16,14,1460,1630,2220,590
2020,1,16,15,1535,1721,2208,487
2020,1,16,16,1560,1719,2218,499
2020,1,16,17,1560,1709,2217,508
2020,1,16,18,1550,1691,2219,528
2020,1,16,19,1550,1667,2200,533
2020,1,16,20,1535,1628,2169,541
2020,1,16,21,1540,1590,2136,546
2020,1,16,22,1525,1592,2133,541
2020,1,16,23,1545,1593,2132,539
2020,1,17,0,1570,1620,2158,538
2020,1,17,1,1635,1678,2189,511
2020,1,17,2,1650,1690,2195,505
2020,1,17,3,1620,1667,2188,521
2020,1,17,4,1590,1644,2220,576
2020,1,17,5,1535,1587,2207,620
2020,1,17,6,1465,1492,2118,626
2020,1,17,7,1400,1446,2184,738
2020,1,17,8,1370,1397,2163,766
2020,1,17,9,1355,1383,2197,814
2020,1,17,10,1350,1381,2204,823
2020,1,17,11,1360,1380,2165,785
2020,1,17,12,1385,1390,2150,760
2020,1,17,13,1430,1443,2232,789
2020,1,17,14,1550,1561,2294,733
2020,1,17,15,1665,1650,2324,674
2020,1,17,16,1680,1663,2352,689
2020,1,17,17,1660,1658,2394,736
2020,1,17,18,1640,1663,2416,753
2020,1,17,19,1610,1638,2424,786
2020,1,17,20,1585,1622,2371,749
2020,1,17,21,1555,1598,2344,746
2020,1,17,22,1535,1573,2344,771
2020,1,17,23,1555,1576,2330,754
2020,1,18,0,1595,1606,2412,806
2020,1,18,1,1655,1671,2440,769
2020,1,18,2,1655,1686,2357,671
2020,1,18,3,1625,1650,2386,736
2020,1,18,4,1590,1638,2392,754
2020,1,18,5,1560,1586,2389,803
2020,1,18,6,1470,1533,2282,749
2020,1,18,7,1400,1467,2256,789
2020,1,18,8,1380,1438,2242,804
2020,1,18,9,1355,1407,2269,862
2020,1,18,10,1345,1400,2270,870
2020,1,18,11,1340,1395,2205,810
2020,1,18,12,1340,1396,2258,862
2020,1,18,13,1380,1427,2327,900
2020,1,18,14,1435,1475,2359,884
2020,1,18,15,1510,1541,2304,763
2020,1,18,16,1540,1582,2267,685
2020,1,18,17,1570,1622,2309,687
2020,1,18,18,1570,1601,2325,724
2020,1,18,19,1565,1586,2279,693
2020,1,18,20,1540,1551,2255,704
2020,1,18,21,1520,1528,2283,755
2020,1,18,22,1510,1500,2255,755
2020,1,18,23,1515,1519,2228,709
2020,1,19,0,1540,1535,2226,691
2020,1,19,1,1615,1625,2280,655
2020,1,19,2,1620,1624,2285,661
2020,1,19,3,1585,1598,2299,701
2020,1,19,4,1550,1566,2301,735
2020,1,19,5,1510,1522,2278,756
2020,1,19,6,1450,1458,2230,772
2020,1,19,7,1390,1415,2259,844
2020,1,19,8,1345,1362,2233,871
2020,1,19,9,1330,1360,2210,850
2020,1,19,10,1310,1341,2196,855
2020,1,19,11,1320,1335,2201,866
2020,1,19,12,1325,1349,2200,851
2020,1,19,13,1350,1358,2187,829
2020,1,19,14,1375,1407,2202,795
2020,1,19,15,1415,1457,2212,755
2020,1,19,16,1450,1500,2275,775
2020,1,19,17,1470,1503,2322,819
2020,1,19,18,1480,1489,2312,823
2020,1,19,19,1470,1469,2284,815
2020,1,19,20,1475,1448,2279,831
2020,1,19,21,1460,1421,2272,851
2020,1,19,22,1450,1406,2263,857
2020,1,19,23,1465,1396,2253,857
2020,1,20,0,1505,1444,2295,851
2020,1,20,1,1575,1543,2380,837
2020,1,20,2,1580,1571,2363,792
2020,1,20,3,1555,1566,2362,796
2020,1,20,4,1525,1536,2367,831
2020,1,20,5,1415,1477,2349,872
2020,1,20,6,1395,1409,2297,888
2020,1,20,7,1330,1353,2182,829
2020,1,20,8,1300,1321,2194,873
2020,1,20,9,1285,1310,2226,916
2020,1,20,10,1285,1303,2212,909
2020,1,20,11,1295,1314,2201,887
2020,1,20,12,1310,1337,2278,941
2020,1,20,13,1360,1380,2321,941
2020,1,20,14,1545,1479,2347,868
2020,1,20,15,1555,1572,2256,684
2020,1,20,16,1555,1580,2238,658
2020,1,20,17,1545,1572,2206,634
2020,1,20,18,1545,1555,2208,653
2020,1,20,19,1530,1540,2218,678
2020,1,20,20,1505,1518,2205,687
2020,1,20,21,1485,1498,2205,707
2020,1,20,22,1475,1492,2198,706
2020,1,20,23,1485,1486,2191,705
2020,1,21,0,1520,1506,2185,679
2020,1,21,1,1585,1590,2184,594
2020,1,21,2,1590,1604,2251,647
2020,1,21,3,1570,1571,2243,672
2020,1,21,4,1540,1541,2250,709
2020,1,21,5,1480,1472,2199,727
2020,1,21,6,1395,1383,2221,838
2020,1,21,7,1330,1316,2266,950
2020,1,21,8,1280,1269,2283,1014
2020,1,21,9,1260,1258,2148,890
2020,1,21,10,1245,1266,2178,912
2020,1,21,11,1245,1256,2184,928
2020,1,21,12,1260,1272,2270,998
2020,1,21,13,1320,1329,2290,961
2020,1,21,14,1420,1452,2333,881
2020,1,21,15,1505,1545,2344,799
2020,1,21,16,1495,1549,2292,743
2020,1,21,17,1505,1536,2314,778
2020,1,21,18,1515,1512,2267,755
2020,1,21,19,1495,1468,2247,779
2020,1,21,20,1485,1438,2190,752
2020,1,21,21,1460,1440,2194,754
2020,1,21,22,1460,1441,2177,736
2020,1,21,23,1465,1435,2150,715
2020,1,22,0,1500,1469,2156,687
2020,1,22,1,1570,1541,2217,676
2020,1,22,2,1565,1564,2217,653
2020,1,22,3,1535,1540,2190,650
2020,1,22,4,1490,1517,2176,659
2020,1,22,5,1440,1448,2167,719
2020,1,22,6,1340,1369,2101,732
2020,1,22,7,1280,1312,2185,873
2020,1,22,8,1270,1278,2199,921
2020,1,22,9,1250,1265,2181,916
2020,1,22,10,1250,1264,2201,937
2020,1,22,11,1260,1266,2221,955
2020,1,22,12,1275,1285,2226,941
2020,1,22,13,1325,1340,2259,919
2020,1,22,14,1445,1453,2386,933
2020,1,22,15,1545,1553,2387,834
2020,1,22,16,1560,1547,2439,892
2020,1,22,17,1540,1517,2369,852
2020,1,22,18,1515,1509,2374,865
2020,1,22,19,1495,1494,2382,888
2020,1,22,20,1470,1467,2336,869
2020,1,22,21,1460,1455,2309,854
2020,1,22,22,1450,1449,2298,849
2020,1,22,23,1450,1457,2319,862
2020,1,23,0,1470,1464,2323,859
2020,1,23,1,1555,1545,2372,827
2020,1,23,2,1565,1568,2407,839
2020,1,23,3,1540,1553,2383,830
2020,1,23,4,1515,1513,2348,835
2020,1,23,5,1450,1469,2333,864
2020,1,23,6,1365,1370,2290,920
2020,1,23,7,1295,1312,2313,1001
2020,1,23,8,1260,1275,2259,984
2020,1,23,9,1250,1267,2187,920
2020,1,23,10,1240,1248,2151,903
2020,1,23,11,1245,1257,2115,858
2020,1,23,12,1260,1280,2170,890
2020,1,23,13,1310,1338,2204,866
2020,1,23,14,1450,1454,2302,848
2020,1,23,15,1565,1546,2226,680
2020,1,23,16,1565,1530,2235,705
2020,1,23,17,1555,1527,2206,679
2020,1,23,18,1540,1501,2213,712
2020,1,23,19,1515,1480,2195,715
2020,1,23,20,1485,1459,2203,744
2020,1,23,21,1460,1453,2177,724
2020,1,23,22,1460,1457,2210,753
2020,1,23,23,1465,1446,2182,736
2020,1,24,0,1490,1479,2221,742
2020,1,24,1,1550,1517,2262,745
2020,1,24,2,1565,1537,2259,722
2020,1,24,3,1545,1524,2260,736
2020,1,24,4,1520,1508,2230,722
2020,1,24,5,1480,1428,2222,794
2020,1,24,6,1380,1355,2234,879
2020,1,24,7,1330,1299,2209,910
2020,1,24,8,1235,1255,2160,905
2020,1,24,9,1225,1230,2049,819
2020,1,24,10,1225,1235,2136,901
2020,1,24,11,1230,1232,2075,843
2020,1,24,12,1245,1263,2067,804
2020,1,24,13,1295,1308,2066,758
2020,1,24,14,1415,1418,2167,749
2020,1,24,15,1520,1506,2158,652
2020,1,24,16,1525,1525,2156,631
2020,1,24,17,1505,1521,2113,592
2020,1,24,18,1495,1499,2136,637
2020,1,24,19,1475,1480,2089,609
2020,1,24,20,1450,1447,2122,675
2020,1,24,21,1435,1460,2179,719
2020,1,24,22,1420,1434,2141,707
2020,1,24,23,1425,1419,2138,719
2020,1,25,0,1445,1439,2112,673
2020,1,25,1,1525,1493,2128,635
2020,1,25,2,1530,1494,2102,608
2020,1,25,3,1505,1486,2091,605
2020,1,25,4,1475,1454,2124,670
2020,1,25,5,1420,1418,2119,701
2020,1,25,6,1360,1366,2104,738
2020,1,25,7,1300,1309,2151,842
2020,1,25,8,1235,1273,2183,910
2020,1,25,9,1210,1259,2122,863
2020,1,25,10,1205,1251,2277,1026
2020,1,25,11,1200,1268,2250,982
2020,1,25,12,1205,1259,2233,974
2020,1,25,13,1240,1284,2235,951
2020,1,25,14,1320,1340,2288,948
2020,1,25,15,1415,1383,2237,854
2020,1,25,16,1440,1421,2227,806
2020,1,25,17,1470,1436,2200,764
2020,1,25,18,1455,1434,2198,764
2020,1,25,19,1440,1430,2186,756
2020,1,25,20,1415,1406,2204,798
2020,1,25,21,1395,1390,2184,794
2020,1,25,22,1380,1388,2147,759
2020,1,25,23,1385,1389,2150,761
2020,1,26,0,1405,1400,2196,796
2020,1,26,1,1480,1458,2227,769
2020,1,26,2,1480,1472,2216,744
2020,1,26,3,1455,1444,2204,760
2020,1,26,4,1430,1411,2180,769
2020,1,26,5,1415,1365,2105,740
2020,1,26,6,1325,1315,2110,795
2020,1,26,7,1275,1272,2162,890
2020,1,26,8,1220,1239,2143,904
2020,1,26,9,1215,1231,2083,852
2020,1,26,10,1195,1229,2080,851
2020,1,26,11,1195,1233,2017,784
2020,1,26,12,1210,1267,1968,701
2020,1,26,13,1230,1298,2066,768
2020,1,26,14,1305,1341,2118,777
2020,1,26,15,1380,1421,2174,753
2020,1,26,16,1410,1449,2213,764
2020,1,26,17,1410,1487,2186,699
2020,1,26,18,1400,1481,2165,684
2020,1,26,19,1385,1480,2176,696
2020,1,26,20,1370,1466,2167,701
2020,1,26,21,1350,1462,2165,703
2020,1,26,22,1340,1442,2131,689
2020,1,26,23,1335,1460,2047,587
2020,1,27,0,1380,1488,2134,646
2020,1,27,1,1455,1565,2169,604
2020,1,27,2,1475,1583,2171,588
2020,1,27,3,1465,1562,2167,605
2020,1,27,4,1445,1541,2174,633
2020,1,27,5,1380,1466,2172,706
2020,1,27,6,1315,1397,2141,744
2020,1,27,7,1265,1341,2124,783
2020,1,27,8,1220,1296,2133,837
2020,1,27,9,1210,1289,2143,854
2020,1,27,10,1200,1266,2123,857
2020,1,27,11,1210,1261,2097,836
2020,1,27,12,1230,1295,2035,740
2020,1,27,13,1280,1364,2126,762
2020,1,27,14,1410,1479,2208,729
2020,1,27,15,1495,1580,2276,696
2020,1,27,16,1500,1567,2244,677
2020,1,27,17,1490,1583,2292,709
2020,1,27,18,1475,1551,2283,732
2020,1,27,19,1460,1570,2287,717
2020,1,27,20,1440,1534,2269,735
2020,1,27,21,1420,1526,2247,721
2020,1,27,22,1415,1512,2252,740
2020,1,27,23,1415,1502,2279,777
2020,1,28,0,1435,1538,2318,780
2020,1,28,1,1510,1592,2262,670
2020,1,28,2,1520,1632,2311,679
2020,1,28,3,1495,1615,2236,621
2020,1,28,4,1470,1579,2222,643
2020,1,28,5,1430,1526,2287,761
2020,1,28,6,1320,1457,2246,789
2020,1,28,7,1255,1380,2194,814
2020,1,28,8,1250,1352,2117,765
2020,1,28,9,1245,1325,2084,759
2020,1,28,10,1245,1325,1964,639
2020,1,28,11,1240,1326,2055,729
2020,1,28,12,1260,1343,2101,758
2020,1,28,13,1310,1406,2198,792
2020,1,28,14,1420,1518,2291,773
2020,1,28,15,1510,1618,2280,662
2020,1,28,16,1520,1596,2245,649
2020,1,28,17,1520,1584,2242,658
2020,1,28,18,1500,1583,2229,646
2020,1,28,19,1470,1571,2210,639
2020,1,28,20,1445,1547,2282,735
2020,1,28,21,1450,1537,2279,742
2020,1,28,22,1440,1512,2169,657
2020,1,28,23,1445,1513,2109,596
2020,1,29,0,1480,1530,2191,661
2020,1,29,1,1550,1590,2220,630
2020,1,29,2,1570,1598,2191,593
2020,1,29,3,1545,1589,2210,621
2020,1,29,4,1520,1557,2176,619
2020,1,29,5,1450,1485,2121,636
2020,1,29,6,1375,1399,2017,618
2020,1,29,7,1315,1339,2025,686
2020,1,29,8,1260,1300,2026,726
2020,1,29,9,1240,1276,1946,670
2020,1,29,10,1245,1270,1890,620
2020,1,29,11,1250,1269,1916,647
2020,1,29,12,1260,1304,2017,713
2020,1,29,13,1315,1343,1999,656
2020,1,29,14,1470,1469,2019,550
2020,1,29,15,1610,1574,2201,627
2020,1,29,16,1615,1565,2217,652
2020,1,29,17,1590,1539,2210,671
2020,1,29,18,1565,1506,2212,706
2020,1,29,19,1535,1484,2137,653
2020,1,29,20,1505,1470,2143,673
2020,1,29,21,1490,1454,2165,711
2020,1,29,22,1475,1438,2231,793
2020,1,29,23,1475,1433,2018,585
2020,1,30,0,1510,1445,1989,544
2020,1,30,1,1595,1514,1973,459
2020,1,30,2,1610,1564,2011,447
2020,1,30,3,1595,1551,1980,429
2020,1,30,4,1560,1538,2077,539
2020,1,30,5,1470,1484,2061,577
2020,1,30,6,1415,1399,2047,648
2020,1,30,7,1350,1341,2029,688
2020,1,30,8,1280,1311,1987,676
2020,1,30,9,1265,1289,2164,875
2020,1,30,10,1250,1289,2198,909
2020,1,30,11,1255,1297,2197,900
2020,1,30,12,1280,1325,2191,866
2020,1,30,13,1340,1387,2189,802
2020,1,30,14,1485,1500,2308,808
2020,1,30,15,1605,1580,2316,736
2020,1,30,16,1590,1558,2244,686
2020,1,30,17,1585,1547,2222,675
2020,1,30,18,1565,1530,2183,653
2020,1,30,19,1545,1492,2064,572
2020,1,30,20,1520,1457,2040,583
2020,1,30,21,1510,1420,1924,504
2020,1,30,22,1505,1428,1899,471
2020,1,30,23,1500,1441,2019,578
2020,1,31,0,1530,1466,2107,641
2020,1,31,1,1575,1519,2098,579
2020,1,31,2,1590,1571,2213,642
2020,1,31,3,1575,1571,2236,665
2020,1,31,4,1560,1561,2203,642
2020,1,31,5,1480,1503,2135,632
2020,1,31,6,1400,1438,2155,717
2020,1,31,7,1340,1379,2203,824
2020,1,31,8,1250,1355,2200,845
2020,1,31,9,1230,1341,2208,867
2020,1,31,10,1230,1330,2129,799
2020,1,31,11,1230,1324,2128,804
2020,1,31,12,1260,1342,2089,747
2020,1,31,13,1305,1396,2157,761
2020,1,31,14,1415,1471,2156,685
2020,1,31,15,1510,1571,2177,606
2020,1,31,16,1510,1581,2197,616
2020,1,31,17,1495,1571,2207,636
2020,1,31,18,1470,1568,2152,584
2020,1,31,19,1450,1548,2176,628
2020,1,31,20,1430,1518,2070,552
2020,1,31,21,1420,1490,1942,452
2020,1,31,22,1400,1474,1832,358
2020,1,31,23,1400,1450,1699,249
2020,2,1,0,1415,1461,1687,226
2020,2,1,1,1480,1512,1873,361
2020,2,1,2,1510,1518,1851,333
2020,2,1,3,1495,1507,1941,434
2020,2,1,4,1480,1472,1885,413
2020,2,1,5,1420,1431,1911,480
2020,2,1,6,1360,1379,1883,504
2020,2,1,7,1300,1313,1832,519
2020,2,1,8,1215,1272,1815,543
2020,2,1,9,1200,1260,1816,556
2020,2,1,10,1190,1245,1742,497
2020,2,1,11,1195,1234,1741,507
2020,2,1,12,1200,1226,1615,389
2020,2,1,13,1230,1263,1644,381
2020,2,1,14,1310,1311,1770,459
2020,2,1,15,1370,1370,1782,412
2020,2,1,16,1400,1418,1962,544
2020,2,1,17,1410,1430,1843,413
2020,2,1,18,1400,1420,1830,410
2020,2,1,19,1395,1397,1786,389
2020,2,1,20,1370,1371,1770,399
2020,2,1,21,1355,1348,1747,399
2020,2,1,22,1350,1337,1642,305
2020,2,1,23,1345,1343,1534,191
2020,2,2,0,1360,1370,1579,209
2020,2,2,1,1425,1441,1812,371
2020,2,2,2,1440,1473,1956,483
2020,2,2,3,1415,1449,1865,416
2020,2,2,4,1385,1422,1888,466
2020,2,2,5,1370,1381,1879,498
2020,2,2,6,1285,1337,1862,525
2020,2,2,7,1240,1297,1860,563
2020,2,2,8,1295,1272,1864,592
2020,2,2,9,1285,1254,1844,590
2020,2,2,10,1280,1239,1846,607
2020,2,2,11,1280,1229,1829,600
2020,2,2,12,1310,1227,1823,596
2020,2,2,13,1345,1264,1834,570
2020,2,2,14,1385,1311,1874,563
2020,2,2,15,1445,1392,1935,543
2020,2,2,16,1465,1470,2074,604
2020,2,2,17,1485,1515,2199,684
2020,2,2,18,1475,1534,2249,715
2020,2,2,19,1465,1526,2148,622
2020,2,2,20,1445,1539,2200,661
2020,2,2,21,1430,1542,2120,578
2020,2,2,22,1415,1538,2098,560
2020,2,2,23,1430,1553,2139,586
2020,2,3,0,1465,1541,2118,577
2020,2,3,1,1535,1558,2109,551
2020,2,3,2,1560,1570,2075,505
2020,2,3,3,1545,1559,2086,527
2020,2,3,4,1520,1545,2077,532
2020,2,3,5,1445,1527,2070,543
2020,2,3,6,1385,1443,1977,534
2020,2,3,7,1330,1380,1872,492
2020,2,3,8,1345,1341,1928,587
2020,2,3,9,1330,1321,1698,377
2020,2,3,10,1320,1315,1692,377
2020,2,3,11,1320,1334,1687,353
2020,2,3,12,1350,1357,1696,339
2020,2,3,13,1420,1437,1875,438
2020,2,3,14,1535,1562,1955,393
2020,2,3,15,1635,1659,2012,353
2020,2,3,16,1630,1670,2048,378
2020,2,3,17,1630,1664,2025,361
2020,2,3,18,1605,1649,2015,366
2020,2,3,19,1610,1615,1951,336
2020,2,3,20,1570,1584,1816,232
2020,2,3,21,1555,1547,1714,167
2020,2,3,22,1545,1533,1691,158
2020,2,3,23,1545,1533,1720,187
2020,2,4,0,1575,1571,1808,237
2020,2,4,1,1640,1635,1845,210
2020,2,4,2,1680,1704,1992,288
2020,2,4,3,1665,1698,2013,315
2020,2,4,4,1635,1672,2043,371
2020,2,4,5,1550,1595,2060,465
2020,2,4,6,1495,1509,1982,473
2020,2,4,7,1420,1452,2081,629
2020,2,4,8,1330,1417,2090,673
2020,2,4,9,1310,1418,2091,673
2020,2,4,10,1300,1416,2080,664
2020,2,4,11,1305,1427,2077,650
2020,2,4,12,1320,1454,2082,628
2020,2,4,13,1370,1511,2126,615
2020,2,4,14,1535,1630,2210,580
2020,2,4,15,1690,1717,2306,589
2020,2,4,16,1695,1710,2324,614
2020,2,4,17,1690,1668,2268,600
2020,2,4,18,1685,1646,2320,674
2020,2,4,19,1665,1610,2295,685
2020,2,4,20,1640,1588,2311,723
2020,2,4,21,1615,1568,2218,650
2020,2,4,22,1610,1567,2213,646
2020,2,4,23,1610,1577,2214,637
2020,2,5,0,1630,1610,2251,641
2020,2,5,1,1685,1679,2323,644
2020,2,5,2,1695,1722,2319,597
2020,2,5,3,1675,1708,2313,605
2020,2,5,4,1655,1676,2302,626
2020,2,5,5,1590,1622,2246,624
2020,2,5,6,1500,1531,2173,642
2020,2,5,7,1445,1467,2132,665
2020,2,5,8,1335,1430,2134,704
2020,2,5,9,1315,1407,2177,770
2020,2,5,10,1310,1414,2115,701
2020,2,5,11,1315,1407,2124,717
2020,2,5,12,1345,1427,2045,618
2020,2,5,13,1395,1492,2103,611
2020,2,5,14,1515,1611,2171,560
2020,2,5,15,1610,1705,2340,635
2020,2,5,16,1605,1692,2351,659
2020,2,5,17,1580,1688,2362,674
2020,2,5,18,1555,1673,2348,675
2020,2,5,19,1535,1646,2347,701
2020,2,5,20,1515,1610,2327,717
2020,2,5,21,1490,1598,2281,683
2020,2,5,22,1480,1577,2188,611
2020,2,5,23,1480,1587,2160,573
2020,2,6,0,1495,1606,2171,565
2020,2,6,1,1570,1657,2197,540
2020,2,6,2,1620,1700,2260,560
2020,2,6,3,1605,1675,2261,586
2020,2,6,4,1585,1646,2239,593
2020,2,6,5,1500,1585,2238,653
2020,2,6,6,1435,1494,2168,674
2020,2,6,7,1375,1426,2084,658
2020,2,6,8,1270,1392,1944,552
2020,2,6,9,1245,1362,1719,357
2020,2,6,10,1240,1363,1695,332
2020,2,6,11,1245,1373,1693,320
2020,2,6,12,1270,1385,1655,270
2020,2,6,13,1325,1450,1789,339
2020,2,6,14,1445,1563,1873,310
2020,2,6,15,1550,1648,1901,253
2020,2,6,16,1545,1640,1913,273
2020,2,6,17,1540,1620,1891,271
2020,2,6,18,1530,1622,1944,322
2020,2,6,19,1500,1601,1966,365
2020,2,6,20,1480,1581,1982,401
2020,2,6,21,1455,1572,1966,394
2020,2,6,22,1455,1551,1877,326
2020,2,6,23,1465,1549,1868,319
2020,2,7,0,1485,1577,1919,342
2020,2,7,1,1530,1609,1934,325
2020,2,7,2,1570,1635,1896,261
2020,2,7,3,1565,1615,1914,299
2020,2,7,4,1555,1583,1977,394
2020,2,7,5,1500,1533,1915,382
2020,2,7,6,1425,1440,1839,399
2020,2,7,7,1365,1375,1671,296
2020,2,7,8,1325,1335,1541,206
2020,2,7,9,1300,1327,1489,162
2020,2,7,10,1300,1327,1451,124
2020,2,7,11,1300,1349,1558,209
2020,2,7,12,1330,1374,1587,213
2020,2,7,13,1380,1433,1678,245
2020,2,7,14,1495,1536,1954,418
2020,2,7,15,1605,1617,1947,330
2020,2,7,16,1620,1603,1973,370
2020,2,7,17,1610,1611,1969,358
2020,2,7,18,1600,1571,1929,358
2020,2,7,19,1575,1556,1891,335
2020,2,7,20,1540,1533,1839,306
2020,2,7,21,1540,1515,1860,345
2020,2,7,22,1515,1507,1755,248
2020,2,7,23,1500,1502,1761,259
2020,2,8,0,1520,1525,1803,278
2020,2,8,1,1575,1588,1890,302
2020,2,8,2,1580,1606,1860,254
2020,2,8,3,1570,1577,1833,256
2020,2,8,4,1540,1530,1745,215
2020,2,8,5,1480,1484,1842,358
2020,2,8,6,1440,1413,1633,220
2020,2,8,7,1375,1365,1683,318
2020,2,8,8,1310,1316,1613,297
2020,2,8,9,1290,1300,1575,275
2020,2,8,10,1280,1287,1493,206
2020,2,8,11,1280,1288,1502,214
2020,2,8,12,1280,1291,1451,160
2020,2,8,13,1320,1327,1520,193
2020,2,8,14,1365,1373,1481,108
2020,2,8,15,1425,1416,1518,102
2020,2,8,16,1475,1453,1465,12
2020,2,8,17,1505,1494,1671,177
2020,2,8,18,1525,1517,1737,220
2020,2,8,19,1520,1498,1562,64
2020,2,8,20,1525,1479,1479,0
2020,2,8,21,1520,1464,1568,104
2020,2,8,22,1515,1452,1545,93
2020,2,8,23,1520,1466,1542,76
2020,2,9,0,1525,1488,1529,41
2020,2,9,1,1550,1543,1555,12
2020,2,9,2,1565,1585,1738,153
2020,2,9,3,1550,1571,1826,255
2020,2,9,4,1530,1529,1809,280
2020,2,9,5,1425,1483,1812,329
2020,2,9,6,1420,1421,1810,389
2020,2,9,7,1355,1390,1990,600
2020,2,9,8,1340,1350,1903,553
2020,2,9,9,1320,1349,2037,688
2020,2,9,10,1310,1338,2027,689
2020,2,9,11,1310,1339,1993,654
2020,2,9,12,1315,1362,1957,595
2020,2,9,13,1355,1390,2014,624
2020,2,9,14,1380,1445,2058,613
2020,2,9,15,1425,1511,2221,710
2020,2,9,16,1475,1553,2194,641
2020,2,9,17,1510,1576,2318,742
2020,2,9,18,1530,1561,2171,610
2020,2,9,19,1525,1557,2150,593
2020,2,9,20,1530,1540,2074,534
2020,2,9,21,1530,1509,2047,538
2020,2,9,22,1520,1504,2034,530
2020,2,9,23,1530,1510,1961,451
2020,2,10,0,1535,1560,2116,556
2020,2,10,1,1565,1623,2240,617
2020,2,10,2,1580,1671,2244,573
2020,2,10,3,1565,1626,2194,568
2020,2,10,4,1550,1595,2094,499
2020,2,10,5,1470,1526,2087,561
2020,2,10,6,1430,1454,2079,625
2020,2,10,7,1365,1376,1985,609
2020,2,10,8,1335,1351,1858,507
2020,2,10,9,1315,1317,1702,385
2020,2,10,10,1315,1315,1652,337
2020,2,10,11,1320,1328,1730,402
2020,2,10,12,1340,1344,1813,469
2020,2,10,13,1410,1422,2043,621
2020,2,10,14,1540,1545,2224,679
2020,2,10,15,1640,1632,2257,625
2020,2,10,16,1640,1618,2208,590
2020,2,10,17,1635,1612,2153,541
2020,2,10,18,1620,1593,2077,484
2020,2,10,19,1605,1578,2136,558
2020,2,10,20,1570,1560,2209,649
2020,2,10,21,1550,1525,2122,597
2020,2,10,22,1530,1524,2080,556
2020,2,10,23,1535,1521,1967,446
2020,2,11,0,1560,1542,2077,535
2020,2,11,1,1620,1584,2086,502
2020,2,11,2,1670,1649,2048,399
2020,2,11,3,1655,1646,2034,388
2020,2,11,4,1625,1615,2063,448
2020,2,11,5,1540,1556,2065,509
2020,2,11,6,1470,1477,1961,484
2020,2,11,7,1405,1430,2013,583
2020,2,11,8,1315,1430,2053,623
2020,2,11,9,1315,1386,2090,704
2020,2,11,10,1310,1384,2095,711
2020,2,11,11,1320,1368,1993,625
2020,2,11,12,1340,1408,2038,630
2020,2,11,13,1390,1464,2061,597
2020,2,11,14,1510,1587,2153,566
2020,2,11,15,1605,1691,2299,608
2020,2,11,16,1600,1674,2320,646
2020,2,11,17,1580,1660,2241,581
2020,2,11,18,1570,1650,2158,508
2020,2,11,19,1545,1618,2137,519
2020,2,11,20,1520,1595,2020,425
2020,2,11,21,1505,1571,1950,379
2020,2,11,22,1495,1571,1995,424
2020,2,11,23,1505,1572,2011,439
2020,2,12,0,1535,1600,2048,448
2020,2,12,1,1600,1619,2004,385
2020,2,12,2,1640,1668,2195,527
2020,2,12,3,1620,1633,2148,515
2020,2,12,4,1585,1583,2077,494
2020,2,12,5,1520,1519,2012,493
2020,2,12,6,1445,1448,1900,452
2020,2,12,7,1375,1366,1896,530
2020,2,12,8,1330,1337,1900,563
2020,2,12,9,1300,1326,1767,441
2020,2,12,10,1300,1309,1738,429
2020,2,12,11,1305,1302,1602,300
2020,2,12,12,1325,1325,1629,304
2020,2,12,13,1390,1386,1647,261
2020,2,12,14,1520,1527,1706,179
2020,2,12,15,1625,1629,1682,53
2020,2,12,16,1610,1627,1873,246
2020,2,12,17,1605,1630,1942,312
2020,2,12,18,1585,1622,1954,332
2020,2,12,19,1565,1600,1967,367
2020,2,12,20,1545,1573,1940,367
2020,2,12,21,1520,1559,1931,372
2020,2,12,22,1510,1546,1928,382
2020,2,12,23,1515,1563,1936,373
2020,2,13,0,1530,1580,1928,348
2020,2,13,1,1580,1624,1920,296
2020,2,13,2,1635,1656,2008,352
2020,2,13,3,1625,1654,2020,366
2020,2,13,4,1600,1619,2016,397
2020,2,13,5,1520,1563,2028,465
2020,2,13,6,1455,1473,1982,509
2020,2,13,7,1395,1419,1900,481
2020,2,13,8,1400,1382,1895,513
2020,2,13,9,1360,1361,1929,568
2020,2,13,10,1355,1357,1912,555
2020,2,13,11,1350,1363,1931,568
2020,2,13,12,1380,1377,1948,571
2020,2,13,13,1440,1434,1996,562
2020,2,13,14,1565,1556,2083,527
2020,2,13,15,1675,1628,2108,480
2020,2,13,16,1655,1627,2157,530
2020,2,13,17,1640,1588,2121,533
2020,2,13,18,1635,1545,2089,544
2020,2,13,19,1605,1517,2097,580
2020,2,13,20,1585,1484,2026,542
2020,2,13,21,1560,1472,2039,567
2020,2,13,22,1555,1482,1932,450
2020,2,13,23,1555,1460,1853,393
2020,2,14,0,1585,1485,1897,412
2020,2,14,1,1615,1505,1955,450
2020,2,14,2,1655,1575,1964,389
2020,2,14,3,1630,1560,1926,366
2020,2,14,4,1590,1538,1965,427
2020,2,14,5,1530,1489,1908,419
2020,2,14,6,1455,1429,1801,372
2020,2,14,7,1375,1367,1743,376
2020,2,14,8,1325,1329,1730,401
2020,2,14,9,1310,1313,1835,522
2020,2,14,10,1305,1304,1748,444
2020,2,14,11,1315,1307,1704,397
2020,2,14,12,1335,1325,1653,328
2020,2,14,13,1390,1375,1736,361
2020,2,14,14,1490,1504,2039,535
2020,2,14,15,1575,1611,2136,525
2020,2,14,16,1570,1587,2127,540
2020,2,14,17,1580,1575,2115,540
2020,2,14,18,1550,1575,2060,485
2020,2,14,19,1535,1557,2100,543
2020,2,14,20,1515,1531,2005,474
2020,2,14,21,1500,1505,1927,422
2020,2,14,22,1490,1500,1807,307
2020,2,14,23,1485,1491,1853,362
2020,2,15,0,1500,1502,1846,344
2020,2,15,1,1545,1533,1859,326
2020,2,15,2,1565,1574,1862,288
2020,2,15,3,1545,1552,1866,314
2020,2,15,4,1505,1527,1787,260
2020,2,15,5,1440,1476,1789,313
2020,2,15,6,1395,1429,1791,362
2020,2,15,7,1340,1367,1769,402
2020,2,15,8,1295,1327,1790,463
2020,2,15,9,1280,1312,1896,584
2020,2,15,10,1270,1299,1888,589
2020,2,15,11,1270,1308,1902,594
2020,2,15,12,1270,1325,1959,634
2020,2,15,13,1310,1341,1963,622
2020,2,15,14,1385,1396,1961,565
2020,2,15,15,1455,1446,2024,578
2020,2,15,16,1485,1499,2119,620
2020,2,15,17,1505,1537,2092,555
2020,2,15,18,1505,1539,2099,560
2020,2,15,19,1490,1526,2182,656
2020,2,15,20,1470,1492,2121,629
2020,2,15,21,1455,1490,2107,617
2020,2,15,22,1445,1474,2090,616
2020,2,15,23,1450,1462,2063,601
2020,2,16,0,1475,1474,2064,590
2020,2,16,1,1525,1524,2139,615
2020,2,16,2,1570,1573,2309,736
2020,2,16,3,1550,1558,2365,807
2020,2,16,4,1515,1517,2281,764
2020,2,16,5,1455,1470,2227,757
2020,2,16,6,1410,1425,2156,731
2020,2,16,7,1365,1366,2043,677
2020,2,16,8,1280,1318,1898,580
2020,2,16,9,1265,1300,1851,551
2020,2,16,10,1260,1290,1850,560
2020,2,16,11,1265,1273,1719,446
2020,2,16,12,1280,1293,1744,451
2020,2,16,13,1315,1304,1743,439
2020,2,16,14,1380,1339,1713,374
2020,2,16,15,1445,1393,1654,261
2020,2,16,16,1480,1443,1762,319
2020,2,16,17,1495,1464,1754,290
2020,2,16,18,1485,1471,1782,311
2020,2,16,19,1475,1463,1780,317
2020,2,16,20,1465,1444,1760,316
2020,2,16,21,1440,1408,1652,244
2020,2,16,22,1440,1417,1672,255
2020,2,16,23,1445,1408,1624,216
2020,2,17,0,1475,1449,1750,301
2020,2,17,1,1520,1511,1893,382
2020,2,17,2,1560,1555,1934,379
2020,2,17,3,1530,1552,1965,413
2020,2,17,4,1505,1516,2027,511
2020,2,17,5,1445,1465,1858,393
2020,2,17,6,1380,1398,1850,452
2020,2,17,7,1310,1345,1932,587
2020,2,17,8,1320,1323,1832,509
2020,2,17,9,1290,1285,1606,321
2020,2,17,10,1285,1289,1608,319
2020,2,17,11,1300,1290,1603,313
2020,2,17,12,1315,1310,1670,360
2020,2,17,13,1385,1370,1815,445
2020,2,17,14,1515,1483,2091,608
2020,2,17,15,1615,1562,2130,568
2020,2,17,16,1605,1572,2131,559
2020,2,17,17,1595,1590,2168,578
2020,2,17,18,1570,1588,2186,598
2020,2,17,19,1555,1560,2198,638
2020,2,17,20,1530,1521,2167,646
2020,2,17,21,1505,1523,2163,640
2020,2,17,22,1505,1505,2090,585
2020,2,17,23,1495,1502,2009,507
2020,2,18,0,1520,1528,2048,520
2020,2,18,1,1565,1582,2216,634
2020,2,18,2,1625,1643,2222,579
2020,2,18,3,1620,1636,2146,510
2020,2,18,4,1595,1603,2105,502
2020,2,18,5,1530,1547,2094,547
2020,2,18,6,1460,1463,2047,584
2020,2,18,7,1405,1406,2011,605
2020,2,18,8,1355,1369,1989,620
2020,2,18,9,1340,1354,1970,616
2020,2,18,10,1335,1347,1984,637
2020,2,18,11,1340,1360,2014,654
2020,2,18,12,1360,1386,2020,634
2020,2,18,13,1410,1439,2062,623
2020,2,18,14,1555,1572,2179,607
2020,2,18,15,1665,1651,2229,578
2020,2,18,16,1670,1663,2160,497
2020,2,18,17,1645,1649,2178,529
2020,2,18,18,1615,1625,2209,584
2020,2,18,19,1585,1590,2213,623
2020,2,18,20,1560,1583,2187,604
2020,2,18,21,1540,1581,2153,572
2020,2,18,22,1550,1572,2131,559
2020,2,18,23,1535,1568,2145,577
2020,2,19,0,1565,1589,2157,568
2020,2,19,1,1605,1618,2148,530
2020,2,19,2,1665,1685,2160,475
2020,2,19,3,1650,1677,2165,488
2020,2,19,4,1620,1663,2159,496
2020,2,19,5,1560,1605,2148,543
2020,2,19,6,1505,1527,2104,577
2020,2,19,7,1440,1473,2052,579
2020,2,19,8,1350,1439,2044,605
2020,2,19,9,1350,1431,1966,535
2020,2,19,10,1340,1436,2014,578
2020,2,19,11,1350,1459,2051,592
2020,2,19,12,1375,1481,2058,577
2020,2,19,13,1430,1538,2111,573
2020,2,19,14,1545,1658,2137,479
2020,2,19,15,1630,1730,2163,433
2020,2,19,16,1620,1712,2150,438
2020,2,19,17,1600,1688,2128,440
2020,2,19,18,1585,1630,2084,454
2020,2,19,19,1555,1575,2080,505
2020,2,19,20,1530,1547,2112,565
2020,2,19,21,1515,1533,2060,527
2020,2,19,22,1510,1506,2031,525
2020,2,19,23,1520,1506,2022,516
2020,2,20,0,1545,1524,2068,544
2020,2,20,1,1605,1571,2108,537
2020,2,20,2,1650,1655,2122,467
2020,2,20,3,1635,1644,2133,489
2020,2,20,4,1605,1640,2118,478
2020,2,20,5,1560,1576,2074,498
2020,2,20,6,1460,1505,2054,549
2020,2,20,7,1400,1449,2109,660
2020,2,20,8,1360,1417,2090,673
2020,2,20,9,1340,1411,2082,671
2020,2,20,10,1335,1408,2093,685
2020,2,20,11,1340,1417,2094,677
2020,2,20,12,1360,1446,2096,650
2020,2,20,13,1420,1502,2167,665
2020,2,20,14,1550,1642,2209,567
2020,2,20,15,1640,1661,2256,595
2020,2,20,16,1635,1679,2251,572
2020,2,20,17,1610,1660,2275,615
2020,2,20,18,1580,1632,2282,650
2020,2,20,19,1545,1600,2262,662
2020,2,20,20,1525,1567,2246,679
2020,2,20,21,1515,1542,2218,676
2020,2,20,22,1520,1522,2150,628
2020,2,20,23,1505,1507,2138,631
2020,2,21,0,1530,1520,2201,681
2020,2,21,1,1550,1552,2191,639
2020,2,21,2,1615,1628,2244,616
2020,2,21,3,1600,1632,2242,610
2020,2,21,4,1575,1610,2246,636
2020,2,21,5,1510,1555,1829,274
2020,2,21,6,1455,1486,1783,297
2020,2,21,7,1395,1425,1881,456
2020,2,21,8,1345,1400,2204,804
2020,2,21,9,1325,1395,2174,779
2020,2,21,10,1325,1393,2204,811
2020,2,21,11,1325,1387,2174,787
2020,2,21,12,1345,1416,2145,729
2020,2,21,13,1400,1462,2178,716
2020,2,21,14,1500,1577,2316,739
2020,2,21,15,1575,1638,2335,697
2020,2,21,16,1555,1635,2307,672
2020,2,21,17,1545,1609,2311,702
2020,2,21,18,1535,1589,2334,745
2020,2,21,19,1510,1555,2333,778
2020,2,21,20,1485,1521,2303,782
2020,2,21,21,1465,1499,2296,797
2020,2,21,22,1460,1477,2314,837
2020,2,21,23,1450,1457,2297,840
2020,2,22,0,1465,1469,2286,817
2020,2,22,1,1500,1486,2264,778
2020,2,22,2,1545,1567,2341,774
2020,2,22,3,1525,1555,2317,762
2020,2,22,4,1505,1545,2281,736
2020,2,22,5,1475,1508,2357,849
2020,2,22,6,1400,1446,2223,777
2020,2,22,7,1340,1400,2192,792
2020,2,22,8,1305,1358,2142,784
2020,2,22,9,1290,1275,2062,787
2020,2,22,10,1280,1264,2052,788
2020,2,22,11,1290,1272,2057,785
2020,2,22,12,1300,1279,2057,778
2020,2,22,13,1330,1305,2106,801
2020,2,22,14,1385,1374,2151,777
2020,2,22,15,1420,1413,2162,749
2020,2,22,16,1460,1447,2185,738
2020,2,22,17,1485,1468,2220,752
2020,2,22,18,1485,1450,2238,788
2020,2,22,19,1465,1428,2188,760
2020,2,22,20,1440,1390,2152,762
2020,2,22,21,1430,1358,2091,733
2020,2,22,22,1415,1344,2043,699
2020,2,22,23,1410,1333,1892,559
2020,2,23,0,1420,1325,1932,607
2020,2,23,1,1465,1367,2065,698
2020,2,23,2,1515,1422,2139,717
2020,2,23,3,1505,1426,2167,741
2020,2,23,4,1465,1403,2169,766
2020,2,23,5,1420,1345,2061,716
2020,2,23,6,1370,1305,2002,697
2020,2,23,7,1315,1003,2060,1057
2020,2,23,8,1285,1233,1999,766
2020,2,23,9,1270,1212,1894,682
2020,2,23,10,1265,1217,1860,643
2020,2,23,11,1260,1208,1823,615
2020,2,23,12,1280,1214,1856,642
2020,2,23,13,1300,1258,1952,694
2020,2,23,14,1345,1298,1967,669
2020,2,23,15,1380,1346,1861,515
2020,2,23,16,1420,1380,1845,465
2020,2,23,17,1435,1396,1925,529
2020,2,23,18,1435,1388,1846,458
2020,2,23,19,1425,1374,1865,491
2020,2,23,20,1400,1351,1761,410
2020,2,23,21,1370,1332,1669,337
2020,2,23,22,1375,1312,1646,334
2020,2,23,23,1365,1312,1684,372
2020,2,24,0,1400,1334,1659,325
2020,2,24,1,1455,1403,1885,482
2020,2,24,2,1500,1445,2027,582
2020,2,24,3,1490,1475,2054,579
2020,2,24,4,1460,1460,2074,614
2020,2,24,5,1380,1398,2101,703
2020,2,24,6,1345,1326,1962,636
2020,2,24,7,1290,1251,1885,634
2020,2,24,8,1300,1317,2045,728
2020,2,24,9,1270,1299,2038,739
2020,2,24,10,1270,1301,1983,682
2020,2,24,11,1275,1298,1972,674
2020,2,24,12,1295,1309,1976,667
2020,2,24,13,1355,1364,2081,717
2020,2,24,14,1485,1492,2186,694
2020,2,24,15,1580,1566,2252,686
2020,2,24,16,1575,1561,2230,669
2020,2,24,17,1585,1564,2212,648
2020,2,24,18,1575,1559,2247,688
2020,2,24,19,1550,1552,2251,699
2020,2,24,20,1515,1533,2055,522
2020,2,24,21,1505,1528,2055,527
2020,2,24,22,1490,1520,2005,485
2020,2,24,23,1485,1512,1984,472
2020,2,25,0,1510,1538,1976,438
2020,2,25,1,1560,1576,2124,548
2020,2,25,2,1620,1641,2199,558
2020,2,25,3,1615,1630,2197,567
2020,2,25,4,1585,1595,2149,554
2020,2,25,5,1500,1535,2046,511
2020,2,25,6,1450,1454,2009,555
2020,2,25,7,1390,1393,2037,644
2020,2,25,8,1415,1368,2031,663
2020,2,25,9,1370,1346,2034,688
2020,2,25,10,1365,1340,2031,691
2020,2,25,11,1355,1341,2033,692
2020,2,25,12,1395,1364,2036,672
2020,2,25,13,1450,1417,2053,636
2020,2,25,14,1570,1541,2064,523
2020,2,25,15,1680,1630,2070,440
2020,2,25,16,1660,1610,2082,472
2020,2,25,17,1650,1581,2081,500
2020,2,25,18,1640,1549,2040,491
2020,2,25,19,1615,1518,2019,501
2020,2,25,20,1590,1490,2024,534
2020,2,25,21,1565,1487,2059,572
2020,2,25,22,1565,1469,2105,636
2020,2,25,23,1560,1463,2088,625
2020,2,26,0,1590,1477,2071,594
2020,2,26,1,1610,1511,2115,604
2020,2,26,2,1655,1589,2149,560
2020,2,26,3,1625,1604,2160,556
2020,2,26,4,1580,1577,2148,571
2020,2,26,5,1515,1522,2174,652
2020,2,26,6,1445,1438,2146,708
2020,2,26,7,1360,1386,2146,760
2020,2,26,8,1310,1350,2080,730
2020,2,26,9,1295,1342,2147,805
2020,2,26,10,1300,1341,2119,778
2020,2,26,11,1310,1331,2128,797
2020,2,26,12,1330,1364,2169,805
2020,2,26,13,1380,1417,2212,795
2020,2,26,14,1505,1538,2299,761
2020,2,26,15,1580,1604,2279,675
2020,2,26,16,1570,1585,2294,709
2020,2,26,17,1565,1571,2297,726
2020,2,26,18,1530,1552,2294,742
2020,2,26,19,1495,1529,2241,712
2020,2,26,20,1470,1500,2202,702
2020,2,26,21,1460,1490,2115,625
2020,2,26,22,1435,1477,2085,608
2020,2,26,23,1440,1478,2053,575
2020,2,27,0,1460,1493,2119,626
2020,2,27,1,1500,1531,2243,712
2020,2,27,2,1570,1571,2293,722
2020,2,27,3,1560,1569,2332,763
2020,2,27,4,1545,1539,2232,693
2020,2,27,5,1480,1482,2166,684
2020,2,27,6,1410,1414,2143,729
2020,2,27,7,1355,1356,2128,772
2020,2,27,8,1290,1316,2094,778
2020,2,27,9,1280,1302,2104,802
2020,2,27,10,1275,1303,2113,810
2020,2,27,11,1280,1317,2135,818
2020,2,27,12,1305,1342,2170,828
2020,2,27,13,1360,1400,2220,820
2020,2,27,14,1505,1515,2258,743
2020,2,27,15,1560,1569,2264,695
2020,2,27,16,1570,1547,2280,733
2020,2,27,17,1545,1554,2298,744
2020,2,27,18,1520,1530,2318,788
2020,2,27,19,1485,1502,2306,804
2020,2,27,20,1460,1476,2280,804
2020,2,27,21,1440,1460,2215,755
2020,2,27,22,1425,1446,2219,773
2020,2,27,23,1415,1435,2234,799
2020,2,28,0,1425,1438,2183,745
2020,2,28,1,1455,1464,2271,807
2020,2,28,2,1530,1530,2356,826
2020,2,28,3,1525,1543,2326,783
2020,2,28,4,1510,1526,2307,781
2020,2,28,5,1470,1467,2257,790
2020,2,28,6,1395,1399,2199,800
2020,2,28,7,1335,1341,2216,875
2020,2,28,8,1265,1312,2184,872
2020,2,28,9,1250,1308,2079,771
2020,2,28,10,1250,1288,2065,777
2020,2,28,11,1245,1291,2056,765
2020,2,28,12,1270,1316,2126,810
2020,2,28,13,1320,1371,2178,807
2020,2,28,14,1440,1480,2280,800
2020,2,28,15,1520,1568,2293,725
2020,2,28,16,1510,1556,2314,758
2020,2,28,17,1485,1538,2303,765
2020,2,28,18,1470,1502,2254,752
2020,2,28,19,1440,1482,2269,787
2020,2,28,20,1410,1451,2207,756
2020,2,28,21,1395,1424,2114,690
2020,2,28,22,1375,1403,2039,636
2020,2,28,23,1365,1379,1984,605
2020,2,29,0,1370,1389,1948,559
2020,2,29,1,1395,1400,1962,562
2020,2,29,2,1465,1443,1957,514
2020,2,29,3,1455,1439,1905,466
2020,2,29,4,1445,1421,1913,492
2020,2,29,5,1400,1383,1926,543
2020,2,29,6,1345,1335,1914,579
2020,2,29,7,1295,1283,1884,601
2020,2,29,8,1340,1241,1793,552
2020,2,29,9,1280,1228,1818,590
2020,2,29,10,1270,1225,1846,621
2020,2,29,11,1280,1234,1833,599
2020,2,29,12,1290,1256,1883,627
2020,2,29,13,1310,1280,1995,715
2020,2,29,14,1370,1329,2005,676
2020,2,29,15,1410,1379,2067,688
2020,2,29,16,1450,1419,1987,568
2020,2,29,17,1480,1424,1908,484
2020,2,29,18,1470,1440,1897,457
2020,2,29,19,1450,1424,1862,438
2020,2,29,20,1415,1411,1753,342
2020,2,29,21,1395,1396,1742,346
2020,2,29,22,1380,1386,1745,359
2020,2,29,23,1370,1378,1721,343
2020,3,1,0,1370,1404,1686,282
2020,3,1,1,1410,1433,1759,326
2020,3,1,2,1460,1504,1890,386
2020,3,1,3,1460,1506,2065,559
2020,3,1,4,1430,1460,2085,625
2020,3,1,5,1370,1412,2024,612
2020,3,1,6,1330,1354,2023,669
2020,3,1,7,1260,1311,2021,710
2020,3,1,8,1270,1278,1965,687
2020,3,1,9,1245,1276,2048,772
2020,3,1,10,1250,1257,2084,827
2020,3,1,11,1240,1257,2044,787
2020,3,1,12,1250,1268,2059,791
2020,3,1,13,1280,1286,2094,808
2020,3,1,14,1315,1327,2076,749
2020,3,1,15,1350,1380,2118,738
2020,3,1,16,1395,1428,2113,685
2020,3,1,17,1410,1450,2116,666
2020,3,1,18,1410,1451,2128,677
2020,3,1,19,1400,1432,2186,754
2020,3,1,20,1380,1418,2183,765
2020,3,1,21,1355,1394,2158,764
2020,3,1,22,1345,1382,2078,696
2020,3,1,23,1340,1394,2075,681
2020,3,2,0,1375,1418,2098,680
2020,3,2,1,1435,1476,2153,677
2020,3,2,2,1475,1554,2195,641
2020,3,2,3,1490,1561,2226,665
2020,3,2,4,1470,1534,2201,667
2020,3,2,5,1400,1483,2157,674
2020,3,2,6,1340,1399,2048,649
2020,3,2,7,1275,1325,1999,674
2020,3,2,8,1330,1291,1962,671
2020,3,2,9,1315,1274,1944,670
2020,3,2,10,1315,1278,1948,670
2020,3,2,11,1310,1286,1922,636
2020,3,2,12,1330,1314,1926,612
2020,3,2,13,1385,1366,2023,657
2020,3,2,14,1495,1504,2194,690
2020,3,2,15,1560,1574,2300,726
2020,3,2,16,1545,1591,2270,679
2020,3,2,17,1545,1574,2266,692
2020,3,2,18,1535,1569,2272,703
2020,3,2,19,1520,1536,2253,717
2020,3,2,20,1500,1527,2233,706
2020,3,2,21,1490,1506,2226,720
2020,3,2,22,1485,1507,2277,770
2020,3,2,23,1480,1501,2264,763
2020,3,3,0,1495,1512,2252,740
2020,3,3,1,1535,1529,2270,741
2020,3,3,2,1590,1592,2260,668
2020,3,3,3,1585,1585,2284,699
2020,3,3,4,1550,1537,2203,666
2020,3,3,5,1490,1486,2194,708
2020,3,3,6,1415,1399,2151,752
2020,3,3,7,1350,1331,2007,676
2020,3,3,8,1260,1298,1484,186
2020,3,3,9,1240,1288,1181,-107
2020,3,3,10,1230,1257,1119,-138
2020,3,3,11,1235,1254,1087,-167
2020,3,3,12,1250,1280,1108,-172
2020,3,3,13,1295,1331,1157,-174
2020,3,3,14,1425,1446,1177,-269
2020,3,3,15,1520,1517,1162,-355
2020,3,3,16,1520,1494,1103,-391
2020,3,3,17,1510,1472,1068,-404
2020,3,3,18,1485,1471,1131,-340
2020,3,3,19,1455,1457,1164,-293
2020,3,3,20,1435,1442,1220,-222
2020,3,3,21,1430,1415,1240,-175
2020,3,3,22,1410,1399,1289,-110
2020,3,3,23,1415,1398,1312,-86
2020,3,4,0,1425,1404,1318,-86
2020,3,4,1,1465,1431,1330,-101
2020,3,4,2,1540,1486,1307,-179
2020,3,4,3,1550,1507,1287,-220
2020,3,4,4,1525,1480,1277,-203
2020,3,4,5,1450,1427,1261,-166
2020,3,4,6,1390,1339,1205,-134
2020,3,4,7,1330,1288,1248,-40
2020,3,4,8,1255,1270,1286,16
2020,3,4,9,1245,1244,1181,-63
2020,3,4,10,1245,1233,1237,4
2020,3,4,11,1245,1246,1253,7
2020,3,4,12,1275,1259,1258,-1
2020,3,4,13,1325,1324,1262,-62
2020,3,4,14,1465,1430,1302,-128
2020,3,4,15,1550,1502,1259,-243
2020,3,4,16,1535,1479,1261,-218
2020,3,4,17,1525,1473,1240,-233
2020,3,4,18,1505,1450,1202,-248
2020,3,4,19,1475,1438,1196,-242
2020,3,4,20,1455,1432,1139,-293
2020,3,4,21,1440,1444,1187,-257
2020,3,4,22,1430,1392,1177,-215
2020,3,4,23,1430,1423,1212,-211
2020,3,5,0,1440,1446,1245,-201
2020,3,5,1,1475,1464,1305,-159
2020,3,5,2,1525,1511,1289,-222
2020,3,5,3,1520,1523,1274,-249
2020,3,5,4,1495,1488,1244,-244
2020,3,5,5,1450,1434,1214,-220
2020,3,5,6,1365,1359,1171,-188
2020,3,5,7,1305,1306,1183,-123
2020,3,5,8,1280,1271,1217,-54
2020,3,5,9,1270,1262,1164,-98
2020,3,5,10,1265,1260,1095,-165
2020,3,5,11,1275,1269,1141,-128
2020,3,5,12,1300,1303,1084,-219
2020,3,5,13,1355,1365,1111,-254
2020,3,5,14,1470,1491,1126,-365
2020,3,5,15,1520,1549,1146,-403
2020,3,5,16,1505,1513,1134,-379
2020,3,5,17,1500,1484,1103,-381
2020,3,5,18,1480,1462,1114,-348
2020,3,5,19,1455,1419,1108,-311
2020,3,5,20,1435,1408,1115,-293
2020,3,5,21,1415,1381,1099,-282
2020,3,5,22,1400,1365,1096,-269
2020,3,5,23,1390,1364,1104,-260
2020,3,6,0,1395,1373,1111,-262
2020,3,6,1,1415,1373,1116,-257
2020,3,6,2,1485,1448,1135,-313
2020,3,6,3,1500,1452,1112,-340
2020,3,6,4,1480,1437,1116,-321
2020,3,6,5,1420,1385,1090,-295
2020,3,6,6,1355,1311,929,-382
2020,3,6,7,1300,1244,893,-351
2020,3,6,8,1235,1226,881,-345
2020,3,6,9,1225,1218,857,-361
2020,3,6,10,1215,1201,859,-342
2020,3,6,11,1220,1204,854,-350
2020,3,6,12,1240,1232,845,-387
2020,3,6,13,1295,1281,845,-436
2020,3,6,14,1385,1384,863,-521
2020,3,6,15,1460,1459,882,-577
2020,3,6,16,1450,1470,881,-589
2020,3,6,17,1430,1446,903,-543
2020,3,6,18,1405,1434,929,-505
2020,3,6,19,1385,1399,946,-453
2020,3,6,20,1360,1377,969,-408
2020,3,6,21,1345,1374,993,-381
2020,3,6,22,1320,1333,1220,-113
2020,3,6,23,1305,1341,1520,179
2020,3,7,0,1320,1356,1698,342
2020,3,7,1,1330,1354,1770,416
2020,3,7,2,1380,1388,1772,384
2020,3,7,3,1380,1389,1753,364
2020,3,7,4,1360,1379,1784,405
2020,3,7,5,1330,1331,1791,460
2020,3,7,6,1270,1283,1778,495
2020,3,7,7,1215,1231,1849,618
2020,3,7,8,1205,1203,1831,628
2020,3,7,9,1180,1186,1880,694
2020,3,7,10,1180,1180,1853,673
2020,3,7,11,1190,1179,1827,648
2020,3,7,12,1205,1195,1841,646
2020,3,7,13,1240,1220,1874,654
2020,3,7,14,1300,1286,1924,638
2020,3,7,15,1355,1338,1827,489
2020,3,7,16,1375,1385,1867,482
2020,3,7,17,1380,1417,1898,481
2020,3,7,18,1380,1413,1901,488
2020,3,7,19,1365,1394,1892,498
2020,3,7,20,1345,1383,1892,509
2020,3,7,21,1330,1368,1923,555
2020,3,7,22,1320,1353,1869,516
2020,3,7,23,1310,1358,1878,520
2020,3,8,0,1330,1374,1906,532
2020,3,8,1,1355,1397,1957,560
2020,3,8,2,1415,1430,1940,510
2020,3,8,3,1415,1436,1993,557
2020,3,8,4,1380,1392,1953,561
2020,3,8,5,1355,1369,1965,596
2020,3,8,6,1280,1332,2064,732
2020,3,8,7,1235,1296,2041,745
2020,3,8,8,1220,1267,2062,795
2020,3,8,9,-9999,1267,2062,-9999
2020,3,8,10,1200,1216,2019,803
2020,3,8,11,1200,1220,1951,731
2020,3,8,12,1215,1235,1995,760
2020,3,8,13,1245,1255,1978,723
2020,3,8,14,1295,1299,1976,677
2020,3,8,15,1335,1345,2034,689
2020,3,8,16,1370,1400,2045,645
2020,3,8,17,1375,1448,2112,664
2020,3,8,18,1370,1456,2077,621
2020,3,8,19,1350,1435,2010,575
2020,3,8,20,1335,1440,2073,633
2020,3,8,21,1310,1413,2080,667
2020,3,8,22,1300,1399,2108,709
2020,3,8,23,1305,1393,2079,686
2020,3,9,0,1330,1392,2082,690
2020,3,9,1,1370,1409,2105,696
2020,3,9,2,1440,1439,2108,669
2020,3,9,3,1450,1481,2084,603
2020,3,9,4,1430,1504,2131,627
2020,3,9,5,1335,1460,2103,643
2020,3,9,6,1300,1389,2024,635
2020,3,9,7,1235,1263,1997,734
2020,3,9,8,1220,1254,1947,693
2020,3,9,9,1220,1244,1955,711
2020,3,9,10,1230,1255,1974,719
2020,3,9,11,1255,1282,1981,699
2020,3,9,12,1305,1329,2049,720
2020,3,9,13,1435,1452,2086,634
2020,3,9,14,1500,1542,2108,566
2020,3,9,15,1500,1550,2113,563
2020,3,9,16,1485,1543,2110,567
2020,3,9,17,1475,1520,2110,590
2020,3,9,18,1445,1489,2100,611
2020,3,9,19,1435,1478,2108,630
2020,3,9,20,1415,1460,2102,642
2020,3,9,21,1415,1457,2101,644
2020,3,9,22,1410,1439,2136,697
2020,3,9,23,1420,1428,2145,717
2020,3,10,0,1440,1448,2124,676
2020,3,10,1,1500,1462,2102,640
2020,3,10,2,1495,1505,2064,559
2020,3,10,3,1455,1511,2080,569
2020,3,10,4,1400,1461,2077,616
2020,3,10,5,1330,1396,2081,685
2020,3,10,6,1260,1317,2093,776
2020,3,10,7,1255,1274,2105,831
2020,3,10,8,1250,1259,2158,899
2020,3,10,9,1220,1262,2214,952
2020,3,10,10,1220,1267,2239,972
2020,3,10,11,1245,1295,2264,969
2020,3,10,12,1295,1346,2290,944
2020,3,10,13,1430,1460,2279,819
2020,3,10,14,1520,1568,2304,736
2020,3,10,15,1500,1563,2343,780
2020,3,10,16,1480,1527,2403,876
2020,3,10,17,1475,1504,2352,848
2020,3,10,18,1455,1488,2421,933
2020,3,10,19,1440,1466,2421,955
2020,3,10,20,1415,1451,2419,968
2020,3,10,21,1400,1437,2428,991
2020,3,10,22,1395,1425,2443,1018
2020,3,10,23,1405,1424,2442,1018
2020,3,11,0,1430,1422,2433,1011
2020,3,11,1,1490,1443,2439,996
2020,3,11,2,1510,1487,2433,946
2020,3,11,3,1485,1503,2428,925
2020,3,11,4,1420,1453,2384,931
2020,3,11,5,1345,1381,2355,974
2020,3,11,6,1290,1297,2254,957
2020,3,11,7,1250,1254,2208,954
2020,3,11,8,1230,1221,2205,984
2020,3,11,9,1220,1209,2218,1009
2020,3,11,10,1230,1196,2180,984
2020,3,11,11,1245,1213,2202,989
2020,3,11,12,1305,1262,2272,1010
2020,3,11,13,1425,1381,2343,962
2020,3,11,14,1510,1467,2343,876
2020,3,11,15,1495,1473,2276,803
2020,3,11,16,1490,1457,2313,856
2020,3,11,17,1470,1472,2363,891
2020,3,11,18,1450,1441,2364,923
2020,3,11,19,1440,1423,2325,902
2020,3,11,20,1440,1420,2338,918
2020,3,11,21,1410,1411,2345,934
2020,3,11,22,1425,1399,2173,774
2020,3,11,23,1440,1405,2156,751
2020,3,12,0,1460,1400,2185,785
2020,3,12,1,1500,1434,2322,888
2020,3,12,2,1515,1465,2317,852
2020,3,12,3,1490,1478,2296,818
2020,3,12,4,1450,1436,2249,813
2020,3,12,5,1360,1358,2260,902
2020,3,12,6,1305,1306,2284,978
2020,3,12,7,1235,1300,2305,1005
2020,3,12,8,1220,1275,2290,1015
2020,3,12,9,1220,1270,2244,974
2020,3,12,10,1230,1283,2191,908
2020,3,12,11,1260,1293,2234,941
2020,3,12,12,1320,1356,2178,822
2020,3,12,13,1445,1474,2158,684
2020,3,12,14,1520,1584,2146,562
2020,3,12,15,1490,1574,2149,575
2020,3,12,16,1465,1555,2145,590
2020,3,12,17,1445,1531,2144,613
2020,3,12,18,1410,1497,2162,665
2020,3,12,19,1395,1483,2180,697
2020,3,12,20,1375,1466,2204,738
2020,3,12,21,1360,1448,2222,774
2020,3,12,22,1350,1439,2204,765
2020,3,12,23,1360,1422,2175,753
2020,3,13,0,1365,1426,2174,748
2020,3,13,1,1425,1441,2235,794
2020,3,13,2,1440,1479,2204,725
2020,3,13,3,1430,1505,2225,720
2020,3,13,4,1380,1472,2172,700
2020,3,13,5,1305,1399,2129,730
2020,3,13,6,1240,1345,2087,742
2020,3,13,7,1340,1310,2075,765
2020,3,13,8,1315,1297,2081,784
2020,3,13,9,1315,1302,2089,787
2020,3,13,10,1305,1309,2091,782
2020,3,13,11,1325,1329,2148,819
2020,3,13,12,1380,1379,2171,792
2020,3,13,13,1500,1493,2212,719
2020,3,13,14,1605,1588,2219,631
2020,3,13,15,1585,1610,2220,610
2020,3,13,16,1570,1608,2229,621
2020,3,13,17,1575,1622,2281,659
2020,3,13,18,1555,1608,2301,693
2020,3,13,19,1530,1591,2297,706
2020,3,13,20,1505,1594,2327,733
2020,3,13,21,1505,1583,2342,759
2020,3,13,22,1495,1591,2358,767
2020,3,13,23,1505,1595,2358,763
2020,3,14,0,1535,1603,2369,766
2020,3,14,1,1575,1615,2368,753
2020,3,14,2,1555,1644,2357,713
2020,3,14,3,1535,1627,2345,718
2020,3,14,4,1485,1586,2343,757
2020,3,14,5,1435,1528,2332,804
2020,3,14,6,1375,1470,2316,846
2020,3,14,7,1300,1432,2294,862
2020,3,14,8,1285,1416,2265,849
2020,3,14,9,1280,1401,2226,825
2020,3,14,10,1290,1408,2261,853
2020,3,14,11,1305,1418,2222,804
2020,3,14,12,1340,1436,2212,776
2020,3,14,13,1410,1509,2248,739
2020,3,14,14,1480,1551,2258,707
2020,3,14,15,1510,1607,2242,635
2020,3,14,16,1520,1651,2243,592
2020,3,14,17,1515,1676,2278,602
2020,3,14,18,1505,1680,2283,603
2020,3,14,19,1490,1663,2289,626
2020,3,14,20,1465,1636,2272,636
2020,3,14,21,1455,1618,2174,556
2020,3,14,22,1455,1607,2163,556
2020,3,14,23,1490,1631,2165,534
2020,3,15,0,1530,1623,2156,533
2020,3,15,1,1570,1637,2172,535
2020,3,15,2,1555,1659,2165,506
2020,3,15,3,1530,1658,2158,500
2020,3,15,4,1480,1618,2161,543
2020,3,15,5,1405,1568,2158,590
2020,3,15,6,1335,1502,2133,631
2020,3,15,7,1320,1460,1987,527
2020,3,15,8,1310,1445,1947,502
2020,3,15,9,1300,1427,1945,518
2020,3,15,10,1305,1434,1960,526
2020,3,15,11,1320,1430,1961,531
2020,3,15,12,1360,1462,1950,488
2020,3,15,13,1420,1510,1936,426
2020,3,15,14,1490,1569,1922,353
2020,3,15,15,1525,1613,1921,308
2020,3,15,16,1540,1665,1912,247
2020,3,15,17,1530,1690,1871,181
2020,3,15,18,1520,1693,1849,156
2020,3,15,19,1500,1654,1830,176
2020,3,15,20,1475,1629,1811,182
2020,3,15,21,1465,1581,1793,212
2020,3,15,22,1470,1556,1791,235
2020,3,15,23,1500,1559,1778,219
2020,3,16,0,1550,1569,1795,226
2020,3,16,1,1590,1572,1801,229
2020,3,16,2,1575,1597,1811,214
2020,3,16,3,1555,1619,1832,213
2020,3,16,4,1490,1575,1818,243
2020,3,16,5,1425,1502,1806,304
2020,3,16,6,1350,1440,1812,372
2020,3,16,7,1350,1400,1823,423
2020,3,16,8,1330,1394,1810,416
2020,3,16,9,1325,1377,1800,423
2020,3,16,10,1335,1395,1795,400
2020,3,16,11,1355,1410,1794,384
2020,3,16,12,1415,1461,1833,372
2020,3,16,13,1525,1549,1858,309
2020,3,16,14,1610,1641,1867,226
2020,3,16,15,1615,1654,1879,225
2020,3,16,16,1605,1660,1898,238
2020,3,16,17,1585,1647,1886,239
2020,3,16,18,1555,1618,1853,235
2020,3,16,19,1540,1580,1779,199
2020,3,16,20,1525,1557,1855,298
2020,3,16,21,1520,1514,1838,324
2020,3,16,22,1500,1491,1837,346
2020,3,16,23,1495,1473,1824,351
2020,3,17,0,1510,1470,1806,336
2020,3,17,1,1535,1472,1797,325
2020,3,17,2,1575,1514,1794,280
2020,3,17,3,1570,1540,1818,278
2020,3,17,4,1520,1513,1905,392
2020,3,17,5,1450,1446,1877,431
2020,3,17,6,1375,1392,1928,536
2020,3,17,7,1355,1362,1943,581
2020,3,17,8,1340,1357,1957,600
2020,3,17,9,1335,1351,1961,610
2020,3,17,10,1335,1356,2009,653
2020,3,17,11,1360,1381,2014,633
2020,3,17,12,1410,1425,2027,602
2020,3,17,13,1490,1519,2056,537
2020,3,17,14,1560,1603,2058,455
2020,3,17,15,1565,1614,2072,458
2020,3,17,16,1545,1613,2079,466
2020,3,17,17,1535,1593,2080,487
2020,3,17,18,1525,1562,2030,468
2020,3,17,19,1500,1530,1993,463
2020,3,17,20,1480,1503,2119,616
2020,3,17,21,1460,1483,2115,632
2020,3,17,22,1445,1446,2159,713
2020,3,17,23,1450,1456,2186,730
2020,3,18,0,1455,1460,2238,778
2020,3,18,1,1480,1459,2224,765
2020,3,18,2,1515,1499,2243,744
2020,3,18,3,1525,1508,2217,709
2020,3,18,4,1460,1449,2170,721
2020,3,18,5,1400,1398,2192,794
2020,3,18,6,1325,1339,2196,857
2020,3,18,7,1315,1322,2215,893
2020,3,18,8,1285,1304,2226,922
2020,3,18,9,1275,1310,2219,909
2020,3,18,10,1270,1299,2174,875
2020,3,18,11,1285,1317,2077,760
2020,3,18,12,1340,1365,2067,702
2020,3,18,13,1460,1460,2028,568
2020,3,18,14,1550,1539,2015,476
2020,3,18,15,1560,1580,2054,474
2020,3,18,16,1545,1600,2068,468
2020,3,18,17,1550,1610,2087,477
2020,3,18,18,1520,1601,2093,492
2020,3,18,19,1500,1584,2074,490
2020,3,18,20,1500,1542,2063,521
2020,3,18,21,1475,1533,2126,593
2020,3,18,22,1465,1497,2097,600
2020,3,18,23,1475,1481,2088,607
2020,3,19,0,1470,1480,2092,612
2020,3,19,1,1500,1498,2091,593
2020,3,19,2,1530,1515,2106,591
2020,3,19,3,1540,1536,2104,568
2020,3,19,4,1480,1476,2097,621
2020,3,19,5,1415,1407,2058,651
2020,3,19,6,1360,1348,2052,704
2020,3,19,7,1315,1321,2096,775
2020,3,19,8,1295,1302,2089,787
2020,3,19,9,1290,1310,2122,812
2020,3,19,10,1300,1315,2108,793
2020,3,19,11,1310,1340,2105,765
2020,3,19,12,1380,1390,2151,761
2020,3,19,13,1510,1491,2150,659
2020,3,19,14,1620,1563,2164,601
2020,3,19,15,1615,1594,2162,568
2020,3,19,16,1600,1589,2173,584
2020,3,19,17,1575,1606,2173,567
2020,3,19,18,1540,1597,2165,568
2020,3,19,19,1525,1575,2170,595
2020,3,19,20,1505,1559,2175,616
2020,3,19,21,1485,1536,2184,648
2020,3,19,22,1465,1532,2146,614
2020,3,19,23,1460,1538,2101,563
2020,3,20,0,1465,1559,2111,552
2020,3,20,1,1485,1568,2109,541
2020,3,20,2,1525,1581,2126,545
2020,3,20,3,1540,1576,2139,563
2020,3,20,4,1500,1524,2139,615
2020,3,20,5,1425,1462,2117,655
2020,3,20,6,1365,1406,2096,690
2020,3,20,7,1315,1384,2097,713
2020,3,20,8,1305,1365,2075,710
2020,3,20,9,1310,1366,2060,694
2020,3,20,10,1310,1372,2049,677
2020,3,20,11,1330,1384,2054,670
2020,3,20,12,1380,1427,2078,651
2020,3,20,13,1470,1496,2079,583
2020,3,20,14,1540,1581,2087,506
2020,3,20,15,1560,1597,2073,476
2020,3,20,16,1560,1599,2078,479
2020,3,20,17,1570,1567,2076,509
2020,3,20,18,1555,1557,2040,483
2020,3,20,19,1535,1504,2027,523
2020,3,20,20,1530,1484,2035,551
2020,3,20,21,1510,1444,2038,594
2020,3,20,22,1515,1421,2044,623
2020,3,20,23,1510,1412,2062,650
2020,3,21,0,1520,1411,2057,646
2020,3,21,1,1535,1413,2047,634
2020,3,21,2,1555,1443,2049,606
2020,3,21,3,1545,1460,2045,585
2020,3,21,4,1500,1415,2041,626
2020,3,21,5,1440,1369,2039,670
2020,3,21,6,1380,1331,2057,726
2020,3,21,7,1290,1308,2080,772
2020,3,21,8,1270,1288,2078,790
2020,3,21,9,1270,1295,2114,819
2020,3,21,10,1275,1307,2157,850
2020,3,21,11,1295,1319,2245,926
2020,3,21,12,1325,1335,2222,887
2020,3,21,13,1340,1378,2208,830
2020,3,21,14,1360,1405,2193,788
2020,3,21,15,1395,1441,2209,768
2020,3,21,16,1400,1436,2199,763
2020,3,21,17,1415,1437,2211,774
2020,3,21,18,1405,1413,2142,729
2020,3,21,19,1390,1378,2040,662
2020,3,21,20,1375,1358,1996,638
2020,3,21,21,1365,1337,1920,583
2020,3,21,22,1360,1331,1927,596
2020,3,21,23,1380,1333,1884,551
2020,3,22,0,1405,1349,1958,609
2020,3,22,1,1450,1373,1962,589
2020,3,22,2,1455,1395,1968,573
2020,3,22,3,1420,1433,2057,624
2020,3,22,4,1360,1402,2055,653
2020,3,22,5,1320,1338,1986,648
2020,3,22,6,1285,1306,2050,744
2020,3,22,7,1260,1266,2036,770
2020,3,22,8,1250,1243,2010,767
2020,3,22,9,1235,1245,2011,766
2020,3,22,10,1240,1241,2035,794
2020,3,22,11,1250,1252,2091,839
2020,3,22,12,1270,1264,2102,838
2020,3,22,13,1295,1314,2111,797
2020,3,22,14,1320,1357,2139,782
2020,3,22,15,1360,1392,2123,731
2020,3,22,16,1375,1418,2085,667
2020,3,22,17,1385,1440,2066,626
2020,3,22,18,1375,1428,2051,623
2020,3,22,19,1355,1405,2022,617
2020,3,22,20,1335,1375,2001,626
2020,3,22,21,1320,1342,2090,748
2020,3,22,22,1325,1324,2038,714
2020,3,22,23,1340,1340,2151,811
2020,3,23,0,1380,1366,2174,808
2020,3,23,1,1425,1381,2172,791
2020,3,23,2,1440,1402,2116,714
2020,3,23,3,1425,1444,2150,706
2020,3,23,4,1320,1406,2117,711
2020,3,23,5,1310,1337,2068,731
2020,3,23,6,1240,1279,2015,736
2020,3,23,7,1225,1240,1916,676
2020,3,23,8,1210,1222,1911,689
2020,3,23,9,1205,1235,1884,649
2020,3,23,10,1215,1241,1884,643
2020,3,23,11,1235,1264,1964,700
2020,3,23,12,1280,1292,1921,629
2020,3,23,13,1370,1379,1914,535
2020,3,23,14,1445,1466,2051,585
2020,3,23,15,1455,1487,2100,613
2020,3,23,16,1455,1486,2103,617
2020,3,23,17,1440,1473,2102,629
2020,3,23,18,1420,1460,2109,649
2020,3,23,19,1405,1435,2022,587
2020,3,23,20,1385,1410,2022,612
2020,3,23,21,1375,1390,2003,613
2020,3,23,22,1360,1383,1976,593
2020,3,23,23,1355,1390,1940,550
2020,3,24,0,1370,1404,1943,539
2020,3,24,1,1380,1419,2067,648
2020,3,24,2,1415,1428,2076,648
2020,3,24,3,1420,1432,1973,541
2020,3,24,4,1380,1370,1911,541
2020,3,24,5,1315,1323,2015,692
2020,3,24,6,1250,1284,2059,775
2020,3,24,7,1235,1249,1945,696
2020,3,24,8,1220,1235,1989,754
2020,3,24,9,1220,1224,2033,809
2020,3,24,10,1215,1222,2100,878
2020,3,24,11,1235,1242,2117,875
2020,3,24,12,1260,1285,2145,860
2020,3,24,13,1365,1373,2233,860
2020,3,24,14,1460,1446,2146,700
2020,3,24,15,1485,1475,2234,759
2020,3,24,16,1495,1485,2217,732
2020,3,24,17,1500,1470,2199,729
2020,3,24,18,1480,1454,2174,720
2020,3,24,19,1460,1448,2201,753
2020,3,24,20,1435,1438,2176,738
2020,3,24,21,1405,1434,2167,733
2020,3,24,22,1380,1428,2125,697
2020,3,24,23,1395,1430,2107,677
2020,3,25,0,1410,1442,2055,613
2020,3,25,1,1420,1455,2066,611
2020,3,25,2,1450,1472,2078,606
2020,3,25,3,1480,1489,2064,575
2020,3,25,4,1410,1447,2061,614
2020,3,25,5,1370,1380,2070,690
2020,3,25,6,1305,1333,2091,758
2020,3,25,7,1230,1302,2060,758
2020,3,25,8,1210,1273,1957,684
2020,3,25,9,1225,1265,1937,672
2020,3,25,10,1210,1276,1960,684
2020,3,25,11,1230,1307,1994,687
2020,3,25,12,1270,1335,2020,685
2020,3,25,13,1365,1432,2038,606
2020,3,25,14,1435,1490,2060,570
2020,3,25,15,1465,1517,2047,530
2020,3,25,16,1470,1519,2004,485
2020,3,25,17,1475,1489,2004,515
2020,3,25,18,1465,1460,2012,552
2020,3,25,19,1445,1450,2066,616
2020,3,25,20,1420,1441,2088,647
2020,3,25,21,1405,1416,1990,574
2020,3,25,22,1380,1418,1940,522
2020,3,25,23,1375,1436,2040,604
2020,3,26,0,1375,1439,2032,593
2020,3,26,1,1395,1449,2048,599
2020,3,26,2,1410,1474,2051,577
2020,3,26,3,1425,1486,2049,563
2020,3,26,4,1370,1453,2033,580
2020,3,26,5,1310,1374,1987,613
2020,3,26,6,1255,1310,2007,697
2020,3,26,7,1235,1269,2008,739
2020,3,26,8,1215,1270,1997,727
2020,3,26,9,1210,1260,1927,667
2020,3,26,10,1215,1276,1985,709
2020,3,26,11,1225,1293,2034,741
2020,3,26,12,1275,1344,2058,714
2020,3,26,13,1365,1433,2130,697
2020,3,26,14,1430,1503,2215,712
2020,3,26,15,1455,1519,2264,745
2020,3,26,16,1460,1511,2270,759
2020,3,26,17,1445,1495,2221,726
2020,3,26,18,1435,1483,2291,808
2020,3,26,19,1425,1473,2255,782
2020,3,26,20,1410,1470,2246,776
2020,3,26,21,1400,1435,2132,697
2020,3,26,22,1395,1421,2124,703
2020,3,26,23,1395,1404,2050,646
2020,3,27,0,1405,1409,1948,539
2020,3,27,1,1415,1420,2036,616
2020,3,27,2,1435,1453,2072,619
2020,3,27,3,1450,1479,2090,611
2020,3,27,4,1430,1450,2045,595
2020,3,27,5,1335,1381,1987,606
2020,3,27,6,1285,1330,1926,596
2020,3,27,7,1245,1291,1923,632
2020,3,27,8,1225,1282,2035,753
2020,3,27,9,1225,1281,2049,768
2020,3,27,10,1220,1276,1994,718
2020,3,27,11,1250,1293,2082,789
2020,3,27,12,1285,1341,2151,810
2020,3,27,13,1375,1420,2256,836
2020,3,27,14,1440,1468,2216,748
2020,3,27,15,1465,1486,2193,707
2020,3,27,16,1470,1489,2239,750
2020,3,27,17,1450,1474,2186,712
2020,3,27,18,1430,1457,2128,671
2020,3,27,19,1415,1452,2128,676
2020,3,27,20,1400,1412,2008,596
2020,3,27,21,1380,1406,2069,663
2020,3,27,22,1375,1381,2104,723
2020,3,27,23,1385,1379,2069,690
2020,3,28,0,1385,1392,2129,737
2020,3,28,1,1395,1416,2214,798
2020,3,28,2,1420,1426,2152,726
2020,3,28,3,1425,1436,2107,671
2020,3,28,4,1400,1400,2138,738
2020,3,28,5,1315,1364,2070,706
2020,3,28,6,1270,1310,2088,778
2020,3,28,7,1215,1276,2105,829
2020,3,28,8,1200,1254,2141,887
2020,3,28,9,1200,1258,2091,833
2020,3,28,10,1210,1255,2076,821
2020,3,28,11,1225,1265,2105,840
2020,3,28,12,1245,1280,2118,838
2020,3,28,13,1325,1322,2177,855
2020,3,28,14,1385,1363,2184,821
2020,3,28,15,1420,1394,2183,789
2020,3,28,16,1420,1420,2225,805
2020,3,28,17,1420,1432,2258,826
2020,3,28,18,1400,1421,2229,808
2020,3,28,19,1380,1405,2203,798
2020,3,28,20,1365,1369,2172,803
2020,3,28,21,1345,1358,2187,829
2020,3,28,22,1335,1341,2158,817
2020,3,28,23,1335,1354,2164,810
2020,3,29,0,1350,1355,2132,777
2020,3,29,1,1370,1364,2125,761
2020,3,29,2,1385,1372,2137,765
2020,3,29,3,1415,1397,2185,788
2020,3,29,4,1385,1362,2208,846
2020,3,29,5,1325,1319,2139,820
2020,3,29,6,1280,1270,2133,863
2020,3,29,7,1205,1230,2138,908
2020,3,29,8,1190,1218,2142,924
2020,3,29,9,1185,1205,2185,980
2020,3,29,10,1185,1207,2121,914
2020,3,29,11,1195,1216,2134,918
2020,3,29,12,1220,1222,2120,898
2020,3,29,13,1285,1270,2142,872
2020,3,29,14,1340,1297,2051,754
2020,3,29,15,1375,1320,2064,744
2020,3,29,16,1395,1332,2101,769
2020,3,29,17,1410,1342,2195,853
2020,3,29,18,1400,1352,2165,813
2020,3,29,19,1380,1332,2104,772
2020,3,29,20,1360,1313,2080,767
2020,3,29,21,1325,1308,2088,780
2020,3,29,22,1310,1302,2079,777
2020,3,29,23,1315,1318,2100,782
2020,3,30,0,1335,1330,2095,765
2020,3,30,1,1350,1357,2095,738
2020,3,30,2,1370,1379,2127,748
2020,3,30,3,1400,1403,2109,706
2020,3,30,4,1340,1363,2111,748
2020,3,30,5,1305,1300,2104,804
2020,3,30,6,1245,1247,2047,800
2020,3,30,7,1200,1212,2059,847
2020,3,30,8,1190,1197,2120,923
2020,3,30,9,1195,1197,2064,867
2020,3,30,10,1205,1201,2107,906
2020,3,30,11,1220,1197,2183,986
2020,3,30,12,1260,1246,2118,872
2020,3,30,13,1355,1339,2290,951
2020,3,30,14,1445,1409,2191,782
2020,3,30,15,1460,1429,2205,776
2020,3,30,16,1460,1418,2139,721
2020,3,30,17,1445,1421,2010,589
2020,3,30,18,1430,1418,1925,507
2020,3,30,19,1410,1394,1914,520
2020,3,30,20,1390,1377,1909,532
2020,3,30,21,1365,1364,2004,640
2020,3,30,22,1355,1354,2022,668
2020,3,30,23,1355,1341,1969,628
2020,3,31,0,1360,1358,2004,646
2020,3,31,1,1375,1387,2128,741
2020,3,31,2,1395,1401,2162,761
2020,3,31,3,1400,1396,2142,746
2020,3,31,4,1370,1356,2137,781
2020,3,31,5,1300,1321,2186,865
2020,3,31,6,1255,1273,2134,861
2020,3,31,7,1195,1243,2131,888
2020,3,31,8,1185,1210,2051,841
2020,3,31,9,1175,1201,2035,834
2020,3,31,10,1175,1203,2037,834
2020,3,31,11,1195,1216,2052,836
2020,3,31,12,1235,1248,2066,818
2020,3,31,13,1320,1335,2132,797
2020,3,31,14,1385,1413,2197,784
2020,3,31,15,1410,1452,2170,718
2020,3,31,16,1420,1450,2081,631
2020,3,31,17,1405,1484,1980,496
2020,3,31,18,1390,1563,1953,390
2020,3,31,19,1380,1428,1815,387
2020,3,31,20,1365,1420,1804,384
2020,3,31,21,1360,1421,1803,382
2020,3,31,22,1350,1416,1816,400
2020,3,31,23,1355,1436,1811,375
2020,4,1,0,1360,1459,1902,443
2020,4,1,1,1370,1445,1986,541
2020,4,1,2,1390,1454,1994,540
2020,4,1,3,1400,1459,2004,545
2020,4,1,4,1385,1426,1986,560
2020,4,1,5,1290,1363,2043,680
2020,4,1,6,1245,1314,2042,728
2020,4,1,7,1315,1295,2011,716
2020,4,1,8,1290,1285,2084,799
2020,4,1,9,1290,1264,2092,828
2020,4,1,10,1280,1277,2082,805
2020,4,1,11,1310,1279,2058,779
2020,4,1,12,1350,1327,2088,761
2020,4,1,13,1435,1399,2215,816
2020,4,1,14,1485,1486,2259,773
2020,4,1,15,1515,1512,2245,733
2020,4,1,16,1520,1533,2216,683
2020,4,1,17,1505,1514,2192,678
2020,4,1,18,1490,1512,2188,676
2020,4,1,19,1475,1499,2149,650
2020,4,1,20,1460,1491,2138,647
2020,4,1,21,1440,1479,2126,647
2020,4,1,22,1435,1494,2135,641
2020,4,1,23,1440,1492,2135,643
2020,4,2,0,1445,1504,2147,643
2020,4,2,1,1460,1512,2142,630
2020,4,2,2,1480,1521,2195,674
2020,4,2,3,1490,1540,2221,681
2020,4,2,4,1440,1503,2207,704
2020,4,2,5,1375,1439,2183,744
2020,4,2,6,1315,1393,2170,777
2020,4,2,7,1240,1366,2089,723
2020,4,2,8,1235,1350,2040,690
2020,4,2,9,1230,1336,2020,684
2020,4,2,10,1245,1349,2086,737
2020,4,2,11,1260,1359,2026,667
2020,4,2,12,1310,1401,2096,695
2020,4,2,13,1410,1485,2099,614
2020,4,2,14,1475,1539,2075,536
2020,4,2,15,1495,1592,2083,491
2020,4,2,16,1490,1588,2027,439
2020,4,2,17,1480,1562,2018,456
2020,4,2,18,1470,1542,2024,482
2020,4,2,19,1465,1519,2024,505
2020,4,2,20,1460,1490,2061,571
2020,4,2,21,1425,1462,2082,620
2020,4,2,22,1415,1438,2055,617
2020,4,2,23,1405,1441,2037,596
2020,4,3,0,1415,1408,1785,377
2020,4,3,1,1425,1408,1622,214
2020,4,3,2,1445,1405,1628,223
2020,4,3,3,1465,1450,1624,174
2020,4,3,4,1430,1418,1602,184
2020,4,3,5,1370,1357,1656,299
2020,4,3,6,1315,1301,1689,388
2020,4,3,7,1270,1280,1684,404
2020,4,3,8,1260,1275,1662,387
2020,4,3,9,1255,1270,1652,382
2020,4,3,10,1255,1272,1688,416
2020,4,3,11,1265,1293,1755,462
2020,4,3,12,1315,1338,1797,459
2020,4,3,13,1380,1410,1841,431
2020,4,3,14,1435,1470,1978,508
2020,4,3,15,1455,1506,2027,521
2020,4,3,16,1460,1493,2001,508
2020,4,3,17,1445,1482,2007,525
2020,4,3,18,1430,1472,2025,553
2020,4,3,19,1420,1445,2073,628
2020,4,3,20,1390,1417,2037,620
2020,4,3,21,1375,1392,2001,609
2020,4,3,22,1360,1360,1993,633
2020,4,3,23,1355,1374,2015,641
2020,4,4,0,1370,1368,1975,607
2020,4,4,1,1385,1371,1950,579
2020,4,4,2,1400,1363,1913,550
2020,4,4,3,1410,1409,1990,581
2020,4,4,4,1360,1373,1948,575
2020,4,4,5,1330,1323,1947,624
2020,4,4,6,1280,1273,2008,735
2020,4,4,7,1250,1248,1973,725
2020,4,4,8,1230,1243,1995,752
2020,4,4,9,1230,1229,1949,720
2020,4,4,10,1235,1226,2003,777
2020,4,4,11,1240,1240,2014,774
2020,4,4,12,1275,1254,2032,778
2020,4,4,13,1320,1310,2097,787
2020,4,4,14,1370,1332,2063,731
2020,4,4,15,1405,1359,2037,678
2020,4,4,16,1420,1388,2044,656
2020,4,4,17,1425,1381,2071,690
2020,4,4,18,1410,1367,2073,706
2020,4,4,19,1390,1344,2079,735
2020,4,4,20,1360,1319,1998,679
2020,4,4,21,1345,1292,2003,711
2020,4,4,22,1330,1272,2020,748
2020,4,4,23,1340,1282,1983,701
2020,4,5,0,1365,1300,2051,751
2020,4,5,1,1380,1313,2083,770
2020,4,5,2,1350,1318,2066,748
2020,4,5,3,1385,1358,2124,766
2020,4,5,4,1370,1332,2062,730
2020,4,5,5,1300,1286,2042,756
2020,4,5,6,1250,1225,2060,835
2020,4,5,7,1225,1200,2038,838
2020,4,5,8,1215,1187,1975,788
2020,4,5,9,1200,1176,1979,803
2020,4,5,10,1205,1180,1951,771
2020,4,5,11,1215,1182,1933,751
2020,4,5,12,1230,1202,1966,764
2020,4,5,13,1285,1238,1974,736
2020,4,5,14,1325,1272,1969,697
2020,4,5,15,1355,1321,1983,662
2020,4,5,16,1370,1352,1975,623
2020,4,5,17,1370,1347,2006,659
2020,4,5,18,1375,1333,1987,654
2020,4,5,19,1355,1313,1978,665
2020,4,5,20,1330,1283,1970,687
2020,4,5,21,1315,1262,1944,682
2020,4,5,22,1305,1249,1985,736
2020,4,5,23,1320,1257,2002,745
2020,4,6,0,1325,1292,2009,717
2020,4,6,1,1350,1302,2033,731
2020,4,6,2,1365,1299,2035,736
2020,4,6,3,1395,1331,2061,730
2020,4,6,4,1325,1306,1997,691
2020,4,6,5,1290,1244,1952,708
2020,4,6,6,1240,1182,1939,757
2020,4,6,7,1210,1150,1864,714
2020,4,6,8,1195,1138,1806,668
2020,4,6,9,1195,1129,1841,712
2020,4,6,10,1200,1146,1876,730
2020,4,6,11,1205,1154,1950,796
2020,4,6,12,1250,1211,2049,838
2020,4,6,13,1335,1291,2064,773
2020,4,6,14,1405,1357,2043,686
2020,4,6,15,1430,1387,2033,646
2020,4,6,16,1420,1407,2107,700
2020,4,6,17,1420,1392,2081,689
2020,4,6,18,1415,1385,2064,679
2020,4,6,19,1390,1383,2177,794
2020,4,6,20,1370,1347,2149,802
2020,4,6,21,1355,1334,2137,803
2020,4,6,22,1340,1323,2123,800
2020,4,6,23,1330,1329,2089,760
2020,4,7,0,1340,1323,2000,677
2020,4,7,1,1360,1336,2003,667
2020,4,7,2,1370,1314,1967,653
2020,4,7,3,1375,1340,1904,564
2020,4,7,4,1340,1294,1904,610
2020,4,7,5,1290,1233,1857,624
2020,4,7,6,1240,1194,1973,779
2020,4,7,7,1140,1154,1931,777
2020,4,7,8,1120,1144,2032,888
2020,4,7,9,1110,1153,1987,834
2020,4,7,10,1115,1142,1957,815
2020,4,7,11,1120,1163,2052,889
2020,4,7,12,1155,1209,2078,869
2020,4,7,13,1220,1292,2140,848
2020,4,7,14,1275,1339,2078,739
2020,4,7,15,1315,1366,2055,689
2020,4,7,16,1320,1362,2102,740
2020,4,7,17,1310,1367,2130,763
2020,4,7,18,1310,1364,2132,768
2020,4,7,19,1305,1342,2127,785
2020,4,7,20,1290,1327,2128,801
2020,4,7,21,1285,1303,2172,869
2020,4,7,22,1275,1287,2176,889
2020,4,7,23,1290,1287,2146,859
2020,4,8,0,1310,1298,2130,832
2020,4,8,1,1305,1292,2120,828
2020,4,8,2,1310,1305,2115,810
2020,4,8,3,1325,1317,2054,737
2020,4,8,4,1275,1302,2135,833
2020,4,8,5,1225,1228,2044,816
2020,4,8,6,1175,1168,2097,929
2020,4,8,7,1155,1140,2144,1004
2020,4,8,8,1140,1110,1870,760
2020,4,8,9,1130,1117,1855,738
2020,4,8,10,1135,1129,1887,758
2020,4,8,11,1140,1162,1900,738
2020,4,8,12,1180,1199,1910,711
2020,4,8,13,1250,1289,1931,642
2020,4,8,14,1320,1342,1908,566
2020,4,8,15,1350,1376,1902,526
2020,4,8,16,1370,1370,1893,523
2020,4,8,17,1355,1367,1877,510
2020,4,8,18,1350,1350,1910,560
2020,4,8,19,1335,1338,1938,600
2020,4,8,20,1325,1314,1907,593
2020,4,8,21,1310,1286,1964,678
2020,4,8,22,1315,1271,1999,728
2020,4,8,23,1315,1270,1967,697
2020,4,9,0,1335,1278,1950,672
2020,4,9,1,1340,1283,1945,662
2020,4,9,2,1350,1293,1951,658
2020,4,9,3,1370,1326,1945,619
2020,4,9,4,1320,1299,1956,657
2020,4,9,5,1270,1229,1882,653
2020,4,9,6,1220,1176,1890,714
2020,4,9,7,1140,1153,1884,731
2020,4,9,8,1130,1138,1889,751
2020,4,9,9,1120,1145,1842,697
2020,4,9,10,1130,1152,1844,692
2020,4,9,11,1140,1172,1842,670
2020,4,9,12,1180,1216,1879,663
2020,4,9,13,1235,1291,1933,642
2020,4,9,14,1275,1358,1929,571
2020,4,9,15,1315,1373,1896,523
2020,4,9,16,1320,1372,1890,518
2020,4,9,17,1305,1365,1877,512
2020,4,9,18,1290,1352,1865,513
2020,4,9,19,1275,1332,1881,549
2020,4,9,20,1250,1308,1849,541
2020,4,9,21,1230,1285,1872,587
2020,4,9,22,1210,1266,1870,604
2020,4,9,23,1210,1265,1882,617
2020,4,10,0,1205,1273,1895,622
2020,4,10,1,1210,1262,1867,605
2020,4,10,2,1210,1275,1813,538
2020,4,10,3,1245,1309,1885,576
2020,4,10,4,1220,1276,1880,604
2020,4,10,5,1160,1210,1851,641
2020,4,10,6,1110,1161,1906,745
2020,4,10,7,1110,1130,1899,769
2020,4,10,8,1105,1123,1924,801
2020,4,10,9,1100,1122,1893,771
2020,4,10,10,1105,1140,1922,782
2020,4,10,11,1115,1161,1937,776
2020,4,10,12,1155,1191,1966,775
2020,4,10,13,1235,1259,2007,748
2020,4,10,14,1305,1307,2010,703
2020,4,10,15,1335,1331,1985,654
2020,4,10,16,1335,1333,1998,665
2020,4,10,17,1330,1327,2053,726
2020,4,10,18,1315,1328,1996,668
2020,4,10,19,1295,1294,2093,799
2020,4,10,20,1265,1293,2116,823
2020,4,10,21,1250,1259,2087,828
2020,4,10,22,1225,1254,2098,844
2020,4,10,23,1230,1266,2090,824
2020,4,11,0,1235,1270,2080,810
2020,4,11,1,1245,1274,2017,743
2020,4,11,2,1240,1260,1825,565
2020,4,11,3,1275,1275,1806,531
2020,4,11,4,1250,1254,1841,587
2020,4,11,5,1200,1210,1770,560
2020,4,11,6,1145,1159,1677,518
2020,4,11,7,0,1144,1752,608
2020,4,11,8,0,1120,1578,458
2020,4,11,9,0,1118,1564,446
2020,4,11,10,0,1123,1575,452
2020,4,11,11,0,1147,1663,516
2020,4,11,12,0,1175,1743,568
2020,4,11,13,0,1203,1707,504
2020,4,11,14,0,1251,1754,503
2020,4,11,15,0,1311,1736,425
2020,4,11,16,0,1373,1756,383
2020,4,11,17,0,1410,1729,319
2020,4,11,18,0,1419,1858,439
2020,4,11,19,0,1479,1987,508
2020,4,11,20,0,1474,2082,608
2020,4,11,21,0,1468,2091,623
2020,4,11,22,0,1444,2082,638
2020,4,11,23,0,1446,2055,609
2020,4,12,0,0,1466,2080,614
2020,4,12,1,0,1463,2051,588
2020,4,12,2,0,1469,2090,621
2020,4,12,3,0,1486,2170,684
2020,4,12,4,0,1449,2155,706
2020,4,12,5,0,1394,2068,674
2020,4,12,6,0,1335,2096,761
2020,4,12,7,1245,1286,2087,801
2020,4,12,8,1305,1271,2036,765
2020,4,12,9,1285,1265,1913,648
2020,4,12,10,1280,1263,1910,647
2020,4,12,11,1290,1269,1927,658
2020,4,12,12,1300,1281,1953,672
2020,4,12,13,1340,1320,1929,609
2020,4,12,14,1365,1351,1979,628
2020,4,12,15,1385,1406,2025,619
2020,4,12,16,1420,1426,2005,579
2020,4,12,17,1440,1440,2014,574
2020,4,12,18,1435,1430,2006,576
2020,4,12,19,1430,1425,2049,624
2020,4,12,20,1420,1397,2068,671
2020,4,12,21,1385,1376,2024,648
2020,4,12,22,1365,1360,2067,707
2020,4,12,23,1355,1357,2063,706
2020,4,13,0,1365,1357,2026,669
2020,4,13,1,1375,1358,2083,725
2020,4,13,2,1390,1373,2049,676
2020,4,13,3,1380,1426,2049,623
2020,4,13,4,1410,1404,2059,655
2020,4,13,5,1385,1362,2049,687
2020,4,13,6,1300,1314,2048,734
2020,4,13,7,1250,1279,2004,725
2020,4,13,8,1260,1262,1979,717
2020,4,13,9,1235,1269,1996,727
2020,4,13,10,1230,1275,2013,738
2020,4,13,11,1235,1293,2075,782
2020,4,13,12,1240,1336,2078,742
2020,4,13,13,1285,1419,2088,669
2020,4,13,14,1345,1475,2053,578
2020,4,13,15,1385,1503,2083,580
2020,4,13,16,1420,1499,2102,603
2020,4,13,17,1420,1503,2142,639
2020,4,13,18,1410,1496,2121,625
2020,4,13,19,1415,1501,2157,656
2020,4,13,20,1410,1476,2121,645
2020,4,13,21,1390,1448,2098,650
2020,4,13,22,1385,1437,2083,646
2020,4,13,23,1375,1433,2090,657
2020,4,14,0,1390,1430,2108,678
2020,4,14,1,1405,1426,2067,641
2020,4,14,2,1395,1425,2065,640
2020,4,14,3,1405,1459,2050,591
2020,4,14,4,1415,1432,2011,579
2020,4,14,5,1385,1378,2089,711
2020,4,14,6,1305,1322,2066,744
2020,4,14,7,1225,1293,2062,769
2020,4,14,8,1210,1290,2125,835
2020,4,14,9,1215,1292,2135,843
2020,4,14,10,1210,1293,2139,846
2020,4,14,11,1225,1311,2136,825
2020,4,14,12,1260,1349,2146,797
2020,4,14,13,1330,1415,2203,788
2020,4,14,14,1370,1462,2201,739
2020,4,14,15,1400,1486,2211,725
2020,4,14,16,1405,1487,2230,743
2020,4,14,17,1405,1472,2204,732
2020,4,14,18,1405,1467,2176,709
2020,4,14,19,1390,1443,2171,728
2020,4,14,20,1370,1425,2164,739
2020,4,14,21,1350,1419,2124,705
2020,4,14,22,1335,1398,2090,692
2020,4,14,23,1340,1408,2033,625
2020,4,15,0,1350,1399,2051,652
2020,4,15,1,1340,1396,1984,588
2020,4,15,2,1355,1395,1984,589
2020,4,15,3,1375,1413,2061,648
2020,4,15,4,1370,1389,2105,716
2020,4,15,5,1285,1322,1954,632
2020,4,15,6,1230,1259,1933,674
2020,4,15,7,1255,1225,1895,670
2020,4,15,8,1230,1229,1963,734
2020,4,15,9,1230,1231,1964,733
2020,4,15,10,1245,1236,1982,746
2020,4,15,11,1270,1259,2039,780
2020,4,15,12,1315,1329,2072,743
2020,4,15,13,1390,1401,2109,708
2020,4,15,14,1435,1455,1997,542
2020,4,15,15,1470,1466,1904,438
2020,4,15,16,1470,1485,1955,470
2020,4,15,17,1465,1482,1953,471
2020,4,15,18,1450,1498,2135,637
2020,4,15,19,1445,1486,2146,660
2020,4,15,20,1420,1473,2140,667
2020,4,15,21,1390,1462,2137,675
2020,4,15,22,1385,1451,2068,617
2020,4,15,23,1380,1440,1983,543
2020,4,16,0,1390,1444,1906,462
2020,4,16,1,1390,1441,1847,406
2020,4,16,2,1395,1445,1863,418
2020,4,16,3,1430,1446,1902,456
2020,4,16,4,1400,1427,1918,491
2020,4,16,5,1335,1360,1932,572
2020,4,16,6,1275,1306,1962,656
2020,4,16,7,1270,1281,1998,717
2020,4,16,8,1265,1257,1948,691
2020,4,16,9,1265,1251,1920,669
2020,4,16,10,1270,1262,1951,689
2020,4,16,11,1285,1279,1934,655
2020,4,16,12,1325,1329,2002,673
2020,4,16,13,1390,1403,1938,535
2020,4,16,14,1440,1449,1894,445
2020,4,16,15,1470,1443,1897,454
2020,4,16,16,1470,1483,1937,454
2020,4,16,17,1455,1475,1945,470
2020,4,16,18,1445,1467,1946,479
2020,4,16,19,1420,1455,1932,477
2020,4,16,20,1400,1427,1929,502
2020,4,16,21,1395,1410,1958,548
2020,4,16,22,1370,1384,1954,570
2020,4,16,23,1385,1378,1945,567
2020,4,17,0,1370,1366,1997,631
2020,4,17,1,1370,1358,1992,634
2020,4,17,2,1370,1355,1975,620
2020,4,17,3,1390,1386,1951,565
2020,4,17,4,1350,1388,1951,563
2020,4,17,5,1295,1339,1932,593
2020,4,17,6,1240,1283,1983,700
2020,4,17,7,1150,1265,2018,753
2020,4,17,8,1130,1263,2074,811
2020,4,17,9,1130,1258,2048,790
2020,4,17,10,1145,1264,2115,851
2020,4,17,11,1165,1294,2092,798
2020,4,17,12,1215,1337,2123,786
2020,4,17,13,1280,1411,2221,810
2020,4,17,14,1320,1464,2245,781
2020,4,17,15,1350,1462,2230,768
2020,4,17,16,1350,1464,2204,740
2020,4,17,17,1345,1442,2196,754
2020,4,17,18,1335,1424,2196,772
2020,4,17,19,1325,1406,2175,769
2020,4,17,20,1300,1375,2147,772
2020,4,17,21,1275,1353,2146,793
2020,4,17,22,1265,1336,2142,806
2020,4,17,23,1260,1328,2133,805
2020,4,18,0,1265,1307,2139,832
2020,4,18,1,1270,1304,2099,795
2020,4,18,2,1275,1268,2066,798
2020,4,18,3,1305,1309,2110,801
2020,4,18,4,1270,1296,2048,752
2020,4,18,5,1215,1251,1984,733
2020,4,18,6,1160,1196,1965,769
2020,4,18,7,1230,1175,1973,798
2020,4,18,8,1205,1156,1942,786
2020,4,18,9,1200,1147,1832,685
2020,4,18,10,1200,1158,1922,764
2020,4,18,11,1215,1168,1941,773
2020,4,18,12,1240,1185,1984,799
2020,4,18,13,1255,1225,2010,785
2020,4,18,14,1260,1254,1962,708
2020,4,18,15,1310,1282,1950,668
2020,4,18,16,1360,1308,1938,630
2020,4,18,17,1375,1325,2016,691
2020,4,18,18,1375,1324,2006,682
2020,4,18,19,1405,1295,1873,578
2020,4,18,20,1390,1276,1783,507
2020,4,18,21,1385,1259,1780,521
2020,4,18,22,1365,1260,1788,528
2020,4,18,23,1370,1260,1786,526
2020,4,19,0,1385,1277,1713,436
2020,4,19,1,1380,1293,1671,378
2020,4,19,2,1385,1296,1805,509
2020,4,19,3,1405,1323,1780,457
2020,4,19,4,1260,1308,1753,445
2020,4,19,5,1325,1262,1671,409
2020,4,19,6,1270,1213,1707,494
2020,4,19,7,1175,1180,1698,518
2020,4,19,8,1155,1164,1551,387
2020,4,19,9,1150,1145,1543,398
2020,4,19,10,1150,1158,1535,377
2020,4,19,11,1160,1168,1555,387
2020,4,19,12,1180,1183,1507,324
2020,4,19,13,1240,1207,1565,358
2020,4,19,14,1285,1247,1567,320
2020,4,19,15,1325,1275,1532,257
2020,4,19,16,1350,1293,1557,264
2020,4,19,17,1360,1292,1590,298
2020,4,19,18,1350,1290,1562,272
2020,4,19,19,1340,1290,1618,328
2020,4,19,20,1315,1288,1874,586
2020,4,19,21,1295,1254,1918,664
2020,4,19,22,1280,1260,1936,676
2020,4,19,23,1275,1258,1938,680
2020,4,20,0,1275,1283,1953,670
2020,4,20,1,1280,1283,1981,698
2020,4,20,2,1285,1285,2053,768
2020,4,20,3,1295,1303,2066,763
2020,4,20,4,1285,1303,2071,768
2020,4,20,5,1265,1243,2029,786
2020,4,20,6,1220,1182,2001,819
2020,4,20,7,1125,1150,1950,800
2020,4,20,8,1110,1129,1882,753
2020,4,20,9,1110,1130,1906,776
2020,4,20,10,1120,1145,1963,818
2020,4,20,11,1130,1152,1937,785
2020,4,20,12,1175,1198,1970,772
2020,4,20,13,1255,1274,2047,773
2020,4,20,14,1310,1330,2019,689
2020,4,20,15,1335,1352,2059,707
2020,4,20,16,1340,1355,2128,773
2020,4,20,17,1340,1353,2144,791
2020,4,20,18,1335,1347,2103,756
2020,4,20,19,1330,1340,2076,736
2020,4,20,20,1310,1327,2081,754
2020,4,20,21,1285,1315,2085,770
2020,4,20,22,1275,1312,2080,768
2020,4,20,23,1270,1294,2073,779
2020,4,21,0,1265,1300,2059,759
2020,4,21,1,1265,1308,2080,772
2020,4,21,2,1260,1303,2108,805
2020,4,21,3,1290,1322,2037,715
2020,4,21,4,1250,1291,2008,717
2020,4,21,5,1215,1236,1956,720
2020,4,21,6,1170,1167,1895,728
2020,4,21,7,1105,1134,1861,727
2020,4,21,8,1095,1123,1929,806
2020,4,21,9,1095,1102,1798,696
2020,4,21,10,1095,1098,1681,583
2020,4,21,11,1110,1116,1724,608
2020,4,21,12,1150,1169,1882,713
2020,4,21,13,1245,1255,1946,691
2020,4,21,14,1315,1288,1863,575
2020,4,21,15,1340,1314,1912,598
2020,4,21,16,1340,1301,1835,534
2020,4,21,17,1340,1287,1744,457
2020,4,21,18,1340,1302,1851,549
2020,4,21,19,1320,1286,1830,544
2020,4,21,20,1305,1272,1860,588
2020,4,21,21,1285,1251,1839,588
2020,4,21,22,1270,1267,1864,597
2020,4,21,23,1275,1271,1860,589
2020,4,22,0,1280,1267,1874,607
2020,4,22,1,1275,1271,1854,583
2020,4,22,2,1285,1273,1871,598
2020,4,22,3,1300,1293,1836,543
2020,4,22,4,1280,1281,1878,597
2020,4,22,5,1210,1233,1906,673
2020,4,22,6,1155,1173,1932,759
2020,4,22,7,1115,1140,1980,840
2020,4,22,8,1100,1137,1954,817
2020,4,22,9,1100,1114,1828,714
2020,4,22,10,1115,1117,1800,683
2020,4,22,11,1125,1136,1803,667
2020,4,22,12,1175,1185,1960,775
2020,4,22,13,1250,1252,2008,756
2020,4,22,14,1305,1314,2024,710
2020,4,22,15,1325,1328,2052,724
2020,4,22,16,1330,1345,2112,767
2020,4,22,17,1325,1353,2119,766
2020,4,22,18,1325,1339,2060,721
2020,4,22,19,1315,1330,2085,755
2020,4,22,20,1300,1318,2132,814
2020,4,22,21,1285,1317,2141,824
2020,4,22,22,1280,1296,2088,792
2020,4,22,23,1265,1299,2109,810
2020,4,23,0,1270,1321,2116,795
2020,4,23,1,1275,1305,2077,772
2020,4,23,2,1275,1295,2007,712
2020,4,23,3,1295,1315,2016,701
2020,4,23,4,1270,1286,2034,748
2020,4,23,5,1210,1221,2025,804
2020,4,23,6,1150,1150,1862,712
2020,4,23,7,1135,1121,1915,794
2020,4,23,8,1115,1108,1896,788
2020,4,23,9,1110,1089,1854,765
2020,4,23,10,1115,1091,1832,741
2020,4,23,11,1135,1112,1856,744
2020,4,23,12,1180,1151,1851,700
2020,4,23,13,1255,1207,1870,663
2020,4,23,14,1305,1269,1920,651
2020,4,23,15,1310,1308,1724,416
2020,4,23,16,1330,1315,1701,386
2020,4,23,17,1320,1328,1730,402
2020,4,23,18,1315,1329,1685,356
2020,4,23,19,1300,1310,1678,368
2020,4,23,20,1280,1307,1709,402
2020,4,23,21,1095,1300,1794,494
2020,4,23,22,1250,1290,1841,551
2020,4,23,23,1245,1303,1824,521
2020,4,24,0,1230,1298,1847,549
2020,4,24,1,1225,1293,1875,582
2020,4,24,2,1225,1291,1998,707
2020,4,24,3,1255,1308,1997,689
2020,4,24,4,1220,1291,1853,562
2020,4,24,5,1195,1237,1753,516
2020,4,24,6,1150,1198,1825,627
2020,4,24,7,1135,1169,1898,729
2020,4,24,8,1130,1160,1975,815
2020,4,24,9,1125,1135,1946,811
2020,4,24,10,1130,1126,1900,774
2020,4,24,11,1155,1144,1960,816
2020,4,24,12,1195,1180,2033,853
2020,4,24,13,1275,1242,2058,816
2020,4,24,14,1340,1295,2111,816
2020,4,24,15,1345,1321,2011,690
2020,4,24,16,1350,1329,2002,673
2020,4,24,17,1340,1328,2050,722
2020,4,24,18,1325,1323,1990,667
2020,4,24,19,1305,1318,2042,724
2020,4,24,20,1285,1282,1977,695
2020,4,24,21,1270,1267,1968,701
2020,4,24,22,1250,1255,1936,681
2020,4,24,23,1250,1262,1940,678
2020,4,25,0,1240,1263,1927,664
2020,4,25,1,1235,1264,2016,752
2020,4,25,2,1210,1269,2021,752
2020,4,25,3,1245,1284,2011,727
2020,4,25,4,1200,1287,2015,728
2020,4,25,5,1175,1225,2010,785
2020,4,25,6,1120,1175,1958,783
2020,4,25,7,1140,1148,1953,805
2020,4,25,8,1125,1122,1964,842
2020,4,25,9,1115,1120,1925,805
2020,4,25,10,1125,1115,1950,835
2020,4,25,11,1135,1117,1942,825
2020,4,25,12,1155,1143,1962,819
2020,4,25,13,1175,1166,2014,848
2020,4,25,14,1190,1206,1968,762
2020,4,25,15,1225,1244,1950,706
2020,4,25,16,1250,1260,2020,760
2020,4,25,17,1270,1261,2089,828
2020,4,25,18,1270,1264,2145,881
2020,4,25,19,1255,1245,2028,783
2020,4,25,20,1245,1251,2029,778
2020,4,25,21,1230,1246,2005,759
2020,4,25,22,1225,1229,2020,791
2020,4,25,23,1230,1246,2022,776
2020,4,26,0,1245,1266,2018,752
2020,4,26,1,1250,1274,2041,767
2020,4,26,2,1250,1277,2042,765
2020,4,26,3,1270,1286,2057,771
2020,4,26,4,1190,1274,1972,698
2020,4,26,5,1205,1230,2033,803
2020,4,26,6,1150,1166,1949,783
2020,4,26,7,1135,1135,1867,732
2020,4,26,8,1120,1099,1743,644
2020,4,26,9,1105,1091,1641,550
2020,4,26,10,1115,1085,1676,591
2020,4,26,11,1125,1080,1539,459
2020,4,26,12,1150,1082,1536,454
2020,4,26,13,1175,1112,1625,513
2020,4,26,14,1210,1142,1618,476
2020,4,26,15,1250,1197,1670,473
2020,4,26,16,1260,1222,1651,429
2020,4,26,17,1275,1243,1609,366
2020,4,26,18,1275,1241,1569,328
2020,4,26,19,1265,1233,1623,390
2020,4,26,20,1260,1213,1624,411
2020,4,26,21,1230,1197,1560,363
2020,4,26,22,1230,1204,1544,340
2020,4,26,23,1230,1212,1570,358
2020,4,27,0,1245,1249,1711,462
2020,4,27,1,1250,1264,1858,594
2020,4,27,2,1250,1256,1829,573
2020,4,27,3,1270,1278,1861,583
2020,4,27,4,1210,1284,2045,761
2020,4,27,5,1210,1214,1937,723
2020,4,27,6,1150,1142,1811,669
2020,4,27,7,1120,1090,1574,484
2020,4,27,8,1105,1081,1454,373
2020,4,27,9,1100,1070,1388,318
2020,4,27,10,1115,1071,1378,307
2020,4,27,11,1120,1085,1420,335
2020,4,27,12,1165,1117,1437,320
2020,4,27,13,1230,1206,1534,328
2020,4,27,14,1280,1289,1572,283
2020,4,27,15,1305,1308,1497,189
2020,4,27,16,1305,1334,1500,166
2020,4,27,17,1310,1364,1501,137
2020,4,27,18,1305,1360,1690,330
2020,4,27,19,1295,1377,1759,382
2020,4,27,20,1285,1347,1694,347
2020,4,27,21,1270,1333,1685,352
2020,4,27,22,1265,1316,1679,363
2020,4,27,23,1255,1294,1604,310
2020,4,28,0,1260,1301,1695,394
2020,4,28,1,1260,1302,1618,316
2020,4,28,2,1260,1288,1637,349
2020,4,28,3,1280,1301,1747,446
2020,4,28,4,1280,1284,1779,495
2020,4,28,5,1200,1227,1789,562
2020,4,28,6,1140,1190,1907,717
2020,4,28,7,1115,1139,1924,785
2020,4,28,8,1090,1112,1736,624
2020,4,28,9,1085,1107,1726,619
2020,4,28,10,1080,1099,1852,753
2020,4,28,11,1085,1128,1920,792
2020,4,28,12,1105,1182,1954,772
2020,4,28,13,1170,1240,1944,704
2020,4,28,14,1225,1302,1866,564
2020,4,28,15,1265,1307,1866,559
2020,4,28,16,1280,1317,1945,628
2020,4,28,17,1285,1314,1877,563
2020,4,28,18,1290,1302,1946,644
2020,4,28,19,1275,1299,1965,666
2020,4,28,20,1260,1298,1969,671
2020,4,28,21,1240,1259,1861,602
2020,4,28,22,1250,1267,1834,567
2020,4,28,23,1255,1276,1833,557
2020,4,29,0,1270,1270,1917,647
2020,4,29,1,1280,1266,1881,615
2020,4,29,2,1280,1275,1994,719
2020,4,29,3,1295,1287,1995,708
2020,4,29,4,1225,1297,2004,707
2020,4,29,5,1225,1225,2029,804
2020,4,29,6,1155,1169,2045,876
2020,4,29,7,1095,1137,2054,917
2020,4,29,8,1095,1121,1874,753
2020,4,29,9,1080,1093,1618,525
2020,4,29,10,1085,1095,1622,527
2020,4,29,11,1100,1107,1657,550
2020,4,29,12,1145,1159,1889,730
2020,4,29,13,1200,1231,2034,803
2020,4,29,14,1250,1281,2015,734
2020,4,29,15,1265,1299,2005,706
2020,4,29,16,1285,1291,1977,686
2020,4,29,17,1295,1264,1865,601
2020,4,29,18,1285,1316,1991,675
2020,4,29,19,1285,1317,1978,661
2020,4,29,20,1270,1311,1952,641
2020,4,29,21,1265,1323,1948,625
2020,4,29,22,1250,1318,1864,546
2020,4,29,23,1245,1328,1868,540
2020,4,30,0,1260,1332,1977,645
2020,4,30,1,1250,1321,1945,624
2020,4,30,2,1245,1314,1940,626
2020,4,30,3,1255,1323,1937,614
2020,4,30,4,1250,1300,1789,489
2020,4,30,5,1175,1225,1787,562
2020,4,30,6,1110,1158,1654,496
2020,4,30,7,1110,1103,1482,379
2020,4,30,8,1095,1089,1501,412
2020,4,30,9,1080,1090,1583,493
2020,4,30,10,1085,1087,1619,532
2020,4,30,11,1100,1102,1550,448
2020,4,30,12,1140,1120,1658,538
2020,4,30,13,1185,1179,1670,491
2020,4,30,14,1230,1230,1684,454
2020,4,30,15,1255,1278,1597,319
2020,4,30,16,1275,1289,1475,186
2020,4,30,17,1290,1316,1490,174
2020,4,30,18,1285,1309,1399,90
2020,4,30,19,1270,1329,1384,55
2020,4,30,20,1265,1341,1493,152
2020,4,30,21,1255,1333,1473,140
2020,4,30,22,1245,1342,1501,159
2020,4,30,23,1250,1342,1477,135
2020,5,1,0,1245,1332,1526,194
2020,5,1,1,1240,1317,1590,273
2020,5,1,2,1235,1324,1716,392
2020,5,1,3,1255,1328,1641,313
2020,5,1,4,1230,1305,1603,298
2020,5,1,5,1190,1238,1763,525
2020,5,1,6,1150,1203,2040,837
2020,5,1,7,1115,1161,2042,881
2020,5,1,8,1100,1112,1768,656
2020,5,1,9,1085,1096,1681,585
2020,5,1,10,1085,1102,1689,587
2020,5,1,11,1105,1101,1785,684
2020,5,1,12,1145,1142,1892,750
2020,5,1,13,1220,1207,2120,913
2020,5,1,14,1280,1255,2023,768
2020,5,1,15,1300,1293,2084,791
2020,5,1,16,1295,1290,2041,751
2020,5,1,17,1285,1297,1943,646
2020,5,1,18,1300,1292,1915,623
2020,5,1,19,1295,1286,1851,565
2020,5,1,20,1280,1276,1917,641
2020,5,1,21,1275,1270,1943,673
2020,5,1,22,1270,1267,1935,668
2020,5,1,23,1275,1260,1882,622
2020,5,2,0,1265,1257,1886,629
2020,5,2,1,1260,1261,2043,782
2020,5,2,2,1255,1248,2009,761
2020,5,2,3,1270,1263,2016,753
2020,5,2,4,1280,1265,1951,686
2020,5,2,5,1195,1228,1974,746
2020,5,2,6,1140,1168,2017,849
2020,5,2,7,1095,1123,1942,819
2020,5,2,8,1075,1123,1998,875
2020,5,2,9,1070,1112,2000,888
2020,5,2,10,1070,1111,1995,884
2020,5,2,11,1075,1122,2001,879
2020,5,2,12,1100,1137,2014,877
2020,5,2,13,1140,1156,1881,725
2020,5,2,14,1185,1176,1610,434
2020,5,2,15,1220,1214,1716,502
2020,5,2,16,1235,1227,1700,473
2020,5,2,17,1245,1236,1690,454
2020,5,2,18,1245,1240,1735,495
2020,5,2,19,1235,1232,1633,401
2020,5,2,20,1230,1213,1641,428
2020,5,2,21,1220,1220,1706,486
2020,5,2,22,1205,1214,1723,509
2020,5,2,23,1215,1226,1692,466
2020,5,3,0,1230,1237,1680,443
2020,5,3,1,1240,1245,1669,424
2020,5,3,2,1235,1234,1589,355
2020,5,3,3,1210,1235,1467,232
2020,5,3,4,1185,1249,1419,170
2020,5,3,5,1190,1197,1373,176
2020,5,3,6,1135,1150,1259,109
2020,5,3,7,1120,1123,1065,-58
2020,5,3,8,1095,1101,1154,53
2020,5,3,9,1085,1092,1030,-62
2020,5,3,10,1085,1087,1000,-87
2020,5,3,11,1085,1084,1005,-79
2020,5,3,12,1100,1094,1004,-90
2020,5,3,13,1135,1108,989,-119
2020,5,3,14,1170,1142,986,-156
2020,5,3,15,1210,1187,990,-197
2020,5,3,16,1230,1237,1069,-168
2020,5,3,17,1240,1258,1124,-134
2020,5,3,18,1250,1286,1138,-148
2020,5,3,19,1245,1285,1171,-114
2020,5,3,20,1230,1300,1251,-49
2020,5,3,21,1215,1265,1180,-85
2020,5,3,22,1220,1253,1221,-32
2020,5,3,23,1230,1265,1292,27
2020,5,4,0,1255,1274,1241,-33
2020,5,4,1,1255,1274,1242,-32
2020,5,4,2,1255,1271,1206,-65
2020,5,4,3,1240,1274,1229,-45
2020,5,4,4,1170,1278,1257,-21
2020,5,4,5,1200,1219,1240,21
2020,5,4,6,1130,1155,1232,77
2020,5,4,7,1120,1123,1211,88
2020,5,4,8,1110,1104,1234,130
2020,5,4,9,1100,1095,1223,128
2020,5,4,10,1105,1105,1252,147
2020,5,4,11,1120,1127,1266,139
2020,5,4,12,1150,1174,1263,89
2020,5,4,13,1215,1256,1322,66
2020,5,4,14,1270,1341,1272,-69
2020,5,4,15,1300,1355,1339,-16
2020,5,4,16,1315,1352,1387,35
2020,5,4,17,1340,1358,1430,72
2020,5,4,18,1335,1354,1501,147
2020,5,4,19,1350,1335,1496,161
2020,5,4,20,1330,1342,1498,156
2020,5,4,21,1320,1319,1482,163
2020,5,4,22,1310,1307,1458,151
2020,5,4,23,1295,1303,1468,165
2020,5,5,0,1295,1317,1490,173
2020,5,5,1,1295,1320,1494,174
2020,5,5,2,1285,1292,1446,154
2020,5,5,3,1295,1275,1369,94
2020,5,5,4,1270,1269,1351,82
2020,5,5,5,1215,1215,1271,56
2020,5,5,6,1175,1141,1196,55
2020,5,5,7,1125,1106,1166,60
2020,5,5,8,1105,1094,1159,65
2020,5,5,9,1100,1099,1168,69
2020,5,5,10,1090,1103,1167,64
2020,5,5,11,1110,1118,1165,47
2020,5,5,12,1155,1170,1154,-16
2020,5,5,13,1215,1215,1137,-78
2020,5,5,14,1280,1285,1159,-126
2020,5,5,15,1290,1287,1171,-116
2020,5,5,16,1305,1274,1211,-63
2020,5,5,17,1305,1240,1189,-51
2020,5,5,18,1305,1268,1234,-34
2020,5,5,19,1300,1260,1235,-25
2020,5,5,20,1300,1292,1250,-42
2020,5,5,21,1265,1269,1232,-37
2020,5,5,22,1270,1272,1220,-52
2020,5,5,23,1280,1277,1211,-66
2020,5,6,0,1275,1271,1171,-100
2020,5,6,1,1275,1258,1158,-100
2020,5,6,2,1275,1246,1186,-60
2020,5,6,3,1285,1261,1253,-8
2020,5,6,4,1280,1268,1311,43
2020,5,6,5,1225,1214,1278,64
2020,5,6,6,1170,1142,1235,93
2020,5,6,7,1120,1111,1191,80
2020,5,6,8,1110,1078,1095,17
2020,5,6,9,1090,1067,1061,-6
2020,5,6,10,1095,1079,1077,-2
2020,5,6,11,1110,1087,1037,-50
2020,5,6,12,1160,1132,1061,-71
2020,5,6,13,1240,1201,1065,-136
2020,5,6,14,1310,1263,1065,-198
2020,5,6,15,1325,1317,1070,-247
2020,5,6,16,1320,1306,1135,-171
2020,5,6,17,1310,1364,1117,-247
2020,5,6,18,1335,1378,1132,-246
2020,5,6,19,1335,1335,1161,-174
2020,5,6,20,1330,1323,1097,-226
2020,5,6,21,1335,1302,1017,-285
2020,5,6,22,1325,1318,1009,-309
2020,5,6,23,1335,1331,1046,-285
2020,5,7,0,1340,1353,1153,-200
2020,5,7,1,1330,1343,1234,-109
2020,5,7,2,1320,1326,1252,-74
2020,5,7,3,1325,1334,1370,36
2020,5,7,4,1310,1322,1473,151
2020,5,7,5,1235,1259,1421,162
2020,5,7,6,1165,1190,1390,200
2020,5,7,7,1110,1154,1408,254
2020,5,7,8,1095,1145,1464,319
2020,5,7,9,1095,1146,1488,342
2020,5,7,10,1090,1148,1476,328
2020,5,7,11,1105,1166,1475,309
2020,5,7,12,1135,1197,1443,246
2020,5,7,13,1185,1281,1436,155
2020,5,7,14,1235,1341,1366,25
2020,5,7,15,1270,1379,1376,-3
2020,5,7,16,1275,1390,1418,28
2020,5,7,17,1295,1402,1394,-8
2020,5,7,18,1310,1398,1373,-25
2020,5,7,19,1300,1376,1328,-48
2020,5,7,20,1315,1349,1241,-108
2020,5,7,21,1305,1335,1217,-118
2020,5,7,22,1305,1307,1166,-141
2020,5,7,23,1310,1306,1135,-171
2020,5,8,0,1300,1289,1117,-172
2020,5,8,1,1290,1271,1125,-146
2020,5,8,2,1285,1275,1131,-144
2020,5,8,3,1290,1278,1151,-127
2020,5,8,4,1235,1288,1153,-135
2020,5,8,5,1215,1232,1153,-79
2020,5,8,6,1170,1135,1116,-19
2020,5,8,7,1155,1138,1140,2
2020,5,8,8,1120,1118,1078,-40
2020,5,8,9,1105,1121,1073,-48
2020,5,8,10,1110,1125,1073,-52
2020,5,8,11,1115,1138,1096,-42
2020,5,8,12,1155,1173,1123,-50
2020,5,8,13,1220,1251,1141,-110
2020,5,8,14,1270,1307,1160,-147
2020,5,8,15,1310,1341,1198,-143
2020,5,8,16,1310,1343,1180,-163
2020,5,8,17,1325,1364,1199,-165
2020,5,8,18,1325,1375,1217,-158
2020,5,8,19,1310,1364,1253,-111
2020,5,8,20,1295,1348,1224,-124
2020,5,8,21,1285,1346,1322,-24
2020,5,8,22,1285,1332,1257,-75
2020,5,8,23,1290,1325,1288,-37
2020,5,9,0,1285,1324,1314,-10
2020,5,9,1,1285,1303,1341,38
2020,5,9,2,1270,1285,1337,52
2020,5,9,3,1285,1291,1345,54
2020,5,9,4,1270,1299,1370,71
2020,5,9,5,1225,1243,1323,80
2020,5,9,6,1165,1194,1315,121
2020,5,9,7,1105,1152,1322,170
2020,5,9,8,1100,1134,1252,118
2020,5,9,9,1095,1125,1224,99
2020,5,9,10,1090,1123,1165,42
2020,5,9,11,1100,1134,1135,1
2020,5,9,12,1120,1155,1115,-40
2020,5,9,13,1180,1166,1058,-108
2020,5,9,14,1235,1220,1049,-171
2020,5,9,15,1275,1256,1036,-220
2020,5,9,16,1290,1288,1044,-244
2020,5,9,17,1300,1284,1050,-234
2020,5,9,18,1300,1272,1042,-230
2020,5,9,19,1290,1261,1027,-234
2020,5,9,20,1270,1240,1028,-212
2020,5,9,21,1270,1224,1030,-194
2020,5,9,22,1260,1221,1060,-161
2020,5,9,23,1270,1232,1089,-143
2020,5,10,0,1280,1236,1133,-103
2020,5,10,1,1285,1254,1129,-125
2020,5,10,2,1275,1238,1148,-90
2020,5,10,3,1280,1255,1065,-190
2020,5,10,4,1235,1284,1084,-200
2020,5,10,5,1220,1231,1111,-120
2020,5,10,6,1180,1180,1094,-86
2020,5,10,7,1130,1132,1089,-43
2020,5,10,8,1110,1117,1061,-56
2020,5,10,9,1105,1110,1016,-94
2020,5,10,10,1100,1123,1013,-110
2020,5,10,11,1100,1126,1027,-99
2020,5,10,12,1115,1142,1028,-114
2020,5,10,13,1150,1157,1041,-116
2020,5,10,14,1195,1214,1053,-161
2020,5,10,15,1240,1261,1067,-194
2020,5,10,16,1280,1296,1081,-215
2020,5,10,17,1305,1300,1102,-198
2020,5,10,18,1320,1298,1123,-175
2020,5,10,19,1315,1287,1127,-160
2020,5,10,20,1315,1268,1133,-135
2020,5,10,21,1285,1261,1157,-104
2020,5,10,22,1275,1267,1167,-100
2020,5,10,23,1285,1284,1189,-95
2020,5,11,0,1290,1276,1347,71
2020,5,11,1,1290,1272,1408,136
2020,5,11,2,1290,1281,1518,237
2020,5,11,3,1295,1314,1827,513
2020,5,11,4,1270,1321,1995,674
2020,5,11,5,1240,1279,2112,833
2020,5,11,6,1165,1216,2051,835
2020,5,11,7,1155,1165,1784,619
2020,5,11,8,1140,1167,1686,519
2020,5,11,9,1130,1150,1631,481
2020,5,11,10,1140,1133,1588,455
2020,5,11,11,1160,1147,1560,413
2020,5,11,12,1200,1168,1430,262
2020,5,11,13,1285,1218,1262,44
2020,5,11,14,1365,1304,1214,-90
2020,5,11,15,1385,1364,1187,-177
2020,5,11,16,1390,1397,1158,-239
2020,5,11,17,1400,1409,1180,-229
2020,5,11,18,1395,1411,1199,-212
2020,5,11,19,1380,1403,1281,-122
2020,5,11,20,1375,1374,1418,44
2020,5,11,21,1355,1364,1463,99
2020,5,11,22,1340,1355,1487,132
2020,5,11,23,1335,1359,1506,147
2020,5,12,0,1315,1365,1502,137
2020,5,12,1,1315,1347,1509,162
2020,5,12,2,1295,1345,1525,180
2020,5,12,3,1285,1343,1520,177
2020,5,12,4,1260,1325,1512,187
2020,5,12,5,1225,1253,1458,205
2020,5,12,6,1175,1179,1464,285
2020,5,12,7,1140,1152,1390,238
2020,5,12,8,1125,1127,1230,103
2020,5,12,9,1125,1131,1180,49
2020,5,12,10,1130,1123,1155,32
2020,5,12,11,1145,1137,1140,3
2020,5,12,12,1195,1188,1227,39
2020,5,12,13,1275,1260,1268,8
2020,5,12,14,1385,1323,1183,-140
2020,5,12,15,1400,1371,1179,-192
2020,5,12,16,1395,1375,1158,-217
2020,5,12,17,1370,1384,1149,-235
2020,5,12,18,1390,1385,1315,-70
2020,5,12,19,1380,1385,1416,31
2020,5,12,20,1400,1364,1383,19
2020,5,12,21,1375,1352,1418,66
2020,5,12,22,1380,1329,1374,45
2020,5,12,23,1390,1336,1347,11
2020,5,13,0,1380,1332,1375,43
2020,5,13,1,1370,1322,1332,10
2020,5,13,2,1365,1301,1324,23
2020,5,13,3,1385,1304,1341,37
2020,5,13,4,1385,1285,1266,-19
2020,5,13,5,1330,1219,1142,-77
2020,5,13,6,1260,1147,1174,27
2020,5,13,7,1155,1109,1093,-16
2020,5,13,8,1135,1105,1073,-32
2020,5,13,9,1120,1088,976,-112
2020,5,13,10,1125,1088,992,-96
2020,5,13,11,1135,1113,1007,-106
2020,5,13,12,1175,1143,1032,-111
2020,5,13,13,1210,1209,1117,-92
2020,5,13,14,1250,1265,1157,-108
2020,5,13,15,1300,1308,1197,-111
2020,5,13,16,1300,1320,1155,-165
2020,5,13,17,1335,1306,1191,-115
2020,5,13,18,1345,1321,1265,-56
2020,5,13,19,1320,1329,1259,-70
2020,5,13,20,1305,1300,1257,-43
2020,5,13,21,1295,1291,1274,-17
2020,5,13,22,1300,1287,1285,-2
2020,5,13,23,1310,1285,1386,101
2020,5,14,0,1325,1277,1323,46
2020,5,14,1,1310,1271,1347,76
2020,5,14,2,1300,1261,1213,-48
2020,5,14,3,1305,1257,1265,8
2020,5,14,4,1250,1257,1179,-78
2020,5,14,5,1225,1204,1149,-55
2020,5,14,6,1160,1150,1274,124
2020,5,14,7,1100,1110,1197,87
2020,5,14,8,1085,1093,1202,109
2020,5,14,9,1085,1094,1178,84
2020,5,14,10,1085,1095,1187,92
2020,5,14,11,1100,1115,1200,85
2020,5,14,12,1135,1155,1235,80
2020,5,14,13,1210,1207,1282,75
2020,5,14,14,1275,1277,1249,-28
2020,5,14,15,1315,1299,1293,-6
2020,5,14,16,1325,1312,1226,-86
2020,5,14,17,1340,1299,1368,69
2020,5,14,18,1335,1288,1420,132
2020,5,14,19,1325,1284,1470,186
2020,5,14,20,1305,1290,1503,213
2020,5,14,21,1295,1264,1443,179
2020,5,14,22,1275,1262,1414,152
2020,5,14,23,1275,1264,1382,118
2020,5,15,0,1260,1258,1369,111
2020,5,15,1,1245,1237,1269,32
2020,5,15,2,1245,1222,1208,-14
2020,5,15,3,1250,1217,1224,7
2020,5,15,4,1225,1234,1384,150
2020,5,15,5,1190,1169,1226,57
2020,5,15,6,1110,1116,1205,89
2020,5,15,7,1115,1086,1109,23
2020,5,15,8,1095,1066,1047,-19
2020,5,15,9,1090,1068,1002,-66
2020,5,15,10,1095,1069,1016,-53
2020,5,15,11,1110,1077,1043,-34
2020,5,15,12,1140,1114,1094,-20
2020,5,15,13,1235,1184,1122,-62
2020,5,15,14,1315,1242,1076,-166
2020,5,15,15,1350,1285,1110,-175
2020,5,15,16,1355,1303,1047,-256
2020,5,15,17,1365,1324,1044,-280
2020,5,15,18,1375,1336,1091,-245
2020,5,15,19,1365,1345,1268,-77
2020,5,15,20,1350,1332,1255,-77
2020,5,15,21,1345,1318,1326,8
2020,5,15,22,1335,1305,1291,-14
2020,5,15,23,1330,1308,1276,-32
2020,5,16,0,1325,1301,1399,98
2020,5,16,1,1310,1269,1531,262
2020,5,16,2,1295,1254,1531,277
2020,5,16,3,1300,1256,1632,376
2020,5,16,4,1290,1258,1630,372
2020,5,16,5,1255,1231,1774,543
2020,5,16,6,1200,1179,1968,789
2020,5,16,7,1085,1134,1951,817
2020,5,16,8,1070,1112,1634,522
2020,5,16,9,1060,1097,1569,472
2020,5,16,10,1060,1097,1536,439
2020,5,16,11,1075,1081,1290,209
2020,5,16,12,1095,1101,1276,175
2020,5,16,13,1130,1118,1253,135
2020,5,16,14,1190,1164,1227,63
2020,5,16,15,1225,1221,1230,9
2020,5,16,16,1250,1251,1235,-16
2020,5,16,17,1245,1260,1234,-26
2020,5,16,18,1235,1230,1230,0
2020,5,16,19,1225,1226,1235,9
2020,5,16,20,1210,1203,1323,120
2020,5,16,21,1195,1195,1285,90
2020,5,16,22,1195,1201,1344,143
2020,5,16,23,1205,1204,1363,159
2020,5,17,0,1205,1216,1386,170
2020,5,17,1,1215,1222,1635,413
2020,5,17,2,1200,1207,1663,456
2020,5,17,3,1210,1200,1646,446
2020,5,17,4,1190,1211,1623,412
2020,5,17,5,1180,1185,1583,398
2020,5,17,6,1130,1120,1645,525
2020,5,17,7,1070,1077,1559,482
2020,5,17,8,1055,1062,1518,456
2020,5,17,9,1050,1052,1501,449
2020,5,17,10,1060,1049,1317,268
2020,5,17,11,1065,1044,1245,201
2020,5,17,12,1080,1060,1249,189
2020,5,17,13,1100,1077,1233,156
2020,5,17,14,1145,1122,1211,89
2020,5,17,15,1185,1192,1230,38
2020,5,17,16,1215,1230,1224,-6
2020,5,17,17,1220,1261,1244,-17
2020,5,17,18,1220,1251,1237,-14
2020,5,17,19,1210,1261,1299,38
2020,5,17,20,1205,1246,1117,-129
2020,5,17,21,1190,1262,1000,-262
2020,5,17,22,1190,1270,1005,-265
2020,5,17,23,1205,1281,1053,-228
2020,5,18,0,1195,1293,1063,-230
2020,5,18,1,1190,1308,1045,-263
2020,5,18,2,1190,1290,1035,-255
2020,5,18,3,1210,1293,1031,-262
2020,5,18,4,1175,1299,1018,-281
2020,5,18,5,1165,1242,1024,-218
2020,5,18,6,1110,1162,1026,-136
2020,5,18,7,1080,1116,970,-146
2020,5,18,8,1075,1102,954,-148
2020,5,18,9,1065,1096,971,-125
2020,5,18,10,1055,1094,955,-139
2020,5,18,11,1070,1098,952,-146
2020,5,18,12,1100,1120,976,-144
2020,5,18,13,1145,1184,976,-208
2020,5,18,14,1220,1262,1138,-124
2020,5,18,15,1260,1297,1116,-181
2020,5,18,16,1285,1328,1124,-204
2020,5,18,17,1290,1355,1136,-219
2020,5,18,18,1280,1362,1168,-194
2020,5,18,19,1280,1373,1184,-189
2020,5,18,20,1265,1365,1188,-177
2020,5,18,21,1250,1366,1202,-164
2020,5,18,22,1240,1356,1145,-211
2020,5,18,23,1240,1370,1119,-251
2020,5,19,0,1245,1355,1122,-233
2020,5,19,1,1235,1360,1147,-213
2020,5,19,2,1220,1329,1156,-173
2020,5,19,3,1215,1315,1135,-180
2020,5,19,4,1190,1302,1069,-233
2020,5,19,5,1145,1239,1071,-168
2020,5,19,6,1080,1164,1080,-84
2020,5,19,7,1110,1125,1104,-21
2020,5,19,8,1090,1104,1160,56
2020,5,19,9,1090,1075,1174,99
2020,5,19,10,1085,1086,1181,95
2020,5,19,11,1095,1092,1177,85
2020,5,19,12,1140,1129,1119,-10
2020,5,19,13,1200,1188,1055,-133
2020,5,19,14,1270,1253,1073,-180
2020,5,19,15,1315,1294,1004,-290
2020,5,19,16,1320,1306,956,-350
2020,5,19,17,1330,1320,971,-349
2020,5,19,18,1335,1328,961,-367
2020,5,19,19,1335,1343,959,-384
2020,5,19,20,1325,1331,1003,-328
2020,5,19,21,1315,1353,1027,-326
2020,5,19,22,1300,1353,1042,-311
2020,5,19,23,1310,1377,1060,-317
2020,5,20,0,1310,1378,1110,-268
2020,5,20,1,1305,1377,1099,-278
2020,5,20,2,1285,1350,1096,-254
2020,5,20,3,1290,1345,1176,-169
2020,5,20,4,1270,1318,1171,-147
2020,5,20,5,1215,1251,1180,-71
2020,5,20,6,1145,1180,1176,-4
2020,5,20,7,1110,1141,1150,9
2020,5,20,8,1095,1120,1135,15
2020,5,20,9,1085,1098,1110,12
2020,5,20,10,1085,1100,1107,7
2020,5,20,11,1105,1111,1101,-10
2020,5,20,12,1135,1141,1082,-59
2020,5,20,13,1200,1207,1073,-134
2020,5,20,14,1255,1268,1086,-182
2020,5,20,15,1300,1311,1124,-187
2020,5,20,16,1315,1336,1092,-244
2020,5,20,17,1315,1353,1099,-254
2020,5,20,18,1330,1363,1110,-253
2020,5,20,19,1330,1359,1099,-260
2020,5,20,20,1310,1349,1094,-255
2020,5,20,21,1300,1351,1173,-178
2020,5,20,22,1295,1372,1216,-156
2020,5,20,23,1300,1371,1317,-54
2020,5,21,0,1295,1338,1311,-27
2020,5,21,1,1290,1320,1122,-198
2020,5,21,2,1275,1290,1041,-249
2020,5,21,3,1270,1281,1029,-252
2020,5,21,4,1255,1282,1058,-224
2020,5,21,5,1210,1221,1104,-117
2020,5,21,6,1150,1150,1130,-20
2020,5,21,7,1110,1118,1215,97
2020,5,21,8,1090,1100,1202,102
2020,5,21,9,1090,1099,1250,151
2020,5,21,10,1095,1089,1227,138
2020,5,21,11,1110,1105,1205,100
2020,5,21,12,1150,1136,1234,98
2020,5,21,13,1200,1213,1259,46
2020,5,21,14,1270,1289,1251,-38
2020,5,21,15,1295,1319,1317,-2
2020,5,21,16,1310,1345,1316,-29
2020,5,21,17,1305,1365,1327,-38
2020,5,21,18,1295,1369,1332,-37
2020,5,21,19,1295,1385,1327,-58
2020,5,21,20,1290,1365,1321,-44
2020,5,21,21,1275,1355,1324,-31
2020,5,21,22,1275,1352,1317,-35
2020,5,21,23,1275,1348,1316,-32
2020,5,22,0,1275,1352,1299,-53
2020,5,22,1,1255,1352,1296,-56
2020,5,22,2,1240,1333,1275,-58
2020,5,22,3,1240,1327,1241,-86
2020,5,22,4,1220,1323,1119,-204
2020,5,22,5,1180,1274,1109,-165
2020,5,22,6,1120,1212,1051,-161
2020,5,22,7,1120,1179,1042,-137
2020,5,22,8,1105,1165,1044,-121
2020,5,22,9,1100,1148,1084,-64
2020,5,22,10,1100,1144,1077,-67
2020,5,22,11,1110,1165,1109,-56
2020,5,22,12,1145,1191,1148,-43
2020,5,22,13,1210,1248,1218,-30
2020,5,22,14,1260,1312,1186,-126
2020,5,22,15,1300,1365,1261,-104
2020,5,22,16,1320,1361,1308,-53
2020,5,22,17,1340,1365,1387,22
2020,5,22,18,1350,1370,1384,14
2020,5,22,19,1355,1351,1330,-21
2020,5,22,20,1345,1334,1270,-64
2020,5,22,21,1330,1320,1137,-183
2020,5,22,22,1325,1305,1135,-170
2020,5,22,23,1325,1318,1115,-203
2020,5,23,0,1310,1288,1149,-139
2020,5,23,1,1285,1290,1163,-127
2020,5,23,2,1270,1279,1119,-160
2020,5,23,3,1265,1262,1088,-174
2020,5,23,4,1260,1266,1073,-193
2020,5,23,5,1230,1239,1036,-203
2020,5,23,6,1170,1180,1078,-102
2020,5,23,7,1145,1151,1098,-53
2020,5,23,8,1125,1097,1105,8
2020,5,23,9,1120,1090,1125,35
2020,5,23,10,1115,1090,1148,58
2020,5,23,11,1110,1092,1153,61
2020,5,23,12,1135,1111,1136,25
2020,5,23,13,1165,1134,1080,-54
2020,5,23,14,1220,1180,1104,-76
2020,5,23,15,1270,1232,974,-258
2020,5,23,16,1300,1281,981,-300
2020,5,23,17,1310,1286,975,-311
2020,5,23,18,1290,1292,977,-315
2020,5,23,19,1290,1274,981,-293
2020,5,23,20,1265,1266,972,-294
2020,5,23,21,1255,1254,1000,-254
2020,5,23,22,1255,1245,989,-256
2020,5,23,23,1260,1250,977,-273
2020,5,24,0,1270,1266,967,-299
2020,5,24,1,1275,1253,954,-299
2020,5,24,2,1255,1262,974,-288
2020,5,24,3,1255,1273,1008,-265
2020,5,24,4,1220,1270,977,-293
2020,5,24,5,1230,1219,993,-226
2020,5,24,6,1165,1169,1009,-160
2020,5,24,7,1125,1129,1022,-107
2020,5,24,8,1110,1109,1037,-72
2020,5,24,9,1105,1095,1019,-76
2020,5,24,10,1105,1095,1026,-69
2020,5,24,11,1105,1094,1011,-83
2020,5,24,12,1125,1106,998,-108
2020,5,24,13,1125,1123,991,-132
2020,5,24,14,1155,1151,972,-179
2020,5,24,15,1210,1200,983,-217
2020,5,24,16,1245,1222,1006,-216
2020,5,24,17,1270,1236,1000,-236
2020,5,24,18,1265,1224,991,-233
2020,5,24,19,1275,1214,1000,-214
2020,5,24,20,1255,1192,994,-198
2020,5,24,21,1265,1184,1016,-168
2020,5,24,22,1270,1172,984,-188
2020,5,24,23,1280,1174,977,-197
2020,5,25,0,1285,1193,1002,-191
2020,5,25,1,1295,1190,978,-212
2020,5,25,2,1280,1191,955,-236
2020,5,25,3,1285,1193,947,-246
2020,5,25,4,1255,1206,932,-274
2020,5,25,5,1235,1180,954,-226
2020,5,25,6,1160,1119,1048,-71
2020,5,25,7,1125,1067,963,-104
2020,5,25,8,1110,1067,1007,-60
2020,5,25,9,1105,1048,1030,-18
2020,5,25,10,1100,1042,1023,-19
2020,5,25,11,1110,1056,1025,-31
2020,5,25,12,1130,1060,1037,-23
2020,5,25,13,1190,1075,1053,-22
2020,5,25,14,1260,1106,1035,-71
2020,5,25,15,1295,1140,1049,-91
2020,5,25,16,1330,1170,1078,-92
2020,5,25,17,1350,1195,1101,-94
2020,5,25,18,1355,1190,1147,-43
2020,5,25,19,1365,1198,1144,-54
2020,5,25,20,1350,1181,1125,-56
2020,5,25,21,1350,1191,1116,-75
2020,5,25,22,1340,1185,1093,-92
2020,5,25,23,1350,1208,1075,-133
2020,5,26,0,1340,1242,1131,-111
2020,5,26,1,1340,1243,1051,-192
2020,5,26,2,1315,1231,1046,-185
2020,5,26,3,1305,1234,1089,-145
2020,5,26,4,1260,1228,1087,-141
2020,5,26,5,1235,1159,1081,-78
2020,5,26,6,1160,1091,1055,-36
2020,5,26,7,1120,1050,1072,22
2020,5,26,8,1095,1037,1131,94
2020,5,26,9,1070,1024,1182,158
2020,5,26,10,1080,1024,1249,225
2020,5,26,11,1085,1035,1273,238
2020,5,26,12,1125,1078,1256,178
2020,5,26,13,1190,1138,1207,69
2020,5,26,14,1265,1223,1211,-12
2020,5,26,15,1305,1280,1240,-40
2020,5,26,16,1315,1291,1262,-29
2020,5,26,17,1330,1287,1283,-4
2020,5,26,18,1335,1324,1385,61
2020,5,26,19,1350,1344,1440,96
2020,5,26,20,1335,1347,1432,85
2020,5,26,21,1350,1361,1431,70
2020,5,26,22,1350,1352,1438,86
2020,5,26,23,1370,1358,1390,32
2020,5,27,0,1370,1348,1346,-2
2020,5,27,1,1365,1328,1345,17
2020,5,27,2,1340,1312,1369,57
2020,5,27,3,1335,1281,1253,-28
2020,5,27,4,1265,1283,1221,-62
2020,5,27,5,1245,1238,1171,-67
2020,5,27,6,1170,1156,1195,39
2020,5,27,7,1105,1097,1166,69
2020,5,27,8,1090,1060,1207,147
2020,5,27,9,1070,1059,1202,143
2020,5,27,10,1070,1054,1108,54
2020,5,27,11,1085,1065,1079,14
2020,5,27,12,1110,1104,1274,170
2020,5,27,13,1180,1163,1300,137
2020,5,27,14,1255,1223,1224,1
2020,5,27,15,1295,1264,1291,27
2020,5,27,16,1320,1280,1156,-124
2020,5,27,17,1335,1308,1100,-208
2020,5,27,18,1345,1317,1262,-55
2020,5,27,19,1345,1330,1343,13
2020,5,27,20,1330,1338,1341,3
2020,5,27,21,1330,1341,1482,141
2020,5,27,22,1340,1351,1544,193
2020,5,27,23,1345,1362,1546,184
2020,5,28,0,1330,1352,1454,102
2020,5,28,1,1315,1356,1542,186
2020,5,28,2,1295,1342,1535,193
2020,5,28,3,1290,1329,1559,230
2020,5,28,4,1255,1308,1426,118
2020,5,28,5,1225,1239,1340,101
2020,5,28,6,1155,1166,1486,320
2020,5,28,7,1090,1122,1462,340
2020,5,28,8,1070,1094,1266,172
2020,5,28,9,1070,1081,1178,97
2020,5,28,10,1065,1085,1132,47
2020,5,28,11,1080,1088,1126,38
2020,5,28,12,1115,1124,1122,-2
2020,5,28,13,1190,1184,1199,15
2020,5,28,14,1275,1255,1253,-2
2020,5,28,15,1305,1298,1251,-47
2020,5,28,16,1330,1310,1247,-63
2020,5,28,17,1335,1307,1151,-156
2020,5,28,18,1345,1328,1229,-99
2020,5,28,19,1360,1335,1279,-56
2020,5,28,20,1345,1331,1413,82
2020,5,28,21,1340,1339,1484,145
2020,5,28,22,1335,1354,1527,173
2020,5,28,23,1335,1357,1533,176
2020,5,29,0,1335,1353,1500,147
2020,5,29,1,1325,1353,1543,190
2020,5,29,2,1310,1346,1552,206
2020,5,29,3,1295,1330,1571,241
2020,5,29,4,1275,1318,1566,248
2020,5,29,5,1250,1273,1565,292
2020,5,29,6,1180,1186,1502,316
2020,5,29,7,1105,1126,1411,285
2020,5,29,8,1080,1087,1278,191
2020,5,29,9,1075,1071,1094,23
2020,5,29,10,1070,1074,1059,-15
2020,5,29,11,1090,1080,1052,-28
2020,5,29,12,1120,1099,1032,-67
2020,5,29,13,1215,1154,1078,-76
2020,5,29,14,1315,1231,1190,-41
2020,5,29,15,1370,1275,1145,-130
2020,5,29,16,1375,1310,1085,-225
2020,5,29,17,1380,1333,1118,-215
2020,5,29,18,1390,1339,1255,-84
2020,5,29,19,1380,1352,1309,-43
2020,5,29,20,1370,1347,1406,59
2020,5,29,21,1360,1347,1413,66
2020,5,29,22,1350,1351,1424,73
2020,5,29,23,1360,1368,1430,62
2020,5,30,0,1335,1369,1448,79
2020,5,30,1,1335,1366,1451,85
2020,5,30,2,1320,1354,1462,108
2020,5,30,3,1305,1343,1493,150
2020,5,30,4,1315,1331,1485,154
2020,5,30,5,1270,1291,1424,133
2020,5,30,6,1205,1213,1446,233
2020,5,30,7,1165,1160,1500,340
2020,5,30,8,1115,1127,1237,110
2020,5,30,9,1105,1094,1137,43
2020,5,30,10,1105,1085,1071,-14
2020,5,30,11,1105,1087,1055,-32
2020,5,30,12,1130,1087,1038,-49
2020,5,30,13,1215,1104,1041,-63
2020,5,30,14,1320,1162,1049,-113
2020,5,30,15,1370,1216,1050,-166
2020,5,30,16,1415,1259,1057,-202
2020,5,30,17,1425,1296,1084,-212
2020,5,30,18,1430,1320,1113,-207
2020,5,30,19,1415,1346,1344,-2
2020,5,30,20,1405,1354,1308,-46
2020,5,30,21,1395,1387,1325,-62
2020,5,30,22,1395,1406,1306,-100
2020,5,30,23,1400,1447,1305,-142
2020,5,31,0,1415,1458,1427,-31
2020,5,31,1,1400,1434,1405,-29
2020,5,31,2,1405,1421,1438,17
2020,5,31,3,1405,1396,1199,-197
2020,5,31,4,1320,1393,1212,-181
2020,5,31,5,1350,1336,1211,-125
2020,5,31,6,1285,1260,1211,-49
2020,5,31,7,1150,1195,1174,-21
2020,5,31,8,1125,1148,1127,-21
2020,5,31,9,1110,1129,1131,2
2020,5,31,10,1115,1111,1140,29
2020,5,31,11,1110,1100,1125,25
2020,5,31,12,1130,1110,1112,2
2020,5,31,13,1210,1117,1073,-44
2020,5,31,14,1300,1160,1035,-125
2020,5,31,15,1360,1226,1044,-182
2020,5,31,16,1385,1275,1040,-235
2020,5,31,17,1400,1321,1048,-273
2020,5,31,18,1395,1356,1123,-233
2020,5,31,19,1390,1399,1190,-209
2020,5,31,20,1370,1408,1212,-196
2020,5,31,21,1365,1429,1296,-133
2020,5,31,22,1360,1452,1281,-171
2020,5,31,23,1365,1471,1234,-237
2020,6,1,0,1380,1489,1239,-250
2020,6,1,1,1385,1487,1235,-252
2020,6,1,2,1380,1463,1204,-259
2020,6,1,3,1375,1438,1248,-190
2020,6,1,4,1300,1399,1346,-53
2020,6,1,5,1350,1331,1338,7
2020,6,1,6,1270,1224,1205,-19
2020,6,1,7,1145,1162,1182,20
2020,6,1,8,1135,1128,1217,89
2020,6,1,9,1120,1092,1122,30
2020,6,1,10,1115,1077,1100,23
2020,6,1,11,1130,1087,1051,-36
2020,6,1,12,1140,1115,1038,-77
2020,6,1,13,1220,1189,1080,-109
2020,6,1,14,1320,1261,1039,-222
2020,6,1,15,1360,1312,996,-316
2020,6,1,16,1390,1330,1065,-265
2020,6,1,17,1415,1366,1083,-283
2020,6,1,18,1415,1401,1109,-292
2020,6,1,19,1425,1416,1115,-301
2020,6,1,20,1410,1425,1113,-312
2020,6,1,21,1420,1426,1122,-304
2020,6,1,22,1415,1458,1136,-322
2020,6,1,23,1435,1433,1086,-347
2020,6,2,0,1460,1458,1109,-349
2020,6,2,1,1460,1464,1110,-354
2020,6,2,2,1445,1423,1232,-191
2020,6,2,3,1440,1388,1118,-270
2020,6,2,4,1400,1373,1236,-137
2020,6,2,5,1360,1319,1199,-120
2020,6,2,6,1275,1231,1175,-56
2020,6,2,7,1100,1160,1133,-27
2020,6,2,8,1085,1133,1136,3
2020,6,2,9,1070,1119,1139,20
2020,6,2,10,1075,1114,1179,65
2020,6,2,11,1085,1116,1113,-3
2020,6,2,12,1125,1134,1101,-33
2020,6,2,13,1175,1191,1097,-94
2020,6,2,14,1245,1254,1080,-174
2020,6,2,15,1300,1309,1143,-166
2020,6,2,16,1310,1341,1331,-10
2020,6,2,17,1310,1350,1380,30
2020,6,2,18,1345,1374,1410,36
2020,6,2,19,1365,1375,1377,2
2020,6,2,20,1365,1390,1360,-30
2020,6,2,21,1380,1402,1380,-22
2020,6,2,22,1370,1418,1454,36
2020,6,2,23,1380,1454,1423,-31
2020,6,3,0,1370,1462,1533,71
2020,6,3,1,1355,1451,1530,79
2020,6,3,2,1335,1424,1236,-188
2020,6,3,3,1310,1391,1137,-254
2020,6,3,4,1275,1383,1078,-305
2020,6,3,5,1260,1321,1097,-224
2020,6,3,6,1175,1232,1085,-147
2020,6,3,7,1130,1174,1102,-72
2020,6,3,8,1090,1144,1132,-12
2020,6,3,9,1080,1125,1136,11
2020,6,3,10,1075,1105,1088,-17
2020,6,3,11,1085,1114,1156,42
2020,6,3,12,1120,1144,1150,6
2020,6,3,13,1205,1180,1217,37
2020,6,3,14,1285,1254,1179,-75
2020,6,3,15,1330,1307,1305,-2
2020,6,3,16,1350,1342,1524,182
2020,6,3,17,1380,1370,1588,218
2020,6,3,18,1395,1398,1577,179
2020,6,3,19,1405,1428,1604,176
2020,6,3,20,1410,1446,1661,215
2020,6,3,21,1410,1463,1670,207
2020,6,3,22,1425,1474,1559,85
2020,6,3,23,1430,1494,1631,137
2020,6,4,0,1425,1473,1633,160
2020,6,4,1,1420,1440,1649,209
2020,6,4,2,1400,1405,1592,187
2020,6,4,3,1385,1374,1420,46
2020,6,4,4,1330,1353,1303,-50
2020,6,4,5,1300,1286,1096,-190
2020,6,4,6,1220,1207,1010,-197
2020,6,4,7,1155,1148,1024,-124
2020,6,4,8,1125,1118,978,-140
2020,6,4,9,1115,1097,998,-99
2020,6,4,10,1110,1097,1008,-89
2020,6,4,11,1115,1099,1028,-71
2020,6,4,12,1140,1121,1088,-33
2020,6,4,13,1215,1189,1081,-108
2020,6,4,14,1295,1250,1157,-93
2020,6,4,15,1345,1305,1145,-160
2020,6,4,16,1370,1333,1188,-145
2020,6,4,17,1375,1354,1202,-152
2020,6,4,18,1395,1373,1147,-226
2020,6,4,19,1400,1384,1187,-197
2020,6,4,20,1405,1399,1336,-63
2020,6,4,21,1415,1392,1327,-65
2020,6,4,22,1425,1413,1449,36
2020,6,4,23,1450,1410,1476,66
2020,6,5,0,1450,1402,1575,173
2020,6,5,1,1445,1396,1559,163
2020,6,5,2,1425,1357,1508,151
2020,6,5,3,1400,1326,1495,169
2020,6,5,4,1380,1333,1501,168
2020,6,5,5,1335,1271,1520,249
2020,6,5,6,1245,1195,1502,307
2020,6,5,7,1155,1135,1309,174
2020,6,5,8,1125,1105,1200,95
2020,6,5,9,1105,1089,1134,45
2020,6,5,10,1105,1081,1125,44
2020,6,5,11,1115,1091,1114,23
2020,6,5,12,1140,1115,1116,1
2020,6,5,13,1225,1174,1295,121
2020,6,5,14,1335,1238,1379,141
2020,6,5,15,1390,1286,1339,53
2020,6,5,16,1420,1318,1371,53
2020,6,5,17,1440,1337,1459,122
2020,6,5,18,1450,1357,1497,140
2020,6,5,19,1465,1371,1525,154
2020,6,5,20,1460,1386,1543,157
2020,6,5,21,1460,1421,1573,152
2020,6,5,22,1460,1453,1615,162
2020,6,5,23,1480,1482,1682,200
2020,6,6,0,1470,1480,1612,132
2020,6,6,1,1465,1472,1578,106
2020,6,6,2,1445,1424,1483,59
2020,6,6,3,1430,1391,1356,-35
2020,6,6,4,1390,1384,1383,-1
2020,6,6,5,1370,1317,1304,-13
2020,6,6,6,1290,1242,1201,-41
2020,6,6,7,1145,1173,1163,-10
2020,6,6,8,1115,1128,1092,-36
2020,6,6,9,1090,1117,1143,26
2020,6,6,10,1085,1097,1066,-31
2020,6,6,11,1085,1115,1062,-53
2020,6,6,12,1095,1112,1044,-68
2020,6,6,13,1085,1126,1060,-66
2020,6,6,14,1105,1167,1090,-77
2020,6,6,15,1155,1217,1090,-127
2020,6,6,16,1190,1269,1047,-222
2020,6,6,17,1220,1295,1143,-152
2020,6,6,18,1240,1328,1175,-153
2020,6,6,19,1255,1324,1135,-189
2020,6,6,20,1260,1332,1139,-193
2020,6,6,21,1275,1316,1115,-201
2020,6,6,22,1290,1320,1138,-182
2020,6,6,23,1315,1315,1183,-132
2020,6,7,0,1320,1334,1101,-233
2020,6,7,1,1295,1320,1122,-198
2020,6,7,2,1290,1289,1164,-125
2020,6,7,3,1270,1280,1136,-144
2020,6,7,4,1250,1276,1254,-22
2020,6,7,5,1220,1219,1138,-81
2020,6,7,6,1150,1146,1168,22
2020,6,7,7,1170,1107,1206,99
2020,6,7,8,1135,1083,1144,61
2020,6,7,9,1115,1069,1142,73
2020,6,7,10,1110,1072,1196,124
2020,6,7,11,1100,1092,1204,112
2020,6,7,12,1115,1084,1151,67
2020,6,7,13,1085,1104,1190,86
2020,6,7,14,1075,1147,1206,59
2020,6,7,15,1130,1202,1227,25
2020,6,7,16,1170,1237,1210,-27
2020,6,7,17,1200,1263,1165,-98
2020,6,7,18,1225,1273,1160,-113
2020,6,7,19,1245,1279,1111,-168
2020,6,7,20,1250,1260,1083,-177
2020,6,7,21,1260,1263,1047,-216
2020,6,7,22,1275,1268,1041,-227
2020,6,7,23,1285,1283,972,-311
2020,6,8,0,1300,1303,960,-343
2020,6,8,1,1295,1302,967,-335
2020,6,8,2,1275,1280,961,-319
2020,6,8,3,1255,1261,1024,-237
2020,6,8,4,1220,1251,1002,-249
2020,6,8,5,1180,1209,1013,-196
2020,6,8,6,1095,1137,996,-141
2020,6,8,7,1180,1110,1022,-88
2020,6,8,8,1155,1095,1003,-92
2020,6,8,9,1125,1097,1011,-86
2020,6,8,10,1115,1089,1007,-82
2020,6,8,11,1125,1107,998,-109
2020,6,8,12,1145,1129,1000,-129
2020,6,8,13,1150,1201,1046,-155
2020,6,8,14,1150,1276,1012,-264
2020,6,8,15,1195,1302,1047,-255
2020,6,8,16,1215,1328,1107,-221
2020,6,8,17,1245,1349,1100,-249
2020,6,8,18,1270,1370,1153,-217
2020,6,8,19,1280,1354,1221,-133
2020,6,8,20,1285,1347,1213,-134
2020,6,8,21,1285,1334,1207,-127
2020,6,8,22,1310,1319,1192,-127
2020,6,8,23,1295,1312,1178,-134
2020,6,9,0,1315,1314,1253,-61
2020,6,9,1,1315,1296,1229,-67
2020,6,9,2,1285,1285,1249,-36
2020,6,9,3,1255,1272,1238,-34
2020,6,9,4,1220,1270,1225,-45
2020,6,9,5,1195,1228,1293,65
2020,6,9,6,1115,1179,1213,34
2020,6,9,7,1130,1126,1176,50
2020,6,9,8,1110,1110,1212,102
2020,6,9,9,1095,1092,1293,201
2020,6,9,10,1090,1107,1339,232
2020,6,9,11,1100,1111,1305,194
2020,6,9,12,1115,1141,1323,182
2020,6,9,13,1145,1196,1440,244
2020,6,9,14,1185,1268,1541,273
2020,6,9,15,1240,1308,1671,363
2020,6,9,16,1265,1333,1713,380
2020,6,9,17,1280,1339,1695,356
2020,6,9,18,1300,1349,1722,373
2020,6,9,19,1305,1333,1724,391
2020,6,9,20,1310,1327,1679,352
2020,6,9,21,1320,1314,1676,362
2020,6,9,22,1330,1320,1681,361
2020,6,9,23,1355,1315,1713,398
2020,6,10,0,1360,1303,1659,356
2020,6,10,1,1350,1307,1647,340
2020,6,10,2,1330,1307,1726,419
2020,6,10,3,1300,1292,1723,431
2020,6,10,4,1270,1283,1710,427
2020,6,10,5,1240,1241,1716,475
2020,6,10,6,1160,1170,1670,500
2020,6,10,7,1145,1141,1416,275
2020,6,10,8,1115,1112,1297,185
2020,6,10,9,1105,1094,1264,170
2020,6,10,10,1090,1102,1280,178
2020,6,10,11,1105,1102,1259,157
2020,6,10,12,1130,1136,1264,128
2020,6,10,13,1165,1195,1283,88
2020,6,10,14,1220,1271,1432,161
2020,6,10,15,1265,1312,1561,249
2020,6,10,16,1295,1337,1602,265
2020,6,10,17,1320,1336,1544,208
2020,6,10,18,1345,1342,1619,277
2020,6,10,19,1365,1334,1573,239
2020,6,10,20,1375,1342,1606,264
2020,6,10,21,1380,1346,1637,291
2020,6,10,22,1390,1344,1650,306
2020,6,10,23,1400,1354,1639,285
2020,6,11,0,1385,1356,1611,255
2020,6,11,1,1365,1367,1562,195
2020,6,11,2,1335,1343,1476,133
2020,6,11,3,1315,1324,1514,190
2020,6,11,4,1270,1322,1493,171
2020,6,11,5,1240,1256,1291,35
2020,6,11,6,1170,1171,1228,57
2020,6,11,7,1145,1113,1176,63
2020,6,11,8,1120,1078,977,-101
2020,6,11,9,1095,1067,971,-96
2020,6,11,10,1100,1066,990,-76
2020,6,11,11,1100,1062,998,-64
2020,6,11,12,1130,1092,949,-143
2020,6,11,13,1240,1158,1008,-150
2020,6,11,14,1350,1231,1050,-181
2020,6,11,15,1400,1281,1014,-267
2020,6,11,16,1430,1307,1045,-262
2020,6,11,17,1445,1336,1094,-242
2020,6,11,18,1465,1347,1114,-233
2020,6,11,19,1470,1362,1104,-258
2020,6,11,20,1475,1391,1206,-185
2020,6,11,21,1470,1415,1314,-101
2020,6,11,22,1490,1435,1356,-79
2020,6,11,23,1485,1457,1404,-53
2020,6,12,0,1475,1459,1464,5
2020,6,12,1,1470,1456,1521,65
2020,6,12,2,1445,1425,1497,72
2020,6,12,3,1415,1389,1336,-53
2020,6,12,4,1380,1375,1332,-43
2020,6,12,5,1360,1301,1361,60
2020,6,12,6,1275,1227,1373,146
2020,6,12,7,1145,1160,1244,84
2020,6,12,8,1110,1124,1104,-20
2020,6,12,9,1090,1095,1003,-92
2020,6,12,10,1090,1093,1010,-83
2020,6,12,11,1100,1093,1015,-78
2020,6,12,12,1125,1113,988,-125
2020,6,12,13,1225,1180,991,-189
2020,6,12,14,1340,1249,1114,-135
2020,6,12,15,1395,1299,1138,-161
2020,6,12,16,1425,1344,1152,-192
2020,6,12,17,1440,1368,1163,-205
2020,6,12,18,1455,1403,1212,-191
2020,6,12,19,1470,1440,1453,13
2020,6,12,20,1475,1490,1472,-18
2020,6,12,21,1500,1527,1476,-51
2020,6,12,22,1525,1546,1436,-110
2020,6,12,23,1550,1572,1395,-177
2020,6,13,0,1550,1571,1300,-271
2020,6,13,1,1545,1545,1247,-298
2020,6,13,2,1505,1491,1131,-360
2020,6,13,3,1475,1446,1129,-317
2020,6,13,4,1440,1421,1080,-341
2020,6,13,5,1405,1360,1023,-337
2020,6,13,6,1320,1265,1008,-257
2020,6,13,7,1170,1198,998,-200
2020,6,13,8,1125,1158,1056,-102
2020,6,13,9,1110,1136,1031,-105
2020,6,13,10,1095,1122,1026,-96
2020,6,13,11,1110,1104,1047,-57
2020,6,13,12,1110,1115,1072,-43
2020,6,13,13,1185,1135,1085,-50
2020,6,13,14,1280,1189,1070,-119
2020,6,13,15,1335,1231,1157,-74
2020,6,13,16,1385,1293,1201,-92
2020,6,13,17,1420,1328,1169,-159
2020,6,13,18,1445,1350,1152,-198
2020,6,13,19,1450,1383,1173,-210
2020,6,13,20,1465,1419,1176,-243
2020,6,13,21,1455,1437,1100,-337
2020,6,13,22,1465,1458,1097,-361
2020,6,13,23,1470,1481,1104,-377
2020,6,14,0,1485,1496,1290,-206
2020,6,14,1,1465,1502,1237,-265
2020,6,14,2,1445,1458,1263,-195
2020,6,14,3,1425,1416,1267,-149
2020,6,14,4,1380,1391,1277,-114
2020,6,14,5,1355,1343,1264,-79
2020,6,14,6,1275,1262,1215,-47
2020,6,14,7,1125,1204,1210,6
2020,6,14,8,1100,1151,1230,79
2020,6,14,9,1085,1118,1193,75
2020,6,14,10,1085,1100,1194,94
2020,6,14,11,1095,1115,1157,42
2020,6,14,12,1095,1114,1155,41
2020,6,14,13,1100,1134,1146,12
2020,6,14,14,1125,1176,1154,-22
2020,6,14,15,1180,1229,1130,-99
2020,6,14,16,1215,1294,1202,-92
2020,6,14,17,1245,1332,1230,-102
2020,6,14,18,1255,1340,1273,-67
2020,6,14,19,1265,1365,1385,20
2020,6,14,20,1260,1360,1327,-33
2020,6,14,21,1270,1372,1350,-22
2020,6,14,22,1280,1345,1331,-14
2020,6,14,23,1295,1349,1314,-35
2020,6,15,0,1310,1350,1295,-55
2020,6,15,1,1310,1352,1290,-62
2020,6,15,2,1285,1334,1363,29
2020,6,15,3,1265,1316,1412,96
2020,6,15,4,1225,1281,1401,120
2020,6,15,5,1195,1257,1442,185
2020,6,15,6,1120,1190,1419,229
2020,6,15,7,1125,1131,1448,317
2020,6,15,8,1095,1104,1403,299
2020,6,15,9,1090,1097,1376,279
2020,6,15,10,1080,1094,1328,234
2020,6,15,11,1095,1099,1321,222
2020,6,15,12,1120,1129,1302,173
2020,6,15,13,1195,1213,1381,168
2020,6,15,14,1265,1278,1523,245
2020,6,15,15,1300,1323,1550,227
2020,6,15,16,1325,1344,1474,130
2020,6,15,17,1355,1370,1501,131
2020,6,15,18,1380,1368,1425,57
2020,6,15,19,1380,1361,1472,111
2020,6,15,20,1380,1355,1480,125
2020,6,15,21,1375,1376,1568,192
2020,6,15,22,1375,1381,1541,160
2020,6,15,23,1370,1422,1539,117
2020,6,16,0,1375,1421,1497,76
2020,6,16,1,1365,1416,1483,67
2020,6,16,2,1345,1374,1336,-38
2020,6,16,3,1325,1345,1217,-128
2020,6,16,4,1300,1321,1232,-89
2020,6,16,5,1270,1254,1197,-57
2020,6,16,6,1210,1157,1031,-126
2020,6,16,7,1130,1119,1106,-13
2020,6,16,8,1110,1073,1100,27
2020,6,16,9,1090,1075,1083,8
2020,6,16,10,1100,1056,1092,36
2020,6,16,11,1105,1067,1108,41
2020,6,16,12,1130,1095,1083,-12
2020,6,16,13,1180,1155,1092,-63
2020,6,16,14,1250,1241,1091,-150
2020,6,16,15,1295,1281,1051,-230
2020,6,16,16,1325,1296,1068,-228
2020,6,16,17,1335,1309,1081,-228
2020,6,16,18,1345,1315,1146,-169
2020,6,16,19,1335,1312,1097,-215
2020,6,16,20,1335,1317,1126,-191
2020,6,16,21,1325,1314,1155,-159
2020,6,16,22,1335,1301,1188,-113
2020,6,16,23,1335,1307,1159,-148
2020,6,17,0,1325,1283,1174,-109
2020,6,17,1,1325,1300,1137,-163
2020,6,17,2,1320,1255,1052,-203
2020,6,17,3,1305,1251,1031,-220
2020,6,17,4,1280,1237,1045,-192
2020,6,17,5,1250,1188,1040,-148
2020,6,17,6,1175,1098,1031,-67
2020,6,17,7,1135,1051,1030,-21
2020,6,17,8,1115,1028,1112,84
2020,6,17,9,1095,1029,1067,38
2020,6,17,10,1095,1029,1061,32
2020,6,17,11,1105,1042,1087,45
2020,6,17,12,1135,1096,1112,16
2020,6,17,13,1195,1166,1105,-61
2020,6,17,14,1250,1240,1111,-129
2020,6,17,15,1295,1288,1084,-204
2020,6,17,16,1320,1330,1074,-256
2020,6,17,17,1340,1366,1101,-265
2020,6,17,18,1345,1386,1136,-250
2020,6,17,19,1345,1387,1156,-231
2020,6,17,20,1335,1378,1229,-149
2020,6,17,21,1340,1357,1231,-126
2020,6,17,22,1355,1343,1156,-187
2020,6,17,23,1360,1339,1191,-148
2020,6,18,0,1335,1332,1188,-144
2020,6,18,1,1315,1321,1283,-38
2020,6,18,2,1290,1285,1317,32
2020,6,18,3,1280,1258,1319,61
2020,6,18,4,1250,1245,1277,32
2020,6,18,5,1210,1202,1275,73
2020,6,18,6,1135,1129,1300,171
2020,6,18,7,1100,1101,1364,263
2020,6,18,8,1065,1087,1294,207
2020,6,18,9,1060,1072,1266,194
2020,6,18,10,1050,1067,1279,212
2020,6,18,11,1050,1077,1251,174
2020,6,18,12,1080,1109,1248,139
2020,6,18,13,1105,1161,1256,95
2020,6,18,14,1140,1228,1219,-9
2020,6,18,15,1185,1271,1179,-92
2020,6,18,16,1210,1294,1387,93
2020,6,18,17,1230,1301,1415,114
2020,6,18,18,1240,1285,1443,158
2020,6,18,19,1250,1274,1460,186
2020,6,18,20,1270,1275,1409,134
2020,6,18,21,1280,1262,1452,190
2020,6,18,22,1295,1244,1470,226
2020,6,18,23,1305,1250,1467,217
2020,6,19,0,1305,1257,1471,214
2020,6,19,1,1300,1234,1416,182
2020,6,19,2,1270,1211,1449,238
2020,6,19,3,1245,1207,1393,186
2020,6,19,4,1200,1210,1264,54
2020,6,19,5,1170,1171,1264,93
2020,6,19,6,1100,1107,1392,285
2020,6,19,7,1110,1062,1382,320
2020,6,19,8,1080,1042,1216,174
2020,6,19,9,1060,1028,1149,121
2020,6,19,10,1060,1028,1089,61
2020,6,19,11,1065,1038,1101,63
2020,6,19,12,1090,1062,1053,-9
2020,6,19,13,1100,1121,1053,-68
2020,6,19,14,1110,1185,1065,-120
2020,6,19,15,1160,1229,1032,-197
2020,6,19,16,1195,1256,1108,-148
2020,6,19,17,1215,1272,1174,-98
2020,6,19,18,1240,1280,1198,-82
2020,6,19,19,1265,1291,1338,47
2020,6,19,20,1290,1282,1345,63
2020,6,19,21,1310,1291,1376,85
2020,6,19,22,1325,1290,1394,104
2020,6,19,23,1345,1297,1433,136
2020,6,20,0,1345,1278,1460,182
2020,6,20,1,1325,1274,1474,200
2020,6,20,2,1285,1266,1436,170
2020,6,20,3,1250,1248,1434,186
2020,6,20,4,1220,1239,1334,95
2020,6,20,5,1180,1199,1217,18
2020,6,20,6,1100,1147,1219,72
2020,6,20,7,1130,1091,1161,70
2020,6,20,8,1100,1060,960,-100
2020,6,20,9,1080,1050,1049,-1
2020,6,20,10,1070,1044,1134,90
2020,6,20,11,1065,1060,1152,92
2020,6,20,12,1075,1063,1273,210
2020,6,20,13,1075,1060,1289,229
2020,6,20,14,1095,1090,1259,169
2020,6,20,15,1135,1140,1239,99
2020,6,20,16,1185,1173,1302,129
2020,6,20,17,1210,1210,1413,203
2020,6,20,18,1225,1226,1396,170
2020,6,20,19,1240,1231,1374,143
2020,6,20,20,1260,1246,1315,69
2020,6,20,21,1265,1264,1315,51
2020,6,20,22,1275,1286,1350,64
2020,6,20,23,1290,1286,1354,68
2020,6,21,0,1300,1303,1425,122
2020,6,21,1,1300,1331,1415,84
2020,6,21,2,1265,1256,1416,160
2020,6,21,3,1235,1227,1366,139
2020,6,21,4,1200,1222,1348,126
2020,6,21,5,1180,1192,1410,218
2020,6,21,6,1110,1136,1378,242
2020,6,21,7,1135,1082,1341,259
2020,6,21,8,1095,1057,1331,274
2020,6,21,9,1070,1055,1356,301
2020,6,21,10,1060,1027,1322,295
2020,6,21,11,1075,1022,1329,307
2020,6,21,12,1075,1040,1311,271
2020,6,21,13,1100,1062,1294,232
2020,6,21,14,1140,1108,1279,171
2020,6,21,15,1190,1151,1233,82
2020,6,21,16,1235,1228,1327,99
2020,6,21,17,1265,1264,1243,-21
2020,6,21,18,1275,1283,1183,-100
2020,6,21,19,1285,1288,1187,-101
2020,6,21,20,1285,1290,1138,-152
2020,6,21,21,1290,1297,1135,-162
2020,6,21,22,1270,1313,1182,-131
2020,6,21,23,1275,1340,1152,-188
2020,6,22,0,1280,1365,1142,-223
2020,6,22,1,1275,1369,1162,-207
2020,6,22,2,1255,1336,1134,-202
2020,6,22,3,1245,1307,1076,-231
2020,6,22,4,1220,1289,1059,-230
2020,6,22,5,1190,1245,1049,-196
2020,6,22,6,1125,1144,1062,-82
2020,6,22,7,1105,1094,1001,-93
2020,6,22,8,1080,1050,1041,-9
2020,6,22,9,1075,1045,1053,8
2020,6,22,10,1070,1035,1028,-7
2020,6,22,11,1080,1037,1029,-8
2020,6,22,12,1110,1054,994,-60
2020,6,22,13,1190,1132,1017,-115
2020,6,22,14,1260,1208,1027,-181
2020,6,22,15,1300,1275,1059,-216
2020,6,22,16,1325,1319,1038,-281
2020,6,22,17,1345,1353,1080,-273
2020,6,22,18,1345,1377,1074,-303
2020,6,22,19,1335,1389,1041,-348
2020,6,22,20,1335,1413,1100,-313
2020,6,22,21,1340,1428,1165,-263
2020,6,22,22,1340,1454,1157,-297
2020,6,22,23,1365,1476,1178,-298
2020,6,23,0,1365,1474,1342,-132
2020,6,23,1,1355,1483,1394,-89
2020,6,23,2,1320,1465,1416,-49
2020,6,23,3,1300,1422,1397,-25
2020,6,23,4,1260,1382,1337,-45
2020,6,23,5,1230,1318,1295,-23
2020,6,23,6,1145,1209,1169,-40
2020,6,23,7,1150,1146,1157,11
2020,6,23,8,1110,1104,1026,-78
2020,6,23,9,1110,1080,976,-104
2020,6,23,10,1090,1070,986,-84
2020,6,23,11,1095,1074,1003,-71
2020,6,23,12,1120,1107,1015,-92
2020,6,23,13,1200,1177,1018,-159
2020,6,23,14,1305,1248,1084,-164
2020,6,23,15,1345,1315,1071,-244
2020,6,23,16,1380,1368,1139,-229
2020,6,23,17,1395,1401,1190,-211
2020,6,23,18,1405,1426,1274,-152
2020,6,23,19,1400,1449,1333,-116
2020,6,23,20,1405,1490,1502,12
2020,6,23,21,1405,1527,1513,-14
2020,6,23,22,1400,1560,1515,-45
2020,6,23,23,1405,1596,1487,-109
2020,6,24,0,1395,1622,1499,-123
2020,6,24,1,1410,1621,1486,-135
2020,6,24,2,1370,1594,1452,-142
2020,6,24,3,1360,1541,1386,-155
2020,6,24,4,1305,1494,1342,-152
2020,6,24,5,1295,1403,1303,-100
2020,6,24,6,1200,1287,1168,-119
2020,6,24,7,1080,1211,1162,-49
2020,6,24,8,1045,1155,1020,-135
2020,6,24,9,1040,1135,1002,-133
2020,6,24,10,1040,1112,1020,-92
2020,6,24,11,1050,1115,1032,-83
2020,6,24,12,1100,1140,1043,-97
2020,6,24,13,1260,1210,1046,-164
2020,6,24,14,1430,1300,1011,-289
2020,6,24,15,1495,1357,1009,-348
2020,6,24,16,1535,1429,1020,-409
2020,6,24,17,1570,1463,1001,-462
2020,6,24,18,1590,1529,1103,-426
2020,6,24,19,1590,1563,1320,-243
2020,6,24,20,1590,1601,1367,-234
2020,6,24,21,1575,1628,1328,-300
2020,6,24,22,1570,1636,1275,-361
2020,6,24,23,1580,1571,1281,-290
2020,6,25,0,1575,1603,1418,-185
2020,6,25,1,1570,1563,1293,-270
2020,6,25,2,1535,1520,1146,-374
2020,6,25,3,1505,1482,1129,-353
2020,6,25,4,1460,1413,1012,-401
2020,6,25,5,1425,1348,1150,-198
2020,6,25,6,1335,1234,1034,-200
2020,6,25,7,1140,1176,1047,-129
2020,6,25,8,1105,1138,1090,-48
2020,6,25,9,1090,1113,1111,-2
2020,6,25,10,1085,1102,1129,27
2020,6,25,11,1085,1093,1054,-39
2020,6,25,12,1115,1128,1018,-110
2020,6,25,13,1145,1187,1031,-156
2020,6,25,14,1175,1259,1034,-225
2020,6,25,15,1225,1319,1056,-263
2020,6,25,16,1260,1353,1048,-305
2020,6,25,17,1290,1414,1115,-299
2020,6,25,18,1305,1434,1171,-263
2020,6,25,19,1325,1456,1179,-277
2020,6,25,20,1355,1478,1426,-52
2020,6,25,21,1380,1492,1453,-39
2020,6,25,22,1405,1510,1487,-23
2020,6,25,23,1430,1523,1486,-37
2020,6,26,0,1440,1519,1447,-72
2020,6,26,1,1435,1498,1425,-73
2020,6,26,2,1410,1483,1430,-53
2020,6,26,3,1370,1445,1424,-21
2020,6,26,4,1350,1412,1374,-38
2020,6,26,5,1270,1361,1345,-16
2020,6,26,6,1185,1250,1270,20
2020,6,26,7,1160,1187,1131,-56
2020,6,26,8,1135,1142,1011,-131
2020,6,26,9,1115,1106,986,-120
2020,6,26,10,1110,1090,968,-122
2020,6,26,11,1115,1092,958,-134
2020,6,26,12,1145,1121,977,-144
2020,6,26,13,1275,1169,990,-179
2020,6,26,14,1415,1250,985,-265
2020,6,26,15,1470,1314,987,-327
2020,6,26,16,1510,1366,1049,-317
2020,6,26,17,1535,1420,1247,-173
2020,6,26,18,1560,1461,1188,-273
2020,6,26,19,1580,1480,1146,-334
2020,6,26,20,1590,1509,1270,-239
2020,6,26,21,1605,1551,1461,-90
2020,6,26,22,1610,1576,1479,-97
2020,6,26,23,1605,1605,1427,-178
2020,6,27,0,1595,1620,1511,-109
2020,6,27,1,1585,1608,1485,-123
2020,6,27,2,1560,1575,1455,-120
2020,6,27,3,1530,1517,1260,-257
2020,6,27,4,1480,1461,1155,-306
2020,6,27,5,1450,1393,1070,-323
2020,6,27,6,1370,1297,1073,-224
2020,6,27,7,1160,1207,1018,-189
2020,6,27,8,1125,1175,1050,-125
2020,6,27,9,1110,1128,1030,-98
2020,6,27,10,1100,1122,1068,-54
2020,6,27,11,1110,1107,1074,-33
2020,6,27,12,1115,1126,1139,13
2020,6,27,13,1140,1141,1117,-24
2020,6,27,14,1195,1190,1030,-160
2020,6,27,15,1250,1278,1079,-199
2020,6,27,16,1290,1336,1072,-264
2020,6,27,17,1335,1370,1079,-291
2020,6,27,18,1350,1413,1092,-321
2020,6,27,19,1365,1427,1137,-290
2020,6,27,20,1385,1453,1243,-210
2020,6,27,21,1400,1469,1236,-233
2020,6,27,22,1425,1482,1280,-202
2020,6,27,23,1430,1507,1330,-177
2020,6,28,0,1445,1495,1326,-169
2020,6,28,1,1460,1475,1287,-188
2020,6,28,2,1400,1427,1223,-204
2020,6,28,3,1365,1379,1096,-283
2020,6,28,4,1330,1340,1126,-214
2020,6,28,5,1315,1283,1101,-182
2020,6,28,6,1235,1211,1072,-139
2020,6,28,7,1155,1152,999,-153
2020,6,28,8,1125,1117,980,-137
2020,6,28,9,1110,1088,971,-117
2020,6,28,10,1095,1075,946,-129
2020,6,28,11,1090,1064,938,-126
2020,6,28,12,1105,1064,956,-108
2020,6,28,13,1105,1068,939,-129
2020,6,28,14,1130,1118,937,-181
2020,6,28,15,1175,1195,960,-235
2020,6,28,16,1240,1239,1022,-217
2020,6,28,17,1280,1280,1022,-258
2020,6,28,18,1300,1297,1025,-272
2020,6,28,19,1310,1321,1034,-287
2020,6,28,20,1315,1321,1025,-296
2020,6,28,21,1325,1336,1022,-314
2020,6,28,22,1335,1330,1046,-284
2020,6,28,23,1355,1350,1049,-301
2020,6,29,0,1370,1341,1045,-296
2020,6,29,1,1370,1330,1058,-272
2020,6,29,2,1345,1300,1150,-150
2020,6,29,3,1315,1292,1132,-160
2020,6,29,4,1280,1272,1156,-116
2020,6,29,5,1250,1220,1091,-129
2020,6,29,6,1155,1158,1098,-60
2020,6,29,7,1125,1121,1032,-89
2020,6,29,8,1085,1089,1043,-46
2020,6,29,9,1075,1086,1069,-17
2020,6,29,10,1070,1085,1060,-25
2020,6,29,11,1070,1092,1159,67
2020,6,29,12,1090,1082,1210,128
2020,6,29,13,1130,1150,1201,51
2020,6,29,14,1165,1240,1293,53
2020,6,29,15,1225,1296,1250,-46
2020,6,29,16,1260,1328,1228,-100
2020,6,29,17,1295,1344,1237,-107
2020,6,29,18,1315,1364,1281,-83
2020,6,29,19,1325,1358,1328,-30
2020,6,29,20,1340,1337,1284,-53
2020,6,29,21,1360,1318,1251,-67
2020,6,29,22,1380,1297,1272,-25
2020,6,29,23,1400,1294,1243,-51
2020,6,30,0,1395,1292,1263,-29
2020,6,30,1,1395,1271,1350,79
2020,6,30,2,1375,1256,1367,111
2020,6,30,3,1340,1251,1415,164
2020,6,30,4,1300,1237,1339,102
2020,6,30,5,1245,1196,1383,187
2020,6,30,6,1145,1128,1358,230
2020,6,30,7,1125,1083,1334,251
2020,6,30,8,1090,1062,1241,179
2020,6,30,9,1070,1053,1322,269
2020,6,30,10,1060,1050,1282,232
2020,6,30,11,1060,1053,1245,192
2020,6,30,12,1085,1097,1293,196
2020,6,30,13,1070,1157,1328,171
2020,6,30,14,1070,1216,1287,71
2020,6,30,15,1125,1248,1235,-13
2020,6,30,16,1165,1275,1304,29
2020,6,30,17,1195,1309,1345,36
2020,6,30,18,1210,1314,1323,9
2020,6,30,19,1230,1309,1281,-28
2020,6,30,20,1245,1306,1313,7
2020,6,30,21,1270,1312,1312,0
2020,6,30,22,1285,1313,1419,106
2020,6,30,23,1305,1307,1415,108
2020,7,1,0,1315,1296,1421,125
2020,7,1,1,1315,1279,1418,139
2020,7,1,2,1290,1250,1360,110
2020,7,1,3,1260,1236,1388,152
2020,7,1,4,1220,1223,1371,148
2020,7,1,5,1160,1179,1348,169
2020,7,1,6,1075,1119,1306,187
2020,7,1,7,1130,1023,1204,181
2020,7,1,8,1090,965,1241,276
2020,7,1,9,1080,953,1252,299
2020,7,1,10,1065,951,1295,344
2020,7,1,11,1070,948,1340,392
2020,7,1,12,1090,987,1334,347
2020,7,1,13,1125,1043,1307,264
2020,7,1,14,1175,1099,1296,197
2020,7,1,15,1230,1152,1254,102
2020,7,1,16,1285,1168,1242,74
2020,7,1,17,1310,1215,1240,25
2020,7,1,18,1355,1220,1220,0
2020,7,1,19,1370,1229,1228,-1
2020,7,1,20,1390,1241,1221,-20
2020,7,1,21,1395,1239,1233,-6
2020,7,1,22,1395,1258,1228,-30
2020,7,1,23,1360,1263,1260,-3
2020,7,2,0,1375,1257,1309,52
2020,7,2,1,1345,1239,1192,-47
2020,7,2,2,1315,1220,1365,145
2020,7,2,3,1285,1193,1285,92
2020,7,2,4,1230,1167,1199,32
2020,7,2,5,1190,1128,1196,68
2020,7,2,6,1100,1060,1250,190
2020,7,2,7,1155,999,1203,204
2020,7,2,8,1125,976,1269,293
2020,7,2,9,1100,969,1287,318
2020,7,2,10,1090,967,1340,373
2020,7,2,11,1085,961,1272,311
2020,7,2,12,1115,992,1248,256
2020,7,2,13,1155,1057,1369,312
2020,7,2,14,1205,1135,1396,261
2020,7,2,15,1260,1198,1362,164
2020,7,2,16,1290,1235,1365,130
2020,7,2,17,1345,1256,1347,91
2020,7,2,18,1355,1256,1344,88
2020,7,2,19,1370,1275,1536,261
2020,7,2,20,1385,1296,1722,426
2020,7,2,21,1400,1303,1683,380
2020,7,2,22,1405,1309,1595,286
2020,7,2,23,1420,1334,1611,277
2020,7,3,0,1415,1332,1655,323
2020,7,3,1,1395,1323,1763,440
2020,7,3,2,1380,1308,1955,647
2020,7,3,3,1350,1274,1939,665
2020,7,3,4,1310,1250,1967,717
2020,7,3,5,1280,1196,1927,731
2020,7,3,6,1175,1109,2061,952
2020,7,3,7,1040,1039,1781,742
2020,7,3,8,1005,1003,1463,460
2020,7,3,9,980,978,1443,465
2020,7,3,10,970,964,1252,288
2020,7,3,11,970,966,1212,246
2020,7,3,12,1000,970,1228,258
2020,7,3,13,1040,1001,1244,243
2020,7,3,14,1095,1063,1280,217
2020,7,3,15,1150,1131,1298,167
2020,7,3,16,1185,1177,1375,198
2020,7,3,17,1225,1214,1439,225
2020,7,3,18,1250,1245,1434,189
2020,7,3,19,1260,1268,1470,202
2020,7,3,20,1280,1290,1527,237
2020,7,3,21,1300,1331,1596,265
2020,7,3,22,1320,1329,1703,374
2020,7,3,23,1335,1331,1691,360
2020,7,4,0,1340,1326,1913,587
2020,7,4,1,1330,1287,1854,567
2020,7,4,2,1305,1257,1612,355
2020,7,4,3,1270,1213,1437,224
2020,7,4,4,1200,1187,1360,173
2020,7,4,5,1180,1159,1368,209
2020,7,4,6,1105,1087,1432,345
2020,7,4,7,1080,1033,1315,282
2020,7,4,8,1045,987,1265,278
2020,7,4,9,1015,964,1272,308
2020,7,4,10,1010,965,1250,285
2020,7,4,11,1000,965,1265,300
2020,7,4,12,1020,952,1271,319
2020,7,4,13,1045,965,1259,294
2020,7,4,14,1100,1020,1257,237
2020,7,4,15,1170,1077,1285,208
2020,7,4,16,1215,1136,1314,178
2020,7,4,17,1250,1184,1438,254
2020,7,4,18,1275,1197,1331,134
2020,7,4,19,1285,1222,1640,418
2020,7,4,20,1310,1246,1927,681
2020,7,4,21,1320,1270,2034,764
2020,7,4,22,1335,1298,2119,821
2020,7,4,23,1350,1307,2145,838
2020,7,5,0,1345,1305,2131,826
2020,7,5,1,1335,1283,2132,849
2020,7,5,2,1285,1243,1927,684
2020,7,5,3,1245,1184,1625,441
2020,7,5,4,1200,1152,1496,344
2020,7,5,5,1175,1119,1460,341
2020,7,5,6,1110,1075,1302,227
2020,7,5,7,1060,1025,1288,263
2020,7,5,8,1020,982,1374,392
2020,7,5,9,1000,961,1292,331
2020,7,5,10,985,944,1314,370
2020,7,5,11,980,944,1287,343
2020,7,5,12,990,941,1275,334
2020,7,5,13,1040,949,1279,330
2020,7,5,14,1120,989,1293,304
2020,7,5,15,1190,1043,1327,284
2020,7,5,16,1230,1107,1307,200
2020,7,5,17,1275,1148,1326,178
2020,7,5,18,1290,1182,1493,311
2020,7,5,19,1310,1220,1537,317
2020,7,5,20,1300,1251,1868,617
2020,7,5,21,1305,1290,2062,772
2020,7,5,22,1310,1323,2164,841
2020,7,5,23,1330,1334,2184,850
2020,7,6,0,1325,1360,2282,922
2020,7,6,1,1315,1344,2263,919
2020,7,6,2,1290,1318,2189,871
2020,7,6,3,1280,1283,2115,832
2020,7,6,4,1230,1248,2029,781
2020,7,6,5,1205,1199,1989,790
2020,7,6,6,1130,1092,1607,515
2020,7,6,7,1040,1019,1292,273
2020,7,6,8,1000,997,1270,273
2020,7,6,9,995,976,1230,254
2020,7,6,10,995,978,1251,273
2020,7,6,11,1000,977,1257,280
2020,7,6,12,1005,1004,1241,237
2020,7,6,13,1105,1065,1246,181
2020,7,6,14,1215,1154,1333,179
2020,7,6,15,1275,1210,1455,245
2020,7,6,16,1310,1267,1402,135
2020,7,6,17,1335,1300,1425,125
2020,7,6,18,1350,1340,1398,58
2020,7,6,19,1350,1381,1558,177
2020,7,6,20,1345,1409,1701,292
2020,7,6,21,1335,1438,1707,269
2020,7,6,22,1330,1475,1811,336
2020,7,6,23,1335,1497,1956,459
2020,7,7,0,1335,1503,1936,433
2020,7,7,1,1315,1501,1873,372
2020,7,7,2,1300,1463,1742,279
2020,7,7,3,1280,1404,1534,130
2020,7,7,4,1240,1364,1380,16
2020,7,7,5,1220,1280,1447,167
2020,7,7,6,1140,1165,1407,242
2020,7,7,7,1010,1097,1403,306
2020,7,7,8,985,1048,1363,315
2020,7,7,9,970,1022,1354,332
2020,7,7,10,965,1006,1332,326
2020,7,7,11,960,1014,1281,267
2020,7,7,12,985,1043,1323,280
2020,7,7,13,1035,1102,1573,471
2020,7,7,14,1105,1195,1728,533
2020,7,7,15,1165,1243,1697,454
2020,7,7,16,1210,1279,1743,464
2020,7,7,17,1235,1321,1814,493
2020,7,7,18,1245,1348,1820,472
2020,7,7,19,1270,1353,1799,446
2020,7,7,20,1285,1365,1485,120
2020,7,7,21,1305,1387,1449,62
2020,7,7,22,1320,1404,1560,156
2020,7,7,23,1345,1383,1526,143
2020,7,8,0,1350,1364,1651,287
2020,7,8,1,1340,1379,1723,344
2020,7,8,2,1320,1327,1588,261
2020,7,8,3,1285,1296,1521,225
2020,7,8,4,1230,1274,1466,192
2020,7,8,5,1200,1220,1364,144
2020,7,8,6,1100,1118,1460,342
2020,7,8,7,1085,1059,1399,340
2020,7,8,8,1030,1031,1396,365
2020,7,8,9,1020,1010,1449,439
2020,7,8,10,1010,1020,1469,449
2020,7,8,11,1010,1028,1499,471
2020,7,8,12,1045,1045,1514,469
2020,7,8,13,1115,1107,1742,635
2020,7,8,14,1185,1194,1895,701
2020,7,8,15,1245,1224,1926,702
2020,7,8,16,1275,1267,2063,796
2020,7,8,17,1320,1305,2084,779
2020,7,8,18,1340,1323,2063,740
2020,7,8,19,1355,1333,2113,780
2020,7,8,20,1375,1355,2320,965
2020,7,8,21,1385,1362,2354,992
2020,7,8,22,1405,1385,2357,972
2020,7,8,23,1405,1416,2359,943
2020,7,9,0,1405,1435,2397,962
2020,7,9,1,1385,1444,2377,933
2020,7,9,2,1360,1391,2319,928
2020,7,9,3,1325,1330,2140,810
2020,7,9,4,1280,1306,2122,816
2020,7,9,5,1235,1225,1929,704
2020,7,9,6,1150,1135,1914,779
2020,7,9,7,1090,1065,1700,635
2020,7,9,8,1055,1024,1259,235
2020,7,9,9,1040,996,1202,206
2020,7,9,10,1035,985,1200,215
2020,7,9,11,1030,1004,1225,221
2020,7,9,12,1060,1028,1252,224
2020,7,9,13,1160,1114,1379,265
2020,7,9,14,1265,1197,1664,467
2020,7,9,15,1335,1245,1794,549
2020,7,9,16,1375,1278,1903,625
2020,7,9,17,1405,1305,1860,555
2020,7,9,18,1415,1343,1892,549
2020,7,9,19,1435,1361,2039,678
2020,7,9,20,1450,1396,1999,603
2020,7,9,21,1465,1412,1922,510
2020,7,9,22,1475,1463,2087,624
2020,7,9,23,1495,1489,2116,627
2020,7,10,0,1485,1506,2054,548
2020,7,10,1,1475,1496,2042,546
2020,7,10,2,1450,1463,2037,574
2020,7,10,3,1410,1403,2043,640
2020,7,10,4,1360,1354,1981,627
2020,7,10,5,1330,1278,1965,687
2020,7,10,6,1220,1171,1492,321
2020,7,10,7,1080,1095,1310,215
2020,7,10,8,1045,1045,1311,266
2020,7,10,9,1020,1030,1280,250
2020,7,10,10,1010,1033,1272,239
2020,7,10,11,1015,1030,1236,206
2020,7,10,12,1025,1059,1319,260
2020,7,10,13,1100,1107,1289,182
2020,7,10,14,1210,1199,1470,271
2020,7,10,15,1280,1266,1620,354
2020,7,10,16,1325,1299,1652,353
2020,7,10,17,1370,1311,1963,652
2020,7,10,18,1400,1319,2076,757
2020,7,10,19,1425,1336,2114,778
2020,7,10,20,1445,1361,2165,804
2020,7,10,21,1480,1360,2096,736
2020,7,10,22,1490,1394,2171,777
2020,7,10,23,1500,1415,2152,737
2020,7,11,0,1500,1429,2195,766
2020,7,11,1,1470,1415,2164,749
2020,7,11,2,1435,1384,2133,749
2020,7,11,3,1385,1340,2153,813
2020,7,11,4,1340,1308,2071,763
2020,7,11,5,1305,1259,2046,787
2020,7,11,6,1220,1162,1880,718
2020,7,11,7,1120,1085,1665,580
2020,7,11,8,1070,1046,1519,473
2020,7,11,9,1045,1008,1390,382
2020,7,11,10,1040,992,1366,374
2020,7,11,11,1045,995,1319,324
2020,7,11,12,1040,993,1307,314
2020,7,11,13,1085,1022,1315,293
2020,7,11,14,1165,1077,1427,350
2020,7,11,15,1225,1142,1566,424
2020,7,11,16,1285,1204,1586,382
2020,7,11,17,1330,1242,1664,422
2020,7,11,18,1355,1287,1854,567
2020,7,11,19,1375,1305,1921,616
2020,7,11,20,1405,1349,2041,692
2020,7,11,21,1420,1389,2062,673
2020,7,11,22,1450,1432,2071,639
2020,7,11,23,1470,1461,1951,490
2020,7,12,0,1470,1495,1776,281
2020,7,12,1,1450,1496,1730,234
2020,7,12,2,1405,1474,1657,183
2020,7,12,3,1345,1422,1610,188
2020,7,12,4,1310,1371,1577,206
2020,7,12,5,1260,1298,1540,242
2020,7,12,6,1200,1184,1377,193
2020,7,12,7,1105,1120,1282,162
2020,7,12,8,1065,1065,1344,279
2020,7,12,9,1040,1040,1336,296
2020,7,12,10,1025,1030,1315,285
2020,7,12,11,1025,1034,1336,302
2020,7,12,12,1030,1036,1358,322
2020,7,12,13,1035,1054,1380,326
2020,7,12,14,1070,1086,1328,242
2020,7,12,15,1130,1163,1412,249
2020,7,12,16,1185,1222,1530,308
2020,7,12,17,1225,1299,1584,285
2020,7,12,18,1260,1338,1622,284
2020,7,12,19,1290,1391,1812,421
2020,7,12,20,1310,1353,1769,416
2020,7,12,21,1335,1437,1821,384
2020,7,12,22,1370,1453,1906,453
2020,7,12,23,1385,1492,1973,481
2020,7,13,0,1405,1507,1996,489
2020,7,13,1,1390,1479,1974,495
2020,7,13,2,1360,1438,1882,444
2020,7,13,3,1325,1384,1843,459
2020,7,13,4,1280,1361,1844,483
2020,7,13,5,1230,1283,1778,495
2020,7,13,6,1140,1181,1435,254
2020,7,13,7,1055,1111,1303,192
2020,7,13,8,1030,1053,1246,193
2020,7,13,9,1010,1029,1278,249
2020,7,13,10,1010,1021,1237,216
2020,7,13,11,1015,1039,1345,306
2020,7,13,12,1035,1081,1492,411
2020,7,13,13,1075,1136,1727,591
2020,7,13,14,1135,1240,1980,740
2020,7,13,15,1190,1291,2040,749
2020,7,13,16,1235,1337,2102,765
2020,7,13,17,1265,1345,2193,848
2020,7,13,18,1300,1355,2204,849
2020,7,13,19,1330,1344,1801,457
2020,7,13,20,1350,1353,1394,41
2020,7,13,21,1370,1373,1301,-72
2020,7,13,22,1395,1388,1353,-35
2020,7,13,23,1415,1417,1760,343
2020,7,14,0,1420,1444,2038,594
2020,7,14,1,1415,1442,2046,604
2020,7,14,2,1385,1416,2040,624
2020,7,14,3,1335,1351,2055,704
2020,7,14,4,1270,1319,2016,697
2020,7,14,5,1225,1251,2004,753
2020,7,14,6,1125,1148,1904,756
2020,7,14,7,1085,1095,1911,816
2020,7,14,8,1040,1050,1726,676
2020,7,14,9,1015,1045,1687,642
2020,7,14,10,1005,1028,1680,652
2020,7,14,11,1010,1033,1707,674
2020,7,14,12,1040,1059,1704,645
2020,7,14,13,1100,1098,1684,586
2020,7,14,14,1175,1187,1836,649
2020,7,14,15,1230,1230,1743,513
2020,7,14,16,1270,1271,1780,509
2020,7,14,17,1315,1295,1940,645
2020,7,14,18,1340,1321,1979,658
2020,7,14,19,1355,1331,1983,652
2020,7,14,20,1355,1366,2046,680
2020,7,14,21,1390,1380,2039,659
2020,7,14,22,1400,1408,2015,607
2020,7,14,23,1395,1437,2142,705
2020,7,15,0,1380,1453,2189,736
2020,7,15,1,1385,1467,2171,704
2020,7,15,2,1335,1440,2111,671
2020,7,15,3,1305,1405,2168,763
2020,7,15,4,1270,1360,2105,745
2020,7,15,5,1230,1278,1933,655
2020,7,15,6,1130,1164,1767,603
2020,7,15,7,1085,1098,1646,548
2020,7,15,8,1045,1050,1509,459
2020,7,15,9,1025,1031,1438,407
2020,7,15,10,1030,1025,1445,420
2020,7,15,11,1040,1035,1470,435
2020,7,15,12,1065,1063,1546,483
2020,7,15,13,1155,1139,1772,633
2020,7,15,14,1270,1222,1923,701
2020,7,15,15,1315,1275,1918,643
2020,7,15,16,1355,1312,1967,655
2020,7,15,17,1390,1355,1999,644
2020,7,15,18,1405,1370,2075,705
2020,7,15,19,1410,1391,2193,802
2020,7,15,20,1430,1428,2201,773
2020,7,15,21,1435,1453,2222,769
2020,7,15,22,1455,1492,2213,721
2020,7,15,23,1485,1525,2274,749
2020,7,16,0,1500,1567,1635,68
2020,7,16,1,1500,1591,1697,106
2020,7,16,2,1455,1526,1722,196
2020,7,16,3,1400,1426,1650,224
2020,7,16,4,1350,1387,1632,245
2020,7,16,5,1300,1312,1668,356
2020,7,16,6,1195,1203,1745,542
2020,7,16,7,1120,1141,1800,659
2020,7,16,8,1085,1091,1737,646
2020,7,16,9,1060,1068,1789,721
2020,7,16,10,1050,1056,1779,723
2020,7,16,11,1065,1067,1773,706
2020,7,16,12,1090,1074,1764,690
2020,7,16,13,1200,1144,1733,589
2020,7,16,14,1315,1223,1672,449
2020,7,16,15,1375,1276,1707,431
2020,7,16,16,1410,1347,1818,471
2020,7,16,17,1440,1375,1876,501
2020,7,16,18,1475,1421,1952,531
2020,7,16,19,1490,1470,2060,590
2020,7,16,20,1525,1510,2102,592
2020,7,16,21,1545,1544,2154,610
2020,7,16,22,1585,1593,2173,580
2020,7,16,23,1615,1628,2186,558
2020,7,17,0,1630,1642,2161,519
2020,7,17,1,1625,1652,2117,465
2020,7,17,2,1590,1621,2128,507
2020,7,17,3,1530,1558,2054,496
2020,7,17,4,1450,1496,2010,514
2020,7,17,5,1400,1412,1967,555
2020,7,17,6,1285,1283,1682,399
2020,7,17,7,1115,1190,1479,289
2020,7,17,8,1065,1128,1377,249
2020,7,17,9,1045,1101,1443,342
2020,7,17,10,1040,1095,1386,291
2020,7,17,11,1045,1076,1377,301
2020,7,17,12,1070,1096,1328,232
2020,7,17,13,1160,1141,1344,203
2020,7,17,14,1275,1219,1370,151
2020,7,17,15,1345,1307,1555,248
2020,7,17,16,1385,1381,1839,458
2020,7,17,17,1415,1442,1781,339
2020,7,17,18,1435,1487,1597,110
2020,7,17,19,1450,1529,1627,98
2020,7,17,20,1485,1553,1568,15
2020,7,17,21,1505,1574,1625,51
2020,7,17,22,1540,1584,1588,4
2020,7,17,23,1565,1594,1914,320
2020,7,18,0,1590,1556,1903,347
2020,7,18,1,1595,1528,1881,353
2020,7,18,2,1545,1476,1864,388
2020,7,18,3,1465,1410,1901,491
2020,7,18,4,1390,1389,1818,429
2020,7,18,5,1365,1324,1720,396
2020,7,18,6,1255,1223,1469,246
2020,7,18,7,1145,1149,1359,210
2020,7,18,8,1105,1103,1361,258
2020,7,18,9,1075,1092,1367,275
2020,7,18,10,1060,1066,1300,234
2020,7,18,11,1065,1059,1362,303
2020,7,18,12,1065,1062,1395,333
2020,7,18,13,1065,1061,1353,292
2020,7,18,14,1090,1119,1439,320
2020,7,18,15,1150,1182,1458,276
2020,7,18,16,1215,1231,1455,224
2020,7,18,17,1250,1295,1614,319
2020,7,18,18,1290,1327,1631,304
2020,7,18,19,1310,1356,1859,503
2020,7,18,20,1350,1368,1997,629
2020,7,18,21,1385,1394,2011,617
2020,7,18,22,1425,1427,2043,616
2020,7,18,23,1455,1460,2090,630
2020,7,19,0,1480,1483,2081,598
2020,7,19,1,1480,1496,2159,663
2020,7,19,2,1455,1467,2138,671
2020,7,19,3,1400,1419,2122,703
2020,7,19,4,1350,1375,2135,760
2020,7,19,5,1280,1316,2142,826
2020,7,19,6,1180,1201,2062,861
2020,7,19,7,1160,1137,1943,806
2020,7,19,8,1105,1082,1839,757
2020,7,19,9,1085,1054,1609,555
2020,7,19,10,1070,1031,1451,420
2020,7,19,11,1075,1031,1472,441
2020,7,19,12,1080,1019,1426,407
2020,7,19,13,1085,1040,1436,396
2020,7,19,14,1110,1084,1455,371
2020,7,19,15,1180,1150,1555,405
2020,7,19,16,1240,1223,1709,486
2020,7,19,17,1305,1271,1759,488
2020,7,19,18,1345,1324,1847,523
2020,7,19,19,1395,1368,2013,645
2020,7,19,20,1380,1402,2136,734
2020,7,19,21,1445,1446,2180,734
2020,7,19,22,1470,1474,2164,690
2020,7,19,23,1505,1507,2167,660
2020,7,20,0,1520,1546,2159,613
2020,7,20,1,1500,1553,2167,614
2020,7,20,2,1465,1544,2201,657
2020,7,20,3,1410,1490,2172,682
2020,7,20,4,1360,1444,2180,736
2020,7,20,5,1305,1345,2153,808
2020,7,20,6,1200,1239,2151,912
2020,7,20,7,1170,1161,2055,894
2020,7,20,8,1110,1118,2005,887
2020,7,20,9,1085,1076,1868,792
2020,7,20,10,1075,1070,1891,821
2020,7,20,11,1095,1067,1791,724
2020,7,20,12,1130,1100,1916,816
2020,7,20,13,1205,1162,1944,782
2020,7,20,14,1325,1255,1940,685
2020,7,20,15,1380,1304,1879,575
2020,7,20,16,1435,1376,2027,651
2020,7,20,17,1450,1416,2064,648
2020,7,20,18,1475,1457,2254,797
2020,7,20,19,1490,1498,2250,752
2020,7,20,20,1510,1529,2240,711
2020,7,20,21,1535,1572,2229,657
2020,7,20,22,1560,1588,2187,599
2020,7,20,23,1590,1613,2191,578
2020,7,21,0,1610,1607,2189,582
2020,7,21,1,1605,1606,2198,592
2020,7,21,2,1575,1561,2211,650
2020,7,21,3,1510,1509,2230,721
2020,7,21,4,1450,1460,2230,770
2020,7,21,5,1385,1360,2195,835
2020,7,21,6,1270,1256,2115,859
2020,7,21,7,1145,1170,2029,859
2020,7,21,8,1095,1119,1715,596
2020,7,21,9,1075,1088,1608,520
2020,7,21,10,1060,1073,1515,442
2020,7,21,11,1065,1064,1505,441
2020,7,21,12,1085,1111,1558,447
2020,7,21,13,1200,1151,1591,440
2020,7,21,14,1365,1252,1904,652
2020,7,21,15,1420,1327,1983,656
2020,7,21,16,1475,1362,2048,686
2020,7,21,17,1440,1421,2074,653
2020,7,21,18,1545,1478,2082,604
2020,7,21,19,1565,1523,2122,599
2020,7,21,20,1595,1565,2150,585
2020,7,21,21,1625,1624,2158,534
2020,7,21,22,1655,1655,2170,515
2020,7,21,23,1680,1683,2175,492
2020,7,22,0,1695,1703,2177,474
2020,7,22,1,1710,1702,2198,496
2020,7,22,2,1680,1674,2171,497
2020,7,22,3,1635,1619,2154,535
2020,7,22,4,1530,1562,2105,543
2020,7,22,5,1490,1447,2068,621
2020,7,22,6,1360,1307,1852,545
2020,7,22,7,1130,1218,1584,366
2020,7,22,8,1085,1162,1511,349
2020,7,22,9,1060,1121,1493,372
2020,7,22,10,1055,1101,1475,374
2020,7,22,11,1065,1099,1280,181
2020,7,22,12,1095,1126,1288,162
2020,7,22,13,1210,1178,1310,132
2020,7,22,14,1340,1272,1670,398
2020,7,22,15,1395,1353,1864,511
2020,7,22,16,1445,1423,1983,560
2020,7,22,17,1485,1485,2077,592
2020,7,22,18,1510,1532,2086,554
2020,7,22,19,1535,1597,2066,469
2020,7,22,20,1570,1664,2010,346
2020,7,22,21,1600,1696,1975,279
2020,7,22,22,1635,1723,1967,244
2020,7,22,23,1665,1721,1944,223
2020,7,23,0,1700,1712,2032,320
2020,7,23,1,1720,1677,2075,398
2020,7,23,2,1655,1612,2041,429
2020,7,23,3,1565,1552,1971,419
2020,7,23,4,1480,1522,1908,386
2020,7,23,5,1435,1414,1858,444
2020,7,23,6,1310,1305,1638,333
2020,7,23,7,1175,1222,1380,158
2020,7,23,8,1130,1174,1320,146
2020,7,23,9,1105,1141,1290,149
2020,7,23,10,1090,1126,1379,253
2020,7,23,11,1100,1131,1419,288
2020,7,23,12,1115,1158,1413,255
2020,7,23,13,1145,1218,1474,256
2020,7,23,14,1180,1301,1559,258
2020,7,23,15,1240,1355,1621,266
2020,7,23,16,1295,1410,1894,484
2020,7,23,17,1325,1446,1946,500
2020,7,23,18,1370,1461,1872,411
2020,7,23,19,1415,1494,1920,426
2020,7,23,20,1450,1525,2030,505
2020,7,23,21,1485,1541,2012,471
2020,7,23,22,1530,1518,1986,468
2020,7,23,23,1560,1524,2052,528
2020,7,24,0,1575,1532,2066,534
2020,7,24,1,1580,1483,1940,457
2020,7,24,2,1550,1423,1986,563
2020,7,24,3,1490,1382,1995,613
2020,7,24,4,1440,1363,2001,638
2020,7,24,5,1345,1299,1895,596
2020,7,24,6,1225,1213,1704,491
2020,7,24,7,1210,1152,1388,236
2020,7,24,8,1155,1116,1410,294
2020,7,24,9,1125,1089,1412,323
2020,7,24,10,1120,1070,1385,315
2020,7,24,11,1105,1082,1320,238
2020,7,24,12,1130,1095,1356,261
2020,7,24,13,1160,1149,1352,203
2020,7,24,14,1230,1228,1415,187
2020,7,24,15,1315,1291,1627,336
2020,7,24,16,1380,1338,1686,348
2020,7,24,17,1435,1395,1666,271
2020,7,24,18,1475,1426,1664,238
2020,7,24,19,1520,1477,1816,339
2020,7,24,20,1550,1504,1866,362
2020,7,24,21,1570,1550,1964,414
2020,7,24,22,1585,1562,1898,336
2020,7,24,23,1595,1579,1794,215
2020,7,25,0,1570,1569,1796,227
2020,7,25,1,1540,1546,1759,213
2020,7,25,2,1490,1516,1982,466
2020,7,25,3,1425,1456,1922,466
2020,7,25,4,1380,1426,1929,503
2020,7,25,5,1335,1357,1940,583
2020,7,25,6,1235,1240,1632,392
2020,7,25,7,1145,1155,1526,371
2020,7,25,8,1100,1100,1461,361
2020,7,25,9,1080,1080,1539,459
2020,7,25,10,1055,1046,1500,454
2020,7,25,11,1055,1047,1515,468
2020,7,25,12,1060,1049,1525,476
2020,7,25,13,1080,1059,1481,422
2020,7,25,14,1140,1101,1452,351
2020,7,25,15,1200,1175,1508,333
2020,7,25,16,1250,1236,1718,482
2020,7,25,17,1305,1293,1934,641
2020,7,25,18,1335,1321,1960,639
2020,7,25,19,1360,1350,1961,611
2020,7,25,20,1380,1365,1945,580
2020,7,25,21,1400,1387,2044,657
2020,7,25,22,1430,1423,2052,629
2020,7,25,23,1450,1447,2029,582
2020,7,26,0,1475,1467,1999,532
2020,7,26,1,1475,1464,2059,595
2020,7,26,2,1440,1433,2057,624
2020,7,26,3,1390,1385,2043,658
2020,7,26,4,1340,1356,1895,539
2020,7,26,5,1290,1274,1802,528
2020,7,26,6,1185,1184,1779,595
2020,7,26,7,1145,1119,1702,583
2020,7,26,8,1090,1058,1536,478
2020,7,26,9,1065,1045,1469,424
2020,7,26,10,1045,1023,1454,431
2020,7,26,11,1045,1021,1467,446
2020,7,26,12,1045,1025,1447,422
2020,7,26,13,1080,1021,1352,331
2020,7,26,14,1135,1084,1207,123
2020,7,26,15,1200,1140,1334,194
2020,7,26,16,1270,1203,1496,293
2020,7,26,17,1320,1245,1662,417
2020,7,26,18,1360,1308,1699,391
2020,7,26,19,1400,1334,1812,478
2020,7,26,20,1420,1372,1990,618
2020,7,26,21,1465,1417,2019,602
2020,7,26,22,1480,1465,2018,553
2020,7,26,23,1510,1509,2013,504
2020,7,27,0,1540,1553,2025,472
2020,7,27,1,1530,1568,2059,491
2020,7,27,2,1505,1550,2093,543
2020,7,27,3,1450,1527,2099,572
2020,7,27,4,1375,1456,2098,642
2020,7,27,5,1325,1352,2066,714
2020,7,27,6,1225,1241,1916,675
2020,7,27,7,1160,1162,1837,675
2020,7,27,8,1115,1098,1723,625
2020,7,27,9,1070,1078,1583,505
2020,7,27,10,1065,1053,1420,367
2020,7,27,11,1065,1060,1430,370
2020,7,27,12,1105,1096,1495,399
2020,7,27,13,1220,1147,1503,356
2020,7,27,14,1375,1240,1625,385
2020,7,27,15,1430,1310,1783,473
2020,7,27,16,1500,1366,1926,560
2020,7,27,17,1525,1417,1972,555
2020,7,27,18,1565,1469,1992,523
2020,7,27,19,1600,1531,2007,476
2020,7,27,20,1630,1572,2009,437
2020,7,27,21,1665,1629,2092,463
2020,7,27,22,1675,1665,2114,449
2020,7,27,23,1695,1701,2099,398
2020,7,28,0,1700,1714,2103,389
2020,7,28,1,1690,1708,2109,401
2020,7,28,2,1640,1678,2130,452
2020,7,28,3,1580,1614,2141,527
2020,7,28,4,1480,1547,2113,566
2020,7,28,5,1440,1442,2024,582
2020,7,28,6,1330,1308,1939,631
2020,7,28,7,1155,1231,1721,490
2020,7,28,8,1110,1160,1542,382
2020,7,28,9,1085,1127,1309,182
2020,7,28,10,1070,1113,1242,129
2020,7,28,11,1065,1114,1235,121
2020,7,28,12,1095,1138,1245,107
2020,7,28,13,1140,1193,1261,68
2020,7,28,14,1240,1281,1662,381
2020,7,28,15,1305,1361,1897,536
2020,7,28,16,1350,1404,1883,479
2020,7,28,17,1400,1462,1884,422
2020,7,28,18,1455,1502,1867,365
2020,7,28,19,1495,1545,1837,292
2020,7,28,20,1530,1599,1926,327
2020,7,28,21,1580,1657,1924,267
2020,7,28,22,1615,1673,1959,286
2020,7,28,23,1650,1699,1938,239
2020,7,29,0,1675,1691,1973,282
2020,7,29,1,1680,1654,1959,305
2020,7,29,2,1655,1595,1975,380
2020,7,29,3,1605,1546,1958,412
2020,7,29,4,1530,1481,1872,391
2020,7,29,5,1435,1388,1805,417
2020,7,29,6,1305,1273,1520,247
2020,7,29,7,1235,1199,1317,118
2020,7,29,8,1180,1157,1333,176
2020,7,29,9,1140,1130,1347,217
2020,7,29,10,1125,1119,1341,222
2020,7,29,11,1125,1117,1407,290
2020,7,29,12,1155,1158,1577,419
2020,7,29,13,1200,1212,1597,385
2020,7,29,14,1280,1282,1726,444
2020,7,29,15,1360,1329,1780,451
2020,7,29,16,1420,1383,1835,452
2020,7,29,17,1485,1452,1945,493
2020,7,29,18,1525,1511,1955,444
2020,7,29,19,1585,1551,1965,414
2020,7,29,20,1650,1610,1950,340
2020,7,29,21,1680,1615,1981,366
2020,7,29,22,1710,1636,2004,368
2020,7,29,23,1715,1644,2026,382
2020,7,30,0,1710,1642,1968,326
2020,7,30,1,1685,1612,1949,337
2020,7,30,2,1620,1564,1949,385
2020,7,30,3,1555,1523,2026,503
2020,7,30,4,1500,1490,2023,533
2020,7,30,5,1415,1390,1915,525
2020,7,30,6,1305,1288,1991,703
2020,7,30,7,1220,1216,1958,742
2020,7,30,8,1165,1173,1783,610
2020,7,30,9,1130,1134,1765,631
2020,7,30,10,1115,1122,1717,595
2020,7,30,11,1120,1120,1689,569
2020,7,30,12,1145,1143,1696,553
2020,7,30,13,1255,1204,1732,528
2020,7,30,14,1385,1281,1938,657
2020,7,30,15,1450,1316,1937,621
2020,7,30,16,1505,1410,1966,556
2020,7,30,17,1545,1475,1996,521
2020,7,30,18,1575,1531,1764,233
2020,7,30,19,1615,1611,1455,-156
2020,7,30,20,1650,1653,1400,-253
2020,7,30,21,1675,1705,1385,-320
2020,7,30,22,1670,1726,1411,-315
2020,7,30,23,1685,1750,1338,-412
2020,7,31,0,1695,1758,1351,-407
2020,7,31,1,1655,1738,1327,-411
2020,7,31,2,1595,1697,1313,-384
2020,7,31,3,1545,1659,1315,-344
2020,7,31,4,1490,1596,1270,-326
2020,7,31,5,1425,1495,1284,-211
2020,7,31,6,1325,1364,1297,-67
2020,7,31,7,1200,1272,1314,42
2020,7,31,8,1160,1211,1235,24
2020,7,31,9,1130,1167,1103,-64
2020,7,31,10,1115,1139,1116,-23
2020,7,31,11,1120,1141,1121,-20
2020,7,31,12,1140,1166,1102,-64
2020,7,31,13,1215,1201,1126,-75
2020,7,31,14,1310,1284,1236,-48
2020,7,31,15,1375,1362,1259,-103
2020,7,31,16,1430,1439,1266,-173
2020,7,31,17,1495,1498,1281,-217
2020,7,31,18,1540,1554,1312,-242
2020,7,31,19,1590,1607,1349,-258
2020,7,31,20,1625,1650,1390,-260
2020,7,31,21,1655,1691,1402,-289
2020,7,31,22,1675,1722,1418,-304
2020,7,31,23,1690,1750,1447,-303
2020,8,1,0,1675,1751,1464,-287
2020,8,1,1,1645,1730,1509,-221
2020,8,1,2,1605,1676,1561,-115
2020,8,1,3,1540,1616,1525,-91
2020,8,1,4,1500,1561,1484,-77
2020,8,1,5,1430,1474,1500,26
2020,8,1,6,1315,1356,1443,87
2020,8,1,7,1215,1286,1406,120
2020,8,1,8,1160,1209,1244,35
2020,8,1,9,1130,1162,1123,-39
2020,8,1,10,1100,1136,1133,-3
2020,8,1,11,1100,1121,1121,0
2020,8,1,12,1110,1122,1138,16
2020,8,1,13,1165,1124,1122,-2
2020,8,1,14,1255,1189,1239,50
2020,8,1,15,1330,1253,1208,-45
2020,8,1,16,1400,1372,1315,-57
2020,8,1,17,1460,1424,1296,-128
2020,8,1,18,1505,1487,1323,-164
2020,8,1,19,1545,1542,1356,-186
2020,8,1,20,1565,1572,1390,-182
2020,8,1,21,1590,1626,1412,-214
2020,8,1,22,1630,1652,1462,-190
2020,8,1,23,1660,1672,1449,-223
2020,8,2,0,1680,1670,1480,-190
2020,8,2,1,1675,1662,1515,-147
2020,8,2,2,1640,1607,1470,-137
2020,8,2,3,1585,1571,1467,-104
2020,8,2,4,1520,1531,1435,-96
2020,8,2,5,1460,1445,1470,25
2020,8,2,6,1340,1333,1485,152
2020,8,2,7,1210,1269,1402,133
2020,8,2,8,1150,1190,1135,-55
2020,8,2,9,1130,1178,1069,-109
2020,8,2,10,1110,1152,1054,-98
2020,8,2,11,1110,1140,1067,-73
2020,8,2,12,1115,1138,1051,-87
2020,8,2,13,1125,1158,1001,-157
2020,8,2,14,1190,1189,1024,-165
2020,8,2,15,1245,1287,1057,-230
2020,8,2,16,1320,1361,1017,-344
2020,8,2,17,1370,1434,1140,-294
2020,8,2,18,1435,1468,1157,-311
2020,8,2,19,1475,1530,1236,-294
2020,8,2,20,1510,1583,1476,-107
2020,8,2,21,1560,1634,1680,46
2020,8,2,22,1600,1685,1741,56
2020,8,2,23,1645,1729,1983,254
2020,8,3,0,1685,1764,2026,262
2020,8,3,1,1690,1773,2129,356
2020,8,3,2,1670,1740,2139,399
2020,8,3,3,1635,1674,2116,442
2020,8,3,4,1540,1612,2036,424
2020,8,3,5,1460,1490,1940,450
2020,8,3,6,1335,1356,1827,471
2020,8,3,7,1220,1263,1531,268
2020,8,3,8,1165,1210,1316,106
2020,8,3,9,1135,1171,1290,119
2020,8,3,10,1120,1137,1266,129
2020,8,3,11,1120,1140,1280,140
2020,8,3,12,1160,1154,1277,123
2020,8,3,13,1215,1217,1389,172
2020,8,3,14,1305,1307,1500,193
2020,8,3,15,1365,1359,1502,143
2020,8,3,16,1435,1435,1766,331
2020,8,3,17,1485,1511,1869,358
2020,8,3,18,1545,1557,1853,296
2020,8,3,19,1610,1584,1874,290
2020,8,3,20,1650,1614,2013,399
2020,8,3,21,1705,1629,1936,307
2020,8,3,22,1740,1670,2012,342
2020,8,3,23,1770,1716,2024,308
2020,8,4,0,1780,1723,2061,338
2020,8,4,1,1775,1681,2017,336
2020,8,4,2,1735,1609,1862,253
2020,8,4,3,1675,1546,1785,239
2020,8,4,4,1600,1477,1785,308
2020,8,4,5,1505,1356,1704,348
2020,8,4,6,1370,1259,1647,388
2020,8,4,7,1195,1185,1507,322
2020,8,4,8,1135,1140,1706,566
2020,8,4,9,1110,1120,1616,496
2020,8,4,10,1095,1094,1580,486
2020,8,4,11,1090,1100,1611,511
2020,8,4,12,1110,1118,1734,616
2020,8,4,13,1155,1177,1847,670
2020,8,4,14,1225,1251,1836,585
2020,8,4,15,1300,1331,1904,573
2020,8,4,16,1350,1382,1929,547
2020,8,4,17,1410,1431,2001,570
2020,8,4,18,1450,1485,1945,460
2020,8,4,19,1500,1522,1987,465
2020,8,4,20,1545,1562,1999,437
2020,8,4,21,1600,1598,2006,408
2020,8,4,22,1625,1628,2034,406
2020,8,4,23,1655,1657,2031,374
2020,8,5,0,1660,1657,2074,417
2020,8,5,1,1630,1661,2106,445
2020,8,5,2,1590,1633,2165,532
2020,8,5,3,1535,1564,2145,581
2020,8,5,4,1450,1516,2109,593
2020,8,5,5,1375,1406,2086,680
2020,8,5,6,1260,1278,2034,756
2020,8,5,7,1175,1197,1930,733
2020,8,5,8,1130,1145,1857,712
2020,8,5,9,1095,1107,1719,612
2020,8,5,10,1080,1086,1631,545
2020,8,5,11,1080,1090,1565,475
2020,8,5,12,1110,1128,1592,464
2020,8,5,13,1200,1182,1814,632
2020,8,5,14,1305,1273,1887,614
2020,8,5,15,1355,1327,1934,607
2020,8,5,16,1415,1373,1915,542
2020,8,5,17,1490,1433,1912,479
2020,8,5,18,1545,1486,1921,435
2020,8,5,19,1590,1531,1958,427
2020,8,5,20,1640,1592,1971,379
2020,8,5,21,1655,1642,1983,341
2020,8,5,22,1680,1678,1985,307
2020,8,5,23,1695,1713,2037,324
2020,8,6,0,1690,1708,2057,349
2020,8,6,1,1655,1677,2058,381
2020,8,6,2,1600,1640,2073,433
2020,8,6,3,1555,1585,2039,454
2020,8,6,4,1470,1544,2030,486
2020,8,6,5,1405,1423,1954,531
2020,8,6,6,1300,1292,1544,252
2020,8,6,7,1155,1197,1353,156
2020,8,6,8,1120,1153,1263,110
2020,8,6,9,1085,1097,1208,111
2020,8,6,10,1070,1097,1186,89
2020,8,6,11,1070,1092,1178,86
2020,8,6,12,1095,1116,1227,111
2020,8,6,13,1160,1180,1305,125
2020,8,6,14,1235,1245,1330,85
2020,8,6,15,1280,1309,1411,102
2020,8,6,16,1355,1374,1673,299
2020,8,6,17,1410,1434,1812,378
2020,8,6,18,1470,1479,1749,270
2020,8,6,19,1525,1547,1757,210
2020,8,6,20,1565,1581,1853,272
2020,8,6,21,1605,1637,1972,335
2020,8,6,22,1625,1649,1909,260
2020,8,6,23,1645,1649,1902,253
2020,8,7,0,1650,1582,1698,116
2020,8,7,1,1630,1523,1713,190
2020,8,7,2,1590,1481,1569,88
2020,8,7,3,1550,1445,1633,188
2020,8,7,4,1470,1406,1484,78
2020,8,7,5,1400,1311,1474,163
2020,8,7,6,1280,1207,1307,100
2020,8,7,7,1185,1147,1232,85
2020,8,7,8,1135,1103,1306,203
2020,8,7,9,1100,1087,1348,261
2020,8,7,10,1075,1080,1348,268
2020,8,7,11,1080,1070,1352,282
2020,8,7,12,1105,1090,1556,466
2020,8,7,13,1115,1155,1860,705
2020,8,7,14,1165,1228,1972,744
2020,8,7,15,1230,1291,2004,713
2020,8,7,16,1290,1333,2115,782
2020,8,7,17,1345,1393,2093,700
2020,8,7,18,1390,1419,2094,675
2020,8,7,19,1435,1437,2154,717
2020,8,7,20,1480,1465,2204,739
2020,8,7,21,1520,1496,2285,789
2020,8,7,22,1545,1504,2241,737
2020,8,7,23,1570,1522,2287,765
2020,8,8,0,1565,1524,2255,731
2020,8,8,1,1545,1508,2212,704
2020,8,8,2,1500,1481,2163,682
2020,8,8,3,1450,1429,2159,730
2020,8,8,4,1370,1381,2087,706
2020,8,8,5,1315,1280,1918,638
2020,8,8,6,1210,1172,1761,589
2020,8,8,7,1175,1108,1736,628
2020,8,8,8,1110,1055,1411,356
2020,8,8,9,1070,1029,1324,295
2020,8,8,10,1050,1007,1294,287
2020,8,8,11,1040,1012,1306,294
2020,8,8,12,1045,1026,1306,280
2020,8,8,13,1055,1036,1320,284
2020,8,8,14,1110,1078,1308,230
2020,8,8,15,1170,1146,1428,282
2020,8,8,16,1260,1187,1427,240
2020,8,8,17,1310,1240,1470,230
2020,8,8,18,1360,1265,1483,218
2020,8,8,19,1415,1303,1545,242
2020,8,8,20,1440,1340,1874,534
2020,8,8,21,1485,1354,1927,573
2020,8,8,22,1510,1384,1916,532
2020,8,8,23,1525,1427,2027,600
2020,8,9,0,1515,1434,1971,537
2020,8,9,1,1495,1451,1764,313
2020,8,9,2,1450,1425,1709,284
2020,8,9,3,1415,1379,1757,378
2020,8,9,4,1350,1334,1610,276
2020,8,9,5,1300,1255,1525,270
2020,8,9,6,1200,1165,1428,263
2020,8,9,7,1120,1106,1411,305
2020,8,9,8,1060,1059,1298,239
2020,8,9,9,1045,1029,1270,241
2020,8,9,10,1030,1015,1218,203
2020,8,9,11,1020,1015,1177,162
2020,8,9,12,1025,1012,1192,180
2020,8,9,13,1010,1027,1237,210
2020,8,9,14,1010,1067,1416,349
2020,8,9,15,1080,1124,1507,383
2020,8,9,16,1140,1200,1868,668
2020,8,9,17,1195,1242,2019,777
2020,8,9,18,1230,1280,2068,788
2020,8,9,19,1280,1301,2068,767
2020,8,9,20,1320,1322,2023,701
2020,8,9,21,1360,1341,2019,678
2020,8,9,22,1390,1372,2024,652
2020,8,9,23,1425,1406,2045,639
2020,8,10,0,1440,1446,2047,601
2020,8,10,1,1430,1442,2112,670
2020,8,10,2,1405,1414,2127,713
2020,8,10,3,1360,1358,2057,699
2020,8,10,4,1280,1342,2075,733
2020,8,10,5,1215,1236,2046,810
2020,8,10,6,1110,1141,1901,760
2020,8,10,7,1140,1075,1810,735
2020,8,10,8,1090,1039,1824,785
2020,8,10,9,1055,1022,1800,778
2020,8,10,10,1030,1006,1796,790
2020,8,10,11,1035,1009,1813,804
2020,8,10,12,1050,1058,1836,778
2020,8,10,13,1120,1113,1917,804
2020,8,10,14,1205,1191,1907,716
2020,8,10,15,1260,1248,1951,703
2020,8,10,16,1320,1301,2078,777
2020,8,10,17,1385,1337,2014,677
2020,8,10,18,1430,1367,2022,655
2020,8,10,19,1470,1401,2066,665
2020,8,10,20,1495,1450,2033,583
2020,8,10,21,1525,1485,2027,542
2020,8,10,22,1560,1536,2035,499
2020,8,10,23,1590,1563,2065,502
2020,8,11,0,1585,1598,2108,510
2020,8,11,1,1545,1606,2152,546
2020,8,11,2,1495,1572,2126,554
2020,8,11,3,1435,1516,2038,522
2020,8,11,4,1360,1456,2000,544
2020,8,11,5,1270,1337,1923,586
2020,8,11,6,1170,1222,1846,624
2020,8,11,7,1180,1151,1825,674
2020,8,11,8,1125,1096,1437,341
2020,8,11,9,1105,1065,1279,214
2020,8,11,10,1080,1058,1397,339
2020,8,11,11,1085,1049,1421,372
2020,8,11,12,1100,1077,1441,364
2020,8,11,13,1175,1141,1630,489
2020,8,11,14,1270,1210,1702,492
2020,8,11,15,1350,1281,1920,639
2020,8,11,16,1405,1330,1925,595
2020,8,11,17,1455,1394,1989,595
2020,8,11,18,1510,1438,2025,587
2020,8,11,19,1545,1495,2069,574
2020,8,11,20,1580,1519,2083,564
2020,8,11,21,1620,1593,2138,545
2020,8,11,22,1650,1632,2135,503
2020,8,11,23,1680,1669,2131,462
2020,8,12,0,1690,1684,2132,448
2020,8,12,1,1685,1670,2133,463
2020,8,12,2,1650,1624,2019,395
2020,8,12,3,1585,1522,1975,453
2020,8,12,4,1500,1463,1983,520
2020,8,12,5,1425,1338,1818,480
2020,8,12,6,1300,1210,1503,293
2020,8,12,7,1165,1133,1313,180
2020,8,12,8,1115,1085,1204,119
2020,8,12,9,1090,1056,1188,132
2020,8,12,10,1070,1040,1283,243
2020,8,12,11,1075,1048,1337,289
2020,8,12,12,1115,1082,1384,302
2020,8,12,13,1150,1146,1440,294
2020,8,12,14,1220,1209,1403,194
2020,8,12,15,1270,1275,1547,272
2020,8,12,16,1320,1317,1597,280
2020,8,12,17,1375,1368,1729,361
2020,8,12,18,1425,1409,1710,301
2020,8,12,19,1465,1441,1790,349
2020,8,12,20,1525,1484,1879,395
2020,8,12,21,1565,1520,1893,373
2020,8,12,22,1600,1533,1932,399
2020,8,12,23,1625,1529,1945,416
2020,8,13,0,1630,1521,2050,529
2020,8,13,1,1605,1488,1964,476
2020,8,13,2,1570,1432,1809,377
2020,8,13,3,1520,1405,1973,568
2020,8,13,4,1470,1364,1885,521
2020,8,13,5,1360,1288,1921,633
2020,8,13,6,1240,1190,1876,686
2020,8,13,7,1090,1126,1799,673
2020,8,13,8,1055,1093,1668,575
2020,8,13,9,1005,1083,1631,548
2020,8,13,10,1005,1060,1516,456
2020,8,13,11,1000,1056,1561,505
2020,8,13,12,1025,1092,1611,519
2020,8,13,13,1075,1162,1748,586
2020,8,13,14,1130,1235,1910,675
2020,8,13,15,1185,1275,1985,710
2020,8,13,16,1245,1313,2053,740
2020,8,13,17,1295,1336,2057,721
2020,8,13,18,1345,1361,2025,664
2020,8,13,19,1405,1380,2023,643
2020,8,13,20,1435,1405,2033,628
2020,8,13,21,1490,1444,2094,650
2020,8,13,22,1505,1454,2091,637
2020,8,13,23,1515,1454,2122,668
2020,8,14,0,1480,1441,2062,621
2020,8,14,1,1440,1402,2070,668
2020,8,14,2,1400,1365,2032,667
2020,8,14,3,1355,1335,1988,653
2020,8,14,4,1290,1313,2028,715
2020,8,14,5,1220,1228,1872,644
2020,8,14,6,1120,1135,1804,669
2020,8,14,7,1060,1086,1754,668
2020,8,14,8,1015,1045,1592,547
2020,8,14,9,990,1025,1647,622
2020,8,14,10,970,1022,1663,641
2020,8,14,11,970,1025,1681,656
2020,8,14,12,1000,1065,1746,681
2020,8,14,13,1080,1104,1728,624
2020,8,14,14,1180,1197,1957,760
2020,8,14,15,1235,1242,1986,744
2020,8,14,16,1285,1271,2043,772
2020,8,14,17,1340,1287,2065,778
2020,8,14,18,1370,1309,2137,828
2020,8,14,19,1395,1326,2204,878
2020,8,14,20,1425,1347,2185,838
2020,8,14,21,1460,1369,2206,837
2020,8,14,22,1470,1404,2263,859
2020,8,14,23,1485,1429,2220,791
2020,8,15,0,1485,1434,2221,787
2020,8,15,1,1465,1453,2206,753
2020,8,15,2,1430,1403,2199,796
2020,8,15,3,1380,1359,2082,723
2020,8,15,4,1350,1318,2059,741
2020,8,15,5,1250,1224,1967,743
2020,8,15,6,1145,1152,1897,745
2020,8,15,7,1115,1097,1842,745
2020,8,15,8,1065,1048,1742,694
2020,8,15,9,1045,1023,1707,684
2020,8,15,10,1025,1007,1735,728
2020,8,15,11,1020,1012,1789,777
2020,8,15,12,1040,1015,1819,804
2020,8,15,13,1140,1026,1828,802
2020,8,15,14,1255,1083,1849,766
2020,8,15,15,1320,1146,1846,700
2020,8,15,16,1370,1188,1866,678
2020,8,15,17,1405,1230,1955,725
2020,8,15,18,1440,1279,2006,727
2020,8,15,19,1470,1304,2034,730
2020,8,15,20,1500,1351,2097,746
2020,8,15,21,1530,1389,2133,744
2020,8,15,22,1550,1430,2134,704
2020,8,15,23,1570,1471,2128,657
2020,8,16,0,1565,1515,2149,634
2020,8,16,1,1550,1535,2213,678
2020,8,16,2,1515,1514,2129,615
2020,8,16,3,1475,1472,2118,646
2020,8,16,4,1430,1409,2092,683
2020,8,16,5,1360,1300,2042,742
2020,8,16,6,1260,1208,1977,769
2020,8,16,7,1140,1111,1915,804
2020,8,16,8,1085,1060,1784,724
2020,8,16,9,1060,1037,1807,770
2020,8,16,10,1040,1029,1905,876
2020,8,16,11,1040,1012,1876,864
2020,8,16,12,1045,1021,1917,896
2020,8,16,13,1130,1033,1931,898
2020,8,16,14,1235,1080,1916,836
2020,8,16,15,1305,1146,1908,762
2020,8,16,16,1375,1193,1958,765
2020,8,16,17,1425,1242,1966,724
2020,8,16,18,1460,1298,1974,676
2020,8,16,19,1490,1359,2000,641
2020,8,16,20,1515,1415,2115,700
2020,8,16,21,1545,1473,2164,691
2020,8,16,22,1580,1553,2197,644
2020,8,16,23,1610,1609,2187,578
2020,8,17,0,1640,1637,2142,505
2020,8,17,1,1630,1638,2130,492
2020,8,17,2,1595,1607,2107,500
2020,8,17,3,1540,1550,2121,571
2020,8,17,4,1460,1481,2077,596
2020,8,17,5,1395,1334,1922,588
2020,8,17,6,1285,1209,1758,549
2020,8,17,7,1210,1147,1804,657
2020,8,17,8,1165,1090,1807,717
2020,8,17,9,1145,1057,1797,740
2020,8,17,10,1120,1046,1738,692
2020,8,17,11,1125,1044,1733,689
2020,8,17,12,1165,1083,1785,702
2020,8,17,13,1255,1151,1874,723
2020,8,17,14,1375,1235,1940,705
2020,8,17,15,1430,1321,1959,638
2020,8,17,16,1490,1372,1966,594
2020,8,17,17,1535,1422,1972,550
2020,8,17,18,1570,1492,2036,544
2020,8,17,19,1605,1560,2105,545
2020,8,17,20,1650,1633,2155,522
2020,8,17,21,1690,1712,2259,547
2020,8,17,22,1735,1764,2307,543
2020,8,17,23,1765,1809,2240,431
2020,8,18,0,1785,1806,2202,396
2020,8,18,1,1775,1797,2152,355
2020,8,18,2,1730,1726,2108,382
2020,8,18,3,1670,1675,2075,400
2020,8,18,4,1550,1566,2047,481
2020,8,18,5,1485,1425,1981,556
2020,8,18,6,1360,1308,1936,628
2020,8,18,7,1150,1222,1953,731
2020,8,18,8,1100,1174,1951,777
2020,8,18,9,1070,1135,1932,797
2020,8,18,10,1060,1118,1905,787
2020,8,18,11,1050,1106,1881,775
2020,8,18,12,1075,1137,1862,725
2020,8,18,13,1150,1206,1900,694
2020,8,18,14,1245,1269,1964,695
2020,8,18,15,1315,1339,1954,615
2020,8,18,16,1370,1380,1825,445
2020,8,18,17,1430,1438,1873,435
2020,8,18,18,1480,1498,1940,442
2020,8,18,19,1540,1550,1999,449
2020,8,18,20,1570,1589,2025,436
2020,8,18,21,1640,1633,2039,406
2020,8,18,22,1690,1661,2025,364
2020,8,18,23,1730,1701,2032,331
2020,8,19,0,1750,1707,2114,407
2020,8,19,1,1740,1692,2151,459
2020,8,19,2,1700,1638,2148,510
2020,8,19,3,1605,1567,2063,496
2020,8,19,4,1520,1496,1953,457
2020,8,19,5,1405,1372,1914,542
2020,8,19,6,1280,1262,1892,630
2020,8,19,7,1235,1171,1520,349
2020,8,19,8,1180,1116,1399,283
2020,8,19,9,1145,1091,1309,218
2020,8,19,10,1085,1070,1295,225
2020,8,19,11,1125,1075,1300,225
2020,8,19,12,1175,1108,1336,228
2020,8,19,13,1235,1171,1624,453
2020,8,19,14,1310,1241,1567,326
2020,8,19,15,1385,1295,1863,568
2020,8,19,16,1430,1343,1998,655
2020,8,19,17,1485,1382,2033,651
2020,8,19,18,1540,1412,2113,701
2020,8,19,19,1585,1462,2113,651
2020,8,19,20,1640,1508,2130,622
2020,8,19,21,1685,1579,2156,577
2020,8,19,22,1710,1604,2134,530
2020,8,19,23,1720,1635,2091,456
2020,8,20,0,1715,1637,2071,434
2020,8,20,1,1680,1611,2060,449
2020,8,20,2,1620,1552,2048,496
2020,8,20,3,1585,1517,2049,532
2020,8,20,4,1510,1441,2032,591
2020,8,20,5,1420,1326,1722,396
2020,8,20,6,1310,1230,1640,410
2020,8,20,7,1150,1157,1610,453
2020,8,20,8,1110,1126,1594,468
2020,8,20,9,1090,1085,1425,340
2020,8,20,10,1055,1070,1357,287
2020,8,20,11,1065,1073,1281,208
2020,8,20,12,1105,1123,1397,274
2020,8,20,13,1230,1193,1444,251
2020,8,20,14,1355,1242,1388,146
2020,8,20,15,1410,1317,1527,210
2020,8,20,16,1455,1360,1741,381
2020,8,20,17,1495,1399,1844,445
2020,8,20,18,1530,1451,1962,511
2020,8,20,19,1560,1492,1997,505
2020,8,20,20,1595,1528,2012,484
2020,8,20,21,1640,1570,2007,437
2020,8,20,22,1650,1604,2000,396
2020,8,20,23,1650,1588,2032,444
2020,8,21,0,1625,1571,2071,500
2020,8,21,1,1580,1531,2077,546
2020,8,21,2,1535,1487,2077,590
2020,8,21,3,1495,1451,2000,549
2020,8,21,4,1440,1411,1919,508
2020,8,21,5,1375,1313,1857,544
2020,8,21,6,1270,1193,1947,754
2020,8,21,7,1180,1126,1952,826
2020,8,21,8,1140,1094,1792,698
2020,8,21,9,1110,1051,1853,802
2020,8,21,10,1105,1050,1858,808
2020,8,21,11,1095,1053,1886,833
2020,8,21,12,1125,1077,1910,833
2020,8,21,13,1175,1130,1934,804
2020,8,21,14,1245,1195,1826,631
2020,8,21,15,1300,1247,1862,615
2020,8,21,16,1345,1298,1906,608
2020,8,21,17,1390,1345,1953,608
2020,8,21,18,1430,1396,1960,564
2020,8,21,19,1460,1439,1961,522
2020,8,21,20,1490,1499,1985,486
2020,8,21,21,1520,1539,2027,488
2020,8,21,22,1550,1585,2001,416
2020,8,21,23,1575,1619,1982,363
2020,8,22,0,1580,1616,1933,317
2020,8,22,1,1575,1596,1914,318
2020,8,22,2,1530,1539,1761,222
2020,8,22,3,1470,1494,1736,242
2020,8,22,4,1400,1410,1740,330
2020,8,22,5,1310,1325,1710,385
2020,8,22,6,1205,1224,1699,475
2020,8,22,7,1220,1151,1522,371
2020,8,22,8,1155,1096,1302,206
2020,8,22,9,1120,1059,1227,168
2020,8,22,10,1095,1044,1241,197
2020,8,22,11,1090,1030,1254,224
2020,8,22,12,1095,1056,1337,281
2020,8,22,13,1090,1071,1437,366
2020,8,22,14,1140,1115,1537,422
2020,8,22,15,1205,1167,1647,480
2020,8,22,16,1290,1224,1663,439
2020,8,22,17,1340,1305,1855,550
2020,8,22,18,1395,1343,1904,561
2020,8,22,19,1440,1394,2050,656
2020,8,22,20,1475,1429,2027,598
2020,8,22,21,1525,1474,2070,596
2020,8,22,22,1555,1515,2095,580
2020,8,22,23,1585,1549,2082,533
2020,8,23,0,1605,1551,2078,527
2020,8,23,1,1605,1541,2096,555
2020,8,23,2,1565,1484,2087,603
2020,8,23,3,1525,1437,2134,697
2020,8,23,4,1465,1372,2090,718
2020,8,23,5,1380,1285,1918,633
2020,8,23,6,1275,1184,1847,663
2020,8,23,7,1110,1122,1800,678
2020,8,23,8,1065,1065,1763,698
2020,8,23,9,1040,1036,1709,673
2020,8,23,10,1025,1027,1726,699
2020,8,23,11,1010,1018,1731,713
2020,8,23,12,1015,990,1721,731
2020,8,23,13,1025,1032,1773,741
2020,8,23,14,1060,1064,1833,769
2020,8,23,15,1130,1148,1829,681
2020,8,23,16,1185,1174,1865,691
2020,8,23,17,1235,1241,1917,676
2020,8,23,18,1285,1268,1912,644
2020,8,23,19,1345,1323,1914,591
2020,8,23,20,1400,1380,1919,539
2020,8,23,21,1455,1431,1931,500
2020,8,23,22,1525,1476,1974,498
2020,8,23,23,1575,1535,2044,509
2020,8,24,0,1610,1576,2056,480
2020,8,24,1,1610,1584,2090,506
2020,8,24,2,1580,1523,2071,548
2020,8,24,3,1520,1467,2019,552
2020,8,24,4,1450,1402,2018,616
2020,8,24,5,1315,1283,1946,663
2020,8,24,6,1190,1176,1876,700
2020,8,24,7,1205,1096,1858,762
2020,8,24,8,1145,1053,1817,764
2020,8,24,9,1125,1033,1842,809
2020,8,24,10,1105,1018,1826,808
2020,8,24,11,1110,1018,1839,821
2020,8,24,12,1145,1061,1832,771
2020,8,24,13,1160,1124,1832,708
2020,8,24,14,1205,1206,1859,653
2020,8,24,15,1275,1268,1878,610
2020,8,24,16,1330,1298,1854,556
2020,8,24,17,1380,1340,1837,497
2020,8,24,18,1435,1392,1865,473
2020,8,24,19,1495,1440,1901,461
2020,8,24,20,1545,1524,1935,411
2020,8,24,21,1600,1571,1936,365
2020,8,24,22,1640,1611,1996,385
2020,8,24,23,1675,1635,1980,345
2020,8,25,0,1685,1635,1968,333
2020,8,25,1,1685,1596,1974,378
2020,8,25,2,1640,1560,2006,446
2020,8,25,3,1580,1538,1956,418
2020,8,25,4,1470,1467,1955,488
2020,8,25,5,1400,1357,1844,487
2020,8,25,6,1275,1243,2015,772
2020,8,25,7,1160,1166,1983,817
2020,8,25,8,1115,1115,1908,793
2020,8,25,9,1080,1085,1958,873
2020,8,25,10,1070,1055,1936,881
2020,8,25,11,1060,1046,1917,871
2020,8,25,12,1075,1079,1926,847
2020,8,25,13,1115,1153,1950,797
2020,8,25,14,1145,1222,1862,640
2020,8,25,15,1215,1270,1910,640
2020,8,25,16,1255,1326,1938,612
2020,8,25,17,1315,1371,1930,559
2020,8,25,18,1365,1433,1933,500
2020,8,25,19,1415,1482,1946,464
2020,8,25,20,1455,1517,1929,412
2020,8,25,21,1505,1538,1950,412
2020,8,25,22,1535,1549,1992,443
2020,8,25,23,1575,1541,2016,475
2020,8,26,0,1590,1529,2061,532
2020,8,26,1,1580,1530,1994,464
2020,8,26,2,1525,1454,2021,567
2020,8,26,3,1455,1413,2002,589
2020,8,26,4,1370,1344,1973,629
2020,8,26,5,1275,1225,1869,644
2020,8,26,6,1165,1155,2031,876
2020,8,26,7,1135,1093,1996,903
2020,8,26,8,1085,1041,1794,753
2020,8,26,9,1065,1011,1792,781
2020,8,26,10,1035,977,1598,621
2020,8,26,11,1050,970,1605,635
2020,8,26,12,1085,1012,1616,604
2020,8,26,13,1140,1104,1790,686
2020,8,26,14,1200,1164,1772,608
2020,8,26,15,1255,1231,1896,665
2020,8,26,16,1290,1269,1903,634
2020,8,26,17,1335,1317,1992,675
2020,8,26,18,1370,1374,2042,668
2020,8,26,19,1420,1430,2114,684
2020,8,26,20,1470,1470,2101,631
2020,8,26,21,1530,1494,2117,623
2020,8,26,22,1555,1539,2139,600
2020,8,26,23,1580,1545,2063,518
2020,8,27,0,1575,1560,2071,511
2020,8,27,1,1550,1542,2104,562
2020,8,27,2,1495,1490,2102,612
2020,8,27,3,1465,1442,2043,601
2020,8,27,4,1370,1353,2030,677
2020,8,27,5,1295,1238,1848,610
2020,8,27,6,1195,1127,1889,762
2020,8,27,7,1070,1076,1903,827
2020,8,27,8,1025,1036,1806,770
2020,8,27,9,1000,1015,1656,641
2020,8,27,10,970,1016,1675,659
2020,8,27,11,970,1018,1650,632
2020,8,27,12,1005,1051,1683,632
2020,8,27,13,1110,1146,1855,709
2020,8,27,14,1215,1215,1818,603
2020,8,27,15,1265,1257,1971,714
2020,8,27,16,1315,1296,1994,698
2020,8,27,17,1355,1322,2050,728
2020,8,27,18,1405,1365,2112,747
2020,8,27,19,1455,1386,2126,740
2020,8,27,20,1485,1420,2156,736
2020,8,27,21,1515,1449,2169,720
2020,8,27,22,1530,1507,2153,646
2020,8,27,23,1520,1486,2132,646
2020,8,28,0,1505,1470,2129,659
2020,8,28,1,1490,1434,2111,677
2020,8,28,2,1425,1406,2081,675
2020,8,28,3,1395,1410,2046,636
2020,8,28,4,1300,1322,2062,740
2020,8,28,5,1225,1218,1972,754
2020,8,28,6,1140,1137,2047,910
2020,8,28,7,1130,1069,1884,815
2020,8,28,8,1090,1032,1803,771
2020,8,28,9,1060,1017,1681,664
2020,8,28,10,1050,1000,1657,657
2020,8,28,11,1050,1006,1594,588
2020,8,28,12,1080,1044,1719,675
2020,8,28,13,1110,1122,1970,848
2020,8,28,14,1145,1179,1887,708
2020,8,28,15,1200,1216,1920,704
2020,8,28,16,1245,1243,1924,681
2020,8,28,17,1280,1272,1955,683
2020,8,28,18,1330,1317,1998,681
2020,8,28,19,1370,1347,2030,683
2020,8,28,20,1420,1355,2017,662
2020,8,28,21,1450,1365,2001,636
2020,8,28,22,1495,1386,2027,641
2020,8,28,23,1520,1423,2045,622
2020,8,29,0,1525,1435,2037,602
2020,8,29,1,1510,1414,2035,621
2020,8,29,2,1460,1364,1971,607
2020,8,29,3,1415,1545,2208,663
2020,8,29,4,1340,1305,2010,705
2020,8,29,5,1250,1201,1946,745
2020,8,29,6,1150,1133,1923,790
2020,8,29,7,1090,1064,1917,853
2020,8,29,8,1040,1019,1927,908
2020,8,29,9,1015,1006,1718,712
2020,8,29,10,1000,989,1659,670
2020,8,29,11,990,997,1624,627
2020,8,29,12,1015,1004,1605,601
2020,8,29,13,1060,1030,1598,568
2020,8,29,14,1130,1072,1562,490
2020,8,29,15,1180,1133,1772,639
2020,8,29,16,1230,1186,1832,646
2020,8,29,17,1290,1232,1850,618
2020,8,29,18,1330,1273,1917,644
2020,8,29,19,1370,1335,1987,652
2020,8,29,20,1405,1383,2025,642
2020,8,29,21,1450,1389,2006,617
2020,8,29,22,1495,1439,2002,563
2020,8,29,23,1520,1458,2002,544
2020,8,30,0,1525,1477,2009,532
2020,8,30,1,1510,1467,1973,506
2020,8,30,2,1465,1420,1913,493
2020,8,30,3,1430,1377,1730,353
2020,8,30,4,1370,1302,1551,249
2020,8,30,5,1265,1210,1552,342
2020,8,30,6,1170,1123,1391,268
2020,8,30,7,1150,1060,1359,299
2020,8,30,8,1105,1021,1482,461
2020,8,30,9,1080,991,1445,454
2020,8,30,10,1075,978,1402,424
2020,8,30,11,1070,972,1384,412
2020,8,30,12,1060,978,1476,498
2020,8,30,13,1015,997,1526,529
2020,8,30,14,965,1013,1517,504
2020,8,30,15,1030,1078,1443,365
2020,8,30,16,1060,1136,1550,414
2020,8,30,17,1105,1153,1744,591
2020,8,30,18,1140,1172,1796,624
2020,8,30,19,1180,1186,1961,775
2020,8,30,20,1230,1184,1916,732
2020,8,30,21,1270,1173,1976,803
2020,8,30,22,1320,1183,1956,773
2020,8,30,23,1355,1209,2003,794
2020,8,31,0,1380,1237,2011,774
2020,8,31,1,1380,1247,1969,722
2020,8,31,2,1330,1232,1978,746
2020,8,31,3,1295,1241,1934,693
2020,8,31,4,1250,1211,1917,706
2020,8,31,5,1125,1125,1904,779
2020,8,31,6,1030,1033,1817,784
2020,8,31,7,1105,993,1668,675
2020,8,31,8,1070,966,1477,511
2020,8,31,9,1055,951,1214,263
2020,8,31,10,1040,960,1154,194
2020,8,31,11,1045,966,1148,182
2020,8,31,12,1080,1009,1286,277
2020,8,31,13,1040,1104,1469,365
2020,8,31,14,1010,1183,1733,550
2020,8,31,15,1060,1220,1816,596
2020,8,31,16,1090,1256,1849,593
2020,8,31,17,1120,1257,1897,640
2020,8,31,18,1165,1262,1864,602
2020,8,31,19,1205,1263,1856,593
2020,8,31,20,1265,1257,1835,578
2020,8,31,21,1305,1256,1835,579
2020,8,31,22,1345,1249,1858,609
2020,8,31,23,1360,1244,1860,616
2020,9,1,0,1350,1255,1868,613
2020,9,1,1,1325,1267,1922,655
2020,9,1,2,1295,1255,1954,699
2020,9,1,3,1275,1271,1952,681
2020,9,1,4,1200,1218,1936,718
2020,9,1,5,1110,1147,1978,831
2020,9,1,6,1020,1061,1864,803
2020,9,1,7,1030,1032,1880,848
2020,9,1,8,990,1024,1911,887
2020,9,1,9,970,1018,1943,925
2020,9,1,10,965,1023,1989,966
2020,9,1,11,960,1028,1900,872
2020,9,1,12,990,1066,1903,837
2020,9,1,13,1095,1153,1952,799
2020,9,1,14,1185,1203,2003,800
2020,9,1,15,1235,1217,2019,802
2020,9,1,16,1280,1241,2151,910
2020,9,1,17,1310,1255,2133,878
2020,9,1,18,1350,1263,2184,921
2020,9,1,19,1370,1285,2231,946
2020,9,1,20,1395,1292,2195,903
2020,9,1,21,1420,1317,2235,918
2020,9,1,22,1465,1310,2219,909
2020,9,1,23,1465,1344,2223,879
2020,9,2,0,1460,1350,2216,866
2020,9,2,1,1440,1362,2214,852
2020,9,2,2,1410,1348,2185,837
2020,9,2,3,1400,1351,2188,837
2020,9,2,4,1310,1320,2223,903
2020,9,2,5,1225,1216,2191,975
2020,9,2,6,1135,1113,2097,984
2020,9,2,7,1195,1069,2052,983
2020,9,2,8,1150,1038,2006,968
2020,9,2,9,1120,1018,2012,994
2020,9,2,10,1090,999,2001,1002
2020,9,2,11,1090,1030,1953,923
2020,9,2,12,1130,1052,1954,902
2020,9,2,13,1130,1158,2027,869
2020,9,2,14,1105,1226,2162,936
2020,9,2,15,1165,1243,2111,868
2020,9,2,16,1200,1297,2272,975
2020,9,2,17,1245,1327,2278,951
2020,9,2,18,1295,1360,2271,911
2020,9,2,19,1345,1401,2344,943
2020,9,2,20,1390,1422,2287,865
2020,9,2,21,1420,1453,2276,823
2020,9,2,22,1460,1466,2246,780
2020,9,2,23,1470,1480,2217,737
2020,9,3,0,1480,1451,2179,728
2020,9,3,1,1465,1412,2163,751
2020,9,3,2,1410,1362,2127,765
2020,9,3,3,1365,1340,2083,743
2020,9,3,4,1280,1286,2037,751
2020,9,3,5,1175,1195,1980,785
2020,9,3,6,1070,1099,1886,787
2020,9,3,7,1030,1042,1846,804
2020,9,3,8,1000,1011,1829,818
2020,9,3,9,980,995,1826,831
2020,9,3,10,985,986,1833,847
2020,9,3,11,985,990,1878,888
2020,9,3,12,1020,1033,1902,869
2020,9,3,13,1140,1120,1977,857
2020,9,3,14,1230,1200,1973,773
2020,9,3,15,1265,1223,1960,737
2020,9,3,16,1300,1245,2017,772
2020,9,3,17,1325,1281,2026,745
2020,9,3,18,1365,1308,2215,907
2020,9,3,19,1385,1339,2229,890
2020,9,3,20,1415,1383,2254,871
2020,9,3,21,1450,1411,2208,797
2020,9,3,22,1490,1461,2191,730
2020,9,3,23,1480,1484,2175,691
2020,9,4,0,1470,1495,2170,675
2020,9,4,1,1445,1468,2162,694
2020,9,4,2,1415,1428,2128,700
2020,9,4,3,1410,1405,2116,711
2020,9,4,4,1320,1285,1128,-157
2020,9,4,5,1235,1189,770,-419
2020,9,4,6,1145,1093,682,-411
2020,9,4,7,1050,1067,682,-385
2020,9,4,8,1015,1049,635,-414
2020,9,4,9,980,1002,610,-392
2020,9,4,10,975,1004,608,-396
2020,9,4,11,980,999,591,-408
2020,9,4,12,1000,1042,613,-429
2020,9,4,13,1105,1109,622,-487
2020,9,4,14,1205,1184,661,-523
2020,9,4,15,1250,1247,670,-577
2020,9,4,16,1300,1271,671,-600
2020,9,4,17,1340,1292,653,-639
2020,9,4,18,1390,1321,660,-661
2020,9,4,19,1430,1348,669,-679
2020,9,4,20,1480,1381,667,-714
2020,9,4,21,1515,1443,678,-765
2020,9,4,22,1560,1490,691,-799
2020,9,4,23,1590,1535,713,-822
2020,9,5,0,1590,1553,710,-843
2020,9,5,1,1565,1559,729,-830
2020,9,5,2,1510,1495,733,-762
2020,9,5,3,1505,1451,713,-738
2020,9,5,4,1415,1363,736,-627
2020,9,5,5,1305,1279,678,-601
2020,9,5,6,1205,1200,679,-521
2020,9,5,7,1070,1126,693,-433
2020,9,5,8,1020,1063,746,-317
2020,9,5,9,1005,1037,794,-243
2020,9,5,10,990,1030,887,-143
2020,9,5,11,995,1021,924,-97
2020,9,5,12,1010,1031,936,-95
2020,9,5,13,1090,1051,1101,50
2020,9,5,14,1180,1082,1150,68
2020,9,5,15,1235,1132,1206,74
2020,9,5,16,1290,1187,1342,155
2020,9,5,17,1340,1223,1322,99
2020,9,5,18,1380,1279,1391,112
2020,9,5,19,1435,1331,1570,239
2020,9,5,20,1480,1386,1512,126
2020,9,5,21,1505,1443,1579,136
2020,9,5,22,1555,1503,1602,99
2020,9,5,23,1580,1540,1594,54
2020,9,6,0,1600,1534,1599,65
2020,9,6,1,1585,1513,1593,80
2020,9,6,2,1530,1473,1556,83
2020,9,6,3,1490,1451,1587,136
2020,9,6,4,1410,1379,1583,204
2020,9,6,5,1310,1253,1618,365
2020,9,6,6,1210,1174,1578,404
2020,9,6,7,1045,1127,1625,498
2020,9,6,8,1000,1072,1746,674
2020,9,6,9,965,1045,1760,715
2020,9,6,10,955,1026,1890,864
2020,9,6,11,950,1028,1958,930
2020,9,6,12,955,1025,1995,970
2020,9,6,13,1045,1052,2032,980
2020,9,6,14,1120,1064,1976,912
2020,9,6,15,1190,1121,2023,902
2020,9,6,16,1240,1157,2055,898
2020,9,6,17,1270,1212,2106,894
2020,9,6,18,1290,1247,2115,868
2020,9,6,19,1310,1280,2139,859
2020,9,6,20,1320,1317,2147,830
2020,9,6,21,1330,1340,2186,846
2020,9,6,22,1355,1376,2199,823
2020,9,6,23,1385,1405,2191,786
2020,9,7,0,1410,1419,2211,792
2020,9,7,1,1420,1405,2241,836
2020,9,7,2,1390,1353,2203,850
2020,9,7,3,1385,1334,2195,861
2020,9,7,4,1300,1273,2126,853
2020,9,7,5,1235,1192,1980,788
2020,9,7,6,1135,1118,1938,820
2020,9,7,7,1115,1053,1821,768
2020,9,7,8,1100,1013,1692,679
2020,9,7,9,1095,990,1677,687
2020,9,7,10,1090,990,1724,734
2020,9,7,11,1105,996,1725,729
2020,9,7,12,1135,1015,1852,837
2020,9,7,13,1190,1050,1901,851
2020,9,7,14,1230,1085,1947,862
2020,9,7,15,1265,1161,2072,911
2020,9,7,16,1285,1195,2058,863
2020,9,7,17,1305,1232,2045,813
2020,9,7,18,1315,1269,2040,771
2020,9,7,19,1315,1288,2068,780
2020,9,7,20,1315,1284,2051,767
2020,9,7,21,1315,1275,2095,820
2020,9,7,22,1315,1263,2114,851
2020,9,7,23,1320,1263,2034,771
2020,9,8,0,1310,1269,2136,867
2020,9,8,1,1290,1252,2129,877
2020,9,8,2,1280,1237,2096,859
2020,9,8,3,1275,1247,2120,873
2020,9,8,4,1230,1182,2052,870
2020,9,8,5,1185,1112,1958,846
2020,9,8,6,1090,1035,1788,753
2020,9,8,7,1180,1005,1705,700
2020,9,8,8,1160,981,1632,651
2020,9,8,9,1155,960,1548,588
2020,9,8,10,1150,965,1505,540
2020,9,8,11,1160,990,1565,575
2020,9,8,12,1195,1039,1679,640
2020,9,8,13,1235,1139,1759,620
2020,9,8,14,1260,1231,1758,527
2020,9,8,15,1295,1236,1825,589
2020,9,8,16,1315,1244,1821,577
2020,9,8,17,1340,1238,1794,556
2020,9,8,18,1350,1228,1843,615
2020,9,8,19,1350,1213,1796,583
2020,9,8,20,1345,1208,1792,584
2020,9,8,21,1345,1177,1507,330
2020,9,8,22,1340,1190,1233,43
2020,9,8,23,1340,1194,1197,3
2020,9,9,0,1330,1212,1192,-20
2020,9,9,1,1310,1213,1200,-13
2020,9,9,2,1295,1216,1183,-33
2020,9,9,3,1290,1257,1248,-9
2020,9,9,4,1260,1202,1215,13
2020,9,9,5,1195,1122,1210,88
2020,9,9,6,1105,1049,1218,169
2020,9,9,7,1015,1018,1209,191
2020,9,9,8,985,1007,1218,211
2020,9,9,9,970,1005,1244,239
2020,9,9,10,975,1003,1257,254
2020,9,9,11,975,1028,1251,223
2020,9,9,12,1015,1069,1254,185
2020,9,9,13,1080,1163,1264,101
2020,9,9,14,1140,1224,1278,54
2020,9,9,15,1185,1235,1274,39
2020,9,9,16,1215,1231,1234,3
2020,9,9,17,1225,1226,1204,-22
2020,9,9,18,1245,1207,1198,-9
2020,9,9,19,1255,1206,1205,-1
2020,9,9,20,1255,1204,1216,12
2020,9,9,21,1255,1204,1228,24
2020,9,9,22,1255,1204,1209,5
2020,9,9,23,1255,1215,1192,-23
2020,9,10,0,1265,1224,1173,-51
2020,9,10,1,1270,1223,1183,-40
2020,9,10,2,1255,1217,1080,-137
2020,9,10,3,1260,1222,1054,-168
2020,9,10,4,1140,1161,1040,-121
2020,9,10,5,1125,1086,1034,-52
2020,9,10,6,1040,1015,1034,19
2020,9,10,7,1045,984,1036,52
2020,9,10,8,1015,963,1034,71
2020,9,10,9,1000,952,1030,78
2020,9,10,10,995,947,1013,66
2020,9,10,11,1000,965,1020,55
2020,9,10,12,1040,1008,1015,7
2020,9,10,13,1070,1112,1033,-79
2020,9,10,14,1085,1165,1025,-140
2020,9,10,15,1105,1182,1034,-148
2020,9,10,16,1125,1178,986,-192
2020,9,10,17,1150,1187,1024,-163
2020,9,10,18,1170,1186,1050,-136
2020,9,10,19,1185,1193,1051,-142
2020,9,10,20,1215,1215,1099,-116
2020,9,10,21,1230,1220,1183,-37
2020,9,10,22,1270,1232,1191,-41
2020,9,10,23,1280,1252,1204,-48
2020,9,11,0,1290,1269,1213,-56
2020,9,11,1,1270,1266,1214,-52
2020,9,11,2,1245,1241,1127,-114
2020,9,11,3,1240,1270,1168,-102
2020,9,11,4,1150,1186,1126,-60
2020,9,11,5,1075,1106,1045,-61
2020,9,11,6,995,1037,1068,31
2020,9,11,7,1000,1004,1067,63
2020,9,11,8,990,975,1073,98
2020,9,11,9,980,975,1081,106
2020,9,11,10,985,961,1086,125
2020,9,11,11,995,981,1075,94
2020,9,11,12,1025,1018,1116,98
2020,9,11,13,1110,1108,1167,59
2020,9,11,14,1160,1172,1172,0
2020,9,11,15,1170,1192,1199,7
2020,9,11,16,1185,1196,1182,-14
2020,9,11,17,1200,1192,1175,-17
2020,9,11,18,1205,1218,1172,-46
2020,9,11,19,1225,1228,1189,-39
2020,9,11,20,1225,1250,1207,-43
2020,9,11,21,1245,1257,1206,-51
2020,9,11,22,1245,1301,1238,-63
2020,9,11,23,1275,1316,1233,-83
2020,9,12,0,1280,1325,1220,-105
2020,9,12,1,1285,1313,1207,-106
2020,9,12,2,1270,1290,1196,-94
2020,9,12,3,1295,1282,1138,-144
2020,9,12,4,1160,1218,1095,-123
2020,9,12,5,1130,1136,1017,-119
2020,9,12,6,1045,1076,1079,3
2020,9,12,7,1035,1034,1091,57
2020,9,12,8,990,1023,1129,106
2020,9,12,9,970,1013,1163,150
2020,9,12,10,960,997,1171,174
2020,9,12,11,960,1007,1218,211
2020,9,12,12,975,1022,1209,187
2020,9,12,13,1010,1043,1250,207
2020,9,12,14,1045,1060,1206,146
2020,9,12,15,1085,1099,1222,123
2020,9,12,16,1125,1138,1229,91
2020,9,12,17,1150,1167,1191,24
2020,9,12,18,1190,1188,1172,-16
2020,9,12,19,1230,1206,1178,-28
2020,9,12,20,1275,1228,1206,-22
2020,9,12,21,1310,1263,1220,-43
2020,9,12,22,1355,1287,1239,-48
2020,9,12,23,1385,1326,1264,-62
2020,9,13,0,1390,1347,1237,-110
2020,9,13,1,1375,1346,1260,-86
2020,9,13,2,1340,1304,1234,-70
2020,9,13,3,1325,1283,1209,-74
2020,9,13,4,1250,1216,1132,-84
2020,9,13,5,1145,1154,1127,-27
2020,9,13,6,1075,1078,1138,60
2020,9,13,7,1045,1027,1149,122
2020,9,13,8,1000,993,1159,166
2020,9,13,9,970,969,1136,167
2020,9,13,10,960,961,1085,124
2020,9,13,11,955,964,1090,126
2020,9,13,12,965,971,1067,96
2020,9,13,13,1035,982,1083,101
2020,9,13,14,1090,1029,1075,46
2020,9,13,15,1140,1067,1008,-59
2020,9,13,16,1170,1116,1061,-55
2020,9,13,17,1210,1135,1068,-67
2020,9,13,18,1235,1153,1061,-92
2020,9,13,19,1260,1158,1088,-70
2020,9,13,20,1290,1170,1120,-50
2020,9,13,21,1300,1183,1133,-50
2020,9,13,22,1330,1190,1139,-51
2020,9,13,23,1355,1225,1096,-129
2020,9,14,0,1375,1243,1093,-150
2020,9,14,1,1370,1250,1105,-145
2020,9,14,2,1325,1262,1093,-169
2020,9,14,3,1320,1248,1110,-138
2020,9,14,4,1250,1182,1102,-80
2020,9,14,5,1175,1093,1088,-5
2020,9,14,6,1100,1028,1063,35
2020,9,14,7,1045,985,1077,92
2020,9,14,8,1005,959,1071,112
2020,9,14,9,980,948,1128,180
2020,9,14,10,985,951,1125,174
2020,9,14,11,995,957,1122,165
2020,9,14,12,1025,1004,1195,191
2020,9,14,13,1160,1107,1309,202
2020,9,14,14,1285,1181,1301,120
2020,9,14,15,1350,1209,1296,87
2020,9,14,16,1375,1231,1270,39
2020,9,14,17,1400,1249,1250,1
2020,9,14,18,1425,1249,1284,35
2020,9,14,19,1430,1274,1339,65
2020,9,14,20,1435,1285,1355,70
2020,9,14,21,1430,1305,1376,71
2020,9,14,22,1425,1333,1361,28
2020,9,14,23,1435,1343,1339,-4
2020,9,15,0,1445,1342,1260,-82
2020,9,15,1,1440,1331,1223,-108
2020,9,15,2,1430,1318,1229,-89
2020,9,15,3,1445,1298,1234,-64
2020,9,15,4,1340,1220,1195,-25
2020,9,15,5,1285,1142,1166,24
2020,9,15,6,1195,1054,1115,61
2020,9,15,7,1030,1013,1126,113
2020,9,15,8,995,976,1155,179
2020,9,15,9,975,971,1131,160
2020,9,15,10,970,961,1129,168
2020,9,15,11,980,970,1125,155
2020,9,15,12,1015,1008,1183,175
2020,9,15,13,1120,1110,1188,78
2020,9,15,14,1220,1177,1186,9
2020,9,15,15,1250,1208,1210,2
2020,9,15,16,1275,1221,1205,-16
2020,9,15,17,1300,1229,1206,-23
2020,9,15,18,1325,1232,1301,69
2020,9,15,19,1340,1257,1328,71
2020,9,15,20,1370,1272,1317,45
2020,9,15,21,1390,1293,1329,36
2020,9,15,22,1425,1304,1306,2
2020,9,15,23,1450,1322,1292,-30
2020,9,16,0,1465,1314,1276,-38
2020,9,16,1,1450,1310,1294,-16
2020,9,16,2,1425,1295,1330,35
2020,9,16,3,1415,1292,1334,42
2020,9,16,4,1340,1214,1306,92
2020,9,16,5,1230,1126,1272,146
2020,9,16,6,1140,1045,1198,153
2020,9,16,7,995,998,1199,201
2020,9,16,8,970,978,1141,163
2020,9,16,9,965,955,1114,159
2020,9,16,10,960,946,1114,168
2020,9,16,11,975,967,1109,142
2020,9,16,12,1020,1001,1118,117
2020,9,16,13,1125,1096,1133,37
2020,9,16,14,1205,1171,1084,-87
2020,9,16,15,1230,1200,1102,-98
2020,9,16,16,1245,1193,1098,-95
2020,9,16,17,1260,1200,1108,-92
2020,9,16,18,1260,1205,1139,-66
2020,9,16,19,1280,1196,1129,-67
2020,9,16,20,1290,1208,1136,-72
2020,9,16,21,1305,1216,1128,-88
2020,9,16,22,1320,1234,1126,-108
2020,9,16,23,1335,1252,1139,-113
2020,9,17,0,1330,1253,1152,-101
2020,9,17,1,1320,1247,1162,-85
2020,9,17,2,1305,1238,1168,-70
2020,9,17,3,1290,1245,1161,-84
2020,9,17,4,1205,1172,1133,-39
2020,9,17,5,1140,1094,1121,27
2020,9,17,6,1050,1020,1125,105
2020,9,17,7,990,981,1145,164
2020,9,17,8,965,961,1103,142
2020,9,17,9,950,951,1094,143
2020,9,17,10,945,955,1096,141
2020,9,17,11,960,968,1100,132
2020,9,17,12,1005,1009,1099,90
2020,9,17,13,1150,1106,1090,-16
2020,9,17,14,1245,1182,1083,-99
2020,9,17,15,1265,1200,1075,-125
2020,9,17,16,1270,1207,1078,-129
2020,9,17,17,1285,1225,1085,-140
2020,9,17,18,1285,1210,1084,-126
2020,9,17,19,1300,1227,1092,-135
2020,9,17,20,1325,1226,1102,-124
2020,9,17,21,1335,1245,1116,-129
2020,9,17,22,1355,1257,1119,-138
2020,9,17,23,1375,1258,1120,-138
2020,9,18,0,1390,1257,1133,-124
2020,9,18,1,1380,1255,1176,-79
2020,9,18,2,1355,1244,1144,-100
2020,9,18,3,1375,1243,1134,-109
2020,9,18,4,1245,1178,1191,13
2020,9,18,5,1195,1116,1208,92
2020,9,18,6,1115,1031,1204,173
2020,9,18,7,1000,994,1242,248
2020,9,18,8,975,970,1210,240
2020,9,18,9,960,966,1141,175
2020,9,18,10,950,956,1098,142
2020,9,18,11,965,965,1141,176
2020,9,18,12,1005,1002,1138,136
2020,9,18,13,1115,1082,1141,59
2020,9,18,14,1210,1152,1111,-41
2020,9,18,15,1235,1181,1102,-79
2020,9,18,16,1240,1190,1096,-94
2020,9,18,17,1240,1203,1059,-144
2020,9,18,18,1265,1205,1127,-78
2020,9,18,19,1275,1210,1141,-69
2020,9,18,20,1295,1214,1147,-67
2020,9,18,21,1310,1216,1155,-61
2020,9,18,22,1350,1227,1123,-104
2020,9,18,23,1370,1238,1127,-111
2020,9,19,0,1380,1217,1133,-84
2020,9,19,1,1370,1207,1149,-58
2020,9,19,2,1345,1215,1157,-58
2020,9,19,3,1335,1143,1127,-16
2020,9,19,4,1210,1162,1102,-60
2020,9,19,5,1180,1096,1074,-22
2020,9,19,6,1115,1033,1104,71
2020,9,19,7,1030,988,1097,109
2020,9,19,8,990,970,1096,126
2020,9,19,9,965,950,1101,151
2020,9,19,10,960,938,1105,167
2020,9,19,11,955,935,1108,173
2020,9,19,12,965,962,1137,175
2020,9,19,13,990,983,1149,166
2020,9,19,14,1010,1044,1154,110
2020,9,19,15,1065,1096,1149,53
2020,9,19,16,1110,1138,1172,34
2020,9,19,17,1125,1172,1206,34
2020,9,19,18,1140,1191,1264,73
2020,9,19,19,1155,1192,1333,141
2020,9,19,20,1155,1186,1280,94
2020,9,19,21,1165,1169,1382,213
2020,9,19,22,1180,1162,1353,191
2020,9,19,23,1200,1166,1335,169
2020,9,20,0,1220,1186,1355,169
2020,9,20,1,1225,1196,1362,166
2020,9,20,2,1205,1199,1371,172
2020,9,20,3,1210,1185,1403,218
2020,9,20,4,1150,1138,1438,300
2020,9,20,5,1085,1082,1385,303
2020,9,20,6,1000,1033,1406,373
2020,9,20,7,1015,989,1355,366
2020,9,20,8,980,969,1366,397
2020,9,20,9,955,964,1329,365
2020,9,20,10,945,950,1282,332
2020,9,20,11,940,953,1330,377
2020,9,20,12,950,957,1330,373
2020,9,20,13,985,993,1339,346
2020,9,20,14,1010,1037,1385,348
2020,9,20,15,1065,1080,1405,325
2020,9,20,16,1110,1132,1361,229
2020,9,20,17,1130,1160,1416,256
2020,9,20,18,1140,1155,1412,257
2020,9,20,19,1155,1165,1453,288
2020,9,20,20,1155,1163,1478,315
2020,9,20,21,1160,1160,1472,312
2020,9,20,22,1175,1167,1427,260
2020,9,20,23,1195,1178,1399,221
2020,9,21,0,1210,1190,1257,67
2020,9,21,1,1220,1199,1176,-23
2020,9,21,2,1200,1206,1180,-26
2020,9,21,3,1200,1215,1155,-60
2020,9,21,4,1140,1148,1092,-56
2020,9,21,5,1080,1071,1086,15
2020,9,21,6,1000,997,1072,75
2020,9,21,7,990,951,1108,157
2020,9,21,8,960,933,1167,234
2020,9,21,9,950,925,1201,276
2020,9,21,10,955,919,1192,273
2020,9,21,11,960,942,1180,238
2020,9,21,12,1000,989,1209,220
2020,9,21,13,1065,1092,1214,122
2020,9,21,14,1110,1180,1213,33
2020,9,21,15,1145,1191,1200,9
2020,9,21,16,1165,1206,1212,6
2020,9,21,17,1180,1206,1244,38
2020,9,21,18,1180,1228,1252,24
2020,9,21,19,1200,1227,1259,32
2020,9,21,20,1210,1219,1273,54
2020,9,21,21,1225,1246,1266,20
2020,9,21,22,1240,1261,1270,9
2020,9,21,23,1250,1278,1274,-4
2020,9,22,0,1250,1285,1253,-32
2020,9,22,1,1240,1276,1214,-62
2020,9,22,2,1230,1251,1168,-83
2020,9,22,3,1220,1231,1175,-56
2020,9,22,4,1110,1163,1173,10
2020,9,22,5,1075,1085,1159,74
2020,9,22,6,995,999,1154,155
2020,9,22,7,985,961,1150,189
2020,9,22,8,955,938,1105,167
2020,9,22,9,950,929,1082,153
2020,9,22,10,940,923,960,37
2020,9,22,11,950,934,962,28
2020,9,22,12,980,977,988,11
2020,9,22,13,1070,1079,1021,-58
2020,9,22,14,1135,1147,1016,-131
2020,9,22,15,1160,1173,1097,-76
2020,9,22,16,1180,1192,1073,-119
2020,9,22,17,1190,1199,1067,-132
2020,9,22,18,1190,1200,1080,-120
2020,9,22,19,1205,1209,1089,-120
2020,9,22,20,1215,1218,1106,-112
2020,9,22,21,1225,1230,1135,-95
2020,9,22,22,1235,1228,1154,-74
2020,9,22,23,1250,1248,1211,-37
2020,9,23,0,1250,1227,1211,-16
2020,9,23,1,1250,1229,1311,82
2020,9,23,2,1240,1222,1236,14
2020,9,23,3,1250,1221,1334,113
2020,9,23,4,1135,1152,1336,184
2020,9,23,5,1090,1074,1249,175
2020,9,23,6,1015,998,1219,221
2020,9,23,7,965,962,1135,173
2020,9,23,8,945,942,998,56
2020,9,23,9,940,923,972,49
2020,9,23,10,930,934,968,34
2020,9,23,11,955,944,997,53
2020,9,23,12,1000,990,1138,148
2020,9,23,13,1105,1091,1160,69
2020,9,23,14,1195,1165,1175,10
2020,9,23,15,1205,1195,1173,-22
2020,9,23,16,1215,1199,1172,-27
2020,9,23,17,1215,1206,1190,-16
2020,9,23,18,1230,1206,1288,82
2020,9,23,19,1225,1226,1299,73
2020,9,23,20,1225,1248,1335,87
2020,9,23,21,1240,1258,1409,151
2020,9,23,22,1255,1278,1379,101
2020,9,23,23,1270,1281,1350,69
2020,9,24,0,1280,1280,1336,56
2020,9,24,1,1270,1264,1231,-33
2020,9,24,2,1255,1273,1215,-58
2020,9,24,3,1240,1246,1220,-26
2020,9,24,4,1195,1169,1193,24
2020,9,24,5,1090,1090,1117,27
2020,9,24,6,1010,1019,1178,159
2020,9,24,7,965,976,1085,109
2020,9,24,8,945,955,1078,123
2020,9,24,9,935,945,1054,109
2020,9,24,10,935,941,962,21
2020,9,24,11,950,960,1013,53
2020,9,24,12,990,998,1009,11
2020,9,24,13,1080,1106,1109,3
2020,9,24,14,1145,1178,1145,-33
2020,9,24,15,1160,1215,1250,35
2020,9,24,16,1170,1238,1276,38
2020,9,24,17,1185,1264,1283,19
2020,9,24,18,1175,1279,1321,42
2020,9,24,19,1185,1287,1410,123
2020,9,24,20,1195,1304,1526,222
2020,9,24,21,1205,1294,1494,200
2020,9,24,22,1215,1298,1490,192
2020,9,24,23,1225,1289,1517,228
2020,9,25,0,1220,1269,1475,206
2020,9,25,1,1220,1245,1452,207
2020,9,25,2,1305,1242,1471,229
2020,9,25,3,1210,1247,1468,221
2020,9,25,4,1145,1182,1497,315
2020,9,25,5,1075,1095,1404,309
2020,9,25,6,1000,1034,1419,385
2020,9,25,7,955,984,1300,316
2020,9,25,8,935,956,1270,314
2020,9,25,9,925,964,1286,322
2020,9,25,10,920,962,1310,348
2020,9,25,11,930,964,1277,313
2020,9,25,12,970,1001,1401,400
2020,9,25,13,1070,1082,1409,327
2020,9,25,14,1150,1160,1362,202
2020,9,25,15,1175,1199,1341,142
2020,9,25,16,1180,1232,1399,167
2020,9,25,17,1195,1252,1391,139
2020,9,25,18,1200,1244,1436,192
2020,9,25,19,1205,1236,1456,220
2020,9,25,20,1215,1221,1375,154
2020,9,25,21,1220,1217,1376,159
2020,9,25,22,1240,1215,1401,186
2020,9,25,23,1250,1207,1392,185
2020,9,26,0,1235,1207,1383,176
2020,9,26,1,1225,1202,1414,212
2020,9,26,2,1230,1204,1310,106
2020,9,26,3,1175,1178,1223,45
2020,9,26,4,1150,1137,1198,61
2020,9,26,5,1090,1068,1124,56
2020,9,26,6,1025,1014,1150,136
2020,9,26,7,0,986,1192,206
2020,9,26,8,0,966,1193,227
2020,9,26,9,0,971,1203,232
2020,9,26,10,940,959,1255,296
2020,9,26,11,945,968,1221,253
2020,9,26,12,970,984,1271,287
2020,9,26,13,1005,1033,1239,206
2020,9,26,14,1060,1067,1201,134
2020,9,26,15,1105,1111,1125,14
2020,9,26,16,1145,1147,1314,167
2020,9,26,17,1175,1177,1416,239
2020,9,26,18,1195,1170,1378,208
2020,9,26,19,1200,1167,1389,222
2020,9,26,20,1205,1143,1427,284
2020,9,26,21,1195,1140,1397,257
2020,9,26,22,1195,1133,1401,268
2020,9,26,23,1200,1148,1445,297
2020,9,27,0,1215,1150,1437,287
2020,9,27,1,1215,1157,1441,284
2020,9,27,2,1210,1172,1387,215
2020,9,27,3,1200,1164,1367,203
2020,9,27,4,1150,1118,1326,208
2020,9,27,5,1085,1073,1321,248
2020,9,27,6,1030,1018,1303,285
2020,9,27,7,990,988,1294,306
2020,9,27,8,970,957,1249,292
2020,9,27,9,960,957,1285,328
2020,9,27,10,950,955,1209,254
2020,9,27,11,955,962,1201,239
2020,9,27,12,965,970,1161,191
2020,9,27,13,1015,994,1168,174
2020,9,27,14,1060,1027,1150,123
2020,9,27,15,1100,1073,1185,112
2020,9,27,16,1145,1115,1289,174
2020,9,27,17,1175,1127,1277,150
2020,9,27,18,1175,1125,1261,136
2020,9,27,19,1180,1132,1317,185
2020,9,27,20,1185,1103,1275,172
2020,9,27,21,1185,1109,1287,178
2020,9,27,22,1195,1117,1343,226
2020,9,27,23,1200,1132,1409,277
2020,9,28,0,1210,1146,1393,247
2020,9,28,1,1210,1156,1393,237
2020,9,28,2,1220,1180,1346,166
2020,9,28,3,1225,1192,1331,139
2020,9,28,4,1150,1133,1298,165
2020,9,28,5,1075,1054,1259,205
2020,9,28,6,1005,1000,1197,197
2020,9,28,7,1015,971,1200,229
2020,9,28,8,995,946,1193,247
2020,9,28,9,990,954,1199,245
2020,9,28,10,980,944,1269,325
2020,9,28,11,1005,967,1235,268
2020,9,28,12,1045,1023,1279,256
2020,9,28,13,1140,1118,1348,230
2020,9,28,14,1205,1207,1380,173
2020,9,28,15,1225,1250,1419,169
2020,9,28,16,1245,1242,1412,170
2020,9,28,17,1250,1219,1370,151
2020,9,28,18,1270,1226,1441,215
2020,9,28,19,1275,1213,1412,199
2020,9,28,20,1275,1212,1409,197
2020,9,28,21,1290,1202,1443,241
2020,9,28,22,1305,1211,1459,248
2020,9,28,23,1320,1219,1453,234
2020,9,29,0,1320,1218,1494,276
2020,9,29,1,1305,1219,1486,267
2020,9,29,2,1290,1239,1496,257
2020,9,29,3,1270,1239,1516,277
2020,9,29,4,1205,1188,1501,313
2020,9,29,5,1115,1133,1498,365
2020,9,29,6,1035,1030,1411,381
2020,9,29,7,980,1003,1386,383
2020,9,29,8,955,973,1368,395
2020,9,29,9,950,967,1353,386
2020,9,29,10,945,966,1357,391
2020,9,29,11,955,983,1343,360
2020,9,29,12,990,1022,1336,314
2020,9,29,13,1075,1117,1416,299
2020,9,29,14,1140,1196,1449,253
2020,9,29,15,1170,1192,1424,232
2020,9,29,16,1195,1212,1411,199
2020,9,29,17,1205,1224,1436,212
2020,9,29,18,1205,1219,1472,253
2020,9,29,19,1215,1229,1486,257
2020,9,29,20,1215,1231,1447,216
2020,9,29,21,1230,1247,1489,242
2020,9,29,22,1230,1257,1477,220
2020,9,29,23,1250,1266,1484,218
2020,9,30,0,1240,1278,1467,189
2020,9,30,1,1240,1253,1413,160
2020,9,30,2,1240,1257,1388,131
2020,9,30,3,1240,1238,1342,104
2020,9,30,4,1140,1192,1383,191
2020,9,30,5,1085,1102,1367,265
2020,9,30,6,1015,1009,1355,346
2020,9,30,7,980,971,1358,387
2020,9,30,8,960,948,1276,328
2020,9,30,9,945,933,1288,355
2020,9,30,10,950,937,1239,302
2020,9,30,11,965,951,1250,299
2020,9,30,12,1010,997,1260,263
2020,9,30,13,1090,1098,1269,171
2020,9,30,14,1150,1172,1296,124
2020,9,30,15,1185,1189,1256,67
2020,9,30,16,1185,1181,1210,29
2020,9,30,17,1185,1191,1192,1
2020,9,30,18,1185,1198,1217,19
2020,9,30,19,1195,1196,1217,21
2020,9,30,20,1210,1197,1243,46
2020,9,30,21,1215,1197,1269,72
2020,9,30,22,1235,1196,1284,88
2020,9,30,23,1240,1199,1285,86
2020,10,1,0,1240,1204,1291,87
2020,10,1,1,1230,1201,1281,80
2020,10,1,2,1235,1231,1294,63
2020,10,1,3,1220,1220,1301,81
2020,10,1,4,1150,1162,1250,88
2020,10,1,5,1075,1084,1213,129
2020,10,1,6,1000,1011,1204,193
2020,10,1,7,960,971,1183,212
2020,10,1,8,940,945,1172,227
2020,10,1,9,930,936,1169,233
2020,10,1,10,930,943,1167,224
2020,10,1,11,945,942,1172,230
2020,10,1,12,985,997,1093,96
2020,10,1,13,1095,1104,1188,84
2020,10,1,14,1175,1182,1166,-16
2020,10,1,15,1200,1192,1183,-9
2020,10,1,16,1220,1197,1142,-55
2020,10,1,17,1240,1185,1166,-19
2020,10,1,18,1250,1187,1168,-19
2020,10,1,19,1260,1181,1183,2
2020,10,1,20,1270,1184,1205,21
2020,10,1,21,1270,1178,1195,17
2020,10,1,22,1275,1195,1206,11
2020,10,1,23,1270,1188,1181,-7
2020,10,2,0,1260,1199,1169,-30
2020,10,2,1,1240,1206,1171,-35
2020,10,2,2,1240,1240,1189,-51
2020,10,2,3,1235,1217,1193,-24
2020,10,2,4,1175,1148,1146,-2
2020,10,2,5,1090,1078,1160,82
2020,10,2,6,1020,1010,1215,205
2020,10,2,7,960,973,1204,231
2020,10,2,8,935,965,1199,234
2020,10,2,9,940,960,1215,255
2020,10,2,10,935,957,1246,289
2020,10,2,11,940,965,1252,287
2020,10,2,12,970,989,1282,293
2020,10,2,13,1060,1075,1279,204
2020,10,2,14,1145,1144,1266,122
2020,10,2,15,1185,1163,1298,135
2020,10,2,16,1215,1169,1277,108
2020,10,2,17,1235,1173,1327,154
2020,10,2,18,1230,1171,1316,145
2020,10,2,19,1225,1170,1266,96
2020,10,2,20,1210,1164,1256,92
2020,10,2,21,1210,1176,1311,135
2020,10,2,22,1210,1174,1305,131
2020,10,2,23,1210,1172,1289,117
2020,10,3,0,1210,1167,1277,110
2020,10,3,1,1210,1166,1259,93
2020,10,3,2,1215,1182,1239,57
2020,10,3,3,1190,1162,1191,29
2020,10,3,4,1145,1113,1124,11
2020,10,3,5,1085,1060,1134,74
2020,10,3,6,1025,1001,1117,116
2020,10,3,7,975,964,1105,141
2020,10,3,8,955,930,1115,185
2020,10,3,9,955,924,1139,215
2020,10,3,10,945,920,1147,227
2020,10,3,11,950,919,1195,276
2020,10,3,12,975,940,1215,275
2020,10,3,13,1050,979,1236,257
2020,10,3,14,1110,1021,1210,189
2020,10,3,15,1150,1067,1191,124
2020,10,3,16,1180,1093,1184,91
2020,10,3,17,1205,1102,1156,54
2020,10,3,18,1200,1096,1154,58
2020,10,3,19,1200,1096,1157,61
2020,10,3,20,1180,1089,1139,50
2020,10,3,21,1180,1098,1141,43
2020,10,3,22,1180,1110,1138,28
2020,10,3,23,1175,1131,1139,8
2020,10,4,0,1190,1138,1165,27
2020,10,4,1,1195,1148,1215,67
2020,10,4,2,1220,1174,1242,68
2020,10,4,3,1200,1152,1218,66
2020,10,4,4,1110,1097,1186,89
2020,10,4,5,1095,1045,1142,97
2020,10,4,6,1040,974,1124,150
2020,10,4,7,980,940,1146,206
2020,10,4,8,955,924,1153,229
2020,10,4,9,950,905,1161,256
2020,10,4,10,950,912,1203,291
2020,10,4,11,955,910,1241,331
2020,10,4,12,970,1069,1424,355
2020,10,4,13,1045,976,1314,338
2020,10,4,14,1115,1022,1405,383
2020,10,4,15,1155,1057,1409,352
2020,10,4,16,1195,1097,1416,319
2020,10,4,17,1205,1114,1450,336
2020,10,4,18,1200,1137,1495,358
2020,10,4,19,1205,1154,1490,336
2020,10,4,20,1185,1146,1518,372
2020,10,4,21,1190,1155,1415,260
2020,10,4,22,1200,1167,1348,181
2020,10,4,23,1210,1199,1424,225
2020,10,5,0,1225,1211,1394,183
2020,10,5,1,1235,1212,1352,140
2020,10,5,2,1260,1235,1335,100
2020,10,5,3,1265,1199,1288,89
2020,10,5,4,1115,1126,1273,147
2020,10,5,5,1115,1053,1302,249
2020,10,5,6,1055,989,1282,293
2020,10,5,7,975,946,1331,385
2020,10,5,8,945,921,1200,279
2020,10,5,9,950,912,1227,315
2020,10,5,10,945,911,1236,325
2020,10,5,11,965,920,1206,286
2020,10,5,12,1020,958,1312,354
2020,10,5,13,1120,1055,1328,273
2020,10,5,14,1210,1137,1288,151
2020,10,5,15,1240,1148,1173,25
2020,10,5,16,1235,1156,1129,-27
2020,10,5,17,1220,1164,1171,7
2020,10,5,18,1230,1179,1221,42
2020,10,5,19,1220,1181,1283,102
2020,10,5,20,1220,1201,1273,72
2020,10,5,21,1215,1217,1299,82
2020,10,5,22,1225,1234,1310,76
2020,10,5,23,1230,1247,1377,130
2020,10,6,0,1235,1262,1381,119
2020,10,6,1,1235,1257,1352,95
2020,10,6,2,1255,1272,1327,55
2020,10,6,3,1245,1240,1308,68
2020,10,6,4,1210,1164,1350,186
2020,10,6,5,1110,1084,1360,276
2020,10,6,6,1040,1005,1360,355
2020,10,6,7,950,962,1318,356
2020,10,6,8,925,950,1373,423
2020,10,6,9,915,946,1391,445
2020,10,6,10,915,931,1384,453
2020,10,6,11,925,942,1375,433
2020,10,6,12,995,984,1374,390
2020,10,6,13,1065,1098,1392,294
2020,10,6,14,1155,1162,1401,239
2020,10,6,15,1160,1178,1419,241
2020,10,6,16,1185,1193,1382,189
2020,10,6,17,1200,1199,1427,228
2020,10,6,18,1200,1203,1388,185
2020,10,6,19,1210,1201,1392,191
2020,10,6,20,1215,1219,1465,246
2020,10,6,21,1225,1231,1454,223
2020,10,6,22,1235,1257,1447,190
2020,10,6,23,1250,1274,1486,212
2020,10,7,0,1255,1284,1481,197
2020,10,7,1,1240,1275,1464,189
2020,10,7,2,1250,1267,1438,171
2020,10,7,3,1230,1237,1366,129
2020,10,7,4,1155,1147,1278,131
2020,10,7,5,1085,1066,1203,137
2020,10,7,6,1000,995,1166,171
2020,10,7,7,960,939,1160,221
2020,10,7,8,935,914,1197,283
2020,10,7,9,920,915,1169,254
2020,10,7,10,925,904,1155,251
2020,10,7,11,935,914,1167,253
2020,10,7,12,980,960,1179,219
2020,10,7,13,1100,1068,1184,116
2020,10,7,14,1195,1143,1124,-19
2020,10,7,15,1210,1156,1126,-30
2020,10,7,16,1205,1153,1100,-53
2020,10,7,17,1215,1163,1129,-34
2020,10,7,18,1225,1162,1147,-15
2020,10,7,19,1225,1168,1161,-7
2020,10,7,20,1235,1181,1175,-6
2020,10,7,21,1240,1188,1188,0
2020,10,7,22,1245,1205,1201,-4
2020,10,7,23,1250,1222,1230,8
2020,10,8,0,1255,1227,1246,19
2020,10,8,1,1250,1228,1259,31
2020,10,8,2,1275,1229,1260,31
2020,10,8,3,1260,1194,1266,72
2020,10,8,4,1195,1129,1234,105
2020,10,8,5,1110,1035,1148,113
2020,10,8,6,1035,972,1132,160
2020,10,8,7,950,935,1147,212
2020,10,8,8,930,910,1099,189
2020,10,8,9,920,902,1100,198
2020,10,8,10,920,902,1117,215
2020,10,8,11,925,908,1138,230
2020,10,8,12,980,968,1184,216
2020,10,8,13,1100,1054,1230,176
2020,10,8,14,1190,1159,1298,139
2020,10,8,15,1205,1167,1304,137
2020,10,8,16,1215,1190,1350,160
2020,10,8,17,1210,1188,1364,176
2020,10,8,18,1215,1185,1373,188
2020,10,8,19,1210,1183,1360,177
2020,10,8,20,1220,1209,1401,192
2020,10,8,21,1215,1226,1467,241
2020,10,8,22,1235,1241,1473,232
2020,10,8,23,1230,1239,1436,197
2020,10,9,0,1240,1233,1447,214
2020,10,9,1,1235,1217,1395,178
2020,10,9,2,1260,1237,1374,137
2020,10,9,3,1235,1201,1310,109
2020,10,9,4,1190,1141,1356,215
2020,10,9,5,1085,1057,1340,283
2020,10,9,6,1020,977,1310,333
2020,10,9,7,925,945,1333,388
2020,10,9,8,910,908,1347,439
2020,10,9,9,910,906,1403,497
2020,10,9,10,905,913,1444,531
2020,10,9,11,915,916,1446,530
2020,10,9,12,945,958,1396,438
2020,10,9,13,1045,1038,1321,283
2020,10,9,14,1130,1128,1292,164
2020,10,9,15,1150,1149,1266,117
2020,10,9,16,1160,1147,1254,107
2020,10,9,17,1165,1161,1325,164
2020,10,9,18,1165,1169,1367,198
2020,10,9,19,1160,1161,1387,226
2020,10,9,20,1160,1178,1400,222
2020,10,9,21,1170,1176,1405,229
2020,10,9,22,1170,1184,1417,233
2020,10,9,23,1170,1188,1360,172
2020,10,10,0,1170,1179,1335,156
2020,10,10,1,1165,1173,1315,142
2020,10,10,2,1180,1178,1242,64
2020,10,10,3,1155,1159,1234,75
2020,10,10,4,1130,1116,1256,140
2020,10,10,5,1045,1051,1237,186
2020,10,10,6,985,1014,1242,228
2020,10,10,7,950,966,1223,257
2020,10,10,8,920,956,1222,266
2020,10,10,9,910,940,1225,285
2020,10,10,10,910,931,1215,284
2020,10,10,11,910,937,1211,274
2020,10,10,12,940,951,1224,273
2020,10,10,13,995,983,1230,247
2020,10,10,14,1055,1041,1244,203
2020,10,10,15,1095,1081,1253,172
2020,10,10,16,1120,1102,1263,161
2020,10,10,17,1135,1113,1274,161
2020,10,10,18,1125,1131,1289,158
2020,10,10,19,1125,1121,1295,174
2020,10,10,20,1120,1121,1295,174
2020,10,10,21,1130,1148,1386,238
2020,10,10,22,1145,1153,1338,185
2020,10,10,23,1155,1157,1437,280
2020,10,11,0,1160,1194,1474,280
2020,10,11,1,1165,1198,1470,272
2020,10,11,2,1190,1198,1463,265
2020,10,11,3,1165,1191,1492,301
2020,10,11,4,1080,1140,1493,353
2020,10,11,5,1055,1073,1385,312
2020,10,11,6,985,1002,1313,311
2020,10,11,7,945,971,1293,322
2020,10,11,8,930,944,1382,438
2020,10,11,9,915,933,1332,399
2020,10,11,10,915,928,1352,424
2020,10,11,11,920,940,1349,409
2020,10,11,12,1035,951,1354,403
2020,10,11,13,995,992,1369,377
2020,10,11,14,1055,1035,1391,356
2020,10,11,15,1080,1054,863,-191
2020,10,11,16,1120,1119,829,-290
2020,10,11,17,1135,1147,836,-311
2020,10,11,18,1145,1159,842,-317
2020,10,11,19,1160,1171,848,-323
2020,10,11,20,1155,1172,859,-313
2020,10,11,21,1165,1157,858,-299
2020,10,11,22,1180,1154,854,-300
2020,10,11,23,1200,1173,857,-316
2020,10,12,0,1210,1198,855,-343
2020,10,12,1,1210,1216,842,-374
2020,10,12,2,1230,1245,834,-411
2020,10,12,3,1205,1220,809,-411
2020,10,12,4,1120,1157,802,-355
2020,10,12,5,1055,1083,767,-316
2020,10,12,6,990,1017,737,-280
2020,10,12,7,975,983,804,-179
2020,10,12,8,955,962,753,-209
2020,10,12,9,945,958,696,-262
2020,10,12,10,945,965,727,-238
2020,10,12,11,955,969,623,-346
2020,10,12,12,1000,1017,714,-303
2020,10,12,13,1075,1116,624,-492
2020,10,12,14,1140,1216,795,-421
2020,10,12,15,1160,1231,779,-452
2020,10,12,16,1170,1247,788,-459
2020,10,12,17,1170,1249,792,-457
2020,10,12,18,1180,1260,756,-504
2020,10,12,19,1175,1247,739,-508
2020,10,12,20,1195,1236,677,-559
2020,10,12,21,1210,1216,749,-467
2020,10,12,22,1220,1214,700,-514
2020,10,12,23,1230,1217,731,-486
2020,10,13,0,1240,1225,759,-466
2020,10,13,1,1235,1253,803,-450
2020,10,13,2,1250,1275,852,-423
2020,10,13,3,1220,1233,831,-402
2020,10,13,4,1140,1177,835,-342
2020,10,13,5,1075,1107,779,-328
2020,10,13,6,995,1051,769,-282
2020,10,13,7,1000,1010,726,-284
2020,10,13,8,985,993,704,-289
2020,10,13,9,975,979,691,-288
2020,10,13,10,965,988,658,-330
2020,10,13,11,980,993,609,-384
2020,10,13,12,1015,1044,617,-427
2020,10,13,13,1100,1154,649,-505
2020,10,13,14,1150,1231,624,-607
2020,10,13,15,1165,1248,582,-666
2020,10,13,16,1190,1260,562,-698
2020,10,13,17,1205,1254,578,-676
2020,10,13,18,1210,1218,563,-655
2020,10,13,19,1210,1228,545,-683
2020,10,13,20,1225,1224,581,-643
2020,10,13,21,1230,1232,626,-606
2020,10,13,22,1250,1235,584,-651
2020,10,13,23,1265,1243,682,-561
2020,10,14,0,1280,1262,786,-476
2020,10,14,1,1275,1284,765,-519
2020,10,14,2,1275,1289,802,-487
2020,10,14,3,1245,1254,818,-436
2020,10,14,4,1150,1192,876,-316
2020,10,14,5,1085,1079,982,-97
2020,10,14,6,1010,1028,1005,-23
2020,10,14,7,1005,978,1058,80
2020,10,14,8,975,952,1127,175
2020,10,14,9,975,931,1098,167
2020,10,14,10,970,941,1137,196
2020,10,14,11,975,947,1087,140
2020,10,14,12,1030,985,1034,49
2020,10,14,13,1140,1090,1046,-44
2020,10,14,14,1225,1187,1059,-128
2020,10,14,15,1240,1187,1043,-144
2020,10,14,16,1240,1203,1042,-161
2020,10,14,17,1245,1211,1050,-161
2020,10,14,18,1250,1202,1125,-77
2020,10,14,19,1250,1186,1083,-103
2020,10,14,20,1260,1179,1147,-32
2020,10,14,21,1260,1167,1128,-39
2020,10,14,22,1270,1150,1116,-34
2020,10,14,23,1285,1147,1071,-76
2020,10,15,0,1290,1165,1044,-121
2020,10,15,1,1295,1198,995,-203
2020,10,15,2,1305,1219,1012,-207
2020,10,15,3,1270,1191,1018,-173
2020,10,15,4,1225,1160,1112,-48
2020,10,15,5,1115,1102,1110,8
2020,10,15,6,1045,1066,1152,86
2020,10,15,7,985,1025,1174,149
2020,10,15,8,985,1008,1186,178
2020,10,15,9,960,1002,1231,229
2020,10,15,10,950,1012,1230,218
2020,10,15,11,955,1020,1188,168
2020,10,15,12,960,1066,1199,133
2020,10,15,13,1020,1145,1150,5
2020,10,15,14,1130,1226,1116,-110
2020,10,15,15,1245,1263,1090,-173
2020,10,15,16,1255,1265,1070,-195
2020,10,15,17,1275,1254,1039,-215
2020,10,15,18,1270,1242,1037,-205
2020,10,15,19,1260,1229,1062,-167
2020,10,15,20,1260,1216,1030,-186
2020,10,15,21,1280,1202,1140,-62
2020,10,15,22,1290,1187,1069,-118
2020,10,15,23,1305,1190,1096,-94
2020,10,16,0,1305,1192,1158,-34
2020,10,16,1,1305,1230,1080,-150
2020,10,16,2,1300,1254,1137,-117
2020,10,16,3,1320,1223,1177,-46
2020,10,16,4,1285,1173,1203,30
2020,10,16,5,1245,1120,1268,148
2020,10,16,6,1125,1062,1234,172
2020,10,16,7,1050,1043,1286,243
2020,10,16,8,1015,1019,1379,360
2020,10,16,9,1010,1010,1345,335
2020,10,16,10,1015,1019,1359,340
2020,10,16,11,1020,1023,1350,327
2020,10,16,12,1065,1060,1344,284
2020,10,16,13,1140,1128,1356,228
2020,10,16,14,1225,1214,1343,129
2020,10,16,15,1245,1251,1356,105
2020,10,16,16,1250,1261,1352,91
2020,10,16,17,1260,1265,1392,127
2020,10,16,18,1260,1270,1439,169
2020,10,16,19,1255,1251,1436,185
2020,10,16,20,1260,1243,1478,235
2020,10,16,21,1260,1224,1460,236
2020,10,16,22,1260,1213,1468,255
2020,10,16,23,1265,1225,1453,228
2020,10,17,0,1260,1244,1479,235
2020,10,17,1,1265,1267,1496,229
2020,10,17,2,1275,1269,1500,231
2020,10,17,3,1250,1226,1508,282
2020,10,17,4,1225,1175,1488,313
2020,10,17,5,1135,1103,1490,387
2020,10,17,6,1090,1055,1523,468
2020,10,17,7,1025,1009,1445,436
2020,10,17,8,1010,979,1232,253
2020,10,17,9,995,968,1188,220
2020,10,17,10,990,987,1183,196
2020,10,17,11,995,1015,1246,231
2020,10,17,12,1015,1061,1187,126
2020,10,17,13,1060,1127,1149,22
2020,10,17,14,1115,1213,1123,-90
2020,10,17,15,1160,1282,1119,-163
2020,10,17,16,1180,1293,1151,-142
2020,10,17,17,1185,1319,1145,-174
2020,10,17,18,1195,1316,1141,-175
2020,10,17,19,1185,1311,1123,-188
2020,10,17,20,1180,1288,1106,-182
2020,10,17,21,1200,1298,1089,-209
2020,10,17,22,1200,1299,1106,-193
2020,10,17,23,1210,1315,1152,-163
2020,10,18,0,1235,1329,1169,-160
2020,10,18,1,1250,1352,1223,-129
2020,10,18,2,1260,1354,1227,-127
2020,10,18,3,1240,1315,1250,-65
2020,10,18,4,1185,1274,1239,-35
2020,10,18,5,1120,1228,1200,-28
2020,10,18,6,1050,1188,1244,56
2020,10,18,7,1090,1138,1203,65
2020,10,18,8,1065,1119,1149,30
2020,10,18,9,1050,1105,1122,17
2020,10,18,10,1050,1088,1123,35
2020,10,18,11,1060,1088,1116,28
2020,10,18,12,1105,1103,1120,17
2020,10,18,13,1100,1144,1114,-30
2020,10,18,14,1120,1202,1115,-87
2020,10,18,15,1150,1255,1136,-119
2020,10,18,16,1200,1305,1159,-146
2020,10,18,17,1225,1316,1174,-142
2020,10,18,18,1235,1305,1172,-133
2020,10,18,19,1240,1305,1103,-202
2020,10,18,20,1240,1325,1145,-180
2020,10,18,21,1225,1336,1152,-184
2020,10,18,22,1225,1322,1150,-172
2020,10,18,23,1240,1311,1116,-195
2020,10,19,0,1260,1339,1109,-230
2020,10,19,1,1280,1378,1114,-264
2020,10,19,2,1310,1388,1112,-276
2020,10,19,3,1280,1339,1111,-228
2020,10,19,4,1220,1288,1018,-270
2020,10,19,5,1140,1213,1025,-188
2020,10,19,6,1075,1148,1022,-126
2020,10,19,7,1045,1102,980,-122
2020,10,19,8,1025,1107,978,-129
2020,10,19,9,1020,1100,987,-113
2020,10,19,10,1025,1086,967,-119
2020,10,19,11,1035,1095,969,-126
2020,10,19,12,1080,1119,978,-141
2020,10,19,13,1140,1210,1080,-130
2020,10,19,14,1195,1307,1079,-228
2020,10,19,15,1215,1338,1054,-284
2020,10,19,16,1225,1331,1014,-317
2020,10,19,17,1230,1339,1079,-260
2020,10,19,18,1235,1320,1093,-227
2020,10,19,19,1225,1311,1106,-205
2020,10,19,20,1220,1292,1146,-146
2020,10,19,21,1205,1267,1079,-188
2020,10,19,22,1200,1259,1254,-5
2020,10,19,23,1205,1263,1270,7
2020,10,20,0,1215,1290,1254,-36
2020,10,20,1,1240,1329,1287,-42
2020,10,20,2,1260,1314,1245,-69
2020,10,20,3,1225,1277,1357,80
2020,10,20,4,1195,1220,1382,162
2020,10,20,5,1095,1155,1353,198
2020,10,20,6,1040,1080,1338,258
2020,10,20,7,1020,1046,1263,217
2020,10,20,8,1005,1040,1233,193
2020,10,20,9,995,1016,1266,250
2020,10,20,10,995,1025,1433,408
2020,10,20,11,1005,1035,1381,346
2020,10,20,12,1045,1072,1356,284
2020,10,20,13,1130,1171,1378,207
2020,10,20,14,1185,1266,1325,59
2020,10,20,15,1210,1275,1263,-12
2020,10,20,16,1225,1284,1215,-69
2020,10,20,17,1230,1262,1227,-35
2020,10,20,18,1205,1301,1216,-85
2020,10,20,19,1210,1255,1205,-50
2020,10,20,20,1215,1183,1201,18
2020,10,20,21,1220,1213,1175,-38
2020,10,20,22,1225,1221,1162,-59
2020,10,20,23,1235,1227,1143,-84
2020,10,21,0,1255,1257,1155,-102
2020,10,21,1,1270,1284,1207,-77
2020,10,21,2,1275,1304,1205,-99
2020,10,21,3,1240,1268,1200,-68
2020,10,21,4,1185,1217,1149,-68
2020,10,21,5,1070,1136,1119,-17
2020,10,21,6,1015,1076,1121,45
2020,10,21,7,1080,1039,1132,93
2020,10,21,8,1055,1030,1160,130
2020,10,21,9,1040,1022,1158,136
2020,10,21,10,1045,1019,1162,143
2020,10,21,11,1050,1044,1159,115
2020,10,21,12,1095,1089,1169,80
2020,10,21,13,1205,1196,1174,-22
2020,10,21,14,1305,1297,1175,-122
2020,10,21,15,1315,1313,1141,-172
2020,10,21,16,1325,1316,1129,-187
2020,10,21,17,1335,1312,1144,-168
2020,10,21,18,1325,1304,1150,-154
2020,10,21,19,1310,1291,1186,-105
2020,10,21,20,1305,1301,1231,-70
2020,10,21,21,1290,1307,1232,-75
2020,10,21,22,1280,1300,1262,-38
2020,10,21,23,1285,1341,1390,49
2020,10,22,0,1300,1378,1387,9
2020,10,22,1,1335,1441,1482,41
2020,10,22,2,1345,1428,1513,85
2020,10,22,3,1310,1380,1470,90
2020,10,22,4,1305,1318,1472,154
2020,10,22,5,1190,1242,1437,195
2020,10,22,6,1135,1182,1428,246
2020,10,22,7,1120,1150,1424,274
2020,10,22,8,1105,1133,1423,290
2020,10,22,9,1090,1123,1431,308
2020,10,22,10,1100,1118,1431,313
2020,10,22,11,1110,1138,1432,294
2020,10,22,12,1160,1194,1435,241
2020,10,22,13,1250,1288,1440,152
2020,10,22,14,1335,1390,1430,40
2020,10,22,15,1365,1401,1362,-39
2020,10,22,16,1370,1409,1306,-103
2020,10,22,17,1360,1411,1283,-128
2020,10,22,18,1365,1377,1235,-142
2020,10,22,19,1345,1356,1246,-110
2020,10,22,20,1325,1330,1200,-130
2020,10,22,21,1320,1338,1201,-137
2020,10,22,22,1315,1341,1170,-171
2020,10,22,23,1320,1344,1143,-201
2020,10,23,0,1325,1354,1125,-229
2020,10,23,1,1355,1404,1167,-237
2020,10,23,2,1380,1409,1206,-203
2020,10,23,3,1345,1393,1215,-178
2020,10,23,4,1335,1342,1200,-142
2020,10,23,5,1215,1272,1186,-86
2020,10,23,6,1145,1197,1172,-25
2020,10,23,7,1190,1175,1193,18
2020,10,23,8,1160,1156,1195,39
2020,10,23,9,1150,1155,1195,40
2020,10,23,10,1160,1164,1194,30
2020,10,23,11,1170,1175,1183,8
2020,10,23,12,1215,1238,1186,-52
2020,10,23,13,1305,1334,1184,-150
2020,10,23,14,1410,1436,1184,-252
2020,10,23,15,1445,1466,1179,-287
2020,10,23,16,1450,1463,1192,-271
2020,10,23,17,1460,1435,1191,-244
2020,10,23,18,1460,1425,1211,-214
2020,10,23,19,1445,1400,1221,-179
2020,10,23,20,1440,1391,1216,-175
2020,10,23,21,1430,1390,1201,-189
2020,10,23,22,1420,1410,1203,-207
2020,10,23,23,1435,1430,1191,-239
2020,10,24,0,1460,1453,1199,-254
2020,10,24,1,1490,1483,1211,-272
2020,10,24,2,1485,1487,1216,-271
2020,10,24,3,1440,1453,1224,-229
2020,10,24,4,1410,1406,1227,-179
2020,10,24,5,1295,1344,1225,-119
2020,10,24,6,1240,1288,1253,-35
2020,10,24,7,1190,1257,1284,27
2020,10,24,8,1165,1240,1315,75
2020,10,24,9,1150,1236,1289,53
2020,10,24,10,1160,1233,1313,80
2020,10,24,11,1170,1236,1319,83
2020,10,24,12,1210,1267,1349,82
2020,10,24,13,1220,1289,1348,59
2020,10,24,14,1260,1361,1358,-3
2020,10,24,15,1315,1412,1363,-49
2020,10,24,16,1335,1430,1428,-2
2020,10,24,17,1355,1449,1454,5
2020,10,24,18,1355,1448,1483,35
2020,10,24,19,1345,1436,1502,66
2020,10,24,20,1335,1423,1462,39
2020,10,24,21,1340,1404,1433,29
2020,10,24,22,1340,1411,1432,21
2020,10,24,23,1350,1430,1425,-5
2020,10,25,0,1370,1449,1386,-63
2020,10,25,1,1400,1508,1381,-127
2020,10,25,2,1400,1498,1380,-118
2020,10,25,3,1370,1463,1352,-111
2020,10,25,4,1340,1420,1317,-103
2020,10,25,5,1260,1364,1241,-123
2020,10,25,6,1205,1310,1190,-120
2020,10,25,7,1245,1280,1196,-84
2020,10,25,8,1225,1264,1220,-44
2020,10,25,9,1215,1262,1229,-33
2020,10,25,10,1210,1266,1204,-62
2020,10,25,11,1220,1279,1233,-46
2020,10,25,12,1245,1300,1233,-67
2020,10,25,13,1250,1346,1221,-125
2020,10,25,14,1270,1386,1176,-210
2020,10,25,15,1315,1443,1174,-269
2020,10,25,16,1360,1463,1175,-288
2020,10,25,17,1380,1480,1169,-311
2020,10,25,18,1380,1449,1156,-293
2020,10,25,19,1375,1437,1160,-277
2020,10,25,20,1375,1419,1162,-257
2020,10,25,21,1375,1388,1152,-236
2020,10,25,22,1370,1381,1169,-212
2020,10,25,23,1375,1399,1225,-174
2020,10,26,0,1405,1439,1270,-169
2020,10,26,1,1440,1505,1323,-182
2020,10,26,2,1450,1546,1351,-195
2020,10,26,3,1410,1512,1339,-173
2020,10,26,4,1380,1464,1330,-134
2020,10,26,5,1265,1392,1344,-48
2020,10,26,6,1195,1338,1362,24
2020,10,26,7,1225,1304,1375,71
2020,10,26,8,1215,1312,1426,114
2020,10,26,9,1205,1309,1454,145
2020,10,26,10,1200,1320,1477,157
2020,10,26,11,1215,1348,1495,147
2020,10,26,12,1260,1401,1507,106
2020,10,26,13,1315,1492,1495,3
2020,10,26,14,1375,1584,1500,-84
2020,10,26,15,1410,1608,1519,-89
2020,10,26,16,1410,1586,1512,-74
2020,10,26,17,1420,1587,1572,-15
2020,10,26,18,1400,1550,1534,-16
2020,10,26,19,1390,1532,1574,42
2020,10,26,20,1375,1509,1620,111
2020,10,26,21,1355,1474,1580,106
2020,10,26,22,1350,1454,1587,133
2020,10,26,23,1355,1466,1550,84
2020,10,27,0,1375,1485,1565,80
2020,10,27,1,1415,1543,1547,4
2020,10,27,2,1410,1541,1571,30
2020,10,27,3,1375,1499,1573,74
2020,10,27,4,1340,1423,1551,128
2020,10,27,5,1240,1344,1549,205
2020,10,27,6,1160,1276,1533,257
2020,10,27,7,1230,1249,1567,318
2020,10,27,8,1220,1222,1620,398
2020,10,27,9,1200,1218,1620,402
2020,10,27,10,1205,1226,1600,374
2020,10,27,11,1220,1239,1571,332
2020,10,27,12,1255,1288,1503,215
2020,10,27,13,1330,1390,1496,106
2020,10,27,14,1395,1463,1502,39
2020,10,27,15,1415,1475,1534,59
2020,10,27,16,1430,1473,1526,53
2020,10,27,17,1420,1442,1547,105
2020,10,27,18,1435,1417,1591,174
2020,10,27,19,1400,1385,1578,193
2020,10,27,20,1345,1340,1607,267
2020,10,27,21,1360,1375,1595,220
2020,10,27,22,1370,1354,1606,252
2020,10,27,23,1375,1364,1611,247
2020,10,28,0,1410,1376,1652,276
2020,10,28,1,1445,1424,1662,238
2020,10,28,2,1470,1426,1645,219
2020,10,28,3,1430,1404,1651,247
2020,10,28,4,1395,1330,1645,315
2020,10,28,5,1280,1253,1427,174
2020,10,28,6,1210,1213,1124,-89
2020,10,28,7,1125,1168,991,-177
2020,10,28,8,1120,1163,981,-182
2020,10,28,9,1105,1158,982,-176
2020,10,28,10,1105,1144,962,-182
2020,10,28,11,1135,1145,932,-213
2020,10,28,12,1180,1203,859,-344
2020,10,28,13,1260,1299,747,-552
2020,10,28,14,1340,1393,710,-683
2020,10,28,15,1355,1400,691,-709
2020,10,28,16,1355,1401,752,-649
2020,10,28,17,1355,1379,757,-622
2020,10,28,18,1340,1359,813,-546
2020,10,28,19,1330,1323,815,-508
2020,10,28,20,1330,1292,826,-466
2020,10,28,21,1325,1282,806,-476
2020,10,28,22,1315,1273,822,-451
2020,10,28,23,1340,1281,894,-387
2020,10,29,0,1375,1309,893,-416
2020,10,29,1,1430,1356,863,-493
2020,10,29,2,1420,1354,893,-461
2020,10,29,3,1385,1332,895,-437
2020,10,29,4,1340,1265,889,-376
2020,10,29,5,1240,1199,928,-271
2020,10,29,6,1185,1146,944,-202
2020,10,29,7,1110,1099,964,-135
2020,10,29,8,1090,1083,948,-135
2020,10,29,9,1080,1075,936,-139
2020,10,29,10,1080,1075,951,-124
2020,10,29,11,1095,1095,972,-123
2020,10,29,12,1145,1139,979,-160
2020,10,29,13,1190,1239,986,-253
2020,10,29,14,1235,1329,991,-338
2020,10,29,15,1250,1350,984,-366
2020,10,29,16,1255,1337,999,-338
2020,10,29,17,1250,1330,1000,-330
2020,10,29,18,1225,1312,1005,-307
2020,10,29,19,1205,1286,1010,-276
2020,10,29,20,1185,1266,988,-278
2020,10,29,21,1190,1246,1010,-236
2020,10,29,22,1190,1220,1005,-215
2020,10,29,23,1190,1209,948,-261
2020,10,30,0,1200,1202,932,-270
2020,10,30,1,1245,1254,848,-406
2020,10,30,2,1250,1259,763,-496
2020,10,30,3,1230,1240,668,-572
2020,10,30,4,1180,1195,641,-554
2020,10,30,5,1120,1132,628,-504
2020,10,30,6,1065,1075,645,-430
2020,10,30,7,1045,1055,670,-385
2020,10,30,8,1025,1038,700,-338
2020,10,30,9,1025,1036,735,-301
2020,10,30,10,1025,1048,745,-303
2020,10,30,11,1035,1068,728,-340
2020,10,30,12,1085,1114,742,-372
2020,10,30,13,1160,1225,792,-433
2020,10,30,14,1245,1317,777,-540
2020,10,30,15,1265,1341,764,-577
2020,10,30,16,1265,1323,762,-561
2020,10,30,17,1245,1297,829,-468
2020,10,30,18,1240,1290,815,-475
2020,10,30,19,1215,1260,795,-465
2020,10,30,20,1205,1236,793,-443
2020,10,30,21,1200,1225,852,-373
2020,10,30,22,1210,1221,787,-434
2020,10,30,23,1210,1233,887,-346
2020,10,31,0,1230,1237,899,-338
2020,10,31,1,1260,1269,898,-371
2020,10,31,2,1250,1262,930,-332
2020,10,31,3,1225,1236,929,-307
2020,10,31,4,1180,1206,894,-312
2020,10,31,5,1115,1151,844,-307
2020,10,31,6,1065,1106,897,-209
2020,10,31,7,1045,1068,914,-154
2020,10,31,8,1030,1053,906,-147
2020,10,31,9,1020,1037,920,-117
2020,10,31,10,1025,1040,928,-112
2020,10,31,11,1035,1038,923,-115
2020,10,31,12,1070,1062,920,-142
2020,10,31,13,1090,1105,859,-246
2020,10,31,14,1140,1157,850,-307
2020,10,31,15,1175,1208,870,-338
2020,10,31,16,1195,1226,775,-451
2020,10,31,17,1215,1227,663,-564
2020,10,31,18,1210,1213,696,-517
2020,10,31,19,1200,1203,682,-521
2020,10,31,20,1185,1167,652,-515
2020,10,31,21,1170,1149,727,-422
2020,10,31,22,1170,1138,767,-371
2020,10,31,23,1180,1147,726,-421
2020,11,1,0,1195,1169,638,-531
2020,11,1,1,1240,1215,627,-588
2020,11,1,2,1235,1222,568,-654
2020,11,1,3,1210,1208,578,-630
2020,11,1,4,1140,1180,600,-580
2020,11,1,5,1115,1155,614,-541
2020,11,1,6,1070,1115,639,-476
2020,11,1,7,1045,1128,702,-426
2020,11,1,8,1030,1065,701,-364
2020,11,1,9,1025,991,573,-418
2020,11,1,10,1025,1067,791,-276
2020,11,1,11,1040,1087,879,-208
2020,11,1,12,1060,1090,875,-215
2020,11,1,13,1085,1129,868,-261
2020,11,1,14,1105,1184,858,-326
2020,11,1,15,1150,1234,914,-320
2020,11,1,16,1165,1252,880,-372
2020,11,1,17,1175,1262,844,-418
2020,11,1,18,1155,1247,876,-371
2020,11,1,19,1150,1243,898,-345
2020,11,1,20,1135,1223,905,-318
2020,11,1,21,1115,1196,909,-287
2020,11,1,22,1110,1179,886,-293
2020,11,1,23,1115,1198,861,-337
2020,11,2,0,1140,1216,788,-428
2020,11,2,1,1185,1307,820,-487
2020,11,2,2,1210,1320,805,-515
2020,11,2,3,1185,1299,790,-509
2020,11,2,4,1105,1258,741,-517
2020,11,2,5,1080,1184,704,-480
2020,11,2,6,1035,1125,721,-404
2020,11,2,7,-9999,1076,676,-400
2020,11,2,8,1040,1058,730,-328
2020,11,2,9,1040,1062,779,-283
2020,11,2,10,1035,1043,796,-247
2020,11,2,11,1040,1063,817,-246
2020,11,2,12,1060,1093,786,-307
2020,11,2,13,1100,1154,844,-310
2020,11,2,14,1185,1272,823,-449
2020,11,2,15,1270,1341,814,-527
2020,11,2,16,1290,1349,794,-555
2020,11,2,17,1275,1330,786,-544
2020,11,2,18,1275,1330,830,-500
2020,11,2,19,1250,1325,891,-434
2020,11,2,20,1235,1292,944,-348
2020,11,2,21,1220,1261,890,-371
2020,11,2,22,1190,1217,999,-218
2020,11,2,23,1175,1188,1046,-142
2020,11,3,0,1180,1198,1067,-131
2020,11,3,1,1195,1265,1279,14
2020,11,3,2,1240,1266,1344,78
2020,11,3,3,1240,1234,1442,208
2020,11,3,4,1205,1197,1451,254
2020,11,3,5,1170,1132,1399,267
2020,11,3,6,1085,1072,1402,330
2020,11,3,7,1030,1017,1360,343
2020,11,3,8,1100,1045,1424,379
2020,11,3,9,1075,1035,1448,413
2020,11,3,10,1050,1037,1545,508
2020,11,3,11,1075,1039,1537,498
2020,11,3,12,1085,1053,1501,448
2020,11,3,13,1130,1108,1528,420
2020,11,3,14,1230,1229,1570,341
2020,11,3,15,1310,1294,1503,209
2020,11,3,16,1325,1289,1531,242
2020,11,3,17,1325,1285,1577,292
2020,11,3,18,1300,1260,1571,311
2020,11,3,19,1290,1257,1590,333
2020,11,3,20,1260,1242,1597,355
2020,11,3,21,1220,1238,1600,362
2020,11,3,22,1240,1219,1589,370
2020,11,3,23,1230,1214,1592,378
2020,11,4,0,1240,1241,1549,308
2020,11,4,1,1275,1292,1472,180
2020,11,4,2,1310,1298,1381,83
2020,11,4,3,1310,1261,1406,145
2020,11,4,4,1280,1216,1378,162
2020,11,4,5,1250,1163,1367,204
2020,11,4,6,1145,1108,1429,321
2020,11,4,7,1105,1043,1425,382
2020,11,4,8,995,1014,1429,415
2020,11,4,9,995,1007,1574,567
2020,11,4,10,985,1007,1537,530
2020,11,4,11,980,999,1521,522
2020,11,4,12,990,1014,1455,441
2020,11,4,13,1045,1062,1502,440
2020,11,4,14,1195,1172,1519,347
2020,11,4,15,1330,1247,1617,370
2020,11,4,16,1340,1246,1616,370
2020,11,4,17,1335,1248,1637,389
2020,11,4,18,1325,1243,1708,465
2020,11,4,19,1310,1240,1713,473
2020,11,4,20,1275,1237,1703,466
2020,11,4,21,1255,1231,1692,461
2020,11,4,22,1240,1209,1687,478
2020,11,4,23,1225,1201,1616,415
2020,11,5,0,1240,1195,1552,357
2020,11,5,1,1275,1274,1519,245
2020,11,5,2,1310,1270,1527,257
2020,11,5,3,1300,1241,1478,237
2020,11,5,4,1275,1212,1441,229
2020,11,5,5,1230,1156,1429,273
2020,11,5,6,1145,1090,1444,354
2020,11,5,7,1090,1044,1478,434
2020,11,5,8,990,1022,1307,285
2020,11,5,9,975,1012,1284,272
2020,11,5,10,970,1001,1329,328
2020,11,5,11,970,1013,1325,312
2020,11,5,12,990,1028,1245,217
2020,11,5,13,1035,1080,1237,157
2020,11,5,14,1150,1157,1411,254
2020,11,5,15,1255,1222,1456,234
2020,11,5,16,1270,1232,1418,186
2020,11,5,17,1260,1220,1429,209
2020,11,5,18,1255,1219,1425,206
2020,11,5,19,1235,1203,1487,284
2020,11,5,20,1215,1198,1528,330
2020,11,5,21,1200,1209,1543,334
2020,11,5,22,1185,1202,1533,331
2020,11,5,23,1170,1198,1524,326
2020,11,6,0,1165,1212,1493,281
2020,11,6,1,1175,1279,1428,149
2020,11,6,2,1215,1269,1388,119
2020,11,6,3,1210,1249,1344,95
2020,11,6,4,1185,1201,1276,75
2020,11,6,5,1120,1150,1245,95
2020,11,6,6,1085,1095,1271,176
2020,11,6,7,1015,1038,1265,227
2020,11,6,8,1000,992,1269,277
2020,11,6,9,985,966,1298,332
2020,11,6,10,985,975,1339,364
2020,11,6,11,990,966,1342,376
2020,11,6,12,1010,981,1332,351
2020,11,6,13,1060,1038,1347,309
2020,11,6,14,1195,1128,1346,218
2020,11,6,15,1315,1203,1307,104
2020,11,6,16,1335,1236,1283,47
2020,11,6,17,1325,1230,1260,30
2020,11,6,18,1300,1243,1256,13
2020,11,6,19,1295,1224,1261,37
2020,11,6,20,1275,1208,1259,51
2020,11,6,21,1255,1204,1296,92
2020,11,6,22,1240,1189,1298,109
2020,11,6,23,1240,1191,1314,123
2020,11,7,0,1245,1224,1373,149
2020,11,7,1,1270,1279,1374,95
2020,11,7,2,1295,1289,1369,80
2020,11,7,3,1280,1261,1361,100
2020,11,7,4,1255,1226,1339,113
2020,11,7,5,1215,1184,1260,76
2020,11,7,6,1155,1129,1186,57
2020,11,7,7,1110,1085,1203,118
2020,11,7,8,1040,1045,1199,154
2020,11,7,9,1025,1023,1190,167
2020,11,7,10,1010,1020,1183,163
2020,11,7,11,1015,1015,1183,168
2020,11,7,12,1020,1018,1175,157
2020,11,7,13,1050,1047,1183,136
2020,11,7,14,1110,1090,1184,94
2020,11,7,15,1180,1133,1190,57
2020,11,7,16,1220,1172,1196,24
2020,11,7,17,1235,1190,1205,15
2020,11,7,18,1240,1201,1195,-6
2020,11,7,19,1225,1202,1203,1
2020,11,7,20,1220,1179,1187,8
2020,11,7,21,1195,1176,1189,13
2020,11,7,22,1180,1181,1208,27
2020,11,7,23,1170,1194,1235,41
2020,11,8,0,1185,1265,1343,78
2020,11,8,1,1215,1322,1378,56
2020,11,8,2,1250,1318,1410,92
2020,11,8,3,1250,1292,1376,84
2020,11,8,4,1225,1241,1351,110
2020,11,8,5,1180,1222,1435,213
2020,11,8,6,1155,1174,1478,304
2020,11,8,7,1110,1156,1528,372
2020,11,8,8,1250,1131,1547,416
2020,11,8,9,1205,1136,1539,403
2020,11,8,10,1150,1101,1512,411
2020,11,8,11,1220,1079,1526,447
2020,11,8,12,1225,1114,1478,364
2020,11,8,13,1265,1109,1461,352
2020,11,8,14,1285,1148,1460,312
2020,11,8,15,1295,1181,1408,227
2020,11,8,16,1315,1249,1404,155
2020,11,8,17,1325,1262,1433,171
2020,11,8,18,1315,1311,1484,173
2020,11,8,19,1305,1331,1442,111
2020,11,8,20,1290,1346,1456,110
2020,11,8,21,1270,1347,1431,84
2020,11,8,22,1255,1358,1415,57
2020,11,8,23,1265,1367,1408,41
2020,11,9,0,1280,1423,1403,-20
2020,11,9,1,1365,1530,1518,-12
2020,11,9,2,1380,1522,1520,-2
2020,11,9,3,1365,1478,1475,-3
2020,11,9,4,1325,1441,1480,39
2020,11,9,5,1295,1389,1447,58
2020,11,9,6,1195,1322,1465,143
2020,11,9,7,1140,1279,1492,213
2020,11,9,8,1215,1237,1521,284
2020,11,9,9,1215,1220,1512,292
2020,11,9,10,1200,1204,1434,230
2020,11,9,11,1220,1207,1423,216
2020,11,9,12,1245,1213,1470,257
2020,11,9,13,1305,1276,1461,185
2020,11,9,14,1375,1377,1491,114
2020,11,9,15,1410,1441,1469,28
2020,11,9,16,1420,1481,1424,-57
2020,11,9,17,1400,1473,1425,-48
2020,11,9,18,1400,1449,1435,-14
2020,11,9,19,1390,1425,1461,36
2020,11,9,20,1360,1407,1504,97
2020,11,9,21,1340,1389,1474,85
2020,11,9,22,1305,1387,1576,189
2020,11,9,23,1280,1390,1607,217
2020,11,10,0,1290,1443,1610,167
2020,11,10,1,1350,1537,1625,88
2020,11,10,2,1360,1532,1592,60
2020,11,10,3,1330,1510,1548,38
2020,11,10,4,1290,1463,1643,180
2020,11,10,5,1240,1411,1667,256
2020,11,10,6,1160,1329,1648,319
2020,11,10,7,1100,1286,1657,371
2020,11,10,8,1220,1245,1678,433
2020,11,10,9,1200,1240,1699,459
2020,11,10,10,1195,1233,1637,404
2020,11,10,11,1200,1241,1642,401
2020,11,10,12,1215,1253,1596,343
2020,11,10,13,1265,1301,1441,140
2020,11,10,14,1380,1404,1464,60
2020,11,10,15,1460,1447,1431,-16
2020,11,10,16,1475,1455,1436,-19
2020,11,10,17,1475,1459,1432,-27
2020,11,10,18,1450,1454,1448,-6
2020,11,10,19,1435,1433,1473,40
2020,11,10,20,1410,1409,1474,65
2020,11,10,21,1380,1401,1476,75
2020,11,10,22,1400,1398,1489,91
2020,11,10,23,1380,1406,1495,89
2020,11,11,0,1400,1424,1494,70
2020,11,11,1,1435,1497,1495,-2
2020,11,11,2,1470,1487,1490,3
2020,11,11,3,1455,1471,1498,27
2020,11,11,4,1420,1444,1500,56
2020,11,11,5,1380,1375,1560,185
2020,11,11,6,1280,1295,1560,265
2020,11,11,7,1220,1235,1565,330
2020,11,11,8,1235,1200,1498,298
2020,11,11,9,1220,1177,1487,310
2020,11,11,10,1215,1169,1489,320
2020,11,11,11,1210,1169,1483,314
2020,11,11,12,1220,1201,1500,299
2020,11,11,13,1280,1273,1515,242
2020,11,11,14,1380,1367,1535,168
2020,11,11,15,1455,1426,1533,107
2020,11,11,16,1475,1427,1510,83
2020,11,11,17,1475,1425,1510,85
2020,11,11,18,1460,1424,1467,43
2020,11,11,19,1440,1420,1470,50
2020,11,11,20,1425,1393,1484,91
2020,11,11,21,1410,1402,1470,68
2020,11,11,22,1395,1394,1454,60
2020,11,11,23,1390,1398,1431,33
2020,11,12,0,1425,1441,1455,14
2020,11,12,1,1510,1528,1431,-97
2020,11,12,2,1515,1526,1424,-102
2020,11,12,3,1490,1492,1392,-100
2020,11,12,4,1450,1456,1362,-94
2020,11,12,5,1380,1392,1349,-43
2020,11,12,6,1310,1309,1376,67
2020,11,12,7,1260,1239,1427,188
2020,11,12,8,1245,1330,1491,161
2020,11,12,9,1240,1213,1568,355
2020,11,12,10,1230,1213,1602,389
2020,11,12,11,1240,1228,1623,395
2020,11,12,12,1255,1252,1604,352
2020,11,12,13,1310,1305,1598,293
2020,11,12,14,1405,1400,1592,192
2020,11,12,15,1465,1456,1551,95
2020,11,12,16,1475,1478,1572,94
2020,11,12,17,1380,1463,1636,173
2020,11,12,18,1465,1435,1653,218
2020,11,12,19,1445,1402,1614,212
2020,11,12,20,1425,1394,1636,242
2020,11,12,21,1425,1371,1624,253
2020,11,12,22,1415,1370,1605,235
2020,11,12,23,1415,1389,1599,210
2020,11,13,0,1425,1431,1599,168
2020,11,13,1,1490,1505,1581,76
2020,11,13,2,1490,1511,1587,76
2020,11,13,3,1475,1493,1579,86
2020,11,13,4,1440,1456,1521,65
2020,11,13,5,1465,1383,1567,184
2020,11,13,6,1300,1326,1567,241
2020,11,13,7,1235,1265,1592,327
2020,11,13,8,1135,1233,1591,358
2020,11,13,9,1110,1221,1579,358
2020,11,13,10,1115,1221,1575,354
2020,11,13,11,1105,1233,1618,385
2020,11,13,12,1125,1239,1602,363
2020,11,13,13,1185,1285,1584,299
2020,11,13,14,1290,1372,1597,225
2020,11,13,15,1370,1441,1545,104
2020,11,13,16,1405,1441,1460,19
2020,11,13,17,1395,1434,1425,-9
2020,11,13,18,1400,1438,1427,-11
2020,11,13,19,1385,1430,1402,-28
2020,11,13,20,1365,1405,1383,-22
2020,11,13,21,1360,1398,1462,64
2020,11,13,22,1345,1389,1473,84
2020,11,13,23,1350,1398,1491,93
2020,11,14,0,1380,1429,1576,147
2020,11,14,1,1440,1471,1598,127
2020,11,14,2,1450,1455,1565,110
2020,11,14,3,1420,1420,1558,138
2020,11,14,4,1385,1385,1620,235
2020,11,14,5,1320,1340,1622,282
2020,11,14,6,1270,1280,1634,354
2020,11,14,7,1215,1224,1651,427
2020,11,14,8,1185,1191,1606,415
2020,11,14,9,1145,1175,1594,419
2020,11,14,10,1140,1164,1593,429
2020,11,14,11,1140,1171,1589,418
2020,11,14,12,1145,1177,1586,409
2020,11,14,13,1180,1207,1604,397
2020,11,14,14,1250,1241,1623,382
2020,11,14,15,1310,1293,1633,340
2020,11,14,16,1355,1334,1623,289
2020,11,14,17,1370,1364,1588,224
2020,11,14,18,1370,1393,1594,201
2020,11,14,19,1365,1397,1600,203
2020,11,14,20,1345,1378,1582,204
2020,11,14,21,1330,1354,1576,222
2020,11,14,22,1330,1353,1625,272
2020,11,14,23,1340,1345,1636,291
2020,11,15,0,1400,1390,1623,233
2020,11,15,1,1465,1469,1626,157
2020,11,15,2,1470,1456,1601,145
2020,11,15,3,1445,1416,1596,180
2020,11,15,4,1400,1383,1590,207
2020,11,15,5,1340,1352,1622,270
2020,11,15,6,1305,1278,1623,345
2020,11,15,7,1275,1208,1596,388
2020,11,15,8,1195,1168,1575,407
2020,11,15,9,1165,1158,1507,349
2020,11,15,10,1130,1156,1471,315
2020,11,15,11,1135,1156,1488,332
2020,11,15,12,1165,1154,1472,318
2020,11,15,13,1180,1175,1495,320
2020,11,15,14,1185,1217,1469,252
2020,11,15,15,1180,1258,1486,228
2020,11,15,16,1235,1302,1474,172
2020,11,15,17,1240,1328,1514,186
2020,11,15,18,1265,1321,1564,243
2020,11,15,19,1270,1307,1489,182
2020,11,15,20,1275,1302,1576,274
2020,11,15,21,1265,1289,1589,300
2020,11,15,22,1270,1288,1578,290
2020,11,15,23,1280,1303,1598,295
2020,11,16,0,1325,1346,1628,282
2020,11,16,1,1420,1438,1636,198
2020,11,16,2,1415,1435,1640,205
2020,11,16,3,1385,1400,1617,217
2020,11,16,4,1345,1366,1634,268
2020,11,16,5,1280,1295,1640,345
2020,11,16,6,1220,1223,1625,402
2020,11,16,7,1180,1165,1619,454
2020,11,16,8,1155,1134,1624,490
2020,11,16,9,1125,1094,1604,510
2020,11,16,10,1115,1111,1635,524
2020,11,16,11,1120,1101,1622,521
2020,11,16,12,1135,1122,1591,469
2020,11,16,13,1195,1176,1575,399
2020,11,16,14,1295,1286,1594,308
2020,11,16,15,1365,1371,1578,207
2020,11,16,16,1395,1385,1515,130
2020,11,16,17,1385,1389,1493,104
2020,11,16,18,1370,1391,1474,83
2020,11,16,19,1345,1386,1509,123
2020,11,16,20,1330,1368,1465,97
2020,11,16,21,1310,1360,1419,59
2020,11,16,22,1300,1348,1353,5
2020,11,16,23,1300,1350,1383,33
2020,11,17,0,1345,1380,1376,-4
2020,11,17,1,1425,1441,1395,-46
2020,11,17,2,1425,1435,1381,-54
2020,11,17,3,1400,1394,1343,-51
2020,11,17,4,1360,1350,1346,-4
2020,11,17,5,1300,1276,1352,76
2020,11,17,6,1230,1201,1322,121
2020,11,17,7,1185,1153,1302,149
2020,11,17,8,1085,1113,1338,225
2020,11,17,9,1080,1110,1320,210
2020,11,17,10,1075,1100,1338,238
2020,11,17,11,1080,1101,1323,222
2020,11,17,12,1090,1124,1316,192
2020,11,17,13,1130,1169,1365,196
2020,11,17,14,1240,1267,1340,73
2020,11,17,15,1305,1346,1333,-13
2020,11,17,16,1320,1349,1329,-20
2020,11,17,17,1325,1342,1329,-13
2020,11,17,18,1315,1334,1335,1
2020,11,17,19,1300,1329,1302,-27
2020,11,17,20,1285,1313,1401,88
2020,11,17,21,1275,1306,1375,69
2020,11,17,22,1275,1292,1374,82
2020,11,17,23,1280,1300,1373,73
2020,11,18,0,1300,1332,1365,33
2020,11,18,1,1370,1384,1421,37
2020,11,18,2,1365,1392,1439,47
2020,11,18,3,1345,1350,1414,64
2020,11,18,4,1310,1311,1259,-52
2020,11,18,5,1250,1234,943,-291
2020,11,18,6,1175,1164,887,-277
2020,11,18,7,1110,1096,943,-153
2020,11,18,8,1065,1071,989,-82
2020,11,18,9,1045,1056,1247,191
2020,11,18,10,1045,1038,1397,359
2020,11,18,11,1040,1055,1514,459
2020,11,18,12,1060,1086,1518,432
2020,11,18,13,1115,1134,1510,376
2020,11,18,14,1220,1244,1521,277
2020,11,18,15,1295,1301,1455,154
2020,11,18,16,1305,1319,1573,254
2020,11,18,17,1305,1327,1556,229
2020,11,18,18,1305,1341,1565,224
2020,11,18,19,1305,1325,1601,276
2020,11,18,20,1285,1320,1595,275
2020,11,18,21,1290,1305,1576,271
2020,11,18,22,1275,1285,1550,265
2020,11,18,23,1275,1280,1583,303
2020,11,19,0,1310,1315,1596,281
2020,11,19,1,1380,1389,1526,137
2020,11,19,2,1375,1388,1436,48
2020,11,19,3,1340,1360,1428,68
2020,11,19,4,1310,1330,1383,53
2020,11,19,5,1295,1262,1332,70
2020,11,19,6,1175,1207,1305,98
2020,11,19,7,1115,1144,1339,195
2020,11,19,8,1165,1112,1385,273
2020,11,19,9,1090,1096,1409,313
2020,11,19,10,1085,1099,1500,401
2020,11,19,11,1095,1104,1600,496
2020,11,19,12,1120,1131,1612,481
2020,11,19,13,1170,1197,1599,402
2020,11,19,14,1295,1285,1554,269
2020,11,19,15,1390,1377,1553,176
2020,11,19,16,1405,1401,1557,156
2020,11,19,17,1390,1385,1529,144
2020,11,19,18,1375,1388,1558,170
2020,11,19,19,1350,1390,1589,199
2020,11,19,20,1340,1384,1683,299
2020,11,19,21,1330,1377,1672,295
2020,11,19,22,1320,1367,1683,316
2020,11,19,23,1335,1358,1669,311
2020,11,20,0,1370,1380,1670,290
2020,11,20,1,1440,1463,1647,184
2020,11,20,2,1440,1448,1663,215
2020,11,20,3,1420,1410,1616,206
2020,11,20,4,1380,1383,1589,206
2020,11,20,5,1300,1316,1628,312
2020,11,20,6,1250,1258,1631,373
2020,11,20,7,1190,1189,1633,444
2020,11,20,8,1155,1163,1618,455
2020,11,20,9,1135,1155,1626,471
2020,11,20,10,1135,1148,1629,481
2020,11,20,11,1140,1158,1626,468
2020,11,20,12,1145,1183,1618,435
2020,11,20,13,1190,1230,1626,396
2020,11,20,14,1300,1308,1631,323
2020,11,20,15,1400,1395,1616,221
2020,11,20,16,1415,1408,1588,180
2020,11,20,17,1415,1399,1616,217
2020,11,20,18,1415,1388,1631,243
2020,11,20,19,1405,1380,1645,265
2020,11,20,20,1385,1349,1641,292
2020,11,20,21,1380,1333,1643,310
2020,11,20,22,1370,1319,1616,297
2020,11,20,23,1380,1309,1586,277
2020,11,21,0,1415,1350,1557,207
2020,11,21,1,1470,1442,1560,118
2020,11,21,2,1460,1426,1475,49
2020,11,21,3,1425,1408,1473,65
2020,11,21,4,1390,1374,1455,81
2020,11,21,5,1320,1337,1427,90
2020,11,21,6,1275,1275,1427,152
2020,11,21,7,1220,1218,1464,246
2020,11,21,8,1220,1204,1491,287
2020,11,21,9,1200,1190,1516,326
2020,11,21,10,1195,1192,1543,351
2020,11,21,11,1200,1200,1587,387
2020,11,21,12,1210,1210,1560,350
2020,11,21,13,1245,1241,1554,313
2020,11,21,14,1245,1274,1580,306
2020,11,21,15,1250,1335,1607,272
2020,11,21,16,1290,1371,1578,207
2020,11,21,17,1310,1379,1532,153
2020,11,21,18,1325,1394,1599,205
2020,11,21,19,1330,1380,1549,169
2020,11,21,20,1315,1359,1554,195
2020,11,21,21,1300,1364,1647,283
2020,11,21,22,1295,1331,1642,311
2020,11,21,23,1290,1338,1620,282
2020,11,22,0,1335,1379,1606,227
2020,11,22,1,1410,1450,1567,117
2020,11,22,2,1400,1450,1550,100
2020,11,22,3,1360,1424,1512,88
2020,11,22,4,1325,1387,1494,107
2020,11,22,5,1250,1353,1477,124
2020,11,22,6,1225,1285,1444,159
2020,11,22,7,1165,1250,1450,200
2020,11,22,8,1240,1222,1444,222
2020,11,22,9,1230,1209,1485,276
2020,11,22,10,1225,1216,1518,302
2020,11,22,11,1220,1213,1522,309
2020,11,22,12,1235,1221,1498,277
2020,11,22,13,1260,1239,1514,275
2020,11,22,14,1260,1276,1513,237
2020,11,22,15,1260,1322,1483,161
2020,11,22,16,1305,1358,1435,77
2020,11,22,17,1320,1363,1371,8
2020,11,22,18,1325,1356,1385,29
2020,11,22,19,1320,1356,1369,13
2020,11,22,20,1315,1337,1356,19
2020,11,22,21,1305,1318,1354,36
2020,11,22,22,1305,1296,1350,54
2020,11,22,23,1315,1302,1318,16
2020,11,23,0,1355,1370,1367,-3
2020,11,23,1,1445,1471,1416,-55
2020,11,23,2,1440,1480,1407,-73
2020,11,23,3,1405,1452,1399,-53
2020,11,23,4,1365,1410,1418,8
2020,11,23,5,1260,1358,1389,31
2020,11,23,6,1230,1296,1417,121
2020,11,23,7,1175,1231,1393,162
2020,11,23,8,1210,1206,1408,202
2020,11,23,9,1180,1186,1437,251
2020,11,23,10,1190,1198,1509,311
2020,11,23,11,1185,1200,1516,316
2020,11,23,12,1210,1231,1534,303
2020,11,23,13,1265,1282,1547,265
2020,11,23,14,1335,1392,1565,173
2020,11,23,15,1390,1475,1555,80
2020,11,23,16,1410,1489,1557,68
2020,11,23,17,1405,1491,1521,30
2020,11,23,18,1405,1488,1538,50
2020,11,23,19,1400,1477,1475,-2
2020,11,23,20,1385,1451,1423,-28
2020,11,23,21,1375,1439,1413,-26
2020,11,23,22,1365,1405,1415,10
2020,11,23,23,1365,1410,1395,-15
2020,11,24,0,1400,1460,1393,-67
2020,11,24,1,1470,1514,1415,-99
2020,11,24,2,1460,1501,1403,-98
2020,11,24,3,1425,1455,1386,-69
2020,11,24,4,1380,1403,1362,-41
2020,11,24,5,1340,1342,1343,1
2020,11,24,6,1235,1276,1371,95
2020,11,24,7,1185,1213,1353,140
2020,11,24,8,1200,1185,1420,235
2020,11,24,9,1195,1176,1512,336
2020,11,24,10,1185,1167,1519,352
2020,11,24,11,1185,1182,1537,355
2020,11,24,12,1205,1203,1561,358
2020,11,24,13,1245,1264,1606,342
2020,11,24,14,1335,1350,1618,268
2020,11,24,15,1395,1418,1602,184
2020,11,24,16,1405,1445,1609,164
2020,11,24,17,1405,1440,1636,196
2020,11,24,18,1395,1429,1680,251
2020,11,24,19,1390,1408,1684,276
2020,11,24,20,1370,1382,1648,266
2020,11,24,21,1360,1376,1639,263
2020,11,24,22,1345,1359,1632,273
2020,11,24,23,1355,1362,1622,260
2020,11,25,0,1395,1411,1650,239
2020,11,25,1,1460,1490,1659,169
2020,11,25,2,1465,1501,1671,170
2020,11,25,3,1430,1486,1763,277
2020,11,25,4,1390,1400,1676,276
2020,11,25,5,1340,1351,1680,329
2020,11,25,6,1245,1299,1721,422
2020,11,25,7,1175,1230,1728,498
2020,11,25,8,1175,1192,1738,546
2020,11,25,9,1155,1180,1780,600
2020,11,25,10,1140,1168,1785,617
2020,11,25,11,1150,1176,1751,575
2020,11,25,12,1185,1195,1734,539
2020,11,25,13,1235,1236,1779,543
2020,11,25,14,1345,1313,1722,409
2020,11,25,15,1405,1385,1731,346
2020,11,25,16,1420,1434,1928,494
2020,11,25,17,1425,1441,1968,527
2020,11,25,18,1435,1451,1997,546
2020,11,25,19,1420,1454,2127,673
2020,11,25,20,1410,1430,2095,665
2020,11,25,21,1400,1425,2031,606
2020,11,25,22,1375,1403,1970,567
2020,11,25,23,1375,1375,1970,527
2020,11,26,0,1420,1434,1924,490
2020,11,26,1,1490,1474,1863,389
2020,11,26,2,1490,1455,1829,374
2020,11,26,3,1450,1427,1790,363
2020,11,26,4,1415,1386,1777,391
2020,11,26,5,1355,1346,1781,435
2020,11,26,6,1285,1297,1837,540
2020,11,26,7,1215,1236,1813,577
2020,11,26,8,1190,1209,1960,751
2020,11,26,9,1160,1199,2044,845
2020,11,26,10,1160,1189,2040,851
2020,11,26,11,1170,1189,2051,862
2020,11,26,12,1200,1209,2122,913
2020,11,26,13,1260,1236,2166,930
2020,11,26,14,1335,1271,2194,923
2020,11,26,15,1410,1334,2179,845
2020,11,26,16,1435,1374,2189,815
2020,11,26,17,1420,1422,2206,784
2020,11,26,18,1415,1443,2240,797
2020,11,26,19,1410,1464,2252,788
2020,11,26,20,1395,1459,2213,754
2020,11,26,21,1390,1430,2228,798
2020,11,26,22,1380,1390,2206,816
2020,11,26,23,1375,1365,2154,789
2020,11,27,0,1405,1372,2219,847
2020,11,27,1,1490,1394,2221,827
2020,11,27,2,1480,1374,2191,817
2020,11,27,3,1450,1353,2166,813
2020,11,27,4,1410,1346,2136,790
2020,11,27,5,1350,1319,2212,893
2020,11,27,6,1285,1275,2191,916
2020,11,27,7,1220,1245,2216,971
2020,11,27,8,1200,1211,2198,987
2020,11,27,9,1190,1195,2191,996
2020,11,27,10,1185,1186,2151,965
2020,11,27,11,1195,1161,2147,986
2020,11,27,12,1210,1175,2188,1013
2020,11,27,13,1250,1218,2163,945
2020,11,27,14,1320,1283,2172,889
2020,11,27,15,1390,1346,2192,846
2020,11,27,16,1405,1375,2198,823
2020,11,27,17,1400,1383,2198,815
2020,11,27,18,1390,1383,2161,778
2020,11,27,19,1385,1377,2190,813
2020,11,27,20,1355,1334,1936,602
2020,11,27,21,1340,1315,2138,823
2020,11,27,22,1325,1301,2143,842
2020,11,27,23,1320,1306,2226,920
2020,11,28,0,1370,1344,2217,873
2020,11,28,1,1455,1423,2301,878
2020,11,28,2,1445,1421,2308,887
2020,11,28,3,1420,1407,2281,874
2020,11,28,4,1385,1377,2293,916
2020,11,28,5,1340,1349,2219,870
2020,11,28,6,1280,1277,2192,915
2020,11,28,7,1225,1245,2222,977
2020,11,28,8,1155,1207,2152,945
2020,11,28,9,1140,1190,2185,995
2020,11,28,10,1140,1164,2205,1041
2020,11,28,11,1150,1165,2207,1042
2020,11,28,12,1160,1185,2271,1086
2020,11,28,13,1195,1214,2270,1056
2020,11,28,14,1260,1257,2319,1062
2020,11,28,15,1340,1304,2286,982
2020,11,28,16,1370,1356,2270,914
2020,11,28,17,1380,1368,2256,888
2020,11,28,18,1395,1379,2228,849
2020,11,28,19,1385,1371,2260,889
2020,11,28,20,1360,1348,2286,938
2020,11,28,21,1360,1329,2287,958
2020,11,28,22,1330,1303,2281,978
2020,11,28,23,1335,1307,2224,917
2020,11,29,0,1380,1349,2240,891
2020,11,29,1,1450,1421,2309,888
2020,11,29,2,1445,1410,2287,877
2020,11,29,3,1415,1386,2230,844
2020,11,29,4,1370,1349,2168,819
2020,11,29,5,1340,1310,2073,763
2020,11,29,6,1265,1259,1955,696
2020,11,29,7,1220,1209,1963,754
2020,11,29,8,1185,1182,1944,762
2020,11,29,9,1170,1164,1935,771
2020,11,29,10,1175,1159,1932,773
2020,11,29,11,1175,1167,1939,772
2020,11,29,12,1185,1180,1980,800
2020,11,29,13,1210,1209,1996,787
2020,11,29,14,1265,1264,2018,754
2020,11,29,15,1320,1320,2018,698
2020,11,29,16,1355,1345,2032,687
2020,11,29,17,1360,1350,2020,670
2020,11,29,18,1355,1358,2048,690
2020,11,29,19,1350,1340,2108,768
2020,11,29,20,1330,1323,2111,788
2020,11,29,21,1320,1302,2141,839
2020,11,29,22,1295,1291,2195,904
2020,11,29,23,1305,1312,2198,886
2020,11,30,0,1365,1390,2185,795
2020,11,30,1,1450,1469,2211,742
2020,11,30,2,1455,1479,2258,779
2020,11,30,3,1425,1454,2243,789
2020,11,30,4,1380,1424,2170,746
2020,11,30,5,1320,1353,1946,593
2020,11,30,6,1260,1290,1972,682
2020,11,30,7,1210,1245,2093,848
2020,11,30,8,1210,1217,2220,1003
2020,11,30,9,1185,1205,2278,1073
2020,11,30,10,1200,1200,2214,1014
2020,11,30,11,1200,1205,2298,1093
2020,11,30,12,1230,1219,2199,980
2020,11,30,13,1275,1285,2175,890
2020,11,30,14,1340,1378,2149,771
2020,11,30,15,1385,1470,2152,682
2020,11,30,16,1400,1479,2199,720
2020,11,30,17,1400,1467,2250,783
2020,11,30,18,1400,1450,2233,783
2020,11,30,19,1390,1429,2147,718
2020,11,30,20,1365,1426,2112,686
2020,11,30,21,1355,1420,2119,699
2020,11,30,22,1325,1415,2110,695
2020,11,30,23,1335,1414,1920,506
2020,12,1,0,1375,1477,2151,674
2020,12,1,1,1430,1525,2019,494
2020,12,1,2,1420,1513,1876,363
2020,12,1,3,1375,1488,1904,416
2020,12,1,4,1325,1443,2001,558
2020,12,1,5,1270,1381,2170,789
2020,12,1,6,1200,1298,2184,886
2020,12,1,7,1140,1231,2196,965
2020,12,1,8,1170,1212,2211,999
2020,12,1,9,1165,1190,2264,1074
2020,12,1,10,1155,1161,2120,959
2020,12,1,11,1165,1162,2185,1023
2020,12,1,12,1185,1178,2217,1039
2020,12,1,13,1240,1242,2209,967
2020,12,1,14,1310,1333,2016,683
2020,12,1,15,1370,1408,1956,548
2020,12,1,16,1390,1437,1950,513
2020,12,1,17,1390,1436,1949,513
2020,12,1,18,1380,1445,2202,757
2020,12,1,19,1365,1447,2303,856
2020,12,1,20,1340,1438,2269,831
2020,12,1,21,1330,1424,2281,857
2020,12,1,22,1315,1418,2240,822
2020,12,1,23,1325,1412,2201,789
2020,12,2,0,1375,1455,2207,752
2020,12,2,1,1450,1532,2248,716
2020,12,2,2,1460,1532,2240,708
2020,12,2,3,1440,1502,2209,707
2020,12,2,4,1375,1467,2170,703
2020,12,2,5,1340,1409,2207,798
2020,12,2,6,1260,1333,2228,895
2020,12,2,7,1195,1269,2190,921
2020,12,2,8,1215,1247,2188,941
2020,12,2,9,1200,1233,2128,895
2020,12,2,10,1180,1230,2099,869
2020,12,2,11,1195,1239,2115,876
2020,12,2,12,1225,1266,2141,875
2020,12,2,13,1270,1324,2165,841
2020,12,2,14,1330,1421,2204,783
2020,12,2,15,1345,1518,2304,786
2020,12,2,16,1360,1516,2269,753
2020,12,2,17,1365,1494,2269,775
2020,12,2,18,1380,1467,2263,796
2020,12,2,19,1365,1442,2263,821
2020,12,2,20,1360,1403,2233,830
2020,12,2,21,1340,1389,2220,831
2020,12,2,22,1325,1372,2202,830
2020,12,2,23,1325,1384,2208,824
2020,12,3,0,1370,1438,2223,785
2020,12,3,1,1445,1534,2235,701
2020,12,3,2,1450,1549,2261,712
2020,12,3,3,1420,1513,2265,752
2020,12,3,4,1390,1475,2227,752
2020,12,3,5,1345,1422,2236,814
2020,12,3,6,1260,1351,2236,885
2020,12,3,7,1200,1273,2173,900
2020,12,3,8,1205,1251,2190,939
2020,12,3,9,1185,1240,2225,985
2020,12,3,10,1175,1239,2259,1020
2020,12,3,11,1175,1249,2273,1024
2020,12,3,12,1195,1271,2275,1004
2020,12,3,13,1235,1319,2301,982
2020,12,3,14,1300,1427,2327,900
2020,12,3,15,1385,1510,2351,841
2020,12,3,16,1420,1519,2359,840
2020,12,3,17,1450,1486,2332,846
2020,12,3,18,1465,1470,2334,864
2020,12,3,19,1480,1440,2324,884
2020,12,3,20,1470,1407,2317,910
2020,12,3,21,1450,1394,2360,966
2020,12,3,22,1420,1378,2376,998
2020,12,3,23,1400,1376,2359,983
2020,12,4,0,1420,1462,2384,922
2020,12,4,1,1460,1538,2358,820
2020,12,4,2,1445,1556,2381,825
2020,12,4,3,1420,1529,2369,840
2020,12,4,4,1405,1487,2380,893
2020,12,4,5,1385,1439,2409,970
2020,12,4,6,1310,1359,2434,1075
2020,12,4,7,1265,1294,2419,1125
2020,12,4,8,1190,1270,2420,1150
2020,12,4,9,1175,1249,2380,1131
2020,12,4,10,1170,1256,2346,1090
2020,12,4,11,1155,1251,2361,1110
2020,12,4,12,1175,1279,2390,1111
2020,12,4,13,1220,1319,2408,1089
2020,12,4,14,1315,1424,2423,999
2020,12,4,15,1410,1508,2463,955
2020,12,4,16,1430,1497,2430,933
2020,12,4,17,1435,1476,2356,880
2020,12,4,18,1425,1453,2371,918
2020,12,4,19,1415,1417,2330,913
2020,12,4,20,1375,1373,2292,919
2020,12,4,21,1355,1363,2305,942
2020,12,4,22,1340,1341,2328,987
2020,12,4,23,1340,1333,2317,984
2020,12,5,0,1385,1396,2318,922
2020,12,5,1,1475,1474,2349,875
2020,12,5,2,1475,1473,2353,880
2020,12,5,3,1450,1452,2306,854
2020,12,5,4,1420,1432,2302,870
2020,12,5,5,1410,1385,2318,933
2020,12,5,6,1315,1321,2248,927
2020,12,5,7,1265,1279,2160,881
2020,12,5,8,1215,1235,2152,917
2020,12,5,9,1200,1229,2109,880
2020,12,5,10,1180,1226,2124,898
2020,12,5,11,1185,1228,2093,865
2020,12,5,12,1205,1224,2095,871
2020,12,5,13,1235,1248,2108,860
2020,12,5,14,1295,1299,2180,881
2020,12,5,15,1360,1372,2179,807
2020,12,5,16,1400,1400,2167,767
2020,12,5,17,1405,1414,2185,771
2020,12,5,18,1410,1399,2173,774
2020,12,5,19,1395,1368,2158,790
2020,12,5,20,1370,1334,2167,833
2020,12,5,21,1355,1300,2122,822
2020,12,5,22,1330,1280,2113,833
2020,12,5,23,1335,1291,2131,840
2020,12,6,0,1385,1354,2147,793
2020,12,6,1,1460,1461,2181,720
2020,12,6,2,1460,1462,2183,721
2020,12,6,3,1430,1440,2184,744
2020,12,6,4,1390,1421,2189,768
2020,12,6,5,1360,1377,2167,790
2020,12,6,6,1290,1314,2219,905
2020,12,6,7,1240,1276,2140,864
2020,12,6,8,1185,1238,2144,906
2020,12,6,9,1175,1210,2122,912
2020,12,6,10,1170,1214,2151,937
2020,12,6,11,1180,1233,2222,989
2020,12,6,12,1190,1251,2243,992
2020,12,6,13,1220,1266,2319,1053
2020,12,6,14,1265,1315,2337,1022
2020,12,6,15,1305,1363,2322,959
2020,12,6,16,1330,1407,2298,891
2020,12,6,17,1330,1416,2294,878
2020,12,6,18,1325,1420,2291,871
2020,12,6,19,1310,1397,2306,909
2020,12,6,20,1290,1382,2311,929
2020,12,6,21,1275,1339,2328,989
2020,12,6,22,1260,1335,2328,993
2020,12,6,23,1270,1350,2319,969
2020,12,7,0,1350,1398,2307,909
2020,12,7,1,1430,1509,2393,884
2020,12,7,2,1440,1512,2341,829
2020,12,7,3,1415,1496,2280,784
2020,12,7,4,1385,1466,2332,866
2020,12,7,5,1305,1409,2318,909
2020,12,7,6,1260,1332,2279,947
2020,12,7,7,1215,1278,2328,1050
2020,12,7,8,1195,1242,2305,1063
2020,12,7,9,1175,1240,2366,1126
2020,12,7,10,1185,1239,2337,1098
2020,12,7,11,1190,1244,2330,1086
2020,12,7,12,1220,1258,2334,1076
2020,12,7,13,1265,1318,2356,1038
2020,12,7,14,1370,1426,2351,925
2020,12,7,15,1455,1518,2353,835
2020,12,7,16,1465,1515,2331,816
2020,12,7,17,1460,1495,2318,823
2020,12,7,18,1455,1478,2335,857
2020,12,7,19,1440,1466,2347,881
2020,12,7,20,1415,1433,2372,939
2020,12,7,21,1400,1417,2381,964
2020,12,7,22,1370,1404,2388,984
2020,12,7,23,1375,1419,2393,974
2020,12,8,0,1430,1485,2399,914
2020,12,8,1,1490,1548,2404,856
2020,12,8,2,1480,1534,2393,859
2020,12,8,3,1440,1518,2383,865
2020,12,8,4,1390,1491,2379,888
2020,12,8,5,1355,1409,2347,938
2020,12,8,6,1265,1333,2345,1012
2020,12,8,7,1200,1261,2348,1087
2020,12,8,8,1175,1223,2345,1122
2020,12,8,9,1155,1203,2292,1089
2020,12,8,10,1140,1189,2301,1112
2020,12,8,11,1145,1194,2293,1099
2020,12,8,12,1160,1225,2304,1079
2020,12,8,13,1210,1266,2286,1020
2020,12,8,14,1280,1367,2331,964
2020,12,8,15,1335,1474,2355,881
2020,12,8,16,1365,1471,2321,850
2020,12,8,17,1365,1467,2331,864
2020,12,8,18,1365,1435,2268,833
2020,12,8,19,1360,1407,2274,867
2020,12,8,20,1345,1380,2280,900
2020,12,8,21,1335,1353,2321,968
2020,12,8,22,1325,1325,2292,967
2020,12,8,23,1325,1334,2270,936
2020,12,9,0,1370,1141,2147,1006
2020,12,9,1,1445,1475,2351,876
2020,12,9,2,1450,1469,2366,897
2020,12,9,3,1425,1448,2346,898
2020,12,9,4,1385,1406,2344,938
2020,12,9,5,1335,1328,2300,972
2020,12,9,6,1265,1248,2256,1008
2020,12,9,7,1200,1197,2167,970
2020,12,9,8,1160,1135,2108,973
2020,12,9,9,1145,1132,2120,988
2020,12,9,10,1145,1114,1990,876
2020,12,9,11,1150,1129,2036,907
2020,12,9,12,1175,1152,2100,948
2020,12,9,13,1230,1203,2049,846
2020,12,9,14,1320,1327,2119,792
2020,12,9,15,1400,1417,2181,764
2020,12,9,16,1400,1421,2124,703
2020,12,9,17,1375,1405,2200,795
2020,12,9,18,1355,1404,2219,815
2020,12,9,19,1335,1380,2174,794
2020,12,9,20,1300,1380,2246,866
2020,12,9,21,1285,1373,2246,873
2020,12,9,22,1270,1355,2246,891
2020,12,9,23,1505,1360,2216,856
2020,12,10,0,1335,1419,2275,856
2020,12,10,1,1420,1479,2261,782
2020,12,10,2,1425,1468,2238,770
2020,12,10,3,1395,1443,2189,746
2020,12,10,4,1365,1412,2184,772
2020,12,10,5,1300,1350,2144,794
2020,12,10,6,1240,1269,2079,810
2020,12,10,7,1170,1203,2062,859
2020,12,10,8,1220,1179,2027,848
2020,12,10,9,1210,1159,1985,826
2020,12,10,10,1200,1147,1961,814
2020,12,10,11,1210,1155,1958,803
2020,12,10,12,1235,1185,1966,781
2020,12,10,13,1280,1228,1993,765
2020,12,10,14,1395,1344,1987,643
2020,12,10,15,1505,1451,1983,532
2020,12,10,16,1515,1464,2004,540
2020,12,10,17,1500,1451,1991,540
2020,12,10,18,1480,1426,2005,579
2020,12,10,19,1460,1407,1988,581
2020,12,10,20,1430,1386,1996,610
2020,12,10,21,1415,1374,2011,637
2020,12,10,22,1390,1351,1999,648
2020,12,10,23,1385,1353,2006,653
2020,12,11,0,1405,1429,2070,641
2020,12,11,1,1530,1536,2090,554
2020,12,11,2,1535,1539,2083,544
2020,12,11,3,1510,1526,2094,568
2020,12,11,4,1470,1494,2052,558
2020,12,11,5,1430,1449,2054,605
2020,12,11,6,1340,1375,2026,651
2020,12,11,7,1285,1310,1976,666
2020,12,11,8,1220,1278,1974,696
2020,12,11,9,1200,1270,1969,699
2020,12,11,10,1195,1273,1978,705
2020,12,11,11,1195,1280,1974,694
2020,12,11,12,1220,1289,1954,665
2020,12,11,13,1265,1339,2019,680
2020,12,11,14,1405,1441,2054,613
2020,12,11,15,1520,1546,2091,545
2020,12,11,16,1520,1575,2088,513
2020,12,11,17,1505,1587,2084,497
2020,12,11,18,1485,1587,2089,502
2020,12,11,19,1455,1584,2086,502
2020,12,11,20,1415,1569,2075,506
2020,12,11,21,1405,1549,2072,523
2020,12,11,22,1385,1513,2066,553
2020,12,11,23,1380,1517,2078,561
2020,12,12,0,1445,1564,2098,534
2020,12,12,1,1525,1610,2131,521
2020,12,12,2,1515,1600,2110,510
2020,12,12,3,1500,1587,2119,532
2020,12,12,4,1475,1540,2079,539
2020,12,12,5,1420,1504,2040,536
2020,12,12,6,1350,1430,2039,609
2020,12,12,7,1305,1367,2048,681
2020,12,12,8,1230,1330,2028,698
2020,12,12,9,1225,1302,2033,731
2020,12,12,10,1210,1288,2018,730
2020,12,12,11,1215,1282,2057,775
2020,12,12,12,1220,1289,2077,788
2020,12,12,13,1255,1322,2085,763
2020,12,12,14,1335,1356,2078,722
2020,12,12,15,1430,1416,2077,661
2020,12,12,16,1460,1468,2090,622
2020,12,12,17,1470,1499,2093,594
2020,12,12,18,1455,1499,2140,641
2020,12,12,19,1425,1474,2124,650
2020,12,12,20,1395,1461,2148,687
2020,12,12,21,1365,1441,2147,706
2020,12,12,22,1345,1440,2182,742
2020,12,12,23,1355,1451,2193,742
2020,12,13,0,1420,1501,2218,717
2020,12,13,1,1530,1584,2209,625
2020,12,13,2,1530,1565,2245,680
2020,12,13,3,1505,1543,2247,704
2020,12,13,4,1480,1505,2238,733
2020,12,13,5,1430,1456,2251,795
2020,12,13,6,1365,1390,2197,807
2020,12,13,7,1320,1334,2146,812
2020,12,13,8,1265,1286,2139,853
2020,12,13,9,1240,1266,2146,880
2020,12,13,10,1240,1248,2155,907
2020,12,13,11,1255,1257,2112,855
2020,12,13,12,1275,1268,2107,839
2020,12,13,13,1300,1290,2095,805
2020,12,13,14,1345,1343,2101,758
2020,12,13,15,1395,1408,2127,719
2020,12,13,16,1435,1456,2095,639
2020,12,13,17,1435,1482,2090,608
2020,12,13,18,1435,1500,2105,605
2020,12,13,19,1415,1505,2107,602
2020,12,13,20,1395,1490,2099,609
2020,12,13,21,1360,1481,2107,626
2020,12,13,22,1350,1473,2103,630
2020,12,13,23,1365,1481,2110,629
2020,12,14,0,1425,1545,2114,569
2020,12,14,1,1535,1621,2121,500
2020,12,14,2,1540,1616,2146,530
2020,12,14,3,1520,1588,2110,522
2020,12,14,4,1495,1551,2102,551
2020,12,14,5,1395,1487,2106,619
2020,12,14,6,1355,1400,2115,715
2020,12,14,7,1300,1335,2106,771
2020,12,14,8,1240,1293,2121,828
2020,12,14,9,1235,1277,2185,908
2020,12,14,10,1230,1245,2186,941
2020,12,14,11,1235,1271,2190,919
2020,12,14,12,1255,1272,2199,927
2020,12,14,13,1310,1323,2235,912
2020,12,14,14,1400,1428,2303,875
2020,12,14,15,1475,1523,2331,808
2020,12,14,16,1480,1538,2313,775
2020,12,14,17,1460,1560,2292,732
2020,12,14,18,1445,1539,2275,736
2020,12,14,19,1425,1517,2344,827
2020,12,14,20,1400,1514,2356,842
2020,12,14,21,1385,1506,2312,806
2020,12,14,22,1370,1493,2282,789
2020,12,14,23,1385,1483,2284,801
2020,12,15,0,1450,1554,2262,708
2020,12,15,1,1525,1617,2245,628
2020,12,15,2,1515,1614,2211,597
2020,12,15,3,1500,1586,2155,569
2020,12,15,4,1465,1538,2122,584
2020,12,15,5,1400,1473,2118,645
2020,12,15,6,1320,1385,2147,762
2020,12,15,7,1250,1309,2146,837
2020,12,15,8,1265,1288,2271,983
2020,12,15,9,1245,1271,2306,1035
2020,12,15,10,1225,1269,2347,1078
2020,12,15,11,1230,1270,2366,1096
2020,12,15,12,1260,1300,2355,1055
2020,12,15,13,1300,1358,2360,1002
2020,12,15,14,1385,1470,2367,897
2020,12,15,15,1475,1551,2374,823
2020,12,15,16,1485,1548,2379,831
2020,12,15,17,1485,1538,2346,808
2020,12,15,18,1470,1526,2342,816
2020,12,15,19,1450,1520,2365,845
2020,12,15,20,1425,1502,2363,861
2020,12,15,21,1405,1510,2374,864
2020,12,15,22,1385,1505,2386,881
2020,12,15,23,1390,1510,2357,847
2020,12,16,0,1275,1556,2364,808
2020,12,16,1,1535,1625,2419,794
2020,12,16,2,1535,1618,2395,777
2020,12,16,3,1510,1587,2374,787
2020,12,16,4,1465,1540,2312,772
2020,12,16,5,1400,1485,2334,849
2020,12,16,6,1310,1395,2357,962
2020,12,16,7,1250,1327,2317,990
2020,12,16,8,1240,1290,2405,1115
2020,12,16,9,1230,1272,2407,1135
2020,12,16,10,1215,1258,2412,1154
2020,12,16,11,1235,1244,2383,1139
2020,12,16,12,1250,1261,2391,1130
2020,12,16,13,1305,1328,2394,1066
2020,12,16,14,1400,1429,2408,979
2020,12,16,15,1465,1506,2404,898
2020,12,16,16,1475,1514,2381,867
2020,12,16,17,1460,1515,2403,888
2020,12,16,18,1455,1501,2411,910
2020,12,16,19,1430,1493,2423,930
2020,12,16,20,1420,1465,2418,953
2020,12,16,21,1415,1450,2428,978
2020,12,16,22,1395,1428,2430,1002
2020,12,16,23,1405,1431,2410,979
2020,12,17,0,1465,1478,2368,890
2020,12,17,1,1535,1581,2386,805
2020,12,17,2,1530,1572,2356,784
2020,12,17,3,1500,1553,2329,776
2020,12,17,4,1460,1511,2281,770
2020,12,17,5,1400,1449,2227,778
2020,12,17,6,1315,1361,2018,657
2020,12,17,7,1245,1285,1760,475
2020,12,17,8,1230,1268,1489,221
2020,12,17,9,1215,1248,1412,164
2020,12,17,10,1205,1238,1430,192
2020,12,17,11,1210,1252,1460,208
2020,12,17,12,1240,1271,1469,198
2020,12,17,13,1290,1321,1527,206
2020,12,17,14,1390,1423,1587,164
2020,12,17,15,1480,1519,1639,120
2020,12,17,16,1490,1519,1634,115
2020,12,17,17,1475,1524,1634,110
2020,12,17,18,1455,1500,1612,112
2020,12,17,19,1435,1477,1598,121
2020,12,17,20,1410,1449,1623,174
2020,12,17,21,1400,1432,1627,195
2020,12,17,22,1385,1437,1621,184
2020,12,17,23,1385,1432,1597,165
2020,12,18,0,1460,1498,1562,64
2020,12,18,1,1560,1557,1603,46
2020,12,18,2,1560,1542,1587,45
2020,12,18,3,1540,1507,1585,78
2020,12,18,4,1505,1474,1485,11
2020,12,18,5,1480,1407,1584,177
2020,12,18,6,1375,1313,1581,268
2020,12,18,7,1270,1239,1596,357
2020,12,18,8,1230,1200,1596,396
2020,12,18,9,1215,1173,1539,366
2020,12,18,10,1210,1164,1451,287
2020,12,18,11,1210,1151,1391,240
2020,12,18,12,1230,1172,1386,214
2020,12,18,13,1275,1223,1373,150
2020,12,18,14,1390,1320,1403,83
2020,12,18,15,1490,1433,1502,69
2020,12,18,16,1510,1469,1481,12
2020,12,18,17,1510,1463,1500,37
2020,12,18,18,1500,1455,1565,110
2020,12,18,19,1490,1447,1575,128
2020,12,18,20,1465,1429,1671,242
2020,12,18,21,1450,1419,1702,283
2020,12,18,22,1430,1415,1698,283
2020,12,18,23,1430,1414,1693,279
2020,12,19,0,1480,1478,1698,220
2020,12,19,1,1540,1526,1687,161
2020,12,19,2,1525,1519,1689,170
2020,12,19,3,1505,1478,1674,196
2020,12,19,4,1460,1452,1666,214
2020,12,19,5,1420,1395,1666,271
2020,12,19,6,1350,1337,1677,340
2020,12,19,7,1285,1267,1661,394
2020,12,19,8,1255,1234,1660,426
2020,12,19,9,1235,1219,1677,458
2020,12,19,10,1230,1183,1591,408
2020,12,19,11,1225,1192,1578,386
2020,12,19,12,1235,1205,1610,405
2020,12,19,13,1265,1238,1659,421
2020,12,19,14,1320,1277,1642,365
2020,12,19,15,1390,1351,1623,272
2020,12,19,16,1430,1396,1571,175
2020,12,19,17,1460,1428,1596,168
2020,12,19,18,1455,1425,1561,136
2020,12,19,19,1430,1435,1613,178
2020,12,19,20,1415,1416,1585,169
2020,12,19,21,1390,1406,1601,195
2020,12,19,22,1390,1405,1609,204
2020,12,19,23,1395,1415,1662,247
2020,12,20,0,1450,1479,1657,178
2020,12,20,1,1535,1548,1711,163
2020,12,20,2,1520,1473,1780,307
2020,12,20,3,1495,1436,1750,314
2020,12,20,4,1460,1404,1859,455
2020,12,20,5,1390,1377,1716,339
2020,12,20,6,1335,1315,1671,356
2020,12,20,7,1280,1254,1661,407
2020,12,20,8,1225,1227,1666,439
2020,12,20,9,1205,1193,1618,425
2020,12,20,10,1190,1175,1600,425
2020,12,20,11,1205,1186,1609,423
2020,12,20,12,1215,1181,1560,379
2020,12,20,13,1240,1210,1573,363
2020,12,20,14,1280,1242,1550,308
2020,12,20,15,1335,1305,1553,248
2020,12,20,16,1370,1347,1506,159
2020,12,20,17,1390,1392,1511,119
2020,12,20,18,1395,1408,1517,109
2020,12,20,19,1390,1402,1488,86
2020,12,20,20,1375,1396,1406,10
2020,12,20,21,1355,1382,1386,4
2020,12,20,22,1350,1374,1407,33
2020,12,20,23,1360,1391,1489,98
2020,12,21,0,1415,1464,1553,89
2020,12,21,1,1490,1529,1613,84
2020,12,21,2,1490,1507,1622,115
2020,12,21,3,1460,1066,1470,404
2020,12,21,4,1425,1019,1490,471
2020,12,21,5,1335,1339,1691,352
2020,12,21,6,1280,1259,1771,512
2020,12,21,7,1215,1182,1864,682
2020,12,21,8,1210,1154,1935,781
2020,12,21,9,1195,1142,2096,954
2020,12,21,10,1175,1130,2124,994
2020,12,21,11,1195,1131,2130,999
2020,12,21,12,1200,1161,2115,954
2020,12,21,13,1250,1200,2051,851
2020,12,21,14,1330,1294,2054,760
2020,12,21,15,1410,1405,1999,594
2020,12,21,16,1420,1443,1962,519
2020,12,21,17,1435,1449,1933,484
2020,12,21,18,1415,1442,1918,476
2020,12,21,19,1395,1437,1916,479
2020,12,21,20,1385,1416,1913,497
2020,12,21,21,1375,1405,1914,509
2020,12,21,22,1360,1380,1907,527
2020,12,21,23,1360,1384,1900,516
2020,12,22,0,1425,1408,1899,491
2020,12,22,1,1485,1495,1941,446
2020,12,22,2,1480,1482,1933,451
2020,12,22,3,1455,1463,1949,486
2020,12,22,4,1410,1432,2013,581
2020,12,22,5,1350,1374,2091,717
2020,12,22,6,1265,1296,2087,791
2020,12,22,7,1195,1228,2172,944
2020,12,22,8,1235,1184,2193,1009
2020,12,22,9,1215,1160,2232,1072
2020,12,22,10,1205,1148,2186,1038
2020,12,22,11,1210,1144,2126,982
2020,12,22,12,1235,1163,2178,1015
2020,12,22,13,1280,1210,2222,1012
2020,12,22,14,1360,1305,2248,943
2020,12,22,15,1435,1396,2281,885
2020,12,22,16,1440,1447,2361,914
2020,12,22,17,1440,1443,2329,886
2020,12,22,18,1435,1483,2365,882
2020,12,22,19,1420,1434,2348,914
2020,12,22,20,1405,1501,2352,851
2020,12,22,21,1405,1508,2379,871
2020,12,22,22,1395,1517,2386,869
2020,12,22,23,1400,1526,2377,851
2020,12,23,0,1415,1581,2389,808
2020,12,23,1,1525,1641,2432,791
2020,12,23,2,1515,1636,2435,799
2020,12,23,3,1405,1584,2425,841
2020,12,23,4,1365,1544,2381,837
2020,12,23,5,1330,1500,2384,884
2020,12,23,6,1290,1418,2378,960
2020,12,23,7,1220,1339,2337,998
2020,12,23,8,1295,1301,2318,1017
2020,12,23,9,1275,1274,2327,1053
2020,12,23,10,1260,1276,2253,977
2020,12,23,11,1255,1273,2236,963
2020,12,23,12,1270,1290,2195,905
2020,12,23,13,1340,1339,2175,836
2020,12,23,14,1450,1425,2166,741
2020,12,23,15,1525,1517,2220,703
2020,12,23,16,1535,1560,2328,768
2020,12,23,17,1535,1562,2285,723
2020,12,23,18,1520,1557,2362,805
2020,12,23,19,1510,1539,2368,829
2020,12,23,20,1485,1505,2367,862
2020,12,23,21,1470,1487,2338,851
2020,12,23,22,1450,1474,2358,884
2020,12,23,23,1455,1487,2353,866
2020,12,24,0,1505,1528,2359,831
2020,12,24,1,1605,1609,2374,765
2020,12,24,2,1595,1609,2393,784
2020,12,24,3,1575,1578,2364,786
2020,12,24,4,1530,1546,2324,778
2020,12,24,5,1470,1521,2308,787
2020,12,24,6,1380,1447,2331,884
2020,12,24,7,1310,1378,2337,959
2020,12,24,8,1155,1334,2332,998
2020,12,24,9,1135,1314,2346,1032
2020,12,24,10,1125,1311,2333,1022
2020,12,24,11,1135,1298,2313,1015
2020,12,24,12,1150,1313,2315,1002
2020,12,24,13,1200,1345,2350,1005
2020,12,24,14,1340,1420,2357,937
2020,12,24,15,1470,1481,2323,842
2020,12,24,16,1485,1525,2303,778
2020,12,24,17,1485,1550,2345,795
2020,12,24,18,1475,1529,2350,821
2020,12,24,19,1445,1505,2349,844
2020,12,24,20,1440,1467,2337,870
2020,12,24,21,1425,1435,2369,934
2020,12,24,22,1430,1414,2374,960
2020,12,24,23,1425,1413,2367,954
2020,12,25,0,1485,1457,2372,915
2020,12,25,1,1555,1532,2401,869
2020,12,25,2,1545,1515,2408,893
2020,12,25,3,1515,1482,2340,858
2020,12,25,4,1480,1448,2330,882
2020,12,25,5,1470,1430,2383,953
2020,12,25,6,1340,1377,2426,1049
2020,12,25,7,1265,1317,2443,1126
2020,12,25,8,1245,1282,2432,1150
2020,12,25,9,1215,1258,2399,1141
2020,12,25,10,1210,1247,2392,1145
2020,12,25,11,1205,1243,2366,1123
2020,12,25,12,1220,1247,2337,1090
2020,12,25,13,1275,1281,2349,1068
2020,12,25,14,1345,1318,2323,1005
2020,12,25,15,1435,1379,2272,893
2020,12,25,16,1465,1417,2196,779
2020,12,25,17,1455,1433,2191,758
2020,12,25,18,1465,1432,2203,771
2020,12,25,19,1445,1407,2220,813
2020,12,25,20,1440,1390,2276,886
2020,12,25,21,1435,1364,2288,924
2020,12,25,22,1430,1350,2282,932
2020,12,25,23,1435,1346,2281,935
2020,12,26,0,1485,1398,2307,909
2020,12,26,1,1535,1453,2324,871
2020,12,26,2,1525,1436,2291,855
2020,12,26,3,1495,1415,2272,857
2020,12,26,4,1460,1388,2312,924
2020,12,26,5,1435,1354,2291,937
2020,12,26,6,1345,1328,2363,1035
2020,12,26,7,1275,1254,2318,1064
2020,12,26,8,1180,1221,2328,1107
2020,12,26,9,1160,1185,2191,1006
2020,12,26,10,1145,1183,2281,1098
2020,12,26,11,1140,1193,2325,1132
2020,12,26,12,1150,1196,2296,1100
2020,12,26,13,1180,1216,2251,1035
2020,12,26,14,1255,1247,2235,988
2020,12,26,15,1350,1314,2254,940
2020,12,26,16,1395,1356,2238,882
2020,12,26,17,1425,1405,2308,903
2020,12,26,18,1435,1423,2308,885
2020,12,26,19,1420,1414,2304,890
2020,12,26,20,1415,1407,2238,831
2020,12,26,21,1400,1371,2172,801
2020,12,26,22,1400,1366,2197,831
2020,12,26,23,1410,1360,2001,641
2020,12,27,0,1460,1409,1950,541
2020,12,27,1,1535,1483,2205,722
2020,12,27,2,1510,1467,2238,771
2020,12,27,3,1480,1444,2200,756
2020,12,27,4,1445,1422,2183,761
2020,12,27,5,1350,1375,2171,796
2020,12,27,6,1335,1300,1957,657
2020,12,27,7,1280,1241,1866,625
2020,12,27,8,1220,1209,1987,778
2020,12,27,9,1195,1192,2106,914
2020,12,27,10,1180,1181,2174,993
2020,12,27,11,1190,1192,2181,989
2020,12,27,12,1195,1190,2206,1016
2020,12,27,13,1220,1223,2282,1059
2020,12,27,14,1255,1257,2341,1084
2020,12,27,15,1305,1319,2294,975
2020,12,27,16,1350,1369,2304,935
2020,12,27,17,1375,1411,2319,908
2020,12,27,18,1395,1419,2320,901
2020,12,27,19,1390,1426,2350,924
2020,12,27,20,1390,1408,1881,473
2020,12,27,21,1380,1397,1619,222
2020,12,27,22,1375,1369,1522,153
2020,12,27,23,1385,1394,1436,42
2020,12,28,0,1440,1443,1443,0
2020,12,28,1,1510,1534,1483,-51
2020,12,28,2,1505,1540,1451,-89
2020,12,28,3,1390,1532,1440,-92
2020,12,28,4,1360,1498,1389,-109
2020,12,28,5,1305,1445,1387,-58
2020,12,28,6,1290,1376,1367,-9
2020,12,28,7,1225,1325,1335,10
2020,12,28,8,1250,1296,1324,28
2020,12,28,9,1230,1277,1352,75
2020,12,28,10,1225,1280,1356,76
2020,12,28,11,1220,1279,1363,84
2020,12,28,12,1245,1318,1376,58
2020,12,28,13,1285,1350,1389,39
2020,12,28,14,1375,1442,1398,-44
2020,12,28,15,1475,1541,1422,-119
2020,12,28,16,1505,1598,1413,-185
2020,12,28,17,1515,1594,1402,-192
2020,12,28,18,1515,1592,1407,-185
2020,12,28,19,1500,1550,1398,-152
2020,12,28,20,1495,1525,1416,-109
2020,12,28,21,1485,1492,1415,-77
2020,12,28,22,1465,1458,1396,-62
2020,12,28,23,1470,1461,1362,-99
2020,12,29,0,1515,1518,1377,-141
2020,12,29,1,1595,1597,1429,-168
2020,12,29,2,1585,1625,1426,-199
2020,12,29,3,1565,1591,1411,-180
2020,12,29,4,1525,1560,1429,-131
2020,12,29,5,1475,1496,1444,-52
2020,12,29,6,1380,1440,1469,29
2020,12,29,7,1300,1369,1513,144
2020,12,29,8,1230,1351,1578,227
2020,12,29,9,1205,1316,1478,162
2020,12,29,10,1195,1289,1457,168
2020,12,29,11,1195,1288,1531,243
2020,12,29,12,1210,1318,1540,222
2020,12,29,13,1260,1354,1559,205
2020,12,29,14,1315,1423,1586,163
2020,12,29,15,1375,1517,1549,32
2020,12,29,16,1415,1548,1526,-22
2020,12,29,17,1420,1546,1508,-38
2020,12,29,18,1450,1544,1494,-50
2020,12,29,19,1415,1521,1528,7
2020,12,29,20,1455,1481,1491,10
2020,12,29,21,1460,1454,1484,30
2020,12,29,22,1460,1435,1498,63
2020,12,29,23,1470,1446,1497,51
2020,12,30,0,1520,1494,1543,49
2020,12,30,1,1585,1597,1550,-47
2020,12,30,2,1580,1587,1586,-1
2020,12,30,3,1545,1561,1602,41
2020,12,30,4,1505,1528,1601,73
2020,12,30,5,1450,1484,1553,69
2020,12,30,6,1375,1421,1602,181
2020,12,30,7,1300,1344,1556,212
2020,12,30,8,1250,1308,1625,317
2020,12,30,9,1230,1297,1648,351
2020,12,30,10,1225,1317,1693,376
2020,12,30,11,1225,1323,1703,380
2020,12,30,12,1245,1337,1709,372
2020,12,30,13,1295,1381,1731,350
2020,12,30,14,1400,1455,1758,303
2020,12,30,15,1505,1529,1766,237
2020,12,30,16,1540,1548,1747,199
2020,12,30,17,1545,1560,1750,190
2020,12,30,18,1535,1557,1768,211
2020,12,30,19,1520,1550,1777,227
2020,12,30,20,1485,1522,1769,247
2020,12,30,21,1465,1518,1780,262
2020,12,30,22,1450,1509,1738,229
2020,12,30,23,1460,1511,1705,194
2020,12,31,0,1505,1569,1716,147
2020,12,31,1,1590,1627,1731,104
2020,12,31,2,1590,1626,1737,111
2020,12,31,3,1565,1590,1733,143
2020,12,31,4,1530,1561,1732,171
2020,12,31,5,1505,1509,1733,224
2020,12,31,6,1365,1413,1723,310
2020,12,31,7,1345,1347,1728,381
2020,12,31,8,1220,1308,1683,375
2020,12,31,9,1195,1289,1666,377
2020,12,31,10,1185,1278,1651,373
2020,12,31,11,1180,1285,1656,371
2020,12,31,12,1200,1281,1660,379
2020,12,31,13,1230,1346,1679,333
2020,12,31,14,1330,1403,1664,261
2020,12,31,15,1420,1483,1675,192
2020,12,31,16,1450,1517,1650,133
2020,12,31,17,1465,1532,1727,195
2020,12,31,18,1445,1502,1833,331
2020,12,31,19,1425,1491,1808,317
2020,12,31,20,1390,1456,1767,311
2020,12,31,21,1365,1446,1779,333
2020,12,31,22,1350,1426,1771,345
2020,12,31,23,1345,1431,1858,427
2021,1,1,0,1395,1469,1940,471
2021,1,1,1,1470,1531,2067,536
2021,1,1,2,1450,1513,2163,650
2021,1,1,3,1425,1479,2252,773
2021,1,1,4,1390,1439,2262,823
2021,1,1,5,1350,1395,2281,886
2021,1,1,6,1305,1345,2268,923
2021,1,1,7,1240,1321,2277,956
2021,1,1,8,1270,1282,2289,1007
2021,1,1,9,1250,1255,2281,1026
2021,1,1,10,1240,1249,2291,1042
2021,1,1,11,1240,1242,2299,1057
2021,1,1,12,1245,1255,2301,1046
2021,1,1,13,1285,1265,2259,994
2021,1,1,14,1350,1305,2237,932
2021,1,1,15,1435,1341,2202,861
2021,1,1,16,1470,1371,2173,802
2021,1,1,17,1480,1394,2173,779
2021,1,1,18,1475,1406,2195,789
2021,1,1,19,1460,1395,2212,817
2021,1,1,20,1440,1394,2206,812
2021,1,1,21,1420,1371,2222,851
2021,1,1,22,1410,1371,2218,847
2021,1,1,23,1405,1374,2230,856
2021,1,2,0,1460,1423,2228,805
2021,1,2,1,1520,1502,2203,701
2021,1,2,2,1505,1494,2227,733
2021,1,2,3,1475,1464,2291,827
2021,1,2,4,1450,1431,2267,836
2021,1,2,5,1435,1385,2223,838
2021,1,2,6,1365,1333,2228,895
2021,1,2,7,1290,1260,2058,798
2021,1,2,8,1240,1208,1968,760
2021,1,2,9,1215,1200,1996,796
2021,1,2,10,1210,1187,1765,578
2021,1,2,11,1215,1190,1713,523
2021,1,2,12,1225,1206,1835,629
2021,1,2,13,1250,1217,1890,673
2021,1,2,14,1280,1266,1898,632
2021,1,2,15,1345,1304,1849,545
2021,1,2,16,1380,1361,1848,487
2021,1,2,17,1420,1398,1922,524
2021,1,2,18,1430,1419,2041,622
2021,1,2,19,1425,1413,2043,630
2021,1,2,20,1415,1394,1907,513
2021,1,2,21,1390,1368,1886,518
2021,1,2,22,1385,1362,1968,606
2021,1,2,23,1385,1366,1967,601
2021,1,3,0,1440,1406,2067,661
2021,1,3,1,1505,1510,2322,812
2021,1,3,2,1480,1495,2362,867
2021,1,3,3,1455,1463,2287,824
2021,1,3,4,1425,1429,2246,817
2021,1,3,5,1345,1375,2119,744
2021,1,3,6,1310,1309,1790,481
2021,1,3,7,1250,1242,1552,310
2021,1,3,8,1200,1209,1476,267
2021,1,3,9,1180,1173,1535,362
2021,1,3,10,1175,1170,1546,376
2021,1,3,11,1180,1179,1553,374
2021,1,3,12,1185,1190,1580,390
2021,1,3,13,1215,1210,1633,423
2021,1,3,14,1245,1242,1587,345
2021,1,3,15,1290,1281,1598,317
2021,1,3,16,1330,1333,1795,462
2021,1,3,17,1365,1393,2180,787
2021,1,3,18,1370,1405,2232,827
2021,1,3,19,1370,1415,2231,816
2021,1,3,20,1365,1414,2222,808
2021,1,3,21,1355,1388,2234,846
2021,1,3,22,1335,1377,2211,834
2021,1,3,23,1355,1391,2245,854
2021,1,4,0,1405,1446,2273,827
2021,1,4,1,1485,1522,2332,810
2021,1,4,2,1485,1525,2346,821
2021,1,4,3,1405,1504,2292,788
2021,1,4,4,1380,1475,2237,762
2021,1,4,5,1350,1420,2236,816
2021,1,4,6,1305,1341,2226,885
2021,1,4,7,1250,1280,2252,972
2021,1,4,8,1205,1244,2244,1000
2021,1,4,9,1185,1220,2199,979
2021,1,4,10,1190,1218,2219,1001
2021,1,4,11,1190,1222,2251,1029
2021,1,4,12,1220,1243,2188,945
2021,1,4,13,1255,1302,2220,918
2021,1,4,14,1355,1406,2256,850
2021,1,4,15,1470,1484,2184,700
2021,1,4,16,1515,1483,1923,440
2021,1,4,17,1515,1500,1947,447
2021,1,4,18,1510,1487,1978,491
2021,1,4,19,1485,1482,2095,613
2021,1,4,20,1460,1466,2094,628
2021,1,4,21,1440,1451,2029,578
2021,1,4,22,1415,1458,2017,559
2021,1,4,23,1420,1453,2002,549
2021,1,5,0,1470,1492,2004,512
2021,1,5,1,1545,1542,2029,487
2021,1,5,2,1560,1526,2044,518
2021,1,5,3,1530,1498,2090,592
2021,1,5,4,1495,1453,1849,396
2021,1,5,5,1470,1390,1785,395
2021,1,5,6,1370,1309,1621,312
2021,1,5,7,1305,1247,1758,511
2021,1,5,8,1250,1218,1858,640
2021,1,5,9,1215,1217,1885,668
2021,1,5,10,1195,1190,1843,653
2021,1,5,11,1195,1189,1852,663
2021,1,5,12,1220,1214,2049,835
2021,1,5,13,1255,1253,2084,831
2021,1,5,14,1335,1376,2316,940
2021,1,5,15,1435,1464,2379,915
2021,1,5,16,1470,1467,2391,924
2021,1,5,17,1480,1473,2374,901
2021,1,5,18,1485,1449,2385,936
2021,1,5,19,1470,1435,2389,954
2021,1,5,20,1450,1417,2359,942
2021,1,5,21,1430,1398,2341,943
2021,1,5,22,1420,1387,2318,931
2021,1,5,23,1430,1391,2358,967
2021,1,6,0,1480,1433,2368,935
2021,1,6,1,1570,1520,2352,832
2021,1,6,2,1565,1520,2311,791
2021,1,6,3,1535,1497,2282,785
2021,1,6,4,1500,1470,2291,821
2021,1,6,5,1435,1422,2327,905
2021,1,6,6,1385,1346,2291,945
2021,1,6,7,1310,1298,2298,1000
2021,1,6,8,1230,1326,2303,977
2021,1,6,9,1215,1233,2294,1061
2021,1,6,10,1225,1223,2234,1011
2021,1,6,11,1230,1223,2249,1026
2021,1,6,12,1245,1248,2283,1035
2021,1,6,13,1295,1294,2321,1027
2021,1,6,14,1375,1401,2318,917
2021,1,6,15,1460,1492,2360,868
2021,1,6,16,1475,1497,2347,850
2021,1,6,17,1485,1481,2369,888
2021,1,6,18,1480,1465,2370,905
2021,1,6,19,1470,1431,2369,938
2021,1,6,20,1445,1402,2335,933
2021,1,6,21,1440,1378,2368,990
2021,1,6,22,1430,1373,2368,995
2021,1,6,23,1435,1378,2303,925
2021,1,7,0,1480,1416,2272,856
2021,1,7,1,1540,1488,2185,697
2021,1,7,2,1535,1502,2129,627
2021,1,7,3,1505,1482,2086,604
2021,1,7,4,1470,1443,2065,622
2021,1,7,5,1460,1389,2037,648
2021,1,7,6,1325,1312,2026,714
2021,1,7,7,1275,1249,2003,754
2021,1,7,8,1215,1216,2015,799
2021,1,7,9,1195,1205,2064,859
2021,1,7,10,1185,1199,2075,876
2021,1,7,11,1180,1204,2070,866
2021,1,7,12,1200,1227,2100,873
2021,1,7,13,1235,1260,2092,832
2021,1,7,14,1360,1391,2087,696
2021,1,7,15,1470,1491,2056,565
2021,1,7,16,1500,1520,2054,534
2021,1,7,17,1515,1521,2066,545
2021,1,7,18,1490,1504,2108,604
2021,1,7,19,1470,1484,2101,617
2021,1,7,20,1440,1486,2131,645
2021,1,7,21,1415,1457,2099,642
2021,1,7,22,1400,1468,2081,613
2021,1,7,23,1395,1481,2075,594
2021,1,8,0,1445,1527,2062,535
2021,1,8,1,1525,1564,2078,514
2021,1,8,2,1510,1565,2103,538
2021,1,8,3,1480,1538,2081,543
2021,1,8,4,1445,1492,2040,548
2021,1,8,5,1405,1412,2036,624
2021,1,8,6,1355,1352,2037,685
2021,1,8,7,1290,1281,2035,754
2021,1,8,8,1260,1259,2028,769
2021,1,8,9,1220,1227,2018,791
2021,1,8,10,1210,1209,2008,799
2021,1,8,11,1205,1209,2004,795
2021,1,8,12,1220,1228,2011,783
2021,1,8,13,1240,1273,2003,730
2021,1,8,14,1325,1372,2005,633
2021,1,8,15,1410,1451,2028,577
2021,1,8,16,1440,1486,2024,538
2021,1,8,17,1455,1489,2024,535
2021,1,8,18,1455,1460,1993,533
2021,1,8,19,1440,1424,2000,576
2021,1,8,20,1425,1394,1990,596
2021,1,8,21,1405,1375,1962,587
2021,1,8,22,1400,1358,1999,641
2021,1,8,23,1400,1344,1954,610
2021,1,9,0,1455,1408,2053,645
2021,1,9,1,1530,1479,2079,600
2021,1,9,2,1525,1487,2073,586
2021,1,9,3,1495,1474,2064,590
2021,1,9,4,1460,1450,2044,594
2021,1,9,5,1410,1413,2031,618
2021,1,9,6,1360,1350,2019,669
2021,1,9,7,1290,1287,2009,722
2021,1,9,8,1265,1269,2023,754
2021,1,9,9,1250,1240,2011,771
2021,1,9,10,1240,1235,2017,782
2021,1,9,11,1245,1235,2029,794
2021,1,9,12,1255,1245,2043,798
2021,1,9,13,1275,1275,2048,773
2021,1,9,14,1310,1320,2068,748
2021,1,9,15,1340,1385,2072,687
2021,1,9,16,1390,1441,2083,642
2021,1,9,17,1420,1464,2084,620
2021,1,9,18,1435,1477,2077,600
2021,1,9,19,1425,1468,2060,592
2021,1,9,20,1415,1444,2055,611
2021,1,9,21,1390,1420,2049,629
2021,1,9,22,1380,1396,2044,648
2021,1,9,23,1385,1382,2031,649
2021,1,10,0,1430,1419,2054,635
2021,1,10,1,1510,1499,2074,575
2021,1,10,2,1500,1511,2089,578
2021,1,10,3,1475,1487,2092,605
2021,1,10,4,1435,1472,2149,677
2021,1,10,5,1340,1423,2158,735
2021,1,10,6,1315,1377,2167,790
2021,1,10,7,1255,1330,2175,845
2021,1,10,8,1265,1298,2177,879
2021,1,10,9,1235,1278,2192,914
2021,1,10,10,1230,1285,2221,936
2021,1,10,11,1235,1279,2232,953
2021,1,10,12,1250,1289,2290,1001
2021,1,10,13,1275,1307,2322,1015
2021,1,10,14,1285,1356,2357,1001
2021,1,10,15,1295,1416,2394,978
2021,1,10,16,1335,1466,2404,938
2021,1,10,17,1375,1477,2385,908
2021,1,10,18,1380,1465,2345,880
2021,1,10,19,1390,1474,2367,893
2021,1,10,20,1385,1426,2341,915
2021,1,10,21,1365,1421,2355,934
2021,1,10,22,1350,1392,2337,945
2021,1,10,23,1365,1403,2348,945
2021,1,11,0,1415,1454,2350,896
2021,1,11,1,1485,1557,2361,804
2021,1,11,2,1490,1568,2357,789
2021,1,11,3,1470,1537,2341,804
2021,1,11,4,1440,1509,2358,849
2021,1,11,5,1370,1446,2378,932
2021,1,11,6,1305,1378,2387,1009
2021,1,11,7,1245,1308,2396,1088
2021,1,11,8,1230,1277,2394,1117
2021,1,11,9,1210,1266,2371,1105
2021,1,11,10,1205,1254,2340,1086
2021,1,11,11,1205,1253,2358,1105
2021,1,11,12,1230,1283,2333,1050
2021,1,11,13,1280,1334,2387,1053
2021,1,11,14,1370,1446,2386,940
2021,1,11,15,1435,1539,2358,819
2021,1,11,16,1450,1569,2368,799
2021,1,11,17,1460,1559,2328,769
2021,1,11,18,1450,1546,2285,739
2021,1,11,19,1435,1514,2344,830
2021,1,11,20,1420,1509,2387,878
2021,1,11,21,1405,1479,2396,917
2021,1,11,22,1400,1465,2397,932
2021,1,11,23,1405,1457,2397,940
2021,1,12,0,1445,1483,2394,911
2021,1,12,1,1495,1567,2362,795
2021,1,12,2,1490,1574,2363,789
2021,1,12,3,1460,1539,2314,775
2021,1,12,4,1420,1502,2317,815
2021,1,12,5,1370,1447,2331,884
2021,1,12,6,1285,1375,2310,935
2021,1,12,7,1215,1316,2323,1007
2021,1,12,8,1210,1281,2357,1076
2021,1,12,9,1200,1264,2321,1057
2021,1,12,10,1190,1255,2344,1089
2021,1,12,11,1190,1248,2278,1030
2021,1,12,12,1210,1262,2324,1062
2021,1,12,13,1240,1308,2247,939
2021,1,12,14,1330,1408,2282,874
2021,1,12,15,1395,1492,2236,744
2021,1,12,16,1415,1506,2248,742
2021,1,12,17,1420,1491,2252,761
2021,1,12,18,1405,1470,2334,864
2021,1,12,19,1390,1453,2313,860
2021,1,12,20,1365,1435,2315,880
2021,1,12,21,1350,1428,2311,883
2021,1,12,22,1340,1441,2374,933
2021,1,12,23,1345,1462,2394,932
2021,1,13,0,1385,1493,2352,859
2021,1,13,1,1475,1535,2334,799
2021,1,13,2,1475,1517,2370,853
2021,1,13,3,1450,1478,2322,844
2021,1,13,4,1420,1437,2318,881
2021,1,13,5,1395,1369,2222,853
2021,1,13,6,1305,1283,2046,763
2021,1,13,7,1250,1213,2003,790
2021,1,13,8,1220,1182,1762,580
2021,1,13,9,1155,1156,1455,299
2021,1,13,10,1150,1150,1450,300
2021,1,13,11,1150,1148,1499,351
2021,1,13,12,1175,1173,1589,416
2021,1,13,13,1215,1223,1601,378
2021,1,13,14,1340,1339,1974,635
2021,1,13,15,1445,1418,2062,644
2021,1,13,16,1455,1416,2173,757
2021,1,13,17,1445,1431,2041,610
2021,1,13,18,1430,1412,2008,596
2021,1,13,19,1400,1378,1470,92
2021,1,13,20,1380,1364,1402,38
2021,1,13,21,1355,1351,1344,-7
2021,1,13,22,1350,1337,1097,-240
2021,1,13,23,1350,1401,1273,-128
2021,1,14,0,1390,1444,1332,-112
2021,1,14,1,1460,1512,1423,-89
2021,1,14,2,1470,1518,1538,20
2021,1,14,3,1445,1491,1572,81
2021,1,14,4,1410,1462,1451,-11
2021,1,14,5,1350,1397,1429,32
2021,1,14,6,1280,1320,1431,111
2021,1,14,7,1215,1266,1462,196
2021,1,14,8,1240,1199,1601,402
2021,1,14,9,1220,1179,1717,538
2021,1,14,10,1205,1198,1798,600
2021,1,14,11,1205,1203,1915,712
2021,1,14,12,1220,1230,1937,707
2021,1,14,13,1265,1304,2150,846
2021,1,14,14,1395,1404,2199,795
2021,1,14,15,1495,1495,2298,803
2021,1,14,16,1520,1518,2322,804
2021,1,14,17,1520,1504,2315,811
2021,1,14,18,1505,1501,2332,831
2021,1,14,19,1490,1477,2351,874
2021,1,14,20,1485,1461,2401,940
2021,1,14,21,1460,1435,2354,919
2021,1,14,22,1460,1426,2252,826
2021,1,14,23,1470,1422,2228,806
2021,1,15,0,1515,1445,2275,830
2021,1,15,1,1560,1523,2312,789
2021,1,15,2,1555,1545,2285,740
2021,1,15,3,1525,1528,2221,693
2021,1,15,4,1480,1500,2175,675
2021,1,15,5,1430,1450,2142,692
2021,1,15,6,1345,1379,2144,765
2021,1,15,7,1270,1307,2125,818
2021,1,15,8,1265,1275,2108,833
2021,1,15,9,1245,1251,2000,749
2021,1,15,10,1230,1252,2037,785
2021,1,15,11,1235,1260,2052,792
2021,1,15,12,1255,1272,2135,863
2021,1,15,13,1300,1319,2212,893
2021,1,15,14,1385,1432,2255,823
2021,1,15,15,1460,1524,2301,777
2021,1,15,16,1485,1537,2325,788
2021,1,15,17,1495,1532,2346,814
2021,1,15,18,1475,1544,2357,813
2021,1,15,19,1445,1529,2361,832
2021,1,15,20,1420,1511,2304,793
2021,1,15,21,1400,1499,2284,785
2021,1,15,22,1390,1501,2274,773
2021,1,15,23,1395,1509,2272,763
2021,1,16,0,1450,1525,2344,819
2021,1,16,1,1525,1571,2368,797
2021,1,16,2,1535,1575,2369,794
2021,1,16,3,1510,1540,2377,837
2021,1,16,4,1485,1484,2332,848
2021,1,16,5,1460,1416,2242,826
2021,1,16,6,1370,1362,2258,896
2021,1,16,7,1305,1307,2306,999
2021,1,16,8,1205,1269,2260,991
2021,1,16,9,1185,1242,2235,993
2021,1,16,10,1185,1242,2188,946
2021,1,16,11,1185,1243,2254,1011
2021,1,16,12,1200,1248,2295,1047
2021,1,16,13,1230,1259,2298,1039
2021,1,16,14,1285,1304,2310,1006
2021,1,16,15,1350,1367,2322,955
2021,1,16,16,1395,1413,2286,873
2021,1,16,17,1415,1454,2284,830
2021,1,16,18,1425,1431,2273,842
2021,1,16,19,1415,1437,2318,881
2021,1,16,20,1395,1402,2347,945
2021,1,16,21,1370,1378,2357,979
2021,1,16,22,1355,1358,2345,987
2021,1,16,23,1345,1345,2307,962
2021,1,17,0,1380,1368,2230,862
2021,1,17,1,1460,1453,2270,817
2021,1,17,2,1470,1459,2206,747
2021,1,17,3,1450,1438,2175,737
2021,1,17,4,1425,1396,2139,743
2021,1,17,5,1350,1361,2142,781
2021,1,17,6,1325,1313,2172,859
2021,1,17,7,1270,1250,2169,919
2021,1,17,8,1190,1209,2222,1013
2021,1,17,9,1170,1189,2300,1111
2021,1,17,10,1175,1193,2357,1164
2021,1,17,11,1180,1210,2386,1176
2021,1,17,12,1190,1227,2411,1184
2021,1,17,13,1215,1253,2417,1164
2021,1,17,14,1265,1291,2416,1125
2021,1,17,15,1315,1354,2433,1079
2021,1,17,16,1360,1398,2408,1010
2021,1,17,17,1365,1442,2412,970
2021,1,17,18,1365,1450,2418,968
2021,1,17,19,1365,1469,2344,875
2021,1,17,20,1340,1465,2305,840
2021,1,17,21,1325,1446,2052,606
2021,1,17,22,1305,1437,2023,586
2021,1,17,23,1305,1417,2001,584
2021,1,18,0,1355,1462,2111,649
2021,1,18,1,1445,1519,2339,820
2021,1,18,2,1455,1517,2305,788
2021,1,18,3,1430,1486,2294,808
2021,1,18,4,1405,1465,2297,832
2021,1,18,5,1315,1396,2287,891
2021,1,18,6,1280,1330,2281,951
2021,1,18,7,1215,1244,2278,1034
2021,1,18,8,1190,1222,2321,1099
2021,1,18,9,1175,1214,2356,1142
2021,1,18,10,1170,1212,2395,1183
2021,1,18,11,1170,1216,2446,1230
2021,1,18,12,1200,1240,2457,1217
2021,1,18,13,1255,1298,2443,1145
2021,1,18,14,1380,1393,2434,1041
2021,1,18,15,1490,1470,2417,947
2021,1,18,16,1515,1515,2407,892
2021,1,18,17,1505,1528,2377,849
2021,1,18,18,1495,1533,2340,807
2021,1,18,19,1470,1519,2383,864
2021,1,18,20,1460,1509,2349,840
2021,1,18,21,1435,1495,2290,795
2021,1,18,22,1425,1503,2362,859
2021,1,18,23,1410,1497,2333,836
2021,1,19,0,1445,1532,2350,818
2021,1,19,1,1520,1575,2316,741
2021,1,19,2,1525,1593,2302,709
2021,1,19,3,1495,1552,2286,734
2021,1,19,4,1460,1498,2250,752
2021,1,19,5,1400,1424,2224,800
2021,1,19,6,1335,1353,2211,858
2021,1,19,7,1270,1288,2188,900
2021,1,19,8,1240,1262,2191,929
2021,1,19,9,1225,1242,2156,914
2021,1,19,10,1220,1250,2163,913
2021,1,19,11,1220,1253,2178,925
2021,1,19,12,1235,1291,2187,896
2021,1,19,13,1275,1353,2279,926
2021,1,19,14,1385,1473,2356,883
2021,1,19,15,1470,1587,2399,812
2021,1,19,16,1490,1606,2416,810
2021,1,19,17,1490,1578,2375,797
2021,1,19,18,1470,1558,2383,825
2021,1,19,19,1460,1508,2384,876
2021,1,19,20,1450,1515,2400,885
2021,1,19,21,1435,1487,2363,876
2021,1,19,22,1440,1472,2364,892
2021,1,19,23,1450,1474,2361,887
2021,1,20,0,1485,1477,2346,869
2021,1,20,1,1540,1559,2336,777
2021,1,20,2,1525,1583,2392,809
2021,1,20,3,1490,1548,2309,761
2021,1,20,4,1455,1492,2158,666
2021,1,20,5,1410,1431,2218,787
2021,1,20,6,1315,1352,2231,879
2021,1,20,7,1240,1298,2128,830
2021,1,20,8,1240,1260,2261,1001
2021,1,20,9,1210,1244,2218,974
2021,1,20,10,1205,1233,2273,1040
2021,1,20,11,1205,1246,2299,1053
2021,1,20,12,1230,1254,2247,993
2021,1,20,13,1280,1327,2313,986
2021,1,20,14,1380,1415,2328,913
2021,1,20,15,1450,1514,2382,868
2021,1,20,16,1450,1522,2409,887
2021,1,20,17,1465,1518,2435,917
2021,1,20,18,1450,1492,2423,931
2021,1,20,19,1430,1482,2420,938
2021,1,20,20,1415,1459,2411,952
2021,1,20,21,1400,1461,2427,966
2021,1,20,22,1390,1441,2414,973
2021,1,20,23,1435,1430,2391,961
2021,1,21,0,1475,1460,2391,931
2021,1,21,1,1535,1521,2380,859
2021,1,21,2,1545,1537,2386,849
2021,1,21,3,1515,1483,2362,879
2021,1,21,4,1480,1438,2352,914
2021,1,21,5,1450,1385,2362,977
2021,1,21,6,1340,1301,2272,971
2021,1,21,7,1280,1243,2265,1022
2021,1,21,8,1210,1211,2245,1034
2021,1,21,9,1190,1194,2216,1022
2021,1,21,10,1205,1199,2183,984
2021,1,21,11,1210,1197,2144,947
2021,1,21,12,1235,1208,2129,921
2021,1,21,13,1300,1279,2130,851
2021,1,21,14,1430,1383,2116,733
2021,1,21,15,1555,1476,2055,579
2021,1,21,16,1580,1502,2018,516
2021,1,21,17,1560,1514,2056,542
2021,1,21,18,1550,1516,2039,523
2021,1,21,19,1525,1505,1847,342
2021,1,21,20,1515,1488,1808,320
2021,1,21,21,1485,1470,1801,331
2021,1,21,22,1480,1463,1847,384
2021,1,21,23,1465,1466,1875,409
2021,1,22,0,1500,1518,1997,479
2021,1,22,1,1580,1576,2004,428
2021,1,22,2,1595,1591,2004,413
2021,1,22,3,1575,1573,2009,436
2021,1,22,4,1540,1526,1995,469
2021,1,22,5,1490,1481,2010,529
2021,1,22,6,1405,1398,2006,608
2021,1,22,7,1335,1340,2014,674
2021,1,22,8,1250,1305,1984,679
2021,1,22,9,1235,1278,2039,761
2021,1,22,10,1230,1278,2032,754
2021,1,22,11,1235,1272,2020,748
2021,1,22,12,1245,1272,2017,745
2021,1,22,13,1300,1326,2021,695
2021,1,22,14,1390,1421,2018,597
2021,1,22,15,1460,1516,2012,496
2021,1,22,16,1475,1547,2012,465
2021,1,22,17,1470,1538,2000,462
2021,1,22,18,1470,1531,2006,475
2021,1,22,19,1455,1509,2007,498
2021,1,22,20,1440,1485,2008,523
2021,1,22,21,1430,1468,2018,550
2021,1,22,22,1425,1440,2034,594
2021,1,22,23,1425,1431,2050,619
2021,1,23,0,1445,1434,2057,623
2021,1,23,1,1480,1516,2070,554
2021,1,23,2,1495,1520,2046,526
2021,1,23,3,1455,1501,2053,552
2021,1,23,4,1410,1468,2070,602
2021,1,23,5,1360,1440,2107,667
2021,1,23,6,1290,1390,2115,725
2021,1,23,7,1240,1343,2101,758
2021,1,23,8,1265,1304,2087,783
2021,1,23,9,1240,1285,2094,809
2021,1,23,10,1245,1279,2092,813
2021,1,23,11,1240,1264,2090,826
2021,1,23,12,1250,1290,2095,805
2021,1,23,13,1275,1313,2087,774
2021,1,23,14,1355,1364,2101,737
2021,1,23,15,1450,1430,2166,736
2021,1,23,16,1495,1497,2165,668
2021,1,23,17,1530,1534,2124,590
2021,1,23,18,1515,1531,2111,580
2021,1,23,19,1515,1515,2066,551
2021,1,23,20,1485,1479,2056,577
2021,1,23,21,1460,1440,2055,615
2021,1,23,22,1440,1431,2067,636
2021,1,23,23,1430,1408,2049,641
2021,1,24,0,1465,1432,2043,611
2021,1,24,1,1555,1510,2039,529
2021,1,24,2,1555,1528,2035,507
2021,1,24,3,1530,1513,2019,506
2021,1,24,4,1490,1484,2002,518
2021,1,24,5,1450,1456,2013,557
2021,1,24,6,1390,1395,2047,652
2021,1,24,7,1325,1345,2036,691
2021,1,24,8,1275,1312,2052,740
2021,1,24,9,1255,1293,2053,760
2021,1,24,10,1260,1289,2084,795
2021,1,24,11,1275,1297,2075,778
2021,1,24,12,1295,1308,2116,808
2021,1,24,13,1320,1335,2133,798
2021,1,24,14,1360,1373,2180,807
2021,1,24,15,1395,1439,2156,717
2021,1,24,16,1430,1476,2188,712
2021,1,24,17,1465,1498,2198,700
2021,1,24,18,1465,1501,2215,714
2021,1,24,19,1485,1482,2230,748
2021,1,24,20,1475,1463,2229,766
2021,1,24,21,1455,1427,2171,744
2021,1,24,22,1445,1413,2131,718
2021,1,24,23,1435,1396,2085,689
2021,1,25,0,1480,1430,2081,651
2021,1,25,1,1540,1513,2087,574
2021,1,25,2,1540,1547,2105,558
2021,1,25,3,1510,1532,2119,587
2021,1,25,4,1485,1499,2091,592
2021,1,25,5,1395,1432,2041,609
2021,1,25,6,1345,1370,2035,665
2021,1,25,7,1265,1317,2033,716
2021,1,25,8,1265,1283,2012,729
2021,1,25,9,1250,1280,2029,749
2021,1,25,10,1250,1274,2013,739
2021,1,25,11,1250,1293,2022,729
2021,1,25,12,1275,1319,2021,702
2021,1,25,13,1330,1375,2014,639
2021,1,25,14,1410,1508,2010,502
2021,1,25,15,1460,1608,2005,397
2021,1,25,16,1500,1651,2041,390
2021,1,25,17,1510,1644,2056,412
2021,1,25,18,1510,1614,2009,395
2021,1,25,19,1500,1574,2031,457
2021,1,25,20,1485,1541,2037,496
2021,1,25,21,1475,1531,2034,503
2021,1,25,22,1475,1506,2040,534
2021,1,25,23,1470,1517,2057,540
2021,1,26,0,1505,1535,2068,533
2021,1,26,1,1550,1617,2085,468
2021,1,26,2,1565,1658,2140,482
2021,1,26,3,1525,1633,2114,481
2021,1,26,4,1475,1593,2066,473
2021,1,26,5,1430,1537,2054,517
2021,1,26,6,1340,1459,2065,606
2021,1,26,7,1280,1417,2064,647
2021,1,26,8,1305,1392,2048,656
2021,1,26,9,1285,1378,2037,659
2021,1,26,10,1290,1382,2047,665
2021,1,26,11,1290,1393,2030,637
2021,1,26,12,1315,1410,2020,610
2021,1,26,13,1375,1478,2027,549
2021,1,26,14,1470,1584,2037,453
2021,1,26,15,1560,1686,2002,316
2021,1,26,16,1585,1696,2060,364
2021,1,26,17,1570,1669,1981,312
2021,1,26,18,1555,1654,1955,301
2021,1,26,19,1515,1620,1924,304
2021,1,26,20,1510,1573,1926,353
2021,1,26,21,1480,1534,1927,393
2021,1,26,22,1475,1508,1922,414
2021,1,26,23,1475,1509,1930,421
2021,1,27,0,1490,1528,1949,421
2021,1,27,1,1570,1602,1974,372
2021,1,27,2,1590,1645,2038,393
2021,1,27,3,1560,1602,2029,427
2021,1,27,4,1510,1570,2035,465
2021,1,27,5,1460,1511,2002,491
2021,1,27,6,1365,1443,2003,560
2021,1,27,7,1310,1387,1986,599
2021,1,27,8,1285,1353,1977,624
2021,1,27,9,1270,1343,1996,653
2021,1,27,10,1265,1350,1993,643
2021,1,27,11,1280,1357,1999,642
2021,1,27,12,1295,1373,2011,638
2021,1,27,13,1360,1433,1993,560
2021,1,27,14,1460,1550,2023,473
2021,1,27,15,1535,1644,2023,379
2021,1,27,16,1560,1663,2050,387
2021,1,27,17,1560,1654,2051,397
2021,1,27,18,1530,1628,2032,404
2021,1,27,19,1500,1596,2035,439
2021,1,27,20,1475,1560,2048,488
2021,1,27,21,1470,1541,2033,492
2021,1,27,22,1445,1531,2040,509
2021,1,27,23,1460,1523,2049,526
2021,1,28,0,1485,1531,2045,514
2021,1,28,1,1560,1587,2036,449
2021,1,28,2,1585,1614,2100,486
2021,1,28,3,1550,1577,2102,525
2021,1,28,4,1510,1513,2147,634
2021,1,28,5,1470,1462,2164,702
2021,1,28,6,1360,1382,2183,801
2021,1,28,7,1305,1322,2174,852
2021,1,28,8,1265,1290,2148,858
2021,1,28,9,1245,1271,2103,832
2021,1,28,10,1250,1268,2091,823
2021,1,28,11,1255,1267,2092,825
2021,1,28,12,1270,1284,2060,776
2021,1,28,13,1335,1324,2037,713
2021,1,28,14,1410,1432,2018,586
2021,1,28,15,1475,1526,2039,513
2021,1,28,16,1500,1546,2014,468
2021,1,28,17,1500,1535,2028,493
2021,1,28,18,1495,1501,2017,516
2021,1,28,19,1485,1470,2015,545
2021,1,28,20,1460,1427,1851,424
2021,1,28,21,1435,1411,1834,423
2021,1,28,22,1430,1385,1820,435
2021,1,28,23,1425,1397,1821,424
2021,1,29,0,1465,1424,2018,594
2021,1,29,1,1525,1484,2024,540
2021,1,29,2,1540,1496,1993,497
2021,1,29,3,1515,1486,1996,510
2021,1,29,4,1475,1442,1998,556
2021,1,29,5,1410,1384,2041,657
2021,1,29,6,1350,1310,2055,745
2021,1,29,7,1285,1253,2049,796
2021,1,29,8,1200,1217,2039,822
2021,1,29,9,1190,1206,2053,847
2021,1,29,10,1185,1199,2018,819
2021,1,29,11,1190,1201,2018,817
2021,1,29,12,1200,1227,2014,787
2021,1,29,13,1250,1269,1996,727
2021,1,29,14,1355,1376,1986,610
2021,1,29,15,1445,1458,1978,520
2021,1,29,16,1470,1497,2003,506
2021,1,29,17,1470,1501,1988,487
2021,1,29,18,1460,1493,1988,495
2021,1,29,19,1440,1484,2004,520
2021,1,29,20,1415,1458,2016,558
2021,1,29,21,1400,1446,2000,554
2021,1,29,22,1380,1421,1999,578
2021,1,29,23,1375,1414,1956,542
2021,1,30,0,1380,1430,2009,579
2021,1,30,1,1450,1514,2036,522
2021,1,30,2,1455,1454,2022,568
2021,1,30,3,1435,1471,2016,545
2021,1,30,4,1395,1441,2023,582
2021,1,30,5,1445,1394,2030,636
2021,1,30,6,1350,1355,2058,703
2021,1,30,7,1255,1306,2051,745
2021,1,30,8,1245,1268,2069,801
2021,1,30,9,1225,1247,2042,795
2021,1,30,10,1225,1228,2071,843
2021,1,30,11,1210,1241,2077,836
2021,1,30,12,1230,1251,2075,824
2021,1,30,13,1255,1252,2077,825
2021,1,30,14,1320,1295,2077,782
2021,1,30,15,1395,1352,2073,721
2021,1,30,16,1445,1415,2077,662
2021,1,30,17,1475,1437,2088,651
2021,1,30,18,1465,1428,2170,742
2021,1,30,19,1450,1422,2219,797
2021,1,30,20,1415,1374,2179,805
2021,1,30,21,1385,1378,2203,825
2021,1,30,22,1370,1346,2259,913
2021,1,30,23,1360,1363,2265,902
2021,1,31,0,1385,1371,2232,861
2021,1,31,1,1460,1442,2278,836
2021,1,31,2,1475,1479,2380,901
2021,1,31,3,1460,1452,2321,869
2021,1,31,4,1425,1429,2367,938
2021,1,31,5,1395,1382,2361,979
2021,1,31,6,1325,1329,2323,994
2021,1,31,7,1275,1283,2330,1047
2021,1,31,8,1235,1255,2331,1076
2021,1,31,9,1215,1239,2224,985
2021,1,31,10,1215,1220,2152,932
2021,1,31,11,1225,1221,2165,944
2021,1,31,12,1240,1236,2160,924
2021,1,31,13,1265,1267,2177,910
2021,1,31,14,1315,1296,2215,919
2021,1,31,15,1385,1372,2314,942
2021,1,31,16,1415,1418,2318,900
2021,1,31,17,1435,1430,2284,854
2021,1,31,18,1430,1410,2198,788
2021,1,31,19,1415,1409,2218,809
2021,1,31,20,1400,1374,2189,815
2021,1,31,21,1370,1347,2204,857
2021,1,31,22,1350,1326,2222,896
2021,1,31,23,1340,1313,2188,875
2021,2,1,0,1375,1348,2182,834
2021,2,1,1,1445,1438,2151,713
2021,2,1,2,1470,1488,2147,659
2021,2,1,3,1455,1474,2153,679
2021,2,1,4,1425,1444,2162,718
2021,2,1,5,1385,1391,2174,783
2021,2,1,6,1295,1313,2212,899
2021,2,1,7,1240,1253,2173,920
2021,2,1,8,1215,1238,2206,968
2021,2,1,9,1210,1218,2225,1007
2021,2,1,10,1205,1217,2231,1014
2021,2,1,11,1215,1215,2180,965
2021,2,1,12,1235,1252,2218,966
2021,2,1,13,1290,1304,2193,889
2021,2,1,14,1395,1404,2180,776
2021,2,1,15,1465,1499,2186,687
2021,2,1,16,1505,1515,2214,699
2021,2,1,17,1500,1508,2211,703
2021,2,1,18,1475,1480,2224,744
2021,2,1,19,1445,1433,2209,776
2021,2,1,20,1415,1417,2187,770
2021,2,1,21,1410,1390,2135,745
2021,2,1,22,1385,1380,2132,752
2021,2,1,23,1395,1367,2114,747
2021,2,2,0,1415,1385,2123,738
2021,2,2,1,1480,1447,2124,677
2021,2,2,2,1510,1489,2123,634
2021,2,2,3,1480,1462,2159,697
2021,2,2,4,1445,1422,2155,733
2021,2,2,5,1390,1371,2171,800
2021,2,2,6,1300,1292,2215,923
2021,2,2,7,1250,1231,2190,959
2021,2,2,8,1240,1205,2206,1001
2021,2,2,9,1220,1200,2267,1067
2021,2,2,10,1225,1177,2247,1070
2021,2,2,11,1235,1183,2274,1091
2021,2,2,12,1250,1201,2273,1072
2021,2,2,13,1315,1256,2266,1010
2021,2,2,14,1415,1358,2283,925
2021,2,2,15,1505,1465,2227,762
2021,2,2,16,1525,1464,2219,755
2021,2,2,17,1515,1436,2171,735
2021,2,2,18,1500,1414,2169,755
2021,2,2,19,1470,1391,2185,794
2021,2,2,20,1440,1371,2183,812
2021,2,2,21,1405,1369,2201,832
2021,2,2,22,1385,1355,2223,868
2021,2,2,23,1385,1368,2248,880
2021,2,3,0,1405,1367,2250,883
2021,2,3,1,1475,1419,2262,843
2021,2,3,2,1510,1469,2261,792
2021,2,3,3,1475,1446,2272,826
2021,2,3,4,1440,1409,2236,827
2021,2,3,5,1370,1353,2209,856
2021,2,3,6,1315,1294,2180,886
2021,2,3,7,1265,1234,2242,1008
2021,2,3,8,1200,1201,2221,1020
2021,2,3,9,1185,1188,2363,1175
2021,2,3,10,1185,1186,2444,1258
2021,2,3,11,1195,1190,2398,1208
2021,2,3,12,1210,1193,2352,1159
2021,2,3,13,1270,1262,2387,1125
2021,2,3,14,1405,1370,2348,978
2021,2,3,15,1525,1469,2338,869
2021,2,3,16,1540,1476,2272,796
2021,2,3,17,1530,1484,2257,773
2021,2,3,18,1505,1475,2204,729
2021,2,3,19,1475,1461,2199,738
2021,2,3,20,1450,1443,2223,780
2021,2,3,21,1430,1438,2276,838
2021,2,3,22,1420,1426,2275,849
2021,2,3,23,1410,1414,2272,858
2021,2,4,0,1425,1440,2210,770
2021,2,4,1,1485,1501,2191,690
2021,2,4,2,1510,1539,2202,663
2021,2,4,3,1475,1526,2196,670
2021,2,4,4,1420,1478,2163,685
2021,2,4,5,1350,1421,2136,715
2021,2,4,6,1290,1349,2153,804
2021,2,4,7,1235,1291,2135,844
2021,2,4,8,1215,-9999,-9999,-9999
2021,2,4,9,1195,-9999,-9999,-9999
2021,2,4,10,1190,-9999,-9999,-9999
2021,2,4,11,1190,-9999,-9999,-9999
2021,2,4,12,1210,-9999,-9999,-9999
2021,2,4,13,1260,-9999,-9999,-9999
2021,2,4,14,1420,-9999,-9999,-9999
2021,2,4,15,1565,-9999,-9999,-9999
2021,2,4,16,1585,-9999,-9999,-9999
2021,2,4,17,1570,-9999,-9999,-9999
2021,2,4,18,1540,-9999,-9999,-9999
2021,2,4,19,1515,-9999,-9999,-9999
2021,2,4,20,1480,-9999,-9999,-9999
2021,2,4,21,1470,-9999,-9999,-9999
2021,2,4,22,1445,-9999,-9999,-9999
2021,2,4,23,1455,-9999,-9999,-9999
2021,2,5,0,1475,-9999,-9999,-9999
2021,2,5,1,1540,-9999,-9999,-9999
2021,2,5,2,1560,-9999,-9999,-9999
2021,2,5,3,1545,-9999,-9999,-9999
2021,2,5,4,1500,-9999,-9999,-9999
2021,2,5,5,1450,-9999,-9999,-9999
2021,2,5,6,1360,-9999,-9999,-9999
2021,2,5,7,1300,-9999,-9999,-9999
