Year,Month,Day,Hour,Forecast_Demand_MWh,Adjusted_Demand_MWh,Adjusted_Generation_MWh,Adjusted_Interchange_MWh
2015,7,1,5,16045,16891,14444,-2447
2015,7,1,6,0,16027,13809,-2218
2015,7,1,7,0,15541,13435,-2106
2015,7,1,8,0,15283,13144,-2139
2015,7,1,9,0,15304,13147,-2157
2015,7,1,10,0,15874,13771,-2103
2015,7,1,11,0,17161,14635,-2526
2015,7,1,12,0,18690,15545,-3145
2015,7,1,13,0,19956,16448,-3508
2015,7,1,14,0,20971,17865,-3106
2015,7,1,15,0,21849,18554,-3295
2015,7,1,16,0,22471,19391,-3080
2015,7,1,17,0,22809,19766,-3043
2015,7,1,18,0,23260,20204,-3056
2015,7,1,19,0,23606,20246,-3360
2015,7,1,20,0,23778,20585,-3193
2015,7,1,21,0,23804,20089,-3715
2015,7,1,22,0,23664,19849,-3815
2015,7,1,23,0,22984,19256,-3728
2015,7,2,0,0,22262,18691,-3571
2015,7,2,1,0,21746,18233,-3513
2015,7,2,2,0,21525,18252,-3273
2015,7,2,3,0,20149,16872,-3277
2015,7,2,4,0,18493,15582,-2911
2015,7,2,5,16893,17090,14478,-2612
2015,7,2,6,16256,16052,13546,-2506
2015,7,2,7,15665,15356,13247,-2109
2015,7,2,8,15274,14936,13103,-1833
2015,7,2,9,15185,14884,13241,-1643
2015,7,2,10,15325,15314,13337,-1977
2015,7,2,11,16160,16591,14106,-2485
2015,7,2,12,17721,18271,15132,-3139
2015,7,2,13,19122,19470,16023,-3447
2015,7,2,14,20140,20364,16564,-3800
2015,7,2,15,20935,21181,16964,-4217
2015,7,2,16,21494,21714,17718,-3996
2015,7,2,17,21846,22057,18076,-3981
2015,7,2,18,22160,22313,18184,-4129
2015,7,2,19,22431,22337,18265,-4072
2015,7,2,20,22632,22136,18217,-3919
2015,7,2,21,22650,21972,18709,-3263
2015,7,2,22,22605,21717,18841,-2876
2015,7,2,23,22037,21071,17899,-3172
2015,7,3,0,21253,20473,17446,-3027
2015,7,3,1,20651,20195,17193,-3002
2015,7,3,2,20485,19896,17085,-2811
2015,7,3,3,19491,18717,15774,-2943
2015,7,3,4,18106,17352,14715,-2637
2015,7,3,5,16584,16108,13636,-2472
2015,7,3,6,15631,15179,12688,-2491
2015,7,3,7,14911,14519,12247,-2272
2015,7,3,8,14399,14107,11948,-2159
2015,7,3,9,14218,13947,11990,-1957
2015,7,3,10,13964,13996,12253,-1743
2015,7,3,11,14488,14541,12544,-1997
2015,7,3,12,15600,15620,12834,-2786
2015,7,3,13,16799,16746,13737,-3009
2015,7,3,14,17966,17752,14547,-3205
2015,7,3,15,18978,18535,15235,-3300
2015,7,3,16,19557,19062,15999,-3063
2015,7,3,17,19856,19430,16407,-3023
2015,7,3,18,20135,19745,16529,-3216
2015,7,3,19,20295,20061,16990,-3071
2015,7,3,20,20454,20435,17068,-3367
2015,7,3,21,20427,20675,17246,-3429
2015,7,3,22,20214,20585,17023,-3562
2015,7,3,23,19438,20138,16725,-3413
2015,7,4,0,18602,19525,16253,-3272
2015,7,4,1,18045,19172,16137,-3035
2015,7,4,2,17925,19034,16080,-2954
2015,7,4,3,17615,18112,14898,-3214
2015,7,4,4,16974,16956,14331,-2625
2015,7,4,5,15771,15872,13594,-2278
2015,7,4,6,15182,15036,12938,-2098
2015,7,4,7,14583,14479,12735,-1744
2015,7,4,8,14134,14118,12524,-1594
2015,7,4,9,13925,13930,12278,-1652
2015,7,4,10,13369,13891,12483,-1408
2015,7,4,11,13254,14069,12761,-1308
2015,7,4,12,13704,14758,13317,-1441
2015,7,4,13,14779,15804,13915,-1889
2015,7,4,14,15898,16822,14671,-2151
2015,7,4,15,16766,17572,15598,-1974
2015,7,4,16,17182,17963,15773,-2190
2015,7,4,17,17309,18211,16104,-2107
2015,7,4,18,17319,18192,16164,-2028
2015,7,4,19,17279,18058,16134,-1924
2015,7,4,20,17252,17974,16295,-1679
2015,7,4,21,17166,18087,16531,-1556
2015,7,4,22,17122,18168,16424,-1744
2015,7,4,23,16892,17927,15848,-2079
2015,7,5,0,16524,17503,15557,-1946
2015,7,5,1,16290,17246,15461,-1785
2015,7,5,2,16440,17159,15184,-1975
2015,7,5,3,16228,16777,15081,-1696
2015,7,5,4,15693,16141,14161,-1980
2015,7,5,5,14668,15281,13526,-1755
2015,7,5,6,13986,14584,12757,-1827
2015,7,5,7,13676,14057,12352,-1705
2015,7,5,8,13451,13744,12156,-1588
2015,7,5,9,13335,13582,12140,-1442
2015,7,5,10,12894,13440,12026,-1414
2015,7,5,11,12900,13566,11867,-1699
2015,7,5,12,13419,14354,12511,-1843
2015,7,5,13,14533,15567,13750,-1817
2015,7,5,14,15770,16691,14458,-2233
2015,7,5,15,16936,17785,15491,-2294
2015,7,5,16,17815,18706,16480,-2226
2015,7,5,17,18405,19403,17006,-2397
2015,7,5,18,18888,19949,17663,-2286
2015,7,5,19,19357,20348,17668,-2680
2015,7,5,20,19744,20764,17830,-2934
2015,7,5,21,19956,21148,18027,-3121
2015,7,5,22,20137,21343,18183,-3160
2015,7,5,23,19822,21123,17727,-3396
2015,7,6,0,19400,20670,17658,-3012
2015,7,6,1,19171,20539,17603,-2936
2015,7,6,2,19250,20580,17822,-2758
2015,7,6,3,18542,19517,16879,-2638
2015,7,6,4,17412,18130,15136,-2994
2015,7,6,5,16152,16923,14136,-2787
2015,7,6,6,15475,16095,13710,-2385
2015,7,6,7,15221,15537,13237,-2300
2015,7,6,8,15092,15261,12742,-2519
2015,7,6,9,15038,15325,12946,-2379
2015,7,6,10,15222,15803,13475,-2328
2015,7,6,11,16381,17065,14219,-2846
2015,7,6,12,18185,18915,15613,-3302
2015,7,6,13,19917,20549,17266,-3283
2015,7,6,14,21210,22019,18478,-3541
2015,7,6,15,22306,23238,19494,-3744
2015,7,6,16,23185,24085,20102,-3983
2015,7,6,17,23775,24614,20443,-4171
2015,7,6,18,24300,25089,20544,-4545
2015,7,6,19,24715,25381,21165,-4216
2015,7,6,20,25000,25580,22207,-3373
2015,7,6,21,25135,25621,22425,-3196
2015,7,6,22,25062,25415,22088,-3327
2015,7,6,23,24527,24683,21081,-3602
2015,7,7,0,23675,23922,20580,-3342
2015,7,7,1,23008,23446,20314,-3132
2015,7,7,2,22726,23139,20140,-2999
2015,7,7,3,21392,21698,19008,-2690
2015,7,7,4,19629,19969,17351,-2618
2015,7,7,5,17761,18563,15588,-2975
2015,7,7,6,17016,17683,14910,-2773
2015,7,7,7,16744,17136,14672,-2464
2015,7,7,8,16573,16843,14355,-2488
2015,7,7,9,16512,16974,14724,-2250
2015,7,7,10,16801,17651,15078,-2573
2015,7,7,11,18111,19086,16194,-2892
2015,7,7,12,19937,21006,17446,-3560
2015,7,7,13,21569,22626,19002,-3624
2015,7,7,14,22802,23979,20362,-3617
2015,7,7,15,23961,25154,21513,-3641
2015,7,7,16,24848,26127,22651,-3476
2015,7,7,17,25402,26871,23322,-3549
2015,7,7,18,25874,27642,24213,-3429
2015,7,7,19,26233,28023,24644,-3379
2015,7,7,20,26490,28043,24162,-3881
2015,7,7,21,26665,28172,24175,-3997
2015,7,7,22,26633,27882,24134,-3748
2015,7,7,23,26041,27070,23543,-3527
2015,7,8,0,25145,26232,23070,-3162
2015,7,8,1,24431,25652,22677,-2975
2015,7,8,2,24176,25164,22109,-3055
2015,7,8,3,22754,23422,20346,-3076
2015,7,8,4,20933,21433,17963,-3470
2015,7,8,5,18849,19820,16342,-3478
2015,7,8,6,18089,18682,15296,-3386
2015,7,8,7,17556,17953,15048,-2905
2015,7,8,8,17265,17588,15076,-2512
2015,7,8,9,17187,17523,15138,-2385
2015,7,8,10,17702,18064,15502,-2562
2015,7,8,11,18710,19436,16329,-3107
2015,7,8,12,20497,21111,17525,-3586
2015,7,8,13,22050,22320,18531,-3789
2015,7,8,14,23142,23232,19812,-3420
2015,7,8,15,24039,24050,20207,-3843
2015,7,8,16,24834,24785,21337,-3448
2015,7,8,17,25323,25462,21872,-3590
2015,7,8,18,25689,26092,22183,-3909
2015,7,8,19,25914,26609,22325,-4284
2015,7,8,20,25999,26567,22420,-4147
2015,7,8,21,26036,26146,22436,-3710
2015,7,8,22,25912,25603,22025,-3578
2015,7,8,23,25366,24933,21492,-3441
2015,7,9,0,24530,24309,21016,-3293
2015,7,9,1,23866,24012,20807,-3205
2015,7,9,2,23627,23595,19990,-3605
2015,7,9,3,22309,22139,18636,-3503
2015,7,9,4,20597,20337,16832,-3505
2015,7,9,5,18824,18834,15096,-3738
2015,7,9,6,17894,17785,14145,-3640
2015,7,9,7,17217,17114,13587,-3527
2015,7,9,8,16862,16565,13116,-3449
2015,7,9,9,16766,16456,12943,-3513
2015,7,9,10,17375,16926,13299,-3627
2015,7,9,11,18323,18037,14062,-3975
2015,7,9,12,19871,19574,15402,-4172
2015,7,9,13,21134,20610,16718,-3892
2015,7,9,14,22075,21271,18419,-2852
2015,7,9,15,22852,21701,18823,-2878
2015,7,9,16,23493,22044,19178,-2866
2015,7,9,17,23876,22253,19056,-3197
2015,7,9,18,24180,22481,19510,-2971
2015,7,9,19,24392,22513,19843,-2670
2015,7,9,20,24485,22624,20216,-2408
2015,7,9,21,24537,22900,20720,-2180
2015,7,9,22,24393,22857,20786,-2071
2015,7,9,23,23878,22253,20144,-2109
2015,7,10,0,23232,21692,18963,-2729
2015,7,10,1,22734,21529,18801,-2728
2015,7,10,2,22569,21057,18195,-2862
2015,7,10,3,21410,19883,17169,-2714
2015,7,10,4,19884,18562,16199,-2363
2015,7,10,5,17973,17437,14740,-2697
2015,7,10,6,16953,16648,13788,-2860
2015,7,10,7,16356,16174,13484,-2690
2015,7,10,8,16028,15896,13416,-2480
2015,7,10,9,15964,15858,13746,-2112
2015,7,10,10,16453,16283,13895,-2388
2015,7,10,11,17365,17452,14772,-2680
2015,7,10,12,18975,19155,15718,-3437
2015,7,10,13,20428,20465,17090,-3375
2015,7,10,14,21587,21391,17783,-3608
2015,7,10,15,22530,22189,18632,-3557
2015,7,10,16,23307,22674,19337,-3337
2015,7,10,17,23826,23087,19566,-3521
2015,7,10,18,24287,23491,19998,-3493
2015,7,10,19,24580,23829,19936,-3893
2015,7,10,20,24735,24157,20236,-3921
2015,7,10,21,24854,24406,20523,-3883
2015,7,10,22,24707,24314,20686,-3628
2015,7,10,23,24061,23604,20478,-3126
2015,7,11,0,23154,22764,19724,-3040
2015,7,11,1,22509,22069,19053,-3016
2015,7,11,2,22379,21683,18616,-3067
2015,7,11,3,21276,20442,17327,-3115
2015,7,11,4,19793,18890,16033,-2857
2015,7,11,5,17911,17542,14793,-2749
2015,7,11,6,16619,16522,13745,-2777
2015,7,11,7,15915,15829,13226,-2603
2015,7,11,8,15462,15339,12862,-2477
2015,7,11,9,15228,15120,12643,-2477
2015,7,11,10,14964,15003,12598,-2405
2015,7,11,11,15137,15330,13269,-2061
2015,7,11,12,15965,16405,14146,-2259
2015,7,11,13,17301,17807,15251,-2556
2015,7,11,14,18659,19188,16162,-3026
2015,7,11,15,19868,20355,17330,-3025
2015,7,11,16,20771,21167,18256,-2911
2015,7,11,17,21403,21757,18297,-3460
2015,7,11,18,21872,22119,18909,-3210
2015,7,11,19,22281,22434,19390,-3044
2015,7,11,20,22532,22793,20076,-2717
2015,7,11,21,22654,23092,20296,-2796
2015,7,11,22,22628,23172,20531,-2641
2015,7,11,23,22272,22879,20392,-2487
2015,7,12,0,21630,22183,19884,-2299
2015,7,12,1,21296,21652,18749,-2903
2015,7,12,2,21346,21465,18107,-3358
2015,7,12,3,20464,20481,17520,-2961
2015,7,12,4,19216,19160,16347,-2813
2015,7,12,5,17701,17903,15467,-2436
2015,7,12,6,16578,16963,14106,-2857
2015,7,12,7,15930,16143,13584,-2559
2015,7,12,8,15487,15664,13447,-2217
2015,7,12,9,15245,15322,13327,-1995
2015,7,12,10,14883,15109,13028,-2081
2015,7,12,11,14924,15214,13372,-1842
2015,7,12,12,15585,16110,13910,-2200
2015,7,12,13,16862,17531,14963,-2568
2015,7,12,14,18298,19027,16185,-2842
2015,7,12,15,19658,20405,17304,-3101
2015,7,12,16,20783,21492,18215,-3277
2015,7,12,17,21625,22278,18877,-3401
2015,7,12,18,22293,22872,19532,-3340
2015,7,12,19,22768,23310,20129,-3181
2015,7,12,20,23128,23713,20591,-3122
2015,7,12,21,23438,23904,20869,-3035
2015,7,12,22,23524,23869,20918,-2951
2015,7,12,23,23289,23592,20729,-2863
2015,7,13,0,22651,23129,20581,-2548
2015,7,13,1,22331,22878,20284,-2594
2015,7,13,2,22321,22811,19723,-3088
2015,7,13,3,21193,21618,18779,-2839
2015,7,13,4,19764,20031,16989,-3042
2015,7,13,5,17985,18648,15648,-3000
2015,7,13,6,17158,17678,14694,-2984
2015,7,13,7,16641,17059,14062,-2997
2015,7,13,8,16329,16744,14008,-2736
2015,7,13,9,16266,16749,13798,-2951
2015,7,13,10,16762,17299,14377,-2922
2015,7,13,11,17839,18562,15643,-2919
2015,7,13,12,19659,20485,17135,-3350
2015,7,13,13,21220,22146,18773,-3373
2015,7,13,14,22405,23643,20453,-3190
2015,7,13,15,23466,24805,21452,-3353
2015,7,13,16,24325,25711,21670,-4041
2015,7,13,17,24916,26447,21668,-4779
2015,7,13,18,25448,27045,21933,-5112
2015,7,13,19,25756,27430,22457,-4973
2015,7,13,20,25940,27638,22871,-4767
2015,7,13,21,26030,27754,23100,-4654
2015,7,13,22,25896,27462,23258,-4204
2015,7,13,23,25214,26490,22499,-3991
2015,7,14,0,24341,25448,22075,-3373
2015,7,14,1,23679,24677,21428,-3249
2015,7,14,2,23275,24171,20638,-3533
2015,7,14,3,21870,22533,19108,-3425
2015,7,14,4,20141,20667,17252,-3415
2015,7,14,5,18711,19115,15692,-3423
2015,7,14,6,17687,18074,15052,-3022
2015,7,14,7,17011,17407,14527,-2880
2015,7,14,8,16627,17038,13950,-3088
2015,7,14,9,16553,17023,13866,-3157
2015,7,14,10,17022,17647,14354,-3293
2015,7,14,11,18040,19033,15782,-3251
2015,7,14,12,19808,20947,17489,-3458
2015,7,14,13,21285,22425,18971,-3454
2015,7,14,14,22302,23562,19858,-3704
2015,7,14,15,23197,24223,20039,-4184
2015,7,14,16,23858,24749,20956,-3793
2015,7,14,17,24323,25029,21360,-3669
2015,7,14,18,24781,25107,21632,-3475
2015,7,14,19,25083,25085,21656,-3429
2015,7,14,20,25290,25120,22164,-2956
2015,7,14,21,25480,25380,22000,-3380
2015,7,14,22,25419,25453,21984,-3469
2015,7,14,23,24835,24857,21348,-3509
2015,7,15,0,24094,24310,20867,-3443
2015,7,15,1,23600,24079,20577,-3502
2015,7,15,2,23275,23792,20551,-3241
2015,7,15,3,21984,22418,19447,-2971
2015,7,15,4,20288,20657,17487,-3170
2015,7,15,5,18768,19250,15460,-3790
2015,7,15,6,17982,18248,14886,-3362
2015,7,15,7,17212,17552,14620,-2932
2015,7,15,8,16766,17163,14595,-2568
2015,7,15,9,16708,17112,14637,-2475
2015,7,15,10,17499,17671,14905,-2766
2015,7,15,11,18351,19059,16012,-3047
2015,7,15,12,19993,20712,17356,-3356
2015,7,15,13,21326,21839,17893,-3946
2015,7,15,14,22322,22736,18695,-4041
2015,7,15,15,23141,23301,19389,-3912
2015,7,15,16,23781,23508,19453,-4055
2015,7,15,17,24135,23527,19657,-3870
2015,7,15,18,24465,23596,20207,-3389
2015,7,15,19,24625,23625,20792,-2833
2015,7,15,20,24680,23729,20907,-2822
2015,7,15,21,24680,23901,21325,-2576
2015,7,15,22,24477,23707,21312,-2395
2015,7,15,23,23846,22940,20020,-2920
2015,7,16,0,23103,22142,19737,-2405
2015,7,16,1,22588,21618,19070,-2548
2015,7,16,2,22256,21151,18725,-2426
2015,7,16,3,20995,19685,17051,-2634
2015,7,16,4,19278,17980,15385,-2595
2015,7,16,5,17743,16630,14069,-2561
2015,7,16,6,16744,15663,13160,-2503
2015,7,16,7,15829,15002,13088,-1914
2015,7,16,8,15350,14592,12915,-1677
2015,7,16,9,15285,14540,12959,-1581
2015,7,16,10,15898,15035,13257,-1778
2015,7,16,11,16606,16164,14142,-2022
2015,7,16,12,18143,17749,15059,-2690
2015,7,16,13,19389,18956,16265,-2691
2015,7,16,14,20269,19867,17167,-2700
2015,7,16,15,21001,20492,17849,-2643
2015,7,16,16,21475,20919,17754,-3165
2015,7,16,17,21832,21250,18013,-3237
2015,7,16,18,22218,21705,18783,-2922
2015,7,16,19,22594,22037,19282,-2755
2015,7,16,20,22858,22412,19435,-2977
2015,7,16,21,22972,22689,19862,-2827
2015,7,16,22,22900,22715,19584,-3131
2015,7,16,23,22292,22149,19435,-2714
2015,7,17,0,21661,21361,18685,-2676
2015,7,17,1,21289,20816,18350,-2466
2015,7,17,2,21038,20507,17888,-2619
2015,7,17,3,19929,19174,16248,-2926
2015,7,17,4,18439,17638,15432,-2206
2015,7,17,5,16570,16378,14416,-1962
2015,7,17,6,15589,15565,13831,-1734
2015,7,17,7,15064,14909,13346,-1563
2015,7,17,8,14736,14627,13239,-1388
2015,7,17,9,14659,14690,13400,-1290
2015,7,17,10,15013,15234,13644,-1590
2015,7,17,11,15952,16421,14554,-1867
2015,7,17,12,17576,18124,15596,-2528
2015,7,17,13,19002,19464,16926,-2538
2015,7,17,14,20020,20593,17857,-2736
2015,7,17,15,20819,21453,18630,-2823
2015,7,17,16,21383,22002,19077,-2925
2015,7,17,17,21853,22390,19439,-2951
2015,7,17,18,22285,22748,19923,-2825
2015,7,17,19,22593,22915,20364,-2551
2015,7,17,20,22868,23010,19840,-3170
2015,7,17,21,23016,23069,19632,-3437
2015,7,17,22,22902,22853,19836,-3017
2015,7,17,23,22313,22089,19571,-2518
2015,7,18,0,21595,21277,18880,-2397
2015,7,18,1,21103,20997,18603,-2394
2015,7,18,2,20936,20766,18835,-1931
2015,7,18,3,19994,19771,17657,-2114
2015,7,18,4,18680,18450,16437,-2013
2015,7,18,5,16887,17358,15775,-1583
2015,7,18,6,16123,16506,14529,-1977
2015,7,18,7,15714,15986,13980,-2006
2015,7,18,8,15416,15683,13848,-1835
2015,7,18,9,15205,15602,13842,-1760
2015,7,18,10,14956,15754,14482,-1272
2015,7,18,11,15483,16144,14597,-1547
2015,7,18,12,16331,17101,15000,-2101
2015,7,18,13,17650,18411,16379,-2032
2015,7,18,14,19098,19591,17347,-2244
2015,7,18,15,20308,20587,18211,-2376
2015,7,18,16,21179,21495,18823,-2672
2015,7,18,17,21784,22173,19489,-2684
2015,7,18,18,22204,22605,19998,-2607
2015,7,18,19,22458,23108,20107,-3001
2015,7,18,20,22736,23766,20464,-3302
2015,7,18,21,23053,24361,21284,-3077
2015,7,18,22,23204,24465,21509,-2956
2015,7,18,23,22947,24179,21024,-3155
2015,7,19,0,22380,23633,19765,-3868
2015,7,19,1,21970,23364,19904,-3460
2015,7,19,2,21951,23158,19866,-3292
2015,7,19,3,21029,22109,19344,-2765
2015,7,19,4,19712,20827,18279,-2548
2015,7,19,5,17751,19556,16441,-3115
2015,7,19,6,16986,18598,15235,-3363
2015,7,19,7,16667,17872,14624,-3248
2015,7,19,8,16420,17371,14463,-2908
2015,7,19,9,16221,17088,14401,-2687
2015,7,19,10,15818,16891,14754,-2137
2015,7,19,11,16138,16973,14627,-2346
2015,7,19,12,16931,18035,15676,-2359
2015,7,19,13,18403,19809,17285,-2524
2015,7,19,14,20210,21644,18752,-2892
2015,7,19,15,21807,23480,20456,-3024
2015,7,19,16,23044,24852,21691,-3161
2015,7,19,17,23963,25865,22394,-3471
2015,7,19,18,24586,26574,23080,-3494
2015,7,19,19,25051,27160,23432,-3728
2015,7,19,20,25483,27606,23701,-3905
2015,7,19,21,25881,27776,23917,-3859
2015,7,19,22,26009,27687,23675,-4012
2015,7,19,23,25706,27249,23302,-3947
2015,7,20,0,25008,26653,22701,-3952
2015,7,20,1,24375,26495,22599,-3896
2015,7,20,2,24166,26295,22386,-3909
2015,7,20,3,22869,24962,21139,-3823
2015,7,20,4,21203,23353,19610,-3743
2015,7,20,5,19928,21942,17607,-4335
2015,7,20,6,19028,20979,16791,-4188
2015,7,20,7,18556,20325,16497,-3828
2015,7,20,8,18209,19920,16216,-3704
2015,7,20,9,18150,19880,16119,-3761
2015,7,20,10,18548,20439,16581,-3858
2015,7,20,11,19709,21566,17572,-3994
2015,7,20,12,21683,23560,19239,-4321
2015,7,20,13,23525,25433,20538,-4895
2015,7,20,14,25054,26899,22573,-4326
2015,7,20,15,26327,28117,24068,-4049
2015,7,20,16,27299,29064,25134,-3930
2015,7,20,17,27933,29652,25997,-3655
2015,7,20,18,28475,30212,26615,-3597
2015,7,20,19,28839,30449,27327,-3122
2015,7,20,20,29117,30575,27770,-2805
2015,7,20,21,29310,30573,27462,-3111
2015,7,20,22,29213,30329,27467,-2862
2015,7,20,23,28548,29625,26723,-2902
2015,7,21,0,27545,28794,25666,-3128
2015,7,21,1,26615,28220,25222,-2998
2015,7,21,2,26148,27474,24591,-2883
2015,7,21,3,24554,25559,23068,-2491
2015,7,21,4,22610,23448,20552,-2896
2015,7,21,5,20979,21655,18503,-3152
2015,7,21,6,19589,20427,17459,-2968
2015,7,21,7,19006,19609,16867,-2742
2015,7,21,8,18601,19135,16698,-2437
2015,7,21,9,18508,19093,16583,-2510
2015,7,21,10,18867,19705,17310,-2395
2015,7,21,11,19946,20945,18389,-2556
2015,7,21,12,21678,22502,19742,-2760
2015,7,21,13,23189,23829,21189,-2640
2015,7,21,14,24413,24820,21867,-2953
2015,7,21,15,25483,25761,22510,-3251
2015,7,21,16,26291,26304,22944,-3360
2015,7,21,17,26820,26704,23670,-3034
2015,7,21,18,27269,26983,24191,-2792
2015,7,21,19,27582,27281,24695,-2586
2015,7,21,20,27862,27668,25181,-2487
2015,7,21,21,28092,27893,25340,-2553
2015,7,21,22,27971,27588,25524,-2064
2015,7,21,23,27283,26718,25592,-1126
2015,7,22,0,26326,25749,24523,-1226
2015,7,22,1,25555,24893,23531,-1362
2015,7,22,2,25199,24331,22744,-1587
2015,7,22,3,23782,22717,21282,-1435
2015,7,22,4,22044,20735,18841,-1894
2015,7,22,5,20476,19104,16280,-2824
2015,7,22,6,18667,17869,15045,-2824
2015,7,22,7,17700,16958,14499,-2459
2015,7,22,8,17073,16499,14469,-2030
2015,7,22,9,16898,16382,14661,-1721
2015,7,22,10,17428,16762,14741,-2021
2015,7,22,11,18194,17858,15455,-2403
2015,7,22,12,19751,19575,17150,-2425
2015,7,22,13,21067,20913,18383,-2530
2015,7,22,14,22040,21899,19480,-2419
2015,7,22,15,22835,22666,20171,-2495
2015,7,22,16,23412,23237,20958,-2279
2015,7,22,17,23778,23643,20973,-2670
2015,7,22,18,24164,24129,21694,-2435
2015,7,22,19,24530,24480,21857,-2623
2015,7,22,20,24804,24793,22091,-2702
2015,7,22,21,25013,24949,22252,-2697
2015,7,22,22,24973,24823,22255,-2568
2015,7,22,23,24306,23991,21761,-2230
2015,7,23,0,23534,23010,21143,-1867
2015,7,23,1,23084,22454,20448,-2006
2015,7,23,2,22867,22034,19828,-2206
2015,7,23,3,21714,20643,18346,-2297
2015,7,23,4,20169,18910,16720,-2190
2015,7,23,5,18482,17525,15374,-2151
2015,7,23,6,17079,16569,14053,-2516
2015,7,23,7,16157,15857,13270,-2587
2015,7,23,8,15627,15496,13240,-2256
2015,7,23,9,15520,15465,13137,-2328
2015,7,23,10,16102,15978,13371,-2607
2015,7,23,11,16863,17195,14753,-2442
2015,7,23,12,18450,18966,16275,-2691
2015,7,23,13,19804,20338,18010,-2328
2015,7,23,14,20730,21380,18756,-2624
2015,7,23,15,21470,22168,19268,-2900
2015,7,23,16,22009,22759,20224,-2535
2015,7,23,17,22364,23137,20841,-2296
2015,7,23,18,22757,23565,21160,-2405
2015,7,23,19,23159,23998,21688,-2310
2015,7,23,20,23446,24380,21969,-2411
2015,7,23,21,23692,24622,22206,-2416
2015,7,23,22,23663,24525,22263,-2262
2015,7,23,23,23084,23809,21300,-2509
2015,7,24,0,22386,22920,20329,-2591
2015,7,24,1,22069,22272,19729,-2543
2015,7,24,2,21883,21853,19282,-2571
2015,7,24,3,20723,20432,17628,-2804
2015,7,24,4,19195,18680,16285,-2395
2015,7,24,5,17317,17289,14675,-2614
2015,7,24,6,16381,16345,13508,-2837
2015,7,24,7,15622,15733,13077,-2656
2015,7,24,8,15144,15399,12943,-2456
2015,7,24,9,15024,15369,13029,-2340
2015,7,24,10,15539,15859,13416,-2443
2015,7,24,11,16316,16947,14747,-2200
2015,7,24,12,17864,18715,16280,-2435
2015,7,24,13,19243,20126,17530,-2596
2015,7,24,14,20234,21213,18293,-2920
2015,7,24,15,21066,22151,19644,-2507
2015,7,24,16,21652,22787,20091,-2696
2015,7,24,17,22055,23230,20667,-2563
2015,7,24,18,22503,23685,20988,-2697
2015,7,24,19,22944,24069,21288,-2781
2015,7,24,20,23268,24370,21655,-2715
2015,7,24,21,23509,24579,21711,-2868
2015,7,24,22,23376,24437,21369,-3068
2015,7,24,23,22750,23687,20845,-2842
2015,7,25,0,21900,22822,19964,-2858
2015,7,25,1,21398,22282,19634,-2648
2015,7,25,2,21258,21885,19387,-2498
2015,7,25,3,20255,20623,18466,-2157
2015,7,25,4,18891,19110,16619,-2491
2015,7,25,5,17387,17746,14626,-3120
2015,7,25,6,16282,16742,13786,-2956
2015,7,25,7,15566,16029,13222,-2807
2015,7,25,8,15066,15550,12836,-2714
2015,7,25,9,14780,15331,12818,-2513
2015,7,25,10,14421,15333,13145,-2188
2015,7,25,11,14648,15614,13485,-2129
2015,7,25,12,15422,16676,14316,-2360
2015,7,25,13,16795,18073,15697,-2376
2015,7,25,14,18126,19366,16845,-2521
2015,7,25,15,19269,20448,17618,-2830
2015,7,25,16,20039,21214,18452,-2762
2015,7,25,17,20538,21750,19189,-2561
2015,7,25,18,20935,22110,19950,-2160
2015,7,25,19,21285,22440,20058,-2382
2015,7,25,20,21612,22749,20164,-2585
2015,7,25,21,21917,22978,20268,-2710
2015,7,25,22,21950,22967,20168,-2799
2015,7,25,23,21603,22568,19961,-2607
2015,7,26,0,20982,21933,19119,-2814
2015,7,26,1,20732,21774,19055,-2719
2015,7,26,2,20784,21619,18786,-2833
2015,7,26,3,19983,20700,17673,-3027
2015,7,26,4,18812,19497,16494,-3003
2015,7,26,5,17358,18314,15127,-3187
2015,7,26,6,16627,17368,14530,-2838
2015,7,26,7,15969,16694,13805,-2889
2015,7,26,8,15535,16244,13370,-2874
2015,7,26,9,15268,16001,13302,-2699
2015,7,26,10,14891,15951,13481,-2470
2015,7,26,11,15056,16007,13491,-2516
2015,7,26,12,15664,16711,13640,-3071
2015,7,26,13,16970,17934,15323,-2611
2015,7,26,14,18407,19368,16471,-2897
2015,7,26,15,19695,20708,17382,-3326
2015,7,26,16,20665,21810,18559,-3251
2015,7,26,17,21362,22705,19756,-2949
2015,7,26,18,21856,23434,20308,-3126
2015,7,26,19,22221,23936,20733,-3203
2015,7,26,20,22599,24206,20672,-3534
2015,7,26,21,22984,24360,21097,-3263
2015,7,26,22,23118,24389,21081,-3308
2015,7,26,23,22846,23862,20422,-3440
2015,7,27,0,22195,23424,20201,-3223
2015,7,27,1,21924,23420,20034,-3386
2015,7,27,2,21901,23103,19723,-3380
2015,7,27,3,20813,21752,18093,-3659
2015,7,27,4,19353,20232,17129,-3103
2015,7,27,5,17933,18901,15845,-3056
2015,7,27,6,17347,18017,15079,-2938
2015,7,27,7,16945,17423,14551,-2872
2015,7,27,8,16694,17098,13841,-3257
2015,7,27,9,16607,17160,14047,-3113
2015,7,27,10,16996,17887,14429,-3458
2015,7,27,11,18252,19037,15631,-3406
2015,7,27,12,19962,20720,17002,-3718
2015,7,27,13,21563,22241,18727,-3514
2015,7,27,14,22830,23602,20040,-3562
2015,7,27,15,23857,24698,20766,-3932
2015,7,27,16,24624,25622,21485,-4137
2015,7,27,17,25159,26406,22265,-4141
2015,7,27,18,25620,27154,23139,-4015
2015,7,27,19,26001,27711,23670,-4041
2015,7,27,20,26385,28106,24236,-3870
2015,7,27,21,26691,28345,24524,-3821
2015,7,27,22,26704,28276,24467,-3809
2015,7,27,23,26099,27555,23468,-4087
2015,7,28,0,25211,26649,22524,-4125
2015,7,28,1,24587,26042,22090,-3952
2015,7,28,2,24194,25460,21857,-3603
2015,7,28,3,22738,23726,20466,-3260
2015,7,28,4,20897,21760,18433,-3327
2015,7,28,5,18994,20143,16275,-3868
2015,7,28,6,18132,19034,15111,-3923
2015,7,28,7,17742,18285,14428,-3857
2015,7,28,8,17490,17813,14199,-3614
2015,7,28,9,17359,17765,14177,-3588
2015,7,28,10,17629,18380,14751,-3629
2015,7,28,11,18895,19645,16302,-3343
2015,7,28,12,20733,21638,18173,-3465
2015,7,28,13,22486,23515,19907,-3608
2015,7,28,14,23831,25164,21763,-3401
2015,7,28,15,25033,26621,23338,-3283
2015,7,28,16,25951,27746,24601,-3145
2015,7,28,17,26664,28524,25297,-3227
2015,7,28,18,27279,29215,25980,-3235
2015,7,28,19,27777,29742,26469,-3273
2015,7,28,20,28216,30148,27063,-3085
2015,7,28,21,28518,30434,27388,-3046
2015,7,28,22,28449,30278,27361,-2917
2015,7,28,23,27654,29510,26874,-2636
2015,7,29,0,26696,28442,26061,-2381
2015,7,29,1,25997,27741,25022,-2719
2015,7,29,2,25478,27077,24115,-2962
2015,7,29,3,23921,25258,21899,-3359
2015,7,29,4,21923,23174,19197,-3977
2015,7,29,5,20315,21427,17950,-3477
2015,7,29,6,19455,20162,16689,-3473
2015,7,29,7,18979,19264,15370,-3894
2015,7,29,8,18660,18721,15044,-3677
2015,7,29,9,18488,18622,14949,-3673
2015,7,29,10,18751,19144,15906,-3238
2015,7,29,11,20024,20312,17285,-3027
2015,7,29,12,21903,22279,19078,-3201
2015,7,29,13,23689,24149,21001,-3148
2015,7,29,14,25158,25870,22796,-3074
2015,7,29,15,26489,27446,24290,-3156
2015,7,29,16,27546,28617,25668,-2949
2015,7,29,17,28348,29451,26972,-2479
2015,7,29,18,29068,30211,28039,-2172
2015,7,29,19,29699,30687,28432,-2255
2015,7,29,20,30213,30938,28656,-2282
2015,7,29,21,30493,31138,29210,-1928
2015,7,29,22,30451,30975,28981,-1994
2015,7,29,23,29705,30354,27926,-2428
2015,7,30,0,28701,29427,26744,-2683
2015,7,30,1,27841,28851,25829,-3022
2015,7,30,2,27294,28245,25421,-2824
2015,7,30,3,25617,26387,23252,-3135
2015,7,30,4,23571,24267,20763,-3504
2015,7,30,5,21702,22465,19238,-3227
2015,7,30,6,20382,21222,17944,-3278
2015,7,30,7,19747,20389,16905,-3484
2015,7,30,8,19357,19934,16445,-3489
2015,7,30,9,19238,19906,16476,-3430
2015,7,30,10,19717,20510,17386,-3124
2015,7,30,11,20913,21763,18696,-3067
2015,7,30,12,22738,23507,20659,-2848
2015,7,30,13,24409,24969,22338,-2631
2015,7,30,14,25744,26030,23497,-2533
2015,7,30,15,26893,26908,24732,-2176
2015,7,30,16,27730,27686,25635,-2051
2015,7,30,17,28330,28307,26601,-1706
2015,7,30,18,28812,28722,27048,-1674
2015,7,30,19,29143,28775,27252,-1523
2015,7,30,20,29429,28435,27491,-944
2015,7,30,21,29570,28035,27542,-493
2015,7,30,22,29477,27532,27120,-412
2015,7,30,23,28709,26886,26274,-612
2015,7,31,0,27679,26131,25185,-946
2015,7,31,1,26812,25682,24924,-758
2015,7,31,2,26320,25224,24075,-1149
2015,7,31,3,24726,23679,21824,-1855
2015,7,31,4,22741,21879,19503,-2376
2015,7,31,5,20797,20324,17601,-2723
2015,7,31,6,19293,19228,16632,-2596
2015,7,31,7,18560,18417,15829,-2588
2015,7,31,8,18147,17863,15432,-2431
2015,7,31,9,18003,17689,15410,-2279
2015,7,31,10,18471,18033,15644,-2389
2015,7,31,11,19375,19022,16400,-2622
2015,7,31,12,21001,20802,18181,-2621
2015,7,31,13,22537,22411,19684,-2727
2015,7,31,14,23773,23711,21290,-2421
2015,7,31,15,24869,24823,22578,-2245
2015,7,31,16,25705,25626,23345,-2281
2015,7,31,17,26294,26210,23831,-2379
2015,7,31,18,26854,26774,24328,-2446
2015,7,31,19,27305,27175,24470,-2705
2015,7,31,20,27649,27497,24707,-2790
2015,7,31,21,27823,27615,24902,-2713
2015,7,31,22,27727,27371,24726,-2645
2015,7,31,23,26874,26468,24039,-2429
2015,8,1,0,25903,25350,22946,-2404
2015,8,1,1,25210,24549,22217,-2332
2015,8,1,2,24843,23935,21416,-2519
2015,8,1,3,23642,22526,19531,-2995
2015,8,1,4,22040,20894,17759,-3135
2015,8,1,5,20476,19452,16091,-3361
2015,8,1,6,18640,18358,15127,-3231
2015,8,1,7,17694,17554,14163,-3391
2015,8,1,8,17025,17033,13784,-3249
2015,8,1,9,16689,16778,13784,-2994
2015,8,1,10,16428,16771,13764,-3007
2015,8,1,11,16442,16946,14122,-2824
2015,8,1,12,17177,18018,15092,-2926
2015,8,1,13,18677,19623,16588,-3035
2015,8,1,14,20194,21130,18084,-3046
2015,8,1,15,21499,22305,19043,-3262
2015,8,1,16,22396,22994,20222,-2772
2015,8,1,17,22938,23543,20720,-2823
2015,8,1,18,23288,23730,21177,-2553
2015,8,1,19,23531,23880,21506,-2374
2015,8,1,20,23732,24044,21536,-2508
2015,8,1,21,23810,24132,21062,-3070
2015,8,1,22,23800,24034,21043,-2991
2015,8,1,23,23384,23565,20915,-2650
2015,8,2,0,22636,22843,19757,-3086
2015,8,2,1,22319,22465,19297,-3168
2015,8,2,2,22293,22106,19053,-3053
2015,8,2,3,21375,20959,18041,-2918
2015,8,2,4,20172,19550,16632,-2918
2015,8,2,5,18561,18278,15131,-3147
2015,8,2,6,17470,17302,14294,-3008
2015,8,2,7,16563,16564,13734,-2830
2015,8,2,8,15945,16039,13732,-2307
2015,8,2,9,15625,15703,13591,-2112
2015,8,2,10,15280,15535,13376,-2159
2015,8,2,11,15170,15494,13337,-2157
2015,8,2,12,15652,16421,13925,-2496
2015,8,2,13,16926,17877,15010,-2867
2015,8,2,14,18325,19320,16551,-2769
2015,8,2,15,19627,20658,17478,-3180
2015,8,2,16,20618,21605,18434,-3171
2015,8,2,17,21325,22316,19022,-3294
2015,8,2,18,21879,22840,19196,-3644
2015,8,2,19,22337,23228,19947,-3281
2015,8,2,20,22679,23678,20515,-3163
2015,8,2,21,22881,24107,20895,-3212
2015,8,2,22,23036,24325,20724,-3601
2015,8,2,23,22707,24028,20524,-3504
2015,8,3,0,22231,23448,20037,-3411
2015,8,3,1,22179,23438,19731,-3707
2015,8,3,2,22134,23242,19872,-3370
2015,8,3,3,21142,22185,18741,-3444
2015,8,3,4,19796,20654,17179,-3475
2015,8,3,5,18447,19395,16046,-3349
2015,8,3,6,17606,18419,15664,-2755
2015,8,3,7,17108,17758,15824,-1934
2015,8,3,8,16788,17432,15411,-2021
2015,8,3,9,16742,17440,15516,-1924
2015,8,3,10,17303,18039,15643,-2396
2015,8,3,11,18245,19231,15996,-3235
2015,8,3,12,19915,21058,17538,-3520
2015,8,3,13,21633,22714,18829,-3885
2015,8,3,14,23008,24032,20369,-3663
2015,8,3,15,24223,25138,21459,-3679
2015,8,3,16,25189,25968,22141,-3827
2015,8,3,17,25833,26658,22714,-3944
2015,8,3,18,26439,27369,23723,-3646
2015,8,3,19,26859,27851,23977,-3874
2015,8,3,20,27102,28119,24477,-3642
2015,8,3,21,27125,28275,24415,-3860
2015,8,3,22,26998,27957,25025,-2932
2015,8,3,23,26383,27046,24409,-2637
2015,8,4,0,25514,26177,23515,-2662
2015,8,4,1,24939,25789,22915,-2874
2015,8,4,2,24467,25188,22009,-3179
2015,8,4,3,22962,23519,20237,-3282
2015,8,4,4,21191,21703,17878,-3825
2015,8,4,5,19331,20199,16272,-3927
2015,8,4,6,18501,19198,15747,-3451
2015,8,4,7,17916,18545,15708,-2837
2015,8,4,8,17556,18219,15538,-2681
2015,8,4,9,17505,17811,15190,-2621
2015,8,4,10,18079,18155,15347,-2808
2015,8,4,11,18846,19231,15992,-3239
2015,8,4,12,20363,20714,17388,-3326
2015,8,4,13,21908,22064,18536,-3528
2015,8,4,14,23140,23436,19601,-3835
2015,8,4,15,24189,24716,20898,-3818
2015,8,4,16,24965,25664,21889,-3775
2015,8,4,17,25459,26354,23061,-3293
2015,8,4,18,25896,26994,24205,-2789
2015,8,4,19,26180,27356,24043,-3313
2015,8,4,20,26355,27533,23786,-3747
2015,8,4,21,26381,27615,24201,-3414
2015,8,4,22,26266,27289,23910,-3379
2015,8,4,23,25601,26398,23067,-3331
2015,8,5,0,24756,25371,21956,-3415
2015,8,5,1,24294,24885,21629,-3256
2015,8,5,2,23901,24127,21040,-3087
2015,8,5,3,22512,22388,18817,-3571
2015,8,5,4,20793,20524,16743,-3781
2015,8,5,5,19545,19066,15702,-3364
2015,8,5,6,18236,17966,14957,-3009
2015,8,5,7,17427,17202,14438,-2764
2015,8,5,8,16917,16832,14378,-2454
2015,8,5,9,16815,16736,14638,-2098
2015,8,5,10,17534,17255,14497,-2758
2015,8,5,11,18147,18364,15141,-3223
2015,8,5,12,19600,19965,16200,-3765
2015,8,5,13,21024,21273,17444,-3829
2015,8,5,14,22118,22411,18820,-3591
2015,8,5,15,23052,23415,20264,-3151
2015,8,5,16,23700,24147,21316,-2831
2015,8,5,17,24084,24663,21783,-2880
2015,8,5,18,24488,25109,22442,-2667
2015,8,5,19,24679,25419,23000,-2419
2015,8,5,20,24812,25656,23607,-2049
2015,8,5,21,24854,25757,23624,-2133
2015,8,5,22,24746,25405,23254,-2151
2015,8,5,23,24151,24504,22528,-1976
2015,8,6,0,23329,23639,21521,-2118
2015,8,6,1,22927,23211,21131,-2080
2015,8,6,2,22548,22673,20508,-2165
2015,8,6,3,21266,21134,18867,-2267
2015,8,6,4,19660,19395,16714,-2681
2015,8,6,5,18417,17921,15058,-2863
2015,8,6,6,17201,16881,14055,-2826
2015,8,6,7,16394,16190,13246,-2944
2015,8,6,8,15760,15755,12741,-3014
2015,8,6,9,15681,15730,12945,-2785
2015,8,6,10,16454,16244,13628,-2616
2015,8,6,11,17032,17298,14398,-2900
2015,8,6,12,18437,18926,16075,-2851
2015,8,6,13,19779,20237,17411,-2826
2015,8,6,14,20766,21291,18383,-2908
2015,8,6,15,21637,22071,19375,-2696
2015,8,6,16,22219,22622,19790,-2832
2015,8,6,17,22597,22952,19714,-3238
2015,8,6,18,22984,23376,20570,-2806
2015,8,6,19,23251,23748,20888,-2860
2015,8,6,20,23433,24013,21065,-2948
2015,8,6,21,23551,24049,21252,-2797
2015,8,6,22,23496,23738,21164,-2574
2015,8,6,23,22918,22971,20583,-2388
2015,8,7,0,22246,22308,19971,-2337
2015,8,7,1,22007,22222,19802,-2420
2015,8,7,2,21751,21708,19407,-2301
2015,8,7,3,20582,20394,17986,-2408
2015,8,7,4,19161,18875,16101,-2774
2015,8,7,5,17507,17592,14682,-2910
2015,8,7,6,16699,16677,14137,-2540
2015,8,7,7,16026,16056,13618,-2438
2015,8,7,8,15477,15636,12969,-2667
2015,8,7,9,15410,15611,12945,-2666
2015,8,7,10,16127,16151,13807,-2344
2015,8,7,11,16711,17135,14457,-2678
2015,8,7,12,18067,18750,15945,-2805
2015,8,7,13,19376,20155,17951,-2204
2015,8,7,14,20391,21306,18933,-2373
2015,8,7,15,21203,22178,20084,-2094
2015,8,7,16,21790,22793,20693,-2100
2015,8,7,17,22190,23160,21077,-2083
2015,8,7,18,22557,23519,21333,-2186
2015,8,7,19,22761,23734,21335,-2399
2015,8,7,20,22817,23957,21401,-2556
2015,8,7,21,22841,24098,21513,-2585
2015,8,7,22,22656,23931,21078,-2853
2015,8,7,23,21958,23152,20401,-2751
2015,8,8,0,21163,22244,19913,-2331
2015,8,8,1,20833,21809,19541,-2268
2015,8,8,2,20577,21207,18943,-2264
2015,8,8,3,19533,19937,17609,-2328
2015,8,8,4,18244,18465,16010,-2455
2015,8,8,5,17002,17221,14152,-3069
2015,8,8,6,16236,16240,13631,-2609
2015,8,8,7,15554,15589,12990,-2599
2015,8,8,8,14912,15162,12870,-2292
2015,8,8,9,14605,14995,12577,-2418
2015,8,8,10,14310,15079,12869,-2210
2015,8,8,11,14496,15321,13006,-2315
2015,8,8,12,15166,16261,13851,-2410
2015,8,8,13,16464,17522,15292,-2230
2015,8,8,14,17813,18674,16332,-2342
2015,8,8,15,18955,19580,17634,-1946
2015,8,8,16,19708,20141,18284,-1857
2015,8,8,17,20182,20412,18342,-2070
2015,8,8,18,20512,20591,18835,-1756
2015,8,8,19,20727,20806,19081,-1725
2015,8,8,20,20896,20945,19399,-1546
2015,8,8,21,21019,20977,19397,-1580
2015,8,8,22,20997,20761,18903,-1858
2015,8,8,23,20551,20330,18741,-1589
2015,8,9,0,19885,19942,18295,-1647
2015,8,9,1,19776,20071,18447,-1624
2015,8,9,2,19676,19843,17872,-1971
2015,8,9,3,18813,18932,16663,-2269
2015,8,9,4,17722,17859,15517,-2342
2015,8,9,5,16419,16921,14984,-1937
2015,8,9,6,15851,16114,14044,-2070
2015,8,9,7,15226,15454,13318,-2136
2015,8,9,8,14582,15023,12732,-2291
2015,8,9,9,14275,14804,12891,-1913
2015,8,9,10,13873,14789,12872,-1917
2015,8,9,11,13994,14813,12865,-1948
2015,8,9,12,14504,15612,13962,-1650
2015,8,9,13,15727,16873,14889,-1984
2015,8,9,14,17083,17929,16073,-1856
2015,8,9,15,18292,18919,16485,-2434
2015,8,9,16,19159,19693,17459,-2234
2015,8,9,17,19737,20263,17971,-2292
2015,8,9,18,20159,20675,17931,-2744
2015,8,9,19,20542,21019,18656,-2363
2015,8,9,20,20823,21275,18950,-2325
2015,8,9,21,21108,21640,19211,-2429
2015,8,9,22,21255,21862,19454,-2408
2015,8,9,23,20870,21637,19663,-1974
2015,8,10,0,20303,21055,19004,-2051
2015,8,10,1,20297,21102,19033,-2069
2015,8,10,2,20155,20825,18912,-1913
2015,8,10,3,19080,19653,17273,-2380
2015,8,10,4,17767,18273,15768,-2505
2015,8,10,5,16307,17148,14700,-2448
2015,8,10,6,15786,16354,14269,-2085
2015,8,10,7,15501,15865,13660,-2205
2015,8,10,8,15181,15638,13238,-2400
2015,8,10,9,15127,15759,13747,-2012
2015,8,10,10,15546,16469,14516,-1953
2015,8,10,11,16675,17612,15539,-2073
2015,8,10,12,18339,19337,17080,-2257
2015,8,10,13,19913,20818,18463,-2355
2015,8,10,14,21139,22053,19717,-2336
2015,8,10,15,22123,23015,20485,-2530
2015,8,10,16,22861,23753,21011,-2742
2015,8,10,17,23352,24268,21484,-2784
2015,8,10,18,23818,24751,21671,-3080
2015,8,10,19,24144,24992,21882,-3110
2015,8,10,20,24376,25010,21790,-3220
2015,8,10,21,24568,24793,21642,-3151
2015,8,10,22,24509,24351,21355,-2996
2015,8,10,23,23836,23578,21010,-2568
2015,8,11,0,23051,23003,20515,-2488
2015,8,11,1,22704,22913,20641,-2272
2015,8,11,2,22163,22192,20036,-2156
2015,8,11,3,20720,20843,18718,-2125
2015,8,11,4,19028,19391,16808,-2583
2015,8,11,5,17679,18180,15673,-2507
2015,8,11,6,16964,17332,14958,-2374
2015,8,11,7,16653,16821,14812,-2009
2015,8,11,8,16278,16582,14372,-2210
2015,8,11,9,16205,16710,14551,-2159
2015,8,11,10,16762,17473,15207,-2266
2015,8,11,11,18020,18858,16522,-2336
2015,8,11,12,19621,20263,17568,-2695
2015,8,11,13,20981,21337,18748,-2589
2015,8,11,14,21992,22141,19467,-2674
2015,8,11,15,22791,22734,20288,-2446
2015,8,11,16,23334,23085,20761,-2324
2015,8,11,17,23589,23339,20983,-2356
2015,8,11,18,23820,23695,20919,-2776
2015,8,11,19,23929,23927,21354,-2573
2015,8,11,20,24017,24301,21913,-2388
2015,8,11,21,24138,24598,22132,-2466
2015,8,11,22,24119,24494,22024,-2470
2015,8,11,23,23468,23972,21441,-2531
2015,8,12,0,22813,23335,20676,-2659
2015,8,12,1,22620,23100,20410,-2690
2015,8,12,2,22132,22453,19988,-2465
2015,8,12,3,20728,21034,18627,-2407
2015,8,12,4,19059,19433,16685,-2748
2015,8,12,5,17389,18019,14815,-3204
2015,8,12,6,16915,17012,14208,-2804
2015,8,12,7,16543,16347,13783,-2564
2015,8,12,8,16123,16014,13713,-2301
2015,8,12,9,16035,15978,13565,-2413
2015,8,12,10,16498,16575,13964,-2611
2015,8,12,11,17591,17740,14698,-3042
2015,8,12,12,19135,19383,16134,-3249
2015,8,12,13,20470,20740,17298,-3442
2015,8,12,14,21455,21766,18231,-3535
2015,8,12,15,22289,22630,19339,-3291
2015,8,12,16,22875,23279,19955,-3324
2015,8,12,17,23196,23675,20181,-3494
2015,8,12,18,23538,24119,20850,-3269
2015,8,12,19,23819,24496,21363,-3133
2015,8,12,20,23921,24767,21763,-3004
2015,8,12,21,24080,24960,21959,-3001
2015,8,12,22,24014,24761,21846,-2915
2015,8,12,23,23351,23909,20862,-3047
2015,8,13,0,22545,23054,20032,-3022
2015,8,13,1,22251,22841,19879,-2962
2015,8,13,2,21778,22151,19307,-2844
2015,8,13,3,20448,20659,17421,-3238
2015,8,13,4,18808,18958,15670,-3288
2015,8,13,5,17419,17524,14345,-3179
2015,8,13,6,16384,16522,13726,-2796
2015,8,13,7,15868,15850,13094,-2756
2015,8,13,8,15559,15455,12497,-2958
2015,8,13,9,15473,15436,12587,-2849
2015,8,13,10,16036,16027,13681,-2346
2015,8,13,11,16953,17119,14117,-3002
2015,8,13,12,18456,18768,15706,-3062
2015,8,13,13,19777,20149,17044,-3105
2015,8,13,14,20745,21224,17784,-3440
2015,8,13,15,21558,22063,18675,-3388
2015,8,13,16,22134,22671,19392,-3279
2015,8,13,17,22499,23126,19563,-3563
2015,8,13,18,22857,23553,20032,-3521
2015,8,13,19,23182,23872,20553,-3319
2015,8,13,20,23412,24178,20996,-3182
2015,8,13,21,23540,24374,21322,-3052
2015,8,13,22,23443,24262,21312,-2950
2015,8,13,23,22769,23550,20680,-2870
2015,8,14,0,22064,22631,19349,-3282
2015,8,14,1,21880,22455,19181,-3274
2015,8,14,2,21419,21784,18404,-3380
2015,8,14,3,20154,20359,17022,-3337
2015,8,14,4,18630,18706,15401,-3305
2015,8,14,5,17436,17390,14377,-3013
2015,8,14,6,16318,16500,14049,-2451
2015,8,14,7,15835,15859,13563,-2296
2015,8,14,8,15533,15495,13121,-2374
2015,8,14,9,15475,15455,13132,-2323
2015,8,14,10,15911,16028,13590,-2438
2015,8,14,11,16951,17146,14477,-2669
2015,8,14,12,18512,18756,16010,-2746
2015,8,14,13,20050,20340,17175,-3165
2015,8,14,14,21231,21588,18004,-3584
2015,8,14,15,22226,22525,19109,-3416
2015,8,14,16,23011,23311,19772,-3539
2015,8,14,17,23533,24014,20372,-3642
2015,8,14,18,24079,24699,21359,-3340
2015,8,14,19,24523,25214,21916,-3298
2015,8,14,20,24851,25560,22242,-3318
2015,8,14,21,24983,25722,22357,-3365
2015,8,14,22,24734,25386,22530,-2856
2015,8,14,23,23916,24506,21464,-3042
2015,8,15,0,23040,23570,20569,-3001
2015,8,15,1,22655,23355,20614,-2741
2015,8,15,2,22166,22668,19676,-2992
2015,8,15,3,20985,21361,17771,-3590
2015,8,15,4,19521,19928,15933,-3995
2015,8,15,5,18299,18584,14683,-3901
2015,8,15,6,17211,17565,14250,-3315
2015,8,15,7,16576,16873,13591,-3282
2015,8,15,8,16080,16390,13360,-3030
2015,8,15,9,15825,16152,12845,-3307
2015,8,15,10,15611,16186,12833,-3353
2015,8,15,11,16073,16380,13600,-2780
2015,8,15,12,16809,17416,14704,-2712
2015,8,15,13,18200,18943,15974,-2969
2015,8,15,14,19803,20483,16824,-3659
2015,8,15,15,21212,21908,18034,-3874
2015,8,15,16,22242,23026,19317,-3709
2015,8,15,17,22912,23865,20346,-3519
2015,8,15,18,23442,24472,21381,-3091
2015,8,15,19,23843,24864,21666,-3198
2015,8,15,20,24186,25216,21835,-3381
2015,8,15,21,24393,25348,22145,-3203
2015,8,15,22,24303,25157,22064,-3093
2015,8,15,23,23795,24573,21545,-3028
2015,8,16,0,23091,23791,20777,-3014
2015,8,16,1,22804,23689,20172,-3517
2015,8,16,2,22466,23127,19734,-3393
2015,8,16,3,21357,22013,18264,-3749
2015,8,16,4,20071,20633,17035,-3598
2015,8,16,5,18506,19344,15262,-4082
2015,8,16,6,17780,18325,14136,-4189
2015,8,16,7,17106,17562,13338,-4224
2015,8,16,8,16619,17056,13045,-4011
2015,8,16,9,16312,16702,12918,-3784
2015,8,16,10,15922,16633,13026,-3607
2015,8,16,11,16245,16602,13562,-3040
2015,8,16,12,16838,17343,14110,-3233
2015,8,16,13,18248,18874,15401,-3473
2015,8,16,14,19968,20395,16517,-3878
2015,8,16,15,21581,21893,17671,-4222
2015,8,16,16,22836,23256,18754,-4502
2015,8,16,17,23728,24356,19870,-4486
2015,8,16,18,24369,25058,20929,-4129
2015,8,16,19,24898,25434,21285,-4149
2015,8,16,20,25346,25568,21750,-3818
2015,8,16,21,25673,25797,21710,-4087
2015,8,16,22,25735,25910,22032,-3878
2015,8,16,23,25399,25579,21844,-3735
2015,8,17,0,24668,24943,21215,-3728
2015,8,17,1,24345,25040,21504,-3536
2015,8,17,2,23871,24422,20777,-3645
2015,8,17,3,22455,23024,18650,-4374
2015,8,17,4,20825,21380,16643,-4737
2015,8,17,5,19098,20047,15567,-4480
2015,8,17,6,18488,19083,15395,-3688
2015,8,17,7,18090,18392,14804,-3588
2015,8,17,8,17850,18006,14030,-3976
2015,8,17,9,17773,18001,13850,-4151
2015,8,17,10,18137,18640,14934,-3706
2015,8,17,11,19545,19771,15954,-3817
2015,8,17,12,21345,21550,17926,-3624
2015,8,17,13,23156,23263,19637,-3626
2015,8,17,14,24639,24967,21351,-3616
2015,8,17,15,25929,26555,22682,-3873
2015,8,17,16,26974,27874,24351,-3523
2015,8,17,17,27741,28941,25582,-3359
2015,8,17,18,28398,29758,26426,-3332
2015,8,17,19,28963,30171,26984,-3187
2015,8,17,20,29382,30382,26663,-3719
2015,8,17,21,29600,30543,26826,-3717
2015,8,17,22,29443,30408,27016,-3392
2015,8,17,23,28752,29558,26446,-3112
2015,8,18,0,27726,28526,25604,-2922
2015,8,18,1,27024,28192,25218,-2974
2015,8,18,2,26299,27047,23734,-3313
2015,8,18,3,24574,25090,21660,-3430
2015,8,18,4,22683,23013,19501,-3512
2015,8,18,5,21224,21303,17373,-3930
2015,8,18,6,19925,20146,16093,-4053
2015,8,18,7,19327,19320,15491,-3829
2015,8,18,8,18996,18827,14754,-4073
2015,8,18,9,18884,18775,14968,-3807
2015,8,18,10,19308,19397,15739,-3658
2015,8,18,11,20561,20535,16895,-3640
2015,8,18,12,22251,22236,18015,-4221
2015,8,18,13,23961,23886,20147,-3739
2015,8,18,14,25328,25333,21697,-3636
2015,8,18,15,26478,26807,23495,-3312
2015,8,18,16,27383,28084,24120,-3964
2015,8,18,17,28062,28830,24726,-4104
2015,8,18,18,28644,29381,25583,-3798
2015,8,18,19,29044,29569,26208,-3361
2015,8,18,20,29336,29536,26419,-3117
2015,8,18,21,29495,29354,26765,-2589
2015,8,18,22,29265,29075,26448,-2627
2015,8,18,23,28471,28174,26016,-2158
2015,8,19,0,27465,27298,24875,-2423
2015,8,19,1,26808,27066,24240,-2826
2015,8,19,2,26083,26082,23242,-2840
2015,8,19,3,24454,24277,21246,-3031
2015,8,19,4,22609,22419,19076,-3343
2015,8,19,5,20793,20864,16461,-4403
2015,8,19,6,19692,19829,15608,-4221
2015,8,19,7,19208,19112,15291,-3821
2015,8,19,8,18902,18763,15495,-3268
2015,8,19,9,18797,18747,15282,-3465
2015,8,19,10,19106,19433,15747,-3686
2015,8,19,11,20410,20758,16885,-3873
2015,8,19,12,22073,22443,18190,-4253
2015,8,19,13,23718,24142,19223,-4919
2015,8,19,14,25038,25572,20913,-4659
2015,8,19,15,26105,26831,22255,-4576
2015,8,19,16,26980,27784,23828,-3956
2015,8,19,17,27660,28467,24447,-4020
2015,8,19,18,28224,29038,25182,-3856
2015,8,19,19,28503,29371,25747,-3624
2015,8,19,20,28744,29550,25729,-3821
2015,8,19,21,28921,29417,25494,-3923
2015,8,19,22,28749,29038,25329,-3709
2015,8,19,23,27978,28259,24405,-3854
2015,8,20,0,26995,27482,23160,-4322
2015,8,20,1,26459,27382,22886,-4496
2015,8,20,2,25827,26473,22305,-4168
2015,8,20,3,24286,24816,20713,-4103
2015,8,20,4,22510,22911,18629,-4282
2015,8,20,5,20681,21428,17441,-3987
2015,8,20,6,19539,20367,16959,-3408
2015,8,20,7,18919,19664,16420,-3244
2015,8,20,8,18541,19289,15542,-3747
2015,8,20,9,18483,19294,15465,-3829
2015,8,20,10,19046,20026,16261,-3765
2015,8,20,11,20193,21273,17470,-3803
2015,8,20,12,21839,22931,18462,-4469
2015,8,20,13,23388,24559,19900,-4659
2015,8,20,14,24603,26003,21735,-4268
2015,8,20,15,25609,27092,23405,-3687
2015,8,20,16,26393,27878,24101,-3777
2015,8,20,17,26994,28276,24310,-3966
2015,8,20,18,27463,28581,24154,-4427
2015,8,20,19,27653,28651,23939,-4712
2015,8,20,20,27786,28557,23905,-4652
2015,8,20,21,27922,28382,23764,-4618
2015,8,20,22,27741,27780,23242,-4538
2015,8,20,23,26992,26823,22824,-3999
2015,8,21,0,26099,26281,22107,-4174
2015,8,21,1,25621,26053,22225,-3828
2015,8,21,2,25000,25248,21208,-4040
2015,8,21,3,23463,23722,19497,-4225
2015,8,21,4,21719,21992,18143,-3849
2015,8,21,5,20142,20554,16560,-3994
2015,8,21,6,18918,19449,15244,-4205
2015,8,21,7,18224,18694,14686,-4008
2015,8,21,8,17809,18251,14772,-3479
2015,8,21,9,17732,18164,14957,-3207
2015,8,21,10,18348,18694,15725,-2969
2015,8,21,11,19231,19721,16474,-3247
2015,8,21,12,20603,20866,17559,-3307
2015,8,21,13,21929,21935,18487,-3448
2015,8,21,14,22969,22662,19442,-3220
2015,8,21,15,23830,23389,20266,-3123
2015,8,21,16,24521,23995,20353,-3642
2015,8,21,17,24987,24348,20722,-3626
2015,8,21,18,25308,24739,21022,-3717
2015,8,21,19,25371,25071,21428,-3643
2015,8,21,20,25331,25316,22050,-3266
2015,8,21,21,25329,25483,22306,-3177
2015,8,21,22,25121,25315,22169,-3146
2015,8,21,23,24369,24507,21329,-3178
2015,8,22,0,23581,23683,20401,-3282
2015,8,22,1,23283,23461,20101,-3360
2015,8,22,2,22788,22589,19087,-3502
2015,8,22,3,21630,21160,17290,-3870
2015,8,22,4,20281,19594,15844,-3750
2015,8,22,5,19507,18204,14617,-3587
2015,8,22,6,17983,17186,14025,-3161
2015,8,22,7,16899,16476,13875,-2601
2015,8,22,8,16191,15927,12934,-2993
2015,8,22,9,15868,15617,12558,-3059
2015,8,22,10,15676,15631,12390,-3241
2015,8,22,11,15747,15762,12922,-2840
2015,8,22,12,16312,16471,13680,-2791
2015,8,22,13,17609,17834,14632,-3202
2015,8,22,14,18969,18983,15970,-3013
2015,8,22,15,20132,19856,16825,-3031
2015,8,22,16,20934,20498,17289,-3209
2015,8,22,17,21515,20976,17970,-3006
2015,8,22,18,21892,21279,17974,-3305
2015,8,22,19,22097,21591,18587,-3004
2015,8,22,20,22236,21832,18702,-3130
2015,8,22,21,22360,21990,18540,-3450
2015,8,22,22,22328,22004,18539,-3465
2015,8,22,23,21967,21586,17925,-3661
2015,8,23,0,21401,20930,17776,-3154
2015,8,23,1,21422,20932,17761,-3171
2015,8,23,2,21153,20274,17032,-3242
2015,8,23,3,20252,19213,16109,-3104
2015,8,23,4,19189,18020,14489,-3531
2015,8,23,5,17614,16962,13818,-3144
2015,8,23,6,16497,16168,13376,-2792
2015,8,23,7,15702,15594,12741,-2853
2015,8,23,8,15178,15254,11947,-3307
2015,8,23,9,14918,15117,12239,-2878
2015,8,23,10,14642,15187,12621,-2566
2015,8,23,11,14715,15240,12703,-2537
2015,8,23,12,15134,15944,13709,-2235
2015,8,23,13,16318,17070,14385,-2685
2015,8,23,14,17695,18284,15065,-3219
2015,8,23,15,18926,19368,15790,-3578
2015,8,23,16,19914,20268,16763,-3505
2015,8,23,17,20671,20996,17056,-3940
2015,8,23,18,21195,21610,17448,-4162
2015,8,23,19,21507,21955,17909,-4046
2015,8,23,20,21720,22239,18318,-3921
2015,8,23,21,21935,22613,18604,-4009
2015,8,23,22,22006,22867,18864,-4003
2015,8,23,23,21751,22644,18737,-3907
2015,8,24,0,21430,22290,18419,-3871
2015,8,24,1,21633,22605,18562,-4043
2015,8,24,2,21313,21972,17798,-4174
2015,8,24,3,20168,20782,16934,-3848
2015,8,24,4,18874,19465,15600,-3865
2015,8,24,5,17120,18290,14683,-3607
2015,8,24,6,16639,17491,14321,-3170
2015,8,24,7,16235,16939,13846,-3093
2015,8,24,8,16001,16693,13236,-3457
2015,8,24,9,15971,16794,13402,-3392
2015,8,24,10,16383,17514,14054,-3460
2015,8,24,11,17603,18783,15280,-3503
2015,8,24,12,19077,20318,16505,-3813
2015,8,24,13,20614,21796,17791,-4005
2015,8,24,14,21843,22980,19119,-3861
2015,8,24,15,22907,23957,20252,-3705
2015,8,24,16,23732,24825,21122,-3703
2015,8,24,17,24360,25366,21801,-3565
2015,8,24,18,24907,25903,22194,-3709
2015,8,24,19,25263,26222,22325,-3897
2015,8,24,20,25454,26451,22254,-4197
2015,8,24,21,25546,26483,22275,-4208
2015,8,24,22,25419,26230,22142,-4088
2015,8,24,23,24796,25313,21595,-3718
2015,8,25,0,24132,24584,20952,-3632
2015,8,25,1,23964,24564,21197,-3367
2015,8,25,2,23266,23598,20175,-3423
2015,8,25,3,21741,22024,18562,-3462
2015,8,25,4,20072,20228,16808,-3420
2015,8,25,5,18279,18850,14974,-3876
2015,8,25,6,17475,17985,14365,-3620
2015,8,25,7,16928,17363,14088,-3275
2015,8,25,8,16636,17111,14311,-2800
2015,8,25,9,16612,17179,13893,-3286
2015,8,25,10,17154,17941,14752,-3189
2015,8,25,11,18235,19245,15670,-3575
2015,8,25,12,19644,20704,17265,-3439
2015,8,25,13,21055,22159,18635,-3524
2015,8,25,14,22179,23338,19361,-3977
2015,8,25,15,23145,24435,20192,-4243
2015,8,25,16,23871,25206,20593,-4613
2015,8,25,17,24374,25865,21066,-4799
2015,8,25,18,24775,26460,21851,-4609
2015,8,25,19,24992,26848,22339,-4509
2015,8,25,20,25070,27026,22242,-4784
2015,8,25,21,25135,27036,22262,-4774
2015,8,25,22,25010,26747,22007,-4740
2015,8,25,23,24294,25789,21672,-4117
2015,8,26,0,23646,25062,21329,-3733
2015,8,26,1,23565,24754,21093,-3661
2015,8,26,2,22803,23558,19947,-3611
2015,8,26,3,21283,21700,17915,-3785
2015,8,26,4,19576,19726,15709,-4017
2015,8,26,5,18185,18162,14361,-3801
2015,8,26,6,17177,17092,13853,-3239
2015,8,26,7,16454,16360,13243,-3117
2015,8,26,8,16006,15918,13356,-2562
2015,8,26,9,15941,15873,12869,-3004
2015,8,26,10,16635,16475,13370,-3105
2015,8,26,11,17490,17576,14847,-2729
2015,8,26,12,18770,18993,16039,-2954
2015,8,26,13,19995,20261,16933,-3328
2015,8,26,14,20935,21261,17673,-3588
2015,8,26,15,21787,22023,18561,-3462
2015,8,26,16,22425,22553,19039,-3514
2015,8,26,17,22823,22990,19408,-3582
2015,8,26,18,23242,23450,19965,-3485
2015,8,26,19,23572,23758,20041,-3717
2015,8,26,20,23745,23823,20352,-3471
2015,8,26,21,23839,23794,20451,-3343
2015,8,26,22,23754,23475,20148,-3327
2015,8,26,23,23145,22702,19692,-3010
2015,8,27,0,22638,22181,19049,-3132
2015,8,27,1,22608,22146,18967,-3179
2015,8,27,2,21984,21222,17857,-3365
2015,8,27,3,20612,19767,16189,-3578
2015,8,27,4,19042,18235,14990,-3245
2015,8,27,5,17504,17003,13764,-3239
2015,8,27,6,16349,16169,12764,-3405
2015,8,27,7,15605,15592,11936,-3656
2015,8,27,8,15177,15295,11976,-3319
2015,8,27,9,15161,15309,12011,-3298
2015,8,27,10,15937,15938,12427,-3511
2015,8,27,11,16790,17050,13788,-3262
2015,8,27,12,18063,18453,15124,-3329
2015,8,27,13,19285,19780,17089,-2691
2015,8,27,14,20148,20732,17522,-3210
2015,8,27,15,20893,21426,17801,-3625
2015,8,27,16,21438,21890,18333,-3557
2015,8,27,17,21774,22103,18770,-3333
2015,8,27,18,22136,22160,18991,-3169
2015,8,27,19,22456,22299,19096,-3203
2015,8,27,20,22628,22374,19294,-3080
2015,8,27,21,22746,22368,19444,-2924
2015,8,27,22,22663,22291,19283,-3008
2015,8,27,23,22143,21647,18726,-2921
2015,8,28,0,21601,21136,18131,-3005
2015,8,28,1,21606,21159,18385,-2774
2015,8,28,2,21012,20288,17888,-2400
2015,8,28,3,19707,18880,15865,-3015
2015,8,28,4,18187,17449,14882,-2567
2015,8,28,5,16526,16203,13537,-2666
2015,8,28,6,15701,15383,12804,-2579
2015,8,28,7,15032,14847,12336,-2511
2015,8,28,8,14670,14587,11908,-2679
2015,8,28,9,14656,14613,11900,-2713
2015,8,28,10,15321,15231,12241,-2990
2015,8,28,11,16205,16361,13138,-3223
2015,8,28,12,17461,17741,14101,-3640
2015,8,28,13,18728,19012,15463,-3549
2015,8,28,14,19676,20069,16680,-3389
2015,8,28,15,20492,20848,17179,-3669
2015,8,28,16,21078,21360,17706,-3654
2015,8,28,17,21448,21652,18126,-3526
2015,8,28,18,21881,22008,17841,-4167
2015,8,28,19,22260,22279,18105,-4174
2015,8,28,20,22491,22520,18344,-4176
2015,8,28,21,22541,22692,18443,-4249
2015,8,28,22,22347,22480,18573,-3907
2015,8,28,23,21594,21761,17877,-3884
2015,8,29,0,20964,21141,17685,-3456
2015,8,29,1,20883,21035,18132,-2903
2015,8,29,2,20218,20190,17347,-2843
2015,8,29,3,19075,18976,15734,-3242
2015,8,29,4,17699,17625,13891,-3734
2015,8,29,5,16025,16348,13044,-3304
2015,8,29,6,15320,15469,12346,-3123
2015,8,29,7,14748,14901,11891,-3010
2015,8,29,8,14311,14560,11774,-2786
2015,8,29,9,14131,14412,11907,-2505
2015,8,29,10,13939,14553,12459,-2094
2015,8,29,11,14343,14861,12750,-2111
2015,8,29,12,14852,15661,13245,-2416
2015,8,29,13,16095,17006,14659,-2347
2015,8,29,14,17446,18248,15704,-2544
2015,8,29,15,18635,19242,16400,-2842
2015,8,29,16,19452,19975,16897,-3078
2015,8,29,17,20007,20416,17286,-3130
2015,8,29,18,20469,20700,17577,-3123
2015,8,29,19,20787,20998,18184,-2814
2015,8,29,20,21078,21313,18485,-2828
2015,8,29,21,21250,21578,18848,-2730
2015,8,29,22,21204,21556,18577,-2979
2015,8,29,23,20710,21088,18340,-2748
2015,8,30,0,20285,20739,18186,-2553
2015,8,30,1,20364,20902,17940,-2962
2015,8,30,2,19821,20240,17337,-2903
2015,8,30,3,18807,19268,16255,-3013
2015,8,30,4,17595,18190,15367,-2823
2015,8,30,5,16255,17103,13876,-3227
2015,8,30,6,15741,16246,12995,-3251
2015,8,30,7,15177,15689,12357,-3332
2015,8,30,8,14804,15282,11949,-3333
2015,8,30,9,14598,15077,12155,-2922
2015,8,30,10,14276,15119,12220,-2899
2015,8,30,11,14605,15224,12250,-2974
2015,8,30,12,14968,15814,12830,-2984
2015,8,30,13,16161,17117,14894,-2223
2015,8,30,14,17638,18446,16229,-2217
2015,8,30,15,18971,19736,17218,-2518
2015,8,30,16,20031,20912,18298,-2614
2015,8,30,17,20825,21855,18575,-3280
2015,8,30,18,21442,22552,18949,-3603
2015,8,30,19,21917,23100,19376,-3724
2015,8,30,20,22345,23385,19959,-3426
2015,8,30,21,22653,23452,20349,-3103
2015,8,30,22,22789,23441,20339,-3102
2015,8,30,23,22448,23156,20359,-2797
2015,8,31,0,21964,23129,20331,-2798
2015,8,31,1,21991,23430,20568,-2862
2015,8,31,2,21348,22707,19765,-2942
2015,8,31,3,20032,21525,18725,-2800
2015,8,31,4,18505,20059,17285,-2774
2015,8,31,5,17361,18811,16095,-2716
2015,8,31,6,16851,17918,15087,-2831
2015,8,31,7,16682,17400,14281,-3119
2015,8,31,8,16557,17097,14139,-2958
2015,8,31,9,16566,17167,13852,-3315
2015,8,31,10,16775,17995,14553,-3442
2015,8,31,11,18309,19299,15726,-3573
2015,8,31,12,19890,20823,17038,-3785
2015,8,31,13,21602,22397,18520,-3877
2015,8,31,14,23034,23702,20020,-3682
2015,8,31,15,24226,24878,20721,-4157
2015,8,31,16,25216,25842,21255,-4587
2015,8,31,17,25942,26597,22324,-4273
2015,8,31,18,26596,27384,23554,-3830
2015,8,31,19,27097,28060,23933,-4127
2015,8,31,20,27497,28433,24182,-4251
2015,8,31,21,27702,28661,24756,-3905
2015,8,31,22,27655,28426,24439,-3987
2015,8,31,23,27050,27582,24048,-3534
2015,9,1,0,26192,27035,23727,-3308
2015,9,1,1,25813,26879,23724,-3155
2015,9,1,2,24800,25681,22468,-3213
2015,9,1,3,23084,23847,20309,-3538
2015,9,1,4,21128,21904,18097,-3807
2015,9,1,5,19773,20324,16193,-4131
2015,9,1,6,18523,19189,15493,-3696
2015,9,1,7,18063,18396,14898,-3498
2015,9,1,8,17758,17925,13977,-3948
2015,9,1,9,17700,17879,14075,-3804
2015,9,1,10,18025,18497,14326,-4171
2015,9,1,11,19383,19828,15815,-4013
2015,9,1,12,20948,21282,17248,-4034
2015,9,1,13,22590,22711,18680,-4031
2015,9,1,14,23927,23975,20211,-3764
2015,9,1,15,25107,25153,21548,-3605
2015,9,1,16,26096,26070,22833,-3237
2015,9,1,17,26782,26776,23407,-3369
2015,9,1,18,27413,27398,24013,-3385
2015,9,1,19,27912,27853,24664,-3189
2015,9,1,20,28303,28205,24935,-3270
2015,9,1,21,28374,28425,25577,-2848
2015,9,1,22,28191,28136,25645,-2491
2015,9,1,23,27343,27104,24378,-2726
2015,9,2,0,26419,26349,23470,-2879
2015,9,2,1,26063,26067,23079,-2988
2015,9,2,2,24962,24727,21831,-2896
2015,9,2,3,23289,22898,19487,-3411
2015,9,2,4,21359,20971,17888,-3083
2015,9,2,5,19400,19455,16783,-2672
2015,9,2,6,18408,18383,15567,-2816
2015,9,2,7,18057,17706,15194,-2512
2015,9,2,8,17789,17301,14686,-2615
2015,9,2,9,17726,17318,14788,-2530
2015,9,2,10,17937,18071,15578,-2493
2015,9,2,11,19380,19472,16708,-2764
2015,9,2,12,20953,20917,18184,-2733
2015,9,2,13,22622,22329,19448,-2881
2015,9,2,14,24040,23724,21479,-2245
2015,9,2,15,25217,25027,22902,-2125
2015,9,2,16,26264,26215,24085,-2130
2015,9,2,17,26993,27176,24827,-2349
2015,9,2,18,27625,27968,25770,-2198
2015,9,2,19,28114,28630,26807,-1823
2015,9,2,20,28487,28978,27632,-1346
2015,9,2,21,28588,28961,27312,-1649
2015,9,2,22,28394,28479,26763,-1716
2015,9,2,23,27597,27439,25349,-2090
2015,9,3,0,26673,26854,24518,-2336
2015,9,3,1,26294,26646,24917,-1729
2015,9,3,2,25250,25384,23435,-1949
2015,9,3,3,23595,23567,20965,-2602
2015,9,3,4,21662,21697,18971,-2726
2015,9,3,5,19636,20134,17121,-3013
2015,9,3,6,18720,19098,15958,-3140
2015,9,3,7,18239,18377,15324,-3053
2015,9,3,8,17897,17947,14683,-3264
2015,9,3,9,17839,17904,14761,-3143
2015,9,3,10,18216,18593,15236,-3357
2015,9,3,11,19536,20048,16617,-3431
2015,9,3,12,21106,21509,18067,-3442
2015,9,3,13,22763,22921,19403,-3518
2015,9,3,14,24143,24212,20629,-3583
2015,9,3,15,25292,25471,22249,-3222
2015,9,3,16,26302,26582,23733,-2849
2015,9,3,17,27003,27564,24994,-2570
2015,9,3,18,27648,28516,25985,-2531
2015,9,3,19,28202,29176,26904,-2272
2015,9,3,20,28577,29401,27366,-2035
2015,9,3,21,28640,29420,27078,-2342
2015,9,3,22,28411,29082,26152,-2930
2015,9,3,23,27574,28065,25315,-2750
2015,9,4,0,26668,27559,24789,-2770
2015,9,4,1,26315,27255,24593,-2662
2015,9,4,2,25262,25961,22991,-2970
2015,9,4,3,23601,24041,20671,-3370
2015,9,4,4,21742,22080,18598,-3482
2015,9,4,5,20183,20508,16230,-4278
2015,9,4,6,18969,19398,15419,-3979
2015,9,4,7,18113,18662,14402,-4260
2015,9,4,8,17589,18151,13901,-4250
2015,9,4,9,17522,18106,13891,-4215
2015,9,4,10,18205,18742,14264,-4478
2015,9,4,11,19093,20024,15406,-4618
2015,9,4,12,20492,21379,17094,-4285
2015,9,4,13,21938,22867,18980,-3887
2015,9,4,14,23158,24133,20051,-4082
2015,9,4,15,24001,24999,21331,-3668
2015,9,4,16,24695,25517,21220,-4297
2015,9,4,17,25199,25772,20979,-4793
2015,9,4,18,25546,26085,21540,-4545
2015,9,4,19,25753,26373,22208,-4165
2015,9,4,20,25882,26590,22889,-3701
2015,9,4,21,25908,26616,23290,-3326
2015,9,4,22,25651,26276,22493,-3783
2015,9,4,23,24794,25217,21839,-3378
2015,9,5,0,23968,24445,21428,-3017
2015,9,5,1,23712,23969,21017,-2952
2015,9,5,2,22823,22818,19260,-3558
2015,9,5,3,21515,21337,17226,-4111
2015,9,5,4,19956,19693,15433,-4260
2015,9,5,5,18675,18333,13824,-4509
2015,9,5,6,17485,17335,12714,-4621
2015,9,5,7,16519,16575,11921,-4654
2015,9,5,8,15842,16067,11531,-4536
2015,9,5,9,15511,15828,11417,-4411
2015,9,5,10,15305,15882,11769,-4113
2015,9,5,11,15588,16104,12297,-3807
2015,9,5,12,16022,16822,13216,-3606
2015,9,5,13,17285,18095,14203,-3892
2015,9,5,14,18621,19334,15659,-3675
2015,9,5,15,19727,20320,16697,-3623
2015,9,5,16,20521,21021,17478,-3543
2015,9,5,17,21026,21595,17849,-3746
2015,9,5,18,21349,22015,18064,-3951
2015,9,5,19,21651,22395,18108,-4287
2015,9,5,20,21881,22701,18709,-3992
2015,9,5,21,21968,22888,19644,-3244
2015,9,5,22,21867,22826,19634,-3192
2015,9,5,23,21335,22198,18870,-3328
2015,9,6,0,20901,21681,18256,-3425
2015,9,6,1,21000,21537,18254,-3283
2015,9,6,2,20306,20695,17044,-3651
2015,9,6,3,19307,19525,15703,-3822
2015,9,6,4,18140,18205,14271,-3934
2015,9,6,5,17044,17042,12750,-4292
2015,9,6,6,16256,16139,11803,-4336
2015,9,6,7,15386,15525,11339,-4186
2015,9,6,8,14761,15108,11048,-4060
2015,9,6,9,14427,14886,11083,-3803
2015,9,6,10,14008,14888,11190,-3698
2015,9,6,11,14226,14966,11049,-3917
2015,9,6,12,14362,15523,12365,-3158
2015,9,6,13,15432,16834,13726,-3108
2015,9,6,14,16847,18168,14782,-3386
2015,9,6,15,18158,19354,16526,-2828
2015,9,6,16,19229,20378,17647,-2731
2015,9,6,17,20040,21236,18104,-3132
2015,9,6,18,20644,21848,18277,-3571
2015,9,6,19,21201,22256,18375,-3881
2015,9,6,20,21627,22533,18638,-3895
2015,9,6,21,21885,22713,19505,-3208
2015,9,6,22,21948,22589,19652,-2937
2015,9,6,23,21523,21979,19209,-2770
2015,9,7,0,21289,21621,18749,-2872
2015,9,7,1,21518,21539,18393,-3146
2015,9,7,2,20750,20830,17868,-2962
2015,9,7,3,19500,19768,16668,-3100
2015,9,7,4,18063,18559,14895,-3664
2015,9,7,5,16771,17476,13277,-4199
2015,9,7,6,16193,16641,12483,-4158
2015,9,7,7,15595,16088,11921,-4167
2015,9,7,8,15186,15740,11636,-4104
2015,9,7,9,15034,15622,11346,-4276
2015,9,7,10,14930,15786,11292,-4494
2015,9,7,11,15514,16036,11921,-4115
2015,9,7,12,15835,16762,13154,-3608
2015,9,7,13,16846,18246,15126,-3120
2015,9,7,14,18345,19843,16442,-3401
2015,9,7,15,19786,21345,17475,-3870
2015,9,7,16,20992,22627,18689,-3938
2015,9,7,17,21935,23655,19940,-3715
2015,9,7,18,22524,24485,21026,-3459
2015,9,7,19,23102,25173,21886,-3287
2015,9,7,20,23537,25778,22230,-3548
2015,9,7,21,23771,26209,22536,-3673
2015,9,7,22,23904,26257,22727,-3530
2015,9,7,23,23544,25765,22380,-3385
2015,9,8,0,23249,25685,22459,-3226
2015,9,8,1,23370,25777,22121,-3656
2015,9,8,2,22437,24675,20847,-3828
2015,9,8,3,20996,22948,19136,-3812
2015,9,8,4,19365,21163,16835,-4328
2015,9,8,5,18378,19807,15201,-4606
2015,9,8,6,17795,18847,14442,-4405
2015,9,8,7,17300,18170,13296,-4874
2015,9,8,8,16973,17814,13208,-4606
2015,9,8,9,16911,17819,13291,-4528
2015,9,8,10,17398,18603,13458,-5145
2015,9,8,11,18774,20283,15268,-5015
2015,9,8,12,20286,21801,17273,-4528
2015,9,8,13,21926,23459,19330,-4129
2015,9,8,14,23300,25039,21394,-3645
2015,9,8,15,24530,26526,22570,-3956
2015,9,8,16,25595,27987,24107,-3880
2015,9,8,17,26446,29214,25404,-3810
2015,9,8,18,27240,30173,26842,-3331
2015,9,8,19,27901,30734,27514,-3220
2015,9,8,20,28368,31010,27174,-3836
2015,9,8,21,28560,31058,27491,-3567
2015,9,8,22,28366,30744,27276,-3468
2015,9,8,23,27577,29753,25961,-3792
2015,9,9,0,26896,29370,25829,-3541
2015,9,9,1,26626,28902,25907,-2995
2015,9,9,2,25371,27396,24017,-3379
2015,9,9,3,23605,25141,21576,-3565
2015,9,9,4,21639,22926,18946,-3980
2015,9,9,5,20084,21264,16824,-4440
2015,9,9,6,18923,20061,15612,-4449
2015,9,9,7,18468,19326,14805,-4521
2015,9,9,8,18132,18900,14758,-4142
2015,9,9,9,18093,18902,14941,-3961
2015,9,9,10,18582,19794,15611,-4183
2015,9,9,11,20038,21606,17369,-4237
2015,9,9,12,21499,23095,18952,-4143
2015,9,9,13,23072,24421,20514,-3907
2015,9,9,14,24402,25807,21862,-3945
2015,9,9,15,25528,26926,23310,-3616
2015,9,9,16,26431,27880,24033,-3847
2015,9,9,17,27104,28554,24763,-3791
2015,9,9,18,27777,29119,25460,-3659
2015,9,9,19,28230,29325,25712,-3613
2015,9,9,20,28473,29426,26160,-3266
2015,9,9,21,28614,29139,25015,-4124
2015,9,9,22,28340,28604,25003,-3601
2015,9,9,23,27450,27647,24280,-3367
2015,9,10,0,26671,27388,24258,-3130
2015,9,10,1,26301,27166,24290,-2876
2015,9,10,2,25099,25911,22651,-3260
2015,9,10,3,23412,23974,20569,-3405
2015,9,10,4,21544,22051,17864,-4187
2015,9,10,5,20177,20459,15850,-4609
2015,9,10,6,18882,19341,14592,-4749
2015,9,10,7,18107,18527,13869,-4658
2015,9,10,8,17648,18134,13679,-4455
2015,9,10,9,17632,18082,13647,-4435
2015,9,10,10,18553,18748,14280,-4468
2015,9,10,11,19615,20374,16372,-4002
2015,9,10,12,20901,21553,17442,-4111
2015,9,10,13,22137,22386,18739,-3647
2015,9,10,14,23029,23056,19656,-3400
2015,9,10,15,23764,23506,20129,-3377
2015,9,10,16,24334,23734,20493,-3241
2015,9,10,17,24752,23795,21059,-2736
2015,9,10,18,25136,23923,21373,-2550
2015,9,10,19,25298,23874,21494,-2380
2015,9,10,20,25333,23928,21566,-2362
2015,9,10,21,25328,23969,21601,-2368
2015,9,10,22,25025,23830,21550,-2280
2015,9,10,23,24274,23362,21172,-2190
2015,9,11,0,23870,23330,20765,-2565
2015,9,11,1,23769,23044,20590,-2454
2015,9,11,2,22708,21980,19028,-2952
2015,9,11,3,21272,20452,17096,-3356
2015,9,11,4,19731,18785,14881,-3904
2015,9,11,5,18391,17489,13475,-4014
2015,9,11,6,17190,16567,13116,-3451
2015,9,11,7,16600,15938,12707,-3231
2015,9,11,8,16295,15586,12801,-2785
2015,9,11,9,16293,15613,12947,-2666
2015,9,11,10,17093,16372,13510,-2862
2015,9,11,11,18099,18010,14973,-3037
2015,9,11,12,19192,19205,16173,-3032
2015,9,11,13,20311,20111,17085,-3026
2015,9,11,14,21160,20836,17875,-2961
2015,9,11,15,21853,21386,18618,-2768
2015,9,11,16,22432,21746,19009,-2737
2015,9,11,17,22869,22024,19294,-2730
2015,9,11,18,23295,22464,19609,-2855
2015,9,11,19,23529,22815,19831,-2984
2015,9,11,20,23644,23108,20362,-2746
2015,9,11,21,23757,23351,20328,-3023
2015,9,11,22,23539,23169,20129,-3040
2015,9,11,23,22801,22392,19254,-3138
2015,9,12,0,22364,22137,18883,-3254
2015,9,12,1,22292,21724,18361,-3363
2015,9,12,2,21409,20781,17832,-2949
2015,9,12,3,20246,19509,16337,-3172
2015,9,12,4,18931,18141,14514,-3627
2015,9,12,5,17606,16927,12444,-4483
2015,9,12,6,16251,16013,11761,-4252
2015,9,12,7,15542,15417,11312,-4105
2015,9,12,8,15038,15075,11271,-3804
2015,9,12,9,14814,14944,11548,-3396
2015,9,12,10,14795,15131,11920,-3211
2015,9,12,11,15216,15575,12293,-3282
2015,9,12,12,15664,16353,12943,-3410
2015,9,12,13,16816,17666,14174,-3492
2015,9,12,14,17966,18860,15591,-3269
2015,9,12,15,18910,19608,16542,-3066
2015,9,12,16,19533,20024,16877,-3147
2015,9,12,17,19966,20237,17043,-3194
2015,9,12,18,20256,20314,16946,-3368
2015,9,12,19,20382,20265,17363,-2902
2015,9,12,20,20469,20115,16994,-3121
2015,9,12,21,20582,20019,16736,-3283
2015,9,12,22,20480,20114,16733,-3381
2015,9,12,23,20098,20191,17269,-2922
2015,9,13,0,20157,20384,17320,-3064
2015,9,13,1,20361,20115,16679,-3436
2015,9,13,2,19660,19505,16178,-3327
2015,9,13,3,18728,18551,15335,-3216
2015,9,13,4,17691,17433,13858,-3575
2015,9,13,5,16363,16419,13501,-2918
2015,9,13,6,15694,15666,12928,-2738
2015,9,13,7,15006,15166,12145,-3021
2015,9,13,8,14554,14823,11911,-2912
2015,9,13,9,14303,14685,11802,-2883
2015,9,13,10,14179,14737,11508,-3229
2015,9,13,11,14510,14972,12199,-2773
2015,9,13,12,14727,15420,12947,-2473
2015,9,13,13,15682,16406,14239,-2167
2015,9,13,14,16742,17498,15744,-1754
2015,9,13,15,17568,18441,16039,-2402
2015,9,13,16,18163,19085,16803,-2282
2015,9,13,17,18575,19570,17378,-2192
2015,9,13,18,18831,19810,17023,-2787
2015,9,13,19,18908,19850,17276,-2574
2015,9,13,20,18953,19687,17147,-2540
2015,9,13,21,19081,19508,17737,-1771
2015,9,13,22,19072,19438,17643,-1795
2015,9,13,23,18884,19256,17473,-1783
2015,9,14,0,19077,19324,17295,-2029
2015,9,14,1,19265,18910,17245,-1665
2015,9,14,2,18505,17966,16366,-1600
2015,9,14,3,17381,16784,15750,-1034
2015,9,14,4,16140,15603,13874,-1729
2015,9,14,5,14579,14577,12845,-1732
2015,9,14,6,14182,13943,12504,-1439
2015,9,14,7,13803,13568,12033,-1535
2015,9,14,8,13618,13395,11855,-1540
2015,9,14,9,13678,13513,11847,-1666
2015,9,14,10,14458,14236,12219,-2017
2015,9,14,11,15802,15695,13706,-1989
2015,9,14,12,17002,16877,15158,-1719
2015,9,14,13,17993,17872,16444,-1428
2015,9,14,14,18676,18608,17317,-1291
2015,9,14,15,19178,19091,17984,-1107
2015,9,14,16,19529,19363,18129,-1234
2015,9,14,17,19790,19616,18636,-980
2015,9,14,18,20125,19792,19105,-687
2015,9,14,19,20340,19977,19284,-693
2015,9,14,20,20514,20057,19120,-937
2015,9,14,21,20726,20185,19123,-1062
2015,9,14,22,20746,20208,19146,-1062
2015,9,14,23,20314,19801,18833,-968
2015,9,15,0,20328,19938,18907,-1031
2015,9,15,1,20407,19648,18952,-696
2015,9,15,2,19471,18627,17788,-839
2015,9,15,3,18124,17289,16093,-1196
2015,9,15,4,16641,15870,13989,-1881
2015,9,15,5,15262,14863,12630,-2233
2015,9,15,6,14325,14155,12076,-2079
2015,9,15,7,13753,13709,11461,-2248
2015,9,15,8,13501,13531,11382,-2149
2015,9,15,9,13517,13667,11683,-1984
2015,9,15,10,14364,14451,12609,-1842
2015,9,15,11,15619,15967,13853,-2114
2015,9,15,12,17037,17177,14798,-2379
2015,9,15,13,18159,18204,16159,-2045
2015,9,15,14,18900,19019,17012,-2007
2015,9,15,15,19503,19723,17769,-1954
2015,9,15,16,19991,20247,17962,-2285
2015,9,15,17,20343,20725,18259,-2466
2015,9,15,18,20803,21237,18834,-2403
2015,9,15,19,21127,21674,19101,-2573
2015,9,15,20,21363,22083,19216,-2867
2015,9,15,21,21506,22375,19401,-2974
2015,9,15,22,21481,22317,19484,-2833
2015,9,15,23,21054,21696,18772,-2924
2015,9,16,0,21122,21719,18921,-2798
2015,9,16,1,20894,21374,18981,-2393
2015,9,16,2,20041,20178,17992,-2186
2015,9,16,3,18604,18618,16284,-2334
2015,9,16,4,16987,17063,13953,-3110
2015,9,16,5,15309,15821,12525,-3296
2015,9,16,6,14564,15010,11940,-3070
2015,9,16,7,14062,14521,11886,-2635
2015,9,16,8,13801,14241,11746,-2495
2015,9,16,9,13770,14329,11865,-2464
2015,9,16,10,14422,15150,12306,-2844
2015,9,16,11,15879,16851,13762,-3089
2015,9,16,12,17363,18139,15561,-2578
2015,9,16,13,18577,19229,17037,-2192
2015,9,16,14,19471,20178,17741,-2437
2015,9,16,15,20217,21057,18108,-2949
2015,9,16,16,20846,21767,18738,-3029
2015,9,16,17,21302,22355,19663,-2692
2015,9,16,18,21865,23004,20023,-2981
2015,9,16,19,22277,23554,20498,-3056
2015,9,16,20,22546,24036,21155,-2881
2015,9,16,21,22643,24387,21513,-2874
2015,9,16,22,22548,24202,21075,-3127
2015,9,16,23,22061,23377,20347,-3030
2015,9,17,0,22022,23235,20296,-2939
2015,9,17,1,21626,22740,19995,-2745
2015,9,17,2,20670,21413,18842,-2571
2015,9,17,3,19133,19756,17019,-2737
2015,9,17,4,17402,18048,14975,-3073
2015,9,17,5,15575,16686,12984,-3702
2015,9,17,6,15135,15822,11971,-3851
2015,9,17,7,14561,15243,11401,-3842
2015,9,17,8,14258,14945,11363,-3582
2015,9,17,9,14209,15009,11479,-3530
2015,9,17,10,14855,15782,12151,-3631
2015,9,17,11,16346,17523,14465,-3058
2015,9,17,12,17850,18763,15958,-2805
2015,9,17,13,19056,19848,17026,-2822
2015,9,17,14,19999,20909,17718,-3191
2015,9,17,15,20780,21887,18284,-3603
2015,9,17,16,21414,22671,19087,-3584
2015,9,17,17,21875,23359,19837,-3522
2015,9,17,18,22393,24049,20384,-3665
2015,9,17,19,22803,24547,20574,-3973
2015,9,17,20,23037,25005,21503,-3502
2015,9,17,21,23055,25257,22149,-3108
2015,9,17,22,22905,24920,22208,-2712
2015,9,17,23,22359,23945,21440,-2505
2015,9,18,0,22252,23691,21575,-2116
2015,9,18,1,21758,23151,21347,-1804
2015,9,18,2,20781,21848,19432,-2416
2015,9,18,3,19243,20122,17302,-2820
2015,9,18,4,17527,18380,14902,-3478
2015,9,18,5,16106,16999,13064,-3935
2015,9,18,6,15453,16019,12177,-3842
2015,9,18,7,14858,15480,11988,-3492
2015,9,18,8,14521,15178,11868,-3310
2015,9,18,9,14460,15210,12279,-2931
2015,9,18,10,15047,15927,12970,-2957
2015,9,18,11,16424,17591,14683,-2908
2015,9,18,12,17862,18835,15958,-2877
2015,9,18,13,19044,20016,17437,-2579
2015,9,18,14,20006,21100,18570,-2530
2015,9,18,15,20783,22035,19200,-2835
2015,9,18,16,21381,22833,19619,-3214
2015,9,18,17,21779,23513,19807,-3706
2015,9,18,18,22231,24075,20805,-3270
2015,9,18,19,22577,24416,21119,-3297
2015,9,18,20,22769,24716,21625,-3091
2015,9,18,21,22747,24680,21291,-3389
2015,9,18,22,22524,24087,21178,-2909
2015,9,18,23,21903,23088,20055,-3033
2015,9,19,0,21666,22829,20028,-2801
2015,9,19,1,21088,22248,19423,-2825
2015,9,19,2,20178,21174,18626,-2548
2015,9,19,3,18904,19843,16940,-2903
2015,9,19,4,17443,18381,15151,-3230
2015,9,19,5,16323,17124,14062,-3062
2015,9,19,6,15594,16248,13381,-2867
2015,9,19,7,15118,15658,12516,-3142
2015,9,19,8,14783,15285,12177,-3108
2015,9,19,9,14618,15215,12498,-2717
2015,9,19,10,14428,15406,12641,-2765
2015,9,19,11,15322,15873,12592,-3281
2015,9,19,12,15883,16588,13468,-3120
2015,9,19,13,16851,17898,14675,-3223
2015,9,19,14,17945,19001,16148,-2853
2015,9,19,15,18809,19942,16999,-2943
2015,9,19,16,19379,20677,17832,-2845
2015,9,19,17,19690,21163,18376,-2787
2015,9,19,18,19948,21518,18467,-3051
2015,9,19,19,20132,21688,18907,-2781
2015,9,19,20,20270,21799,18873,-2926
2015,9,19,21,20326,21821,19025,-2796
2015,9,19,22,20322,21676,19115,-2561
2015,9,19,23,20026,21281,18836,-2445
2015,9,20,0,20098,21515,19096,-2419
2015,9,20,1,19769,21197,19113,-2084
2015,9,20,2,19049,20452,17931,-2521
2015,9,20,3,18051,19443,16643,-2800
2015,9,20,4,16967,18228,14973,-3255
2015,9,20,5,16280,17170,13902,-3268
2015,9,20,6,15225,16361,13186,-3175
2015,9,20,7,14412,15800,12226,-3574
2015,9,20,8,13927,15404,11521,-3883
2015,9,20,9,13737,15163,11101,-4062
2015,9,20,10,13698,15227,11098,-4129
2015,9,20,11,14171,15396,11547,-3849
2015,9,20,12,14559,15620,12524,-3096
2015,9,20,13,15393,16422,14042,-2380
2015,9,20,14,16386,17098,14953,-2145
2015,9,20,15,17138,17610,15417,-2193
2015,9,20,16,17583,17912,15168,-2744
2015,9,20,17,17816,18168,15294,-2874
2015,9,20,18,17909,18380,15548,-2832
2015,9,20,19,17947,18600,15831,-2769
2015,9,20,20,18050,18785,16097,-2688
2015,9,20,21,18188,18966,16088,-2878
2015,9,20,22,18396,19007,15971,-3036
2015,9,20,23,18318,18733,15650,-3083
2015,9,21,0,18626,19083,16259,-2824
2015,9,21,1,18465,18716,15962,-2754
2015,9,21,2,17674,17793,15051,-2742
2015,9,21,3,16569,16626,14227,-2399
2015,9,21,4,15343,15408,12541,-2867
2015,9,21,5,14680,14418,11555,-2863
2015,9,21,6,13755,13804,11082,-2722
2015,9,21,7,13448,13428,10386,-3042
2015,9,21,8,13370,13269,10295,-2974
2015,9,21,9,13477,13438,10448,-2990
2015,9,21,10,14168,14333,11326,-3007
2015,9,21,11,15790,16059,13160,-2899
2015,9,21,12,17033,17190,14419,-2771
2015,9,21,13,17907,17998,15409,-2589
2015,9,21,14,18563,18593,16278,-2315
2015,9,21,15,19024,19036,16422,-2614
2015,9,21,16,19303,19263,16952,-2311
2015,9,21,17,19463,19442,17225,-2217
2015,9,21,18,19623,19626,17280,-2346
2015,9,21,19,19696,19609,17057,-2552
2015,9,21,20,19778,19558,16819,-2739
2015,9,21,21,19913,19622,17033,-2589
2015,9,21,22,19966,19614,17495,-2119
2015,9,21,23,19795,19491,17557,-1934
2015,9,22,0,19902,19855,17846,-2009
2015,9,22,1,19595,19348,17043,-2305
2015,9,22,2,18710,18263,15720,-2543
2015,9,22,3,17368,16893,14864,-2029
2015,9,22,4,16010,15480,12617,-2863
2015,9,22,5,14911,14399,11607,-2792
2015,9,22,6,13855,13691,10863,-2828
2015,9,22,7,13407,13360,10817,-2543
2015,9,22,8,13254,13195,10663,-2532
2015,9,22,9,13364,13384,11128,-2256
2015,9,22,10,14242,14246,11934,-2312
2015,9,22,11,15698,16119,13640,-2479
2015,9,22,12,16912,17357,15272,-2085
2015,9,22,13,17788,18097,15978,-2119
2015,9,22,14,18417,18666,16256,-2410
2015,9,22,15,18890,19086,16988,-2098
2015,9,22,16,19231,19351,17132,-2219
2015,9,22,17,19502,19496,17295,-2201
2015,9,22,18,19768,19636,17364,-2272
2015,9,22,19,19934,19703,17467,-2236
2015,9,22,20,20053,19766,17651,-2115
2015,9,22,21,20196,19802,17546,-2256
2015,9,22,22,20166,19704,17433,-2271
2015,9,22,23,19907,19372,17180,-2192
2015,9,23,0,19969,19725,17722,-2003
2015,9,23,1,19667,19244,16993,-2251
2015,9,23,2,18669,18182,15867,-2315
2015,9,23,3,17273,16852,14465,-2387
2015,9,23,4,15754,15498,12966,-2532
2015,9,23,5,14368,14540,12415,-2125
2015,9,23,6,13690,13852,11663,-2189
2015,9,23,7,13365,13446,10906,-2540
2015,9,23,8,13210,13280,10479,-2801
2015,9,23,9,13262,13426,10892,-2534
2015,9,23,10,13839,14199,11444,-2755
2015,9,23,11,15448,15633,13061,-2572
2015,9,23,12,16697,16752,13892,-2860
2015,9,23,13,17668,17627,15017,-2610
2015,9,23,14,18340,18285,15581,-2704
2015,9,23,15,18907,18799,16032,-2767
2015,9,23,16,19312,19115,16474,-2641
2015,9,23,17,19620,19419,16856,-2563
2015,9,23,18,19989,19809,16903,-2906
2015,9,23,19,20321,20045,17100,-2945
2015,9,23,20,20578,20249,17252,-2997
2015,9,23,21,20747,20482,17477,-3005
2015,9,23,22,20700,20362,17724,-2638
2015,9,23,23,20255,19899,17423,-2476
2015,9,24,0,20202,20111,17671,-2440
2015,9,24,1,19938,19610,17162,-2448
2015,9,24,2,18882,18489,15716,-2773
2015,9,24,3,17453,17015,14339,-2676
2015,9,24,4,15896,15641,12472,-3169
2015,9,24,5,14544,14649,11407,-3242
2015,9,24,6,13856,14004,10756,-3248
2015,9,24,7,13537,13587,10356,-3231
2015,9,24,8,13365,13349,10236,-3113
2015,9,24,9,13416,13489,10348,-3141
2015,9,24,10,13996,14292,11015,-3277
2015,9,24,11,15621,15933,12526,-3407
2015,9,24,12,16868,17110,13911,-3199
2015,9,24,13,17854,18054,15225,-2829
2015,9,24,14,18539,18777,16160,-2617
2015,9,24,15,19148,19394,17065,-2329
2015,9,24,16,19578,19856,17780,-2076
2015,9,24,17,19885,20197,18080,-2117
2015,9,24,18,20281,20586,18298,-2288
2015,9,24,19,20565,20844,18710,-2134
2015,9,24,20,20831,21102,18645,-2457
2015,9,24,21,21049,21303,18754,-2549
2015,9,24,22,20997,21132,18857,-2275
2015,9,24,23,20616,20580,18828,-1752
2015,9,25,0,20489,20872,18587,-2285
2015,9,25,1,20195,20324,18399,-1925
2015,9,25,2,19195,19208,17074,-2134
2015,9,25,3,17794,17744,15620,-2124
2015,9,25,4,16339,16285,13371,-2914
2015,9,25,5,14957,15158,11956,-3202
2015,9,25,6,14201,14417,11674,-2743
2015,9,25,7,13707,13944,11618,-2326
2015,9,25,8,13428,13732,11671,-2061
2015,9,25,9,13507,13839,11661,-2178
2015,9,25,10,14354,14618,11921,-2697
2015,9,25,11,15762,16297,13477,-2820
2015,9,25,12,17027,17473,15257,-2216
2015,9,25,13,18005,18313,16301,-2012
2015,9,25,14,18734,18924,16817,-2107
2015,9,25,15,19300,19405,17283,-2122
2015,9,25,16,19656,19706,17748,-1958
2015,9,25,17,19901,19871,17989,-1882
2015,9,25,18,20139,20078,18287,-1791
2015,9,25,19,20252,20140,18197,-1943
2015,9,25,20,20336,20128,18183,-1945
2015,9,25,21,20411,20002,17769,-2233
2015,9,25,22,20220,19661,17375,-2286
2015,9,25,23,19778,19312,17337,-1975
2015,9,26,0,19643,19508,17644,-1864
2015,9,26,1,19309,18967,17067,-1900
2015,9,26,2,18309,18080,15752,-2328
2015,9,26,3,17045,16880,14583,-2297
2015,9,26,4,15765,15632,12827,-2805
2015,9,26,5,14595,14588,11978,-2610
2015,9,26,6,13970,13902,11473,-2429
2015,9,26,7,13415,13454,11170,-2284
2015,9,26,8,13050,13217,11295,-1922
2015,9,26,9,13011,13147,11496,-1651
2015,9,26,10,13152,13388,11815,-1573
2015,9,26,11,13727,13948,12051,-1897
2015,9,26,12,14188,14577,12520,-2057
2015,9,26,13,15039,15593,13353,-2240
2015,9,26,14,16004,16366,13789,-2577
2015,9,26,15,16724,16790,14441,-2349
2015,9,26,16,17101,16966,14847,-2119
2015,9,26,17,17311,17027,15063,-1964
2015,9,26,18,17420,17025,15119,-1906
2015,9,26,19,17415,17018,15052,-1966
2015,9,26,20,17463,17013,15112,-1901
2015,9,26,21,17571,17064,15004,-2060
2015,9,26,22,17565,17105,15042,-2063
2015,9,26,23,17538,17192,15121,-2071
2015,9,27,0,17729,17717,15816,-1901
2015,9,27,1,17501,17405,15398,-2007
2015,9,27,2,16746,16728,15204,-1524
2015,9,27,3,15824,15815,14139,-1676
2015,9,27,4,14853,14845,13504,-1341
2015,9,27,5,13986,14021,12625,-1396
2015,9,27,6,13416,13396,12232,-1164
2015,9,27,7,12948,12970,12211,-759
2015,9,27,8,12644,12758,12026,-732
2015,9,27,9,12563,12703,11969,-734
2015,9,27,10,12537,12851,12034,-817
2015,9,27,11,13004,13164,12541,-623
2015,9,27,12,13238,13475,12788,-687
2015,9,27,13,13910,14421,13444,-977
2015,9,27,14,14709,15184,14016,-1168
2015,9,27,15,15443,15711,14455,-1256
2015,9,27,16,15885,16053,14618,-1435
2015,9,27,17,16206,16271,14758,-1513
2015,9,27,18,16408,16442,14891,-1551
2015,9,27,19,16520,16602,15345,-1257
2015,9,27,20,16707,16773,15435,-1338
2015,9,27,21,16941,17058,15626,-1432
2015,9,27,22,17120,17391,16014,-1377
2015,9,27,23,17253,17643,16770,-873
2015,9,28,0,17613,18255,16862,-1393
2015,9,28,1,17561,17927,16731,-1196
2015,9,28,2,16882,17043,15995,-1048
2015,9,28,3,15905,15973,15210,-763
2015,9,28,4,14844,14959,14225,-734
2015,9,28,5,13660,14112,13582,-530
2015,9,28,6,13301,13585,12771,-814
2015,9,28,7,13040,13345,12927,-418
2015,9,28,8,12910,13266,12786,-480
2015,9,28,9,13000,13481,13143,-338
2015,9,28,10,13574,14418,13934,-484
2015,9,28,11,15240,16311,15481,-830
2015,9,28,12,16613,17667,16433,-1234
2015,9,28,13,17693,18503,17003,-1500
2015,9,28,14,18475,19174,17840,-1334
2015,9,28,15,19078,19646,18633,-1013
2015,9,28,16,19512,20020,18869,-1151
2015,9,28,17,19856,20221,19278,-943
2015,9,28,18,20228,20430,19722,-708
2015,9,28,19,20435,20627,19974,-653
2015,9,28,20,20610,20894,20132,-762
2015,9,28,21,20770,21072,20124,-948
2015,9,28,22,20743,21038,19722,-1316
2015,9,28,23,20595,20931,19326,-1605
2015,9,29,0,20650,21354,20181,-1173
2015,9,29,1,20301,20678,19884,-794
2015,9,29,2,19292,19577,19141,-436
2015,9,29,3,17940,18185,17313,-872
2015,9,29,4,16424,16824,15300,-1524
2015,9,29,5,15045,15742,14131,-1611
2015,9,29,6,14628,15091,13598,-1493
2015,9,29,7,14361,14736,13621,-1115
2015,9,29,8,14214,14546,13433,-1113
2015,9,29,9,14252,14724,13622,-1102
2015,9,29,10,14762,15626,14187,-1439
2015,9,29,11,16642,17709,15819,-1890
2015,9,29,12,18060,19138,17372,-1766
2015,9,29,13,19096,20158,18454,-1704
2015,9,29,14,19852,20998,19344,-1654
2015,9,29,15,20441,21701,20250,-1451
2015,9,29,16,20844,22236,20771,-1465
2015,9,29,17,21181,22641,21193,-1448
2015,9,29,18,21495,22937,21256,-1681
2015,9,29,19,21640,22843,20824,-2019
2015,9,29,20,21743,22772,20703,-2069
2015,9,29,21,21819,22767,20898,-1869
2015,9,29,22,21746,22758,20600,-2158
2015,9,29,23,21492,22707,20310,-2397
2015,9,30,0,21537,22811,20569,-2242
2015,9,30,1,21132,22125,20427,-1698
2015,9,30,2,20055,21024,19120,-1904
2015,9,30,3,18604,19462,17533,-1929
2015,9,30,4,16999,17882,15618,-2264
2015,9,30,5,15797,16700,14694,-2006
2015,9,30,6,15050,16039,14323,-1716
2015,9,30,7,14593,15604,13819,-1785
2015,9,30,8,14339,15292,13512,-1780
2015,9,30,9,14434,15418,13609,-1809
2015,9,30,10,15307,16385,14849,-1536
2015,9,30,11,17002,18377,16839,-1538
2015,9,30,12,18324,19925,18737,-1188
2015,9,30,13,19231,20804,19340,-1464
2015,9,30,14,19872,21490,20061,-1429
2015,9,30,15,20319,21967,20949,-1018
2015,9,30,16,20530,22116,21200,-916
2015,9,30,17,20614,22065,21047,-1018
2015,9,30,18,20701,21908,20987,-921
2015,9,30,19,20615,21213,20075,-1138
2015,9,30,20,20514,20724,19500,-1224
2015,9,30,21,20494,20613,19261,-1352
2015,9,30,22,20435,20400,19124,-1276
2015,9,30,23,20281,20191,18814,-1377
2015,10,1,0,20358,20332,19142,-1190
2015,10,1,1,19882,19545,18650,-895
2015,10,1,2,18776,18357,17346,-1011
2015,10,1,3,17408,16897,15542,-1355
2015,10,1,4,15972,15424,13844,-1580
2015,10,1,5,15087,14355,12790,-1565
2015,10,1,6,14043,13711,12323,-1388
2015,10,1,7,13541,13238,12089,-1149
2015,10,1,8,13319,12969,11919,-1050
2015,10,1,9,13431,13088,12217,-871
2015,10,1,10,14234,13917,12822,-1095
2015,10,1,11,15692,15715,14330,-1385
2015,10,1,12,17037,16925,16213,-712
2015,10,1,13,17755,17529,16921,-608
2015,10,1,14,18208,17927,17362,-565
2015,10,1,15,18504,18177,17139,-1038
2015,10,1,16,18585,18218,17079,-1139
2015,10,1,17,18556,18167,16903,-1264
2015,10,1,18,18542,18151,16676,-1475
2015,10,1,19,18487,18091,16596,-1495
2015,10,1,20,18478,18069,16783,-1286
2015,10,1,21,18676,18132,17025,-1107
2015,10,1,22,18793,18296,17308,-988
2015,10,1,23,18889,18576,17531,-1045
2015,10,2,0,19244,18899,18139,-760
2015,10,2,1,18865,18371,17391,-980
2015,10,2,2,17950,17346,16476,-870
2015,10,2,3,16687,16042,14948,-1094
2015,10,2,4,15382,14761,13439,-1322
2015,10,2,5,14199,13791,12305,-1486
2015,10,2,6,13421,13147,11603,-1544
2015,10,2,7,12904,12791,11132,-1659
2015,10,2,8,12697,12618,11161,-1457
2015,10,2,9,12816,12775,11588,-1187
2015,10,2,10,13669,13633,12656,-977
2015,10,2,11,15052,15428,13969,-1459
2015,10,2,12,16392,16702,15543,-1159
2015,10,2,13,17177,17380,16116,-1264
2015,10,2,14,17709,17818,16447,-1371
2015,10,2,15,18063,18071,16901,-1170
2015,10,2,16,18198,18130,17107,-1023
2015,10,2,17,18190,18060,17060,-1000
2015,10,2,18,18193,18106,17095,-1011
2015,10,2,19,18085,18033,17196,-837
2015,10,2,20,18006,17998,17094,-904
2015,10,2,21,18147,18109,17203,-906
2015,10,2,22,18200,18236,17309,-927
2015,10,2,23,18285,18451,17448,-1003
2015,10,3,0,18591,18581,17720,-861
2015,10,3,1,18091,18041,17379,-662
2015,10,3,2,17221,17224,15780,-1444
2015,10,3,3,16123,16147,14826,-1321
2015,10,3,4,14983,14964,13417,-1547
2015,10,3,5,13661,13905,12979,-926
2015,10,3,6,13169,13255,12463,-792
2015,10,3,7,12731,12899,11914,-985
2015,10,3,8,12470,12703,11527,-1176
2015,10,3,9,12482,12717,11614,-1103
2015,10,3,10,12728,13035,12353,-682
2015,10,3,11,13469,13684,12939,-745
2015,10,3,12,14055,14404,13245,-1159
2015,10,3,13,14695,15461,14505,-956
2015,10,3,14,15506,16268,14787,-1481
2015,10,3,15,16109,16752,15001,-1751
2015,10,3,16,16383,16905,15176,-1729
2015,10,3,17,16438,16909,15545,-1364
2015,10,3,18,16395,16763,15604,-1159
2015,10,3,19,16215,16653,15453,-1200
2015,10,3,20,16130,16589,15261,-1328
2015,10,3,21,16308,16676,15307,-1369
2015,10,3,22,16497,16899,15569,-1330
2015,10,3,23,16819,17302,16191,-1111
2015,10,4,0,17290,17538,16711,-827
2015,10,4,1,16900,17164,16151,-1013
2015,10,4,2,16180,16594,15318,-1276
2015,10,4,3,15267,15735,14495,-1240
2015,10,4,4,14332,14730,13498,-1232
2015,10,4,5,13410,13852,12634,-1218
2015,10,4,6,12916,13198,12491,-707
2015,10,4,7,12435,12786,11882,-904
2015,10,4,8,12108,12542,11688,-854
2015,10,4,9,12074,12493,11782,-711
2015,10,4,10,12177,12700,12436,-264
2015,10,4,11,12729,13115,13049,-66
2015,10,4,12,13142,13553,13222,-331
2015,10,4,13,13626,14453,14198,-255
2015,10,4,14,14318,15190,15036,-154
2015,10,4,15,14859,15576,15764,188
2015,10,4,16,15148,0,56,56
2015,10,4,17,15256,15610,15366,-244
2015,10,4,18,15274,15526,15202,-324
2015,10,4,19,15153,15462,15102,-360
2015,10,4,20,15122,15563,15111,-452
2015,10,4,21,15339,15766,15028,-738
2015,10,4,22,15663,16116,15582,-534
2015,10,4,23,16185,16683,16186,-497
2015,10,5,0,16817,17444,16989,-455
2015,10,5,1,16569,17072,17117,45
2015,10,5,2,15881,16294,15962,-332
2015,10,5,3,14878,15220,14673,-547
2015,10,5,4,13839,14182,13794,-388
2015,10,5,5,12982,13350,13272,-78
2015,10,5,6,12516,12849,12896,47
2015,10,5,7,12296,12591,12313,-278
2015,10,5,8,12203,12529,12400,-129
2015,10,5,9,12327,12754,12452,-302
2015,10,5,10,12971,13684,13400,-284
2015,10,5,11,14801,15528,15349,-179
2015,10,5,12,16269,16810,16638,-172
2015,10,5,13,16981,17392,17007,-385
2015,10,5,14,17400,17733,16969,-764
2015,10,5,15,17664,17907,17243,-664
2015,10,5,16,17740,17966,17383,-583
2015,10,5,17,17684,17947,17454,-493
2015,10,5,18,17682,17971,17716,-255
2015,10,5,19,17546,17904,17622,-282
2015,10,5,20,17458,17854,17601,-253
2015,10,5,21,17582,17932,17059,-873
2015,10,5,22,17791,18090,17207,-883
2015,10,5,23,18137,18419,17533,-886
2015,10,6,0,18555,18959,18260,-699
2015,10,6,1,18117,18431,17891,-540
2015,10,6,2,17205,17404,16671,-733
2015,10,6,3,15878,16040,15555,-485
2015,10,6,4,14516,14702,14389,-313
2015,10,6,5,13459,13696,13034,-662
2015,10,6,6,12774,13147,13078,-69
2015,10,6,7,12485,12789,12136,-653
2015,10,6,8,12345,12645,12081,-564
2015,10,6,9,12444,12861,12455,-406
2015,10,6,10,13105,13719,13506,-213
2015,10,6,11,14798,15556,15934,378
2015,10,6,12,16240,16769,17178,409
2015,10,6,13,16923,17313,17019,-294
2015,10,6,14,17327,17671,17304,-367
2015,10,6,15,17602,17889,17416,-473
2015,10,6,16,17700,17951,17558,-393
2015,10,6,17,17695,18023,17629,-394
2015,10,6,18,17746,18125,17701,-424
2015,10,6,19,17656,18176,17685,-491
2015,10,6,20,17613,18273,17849,-424
2015,10,6,21,17725,18478,18038,-440
2015,10,6,22,17873,18607,18339,-268
2015,10,6,23,18161,18873,18311,-562
2015,10,7,0,18498,19179,18830,-349
2015,10,7,1,18047,18578,18695,117
2015,10,7,2,17185,17538,17133,-405
2015,10,7,3,15896,16170,15031,-1139
2015,10,7,4,14547,14813,13612,-1201
2015,10,7,5,13448,13822,12861,-961
2015,10,7,6,12846,13197,12590,-607
2015,10,7,7,12579,12835,12191,-644
2015,10,7,8,12430,12677,12228,-449
2015,10,7,9,12500,12830,12575,-255
2015,10,7,10,13100,13679,13042,-637
2015,10,7,11,14880,15536,14436,-1100
2015,10,7,12,16397,16760,15867,-893
2015,10,7,13,17132,17404,16800,-604
2015,10,7,14,17597,17816,17320,-496
2015,10,7,15,17905,18043,17345,-698
2015,10,7,16,18021,18233,17747,-486
2015,10,7,17,18022,18327,17776,-551
2015,10,7,18,18087,18474,17810,-664
2015,10,7,19,17999,18545,17722,-823
2015,10,7,20,17955,18667,17846,-821
2015,10,7,21,18032,18790,18096,-694
2015,10,7,22,18138,18858,18297,-561
2015,10,7,23,18376,19043,18012,-1031
2015,10,8,0,18672,19323,18846,-477
2015,10,8,1,18166,18663,18677,14
2015,10,8,2,17313,17625,17298,-327
2015,10,8,3,16046,16251,15650,-601
2015,10,8,4,14674,14899,13911,-988
2015,10,8,5,13523,13869,13269,-600
2015,10,8,6,12922,13270,12708,-562
2015,10,8,7,12597,12885,12170,-715
2015,10,8,8,12422,12744,12362,-382
2015,10,8,9,12502,12909,12660,-249
2015,10,8,10,13180,13817,13428,-389
2015,10,8,11,14931,15717,14610,-1107
2015,10,8,12,16462,16962,16158,-804
2015,10,8,13,17198,17543,16480,-1063
2015,10,8,14,17605,17939,17080,-859
2015,10,8,15,17836,18171,17369,-802
2015,10,8,16,17872,18256,17243,-1013
2015,10,8,17,17819,18310,17431,-879
2015,10,8,18,17810,18402,17384,-1018
2015,10,8,19,17684,18382,17292,-1090
2015,10,8,20,17587,18359,17550,-809
2015,10,8,21,17637,18464,17674,-790
2015,10,8,22,17784,18470,17365,-1105
2015,10,8,23,18097,18759,17628,-1131
2015,10,9,0,18432,19113,18257,-856
2015,10,9,1,17983,18524,17787,-737
2015,10,9,2,17157,17538,17001,-537
2015,10,9,3,15911,16225,15110,-1115
2015,10,9,4,14562,14853,13559,-1294
2015,10,9,5,13494,13866,12896,-970
2015,10,9,6,13054,13308,12760,-548
2015,10,9,7,12831,12972,12344,-628
2015,10,9,8,12672,12854,12276,-578
2015,10,9,9,12716,13030,12453,-577
2015,10,9,10,13238,13894,13184,-710
2015,10,9,11,15130,15725,14846,-879
2015,10,9,12,16714,17134,16566,-568
2015,10,9,13,17574,18008,17528,-480
2015,10,9,14,18182,18603,17876,-727
2015,10,9,15,18568,18989,17983,-1006
2015,10,9,16,18729,19211,18235,-976
2015,10,9,17,18766,19256,18404,-852
2015,10,9,18,18822,19326,18544,-782
2015,10,9,19,18748,19386,18473,-913
2015,10,9,20,18670,19364,18353,-1011
2015,10,9,21,18669,19407,18335,-1072
2015,10,9,22,18673,19439,18448,-991
2015,10,9,23,18790,19457,18438,-1019
2015,10,10,0,18929,19206,18567,-639
2015,10,10,1,18319,18527,18118,-409
2015,10,10,2,17488,17667,17186,-481
2015,10,10,3,16371,16562,15584,-978
2015,10,10,4,15122,15273,14126,-1147
2015,10,10,5,14137,14125,13142,-983
2015,10,10,6,13431,13404,12395,-1009
2015,10,10,7,12871,12923,11914,-1009
2015,10,10,8,12491,12612,12016,-596
2015,10,10,9,12452,12563,11998,-565
2015,10,10,10,12711,12835,12043,-792
2015,10,10,11,13422,13464,12450,-1014
2015,10,10,12,14070,14127,13465,-662
2015,10,10,13,14692,14998,14453,-545
2015,10,10,14,15382,15592,14998,-594
2015,10,10,15,15809,15858,15185,-673
2015,10,10,16,15956,15889,15148,-741
2015,10,10,17,15942,15779,15050,-729
2015,10,10,18,15859,15634,14764,-870
2015,10,10,19,15728,15515,14918,-597
2015,10,10,20,15687,15463,14777,-686
2015,10,10,21,15762,15642,14808,-834
2015,10,10,22,16017,15913,15026,-887
2015,10,10,23,16588,16544,15669,-875
2015,10,11,0,17051,17043,16021,-1022
2015,10,11,1,16719,16728,16160,-568
2015,10,11,2,16112,16136,15336,-800
2015,10,11,3,15297,15335,14545,-790
2015,10,11,4,14392,14458,13418,-1040
2015,10,11,5,13646,13607,12293,-1314
2015,10,11,6,12929,12979,11696,-1283
2015,10,11,7,12454,12551,11152,-1399
2015,10,11,8,12133,12338,11399,-939
2015,10,11,9,12099,12299,11535,-764
2015,10,11,10,12283,12494,11928,-566
2015,10,11,11,12828,12967,12507,-460
2015,10,11,12,13242,13459,12925,-534
2015,10,11,13,13668,14235,13681,-554
2015,10,11,14,14284,14867,14116,-751
2015,10,11,15,14729,15217,14563,-654
2015,10,11,16,14985,15357,14684,-673
2015,10,11,17,15128,15409,14767,-642
2015,10,11,18,15197,15396,14621,-775
2015,10,11,19,15203,15403,14641,-762
2015,10,11,20,15259,15487,14680,-807
2015,10,11,21,15415,15767,14969,-798
2015,10,11,22,15721,16106,15389,-717
2015,10,11,23,16334,16699,15647,-1052
2015,10,12,0,16891,17217,16436,-781
2015,10,12,1,16628,16830,15906,-924
2015,10,12,2,16014,16144,15630,-514
2015,10,12,3,15044,15260,14729,-531
2015,10,12,4,13982,14280,13684,-596
2015,10,12,5,13038,13420,12556,-864
2015,10,12,6,12513,12857,12125,-732
2015,10,12,7,12309,12530,11852,-678
2015,10,12,8,12220,12406,11697,-709
2015,10,12,9,12324,12567,11928,-639
2015,10,12,10,12928,13300,12720,-580
2015,10,12,11,14715,14585,14105,-480
2015,10,12,12,16175,15710,15231,-479
2015,10,12,13,16963,16744,16169,-575
2015,10,12,14,17430,17439,16485,-954
2015,10,12,15,17719,17828,16579,-1249
2015,10,12,16,17873,18057,16562,-1495
2015,10,12,17,17950,18206,16381,-1825
2015,10,12,18,18063,18296,16217,-2079
2015,10,12,19,18116,18381,16487,-1894
2015,10,12,20,18157,18448,16474,-1974
2015,10,12,21,18227,18600,16802,-1798
2015,10,12,22,18351,18637,16763,-1874
2015,10,12,23,18643,18923,17286,-1637
2015,10,13,0,18928,19162,17747,-1415
2015,10,13,1,18444,18447,17755,-692
2015,10,13,2,17567,17435,16845,-590
2015,10,13,3,16286,16097,15561,-536
2015,10,13,4,14903,14773,14099,-674
2015,10,13,5,13667,13715,12886,-829
2015,10,13,6,12958,13102,12632,-470
2015,10,13,7,12690,12784,12643,-141
2015,10,13,8,12551,12658,12781,123
2015,10,13,9,12639,12838,12889,51
2015,10,13,10,13262,13784,13382,-402
2015,10,13,11,15047,15716,14941,-775
2015,10,13,12,16613,17105,16315,-790
2015,10,13,13,17408,17754,17228,-526
2015,10,13,14,17852,18281,17595,-686
2015,10,13,15,18102,18698,17689,-1009
2015,10,13,16,18198,18921,17918,-1003
2015,10,13,17,18209,19022,17999,-1023
2015,10,13,18,18259,19054,17919,-1135
2015,10,13,19,18268,18877,17672,-1205
2015,10,13,20,18310,18922,17918,-1004
2015,10,13,21,18413,18936,17890,-1046
2015,10,13,22,18565,19027,18187,-840
2015,10,13,23,18809,19422,18283,-1139
2015,10,14,0,19055,19571,18381,-1190
2015,10,14,1,18528,18830,17955,-875
2015,10,14,2,17589,17792,16951,-841
2015,10,14,3,16274,16393,15695,-698
2015,10,14,4,14856,14968,14130,-838
2015,10,14,5,13726,13835,13316,-519
2015,10,14,6,13085,13250,13073,-177
2015,10,14,7,12725,12873,12720,-153
2015,10,14,8,12532,12695,12573,-122
2015,10,14,9,12599,12834,12599,-235
2015,10,14,10,13253,13662,13069,-593
2015,10,14,11,14825,15553,14789,-764
2015,10,14,12,16342,16897,16381,-516
2015,10,14,13,17098,17482,16776,-706
2015,10,14,14,17478,17897,17168,-729
2015,10,14,15,17668,18096,17242,-854
2015,10,14,16,17732,18177,17051,-1126
2015,10,14,17,17703,18203,17051,-1152
2015,10,14,18,17712,18272,17138,-1134
2015,10,14,19,17700,18255,17247,-1008
2015,10,14,20,17713,18232,17410,-822
2015,10,14,21,17840,18300,17307,-993
2015,10,14,22,18046,18390,17360,-1030
2015,10,14,23,18370,18821,17619,-1202
2015,10,15,0,18634,18987,17528,-1459
2015,10,15,1,18146,18350,16970,-1380
2015,10,15,2,17284,17323,16514,-809
2015,10,15,3,16091,15999,14954,-1045
2015,10,15,4,14758,14614,13696,-918
2015,10,15,5,13576,13607,12971,-636
2015,10,15,6,12936,13053,12519,-534
2015,10,15,7,12604,12722,12279,-443
2015,10,15,8,12449,12603,12323,-280
2015,10,15,9,12546,12781,12202,-579
2015,10,15,10,13240,13726,12761,-965
2015,10,15,11,14882,15644,14705,-939
2015,10,15,12,16359,16910,16162,-748
2015,10,15,13,17103,17454,16739,-715
2015,10,15,14,17449,17766,17058,-708
2015,10,15,15,17569,17935,17022,-913
2015,10,15,16,17550,17922,17006,-916
2015,10,15,17,17468,17847,17133,-714
2015,10,15,18,17417,17862,17277,-585
2015,10,15,19,17366,17805,17217,-588
2015,10,15,20,17356,17817,17399,-418
2015,10,15,21,17488,17946,17627,-319
2015,10,15,22,17734,18100,17775,-325
2015,10,15,23,18169,18627,18154,-473
2015,10,16,0,18472,18796,18489,-307
2015,10,16,1,17998,18242,17884,-358
2015,10,16,2,17134,17256,16858,-398
2015,10,16,3,15918,15985,15664,-321
2015,10,16,4,14590,14707,14006,-701
2015,10,16,5,13383,13666,13377,-289
2015,10,16,6,12785,13059,12979,-80
2015,10,16,7,12439,12704,13130,426
2015,10,16,8,12266,12587,13001,414
2015,10,16,9,12342,12782,13410,628
2015,10,16,10,12990,13642,13639,-3
2015,10,16,11,14494,15541,15442,-99
2015,10,16,12,15962,16843,16591,-252
2015,10,16,13,16797,17390,16964,-426
2015,10,16,14,17245,17687,17331,-356
2015,10,16,15,17459,17889,17276,-613
2015,10,16,16,17538,17925,17421,-504
2015,10,16,17,17507,17821,17309,-512
2015,10,16,18,17473,17764,17206,-558
2015,10,16,19,17376,17654,17160,-494
2015,10,16,20,17323,17600,17032,-568
2015,10,16,21,17380,17675,17187,-488
2015,10,16,22,17490,17788,17321,-467
2015,10,16,23,17827,18206,17737,-469
2015,10,17,0,18046,18201,17674,-527
2015,10,17,1,17482,17701,17260,-441
2015,10,17,2,16680,16949,16706,-243
2015,10,17,3,15698,15880,15183,-697
2015,10,17,4,14579,14713,13960,-753
2015,10,17,5,13547,13783,12926,-857
2015,10,17,6,12890,13199,12484,-715
2015,10,17,7,12514,12835,12335,-500
2015,10,17,8,12296,12634,12094,-540
2015,10,17,9,12326,12641,12270,-371
2015,10,17,10,12589,12975,12464,-511
2015,10,17,11,13272,13689,13497,-192
2015,10,17,12,13928,14432,14259,-173
2015,10,17,13,14548,15361,15090,-271
2015,10,17,14,15259,15987,15524,-463
2015,10,17,15,15687,16266,15895,-371
2015,10,17,16,15843,16281,16059,-222
2015,10,17,17,15854,16192,15565,-627
2015,10,17,18,15768,16026,15297,-729
2015,10,17,19,15613,15902,15238,-664
2015,10,17,20,15573,15895,15298,-597
2015,10,17,21,15686,16088,15471,-617
2015,10,17,22,15983,16468,15747,-721
2015,10,17,23,16679,17300,16442,-858
2015,10,18,0,17125,17592,16752,-840
2015,10,18,1,16750,17212,16495,-717
2015,10,18,2,16143,16655,16222,-433
2015,10,18,3,15381,15863,15347,-516
2015,10,18,4,14518,14895,14369,-526
2015,10,18,5,13791,14043,13355,-688
2015,10,18,6,13135,13513,13153,-360
2015,10,18,7,12718,13130,12842,-288
2015,10,18,8,12476,12925,12688,-237
2015,10,18,9,12497,12920,12869,-51
2015,10,18,10,12689,13174,13114,-60
2015,10,18,11,13172,13684,13642,-42
2015,10,18,12,13627,14258,14002,-256
2015,10,18,13,14093,15078,15251,173
2015,10,18,14,14718,15723,15636,-87
2015,10,18,15,15124,16030,15906,-124
2015,10,18,16,15314,16244,15728,-516
2015,10,18,17,15370,16345,15562,-783
2015,10,18,18,15321,16331,15226,-1105
2015,10,18,19,15227,16229,15068,-1161
2015,10,18,20,15246,16264,15271,-993
2015,10,18,21,15441,16515,15966,-549
2015,10,18,22,15872,16994,16477,-517
2015,10,18,23,16756,17983,17584,-399
2015,10,19,0,17333,18340,17789,-551
2015,10,19,1,17072,17986,17187,-799
2015,10,19,2,16478,17211,16997,-214
2015,10,19,3,15583,16174,15918,-256
2015,10,19,4,14571,15082,14555,-527
2015,10,19,5,13774,14229,13599,-630
2015,10,19,6,13228,13757,12969,-788
2015,10,19,7,13046,13523,12914,-609
2015,10,19,8,12983,13473,12930,-543
2015,10,19,9,13097,13763,13335,-428
2015,10,19,10,13674,14797,14498,-299
2015,10,19,11,15522,16767,16456,-311
2015,10,19,12,16997,18047,18122,75
2015,10,19,13,17714,18484,18364,-120
2015,10,19,14,18079,18697,17798,-899
2015,10,19,15,18217,18770,17862,-908
2015,10,19,16,18155,18599,18135,-464
2015,10,19,17,18022,18345,17929,-416
2015,10,19,18,17901,18261,17837,-424
2015,10,19,19,17739,18094,17641,-453
2015,10,19,20,17665,18058,17752,-306
2015,10,19,21,17752,18238,17970,-268
2015,10,19,22,18027,18635,18441,-194
2015,10,19,23,18656,19505,19204,-301
2015,10,20,0,19001,19695,19612,-83
2015,10,20,1,18516,19093,19419,326
2015,10,20,2,17656,18098,18189,91
2015,10,20,3,16413,16709,16638,-71
2015,10,20,4,15058,15330,15060,-270
2015,10,20,5,13910,14314,14053,-261
2015,10,20,6,13186,13728,13423,-305
2015,10,20,7,12867,13366,13038,-328
2015,10,20,8,12722,13231,13005,-226
2015,10,20,9,12804,13404,13189,-215
2015,10,20,10,13452,14312,13971,-341
2015,10,20,11,15081,16209,16460,251
2015,10,20,12,16564,17527,18065,538
2015,10,20,13,17253,17985,18485,500
2015,10,20,14,17599,18174,18224,50
2015,10,20,15,17762,18317,18259,-58
2015,10,20,16,17763,18241,18372,131
2015,10,20,17,17704,18142,18287,145
2015,10,20,18,17666,18111,18093,-18
2015,10,20,19,17576,18060,17812,-248
2015,10,20,20,17558,18088,17848,-240
2015,10,20,21,17670,18278,18204,-74
2015,10,20,22,17894,18556,18629,73
2015,10,20,23,18397,19191,18743,-448
2015,10,21,0,18632,19163,19244,81
2015,10,21,1,18122,18477,18308,-169
2015,10,21,2,17277,17464,17221,-243
2015,10,21,3,16061,16174,16203,29
2015,10,21,4,14729,14828,14730,-98
2015,10,21,5,13586,13733,13639,-94
2015,10,21,6,12918,13192,12943,-249
2015,10,21,7,12591,12831,12702,-129
2015,10,21,8,12432,12721,12284,-437
2015,10,21,9,12503,12916,12504,-412
2015,10,21,10,13153,13757,13457,-300
2015,10,21,11,14766,15662,15547,-115
2015,10,21,12,16267,17068,17369,301
2015,10,21,13,17014,17520,17393,-127
2015,10,21,14,17419,17882,18164,282
2015,10,21,15,17652,18123,18258,135
2015,10,21,16,17740,18274,18471,197
2015,10,21,17,17760,18323,18337,14
2015,10,21,18,17814,18383,18425,42
2015,10,21,19,17765,18336,18190,-146
2015,10,21,20,17762,18338,18323,-15
2015,10,21,21,17868,18384,18592,208
2015,10,21,22,18034,18535,18559,24
2015,10,21,23,18535,19145,18901,-244
2015,10,22,0,18705,19112,18894,-218
2015,10,22,1,18143,18482,18433,-49
2015,10,22,2,17271,17477,17521,44
2015,10,22,3,16017,16181,16103,-78
2015,10,22,4,14637,14882,14676,-206
2015,10,22,5,13578,13812,13086,-726
2015,10,22,6,12894,13207,12543,-664
2015,10,22,7,12600,12856,12366,-490
2015,10,22,8,12469,12754,12376,-378
2015,10,22,9,12555,12911,12606,-305
2015,10,22,10,13181,13756,13582,-174
2015,10,22,11,14897,15665,15736,71
2015,10,22,12,16467,17036,17243,207
2015,10,22,13,17160,17606,17730,124
2015,10,22,14,17536,17987,18036,49
2015,10,22,15,17763,18224,18118,-106
2015,10,22,16,17842,18343,17918,-425
2015,10,22,17,17858,18448,18029,-419
2015,10,22,18,17928,18533,17965,-568
2015,10,22,19,17913,18505,17661,-844
2015,10,22,20,17932,18474,17806,-668
2015,10,22,21,18032,18584,17906,-678
2015,10,22,22,18205,18714,18186,-528
2015,10,22,23,18745,19278,18904,-374
2015,10,23,0,18896,19213,18647,-566
2015,10,23,1,18378,18580,17836,-744
2015,10,23,2,17559,17595,16890,-705
2015,10,23,3,16352,16297,15581,-716
2015,10,23,4,15031,14955,14053,-902
2015,10,23,5,13919,13959,12755,-1204
2015,10,23,6,13136,13302,12439,-863
2015,10,23,7,12647,12929,12310,-619
2015,10,23,8,12436,12775,12469,-306
2015,10,23,9,12531,12931,12491,-440
2015,10,23,10,13385,13749,12698,-1051
2015,10,23,11,14833,15635,14633,-1002
2015,10,23,12,16398,16945,16392,-553
2015,10,23,13,17108,17488,17327,-161
2015,10,23,14,17454,17803,17046,-757
2015,10,23,15,17593,17916,16862,-1054
2015,10,23,16,17564,17867,16443,-1424
2015,10,23,17,17447,17744,16657,-1087
2015,10,23,18,17370,17650,17004,-646
2015,10,23,19,17238,17549,16810,-739
2015,10,23,20,17149,17426,16624,-802
2015,10,23,21,17209,17499,16244,-1255
2015,10,23,22,17395,17701,15972,-1729
2015,10,23,23,18041,18356,16832,-1524
2015,10,24,0,18187,18361,17481,-880
2015,10,24,1,17646,17859,17462,-397
2015,10,24,2,16912,17171,16651,-520
2015,10,24,3,15928,16193,15628,-565
2015,10,24,4,14809,15064,14101,-963
2015,10,24,5,13812,14134,13015,-1119
2015,10,24,6,13273,13532,12833,-699
2015,10,24,7,12863,13149,12549,-600
2015,10,24,8,12627,12990,12383,-607
2015,10,24,9,12660,13016,12493,-523
2015,10,24,10,13016,13377,12745,-632
2015,10,24,11,13841,14082,13702,-380
2015,10,24,12,14601,14891,14519,-372
2015,10,24,13,15092,15717,15391,-326
2015,10,24,14,15702,16312,16062,-250
2015,10,24,15,16078,16602,16181,-421
2015,10,24,16,16172,16658,15860,-798
2015,10,24,17,16112,16592,15872,-720
2015,10,24,18,15991,16476,15657,-819
2015,10,24,19,15815,16367,15622,-745
2015,10,24,20,15737,16315,15450,-865
2015,10,24,21,15845,16440,15682,-758
2015,10,24,22,16154,16898,16162,-736
2015,10,24,23,17010,17579,17069,-510
2015,10,25,0,17236,17477,17069,-408
2015,10,25,1,16777,17034,16481,-553
2015,10,25,2,16111,16481,16096,-385
2015,10,25,3,15252,15697,14879,-818
2015,10,25,4,14298,14747,14007,-740
2015,10,25,5,13508,13914,13281,-633
2015,10,25,6,13044,13328,12968,-360
2015,10,25,7,12575,12902,12094,-808
2015,10,25,8,12254,12623,11575,-1048
2015,10,25,9,12202,12538,11642,-896
2015,10,25,10,12309,12720,11872,-848
2015,10,25,11,12870,13172,12464,-708
2015,10,25,12,13468,13781,13620,-161
2015,10,25,13,13913,14635,14309,-326
2015,10,25,14,14511,15500,15141,-359
2015,10,25,15,14953,15999,15709,-290
2015,10,25,16,15206,16265,15980,-285
2015,10,25,17,15318,16311,15924,-387
2015,10,25,18,15323,16208,15398,-810
2015,10,25,19,15266,16043,15170,-873
2015,10,25,20,15281,16010,15074,-936
2015,10,25,21,15468,16168,15235,-933
2015,10,25,22,15873,16530,15979,-551
2015,10,25,23,16766,17454,16847,-607
2015,10,26,0,17096,17587,17198,-389
2015,10,26,1,16749,17136,16844,-292
2015,10,26,2,16099,16345,16142,-203
2015,10,26,3,15178,15326,15052,-274
2015,10,26,4,14145,14237,13778,-459
2015,10,26,5,13324,13413,13052,-361
2015,10,26,6,12804,12966,12868,-98
2015,10,26,7,12592,12700,12270,-430
2015,10,26,8,12523,12660,12048,-612
2015,10,26,9,12643,12934,12095,-839
2015,10,26,10,13278,13979,13002,-977
2015,10,26,11,15141,15977,15105,-872
2015,10,26,12,16744,17412,16929,-483
2015,10,26,13,17369,17858,17329,-529
2015,10,26,14,17653,18096,17529,-567
2015,10,26,15,17728,18148,17260,-888
2015,10,26,16,17652,18056,17164,-892
2015,10,26,17,17511,17918,16876,-1042
2015,10,26,18,17407,17858,16829,-1029
2015,10,26,19,17271,17769,16494,-1275
2015,10,26,20,17197,17736,16666,-1070
2015,10,26,21,17310,17883,16714,-1169
2015,10,26,22,17664,18288,17327,-961
2015,10,26,23,18519,19218,18390,-828
2015,10,27,0,18761,19273,18619,-654
2015,10,27,1,18295,18679,18132,-547
2015,10,27,2,17467,17744,17181,-563
2015,10,27,3,16267,16418,15767,-651
2015,10,27,4,14945,15102,13961,-1141
2015,10,27,5,13823,14148,12674,-1474
2015,10,27,6,13221,13651,12355,-1296
2015,10,27,7,12926,13332,11925,-1407
2015,10,27,8,12813,13255,12067,-1188
2015,10,27,9,12919,13526,12082,-1444
2015,10,27,10,13594,14516,12884,-1632
2015,10,27,11,15402,16505,15358,-1147
2015,10,27,12,17023,17896,16899,-997
2015,10,27,13,17600,18207,17196,-1011
2015,10,27,14,17821,18343,17043,-1300
2015,10,27,15,17862,18349,16945,-1404
2015,10,27,16,17753,18237,16961,-1276
2015,10,27,17,17607,18086,16921,-1165
2015,10,27,18,17501,17997,17175,-822
2015,10,27,19,17368,17851,16978,-873
2015,10,27,20,17293,17809,16540,-1269
2015,10,27,21,17397,17989,16461,-1528
2015,10,27,22,17736,18399,16857,-1542
2015,10,27,23,18524,19298,17819,-1479
2015,10,28,0,18666,19247,17959,-1288
2015,10,28,1,18174,18638,17740,-898
2015,10,28,2,17318,17697,16807,-890
2015,10,28,3,16089,16432,15286,-1146
2015,10,28,4,14737,15146,13771,-1375
2015,10,28,5,13624,14185,12722,-1463
2015,10,28,6,13182,13596,12538,-1058
2015,10,28,7,12947,13229,12235,-994
2015,10,28,8,12822,13098,12318,-780
2015,10,28,9,12893,13282,12389,-893
2015,10,28,10,13476,14208,12960,-1248
2015,10,28,11,15323,16139,14815,-1324
2015,10,28,12,16958,17646,16570,-1076
2015,10,28,13,17577,18205,17220,-985
2015,10,28,14,17940,18618,17572,-1046
2015,10,28,15,18118,18878,17813,-1065
2015,10,28,16,18151,19018,17798,-1220
2015,10,28,17,18112,19028,17891,-1137
2015,10,28,18,18080,19030,18111,-919
2015,10,28,19,17980,18942,18057,-885
2015,10,28,20,17968,19020,18165,-855
2015,10,28,21,18148,19372,18358,-1014
2015,10,28,22,18518,19803,18752,-1051
2015,10,28,23,19160,20088,19393,-695
2015,10,29,0,19180,19706,18913,-793
2015,10,29,1,18628,19018,18306,-712
2015,10,29,2,17761,18022,17478,-544
2015,10,29,3,16542,16698,16068,-630
2015,10,29,4,15187,15331,14082,-1249
2015,10,29,5,14115,14315,12834,-1481
2015,10,29,6,13411,13687,12246,-1441
2015,10,29,7,13019,13306,11949,-1357
2015,10,29,8,12810,13145,11894,-1251
2015,10,29,9,12871,13255,12195,-1060
2015,10,29,10,13556,14093,12618,-1475
2015,10,29,11,15199,16039,14737,-1302
2015,10,29,12,16964,17475,15854,-1621
2015,10,29,13,17752,17973,16010,-1963
2015,10,29,14,18213,18327,16293,-2034
2015,10,29,15,18440,18528,16601,-1927
2015,10,29,16,18461,18668,16650,-2018
2015,10,29,17,18401,18535,16411,-2124
2015,10,29,18,18335,18492,16654,-1838
2015,10,29,19,18265,18316,16504,-1812
2015,10,29,20,18196,18189,16601,-1588
2015,10,29,21,18202,18270,16654,-1616
2015,10,29,22,18383,18592,17267,-1325
2015,10,29,23,18889,19185,17799,-1386
2015,10,30,0,18821,18979,17830,-1149
2015,10,30,1,18189,18394,17441,-953
2015,10,30,2,17271,17509,16639,-870
2015,10,30,3,16040,16231,15451,-780
2015,10,30,4,14703,14907,14059,-848
2015,10,30,5,13766,13912,13167,-745
2015,10,30,6,13096,13333,12559,-774
2015,10,30,7,12780,12950,12299,-651
2015,10,30,8,12646,12799,12563,-236
2015,10,30,9,12732,12955,12700,-255
2015,10,30,10,13380,13861,13296,-565
2015,10,30,11,15046,15733,14712,-1021
2015,10,30,12,16697,17216,16315,-901
2015,10,30,13,17359,17601,16542,-1059
2015,10,30,14,17714,17834,16269,-1565
2015,10,30,15,17859,17927,16416,-1511
2015,10,30,16,17873,17978,16561,-1417
2015,10,30,17,17806,17786,16415,-1371
2015,10,30,18,17725,17706,16362,-1344
2015,10,30,19,17610,17555,16169,-1386
2015,10,30,20,17512,17460,15940,-1520
2015,10,30,21,17542,17489,15907,-1582
2015,10,30,22,17796,17772,15831,-1941
2015,10,30,23,18434,18425,16802,-1623
2015,10,31,0,18418,18336,17067,-1269
2015,10,31,1,17864,17839,16498,-1341
2015,10,31,2,17131,17174,16129,-1045
2015,10,31,3,16164,16181,14684,-1497
2015,10,31,4,15071,15050,13080,-1970
2015,10,31,5,13968,14106,12043,-2063
2015,10,31,6,13380,13511,11642,-1869
2015,10,31,7,12964,13156,11666,-1490
2015,10,31,8,12748,12972,11525,-1447
2015,10,31,9,12784,13002,11244,-1758
2015,10,31,10,13142,13342,11222,-2120
2015,10,31,11,13942,14122,12267,-1855
2015,10,31,12,14764,14938,13232,-1706
2015,10,31,13,15237,15720,14167,-1553
2015,10,31,14,15849,16286,14410,-1876
2015,10,31,15,16215,16512,14751,-1761
2015,10,31,16,16320,16486,14656,-1830
2015,10,31,17,16289,16280,14617,-1663
2015,10,31,18,16168,16085,14639,-1446
2015,10,31,19,16000,15930,14442,-1488
2015,10,31,20,15903,15880,14306,-1574
2015,10,31,21,15991,16077,14378,-1699
2015,10,31,22,16395,16424,14600,-1824
2015,10,31,23,17230,17137,15331,-1806
2015,11,1,0,17334,17005,15430,-1575
2015,11,1,1,16884,16711,15119,-1592
2015,11,1,2,16248,16235,14332,-1903
2015,11,1,3,15399,15481,13737,-1744
2015,11,1,4,14485,14611,12426,-2185
2015,11,1,5,13619,13775,12196,-1579
2015,11,1,6,13198,13221,11719,-1502
2015,11,1,7,12909,12837,11430,-1407
2015,11,1,8,12644,12617,11465,-1152
2015,11,1,9,12458,12516,10976,-1540
2015,11,1,10,11856,12534,11248,-1286
2015,11,1,11,12187,12816,11549,-1267
2015,11,1,12,12749,13352,12421,-931
2015,11,1,13,13489,14016,12891,-1125
2015,11,1,14,14326,14984,13353,-1631
2015,11,1,15,14966,15626,13999,-1627
2015,11,1,16,15369,15953,14744,-1209
2015,11,1,17,15549,16093,14777,-1316
2015,11,1,18,15526,16088,14964,-1124
2015,11,1,19,15529,16011,14958,-1053
2015,11,1,20,15519,16001,14994,-1007
2015,11,1,21,15667,16126,15154,-972
2015,11,1,22,16183,16638,15666,-972
2015,11,1,23,17290,17944,16739,-1205
2015,11,2,0,17558,17969,17056,-913
2015,11,2,1,17344,17570,16757,-813
2015,11,2,2,16977,16992,16025,-967
2015,11,2,3,16414,16023,15035,-988
2015,11,2,4,15490,15072,14082,-990
2015,11,2,5,14432,14110,13166,-944
2015,11,2,6,13690,13421,12367,-1054
2015,11,2,7,12998,12891,11904,-987
2015,11,2,8,12534,12623,11697,-926
2015,11,2,9,12393,12591,11718,-873
2015,11,2,10,12665,12901,12153,-748
2015,11,2,11,13613,13972,13178,-794
2015,11,2,12,15394,15888,14599,-1289
2015,11,2,13,16561,16957,16057,-900
2015,11,2,14,17198,17503,15986,-1517
2015,11,2,15,17596,17835,16158,-1677
2015,11,2,16,17816,18038,16276,-1762
2015,11,2,17,17835,18084,16551,-1533
2015,11,2,18,17745,17981,16527,-1454
2015,11,2,19,17690,17933,16510,-1423
2015,11,2,20,17594,17877,16646,-1231
2015,11,2,21,17714,17902,16491,-1411
2015,11,2,22,18261,18420,16589,-1831
2015,11,2,23,19284,19568,17681,-1887
2015,11,3,0,19385,19491,17534,-1957
2015,11,3,1,18946,18975,17219,-1756
2015,11,3,2,18325,18224,16796,-1428
2015,11,3,3,17403,17211,15831,-1380
2015,11,3,4,16096,15904,14786,-1118
2015,11,3,5,14692,14653,13725,-928
2015,11,3,6,14029,13765,12396,-1369
2015,11,3,7,13277,13259,12028,-1231
2015,11,3,8,12811,12981,11882,-1099
2015,11,3,9,12630,12902,11725,-1177
2015,11,3,10,12840,13195,11820,-1375
2015,11,3,11,13841,14195,12926,-1269
2015,11,3,12,15617,15841,14492,-1349
2015,11,3,13,16689,16872,15606,-1266
2015,11,3,14,17236,17406,16268,-1138
2015,11,3,15,17614,17705,16318,-1387
2015,11,3,16,17812,17932,16108,-1824
2015,11,3,17,17866,18021,16311,-1710
2015,11,3,18,17799,18036,16578,-1458
2015,11,3,19,17774,18124,16804,-1320
2015,11,3,20,17689,18151,16772,-1379
2015,11,3,21,17750,18202,16702,-1500
2015,11,3,22,18126,18534,16953,-1581
2015,11,3,23,19130,19615,17770,-1845
2015,11,4,0,19223,19507,17779,-1728
2015,11,4,1,18813,18911,17536,-1375
2015,11,4,2,18210,18162,16859,-1303
2015,11,4,3,17304,17096,15735,-1361
2015,11,4,4,15981,15816,14283,-1533
2015,11,4,5,14571,14571,13114,-1457
2015,11,4,6,13925,13611,11845,-1766
2015,11,4,7,13230,13077,11701,-1376
2015,11,4,8,12768,12794,11531,-1263
2015,11,4,9,12587,12705,11451,-1254
2015,11,4,10,12790,12962,11747,-1215
2015,11,4,11,13846,13934,12606,-1328
2015,11,4,12,15621,15769,14280,-1489
2015,11,4,13,16663,16876,15567,-1309
2015,11,4,14,17222,17444,16122,-1322
2015,11,4,15,17629,17746,16141,-1605
2015,11,4,16,17851,18009,16311,-1698
2015,11,4,17,17926,18123,16307,-1816
2015,11,4,18,17886,18120,16318,-1802
2015,11,4,19,17877,18202,16096,-2106
2015,11,4,20,17789,18200,16001,-2199
2015,11,4,21,17846,18212,15916,-2296
2015,11,4,22,18202,18535,16349,-2186
2015,11,4,23,19211,19579,17522,-2057
2015,11,5,0,19255,19486,17437,-2049
2015,11,5,1,18814,18923,17323,-1600
2015,11,5,2,18214,18216,17067,-1149
2015,11,5,3,17287,17165,16128,-1037
2015,11,5,4,15969,15844,14757,-1087
2015,11,5,5,14584,14578,13444,-1134
2015,11,5,6,13872,13663,12135,-1528
2015,11,5,7,13174,13128,12001,-1127
2015,11,5,8,12724,12822,11763,-1059
2015,11,5,9,12553,12720,11774,-946
2015,11,5,10,12725,12945,11837,-1108
2015,11,5,11,13785,13884,12480,-1404
2015,11,5,12,15536,15709,14147,-1562
2015,11,5,13,16630,16996,15664,-1332
2015,11,5,14,17246,17677,16219,-1458
2015,11,5,15,17687,18160,16283,-1877
2015,11,5,16,17944,18490,16517,-1973
2015,11,5,17,18031,18544,16535,-2009
2015,11,5,18,17995,18580,16696,-1884
2015,11,5,19,18040,18651,16633,-2018
2015,11,5,20,18010,18689,16758,-1931
2015,11,5,21,18087,18741,16456,-2285
2015,11,5,22,18500,19197,16942,-2255
2015,11,5,23,19484,20065,17995,-2070
2015,11,6,0,19419,19842,17963,-1879
2015,11,6,1,18902,19319,17644,-1675
2015,11,6,2,18283,18605,17280,-1325
2015,11,6,3,17353,17629,16302,-1327
2015,11,6,4,16096,16279,14656,-1623
2015,11,6,5,14724,15010,13512,-1498
2015,11,6,6,14130,14006,12638,-1368
2015,11,6,7,13539,13403,12400,-1003
2015,11,6,8,13143,13084,12307,-777
2015,11,6,9,12936,12965,12255,-710
2015,11,6,10,12967,13167,12211,-956
2015,11,6,11,14103,14122,12846,-1276
2015,11,6,12,15894,15949,14447,-1502
2015,11,6,13,17151,17368,15813,-1555
2015,11,6,14,17989,18277,16574,-1703
2015,11,6,15,18552,18819,16810,-2009
2015,11,6,16,18907,19087,17002,-2085
2015,11,6,17,19030,19254,17245,-2009
2015,11,6,18,19000,19258,17328,-1930
2015,11,6,19,19016,19209,17239,-1970
2015,11,6,20,18961,19091,17103,-1988
2015,11,6,21,18990,19043,17100,-1943
2015,11,6,22,19275,19337,17734,-1603
2015,11,6,23,20011,20071,18153,-1918
2015,11,7,0,19754,19662,17821,-1841
2015,11,7,1,19106,19026,17258,-1768
2015,11,7,2,18504,18303,17122,-1181
2015,11,7,3,17734,17472,16277,-1195
2015,11,7,4,16594,16394,14884,-1510
2015,11,7,5,15238,15191,13616,-1575
2015,11,7,6,14300,14190,12341,-1849
2015,11,7,7,13528,13523,11882,-1641
2015,11,7,8,12990,13109,11610,-1499
2015,11,7,9,12635,12861,11695,-1166
2015,11,7,10,12007,12817,11328,-1489
2015,11,7,11,12387,13098,11802,-1296
2015,11,7,12,13254,13678,12355,-1323
2015,11,7,13,14253,14502,13027,-1475
2015,11,7,14,15188,15516,13983,-1533
2015,11,7,15,15822,16140,14531,-1609
2015,11,7,16,16142,16519,14936,-1583
2015,11,7,17,16187,16638,14829,-1809
2015,11,7,18,16015,16593,14777,-1816
2015,11,7,19,15893,16487,14607,-1880
2015,11,7,20,15810,16382,14096,-2286
2015,11,7,21,15879,16443,14388,-2055
2015,11,7,22,16349,17008,14888,-2120
2015,11,7,23,17426,17872,15517,-2355
2015,11,8,0,17508,17766,15537,-2229
2015,11,8,1,17077,17354,15724,-1630
2015,11,8,2,16660,16907,15192,-1715
2015,11,8,3,16161,16323,14631,-1692
2015,11,8,4,15401,15528,13953,-1575
2015,11,8,5,14421,14621,13131,-1490
2015,11,8,6,13480,13785,12671,-1114
2015,11,8,7,12950,13215,12377,-838
2015,11,8,8,12573,12851,11825,-1026
2015,11,8,9,12318,12647,11742,-905
2015,11,8,10,11745,12645,11661,-984
2015,11,8,11,11933,12906,12047,-859
2015,11,8,12,12580,13326,12278,-1048
2015,11,8,13,13342,13843,12655,-1188
2015,11,8,14,14080,14646,13287,-1359
2015,11,8,15,14600,15190,13842,-1348
2015,11,8,16,14923,15499,13978,-1521
2015,11,8,17,15049,15706,13878,-1828
2015,11,8,18,14949,15754,13806,-1948
2015,11,8,19,14897,15734,13662,-2072
2015,11,8,20,14884,15730,13607,-2123
2015,11,8,21,15016,15902,14217,-1685
2015,11,8,22,15601,16586,14951,-1635
2015,11,8,23,16923,17963,16161,-1802
2015,11,9,0,17291,18094,16486,-1608
2015,11,9,1,17136,17810,16382,-1428
2015,11,9,2,16798,17358,16108,-1250
2015,11,9,3,16211,16536,15145,-1391
2015,11,9,4,15329,15539,14262,-1277
2015,11,9,5,14333,14523,13302,-1221
2015,11,9,6,13434,13803,12444,-1359
2015,11,9,7,12892,13362,12506,-856
2015,11,9,8,12624,13118,12309,-809
2015,11,9,9,12575,13075,12129,-946
2015,11,9,10,12924,13413,12557,-856
2015,11,9,11,13675,14458,13425,-1033
2015,11,9,12,15432,16322,14806,-1516
2015,11,9,13,16624,17425,15866,-1559
2015,11,9,14,17167,17859,16238,-1621
2015,11,9,15,17434,18077,16362,-1715
2015,11,9,16,17519,18102,16041,-2061
2015,11,9,17,17466,17987,15814,-2173
2015,11,9,18,17302,17852,15639,-2213
2015,11,9,19,17190,17844,15608,-2236
2015,11,9,20,17061,17796,15495,-2301
2015,11,9,21,17084,17895,15253,-2642
2015,11,9,22,17557,18594,15854,-2740
2015,11,9,23,18828,19805,17190,-2615
2015,11,10,0,18992,19718,17388,-2330
2015,11,10,1,18640,19300,17235,-2065
2015,11,10,2,18011,18616,16934,-1682
2015,11,10,3,17058,17649,16321,-1328
2015,11,10,4,15812,16340,15555,-785
2015,11,10,5,14540,14968,14279,-689
2015,11,10,6,13700,13937,12771,-1166
2015,11,10,7,13119,13433,12728,-705
2015,11,10,8,12776,13100,12556,-544
2015,11,10,9,12666,13023,12387,-636
2015,11,10,10,12944,13278,12779,-499
2015,11,10,11,13746,14232,13662,-570
2015,11,10,12,15410,16097,15201,-896
2015,11,10,13,16589,17337,16175,-1162
2015,11,10,14,17219,17983,16628,-1355
2015,11,10,15,17560,18431,16704,-1727
2015,11,10,16,17778,18661,16750,-1911
2015,11,10,17,17830,18750,16956,-1794
2015,11,10,18,17777,18674,17161,-1513
2015,11,10,19,17762,18637,17207,-1430
2015,11,10,20,17717,18583,17308,-1275
2015,11,10,21,17809,18777,17179,-1598
2015,11,10,22,18300,19394,17551,-1843
2015,11,10,23,19268,20106,18047,-2059
2015,11,11,0,19225,19772,17872,-1900
2015,11,11,1,18680,19222,17948,-1274
2015,11,11,2,17955,18464,17542,-922
2015,11,11,3,16940,17486,16845,-641
2015,11,11,4,15716,16254,15572,-682
2015,11,11,5,14462,15030,14223,-807
2015,11,11,6,13531,14072,13013,-1059
2015,11,11,7,12923,13471,12367,-1104
2015,11,11,8,12586,13119,12289,-830
2015,11,11,9,12443,12995,12259,-736
2015,11,11,10,12674,13190,12383,-807
2015,11,11,11,13482,13979,12903,-1076
2015,11,11,12,15113,15235,14119,-1116
2015,11,11,13,16278,16469,15038,-1431
2015,11,11,14,16927,17445,15977,-1468
2015,11,11,15,17297,17987,16217,-1770
2015,11,11,16,17547,18273,16591,-1682
2015,11,11,17,17624,18344,16380,-1964
2015,11,11,18,17606,18279,16270,-2009
2015,11,11,19,17611,18241,16011,-2230
2015,11,11,20,17539,18183,16582,-1601
2015,11,11,21,17582,18240,16748,-1492
2015,11,11,22,18087,18868,17009,-1859
2015,11,11,23,19106,19783,18201,-1582
2015,11,12,0,19067,19617,17746,-1871
2015,11,12,1,18578,19116,17016,-2100
2015,11,12,2,17890,18419,16610,-1809
2015,11,12,3,16931,17482,15729,-1753
2015,11,12,4,15719,16220,14738,-1482
2015,11,12,5,14489,14948,13655,-1293
2015,11,12,6,13623,13913,12722,-1191
2015,11,12,7,13008,13358,12359,-999
2015,11,12,8,12651,13001,12132,-869
2015,11,12,9,12511,12906,12124,-782
2015,11,12,10,12826,13160,12364,-796
2015,11,12,11,13619,14156,13036,-1120
2015,11,12,12,15249,15999,14612,-1387
2015,11,12,13,16408,17352,15762,-1590
2015,11,12,14,17054,17981,16429,-1552
2015,11,12,15,17403,18407,16695,-1712
2015,11,12,16,17647,18681,16932,-1749
2015,11,12,17,17712,18733,16977,-1756
2015,11,12,18,17689,18684,16888,-1796
2015,11,12,19,17731,18743,16732,-2011
2015,11,12,20,17706,18691,16762,-1929
2015,11,12,21,17799,18786,16858,-1928
2015,11,12,22,18303,19390,17303,-2087
2015,11,12,23,19270,20173,17828,-2345
2015,11,13,0,19161,19933,17728,-2205
2015,11,13,1,18624,19348,17591,-1757
2015,11,13,2,17936,18626,17351,-1275
2015,11,13,3,16980,17603,16575,-1028
2015,11,13,4,15783,16346,15813,-533
2015,11,13,5,14535,15032,14617,-415
2015,11,13,6,13611,13993,13368,-625
2015,11,13,7,12977,13409,12820,-589
2015,11,13,8,12629,13019,12354,-665
2015,11,13,9,12471,12916,12356,-560
2015,11,13,10,12710,13123,12342,-781
2015,11,13,11,13472,14031,12720,-1311
2015,11,13,12,15113,15821,14295,-1526
2015,11,13,13,16336,17026,15573,-1453
2015,11,13,14,17002,17602,15964,-1638
2015,11,13,15,17407,17925,16250,-1675
2015,11,13,16,17675,18155,16170,-1985
2015,11,13,17,17738,18192,16189,-2003
2015,11,13,18,17685,18110,16270,-1840
2015,11,13,19,17672,18068,16565,-1503
2015,11,13,20,17576,17970,16213,-1757
2015,11,13,21,17588,18027,16234,-1793
2015,11,13,22,18011,18646,16853,-1793
2015,11,13,23,18958,19553,17406,-2147
2015,11,14,0,18816,19374,17163,-2211
2015,11,14,1,18299,18837,16929,-1908
2015,11,14,2,17723,18204,16668,-1536
2015,11,14,3,17009,17395,15769,-1626
2015,11,14,4,16043,16366,14676,-1690
2015,11,14,5,14912,15180,13722,-1458
2015,11,14,6,13909,14265,13042,-1223
2015,11,14,7,13352,13695,13193,-502
2015,11,14,8,13018,13321,12873,-448
2015,11,14,9,12778,13139,12797,-342
2015,11,14,10,12439,13182,12942,-240
2015,11,14,11,12710,13567,13215,-352
2015,11,14,12,13386,14224,13724,-500
2015,11,14,13,14294,14930,14252,-678
2015,11,14,14,15215,15819,14861,-958
2015,11,14,15,15845,16474,15245,-1229
2015,11,14,16,16210,16795,16062,-733
2015,11,14,17,16308,16849,15817,-1032
2015,11,14,18,16209,16779,15517,-1262
2015,11,14,19,16135,16671,15489,-1182
2015,11,14,20,16059,16618,15478,-1140
2015,11,14,21,16087,16700,15481,-1219
2015,11,14,22,16599,17340,16174,-1166
2015,11,14,23,17828,18449,16964,-1485
2015,11,15,0,17946,18373,16514,-1859
2015,11,15,1,17672,18000,15961,-2039
2015,11,15,2,17270,17552,15902,-1650
2015,11,15,3,16744,16862,15617,-1245
2015,11,15,4,15987,16033,14306,-1727
2015,11,15,5,15086,15100,13767,-1333
2015,11,15,6,13986,14281,12768,-1513
2015,11,15,7,13445,13736,12694,-1042
2015,11,15,8,13097,13371,12233,-1138
2015,11,15,9,12837,13174,12204,-970
2015,11,15,10,12351,13177,12044,-1133
2015,11,15,11,12473,13418,12432,-986
2015,11,15,12,12968,13827,12703,-1124
2015,11,15,13,13698,14280,13001,-1279
2015,11,15,14,14465,14948,13407,-1541
2015,11,15,15,15026,15428,14227,-1201
2015,11,15,16,15368,15677,14148,-1529
2015,11,15,17,15545,15804,14180,-1624
2015,11,15,18,15481,15804,14359,-1445
2015,11,15,19,15421,15767,14372,-1395
2015,11,15,20,15350,15804,14458,-1346
2015,11,15,21,15426,15932,14388,-1544
2015,11,15,22,16082,16711,15162,-1549
2015,11,15,23,17386,18094,15922,-2172
2015,11,16,0,17615,18177,15887,-2290
2015,11,16,1,17444,17807,15832,-1975
2015,11,16,2,17037,17325,15824,-1501
2015,11,16,3,16365,16531,15022,-1509
2015,11,16,4,15479,15458,13766,-1692
2015,11,16,5,14509,14312,12878,-1434
2015,11,16,6,13474,13542,12258,-1284
2015,11,16,7,12949,13082,12524,-558
2015,11,16,8,12699,12854,12269,-585
2015,11,16,9,12670,12846,12461,-385
2015,11,16,10,13147,13141,12357,-784
2015,11,16,11,13836,14139,12839,-1300
2015,11,16,12,15433,16026,14410,-1616
2015,11,16,13,16591,17100,15309,-1791
2015,11,16,14,17210,17557,15965,-1592
2015,11,16,15,17555,17786,15689,-2097
2015,11,16,16,17758,17868,15516,-2352
2015,11,16,17,17825,17854,15024,-2830
2015,11,16,18,17733,17873,15108,-2765
2015,11,16,19,17678,17876,15664,-2212
2015,11,16,20,17583,17859,15655,-2204
2015,11,16,21,17573,17909,15926,-1983
2015,11,16,22,18143,18544,16584,-1960
2015,11,16,23,19323,19730,17710,-2020
2015,11,17,0,19413,19594,17452,-2142
2015,11,17,1,19071,19158,16907,-2251
2015,11,17,2,18453,18517,16314,-2203
2015,11,17,3,17478,17570,15690,-1880
2015,11,17,4,16273,16301,14492,-1809
2015,11,17,5,15011,14962,13395,-1567
2015,11,17,6,13870,14052,12728,-1324
2015,11,17,7,13275,13520,12373,-1147
2015,11,17,8,12972,13270,12189,-1081
2015,11,17,9,12900,13242,12166,-1076
2015,11,17,10,13349,13542,12531,-1011
2015,11,17,11,14078,14629,13491,-1138
2015,11,17,12,15722,16598,14848,-1750
2015,11,17,13,16852,17668,15803,-1865
2015,11,17,14,17377,18078,16258,-1820
2015,11,17,15,17665,18186,16086,-2100
2015,11,17,16,17798,18181,16216,-1965
2015,11,17,17,17787,18111,15924,-2187
2015,11,17,18,17655,17981,15748,-2233
2015,11,17,19,17557,17955,15812,-2143
2015,11,17,20,17463,17940,15698,-2242
2015,11,17,21,17470,18085,15865,-2220
2015,11,17,22,18062,18941,16293,-2648
2015,11,17,23,19332,20221,17404,-2817
2015,11,18,0,19437,20112,17429,-2683
2015,11,18,1,19106,19687,17339,-2348
2015,11,18,2,18495,19050,17100,-1950
2015,11,18,3,17493,18076,16366,-1710
2015,11,18,4,16231,16731,14785,-1946
2015,11,18,5,14941,15347,14020,-1327
2015,11,18,6,14008,14397,13486,-911
2015,11,18,7,13440,13852,13378,-474
2015,11,18,8,13060,13538,13305,-233
2015,11,18,9,12936,13433,13255,-178
2015,11,18,10,13290,13681,13384,-297
2015,11,18,11,14089,14638,13866,-772
2015,11,18,12,15666,16561,14962,-1599
2015,11,18,13,16808,17721,16151,-1570
2015,11,18,14,17363,18148,16350,-1798
2015,11,18,15,17667,18291,16474,-1817
2015,11,18,16,17850,18283,16330,-1953
2015,11,18,17,17838,18235,16532,-1703
2015,11,18,18,17759,18143,16509,-1634
2015,11,18,19,17722,18187,16670,-1517
2015,11,18,20,17700,18184,16676,-1508
2015,11,18,21,17766,18376,16755,-1621
2015,11,18,22,18352,19244,17540,-1704
2015,11,18,23,19419,20098,18124,-1974
2015,11,19,0,19280,19844,17769,-2075
2015,11,19,1,18769,19317,17688,-1629
2015,11,19,2,18110,18635,17550,-1085
2015,11,19,3,17114,17632,16622,-1010
2015,11,19,4,15868,16310,15260,-1050
2015,11,19,5,14557,14938,14178,-760
2015,11,19,6,13758,13940,13032,-908
2015,11,19,7,13175,13383,12816,-567
2015,11,19,8,12846,13066,12819,-247
2015,11,19,9,12687,12957,12667,-290
2015,11,19,10,12930,13152,12773,-379
2015,11,19,11,13806,14060,13124,-936
2015,11,19,12,15453,15935,14250,-1685
2015,11,19,13,16710,17202,15747,-1455
2015,11,19,14,17417,17800,16018,-1782
2015,11,19,15,17841,18202,16460,-1742
2015,11,19,16,18114,18444,16220,-2224
2015,11,19,17,18180,18531,16395,-2136
2015,11,19,18,18150,18565,16385,-2180
2015,11,19,19,18151,18564,16552,-2012
2015,11,19,20,18130,18535,16374,-2161
2015,11,19,21,18159,18653,16065,-2588
2015,11,19,22,18701,19319,16788,-2531
2015,11,19,23,19677,20061,17342,-2719
2015,11,20,0,19495,19801,16926,-2875
2015,11,20,1,18959,19299,16397,-2902
2015,11,20,2,18257,18611,16178,-2433
2015,11,20,3,17270,17559,15472,-2087
2015,11,20,4,16079,16341,14546,-1795
2015,11,20,5,14766,15018,13502,-1516
2015,11,20,6,13792,14034,12633,-1401
2015,11,20,7,13052,13431,12487,-944
2015,11,20,8,12639,13058,12194,-864
2015,11,20,9,12474,12922,12126,-796
2015,11,20,10,12751,13109,12371,-738
2015,11,20,11,13494,13988,12937,-1051
2015,11,20,12,15154,15825,13925,-1900
2015,11,20,13,16464,16932,15298,-1634
2015,11,20,14,17126,17475,15928,-1547
2015,11,20,15,17482,17775,15605,-2170
2015,11,20,16,17705,17836,15887,-1949
2015,11,20,17,17749,17792,15649,-2143
2015,11,20,18,17650,17701,15711,-1990
2015,11,20,19,17575,17667,15553,-2114
2015,11,20,20,17472,17645,16036,-1609
2015,11,20,21,17437,17705,16302,-1403
2015,11,20,22,17921,18345,16272,-2073
2015,11,20,23,19058,19423,17051,-2372
2015,11,21,0,18992,19171,16768,-2403
2015,11,21,1,18542,18640,16795,-1845
2015,11,21,2,17995,18104,16937,-1167
2015,11,21,3,17254,17353,16069,-1284
2015,11,21,4,16228,16320,14737,-1583
2015,11,21,5,15003,15217,14087,-1130
2015,11,21,6,13936,14305,12297,-2008
2015,11,21,7,13380,13713,11599,-2114
2015,11,21,8,13033,13385,11577,-1808
2015,11,21,9,12803,13211,11707,-1504
2015,11,21,10,12435,13285,11472,-1813
2015,11,21,11,12755,13693,11791,-1902
2015,11,21,12,13521,14379,12960,-1419
2015,11,21,13,14513,15101,13723,-1378
2015,11,21,14,15330,15934,13947,-1987
2015,11,21,15,15848,16430,14631,-1799
2015,11,21,16,16127,16641,14920,-1721
2015,11,21,17,16177,16609,15014,-1595
2015,11,21,18,16040,16491,15258,-1233
2015,11,21,19,15919,16334,15274,-1060
2015,11,21,20,15827,16290,15420,-870
2015,11,21,21,15897,16407,15038,-1369
2015,11,21,22,16560,17232,15761,-1471
2015,11,21,23,17844,18314,16751,-1563
2015,11,22,0,17905,18222,17063,-1159
2015,11,22,1,17535,17810,16700,-1110
2015,11,22,2,17094,17325,16001,-1324
2015,11,22,3,16503,16653,15343,-1310
2015,11,22,4,15703,15796,14526,-1270
2015,11,22,5,14676,14823,13296,-1527
2015,11,22,6,13719,14010,13647,-363
2015,11,22,7,13235,13443,13538,95
2015,11,22,8,12928,13041,13054,13
2015,11,22,9,12710,12813,12808,-5
2015,11,22,10,12245,12814,12645,-169
2015,11,22,11,12316,13029,12742,-287
2015,11,22,12,12869,13517,13513,-4
2015,11,22,13,13698,14040,13985,-55
2015,11,22,14,14422,14876,14706,-170
2015,11,22,15,14945,15550,15096,-454
2015,11,22,16,15312,16010,14676,-1334
2015,11,22,17,15467,16303,15208,-1095
2015,11,22,18,15478,16475,15246,-1229
2015,11,22,19,15483,16576,15700,-876
2015,11,22,20,15526,16659,15282,-1377
2015,11,22,21,15686,16931,15733,-1198
2015,11,22,22,16400,17847,16585,-1262
2015,11,22,23,17702,18819,17216,-1603
2015,11,23,0,17915,18769,17056,-1713
2015,11,23,1,17748,18467,16699,-1768
2015,11,23,2,17399,17974,16395,-1579
2015,11,23,3,16771,17172,15748,-1424
2015,11,23,4,15954,16063,14530,-1533
2015,11,23,5,15011,14983,13878,-1105
2015,11,23,6,13995,14194,13292,-902
2015,11,23,7,13576,13755,12940,-815
2015,11,23,8,13376,13547,12822,-725
2015,11,23,9,13389,13528,12427,-1101
2015,11,23,10,13808,13852,12845,-1007
2015,11,23,11,14529,14916,13806,-1110
2015,11,23,12,16187,16854,15239,-1615
2015,11,23,13,17382,18041,16655,-1386
2015,11,23,14,17900,18532,17305,-1227
2015,11,23,15,18175,18758,17321,-1437
2015,11,23,16,18288,18828,17134,-1694
2015,11,23,17,18265,18828,17309,-1519
2015,11,23,18,18178,18731,17047,-1684
2015,11,23,19,18143,18706,17233,-1473
2015,11,23,20,18120,18715,17391,-1324
2015,11,23,21,18220,18900,17728,-1172
2015,11,23,22,18809,19807,18140,-1667
2015,11,23,23,20101,20993,19177,-1816
2015,11,24,0,20175,20913,19063,-1850
2015,11,24,1,19771,20538,18635,-1903
2015,11,24,2,19168,19908,18197,-1711
2015,11,24,3,18207,18885,17375,-1510
2015,11,24,4,16977,17583,15969,-1614
2015,11,24,5,15712,16205,14816,-1389
2015,11,24,6,14774,15191,13517,-1674
2015,11,24,7,14186,14605,12904,-1701
2015,11,24,8,13902,14290,12803,-1487
2015,11,24,9,13841,14218,12819,-1399
2015,11,24,10,14231,14473,12969,-1504
2015,11,24,11,14973,15544,14010,-1534
2015,11,24,12,16559,17397,16245,-1152
2015,11,24,13,17680,18622,16817,-1805
2015,11,24,14,18124,19079,17477,-1602
2015,11,24,15,18318,19194,17938,-1256
2015,11,24,16,18347,19154,17838,-1316
2015,11,24,17,18245,19020,17830,-1190
2015,11,24,18,18172,18875,17373,-1502
2015,11,24,19,18147,18823,17072,-1751
2015,11,24,20,18118,18763,16984,-1779
2015,11,24,21,18210,18879,17353,-1526
2015,11,24,22,18793,19692,18234,-1458
2015,11,24,23,20047,20739,18971,-1768
2015,11,25,0,20111,20562,18905,-1657
2015,11,25,1,19704,20177,18827,-1350
2015,11,25,2,19127,19560,18492,-1068
2015,11,25,3,18193,18646,17529,-1117
2015,11,25,4,16985,17373,16016,-1357
2015,11,25,5,15723,16027,14913,-1114
2015,11,25,6,14697,15038,13349,-1689
2015,11,25,7,14077,14486,12859,-1627
2015,11,25,8,13737,14143,12837,-1306
2015,11,25,9,13644,14056,12606,-1450
2015,11,25,10,14029,14340,12847,-1493
2015,11,25,11,14794,15264,13438,-1826
2015,11,25,12,16448,16991,15255,-1736
2015,11,25,13,17542,18123,16699,-1424
2015,11,25,14,17963,18657,16704,-1953
2015,11,25,15,18168,18900,16831,-2069
2015,11,25,16,18202,18875,16643,-2232
2015,11,25,17,18140,18742,16801,-1941
2015,11,25,18,18045,18512,16314,-2198
2015,11,25,19,17977,18355,16005,-2350
2015,11,25,20,17917,18249,15814,-2435
2015,11,25,21,17992,18285,16101,-2184
2015,11,25,22,18587,19006,17320,-1686
2015,11,25,23,19854,20080,18323,-1757
2015,11,26,0,19907,19923,17479,-2444
2015,11,26,1,19550,19490,17023,-2467
2015,11,26,2,18953,18903,16873,-2030
2015,11,26,3,18000,18097,16385,-1712
2015,11,26,4,16757,16961,14975,-1986
2015,11,26,5,15468,15731,14114,-1617
2015,11,26,6,14451,14679,13265,-1414
2015,11,26,7,13803,14019,12900,-1119
2015,11,26,8,13354,13586,12782,-804
2015,11,26,9,13101,13370,12714,-656
2015,11,26,10,12868,13444,12849,-595
2015,11,26,11,13258,13796,12862,-934
2015,11,26,12,13710,14372,13368,-1004
2015,11,26,13,14261,14922,13741,-1181
2015,11,26,14,14977,15694,14196,-1498
2015,11,26,15,15585,16373,14818,-1555
2015,11,26,16,15967,16776,15279,-1497
2015,11,26,17,16150,16936,14751,-2185
2015,11,26,18,16053,16811,14567,-2244
2015,11,26,19,15767,16399,14354,-2045
2015,11,26,20,15425,15919,14121,-1798
2015,11,26,21,15229,15576,14362,-1214
2015,11,26,22,15313,15814,14541,-1273
2015,11,26,23,15714,16274,14786,-1488
2015,11,27,0,15534,16119,14867,-1252
2015,11,27,1,15380,15924,14611,-1313
2015,11,27,2,15268,15721,14190,-1531
2015,11,27,3,15082,15452,13738,-1714
2015,11,27,4,14667,14865,13360,-1505
2015,11,27,5,14052,14103,12709,-1394
2015,11,27,6,13273,13370,11952,-1418
2015,11,27,7,12765,12911,11849,-1062
2015,11,27,8,12449,12626,12089,-537
2015,11,27,9,12302,12510,11756,-754
2015,11,27,10,12356,12676,12055,-621
2015,11,27,11,12836,13176,12189,-987
2015,11,27,12,13577,14045,13429,-616
2015,11,27,13,14312,14785,13954,-831
2015,11,27,14,15059,15464,14230,-1234
2015,11,27,15,15609,16007,14638,-1369
2015,11,27,16,15891,16358,15083,-1275
2015,11,27,17,16029,16476,15306,-1170
2015,11,27,18,16078,16460,15127,-1333
2015,11,27,19,16031,16361,15203,-1158
2015,11,27,20,16003,16406,15490,-916
2015,11,27,21,16144,16567,15562,-1005
2015,11,27,22,16775,17419,15687,-1732
2015,11,27,23,17881,18286,15922,-2364
2015,11,28,0,17834,18038,15811,-2227
2015,11,28,1,17400,17588,15606,-1982
2015,11,28,2,16946,17063,15408,-1655
2015,11,28,3,16325,16368,15095,-1273
2015,11,28,4,15528,15465,13803,-1662
2015,11,28,5,14534,14464,12866,-1598
2015,11,28,6,13729,13594,11628,-1966
2015,11,28,7,13080,13015,10895,-2120
2015,11,28,8,12657,12662,10559,-2103
2015,11,28,9,12384,12456,10482,-1974
2015,11,28,10,11930,12491,10807,-1684
2015,11,28,11,12107,12850,11605,-1245
2015,11,28,12,12684,13486,12437,-1049
2015,11,28,13,13601,14196,13268,-928
2015,11,28,14,14446,15146,14349,-797
2015,11,28,15,15061,15944,15255,-689
2015,11,28,16,15355,16448,15044,-1404
2015,11,28,17,15458,16754,14272,-2482
2015,11,28,18,15388,16827,14259,-2568
2015,11,28,19,15327,16796,14228,-2568
2015,11,28,20,15317,16763,14730,-2033
2015,11,28,21,15480,16944,14996,-1948
2015,11,28,22,16151,17723,15125,-2598
2015,11,28,23,17336,18336,15264,-3072
2015,11,29,0,17351,18270,15058,-3212
2015,11,29,1,17034,17943,14996,-2947
2015,11,29,2,16717,17529,15124,-2405
2015,11,29,3,16243,16945,14977,-1968
2015,11,29,4,15560,16072,14236,-1836
2015,11,29,5,14675,15049,13004,-2045
2015,11,29,6,13668,14196,12229,-1967
2015,11,29,7,13180,13614,11660,-1954
2015,11,29,8,12844,13264,11395,-1869
2015,11,29,9,12623,13054,11068,-1986
2015,11,29,10,12192,13102,11297,-1805
2015,11,29,11,12359,13381,11402,-1979
2015,11,29,12,12918,13915,11890,-2025
2015,11,29,13,13747,14447,12688,-1759
2015,11,29,14,14454,15242,13583,-1659
2015,11,29,15,14972,15920,14381,-1539
2015,11,29,16,15260,16359,14443,-1916
2015,11,29,17,15367,16410,14207,-2203
2015,11,29,18,15294,16414,14239,-2175
2015,11,29,19,15271,16416,14500,-1916
2015,11,29,20,15280,16457,14727,-1730
2015,11,29,21,15464,16760,15115,-1645
2015,11,29,22,16252,17843,16190,-1653
2015,11,29,23,17716,19135,16609,-2526
2015,11,30,0,17965,19199,16486,-2713
2015,11,30,1,17805,18951,15975,-2976
2015,11,30,2,17473,18460,15796,-2664
2015,11,30,3,16845,17621,15546,-2075
2015,11,30,4,15950,16474,14427,-2047
2015,11,30,5,14930,15360,13423,-1937
2015,11,30,6,14254,14541,12315,-2226
2015,11,30,7,13687,14076,11979,-2097
2015,11,30,8,13432,13837,12034,-1803
2015,11,30,9,13397,13764,12129,-1635
2015,11,30,10,13841,14099,12013,-2086
2015,11,30,11,14630,15186,13315,-1871
2015,11,30,12,16329,17182,14998,-2184
2015,11,30,13,17606,18457,15799,-2658
2015,11,30,14,18107,18824,16156,-2668
2015,11,30,15,18370,19078,16428,-2650
2015,11,30,16,18456,19162,16285,-2877
2015,11,30,17,18410,19028,16245,-2783
2015,11,30,18,18300,18859,16180,-2679
2015,11,30,19,18204,18759,16265,-2494
2015,11,30,20,18125,18666,16234,-2432
2015,11,30,21,18185,18832,16595,-2237
2015,11,30,22,18914,19869,16830,-3039
2015,11,30,23,20227,21086,18072,-3014
2015,12,1,0,20223,21009,17878,-3131
2015,12,1,1,19842,20549,17685,-2864
2015,12,1,2,19231,19871,17188,-2683
2015,12,1,3,18243,18822,16139,-2683
2015,12,1,4,16952,17369,15087,-2282
2015,12,1,5,15574,15916,13780,-2136
2015,12,1,6,14638,14827,12254,-2573
2015,12,1,7,13924,14209,11845,-2364
2015,12,1,8,13521,13848,11938,-1910
2015,12,1,9,13356,13733,11905,-1828
2015,12,1,10,13695,13998,11906,-2092
2015,12,1,11,14549,15013,12576,-2437
2015,12,1,12,16156,16898,14176,-2722
2015,12,1,13,17427,18193,15019,-3174
2015,12,1,14,18035,18738,15276,-3462
2015,12,1,15,18455,19026,15457,-3569
2015,12,1,16,18672,19250,15650,-3600
2015,12,1,17,18756,19296,15947,-3349
2015,12,1,18,18747,19246,15949,-3297
2015,12,1,19,18736,19240,16127,-3113
2015,12,1,20,18711,19215,15799,-3416
2015,12,1,21,18848,19390,15989,-3401
2015,12,1,22,19516,20183,16458,-3725
2015,12,1,23,20447,20929,16967,-3962
2015,12,2,0,20249,20715,17139,-3576
2015,12,2,1,19739,20190,16693,-3497
2015,12,2,2,19087,19496,16286,-3210
2015,12,2,3,18139,18418,15364,-3054
2015,12,2,4,16796,16983,14460,-2523
2015,12,2,5,15318,15539,13484,-2055
2015,12,2,6,14255,14453,12483,-1970
2015,12,2,7,13532,13834,11740,-2094
2015,12,2,8,13125,13498,11560,-1938
2015,12,2,9,12934,13362,11296,-2066
2015,12,2,10,13181,13587,11373,-2214
2015,12,2,11,14094,14512,11935,-2577
2015,12,2,12,15728,16400,13858,-2542
2015,12,2,13,17027,17754,15376,-2378
2015,12,2,14,17649,18313,15519,-2794
2015,12,2,15,18090,18726,15762,-2964
2015,12,2,16,18357,18910,16136,-2774
2015,12,2,17,18445,18945,15698,-3247
2015,12,2,18,18456,18919,15811,-3108
2015,12,2,19,18466,18962,15810,-3152
2015,12,2,20,18457,18940,15768,-3172
2015,12,2,21,18624,19145,15860,-3285
2015,12,2,22,19338,20040,16370,-3670
2015,12,2,23,20278,20701,16786,-3915
2015,12,3,0,20093,20428,16774,-3654
2015,12,3,1,19578,19942,16594,-3348
2015,12,3,2,18948,19233,16326,-2907
2015,12,3,3,18055,18260,15442,-2818
2015,12,3,4,16740,16896,14242,-2654
2015,12,3,5,15265,15420,12838,-2582
2015,12,3,6,14246,14305,11590,-2715
2015,12,3,7,13500,13706,11098,-2608
2015,12,3,8,13102,13369,11213,-2156
2015,12,3,9,12934,13259,11133,-2126
2015,12,3,10,13248,13487,10934,-2553
2015,12,3,11,14132,14511,11799,-2712
2015,12,3,12,15799,16504,13729,-2775
2015,12,3,13,17143,17741,15652,-2089
2015,12,3,14,17734,18206,15895,-2311
2015,12,3,15,18147,18451,15807,-2644
2015,12,3,16,18373,18655,16017,-2638
2015,12,3,17,18413,18741,15759,-2982
2015,12,3,18,18378,18634,15903,-2731
2015,12,3,19,18386,18648,15653,-2995
2015,12,3,20,18346,18672,15610,-3062
2015,12,3,21,18462,18871,15870,-3001
2015,12,3,22,19169,19725,17065,-2660
2015,12,3,23,20256,20753,17616,-3137
2015,12,4,0,20223,20637,17442,-3195
2015,12,4,1,19793,20195,17599,-2596
2015,12,4,2,19219,19588,17125,-2463
2015,12,4,3,18364,18619,16126,-2493
2015,12,4,4,17053,17210,14658,-2552
2015,12,4,5,15588,15663,12836,-2827
2015,12,4,6,14478,14503,11459,-3044
2015,12,4,7,13701,14001,11215,-2786
2015,12,4,8,13300,13699,11165,-2534
2015,12,4,9,13140,13555,10923,-2632
2015,12,4,10,13506,13807,11171,-2636
2015,12,4,11,14321,14807,12081,-2726
2015,12,4,12,15988,16718,14505,-2213
2015,12,4,13,17315,17944,15960,-1984
2015,12,4,14,17885,18376,16105,-2271
2015,12,4,15,18302,18707,15728,-2979
2015,12,4,16,18511,18847,16049,-2798
2015,12,4,17,18565,18769,16130,-2639
2015,12,4,18,18485,18618,16043,-2575
2015,12,4,19,18386,18518,15916,-2602
2015,12,4,20,18252,18570,16084,-2486
2015,12,4,21,18286,18702,16094,-2608
2015,12,4,22,18915,19451,16865,-2586
2015,12,4,23,19988,20265,17686,-2579
2015,12,5,0,19915,19973,17096,-2877
2015,12,5,1,19430,19514,16711,-2803
2015,12,5,2,18912,18944,16366,-2578
2015,12,5,3,18219,18193,15504,-2689
2015,12,5,4,17070,17149,14360,-2789
2015,12,5,5,15659,15853,13115,-2738
2015,12,5,6,14399,14785,11922,-2863
2015,12,5,7,13710,14089,11338,-2751
2015,12,5,8,13296,13658,11161,-2497
2015,12,5,9,13037,13483,11063,-2420
2015,12,5,10,12757,13515,11062,-2453
2015,12,5,11,13116,13928,11302,-2626
2015,12,5,12,13909,14716,12036,-2680
2015,12,5,13,14906,15418,12738,-2680
2015,12,5,14,15639,16202,13551,-2651
2015,12,5,15,16199,16707,14141,-2566
2015,12,5,16,16460,16909,14366,-2543
2015,12,5,17,16531,16900,14309,-2591
2015,12,5,18,16390,16716,14203,-2513
2015,12,5,19,16240,16539,13457,-3082
2015,12,5,20,16105,16433,12980,-3453
2015,12,5,21,16173,16559,12919,-3640
2015,12,5,22,16964,17504,14072,-3432
2015,12,5,23,18318,18734,14613,-4121
2015,12,6,0,18545,18895,15052,-3843
2015,12,6,1,18343,18524,14907,-3617
2015,12,6,2,18009,18116,14837,-3279
2015,12,6,3,17495,17627,14396,-3231
2015,12,6,4,16576,16810,13287,-3523
2015,12,6,5,15381,15773,12709,-3064
2015,12,6,6,14228,14911,11746,-3165
2015,12,6,7,13618,14280,11160,-3120
2015,12,6,8,13241,13849,10729,-3120
2015,12,6,9,12981,13662,10724,-2938
2015,12,6,10,12541,13694,10888,-2806
2015,12,6,11,12690,13883,10974,-2909
2015,12,6,12,13315,14319,11263,-3056
2015,12,6,13,14193,14836,11879,-2957
2015,12,6,14,14815,15737,12420,-3317
2015,12,6,15,15331,16268,13144,-3124
2015,12,6,16,15641,16474,13250,-3224
2015,12,6,17,15779,16513,13610,-2903
2015,12,6,18,15700,16553,13306,-3247
2015,12,6,19,15606,16532,13051,-3481
2015,12,6,20,15566,16547,12979,-3568
2015,12,6,21,15729,16783,13435,-3348
2015,12,6,22,16647,18026,14391,-3635
2015,12,6,23,18080,19412,15303,-4109
2015,12,7,0,18428,19450,15222,-4228
2015,12,7,1,18336,19175,15041,-4134
2015,12,7,2,18014,18735,14805,-3930
2015,12,7,3,17382,17881,14893,-2988
2015,12,7,4,16323,16734,13679,-3055
2015,12,7,5,15108,15473,12626,-2847
2015,12,7,6,14124,14514,10883,-3631
2015,12,7,7,13491,14018,10351,-3667
2015,12,7,8,13165,13740,10271,-3469
2015,12,7,9,13092,13691,10386,-3305
2015,12,7,10,13518,13997,10623,-3374
2015,12,7,11,14296,14975,11458,-3517
2015,12,7,12,16044,16958,13188,-3770
2015,12,7,13,17465,18272,14742,-3530
2015,12,7,14,17923,18694,15166,-3528
2015,12,7,15,18223,18870,15328,-3542
2015,12,7,16,18354,18870,15105,-3765
2015,12,7,17,18360,18777,14807,-3970
2015,12,7,18,18250,18669,14397,-4272
2015,12,7,19,18169,18601,14561,-4040
2015,12,7,20,18071,18561,14631,-3930
2015,12,7,21,18168,18787,14636,-4151
2015,12,7,22,18963,19921,15363,-4558
2015,12,7,23,20252,21152,16064,-5088
2015,12,8,0,20392,20995,16302,-4693
2015,12,8,1,20097,20505,16386,-4119
2015,12,8,2,19539,19892,15772,-4120
2015,12,8,3,18587,18894,14631,-4263
2015,12,8,4,17213,17425,13395,-4030
2015,12,8,5,15699,15898,11877,-4021
2015,12,8,6,14606,14782,11176,-3606
2015,12,8,7,13872,14135,10646,-3489
2015,12,8,8,13481,13830,10535,-3295
2015,12,8,9,13343,13712,10647,-3065
2015,12,8,10,13632,13970,10727,-3243
2015,12,8,11,14482,14965,11551,-3414
2015,12,8,12,16179,16911,13253,-3658
2015,12,8,13,17582,18221,15105,-3116
2015,12,8,14,18057,18639,15325,-3314
2015,12,8,15,18329,18816,15207,-3609
2015,12,8,16,18442,18860,15237,-3623
2015,12,8,17,18369,18784,15291,-3493
2015,12,8,18,18230,18671,15286,-3385
2015,12,8,19,18175,18615,14967,-3648
2015,12,8,20,18103,18565,14718,-3847
2015,12,8,21,18232,18720,14933,-3787
2015,12,8,22,19036,19865,16013,-3852
2015,12,8,23,20323,21069,17436,-3633
2015,12,9,0,20400,20902,17047,-3855
2015,12,9,1,20070,20490,16884,-3606
2015,12,9,2,19491,19877,16426,-3451
2015,12,9,3,18551,18864,15964,-2900
2015,12,9,4,17202,17482,14603,-2879
2015,12,9,5,15701,15941,13064,-2877
2015,12,9,6,14629,14868,11656,-3212
2015,12,9,7,13894,14235,10971,-3264
2015,12,9,8,13515,13920,11055,-2865
2015,12,9,9,13336,13841,11190,-2651
2015,12,9,10,13632,14063,11392,-2671
2015,12,9,11,14484,15017,12139,-2878
2015,12,9,12,16205,17012,14139,-2873
2015,12,9,13,17592,18236,15752,-2484
2015,12,9,14,18025,18618,15816,-2802
2015,12,9,15,18274,18738,15530,-3208
2015,12,9,16,18365,18765,15473,-3292
2015,12,9,17,18297,18630,15198,-3432
2015,12,9,18,18180,18494,15154,-3340
2015,12,9,19,18147,18505,15287,-3218
2015,12,9,20,18064,18430,15386,-3044
2015,12,9,21,18240,18590,15306,-3284
2015,12,9,22,19015,19662,16206,-3456
2015,12,9,23,20263,20812,17394,-3418
2015,12,10,0,20243,20604,17130,-3474
2015,12,10,1,19767,20147,16601,-3546
2015,12,10,2,19156,19527,16580,-2947
2015,12,10,3,18196,18539,16663,-1876
2015,12,10,4,16819,17059,15206,-1853
2015,12,10,5,15278,15509,13908,-1601
2015,12,10,6,14317,14383,12937,-1446
2015,12,10,7,13577,13725,12419,-1306
2015,12,10,8,13169,13350,12190,-1160
2015,12,10,9,12995,13252,12278,-974
2015,12,10,10,13219,13433,12200,-1233
2015,12,10,11,14123,14365,12894,-1471
2015,12,10,12,15869,16278,14883,-1395
2015,12,10,13,17292,17491,15701,-1790
2015,12,10,14,17778,17865,15492,-2373
2015,12,10,15,18064,18072,15997,-2075
2015,12,10,16,18198,18101,15750,-2351
2015,12,10,17,18144,18043,15538,-2505
2015,12,10,18,18068,17932,14946,-2986
2015,12,10,19,18068,17920,15254,-2666
2015,12,10,20,18017,17911,14719,-3192
2015,12,10,21,18142,18050,15201,-2849
2015,12,10,22,18892,19112,15948,-3164
2015,12,10,23,20078,20369,16521,-3848
2015,12,11,0,20033,20245,16900,-3345
2015,12,11,1,19625,19825,16775,-3050
2015,12,11,2,19025,19254,16626,-2628
2015,12,11,3,18090,18308,15992,-2316
2015,12,11,4,16776,16913,15042,-1871
2015,12,11,5,15279,15461,13413,-2048
2015,12,11,6,14150,14374,12782,-1592
2015,12,11,7,13373,13739,12164,-1575
2015,12,11,8,12946,13383,11501,-1882
2015,12,11,9,12756,13234,11716,-1518
2015,12,11,10,12969,13437,11363,-2074
2015,12,11,11,13850,14349,12723,-1626
2015,12,11,12,15662,16233,14307,-1926
2015,12,11,13,17166,17509,15043,-2466
2015,12,11,14,17703,17975,15431,-2544
2015,12,11,15,18026,18230,15267,-2963
2015,12,11,16,18167,18308,15302,-3006
2015,12,11,17,18119,18248,14919,-3329
2015,12,11,18,18041,18028,15460,-2568
2015,12,11,19,17942,17989,15328,-2661
2015,12,11,20,17828,17969,15529,-2440
2015,12,11,21,17873,18088,15131,-2957
2015,12,11,22,18585,19014,16292,-2722
2015,12,11,23,19768,20031,17316,-2715
2015,12,12,0,19647,19734,17147,-2587
2015,12,12,1,19187,19220,17006,-2214
2015,12,12,2,18619,18672,16626,-2046
2015,12,12,3,17865,17938,15783,-2155
2015,12,12,4,16680,16825,14794,-2031
2015,12,12,5,15225,15512,13386,-2126
2015,12,12,6,13996,14423,13003,-1420
2015,12,12,7,13352,13763,12871,-892
2015,12,12,8,12919,13307,12715,-592
2015,12,12,9,12648,13073,12611,-462
2015,12,12,10,12264,13132,12772,-360
2015,12,12,11,12612,13503,12533,-970
2015,12,12,12,13473,14235,12583,-1652
2015,12,12,13,14588,14928,12948,-1980
2015,12,12,14,15324,15742,13238,-2504
2015,12,12,15,15862,16320,13527,-2793
2015,12,12,16,16129,16532,14034,-2498
2015,12,12,17,16166,16643,13734,-2909
2015,12,12,18,16071,16587,13439,-3148
2015,12,12,19,15995,16510,13603,-2907
2015,12,12,20,15927,16554,14028,-2526
2015,12,12,21,16057,16713,14137,-2576
2015,12,12,22,16912,17657,14372,-3285
2015,12,12,23,18248,18521,15191,-3330
2015,12,13,0,18290,18388,14886,-3502
2015,12,13,1,17933,18022,14401,-3621
2015,12,13,2,17497,17567,14168,-3399
2015,12,13,3,16934,16949,13707,-3242
2015,12,13,4,16010,16044,13012,-3032
2015,12,13,5,14775,14963,12066,-2897
2015,12,13,6,13760,14008,11722,-2286
2015,12,13,7,13198,13288,11457,-1831
2015,12,13,8,12843,12882,11209,-1673
2015,12,13,9,12586,12661,11172,-1489
2015,12,13,10,12099,12628,11141,-1487
2015,12,13,11,12216,12830,11211,-1619
2015,12,13,12,12843,13331,11697,-1634
2015,12,13,13,13826,13912,12226,-1686
2015,12,13,14,14515,14801,12850,-1951
2015,12,13,15,15079,15492,13760,-1732
2015,12,13,16,15428,15894,13581,-2313
2015,12,13,17,15559,16138,13393,-2745
2015,12,13,18,15570,16254,13346,-2908
2015,12,13,19,15628,16252,13614,-2638
2015,12,13,20,15675,16249,13958,-2291
2015,12,13,21,15914,16454,14046,-2408
2015,12,13,22,16838,17680,14665,-3015
2015,12,13,23,18193,18899,15890,-3009
2015,12,14,0,18308,18875,16090,-2785
2015,12,14,1,18008,18565,15418,-3147
2015,12,14,2,17572,18045,15237,-2808
2015,12,14,3,16916,17163,14655,-2508
2015,12,14,4,15918,16036,13851,-2185
2015,12,14,5,14677,14689,12784,-1905
2015,12,14,6,13707,13669,11712,-1957
2015,12,14,7,13097,13061,11591,-1470
2015,12,14,8,12764,12775,11651,-1124
2015,12,14,9,12631,12685,11555,-1130
2015,12,14,10,12923,12936,11596,-1340
2015,12,14,11,13763,13930,12612,-1318
2015,12,14,12,15568,15873,14332,-1541
2015,12,14,13,17091,17336,15186,-2150
2015,12,14,14,17677,17855,15401,-2454
2015,12,14,15,18047,18293,15861,-2432
2015,12,14,16,18237,18529,16147,-2382
2015,12,14,17,18262,18600,16156,-2444
2015,12,14,18,18222,18517,16182,-2335
2015,12,14,19,18211,18517,16025,-2492
2015,12,14,20,18198,18457,15945,-2512
2015,12,14,21,18372,18658,16063,-2595
2015,12,14,22,19225,19713,16729,-2984
2015,12,14,23,20511,20790,17623,-3167
2015,12,15,0,20418,20624,17510,-3114
2015,12,15,1,19856,20171,17074,-3097
2015,12,15,2,19134,19465,16839,-2626
2015,12,15,3,18134,18384,15650,-2734
2015,12,15,4,16749,17008,14311,-2697
2015,12,15,5,15159,15446,13015,-2431
2015,12,15,6,14118,14225,12421,-1804
2015,12,15,7,13341,13519,11993,-1526
2015,12,15,8,12894,13138,11932,-1206
2015,12,15,9,12682,12977,11985,-992
2015,12,15,10,12835,13170,11860,-1310
2015,12,15,11,13720,14114,12377,-1737
2015,12,15,12,15527,16009,14563,-1446
2015,12,15,13,17054,17408,15445,-1963
2015,12,15,14,17543,17806,15655,-2151
2015,12,15,15,17838,18106,16519,-1587
2015,12,15,16,17958,18227,16485,-1742
2015,12,15,17,17967,18329,16496,-1833
2015,12,15,18,17870,18315,16243,-2072
2015,12,15,19,17827,18299,16436,-1863
2015,12,15,20,17802,18355,16448,-1907
2015,12,15,21,17951,18581,16612,-1969
2015,12,15,22,18761,19619,17351,-2268
2015,12,15,23,20087,20679,18332,-2347
2015,12,16,0,20083,20532,18275,-2257
2015,12,16,1,19633,20074,17841,-2233
2015,12,16,2,18997,19503,17396,-2107
2015,12,16,3,18089,18500,16540,-1960
2015,12,16,4,16752,17113,15107,-2006
2015,12,16,5,15220,15507,13175,-2332
2015,12,16,6,14150,14370,11943,-2427
2015,12,16,7,13443,13739,11360,-2379
2015,12,16,8,13056,13411,11210,-2201
2015,12,16,9,12901,13287,11240,-2047
2015,12,16,10,13179,13542,11558,-1984
2015,12,16,11,14009,14559,12478,-2081
2015,12,16,12,15778,16571,14367,-2204
2015,12,16,13,17160,17845,15387,-2458
2015,12,16,14,17572,18284,15858,-2426
2015,12,16,15,17807,18480,16018,-2462
2015,12,16,16,17863,18518,16012,-2506
2015,12,16,17,17840,18517,15990,-2527
2015,12,16,18,17708,18473,15823,-2650
2015,12,16,19,17642,18540,15780,-2760
2015,12,16,20,17595,18592,15554,-3038
2015,12,16,21,17708,18841,15406,-3435
2015,12,16,22,18557,19888,16221,-3667
2015,12,16,23,20042,20943,17456,-3487
2015,12,17,0,20089,20817,17297,-3520
2015,12,17,1,19732,20424,17099,-3325
2015,12,17,2,19178,19837,16467,-3370
2015,12,17,3,18286,18887,16314,-2573
2015,12,17,4,16917,17454,14899,-2555
2015,12,17,5,15361,15815,13335,-2480
2015,12,17,6,14250,14691,12406,-2285
2015,12,17,7,13500,13971,11943,-2028
2015,12,17,8,13085,13583,11631,-1952
2015,12,17,9,12901,13451,11563,-1888
2015,12,17,10,13079,13649,11479,-2170
2015,12,17,11,13929,14535,12545,-1990
2015,12,17,12,15658,16415,14106,-2309
2015,12,17,13,17120,17930,15322,-2608
2015,12,17,14,17599,18496,16283,-2213
2015,12,17,15,17915,18824,16027,-2797
2015,12,17,16,18063,19035,15869,-3166
2015,12,17,17,18091,19099,16162,-2937
2015,12,17,18,18024,19103,16518,-2585
2015,12,17,19,18047,19193,16898,-2295
2015,12,17,20,18032,19181,16659,-2522
2015,12,17,21,18177,19426,16495,-2931
2015,12,17,22,18986,20311,17207,-3104
2015,12,17,23,20256,21020,17936,-3084
2015,12,18,0,20159,20776,17472,-3304
2015,12,18,1,19683,20253,17015,-3238
2015,12,18,2,19106,19561,16946,-2615
2015,12,18,3,18206,18602,16251,-2351
2015,12,18,4,16913,17210,14919,-2291
2015,12,18,5,15398,15668,13395,-2273
2015,12,18,6,14318,14544,12526,-2018
2015,12,18,7,13549,13847,12395,-1452
2015,12,18,8,13127,13447,12065,-1382
2015,12,18,9,12951,13324,11867,-1457
2015,12,18,10,13121,13493,11849,-1644
2015,12,18,11,13906,14447,12549,-1898
2015,12,18,12,15611,16373,14264,-2109
2015,12,18,13,17115,17911,15849,-2062
2015,12,18,14,17631,18459,16036,-2423
2015,12,18,15,17957,18805,16365,-2440
2015,12,18,16,18118,18999,16313,-2686
2015,12,18,17,18131,19067,16140,-2927
2015,12,18,18,18024,18918,16018,-2900
2015,12,18,19,18020,18884,15993,-2891
2015,12,18,20,17935,18835,16016,-2819
2015,12,18,21,18029,18940,16059,-2881
2015,12,18,22,18764,19897,16755,-3142
2015,12,18,23,20119,20873,17601,-3272
2015,12,19,0,20092,20651,17353,-3298
2015,12,19,1,19672,20209,16925,-3284
2015,12,19,2,19243,19723,16957,-2766
2015,12,19,3,18598,18948,16418,-2530
2015,12,19,4,17513,17883,15280,-2603
2015,12,19,5,16082,16557,13660,-2897
2015,12,19,6,14898,15431,13213,-2218
2015,12,19,7,14268,14645,12507,-2138
2015,12,19,8,13890,14200,12085,-2115
2015,12,19,9,13641,13993,11980,-2013
2015,12,19,10,13307,14071,12337,-1734
2015,12,19,11,13575,14465,12428,-2037
2015,12,19,12,14340,15274,13293,-1981
2015,12,19,13,15469,16132,13937,-2195
2015,12,19,14,16224,16954,14318,-2636
2015,12,19,15,16808,17521,14755,-2766
2015,12,19,16,17077,17798,15082,-2716
2015,12,19,17,17210,17884,15327,-2557
2015,12,19,18,17066,17895,15154,-2741
2015,12,19,19,17003,17894,15409,-2485
2015,12,19,20,16963,17977,15482,-2495
2015,12,19,21,17090,18136,15640,-2496
2015,12,19,22,17950,19135,16371,-2764
2015,12,19,23,19490,20278,17627,-2651
2015,12,20,0,19689,20229,17929,-2300
2015,12,20,1,19415,19913,17604,-2309
2015,12,20,2,19104,19454,17057,-2397
2015,12,20,3,18605,18856,16434,-2422
2015,12,20,4,17741,17936,15794,-2142
2015,12,20,5,16530,16810,14782,-2028
2015,12,20,6,15211,15711,13954,-1757
2015,12,20,7,14601,14928,13174,-1754
2015,12,20,8,14219,14493,12991,-1502
2015,12,20,9,13951,14261,12768,-1493
2015,12,20,10,13493,14297,12906,-1391
2015,12,20,11,13577,14526,13020,-1506
2015,12,20,12,14115,15036,13451,-1585
2015,12,20,13,15044,15596,13748,-1848
2015,12,20,14,15693,16296,14205,-2091
2015,12,20,15,16209,16836,14423,-2413
2015,12,20,16,16500,17145,14657,-2488
2015,12,20,17,16667,17265,14879,-2386
2015,12,20,18,16584,17284,14914,-2370
2015,12,20,19,16561,17209,14193,-3016
2015,12,20,20,16535,17162,14335,-2827
2015,12,20,21,16717,17367,14532,-2835
2015,12,20,22,17607,18485,15495,-2990
2015,12,20,23,19161,19994,17295,-2699
2015,12,21,0,19515,20078,17358,-2720
2015,12,21,1,19389,19864,17533,-2331
2015,12,21,2,19103,19517,16975,-2542
2015,12,21,3,18513,18751,16303,-2448
2015,12,21,4,17542,17516,15474,-2042
2015,12,21,5,16364,16207,14421,-1786
2015,12,21,6,15070,15160,13540,-1620
2015,12,21,7,14305,14455,13105,-1350
2015,12,21,8,13899,14105,12951,-1154
2015,12,21,9,13757,13984,12848,-1136
2015,12,21,10,14148,14231,12901,-1330
2015,12,21,11,14848,15209,13798,-1411
2015,12,21,12,16412,17073,15803,-1270
2015,12,21,13,17839,18460,17227,-1233
2015,12,21,14,18462,18959,17625,-1334
2015,12,21,15,18863,19240,17508,-1732
2015,12,21,16,19068,19339,16918,-2421
2015,12,21,17,19125,19396,16927,-2469
2015,12,21,18,19094,19207,16906,-2301
2015,12,21,19,19102,19198,17237,-1961
2015,12,21,20,19033,19133,17306,-1827
2015,12,21,21,19104,19335,17503,-1832
2015,12,21,22,19846,20329,18188,-2141
2015,12,21,23,21057,21186,19365,-1821
2015,12,22,0,21015,20977,19266,-1711
2015,12,22,1,20589,20495,18939,-1556
2015,12,22,2,20012,19904,18231,-1673
2015,12,22,3,19088,18939,17247,-1692
2015,12,22,4,17799,17463,15671,-1792
2015,12,22,5,16314,15926,14052,-1874
2015,12,22,6,14917,14655,13017,-1638
2015,12,22,7,14007,13912,12464,-1448
2015,12,22,8,13480,13487,12221,-1266
2015,12,22,9,13241,13339,12048,-1291
2015,12,22,10,13521,13540,12113,-1427
2015,12,22,11,14299,14410,12625,-1785
2015,12,22,12,15868,16263,14106,-2157
2015,12,22,13,17309,17711,15820,-1891
2015,12,22,14,17957,18337,16322,-2015
2015,12,22,15,18387,18708,16281,-2427
2015,12,22,16,18617,18924,16456,-2468
2015,12,22,17,18718,19033,16815,-2218
2015,12,22,18,18722,18996,16732,-2264
2015,12,22,19,18742,19009,16404,-2605
2015,12,22,20,18688,18874,16262,-2612
2015,12,22,21,18760,18912,16087,-2825
2015,12,22,22,19484,19684,16361,-3323
2015,12,22,23,20684,20545,17594,-2951
2015,12,23,0,20645,20370,17698,-2672
2015,12,23,1,20234,19898,17626,-2272
2015,12,23,2,19683,19304,17344,-1960
2015,12,23,3,18803,18489,16464,-2025
2015,12,23,4,17543,17068,15013,-2055
2015,12,23,5,16082,15573,13534,-2039
2015,12,23,6,14628,14381,12624,-1757
2015,12,23,7,13797,13692,12358,-1334
2015,12,23,8,13276,13313,12227,-1086
2015,12,23,9,13031,13169,12274,-895
2015,12,23,10,13371,13353,12365,-988
2015,12,23,11,14183,14204,12601,-1603
2015,12,23,12,15746,15917,13840,-2077
2015,12,23,13,17135,17364,15300,-2064
2015,12,23,14,17832,18020,16005,-2015
2015,12,23,15,18259,18410,16366,-2044
2015,12,23,16,18508,18597,16104,-2493
2015,12,23,17,18600,18616,15689,-2927
2015,12,23,18,18650,18543,15787,-2756
2015,12,23,19,18655,18566,16049,-2517
2015,12,23,20,18625,18571,16186,-2385
2015,12,23,21,18710,18821,16411,-2410
2015,12,23,22,19418,19791,17304,-2487
2015,12,23,23,20610,20487,17920,-2567
2015,12,24,0,20520,20305,17776,-2529
2015,12,24,1,20089,19830,17090,-2740
2015,12,24,2,19510,19244,16600,-2644
2015,12,24,3,18614,18425,16278,-2147
2015,12,24,4,17337,17224,15163,-2061
2015,12,24,5,15840,15713,13769,-1944
2015,12,24,6,14480,14367,12450,-1917
2015,12,24,7,13698,13532,11823,-1709
2015,12,24,8,13192,13020,11455,-1565
2015,12,24,9,12919,12756,11288,-1468
2015,12,24,10,12901,12816,11338,-1478
2015,12,24,11,13600,13316,11720,-1596
2015,12,24,12,14658,14443,12817,-1626
2015,12,24,13,15805,15572,13573,-1999
2015,12,24,14,16670,16425,14146,-2279
2015,12,24,15,17317,17299,15164,-2135
2015,12,24,16,17618,17802,15537,-2265
2015,12,24,17,17722,18016,15630,-2386
2015,12,24,18,17627,17914,15901,-2013
2015,12,24,19,17597,17648,15999,-1649
2015,12,24,20,17488,17566,15728,-1838
2015,12,24,21,17358,17409,15552,-1857
2015,12,24,22,17712,18003,16046,-1957
2015,12,24,23,18677,18918,17014,-1904
2015,12,25,0,18301,18343,16649,-1694
2015,12,25,1,17823,17657,16263,-1394
2015,12,25,2,17366,17153,16090,-1063
2015,12,25,3,16846,16643,15055,-1588
2015,12,25,4,16147,15981,14163,-1818
2015,12,25,5,15224,15031,12822,-2209
2015,12,25,6,14119,14133,12246,-1887
2015,12,25,7,13316,13364,11668,-1696
2015,12,25,8,12735,12829,11210,-1619
2015,12,25,9,12395,12552,10808,-1744
2015,12,25,10,12163,12471,10906,-1565
2015,12,25,11,12552,12691,10866,-1825
2015,12,25,12,13031,13228,11533,-1695
2015,12,25,13,13766,13847,12780,-1067
2015,12,25,14,14537,14526,13442,-1084
2015,12,25,15,15069,15156,13708,-1448
2015,12,25,16,15372,15478,14093,-1385
2015,12,25,17,15460,15673,14140,-1533
2015,12,25,18,15457,15730,14437,-1293
2015,12,25,19,15340,15685,14223,-1462
2015,12,25,20,15141,15592,14203,-1389
2015,12,25,21,14953,15628,14002,-1626
2015,12,25,22,15064,16292,14681,-1611
2015,12,25,23,15773,16896,15244,-1652
2015,12,26,0,15660,16756,14915,-1841
2015,12,26,1,15559,16591,14730,-1861
2015,12,26,2,15549,16392,14606,-1786
2015,12,26,3,15543,16063,14229,-1834
2015,12,26,4,15123,15424,13272,-2152
2015,12,26,5,14232,14490,12105,-2385
2015,12,26,6,13237,13628,11237,-2391
2015,12,26,7,12663,12978,10846,-2132
2015,12,26,8,12308,12599,10535,-2064
2015,12,26,9,12086,12411,10080,-2331
2015,12,26,10,11823,12442,10086,-2356
2015,12,26,11,12011,12774,10308,-2466
2015,12,26,12,12440,13425,11286,-2139
2015,12,26,13,13330,14109,11932,-2177
2015,12,26,14,14235,14883,12750,-2133
2015,12,26,15,14973,15681,13150,-2531
2015,12,26,16,15416,16182,13485,-2697
2015,12,26,17,15604,16455,14000,-2455
2015,12,26,18,15586,16482,14324,-2158
2015,12,26,19,15566,16407,14454,-1953
2015,12,26,20,15525,16461,14349,-2112
2015,12,26,21,15607,16641,14485,-2156
2015,12,26,22,16204,17530,15322,-2208
2015,12,26,23,17319,18398,15952,-2446
2015,12,27,0,17366,18338,16021,-2317
2015,12,27,1,16979,18022,15916,-2106
2015,12,27,2,16580,17652,15535,-2117
2015,12,27,3,16116,17120,14732,-2388
2015,12,27,4,15385,16202,14026,-2176
2015,12,27,5,14448,15092,12780,-2312
2015,12,27,6,13359,14133,12298,-1835
2015,12,27,7,12852,13461,11677,-1784
2015,12,27,8,12538,13001,10824,-2177
2015,12,27,9,12317,12771,10963,-1808
2015,12,27,10,11916,12709,10987,-1722
2015,12,27,11,11923,12921,11333,-1588
2015,12,27,12,12224,13322,11948,-1374
2015,12,27,13,13019,13820,12625,-1195
2015,12,27,14,13829,14547,13268,-1279
2015,12,27,15,14553,15354,13696,-1658
2015,12,27,16,15068,16055,13862,-2193
2015,12,27,17,15351,16472,14201,-2271
2015,12,27,18,15402,16631,14301,-2330
2015,12,27,19,15430,16704,14197,-2507
2015,12,27,20,15465,16759,14187,-2572
2015,12,27,21,15618,16905,14285,-2620
2015,12,27,22,16261,17843,15423,-2420
2015,12,27,23,17437,18707,15946,-2761
2015,12,28,0,17601,18653,16060,-2593
2015,12,28,1,17303,18328,15742,-2586
2015,12,28,2,16927,17866,15884,-1982
2015,12,28,3,16398,17241,15417,-1824
2015,12,28,4,15581,16258,14351,-1907
2015,12,28,5,14609,15111,12692,-2419
2015,12,28,6,13851,14166,12014,-2152
2015,12,28,7,13283,13620,11703,-1917
2015,12,28,8,13006,13333,11407,-1926
2015,12,28,9,12920,13270,11433,-1837
2015,12,28,10,13297,13526,11478,-2048
2015,12,28,11,13960,14355,12066,-2289
2015,12,28,12,15289,15726,13300,-2426
2015,12,28,13,16512,16935,14803,-2132
2015,12,28,14,17251,17735,15080,-2655
2015,12,28,15,17838,18350,15556,-2794
2015,12,28,16,18214,18702,15953,-2749
2015,12,28,17,18364,18824,16324,-2500
2015,12,28,18,18346,18783,16300,-2483
2015,12,28,19,18340,18861,16224,-2637
2015,12,28,20,18334,18919,16335,-2584
2015,12,28,21,18476,19140,16610,-2530
2015,12,28,22,19108,20209,17712,-2497
2015,12,28,23,20351,21254,18688,-2566
2015,12,29,0,20380,21093,18676,-2417
2015,12,29,1,19859,20654,18621,-2033
2015,12,29,2,19233,20100,18037,-2063
2015,12,29,3,18363,19281,17199,-2082
2015,12,29,4,17132,18014,16432,-1582
2015,12,29,5,15809,16649,15024,-1625
2015,12,29,6,14982,15571,13823,-1748
2015,12,29,7,14186,14920,13594,-1326
2015,12,29,8,13757,14520,13236,-1284
2015,12,29,9,13568,14340,12826,-1514
2015,12,29,10,13804,14453,12970,-1483
2015,12,29,11,14463,15133,13537,-1596
2015,12,29,12,15685,16362,14638,-1724
2015,12,29,13,16799,17542,15921,-1621
2015,12,29,14,17446,18344,16667,-1677
2015,12,29,15,18013,19025,17149,-1876
2015,12,29,16,18381,19436,17917,-1519
2015,12,29,17,18542,19526,17640,-1886
2015,12,29,18,18522,19483,16986,-2497
2015,12,29,19,18488,19393,16579,-2814
2015,12,29,20,18446,19308,16588,-2720
2015,12,29,21,18526,19275,16652,-2623
2015,12,29,22,19097,19895,17951,-1944
2015,12,29,23,20196,20903,18386,-2517
2015,12,30,0,20161,20725,17969,-2756
2015,12,30,1,19660,20202,17703,-2499
2015,12,30,2,19051,19489,17190,-2299
2015,12,30,3,18238,18665,16383,-2282
2015,12,30,4,17013,17391,15448,-1943
2015,12,30,5,15698,16054,13954,-2100
2015,12,30,6,14636,14954,12223,-2731
2015,12,30,7,13842,14282,11875,-2407
2015,12,30,8,13393,13884,11523,-2361
2015,12,30,9,13193,13730,11416,-2314
2015,12,30,10,13425,13876,11536,-2340
2015,12,30,11,14044,14606,12144,-2462
2015,12,30,12,15298,15935,13908,-2027
2015,12,30,13,16412,17081,15369,-1712
2015,12,30,14,17024,17814,15783,-2031
2015,12,30,15,17602,18430,16397,-2033
2015,12,30,16,18001,18794,16576,-2218
2015,12,30,17,18171,18953,16663,-2290
2015,12,30,18,18154,18888,16621,-2267
2015,12,30,19,18117,18874,16549,-2325
2015,12,30,20,18092,18850,16806,-2044
2015,12,30,21,18210,18958,16713,-2245
2015,12,30,22,18807,19716,17271,-2445
2015,12,30,23,19878,20564,17730,-2834
2015,12,31,0,19840,20332,17603,-2729
2015,12,31,1,19332,19849,17123,-2726
2015,12,31,2,18744,19279,17152,-2127
2015,12,31,3,17970,18497,16619,-1878
2015,12,31,4,16776,17301,15390,-1911
2015,12,31,5,15467,15953,13513,-2440
2015,12,31,6,14585,14854,12062,-2792
2015,12,31,7,13955,14123,11944,-2179
2015,12,31,8,13528,13644,11547,-2097
2015,12,31,9,13301,13420,11492,-1928
2015,12,31,10,13225,13538,11478,-2060
2015,12,31,11,13745,14202,12279,-1923
2015,12,31,12,14615,15378,13763,-1615
2015,12,31,13,15556,16416,14900,-1516
2015,12,31,14,16212,17190,15238,-1952
2015,12,31,15,16819,17776,15698,-2078
2015,12,31,16,17223,18104,15913,-2191
2015,12,31,17,17456,18194,16006,-2188
2015,12,31,18,17419,18187,16078,-2109
2015,12,31,19,17393,18198,16154,-2044
2015,12,31,20,17379,18167,16033,-2134
2015,12,31,21,17390,18270,15924,-2346
2015,12,31,22,17907,19148,16659,-2489
2015,12,31,23,19240,20033,17764,-2269
2016,1,1,0,19133,19726,17302,-2424
2016,1,1,1,18542,19008,16481,-2527
2016,1,1,2,17814,18340,16349,-1991
2016,1,1,3,17244,17557,15670,-1887
2016,1,1,4,16645,16772,14908,-1864
2016,1,1,5,16124,16055,13933,-2122
2016,1,1,6,15234,15250,12630,-2620
2016,1,1,7,14486,14583,12339,-2244
2016,1,1,8,13836,14013,11554,-2459
2016,1,1,9,13461,13632,11474,-2158
2016,1,1,10,13243,13500,11462,-2038
2016,1,1,11,13374,13671,12041,-1630
2016,1,1,12,13582,14093,12924,-1169
2016,1,1,13,13698,14398,13213,-1185
2016,1,1,14,14041,14791,13506,-1285
2016,1,1,15,14789,15502,14073,-1429
2016,1,1,16,15571,16144,14708,-1436
2016,1,1,17,16148,16548,14940,-1608
2016,1,1,18,16455,16812,15043,-1769
2016,1,1,19,16512,16915,15158,-1757
2016,1,1,20,16479,17069,15214,-1855
2016,1,1,21,16488,17248,15410,-1838
2016,1,1,22,17068,17925,15984,-1941
2016,1,1,23,18405,19059,17044,-2015
2016,1,2,0,18477,19106,16823,-2283
2016,1,2,1,18180,18892,16468,-2424
2016,1,2,2,17781,18513,16411,-2102
2016,1,2,3,17369,17979,15560,-2419
2016,1,2,4,16631,17113,15238,-1875
2016,1,2,5,15690,16106,14143,-1963
2016,1,2,6,14599,15151,12737,-2414
2016,1,2,7,14090,14488,12396,-2092
2016,1,2,8,13742,14114,11934,-2180
2016,1,2,9,13537,13915,11891,-2024
2016,1,2,10,13158,13936,11873,-2063
2016,1,2,11,13238,14220,12158,-2062
2016,1,2,12,13696,14839,13410,-1429
2016,1,2,13,14541,15491,14116,-1375
2016,1,2,14,15308,16194,14586,-1608
2016,1,2,15,16011,16940,15050,-1890
2016,1,2,16,16506,17430,15541,-1889
2016,1,2,17,16765,17613,15575,-2038
2016,1,2,18,16694,17641,15825,-1816
2016,1,2,19,16541,17539,16079,-1460
2016,1,2,20,16455,17487,15883,-1604
2016,1,2,21,16400,17629,15823,-1806
2016,1,2,22,17006,18483,16360,-2123
2016,1,2,23,18393,19562,16851,-2711
2016,1,3,0,18566,19536,16749,-2787
2016,1,3,1,18338,19237,16712,-2525
2016,1,3,2,17918,18808,16632,-2176
2016,1,3,3,17449,18288,16594,-1694
2016,1,3,4,16787,17380,15873,-1507
2016,1,3,5,15927,16381,14548,-1833
2016,1,3,6,14725,15401,13043,-2358
2016,1,3,7,14224,14652,12636,-2016
2016,1,3,8,13888,14192,11875,-2317
2016,1,3,9,13680,13946,11681,-2265
2016,1,3,10,13264,13927,11724,-2203
2016,1,3,11,13222,14112,11944,-2168
2016,1,3,12,13590,14571,12760,-1811
2016,1,3,13,14338,15030,13231,-1799
2016,1,3,14,14992,15652,13859,-1793
2016,1,3,15,15618,16270,14594,-1676
2016,1,3,16,16115,16740,14861,-1879
2016,1,3,17,16396,17079,15194,-1885
2016,1,3,18,16398,17257,15315,-1942
2016,1,3,19,16355,17281,15273,-2008
2016,1,3,20,16340,17311,15453,-1858
2016,1,3,21,16377,17492,15611,-1881
2016,1,3,22,17092,18434,16216,-2218
2016,1,3,23,18474,19723,16894,-2829
2016,1,4,0,18791,19807,17025,-2782
2016,1,4,1,18701,19554,16730,-2824
2016,1,4,2,18335,19043,16646,-2397
2016,1,4,3,17749,18167,15611,-2556
2016,1,4,4,16959,17057,14869,-2188
2016,1,4,5,16049,15922,13725,-2197
2016,1,4,6,15096,15097,11999,-3098
2016,1,4,7,14642,14603,11664,-2939
2016,1,4,8,14397,14355,11441,-2914
2016,1,4,9,14380,14321,11291,-3030
2016,1,4,10,14789,14649,11648,-3001
2016,1,4,11,15529,15694,12593,-3101
2016,1,4,12,17182,17592,15195,-2397
2016,1,4,13,18600,19068,17094,-1974
2016,1,4,14,19152,19608,17901,-1707
2016,1,4,15,19544,20094,17641,-2453
2016,1,4,16,19844,20294,17588,-2706
2016,1,4,17,19921,20333,17364,-2969
2016,1,4,18,19860,20333,17279,-3054
2016,1,4,19,19815,20378,17339,-3039
2016,1,4,20,19783,20422,17559,-2863
2016,1,4,21,19739,20695,18080,-2615
2016,1,4,22,20313,21618,19219,-2399
2016,1,4,23,21618,23087,20641,-2446
2016,1,5,0,21799,23179,20665,-2514
2016,1,5,1,21531,22837,20513,-2324
2016,1,5,2,20907,22233,19893,-2340
2016,1,5,3,19972,21296,18606,-2690
2016,1,5,4,18739,19951,17240,-2711
2016,1,5,5,17431,18516,15737,-2779
2016,1,5,6,16410,17548,14222,-3326
2016,1,5,7,15820,16994,13444,-3550
2016,1,5,8,15497,16701,13361,-3340
2016,1,5,9,15437,16654,13753,-2901
2016,1,5,10,15898,16930,14906,-2024
2016,1,5,11,16602,17871,15578,-2293
2016,1,5,12,18201,19670,17374,-2296
2016,1,5,13,19438,20936,18686,-2250
2016,1,5,14,19837,21276,19137,-2139
2016,1,5,15,20104,21434,19493,-1941
2016,1,5,16,20255,21572,19018,-2554
2016,1,5,17,20246,21388,17579,-3809
2016,1,5,18,20093,21137,16532,-4605
2016,1,5,19,19955,21002,17045,-3957
2016,1,5,20,19840,20881,17437,-3444
2016,1,5,21,19754,20959,17649,-3310
2016,1,5,22,20248,21667,18065,-3602
2016,1,5,23,21543,23085,19706,-3379
2016,1,6,0,21737,23162,19934,-3228
2016,1,6,1,21457,22793,19430,-3363
2016,1,6,2,20823,22115,18676,-3439
2016,1,6,3,19859,21072,17776,-3296
2016,1,6,4,18590,19627,16447,-3180
2016,1,6,5,17265,18169,14951,-3218
2016,1,6,6,16266,17171,14207,-2964
2016,1,6,7,15662,16581,13820,-2761
2016,1,6,8,15324,16248,13397,-2851
2016,1,6,9,15214,16160,13405,-2755
2016,1,6,10,15636,16408,13214,-3194
2016,1,6,11,16351,17360,13682,-3678
2016,1,6,12,17919,19210,15778,-3432
2016,1,6,13,19101,20467,16479,-3988
2016,1,6,14,19461,20688,16104,-4584
2016,1,6,15,19676,20718,15740,-4978
2016,1,6,16,19789,20589,15978,-4611
2016,1,6,17,19756,20380,15840,-4540
2016,1,6,18,19625,20085,15653,-4432
2016,1,6,19,19489,19883,15341,-4542
2016,1,6,20,19370,19722,14772,-4950
2016,1,6,21,19303,19758,14616,-5142
2016,1,6,22,19774,20525,15744,-4781
2016,1,6,23,21074,21951,16884,-5067
2016,1,7,0,21281,21955,17349,-4606
2016,1,7,1,20991,21582,17562,-4020
2016,1,7,2,20395,20963,17106,-3857
2016,1,7,3,19461,20005,16367,-3638
2016,1,7,4,18203,18595,15569,-3026
2016,1,7,5,16890,17213,14630,-2583
2016,1,7,6,15945,16226,13891,-2335
2016,1,7,7,15266,15661,13502,-2159
2016,1,7,8,14887,15372,13307,-2065
2016,1,7,9,14774,15326,13351,-1975
2016,1,7,10,15203,15596,13532,-2064
2016,1,7,11,15961,16571,14295,-2276
2016,1,7,12,17563,18526,16290,-2236
2016,1,7,13,18756,19887,17655,-2232
2016,1,7,14,19120,20088,17699,-2389
2016,1,7,15,19326,20146,17665,-2481
2016,1,7,16,19422,20026,17113,-2913
2016,1,7,17,19357,19811,17030,-2781
2016,1,7,18,19240,19553,16829,-2724
2016,1,7,19,19165,19401,16701,-2700
2016,1,7,20,19070,19308,16705,-2603
2016,1,7,21,19017,19443,16938,-2505
2016,1,7,22,19485,20062,17701,-2361
2016,1,7,23,20795,21371,18791,-2580
2016,1,8,0,21007,21385,18878,-2507
2016,1,8,1,20737,20991,18360,-2631
2016,1,8,2,20168,20401,17931,-2470
2016,1,8,3,19247,19484,17464,-2020
2016,1,8,4,17986,18153,16043,-2110
2016,1,8,5,16696,16844,14929,-1915
2016,1,8,6,15658,15836,13109,-2727
2016,1,8,7,14966,15317,12550,-2767
2016,1,8,8,14576,15028,12367,-2661
2016,1,8,9,14432,14938,12380,-2558
2016,1,8,10,14783,15206,12675,-2531
2016,1,8,11,15557,16166,13260,-2906
2016,1,8,12,17215,18118,15475,-2643
2016,1,8,13,18532,19407,16804,-2603
2016,1,8,14,18980,19712,17131,-2581
2016,1,8,15,19227,19871,17216,-2655
2016,1,8,16,19352,19848,17127,-2721
2016,1,8,17,19304,19698,16917,-2781
2016,1,8,18,19203,19483,16740,-2743
2016,1,8,19,19108,19329,16649,-2680
2016,1,8,20,18977,19243,16727,-2516
2016,1,8,21,18933,19281,16948,-2333
2016,1,8,22,19447,19910,17455,-2455
2016,1,8,23,20584,20755,18131,-2624
2016,1,9,0,20586,20487,17961,-2526
2016,1,9,1,20059,19972,17692,-2280
2016,1,9,2,19499,19359,17358,-2001
2016,1,9,3,18723,18547,16914,-1633
2016,1,9,4,17609,17495,15484,-2011
2016,1,9,5,16343,16304,14164,-2140
2016,1,9,6,15159,15231,13195,-2036
2016,1,9,7,14501,14561,12195,-2366
2016,1,9,8,14061,14147,12036,-2111
2016,1,9,9,13754,13914,11884,-2030
2016,1,9,10,13388,13906,11872,-2034
2016,1,9,11,13642,14249,12296,-1953
2016,1,9,12,14391,14941,12953,-1988
2016,1,9,13,15493,15684,13713,-1971
2016,1,9,14,16224,16481,14203,-2278
2016,1,9,15,16744,17208,14960,-2248
2016,1,9,16,17061,17589,15162,-2427
2016,1,9,17,17134,17724,15430,-2294
2016,1,9,18,17072,17669,15604,-2065
2016,1,9,19,16990,17499,15593,-1906
2016,1,9,20,16930,17362,15237,-2125
2016,1,9,21,17022,17442,15390,-2052
2016,1,9,22,17523,18077,15886,-2191
2016,1,9,23,18685,18950,16525,-2425
2016,1,10,0,18801,18857,16648,-2209
2016,1,10,1,18425,18480,16413,-2067
2016,1,10,2,18039,17928,16159,-1769
2016,1,10,3,17509,17298,15442,-1856
2016,1,10,4,16679,16519,14536,-1983
2016,1,10,5,15680,15578,13338,-2240
2016,1,10,6,14647,14711,12625,-2086
2016,1,10,7,13984,14001,12210,-1791
2016,1,10,8,13526,13560,11900,-1660
2016,1,10,9,13199,13321,11689,-1632
2016,1,10,10,12716,13309,11882,-1427
2016,1,10,11,12774,13570,11984,-1586
2016,1,10,12,13343,14061,12183,-1878
2016,1,10,13,14346,14689,13091,-1598
2016,1,10,14,15003,15458,13977,-1481
2016,1,10,15,15540,16213,14312,-1901
2016,1,10,16,15947,16884,14991,-1893
2016,1,10,17,16137,17212,15183,-2029
2016,1,10,18,16175,17361,15525,-1836
2016,1,10,19,16176,17260,15488,-1772
2016,1,10,20,16197,17164,15123,-2041
2016,1,10,21,16391,17262,15050,-2212
2016,1,10,22,16909,17923,15458,-2465
2016,1,10,23,18239,18957,16595,-2362
2016,1,11,0,18562,19050,16691,-2359
2016,1,11,1,18330,18785,16745,-2040
2016,1,11,2,17931,18382,16253,-2129
2016,1,11,3,17316,17561,15509,-2052
2016,1,11,4,16378,16521,13714,-2807
2016,1,11,5,15368,15457,12916,-2541
2016,1,11,6,14548,14755,12736,-2019
2016,1,11,7,14037,14385,12711,-1674
2016,1,11,8,13764,14174,12135,-2039
2016,1,11,9,13680,14209,12410,-1799
2016,1,11,10,14029,14601,12794,-1807
2016,1,11,11,14904,15720,13018,-2702
2016,1,11,12,16678,17679,14712,-2967
2016,1,11,13,18181,19213,16963,-2250
2016,1,11,14,18708,19645,17100,-2545
2016,1,11,15,19061,19841,17084,-2757
2016,1,11,16,19283,19965,16922,-3043
2016,1,11,17,19350,19976,16766,-3210
2016,1,11,18,19330,19925,16839,-3086
2016,1,11,19,19276,19896,16801,-3095
2016,1,11,20,19218,19874,16623,-3251
2016,1,11,21,19344,20053,16690,-3363
2016,1,11,22,19860,20795,17553,-3242
2016,1,11,23,21206,22112,18445,-3667
2016,1,12,0,21418,22141,18581,-3560
2016,1,12,1,20979,21780,18381,-3399
2016,1,12,2,20334,21213,17839,-3374
2016,1,12,3,19371,20210,17084,-3126
2016,1,12,4,18000,18850,15776,-3074
2016,1,12,5,16626,17504,14731,-2773
2016,1,12,6,15921,16547,13195,-3352
2016,1,12,7,15216,15983,13168,-2815
2016,1,12,8,14853,15662,12962,-2700
2016,1,12,9,14703,15549,12844,-2705
2016,1,12,10,15035,15799,13275,-2524
2016,1,12,11,15867,16790,13876,-2914
2016,1,12,12,17514,18654,15338,-3316
2016,1,12,13,18907,20016,17202,-2814
2016,1,12,14,19328,20256,16908,-3348
2016,1,12,15,19560,20451,16821,-3630
2016,1,12,16,19656,20488,17338,-3150
2016,1,12,17,19611,20490,17216,-3274
2016,1,12,18,19527,20445,17157,-3288
2016,1,12,19,19464,20437,17196,-3241
2016,1,12,20,19394,20392,17111,-3281
2016,1,12,21,19492,20565,17181,-3384
2016,1,12,22,19971,21201,17339,-3862
2016,1,12,23,21213,22181,18024,-4157
2016,1,13,0,21347,22058,18310,-3748
2016,1,13,1,20868,21579,17936,-3643
2016,1,13,2,20232,20852,17611,-3241
2016,1,13,3,19278,19891,17289,-2602
2016,1,13,4,17958,18607,16215,-2392
2016,1,13,5,16617,17383,15043,-2340
2016,1,13,6,15777,16507,13597,-2910
2016,1,13,7,15308,16028,13373,-2655
2016,1,13,8,15033,15747,13185,-2562
2016,1,13,9,14918,15726,13261,-2465
2016,1,13,10,15122,16014,13400,-2614
2016,1,13,11,16076,17030,14449,-2581
2016,1,13,12,17706,18949,16057,-2892
2016,1,13,13,19092,20198,17808,-2390
2016,1,13,14,19604,20581,18091,-2490
2016,1,13,15,19936,20835,17986,-2849
2016,1,13,16,20133,20975,17694,-3281
2016,1,13,17,20115,20925,17133,-3792
2016,1,13,18,20085,20767,16803,-3964
2016,1,13,19,20014,20689,16948,-3741
2016,1,13,20,19954,20626,16814,-3812
2016,1,13,21,20048,20787,16972,-3815
2016,1,13,22,20457,21492,17567,-3925
2016,1,13,23,21677,22820,18390,-4430
2016,1,14,0,21875,22835,18533,-4302
2016,1,14,1,21437,22402,18274,-4128
2016,1,14,2,20854,21748,17962,-3786
2016,1,14,3,19993,20739,17407,-3332
2016,1,14,4,18732,19329,15910,-3419
2016,1,14,5,17416,17953,14655,-3298
2016,1,14,6,16447,17015,13964,-3051
2016,1,14,7,15762,16461,13450,-3011
2016,1,14,8,15392,16137,13353,-2784
2016,1,14,9,15243,16055,13409,-2646
2016,1,14,10,15545,16261,13502,-2759
2016,1,14,11,16391,17155,13596,-3559
2016,1,14,12,18000,19009,15121,-3888
2016,1,14,13,19389,20361,16272,-4089
2016,1,14,14,19860,20734,15884,-4850
2016,1,14,15,20113,20847,16238,-4609
2016,1,14,16,20228,20863,16581,-4282
2016,1,14,17,20121,20779,16532,-4247
2016,1,14,18,20004,20577,16355,-4222
2016,1,14,19,19907,20504,16382,-4122
2016,1,14,20,19783,20378,16256,-4122
2016,1,14,21,19827,20489,16260,-4229
2016,1,14,22,20214,21152,16599,-4553
2016,1,14,23,21341,22122,17053,-5069
2016,1,15,0,21459,21951,17162,-4789
2016,1,15,1,21015,21429,17117,-4312
2016,1,15,2,20419,20720,16855,-3865
2016,1,15,3,19524,19707,16268,-3439
2016,1,15,4,18293,18306,15161,-3145
2016,1,15,5,16975,16906,13747,-3159
2016,1,15,6,15972,15930,12566,-3364
2016,1,15,7,15168,15343,11841,-3502
2016,1,15,8,14707,15018,11326,-3692
2016,1,15,9,14499,14940,11447,-3493
2016,1,15,10,14816,15115,11474,-3641
2016,1,15,11,15595,16029,12104,-3925
2016,1,15,12,17179,17852,14241,-3611
2016,1,15,13,18588,19171,15473,-3698
2016,1,15,14,19054,19536,15668,-3868
2016,1,15,15,19324,19635,15675,-3960
2016,1,15,16,19458,19549,15768,-3781
2016,1,15,17,19396,19372,15557,-3815
2016,1,15,18,19314,19181,15641,-3540
2016,1,15,19,19222,19032,15463,-3569
2016,1,15,20,19111,18908,15255,-3653
2016,1,15,21,19127,18964,15183,-3781
2016,1,15,22,19409,19548,15622,-3926
2016,1,15,23,20330,20422,16163,-4259
2016,1,16,0,20275,20188,16226,-3962
2016,1,16,1,19720,19622,16065,-3557
2016,1,16,2,19170,18993,15632,-3361
2016,1,16,3,18477,18209,14989,-3220
2016,1,16,4,17461,17236,14456,-2780
2016,1,16,5,16256,16008,13447,-2561
2016,1,16,6,15182,15047,12388,-2659
2016,1,16,7,14519,14441,11831,-2610
2016,1,16,8,14108,14181,11904,-2277
2016,1,16,9,13820,13991,11589,-2402
2016,1,16,10,13422,14088,11997,-2091
2016,1,16,11,13726,14400,12122,-2278
2016,1,16,12,14447,15025,12389,-2636
2016,1,16,13,15586,15767,13107,-2660
2016,1,16,14,16308,16603,13937,-2666
2016,1,16,15,16842,17378,14148,-3230
2016,1,16,16,17158,17766,14428,-3338
2016,1,16,17,17240,17867,14683,-3184
2016,1,16,18,17161,17700,14306,-3394
2016,1,16,19,17016,17503,14332,-3171
2016,1,16,20,16922,17431,14099,-3332
2016,1,16,21,16995,17547,14134,-3413
2016,1,16,22,17398,18184,14818,-3366
2016,1,16,23,18566,19050,15188,-3862
2016,1,17,0,18811,19062,15541,-3521
2016,1,17,1,18511,18690,15677,-3013
2016,1,17,2,18164,18252,15571,-2681
2016,1,17,3,17731,17643,14872,-2771
2016,1,17,4,17020,16839,14304,-2535
2016,1,17,5,16114,15914,12969,-2945
2016,1,17,6,15044,15071,12381,-2690
2016,1,17,7,14516,14473,11777,-2696
2016,1,17,8,14156,14114,11669,-2445
2016,1,17,9,13901,13968,11592,-2376
2016,1,17,10,13457,13989,11471,-2518
2016,1,17,11,13509,14271,11660,-2611
2016,1,17,12,13899,14741,12051,-2690
2016,1,17,13,14828,15314,12654,-2660
2016,1,17,14,15534,16216,13315,-2901
2016,1,17,15,16132,17038,13797,-3241
2016,1,17,16,16532,17633,13886,-3747
2016,1,17,17,16699,17972,14108,-3864
2016,1,17,18,16683,18166,14304,-3862
2016,1,17,19,16629,18193,14640,-3553
2016,1,17,20,16601,18217,14599,-3618
2016,1,17,21,16769,18353,14539,-3814
2016,1,17,22,17338,18931,14932,-3999
2016,1,17,23,18594,19946,15494,-4452
2016,1,18,0,18934,20009,15916,-4093
2016,1,18,1,18719,19650,15695,-3955
2016,1,18,2,18377,19210,15587,-3623
2016,1,18,3,17825,18510,15138,-3372
2016,1,18,4,16988,17590,14511,-3079
2016,1,18,5,16036,16586,13648,-2938
2016,1,18,6,15335,15789,12812,-2977
2016,1,18,7,14838,15334,12740,-2594
2016,1,18,8,14568,15071,12251,-2820
2016,1,18,9,14458,15028,12506,-2522
2016,1,18,10,14580,15299,12720,-2579
2016,1,18,11,15223,16107,13017,-3090
2016,1,18,12,16290,17429,14035,-3394
2016,1,18,13,17493,18544,15061,-3483
2016,1,18,14,18381,19378,15651,-3727
2016,1,18,15,19123,20039,16355,-3684
2016,1,18,16,19550,20393,16750,-3643
2016,1,18,17,19646,20556,16475,-4081
2016,1,18,18,19617,20565,16372,-4193
2016,1,18,19,19575,20569,15965,-4604
2016,1,18,20,19471,20607,16220,-4387
2016,1,18,21,19563,20760,16227,-4533
2016,1,18,22,20036,21413,16908,-4505
2016,1,18,23,21173,22801,17603,-5198
2016,1,19,0,21335,22927,17969,-4958
2016,1,19,1,20891,22563,17844,-4719
2016,1,19,2,20338,21832,17303,-4529
2016,1,19,3,19493,20834,16870,-3964
2016,1,19,4,18356,19475,15636,-3839
2016,1,19,5,17150,18171,14791,-3380
2016,1,19,6,16310,17242,13283,-3959
2016,1,19,7,15823,16785,13041,-3744
2016,1,19,8,15590,16553,13214,-3339
2016,1,19,9,15503,16526,13523,-3003
2016,1,19,10,15818,16807,13666,-3141
2016,1,19,11,16706,17807,13829,-3978
2016,1,19,12,18330,19750,14998,-4752
2016,1,19,13,19732,21045,16549,-4496
2016,1,19,14,20209,21390,16701,-4689
2016,1,19,15,20500,21613,16894,-4719
2016,1,19,16,20684,21703,17038,-4665
2016,1,19,17,20671,21670,17253,-4417
2016,1,19,18,20660,21500,16860,-4640
2016,1,19,19,20540,21420,16901,-4519
2016,1,19,20,20436,21328,16722,-4606
2016,1,19,21,20505,21434,17009,-4425
2016,1,19,22,20877,22032,17226,-4806
2016,1,19,23,21952,23228,17971,-5257
2016,1,20,0,22168,23317,18634,-4683
2016,1,20,1,21701,22825,17840,-4985
2016,1,20,2,21037,22120,17812,-4308
2016,1,20,3,20092,21022,16854,-4168
2016,1,20,4,18824,19551,15998,-3553
2016,1,20,5,17515,18093,15101,-2992
2016,1,20,6,16531,17144,14332,-2812
2016,1,20,7,15939,16517,13823,-2694
2016,1,20,8,15634,16199,13646,-2553
2016,1,20,9,15506,16074,13880,-2194
2016,1,20,10,15809,16309,13702,-2607
2016,1,20,11,16669,17252,14092,-3160
2016,1,20,12,18255,19204,15488,-3716
2016,1,20,13,19511,20434,16788,-3646
2016,1,20,14,19927,20695,16287,-4408
2016,1,20,15,20167,20737,16062,-4675
2016,1,20,16,20285,20730,16206,-4524
2016,1,20,17,20240,20576,15974,-4602
2016,1,20,18,20131,20367,15691,-4676
2016,1,20,19,20036,20239,15741,-4498
2016,1,20,20,19941,20195,15743,-4452
2016,1,20,21,20028,20343,16062,-4281
2016,1,20,22,20386,20948,16378,-4570
2016,1,20,23,21470,22081,16813,-5268
2016,1,21,0,21654,22175,16972,-5203
2016,1,21,1,21196,21763,16650,-5113
2016,1,21,2,20602,21126,16287,-4839
2016,1,21,3,19749,20100,15568,-4532
2016,1,21,4,18577,18791,14723,-4068
2016,1,21,5,17338,17438,13652,-3786
2016,1,21,6,16323,16466,12870,-3596
2016,1,21,7,15675,15915,12182,-3733
2016,1,21,8,15372,15645,11761,-3884
2016,1,21,9,15261,15546,11741,-3805
2016,1,21,10,15621,15852,12026,-3826
2016,1,21,11,16474,16867,13237,-3630
2016,1,21,12,18138,18805,15423,-3382
2016,1,21,13,19405,20210,16788,-3422
2016,1,21,14,19800,20497,16356,-4141
2016,1,21,15,20031,20579,16086,-4493
2016,1,21,16,20126,20570,15897,-4673
2016,1,21,17,20121,20419,15694,-4725
2016,1,21,18,20012,20259,15742,-4517
2016,1,21,19,19897,20181,16025,-4156
2016,1,21,20,19811,20106,15685,-4421
2016,1,21,21,19851,20268,16064,-4204
2016,1,21,22,20176,20832,16285,-4547
2016,1,21,23,21321,22163,17424,-4739
2016,1,22,0,21633,22333,17735,-4598
2016,1,22,1,21267,21939,17278,-4661
2016,1,22,2,20695,21355,17084,-4271
2016,1,22,3,19849,20388,16070,-4318
2016,1,22,4,18674,19122,15177,-3945
2016,1,22,5,17437,17745,13928,-3817
2016,1,22,6,16379,16798,12931,-3867
2016,1,22,7,15745,16315,12591,-3724
2016,1,22,8,15413,16062,12426,-3636
2016,1,22,9,15320,15996,12335,-3661
2016,1,22,10,15703,16241,12551,-3690
2016,1,22,11,16522,17243,13397,-3846
2016,1,22,12,18196,19155,15400,-3755
2016,1,22,13,19499,20508,16420,-4088
2016,1,22,14,19950,20872,16403,-4469
2016,1,22,15,20189,21010,16467,-4543
2016,1,22,16,20279,21031,16231,-4800
2016,1,22,17,20197,20825,15906,-4919
2016,1,22,18,20026,20592,15861,-4731
2016,1,22,19,19860,20630,16125,-4505
2016,1,22,20,19693,20639,16279,-4360
2016,1,22,21,19645,20708,15944,-4764
2016,1,22,22,19902,21130,16093,-5037
2016,1,22,23,21065,22016,17523,-4493
2016,1,23,0,21326,21969,17623,-4346
2016,1,23,1,20815,21501,17556,-3945
2016,1,23,2,20254,20854,16755,-4099
2016,1,23,3,19541,20036,15864,-4172
2016,1,23,4,18470,19031,15105,-3926
2016,1,23,5,17230,17931,13929,-4002
2016,1,23,6,16291,16961,13129,-3832
2016,1,23,7,15798,16326,12452,-3874
2016,1,23,8,15513,15963,12182,-3781
2016,1,23,9,15305,15795,12162,-3633
2016,1,23,10,14967,15830,12423,-3407
2016,1,23,11,15257,16184,13116,-3068
2016,1,23,12,16018,16839,14146,-2693
2016,1,23,13,17120,17660,14810,-2850
2016,1,23,14,17894,18474,15148,-3326
2016,1,23,15,18452,19243,15784,-3459
2016,1,23,16,18757,19744,16093,-3651
2016,1,23,17,18840,19914,16353,-3561
2016,1,23,18,18705,19928,16528,-3400
2016,1,23,19,18516,19776,16236,-3540
2016,1,23,20,18395,19584,16136,-3448
2016,1,23,21,18410,19534,16066,-3468
2016,1,23,22,18813,19924,16360,-3564
2016,1,23,23,20000,20916,17352,-3564
2016,1,24,0,20393,20997,17372,-3625
2016,1,24,1,20064,20664,17100,-3564
2016,1,24,2,19661,20116,16664,-3452
2016,1,24,3,19136,19413,15911,-3502
2016,1,24,4,18332,18513,14738,-3775
2016,1,24,5,17328,17499,13608,-3891
2016,1,24,6,16349,16638,13020,-3618
2016,1,24,7,15802,16084,11941,-4143
2016,1,24,8,15468,15745,11589,-4156
2016,1,24,9,15231,15581,11389,-4192
2016,1,24,10,14822,15615,11514,-4101
2016,1,24,11,14940,15838,11551,-4287
2016,1,24,12,15527,16317,12293,-4024
2016,1,24,13,16414,16900,13398,-3502
2016,1,24,14,17023,17602,14212,-3390
2016,1,24,15,17485,18139,14396,-3743
2016,1,24,16,17762,18465,14688,-3777
2016,1,24,17,17881,18603,14700,-3903
2016,1,24,18,17762,18651,14929,-3722
2016,1,24,19,17612,18571,14848,-3723
2016,1,24,20,17557,18549,14829,-3720
2016,1,24,21,17656,18724,14857,-3867
2016,1,24,22,18116,19225,15045,-4180
2016,1,24,23,19504,20591,16231,-4360
2016,1,25,0,20093,20835,16503,-4332
2016,1,25,1,19927,20577,16340,-4237
2016,1,25,2,19556,19953,15552,-4401
2016,1,25,3,18890,19073,14990,-4083
2016,1,25,4,17987,17886,13903,-3983
2016,1,25,5,16969,16774,13191,-3583
2016,1,25,6,16121,15886,11959,-3927
2016,1,25,7,15493,15438,11478,-3960
2016,1,25,8,15182,15222,11576,-3646
2016,1,25,9,15117,15201,11657,-3544
2016,1,25,10,15639,15498,11754,-3744
2016,1,25,11,16436,16430,12771,-3659
2016,1,25,12,18160,18294,15026,-3268
2016,1,25,13,19461,19625,16291,-3334
2016,1,25,14,19874,20022,16250,-3772
2016,1,25,15,20137,20258,15980,-4278
2016,1,25,16,20231,20377,16442,-3935
2016,1,25,17,20166,20333,16402,-3931
2016,1,25,18,19993,20168,16398,-3770
2016,1,25,19,19883,20037,16344,-3693
2016,1,25,20,19787,19819,16060,-3759
2016,1,25,21,19845,19833,15846,-3987
2016,1,25,22,20221,20175,16241,-3934
2016,1,25,23,21313,21430,17935,-3495
2016,1,26,0,21664,21682,18257,-3425
2016,1,26,1,21334,21267,17768,-3499
2016,1,26,2,20675,20598,17188,-3410
2016,1,26,3,19665,19588,16495,-3093
2016,1,26,4,18359,18217,15022,-3195
2016,1,26,5,17013,16887,13999,-2888
2016,1,26,6,16130,15909,13361,-2548
2016,1,26,7,15290,15374,12897,-2477
2016,1,26,8,14810,15005,12212,-2793
2016,1,26,9,14633,14931,12364,-2567
2016,1,26,10,15068,15209,12815,-2394
2016,1,26,11,15824,16143,13422,-2721
2016,1,26,12,17491,17936,15347,-2589
2016,1,26,13,18798,19222,16373,-2849
2016,1,26,14,19193,19599,16674,-2925
2016,1,26,15,19445,19863,16759,-3104
2016,1,26,16,19600,19960,16975,-2985
2016,1,26,17,19596,19892,16981,-2911
2016,1,26,18,19568,19723,16680,-3043
2016,1,26,19,19523,19624,16596,-3028
2016,1,26,20,19478,19532,16703,-2829
2016,1,26,21,19543,19617,16853,-2764
2016,1,26,22,19867,20144,17657,-2487
2016,1,26,23,20755,21224,18442,-2782
2016,1,27,0,20981,21236,18473,-2763
2016,1,27,1,20536,20764,17968,-2796
2016,1,27,2,19855,20067,17523,-2544
2016,1,27,3,18878,19034,16663,-2371
2016,1,27,4,17625,17664,15028,-2636
2016,1,27,5,16317,16364,14383,-1981
2016,1,27,6,15405,15369,12840,-2529
2016,1,27,7,14658,14835,12554,-2281
2016,1,27,8,14239,14549,12427,-2122
2016,1,27,9,14051,14474,12292,-2182
2016,1,27,10,14389,14796,12380,-2416
2016,1,27,11,15223,15806,13266,-2540
2016,1,27,12,16928,17668,15069,-2599
2016,1,27,13,18247,19064,16323,-2741
2016,1,27,14,18684,19408,16423,-2985
2016,1,27,15,18951,19643,16699,-2944
2016,1,27,16,19106,19778,16877,-2901
2016,1,27,17,19108,19675,16725,-2950
2016,1,27,18,19042,19469,16309,-3160
2016,1,27,19,18982,19401,16027,-3374
2016,1,27,20,18938,19321,16137,-3184
2016,1,27,21,19029,19401,16148,-3253
2016,1,27,22,19381,19866,16649,-3217
2016,1,27,23,20429,21045,17473,-3572
2016,1,28,0,20839,21329,17606,-3723
2016,1,28,1,20506,20963,17391,-3572
2016,1,28,2,19890,20319,16854,-3465
2016,1,28,3,18977,19376,16414,-2962
2016,1,28,4,17717,17924,14946,-2978
2016,1,28,5,16405,16691,13787,-2904
2016,1,28,6,15713,15789,13006,-2783
2016,1,28,7,14948,15334,12619,-2715
2016,1,28,8,14539,15085,12444,-2641
2016,1,28,9,14411,15006,12578,-2428
2016,1,28,10,14828,15282,12829,-2453
2016,1,28,11,15631,16197,13446,-2751
2016,1,28,12,17337,18092,15480,-2612
2016,1,28,13,18628,19530,16953,-2577
2016,1,28,14,19017,19882,17187,-2695
2016,1,28,15,19222,19949,16796,-3153
2016,1,28,16,19302,19901,16731,-3170
2016,1,28,17,19247,19763,16853,-2910
2016,1,28,18,19107,19504,16247,-3257
2016,1,28,19,19020,19358,16083,-3275
2016,1,28,20,18915,19203,16163,-3040
2016,1,28,21,18922,19289,16732,-2557
2016,1,28,22,19246,19804,16946,-2858
2016,1,28,23,20312,20897,17639,-3258
2016,1,29,0,20751,21126,17751,-3375
2016,1,29,1,20405,20676,17599,-3077
2016,1,29,2,19774,20091,17165,-2926
2016,1,29,3,18809,19387,16543,-2844
2016,1,29,4,17547,17743,14668,-3075
2016,1,29,5,16205,16487,13675,-2812
2016,1,29,6,15455,15576,12513,-3063
2016,1,29,7,14794,15016,12069,-2947
2016,1,29,8,14422,14717,12367,-2350
2016,1,29,9,14266,14613,12314,-2299
2016,1,29,10,14489,14843,12399,-2444
2016,1,29,11,15364,15814,13026,-2788
2016,1,29,12,17043,17637,14868,-2769
2016,1,29,13,18447,19064,15902,-3162
2016,1,29,14,18983,19450,15952,-3498
2016,1,29,15,19311,19715,15644,-4071
2016,1,29,16,19510,19964,16011,-3953
2016,1,29,17,19515,19983,16355,-3628
2016,1,29,18,19418,19917,16172,-3745
2016,1,29,19,19354,19942,16225,-3717
2016,1,29,20,19230,19903,16266,-3637
2016,1,29,21,19225,19909,16408,-3501
2016,1,29,22,19466,20267,16754,-3513
2016,1,29,23,20295,21036,17033,-4003
2016,1,30,0,20599,21091,17500,-3591
2016,1,30,1,20154,20674,17722,-2952
2016,1,30,2,19593,20150,17463,-2687
2016,1,30,3,18838,19410,16554,-2856
2016,1,30,4,17776,18360,15219,-3141
2016,1,30,5,16539,17148,14282,-2866
2016,1,30,6,15763,16203,12800,-3403
2016,1,30,7,15189,15654,12382,-3272
2016,1,30,8,14839,15293,11853,-3440
2016,1,30,9,14602,15132,11898,-3234
2016,1,30,10,14227,15177,11980,-3197
2016,1,30,11,14544,15514,12347,-3167
2016,1,30,12,15265,16224,13322,-2902
2016,1,30,13,16330,16959,13850,-3109
2016,1,30,14,17101,17723,14492,-3231
2016,1,30,15,17671,18179,14637,-3542
2016,1,30,16,17946,18307,14676,-3631
2016,1,30,17,17968,18250,14678,-3572
2016,1,30,18,17784,17994,14657,-3337
2016,1,30,19,17644,17694,14574,-3120
2016,1,30,20,17493,17513,14496,-3017
2016,1,30,21,17498,17592,14590,-3002
2016,1,30,22,17834,18014,14855,-3159
2016,1,30,23,18900,19109,16111,-2998
2016,1,31,0,19424,19449,16284,-3165
2016,1,31,1,19120,19145,16256,-2889
2016,1,31,2,18647,18708,15688,-3020
2016,1,31,3,18048,18023,15025,-2998
2016,1,31,4,17190,17166,14156,-3010
2016,1,31,5,16162,16187,13136,-3051
2016,1,31,6,15222,15331,12485,-2846
2016,1,31,7,14680,14718,12284,-2434
2016,1,31,8,14303,14350,11890,-2460
2016,1,31,9,14037,14145,11667,-2478
2016,1,31,10,13535,14150,11692,-2458
2016,1,31,11,13599,14280,11707,-2573
2016,1,31,12,14095,14794,12680,-2114
2016,1,31,13,15022,15275,12873,-2402
2016,1,31,14,15681,15983,13070,-2913
2016,1,31,15,16185,16579,13682,-2897
2016,1,31,16,16542,16860,13919,-2941
2016,1,31,17,16670,16946,14039,-2907
2016,1,31,18,16594,16878,13970,-2908
2016,1,31,19,16533,16763,13898,-2865
2016,1,31,20,16474,16645,14024,-2621
2016,1,31,21,16563,16652,13933,-2719
2016,1,31,22,16975,17195,14378,-2817
2016,1,31,23,17989,18568,15481,-3087
2016,2,1,0,18577,19002,15825,-3177
2016,2,1,1,18410,18727,15760,-2967
2016,2,1,2,17989,18223,15679,-2544
2016,2,1,3,17448,17377,15054,-2323
2016,2,1,4,16712,16283,13887,-2396
2016,2,1,5,15891,15092,12757,-2335
2016,2,1,6,14951,14318,12739,-1579
2016,2,1,7,13918,13866,12530,-1336
2016,2,1,8,13565,13608,12799,-809
2016,2,1,9,13459,13576,12498,-1078
2016,2,1,10,13877,13864,12576,-1288
2016,2,1,11,14577,14878,13484,-1394
2016,2,1,12,16116,16853,15363,-1490
2016,2,1,13,17385,18172,16613,-1559
2016,2,1,14,17900,18419,16673,-1746
2016,2,1,15,18244,18667,16137,-2530
2016,2,1,16,18449,18778,16075,-2703
2016,2,1,17,18474,18708,15821,-2887
2016,2,1,18,18397,18659,15677,-2982
2016,2,1,19,18335,18644,15695,-2949
2016,2,1,20,18243,18591,15626,-2965
2016,2,1,21,18207,18645,15754,-2891
2016,2,1,22,18526,19120,16269,-2851
2016,2,1,23,19343,20104,16919,-3185
2016,2,2,0,19803,20315,17048,-3267
2016,2,2,1,19407,19968,16951,-3017
2016,2,2,2,18836,19352,16332,-3020
2016,2,2,3,18048,18386,15571,-2815
2016,2,2,4,17041,17111,14284,-2827
2016,2,2,5,16012,15765,13165,-2600
2016,2,2,6,15274,14821,11675,-3146
2016,2,2,7,14234,14300,11303,-2997
2016,2,2,8,13887,14033,11222,-2811
2016,2,2,9,13821,14004,11113,-2891
2016,2,2,10,14306,14314,11024,-3290
2016,2,2,11,15026,15378,11919,-3459
2016,2,2,12,16610,17384,14357,-3027
2016,2,2,13,17792,18631,15476,-3155
2016,2,2,14,18199,18930,15570,-3360
2016,2,2,15,18409,18957,15469,-3488
2016,2,2,16,18446,18903,15394,-3509
2016,2,2,17,18380,18742,15072,-3670
2016,2,2,18,18178,18535,15228,-3307
2016,2,2,19,18011,18421,14768,-3653
2016,2,2,20,17876,18267,14944,-3323
2016,2,2,21,17816,18347,15165,-3182
2016,2,2,22,18120,18832,15650,-3182
2016,2,2,23,19121,20058,16861,-3197
2016,2,3,0,19766,20449,17114,-3335
2016,2,3,1,19450,20119,16693,-3426
2016,2,3,2,18888,19489,16249,-3240
2016,2,3,3,18059,18576,15543,-3033
2016,2,3,4,16995,17288,14091,-3197
2016,2,3,5,15917,15967,13328,-2639
2016,2,3,6,15187,15022,12128,-2894
2016,2,3,7,14189,14494,11943,-2551
2016,2,3,8,13822,14186,12017,-2169
2016,2,3,9,13666,14105,11929,-2176
2016,2,3,10,13960,14349,11995,-2354
2016,2,3,11,14841,15294,12590,-2704
2016,2,3,12,16412,17158,14632,-2526
2016,2,3,13,17636,18550,16121,-2429
2016,2,3,14,18118,19046,16243,-2803
2016,2,3,15,18406,19330,16364,-2966
2016,2,3,16,18536,19485,16415,-3070
2016,2,3,17,18492,19454,16306,-3148
2016,2,3,18,18368,19395,16311,-3084
2016,2,3,19,18253,19338,16533,-2805
2016,2,3,20,18124,19163,16229,-2934
2016,2,3,21,18078,19183,16285,-2898
2016,2,3,22,18345,19412,16531,-2881
2016,2,3,23,19090,20133,17321,-2812
2016,2,4,0,19531,20176,17109,-3067
2016,2,4,1,19092,19780,17102,-2678
2016,2,4,2,18496,19108,16547,-2561
2016,2,4,3,17659,18069,15043,-3026
2016,2,4,4,16578,16720,13430,-3290
2016,2,4,5,15476,15399,12703,-2696
2016,2,4,6,14768,14445,12237,-2208
2016,2,4,7,13778,13860,11366,-2494
2016,2,4,8,13454,13556,11396,-2160
2016,2,4,9,13316,13431,11202,-2229
2016,2,4,10,13542,13653,11372,-2281
2016,2,4,11,14407,14613,12023,-2590
2016,2,4,12,15991,16578,13907,-2671
2016,2,4,13,17267,17941,15072,-2869
2016,2,4,14,17743,18381,15472,-2909
2016,2,4,15,18033,18650,15382,-3268
2016,2,4,16,18169,18790,15995,-2795
2016,2,4,17,18117,18761,16101,-2660
2016,2,4,18,17988,18732,16273,-2459
2016,2,4,19,17908,18659,15895,-2764
2016,2,4,20,17837,18570,15790,-2780
2016,2,4,21,17811,18615,15821,-2794
2016,2,4,22,18134,19026,16144,-2882
2016,2,4,23,18926,19983,16856,-3127
2016,2,5,0,19480,20192,16999,-3193
2016,2,5,1,19116,19825,16968,-2857
2016,2,5,2,18599,19238,16413,-2825
2016,2,5,3,17868,18321,15404,-2917
2016,2,5,4,16903,17065,13879,-3186
2016,2,5,5,15888,15858,12814,-3044
2016,2,5,6,15179,14914,11621,-3293
2016,2,5,7,14140,14372,11286,-3086
2016,2,5,8,13819,14051,10739,-3312
2016,2,5,9,13719,14041,10766,-3275
2016,2,5,10,14040,14339,11155,-3184
2016,2,5,11,14880,15408,12102,-3306
2016,2,5,12,16558,17261,14326,-2935
2016,2,5,13,17929,18622,15276,-3346
2016,2,5,14,18492,19296,15844,-3452
2016,2,5,15,18791,19906,16224,-3682
2016,2,5,16,18914,20201,16991,-3210
2016,2,5,17,18830,20269,17336,-2933
2016,2,5,18,18602,20001,17024,-2977
2016,2,5,19,18424,19638,16085,-3553
2016,2,5,20,18247,19341,15894,-3447
2016,2,5,21,18130,19234,16021,-3213
2016,2,5,22,18310,19531,16346,-3185
2016,2,5,23,19166,20434,17330,-3104
2016,2,6,0,19843,20758,17864,-2894
2016,2,6,1,19486,20355,17351,-3004
2016,2,6,2,19020,19787,16767,-3020
2016,2,6,3,18435,19023,15971,-3052
2016,2,6,4,17552,17924,14569,-3355
2016,2,6,5,16553,16792,13695,-3097
2016,2,6,6,15777,15867,12840,-3027
2016,2,6,7,14832,15293,12229,-3064
2016,2,6,8,14507,14894,12097,-2797
2016,2,6,9,14285,14732,12036,-2696
2016,2,6,10,13860,14784,11981,-2803
2016,2,6,11,14127,15135,12217,-2918
2016,2,6,12,14831,15824,13275,-2549
2016,2,6,13,15938,16541,14053,-2488
2016,2,6,14,16696,17339,14605,-2734
2016,2,6,15,17149,17923,15192,-2731
2016,2,6,16,17346,18168,15463,-2705
2016,2,6,17,17296,18166,15376,-2790
2016,2,6,18,17071,17986,15222,-2764
2016,2,6,19,16879,17774,15103,-2671
2016,2,6,20,16683,17601,14823,-2778
2016,2,6,21,16634,17496,14727,-2769
2016,2,6,22,16943,17764,15240,-2524
2016,2,6,23,17930,18782,15977,-2805
2016,2,7,0,18677,19359,16273,-3086
2016,2,7,1,18468,19133,16177,-2956
2016,2,7,2,18167,18721,15822,-2899
2016,2,7,3,17804,18127,15419,-2708
2016,2,7,4,17225,17297,14386,-2911
2016,2,7,5,16487,16386,13708,-2678
2016,2,7,6,15669,15530,13189,-2341
2016,2,7,7,14727,14820,12631,-2189
2016,2,7,8,14417,14453,12439,-2014
2016,2,7,9,14199,14268,12199,-2069
2016,2,7,10,13710,14288,12250,-2038
2016,2,7,11,13792,14529,12249,-2280
2016,2,7,12,14308,15110,12971,-2139
2016,2,7,13,15180,15666,13441,-2225
2016,2,7,14,15767,16341,13774,-2567
2016,2,7,15,16163,16796,13871,-2925
2016,2,7,16,16380,17036,14053,-2983
2016,2,7,17,16428,17182,14201,-2981
2016,2,7,18,16266,17194,14291,-2903
2016,2,7,19,16115,17051,14229,-2822
2016,2,7,20,16011,16966,14112,-2854
2016,2,7,21,16040,17138,14127,-3011
2016,2,7,22,16412,17652,14498,-3154
2016,2,7,23,17472,18806,15393,-3413
2016,2,8,0,18345,19029,15762,-3267
2016,2,8,1,18311,18522,15235,-3287
2016,2,8,2,18048,18074,15029,-3045
2016,2,8,3,17505,17549,14901,-2648
2016,2,8,4,16688,16835,13961,-2874
2016,2,8,5,15771,15876,12970,-2906
2016,2,8,6,14942,14963,12697,-2266
2016,2,8,7,14427,14461,12303,-2158
2016,2,8,8,14160,14225,12410,-1815
2016,2,8,9,14124,14177,12323,-1854
2016,2,8,10,14513,14444,12912,-1532
2016,2,8,11,15331,15403,13626,-1777
2016,2,8,12,16911,17214,15573,-1641
2016,2,8,13,18247,18568,16865,-1703
2016,2,8,14,18808,19192,17398,-1794
2016,2,8,15,19136,19649,17789,-1860
2016,2,8,16,19313,19963,17582,-2381
2016,2,8,17,19273,20035,17609,-2426
2016,2,8,18,19139,19976,17314,-2662
2016,2,8,19,19008,19965,17017,-2948
2016,2,8,20,18861,19902,17166,-2736
2016,2,8,21,18861,19943,17176,-2767
2016,2,8,22,19179,20273,17294,-2979
2016,2,8,23,19950,21206,18292,-2914
2016,2,9,0,20587,21466,18705,-2761
2016,2,9,1,20223,21105,18373,-2732
2016,2,9,2,19650,20402,18129,-2273
2016,2,9,3,18751,19395,17052,-2343
2016,2,9,4,17571,18006,15744,-2262
2016,2,9,5,16331,16697,14299,-2398
2016,2,9,6,15506,15822,12914,-2908
2016,2,9,7,14876,15271,12715,-2556
2016,2,9,8,14555,14976,12182,-2794
2016,2,9,9,14454,14923,12101,-2822
2016,2,9,10,14788,15183,12384,-2799
2016,2,9,11,15663,16163,13142,-3021
2016,2,9,12,17250,18017,15320,-2697
2016,2,9,13,18560,19357,16781,-2576
2016,2,9,14,19062,19922,16863,-3059
2016,2,9,15,19349,20215,16764,-3451
2016,2,9,16,19482,20299,16957,-3342
2016,2,9,17,19421,20156,17181,-2975
2016,2,9,18,19270,19984,16992,-2992
2016,2,9,19,19142,19916,16951,-2965
2016,2,9,20,18998,19820,16749,-3071
2016,2,9,21,18996,19841,16785,-3056
2016,2,9,22,19272,20174,17486,-2688
2016,2,9,23,20003,21115,18430,-2685
2016,2,10,0,20650,21474,18378,-3096
2016,2,10,1,20296,21083,18222,-2861
2016,2,10,2,19701,20432,17603,-2829
2016,2,10,3,18775,19436,16810,-2626
2016,2,10,4,17552,18087,15525,-2562
2016,2,10,5,16284,16709,13970,-2739
2016,2,10,6,15445,15769,13321,-2448
2016,2,10,7,14850,15224,13051,-2173
2016,2,10,8,14517,14914,12785,-2129
2016,2,10,9,14394,14851,12677,-2174
2016,2,10,10,14660,15116,12914,-2202
2016,2,10,11,15598,16053,14197,-1856
2016,2,10,12,17190,17982,16412,-1570
2016,2,10,13,18504,19233,17865,-1368
2016,2,10,14,19011,19763,17857,-1906
2016,2,10,15,19292,20104,18093,-2011
2016,2,10,16,19446,20148,17496,-2652
2016,2,10,17,19405,20078,17546,-2532
2016,2,10,18,19283,19932,17485,-2447
2016,2,10,19,19176,19958,17452,-2506
2016,2,10,20,19046,19856,17785,-2071
2016,2,10,21,19033,19905,17866,-2039
2016,2,10,22,19240,20252,18086,-2166
2016,2,10,23,19978,21200,18984,-2216
2016,2,11,0,20629,21663,19460,-2203
2016,2,11,1,20282,21335,19479,-1856
2016,2,11,2,19726,20776,18827,-1949
2016,2,11,3,18888,19867,18124,-1743
2016,2,11,4,17746,18524,16745,-1779
2016,2,11,5,16541,17181,15403,-1778
2016,2,11,6,15741,16342,14179,-2163
2016,2,11,7,15223,15844,13317,-2527
2016,2,11,8,14964,15580,13313,-2267
2016,2,11,9,14892,15597,13058,-2539
2016,2,11,10,15147,15941,13641,-2300
2016,2,11,11,16126,17019,14707,-2312
2016,2,11,12,17760,18956,16809,-2147
2016,2,11,13,19170,20123,18047,-2076
2016,2,11,14,19800,20576,18009,-2567
2016,2,11,15,20157,20882,18234,-2648
2016,2,11,16,20355,21113,18457,-2656
2016,2,11,17,20346,21180,18166,-3014
2016,2,11,18,20250,21150,18598,-2552
2016,2,11,19,20181,21113,18659,-2454
2016,2,11,20,20075,21080,18412,-2668
2016,2,11,21,20085,21220,18359,-2861
2016,2,11,22,20324,21698,19258,-2440
2016,2,11,23,20994,22688,20491,-2197
2016,2,12,0,21686,23301,21664,-1637
2016,2,12,1,21353,23057,21034,-2023
2016,2,12,2,20793,22432,20169,-2263
2016,2,12,3,19949,21564,18565,-2999
2016,2,12,4,18804,20209,17237,-2972
2016,2,12,5,17584,18864,15806,-3058
2016,2,12,6,16655,17923,14615,-3308
2016,2,12,7,16071,17381,13551,-3830
2016,2,12,8,15768,17038,13259,-3779
2016,2,12,9,15726,16941,13112,-3829
2016,2,12,10,16050,17160,13124,-4036
2016,2,12,11,16912,18054,14000,-4054
2016,2,12,12,18491,19839,16839,-3000
2016,2,12,13,19820,20850,18662,-2188
2016,2,12,14,20446,21209,18689,-2520
2016,2,12,15,20791,21395,18570,-2825
2016,2,12,16,20958,21487,18112,-3375
2016,2,12,17,20857,21340,17481,-3859
2016,2,12,18,20670,21003,17150,-3853
2016,2,12,19,20498,20952,17343,-3609
2016,2,12,20,20306,20908,17526,-3382
2016,2,12,21,20185,20971,17231,-3740
2016,2,12,22,20303,21261,17635,-3626
2016,2,12,23,20913,22042,18686,-3356
2016,2,13,0,21466,22330,19171,-3159
2016,2,13,1,21001,21951,18805,-3146
2016,2,13,2,20432,21382,18406,-2976
2016,2,13,3,19717,20534,17243,-3291
2016,2,13,4,18717,19444,15949,-3495
2016,2,13,5,17523,18326,14778,-3548
2016,2,13,6,16560,17423,13464,-3959
2016,2,13,7,16253,16838,13033,-3805
2016,2,13,8,16056,16510,12893,-3617
2016,2,13,9,15935,16386,13007,-3379
2016,2,13,10,15539,16447,13070,-3377
2016,2,13,11,15831,16815,13735,-3080
2016,2,13,12,16467,17525,15066,-2459
2016,2,13,13,17619,18267,15768,-2499
2016,2,13,14,18589,19212,16678,-2534
2016,2,13,15,19264,19950,17325,-2625
2016,2,13,16,19619,20410,17578,-2832
2016,2,13,17,19669,20565,17346,-3219
2016,2,13,18,19523,20547,17211,-3336
2016,2,13,19,19346,20466,16726,-3740
2016,2,13,20,19195,20425,16690,-3735
2016,2,13,21,19141,20578,16762,-3816
2016,2,13,22,19411,21089,17571,-3518
2016,2,13,23,20354,22161,18735,-3426
2016,2,14,0,21239,22917,20035,-2882
2016,2,14,1,21063,22715,19755,-2960
2016,2,14,2,20758,22325,19326,-2999
2016,2,14,3,20359,21744,18624,-3120
2016,2,14,4,19691,20912,17641,-3271
2016,2,14,5,18807,19950,15934,-4016
2016,2,14,6,17798,19120,15339,-3781
2016,2,14,7,17349,18547,14859,-3688
2016,2,14,8,17063,18205,14691,-3514
2016,2,14,9,16907,18074,14522,-3552
2016,2,14,10,16416,18095,14600,-3495
2016,2,14,11,16481,18369,15193,-3176
2016,2,14,12,16784,18907,16270,-2637
2016,2,14,13,17612,19477,17234,-2243
2016,2,14,14,18413,20304,17805,-2499
2016,2,14,15,18993,20830,17914,-2916
2016,2,14,16,19295,21210,17725,-3485
2016,2,14,17,19360,21251,18073,-3178
2016,2,14,18,19163,21096,18040,-3056
2016,2,14,19,18930,20841,17603,-3238
2016,2,14,20,18756,20611,17472,-3139
2016,2,14,21,18707,20565,17278,-3287
2016,2,14,22,19026,20937,17464,-3473
2016,2,14,23,20045,21997,18821,-3176
2016,2,15,0,21146,22763,19779,-2984
2016,2,15,1,21118,22523,19526,-2997
2016,2,15,2,20829,22039,18606,-3433
2016,2,15,3,20331,21392,18107,-3285
2016,2,15,4,19540,20464,17694,-2770
2016,2,15,5,18629,19481,16035,-3446
2016,2,15,6,17646,18557,14970,-3587
2016,2,15,7,17035,18045,14149,-3896
2016,2,15,8,16693,17767,13810,-3957
2016,2,15,9,16621,17655,13756,-3899
2016,2,15,10,16935,17802,14500,-3302
2016,2,15,11,17460,18404,15935,-2469
2016,2,15,12,18310,19439,17034,-2405
2016,2,15,13,19152,20244,17809,-2435
2016,2,15,14,19921,21195,17861,-3334
2016,2,15,15,20529,21787,18095,-3692
2016,2,15,16,20873,22224,18657,-3567
2016,2,15,17,20880,22509,18830,-3679
2016,2,15,18,20710,22437,18821,-3616
2016,2,15,19,20518,22272,19011,-3261
2016,2,15,20,20291,22127,18706,-3421
2016,2,15,21,20155,21961,18400,-3561
2016,2,15,22,20283,22143,18674,-3469
2016,2,15,23,20834,22784,19665,-3119
2016,2,16,0,21653,22951,20168,-2783
2016,2,16,1,21238,22429,20097,-2332
2016,2,16,2,20634,21625,18762,-2863
2016,2,16,3,19809,20582,17143,-3439
2016,2,16,4,18720,19284,15849,-3435
2016,2,16,5,17522,17976,14634,-3342
2016,2,16,6,16482,16906,12891,-4015
2016,2,16,7,15614,16300,12373,-3927
2016,2,16,8,15078,15887,11954,-3933
2016,2,16,9,14865,15704,11630,-4074
2016,2,16,10,15127,15804,11716,-4088
2016,2,16,11,15908,16531,12237,-4294
2016,2,16,12,17422,17830,13193,-4637
2016,2,16,13,18640,18877,14243,-4634
2016,2,16,14,19190,19696,15279,-4417
2016,2,16,15,19537,20182,15613,-4569
2016,2,16,16,19753,20433,16556,-3877
2016,2,16,17,19766,20495,16538,-3957
2016,2,16,18,19722,20493,16192,-4301
2016,2,16,19,19691,20512,16175,-4337
2016,2,16,20,19626,20419,16064,-4355
2016,2,16,21,19650,20189,15763,-4426
2016,2,16,22,19871,20201,15909,-4292
2016,2,16,23,20349,20675,16613,-4062
2016,2,17,0,20927,21056,17110,-3946
2016,2,17,1,20570,20582,16890,-3692
2016,2,17,2,19945,19936,16703,-3233
2016,2,17,3,19070,19064,16030,-3034
2016,2,17,4,17948,17801,15304,-2497
2016,2,17,5,16747,16606,14036,-2570
2016,2,17,6,15856,15687,12921,-2766
2016,2,17,7,15030,15155,12287,-2868
2016,2,17,8,14541,14868,11595,-3273
2016,2,17,9,14369,14779,11571,-3208
2016,2,17,10,14738,14991,11884,-3107
2016,2,17,11,15533,15898,12948,-2950
2016,2,17,12,17170,17443,14586,-2857
2016,2,17,13,18409,18526,15787,-2739
2016,2,17,14,18982,19148,16234,-2914
2016,2,17,15,19278,19724,16499,-3225
2016,2,17,16,19457,20027,16058,-3969
2016,2,17,17,19444,20035,15730,-4305
2016,2,17,18,19320,19998,15692,-4306
2016,2,17,19,19220,20146,16301,-3845
2016,2,17,20,19108,20193,16421,-3772
2016,2,17,21,19103,20285,16355,-3930
2016,2,17,22,19366,20571,16461,-4110
2016,2,17,23,20074,21147,16765,-4382
2016,2,18,0,20909,21462,17253,-4209
2016,2,18,1,20664,21048,17483,-3565
2016,2,18,2,20071,20454,17578,-2876
2016,2,18,3,19171,19574,16750,-2824
2016,2,18,4,17934,18390,15507,-2883
2016,2,18,5,16667,17121,14465,-2656
2016,2,18,6,15983,16229,13304,-2925
2016,2,18,7,15287,15710,12673,-3037
2016,2,18,8,14929,15432,12759,-2673
2016,2,18,9,14830,15385,12847,-2538
2016,2,18,10,15188,15697,12943,-2754
2016,2,18,11,16048,16612,13785,-2827
2016,2,18,12,17703,18139,15127,-3012
2016,2,18,13,18855,19250,16906,-2344
2016,2,18,14,19370,19844,16995,-2849
2016,2,18,15,19625,20058,16847,-3211
2016,2,18,16,19752,20152,16707,-3445
2016,2,18,17,19718,20073,16528,-3545
2016,2,18,18,19580,19862,16254,-3608
2016,2,18,19,19463,19773,16305,-3468
2016,2,18,20,19354,19642,16348,-3294
2016,2,18,21,19288,19610,16445,-3165
2016,2,18,22,19504,19907,16765,-3142
2016,2,18,23,20297,20757,17305,-3452
2016,2,19,0,21245,21638,17846,-3792
2016,2,19,1,21109,21436,17523,-3913
2016,2,19,2,20559,20918,17682,-3236
2016,2,19,3,19678,20049,17077,-2972
2016,2,19,4,18487,18915,16119,-2796
2016,2,19,5,17224,17758,14583,-3175
2016,2,19,6,16495,16864,13847,-3017
2016,2,19,7,15800,16359,13788,-2571
2016,2,19,8,15395,16092,13663,-2429
2016,2,19,9,15284,15997,13648,-2349
2016,2,19,10,15659,16244,13830,-2414
2016,2,19,11,16515,17058,14469,-2589
2016,2,19,12,18108,18468,15661,-2807
2016,2,19,13,19293,19509,16841,-2668
2016,2,19,14,19951,20097,17518,-2579
2016,2,19,15,20345,20449,17790,-2659
2016,2,19,16,20563,20515,17732,-2783
2016,2,19,17,20558,20349,17609,-2740
2016,2,19,18,20456,20316,17570,-2746
2016,2,19,19,20358,20197,17451,-2746
2016,2,19,20,20198,20017,17556,-2461
2016,2,19,21,20064,19904,17428,-2476
2016,2,19,22,20134,20226,17649,-2577
2016,2,19,23,20559,20810,18230,-2580
2016,2,20,0,21187,21020,18370,-2650
2016,2,20,1,20715,20574,18303,-2271
2016,2,20,2,20055,19989,17804,-2185
2016,2,20,3,19220,19181,16528,-2653
2016,2,20,4,18091,18115,15521,-2594
2016,2,20,5,16806,16902,13930,-2972
2016,2,20,6,15790,15966,13787,-2179
2016,2,20,7,15098,15319,12909,-2410
2016,2,20,8,14631,14906,12880,-2026
2016,2,20,9,14323,14679,12868,-1811
2016,2,20,10,13852,14652,12866,-1786
2016,2,20,11,14067,14884,12806,-2078
2016,2,20,12,14710,15455,13476,-1979
2016,2,20,13,15643,16007,13941,-2066
2016,2,20,14,16488,16575,14470,-2105
2016,2,20,15,17030,16919,14571,-2348
2016,2,20,16,17369,17121,15068,-2053
2016,2,20,17,17469,17133,15475,-1658
2016,2,20,18,17337,17013,14807,-2206
2016,2,20,19,17221,16846,14423,-2423
2016,2,20,20,17139,16620,14098,-2522
2016,2,20,21,17100,16483,13968,-2515
2016,2,20,22,17264,16691,14367,-2324
2016,2,20,23,17879,17380,14428,-2952
2016,2,21,0,18669,18207,14935,-3272
2016,2,21,1,18513,18029,15159,-2870
2016,2,21,2,18133,17644,14961,-2683
2016,2,21,3,17678,17110,14891,-2219
2016,2,21,4,16945,16300,13460,-2840
2016,2,21,5,16044,15361,12295,-3066
2016,2,21,6,15044,14582,12142,-2440
2016,2,21,7,14390,14114,11876,-2238
2016,2,21,8,13937,13633,11360,-2273
2016,2,21,9,13621,13456,11280,-2176
2016,2,21,10,13098,13485,11248,-2237
2016,2,21,11,13097,13732,11399,-2333
2016,2,21,12,13502,14217,12057,-2160
2016,2,21,13,14268,14623,12577,-2046
2016,2,21,14,15063,15409,13237,-2172
2016,2,21,15,15618,16127,13755,-2372
2016,2,21,16,16026,16495,13597,-2898
2016,2,21,17,16228,16806,13679,-3127
2016,2,21,18,16214,16956,13752,-3204
2016,2,21,19,16184,16879,13544,-3335
2016,2,21,20,16185,16781,13498,-3283
2016,2,21,21,16279,16899,13629,-3270
2016,2,21,22,16609,17352,14125,-3227
2016,2,21,23,17270,18249,14746,-3503
2016,2,22,0,18136,18929,15458,-3471
2016,2,22,1,18051,18721,15438,-3283
2016,2,22,2,17705,18227,15128,-3099
2016,2,22,3,17172,17472,14307,-3165
2016,2,22,4,16405,16429,13204,-3225
2016,2,22,5,15515,15321,11873,-3448
2016,2,22,6,14734,14625,11768,-2857
2016,2,22,7,14097,14229,11492,-2737
2016,2,22,8,13786,14013,11333,-2680
2016,2,22,9,13683,13980,11314,-2666
2016,2,22,10,14091,14354,11877,-2477
2016,2,22,11,14845,15475,12669,-2806
2016,2,22,12,16326,17322,14227,-3095
2016,2,22,13,17465,18486,15312,-3174
2016,2,22,14,18158,18796,15870,-2926
2016,2,22,15,18534,18891,16021,-2870
2016,2,22,16,18750,18880,15612,-3268
2016,2,22,17,18795,18725,15024,-3701
2016,2,22,18,18705,18515,15079,-3436
2016,2,22,19,18601,18418,15108,-3310
2016,2,22,20,18503,18290,15216,-3074
2016,2,22,21,18424,18361,15392,-2969
2016,2,22,22,18629,18757,15864,-2893
2016,2,22,23,19319,19622,16486,-3136
2016,2,23,0,20261,20577,17188,-3389
2016,2,23,1,20110,20343,16951,-3392
2016,2,23,2,19506,19775,16529,-3246
2016,2,23,3,18629,18854,15629,-3225
2016,2,23,4,17436,17592,14314,-3278
2016,2,23,5,16187,16312,12713,-3599
2016,2,23,6,15436,15534,12384,-3150
2016,2,23,7,14806,15070,12183,-2887
2016,2,23,8,14467,14824,12111,-2713
2016,2,23,9,14345,14782,12160,-2622
2016,2,23,10,14703,15057,12328,-2729
2016,2,23,11,15478,16058,12956,-3102
2016,2,23,12,16893,17904,14887,-3017
2016,2,23,13,17929,19056,16586,-2470
2016,2,23,14,18564,19581,16878,-2703
2016,2,23,15,18914,19843,16488,-3355
2016,2,23,16,19106,19957,16573,-3384
2016,2,23,17,19113,19910,16708,-3202
2016,2,23,18,19035,19824,16600,-3224
2016,2,23,19,18972,19859,16675,-3184
2016,2,23,20,18873,19850,16691,-3159
2016,2,23,21,18782,19926,16915,-3011
2016,2,23,22,18994,20296,17213,-3083
2016,2,23,23,19474,20941,18612,-2329
2016,2,24,0,20219,21333,18893,-2440
2016,2,24,1,19922,20976,18214,-2762
2016,2,24,2,19266,20308,17827,-2481
2016,2,24,3,18328,19257,16851,-2406
2016,2,24,4,17122,17864,15191,-2673
2016,2,24,5,15852,16557,13382,-3175
2016,2,24,6,15163,15644,11954,-3690
2016,2,24,7,14575,15080,11868,-3212
2016,2,24,8,14184,14772,11662,-3110
2016,2,24,9,13988,14754,11710,-3044
2016,2,24,10,14150,14961,11736,-3225
2016,2,24,11,15032,15887,12422,-3465
2016,2,24,12,16430,17696,14476,-3220
2016,2,24,13,17519,18971,15633,-3338
2016,2,24,14,18231,19568,16042,-3526
2016,2,24,15,18706,19982,16619,-3363
2016,2,24,16,18996,20198,16436,-3762
2016,2,24,17,19087,20319,16633,-3686
2016,2,24,18,19089,20317,16713,-3604
2016,2,24,19,19086,20270,16739,-3531
2016,2,24,20,19019,20094,16685,-3409
2016,2,24,21,18979,19997,16589,-3408
2016,2,24,22,19131,20269,16758,-3511
2016,2,24,23,19405,20793,17556,-3237
2016,2,25,0,19933,20938,17948,-2990
2016,2,25,1,19562,20488,17671,-2817
2016,2,25,2,18859,19776,16868,-2908
2016,2,25,3,17903,18629,15454,-3175
2016,2,25,4,16669,17197,13954,-3243
2016,2,25,5,15366,15789,12303,-3486
2016,2,25,6,14668,14781,12312,-2469
2016,2,25,7,14049,14202,12097,-2105
2016,2,25,8,13635,13840,11918,-1922
2016,2,25,9,13426,13723,11781,-1942
2016,2,25,10,13567,13898,11655,-2243
2016,2,25,11,14404,14688,11931,-2757
2016,2,25,12,15804,16598,13727,-2871
2016,2,25,13,16934,17705,14660,-3045
2016,2,25,14,17616,18292,15242,-3050
2016,2,25,15,18033,18805,15356,-3449
2016,2,25,16,18286,19052,15421,-3631
2016,2,25,17,18355,19135,15545,-3590
2016,2,25,18,18337,19032,15435,-3597
2016,2,25,19,18356,19075,15959,-3116
2016,2,25,20,18323,19209,16016,-3193
2016,2,25,21,18301,19468,16407,-3061
2016,2,25,22,18486,19787,16969,-2818
2016,2,25,23,18831,20377,17355,-3022
2016,2,26,0,19603,20850,17871,-2979
2016,2,26,1,19351,20589,17485,-3104
2016,2,26,2,18781,20067,17259,-2808
2016,2,26,3,17979,19133,16036,-3097
2016,2,26,4,16905,17895,14703,-3192
2016,2,26,5,15717,16560,13102,-3458
2016,2,26,6,15117,15676,12564,-3112
2016,2,26,7,14562,15148,12148,-3000
2016,2,26,8,14239,14853,11921,-2932
2016,2,26,9,14106,14829,12326,-2503
2016,2,26,10,14404,15161,12528,-2633
2016,2,26,11,15272,16218,13175,-3043
2016,2,26,12,16797,18061,15027,-3034
2016,2,26,13,18034,19219,16356,-2863
2016,2,26,14,18731,19667,16593,-3074
2016,2,26,15,19167,19894,16520,-3374
2016,2,26,16,19373,19925,16402,-3523
2016,2,26,17,19412,19824,16344,-3480
2016,2,26,18,19312,19644,16207,-3437
2016,2,26,19,19218,19520,16135,-3385
2016,2,26,20,19060,19403,16095,-3308
2016,2,26,21,18952,19459,16292,-3167
2016,2,26,22,19050,19709,16749,-2960
2016,2,26,23,19560,20350,17636,-2714
2016,2,27,0,20486,21106,18280,-2826
2016,2,27,1,20241,20819,17951,-2868
2016,2,27,2,19718,20245,17393,-2852
2016,2,27,3,19018,19540,16778,-2762
2016,2,27,4,17991,18522,15505,-3017
2016,2,27,5,16782,17405,14303,-3102
2016,2,27,6,15819,16482,13445,-3037
2016,2,27,7,15323,15898,12925,-2973
2016,2,27,8,14959,15569,12872,-2697
2016,2,27,9,14742,15372,12869,-2503
2016,2,27,10,14336,15408,12878,-2530
2016,2,27,11,14610,15737,12966,-2771
2016,2,27,12,15123,16348,13955,-2393
2016,2,27,13,16036,17012,14410,-2602
2016,2,27,14,16890,17718,14917,-2801
2016,2,27,15,17403,18171,15257,-2914
2016,2,27,16,17624,18353,15394,-2959
2016,2,27,17,17659,18197,15185,-3012
2016,2,27,18,17475,17906,14851,-3055
2016,2,27,19,17274,17571,14475,-3096
2016,2,27,20,17069,17339,14384,-2955
2016,2,27,21,16960,17272,14445,-2827
2016,2,27,22,17231,17578,14929,-2649
2016,2,27,23,17918,18310,15620,-2690
2016,2,28,0,18910,19301,16709,-2592
2016,2,28,1,18814,19090,16452,-2638
2016,2,28,2,18430,18681,16082,-2599
2016,2,28,3,17894,18069,15531,-2538
2016,2,28,4,17120,17212,14452,-2760
2016,2,28,5,16150,16242,13919,-2323
2016,2,28,6,15191,15383,13410,-1973
2016,2,28,7,14701,14736,12664,-2072
2016,2,28,8,14313,14335,12263,-2072
2016,2,28,9,14065,14119,12186,-1933
2016,2,28,10,13527,14101,12104,-1997
2016,2,28,11,13585,14317,12096,-2221
2016,2,28,12,13946,14692,12847,-1845
2016,2,28,13,14641,15133,12871,-2262
2016,2,28,14,15303,15751,13422,-2329
2016,2,28,15,15795,16139,13520,-2619
2016,2,28,16,16075,16303,13636,-2667
2016,2,28,17,16205,16339,13905,-2434
2016,2,28,18,16134,16231,13817,-2414
2016,2,28,19,16019,16031,13451,-2580
2016,2,28,20,15939,15837,13151,-2686
2016,2,28,21,15933,15828,13320,-2508
2016,2,28,22,16234,16161,13409,-2752
2016,2,28,23,16943,16983,14072,-2911
2016,2,29,0,17944,18215,15250,-2965
2016,2,29,1,18016,18214,15331,-2883
2016,2,29,2,17698,17781,15075,-2706
2016,2,29,3,17121,17003,14668,-2335
2016,2,29,4,16290,15937,13490,-2447
2016,2,29,5,15346,14942,13040,-1902
2016,2,29,6,14362,14124,12243,-1881
2016,2,29,7,13758,13621,12223,-1398
2016,2,29,8,13367,13364,12254,-1110
2016,2,29,9,13293,13274,12352,-922
2016,2,29,10,13733,13587,12264,-1323
2016,2,29,11,14480,14631,13093,-1538
2016,2,29,12,15968,16495,14375,-2120
2016,2,29,13,17129,17689,15585,-2104
2016,2,29,14,17703,18217,15765,-2452
2016,2,29,15,18069,18716,16333,-2383
2016,2,29,16,18271,19020,16695,-2325
2016,2,29,17,18325,19134,16799,-2335
2016,2,29,18,18252,18953,16449,-2504
2016,2,29,19,18181,18746,16230,-2516
2016,2,29,20,18070,18440,15774,-2666
2016,2,29,21,18071,18352,15575,-2777
2016,2,29,22,18263,18628,15948,-2680
2016,2,29,23,18773,19325,16780,-2545
2016,3,1,0,19649,20204,17168,-3036
2016,3,1,1,19539,19963,16795,-3168
2016,3,1,2,18934,19363,16456,-2907
2016,3,1,3,18025,18390,15804,-2586
2016,3,1,4,16842,17078,14444,-2634
2016,3,1,5,15582,15811,13040,-2771
2016,3,1,6,14648,14929,12662,-2267
2016,3,1,7,14105,14468,12507,-1961
2016,3,1,8,13799,14212,12284,-1928
2016,3,1,9,13772,14145,12013,-2132
2016,3,1,10,14250,14423,12144,-2279
2016,3,1,11,15089,15469,12470,-2999
2016,3,1,12,16703,17275,14470,-2805
2016,3,1,13,17776,18348,15650,-2698
2016,3,1,14,18215,18734,15964,-2770
2016,3,1,15,18412,18998,15818,-3180
2016,3,1,16,18467,19096,16042,-3054
2016,3,1,17,18404,18869,15776,-3093
2016,3,1,18,18267,18668,15567,-3101
2016,3,1,19,18175,18569,15455,-3114
2016,3,1,20,18073,18418,15432,-2986
2016,3,1,21,18112,18427,15535,-2892
2016,3,1,22,18371,18792,15861,-2931
2016,3,1,23,18844,19563,16655,-2908
2016,3,2,0,19791,20515,17643,-2872
2016,3,2,1,19714,20253,16913,-3340
2016,3,2,2,19108,19615,16431,-3184
2016,3,2,3,18131,18633,15969,-2664
2016,3,2,4,16815,17228,14680,-2548
2016,3,2,5,15473,15821,13047,-2774
2016,3,2,6,14723,14856,12784,-2072
2016,3,2,7,14213,14294,12434,-1860
2016,3,2,8,13918,13992,12445,-1547
2016,3,2,9,13827,13949,12635,-1314
2016,3,2,10,14107,14200,12424,-1776
2016,3,2,11,14942,15215,13043,-2172
2016,3,2,12,16433,17031,14846,-2185
2016,3,2,13,17544,18264,16740,-1524
2016,3,2,14,18054,18848,16952,-1896
2016,3,2,15,18319,19070,17035,-2035
2016,3,2,16,18441,19205,17082,-2123
2016,3,2,17,18420,19249,17344,-1905
2016,3,2,18,18356,19133,17282,-1851
2016,3,2,19,18323,19035,17072,-1963
2016,3,2,20,18274,18947,17229,-1718
2016,3,2,21,18320,18962,17121,-1841
2016,3,2,22,18586,19198,17380,-1818
2016,3,2,23,19027,19775,17446,-2329
2016,3,3,0,20024,20805,18088,-2717
2016,3,3,1,20003,20855,18364,-2491
2016,3,3,2,19521,20435,17909,-2526
2016,3,3,3,18726,19520,17352,-2168
2016,3,3,4,17567,18224,16203,-2021
2016,3,3,5,16368,16935,14709,-2226
2016,3,3,6,15526,16097,13785,-2312
2016,3,3,7,15032,15572,13400,-2172
2016,3,3,8,14809,15299,12909,-2390
2016,3,3,9,14810,15276,12979,-2297
2016,3,3,10,15233,15613,13158,-2455
2016,3,3,11,16068,16643,13977,-2666
2016,3,3,12,17548,18352,15973,-2379
2016,3,3,13,18554,19422,16919,-2503
2016,3,3,14,18941,19751,17125,-2626
2016,3,3,15,19114,19826,17295,-2531
2016,3,3,16,19122,19836,17384,-2452
2016,3,3,17,19041,19658,17218,-2440
2016,3,3,18,18821,19493,17213,-2280
2016,3,3,19,18672,19404,17132,-2272
2016,3,3,20,18537,19314,16844,-2470
2016,3,3,21,18500,19334,16740,-2594
2016,3,3,22,18808,19717,16790,-2927
2016,3,3,23,19386,20417,17668,-2749
2016,3,4,0,20362,21234,18306,-2928
2016,3,4,1,20354,21002,18179,-2823
2016,3,4,2,19867,20459,17823,-2636
2016,3,4,3,19016,19549,17082,-2467
2016,3,4,4,17816,18224,15665,-2559
2016,3,4,5,16565,16983,14542,-2441
2016,3,4,6,15595,16069,13564,-2505
2016,3,4,7,15049,15555,13417,-2138
2016,3,4,8,14788,15310,13336,-1974
2016,3,4,9,14733,15245,13542,-1703
2016,3,4,10,15076,15525,13930,-1595
2016,3,4,11,15929,16432,14206,-2226
2016,3,4,12,17407,18060,16216,-1844
2016,3,4,13,18492,19229,17360,-1869
2016,3,4,14,18992,19841,17918,-1923
2016,3,4,15,19260,20189,17690,-2499
2016,3,4,16,19358,20241,17821,-2420
2016,3,4,17,19256,20113,17491,-2622
2016,3,4,18,19080,19925,17382,-2543
2016,3,4,19,18903,19731,17583,-2148
2016,3,4,20,18693,19445,17252,-2193
2016,3,4,21,18592,19270,16783,-2487
2016,3,4,22,18747,19377,16729,-2648
2016,3,4,23,19115,19761,17226,-2535
2016,3,5,0,20061,20495,17859,-2636
2016,3,5,1,20018,20264,18083,-2181
2016,3,5,2,19584,19782,17913,-1869
2016,3,5,3,18908,19030,17103,-1927
2016,3,5,4,17895,18011,15905,-2106
2016,3,5,5,16698,16943,14686,-2257
2016,3,5,6,15639,16031,13267,-2764
2016,3,5,7,15165,15437,13066,-2371
2016,3,5,8,14882,15130,12928,-2202
2016,3,5,9,14693,15019,12657,-2362
2016,3,5,10,14331,15089,12695,-2394
2016,3,5,11,14621,15490,13493,-1997
2016,3,5,12,15225,16060,14370,-1690
2016,3,5,13,16047,16762,15347,-1415
2016,3,5,14,16708,17473,15704,-1769
2016,3,5,15,17111,17900,16051,-1849
2016,3,5,16,17241,18068,15761,-2307
2016,3,5,17,17145,17963,15399,-2564
2016,3,5,18,16905,17771,15270,-2501
2016,3,5,19,16688,17445,15102,-2343
2016,3,5,20,16515,17187,15092,-2095
2016,3,5,21,16483,17258,15301,-1957
2016,3,5,22,16764,17521,15707,-1814
2016,3,5,23,17351,18094,16495,-1599
2016,3,6,0,18486,18982,17023,-1959
2016,3,6,1,18576,18888,16791,-2097
2016,3,6,2,18343,18505,16717,-1788
2016,3,6,3,17901,17962,16352,-1610
2016,3,6,4,17192,17135,14824,-2311
2016,3,6,5,16237,16235,13781,-2454
2016,3,6,6,15437,15467,13320,-2147
2016,3,6,7,14939,14907,13156,-1751
2016,3,6,8,14630,14584,13035,-1549
2016,3,6,9,14406,14450,13113,-1337
2016,3,6,10,13919,14460,13304,-1156
2016,3,6,11,14036,14730,13513,-1217
2016,3,6,12,14432,15111,14301,-810
2016,3,6,13,15146,15551,14550,-1001
2016,3,6,14,15686,16091,14691,-1400
2016,3,6,15,16018,16655,15163,-1492
2016,3,6,16,16173,16778,14988,-1790
2016,3,6,17,16126,16712,14517,-2195
2016,3,6,18,15921,16556,14301,-2255
2016,3,6,19,15746,16374,14401,-1973
2016,3,6,20,15617,16247,14153,-2094
2016,3,6,21,15601,16262,14218,-2044
2016,3,6,22,15912,16624,14628,-1996
2016,3,6,23,16642,17371,14902,-2469
2016,3,7,0,17931,18624,16271,-2353
2016,3,7,1,18220,18767,16732,-2035
2016,3,7,2,18025,18433,16587,-1846
2016,3,7,3,17537,17727,16118,-1609
2016,3,7,4,16760,16760,14862,-1898
2016,3,7,5,15849,15716,14125,-1591
2016,3,7,6,15007,14968,13621,-1347
2016,3,7,7,14375,14518,13315,-1203
2016,3,7,8,14060,14287,12956,-1331
2016,3,7,9,13997,14232,12828,-1404
2016,3,7,10,14531,14501,13090,-1411
2016,3,7,11,15279,15495,14491,-1004
2016,3,7,12,16748,17129,16185,-944
2016,3,7,13,17839,18189,16260,-1929
2016,3,7,14,18273,18556,16411,-2145
2016,3,7,15,18493,18682,16654,-2028
2016,3,7,16,18552,18683,16643,-2040
2016,3,7,17,18447,18565,16659,-1906
2016,3,7,18,18231,18396,17058,-1338
2016,3,7,19,18030,18341,16682,-1659
2016,3,7,20,17813,18190,16370,-1820
2016,3,7,21,17690,18198,16111,-2087
2016,3,7,22,17857,18393,16470,-1923
2016,3,7,23,18353,18932,16455,-2477
2016,3,8,0,19457,19780,16902,-2878
2016,3,8,1,19490,19568,16621,-2947
2016,3,8,2,18941,18961,16181,-2780
2016,3,8,3,18016,17925,15050,-2875
2016,3,8,4,16795,16544,13657,-2887
2016,3,8,5,15518,15243,12724,-2519
2016,3,8,6,14537,14306,11380,-2926
2016,3,8,7,13835,13826,10759,-3067
2016,3,8,8,13457,13582,10757,-2825
2016,3,8,9,13335,13544,10684,-2860
2016,3,8,10,13794,13833,10930,-2903
2016,3,8,11,14666,14822,11856,-2966
2016,3,8,12,16207,16456,13488,-2968
2016,3,8,13,17335,17553,14475,-3078
2016,3,8,14,17792,17884,14682,-3202
2016,3,8,15,18011,17998,14522,-3476
2016,3,8,16,18074,18034,14531,-3503
2016,3,8,17,17945,17940,14565,-3375
2016,3,8,18,17777,17799,14397,-3402
2016,3,8,19,17621,17704,14295,-3409
2016,3,8,20,17407,17679,14253,-3426
2016,3,8,21,17318,17697,14082,-3615
2016,3,8,22,17475,17904,14289,-3615
2016,3,8,23,17866,18425,14875,-3550
2016,3,9,0,18903,19279,15325,-3954
2016,3,9,1,18945,19133,15677,-3456
2016,3,9,2,18382,18527,15519,-3008
2016,3,9,3,17415,17478,14594,-2884
2016,3,9,4,16133,16175,12862,-3313
2016,3,9,5,14806,14908,11711,-3197
2016,3,9,6,14045,13969,11461,-2508
2016,3,9,7,13408,13440,11510,-1930
2016,3,9,8,13039,13176,11097,-2079
2016,3,9,9,12900,13131,11085,-2046
2016,3,9,10,13285,13374,11432,-1942
2016,3,9,11,14243,14332,11786,-2546
2016,3,9,12,15769,15888,13051,-2837
2016,3,9,13,16908,17006,13951,-3055
2016,3,9,14,17433,17427,14374,-3053
2016,3,9,15,17762,17510,14252,-3258
2016,3,9,16,17943,17600,14336,-3264
2016,3,9,17,17960,17603,14394,-3209
2016,3,9,18,17905,17599,14579,-3020
2016,3,9,19,17794,17612,14730,-2882
2016,3,9,20,17613,17581,14735,-2846
2016,3,9,21,17539,17654,14860,-2794
2016,3,9,22,17635,17823,15167,-2656
2016,3,9,23,17936,18179,15440,-2739
2016,3,10,0,18896,18937,15823,-3114
2016,3,10,1,18901,18741,15868,-2873
2016,3,10,2,18313,18047,15211,-2836
2016,3,10,3,17337,17043,14227,-2816
2016,3,10,4,16046,15732,13079,-2653
2016,3,10,5,14708,14427,11684,-2743
2016,3,10,6,13844,13437,10658,-2779
2016,3,10,7,13222,12879,10280,-2599
2016,3,10,8,12853,12568,10026,-2542
2016,3,10,9,12699,12483,9836,-2647
2016,3,10,10,13001,12662,10162,-2500
2016,3,10,11,13935,13572,10624,-2948
2016,3,10,12,15497,15278,11883,-3395
2016,3,10,13,16721,16572,13182,-3390
2016,3,10,14,17315,17276,14046,-3230
2016,3,10,15,17688,17711,14495,-3216
2016,3,10,16,17885,18064,14960,-3104
2016,3,10,17,17874,18194,15390,-2804
2016,3,10,18,17829,18265,15552,-2713
2016,3,10,19,17802,18333,15383,-2950
2016,3,10,20,17686,18281,15478,-2803
2016,3,10,21,17640,18289,15414,-2875
2016,3,10,22,17825,18508,15554,-2954
2016,3,10,23,18011,18909,16003,-2906
2016,3,11,0,18875,19317,16404,-2913
2016,3,11,1,18816,19009,16006,-3003
2016,3,11,2,18212,18329,15309,-3020
2016,3,11,3,17265,17344,14508,-2836
2016,3,11,4,16031,16078,13031,-3047
2016,3,11,5,14709,14763,12062,-2701
2016,3,11,6,13779,13826,11721,-2105
2016,3,11,7,13091,13261,11298,-1963
2016,3,11,8,12692,12884,11193,-1691
2016,3,11,9,12544,12768,11111,-1657
2016,3,11,10,12795,12965,11289,-1676
2016,3,11,11,13701,13865,11614,-2251
2016,3,11,12,15268,15553,12913,-2640
2016,3,11,13,16566,16870,13944,-2926
2016,3,11,14,17189,17516,14374,-3142
2016,3,11,15,17489,17839,14547,-3292
2016,3,11,16,17598,17959,14534,-3425
2016,3,11,17,17542,17931,14441,-3490
2016,3,11,18,17351,17820,14091,-3729
2016,3,11,19,17158,17724,13963,-3761
2016,3,11,20,16927,17597,13960,-3637
2016,3,11,21,16774,17530,13692,-3838
2016,3,11,22,16779,17590,13856,-3734
2016,3,11,23,17089,17810,14300,-3510
2016,3,12,0,18105,18491,14992,-3499
2016,3,12,1,18192,18338,15068,-3270
2016,3,12,2,17721,17833,14729,-3104
2016,3,12,3,17020,17140,13996,-3144
2016,3,12,4,15962,16176,12868,-3308
2016,3,12,5,14733,15056,12118,-2938
2016,3,12,6,13919,14185,11380,-2805
2016,3,12,7,13386,13590,11066,-2524
2016,3,12,8,13058,13282,10830,-2452
2016,3,12,9,12858,13143,10874,-2269
2016,3,12,10,12467,13223,11077,-2146
2016,3,12,11,12805,13591,11107,-2484
2016,3,12,12,13445,14095,11579,-2516
2016,3,12,13,14401,14815,12281,-2534
2016,3,12,14,15161,15500,12574,-2926
2016,3,12,15,15612,15903,12411,-3492
2016,3,12,16,15742,16075,12591,-3484
2016,3,12,17,15656,16018,12425,-3593
2016,3,12,18,15410,15806,12339,-3467
2016,3,12,19,15151,15571,12305,-3266
2016,3,12,20,14905,15368,12195,-3173
2016,3,12,21,14778,15371,12435,-2936
2016,3,12,22,14939,15593,12908,-2685
2016,3,12,23,15545,16061,13108,-2953
2016,3,13,0,16727,17044,14009,-3035
2016,3,13,1,16938,17083,14142,-2941
2016,3,13,2,16598,16686,13898,-2788
2016,3,13,3,16064,16122,13227,-2895
2016,3,13,4,15222,15266,12476,-2790
2016,3,13,5,14219,14377,12068,-2309
2016,3,13,6,13339,13536,11660,-1876
2016,3,13,7,12673,12975,11064,-1911
2016,3,13,8,12316,12701,10571,-2130
2016,3,13,9,12315,12596,10327,-2269
2016,3,13,10,12736,12731,10307,-2424
2016,3,13,11,12972,13121,10386,-2735
2016,3,13,12,13422,13502,10682,-2820
2016,3,13,13,13862,14114,11081,-3033
2016,3,13,14,14283,14667,11578,-3089
2016,3,13,15,14550,15151,11735,-3416
2016,3,13,16,14659,15492,11914,-3578
2016,3,13,17,14596,15572,11814,-3758
2016,3,13,18,14497,15552,12016,-3536
2016,3,13,19,14344,15524,11889,-3635
2016,3,13,20,14279,15542,11936,-3606
2016,3,13,21,14431,15745,12175,-3570
2016,3,13,22,14676,16127,12569,-3558
2016,3,13,23,14970,16615,13231,-3384
2016,3,14,0,15859,17369,13885,-3484
2016,3,14,1,16093,17291,13975,-3316
2016,3,14,2,15509,16612,13258,-3354
2016,3,14,3,14604,15567,12499,-3068
2016,3,14,4,13620,14428,12010,-2418
2016,3,14,5,12781,13564,12074,-1490
2016,3,14,6,12548,13031,11031,-2000
2016,3,14,7,12460,12743,10694,-2049
2016,3,14,8,12498,12641,10683,-1958
2016,3,14,9,12633,12908,11078,-1830
2016,3,14,10,13315,13832,11648,-2184
2016,3,14,11,15190,15721,12980,-2741
2016,3,14,12,16634,17279,14452,-2827
2016,3,14,13,17390,17943,14779,-3164
2016,3,14,14,17713,18418,15061,-3357
2016,3,14,15,17896,18738,15469,-3269
2016,3,14,16,17957,18814,15508,-3306
2016,3,14,17,17864,18743,15832,-2911
2016,3,14,18,17822,18749,15788,-2961
2016,3,14,19,17686,18608,15720,-2888
2016,3,14,20,17640,18608,15732,-2876
2016,3,14,21,17763,18766,15258,-3508
2016,3,14,22,17895,19020,15506,-3514
2016,3,14,23,17813,19134,15831,-3303
2016,3,15,0,18352,19454,15857,-3597
2016,3,15,1,18326,19053,15617,-3436
2016,3,15,2,17429,18156,15073,-3083
2016,3,15,3,16169,16839,13812,-3027
2016,3,15,4,14827,15456,12985,-2471
2016,3,15,5,13645,14410,12355,-2055
2016,3,15,6,12879,13787,12004,-1783
2016,3,15,7,12602,13446,11949,-1497
2016,3,15,8,12583,13319,11687,-1632
2016,3,15,9,12743,13499,11666,-1833
2016,3,15,10,13639,14371,12403,-1968
2016,3,15,11,15223,16278,13981,-2297
2016,3,15,12,16654,17627,15256,-2371
2016,3,15,13,17319,18013,15256,-2757
2016,3,15,14,17520,18333,15347,-2986
2016,3,15,15,17591,18430,15651,-2779
2016,3,15,16,17554,18333,15535,-2798
2016,3,15,17,17414,18166,15703,-2463
2016,3,15,18,17328,18083,15304,-2779
2016,3,15,19,17175,17987,15345,-2642
2016,3,15,20,17124,17927,15037,-2890
2016,3,15,21,17225,18047,15146,-2901
2016,3,15,22,17321,18178,15054,-3124
2016,3,15,23,17232,18135,15278,-2857
2016,3,16,0,17781,18697,15773,-2924
2016,3,16,1,17808,18466,15476,-2990
2016,3,16,2,16948,17672,14598,-3074
2016,3,16,3,15701,16395,13746,-2649
2016,3,16,4,14382,15024,12936,-2088
2016,3,16,5,13487,14007,11358,-2649
2016,3,16,6,12739,13387,11071,-2316
2016,3,16,7,12534,13083,10974,-2109
2016,3,16,8,12547,12955,10823,-2132
2016,3,16,9,12668,13146,10891,-2255
2016,3,16,10,13404,14096,11914,-2182
2016,3,16,11,15099,15915,12907,-3008
2016,3,16,12,16515,17132,14065,-3067
2016,3,16,13,17233,17514,14400,-3114
2016,3,16,14,17440,17648,14148,-3500
2016,3,16,15,17464,17737,14452,-3285
2016,3,16,16,17438,17669,14382,-3287
2016,3,16,17,17278,17551,14509,-3042
2016,3,16,18,17188,17509,14323,-3186
2016,3,16,19,17055,17437,14355,-3082
2016,3,16,20,17006,17445,14330,-3115
2016,3,16,21,17116,17554,14486,-3068
2016,3,16,22,17209,17750,14695,-3055
2016,3,16,23,17191,18042,15108,-2934
2016,3,17,0,17706,18382,15112,-3270
2016,3,17,1,17750,18116,15174,-2942
2016,3,17,2,16928,17343,14517,-2826
2016,3,17,3,15718,16155,13459,-2696
2016,3,17,4,14368,14848,12745,-2103
2016,3,17,5,13385,13880,12201,-1679
2016,3,17,6,12655,13273,11620,-1653
2016,3,17,7,12422,12944,11262,-1682
2016,3,17,8,12410,12857,11046,-1811
2016,3,17,9,12547,13060,10810,-2250
2016,3,17,10,13338,14002,11837,-2165
2016,3,17,11,15031,15954,13316,-2638
2016,3,17,12,16493,17244,14734,-2510
2016,3,17,13,17190,17613,14789,-2824
2016,3,17,14,17403,17769,14691,-3078
2016,3,17,15,17426,17762,14641,-3121
2016,3,17,16,17378,17666,14300,-3366
2016,3,17,17,17223,17628,14450,-3178
2016,3,17,18,17152,17705,14477,-3228
2016,3,17,19,17018,17608,14562,-3046
2016,3,17,20,16960,17510,14599,-2911
2016,3,17,21,17038,17473,14545,-2928
2016,3,17,22,17191,17713,14938,-2775
2016,3,17,23,17226,17817,14926,-2891
2016,3,18,0,17729,18267,14984,-3283
2016,3,18,1,17791,18124,15026,-3098
2016,3,18,2,17024,17408,14562,-2846
2016,3,18,3,15831,16218,13233,-2985
2016,3,18,4,14546,14956,12499,-2457
2016,3,18,5,13492,13980,11759,-2221
2016,3,18,6,12824,13421,11062,-2359
2016,3,18,7,12620,13099,11034,-2065
2016,3,18,8,12602,12992,10923,-2069
2016,3,18,9,12717,13210,11077,-2133
2016,3,18,10,13409,14141,12051,-2090
2016,3,18,11,15143,15973,13332,-2641
2016,3,18,12,16600,17195,14276,-2919
2016,3,18,13,17269,17640,14528,-3112
2016,3,18,14,17606,17944,14844,-3100
2016,3,18,15,17751,18049,14952,-3097
2016,3,18,16,17763,18030,14915,-3115
2016,3,18,17,17617,17913,14798,-3115
2016,3,18,18,17544,17909,14662,-3247
2016,3,18,19,17404,17821,14737,-3084
2016,3,18,20,17309,17734,14566,-3168
2016,3,18,21,17335,17694,14512,-3182
2016,3,18,22,17285,17797,14864,-2933
2016,3,18,23,17309,17796,15140,-2656
2016,3,19,0,17786,18160,15371,-2789
2016,3,19,1,17858,18068,15062,-3006
2016,3,19,2,17213,17481,14371,-3110
2016,3,19,3,16263,16527,13182,-3345
2016,3,19,4,15156,15416,12426,-2990
2016,3,19,5,14142,14497,11996,-2501
2016,3,19,6,13346,13928,11504,-2424
2016,3,19,7,13131,13590,11150,-2440
2016,3,19,8,13051,13474,11336,-2138
2016,3,19,9,13096,13546,11362,-2184
2016,3,19,10,13319,13910,11633,-2277
2016,3,19,11,14113,14615,12211,-2404
2016,3,19,12,14746,15386,13066,-2320
2016,3,19,13,15266,16119,13590,-2529
2016,3,19,14,15863,16533,13996,-2537
2016,3,19,15,16215,16759,14182,-2577
2016,3,19,16,16285,16692,14056,-2636
2016,3,19,17,16183,16494,13705,-2789
2016,3,19,18,15955,16277,13318,-2959
2016,3,19,19,15702,16122,13238,-2884
2016,3,19,20,15565,16033,13393,-2640
2016,3,19,21,15599,16032,13395,-2637
2016,3,19,22,15765,16330,13910,-2420
2016,3,19,23,16211,16689,14093,-2596
2016,3,20,0,16892,17415,14996,-2419
2016,3,20,1,17122,17598,14945,-2653
2016,3,20,2,16656,17156,14011,-3145
2016,3,20,3,15911,16410,13799,-2611
2016,3,20,4,15022,15553,13057,-2496
2016,3,20,5,14355,14761,12988,-1773
2016,3,20,6,13774,14207,12150,-2057
2016,3,20,7,13498,13868,11824,-2044
2016,3,20,8,13372,13730,11761,-1969
2016,3,20,9,13373,13758,12028,-1730
2016,3,20,10,13442,14040,12026,-2014
2016,3,20,11,14019,14556,12234,-2322
2016,3,20,12,14422,15060,12984,-2076
2016,3,20,13,14811,15763,13423,-2340
2016,3,20,14,15325,16308,13623,-2685
2016,3,20,15,15685,16721,13708,-3013
2016,3,20,16,15826,16871,13750,-3121
2016,3,20,17,15811,16941,13623,-3318
2016,3,20,18,15727,16755,13252,-3503
2016,3,20,19,15620,16478,13044,-3434
2016,3,20,20,15584,16338,13161,-3177
2016,3,20,21,15719,16526,13414,-3112
2016,3,20,22,16035,17042,13987,-3055
2016,3,20,23,16497,17490,14832,-2658
2016,3,21,0,17127,18150,15693,-2457
2016,3,21,1,17412,18177,15694,-2483
2016,3,21,2,16979,17526,14812,-2714
2016,3,21,3,16110,16541,14052,-2489
2016,3,21,4,15107,15465,13303,-2162
2016,3,21,5,14260,14680,12795,-1885
2016,3,21,6,13827,14248,12403,-1845
2016,3,21,7,13584,13992,11791,-2201
2016,3,21,8,13517,13985,12255,-1730
2016,3,21,9,13642,14266,12731,-1535
2016,3,21,10,14336,15284,13787,-1497
2016,3,21,11,16202,16945,14675,-2270
2016,3,21,12,17634,18261,15947,-2314
2016,3,21,13,18170,18808,16192,-2616
2016,3,21,14,18452,18887,16337,-2550
2016,3,21,15,18590,18919,16565,-2354
2016,3,21,16,18549,18761,16565,-2196
2016,3,21,17,18385,18636,16340,-2296
2016,3,21,18,18289,18454,16256,-2198
2016,3,21,19,18165,18224,15958,-2266
2016,3,21,20,18062,18100,15827,-2273
2016,3,21,21,18089,18232,15956,-2276
2016,3,21,22,18225,18484,16187,-2297
2016,3,21,23,18487,18645,16491,-2154
2016,3,22,0,18945,19323,17017,-2306
2016,3,22,1,19069,19278,16975,-2303
2016,3,22,2,18405,18474,15770,-2704
2016,3,22,3,17230,17221,14489,-2732
2016,3,22,4,15884,15902,13867,-2035
2016,3,22,5,14847,15014,12828,-2186
2016,3,22,6,14080,14480,12557,-1923
2016,3,22,7,13793,14192,12312,-1880
2016,3,22,8,13689,14140,12249,-1891
2016,3,22,9,13825,14392,12238,-2154
2016,3,22,10,14515,15369,13000,-2369
2016,3,22,11,16295,17151,14589,-2562
2016,3,22,12,17724,18285,15324,-2961
2016,3,22,13,18229,18568,15415,-3153
2016,3,22,14,18433,18610,15472,-3138
2016,3,22,15,18531,18606,15491,-3115
2016,3,22,16,18458,18428,15296,-3132
2016,3,22,17,18316,18207,15054,-3153
2016,3,22,18,18221,18041,14910,-3131
2016,3,22,19,18076,17855,14629,-3226
2016,3,22,20,17979,17750,14758,-2992
2016,3,22,21,17971,17845,14803,-3042
2016,3,22,22,18119,18014,15180,-2834
2016,3,22,23,18272,18138,15539,-2599
2016,3,23,0,18573,18770,16043,-2727
2016,3,23,1,18638,18661,16155,-2506
2016,3,23,2,17974,17822,15536,-2286
2016,3,23,3,16780,16568,14601,-1967
2016,3,23,4,15442,15243,13331,-1912
2016,3,23,5,14287,14248,12393,-1855
2016,3,23,6,13483,13666,11650,-2016
2016,3,23,7,13141,13318,11251,-2067
2016,3,23,8,12997,13215,11256,-1959
2016,3,23,9,13076,13424,11437,-1987
2016,3,23,10,13748,14316,12307,-2009
2016,3,23,11,15416,16103,14391,-1712
2016,3,23,12,16915,17363,15809,-1554
2016,3,23,13,17548,17848,16012,-1836
2016,3,23,14,17827,18050,15929,-2121
2016,3,23,15,17981,18176,15846,-2330
2016,3,23,16,17978,18198,15675,-2523
2016,3,23,17,17886,18099,15435,-2664
2016,3,23,18,17850,18047,15062,-2985
2016,3,23,19,17746,17920,14839,-3081
2016,3,23,20,17677,17927,14877,-3050
2016,3,23,21,17699,18076,15466,-2610
2016,3,23,22,17864,18227,15316,-2911
2016,3,23,23,17957,18191,14944,-3247
2016,3,24,0,18222,18573,15566,-3007
2016,3,24,1,18299,18408,15506,-2902
2016,3,24,2,17640,17644,15092,-2552
2016,3,24,3,16497,16480,14215,-2265
2016,3,24,4,15188,15203,13160,-2043
2016,3,24,5,13797,14260,12786,-1474
2016,3,24,6,13120,13715,12293,-1422
2016,3,24,7,12766,13402,11952,-1450
2016,3,24,8,12678,13324,11943,-1381
2016,3,24,9,12872,13523,12041,-1482
2016,3,24,10,13814,14420,12732,-1688
2016,3,24,11,15742,16158,14143,-2015
2016,3,24,12,17191,17358,15630,-1728
2016,3,24,13,17802,17929,15877,-2052
2016,3,24,14,18136,18254,15862,-2392
2016,3,24,15,18307,18365,16063,-2302
2016,3,24,16,18284,18296,15962,-2334
2016,3,24,17,18181,18090,15767,-2323
2016,3,24,18,18108,17913,15738,-2175
2016,3,24,19,17935,17658,15662,-1996
2016,3,24,20,17867,17473,15557,-1916
2016,3,24,21,17898,17509,15709,-1800
2016,3,24,22,17920,17679,15907,-1772
2016,3,24,23,17825,17842,16159,-1683
2016,3,25,0,18315,18263,16641,-1622
2016,3,25,1,18354,18148,16307,-1841
2016,3,25,2,17512,17420,15282,-2138
2016,3,25,3,16119,16330,14293,-2037
2016,3,25,4,14687,15087,13641,-1446
2016,3,25,5,13699,14068,12780,-1288
2016,3,25,6,13029,13428,12177,-1251
2016,3,25,7,12640,13048,11910,-1138
2016,3,25,8,12469,12895,12128,-767
2016,3,25,9,12544,13020,11882,-1138
2016,3,25,10,13132,13628,12423,-1205
2016,3,25,11,14354,14860,13617,-1243
2016,3,25,12,15442,15935,14683,-1252
2016,3,25,13,16346,16799,14811,-1988
2016,3,25,14,16974,17403,15226,-2177
2016,3,25,15,17288,17773,15494,-2279
2016,3,25,16,17381,17853,15676,-2177
2016,3,25,17,17302,17783,15769,-2014
2016,3,25,18,17206,17653,15678,-1975
2016,3,25,19,17035,17539,15454,-2085
2016,3,25,20,16936,17397,15173,-2224
2016,3,25,21,16946,17402,15295,-2107
2016,3,25,22,16966,17448,15373,-2075
2016,3,25,23,16868,17366,15631,-1735
2016,3,26,0,17247,17659,15583,-2076
2016,3,26,1,17295,17538,14956,-2582
2016,3,26,2,16817,16891,14358,-2533
2016,3,26,3,15892,16008,13536,-2472
2016,3,26,4,14798,15007,13027,-1980
2016,3,26,5,13652,14151,12360,-1791
2016,3,26,6,13062,13573,11765,-1808
2016,3,26,7,12683,13254,11732,-1522
2016,3,26,8,12546,13117,11646,-1471
2016,3,26,9,12589,13151,11588,-1563
2016,3,26,10,13016,13469,11686,-1783
2016,3,26,11,13823,14110,11966,-2144
2016,3,26,12,14516,14770,12537,-2233
2016,3,26,13,15320,15582,13317,-2265
2016,3,26,14,15872,16108,13753,-2355
2016,3,26,15,16112,16283,13935,-2348
2016,3,26,16,16105,16175,13877,-2298
2016,3,26,17,15963,15946,13677,-2269
2016,3,26,18,15727,15638,13403,-2235
2016,3,26,19,15548,15373,12988,-2385
2016,3,26,20,15481,15219,13007,-2212
2016,3,26,21,15574,15323,13088,-2235
2016,3,26,22,15776,15572,13355,-2217
2016,3,26,23,16024,15820,13516,-2304
2016,3,27,0,16664,16545,14198,-2347
2016,3,27,1,16943,16901,14589,-2312
2016,3,27,2,16481,16516,14182,-2334
2016,3,27,3,15597,15810,13752,-2058
2016,3,27,4,14560,14856,13017,-1839
2016,3,27,5,13624,14016,12742,-1274
2016,3,27,6,12988,13403,12193,-1210
2016,3,27,7,12623,13033,11731,-1302
2016,3,27,8,12473,12839,11749,-1090
2016,3,27,9,12479,12833,11699,-1134
2016,3,27,10,12751,13054,11723,-1331
2016,3,27,11,13283,13509,12036,-1473
2016,3,27,12,13747,13994,12719,-1275
2016,3,27,13,14411,14766,13142,-1624
2016,3,27,14,14943,15212,13281,-1931
2016,3,27,15,15260,15350,13566,-1784
2016,3,27,16,15314,15251,13538,-1713
2016,3,27,17,15306,15071,13251,-1820
2016,3,27,18,15168,14795,12974,-1821
2016,3,27,19,15025,14512,12661,-1851
2016,3,27,20,14970,14359,12327,-2032
2016,3,27,21,15132,14335,12109,-2226
2016,3,27,22,15388,14488,12543,-1945
2016,3,27,23,15682,14802,12916,-1886
2016,3,28,0,16421,15732,13604,-2128
2016,3,28,1,16837,16195,14161,-2034
2016,3,28,2,16245,15808,13958,-1850
2016,3,28,3,15261,15002,13235,-1767
2016,3,28,4,14133,14003,12402,-1601
2016,3,28,5,13294,13221,12237,-984
2016,3,28,6,12767,12766,11800,-966
2016,3,28,7,12460,12526,11686,-840
2016,3,28,8,12374,12471,11700,-771
2016,3,28,9,12560,12733,12071,-662
2016,3,28,10,13449,13676,12264,-1412
2016,3,28,11,15231,15372,13273,-2099
2016,3,28,12,16640,16819,14790,-2029
2016,3,28,13,17310,17689,15738,-1951
2016,3,28,14,17720,18246,16133,-2113
2016,3,28,15,17938,18635,16377,-2258
2016,3,28,16,17964,18702,16589,-2113
2016,3,28,17,17837,18522,16249,-2273
2016,3,28,18,17726,18390,16161,-2229
2016,3,28,19,17538,18220,15622,-2598
2016,3,28,20,17420,17997,15109,-2888
2016,3,28,21,17453,17983,14853,-3130
2016,3,28,22,17524,18194,15235,-2959
2016,3,28,23,17519,18260,15802,-2458
2016,3,29,0,17998,18690,15833,-2857
2016,3,29,1,18049,18560,15738,-2822
2016,3,29,2,17313,17735,15065,-2670
2016,3,29,3,16066,16485,13895,-2590
2016,3,29,4,14682,15216,13351,-1865
2016,3,29,5,13552,14268,12590,-1678
2016,3,29,6,12968,13746,12345,-1401
2016,3,29,7,12655,13455,12044,-1411
2016,3,29,8,12571,13387,12349,-1038
2016,3,29,9,12820,13619,12407,-1212
2016,3,29,10,13774,14567,13223,-1344
2016,3,29,11,15652,16331,14385,-1946
2016,3,29,12,17071,17443,15540,-1903
2016,3,29,13,17720,17961,15487,-2474
2016,3,29,14,18064,18176,15859,-2317
2016,3,29,15,18247,18186,15720,-2466
2016,3,29,16,18282,18058,15493,-2565
2016,3,29,17,18174,17867,15301,-2566
2016,3,29,18,18108,17754,15190,-2564
2016,3,29,19,17998,17586,15079,-2507
2016,3,29,20,17916,17456,14909,-2547
2016,3,29,21,17996,17539,15052,-2487
2016,3,29,22,18121,17700,15302,-2398
2016,3,29,23,18157,17784,15549,-2235
2016,3,30,0,18613,18445,16175,-2270
2016,3,30,1,18764,18709,16386,-2323
2016,3,30,2,18049,17920,15493,-2427
2016,3,30,3,16720,16698,14215,-2483
2016,3,30,4,15295,15417,12734,-2683
2016,3,30,5,14075,14496,12337,-2159
2016,3,30,6,13481,14019,12116,-1903
2016,3,30,7,13137,13751,11946,-1805
2016,3,30,8,13049,13661,12084,-1577
2016,3,30,9,13281,13925,12037,-1888
2016,3,30,10,14203,14911,12756,-2155
2016,3,30,11,16051,16613,13849,-2764
2016,3,30,12,17418,17695,14934,-2761
2016,3,30,13,17956,17968,15224,-2744
2016,3,30,14,18139,18016,15318,-2698
2016,3,30,15,18191,17917,15069,-2848
2016,3,30,16,18087,17728,14739,-2989
2016,3,30,17,17910,17498,14581,-2917
2016,3,30,18,17812,17367,14531,-2836
2016,3,30,19,17688,17205,14635,-2570
2016,3,30,20,17599,17117,14685,-2432
2016,3,30,21,17631,17231,14968,-2263
2016,3,30,22,17722,17399,15020,-2379
2016,3,30,23,17696,17453,15006,-2447
2016,3,31,0,18128,18087,15647,-2440
2016,3,31,1,18267,18294,15732,-2562
2016,3,31,2,17531,17528,14869,-2659
2016,3,31,3,16154,16238,13659,-2579
2016,3,31,4,14706,14978,12770,-2208
2016,3,31,5,13693,13988,12777,-1211
2016,3,31,6,13113,13418,12058,-1360
2016,3,31,7,12725,13058,12106,-952
2016,3,31,8,12591,12925,11686,-1239
2016,3,31,9,12754,13102,12125,-977
2016,3,31,10,13617,14041,12879,-1162
2016,3,31,11,15351,15803,13913,-1890
2016,3,31,12,16732,16925,14933,-1992
2016,3,31,13,17371,17415,15143,-2272
2016,3,31,14,17701,17708,14992,-2716
2016,3,31,15,17888,17913,15367,-2546
2016,3,31,16,17881,17910,15979,-1931
2016,3,31,17,17801,17800,15290,-2510
2016,3,31,18,17771,17724,15363,-2361
2016,3,31,19,17643,17622,15361,-2261
2016,3,31,20,17628,17555,15426,-2129
2016,3,31,21,17703,17674,15787,-1887
2016,3,31,22,17782,17736,15913,-1823
2016,3,31,23,17714,17621,15503,-2118
2016,4,1,0,18018,18048,15830,-2218
2016,4,1,1,18031,18091,15927,-2164
2016,4,1,2,17349,17281,15192,-2089
2016,4,1,3,16096,15994,13692,-2302
2016,4,1,4,14711,14745,12998,-1747
2016,4,1,5,13291,13726,12663,-1063
2016,4,1,6,12643,13130,12516,-614
2016,4,1,7,12248,12812,12738,-74
2016,4,1,8,12095,12677,12549,-128
2016,4,1,9,12250,12837,12582,-255
2016,4,1,10,13087,13641,12674,-967
2016,4,1,11,14884,15345,13492,-1853
2016,4,1,12,16279,16720,14420,-2300
2016,4,1,13,17098,17513,14737,-2776
2016,4,1,14,17607,17953,15263,-2690
2016,4,1,15,17924,18209,15535,-2674
2016,4,1,16,18057,18287,15744,-2543
2016,4,1,17,18065,18177,15799,-2378
2016,4,1,18,18057,18082,15666,-2416
2016,4,1,19,17957,17957,15676,-2281
2016,4,1,20,17849,17834,15379,-2455
2016,4,1,21,17790,17876,15358,-2518
2016,4,1,22,17638,17855,15113,-2742
2016,4,1,23,17376,17698,15046,-2652
2016,4,2,0,17634,17930,15163,-2767
2016,4,2,1,17863,17807,15042,-2765
2016,4,2,2,17041,17185,15067,-2118
2016,4,2,3,15874,16183,13987,-2196
2016,4,2,4,14608,14908,13096,-1812
2016,4,2,5,13089,13856,11879,-1977
2016,4,2,6,12497,13196,11763,-1433
2016,4,2,7,12121,12799,11622,-1177
2016,4,2,8,11944,12587,11448,-1139
2016,4,2,9,11946,12604,11459,-1145
2016,4,2,10,12268,12884,11599,-1285
2016,4,2,11,12915,13516,12052,-1464
2016,4,2,12,13570,14303,12649,-1654
2016,4,2,13,14441,15376,13375,-2001
2016,4,2,14,15119,16155,14171,-1984
2016,4,2,15,15517,16654,14818,-1836
2016,4,2,16,15680,16762,14901,-1861
2016,4,2,17,15681,16548,14339,-2209
2016,4,2,18,15533,16298,13913,-2385
2016,4,2,19,15419,15997,13876,-2121
2016,4,2,20,15342,15912,14080,-1832
2016,4,2,21,15360,15896,13904,-1992
2016,4,2,22,15464,16125,14202,-1923
2016,4,2,23,15616,16359,14487,-1872
2016,4,3,0,16110,16901,15108,-1793
2016,4,3,1,16503,17072,15010,-2062
2016,4,3,2,15943,16612,14183,-2429
2016,4,3,3,15150,15882,13338,-2544
2016,4,3,4,14213,15009,12593,-2416
2016,4,3,5,13206,14179,12150,-2029
2016,4,3,6,12696,13596,11892,-1704
2016,4,3,7,12385,13253,11873,-1380
2016,4,3,8,12250,13089,11764,-1325
2016,4,3,9,12255,13133,12162,-971
2016,4,3,10,12481,13436,12334,-1102
2016,4,3,11,12925,13968,12652,-1316
2016,4,3,12,13379,14546,13288,-1258
2016,4,3,13,14132,15396,13585,-1811
2016,4,3,14,14792,16091,14453,-1638
2016,4,3,15,15200,16542,14634,-1908
2016,4,3,16,15372,16813,15141,-1672
2016,4,3,17,15438,16937,15061,-1876
2016,4,3,18,15335,16853,15109,-1744
2016,4,3,19,15243,16680,15314,-1366
2016,4,3,20,15182,16649,15452,-1197
2016,4,3,21,15285,16832,15611,-1221
2016,4,3,22,15535,17204,15638,-1566
2016,4,3,23,15820,17502,15890,-1612
2016,4,4,0,16436,18156,16328,-1828
2016,4,4,1,16993,18421,16315,-2106
2016,4,4,2,16420,17740,15499,-2241
2016,4,4,3,15529,16671,14386,-2285
2016,4,4,4,14534,15506,13147,-2359
2016,4,4,5,13950,14698,12400,-2298
2016,4,4,6,13462,14227,12214,-2013
2016,4,4,7,13239,13981,11593,-2388
2016,4,4,8,13180,13893,11197,-2696
2016,4,4,9,13399,14188,11357,-2831
2016,4,4,10,14257,15148,12588,-2560
2016,4,4,11,15899,16940,14660,-2280
2016,4,4,12,17209,18319,15967,-2352
2016,4,4,13,17910,19053,16209,-2844
2016,4,4,14,18320,19502,16702,-2800
2016,4,4,15,18531,19757,16788,-2969
2016,4,4,16,18561,19840,16931,-2909
2016,4,4,17,18486,19790,16804,-2986
2016,4,4,18,18420,19767,16731,-3036
2016,4,4,19,18286,19628,16576,-3052
2016,4,4,20,18182,19561,16752,-2809
2016,4,4,21,18227,19667,16694,-2973
2016,4,4,22,18433,19881,16928,-2953
2016,4,4,23,18478,19964,17014,-2950
2016,4,5,0,18881,20173,17283,-2890
2016,4,5,1,19191,20084,17235,-2849
2016,4,5,2,18392,19178,16585,-2593
2016,4,5,3,17190,17892,15342,-2550
2016,4,5,4,15886,16609,14708,-1901
2016,4,5,5,14648,15686,13892,-1794
2016,4,5,6,14145,15175,13536,-1639
2016,4,5,7,13877,14908,13101,-1807
2016,4,5,8,13818,14844,12962,-1882
2016,4,5,9,14056,15162,13567,-1595
2016,4,5,10,14960,16180,14325,-1855
2016,4,5,11,16581,17938,16076,-1862
2016,4,5,12,17848,19046,17383,-1663
2016,4,5,13,18508,19384,17700,-1684
2016,4,5,14,18848,19519,17603,-1916
2016,4,5,15,18979,19491,17494,-1997
2016,4,5,16,18987,19356,17141,-2215
2016,4,5,17,18872,19122,16589,-2533
2016,4,5,18,18781,18948,16611,-2337
2016,4,5,19,18649,18687,16174,-2513
2016,4,5,20,18552,18509,16029,-2480
2016,4,5,21,18577,18552,16014,-2538
2016,4,5,22,18689,18695,16317,-2378
2016,4,5,23,18740,18747,16367,-2380
2016,4,6,0,19135,19306,16806,-2500
2016,4,6,1,19569,19725,17221,-2504
2016,4,6,2,18773,18981,16457,-2524
2016,4,6,3,17485,17725,15377,-2348
2016,4,6,4,16133,16444,14573,-1871
2016,4,6,5,15121,15535,13511,-2024
2016,4,6,6,14583,15036,13287,-1749
2016,4,6,7,14254,14770,12965,-1805
2016,4,6,8,14152,14686,12743,-1943
2016,4,6,9,14352,14962,12761,-2201
2016,4,6,10,15197,15940,13404,-2536
2016,4,6,11,16854,17669,15498,-2171
2016,4,6,12,18131,18751,16460,-2291
2016,4,6,13,18783,19092,16572,-2520
2016,4,6,14,19100,19169,16692,-2477
2016,4,6,15,19212,19121,16786,-2335
2016,4,6,16,19198,19098,16880,-2218
2016,4,6,17,19097,18887,16264,-2623
2016,4,6,18,19014,18751,16329,-2422
2016,4,6,19,18868,18649,15903,-2746
2016,4,6,20,18777,18701,16057,-2644
2016,4,6,21,18802,18933,16100,-2833
2016,4,6,22,18845,19015,16351,-2664
2016,4,6,23,18765,18942,16619,-2323
2016,4,7,0,19049,19367,17261,-2106
2016,4,7,1,19318,19394,17354,-2040
2016,4,7,2,18440,18501,16772,-1729
2016,4,7,3,17126,17079,15602,-1477
2016,4,7,4,15690,15661,14211,-1450
2016,4,7,5,14224,14628,13490,-1138
2016,4,7,6,13593,14040,13077,-963
2016,4,7,7,13216,13694,12864,-830
2016,4,7,8,13068,13565,12621,-944
2016,4,7,9,13212,13749,12754,-995
2016,4,7,10,14013,14670,13325,-1345
2016,4,7,11,15649,16398,14965,-1433
2016,4,7,12,16988,17552,15959,-1593
2016,4,7,13,17710,18097,16424,-1673
2016,4,7,14,18147,18356,16351,-2005
2016,4,7,15,18410,18581,16404,-2177
2016,4,7,16,18507,18555,16249,-2306
2016,4,7,17,18486,18498,16225,-2273
2016,4,7,18,18471,18560,16555,-2005
2016,4,7,19,18358,18486,16290,-2196
2016,4,7,20,18275,18333,16342,-1991
2016,4,7,21,18299,18231,16530,-1701
2016,4,7,22,18353,18232,16474,-1758
2016,4,7,23,18248,18147,16579,-1568
2016,4,8,0,18469,18404,16681,-1723
2016,4,8,1,18721,18460,16703,-1757
2016,4,8,2,17916,17747,16430,-1317
2016,4,8,3,16676,16527,15178,-1349
2016,4,8,4,15308,15224,13782,-1442
2016,4,8,5,13856,14277,12862,-1415
2016,4,8,6,13242,13755,12231,-1524
2016,4,8,7,12913,13428,12197,-1231
2016,4,8,8,12809,13343,11917,-1426
2016,4,8,9,13004,13603,12258,-1345
2016,4,8,10,13871,14574,13144,-1430
2016,4,8,11,15576,16330,14789,-1541
2016,4,8,12,16971,17573,16202,-1371
2016,4,8,13,17760,18126,16620,-1506
2016,4,8,14,18222,18427,16897,-1530
2016,4,8,15,18505,18629,17137,-1492
2016,4,8,16,18556,18666,17078,-1588
2016,4,8,17,18510,18542,16890,-1652
2016,4,8,18,18448,18510,16599,-1911
2016,4,8,19,18333,18356,16571,-1785
2016,4,8,20,18233,18241,16503,-1738
2016,4,8,21,18204,18241,16310,-1931
2016,4,8,22,18173,18171,16194,-1977
2016,4,8,23,17995,18061,16328,-1733
2016,4,9,0,18208,18344,16344,-2000
2016,4,9,1,18527,18487,16403,-2084
2016,4,9,2,17830,17851,15991,-1860
2016,4,9,3,16717,16867,14840,-2027
2016,4,9,4,15447,15740,13871,-1869
2016,4,9,5,14473,14790,13062,-1728
2016,4,9,6,13888,14220,12527,-1693
2016,4,9,7,13547,13906,12230,-1676
2016,4,9,8,13374,13765,12186,-1579
2016,4,9,9,13391,13817,12202,-1615
2016,4,9,10,13704,14192,12874,-1318
2016,4,9,11,14256,14785,13481,-1304
2016,4,9,12,14928,15482,14196,-1286
2016,4,9,13,15822,16263,14734,-1529
2016,4,9,14,16480,16869,15043,-1826
2016,4,9,15,16819,17152,14874,-2278
2016,4,9,16,16869,17247,15035,-2212
2016,4,9,17,16741,17210,15296,-1914
2016,4,9,18,16500,17064,15362,-1702
2016,4,9,19,16289,16892,15087,-1805
2016,4,9,20,16129,16822,15104,-1718
2016,4,9,21,16159,16924,15577,-1347
2016,4,9,22,16357,17096,15739,-1357
2016,4,9,23,16590,17231,15955,-1276
2016,4,10,0,17020,17579,15769,-1810
2016,4,10,1,17509,17903,16220,-1683
2016,4,10,2,17085,17442,15770,-1672
2016,4,10,3,16331,16643,14810,-1833
2016,4,10,4,15431,15730,14084,-1646
2016,4,10,5,14489,14926,13222,-1704
2016,4,10,6,13925,14396,12651,-1745
2016,4,10,7,13645,14092,12480,-1612
2016,4,10,8,13513,13941,12490,-1451
2016,4,10,9,13508,13979,12465,-1514
2016,4,10,10,13750,14219,12865,-1354
2016,4,10,11,14092,14586,13228,-1358
2016,4,10,12,14533,15048,13485,-1563
2016,4,10,13,15270,15633,13957,-1676
2016,4,10,14,15861,16081,14321,-1760
2016,4,10,15,16213,16307,14572,-1735
2016,4,10,16,16353,16367,14469,-1898
2016,4,10,17,16321,16270,14286,-1984
2016,4,10,18,16192,16090,13909,-2181
2016,4,10,19,16048,15932,13825,-2107
2016,4,10,20,15945,15875,13870,-2005
2016,4,10,21,16055,16077,14203,-1874
2016,4,10,22,16290,16438,14652,-1786
2016,4,10,23,16544,16785,15224,-1561
2016,4,11,0,17055,17475,15647,-1828
2016,4,11,1,17662,17831,15889,-1942
2016,4,11,2,17159,17173,15287,-1886
2016,4,11,3,16161,16174,14106,-2068
2016,4,11,4,15061,15027,12903,-2124
2016,4,11,5,13943,14187,12146,-2041
2016,4,11,6,13403,13741,12024,-1717
2016,4,11,7,13142,13470,11729,-1741
2016,4,11,8,13042,13397,11698,-1699
2016,4,11,9,13239,13634,12010,-1624
2016,4,11,10,14111,14599,12978,-1621
2016,4,11,11,15736,16396,14646,-1750
2016,4,11,12,17141,17735,15841,-1894
2016,4,11,13,17922,18321,16112,-2209
2016,4,11,14,18393,18684,16337,-2347
2016,4,11,15,18671,18907,16515,-2392
2016,4,11,16,18761,18782,16623,-2159
2016,4,11,17,18718,18595,16238,-2357
2016,4,11,18,18668,18386,15791,-2595
2016,4,11,19,18548,18166,15324,-2842
2016,4,11,20,18432,18113,15440,-2673
2016,4,11,21,18441,18226,15463,-2763
2016,4,11,22,18526,18436,15480,-2956
2016,4,11,23,18420,18451,15722,-2729
2016,4,12,0,18594,18695,16125,-2570
2016,4,12,1,18828,18566,15840,-2726
2016,4,12,2,17994,17613,15207,-2406
2016,4,12,3,16686,16305,14022,-2283
2016,4,12,4,15249,14990,12719,-2271
2016,4,12,5,13659,14052,11939,-2113
2016,4,12,6,13045,13513,11404,-2109
2016,4,12,7,12698,13199,11054,-2145
2016,4,12,8,12558,13102,11091,-2011
2016,4,12,9,12739,13335,11203,-2132
2016,4,12,10,13578,14264,11996,-2268
2016,4,12,11,15225,16061,13756,-2305
2016,4,12,12,16643,17365,15142,-2223
2016,4,12,13,17421,18031,15770,-2261
2016,4,12,14,17911,18382,15765,-2617
2016,4,12,15,18198,18613,15440,-3173
2016,4,12,16,18331,18637,15494,-3143
2016,4,12,17,18320,18500,15673,-2827
2016,4,12,18,18296,18369,15749,-2620
2016,4,12,19,18184,18101,15628,-2473
2016,4,12,20,18077,17871,15239,-2632
2016,4,12,21,18088,17876,15155,-2721
2016,4,12,22,18169,17938,14983,-2955
2016,4,12,23,18082,17924,14732,-3192
2016,4,13,0,18282,18179,14775,-3404
2016,4,13,1,18664,18566,15219,-3347
2016,4,13,2,17873,17839,15064,-2775
2016,4,13,3,16506,16593,13839,-2754
2016,4,13,4,15077,15266,12472,-2794
2016,4,13,5,13766,14311,11759,-2552
2016,4,13,6,13222,13830,11355,-2475
2016,4,13,7,12877,13551,11080,-2471
2016,4,13,8,12764,13527,11139,-2388
2016,4,13,9,12984,13790,11216,-2574
2016,4,13,10,13875,14766,12326,-2440
2016,4,13,11,15545,16439,13752,-2687
2016,4,13,12,16927,17498,14770,-2728
2016,4,13,13,17592,17812,14752,-3060
2016,4,13,14,17886,17862,14425,-3437
2016,4,13,15,18021,17821,14332,-3489
2016,4,13,16,18006,17658,14343,-3315
2016,4,13,17,17873,17463,13824,-3639
2016,4,13,18,17821,17350,13658,-3692
2016,4,13,19,17708,17221,13617,-3604
2016,4,13,20,17612,17207,13554,-3653
2016,4,13,21,17670,17317,13690,-3627
2016,4,13,22,17754,17414,14147,-3267
2016,4,13,23,17693,17466,14165,-3301
2016,4,14,0,17977,17890,14505,-3385
2016,4,14,1,18442,18270,15177,-3093
2016,4,14,2,17707,17597,14591,-3006
2016,4,14,3,16365,16393,13555,-2838
2016,4,14,4,14936,15093,12474,-2619
2016,4,14,5,13832,14162,11678,-2484
2016,4,14,6,13258,13671,11452,-2219
2016,4,14,7,12971,13402,11304,-2098
2016,4,14,8,12869,13349,11219,-2130
2016,4,14,9,13096,13609,11853,-1756
2016,4,14,10,13986,14597,12658,-1939
2016,4,14,11,15580,16254,13881,-2373
2016,4,14,12,16897,17348,14477,-2871
2016,4,14,13,17552,17661,14658,-3003
2016,4,14,14,17814,17743,14618,-3125
2016,4,14,15,17905,17696,14704,-2992
2016,4,14,16,17859,17552,14522,-3030
2016,4,14,17,17709,17339,14502,-2837
2016,4,14,18,17623,17211,14241,-2970
2016,4,14,19,17473,17039,13821,-3218
2016,4,14,20,17363,16956,13947,-3009
2016,4,14,21,17383,17003,14325,-2678
2016,4,14,22,17457,17093,14511,-2582
2016,4,14,23,17408,17061,14570,-2491
2016,4,15,0,17676,17408,14831,-2577
2016,4,15,1,18177,17954,15529,-2425
2016,4,15,2,17542,17295,14857,-2438
2016,4,15,3,16311,16145,13443,-2702
2016,4,15,4,14973,14836,12674,-2162
2016,4,15,5,13667,13914,11602,-2312
2016,4,15,6,13072,13429,10847,-2582
2016,4,15,7,12735,13172,11035,-2137
2016,4,15,8,12628,13103,11025,-2078
2016,4,15,9,12836,13383,11689,-1694
2016,4,15,10,13682,14350,12506,-1844
2016,4,15,11,15240,15977,13843,-2134
2016,4,15,12,16575,17058,14770,-2288
2016,4,15,13,17263,17404,14474,-2930
2016,4,15,14,17533,17476,14440,-3036
2016,4,15,15,17643,17443,14482,-2961
2016,4,15,16,17584,17300,14562,-2738
2016,4,15,17,17422,17106,14521,-2585
2016,4,15,18,17328,17000,14535,-2465
2016,4,15,19,17169,16838,13950,-2888
2016,4,15,20,17038,16692,13894,-2798
2016,4,15,21,17003,16672,14460,-2212
2016,4,15,22,16939,16688,14650,-2038
2016,4,15,23,16752,16543,14524,-2019
2016,4,16,0,16890,16725,14615,-2110
2016,4,16,1,17340,17200,15135,-2065
2016,4,16,2,16779,16660,14568,-2092
2016,4,16,3,15726,15734,13181,-2553
2016,4,16,4,14523,14590,12197,-2393
2016,4,16,5,13597,13671,10777,-2894
2016,4,16,6,12965,13115,10094,-3021
2016,4,16,7,12566,12802,9935,-2867
2016,4,16,8,12377,12666,9764,-2902
2016,4,16,9,12420,12718,9811,-2907
2016,4,16,10,12792,13075,10020,-3055
2016,4,16,11,13339,13562,10886,-2676
2016,4,16,12,14080,14344,11954,-2390
2016,4,16,13,15016,15059,12509,-2550
2016,4,16,14,15621,15425,12707,-2718
2016,4,16,15,15912,15535,12640,-2895
2016,4,16,16,15943,15458,12547,-2911
2016,4,16,17,15833,15312,12450,-2862
2016,4,16,18,15640,15071,12467,-2604
2016,4,16,19,15471,14887,12293,-2594
2016,4,16,20,15360,14870,11973,-2897
2016,4,16,21,15398,14980,12079,-2901
2016,4,16,22,15540,15169,12349,-2820
2016,4,16,23,15622,15375,12108,-3267
2016,4,17,0,15944,15655,12523,-3132
2016,4,17,1,16566,16224,13255,-2969
2016,4,17,2,16161,15865,12832,-3033
2016,4,17,3,15306,15120,11833,-3287
2016,4,17,4,14270,14151,11031,-3120
2016,4,17,5,13071,13338,10522,-2816
2016,4,17,6,12486,12825,9898,-2927
2016,4,17,7,12121,12504,9959,-2545
2016,4,17,8,11955,12366,9640,-2726
2016,4,17,9,11950,12390,9814,-2576
2016,4,17,10,12172,12622,10313,-2309
2016,4,17,11,12447,12904,10312,-2592
2016,4,17,12,12923,13514,11289,-2225
2016,4,17,13,13691,14203,11627,-2576
2016,4,17,14,14254,14635,11790,-2845
2016,4,17,15,14603,14896,11540,-3356
2016,4,17,16,14750,14976,11053,-3923
2016,4,17,17,14764,14982,11336,-3646
2016,4,17,18,14712,14890,11479,-3411
2016,4,17,19,14611,14834,11613,-3221
2016,4,17,20,14562,14905,11509,-3396
2016,4,17,21,14667,15115,11945,-3170
2016,4,17,22,14872,15394,12620,-2774
2016,4,17,23,15025,15552,12753,-2799
2016,4,18,0,15441,15876,12887,-2989
2016,4,18,1,16149,16535,13846,-2689
2016,4,18,2,15745,15956,13002,-2954
2016,4,18,3,14791,14864,11748,-3116
2016,4,18,4,13717,13735,10752,-2983
2016,4,18,5,12544,12968,10116,-2852
2016,4,18,6,12061,12501,9464,-3037
2016,4,18,7,11810,12261,9180,-3081
2016,4,18,8,11757,12221,9243,-2978
2016,4,18,9,12007,12491,9407,-3084
2016,4,18,10,12924,13476,10213,-3263
2016,4,18,11,14520,15061,11922,-3139
2016,4,18,12,15937,16308,12787,-3521
2016,4,18,13,16764,16913,13256,-3657
2016,4,18,14,17213,17270,13682,-3588
2016,4,18,15,17527,17500,13441,-4059
2016,4,18,16,17685,17614,13862,-3752
2016,4,18,17,17785,17665,14016,-3649
2016,4,18,18,17876,17750,14164,-3586
2016,4,18,19,17873,17765,14206,-3559
2016,4,18,20,17795,17833,14416,-3417
2016,4,18,21,17768,17941,14384,-3557
2016,4,18,22,17720,17956,14164,-3792
2016,4,18,23,17505,17669,14070,-3599
2016,4,19,0,17619,17791,14162,-3629
2016,4,19,1,17993,18065,14358,-3707
2016,4,19,2,17250,17171,13516,-3655
2016,4,19,3,15893,15778,12280,-3498
2016,4,19,4,14439,14405,11452,-2953
2016,4,19,5,12936,13402,11084,-2318
2016,4,19,6,12375,12804,10769,-2035
2016,4,19,7,12031,12478,10403,-2075
2016,4,19,8,11878,12348,10240,-2108
2016,4,19,9,12087,12572,10272,-2300
2016,4,19,10,12967,13476,11056,-2420
2016,4,19,11,14594,15171,12303,-2868
2016,4,19,12,16080,16515,13969,-2546
2016,4,19,13,16855,17179,14457,-2722
2016,4,19,14,17293,17456,14530,-2926
2016,4,19,15,17583,17643,14670,-2973
2016,4,19,16,17664,17655,14686,-2969
2016,4,19,17,17679,17584,14515,-3069
2016,4,19,18,17660,17583,14532,-3051
2016,4,19,19,17626,17538,14606,-2932
2016,4,19,20,17530,17526,14678,-2848
2016,4,19,21,17537,17601,14515,-3086
2016,4,19,22,17518,17611,14532,-3079
2016,4,19,23,17327,17415,14313,-3102
2016,4,20,0,17412,17474,14498,-2976
2016,4,20,1,17884,17874,14629,-3245
2016,4,20,2,17168,17118,13887,-3231
2016,4,20,3,15797,15856,12938,-2918
2016,4,20,4,14344,14531,12062,-2469
2016,4,20,5,13101,13549,11041,-2508
2016,4,20,6,12493,13026,10915,-2111
2016,4,20,7,12133,12719,10586,-2133
2016,4,20,8,12014,12613,10371,-2242
2016,4,20,9,12237,12851,10588,-2263
2016,4,20,10,13153,13756,11147,-2609
2016,4,20,11,14803,15311,12226,-3085
2016,4,20,12,16275,16482,13663,-2819
2016,4,20,13,17015,16998,14067,-2931
2016,4,20,14,17309,17195,14059,-3136
2016,4,20,15,17461,17285,14111,-3174
2016,4,20,16,17451,17261,14041,-3220
2016,4,20,17,17334,17168,14073,-3095
2016,4,20,18,17301,17163,14078,-3085
2016,4,20,19,17182,17116,14088,-3028
2016,4,20,20,17098,17147,14221,-2926
2016,4,20,21,17144,17263,14437,-2826
2016,4,20,22,17202,17261,14634,-2627
2016,4,20,23,17061,17111,14449,-2662
2016,4,21,0,17186,17269,14236,-3033
2016,4,21,1,17758,17797,14684,-3113
2016,4,21,2,17108,17074,13711,-3363
2016,4,21,3,15751,15755,12500,-3255
2016,4,21,4,14298,14427,11236,-3191
2016,4,21,5,13125,13474,10548,-2926
2016,4,21,6,12550,12948,10179,-2769
2016,4,21,7,12212,12671,9813,-2858
2016,4,21,8,12110,12586,10060,-2526
2016,4,21,9,12313,12847,10417,-2430
2016,4,21,10,13177,13757,10915,-2842
2016,4,21,11,14726,15291,12267,-3024
2016,4,21,12,16128,16490,13533,-2957
2016,4,21,13,16856,16996,13881,-3115
2016,4,21,14,17191,17283,13928,-3355
2016,4,21,15,17376,17479,13988,-3491
2016,4,21,16,17442,17528,14073,-3455
2016,4,21,17,17442,17498,13819,-3679
2016,4,21,18,17465,17558,13697,-3861
2016,4,21,19,17435,17580,13841,-3739
2016,4,21,20,17353,17562,14035,-3527
2016,4,21,21,17409,17660,14257,-3403
2016,4,21,22,17419,17720,14415,-3305
2016,4,21,23,17229,17545,14361,-3184
2016,4,22,0,17299,17687,14431,-3256
2016,4,22,1,17735,17949,14798,-3151
2016,4,22,2,17117,17161,13977,-3184
2016,4,22,3,15790,15887,12587,-3300
2016,4,22,4,14387,14550,11583,-2967
2016,4,22,5,13318,13577,10646,-2931
2016,4,22,6,12701,12978,10133,-2845
2016,4,22,7,12312,12616,10087,-2529
2016,4,22,8,12162,12444,9975,-2469
2016,4,22,9,12320,12606,10128,-2478
2016,4,22,10,13109,13449,10627,-2822
2016,4,22,11,14647,14916,11730,-3186
2016,4,22,12,16162,16291,13366,-2925
2016,4,22,13,17112,17148,13953,-3195
2016,4,22,14,17697,17756,14456,-3300
2016,4,22,15,18104,18118,14780,-3338
2016,4,22,16,18323,18295,15131,-3164
2016,4,22,17,18404,18407,14994,-3413
2016,4,22,18,18489,18597,14995,-3602
2016,4,22,19,18467,18601,14838,-3763
2016,4,22,20,18430,18490,14735,-3755
2016,4,22,21,18366,18473,14744,-3729
2016,4,22,22,18195,18312,14666,-3646
2016,4,22,23,17783,17902,14156,-3746
2016,4,23,0,17644,17842,14321,-3521
2016,4,23,1,17810,17998,14737,-3261
2016,4,23,2,17213,17306,14028,-3278
2016,4,23,3,16099,16231,12675,-3556
2016,4,23,4,14830,15042,11916,-3126
2016,4,23,5,13560,13961,11116,-2845
2016,4,23,6,12875,13245,10769,-2476
2016,4,23,7,12438,12803,10488,-2315
2016,4,23,8,12214,12576,10426,-2150
2016,4,23,9,12214,12558,10379,-2179
2016,4,23,10,12531,12804,10552,-2252
2016,4,23,11,13030,13285,10936,-2349
2016,4,23,12,13903,14074,11771,-2303
2016,4,23,13,14995,15103,12555,-2548
2016,4,23,14,15794,15827,13133,-2694
2016,4,23,15,16272,16164,13230,-2934
2016,4,23,16,16456,16180,12941,-3239
2016,4,23,17,16458,15995,12832,-3163
2016,4,23,18,16318,15742,12735,-3007
2016,4,23,19,16206,15530,12629,-2901
2016,4,23,20,16125,15456,12710,-2746
2016,4,23,21,16115,15528,12836,-2692
2016,4,23,22,16171,15681,13244,-2437
2016,4,23,23,16136,15641,12957,-2684
2016,4,24,0,16247,15743,13222,-2521
2016,4,24,1,16782,16302,13849,-2453
2016,4,24,2,16435,15948,13373,-2575
2016,4,24,3,15582,15101,12182,-2919
2016,4,24,4,14552,14153,11138,-3015
2016,4,24,5,13268,13325,10576,-2749
2016,4,24,6,12638,12795,10130,-2665
2016,4,24,7,12260,12434,9890,-2544
2016,4,24,8,12069,12244,9840,-2404
2016,4,24,9,12058,12217,9857,-2360
2016,4,24,10,12279,12419,9881,-2538
2016,4,24,11,12522,12619,9952,-2667
2016,4,24,12,13067,13213,10623,-2590
2016,4,24,13,13902,13798,10825,-2973
2016,4,24,14,14502,14311,11505,-2806
2016,4,24,15,14882,14599,11691,-2908
2016,4,24,16,15027,14689,11590,-3099
2016,4,24,17,15025,14668,11871,-2797
2016,4,24,18,14906,14583,11874,-2709
2016,4,24,19,14785,14521,11731,-2790
2016,4,24,20,14712,14586,11944,-2642
2016,4,24,21,14853,14820,12294,-2526
2016,4,24,22,15107,15131,12661,-2470
2016,4,24,23,15288,15309,13207,-2102
2016,4,25,0,15609,15630,13570,-2060
2016,4,25,1,16323,16212,14262,-1950
2016,4,25,2,15915,15678,13536,-2142
2016,4,25,3,14932,14750,12345,-2405
2016,4,25,4,13796,13723,11565,-2158
2016,4,25,5,12849,13016,10684,-2332
2016,4,25,6,12387,12617,9966,-2651
2016,4,25,7,12116,12358,9774,-2584
2016,4,25,8,12036,12275,9584,-2691
2016,4,25,9,12268,12480,9459,-3021
2016,4,25,10,13216,13294,10106,-3188
2016,4,25,11,14809,14629,11403,-3226
2016,4,25,12,16323,15972,12789,-3183
2016,4,25,13,17166,16774,13544,-3230
2016,4,25,14,17609,17252,13970,-3282
2016,4,25,15,17869,17529,14346,-3183
2016,4,25,16,17970,17577,14897,-2680
2016,4,25,17,17958,17550,14829,-2721
2016,4,25,18,17944,17541,14385,-3156
2016,4,25,19,17839,17419,14128,-3291
2016,4,25,20,17766,17327,14119,-3208
2016,4,25,21,17796,17377,14202,-3175
2016,4,25,22,17861,17400,14110,-3290
2016,4,25,23,17702,17254,14357,-2897
2016,4,26,0,17758,17349,14537,-2812
2016,4,26,1,18151,17677,14878,-2799
2016,4,26,2,17470,16957,14109,-2848
2016,4,26,3,16098,15672,12766,-2906
2016,4,26,4,14650,14355,11420,-2935
2016,4,26,5,13300,13478,10660,-2818
2016,4,26,6,12661,12926,10189,-2737
2016,4,26,7,12309,12614,9795,-2819
2016,4,26,8,12164,12533,10018,-2515
2016,4,26,9,12339,12734,9937,-2797
2016,4,26,10,13182,13542,10511,-3031
2016,4,26,11,14778,14983,11821,-3162
2016,4,26,12,16347,16323,12871,-3452
2016,4,26,13,17238,17212,13376,-3836
2016,4,26,14,17767,17774,13557,-4217
2016,4,26,15,18111,18219,13884,-4335
2016,4,26,16,18274,18287,13771,-4516
2016,4,26,17,18285,18145,13881,-4264
2016,4,26,18,18280,18020,13843,-4177
2016,4,26,19,18187,17894,14435,-3459
2016,4,26,20,18094,17796,14493,-3303
2016,4,26,21,18143,17926,14106,-3820
2016,4,26,22,18221,17983,13976,-4007
2016,4,26,23,18067,17830,13623,-4207
2016,4,27,0,17988,17855,13704,-4151
2016,4,27,1,18324,17965,14013,-3952
2016,4,27,2,17651,17287,13699,-3588
2016,4,27,3,16289,16036,12716,-3320
2016,4,27,4,14816,14781,11796,-2985
2016,4,27,5,13395,13848,10571,-3277
2016,4,27,6,12789,13346,10036,-3310
2016,4,27,7,12439,13040,9739,-3301
2016,4,27,8,12305,12916,9730,-3186
2016,4,27,9,12521,13120,9883,-3237
2016,4,27,10,13387,13917,10890,-3027
2016,4,27,11,15004,15192,12323,-2869
2016,4,27,12,16518,16430,13351,-3079
2016,4,27,13,17299,17081,13335,-3746
2016,4,27,14,17649,17324,13625,-3699
2016,4,27,15,17822,17336,13478,-3858
2016,4,27,16,17806,17205,13305,-3900
2016,4,27,17,17706,17024,13472,-3552
2016,4,27,18,17641,16946,13474,-3472
2016,4,27,19,17529,16843,13483,-3360
2016,4,27,20,17434,16804,13074,-3730
2016,4,27,21,17495,16875,13098,-3777
2016,4,27,22,17571,16931,13103,-3828
2016,4,27,23,17417,16829,13321,-3508
2016,4,28,0,17438,16925,13337,-3588
2016,4,28,1,17968,17511,13926,-3585
2016,4,28,2,17369,16983,13418,-3565
2016,4,28,3,16043,15787,12525,-3262
2016,4,28,4,14559,14548,11699,-2849
2016,4,28,5,13420,13610,10855,-2755
2016,4,28,6,12878,13081,10363,-2718
2016,4,28,7,12531,12788,10061,-2727
2016,4,28,8,12387,12705,10077,-2628
2016,4,28,9,12600,12942,10191,-2751
2016,4,28,10,13471,13764,11027,-2737
2016,4,28,11,15048,14992,11864,-3128
2016,4,28,12,16538,16161,13061,-3100
2016,4,28,13,17297,16791,13144,-3647
2016,4,28,14,17648,17073,13454,-3619
2016,4,28,15,17817,17156,13546,-3610
2016,4,28,16,17790,17143,13441,-3702
2016,4,28,17,17724,17091,13486,-3605
2016,4,28,18,17648,17134,13969,-3165
2016,4,28,19,17508,17057,13800,-3257
2016,4,28,20,17441,17019,13947,-3072
2016,4,28,21,17490,17051,14017,-3034
2016,4,28,22,17620,17220,14015,-3205
2016,4,28,23,17540,17281,14272,-3009
2016,4,29,0,17509,17409,14261,-3148
2016,4,29,1,17915,17592,14576,-3016
2016,4,29,2,17314,16918,13885,-3033
2016,4,29,3,16030,15755,12838,-2917
2016,4,29,4,14621,14559,11692,-2867
2016,4,29,5,13232,13677,10927,-2750
2016,4,29,6,12641,13161,10657,-2504
2016,4,29,7,12301,12825,10480,-2345
2016,4,29,8,12165,12716,10603,-2113
2016,4,29,9,12326,12912,10744,-2168
2016,4,29,10,13119,13679,11314,-2365
2016,4,29,11,14642,14921,12152,-2769
2016,4,29,12,16157,16103,13789,-2314
2016,4,29,13,17010,16834,14269,-2565
2016,4,29,14,17451,17144,14427,-2717
2016,4,29,15,17715,17243,14350,-2893
2016,4,29,16,17799,17207,14528,-2679
2016,4,29,17,17689,17097,14283,-2814
2016,4,29,18,17627,17041,14086,-2955
2016,4,29,19,17527,16965,13767,-3198
2016,4,29,20,17411,16943,13900,-3043
2016,4,29,21,17387,16994,14033,-2961
2016,4,29,22,17310,17056,14169,-2887
2016,4,29,23,17080,16956,14184,-2772
2016,4,30,0,16961,16983,14238,-2745
2016,4,30,1,17307,17164,13989,-3175
2016,4,30,2,16821,16601,13496,-3105
2016,4,30,3,15773,15615,12622,-2993
2016,4,30,4,14546,14501,11582,-2919
2016,4,30,5,13317,13672,10226,-3446
2016,4,30,6,12667,13048,9759,-3289
2016,4,30,7,12262,12696,9752,-2944
2016,4,30,8,12068,12505,9764,-2741
2016,4,30,9,12083,12523,9713,-2810
2016,4,30,10,12368,12810,10182,-2628
2016,4,30,11,12868,13211,10091,-3120
2016,4,30,12,13708,13955,10929,-3026
2016,4,30,13,14735,14687,11845,-2842
2016,4,30,14,15424,15108,12432,-2676
2016,4,30,15,15780,15224,12466,-2758
2016,4,30,16,15881,15184,11768,-3416
2016,4,30,17,15832,15105,11532,-3573
2016,4,30,18,15646,14962,11439,-3523
2016,4,30,19,15509,14839,11321,-3518
2016,4,30,20,15444,14789,11236,-3553
2016,4,30,21,15506,14887,11555,-3332
2016,4,30,22,15656,15066,11814,-3252
2016,4,30,23,15709,15183,11814,-3369
2016,5,1,0,15799,15406,12415,-2991
2016,5,1,1,16376,16005,13106,-2899
2016,5,1,2,16077,15739,12611,-3128
2016,5,1,3,15204,14980,11824,-3156
2016,5,1,4,14159,14072,11039,-3033
2016,5,1,5,12937,13309,10896,-2413
2016,5,1,6,12291,12720,10371,-2349
2016,5,1,7,11893,12361,10315,-2046
2016,5,1,8,11722,12157,10103,-2054
2016,5,1,9,11711,12114,10174,-1940
2016,5,1,10,11933,12293,10118,-2175
2016,5,1,11,12066,12559,10501,-2058
2016,5,1,12,12670,13218,11288,-1930
2016,5,1,13,13554,14093,11814,-2279
2016,5,1,14,14289,14905,12452,-2453
2016,5,1,15,14810,15523,13023,-2500
2016,5,1,16,15108,15871,13312,-2559
2016,5,1,17,15269,16002,13897,-2105
2016,5,1,18,15279,16042,14143,-1899
2016,5,1,19,15213,16039,13996,-2043
2016,5,1,20,15191,16074,14070,-2004
2016,5,1,21,15268,16254,14123,-2131
2016,5,1,22,15426,16569,14543,-2026
2016,5,1,23,15532,16646,14778,-1868
2016,5,2,0,15723,16770,14544,-2226
2016,5,2,1,16259,16925,15019,-1906
2016,5,2,2,15959,16262,14411,-1851
2016,5,2,3,14989,15222,13407,-1815
2016,5,2,4,13905,14101,11947,-2154
2016,5,2,5,12668,13308,11085,-2223
2016,5,2,6,12120,12863,10694,-2169
2016,5,2,7,11821,12606,10648,-1958
2016,5,2,8,11757,12527,10684,-1843
2016,5,2,9,12003,12787,10872,-1915
2016,5,2,10,12917,13712,11643,-2069
2016,5,2,11,14354,15332,12907,-2425
2016,5,2,12,15891,16715,14305,-2410
2016,5,2,13,16765,17475,15139,-2336
2016,5,2,14,17259,17947,15760,-2187
2016,5,2,15,17614,18232,15966,-2266
2016,5,2,16,17768,18185,15825,-2360
2016,5,2,17,17843,18139,15869,-2270
2016,5,2,18,17902,18020,15762,-2258
2016,5,2,19,17839,17763,15488,-2275
2016,5,2,20,17783,17609,15332,-2277
2016,5,2,21,17791,17667,15232,-2435
2016,5,2,22,17821,17752,15546,-2206
2016,5,2,23,17626,17605,15643,-1962
2016,5,3,0,17562,17630,15577,-2053
2016,5,3,1,17879,17921,15894,-2027
2016,5,3,2,17320,17272,14984,-2288
2016,5,3,3,16002,15986,13931,-2055
2016,5,3,4,14505,14603,12518,-2085
2016,5,3,5,13116,13633,11676,-1957
2016,5,3,6,12462,13115,11484,-1631
2016,5,3,7,12092,12816,11299,-1517
2016,5,3,8,11961,12723,11238,-1485
2016,5,3,9,12156,12925,11341,-1584
2016,5,3,10,13031,13778,12018,-1760
2016,5,3,11,14480,15361,13434,-1927
2016,5,3,12,16056,16693,15087,-1606
2016,5,3,13,16914,17358,15487,-1871
2016,5,3,14,17388,17687,15919,-1768
2016,5,3,15,17710,17899,16025,-1874
2016,5,3,16,17870,17907,16128,-1779
2016,5,3,17,17934,17805,16057,-1748
2016,5,3,18,17971,17755,15972,-1783
2016,5,3,19,17911,17632,15998,-1634
2016,5,3,20,17838,17594,15808,-1786
2016,5,3,21,17844,17636,15826,-1810
2016,5,3,22,17831,17708,15932,-1776
2016,5,3,23,17611,17659,15863,-1796
2016,5,4,0,17477,17690,16123,-1567
2016,5,4,1,17776,17851,16348,-1503
2016,5,4,2,17217,17187,15207,-1980
2016,5,4,3,15787,15928,13948,-1980
2016,5,4,4,14257,14530,12555,-1975
2016,5,4,5,13090,13582,11624,-1958
2016,5,4,6,12450,13016,11065,-1951
2016,5,4,7,12061,12709,10909,-1800
2016,5,4,8,11921,12610,10802,-1808
2016,5,4,9,12101,12820,11028,-1792
2016,5,4,10,12963,13646,11799,-1847
2016,5,4,11,14439,15210,13200,-2010
2016,5,4,12,16016,16605,14915,-1690
2016,5,4,13,16868,17217,15615,-1602
2016,5,4,14,17322,17589,16038,-1551
2016,5,4,15,17641,17780,16174,-1606
2016,5,4,16,17776,17872,16260,-1612
2016,5,4,17,17817,17824,16364,-1460
2016,5,4,18,17873,17829,16402,-1427
2016,5,4,19,17813,17785,16141,-1644
2016,5,4,20,17749,17791,16098,-1693
2016,5,4,21,17739,17852,15979,-1873
2016,5,4,22,17705,17883,16018,-1865
2016,5,4,23,17477,17779,16441,-1338
2016,5,5,0,17379,17818,16383,-1435
2016,5,5,1,17734,17969,16408,-1561
2016,5,5,2,17194,17324,15725,-1599
2016,5,5,3,15806,15998,14150,-1848
2016,5,5,4,14324,14645,12828,-1817
2016,5,5,5,13066,13663,11959,-1704
2016,5,5,6,12424,13116,11541,-1575
2016,5,5,7,12031,12783,11075,-1708
2016,5,5,8,11909,12686,10871,-1815
2016,5,5,9,12093,12866,11021,-1845
2016,5,5,10,12942,13721,11970,-1751
2016,5,5,11,14399,15274,13718,-1556
2016,5,5,12,15967,16711,15221,-1490
2016,5,5,13,16808,17379,15664,-1715
2016,5,5,14,17256,17684,16109,-1575
2016,5,5,15,17566,17841,16288,-1553
2016,5,5,16,17691,17834,16367,-1467
2016,5,5,17,17719,17725,16330,-1395
2016,5,5,18,17750,17648,16284,-1364
2016,5,5,19,17676,17511,16110,-1401
2016,5,5,20,17596,17441,16045,-1396
2016,5,5,21,17578,17481,16095,-1386
2016,5,5,22,17532,17506,15953,-1553
2016,5,5,23,17333,17453,16017,-1436
2016,5,6,0,17233,17499,16062,-1437
2016,5,6,1,17592,17765,16219,-1546
2016,5,6,2,17088,17216,15621,-1595
2016,5,6,3,15724,15930,14448,-1482
2016,5,6,4,14277,14624,12915,-1709
2016,5,6,5,13110,13648,11604,-2044
2016,5,6,6,12456,13074,11045,-2029
2016,5,6,7,12060,12734,10777,-1957
2016,5,6,8,11931,12618,10827,-1791
2016,5,6,9,12099,12831,11111,-1720
2016,5,6,10,12891,13615,11868,-1747
2016,5,6,11,14274,15044,13065,-1979
2016,5,6,12,15864,16542,14861,-1681
2016,5,6,13,16776,17265,15658,-1607
2016,5,6,14,17279,17708,16143,-1565
2016,5,6,15,17611,17970,16396,-1574
2016,5,6,16,17762,18002,16410,-1592
2016,5,6,17,17788,17929,16395,-1534
2016,5,6,18,17807,17846,16185,-1661
2016,5,6,19,17743,17706,16235,-1471
2016,5,6,20,17652,17559,15788,-1771
2016,5,6,21,17577,17547,15768,-1779
2016,5,6,22,17413,17555,15914,-1641
2016,5,6,23,17099,17479,15984,-1495
2016,5,7,0,16892,17426,15852,-1574
2016,5,7,1,17200,17507,16196,-1311
2016,5,7,2,16798,17013,15640,-1373
2016,5,7,3,15660,16012,14132,-1880
2016,5,7,4,14374,14803,12897,-1906
2016,5,7,5,13274,13767,11948,-1819
2016,5,7,6,12570,13100,11490,-1610
2016,5,7,7,12111,12702,10752,-1950
2016,5,7,8,11899,12487,10668,-1819
2016,5,7,9,11905,12489,10705,-1784
2016,5,7,10,12167,12724,10901,-1823
2016,5,7,11,12532,13182,11364,-1818
2016,5,7,12,13477,14027,12158,-1869
2016,5,7,13,14620,14933,13196,-1737
2016,5,7,14,15445,15550,13574,-1976
2016,5,7,15,15950,15821,13886,-1935
2016,5,7,16,16163,15837,13852,-1985
2016,5,7,17,16199,15749,13788,-1961
2016,5,7,18,16112,15587,13794,-1793
2016,5,7,19,15982,15415,13812,-1603
2016,5,7,20,15962,15314,13779,-1535
2016,5,7,21,16026,15303,13797,-1506
2016,5,7,22,16149,15389,14022,-1367
2016,5,7,23,16104,15447,14049,-1398
2016,5,8,0,16002,15602,14002,-1600
2016,5,8,1,16420,16108,14240,-1868
2016,5,8,2,16215,15894,14054,-1840
2016,5,8,3,15440,15142,13533,-1609
2016,5,8,4,14241,14176,12434,-1742
2016,5,8,5,13015,13292,12334,-958
2016,5,8,6,12359,12664,12068,-596
2016,5,8,7,11964,12292,11737,-555
2016,5,8,8,11667,12064,11425,-639
2016,5,8,9,11646,12023,11544,-479
2016,5,8,10,11769,12192,11823,-369
2016,5,8,11,11913,12434,11982,-452
2016,5,8,12,12621,13147,12365,-782
2016,5,8,13,13566,14083,13433,-650
2016,5,8,14,14362,14833,13989,-844
2016,5,8,15,14887,15190,14432,-758
2016,5,8,16,15221,15158,14178,-980
2016,5,8,17,15369,14983,14080,-903
2016,5,8,18,15315,14789,13922,-867
2016,5,8,19,15271,14570,13820,-750
2016,5,8,20,15275,14546,13573,-973
2016,5,8,21,15459,14738,14017,-721
2016,5,8,22,15696,14950,14236,-714
2016,5,8,23,15744,15128,14271,-857
2016,5,9,0,15748,15370,14005,-1365
2016,5,9,1,16235,16081,14874,-1207
2016,5,9,2,16042,15863,14498,-1365
2016,5,9,3,14979,14983,13743,-1240
2016,5,9,4,13754,13974,13144,-830
2016,5,9,5,12673,13175,12045,-1130
2016,5,9,6,12165,12692,11789,-903
2016,5,9,7,11858,12435,11683,-752
2016,5,9,8,11784,12367,11424,-943
2016,5,9,9,12019,12634,11828,-806
2016,5,9,10,12814,13571,12356,-1215
2016,5,9,11,14287,15070,13787,-1283
2016,5,9,12,15945,16391,14945,-1446
2016,5,9,13,16867,16973,15135,-1838
2016,5,9,14,17392,17122,15295,-1827
2016,5,9,15,17718,17381,15950,-1431
2016,5,9,16,17843,17458,16277,-1181
2016,5,9,17,17822,17417,16509,-908
2016,5,9,18,17849,17501,16409,-1092
2016,5,9,19,17775,17482,16659,-823
2016,5,9,20,17748,17438,16561,-877
2016,5,9,21,17823,17432,16376,-1056
2016,5,9,22,17891,17419,16393,-1026
2016,5,9,23,17685,17237,16094,-1143
2016,5,10,0,17450,17276,16118,-1158
2016,5,10,1,17674,17720,16632,-1088
2016,5,10,2,17237,17250,16085,-1165
2016,5,10,3,15839,15898,14427,-1471
2016,5,10,4,14353,14504,13346,-1158
2016,5,10,5,12995,13502,12394,-1108
2016,5,10,6,12362,12951,12160,-791
2016,5,10,7,12032,12672,11955,-717
2016,5,10,8,11898,12582,11993,-589
2016,5,10,9,12088,12786,12038,-748
2016,5,10,10,12885,13541,12329,-1212
2016,5,10,11,14423,15082,13643,-1439
2016,5,10,12,16054,16330,14563,-1767
2016,5,10,13,16894,16819,15047,-1772
2016,5,10,14,17329,17073,15273,-1800
2016,5,10,15,17575,17192,15472,-1720
2016,5,10,16,17691,17268,15546,-1722
2016,5,10,17,17657,17237,15332,-1905
2016,5,10,18,17657,17268,15499,-1769
2016,5,10,19,17569,17234,15703,-1531
2016,5,10,20,17547,17257,15554,-1703
2016,5,10,21,17624,17315,15543,-1772
2016,5,10,22,17714,17372,15645,-1727
2016,5,10,23,17528,17198,15603,-1595
2016,5,11,0,17287,17156,15748,-1408
2016,5,11,1,17575,17513,16342,-1171
2016,5,11,2,17098,17046,15684,-1362
2016,5,11,3,15883,15690,14308,-1382
2016,5,11,4,14268,14287,12900,-1387
2016,5,11,5,13033,13323,11974,-1349
2016,5,11,6,12434,12777,11702,-1075
2016,5,11,7,12066,12485,11631,-854
2016,5,11,8,11886,12411,11576,-835
2016,5,11,9,12055,12637,11558,-1079
2016,5,11,10,12801,13425,11907,-1518
2016,5,11,11,14308,14938,13232,-1706
2016,5,11,12,15952,16235,14718,-1517
2016,5,11,13,16825,16824,15325,-1499
2016,5,11,14,17289,17171,15633,-1538
2016,5,11,15,17611,17407,15612,-1795
2016,5,11,16,17760,17491,15705,-1786
2016,5,11,17,17816,17512,15691,-1821
2016,5,11,18,17927,17588,15760,-1828
2016,5,11,19,17960,17605,15887,-1718
2016,5,11,20,17977,17679,15969,-1710
2016,5,11,21,18068,17802,16216,-1586
2016,5,11,22,18048,17804,16652,-1152
2016,5,11,23,17697,17514,16519,-995
2016,5,12,0,17403,17369,16263,-1106
2016,5,12,1,17620,17717,16617,-1100
2016,5,12,2,17222,17240,16130,-1110
2016,5,12,3,15831,15917,14207,-1710
2016,5,12,4,14319,14494,12264,-2230
2016,5,12,5,13036,13490,11022,-2468
2016,5,12,6,12404,12865,10846,-2019
2016,5,12,7,12030,12500,10940,-1560
2016,5,12,8,11881,12393,10719,-1674
2016,5,12,9,12033,12593,11037,-1556
2016,5,12,10,12738,13329,11344,-1985
2016,5,12,11,14203,14840,12990,-1850
2016,5,12,12,15812,16294,14530,-1764
2016,5,12,13,16731,17037,15230,-1807
2016,5,12,14,17287,17496,15620,-1876
2016,5,12,15,17688,17801,15934,-1867
2016,5,12,16,17904,17984,15924,-2060
2016,5,12,17,17992,18121,15824,-2297
2016,5,12,18,18144,18309,15831,-2478
2016,5,12,19,18216,18442,16012,-2430
2016,5,12,20,18267,18632,16372,-2260
2016,5,12,21,18367,18802,16721,-2081
2016,5,12,22,18315,18630,16183,-2447
2016,5,12,23,17963,18226,16398,-1828
2016,5,13,0,17681,17903,16068,-1835
2016,5,13,1,17935,18185,16379,-1806
2016,5,13,2,17546,17670,15947,-1723
2016,5,13,3,16269,16304,14370,-1934
2016,5,13,4,14746,14844,13004,-1840
2016,5,13,5,13506,13764,11813,-1951
2016,5,13,6,12805,13076,11440,-1636
2016,5,13,7,12419,12697,11668,-1029
2016,5,13,8,12154,12535,11413,-1122
2016,5,13,9,12263,12694,11381,-1313
2016,5,13,10,12961,13383,11746,-1637
2016,5,13,11,14386,14827,13177,-1650
2016,5,13,12,16042,16262,14693,-1569
2016,5,13,13,17031,17114,15662,-1452
2016,5,13,14,17616,17682,16105,-1577
2016,5,13,15,18018,18146,16380,-1766
2016,5,13,16,18204,18242,16465,-1777
2016,5,13,17,18287,18266,16838,-1428
2016,5,13,18,18367,18262,17174,-1088
2016,5,13,19,18334,18127,16970,-1157
2016,5,13,20,18236,17995,16724,-1271
2016,5,13,21,18167,17971,16835,-1136
2016,5,13,22,17985,17863,16409,-1454
2016,5,13,23,17592,17570,16083,-1487
2016,5,14,0,17284,17320,16106,-1214
2016,5,14,1,17499,17303,17072,-231
2016,5,14,2,17141,16998,16003,-995
2016,5,14,3,15981,15987,14355,-1632
2016,5,14,4,14683,14751,13278,-1473
2016,5,14,5,13330,13710,12271,-1439
2016,5,14,6,12653,13051,11622,-1429
2016,5,14,7,12168,12600,11351,-1249
2016,5,14,8,11892,12349,11386,-963
2016,5,14,9,11849,12321,11583,-738
2016,5,14,10,12000,12439,11610,-829
2016,5,14,11,12401,12832,11930,-902
2016,5,14,12,13412,13742,12788,-954
2016,5,14,13,14623,14731,13473,-1258
2016,5,14,14,15533,15427,13927,-1500
2016,5,14,15,16127,15888,14255,-1633
2016,5,14,16,16382,16114,14422,-1692
2016,5,14,17,16465,16145,14709,-1436
2016,5,14,18,16421,16048,14778,-1270
2016,5,14,19,16372,15951,14609,-1342
2016,5,14,20,16296,15917,14680,-1237
2016,5,14,21,16280,15964,14770,-1194
2016,5,14,22,16325,16152,14893,-1259
2016,5,14,23,16243,16237,15023,-1214
2016,5,15,0,16201,16244,15032,-1212
2016,5,15,1,16604,16404,15248,-1156
2016,5,15,2,16391,16095,14793,-1302
2016,5,15,3,15451,15245,13627,-1618
2016,5,15,4,14374,14221,12819,-1402
2016,5,15,5,13078,13304,12323,-981
2016,5,15,6,12437,12666,11898,-768
2016,5,15,7,12032,12278,11712,-566
2016,5,15,8,11790,12073,11489,-584
2016,5,15,9,11730,12050,11535,-515
2016,5,15,10,11762,12134,11760,-374
2016,5,15,11,11938,12392,12196,-196
2016,5,15,12,12685,13101,13058,-43
2016,5,15,13,13651,13946,13796,-150
2016,5,15,14,14410,14652,14555,-97
2016,5,15,15,14910,15150,14685,-465
2016,5,15,16,15181,15467,14797,-670
2016,5,15,17,15261,15700,15185,-515
2016,5,15,18,15219,15655,15135,-520
2016,5,15,19,15114,15590,15217,-373
2016,5,15,20,15083,15559,15217,-342
2016,5,15,21,15205,15644,15356,-288
2016,5,15,22,15451,15876,15713,-163
2016,5,15,23,15575,15996,15830,-166
2016,5,16,0,15628,16179,16057,-122
2016,5,16,1,16202,16632,16528,-104
2016,5,16,2,15931,16337,15869,-468
2016,5,16,3,14970,15331,14671,-660
2016,5,16,4,13897,14230,13805,-425
2016,5,16,5,12996,13411,12828,-583
2016,5,16,6,12487,12938,12414,-524
2016,5,16,7,12184,12678,12311,-367
2016,5,16,8,12104,12622,12212,-410
2016,5,16,9,12321,12881,12324,-557
2016,5,16,10,13072,13715,12826,-889
2016,5,16,11,14571,15316,14098,-1218
2016,5,16,12,16210,16717,15706,-1011
2016,5,16,13,17089,17297,16520,-777
2016,5,16,14,17585,17655,16822,-833
2016,5,16,15,17856,17738,16639,-1099
2016,5,16,16,17916,17688,16515,-1173
2016,5,16,17,17855,17548,16467,-1081
2016,5,16,18,17807,17462,16333,-1129
2016,5,16,19,17740,17341,16137,-1204
2016,5,16,20,17658,17295,16040,-1255
2016,5,16,21,17746,17410,16004,-1406
2016,5,16,22,17867,17484,16109,-1375
2016,5,16,23,17673,17314,15642,-1672
2016,5,17,0,17455,17218,15930,-1288
2016,5,17,1,17748,17604,16462,-1142
2016,5,17,2,17337,17167,16130,-1037
2016,5,17,3,16005,15883,14349,-1534
2016,5,17,4,14582,14495,13150,-1345
2016,5,17,5,13134,13533,12553,-980
2016,5,17,6,12482,13000,12326,-674
2016,5,17,7,12096,12685,11863,-822
2016,5,17,8,11962,12590,11908,-682
2016,5,17,9,12093,12793,12041,-752
2016,5,17,10,12773,13571,12621,-950
2016,5,17,11,14307,15132,13806,-1326
2016,5,17,12,15939,16495,14861,-1634
2016,5,17,13,16800,17214,15396,-1818
2016,5,17,14,17318,17628,15530,-2098
2016,5,17,15,17658,17759,15516,-2243
2016,5,17,16,17821,17854,15790,-2064
2016,5,17,17,17894,17854,15702,-2152
2016,5,17,18,17981,17863,15596,-2267
2016,5,17,19,17955,17809,15385,-2424
2016,5,17,20,17866,17693,15412,-2281
2016,5,17,21,17890,17757,15621,-2136
2016,5,17,22,17887,17762,15801,-1961
2016,5,17,23,17649,17505,15844,-1661
2016,5,18,0,17469,17365,15610,-1755
2016,5,18,1,17784,17573,15758,-1815
2016,5,18,2,17333,17207,15455,-1752
2016,5,18,3,15926,15912,14254,-1658
2016,5,18,4,14415,14486,12565,-1921
2016,5,18,5,13065,13565,11952,-1613
2016,5,18,6,12432,13024,11593,-1431
2016,5,18,7,12037,12732,11328,-1404
2016,5,18,8,11917,12660,11246,-1414
2016,5,18,9,12059,12865,11408,-1457
2016,5,18,10,12756,13556,11979,-1577
2016,5,18,11,14287,15107,13045,-2062
2016,5,18,12,15906,16475,14570,-1905
2016,5,18,13,16806,17077,15086,-1991
2016,5,18,14,17361,17333,15156,-2177
2016,5,18,15,17718,17495,15403,-2092
2016,5,18,16,17796,17504,15263,-2241
2016,5,18,17,17796,17478,15493,-1985
2016,5,18,18,17825,17515,15560,-1955
2016,5,18,19,17787,17511,15670,-1841
2016,5,18,20,17766,17507,15302,-2205
2016,5,18,21,17851,17568,15235,-2333
2016,5,18,22,17868,17595,15108,-2487
2016,5,18,23,17581,17385,15284,-2101
2016,5,19,0,17312,17327,15281,-2046
2016,5,19,1,17597,17554,15456,-2098
2016,5,19,2,17205,17097,15014,-2083
2016,5,19,3,15893,15804,13931,-1873
2016,5,19,4,14329,14407,12611,-1796
2016,5,19,5,13070,13437,11773,-1664
2016,5,19,6,12437,12895,11600,-1295
2016,5,19,7,12040,12579,11304,-1275
2016,5,19,8,11927,12512,11296,-1216
2016,5,19,9,12070,12708,11541,-1167
2016,5,19,10,12743,13455,11844,-1611
2016,5,19,11,14240,14978,12720,-2258
2016,5,19,12,15918,16422,14040,-2382
2016,5,19,13,16811,17110,14440,-2670
2016,5,19,14,17298,17428,14635,-2793
2016,5,19,15,17674,17670,14816,-2854
2016,5,19,16,17811,17780,15080,-2700
2016,5,19,17,17820,17859,14791,-3068
2016,5,19,18,17845,17948,14872,-3076
2016,5,19,19,17778,17886,14834,-3052
2016,5,19,20,17721,17796,14455,-3341
2016,5,19,21,17763,17849,14529,-3320
2016,5,19,22,17758,17771,14843,-2928
2016,5,19,23,17520,17441,14438,-3003
2016,5,20,0,17280,17258,14281,-2977
2016,5,20,1,17561,17499,14719,-2780
2016,5,20,2,17170,17226,14530,-2696
2016,5,20,3,15783,15929,13497,-2432
2016,5,20,4,14314,14536,12078,-2458
2016,5,20,5,13038,13563,11319,-2244
2016,5,20,6,12408,12970,10778,-2192
2016,5,20,7,12045,12641,10624,-2017
2016,5,20,8,11884,12547,10860,-1687
2016,5,20,9,11999,12713,10943,-1770
2016,5,20,10,12611,13368,10973,-2395
2016,5,20,11,14057,14855,11997,-2858
2016,5,20,12,15671,16270,13751,-2519
2016,5,20,13,16622,16947,14569,-2378
2016,5,20,14,17195,17394,14774,-2620
2016,5,20,15,17604,17693,14748,-2945
2016,5,20,16,17791,17799,14753,-3046
2016,5,20,17,17865,17810,14688,-3122
2016,5,20,18,17974,17944,14699,-3245
2016,5,20,19,18035,17958,14709,-3249
2016,5,20,20,17985,18048,14781,-3267
2016,5,20,21,18001,18112,14907,-3205
2016,5,20,22,17829,17949,14735,-3214
2016,5,20,23,17395,17469,14465,-3004
2016,5,21,0,17007,17142,14481,-2661
2016,5,21,1,17161,17253,14811,-2442
2016,5,21,2,16934,16998,14477,-2521
2016,5,21,3,15905,15939,13243,-2696
2016,5,21,4,14569,14677,12072,-2605
2016,5,21,5,13226,13613,11315,-2298
2016,5,21,6,12513,12963,10624,-2339
2016,5,21,7,12075,12546,10331,-2215
2016,5,21,8,11772,12316,10304,-2012
2016,5,21,9,11667,12302,10626,-1676
2016,5,21,10,11801,12413,10879,-1534
2016,5,21,11,12200,12836,11360,-1476
2016,5,21,12,13230,13756,12269,-1487
2016,5,21,13,14398,14799,13198,-1601
2016,5,21,14,15292,15593,13671,-1922
2016,5,21,15,15868,16056,13698,-2358
2016,5,21,16,16116,16201,13551,-2650
2016,5,21,17,16195,16166,13616,-2550
2016,5,21,18,16155,16022,13455,-2567
2016,5,21,19,16080,15889,13497,-2392
2016,5,21,20,15962,15807,13704,-2103
2016,5,21,21,15929,15843,13540,-2303
2016,5,21,22,15959,15900,13350,-2550
2016,5,21,23,15906,15914,13079,-2835
2016,5,22,0,15883,16011,13225,-2786
2016,5,22,1,16300,16270,13508,-2762
2016,5,22,2,16091,16018,13113,-2905
2016,5,22,3,15191,15137,12198,-2939
2016,5,22,4,14105,14168,11478,-2690
2016,5,22,5,12897,13336,11539,-1797
2016,5,22,6,12239,12745,11195,-1550
2016,5,22,7,11816,12357,10820,-1537
2016,5,22,8,11618,12126,10389,-1737
2016,5,22,9,11516,12063,10152,-1911
2016,5,22,10,11514,12152,10072,-2080
2016,5,22,11,11687,12362,10345,-2017
2016,5,22,12,12426,13030,10733,-2297
2016,5,22,13,13421,13957,11387,-2570
2016,5,22,14,14271,14756,11913,-2843
2016,5,22,15,14859,15240,12504,-2736
2016,5,22,16,15191,15371,12546,-2825
2016,5,22,17,15364,15515,12482,-3033
2016,5,22,18,15438,15437,12387,-3050
2016,5,22,19,15394,15456,12473,-2983
2016,5,22,20,15381,15579,12471,-3108
2016,5,22,21,15506,15797,12737,-3060
2016,5,22,22,15711,16066,12921,-3145
2016,5,22,23,15738,16167,13028,-3139
2016,5,23,0,15730,16236,13073,-3163
2016,5,23,1,16187,16632,13421,-3211
2016,5,23,2,15993,16412,12970,-3442
2016,5,23,3,15083,15333,12060,-3273
2016,5,23,4,13830,14099,11083,-3016
2016,5,23,5,12874,13213,10854,-2359
2016,5,23,6,12258,12707,10531,-2176
2016,5,23,7,11943,12388,10515,-1873
2016,5,23,8,11835,12286,10381,-1905
2016,5,23,9,11946,12527,10792,-1735
2016,5,23,10,12601,13206,10884,-2322
2016,5,23,11,14048,14758,11997,-2761
2016,5,23,12,15805,16383,13714,-2669
2016,5,23,13,16858,17231,14221,-3010
2016,5,23,14,17562,17773,14625,-3148
2016,5,23,15,18056,18262,14923,-3339
2016,5,23,16,18280,18523,15372,-3151
2016,5,23,17,18391,18623,15612,-3011
2016,5,23,18,18457,18842,15525,-3317
2016,5,23,19,18470,18882,15694,-3188
2016,5,23,20,18424,18978,15691,-3287
2016,5,23,21,18414,19056,16150,-2906
2016,5,23,22,18363,18957,15901,-3056
2016,5,23,23,18041,18568,15303,-3265
2016,5,24,0,17830,18283,15411,-2872
2016,5,24,1,18038,18341,15613,-2728
2016,5,24,2,17567,17869,15368,-2501
2016,5,24,3,16169,16429,13522,-2907
2016,5,24,4,14698,14903,12102,-2801
2016,5,24,5,13660,13816,11395,-2421
2016,5,24,6,12967,13213,11363,-1850
2016,5,24,7,12497,12837,11131,-1706
2016,5,24,8,12313,12689,11027,-1662
2016,5,24,9,12457,12861,10991,-1870
2016,5,24,10,13147,13561,11417,-2144
2016,5,24,11,14634,15096,12638,-2458
2016,5,24,12,16333,16648,14175,-2473
2016,5,24,13,17405,17474,14900,-2574
2016,5,24,14,18090,18097,14866,-3231
2016,5,24,15,18603,18470,15433,-3037
2016,5,24,16,18955,18591,14997,-3594
2016,5,24,17,19149,18781,15398,-3383
2016,5,24,18,19333,18923,15413,-3510
2016,5,24,19,19428,18880,15755,-3125
2016,5,24,20,19519,18837,15867,-2970
2016,5,24,21,19612,19110,15936,-3174
2016,5,24,22,19556,19081,15556,-3525
2016,5,24,23,19126,18790,15874,-2916
2016,5,25,0,18663,18538,15674,-2864
2016,5,25,1,18402,18481,15724,-2757
2016,5,25,2,18041,17988,15313,-2675
2016,5,25,3,16825,16558,14032,-2526
2016,5,25,4,15175,15074,12681,-2393
2016,5,25,5,13972,13983,12083,-1900
2016,5,25,6,13227,13292,11190,-2102
2016,5,25,7,12731,12903,10867,-2036
2016,5,25,8,12482,12733,10729,-2004
2016,5,25,9,12603,12851,10917,-1934
2016,5,25,10,13223,13493,11363,-2130
2016,5,25,11,14679,15055,12473,-2582
2016,5,25,12,16422,16722,14645,-2077
2016,5,25,13,17647,17735,15525,-2210
2016,5,25,14,18563,18448,16173,-2275
2016,5,25,15,19365,19046,16637,-2409
2016,5,25,16,20019,19559,17221,-2338
2016,5,25,17,20536,19960,17803,-2157
2016,5,25,18,21077,20408,18026,-2382
2016,5,25,19,21490,20742,18249,-2493
2016,5,25,20,21874,21123,18704,-2419
2016,5,25,21,22168,21384,18993,-2391
2016,5,25,22,22114,21438,19063,-2375
2016,5,25,23,21483,20952,18518,-2434
2016,5,26,0,20741,20450,18099,-2351
2016,5,26,1,20360,20406,17871,-2535
2016,5,26,2,20068,20001,17569,-2432
2016,5,26,3,18675,18501,15551,-2950
2016,5,26,4,17017,16768,13849,-2919
2016,5,26,5,15315,15513,12665,-2848
2016,5,26,6,14436,14695,12197,-2498
2016,5,26,7,13866,14148,11949,-2199
2016,5,26,8,13577,13887,11579,-2308
2016,5,26,9,13661,13977,11928,-2049
2016,5,26,10,14259,14598,12092,-2506
2016,5,26,11,15763,16122,13194,-2928
2016,5,26,12,17661,17889,15881,-2008
2016,5,26,13,19067,19050,17015,-2035
2016,5,26,14,20143,20000,17475,-2525
2016,5,26,15,21112,20890,18292,-2598
2016,5,26,16,21936,21603,19232,-2371
2016,5,26,17,22553,22157,19333,-2824
2016,5,26,18,23112,22728,20138,-2590
2016,5,26,19,23517,23041,20004,-3037
2016,5,26,20,23789,23382,20774,-2608
2016,5,26,21,23943,23579,21112,-2467
2016,5,26,22,23726,23245,21206,-2039
2016,5,26,23,22952,22530,20494,-2036
2016,5,27,0,22113,21909,19881,-2028
2016,5,27,1,21611,21602,19874,-1728
2016,5,27,2,21198,21105,19368,-1737
2016,5,27,3,19643,19092,16510,-2582
2016,5,27,4,17922,17835,14701,-3134
2016,5,27,5,16202,16514,13596,-2918
2016,5,27,6,15270,15659,13083,-2576
2016,5,27,7,14695,15121,12620,-2501
2016,5,27,8,14308,14823,12431,-2392
2016,5,27,9,14322,14890,12557,-2333
2016,5,27,10,14861,15456,13030,-2426
2016,5,27,11,16265,16843,14226,-2617
2016,5,27,12,18136,18592,16438,-2154
2016,5,27,13,19632,19966,17153,-2813
2016,5,27,14,20820,21145,18207,-2938
2016,5,27,15,21840,22148,19056,-3092
2016,5,27,16,22663,22956,20092,-2864
2016,5,27,17,23237,23466,20513,-2953
2016,5,27,18,23740,23942,21207,-2735
2016,5,27,19,24105,24216,21322,-2894
2016,5,27,20,24345,24232,21182,-3050
2016,5,27,21,24451,24137,21256,-2881
2016,5,27,22,24144,23940,21282,-2658
2016,5,27,23,23289,23167,20867,-2300
2016,5,28,0,22370,22344,20375,-1969
2016,5,28,1,21766,21962,19963,-1999
2016,5,28,2,21423,21514,19013,-2501
2016,5,28,3,20178,20186,17504,-2682
2016,5,28,4,18464,18576,15896,-2680
2016,5,28,5,16894,17167,14379,-2788
2016,5,28,6,15945,16137,13541,-2596
2016,5,28,7,15260,15479,12786,-2693
2016,5,28,8,14784,15072,12270,-2802
2016,5,28,9,14598,14905,12161,-2744
2016,5,28,10,14588,14831,11944,-2887
2016,5,28,11,14946,15227,12100,-3127
2016,5,28,12,16142,16493,13102,-3391
2016,5,28,13,17761,18095,14435,-3660
2016,5,28,14,19216,19604,16184,-3420
2016,5,28,15,20444,20952,17497,-3455
2016,5,28,16,21405,21965,18377,-3588
2016,5,28,17,22062,22639,19408,-3231
2016,5,28,18,22479,23037,20174,-2863
2016,5,28,19,22808,23357,19831,-3526
2016,5,28,20,23089,23588,20139,-3449
2016,5,28,21,23239,23796,20463,-3333
2016,5,28,22,23131,23801,20733,-3068
2016,5,28,23,22638,23309,20276,-3033
2016,5,29,0,21907,22648,19185,-3463
2016,5,29,1,21461,22374,19332,-3042
2016,5,29,2,21317,22111,18779,-3332
2016,5,29,3,20205,20948,17482,-3466
2016,5,29,4,18815,19420,16050,-3370
2016,5,29,5,17555,18039,14534,-3505
2016,5,29,6,16493,16925,13600,-3325
2016,5,29,7,15738,16127,13005,-3122
2016,5,29,8,15266,15607,12470,-3137
2016,5,29,9,14993,15297,12292,-3005
2016,5,29,10,14737,15071,12021,-3050
2016,5,29,11,14669,15328,12558,-2770
2016,5,29,12,15487,16355,13171,-3184
2016,5,29,13,16996,17802,14209,-3593
2016,5,29,14,18482,19233,14971,-4262
2016,5,29,15,19691,20620,16172,-4448
2016,5,29,16,20642,21543,17535,-4008
2016,5,29,17,21260,22062,18232,-3830
2016,5,29,18,21607,22379,18433,-3946
2016,5,29,19,21780,22439,18497,-3942
2016,5,29,20,21920,22287,18498,-3789
2016,5,29,21,22002,22095,18317,-3778
2016,5,29,22,21949,21852,18241,-3611
2016,5,29,23,21548,21329,18189,-3140
2016,5,30,0,21023,20718,17594,-3124
2016,5,30,1,20859,20586,17530,-3056
2016,5,30,2,20703,20349,16924,-3425
2016,5,30,3,19496,19323,16061,-3262
2016,5,30,4,17985,18055,15207,-2848
2016,5,30,5,16324,16988,13922,-3066
2016,5,30,6,15463,16111,12878,-3233
2016,5,30,7,14883,15552,12330,-3222
2016,5,30,8,14594,15239,12106,-3133
2016,5,30,9,14458,15130,12067,-3063
2016,5,30,10,14473,15217,12498,-2719
2016,5,30,11,14735,15512,13336,-2176
2016,5,30,12,15499,16252,14094,-2158
2016,5,30,13,16543,17274,14648,-2626
2016,5,30,14,17535,18269,15233,-3036
2016,5,30,15,18273,19276,16253,-3023
2016,5,30,16,18789,20153,17046,-3107
2016,5,30,17,19048,20862,17855,-3007
2016,5,30,18,19095,21283,18191,-3092
2016,5,30,19,19017,21569,18323,-3246
2016,5,30,20,18948,21612,18023,-3589
2016,5,30,21,18971,21708,18840,-2868
2016,5,30,22,19029,21758,19023,-2735
2016,5,30,23,18870,21448,19082,-2366
2016,5,31,0,18682,21169,18316,-2853
2016,5,31,1,18840,21143,17899,-3244
2016,5,31,2,18860,20789,17343,-3446
2016,5,31,3,17645,19396,15911,-3485
2016,5,31,4,16275,17844,14768,-3076
2016,5,31,5,15136,16636,14157,-2479
2016,5,31,6,14480,15876,13372,-2504
2016,5,31,7,14007,15384,12699,-2685
2016,5,31,8,13777,15160,12156,-3004
2016,5,31,9,13865,15267,12256,-3011
2016,5,31,10,14397,15940,12701,-3239
2016,5,31,11,15760,17592,14271,-3321
2016,5,31,12,17405,19466,15722,-3744
2016,5,31,13,18740,20718,17049,-3669
2016,5,31,14,19715,21579,18086,-3493
2016,5,31,15,20659,22375,18693,-3682
2016,5,31,16,21153,22913,18583,-4330
2016,5,31,17,21650,23437,19033,-4404
2016,5,31,18,22017,23910,19897,-4013
2016,5,31,19,22199,24334,20598,-3736
2016,5,31,20,22383,24764,21254,-3510
2016,5,31,21,22644,25061,21122,-3939
2016,5,31,22,22555,24932,21071,-3861
2016,5,31,23,21974,24194,20443,-3751
2016,6,1,0,21278,23217,20084,-3133
2016,6,1,1,20909,22583,19747,-2836
2016,6,1,2,20491,22086,18798,-3288
2016,6,1,3,18985,20427,17501,-2926
2016,6,1,4,17230,18546,15748,-2798
2016,6,1,5,15407,17050,13458,-3592
2016,6,1,6,14532,16085,12579,-3506
2016,6,1,7,14037,15450,12081,-3369
2016,6,1,8,13688,15037,11758,-3279
2016,6,1,9,13762,15021,11622,-3399
2016,6,1,10,14234,15483,12520,-2963
2016,6,1,11,15626,17051,14155,-2896
2016,6,1,12,17323,18819,15645,-3174
2016,6,1,13,18546,19853,17259,-2594
2016,6,1,14,19448,20635,17947,-2688
2016,6,1,15,20141,21375,18197,-3178
2016,6,1,16,20707,21952,19210,-2742
2016,6,1,17,21037,22388,19902,-2486
2016,6,1,18,21363,22831,20222,-2609
2016,6,1,19,21552,23167,20528,-2639
2016,6,1,20,21734,23563,20566,-2997
2016,6,1,21,21838,23934,20684,-3250
2016,6,1,22,21709,23828,20795,-3033
2016,6,1,23,21080,23050,20312,-2738
2016,6,2,0,20338,22148,19796,-2352
2016,6,2,1,19910,21583,19392,-2191
2016,6,2,2,19544,21069,18659,-2410
2016,6,2,3,18357,19413,16861,-2552
2016,6,2,4,16693,17609,14742,-2867
2016,6,2,5,15503,16179,13318,-2861
2016,6,2,6,14615,15392,12799,-2593
2016,6,2,7,14044,14858,12368,-2490
2016,6,2,8,13782,14582,12133,-2449
2016,6,2,9,13808,14682,12367,-2315
2016,6,2,10,14346,15246,12910,-2336
2016,6,2,11,15740,16860,14136,-2724
2016,6,2,12,17459,18535,16005,-2530
2016,6,2,13,18674,19578,16458,-3120
2016,6,2,14,19573,20368,16879,-3489
2016,6,2,15,20297,20976,17715,-3261
2016,6,2,16,20797,21333,18158,-3175
2016,6,2,17,21110,21599,18155,-3444
2016,6,2,18,21393,21945,18444,-3501
2016,6,2,19,21511,22188,18431,-3757
2016,6,2,20,21633,22515,18898,-3617
2016,6,2,21,21686,22769,19874,-2895
2016,6,2,22,21536,22580,19834,-2746
2016,6,2,23,20949,21858,18951,-2907
2016,6,3,0,20281,21133,18214,-2919
2016,6,3,1,19941,20831,18031,-2800
2016,6,3,2,19567,20341,17391,-2950
2016,6,3,3,18218,18922,15669,-3253
2016,6,3,4,16655,17306,14115,-3191
2016,6,3,5,15320,15982,12167,-3815
2016,6,3,6,14505,15166,11429,-3737
2016,6,3,7,13970,14633,11154,-3479
2016,6,3,8,13709,14386,10643,-3743
2016,6,3,9,13755,14476,10765,-3711
2016,6,3,10,14286,15097,11516,-3581
2016,6,3,11,15624,16631,12968,-3663
2016,6,3,12,17286,18254,14548,-3706
2016,6,3,13,18457,19252,15845,-3407
2016,6,3,14,19290,19886,16456,-3430
2016,6,3,15,19909,20382,16728,-3654
2016,6,3,16,20358,20668,17380,-3288
2016,6,3,17,20624,20812,17817,-2995
2016,6,3,18,20870,20955,18016,-2939
2016,6,3,19,21029,21027,17472,-3555
2016,6,3,20,21118,21041,17268,-3773
2016,6,3,21,21173,21064,17804,-3260
2016,6,3,22,20942,20975,17802,-3173
2016,6,3,23,20306,20423,17202,-3221
2016,6,4,0,19639,19913,16696,-3217
2016,6,4,1,19249,19639,16464,-3175
2016,6,4,2,19011,19382,16207,-3175
2016,6,4,3,18117,18228,14434,-3794
2016,6,4,4,16626,16880,13668,-3212
2016,6,4,5,15418,15579,12077,-3502
2016,6,4,6,14612,14800,11348,-3452
2016,6,4,7,14068,14259,10424,-3835
2016,6,4,8,13606,13959,10174,-3785
2016,6,4,9,13449,13869,10352,-3517
2016,6,4,10,13411,13932,10673,-3259
2016,6,4,11,13740,14422,11121,-3301
2016,6,4,12,14802,15463,11683,-3780
2016,6,4,13,16187,16819,13334,-3485
2016,6,4,14,17403,18075,14697,-3378
2016,6,4,15,18376,19000,15379,-3621
2016,6,4,16,19089,19700,15675,-4025
2016,6,4,17,19590,20330,16447,-3883
2016,6,4,18,19899,20755,17009,-3746
2016,6,4,19,20126,21081,17286,-3795
2016,6,4,20,20383,21335,17604,-3731
2016,6,4,21,20526,21520,17809,-3711
2016,6,4,22,20495,21409,17718,-3691
2016,6,4,23,20072,20936,17224,-3712
2016,6,5,0,19465,20396,16726,-3670
2016,6,5,1,19200,20189,16795,-3394
2016,6,5,2,19151,19886,16306,-3580
2016,6,5,3,18412,18828,15284,-3544
2016,6,5,4,17146,17550,14154,-3396
2016,6,5,5,15937,16369,12929,-3440
2016,6,5,6,15084,15533,12083,-3450
2016,6,5,7,14468,14960,11360,-3600
2016,6,5,8,14103,14617,11363,-3254
2016,6,5,9,13921,14415,11644,-2771
2016,6,5,10,13822,14362,11496,-2866
2016,6,5,11,13991,14518,12220,-2298
2016,6,5,12,14774,15175,12593,-2582
2016,6,5,13,15965,16219,13652,-2567
2016,6,5,14,17031,17171,14525,-2646
2016,6,5,15,17822,17951,15010,-2941
2016,6,5,16,18368,18427,15485,-2942
2016,6,5,17,18691,18626,15703,-2923
2016,6,5,18,18857,18639,15649,-2990
2016,6,5,19,18934,18617,15889,-2728
2016,6,5,20,19041,18691,16319,-2372
2016,6,5,21,19223,18848,16396,-2452
2016,6,5,22,19330,19106,16658,-2448
2016,6,5,23,19176,19167,16809,-2358
2016,6,6,0,18948,18890,16492,-2398
2016,6,6,1,18931,18754,16308,-2446
2016,6,6,2,18934,18519,15597,-2922
2016,6,6,3,17930,17494,14575,-2919
2016,6,6,4,16631,16192,13360,-2832
2016,6,6,5,15755,15135,12309,-2826
2016,6,6,6,15070,14537,11650,-2887
2016,6,6,7,14609,14167,11737,-2430
2016,6,6,8,14309,13965,11607,-2358
2016,6,6,9,14413,14223,12210,-2013
2016,6,6,10,15002,14941,12319,-2622
2016,6,6,11,16441,16602,14021,-2581
2016,6,6,12,18338,18569,15817,-2752
2016,6,6,13,19698,19759,16720,-3039
2016,6,6,14,20770,20580,17739,-2841
2016,6,6,15,21636,21219,17885,-3334
2016,6,6,16,22324,21602,18491,-3111
2016,6,6,17,22780,21943,19096,-2847
2016,6,6,18,23195,22370,19604,-2766
2016,6,6,19,23477,22773,20437,-2336
2016,6,6,20,23720,23103,20446,-2657
2016,6,6,21,23939,23339,20388,-2951
2016,6,6,22,23859,23295,20985,-2310
2016,6,6,23,23210,22753,20634,-2119
2016,6,7,0,22447,22101,20008,-2093
2016,6,7,1,21907,21676,19795,-1881
2016,6,7,2,21584,21331,18748,-2583
2016,6,7,3,20103,19786,16757,-3029
2016,6,7,4,18355,18243,15228,-3015
2016,6,7,5,16331,16829,12777,-4052
2016,6,7,6,15446,15824,11898,-3926
2016,6,7,7,14916,15251,12111,-3140
2016,6,7,8,14557,15006,12234,-2772
2016,6,7,9,14646,15059,12370,-2689
2016,6,7,10,15209,15718,12895,-2823
2016,6,7,11,16676,17379,13994,-3385
2016,6,7,12,18546,19223,15916,-3307
2016,6,7,13,19899,20424,17060,-3364
2016,6,7,14,20923,21280,17932,-3348
2016,6,7,15,21774,21958,18734,-3224
2016,6,7,16,22421,22483,19068,-3415
2016,6,7,17,22882,22829,19078,-3751
2016,6,7,18,23244,22982,19668,-3314
2016,6,7,19,23403,23110,19772,-3338
2016,6,7,20,23519,23019,19720,-3299
2016,6,7,21,23558,22609,19362,-3247
2016,6,7,22,23334,22202,19015,-3187
2016,6,7,23,22588,21328,18262,-3066
2016,6,8,0,21788,20764,17848,-2916
2016,6,8,1,21302,20292,17599,-2693
2016,6,8,2,20889,19859,17032,-2827
2016,6,8,3,19411,18443,15209,-3234
2016,6,8,4,17626,16585,13273,-3312
2016,6,8,5,15384,15345,12150,-3195
2016,6,8,6,14512,14527,11637,-2890
2016,6,8,7,13960,13967,11071,-2896
2016,6,8,8,13699,13732,11119,-2613
2016,6,8,9,13739,13791,11202,-2589
2016,6,8,10,14294,14262,11537,-2725
2016,6,8,11,15772,15771,12485,-3286
2016,6,8,12,17470,17290,14567,-2723
2016,6,8,13,18520,18169,15624,-2545
2016,6,8,14,19215,18696,16126,-2570
2016,6,8,15,19694,19167,16225,-2942
2016,6,8,16,19931,19317,16522,-2795
2016,6,8,17,19959,19305,16694,-2611
2016,6,8,18,20020,19121,16627,-2494
2016,6,8,19,19974,18725,16170,-2555
2016,6,8,20,19906,18537,16284,-2253
2016,6,8,21,19899,18490,15985,-2505
2016,6,8,22,19846,18388,16235,-2153
2016,6,8,23,19430,18116,15857,-2259
2016,6,9,0,18938,17897,15614,-2283
2016,6,9,1,18709,17905,15426,-2479
2016,6,9,2,18454,17598,15091,-2507
2016,6,9,3,17164,16316,13611,-2705
2016,6,9,4,15678,14922,12183,-2739
2016,6,9,5,13675,13884,11676,-2208
2016,6,9,6,12942,13269,11214,-2055
2016,6,9,7,12514,12869,11261,-1608
2016,6,9,8,12317,12725,11064,-1661
2016,6,9,9,12463,12885,11028,-1857
2016,6,9,10,13050,13438,11223,-2215
2016,6,9,11,14585,14912,12384,-2528
2016,6,9,12,16268,16373,13845,-2528
2016,6,9,13,17268,17154,14558,-2596
2016,6,9,14,17902,17629,14927,-2702
2016,6,9,15,18313,17942,15299,-2643
2016,6,9,16,18545,18111,15542,-2569
2016,6,9,17,18582,18147,15656,-2491
2016,6,9,18,18675,18231,15916,-2315
2016,6,9,19,18695,18335,15791,-2544
2016,6,9,20,18747,18445,15860,-2585
2016,6,9,21,18909,18652,15898,-2754
2016,6,9,22,18925,18686,16067,-2619
2016,6,9,23,18544,18356,15952,-2404
2016,6,10,0,18078,18004,15783,-2221
2016,6,10,1,17894,17888,15591,-2297
2016,6,10,2,17761,17715,14988,-2727
2016,6,10,3,16528,16502,13285,-3217
2016,6,10,4,15025,15072,12512,-2560
2016,6,10,5,13347,14031,11515,-2516
2016,6,10,6,12647,13377,11022,-2355
2016,6,10,7,12241,12958,10486,-2472
2016,6,10,8,12049,12792,10344,-2448
2016,6,10,9,12170,12885,10393,-2492
2016,6,10,10,12732,13442,10772,-2670
2016,6,10,11,14181,14919,12203,-2716
2016,6,10,12,15823,16499,13542,-2957
2016,6,10,13,16877,17387,14253,-3134
2016,6,10,14,17552,17918,15117,-2801
2016,6,10,15,18043,18281,15513,-2768
2016,6,10,16,18330,18482,15793,-2689
2016,6,10,17,18458,18579,15919,-2660
2016,6,10,18,18617,18786,16087,-2699
2016,6,10,19,18745,18953,16250,-2703
2016,6,10,20,18851,19172,16466,-2706
2016,6,10,21,18997,19422,16682,-2740
2016,6,10,22,18875,19449,16928,-2521
2016,6,10,23,18346,19086,16716,-2370
2016,6,11,0,17744,18553,15981,-2572
2016,6,11,1,17479,18210,15514,-2696
2016,6,11,2,17439,18030,15348,-2682
2016,6,11,3,16463,17016,13680,-3336
2016,6,11,4,15176,15666,12457,-3209
2016,6,11,5,14049,14554,10935,-3619
2016,6,11,6,13330,13753,10243,-3510
2016,6,11,7,12857,13225,10183,-3042
2016,6,11,8,12555,12951,10117,-2834
2016,6,11,9,12465,12890,10115,-2775
2016,6,11,10,12473,12912,10412,-2500
2016,6,11,11,12842,13410,10986,-2424
2016,6,11,12,13845,14407,11757,-2650
2016,6,11,13,15055,15565,12998,-2567
2016,6,11,14,16053,16561,13739,-2822
2016,6,11,15,16768,17324,14386,-2938
2016,6,11,16,17247,17919,15064,-2855
2016,6,11,17,17552,18288,15506,-2782
2016,6,11,18,17751,18533,15613,-2920
2016,6,11,19,17905,18734,15881,-2853
2016,6,11,20,18181,19142,16365,-2777
2016,6,11,21,18429,19799,17230,-2569
2016,6,11,22,18554,20419,17811,-2608
2016,6,11,23,18395,20622,18252,-2370
2016,6,12,0,18088,20543,18141,-2402
2016,6,12,1,18010,20447,17952,-2495
2016,6,12,2,18101,20468,17616,-2852
2016,6,12,3,17393,19581,16013,-3568
2016,6,12,4,16246,18325,14606,-3719
2016,6,12,5,15150,17171,13316,-3855
2016,6,12,6,14279,16172,12815,-3357
2016,6,12,7,13684,15473,12494,-2979
2016,6,12,8,13334,15084,12312,-2772
2016,6,12,9,13252,14889,11965,-2924
2016,6,12,10,13185,14698,11787,-2911
2016,6,12,11,13484,14972,12085,-2887
2016,6,12,12,14489,16009,13047,-2962
2016,6,12,13,15807,17314,14315,-2999
2016,6,12,14,16912,18274,14943,-3331
2016,6,12,15,17775,18737,15399,-3338
2016,6,12,16,18371,18998,15845,-3153
2016,6,12,17,18653,19113,15814,-3299
2016,6,12,18,18721,19116,15959,-3157
2016,6,12,19,18746,19095,16195,-2900
2016,6,12,20,18717,19121,16199,-2922
2016,6,12,21,18740,19153,16007,-3146
2016,6,12,22,18723,19092,15696,-3396
2016,6,12,23,18435,18775,15482,-3293
2016,6,13,0,18033,18297,15291,-3006
2016,6,13,1,17905,18043,15366,-2677
2016,6,13,2,17829,17721,14924,-2797
2016,6,13,3,16692,16616,13739,-2877
2016,6,13,4,15284,15372,12833,-2539
2016,6,13,5,14025,14359,11941,-2418
2016,6,13,6,13378,13654,10906,-2748
2016,6,13,7,12976,13295,10603,-2692
2016,6,13,8,12781,13145,10583,-2562
2016,6,13,9,12900,13318,10889,-2429
2016,6,13,10,13460,13943,11321,-2622
2016,6,13,11,14856,15466,12785,-2681
2016,6,13,12,16549,16932,14180,-2752
2016,6,13,13,17664,17873,15035,-2838
2016,6,13,14,18423,18507,15493,-3014
2016,6,13,15,18978,18940,15790,-3150
2016,6,13,16,19325,19189,16000,-3189
2016,6,13,17,19495,19304,16401,-2903
2016,6,13,18,19677,19606,16886,-2720
2016,6,13,19,19792,19755,17144,-2611
2016,6,13,20,19855,20007,17375,-2632
2016,6,13,21,19958,20112,17478,-2634
2016,6,13,22,19965,19900,17325,-2575
2016,6,13,23,19599,19355,16803,-2552
2016,6,14,0,19148,18891,16651,-2240
2016,6,14,1,18957,18761,16617,-2144
2016,6,14,2,18739,18414,15920,-2494
2016,6,14,3,17513,17100,14059,-3041
2016,6,14,4,15982,15655,12526,-3129
2016,6,14,5,14148,14553,11407,-3146
2016,6,14,6,13347,13878,10942,-2936
2016,6,14,7,12922,13424,10446,-2978
2016,6,14,8,12704,13216,10434,-2782
2016,6,14,9,12804,13332,10427,-2905
2016,6,14,10,13375,13866,10867,-2999
2016,6,14,11,14856,15414,12219,-3195
2016,6,14,12,16565,17003,13903,-3100
2016,6,14,13,17687,17925,14817,-3108
2016,6,14,14,18471,18548,15657,-2891
2016,6,14,15,19086,18949,16242,-2707
2016,6,14,16,19524,19242,16718,-2524
2016,6,14,17,19817,19453,16925,-2528
2016,6,14,18,20124,19822,17226,-2596
2016,6,14,19,20351,20151,17428,-2723
2016,6,14,20,20559,20537,17627,-2910
2016,6,14,21,20793,20922,18136,-2786
2016,6,14,22,20796,21073,18200,-2873
2016,6,14,23,20278,20725,18031,-2694
2016,6,15,0,19666,20126,17631,-2495
2016,6,15,1,19365,19718,17322,-2396
2016,6,15,2,19148,19405,16623,-2782
2016,6,15,3,17789,18072,14755,-3317
2016,6,15,4,16137,16463,13066,-3397
2016,6,15,5,14316,15248,12026,-3222
2016,6,15,6,13524,14421,10786,-3635
2016,6,15,7,13033,13943,10658,-3285
2016,6,15,8,12795,13714,10655,-3059
2016,6,15,9,12901,13748,10688,-3060
2016,6,15,10,13455,14279,11253,-3026
2016,6,15,11,14952,15814,12645,-3169
2016,6,15,12,16732,17544,14520,-3024
2016,6,15,13,17963,18666,15694,-2972
2016,6,15,14,18909,19524,16313,-3211
2016,6,15,15,19725,20295,17086,-3209
2016,6,15,16,20416,20869,17610,-3259
2016,6,15,17,20922,21309,17570,-3739
2016,6,15,18,21419,21785,18323,-3462
2016,6,15,19,21815,22238,18829,-3409
2016,6,15,20,22103,22747,19382,-3365
2016,6,15,21,22342,23018,19589,-3429
2016,6,15,22,22245,22895,19390,-3505
2016,6,15,23,21602,22292,18925,-3367
2016,6,16,0,20870,21591,18230,-3361
2016,6,16,1,20522,21277,18020,-3257
2016,6,16,2,20147,20980,17561,-3419
2016,6,16,3,18906,19571,15915,-3656
2016,6,16,4,17169,17954,14439,-3515
2016,6,16,5,15348,16668,12886,-3782
2016,6,16,6,14575,15802,11977,-3825
2016,6,16,7,14074,15273,11435,-3838
2016,6,16,8,13832,15018,11343,-3675
2016,6,16,9,13929,15054,11444,-3610
2016,6,16,10,14524,15706,12049,-3657
2016,6,16,11,15960,17183,13302,-3881
2016,6,16,12,17581,18835,15073,-3762
2016,6,16,13,18723,19867,16357,-3510
2016,6,16,14,19509,20589,17011,-3578
2016,6,16,15,20090,21204,18005,-3199
2016,6,16,16,20548,21575,18638,-2937
2016,6,16,17,20949,21830,18456,-3374
2016,6,16,18,21330,22012,18074,-3938
2016,6,16,19,21581,22036,17681,-4355
2016,6,16,20,21791,22165,18097,-4068
2016,6,16,21,22003,22305,18705,-3600
2016,6,16,22,21807,22273,18760,-3513
2016,6,16,23,21127,21851,18200,-3651
2016,6,17,0,20410,21347,17514,-3833
2016,6,17,1,19997,20961,17386,-3575
2016,6,17,2,19695,20612,17104,-3508
2016,6,17,3,18355,19197,15148,-4049
2016,6,17,4,16745,17551,13510,-4041
2016,6,17,5,15685,16179,12130,-4049
2016,6,17,6,14779,15277,11698,-3579
2016,6,17,7,14216,14737,11519,-3218
2016,6,17,8,13924,14449,11254,-3195
2016,6,17,9,13987,14488,11127,-3361
2016,6,17,10,14525,14931,11736,-3195
2016,6,17,11,15822,16447,12765,-3682
2016,6,17,12,17464,18114,14623,-3491
2016,6,17,13,18682,19394,15757,-3637
2016,6,17,14,19519,20254,16500,-3754
2016,6,17,15,20121,20924,17410,-3514
2016,6,17,16,20527,21426,17896,-3530
2016,6,17,17,20850,21706,17987,-3719
2016,6,17,18,21188,21837,17992,-3845
2016,6,17,19,21453,22024,18563,-3461
2016,6,17,20,21659,22244,18788,-3456
2016,6,17,21,21825,22424,19217,-3207
2016,6,17,22,21530,22262,19057,-3205
2016,6,17,23,20771,21584,18334,-3250
2016,6,18,0,19894,20731,17555,-3176
2016,6,18,1,19333,19965,17166,-2799
2016,6,18,2,19068,19552,16791,-2761
2016,6,18,3,17908,18360,15280,-3080
2016,6,18,4,16428,16894,13337,-3557
2016,6,18,5,15548,15590,11899,-3691
2016,6,18,6,14672,14693,10925,-3768
2016,6,18,7,14104,14133,10575,-3558
2016,6,18,8,13766,13804,10202,-3602
2016,6,18,9,13669,13665,9989,-3676
2016,6,18,10,13670,13552,10164,-3388
2016,6,18,11,13940,14021,10905,-3116
2016,6,18,12,14945,15158,11968,-3190
2016,6,18,13,16256,16514,13102,-3412
2016,6,18,14,17400,17638,14057,-3581
2016,6,18,15,18269,18602,14583,-4019
2016,6,18,16,18785,19376,15204,-4172
2016,6,18,17,19230,19976,15853,-4123
2016,6,18,18,19506,20445,16502,-3943
2016,6,18,19,19798,20895,17070,-3825
2016,6,18,20,20119,21361,17611,-3750
2016,6,18,21,20496,21674,17803,-3871
2016,6,18,22,20588,21731,18115,-3616
2016,6,18,23,20236,21376,17221,-4155
2016,6,19,0,19524,20677,16912,-3765
2016,6,19,1,19119,20139,16269,-3870
2016,6,19,2,19098,19870,16043,-3827
2016,6,19,3,18169,18872,14906,-3966
2016,6,19,4,16894,17597,13471,-4126
2016,6,19,5,15749,16304,13027,-3277
2016,6,19,6,14883,15377,11994,-3383
2016,6,19,7,14289,14761,10952,-3809
2016,6,19,8,13911,14356,10826,-3530
2016,6,19,9,13751,14120,10566,-3554
2016,6,19,10,13660,13872,10774,-3098
2016,6,19,11,13759,14111,11027,-3084
2016,6,19,12,14596,15067,12236,-2831
2016,6,19,13,15871,16414,13042,-3372
2016,6,19,14,17088,17802,14263,-3539
2016,6,19,15,18108,19050,15508,-3542
2016,6,19,16,18848,20078,15808,-4270
2016,6,19,17,19739,20803,16729,-4074
2016,6,19,18,20377,21232,17352,-3880
2016,6,19,19,20935,21519,17776,-3743
2016,6,19,20,21439,21867,18164,-3703
2016,6,19,21,21859,22166,18582,-3584
2016,6,19,22,21971,22170,18568,-3602
2016,6,19,23,21562,21775,18379,-3396
2016,6,20,0,20861,21188,17965,-3223
2016,6,20,1,20548,20902,17747,-3155
2016,6,20,2,20434,20763,17008,-3755
2016,6,20,3,19222,19486,15208,-4278
2016,6,20,4,17681,17992,14219,-3773
2016,6,20,5,16137,16744,13258,-3486
2016,6,20,6,15312,15893,11915,-3978
2016,6,20,7,14813,15327,11655,-3672
2016,6,20,8,14568,15102,11491,-3611
2016,6,20,9,14680,15207,11639,-3568
2016,6,20,10,15296,15749,12184,-3565
2016,6,20,11,16609,17304,14032,-3272
2016,6,20,12,18478,19265,15736,-3529
2016,6,20,13,20027,20693,17218,-3475
2016,6,20,14,21244,21954,18302,-3652
2016,6,20,15,22252,23058,19461,-3597
2016,6,20,16,23135,23938,20508,-3430
2016,6,20,17,23789,24617,21212,-3405
2016,6,20,18,24391,25280,22032,-3248
2016,6,20,19,24833,25793,22282,-3511
2016,6,20,20,25113,26135,23032,-3103
2016,6,20,21,25331,26286,23271,-3015
2016,6,20,22,25126,26070,23067,-3003
2016,6,20,23,24414,25369,22260,-3109
2016,6,21,0,23547,24578,21777,-2801
2016,6,21,1,22934,23987,21723,-2264
2016,6,21,2,22412,23931,22175,-1756
2016,6,21,3,20834,22112,19623,-2489
2016,6,21,4,18944,20126,17259,-2867
2016,6,21,5,17351,18501,15745,-2756
2016,6,21,6,16292,17475,14060,-3415
2016,6,21,7,15646,16749,13347,-3402
2016,6,21,8,15277,16368,12957,-3411
2016,6,21,9,15293,16409,12893,-3516
2016,6,21,10,15853,16926,13568,-3358
2016,6,21,11,17192,18419,15141,-3278
2016,6,21,12,18955,19962,16548,-3414
2016,6,21,13,20333,20917,17289,-3628
2016,6,21,14,21348,21791,18097,-3694
2016,6,21,15,22114,22623,19365,-3258
2016,6,21,16,22580,23333,20310,-3023
2016,6,21,17,23030,23869,21036,-2833
2016,6,21,18,23443,24402,21659,-2743
2016,6,21,19,23759,24862,22362,-2500
2016,6,21,20,23983,25266,22824,-2442
2016,6,21,21,24145,25340,25340,0
2016,6,21,22,23907,25073,25073,0
2016,6,21,23,23095,24447,24447,0
2016,6,22,0,22157,23722,23722,0
2016,6,22,1,21548,23044,23044,0
2016,6,22,2,21152,22382,22382,0
2016,6,22,3,19626,20681,20681,0
2016,6,22,4,17867,18733,18733,0
2016,6,22,5,16988,17233,13466,-3767
2016,6,22,6,16110,16262,12595,-3667
2016,6,22,7,15507,15624,12531,-3093
2016,6,22,8,15194,15244,12377,-2867
2016,6,22,9,15243,15210,12112,-3098
2016,6,22,10,15804,15680,12644,-3036
2016,6,22,11,17071,17125,14125,-3000
2016,6,22,12,18700,18810,16195,-2615
2016,6,22,13,19879,20201,17692,-2509
2016,6,22,14,20650,21234,18599,-2635
2016,6,22,15,21241,22052,19442,-2610
2016,6,22,16,21599,22663,20190,-2473
2016,6,22,17,22011,23095,20588,-2507
2016,6,22,18,22446,23507,21346,-2161
2016,6,22,19,22792,23688,21519,-2169
2016,6,22,20,23093,23875,21745,-2130
2016,6,22,21,23347,24113,21328,-2785
2016,6,22,22,23152,24072,21352,-2720
2016,6,22,23,22347,23504,20572,-2932
2016,6,23,0,21441,22703,20331,-2372
2016,6,23,1,20848,22066,19686,-2380
2016,6,23,2,20479,21716,18668,-3048
2016,6,23,3,19026,20210,17186,-3024
2016,6,23,4,17350,18471,15346,-3125
2016,6,23,5,16420,17075,13779,-3296
2016,6,23,6,15553,16085,12688,-3397
2016,6,23,7,14980,15475,12357,-3118
2016,6,23,8,14685,15129,12036,-3093
2016,6,23,9,14747,15126,11852,-3274
2016,6,23,10,15310,15597,12032,-3565
2016,6,23,11,16675,16985,13776,-3209
2016,6,23,12,18320,18587,14694,-3893
2016,6,23,13,19485,19876,16201,-3675
2016,6,23,14,20295,20818,17113,-3705
2016,6,23,15,20870,21472,18002,-3470
2016,6,23,16,21273,22012,18493,-3519
2016,6,23,17,21535,22379,18635,-3744
2016,6,23,18,21775,22761,19385,-3376
2016,6,23,19,21923,23177,19785,-3392
2016,6,23,20,22076,23427,20645,-2782
2016,6,23,21,22276,23498,20915,-2583
2016,6,23,22,22133,23254,20740,-2514
2016,6,23,23,21490,22745,20321,-2424
2016,6,24,0,20792,22187,19801,-2386
2016,6,24,1,20344,21734,19160,-2574
2016,6,24,2,20083,21456,18656,-2800
2016,6,24,3,18764,20173,16795,-3378
2016,6,24,4,17170,18509,15063,-3446
2016,6,24,5,16021,17124,13380,-3744
2016,6,24,6,15142,16196,12479,-3717
2016,6,24,7,14581,15557,12108,-3449
2016,6,24,8,14293,15220,11700,-3520
2016,6,24,9,14362,15240,11919,-3321
2016,6,24,10,14907,15615,12199,-3416
2016,6,24,11,16163,16938,13448,-3490
2016,6,24,12,17888,18637,14788,-3849
2016,6,24,13,19234,19972,16180,-3792
2016,6,24,14,20197,21021,17374,-3647
2016,6,24,15,20918,21862,18300,-3562
2016,6,24,16,21497,22446,18679,-3767
2016,6,24,17,22031,22851,19237,-3614
2016,6,24,18,22522,23275,19228,-4047
2016,6,24,19,22927,23537,19455,-4082
2016,6,24,20,23223,23766,19744,-4022
2016,6,24,21,23442,23952,19663,-4289
2016,6,24,22,23144,23807,19548,-4259
2016,6,24,23,22271,22962,19142,-3820
2016,6,25,0,21259,22038,18523,-3515
2016,6,25,1,20627,21257,18016,-3241
2016,6,25,2,20354,20879,17555,-3324
2016,6,25,3,19111,19701,15528,-4173
2016,6,25,4,17535,18125,13703,-4422
2016,6,25,5,16416,16765,11871,-4894
2016,6,25,6,15441,15755,10980,-4775
2016,6,25,7,14798,15094,10545,-4549
2016,6,25,8,14397,14698,9957,-4741
2016,6,25,9,14252,14504,9885,-4619
2016,6,25,10,14243,14410,9904,-4506
2016,6,25,11,14527,14861,10648,-4213
2016,6,25,12,15578,16035,11519,-4516
2016,6,25,13,16981,17398,13117,-4281
2016,6,25,14,18259,18627,14389,-4238
2016,6,25,15,19268,19717,15151,-4566
2016,6,25,16,19910,20516,15596,-4920
2016,6,25,17,20477,21076,15982,-5094
2016,6,25,18,20828,21469,16744,-4725
2016,6,25,19,21177,21765,17098,-4667
2016,6,25,20,21528,22083,17685,-4398
2016,6,25,21,21906,22403,18082,-4321
2016,6,25,22,21966,22436,18291,-4145
2016,6,25,23,21544,22069,17842,-4227
2016,6,26,0,20778,21329,16867,-4462
2016,6,26,1,20305,20693,16209,-4484
2016,6,26,2,20258,20420,15995,-4425
2016,6,26,3,19261,19324,14811,-4513
2016,6,26,4,17901,18024,13313,-4711
2016,6,26,5,16469,16793,12401,-4392
2016,6,26,6,15524,15906,11591,-4315
2016,6,26,7,14872,15284,10747,-4537
2016,6,26,8,14450,14884,10426,-4458
2016,6,26,9,14261,14660,10598,-4062
2016,6,26,10,14165,14457,10587,-3870
2016,6,26,11,14243,14751,10814,-3937
2016,6,26,12,15139,15713,11826,-3887
2016,6,26,13,16510,17048,12808,-4240
2016,6,26,14,17854,18408,14077,-4331
2016,6,26,15,18999,19896,15352,-4544
2016,6,26,16,19805,20931,16520,-4411
2016,6,26,17,20713,21736,17603,-4133
2016,6,26,18,21369,22326,18219,-4107
2016,6,26,19,21936,22681,18617,-4064
2016,6,26,20,22440,23050,19333,-3717
2016,6,26,21,22866,23297,19668,-3629
2016,6,26,22,22953,23312,20021,-3291
2016,6,26,23,22499,22926,19755,-3171
2016,6,27,0,21757,22284,19188,-3096
2016,6,27,1,21392,21888,18512,-3376
2016,6,27,2,21225,21711,18031,-3680
2016,6,27,3,19962,20547,16392,-4155
2016,6,27,4,18368,19082,15246,-3836
2016,6,27,5,17087,17834,14134,-3700
2016,6,27,6,16243,16932,13066,-3866
2016,6,27,7,15714,16313,12220,-4093
2016,6,27,8,15440,15956,12224,-3732
2016,6,27,9,15535,15953,12223,-3730
2016,6,27,10,16162,16439,12429,-4010
2016,6,27,11,17497,17776,13581,-4195
2016,6,27,12,19341,19532,15875,-3657
2016,6,27,13,20813,20925,16904,-4021
2016,6,27,14,21935,22096,18019,-4077
2016,6,27,15,22819,23078,19250,-3828
2016,6,27,16,23490,23822,20296,-3526
2016,6,27,17,24140,24347,20671,-3676
2016,6,27,18,24721,24913,21357,-3556
2016,6,27,19,25139,25275,21599,-3676
2016,6,27,20,25406,25506,21825,-3681
2016,6,27,21,25565,25550,21665,-3885
2016,6,27,22,25274,25214,21801,-3413
2016,6,27,23,24486,24391,21273,-3118
2016,6,28,0,23578,23754,20498,-3256
2016,6,28,1,22962,23246,19923,-3323
2016,6,28,2,22454,22693,19142,-3551
2016,6,28,3,20855,21251,17622,-3629
2016,6,28,4,19001,19464,15889,-3575
2016,6,28,5,18020,18059,14065,-3994
2016,6,28,6,17057,17083,13172,-3911
2016,6,28,7,16420,16464,12678,-3786
2016,6,28,8,16067,16164,12186,-3978
2016,6,28,9,16092,16247,12203,-4044
2016,6,28,10,16679,16841,12560,-4281
2016,6,28,11,18098,18251,14140,-4111
2016,6,28,12,19878,19844,16049,-3795
2016,6,28,13,21278,20980,17124,-3856
2016,6,28,14,22375,21872,18040,-3832
2016,6,28,15,23237,22525,19039,-3486
2016,6,28,16,23701,22949,19517,-3432
2016,6,28,17,23987,23188,19536,-3652
2016,6,28,18,24270,23324,19575,-3749
2016,6,28,19,24431,23372,20086,-3286
2016,6,28,20,24551,23500,20512,-2988
2016,6,28,21,24670,23462,20969,-2493
2016,6,28,22,24451,23329,21229,-2100
2016,6,28,23,23785,22705,20357,-2348
2016,6,29,0,23084,22139,19755,-2384
2016,6,29,1,22595,21844,19042,-2802
2016,6,29,2,22241,21390,18355,-3035
2016,6,29,3,20781,19981,17056,-2925
2016,6,29,4,19030,18392,15203,-3189
2016,6,29,5,17603,17078,13266,-3812
2016,6,29,6,16634,16250,12621,-3629
2016,6,29,7,15976,15697,11920,-3777
2016,6,29,8,15616,15450,11540,-3910
2016,6,29,9,15635,15487,11616,-3871
2016,6,29,10,16185,16050,12292,-3758
2016,6,29,11,17554,17337,14063,-3274
2016,6,29,12,19291,19071,15203,-3868
2016,6,29,13,20677,20441,16846,-3595
2016,6,29,14,21775,21458,18213,-3245
2016,6,29,15,22671,22340,18582,-3758
2016,6,29,16,23188,22998,19232,-3766
2016,6,29,17,23470,23508,19516,-3992
2016,6,29,18,23782,24049,20362,-3687
2016,6,29,19,24002,24391,20872,-3519
2016,6,29,20,24225,24596,21104,-3492
2016,6,29,21,24443,24661,21179,-3482
2016,6,29,22,24282,24563,20946,-3617
2016,6,29,23,23595,23950,20143,-3807
2016,6,30,0,22785,23111,19236,-3875
2016,6,30,1,22225,22308,19071,-3237
2016,6,30,2,21887,21935,18937,-2998
2016,6,30,3,20457,20497,17061,-3436
2016,6,30,4,18737,18686,15430,-3256
2016,6,30,5,17012,17194,13909,-3285
2016,6,30,6,16050,16266,12950,-3316
2016,6,30,7,15414,15615,12363,-3252
2016,6,30,8,15078,15245,12189,-3056
2016,6,30,9,15115,15196,12116,-3080
2016,6,30,10,15672,15592,12370,-3222
2016,6,30,11,16942,16895,13669,-3226
2016,6,30,12,18719,18649,15034,-3615
2016,6,30,13,20130,20092,16679,-3413
2016,6,30,14,21216,21126,17711,-3415
2016,6,30,15,22066,22026,18378,-3648
2016,6,30,16,22623,22754,19019,-3735
2016,6,30,17,23097,23275,19594,-3681
2016,6,30,18,23576,23827,20268,-3559
2016,6,30,19,23950,24266,20652,-3614
2016,6,30,20,24268,24567,21104,-3463
2016,6,30,21,24516,24852,21752,-3100
2016,6,30,22,24311,24751,21866,-2885
2016,6,30,23,23558,23975,21369,-2606
2016,7,1,0,22648,23071,20419,-2652
2016,7,1,1,22041,22432,19443,-2989
2016,7,1,2,21649,22129,18813,-3316
2016,7,1,3,20162,20728,17255,-3473
2016,7,1,4,18433,19059,15707,-3352
2016,7,1,5,16980,17654,13956,-3698
2016,7,1,6,16080,16714,13097,-3617
2016,7,1,7,15478,15990,12488,-3502
2016,7,1,8,15142,15561,11955,-3606
2016,7,1,9,15152,15501,12212,-3289
2016,7,1,10,15623,15938,12501,-3437
2016,7,1,11,16733,17217,13612,-3605
2016,7,1,12,18443,18937,15284,-3653
2016,7,1,13,19958,20407,16553,-3854
2016,7,1,14,21171,21614,17381,-4233
2016,7,1,15,22133,22492,18570,-3922
2016,7,1,16,22707,23058,19237,-3821
2016,7,1,17,23015,23302,19542,-3760
2016,7,1,18,23354,23485,19897,-3588
2016,7,1,19,23586,23596,20613,-2983
2016,7,1,20,23703,23460,20632,-2828
2016,7,1,21,23812,23211,20494,-2717
2016,7,1,22,23543,22799,20169,-2630
2016,7,1,23,22842,21986,19650,-2336
2016,7,2,0,22086,21366,18827,-2539
2016,7,2,1,21618,20914,18306,-2608
2016,7,2,2,21427,20575,17729,-2846
2016,7,2,3,20338,19408,16439,-2969
2016,7,2,4,18857,18069,15032,-3037
2016,7,2,5,17265,16872,13197,-3675
2016,7,2,6,16299,15984,12414,-3570
2016,7,2,7,15665,15306,11933,-3373
2016,7,2,8,15239,14863,11881,-2982
2016,7,2,9,15050,14566,11543,-3023
2016,7,2,10,14943,14341,11428,-2913
2016,7,2,11,14971,14597,11983,-2614
2016,7,2,12,15832,15566,12416,-3150
2016,7,2,13,17153,16648,13075,-3573
2016,7,2,14,18383,17480,14212,-3268
2016,7,2,15,19367,18062,14949,-3113
2016,7,2,16,19993,18406,15638,-2768
2016,7,2,17,20125,18570,15965,-2605
2016,7,2,18,20116,18663,16192,-2471
2016,7,2,19,20130,18727,16308,-2419
2016,7,2,20,20212,18852,16192,-2660
2016,7,2,21,20470,18969,16135,-2834
2016,7,2,22,20558,18979,16456,-2523
2016,7,2,23,20381,18863,16221,-2642
2016,7,3,0,19866,18480,15750,-2730
2016,7,3,1,19521,18167,15528,-2639
2016,7,3,2,19583,18173,15471,-2702
2016,7,3,3,18895,17454,14326,-3128
2016,7,3,4,17895,16470,12976,-3494
2016,7,3,5,16293,15386,11401,-3985
2016,7,3,6,15455,14596,10942,-3654
2016,7,3,7,14859,14069,10754,-3315
2016,7,3,8,14472,13742,10578,-3164
2016,7,3,9,14273,13583,10476,-3107
2016,7,3,10,14057,13396,10732,-2664
2016,7,3,11,13797,13557,10539,-3018
2016,7,3,12,14377,14422,11168,-3254
2016,7,3,13,15555,15573,11772,-3801
2016,7,3,14,16724,16574,12893,-3681
2016,7,3,15,17696,17403,13862,-3541
2016,7,3,16,18369,18086,14746,-3340
2016,7,3,17,18929,18547,15432,-3115
2016,7,3,18,19311,18846,15879,-2967
2016,7,3,19,19648,18951,15911,-3040
2016,7,3,20,19949,19021,16076,-2945
2016,7,3,21,20260,19164,16499,-2665
2016,7,3,22,20346,19147,16817,-2330
2016,7,3,23,20111,18909,16641,-2268
2016,7,4,0,19642,18520,15716,-2804
2016,7,4,1,19449,18357,15703,-2654
2016,7,4,2,19466,18403,15888,-2515
2016,7,4,3,18650,17791,15363,-2428
2016,7,4,4,17497,16855,14044,-2811
2016,7,4,5,15042,15808,12401,-3407
2016,7,4,6,14248,14969,11674,-3295
2016,7,4,7,13724,14419,11465,-2954
2016,7,4,8,13441,14050,11140,-2910
2016,7,4,9,13431,13885,10905,-2980
2016,7,4,10,13559,13785,11337,-2448
2016,7,4,11,13722,14119,11686,-2433
2016,7,4,12,14476,15057,12346,-2711
2016,7,4,13,15629,16301,13150,-3151
2016,7,4,14,16717,17655,14238,-3417
2016,7,4,15,17689,18759,14931,-3828
2016,7,4,16,18330,19562,15799,-3763
2016,7,4,17,19168,20125,16377,-3748
2016,7,4,18,19727,20553,16678,-3875
2016,7,4,19,20135,20863,16858,-4005
2016,7,4,20,20459,21107,17094,-4013
2016,7,4,21,20632,21282,17661,-3621
2016,7,4,22,20537,21293,18044,-3249
2016,7,4,23,19960,20859,17327,-3532
2016,7,5,0,19192,20474,16987,-3487
2016,7,5,1,18667,20258,17179,-3079
2016,7,5,2,18391,19934,16795,-3139
2016,7,5,3,17568,19216,15848,-3368
2016,7,5,4,16654,18209,14181,-4028
2016,7,5,5,16135,17120,12513,-4607
2016,7,5,6,15519,16397,11792,-4605
2016,7,5,7,15081,15965,11545,-4420
2016,7,5,8,14866,15782,11493,-4289
2016,7,5,9,14961,15897,11616,-4281
2016,7,5,10,15526,16559,11964,-4595
2016,7,5,11,16714,17786,13337,-4449
2016,7,5,12,18274,19458,15389,-4069
2016,7,5,13,19543,20938,16614,-4324
2016,7,5,14,20514,22179,17721,-4458
2016,7,5,15,21298,23284,18440,-4844
2016,7,5,16,22133,24064,19459,-4605
2016,7,5,17,22895,24663,19684,-4979
2016,7,5,18,23598,25345,20096,-5249
2016,7,5,19,24107,26047,20843,-5204
2016,7,5,20,24421,26686,21429,-5257
2016,7,5,21,24707,27270,22033,-5237
2016,7,5,22,24496,27559,22521,-5038
2016,7,5,23,23780,27239,22466,-4773
2016,7,6,0,22882,26456,21572,-4884
2016,7,6,1,22298,25643,20664,-4979
2016,7,6,2,21869,25230,20096,-5134
2016,7,6,3,20457,23556,18202,-5354
2016,7,6,4,18858,21582,16062,-5520
2016,7,6,5,18307,19962,14911,-5051
2016,7,6,6,17417,18789,13554,-5235
2016,7,6,7,16792,17963,12952,-5011
2016,7,6,8,16441,17447,12296,-5151
2016,7,6,9,16444,17337,12343,-4994
2016,7,6,10,16951,17743,12569,-5174
2016,7,6,11,18032,19117,14373,-4744
2016,7,6,12,19797,21208,16309,-4899
2016,7,6,13,21376,23088,18155,-4933
2016,7,6,14,22660,24706,19405,-5301
2016,7,6,15,23764,26142,20694,-5448
2016,7,6,16,24815,27104,21914,-5190
2016,7,6,17,25794,27832,22640,-5192
2016,7,6,18,26694,28421,23348,-5073
2016,7,6,19,27361,28949,23957,-4992
2016,7,6,20,27800,29348,24601,-4747
2016,7,6,21,28070,29656,24686,-4970
2016,7,6,22,27783,29641,24903,-4738
2016,7,6,23,26839,29016,24549,-4467
2016,7,7,0,25705,28156,23652,-4504
2016,7,7,1,24936,27340,23110,-4230
2016,7,7,2,24338,26888,22064,-4824
2016,7,7,3,22681,25136,19954,-5182
2016,7,7,4,20797,23056,17602,-5454
2016,7,7,5,20215,21355,15988,-5367
2016,7,7,6,19156,20191,14799,-5392
2016,7,7,7,18415,19399,13939,-5460
2016,7,7,8,17984,18920,13282,-5638
2016,7,7,9,17934,18870,13209,-5661
2016,7,7,10,18409,19307,13690,-5617
2016,7,7,11,19542,20657,15283,-5374
2016,7,7,12,21404,22768,17276,-5492
2016,7,7,13,23143,24526,19205,-5321
2016,7,7,14,24672,26100,21078,-5022
2016,7,7,15,25978,27521,22285,-5236
2016,7,7,16,26978,28560,23105,-5455
2016,7,7,17,27790,29095,23625,-5470
2016,7,7,18,28524,29332,24567,-4765
2016,7,7,19,29029,29340,24704,-4636
2016,7,7,20,29355,29181,24419,-4762
2016,7,7,21,29542,29032,24786,-4246
2016,7,7,22,29255,28796,24881,-3915
2016,7,7,23,28361,27905,24323,-3582
2016,7,8,0,27301,27082,23785,-3297
2016,7,8,1,26540,26425,23255,-3170
2016,7,8,2,25960,26001,22394,-3607
2016,7,8,3,24301,24454,20003,-4451
2016,7,8,4,22334,22555,17612,-4943
2016,7,8,5,20517,20905,15501,-5404
2016,7,8,6,19326,19763,14510,-5253
2016,7,8,7,18513,18976,14065,-4911
2016,7,8,8,18018,18479,13769,-4710
2016,7,8,9,17918,18433,13771,-4662
2016,7,8,10,18340,18917,14396,-4521
2016,7,8,11,19419,20182,15811,-4371
2016,7,8,12,21263,22016,17314,-4702
2016,7,8,13,23061,23571,19062,-4509
2016,7,8,14,24640,24881,20217,-4664
2016,7,8,15,25976,25969,21388,-4581
2016,7,8,16,26923,26675,22114,-4561
2016,7,8,17,27544,27014,22818,-4196
2016,7,8,18,28117,27293,23081,-4212
2016,7,8,19,28506,27500,23399,-4101
2016,7,8,20,28739,27493,23383,-4110
2016,7,8,21,28842,27136,23459,-3677
2016,7,8,22,28497,26329,22828,-3501
2016,7,8,23,27590,25232,22302,-2930
2016,7,9,0,26512,24292,21618,-2674
2016,7,9,1,25758,23586,21133,-2453
2016,7,9,2,25311,23002,19807,-3195
2016,7,9,3,23917,21684,18461,-3223
2016,7,9,4,22105,20022,16439,-3583
2016,7,9,5,19066,18653,15383,-3270
2016,7,9,6,17972,17704,14392,-3312
2016,7,9,7,17274,16961,13604,-3357
2016,7,9,8,16790,16461,12896,-3565
2016,7,9,9,16538,16216,13049,-3167
2016,7,9,10,16419,16122,13352,-2770
2016,7,9,11,16576,16369,14176,-2193
2016,7,9,12,17395,17169,14427,-2742
2016,7,9,13,18667,18188,15182,-3006
2016,7,9,14,19992,19124,16428,-2696
2016,7,9,15,21069,19851,16758,-3093
2016,7,9,16,21759,20309,17263,-3046
2016,7,9,17,21744,20430,17624,-2806
2016,7,9,18,21543,20354,18212,-2142
2016,7,9,19,21333,20230,18523,-1707
2016,7,9,20,21226,19991,18416,-1575
2016,7,9,21,21352,19868,18108,-1760
2016,7,9,22,21402,19793,18061,-1732
2016,7,9,23,21302,19618,17875,-1743
2016,7,10,0,20918,19380,17307,-2073
2016,7,10,1,20579,19350,17375,-1975
2016,7,10,2,20592,19200,16987,-2213
2016,7,10,3,19942,18408,16360,-2048
2016,7,10,4,19013,17328,14993,-2335
2016,7,10,5,17359,16441,14370,-2071
2016,7,10,6,16475,15749,13612,-2137
2016,7,10,7,15818,15206,13028,-2178
2016,7,10,8,15371,14891,12764,-2127
2016,7,10,9,15130,14760,12749,-2011
2016,7,10,10,14975,14709,12440,-2269
2016,7,10,11,14944,14818,12623,-2195
2016,7,10,12,15649,15484,12986,-2498
2016,7,10,13,16945,16621,13760,-2861
2016,7,10,14,18337,17801,14916,-2885
2016,7,10,15,19565,18779,15582,-3197
2016,7,10,16,20484,19589,16313,-3276
2016,7,10,17,20819,20042,16569,-3473
2016,7,10,18,20960,20401,16949,-3452
2016,7,10,19,21034,20608,16877,-3731
2016,7,10,20,21104,20694,17157,-3537
2016,7,10,21,21273,20852,17460,-3392
2016,7,10,22,21350,21003,17557,-3446
2016,7,10,23,21215,20817,17597,-3220
2016,7,11,0,20867,20430,17263,-3167
2016,7,11,1,20646,20200,17028,-3172
2016,7,11,2,20667,20181,16769,-3412
2016,7,11,3,19842,19073,15319,-3754
2016,7,11,4,18654,17689,14178,-3511
2016,7,11,5,16254,16484,13187,-3297
2016,7,11,6,15431,15654,12758,-2896
2016,7,11,7,14904,15126,12515,-2611
2016,7,11,8,14621,14821,12068,-2753
2016,7,11,9,14675,14905,11917,-2988
2016,7,11,10,15205,15447,12243,-3204
2016,7,11,11,16242,16700,13133,-3567
2016,7,11,12,17889,18368,15286,-3082
2016,7,11,13,19366,19755,16930,-2825
2016,7,11,14,20576,20772,17733,-3039
2016,7,11,15,21569,21502,18445,-3057
2016,7,11,16,22279,22052,18945,-3107
2016,7,11,17,22656,22477,19179,-3298
2016,7,11,18,23051,22998,19540,-3458
2016,7,11,19,23366,23374,19810,-3564
2016,7,11,20,23600,23677,20239,-3438
2016,7,11,21,23839,23904,20666,-3238
2016,7,11,22,23771,23975,21144,-2831
2016,7,11,23,23189,23412,20777,-2635
2016,7,12,0,22421,22663,20084,-2579
2016,7,12,1,21854,22056,19431,-2625
2016,7,12,2,21492,21626,18775,-2851
2016,7,12,3,20192,20148,17078,-3070
2016,7,12,4,18620,18412,15597,-2815
2016,7,12,5,16749,17064,14274,-2790
2016,7,12,6,15857,16192,13648,-2544
2016,7,12,7,15280,15564,13255,-2309
2016,7,12,8,14963,15252,13234,-2018
2016,7,12,9,14991,15325,13178,-2147
2016,7,12,10,15530,15873,13200,-2673
2016,7,12,11,16642,17201,13767,-3434
2016,7,12,12,18348,18960,15832,-3128
2016,7,12,13,19861,20366,17546,-2820
2016,7,12,14,21134,21513,18349,-3164
2016,7,12,15,22186,22569,19442,-3127
2016,7,12,16,23101,23412,20192,-3220
2016,7,12,17,23735,24177,21067,-3110
2016,7,12,18,24369,24882,21589,-3293
2016,7,12,19,24860,25452,21909,-3543
2016,7,12,20,25154,25918,22148,-3770
2016,7,12,21,25378,26259,22898,-3361
2016,7,12,22,25224,26223,23132,-3091
2016,7,12,23,24545,25533,22790,-2743
2016,7,13,0,23676,24663,22137,-2526
2016,7,13,1,23100,24015,21639,-2376
2016,7,13,2,22649,23665,21348,-2317
2016,7,13,3,21186,22214,19548,-2666
2016,7,13,4,19470,20442,17144,-3298
2016,7,13,5,17859,18935,15503,-3432
2016,7,13,6,16921,17934,14770,-3164
2016,7,13,7,16299,17275,14316,-2959
2016,7,13,8,15947,16893,13905,-2988
2016,7,13,9,15950,16914,13996,-2918
2016,7,13,10,16477,17500,14421,-3079
2016,7,13,11,17625,18971,15516,-3455
2016,7,13,12,19460,21020,17666,-3354
2016,7,13,13,21177,22604,19504,-3100
2016,7,13,14,22700,23840,20179,-3661
2016,7,13,15,23977,25083,21148,-3935
2016,7,13,16,24925,26161,22592,-3569
2016,7,13,17,25561,26884,23475,-3409
2016,7,13,18,26192,27527,24446,-3081
2016,7,13,19,26671,27884,24962,-2922
2016,7,13,20,26967,27986,24903,-3083
2016,7,13,21,27201,27721,24236,-3485
2016,7,13,22,27003,27455,24609,-2846
2016,7,13,23,26259,26654,24012,-2642
2016,7,14,0,25336,25816,23590,-2226
2016,7,14,1,24693,25212,22872,-2340
2016,7,14,2,24198,24781,22064,-2717
2016,7,14,3,22651,23231,19625,-3606
2016,7,14,4,20811,21509,17506,-4003
2016,7,14,5,19553,20067,16471,-3596
2016,7,14,6,18498,19161,16377,-2784
2016,7,14,7,17772,18507,15062,-3445
2016,7,14,8,17347,18200,14669,-3531
2016,7,14,9,17305,18285,14721,-3564
2016,7,14,10,17814,18976,15104,-3872
2016,7,14,11,19081,20455,16129,-4326
2016,7,14,12,20956,22430,18454,-3976
2016,7,14,13,22760,23853,19944,-3909
2016,7,14,14,24434,24956,21170,-3786
2016,7,14,15,25841,26014,22124,-3890
2016,7,14,16,26793,26805,22985,-3820
2016,7,14,17,27335,27317,23710,-3607
2016,7,14,18,27834,27974,23892,-4082
2016,7,14,19,28150,28610,24565,-4045
2016,7,14,20,28372,29081,24963,-4118
2016,7,14,21,28552,28381,25054,-3327
2016,7,14,22,28313,28052,24972,-3080
2016,7,14,23,27553,27912,24649,-3263
2016,7,15,0,26661,27272,23688,-3584
2016,7,15,1,25997,26609,22841,-3768
2016,7,15,2,25534,26186,22284,-3902
2016,7,15,3,24017,24609,20034,-4575
2016,7,15,4,22163,22746,17869,-4877
2016,7,15,5,20477,21182,16576,-4606
2016,7,15,6,19319,20030,15918,-4112
2016,7,15,7,18514,19261,15196,-4065
2016,7,15,8,18019,18793,14398,-4395
2016,7,15,9,17920,18749,14536,-4213
2016,7,15,10,18375,19232,15183,-4049
2016,7,15,11,19439,20542,16189,-4353
2016,7,15,12,21236,22641,17970,-4671
2016,7,15,13,22991,24443,19503,-4940
2016,7,15,14,24522,26023,21304,-4719
2016,7,15,15,25790,27344,22881,-4463
2016,7,15,16,26547,28148,23821,-4327
2016,7,15,17,27071,28513,24323,-4190
2016,7,15,18,27549,28932,24742,-4190
2016,7,15,19,27881,29195,25274,-3921
2016,7,15,20,28094,29204,25317,-3887
2016,7,15,21,28212,29142,25388,-3754
2016,7,15,22,27881,28940,25210,-3730
2016,7,15,23,26966,28084,24351,-3733
2016,7,16,0,25870,26916,23059,-3857
2016,7,16,1,25065,26014,22440,-3574
2016,7,16,2,24671,25514,21572,-3942
2016,7,16,3,23326,24075,19653,-4422
2016,7,16,4,21576,22333,17559,-4774
2016,7,16,5,20149,20783,15646,-5137
2016,7,16,6,19050,19518,14412,-5106
2016,7,16,7,18262,18617,13459,-5158
2016,7,16,8,17726,17989,13235,-4754
2016,7,16,9,17454,17607,13105,-4502
2016,7,16,10,17366,17442,13060,-4382
2016,7,16,11,17400,17661,13489,-4172
2016,7,16,12,18323,18916,14486,-4430
2016,7,16,13,19768,20524,15462,-5062
2016,7,16,14,21198,21987,16785,-5202
2016,7,16,15,22387,23260,18340,-4920
2016,7,16,16,23160,24149,19205,-4944
2016,7,16,17,23611,24716,19919,-4797
2016,7,16,18,23859,25060,20245,-4815
2016,7,16,19,24049,25299,20289,-5010
2016,7,16,20,24224,25350,20326,-5024
2016,7,16,21,24456,24891,20113,-4778
2016,7,16,22,24459,24362,19754,-4608
2016,7,16,23,24070,23757,19205,-4552
2016,7,17,0,23328,23036,18524,-4512
2016,7,17,1,22764,22724,18387,-4337
2016,7,17,2,22643,22535,18237,-4298
2016,7,17,3,21678,21532,16984,-4548
2016,7,17,4,20337,20267,15518,-4749
2016,7,17,5,19414,19023,14287,-4736
2016,7,17,6,18420,17996,13638,-4358
2016,7,17,7,17694,17297,13013,-4284
2016,7,17,8,17198,16842,12407,-4435
2016,7,17,9,16923,16600,12415,-4185
2016,7,17,10,16763,16501,12443,-4058
2016,7,17,11,16703,16585,12752,-3833
2016,7,17,12,17464,17423,13379,-4044
2016,7,17,13,18885,18762,14305,-4457
2016,7,17,14,20456,20322,15941,-4381
2016,7,17,15,21863,21796,17050,-4746
2016,7,17,16,22854,23051,18344,-4707
2016,7,17,17,23502,23980,19249,-4731
2016,7,17,18,23905,24518,19652,-4866
2016,7,17,19,24209,24981,20048,-4933
2016,7,17,20,24509,25361,20406,-4955
2016,7,17,21,24874,25741,20875,-4866
2016,7,17,22,25028,25998,21060,-4938
2016,7,17,23,24778,25766,20519,-5247
2016,7,18,0,24110,25196,20053,-5143
2016,7,18,1,23650,24795,19652,-5143
2016,7,18,2,23492,24573,19449,-5124
2016,7,18,3,22402,23221,18024,-5197
2016,7,18,4,21024,21526,16395,-5131
2016,7,18,5,19752,20176,15160,-5016
2016,7,18,6,18787,19217,14721,-4496
2016,7,18,7,18131,18649,14499,-4150
2016,7,18,8,17751,18359,14600,-3759
2016,7,18,9,17744,18429,14534,-3895
2016,7,18,10,18307,19012,14703,-4309
2016,7,18,11,19402,20312,15588,-4724
2016,7,18,12,21225,22262,17451,-4811
2016,7,18,13,22972,24038,19705,-4333
2016,7,18,14,24503,25679,21390,-4289
2016,7,18,15,25815,27117,22588,-4529
2016,7,18,16,26832,28159,24123,-4036
2016,7,18,17,27653,28983,25334,-3649
2016,7,18,18,28379,29485,25996,-3489
2016,7,18,19,28895,29783,26373,-3410
2016,7,18,20,29202,29538,26809,-2729
2016,7,18,21,29370,29119,26399,-2720
2016,7,18,22,29085,28141,25632,-2509
2016,7,18,23,28245,27358,25001,-2357
2016,7,19,0,27253,26660,23831,-2829
2016,7,19,1,26501,26026,22838,-3188
2016,7,19,2,25918,25421,21518,-3903
2016,7,19,3,24257,23692,19308,-4384
2016,7,19,4,22262,21723,17157,-4566
2016,7,19,5,20102,20148,15487,-4661
2016,7,19,6,18916,19049,14581,-4468
2016,7,19,7,18148,18282,13849,-4433
2016,7,19,8,17672,17801,13303,-4498
2016,7,19,9,17577,17732,13338,-4394
2016,7,19,10,18045,18116,13732,-4384
2016,7,19,11,18963,19124,14842,-4282
2016,7,19,12,20517,20745,16044,-4701
2016,7,19,13,21893,22052,18009,-4043
2016,7,19,14,22987,22945,18481,-4464
2016,7,19,15,23792,23707,19870,-3837
2016,7,19,16,24196,24238,21099,-3139
2016,7,19,17,24526,24568,21595,-2973
2016,7,19,18,24884,24861,21625,-3236
2016,7,19,19,25159,25094,21910,-3184
2016,7,19,20,25358,25218,22301,-2917
2016,7,19,21,25530,25312,22565,-2747
2016,7,19,22,25384,25227,22386,-2841
2016,7,19,23,24669,24570,21867,-2703
2016,7,20,0,23727,23704,20967,-2737
2016,7,20,1,23036,23043,20225,-2818
2016,7,20,2,22607,22563,19014,-3549
2016,7,20,3,21156,21069,16968,-4101
2016,7,20,4,19420,19357,15254,-4103
2016,7,20,5,17663,17890,13954,-3936
2016,7,20,6,16657,16894,12992,-3902
2016,7,20,7,15988,16262,12379,-3883
2016,7,20,8,15609,15835,12061,-3774
2016,7,20,9,15587,15812,12033,-3779
2016,7,20,10,16086,16292,12400,-3892
2016,7,20,11,17035,17439,13669,-3770
2016,7,20,12,18602,19127,15117,-4010
2016,7,20,13,19951,20502,16743,-3759
2016,7,20,14,21020,21502,17537,-3965
2016,7,20,15,21832,22326,18142,-4184
2016,7,20,16,22411,22924,18575,-4349
2016,7,20,17,22872,23380,20065,-3315
2016,7,20,18,23377,23971,19794,-4177
2016,7,20,19,23821,24512,19851,-4661
2016,7,20,20,24179,24954,21275,-3679
2016,7,20,21,24482,25352,21585,-3767
2016,7,20,22,24363,25400,21896,-3504
2016,7,20,23,23592,24764,21584,-3180
2016,7,21,0,22598,23856,20631,-3225
2016,7,21,1,21922,23233,19956,-3277
2016,7,21,2,21512,22755,19216,-3539
2016,7,21,3,20104,21274,17656,-3618
2016,7,21,4,18478,19593,16428,-3165
2016,7,21,5,17210,18136,14760,-3376
2016,7,21,6,16360,17126,13925,-3201
2016,7,21,7,15774,16478,13388,-3090
2016,7,21,8,15463,16076,12902,-3174
2016,7,21,9,15500,16136,13169,-2967
2016,7,21,10,16088,16715,13710,-3005
2016,7,21,11,17147,18010,14716,-3294
2016,7,21,12,18846,19869,16598,-3271
2016,7,21,13,20372,21433,18126,-3307
2016,7,21,14,21634,22707,19381,-3326
2016,7,21,15,22646,23973,20464,-3509
2016,7,21,16,23617,24934,21252,-3682
2016,7,21,17,24460,25725,22048,-3677
2016,7,21,18,25245,26579,23032,-3547
2016,7,21,19,25879,27349,23611,-3738
2016,7,21,20,26287,27923,24046,-3877
2016,7,21,21,26549,28319,24410,-3909
2016,7,21,22,26327,28254,24446,-3808
2016,7,21,23,25469,27461,23785,-3676
2016,7,22,0,24432,26466,23201,-3265
2016,7,22,1,23784,25876,22234,-3642
2016,7,22,2,23299,25419,21594,-3825
2016,7,22,3,21764,23870,20121,-3749
2016,7,22,4,19997,22155,18453,-3702
2016,7,22,5,18564,20657,17495,-3162
2016,7,22,6,17544,19479,16173,-3306
2016,7,22,7,16866,18729,15164,-3565
2016,7,22,8,16474,18341,14663,-3678
2016,7,22,9,16450,18380,14862,-3518
2016,7,22,10,17022,18974,15364,-3610
2016,7,22,11,18189,20286,16247,-4039
2016,7,22,12,19986,22101,17895,-4206
2016,7,22,13,21680,23738,19635,-4103
2016,7,22,14,23156,25202,21085,-4117
2016,7,22,15,24359,26608,22735,-3873
2016,7,22,16,25491,27833,24023,-3810
2016,7,22,17,26570,28849,25288,-3561
2016,7,22,18,27481,29802,26258,-3544
2016,7,22,19,28190,30453,27083,-3370
2016,7,22,20,28603,30923,27510,-3413
2016,7,22,21,28792,31187,27809,-3378
2016,7,22,22,28334,31064,27796,-3268
2016,7,22,23,27153,30295,27165,-3130
2016,7,23,0,25827,29307,26148,-3159
2016,7,23,1,24947,28520,25860,-2660
2016,7,23,2,24413,27911,24619,-3292
2016,7,23,3,22906,26347,22363,-3984
2016,7,23,4,21124,24444,19865,-4579
2016,7,23,5,20414,22736,18437,-4299
2016,7,23,6,19315,21366,16952,-4414
2016,7,23,7,18523,20363,16047,-4316
2016,7,23,8,17979,19620,15156,-4464
2016,7,23,9,17700,19173,14690,-4483
2016,7,23,10,17644,18994,15062,-3932
2016,7,23,11,17651,19244,15450,-3794
2016,7,23,12,18617,20592,16503,-4089
2016,7,23,13,20184,22394,17731,-4663
2016,7,23,14,21751,24080,19810,-4270
2016,7,23,15,23051,25481,22046,-3435
2016,7,23,16,23922,26484,23691,-2793
2016,7,23,17,24789,27153,24752,-2401
2016,7,23,18,25396,27509,25018,-2491
2016,7,23,19,25921,27817,25104,-2713
2016,7,23,20,26337,28077,25637,-2440
2016,7,23,21,26632,28230,26118,-2112
2016,7,23,22,26592,28264,26254,-2010
2016,7,23,23,25937,27820,25737,-2083
2016,7,24,0,24900,26966,24351,-2615
2016,7,24,1,24197,26249,23184,-3065
2016,7,24,2,23959,25709,22174,-3535
2016,7,24,3,22790,24234,20155,-4079
2016,7,24,4,21244,22532,18371,-4161
2016,7,24,5,20031,20978,15971,-5007
2016,7,24,6,18963,19720,14611,-5109
2016,7,24,7,18178,18718,13589,-5129
2016,7,24,8,17635,18023,12933,-5090
2016,7,24,9,17329,17571,12665,-4906
2016,7,24,10,17188,17258,12689,-4569
2016,7,24,11,16966,17292,13138,-4154
2016,7,24,12,17675,18282,14145,-4137
2016,7,24,13,19043,19822,15346,-4476
2016,7,24,14,20491,21358,16720,-4638
2016,7,24,15,21742,22941,18667,-4274
2016,7,24,16,22638,24262,19758,-4504
2016,7,24,17,23586,25138,20852,-4286
2016,7,24,18,24305,25782,21831,-3951
2016,7,24,19,24916,26240,22346,-3894
2016,7,24,20,25435,26543,22731,-3812
2016,7,24,21,25819,26771,23525,-3246
2016,7,24,22,25887,26776,23850,-2926
2016,7,24,23,25345,26430,23811,-2619
2016,7,25,0,24473,25778,22761,-3017
2016,7,25,1,23964,25637,22022,-3615
2016,7,25,2,23670,25432,21024,-4408
2016,7,25,3,22394,24087,19371,-4716
2016,7,25,4,20880,22403,17772,-4631
2016,7,25,5,20743,21023,16554,-4469
2016,7,25,6,19865,20005,15504,-4501
2016,7,25,7,19227,19264,14476,-4788
2016,7,25,8,18867,18887,14149,-4738
2016,7,25,9,18877,18975,14369,-4606
2016,7,25,10,19498,19661,14946,-4715
2016,7,25,11,20651,20920,16380,-4540
2016,7,25,12,22470,22655,18500,-4155
2016,7,25,13,24211,24149,19936,-4213
2016,7,25,14,25767,25370,21839,-3531
2016,7,25,15,27070,26495,23445,-3050
2016,7,25,16,28264,27372,24667,-2705
2016,7,25,17,29354,28179,25429,-2750
2016,7,25,18,30243,29001,26426,-2575
2016,7,25,19,30865,29120,27281,-1839
2016,7,25,20,31239,29198,27527,-1671
2016,7,25,21,31401,29094,27603,-1491
2016,7,25,22,31038,28435,26425,-2010
2016,7,25,23,30040,27692,25648,-2044
2016,7,26,0,28903,26979,25176,-1803
2016,7,26,1,28057,26287,23988,-2299
2016,7,26,2,27372,25593,23279,-2314
2016,7,26,3,25576,24022,20811,-3211
2016,7,26,4,23472,22271,18757,-3514
2016,7,26,5,21728,20710,16739,-3971
2016,7,26,6,20576,19579,15806,-3773
2016,7,26,7,19776,18844,15247,-3597
2016,7,26,8,19283,18403,14617,-3786
2016,7,26,9,19185,18350,14495,-3855
2016,7,26,10,19714,18844,14880,-3964
2016,7,26,11,20710,20076,15917,-4159
2016,7,26,12,22441,21990,17722,-4268
2016,7,26,13,24122,23545,19446,-4099
2016,7,26,14,25574,24967,21443,-3524
2016,7,26,15,26768,26112,22896,-3216
2016,7,26,16,27638,26930,23651,-3279
2016,7,26,17,28327,27589,24313,-3276
2016,7,26,18,28922,28172,24979,-3193
2016,7,26,19,29347,28650,25604,-3046
2016,7,26,20,29634,29112,25976,-3136
2016,7,26,21,29826,29420,26687,-2733
2016,7,26,22,29591,29491,26653,-2838
2016,7,26,23,28707,28903,26199,-2704
2016,7,27,0,27585,27862,25220,-2642
2016,7,27,1,26710,27020,24257,-2763
2016,7,27,2,26125,26244,23005,-3239
2016,7,27,3,24434,24436,20762,-3674
2016,7,27,4,22446,22437,18592,-3845
2016,7,27,5,20302,20685,16991,-3694
2016,7,27,6,19117,19506,15828,-3678
2016,7,27,7,18305,18608,14992,-3616
2016,7,27,8,17817,18049,14265,-3784
2016,7,27,9,17725,17978,14388,-3590
2016,7,27,10,18277,18473,14705,-3768
2016,7,27,11,19336,19646,15658,-3988
2016,7,27,12,21080,21487,17565,-3922
2016,7,27,13,22722,23125,19669,-3456
2016,7,27,14,24150,24570,21162,-3408
2016,7,27,15,25313,25888,23079,-2809
2016,7,27,16,26198,26922,24208,-2714
2016,7,27,17,26955,27689,25078,-2611
2016,7,27,18,27683,28512,25733,-2779
2016,7,27,19,28258,29133,26299,-2834
2016,7,27,20,28650,29673,26773,-2900
2016,7,27,21,28901,30021,27286,-2735
2016,7,27,22,28691,30024,27505,-2519
2016,7,27,23,27752,29327,26654,-2673
2016,7,28,0,26568,28280,25771,-2509
2016,7,28,1,25723,27541,25042,-2499
2016,7,28,2,25119,26848,23739,-3109
2016,7,28,3,23419,25038,21340,-3698
2016,7,28,4,21486,23076,18915,-4161
2016,7,28,5,20456,21440,16878,-4562
2016,7,28,6,19382,20237,15930,-4307
2016,7,28,7,18618,19405,15175,-4230
2016,7,28,8,18175,18921,14544,-4377
2016,7,28,9,18121,18886,14487,-4399
2016,7,28,10,18713,19426,14744,-4682
2016,7,28,11,19834,20627,15660,-4967
2016,7,28,12,21630,22549,17551,-4998
2016,7,28,13,23338,24290,19530,-4760
2016,7,28,14,24857,25779,21389,-4390
2016,7,28,15,26095,27104,22840,-4264
2016,7,28,16,27094,28125,23978,-4147
2016,7,28,17,27938,28833,25083,-3750
2016,7,28,18,28693,29524,25605,-3919
2016,7,28,19,29231,29994,25835,-4159
2016,7,28,20,29550,30219,26253,-3966
2016,7,28,21,29696,30058,26055,-4003
2016,7,28,22,29380,29512,25802,-3710
2016,7,28,23,28455,28424,24957,-3467
2016,7,29,0,27406,27470,24288,-3182
2016,7,29,1,26698,27051,23724,-3327
2016,7,29,2,26115,26346,22689,-3657
2016,7,29,3,24411,24629,20321,-4308
2016,7,29,4,22392,22865,18310,-4555
2016,7,29,5,20849,21278,16530,-4748
2016,7,29,6,19723,20105,15516,-4589
2016,7,29,7,18981,19312,14652,-4660
2016,7,29,8,18530,18811,13980,-4831
2016,7,29,9,18442,18698,14023,-4675
2016,7,29,10,18947,19136,14480,-4656
2016,7,29,11,20021,20169,15258,-4911
2016,7,29,12,21540,21508,16883,-4625
2016,7,29,13,22960,22559,18553,-4006
2016,7,29,14,24218,23521,19597,-3924
2016,7,29,15,25189,24323,20755,-3568
2016,7,29,16,25698,25058,21501,-3557
2016,7,29,17,25828,25541,22067,-3474
2016,7,29,18,25985,26063,22847,-3216
2016,7,29,19,26034,26672,23265,-3407
2016,7,29,20,26014,27249,23822,-3427
2016,7,29,21,26038,27687,24473,-3214
2016,7,29,22,25821,27708,24502,-3206
2016,7,29,23,25224,26956,23879,-3077
2016,7,30,0,24465,25791,23026,-2765
2016,7,30,1,23894,25057,22133,-2924
2016,7,30,2,23662,24440,21206,-3234
2016,7,30,3,22543,23057,19320,-3737
2016,7,30,4,20995,21358,17134,-4224
2016,7,30,5,19932,19950,15534,-4416
2016,7,30,6,18821,18855,14738,-4117
2016,7,30,7,18041,18068,13952,-4116
2016,7,30,8,17512,17570,13445,-4125
2016,7,30,9,17249,17273,13291,-3982
2016,7,30,10,17239,17258,13284,-3974
2016,7,30,11,17327,17496,13461,-4035
2016,7,30,12,18259,18573,14340,-4233
2016,7,30,13,19758,20067,15958,-4109
2016,7,30,14,21325,21448,17264,-4184
2016,7,30,15,22614,22644,18918,-3726
2016,7,30,16,23480,23520,19415,-4105
2016,7,30,17,23800,24020,19845,-4175
2016,7,30,18,23902,24223,20158,-4065
2016,7,30,19,23944,24391,20716,-3675
2016,7,30,20,24018,24188,20792,-3396
2016,7,30,21,24237,23822,20163,-3659
2016,7,30,22,24311,23483,19667,-3816
2016,7,30,23,24057,22996,19675,-3321
2016,7,31,0,23462,22617,19627,-2990
2016,7,31,1,23052,22611,19583,-3028
2016,7,31,2,23013,22288,18885,-3403
2016,7,31,3,22099,21356,17524,-3832
2016,7,31,4,20786,20182,16101,-4081
2016,7,31,5,19420,19080,14947,-4133
2016,7,31,6,18424,18217,14444,-3773
2016,7,31,7,17729,17573,13907,-3666
2016,7,31,8,17248,17142,13510,-3632
2016,7,31,9,16978,16910,13428,-3482
2016,7,31,10,16892,16936,13256,-3680
2016,7,31,11,16892,17034,13655,-3379
2016,7,31,12,17499,17671,14314,-3357
2016,7,31,13,18739,18780,15526,-3254
2016,7,31,14,20162,20042,16736,-3306
2016,7,31,15,21402,21042,17637,-3405
2016,7,31,16,22306,21693,18362,-3331
2016,7,31,17,22552,22034,18908,-3126
2016,7,31,18,22572,22270,19231,-3039
2016,7,31,19,22497,22466,19577,-2889
2016,7,31,20,22470,22599,19636,-2963
2016,7,31,21,22649,22708,19792,-2916
2016,7,31,22,22733,22812,20142,-2670
2016,7,31,23,22674,22558,20065,-2493
2016,8,1,0,22369,22249,19783,-2466
2016,8,1,1,22156,22271,19815,-2456
2016,8,1,2,22150,21924,19195,-2729
2016,8,1,3,21282,20797,17777,-3020
2016,8,1,4,20132,19413,15939,-3474
2016,8,1,5,18602,18245,14445,-3800
2016,8,1,6,17750,17447,13934,-3513
2016,8,1,7,17176,16918,13434,-3484
2016,8,1,8,16857,16646,13011,-3635
2016,8,1,9,16886,16773,12890,-3883
2016,8,1,10,17492,17501,13236,-4265
2016,8,1,11,18555,18669,14640,-4029
2016,8,1,12,20011,20103,16369,-3734
2016,8,1,13,21467,21300,17499,-3801
2016,8,1,14,22690,22141,18531,-3610
2016,8,1,15,23732,22853,19135,-3718
2016,8,1,16,24245,23392,20157,-3235
2016,8,1,17,24267,23669,20674,-2995
2016,8,1,18,24359,24032,21524,-2508
2016,8,1,19,24345,24404,21771,-2633
2016,8,1,20,24322,24684,22004,-2680
2016,8,1,21,24385,24974,22297,-2677
2016,8,1,22,24347,24920,22170,-2750
2016,8,1,23,23881,24274,22046,-2228
2016,8,2,0,23346,23618,20965,-2653
2016,8,2,1,23316,23310,20633,-2677
2016,8,2,2,22717,22650,19756,-2894
2016,8,2,3,21422,21082,17638,-3444
2016,8,2,4,19926,19394,15618,-3776
2016,8,2,5,18117,18009,14597,-3412
2016,8,2,6,17148,17087,13823,-3264
2016,8,2,7,16494,16471,13044,-3427
2016,8,2,8,16122,16123,12628,-3495
2016,8,2,9,16112,16173,12469,-3704
2016,8,2,10,16733,16823,13133,-3690
2016,8,2,11,17828,18003,14735,-3268
2016,8,2,12,19286,19549,16643,-2906
2016,8,2,13,20676,20856,18313,-2543
2016,8,2,14,21799,21848,19615,-2233
2016,8,2,15,22685,22621,20248,-2373
2016,8,2,16,23153,23231,20817,-2414
2016,8,2,17,23308,23701,21031,-2670
2016,8,2,18,23518,23963,21377,-2586
2016,8,2,19,23647,24035,21585,-2450
2016,8,2,20,23737,24078,21779,-2299
2016,8,2,21,23857,24155,22406,-1749
2016,8,2,22,23798,24115,22625,-1490
2016,8,2,23,23196,23565,22155,-1410
2016,8,3,0,22460,22807,21262,-1545
2016,8,3,1,22343,22337,20418,-1919
2016,8,3,2,21663,21736,20010,-1726
2016,8,3,3,20252,20186,18014,-2172
2016,8,3,4,18722,18460,15975,-2485
2016,8,3,5,17292,17168,14510,-2658
2016,8,3,6,16442,16240,13460,-2780
2016,8,3,7,15843,15604,13193,-2411
2016,8,3,8,15525,15296,12735,-2561
2016,8,3,9,15561,15321,12946,-2375
2016,8,3,10,16216,15971,13343,-2628
2016,8,3,11,17273,17098,14514,-2584
2016,8,3,12,18776,18793,16292,-2501
2016,8,3,13,20211,20224,17591,-2633
2016,8,3,14,21339,21258,18685,-2573
2016,8,3,15,22291,22211,19311,-2900
2016,8,3,16,22935,22987,20087,-2900
2016,8,3,17,23286,23503,20600,-2903
2016,8,3,18,23707,24031,20989,-3042
2016,8,3,19,24013,24495,21756,-2739
2016,8,3,20,24235,24861,22480,-2381
2016,8,3,21,24441,25153,23096,-2057
2016,8,3,22,24385,25137,23151,-1986
2016,8,3,23,23664,24506,22638,-1868
2016,8,4,0,22794,23530,21880,-1650
2016,8,4,1,22625,22935,21038,-1897
2016,8,4,2,21894,22276,20564,-1712
2016,8,4,3,20405,20761,18572,-2189
2016,8,4,4,18799,19043,16057,-2986
2016,8,4,5,17065,17604,14489,-3115
2016,8,4,6,16152,16625,13669,-2956
2016,8,4,7,15548,15995,13158,-2837
2016,8,4,8,15224,15643,12789,-2854
2016,8,4,9,15262,15624,12655,-2969
2016,8,4,10,15931,16217,13258,-2959
2016,8,4,11,17033,17400,14478,-2922
2016,8,4,12,18624,19160,16564,-2596
2016,8,4,13,20183,20724,17963,-2761
2016,8,4,14,21475,21953,19242,-2711
2016,8,4,15,22534,22997,20458,-2539
2016,8,4,16,23307,23838,21805,-2033
2016,8,4,17,23760,24373,21953,-2420
2016,8,4,18,24243,25033,22181,-2852
2016,8,4,19,24594,25494,22807,-2687
2016,8,4,20,24824,25933,23366,-2567
2016,8,4,21,25015,26285,24017,-2268
2016,8,4,22,24921,26171,23795,-2376
2016,8,4,23,24176,25449,23400,-2049
2016,8,5,0,23273,24449,22738,-1711
2016,8,5,1,23082,23846,21938,-1908
2016,8,5,2,22312,23206,21307,-1899
2016,8,5,3,20784,21615,19024,-2591
2016,8,5,4,19110,19880,17299,-2581
2016,8,5,5,17242,18434,15465,-2969
2016,8,5,6,16260,17432,14471,-2961
2016,8,5,7,15622,16746,13833,-2913
2016,8,5,8,15263,16332,12974,-3358
2016,8,5,9,15275,16299,12835,-3464
2016,8,5,10,15917,16866,13548,-3318
2016,8,5,11,16997,17955,15266,-2689
2016,8,5,12,18608,19620,16789,-2831
2016,8,5,13,20255,21171,18067,-3104
2016,8,5,14,21631,22441,19265,-3176
2016,8,5,15,22761,23606,20135,-3471
2016,8,5,16,23514,24612,21692,-2920
2016,8,5,17,23969,25336,22404,-2932
2016,8,5,18,24455,26001,23048,-2953
2016,8,5,19,24807,26483,23727,-2756
2016,8,5,20,25018,26786,24032,-2754
2016,8,5,21,25158,26854,24068,-2786
2016,8,5,22,24937,26514,24074,-2440
2016,8,5,23,24056,25535,23605,-1930
2016,8,6,0,23019,24659,22538,-2121
2016,8,6,1,22762,24268,22167,-2101
2016,8,6,2,22059,23732,21154,-2578
2016,8,6,3,20708,22375,19204,-3171
2016,8,6,4,19193,20870,17233,-3637
2016,8,6,5,18213,19452,15368,-4084
2016,8,6,6,17261,18387,14725,-3662
2016,8,6,7,16568,17667,13763,-3904
2016,8,6,8,16114,17232,13093,-4139
2016,8,6,9,15915,17057,12737,-4320
2016,8,6,10,16009,17167,12985,-4182
2016,8,6,11,16196,17458,13719,-3739
2016,8,6,12,17047,18452,14407,-4045
2016,8,6,13,18580,19893,15843,-4050
2016,8,6,14,20102,21368,17325,-4043
2016,8,6,15,21374,22754,19230,-3524
2016,8,6,16,22270,23869,20382,-3487
2016,8,6,17,22889,24482,20945,-3537
2016,8,6,18,23263,24952,21348,-3604
2016,8,6,19,23517,25456,21916,-3540
2016,8,6,20,23693,25917,22380,-3537
2016,8,6,21,23823,25896,22373,-3523
2016,8,6,22,23793,25360,22184,-3176
2016,8,6,23,23274,25000,21752,-3248
2016,8,7,0,22486,24261,21132,-3129
2016,8,7,1,22376,23828,20473,-3355
2016,8,7,2,21946,23316,19964,-3352
2016,8,7,3,20861,21947,18221,-3726
2016,8,7,4,19503,20357,16416,-3941
2016,8,7,5,18044,18904,14692,-4212
2016,8,7,6,17060,17823,13541,-4282
2016,8,7,7,16351,17007,12645,-4362
2016,8,7,8,15874,16445,12150,-4295
2016,8,7,9,15628,16084,11680,-4404
2016,8,7,10,15606,15919,11782,-4137
2016,8,7,11,15440,15872,12303,-3569
2016,8,7,12,16002,16704,12871,-3833
2016,8,7,13,17301,18119,14332,-3787
2016,8,7,14,18617,19536,15478,-4058
2016,8,7,15,19773,20778,16829,-3949
2016,8,7,16,20617,21763,18235,-3528
2016,8,7,17,21268,22490,18952,-3538
2016,8,7,18,21716,23029,19693,-3336
2016,8,7,19,22050,23460,19983,-3477
2016,8,7,20,22336,23819,20033,-3786
2016,8,7,21,22599,24222,20684,-3538
2016,8,7,22,22687,24428,21132,-3296
2016,8,7,23,22242,24162,21101,-3061
2016,8,8,0,21501,23419,20698,-2721
2016,8,8,1,21454,23120,19798,-3322
2016,8,8,2,20956,22643,19100,-3543
2016,8,8,3,19795,21294,17409,-3885
2016,8,8,4,18478,19758,15934,-3824
2016,8,8,5,17941,18501,14354,-4147
2016,8,8,6,17069,17538,13243,-4295
2016,8,8,7,16479,16919,12634,-4285
2016,8,8,8,16164,16555,12323,-4232
2016,8,8,9,16211,16574,12358,-4216
2016,8,8,10,16909,17147,12722,-4425
2016,8,8,11,17933,18164,14256,-3908
2016,8,8,12,19421,19886,15694,-4192
2016,8,8,13,20860,21384,17356,-4028
2016,8,8,14,21977,22573,18643,-3930
2016,8,8,15,22872,23731,19636,-4095
2016,8,8,16,23665,24587,20595,-3992
2016,8,8,17,24358,25114,21297,-3817
2016,8,8,18,24983,25568,22080,-3488
2016,8,8,19,25453,25954,22525,-3429
2016,8,8,20,25750,26217,22670,-3547
2016,8,8,21,25911,26489,23063,-3426
2016,8,8,22,25739,26438,23431,-3007
2016,8,8,23,24854,25849,23192,-2657
2016,8,9,0,23803,24985,22273,-2712
2016,8,9,1,23489,24471,21710,-2761
2016,8,9,2,22605,23593,20840,-2753
2016,8,9,3,20956,21883,18552,-3331
2016,8,9,4,19233,20072,16257,-3815
2016,8,9,5,18175,18629,14928,-3701
2016,8,9,6,17249,17574,13957,-3617
2016,8,9,7,16628,16910,13135,-3775
2016,8,9,8,16291,16501,12710,-3791
2016,8,9,9,16322,16513,12771,-3742
2016,8,9,10,17020,17080,13246,-3834
2016,8,9,11,18072,18240,14432,-3808
2016,8,9,12,19627,19972,16432,-3540
2016,8,9,13,21148,21540,17986,-3554
2016,8,9,14,22373,22887,19348,-3539
2016,8,9,15,23385,24081,20457,-3624
2016,8,9,16,24371,24985,21606,-3379
2016,8,9,17,25235,25685,22375,-3310
2016,8,9,18,26041,26382,22870,-3512
2016,8,9,19,26648,26996,23766,-3230
2016,8,9,20,27018,27450,24415,-3035
2016,8,9,21,27209,27813,24926,-2887
2016,8,9,22,27020,27745,25015,-2730
2016,8,9,23,26093,26949,24364,-2585
2016,8,10,0,24978,25942,23548,-2394
2016,8,10,1,24675,25733,23288,-2445
2016,8,10,2,23722,25065,22219,-2846
2016,8,10,3,21962,23560,20260,-3300
2016,8,10,4,20148,21926,18379,-3547
2016,8,10,5,19420,20546,16819,-3727
2016,8,10,6,18470,19601,15620,-3981
2016,8,10,7,17804,18944,15016,-3928
2016,8,10,8,17435,18603,14474,-4129
2016,8,10,9,17440,18641,14368,-4273
2016,8,10,10,18135,19415,15501,-3914
2016,8,10,11,19414,20833,16657,-4176
2016,8,10,12,21013,22453,18752,-3701
2016,8,10,13,22592,23843,20439,-3404
2016,8,10,14,23977,24973,21374,-3599
2016,8,10,15,25128,25901,22840,-3061
2016,8,10,16,26093,26703,23536,-3167
2016,8,10,17,26832,27322,24314,-3008
2016,8,10,18,27495,27724,24713,-3011
2016,8,10,19,27932,28232,25004,-3228
2016,8,10,20,28174,28906,25608,-3298
2016,8,10,21,28292,29434,25905,-3529
2016,8,10,22,28033,29326,26146,-3180
2016,8,10,23,27102,28756,25777,-2979
2016,8,11,0,26081,28143,25055,-3088
2016,8,11,1,25832,27961,24764,-3197
2016,8,11,2,24942,27180,24322,-2858
2016,8,11,3,23202,25463,22010,-3453
2016,8,11,4,21399,23608,19649,-3959
2016,8,11,5,21097,22053,17840,-4213
2016,8,11,6,20122,20944,16716,-4228
2016,8,11,7,19378,20181,15614,-4567
2016,8,11,8,18963,19753,14827,-4926
2016,8,11,9,18939,19699,14672,-5027
2016,8,11,10,19623,20409,15465,-4944
2016,8,11,11,20825,21719,17104,-4615
2016,8,11,12,22521,23495,19056,-4439
2016,8,11,13,24281,25187,21025,-4162
2016,8,11,14,25839,26741,22994,-3747
2016,8,11,15,27196,28361,25344,-3017
2016,8,11,16,28291,29612,26546,-3066
2016,8,11,17,29085,30551,27199,-3352
2016,8,11,18,29755,31406,28208,-3198
2016,8,11,19,30170,31836,28438,-3398
2016,8,11,20,30431,31997,28476,-3521
2016,8,11,21,30549,32076,28472,-3604
2016,8,11,22,30230,31861,27921,-3940
2016,8,11,23,29248,30866,26957,-3909
2016,8,12,0,28170,30060,26742,-3318
2016,8,12,1,27804,29561,26204,-3357
2016,8,12,2,26846,28487,25515,-2972
2016,8,12,3,25044,26667,23496,-3171
2016,8,12,4,23114,24785,21181,-3604
2016,8,12,5,22385,23006,18818,-4188
2016,8,12,6,21260,21480,17114,-4366
2016,8,12,7,20420,20619,16286,-4333
2016,8,12,8,19925,20154,15749,-4405
2016,8,12,9,19841,20094,15666,-4428
2016,8,12,10,20459,20711,16326,-4385
2016,8,12,11,21649,21968,17597,-4371
2016,8,12,12,23356,23735,19662,-4073
2016,8,12,13,25201,25514,22070,-3444
2016,8,12,14,26863,27137,24165,-2972
2016,8,12,15,28302,28809,25798,-3011
2016,8,12,16,29285,30143,26737,-3406
2016,8,12,17,29987,30914,27553,-3361
2016,8,12,18,30562,31174,27242,-3932
2016,8,12,19,30899,31477,27844,-3633
2016,8,12,20,31089,31412,27948,-3464
2016,8,12,21,31126,31188,27691,-3497
2016,8,12,22,30734,30977,27842,-3135
2016,8,12,23,29671,30476,27617,-2859
2016,8,13,0,28484,29410,26817,-2593
2016,8,13,1,27986,28870,25931,-2939
2016,8,13,2,27110,27904,25220,-2684
2016,8,13,3,25490,26354,23443,-2911
2016,8,13,4,23689,24588,21098,-3490
2016,8,13,5,22878,23092,18957,-4135
2016,8,13,6,21754,21893,17533,-4360
2016,8,13,7,20876,21116,16741,-4375
2016,8,13,8,20278,20614,16276,-4338
2016,8,13,9,19973,20337,15999,-4338
2016,8,13,10,19997,20489,15648,-4841
2016,8,13,11,20182,20791,16098,-4693
2016,8,13,12,21178,22021,17668,-4353
2016,8,13,13,22954,24030,19481,-4549
2016,8,13,14,24834,26103,22069,-4034
2016,8,13,15,26519,27957,23800,-4157
2016,8,13,16,27728,29331,25128,-4203
2016,8,13,17,28424,30143,25949,-4194
2016,8,13,18,28778,30404,26150,-4254
2016,8,13,19,28942,30553,26434,-4119
2016,8,13,20,29048,30529,25965,-4564
2016,8,13,21,29133,30263,25967,-4296
2016,8,13,22,29033,30040,26389,-3651
2016,8,13,23,28455,29478,26279,-3199
2016,8,14,0,27579,28786,25138,-3648
2016,8,14,1,27258,28352,24723,-3629
2016,8,14,2,26654,27456,23843,-3613
2016,8,14,3,25356,26193,21846,-4347
2016,8,14,4,23834,24737,20465,-4272
2016,8,14,5,23348,23060,19343,-3717
2016,8,14,6,22237,21986,18252,-3734
2016,8,14,7,21352,21151,16791,-4360
2016,8,14,8,20741,20529,15641,-4888
2016,8,14,9,20388,20190,15427,-4763
2016,8,14,10,20295,20224,16067,-4157
2016,8,14,11,20237,20334,15857,-4477
2016,8,14,12,20941,21254,16792,-4462
2016,8,14,13,22516,22877,18321,-4556
2016,8,14,14,24260,24613,20169,-4444
2016,8,14,15,25880,26030,22015,-4015
2016,8,14,16,27077,27244,23626,-3618
2016,8,14,17,27850,28122,24494,-3628
2016,8,14,18,28270,28626,25272,-3354
2016,8,14,19,28457,28988,25356,-3632
2016,8,14,20,28566,28952,25476,-3476
2016,8,14,21,28648,28997,25587,-3410
2016,8,14,22,28556,28914,25779,-3135
2016,8,14,23,28042,28576,25651,-2925
2016,8,15,0,27307,27944,24972,-2972
2016,8,15,1,27119,27560,24527,-3033
2016,8,15,2,26486,26728,23381,-3347
2016,8,15,3,25097,25203,21498,-3705
2016,8,15,4,23545,23520,20208,-3312
2016,8,15,5,22572,22091,18405,-3686
2016,8,15,6,21588,21038,17268,-3770
2016,8,15,7,20843,20252,16590,-3662
2016,8,15,8,20402,19795,16011,-3784
2016,8,15,9,20356,19733,15968,-3765
2016,8,15,10,20989,20351,16722,-3629
2016,8,15,11,22011,21428,17787,-3641
2016,8,15,12,23574,22931,19126,-3805
2016,8,15,13,25200,24481,20390,-4091
2016,8,15,14,26577,25856,21902,-3954
2016,8,15,15,27766,26996,22796,-4200
2016,8,15,16,28529,27732,23647,-4085
2016,8,15,17,29052,28291,24468,-3823
2016,8,15,18,29513,28894,25505,-3389
2016,8,15,19,29743,29288,25981,-3307
2016,8,15,20,29865,29739,26455,-3284
2016,8,15,21,29891,29910,26873,-3037
2016,8,15,22,29687,29662,26907,-2755
2016,8,15,23,28874,28882,25893,-2989
2016,8,16,0,27980,28072,25305,-2767
2016,8,16,1,27627,27932,24909,-3023
2016,8,16,2,26702,26937,23868,-3069
2016,8,16,3,24971,25160,21548,-3612
2016,8,16,4,23101,23347,19682,-3665
2016,8,16,5,21936,21760,18372,-3388
2016,8,16,6,20867,20691,17027,-3664
2016,8,16,7,20082,19946,16235,-3711
2016,8,16,8,19618,19547,15862,-3685
2016,8,16,9,19552,19546,15632,-3914
2016,8,16,10,20197,20219,16188,-4031
2016,8,16,11,21396,21472,17533,-3939
2016,8,16,12,22963,23099,19235,-3864
2016,8,16,13,24556,24606,20680,-3926
2016,8,16,14,25955,25948,22278,-3670
2016,8,16,15,27149,27066,23662,-3404
2016,8,16,16,27974,27979,24480,-3499
2016,8,16,17,28475,28633,25100,-3533
2016,8,16,18,28911,29146,25754,-3392
2016,8,16,19,29133,29546,26925,-2621
2016,8,16,20,29232,29935,27619,-2316
2016,8,16,21,29268,30281,27843,-2438
2016,8,16,22,29042,30357,27880,-2477
2016,8,16,23,28245,29698,27038,-2660
2016,8,17,0,27421,29099,26675,-2424
2016,8,17,1,27164,28576,26631,-1945
2016,8,17,2,26271,27640,25417,-2223
2016,8,17,3,24548,25984,22977,-3007
2016,8,17,4,22695,24236,20810,-3426
2016,8,17,5,21622,22723,19004,-3719
2016,8,17,6,20535,21377,17489,-3888
2016,8,17,7,19751,20368,16429,-3939
2016,8,17,8,19287,19885,15907,-3978
2016,8,17,9,19208,19758,15718,-4040
2016,8,17,10,19819,20298,16163,-4135
2016,8,17,11,20899,21408,16975,-4433
2016,8,17,12,22348,22717,18493,-4224
2016,8,17,13,23786,23903,20054,-3849
2016,8,17,14,24967,24854,21164,-3690
2016,8,17,15,25938,25536,22010,-3526
2016,8,17,16,26524,26062,22492,-3570
2016,8,17,17,26940,26459,23080,-3379
2016,8,17,18,27335,26958,23768,-3190
2016,8,17,19,27562,27388,24256,-3132
2016,8,17,20,27681,27808,24872,-2936
2016,8,17,21,27739,28070,25214,-2856
2016,8,17,22,27507,27880,25335,-2545
2016,8,17,23,26641,27033,24501,-2532
2016,8,18,0,25728,26153,23670,-2483
2016,8,18,1,25430,25974,23301,-2673
2016,8,18,2,24604,25093,21987,-3106
2016,8,18,3,22960,23555,19761,-3794
2016,8,18,4,21188,21744,17787,-3957
2016,8,18,5,20230,20233,16037,-4196
2016,8,18,6,19267,19221,15155,-4066
2016,8,18,7,18544,18533,14436,-4097
2016,8,18,8,18140,18156,14054,-4102
2016,8,18,9,18114,18162,14043,-4119
2016,8,18,10,18783,18796,14525,-4271
2016,8,18,11,19942,20049,15594,-4455
2016,8,18,12,21395,21366,16806,-4560
2016,8,18,13,22801,22585,18018,-4567
2016,8,18,14,23961,23514,19198,-4316
2016,8,18,15,24928,24347,20231,-4116
2016,8,18,16,25665,25013,21330,-3683
2016,8,18,17,26287,25622,22093,-3529
2016,8,18,18,26856,26341,23205,-3136
2016,8,18,19,27248,26897,23700,-3197
2016,8,18,20,27511,27278,24356,-2922
2016,8,18,21,27664,27618,25158,-2460
2016,8,18,22,27411,27675,25310,-2365
2016,8,18,23,26499,27007,24330,-2677
2016,8,19,0,25546,26081,23270,-2811
2016,8,19,1,25209,25825,23226,-2599
2016,8,19,2,24305,24928,22034,-2894
2016,8,19,3,22630,23367,19848,-3519
2016,8,19,4,20868,21660,17790,-3870
2016,8,19,5,19594,20177,16209,-3968
2016,8,19,6,18624,19129,15304,-3825
2016,8,19,7,17921,18434,14439,-3995
2016,8,19,8,17521,17997,14366,-3631
2016,8,19,9,17501,17973,14442,-3531
2016,8,19,10,18143,18568,14659,-3909
2016,8,19,11,19264,19684,15732,-3952
2016,8,19,12,20820,21281,16976,-4305
2016,8,19,13,22440,22899,18762,-4137
2016,8,19,14,23825,24264,20337,-3927
2016,8,19,15,25020,25363,22066,-3297
2016,8,19,16,25790,26266,22854,-3412
2016,8,19,17,26269,26903,23670,-3233
2016,8,19,18,26728,27459,24253,-3206
2016,8,19,19,27027,27880,24691,-3189
2016,8,19,20,27220,28174,25021,-3153
2016,8,19,21,27338,28296,25672,-2624
2016,8,19,22,27083,28064,25521,-2543
2016,8,19,23,26225,27172,24481,-2691
2016,8,20,0,25280,26104,23632,-2472
2016,8,20,1,24897,25673,23572,-2101
2016,8,20,2,24134,24592,21716,-2876
2016,8,20,3,22727,23121,19266,-3855
2016,8,20,4,21090,21440,17382,-4058
2016,8,20,5,19544,19996,16443,-3553
2016,8,20,6,18506,18945,15387,-3558
2016,8,20,7,17758,18160,14440,-3720
2016,8,20,8,17258,17649,14043,-3606
2016,8,20,9,17034,17444,14054,-3390
2016,8,20,10,17119,17498,14068,-3430
2016,8,20,11,17321,17663,14278,-3385
2016,8,20,12,18177,18648,14845,-3803
2016,8,20,13,19753,20300,16344,-3956
2016,8,20,14,21369,21949,18115,-3834
2016,8,20,15,22797,23338,19765,-3573
2016,8,20,16,23778,24376,21039,-3337
2016,8,20,17,24289,24845,21565,-3280
2016,8,20,18,24566,25058,21856,-3202
2016,8,20,19,24741,24970,22010,-2960
2016,8,20,20,24929,24919,21909,-3010
2016,8,20,21,25193,25312,22317,-2995
2016,8,20,22,25259,25401,22827,-2574
2016,8,20,23,24854,24857,22551,-2306
2016,8,21,0,24169,24173,21884,-2289
2016,8,21,1,23948,24181,21908,-2273
2016,8,21,2,23367,23591,20860,-2731
2016,8,21,3,22205,22432,19014,-3418
2016,8,21,4,20850,21124,17752,-3372
2016,8,21,5,19651,20021,16647,-3374
2016,8,21,6,18613,19141,15681,-3460
2016,8,21,7,17847,18473,15007,-3466
2016,8,21,8,17325,18070,14576,-3494
2016,8,21,9,17039,17876,14688,-3188
2016,8,21,10,17003,17909,14868,-3041
2016,8,21,11,17074,18002,15030,-2972
2016,8,21,12,17680,18758,15325,-3433
2016,8,21,13,19099,20045,16380,-3665
2016,8,21,14,20686,21462,18081,-3381
2016,8,21,15,22122,22652,19500,-3152
2016,8,21,16,23156,23530,20407,-3123
2016,8,21,17,23646,24100,20954,-3146
2016,8,21,18,23866,24484,21365,-3119
2016,8,21,19,23927,24639,21601,-3038
2016,8,21,20,23959,24548,21808,-2740
2016,8,21,21,24070,24351,21825,-2526
2016,8,21,22,24025,24232,21621,-2611
2016,8,21,23,23724,23907,21246,-2661
2016,8,22,0,23338,23662,21119,-2543
2016,8,22,1,23359,23665,20928,-2737
2016,8,22,2,22844,22892,19397,-3495
2016,8,22,3,21681,21633,17566,-4067
2016,8,22,4,20267,20301,16410,-3891
2016,8,22,5,18471,19047,15333,-3714
2016,8,22,6,17584,18023,14369,-3654
2016,8,22,7,17003,17333,13854,-3479
2016,8,22,8,16673,16914,13567,-3347
2016,8,22,9,16683,16824,13422,-3402
2016,8,22,10,17288,17350,13821,-3529
2016,8,22,11,18244,18299,14703,-3596
2016,8,22,12,19537,19698,16484,-3214
2016,8,22,13,20821,20854,17385,-3469
2016,8,22,14,21849,21638,18038,-3600
2016,8,22,15,22694,22153,18810,-3343
2016,8,22,16,22963,22467,19328,-3139
2016,8,22,17,22960,22667,19838,-2829
2016,8,22,18,23056,22888,19844,-3044
2016,8,22,19,23100,23076,20321,-2755
2016,8,22,20,23157,23182,20609,-2573
2016,8,22,21,23279,23207,20839,-2368
2016,8,22,22,23234,22989,20829,-2160
2016,8,22,23,22716,22172,19829,-2343
2016,8,23,0,22173,21312,18868,-2444
2016,8,23,1,21957,21149,18640,-2509
2016,8,23,2,21271,20184,17619,-2565
2016,8,23,3,19967,18659,15756,-2903
2016,8,23,4,18499,17147,14187,-2960
2016,8,23,5,16763,15985,12790,-3195
2016,8,23,6,15809,15201,12466,-2735
2016,8,23,7,15185,14653,12240,-2413
2016,8,23,8,14846,14371,12081,-2290
2016,8,23,9,14865,14435,12174,-2261
2016,8,23,10,15512,15116,12470,-2646
2016,8,23,11,16609,16200,12980,-3220
2016,8,23,12,17974,17648,14203,-3445
2016,8,23,13,19267,18881,15827,-3054
2016,8,23,14,20302,19820,16949,-2871
2016,8,23,15,21116,20631,17630,-3001
2016,8,23,16,21598,21234,18045,-3189
2016,8,23,17,21960,21664,18712,-2952
2016,8,23,18,22367,22158,19356,-2802
2016,8,23,19,22727,22730,20241,-2489
2016,8,23,20,23029,23185,20850,-2335
2016,8,23,21,23283,23547,21317,-2230
2016,8,23,22,23174,23579,21200,-2379
2016,8,23,23,22418,22992,20476,-2516
2016,8,24,0,21648,22249,19730,-2519
2016,8,24,1,21369,22170,19653,-2517
2016,8,24,2,20558,21311,18579,-2732
2016,8,24,3,19079,19866,16869,-2997
2016,8,24,4,17544,18359,15188,-3171
2016,8,24,5,16255,17095,13610,-3485
2016,8,24,6,15515,16253,13037,-3216
2016,8,24,7,14993,15656,12746,-2910
2016,8,24,8,14732,15317,12294,-3023
2016,8,24,9,14812,15332,12308,-3024
2016,8,24,10,15545,16057,12839,-3218
2016,8,24,11,16759,17196,13863,-3333
2016,8,24,12,18246,18722,15435,-3287
2016,8,24,13,19680,20176,16792,-3384
2016,8,24,14,20841,21357,17660,-3697
2016,8,24,15,21837,22511,18776,-3735
2016,8,24,16,22718,23441,19600,-3841
2016,8,24,17,23490,24189,20663,-3526
2016,8,24,18,24232,24919,22617,-2302
2016,8,24,19,24816,25539,23483,-2056
2016,8,24,20,25212,26106,23870,-2236
2016,8,24,21,25476,26458,24273,-2185
2016,8,24,22,25272,26344,24218,-2126
2016,8,24,23,24368,25461,22808,-2653
2016,8,25,0,23506,24631,21784,-2847
2016,8,25,1,23196,24436,21498,-2938
2016,8,25,2,22292,23466,20278,-3188
2016,8,25,3,20670,21887,18122,-3765
2016,8,25,4,18951,20160,16185,-3975
2016,8,25,5,17562,18778,15043,-3735
2016,8,25,6,16623,17770,14126,-3644
2016,8,25,7,16005,17125,13927,-3198
2016,8,25,8,15671,16787,13631,-3156
2016,8,25,9,15702,16820,13655,-3165
2016,8,25,10,16423,17464,14177,-3287
2016,8,25,11,17734,18669,14975,-3694
2016,8,25,12,19281,20168,16652,-3516
2016,8,25,13,20807,21577,18532,-3045
2016,8,25,14,22131,22748,19409,-3339
2016,8,25,15,23234,23799,21252,-2547
2016,8,25,16,24089,24575,22342,-2233
2016,8,25,17,24731,25140,22730,-2410
2016,8,25,18,25347,25661,23544,-2117
2016,8,25,19,25770,26064,24316,-1748
2016,8,25,20,26024,26373,24705,-1668
2016,8,25,21,26170,26420,25271,-1149
2016,8,25,22,25863,26213,24911,-1302
2016,8,25,23,24994,25726,24420,-1306
2016,8,26,0,24261,25451,23633,-1818
2016,8,26,1,23998,25488,23502,-1986
2016,8,26,2,23068,24611,22054,-2557
2016,8,26,3,21435,23050,19633,-3417
2016,8,26,4,19724,21376,16855,-4521
2016,8,26,5,19077,20039,15723,-4316
2016,8,26,6,18150,19074,15095,-3979
2016,8,26,7,17480,18428,14404,-4024
2016,8,26,8,17102,18048,14020,-4028
2016,8,26,9,17099,18080,13895,-4185
2016,8,26,10,17770,18783,14659,-4124
2016,8,26,11,19067,20042,16008,-4034
2016,8,26,12,20625,21607,17486,-4121
2016,8,26,13,22248,23143,18933,-4210
2016,8,26,14,23662,24749,20765,-3984
2016,8,26,15,24881,26166,22479,-3687
2016,8,26,16,25823,27329,24147,-3182
2016,8,26,17,26635,28076,24916,-3160
2016,8,26,18,27317,28701,25894,-2807
2016,8,26,19,27782,29168,26437,-2731
2016,8,26,20,28084,29457,26863,-2594
2016,8,26,21,28215,29555,26953,-2602
2016,8,26,22,27764,29241,26375,-2866
2016,8,26,23,26686,28159,25382,-2777
2016,8,27,0,25672,27033,24359,-2674
2016,8,27,1,25129,26406,23968,-2438
2016,8,27,2,24235,25170,22177,-2993
2016,8,27,3,22727,23484,19805,-3679
2016,8,27,4,20969,21674,17375,-4299
2016,8,27,5,19151,20072,16224,-3848
2016,8,27,6,18026,18891,15089,-3802
2016,8,27,7,17232,18015,13949,-4066
2016,8,27,8,16705,17356,13134,-4222
2016,8,27,9,16459,17016,12680,-4336
2016,8,27,10,16539,17022,12734,-4288
2016,8,27,11,16733,17182,12946,-4236
2016,8,27,12,17478,18017,13883,-4134
2016,8,27,13,18900,19569,15563,-4006
2016,8,27,14,20318,21013,17120,-3893
2016,8,27,15,21538,22290,18444,-3846
2016,8,27,16,22341,23245,19535,-3710
2016,8,27,17,23003,23946,20219,-3727
2016,8,27,18,23465,24462,20872,-3590
2016,8,27,19,23852,24886,21519,-3367
2016,8,27,20,24187,25162,21620,-3542
2016,8,27,21,24463,25307,21678,-3629
2016,8,27,22,24416,25196,21611,-3585
2016,8,27,23,23844,24530,21261,-3269
2016,8,28,0,23138,23695,20287,-3408
2016,8,28,1,22807,23480,19987,-3493
2016,8,28,2,22121,22583,18814,-3769
2016,8,28,3,20925,21366,17373,-3993
2016,8,28,4,19541,20012,15652,-4360
2016,8,28,5,18557,18843,14466,-4377
2016,8,28,6,17554,17916,13833,-4083
2016,8,28,7,16821,17239,13264,-3975
2016,8,28,8,16329,16778,13062,-3716
2016,8,28,9,16078,16547,12518,-4029
2016,8,28,10,16081,16578,12842,-3736
2016,8,28,11,16180,16684,13131,-3553
2016,8,28,12,16802,17433,13847,-3586
2016,8,28,13,18245,18933,15137,-3796
2016,8,28,14,19841,20498,16386,-4112
2016,8,28,15,21312,21888,17558,-4330
2016,8,28,16,22389,23002,18827,-4175
2016,8,28,17,23153,23887,19790,-4097
2016,8,28,18,23670,24559,20676,-3883
2016,8,28,19,24033,25050,21168,-3882
2016,8,28,20,24365,25460,21621,-3839
2016,8,28,21,24696,25672,22210,-3462
2016,8,28,22,24736,25584,22490,-3094
2016,8,28,23,24312,25052,22170,-2882
2016,8,29,0,23841,24499,21700,-2799
2016,8,29,1,23692,24540,21488,-3052
2016,8,29,2,22975,23741,20199,-3542
2016,8,29,3,21644,22445,18469,-3976
2016,8,29,4,20143,20938,16596,-4342
2016,8,29,5,18821,19667,15108,-4559
2016,8,29,6,17864,18748,14513,-4235
2016,8,29,7,17216,18145,13773,-4372
2016,8,29,8,16851,17811,13358,-4453
2016,8,29,9,16865,17859,13266,-4593
2016,8,29,10,17544,18541,13710,-4831
2016,8,29,11,18791,19586,15096,-4490
2016,8,29,12,20341,21117,16875,-4242
2016,8,29,13,21929,22666,18896,-3770
2016,8,29,14,23313,24083,20086,-3997
2016,8,29,15,24500,25410,21677,-3733
2016,8,29,16,25321,26504,22842,-3662
2016,8,29,17,25989,27240,24285,-2955
2016,8,29,18,26565,27852,24743,-3109
2016,8,29,19,26968,28254,25231,-3023
2016,8,29,20,27276,28538,25466,-3072
2016,8,29,21,27441,28629,26191,-2438
2016,8,29,22,27140,28362,25688,-2674
2016,8,29,23,26274,27349,24431,-2918
2016,8,30,0,25498,26288,23133,-3155
2016,8,30,1,24989,25782,22900,-2882
2016,8,30,2,23966,24373,21269,-3104
2016,8,30,3,22285,22467,18605,-3862
2016,8,30,4,20408,20417,15987,-4430
2016,8,30,5,18480,18834,14446,-4388
2016,8,30,6,17411,17783,13693,-4090
2016,8,30,7,16702,17043,12761,-4282
2016,8,30,8,16295,16574,12443,-4131
2016,8,30,9,16280,16530,12450,-4080
2016,8,30,10,16940,17135,12670,-4465
2016,8,30,11,18149,18202,14262,-3940
2016,8,30,12,19566,19584,15877,-3707
2016,8,30,13,20948,20972,17384,-3588
2016,8,30,14,22076,22174,18626,-3548
2016,8,30,15,23016,23259,19896,-3363
2016,8,30,16,23701,24070,21014,-3056
2016,8,30,17,24262,24684,21769,-2915
2016,8,30,18,24813,25335,22545,-2790
2016,8,30,19,25219,25885,23360,-2525
2016,8,30,20,25528,26343,23599,-2744
2016,8,30,21,25725,26621,24323,-2298
2016,8,30,22,25455,26447,24194,-2253
2016,8,30,23,24632,25541,23299,-2242
2016,8,31,0,23933,24828,22634,-2194
2016,8,31,1,23532,24637,22246,-2391
2016,8,31,2,22499,23561,21068,-2493
2016,8,31,3,20852,22024,18923,-3101
2016,8,31,4,19140,20313,16486,-3827
2016,8,31,5,18549,18909,15276,-3633
2016,8,31,6,17607,18046,14806,-3240
2016,8,31,7,16952,17490,14089,-3401
2016,8,31,8,16593,17193,13753,-3440
2016,8,31,9,16611,17262,13643,-3619
2016,8,31,10,17332,18031,14276,-3755
2016,8,31,11,18723,19472,15785,-3687
2016,8,31,12,20244,20948,17200,-3748
2016,8,31,13,21717,22238,18291,-3947
2016,8,31,14,23004,23389,19510,-3879
2016,8,31,15,24118,24274,20452,-3822
2016,8,31,16,24943,24942,21683,-3259
2016,8,31,17,25610,25445,22428,-3017
2016,8,31,18,26261,25962,23286,-2676
2016,8,31,19,26711,26335,23749,-2586
2016,8,31,20,26987,26596,23722,-2874
2016,8,31,21,27130,26597,23726,-2871
2016,8,31,22,26799,26169,23422,-2747
2016,8,31,23,25928,25488,22713,-2775
2016,9,1,0,25319,25258,22550,-2708
2016,9,1,1,25021,25223,22286,-2937
2016,9,1,2,23997,24205,20893,-3312
2016,9,1,3,22286,22622,18609,-4013
2016,9,1,4,20409,20894,16389,-4505
2016,9,1,5,18754,19464,14889,-4575
2016,9,1,6,17804,18457,13957,-4500
2016,9,1,7,17148,17768,13331,-4437
2016,9,1,8,16782,17426,12821,-4605
2016,9,1,9,16784,17401,12955,-4446
2016,9,1,10,17463,18025,13761,-4264
2016,9,1,11,18775,19410,15050,-4360
2016,9,1,12,20081,20629,16243,-4386
2016,9,1,13,21276,21657,17528,-4129
2016,9,1,14,22227,22376,18199,-4177
2016,9,1,15,22971,22850,18748,-4102
2016,9,1,16,23344,23145,19138,-4007
2016,9,1,17,23627,23460,19732,-3728
2016,9,1,18,23937,23880,20160,-3720
2016,9,1,19,24108,23935,20549,-3386
2016,9,1,20,24238,23726,20301,-3425
2016,9,1,21,24347,23561,20388,-3173
2016,9,1,22,24053,23340,20259,-3081
2016,9,1,23,23365,22770,19861,-2909
2016,9,2,0,22939,22477,19573,-2904
2016,9,2,1,22708,22439,19426,-3013
2016,9,2,2,21839,21594,18221,-3373
2016,9,2,3,20390,20208,16515,-3693
2016,9,2,4,18786,18452,14313,-4139
2016,9,2,5,17446,17148,12879,-4269
2016,9,2,6,16486,16220,12190,-4030
2016,9,2,7,15845,15580,11505,-4075
2016,9,2,8,15489,15221,11431,-3790
2016,9,2,9,15489,15202,11423,-3779
2016,9,2,10,16115,15776,11612,-4164
2016,9,2,11,17254,16870,12730,-4140
2016,9,2,12,18555,18064,14179,-3885
2016,9,2,13,19774,19307,15549,-3758
2016,9,2,14,20724,20237,16562,-3675
2016,9,2,15,21456,20927,17204,-3723
2016,9,2,16,21756,21388,17831,-3557
2016,9,2,17,21912,21776,18145,-3631
2016,9,2,18,22138,22225,18567,-3658
2016,9,2,19,22322,22502,18887,-3615
2016,9,2,20,22473,22601,18937,-3664
2016,9,2,21,22608,22685,19254,-3431
2016,9,2,22,22298,22492,19211,-3281
2016,9,2,23,21536,21652,18589,-3063
2016,9,3,0,21019,21162,17894,-3268
2016,9,3,1,20723,20910,17970,-2940
2016,9,3,2,19971,20028,16648,-3380
2016,9,3,3,18805,18798,14928,-3870
2016,9,3,4,17481,17445,13230,-4215
2016,9,3,5,16325,16275,12188,-4087
2016,9,3,6,15496,15448,11635,-3813
2016,9,3,7,14895,14913,11027,-3886
2016,9,3,8,14525,14565,10627,-3938
2016,9,3,9,14386,14444,10742,-3702
2016,9,3,10,14526,14610,10972,-3638
2016,9,3,11,14820,14945,11395,-3550
2016,9,3,12,15353,15567,12459,-3108
2016,9,3,13,16447,16574,13399,-3175
2016,9,3,14,17477,17422,13935,-3487
2016,9,3,15,18251,18034,14634,-3400
2016,9,3,16,18779,18341,15237,-3104
2016,9,3,17,19026,18551,15390,-3161
2016,9,3,18,19098,18579,15350,-3229
2016,9,3,19,19168,18554,15145,-3409
2016,9,3,20,19234,18674,15215,-3459
2016,9,3,21,19366,18860,15494,-3366
2016,9,3,22,19286,18958,15514,-3444
2016,9,3,23,19003,18783,15651,-3132
2016,9,4,0,18911,18664,15532,-3132
2016,9,4,1,18949,18730,15703,-3027
2016,9,4,2,18440,18063,15183,-2880
2016,9,4,3,17582,17157,13974,-3183
2016,9,4,4,16536,16129,12648,-3481
2016,9,4,5,15282,15214,12165,-3049
2016,9,4,6,14527,14544,11377,-3167
2016,9,4,7,13996,14014,10379,-3635
2016,9,4,8,13664,13702,10533,-3169
2016,9,4,9,13505,13543,10536,-3007
2016,9,4,10,13485,13575,10349,-3226
2016,9,4,11,13391,13696,10715,-2981
2016,9,4,12,13498,14108,10900,-3208
2016,9,4,13,14398,15150,12114,-3036
2016,9,4,14,15385,16084,13279,-2805
2016,9,4,15,16223,16891,13990,-2901
2016,9,4,16,16843,17486,14186,-3300
2016,9,4,17,17232,17965,14632,-3333
2016,9,4,18,17436,18327,14877,-3450
2016,9,4,19,17588,18677,15226,-3451
2016,9,4,20,17755,19104,15842,-3262
2016,9,4,21,17992,19477,16433,-3044
2016,9,4,22,18005,19677,16737,-2940
2016,9,4,23,17874,19439,16773,-2666
2016,9,5,0,17999,19318,16629,-2689
2016,9,5,1,18288,19364,16502,-2862
2016,9,5,2,17765,18692,15729,-2963
2016,9,5,3,16884,17738,14770,-2968
2016,9,5,4,15869,16559,13325,-3234
2016,9,5,5,14236,15443,11798,-3645
2016,9,5,6,13505,14640,11111,-3529
2016,9,5,7,13044,14074,10338,-3736
2016,9,5,8,12789,13774,10198,-3576
2016,9,5,9,12778,13699,10145,-3554
2016,9,5,10,13070,13885,10480,-3405
2016,9,5,11,13339,14194,10736,-3458
2016,9,5,12,13583,14627,11203,-3424
2016,9,5,13,14465,15568,12235,-3333
2016,9,5,14,15494,16583,13140,-3443
2016,9,5,15,16407,17449,14181,-3268
2016,9,5,16,17197,18062,14597,-3465
2016,9,5,17,17827,18507,14914,-3593
2016,9,5,18,18219,19084,15805,-3279
2016,9,5,19,18538,19646,16636,-3010
2016,9,5,20,18847,20216,17256,-2960
2016,9,5,21,19149,20793,17777,-3016
2016,9,5,22,19136,21136,18056,-3080
2016,9,5,23,18790,21030,18040,-2990
2016,9,6,0,18792,21080,18118,-2962
2016,9,6,1,19199,21239,18254,-2985
2016,9,6,2,18417,20372,17222,-3150
2016,9,6,3,17247,18968,15592,-3376
2016,9,6,4,16092,17589,13941,-3648
2016,9,6,5,15277,16529,12536,-3993
2016,9,6,6,14623,15796,12162,-3634
2016,9,6,7,14201,15290,11805,-3485
2016,9,6,8,14010,15075,11736,-3339
2016,9,6,9,14140,15204,11741,-3463
2016,9,6,10,14913,16039,12549,-3490
2016,9,6,11,16240,17584,14473,-3111
2016,9,6,12,17532,18928,15932,-2996
2016,9,6,13,18669,20039,17221,-2818
2016,9,6,14,19515,21005,17701,-3304
2016,9,6,15,20221,21851,18731,-3120
2016,9,6,16,21069,22427,19109,-3318
2016,9,6,17,21924,22969,19859,-3110
2016,9,6,18,22678,23577,20574,-3003
2016,9,6,19,23228,23922,20946,-2976
2016,9,6,20,23589,24052,21391,-2661
2016,9,6,21,23798,24235,21793,-2442
2016,9,6,22,23366,24264,22115,-2149
2016,9,6,23,22508,23853,21853,-2000
2016,9,7,0,22027,23795,21709,-2086
2016,9,7,1,21713,23529,21202,-2327
2016,9,7,2,20653,22402,19743,-2659
2016,9,7,3,19107,20786,17392,-3394
2016,9,7,4,17569,19108,15262,-3846
2016,9,7,5,16953,17784,14037,-3747
2016,9,7,6,16233,16956,13723,-3233
2016,9,7,7,15704,16404,12972,-3432
2016,9,7,8,15440,16146,12656,-3490
2016,9,7,9,15527,16224,12582,-3642
2016,9,7,10,16279,17077,13447,-3630
2016,9,7,11,17702,18702,14804,-3898
2016,9,7,12,19087,20129,16409,-3720
2016,9,7,13,20385,21310,17481,-3829
2016,9,7,14,21455,22239,19112,-3127
2016,9,7,15,22416,23067,19844,-3223
2016,9,7,16,23301,23909,21198,-2711
2016,9,7,17,24023,24669,22259,-2410
2016,9,7,18,24697,25366,22987,-2379
2016,9,7,19,25162,25757,23267,-2490
2016,9,7,20,25464,26158,23649,-2509
2016,9,7,21,25668,26658,24033,-2625
2016,9,7,22,25265,26664,24155,-2509
2016,9,7,23,24455,26019,23966,-2053
2016,9,8,0,24025,25637,23682,-1955
2016,9,8,1,23667,25404,23300,-2104
2016,9,8,2,22580,24175,21658,-2517
2016,9,8,3,20981,22431,18814,-3617
2016,9,8,4,19309,20596,16872,-3724
2016,9,8,5,18540,19154,15353,-3801
2016,9,8,6,17579,18162,14437,-3725
2016,9,8,7,16914,17523,13641,-3882
2016,9,8,8,16546,17169,13592,-3577
2016,9,8,9,16567,17210,13698,-3512
2016,9,8,10,17282,18059,14369,-3690
2016,9,8,11,18755,19801,16031,-3770
2016,9,8,12,20350,21224,17844,-3380
2016,9,8,13,21961,22518,19339,-3179
2016,9,8,14,23433,23727,21012,-2715
2016,9,8,15,24737,24915,21769,-3146
2016,9,8,16,25695,25899,22767,-3132
2016,9,8,17,26357,26689,23223,-3466
2016,9,8,18,26978,27494,24437,-3057
2016,9,8,19,27389,28144,25123,-3021
2016,9,8,20,27674,28690,26133,-2557
2016,9,8,21,27842,29004,26402,-2602
2016,9,8,22,27419,28846,26392,-2454
2016,9,8,23,26599,27990,25941,-2049
2016,9,9,0,26163,27701,25802,-1899
2016,9,9,1,25738,27304,25553,-1751
2016,9,9,2,24586,26134,23839,-2295
2016,9,9,3,22898,24478,21558,-2920
2016,9,9,4,21076,22643,18906,-3737
2016,9,9,5,19997,21115,17477,-3638
2016,9,9,6,18961,20079,16267,-3812
2016,9,9,7,18227,19414,15518,-3896
2016,9,9,8,17798,19045,14709,-4336
2016,9,9,9,17759,19134,14669,-4465
2016,9,9,10,18411,19997,15419,-4578
2016,9,9,11,19811,21813,17712,-4101
2016,9,9,12,21313,23235,18669,-4566
2016,9,9,13,22875,24494,20399,-4095
2016,9,9,14,24262,25796,22185,-3611
2016,9,9,15,25464,26885,23721,-3164
2016,9,9,16,26272,27742,24755,-2987
2016,9,9,17,26975,28561,25439,-3122
2016,9,9,18,27570,28984,26388,-2596
2016,9,9,19,27964,29093,26903,-2190
2016,9,9,20,28212,29437,27392,-2045
2016,9,9,21,28276,29637,27341,-2296
2016,9,9,22,27701,29164,26881,-2283
2016,9,9,23,26705,28177,26338,-1839
2016,9,10,0,26067,27625,25418,-2207
2016,9,10,1,25462,27068,25075,-1993
2016,9,10,2,24400,25882,23494,-2388
2016,9,10,3,22903,24226,21185,-3041
2016,9,10,4,21162,22395,19055,-3340
2016,9,10,5,19829,20896,17030,-3866
2016,9,10,6,18778,19766,15790,-3976
2016,9,10,7,17994,18922,14962,-3960
2016,9,10,8,17475,18341,14426,-3915
2016,9,10,9,17238,18075,14327,-3748
2016,9,10,10,17335,18212,14383,-3829
2016,9,10,11,17749,18615,15154,-3461
2016,9,10,12,18454,19412,15700,-3712
2016,9,10,13,19839,20837,16848,-3989
2016,9,10,14,21285,22372,18471,-3901
2016,9,10,15,22587,23796,20312,-3484
2016,9,10,16,23512,24931,21843,-3088
2016,9,10,17,24120,25947,23058,-2889
2016,9,10,18,24488,26743,24304,-2439
2016,9,10,19,24737,27185,24634,-2551
2016,9,10,20,24946,27337,24747,-2590
2016,9,10,21,25143,27454,25326,-2128
2016,9,10,22,24942,27308,25483,-1825
2016,9,10,23,24531,26818,24473,-2345
2016,9,11,0,24299,26625,24232,-2393
2016,9,11,1,23927,26255,23840,-2415
2016,9,11,2,23100,25275,22447,-2828
2016,9,11,3,21926,23953,20470,-3483
2016,9,11,4,20507,22492,18993,-3499
2016,9,11,5,19700,21107,17434,-3673
2016,9,11,6,18623,19958,16265,-3693
2016,9,11,7,17851,19140,15152,-3988
2016,9,11,8,17321,18570,14681,-3889
2016,9,11,9,17022,18161,14767,-3394
2016,9,11,10,16971,18141,14842,-3299
2016,9,11,11,17075,18294,14902,-3392
2016,9,11,12,17439,18678,15343,-3335
2016,9,11,13,18497,19743,16602,-3141
2016,9,11,14,19649,20801,17904,-2897
2016,9,11,15,20654,21337,18610,-2727
2016,9,11,16,21339,21438,18854,-2584
2016,9,11,17,21746,21530,18855,-2675
2016,9,11,18,21890,21607,19233,-2374
2016,9,11,19,21941,21718,19502,-2216
2016,9,11,20,21950,21894,19696,-2198
2016,9,11,21,22003,22172,19953,-2219
2016,9,11,22,21818,22140,19950,-2190
2016,9,11,23,21506,21593,19406,-2187
2016,9,12,0,21445,21411,19259,-2152
2016,9,12,1,21221,21230,19391,-1839
2016,9,12,2,20495,20116,17749,-2367
2016,9,12,3,19425,18665,15802,-2863
2016,9,12,4,18151,17168,14184,-2984
2016,9,12,5,17051,16049,12679,-3370
2016,9,12,6,16130,15263,12238,-3025
2016,9,12,7,15538,14780,11486,-3294
2016,9,12,8,15222,14477,11163,-3314
2016,9,12,9,15274,14557,11266,-3291
2016,9,12,10,15973,15284,11864,-3420
2016,9,12,11,17211,16759,13272,-3487
2016,9,12,12,18490,17920,14674,-3246
2016,9,12,13,19656,18889,16137,-2752
2016,9,12,14,20568,19705,16601,-3104
2016,9,12,15,21295,20366,17306,-3060
2016,9,12,16,21647,20795,17809,-2986
2016,9,12,17,21880,21068,18230,-2838
2016,9,12,18,22205,21409,18635,-2774
2016,9,12,19,22490,21668,19014,-2654
2016,9,12,20,22736,21989,19503,-2486
2016,9,12,21,22957,22272,20008,-2264
2016,9,12,22,22686,22216,20032,-2184
2016,9,12,23,22047,21544,19395,-2149
2016,9,13,0,21798,21340,18825,-2515
2016,9,13,1,21375,20945,18759,-2186
2016,9,13,2,20288,19811,17352,-2459
2016,9,13,3,18813,18281,15544,-2737
2016,9,13,4,17264,16779,14135,-2644
2016,9,13,5,15729,15638,12969,-2669
2016,9,13,6,14925,14925,12744,-2181
2016,9,13,7,14416,14471,12140,-2331
2016,9,13,8,14162,14271,12036,-2235
2016,9,13,9,14253,14398,12195,-2203
2016,9,13,10,14992,15220,12773,-2447
2016,9,13,11,16368,16843,14083,-2760
2016,9,13,12,17733,18098,15593,-2505
2016,9,13,13,18997,19138,16930,-2208
2016,9,13,14,20030,19995,17483,-2512
2016,9,13,15,20876,20677,18099,-2578
2016,9,13,16,21521,21287,18590,-2697
2016,9,13,17,22051,21797,19330,-2467
2016,9,13,18,22572,22347,20042,-2305
2016,9,13,19,23012,22841,20548,-2293
2016,9,13,20,23338,23302,21049,-2253
2016,9,13,21,23586,23628,21323,-2305
2016,9,13,22,23272,23539,21369,-2170
2016,9,13,23,22583,22779,21133,-1646
2016,9,14,0,22337,22689,20816,-1873
2016,9,14,1,21975,22347,20617,-1730
2016,9,14,2,20901,21202,19239,-1963
2016,9,14,3,19409,19590,17598,-1992
2016,9,14,4,17823,17986,15681,-2305
2016,9,14,5,16041,16763,14334,-2429
2016,9,14,6,15246,15976,13678,-2298
2016,9,14,7,14745,15477,13202,-2275
2016,9,14,8,14495,15248,13188,-2060
2016,9,14,9,14571,15350,13171,-2179
2016,9,14,10,15323,16203,13675,-2528
2016,9,14,11,16732,17952,15054,-2898
2016,9,14,12,18112,19292,16829,-2463
2016,9,14,13,19366,20418,18025,-2393
2016,9,14,14,20354,21328,18896,-2432
2016,9,14,15,21155,22209,19680,-2529
2016,9,14,16,21787,22921,20586,-2335
2016,9,14,17,22375,23558,21566,-1992
2016,9,14,18,22883,24150,22197,-1953
2016,9,14,19,23288,24564,23071,-1493
2016,9,14,20,23561,24992,23838,-1154
2016,9,14,21,23742,25208,24242,-966
2016,9,14,22,23352,24597,23334,-1263
2016,9,14,23,22499,23487,21883,-1604
2016,9,15,0,22189,23335,21483,-1852
2016,9,15,1,21765,22907,20916,-1991
2016,9,15,2,20692,21686,19320,-2366
2016,9,15,3,19217,19906,17203,-2703
2016,9,15,4,17599,17949,14840,-3109
2016,9,15,5,15714,16460,13735,-2725
2016,9,15,6,14850,15459,12877,-2582
2016,9,15,7,14317,14822,12250,-2572
2016,9,15,8,14036,14451,12195,-2256
2016,9,15,9,14117,14434,12063,-2371
2016,9,15,10,14909,15123,12805,-2318
2016,9,15,11,16585,16646,14379,-2267
2016,9,15,12,17848,17703,15208,-2495
2016,9,15,13,18693,18493,16125,-2368
2016,9,15,14,19367,19004,16240,-2764
2016,9,15,15,19912,19435,16975,-2460
2016,9,15,16,20202,19676,17205,-2471
2016,9,15,17,20423,19812,17422,-2390
2016,9,15,18,20696,20036,18043,-1993
2016,9,15,19,20807,20187,18132,-2055
2016,9,15,20,20893,20456,18606,-1850
2016,9,15,21,20980,20707,19001,-1706
2016,9,15,22,20763,20610,18681,-1929
2016,9,15,23,20164,20021,17847,-2174
2016,9,16,0,20304,20051,17951,-2100
2016,9,16,1,19893,19643,17692,-1951
2016,9,16,2,18752,18598,15921,-2677
2016,9,16,3,17232,17272,14519,-2753
2016,9,16,4,15721,15898,13078,-2820
2016,9,16,5,14908,14832,12266,-2566
2016,9,16,6,14203,14161,11684,-2477
2016,9,16,7,13756,13769,11401,-2368
2016,9,16,8,13540,13550,11304,-2246
2016,9,16,9,13658,13653,11393,-2260
2016,9,16,10,14453,14396,12114,-2282
2016,9,16,11,16079,16002,13315,-2687
2016,9,16,12,17345,17242,14903,-2339
2016,9,16,13,18258,18130,15888,-2242
2016,9,16,14,18997,18841,16349,-2492
2016,9,16,15,19583,19273,16856,-2417
2016,9,16,16,19908,19540,17135,-2405
2016,9,16,17,20107,19734,17445,-2289
2016,9,16,18,20361,19942,17798,-2144
2016,9,16,19,20493,20086,17769,-2317
2016,9,16,20,20572,20197,18194,-2003
2016,9,16,21,20611,20327,18612,-1715
2016,9,16,22,20322,20142,18615,-1527
2016,9,16,23,19662,19535,17536,-1999
2016,9,17,0,19786,19566,17328,-2238
2016,9,17,1,19338,19146,17270,-1876
2016,9,17,2,18368,18275,16105,-2170
2016,9,17,3,17123,17093,14672,-2421
2016,9,17,4,15797,15863,13292,-2571
2016,9,17,5,14466,14816,11936,-2880
2016,9,17,6,13762,14118,11332,-2786
2016,9,17,7,13296,13662,10734,-2928
2016,9,17,8,13032,13393,11078,-2315
2016,9,17,9,13005,13324,11217,-2107
2016,9,17,10,13273,13536,11430,-2106
2016,9,17,11,13794,14061,11663,-2398
2016,9,17,12,14413,14745,11978,-2767
2016,9,17,13,15556,15899,13455,-2444
2016,9,17,14,16616,16813,14299,-2514
2016,9,17,15,17391,17462,14911,-2551
2016,9,17,16,17812,17899,15342,-2557
2016,9,17,17,18061,18142,15739,-2403
2016,9,17,18,18208,18360,15994,-2366
2016,9,17,19,18323,18576,16293,-2283
2016,9,17,20,18461,18755,16870,-1885
2016,9,17,21,18666,18981,17179,-1802
2016,9,17,22,18628,19103,17265,-1838
2016,9,17,23,18370,19094,17493,-1601
2016,9,18,0,18749,19477,17926,-1551
2016,9,18,1,18482,19302,17790,-1512
2016,9,18,2,17814,18719,16530,-2189
2016,9,18,3,16912,17853,15264,-2589
2016,9,18,4,15903,16871,14159,-2712
2016,9,18,5,15176,15981,13071,-2910
2016,9,18,6,14459,15296,12216,-3080
2016,9,18,7,13959,14826,11520,-3306
2016,9,18,8,13649,14535,11068,-3467
2016,9,18,9,13571,14435,11071,-3364
2016,9,18,10,13772,14571,11301,-3270
2016,9,18,11,14182,14919,11481,-3438
2016,9,18,12,14657,15513,12278,-3235
2016,9,18,13,15844,16728,13800,-2928
2016,9,18,14,17072,17908,15132,-2776
2016,9,18,15,18101,18879,16219,-2660
2016,9,18,16,18881,19674,17237,-2437
2016,9,18,17,19449,20375,17636,-2739
2016,9,18,18,19802,20844,18184,-2660
2016,9,18,19,20036,21301,18441,-2860
2016,9,18,20,20258,21632,18798,-2834
2016,9,18,21,20530,21803,19063,-2740
2016,9,18,22,20497,21946,19276,-2670
2016,9,18,23,20178,21966,19160,-2806
2016,9,19,0,20551,22459,19448,-3011
2016,9,19,1,20197,22232,19521,-2711
2016,9,19,2,19300,21252,18003,-3249
2016,9,19,3,18102,19912,16411,-3501
2016,9,19,4,16824,18499,14768,-3731
2016,9,19,5,16226,17436,14059,-3377
2016,9,19,6,15654,16650,13193,-3457
2016,9,19,7,15267,16187,12407,-3780
2016,9,19,8,15071,16004,12029,-3975
2016,9,19,9,15225,16192,12443,-3749
2016,9,19,10,16061,17104,13516,-3588
2016,9,19,11,17686,19017,15545,-3472
2016,9,19,12,18937,20207,17408,-2799
2016,9,19,13,19884,21139,18105,-3034
2016,9,19,14,20633,21844,19231,-2613
2016,9,19,15,21318,22347,19697,-2650
2016,9,19,16,21682,22563,20105,-2458
2016,9,19,17,21985,22669,20291,-2378
2016,9,19,18,22316,22781,20056,-2725
2016,9,19,19,22437,22807,20028,-2779
2016,9,19,20,22479,22816,20643,-2173
2016,9,19,21,22504,22888,20885,-2003
2016,9,19,22,22258,22820,20992,-1828
2016,9,19,23,21724,22525,20841,-1684
2016,9,20,0,21845,22620,20580,-2040
2016,9,20,1,21271,22074,20314,-1760
2016,9,20,2,20140,20905,18717,-2188
2016,9,20,3,18676,19380,16300,-3080
2016,9,20,4,17195,17793,14571,-3222
2016,9,20,5,16821,16547,13382,-3165
2016,9,20,6,16030,15780,12880,-2900
2016,9,20,7,15503,15292,12353,-2939
2016,9,20,8,15218,15072,11930,-3142
2016,9,20,9,15322,15226,12006,-3220
2016,9,20,10,16186,16105,12929,-3176
2016,9,20,11,17975,17973,14938,-3035
2016,9,20,12,19350,19281,16428,-2853
2016,9,20,13,20336,20220,17517,-2703
2016,9,20,14,21167,20989,18403,-2586
2016,9,20,15,21943,21712,19232,-2480
2016,9,20,16,22511,22330,20077,-2253
2016,9,20,17,22994,22945,20589,-2356
2016,9,20,18,23484,23571,21375,-2196
2016,9,20,19,23776,24018,22108,-1910
2016,9,20,20,24014,24413,22452,-1961
2016,9,20,21,24159,24611,22400,-2211
2016,9,20,22,23842,24400,22233,-2167
2016,9,20,23,23131,23841,21995,-1846
2016,9,21,0,23077,23886,21915,-1971
2016,9,21,1,22333,23254,21445,-1809
2016,9,21,2,20979,22009,19796,-2213
2016,9,21,3,19266,20292,17072,-3220
2016,9,21,4,17572,18510,15168,-3342
2016,9,21,5,16528,17111,14582,-2529
2016,9,21,6,15699,16253,13665,-2588
2016,9,21,7,15132,15649,12907,-2742
2016,9,21,8,14817,15318,12509,-2809
2016,9,21,9,14888,15369,12295,-3074
2016,9,21,10,15682,16154,13454,-2700
2016,9,21,11,17366,17898,15697,-2201
2016,9,21,12,18593,19089,16643,-2446
2016,9,21,13,19485,19898,17473,-2425
2016,9,21,14,20197,20559,17974,-2585
2016,9,21,15,20823,21117,18776,-2341
2016,9,21,16,21405,21522,19186,-2336
2016,9,21,17,21863,21978,19850,-2128
2016,9,21,18,22312,22534,20464,-2070
2016,9,21,19,22611,22964,20826,-2138
2016,9,21,20,22880,23328,21463,-1865
2016,9,21,21,23068,23523,22058,-1465
2016,9,21,22,22768,23301,22220,-1081
2016,9,21,23,22040,22632,21415,-1217
2016,9,22,0,22035,22594,21299,-1295
2016,9,22,1,21347,21904,20812,-1092
2016,9,22,2,19951,20679,18917,-1762
2016,9,22,3,18187,19082,16583,-2499
2016,9,22,4,16480,17424,14913,-2511
2016,9,22,5,15802,16165,13484,-2681
2016,9,22,6,15025,15352,12374,-2978
2016,9,22,7,14498,14836,11930,-2906
2016,9,22,8,14224,14572,11747,-2825
2016,9,22,9,14328,14642,11746,-2896
2016,9,22,10,15153,15426,12186,-3240
2016,9,22,11,16886,17081,13939,-3142
2016,9,22,12,18160,18259,15435,-2824
2016,9,22,13,19075,19265,16269,-2996
2016,9,22,14,19825,20130,16963,-3167
2016,9,22,15,20462,20951,17989,-2962
2016,9,22,16,21071,21621,18810,-2811
2016,9,22,17,21608,22205,19727,-2478
2016,9,22,18,22117,22811,20292,-2519
2016,9,22,19,22476,23313,21049,-2264
2016,9,22,20,22824,23764,21643,-2121
2016,9,22,21,23105,24006,21833,-2173
2016,9,22,22,22851,23736,21497,-2239
2016,9,22,23,22205,22865,21244,-1621
2016,9,23,0,22218,22749,20634,-2115
2016,9,23,1,21483,21939,20189,-1750
2016,9,23,2,20047,20707,18474,-2233
2016,9,23,3,18266,19121,16389,-2732
2016,9,23,4,16540,17577,14771,-2806
2016,9,23,5,15510,16387,13570,-2817
2016,9,23,6,14724,15579,12748,-2831
2016,9,23,7,14223,15052,12185,-2867
2016,9,23,8,13955,14774,12054,-2720
2016,9,23,9,14051,14848,12001,-2847
2016,9,23,10,14852,15599,12760,-2839
2016,9,23,11,16581,17334,14654,-2680
2016,9,23,12,17970,18623,16111,-2512
2016,9,23,13,19011,19635,17430,-2205
2016,9,23,14,19869,20493,17980,-2513
2016,9,23,15,20582,21070,18777,-2293
2016,9,23,16,21107,21474,19264,-2210
2016,9,23,17,21515,21788,19376,-2412
2016,9,23,18,21871,22239,19903,-2336
2016,9,23,19,22114,22533,20079,-2454
2016,9,23,20,22294,22859,20545,-2314
2016,9,23,21,22419,23089,21018,-2071
2016,9,23,22,22032,22831,21221,-1610
2016,9,23,23,21287,22054,21072,-982
2016,9,24,0,21161,21853,20838,-1015
2016,9,24,1,20430,21213,19631,-1582
2016,9,24,2,19243,20195,18256,-1939
2016,9,24,3,17841,18987,16991,-1996
2016,9,24,4,16373,17584,15676,-1908
2016,9,24,5,15427,16259,13649,-2610
2016,9,24,6,14561,15245,12713,-2532
2016,9,24,7,13975,14545,12011,-2534
2016,9,24,8,13621,14121,11283,-2838
2016,9,24,9,13505,13936,11078,-2858
2016,9,24,10,13690,14066,10873,-3193
2016,9,24,11,14174,14543,11655,-2888
2016,9,24,12,14677,15095,12158,-2937
2016,9,24,13,15738,15953,13093,-2860
2016,9,24,14,16680,16552,13662,-2890
2016,9,24,15,17251,16908,14142,-2766
2016,9,24,16,17549,16962,14300,-2662
2016,9,24,17,17614,16942,14195,-2747
2016,9,24,18,17559,16959,14489,-2470
2016,9,24,19,17480,17019,14738,-2281
2016,9,24,20,17440,17035,14531,-2504
2016,9,24,21,17499,17212,15072,-2140
2016,9,24,22,17401,17275,15059,-2216
2016,9,24,23,17286,17217,14991,-2226
2016,9,25,0,17728,17593,15448,-2145
2016,9,25,1,17482,17276,15350,-1926
2016,9,25,2,16675,16629,14205,-2424
2016,9,25,3,15708,15745,12816,-2929
2016,9,25,4,14697,14724,11665,-3059
2016,9,25,5,14101,13859,10882,-2977
2016,9,25,6,13427,13245,10467,-2778
2016,9,25,7,12990,12851,10008,-2843
2016,9,25,8,12755,12606,9768,-2838
2016,9,25,9,12699,12509,9460,-3049
2016,9,25,10,12846,12641,9768,-2873
2016,9,25,11,13137,12976,9781,-3195
2016,9,25,12,13399,13421,10553,-2868
2016,9,25,13,14234,14258,11369,-2889
2016,9,25,14,14992,14928,12282,-2646
2016,9,25,15,15500,15343,12924,-2419
2016,9,25,16,15782,15534,12823,-2711
2016,9,25,17,15927,15731,12999,-2732
2016,9,25,18,15983,15868,13188,-2680
2016,9,25,19,15990,15982,13308,-2674
2016,9,25,20,16054,16169,13624,-2545
2016,9,25,21,16246,16493,14333,-2160
2016,9,25,22,16352,16811,14702,-2109
2016,9,25,23,16535,17012,15182,-1830
2016,9,26,0,17245,17617,15890,-1727
2016,9,26,1,17214,17263,15243,-2020
2016,9,26,2,16439,16457,13992,-2465
2016,9,26,3,15425,15362,12679,-2683
2016,9,26,4,14391,14234,11412,-2822
2016,9,26,5,13441,13437,10695,-2742
2016,9,26,6,12983,12926,10219,-2707
2016,9,26,7,12729,12669,9930,-2739
2016,9,26,8,12649,12580,9914,-2666
2016,9,26,9,12866,12812,10402,-2410
2016,9,26,10,13717,13685,10836,-2849
2016,9,26,11,15337,15423,12414,-3009
2016,9,26,12,16471,16584,13633,-2951
2016,9,26,13,17194,17292,14340,-2952
2016,9,26,14,17698,17837,14804,-3033
2016,9,26,15,18075,18222,15440,-2782
2016,9,26,16,18271,18453,15616,-2837
2016,9,26,17,18374,18593,16146,-2447
2016,9,26,18,18527,18767,16454,-2313
2016,9,26,19,18565,18874,16292,-2582
2016,9,26,20,18594,18909,16536,-2373
2016,9,26,21,18674,19009,16781,-2228
2016,9,26,22,18593,19051,16912,-2139
2016,9,26,23,18497,19180,17282,-1898
2016,9,27,0,18889,19545,17621,-1924
2016,9,27,1,18527,18980,16744,-2236
2016,9,27,2,17564,17832,15521,-2311
2016,9,27,3,16288,16656,14052,-2604
2016,9,27,4,15019,15398,12753,-2645
2016,9,27,5,14137,14386,11911,-2475
2016,9,27,6,13576,13809,10944,-2865
2016,9,27,7,13230,13457,10853,-2604
2016,9,27,8,13086,13339,10864,-2475
2016,9,27,9,13244,13534,11185,-2349
2016,9,27,10,14071,14427,11632,-2795
2016,9,27,11,15782,16302,13260,-3042
2016,9,27,12,17007,17598,14475,-3123
2016,9,27,13,17783,18381,15052,-3329
2016,9,27,14,18311,18907,15678,-3229
2016,9,27,15,18707,19240,16349,-2891
2016,9,27,16,18926,19442,16530,-2912
2016,9,27,17,19048,19587,16944,-2643
2016,9,27,18,19189,19761,16873,-2888
2016,9,27,19,19238,19846,16767,-3079
2016,9,27,20,19250,19984,16763,-3221
2016,9,27,21,19298,20060,16801,-3259
2016,9,27,22,19137,19971,16709,-3262
2016,9,27,23,18929,19702,16520,-3182
2016,9,28,0,19213,20071,17365,-2706
2016,9,28,1,18834,19471,17188,-2283
2016,9,28,2,17835,18418,16066,-2352
2016,9,28,3,16508,17008,14566,-2442
2016,9,28,4,15183,15575,12867,-2708
2016,9,28,5,14354,14550,12094,-2456
2016,9,28,6,13716,13905,11220,-2685
2016,9,28,7,13310,13493,11014,-2479
2016,9,28,8,13128,13317,10844,-2473
2016,9,28,9,13267,13475,11090,-2385
2016,9,28,10,14078,14300,11458,-2842
2016,9,28,11,15805,16075,12830,-3245
2016,9,28,12,17026,17324,14308,-3016
2016,9,28,13,17790,18086,15277,-2809
2016,9,28,14,18382,18660,15585,-3075
2016,9,28,15,18884,19068,15753,-3315
2016,9,28,16,19184,19287,16203,-3084
2016,9,28,17,19322,19304,16126,-3178
2016,9,28,18,19529,19322,16069,-3253
2016,9,28,19,19594,19247,16103,-3144
2016,9,28,20,19630,19158,16214,-2944
2016,9,28,21,19693,19137,16176,-2961
2016,9,28,22,19498,19103,16277,-2826
2016,9,28,23,19254,19104,16328,-2776
2016,9,29,0,19465,19292,16655,-2637
2016,9,29,1,18994,18650,16129,-2521
2016,9,29,2,17959,17598,14957,-2641
2016,9,29,3,16589,16211,13094,-3117
2016,9,29,4,15196,14877,12070,-2807
2016,9,29,5,14202,13888,11086,-2802
2016,9,29,6,13562,13316,11000,-2316
2016,9,29,7,13166,12987,10468,-2519
2016,9,29,8,12986,12871,10212,-2659
2016,9,29,9,13112,13052,10711,-2341
2016,9,29,10,13907,13905,11320,-2585
2016,9,29,11,15627,15697,12816,-2881
2016,9,29,12,16891,17009,14174,-2835
2016,9,29,13,17688,17742,14849,-2893
2016,9,29,14,18305,18170,15176,-2994
2016,9,29,15,18739,18408,15457,-2951
2016,9,29,16,18888,18489,15557,-2932
2016,9,29,17,18888,18436,15579,-2857
2016,9,29,18,18946,18416,15480,-2936
2016,9,29,19,18884,18309,15367,-2942
2016,9,29,20,18838,18266,15204,-3062
2016,9,29,21,18873,18384,15403,-2981
2016,9,29,22,18735,18450,15412,-3038
2016,9,29,23,18652,18609,15430,-3179
2016,9,30,0,18920,18887,15808,-3079
2016,9,30,1,18529,18295,15407,-2888
2016,9,30,2,17596,17366,14215,-3151
2016,9,30,3,16352,16021,12850,-3171
2016,9,30,4,15084,14722,11981,-2741
2016,9,30,5,13866,13719,11020,-2699
2016,9,30,6,13274,13074,10605,-2469
2016,9,30,7,12928,12735,10510,-2225
2016,9,30,8,12775,12614,10509,-2105
2016,9,30,9,12911,12787,10731,-2056
2016,9,30,10,13678,13590,11254,-2336
2016,9,30,11,15337,15334,12591,-2743
2016,9,30,12,16550,16671,13728,-2943
2016,9,30,13,17318,17468,14647,-2821
2016,9,30,14,17876,17958,15055,-2903
2016,9,30,15,18258,18270,15373,-2897
2016,9,30,16,18390,18297,15299,-2998
2016,9,30,17,18348,18229,15350,-2879
2016,9,30,18,18336,18226,15434,-2792
2016,9,30,19,18236,18139,15159,-2980
2016,9,30,20,18132,18094,15059,-3035
2016,9,30,21,18099,18084,15135,-2949
2016,9,30,22,17905,18053,15010,-3043
2016,9,30,23,17827,18155,15046,-3109
2016,10,1,0,18029,18260,15304,-2956
2016,10,1,1,17629,17694,14965,-2729
2016,10,1,2,16867,16939,14067,-2872
2016,10,1,3,15899,15860,13039,-2821
2016,10,1,4,14808,14743,12187,-2556
2016,10,1,5,13462,13759,11430,-2329
2016,10,1,6,12842,13100,10957,-2143
2016,10,1,7,12468,12702,10548,-2154
2016,10,1,8,12262,12499,10523,-1976
2016,10,1,9,12246,12500,10514,-1986
2016,10,1,10,12507,12781,11058,-1723
2016,10,1,11,13071,13419,11192,-2227
2016,10,1,12,13713,14164,11892,-2272
2016,10,1,13,14622,15159,12621,-2538
2016,10,1,14,15423,15941,13355,-2586
2016,10,1,15,15855,16378,13723,-2655
2016,10,1,16,15972,16610,13876,-2734
2016,10,1,17,15875,16610,13866,-2744
2016,10,1,18,15733,16545,13825,-2720
2016,10,1,19,15563,16457,13711,-2746
2016,10,1,20,15451,16385,13505,-2880
2016,10,1,21,15502,16412,13399,-3013
2016,10,1,22,15690,16647,14088,-2559
2016,10,1,23,16041,17026,14750,-2276
2016,10,2,0,16604,17318,15336,-1982
2016,10,2,1,16298,16936,14341,-2595
2016,10,2,2,15696,16320,13468,-2852
2016,10,2,3,15018,15445,12777,-2668
2016,10,2,4,14195,14434,11693,-2741
2016,10,2,5,13145,13592,11217,-2375
2016,10,2,6,12551,12951,11067,-1884
2016,10,2,7,12164,12540,10686,-1854
2016,10,2,8,11956,12310,10531,-1779
2016,10,2,9,11904,12253,10611,-1642
2016,10,2,10,12077,12411,11044,-1367
2016,10,2,11,12468,12823,10975,-1848
2016,10,2,12,12914,13311,11433,-1878
2016,10,2,13,13760,14210,11913,-2297
2016,10,2,14,14572,15042,12626,-2416
2016,10,2,15,15098,15686,13383,-2303
2016,10,2,16,15431,16041,13572,-2469
2016,10,2,17,15572,16226,13566,-2660
2016,10,2,18,15629,16286,13666,-2620
2016,10,2,19,15630,16333,13683,-2650
2016,10,2,20,15685,16354,13824,-2530
2016,10,2,21,15873,16579,13946,-2633
2016,10,2,22,16124,16883,14308,-2575
2016,10,2,23,16513,17196,15155,-2041
2016,10,3,0,17124,17507,15624,-1883
2016,10,3,1,16814,17067,14859,-2208
2016,10,3,2,16048,16288,13988,-2300
2016,10,3,3,15129,15331,12715,-2616
2016,10,3,4,14138,14287,11531,-2756
2016,10,3,5,13110,13466,11074,-2392
2016,10,3,6,12640,12962,10834,-2128
2016,10,3,7,12369,12683,10475,-2208
2016,10,3,8,12277,12591,10360,-2231
2016,10,3,9,12477,12793,10483,-2310
2016,10,3,10,13335,13624,11226,-2398
2016,10,3,11,15056,15165,12511,-2654
2016,10,3,12,16426,16393,14344,-2049
2016,10,3,13,17231,17189,14932,-2257
2016,10,3,14,17836,17761,15396,-2365
2016,10,3,15,18250,18154,15858,-2296
2016,10,3,16,18381,18301,15755,-2546
2016,10,3,17,18403,18374,16079,-2295
2016,10,3,18,18482,18455,16070,-2385
2016,10,3,19,18456,18527,16198,-2329
2016,10,3,20,18409,18572,16047,-2525
2016,10,3,21,18422,18676,16321,-2355
2016,10,3,22,18456,18763,16540,-2223
2016,10,3,23,18567,18868,16491,-2377
2016,10,4,0,18940,19229,16973,-2256
2016,10,4,1,18420,18571,16846,-1725
2016,10,4,2,17432,17601,15345,-2256
2016,10,4,3,16215,16314,14020,-2294
2016,10,4,4,14916,15030,12757,-2273
2016,10,4,5,13732,14003,11889,-2114
2016,10,4,6,13099,13411,11658,-1753
2016,10,4,7,12727,13008,11392,-1616
2016,10,4,8,12553,12865,11301,-1564
2016,10,4,9,12686,13004,11287,-1717
2016,10,4,10,13501,13769,11797,-1972
2016,10,4,11,15231,15396,13410,-1986
2016,10,4,12,16532,16591,14969,-1622
2016,10,4,13,17239,17292,15666,-1626
2016,10,4,14,17755,17817,15414,-2403
2016,10,4,15,18091,18097,15427,-2670
2016,10,4,16,18160,18202,16107,-2095
2016,10,4,17,18134,18262,15732,-2530
2016,10,4,18,18192,18369,16036,-2333
2016,10,4,19,18117,18360,16191,-2169
2016,10,4,20,18036,18381,16186,-2195
2016,10,4,21,18032,18506,16562,-1944
2016,10,4,22,18083,18573,16764,-1809
2016,10,4,23,18243,18778,16840,-1938
2016,10,5,0,18607,19094,17378,-1716
2016,10,5,1,18110,18501,17208,-1293
2016,10,5,2,17106,17439,15378,-2061
2016,10,5,3,15851,16080,13975,-2105
2016,10,5,4,14553,14752,12380,-2372
2016,10,5,5,13475,13735,11719,-2016
2016,10,5,6,12888,13125,11443,-1682
2016,10,5,7,12526,12714,10882,-1832
2016,10,5,8,12375,12534,10792,-1742
2016,10,5,9,12526,12735,10967,-1768
2016,10,5,10,13351,13537,11840,-1697
2016,10,5,11,15079,15336,13660,-1676
2016,10,5,12,16310,16516,15141,-1375
2016,10,5,13,16914,17086,15853,-1233
2016,10,5,14,17311,17422,15919,-1503
2016,10,5,15,17569,17637,15934,-1703
2016,10,5,16,17629,17767,16176,-1591
2016,10,5,17,17648,17863,15999,-1864
2016,10,5,18,17767,18026,15851,-2175
2016,10,5,19,17773,18120,16064,-2056
2016,10,5,20,17785,18250,16511,-1739
2016,10,5,21,17865,18444,17070,-1374
2016,10,5,22,17920,18502,16811,-1691
2016,10,5,23,18096,18606,17319,-1287
2016,10,6,0,18478,18989,17753,-1236
2016,10,6,1,18037,18360,17098,-1262
2016,10,6,2,17035,17331,15867,-1464
2016,10,6,3,15731,16030,14032,-1998
2016,10,6,4,14376,14685,12290,-2395
2016,10,6,5,13274,13732,11717,-2015
2016,10,6,6,12698,13125,11292,-1833
2016,10,6,7,12352,12769,10614,-2155
2016,10,6,8,12218,12634,10610,-2024
2016,10,6,9,12384,12793,10832,-1961
2016,10,6,10,13217,13609,11624,-1985
2016,10,6,11,14959,15406,13501,-1905
2016,10,6,12,16202,16591,14998,-1593
2016,10,6,13,16833,17181,15705,-1476
2016,10,6,14,17286,17560,15885,-1675
2016,10,6,15,17574,17815,16015,-1800
2016,10,6,16,17705,18042,16509,-1533
2016,10,6,17,17782,18195,16543,-1652
2016,10,6,18,17938,18413,15985,-2428
2016,10,6,19,17987,18577,15931,-2646
2016,10,6,20,18031,18770,16601,-2169
2016,10,6,21,18135,18958,17385,-1573
2016,10,6,22,18156,18959,17361,-1598
2016,10,6,23,18300,18992,17304,-1688
2016,10,7,0,18644,19284,17775,-1509
2016,10,7,1,18166,18627,16988,-1639
2016,10,7,2,17152,17582,15762,-1820
2016,10,7,3,15827,16187,14437,-1750
2016,10,7,4,14461,14840,12796,-2044
2016,10,7,5,13354,13820,11660,-2160
2016,10,7,6,12759,13194,11232,-1962
2016,10,7,7,12408,12803,10765,-2038
2016,10,7,8,12259,12624,10561,-2063
2016,10,7,9,12410,12783,10921,-1862
2016,10,7,10,13223,13602,11933,-1669
2016,10,7,11,14951,15388,13467,-1921
2016,10,7,12,16250,16611,15017,-1594
2016,10,7,13,16962,17296,15419,-1877
2016,10,7,14,17505,17765,15539,-2226
2016,10,7,15,17872,18074,15686,-2388
2016,10,7,16,17990,18313,16195,-2118
2016,10,7,17,18027,18455,16288,-2167
2016,10,7,18,18136,18680,16383,-2297
2016,10,7,19,18156,18801,16405,-2396
2016,10,7,20,18137,18812,16487,-2325
2016,10,7,21,18145,18834,16588,-2246
2016,10,7,22,18040,18666,16622,-2044
2016,10,7,23,18128,18557,16786,-1771
2016,10,8,0,18363,18672,17388,-1284
2016,10,8,1,17829,18062,16514,-1548
2016,10,8,2,16966,17255,15639,-1616
2016,10,8,3,15880,16193,14084,-2109
2016,10,8,4,14645,15021,12886,-2135
2016,10,8,5,13778,14034,12000,-2034
2016,10,8,6,13103,13338,11467,-1871
2016,10,8,7,12681,12941,11082,-1859
2016,10,8,8,12459,12711,10859,-1852
2016,10,8,9,12443,12678,10967,-1711
2016,10,8,10,12710,12932,11606,-1326
2016,10,8,11,13370,13516,11741,-1775
2016,10,8,12,14112,14210,12424,-1786
2016,10,8,13,15096,15156,13147,-2009
2016,10,8,14,15970,15881,13869,-2012
2016,10,8,15,16476,16390,14276,-2114
2016,10,8,16,16654,16623,14430,-2193
2016,10,8,17,16621,16750,14393,-2357
2016,10,8,18,16515,16707,14317,-2390
2016,10,8,19,16373,16639,14145,-2494
2016,10,8,20,16309,16576,14242,-2334
2016,10,8,21,16419,16688,14377,-2311
2016,10,8,22,16653,16976,14796,-2180
2016,10,8,23,17142,17463,15116,-2347
2016,10,9,0,17551,17594,15256,-2338
2016,10,9,1,17140,17190,14723,-2467
2016,10,9,2,16453,16553,13930,-2623
2016,10,9,3,15628,15679,12910,-2769
2016,10,9,4,14678,14720,11996,-2724
2016,10,9,5,13644,13924,11609,-2315
2016,10,9,6,13018,13286,11319,-1967
2016,10,9,7,12607,12859,11181,-1678
2016,10,9,8,12367,12593,11124,-1469
2016,10,9,9,12282,12431,10882,-1549
2016,10,9,10,12422,12520,11047,-1473
2016,10,9,11,12808,12903,11305,-1598
2016,10,9,12,13212,13435,11886,-1549
2016,10,9,13,13973,14277,12340,-1937
2016,10,9,14,14720,15075,12952,-2123
2016,10,9,15,15173,15604,13628,-1976
2016,10,9,16,15408,15859,14272,-1587
2016,10,9,17,15484,15932,14084,-1848
2016,10,9,18,15446,15973,13774,-2199
2016,10,9,19,15371,15882,13715,-2167
2016,10,9,20,15372,15891,13784,-2107
2016,10,9,21,15555,16000,14078,-1922
2016,10,9,22,15841,16149,14279,-1870
2016,10,9,23,16487,16660,14556,-2104
2016,10,10,0,17059,17060,14882,-2178
2016,10,10,1,16765,16718,14747,-1971
2016,10,10,2,16008,15948,14106,-1842
2016,10,10,3,15064,15155,13016,-2139
2016,10,10,4,14059,14236,12259,-1977
2016,10,10,5,13032,13342,11344,-1998
2016,10,10,6,12597,12759,10881,-1878
2016,10,10,7,12352,12434,10429,-2005
2016,10,10,8,12278,12321,10508,-1813
2016,10,10,9,12507,12489,10558,-1931
2016,10,10,10,13413,13187,11083,-2104
2016,10,10,11,15130,14444,12083,-2361
2016,10,10,12,16369,15553,13394,-2159
2016,10,10,13,16912,16443,14120,-2323
2016,10,10,14,17208,16936,14598,-2338
2016,10,10,15,17296,17138,14958,-2180
2016,10,10,16,17277,17150,14636,-2514
2016,10,10,17,17206,17075,14327,-2748
2016,10,10,18,17163,17059,14370,-2689
2016,10,10,19,17099,17020,14053,-2967
2016,10,10,20,17082,17054,14278,-2776
2016,10,10,21,17218,17290,14633,-2657
2016,10,10,22,17405,17611,14959,-2652
2016,10,10,23,17848,18114,15492,-2622
2016,10,11,0,18204,18537,16395,-2142
2016,10,11,1,17784,17994,15862,-2132
2016,10,11,2,16793,17080,14998,-2082
2016,10,11,3,15534,15830,13274,-2556
2016,10,11,4,14241,14582,12095,-2487
2016,10,11,5,13358,13646,11274,-2372
2016,10,11,6,12852,13108,11371,-1737
2016,10,11,7,12573,12786,11118,-1668
2016,10,11,8,12493,12679,11153,-1526
2016,10,11,9,12717,12907,11362,-1545
2016,10,11,10,13630,13870,12043,-1827
2016,10,11,11,15408,15728,13817,-1911
2016,10,11,12,16598,16973,15233,-1740
2016,10,11,13,17012,17454,15426,-2028
2016,10,11,14,17187,17605,15691,-1914
2016,10,11,15,17228,17653,15448,-2205
2016,10,11,16,17195,17604,15453,-2151
2016,10,11,17,17118,17564,15362,-2202
2016,10,11,18,17126,17591,15390,-2201
2016,10,11,19,17067,17596,15669,-1927
2016,10,11,20,17034,17637,15550,-2087
2016,10,11,21,17158,17813,16035,-1778
2016,10,11,22,17339,18004,16185,-1819
2016,10,11,23,17801,18472,16638,-1834
2016,10,12,0,18134,18670,17091,-1579
2016,10,12,1,17669,18075,16550,-1525
2016,10,12,2,16689,17111,15781,-1330
2016,10,12,3,15393,15889,14418,-1471
2016,10,12,4,14077,14683,13004,-1679
2016,10,12,5,13192,13693,12008,-1685
2016,10,12,6,12675,13117,11718,-1399
2016,10,12,7,12370,12798,11537,-1261
2016,10,12,8,12269,12685,11608,-1077
2016,10,12,9,12464,12881,11854,-1027
2016,10,12,10,13320,13673,12196,-1477
2016,10,12,11,15101,15282,13686,-1596
2016,10,12,12,16361,16422,15204,-1218
2016,10,12,13,16860,17028,15451,-1577
2016,10,12,14,17149,17411,15364,-2047
2016,10,12,15,17285,17617,15469,-2148
2016,10,12,16,17371,17701,15358,-2343
2016,10,12,17,17354,17725,15338,-2387
2016,10,12,18,17410,17764,15341,-2423
2016,10,12,19,17393,17744,15418,-2326
2016,10,12,20,17399,17762,15728,-2034
2016,10,12,21,17528,17870,15726,-2144
2016,10,12,22,17656,18039,16151,-1888
2016,10,12,23,18056,18419,16561,-1858
2016,10,13,0,18303,18765,17446,-1319
2016,10,13,1,17805,18197,17013,-1184
2016,10,13,2,16777,17258,15659,-1599
2016,10,13,3,15434,15971,14210,-1761
2016,10,13,4,14067,14673,13022,-1651
2016,10,13,5,13197,13714,12650,-1064
2016,10,13,6,12647,13122,12484,-638
2016,10,13,7,12320,12787,12333,-454
2016,10,13,8,12201,12695,12334,-361
2016,10,13,9,12371,12859,11949,-910
2016,10,13,10,13186,13697,12489,-1208
2016,10,13,11,14940,15506,14324,-1182
2016,10,13,12,16254,16786,16280,-506
2016,10,13,13,16847,17428,16371,-1057
2016,10,13,14,17288,17813,16706,-1107
2016,10,13,15,17543,18085,16400,-1685
2016,10,13,16,17608,18244,16551,-1693
2016,10,13,17,17607,18270,16700,-1570
2016,10,13,18,17679,18336,16786,-1550
2016,10,13,19,17639,18251,16740,-1511
2016,10,13,20,17635,18174,16835,-1339
2016,10,13,21,17739,18217,16904,-1313
2016,10,13,22,17882,18314,17058,-1256
2016,10,13,23,18273,18663,17163,-1500
2016,10,14,0,18462,18838,17701,-1137
2016,10,14,1,17902,18295,17189,-1106
2016,10,14,2,16988,17309,15976,-1333
2016,10,14,3,15762,15961,14552,-1409
2016,10,14,4,14473,14666,13167,-1499
2016,10,14,5,13316,13691,11969,-1722
2016,10,14,6,12753,13100,11268,-1832
2016,10,14,7,12439,12799,10985,-1814
2016,10,14,8,12327,12694,11036,-1658
2016,10,14,9,12516,12900,11191,-1709
2016,10,14,10,13376,13789,12138,-1651
2016,10,14,11,15152,15620,13791,-1829
2016,10,14,12,16423,16883,15002,-1881
2016,10,14,13,16914,17367,15169,-2198
2016,10,14,14,17178,17546,14845,-2701
2016,10,14,15,17269,17542,14689,-2853
2016,10,14,16,17215,17436,14699,-2737
2016,10,14,17,17038,17298,14814,-2484
2016,10,14,18,16966,17259,14892,-2367
2016,10,14,19,16839,17177,14766,-2411
2016,10,14,20,16737,17165,14559,-2606
2016,10,14,21,16791,17342,14684,-2658
2016,10,14,22,16853,17506,14866,-2640
2016,10,14,23,17304,17910,15141,-2769
2016,10,15,0,17506,18079,15685,-2394
2016,10,15,1,17088,17606,15324,-2282
2016,10,15,2,16360,16889,14535,-2354
2016,10,15,3,15386,15924,13726,-2198
2016,10,15,4,14286,14811,12052,-2759
2016,10,15,5,13520,13836,11062,-2774
2016,10,15,6,12913,13256,11032,-2224
2016,10,15,7,12544,12913,10902,-2011
2016,10,15,8,12375,12746,10792,-1954
2016,10,15,9,12408,12762,10877,-1885
2016,10,15,10,12752,13091,11414,-1677
2016,10,15,11,13390,13800,11315,-2485
2016,10,15,12,14044,14498,12075,-2423
2016,10,15,13,14762,15309,13162,-2147
2016,10,15,14,15294,15727,13384,-2343
2016,10,15,15,15481,15864,13390,-2474
2016,10,15,16,15467,15808,13476,-2332
2016,10,15,17,15310,15674,13270,-2404
2016,10,15,18,15114,15524,12456,-3068
2016,10,15,19,14960,15455,12247,-3208
2016,10,15,20,14905,15462,12512,-2950
2016,10,15,21,15052,15651,12839,-2812
2016,10,15,22,15333,15989,13661,-2328
2016,10,15,23,16064,16635,14471,-2164
2016,10,16,0,16443,16956,15388,-1568
2016,10,16,1,16139,16632,14915,-1717
2016,10,16,2,15526,16078,13835,-2243
2016,10,16,3,14704,15289,12879,-2410
2016,10,16,4,13781,14397,12058,-2339
2016,10,16,5,13052,13606,11849,-1757
2016,10,16,6,12490,13001,11320,-1681
2016,10,16,7,12135,12589,11094,-1495
2016,10,16,8,11954,12362,10929,-1433
2016,10,16,9,11929,12361,11271,-1090
2016,10,16,10,12108,12554,11224,-1330
2016,10,16,11,12522,12991,11450,-1541
2016,10,16,12,12968,13470,12174,-1296
2016,10,16,13,13611,14224,12870,-1354
2016,10,16,14,14237,14876,13169,-1707
2016,10,16,15,14626,15301,13113,-2188
2016,10,16,16,14879,15500,13121,-2379
2016,10,16,17,14995,15637,13124,-2513
2016,10,16,18,15035,15700,12982,-2718
2016,10,16,19,15034,15746,13096,-2650
2016,10,16,20,15131,15882,13293,-2589
2016,10,16,21,15389,16198,13713,-2485
2016,10,16,22,15722,16706,14373,-2333
2016,10,16,23,16505,17451,15269,-2182
2016,10,17,0,16883,17664,15766,-1898
2016,10,17,1,16485,17204,15056,-2148
2016,10,17,2,15796,16377,14171,-2206
2016,10,17,3,14849,15345,12738,-2607
2016,10,17,4,13855,14308,11520,-2788
2016,10,17,5,13093,13471,11006,-2465
2016,10,17,6,12656,12933,10755,-2178
2016,10,17,7,12396,12651,10464,-2187
2016,10,17,8,12309,12558,10361,-2197
2016,10,17,9,12494,12794,10433,-2361
2016,10,17,10,13333,13667,11311,-2356
2016,10,17,11,15045,15527,13536,-1991
2016,10,17,12,16478,16960,15309,-1651
2016,10,17,13,17221,17630,15911,-1719
2016,10,17,14,17768,18096,16155,-1941
2016,10,17,15,18205,18553,16496,-2057
2016,10,17,16,18389,18876,16544,-2332
2016,10,17,17,18512,19071,16562,-2509
2016,10,17,18,18702,19293,16635,-2658
2016,10,17,19,18800,19425,16682,-2743
2016,10,17,20,18878,19505,17135,-2370
2016,10,17,21,18998,19632,17354,-2278
2016,10,17,22,19003,19756,17572,-2184
2016,10,17,23,19319,20132,18329,-1803
2016,10,18,0,19341,20153,18705,-1448
2016,10,18,1,18684,19415,18404,-1011
2016,10,18,2,17850,18361,16790,-1571
2016,10,18,3,16649,16944,15047,-1897
2016,10,18,4,15361,15582,13366,-2216
2016,10,18,5,14289,14599,12371,-2228
2016,10,18,6,13616,13936,11866,-2070
2016,10,18,7,13209,13520,11527,-1993
2016,10,18,8,13012,13343,11142,-2201
2016,10,18,9,13145,13537,11666,-1871
2016,10,18,10,14003,14389,12709,-1680
2016,10,18,11,15853,16279,15131,-1148
2016,10,18,12,17385,17607,16484,-1123
2016,10,18,13,18179,18249,16695,-1554
2016,10,18,14,18865,18839,17206,-1633
2016,10,18,15,19479,19348,17765,-1583
2016,10,18,16,19821,19735,18122,-1613
2016,10,18,17,20019,20060,18423,-1637
2016,10,18,18,20276,20406,18860,-1546
2016,10,18,19,20392,20592,19391,-1201
2016,10,18,20,20471,20756,19464,-1292
2016,10,18,21,20559,20836,19661,-1175
2016,10,18,22,20458,20845,19638,-1207
2016,10,18,23,20685,21143,19800,-1343
2016,10,19,0,20548,21070,19673,-1397
2016,10,19,1,19772,20320,18786,-1534
2016,10,19,2,18875,19130,17360,-1770
2016,10,19,3,17575,17682,15908,-1774
2016,10,19,4,16157,16265,14884,-1381
2016,10,19,5,14948,15171,13417,-1754
2016,10,19,6,14176,14470,12528,-1942
2016,10,19,7,13679,14007,12046,-1961
2016,10,19,8,13423,13780,11609,-2171
2016,10,19,9,13536,13880,12072,-1808
2016,10,19,10,14398,14753,12942,-1811
2016,10,19,11,16325,16676,15149,-1527
2016,10,19,12,17891,18018,16472,-1546
2016,10,19,13,18611,18637,16970,-1667
2016,10,19,14,19209,19274,17785,-1489
2016,10,19,15,19721,19722,18120,-1602
2016,10,19,16,20100,20024,18112,-1912
2016,10,19,17,20295,20292,18992,-1300
2016,10,19,18,20515,20592,19121,-1471
2016,10,19,19,20579,20793,19336,-1457
2016,10,19,20,20605,20894,19262,-1632
2016,10,19,21,20649,20954,19790,-1164
2016,10,19,22,20558,20702,19468,-1234
2016,10,19,23,20773,20738,19290,-1448
2016,10,20,0,20589,20565,19559,-1006
2016,10,20,1,19751,19699,18474,-1225
2016,10,20,2,18653,18452,17301,-1151
2016,10,20,3,17160,17108,15755,-1353
2016,10,20,4,15601,15664,13979,-1685
2016,10,20,5,14237,14526,12773,-1753
2016,10,20,6,13572,13788,11827,-1961
2016,10,20,7,13140,13341,11623,-1718
2016,10,20,8,12930,13103,11585,-1518
2016,10,20,9,13037,13230,11726,-1504
2016,10,20,10,13827,14023,12672,-1351
2016,10,20,11,15620,15900,14299,-1601
2016,10,20,12,17022,17229,15924,-1305
2016,10,20,13,17622,17801,16353,-1448
2016,10,20,14,18129,18233,16940,-1293
2016,10,20,15,18478,18581,17317,-1264
2016,10,20,16,18642,18809,17242,-1567
2016,10,20,17,18685,18901,17533,-1368
2016,10,20,18,18779,18959,17741,-1218
2016,10,20,19,18749,18953,17773,-1180
2016,10,20,20,18753,18923,18134,-789
2016,10,20,21,18841,19126,18392,-734
2016,10,20,22,18847,19350,18499,-851
2016,10,20,23,19228,19699,18592,-1107
2016,10,21,0,19120,19456,18543,-913
2016,10,21,1,18347,18815,17766,-1049
2016,10,21,2,17401,17856,16559,-1297
2016,10,21,3,16089,16661,15157,-1504
2016,10,21,4,14756,15410,13737,-1673
2016,10,21,5,14088,14439,12649,-1790
2016,10,21,6,13484,13858,12395,-1463
2016,10,21,7,13092,13485,12143,-1342
2016,10,21,8,12913,13344,11870,-1474
2016,10,21,9,13037,13504,11938,-1566
2016,10,21,10,13842,14333,12865,-1468
2016,10,21,11,15622,16183,14952,-1231
2016,10,21,12,17113,17679,16674,-1005
2016,10,21,13,17836,18471,17088,-1383
2016,10,21,14,18417,19092,17276,-1816
2016,10,21,15,18823,19435,17654,-1781
2016,10,21,16,19015,19565,17985,-1580
2016,10,21,17,19071,19489,17846,-1643
2016,10,21,18,19119,19509,17644,-1865
2016,10,21,19,19096,19331,17612,-1719
2016,10,21,20,19056,19254,17527,-1727
2016,10,21,21,19056,19347,17671,-1676
2016,10,21,22,18943,19348,17718,-1630
2016,10,21,23,19186,19543,17926,-1617
2016,10,22,0,18953,19284,18081,-1203
2016,10,22,1,18152,18576,17341,-1235
2016,10,22,2,17364,17749,16332,-1417
2016,10,22,3,16313,16697,15265,-1432
2016,10,22,4,15125,15489,13999,-1490
2016,10,22,5,14432,14380,13312,-1068
2016,10,22,6,13707,13607,12691,-916
2016,10,22,7,13215,13151,12082,-1069
2016,10,22,8,12906,12864,11898,-966
2016,10,22,9,12815,12776,11717,-1059
2016,10,22,10,13026,13019,12092,-927
2016,10,22,11,13602,13636,12824,-812
2016,10,22,12,14285,14431,13810,-621
2016,10,22,13,15056,15296,14224,-1072
2016,10,22,14,15812,16072,14917,-1155
2016,10,22,15,16302,16522,15189,-1333
2016,10,22,16,16498,16727,15343,-1384
2016,10,22,17,16509,16743,15382,-1361
2016,10,22,18,16439,16653,15337,-1316
2016,10,22,19,16333,16506,14954,-1552
2016,10,22,20,16302,16380,14756,-1624
2016,10,22,21,16388,16492,14944,-1548
2016,10,22,22,16524,16869,15163,-1706
2016,10,22,23,17265,17452,15661,-1791
2016,10,23,0,17353,17463,15359,-2104
2016,10,23,1,16779,17061,14966,-2095
2016,10,23,2,16174,16514,14329,-2185
2016,10,23,3,15389,15696,13651,-2045
2016,10,23,4,14490,14732,12882,-1850
2016,10,23,5,13842,13978,12124,-1854
2016,10,23,6,13267,13361,11509,-1852
2016,10,23,7,12864,12983,11302,-1681
2016,10,23,8,12641,12734,10935,-1799
2016,10,23,9,12599,12664,10786,-1878
2016,10,23,10,12819,12872,11192,-1680
2016,10,23,11,13289,13369,12081,-1288
2016,10,23,12,13819,13846,12670,-1176
2016,10,23,13,14433,14538,13088,-1450
2016,10,23,14,15051,15104,13500,-1604
2016,10,23,15,15403,15356,13488,-1868
2016,10,23,16,15509,15475,13493,-1982
2016,10,23,17,15537,15478,13443,-2035
2016,10,23,18,15451,15440,13467,-1973
2016,10,23,19,15375,15461,13729,-1732
2016,10,23,20,15384,15517,13571,-1946
2016,10,23,21,15586,15834,13802,-2032
2016,10,23,22,15931,16317,14107,-2210
2016,10,23,23,16922,17237,15000,-2237
2016,10,24,0,17204,17367,15290,-2077
2016,10,24,1,16874,16947,14835,-2112
2016,10,24,2,16176,16115,13928,-2187
2016,10,24,3,15184,15093,12900,-2193
2016,10,24,4,14098,14067,11991,-2076
2016,10,24,5,12913,13327,11164,-2163
2016,10,24,6,12457,12827,10778,-2049
2016,10,24,7,12201,12531,10583,-1948
2016,10,24,8,12121,12424,10811,-1613
2016,10,24,9,12336,12589,10836,-1753
2016,10,24,10,13196,13594,11650,-1944
2016,10,24,11,14929,15478,13169,-2309
2016,10,24,12,16350,16848,14664,-2184
2016,10,24,13,16862,17312,14899,-2413
2016,10,24,14,17197,17619,15180,-2439
2016,10,24,15,17404,17808,15310,-2498
2016,10,24,16,17422,17875,15540,-2335
2016,10,24,17,17363,17832,15543,-2289
2016,10,24,18,17334,17767,15515,-2252
2016,10,24,19,17264,17659,15351,-2308
2016,10,24,20,17240,17668,15364,-2304
2016,10,24,21,17371,17864,15605,-2259
2016,10,24,22,17567,18221,15875,-2346
2016,10,24,23,18285,19045,16234,-2811
2016,10,25,0,18362,19013,16567,-2446
2016,10,25,1,17771,18400,15861,-2539
2016,10,25,2,16916,17441,15453,-1988
2016,10,25,3,15731,16159,14009,-2150
2016,10,25,4,14502,14852,12753,-2099
2016,10,25,5,13408,13897,11981,-1916
2016,10,25,6,12890,13388,11864,-1524
2016,10,25,7,12602,13064,11678,-1386
2016,10,25,8,12502,12963,11706,-1257
2016,10,25,9,12705,13204,11902,-1302
2016,10,25,10,13574,14125,12361,-1764
2016,10,25,11,15317,16063,13709,-2354
2016,10,25,12,16696,17429,15003,-2426
2016,10,25,13,17117,17809,15292,-2517
2016,10,25,14,17361,17936,15295,-2641
2016,10,25,15,17468,17992,15314,-2678
2016,10,25,16,17455,18017,15229,-2788
2016,10,25,17,17362,17977,15369,-2608
2016,10,25,18,17334,17834,15130,-2704
2016,10,25,19,17267,17755,15210,-2545
2016,10,25,20,17257,17730,15106,-2624
2016,10,25,21,17457,17973,15511,-2462
2016,10,25,22,17709,18424,15854,-2570
2016,10,25,23,18459,19236,16192,-3044
2016,10,26,0,18505,19282,16310,-2972
2016,10,26,1,17952,18698,15808,-2890
2016,10,26,2,17109,17787,14948,-2839
2016,10,26,3,15886,16474,14158,-2316
2016,10,26,4,14632,15140,12762,-2378
2016,10,26,5,13650,14184,11810,-2374
2016,10,26,6,0,13624,11178,-2446
2016,10,26,7,0,13329,10842,-2487
2016,10,26,8,0,13234,10693,-2541
2016,10,26,9,0,13481,10806,-2675
2016,10,26,10,0,14449,11558,-2891
2016,10,26,11,0,16393,13575,-2818
2016,10,26,12,0,17740,14575,-3165
2016,10,26,13,0,18050,14917,-3133
2016,10,26,14,0,18163,14791,-3372
2016,10,26,15,0,18186,15525,-2661
2016,10,26,16,0,18131,15677,-2454
2016,10,26,17,0,17993,15272,-2721
2016,10,26,18,0,17901,15173,-2728
2016,10,26,19,0,17807,14897,-2910
2016,10,26,20,0,17825,14956,-2869
2016,10,26,21,0,18083,15114,-2969
2016,10,26,22,0,18549,15331,-3218
2016,10,26,23,0,19447,15935,-3512
2016,10,27,0,0,19383,16287,-3096
2016,10,27,1,0,18845,15917,-2928
2016,10,27,2,0,17959,15334,-2625
2016,10,27,3,0,16683,13691,-2992
2016,10,27,4,0,15334,12589,-2745
2016,10,27,5,13885,14407,11638,-2769
2016,10,27,6,13345,13833,11351,-2482
2016,10,27,7,13039,13536,11101,-2435
2016,10,27,8,12936,13463,11128,-2335
2016,10,27,9,13143,13709,11363,-2346
2016,10,27,10,14035,14643,11825,-2818
2016,10,27,11,15866,16557,13933,-2624
2016,10,27,12,17355,18037,15580,-2457
2016,10,27,13,17837,18553,15842,-2711
2016,10,27,14,18148,18970,16145,-2825
2016,10,27,15,18322,19266,16319,-2947
2016,10,27,16,18320,19389,16793,-2596
2016,10,27,17,18183,19386,16966,-2420
2016,10,27,18,18152,19406,16731,-2675
2016,10,27,19,17993,19392,16378,-3014
2016,10,27,20,17918,19444,16447,-2997
2016,10,27,21,18070,19639,16550,-3089
2016,10,27,22,18303,19961,17179,-2782
2016,10,27,23,18951,20102,16952,-3150
2016,10,28,0,18888,19781,17305,-2476
2016,10,28,1,18189,19114,16617,-2497
2016,10,28,2,17314,18083,15709,-2374
2016,10,28,3,16065,16773,14593,-2180
2016,10,28,4,14783,15408,13083,-2325
2016,10,28,5,13845,14427,12419,-2008
2016,10,28,6,13247,13808,11709,-2099
2016,10,28,7,12884,13432,11221,-2211
2016,10,28,8,12741,13313,11142,-2171
2016,10,28,9,12906,13520,11030,-2490
2016,10,28,10,13756,14398,11508,-2890
2016,10,28,11,15553,16270,13330,-2940
2016,10,28,12,17034,17698,15162,-2536
2016,10,28,13,17475,18119,15370,-2749
2016,10,28,14,17726,18394,15058,-3336
2016,10,28,15,17851,18492,14982,-3510
2016,10,28,16,17831,18484,15145,-3339
2016,10,28,17,17664,18389,14878,-3511
2016,10,28,18,17605,18186,14557,-3629
2016,10,28,19,17464,17965,14103,-3862
2016,10,28,20,17365,17819,14148,-3671
2016,10,28,21,17443,17897,14770,-3127
2016,10,28,22,17580,18225,15279,-2946
2016,10,28,23,18198,18867,16079,-2788
2016,10,29,0,18111,18726,16020,-2706
2016,10,29,1,17537,18248,15180,-3068
2016,10,29,2,16907,17552,14383,-3169
2016,10,29,3,15966,16577,13235,-3342
2016,10,29,4,14875,15434,12222,-3212
2016,10,29,5,13942,14527,11810,-2717
2016,10,29,6,13315,13911,11277,-2634
2016,10,29,7,12930,13572,10821,-2751
2016,10,29,8,12729,13360,10588,-2772
2016,10,29,9,12744,13374,10677,-2697
2016,10,29,10,13077,13698,11074,-2624
2016,10,29,11,13752,14384,11333,-3051
2016,10,29,12,14546,15171,12190,-2981
2016,10,29,13,15196,15913,12673,-3240
2016,10,29,14,15747,16455,13179,-3276
2016,10,29,15,16013,16830,13418,-3412
2016,10,29,16,15969,16770,13303,-3467
2016,10,29,17,15808,16551,13272,-3279
2016,10,29,18,15591,16363,13246,-3117
2016,10,29,19,15399,16243,13050,-3193
2016,10,29,20,15312,16191,13244,-2947
2016,10,29,21,15466,16352,13423,-2929
2016,10,29,22,15823,16831,13989,-2842
2016,10,29,23,16661,17507,14635,-2872
2016,10,30,0,16702,17375,14815,-2560
2016,10,30,1,16237,16970,14149,-2821
2016,10,30,2,15745,16326,13276,-3050
2016,10,30,3,14959,15477,12292,-3185
2016,10,30,4,14046,14503,11926,-2577
2016,10,30,5,13290,13721,10963,-2758
2016,10,30,6,12679,13081,10517,-2564
2016,10,30,7,12267,12686,10374,-2312
2016,10,30,8,12032,12480,10235,-2245
2016,10,30,9,11968,12411,10250,-2161
2016,10,30,10,12141,12602,10150,-2452
2016,10,30,11,12553,13045,10593,-2452
2016,10,30,12,13134,13603,11134,-2469
2016,10,30,13,13741,14295,11887,-2408
2016,10,30,14,14406,14999,12724,-2275
2016,10,30,15,14889,15442,12815,-2627
2016,10,30,16,15240,15773,12905,-2868
2016,10,30,17,15382,16050,13097,-2953
2016,10,30,18,15398,16241,13434,-2807
2016,10,30,19,15375,16356,13689,-2667
2016,10,30,20,15399,16524,13606,-2918
2016,10,30,21,15570,16919,14075,-2844
2016,10,30,22,15911,17522,15055,-2467
2016,10,30,23,16754,17955,15656,-2299
2016,10,31,0,16909,17760,15383,-2377
2016,10,31,1,16425,17314,14433,-2881
2016,10,31,2,15769,16527,13803,-2724
2016,10,31,3,14794,15480,12364,-3116
2016,10,31,4,13760,14410,11789,-2621
2016,10,31,5,13154,13558,11455,-2103
2016,10,31,6,12705,13048,11026,-2022
2016,10,31,7,12440,12753,10763,-1990
2016,10,31,8,12362,12687,10515,-2172
2016,10,31,9,12601,12907,10681,-2226
2016,10,31,10,13530,13834,11525,-2309
2016,10,31,11,15357,15789,13042,-2747
2016,10,31,12,16871,17363,14892,-2471
2016,10,31,13,17337,17807,15124,-2683
2016,10,31,14,17619,17939,14806,-3133
2016,10,31,15,17768,17971,14812,-3159
2016,10,31,16,17740,17921,14809,-3112
2016,10,31,17,17640,17785,14497,-3288
2016,10,31,18,17576,17700,14434,-3266
2016,10,31,19,17514,17585,14141,-3444
2016,10,31,20,17518,17605,14177,-3428
2016,10,31,21,17717,17769,14922,-2847
2016,10,31,22,18024,18037,14945,-3092
2016,10,31,23,18752,18651,15619,-3032
2016,11,1,0,18773,18525,15602,-2923
2016,11,1,1,18226,18248,15409,-2839
2016,11,1,2,17396,17577,14767,-2810
2016,11,1,3,16136,16366,13203,-3163
2016,11,1,4,14833,15077,12091,-2986
2016,11,1,5,13733,14182,11433,-2749
2016,11,1,6,13186,13695,11303,-2392
2016,11,1,7,12880,13416,11267,-2149
2016,11,1,8,12784,13343,11088,-2255
2016,11,1,9,13007,13600,11357,-2243
2016,11,1,10,13940,14540,12101,-2439
2016,11,1,11,15769,16484,13851,-2633
2016,11,1,12,17343,17894,15322,-2572
2016,11,1,13,17660,18180,15827,-2353
2016,11,1,14,17781,18234,15902,-2332
2016,11,1,15,17839,18153,15716,-2437
2016,11,1,16,17742,17957,15427,-2530
2016,11,1,17,17598,17882,14863,-3019
2016,11,1,18,17543,17801,14961,-2840
2016,11,1,19,17435,17686,14956,-2730
2016,11,1,20,17432,17751,15040,-2711
2016,11,1,21,17898,17961,15338,-2623
2016,11,1,22,17934,18453,15706,-2747
2016,11,1,23,18662,19228,16416,-2812
2016,11,2,0,18525,19046,16560,-2486
2016,11,2,1,18068,18459,16204,-2255
2016,11,2,2,17090,17528,15371,-2157
2016,11,2,3,15778,16228,13768,-2460
2016,11,2,4,14391,14893,12563,-2330
2016,11,2,5,13459,13882,11791,-2091
2016,11,2,6,12922,13296,11500,-1796
2016,11,2,7,12593,12949,11145,-1804
2016,11,2,8,12479,12817,11167,-1650
2016,11,2,9,12659,13003,11192,-1811
2016,11,2,10,13508,13878,11753,-2125
2016,11,2,11,15301,15750,13311,-2439
2016,11,2,12,16852,17186,14933,-2253
2016,11,2,13,17215,17533,14877,-2656
2016,11,2,14,17416,17750,14883,-2867
2016,11,2,15,17566,17860,14852,-3008
2016,11,2,16,17595,17874,14599,-3275
2016,11,2,17,17533,17799,14568,-3231
2016,11,2,18,17568,17892,14702,-3190
2016,11,2,19,17537,17902,14810,-3092
2016,11,2,20,17584,17936,14800,-3136
2016,11,2,21,17987,18162,15142,-3020
2016,11,2,22,17954,18661,15445,-3216
2016,11,2,23,18551,19264,16147,-3117
2016,11,3,0,18343,19014,16323,-2691
2016,11,3,1,17823,18331,15374,-2957
2016,11,3,2,16898,17395,14523,-2872
2016,11,3,3,15639,16107,13050,-3057
2016,11,3,4,14304,14871,11970,-2901
2016,11,3,5,13416,13925,11242,-2683
2016,11,3,6,12828,13225,10386,-2839
2016,11,3,7,12474,12813,10133,-2680
2016,11,3,8,12354,12661,9937,-2724
2016,11,3,9,12535,12856,10340,-2516
2016,11,3,10,13410,13705,11186,-2519
2016,11,3,11,15251,15638,12546,-3092
2016,11,3,12,16918,17228,14131,-3097
2016,11,3,13,17408,17780,14719,-3061
2016,11,3,14,17777,18192,14943,-3249
2016,11,3,15,18035,18429,14713,-3716
2016,11,3,16,17927,18506,14519,-3987
2016,11,3,17,17895,18404,14271,-4133
2016,11,3,18,17927,18482,14406,-4076
2016,11,3,19,17879,18414,14624,-3790
2016,11,3,20,17878,18340,14733,-3607
2016,11,3,21,18216,18482,15050,-3432
2016,11,3,22,18142,18786,15357,-3429
2016,11,3,23,18661,19216,15674,-3542
2016,11,4,0,18436,18895,15532,-3363
2016,11,4,1,17897,18245,15112,-3133
2016,11,4,2,17022,17274,14333,-2941
2016,11,4,3,15840,16004,12991,-3013
2016,11,4,4,14588,14675,11949,-2726
2016,11,4,5,13484,13714,11229,-2485
2016,11,4,6,12887,13142,10899,-2243
2016,11,4,7,12532,12787,10227,-2560
2016,11,4,8,12391,12664,10349,-2315
2016,11,4,9,12553,12857,10744,-2113
2016,11,4,10,13352,13732,11474,-2258
2016,11,4,11,15115,15585,12826,-2759
2016,11,4,12,16710,17124,14423,-2701
2016,11,4,13,17118,17516,14482,-3034
2016,11,4,14,17370,17721,14459,-3262
2016,11,4,15,17520,17771,14345,-3426
2016,11,4,16,17530,17743,14278,-3465
2016,11,4,17,17397,17564,13971,-3593
2016,11,4,18,17312,17453,14262,-3191
2016,11,4,19,17214,17339,14149,-3190
2016,11,4,20,17188,17325,14218,-3107
2016,11,4,21,17482,17455,14487,-2968
2016,11,4,22,17265,17781,14577,-3204
2016,11,4,23,17797,18422,15245,-3177
2016,11,5,0,17622,18214,15443,-2771
2016,11,5,1,17246,17728,14790,-2938
2016,11,5,2,16586,17086,14327,-2759
2016,11,5,3,15706,16106,13381,-2725
2016,11,5,4,14673,14967,12375,-2592
2016,11,5,5,13713,14065,11540,-2525
2016,11,5,6,13094,13468,11096,-2372
2016,11,5,7,12712,13093,10845,-2248
2016,11,5,8,12533,12912,11227,-1685
2016,11,5,9,12550,12933,11562,-1371
2016,11,5,10,12862,13277,11672,-1605
2016,11,5,11,13476,14002,11834,-2168
2016,11,5,12,14463,14920,13020,-1900
2016,11,5,13,15128,15647,13777,-1870
2016,11,5,14,15646,16105,13987,-2118
2016,11,5,15,15928,16307,14261,-2046
2016,11,5,16,15964,16301,14130,-2171
2016,11,5,17,15827,16145,13998,-2147
2016,11,5,18,15616,15959,13711,-2248
2016,11,5,19,15468,15842,13517,-2325
2016,11,5,20,15423,15848,13607,-2241
2016,11,5,21,15818,16064,13808,-2256
2016,11,5,22,15860,16555,14225,-2330
2016,11,5,23,16659,17369,14774,-2595
2016,11,6,0,16602,17233,14744,-2489
2016,11,6,1,16306,16824,14090,-2734
2016,11,6,2,15730,16283,13892,-2391
2016,11,6,3,14976,15510,13150,-2360
2016,11,6,4,14071,14567,12188,-2379
2016,11,6,5,13088,13724,11168,-2556
2016,11,6,6,12558,13124,10628,-2496
2016,11,6,7,12558,12660,10152,-2508
2016,11,6,8,12229,12453,10291,-2162
2016,11,6,9,12061,12371,10520,-1851
2016,11,6,10,12079,12467,10671,-1796
2016,11,6,11,12308,12830,10883,-1947
2016,11,6,12,12651,13349,11003,-2346
2016,11,6,13,12972,14070,11686,-2384
2016,11,6,14,13671,14835,12035,-2800
2016,11,6,15,14201,15310,12441,-2869
2016,11,6,16,14528,15517,12599,-2918
2016,11,6,17,14841,15638,12533,-3105
2016,11,6,18,14911,15641,12423,-3218
2016,11,6,19,14888,15592,12436,-3156
2016,11,6,20,14880,15674,12821,-2853
2016,11,6,21,15048,15946,13163,-2783
2016,11,6,22,15809,16685,13752,-2933
2016,11,6,23,17132,17946,15048,-2898
2016,11,7,0,17295,17987,15496,-2491
2016,11,7,1,16987,17670,15072,-2598
2016,11,7,2,16513,17150,14455,-2695
2016,11,7,3,15774,16344,13780,-2564
2016,11,7,4,14776,15287,12835,-2452
2016,11,7,5,13751,14273,11512,-2761
2016,11,7,6,13157,13623,11166,-2457
2016,11,7,7,12741,13256,11033,-2223
2016,11,7,8,12526,13067,10951,-2116
2016,11,7,9,12500,13068,10928,-2140
2016,11,7,10,12804,13429,11242,-2187
2016,11,7,11,13804,14538,12291,-2247
2016,11,7,12,15548,16424,13937,-2487
2016,11,7,13,16736,17528,15220,-2308
2016,11,7,14,17221,17874,14998,-2876
2016,11,7,15,17389,18075,15202,-2873
2016,11,7,16,17398,18092,15002,-3090
2016,11,7,17,17306,18003,14929,-3074
2016,11,7,18,17135,17867,14841,-3026
2016,11,7,19,17056,17846,14705,-3141
2016,11,7,20,16971,17828,14578,-3250
2016,11,7,21,17044,17942,14928,-3014
2016,11,7,22,17727,18496,15548,-2948
2016,11,7,23,18961,19648,16649,-2999
2016,11,8,0,18971,19609,16810,-2799
2016,11,8,1,18559,19163,16551,-2612
2016,11,8,2,17934,18529,15606,-2923
2016,11,8,3,16976,17603,14775,-2828
2016,11,8,4,15691,16312,13657,-2655
2016,11,8,5,14396,15052,12564,-2488
2016,11,8,6,13564,14207,11991,-2216
2016,11,8,7,13055,13688,11559,-2129
2016,11,8,8,12778,13467,11353,-2114
2016,11,8,9,12697,13428,11314,-2114
2016,11,8,10,12946,13746,11572,-2174
2016,11,8,11,13877,14781,12526,-2255
2016,11,8,12,15616,16372,13933,-2439
2016,11,8,13,16716,17325,15122,-2203
2016,11,8,14,17119,17701,15159,-2542
2016,11,8,15,17248,17770,15063,-2707
2016,11,8,16,17261,17822,14742,-3080
2016,11,8,17,17174,17772,14356,-3416
2016,11,8,18,17072,17721,14385,-3336
2016,11,8,19,17090,17817,14769,-3048
2016,11,8,20,17073,17872,14768,-3104
2016,11,8,21,17184,17955,14743,-3212
2016,11,8,22,17825,18522,15093,-3429
2016,11,8,23,18922,19511,15904,-3607
2016,11,9,0,18830,19359,16037,-3322
2016,11,9,1,18352,18905,15960,-2945
2016,11,9,2,17679,18273,15604,-2669
2016,11,9,3,16726,17332,14836,-2496
2016,11,9,4,15444,16154,13714,-2440
2016,11,9,5,14179,15038,12318,-2720
2016,11,9,6,13416,14272,11724,-2548
2016,11,9,7,12916,13679,11465,-2214
2016,11,9,8,12633,13242,11152,-2090
2016,11,9,9,12550,13046,11010,-2036
2016,11,9,10,12772,13216,11048,-2168
2016,11,9,11,13630,14145,11816,-2329
2016,11,9,12,15233,15957,13356,-2601
2016,11,9,13,16409,17120,14778,-2342
2016,11,9,14,16995,17788,14818,-2970
2016,11,9,15,17355,18193,14864,-3329
2016,11,9,16,17515,18409,15294,-3115
2016,11,9,17,17543,18457,14958,-3499
2016,11,9,18,17486,18448,14830,-3618
2016,11,9,19,17487,18445,14745,-3700
2016,11,9,20,17472,18420,14936,-3484
2016,11,9,21,17592,18565,15046,-3519
2016,11,9,22,18230,19241,15559,-3682
2016,11,9,23,19226,19900,16500,-3400
2016,11,10,0,19068,19662,16392,-3270
2016,11,10,1,18558,19164,15830,-3334
2016,11,10,2,17919,18454,15335,-3119
2016,11,10,3,17045,17486,14517,-2969
2016,11,10,4,15875,16194,13522,-2672
2016,11,10,5,14685,14932,12620,-2312
2016,11,10,6,13720,14120,12234,-1886
2016,11,10,7,13195,13586,11739,-1847
2016,11,10,8,12918,13317,11502,-1815
2016,11,10,9,12847,13300,11367,-1933
2016,11,10,10,13107,13623,11854,-1769
2016,11,10,11,14065,14662,12703,-1959
2016,11,10,12,15815,16412,14087,-2325
2016,11,10,13,16959,17540,15348,-2192
2016,11,10,14,17418,17958,15767,-2191
2016,11,10,15,17616,18105,15869,-2236
2016,11,10,16,17629,18081,15289,-2792
2016,11,10,17,17536,17969,15087,-2882
2016,11,10,18,17370,17906,15296,-2610
2016,11,10,19,17328,17912,15402,-2510
2016,11,10,20,17250,17905,15381,-2524
2016,11,10,21,17343,17999,15344,-2655
2016,11,10,22,18017,18545,16002,-2543
2016,11,10,23,19131,19564,16784,-2780
2016,11,11,0,19017,19433,16989,-2444
2016,11,11,1,18530,18972,16581,-2391
2016,11,11,2,17934,18365,15943,-2422
2016,11,11,3,16991,17505,15306,-2199
2016,11,11,4,15719,16387,14104,-2283
2016,11,11,5,14453,15130,13071,-2059
2016,11,11,6,13665,14185,12191,-1994
2016,11,11,7,13147,13579,11651,-1928
2016,11,11,8,12840,13225,11553,-1672
2016,11,11,9,12738,13087,11166,-1921
2016,11,11,10,12940,13272,11346,-1926
2016,11,11,11,13762,13989,11755,-2234
2016,11,11,12,15336,15273,12959,-2314
2016,11,11,13,16446,16407,14039,-2368
2016,11,11,14,17003,17244,14737,-2507
2016,11,11,15,17329,17725,15074,-2651
2016,11,11,16,17466,17916,15281,-2635
2016,11,11,17,17527,17930,15445,-2485
2016,11,11,18,17429,17807,15454,-2353
2016,11,11,19,17378,17773,15384,-2389
2016,11,11,20,17357,17790,15455,-2335
2016,11,11,21,17442,17901,15474,-2427
2016,11,11,22,17996,18471,15897,-2574
2016,11,11,23,18894,19391,17042,-2349
2016,11,12,0,18692,19119,16888,-2231
2016,11,12,1,18171,18638,16344,-2294
2016,11,12,2,17554,18102,15722,-2380
2016,11,12,3,16834,17403,14880,-2523
2016,11,12,4,15939,16457,13979,-2478
2016,11,12,5,14981,15391,12956,-2435
2016,11,12,6,14292,14566,12414,-2152
2016,11,12,7,13704,14000,12022,-1978
2016,11,12,8,13354,13652,11257,-2395
2016,11,12,9,13190,13455,10931,-2524
2016,11,12,10,13252,13556,11287,-2269
2016,11,12,11,13618,13976,11404,-2572
2016,11,12,12,14222,14653,12046,-2607
2016,11,12,13,14790,15346,12992,-2354
2016,11,12,14,15605,16068,13355,-2713
2016,11,12,15,16132,16495,13468,-3027
2016,11,12,16,16340,16665,13785,-2880
2016,11,12,17,16333,16620,13838,-2782
2016,11,12,18,16178,16460,13759,-2701
2016,11,12,19,15977,16303,13606,-2697
2016,11,12,20,15852,16227,13625,-2602
2016,11,12,21,15902,16393,13888,-2505
2016,11,12,22,16549,17075,14690,-2385
2016,11,12,23,17691,18229,15794,-2435
2016,11,13,0,17735,18248,15807,-2441
2016,11,13,1,17405,17913,15339,-2574
2016,11,13,2,16961,17514,14821,-2693
2016,11,13,3,16349,16880,14131,-2749
2016,11,13,4,15573,16024,12964,-3060
2016,11,13,5,14727,15050,12581,-2469
2016,11,13,6,14002,14324,12255,-2069
2016,11,13,7,13433,13778,12032,-1746
2016,11,13,8,13069,13418,11905,-1513
2016,11,13,9,12883,13208,11715,-1493
2016,11,13,10,12893,13205,11386,-1819
2016,11,13,11,13144,13472,11547,-1925
2016,11,13,12,13520,13906,11763,-2143
2016,11,13,13,13840,14410,12288,-2122
2016,11,13,14,14519,15126,13070,-2056
2016,11,13,15,15015,15525,13055,-2470
2016,11,13,16,15281,15671,13246,-2425
2016,11,13,17,15411,15777,13215,-2562
2016,11,13,18,15397,15781,13208,-2573
2016,11,13,19,15318,15735,13312,-2423
2016,11,13,20,15265,15777,13288,-2489
2016,11,13,21,15397,15994,13434,-2560
2016,11,13,22,16186,16756,14003,-2753
2016,11,13,23,17572,17927,15326,-2601
2016,11,14,0,17693,18056,15645,-2411
2016,11,14,1,17423,17787,15152,-2635
2016,11,14,2,17004,17376,14522,-2854
2016,11,14,3,16242,16644,14006,-2638
2016,11,14,4,15234,15594,13010,-2584
2016,11,14,5,14186,14575,12471,-2104
2016,11,14,6,13454,13828,12288,-1540
2016,11,14,7,13050,13391,11685,-1706
2016,11,14,8,12835,13181,11587,-1594
2016,11,14,9,12805,13175,11536,-1639
2016,11,14,10,13096,13512,12083,-1429
2016,11,14,11,14054,14593,12963,-1630
2016,11,14,12,15803,16388,14529,-1859
2016,11,14,13,16921,17570,15687,-1883
2016,11,14,14,17356,17895,15752,-2143
2016,11,14,15,17524,17953,15503,-2450
2016,11,14,16,17559,18003,15333,-2670
2016,11,14,17,17493,17894,15054,-2840
2016,11,14,18,17374,17763,14972,-2791
2016,11,14,19,17361,17732,14880,-2852
2016,11,14,20,17333,17753,14808,-2945
2016,11,14,21,17460,17936,15040,-2896
2016,11,14,22,18142,18682,15764,-2918
2016,11,14,23,19243,19691,16576,-3115
2016,11,15,0,19120,19515,16582,-2933
2016,11,15,1,18674,19021,16066,-2955
2016,11,15,2,18066,18399,15462,-2937
2016,11,15,3,17123,17446,14563,-2883
2016,11,15,4,15884,16178,13454,-2724
2016,11,15,5,14641,14892,12424,-2468
2016,11,15,6,13678,13940,11779,-2161
2016,11,15,7,13161,13433,11228,-2205
2016,11,15,8,12894,13151,11233,-1918
2016,11,15,9,12818,13065,11154,-1911
2016,11,15,10,13060,13339,11262,-2077
2016,11,15,11,13976,14314,11866,-2448
2016,11,15,12,15622,16194,13574,-2620
2016,11,15,13,16754,17501,15023,-2478
2016,11,15,14,17289,18123,15297,-2826
2016,11,15,15,17624,18491,15416,-3075
2016,11,15,16,17748,18749,15545,-3204
2016,11,15,17,17748,18813,15506,-3307
2016,11,15,18,17661,18677,15244,-3433
2016,11,15,19,17636,18607,15247,-3360
2016,11,15,20,17597,18529,15227,-3302
2016,11,15,21,17715,18583,15440,-3143
2016,11,15,22,18389,19267,15883,-3384
2016,11,15,23,19402,20052,16832,-3220
2016,11,16,0,19207,19802,16524,-3278
2016,11,16,1,18703,19293,16254,-3039
2016,11,16,2,18062,18619,15447,-3172
2016,11,16,3,17091,17619,14828,-2791
2016,11,16,4,15838,16313,13426,-2887
2016,11,16,5,14594,15002,12403,-2599
2016,11,16,6,13678,14060,11500,-2560
2016,11,16,7,13147,13501,11335,-2166
2016,11,16,8,12856,13193,11042,-2151
2016,11,16,9,12768,13110,11039,-2071
2016,11,16,10,13004,13372,11016,-2356
2016,11,16,11,13924,14345,12096,-2249
2016,11,16,12,15673,16156,13754,-2402
2016,11,16,13,16788,17238,15017,-2221
2016,11,16,14,17220,17664,15159,-2505
2016,11,16,15,17412,17824,15266,-2558
2016,11,16,16,17461,17898,15301,-2597
2016,11,16,17,17401,17876,15327,-2549
2016,11,16,18,17291,17800,15338,-2462
2016,11,16,19,17303,17869,15249,-2620
2016,11,16,20,17290,17884,15112,-2772
2016,11,16,21,17434,18087,15115,-2972
2016,11,16,22,18126,18774,15493,-3281
2016,11,16,23,19220,19690,16749,-2941
2016,11,17,0,19022,19464,16916,-2548
2016,11,17,1,18521,19030,16589,-2441
2016,11,17,2,17904,18378,15784,-2594
2016,11,17,3,16954,17461,15114,-2347
2016,11,17,4,15691,16179,13790,-2389
2016,11,17,5,14424,14895,12232,-2663
2016,11,17,6,13588,13994,11668,-2326
2016,11,17,7,13050,13455,11611,-1844
2016,11,17,8,12750,13176,11576,-1600
2016,11,17,9,12666,13098,11539,-1559
2016,11,17,10,12901,13351,11441,-1910
2016,11,17,11,13815,14308,11799,-2509
2016,11,17,12,15575,16069,13345,-2724
2016,11,17,13,16702,17182,14777,-2405
2016,11,17,14,17159,17622,15042,-2580
2016,11,17,15,17396,17797,15218,-2579
2016,11,17,16,17453,17822,15090,-2732
2016,11,17,17,17442,17836,15058,-2778
2016,11,17,18,17311,17753,14567,-3186
2016,11,17,19,17281,17763,14456,-3307
2016,11,17,20,17232,17716,14614,-3102
2016,11,17,21,17333,17837,14936,-2901
2016,11,17,22,18018,18492,15470,-3022
2016,11,17,23,19200,19524,16511,-3013
2016,11,18,0,19056,19391,16394,-2997
2016,11,18,1,18588,19024,16369,-2655
2016,11,18,2,17976,18458,15605,-2853
2016,11,18,3,17010,17551,14632,-2919
2016,11,18,4,15749,16274,13199,-3075
2016,11,18,5,14487,15043,12063,-2980
2016,11,18,6,13611,14139,11364,-2775
2016,11,18,7,13104,13608,11201,-2407
2016,11,18,8,12817,13314,10940,-2374
2016,11,18,9,12726,13210,10903,-2307
2016,11,18,10,12964,13466,10997,-2469
2016,11,18,11,13875,14411,11789,-2622
2016,11,18,12,15677,16146,13128,-3018
2016,11,18,13,16757,17276,14622,-2654
2016,11,18,14,17159,17684,14628,-3056
2016,11,18,15,17322,17801,14281,-3520
2016,11,18,16,17352,17805,14254,-3551
2016,11,18,17,17274,17712,14153,-3559
2016,11,18,18,17135,17561,14122,-3439
2016,11,18,19,17115,17517,14055,-3462
2016,11,18,20,17069,17524,13999,-3525
2016,11,18,21,17126,17639,14230,-3409
2016,11,18,22,17677,18146,14640,-3506
2016,11,18,23,18690,19074,16140,-2934
2016,11,19,0,18437,18757,15851,-2906
2016,11,19,1,17911,18266,15272,-2994
2016,11,19,2,17277,17725,14658,-3067
2016,11,19,3,16435,17004,13798,-3206
2016,11,19,4,15405,16060,12887,-3173
2016,11,19,5,14318,14939,12084,-2855
2016,11,19,6,13538,14069,11326,-2743
2016,11,19,7,12955,13487,10787,-2700
2016,11,19,8,12607,13142,10107,-3035
2016,11,19,9,12437,12999,10333,-2666
2016,11,19,10,12475,13085,10420,-2665
2016,11,19,11,12806,13479,10759,-2720
2016,11,19,12,13465,14106,11342,-2764
2016,11,19,13,13994,14752,12536,-2216
2016,11,19,14,14733,15480,12929,-2551
2016,11,19,15,15264,15945,13324,-2621
2016,11,19,16,15528,16138,13366,-2772
2016,11,19,17,15589,16122,13393,-2729
2016,11,19,18,15521,16104,13407,-2697
2016,11,19,19,15424,16090,13503,-2587
2016,11,19,20,15396,16200,13708,-2492
2016,11,19,21,15515,16406,13659,-2747
2016,11,19,22,16185,17173,14177,-2996
2016,11,19,23,17300,18052,14852,-3200
2016,11,20,0,17227,17973,14750,-3223
2016,11,20,1,16831,17623,14833,-2790
2016,11,20,2,16336,17198,14473,-2725
2016,11,20,3,15686,16551,13779,-2772
2016,11,20,4,14902,15703,12754,-2949
2016,11,20,5,14103,14822,11896,-2926
2016,11,20,6,13583,14146,11767,-2379
2016,11,20,7,13046,13701,11417,-2284
2016,11,20,8,12726,13376,11305,-2071
2016,11,20,9,12591,13246,11160,-2086
2016,11,20,10,12652,13285,11234,-2051
2016,11,20,11,12967,13587,11608,-1979
2016,11,20,12,13419,14079,12158,-1921
2016,11,20,13,13839,14708,12799,-1909
2016,11,20,14,14643,15631,13276,-2355
2016,11,20,15,15336,16417,13890,-2527
2016,11,20,16,15795,17011,14354,-2657
2016,11,20,17,16044,17315,14660,-2655
2016,11,20,18,16192,17509,14660,-2849
2016,11,20,19,16229,17633,14774,-2859
2016,11,20,20,16288,17798,15010,-2788
2016,11,20,21,16522,18012,15240,-2772
2016,11,20,22,17368,18859,15901,-2958
2016,11,20,23,18610,19850,17096,-2754
2016,11,21,0,18602,19711,16905,-2806
2016,11,21,1,18269,19378,16484,-2894
2016,11,21,2,17788,18844,16155,-2689
2016,11,21,3,16992,17984,15294,-2690
2016,11,21,4,15989,16858,14048,-2810
2016,11,21,5,14959,15789,13041,-2748
2016,11,21,6,14413,14966,12449,-2517
2016,11,21,7,13963,14489,11955,-2534
2016,11,21,8,13727,14251,11683,-2568
2016,11,21,9,13690,14213,11760,-2453
2016,11,21,10,13985,14538,12105,-2433
2016,11,21,11,14953,15473,12800,-2673
2016,11,21,12,16627,17313,14852,-2461
2016,11,21,13,17895,18530,16549,-1981
2016,11,21,14,18528,19187,17023,-2164
2016,11,21,15,18904,19659,17426,-2233
2016,11,21,16,19095,19907,17636,-2271
2016,11,21,17,19053,19920,17664,-2256
2016,11,21,18,18982,19866,17691,-2175
2016,11,21,19,18964,19922,17738,-2184
2016,11,21,20,18925,19895,17801,-2094
2016,11,21,21,19033,20071,17960,-2111
2016,11,21,22,19730,20788,18625,-2163
2016,11,21,23,20816,21613,19379,-2234
2016,11,22,0,20641,21411,19272,-2139
2016,11,22,1,20174,20908,18587,-2321
2016,11,22,2,19516,20197,18029,-2168
2016,11,22,3,18519,19239,17047,-2192
2016,11,22,4,17263,17898,15411,-2487
2016,11,22,5,16008,16539,14460,-2079
2016,11,22,6,15079,15560,13474,-2086
2016,11,22,7,14531,14958,13070,-1888
2016,11,22,8,14232,14637,12738,-1899
2016,11,22,9,14143,14558,12624,-1934
2016,11,22,10,14383,14810,12825,-1985
2016,11,22,11,15303,15777,13664,-2113
2016,11,22,12,17004,17585,15739,-1846
2016,11,22,13,18192,18718,17013,-1705
2016,11,22,14,18704,19152,17195,-1957
2016,11,22,15,18962,19328,17295,-2033
2016,11,22,16,19070,19422,17163,-2259
2016,11,22,17,19010,19426,17083,-2343
2016,11,22,18,18910,19322,16814,-2508
2016,11,22,19,18881,19277,16498,-2779
2016,11,22,20,18836,19251,16255,-2996
2016,11,22,21,18933,19452,16414,-3038
2016,11,22,22,19583,20204,17378,-2826
2016,11,22,23,20648,21188,18575,-2613
2016,11,23,0,20491,20992,18401,-2591
2016,11,23,1,20048,20562,18067,-2495
2016,11,23,2,19455,19943,17640,-2303
2016,11,23,3,18518,19023,16645,-2378
2016,11,23,4,17302,17776,14661,-3115
2016,11,23,5,16076,16423,13600,-2823
2016,11,23,6,15086,15450,12453,-2997
2016,11,23,7,14541,14879,12192,-2687
2016,11,23,8,14243,14554,11739,-2815
2016,11,23,9,14162,14449,11629,-2820
2016,11,23,10,14409,14652,11646,-3006
2016,11,23,11,15336,15494,12271,-3223
2016,11,23,12,17105,17034,14538,-2496
2016,11,23,13,18251,18189,15833,-2356
2016,11,23,14,18654,18779,15783,-2996
2016,11,23,15,18785,19029,15783,-3246
2016,11,23,16,18789,19061,15607,-3454
2016,11,23,17,18672,18928,15266,-3662
2016,11,23,18,18491,18700,14885,-3815
2016,11,23,19,18437,18612,15070,-3542
2016,11,23,20,18386,18543,15295,-3248
2016,11,23,21,18505,18634,15013,-3621
2016,11,23,22,19195,19448,15741,-3707
2016,11,23,23,20332,20395,16746,-3649
2016,11,24,0,20191,20172,16547,-3625
2016,11,24,1,19771,19678,15876,-3802
2016,11,24,2,19225,19102,15436,-3666
2016,11,24,3,18333,18286,14622,-3664
2016,11,24,4,17128,17180,13442,-3738
2016,11,24,5,15908,15942,12435,-3507
2016,11,24,6,14815,14917,11104,-3813
2016,11,24,7,14165,14242,10823,-3419
2016,11,24,8,13754,13828,10473,-3355
2016,11,24,9,13551,13623,10257,-3366
2016,11,24,10,13577,13646,10436,-3210
2016,11,24,11,13862,13980,10864,-3116
2016,11,24,12,14250,14573,11334,-3239
2016,11,24,13,14681,15223,12310,-2913
2016,11,24,14,15454,16129,12936,-3193
2016,11,24,15,16181,16909,13570,-3339
2016,11,24,16,16628,17431,14218,-3213
2016,11,24,17,16812,17777,14174,-3603
2016,11,24,18,16677,17837,13720,-4117
2016,11,24,19,16301,17510,13610,-3900
2016,11,24,20,15870,17103,12890,-4213
2016,11,24,21,15559,16774,12882,-3892
2016,11,24,22,15754,16878,13186,-3692
2016,11,24,23,16100,16892,13759,-3133
2016,11,25,0,15880,16613,13172,-3441
2016,11,25,1,15718,16405,12811,-3594
2016,11,25,2,15596,16244,12703,-3541
2016,11,25,3,15376,15931,12444,-3487
2016,11,25,4,14930,15323,11534,-3789
2016,11,25,5,14304,14608,10987,-3621
2016,11,25,6,13541,13947,10146,-3801
2016,11,25,7,13087,13457,9970,-3487
2016,11,25,8,12809,13160,9580,-3580
2016,11,25,9,12699,13055,9489,-3566
2016,11,25,10,12840,13190,9741,-3449
2016,11,25,11,13354,13706,10102,-3604
2016,11,25,12,14130,14532,11011,-3521
2016,11,25,13,14737,15359,12089,-3270
2016,11,25,14,15383,16149,12580,-3569
2016,11,25,15,15955,16696,12728,-3968
2016,11,25,16,16254,16949,12892,-4057
2016,11,25,17,16356,17002,12657,-4345
2016,11,25,18,16342,16968,12548,-4420
2016,11,25,19,16260,16958,12655,-4303
2016,11,25,20,16267,16999,12760,-4239
2016,11,25,21,16430,17252,13048,-4204
2016,11,25,22,17250,17984,14013,-3971
2016,11,25,23,18112,18648,14908,-3740
2016,11,26,0,17825,18358,14693,-3665
2016,11,26,1,17373,17912,14205,-3707
2016,11,26,2,16931,17445,13769,-3676
2016,11,26,3,16353,16833,13078,-3755
2016,11,26,4,15592,15961,12144,-3817
2016,11,26,5,14651,14976,11029,-3947
2016,11,26,6,13796,14098,9786,-4312
2016,11,26,7,13205,13528,9835,-3693
2016,11,26,8,12864,13180,9584,-3596
2016,11,26,9,12700,13010,9469,-3541
2016,11,26,10,12745,13070,9444,-3626
2016,11,26,11,13034,13380,9687,-3693
2016,11,26,12,13463,14017,10116,-3901
2016,11,26,13,13941,14675,11159,-3516
2016,11,26,14,14783,15526,11648,-3878
2016,11,26,15,15446,16217,12212,-4005
2016,11,26,16,15781,16561,12559,-4002
2016,11,26,17,15884,16684,12725,-3959
2016,11,26,18,15847,16709,12780,-3929
2016,11,26,19,15726,16589,12352,-4237
2016,11,26,20,15685,16495,12184,-4311
2016,11,26,21,15834,16645,12372,-4273
2016,11,26,22,16613,17431,13368,-4063
2016,11,26,23,17789,18322,14445,-3877
2016,11,27,0,17728,18271,14436,-3835
2016,11,27,1,17373,17954,13870,-4084
2016,11,27,2,16906,17599,13443,-4156
2016,11,27,3,16268,17078,12856,-4222
2016,11,27,4,15505,16254,11827,-4427
2016,11,27,5,14656,15284,11106,-4178
2016,11,27,6,13909,14450,10636,-3814
2016,11,27,7,13362,13865,10106,-3759
2016,11,27,8,13022,13455,9996,-3459
2016,11,27,9,12862,13317,9846,-3471
2016,11,27,10,12898,13342,9952,-3390
2016,11,27,11,13172,13579,10093,-3486
2016,11,27,12,13650,14041,10555,-3486
2016,11,27,13,14030,14540,11548,-2992
2016,11,27,14,14718,15239,11888,-3351
2016,11,27,15,15274,15808,12376,-3432
2016,11,27,16,15612,16182,12511,-3671
2016,11,27,17,15813,16409,12509,-3900
2016,11,27,18,15887,16566,12707,-3859
2016,11,27,19,15873,16614,12649,-3965
2016,11,27,20,15882,16692,12509,-4183
2016,11,27,21,16088,16918,12807,-4111
2016,11,27,22,16990,17913,14048,-3865
2016,11,27,23,18437,19008,15491,-3517
2016,11,28,0,18484,19013,15221,-3792
2016,11,28,1,18209,18717,15013,-3704
2016,11,28,2,17739,18246,14645,-3601
2016,11,28,3,16898,17413,13638,-3775
2016,11,28,4,15846,16315,12413,-3902
2016,11,28,5,14758,15225,11883,-3342
2016,11,28,6,13945,14411,10840,-3571
2016,11,28,7,13482,13924,10320,-3604
2016,11,28,8,13246,13690,10048,-3642
2016,11,28,9,13209,13677,9830,-3847
2016,11,28,10,13511,14022,10225,-3797
2016,11,28,11,14508,15029,11062,-3967
2016,11,28,12,16378,16914,12855,-4059
2016,11,28,13,17616,18119,14338,-3781
2016,11,28,14,18055,18441,14392,-4049
2016,11,28,15,18222,18465,14468,-3997
2016,11,28,16,18263,18411,14287,-4124
2016,11,28,17,18177,18285,14296,-3989
2016,11,28,18,17988,18134,13908,-4226
2016,11,28,19,17898,18111,14028,-4083
2016,11,28,20,17823,18079,14284,-3795
2016,11,28,21,17924,18338,14627,-3711
2016,11,28,22,18677,19399,15803,-3596
2016,11,28,23,19937,20574,17387,-3187
2016,11,29,0,19785,20425,17475,-2950
2016,11,29,1,19358,20051,16784,-3267
2016,11,29,2,18712,19441,16250,-3191
2016,11,29,3,17671,18422,15199,-3223
2016,11,29,4,16348,17082,13729,-3353
2016,11,29,5,15021,15658,12471,-3187
2016,11,29,6,14029,14589,11537,-3052
2016,11,29,7,13490,13998,11143,-2855
2016,11,29,8,13198,13655,10976,-2679
2016,11,29,9,13091,13524,11008,-2516
2016,11,29,10,13296,13761,11162,-2599
2016,11,29,11,14141,14663,11681,-2982
2016,11,29,12,15780,16514,13794,-2720
2016,11,29,13,16910,17906,15319,-2587
2016,11,29,14,17425,18385,15582,-2803
2016,11,29,15,17818,18790,15939,-2851
2016,11,29,16,18006,19036,16385,-2651
2016,11,29,17,18026,19169,16284,-2885
2016,11,29,18,17973,19183,16274,-2909
2016,11,29,19,17968,19173,16261,-2912
2016,11,29,20,17933,19090,16365,-2725
2016,11,29,21,18044,19189,16130,-3059
2016,11,29,22,18682,19744,16957,-2787
2016,11,29,23,19641,20414,17244,-3170
2016,11,30,0,19311,20138,17262,-2876
2016,11,30,1,18766,19642,16936,-2706
2016,11,30,2,18109,18973,16312,-2661
2016,11,30,3,17093,17935,14903,-3032
2016,11,30,4,15845,16596,13060,-3536
2016,11,30,5,14601,15167,11745,-3422
2016,11,30,6,13656,14154,11157,-2997
2016,11,30,7,13102,13571,10632,-2939
2016,11,30,8,12815,13244,10306,-2938
2016,11,30,9,12723,13137,10238,-2899
2016,11,30,10,12943,13346,10417,-2929
2016,11,30,11,13831,14272,11365,-2907
2016,11,30,12,15583,16116,13106,-3010
2016,11,30,13,16772,17410,14541,-2869
2016,11,30,14,17252,17922,14828,-3094
2016,11,30,15,17594,18248,14977,-3271
2016,11,30,16,17789,18479,15190,-3289
2016,11,30,17,17740,18609,14972,-3637
2016,11,30,18,17721,18610,15151,-3459
2016,11,30,19,17792,18713,15191,-3522
2016,11,30,20,17807,18754,15361,-3393
2016,11,30,21,17971,18985,15486,-3499
2016,11,30,22,18602,19752,16426,-3326
2016,11,30,23,19467,20298,16926,-3372
2016,12,1,0,19114,20023,16867,-3156
2016,12,1,1,18595,19476,16197,-3279
2016,12,1,2,17996,18828,15581,-3247
2016,12,1,3,17078,17909,14607,-3302
2016,12,1,4,15895,16636,13613,-3023
2016,12,1,5,14730,15234,12516,-2718
2016,12,1,6,13998,14230,11797,-2433
2016,12,1,7,13388,13620,11459,-2161
2016,12,1,8,13041,13251,11267,-1984
2016,12,1,9,12930,13103,11112,-1991
2016,12,1,10,13138,13330,11331,-1999
2016,12,1,11,14008,14244,11936,-2308
2016,12,1,12,15817,16124,13559,-2565
2016,12,1,13,17138,17386,14962,-2424
2016,12,1,14,17610,17795,15147,-2648
2016,12,1,15,17890,18072,15465,-2607
2016,12,1,16,17993,18216,15404,-2812
2016,12,1,17,18008,18234,15362,-2872
2016,12,1,18,17927,18197,15003,-3194
2016,12,1,19,17902,18312,14974,-3338
2016,12,1,20,17906,18468,15214,-3254
2016,12,1,21,18089,18713,15225,-3488
2016,12,1,22,18920,19557,15775,-3782
2016,12,1,23,19976,20418,16963,-3455
2016,12,2,0,19842,20242,16778,-3464
2016,12,2,1,19415,19817,16451,-3366
2016,12,2,2,18821,19233,16158,-3075
2016,12,2,3,17928,18345,15235,-3110
2016,12,2,4,16655,17004,13687,-3317
2016,12,2,5,15299,15597,12269,-3328
2016,12,2,6,14525,14590,11535,-3055
2016,12,2,7,13954,13990,11354,-2636
2016,12,2,8,13639,13639,11082,-2557
2016,12,2,9,13544,13526,10921,-2605
2016,12,2,10,13771,13761,11256,-2505
2016,12,2,11,14661,14713,11737,-2976
2016,12,2,12,16451,16511,13185,-3326
2016,12,2,13,17691,17716,14728,-2988
2016,12,2,14,18129,18134,15012,-3122
2016,12,2,15,18369,18354,15161,-3193
2016,12,2,16,18413,18457,15175,-3282
2016,12,2,17,18316,18366,14978,-3388
2016,12,2,18,18157,18275,15169,-3106
2016,12,2,19,18090,18335,15201,-3134
2016,12,2,20,18048,18401,15327,-3074
2016,12,2,21,18174,18623,15518,-3105
2016,12,2,22,18921,19436,15915,-3521
2016,12,2,23,19826,20213,17264,-2949
2016,12,3,0,19623,19919,16523,-3396
2016,12,3,1,19178,19459,16220,-3239
2016,12,3,2,18623,18943,15916,-3027
2016,12,3,3,17898,18223,14896,-3327
2016,12,3,4,16884,17129,13947,-3182
2016,12,3,5,15732,15910,12562,-3348
2016,12,3,6,14802,14840,11392,-3448
2016,12,3,7,14186,14185,10896,-3289
2016,12,3,8,13819,13791,10719,-3072
2016,12,3,9,13648,13615,10669,-2946
2016,12,3,10,13692,13678,10788,-2890
2016,12,3,11,14031,14087,11364,-2723
2016,12,3,12,14697,14754,11895,-2859
2016,12,3,13,15316,15556,12698,-2858
2016,12,3,14,16059,16349,13719,-2630
2016,12,3,15,16636,16868,14122,-2746
2016,12,3,16,16900,17125,13952,-3173
2016,12,3,17,16977,17180,13718,-3462
2016,12,3,18,16910,17149,13717,-3432
2016,12,3,19,16793,17066,13543,-3523
2016,12,3,20,16753,17060,13505,-3555
2016,12,3,21,16892,17229,13438,-3791
2016,12,3,22,17714,18172,14359,-3813
2016,12,3,23,18802,19115,15425,-3690
2016,12,4,0,18786,19022,15224,-3798
2016,12,4,1,18467,18708,15092,-3616
2016,12,4,2,18017,18272,14568,-3704
2016,12,4,3,17401,17582,13942,-3640
2016,12,4,4,16568,16751,13067,-3684
2016,12,4,5,15588,15732,12238,-3494
2016,12,4,6,14768,14754,10780,-3974
2016,12,4,7,14169,14066,9825,-4241
2016,12,4,8,13802,13653,9724,-3929
2016,12,4,9,13631,13457,9736,-3721
2016,12,4,10,13651,13480,9888,-3592
2016,12,4,11,13908,13778,10069,-3709
2016,12,4,12,14396,14316,10503,-3813
2016,12,4,13,14827,14846,11134,-3712
2016,12,4,14,15455,15592,11966,-3626
2016,12,4,15,15983,16123,12416,-3707
2016,12,4,16,16268,16423,12815,-3608
2016,12,4,17,16415,16527,12647,-3880
2016,12,4,18,16429,16539,12416,-4123
2016,12,4,19,16373,16555,12315,-4240
2016,12,4,20,16355,16617,12561,-4056
2016,12,4,21,16576,16987,12837,-4150
2016,12,4,22,17585,18302,14476,-3826
2016,12,4,23,18956,19528,15971,-3557
2016,12,5,0,19095,19545,16197,-3348
2016,12,5,1,18875,19327,15902,-3425
2016,12,5,2,18491,18832,15345,-3487
2016,12,5,3,17763,18004,14463,-3541
2016,12,5,4,16710,16809,13297,-3512
2016,12,5,5,15536,15557,12174,-3383
2016,12,5,6,14599,14623,11162,-3461
2016,12,5,7,14070,14130,10926,-3204
2016,12,5,8,13790,13885,10686,-3199
2016,12,5,9,13721,13910,10762,-3148
2016,12,5,10,13977,14232,10983,-3249
2016,12,5,11,14911,15194,11917,-3277
2016,12,5,12,16608,16965,13595,-3370
2016,12,5,13,17918,18429,15295,-3134
2016,12,5,14,18420,18961,15704,-3257
2016,12,5,15,18735,19267,16021,-3246
2016,12,5,16,18806,19445,16170,-3275
2016,12,5,17,18716,19280,16077,-3203
2016,12,5,18,18554,19043,15860,-3183
2016,12,5,19,18455,18930,15841,-3089
2016,12,5,20,18362,18925,15764,-3161
2016,12,5,21,18469,19084,15912,-3172
2016,12,5,22,19307,20029,16826,-3203
2016,12,5,23,20453,21143,18026,-3117
2016,12,6,0,20387,21009,17831,-3178
2016,12,6,1,20044,20589,17479,-3110
2016,12,6,2,19464,19942,16740,-3202
2016,12,6,3,18538,18977,15811,-3166
2016,12,6,4,17248,17525,14050,-3475
2016,12,6,5,15872,15988,12627,-3361
2016,12,6,6,14850,14923,11932,-2991
2016,12,6,7,14300,14342,11437,-2905
2016,12,6,8,14003,14052,10865,-3187
2016,12,6,9,13918,13967,10748,-3219
2016,12,6,10,14154,14265,11015,-3250
2016,12,6,11,15067,15266,12156,-3110
2016,12,6,12,16836,17190,14109,-3081
2016,12,6,13,18073,18422,15832,-2590
2016,12,6,14,18452,18812,15979,-2833
2016,12,6,15,18681,18910,16061,-2849
2016,12,6,16,18729,18897,16146,-2751
2016,12,6,17,18656,18877,16122,-2755
2016,12,6,18,18523,18819,16074,-2745
2016,12,6,19,18489,18883,16007,-2876
2016,12,6,20,18451,18978,16103,-2875
2016,12,6,21,18607,19333,16388,-2945
2016,12,6,22,19460,20428,17547,-2881
2016,12,6,23,20465,21200,18043,-3157
2016,12,7,0,20305,21025,18028,-2997
2016,12,7,1,19898,20626,17816,-2810
2016,12,7,2,19358,20018,17775,-2243
2016,12,7,3,18479,19044,16569,-2475
2016,12,7,4,17209,17604,14935,-2669
2016,12,7,5,15857,16102,13087,-3015
2016,12,7,6,14802,14988,11362,-3626
2016,12,7,7,14208,14391,11145,-3246
2016,12,7,8,13879,14043,11044,-2999
2016,12,7,9,13777,13917,11053,-2864
2016,12,7,10,13992,14174,11363,-2811
2016,12,7,11,14868,15155,12331,-2824
2016,12,7,12,16557,17010,14470,-2540
2016,12,7,13,17799,18342,15837,-2505
2016,12,7,14,18225,18859,16009,-2850
2016,12,7,15,18506,19171,16482,-2689
2016,12,7,16,18569,19320,16453,-2867
2016,12,7,17,18537,19293,15879,-3414
2016,12,7,18,18417,19090,15634,-3456
2016,12,7,19,18392,19022,15355,-3667
2016,12,7,20,18365,18935,15242,-3693
2016,12,7,21,18533,19099,15561,-3538
2016,12,7,22,19435,20062,16736,-3326
2016,12,7,23,20501,21175,18150,-3025
2016,12,8,0,20361,21043,17804,-3239
2016,12,8,1,19957,20589,17436,-3153
2016,12,8,2,19419,20019,16928,-3091
2016,12,8,3,18547,19076,15933,-3143
2016,12,8,4,17273,17642,14019,-3623
2016,12,8,5,15905,16165,12813,-3352
2016,12,8,6,14884,15088,11880,-3208
2016,12,8,7,14312,14479,11482,-2997
2016,12,8,8,13992,14167,11171,-2996
2016,12,8,9,13910,14052,11244,-2808
2016,12,8,10,14148,14326,11654,-2672
2016,12,8,11,15060,15369,12595,-2774
2016,12,8,12,16810,17185,14292,-2893
2016,12,8,13,18075,18440,15872,-2568
2016,12,8,14,18485,18907,16141,-2766
2016,12,8,15,18760,19175,16393,-2782
2016,12,8,16,18815,19251,16360,-2891
2016,12,8,17,18786,19207,16276,-2931
2016,12,8,18,18663,19094,16336,-2758
2016,12,8,19,18628,19100,16247,-2853
2016,12,8,20,18584,19087,16070,-3017
2016,12,8,21,18756,19325,16262,-3063
2016,12,8,22,19679,20330,17066,-3264
2016,12,8,23,20821,21430,18680,-2750
2016,12,9,0,20730,21314,18836,-2478
2016,12,9,1,20356,20951,18180,-2771
2016,12,9,2,19816,20401,17500,-2901
2016,12,9,3,18936,19486,16580,-2906
2016,12,9,4,17646,18109,15029,-3080
2016,12,9,5,16274,16711,13747,-2964
2016,12,9,6,15277,15648,13284,-2364
2016,12,9,7,14730,15065,12592,-2473
2016,12,9,8,14426,14723,12018,-2705
2016,12,9,9,14341,14657,11960,-2697
2016,12,9,10,14565,14916,12222,-2694
2016,12,9,11,15432,15890,13464,-2426
2016,12,9,12,17158,17699,15151,-2548
2016,12,9,13,18393,18879,16378,-2501
2016,12,9,14,18798,19255,16404,-2851
2016,12,9,15,19042,19418,16230,-3188
2016,12,9,16,19115,19515,16558,-2957
2016,12,9,17,19062,19457,16727,-2730
2016,12,9,18,18937,19333,16557,-2776
2016,12,9,19,18884,19360,17053,-2307
2016,12,9,20,18839,19408,17290,-2118
2016,12,9,21,18976,19686,17667,-2019
2016,12,9,22,19767,20633,18685,-1948
2016,12,9,23,20673,21658,19724,-1934
2016,12,10,0,20521,21428,19738,-1690
2016,12,10,1,20114,20979,19049,-1930
2016,12,10,2,19603,20431,18455,-1976
2016,12,10,3,18917,19685,17854,-1831
2016,12,10,4,17953,18536,16196,-2340
2016,12,10,5,16839,17258,14994,-2264
2016,12,10,6,15889,16194,14410,-1784
2016,12,10,7,15243,15511,13877,-1634
2016,12,10,8,14874,15116,13178,-1938
2016,12,10,9,14702,14965,12978,-1987
2016,12,10,10,14735,14998,13224,-1774
2016,12,10,11,15059,15401,13288,-2113
2016,12,10,12,15692,16152,14684,-1468
2016,12,10,13,16312,16892,15286,-1606
2016,12,10,14,17025,17669,15680,-1989
2016,12,10,15,17604,18156,16165,-1991
2016,12,10,16,17853,18303,16352,-1951
2016,12,10,17,17866,18324,15832,-2492
2016,12,10,18,17759,18267,15175,-3092
2016,12,10,19,17604,18265,15068,-3197
2016,12,10,20,17523,18249,14955,-3294
2016,12,10,21,17655,18403,15187,-3216
2016,12,10,22,18498,19347,16597,-2750
2016,12,10,23,19588,20497,17882,-2615
2016,12,11,0,19608,20434,17805,-2629
2016,12,11,1,19308,20112,17598,-2514
2016,12,11,2,18906,19649,17186,-2463
2016,12,11,3,18340,19061,16424,-2637
2016,12,11,4,17547,18180,15299,-2881
2016,12,11,5,16611,17141,14283,-2858
2016,12,11,6,15894,16209,13721,-2488
2016,12,11,7,15283,15581,13368,-2213
2016,12,11,8,14902,15199,12878,-2321
2016,12,11,9,14710,14996,12735,-2261
2016,12,11,10,14697,15000,12692,-2308
2016,12,11,11,14905,15243,13407,-1836
2016,12,11,12,15309,15766,14285,-1481
2016,12,11,13,15714,16353,14924,-1429
2016,12,11,14,16320,17082,15603,-1479
2016,12,11,15,16922,17603,15836,-1767
2016,12,11,16,17264,17966,16283,-1683
2016,12,11,17,17442,18048,15971,-2077
2016,12,11,18,17482,18200,15657,-2543
2016,12,11,19,17456,18352,15523,-2829
2016,12,11,20,17447,18479,15605,-2874
2016,12,11,21,17659,18764,15778,-2986
2016,12,11,22,18627,19921,17194,-2727
2016,12,11,23,19785,20946,18760,-2186
2016,12,12,0,19794,20914,18583,-2331
2016,12,12,1,19514,20601,18452,-2149
2016,12,12,2,19102,20066,18034,-2032
2016,12,12,3,18388,19136,16465,-2671
2016,12,12,4,17364,17862,15065,-2797
2016,12,12,5,16216,16591,14473,-2118
2016,12,12,6,15343,15617,13821,-1796
2016,12,12,7,14764,15045,13205,-1840
2016,12,12,8,14449,14759,13030,-1729
2016,12,12,9,14344,14634,12917,-1717
2016,12,12,10,14552,14866,13119,-1747
2016,12,12,11,15401,15762,13998,-1764
2016,12,12,12,16997,17372,15831,-1541
2016,12,12,13,18259,18824,17095,-1729
2016,12,12,14,18721,19368,17025,-2343
2016,12,12,15,19068,19718,16640,-3078
2016,12,12,16,19179,19976,16851,-3125
2016,12,12,17,19092,19990,17137,-2853
2016,12,12,18,18972,19864,16971,-2893
2016,12,12,19,18913,19808,17160,-2648
2016,12,12,20,18833,19722,17109,-2613
2016,12,12,21,18956,19842,17370,-2472
2016,12,12,22,19782,20683,18256,-2427
2016,12,12,23,20769,21730,19565,-2165
2016,12,13,0,20640,21568,19364,-2204
2016,12,13,1,20278,21174,19191,-1983
2016,12,13,2,19729,20522,18645,-1877
2016,12,13,3,18885,19533,17698,-1835
2016,12,13,4,17689,18080,16325,-1755
2016,12,13,5,16390,16563,14828,-1735
2016,12,13,6,15489,15479,14061,-1418
2016,12,13,7,14923,14883,13300,-1583
2016,12,13,8,14620,14591,12608,-1983
2016,12,13,9,14537,14510,12155,-2355
2016,12,13,10,14769,14785,12347,-2438
2016,12,13,11,15660,15773,13697,-2076
2016,12,13,12,17387,17673,15565,-2108
2016,12,13,13,18605,18899,16490,-2409
2016,12,13,14,18942,19236,16568,-2668
2016,12,13,15,19160,19297,16413,-2884
2016,12,13,16,19196,19302,15921,-3381
2016,12,13,17,19100,19250,16171,-3079
2016,12,13,18,18985,19155,16391,-2764
2016,12,13,19,18947,19172,16376,-2796
2016,12,13,20,18912,19246,16526,-2720
2016,12,13,21,19080,19622,16719,-2903
2016,12,13,22,19944,20711,18022,-2689
2016,12,13,23,20958,21678,18992,-2686
2016,12,14,0,20840,21511,18903,-2608
2016,12,14,1,20474,21083,18497,-2586
2016,12,14,2,19976,20483,17966,-2517
2016,12,14,3,19156,19510,16736,-2774
2016,12,14,4,17937,18051,15739,-2312
2016,12,14,5,16632,16563,14826,-1737
2016,12,14,6,15531,15452,13572,-1880
2016,12,14,7,14948,14840,12917,-1923
2016,12,14,8,14634,14535,13065,-1470
2016,12,14,9,14557,14492,13148,-1344
2016,12,14,10,14794,14798,13161,-1637
2016,12,14,11,15692,15829,13870,-1959
2016,12,14,12,17462,17829,16189,-1640
2016,12,14,13,18723,19069,17647,-1422
2016,12,14,14,19073,19361,17421,-1940
2016,12,14,15,19283,19482,17419,-2063
2016,12,14,16,19322,19508,17340,-2168
2016,12,14,17,19234,19438,16967,-2471
2016,12,14,18,19119,19289,16339,-2950
2016,12,14,19,19101,19299,16520,-2779
2016,12,14,20,19081,19416,16712,-2704
2016,12,14,21,19282,19793,17203,-2590
2016,12,14,22,20218,20964,18520,-2444
2016,12,14,23,21350,22208,20144,-2064
2016,12,15,0,21330,22141,20168,-1973
2016,12,15,1,20989,21815,19538,-2277
2016,12,15,2,20501,21283,18643,-2640
2016,12,15,3,19694,20328,17706,-2622
2016,12,15,4,18474,18896,16417,-2479
2016,12,15,5,17169,17438,15344,-2094
2016,12,15,6,16138,16376,14081,-2295
2016,12,15,7,15605,15792,13702,-2090
2016,12,15,8,15324,15513,13449,-2064
2016,12,15,9,15277,15486,13644,-1842
2016,12,15,10,15531,15815,13854,-1961
2016,12,15,11,16414,16891,14529,-2362
2016,12,15,12,18108,18832,16361,-2471
2016,12,15,13,19395,20147,17999,-2148
2016,12,15,14,19859,20591,17936,-2655
2016,12,15,15,20214,20985,18276,-2709
2016,12,15,16,20363,21328,18358,-2970
2016,12,15,17,20399,21295,18354,-2941
2016,12,15,18,20343,21285,18403,-2882
2016,12,15,19,20341,21373,18505,-2868
2016,12,15,20,20321,21548,18156,-3392
2016,12,15,21,20483,21797,18418,-3379
2016,12,15,22,21417,22903,20405,-2498
2016,12,15,23,22564,24164,21982,-2182
2016,12,16,0,22549,24079,21914,-2165
2016,12,16,1,22192,23734,21709,-2025
2016,12,16,2,21656,23123,20231,-2892
2016,12,16,3,20792,22183,18709,-3474
2016,12,16,4,19539,20708,17092,-3616
2016,12,16,5,18212,19157,15462,-3695
2016,12,16,6,17302,18050,14088,-3962
2016,12,16,7,16742,17402,13455,-3947
2016,12,16,8,16446,17061,13205,-3856
2016,12,16,9,16375,16952,12924,-4028
2016,12,16,10,16610,17211,13426,-3785
2016,12,16,11,17455,18206,14663,-3543
2016,12,16,12,19095,20008,16703,-3305
2016,12,16,13,20298,21221,17974,-3247
2016,12,16,14,20670,21646,17957,-3689
2016,12,16,15,20910,21939,17862,-4077
2016,12,16,16,20924,21840,17592,-4248
2016,12,16,17,20806,21629,17801,-3828
2016,12,16,18,20602,21339,17353,-3986
2016,12,16,19,20465,21235,16620,-4615
2016,12,16,20,20337,21214,16700,-4514
2016,12,16,21,20383,21453,17621,-3832
2016,12,16,22,21150,22419,19097,-3322
2016,12,16,23,22112,23273,20390,-2883
2016,12,17,0,22008,23040,20017,-3023
2016,12,17,1,21587,22550,19309,-3241
2016,12,17,2,21048,22015,18388,-3627
2016,12,17,3,20342,21198,17334,-3864
2016,12,17,4,19361,20004,15696,-4308
2016,12,17,5,18229,18633,14714,-3919
2016,12,17,6,17289,17475,13800,-3675
2016,12,17,7,16643,16748,13396,-3352
2016,12,17,8,16230,16287,12588,-3699
2016,12,17,9,16001,16113,12460,-3653
2016,12,17,10,15942,16150,12495,-3655
2016,12,17,11,16106,16485,12657,-3828
2016,12,17,12,16453,17165,13515,-3650
2016,12,17,13,16938,17979,14654,-3325
2016,12,17,14,17568,18929,15570,-3359
2016,12,17,15,18173,19754,16413,-3341
2016,12,17,16,18462,20265,16627,-3638
2016,12,17,17,18603,20320,16409,-3911
2016,12,17,18,18537,20108,16297,-3811
2016,12,17,19,18417,19778,16426,-3352
2016,12,17,20,18327,19493,16448,-3045
2016,12,17,21,18403,19494,16165,-3329
2016,12,17,22,19137,20277,17019,-3258
2016,12,17,23,19914,21097,17472,-3625
2016,12,18,0,19721,20895,17580,-3315
2016,12,18,1,19309,20443,17329,-3114
2016,12,18,2,18836,19887,16962,-2925
2016,12,18,3,18242,19158,16113,-3045
2016,12,18,4,17459,18201,14794,-3407
2016,12,18,5,16521,17030,13937,-3093
2016,12,18,6,15637,16042,12887,-3155
2016,12,18,7,14904,15301,12319,-2982
2016,12,18,8,14462,14821,11796,-3025
2016,12,18,9,14199,14555,11438,-3117
2016,12,18,10,14114,14503,11283,-3220
2016,12,18,11,14239,14706,11440,-3266
2016,12,18,12,14547,15152,11832,-3320
2016,12,18,13,14940,15775,12506,-3269
2016,12,18,14,15602,16639,13333,-3306
2016,12,18,15,16385,17416,14182,-3234
2016,12,18,16,16853,17853,14979,-2874
2016,12,18,17,17123,18105,15002,-3103
2016,12,18,18,17271,18234,14964,-3270
2016,12,18,19,17302,18188,14689,-3499
2016,12,18,20,17308,18269,14706,-3563
2016,12,18,21,17518,18619,14824,-3795
2016,12,18,22,18528,19669,15759,-3910
2016,12,18,23,19727,20744,17000,-3744
2016,12,19,0,19796,20795,17177,-3618
2016,12,19,1,19558,20612,17124,-3488
2016,12,19,2,19264,20237,16561,-3676
2016,12,19,3,18661,19551,15907,-3644
2016,12,19,4,17785,18419,14935,-3484
2016,12,19,5,16756,17206,13561,-3645
2016,12,19,6,16071,16285,12093,-4192
2016,12,19,7,15550,15773,11630,-4143
2016,12,19,8,15302,15520,11750,-3770
2016,12,19,9,15269,15501,11928,-3573
2016,12,19,10,15569,15813,12530,-3283
2016,12,19,11,16533,16887,13450,-3437
2016,12,19,12,18311,18752,16033,-2719
2016,12,19,13,19654,20214,18289,-1925
2016,12,19,14,20076,20765,18574,-2191
2016,12,19,15,20379,20909,18068,-2841
2016,12,19,16,20467,20819,17784,-3035
2016,12,19,17,20328,20662,17024,-3638
2016,12,19,18,20159,20478,16322,-4156
2016,12,19,19,20071,20441,16335,-4106
2016,12,19,20,19979,20502,16597,-3905
2016,12,19,21,20096,20846,17214,-3632
2016,12,19,22,20969,21918,19173,-2745
2016,12,19,23,22093,23195,20663,-2532
2016,12,20,0,22145,23194,20194,-3000
2016,12,20,1,21886,22907,19641,-3266
2016,12,20,2,21412,22392,18640,-3752
2016,12,20,3,20606,21508,17434,-4074
2016,12,20,4,19406,20043,15899,-4144
2016,12,20,5,18099,18508,14268,-4240
2016,12,20,6,16900,17394,13350,-4044
2016,12,20,7,16268,16780,12778,-4002
2016,12,20,8,15940,16469,12422,-4047
2016,12,20,9,15838,16387,12376,-4011
2016,12,20,10,16052,16654,12616,-4038
2016,12,20,11,16918,17652,13743,-3909
2016,12,20,12,18639,19431,15932,-3499
2016,12,20,13,19831,20676,17405,-3271
2016,12,20,14,20086,21012,17117,-3895
2016,12,20,15,20247,21042,17181,-3861
2016,12,20,16,20211,20953,17007,-3946
2016,12,20,17,19979,20769,16888,-3881
2016,12,20,18,19760,20486,16602,-3884
2016,12,20,19,19643,20412,16621,-3791
2016,12,20,20,19510,20363,16782,-3581
2016,12,20,21,19610,20502,16743,-3759
2016,12,20,22,20461,21446,17655,-3791
2016,12,20,23,21487,22744,19323,-3421
2016,12,21,0,21458,22663,19435,-3228
2016,12,21,1,21151,22250,19218,-3032
2016,12,21,2,20704,21729,18747,-2982
2016,12,21,3,19922,20756,17884,-2872
2016,12,21,4,18740,19235,16145,-3090
2016,12,21,5,17469,17685,14740,-2945
2016,12,21,6,16577,16554,13600,-2954
2016,12,21,7,15977,15919,13009,-2910
2016,12,21,8,15624,15566,12442,-3124
2016,12,21,9,15506,15457,12584,-2873
2016,12,21,10,15677,15740,12695,-3045
2016,12,21,11,16428,16699,13252,-3447
2016,12,21,12,17942,18477,14523,-3954
2016,12,21,13,19011,19703,16640,-3063
2016,12,21,14,19294,20015,16695,-3320
2016,12,21,15,19464,20068,16399,-3669
2016,12,21,16,19455,20043,16142,-3901
2016,12,21,17,19329,19983,16215,-3768
2016,12,21,18,19137,19920,16182,-3738
2016,12,21,19,19078,19843,16308,-3535
2016,12,21,20,19023,19790,16449,-3341
2016,12,21,21,19177,19968,16673,-3295
2016,12,21,22,20111,20964,17003,-3961
2016,12,21,23,21230,21987,18297,-3690
2016,12,22,0,21154,21892,18196,-3696
2016,12,22,1,20759,21520,17972,-3548
2016,12,22,2,20264,20950,17629,-3321
2016,12,22,3,19495,20043,16637,-3406
2016,12,22,4,18300,18671,15141,-3530
2016,12,22,5,16966,17135,13791,-3344
2016,12,22,6,16096,15952,12863,-3089
2016,12,22,7,15435,15291,12243,-3048
2016,12,22,8,15039,15017,12563,-2454
2016,12,22,9,14887,14885,12376,-2509
2016,12,22,10,15034,15104,12499,-2605
2016,12,22,11,15724,15977,13266,-2711
2016,12,22,12,17072,17689,14759,-2930
2016,12,22,13,18178,18990,16322,-2668
2016,12,22,14,18687,19552,16498,-3054
2016,12,22,15,19081,19856,16606,-3250
2016,12,22,16,19222,19933,16742,-3191
2016,12,22,17,19172,19763,16363,-3400
2016,12,22,18,18990,19445,15902,-3543
2016,12,22,19,18931,19273,15752,-3521
2016,12,22,20,18879,19222,15557,-3665
2016,12,22,21,18987,19454,15714,-3740
2016,12,22,22,19921,20369,16313,-4056
2016,12,22,23,21144,21481,17434,-4047
2016,12,23,0,21075,21366,17381,-3985
2016,12,23,1,20642,21012,17263,-3749
2016,12,23,2,20057,20507,17074,-3433
2016,12,23,3,19235,19657,16247,-3410
2016,12,23,4,17996,18399,15357,-3042
2016,12,23,5,16600,16949,13798,-3151
2016,12,23,6,15886,15720,13233,-2487
2016,12,23,7,15199,15003,12761,-2242
2016,12,23,8,14741,14614,12341,-2273
2016,12,23,9,14517,14489,12258,-2231
2016,12,23,10,14602,14698,12469,-2229
2016,12,23,11,15072,15501,13209,-2292
2016,12,23,12,16132,17043,14521,-2522
2016,12,23,13,17077,18227,15619,-2608
2016,12,23,14,17794,18661,15633,-3028
2016,12,23,15,18289,18805,15859,-2946
2016,12,23,16,18498,18796,15974,-2822
2016,12,23,17,18413,18632,15818,-2814
2016,12,23,18,18042,18405,15494,-2911
2016,12,23,19,17815,18260,15259,-3001
2016,12,23,20,17696,18226,15344,-2882
2016,12,23,21,17646,18459,15837,-2622
2016,12,23,22,18370,19512,16626,-2886
2016,12,23,23,19572,20638,17711,-2927
2016,12,24,0,19416,20474,17632,-2842
2016,12,24,1,18820,20081,17432,-2649
2016,12,24,2,18250,19596,16975,-2621
2016,12,24,3,17848,18959,16281,-2678
2016,12,24,4,17240,17877,15065,-2812
2016,12,24,5,16213,16635,14063,-2572
2016,12,24,6,15297,15523,13016,-2507
2016,12,24,7,14590,14763,12405,-2358
2016,12,24,8,14133,14304,11748,-2556
2016,12,24,9,13864,14052,11872,-2180
2016,12,24,10,13781,14027,11818,-2209
2016,12,24,11,13820,14300,12226,-2074
2016,12,24,12,13882,14905,12559,-2346
2016,12,24,13,14271,15810,13580,-2230
2016,12,24,14,15084,16756,14153,-2603
2016,12,24,15,15935,17739,14936,-2803
2016,12,24,16,16357,18311,15259,-3052
2016,12,24,17,16683,18533,15784,-2749
2016,12,24,18,16585,18464,15696,-2768
2016,12,24,19,16377,18222,15663,-2559
2016,12,24,20,16236,17840,15592,-2248
2016,12,24,21,16259,17675,15489,-2186
2016,12,24,22,17000,18247,15899,-2348
2016,12,24,23,17953,19005,16453,-2552
2016,12,25,0,17779,18663,16066,-2597
2016,12,25,1,17404,18204,15775,-2429
2016,12,25,2,17027,17848,15514,-2334
2016,12,25,3,16739,17491,14998,-2493
2016,12,25,4,16355,16847,13873,-2974
2016,12,25,5,15738,16026,13162,-2864
2016,12,25,6,15008,15193,12277,-2916
2016,12,25,7,14419,14532,11938,-2594
2016,12,25,8,14036,14082,11515,-2567
2016,12,25,9,13831,13848,11546,-2302
2016,12,25,10,13747,13810,11563,-2247
2016,12,25,11,13726,13996,11446,-2550
2016,12,25,12,13649,14449,12167,-2282
2016,12,25,13,13737,15024,12642,-2382
2016,12,25,14,14294,15614,12929,-2685
2016,12,25,15,14921,16007,12830,-3177
2016,12,25,16,15242,16143,12847,-3296
2016,12,25,17,15491,16168,12795,-3373
2016,12,25,18,15588,16108,12440,-3668
2016,12,25,19,15526,15996,12384,-3612
2016,12,25,20,15477,15933,12382,-3551
2016,12,25,21,15656,16017,12795,-3222
2016,12,25,22,16597,16692,13197,-3495
2016,12,25,23,17880,17729,14099,-3630
2016,12,26,0,18148,17762,14177,-3585
2016,12,26,1,18145,17773,14217,-3556
2016,12,26,2,18009,17777,14208,-3569
2016,12,26,3,17627,17600,14399,-3201
2016,12,26,4,16954,16897,13431,-3466
2016,12,26,5,15796,16020,12010,-4010
2016,12,26,6,11779,15244,11632,-3612
2016,12,26,7,10332,14730,11662,-3068
2016,12,26,8,9581,14447,11861,-2586
2016,12,26,9,9097,14344,11629,-2715
2016,12,26,10,9033,14471,11769,-2702
2016,12,26,11,11000,14830,12490,-2340
2016,12,26,12,11264,15521,12883,-2638
2016,12,26,13,12469,16176,13082,-3094
2016,12,26,14,14059,16835,13787,-3048
2016,12,26,15,16979,17540,14645,-2895
2016,12,26,16,18314,18027,14707,-3320
2016,12,26,17,17742,18297,14754,-3543
2016,12,26,18,18090,18364,14845,-3519
2016,12,26,19,17475,18375,14848,-3527
2016,12,26,20,15881,18387,15055,-3332
2016,12,26,21,16866,18531,15221,-3310
2016,12,26,22,18770,19317,16390,-2927
2016,12,26,23,21563,20169,16954,-3215
2016,12,27,0,22007,19985,16709,-3276
2016,12,27,1,21720,19584,16415,-3169
2016,12,27,2,21317,19006,16277,-2729
2016,12,27,3,20238,18213,15766,-2447
2016,12,27,4,18922,17028,14549,-2479
2016,12,27,5,17500,15757,13184,-2573
2016,12,27,6,13631,14718,12067,-2651
2016,12,27,7,12371,14049,11189,-2860
2016,12,27,8,11817,13680,11017,-2663
2016,12,27,9,11577,13504,10504,-3000
2016,12,27,10,11799,13679,10898,-2781
2016,12,27,11,12859,14399,11594,-2805
2016,12,27,12,15020,15641,12838,-2803
2016,12,27,13,16837,16821,13894,-2927
2016,12,27,14,17834,17596,14512,-3084
2016,12,27,15,18720,18228,14979,-3249
2016,12,27,16,19291,18663,15069,-3594
2016,12,27,17,18912,18721,14656,-4065
2016,12,27,18,18871,18454,14526,-3928
2016,12,27,19,18848,18402,14748,-3654
2016,12,27,20,18889,18348,14965,-3383
2016,12,27,21,19020,18482,15333,-3149
2016,12,27,22,19927,19295,15921,-3374
2016,12,27,23,21154,20389,16814,-3575
2016,12,28,0,21050,20274,16641,-3633
2016,12,28,1,20553,19871,16403,-3468
2016,12,28,2,19929,19324,15792,-3532
2016,12,28,3,19035,18536,15177,-3359
2016,12,28,4,17771,17417,14092,-3325
2016,12,28,5,16361,16166,13086,-3080
2016,12,28,6,15257,15148,11689,-3459
2016,12,28,7,14720,14571,11236,-3335
2016,12,28,8,14412,14248,11226,-3022
2016,12,28,9,14321,14123,11177,-2946
2016,12,28,10,14526,14319,11239,-3080
2016,12,28,11,15300,15073,12066,-3007
2016,12,28,12,16769,16398,13014,-3384
2016,12,28,13,17895,17554,13970,-3584
2016,12,28,14,18328,18278,14452,-3826
2016,12,28,15,18645,18835,14854,-3981
2016,12,28,16,18810,19130,15042,-4088
2016,12,28,17,18864,19259,15266,-3993
2016,12,28,18,18786,19258,14918,-4340
2016,12,28,19,18766,19241,14609,-4632
2016,12,28,20,18790,19202,14819,-4383
2016,12,28,21,18919,19347,14990,-4357
2016,12,28,22,19799,20146,15634,-4512
2016,12,28,23,20982,21183,16782,-4401
2016,12,29,0,20903,21041,16593,-4448
2016,12,29,1,20511,20616,15959,-4657
2016,12,29,2,19997,20037,15534,-4503
2016,12,29,3,19202,19186,14849,-4337
2016,12,29,4,17990,18005,13972,-4033
2016,12,29,5,16672,16698,13184,-3514
2016,12,29,6,15410,15708,12540,-3168
2016,12,29,7,14784,15092,12037,-3055
2016,12,29,8,14428,14743,11587,-3156
2016,12,29,9,14304,14610,11566,-3044
2016,12,29,10,14481,14794,12088,-2706
2016,12,29,11,15237,15516,12707,-2809
2016,12,29,12,16650,16770,14137,-2633
2016,12,29,13,17816,17993,15046,-2947
2016,12,29,14,18328,18749,15647,-3102
2016,12,29,15,18751,19430,16165,-3265
2016,12,29,16,18970,19840,16319,-3521
2016,12,29,17,18991,20013,16206,-3807
2016,12,29,18,18910,20028,16306,-3722
2016,12,29,19,18875,19945,16167,-3778
2016,12,29,20,18873,19796,15962,-3834
2016,12,29,21,18980,19844,15661,-4183
2016,12,29,22,19819,20453,16358,-4095
2016,12,29,23,20824,21244,17039,-4205
2016,12,30,0,20634,20974,16948,-4026
2016,12,30,1,20196,20479,16625,-3854
2016,12,30,2,19664,19918,16486,-3432
2016,12,30,3,18886,19096,15918,-3178
2016,12,30,4,17722,17897,14714,-3183
2016,12,30,5,16463,16644,13529,-3115
2016,12,30,6,15566,15611,12284,-3327
2016,12,30,7,14995,14975,11661,-3314
2016,12,30,8,14662,14630,11746,-2884
2016,12,30,9,14547,14498,11799,-2699
2016,12,30,10,14720,14668,11740,-2928
2016,12,30,11,15415,15366,12022,-3344
2016,12,30,12,16742,16571,13413,-3158
2016,12,30,13,17856,17626,14096,-3530
2016,12,30,14,18475,18304,14569,-3735
2016,12,30,15,18940,18812,15126,-3686
2016,12,30,16,19261,19097,15347,-3750
2016,12,30,17,19296,19294,15576,-3718
2016,12,30,18,19216,19257,15539,-3718
2016,12,30,19,19161,19256,15436,-3820
2016,12,30,20,19190,19097,15110,-3987
2016,12,30,21,19233,19171,15293,-3878
2016,12,30,22,19857,19918,16032,-3886
2016,12,30,23,20720,21104,17005,-4099
2016,12,31,0,20510,20922,16931,-3991
2016,12,31,1,20029,20463,16472,-3991
2016,12,31,2,19522,19938,16108,-3830
2016,12,31,3,18949,19281,15447,-3834
2016,12,31,4,18126,18298,14311,-3987
2016,12,31,5,17134,17190,13377,-3813
2016,12,31,6,16027,16153,12268,-3885
2016,12,31,7,15357,15485,11635,-3850
2016,12,31,8,14952,15077,10903,-4174
2016,12,31,9,14754,14855,10767,-4088
2016,12,31,10,14752,14871,10863,-4008
2016,12,31,11,14994,15117,11463,-3654
2016,12,31,12,15468,15698,12193,-3505
2016,12,31,13,16017,16326,12768,-3558
2016,12,31,14,16656,16955,13168,-3787
2016,12,31,15,17295,17668,13987,-3681
2016,12,31,16,17587,17998,14279,-3719
2016,12,31,17,17695,18049,14424,-3625
2016,12,31,18,17630,17972,14492,-3480
2016,12,31,19,17501,17863,14330,-3533
2016,12,31,20,17424,17847,14328,-3519
2016,12,31,21,17539,18117,14465,-3652
2016,12,31,22,18377,19122,15400,-3722
2016,12,31,23,19283,20159,16637,-3522
2017,1,1,0,19201,19927,16377,-3550
2017,1,1,1,18815,19330,15538,-3792
2017,1,1,2,18360,18664,15083,-3581
2017,1,1,3,17858,17933,14538,-3395
2017,1,1,4,17153,17134,13963,-3171
2017,1,1,5,16306,16400,13204,-3196
2017,1,1,6,15413,15665,12736,-2929
2017,1,1,7,14879,14998,11874,-3124
2017,1,1,8,14464,14438,11699,-2739
2017,1,1,9,14210,14064,11528,-2536
2017,1,1,10,14070,13932,11324,-2608
2017,1,1,11,13956,14062,11665,-2397
2017,1,1,12,13714,14366,12359,-2007
2017,1,1,13,13592,14591,12428,-2163
2017,1,1,14,13999,14980,12489,-2491
2017,1,1,15,14643,15411,12714,-2697
2017,1,1,16,15098,15795,13313,-2482
2017,1,1,17,15454,16015,13245,-2770
2017,1,1,18,15601,16102,13307,-2795
2017,1,1,19,15557,16119,13232,-2887
2017,1,1,20,15526,16142,13256,-2886
2017,1,1,21,15699,16318,13505,-2813
2017,1,1,22,16419,17205,14369,-2836
2017,1,1,23,17738,18637,15659,-2978
2017,1,2,0,17978,18776,15920,-2856
2017,1,2,1,17932,18589,15505,-3084
2017,1,2,2,17735,18347,15385,-2962
2017,1,2,3,17297,17819,14976,-2843
2017,1,2,4,16657,16990,14492,-2498
2017,1,2,5,15930,16084,13516,-2568
2017,1,2,6,14725,15269,12206,-3063
2017,1,2,7,14163,14699,11489,-3210
2017,1,2,8,13783,14379,11260,-3119
2017,1,2,9,13576,14263,11423,-2840
2017,1,2,10,13647,14388,11770,-2618
2017,1,2,11,14032,14845,12019,-2826
2017,1,2,12,14544,15548,12568,-2980
2017,1,2,13,15101,16252,13242,-3010
2017,1,2,14,15817,16923,13909,-3014
2017,1,2,15,16515,17634,14583,-3051
2017,1,2,16,17215,18214,15118,-3096
2017,1,2,17,17592,18507,15030,-3477
2017,1,2,18,17642,18620,14817,-3803
2017,1,2,19,17528,18579,14782,-3797
2017,1,2,20,17562,18599,14840,-3759
2017,1,2,21,17540,18781,15007,-3774
2017,1,2,22,18026,19601,16052,-3549
2017,1,2,23,19530,20545,16708,-3837
2017,1,3,0,19424,20456,16974,-3482
2017,1,3,1,18998,20063,16716,-3347
2017,1,3,2,18409,19447,16347,-3100
2017,1,3,3,17530,18514,15873,-2641
2017,1,3,4,16372,17229,13999,-3230
2017,1,3,5,15224,15922,12813,-3109
2017,1,3,6,14559,14978,11796,-3182
2017,1,3,7,14053,14420,11710,-2710
2017,1,3,8,13755,14141,11476,-2665
2017,1,3,9,13646,14044,11036,-3008
2017,1,3,10,13825,14291,11369,-2922
2017,1,3,11,14570,15269,11805,-3464
2017,1,3,12,15980,17062,13373,-3689
2017,1,3,13,17109,18407,14646,-3761
2017,1,3,14,17546,18844,15028,-3816
2017,1,3,15,17975,19199,15908,-3291
2017,1,3,16,18190,19515,16203,-3312
2017,1,3,17,18276,19692,16278,-3414
2017,1,3,18,18249,19720,16343,-3377
2017,1,3,19,18223,19734,16551,-3183
2017,1,3,20,18164,19687,16481,-3206
2017,1,3,21,18222,19880,16574,-3306
2017,1,3,22,18799,20600,16996,-3604
2017,1,3,23,19833,21279,17977,-3302
2017,1,4,0,19646,21038,17707,-3331
2017,1,4,1,19194,20530,16965,-3565
2017,1,4,2,18606,19775,16428,-3347
2017,1,4,3,17727,18776,15317,-3459
2017,1,4,4,16586,17346,14328,-3018
2017,1,4,5,15416,15791,12868,-2923
2017,1,4,6,14575,14774,11588,-3186
2017,1,4,7,13974,14343,10807,-3536
2017,1,4,8,13631,14078,10968,-3110
2017,1,4,9,13509,13967,10653,-3314
2017,1,4,10,13705,14196,11047,-3149
2017,1,4,11,14549,15106,12029,-3077
2017,1,4,12,16216,16915,13817,-3098
2017,1,4,13,17468,18267,15165,-3102
2017,1,4,14,17832,18584,15425,-3159
2017,1,4,15,18171,18808,15637,-3171
2017,1,4,16,18311,18977,15615,-3362
2017,1,4,17,18381,19017,15908,-3109
2017,1,4,18,18357,19006,15779,-3227
2017,1,4,19,18374,18925,15896,-3029
2017,1,4,20,18371,18846,15708,-3138
2017,1,4,21,18537,19018,15730,-3288
2017,1,4,22,19285,19818,16760,-3058
2017,1,4,23,20553,21140,18010,-3130
2017,1,5,0,20529,21187,18186,-3001
2017,1,5,1,20136,20862,17679,-3183
2017,1,5,2,19566,20385,17156,-3229
2017,1,5,3,18691,19529,16415,-3114
2017,1,5,4,17484,18223,14883,-3340
2017,1,5,5,16241,16964,13910,-3054
2017,1,5,6,15498,16035,12815,-3220
2017,1,5,7,14976,15493,12467,-3026
2017,1,5,8,14685,15265,12509,-2756
2017,1,5,9,14608,15254,12456,-2798
2017,1,5,10,14848,15521,13071,-2450
2017,1,5,11,15735,16505,13580,-2925
2017,1,5,12,17475,18312,15156,-3156
2017,1,5,13,18771,19660,16716,-2944
2017,1,5,14,19115,20018,16975,-3043
2017,1,5,15,19412,20288,16837,-3451
2017,1,5,16,19535,20499,17165,-3334
2017,1,5,17,19534,20537,16924,-3613
2017,1,5,18,19452,20365,16992,-3373
2017,1,5,19,19416,20222,17049,-3173
2017,1,5,20,19336,20302,17203,-3099
2017,1,5,21,19443,20487,17218,-3269
2017,1,5,22,20111,21237,18311,-2926
2017,1,5,23,21289,22309,19299,-3010
2017,1,6,0,21263,22179,18979,-3200
2017,1,6,1,20875,21802,18630,-3172
2017,1,6,2,20324,21117,18422,-2695
2017,1,6,3,19441,20117,17219,-2898
2017,1,6,4,18238,18740,15735,-3005
2017,1,6,5,16993,17355,13931,-3424
2017,1,6,6,15856,16313,12809,-3504
2017,1,6,7,15265,15805,12317,-3488
2017,1,6,8,14945,15530,11895,-3635
2017,1,6,9,14843,15473,12042,-3431
2017,1,6,10,15055,15747,12434,-3313
2017,1,6,11,15906,16690,13598,-3092
2017,1,6,12,17557,18462,15266,-3196
2017,1,6,13,18874,19852,16526,-3326
2017,1,6,14,19305,20264,16691,-3573
2017,1,6,15,19637,20474,16598,-3876
2017,1,6,16,19762,20578,16561,-4017
2017,1,6,17,19657,20448,16865,-3583
2017,1,6,18,19518,20274,16439,-3835
2017,1,6,19,19413,20183,16406,-3777
2017,1,6,20,19312,20145,16011,-4134
2017,1,6,21,19347,20290,16510,-3780
2017,1,6,22,19866,21020,17542,-3478
2017,1,6,23,20877,21929,18672,-3257
2017,1,7,0,20862,21793,18624,-3169
2017,1,7,1,20463,21408,18036,-3372
2017,1,7,2,19949,20865,17720,-3145
2017,1,7,3,19279,20158,16914,-3244
2017,1,7,4,18404,19090,15259,-3831
2017,1,7,5,17437,17927,14099,-3828
2017,1,7,6,16635,17024,12755,-4269
2017,1,7,7,16002,16398,11888,-4510
2017,1,7,8,15641,16055,11716,-4339
2017,1,7,9,15469,15899,11421,-4478
2017,1,7,10,15508,15950,11568,-4382
2017,1,7,11,15827,16293,11512,-4781
2017,1,7,12,16433,16932,12522,-4410
2017,1,7,13,17129,17749,13686,-4063
2017,1,7,14,17887,18684,14845,-3839
2017,1,7,15,18613,19544,15556,-3988
2017,1,7,16,18997,20115,15667,-4448
2017,1,7,17,19059,20328,15759,-4569
2017,1,7,18,18998,20288,16014,-4274
2017,1,7,19,18847,20145,16097,-4048
2017,1,7,20,18746,20090,16211,-3879
2017,1,7,21,18780,20179,16120,-4059
2017,1,7,22,19268,20802,16850,-3952
2017,1,7,23,20342,21765,17816,-3949
2017,1,8,0,20421,21818,17566,-4252
2017,1,8,1,20072,21453,17140,-4313
2017,1,8,2,19623,20912,16399,-4513
2017,1,8,3,19057,20181,15454,-4727
2017,1,8,4,18355,19256,14197,-5059
2017,1,8,5,17598,18144,13168,-4976
2017,1,8,6,16797,17313,12321,-4992
2017,1,8,7,16208,16711,11755,-4956
2017,1,8,8,15860,16365,11851,-4514
2017,1,8,9,15680,16202,12037,-4165
2017,1,8,10,15684,16202,12071,-4131
2017,1,8,11,15899,16442,12231,-4211
2017,1,8,12,16334,16962,12821,-4141
2017,1,8,13,16824,17555,13822,-3733
2017,1,8,14,17490,18336,14934,-3402
2017,1,8,15,18202,19036,15627,-3409
2017,1,8,16,18653,19529,15937,-3592
2017,1,8,17,18870,19776,15672,-4104
2017,1,8,18,18940,19991,15833,-4158
2017,1,8,19,18873,20026,16078,-3948
2017,1,8,20,18827,19983,15716,-4267
2017,1,8,21,18948,20215,15796,-4419
2017,1,8,22,19629,20952,16540,-4412
2017,1,8,23,21000,22172,17645,-4527
2017,1,9,0,21244,22226,17778,-4448
2017,1,9,1,20966,21905,17587,-4318
2017,1,9,2,20506,21429,17448,-3981
2017,1,9,3,19767,20567,16494,-4073
2017,1,9,4,18797,19398,14826,-4572
2017,1,9,5,17776,18221,13915,-4306
2017,1,9,6,17087,17414,13218,-4196
2017,1,9,7,16578,16962,12391,-4571
2017,1,9,8,16325,16734,12496,-4238
2017,1,9,9,16269,16787,12643,-4144
2017,1,9,10,16548,17072,12974,-4098
2017,1,9,11,17490,18022,13915,-4107
2017,1,9,12,19241,19816,16016,-3800
2017,1,9,13,20617,21203,17569,-3634
2017,1,9,14,21027,21621,17412,-4209
2017,1,9,15,21340,21959,17828,-4131
2017,1,9,16,21493,22145,17795,-4350
2017,1,9,17,21451,22129,17904,-4225
2017,1,9,18,21286,21984,17597,-4387
2017,1,9,19,21145,21880,17405,-4475
2017,1,9,20,20980,21728,17239,-4489
2017,1,9,21,20982,21706,17823,-3883
2017,1,9,22,21537,22311,18327,-3984
2017,1,9,23,22782,23526,19531,-3995
2017,1,10,0,22828,23511,19650,-3861
2017,1,10,1,22382,23121,19236,-3885
2017,1,10,2,21692,22485,18511,-3974
2017,1,10,3,20662,21494,17516,-3978
2017,1,10,4,19315,20072,16052,-4020
2017,1,10,5,17956,18670,14877,-3793
2017,1,10,6,17090,17663,14388,-3275
2017,1,10,7,16521,17044,13896,-3148
2017,1,10,8,16201,16696,13207,-3489
2017,1,10,9,16077,16598,12992,-3606
2017,1,10,10,16267,16857,13477,-3380
2017,1,10,11,17094,17801,14386,-3415
2017,1,10,12,18694,19620,16036,-3584
2017,1,10,13,19975,20911,17293,-3618
2017,1,10,14,20323,21218,17976,-3242
2017,1,10,15,20605,21435,18011,-3424
2017,1,10,16,20720,21583,18543,-3040
2017,1,10,17,20631,21450,18142,-3308
2017,1,10,18,20498,21220,18177,-3043
2017,1,10,19,20391,21164,18082,-3082
2017,1,10,20,20246,21098,18119,-2979
2017,1,10,21,20275,21192,18046,-3146
2017,1,10,22,20760,21828,18620,-3208
2017,1,10,23,21687,22636,19636,-3000
2017,1,11,0,21491,22399,19577,-2822
2017,1,11,1,20938,21880,19021,-2859
2017,1,11,2,20255,21140,17877,-3263
2017,1,11,3,19286,19958,16552,-3406
2017,1,11,4,18017,18530,14696,-3834
2017,1,11,5,16735,17029,13417,-3612
2017,1,11,6,15773,16005,12925,-3080
2017,1,11,7,15169,15411,12421,-2990
2017,1,11,8,14813,15086,12351,-2735
2017,1,11,9,14673,14933,12256,-2677
2017,1,11,10,14837,15092,12329,-2763
2017,1,11,11,15636,15913,12853,-3060
2017,1,11,12,17277,17674,14318,-3356
2017,1,11,13,18527,18974,16036,-2938
2017,1,11,14,18845,19178,15957,-3221
2017,1,11,15,19073,19168,15737,-3431
2017,1,11,16,19163,19050,15345,-3705
2017,1,11,17,19143,19059,15505,-3554
2017,1,11,18,19033,18857,14977,-3880
2017,1,11,19,18976,18816,14947,-3869
2017,1,11,20,18901,18701,14990,-3711
2017,1,11,21,18993,18804,15086,-3718
2017,1,11,22,19519,19508,15797,-3711
2017,1,11,23,20549,20612,17053,-3559
2017,1,12,0,20470,20541,17173,-3368
2017,1,12,1,19981,20116,16761,-3355
2017,1,12,2,19361,19470,16314,-3156
2017,1,12,3,18484,18506,15347,-3159
2017,1,12,4,17301,17166,14175,-2991
2017,1,12,5,16077,15829,13064,-2765
2017,1,12,6,14772,14844,11549,-3295
2017,1,12,7,14170,14267,11244,-3023
2017,1,12,8,13827,13945,11221,-2724
2017,1,12,9,13678,13839,11284,-2555
2017,1,12,10,13844,14044,11213,-2831
2017,1,12,11,14639,14915,12012,-2903
2017,1,12,12,16273,16733,13715,-3018
2017,1,12,13,17534,18095,14932,-3163
2017,1,12,14,17907,18483,15017,-3466
2017,1,12,15,18292,18725,15510,-3215
2017,1,12,16,18458,18752,15470,-3282
2017,1,12,17,18488,18724,15453,-3271
2017,1,12,18,18419,18655,15076,-3579
2017,1,12,19,18389,18609,15265,-3344
2017,1,12,20,18318,18553,15193,-3360
2017,1,12,21,18402,18649,15646,-3003
2017,1,12,22,18944,19201,15385,-3816
2017,1,12,23,19914,20079,16168,-3911
2017,1,13,0,19810,19948,16298,-3650
2017,1,13,1,19300,19502,16003,-3499
2017,1,13,2,18652,18878,15470,-3408
2017,1,13,3,17732,17955,14617,-3338
2017,1,13,4,16518,16675,13022,-3653
2017,1,13,5,15289,15369,11528,-3841
2017,1,13,6,14206,14467,10665,-3802
2017,1,13,7,13678,13919,10295,-3624
2017,1,13,8,13391,13618,9975,-3643
2017,1,13,9,13310,13569,10087,-3482
2017,1,13,10,13554,13838,10059,-3779
2017,1,13,11,14469,14756,11126,-3630
2017,1,13,12,16299,16651,13093,-3558
2017,1,13,13,17697,18062,14738,-3324
2017,1,13,14,18114,18509,15189,-3320
2017,1,13,15,18390,18751,15181,-3570
2017,1,13,16,18538,18883,15247,-3636
2017,1,13,17,18521,18775,15115,-3660
2017,1,13,18,18408,18611,14777,-3834
2017,1,13,19,18347,18582,14561,-4021
2017,1,13,20,18291,18574,14490,-4084
2017,1,13,21,18379,18828,14651,-4177
2017,1,13,22,18860,19512,15078,-4434
2017,1,13,23,19921,20576,16317,-4259
2017,1,14,0,20017,20479,16192,-4287
2017,1,14,1,19599,20039,15859,-4180
2017,1,14,2,19037,19529,15344,-4185
2017,1,14,3,18355,18843,14429,-4414
2017,1,14,4,17438,17852,13314,-4538
2017,1,14,5,16443,16753,12459,-4294
2017,1,14,6,15464,15869,11341,-4528
2017,1,14,7,14862,15311,10820,-4491
2017,1,14,8,14522,14991,10662,-4329
2017,1,14,9,14361,14869,10734,-4135
2017,1,14,10,14439,14945,10729,-4216
2017,1,14,11,14843,15331,11441,-3890
2017,1,14,12,15579,16055,12128,-3927
2017,1,14,13,16430,16845,13228,-3617
2017,1,14,14,17176,17575,13823,-3752
2017,1,14,15,17795,18152,14266,-3886
2017,1,14,16,18094,18457,14652,-3805
2017,1,14,17,18079,18531,14727,-3804
2017,1,14,18,17953,18637,14783,-3854
2017,1,14,19,17738,18623,14688,-3935
2017,1,14,20,17594,18630,14812,-3818
2017,1,14,21,17605,18809,15069,-3740
2017,1,14,22,18058,19318,15763,-3555
2017,1,14,23,19160,20071,16911,-3160
2017,1,15,0,19295,20064,16653,-3411
2017,1,15,1,18924,19665,16227,-3438
2017,1,15,2,18455,19210,16028,-3182
2017,1,15,3,17849,18531,15354,-3177
2017,1,15,4,17071,17661,14123,-3538
2017,1,15,5,16236,16729,13124,-3605
2017,1,15,6,15338,15863,11923,-3940
2017,1,15,7,14747,15288,11537,-3751
2017,1,15,8,14378,14937,11612,-3325
2017,1,15,9,14187,14770,11483,-3287
2017,1,15,10,14180,14776,11547,-3229
2017,1,15,11,14384,15039,11769,-3270
2017,1,15,12,14793,15542,12272,-3270
2017,1,15,13,15253,16077,12912,-3165
2017,1,15,14,15895,16755,12977,-3778
2017,1,15,15,16483,17277,12907,-4370
2017,1,15,16,16854,17547,13152,-4395
2017,1,15,17,16969,17585,13112,-4473
2017,1,15,18,16948,17492,12798,-4694
2017,1,15,19,16832,17349,12759,-4590
2017,1,15,20,16735,17313,12846,-4467
2017,1,15,21,16824,17486,13201,-4285
2017,1,15,22,17439,18176,13874,-4302
2017,1,15,23,18861,19446,15203,-4243
2017,1,16,0,19226,19602,15639,-3963
2017,1,16,1,19019,19270,15397,-3873
2017,1,16,2,18629,18908,15200,-3708
2017,1,16,3,17954,18345,14642,-3703
2017,1,16,4,17023,17514,13624,-3890
2017,1,16,5,16077,16618,12648,-3970
2017,1,16,6,15474,15788,11504,-4284
2017,1,16,7,15012,15331,11434,-3897
2017,1,16,8,14742,15091,11532,-3559
2017,1,16,9,14648,15040,11655,-3385
2017,1,16,10,14859,15295,11864,-3431
2017,1,16,11,15547,16040,12457,-3583
2017,1,16,12,16721,17244,13673,-3571
2017,1,16,13,17617,18247,14623,-3624
2017,1,16,14,18202,18860,14612,-4248
2017,1,16,15,18654,19150,14894,-4256
2017,1,16,16,18844,19210,14995,-4215
2017,1,16,17,18842,19081,14950,-4131
2017,1,16,18,18639,18843,14565,-4278
2017,1,16,19,18546,18678,14203,-4475
2017,1,16,20,18428,18633,14106,-4527
2017,1,16,21,18451,18765,14666,-4099
2017,1,16,22,18959,19440,15172,-4268
2017,1,16,23,20185,20728,16337,-4391
2017,1,17,0,20319,20728,16601,-4127
2017,1,17,1,19956,20295,15909,-4386
2017,1,17,2,19358,19623,15572,-4051
2017,1,17,3,18485,18652,14594,-4058
2017,1,17,4,17298,17345,12932,-4413
2017,1,17,5,16147,16054,11614,-4440
2017,1,17,6,15102,15185,10783,-4402
2017,1,17,7,14590,14676,10600,-4076
2017,1,17,8,14318,14380,10331,-4049
2017,1,17,9,14233,14328,10330,-3998
2017,1,17,10,14458,14614,10700,-3914
2017,1,17,11,15331,15580,11321,-4259
2017,1,17,12,17004,17424,13017,-4407
2017,1,17,13,18306,18740,14498,-4242
2017,1,17,14,18667,19123,15055,-4068
2017,1,17,15,18897,19471,15095,-4376
2017,1,17,16,18998,19741,15345,-4396
2017,1,17,17,18997,19846,15496,-4350
2017,1,17,18,18880,19856,15223,-4633
2017,1,17,19,18803,19874,15252,-4622
2017,1,17,20,18704,19871,15435,-4436
2017,1,17,21,18763,20014,15787,-4227
2017,1,17,22,19265,20551,16614,-3937
2017,1,17,23,20244,21213,17189,-4024
2017,1,18,0,20188,20990,16566,-4424
2017,1,18,1,19688,20472,15883,-4589
2017,1,18,2,19038,19776,15882,-3894
2017,1,18,3,18104,18761,15020,-3741
2017,1,18,4,16856,17423,13354,-4069
2017,1,18,5,15608,16117,12425,-3692
2017,1,18,6,14618,15157,11650,-3507
2017,1,18,7,14057,14611,11482,-3129
2017,1,18,8,13741,14277,10934,-3343
2017,1,18,9,13637,14163,10813,-3350
2017,1,18,10,13855,14412,11137,-3275
2017,1,18,11,14747,15296,12127,-3169
2017,1,18,12,16480,17043,13423,-3620
2017,1,18,13,17853,18419,14219,-4200
2017,1,18,14,18269,18962,14403,-4559
2017,1,18,15,18568,19304,14534,-4770
2017,1,18,16,18718,19489,14514,-4975
2017,1,18,17,18743,19578,14701,-4877
2017,1,18,18,18668,19514,14895,-4619
2017,1,18,19,18640,19506,14942,-4564
2017,1,18,20,18591,19405,14657,-4748
2017,1,18,21,18696,19487,14794,-4693
2017,1,18,22,19264,19992,15067,-4925
2017,1,18,23,20319,20766,15927,-4839
2017,1,19,0,20293,20611,15697,-4914
2017,1,19,1,19764,20149,15391,-4758
2017,1,19,2,19096,19520,14989,-4531
2017,1,19,3,18162,18612,14458,-4154
2017,1,19,4,16884,17313,12842,-4471
2017,1,19,5,15586,16019,11947,-4072
2017,1,19,6,14661,15025,10860,-4165
2017,1,19,7,14059,14477,10973,-3504
2017,1,19,8,13720,14206,10792,-3414
2017,1,19,9,13607,14133,10700,-3433
2017,1,19,10,13837,14374,11153,-3221
2017,1,19,11,14767,15293,11940,-3353
2017,1,19,12,16582,17132,13796,-3336
2017,1,19,13,17962,18443,14658,-3785
2017,1,19,14,18336,18747,14921,-3826
2017,1,19,15,18544,18879,14591,-4288
2017,1,19,16,18590,18872,14585,-4287
2017,1,19,17,18517,18767,14272,-4495
2017,1,19,18,18366,18696,14322,-4374
2017,1,19,19,18275,18752,14341,-4411
2017,1,19,20,18177,18737,14301,-4436
2017,1,19,21,18259,18904,14157,-4747
2017,1,19,22,18834,19518,14379,-5139
2017,1,19,23,20022,20435,15160,-5275
2017,1,20,0,20126,20328,15308,-5020
2017,1,20,1,19693,19902,14979,-4923
2017,1,20,2,19084,19275,14923,-4352
2017,1,20,3,18190,18339,14021,-4318
2017,1,20,4,16922,17097,12566,-4531
2017,1,20,5,15639,15821,11508,-4313
2017,1,20,6,14696,14890,10564,-4326
2017,1,20,7,14132,14372,10274,-4098
2017,1,20,8,13817,14095,10294,-3801
2017,1,20,9,13713,14010,10503,-3507
2017,1,20,10,13946,14251,10764,-3487
2017,1,20,11,14876,15153,11424,-3729
2017,1,20,12,16715,16948,13092,-3856
2017,1,20,13,18099,18315,13976,-4339
2017,1,20,14,18493,18758,14505,-4253
2017,1,20,15,18727,19064,14630,-4434
2017,1,20,16,18808,19296,14839,-4457
2017,1,20,17,18710,19258,14744,-4514
2017,1,20,18,18517,19104,14751,-4353
2017,1,20,19,18401,19088,14605,-4483
2017,1,20,20,18278,18975,14655,-4320
2017,1,20,21,18303,19034,14430,-4604
2017,1,20,22,18744,19441,14938,-4503
2017,1,20,23,19646,20085,15621,-4464
2017,1,21,0,19574,19873,15690,-4183
2017,1,21,1,19037,19341,15010,-4331
2017,1,21,2,18383,18703,14943,-3760
2017,1,21,3,17617,17905,14252,-3653
2017,1,21,4,16612,16845,12745,-4100
2017,1,21,5,15530,15719,11633,-4086
2017,1,21,6,14559,14783,10703,-4080
2017,1,21,7,13884,14161,10100,-4061
2017,1,21,8,13480,13793,9892,-3901
2017,1,21,9,13263,13612,9864,-3748
2017,1,21,10,13285,13623,10216,-3407
2017,1,21,11,13625,13901,10507,-3394
2017,1,21,12,14278,14534,11179,-3355
2017,1,21,13,15025,15301,12285,-3016
2017,1,21,14,15754,16070,12789,-3281
2017,1,21,15,16384,16740,13316,-3424
2017,1,21,16,16705,17052,13304,-3748
2017,1,21,17,16740,17047,13483,-3564
2017,1,21,18,16616,16903,13099,-3804
2017,1,21,19,16402,16504,12909,-3595
2017,1,21,20,16256,16324,12893,-3431
2017,1,21,21,16281,16460,13039,-3421
2017,1,21,22,16770,16914,13507,-3407
2017,1,21,23,17853,17991,14194,-3797
2017,1,22,0,18040,18158,14365,-3793
2017,1,22,1,17652,17869,14362,-3507
2017,1,22,2,17129,17447,13980,-3467
2017,1,22,3,16489,16844,13392,-3452
2017,1,22,4,15674,15980,12036,-3944
2017,1,22,5,14783,15029,10702,-4327
2017,1,22,6,13953,14247,10132,-4115
2017,1,22,7,13337,13686,9894,-3792
2017,1,22,8,12950,13318,9733,-3585
2017,1,22,9,12746,13126,9613,-3513
2017,1,22,10,12754,13115,9621,-3494
2017,1,22,11,13021,13354,9982,-3372
2017,1,22,12,13515,13835,10566,-3269
2017,1,22,13,14061,14397,11236,-3161
2017,1,22,14,14713,15178,11893,-3285
2017,1,22,15,15387,15910,12249,-3661
2017,1,22,16,15837,16357,12290,-4067
2017,1,22,17,16072,16610,12572,-4038
2017,1,22,18,16154,16679,12494,-4185
2017,1,22,19,16104,16610,12571,-4039
2017,1,22,20,16077,16714,12962,-3752
2017,1,22,21,16216,16979,13200,-3779
2017,1,22,22,16854,17582,13526,-4056
2017,1,22,23,18035,18467,14488,-3979
2017,1,23,0,18285,18596,14090,-4506
2017,1,23,1,17962,18265,13835,-4430
2017,1,23,2,17457,17822,13905,-3917
2017,1,23,3,16686,17058,13173,-3885
2017,1,23,4,15655,15981,11707,-4274
2017,1,23,5,14594,14877,10703,-4174
2017,1,23,6,13775,14149,10238,-3911
2017,1,23,7,13330,13692,9815,-3877
2017,1,23,8,13092,13450,9457,-3993
2017,1,23,9,13043,13447,10059,-3388
2017,1,23,10,13327,13774,10366,-3408
2017,1,23,11,14294,14801,11284,-3517
2017,1,23,12,16078,16677,12926,-3751
2017,1,23,13,17530,18229,14346,-3883
2017,1,23,14,18088,18830,14849,-3981
2017,1,23,15,18522,19167,14929,-4238
2017,1,23,16,18781,19405,15134,-4271
2017,1,23,17,18827,19537,14865,-4672
2017,1,23,18,18805,19579,14878,-4701
2017,1,23,19,18793,19608,14925,-4683
2017,1,23,20,18737,19585,15031,-4554
2017,1,23,21,18822,19737,15227,-4510
2017,1,23,22,19364,20354,15709,-4645
2017,1,23,23,20374,21206,16820,-4386
2017,1,24,0,20415,21190,16565,-4625
2017,1,24,1,19919,20691,15973,-4718
2017,1,24,2,19173,19924,15951,-3973
2017,1,24,3,18176,18870,14983,-3887
2017,1,24,4,16885,17570,13081,-4489
2017,1,24,5,15590,16290,11967,-4323
2017,1,24,6,14662,15423,11403,-4020
2017,1,24,7,14107,14908,11013,-3895
2017,1,24,8,13803,14603,10760,-3843
2017,1,24,9,13703,14501,10703,-3798
2017,1,24,10,13931,14775,11119,-3656
2017,1,24,11,14833,15696,11895,-3801
2017,1,24,12,16560,17317,13574,-3743
2017,1,24,13,17930,18687,14590,-4097
2017,1,24,14,18415,19293,14866,-4427
2017,1,24,15,18778,19681,14790,-4891
2017,1,24,16,18967,19968,15103,-4865
2017,1,24,17,18940,20094,15220,-4874
2017,1,24,18,18897,20093,15236,-4857
2017,1,24,19,18870,20114,15206,-4908
2017,1,24,20,18819,20039,15189,-4850
2017,1,24,21,18896,20093,15147,-4946
2017,1,24,22,19406,20502,15391,-5111
2017,1,24,23,20331,21316,16035,-5281
2017,1,25,0,20385,21246,15984,-5262
2017,1,25,1,19910,20735,15588,-5147
2017,1,25,2,19255,20011,15212,-4799
2017,1,25,3,18327,18984,14548,-4436
2017,1,25,4,17095,17668,13191,-4477
2017,1,25,5,15860,16417,12110,-4307
2017,1,25,6,15003,15495,11260,-4235
2017,1,25,7,14429,14971,10647,-4324
2017,1,25,8,14106,14680,10663,-4017
2017,1,25,9,13999,14593,10521,-4072
2017,1,25,10,14230,14840,10777,-4063
2017,1,25,11,15153,15793,11714,-4079
2017,1,25,12,16996,17537,13705,-3832
2017,1,25,13,18325,18739,14684,-4055
2017,1,25,14,18673,19073,14895,-4178
2017,1,25,15,18841,19274,15145,-4129
2017,1,25,16,18886,19232,15305,-3927
2017,1,25,17,18801,19117,14993,-4124
2017,1,25,18,18642,18944,14860,-4084
2017,1,25,19,18565,18895,14676,-4219
2017,1,25,20,18477,18779,14546,-4233
2017,1,25,21,18545,18842,14704,-4138
2017,1,25,22,19084,19283,15001,-4282
2017,1,25,23,20171,20345,15878,-4467
2017,1,26,0,20296,20441,15764,-4677
2017,1,26,1,19846,20046,15437,-4609
2017,1,26,2,19191,19396,14969,-4427
2017,1,26,3,18240,18448,14356,-4092
2017,1,26,4,16936,17112,12928,-4184
2017,1,26,5,15615,15764,11348,-4416
2017,1,26,6,14726,14839,10864,-3975
2017,1,26,7,14129,14261,10600,-3661
2017,1,26,8,13788,13944,10565,-3379
2017,1,26,9,13664,13842,10568,-3274
2017,1,26,10,13877,14086,10669,-3417
2017,1,26,11,14766,15021,11377,-3644
2017,1,26,12,16527,16847,13453,-3394
2017,1,26,13,17842,18263,14735,-3528
2017,1,26,14,18262,18727,15000,-3727
2017,1,26,15,18557,19101,15136,-3965
2017,1,26,16,18657,19265,15222,-4043
2017,1,26,17,18657,19254,15219,-4035
2017,1,26,18,18532,19118,15110,-4008
2017,1,26,19,18455,19011,14923,-4088
2017,1,26,20,18373,18847,14791,-4056
2017,1,26,21,18461,18950,14983,-3967
2017,1,26,22,19025,19411,15154,-4257
2017,1,26,23,20067,20349,16090,-4259
2017,1,27,0,20211,20506,16561,-3945
2017,1,27,1,19783,20114,16400,-3714
2017,1,27,2,19124,19524,15823,-3701
2017,1,27,3,18185,18612,15069,-3543
2017,1,27,4,16924,17265,13048,-4217
2017,1,27,5,15655,15976,11855,-4121
2017,1,27,6,14736,15052,11583,-3469
2017,1,27,7,14210,14520,11155,-3365
2017,1,27,8,13908,14229,11057,-3172
2017,1,27,9,13812,14161,11039,-3122
2017,1,27,10,14047,14438,11376,-3062
2017,1,27,11,14949,15377,12306,-3071
2017,1,27,12,16735,17169,13772,-3397
2017,1,27,13,18059,18486,14690,-3796
2017,1,27,14,18518,18994,14903,-4091
2017,1,27,15,18813,19274,14963,-4311
2017,1,27,16,18946,19347,14988,-4359
2017,1,27,17,18908,19382,15509,-3873
2017,1,27,18,18788,19375,15660,-3715
2017,1,27,19,18719,19403,15044,-4359
2017,1,27,20,18644,19383,15059,-4324
2017,1,27,21,18699,19438,15202,-4236
2017,1,27,22,19128,19860,15625,-4235
2017,1,27,23,19908,20503,16357,-4146
2017,1,28,0,19975,20367,16454,-3913
2017,1,28,1,19504,19936,15889,-4047
2017,1,28,2,18858,19365,15434,-3931
2017,1,28,3,18083,18593,14848,-3745
2017,1,28,4,17116,17525,13568,-3957
2017,1,28,5,16081,16374,12688,-3686
2017,1,28,6,15086,15505,12265,-3240
2017,1,28,7,14472,14904,11571,-3333
2017,1,28,8,14105,14545,11229,-3316
2017,1,28,9,13929,14377,11221,-3156
2017,1,28,10,13981,14428,11192,-3236
2017,1,28,11,14350,14764,11768,-2996
2017,1,28,12,15048,15449,12253,-3196
2017,1,28,13,15756,16207,13033,-3174
2017,1,28,14,16533,17019,13649,-3370
2017,1,28,15,17160,17672,13824,-3848
2017,1,28,16,17488,17969,14133,-3836
2017,1,28,17,17507,18127,14295,-3832
2017,1,28,18,17421,18196,14248,-3948
2017,1,28,19,17253,18165,14340,-3825
2017,1,28,20,17146,18096,14154,-3942
2017,1,28,21,17184,18153,14269,-3884
2017,1,28,22,17624,18522,14249,-4273
2017,1,28,23,18525,19327,14873,-4454
2017,1,29,0,18808,19404,14834,-4570
2017,1,29,1,18500,19055,14573,-4482
2017,1,29,2,18011,18589,14280,-4309
2017,1,29,3,17394,17930,13898,-4032
2017,1,29,4,16653,17093,13292,-3801
2017,1,29,5,15840,16154,12618,-3536
2017,1,29,6,14991,15325,12030,-3295
2017,1,29,7,14383,14771,11598,-3173
2017,1,29,8,14018,14415,11178,-3237
2017,1,29,9,13829,14240,11152,-3088
2017,1,29,10,13839,14252,11147,-3105
2017,1,29,11,14102,14492,11752,-2740
2017,1,29,12,14614,14978,12099,-2879
2017,1,29,13,15102,15453,12657,-2796
2017,1,29,14,15782,16172,12994,-3178
2017,1,29,15,16382,16707,13227,-3480
2017,1,29,16,16769,17009,13468,-3541
2017,1,29,17,16923,17206,13581,-3625
2017,1,29,18,16964,17173,13369,-3804
2017,1,29,19,16893,17138,13509,-3629
2017,1,29,20,16849,17159,13653,-3506
2017,1,29,21,16968,17370,13874,-3496
2017,1,29,22,17562,17943,13959,-3984
2017,1,29,23,18691,19158,15065,-4093
2017,1,30,0,19144,19524,15368,-4156
2017,1,30,1,18946,19279,15136,-4143
2017,1,30,2,18515,18822,14851,-3971
2017,1,30,3,17774,18077,14133,-3944
2017,1,30,4,16833,17043,13300,-3743
2017,1,30,5,15855,16005,12504,-3501
2017,1,30,6,15002,15247,11432,-3815
2017,1,30,7,14525,14845,11293,-3552
2017,1,30,8,14288,14636,11194,-3442
2017,1,30,9,14250,14634,11104,-3530
2017,1,30,10,14554,14977,11195,-3782
2017,1,30,11,15558,15996,12052,-3944
2017,1,30,12,17382,17856,13882,-3974
2017,1,30,13,18798,19148,14929,-4219
2017,1,30,14,19350,19592,15199,-4393
2017,1,30,15,19699,19816,15181,-4635
2017,1,30,16,19869,19890,15882,-4008
2017,1,30,17,19813,19810,15608,-4202
2017,1,30,18,19680,19627,15243,-4384
2017,1,30,19,19571,19494,14941,-4553
2017,1,30,20,19455,19399,14957,-4442
2017,1,30,21,19520,19541,15403,-4138
2017,1,30,22,20063,20072,16091,-3981
2017,1,30,23,21126,21260,17562,-3698
2017,1,31,0,21492,21634,17590,-4044
2017,1,31,1,21165,21278,17316,-3962
2017,1,31,2,20511,20633,16941,-3692
2017,1,31,3,19497,19680,15977,-3703
2017,1,31,4,18200,18347,14100,-4247
2017,1,31,5,16910,17041,12903,-4138
2017,1,31,6,15859,16210,12045,-4165
2017,1,31,7,15322,15751,11727,-4024
2017,1,31,8,15038,15458,11425,-4033
2017,1,31,9,14951,15412,11365,-4047
2017,1,31,10,15200,15718,11710,-4008
2017,1,31,11,16138,16713,12689,-4024
2017,1,31,12,17905,18579,14785,-3794
2017,1,31,13,19206,19827,16345,-3482
2017,1,31,14,19659,20179,16261,-3918
2017,1,31,15,19930,20541,16322,-4219
2017,1,31,16,20011,20762,16553,-4209
2017,1,31,17,19904,20815,16567,-4248
2017,1,31,18,19736,20704,16541,-4163
2017,1,31,19,19623,20672,16531,-4141
2017,1,31,20,19499,20599,16381,-4218
2017,1,31,21,19535,20587,16428,-4159
2017,1,31,22,20051,20875,16736,-4139
2017,1,31,23,20958,21752,17788,-3964
2017,2,1,0,21192,21824,18089,-3735
2017,2,1,1,20781,21368,17623,-3745
2017,2,1,2,20105,20667,17142,-3525
2017,2,1,3,19067,19708,15972,-3736
2017,2,1,4,17754,18336,14283,-4053
2017,2,1,5,16461,16954,13063,-3891
2017,2,1,6,15568,16056,12720,-3336
2017,2,1,7,15015,15505,11983,-3522
2017,2,1,8,14688,15199,11689,-3510
2017,2,1,9,14588,15149,11630,-3519
2017,2,1,10,14796,15399,11905,-3494
2017,2,1,11,15672,16243,13121,-3122
2017,2,1,12,17418,17967,15187,-2780
2017,2,1,13,18613,19087,16236,-2851
2017,2,1,14,18979,19469,16280,-3189
2017,2,1,15,19168,19641,16691,-2950
2017,2,1,16,19242,19598,16264,-3334
2017,2,1,17,19152,19429,15496,-3933
2017,2,1,18,19009,19279,15237,-4042
2017,2,1,19,18937,19279,15522,-3757
2017,2,1,20,18841,19238,15809,-3429
2017,2,1,21,18850,19375,15939,-3436
2017,2,1,22,19156,19715,15893,-3822
2017,2,1,23,20080,20621,16839,-3782
2017,2,2,0,20414,20858,16971,-3887
2017,2,2,1,19986,20458,16695,-3763
2017,2,2,2,19421,19852,16099,-3753
2017,2,2,3,18684,18917,15484,-3433
2017,2,2,4,17512,17616,13876,-3740
2017,2,2,5,16317,16340,12095,-4245
2017,2,2,6,15413,15455,11385,-4070
2017,2,2,7,14880,14946,11374,-3572
2017,2,2,8,14584,14688,11160,-3528
2017,2,2,9,14510,14645,11216,-3429
2017,2,2,10,14754,14938,11626,-3312
2017,2,2,11,15668,15930,12511,-3419
2017,2,2,12,17480,17738,14332,-3406
2017,2,2,13,18700,19020,15531,-3489
2017,2,2,14,19091,19419,15290,-4129
2017,2,2,15,19315,19613,15297,-4316
2017,2,2,16,19406,19507,14833,-4674
2017,2,2,17,19340,19376,14532,-4844
2017,2,2,18,19204,19346,14564,-4782
2017,2,2,19,19133,19369,14808,-4561
2017,2,2,20,19045,19282,14774,-4508
2017,2,2,21,19080,19392,14919,-4473
2017,2,2,22,19437,19889,15623,-4266
2017,2,2,23,20426,20857,16677,-4180
2017,2,3,0,20875,21243,17178,-4065
2017,2,3,1,20500,20924,16840,-4084
2017,2,3,2,19953,20334,16126,-4208
2017,2,3,3,19206,19387,15230,-4157
2017,2,3,4,18024,18042,13749,-4293
2017,2,3,5,16835,16826,12455,-4371
2017,2,3,6,15799,16020,11585,-4435
2017,2,3,7,15318,15501,11576,-3925
2017,2,3,8,15051,15254,11356,-3898
2017,2,3,9,14993,15204,11741,-3463
2017,2,3,10,15249,15501,11957,-3544
2017,2,3,11,16152,16469,12797,-3672
2017,2,3,12,17936,18355,14962,-3393
2017,2,3,13,19128,19603,16652,-2951
2017,2,3,14,19558,19984,16691,-3293
2017,2,3,15,19805,20220,16457,-3763
2017,2,3,16,19899,20269,15931,-4338
2017,2,3,17,19812,20141,16067,-4074
2017,2,3,18,19634,19897,15949,-3948
2017,2,3,19,19500,19754,16027,-3727
2017,2,3,20,19366,19684,16284,-3400
2017,2,3,21,19327,19802,16489,-3313
2017,2,3,22,19560,20244,16889,-3355
2017,2,3,23,20360,21050,17382,-3668
2017,2,4,0,20741,21297,17670,-3627
2017,2,4,1,20295,20875,17523,-3352
2017,2,4,2,19725,20374,17360,-3014
2017,2,4,3,19096,19656,16750,-2906
2017,2,4,4,18156,18608,15098,-3510
2017,2,4,5,17154,17487,13449,-4038
2017,2,4,6,16300,16606,12134,-4472
2017,2,4,7,15752,16080,11806,-4274
2017,2,4,8,15423,15752,12025,-3727
2017,2,4,9,15273,15632,11953,-3679
2017,2,4,10,15326,15671,12051,-3620
2017,2,4,11,15649,16028,12584,-3444
2017,2,4,12,16299,16742,13653,-3089
2017,2,4,13,16821,17438,14557,-2881
2017,2,4,14,17524,18157,14882,-3275
2017,2,4,15,18044,18600,15179,-3421
2017,2,4,16,18271,18742,15209,-3533
2017,2,4,17,18274,18649,14905,-3744
2017,2,4,18,18088,18429,14738,-3691
2017,2,4,19,17850,18122,14442,-3680
2017,2,4,20,17662,17962,14553,-3409
2017,2,4,21,17599,18044,14789,-3255
2017,2,4,22,17836,18528,15347,-3181
2017,2,4,23,18822,19607,16047,-3560
2017,2,5,0,19432,20068,16006,-4062
2017,2,5,1,19137,19817,16019,-3798
2017,2,5,2,18677,19394,15913,-3481
2017,2,5,3,18175,18748,15201,-3547
2017,2,5,4,17436,17809,14008,-3801
2017,2,5,5,16634,16829,12663,-4166
2017,2,5,6,15936,16022,12046,-3976
2017,2,5,7,15378,15431,11706,-3725
2017,2,5,8,15000,15075,11447,-3628
2017,2,5,9,14796,14889,11389,-3500
2017,2,5,10,14764,14859,11437,-3422
2017,2,5,11,14942,15065,11844,-3221
2017,2,5,12,15289,15563,12646,-2917
2017,2,5,13,15586,16067,13136,-2931
2017,2,5,14,16224,16841,13638,-3203
2017,2,5,15,16819,17519,14153,-3366
2017,2,5,16,17199,17973,14690,-3283
2017,2,5,17,17438,18187,14646,-3541
2017,2,5,18,17462,18240,14485,-3755
2017,2,5,19,17382,18226,14472,-3754
2017,2,5,20,17274,18279,14670,-3609
2017,2,5,21,17285,18396,15092,-3304
2017,2,5,22,17629,18762,15580,-3182
2017,2,5,23,18606,19550,16078,-3472
2017,2,6,0,19158,19607,16513,-3094
2017,2,6,1,18870,18998,15940,-3058
2017,2,6,2,18378,18490,15535,-2955
2017,2,6,3,17696,17910,14973,-2937
2017,2,6,4,16704,17073,13701,-3372
2017,2,6,5,15694,16098,13155,-2943
2017,2,6,6,15056,15206,12237,-2969
2017,2,6,7,14640,14707,11599,-3108
2017,2,6,8,14418,14453,11354,-3099
2017,2,6,9,14396,14403,11134,-3269
2017,2,6,10,14688,14679,11339,-3340
2017,2,6,11,15651,15703,12441,-3262
2017,2,6,12,17452,17512,14116,-3396
2017,2,6,13,18633,18740,15560,-3180
2017,2,6,14,19056,19133,15655,-3478
2017,2,6,15,19266,19224,15646,-3578
2017,2,6,16,19341,19208,15148,-4060
2017,2,6,17,19251,19133,14911,-4222
2017,2,6,18,19096,19027,14847,-4180
2017,2,6,19,18994,18950,15004,-3946
2017,2,6,20,18870,18817,15134,-3683
2017,2,6,21,18848,18841,15074,-3767
2017,2,6,22,19146,19281,15634,-3647
2017,2,6,23,20111,20348,16375,-3973
2017,2,7,0,20617,20775,16951,-3824
2017,2,7,1,20258,20421,16635,-3786
2017,2,7,2,19630,19796,16092,-3704
2017,2,7,3,18775,18752,14881,-3871
2017,2,7,4,17538,17442,13623,-3819
2017,2,7,5,16281,16203,12489,-3714
2017,2,7,6,15130,15286,11036,-4250
2017,2,7,7,14555,14758,10740,-4018
2017,2,7,8,14239,14476,10703,-3773
2017,2,7,9,14123,14422,10620,-3802
2017,2,7,10,14326,14679,10861,-3818
2017,2,7,11,15198,15610,11574,-4036
2017,2,7,12,16901,17414,13187,-4227
2017,2,7,13,18085,18799,14888,-3911
2017,2,7,14,18569,19341,15082,-4259
2017,2,7,15,18920,19680,15591,-4089
2017,2,7,16,19103,19903,15708,-4195
2017,2,7,17,19087,20116,15854,-4262
2017,2,7,18,18987,20129,16130,-3999
2017,2,7,19,18901,20114,16394,-3720
2017,2,7,20,18763,20028,16651,-3377
2017,2,7,21,18723,20040,16334,-3706
2017,2,7,22,18988,20366,16677,-3689
2017,2,7,23,19681,21075,17631,-3444
2017,2,8,0,19963,21075,17370,-3705
2017,2,8,1,19473,20602,17165,-3437
2017,2,8,2,18792,19799,16515,-3284
2017,2,8,3,17872,18750,15041,-3709
2017,2,8,4,16603,17368,13182,-4186
2017,2,8,5,15340,16054,12533,-3521
2017,2,8,6,14423,15019,12077,-2942
2017,2,8,7,13864,14429,12054,-2375
2017,2,8,8,13523,14102,11785,-2317
2017,2,8,9,13400,13975,11518,-2457
2017,2,8,10,13581,14206,11862,-2344
2017,2,8,11,14396,15126,12749,-2377
2017,2,8,12,16060,16931,14143,-2788
2017,2,8,13,17218,18222,15488,-2734
2017,2,8,14,17713,18562,15689,-2873
2017,2,8,15,18083,18718,15728,-2990
2017,2,8,16,18261,18670,15588,-3082
2017,2,8,17,18263,18444,15234,-3210
2017,2,8,18,18197,18269,14888,-3381
2017,2,8,19,18135,18218,14359,-3859
2017,2,8,20,18077,18172,14246,-3926
2017,2,8,21,18098,18274,14561,-3713
2017,2,8,22,18407,18696,15127,-3569
2017,2,8,23,19238,19623,16116,-3507
2017,2,9,0,19699,20048,16445,-3603
2017,2,9,1,19307,19719,15917,-3802
2017,2,9,2,18723,19186,15378,-3808
2017,2,9,3,17927,18360,14828,-3532
2017,2,9,4,16794,17229,13136,-4093
2017,2,9,5,15639,16108,12025,-4083
2017,2,9,6,14896,15275,11116,-4159
2017,2,9,7,14409,14781,10977,-3804
2017,2,9,8,14141,14533,10946,-3587
2017,2,9,9,14100,14519,10954,-3565
2017,2,9,10,14379,14855,11338,-3517
2017,2,9,11,15325,15792,12032,-3760
2017,2,9,12,17102,17228,13447,-3781
2017,2,9,13,18378,18334,14573,-3761
2017,2,9,14,18966,19158,14849,-4309
2017,2,9,15,19390,19815,15239,-4576
2017,2,9,16,19636,20339,15685,-4654
2017,2,9,17,19704,20510,15938,-4572
2017,2,9,18,19662,20486,15825,-4661
2017,2,9,19,19648,20478,15992,-4486
2017,2,9,20,19587,20343,16058,-4285
2017,2,9,21,19639,20281,16314,-3967
2017,2,9,22,20035,20518,16603,-3915
2017,2,9,23,20981,21484,17432,-4052
2017,2,10,0,21575,22215,18372,-3843
2017,2,10,1,21233,21858,17942,-3916
2017,2,10,2,20651,21198,17347,-3851
2017,2,10,3,19773,20223,15895,-4328
2017,2,10,4,18531,19015,14666,-4349
2017,2,10,5,17303,17816,13695,-4121
2017,2,10,6,16397,16948,12597,-4351
2017,2,10,7,15873,16447,12508,-3939
2017,2,10,8,15576,16176,12647,-3529
2017,2,10,9,15484,16112,12649,-3463
2017,2,10,10,15711,16360,12861,-3499
2017,2,10,11,16555,17249,13637,-3612
2017,2,10,12,18209,18838,15110,-3728
2017,2,10,13,19366,19940,16944,-2996
2017,2,10,14,19853,20481,16846,-3635
2017,2,10,15,20129,20850,16906,-3944
2017,2,10,16,20251,21003,16970,-4033
2017,2,10,17,20181,20950,16725,-4225
2017,2,10,18,20016,20762,16687,-4075
2017,2,10,19,19881,20570,16357,-4213
2017,2,10,20,19717,20317,16086,-4231
2017,2,10,21,19639,20181,15804,-4377
2017,2,10,22,19837,20400,16040,-4360
2017,2,10,23,20511,21210,17041,-4169
2017,2,11,0,20965,21545,17432,-4113
2017,2,11,1,20520,21094,17348,-3746
2017,2,11,2,19877,20451,16900,-3551
2017,2,11,3,19131,19639,15725,-3914
2017,2,11,4,18146,18577,14559,-4018
2017,2,11,5,17101,17455,13702,-3753
2017,2,11,6,16272,16481,12292,-4189
2017,2,11,7,15634,15869,11883,-3986
2017,2,11,8,15220,15412,11775,-3637
2017,2,11,9,14987,15180,11418,-3762
2017,2,11,10,14956,15152,11445,-3707
2017,2,11,11,15189,15451,11600,-3851
2017,2,11,12,15636,16059,12486,-3573
2017,2,11,13,16108,16685,13187,-3498
2017,2,11,14,16881,17458,13627,-3831
2017,2,11,15,17497,18049,14000,-4049
2017,2,11,16,17803,18330,14514,-3816
2017,2,11,17,17908,18299,14317,-3982
2017,2,11,18,17760,18210,14080,-4130
2017,2,11,19,17555,17971,13806,-4165
2017,2,11,20,17374,17798,13759,-4039
2017,2,11,21,17284,17676,13693,-3983
2017,2,11,22,17458,17912,13952,-3960
2017,2,11,23,18143,18754,14733,-4021
2017,2,12,0,18691,19176,14969,-4207
2017,2,12,1,18376,18878,15086,-3792
2017,2,12,2,17889,18432,14611,-3821
2017,2,12,3,17330,17835,13650,-4185
2017,2,12,4,16600,17047,12711,-4336
2017,2,12,5,15805,16184,11768,-4416
2017,2,12,6,15136,15435,11337,-4098
2017,2,12,7,14547,14842,10967,-3875
2017,2,12,8,14164,14545,10977,-3568
2017,2,12,9,13974,14379,10831,-3548
2017,2,12,10,13973,14424,10859,-3565
2017,2,12,11,14222,14699,11250,-3449
2017,2,12,12,14630,15209,11682,-3527
2017,2,12,13,14989,15784,12476,-3308
2017,2,12,14,15756,16734,13442,-3292
2017,2,12,15,16488,17632,13843,-3789
2017,2,12,16,16980,18309,14150,-4159
2017,2,12,17,17272,18731,14511,-4220
2017,2,12,18,17375,19019,14673,-4346
2017,2,12,19,17357,19088,14679,-4409
2017,2,12,20,17313,19062,14472,-4590
2017,2,12,21,17368,19074,14365,-4709
2017,2,12,22,17705,19345,14560,-4785
2017,2,12,23,18469,20065,15583,-4482
2017,2,13,0,19051,20281,15720,-4561
2017,2,13,1,18775,19872,15616,-4256
2017,2,13,2,18264,19258,15332,-3926
2017,2,13,3,17527,18356,14335,-4021
2017,2,13,4,16541,17264,12794,-4470
2017,2,13,5,15520,16240,12053,-4187
2017,2,13,6,14809,15451,11862,-3589
2017,2,13,7,14362,14964,11495,-3469
2017,2,13,8,14117,14746,11265,-3481
2017,2,13,9,14081,14742,11348,-3394
2017,2,13,10,14358,15085,11735,-3350
2017,2,13,11,15301,16086,12424,-3662
2017,2,13,12,17001,17728,14178,-3550
2017,2,13,13,18238,18929,15279,-3650
2017,2,13,14,18833,19612,15489,-4123
2017,2,13,15,19223,19943,15763,-4180
2017,2,13,16,19431,20099,15896,-4203
2017,2,13,17,19411,20091,15927,-4164
2017,2,13,18,19342,20032,15841,-4191
2017,2,13,19,19290,19931,15618,-4313
2017,2,13,20,19196,19827,15755,-4072
2017,2,13,21,19197,19843,15870,-3973
2017,2,13,22,19526,20165,16026,-4139
2017,2,13,23,20357,20988,16748,-4240
2017,2,14,0,20998,21530,17258,-4272
2017,2,14,1,20694,21200,16926,-4274
2017,2,14,2,20058,20621,16397,-4224
2017,2,14,3,19143,19676,15297,-4379
2017,2,14,4,17920,18330,13861,-4469
2017,2,14,5,16688,17008,12853,-4155
2017,2,14,6,15773,16096,11831,-4265
2017,2,14,7,15215,15557,11370,-4187
2017,2,14,8,14918,15289,11432,-3857
2017,2,14,9,14831,15208,11354,-3854
2017,2,14,10,15085,15473,11580,-3893
2017,2,14,11,16035,16461,12232,-4229
2017,2,14,12,17819,18284,14077,-4207
2017,2,14,13,18985,19363,15028,-4335
2017,2,14,14,19393,19742,14945,-4797
2017,2,14,15,19604,19909,14960,-4949
2017,2,14,16,19630,19818,14874,-4944
2017,2,14,17,19464,19647,14738,-4909
2017,2,14,18,19236,19353,14435,-4918
2017,2,14,19,19100,19014,14088,-4926
2017,2,14,20,18922,18819,14035,-4784
2017,2,14,21,18883,18850,14131,-4719
2017,2,14,22,19175,19213,14464,-4749
2017,2,14,23,19951,20133,15299,-4834
2017,2,15,0,20565,20707,16086,-4621
2017,2,15,1,20247,20343,15849,-4494
2017,2,15,2,19630,19713,15214,-4499
2017,2,15,3,18696,18786,14489,-4297
2017,2,15,4,17418,17546,12868,-4678
2017,2,15,5,16144,16326,12315,-4011
2017,2,15,6,15177,15390,11606,-3784
2017,2,15,7,14636,14859,11568,-3291
2017,2,15,8,14323,14564,11858,-2706
2017,2,15,9,14233,14484,11712,-2772
2017,2,15,10,14455,14751,11768,-2983
2017,2,15,11,15344,15743,12493,-3250
2017,2,15,12,17014,17474,14164,-3310
2017,2,15,13,18153,18570,15109,-3461
2017,2,15,14,18629,19049,14804,-4245
2017,2,15,15,18906,19306,14617,-4689
2017,2,15,16,19011,19420,14650,-4770
2017,2,15,17,18942,19381,14756,-4625
2017,2,15,18,18810,19176,14584,-4592
2017,2,15,19,18741,19025,14780,-4245
2017,2,15,20,18644,18828,14469,-4359
2017,2,15,21,18659,18969,14900,-4069
2017,2,15,22,18962,19462,15194,-4268
2017,2,15,23,19657,20364,16240,-4124
2017,2,16,0,20257,20833,16288,-4545
2017,2,16,1,19961,20551,16332,-4219
2017,2,16,2,19401,19972,15945,-4027
2017,2,16,3,18566,19015,15381,-3634
2017,2,16,4,17408,17747,13926,-3821
2017,2,16,5,16239,16502,12631,-3871
2017,2,16,6,15269,15592,11935,-3657
2017,2,16,7,14786,15111,11660,-3451
2017,2,16,8,14517,14884,11627,-3257
2017,2,16,9,14460,14841,11337,-3504
2017,2,16,10,14712,15124,11637,-3487
2017,2,16,11,15621,16136,12729,-3407
2017,2,16,12,17318,18014,14498,-3516
2017,2,16,13,18469,19153,15797,-3356
2017,2,16,14,18952,19548,16187,-3361
2017,2,16,15,19234,19745,16230,-3515
2017,2,16,16,19352,19790,16198,-3592
2017,2,16,17,19330,19699,15941,-3758
2017,2,16,18,19219,19588,15801,-3787
2017,2,16,19,19161,19476,15734,-3742
2017,2,16,20,19061,19444,15741,-3703
2017,2,16,21,19083,19571,15814,-3757
2017,2,16,22,19419,19970,15950,-4020
2017,2,16,23,20117,20805,16115,-4690
2017,2,17,0,20756,21436,16519,-4917
2017,2,17,1,20475,21168,16593,-4575
2017,2,17,2,19917,20574,16354,-4220
2017,2,17,3,19044,19652,15758,-3894
2017,2,17,4,17858,18381,14239,-4142
2017,2,17,5,16668,17099,12972,-4127
2017,2,17,6,15775,16187,12570,-3617
2017,2,17,7,15247,15643,12235,-3408
2017,2,17,8,14951,15354,12090,-3264
2017,2,17,9,14870,15295,12036,-3259
2017,2,17,10,15105,15549,12128,-3421
2017,2,17,11,15999,16506,13057,-3449
2017,2,17,12,17675,18304,14795,-3509
2017,2,17,13,18779,19365,15955,-3410
2017,2,17,14,19209,19711,15768,-3943
2017,2,17,15,19384,19783,15738,-4045
2017,2,17,16,19371,19660,15370,-4290
2017,2,17,17,19198,19414,14902,-4512
2017,2,17,18,18939,19096,14451,-4645
2017,2,17,19,18762,18863,14228,-4635
2017,2,17,20,18572,18642,14429,-4213
2017,2,17,21,18503,18633,14433,-4200
2017,2,17,22,18701,18963,14839,-4124
2017,2,17,23,19338,19654,15281,-4373
2017,2,18,0,20000,20212,15768,-4444
2017,2,18,1,19690,19892,15564,-4328
2017,2,18,2,19123,19386,15497,-3889
2017,2,18,3,18384,18625,14479,-4146
2017,2,18,4,17441,17560,12728,-4832
2017,2,18,5,16432,16459,11736,-4723
2017,2,18,6,15729,15635,11575,-4060
2017,2,18,7,15132,15113,11333,-3780
2017,2,18,8,14748,14759,10968,-3791
2017,2,18,9,14537,14581,10739,-3842
2017,2,18,10,14522,14615,10894,-3721
2017,2,18,11,14769,14933,11346,-3587
2017,2,18,12,15227,15589,12327,-3262
2017,2,18,13,15652,16131,13111,-3020
2017,2,18,14,16342,16671,13514,-3157
2017,2,18,15,16821,16976,13521,-3455
2017,2,18,16,17027,17034,13174,-3860
2017,2,18,17,17058,16805,12978,-3827
2017,2,18,18,16856,16480,12680,-3800
2017,2,18,19,16594,16156,12738,-3418
2017,2,18,20,16388,15979,12452,-3527
2017,2,18,21,16285,16006,12550,-3456
2017,2,18,22,16500,16283,13046,-3237
2017,2,18,23,17160,17050,13549,-3501
2017,2,19,0,17911,17906,14305,-3601
2017,2,19,1,17717,17760,14157,-3603
2017,2,19,2,17275,17340,14032,-3308
2017,2,19,3,16664,16715,13303,-3412
2017,2,19,4,15920,15894,12350,-3544
2017,2,19,5,15120,15027,11686,-3341
2017,2,19,6,14353,14259,11298,-2961
2017,2,19,7,13801,13644,10417,-3227
2017,2,19,8,13444,13338,10323,-3015
2017,2,19,9,13256,13171,10345,-2826
2017,2,19,10,13231,13163,10285,-2878
2017,2,19,11,13389,13408,10348,-3060
2017,2,19,12,13613,13890,11154,-2736
2017,2,19,13,13814,14368,12088,-2280
2017,2,19,14,14521,15017,12493,-2524
2017,2,19,15,15127,15400,12657,-2743
2017,2,19,16,15501,15513,12903,-2610
2017,2,19,17,15745,15641,12766,-2875
2017,2,19,18,15745,15490,12608,-2882
2017,2,19,19,15632,15276,12543,-2733
2017,2,19,20,15539,15165,12517,-2648
2017,2,19,21,15561,15293,12803,-2490
2017,2,19,22,15901,15722,12962,-2760
2017,2,19,23,16754,16567,13697,-2870
2017,2,20,0,17656,17462,13920,-3542
2017,2,20,1,17565,17267,13944,-3323
2017,2,20,2,17175,16908,13452,-3456
2017,2,20,3,16507,16340,13072,-3268
2017,2,20,4,15629,15568,12093,-3475
2017,2,20,5,14720,14705,11450,-3255
2017,2,20,6,13867,14050,11107,-2943
2017,2,20,7,13445,13640,10795,-2845
2017,2,20,8,13218,13379,10806,-2573
2017,2,20,9,13122,13336,10840,-2496
2017,2,20,10,13299,13613,10871,-2742
2017,2,20,11,13943,14351,11549,-2802
2017,2,20,12,15005,15342,12579,-2763
2017,2,20,13,15791,16108,13002,-3106
2017,2,20,14,16528,16671,13397,-3274
2017,2,20,15,17015,17025,13463,-3562
2017,2,20,16,17259,17205,13658,-3547
2017,2,20,17,17375,17190,13485,-3705
2017,2,20,18,17242,17033,13339,-3694
2017,2,20,19,17077,16896,13275,-3621
2017,2,20,20,16971,16808,13356,-3452
2017,2,20,21,16933,16852,13271,-3581
2017,2,20,22,17181,17258,13706,-3552
2017,2,20,23,17899,18156,14358,-3798
2017,2,21,0,18757,19082,14719,-4363
2017,2,21,1,18572,18907,14655,-4252
2017,2,21,2,18053,18425,14530,-3895
2017,2,21,3,17308,17708,13936,-3772
2017,2,21,4,16327,16657,12222,-4435
2017,2,21,5,15326,15593,11064,-4529
2017,2,21,6,14478,14776,10314,-4462
2017,2,21,7,14032,14336,10228,-4108
2017,2,21,8,13788,14170,10462,-3708
2017,2,21,9,13740,14124,10588,-3536
2017,2,21,10,13991,14405,10964,-3441
2017,2,21,11,14902,15333,12005,-3328
2017,2,21,12,16542,16879,13597,-3282
2017,2,21,13,17616,17948,14438,-3510
2017,2,21,14,18011,18507,14650,-3857
2017,2,21,15,18153,18671,14685,-3986
2017,2,21,16,18153,18627,14817,-3810
2017,2,21,17,18081,18480,14643,-3837
2017,2,21,18,17899,18272,14562,-3710
2017,2,21,19,17804,18187,14540,-3647
2017,2,21,20,17672,18219,14677,-3542
2017,2,21,21,17649,18248,14728,-3520
2017,2,21,22,17966,18654,15211,-3443
2017,2,21,23,18593,19373,15699,-3674
2017,2,22,0,19260,19827,16183,-3644
2017,2,22,1,19011,19453,15879,-3574
2017,2,22,2,18425,18820,15675,-3145
2017,2,22,3,17490,17882,14866,-3016
2017,2,22,4,16275,16680,13056,-3624
2017,2,22,5,15066,15469,12507,-2962
2017,2,22,6,14110,14570,11414,-3156
2017,2,22,7,13609,14004,10964,-3040
2017,2,22,8,13316,13670,10757,-2913
2017,2,22,9,13231,13557,10667,-2890
2017,2,22,10,13446,13804,10930,-2874
2017,2,22,11,14319,14619,11419,-3200
2017,2,22,12,15874,16087,12912,-3175
2017,2,22,13,16952,17177,13999,-3178
2017,2,22,14,17416,17867,14201,-3666
2017,2,22,15,17682,18073,14364,-3709
2017,2,22,16,17735,18130,14521,-3609
2017,2,22,17,17670,18109,14496,-3613
2017,2,22,18,17493,17854,14121,-3733
2017,2,22,19,17403,17733,13900,-3833
2017,2,22,20,17269,17592,13882,-3710
2017,2,22,21,17248,17559,13792,-3767
2017,2,22,22,17530,17804,14237,-3567
2017,2,22,23,18134,18466,14614,-3852
2017,2,23,0,18820,19037,15008,-4029
2017,2,23,1,18568,18730,14954,-3776
2017,2,23,2,17996,18044,14789,-3255
2017,2,23,3,17070,17363,14090,-3273
2017,2,23,4,15885,16224,12359,-3865
2017,2,23,5,14678,15072,11353,-3719
2017,2,23,6,13819,14175,10687,-3488
2017,2,23,7,13293,13627,10206,-3421
2017,2,23,8,12985,13326,10351,-2975
2017,2,23,9,12888,13259,10259,-3000
2017,2,23,10,13100,13502,10463,-3039
2017,2,23,11,13967,14335,10933,-3402
2017,2,23,12,15606,15843,12536,-3307
2017,2,23,13,16677,16944,13833,-3111
2017,2,23,14,17120,17561,14314,-3247
2017,2,23,15,17401,17874,14431,-3443
2017,2,23,16,17482,17935,14315,-3620
2017,2,23,17,17474,17839,14153,-3686
2017,2,23,18,17366,17647,13906,-3741
2017,2,23,19,17330,17543,13961,-3582
2017,2,23,20,17233,17430,14015,-3415
2017,2,23,21,17232,17314,14112,-3202
2017,2,23,22,17503,17290,14266,-3024
2017,2,23,23,18082,17767,14915,-2852
2017,2,24,0,18744,18526,15243,-3283
2017,2,24,1,18465,18326,14862,-3464
2017,2,24,2,17858,17778,14443,-3335
2017,2,24,3,16899,16968,13594,-3374
2017,2,24,4,15688,15812,11948,-3864
2017,2,24,5,14473,14651,11139,-3512
2017,2,24,6,13517,13811,11268,-2543
2017,2,24,7,13000,13301,11224,-2077
2017,2,24,8,12710,13023,11180,-1843
2017,2,24,9,12616,12916,11148,-1768
2017,2,24,10,12827,13142,11352,-1790
2017,2,24,11,13681,13967,11943,-2024
2017,2,24,12,15250,15385,12998,-2387
2017,2,24,13,16357,16433,13932,-2501
2017,2,24,14,16911,17116,14078,-3038
2017,2,24,15,17289,17499,14365,-3134
2017,2,24,16,17431,17588,14249,-3339
2017,2,24,17,17365,17572,14393,-3179
2017,2,24,18,17231,17389,14364,-3025
2017,2,24,19,17174,17342,14465,-2877
2017,2,24,20,17057,17301,14406,-2895
2017,2,24,21,17005,17261,14426,-2835
2017,2,24,22,17135,17360,14591,-2769
2017,2,24,23,17472,17736,14942,-2794
2017,2,25,0,18042,18258,15591,-2667
2017,2,25,1,17711,17849,15259,-2590
2017,2,25,2,17111,17287,14780,-2507
2017,2,25,3,16316,16563,14023,-2540
2017,2,25,4,15393,15588,13004,-2584
2017,2,25,5,14400,14534,11677,-2857
2017,2,25,6,13306,13602,11165,-2437
2017,2,25,7,12737,13049,10484,-2565
2017,2,25,8,12400,12704,10657,-2047
2017,2,25,9,12217,12563,10801,-1762
2017,2,25,10,12232,12586,10942,-1644
2017,2,25,11,12482,12865,11164,-1701
2017,2,25,12,12850,13457,12066,-1391
2017,2,25,13,13299,14037,12359,-1678
2017,2,25,14,14032,14900,12749,-2151
2017,2,25,15,14656,15542,12989,-2553
2017,2,25,16,15010,15959,13317,-2642
2017,2,25,17,15176,16075,13164,-2911
2017,2,25,18,15186,16101,13328,-2773
2017,2,25,19,15132,16010,13586,-2424
2017,2,25,20,15110,15999,13768,-2231
2017,2,25,21,15170,16018,13875,-2143
2017,2,25,22,15438,16407,14027,-2380
2017,2,25,23,15962,17145,14471,-2674
2017,2,26,0,16652,17553,14562,-2991
2017,2,26,1,16481,17341,14692,-2649
2017,2,26,2,16014,16916,14372,-2544
2017,2,26,3,15331,16303,14098,-2205
2017,2,26,4,14670,15541,13556,-1985
2017,2,26,5,14000,14694,12455,-2239
2017,2,26,6,13552,13985,11136,-2849
2017,2,26,7,13096,13507,10599,-2908
2017,2,26,8,12801,13209,10420,-2789
2017,2,26,9,12687,13096,10317,-2779
2017,2,26,10,12754,13167,10445,-2722
2017,2,26,11,13025,13472,10810,-2662
2017,2,26,12,13387,13972,11444,-2528
2017,2,26,13,13724,14542,12040,-2502
2017,2,26,14,14397,15427,12489,-2938
2017,2,26,15,15032,16022,12926,-3096
2017,2,26,16,15344,16407,13271,-3136
2017,2,26,17,15493,16577,13343,-3234
2017,2,26,18,15540,16615,13120,-3495
2017,2,26,19,15495,16549,13132,-3417
2017,2,26,20,15451,16501,13295,-3206
2017,2,26,21,15520,16610,13562,-3048
2017,2,26,22,15881,17009,14069,-2940
2017,2,26,23,16671,17808,14701,-3107
2017,2,27,0,17583,18851,15389,-3462
2017,2,27,1,17601,18826,15289,-3537
2017,2,27,2,17219,18374,14829,-3545
2017,2,27,3,16389,17561,14646,-2915
2017,2,27,4,15521,16608,13824,-2784
2017,2,27,5,14645,15622,13046,-2576
2017,2,27,6,14060,14873,12328,-2545
2017,2,27,7,13637,14361,12067,-2294
2017,2,27,8,13407,14123,11820,-2303
2017,2,27,9,13352,14078,11706,-2372
2017,2,27,10,13618,14377,11815,-2562
2017,2,27,11,14473,15411,12823,-2588
2017,2,27,12,16016,17188,14894,-2294
2017,2,27,13,17082,18208,16120,-2088
2017,2,27,14,17503,18543,15891,-2652
2017,2,27,15,17646,18565,15690,-2875
2017,2,27,16,17656,18453,15771,-2682
2017,2,27,17,17568,18286,15536,-2750
2017,2,27,18,17405,18058,15386,-2672
2017,2,27,19,17327,17993,15458,-2535
2017,2,27,20,17252,17922,15462,-2460
2017,2,27,21,17285,18012,15501,-2511
2017,2,27,22,17614,18274,15541,-2733
2017,2,27,23,18307,18895,15963,-2932
2017,2,28,0,19099,19732,16470,-3262
2017,2,28,1,18928,19478,16391,-3087
2017,2,28,2,18304,18838,15852,-2986
2017,2,28,3,17198,17875,14910,-2965
2017,2,28,4,16010,16627,13936,-2691
2017,2,28,5,14847,15342,12717,-2625
2017,2,28,6,14065,14453,11710,-2743
2017,2,28,7,13576,13952,11783,-2169
2017,2,28,8,13311,13647,11452,-2195
2017,2,28,9,13237,13556,11060,-2496
2017,2,28,10,13489,13791,11627,-2164
2017,2,28,11,14349,14812,12514,-2298
2017,2,28,12,15870,16569,14135,-2434
2017,2,28,13,16960,17645,14747,-2898
2017,2,28,14,17402,18009,14734,-3275
2017,2,28,15,17662,18003,14578,-3425
2017,2,28,16,17685,17920,14386,-3534
2017,2,28,17,17607,17774,14217,-3557
2017,2,28,18,17465,17582,14286,-3296
2017,2,28,19,17413,17521,14529,-2992
2017,2,28,20,17342,17595,14821,-2774
2017,2,28,21,17387,17767,14719,-3048
2017,2,28,22,17678,18194,15031,-3163
2017,2,28,23,18151,18873,15736,-3137
2017,3,1,0,18818,19279,16214,-3065
2017,3,1,1,18584,18962,15924,-3038
2017,3,1,2,17963,18307,15399,-2908
2017,3,1,3,16852,17309,14568,-2741
2017,3,1,4,15660,16079,13405,-2674
2017,3,1,5,14503,14753,12219,-2534
2017,3,1,6,13626,13833,11710,-2123
2017,3,1,7,13105,13282,11268,-2014
2017,3,1,8,12824,12920,11333,-1587
2017,3,1,9,12722,12817,11090,-1727
2017,3,1,10,12946,13039,11334,-1705
2017,3,1,11,13888,13986,11721,-2265
2017,3,1,12,15534,15729,13054,-2675
2017,3,1,13,16665,16983,14050,-2933
2017,3,1,14,17148,17598,14547,-3051
2017,3,1,15,17449,17900,14886,-3014
2017,3,1,16,17610,18077,15002,-3075
2017,3,1,17,17629,18114,15000,-3114
2017,3,1,18,17562,17964,14894,-3070
2017,3,1,19,17555,17894,15069,-2825
2017,3,1,20,17476,17794,15234,-2560
2017,3,1,21,17513,17836,15387,-2449
2017,3,1,22,17711,18077,15207,-2870
2017,3,1,23,17948,18580,15546,-3034
2017,3,2,0,18517,19143,15940,-3203
2017,3,2,1,18289,18765,15688,-3077
2017,3,2,2,17676,18106,15382,-2724
2017,3,2,3,16822,17189,14677,-2512
2017,3,2,4,15635,15938,13723,-2215
2017,3,2,5,14465,14666,12548,-2118
2017,3,2,6,13632,13779,11650,-2129
2017,3,2,7,13109,13315,11750,-1565
2017,3,2,8,12829,13091,11452,-1639
2017,3,2,9,12785,13061,11372,-1689
2017,3,2,10,13064,13350,11603,-1747
2017,3,2,11,14056,14380,12246,-2134
2017,3,2,12,15828,16218,13894,-2324
2017,3,2,13,17053,17429,15279,-2150
2017,3,2,14,17534,17968,15678,-2290
2017,3,2,15,17713,18184,16052,-2132
2017,3,2,16,17753,18317,16271,-2046
2017,3,2,17,17693,18262,16323,-1939
2017,3,2,18,17573,18140,15786,-2354
2017,3,2,19,17537,18083,15221,-2862
2017,3,2,20,17469,18020,15259,-2761
2017,3,2,21,17517,18145,15713,-2432
2017,3,2,22,17827,18637,16035,-2602
2017,3,2,23,18391,19340,16732,-2608
2017,3,3,0,19226,20226,17619,-2607
2017,3,3,1,19199,20132,17610,-2522
2017,3,3,2,18721,19588,16378,-3210
2017,3,3,3,17911,18702,15509,-3193
2017,3,3,4,16757,17415,14709,-2706
2017,3,3,5,15602,16180,13723,-2457
2017,3,3,6,14715,15338,12384,-2954
2017,3,3,7,14230,14866,12175,-2691
2017,3,3,8,13974,14643,11932,-2711
2017,3,3,9,13912,14630,11912,-2718
2017,3,3,10,14188,14902,12098,-2804
2017,3,3,11,15155,15889,12650,-3239
2017,3,3,12,16854,17567,14124,-3443
2017,3,3,13,18008,18580,15313,-3267
2017,3,3,14,18465,18887,15171,-3716
2017,3,3,15,18724,18997,15102,-3895
2017,3,3,16,18747,19067,14485,-4582
2017,3,3,17,18645,19005,14984,-4021
2017,3,3,18,18463,18896,15086,-3810
2017,3,3,19,18349,18880,14498,-4382
2017,3,3,20,18233,18828,14555,-4273
2017,3,3,21,18223,19017,14893,-4124
2017,3,3,22,18460,19344,15544,-3800
2017,3,3,23,18830,19852,16220,-3632
2017,3,4,0,19593,20680,17326,-3354
2017,3,4,1,19457,20490,17110,-3380
2017,3,4,2,18928,20039,16658,-3381
2017,3,4,3,18202,19365,15991,-3374
2017,3,4,4,17253,18319,14234,-4085
2017,3,4,5,16267,17245,13238,-4007
2017,3,4,6,15814,16410,12642,-3768
2017,3,4,7,15325,15902,12493,-3409
2017,3,4,8,15040,15608,12418,-3190
2017,3,4,9,14932,15470,12402,-3068
2017,3,4,10,15022,15534,12672,-2862
2017,3,4,11,15405,15877,13025,-2852
2017,3,4,12,15970,16466,13425,-3041
2017,3,4,13,16491,17153,14347,-2806
2017,3,4,14,17260,17963,15222,-2741
2017,3,4,15,17879,18474,15405,-3069
2017,3,4,16,18130,18734,15163,-3571
2017,3,4,17,18115,18805,14958,-3847
2017,3,4,18,17953,18616,14679,-3937
2017,3,4,19,17718,18424,14565,-3859
2017,3,4,20,17498,18270,14443,-3827
2017,3,4,21,17454,18223,14618,-3605
2017,3,4,22,17671,18560,15200,-3360
2017,3,4,23,18275,19297,16077,-3220
2017,3,5,0,19304,20366,16808,-3558
2017,3,5,1,19362,20409,17080,-3329
2017,3,5,2,18998,20099,16629,-3470
2017,3,5,3,18393,19558,16026,-3532
2017,3,5,4,17654,18748,14940,-3808
2017,3,5,5,16889,17874,14602,-3272
2017,3,5,6,16546,17172,13755,-3417
2017,3,5,7,16080,16646,13406,-3240
2017,3,5,8,15790,16342,13174,-3168
2017,3,5,9,15661,16187,13005,-3182
2017,3,5,10,15706,16224,13085,-3139
2017,3,5,11,15969,16481,13319,-3162
2017,3,5,12,16324,16889,13722,-3167
2017,3,5,13,16598,17332,14272,-3060
2017,3,5,14,17119,17841,14251,-3590
2017,3,5,15,17402,18194,14478,-3716
2017,3,5,16,17458,18317,14396,-3921
2017,3,5,17,17343,18249,14198,-4051
2017,3,5,18,17137,18154,14346,-3808
2017,3,5,19,16911,17875,13917,-3958
2017,3,5,20,16719,17671,13781,-3890
2017,3,5,21,16742,17687,13680,-4007
2017,3,5,22,17105,18055,14155,-3900
2017,3,5,23,17891,18884,15064,-3820
2017,3,6,0,19073,20008,16325,-3683
2017,3,6,1,19243,20097,16346,-3751
2017,3,6,2,18918,19663,16234,-3429
2017,3,6,3,18168,18909,15484,-3425
2017,3,6,4,17217,17803,13974,-3829
2017,3,6,5,16284,16702,12928,-3774
2017,3,6,6,15830,15944,12343,-3601
2017,3,6,7,15445,15528,12295,-3233
2017,3,6,8,15242,15303,12354,-2949
2017,3,6,9,15209,15256,12307,-2949
2017,3,6,10,15470,15570,12467,-3103
2017,3,6,11,16358,16595,13307,-3288
2017,3,6,12,17818,18239,14667,-3572
2017,3,6,13,18864,19291,15877,-3414
2017,3,6,14,19232,19525,15873,-3652
2017,3,6,15,19204,19561,15535,-4026
2017,3,6,16,19137,19431,15047,-4384
2017,3,6,17,18923,19211,14697,-4514
2017,3,6,18,18664,18928,14553,-4375
2017,3,6,19,18523,18751,14458,-4293
2017,3,6,20,18364,18618,14644,-3974
2017,3,6,21,18382,18736,14856,-3880
2017,3,6,22,18680,19152,15122,-4030
2017,3,6,23,19139,19810,16089,-3721
2017,3,7,0,19945,20461,16821,-3640
2017,3,7,1,19866,20237,16764,-3473
2017,3,7,2,19267,19588,15952,-3636
2017,3,7,3,18295,18532,15040,-3492
2017,3,7,4,17049,17134,13895,-3239
2017,3,7,5,15808,15808,13214,-2594
2017,3,7,6,14823,14846,12273,-2573
2017,3,7,7,14299,14321,12044,-2277
2017,3,7,8,14026,14019,11827,-2192
2017,3,7,9,13950,13920,11521,-2399
2017,3,7,10,14189,14186,11989,-2197
2017,3,7,11,15098,15134,12937,-2197
2017,3,7,12,16636,16832,14223,-2609
2017,3,7,13,17743,17994,15099,-2895
2017,3,7,14,18184,18405,15283,-3122
2017,3,7,15,18394,18751,15483,-3268
2017,3,7,16,18461,18962,15594,-3368
2017,3,7,17,18389,18963,15524,-3439
2017,3,7,18,18245,18898,15506,-3392
2017,3,7,19,18160,18830,15500,-3330
2017,3,7,20,18012,18660,15310,-3350
2017,3,7,21,18024,18708,15355,-3353
2017,3,7,22,18263,18957,15702,-3255
2017,3,7,23,18510,19418,16750,-2668
2017,3,8,0,19210,19871,16997,-2874
2017,3,8,1,19076,19549,16991,-2558
2017,3,8,2,18475,18872,16415,-2457
2017,3,8,3,17453,17840,15484,-2356
2017,3,8,4,16211,16489,14844,-1645
2017,3,8,5,14986,15213,13465,-1748
2017,3,8,6,13798,14280,12247,-2033
2017,3,8,7,13292,13733,11725,-2008
2017,3,8,8,13020,13452,11620,-1832
2017,3,8,9,12942,13353,11553,-1800
2017,3,8,10,13179,13614,11517,-2097
2017,3,8,11,14086,14586,12080,-2506
2017,3,8,12,15661,16394,13582,-2812
2017,3,8,13,16803,17576,14221,-3355
2017,3,8,14,17232,18005,14165,-3840
2017,3,8,15,17417,18027,14436,-3591
2017,3,8,16,17415,17949,14242,-3707
2017,3,8,17,17313,17720,14248,-3472
2017,3,8,18,17142,17536,14316,-3220
2017,3,8,19,17086,17403,14351,-3052
2017,3,8,20,17009,17105,14255,-2850
2017,3,8,21,17059,17066,14384,-2682
2017,3,8,22,17350,17367,14251,-3116
2017,3,8,23,17768,17873,14700,-3173
2017,3,9,0,18554,18644,14834,-3810
2017,3,9,1,18497,18524,14814,-3710
2017,3,9,2,17993,18008,14571,-3437
2017,3,9,3,17062,17212,14566,-2646
2017,3,9,4,15907,16036,13909,-2127
2017,3,9,5,14752,14839,13013,-1826
2017,3,9,6,13897,14008,12474,-1534
2017,3,9,7,13422,13535,12533,-1002
2017,3,9,8,13175,13306,12249,-1057
2017,3,9,9,13126,13269,12437,-832
2017,3,9,10,13398,13531,12389,-1142
2017,3,9,11,14323,14469,12984,-1485
2017,3,9,12,15938,16043,14224,-1819
2017,3,9,13,17041,17068,14646,-2422
2017,3,9,14,17420,17481,14650,-2831
2017,3,9,15,17544,17653,14738,-2915
2017,3,9,16,17521,17729,14712,-3017
2017,3,9,17,17421,17632,14618,-3014
2017,3,9,18,17253,17469,14511,-2958
2017,3,9,19,17191,17459,14575,-2884
2017,3,9,20,17122,17435,14630,-2805
2017,3,9,21,17186,17538,14732,-2806
2017,3,9,22,17502,17912,14830,-3082
2017,3,9,23,17925,18453,15188,-3265
2017,3,10,0,18735,19219,15631,-3588
2017,3,10,1,18706,19118,15756,-3362
2017,3,10,2,18230,18575,15050,-3525
2017,3,10,3,17302,17696,14233,-3463
2017,3,10,4,16163,16472,13061,-3411
2017,3,10,5,15045,15283,12649,-2634
2017,3,10,6,14139,14494,11521,-2973
2017,3,10,7,13677,13999,11064,-2935
2017,3,10,8,13430,13705,10957,-2748
2017,3,10,9,13384,13671,10766,-2905
2017,3,10,10,13667,13945,10898,-3047
2017,3,10,11,14586,14940,12197,-2743
2017,3,10,12,16133,16657,13625,-3032
2017,3,10,13,17349,18047,14606,-3441
2017,3,10,14,17934,18904,15204,-3700
2017,3,10,15,18340,19432,15469,-3963
2017,3,10,16,18423,19761,15838,-3923
2017,3,10,17,18357,19847,15788,-4059
2017,3,10,18,18205,19758,15812,-3946
2017,3,10,19,18103,19625,16089,-3536
2017,3,10,20,17984,19357,16075,-3282
2017,3,10,21,17971,19215,15735,-3480
2017,3,10,22,18230,19431,15911,-3520
2017,3,10,23,18607,19958,17087,-2871
2017,3,11,0,19472,20723,17454,-3269
2017,3,11,1,19427,20656,17589,-3067
2017,3,11,2,18897,20195,17484,-2711
2017,3,11,3,18063,19506,16457,-3049
2017,3,11,4,17121,18573,15066,-3507
2017,3,11,5,16174,17496,14198,-3298
2017,3,11,6,15782,16680,13717,-2963
2017,3,11,7,15316,16206,13612,-2594
2017,3,11,8,15043,15926,13292,-2634
2017,3,11,9,14944,15836,13336,-2500
2017,3,11,10,15054,15910,13467,-2443
2017,3,11,11,15416,16284,13640,-2644
2017,3,11,12,15893,16759,14484,-2275
2017,3,11,13,16468,17499,15130,-2369
2017,3,11,14,17304,18334,15688,-2646
2017,3,11,15,17979,18944,16311,-2633
2017,3,11,16,18223,19331,16567,-2764
2017,3,11,17,18215,19389,16433,-2956
2017,3,11,18,18078,19299,16314,-2985
2017,3,11,19,17878,19164,16310,-2854
2017,3,11,20,17716,19015,16097,-2918
2017,3,11,21,17714,18991,16105,-2886
2017,3,11,22,17956,19234,16439,-2795
2017,3,11,23,18406,19713,17261,-2452
2017,3,12,0,19390,20565,17749,-2816
2017,3,12,1,19453,20505,17777,-2728
2017,3,12,2,19015,20109,18065,-2044
2017,3,12,3,18280,19538,16752,-2786
2017,3,12,4,17499,18657,15856,-2801
2017,3,12,5,16703,17759,14913,-2846
2017,3,12,6,16298,16974,13548,-3426
2017,3,12,7,15771,16454,12898,-3556
2017,3,12,8,15291,16179,13048,-3131
2017,3,12,9,15308,16089,13097,-2992
2017,3,12,10,15556,16202,13395,-2807
2017,3,12,11,16036,16605,14082,-2523
2017,3,12,12,16561,17002,14754,-2248
2017,3,12,13,17218,17590,15345,-2245
2017,3,12,14,17845,18113,15758,-2355
2017,3,12,15,18150,18469,15839,-2630
2017,3,12,16,18197,18613,16093,-2520
2017,3,12,17,18128,18638,16148,-2490
2017,3,12,18,17962,18505,15672,-2833
2017,3,12,19,17796,18343,15347,-2996
2017,3,12,20,17770,18331,15539,-2792
2017,3,12,21,17862,18437,15816,-2621
2017,3,12,22,18189,18782,16250,-2532
2017,3,12,23,18583,19347,16790,-2557
2017,3,13,0,19396,20297,17278,-3019
2017,3,13,1,19530,20334,16924,-3410
2017,3,13,2,18808,19731,15904,-3827
2017,3,13,3,17891,18714,14581,-4133
2017,3,13,4,16888,17545,13634,-3911
2017,3,13,5,16081,16718,12800,-3918
2017,3,13,6,15680,16261,12345,-3916
2017,3,13,7,15473,16022,12396,-3626
2017,3,13,8,15457,15985,12053,-3932
2017,3,13,9,15740,16267,12280,-3987
2017,3,13,10,16675,17157,13228,-3929
2017,3,13,11,18391,18960,15638,-3322
2017,3,13,12,19685,20234,17050,-3184
2017,3,13,13,20084,20611,17018,-3593
2017,3,13,14,20206,20666,16843,-3823
2017,3,13,15,20223,20618,16295,-4323
2017,3,13,16,20068,20527,15600,-4927
2017,3,13,17,19849,20227,15286,-4941
2017,3,13,18,19681,20013,15240,-4773
2017,3,13,19,19487,19817,15371,-4446
2017,3,13,20,19434,19635,15267,-4368
2017,3,13,21,19510,19731,15371,-4360
2017,3,13,22,19617,19899,15455,-4444
2017,3,13,23,19789,20273,16356,-3917
2017,3,14,0,20437,21009,16851,-4158
2017,3,14,1,20377,20808,16521,-4287
2017,3,14,2,19456,20026,15855,-4171
2017,3,14,3,18223,18880,14459,-4421
2017,3,14,4,16941,17687,13406,-4281
2017,3,14,5,16078,16671,12339,-4332
2017,3,14,6,15552,16068,11524,-4544
2017,3,14,7,15255,15715,11187,-4528
2017,3,14,8,15177,15632,11020,-4612
2017,3,14,9,15392,15771,11086,-4685
2017,3,14,10,16249,16296,12317,-3979
2017,3,14,11,17890,17232,14004,-3228
2017,3,14,12,19202,17945,15222,-2723
2017,3,14,13,19696,18590,15498,-3092
2017,3,14,14,20018,19446,15669,-3777
2017,3,14,15,20161,20104,16219,-3885
2017,3,14,16,20130,20354,15632,-4722
2017,3,14,17,20019,20408,16445,-3963
2017,3,14,18,19927,20324,16245,-4079
2017,3,14,19,19793,20097,16131,-3966
2017,3,14,20,19754,19889,15618,-4271
2017,3,14,21,19823,19926,15068,-4858
2017,3,14,22,19869,20163,15878,-4285
2017,3,14,23,19968,20387,16131,-4256
2017,3,15,0,20569,20887,16626,-4261
2017,3,15,1,20505,20533,16501,-4032
2017,3,15,2,19584,19742,15619,-4123
2017,3,15,3,18357,18674,15023,-3651
2017,3,15,4,17097,17485,14015,-3470
2017,3,15,5,16327,16569,13025,-3544
2017,3,15,6,15833,16072,12534,-3538
2017,3,15,7,15555,15847,12661,-3186
2017,3,15,8,15506,15779,12539,-3240
2017,3,15,9,15742,15999,12665,-3334
2017,3,15,10,16630,16753,13153,-3600
2017,3,15,11,18321,18214,14937,-3277
2017,3,15,12,19626,19397,16379,-3018
2017,3,15,13,20094,20024,16805,-3219
2017,3,15,14,20441,20530,17376,-3154
2017,3,15,15,20569,20846,16791,-4055
2017,3,15,16,20513,20962,16902,-4060
2017,3,15,17,20377,20940,16493,-4447
2017,3,15,18,20270,20879,16554,-4325
2017,3,15,19,20137,20672,16176,-4496
2017,3,15,20,20086,20598,16306,-4292
2017,3,15,21,20154,20717,16389,-4328
2017,3,15,22,20189,20946,16844,-4102
2017,3,15,23,20285,21117,17070,-4047
2017,3,16,0,20896,21689,17587,-4102
2017,3,16,1,20874,21483,17396,-4087
2017,3,16,2,19987,20541,16626,-3915
2017,3,16,3,18764,19183,15783,-3400
2017,3,16,4,17483,17832,14508,-3324
2017,3,16,5,16386,16831,13427,-3404
2017,3,16,6,15884,16287,13096,-3191
2017,3,16,7,15602,15962,12771,-3191
2017,3,16,8,15538,15859,12539,-3320
2017,3,16,9,15758,16095,12828,-3267
2017,3,16,10,16613,16965,13083,-3882
2017,3,16,11,18259,18787,15066,-3721
2017,3,16,12,19468,20011,16712,-3299
2017,3,16,13,19861,20279,16924,-3355
2017,3,16,14,20092,20404,16177,-4227
2017,3,16,15,20116,20405,16024,-4381
2017,3,16,16,19975,20206,15647,-4559
2017,3,16,17,19749,19915,15259,-4656
2017,3,16,18,19580,19726,15149,-4577
2017,3,16,19,19378,19488,15368,-4120
2017,3,16,20,19285,19294,15418,-3876
2017,3,16,21,19308,19313,15322,-3991
2017,3,16,22,19375,19502,15454,-4048
2017,3,16,23,19505,19775,15981,-3794
2017,3,17,0,20135,20526,16369,-4157
2017,3,17,1,20175,20465,16409,-4056
2017,3,17,2,19366,19697,15595,-4102
2017,3,17,3,18208,18490,14202,-4288
2017,3,17,4,16982,17178,13203,-3975
2017,3,17,5,15948,16172,11996,-4176
2017,3,17,6,15468,15634,11710,-3924
2017,3,17,7,15200,15370,11787,-3583
2017,3,17,8,15137,15286,11622,-3664
2017,3,17,9,15337,15521,11691,-3830
2017,3,17,10,16129,16430,12737,-3693
2017,3,17,11,17665,18230,14550,-3680
2017,3,17,12,18752,19447,15484,-3963
2017,3,17,13,19089,19709,15138,-4571
2017,3,17,14,19271,19748,14507,-5241
2017,3,17,15,19194,19613,14320,-5293
2017,3,17,16,18984,19358,14398,-4960
2017,3,17,17,18679,19036,14074,-4962
2017,3,17,18,18470,18760,13943,-4817
2017,3,17,19,18244,18419,13638,-4781
2017,3,17,20,18132,18205,13464,-4741
2017,3,17,21,18088,18144,13453,-4691
2017,3,17,22,18053,18161,13728,-4433
2017,3,17,23,18101,18333,14160,-4173
2017,3,18,0,18648,19020,14640,-4380
2017,3,18,1,18693,19023,14551,-4472
2017,3,18,2,18121,18516,13782,-4734
2017,3,18,3,17274,17625,13071,-4554
2017,3,18,4,16287,16575,12207,-4368
2017,3,18,5,15616,15718,12012,-3706
2017,3,18,6,15059,15182,11627,-3555
2017,3,18,7,14713,14877,11360,-3517
2017,3,18,8,14567,14717,11213,-3504
2017,3,18,9,14589,14789,11611,-3178
2017,3,18,10,14884,15110,12318,-2792
2017,3,18,11,15442,15802,12558,-3244
2017,3,18,12,16021,16528,13053,-3475
2017,3,18,13,16751,17340,13286,-4054
2017,3,18,14,17508,17926,13469,-4457
2017,3,18,15,17786,18257,14069,-4188
2017,3,18,16,17778,18338,14090,-4248
2017,3,18,17,17612,18253,13896,-4357
2017,3,18,18,17382,18080,13916,-4164
2017,3,18,19,17193,17936,13634,-4302
2017,3,18,20,17081,17916,13662,-4254
2017,3,18,21,17046,18015,13788,-4227
2017,3,18,22,17001,18169,14149,-4020
2017,3,18,23,17096,18334,14509,-3825
2017,3,19,0,17717,18688,14832,-3856
2017,3,19,1,17862,18578,14930,-3648
2017,3,19,2,17417,18066,14416,-3650
2017,3,19,3,16737,17227,13424,-3803
2017,3,19,4,15898,16257,12257,-4000
2017,3,19,5,14899,15443,11525,-3918
2017,3,19,6,14338,14864,11260,-3604
2017,3,19,7,13980,14460,11105,-3355
2017,3,19,8,13827,14282,10866,-3416
2017,3,19,9,13831,14254,10902,-3352
2017,3,19,10,14062,14463,11198,-3265
2017,3,19,11,14452,14931,12185,-2746
2017,3,19,12,14878,15437,12928,-2509
2017,3,19,13,15579,16143,13392,-2751
2017,3,19,14,16275,16575,13469,-3106
2017,3,19,15,16576,16823,13826,-2997
2017,3,19,16,16630,16844,13555,-3289
2017,3,19,17,16571,16680,13478,-3202
2017,3,19,18,16408,16428,13109,-3319
2017,3,19,19,16256,16216,13041,-3175
2017,3,19,20,16219,16160,13157,-3003
2017,3,19,21,16335,16325,13321,-3004
2017,3,19,22,16582,16688,13678,-3010
2017,3,19,23,16876,17109,14286,-2823
2017,3,20,0,17646,18081,14857,-3224
2017,3,20,1,17885,18309,15341,-2968
2017,3,20,2,17325,17730,14732,-2998
2017,3,20,3,16450,16774,13478,-3296
2017,3,20,4,15476,15717,12429,-3288
2017,3,20,5,14504,14849,11231,-3618
2017,3,20,6,14101,14415,11254,-3161
2017,3,20,7,13896,14275,11144,-3131
2017,3,20,8,13886,14272,11017,-3255
2017,3,20,9,14161,14585,11143,-3442
2017,3,20,10,15079,15622,12304,-3318
2017,3,20,11,16760,17535,14465,-3070
2017,3,20,12,17936,18701,15598,-3103
2017,3,20,13,18339,18981,15389,-3592
2017,3,20,14,18495,18985,15341,-3644
2017,3,20,15,18467,18938,14798,-4140
2017,3,20,16,18304,18766,14251,-4515
2017,3,20,17,18074,18497,14434,-4063
2017,3,20,18,17929,18291,14702,-3589
2017,3,20,19,17757,18083,14470,-3613
2017,3,20,20,17680,18001,13867,-4134
2017,3,20,21,17737,18162,14020,-4142
2017,3,20,22,17824,18373,14151,-4222
2017,3,20,23,17914,18595,14655,-3940
2017,3,21,0,18495,19183,15322,-3861
2017,3,21,1,18522,19047,15710,-3337
2017,3,21,2,17755,18178,14980,-3198
2017,3,21,3,16585,16871,13039,-3832
2017,3,21,4,15348,15594,12169,-3425
2017,3,21,5,14336,14633,10647,-3986
2017,3,21,6,13828,14114,10650,-3464
2017,3,21,7,13544,13835,10448,-3387
2017,3,21,8,13477,13754,10271,-3483
2017,3,21,9,13712,13989,10636,-3353
2017,3,21,10,14616,14932,11464,-3468
2017,3,21,11,16320,16789,13359,-3430
2017,3,21,12,17506,18050,14799,-3251
2017,3,21,13,17905,18541,15006,-3535
2017,3,21,14,18082,18640,15100,-3540
2017,3,21,15,18083,18497,15111,-3386
2017,3,21,16,17958,18229,14894,-3335
2017,3,21,17,17762,18015,14273,-3742
2017,3,21,18,17624,17727,14400,-3327
2017,3,21,19,17461,17521,14432,-3089
2017,3,21,20,17369,17428,14506,-2922
2017,3,21,21,17408,17541,14608,-2933
2017,3,21,22,17478,17776,14601,-3175
2017,3,21,23,17566,17949,14691,-3258
2017,3,22,0,18141,18621,15124,-3497
2017,3,22,1,18199,18673,15252,-3421
2017,3,22,2,17435,17977,14987,-2990
2017,3,22,3,16252,16685,13339,-3346
2017,3,22,4,15045,15403,12172,-3231
2017,3,22,5,14358,14515,11569,-2946
2017,3,22,6,13919,14026,11502,-2524
2017,3,22,7,13676,13805,11654,-2151
2017,3,22,8,13658,13812,11651,-2161
2017,3,22,9,13935,14131,12172,-1959
2017,3,22,10,14878,15231,13047,-2184
2017,3,22,11,16661,17180,14701,-2479
2017,3,22,12,17952,18428,16105,-2323
2017,3,22,13,18478,18865,16118,-2747
2017,3,22,14,18762,18979,16305,-2674
2017,3,22,15,18853,19033,16192,-2841
2017,3,22,16,18822,18940,15878,-3062
2017,3,22,17,18698,18820,15556,-3264
2017,3,22,18,18640,18770,15523,-3247
2017,3,22,19,18537,18659,15004,-3655
2017,3,22,20,18517,18678,15128,-3550
2017,3,22,21,18648,18888,15402,-3486
2017,3,22,22,18907,19208,15870,-3338
2017,3,22,23,19120,19581,16576,-3005
2017,3,23,0,19708,20372,17336,-3036
2017,3,23,1,19784,20485,17448,-3037
2017,3,23,2,19032,19753,16343,-3410
2017,3,23,3,17848,18512,15432,-3080
2017,3,23,4,16610,17156,14026,-3130
2017,3,23,5,15623,16290,13179,-3111
2017,3,23,6,15135,15794,12898,-2896
2017,3,23,7,14869,15522,12744,-2778
2017,3,23,8,14807,15460,12767,-2693
2017,3,23,9,15032,15736,13144,-2592
2017,3,23,10,15887,16708,14171,-2537
2017,3,23,11,17528,18579,16015,-2564
2017,3,23,12,18636,19762,17193,-2569
2017,3,23,13,18952,19921,16797,-3124
2017,3,23,14,18916,19861,16187,-3674
2017,3,23,15,18780,19629,15700,-3929
2017,3,23,16,18539,19321,15183,-4138
2017,3,23,17,18247,19014,15236,-3778
2017,3,23,18,18058,18762,15012,-3750
2017,3,23,19,17865,18468,14843,-3625
2017,3,23,20,17800,18298,14693,-3605
2017,3,23,21,17891,18378,14748,-3630
2017,3,23,22,18139,18595,15017,-3578
2017,3,23,23,18317,18755,15366,-3389
2017,3,24,0,18871,19512,15970,-3542
2017,3,24,1,18916,19617,16461,-3156
2017,3,24,2,18206,18848,15728,-3120
2017,3,24,3,17045,17606,14326,-3280
2017,3,24,4,15858,16353,13381,-2972
2017,3,24,5,15305,15342,11588,-3754
2017,3,24,6,14827,14841,11449,-3392
2017,3,24,7,14533,14516,11174,-3342
2017,3,24,8,14438,14412,11346,-3066
2017,3,24,9,14599,14601,11765,-2836
2017,3,24,10,15337,15489,12182,-3307
2017,3,24,11,16831,17303,13753,-3550
2017,3,24,12,17904,18515,15459,-3056
2017,3,24,13,18344,19027,15102,-3925
2017,3,24,14,18579,19295,14877,-4418
2017,3,24,15,18642,19367,14979,-4388
2017,3,24,16,18540,19364,15201,-4163
2017,3,24,17,18328,19180,15075,-4105
2017,3,24,18,18149,19031,14561,-4470
2017,3,24,19,17935,18920,14598,-4322
2017,3,24,20,17807,18561,14121,-4440
2017,3,24,21,17734,18278,13745,-4533
2017,3,24,22,17625,18343,13775,-4568
2017,3,24,23,17532,18288,14077,-4211
2017,3,25,0,17870,18550,14057,-4493
2017,3,25,1,17776,18365,14105,-4260
2017,3,25,2,17163,17741,13524,-4217
2017,3,25,3,16253,16813,12027,-4786
2017,3,25,4,15238,15687,11121,-4566
2017,3,25,5,14322,14781,10851,-3930
2017,3,25,6,13716,14203,10547,-3656
2017,3,25,7,13349,13804,9865,-3939
2017,3,25,8,13170,13615,9899,-3716
2017,3,25,9,13185,13620,10106,-3514
2017,3,25,10,13494,13947,10431,-3516
2017,3,25,11,14160,14579,11165,-3414
2017,3,25,12,14790,15320,11753,-3567
2017,3,25,13,15611,16154,12566,-3588
2017,3,25,14,16361,16824,13130,-3694
2017,3,25,15,16680,17136,13569,-3567
2017,3,25,16,16713,17224,13222,-4002
2017,3,25,17,16567,17137,13366,-3771
2017,3,25,18,16337,16956,12523,-4433
2017,3,25,19,16115,16897,12442,-4455
2017,3,25,20,15983,16832,12612,-4220
2017,3,25,21,15942,16921,12679,-4242
2017,3,25,22,16042,17029,12661,-4368
2017,3,25,23,16218,17212,12660,-4552
2017,3,26,0,16785,17643,12663,-4980
2017,3,26,1,16940,17628,13089,-4539
2017,3,26,2,16556,17132,12895,-4237
2017,3,26,3,15856,16399,11860,-4539
2017,3,26,4,14990,15462,11121,-4341
2017,3,26,5,14125,14605,11060,-3545
2017,3,26,6,13528,14049,10946,-3103
2017,3,26,7,13158,13692,10839,-2853
2017,3,26,8,12993,13516,10701,-2815
2017,3,26,9,13000,13553,10750,-2803
2017,3,26,10,13237,13798,11089,-2709
2017,3,26,11,13775,14303,11635,-2668
2017,3,26,12,14232,14839,12232,-2607
2017,3,26,13,14968,15713,13091,-2622
2017,3,26,14,15713,16457,13344,-3113
2017,3,26,15,16061,16940,13577,-3363
2017,3,26,16,16169,17130,13700,-3430
2017,3,26,17,16137,17194,13781,-3413
2017,3,26,18,16011,17169,13825,-3344
2017,3,26,19,15856,17100,14052,-3048
2017,3,26,20,15797,17078,13969,-3109
2017,3,26,21,15901,17212,13961,-3251
2017,3,26,22,16196,17500,14431,-3069
2017,3,26,23,16492,17673,14425,-3248
2017,3,27,0,17128,18181,14744,-3437
2017,3,27,1,17285,18087,14642,-3445
2017,3,27,2,16751,17364,13925,-3439
2017,3,27,3,15795,16339,13029,-3310
2017,3,27,4,14732,15228,11768,-3460
2017,3,27,5,13716,14413,11270,-3143
2017,3,27,6,13230,13942,11101,-2841
2017,3,27,7,12962,13680,11034,-2646
2017,3,27,8,12895,13619,11224,-2395
2017,3,27,9,13141,13889,11260,-2629
2017,3,27,10,14064,14843,12178,-2665
2017,3,27,11,15928,16733,14079,-2654
2017,3,27,12,17246,18009,15055,-2954
2017,3,27,13,17800,18602,15170,-3432
2017,3,27,14,18067,18930,14843,-4087
2017,3,27,15,18156,19176,15126,-4050
2017,3,27,16,18067,19134,15337,-3797
2017,3,27,17,17887,18855,15155,-3700
2017,3,27,18,17753,18629,15365,-3264
2017,3,27,19,17552,18418,15245,-3173
2017,3,27,20,17418,18250,14754,-3496
2017,3,27,21,17419,18231,14442,-3789
2017,3,27,22,17542,18340,14770,-3570
2017,3,27,23,17619,18274,14845,-3429
2017,3,28,0,18073,18729,15077,-3652
2017,3,28,1,18027,18687,15086,-3601
2017,3,28,2,17268,17852,14307,-3545
2017,3,28,3,16051,16519,13087,-3432
2017,3,28,4,14770,15193,12221,-2972
2017,3,28,5,13738,14242,10993,-3249
2017,3,28,6,13189,13697,10559,-3138
2017,3,28,7,12886,13379,10444,-2935
2017,3,28,8,12804,13286,10559,-2727
2017,3,28,9,13035,13510,10869,-2641
2017,3,28,10,13948,14487,11481,-3006
2017,3,28,11,15824,16391,13677,-2714
2017,3,28,12,17109,17617,14412,-3205
2017,3,28,13,17596,18150,14859,-3291
2017,3,28,14,17900,18367,14830,-3537
2017,3,28,15,17968,18608,15144,-3464
2017,3,28,16,17900,18830,15236,-3594
2017,3,28,17,17723,18790,15061,-3729
2017,3,28,18,17610,18794,15122,-3672
2017,3,28,19,17427,18677,15150,-3527
2017,3,28,20,17324,18626,14829,-3797
2017,3,28,21,17340,18726,15101,-3625
2017,3,28,22,17444,18998,15345,-3653
2017,3,28,23,17546,19126,15530,-3596
2017,3,29,0,17984,19308,15616,-3692
2017,3,29,1,17964,19005,15513,-3492
2017,3,29,2,17265,18073,14562,-3511
2017,3,29,3,16089,16687,13028,-3659
2017,3,29,4,14848,15387,11795,-3592
2017,3,29,5,13879,14401,10862,-3539
2017,3,29,6,13347,13858,10764,-3094
2017,3,29,7,13048,13547,10423,-3124
2017,3,29,8,12969,13457,10447,-3010
2017,3,29,9,13192,13698,10866,-2832
2017,3,29,10,14071,14628,11747,-2881
2017,3,29,11,15877,16462,13717,-2745
2017,3,29,12,17116,17585,14693,-2892
2017,3,29,13,17573,17937,14938,-2999
2017,3,29,14,17827,18048,15119,-2929
2017,3,29,15,17812,17947,15173,-2774
2017,3,29,16,17702,17733,15125,-2608
2017,3,29,17,17503,17533,15007,-2526
2017,3,29,18,17399,17425,14958,-2467
2017,3,29,19,17256,17266,14920,-2346
2017,3,29,20,17183,17223,14766,-2457
2017,3,29,21,17232,17378,14800,-2578
2017,3,29,22,17336,17602,15034,-2568
2017,3,29,23,17414,17775,15309,-2466
2017,3,30,0,17895,18339,15508,-2831
2017,3,30,1,18014,18510,15600,-2910
2017,3,30,2,17421,17791,14960,-2831
2017,3,30,3,16283,16598,13577,-3021
2017,3,30,4,15072,15324,12181,-3143
2017,3,30,5,14175,14431,10962,-3469
2017,3,30,6,13680,13947,10592,-3355
2017,3,30,7,13409,13662,10100,-3562
2017,3,30,8,13351,13635,10079,-3556
2017,3,30,9,13596,13921,10206,-3715
2017,3,30,10,14479,14926,11208,-3718
2017,3,30,11,16187,16759,13218,-3541
2017,3,30,12,17398,17877,13964,-3913
2017,3,30,13,17825,18172,14294,-3878
2017,3,30,14,18047,18260,14363,-3897
2017,3,30,15,17997,18191,13806,-4385
2017,3,30,16,17851,18007,13510,-4497
2017,3,30,17,17604,17745,13623,-4122
2017,3,30,18,17469,17675,13848,-3827
2017,3,30,19,17302,17668,14036,-3632
2017,3,30,20,17216,17830,13842,-3988
2017,3,30,21,17255,18112,14151,-3961
2017,3,30,22,17370,18450,14555,-3895
2017,3,30,23,17475,18682,15170,-3512
2017,3,31,0,17933,19036,15453,-3583
2017,3,31,1,17984,18771,15306,-3465
2017,3,31,2,17407,17960,14680,-3280
2017,3,31,3,16257,16750,13207,-3543
2017,3,31,4,15051,15465,12034,-3431
2017,3,31,5,14197,14510,11021,-3489
2017,3,31,6,13676,13952,10474,-3478
2017,3,31,7,13362,13688,10383,-3305
2017,3,31,8,13267,13627,10551,-3076
2017,3,31,9,13460,13878,10970,-2908
2017,3,31,10,14258,14827,11899,-2928
2017,3,31,11,15974,16627,13814,-2813
2017,3,31,12,17254,17982,14865,-3117
2017,3,31,13,17856,18632,15074,-3558
2017,3,31,14,18247,19112,15565,-3547
2017,3,31,15,18362,19349,15626,-3723
2017,3,31,16,18326,19429,15459,-3970
2017,3,31,17,18142,19380,15491,-3889
2017,3,31,18,18009,19315,15476,-3839
2017,3,31,19,17818,19180,15449,-3731
2017,3,31,20,17678,19153,15439,-3714
2017,3,31,21,17606,19219,15472,-3747
2017,3,31,22,17557,19272,15395,-3877
2017,3,31,23,17499,19251,15303,-3948
2017,4,1,0,17764,19288,15293,-3995
2017,4,1,1,17653,18925,15250,-3675
2017,4,1,2,17139,18175,14750,-3425
2017,4,1,3,16195,17195,13611,-3584
2017,4,1,4,15136,16049,12609,-3440
2017,4,1,5,14303,14981,11765,-3216
2017,4,1,6,13728,14399,11146,-3253
2017,4,1,7,13365,14037,10577,-3460
2017,4,1,8,13180,13828,10299,-3529
2017,4,1,9,13212,13862,10350,-3512
2017,4,1,10,13602,14136,10608,-3528
2017,4,1,11,14262,14856,11642,-3214
2017,4,1,12,14817,15664,12237,-3427
2017,4,1,13,15607,16549,12893,-3656
2017,4,1,14,16089,17206,13806,-3400
2017,4,1,15,16425,17487,14079,-3408
2017,4,1,16,16474,17492,13697,-3795
2017,4,1,17,16386,17435,13467,-3968
2017,4,1,18,16211,17163,13263,-3900
2017,4,1,19,16054,17011,13122,-3889
2017,4,1,20,15981,16908,12944,-3964
2017,4,1,21,16028,16861,12751,-4110
2017,4,1,22,16174,17013,13166,-3847
2017,4,1,23,16291,17139,13366,-3773
2017,4,2,0,16760,17498,13370,-4128
2017,4,2,1,17109,17578,13310,-4268
2017,4,2,2,16489,17110,13598,-3512
2017,4,2,3,15724,16351,12554,-3797
2017,4,2,4,14844,15389,11590,-3799
2017,4,2,5,13995,14489,11121,-3368
2017,4,2,6,13445,13907,10705,-3202
2017,4,2,7,13097,13583,10585,-2998
2017,4,2,8,12924,13398,10497,-2901
2017,4,2,9,12945,13402,10752,-2650
2017,4,2,10,13269,13642,10796,-2846
2017,4,2,11,13694,14085,11276,-2809
2017,4,2,12,14034,14561,11640,-2921
2017,4,2,13,14641,15115,12212,-2903
2017,4,2,14,15015,15473,12934,-2539
2017,4,2,15,15249,15544,12914,-2630
2017,4,2,16,15278,15523,12636,-2887
2017,4,2,17,15222,15385,12152,-3233
2017,4,2,18,15094,15219,12027,-3192
2017,4,2,19,14969,15105,12329,-2776
2017,4,2,20,14960,15118,12377,-2741
2017,4,2,21,15124,15356,12994,-2362
2017,4,2,22,15389,15685,13111,-2574
2017,4,2,23,15595,15992,13358,-2634
2017,4,3,0,16214,16727,13978,-2749
2017,4,3,1,16782,17149,14332,-2817
2017,4,3,2,16120,16529,13603,-2926
2017,4,3,3,15227,15564,12151,-3413
2017,4,3,4,14258,14504,11003,-3501
2017,4,3,5,13364,13726,10472,-3254
2017,4,3,6,12945,13249,10428,-2821
2017,4,3,7,12735,13018,10429,-2589
2017,4,3,8,12704,12995,10421,-2574
2017,4,3,9,12987,13360,10728,-2632
2017,4,3,10,13996,14440,11691,-2749
2017,4,3,11,15699,16193,13374,-2819
2017,4,3,12,16853,17317,14906,-2411
2017,4,3,13,17354,17826,14828,-2998
2017,4,3,14,17482,17957,14761,-3196
2017,4,3,15,17556,17953,14631,-3322
2017,4,3,16,17478,17785,14698,-3087
2017,4,3,17,17336,17521,14357,-3164
2017,4,3,18,17250,17377,14221,-3156
2017,4,3,19,17125,17167,14056,-3111
2017,4,3,20,17064,17067,14134,-2933
2017,4,3,21,17130,17157,14245,-2912
2017,4,3,22,17209,17389,14570,-2819
2017,4,3,23,17195,17632,14878,-2754
2017,4,4,0,17583,18227,15585,-2642
2017,4,4,1,17836,18150,15680,-2470
2017,4,4,2,16940,17253,14705,-2548
2017,4,4,3,15733,15895,13161,-2734
2017,4,4,4,14477,14566,11904,-2662
2017,4,4,5,13472,13697,11436,-2261
2017,4,4,6,12941,13262,11093,-2169
2017,4,4,7,12650,13023,10744,-2279
2017,4,4,8,12542,12972,10722,-2250
2017,4,4,9,12756,13175,11381,-1794
2017,4,4,10,13685,14035,11818,-2217
2017,4,4,11,15407,15880,12968,-2912
2017,4,4,12,16599,17203,14360,-2843
2017,4,4,13,17149,17878,14958,-2920
2017,4,4,14,17358,18225,15446,-2779
2017,4,4,15,17533,18462,15361,-3101
2017,4,4,16,17556,18488,15292,-3196
2017,4,4,17,17492,18356,15097,-3259
2017,4,4,18,17459,18384,14972,-3412
2017,4,4,19,17364,18256,15184,-3072
2017,4,4,20,17330,18166,14781,-3385
2017,4,4,21,17420,18325,15085,-3240
2017,4,4,22,17464,18542,15456,-3086
2017,4,4,23,17394,18591,15822,-2769
2017,4,5,0,17689,18763,15749,-3014
2017,4,5,1,17870,18619,15540,-3079
2017,4,5,2,16937,17748,15181,-2567
2017,4,5,3,15708,16407,13695,-2712
2017,4,5,4,14443,15039,12449,-2590
2017,4,5,5,13441,14070,11562,-2508
2017,4,5,6,12893,13513,11155,-2358
2017,4,5,7,12581,13204,10715,-2489
2017,4,5,8,12475,13092,10341,-2751
2017,4,5,9,12683,13331,10659,-2672
2017,4,5,10,13622,14305,11593,-2712
2017,4,5,11,15303,16123,13503,-2620
2017,4,5,12,16493,17449,15298,-2151
2017,4,5,13,17003,17939,15802,-2137
2017,4,5,14,17181,18114,15639,-2475
2017,4,5,15,17292,18100,15227,-2873
2017,4,5,16,17274,18055,14928,-3127
2017,4,5,17,17180,17872,14581,-3291
2017,4,5,18,17156,17681,14212,-3469
2017,4,5,19,17067,17422,13821,-3601
2017,4,5,20,17049,17339,13914,-3425
2017,4,5,21,17156,17439,13931,-3508
2017,4,5,22,17182,17596,13910,-3686
2017,4,5,23,17103,17659,14298,-3361
2017,4,6,0,17441,18092,14502,-3590
2017,4,6,1,17753,18341,14915,-3426
2017,4,6,2,16894,17602,14131,-3471
2017,4,6,3,15682,16276,12271,-4005
2017,4,6,4,14418,14958,11104,-3854
2017,4,6,5,13546,13996,10873,-3123
2017,4,6,6,13013,13390,10520,-2870
2017,4,6,7,12721,13067,10116,-2951
2017,4,6,8,12620,13027,10226,-2801
2017,4,6,9,12842,13259,10726,-2533
2017,4,6,10,13800,14226,11287,-2939
2017,4,6,11,15558,16195,13204,-2991
2017,4,6,12,16817,17520,14701,-2819
2017,4,6,13,17403,18219,14883,-3336
2017,4,6,14,17638,18767,15122,-3645
2017,4,6,15,17797,19023,15247,-3776
2017,4,6,16,17783,19192,15738,-3454
2017,4,6,17,17675,19151,15836,-3315
2017,4,6,18,17616,18976,16631,-2345
2017,4,6,19,17480,18737,15813,-2924
2017,4,6,20,17432,18728,15615,-3113
2017,4,6,21,17524,19088,16001,-3087
2017,4,6,22,17558,19128,16293,-2835
2017,4,6,23,17523,18794,15897,-2897
2017,4,7,0,17825,18851,15798,-3053
2017,4,7,1,18038,18750,15888,-2862
2017,4,7,2,17134,17932,15504,-2428
2017,4,7,3,15889,16666,14440,-2226
2017,4,7,4,14618,15352,12563,-2789
2017,4,7,5,13682,14421,12046,-2375
2017,4,7,6,13146,13864,11418,-2446
2017,4,7,7,12841,13519,10870,-2649
2017,4,7,8,12733,13410,11043,-2367
2017,4,7,9,12931,13608,10952,-2656
2017,4,7,10,13806,14560,12034,-2526
2017,4,7,11,15396,16287,14170,-2117
2017,4,7,12,16613,17497,15453,-2044
2017,4,7,13,17249,18088,15853,-2235
2017,4,7,14,17523,18520,15720,-2800
2017,4,7,15,17701,18669,15541,-3128
2017,4,7,16,17705,18575,15673,-2902
2017,4,7,17,17596,18436,15622,-2814
2017,4,7,18,17520,18379,15650,-2729
2017,4,7,19,17409,18237,15552,-2685
2017,4,7,20,17334,18262,15401,-2861
2017,4,7,21,17366,18417,15055,-3362
2017,4,7,22,17341,18517,14834,-3683
2017,4,7,23,17238,18488,15043,-3445
2017,4,8,0,17458,18719,15287,-3432
2017,4,8,1,17628,18743,15277,-3466
2017,4,8,2,16905,18192,14627,-3565
2017,4,8,3,15934,17182,13549,-3633
2017,4,8,4,14868,15990,12947,-3043
2017,4,8,5,14193,14983,11574,-3409
2017,4,8,6,13662,14381,11122,-3259
2017,4,8,7,13332,14032,10970,-3062
2017,4,8,8,13169,13849,10859,-2990
2017,4,8,9,13218,13887,10882,-3005
2017,4,8,10,13573,14215,11191,-3024
2017,4,8,11,14070,14750,11961,-2789
2017,4,8,12,14616,15463,12838,-2625
2017,4,8,13,15344,16136,13418,-2718
2017,4,8,14,15719,16515,13443,-3072
2017,4,8,15,15916,16614,13297,-3317
2017,4,8,16,15887,16452,13276,-3176
2017,4,8,17,15751,16167,13112,-3055
2017,4,8,18,15559,15883,12882,-3001
2017,4,8,19,15406,15638,12951,-2687
2017,4,8,20,15345,15486,12786,-2700
2017,4,8,21,15433,15525,12820,-2705
2017,4,8,22,15555,15709,12945,-2764
2017,4,8,23,15661,15938,13149,-2789
2017,4,9,0,16079,16470,13640,-2830
2017,4,9,1,16566,17001,13877,-3124
2017,4,9,2,16077,16687,13595,-3092
2017,4,9,3,15363,15953,12399,-3554
2017,4,9,4,14551,15025,11495,-3530
2017,4,9,5,13755,14233,10608,-3625
2017,4,9,6,13225,13684,10232,-3452
2017,4,9,7,12892,13345,10108,-3237
2017,4,9,8,12730,13181,10078,-3103
2017,4,9,9,12755,13153,10051,-3102
2017,4,9,10,13041,13439,10516,-2923
2017,4,9,11,13361,13820,10991,-2829
2017,4,9,12,13690,14279,11494,-2785
2017,4,9,13,14288,14734,11737,-2997
2017,4,9,14,14676,14981,11719,-3262
2017,4,9,15,14863,15045,11534,-3511
2017,4,9,16,14886,14937,11249,-3688
2017,4,9,17,14840,14813,11143,-3670
2017,4,9,18,14744,14649,10988,-3661
2017,4,9,19,14654,14550,10959,-3591
2017,4,9,20,14669,14561,11127,-3434
2017,4,9,21,14824,14776,11482,-3294
2017,4,9,22,15035,15105,11747,-3358
2017,4,9,23,15207,15411,11810,-3601
2017,4,10,0,15712,16023,12116,-3907
2017,4,10,1,16269,16522,13086,-3436
2017,4,10,2,15733,16054,12733,-3321
2017,4,10,3,14841,15100,11640,-3460
2017,4,10,4,13883,14097,10631,-3466
2017,4,10,5,13049,13308,10229,-3079
2017,4,10,6,12591,12842,10106,-2736
2017,4,10,7,12343,12563,9683,-2880
2017,4,10,8,12273,12508,9714,-2794
2017,4,10,9,12515,12737,9880,-2857
2017,4,10,10,13437,13601,10451,-3150
2017,4,10,11,14996,15079,11759,-3320
2017,4,10,12,16181,16210,13045,-3165
2017,4,10,13,16782,16889,13482,-3407
2017,4,10,14,17070,17137,13563,-3574
2017,4,10,15,17291,17224,13556,-3668
2017,4,10,16,17353,17246,13492,-3754
2017,4,10,17,17338,17149,13355,-3794
2017,4,10,18,17380,17137,13420,-3717
2017,4,10,19,17363,17107,13548,-3559
2017,4,10,20,17368,17142,13760,-3382
2017,4,10,21,17412,17193,13527,-3666
2017,4,10,22,17356,17356,13882,-3474
2017,4,10,23,17194,17256,13943,-3313
2017,4,11,0,17438,17482,13824,-3658
2017,4,11,1,17713,17684,14106,-3578
2017,4,11,2,16874,16878,13780,-3098
2017,4,11,3,15600,15680,12388,-3292
2017,4,11,4,14287,14460,11894,-2566
2017,4,11,5,13274,13487,11238,-2249
2017,4,11,6,12712,12889,10753,-2136
2017,4,11,7,12392,12514,10499,-2015
2017,4,11,8,12272,12394,10387,-2007
2017,4,11,9,12456,12568,10418,-2150
2017,4,11,10,13291,13306,10728,-2578
2017,4,11,11,14794,14716,11680,-3036
2017,4,11,12,15997,15908,12873,-3035
2017,4,11,13,16657,16628,13301,-3327
2017,4,11,14,17027,17036,13630,-3406
2017,4,11,15,17327,17286,13686,-3600
2017,4,11,16,17504,17426,13514,-3912
2017,4,11,17,17609,17570,13707,-3863
2017,4,11,18,17758,17731,13923,-3808
2017,4,11,19,17822,17750,13989,-3761
2017,4,11,20,17882,17774,13843,-3931
2017,4,11,21,17952,17857,14291,-3566
2017,4,11,22,17856,17871,14432,-3439
2017,4,11,23,17611,17571,14294,-3277
2017,4,12,0,17744,17718,14601,-3117
2017,4,12,1,17931,17831,14677,-3154
2017,4,12,2,17130,17040,14063,-2977
2017,4,12,3,15852,15842,12531,-3311
2017,4,12,4,14531,14575,11516,-3059
2017,4,12,5,13339,13623,11122,-2501
2017,4,12,6,12769,13059,10882,-2177
2017,4,12,7,12425,12677,10678,-1999
2017,4,12,8,12297,12513,10582,-1931
2017,4,12,9,12476,12653,10686,-1967
2017,4,12,10,13348,13422,10791,-2631
2017,4,12,11,14999,14812,11976,-2836
2017,4,12,12,16297,16023,12906,-3117
2017,4,12,13,16991,16861,13832,-3029
2017,4,12,14,17386,17387,14320,-3067
2017,4,12,15,17640,17723,14510,-3213
2017,4,12,16,17709,17893,14776,-3117
2017,4,12,17,17674,17876,14768,-3108
2017,4,12,18,17672,17745,14838,-2907
2017,4,12,19,17583,17488,14666,-2822
2017,4,12,20,17530,17412,14626,-2786
2017,4,12,21,17552,17507,14745,-2762
2017,4,12,22,17427,17674,15028,-2646
2017,4,12,23,17165,17560,14824,-2736
2017,4,13,0,17298,17715,14831,-2884
2017,4,13,1,17537,17896,14857,-3039
2017,4,13,2,16722,17160,14284,-2876
2017,4,13,3,15433,15938,12991,-2947
2017,4,13,4,14136,14674,11947,-2727
2017,4,13,5,13130,13716,11053,-2663
2017,4,13,6,12636,13103,10834,-2269
2017,4,13,7,12363,12749,10805,-1944
2017,4,13,8,12290,12631,10896,-1735
2017,4,13,9,12517,12829,10974,-1855
2017,4,13,10,13418,13657,11399,-2258
2017,4,13,11,14989,15020,12816,-2204
2017,4,13,12,16190,16116,13854,-2262
2017,4,13,13,16724,16744,14150,-2594
2017,4,13,14,16956,17034,13911,-3123
2017,4,13,15,17047,17146,13699,-3447
2017,4,13,16,17006,17008,13557,-3451
2017,4,13,17,16900,16809,13760,-3049
2017,4,13,18,16858,16758,13626,-3132
2017,4,13,19,16757,16728,13458,-3270
2017,4,13,20,16708,16733,13630,-3103
2017,4,13,21,16791,16830,13483,-3347
2017,4,13,22,16797,16932,13552,-3380
2017,4,13,23,16700,16895,13306,-3589
2017,4,14,0,16915,17100,13594,-3506
2017,4,14,1,17273,17375,13941,-3434
2017,4,14,2,16567,16763,13567,-3196
2017,4,14,3,15403,15689,12323,-3366
2017,4,14,4,14191,14531,11145,-3386
2017,4,14,5,13192,13651,10484,-3167
2017,4,14,6,12626,13124,10347,-2777
2017,4,14,7,12321,12753,10351,-2402
2017,4,14,8,12200,12697,10325,-2372
2017,4,14,9,12366,12861,10182,-2679
2017,4,14,10,13001,13553,10617,-2936
2017,4,14,11,13925,14666,11917,-2749
2017,4,14,12,14800,15639,12496,-3143
2017,4,14,13,15515,16187,12579,-3608
2017,4,14,14,15887,16428,12387,-4041
2017,4,14,15,16013,16471,12604,-3867
2017,4,14,16,15978,16412,12653,-3759
2017,4,14,17,15867,16231,12504,-3727
2017,4,14,18,15783,16070,12333,-3737
2017,4,14,19,15704,15966,12286,-3680
2017,4,14,20,15656,15869,12165,-3704
2017,4,14,21,15730,15976,12443,-3533
2017,4,14,22,15659,16141,12709,-3432
2017,4,14,23,15474,16090,12536,-3554
2017,4,15,0,15603,16212,12856,-3356
2017,4,15,1,16025,16619,13094,-3525
2017,4,15,2,15526,16146,13044,-3102
2017,4,15,3,14706,15272,12259,-3013
2017,4,15,4,13797,14230,11206,-3024
2017,4,15,5,13064,13328,10591,-2737
2017,4,15,6,12551,12786,10037,-2749
2017,4,15,7,12242,12457,9750,-2707
2017,4,15,8,12078,12283,9700,-2583
2017,4,15,9,12128,12302,10077,-2225
2017,4,15,10,12441,12629,10312,-2317
2017,4,15,11,12840,13109,10950,-2159
2017,4,15,12,13363,13625,11396,-2229
2017,4,15,13,14073,14260,11888,-2372
2017,4,15,14,14520,14708,11833,-2875
2017,4,15,15,14776,15001,12586,-2415
2017,4,15,16,14823,15173,12660,-2513
2017,4,15,17,14754,15066,12560,-2506
2017,4,15,18,14644,15132,12661,-2471
2017,4,15,19,14541,15081,12645,-2436
2017,4,15,20,14511,15118,12968,-2150
2017,4,15,21,14583,15285,13212,-2073
2017,4,15,22,14658,15566,13457,-2109
2017,4,15,23,14749,15694,13435,-2259
2017,4,16,0,15009,15943,13568,-2375
2017,4,16,1,15415,16191,13596,-2595
2017,4,16,2,15038,15805,13460,-2345
2017,4,16,3,14330,15000,12903,-2097
2017,4,16,4,13546,14030,12406,-1624
2017,4,16,5,12961,13153,11607,-1546
2017,4,16,6,12376,12551,11099,-1452
2017,4,16,7,11989,12154,10838,-1316
2017,4,16,8,11778,11894,10490,-1404
2017,4,16,9,11756,11831,10456,-1375
2017,4,16,10,11939,12008,10439,-1569
2017,4,16,11,12136,12267,10686,-1581
2017,4,16,12,12546,12820,11092,-1728
2017,4,16,13,13332,13656,11817,-1839
2017,4,16,14,14065,14287,12150,-2137
2017,4,16,15,14587,14737,12560,-2177
2017,4,16,16,14945,15067,12867,-2200
2017,4,16,17,15177,15253,13086,-2167
2017,4,16,18,15336,15376,13030,-2346
2017,4,16,19,15475,15421,13253,-2168
2017,4,16,20,15645,15476,13228,-2248
2017,4,16,21,15857,15594,13340,-2254
2017,4,16,22,15953,15642,13323,-2319
2017,4,16,23,16006,15734,13447,-2287
2017,4,17,0,16292,16014,13578,-2436
2017,4,17,1,16755,16538,13878,-2660
2017,4,17,2,16327,16132,13445,-2687
2017,4,17,3,15401,15178,12300,-2878
2017,4,17,4,14333,14120,11875,-2245
2017,4,17,5,12774,13288,11068,-2220
2017,4,17,6,12302,12707,10716,-1991
2017,4,17,7,12050,12392,10616,-1776
2017,4,17,8,11973,12253,10769,-1484
2017,4,17,9,12196,12466,10953,-1513
2017,4,17,10,13073,13298,11250,-2048
2017,4,17,11,14558,14641,12324,-2317
2017,4,17,12,15860,15935,13605,-2330
2017,4,17,13,16607,16845,14174,-2671
2017,4,17,14,17080,17264,14084,-3180
2017,4,17,15,17354,17451,14223,-3228
2017,4,17,16,17411,17513,14462,-3051
2017,4,17,17,17354,17431,14548,-2883
2017,4,17,18,17293,17487,14745,-2742
2017,4,17,19,17123,17406,14615,-2791
2017,4,17,20,16984,17285,14448,-2837
2017,4,17,21,16938,17322,14377,-2945
2017,4,17,22,16816,17399,14534,-2865
2017,4,17,23,16637,17286,14534,-2752
2017,4,18,0,16761,17363,14328,-3035
2017,4,18,1,17013,17569,14270,-3299
2017,4,18,2,16220,16783,13792,-2991
2017,4,18,3,14930,15588,12797,-2791
2017,4,18,4,13665,14369,11725,-2644
2017,4,18,5,13093,13413,10642,-2771
2017,4,18,6,12598,12862,10377,-2485
2017,4,18,7,12280,12521,10209,-2312
2017,4,18,8,12162,12425,10251,-2174
2017,4,18,9,12358,12654,10340,-2314
2017,4,18,10,13174,13505,10683,-2822
2017,4,18,11,14610,14885,12058,-2827
2017,4,18,12,15756,16060,13278,-2782
2017,4,18,13,16272,16582,13396,-3186
2017,4,18,14,16492,16770,13411,-3359
2017,4,18,15,16543,16806,13271,-3535
2017,4,18,16,16497,16807,13305,-3502
2017,4,18,17,16410,16766,13896,-2870
2017,4,18,18,16389,16766,13903,-2863
2017,4,18,19,16326,16691,13615,-3076
2017,4,18,20,16295,16644,13817,-2827
2017,4,18,21,16366,16723,13689,-3034
2017,4,18,22,16341,16862,13873,-2989
2017,4,18,23,16213,16801,13883,-2918
2017,4,19,0,16369,16960,13823,-3137
2017,4,19,1,16742,17421,14256,-3165
2017,4,19,2,16082,16735,13932,-2803
2017,4,19,3,14896,15575,12823,-2752
2017,4,19,4,13687,14268,11746,-2522
2017,4,19,5,12892,13364,10992,-2372
2017,4,19,6,12410,12828,10917,-1911
2017,4,19,7,12121,12525,10966,-1559
2017,4,19,8,12020,12414,10664,-1750
2017,4,19,9,12228,12625,10809,-1816
2017,4,19,10,13054,13496,11377,-2119
2017,4,19,11,14536,15032,12753,-2279
2017,4,19,12,15749,16267,13843,-2424
2017,4,19,13,16330,16838,14320,-2518
2017,4,19,14,16606,17205,14342,-2863
2017,4,19,15,16725,17364,14584,-2780
2017,4,19,16,16708,17368,14836,-2532
2017,4,19,17,16618,17328,14778,-2550
2017,4,19,18,16593,17342,14701,-2641
2017,4,19,19,16512,17273,14629,-2644
2017,4,19,20,16494,17411,14540,-2871
2017,4,19,21,16597,17689,14988,-2701
2017,4,19,22,16602,17955,15489,-2466
2017,4,19,23,16491,17914,15035,-2879
2017,4,20,0,16581,17964,14704,-3260
2017,4,20,1,16866,17857,14574,-3283
2017,4,20,2,16218,17059,13951,-3108
2017,4,20,3,15042,15807,12982,-2825
2017,4,20,4,13819,14533,11995,-2538
2017,4,20,5,12793,13619,10875,-2744
2017,4,20,6,12270,13046,10434,-2612
2017,4,20,7,11973,12689,10413,-2276
2017,4,20,8,11857,12589,10285,-2304
2017,4,20,9,12050,12769,10394,-2375
2017,4,20,10,12858,13591,10780,-2811
2017,4,20,11,14339,15160,12160,-3000
2017,4,20,12,15613,16552,13166,-3386
2017,4,20,13,16283,17272,13674,-3598
2017,4,20,14,16633,17568,13831,-3737
2017,4,20,15,16803,17671,13782,-3889
2017,4,20,16,16807,17606,13833,-3773
2017,4,20,17,16735,17380,13555,-3825
2017,4,20,18,16719,17306,13619,-3687
2017,4,20,19,16630,17168,13609,-3559
2017,4,20,20,16592,17192,14077,-3115
2017,4,20,21,16630,17322,14245,-3077
2017,4,20,22,16571,17507,14189,-3318
2017,4,20,23,16412,17475,14035,-3440
2017,4,21,0,16483,17633,14318,-3315
2017,4,21,1,16780,17679,14582,-3097
2017,4,21,2,16141,16914,13802,-3112
2017,4,21,3,14958,15684,13052,-2632
2017,4,21,4,13740,14456,12165,-2291
2017,4,21,5,12837,13486,11363,-2123
2017,4,21,6,12281,12926,11315,-1611
2017,4,21,7,11959,12635,11031,-1604
2017,4,21,8,11831,12503,10934,-1569
2017,4,21,9,12007,12674,11085,-1589
2017,4,21,10,12761,13503,11621,-1882
2017,4,21,11,14169,15062,13199,-1863
2017,4,21,12,15421,16390,13797,-2593
2017,4,21,13,16123,17167,14484,-2683
2017,4,21,14,16513,17611,14951,-2660
2017,4,21,15,16710,17831,14831,-3000
2017,4,21,16,16725,17836,14712,-3124
2017,4,21,17,16640,17619,14465,-3154
2017,4,21,18,16591,17560,14303,-3257
2017,4,21,19,16493,17406,14443,-2963
2017,4,21,20,16434,17257,14230,-3027
2017,4,21,21,16448,17280,14080,-3200
2017,4,21,22,16339,17292,14052,-3240
2017,4,21,23,16118,17163,14218,-2945
2017,4,22,0,16101,17226,14228,-2998
2017,4,22,1,16330,17204,14090,-3114
2017,4,22,2,15810,16616,13613,-3003
2017,4,22,3,14862,15633,12828,-2805
2017,4,22,4,13809,14471,12143,-2328
2017,4,22,5,12841,13595,11103,-2492
2017,4,22,6,12277,12985,10700,-2285
2017,4,22,7,11943,12622,10613,-2009
2017,4,22,8,11763,12421,10467,-1954
2017,4,22,9,11794,12422,10416,-2006
2017,4,22,10,12051,12753,10534,-2219
2017,4,22,11,12410,13220,10922,-2298
2017,4,22,12,13039,14059,11738,-2321
2017,4,22,13,13909,15037,12293,-2744
2017,4,22,14,14515,15776,12812,-2964
2017,4,22,15,14830,16104,12759,-3345
2017,4,22,16,14878,16100,12859,-3241
2017,4,22,17,14791,15994,12715,-3279
2017,4,22,18,14645,15807,12487,-3320
2017,4,22,19,14517,15706,12544,-3162
2017,4,22,20,14471,15604,12622,-2982
2017,4,22,21,14544,15623,12678,-2945
2017,4,22,22,14615,15772,12794,-2978
2017,4,22,23,14694,15853,12926,-2927
2017,4,23,0,14882,16056,12846,-3210
2017,4,23,1,15368,16395,13134,-3261
2017,4,23,2,15052,16045,12910,-3135
2017,4,23,3,14312,15306,12163,-3143
2017,4,23,4,13472,14340,11159,-3181
2017,4,23,5,12694,13555,10673,-2882
2017,4,23,6,12162,13024,10611,-2413
2017,4,23,7,11830,12658,10517,-2141
2017,4,23,8,11660,12494,10258,-2236
2017,4,23,9,11679,12490,10224,-2266
2017,4,23,10,11869,12684,10213,-2471
2017,4,23,11,12024,12919,10406,-2513
2017,4,23,12,12441,13400,10810,-2590
2017,4,23,13,13172,13977,10907,-3070
2017,4,23,14,13775,14305,10923,-3382
2017,4,23,15,14017,14458,10759,-3699
2017,4,23,16,14061,14509,10794,-3715
2017,4,23,17,14018,14446,10698,-3748
2017,4,23,18,13916,14382,10701,-3681
2017,4,23,19,13818,14351,10743,-3608
2017,4,23,20,13827,14412,10957,-3455
2017,4,23,21,13984,14661,11171,-3490
2017,4,23,22,14162,14992,11378,-3614
2017,4,23,23,14307,15229,11320,-3909
2017,4,24,0,14628,15646,11797,-3849
2017,4,24,1,15298,16295,12314,-3981
2017,4,24,2,14940,15824,12101,-3723
2017,4,24,3,14026,14741,11199,-3542
2017,4,24,4,13056,13659,10164,-3495
2017,4,24,5,12456,12902,9568,-3334
2017,4,24,6,12053,12446,9452,-2994
2017,4,24,7,11843,12177,9143,-3034
2017,4,24,8,11805,12138,9249,-2889
2017,4,24,9,12072,12431,9517,-2914
2017,4,24,10,12921,13454,10191,-3263
2017,4,24,11,14323,14957,11335,-3622
2017,4,24,12,15551,16249,12624,-3625
2017,4,24,13,16193,16773,12791,-3982
2017,4,24,14,16548,16942,12844,-4098
2017,4,24,15,16675,17061,12864,-4197
2017,4,24,16,16648,17094,13044,-4050
2017,4,24,17,16551,17065,13108,-3957
2017,4,24,18,16499,17060,13260,-3800
2017,4,24,19,16394,16966,13151,-3815
2017,4,24,20,16331,16960,13254,-3706
2017,4,24,21,16359,17010,13267,-3743
2017,4,24,22,16363,17097,13301,-3796
2017,4,24,23,16299,17104,13081,-4023
2017,4,25,0,16408,17207,13482,-3725
2017,4,25,1,16778,17498,13822,-3676
2017,4,25,2,16162,16735,13382,-3353
2017,4,25,3,14959,15489,12067,-3422
2017,4,25,4,13725,14133,10887,-3246
2017,4,25,5,12887,13219,10241,-2978
2017,4,25,6,12373,12733,10241,-2492
2017,4,25,7,12088,12413,10008,-2405
2017,4,25,8,11987,12309,10031,-2278
2017,4,25,9,12207,12533,10103,-2430
2017,4,25,10,13015,13438,10721,-2717
2017,4,25,11,14482,15080,12118,-2962
2017,4,25,12,15799,16413,13046,-3367
2017,4,25,13,16484,17021,13598,-3423
2017,4,25,14,16866,17518,13872,-3646
2017,4,25,15,17046,17808,14062,-3746
2017,4,25,16,17070,17833,14438,-3395
2017,4,25,17,17002,17859,14309,-3550
2017,4,25,18,16984,17815,14147,-3668
2017,4,25,19,16884,17634,14111,-3523
2017,4,25,20,16856,17599,13990,-3609
2017,4,25,21,16945,17766,14045,-3721
2017,4,25,22,16938,17872,14077,-3795
2017,4,25,23,16831,17802,14146,-3656
2017,4,26,0,16836,17884,14263,-3621
2017,4,26,1,17102,17918,14318,-3600
2017,4,26,2,16434,17145,13922,-3223
2017,4,26,3,15197,15812,12580,-3232
2017,4,26,4,13925,14407,11392,-3015
2017,4,26,5,12914,13465,11056,-2409
2017,4,26,6,12363,12930,10985,-1945
2017,4,26,7,12044,12594,10531,-2063
2017,4,26,8,11920,12469,10296,-2173
2017,4,26,9,12108,12646,10418,-2228
2017,4,26,10,12885,13502,10642,-2860
2017,4,26,11,14330,15127,11816,-3311
2017,4,26,12,15677,16425,12957,-3468
2017,4,26,13,16408,17075,13382,-3693
2017,4,26,14,16836,17358,13611,-3747
2017,4,26,15,17060,17519,13741,-3778
2017,4,26,16,17111,17506,13638,-3868
2017,4,26,17,17072,17415,13465,-3950
2017,4,26,18,17088,17429,13334,-4095
2017,4,26,19,17028,17409,13593,-3816
2017,4,26,20,17010,17437,13620,-3817
2017,4,26,21,17048,0,13620,0
2017,4,26,22,16947,17618,14347,-3271
2017,4,26,23,16736,17574,13628,-3946
2017,4,27,0,16730,17602,13510,-4092
2017,4,27,1,17076,17794,13766,-4028
2017,4,27,2,16476,17066,13334,-3732
2017,4,27,3,15216,15782,12140,-3642
2017,4,27,4,13911,14410,11160,-3250
2017,4,27,5,12958,13425,10544,-2881
2017,4,27,6,12367,12814,10333,-2481
2017,4,27,7,12024,12455,10200,-2255
2017,4,27,8,11898,12361,10167,-2194
2017,4,27,9,12082,12524,10203,-2321
2017,4,27,10,12847,13341,10656,-2685
2017,4,27,11,14260,14864,12056,-2808
2017,4,27,12,15596,16347,13199,-3148
2017,4,27,13,16375,17119,13416,-3703
2017,4,27,14,16852,17553,13499,-4054
2017,4,27,15,17136,17729,13648,-4081
2017,4,27,16,17262,17846,13730,-4116
2017,4,27,17,17300,17887,13872,-4015
2017,4,27,18,17396,17925,13889,-4036
2017,4,27,19,17431,17963,14084,-3879
2017,4,27,20,17505,17983,14298,-3685
2017,4,27,21,17600,18034,14596,-3438
2017,4,27,22,17490,18064,14686,-3378
2017,4,27,23,17244,17875,14702,-3173
2017,4,28,0,17198,17949,14990,-2959
2017,4,28,1,17488,18108,14807,-3301
2017,4,28,2,16893,17293,14227,-3066
2017,4,28,3,15616,15945,13027,-2918
2017,4,28,4,14277,14540,11852,-2688
2017,4,28,5,13113,13478,11056,-2422
2017,4,28,6,12482,12856,10871,-1985
2017,4,28,7,12123,12490,10749,-1741
2017,4,28,8,11970,12322,10872,-1450
2017,4,28,9,12136,12484,10941,-1543
2017,4,28,10,12850,13275,11141,-2134
2017,4,28,11,14223,14769,12008,-2761
2017,4,28,12,15597,16143,13232,-2911
2017,4,28,13,16476,16892,13972,-2920
2017,4,28,14,17036,17314,14193,-3121
2017,4,28,15,17346,17595,14428,-3167
2017,4,28,16,17482,17813,14622,-3191
2017,4,28,17,17515,17933,14948,-2985
2017,4,28,18,17615,18232,15018,-3214
2017,4,28,19,17664,18423,14665,-3758
2017,4,28,20,17700,18585,15027,-3558
2017,4,28,21,17704,18679,15475,-3204
2017,4,28,22,17406,18540,15599,-2941
2017,4,28,23,16969,18116,15189,-2927
2017,4,29,0,16771,17833,14666,-3167
2017,4,29,1,17015,18046,14841,-3205
2017,4,29,2,16533,17421,14533,-2888
2017,4,29,3,15472,16200,12704,-3496
2017,4,29,4,14297,14934,11774,-3160
2017,4,29,5,13414,13887,11022,-2865
2017,4,29,6,12739,13184,10630,-2554
2017,4,29,7,12311,12732,10429,-2303
2017,4,29,8,12083,12496,10187,-2309
2017,4,29,9,12077,12470,10292,-2178
2017,4,29,10,12286,12721,10615,-2106
2017,4,29,11,12642,13141,10994,-2147
2017,4,29,12,13450,13978,11451,-2527
2017,4,29,13,14585,15012,12378,-2634
2017,4,29,14,15430,15766,13142,-2624
2017,4,29,15,15981,16473,13681,-2792
2017,4,29,16,16230,17009,14093,-2916
2017,4,29,17,16327,17110,14216,-2894
2017,4,29,18,16338,17153,14362,-2791
2017,4,29,19,16354,17320,14722,-2598
2017,4,29,20,16416,17496,14947,-2549
2017,4,29,21,16524,17640,15224,-2416
2017,4,29,22,16483,17622,15010,-2612
2017,4,29,23,16383,17517,14695,-2822
2017,4,30,0,16362,17432,14487,-2945
2017,4,30,1,16797,17752,14492,-3260
2017,4,30,2,16560,17274,14126,-3148
2017,4,30,3,15698,16236,12825,-3411
2017,4,30,4,14666,15038,11876,-3162
2017,4,30,5,13990,14067,11211,-2856
2017,4,30,6,13218,13338,10530,-2808
2017,4,30,7,12709,12790,10221,-2569
2017,4,30,8,12383,12481,10490,-1991
2017,4,30,9,12262,12381,10339,-2042
2017,4,30,10,12310,12430,10194,-2236
2017,4,30,11,12381,12533,10153,-2380
2017,4,30,12,12938,13112,10949,-2163
2017,4,30,13,13869,13972,11416,-2556
2017,4,30,14,14686,14703,11892,-2811
2017,4,30,15,15160,15244,12142,-3102
2017,4,30,16,15382,15479,12381,-3098
2017,4,30,17,15473,15580,12612,-2968
2017,4,30,18,15438,15500,12644,-2856
2017,4,30,19,15312,15336,12574,-2762
2017,4,30,20,15235,15334,12615,-2719
2017,4,30,21,15281,15477,12751,-2726
2017,4,30,22,15295,15762,13214,-2548
2017,4,30,23,15327,15960,13321,-2639
2017,5,1,0,15474,16143,13549,-2594
2017,5,1,1,15980,16493,13755,-2738
2017,5,1,2,15558,15952,13754,-2198
2017,5,1,3,14488,14874,12662,-2212
2017,5,1,4,13366,13732,11684,-2048
2017,5,1,5,12700,12982,11223,-1759
2017,5,1,6,12256,12501,11079,-1422
2017,5,1,7,11974,12258,10826,-1432
2017,5,1,8,11867,12175,10764,-1411
2017,5,1,9,12071,12386,10859,-1527
2017,5,1,10,12917,13237,11436,-1801
2017,5,1,11,14326,14789,13135,-1654
2017,5,1,12,15759,16179,14455,-1724
2017,5,1,13,16603,16979,15076,-1903
2017,5,1,14,17197,17337,15401,-1936
2017,5,1,15,17569,17574,15581,-1993
2017,5,1,16,17751,17661,15243,-2418
2017,5,1,17,17851,17635,15304,-2331
2017,5,1,18,17996,17730,15415,-2315
2017,5,1,19,18093,17740,15505,-2235
2017,5,1,20,18207,17868,15612,-2256
2017,5,1,21,18346,18053,15887,-2166
2017,5,1,22,18284,18137,16024,-2113
2017,5,1,23,17932,17942,15860,-2082
2017,5,2,0,17724,17926,15769,-2157
2017,5,2,1,17796,17985,15991,-1994
2017,5,2,2,17228,17174,14970,-2204
2017,5,2,3,15858,15701,13885,-1816
2017,5,2,4,14387,14350,12849,-1501
2017,5,2,5,13150,13426,11655,-1771
2017,5,2,6,12613,12848,11431,-1417
2017,5,2,7,12300,12515,11172,-1343
2017,5,2,8,12193,12431,11212,-1219
2017,5,2,9,12389,12655,11553,-1102
2017,5,2,10,13192,13532,11971,-1561
2017,5,2,11,14574,15136,12945,-2191
2017,5,2,12,15941,16594,14040,-2554
2017,5,2,13,16692,17311,14945,-2366
2017,5,2,14,17212,17884,14905,-2979
2017,5,2,15,17512,18184,15270,-2914
2017,5,2,16,17652,18291,15673,-2618
2017,5,2,17,17690,18236,15463,-2773
2017,5,2,18,17759,18218,15553,-2665
2017,5,2,19,17742,18134,15523,-2611
2017,5,2,20,17735,18113,15524,-2589
2017,5,2,21,17810,18198,15602,-2596
2017,5,2,22,17712,18182,15581,-2601
2017,5,2,23,17385,17923,15504,-2419
2017,5,3,0,17205,17799,15464,-2335
2017,5,3,1,17297,17956,15777,-2179
2017,5,3,2,16762,17207,14924,-2283
2017,5,3,3,15480,15885,13953,-1932
2017,5,3,4,14163,14536,13180,-1356
2017,5,3,5,13185,13496,12624,-872
2017,5,3,6,12638,12886,11999,-887
2017,5,3,7,12301,12546,11964,-582
2017,5,3,8,12173,12392,11776,-616
2017,5,3,9,12331,12537,11780,-757
2017,5,3,10,13071,13386,11882,-1504
2017,5,3,11,14364,14898,13048,-1850
2017,5,3,12,15638,16274,13891,-2383
2017,5,3,13,16282,16913,14408,-2505
2017,5,3,14,16681,17194,14505,-2689
2017,5,3,15,16882,17265,14457,-2808
2017,5,3,16,16943,17269,14731,-2538
2017,5,3,17,16928,17219,14938,-2281
2017,5,3,18,16954,17163,15113,-2050
2017,5,3,19,16914,16958,15118,-1840
2017,5,3,20,16917,16951,15083,-1868
2017,5,3,21,17030,17032,15050,-1982
2017,5,3,22,17003,17085,15058,-2027
2017,5,3,23,16797,16936,14831,-2105
2017,5,4,0,16691,16908,14540,-2368
2017,5,4,1,16921,17297,14693,-2604
2017,5,4,2,16459,16802,14165,-2637
2017,5,4,3,15278,15547,13079,-2468
2017,5,4,4,14023,14236,12051,-2185
2017,5,4,5,13042,13286,11091,-2195
2017,5,4,6,12546,12753,10739,-2014
2017,5,4,7,12260,12470,10339,-2131
2017,5,4,8,12167,12389,10437,-1952
2017,5,4,9,12374,12629,10404,-2225
2017,5,4,10,13163,13468,10863,-2605
2017,5,4,11,14462,14952,11870,-3082
2017,5,4,12,15702,16205,12874,-3331
2017,5,4,13,16279,16711,13298,-3413
2017,5,4,14,16587,16912,13275,-3637
2017,5,4,15,16722,16998,13496,-3502
2017,5,4,16,16735,17021,13867,-3154
2017,5,4,17,16720,16960,13848,-3112
2017,5,4,18,16756,16944,13775,-3169
2017,5,4,19,16731,16889,13812,-3077
2017,5,4,20,16751,16983,13788,-3195
2017,5,4,21,16868,17136,13839,-3297
2017,5,4,22,16901,17273,14018,-3255
2017,5,4,23,16722,17263,14252,-3011
2017,5,5,0,16604,17419,14376,-3043
2017,5,5,1,16816,17584,14570,-3014
2017,5,5,2,16395,16837,13658,-3179
2017,5,5,3,15245,15557,12655,-2902
2017,5,5,4,14016,14269,11807,-2462
2017,5,5,5,12929,13301,11298,-2003
2017,5,5,6,12403,12765,11170,-1595
2017,5,5,7,12106,12460,11211,-1249
2017,5,5,8,11986,12386,11214,-1172
2017,5,5,9,12148,12560,11587,-973
2017,5,5,10,12832,13388,11927,-1461
2017,5,5,11,14086,14975,13001,-1974
2017,5,5,12,15365,16385,13756,-2629
2017,5,5,13,16076,17150,14519,-2631
2017,5,5,14,16485,17595,15095,-2500
2017,5,5,15,16726,18005,15436,-2569
2017,5,5,16,16794,18289,15685,-2604
2017,5,5,17,16768,18334,15600,-2734
2017,5,5,18,16775,18313,15262,-3051
2017,5,5,19,16726,18115,15038,-3077
2017,5,5,20,16728,17916,15099,-2817
2017,5,5,21,16797,17833,15468,-2365
2017,5,5,22,16706,17676,15860,-1816
2017,5,5,23,16433,17441,15424,-2017
2017,5,6,0,16189,17324,15127,-2197
2017,5,6,1,16265,17266,14890,-2376
2017,5,6,2,15893,16681,13996,-2685
2017,5,6,3,14966,15646,12901,-2745
2017,5,6,4,13919,14488,12361,-2127
2017,5,6,5,12878,13528,11600,-1928
2017,5,6,6,12273,12964,10806,-2158
2017,5,6,7,11893,12605,10677,-1928
2017,5,6,8,11692,12358,10104,-2254
2017,5,6,9,11680,12341,10144,-2197
2017,5,6,10,11867,12584,10276,-2308
2017,5,6,11,12117,13036,10505,-2531
2017,5,6,12,12834,13890,11156,-2734
2017,5,6,13,13713,14859,12380,-2479
2017,5,6,14,14321,15468,12915,-2553
2017,5,6,15,14658,15659,13092,-2567
2017,5,6,16,14781,15717,13003,-2714
2017,5,6,17,14759,15708,12866,-2842
2017,5,6,18,14685,15575,12602,-2973
2017,5,6,19,14624,15503,12629,-2874
2017,5,6,20,14624,15464,12680,-2784
2017,5,6,21,14731,15619,12857,-2762
2017,5,6,22,14811,15772,13157,-2615
2017,5,6,23,14814,15801,13167,-2634
2017,5,7,0,14811,15925,13239,-2686
2017,5,7,1,15119,16250,13461,-2789
2017,5,7,2,14973,15836,13053,-2783
2017,5,7,3,14231,15038,12058,-2980
2017,5,7,4,13360,14058,11192,-2866
2017,5,7,5,12612,13232,10579,-2653
2017,5,7,6,12078,12641,10226,-2415
2017,5,7,7,11744,12285,9955,-2330
2017,5,7,8,11574,12094,9811,-2283
2017,5,7,9,11554,12055,9863,-2192
2017,5,7,10,11677,12205,10226,-1979
2017,5,7,11,11761,12435,10459,-1976
2017,5,7,12,12295,13027,10852,-2175
2017,5,7,13,13091,13824,11437,-2387
2017,5,7,14,13835,14519,11941,-2578
2017,5,7,15,14266,14973,12292,-2681
2017,5,7,16,14482,15228,12399,-2829
2017,5,7,17,14570,15321,12415,-2906
2017,5,7,18,14584,15289,12242,-3047
2017,5,7,19,14567,15267,12309,-2958
2017,5,7,20,14620,15360,12518,-2842
2017,5,7,21,14799,15585,12779,-2806
2017,5,7,22,14964,15829,12836,-2993
2017,5,7,23,15027,15950,12932,-3018
2017,5,8,0,15105,16129,13175,-2954
2017,5,8,1,15504,16511,13758,-2753
2017,5,8,2,15301,16015,13048,-2967
2017,5,8,3,14427,14980,11889,-3091
2017,5,8,4,13447,13913,10799,-3114
2017,5,8,5,12856,13168,10321,-2847
2017,5,8,6,12418,12698,10229,-2469
2017,5,8,7,12184,12451,10090,-2361
2017,5,8,8,12136,12404,9974,-2430
2017,5,8,9,12384,12675,10235,-2440
2017,5,8,10,13186,13581,11021,-2560
2017,5,8,11,14513,15114,12377,-2737
2017,5,8,12,15850,16397,13645,-2752
2017,5,8,13,16530,16953,14201,-2752
2017,5,8,14,16904,17204,14161,-3043
2017,5,8,15,17094,17306,14814,-2492
2017,5,8,16,17128,17317,15254,-2063
2017,5,8,17,17088,17280,15249,-2031
2017,5,8,18,17094,17215,15232,-1983
2017,5,8,19,17036,17110,15067,-2043
2017,5,8,20,17027,17105,15354,-1751
2017,5,8,21,17155,17253,15456,-1797
2017,5,8,22,17226,17322,14938,-2384
2017,5,8,23,17103,17245,14765,-2480
2017,5,9,0,16988,17261,14948,-2313
2017,5,9,1,17186,17581,16094,-1487
2017,5,9,2,16722,16991,15117,-1874
2017,5,9,3,15507,15746,13331,-2415
2017,5,9,4,14221,14447,11866,-2581
2017,5,9,5,13229,13500,11095,-2405
2017,5,9,6,12718,12990,10909,-2081
2017,5,9,7,12434,12715,10705,-2010
2017,5,9,8,12355,12617,10538,-2079
2017,5,9,9,12571,12856,10535,-2321
2017,5,9,10,13332,13738,11199,-2539
2017,5,9,11,14670,15221,12424,-2797
2017,5,9,12,15966,16478,13849,-2629
2017,5,9,13,16575,16957,14310,-2647
2017,5,9,14,16841,17125,14132,-2993
2017,5,9,15,16956,17242,14122,-3120
2017,5,9,16,16963,17299,14202,-3097
2017,5,9,17,16913,17280,14609,-2671
2017,5,9,18,16919,17180,14359,-2821
2017,5,9,19,16881,17079,14520,-2559
2017,5,9,20,16891,17069,14486,-2583
2017,5,9,21,17027,17111,14266,-2845
2017,5,9,22,17097,17282,14318,-2964
2017,5,9,23,16962,17218,14436,-2782
2017,5,10,0,16824,17284,14520,-2764
2017,5,10,1,17034,17630,15098,-2532
2017,5,10,2,16594,17050,14270,-2780
2017,5,10,3,15416,15721,12469,-3252
2017,5,10,4,14166,14403,11158,-3245
2017,5,10,5,13148,13443,10652,-2791
2017,5,10,6,12639,12922,10698,-2224
2017,5,10,7,12357,12624,10534,-2090
2017,5,10,8,12273,12560,10423,-2137
2017,5,10,9,12472,12801,10664,-2137
2017,5,10,10,13204,13629,11064,-2565
2017,5,10,11,14504,15148,12363,-2785
2017,5,10,12,15734,16419,13839,-2580
2017,5,10,13,16287,16944,13995,-2949
2017,5,10,14,16516,17034,13843,-3191
2017,5,10,15,16616,17083,13798,-3285
2017,5,10,16,16635,17110,14106,-3004
2017,5,10,17,16597,17080,14277,-2803
2017,5,10,18,16633,17020,14253,-2767
2017,5,10,19,16624,16935,14198,-2737
2017,5,10,20,16663,16928,14329,-2599
2017,5,10,21,16788,16932,14228,-2704
2017,5,10,22,16812,16927,14290,-2637
2017,5,10,23,16609,16833,14313,-2520
2017,5,11,0,16458,16840,14175,-2665
2017,5,11,1,16718,17324,15060,-2264
2017,5,11,2,16343,16827,14268,-2559
2017,5,11,3,15216,15591,12784,-2807
2017,5,11,4,14010,14240,11670,-2570
2017,5,11,5,13066,13358,10970,-2388
2017,5,11,6,12537,12851,10275,-2576
2017,5,11,7,12242,12566,10026,-2540
2017,5,11,8,12150,12493,10120,-2373
2017,5,11,9,12351,12722,10387,-2335
2017,5,11,10,13087,13518,10989,-2529
2017,5,11,11,14386,15002,12289,-2713
2017,5,11,12,15657,16299,13440,-2859
2017,5,11,13,16257,16762,13867,-2895
2017,5,11,14,16540,16904,13724,-3180
2017,5,11,15,16687,16940,14108,-2832
2017,5,11,16,16723,16955,14318,-2637
2017,5,11,17,16708,16912,14426,-2486
2017,5,11,18,16755,16901,14198,-2703
2017,5,11,19,16749,16863,13896,-2967
2017,5,11,20,16775,16810,13893,-2917
2017,5,11,21,16872,16869,13979,-2890
2017,5,11,22,16874,16882,14065,-2817
2017,5,11,23,16669,16814,13938,-2876
2017,5,12,0,16511,16849,13847,-3002
2017,5,12,1,16733,17243,14193,-3050
2017,5,12,2,16345,16770,13687,-3083
2017,5,12,3,15208,15558,12491,-3067
2017,5,12,4,13987,14277,11091,-3186
2017,5,12,5,12988,13341,10555,-2786
2017,5,12,6,12453,12779,10486,-2293
2017,5,12,7,12149,12440,10337,-2103
2017,5,12,8,12038,12370,10149,-2221
2017,5,12,9,12209,12650,10542,-2108
2017,5,12,10,12874,13443,10835,-2608
2017,5,12,11,14132,14872,11888,-2984
2017,5,12,12,15405,16170,13102,-3068
2017,5,12,13,16066,16678,13348,-3330
2017,5,12,14,16378,16928,13364,-3564
2017,5,12,15,16564,17009,13423,-3586
2017,5,12,16,16614,17007,13272,-3735
2017,5,12,17,16577,16915,13461,-3454
2017,5,12,18,16596,16882,13523,-3359
2017,5,12,19,16575,16782,13763,-3019
2017,5,12,20,16571,16729,13760,-2969
2017,5,12,21,16616,16822,13646,-3176
2017,5,12,22,16541,16763,13536,-3227
2017,5,12,23,16279,16574,13468,-3106
2017,5,13,0,16037,16587,13508,-3079
2017,5,13,1,16178,16820,13591,-3229
2017,5,13,2,15866,16342,13111,-3231
2017,5,13,3,14950,15370,11720,-3650
2017,5,13,4,13903,14214,10998,-3216
2017,5,13,5,12918,13245,10175,-3070
2017,5,13,6,12340,12637,9688,-2949
2017,5,13,7,11982,12278,9549,-2729
2017,5,13,8,11795,12071,9296,-2775
2017,5,13,9,11803,12082,9435,-2647
2017,5,13,10,11983,12340,9532,-2808
2017,5,13,11,12310,12764,9647,-3117
2017,5,13,12,13054,13633,10428,-3205
2017,5,13,13,13938,14688,11202,-3486
2017,5,13,14,14547,15492,12099,-3393
2017,5,13,15,14942,15958,12503,-3455
2017,5,13,16,15076,16109,12646,-3463
2017,5,13,17,15075,16092,12757,-3335
2017,5,13,18,14999,15992,12512,-3480
2017,5,13,19,14933,15891,12455,-3436
2017,5,13,20,14936,15835,12402,-3433
2017,5,13,21,15035,15884,12421,-3463
2017,5,13,22,15098,15996,12435,-3561
2017,5,13,23,15099,16012,12462,-3550
2017,5,14,0,15050,16075,12486,-3589
2017,5,14,1,15368,16314,13114,-3200
2017,5,14,2,15213,15970,12378,-3592
2017,5,14,3,14476,15187,11446,-3741
2017,5,14,4,13607,14217,10659,-3558
2017,5,14,5,12697,13391,10255,-3136
2017,5,14,6,12160,12819,9794,-3025
2017,5,14,7,11812,12392,9460,-2932
2017,5,14,8,11627,12184,9278,-2906
2017,5,14,9,11621,12132,9410,-2722
2017,5,14,10,11739,12249,9424,-2825
2017,5,14,11,11926,12509,9409,-3100
2017,5,14,12,12503,13138,10127,-3011
2017,5,14,13,13297,13916,10634,-3282
2017,5,14,14,13912,14428,11019,-3409
2017,5,14,15,14278,14625,11147,-3478
2017,5,14,16,14434,14709,11364,-3345
2017,5,14,17,14488,14692,11488,-3204
2017,5,14,18,14467,14628,11532,-3096
2017,5,14,19,14429,14625,11673,-2952
2017,5,14,20,14468,14751,11867,-2884
2017,5,14,21,14637,14852,11887,-2965
2017,5,14,22,14804,15108,12231,-2877
2017,5,14,23,14872,15206,12192,-3014
2017,5,15,0,14915,15420,12424,-2996
2017,5,15,1,15364,15979,13013,-2966
2017,5,15,2,15177,15721,12688,-3033
2017,5,15,3,14283,14780,11881,-2899
2017,5,15,4,13296,13722,10741,-2981
2017,5,15,5,12498,12903,9794,-3109
2017,5,15,6,12049,12406,9397,-3009
2017,5,15,7,11804,12192,9475,-2717
2017,5,15,8,11737,12136,9984,-2152
2017,5,15,9,11950,12424,10357,-2067
2017,5,15,10,12668,13181,10831,-2350
2017,5,15,11,13949,14742,12522,-2220
2017,5,15,12,15323,16112,13606,-2506
2017,5,15,13,16062,16773,14146,-2627
2017,5,15,14,16441,17147,14573,-2574
2017,5,15,15,16693,17286,14261,-3025
2017,5,15,16,16783,17297,14294,-3003
2017,5,15,17,16782,17250,14683,-2567
2017,5,15,18,16814,17257,14792,-2465
2017,5,15,19,16787,17119,14708,-2411
2017,5,15,20,16794,17039,14789,-2250
2017,5,15,21,16875,17155,14898,-2257
2017,5,15,22,16846,17326,15127,-2199
2017,5,15,23,16627,17180,15194,-1986
2017,5,16,0,16482,17091,15040,-2051
2017,5,16,1,16710,17362,15144,-2218
2017,5,16,2,16266,16934,14689,-2245
2017,5,16,3,15081,15620,13446,-2174
2017,5,16,4,13821,14272,12189,-2083
2017,5,16,5,12816,13245,10893,-2352
2017,5,16,6,12264,12650,10569,-2081
2017,5,16,7,11946,12320,10275,-2045
2017,5,16,8,11831,12253,10327,-1926
2017,5,16,9,12004,12463,10339,-2124
2017,5,16,10,12666,13229,10702,-2527
2017,5,16,11,13924,14705,12047,-2658
2017,5,16,12,15232,16081,13540,-2541
2017,5,16,13,15920,16742,13956,-2786
2017,5,16,14,16269,17111,14534,-2577
2017,5,16,15,16551,17319,14546,-2773
2017,5,16,16,16755,17440,14411,-3029
2017,5,16,17,16889,17549,14545,-3004
2017,5,16,18,17086,17783,14787,-2996
2017,5,16,19,17240,17920,14906,-3014
2017,5,16,20,17387,18013,15219,-2794
2017,5,16,21,17536,18265,15350,-2915
2017,5,16,22,17456,18337,15475,-2862
2017,5,16,23,17142,18034,15076,-2958
2017,5,17,0,16926,17810,15145,-2665
2017,5,17,1,17104,17983,15554,-2429
2017,5,17,2,16696,17515,14897,-2618
2017,5,17,3,15482,16145,13554,-2591
2017,5,17,4,14217,14668,11822,-2846
2017,5,17,5,13538,13595,11361,-2234
2017,5,17,6,12856,12949,11037,-1912
2017,5,17,7,12430,12583,10635,-1948
2017,5,17,8,12260,12440,10828,-1612
2017,5,17,9,12440,12600,11127,-1473
2017,5,17,10,13262,13350,11412,-1938
2017,5,17,11,14849,14868,12488,-2380
2017,5,17,12,16545,16452,13952,-2500
2017,5,17,13,17535,17381,14388,-2993
2017,5,17,14,18105,18085,15074,-3011
2017,5,17,15,18612,18689,15908,-2781
2017,5,17,16,19003,19282,16358,-2924
2017,5,17,17,19300,19866,17048,-2818
2017,5,17,18,19681,20514,17789,-2725
2017,5,17,19,19978,21029,18472,-2557
2017,5,17,20,20282,21585,19072,-2513
2017,5,17,21,20544,22048,19686,-2362
2017,5,17,22,20430,22260,20202,-2058
2017,5,17,23,19934,21936,19935,-2001
2017,5,18,0,19589,21541,19566,-1975
2017,5,18,1,19775,21532,19853,-1679
2017,5,18,2,19329,21047,18844,-2203
2017,5,18,3,17862,19437,16560,-2877
2017,5,18,4,16292,17727,15174,-2553
2017,5,18,5,15465,16432,14190,-2242
2017,5,18,6,14644,15555,13211,-2344
2017,5,18,7,14120,14979,12706,-2273
2017,5,18,8,13882,14675,12584,-2091
2017,5,18,9,14042,14684,12508,-2176
2017,5,18,10,14927,15345,13164,-2181
2017,5,18,11,16691,16968,14714,-2254
2017,5,18,12,18604,18808,16008,-2800
2017,5,18,13,19796,20256,17872,-2384
2017,5,18,14,20583,21446,18878,-2568
2017,5,18,15,21261,22518,19783,-2735
2017,5,18,16,21805,23317,21065,-2252
2017,5,18,17,22245,23803,21208,-2595
2017,5,18,18,22686,24352,21623,-2729
2017,5,18,19,22954,24838,22234,-2604
2017,5,18,20,23160,25303,23202,-2101
2017,5,18,21,23270,25578,23521,-2057
2017,5,18,22,22990,25467,24199,-1268
2017,5,18,23,22352,24777,23535,-1242
2017,5,19,0,21876,24050,22563,-1487
2017,5,19,1,21995,23549,22099,-1450
2017,5,19,2,21453,22935,21857,-1078
2017,5,19,3,19828,21281,19599,-1682
2017,5,19,4,18002,19392,17289,-2103
2017,5,19,5,16420,17816,15324,-2492
2017,5,19,6,15430,16800,15352,-1448
2017,5,19,7,14819,16208,14462,-1746
2017,5,19,8,14481,15852,13944,-1908
2017,5,19,9,14512,15846,13484,-2362
2017,5,19,10,15119,16425,13882,-2543
2017,5,19,11,16496,17974,15341,-2633
2017,5,19,12,18051,19766,16871,-2895
2017,5,19,13,19063,21065,18383,-2682
2017,5,19,14,19713,22033,19587,-2446
2017,5,19,15,20230,22806,20020,-2786
2017,5,19,16,20601,23334,20453,-2881
2017,5,19,17,20901,23669,20974,-2695
2017,5,19,18,21202,24013,21411,-2602
2017,5,19,19,21355,24230,22084,-2146
2017,5,19,20,21423,24305,22170,-2135
2017,5,19,21,21362,24200,22027,-2173
2017,5,19,22,20986,23999,21537,-2462
2017,5,19,23,20297,23416,20985,-2431
2017,5,20,0,19685,22610,19942,-2668
2017,5,20,1,19638,22138,19280,-2858
2017,5,20,2,19180,21165,17589,-3576
2017,5,20,3,18012,19495,15837,-3658
2017,5,20,4,16587,17594,14285,-3309
2017,5,20,5,15378,16024,12547,-3477
2017,5,20,6,14413,14993,11511,-3482
2017,5,20,7,13819,14303,10700,-3603
2017,5,20,8,13445,13861,10092,-3769
2017,5,20,9,13314,13699,10559,-3140
2017,5,20,10,13361,13697,10694,-3003
2017,5,20,11,13620,13959,11042,-2917
2017,5,20,12,14390,14726,11839,-2887
2017,5,20,13,15301,15537,12274,-3263
2017,5,20,14,15811,15964,12335,-3629
2017,5,20,15,16124,16160,12636,-3524
2017,5,20,16,16238,16305,13014,-3291
2017,5,20,17,16258,16250,12461,-3789
2017,5,20,18,16237,16084,12305,-3779
2017,5,20,19,16209,15957,12188,-3769
2017,5,20,20,16195,15905,12312,-3593
2017,5,20,21,16227,16011,12384,-3627
2017,5,20,22,16155,16147,12789,-3358
2017,5,20,23,15975,16148,12781,-3367
2017,5,21,0,15802,16019,12695,-3324
2017,5,21,1,16062,16258,12787,-3471
2017,5,21,2,15842,16142,12620,-3522
2017,5,21,3,15002,15304,11829,-3475
2017,5,21,4,14044,14331,11113,-3218
2017,5,21,5,13173,13463,10313,-3150
2017,5,21,6,12620,12836,9835,-3001
2017,5,21,7,12272,12433,9883,-2550
2017,5,21,8,12086,12240,9653,-2587
2017,5,21,9,12064,12169,9697,-2472
2017,5,21,10,12117,12173,9844,-2329
2017,5,21,11,12254,12386,10421,-1965
2017,5,21,12,12855,13000,10721,-2279
2017,5,21,13,13640,13856,10962,-2894
2017,5,21,14,14206,14543,11409,-3134
2017,5,21,15,14558,14986,11877,-3109
2017,5,21,16,14747,15272,12229,-3043
2017,5,21,17,14839,15372,12592,-2780
2017,5,21,18,14870,15329,12656,-2673
2017,5,21,19,14872,15329,12740,-2589
2017,5,21,20,14951,15461,12944,-2517
2017,5,21,21,15134,15753,13250,-2503
2017,5,21,22,15291,16081,13728,-2353
2017,5,21,23,15358,16205,13643,-2562
2017,5,22,0,15447,16209,13683,-2526
2017,5,22,1,15899,16503,14209,-2294
2017,5,22,2,15705,16105,13976,-2129
2017,5,22,3,14802,15024,13175,-1849
2017,5,22,4,13796,13925,12280,-1645
2017,5,22,5,12565,13105,11452,-1653
2017,5,22,6,12085,12623,11567,-1056
2017,5,22,7,11831,12352,11338,-1014
2017,5,22,8,11754,12274,11237,-1037
2017,5,22,9,11958,12494,11414,-1080
2017,5,22,10,12636,13337,11578,-1759
2017,5,22,11,13991,14836,12786,-2050
2017,5,22,12,15387,16357,14241,-2116
2017,5,22,13,16149,17240,14963,-2277
2017,5,22,14,16510,17739,15420,-2319
2017,5,22,15,16805,18082,15417,-2665
2017,5,22,16,16946,18275,15325,-2950
2017,5,22,17,16995,18307,14992,-3315
2017,5,22,18,17071,18318,15018,-3300
2017,5,22,19,17064,18298,15155,-3143
2017,5,22,20,17072,18226,15263,-2963
2017,5,22,21,17134,18218,15293,-2925
2017,5,22,22,17071,18239,15377,-2862
2017,5,22,23,16874,18049,15277,-2772
2017,5,23,0,16758,17793,15288,-2505
2017,5,23,1,17004,17682,15124,-2558
2017,5,23,2,16575,17114,14582,-2532
2017,5,23,3,15379,15812,13479,-2333
2017,5,23,4,14110,14509,12252,-2257
2017,5,23,5,13038,13544,11674,-1870
2017,5,23,6,12502,12959,11032,-1927
2017,5,23,7,12189,12630,10914,-1716
2017,5,23,8,12083,12525,10935,-1590
2017,5,23,9,12261,12727,11218,-1509
2017,5,23,10,12926,13435,11667,-1768
2017,5,23,11,14314,14911,12917,-1994
2017,5,23,12,15671,16307,13770,-2537
2017,5,23,13,16364,17030,13994,-3036
2017,5,23,14,16680,17418,14016,-3402
2017,5,23,15,16953,17649,14055,-3594
2017,5,23,16,17135,17771,14188,-3583
2017,5,23,17,17224,17774,14314,-3460
2017,5,23,18,17372,17874,14586,-3288
2017,5,23,19,17459,17838,14466,-3372
2017,5,23,20,17505,17921,14634,-3287
2017,5,23,21,17554,18041,14781,-3260
2017,5,23,22,17402,18032,14653,-3379
2017,5,23,23,17078,17758,14624,-3134
2017,5,24,0,16921,17609,14687,-2922
2017,5,24,1,17197,17799,15160,-2639
2017,5,24,2,16757,17390,14526,-2864
2017,5,24,3,15513,16075,13303,-2772
2017,5,24,4,14226,14661,12281,-2380
2017,5,24,5,13313,13583,11177,-2406
2017,5,24,6,12696,12985,11262,-1723
2017,5,24,7,12325,12647,11115,-1532
2017,5,24,8,12172,12479,10960,-1519
2017,5,24,9,12321,12667,11166,-1501
2017,5,24,10,12930,13403,11513,-1890
2017,5,24,11,14283,14885,12608,-2277
2017,5,24,12,15749,16305,13552,-2753
2017,5,24,13,16765,17097,13832,-3265
2017,5,24,14,17732,17480,13992,-3488
2017,5,24,15,18050,17823,14261,-3562
2017,5,24,16,18138,17980,14421,-3559
2017,5,24,17,18091,18052,14308,-3744
2017,5,24,18,18138,18129,14849,-3280
2017,5,24,19,18178,18163,14925,-3238
2017,5,24,20,18314,18241,15139,-3102
2017,5,24,21,18537,18315,15372,-2943
2017,5,24,22,18554,18328,15016,-3312
2017,5,24,23,18170,18034,14612,-3422
2017,5,25,0,17748,17763,14444,-3319
2017,5,25,1,17461,17922,14620,-3302
2017,5,25,2,17274,17502,14226,-3276
2017,5,25,3,16181,16176,13335,-2841
2017,5,25,4,14869,14774,12694,-2080
2017,5,25,5,13216,13714,11795,-1919
2017,5,25,6,12566,13104,11430,-1674
2017,5,25,7,12210,12720,11409,-1311
2017,5,25,8,12076,12551,11401,-1150
2017,5,25,9,12240,12685,11033,-1652
2017,5,25,10,12878,13411,11268,-2143
2017,5,25,11,14282,14851,11968,-2883
2017,5,25,12,15764,16344,13500,-2844
2017,5,25,13,16678,17178,14012,-3166
2017,5,25,14,17372,17746,14403,-3343
2017,5,25,15,17491,18088,14808,-3280
2017,5,25,16,17393,18183,15463,-2720
2017,5,25,17,17198,18096,15242,-2854
2017,5,25,18,17119,18046,15125,-2921
2017,5,25,19,17020,17876,15239,-2637
2017,5,25,20,17021,17839,15025,-2814
2017,5,25,21,17183,17893,15152,-2741
2017,5,25,22,17249,17921,15160,-2761
2017,5,25,23,17081,17703,15188,-2515
2017,5,26,0,16875,17599,15100,-2499
2017,5,26,1,16818,17558,14885,-2673
2017,5,26,2,16693,17076,14238,-2838
2017,5,26,3,15709,15888,12974,-2914
2017,5,26,4,14540,14601,11978,-2623
2017,5,26,5,13340,13657,11571,-2086
2017,5,26,6,12681,13032,11283,-1749
2017,5,26,7,12291,12670,11376,-1294
2017,5,26,8,12139,12522,11390,-1132
2017,5,26,9,12293,12654,11587,-1067
2017,5,26,10,12926,13367,11552,-1815
2017,5,26,11,14357,14657,12097,-2560
2017,5,26,12,15821,16074,13321,-2753
2017,5,26,13,16760,16954,14265,-2689
2017,5,26,14,17451,17473,14617,-2856
2017,5,26,15,17652,17829,14653,-3176
2017,5,26,16,17668,18071,14842,-3229
2017,5,26,17,17547,18129,15047,-3082
2017,5,26,18,17534,18250,15206,-3044
2017,5,26,19,17535,18126,15042,-3084
2017,5,26,20,17604,17945,14827,-3118
2017,5,26,21,17761,17984,14814,-3170
2017,5,26,22,17744,17990,14817,-3173
2017,5,26,23,17353,17743,14659,-3084
2017,5,27,0,16982,17489,14243,-3246
2017,5,27,1,16839,17468,14165,-3303
2017,5,27,2,16834,17099,13756,-3343
2017,5,27,3,16011,16034,13030,-3004
2017,5,27,4,14890,14795,12266,-2529
2017,5,27,5,13218,13774,11622,-2152
2017,5,27,6,12529,13093,11532,-1561
2017,5,27,7,12123,12658,11336,-1322
2017,5,27,8,11898,12426,11198,-1228
2017,5,27,9,11874,12332,11340,-992
2017,5,27,10,11972,12350,11222,-1128
2017,5,27,11,12353,12758,11829,-929
2017,5,27,12,13260,13574,12098,-1476
2017,5,27,13,14359,14509,12267,-2242
2017,5,27,14,15687,15229,12979,-2250
2017,5,27,15,16029,15758,13455,-2303
2017,5,27,16,16036,16016,13651,-2365
2017,5,27,17,15847,16114,13679,-2435
2017,5,27,18,15576,16075,13614,-2461
2017,5,27,19,15370,15963,13351,-2612
2017,5,27,20,15285,15900,13316,-2584
2017,5,27,21,15426,15932,13388,-2544
2017,5,27,22,15588,15989,13464,-2525
2017,5,27,23,15610,16052,13568,-2484
2017,5,28,0,15503,16010,13414,-2596
2017,5,28,1,15465,16171,13520,-2651
2017,5,28,2,15581,16090,13502,-2588
2017,5,28,3,14978,15325,12963,-2362
2017,5,28,4,14178,14406,12321,-2085
2017,5,28,5,13358,13515,11324,-2191
2017,5,28,6,12708,12883,11125,-1758
2017,5,28,7,12265,12457,11154,-1303
2017,5,28,8,12008,12226,11004,-1222
2017,5,28,9,11904,12150,11270,-880
2017,5,28,10,11780,12063,10948,-1115
2017,5,28,11,11757,12231,10829,-1402
2017,5,28,12,12249,12870,11580,-1290
2017,5,28,13,13233,13757,11911,-1846
2017,5,28,14,14806,14550,12546,-2004
2017,5,28,15,15150,15199,13064,-2135
2017,5,28,16,15190,15627,13336,-2291
2017,5,28,17,15062,15854,13659,-2195
2017,5,28,18,14833,15911,13673,-2238
2017,5,28,19,14633,15881,13639,-2242
2017,5,28,20,14574,15907,13591,-2316
2017,5,28,21,14798,15971,13537,-2434
2017,5,28,22,15059,16008,13428,-2580
2017,5,28,23,15176,15928,13493,-2435
2017,5,29,0,15249,15839,13435,-2404
2017,5,29,1,15428,16072,13882,-2190
2017,5,29,2,15477,15987,13932,-2055
2017,5,29,3,14771,15242,13431,-1811
2017,5,29,4,13895,14156,12641,-1515
2017,5,29,5,13023,13354,12141,-1213
2017,5,29,6,12431,12792,11692,-1100
2017,5,29,7,12086,12408,11169,-1239
2017,5,29,8,11893,12220,11206,-1014
2017,5,29,9,11907,12216,11155,-1061
2017,5,29,10,12041,12369,11206,-1163
2017,5,29,11,12378,12665,11477,-1188
2017,5,29,12,12959,13255,11699,-1556
2017,5,29,13,13782,14180,12240,-1940
2017,5,29,14,15197,15076,13053,-2023
2017,5,29,15,15422,15747,13647,-2100
2017,5,29,16,15421,16118,14035,-2083
2017,5,29,17,15241,16254,14133,-2121
2017,5,29,18,14924,16175,13942,-2233
2017,5,29,19,14603,16076,13933,-2143
2017,5,29,20,14378,16027,13781,-2246
2017,5,29,21,14446,16204,14015,-2189
2017,5,29,22,14634,16440,14100,-2340
2017,5,29,23,14787,16461,14167,-2294
2017,5,30,0,14949,16454,13972,-2482
2017,5,30,1,15245,16563,14007,-2556
2017,5,30,2,15236,16245,13825,-2420
2017,5,30,3,14386,15147,13067,-2080
2017,5,30,4,13484,13978,12562,-1416
2017,5,30,5,12598,13128,11823,-1305
2017,5,30,6,12103,12647,12034,-613
2017,5,30,7,11798,12342,11603,-739
2017,5,30,8,11696,12250,11812,-438
2017,5,30,9,11883,12414,11910,-504
2017,5,30,10,12504,13162,12094,-1068
2017,5,30,11,13916,14657,12687,-1970
2017,5,30,12,15466,16226,13867,-2359
2017,5,30,13,16523,17013,14290,-2723
2017,5,30,14,17721,17510,14679,-2831
2017,5,30,15,17750,17850,14995,-2855
2017,5,30,16,17481,18006,15217,-2789
2017,5,30,17,17096,18028,15193,-2835
2017,5,30,18,16840,18088,15131,-2957
2017,5,30,19,16648,17993,14953,-3040
2017,5,30,20,16664,17923,15086,-2837
2017,5,30,21,16932,17996,15256,-2740
2017,5,30,22,17163,18022,15424,-2598
2017,5,30,23,17113,17948,15453,-2495
2017,5,31,0,17046,17772,15396,-2376
2017,5,31,1,17029,17642,15159,-2483
2017,5,31,2,16806,17135,14567,-2568
2017,5,31,3,15752,15881,13584,-2297
2017,5,31,4,14594,14515,12419,-2096
2017,5,31,5,13257,13551,11418,-2133
2017,5,31,6,12575,13017,11133,-1884
2017,5,31,7,12176,12682,11331,-1351
2017,5,31,8,12020,12520,10944,-1576
2017,5,31,9,12182,12669,11182,-1487
2017,5,31,10,12795,13388,11645,-1743
2017,5,31,11,14252,14832,12687,-2145
2017,5,31,12,15821,16301,13927,-2374
2017,5,31,13,16932,17167,14471,-2696
2017,5,31,14,18156,17643,14867,-2776
2017,5,31,15,18368,17917,15405,-2512
2017,5,31,16,18336,18022,15432,-2590
2017,5,31,17,18151,18160,15461,-2699
2017,5,31,18,18068,18368,15680,-2688
2017,5,31,19,18019,18480,15554,-2926
2017,5,31,20,18124,18698,15801,-2897
2017,5,31,21,18336,19020,15958,-3062
2017,5,31,22,18402,19136,16221,-2915
2017,5,31,23,18130,18835,16152,-2683
2017,6,1,0,17837,18377,15837,-2540
2017,6,1,1,17718,18189,15643,-2546
2017,6,1,2,17585,17831,15036,-2795
2017,6,1,3,16542,16557,13849,-2708
2017,6,1,4,15252,15095,12650,-2445
2017,6,1,5,13518,13999,12086,-1913
2017,6,1,6,12877,13310,11631,-1679
2017,6,1,7,12524,12887,11425,-1462
2017,6,1,8,12385,12711,11273,-1438
2017,6,1,9,12544,12834,11146,-1688
2017,6,1,10,13151,13504,11712,-1792
2017,6,1,11,14503,15043,12877,-2166
2017,6,1,12,16039,16492,14279,-2213
2017,6,1,13,17090,17384,14982,-2402
2017,6,1,14,18109,17946,15445,-2501
2017,6,1,15,18380,18354,15758,-2596
2017,6,1,16,18392,18729,16087,-2642
2017,6,1,17,18275,18985,16230,-2755
2017,6,1,18,18252,19184,16462,-2722
2017,6,1,19,18232,19187,16366,-2821
2017,6,1,20,18334,19323,16830,-2493
2017,6,1,21,18576,19451,16544,-2907
2017,6,1,22,18625,19489,16664,-2825
2017,6,1,23,18290,19113,16332,-2781
2017,6,2,0,17913,18624,15745,-2879
2017,6,2,1,17684,18501,15917,-2584
2017,6,2,2,17562,18099,15188,-2911
2017,6,2,3,16561,16795,14153,-2642
2017,6,2,4,15326,15355,12914,-2441
2017,6,2,5,13812,14215,11852,-2363
2017,6,2,6,13080,13450,11197,-2253
2017,6,2,7,12657,12977,10959,-2018
2017,6,2,8,12480,12718,10750,-1968
2017,6,2,9,12621,12806,10817,-1989
2017,6,2,10,13225,13397,11060,-2337
2017,6,2,11,14567,14874,12052,-2822
2017,6,2,12,16141,16277,13061,-3216
2017,6,2,13,17199,17189,14066,-3123
2017,6,2,14,18075,17700,14440,-3260
2017,6,2,15,18323,17995,14615,-3380
2017,6,2,16,18306,18225,15079,-3146
2017,6,2,17,18148,18270,14998,-3272
2017,6,2,18,18070,18474,15120,-3354
2017,6,2,19,17985,18480,15175,-3305
2017,6,2,20,17992,18492,15351,-3141
2017,6,2,21,18075,18450,15330,-3120
2017,6,2,22,17999,18357,15479,-2878
2017,6,2,23,17587,17985,15122,-2863
2017,6,3,0,17107,17538,14460,-3078
2017,6,3,1,16802,17282,14118,-3164
2017,6,3,2,16729,17089,14016,-3073
2017,6,3,3,15861,16080,13517,-2563
2017,6,3,4,14736,14897,12846,-2051
2017,6,3,5,13482,13861,11892,-1969
2017,6,3,6,12786,13136,11398,-1738
2017,6,3,7,12342,12681,10751,-1930
2017,6,3,8,12087,12471,10639,-1832
2017,6,3,9,12036,12422,10770,-1652
2017,6,3,10,12089,12486,10977,-1509
2017,6,3,11,12465,12976,11450,-1526
2017,6,3,12,13323,13886,12289,-1597
2017,6,3,13,14327,14706,12615,-2091
2017,6,3,14,15347,15284,13102,-2182
2017,6,3,15,15711,15559,13278,-2281
2017,6,3,16,15789,15775,13498,-2277
2017,6,3,17,15683,15840,13580,-2260
2017,6,3,18,15483,15749,13624,-2125
2017,6,3,19,15356,15745,13501,-2244
2017,6,3,20,15370,15825,13407,-2418
2017,6,3,21,15581,16060,13521,-2539
2017,6,3,22,15740,16230,13839,-2391
2017,6,3,23,15714,16295,13725,-2570
2017,6,4,0,15496,16205,13365,-2840
2017,6,4,1,15353,16227,13247,-2980
2017,6,4,2,15491,16205,13124,-3081
2017,6,4,3,14880,15472,12675,-2797
2017,6,4,4,14056,14455,12310,-2145
2017,6,4,5,13132,13570,11683,-1887
2017,6,4,6,12498,12929,11392,-1537
2017,6,4,7,12086,12474,11199,-1275
2017,6,4,8,11855,12209,10877,-1332
2017,6,4,9,11790,12128,10916,-1212
2017,6,4,10,11758,12078,10901,-1177
2017,6,4,11,11932,12313,10919,-1394
2017,6,4,12,12648,12972,11612,-1360
2017,6,4,13,13616,13956,12020,-1936
2017,6,4,14,14833,14851,12495,-2356
2017,6,4,15,15284,15518,12988,-2530
2017,6,4,16,15489,15936,13162,-2774
2017,6,4,17,15508,16065,13196,-2869
2017,6,4,18,15426,16204,13389,-2815
2017,6,4,19,15313,16142,13550,-2592
2017,6,4,20,15304,16122,13605,-2517
2017,6,4,21,15487,16238,13601,-2637
2017,6,4,22,15668,16443,13856,-2587
2017,6,4,23,15713,16511,13880,-2631
2017,6,5,0,15692,16531,13836,-2695
2017,6,5,1,15843,16609,13850,-2759
2017,6,5,2,15859,16335,13697,-2638
2017,6,5,3,15081,15382,13051,-2331
2017,6,5,4,14154,14271,12384,-1887
2017,6,5,5,13544,13412,11540,-1872
2017,6,5,6,13000,12862,11254,-1608
2017,6,5,7,12660,12593,11183,-1410
2017,6,5,8,12534,12506,11292,-1214
2017,6,5,9,12725,12704,11481,-1223
2017,6,5,10,13381,13490,11846,-1644
2017,6,5,11,14839,15000,12752,-2248
2017,6,5,12,16420,16523,13934,-2589
2017,6,5,13,17537,17504,14617,-2887
2017,6,5,14,18614,18068,15370,-2698
2017,6,5,15,18940,18403,15331,-3072
2017,6,5,16,19016,18718,15741,-2977
2017,6,5,17,18974,18772,15924,-2848
2017,6,5,18,18979,18816,16079,-2737
2017,6,5,19,18960,18760,16007,-2753
2017,6,5,20,19002,18769,15983,-2786
2017,6,5,21,19142,18853,15809,-3044
2017,6,5,22,19108,18861,15944,-2917
2017,6,5,23,18775,18619,16000,-2619
2017,6,6,0,18491,18333,15590,-2743
2017,6,6,1,18373,18091,15390,-2701
2017,6,6,2,18158,17412,14607,-2805
2017,6,6,3,17005,16074,13307,-2767
2017,6,6,4,15606,14735,12567,-2168
2017,6,6,5,13723,13754,11888,-1866
2017,6,6,6,13013,13151,11407,-1744
2017,6,6,7,12627,12779,11360,-1419
2017,6,6,8,12477,12638,11413,-1225
2017,6,6,9,12645,12820,11444,-1376
2017,6,6,10,13276,13511,11741,-1770
2017,6,6,11,14747,15013,12891,-2122
2017,6,6,12,16260,16505,13884,-2621
2017,6,6,13,17180,17268,14735,-2533
2017,6,6,14,17956,17701,15108,-2593
2017,6,6,15,18022,18001,15170,-2831
2017,6,6,16,17864,18193,15450,-2743
2017,6,6,17,17589,18128,15281,-2847
2017,6,6,18,17382,18032,14983,-3049
2017,6,6,19,17155,17841,14800,-3041
2017,6,6,20,17037,17763,14933,-2830
2017,6,6,21,17127,17856,15158,-2698
2017,6,6,22,17181,17889,15211,-2678
2017,6,6,23,17025,17692,15084,-2608
2017,6,7,0,16889,17468,14924,-2544
2017,6,7,1,16901,17415,14861,-2554
2017,6,7,2,16720,16866,14068,-2798
2017,6,7,3,15659,15640,13406,-2234
2017,6,7,4,14422,14313,12602,-1711
2017,6,7,5,13168,13380,12023,-1357
2017,6,7,6,12495,12834,11470,-1364
2017,6,7,7,12121,12516,11305,-1211
2017,6,7,8,11981,12400,11316,-1084
2017,6,7,9,12171,12581,11382,-1199
2017,6,7,10,12840,13218,11571,-1647
2017,6,7,11,14369,14670,12236,-2434
2017,6,7,12,15863,16016,13816,-2200
2017,6,7,13,16701,16668,14317,-2351
2017,6,7,14,17235,17019,14293,-2726
2017,6,7,15,17366,17238,14138,-3100
2017,6,7,16,17345,17379,14121,-3258
2017,6,7,17,17240,17364,14256,-3108
2017,6,7,18,17217,17512,14423,-3089
2017,6,7,19,17191,17526,14491,-3035
2017,6,7,20,17277,17609,14496,-3113
2017,6,7,21,17471,17779,14481,-3298
2017,6,7,22,17575,17829,14661,-3168
2017,6,7,23,17372,17683,14756,-2927
2017,6,8,0,17099,17451,14406,-3045
2017,6,8,1,16987,17435,14378,-3057
2017,6,8,2,16835,17268,14064,-3204
2017,6,8,3,15740,16064,12999,-3065
2017,6,8,4,14445,14628,12037,-2591
2017,6,8,5,13282,13520,11239,-2281
2017,6,8,6,12607,12869,10866,-2003
2017,6,8,7,12224,12496,10786,-1710
2017,6,8,8,12088,12364,10769,-1595
2017,6,8,9,12278,12505,10955,-1550
2017,6,8,10,12907,13114,11203,-1911
2017,6,8,11,14271,14570,12216,-2354
2017,6,8,12,15861,16023,13843,-2180
2017,6,8,13,16907,16864,14730,-2134
2017,6,8,14,17693,17358,14989,-2369
2017,6,8,15,17994,17823,15523,-2300
2017,6,8,16,18088,18136,15687,-2449
2017,6,8,17,18070,18289,15595,-2694
2017,6,8,18,18133,18422,15438,-2984
2017,6,8,19,18173,18412,15403,-3009
2017,6,8,20,18277,18437,15606,-2831
2017,6,8,21,18452,18427,15614,-2813
2017,6,8,22,18439,18332,15521,-2811
2017,6,8,23,18080,18008,15373,-2635
2017,6,9,0,17718,17766,15077,-2689
2017,6,9,1,17554,17685,15423,-2262
2017,6,9,2,17345,17351,15025,-2326
2017,6,9,3,16203,16093,13695,-2398
2017,6,9,4,14862,14675,12755,-1920
2017,6,9,5,13469,13568,12208,-1360
2017,6,9,6,12783,12948,11875,-1073
2017,6,9,7,12391,12538,11585,-953
2017,6,9,8,12229,12386,11344,-1042
2017,6,9,9,12382,12517,11541,-976
2017,6,9,10,12968,13077,12017,-1060
2017,6,9,11,14365,14557,12626,-1931
2017,6,9,12,15921,16058,13829,-2229
2017,6,9,13,17038,16952,14765,-2187
2017,6,9,14,17924,17538,15154,-2384
2017,6,9,15,18313,17978,15399,-2579
2017,6,9,16,18493,18297,15748,-2549
2017,6,9,17,18549,18549,16145,-2404
2017,6,9,18,18697,18893,16543,-2350
2017,6,9,19,18831,19126,16972,-2154
2017,6,9,20,19025,19339,17241,-2098
2017,6,9,21,19245,19606,17374,-2232
2017,6,9,22,19171,19679,17296,-2383
2017,6,9,23,18703,19364,16890,-2474
2017,6,10,0,18174,18880,16211,-2669
2017,6,10,1,17819,18539,15885,-2654
2017,6,10,2,17746,18292,15540,-2752
2017,6,10,3,16833,17233,14881,-2352
2017,6,10,4,15621,15873,13775,-2098
2017,6,10,5,14148,14717,12419,-2298
2017,6,10,6,13435,13880,11875,-2005
2017,6,10,7,12987,13369,11963,-1406
2017,6,10,8,12724,13099,11769,-1330
2017,6,10,9,12668,13018,12111,-907
2017,6,10,10,12739,13037,11999,-1038
2017,6,10,11,13155,13467,12128,-1339
2017,6,10,12,14187,14524,13231,-1293
2017,6,10,13,15446,15810,14188,-1622
2017,6,10,14,16707,16882,15088,-1794
2017,6,10,15,17508,17634,15788,-1846
2017,6,10,16,18061,18279,16567,-1712
2017,6,10,17,18400,18764,16832,-1932
2017,6,10,18,18570,19135,17131,-2004
2017,6,10,19,18743,19442,17276,-2166
2017,6,10,20,18952,19741,17559,-2182
2017,6,10,21,19176,20051,18225,-1826
2017,6,10,22,19259,20228,18391,-1837
2017,6,10,23,19098,20079,17979,-2100
2017,6,11,0,18709,19691,17735,-1956
2017,6,11,1,18409,19453,17542,-1911
2017,6,11,2,18471,19346,17027,-2319
2017,6,11,3,17712,18444,16247,-2197
2017,6,11,4,16662,17269,15290,-1979
2017,6,11,5,15899,16190,14295,-1895
2017,6,11,6,15075,15389,13947,-1442
2017,6,11,7,14480,14755,13541,-1214
2017,6,11,8,14103,14354,13443,-911
2017,6,11,9,13945,14153,13388,-765
2017,6,11,10,13884,13960,13056,-904
2017,6,11,11,14123,14297,13310,-987
2017,6,11,12,15082,15360,13838,-1522
2017,6,11,13,16422,16847,14542,-2305
2017,6,11,14,17674,18369,15990,-2379
2017,6,11,15,18907,19738,16966,-2772
2017,6,11,16,19951,20723,17953,-2770
2017,6,11,17,20773,21460,18614,-2846
2017,6,11,18,21354,22034,19371,-2663
2017,6,11,19,21817,22548,19735,-2813
2017,6,11,20,22261,23017,20188,-2829
2017,6,11,21,22624,23547,20685,-2862
2017,6,11,22,22688,23944,21002,-2942
2017,6,11,23,22353,23905,21113,-2792
2017,6,12,0,21738,23566,20744,-2822
2017,6,12,1,21274,23259,20515,-2744
2017,6,12,2,21097,23055,20081,-2974
2017,6,12,3,19934,21663,18174,-3489
2017,6,12,4,18515,20000,16732,-3268
2017,6,12,5,17857,18568,14533,-4035
2017,6,12,6,16993,17562,13827,-3735
2017,6,12,7,16384,16895,13318,-3577
2017,6,12,8,16049,16494,13074,-3420
2017,6,12,9,16097,16516,13221,-3295
2017,6,12,10,16655,17002,13797,-3205
2017,6,12,11,17945,18528,14876,-3652
2017,6,12,12,19872,20616,16593,-4023
2017,6,12,13,21478,22329,17891,-4438
2017,6,12,14,22629,23763,19374,-4389
2017,6,12,15,23870,25042,20477,-4565
2017,6,12,16,24902,26062,22110,-3952
2017,6,12,17,25749,26878,23274,-3604
2017,6,12,18,26508,27625,24005,-3620
2017,6,12,19,27038,28140,24558,-3582
2017,6,12,20,27464,28628,24879,-3749
2017,6,12,21,27700,29000,25377,-3623
2017,6,12,22,27450,29049,25282,-3767
2017,6,12,23,26581,28525,25066,-3459
2017,6,13,0,25538,27741,24518,-3223
2017,6,13,1,24637,26933,24021,-2912
2017,6,13,2,23985,26241,22882,-3359
2017,6,13,3,22283,24363,20564,-3799
2017,6,13,4,20368,22192,18599,-3593
2017,6,13,5,19304,20457,16701,-3756
2017,6,13,6,18253,19275,15814,-3461
2017,6,13,7,17532,18440,15293,-3147
2017,6,13,8,17127,17973,14917,-3056
2017,6,13,9,17119,17869,14963,-2906
2017,6,13,10,17634,18349,15254,-3095
2017,6,13,11,18959,19843,16328,-3515
2017,6,13,12,20848,21792,17863,-3929
2017,6,13,13,22371,23376,19179,-4197
2017,6,13,14,23469,24744,20792,-3952
2017,6,13,15,24605,26098,22220,-3878
2017,6,13,16,25533,27186,23581,-3605
2017,6,13,17,26248,27931,24506,-3425
2017,6,13,18,26877,28631,25006,-3625
2017,6,13,19,27303,28968,25148,-3820
2017,6,13,20,27641,29116,25660,-3456
2017,6,13,21,27802,29126,25868,-3258
2017,6,13,22,27471,29035,25777,-3258
2017,6,13,23,26612,28348,25075,-3273
2017,6,14,0,25662,27321,24196,-3125
2017,6,14,1,24891,26616,23527,-3089
2017,6,14,2,24278,25805,22384,-3421
2017,6,14,3,22589,23989,20640,-3349
2017,6,14,4,20576,21984,18290,-3694
2017,6,14,5,18773,20344,16335,-4009
2017,6,14,6,17652,19247,14892,-4355
2017,6,14,7,16931,18377,13538,-4839
2017,6,14,8,16514,17748,13312,-4436
2017,6,14,9,16476,17515,13372,-4143
2017,6,14,10,16932,17839,13702,-4137
2017,6,14,11,18169,19070,14749,-4321
2017,6,14,12,19750,20541,16606,-3935
2017,6,14,13,20894,21277,16865,-4412
2017,6,14,14,21740,21781,17300,-4481
2017,6,14,15,22277,22469,17850,-4619
2017,6,14,16,22556,22958,18206,-4752
2017,6,14,17,22641,23247,18677,-4570
2017,6,14,18,22740,23789,19465,-4324
2017,6,14,19,22775,24181,19779,-4402
2017,6,14,20,22890,24492,20087,-4405
2017,6,14,21,23036,24638,20935,-3703
2017,6,14,22,22892,24365,20531,-3834
2017,6,14,23,22211,23540,19934,-3606
2017,6,15,0,21401,22519,19007,-3512
2017,6,15,1,20751,21665,18065,-3600
2017,6,15,2,20320,21061,17669,-3392
2017,6,15,3,18929,19498,15749,-3749
2017,6,15,4,17294,17760,14080,-3680
2017,6,15,5,16414,16258,12896,-3362
2017,6,15,6,15431,15387,12088,-3299
2017,6,15,7,14767,14812,11613,-3199
2017,6,15,8,14401,14530,11214,-3316
2017,6,15,9,14414,14547,11252,-3295
2017,6,15,10,14911,15057,11955,-3102
2017,6,15,11,16242,16452,12745,-3707
2017,6,15,12,17959,18082,14279,-3803
2017,6,15,13,19234,19079,14884,-4195
2017,6,15,14,20457,19740,15613,-4127
2017,6,15,15,20870,20289,16408,-3881
2017,6,15,16,20991,20696,16958,-3738
2017,6,15,17,20937,21001,16645,-4356
2017,6,15,18,20984,21349,17050,-4299
2017,6,15,19,21041,21561,17085,-4476
2017,6,15,20,21203,21789,17717,-4072
2017,6,15,21,21462,21958,17828,-4130
2017,6,15,22,21473,21835,17524,-4311
2017,6,15,23,20919,21172,17087,-4085
2017,6,16,0,20304,20518,16323,-4195
2017,6,16,1,19881,20087,16214,-3873
2017,6,16,2,19564,19703,16185,-3518
2017,6,16,3,18297,18375,14860,-3515
2017,6,16,4,16771,16900,13593,-3307
2017,6,16,5,15334,15746,12647,-3099
2017,6,16,6,14506,14998,11987,-3011
2017,6,16,7,14000,14507,11841,-2666
2017,6,16,8,13746,14266,11776,-2490
2017,6,16,9,13840,14332,12043,-2289
2017,6,16,10,14415,14947,12522,-2425
2017,6,16,11,15896,16339,13424,-2915
2017,6,16,12,17637,17909,14832,-3077
2017,6,16,13,19005,19012,15910,-3102
2017,6,16,14,20507,19720,16963,-2757
2017,6,16,15,20842,20221,17438,-2783
2017,6,16,16,20829,20508,17399,-3109
2017,6,16,17,20603,20629,17227,-3402
2017,6,16,18,20441,20779,17565,-3214
2017,6,16,19,20315,20773,17427,-3346
2017,6,16,20,20287,20747,17626,-3121
2017,6,16,21,20390,20713,17513,-3200
2017,6,16,22,20307,20575,17365,-3210
2017,6,16,23,19852,20143,16636,-3507
2017,6,17,0,19409,19800,15867,-3933
2017,6,17,1,19121,19460,15603,-3857
2017,6,17,2,19043,19187,15378,-3809
2017,6,17,3,18139,18141,14249,-3892
2017,6,17,4,16940,16813,13027,-3786
2017,6,17,5,16110,15720,12015,-3705
2017,6,17,6,15251,14982,11251,-3731
2017,6,17,7,14650,14494,10575,-3919
2017,6,17,8,14275,14196,10292,-3904
2017,6,17,9,14157,14128,10408,-3720
2017,6,17,10,14204,14226,10595,-3631
2017,6,17,11,14755,14665,11060,-3605
2017,6,17,12,15887,15774,12105,-3669
2017,6,17,13,17346,17163,13076,-4087
2017,6,17,14,19235,18317,14046,-4271
2017,6,17,15,20055,19170,14768,-4402
2017,6,17,16,20521,19745,15149,-4596
2017,6,17,17,20711,20002,15787,-4215
2017,6,17,18,20727,20064,16084,-3980
2017,6,17,19,20733,20081,15754,-4327
2017,6,17,20,20839,20273,16055,-4218
2017,6,17,21,21055,20513,16198,-4315
2017,6,17,22,21166,20644,16220,-4424
2017,6,17,23,21000,20550,16200,-4350
2017,6,18,0,20646,20279,15937,-4342
2017,6,18,1,20348,20135,15897,-4238
2017,6,18,2,20289,20028,15688,-4340
2017,6,18,3,19430,19210,15390,-3820
2017,6,18,4,18306,18071,14154,-3917
2017,6,18,5,17027,17018,13096,-3922
2017,6,18,6,16163,16222,12589,-3633
2017,6,18,7,15542,15659,12355,-3304
2017,6,18,8,15145,15393,11568,-3825
2017,6,18,9,14974,15250,11325,-3925
2017,6,18,10,14906,15200,11614,-3586
2017,6,18,11,15276,15524,11784,-3740
2017,6,18,12,16253,16560,13076,-3484
2017,6,18,13,17669,18022,14052,-3970
2017,6,18,14,19660,19317,14907,-4410
2017,6,18,15,20710,20566,16207,-4359
2017,6,18,16,21426,21639,17064,-4575
2017,6,18,17,21859,22554,17810,-4744
2017,6,18,18,22055,23110,18387,-4723
2017,6,18,19,22142,23418,18700,-4718
2017,6,18,20,22301,23536,19110,-4426
2017,6,18,21,22530,23766,19644,-4122
2017,6,18,22,22660,23807,19572,-4235
2017,6,18,23,22487,23424,19066,-4358
2017,6,19,0,22153,22902,18611,-4291
2017,6,19,1,21836,22723,18170,-4553
2017,6,19,2,21643,22516,17908,-4608
2017,6,19,3,20580,21377,17197,-4180
2017,6,19,4,19283,19897,16156,-3741
2017,6,19,5,18323,18608,15245,-3363
2017,6,19,6,17442,17710,14420,-3290
2017,6,19,7,16833,17106,13655,-3451
2017,6,19,8,16497,16846,13557,-3289
2017,6,19,9,16537,16932,13548,-3384
2017,6,19,10,17068,17648,14219,-3429
2017,6,19,11,18415,19284,15450,-3834
2017,6,19,12,20260,21220,17307,-3913
2017,6,19,13,21869,22707,17829,-4878
2017,6,19,14,23784,23797,18571,-5226
2017,6,19,15,24423,24747,19790,-4957
2017,6,19,16,24673,25429,20921,-4508
2017,6,19,17,24653,25734,21181,-4553
2017,6,19,18,24605,25870,21597,-4273
2017,6,19,19,24499,25999,21943,-4056
2017,6,19,20,24500,26164,22503,-3661
2017,6,19,21,24571,25845,22000,-3845
2017,6,19,22,24470,25012,20733,-4279
2017,6,19,23,23991,24132,19667,-4465
2017,6,20,0,23509,23429,18993,-4436
2017,6,20,1,23064,22769,18559,-4210
2017,6,20,2,22719,22045,17576,-4469
2017,6,20,3,21429,20603,16553,-4050
2017,6,20,4,19818,18928,15241,-3687
2017,6,20,5,18007,17607,14226,-3381
2017,6,20,6,16952,16807,13677,-3130
2017,6,20,7,16272,16246,13155,-3091
2017,6,20,8,15884,16015,13084,-2931
2017,6,20,9,15879,16116,13411,-2705
2017,6,20,10,16382,16779,14191,-2588
2017,6,20,11,17765,18297,15247,-3050
2017,6,20,12,19546,20072,16837,-3235
2017,6,20,13,21044,21273,17369,-3904
2017,6,20,14,22907,22004,17708,-4296
2017,6,20,15,23280,22567,18371,-4196
2017,6,20,16,23286,22935,18775,-4160
2017,6,20,17,23030,23306,18843,-4463
2017,6,20,18,22838,23693,19697,-3996
2017,6,20,19,22694,23923,19940,-3983
2017,6,20,20,22742,24179,20841,-3338
2017,6,20,21,22956,24291,20911,-3380
2017,6,20,22,23046,24145,20307,-3838
2017,6,20,23,22607,23535,19649,-3886
2017,6,21,0,22081,22813,18787,-4026
2017,6,21,1,21558,22118,18465,-3653
2017,6,21,2,21272,21758,18338,-3420
2017,6,21,3,20058,20343,16830,-3513
2017,6,21,4,18523,18738,15114,-3624
2017,6,21,5,16835,17448,13931,-3517
2017,6,21,6,15877,16613,13421,-3192
2017,6,21,7,15253,16049,13071,-2978
2017,6,21,8,14909,15728,12663,-3065
2017,6,21,9,14923,15797,12817,-2980
2017,6,21,10,15420,16341,13463,-2878
2017,6,21,11,16727,17891,14725,-3166
2017,6,21,12,18466,19603,15879,-3724
2017,6,21,13,19853,20791,16636,-4155
2017,6,21,14,21338,21520,17444,-4076
2017,6,21,15,21804,22246,18455,-3791
2017,6,21,16,21971,22799,18907,-3892
2017,6,21,17,21938,23097,19139,-3958
2017,6,21,18,21972,23268,19570,-3698
2017,6,21,19,22006,23481,19662,-3819
2017,6,21,20,22170,23922,20263,-3659
2017,6,21,21,22415,24163,20581,-3582
2017,6,21,22,22392,23883,20222,-3661
2017,6,21,23,21883,23300,19574,-3726
2017,6,22,0,21305,22611,18649,-3962
2017,6,22,1,20797,21888,17678,-4210
2017,6,22,2,20520,21515,17254,-4261
2017,6,22,3,19295,20140,15863,-4277
2017,6,22,4,17767,18492,14804,-3688
2017,6,22,5,16511,17070,13393,-3677
2017,6,22,6,15522,16126,12569,-3557
2017,6,22,7,14882,15485,12289,-3196
2017,6,22,8,14534,15127,12046,-3081
2017,6,22,9,14569,15091,12072,-3019
2017,6,22,10,15111,15537,12600,-2937
2017,6,22,11,16503,17011,13728,-3283
2017,6,22,12,18329,18771,15133,-3638
2017,6,22,13,19748,20044,16343,-3701
2017,6,22,14,21129,21009,16905,-4104
2017,6,22,15,21660,21773,17338,-4435
2017,6,22,16,21903,22396,17892,-4504
2017,6,22,17,22000,22845,18313,-4532
2017,6,22,18,22168,23236,18595,-4641
2017,6,22,19,22281,23563,18944,-4619
2017,6,22,20,22477,24082,19733,-4349
2017,6,22,21,22694,24582,20360,-4222
2017,6,22,22,22615,24683,20207,-4476
2017,6,22,23,22065,24128,19975,-4153
2017,6,23,0,21459,23392,19300,-4092
2017,6,23,1,21050,23016,18727,-4289
2017,6,23,2,20748,22856,18656,-4200
2017,6,23,3,19436,21681,17738,-3943
2017,6,23,4,17912,20238,16426,-3812
2017,6,23,5,17548,18933,15335,-3598
2017,6,23,6,16694,18074,14610,-3464
2017,6,23,7,16106,17488,14022,-3466
2017,6,23,8,15802,17174,13714,-3460
2017,6,23,9,15859,17230,13880,-3350
2017,6,23,10,16427,17843,14574,-3269
2017,6,23,11,17872,19400,15589,-3811
2017,6,23,12,19701,21358,17370,-3988
2017,6,23,13,21194,22893,18685,-4208
2017,6,23,14,22560,24004,19643,-4361
2017,6,23,15,23402,24786,20757,-4029
2017,6,23,16,23980,25329,21487,-3842
2017,6,23,17,24347,25690,22244,-3446
2017,6,23,18,24671,25859,22656,-3203
2017,6,23,19,24858,25497,22583,-2914
2017,6,23,20,25031,25500,22578,-2922
2017,6,23,21,25117,25589,22641,-2948
2017,6,23,22,24847,25430,21782,-3648
2017,6,23,23,24152,24822,21580,-3242
2017,6,24,0,23459,24186,20765,-3421
2017,6,24,1,22955,23706,20207,-3499
2017,6,24,2,22680,23404,19677,-3727
2017,6,24,3,21481,22337,18654,-3683
2017,6,24,4,19904,20924,17235,-3689
2017,6,24,5,18815,19599,15800,-3799
2017,6,24,6,17786,18564,14894,-3670
2017,6,24,7,17087,17753,14271,-3482
2017,6,24,8,16617,17215,13960,-3255
2017,6,24,9,16396,16951,13757,-3194
2017,6,24,10,16334,16857,13816,-3041
2017,6,24,11,16723,17124,13926,-3198
2017,6,24,12,17644,18024,14626,-3398
2017,6,24,13,18855,19097,15392,-3705
2017,6,24,14,20300,20331,16752,-3579
2017,6,24,15,21040,21450,17979,-3471
2017,6,24,16,21516,22222,19083,-3139
2017,6,24,17,21728,22509,18983,-3526
2017,6,24,18,21759,22541,18680,-3861
2017,6,24,19,21771,22595,18621,-3974
2017,6,24,20,21865,22721,18875,-3846
2017,6,24,21,21979,22753,19000,-3753
2017,6,24,22,21990,22694,19464,-3230
2017,6,24,23,21695,22484,19326,-3158
2017,6,25,0,21174,21837,18668,-3169
2017,6,25,1,20659,21192,17992,-3200
2017,6,25,2,20511,21018,17463,-3555
2017,6,25,3,19662,20123,16487,-3636
2017,6,25,4,18537,18782,14704,-4078
2017,6,25,5,17594,17538,13524,-4014
2017,6,25,6,16643,16453,12764,-3689
2017,6,25,7,15948,15742,12297,-3445
2017,6,25,8,15474,15196,11908,-3288
2017,6,25,9,15224,14894,12051,-2843
2017,6,25,10,15056,14631,11987,-2644
2017,6,25,11,15135,14889,12381,-2508
2017,6,25,12,15922,15783,12846,-2937
2017,6,25,13,17102,17003,13398,-3605
2017,6,25,14,18889,18215,14402,-3813
2017,6,25,15,19518,19211,15621,-3590
2017,6,25,16,19832,19914,16205,-3709
2017,6,25,17,19908,20423,16726,-3697
2017,6,25,18,19837,20696,17015,-3681
2017,6,25,19,19760,20741,17259,-3482
2017,6,25,20,19819,20652,17403,-3249
2017,6,25,21,20020,20804,17309,-3495
2017,6,25,22,20149,20972,17403,-3569
2017,6,25,23,19979,20826,17467,-3359
2017,6,26,0,19613,20340,16919,-3421
2017,6,26,1,19261,19990,16685,-3305
2017,6,26,2,19090,19950,16663,-3287
2017,6,26,3,18195,19056,15626,-3430
2017,6,26,4,17077,17739,14479,-3260
2017,6,26,5,15739,16541,13194,-3347
2017,6,26,6,14957,15560,12188,-3372
2017,6,26,7,14450,14929,11963,-2966
2017,6,26,8,14187,14586,11891,-2695
2017,6,26,9,14270,14637,11921,-2716
2017,6,26,10,14803,15104,12386,-2718
2017,6,26,11,16020,16299,13126,-3173
2017,6,26,12,17698,17902,14372,-3530
2017,6,26,13,19005,19182,15587,-3595
2017,6,26,14,20400,20086,16382,-3704
2017,6,26,15,20795,20718,17068,-3650
2017,6,26,16,20865,21147,17261,-3886
2017,6,26,17,20744,21504,17722,-3782
2017,6,26,18,20674,21736,17759,-3977
2017,6,26,19,20608,21874,18096,-3778
2017,6,26,20,20684,22007,18105,-3902
2017,6,26,21,20865,22114,18096,-4018
2017,6,26,22,20857,21993,17852,-4141
2017,6,26,23,20389,21438,17327,-4111
2017,6,27,0,19893,20724,16508,-4216
2017,6,27,1,19480,20236,16199,-4037
2017,6,27,2,19206,19917,15952,-3965
2017,6,27,3,18044,18725,14901,-3824
2017,6,27,4,16629,17312,13563,-3749
2017,6,27,5,15228,16033,12443,-3590
2017,6,27,6,14459,15258,11533,-3725
2017,6,27,7,13966,14717,11345,-3372
2017,6,27,8,13726,14408,10950,-3458
2017,6,27,9,13827,14499,11309,-3190
2017,6,27,10,14394,15015,11740,-3275
2017,6,27,11,15734,16224,12751,-3473
2017,6,27,12,17332,17608,13780,-3828
2017,6,27,13,18459,18697,14561,-4136
2017,6,27,14,19549,19497,15241,-4256
2017,6,27,15,19918,19882,15870,-4012
2017,6,27,16,20044,20327,16551,-3776
2017,6,27,17,20018,20602,16494,-4108
2017,6,27,18,20046,20930,16780,-4150
2017,6,27,19,20045,21131,17045,-4086
2017,6,27,20,20132,21302,17440,-3862
2017,6,27,21,20311,21281,17039,-4242
2017,6,27,22,20265,21019,17284,-3735
2017,6,27,23,19854,20559,17030,-3529
2017,6,28,0,19405,19929,16134,-3795
2017,6,28,1,19074,19491,15830,-3661
2017,6,28,2,18819,19260,15725,-3535
2017,6,28,3,17644,18103,14625,-3478
2017,6,28,4,16237,16702,13452,-3250
2017,6,28,5,14824,15496,12165,-3331
2017,6,28,6,14018,14642,11549,-3093
2017,6,28,7,13516,14128,11532,-2596
2017,6,28,8,13271,13824,10904,-2920
2017,6,28,9,13374,13917,10972,-2945
2017,6,28,10,13952,14401,11693,-2708
2017,6,28,11,15274,15670,13079,-2591
2017,6,28,12,16930,17187,14175,-3012
2017,6,28,13,18131,18259,14798,-3461
2017,6,28,14,19226,19001,14895,-4106
2017,6,28,15,19666,19574,15465,-4109
2017,6,28,16,19868,19970,16000,-3970
2017,6,28,17,19913,20284,16381,-3903
2017,6,28,18,20042,20680,16530,-4150
2017,6,28,19,20159,20889,16661,-4228
2017,6,28,20,20382,21204,17017,-4187
2017,6,28,21,20665,21581,17197,-4384
2017,6,28,22,20655,21711,17030,-4681
2017,6,28,23,20123,21255,16704,-4551
2017,6,29,0,19554,20564,16474,-4090
2017,6,29,1,19157,20179,16266,-3913
2017,6,29,2,18932,19998,16136,-3862
2017,6,29,3,17729,18796,15198,-3598
2017,6,29,4,16304,17251,13873,-3378
2017,6,29,5,15213,16028,13018,-3010
2017,6,29,6,14456,15158,12143,-3015
2017,6,29,7,13978,14597,11914,-2683
2017,6,29,8,13752,14325,11422,-2903
2017,6,29,9,13868,14436,11550,-2886
2017,6,29,10,14485,15012,12363,-2649
2017,6,29,11,15881,16232,12853,-3379
2017,6,29,12,17530,17876,14157,-3719
2017,6,29,13,18718,19144,15104,-4040
2017,6,29,14,19588,20180,15750,-4430
2017,6,29,15,20315,20931,16500,-4431
2017,6,29,16,20882,21520,17300,-4220
2017,6,29,17,21327,21944,17989,-3955
2017,6,29,18,21806,22435,18625,-3810
2017,6,29,19,22134,22817,18654,-4163
2017,6,29,20,22436,23063,19096,-3967
2017,6,29,21,22665,23271,19395,-3876
2017,6,29,22,22524,23200,19246,-3954
2017,6,29,23,21920,22531,18901,-3630
2017,6,30,0,21306,21966,18481,-3485
2017,6,30,1,20910,21700,18417,-3283
2017,6,30,2,20578,21539,18410,-3129
2017,6,30,3,19243,20419,17414,-3005
2017,6,30,4,17733,18932,15808,-3124
2017,6,30,5,16857,17636,14565,-3071
2017,6,30,6,15990,16729,13601,-3128
2017,6,30,7,15401,16137,13035,-3102
2017,6,30,8,15093,15827,12793,-3034
2017,6,30,9,15162,15880,12876,-3004
2017,6,30,10,15755,16451,13696,-2755
2017,6,30,11,17163,17806,14405,-3401
2017,6,30,12,18981,19468,15732,-3736
2017,6,30,13,20436,20918,16966,-3952
2017,6,30,14,21480,22087,18066,-4021
2017,6,30,15,22529,23097,19207,-3890
2017,6,30,16,23403,23919,20133,-3786
2017,6,30,17,24123,24551,20534,-4017
2017,6,30,18,24785,25164,21327,-3837
2017,6,30,19,25230,25622,21725,-3897
2017,6,30,20,25578,25968,22167,-3801
2017,6,30,21,25715,26059,22347,-3712
2017,6,30,22,25347,25624,22510,-3114
2017,6,30,23,24488,24836,22036,-2800
2017,7,1,0,23571,23992,20790,-3202
2017,7,1,1,22920,23361,20214,-3147
2017,7,1,2,22540,22984,19358,-3626
2017,7,1,3,21200,21894,17938,-3956
2017,7,1,4,19587,20415,16747,-3668
2017,7,1,5,18259,19006,15275,-3731
2017,7,1,6,17261,17948,14368,-3580
2017,7,1,7,16533,17162,13967,-3195
2017,7,1,8,16056,16642,13525,-3117
2017,7,1,9,15852,16358,13306,-3052
2017,7,1,10,15806,16320,13604,-2716
2017,7,1,11,16160,16747,13728,-3019
2017,7,1,12,17341,17750,14490,-3260
2017,7,1,13,18967,19076,15201,-3875
2017,7,1,14,21115,20293,16526,-3767
2017,7,1,15,22005,21328,17490,-3838
2017,7,1,16,22474,22135,18248,-3887
2017,7,1,17,22610,22690,19028,-3662
2017,7,1,18,22569,22868,19389,-3479
2017,7,1,19,22507,22764,19446,-3318
2017,7,1,20,22469,22601,19364,-3237
2017,7,1,21,22561,22711,19315,-3396
2017,7,1,22,22577,22628,19369,-3259
2017,7,1,23,22330,22151,18910,-3241
2017,7,2,0,21913,21645,18147,-3498
2017,7,2,1,21558,21072,17605,-3467
2017,7,2,2,21463,20875,17531,-3344
2017,7,2,3,20631,20023,16953,-3070
2017,7,2,4,19533,18829,16056,-2773
2017,7,2,5,18334,17685,15233,-2452
2017,7,2,6,17341,16844,14426,-2418
2017,7,2,7,16606,16231,14000,-2231
2017,7,2,8,16107,15817,13446,-2371
2017,7,2,9,15837,15584,13164,-2420
2017,7,2,10,15611,15363,13112,-2251
2017,7,2,11,15576,15635,13424,-2211
2017,7,2,12,16416,16597,14641,-1956
2017,7,2,13,17929,17969,15230,-2739
2017,7,2,14,20155,19275,15935,-3340
2017,7,2,15,21148,20393,17045,-3348
2017,7,2,16,21785,21257,17594,-3663
2017,7,2,17,22100,21957,18166,-3791
2017,7,2,18,22206,22505,18619,-3886
2017,7,2,19,22276,22951,19123,-3828
2017,7,2,20,22431,23402,19496,-3906
2017,7,2,21,22700,23755,19836,-3919
2017,7,2,22,22888,23935,20111,-3824
2017,7,2,23,22691,23570,19921,-3649
2017,7,3,0,22240,22860,19459,-3401
2017,7,3,1,21772,22280,18742,-3538
2017,7,3,2,21617,22166,18352,-3814
2017,7,3,3,20702,21249,17876,-3373
2017,7,3,4,19473,19940,16880,-3060
2017,7,3,5,17408,18659,15209,-3450
2017,7,3,6,16468,17629,14517,-3112
2017,7,3,7,15864,16864,13470,-3394
2017,7,3,8,15510,16414,13381,-3033
2017,7,3,9,15478,16307,13284,-3023
2017,7,3,10,15783,16545,13603,-2942
2017,7,3,11,16458,17536,14127,-3409
2017,7,3,12,17872,19144,15582,-3562
2017,7,3,13,19478,20653,16529,-4124
2017,7,3,14,21279,21857,17438,-4419
2017,7,3,15,22223,22826,18522,-4304
2017,7,3,16,22769,23549,19103,-4446
2017,7,3,17,23045,24037,19876,-4161
2017,7,3,18,23266,24569,20383,-4186
2017,7,3,19,23406,24946,20972,-3974
2017,7,3,20,23649,25147,21143,-4004
2017,7,3,21,23963,25272,20932,-4340
2017,7,3,22,23985,24958,20475,-4483
2017,7,3,23,23567,24275,20233,-4042
2017,7,4,0,22818,23472,19967,-3505
2017,7,4,1,21972,22606,19244,-3362
2017,7,4,2,21526,22161,18425,-3736
2017,7,4,3,20458,20944,17475,-3469
2017,7,4,4,19023,19395,15929,-3466
2017,7,4,5,16904,18038,14480,-3558
2017,7,4,6,15874,17024,13497,-3527
2017,7,4,7,15192,16265,13049,-3216
2017,7,4,8,14760,15737,12910,-2827
2017,7,4,9,14595,15411,12516,-2895
2017,7,4,10,14614,15246,12843,-2403
2017,7,4,11,15038,15505,12772,-2733
2017,7,4,12,15872,16286,13419,-2867
2017,7,4,13,16874,17337,14044,-3293
2017,7,4,14,18037,18326,14926,-3400
2017,7,4,15,18888,19157,15992,-3165
2017,7,4,16,19514,19977,16893,-3084
2017,7,4,17,19879,20601,17396,-3205
2017,7,4,18,20091,21009,17794,-3215
2017,7,4,19,20239,21403,17975,-3428
2017,7,4,20,20416,21754,18324,-3430
2017,7,4,21,20601,22004,18375,-3629
2017,7,4,22,20627,22007,18590,-3417
2017,7,4,23,20257,21792,18424,-3368
2017,7,5,0,19654,21168,17913,-3255
2017,7,5,1,18985,20529,17582,-2947
2017,7,5,2,18681,20118,17456,-2662
2017,7,5,3,17911,19315,16362,-2953
2017,7,5,4,16980,18214,14889,-3325
2017,7,5,5,16331,17046,13645,-3401
2017,7,5,6,15568,16159,12707,-3452
2017,7,5,7,15046,15602,12523,-3079
2017,7,5,8,14769,15305,12580,-2725
2017,7,5,9,14809,15327,12784,-2543
2017,7,5,10,15301,15676,13105,-2571
2017,7,5,11,16351,16873,13831,-3042
2017,7,5,12,17897,18635,15210,-3425
2017,7,5,13,19160,20120,16383,-3737
2017,7,5,14,20068,21270,17381,-3889
2017,7,5,15,20895,22326,18307,-4019
2017,7,5,16,21499,23142,19128,-4014
2017,7,5,17,21979,23770,19758,-4012
2017,7,5,18,22510,24334,20046,-4288
2017,7,5,19,22937,24808,20830,-3978
2017,7,5,20,23336,25182,21443,-3739
2017,7,5,21,23701,25480,21594,-3886
2017,7,5,22,23646,25363,21801,-3562
2017,7,5,23,23040,24605,21458,-3147
2017,7,6,0,22162,23614,20697,-2917
2017,7,6,1,21424,22715,19594,-3121
2017,7,6,2,20904,22308,19320,-2988
2017,7,6,3,19598,21012,17924,-3088
2017,7,6,4,18078,19313,16231,-3082
2017,7,6,5,17018,17898,14103,-3795
2017,7,6,6,16081,16936,13476,-3460
2017,7,6,7,15458,16349,13441,-2908
2017,7,6,8,15129,16003,13288,-2715
2017,7,6,9,15180,16052,13384,-2668
2017,7,6,10,15754,16605,13878,-2727
2017,7,6,11,17069,17810,14474,-3336
2017,7,6,12,18863,19392,15388,-4004
2017,7,6,13,20307,20608,16035,-4573
2017,7,6,14,21567,21449,17026,-4423
2017,7,6,15,22194,22076,17616,-4460
2017,7,6,16,22504,22490,18136,-4354
2017,7,6,17,22624,22747,18333,-4414
2017,7,6,18,22824,23081,18767,-4314
2017,7,6,19,22986,23411,23411,0
2017,7,6,20,23115,23726,23726,0
2017,7,6,21,23275,23825,23825,0
2017,7,6,22,23187,23648,23648,0
2017,7,6,23,22630,23012,23012,0
2017,7,7,0,22017,22350,22350,0
2017,7,7,1,21641,22034,22034,0
2017,7,7,2,21309,21809,21809,0
2017,7,7,3,20011,20612,20612,0
2017,7,7,4,18497,19176,19176,0
2017,7,7,5,17523,17822,14190,-3632
2017,7,7,6,16538,16969,13044,-3925
2017,7,7,7,15869,16418,12838,-3580
2017,7,7,8,15501,16070,12392,-3678
2017,7,7,9,15530,16114,12535,-3579
2017,7,7,10,16080,16717,13394,-3323
2017,7,7,11,17448,17978,14304,-3674
2017,7,7,12,19269,19580,15908,-3672
2017,7,7,13,20847,20811,16535,-4276
2017,7,7,14,22336,21694,17420,-4274
2017,7,7,15,23010,22166,18658,-3508
2017,7,7,16,23344,22419,18814,-3605
2017,7,7,17,23461,22552,18823,-3729
2017,7,7,18,23631,22845,18954,-3891
2017,7,7,19,23768,23089,19080,-4009
2017,7,7,20,23894,23399,19453,-3946
2017,7,7,21,24059,23802,20062,-3740
2017,7,7,22,23939,23986,19769,-4217
2017,7,7,23,23317,23544,19291,-4253
2017,7,8,0,22558,22805,18832,-3973
2017,7,8,1,21997,22212,18277,-3935
2017,7,8,2,21780,21818,17870,-3948
2017,7,8,3,20697,20726,16719,-4007
2017,7,8,4,19262,19343,15340,-4003
2017,7,8,5,17533,17967,13812,-4155
2017,7,8,6,16637,17032,13039,-3993
2017,7,8,7,16021,16339,12469,-3870
2017,7,8,8,15613,15860,12238,-3622
2017,7,8,9,15441,15626,12247,-3379
2017,7,8,10,15413,15626,12605,-3021
2017,7,8,11,15643,15940,13076,-2864
2017,7,8,12,16620,16992,13958,-3034
2017,7,8,13,17973,18335,14509,-3826
2017,7,8,14,19522,19517,15622,-3895
2017,7,8,15,20391,20565,16491,-4074
2017,7,8,16,20947,21392,17469,-3923
2017,7,8,17,21243,21927,18045,-3882
2017,7,8,18,21375,22350,18335,-4015
2017,7,8,19,21497,22566,18604,-3962
2017,7,8,20,21631,22725,18754,-3971
2017,7,8,21,21768,22779,19037,-3742
2017,7,8,22,21781,22566,19089,-3477
2017,7,8,23,21512,22027,18628,-3399
2017,7,9,0,21001,21377,17859,-3518
2017,7,9,1,20545,20740,17019,-3721
2017,7,9,2,20465,20477,16763,-3714
2017,7,9,3,19706,19506,15804,-3702
2017,7,9,4,18618,18211,14598,-3613
2017,7,9,5,16984,17084,13446,-3638
2017,7,9,6,15999,16121,12692,-3429
2017,7,9,7,15318,15385,11971,-3414
2017,7,9,8,14867,14851,11721,-3130
2017,7,9,9,14637,14534,11771,-2763
2017,7,9,10,14478,14293,11775,-2518
2017,7,9,11,14422,14428,11960,-2468
2017,7,9,12,15251,15194,12763,-2431
2017,7,9,13,16601,16250,13475,-2775
2017,7,9,14,18452,17332,14419,-2913
2017,7,9,15,19245,18208,15181,-3027
2017,7,9,16,19681,18896,15955,-2941
2017,7,9,17,19872,19396,16390,-3006
2017,7,9,18,19947,19829,16496,-3333
2017,7,9,19,20016,20245,16976,-3269
2017,7,9,20,20193,20688,17373,-3315
2017,7,9,21,20518,21163,17551,-3612
2017,7,9,22,20736,21529,17779,-3750
2017,7,9,23,20537,21458,17898,-3560
2017,7,10,0,20054,20952,17338,-3614
2017,7,10,1,19626,20563,16964,-3599
2017,7,10,2,19467,20488,17359,-3129
2017,7,10,3,18559,19457,16282,-3175
2017,7,10,4,17455,18086,14609,-3477
2017,7,10,5,16392,16926,13658,-3268
2017,7,10,6,15616,16071,13060,-3011
2017,7,10,7,15089,15501,12672,-2829
2017,7,10,8,14814,15180,12493,-2687
2017,7,10,9,14910,15238,12999,-2239
2017,7,10,10,15499,15762,13539,-2223
2017,7,10,11,16664,16993,14622,-2371
2017,7,10,12,18480,18759,16120,-2639
2017,7,10,13,20038,20132,17128,-3004
2017,7,10,14,21314,21238,17741,-3497
2017,7,10,15,22233,22189,18724,-3465
2017,7,10,16,22891,22878,19328,-3550
2017,7,10,17,23366,23489,19844,-3645
2017,7,10,18,23864,23970,20787,-3183
2017,7,10,19,24266,24487,21453,-3034
2017,7,10,20,24571,24994,21877,-3117
2017,7,10,21,24810,25216,21938,-3278
2017,7,10,22,24683,25156,21536,-3620
2017,7,10,23,24037,0,21536,0
2017,7,11,0,23271,23816,19910,-3906
2017,7,11,1,22685,23362,19745,-3617
2017,7,11,2,22226,22927,19874,-3053
2017,7,11,3,20801,21665,18618,-3047
2017,7,11,4,19154,20117,16695,-3422
2017,7,11,5,17938,18746,15287,-3459
2017,7,11,6,17021,17820,14535,-3285
2017,7,11,7,16397,17212,13957,-3255
2017,7,11,8,16068,16893,13805,-3088
2017,7,11,9,16126,16948,13871,-3077
2017,7,11,10,16714,17581,14312,-3269
2017,7,11,11,18027,18968,15496,-3472
2017,7,11,12,19851,20839,16968,-3871
2017,7,11,13,21426,22385,18683,-3702
2017,7,11,14,22812,23268,19269,-3999
2017,7,11,15,23821,23931,19721,-4210
2017,7,11,16,24581,24819,20719,-4100
2017,7,11,17,25128,25554,21383,-4171
2017,7,11,18,25647,26232,21823,-4409
2017,7,11,19,26015,26515,22528,-3987
2017,7,11,20,26298,26746,23040,-3706
2017,7,11,21,26495,27063,23273,-3790
2017,7,11,22,26337,27021,23715,-3306
2017,7,11,23,25653,26569,23319,-3250
2017,7,12,0,24853,25913,22735,-3178
2017,7,12,1,24228,25363,22148,-3215
2017,7,12,2,23768,24923,21236,-3687
2017,7,12,3,22273,23299,19658,-3641
2017,7,12,4,20538,21417,17575,-3842
2017,7,12,5,19306,19841,15437,-4404
2017,7,12,6,18214,18799,14533,-4266
2017,7,12,7,17446,18084,13950,-4134
2017,7,12,8,17007,17719,13699,-4020
2017,7,12,9,16987,17727,13824,-3903
2017,7,12,10,17525,18323,14343,-3980
2017,7,12,11,18805,19661,15436,-4225
2017,7,12,12,20746,21431,17229,-4202
2017,7,12,13,22511,22885,18846,-4039
2017,7,12,14,24287,24134,20307,-3827
2017,7,12,15,25258,25270,21604,-3666
2017,7,12,16,25897,26283,22532,-3751
2017,7,12,17,26271,27038,23110,-3928
2017,7,12,18,26666,27771,23678,-4093
2017,7,12,19,26944,28139,24552,-3587
2017,7,12,20,27186,28382,24647,-3735
2017,7,12,21,27393,28523,24738,-3785
2017,7,12,22,27274,28395,25007,-3388
2017,7,12,23,26546,27606,23991,-3615
2017,7,13,0,25753,26855,22712,-4143
2017,7,13,1,25135,26424,22164,-4260
2017,7,13,2,24689,25783,21483,-4300
2017,7,13,3,23192,24135,19850,-4285
2017,7,13,4,21415,22232,17777,-4455
2017,7,13,5,20321,20696,16411,-4285
2017,7,13,6,19220,19669,15647,-4022
2017,7,13,7,18450,18953,15136,-3817
2017,7,13,8,18006,18575,15055,-3520
2017,7,13,9,17965,18546,14975,-3571
2017,7,13,10,18470,19097,15458,-3639
2017,7,13,11,19688,20396,16296,-4100
2017,7,13,12,21539,22317,17799,-4518
2017,7,13,13,23205,23888,19575,-4313
2017,7,13,14,24824,25279,20960,-4319
2017,7,13,15,25742,26510,22127,-4383
2017,7,13,16,26323,27390,23093,-4297
2017,7,13,17,26656,27844,23856,-3988
2017,7,13,18,27004,27951,24426,-3525
2017,7,13,19,27243,27724,24870,-2854
2017,7,13,20,27453,27514,24109,-3405
2017,7,13,21,27591,27304,24013,-3291
2017,7,13,22,27435,26672,23411,-3261
2017,7,13,23,26723,25373,22024,-3349
2017,7,14,0,25988,24612,21055,-3557
2017,7,14,1,25429,24212,20427,-3785
2017,7,14,2,25013,23651,19418,-4233
2017,7,14,3,23582,22218,17656,-4562
2017,7,14,4,21797,20407,16002,-4405
2017,7,14,5,19160,18843,14423,-4420
2017,7,14,6,18041,17780,13345,-4435
2017,7,14,7,17324,17070,12651,-4419
2017,7,14,8,16899,16597,12501,-4096
2017,7,14,9,16843,16495,12538,-3957
2017,7,14,10,17280,16974,13305,-3669
2017,7,14,11,18388,18034,14427,-3607
2017,7,14,12,19898,19318,15742,-3576
2017,7,14,13,21253,20338,16749,-3589
2017,7,14,14,22931,21073,17226,-3847
2017,7,14,15,23166,21597,17214,-4383
2017,7,14,16,22978,21994,17640,-4354
2017,7,14,17,22523,22161,18358,-3803
2017,7,14,18,22167,22264,18804,-3460
2017,7,14,19,21906,22182,18894,-3288
2017,7,14,20,21754,22035,18312,-3723
2017,7,14,21,21789,21987,18173,-3814
2017,7,14,22,21764,21843,17990,-3853
2017,7,14,23,21347,21311,17568,-3743
2017,7,15,0,20881,20869,17101,-3768
2017,7,15,1,20524,20525,16927,-3598
2017,7,15,2,20439,20103,16528,-3575
2017,7,15,3,19641,19085,15183,-3902
2017,7,15,4,18560,17843,14220,-3623
2017,7,15,5,17136,16696,12826,-3870
2017,7,15,6,16281,15918,12179,-3739
2017,7,15,7,15649,15353,11618,-3735
2017,7,15,8,15235,15037,11279,-3758
2017,7,15,9,15077,14928,11280,-3648
2017,7,15,10,15096,15066,11519,-3547
2017,7,15,11,15434,15418,12040,-3378
2017,7,15,12,16495,16313,12974,-3339
2017,7,15,13,18042,17533,13822,-3711
2017,7,15,14,20294,18596,15089,-3507
2017,7,15,15,21109,19547,15886,-3661
2017,7,15,16,21515,20336,16415,-3921
2017,7,15,17,21605,20882,16626,-4256
2017,7,15,18,21535,21229,16768,-4461
2017,7,15,19,21499,21446,16799,-4647
2017,7,15,20,21554,21742,17436,-4306
2017,7,15,21,21757,22004,17847,-4157
2017,7,15,22,21897,22120,17920,-4200
2017,7,15,23,21750,21986,17812,-4174
2017,7,16,0,21351,21393,17347,-4046
2017,7,16,1,20881,20932,17042,-3890
2017,7,16,2,20847,20815,17145,-3670
2017,7,16,3,20103,19861,16523,-3338
2017,7,16,4,19032,18600,15468,-3132
2017,7,16,5,16903,17348,14075,-3273
2017,7,16,6,15958,16376,13272,-3104
2017,7,16,7,15297,15697,12794,-2903
2017,7,16,8,14861,15206,12446,-2760
2017,7,16,9,14658,14938,12099,-2839
2017,7,16,10,14575,14784,11988,-2796
2017,7,16,11,14617,14999,12192,-2807
2017,7,16,12,15562,15875,12666,-3209
2017,7,16,13,17103,17295,13618,-3677
2017,7,16,14,19311,18621,14744,-3877
2017,7,16,15,20302,19792,15952,-3840
2017,7,16,16,20928,20755,16927,-3828
2017,7,16,17,21274,21450,17337,-4113
2017,7,16,18,21464,21986,17951,-4035
2017,7,16,19,21603,22502,18452,-4050
2017,7,16,20,21807,22996,19003,-3993
2017,7,16,21,22122,23464,19828,-3636
2017,7,16,22,22308,23782,20704,-3078
2017,7,16,23,22088,23529,20523,-3006
2017,7,17,0,21622,22955,19588,-3367
2017,7,17,1,21190,22568,19222,-3346
2017,7,17,2,21015,22253,18925,-3328
2017,7,17,3,20013,21125,17530,-3595
2017,7,17,4,18791,19681,15844,-3837
2017,7,17,5,17884,18401,14582,-3819
2017,7,17,6,17009,17480,13864,-3616
2017,7,17,7,16405,16840,13312,-3528
2017,7,17,8,16083,16510,12971,-3539
2017,7,17,9,16160,16565,13191,-3374
2017,7,17,10,16784,17201,13865,-3336
2017,7,17,11,18040,18447,14848,-3599
2017,7,17,12,19965,20304,16330,-3974
2017,7,17,13,21777,21872,17851,-4021
2017,7,17,14,23841,23161,19187,-3974
2017,7,17,15,24696,24446,20835,-3611
2017,7,17,16,25155,25290,22023,-3267
2017,7,17,17,25341,25795,22683,-3112
2017,7,17,18,25543,26277,23160,-3117
2017,7,17,19,25677,26586,23493,-3093
2017,7,17,20,25819,26854,23650,-3204
2017,7,17,21,26003,26980,23571,-3409
2017,7,17,22,25956,26842,23625,-3217
2017,7,17,23,25386,26108,23200,-2908
2017,7,18,0,24730,25325,22721,-2604
2017,7,18,1,24115,24662,21625,-3037
2017,7,18,2,23699,24043,20965,-3078
2017,7,18,3,22292,22555,19301,-3254
2017,7,18,4,20589,20801,17330,-3471
2017,7,18,5,18907,19337,15092,-4245
2017,7,18,6,17799,18362,14451,-3911
2017,7,18,7,17062,17649,13844,-3805
2017,7,18,8,16646,17257,13496,-3761
2017,7,18,9,16658,17239,13581,-3658
2017,7,18,10,17247,17804,14099,-3705
2017,7,18,11,18574,19105,15225,-3880
2017,7,18,12,20533,20997,16626,-4371
2017,7,18,13,22366,22393,17938,-4455
2017,7,18,14,24563,23615,18892,-4723
2017,7,18,15,25387,24764,20555,-4209
2017,7,18,16,25817,25686,21806,-3880
2017,7,18,17,25958,26367,22614,-3753
2017,7,18,18,26116,27025,23059,-3966
2017,7,18,19,26258,27535,23479,-4056
2017,7,18,20,26438,27944,24077,-3867
2017,7,18,21,26686,28112,24325,-3787
2017,7,18,22,26701,28220,24277,-3943
2017,7,18,23,26138,27702,24187,-3515
2017,7,19,0,25393,26739,22773,-3966
2017,7,19,1,24665,26026,21622,-4404
2017,7,19,2,24247,25474,21790,-3684
2017,7,19,3,22801,23828,20530,-3298
2017,7,19,4,21056,21959,18528,-3431
2017,7,19,5,19594,20354,16583,-3771
2017,7,19,6,18435,19145,14916,-4229
2017,7,19,7,17643,18393,14367,-4026
2017,7,19,8,17184,17929,13975,-3954
2017,7,19,9,17161,17888,14034,-3854
2017,7,19,10,17738,18476,14503,-3973
2017,7,19,11,19031,19836,15696,-4140
2017,7,19,12,21098,21812,17618,-4194
2017,7,19,13,23073,23508,19244,-4264
2017,7,19,14,25353,24940,20867,-4073
2017,7,19,15,26406,26113,22471,-3642
2017,7,19,16,27049,27185,23940,-3245
2017,7,19,17,27376,27781,24800,-2981
2017,7,19,18,27698,28363,26241,-2122
2017,7,19,19,27953,28846,26949,-1897
2017,7,19,20,28211,29322,27384,-1938
2017,7,19,21,28485,29670,27551,-2119
2017,7,19,22,28440,29699,27676,-2023
2017,7,19,23,27733,29229,27330,-1899
2017,7,20,0,26866,28385,26299,-2086
2017,7,20,1,26102,27612,25367,-2245
2017,7,20,2,25624,27002,24395,-2607
2017,7,20,3,24078,25229,22265,-2964
2017,7,20,4,22179,23225,19377,-3848
2017,7,20,5,20512,21505,17073,-4432
2017,7,20,6,19310,20259,16018,-4241
2017,7,20,7,18504,19464,15120,-4344
2017,7,20,8,18038,18844,14596,-4248
2017,7,20,9,17997,18825,14465,-4360
2017,7,20,10,18547,19278,15083,-4195
2017,7,20,11,19731,20517,16448,-4069
2017,7,20,12,21683,22464,18697,-3767
2017,7,20,13,23498,24176,20289,-3887
2017,7,20,14,25337,25614,22135,-3479
2017,7,20,15,26408,27025,23753,-3272
2017,7,20,16,27094,28176,25269,-2907
2017,7,20,17,27510,28856,26178,-2678
2017,7,20,18,27911,29264,26708,-2556
2017,7,20,19,28184,29369,27268,-2101
2017,7,20,20,28417,29345,27551,-1794
2017,7,20,21,28583,29423,27848,-1575
2017,7,20,22,28409,29005,27736,-1269
2017,7,20,23,27622,28378,26672,-1706
2017,7,21,0,26753,27650,26117,-1533
2017,7,21,1,26038,26984,25671,-1313
2017,7,21,2,25538,26153,24502,-1651
2017,7,21,3,23978,24404,21683,-2721
2017,7,21,4,22116,22471,19238,-3233
2017,7,21,5,20858,20902,17237,-3665
2017,7,21,6,19672,19768,16378,-3390
2017,7,21,7,18852,18982,15757,-3225
2017,7,21,8,18368,18532,15206,-3326
2017,7,21,9,18298,18484,15189,-3295
2017,7,21,10,18793,18998,15699,-3299
2017,7,21,11,19879,20271,17076,-3195
2017,7,21,12,21693,22150,18938,-3212
2017,7,21,13,23407,23830,20550,-3280
2017,7,21,14,25093,25216,22033,-3183
2017,7,21,15,26103,26314,23550,-2764
2017,7,21,16,26735,27259,24888,-2371
2017,7,21,17,27081,27985,25710,-2275
2017,7,21,18,27403,28683,26296,-2387
2017,7,21,19,27640,29194,26953,-2241
2017,7,21,20,27859,29421,27386,-2035
2017,7,21,21,27987,29622,28189,-1433
2017,7,21,22,27754,29550,28325,-1225
2017,7,21,23,26902,28750,27386,-1364
2017,7,22,0,25883,27667,26087,-1580
2017,7,22,1,25022,26809,25065,-1744
2017,7,22,2,24640,26202,23730,-2472
2017,7,22,3,23356,24796,21826,-2970
2017,7,22,4,21669,23074,19652,-3422
2017,7,22,5,20045,21588,17718,-3870
2017,7,22,6,18870,20379,16779,-3600
2017,7,22,7,18060,19558,15714,-3844
2017,7,22,8,17515,18982,14906,-4076
2017,7,22,9,17253,18538,14589,-3949
2017,7,22,10,17222,18337,14171,-4166
2017,7,22,11,17377,18477,14290,-4187
2017,7,22,12,18449,19541,15294,-4247
2017,7,22,13,20030,20889,16127,-4762
2017,7,22,14,21818,22201,17270,-4931
2017,7,22,15,22907,23289,18841,-4448
2017,7,22,16,23648,24101,19398,-4703
2017,7,22,17,24071,24597,20086,-4511
2017,7,22,18,24313,24815,20776,-4039
2017,7,22,19,24495,24816,20890,-3926
2017,7,22,20,24645,24906,21476,-3430
2017,7,22,21,24766,24943,21455,-3488
2017,7,22,22,24674,24644,21304,-3340
2017,7,22,23,24206,24067,20541,-3526
2017,7,23,0,23528,23511,19709,-3802
2017,7,23,1,23012,23362,19434,-3928
2017,7,23,2,22799,23119,18984,-4135
2017,7,23,3,21778,22099,18122,-3977
2017,7,23,4,20460,20681,16991,-3690
2017,7,23,5,19300,19360,15412,-3948
2017,7,23,6,18237,18299,14404,-3895
2017,7,23,7,17476,17567,13682,-3885
2017,7,23,8,16957,17116,13506,-3610
2017,7,23,9,16679,16872,13046,-3826
2017,7,23,10,16555,16795,12940,-3855
2017,7,23,11,16577,16843,12986,-3857
2017,7,23,12,17290,17451,13671,-3780
2017,7,23,13,18599,18519,14400,-4119
2017,7,23,14,20582,19697,15507,-4190
2017,7,23,15,21401,20961,16695,-4266
2017,7,23,16,21884,21920,17644,-4276
2017,7,23,17,22084,22421,18432,-3989
2017,7,23,18,22131,22576,18537,-4039
2017,7,23,19,22140,22600,18721,-3879
2017,7,23,20,22203,22644,18972,-3672
2017,7,23,21,22436,22711,19612,-3099
2017,7,23,22,22596,22645,19676,-2969
2017,7,23,23,22384,22342,19514,-2828
2017,7,24,0,21978,21909,18902,-3007
2017,7,24,1,21644,21911,18434,-3477
2017,7,24,2,21421,21718,18267,-3451
2017,7,24,3,20401,20686,16985,-3701
2017,7,24,4,19197,19381,15607,-3774
2017,7,24,5,17817,18231,14191,-4040
2017,7,24,6,16992,17448,13563,-3885
2017,7,24,7,16432,16953,13364,-3589
2017,7,24,8,16128,16641,13216,-3425
2017,7,24,9,16175,16729,13224,-3505
2017,7,24,10,16739,17396,13644,-3752
2017,7,24,11,17866,18521,14651,-3870
2017,7,24,12,19356,19819,15660,-4159
2017,7,24,13,20684,20899,16976,-3923
2017,7,24,14,22347,21556,17913,-3643
2017,7,24,15,22727,21735,18456,-3279
2017,7,24,16,22725,21687,19143,-2544
2017,7,24,17,22480,21527,19079,-2448
2017,7,24,18,22298,21402,18863,-2539
2017,7,24,19,22150,21285,19197,-2088
2017,7,24,20,22089,21192,19166,-2026
2017,7,24,21,22166,21184,19381,-1803
2017,7,24,22,22190,21030,18872,-2158
2017,7,24,23,21823,20586,18292,-2294
2017,7,25,0,21425,20113,18020,-2093
2017,7,25,1,21094,19822,17841,-1981
2017,7,25,2,20846,19209,17158,-2051
2017,7,25,3,19776,17884,15648,-2236
2017,7,25,4,18412,16573,14397,-2176
2017,7,25,5,16345,15562,13083,-2479
2017,7,25,6,15455,14843,12564,-2279
2017,7,25,7,14875,14414,11837,-2577
2017,7,25,8,14554,14176,11648,-2528
2017,7,25,9,14586,14308,11984,-2324
2017,7,25,10,15138,14980,12193,-2787
2017,7,25,11,16305,16143,13307,-2836
2017,7,25,12,17764,17487,14546,-2941
2017,7,25,13,18997,18491,15397,-3094
2017,7,25,14,20666,19168,16243,-2925
2017,7,25,15,20800,19538,16266,-3272
2017,7,25,16,20558,19741,16528,-3213
2017,7,25,17,20117,19763,16659,-3104
2017,7,25,18,19811,19928,16964,-2964
2017,7,25,19,19614,19980,17047,-2933
2017,7,25,20,19583,19935,17312,-2623
2017,7,25,21,19763,19971,17408,-2563
2017,7,25,22,19906,19924,17569,-2355
2017,7,25,23,19665,19516,16969,-2547
2017,7,26,0,19394,19194,16850,-2344
2017,7,26,1,19200,19124,16754,-2370
2017,7,26,2,19083,18777,16203,-2574
2017,7,26,3,18122,17643,14900,-2743
2017,7,26,4,16918,16327,13454,-2873
2017,7,26,5,15266,15264,12484,-2780
2017,7,26,6,14521,14579,12150,-2429
2017,7,26,7,14050,14133,11543,-2590
2017,7,26,8,13823,13913,11701,-2212
2017,7,26,9,13935,13985,11964,-2021
2017,7,26,10,14565,14611,12323,-2288
2017,7,26,11,15723,15806,13033,-2773
2017,7,26,12,17302,17327,14223,-3104
2017,7,26,13,18649,18476,15258,-3218
2017,7,26,14,20268,19333,15602,-3731
2017,7,26,15,20739,19977,16485,-3492
2017,7,26,16,20876,20486,17314,-3172
2017,7,26,17,20815,20775,17628,-3147
2017,7,26,18,20892,21117,18016,-3101
2017,7,26,19,20989,21465,18240,-3225
2017,7,26,20,21180,21749,18296,-3453
2017,7,26,21,21484,21949,18742,-3207
2017,7,26,22,21590,21776,18511,-3265
2017,7,26,23,21185,21198,18258,-2940
2017,7,27,0,20734,20506,17475,-3031
2017,7,27,1,20379,20268,17432,-2836
2017,7,27,2,20197,19863,16967,-2896
2017,7,27,3,19093,18580,15547,-3033
2017,7,27,4,17725,17115,14331,-2784
2017,7,27,5,16021,15985,13222,-2763
2017,7,27,6,15175,15242,12582,-2660
2017,7,27,7,14637,14775,12242,-2533
2017,7,27,8,14372,14519,12171,-2348
2017,7,27,9,14476,14614,12465,-2149
2017,7,27,10,15166,15324,12781,-2543
2017,7,27,11,16488,16530,13624,-2906
2017,7,27,12,18163,18049,15496,-2553
2017,7,27,13,19584,19246,16477,-2769
2017,7,27,14,21133,20156,17392,-2764
2017,7,27,15,21730,20834,18157,-2677
2017,7,27,16,22027,21344,18604,-2740
2017,7,27,17,22134,21813,18854,-2959
2017,7,27,18,22330,22220,19176,-3044
2017,7,27,19,22494,22372,19833,-2539
2017,7,27,20,22656,22386,19847,-2539
2017,7,27,21,22864,22450,19979,-2471
2017,7,27,22,22828,22482,20036,-2446
2017,7,27,23,22358,22199,19480,-2719
2017,7,28,0,21845,21861,18711,-3150
2017,7,28,1,21507,21802,18334,-3468
2017,7,28,2,21274,21514,17976,-3538
2017,7,28,3,20072,20312,16636,-3676
2017,7,28,4,18632,18847,14978,-3869
2017,7,28,5,16966,17547,13066,-4481
2017,7,28,6,16102,16655,12330,-4325
2017,7,28,7,15530,16057,12141,-3916
2017,7,28,8,15227,15700,11991,-3709
2017,7,28,9,15287,15731,12178,-3553
2017,7,28,10,15906,16322,12470,-3852
2017,7,28,11,17079,17486,13345,-4141
2017,7,28,12,18716,19190,15175,-4015
2017,7,28,13,20190,20580,16593,-3987
2017,7,28,14,21773,21628,17464,-4164
2017,7,28,15,22423,22482,18517,-3965
2017,7,28,16,22737,23109,19421,-3688
2017,7,28,17,22832,23619,19955,-3664
2017,7,28,18,22975,24117,20430,-3687
2017,7,28,19,23081,24307,20922,-3385
2017,7,28,20,23189,24450,21101,-3349
2017,7,28,21,23265,24412,21049,-3363
2017,7,28,22,23079,24100,21016,-3084
2017,7,28,23,22482,23263,20496,-2767
2017,7,29,0,21824,22539,19481,-3058
2017,7,29,1,21381,22148,18585,-3563
2017,7,29,2,21184,21661,18311,-3350
2017,7,29,3,20174,20403,16859,-3544
2017,7,29,4,18766,18913,15115,-3798
2017,7,29,5,16837,17571,13775,-3796
2017,7,29,6,15906,16484,13223,-3261
2017,7,29,7,15306,15799,12698,-3101
2017,7,29,8,14915,15329,12193,-3136
2017,7,29,9,14757,15033,11823,-3210
2017,7,29,10,14797,14974,12091,-2883
2017,7,29,11,14963,15138,12311,-2827
2017,7,29,12,15622,15742,13505,-2237
2017,7,29,13,16681,16621,14513,-2108
2017,7,29,14,18212,17415,15280,-2135
2017,7,29,15,18658,17908,15847,-2061
2017,7,29,16,18729,18184,16145,-2039
2017,7,29,17,18579,18329,16155,-2174
2017,7,29,18,18341,18379,16317,-2062
2017,7,29,19,18153,18440,16437,-2003
2017,7,29,20,18057,18498,16335,-2163
2017,7,29,21,18152,18763,16370,-2393
2017,7,29,22,18265,18997,16770,-2227
2017,7,29,23,18172,18906,16728,-2178
2017,7,30,0,17871,18554,16610,-1944
2017,7,30,1,17614,18385,16298,-2087
2017,7,30,2,17601,18089,15566,-2523
2017,7,30,3,16981,17197,14526,-2671
2017,7,30,4,16185,16120,13114,-3006
2017,7,30,5,15522,15144,12037,-3107
2017,7,30,6,14759,14448,11138,-3310
2017,7,30,7,14175,13928,10921,-3007
2017,7,30,8,13797,13594,10821,-2773
2017,7,30,9,13613,13414,10863,-2551
2017,7,30,10,13561,13366,10577,-2789
2017,7,30,11,13453,13445,10874,-2571
2017,7,30,12,14049,14107,11831,-2276
2017,7,30,13,15137,15130,12231,-2899
2017,7,30,14,16479,16191,13111,-3080
2017,7,30,15,17320,17038,13817,-3221
2017,7,30,16,17893,17757,14540,-3217
2017,7,30,17,18275,18314,15028,-3286
2017,7,30,18,18576,18860,15640,-3220
2017,7,30,19,18881,19359,15912,-3447
2017,7,30,20,19220,19907,16147,-3760
2017,7,30,21,19599,20582,16696,-3886
2017,7,30,22,19824,21016,17676,-3340
2017,7,30,23,19646,20984,18155,-2829
2017,7,31,0,19191,20504,17666,-2838
2017,7,31,1,18863,20267,17061,-3206
2017,7,31,2,18789,20006,17210,-2796
2017,7,31,3,17920,18854,15664,-3190
2017,7,31,4,16810,17533,14171,-3362
2017,7,31,5,15753,16345,12986,-3359
2017,7,31,6,15028,15504,12684,-2820
2017,7,31,7,14567,14973,12669,-2304
2017,7,31,8,14342,14654,12140,-2514
2017,7,31,9,14474,14736,12147,-2589
2017,7,31,10,15160,15345,12843,-2502
2017,7,31,11,16260,16458,13226,-3232
2017,7,31,12,17953,18154,14709,-3445
2017,7,31,13,19466,19641,15718,-3923
2017,7,31,14,20855,20917,16823,-4094
2017,7,31,15,21885,21944,17969,-3975
2017,7,31,16,22657,22834,18845,-3989
2017,7,31,17,23266,23621,19352,-4269
2017,7,31,18,23895,24400,20324,-4076
2017,7,31,19,24373,25124,21319,-3805
2017,7,31,20,24776,25788,22367,-3421
2017,7,31,21,25053,26292,22809,-3483
2017,7,31,22,24911,26327,22819,-3508
2017,7,31,23,24214,25681,22001,-3680
2017,8,1,0,23385,24736,20775,-3961
2017,8,1,1,22679,24109,20349,-3760
2017,8,1,2,22193,23313,19752,-3561
2017,8,1,3,20732,21720,18169,-3551
2017,8,1,4,19026,19977,15676,-4301
2017,8,1,5,17290,18499,14127,-4372
2017,8,1,6,16351,17464,13509,-3955
2017,8,1,7,15755,16758,12567,-4191
2017,8,1,8,15443,16354,12190,-4164
2017,8,1,9,15521,16302,12277,-4025
2017,8,1,10,16167,16888,13131,-3757
2017,8,1,11,17342,18106,14419,-3687
2017,8,1,12,19065,19922,16962,-2960
2017,8,1,13,20735,21453,17711,-3742
2017,8,1,14,22286,22745,18664,-4081
2017,8,1,15,23359,23985,19722,-4263
2017,8,1,16,24188,24977,21005,-3972
2017,8,1,17,24836,25771,22218,-3553
2017,8,1,18,25454,26490,23215,-3275
2017,8,1,19,25889,27120,24071,-3049
2017,8,1,20,26242,27650,24417,-3233
2017,8,1,21,26447,27999,24831,-3168
2017,8,1,22,26205,27958,24745,-3213
2017,8,1,23,25383,27274,23911,-3363
2017,8,2,0,24425,26206,23140,-3066
2017,8,2,1,24046,25487,22445,-3042
2017,8,2,2,23264,24682,21566,-3116
2017,8,2,3,21602,22960,19678,-3282
2017,8,2,4,19845,21117,17045,-4072
2017,8,2,5,18634,19563,15093,-4470
2017,8,2,6,17602,18522,13757,-4765
2017,8,2,7,16903,17795,13506,-4289
2017,8,2,8,16512,17358,13300,-4058
2017,8,2,9,16522,17320,13246,-4074
2017,8,2,10,17129,17933,13471,-4462
2017,8,2,11,18345,19161,14886,-4275
2017,8,2,12,20017,20839,16617,-4222
2017,8,2,13,21647,22168,17864,-4304
2017,8,2,14,23148,23290,18818,-4472
2017,8,2,15,24131,24587,20706,-3881
2017,8,2,16,24876,25552,22145,-3407
2017,8,2,17,25410,26276,22923,-3353
2017,8,2,18,25933,26606,22847,-3759
2017,8,2,19,26313,26692,23514,-3178
2017,8,2,20,26597,26693,23853,-2840
2017,8,2,21,26789,26436,23551,-2885
2017,8,2,22,26567,25507,22358,-3149
2017,8,2,23,25754,24527,21860,-2667
2017,8,3,0,24823,23758,20818,-2940
2017,8,3,1,24524,23394,20161,-3233
2017,8,3,2,23751,22752,19505,-3247
2017,8,3,3,22098,21299,17791,-3508
2017,8,3,4,20313,19560,15695,-3865
2017,8,3,5,18920,18244,14675,-3569
2017,8,3,6,17805,17332,14359,-2973
2017,8,3,7,17048,16726,13625,-3101
2017,8,3,8,16613,16325,13142,-3183
2017,8,3,9,16607,16350,13145,-3205
2017,8,3,10,17225,16989,13582,-3407
2017,8,3,11,18504,18115,14921,-3194
2017,8,3,12,20259,19831,16468,-3363
2017,8,3,13,22012,21342,18056,-3286
2017,8,3,14,23922,22492,18760,-3732
2017,8,3,15,24769,23688,19810,-3878
2017,8,3,16,25264,24697,21212,-3485
2017,8,3,17,25503,25493,21852,-3641
2017,8,3,18,25776,26297,22995,-3302
2017,8,3,19,25976,26907,23520,-3387
2017,8,3,20,26171,27395,23818,-3577
2017,8,3,21,26360,27528,24426,-3102
2017,8,3,22,26228,27161,24441,-2720
2017,8,3,23,25486,26172,23661,-2511
2017,8,4,0,24645,25168,22727,-2441
2017,8,4,1,24411,24690,22022,-2668
2017,8,4,2,23702,23967,20684,-3283
2017,8,4,3,22132,22619,18700,-3919
2017,8,4,4,20402,20835,16618,-4217
2017,8,4,5,18568,19346,15195,-4151
2017,8,4,6,17505,18346,14312,-4034
2017,8,4,7,16795,17695,13644,-4051
2017,8,4,8,16397,17327,13527,-3800
2017,8,4,9,16408,17352,13857,-3495
2017,8,4,10,17013,17968,14673,-3295
2017,8,4,11,18250,19217,15762,-3455
2017,8,4,12,20011,20734,16789,-3945
2017,8,4,13,21838,21893,18040,-3853
2017,8,4,14,23934,23041,19225,-3816
2017,8,4,15,24769,24306,20588,-3718
2017,8,4,16,25217,25338,21690,-3648
2017,8,4,17,25378,25973,21812,-4161
2017,8,4,18,25548,26322,22282,-4040
2017,8,4,19,25652,26515,22899,-3616
2017,8,4,20,25762,26592,22571,-4021
2017,8,4,21,25867,26488,22419,-4069
2017,8,4,22,25656,25990,22405,-3585
2017,8,4,23,24881,25125,21829,-3296
2017,8,5,0,24022,24276,20784,-3492
2017,8,5,1,23764,23781,20698,-3083
2017,8,5,2,23203,23058,19827,-3231
2017,8,5,3,21916,21796,17825,-3971
2017,8,5,4,20311,20300,15954,-4346
2017,8,5,5,18051,19016,14821,-4195
2017,8,5,6,17062,18059,13787,-4272
2017,8,5,7,16421,17472,12837,-4635
2017,8,5,8,15997,17036,12734,-4302
2017,8,5,9,15799,16821,12310,-4511
2017,8,5,10,15815,16841,12912,-3929
2017,8,5,11,16015,16919,12800,-4119
2017,8,5,12,16736,17524,13296,-4228
2017,8,5,13,18009,18600,14501,-4099
2017,8,5,14,19870,19514,15177,-4337
2017,8,5,15,20472,20211,16609,-3602
2017,8,5,16,20743,20573,17314,-3259
2017,8,5,17,20761,20832,17616,-3216
2017,8,5,18,20618,20781,17327,-3454
2017,8,5,19,20481,20735,16946,-3789
2017,8,5,20,20427,20863,17137,-3726
2017,8,5,21,20507,21062,17691,-3371
2017,8,5,22,20533,20966,17784,-3182
2017,8,5,23,20267,20439,17517,-2922
2017,8,6,0,19777,19626,17004,-2622
2017,8,6,1,19652,19307,16676,-2631
2017,8,6,2,19337,18930,16664,-2266
2017,8,6,3,18560,18088,15199,-2889
2017,8,6,4,17656,16999,13876,-3123
2017,8,6,5,16723,15986,12403,-3583
2017,8,6,6,15767,15126,11308,-3818
2017,8,6,7,15050,14516,10840,-3676
2017,8,6,8,14563,14103,10642,-3461
2017,8,6,9,14304,13892,10552,-3340
2017,8,6,10,14189,13865,10473,-3392
2017,8,6,11,14044,13867,10878,-2989
2017,8,6,12,14585,14503,11256,-3247
2017,8,6,13,15830,15434,11598,-3836
2017,8,6,14,17728,16232,12174,-4058
2017,8,6,15,18368,16988,13392,-3596
2017,8,6,16,18662,17558,14325,-3233
2017,8,6,17,18753,18022,14830,-3192
2017,8,6,18,18757,18212,14819,-3393
2017,8,6,19,18774,18430,15048,-3382
2017,8,6,20,18884,18579,15070,-3509
2017,8,6,21,19151,18848,15116,-3732
2017,8,6,22,19286,19034,15227,-3807
2017,8,6,23,19093,18906,15224,-3682
2017,8,7,0,18702,18661,15046,-3615
2017,8,7,1,18851,18839,15079,-3760
2017,8,7,2,18531,18575,14855,-3720
2017,8,7,3,17579,17591,13316,-4275
2017,8,7,4,16561,16411,12240,-4171
2017,8,7,5,15606,15460,11217,-4243
2017,8,7,6,15015,14792,10860,-3932
2017,8,7,7,14613,14387,10527,-3860
2017,8,7,8,14428,14236,10336,-3900
2017,8,7,9,14561,14403,10465,-3938
2017,8,7,10,15223,15167,11186,-3981
2017,8,7,11,16357,16378,11934,-4444
2017,8,7,12,17675,17863,13057,-4806
2017,8,7,13,18908,19113,14404,-4709
2017,8,7,14,20214,19933,14886,-5047
2017,8,7,15,20659,20534,15970,-4564
2017,8,7,16,20824,20867,16280,-4587
2017,8,7,17,20825,20971,16666,-4305
2017,8,7,18,20888,21035,16883,-4152
2017,8,7,19,20917,20903,16569,-4334
2017,8,7,20,20960,20688,16177,-4511
2017,8,7,21,21046,20512,16096,-4416
2017,8,7,22,20953,20292,16235,-4057
2017,8,7,23,20525,19931,16267,-3664
2017,8,8,0,20092,19635,16218,-3417
2017,8,8,1,20200,19503,15854,-3649
2017,8,8,2,19729,18910,15182,-3728
2017,8,8,3,18533,17729,13826,-3903
2017,8,8,4,17244,16485,12685,-3800
2017,8,8,5,15573,15434,11444,-3990
2017,8,8,6,14839,14733,10725,-4008
2017,8,8,7,14364,14353,10374,-3979
2017,8,8,8,14133,14166,10230,-3936
2017,8,8,9,14242,14308,10571,-3737
2017,8,8,10,14896,15084,11082,-4002
2017,8,8,11,16075,16339,12234,-4105
2017,8,8,12,17432,17776,13339,-4437
2017,8,8,13,18671,18848,14757,-4091
2017,8,8,14,19998,19556,15502,-4054
2017,8,8,15,20468,20080,15412,-4668
2017,8,8,16,20680,20398,15941,-4457
2017,8,8,17,20767,20701,16396,-4305
2017,8,8,18,20925,21065,16710,-4355
2017,8,8,19,21063,21374,17090,-4284
2017,8,8,20,21257,21680,17170,-4510
2017,8,8,21,21501,21985,17703,-4282
2017,8,8,22,21493,22048,17966,-4082
2017,8,8,23,21039,21715,17626,-4089
2017,8,9,0,20472,21057,17594,-3463
2017,8,9,1,20383,20769,17230,-3539
2017,8,9,2,19893,20171,16780,-3391
2017,8,9,3,18619,18887,15429,-3458
2017,8,9,4,17225,17403,13643,-3760
2017,8,9,5,15536,16223,12691,-3532
2017,8,9,6,14720,15394,12231,-3163
2017,8,9,7,14204,14802,12066,-2736
2017,8,9,8,13941,14500,11843,-2657
2017,8,9,9,14018,14520,11888,-2632
2017,8,9,10,14650,15150,12283,-2867
2017,8,9,11,15719,16262,12951,-3311
2017,8,9,12,17174,17818,14349,-3469
2017,8,9,13,18506,19096,15375,-3721
2017,8,9,14,19769,20047,16131,-3916
2017,8,9,15,20424,20820,16660,-4160
2017,8,9,16,20843,21506,17659,-3847
2017,8,9,17,21132,22161,18697,-3464
2017,8,9,18,21505,22833,19321,-3512
2017,8,9,19,21815,23434,19757,-3677
2017,8,9,20,22132,23873,19948,-3925
2017,8,9,21,22411,24173,20586,-3587
2017,8,9,22,22316,24236,21188,-3048
2017,8,9,23,21658,23579,20757,-2822
2017,8,10,0,20891,22681,19815,-2866
2017,8,10,1,20716,22336,19164,-3172
2017,8,10,2,20143,21621,18313,-3308
2017,8,10,3,18779,20107,16487,-3620
2017,8,10,4,17317,18469,14029,-4440
2017,8,10,5,16329,17128,12449,-4679
2017,8,10,6,15489,16205,11639,-4566
2017,8,10,7,14944,15538,11445,-4093
2017,8,10,8,14658,15210,11235,-3975
2017,8,10,9,14735,15228,11535,-3693
2017,8,10,10,15393,15856,11861,-3995
2017,8,10,11,16509,16983,12792,-4191
2017,8,10,12,18008,18605,14239,-4366
2017,8,10,13,19416,20083,15884,-4199
2017,8,10,14,20643,21294,16906,-4388
2017,8,10,15,21462,22308,18251,-4057
2017,8,10,16,22053,23168,19341,-3827
2017,8,10,17,22499,23808,19987,-3821
2017,8,10,18,22964,24426,20391,-4035
2017,8,10,19,23318,24830,20949,-3881
2017,8,10,20,23597,25115,21798,-3317
2017,8,10,21,23812,25300,21876,-3424
2017,8,10,22,23664,24990,21685,-3305
2017,8,10,23,22954,24101,20740,-3361
2017,8,11,0,22129,23133,19691,-3442
2017,8,11,1,21928,22739,18879,-3860
2017,8,11,2,21260,21955,18063,-3892
2017,8,11,3,19797,20485,16285,-4200
2017,8,11,4,18225,18824,14019,-4805
2017,8,11,5,16703,17486,12960,-4526
2017,8,11,6,15748,16564,12229,-4335
2017,8,11,7,15122,15961,11917,-4044
2017,8,11,8,14783,15612,11685,-3927
2017,8,11,9,14824,15568,11509,-4059
2017,8,11,10,15491,16153,12022,-4131
2017,8,11,11,16700,17232,13267,-3965
2017,8,11,12,18221,18769,14902,-3867
2017,8,11,13,19667,20184,16198,-3986
2017,8,11,14,21030,21222,17275,-3947
2017,8,11,15,21652,22135,18775,-3360
2017,8,11,16,21994,22808,19678,-3130
2017,8,11,17,22154,23246,19819,-3427
2017,8,11,18,22377,23570,20232,-3338
2017,8,11,19,22549,23699,20273,-3426
2017,8,11,20,22680,23645,20330,-3315
2017,8,11,21,22766,23566,20400,-3166
2017,8,11,22,22523,23263,20384,-2879
2017,8,11,23,21767,22512,19443,-3069
2017,8,12,0,20959,21894,18687,-3207
2017,8,12,1,20856,21675,18428,-3247
2017,8,12,2,20339,21013,17410,-3603
2017,8,12,3,19144,19846,16172,-3674
2017,8,12,4,17784,18574,14711,-3863
2017,8,12,5,16517,17436,13380,-4056
2017,8,12,6,15642,16531,12512,-4019
2017,8,12,7,15033,15691,11967,-3724
2017,8,12,8,14642,15238,11627,-3611
2017,8,12,9,14497,15049,11666,-3383
2017,8,12,10,14611,15186,11741,-3445
2017,8,12,11,14934,15439,11872,-3567
2017,8,12,12,15713,16226,12700,-3526
2017,8,12,13,17115,17395,13602,-3793
2017,8,12,14,19336,18612,14868,-3744
2017,8,12,15,19911,19532,16001,-3531
2017,8,12,16,20085,20098,16497,-3601
2017,8,12,17,19987,20418,16811,-3607
2017,8,12,18,19755,20649,17076,-3573
2017,8,12,19,19565,20746,17303,-3443
2017,8,12,20,19479,20905,17731,-3174
2017,8,12,21,19585,21213,17691,-3522
2017,8,12,22,19659,21313,18095,-3218
2017,8,12,23,19497,20970,18318,-2652
2017,8,13,0,19187,20585,17782,-2803
2017,8,13,1,19266,20762,17737,-3025
2017,8,13,2,18989,20422,17132,-3290
2017,8,13,3,18215,19537,15652,-3885
2017,8,13,4,17334,18441,14104,-4337
2017,8,13,5,16427,17408,13360,-4048
2017,8,13,6,15601,16616,12900,-3716
2017,8,13,7,14998,16026,12396,-3630
2017,8,13,8,14606,15610,11818,-3792
2017,8,13,9,14433,15407,11656,-3751
2017,8,13,10,14449,15388,11596,-3792
2017,8,13,11,14457,15387,11789,-3598
2017,8,13,12,15047,16097,12371,-3726
2017,8,13,13,16340,17342,13368,-3974
2017,8,13,14,18439,18499,14386,-4113
2017,8,13,15,19180,19512,15764,-3748
2017,8,13,16,19600,20277,16320,-3957
2017,8,13,17,19762,20790,16845,-3945
2017,8,13,18,19784,21228,17295,-3933
2017,8,13,19,19755,21555,17894,-3661
2017,8,13,20,19825,21903,18769,-3134
2017,8,13,21,20055,22317,19419,-2898
2017,8,13,22,20202,22493,19841,-2652
2017,8,13,23,20003,22179,19869,-2310
2017,8,14,0,19615,21535,19194,-2341
2017,8,14,1,19583,21511,18850,-2661
2017,8,14,2,19196,20946,18061,-2885
2017,8,14,3,18232,19754,16866,-2888
2017,8,14,4,17179,18381,14908,-3473
2017,8,14,5,16838,17193,13334,-3859
2017,8,14,6,16005,16327,12454,-3873
2017,8,14,7,15428,15764,12071,-3693
2017,8,14,8,15117,15488,11882,-3606
2017,8,14,9,15170,15598,11994,-3604
2017,8,14,10,15816,16288,12523,-3765
2017,8,14,11,16920,17396,13527,-3869
2017,8,14,12,18386,18834,14936,-3898
2017,8,14,13,19816,20133,15792,-4341
2017,8,14,14,21262,21313,16800,-4513
2017,8,14,15,21973,22180,17950,-4230
2017,8,14,16,22409,22806,19130,-3676
2017,8,14,17,22691,23260,19561,-3699
2017,8,14,18,23018,23787,20005,-3782
2017,8,14,19,23276,24053,20577,-3476
2017,8,14,20,23507,24132,20615,-3517
2017,8,14,21,23713,24117,20666,-3451
2017,8,14,22,23607,23938,20400,-3538
2017,8,14,23,23001,23467,20145,-3322
2017,8,15,0,22330,23034,19836,-3198
2017,8,15,1,22176,22980,19825,-3155
2017,8,15,2,21470,22227,19180,-3047
2017,8,15,3,20017,20840,17073,-3767
2017,8,15,4,18468,19253,15311,-3942
2017,8,15,5,17501,17902,13890,-4012
2017,8,15,6,16620,17061,13269,-3792
2017,8,15,7,16025,16480,12724,-3756
2017,8,15,8,15710,16127,12446,-3681
2017,8,15,9,15782,16173,12525,-3648
2017,8,15,10,16483,16824,13435,-3389
2017,8,15,11,17729,18068,14532,-3536
2017,8,15,12,19239,19492,15870,-3622
2017,8,15,13,20674,20715,17175,-3540
2017,8,15,14,22050,21647,17902,-3745
2017,8,15,15,22831,22374,18928,-3446
2017,8,15,16,23374,22908,19290,-3618
2017,8,15,17,23746,23171,19371,-3800
2017,8,15,18,24122,23319,19690,-3629
2017,8,15,19,24396,23212,19756,-3456
2017,8,15,20,24638,23077,19508,-3569
2017,8,15,21,24830,23117,19493,-3624
2017,8,15,22,24719,23153,19649,-3504
2017,8,15,23,24067,22797,19468,-3329
2017,8,16,0,23350,22465,18958,-3507
2017,8,16,1,23092,22415,18865,-3550
2017,8,16,2,22363,21655,18213,-3442
2017,8,16,3,20830,20361,16677,-3684
2017,8,16,4,19195,18863,14945,-3918
2017,8,16,5,17711,17625,13741,-3884
2017,8,16,6,16800,16766,12735,-4031
2017,8,16,7,16163,16169,11863,-4306
2017,8,16,8,15803,15849,11633,-4216
2017,8,16,9,15824,15892,11708,-4184
2017,8,16,10,16477,16611,12249,-4362
2017,8,16,11,17633,17805,13428,-4377
2017,8,16,12,19139,19315,15261,-4054
2017,8,16,13,20587,20689,16440,-4249
2017,8,16,14,22108,21670,17453,-4217
2017,8,16,15,22850,22671,18165,-4506
2017,8,16,16,23297,23410,19305,-4105
2017,8,16,17,23549,23982,20178,-3804
2017,8,16,18,23844,24563,21077,-3486
2017,8,16,19,24077,25035,21883,-3152
2017,8,16,20,24338,25358,22109,-3249
2017,8,16,21,24583,25545,22256,-3289
2017,8,16,22,24477,25475,22170,-3305
2017,8,16,23,23813,24743,21673,-3070
2017,8,17,0,23077,23766,21031,-2735
2017,8,17,1,22798,23409,20215,-3194
2017,8,17,2,22127,22559,18767,-3792
2017,8,17,3,20673,21032,17143,-3889
2017,8,17,4,19048,19330,15073,-4257
2017,8,17,5,17283,17945,13529,-4416
2017,8,17,6,16321,16922,12550,-4372
2017,8,17,7,15696,16197,12073,-4124
2017,8,17,8,15356,15733,11273,-4460
2017,8,17,9,15395,15641,11339,-4302
2017,8,17,10,16046,16214,12090,-4124
2017,8,17,11,17193,17284,13411,-3873
2017,8,17,12,18652,18603,14684,-3919
2017,8,17,13,20019,19730,15596,-4134
2017,8,17,14,21306,20803,16792,-4011
2017,8,17,15,21976,21670,17156,-4514
2017,8,17,16,22382,22420,17682,-4738
2017,8,17,17,22631,22928,18870,-4058
2017,8,17,18,22953,23490,20401,-3089
2017,8,17,19,23200,24006,20483,-3523
2017,8,17,20,23448,24496,20498,-3998
2017,8,17,21,23640,24662,21309,-3353
2017,8,17,22,23475,24498,21423,-3075
2017,8,17,23,22796,23805,20621,-3184
2017,8,18,0,22092,23225,19397,-3828
2017,8,18,1,21947,23237,19455,-3782
2017,8,18,2,21266,22554,18667,-3887
2017,8,18,3,19848,21410,17177,-4233
2017,8,18,4,18396,20046,16334,-3712
2017,8,18,5,17845,18924,14940,-3984
2017,8,18,6,17034,18150,14116,-4034
2017,8,18,7,16442,17663,13717,-3946
2017,8,18,8,16130,17390,13259,-4131
2017,8,18,9,16193,17502,13455,-4047
2017,8,18,10,16885,18298,14449,-3849
2017,8,18,11,18187,19657,15624,-4033
2017,8,18,12,19681,21180,17261,-3919
2017,8,18,13,21159,22506,18950,-3556
2017,8,18,14,22718,23482,20557,-2925
2017,8,18,15,23507,24207,21244,-2963
2017,8,18,16,24002,24825,21521,-3304
2017,8,18,17,24278,25433,21576,-3857
2017,8,18,18,24536,25821,22111,-3710
2017,8,18,19,24696,26022,22218,-3804
2017,8,18,20,24818,26245,21907,-4338
2017,8,18,21,24898,26308,22341,-3967
2017,8,18,22,24652,26026,22583,-3443
2017,8,18,23,23966,25473,22069,-3404
2017,8,19,0,23345,24741,21203,-3538
2017,8,19,1,23235,24082,20952,-3130
2017,8,19,2,22690,23159,20037,-3122
2017,8,19,3,21486,21839,18143,-3696
2017,8,19,4,20086,20383,16553,-3830
2017,8,19,5,19093,19028,15222,-3806
2017,8,19,6,18028,18095,14518,-3577
2017,8,19,7,17296,17403,13828,-3575
2017,8,19,8,16801,16947,13312,-3635
2017,8,19,9,16572,16739,13077,-3662
2017,8,19,10,16637,16829,13102,-3727
2017,8,19,11,16915,17049,13130,-3919
2017,8,19,12,17722,17994,14159,-3835
2017,8,19,13,19180,19484,15479,-4005
2017,8,19,14,21327,20803,16636,-4167
2017,8,19,15,22141,21896,17431,-4465
2017,8,19,16,22586,22674,18431,-4243
2017,8,19,17,22716,23217,19190,-4027
2017,8,19,18,22680,23547,19756,-3791
2017,8,19,19,22619,23769,20261,-3508
2017,8,19,20,22624,23939,20406,-3533
2017,8,19,21,22747,24103,21364,-2739
2017,8,19,22,22767,24035,21385,-2650
2017,8,19,23,22415,23569,20348,-3221
2017,8,20,0,21954,22864,19240,-3624
2017,8,20,1,21769,22749,18705,-4044
2017,8,20,2,21303,22102,18188,-3914
2017,8,20,3,20375,21035,17297,-3738
2017,8,20,4,19306,19739,16459,-3280
2017,8,20,5,18270,18586,14948,-3638
2017,8,20,6,17271,17565,13688,-3877
2017,8,20,7,16527,16734,12964,-3770
2017,8,20,8,16023,16160,12428,-3732
2017,8,20,9,15764,15801,12227,-3574
2017,8,20,10,15742,15642,12161,-3481
2017,8,20,11,15758,15576,12027,-3549
2017,8,20,12,16411,16187,12784,-3403
2017,8,20,13,17852,17315,13640,-3675
2017,8,20,14,20182,18429,14458,-3971
2017,8,20,15,21067,19371,15623,-3748
2017,8,20,16,21563,20188,16557,-3631
2017,8,20,17,21761,20827,17348,-3479
2017,8,20,18,21792,21347,18193,-3154
2017,8,20,19,21788,21751,18448,-3303
2017,8,20,20,21910,22178,18713,-3465
2017,8,20,21,22198,22629,19145,-3484
2017,8,20,22,22389,22871,19310,-3561
2017,8,20,23,22139,22604,19210,-3394
2017,8,21,0,21720,21986,18781,-3205
2017,8,21,1,21534,22030,18977,-3053
2017,8,21,2,20980,21252,18113,-3139
2017,8,21,3,19871,20026,16697,-3329
2017,8,21,4,18700,18637,15203,-3434
2017,8,21,5,17636,17511,13611,-3900
2017,8,21,6,16808,16689,12885,-3804
2017,8,21,7,16202,16147,12379,-3768
2017,8,21,8,15871,15880,12380,-3500
2017,8,21,9,15931,15974,12426,-3548
2017,8,21,10,16640,16649,12924,-3725
2017,8,21,11,17823,17792,13991,-3801
2017,8,21,12,19457,19312,15699,-3613
2017,8,21,13,21104,20786,16903,-3883
2017,8,21,14,22770,22068,18288,-3780
2017,8,21,15,23782,23306,19692,-3614
2017,8,21,16,24501,24328,20477,-3851
2017,8,21,17,25017,25257,21893,-3364
2017,8,21,18,25537,26154,22991,-3163
2017,8,21,19,25935,26247,23499,-2748
2017,8,21,20,26276,26043,22945,-3098
2017,8,21,21,26533,26670,23483,-3187
2017,8,21,22,26398,26817,23452,-3365
2017,8,21,23,25676,26231,22820,-3411
2017,8,22,0,24931,25489,22243,-3246
2017,8,22,1,24533,25354,22086,-3268
2017,8,22,2,23646,24383,21116,-3267
2017,8,22,3,22036,22782,19218,-3564
2017,8,22,4,20329,21026,17213,-3813
2017,8,22,5,18927,19619,15675,-3944
2017,8,22,6,17977,18659,15165,-3494
2017,8,22,7,17324,18007,14403,-3604
2017,8,22,8,16973,17648,14288,-3360
2017,8,22,9,17025,17733,14584,-3149
2017,8,22,10,17754,18483,15009,-3474
2017,8,22,11,19096,19872,16544,-3328
2017,8,22,12,20757,21499,18143,-3356
2017,8,22,13,22393,23017,19114,-3903
2017,8,22,14,23976,24398,20483,-3915
2017,8,22,15,25088,25532,21965,-3567
2017,8,22,16,25945,26653,23616,-3037
2017,8,22,17,26581,27526,24455,-3071
2017,8,22,18,27172,28300,25778,-2522
2017,8,22,19,27576,28740,26375,-2365
2017,8,22,20,27872,28968,26658,-2310
2017,8,22,21,28025,28941,26781,-2160
2017,8,22,22,27767,28741,26793,-1948
2017,8,22,23,26960,27785,25876,-1909
2017,8,23,0,26231,27073,24990,-2083
2017,8,23,1,25891,26678,24792,-1886
2017,8,23,2,24948,25363,23652,-1711
2017,8,23,3,23232,23669,21568,-2101
2017,8,23,4,21336,21466,19102,-2364
2017,8,23,5,19303,19866,16459,-3407
2017,8,23,6,18271,18808,15006,-3802
2017,8,23,7,17612,18120,14296,-3824
2017,8,23,8,17232,17683,14134,-3549
2017,8,23,9,17211,17659,14204,-3455
2017,8,23,10,17802,18318,14850,-3468
2017,8,23,11,18906,19468,15928,-3540
2017,8,23,12,20162,20592,16813,-3779
2017,8,23,13,21340,21356,17724,-3632
2017,8,23,14,22508,21964,18325,-3639
2017,8,23,15,23025,22495,19688,-2807
2017,8,23,16,23243,22916,19820,-3096
2017,8,23,17,23274,23230,20119,-3111
2017,8,23,18,23331,23611,20869,-2742
2017,8,23,19,23337,23839,21352,-2487
2017,8,23,20,23388,23939,21829,-2110
2017,8,23,21,23475,24002,21758,-2244
2017,8,23,22,23344,23843,21573,-2270
2017,8,23,23,22724,23081,20605,-2476
2017,8,24,0,22183,22301,19254,-3047
2017,8,24,1,21937,22012,18817,-3195
2017,8,24,2,21236,21068,17810,-3258
2017,8,24,3,19920,19613,16220,-3393
2017,8,24,4,18478,18114,14634,-3480
2017,8,24,5,16935,16869,13212,-3657
2017,8,24,6,16022,15991,12712,-3279
2017,8,24,7,15398,15394,12189,-3205
2017,8,24,8,15050,15079,11751,-3328
2017,8,24,9,15065,15093,12087,-3006
2017,8,24,10,15705,15721,12647,-3074
2017,8,24,11,16829,16846,13424,-3422
2017,8,24,12,18163,18221,14725,-3496
2017,8,24,13,19345,19376,15660,-3716
2017,8,24,14,20569,20228,16310,-3918
2017,8,24,15,20980,20863,17107,-3756
2017,8,24,16,21084,21298,17609,-3689
2017,8,24,17,21020,21447,17765,-3682
2017,8,24,18,21071,21554,18667,-2887
2017,8,24,19,21121,21727,19059,-2668
2017,8,24,20,21244,21918,19009,-2909
2017,8,24,21,21418,22050,18896,-3154
2017,8,24,22,21341,22028,18726,-3302
2017,8,24,23,20773,21424,18521,-2903
2017,8,25,0,20345,20810,17681,-3129
2017,8,25,1,20276,20733,17674,-3059
2017,8,25,2,19639,19873,16514,-3359
2017,8,25,3,18397,18596,14830,-3766
2017,8,25,4,17037,17196,13546,-3650
2017,8,25,5,15523,16079,12123,-3956
2017,8,25,6,14750,15272,11639,-3633
2017,8,25,7,14253,14748,11362,-3386
2017,8,25,8,14005,14465,11129,-3336
2017,8,25,9,14088,14503,11068,-3435
2017,8,25,10,14780,15140,11939,-3201
2017,8,25,11,15961,16252,12652,-3600
2017,8,25,12,17229,17508,13776,-3732
2017,8,25,13,18331,18669,14971,-3698
2017,8,25,14,19338,19556,15725,-3831
2017,8,25,15,19753,20227,16234,-3993
2017,8,25,16,19863,20615,16726,-3889
2017,8,25,17,19819,20870,17064,-3806
2017,8,25,18,19865,21086,17052,-4034
2017,8,25,19,19911,21207,17324,-3883
2017,8,25,20,19997,21171,17114,-4057
2017,8,25,21,20101,21108,16957,-4151
2017,8,25,22,19951,20851,16818,-4033
2017,8,25,23,19365,20213,16302,-3911
2017,8,26,0,18885,19794,16326,-3468
2017,8,26,1,18733,19717,16390,-3327
2017,8,26,2,18212,18890,15552,-3338
2017,8,26,3,17226,17778,13997,-3781
2017,8,26,4,16094,16584,12637,-3947
2017,8,26,5,14909,15502,11389,-4113
2017,8,26,6,14117,14717,10940,-3777
2017,8,26,7,13592,14163,10535,-3628
2017,8,26,8,13275,13831,10475,-3356
2017,8,26,9,13186,13678,10431,-3247
2017,8,26,10,13376,13851,10807,-3044
2017,8,26,11,13608,14191,11108,-3083
2017,8,26,12,14247,14904,11461,-3443
2017,8,26,13,15400,15895,11993,-3902
2017,8,26,14,16669,16784,12600,-4184
2017,8,26,15,17211,17374,13424,-3950
2017,8,26,16,17390,17747,13996,-3751
2017,8,26,17,17383,17958,14249,-3709
2017,8,26,18,17309,18100,14309,-3791
2017,8,26,19,17277,18274,14604,-3670
2017,8,26,20,17355,18442,14711,-3731
2017,8,26,21,17579,18614,14802,-3812
2017,8,26,22,17707,18732,14850,-3882
2017,8,26,23,17494,18494,14794,-3700
2017,8,27,0,17257,18197,14529,-3668
2017,8,27,1,17284,18257,14915,-3342
2017,8,27,2,16856,17609,14049,-3560
2017,8,27,3,16046,16650,12749,-3901
2017,8,27,4,15185,15593,12046,-3547
2017,8,27,5,14302,14786,11399,-3387
2017,8,27,6,13629,14251,10994,-3257
2017,8,27,7,13155,13731,10738,-2993
2017,8,27,8,12865,13458,10300,-3158
2017,8,27,9,12755,13297,10119,-3178
2017,8,27,10,12849,13353,10535,-2818
2017,8,27,11,12876,13432,10915,-2517
2017,8,27,12,13291,13916,11190,-2726
2017,8,27,13,14305,14808,11793,-3015
2017,8,27,14,15547,15655,12382,-3273
2017,8,27,15,16221,16326,13105,-3221
2017,8,27,16,16606,16852,13641,-3211
2017,8,27,17,16823,17289,14143,-3146
2017,8,27,18,16956,17590,14352,-3238
2017,8,27,19,17068,17712,14208,-3504
2017,8,27,20,17245,17957,14479,-3478
2017,8,27,21,17538,18290,14648,-3642
2017,8,27,22,17730,18576,15040,-3536
2017,8,27,23,17586,18375,15367,-3008
2017,8,28,0,17490,18265,15475,-2790
2017,8,28,1,17651,18529,15676,-2853
2017,8,28,2,17160,17827,15090,-2737
2017,8,28,3,16222,16849,13794,-3055
2017,8,28,4,15232,15784,12946,-2838
2017,8,28,5,14112,14884,12050,-2834
2017,8,28,6,13553,14260,11544,-2716
2017,8,28,7,13212,13881,11255,-2626
2017,8,28,8,13076,13718,11162,-2556
2017,8,28,9,13246,13850,11398,-2452
2017,8,28,10,14017,14572,12012,-2560
2017,8,28,11,15240,15761,13209,-2552
2017,8,28,12,16511,17129,14476,-2653
2017,8,28,13,17633,18332,15484,-2848
2017,8,28,14,18742,19191,15886,-3305
2017,8,28,15,19202,19702,16617,-3085
2017,8,28,16,19385,20027,16709,-3318
2017,8,28,17,19417,20212,17139,-3073
2017,8,28,18,19525,20424,17384,-3040
2017,8,28,19,19611,20493,17095,-3398
2017,8,28,20,19709,20517,17091,-3426
2017,8,28,21,19876,20592,17163,-3429
2017,8,28,22,19839,20431,17276,-3155
2017,8,28,23,19409,19946,17063,-2883
2017,8,29,0,19160,19676,17052,-2624
2017,8,29,1,19147,19657,17379,-2278
2017,8,29,2,18427,18757,16397,-2360
2017,8,29,3,17212,17453,14310,-3143
2017,8,29,4,15912,16103,12832,-3271
2017,8,29,5,14412,15139,12340,-2799
2017,8,29,6,13727,14422,11486,-2936
2017,8,29,7,13322,14007,11370,-2637
2017,8,29,8,13142,13799,11288,-2511
2017,8,29,9,13286,13929,11564,-2365
2017,8,29,10,14053,14645,11924,-2721
2017,8,29,11,15432,16027,12901,-3126
2017,8,29,12,16628,17263,13894,-3369
2017,8,29,13,17631,18289,14710,-3579
2017,8,29,14,18610,18924,15206,-3718
2017,8,29,15,18907,19303,15951,-3352
2017,8,29,16,18975,19490,16087,-3403
2017,8,29,17,18923,19473,16141,-3332
2017,8,29,18,18965,19579,16222,-3357
2017,8,29,19,19005,19604,16464,-3140
2017,8,29,20,19048,19593,16304,-3289
2017,8,29,21,19169,19520,16283,-3237
2017,8,29,22,19133,19398,16288,-3110
2017,8,29,23,18738,19077,16268,-2809
2017,8,30,0,18597,18979,16046,-2933
2017,8,30,1,18700,18778,15884,-2894
2017,8,30,2,17990,17934,14955,-2979
2017,8,30,3,16797,16705,13490,-3215
2017,8,30,4,15553,15418,12396,-3022
2017,8,30,5,14193,14397,11297,-3100
2017,8,30,6,13540,13840,10851,-2989
2017,8,30,7,13126,13422,10750,-2672
2017,8,30,8,12942,13260,10759,-2501
2017,8,30,9,13070,13389,10841,-2548
2017,8,30,10,13825,14095,11181,-2914
2017,8,30,11,15180,15393,12265,-3128
2017,8,30,12,16384,16665,13680,-2985
2017,8,30,13,17419,17708,14586,-3122
2017,8,30,14,18458,18318,14877,-3441
2017,8,30,15,18830,18805,15611,-3194
2017,8,30,16,18974,19165,15920,-3245
2017,8,30,17,18972,19425,15776,-3649
2017,8,30,18,19082,19802,15786,-4016
2017,8,30,19,19225,20128,15926,-4202
2017,8,30,20,19441,20502,16115,-4387
2017,8,30,21,19748,20842,16809,-4033
2017,8,30,22,19838,20880,16939,-3941
2017,8,30,23,19389,20389,16873,-3516
2017,8,31,0,19133,20064,16648,-3416
2017,8,31,1,19051,19967,16802,-3165
2017,8,31,2,18376,19152,16113,-3039
2017,8,31,3,17208,17927,14668,-3259
2017,8,31,4,15950,16527,13048,-3479
2017,8,31,5,14787,15405,12187,-3218
2017,8,31,6,14105,14691,11461,-3230
2017,8,31,7,13694,14211,11088,-3123
2017,8,31,8,13519,13995,11266,-2729
2017,8,31,9,13667,14059,11639,-2420
2017,8,31,10,14462,14804,12201,-2603
2017,8,31,11,15784,16173,13261,-2912
2017,8,31,12,17080,17502,14352,-3150
2017,8,31,13,18136,18636,15097,-3539
2017,8,31,14,19080,19570,15740,-3830
2017,8,31,15,19598,20236,16196,-4040
2017,8,31,16,19881,20758,16680,-4078
2017,8,31,17,20063,21166,17107,-4059
2017,8,31,18,20290,21514,17561,-3953
2017,8,31,19,20440,21563,17940,-3623
2017,8,31,20,20564,21401,17859,-3542
2017,8,31,21,20684,21204,17595,-3609
2017,8,31,22,20557,21035,17502,-3533
2017,8,31,23,20082,20356,17146,-3210
2017,9,1,0,19879,19984,16881,-3103
2017,9,1,1,19839,19749,16659,-3090
2017,9,1,2,19070,18783,15543,-3240
2017,9,1,3,17817,17505,14437,-3068
2017,9,1,4,16439,16144,12782,-3362
2017,9,1,5,14620,14971,11733,-3238
2017,9,1,6,13788,14163,11211,-2952
2017,9,1,7,13289,13666,11072,-2594
2017,9,1,8,13045,13394,10994,-2400
2017,9,1,9,13141,13329,10967,-2362
2017,9,1,10,13931,14028,11302,-2726
2017,9,1,11,15292,15113,12030,-3083
2017,9,1,12,16492,16226,13110,-3116
2017,9,1,13,17387,17103,13423,-3680
2017,9,1,14,17989,17622,13461,-4161
2017,9,1,15,18103,17945,13937,-4008
2017,9,1,16,17977,18092,14120,-3972
2017,9,1,17,17767,18144,14444,-3700
2017,9,1,18,17686,18284,14955,-3329
2017,9,1,19,17617,18369,14838,-3531
2017,9,1,20,17588,18397,14944,-3453
2017,9,1,21,17630,18382,14971,-3411
2017,9,1,22,17543,18274,15180,-3094
2017,9,1,23,17151,17889,14688,-3201
2017,9,2,0,17021,17834,14727,-3107
2017,9,2,1,17098,17799,14491,-3308
2017,9,2,2,16456,17090,13907,-3183
2017,9,2,3,15514,16106,13283,-2823
2017,9,2,4,14504,14912,11845,-3067
2017,9,2,5,13818,13971,10800,-3171
2017,9,2,6,13205,13338,10241,-3097
2017,9,2,7,12812,12900,10000,-2900
2017,9,2,8,12598,12683,10065,-2618
2017,9,2,9,12590,12632,10037,-2595
2017,9,2,10,12886,12800,9981,-2819
2017,9,2,11,13248,13171,10176,-2995
2017,9,2,12,13749,13778,10756,-3022
2017,9,2,13,14658,14664,11426,-3238
2017,9,2,14,15597,15361,11693,-3668
2017,9,2,15,15845,15797,12248,-3549
2017,9,2,16,15780,15960,12280,-3680
2017,9,2,17,15589,15956,12234,-3722
2017,9,2,18,15345,15908,12158,-3750
2017,9,2,19,15185,15856,12163,-3693
2017,9,2,20,15105,15891,12262,-3629
2017,9,2,21,15264,15974,12538,-3436
2017,9,2,22,15443,16166,12980,-3186
2017,9,2,23,15508,16220,13029,-3191
2017,9,3,0,15817,16548,13216,-3332
2017,9,3,1,16224,16655,13247,-3408
2017,9,3,2,15745,16136,13211,-2925
2017,9,3,3,15056,15330,13097,-2233
2017,9,3,4,14364,14459,12108,-2351
2017,9,3,5,13520,13655,11551,-2104
2017,9,3,6,12996,13098,11350,-1748
2017,9,3,7,12634,12679,11238,-1441
2017,9,3,8,12429,12483,11206,-1277
2017,9,3,9,12358,12433,11285,-1148
2017,9,3,10,12435,12547,11323,-1224
2017,9,3,11,12479,12866,11422,-1444
2017,9,3,12,12546,13420,11763,-1657
2017,9,3,13,13268,14386,12044,-2342
2017,9,3,14,14255,15270,12097,-3173
2017,9,3,15,14810,15989,12418,-3571
2017,9,3,16,15153,16378,13187,-3191
2017,9,3,17,15365,16522,13271,-3251
2017,9,3,18,15438,16469,13409,-3060
2017,9,3,19,15504,16446,13452,-2994
2017,9,3,20,15637,16391,13456,-2935
2017,9,3,21,15943,16469,13527,-2942
2017,9,3,22,16204,16630,13719,-2911
2017,9,3,23,16287,16631,13823,-2808
2017,9,4,0,16545,16783,13884,-2899
2017,9,4,1,16942,16937,13747,-3190
2017,9,4,2,16472,16381,13602,-2779
2017,9,4,3,15732,15591,13046,-2545
2017,9,4,4,14929,14674,11610,-3064
2017,9,4,5,13017,13868,11196,-2672
2017,9,4,6,12502,13253,10706,-2547
2017,9,4,7,12187,12882,11361,-1521
2017,9,4,8,12054,12667,11186,-1481
2017,9,4,9,12116,12623,11121,-1502
2017,9,4,10,12422,12859,11495,-1364
2017,9,4,11,12675,13209,11632,-1577
2017,9,4,12,13063,13756,11691,-2065
2017,9,4,13,14020,14718,12120,-2598
2017,9,4,14,15479,15655,12946,-2709
2017,9,4,15,16166,16432,13422,-3010
2017,9,4,16,16550,17010,14043,-2967
2017,9,4,17,16771,17344,14437,-2907
2017,9,4,18,16918,17613,14743,-2870
2017,9,4,19,17102,17937,15298,-2639
2017,9,4,20,17441,18373,15767,-2606
2017,9,4,21,17971,18806,16241,-2565
2017,9,4,22,18287,19080,16622,-2458
2017,9,4,23,18199,18915,16610,-2305
2017,9,5,0,18274,19093,16838,-2255
2017,9,5,1,18571,19306,17082,-2224
2017,9,5,2,17887,18630,16498,-2132
2017,9,5,3,16825,17432,15264,-2168
2017,9,5,4,15856,16169,13696,-2473
2017,9,5,5,15202,15248,13059,-2189
2017,9,5,6,14547,14630,12941,-1689
2017,9,5,7,14115,14302,12711,-1591
2017,9,5,8,13915,14126,12881,-1245
2017,9,5,9,14052,14289,12836,-1453
2017,9,5,10,14864,15188,13098,-2090
2017,9,5,11,16254,16737,13904,-2833
2017,9,5,12,17577,18183,14811,-3372
2017,9,5,13,18743,19222,15825,-3397
2017,9,5,14,19871,20275,16459,-3816
2017,9,5,15,20529,21152,17129,-4023
2017,9,5,16,20958,21813,18066,-3747
2017,9,5,17,21210,22464,18213,-4251
2017,9,5,18,21461,23029,18606,-4423
2017,9,5,19,21618,23433,18983,-4450
2017,9,5,20,21741,23714,19418,-4296
2017,9,5,21,21872,23871,19987,-3884
2017,9,5,22,21776,23742,19929,-3813
2017,9,5,23,21213,23032,19335,-3697
2017,9,6,0,21041,22785,19373,-3412
2017,9,6,1,20935,22159,19091,-3068
2017,9,6,2,19989,20898,17764,-3134
2017,9,6,3,18659,19325,16010,-3315
2017,9,6,4,17274,17793,15033,-2760
2017,9,6,5,16296,16549,13516,-3033
2017,9,6,6,15500,15722,12914,-2808
2017,9,6,7,14946,15171,12635,-2536
2017,9,6,8,14660,14898,12472,-2426
2017,9,6,9,14730,14979,12416,-2563
2017,9,6,10,15505,15833,13052,-2781
2017,9,6,11,16959,17500,14441,-3059
2017,9,6,12,18163,18880,16174,-2706
2017,9,6,13,19170,19741,16714,-3027
2017,9,6,14,20225,20314,17240,-3074
2017,9,6,15,20530,20491,17950,-2541
2017,9,6,16,20566,20479,18048,-2431
2017,9,6,17,20417,20336,17493,-2843
2017,9,6,18,20326,20263,17360,-2903
2017,9,6,19,20220,20087,17303,-2784
2017,9,6,20,20147,19949,17255,-2694
2017,9,6,21,20165,19875,17127,-2748
2017,9,6,22,20100,19861,16960,-2901
2017,9,6,23,19703,19518,16884,-2634
2017,9,7,0,19727,19524,16961,-2563
2017,9,7,1,19802,19167,16517,-2650
2017,9,7,2,18893,18183,15471,-2712
2017,9,7,3,17666,16825,13959,-2866
2017,9,7,4,16374,15534,12676,-2858
2017,9,7,5,15062,14551,11585,-2966
2017,9,7,6,14297,13928,10919,-3009
2017,9,7,7,13789,13549,10859,-2690
2017,9,7,8,13533,13365,11031,-2334
2017,9,7,9,13622,13484,11261,-2223
2017,9,7,10,14400,14310,11676,-2634
2017,9,7,11,15883,15920,12699,-3221
2017,9,7,12,17093,17077,13883,-3194
2017,9,7,13,18106,17887,14283,-3604
2017,9,7,14,19352,18466,14591,-3875
2017,9,7,15,19480,18797,14861,-3936
2017,9,7,16,19296,18992,14983,-4009
2017,9,7,17,18941,19066,14880,-4186
2017,9,7,18,18719,19252,15006,-4246
2017,9,7,19,18572,19392,15688,-3704
2017,9,7,20,18552,19508,16009,-3499
2017,9,7,21,18758,19627,15933,-3694
2017,9,7,22,18889,19595,15523,-4072
2017,9,7,23,18622,19176,15463,-3713
2017,9,8,0,18705,19159,15627,-3532
2017,9,8,1,18717,18958,15404,-3554
2017,9,8,2,17917,17990,14614,-3376
2017,9,8,3,16840,16524,12970,-3554
2017,9,8,4,15668,15162,12280,-2882
2017,9,8,5,14160,14202,11594,-2608
2017,9,8,6,13471,13535,11017,-2518
2017,9,8,7,13059,13167,10530,-2637
2017,9,8,8,12883,12944,10470,-2474
2017,9,8,9,13021,13068,10636,-2432
2017,9,8,10,13824,13922,11362,-2560
2017,9,8,11,15206,15492,12524,-2968
2017,9,8,12,16400,16681,13317,-3364
2017,9,8,13,17376,17461,13564,-3897
2017,9,8,14,18334,18019,14361,-3658
2017,9,8,15,18534,18325,14771,-3554
2017,9,8,16,18455,18511,14754,-3757
2017,9,8,17,18221,18654,14627,-4027
2017,9,8,18,18113,18778,15255,-3523
2017,9,8,19,18026,18750,15244,-3506
2017,9,8,20,18010,18726,15255,-3471
2017,9,8,21,18094,18750,15318,-3432
2017,9,8,22,18086,18652,15341,-3311
2017,9,8,23,17719,18255,15352,-2903
2017,9,9,0,17771,18214,15179,-3035
2017,9,9,1,17786,18024,14859,-3165
2017,9,9,2,17061,17238,14012,-3226
2017,9,9,3,16193,16119,12888,-3231
2017,9,9,4,15178,14916,11606,-3310
2017,9,9,5,13873,13940,10994,-2946
2017,9,9,6,13208,13281,10823,-2458
2017,9,9,7,12791,12829,10280,-2549
2017,9,9,8,12554,12599,10199,-2400
2017,9,9,9,12507,12566,10153,-2413
2017,9,9,10,12777,12838,10437,-2401
2017,9,9,11,13133,13309,11287,-2022
2017,9,9,12,13616,14009,11549,-2460
2017,9,9,13,14533,14950,11969,-2981
2017,9,9,14,15585,15602,12343,-3259
2017,9,9,15,15899,16064,12817,-3247
2017,9,9,16,15872,16240,13149,-3091
2017,9,9,17,15681,16307,13281,-3026
2017,9,9,18,15440,16329,13433,-2896
2017,9,9,19,15278,16289,13078,-3211
2017,9,9,20,15239,16311,13102,-3209
2017,9,9,21,15439,16391,13473,-2918
2017,9,9,22,15684,16500,13774,-2726
2017,9,9,23,15723,16501,13833,-2668
2017,9,10,0,16057,16761,13851,-2910
2017,9,10,1,16185,16793,14226,-2567
2017,9,10,2,15564,16223,13746,-2477
2017,9,10,3,14920,15383,12379,-3004
2017,9,10,4,14238,14430,11471,-2959
2017,9,10,5,13192,13630,10941,-2689
2017,9,10,6,12648,13032,10894,-2138
2017,9,10,7,12300,12637,11152,-1485
2017,9,10,8,12116,12391,10631,-1760
2017,9,10,9,12068,12331,10492,-1839
2017,9,10,10,12251,12460,10602,-1858
2017,9,10,11,12400,12744,10696,-2048
2017,9,10,12,12663,13247,10985,-2262
2017,9,10,13,13389,14089,11441,-2648
2017,9,10,14,14180,14795,11779,-3016
2017,9,10,15,14593,15276,12469,-2807
2017,9,10,16,14776,15594,12590,-3004
2017,9,10,17,14867,15834,12901,-2933
2017,9,10,18,14892,15970,12947,-3023
2017,9,10,19,14949,16114,13048,-3066
2017,9,10,20,15090,16307,13323,-2984
2017,9,10,21,15424,16609,13935,-2674
2017,9,10,22,15739,16912,14072,-2840
2017,9,10,23,15808,17013,14231,-2782
2017,9,11,0,16139,17388,14355,-3033
2017,9,11,1,16286,17430,14609,-2821
2017,9,11,2,15624,16595,13783,-2812
2017,9,11,3,14840,15471,12789,-2682
2017,9,11,4,14051,14369,11776,-2593
2017,9,11,5,13119,13567,10871,-2696
2017,9,11,6,12646,13041,10806,-2235
2017,9,11,7,12382,12711,10244,-2467
2017,9,11,8,12306,12587,10360,-2227
2017,9,11,9,12526,12809,10856,-1953
2017,9,11,10,13391,13721,11665,-2056
2017,9,11,11,14725,15401,13087,-2314
2017,9,11,12,15855,16565,13933,-2632
2017,9,11,13,16725,17265,14278,-2987
2017,9,11,14,17283,17804,15103,-2701
2017,9,11,15,17732,18207,15589,-2618
2017,9,11,16,18010,18374,15510,-2864
2017,9,11,17,18226,18548,15445,-3103
2017,9,11,18,18506,18851,15807,-3044
2017,9,11,19,18739,19054,15889,-3165
2017,9,11,20,18949,19399,16080,-3319
2017,9,11,21,19165,19710,16325,-3385
2017,9,11,22,19164,19793,16416,-3377
2017,9,11,23,18780,19426,16363,-3063
2017,9,12,0,18800,19561,16524,-3037
2017,9,12,1,18681,19177,16301,-2876
2017,9,12,2,17687,18074,15518,-2556
2017,9,12,3,16469,16652,13861,-2791
2017,9,12,4,15220,15269,12589,-2680
2017,9,12,5,13908,14308,12370,-1938
2017,9,12,6,13290,13674,11928,-1746
2017,9,12,7,12935,13261,11783,-1478
2017,9,12,8,12793,13109,11691,-1418
2017,9,12,9,12969,13283,11966,-1317
2017,9,12,10,13817,14114,12586,-1528
2017,9,12,11,15263,15812,13383,-2429
2017,9,12,12,16445,16957,14196,-2761
2017,9,12,13,17375,17666,14867,-2799
2017,9,12,14,17943,18221,15541,-2680
2017,9,12,15,18558,18699,16102,-2597
2017,9,12,16,19035,19068,16465,-2603
2017,9,12,17,19441,19385,16802,-2583
2017,9,12,18,19888,19809,17387,-2422
2017,9,12,19,20231,20120,17510,-2610
2017,9,12,20,20520,20482,17707,-2775
2017,9,12,21,20744,20764,18145,-2619
2017,9,12,22,20662,20785,18259,-2526
2017,9,12,23,20111,20375,17871,-2504
2017,9,13,0,20041,20414,18232,-2182
2017,9,13,1,19848,20098,17832,-2266
2017,9,13,2,18738,19010,16651,-2359
2017,9,13,3,17389,17508,15402,-2106
2017,9,13,4,15987,16060,13852,-2208
2017,9,13,5,14505,14936,12780,-2156
2017,9,13,6,13794,14250,12375,-1875
2017,9,13,7,13364,13791,12216,-1575
2017,9,13,8,13162,13565,12065,-1500
2017,9,13,9,13290,13647,12150,-1497
2017,9,13,10,14113,14435,12354,-2081
2017,9,13,11,15545,16100,13044,-3056
2017,9,13,12,16851,17296,14405,-2891
2017,9,13,13,17989,18152,15294,-2858
2017,9,13,14,19008,18791,16037,-2754
2017,9,13,15,19584,19449,16656,-2793
2017,9,13,16,19942,19936,17013,-2923
2017,9,13,17,20189,20408,17268,-3140
2017,9,13,18,20509,20988,18034,-2954
2017,9,13,19,20772,21356,18344,-3012
2017,9,13,20,21043,21602,18456,-3146
2017,9,13,21,21297,21722,18808,-2914
2017,9,13,22,21286,21727,19182,-2545
2017,9,13,23,20768,21396,18983,-2413
2017,9,14,0,20704,21596,19156,-2440
2017,9,14,1,20447,21358,18880,-2478
2017,9,14,2,19379,20424,17814,-2610
2017,9,14,3,18093,18979,16102,-2877
2017,9,14,4,16733,17518,14435,-3083
2017,9,14,5,15447,16374,13289,-3085
2017,9,14,6,14722,15625,12703,-2922
2017,9,14,7,14261,15103,12160,-2943
2017,9,14,8,14037,14903,12047,-2856
2017,9,14,9,14151,15063,12128,-2935
2017,9,14,10,14971,15973,12601,-3372
2017,9,14,11,16425,17781,13870,-3911
2017,9,14,12,17755,19171,15356,-3815
2017,9,14,13,18945,19998,15884,-4114
2017,9,14,14,20195,20669,16750,-3919
2017,9,14,15,20708,21246,17543,-3703
2017,9,14,16,20930,21718,17877,-3841
2017,9,14,17,21005,21945,18025,-3920
2017,9,14,18,21135,22436,18407,-4029
2017,9,14,19,21235,22725,18864,-3861
2017,9,14,20,21374,22895,19024,-3871
2017,9,14,21,21578,22997,18900,-4097
2017,9,14,22,21620,22851,18825,-4026
2017,9,14,23,21189,22360,18774,-3586
2017,9,15,0,21182,22434,18930,-3504
2017,9,15,1,20877,22072,18694,-3378
2017,9,15,2,19814,21042,17977,-3065
2017,9,15,3,18590,19480,16392,-3088
2017,9,15,4,17270,17918,14797,-3121
2017,9,15,5,16178,16725,13097,-3628
2017,9,15,6,15277,15897,12309,-3588
2017,9,15,7,14688,15328,11922,-3406
2017,9,15,8,14362,15008,11554,-3454
2017,9,15,9,14419,15021,11598,-3423
2017,9,15,10,15175,15797,12244,-3553
2017,9,15,11,16811,17451,13851,-3600
2017,9,15,12,18093,18775,14937,-3838
2017,9,15,13,19058,19816,15703,-4113
2017,9,15,14,19800,20753,16789,-3964
2017,9,15,15,20374,21514,17792,-3722
2017,9,15,16,20803,22089,18409,-3680
2017,9,15,17,21166,22550,19060,-3490
2017,9,15,18,21580,23049,19730,-3319
2017,9,15,19,21883,23342,19910,-3432
2017,9,15,20,22117,23653,20383,-3270
2017,9,15,21,22231,23853,20657,-3196
2017,9,15,22,21955,23600,20496,-3104
2017,9,15,23,21314,22829,19807,-3022
2017,9,16,0,21341,22553,19375,-3178
2017,9,16,1,20802,22026,19188,-2838
2017,9,16,2,19757,21015,17773,-3242
2017,9,16,3,18459,19691,16114,-3577
2017,9,16,4,17080,18256,14627,-3629
2017,9,16,5,16796,17052,13424,-3628
2017,9,16,6,15798,16183,12273,-3910
2017,9,16,7,15121,15585,11559,-4026
2017,9,16,8,14694,15209,11338,-3871
2017,9,16,9,14578,15058,10996,-4062
2017,9,16,10,14814,15223,11521,-3702
2017,9,16,11,15413,15719,11951,-3768
2017,9,16,12,16054,16415,12612,-3803
2017,9,16,13,17256,17520,14274,-3246
2017,9,16,14,18268,18513,15233,-3280
2017,9,16,15,19052,19341,16470,-2871
2017,9,16,16,19605,19990,17081,-2909
2017,9,16,17,20024,20582,17818,-2764
2017,9,16,18,20365,21044,17568,-3476
2017,9,16,19,20668,21470,17607,-3863
2017,9,16,20,20961,21793,18585,-3208
2017,9,16,21,21209,21883,19062,-2821
2017,9,16,22,21178,21697,19089,-2608
2017,9,16,23,20879,21199,18585,-2614
2017,9,17,0,21197,21133,18353,-2780
2017,9,17,1,20822,20751,17774,-2977
2017,9,17,2,19923,19923,17045,-2878
2017,9,17,3,18784,18736,15059,-3677
2017,9,17,4,17529,17504,13873,-3631
2017,9,17,5,16598,16419,12604,-3815
2017,9,17,6,15553,15650,12033,-3617
2017,9,17,7,14824,15072,11294,-3778
2017,9,17,8,14364,14704,11090,-3614
2017,9,17,9,14190,14548,10600,-3948
2017,9,17,10,14323,14609,10743,-3866
2017,9,17,11,14739,14888,11107,-3781
2017,9,17,12,15180,15330,11625,-3705
2017,9,17,13,16355,16396,12429,-3967
2017,9,17,14,17570,17393,13208,-4185
2017,9,17,15,18496,18302,14407,-3895
2017,9,17,16,19194,19124,15162,-3962
2017,9,17,17,19764,19825,16130,-3695
2017,9,17,18,20214,20447,17000,-3447
2017,9,17,19,20584,21020,17661,-3359
2017,9,17,20,20958,21407,18113,-3294
2017,9,17,21,21308,21754,18516,-3238
2017,9,17,22,21377,21822,18777,-3045
2017,9,17,23,21150,21446,18123,-3323
2017,9,18,0,21609,21571,18142,-3429
2017,9,18,1,21278,21179,17825,-3354
2017,9,18,2,20198,20099,16134,-3965
2017,9,18,3,18783,18721,14680,-4041
2017,9,18,4,17278,17376,13228,-4148
2017,9,18,5,15712,16333,12509,-3824
2017,9,18,6,14952,15635,11548,-4087
2017,9,18,7,14477,15196,11265,-3931
2017,9,18,8,14228,14985,11146,-3839
2017,9,18,9,14365,15119,11372,-3747
2017,9,18,10,15239,16032,12398,-3634
2017,9,18,11,16991,17738,14701,-3037
2017,9,18,12,18322,18989,15891,-3098
2017,9,18,13,19302,19867,16488,-3379
2017,9,18,14,20105,20596,17523,-3073
2017,9,18,15,20728,21170,18280,-2890
2017,9,18,16,21145,21671,18154,-3517
2017,9,18,17,21482,22102,18178,-3924
2017,9,18,18,21845,22437,18697,-3740
2017,9,18,19,22087,22649,18726,-3923
2017,9,18,20,22296,22797,18995,-3802
2017,9,18,21,22462,22907,19151,-3756
2017,9,18,22,22314,22827,19403,-3424
2017,9,18,23,21811,22447,19075,-3372
2017,9,19,0,21977,22526,19255,-3271
2017,9,19,1,21380,21966,19066,-2900
2017,9,19,2,20115,20827,17830,-2997
2017,9,19,3,18535,19317,15571,-3746
2017,9,19,4,16947,17759,14573,-3186
2017,9,19,5,15586,16569,13044,-3525
2017,9,19,6,14829,15805,12322,-3483
2017,9,19,7,14363,15336,11631,-3705
2017,9,19,8,14117,15120,11427,-3693
2017,9,19,9,14216,15243,11775,-3468
2017,9,19,10,14975,16138,12781,-3357
2017,9,19,11,16571,17897,14237,-3660
2017,9,19,12,17729,19114,15401,-3713
2017,9,19,13,18540,19926,15782,-4144
2017,9,19,14,19178,20586,16418,-4168
2017,9,19,15,19680,21207,17525,-3682
2017,9,19,16,20026,21644,17937,-3707
2017,9,19,17,20293,21991,18044,-3947
2017,9,19,18,20590,22240,17915,-4325
2017,9,19,19,20792,22318,18070,-4248
2017,9,19,20,20959,22365,18208,-4157
2017,9,19,21,21093,22426,18773,-3653
2017,9,19,22,20968,22376,18370,-4006
2017,9,19,23,20533,22004,18064,-3940
2017,9,20,0,20629,22011,18195,-3816
2017,9,20,1,20089,21484,17751,-3733
2017,9,20,2,18961,20365,16645,-3720
2017,9,20,3,17559,18903,15074,-3829
2017,9,20,4,16190,17382,13921,-3461
2017,9,20,5,15764,16226,12626,-3600
2017,9,20,6,14929,15446,12038,-3408
2017,9,20,7,14381,14949,11429,-3520
2017,9,20,8,14081,14722,11131,-3591
2017,9,20,9,14157,14864,11296,-3568
2017,9,20,10,14967,15716,11936,-3780
2017,9,20,11,16721,17480,13400,-4080
2017,9,20,12,18020,18735,14468,-4267
2017,9,20,13,18940,19559,15044,-4515
2017,9,20,14,19643,20371,15745,-4626
2017,9,20,15,20212,21090,16872,-4218
2017,9,20,16,20619,21634,17426,-4208
2017,9,20,17,20958,22061,17867,-4194
2017,9,20,18,21359,22375,18472,-3903
2017,9,20,19,21646,22556,18729,-3827
2017,9,20,20,21917,22802,19175,-3627
2017,9,20,21,22118,22948,19604,-3344
2017,9,20,22,21980,22843,19483,-3360
2017,9,20,23,21493,22464,19249,-3215
2017,9,21,0,21630,22607,19398,-3209
2017,9,21,1,21100,22046,18509,-3537
2017,9,21,2,19928,20960,17241,-3719
2017,9,21,3,18437,19519,15875,-3644
2017,9,21,4,16926,18028,14682,-3346
2017,9,21,5,15959,16766,13575,-3191
2017,9,21,6,15108,15965,12561,-3404
2017,9,21,7,14562,15431,12089,-3342
2017,9,21,8,14268,15197,11773,-3424
2017,9,21,9,14356,15254,11751,-3503
2017,9,21,10,15187,16052,12356,-3696
2017,9,21,11,16959,17633,14089,-3544
2017,9,21,12,18254,18718,15159,-3559
2017,9,21,13,19172,19643,16161,-3482
2017,9,21,14,19897,20433,17058,-3375
2017,9,21,15,20480,21064,18048,-3016
2017,9,21,16,20904,21586,18511,-3075
2017,9,21,17,21267,21969,19122,-2847
2017,9,21,18,21683,22255,19785,-2470
2017,9,21,19,21971,22438,20429,-2009
2017,9,21,20,22225,22615,20196,-2419
2017,9,21,21,22384,22778,19965,-2813
2017,9,21,22,22203,22670,20088,-2582
2017,9,21,23,21711,22177,19814,-2363
2017,9,22,0,21850,22256,20019,-2237
2017,9,22,1,21314,21697,18988,-2709
2017,9,22,2,20106,20602,17474,-3128
2017,9,22,3,18593,19179,16088,-3091
2017,9,22,4,17019,17688,14657,-3031
2017,9,22,5,15620,16372,13210,-3162
2017,9,22,6,14712,15447,12338,-3109
2017,9,22,7,14145,14840,12259,-2581
2017,9,22,8,13823,14508,12026,-2482
2017,9,22,9,13869,14513,11833,-2680
2017,9,22,10,14613,15182,12347,-2835
2017,9,22,11,16256,16520,13420,-3100
2017,9,22,12,17488,17529,14546,-2983
2017,9,22,13,18393,18331,15405,-2926
2017,9,22,14,19059,19048,16193,-2855
2017,9,22,15,19576,19670,16553,-3117
2017,9,22,16,19907,20147,17130,-3017
2017,9,22,17,20169,20624,17513,-3111
2017,9,22,18,20478,21181,18051,-3130
2017,9,22,19,20704,21667,18784,-2883
2017,9,22,20,20893,22074,18889,-3185
2017,9,22,21,20987,22294,19249,-3045
2017,9,22,22,20699,22068,18745,-3323
2017,9,22,23,20123,21340,18147,-3193
2017,9,23,0,20127,21176,17991,-3185
2017,9,23,1,19536,20496,17188,-3308
2017,9,23,2,18469,19491,16140,-3351
2017,9,23,3,17233,18307,15394,-2913
2017,9,23,4,15949,17015,13751,-3264
2017,9,23,5,15174,15888,12887,-3001
2017,9,23,6,14327,15090,12391,-2699
2017,9,23,7,13735,14544,11816,-2728
2017,9,23,8,13380,14200,11429,-2771
2017,9,23,9,13304,14075,11166,-2909
2017,9,23,10,13576,14264,11236,-3028
2017,9,23,11,14178,14795,11904,-2891
2017,9,23,12,14776,15441,12952,-2489
2017,9,23,13,15885,16615,13987,-2628
2017,9,23,14,16817,17646,14957,-2689
2017,9,23,15,17586,18514,15514,-3000
2017,9,23,16,18124,19234,16244,-2990
2017,9,23,17,18516,19951,16857,-3094
2017,9,23,18,18833,20589,17676,-2913
2017,9,23,19,19134,21157,18266,-2891
2017,9,23,20,19440,21624,18701,-2923
2017,9,23,21,19711,22011,19078,-2933
2017,9,23,22,19692,22054,19289,-2765
2017,9,23,23,19567,21521,19064,-2457
2017,9,24,0,19954,21417,18656,-2761
2017,9,24,1,19631,20840,18105,-2735
2017,9,24,2,18767,19919,16656,-3263
2017,9,24,3,17719,18867,15906,-2961
2017,9,24,4,16595,17677,14699,-2978
2017,9,24,5,15883,16552,13528,-3024
2017,9,24,6,14846,15708,12777,-2931
2017,9,24,7,14115,15107,11953,-3154
2017,9,24,8,13658,14704,11615,-3089
2017,9,24,9,13501,14517,11400,-3117
2017,9,24,10,13727,14577,11430,-3147
2017,9,24,11,14236,14860,11614,-3246
2017,9,24,12,14709,15308,12478,-2830
2017,9,24,13,15952,16543,13541,-3002
2017,9,24,14,17264,17862,14592,-3270
2017,9,24,15,18327,19213,15955,-3258
2017,9,24,16,19175,20540,17137,-3403
2017,9,24,17,19879,21749,18341,-3408
2017,9,24,18,20436,22771,19789,-2982
2017,9,24,19,20878,23595,20801,-2794
2017,9,24,20,21304,24172,21439,-2733
2017,9,24,21,21693,24517,22093,-2424
2017,9,24,22,21729,24543,22161,-2382
2017,9,24,23,21657,23985,21682,-2303
2017,9,25,0,22211,23940,21691,-2249
2017,9,25,1,21887,23280,21172,-2108
2017,9,25,2,20723,22007,19047,-2960
2017,9,25,3,19227,20563,17382,-3181
2017,9,25,4,17637,19022,15803,-3219
2017,9,25,5,16377,17816,14619,-3197
2017,9,25,6,15458,16991,13670,-3321
2017,9,25,7,14881,16390,12937,-3453
2017,9,25,8,14584,16073,12583,-3490
2017,9,25,9,14751,16171,12888,-3283
2017,9,25,10,15832,17043,13522,-3521
2017,9,25,11,17958,18725,15229,-3496
2017,9,25,12,19511,20006,16020,-3986
2017,9,25,13,20663,21080,17168,-3912
2017,9,25,14,21634,22264,18561,-3703
2017,9,25,15,22438,23415,20311,-3104
2017,9,25,16,23046,24380,21982,-2398
2017,9,25,17,23554,25359,23236,-2123
2017,9,25,18,24087,26257,23970,-2287
2017,9,25,19,24439,26818,24694,-2124
2017,9,25,20,24714,27232,25448,-1784
2017,9,25,21,24880,27394,25824,-1570
2017,9,25,22,24597,27094,25972,-1122
2017,9,25,23,24137,26067,25291,-776
2017,9,26,0,24296,25754,24829,-925
2017,9,26,1,23551,24638,23454,-1184
2017,9,26,2,22027,23083,21113,-1970
2017,9,26,3,20151,21251,18530,-2721
2017,9,26,4,18275,19477,16516,-2961
2017,9,26,5,16948,18043,14603,-3440
2017,9,26,6,15910,17146,13983,-3163
2017,9,26,7,15245,16521,13096,-3425
2017,9,26,8,14885,16184,12839,-3345
2017,9,26,9,14987,16255,12992,-3263
2017,9,26,10,15989,17037,13550,-3487
2017,9,26,11,18117,18836,15755,-3081
2017,9,26,12,19637,20020,17109,-2911
2017,9,26,13,20717,20872,18259,-2613
2017,9,26,14,21599,21727,19260,-2467
2017,9,26,15,22326,22553,20101,-2452
2017,9,26,16,22862,23442,21456,-1986
2017,9,26,17,23311,24331,22080,-2251
2017,9,26,18,23795,25188,23350,-1838
2017,9,26,19,24118,25805,23975,-1830
2017,9,26,20,24375,26195,24285,-1910
2017,9,26,21,24535,26407,24811,-1596
2017,9,26,22,24258,26135,24789,-1346
2017,9,26,23,23786,25259,23693,-1566
2017,9,27,0,23855,25062,23638,-1424
2017,9,27,1,23135,24120,22640,-1480
2017,9,27,2,21689,22700,20795,-1905
2017,9,27,3,19886,20962,18932,-2030
2017,9,27,4,18109,19199,16920,-2279
2017,9,27,5,17077,17863,14850,-3013
2017,9,27,6,16090,16988,14006,-2982
2017,9,27,7,15445,16412,13386,-3026
2017,9,27,8,15089,16128,13301,-2827
2017,9,27,9,15182,16193,13511,-2682
2017,9,27,10,16162,17032,14115,-2917
2017,9,27,11,18260,18840,15544,-3296
2017,9,27,12,19740,20115,16954,-3161
2017,9,27,13,20784,21139,18052,-3087
2017,9,27,14,21634,22097,18547,-3550
2017,9,27,15,22358,23096,19914,-3182
2017,9,27,16,22912,24176,21394,-2782
2017,9,27,17,23388,25188,22576,-2612
2017,9,27,18,23911,26142,23372,-2770
2017,9,27,19,24268,26707,23728,-2979
2017,9,27,20,24571,27139,23914,-3225
2017,9,27,21,24744,27442,24072,-3370
2017,9,27,22,24476,27120,24057,-3063
2017,9,27,23,24039,26345,23094,-3251
2017,9,28,0,24098,26225,23000,-3225
2017,9,28,1,23382,25356,22479,-2877
2017,9,28,2,22016,23858,20418,-3440
2017,9,28,3,20277,22009,18210,-3799
2017,9,28,4,18435,20196,16498,-3698
2017,9,28,5,16429,18774,15016,-3758
2017,9,28,6,15576,17754,14461,-3293
2017,9,28,7,15082,17102,13969,-3133
2017,9,28,8,14812,16745,13412,-3333
2017,9,28,9,14886,16767,13135,-3632
2017,9,28,10,15616,17521,13877,-3644
2017,9,28,11,17192,19125,15537,-3588
2017,9,28,12,18275,19908,16214,-3694
2017,9,28,13,18987,20269,16586,-3683
2017,9,28,14,19560,20544,17301,-3243
2017,9,28,15,19994,20736,17477,-3259
2017,9,28,16,20251,20848,17640,-3208
2017,9,28,17,20433,20871,17464,-3407
2017,9,28,18,20648,21030,17640,-3390
2017,9,28,19,20726,21111,17658,-3453
2017,9,28,20,20756,21272,18178,-3094
2017,9,28,21,20721,21275,18324,-2951
2017,9,28,22,20422,20907,18231,-2676
2017,9,28,23,20099,20202,17802,-2400
2017,9,29,0,20147,20270,17525,-2745
2017,9,29,1,19640,19510,17056,-2454
2017,9,29,2,18555,18389,15787,-2602
2017,9,29,3,17240,16935,14661,-2274
2017,9,29,4,15936,15535,13370,-2165
2017,9,29,5,14962,14492,12013,-2479
2017,9,29,6,14233,13794,11381,-2413
2017,9,29,7,13773,13359,10804,-2555
2017,9,29,8,13519,13143,10663,-2480
2017,9,29,9,13570,13283,10885,-2398
2017,9,29,10,14232,14015,11255,-2760
2017,9,29,11,15693,15609,12851,-2758
2017,9,29,12,16665,16703,13692,-3011
2017,9,29,13,17243,17382,14094,-3288
2017,9,29,14,17592,17797,14427,-3370
2017,9,29,15,17851,18069,14482,-3587
2017,9,29,16,18005,18206,14740,-3466
2017,9,29,17,18106,18252,14976,-3276
2017,9,29,18,18282,18353,15153,-3200
2017,9,29,19,18406,18348,15206,-3142
2017,9,29,20,18514,18333,15267,-3066
2017,9,29,21,18597,18438,15148,-3290
2017,9,29,22,18404,18441,15143,-3298
2017,9,29,23,18232,18237,14947,-3290
2017,9,30,0,18345,18447,15395,-3052
2017,9,30,1,17873,17887,14893,-2994
2017,9,30,2,17029,17076,14477,-2599
2017,9,30,3,16017,15977,13456,-2521
2017,9,30,4,14936,14865,12628,-2237
2017,9,30,5,13810,13935,11689,-2246
2017,9,30,6,13278,13371,11265,-2106
2017,9,30,7,12960,12995,11161,-1834
2017,9,30,8,12783,12791,10818,-1973
2017,9,30,9,12782,12729,10655,-2074
2017,9,30,10,13026,12945,10907,-2038
2017,9,30,11,13503,13517,11688,-1829
2017,9,30,12,13965,14213,12361,-1852
2017,9,30,13,14724,15096,12914,-2182
2017,9,30,14,15270,15788,13769,-2019
2017,9,30,15,15669,16205,14090,-2115
2017,9,30,16,15844,16409,14351,-2058
2017,9,30,17,15901,16412,13910,-2502
2017,9,30,18,15894,16294,13758,-2536
2017,9,30,19,15895,16114,13976,-2138
2017,9,30,20,15955,15986,13875,-2111
2017,9,30,21,16088,16015,13894,-2121
2017,9,30,22,16120,16183,14033,-2150
2017,9,30,23,16278,16450,14338,-2112
2017,10,1,0,16603,16823,14753,-2070
2017,10,1,1,16397,16533,14322,-2211
2017,10,1,2,15800,15978,13594,-2384
2017,10,1,3,15075,15107,12962,-2145
2017,10,1,4,14274,14161,11840,-2321
2017,10,1,5,13160,13345,11054,-2291
2017,10,1,6,12616,12856,10763,-2093
2017,10,1,7,12290,12494,10269,-2225
2017,10,1,8,12123,12307,10025,-2282
2017,10,1,9,12122,12272,10394,-1878
2017,10,1,10,12305,12421,10469,-1952
2017,10,1,11,12647,12832,10683,-2149
2017,10,1,12,12991,13331,11454,-1877
2017,10,1,13,13657,14113,11684,-2429
2017,10,1,14,14264,14654,11875,-2779
2017,10,1,15,14500,14934,12290,-2644
2017,10,1,16,14585,15103,12284,-2819
2017,10,1,17,14604,15173,12369,-2804
2017,10,1,18,14577,15149,12392,-2757
2017,10,1,19,14566,15211,12498,-2713
2017,10,1,20,14660,15404,12799,-2605
2017,10,1,21,14920,15801,13317,-2484
2017,10,1,22,15325,16257,13957,-2300
2017,10,1,23,15769,16641,14039,-2602
2017,10,2,0,16496,17232,14681,-2551
2017,10,2,1,16351,16848,14425,-2423
2017,10,2,2,15514,16024,13720,-2304
2017,10,2,3,14605,14962,12857,-2105
2017,10,2,4,13676,13910,11696,-2214
2017,10,2,5,12718,13182,10974,-2208
2017,10,2,6,12276,12738,10606,-2132
2017,10,2,7,12036,12446,10356,-2090
2017,10,2,8,11972,12384,10506,-1878
2017,10,2,9,12202,12636,10625,-2011
2017,10,2,10,13028,13581,11719,-1862
2017,10,2,11,14596,15369,13132,-2237
2017,10,2,12,15695,16549,13846,-2703
2017,10,2,13,16229,17040,14326,-2714
2017,10,2,14,16584,17367,15112,-2255
2017,10,2,15,16732,17541,14906,-2635
2017,10,2,16,16795,17686,14718,-2968
2017,10,2,17,16822,17782,14459,-3323
2017,10,2,18,16914,17951,14320,-3631
2017,10,2,19,16972,18035,14300,-3735
2017,10,2,20,17033,18255,14501,-3754
2017,10,2,21,17155,18488,15079,-3409
2017,10,2,22,17310,18618,15405,-3213
2017,10,2,23,17469,18610,15295,-3315
2017,10,3,0,17940,18967,15918,-3049
2017,10,3,1,17528,18319,15561,-2758
2017,10,3,2,16450,17279,14633,-2646
2017,10,3,3,15224,15967,13340,-2627
2017,10,3,4,14005,14647,12266,-2381
2017,10,3,5,13045,13734,11817,-1917
2017,10,3,6,12536,13171,11538,-1633
2017,10,3,7,12252,12861,11248,-1613
2017,10,3,8,12154,12737,11180,-1557
2017,10,3,9,12344,12936,11425,-1511
2017,10,3,10,13130,13818,12092,-1726
2017,10,3,11,14709,15601,13660,-1941
2017,10,3,12,15841,16788,14860,-1928
2017,10,3,13,16419,17320,15212,-2108
2017,10,3,14,16791,17680,15409,-2271
2017,10,3,15,17008,17940,15329,-2611
2017,10,3,16,17133,18065,15333,-2732
2017,10,3,17,17192,18136,15341,-2795
2017,10,3,18,17297,18300,15448,-2852
2017,10,3,19,17344,18351,15498,-2853
2017,10,3,20,17387,18478,15572,-2906
2017,10,3,21,17484,18629,15883,-2746
2017,10,3,22,17564,18693,16180,-2513
2017,10,3,23,17639,18622,16535,-2087
2017,10,4,0,18010,18951,16920,-2031
2017,10,4,1,17540,18386,16422,-1964
2017,10,4,2,16445,17364,15248,-2116
2017,10,4,3,15193,16039,13891,-2148
2017,10,4,4,13975,14719,12685,-2034
2017,10,4,5,13177,13815,11975,-1840
2017,10,4,6,12639,13237,11636,-1601
2017,10,4,7,12322,12881,11346,-1535
2017,10,4,8,12197,12731,11312,-1419
2017,10,4,9,12355,12871,11574,-1297
2017,10,4,10,13129,13747,12302,-1445
2017,10,4,11,14735,15469,13754,-1715
2017,10,4,12,15899,16680,14802,-1878
2017,10,4,13,16516,17308,15404,-1904
2017,10,4,14,16948,17729,16028,-1701
2017,10,4,15,17230,18116,16227,-1889
2017,10,4,16,17436,18341,16314,-2027
2017,10,4,17,17581,18564,16328,-2236
2017,10,4,18,17812,18898,16617,-2281
2017,10,4,19,18004,19121,16806,-2315
2017,10,4,20,18206,19381,17186,-2195
2017,10,4,21,18430,19625,17679,-1946
2017,10,4,22,18522,19745,18035,-1710
2017,10,4,23,18562,19769,17431,-2338
2017,10,5,0,18830,20004,17692,-2312
2017,10,5,1,18290,19402,17226,-2176
2017,10,5,2,17264,18446,16137,-2309
2017,10,5,3,16007,17013,14382,-2631
2017,10,5,4,14716,15588,13243,-2345
2017,10,5,5,13684,14584,12101,-2483
2017,10,5,6,13085,13949,11557,-2392
2017,10,5,7,12731,13558,11302,-2256
2017,10,5,8,12582,13387,11205,-2182
2017,10,5,9,12753,13513,11294,-2219
2017,10,5,10,13584,14323,11944,-2379
2017,10,5,11,15325,16044,13038,-3006
2017,10,5,12,16643,17255,14372,-2883
2017,10,5,13,17406,17965,15260,-2705
2017,10,5,14,17968,18511,15922,-2589
2017,10,5,15,18315,18976,16490,-2486
2017,10,5,16,18503,19411,17163,-2248
2017,10,5,17,18632,19818,17634,-2184
2017,10,5,18,18825,20276,18075,-2201
2017,10,5,19,18946,20569,18509,-2060
2017,10,5,20,19075,20836,18807,-2029
2017,10,5,21,19210,20959,18962,-1997
2017,10,5,22,19243,20874,18666,-2208
2017,10,5,23,19216,20855,18749,-2106
2017,10,6,0,19466,21035,18806,-2229
2017,10,6,1,18934,20443,18765,-1678
2017,10,6,2,17850,19472,17684,-1788
2017,10,6,3,16564,18078,15240,-2838
2017,10,6,4,15242,16612,13893,-2719
2017,10,6,5,14541,15476,12721,-2755
2017,10,6,6,13892,14790,11796,-2994
2017,10,6,7,13487,14365,11509,-2856
2017,10,6,8,13290,14109,11594,-2515
2017,10,6,9,13405,14230,11747,-2483
2017,10,6,10,14146,15080,12348,-2732
2017,10,6,11,15778,16793,13902,-2891
2017,10,6,12,16985,18045,14957,-3088
2017,10,6,13,17685,18838,15630,-3208
2017,10,6,14,18191,19478,16751,-2727
2017,10,6,15,18517,19900,17411,-2489
2017,10,6,16,18717,20248,17859,-2389
2017,10,6,17,18853,20447,18214,-2233
2017,10,6,18,19014,20782,18546,-2236
2017,10,6,19,19090,20952,18695,-2257
2017,10,6,20,19129,20970,18758,-2212
2017,10,6,21,19150,20858,18503,-2355
2017,10,6,22,19065,20638,18342,-2296
2017,10,6,23,19003,20482,18156,-2326
2017,10,7,0,19071,20452,18303,-2149
2017,10,7,1,18416,19799,17318,-2481
2017,10,7,2,17437,19039,15898,-3141
2017,10,7,3,16384,18013,14181,-3832
2017,10,7,4,15278,16715,12722,-3993
2017,10,7,5,14892,15674,11524,-4150
2017,10,7,6,14131,14891,10999,-3892
2017,10,7,7,13606,14423,10759,-3664
2017,10,7,8,13296,14133,10512,-3621
2017,10,7,9,13235,14015,10389,-3626
2017,10,7,10,13491,14229,10645,-3584
2017,10,7,11,14122,14846,11292,-3554
2017,10,7,12,14752,15564,12250,-3314
2017,10,7,13,15658,16645,13368,-3277
2017,10,7,14,16406,17598,14198,-3400
2017,10,7,15,16948,18238,14679,-3559
2017,10,7,16,17295,18754,15025,-3729
2017,10,7,17,17544,19118,15277,-3841
2017,10,7,18,17729,19336,15739,-3597
2017,10,7,19,17925,19467,15831,-3636
2017,10,7,20,18141,19439,15964,-3475
2017,10,7,21,18386,19422,16328,-3094
2017,10,7,22,18596,19417,16283,-3134
2017,10,7,23,18918,19493,16314,-3179
2017,10,8,0,19212,19818,16600,-3218
2017,10,8,1,18712,19448,15967,-3481
2017,10,8,2,17924,18855,15449,-3406
2017,10,8,3,17037,17911,14306,-3605
2017,10,8,4,16027,16932,13464,-3468
2017,10,8,5,15258,16060,13018,-3042
2017,10,8,6,14512,15428,12300,-3128
2017,10,8,7,14012,14981,11754,-3227
2017,10,8,8,13708,14738,11387,-3351
2017,10,8,9,13624,14733,11331,-3402
2017,10,8,10,13800,14935,11722,-3213
2017,10,8,11,14294,15323,12150,-3173
2017,10,8,12,14772,15829,13213,-2616
2017,10,8,13,15640,16776,14291,-2485
2017,10,8,14,16585,17706,14876,-2830
2017,10,8,15,17242,18388,15331,-3057
2017,10,8,16,17730,18884,16045,-2839
2017,10,8,17,18098,19243,16442,-2801
2017,10,8,18,18335,19334,16924,-2410
2017,10,8,19,18487,19334,16800,-2534
2017,10,8,20,18640,19432,16804,-2628
2017,10,8,21,18818,19523,16963,-2560
2017,10,8,22,19020,19698,17425,-2273
2017,10,8,23,19368,20171,17990,-2181
2017,10,9,0,19656,20453,18317,-2136
2017,10,9,1,19189,20027,17488,-2539
2017,10,9,2,18342,19362,16766,-2596
2017,10,9,3,17324,18329,15653,-2676
2017,10,9,4,16238,17272,14680,-2592
2017,10,9,5,15874,16315,12933,-3382
2017,10,9,6,15266,15680,12284,-3396
2017,10,9,7,14871,15289,11386,-3903
2017,10,9,8,14663,15056,11025,-4031
2017,10,9,9,14765,15175,11318,-3857
2017,10,9,10,15479,15912,12416,-3496
2017,10,9,11,16986,17233,13717,-3516
2017,10,9,12,18127,18532,15328,-3204
2017,10,9,13,18822,19663,16357,-3306
2017,10,9,14,19390,20539,16909,-3630
2017,10,9,15,19807,21177,18138,-3039
2017,10,9,16,20082,21500,19255,-2245
2017,10,9,17,20313,21565,19574,-1991
2017,10,9,18,20573,21585,19538,-2047
2017,10,9,19,20710,21449,19693,-1756
2017,10,9,20,20820,21397,19798,-1599
2017,10,9,21,20899,21565,19833,-1732
2017,10,9,22,20933,21846,19957,-1889
2017,10,9,23,21014,22140,20351,-1789
2017,10,10,0,21024,22238,20590,-1648
2017,10,10,1,20307,21614,20094,-1520
2017,10,10,2,19283,20684,18645,-2039
2017,10,10,3,18083,19413,16194,-3219
2017,10,10,4,16886,18011,14275,-3736
2017,10,10,5,16055,16757,12972,-3785
2017,10,10,6,15320,15768,11843,-3925
2017,10,10,7,14851,15182,11375,-3807
2017,10,10,8,14609,14798,11226,-3572
2017,10,10,9,14704,14826,11300,-3526
2017,10,10,10,15442,15586,12053,-3533
2017,10,10,11,17034,17336,14385,-2951
2017,10,10,12,18212,18466,15706,-2760
2017,10,10,13,18855,19190,15976,-3214
2017,10,10,14,19360,19865,16779,-3086
2017,10,10,15,19711,20400,17629,-2771
2017,10,10,16,19975,20788,17849,-2939
2017,10,10,17,20213,21111,18397,-2714
2017,10,10,18,20487,21567,19458,-2109
2017,10,10,19,20674,21813,19915,-1898
2017,10,10,20,20819,22078,20136,-1942
2017,10,10,21,20942,22227,20737,-1490
2017,10,10,22,20905,22079,20758,-1321
2017,10,10,23,20945,21846,20217,-1629
2017,10,11,0,20974,21854,20579,-1275
2017,10,11,1,20311,21013,19540,-1473
2017,10,11,2,19202,19803,17119,-2684
2017,10,11,3,17850,18278,15061,-3217
2017,10,11,4,16460,16719,13492,-3227
2017,10,11,5,15146,15552,12615,-2937
2017,10,11,6,14404,14801,12071,-2730
2017,10,11,7,13926,14269,11621,-2648
2017,10,11,8,13672,14036,11431,-2605
2017,10,11,9,13751,14126,11550,-2576
2017,10,11,10,14484,14929,12202,-2727
2017,10,11,11,16150,16698,13772,-2926
2017,10,11,12,17386,18046,15052,-2994
2017,10,11,13,18018,18680,15889,-2791
2017,10,11,14,18482,19118,16398,-2720
2017,10,11,15,18771,19422,16720,-2702
2017,10,11,16,18924,19558,16916,-2642
2017,10,11,17,19012,19656,17019,-2637
2017,10,11,18,19156,19872,17281,-2591
2017,10,11,19,19203,20035,17503,-2532
2017,10,11,20,19257,20069,17648,-2421
2017,10,11,21,19334,20084,17601,-2483
2017,10,11,22,19352,20218,17632,-2586
2017,10,11,23,19469,20399,17659,-2740
2017,10,12,0,19455,20241,17775,-2466
2017,10,12,1,18725,19518,16795,-2723
2017,10,12,2,17654,18426,15650,-2776
2017,10,12,3,16371,17045,14265,-2780
2017,10,12,4,15091,15703,13142,-2561
2017,10,12,5,14109,14649,11637,-3012
2017,10,12,6,13511,13931,11139,-2792
2017,10,12,7,13142,13499,10786,-2713
2017,10,12,8,12981,13329,10675,-2654
2017,10,12,9,13128,13468,10745,-2723
2017,10,12,10,13923,14264,11399,-2865
2017,10,12,11,15649,15999,12763,-3236
2017,10,12,12,16864,17240,14124,-3116
2017,10,12,13,17399,17716,14468,-3248
2017,10,12,14,17730,17993,14664,-3329
2017,10,12,15,17883,18094,14514,-3580
2017,10,12,16,17911,18091,14221,-3870
2017,10,12,17,17883,17969,14051,-3918
2017,10,12,18,17905,17928,14093,-3835
2017,10,12,19,17862,17908,14170,-3738
2017,10,12,20,17843,17962,14371,-3591
2017,10,12,21,17897,18126,14681,-3445
2017,10,12,22,17942,18258,15009,-3249
2017,10,12,23,18234,18584,15413,-3171
2017,10,13,0,18420,18743,15384,-3359
2017,10,13,1,17884,18157,15069,-3088
2017,10,13,2,16900,17251,14216,-3035
2017,10,13,3,15699,16008,12794,-3214
2017,10,13,4,14492,14769,12113,-2656
2017,10,13,5,13508,13797,11044,-2753
2017,10,13,6,12991,13233,11009,-2224
2017,10,13,7,12693,12875,10779,-2096
2017,10,13,8,12575,12777,10695,-2082
2017,10,13,9,12737,12928,10887,-2041
2017,10,13,10,13489,13756,11370,-2386
2017,10,13,11,15051,15428,12695,-2733
2017,10,13,12,16202,16634,13702,-2932
2017,10,13,13,16736,17176,14037,-3139
2017,10,13,14,17051,17457,14481,-2976
2017,10,13,15,17247,17615,14321,-3294
2017,10,13,16,17336,17637,14474,-3163
2017,10,13,17,17340,17594,14203,-3391
2017,10,13,18,17407,17708,13879,-3829
2017,10,13,19,17433,17760,13919,-3841
2017,10,13,20,17471,17773,13884,-3889
2017,10,13,21,17549,17849,13971,-3878
2017,10,13,22,17578,17960,14352,-3608
2017,10,13,23,17849,18283,14757,-3526
2017,10,14,0,17937,18269,14938,-3331
2017,10,14,1,17359,17729,14234,-3495
2017,10,14,2,16548,16970,13567,-3403
2017,10,14,3,15599,15972,12386,-3586
2017,10,14,4,14585,14870,11712,-3158
2017,10,14,5,13632,13936,11308,-2628
2017,10,14,6,13027,13241,10748,-2493
2017,10,14,7,12648,12903,10665,-2238
2017,10,14,8,12450,12712,10291,-2421
2017,10,14,9,12458,12708,10793,-1915
2017,10,14,10,12733,12964,11145,-1819
2017,10,14,11,13333,13610,11345,-2265
2017,10,14,12,13954,14324,12095,-2229
2017,10,14,13,14730,15249,12630,-2619
2017,10,14,14,15330,16088,13164,-2924
2017,10,14,15,15767,16585,14366,-2219
2017,10,14,16,16001,16808,14453,-2355
2017,10,14,17,16108,16872,14546,-2326
2017,10,14,18,16157,16830,14559,-2271
2017,10,14,19,16233,16774,14589,-2185
2017,10,14,20,16372,16861,14510,-2351
2017,10,14,21,16590,17037,14664,-2373
2017,10,14,22,16799,17261,15262,-1999
2017,10,14,23,17302,17738,15852,-1886
2017,10,15,0,17492,17911,16572,-1339
2017,10,15,1,17016,17496,15765,-1731
2017,10,15,2,16415,16864,14331,-2533
2017,10,15,3,15654,16079,13221,-2858
2017,10,15,4,14814,15106,12702,-2404
2017,10,15,5,13982,14210,11510,-2700
2017,10,15,6,13351,13572,11046,-2526
2017,10,15,7,12923,13171,10682,-2489
2017,10,15,8,12679,12934,10664,-2270
2017,10,15,9,12626,12863,10416,-2447
2017,10,15,10,12818,12994,10459,-2535
2017,10,15,11,13311,13433,11057,-2376
2017,10,15,12,13815,13978,11788,-2190
2017,10,15,13,14576,14859,12281,-2578
2017,10,15,14,15386,15672,12847,-2825
2017,10,15,15,15982,16315,13496,-2819
2017,10,15,16,16395,16820,14069,-2751
2017,10,15,17,16701,17117,14344,-2773
2017,10,15,18,16914,17293,14371,-2922
2017,10,15,19,17089,17410,14683,-2727
2017,10,15,20,17293,17532,14907,-2625
2017,10,15,21,17553,17764,15290,-2474
2017,10,15,22,17781,18062,15920,-2142
2017,10,15,23,18329,18524,16500,-2024
2017,10,16,0,18575,18637,16451,-2186
2017,10,16,1,18114,18044,15661,-2383
2017,10,16,2,17378,17185,14491,-2694
2017,10,16,3,16387,16129,13566,-2563
2017,10,16,4,15289,15014,12661,-2353
2017,10,16,5,14016,14162,12063,-2099
2017,10,16,6,13439,13601,11649,-1952
2017,10,16,7,13091,13248,11405,-1843
2017,10,16,8,12933,13042,11307,-1735
2017,10,16,9,13083,13100,11289,-1811
2017,10,16,10,13897,13877,12380,-1497
2017,10,16,11,15592,15596,13874,-1722
2017,10,16,12,16883,16826,14552,-2274
2017,10,16,13,17470,17279,14967,-2312
2017,10,16,14,17860,17589,15413,-2176
2017,10,16,15,18056,17750,15629,-2121
2017,10,16,16,18074,17732,15823,-1909
2017,10,16,17,18041,17649,15776,-1873
2017,10,16,18,18036,17592,15952,-1640
2017,10,16,19,17936,17470,15964,-1506
2017,10,16,20,17870,17348,15902,-1446
2017,10,16,21,17918,17538,16030,-1508
2017,10,16,22,17996,17784,16303,-1481
2017,10,16,23,18451,18344,16694,-1650
2017,10,17,0,18566,18484,16868,-1616
2017,10,17,1,17934,17884,16651,-1233
2017,10,17,2,16897,16916,15259,-1657
2017,10,17,3,15629,15671,13820,-1851
2017,10,17,4,14379,14425,12862,-1563
2017,10,17,5,13606,13521,11709,-1812
2017,10,17,6,13168,12984,11392,-1592
2017,10,17,7,12911,12690,11076,-1614
2017,10,17,8,12819,12606,11088,-1518
2017,10,17,9,13039,12835,11415,-1420
2017,10,17,10,13924,13757,12356,-1401
2017,10,17,11,15627,15605,13850,-1755
2017,10,17,12,16811,16824,15114,-1710
2017,10,17,13,17167,17222,15395,-1827
2017,10,17,14,17312,17336,15422,-1914
2017,10,17,15,17333,17350,15583,-1767
2017,10,17,16,17290,17273,15258,-2015
2017,10,17,17,17203,17120,14810,-2310
2017,10,17,18,17197,17118,14978,-2140
2017,10,17,19,17160,17099,15147,-1952
2017,10,17,20,17175,17213,15392,-1821
2017,10,17,21,17338,17434,15791,-1643
2017,10,17,22,17501,17778,16201,-1577
2017,10,17,23,17992,18381,16748,-1633
2017,10,18,0,18165,18545,17239,-1306
2017,10,18,1,17735,17977,16809,-1168
2017,10,18,2,16809,17115,16008,-1107
2017,10,18,3,15605,15767,14465,-1302
2017,10,18,4,14395,14509,13484,-1025
2017,10,18,5,13379,13547,12366,-1181
2017,10,18,6,12833,13030,12274,-756
2017,10,18,7,12508,12738,12299,-439
2017,10,18,8,12387,12613,11833,-780
2017,10,18,9,12589,12781,11928,-853
2017,10,18,10,13473,13648,12904,-744
2017,10,18,11,15256,15460,14409,-1051
2017,10,18,12,16504,16691,15997,-694
2017,10,18,13,16920,17004,15876,-1128
2017,10,18,14,17128,17135,15734,-1401
2017,10,18,15,17236,17220,15688,-1532
2017,10,18,16,17265,17274,15623,-1651
2017,10,18,17,17243,17335,15568,-1767
2017,10,18,18,17317,17491,15522,-1969
2017,10,18,19,17364,17606,15605,-2001
2017,10,18,20,17429,17805,15972,-1833
2017,10,18,21,17546,18029,16245,-1784
2017,10,18,22,17627,18168,16116,-2052
2017,10,18,23,18087,18552,16820,-1732
2017,10,19,0,18225,18636,17301,-1335
2017,10,19,1,17733,17987,16688,-1299
2017,10,19,2,16795,17051,15625,-1426
2017,10,19,3,15524,15760,14240,-1520
2017,10,19,4,14241,14493,13230,-1263
2017,10,19,5,13142,13571,12199,-1372
2017,10,19,6,12593,12986,11886,-1100
2017,10,19,7,12275,12697,11785,-912
2017,10,19,8,12152,12590,11749,-841
2017,10,19,9,12320,12801,12250,-551
2017,10,19,10,13114,13654,12992,-662
2017,10,19,11,14755,15460,14023,-1437
2017,10,19,12,15955,16736,15166,-1570
2017,10,19,13,16396,17172,15273,-1899
2017,10,19,14,16665,17407,15316,-2091
2017,10,19,15,16846,17588,15599,-1989
2017,10,19,16,16964,17646,15571,-2075
2017,10,19,17,17019,17670,15760,-1910
2017,10,19,18,17153,17807,15929,-1878
2017,10,19,19,17229,17915,15974,-1941
2017,10,19,20,17305,18011,16086,-1925
2017,10,19,21,17414,18189,16148,-2041
2017,10,19,22,17433,18290,16246,-2044
2017,10,19,23,17843,18746,16758,-1988
2017,10,20,0,17930,18762,17026,-1736
2017,10,20,1,17401,18100,16701,-1399
2017,10,20,2,16556,17132,15877,-1255
2017,10,20,3,15384,15797,14114,-1683
2017,10,20,4,14195,14529,12924,-1605
2017,10,20,5,13122,13589,11575,-2014
2017,10,20,6,12594,13010,11322,-1688
2017,10,20,7,12283,12660,11264,-1396
2017,10,20,8,12160,12522,11106,-1416
2017,10,20,9,12309,12679,11484,-1195
2017,10,20,10,13066,13533,12210,-1323
2017,10,20,11,14643,15345,13333,-2012
2017,10,20,12,15816,16630,14335,-2295
2017,10,20,13,16277,17095,14503,-2592
2017,10,20,14,16552,17366,14593,-2773
2017,10,20,15,16735,17500,14791,-2709
2017,10,20,16,16834,17556,15156,-2400
2017,10,20,17,16865,17608,15336,-2272
2017,10,20,18,16964,17646,15411,-2235
2017,10,20,19,17008,17692,15374,-2318
2017,10,20,20,17033,17798,15512,-2286
2017,10,20,21,17062,17891,15424,-2467
2017,10,20,22,16980,17865,15539,-2326
2017,10,20,23,17305,18124,15713,-2411
2017,10,21,0,17308,18001,15736,-2265
2017,10,21,1,16756,17393,15547,-1846
2017,10,21,2,16018,16625,14286,-2339
2017,10,21,3,15067,15589,12743,-2846
2017,10,21,4,14057,14459,11947,-2512
2017,10,21,5,13467,13531,11626,-1905
2017,10,21,6,12870,12953,11345,-1608
2017,10,21,7,12500,12569,10930,-1639
2017,10,21,8,12299,12401,10752,-1649
2017,10,21,9,12299,12397,10745,-1652
2017,10,21,10,12574,12697,10952,-1745
2017,10,21,11,13182,13362,11581,-1781
2017,10,21,12,13818,14074,12272,-1802
2017,10,21,13,14477,14880,13049,-1831
2017,10,21,14,14974,15389,13503,-1886
2017,10,21,15,15285,15698,13697,-2001
2017,10,21,16,15436,15822,13752,-2070
2017,10,21,17,15504,15914,13656,-2258
2017,10,21,18,15539,15979,13574,-2405
2017,10,21,19,15599,16077,13558,-2519
2017,10,21,20,15689,16171,13619,-2552
2017,10,21,21,15861,16228,14208,-2020
2017,10,21,22,15994,16389,14470,-1919
2017,10,21,23,16629,17010,14560,-2450
2017,10,22,0,16782,16976,14567,-2409
2017,10,22,1,16307,16575,14103,-2472
2017,10,22,2,15764,15981,13643,-2338
2017,10,22,3,14980,15222,12860,-2362
2017,10,22,4,14126,14301,12313,-1988
2017,10,22,5,13313,13468,11755,-1713
2017,10,22,6,12701,12906,11505,-1401
2017,10,22,7,12302,12516,10892,-1624
2017,10,22,8,12083,12317,10715,-1602
2017,10,22,9,12039,12262,10700,-1562
2017,10,22,10,12234,12422,10664,-1758
2017,10,22,11,12703,12882,10797,-2085
2017,10,22,12,13210,13380,11441,-1939
2017,10,22,13,13857,14047,11944,-2103
2017,10,22,14,14535,14681,12213,-2468
2017,10,22,15,15014,15119,12614,-2505
2017,10,22,16,15329,15408,12809,-2599
2017,10,22,17,15536,15650,13012,-2638
2017,10,22,18,15671,15821,13003,-2818
2017,10,22,19,15772,15945,13272,-2673
2017,10,22,20,15915,16019,13246,-2773
2017,10,22,21,16156,16273,13572,-2701
2017,10,22,22,16365,16649,13753,-2896
2017,10,22,23,17116,17482,14726,-2756
2017,10,23,0,17306,17564,15204,-2360
2017,10,23,1,16842,17026,14524,-2502
2017,10,23,2,16192,16199,13944,-2255
2017,10,23,3,15192,15212,12965,-2247
2017,10,23,4,14139,14152,12367,-1785
2017,10,23,5,12957,13421,11718,-1703
2017,10,23,6,12506,12956,11435,-1521
2017,10,23,7,12257,12673,11149,-1524
2017,10,23,8,12180,12601,11338,-1263
2017,10,23,9,12384,12899,11846,-1053
2017,10,23,10,13230,13820,12187,-1633
2017,10,23,11,14901,15657,13173,-2484
2017,10,23,12,16235,17082,14836,-2246
2017,10,23,13,16838,17618,15488,-2130
2017,10,23,14,17279,17947,15785,-2162
2017,10,23,15,17659,18452,16439,-2013
2017,10,23,16,17887,18732,16768,-1964
2017,10,23,17,18009,18845,16877,-1968
2017,10,23,18,18159,18897,17175,-1722
2017,10,23,19,18230,18915,16959,-1956
2017,10,23,20,18323,18929,16915,-2014
2017,10,23,21,18444,19031,16949,-2082
2017,10,23,22,18451,19305,16736,-2569
2017,10,23,23,18868,19817,17598,-2219
2017,10,24,0,18756,19608,17228,-2380
2017,10,24,1,18011,18972,16362,-2610
2017,10,24,2,17125,18024,15321,-2703
2017,10,24,3,15877,16726,14050,-2676
2017,10,24,4,14630,15469,13201,-2268
2017,10,24,5,13818,14530,12461,-2069
2017,10,24,6,13313,13983,11979,-2004
2017,10,24,7,13005,13632,11652,-1980
2017,10,24,8,12886,13494,11665,-1829
2017,10,24,9,13061,13716,12025,-1691
2017,10,24,10,13888,14642,13011,-1631
2017,10,24,11,15573,16525,14774,-1751
2017,10,24,12,16902,18152,16282,-1870
2017,10,24,13,17470,18741,16806,-1935
2017,10,24,14,17885,19175,17077,-2098
2017,10,24,15,18219,19491,17504,-1987
2017,10,24,16,18412,19649,17919,-1730
2017,10,24,17,18523,19716,17528,-2188
2017,10,24,18,18660,19758,17551,-2207
2017,10,24,19,18733,19629,17230,-2399
2017,10,24,20,18799,19494,17458,-2036
2017,10,24,21,18907,19568,17656,-1912
2017,10,24,22,18916,19675,17555,-2120
2017,10,24,23,19297,20040,18175,-1865
2017,10,25,0,19138,19832,18413,-1419
2017,10,25,1,18424,19094,17315,-1779
2017,10,25,2,17578,18088,15865,-2223
2017,10,25,3,16367,16825,14139,-2686
2017,10,25,4,15131,15517,13186,-2331
2017,10,25,5,14360,14538,12198,-2340
2017,10,25,6,13669,13912,11656,-2256
2017,10,25,7,13211,13481,11531,-1950
2017,10,25,8,12970,13271,11445,-1826
2017,10,25,9,13062,13382,11451,-1931
2017,10,25,10,13859,14165,11947,-2218
2017,10,25,11,15639,15868,13344,-2524
2017,10,25,12,16987,17200,14989,-2211
2017,10,25,13,17434,17639,15286,-2353
2017,10,25,14,17671,17862,15812,-2050
2017,10,25,15,17803,17955,16541,-1414
2017,10,25,16,17815,17933,16626,-1307
2017,10,25,17,17791,17882,16233,-1649
2017,10,25,18,17832,17854,16289,-1565
2017,10,25,19,17823,17805,16499,-1306
2017,10,25,20,17832,17823,16453,-1370
2017,10,25,21,17906,18050,16525,-1525
2017,10,25,22,17935,18299,16710,-1589
2017,10,25,23,18441,18845,17355,-1490
2017,10,26,0,18313,18598,17344,-1254
2017,10,26,1,17597,17941,16113,-1828
2017,10,26,2,16695,17058,15010,-2048
2017,10,26,3,15427,15773,13195,-2578
2017,10,26,4,14173,14528,12295,-2233
2017,10,26,5,13569,13564,11323,-2241
2017,10,26,6,13049,12996,10813,-2183
2017,10,26,7,12716,12640,10438,-2202
2017,10,26,8,12578,12515,10392,-2123
2017,10,26,9,12746,12713,10506,-2207
2017,10,26,10,13585,13566,11379,-2187
2017,10,26,11,15367,15375,12896,-2479
2017,10,26,12,16683,16795,14706,-2089
2017,10,26,13,17077,17319,15177,-2142
2017,10,26,14,17250,17528,15104,-2424
2017,10,26,15,17344,17640,15230,-2410
2017,10,26,16,17338,17698,15085,-2613
2017,10,26,17,17276,17658,15193,-2465
2017,10,26,18,17276,17640,15367,-2273
2017,10,26,19,17228,17550,15384,-2166
2017,10,26,20,17243,17532,15349,-2183
2017,10,26,21,17392,17677,15515,-2162
2017,10,26,22,17544,17961,15841,-2120
2017,10,26,23,18187,18426,16537,-1889
2017,10,27,0,18184,18397,16502,-1895
2017,10,27,1,17609,17869,15719,-2150
2017,10,27,2,16806,16994,14843,-2151
2017,10,27,3,15643,15761,13264,-2497
2017,10,27,4,14455,14553,11980,-2573
2017,10,27,5,13429,13660,11491,-2169
2017,10,27,6,12905,13128,10891,-2237
2017,10,27,7,12613,12841,10530,-2311
2017,10,27,8,12510,12724,10446,-2278
2017,10,27,9,12714,12917,10751,-2166
2017,10,27,10,13564,13764,11553,-2211
2017,10,27,11,15238,15555,13255,-2300
2017,10,27,12,16512,16813,14981,-1832
2017,10,27,13,16871,17217,14800,-2417
2017,10,27,14,16998,17331,14931,-2400
2017,10,27,15,17057,17302,14563,-2739
2017,10,27,16,17019,17195,14431,-2764
2017,10,27,17,16941,17104,14065,-3039
2017,10,27,18,16933,17038,14083,-2955
2017,10,27,19,16897,16951,13922,-3029
2017,10,27,20,16888,16945,13942,-3003
2017,10,27,21,16958,17105,14296,-2809
2017,10,27,22,16988,17324,14687,-2637
2017,10,27,23,17474,17858,15908,-1950
2017,10,28,0,17383,17712,16270,-1442
2017,10,28,1,16859,17197,15390,-1807
2017,10,28,2,16193,16562,14436,-2126
2017,10,28,3,15264,15597,13059,-2538
2017,10,28,4,14254,14493,12042,-2451
2017,10,28,5,13316,13604,11436,-2168
2017,10,28,6,12731,13007,11210,-1797
2017,10,28,7,12376,12658,11085,-1573
2017,10,28,8,12184,12461,10977,-1484
2017,10,28,9,12202,12478,11038,-1440
2017,10,28,10,12513,12804,11295,-1509
2017,10,28,11,13143,13513,11946,-1567
2017,10,28,12,13853,14290,12938,-1352
2017,10,28,13,14468,14965,13209,-1756
2017,10,28,14,14907,15448,13279,-2169
2017,10,28,15,15201,15703,13457,-2246
2017,10,28,16,15280,15767,13627,-2140
2017,10,28,17,15266,15702,13779,-1923
2017,10,28,18,15187,15682,13668,-2014
2017,10,28,19,15152,15679,13591,-2088
2017,10,28,20,15193,15697,13433,-2264
2017,10,28,21,15353,15937,13557,-2380
2017,10,28,22,15579,16346,14032,-2314
2017,10,28,23,16382,17014,15399,-1615
2017,10,29,0,16463,16935,15244,-1691
2017,10,29,1,15969,16545,14456,-2089
2017,10,29,2,15491,15960,13573,-2387
2017,10,29,3,14735,15214,12551,-2663
2017,10,29,4,13927,14309,11971,-2338
2017,10,29,5,13189,13523,11420,-2103
2017,10,29,6,12631,12958,11169,-1789
2017,10,29,7,12261,12594,11037,-1557
2017,10,29,8,12062,12355,10909,-1446
2017,10,29,9,12036,12305,10864,-1441
2017,10,29,10,12264,12468,11061,-1407
2017,10,29,11,12806,12959,11365,-1594
2017,10,29,12,13435,13674,12116,-1558
2017,10,29,13,14070,14478,12188,-2290
2017,10,29,14,14756,15315,12948,-2367
2017,10,29,15,15244,15969,13260,-2709
2017,10,29,16,15518,16383,13708,-2675
2017,10,29,17,15644,16715,14072,-2643
2017,10,29,18,15676,16826,14187,-2639
2017,10,29,19,15699,16919,14129,-2790
2017,10,29,20,15804,16995,14201,-2794
2017,10,29,21,16031,17314,14295,-3019
2017,10,29,22,16297,17756,14823,-2933
2017,10,29,23,17091,18049,15389,-2660
2017,10,30,0,17170,17838,15653,-2185
2017,10,30,1,16678,17262,15328,-1934
2017,10,30,2,16102,16468,14352,-2116
2017,10,30,3,15173,15492,13091,-2401
2017,10,30,4,14172,14406,12144,-2262
2017,10,30,5,13320,13518,11606,-1912
2017,10,30,6,12807,12989,11153,-1836
2017,10,30,7,12501,12709,11053,-1656
2017,10,30,8,12379,12584,11022,-1562
2017,10,30,9,12552,12759,11558,-1201
2017,10,30,10,13417,13652,12201,-1451
2017,10,30,11,15200,15340,13299,-2041
2017,10,30,12,16636,16804,14902,-1902
2017,10,30,13,17079,17365,15404,-1961
2017,10,30,14,17302,17648,15239,-2409
2017,10,30,15,17440,17893,15624,-2269
2017,10,30,16,17390,17897,15595,-2302
2017,10,30,17,17299,17732,15513,-2219
2017,10,30,18,17279,17650,15396,-2254
2017,10,30,19,17213,17571,15312,-2259
2017,10,30,20,17215,17544,15326,-2218
2017,10,30,21,17360,17839,15653,-2186
2017,10,30,22,17514,18321,16335,-1986
2017,10,30,23,18198,19045,17067,-1978
2017,10,31,0,18191,18846,17203,-1643
2017,10,31,1,17537,18236,16323,-1913
2017,10,31,2,16733,17367,15485,-1882
2017,10,31,3,15501,16060,14098,-1962
2017,10,31,4,14268,14796,12892,-1904
2017,10,31,5,13457,13833,12595,-1238
2017,10,31,6,12965,13300,12225,-1075
2017,10,31,7,12677,12986,11566,-1420
2017,10,31,8,12580,12876,11805,-1071
2017,10,31,9,12796,13090,12051,-1039
2017,10,31,10,13681,13996,12849,-1147
2017,10,31,11,15420,15856,14304,-1552
2017,10,31,12,16785,17225,15469,-1756
2017,10,31,13,17117,17559,16238,-1321
2017,10,31,14,17266,17727,16237,-1490
2017,10,31,15,17359,17837,16002,-1835
2017,10,31,16,17364,17778,15889,-1889
2017,10,31,17,17299,17648,15874,-1774
2017,10,31,18,17306,17559,15899,-1660
2017,10,31,19,17268,17459,15593,-1866
2017,10,31,20,17293,17534,15508,-2026
2017,10,31,21,17482,17708,16016,-1692
2017,10,31,22,17679,17908,16373,-1535
2017,10,31,23,18302,18391,16950,-1441
2017,11,1,0,18253,18222,17301,-921
2017,11,1,1,17711,17874,16562,-1312
2017,11,1,2,16947,17168,15933,-1235
2017,11,1,3,15750,16050,14475,-1575
2017,11,1,4,14532,14853,13139,-1714
2017,11,1,5,13519,13872,11668,-2204
2017,11,1,6,13009,13389,11236,-2153
2017,11,1,7,12721,13065,10873,-2192
2017,11,1,8,12651,12993,10854,-2139
2017,11,1,9,12885,13228,11029,-2199
2017,11,1,10,13760,14156,12096,-2060
2017,11,1,11,15554,15969,14053,-1916
2017,11,1,12,17052,17402,15797,-1605
2017,11,1,13,17406,17860,16325,-1535
2017,11,1,14,17614,18146,16189,-1957
2017,11,1,15,17658,18284,15905,-2379
2017,11,1,16,17581,18232,16292,-1940
2017,11,1,17,17427,18103,16308,-1795
2017,11,1,18,17368,18155,16178,-1977
2017,11,1,19,17283,18073,15682,-2391
2017,11,1,20,17320,18130,15790,-2340
2017,11,1,21,17710,18346,16527,-1819
2017,11,1,22,17926,18798,16539,-2259
2017,11,1,23,18593,19299,16888,-2411
2017,11,2,0,18461,19016,17129,-1887
2017,11,2,1,17944,18413,16401,-2012
2017,11,2,2,16933,17499,15539,-1960
2017,11,2,3,15757,16227,13824,-2403
2017,11,2,4,14515,14944,12303,-2641
2017,11,2,5,13469,13994,11609,-2385
2017,11,2,6,12900,13417,11185,-2232
2017,11,2,7,12548,13099,11111,-1988
2017,11,2,8,12415,12960,11018,-1942
2017,11,2,9,12591,13115,11178,-1937
2017,11,2,10,13392,14044,11984,-2060
2017,11,2,11,15169,15899,13853,-2046
2017,11,2,12,16687,17400,15150,-2250
2017,11,2,13,17123,17870,15498,-2372
2017,11,2,14,17404,18140,15711,-2429
2017,11,2,15,17588,18280,15601,-2679
2017,11,2,16,17645,18365,16016,-2349
2017,11,2,17,17613,18314,16175,-2139
2017,11,2,18,17670,18325,15789,-2536
2017,11,2,19,17686,18245,15873,-2372
2017,11,2,20,17771,18346,16069,-2277
2017,11,2,21,18093,18482,15923,-2559
2017,11,2,22,18167,18739,16194,-2545
2017,11,2,23,18666,19290,16423,-2867
2017,11,3,0,18423,19013,16324,-2689
2017,11,3,1,17831,18379,15750,-2629
2017,11,3,2,16883,17450,14863,-2587
2017,11,3,3,15742,16171,13625,-2546
2017,11,3,4,14545,14889,12089,-2800
2017,11,3,5,13543,13913,11140,-2773
2017,11,3,6,12969,13326,10852,-2474
2017,11,3,7,12615,12952,10885,-2067
2017,11,3,8,12489,12820,10987,-1833
2017,11,3,9,12657,13014,11207,-1807
2017,11,3,10,13436,13817,11653,-2164
2017,11,3,11,15160,15514,12658,-2856
2017,11,3,12,16686,16986,14091,-2895
2017,11,3,13,17200,17529,14631,-2898
2017,11,3,14,17715,17883,15153,-2730
2017,11,3,15,17914,18182,15400,-2782
2017,11,3,16,17944,18326,15353,-2973
2017,11,3,17,17870,18399,15473,-2926
2017,11,3,18,17863,18459,15679,-2780
2017,11,3,19,17830,18429,15887,-2542
2017,11,3,20,17821,18421,15472,-2949
2017,11,3,21,18012,18511,15394,-3117
2017,11,3,22,17873,18711,15182,-3529
2017,11,3,23,18216,18955,15994,-2961
2017,11,4,0,17929,18400,15663,-2737
2017,11,4,1,17375,17651,14778,-2873
2017,11,4,2,16636,16801,13903,-2898
2017,11,4,3,15762,15805,12533,-3272
2017,11,4,4,14743,14712,11327,-3385
2017,11,4,5,13763,13813,10013,-3800
2017,11,4,6,13186,13253,9757,-3496
2017,11,4,7,12829,12882,9219,-3663
2017,11,4,8,12660,12687,9270,-3417
2017,11,4,9,12701,12714,9302,-3412
2017,11,4,10,13023,13054,9331,-3723
2017,11,4,11,13713,13799,10368,-3431
2017,11,4,12,14586,14637,11340,-3297
2017,11,4,13,15186,15367,11850,-3517
2017,11,4,14,15751,15848,12594,-3254
2017,11,4,15,15974,16051,12481,-3570
2017,11,4,16,15937,16020,12186,-3834
2017,11,4,17,15790,15888,12183,-3705
2017,11,4,18,15590,15752,12178,-3574
2017,11,4,19,15471,15660,12144,-3516
2017,11,4,20,15455,15660,12126,-3534
2017,11,4,21,15797,15908,12315,-3593
2017,11,4,22,16023,16452,12579,-3873
2017,11,4,23,16791,17270,13260,-4010
2017,11,5,0,16751,17128,13330,-3798
2017,11,5,1,16407,16740,12599,-4141
2017,11,5,2,15791,16269,12471,-3798
2017,11,5,3,15086,15488,11882,-3606
2017,11,5,4,14241,14579,11102,-3477
2017,11,5,5,13298,13755,10735,-3020
2017,11,5,6,12745,13134,10360,-2774
2017,11,5,7,12745,12675,10022,-2653
2017,11,5,8,12414,12413,9362,-3051
2017,11,5,9,12232,12347,9462,-2885
2017,11,5,10,12250,12442,9863,-2579
2017,11,5,11,12467,12754,10085,-2669
2017,11,5,12,12891,13271,10312,-2959
2017,11,5,13,13230,13975,10879,-3096
2017,11,5,14,13903,14930,11271,-3659
2017,11,5,15,14392,15669,12001,-3668
2017,11,5,16,14753,16103,12482,-3621
2017,11,5,17,14939,16334,12558,-3776
2017,11,5,18,15031,16450,12630,-3820
2017,11,5,19,15058,16455,12587,-3868
2017,11,5,20,15113,16488,12738,-3750
2017,11,5,21,15344,16717,13036,-3681
2017,11,5,22,16076,17352,13757,-3595
2017,11,5,23,17220,18091,14174,-3917
2017,11,6,0,17400,17958,14193,-3765
2017,11,6,1,17027,17585,13701,-3884
2017,11,6,2,16391,17001,12779,-4222
2017,11,6,3,15656,16134,12300,-3834
2017,11,6,4,14674,15098,11515,-3583
2017,11,6,5,13733,14062,10875,-3187
2017,11,6,6,13023,13374,9913,-3461
2017,11,6,7,12604,12968,9578,-3390
2017,11,6,8,12351,12716,9386,-3330
2017,11,6,9,12302,12664,9062,-3602
2017,11,6,10,12574,12946,9777,-3169
2017,11,6,11,13461,13953,10840,-3113
2017,11,6,12,15112,15780,12435,-3345
2017,11,6,13,16302,17094,13657,-3437
2017,11,6,14,16929,17824,13889,-3935
2017,11,6,15,17259,18263,14637,-3626
2017,11,6,16,17416,18486,14730,-3756
2017,11,6,17,17403,18527,14636,-3891
2017,11,6,18,17336,18452,14612,-3840
2017,11,6,19,17333,18448,14860,-3588
2017,11,6,20,17326,18399,14825,-3574
2017,11,6,21,17473,18444,14634,-3810
2017,11,6,22,18104,18829,15206,-3623
2017,11,6,23,19140,19646,15658,-3988
2017,11,7,0,19006,19363,15709,-3654
2017,11,7,1,18465,18796,15226,-3570
2017,11,7,2,17650,18018,14312,-3706
2017,11,7,3,16692,17090,13215,-3875
2017,11,7,4,15478,15814,11819,-3995
2017,11,7,5,14295,14598,11112,-3486
2017,11,7,6,13410,13778,11112,-2666
2017,11,7,7,12968,13284,10746,-2538
2017,11,7,8,12755,13019,10453,-2566
2017,11,7,9,12726,12986,10340,-2646
2017,11,7,10,13035,13275,10590,-2685
2017,11,7,11,14005,14286,11511,-2775
2017,11,7,12,15753,15899,13228,-2671
2017,11,7,13,16857,16942,14554,-2388
2017,11,7,14,17230,17497,14491,-3006
2017,11,7,15,17456,17816,14475,-3341
2017,11,7,16,17417,18044,14627,-3417
2017,11,7,17,17331,18200,15067,-3133
2017,11,7,18,17223,18272,15264,-3008
2017,11,7,19,17213,18301,15485,-2816
2017,11,7,20,17222,18277,15116,-3161
2017,11,7,21,17383,18436,15254,-3182
2017,11,7,22,18050,19072,15837,-3235
2017,11,7,23,19075,19876,16629,-3247
2017,11,8,0,19066,19738,16797,-2941
2017,11,8,1,18637,19342,16822,-2520
2017,11,8,2,18004,18665,15944,-2721
2017,11,8,3,17143,17721,14758,-2963
2017,11,8,4,15946,16493,13392,-3101
2017,11,8,5,14752,15283,12255,-3028
2017,11,8,6,13925,14412,11433,-2979
2017,11,8,7,13411,13927,11255,-2672
2017,11,8,8,13141,13666,10493,-3173
2017,11,8,9,13075,13608,10285,-3323
2017,11,8,10,13348,13889,10651,-3238
2017,11,8,11,14271,14900,11540,-3360
2017,11,8,12,15983,16674,13318,-3356
2017,11,8,13,17025,17740,15040,-2700
2017,11,8,14,17300,18145,15423,-2722
2017,11,8,15,17396,18237,15765,-2472
2017,11,8,16,17262,18179,15694,-2485
2017,11,8,17,17069,18028,15508,-2520
2017,11,8,18,16867,17798,15062,-2736
2017,11,8,19,16851,17782,14864,-2918
2017,11,8,20,16912,17808,14724,-3084
2017,11,8,21,17189,18033,14729,-3304
2017,11,8,22,17974,18736,15746,-2990
2017,11,8,23,19044,19854,17264,-2590
2017,11,9,0,19027,19779,17427,-2352
2017,11,9,1,18635,19400,17160,-2240
2017,11,9,2,18078,18757,15969,-2788
2017,11,9,3,17257,17814,14718,-3096
2017,11,9,4,16068,16654,13534,-3120
2017,11,9,5,14880,15390,11736,-3654
2017,11,9,6,14064,14524,10853,-3671
2017,11,9,7,13575,14035,10556,-3479
2017,11,9,8,13310,13759,10392,-3367
2017,11,9,9,13245,13709,10078,-3631
2017,11,9,10,13519,14005,10621,-3384
2017,11,9,11,14451,15034,12029,-3005
2017,11,9,12,16142,16789,14407,-2382
2017,11,9,13,17156,17845,15559,-2286
2017,11,9,14,17427,18178,15556,-2622
2017,11,9,15,17527,18209,15150,-3059
2017,11,9,16,17441,18207,14811,-3396
2017,11,9,17,17287,18146,14542,-3604
2017,11,9,18,17138,18049,14371,-3678
2017,11,9,19,17161,18046,14403,-3643
2017,11,9,20,17205,18056,14491,-3565
2017,11,9,21,17434,18234,15134,-3100
2017,11,9,22,18143,18842,15916,-2926
2017,11,9,23,19143,19706,17441,-2265
2017,11,10,0,19046,19520,16736,-2784
2017,11,10,1,18580,19159,16129,-3030
2017,11,10,2,17940,18611,15585,-3026
2017,11,10,3,17058,17715,14603,-3112
2017,11,10,4,15859,16463,13655,-2808
2017,11,10,5,14700,15274,12628,-2646
2017,11,10,6,14106,14396,11727,-2669
2017,11,10,7,13670,13883,11410,-2473
2017,11,10,8,13437,13577,11467,-2110
2017,11,10,9,13402,13526,11720,-1806
2017,11,10,10,13683,13803,12187,-1616
2017,11,10,11,14581,14682,13143,-1539
2017,11,10,12,16185,16105,14743,-1362
2017,11,10,13,17255,17261,16435,-826
2017,11,10,14,17712,18018,16585,-1433
2017,11,10,15,18054,18381,16363,-2018
2017,11,10,16,18108,18763,16408,-2355
2017,11,10,17,18021,18769,16256,-2513
2017,11,10,18,17910,18685,16164,-2521
2017,11,10,19,17927,18743,16051,-2692
2017,11,10,20,18007,18777,15881,-2896
2017,11,10,21,18268,19037,15998,-3039
2017,11,10,22,18968,19739,17127,-2612
2017,11,10,23,19916,20712,18147,-2565
2017,11,11,0,19851,20592,18719,-1873
2017,11,11,1,19383,20178,18360,-1818
2017,11,11,2,18798,19637,17524,-2113
2017,11,11,3,18087,18919,16593,-2326
2017,11,11,4,17156,17898,15508,-2390
2017,11,11,5,16179,16836,14744,-2092
2017,11,11,6,15450,15970,13381,-2589
2017,11,11,7,14912,15452,13013,-2439
2017,11,11,8,14589,15088,12906,-2182
2017,11,11,9,14441,14918,12999,-1919
2017,11,11,10,14513,14976,13193,-1783
2017,11,11,11,14845,15330,13646,-1684
2017,11,11,12,15392,15980,14376,-1604
2017,11,11,13,15796,16567,15503,-1064
2017,11,11,14,16364,17171,15567,-1604
2017,11,11,15,16747,17484,15721,-1763
2017,11,11,16,16784,17542,15386,-2156
2017,11,11,17,16642,17475,15015,-2460
2017,11,11,18,16459,17306,14955,-2351
2017,11,11,19,16341,17110,14483,-2627
2017,11,11,20,16388,17124,14650,-2474
2017,11,11,21,16666,17423,14901,-2522
2017,11,11,22,17432,18212,15853,-2359
2017,11,11,23,18587,19158,17091,-2067
2017,11,12,0,18689,19121,17581,-1540
2017,11,12,1,18360,18786,17103,-1683
2017,11,12,2,17877,18368,16633,-1735
2017,11,12,3,17281,17800,15617,-2183
2017,11,12,4,16513,16982,14485,-2497
2017,11,12,5,15712,16060,13645,-2415
2017,11,12,6,15116,15324,12850,-2474
2017,11,12,7,14559,14795,12402,-2393
2017,11,12,8,14198,14429,12468,-1961
2017,11,12,9,14027,14252,12597,-1655
2017,11,12,10,14044,14280,12369,-1911
2017,11,12,11,14276,14527,12541,-1986
2017,11,12,12,14574,14925,13070,-1855
2017,11,12,13,14838,15478,14045,-1433
2017,11,12,14,15442,16117,14518,-1599
2017,11,12,15,15874,16475,15054,-1421
2017,11,12,16,16040,16642,14624,-2018
2017,11,12,17,16035,16709,14497,-2212
2017,11,12,18,16003,16632,14414,-2218
2017,11,12,19,15951,16528,14257,-2271
2017,11,12,20,16014,16574,14368,-2206
2017,11,12,21,16326,16860,14816,-2044
2017,11,12,22,17245,17765,16014,-1751
2017,11,12,23,18512,18856,16929,-1927
2017,11,13,0,18611,18847,17007,-1840
2017,11,13,1,18304,18529,16768,-1761
2017,11,13,2,17797,18041,16450,-1591
2017,11,13,3,17005,17259,15406,-1853
2017,11,13,4,15987,16207,13920,-2287
2017,11,13,5,14987,15193,12615,-2578
2017,11,13,6,14285,14387,11619,-2768
2017,11,13,7,13858,13978,11460,-2518
2017,11,13,8,13645,13737,11496,-2241
2017,11,13,9,13620,13710,11481,-2229
2017,11,13,10,13930,14007,11670,-2337
2017,11,13,11,14889,14994,12711,-2283
2017,11,13,12,16484,16806,14598,-2208
2017,11,13,13,17611,17974,16244,-1730
2017,11,13,14,18113,18522,16745,-1777
2017,11,13,15,18401,18895,16797,-2098
2017,11,13,16,18436,19103,16980,-2123
2017,11,13,17,18310,19087,17286,-1801
2017,11,13,18,18148,18936,16852,-2084
2017,11,13,19,18066,18834,16689,-2145
2017,11,13,20,18039,18769,16766,-2003
2017,11,13,21,18236,18904,16566,-2338
2017,11,13,22,18965,19535,16900,-2635
2017,11,13,23,19997,20410,18409,-2001
2017,11,14,0,19913,20218,18506,-1712
2017,11,14,1,19493,19777,17856,-1921
2017,11,14,2,18838,19139,17174,-1965
2017,11,14,3,17903,18142,15999,-2143
2017,11,14,4,16658,16746,14768,-1978
2017,11,14,5,15425,15530,13339,-2191
2017,11,14,6,14378,14636,12570,-2066
2017,11,14,7,13868,14121,12002,-2119
2017,11,14,8,13602,13824,11736,-2088
2017,11,14,9,13546,13730,11813,-1917
2017,11,14,10,13835,14001,12112,-1889
2017,11,14,11,14784,15051,13236,-1815
2017,11,14,12,16444,16785,15413,-1372
2017,11,14,13,17542,17920,16666,-1254
2017,11,14,14,17945,18411,16698,-1713
2017,11,14,15,18197,18700,16820,-1880
2017,11,14,16,18161,18843,16788,-2055
2017,11,14,17,18024,18888,16621,-2267
2017,11,14,18,17897,18828,16302,-2526
2017,11,14,19,17891,18820,16227,-2593
2017,11,14,20,17937,18776,16065,-2711
2017,11,14,21,18171,18919,16287,-2632
2017,11,14,22,18918,19567,17287,-2280
2017,11,14,23,19896,20377,18202,-2175
2017,11,15,0,19775,20189,18026,-2163
2017,11,15,1,19341,19749,17650,-2099
2017,11,15,2,18740,19150,16911,-2239
2017,11,15,3,17830,18224,15856,-2368
2017,11,15,4,16595,16917,14506,-2411
2017,11,15,5,15369,15655,13050,-2605
2017,11,15,6,14349,14777,12080,-2697
2017,11,15,7,13844,14295,11885,-2410
2017,11,15,8,13577,14042,11736,-2306
2017,11,15,9,13515,13990,11749,-2241
2017,11,15,10,13788,14279,12106,-2173
2017,11,15,11,14734,15292,13021,-2271
2017,11,15,12,16431,17045,14925,-2120
2017,11,15,13,17478,18061,15948,-2113
2017,11,15,14,17764,18367,15952,-2415
2017,11,15,15,17862,18331,15865,-2466
2017,11,15,16,17738,18206,15682,-2524
2017,11,15,17,17580,18131,15417,-2714
2017,11,15,18,17420,18040,15417,-2623
2017,11,15,19,17440,18057,15077,-2980
2017,11,15,20,17530,18153,15241,-2912
2017,11,15,21,17835,18408,16078,-2330
2017,11,15,22,18604,19281,16613,-2668
2017,11,15,23,19556,20111,17529,-2582
2017,11,16,0,19365,19980,18131,-1849
2017,11,16,1,18904,19518,17446,-2072
2017,11,16,2,18293,18924,16772,-2152
2017,11,16,3,17394,17968,15698,-2270
2017,11,16,4,16173,16656,14156,-2500
2017,11,16,5,14957,15406,13270,-2136
2017,11,16,6,14050,14503,12630,-1873
2017,11,16,7,13517,13906,12064,-1842
2017,11,16,8,13208,13600,11758,-1842
2017,11,16,9,13105,13518,11759,-1759
2017,11,16,10,13341,13748,12052,-1696
2017,11,16,11,14235,14723,13217,-1506
2017,11,16,12,15830,16490,14562,-1928
2017,11,16,13,16948,17669,15477,-2192
2017,11,16,14,17439,18148,15791,-2357
2017,11,16,15,17739,18394,15901,-2493
2017,11,16,16,17755,18434,15944,-2490
2017,11,16,17,17657,18364,15861,-2503
2017,11,16,18,17557,18267,15812,-2455
2017,11,16,19,17557,18236,15736,-2500
2017,11,16,20,17582,18292,15770,-2522
2017,11,16,21,17840,18499,15842,-2657
2017,11,16,22,18566,19139,16614,-2525
2017,11,16,23,19491,20019,17524,-2495
2017,11,17,0,19305,19864,17510,-2354
2017,11,17,1,18833,19470,16787,-2683
2017,11,17,2,18214,18866,16272,-2594
2017,11,17,3,17299,17975,15157,-2818
2017,11,17,4,16139,16782,14109,-2673
2017,11,17,5,15002,15606,13292,-2314
2017,11,17,6,14162,14718,12262,-2456
2017,11,17,7,13699,14211,12268,-1943
2017,11,17,8,13442,13930,12343,-1587
2017,11,17,9,13389,13892,12332,-1560
2017,11,17,10,13662,14174,12469,-1705
2017,11,17,11,14579,15185,12981,-2204
2017,11,17,12,16203,16957,14780,-2177
2017,11,17,13,17214,18086,15899,-2187
2017,11,17,14,17517,18491,16339,-2152
2017,11,17,15,17686,18569,16263,-2306
2017,11,17,16,17564,18463,16010,-2453
2017,11,17,17,17400,18339,15592,-2747
2017,11,17,18,17224,18142,15210,-2932
2017,11,17,19,17228,18114,15393,-2721
2017,11,17,20,17329,18123,15380,-2743
2017,11,17,21,17602,18336,15371,-2965
2017,11,17,22,18309,19078,16062,-3016
2017,11,17,23,19224,19943,17070,-2873
2017,11,18,0,19047,19696,16835,-2861
2017,11,18,1,18604,19313,16432,-2881
2017,11,18,2,18056,18808,15916,-2892
2017,11,18,3,17351,18080,15049,-3031
2017,11,18,4,16428,17033,13989,-3044
2017,11,18,5,15435,15999,13156,-2843
2017,11,18,6,14495,15150,11711,-3439
2017,11,18,7,13918,14631,11308,-3323
2017,11,18,8,13575,14301,11013,-3288
2017,11,18,9,13410,14172,11103,-3069
2017,11,18,10,13464,14231,11199,-3032
2017,11,18,11,13823,14578,11469,-3109
2017,11,18,12,14385,15230,12626,-2604
2017,11,18,13,14831,15983,13518,-2465
2017,11,18,14,15499,16764,14028,-2736
2017,11,18,15,16145,17433,14263,-3170
2017,11,18,16,16410,17732,14290,-3442
2017,11,18,17,16439,17721,14242,-3479
2017,11,18,18,16385,17567,14388,-3179
2017,11,18,19,16296,17481,14355,-3126
2017,11,18,20,16276,17420,14441,-2979
2017,11,18,21,16384,17573,14370,-3203
2017,11,18,22,16971,18213,14956,-3257
2017,11,18,23,17789,18651,15343,-3308
2017,11,19,0,17616,18418,15235,-3183
2017,11,19,1,17197,18049,14907,-3142
2017,11,19,2,16715,17599,14182,-3417
2017,11,19,3,16067,16932,13587,-3345
2017,11,19,4,15288,16078,12977,-3101
2017,11,19,5,14465,15123,12386,-2737
2017,11,19,6,13789,14269,11766,-2503
2017,11,19,7,13197,13652,11208,-2444
2017,11,19,8,12831,13288,10878,-2410
2017,11,19,9,12656,13131,11052,-2079
2017,11,19,10,12667,13139,11154,-1985
2017,11,19,11,12918,13368,11303,-2065
2017,11,19,12,13235,13880,11788,-2092
2017,11,19,13,13602,14545,12391,-2154
2017,11,19,14,14316,15303,12773,-2530
2017,11,19,15,14937,15981,13303,-2678
2017,11,19,16,15315,16407,13719,-2688
2017,11,19,17,15509,16586,13695,-2891
2017,11,19,18,15648,16689,13780,-2909
2017,11,19,19,15781,16769,13773,-2996
2017,11,19,20,15950,16888,13854,-3034
2017,11,19,21,16322,17121,13922,-3199
2017,11,19,22,17176,17942,14711,-3231
2017,11,19,23,18309,18927,15675,-3252
2017,11,20,0,18359,18855,15810,-3045
2017,11,20,1,18077,18567,15322,-3245
2017,11,20,2,17544,18091,14804,-3287
2017,11,20,3,16733,17359,14149,-3210
2017,11,20,4,15760,16347,13396,-2951
2017,11,20,5,14790,15300,12686,-2614
2017,11,20,6,14119,14562,12076,-2486
2017,11,20,7,13697,14146,11761,-2385
2017,11,20,8,13491,13932,11798,-2134
2017,11,20,9,13480,13928,11804,-2124
2017,11,20,10,13814,14272,11969,-2303
2017,11,20,11,14849,15265,12985,-2280
2017,11,20,12,16621,17073,14506,-2567
2017,11,20,13,17783,18226,15655,-2571
2017,11,20,14,18183,18715,16019,-2696
2017,11,20,15,18360,19013,16209,-2804
2017,11,20,16,18355,19187,16197,-2990
2017,11,20,17,18256,19072,15698,-3374
2017,11,20,18,18163,18893,15672,-3221
2017,11,20,19,18205,18853,15709,-3144
2017,11,20,20,18293,18853,15774,-3079
2017,11,20,21,18566,18997,15761,-3236
2017,11,20,22,19352,19738,16427,-3311
2017,11,20,23,20402,20568,17701,-2867
2017,11,21,0,20231,20407,17518,-2889
2017,11,21,1,19787,19939,17149,-2790
2017,11,21,2,19141,19374,16573,-2801
2017,11,21,3,18101,18488,15755,-2733
2017,11,21,4,16809,17185,14501,-2684
2017,11,21,5,15520,15834,13226,-2608
2017,11,21,6,14372,14933,12754,-2179
2017,11,21,7,13835,14382,12374,-2008
2017,11,21,8,13553,14045,11962,-2083
2017,11,21,9,13477,13947,12096,-1851
2017,11,21,10,13753,14191,12379,-1812
2017,11,21,11,14735,15216,13231,-1985
2017,11,21,12,16545,16995,14741,-2254
2017,11,21,13,17572,18006,15532,-2474
2017,11,21,14,17746,18232,15622,-2610
2017,11,21,15,17737,18189,15596,-2593
2017,11,21,16,17606,18220,15689,-2531
2017,11,21,17,17471,18081,15501,-2580
2017,11,21,18,17347,17869,15386,-2483
2017,11,21,19,17404,17810,15124,-2686
2017,11,21,20,17480,17845,15203,-2642
2017,11,21,21,17769,18032,15273,-2759
2017,11,21,22,18541,18787,15940,-2847
2017,11,21,23,19565,19713,16630,-3083
2017,11,22,0,19393,19524,16595,-2929
2017,11,22,1,18957,19110,16102,-3008
2017,11,22,2,18360,18524,15520,-3004
2017,11,22,3,17375,17700,14991,-2709
2017,11,22,4,16122,16543,13808,-2735
2017,11,22,5,14888,15298,13084,-2214
2017,11,22,6,13962,14365,11941,-2424
2017,11,22,7,13449,13808,11549,-2259
2017,11,22,8,13163,13484,11037,-2447
2017,11,22,9,13096,13360,11036,-2324
2017,11,22,10,13359,13538,11335,-2203
2017,11,22,11,14294,14376,11936,-2440
2017,11,22,12,15972,15901,13044,-2857
2017,11,22,13,17112,17238,14305,-2933
2017,11,22,14,17532,18105,14918,-3187
2017,11,22,15,17780,18628,15169,-3459
2017,11,22,16,17766,18905,15620,-3285
2017,11,22,17,17660,18957,15812,-3145
2017,11,22,18,17555,18824,15695,-3129
2017,11,22,19,17603,18718,15336,-3382
2017,11,22,20,17711,18678,15327,-3351
2017,11,22,21,18043,18748,15430,-3318
2017,11,22,22,18833,19372,15938,-3434
2017,11,22,23,19870,20125,16705,-3420
2017,11,23,0,19749,19878,16714,-3164
2017,11,23,1,19359,19481,16225,-3256
2017,11,23,2,18797,18944,15704,-3240
2017,11,23,3,17914,18133,14940,-3193
2017,11,23,4,16748,17134,13858,-3276
2017,11,23,5,15582,15991,12640,-3351
2017,11,23,6,14536,15083,11548,-3535
2017,11,23,7,13911,14481,10988,-3493
2017,11,23,8,13525,14110,10780,-3330
2017,11,23,9,13371,13948,10756,-3192
2017,11,23,10,13475,14014,10761,-3253
2017,11,23,11,13869,14335,11167,-3168
2017,11,23,12,14465,14941,11900,-3041
2017,11,23,13,14888,15520,12521,-2999
2017,11,23,14,15498,16249,12689,-3560
2017,11,23,15,16045,16823,13096,-3727
2017,11,23,16,16356,17188,13213,-3975
2017,11,23,17,16485,17354,13280,-4074
2017,11,23,18,16373,17258,13124,-4134
2017,11,23,19,16086,16949,12748,-4201
2017,11,23,20,15789,16637,12669,-3968
2017,11,23,21,15632,16459,13069,-3390
2017,11,23,22,15939,16702,13449,-3253
2017,11,23,23,16377,17006,14025,-2981
2017,11,24,0,16233,16819,13953,-2866
2017,11,24,1,16095,16686,13888,-2798
2017,11,24,2,15944,16548,13887,-2661
2017,11,24,3,15670,16275,13439,-2836
2017,11,24,4,15143,15691,12897,-2794
2017,11,24,5,14478,14950,11720,-3230
2017,11,24,6,13988,14338,11390,-2948
2017,11,24,7,13553,13904,11202,-2702
2017,11,24,8,13287,13626,11076,-2550
2017,11,24,9,13196,13548,11023,-2525
2017,11,24,10,13371,13680,10933,-2747
2017,11,24,11,13924,14260,11246,-3014
2017,11,24,12,14807,15102,11890,-3212
2017,11,24,13,15314,15774,12439,-3335
2017,11,24,14,15679,16326,12566,-3760
2017,11,24,15,15924,16549,12724,-3825
2017,11,24,16,15932,16607,12784,-3823
2017,11,24,17,15857,16586,12689,-3897
2017,11,24,18,15707,16482,12618,-3864
2017,11,24,19,15655,16426,12723,-3703
2017,11,24,20,15757,16437,12826,-3611
2017,11,24,21,16098,16642,13181,-3461
2017,11,24,22,17053,17461,13616,-3845
2017,11,24,23,18039,18523,14488,-4035
2017,11,25,0,17892,18356,14777,-3579
2017,11,25,1,17540,18016,14686,-3330
2017,11,25,2,17123,17622,14459,-3163
2017,11,25,3,16543,17001,13979,-3022
2017,11,25,4,15717,16123,13354,-2769
2017,11,25,5,14765,15094,11898,-3196
2017,11,25,6,14084,14302,11586,-2716
2017,11,25,7,13526,13781,11698,-2083
2017,11,25,8,13190,13440,11611,-1829
2017,11,25,9,13023,13265,11206,-2059
2017,11,25,10,13067,13317,11272,-2045
2017,11,25,11,13374,13647,11675,-1972
2017,11,25,12,13844,14216,11784,-2432
2017,11,25,13,14153,14778,11918,-2860
2017,11,25,14,14736,15463,12266,-3197
2017,11,25,15,15162,15971,12676,-3295
2017,11,25,16,15383,16246,13118,-3128
2017,11,25,17,15446,16296,13236,-3060
2017,11,25,18,15425,16288,13240,-3048
2017,11,25,19,15406,16258,13140,-3118
2017,11,25,20,15494,16258,13103,-3155
2017,11,25,21,15770,16412,13201,-3211
2017,11,25,22,16556,17205,13544,-3661
2017,11,25,23,17550,17905,14053,-3852
2017,11,26,0,17438,17778,13988,-3790
2017,11,26,1,17061,17428,13829,-3599
2017,11,26,2,16578,17070,13639,-3431
2017,11,26,3,15911,16534,13384,-3150
2017,11,26,4,15153,15760,12717,-3043
2017,11,26,5,14373,14848,11953,-2895
2017,11,26,6,13792,14066,11798,-2268
2017,11,26,7,13287,13504,12020,-1484
2017,11,26,8,12968,13206,11924,-1282
2017,11,26,9,12836,13046,11933,-1113
2017,11,26,10,12906,13087,11608,-1479
2017,11,26,11,13248,13321,11852,-1469
2017,11,26,12,13747,13811,12088,-1723
2017,11,26,13,14040,14323,12405,-1918
2017,11,26,14,14610,15049,12667,-2382
2017,11,26,15,14984,15744,12930,-2814
2017,11,26,16,15273,16173,13000,-3173
2017,11,26,17,15428,16375,12992,-3383
2017,11,26,18,15555,16491,13001,-3490
2017,11,26,19,15669,16641,13070,-3571
2017,11,26,20,15864,16893,13358,-3535
2017,11,26,21,16294,17180,13881,-3299
2017,11,26,22,17247,18074,14144,-3930
2017,11,26,23,18576,19070,14789,-4281
2017,11,27,0,18610,19025,15108,-3917
2017,11,27,1,18310,18743,14999,-3744
2017,11,27,2,17795,18232,14796,-3436
2017,11,27,3,16912,17446,14202,-3244
2017,11,27,4,15884,16383,13493,-2890
2017,11,27,5,14883,15306,12859,-2447
2017,11,27,6,13940,14546,12499,-2047
2017,11,27,7,13508,14061,12370,-1691
2017,11,27,8,13280,13805,12287,-1518
2017,11,27,9,13243,13762,12397,-1365
2017,11,27,10,13551,14086,12796,-1290
2017,11,27,11,14551,15115,13536,-1579
2017,11,27,12,16308,16847,14395,-2452
2017,11,27,13,17429,17974,15465,-2509
2017,11,27,14,17755,18359,15537,-2822
2017,11,27,15,17788,18557,15818,-2739
2017,11,27,16,17744,18608,15692,-2916
2017,11,27,17,17628,18580,15797,-2783
2017,11,27,18,17520,18441,15456,-2985
2017,11,27,19,17535,18374,15315,-3059
2017,11,27,20,17629,18377,15244,-3133
2017,11,27,21,17929,18597,15846,-2751
2017,11,27,22,18757,19559,16318,-3241
2017,11,27,23,19978,20606,17682,-2924
2017,11,28,0,19918,20504,17384,-3120
2017,11,28,1,19561,20169,17141,-3028
2017,11,28,2,18954,19595,17049,-2546
2017,11,28,3,17942,18658,16065,-2593
2017,11,28,4,16681,17377,14735,-2642
2017,11,28,5,15441,16032,12729,-3303
2017,11,28,6,14593,15135,11595,-3540
2017,11,28,7,14086,14627,11104,-3523
2017,11,28,8,13825,14350,11135,-3215
2017,11,28,9,13768,14337,11154,-3183
2017,11,28,10,14062,14628,11420,-3208
2017,11,28,11,15081,15612,12264,-3348
2017,11,28,12,16947,17410,14241,-3169
2017,11,28,13,17999,18439,14943,-3496
2017,11,28,14,18119,18709,14975,-3734
2017,11,28,15,17981,18653,14958,-3695
2017,11,28,16,17790,18591,15235,-3356
2017,11,28,17,17590,18350,15180,-3170
2017,11,28,18,17406,18182,14996,-3186
2017,11,28,19,17423,18130,14941,-3189
2017,11,28,20,17475,18179,15110,-3069
2017,11,28,21,17711,18423,15449,-2974
2017,11,28,22,18501,19272,16016,-3256
2017,11,28,23,19636,20323,17281,-3042
2017,11,29,0,19472,20229,17260,-2969
2017,11,29,1,19065,19798,16952,-2846
2017,11,29,2,18467,19141,16270,-2871
2017,11,29,3,17407,18115,15250,-2865
2017,11,29,4,16084,16730,13948,-2782
2017,11,29,5,14806,15355,12751,-2604
2017,11,29,6,14020,14374,11867,-2507
2017,11,29,7,13497,13750,11225,-2525
2017,11,29,8,13203,13432,10764,-2668
2017,11,29,9,13115,13359,10721,-2638
2017,11,29,10,13356,13553,10787,-2766
2017,11,29,11,14288,14517,11552,-2965
2017,11,29,12,16052,16290,13282,-3008
2017,11,29,13,17117,17405,14294,-3111
2017,11,29,14,17371,17770,14223,-3547
2017,11,29,15,17447,17919,14589,-3330
2017,11,29,16,17410,17910,14643,-3267
2017,11,29,17,17307,17905,14476,-3429
2017,11,29,18,17211,17871,14381,-3490
2017,11,29,19,17277,17908,14388,-3520
2017,11,29,20,17410,17905,14427,-3478
2017,11,29,21,17708,18078,14820,-3258
2017,11,29,22,18463,18933,15290,-3643
2017,11,29,23,19531,20101,16286,-3815
2017,11,30,0,19382,20028,16303,-3725
2017,11,30,1,19002,19692,15669,-4023
2017,11,30,2,18480,19137,15547,-3590
2017,11,30,3,17577,18287,15012,-3275
2017,11,30,4,16426,17008,14089,-2919
2017,11,30,5,15262,15685,12537,-3148
2017,11,30,6,14289,14843,11829,-3014
2017,11,30,7,13796,14353,11375,-2978
2017,11,30,8,13547,14074,11168,-2906
2017,11,30,9,13505,14062,11205,-2857
2017,11,30,10,13809,14378,11357,-3021
2017,11,30,11,14839,15395,12546,-2849
2017,11,30,12,16690,17258,14546,-2712
2017,11,30,13,17791,18394,15430,-2964
2017,11,30,14,18021,18765,15202,-3563
2017,11,30,15,18075,18868,15244,-3624
2017,11,30,16,18016,18765,15267,-3498
2017,11,30,17,17895,18656,15239,-3417
2017,11,30,18,17755,18509,15202,-3307
2017,11,30,19,17753,18446,15087,-3359
2017,11,30,20,17784,18479,15167,-3312
2017,11,30,21,18028,18747,15548,-3199
2017,11,30,22,18799,19656,16101,-3555
2017,11,30,23,19791,20461,16826,-3635
2017,12,1,0,19530,20273,16835,-3438
2017,12,1,1,19082,19847,16444,-3403
2017,12,1,2,18474,19224,16050,-3174
2017,12,1,3,17469,18217,15043,-3174
2017,12,1,4,16212,16871,14004,-2867
2017,12,1,5,15008,15491,12740,-2751
2017,12,1,6,14238,14477,11584,-2893
2017,12,1,7,13686,13843,11104,-2739
2017,12,1,8,13366,13507,11202,-2305
2017,12,1,9,13263,13428,11442,-1986
2017,12,1,10,13494,13681,11307,-2374
2017,12,1,11,14388,14595,11991,-2604
2017,12,1,12,16113,16362,13585,-2777
2017,12,1,13,17263,17567,14729,-2838
2017,12,1,14,17571,17989,15042,-2947
2017,12,1,15,17683,18101,15099,-3002
2017,12,1,16,17592,18178,14772,-3406
2017,12,1,17,17440,18154,14606,-3548
2017,12,1,18,17276,18025,14278,-3747
2017,12,1,19,17288,17989,14319,-3670
2017,12,1,20,17382,17949,14578,-3371
2017,12,1,21,17687,18121,14467,-3654
2017,12,1,22,18510,18920,15023,-3897
2017,12,1,23,19466,19778,15853,-3925
2017,12,2,0,19337,19495,16046,-3449
2017,12,2,1,18903,19118,15279,-3839
2017,12,2,2,18348,18706,14862,-3844
2017,12,2,3,17611,18038,14162,-3876
2017,12,2,4,16595,17027,13158,-3869
2017,12,2,5,15473,15832,12134,-3698
2017,12,2,6,14676,14950,11257,-3693
2017,12,2,7,14054,14357,10843,-3514
2017,12,2,8,13688,14024,10779,-3245
2017,12,2,9,13526,13875,10803,-3072
2017,12,2,10,13605,13934,11032,-2902
2017,12,2,11,13996,14335,11672,-2663
2017,12,2,12,14680,15075,12447,-2628
2017,12,2,13,15270,15814,13373,-2441
2017,12,2,14,15896,16509,13967,-2542
2017,12,2,15,16357,16903,14349,-2554
2017,12,2,16,16529,17039,14331,-2708
2017,12,2,17,16509,17010,14228,-2782
2017,12,2,18,16430,16909,13833,-3076
2017,12,2,19,16341,16832,13525,-3307
2017,12,2,20,16352,16791,13606,-3185
2017,12,2,21,16613,16988,13919,-3069
2017,12,2,22,17490,17866,14910,-2956
2017,12,2,23,18559,18658,15675,-2983
2017,12,3,0,18547,18707,15598,-3109
2017,12,3,1,18231,18457,14967,-3490
2017,12,3,2,17792,18090,14804,-3286
2017,12,3,3,17146,17537,14206,-3331
2017,12,3,4,16262,16677,13123,-3554
2017,12,3,5,15284,15683,12347,-3336
2017,12,3,6,14366,14790,11373,-3417
2017,12,3,7,13745,14166,10902,-3264
2017,12,3,8,13368,13804,10585,-3219
2017,12,3,9,13192,13605,10446,-3159
2017,12,3,10,13223,13612,10596,-3016
2017,12,3,11,13514,13873,11081,-2792
2017,12,3,12,14004,14415,11864,-2551
2017,12,3,13,14409,14965,12293,-2672
2017,12,3,14,14951,15722,12726,-2996
2017,12,3,15,15379,16321,12983,-3338
2017,12,3,16,15543,16534,13165,-3369
2017,12,3,17,15564,16571,12938,-3633
2017,12,3,18,15550,16650,12887,-3763
2017,12,3,19,15521,16718,13198,-3520
2017,12,3,20,15602,16832,13410,-3422
2017,12,3,21,15970,17094,13810,-3284
2017,12,3,22,16992,18069,14400,-3669
2017,12,3,23,18287,19156,15643,-3513
2017,12,4,0,18410,19157,15653,-3504
2017,12,4,1,18219,18872,15071,-3801
2017,12,4,2,17841,18413,14788,-3625
2017,12,4,3,17084,17669,14077,-3592
2017,12,4,4,16018,16534,13290,-3244
2017,12,4,5,14898,15319,12004,-3315
2017,12,4,6,14044,14505,11310,-3195
2017,12,4,7,13574,14063,10868,-3195
2017,12,4,8,13336,13834,10668,-3166
2017,12,4,9,13311,13819,10380,-3439
2017,12,4,10,13627,14148,10610,-3538
2017,12,4,11,14631,15176,11903,-3273
2017,12,4,12,16468,17011,13984,-3027
2017,12,4,13,17650,18210,15405,-2805
2017,12,4,14,17888,18533,15365,-3168
2017,12,4,15,17927,18637,15262,-3375
2017,12,4,16,17831,18624,15191,-3433
2017,12,4,17,17656,18464,14916,-3548
2017,12,4,18,17493,18326,14711,-3615
2017,12,4,19,17503,18305,14724,-3581
2017,12,4,20,17597,18316,14687,-3629
2017,12,4,21,17930,18574,15262,-3312
2017,12,4,22,18855,19695,16094,-3601
2017,12,4,23,19927,20707,17120,-3587
2017,12,5,0,19836,20538,17496,-3042
2017,12,5,1,19466,20148,17168,-2980
2017,12,5,2,18881,19535,16554,-2981
2017,12,5,3,17926,18512,15429,-3083
2017,12,5,4,16590,17087,14152,-2935
2017,12,5,5,15213,15699,13117,-2582
2017,12,5,6,14271,14628,12179,-2449
2017,12,5,7,13701,13991,11615,-2376
2017,12,5,8,13392,13621,11255,-2366
2017,12,5,9,13283,13521,11166,-2355
2017,12,5,10,13507,13734,11583,-2151
2017,12,5,11,14403,14685,12310,-2375
2017,12,5,12,16095,16460,13770,-2690
2017,12,5,13,17280,17828,14891,-2937
2017,12,5,14,17666,18341,15427,-2914
2017,12,5,15,17913,18671,15609,-3062
2017,12,5,16,17999,18833,15737,-3096
2017,12,5,17,17984,18866,15900,-2966
2017,12,5,18,17919,18792,15586,-3206
2017,12,5,19,17957,18704,15528,-3176
2017,12,5,20,17979,18690,15544,-3146
2017,12,5,21,18206,18897,15621,-3276
2017,12,5,22,19033,19726,16095,-3631
2017,12,5,23,19887,20367,17364,-3003
2017,12,6,0,19668,20129,16432,-3697
2017,12,6,1,19189,19734,16059,-3675
2017,12,6,2,18569,19149,16009,-3140
2017,12,6,3,17609,18167,15118,-3049
2017,12,6,4,16328,16744,14036,-2708
2017,12,6,5,15012,15372,13134,-2238
2017,12,6,6,14097,14377,12874,-1503
2017,12,6,7,13513,13780,12197,-1583
2017,12,6,8,13189,13488,11979,-1509
2017,12,6,9,13100,13398,11781,-1617
2017,12,6,10,13349,13666,12052,-1614
2017,12,6,11,14284,14626,12620,-2006
2017,12,6,12,16083,16538,14178,-2360
2017,12,6,13,17378,17904,14880,-3024
2017,12,6,14,17736,18358,14961,-3397
2017,12,6,15,17889,18605,15311,-3294
2017,12,6,16,17838,18681,15523,-3158
2017,12,6,17,17752,18621,15507,-3114
2017,12,6,18,17646,18416,15640,-2776
2017,12,6,19,17731,18432,15570,-2862
2017,12,6,20,17840,18558,15719,-2839
2017,12,6,21,18179,18933,16097,-2836
2017,12,6,22,19160,19963,16680,-3283
2017,12,6,23,20282,20946,17559,-3387
2017,12,7,0,20203,20762,17840,-2922
2017,12,7,1,19830,20393,17226,-3167
2017,12,7,2,19277,19826,16720,-3106
2017,12,7,3,18385,18936,16150,-2786
2017,12,7,4,17103,17540,14883,-2657
2017,12,7,5,15743,16074,13464,-2610
2017,12,7,6,14656,15075,12153,-2922
2017,12,7,7,14067,14499,11860,-2639
2017,12,7,8,13753,14164,11527,-2637
2017,12,7,9,13668,14084,11476,-2608
2017,12,7,10,13926,14349,11654,-2695
2017,12,7,11,14874,15334,12708,-2626
2017,12,7,12,16694,17227,14485,-2742
2017,12,7,13,17894,18497,15601,-2896
2017,12,7,14,18123,18750,15869,-2881
2017,12,7,15,18171,18843,15756,-3087
2017,12,7,16,18057,18862,15248,-3614
2017,12,7,17,17901,18829,14921,-3908
2017,12,7,18,17778,18733,14707,-4026
2017,12,7,19,17834,18767,14880,-3887
2017,12,7,20,17972,18805,15248,-3557
2017,12,7,21,18324,19038,16356,-2682
2017,12,7,22,19299,19934,16692,-3242
2017,12,7,23,20434,20937,17295,-3642
2017,12,8,0,20347,20883,17248,-3635
2017,12,8,1,19982,20604,17049,-3555
2017,12,8,2,19457,20072,16625,-3447
2017,12,8,3,18585,19141,16044,-3097
2017,12,8,4,17322,17774,14233,-3541
2017,12,8,5,15998,16402,13291,-3111
2017,12,8,6,14967,15406,12336,-3070
2017,12,8,7,14404,14825,12037,-2788
2017,12,8,8,14092,14538,11643,-2895
2017,12,8,9,14007,14460,11704,-2756
2017,12,8,10,14254,14767,12359,-2408
2017,12,8,11,15163,15709,13300,-2409
2017,12,8,12,16904,17485,15259,-2226
2017,12,8,13,18091,18687,15813,-2874
2017,12,8,14,18403,19166,15845,-3321
2017,12,8,15,18622,19367,15990,-3377
2017,12,8,16,18612,19464,16182,-3282
2017,12,8,17,18519,19437,16449,-2988
2017,12,8,18,18370,19222,16268,-2954
2017,12,8,19,18341,19212,16375,-2837
2017,12,8,20,18353,19265,16470,-2795
2017,12,8,21,18590,19495,16430,-3065
2017,12,8,22,19446,20381,17058,-3323
2017,12,8,23,20371,21116,18061,-3055
2017,12,9,0,20158,20973,17621,-3352
2017,12,9,1,19703,20534,17309,-3225
2017,12,9,2,19130,19991,16792,-3199
2017,12,9,3,18365,19186,16064,-3122
2017,12,9,4,17306,18108,15299,-2809
2017,12,9,5,16131,16854,13930,-2924
2017,12,9,6,15346,15802,12339,-3463
2017,12,9,7,14700,15218,11942,-3276
2017,12,9,8,14316,14776,11713,-3063
2017,12,9,9,14144,14574,11439,-3135
2017,12,9,10,14210,14648,11714,-2934
2017,12,9,11,14590,15025,11481,-3544
2017,12,9,12,15275,15657,12498,-3159
2017,12,9,13,15934,16509,13496,-3013
2017,12,9,14,16636,17400,14032,-3368
2017,12,9,15,17290,18133,14675,-3458
2017,12,9,16,17556,18608,14692,-3916
2017,12,9,17,17606,18974,14710,-4264
2017,12,9,18,17534,18970,14629,-4341
2017,12,9,19,17455,18834,14969,-3865
2017,12,9,20,17462,18708,15554,-3154
2017,12,9,21,17708,18834,15843,-2991
2017,12,9,22,18599,19651,16945,-2706
2017,12,9,23,19601,20417,17888,-2529
2017,12,10,0,19530,20318,17576,-2742
2017,12,10,1,19173,19948,16606,-3342
2017,12,10,2,18704,19501,15567,-3934
2017,12,10,3,18072,18863,15023,-3840
2017,12,10,4,17186,17831,14011,-3820
2017,12,10,5,16177,16787,13047,-3740
2017,12,10,6,15301,15829,11815,-4014
2017,12,10,7,14641,15214,11247,-3967
2017,12,10,8,14240,14822,11018,-3804
2017,12,10,9,14057,14666,10953,-3713
2017,12,10,10,14088,14665,11014,-3651
2017,12,10,11,14379,14897,11532,-3365
2017,12,10,12,14919,15446,12450,-2996
2017,12,10,13,15410,16076,12979,-3097
2017,12,10,14,15974,16935,13770,-3165
2017,12,10,15,16510,17610,14059,-3551
2017,12,10,16,16716,17886,14720,-3166
2017,12,10,17,16791,17944,14329,-3615
2017,12,10,18,16837,17978,14147,-3831
2017,12,10,19,16893,17992,14173,-3819
2017,12,10,20,17033,18081,14059,-4022
2017,12,10,21,17408,18328,14411,-3917
2017,12,10,22,18481,19444,15114,-4330
2017,12,10,23,19744,20591,16113,-4478
2017,12,11,0,19820,20552,16244,-4308
2017,12,11,1,19583,20214,16157,-4057
2017,12,11,2,19178,19692,15930,-3762
2017,12,11,3,18430,18849,15049,-3800
2017,12,11,4,17360,17595,13842,-3753
2017,12,11,5,16187,16350,12834,-3516
2017,12,11,6,15168,15465,11571,-3894
2017,12,11,7,14663,14934,10940,-3994
2017,12,11,8,14411,14655,10591,-4064
2017,12,11,9,14374,14586,10890,-3696
2017,12,11,10,14663,14901,11126,-3775
2017,12,11,11,15603,15911,12116,-3795
2017,12,11,12,17297,17745,13867,-3878
2017,12,11,13,18547,19012,15096,-3916
2017,12,11,14,18905,19384,15592,-3792
2017,12,11,15,19107,19597,15630,-3967
2017,12,11,16,19048,19717,15459,-4258
2017,12,11,17,18911,19688,15407,-4281
2017,12,11,18,18797,19559,15436,-4123
2017,12,11,19,18825,19519,15072,-4447
2017,12,11,20,18911,19525,15136,-4389
2017,12,11,21,19238,19802,15611,-4191
2017,12,11,22,20208,20789,16648,-4141
2017,12,11,23,21306,21824,17650,-4174
2017,12,12,0,21232,21718,17892,-3826
2017,12,12,1,20875,21310,17623,-3687
2017,12,12,2,20302,20689,17057,-3632
2017,12,12,3,19390,19782,15511,-4271
2017,12,12,4,18089,18421,14580,-3841
2017,12,12,5,16706,16945,13712,-3233
2017,12,12,6,15419,15865,13113,-2752
2017,12,12,7,14764,15244,12759,-2485
2017,12,12,8,14410,14879,12546,-2333
2017,12,12,9,14295,14727,12420,-2307
2017,12,12,10,14531,14919,12519,-2400
2017,12,12,11,15436,15894,13159,-2735
2017,12,12,12,17150,17622,13996,-3626
2017,12,12,13,18428,18855,15369,-3486
2017,12,12,14,18818,19331,15439,-3892
2017,12,12,15,19097,19633,15517,-4116
2017,12,12,16,19118,19821,15992,-3829
2017,12,12,17,19019,19856,15832,-4024
2017,12,12,18,18890,19810,15627,-4183
2017,12,12,19,18862,19774,15557,-4217
2017,12,12,20,18854,19724,15619,-4105
2017,12,12,21,19104,19881,15812,-4069
2017,12,12,22,20069,20825,16751,-4074
2017,12,12,23,21141,21891,17785,-4106
2017,12,13,0,21057,21817,17682,-4135
2017,12,13,1,20687,21564,17121,-4443
2017,12,13,2,20119,21039,16656,-4383
2017,12,13,3,19231,20157,16080,-4077
2017,12,13,4,17925,18856,15143,-3713
2017,12,13,5,16571,17523,14098,-3425
2017,12,13,6,15832,16531,13632,-2899
2017,12,13,7,15300,15985,13209,-2776
2017,12,13,8,15018,15767,13115,-2652
2017,12,13,9,14970,15808,13666,-2142
2017,12,13,10,15266,16153,13847,-2306
2017,12,13,11,16237,17185,14420,-2765
2017,12,13,12,18036,19110,16136,-2974
2017,12,13,13,19340,20295,17379,-2916
2017,12,13,14,19712,20776,17655,-3121
2017,12,13,15,19988,21073,17988,-3085
2017,12,13,16,20006,21287,17858,-3429
2017,12,13,17,19894,21284,18044,-3240
2017,12,13,18,19751,21064,17620,-3444
2017,12,13,19,19748,20892,17363,-3529
2017,12,13,20,19809,20844,16987,-3857
2017,12,13,21,20098,21099,17185,-3914
2017,12,13,22,21111,22077,18242,-3835
2017,12,13,23,22287,23237,19358,-3879
2017,12,14,0,22232,23141,19265,-3876
2017,12,14,1,21857,22695,18993,-3702
2017,12,14,2,21291,22109,18350,-3759
2017,12,14,3,20350,21138,17489,-3649
2017,12,14,4,18990,19662,16295,-3367
2017,12,14,5,17544,18109,14773,-3336
2017,12,14,6,16466,17132,13452,-3680
2017,12,14,7,15837,16490,12850,-3640
2017,12,14,8,15505,16158,12700,-3458
2017,12,14,9,15415,16063,12838,-3225
2017,12,14,10,15654,16310,12829,-3481
2017,12,14,11,16551,17257,13449,-3808
2017,12,14,12,18260,18959,15167,-3792
2017,12,14,13,19532,20138,17304,-2834
2017,12,14,14,19875,20631,17956,-2675
2017,12,14,15,20090,20926,17640,-3286
2017,12,14,16,20041,21009,17245,-3764
2017,12,14,17,19857,20949,16790,-4159
2017,12,14,18,19664,20727,16405,-4322
2017,12,14,19,19638,20660,16332,-4328
2017,12,14,20,19686,20673,16400,-4273
2017,12,14,21,20000,20892,16773,-4119
2017,12,14,22,20995,21921,18513,-3408
2017,12,14,23,22210,23212,19614,-3598
2017,12,15,0,22226,23101,19183,-3918
2017,12,15,1,21892,22764,19113,-3651
2017,12,15,2,21378,22235,18261,-3974
2017,12,15,3,20503,21323,17671,-3652
2017,12,15,4,19212,19912,16228,-3684
2017,12,15,5,17851,18463,14782,-3681
2017,12,15,6,16954,17451,13544,-3907
2017,12,15,7,16343,16837,13098,-3739
2017,12,15,8,16017,16538,12896,-3642
2017,12,15,9,15923,16462,12798,-3664
2017,12,15,10,16157,16707,12959,-3748
2017,12,15,11,17032,17639,13718,-3921
2017,12,15,12,18706,19491,15687,-3804
2017,12,15,13,19929,20674,17691,-2983
2017,12,15,14,20263,21183,17513,-3670
2017,12,15,15,20578,21447,16829,-4618
2017,12,15,16,20586,21515,16721,-4794
2017,12,15,17,20453,21418,16363,-5055
2017,12,15,18,20252,21236,16523,-4713
2017,12,15,19,20177,21234,16832,-4402
2017,12,15,20,20129,21203,16678,-4525
2017,12,15,21,20302,21391,17327,-4064
2017,12,15,22,21134,22220,19020,-3200
2017,12,15,23,22008,22864,19886,-2978
2017,12,16,0,21761,22561,19397,-3164
2017,12,16,1,21262,22166,18784,-3382
2017,12,16,2,20648,21643,17425,-4218
2017,12,16,3,19860,20864,16168,-4696
2017,12,16,4,18760,19707,15215,-4492
2017,12,16,5,17527,18387,14523,-3864
2017,12,16,6,16810,17300,13139,-4161
2017,12,16,7,16139,16620,12967,-3653
2017,12,16,8,15735,16205,12516,-3689
2017,12,16,9,15548,16017,12194,-3823
2017,12,16,10,15590,16036,12407,-3629
2017,12,16,11,15936,16352,12766,-3586
2017,12,16,12,16636,17088,13381,-3707
2017,12,16,13,17261,17944,14488,-3456
2017,12,16,14,17808,18762,14865,-3897
2017,12,16,15,18317,19378,15167,-4211
2017,12,16,16,18454,19627,15485,-4142
2017,12,16,17,18431,19651,15336,-4315
2017,12,16,18,18324,19465,14852,-4613
2017,12,16,19,18254,19209,14487,-4722
2017,12,16,20,18256,19286,14430,-4856
2017,12,16,21,18511,19508,14739,-4769
2017,12,16,22,19448,20297,15481,-4816
2017,12,16,23,20531,21077,16250,-4827
2017,12,17,0,20536,20947,16199,-4748
2017,12,17,1,20236,20563,15927,-4636
2017,12,17,2,19831,20125,15727,-4398
2017,12,17,3,19262,19552,15120,-4432
2017,12,17,4,18420,18614,14688,-3926
2017,12,17,5,17399,17546,13373,-4173
2017,12,17,6,16308,16580,12795,-3785
2017,12,17,7,15666,15952,11699,-4253
2017,12,17,8,15290,15552,11539,-4013
2017,12,17,9,15133,15345,11535,-3810
2017,12,17,10,15179,15351,11564,-3787
2017,12,17,11,15475,15634,11818,-3816
2017,12,17,12,16022,16228,12618,-3610
2017,12,17,13,16473,16869,13416,-3453
2017,12,17,14,16964,17661,13939,-3722
2017,12,17,15,17530,18306,14206,-4100
2017,12,17,16,17734,18658,14868,-3790
2017,12,17,17,17797,18740,14769,-3971
2017,12,17,18,17800,18670,14608,-4062
2017,12,17,19,17823,18603,14890,-3713
2017,12,17,20,17916,18628,14393,-4235
2017,12,17,21,18240,18853,14360,-4493
2017,12,17,22,19305,19940,15112,-4828
2017,12,17,23,20513,21090,16541,-4549
2017,12,18,0,20563,21079,16257,-4822
2017,12,18,1,20304,20844,16000,-4844
2017,12,18,2,19877,20426,15609,-4817
2017,12,18,3,19150,19578,15182,-4396
2017,12,18,4,18074,18367,14092,-4275
2017,12,18,5,16850,17052,13059,-3993
2017,12,18,6,15577,16079,12439,-3640
2017,12,18,7,14974,15532,11996,-3536
2017,12,18,8,14669,15223,11644,-3579
2017,12,18,9,14584,15147,11603,-3544
2017,12,18,10,14844,15432,11879,-3553
2017,12,18,11,15768,16398,12947,-3451
2017,12,18,12,17462,18089,15087,-3002
2017,12,18,13,18769,19354,16705,-2649
2017,12,18,14,19154,19860,16579,-3281
2017,12,18,15,19485,20241,15994,-4247
2017,12,18,16,19495,20382,16306,-4076
2017,12,18,17,19341,20280,16132,-4148
2017,12,18,18,19155,19974,15827,-4147
2017,12,18,19,19097,19864,15848,-4016
2017,12,18,20,19080,19774,15616,-4158
2017,12,18,21,19306,19918,16300,-3618
2017,12,18,22,20267,20820,17312,-3508
2017,12,18,23,21281,21787,18166,-3621
2017,12,19,0,21098,21675,17603,-4072
2017,12,19,1,20693,21245,17033,-4212
2017,12,19,2,20093,20680,16519,-4161
2017,12,19,3,19184,19741,15637,-4104
2017,12,19,4,17859,18309,14547,-3762
2017,12,19,5,16427,16709,12764,-3945
2017,12,19,6,15219,15587,11798,-3789
2017,12,19,7,14572,14951,11342,-3609
2017,12,19,8,14227,14596,11248,-3348
2017,12,19,9,14117,14493,11185,-3308
2017,12,19,10,14366,14742,11292,-3450
2017,12,19,11,15306,15665,12123,-3542
2017,12,19,12,17097,17468,13802,-3666
2017,12,19,13,18369,18735,14543,-4192
2017,12,19,14,18659,19137,14629,-4508
2017,12,19,15,18925,19290,14552,-4738
2017,12,19,16,18893,19238,14756,-4482
2017,12,19,17,18802,19106,14773,-4333
2017,12,19,18,18668,18903,14361,-4542
2017,12,19,19,18667,18842,14327,-4515
2017,12,19,20,18681,18880,14351,-4529
2017,12,19,21,18903,19074,14443,-4631
2017,12,19,22,19867,20057,15503,-4554
2017,12,19,23,20817,21073,16662,-4411
2017,12,20,0,20607,20878,16256,-4622
2017,12,20,1,20206,20518,15950,-4568
2017,12,20,2,19678,20028,15366,-4662
2017,12,20,3,18814,19126,14434,-4692
2017,12,20,4,17513,17774,13735,-4039
2017,12,20,5,16106,16318,12997,-3321
2017,12,20,6,14922,15257,11949,-3308
2017,12,20,7,14299,14637,11524,-3113
2017,12,20,8,13969,14310,11088,-3222
2017,12,20,9,13880,14237,11358,-2879
2017,12,20,10,14132,14536,11519,-3017
2017,12,20,11,15052,15485,12394,-3091
2017,12,20,12,16827,17330,14302,-3028
2017,12,20,13,18108,18693,15704,-2989
2017,12,20,14,18460,19083,15621,-3462
2017,12,20,15,18747,19375,15453,-3922
2017,12,20,16,18783,19511,15560,-3951
2017,12,20,17,18750,19497,15521,-3976
2017,12,20,18,18654,19412,15247,-4165
2017,12,20,19,18653,19456,15166,-4290
2017,12,20,20,18706,19546,15271,-4275
2017,12,20,21,18984,19674,15489,-4185
2017,12,20,22,19962,20690,16719,-3971
2017,12,20,23,21048,21703,17662,-4041
2017,12,21,0,20999,21588,17475,-4113
2017,12,21,1,20661,21310,17089,-4221
2017,12,21,2,20187,20794,16652,-4142
2017,12,21,3,19415,19924,16071,-3853
2017,12,21,4,18207,18599,14479,-4120
2017,12,21,5,16864,17160,12665,-4495
2017,12,21,6,15551,16110,12241,-3869
2017,12,21,7,14921,15506,12072,-3434
2017,12,21,8,14595,15239,12069,-3170
2017,12,21,9,14511,15182,11735,-3447
2017,12,21,10,14766,15488,12229,-3259
2017,12,21,11,15657,16415,12775,-3640
2017,12,21,12,17365,18229,14446,-3783
2017,12,21,13,18601,19467,15792,-3675
2017,12,21,14,18923,19792,16074,-3718
2017,12,21,15,19080,19788,16002,-3786
2017,12,21,16,19024,19706,15474,-4232
2017,12,21,17,18830,19528,15155,-4373
2017,12,21,18,18599,19341,14731,-4610
2017,12,21,19,18517,19291,14720,-4571
2017,12,21,20,18556,19348,14836,-4512
2017,12,21,21,18823,19619,15124,-4495
2017,12,21,22,19792,20640,16294,-4346
2017,12,21,23,20969,21777,17690,-4087
2017,12,22,0,20964,21663,17729,-3934
2017,12,22,1,20645,21319,17430,-3889
2017,12,22,2,20160,20869,16711,-4158
2017,12,22,3,19387,20098,15998,-4100
2017,12,22,4,18180,18852,14904,-3948
2017,12,22,5,16855,17453,13264,-4189
2017,12,22,6,15850,16379,12061,-4318
2017,12,22,7,15152,15764,11488,-4276
2017,12,22,8,14768,15388,11154,-4234
2017,12,22,9,14620,15263,11209,-4054
2017,12,22,10,14810,15503,11369,-4134
2017,12,22,11,15586,16373,12351,-4022
2017,12,22,12,17077,17960,14205,-3755
2017,12,22,13,18300,19239,15754,-3485
2017,12,22,14,18815,19864,16977,-2887
2017,12,22,15,19198,20293,17272,-3021
2017,12,22,16,19230,20500,17815,-2685
2017,12,22,17,19075,20518,17356,-3162
2017,12,22,18,18843,20299,16976,-3323
2017,12,22,19,18692,20057,16796,-3261
2017,12,22,20,18617,19926,16124,-3802
2017,12,22,21,18744,19977,16444,-3533
2017,12,22,22,19484,20712,17088,-3624
2017,12,22,23,20285,21337,18088,-3249
2017,12,23,0,20020,20998,17919,-3079
2017,12,23,1,19531,20514,17221,-3293
2017,12,23,2,18966,19933,16674,-3259
2017,12,23,3,18315,19200,15647,-3553
2017,12,23,4,17355,18190,14331,-3859
2017,12,23,5,16187,16950,12979,-3971
2017,12,23,6,15267,15845,11780,-4065
2017,12,23,7,14503,15149,11583,-3566
2017,12,23,8,14053,14741,11218,-3523
2017,12,23,9,13825,14525,10696,-3829
2017,12,23,10,13835,14539,10604,-3935
2017,12,23,11,14102,14837,10865,-3972
2017,12,23,12,14590,15478,11700,-3778
2017,12,23,13,15241,16384,12396,-3988
2017,12,23,14,16045,17309,13114,-4195
2017,12,23,15,16842,18146,13923,-4223
2017,12,23,16,17143,18716,14348,-4368
2017,12,23,17,17180,18979,14627,-4352
2017,12,23,18,17086,18944,14447,-4497
2017,12,23,19,16941,18770,14178,-4592
2017,12,23,20,16904,18630,13930,-4700
2017,12,23,21,17055,18576,14509,-4067
2017,12,23,22,17872,19128,15488,-3640
2017,12,23,23,18784,19789,15750,-4039
2017,12,24,0,18730,19682,15520,-4162
2017,12,24,1,18393,19417,15426,-3991
2017,12,24,2,18006,18983,14815,-4168
2017,12,24,3,17543,18465,14099,-4366
2017,12,24,4,16805,17604,13457,-4147
2017,12,24,5,15852,16525,12497,-4028
2017,12,24,6,15069,15549,11525,-4024
2017,12,24,7,14334,14865,10940,-3925
2017,12,24,8,13880,14443,10905,-3538
2017,12,24,9,13671,14237,10646,-3591
2017,12,24,10,13668,14192,10584,-3608
2017,12,24,11,13857,14423,10658,-3765
2017,12,24,12,14122,14964,11048,-3916
2017,12,24,13,14453,15651,11861,-3790
2017,12,24,14,15094,16468,13239,-3229
2017,12,24,15,16016,17192,13416,-3776
2017,12,24,16,16408,17515,13563,-3952
2017,12,24,17,16559,17665,13684,-3981
2017,12,24,18,16570,17659,13835,-3824
2017,12,24,19,16537,17644,13893,-3751
2017,12,24,20,16545,17633,13959,-3674
2017,12,24,21,16795,17723,14156,-3567
2017,12,24,22,17791,18375,14910,-3465
2017,12,24,23,18940,19125,15475,-3650
2017,12,25,0,18878,18859,15346,-3513
2017,12,25,1,18590,18451,14883,-3568
2017,12,25,2,18244,18188,15007,-3181
2017,12,25,3,17765,17890,14974,-2916
2017,12,25,4,16990,17381,14427,-2954
2017,12,25,5,15982,16567,13003,-3564
2017,12,25,6,14751,15725,12101,-3624
2017,12,25,7,14108,15058,11505,-3553
2017,12,25,8,13675,14616,11780,-2836
2017,12,25,9,13480,14385,12037,-2348
2017,12,25,10,13548,14377,11723,-2654
2017,12,25,11,13902,14659,11909,-2750
2017,12,25,12,14491,15202,11795,-3407
2017,12,25,13,15141,15806,12880,-2926
2017,12,25,14,15783,16492,13579,-2913
2017,12,25,15,16522,16987,13865,-3122
2017,12,25,16,16734,17308,14174,-3134
2017,12,25,17,16757,17526,13895,-3631
2017,12,25,18,16756,17532,13786,-3746
2017,12,25,19,16675,17382,13763,-3619
2017,12,25,20,16634,17379,13744,-3635
2017,12,25,21,16740,17513,14090,-3423
2017,12,25,22,17334,18193,14749,-3444
2017,12,25,23,18198,19076,15492,-3584
2017,12,26,0,18245,19088,15795,-3293
2017,12,26,1,18212,19002,15725,-3277
2017,12,26,2,18114,18880,15531,-3349
2017,12,26,3,17761,18576,14887,-3689
2017,12,26,4,17090,17867,14167,-3700
2017,12,26,5,16217,16971,13524,-3447
2017,12,26,6,15672,16229,13298,-2931
2017,12,26,7,15187,15737,12673,-3064
2017,12,26,8,14925,15478,12458,-3020
2017,12,26,9,14856,15454,12440,-3014
2017,12,26,10,15052,15685,12640,-3045
2017,12,26,11,15674,16397,13101,-3296
2017,12,26,12,16682,17580,13931,-3649
2017,12,26,13,17514,18662,14658,-4004
2017,12,26,14,18051,19453,15535,-3918
2017,12,26,15,18596,20051,15836,-4215
2017,12,26,16,18866,20490,16378,-4112
2017,12,26,17,18955,20540,16224,-4316
2017,12,26,18,18886,20485,16111,-4374
2017,12,26,19,18870,20423,15972,-4451
2017,12,26,20,18899,20433,15948,-4485
2017,12,26,21,19095,20649,16468,-4181
2017,12,26,22,19913,21595,17420,-4175
2017,12,26,23,21083,22832,18308,-4524
2017,12,27,0,21162,22750,18246,-4504
2017,12,27,1,20861,22345,17874,-4471
2017,12,27,2,20387,21824,17422,-4402
2017,12,27,3,19628,21026,16733,-4293
2017,12,27,4,18516,19861,16003,-3858
2017,12,27,5,17379,18616,14868,-3748
2017,12,27,6,16724,17660,13992,-3668
2017,12,27,7,16169,17052,13370,-3682
2017,12,27,8,15871,16727,12948,-3779
2017,12,27,9,15790,16605,12888,-3717
2017,12,27,10,16002,16811,13143,-3668
2017,12,27,11,16752,17546,13861,-3685
2017,12,27,12,18111,18855,15115,-3740
2017,12,27,13,19165,20051,16046,-4005
2017,12,27,14,19583,20744,17194,-3550
2017,12,27,15,19898,21123,17731,-3392
2017,12,27,16,20007,21214,17877,-3337
2017,12,27,17,19978,21284,17978,-3306
2017,12,27,18,19876,21187,17425,-3762
2017,12,27,19,19883,21136,17447,-3689
2017,12,27,20,19947,21182,17644,-3538
2017,12,27,21,20193,21382,17911,-3471
2017,12,27,22,21159,22248,19159,-3089
2017,12,27,23,22378,23551,20554,-2997
2017,12,28,0,22444,23441,20764,-2677
2017,12,28,1,22099,23078,20009,-3069
2017,12,28,2,21563,22589,19447,-3142
2017,12,28,3,20750,21807,18644,-3163
2017,12,28,4,19526,20586,17288,-3298
2017,12,28,5,18242,19300,16093,-3207
2017,12,28,6,17486,18359,14680,-3679
2017,12,28,7,16891,17777,14081,-3696
2017,12,28,8,16585,17480,14153,-3327
2017,12,28,9,16516,17398,14056,-3342
2017,12,28,10,16750,17660,14960,-2700
2017,12,28,11,17526,18416,15695,-2721
2017,12,28,12,18928,19722,17242,-2480
2017,12,28,13,20031,20870,17992,-2878
2017,12,28,14,20476,21625,18424,-3201
2017,12,28,15,20874,22092,18664,-3428
2017,12,28,16,20997,22257,18069,-4188
2017,12,28,17,20930,22251,17970,-4281
2017,12,28,18,20775,22096,18070,-4026
2017,12,28,19,20738,22036,18507,-3529
2017,12,28,20,20745,22017,18324,-3693
2017,12,28,21,20963,22186,18630,-3556
2017,12,28,22,21894,23086,19928,-3158
2017,12,28,23,23137,24256,21556,-2700
2017,12,29,0,23256,24189,21400,-2789
2017,12,29,1,22921,23814,20540,-3274
2017,12,29,2,22402,23291,19543,-3748
2017,12,29,3,21593,22457,18624,-3833
2017,12,29,4,20353,21269,17830,-3439
2017,12,29,5,19024,19931,16683,-3248
2017,12,29,6,17994,18891,15915,-2976
2017,12,29,7,17345,18267,15446,-2821
2017,12,29,8,17010,17901,15241,-2660
2017,12,29,9,16908,17754,15476,-2278
2017,12,29,10,17110,17885,15479,-2406
2017,12,29,11,17839,18519,16517,-2002
2017,12,29,12,19124,19658,17595,-2063
2017,12,29,13,20230,20780,18569,-2211
2017,12,29,14,20773,21621,19097,-2524
2017,12,29,15,21373,21965,19465,-2500
2017,12,29,16,21547,22069,19498,-2571
2017,12,29,17,21463,22060,19578,-2482
2017,12,29,18,21251,21818,19029,-2789
2017,12,29,19,21112,21707,18744,-2963
2017,12,29,20,21005,21486,18422,-3064
2017,12,29,21,21098,21618,18998,-2620
2017,12,29,22,21861,22467,19993,-2474
2017,12,29,23,22815,23579,21357,-2222
2017,12,30,0,22739,23512,21109,-2403
2017,12,30,1,22300,23126,20624,-2502
2017,12,30,2,21736,22581,20199,-2382
2017,12,30,3,21056,21882,19238,-2644
2017,12,30,4,20032,20842,18272,-2570
2017,12,30,5,18845,19621,16217,-3404
2017,12,30,6,17854,18581,15510,-3071
2017,12,30,7,17161,17942,15064,-2878
2017,12,30,8,16754,17535,14491,-3044
2017,12,30,9,16557,17325,14717,-2608
2017,12,30,10,16562,17341,14662,-2679
2017,12,30,11,16764,17575,15500,-2075
2017,12,30,12,17095,18172,16311,-1861
2017,12,30,13,17632,18791,16462,-2329
2017,12,30,14,18429,19628,16922,-2706
2017,12,30,15,19348,20489,17991,-2498
2017,12,30,16,19731,21020,18561,-2459
2017,12,30,17,19795,21152,18788,-2364
2017,12,30,18,19675,21125,18076,-3049
2017,12,30,19,19517,20909,17402,-3507
2017,12,30,20,19435,20725,17456,-3269
2017,12,30,21,19566,20706,17830,-2876
2017,12,30,22,20386,21368,18382,-2986
2017,12,30,23,21375,22551,19728,-2823
2017,12,31,0,21390,22582,19615,-2967
2017,12,31,1,21034,22273,19463,-2810
2017,12,31,2,20571,21839,18852,-2987
2017,12,31,3,20046,21218,18205,-3013
2017,12,31,4,19246,20285,17073,-3212
2017,12,31,5,18294,19195,15762,-3433
2017,12,31,6,17598,18343,14876,-3467
2017,12,31,7,16951,17728,14359,-3369
2017,12,31,8,16550,17337,14026,-3311
2017,12,31,9,16369,17149,13764,-3385
2017,12,31,10,16356,17145,13846,-3299
2017,12,31,11,16467,17411,14296,-3115
2017,12,31,12,16564,17923,15167,-2756
2017,12,31,13,16761,18568,16317,-2251
2017,12,31,14,17399,19361,17161,-2200
2017,12,31,15,18326,20083,17070,-3013
2017,12,31,16,18746,20599,17007,-3592
2017,12,31,17,18920,20841,17175,-3666
2017,12,31,18,18962,20982,17339,-3643
2017,12,31,19,18909,21199,18186,-3013
2017,12,31,20,18943,21314,18375,-2939
2017,12,31,21,19176,21503,18697,-2806
2017,12,31,22,20141,22287,19483,-2804
2017,12,31,23,21624,23553,20598,-2955
2018,1,1,0,21881,23475,20270,-3205
2018,1,1,1,21558,22871,19862,-3009
2018,1,1,2,21058,22310,19324,-2986
2018,1,1,3,20473,21612,17972,-3640
2018,1,1,4,19721,20906,17223,-3683
2018,1,1,5,18894,20178,16812,-3366
2018,1,1,6,17927,19467,16165,-3302
2018,1,1,7,17369,18882,15605,-3277
2018,1,1,8,16907,18420,15234,-3186
2018,1,1,9,16660,18138,14920,-3218
2018,1,1,10,16667,18018,15094,-2924
2018,1,1,11,16899,18190,15417,-2773
2018,1,1,12,17302,18643,16598,-2045
2018,1,1,13,17548,19011,17276,-1735
2018,1,1,14,17861,19513,17699,-1814
2018,1,1,15,18559,20095,17874,-2221
2018,1,1,16,18940,20524,17538,-2986
2018,1,1,17,19149,20745,16976,-3769
2018,1,1,18,19228,20830,17083,-3747
2018,1,1,19,19220,20779,17017,-3762
2018,1,1,20,19246,20785,17074,-3711
2018,1,1,21,19452,21015,17552,-3463
2018,1,1,22,20222,21982,19097,-2885
2018,1,1,23,21666,23435,20252,-3183
2018,1,2,0,21901,23435,20486,-2949
2018,1,2,1,21699,23148,20465,-2683
2018,1,2,2,21264,22651,19612,-3039
2018,1,2,3,20531,21759,19033,-2726
2018,1,2,4,19528,20466,17875,-2591
2018,1,2,5,18505,19276,16995,-2281
2018,1,2,6,17881,18439,16620,-1819
2018,1,2,7,17359,17908,15806,-2102
2018,1,2,8,17078,17675,15566,-2109
2018,1,2,9,17000,17608,15431,-2177
2018,1,2,10,17228,17881,15816,-2065
2018,1,2,11,18015,18783,17082,-1701
2018,1,2,12,19454,20456,18221,-2235
2018,1,2,13,20525,21731,19544,-2187
2018,1,2,14,20811,22199,19543,-2656
2018,1,2,15,21053,22533,19782,-2751
2018,1,2,16,21102,22660,19739,-2921
2018,1,2,17,21023,22610,19704,-2906
2018,1,2,18,20882,22448,19160,-3288
2018,1,2,19,20798,22318,19263,-3055
2018,1,2,20,20730,22142,18894,-3248
2018,1,2,21,20827,22221,18918,-3303
2018,1,2,22,21449,23022,20206,-2816
2018,1,2,23,22660,24419,21799,-2620
2018,1,3,0,22709,24471,21743,-2728
2018,1,3,1,22349,24068,21437,-2631
2018,1,3,2,21779,23389,20201,-3188
2018,1,3,3,20818,22345,19140,-3205
2018,1,3,4,19568,20951,18392,-2559
2018,1,3,5,18337,19519,17207,-2312
2018,1,3,6,17599,18521,16439,-2082
2018,1,3,7,17076,17953,15552,-2401
2018,1,3,8,16801,17651,15086,-2565
2018,1,3,9,16734,17572,15354,-2218
2018,1,3,10,16987,17832,15663,-2169
2018,1,3,11,17869,18707,16642,-2065
2018,1,3,12,19534,20439,18475,-1964
2018,1,3,13,20704,21659,19251,-2408
2018,1,3,14,20878,21963,19739,-2224
2018,1,3,15,20965,22004,19515,-2489
2018,1,3,16,20882,21937,19102,-2835
2018,1,3,17,20733,21745,18720,-3025
2018,1,3,18,20542,21527,18266,-3261
2018,1,3,19,20487,21407,18217,-3190
2018,1,3,20,20439,21281,17924,-3357
2018,1,3,21,20606,21402,18477,-2925
2018,1,3,22,21334,22213,19502,-2711
2018,1,3,23,22520,23460,20672,-2788
2018,1,4,0,22540,23531,20788,-2743
2018,1,4,1,22178,23151,20676,-2475
2018,1,4,2,21623,22556,20252,-2304
2018,1,4,3,20700,21618,19242,-2376
2018,1,4,4,19432,20308,17752,-2556
2018,1,4,5,18139,19016,16247,-2769
2018,1,4,6,17133,17975,15974,-2001
2018,1,4,7,16531,17364,15290,-2074
2018,1,4,8,16218,16981,14838,-2143
2018,1,4,9,16130,16870,14228,-2642
2018,1,4,10,16375,17098,14470,-2628
2018,1,4,11,17262,17954,15459,-2495
2018,1,4,12,18932,19357,17346,-2011
2018,1,4,13,20240,20542,18244,-2298
2018,1,4,14,20654,21191,18332,-2859
2018,1,4,15,21161,21826,19121,-2705
2018,1,4,16,21312,22304,19594,-2710
2018,1,4,17,21276,22525,20010,-2515
2018,1,4,18,21162,22515,20103,-2412
2018,1,4,19,21110,22446,20332,-2114
2018,1,4,20,21026,22275,20278,-1997
2018,1,4,21,21125,22206,20183,-2023
2018,1,4,22,21783,22722,20426,-2296
2018,1,4,23,22863,23857,21463,-2394
2018,1,5,0,22843,23846,21941,-1905
2018,1,5,1,22442,23403,21787,-1616
2018,1,5,2,21869,22722,20774,-1948
2018,1,5,3,20959,21801,19406,-2395
2018,1,5,4,19728,20621,18827,-1794
2018,1,5,5,18496,19474,17977,-1497
2018,1,5,6,17750,18645,17366,-1279
2018,1,5,7,17227,18176,16835,-1341
2018,1,5,8,16969,17968,16743,-1225
2018,1,5,9,16934,17951,16900,-1051
2018,1,5,10,17221,18257,17349,-908
2018,1,5,11,18127,19105,18101,-1004
2018,1,5,12,19811,20457,19173,-1284
2018,1,5,13,21135,21589,20450,-1139
2018,1,5,14,21585,22349,20970,-1379
2018,1,5,15,22199,22887,21451,-1436
2018,1,5,16,22354,23185,21748,-1437
2018,1,5,17,22305,23292,21821,-1471
2018,1,5,18,22154,23291,21264,-2027
2018,1,5,19,22087,23225,21010,-2215
2018,1,5,20,22036,23190,20960,-2230
2018,1,5,21,22091,23300,21342,-1958
2018,1,5,22,22629,23943,22194,-1749
2018,1,5,23,23615,25081,23667,-1414
2018,1,6,0,23609,25012,23671,-1341
2018,1,6,1,23196,24615,23815,-800
2018,1,6,2,22645,24047,22924,-1123
2018,1,6,3,21883,23206,21656,-1550
2018,1,6,4,20876,22129,20598,-1531
2018,1,6,5,19774,20941,19728,-1213
2018,1,6,6,18679,19971,19131,-840
2018,1,6,7,18064,19346,18990,-356
2018,1,6,8,17724,18956,18642,-314
2018,1,6,9,17580,18801,18073,-728
2018,1,6,10,17643,18827,18380,-447
2018,1,6,11,17951,19117,18949,-168
2018,1,6,12,18572,19765,19947,182
2018,1,6,13,19245,20483,20410,-73
2018,1,6,14,19949,21250,20829,-421
2018,1,6,15,20914,21857,21243,-614
2018,1,6,16,21240,22226,20879,-1347
2018,1,6,17,21275,22378,20386,-1992
2018,1,6,18,21144,22268,20333,-1935
2018,1,6,19,20996,22130,20314,-1816
2018,1,6,20,20897,22092,20318,-1774
2018,1,6,21,20963,22279,20182,-2097
2018,1,6,22,21463,23021,21622,-1399
2018,1,6,23,22571,24302,22731,-1571
2018,1,7,0,22735,24303,22910,-1393
2018,1,7,1,22434,23977,22990,-987
2018,1,7,2,22012,23540,22613,-927
2018,1,7,3,21421,22858,21499,-1359
2018,1,7,4,20683,21882,20728,-1154
2018,1,7,5,19829,20816,19453,-1363
2018,1,7,6,18887,19933,18427,-1506
2018,1,7,7,18281,19286,17400,-1886
2018,1,7,8,17917,18905,17382,-1523
2018,1,7,9,17753,18716,17249,-1467
2018,1,7,10,17782,18673,17330,-1343
2018,1,7,11,18005,18889,18158,-731
2018,1,7,12,18461,19407,19270,-137
2018,1,7,13,18920,20030,19623,-407
2018,1,7,14,19430,20673,19707,-966
2018,1,7,15,20120,21214,20024,-1190
2018,1,7,16,20359,21476,19693,-1783
2018,1,7,17,20385,21620,19414,-2206
2018,1,7,18,20289,21520,19134,-2386
2018,1,7,19,20191,21397,19372,-2025
2018,1,7,20,20140,21318,19347,-1971
2018,1,7,21,20295,21486,19515,-1971
2018,1,7,22,20948,22526,21011,-1515
2018,1,7,23,22266,23757,22273,-1484
2018,1,8,0,22489,23700,22034,-1666
2018,1,8,1,22192,23244,21466,-1778
2018,1,8,2,21702,22676,20748,-1928
2018,1,8,3,20868,21741,19797,-1944
2018,1,8,4,19814,20462,18912,-1550
2018,1,8,5,18695,19185,17729,-1456
2018,1,8,6,17769,18311,16333,-1978
2018,1,8,7,17205,17782,15938,-1844
2018,1,8,8,16913,17450,15674,-1776
2018,1,8,9,16829,17348,15787,-1561
2018,1,8,10,17087,17565,15861,-1704
2018,1,8,11,17999,18497,16715,-1782
2018,1,8,12,19689,20154,18295,-1859
2018,1,8,13,21023,21318,19048,-2270
2018,1,8,14,21389,21586,19401,-2185
2018,1,8,15,21752,21902,19494,-2408
2018,1,8,16,21869,22136,19767,-2369
2018,1,8,17,21791,22140,19938,-2202
2018,1,8,18,21620,22111,19784,-2327
2018,1,8,19,21526,22026,19472,-2554
2018,1,8,20,21376,21904,19017,-2887
2018,1,8,21,21450,22002,19093,-2909
2018,1,8,22,22039,22611,19868,-2743
2018,1,8,23,22994,23468,20667,-2801
2018,1,9,0,22893,23298,20860,-2438
2018,1,9,1,22399,22883,20449,-2434
2018,1,9,2,21702,22141,19715,-2426
2018,1,9,3,20654,21075,18378,-2697
2018,1,9,4,19301,19547,16664,-2883
2018,1,9,5,17914,18167,15132,-3035
2018,1,9,6,16512,17164,14964,-2200
2018,1,9,7,15926,16585,14541,-2044
2018,1,9,8,15623,16274,13928,-2346
2018,1,9,9,15544,16195,13763,-2432
2018,1,9,10,15813,16403,14222,-2181
2018,1,9,11,16752,17277,15496,-1781
2018,1,9,12,18533,19031,16730,-2301
2018,1,9,13,19822,20269,18630,-1639
2018,1,9,14,20063,20528,18939,-1589
2018,1,9,15,20325,20585,18720,-1865
2018,1,9,16,20301,20618,18987,-1631
2018,1,9,17,20199,20523,18353,-2170
2018,1,9,18,20021,20387,17421,-2966
2018,1,9,19,19961,20341,17393,-2948
2018,1,9,20,19923,20297,17686,-2611
2018,1,9,21,20100,20448,18025,-2423
2018,1,9,22,20788,21115,18589,-2526
2018,1,9,23,21943,22205,19558,-2647
2018,1,10,0,22058,22145,19379,-2766
2018,1,10,1,21722,21813,19119,-2694
2018,1,10,2,21213,21235,18388,-2847
2018,1,10,3,20319,20266,17147,-3119
2018,1,10,4,19079,18953,16056,-2897
2018,1,10,5,17804,17690,14978,-2712
2018,1,10,6,16424,16781,13732,-3049
2018,1,10,7,15885,16298,13089,-3209
2018,1,10,8,15622,16089,12849,-3240
2018,1,10,9,15571,16054,12801,-3253
2018,1,10,10,15873,16312,13039,-3273
2018,1,10,11,16876,17340,14095,-3245
2018,1,10,12,18747,19144,16074,-3070
2018,1,10,13,20029,20364,17256,-3108
2018,1,10,14,20172,20558,17112,-3446
2018,1,10,15,20261,20466,16843,-3623
2018,1,10,16,20134,20236,16536,-3700
2018,1,10,17,19944,19940,16304,-3636
2018,1,10,18,19699,19661,15934,-3727
2018,1,10,19,19627,19583,16011,-3572
2018,1,10,20,19586,19602,16041,-3561
2018,1,10,21,19790,19875,16182,-3693
2018,1,10,22,20469,20668,16920,-3748
2018,1,10,23,21503,21851,17422,-4429
2018,1,11,0,21464,21782,17253,-4529
2018,1,11,1,21038,21322,16942,-4380
2018,1,11,2,20452,20670,16558,-4112
2018,1,11,3,19507,19676,15549,-4127
2018,1,11,4,18203,18340,14814,-3526
2018,1,11,5,16872,17003,14003,-3000
2018,1,11,6,15478,16044,13310,-2734
2018,1,11,7,14874,15495,12953,-2542
2018,1,11,8,14536,15150,12601,-2549
2018,1,11,9,14412,15036,12795,-2241
2018,1,11,10,14633,15233,13146,-2087
2018,1,11,11,15543,16089,13714,-2375
2018,1,11,12,17296,17843,15537,-2306
2018,1,11,13,18554,19047,16490,-2557
2018,1,11,14,18817,19348,16416,-2932
2018,1,11,15,19058,19550,16526,-3024
2018,1,11,16,19115,19616,16557,-3059
2018,1,11,17,19036,19499,16575,-2924
2018,1,11,18,18886,19285,16361,-2924
2018,1,11,19,18808,19154,16174,-2980
2018,1,11,20,18719,19028,16112,-2916
2018,1,11,21,18834,19100,16221,-2879
2018,1,11,22,19382,19692,16676,-3016
2018,1,11,23,20265,20697,17553,-3144
2018,1,12,0,20137,20578,17321,-3257
2018,1,12,1,19664,20203,17373,-2830
2018,1,12,2,19054,19590,16709,-2881
2018,1,12,3,18130,18645,15559,-3086
2018,1,12,4,16905,17330,14109,-3221
2018,1,12,5,15675,16044,13263,-2781
2018,1,12,6,14452,15099,12072,-3027
2018,1,12,7,13895,14517,11644,-2873
2018,1,12,8,13585,14191,11240,-2951
2018,1,12,9,13455,14102,11251,-2851
2018,1,12,10,13652,14303,11410,-2893
2018,1,12,11,14501,15108,12012,-3096
2018,1,12,12,16107,16806,13813,-2993
2018,1,12,13,17343,18111,15221,-2890
2018,1,12,14,17731,18593,15555,-3038
2018,1,12,15,18158,18943,15461,-3482
2018,1,12,16,18321,19097,15420,-3677
2018,1,12,17,18343,19192,15837,-3355
2018,1,12,18,18269,19137,16548,-2589
2018,1,12,19,18248,19112,16256,-2856
2018,1,12,20,18215,18994,15513,-3481
2018,1,12,21,18308,19040,15256,-3784
2018,1,12,22,18750,19537,15569,-3968
2018,1,12,23,19423,20112,15561,-4551
2018,1,13,0,19233,19873,15738,-4135
2018,1,13,1,18678,19413,15585,-3828
2018,1,13,2,18042,18854,14904,-3950
2018,1,13,3,17312,18075,14009,-4066
2018,1,13,4,16410,17150,13262,-3888
2018,1,13,5,15464,16096,12202,-3894
2018,1,13,6,14859,15294,11420,-3874
2018,1,13,7,14321,14739,11034,-3705
2018,1,13,8,14026,14430,10683,-3747
2018,1,13,9,13914,14344,10288,-4056
2018,1,13,10,14025,14430,10397,-4033
2018,1,13,11,14449,14753,11338,-3415
2018,1,13,12,15130,15457,12477,-2980
2018,1,13,13,15853,16355,13457,-2898
2018,1,13,14,16613,17273,13994,-3279
2018,1,13,15,17500,18095,14500,-3595
2018,1,13,16,17924,18677,14915,-3762
2018,1,13,17,18093,18830,15231,-3599
2018,1,13,18,18121,18742,14343,-4399
2018,1,13,19,18089,18659,14232,-4427
2018,1,13,20,18098,18678,14306,-4372
2018,1,13,21,18284,18907,14449,-4458
2018,1,13,22,18843,19682,15084,-4598
2018,1,13,23,19890,20952,16764,-4188
2018,1,14,0,20112,21153,17280,-3873
2018,1,14,1,19828,20892,17058,-3834
2018,1,14,2,19390,20618,16544,-4074
2018,1,14,3,18839,20074,15680,-4394
2018,1,14,4,18111,19238,15039,-4199
2018,1,14,5,17347,18390,14864,-3526
2018,1,14,6,16739,17613,14239,-3374
2018,1,14,7,16225,17089,13928,-3161
2018,1,14,8,15920,16798,13482,-3316
2018,1,14,9,15788,16677,13352,-3325
2018,1,14,10,15853,16747,13656,-3091
2018,1,14,11,16110,17031,13939,-3092
2018,1,14,12,16553,17591,15210,-2381
2018,1,14,13,16988,18193,15570,-2623
2018,1,14,14,17538,18859,16906,-1953
2018,1,14,15,18144,19360,17253,-2107
2018,1,14,16,18370,19608,17581,-2027
2018,1,14,17,18413,19641,17232,-2409
2018,1,14,18,18357,19571,16806,-2765
2018,1,14,19,18290,19436,16388,-3048
2018,1,14,20,18307,19409,16039,-3370
2018,1,14,21,18552,19675,16091,-3584
2018,1,14,22,19222,20406,17688,-2718
2018,1,14,23,20627,21719,19097,-2622
2018,1,15,0,21062,21868,19495,-2373
2018,1,15,1,20888,21576,19356,-2220
2018,1,15,2,20479,21254,18984,-2270
2018,1,15,3,19756,20702,18209,-2493
2018,1,15,4,18800,19825,16953,-2872
2018,1,15,5,17893,18876,15888,-2988
2018,1,15,6,17249,18089,14653,-3436
2018,1,15,7,16818,17623,14413,-3210
2018,1,15,8,16580,17359,14312,-3047
2018,1,15,9,16508,17260,14281,-2979
2018,1,15,10,16754,17455,14495,-2960
2018,1,15,11,17454,18134,15427,-2707
2018,1,15,12,18553,19280,17639,-1641
2018,1,15,13,19451,20275,18931,-1344
2018,1,15,14,20056,21003,18849,-2154
2018,1,15,15,20584,21447,18417,-3030
2018,1,15,16,20811,21763,18994,-2769
2018,1,15,17,20796,21839,18874,-2965
2018,1,15,18,20620,21666,18504,-3162
2018,1,15,19,20537,21506,18125,-3381
2018,1,15,20,20472,21352,18010,-3342
2018,1,15,21,20590,21411,18659,-2752
2018,1,15,22,21121,21946,19570,-2376
2018,1,15,23,22245,23022,20234,-2788
2018,1,16,0,22342,22998,20299,-2699
2018,1,16,1,21895,22583,19881,-2702
2018,1,16,2,21192,21965,19129,-2836
2018,1,16,3,20182,20980,17817,-3163
2018,1,16,4,18901,19672,16601,-3071
2018,1,16,5,17713,18444,15627,-2817
2018,1,16,6,16984,17494,14420,-3074
2018,1,16,7,16467,16948,13836,-3112
2018,1,16,8,16193,16664,13294,-3370
2018,1,16,9,16113,16567,13245,-3322
2018,1,16,10,16350,16800,13554,-3246
2018,1,16,11,17211,17717,15088,-2629
2018,1,16,12,18820,19461,17293,-2168
2018,1,16,13,20015,20740,18478,-2262
2018,1,16,14,20272,21122,18747,-2375
2018,1,16,15,20468,21289,18508,-2781
2018,1,16,16,20479,21336,18046,-3290
2018,1,16,17,20371,21285,17610,-3675
2018,1,16,18,20202,21122,17108,-4014
2018,1,16,19,20134,21005,16937,-4068
2018,1,16,20,20071,20836,17100,-3736
2018,1,16,21,20212,21029,17460,-3569
2018,1,16,22,20740,21568,18157,-3411
2018,1,16,23,21631,22555,19516,-3039
2018,1,17,0,21674,22488,19369,-3119
2018,1,17,1,21217,22048,18441,-3607
2018,1,17,2,20574,21420,17840,-3580
2018,1,17,3,19664,20334,16385,-3949
2018,1,17,4,18413,19031,14998,-4033
2018,1,17,5,17189,17696,13915,-3781
2018,1,17,6,16279,16710,12956,-3754
2018,1,17,7,15754,16215,12188,-4027
2018,1,17,8,15470,15917,12135,-3782
2018,1,17,9,15396,15863,12218,-3645
2018,1,17,10,15649,16105,12366,-3739
2018,1,17,11,16561,16986,13547,-3439
2018,1,17,12,18273,18677,15768,-2909
2018,1,17,13,19570,20037,16891,-3146
2018,1,17,14,19924,20580,17218,-3362
2018,1,17,15,20275,20968,17146,-3822
2018,1,17,16,20350,21168,17497,-3671
2018,1,17,17,20285,21236,17780,-3456
2018,1,17,18,20149,21250,18073,-3177
2018,1,17,19,20088,21131,17944,-3187
2018,1,17,20,20047,20979,17852,-3127
2018,1,17,21,20216,21081,18101,-2980
2018,1,17,22,20812,21657,18381,-3276
2018,1,17,23,21771,22704,19069,-3635
2018,1,18,0,21879,22782,19236,-3546
2018,1,18,1,21471,22409,18843,-3566
2018,1,18,2,20900,21848,18587,-3261
2018,1,18,3,20038,20960,17733,-3227
2018,1,18,4,18818,19599,16349,-3250
2018,1,18,5,17611,18349,15207,-3142
2018,1,18,6,16725,17515,13820,-3695
2018,1,18,7,16221,17082,13436,-3646
2018,1,18,8,15966,16857,13280,-3577
2018,1,18,9,15914,16830,13712,-3118
2018,1,18,10,16197,17146,14000,-3146
2018,1,18,11,17142,18070,15040,-3030
2018,1,18,12,18936,19921,16828,-3093
2018,1,18,13,20171,21170,17923,-3247
2018,1,18,14,20332,21528,18619,-2909
2018,1,18,15,20389,21628,18581,-3047
2018,1,18,16,20280,21555,18279,-3276
2018,1,18,17,20102,21346,17400,-3946
2018,1,18,18,19904,21155,17112,-4043
2018,1,18,19,19848,20997,16800,-4197
2018,1,18,20,19825,20909,16877,-4032
2018,1,18,21,20020,21009,16727,-4282
2018,1,18,22,20641,21504,17177,-4327
2018,1,18,23,21725,22624,18205,-4419
2018,1,19,0,21898,22677,18525,-4152
2018,1,19,1,21503,22338,18397,-3941
2018,1,19,2,20908,21739,17658,-4081
2018,1,19,3,20002,20752,16477,-4275
2018,1,19,4,18740,19438,15467,-3971
2018,1,19,5,17501,18220,14824,-3396
2018,1,19,6,16673,17387,13483,-3904
2018,1,19,7,16162,16847,12903,-3944
2018,1,19,8,15880,16499,12729,-3770
2018,1,19,9,15796,16457,12689,-3768
2018,1,19,10,16031,16698,12898,-3800
2018,1,19,11,16900,17584,13666,-3918
2018,1,19,12,18546,19293,15386,-3907
2018,1,19,13,19711,20489,16524,-3965
2018,1,19,14,19929,20874,16706,-4168
2018,1,19,15,20154,21073,17005,-4068
2018,1,19,16,20069,21096,16973,-4123
2018,1,19,17,19858,20809,16238,-4571
2018,1,19,18,19588,20567,16082,-4485
2018,1,19,19,19427,20247,15560,-4687
2018,1,19,20,19307,20075,15457,-4618
2018,1,19,21,19415,20069,15511,-4558
2018,1,19,22,19848,20459,15852,-4607
2018,1,19,23,20669,21418,16778,-4640
2018,1,20,0,20697,21409,17041,-4368
2018,1,20,1,20242,20960,16626,-4334
2018,1,20,2,19665,20379,16091,-4288
2018,1,20,3,18956,19662,15533,-4129
2018,1,20,4,17984,18594,14763,-3831
2018,1,20,5,16955,17473,13831,-3642
2018,1,20,6,16084,16511,12739,-3772
2018,1,20,7,15494,15933,12261,-3672
2018,1,20,8,15137,15554,11755,-3799
2018,1,20,9,14962,15382,11537,-3845
2018,1,20,10,15004,15384,11523,-3861
2018,1,20,11,15332,15677,11964,-3713
2018,1,20,12,15966,16309,12854,-3455
2018,1,20,13,16546,17068,13914,-3154
2018,1,20,14,17042,17688,14277,-3411
2018,1,20,15,17631,17987,14350,-3637
2018,1,20,16,17749,18064,14596,-3468
2018,1,20,17,17658,17865,14435,-3430
2018,1,20,18,17464,17579,14185,-3394
2018,1,20,19,17270,17312,13954,-3358
2018,1,20,20,17181,17160,13723,-3437
2018,1,20,21,17306,17240,13644,-3596
2018,1,20,22,17803,17808,14331,-3477
2018,1,20,23,18745,19009,15523,-3486
2018,1,21,0,18919,19207,15591,-3616
2018,1,21,1,18607,18954,15477,-3477
2018,1,21,2,18197,18606,15306,-3300
2018,1,21,3,17695,17982,14382,-3600
2018,1,21,4,16983,17146,13247,-3899
2018,1,21,5,16177,16287,12726,-3561
2018,1,21,6,15109,15549,12169,-3380
2018,1,21,7,14551,15029,11452,-3577
2018,1,21,8,14221,14731,11275,-3456
2018,1,21,9,14072,14516,10991,-3525
2018,1,21,10,14121,14462,10928,-3534
2018,1,21,11,14415,14726,11159,-3567
2018,1,21,12,14921,15199,11908,-3291
2018,1,21,13,15360,15731,12465,-3266
2018,1,21,14,15839,16391,13103,-3288
2018,1,21,15,16464,16858,13578,-3280
2018,1,21,16,16704,17029,13542,-3487
2018,1,21,17,16774,17086,13723,-3363
2018,1,21,18,16764,17114,13605,-3509
2018,1,21,19,16715,17037,13328,-3709
2018,1,21,20,16724,17093,13609,-3484
2018,1,21,21,16962,17339,14082,-3257
2018,1,21,22,17627,17911,14313,-3598
2018,1,21,23,18723,19009,14869,-4140
2018,1,22,0,18988,19278,15005,-4273
2018,1,22,1,18734,18983,14612,-4371
2018,1,22,2,18299,18460,14363,-4097
2018,1,22,3,17618,17657,13917,-3740
2018,1,22,4,16677,16592,13272,-3320
2018,1,22,5,15699,15545,12181,-3364
2018,1,22,6,14435,14801,11092,-3709
2018,1,22,7,13978,14341,10302,-4039
2018,1,22,8,13749,14120,10125,-3995
2018,1,22,9,13704,14055,10199,-3856
2018,1,22,10,13998,14349,10405,-3944
2018,1,22,11,14950,15344,11437,-3907
2018,1,22,12,16656,17117,13449,-3668
2018,1,22,13,17956,18503,14797,-3706
2018,1,22,14,18377,18992,14796,-4196
2018,1,22,15,18822,19308,15106,-4202
2018,1,22,16,18933,19502,15540,-3962
2018,1,22,17,18896,19464,15411,-4053
2018,1,22,18,18801,19356,15341,-4015
2018,1,22,19,18740,19347,15428,-3919
2018,1,22,20,18675,19284,15684,-3600
2018,1,22,21,18809,19421,15828,-3593
2018,1,22,22,19309,19933,16325,-3608
2018,1,22,23,20085,20824,17183,-3641
2018,1,23,0,20092,20758,17083,-3675
2018,1,23,1,19648,20316,16850,-3466
2018,1,23,2,18985,19607,16342,-3265
2018,1,23,3,18087,18556,15071,-3485
2018,1,23,4,16884,17266,13870,-3396
2018,1,23,5,15684,16032,12978,-3054
2018,1,23,6,14451,15123,11697,-3426
2018,1,23,7,13890,14632,11638,-2994
2018,1,23,8,13580,14346,11684,-2662
2018,1,23,9,13474,14259,11628,-2631
2018,1,23,10,13718,14492,11961,-2531
2018,1,23,11,14643,15366,12349,-3017
2018,1,23,12,16385,17125,13866,-3259
2018,1,23,13,17657,18512,15437,-3075
2018,1,23,14,18015,18969,15812,-3157
2018,1,23,15,18302,19271,15596,-3675
2018,1,23,16,18360,19444,15497,-3947
2018,1,23,17,18317,19520,15561,-3959
2018,1,23,18,18211,19360,15498,-3862
2018,1,23,19,18185,19110,15258,-3852
2018,1,23,20,18162,18819,15021,-3798
2018,1,23,21,18317,18911,15183,-3728
2018,1,23,22,18865,19528,15678,-3850
2018,1,23,23,19737,20429,16169,-4260
2018,1,24,0,19820,20364,15921,-4443
2018,1,24,1,19373,19964,15992,-3972
2018,1,24,2,18714,19371,15743,-3628
2018,1,24,3,17806,18490,15365,-3125
2018,1,24,4,16600,17262,14535,-2727
2018,1,24,5,15437,16106,13659,-2447
2018,1,24,6,14717,15309,12457,-2852
2018,1,24,7,14269,14818,12045,-2773
2018,1,24,8,14027,14556,11833,-2723
2018,1,24,9,13995,14541,12043,-2498
2018,1,24,10,14293,14818,12045,-2773
2018,1,24,11,15272,15809,12674,-3135
2018,1,24,12,17082,17621,14371,-3250
2018,1,24,13,18352,19001,15889,-3112
2018,1,24,14,18668,19411,16289,-3122
2018,1,24,15,18863,19638,16283,-3355
2018,1,24,16,18871,19667,16270,-3397
2018,1,24,17,18810,19528,16367,-3161
2018,1,24,18,18701,19444,16140,-3304
2018,1,24,19,18709,19394,15619,-3775
2018,1,24,20,18752,19377,15144,-4233
2018,1,24,21,19002,19605,15575,-4030
2018,1,24,22,19695,20256,16474,-3782
2018,1,24,23,20793,21498,17596,-3902
2018,1,25,0,21037,21735,17737,-3998
2018,1,25,1,20664,21407,17788,-3619
2018,1,25,2,20062,20855,17186,-3669
2018,1,25,3,19172,20005,16467,-3538
2018,1,25,4,17951,18760,15316,-3444
2018,1,25,5,16761,17562,14186,-3376
2018,1,25,6,15942,16703,13234,-3469
2018,1,25,7,15456,16250,12840,-3410
2018,1,25,8,15210,16029,12755,-3274
2018,1,25,9,15162,15991,12725,-3266
2018,1,25,10,15446,16276,13001,-3275
2018,1,25,11,16393,17279,13863,-3416
2018,1,25,12,18156,19071,16126,-2945
2018,1,25,13,19373,20354,17529,-2825
2018,1,25,14,19593,20615,16642,-3973
2018,1,25,15,19631,20634,16282,-4352
2018,1,25,16,19500,20506,16353,-4153
2018,1,25,17,19287,20329,16276,-4053
2018,1,25,18,19059,20094,16122,-3972
2018,1,25,19,18972,19962,15761,-4201
2018,1,25,20,18965,19931,15785,-4146
2018,1,25,21,19185,20165,16343,-3822
2018,1,25,22,19849,20817,17089,-3728
2018,1,25,23,21004,21892,17529,-4363
2018,1,26,0,21322,22061,17714,-4347
2018,1,26,1,20993,21732,17823,-3909
2018,1,26,2,20405,21082,17650,-3432
2018,1,26,3,19493,20150,16617,-3533
2018,1,26,4,18261,18884,15478,-3406
2018,1,26,5,17082,17653,14196,-3457
2018,1,26,6,16524,16803,13072,-3731
2018,1,26,7,16073,16332,12724,-3608
2018,1,26,8,15820,16066,12547,-3519
2018,1,26,9,15742,16044,12674,-3370
2018,1,26,10,15968,16387,12915,-3472
2018,1,26,11,16787,17343,13738,-3605
2018,1,26,12,18366,19099,15403,-3696
2018,1,26,13,19400,20254,16779,-3475
2018,1,26,14,19556,20403,16487,-3916
2018,1,26,15,19611,20302,16453,-3849
2018,1,26,16,19440,20100,16463,-3637
2018,1,26,17,19198,19811,16169,-3642
2018,1,26,18,18901,19524,16011,-3513
2018,1,26,19,18750,19369,15739,-3630
2018,1,26,20,18649,19267,15590,-3677
2018,1,26,21,18771,19357,15519,-3838
2018,1,26,22,19255,19847,16139,-3708
2018,1,26,23,20096,20773,17184,-3589
2018,1,27,0,20233,20940,17312,-3628
2018,1,27,1,19832,20597,17018,-3579
2018,1,27,2,19248,20016,16391,-3625
2018,1,27,3,18510,19251,15493,-3758
2018,1,27,4,17578,18289,14769,-3520
2018,1,27,5,16598,17180,13632,-3548
2018,1,27,6,15824,16201,12606,-3595
2018,1,27,7,15248,15616,12210,-3406
2018,1,27,8,14891,15284,12146,-3138
2018,1,27,9,14708,15120,12121,-2999
2018,1,27,10,14732,15152,12178,-2974
2018,1,27,11,15037,15474,12608,-2866
2018,1,27,12,15640,16178,13294,-2884
2018,1,27,13,16143,16841,14219,-2622
2018,1,27,14,16607,17384,14213,-3171
2018,1,27,15,17060,17672,14359,-3313
2018,1,27,16,17176,17745,14031,-3714
2018,1,27,17,17132,17691,14046,-3645
2018,1,27,18,17000,17552,13924,-3628
2018,1,27,19,16843,17429,13993,-3436
2018,1,27,20,16791,17426,14053,-3373
2018,1,27,21,16927,17560,14221,-3339
2018,1,27,22,17422,18047,14579,-3468
2018,1,27,23,18233,18901,15611,-3290
2018,1,28,0,18448,18912,15408,-3504
2018,1,28,1,18125,18571,15073,-3498
2018,1,28,2,17652,18100,14718,-3382
2018,1,28,3,17047,17468,14406,-3062
2018,1,28,4,16311,16606,13627,-2979
2018,1,28,5,15500,15681,12954,-2727
2018,1,28,6,14487,14861,11737,-3124
2018,1,28,7,13923,14290,11013,-3277
2018,1,28,8,13591,13955,10846,-3109
2018,1,28,9,13436,13770,10734,-3036
2018,1,28,10,13473,13762,11044,-2718
2018,1,28,11,13750,13990,11298,-2692
2018,1,28,12,14187,14510,11999,-2511
2018,1,28,13,14591,15128,12755,-2373
2018,1,28,14,15140,15861,13278,-2583
2018,1,28,15,15784,16533,13438,-3095
2018,1,28,16,16054,16932,13567,-3365
2018,1,28,17,16139,17131,13693,-3438
2018,1,28,18,16156,17109,13542,-3567
2018,1,28,19,16139,16973,13399,-3574
2018,1,28,20,16198,16900,13292,-3608
2018,1,28,21,16467,17040,13464,-3576
2018,1,28,22,17127,17626,14028,-3598
2018,1,28,23,18127,18702,14911,-3791
2018,1,29,0,18497,18985,15118,-3867
2018,1,29,1,18281,18711,14956,-3755
2018,1,29,2,17827,18255,14321,-3934
2018,1,29,3,17096,17525,13859,-3666
2018,1,29,4,16193,16562,13227,-3335
2018,1,29,5,15270,15557,12387,-3170
2018,1,29,6,14378,14859,11260,-3599
2018,1,29,7,13971,14355,10685,-3670
2018,1,29,8,13776,14196,10510,-3686
2018,1,29,9,13770,14190,10436,-3754
2018,1,29,10,14093,14543,10667,-3876
2018,1,29,11,15076,15594,11715,-3879
2018,1,29,12,16816,17485,13941,-3544
2018,1,29,13,18054,18806,15902,-2904
2018,1,29,14,18412,19165,16045,-3120
2018,1,29,15,18674,19319,16004,-3315
2018,1,29,16,18700,19333,16011,-3322
2018,1,29,17,18631,19204,15775,-3429
2018,1,29,18,18536,19076,15716,-3360
2018,1,29,19,18526,19174,15880,-3294
2018,1,29,20,18564,19157,15654,-3503
2018,1,29,21,18790,19330,15877,-3453
2018,1,29,22,19416,19914,16343,-3571
2018,1,29,23,20343,20899,17252,-3647
2018,1,30,0,20600,21042,17277,-3765
2018,1,30,1,20255,20669,16962,-3707
2018,1,30,2,19596,20044,16678,-3366
2018,1,30,3,18612,19103,15957,-3146
2018,1,30,4,17396,17862,14563,-3299
2018,1,30,5,16218,16630,13496,-3134
2018,1,30,6,15309,15798,12144,-3654
2018,1,30,7,14845,15358,11812,-3546
2018,1,30,8,14601,15112,11731,-3381
2018,1,30,9,14564,15095,11763,-3332
2018,1,30,10,14858,15420,11984,-3436
2018,1,30,11,15799,16476,13052,-3424
2018,1,30,12,17499,18287,14806,-3481
2018,1,30,13,18725,19631,15961,-3670
2018,1,30,14,19113,20103,16486,-3617
2018,1,30,15,19449,20466,16738,-3728
2018,1,30,16,19506,20573,16991,-3582
2018,1,30,17,19440,20478,16845,-3633
2018,1,30,18,19323,20415,16755,-3660
2018,1,30,19,19273,20400,16689,-3711
2018,1,30,20,19237,20346,16746,-3600
2018,1,30,21,19412,20448,16812,-3636
2018,1,30,22,20006,20969,17161,-3808
2018,1,30,23,20947,22009,18059,-3950
2018,1,31,0,21269,22260,18077,-4183
2018,1,31,1,20936,21984,17916,-4068
2018,1,31,2,20312,21452,17786,-3666
2018,1,31,3,19329,20522,16863,-3659
2018,1,31,4,18100,19278,16010,-3268
2018,1,31,5,16931,18067,14732,-3335
2018,1,31,6,16198,17163,12969,-4194
2018,1,31,7,15737,16706,12583,-4123
2018,1,31,8,15484,16476,12647,-3829
2018,1,31,9,15432,16442,12729,-3713
2018,1,31,10,15716,16767,12995,-3772
2018,1,31,11,16652,17764,13579,-4185
2018,1,31,12,18424,19595,15256,-4339
2018,1,31,13,19572,20729,16315,-4414
2018,1,31,14,19766,21014,16216,-4798
2018,1,31,15,19808,21047,16446,-4601
2018,1,31,16,19705,20921,16763,-4158
2018,1,31,17,19533,20722,16417,-4305
2018,1,31,18,19348,20521,16180,-4341
2018,1,31,19,19323,20412,16204,-4208
2018,1,31,20,19348,20348,16149,-4199
2018,1,31,21,19617,20526,16304,-4222
2018,1,31,22,20274,21076,16680,-4396
2018,1,31,23,21169,22024,17511,-4513
2018,2,1,0,21391,22229,17630,-4599
2018,2,1,1,20988,21796,17595,-4201
2018,2,1,2,20288,21202,17451,-3751
2018,2,1,3,19218,20159,16566,-3593
2018,2,1,4,17925,18775,15456,-3319
2018,2,1,5,16674,17442,14250,-3192
2018,2,1,6,16058,16431,12612,-3819
2018,2,1,7,15498,15848,12156,-3692
2018,2,1,8,15171,15554,12032,-3522
2018,2,1,9,15067,15432,11953,-3479
2018,2,1,10,15300,15641,12274,-3367
2018,2,1,11,16250,16555,12992,-3563
2018,2,1,12,17980,18275,14507,-3768
2018,2,1,13,19110,19482,15663,-3819
2018,2,1,14,19394,19861,15958,-3903
2018,2,1,15,19526,20084,16027,-4057
2018,2,1,16,19520,20049,15717,-4332
2018,2,1,17,19371,19852,15905,-3947
2018,2,1,18,19173,19625,15580,-4045
2018,2,1,19,19108,19479,15411,-4068
2018,2,1,20,19032,19386,15582,-3804
2018,2,1,21,19118,19533,15622,-3911
2018,2,1,22,19470,20003,16334,-3669
2018,2,1,23,20194,20870,17135,-3735
2018,2,2,0,20469,20900,16977,-3923
2018,2,2,1,19988,20572,16981,-3591
2018,2,2,2,19395,19993,16487,-3506
2018,2,2,3,18730,19103,15603,-3500
2018,2,2,4,17541,17859,14552,-3307
2018,2,2,5,16374,16701,13669,-3032
2018,2,2,6,15647,15854,12442,-3412
2018,2,2,7,15182,15443,11738,-3705
2018,2,2,8,14939,15232,11700,-3532
2018,2,2,9,14916,15239,11864,-3375
2018,2,2,10,15225,15556,12135,-3421
2018,2,2,11,16231,16563,12957,-3606
2018,2,2,12,18019,18446,14843,-3603
2018,2,2,13,19249,19846,16252,-3594
2018,2,2,14,19692,20434,16429,-4005
2018,2,2,15,20007,20629,16553,-4076
2018,2,2,16,20070,20654,16349,-4305
2018,2,2,17,19988,20689,16360,-4329
2018,2,2,18,19871,20672,16583,-4089
2018,2,2,19,19855,20647,17044,-3603
2018,2,2,20,19890,20682,16824,-3858
2018,2,2,21,20016,20843,16744,-4099
2018,2,2,22,20372,21370,17296,-4074
2018,2,2,23,21105,22312,18283,-4029
2018,2,3,0,21501,22642,18814,-3828
2018,2,3,1,21065,22299,18743,-3556
2018,2,3,2,20519,21781,17825,-3956
2018,2,3,3,19964,21081,16693,-4388
2018,2,3,4,19006,20026,15568,-4458
2018,2,3,5,17994,19001,14659,-4342
2018,2,3,6,17044,18137,13884,-4253
2018,2,3,7,16469,17589,13425,-4164
2018,2,3,8,16122,17223,13283,-3940
2018,2,3,9,15953,17064,13031,-4033
2018,2,3,10,16008,17095,13415,-3680
2018,2,3,11,16370,17393,13715,-3678
2018,2,3,12,17029,18120,14733,-3387
2018,2,3,13,17524,18684,15131,-3553
2018,2,3,14,18067,19317,15600,-3717
2018,2,3,15,18470,19642,16792,-2850
2018,2,3,16,18583,19630,17443,-2187
2018,2,3,17,18500,19577,16371,-3206
2018,2,3,18,18325,19405,15698,-3707
2018,2,3,19,18173,19141,15112,-4029
2018,2,3,20,18106,19048,15001,-4047
2018,2,3,21,18228,19139,15046,-4093
2018,2,3,22,18573,19543,15566,-3977
2018,2,3,23,19436,20436,16436,-4000
2018,2,4,0,19934,20765,16919,-3846
2018,2,4,1,19557,20508,16660,-3848
2018,2,4,2,19050,20091,16397,-3694
2018,2,4,3,18552,19464,15744,-3720
2018,2,4,4,17749,18617,14795,-3822
2018,2,4,5,16896,17623,14005,-3618
2018,2,4,6,16256,16747,12315,-4432
2018,2,4,7,15668,16164,11940,-4224
2018,2,4,8,15271,15745,11546,-4199
2018,2,4,9,15062,15492,11387,-4105
2018,2,4,10,15037,15456,11514,-3942
2018,2,4,11,15257,15637,11622,-4015
2018,2,4,12,15616,16061,12407,-3654
2018,2,4,13,15893,16597,13566,-3031
2018,2,4,14,16460,17289,14049,-3240
2018,2,4,15,17090,18024,14352,-3672
2018,2,4,16,17438,18397,14674,-3723
2018,2,4,17,17588,18554,14765,-3789
2018,2,4,18,17609,18771,15175,-3596
2018,2,4,19,17572,18812,15195,-3617
2018,2,4,20,17524,18867,15182,-3685
2018,2,4,21,17645,18977,15244,-3733
2018,2,4,22,18035,19338,15587,-3751
2018,2,4,23,18826,20060,16386,-3674
2018,2,5,0,19282,19844,15963,-3881
2018,2,5,1,18949,19205,15505,-3700
2018,2,5,2,18469,18634,15240,-3394
2018,2,5,3,17860,18019,14482,-3537
2018,2,5,4,16888,17254,13663,-3591
2018,2,5,5,15909,16378,12955,-3423
2018,2,5,6,15105,15520,11764,-3756
2018,2,5,7,14720,15056,11245,-3811
2018,2,5,8,14539,14867,11179,-3688
2018,2,5,9,14562,14868,11260,-3608
2018,2,5,10,14908,15186,11554,-3632
2018,2,5,11,15948,16213,12571,-3642
2018,2,5,12,17764,17943,14432,-3511
2018,2,5,13,18942,19143,15374,-3769
2018,2,5,14,19283,19835,15961,-3874
2018,2,5,15,19376,20076,16161,-3915
2018,2,5,16,19338,20117,16013,-4104
2018,2,5,17,19220,20042,15906,-4136
2018,2,5,18,19075,19890,15506,-4384
2018,2,5,19,19077,19829,15267,-4562
2018,2,5,20,19122,19753,15184,-4569
2018,2,5,21,19352,19926,15591,-4335
2018,2,5,22,19903,20503,16748,-3755
2018,2,5,23,20931,21647,17976,-3671
2018,2,6,0,21551,22180,18424,-3756
2018,2,6,1,21253,21915,17847,-4068
2018,2,6,2,20688,21298,17449,-3849
2018,2,6,3,19894,20312,16347,-3965
2018,2,6,4,18678,18944,14581,-4363
2018,2,6,5,17458,17702,13601,-4101
2018,2,6,6,16232,16887,12102,-4785
2018,2,6,7,15686,16368,11739,-4629
2018,2,6,8,15407,16073,11750,-4323
2018,2,6,9,15331,16001,11784,-4217
2018,2,6,10,15592,16251,12187,-4064
2018,2,6,11,16536,17183,12764,-4419
2018,2,6,12,18224,18916,14288,-4628
2018,2,6,13,19338,20065,15653,-4412
2018,2,6,14,19647,20499,16099,-4400
2018,2,6,15,19777,20810,16302,-4508
2018,2,6,16,19685,20798,16541,-4257
2018,2,6,17,19489,20583,16492,-4091
2018,2,6,18,19263,20333,16182,-4151
2018,2,6,19,19140,20145,15999,-4146
2018,2,6,20,19065,20038,15912,-4126
2018,2,6,21,19192,20064,16215,-3849
2018,2,6,22,19636,20458,16091,-4367
2018,2,6,23,20500,21342,16599,-4743
2018,2,7,0,21034,21801,17031,-4770
2018,2,7,1,20705,21525,16527,-4998
2018,2,7,2,20141,20943,16149,-4794
2018,2,7,3,19354,20060,15434,-4626
2018,2,7,4,18124,18788,14293,-4495
2018,2,7,5,16934,17586,13376,-4210
2018,2,7,6,16105,16766,12467,-4299
2018,2,7,7,15616,16275,12214,-4061
2018,2,7,8,15348,16030,12069,-3961
2018,2,7,9,15285,15948,12119,-3829
2018,2,7,10,15548,16193,12392,-3801
2018,2,7,11,16494,17110,13237,-3873
2018,2,7,12,18205,18676,14872,-3804
2018,2,7,13,19292,19891,16010,-3881
2018,2,7,14,19630,20535,16422,-4113
2018,2,7,15,19885,21049,16469,-4580
2018,2,7,16,19925,21391,16781,-4610
2018,2,7,17,19836,21544,17122,-4422
2018,2,7,18,19675,21543,17414,-4129
2018,2,7,19,19614,21465,17409,-4056
2018,2,7,20,19542,21264,17048,-4216
2018,2,7,21,19625,21161,16707,-4454
2018,2,7,22,19967,21343,17243,-4100
2018,2,7,23,20569,21921,17133,-4788
2018,2,8,0,20907,21965,17400,-4565
2018,2,8,1,20465,21418,17034,-4384
2018,2,8,2,19831,20682,16890,-3792
2018,2,8,3,19028,19653,15497,-4156
2018,2,8,4,17797,18471,14392,-4079
2018,2,8,5,16600,17355,13438,-3917
2018,2,8,6,15884,16599,12526,-4073
2018,2,8,7,15442,16168,12212,-3956
2018,2,8,8,15213,15947,12045,-3902
2018,2,8,9,15201,15901,12091,-3810
2018,2,8,10,15504,16232,12674,-3558
2018,2,8,11,16493,17208,13205,-4003
2018,2,8,12,18257,18911,15576,-3335
2018,2,8,13,19328,20064,16507,-3557
2018,2,8,14,19574,20494,16404,-4090
2018,2,8,15,19678,20513,16247,-4266
2018,2,8,16,19541,20461,16287,-4174
2018,2,8,17,19352,20288,16262,-4026
2018,2,8,18,19162,20114,16134,-3980
2018,2,8,19,19139,20044,16198,-3846
2018,2,8,20,19152,20035,15976,-4059
2018,2,8,21,19318,20183,15973,-4210
2018,2,8,22,19760,20649,16784,-3865
2018,2,8,23,20562,21605,17603,-4002
2018,2,9,0,21150,22107,17878,-4229
2018,2,9,1,20870,21851,17762,-4089
2018,2,9,2,20383,21312,17354,-3958
2018,2,9,3,19679,20336,16534,-3802
2018,2,9,4,18541,19118,15535,-3583
2018,2,9,5,17406,17926,13922,-4004
2018,2,9,6,16545,17068,13047,-4021
2018,2,9,7,16044,16629,12793,-3836
2018,2,9,8,15777,16355,12786,-3569
2018,2,9,9,15706,16301,12739,-3562
2018,2,9,10,15951,16574,12974,-3600
2018,2,9,11,16839,17495,13753,-3742
2018,2,9,12,18475,19249,15191,-4058
2018,2,9,13,19505,20361,16382,-3979
2018,2,9,14,19821,20727,15974,-4753
2018,2,9,15,20071,20949,16199,-4750
2018,2,9,16,20068,21019,16549,-4470
2018,2,9,17,19963,20709,16175,-4534
2018,2,9,18,19788,20644,16105,-4539
2018,2,9,19,19688,20620,15994,-4626
2018,2,9,20,19594,20556,15946,-4610
2018,2,9,21,19627,20526,16094,-4432
2018,2,9,22,19846,20682,16062,-4620
2018,2,9,23,20268,21359,16431,-4928
2018,2,10,0,20546,21473,16419,-5054
2018,2,10,1,20072,21048,16533,-4515
2018,2,10,2,19440,20380,16371,-4009
2018,2,10,3,18760,19528,15627,-3901
2018,2,10,4,17800,18435,14369,-4066
2018,2,10,5,16777,17287,13054,-4233
2018,2,10,6,15899,16349,12297,-4052
2018,2,10,7,15274,15741,12008,-3733
2018,2,10,8,14883,15334,11723,-3611
2018,2,10,9,14677,15118,11620,-3498
2018,2,10,10,14688,15118,11662,-3456
2018,2,10,11,15004,15391,11953,-3438
2018,2,10,12,15532,16017,12412,-3605
2018,2,10,13,15999,16663,13543,-3120
2018,2,10,14,16698,17370,13836,-3534
2018,2,10,15,17409,17904,14006,-3898
2018,2,10,16,17671,18191,14102,-4089
2018,2,10,17,17674,18204,14089,-4115
2018,2,10,18,17542,18142,14238,-3904
2018,2,10,19,17363,18085,14155,-3930
2018,2,10,20,17239,18080,14087,-3993
2018,2,10,21,17253,18159,14183,-3976
2018,2,10,22,17494,18412,14394,-4018
2018,2,10,23,18054,19099,14943,-4156
2018,2,11,0,18537,19309,15214,-4095
2018,2,11,1,18227,18952,14822,-4130
2018,2,11,2,17787,18513,14424,-4089
2018,2,11,3,17302,17857,13832,-4025
2018,2,11,4,16600,17011,13190,-3821
2018,2,11,5,15806,16046,12095,-3951
2018,2,11,6,14812,15284,11365,-3919
2018,2,11,7,14225,14770,11134,-3636
2018,2,11,8,13871,14429,10962,-3467
2018,2,11,9,13700,14257,10977,-3280
2018,2,11,10,13734,14244,10940,-3304
2018,2,11,11,14031,14446,10933,-3513
2018,2,11,12,14445,14919,11025,-3894
2018,2,11,13,14768,15478,12310,-3168
2018,2,11,14,15442,16299,13275,-3024
2018,2,11,15,16251,17149,13610,-3539
2018,2,11,16,16641,17646,13997,-3649
2018,2,11,17,16811,17978,14211,-3767
2018,2,11,18,16849,18034,14341,-3693
2018,2,11,19,16816,18031,14588,-3443
2018,2,11,20,16777,17932,14738,-3194
2018,2,11,21,16878,17935,14693,-3242
2018,2,11,22,17243,18239,14796,-3443
2018,2,11,23,17926,19074,15468,-3606
2018,2,12,0,18540,19373,15767,-3606
2018,2,12,1,18308,19062,15485,-3577
2018,2,12,2,17865,18502,15097,-3405
2018,2,12,3,17190,17710,14495,-3215
2018,2,12,4,16246,16616,13455,-3161
2018,2,12,5,15282,15579,12430,-3149
2018,2,12,6,14276,14817,11355,-3462
2018,2,12,7,13868,14350,11242,-3108
2018,2,12,8,13669,14098,11005,-3093
2018,2,12,9,13661,14065,11232,-2833
2018,2,12,10,13980,14315,11269,-3046
2018,2,12,11,14984,15308,11939,-3369
2018,2,12,12,16716,17191,13247,-3944
2018,2,12,13,17865,18479,14715,-3764
2018,2,12,14,18308,19004,15224,-3780
2018,2,12,15,18533,19360,15585,-3775
2018,2,12,16,18563,19540,15591,-3949
2018,2,12,17,18465,19551,15535,-4016
2018,2,12,18,18319,19394,15653,-3741
2018,2,12,19,18269,19114,15460,-3654
2018,2,12,20,18264,18814,15242,-3572
2018,2,12,21,18416,18918,15147,-3771
2018,2,12,22,18867,19399,15792,-3607
2018,2,12,23,19795,20369,16381,-3988
2018,2,13,0,20492,21015,16502,-4513
2018,2,13,1,20252,20761,16560,-4201
2018,2,13,2,19697,20249,16310,-3939
2018,2,13,3,18842,19373,15538,-3835
2018,2,13,4,17676,18114,14431,-3683
2018,2,13,5,16537,16940,13175,-3765
2018,2,13,6,15669,16159,12270,-3889
2018,2,13,7,15224,15716,11978,-3738
2018,2,13,8,15004,15518,11958,-3560
2018,2,13,9,14980,15534,11877,-3657
2018,2,13,10,15287,15842,12062,-3780
2018,2,13,11,16263,16912,13046,-3866
2018,2,13,12,18000,18722,14980,-3742
2018,2,13,13,19029,19773,16065,-3708
2018,2,13,14,19251,19940,16035,-3905
2018,2,13,15,19258,19826,15987,-3839
2018,2,13,16,19093,19627,15943,-3684
2018,2,13,17,18877,19393,15756,-3637
2018,2,13,18,18640,19129,15250,-3879
2018,2,13,19,18567,19010,15261,-3749
2018,2,13,20,18578,18932,15191,-3741
2018,2,13,21,18767,19098,15297,-3801
2018,2,13,22,19239,19651,15859,-3792
2018,2,13,23,20066,20655,16276,-4379
2018,2,14,0,20703,21295,16670,-4625
2018,2,14,1,20447,21026,16586,-4440
2018,2,14,2,19884,20474,16447,-4027
2018,2,14,3,19002,19556,15554,-4002
2018,2,14,4,17789,18276,14477,-3799
2018,2,14,5,16621,16964,13420,-3544
2018,2,14,6,15665,16019,12447,-3572
2018,2,14,7,15137,15469,12192,-3277
2018,2,14,8,14824,15149,11991,-3158
2018,2,14,9,14716,15029,12055,-2974
2018,2,14,10,14927,15245,12205,-3040
2018,2,14,11,15805,16151,12674,-3477
2018,2,14,12,17429,17831,14394,-3437
2018,2,14,13,18437,18864,15544,-3320
2018,2,14,14,18723,19275,15408,-3867
2018,2,14,15,18756,19421,15242,-4179
2018,2,14,16,18657,19231,15378,-3853
2018,2,14,17,18452,18942,14869,-4073
2018,2,14,18,18202,18676,14451,-4225
2018,2,14,19,18118,18633,14468,-4165
2018,2,14,20,18066,18466,14688,-3778
2018,2,14,21,18197,18513,14802,-3711
2018,2,14,22,18599,18837,15133,-3704
2018,2,14,23,19332,19633,15399,-4234
2018,2,15,0,19848,20082,15849,-4233
2018,2,15,1,19539,19730,15637,-4093
2018,2,15,2,18965,19204,15295,-3909
2018,2,15,3,18087,18348,14841,-3507
2018,2,15,4,16906,17143,13940,-3203
2018,2,15,5,15731,15976,12849,-3127
2018,2,15,6,14758,15110,11980,-3130
2018,2,15,7,14231,14576,11326,-3250
2018,2,15,8,13934,14272,11206,-3066
2018,2,15,9,13839,14145,11153,-2992
2018,2,15,10,14073,14359,11485,-2874
2018,2,15,11,14991,15233,12352,-2881
2018,2,15,12,16634,16904,13976,-2928
2018,2,15,13,17652,17996,14816,-3180
2018,2,15,14,17977,18411,14991,-3420
2018,2,15,15,18130,18719,14963,-3756
2018,2,15,16,18133,18804,15224,-3580
2018,2,15,17,18024,18517,14843,-3674
2018,2,15,18,17856,18351,14680,-3671
2018,2,15,19,17849,18342,14732,-3610
2018,2,15,20,17836,18257,14642,-3615
2018,2,15,21,17949,18308,14709,-3599
2018,2,15,22,18279,18535,14802,-3733
2018,2,15,23,18841,19190,15069,-4121
2018,2,16,0,19298,19564,15198,-4366
2018,2,16,1,18947,19218,14848,-4370
2018,2,16,2,18344,18616,14279,-4337
2018,2,16,3,17426,17724,13797,-3927
2018,2,16,4,16265,16524,12999,-3525
2018,2,16,5,15131,15389,12002,-3387
2018,2,16,6,14133,14543,10794,-3749
2018,2,16,7,13621,13978,10167,-3811
2018,2,16,8,13328,13708,9756,-3952
2018,2,16,9,13240,13625,9567,-4058
2018,2,16,10,13477,13805,9850,-3955
2018,2,16,11,14354,14631,10332,-4299
2018,2,16,12,15915,16210,11806,-4404
2018,2,16,13,17005,17407,12721,-4686
2018,2,16,14,17514,18028,13570,-4458
2018,2,16,15,17939,18403,13370,-5033
2018,2,16,16,18056,18673,13634,-5039
2018,2,16,17,18017,18700,13547,-5153
2018,2,16,18,17902,18654,13563,-5091
2018,2,16,19,17852,18562,13500,-5062
2018,2,16,20,17814,18489,13437,-5052
2018,2,16,21,17903,18525,13435,-5090
2018,2,16,22,18188,18803,13748,-5055
2018,2,16,23,18704,19376,14289,-5087
2018,2,17,0,19230,19678,14365,-5313
2018,2,17,1,18908,19374,14065,-5309
2018,2,17,2,18332,18890,13725,-5165
2018,2,17,3,17638,18237,13358,-4879
2018,2,17,4,16771,17410,12405,-5005
2018,2,17,5,15874,16435,11379,-5056
2018,2,17,6,15080,15653,10462,-5191
2018,2,17,7,14575,15173,10312,-4861
2018,2,17,8,14274,14912,10226,-4686
2018,2,17,9,14156,14788,10231,-4557
2018,2,17,10,14265,14879,10272,-4607
2018,2,17,11,14679,15275,10688,-4587
2018,2,17,12,15330,15943,11626,-4317
2018,2,17,13,15744,16591,12595,-3996
2018,2,17,14,16281,17127,13036,-4091
2018,2,17,15,16742,17402,13076,-4326
2018,2,17,16,16849,17502,12949,-4553
2018,2,17,17,16794,17472,12810,-4662
2018,2,17,18,16683,17310,12623,-4687
2018,2,17,19,16625,17349,12893,-4456
2018,2,17,20,16692,17669,13393,-4276
2018,2,17,21,16858,17901,13498,-4403
2018,2,17,22,17246,18325,13924,-4401
2018,2,17,23,17906,19003,14691,-4312
2018,2,18,0,18571,19358,14808,-4550
2018,2,18,1,18350,19139,14832,-4307
2018,2,18,2,17866,18732,14559,-4173
2018,2,18,3,17219,18191,13936,-4255
2018,2,18,4,16466,17391,12993,-4398
2018,2,18,5,15679,16445,11894,-4551
2018,2,18,6,14895,15679,10841,-4838
2018,2,18,7,14341,15102,10680,-4422
2018,2,18,8,13984,14715,10357,-4358
2018,2,18,9,13804,14529,10265,-4264
2018,2,18,10,13804,14500,10337,-4163
2018,2,18,11,13997,14739,10618,-4121
2018,2,18,12,14260,15189,11410,-3779
2018,2,18,13,14420,15673,12435,-3238
2018,2,18,14,14946,16419,13124,-3295
2018,2,18,15,15471,16922,13176,-3746
2018,2,18,16,15639,17182,13170,-4012
2018,2,18,17,15677,17244,13073,-4171
2018,2,18,18,15628,17119,12877,-4242
2018,2,18,19,15553,16858,12500,-4358
2018,2,18,20,15536,16690,12308,-4382
2018,2,18,21,15719,16755,12614,-4141
2018,2,18,22,16207,17158,12764,-4394
2018,2,18,23,17155,18047,13338,-4709
2018,2,19,0,18019,18827,13760,-5067
2018,2,19,1,17970,18679,13805,-4874
2018,2,19,2,17626,18297,13669,-4628
2018,2,19,3,16964,17768,13214,-4554
2018,2,19,4,16143,16968,12858,-4110
2018,2,19,5,15321,16102,12261,-3841
2018,2,19,6,14716,15352,11016,-4336
2018,2,19,7,14266,14930,10794,-4136
2018,2,19,8,14018,14689,10492,-4197
2018,2,19,9,13899,14619,10490,-4129
2018,2,19,10,14056,14791,10768,-4023
2018,2,19,11,14666,15414,11602,-3812
2018,2,19,12,15686,16411,13254,-3157
2018,2,19,13,16288,17102,13361,-3741
2018,2,19,14,16779,17573,13574,-3999
2018,2,19,15,17175,17864,13748,-4116
2018,2,19,16,17367,18158,14080,-4078
2018,2,19,17,17475,18432,14143,-4289
2018,2,19,18,17427,18537,14021,-4516
2018,2,19,19,17389,18614,14013,-4601
2018,2,19,20,17401,18553,13905,-4648
2018,2,19,21,17500,18630,13956,-4674
2018,2,19,22,17771,18965,14330,-4635
2018,2,19,23,18216,19586,15055,-4531
2018,2,20,0,18756,19746,15237,-4509
2018,2,20,1,18408,19336,14935,-4401
2018,2,20,2,17785,18729,14449,-4280
2018,2,20,3,16932,17854,13577,-4277
2018,2,20,4,15899,16727,12692,-4035
2018,2,20,5,14879,15571,11503,-4068
2018,2,20,6,14106,14729,10496,-4233
2018,2,20,7,13621,14187,9756,-4431
2018,2,20,8,13345,13883,9508,-4375
2018,2,20,9,13245,13753,9584,-4169
2018,2,20,10,13460,13965,9747,-4218
2018,2,20,11,14309,14755,10420,-4335
2018,2,20,12,15810,16144,12193,-3951
2018,2,20,13,16801,17240,13199,-4041
2018,2,20,14,17185,17913,13958,-3955
2018,2,20,15,17452,18251,14182,-4069
2018,2,20,16,17493,18350,14527,-3823
2018,2,20,17,17425,18092,14488,-3604
2018,2,20,18,17309,17752,14245,-3507
2018,2,20,19,17302,17754,14295,-3459
2018,2,20,20,17260,17697,14193,-3504
2018,2,20,21,17351,17711,14251,-3460
2018,2,20,22,17657,17988,14521,-3467
2018,2,20,23,18160,18630,14785,-3845
2018,2,21,0,18660,19102,15350,-3752
2018,2,21,1,18335,18743,14913,-3830
2018,2,21,2,17741,18142,14590,-3552
2018,2,21,3,16795,17273,13847,-3426
2018,2,21,4,15664,16156,12751,-3405
2018,2,21,5,14563,15053,11874,-3179
2018,2,21,6,13685,14143,10300,-3843
2018,2,21,7,13171,13589,9804,-3785
2018,2,21,8,12884,13258,9452,-3806
2018,2,21,9,12786,13171,10012,-3159
2018,2,21,10,13002,13361,9940,-3421
2018,2,21,11,13846,14179,10886,-3293
2018,2,21,12,15365,15562,12262,-3300
2018,2,21,13,16375,16682,13766,-2916
2018,2,21,14,16765,17399,14272,-3127
2018,2,21,15,17026,17762,14317,-3445
2018,2,21,16,17109,17893,13983,-3910
2018,2,21,17,17103,17883,13629,-4254
2018,2,21,18,17030,17819,13541,-4278
2018,2,21,19,17088,17969,13866,-4103
2018,2,21,20,17127,18078,14052,-4026
2018,2,21,21,17304,18240,14168,-4072
2018,2,21,22,17699,18519,14259,-4260
2018,2,21,23,18238,18970,14161,-4809
2018,2,22,0,18761,19379,14603,-4776
2018,2,22,1,18449,18952,14101,-4851
2018,2,22,2,17825,18274,13814,-4460
2018,2,22,3,16917,17375,13350,-4025
2018,2,22,4,15817,16249,12456,-3793
2018,2,22,5,14742,15126,11119,-4007
2018,2,22,6,13931,14295,10085,-4210
2018,2,22,7,13471,13778,9819,-3959
2018,2,22,8,13217,13485,9658,-3827
2018,2,22,9,13169,13418,9755,-3663
2018,2,22,10,13437,13631,10193,-3438
2018,2,22,11,14328,14484,10790,-3694
2018,2,22,12,15902,15994,12178,-3816
2018,2,22,13,16987,17284,13437,-3847
2018,2,22,14,17464,18100,13916,-4184
2018,2,22,15,17843,18660,14295,-4365
2018,2,22,16,17954,19021,14444,-4577
2018,2,22,17,17973,19212,14505,-4707
2018,2,22,18,17942,19223,14732,-4491
2018,2,22,19,17974,19317,14806,-4511
2018,2,22,20,17983,19253,14755,-4498
2018,2,22,21,18077,19097,14755,-4342
2018,2,22,22,18424,19154,14494,-4660
2018,2,22,23,18942,19528,14879,-4649
2018,2,23,0,19511,20019,15495,-4524
2018,2,23,1,19267,19834,15046,-4788
2018,2,23,2,18671,19275,14772,-4503
2018,2,23,3,17730,18431,13707,-4724
2018,2,23,4,16637,17355,13505,-3850
2018,2,23,5,15574,16255,12245,-4010
2018,2,23,6,14597,15388,10769,-4619
2018,2,23,7,14093,14793,10403,-4390
2018,2,23,8,13818,14502,10378,-4124
2018,2,23,9,13723,14414,10456,-3958
2018,2,23,10,13954,14635,10694,-3941
2018,2,23,11,14797,15433,11453,-3980
2018,2,23,12,16315,16807,13644,-3163
2018,2,23,13,17368,17940,14640,-3300
2018,2,23,14,17815,18763,15221,-3542
2018,2,23,15,18290,19223,15204,-4019
2018,2,23,16,18376,19498,15422,-4076
2018,2,23,17,18326,19629,15419,-4210
2018,2,23,18,18210,19578,15427,-4151
2018,2,23,19,18151,19538,15397,-4141
2018,2,23,20,18040,19431,15228,-4203
2018,2,23,21,18043,19396,15231,-4165
2018,2,23,22,18239,19565,15598,-3967
2018,2,23,23,18536,19870,15747,-4123
2018,2,24,0,18959,19901,16003,-3898
2018,2,24,1,18575,19422,15647,-3775
2018,2,24,2,17908,18832,15457,-3375
2018,2,24,3,17025,18058,14485,-3573
2018,2,24,4,16114,17067,13401,-3666
2018,2,24,5,15157,16001,12316,-3685
2018,2,24,6,14469,15107,11073,-4034
2018,2,24,7,13904,14545,10417,-4128
2018,2,24,8,13555,14191,10234,-3957
2018,2,24,9,13375,13968,10289,-3679
2018,2,24,10,13415,13967,10362,-3605
2018,2,24,11,13721,14297,10867,-3430
2018,2,24,12,14189,14839,11624,-3215
2018,2,24,13,14646,15370,12381,-2989
2018,2,24,14,15326,16009,12581,-3428
2018,2,24,15,16028,16338,12837,-3501
2018,2,24,16,16268,16794,12972,-3822
2018,2,24,17,16284,16967,12986,-3981
2018,2,24,18,16196,17040,12918,-4122
2018,2,24,19,16125,17011,12920,-4091
2018,2,24,20,16092,16989,13163,-3826
2018,2,24,21,16170,17020,13092,-3928
2018,2,24,22,16454,17275,13386,-3889
2018,2,24,23,16938,17750,13561,-4189
2018,2,25,0,17640,18197,13492,-4705
2018,2,25,1,17474,17937,13349,-4588
2018,2,25,2,17038,17559,13397,-4162
2018,2,25,3,16375,17016,13011,-4005
2018,2,25,4,15731,16303,12216,-4087
2018,2,25,5,15011,15459,11193,-4266
2018,2,25,6,14242,14692,10306,-4386
2018,2,25,7,13708,14220,10309,-3911
2018,2,25,8,13373,13894,10004,-3890
2018,2,25,9,13202,13698,10080,-3618
2018,2,25,10,13224,13720,9990,-3730
2018,2,25,11,13446,13989,10037,-3952
2018,2,25,12,13701,14477,11032,-3445
2018,2,25,13,13998,14943,11732,-3211
2018,2,25,14,14681,15789,12534,-3255
2018,2,25,15,15442,16561,13133,-3428
2018,2,25,16,15806,17145,13547,-3598
2018,2,25,17,15976,17487,13649,-3838
2018,2,25,18,16024,17457,13474,-3983
2018,2,25,19,15995,17373,13303,-4070
2018,2,25,20,15957,17239,13423,-3816
2018,2,25,21,16061,17213,13448,-3765
2018,2,25,22,16446,17450,13480,-3970
2018,2,25,23,17103,18066,14127,-3939
2018,2,26,0,17946,18700,14689,-4011
2018,2,26,1,17851,18501,14719,-3782
2018,2,26,2,17381,18050,14541,-3509
2018,2,26,3,16488,17294,13993,-3301
2018,2,26,4,15572,16291,13090,-3201
2018,2,26,5,14676,15284,12251,-3033
2018,2,26,6,13848,14546,11256,-3290
2018,2,26,7,13455,14060,10969,-3091
2018,2,26,8,13251,13812,10801,-3011
2018,2,26,9,13225,13770,10935,-2835
2018,2,26,10,13519,14098,11054,-3044
2018,2,26,11,14426,15130,11685,-3445
2018,2,26,12,15974,16813,13531,-3282
2018,2,26,13,17014,17894,14613,-3281
2018,2,26,14,17382,18338,14560,-3778
2018,2,26,15,17540,18567,14905,-3662
2018,2,26,16,17473,18613,15089,-3524
2018,2,26,17,17305,18462,15177,-3285
2018,2,26,18,17098,18222,14999,-3223
2018,2,26,19,17043,18080,14693,-3387
2018,2,26,20,16991,17923,14538,-3385
2018,2,26,21,17099,18046,14722,-3324
2018,2,26,22,17520,18481,14959,-3522
2018,2,26,23,18298,19070,15207,-3863
2018,2,27,0,19151,19844,15885,-3959
2018,2,27,1,19036,19631,15436,-4195
2018,2,27,2,18477,19112,15399,-3713
2018,2,27,3,17435,18263,14685,-3578
2018,2,27,4,16294,17070,13981,-3089
2018,2,27,5,15181,15862,12514,-3348
2018,2,27,6,14380,15048,11141,-3907
2018,2,27,7,13913,14583,10798,-3785
2018,2,27,8,13670,14336,10639,-3697
2018,2,27,9,13616,14300,10620,-3680
2018,2,27,10,13886,14583,10880,-3703
2018,2,27,11,14772,15548,11656,-3892
2018,2,27,12,16368,17250,13841,-3409
2018,2,27,13,17299,18149,14350,-3799
2018,2,27,14,17458,18162,14097,-4065
2018,2,27,15,17452,18003,13621,-4382
2018,2,27,16,17273,17828,13660,-4168
2018,2,27,17,17059,17630,13655,-3975
2018,2,27,18,16826,17409,13330,-4079
2018,2,27,19,16803,17368,13357,-4011
2018,2,27,20,16785,17301,13370,-3931
2018,2,27,21,16922,17470,13655,-3815
2018,2,27,22,17355,17871,14030,-3841
2018,2,27,23,18079,18558,14405,-4153
2018,2,28,0,18910,19435,15014,-4421
2018,2,28,1,18803,19247,14927,-4320
2018,2,28,2,18280,18714,14568,-4146
2018,2,28,3,17268,17852,14130,-3722
2018,2,28,4,16125,16640,13416,-3224
2018,2,28,5,15013,15530,12083,-3447
2018,2,28,6,14211,14675,11549,-3126
2018,2,28,7,13749,14208,11065,-3143
2018,2,28,8,13492,13900,11033,-2867
2018,2,28,9,13419,13890,10991,-2899
2018,2,28,10,13664,14160,11156,-3004
2018,2,28,11,14513,15116,11658,-3458
2018,2,28,12,16034,16808,13287,-3521
2018,2,28,13,16994,17668,13905,-3763
2018,2,28,14,17225,17809,13856,-3953
2018,2,28,15,17267,17701,13700,-4001
2018,2,28,16,17175,17599,13618,-3981
2018,2,28,17,17053,17366,13642,-3724
2018,2,28,18,16930,17194,13694,-3500
2018,2,28,19,16963,17183,13768,-3415
2018,2,28,20,17019,17222,13871,-3351
2018,2,28,21,17204,17422,14252,-3170
2018,2,28,22,17617,17792,14433,-3359
2018,2,28,23,18166,18288,14738,-3550
2018,3,1,0,18854,18964,14947,-4017
2018,3,1,1,18640,18810,15025,-3785
2018,3,1,2,18049,18243,14887,-3356
2018,3,1,3,16996,17339,14425,-2914
2018,3,1,4,15874,16144,13454,-2690
2018,3,1,5,14776,14980,12276,-2704
2018,3,1,6,13892,14085,11166,-2919
2018,3,1,7,13422,13605,10673,-2932
2018,3,1,8,13168,13354,10654,-2700
2018,3,1,9,13117,13325,10549,-2776
2018,3,1,10,13397,13593,10720,-2873
2018,3,1,11,14415,14552,11671,-2881
2018,3,1,12,16143,16264,13424,-2840
2018,3,1,13,17197,17297,14270,-3027
2018,3,1,14,17497,17727,14514,-3213
2018,3,1,15,17558,17878,14627,-3251
2018,3,1,16,17548,17868,14364,-3504
2018,3,1,17,17457,17826,14375,-3451
2018,3,1,18,17361,17791,14503,-3288
2018,3,1,19,17358,17733,14771,-2962
2018,3,1,20,17334,17748,14777,-2971
2018,3,1,21,17465,17890,14820,-3070
2018,3,1,22,17804,18250,15265,-2985
2018,3,1,23,18110,18868,15821,-3047
2018,3,2,0,18773,19308,15882,-3426
2018,3,2,1,18615,19056,15777,-3279
2018,3,2,2,18051,18512,15368,-3144
2018,3,2,3,17191,17718,14638,-3080
2018,3,2,4,16020,16577,13699,-2878
2018,3,2,5,14902,15431,12838,-2593
2018,3,2,6,14146,14707,12215,-2492
2018,3,2,7,13673,14283,11676,-2607
2018,3,2,8,13409,14025,11637,-2388
2018,3,2,9,13350,13985,11273,-2712
2018,3,2,10,13626,14227,11373,-2854
2018,3,2,11,14612,15043,12074,-2969
2018,3,2,12,16269,16466,13279,-3187
2018,3,2,13,17433,17682,14414,-3268
2018,3,2,14,17953,18475,15149,-3326
2018,3,2,15,18271,19036,15614,-3422
2018,3,2,16,18384,19412,15771,-3641
2018,3,2,17,18379,19628,16057,-3571
2018,3,2,18,18288,19593,16122,-3471
2018,3,2,19,18262,19485,16065,-3420
2018,3,2,20,18208,19297,15761,-3536
2018,3,2,21,18267,19208,15686,-3522
2018,3,2,22,18519,19386,15506,-3880
2018,3,2,23,18686,19736,15706,-4030
2018,3,3,0,19231,19977,15793,-4184
2018,3,3,1,18948,19580,15506,-4074
2018,3,3,2,18277,18932,14860,-4072
2018,3,3,3,17455,18133,14201,-3932
2018,3,3,4,16445,17128,13445,-3683
2018,3,3,5,15428,16074,12498,-3576
2018,3,3,6,14926,15282,11974,-3308
2018,3,3,7,14379,14706,11379,-3327
2018,3,3,8,14051,14371,11052,-3319
2018,3,3,9,13901,14190,10964,-3226
2018,3,3,10,13973,14232,11138,-3094
2018,3,3,11,14365,14565,11332,-3233
2018,3,3,12,14885,15146,12079,-3067
2018,3,3,13,15342,15804,12656,-3148
2018,3,3,14,16024,16583,13116,-3467
2018,3,3,15,16667,16953,13253,-3700
2018,3,3,16,16859,17091,13362,-3729
2018,3,3,17,16796,17064,13424,-3640
2018,3,3,18,16626,17007,13424,-3583
2018,3,3,19,16459,16856,13200,-3656
2018,3,3,20,16367,16814,13247,-3567
2018,3,3,21,16433,16837,13301,-3536
2018,3,3,22,16726,17158,13452,-3706
2018,3,3,23,17103,17746,13702,-4044
2018,3,4,0,17917,18353,13909,-4444
2018,3,4,1,17881,18212,13877,-4335
2018,3,4,2,17496,17809,13617,-4192
2018,3,4,3,16950,17269,13408,-3861
2018,3,4,4,16238,16536,13077,-3459
2018,3,4,5,15458,15678,12090,-3588
2018,3,4,6,14735,14927,11139,-3788
2018,3,4,7,14218,14382,10819,-3563
2018,3,4,8,13909,14061,10784,-3277
2018,3,4,9,13781,13920,10497,-3423
2018,3,4,10,13838,13927,10646,-3281
2018,3,4,11,14151,14171,10899,-3272
2018,3,4,12,14522,14586,11439,-3147
2018,3,4,13,14775,14991,11849,-3142
2018,3,4,14,15312,15698,12262,-3436
2018,3,4,15,15851,16267,13066,-3201
2018,3,4,16,16044,16729,13652,-3077
2018,3,4,17,16087,16816,13511,-3305
2018,3,4,18,16063,16767,13350,-3417
2018,3,4,19,16012,16765,13283,-3482
2018,3,4,20,16000,16714,13235,-3479
2018,3,4,21,16182,16834,13524,-3310
2018,3,4,22,16640,17234,13738,-3496
2018,3,4,23,17268,17975,14013,-3962
2018,3,5,0,18255,18975,14974,-4001
2018,3,5,1,18357,19006,15059,-3947
2018,3,5,2,18034,18589,14729,-3860
2018,3,5,3,17365,17869,13887,-3982
2018,3,5,4,16481,16927,13133,-3794
2018,3,5,5,15580,15941,11925,-4016
2018,3,5,6,14654,15221,11055,-4166
2018,3,5,7,14280,14802,10914,-3888
2018,3,5,8,14097,14584,10691,-3893
2018,3,5,9,14093,14548,10856,-3692
2018,3,5,10,14403,14836,11138,-3698
2018,3,5,11,15362,15844,11988,-3856
2018,3,5,12,16910,17509,13734,-3775
2018,3,5,13,17934,18455,14584,-3871
2018,3,5,14,18275,18802,14952,-3850
2018,3,5,15,18397,18984,14918,-4066
2018,3,5,16,18359,19187,15193,-3994
2018,3,5,17,18227,19223,15227,-3996
2018,3,5,18,18066,19142,15313,-3829
2018,3,5,19,17999,19128,15290,-3838
2018,3,5,20,17959,19084,15264,-3820
2018,3,5,21,18079,19050,14861,-4189
2018,3,5,22,18466,19215,14941,-4274
2018,3,5,23,18947,19768,15375,-4393
2018,3,6,0,19761,20456,16076,-4380
2018,3,6,1,19698,20343,16071,-4272
2018,3,6,2,19128,19708,15492,-4216
2018,3,6,3,18189,18750,14769,-3981
2018,3,6,4,16983,17499,13792,-3707
2018,3,6,5,15821,16304,12693,-3611
2018,3,6,6,14913,15457,11722,-3735
2018,3,6,7,14458,15001,11462,-3539
2018,3,6,8,14230,14763,11389,-3374
2018,3,6,9,14205,14705,11394,-3311
2018,3,6,10,14499,14975,11736,-3239
2018,3,6,11,15457,15910,12366,-3544
2018,3,6,12,17066,17531,13991,-3540
2018,3,6,13,18034,18426,14740,-3686
2018,3,6,14,18226,18557,14663,-3894
2018,3,6,15,18166,18446,14614,-3832
2018,3,6,16,17983,18336,14497,-3839
2018,3,6,17,17761,18158,14452,-3706
2018,3,6,18,17524,17961,14148,-3813
2018,3,6,19,17441,17851,14140,-3711
2018,3,6,20,17405,17833,14409,-3424
2018,3,6,21,17577,17992,14593,-3399
2018,3,6,22,18058,18430,14791,-3639
2018,3,6,23,18593,19135,15381,-3754
2018,3,7,0,19452,19913,15945,-3968
2018,3,7,1,19417,19796,15949,-3847
2018,3,7,2,18881,19259,15225,-4034
2018,3,7,3,17942,18427,14687,-3740
2018,3,7,4,16731,17252,14194,-3058
2018,3,7,5,15571,16083,12882,-3201
2018,3,7,6,14780,15203,12119,-3084
2018,3,7,7,14313,14730,11798,-2932
2018,3,7,8,14053,14448,11630,-2818
2018,3,7,9,13996,14374,11844,-2530
2018,3,7,10,14251,14672,12359,-2313
2018,3,7,11,15158,15615,13335,-2280
2018,3,7,12,16690,17105,14166,-2939
2018,3,7,13,17793,18245,15283,-2962
2018,3,7,14,18228,18964,15860,-3104
2018,3,7,15,18514,19420,15920,-3500
2018,3,7,16,18567,19704,15812,-3892
2018,3,7,17,18511,19945,15818,-4127
2018,3,7,18,18403,20126,16040,-4086
2018,3,7,19,18371,20162,15896,-4266
2018,3,7,20,18327,20081,15905,-4176
2018,3,7,21,18430,20057,16042,-4015
2018,3,7,22,18770,20223,16347,-3876
2018,3,7,23,19055,20511,16464,-4047
2018,3,8,0,19755,20756,16573,-4183
2018,3,8,1,19636,20290,16254,-4036
2018,3,8,2,19057,19556,15879,-3677
2018,3,8,3,18114,18572,15350,-3222
2018,3,8,4,16930,17407,14688,-2719
2018,3,8,5,15766,16247,13501,-2746
2018,3,8,6,14835,15452,12732,-2720
2018,3,8,7,14350,14983,12036,-2947
2018,3,8,8,14090,14722,11769,-2953
2018,3,8,9,14035,14695,11951,-2744
2018,3,8,10,14295,14973,12392,-2581
2018,3,8,11,15194,15907,13324,-2583
2018,3,8,12,16700,17325,14410,-2915
2018,3,8,13,17727,18326,15279,-3047
2018,3,8,14,18061,18838,15544,-3294
2018,3,8,15,18211,19067,15786,-3281
2018,3,8,16,18159,19208,15834,-3374
2018,3,8,17,18055,19181,15991,-3190
2018,3,8,18,17916,19129,15896,-3233
2018,3,8,19,17875,19160,15923,-3237
2018,3,8,20,17857,19111,15744,-3367
2018,3,8,21,17986,19210,15551,-3659
2018,3,8,22,18368,19541,15678,-3863
2018,3,8,23,18783,19983,16221,-3762
2018,3,9,0,19584,20540,16605,-3935
2018,3,9,1,19539,20367,16169,-4198
2018,3,9,2,19031,19823,15309,-4514
2018,3,9,3,18124,18936,14587,-4349
2018,3,9,4,16985,17729,13700,-4029
2018,3,9,5,15874,16583,12907,-3676
2018,3,9,6,15215,15725,12295,-3430
2018,3,9,7,14727,15284,12061,-3223
2018,3,9,8,14467,15009,11879,-3130
2018,3,9,9,14405,14969,11941,-3028
2018,3,9,10,14675,15251,12175,-3076
2018,3,9,11,15581,16176,12849,-3327
2018,3,9,12,17096,17665,14038,-3627
2018,3,9,13,18166,18708,15161,-3547
2018,3,9,14,18557,19119,15544,-3575
2018,3,9,15,18843,19302,15561,-3741
2018,3,9,16,18804,19390,15508,-3882
2018,3,9,17,18637,19317,15346,-3971
2018,3,9,18,18415,19093,15183,-3910
2018,3,9,19,18309,18972,15257,-3715
2018,3,9,20,18211,18846,15329,-3517
2018,3,9,21,18247,18884,15377,-3507
2018,3,9,22,18502,19098,15402,-3696
2018,3,9,23,18698,19436,15914,-3522
2018,3,10,0,19394,20074,16239,-3835
2018,3,10,1,19267,19885,16203,-3682
2018,3,10,2,18696,19377,15796,-3581
2018,3,10,3,17853,18674,15281,-3393
2018,3,10,4,16880,17682,13925,-3757
2018,3,10,5,15872,16668,12957,-3711
2018,3,10,6,15084,15761,12375,-3386
2018,3,10,7,14573,15226,12006,-3220
2018,3,10,8,14272,14893,11681,-3212
2018,3,10,9,14150,14731,11534,-3197
2018,3,10,10,14228,14787,11715,-3072
2018,3,10,11,14560,15144,11838,-3306
2018,3,10,12,15009,15738,12402,-3336
2018,3,10,13,15393,16422,12949,-3473
2018,3,10,14,15957,17052,13375,-3677
2018,3,10,15,16545,17447,13779,-3668
2018,3,10,16,16679,17705,14344,-3361
2018,3,10,17,16641,17792,14162,-3630
2018,3,10,18,16519,17666,13888,-3778
2018,3,10,19,16369,17520,13919,-3601
2018,3,10,20,16261,17471,13893,-3578
2018,3,10,21,16351,17527,14189,-3338
2018,3,10,22,16655,17732,14465,-3267
2018,3,10,23,17022,18262,14975,-3287
2018,3,11,0,17894,18949,15207,-3742
2018,3,11,1,17960,18844,15088,-3756
2018,3,11,2,17629,18473,14982,-3491
2018,3,11,3,17037,17902,14537,-3365
2018,3,11,4,16370,17057,13491,-3566
2018,3,11,5,15634,16111,13147,-2964
2018,3,11,6,14900,15360,12443,-2917
2018,3,11,7,14397,14857,12270,-2587
2018,3,11,8,13949,14545,12085,-2460
2018,3,11,9,13967,14488,12070,-2418
2018,3,11,10,14228,14640,12142,-2498
2018,3,11,11,14695,15069,12045,-3024
2018,3,11,12,15130,15516,12721,-2795
2018,3,11,13,15525,16023,13066,-2957
2018,3,11,14,15889,16418,13317,-3101
2018,3,11,15,15967,16682,13547,-3135
2018,3,11,16,15903,16760,13922,-2838
2018,3,11,17,15791,16747,13773,-2974
2018,3,11,18,15648,16610,13436,-3174
2018,3,11,19,15558,16367,13082,-3285
2018,3,11,20,15626,16330,13076,-3254
2018,3,11,21,15868,16507,13450,-3057
2018,3,11,22,16256,16950,13800,-3150
2018,3,11,23,16683,17466,14251,-3215
2018,3,12,0,17500,18439,15082,-3357
2018,3,12,1,17689,18507,15239,-3268
2018,3,12,2,17081,17933,14661,-3272
2018,3,12,3,16264,17033,13957,-3076
2018,3,12,4,15370,15930,13401,-2529
2018,3,12,5,14662,15146,12599,-2547
2018,3,12,6,14278,14741,12531,-2210
2018,3,12,7,14080,14513,12223,-2290
2018,3,12,8,14081,14522,12369,-2153
2018,3,12,9,14371,14831,12156,-2675
2018,3,12,10,15322,15777,13004,-2773
2018,3,12,11,17027,17614,14392,-3222
2018,3,12,12,18260,18911,15590,-3321
2018,3,12,13,18534,19179,16521,-2658
2018,3,12,14,18611,19195,16525,-2670
2018,3,12,15,18555,19116,15829,-3287
2018,3,12,16,18404,18986,15481,-3505
2018,3,12,17,18231,18859,15558,-3301
2018,3,12,18,18129,18805,15539,-3266
2018,3,12,19,18033,18694,15587,-3107
2018,3,12,20,18060,18769,15646,-3123
2018,3,12,21,18198,18996,15887,-3109
2018,3,12,22,18249,19288,15888,-3400
2018,3,12,23,18381,19535,16616,-2919
2018,3,13,0,19023,19949,16984,-2965
2018,3,13,1,18976,19664,16350,-3314
2018,3,13,2,18118,18860,15930,-2930
2018,3,13,3,16973,17614,14746,-2868
2018,3,13,4,15795,16338,13184,-3154
2018,3,13,5,14900,15433,12788,-2645
2018,3,13,6,14430,14999,12277,-2722
2018,3,13,7,14162,14702,11665,-3037
2018,3,13,8,14110,14654,11479,-3175
2018,3,13,9,14353,14948,12019,-2929
2018,3,13,10,15253,15843,12942,-2901
2018,3,13,11,16902,17516,14738,-2778
2018,3,13,12,18145,18827,16351,-2476
2018,3,13,13,18515,19350,16547,-2803
2018,3,13,14,18779,19803,17116,-2687
2018,3,13,15,18825,20024,17150,-2874
2018,3,13,16,18732,20024,17063,-2961
2018,3,13,17,18582,19912,16803,-3109
2018,3,13,18,18479,19796,16662,-3134
2018,3,13,19,18348,19494,16341,-3153
2018,3,13,20,18321,19328,16185,-3143
2018,3,13,21,18428,19320,16292,-3028
2018,3,13,22,18458,19478,16491,-2987
2018,3,13,23,18562,19640,16779,-2861
2018,3,14,0,19184,20238,17514,-2724
2018,3,14,1,19149,19998,17186,-2812
2018,3,14,2,18269,19187,16479,-2708
2018,3,14,3,17111,17965,15158,-2807
2018,3,14,4,15933,16680,13987,-2693
2018,3,14,5,15130,15790,12905,-2885
2018,3,14,6,14637,15314,12656,-2658
2018,3,14,7,14356,15021,12359,-2662
2018,3,14,8,14291,14923,12110,-2813
2018,3,14,9,14526,15165,12290,-2875
2018,3,14,10,15425,16072,13123,-2949
2018,3,14,11,17131,17845,14969,-2876
2018,3,14,12,18359,19032,16532,-2500
2018,3,14,13,18654,19422,16786,-2636
2018,3,14,14,18844,19361,16424,-2937
2018,3,14,15,18802,19392,16289,-3103
2018,3,14,16,18678,19275,16414,-2861
2018,3,14,17,18515,19118,16206,-2912
2018,3,14,18,18446,19103,16017,-3086
2018,3,14,19,18368,19057,16122,-2935
2018,3,14,20,18416,19013,15969,-3044
2018,3,14,21,18567,19238,16136,-3102
2018,3,14,22,18578,19633,16616,-3017
2018,3,14,23,18643,19925,17015,-2910
2018,3,15,0,19269,20403,17580,-2823
2018,3,15,1,19277,20103,17493,-2610
2018,3,15,2,18454,19286,16438,-2848
2018,3,15,3,17314,18079,15086,-2993
2018,3,15,4,16124,16808,14298,-2510
2018,3,15,5,15284,15909,13431,-2478
2018,3,15,6,14790,15440,12969,-2471
2018,3,15,7,14512,15160,12583,-2577
2018,3,15,8,14450,15062,12524,-2538
2018,3,15,9,14682,15330,12682,-2648
2018,3,15,10,15564,16256,13501,-2755
2018,3,15,11,17209,18008,14997,-3011
2018,3,15,12,18383,19169,16400,-2769
2018,3,15,13,18653,19481,16667,-2814
2018,3,15,14,18788,19504,16569,-2935
2018,3,15,15,18670,19303,16491,-2812
2018,3,15,16,18450,18972,15908,-3064
2018,3,15,17,18208,18646,15224,-3422
2018,3,15,18,18080,18436,15091,-3345
2018,3,15,19,17976,18215,15166,-3049
2018,3,15,20,18014,18227,15403,-2824
2018,3,15,21,18186,18560,15795,-2765
2018,3,15,22,18242,18782,16100,-2682
2018,3,15,23,18354,19038,16309,-2729
2018,3,16,0,19002,19638,16779,-2859
2018,3,16,1,19058,19527,16874,-2653
2018,3,16,2,18292,18791,15814,-2977
2018,3,16,3,17196,17639,14704,-2935
2018,3,16,4,16057,16414,13671,-2743
2018,3,16,5,15168,15522,12581,-2941
2018,3,16,6,14706,15042,12104,-2938
2018,3,16,7,14443,14763,11788,-2975
2018,3,16,8,14396,14703,11804,-2899
2018,3,16,9,14628,14968,12158,-2810
2018,3,16,10,15491,15884,13260,-2624
2018,3,16,11,17124,17640,14684,-2956
2018,3,16,12,18297,18859,15845,-3014
2018,3,16,13,18653,19222,15839,-3383
2018,3,16,14,18900,19357,15841,-3516
2018,3,16,15,18881,19362,15927,-3435
2018,3,16,16,18755,19340,16127,-3213
2018,3,16,17,18569,19173,16287,-2886
2018,3,16,18,18454,19056,16290,-2766
2018,3,16,19,18310,18806,16103,-2703
2018,3,16,20,18280,18670,16047,-2623
2018,3,16,21,18310,18721,16168,-2553
2018,3,16,22,18255,18903,16220,-2683
2018,3,16,23,18301,19127,16475,-2652
2018,3,17,0,18878,19757,16552,-3205
2018,3,17,1,18909,19721,16804,-2917
2018,3,17,2,18252,19115,16359,-2756
2018,3,17,3,17363,18207,15575,-2632
2018,3,17,4,16370,17151,14564,-2587
2018,3,17,5,15623,16306,13335,-2971
2018,3,17,6,15106,15744,12697,-3047
2018,3,17,7,14788,15408,12358,-3050
2018,3,17,8,14652,15222,11935,-3287
2018,3,17,9,14687,15260,11999,-3261
2018,3,17,10,14993,15570,12596,-2974
2018,3,17,11,15581,16250,13167,-3083
2018,3,17,12,16121,16944,14286,-2658
2018,3,17,13,16659,17554,14707,-2847
2018,3,17,14,17141,17814,14781,-3033
2018,3,17,15,17180,17845,14993,-2852
2018,3,17,16,17013,17646,14785,-2861
2018,3,17,17,16757,17319,14313,-3006
2018,3,17,18,16475,16951,13883,-3068
2018,3,17,19,16244,16682,13729,-2953
2018,3,17,20,16179,16596,14005,-2591
2018,3,17,21,16274,16720,14069,-2651
2018,3,17,22,16553,16933,13931,-3002
2018,3,17,23,16918,17185,14184,-3001
2018,3,18,0,17678,17946,14438,-3508
2018,3,18,1,17914,18064,14563,-3501
2018,3,18,2,17520,17689,14780,-2909
2018,3,18,3,16926,17082,13841,-3241
2018,3,18,4,16202,16272,12876,-3396
2018,3,18,5,15294,15540,11888,-3652
2018,3,18,6,14825,15052,11702,-3350
2018,3,18,7,14536,14795,11678,-3117
2018,3,18,8,14439,14725,11671,-3054
2018,3,18,9,14494,14764,11760,-3004
2018,3,18,10,14777,15036,12129,-2907
2018,3,18,11,15252,15609,12272,-3337
2018,3,18,12,15589,16083,12965,-3118
2018,3,18,13,16010,16617,13678,-2939
2018,3,18,14,16340,16980,13642,-3338
2018,3,18,15,16335,17091,13612,-3479
2018,3,18,16,16192,17028,13276,-3752
2018,3,18,17,16011,16891,13314,-3577
2018,3,18,18,15807,16696,13260,-3436
2018,3,18,19,15678,16528,13143,-3385
2018,3,18,20,15776,16457,12965,-3492
2018,3,18,21,16053,16640,13011,-3629
2018,3,18,22,16481,17042,13298,-3744
2018,3,18,23,16946,17564,14176,-3388
2018,3,19,0,17781,18441,14748,-3693
2018,3,19,1,18009,18571,14835,-3736
2018,3,19,2,17432,18021,14244,-3777
2018,3,19,3,16562,17092,13431,-3661
2018,3,19,4,15632,16066,12390,-3676
2018,3,19,5,14844,15309,11374,-3935
2018,3,19,6,14480,14865,11231,-3634
2018,3,19,7,14294,14688,11186,-3502
2018,3,19,8,14304,14665,11247,-3418
2018,3,19,9,14595,14979,11341,-3638
2018,3,19,10,15510,16025,12389,-3636
2018,3,19,11,17157,17861,14251,-3610
2018,3,19,12,18272,19084,15254,-3830
2018,3,19,13,18554,19349,15006,-4343
2018,3,19,14,18540,19215,15103,-4112
2018,3,19,15,18345,18990,15023,-3967
2018,3,19,16,18069,18749,14942,-3807
2018,3,19,17,17778,18509,14973,-3536
2018,3,19,18,17610,18289,15044,-3245
2018,3,19,19,17490,18056,14611,-3445
2018,3,19,20,17516,17972,14404,-3568
2018,3,19,21,17704,18164,14461,-3703
2018,3,19,22,18040,18455,14560,-3895
2018,3,19,23,18383,18771,14979,-3792
2018,3,20,0,19066,19520,15521,-3999
2018,3,20,1,19122,19507,15602,-3905
2018,3,20,2,18387,18821,14855,-3966
2018,3,20,3,17269,17698,13941,-3757
2018,3,20,4,16127,16463,12617,-3846
2018,3,20,5,15417,15703,12185,-3518
2018,3,20,6,15004,15283,12018,-3265
2018,3,20,7,14779,15074,12213,-2861
2018,3,20,8,14757,15062,12172,-2890
2018,3,20,9,15013,15364,12182,-3182
2018,3,20,10,15890,16324,12560,-3764
2018,3,20,11,17524,18159,14459,-3700
2018,3,20,12,18603,19338,15641,-3697
2018,3,20,13,18864,19583,15340,-4243
2018,3,20,14,18885,19560,15326,-4234
2018,3,20,15,18761,19496,15471,-4025
2018,3,20,16,18556,19456,15950,-3506
2018,3,20,17,18318,19349,15949,-3400
2018,3,20,18,18188,19288,16019,-3269
2018,3,20,19,18058,19210,15912,-3298
2018,3,20,20,18061,19143,15809,-3334
2018,3,20,21,18222,19313,15924,-3389
2018,3,20,22,18384,19521,15784,-3737
2018,3,20,23,18572,19668,15984,-3684
2018,3,21,0,19151,20092,16540,-3552
2018,3,21,1,19153,19931,16410,-3521
2018,3,21,2,18385,19152,15687,-3465
2018,3,21,3,17237,18021,14726,-3295
2018,3,21,4,16085,16819,13528,-3291
2018,3,21,5,15306,15952,12774,-3178
2018,3,21,6,14852,15426,12387,-3039
2018,3,21,7,14587,15157,12341,-2816
2018,3,21,8,14532,15064,12173,-2891
2018,3,21,9,14759,15304,12543,-2761
2018,3,21,10,15615,16188,13277,-2911
2018,3,21,11,17232,17662,15014,-2648
2018,3,21,12,18390,18824,16362,-2462
2018,3,21,13,18810,19472,16603,-2869
2018,3,21,14,19047,19905,16978,-2927
2018,3,21,15,19084,20098,17256,-2842
2018,3,21,16,18993,20089,17205,-2884
2018,3,21,17,18846,19980,17353,-2627
2018,3,21,18,18763,19810,16812,-2998
2018,3,21,19,18662,19577,16499,-3078
2018,3,21,20,18672,19422,16275,-3147
2018,3,21,21,18803,19545,16435,-3110
2018,3,21,22,18845,19766,17036,-2730
2018,3,21,23,18900,19853,17464,-2389
2018,3,22,0,19399,20237,17954,-2283
2018,3,22,1,19363,19967,17594,-2373
2018,3,22,2,18571,19098,16558,-2540
2018,3,22,3,17399,17937,15404,-2533
2018,3,22,4,16197,16738,14025,-2713
2018,3,22,5,15151,15913,13273,-2640
2018,3,22,6,14650,15394,12607,-2787
2018,3,22,7,14362,15130,12313,-2817
2018,3,22,8,14293,15083,12136,-2947
2018,3,22,9,14508,15332,12357,-2975
2018,3,22,10,15370,16237,13007,-3230
2018,3,22,11,16991,17828,14792,-3036
2018,3,22,12,18123,18859,16067,-2792
2018,3,22,13,18502,19322,16487,-2835
2018,3,22,14,18687,19391,16480,-2911
2018,3,22,15,18600,19278,16480,-2798
2018,3,22,16,18383,19103,16192,-2911
2018,3,22,17,18148,18811,15940,-2871
2018,3,22,18,18002,18562,15694,-2868
2018,3,22,19,17862,18308,15461,-2847
2018,3,22,20,17853,18107,15235,-2872
2018,3,22,21,18011,18197,15506,-2691
2018,3,22,22,18141,18399,15604,-2795
2018,3,22,23,18275,18638,15896,-2742
2018,3,23,0,18822,19279,16388,-2891
2018,3,23,1,18857,19275,16474,-2801
2018,3,23,2,18137,18577,15650,-2927
2018,3,23,3,17013,17442,14711,-2731
2018,3,23,4,15845,16284,13440,-2844
2018,3,23,5,14826,15461,12559,-2902
2018,3,23,6,14359,14970,12286,-2684
2018,3,23,7,14089,14723,12161,-2562
2018,3,23,8,14033,14667,12143,-2524
2018,3,23,9,14252,14923,12546,-2377
2018,3,23,10,15078,15842,12947,-2895
2018,3,23,11,16658,17545,14709,-2836
2018,3,23,12,17739,18661,15749,-2912
2018,3,23,13,18114,19005,15921,-3084
2018,3,23,14,18390,18982,15820,-3162
2018,3,23,15,18360,18807,15393,-3414
2018,3,23,16,18205,18537,15286,-3251
2018,3,23,17,17964,18187,15033,-3154
2018,3,23,18,17806,17909,14705,-3204
2018,3,23,19,17645,17735,14464,-3271
2018,3,23,20,17575,17783,14670,-3113
2018,3,23,21,17574,17958,15016,-2942
2018,3,23,22,17481,18196,15375,-2821
2018,3,23,23,17481,18348,15570,-2778
2018,3,24,0,17944,18779,15801,-2978
2018,3,24,1,17963,18711,15895,-2816
2018,3,24,2,17429,18165,15386,-2779
2018,3,24,3,16567,17209,14061,-3148
2018,3,24,4,15598,16209,13124,-3085
2018,3,24,5,14764,15362,11597,-3765
2018,3,24,6,14248,14778,11144,-3634
2018,3,24,7,13928,14454,10865,-3589
2018,3,24,8,13806,14349,10848,-3501
2018,3,24,9,13865,14426,11201,-3225
2018,3,24,10,14190,14792,11322,-3470
2018,3,24,11,14784,15557,12347,-3210
2018,3,24,12,15290,16190,12678,-3512
2018,3,24,13,15888,16708,12786,-3922
2018,3,24,14,16435,16901,12757,-4144
2018,3,24,15,16521,16902,12906,-3996
2018,3,24,16,16402,16772,12684,-4088
2018,3,24,17,16201,16511,12530,-3981
2018,3,24,18,15978,16247,12565,-3682
2018,3,24,19,15793,16056,12406,-3650
2018,3,24,20,15768,15945,12364,-3581
2018,3,24,21,15854,16021,12217,-3804
2018,3,24,22,16076,16326,12507,-3819
2018,3,24,23,16371,16742,12899,-3843
2018,3,25,0,17022,17491,13378,-4113
2018,3,25,1,17223,17715,13693,-4022
2018,3,25,2,16884,17377,13307,-4070
2018,3,25,3,16235,16735,12723,-4012
2018,3,25,4,15458,15929,12042,-3887
2018,3,25,5,14633,15197,11038,-4159
2018,3,25,6,14131,14738,10633,-4105
2018,3,25,7,13811,14439,10241,-4198
2018,3,25,8,13684,14294,10143,-4151
2018,3,25,9,13713,14343,10168,-4175
2018,3,25,10,13956,14598,10479,-4119
2018,3,25,11,14415,15087,11125,-3962
2018,3,25,12,14770,15597,11984,-3613
2018,3,25,13,15324,16227,12408,-3819
2018,3,25,14,15741,16684,12642,-4042
2018,3,25,15,15845,16871,12590,-4281
2018,3,25,16,15776,16953,12412,-4541
2018,3,25,17,15635,16881,12404,-4477
2018,3,25,18,15456,16675,12385,-4290
2018,3,25,19,15304,16429,12350,-4079
2018,3,25,20,15308,16336,12381,-3955
2018,3,25,21,15540,16450,12520,-3930
2018,3,25,22,15999,16801,12754,-4047
2018,3,25,23,16451,17214,13027,-4187
2018,3,26,0,17197,17950,13716,-4234
2018,3,26,1,17425,18205,14184,-4021
2018,3,26,2,16891,17627,13565,-4062
2018,3,26,3,15973,16689,12696,-3993
2018,3,26,4,15002,15711,12064,-3647
2018,3,26,5,14244,15071,11522,-3549
2018,3,26,6,13882,14693,11273,-3420
2018,3,26,7,13684,14500,10985,-3515
2018,3,26,8,13680,14514,11090,-3424
2018,3,26,9,13948,14836,11378,-3458
2018,3,26,10,14821,15834,12352,-3482
2018,3,26,11,16405,17588,13670,-3918
2018,3,26,12,17439,18723,14851,-3872
2018,3,26,13,17649,18869,14645,-4224
2018,3,26,14,17528,18754,14512,-4242
2018,3,26,15,17277,18553,14680,-3873
2018,3,26,16,16983,18269,14226,-4043
2018,3,26,17,16686,17979,13769,-4210
2018,3,26,18,16539,17765,13604,-4161
2018,3,26,19,16423,17533,13548,-3985
2018,3,26,20,16473,17428,13495,-3933
2018,3,26,21,16718,17592,13607,-3985
2018,3,26,22,17112,17904,13814,-4090
2018,3,26,23,17459,18173,14124,-4049
2018,3,27,0,18054,18827,14324,-4503
2018,3,27,1,18114,19008,14834,-4174
2018,3,27,2,17448,18310,14273,-4037
2018,3,27,3,16325,17151,13464,-3687
2018,3,27,4,15178,15935,12401,-3534
2018,3,27,5,14441,15038,11284,-3754
2018,3,27,6,14011,14621,11406,-3215
2018,3,27,7,13771,14413,11180,-3233
2018,3,27,8,13735,14369,11135,-3234
2018,3,27,9,13991,14652,11289,-3363
2018,3,27,10,14857,15654,11925,-3729
2018,3,27,11,16493,17348,13446,-3902
2018,3,27,12,17534,18458,14726,-3732
2018,3,27,13,17739,18778,14590,-4188
2018,3,27,14,17791,18745,15063,-3682
2018,3,27,15,17603,18655,15070,-3585
2018,3,27,16,17380,18653,14794,-3859
2018,3,27,17,17143,18496,14526,-3970
2018,3,27,18,17041,18426,14589,-3837
2018,3,27,19,16936,18392,14590,-3802
2018,3,27,20,16953,18505,14650,-3855
2018,3,27,21,17103,18836,14781,-4055
2018,3,27,22,17312,19143,15288,-3855
2018,3,27,23,17515,19296,15352,-3944
2018,3,28,0,18021,19634,15258,-4376
2018,3,28,1,18024,19223,15162,-4061
2018,3,28,2,17395,18411,14528,-3883
2018,3,28,3,16285,17199,13129,-4070
2018,3,28,4,15130,15961,12135,-3826
2018,3,28,5,14183,15000,11455,-3545
2018,3,28,6,13687,14521,11113,-3408
2018,3,28,7,13406,14216,10967,-3249
2018,3,28,8,13330,14093,10954,-3139
2018,3,28,9,13549,14299,11202,-3097
2018,3,28,10,14413,15217,11860,-3357
2018,3,28,11,16175,16954,13306,-3648
2018,3,28,12,17326,18138,13933,-4205
2018,3,28,13,17699,18596,14287,-4309
2018,3,28,14,17882,18831,14440,-4391
2018,3,28,15,17825,18832,14579,-4253
2018,3,28,16,17634,18672,14499,-4173
2018,3,28,17,17368,18379,14155,-4224
2018,3,28,18,17212,18205,14218,-3987
2018,3,28,19,16982,18050,14256,-3794
2018,3,28,20,16885,18033,14083,-3950
2018,3,28,21,16961,18160,14057,-4103
2018,3,28,22,17115,18383,14289,-4094
2018,3,28,23,17296,18470,14315,-4155
2018,3,29,0,17788,18822,14445,-4377
2018,3,29,1,17803,18690,14715,-3975
2018,3,29,2,17156,17949,14062,-3887
2018,3,29,3,16034,16712,12669,-4043
2018,3,29,4,14868,15438,11568,-3870
2018,3,29,5,13847,14553,11250,-3303
2018,3,29,6,13336,14042,10827,-3215
2018,3,29,7,13058,13709,10624,-3085
2018,3,29,8,12988,13619,10458,-3161
2018,3,29,9,13219,13840,10603,-3237
2018,3,29,10,14103,14719,11394,-3325
2018,3,29,11,15896,16425,13068,-3357
2018,3,29,12,17061,17584,14428,-3156
2018,3,29,13,17438,18156,14919,-3237
2018,3,29,14,17683,18440,14824,-3616
2018,3,29,15,17648,18643,14807,-3836
2018,3,29,16,17493,18638,14658,-3980
2018,3,29,17,17259,18529,14679,-3850
2018,3,29,18,17127,18473,14668,-3805
2018,3,29,19,16932,18282,14544,-3738
2018,3,29,20,16854,18160,14427,-3733
2018,3,29,21,16886,18252,14420,-3832
2018,3,29,22,16945,18432,14692,-3740
2018,3,29,23,17076,18452,14939,-3513
2018,3,30,0,17524,18731,15181,-3550
2018,3,30,1,17537,18485,14711,-3774
2018,3,30,2,16924,17736,13926,-3810
2018,3,30,3,15845,16614,12404,-4210
2018,3,30,4,14717,15399,11363,-4036
2018,3,30,5,13628,14452,10527,-3925
2018,3,30,6,13055,13876,10194,-3682
2018,3,30,7,12741,13522,10070,-3452
2018,3,30,8,12609,13420,9935,-3485
2018,3,30,9,12732,13523,10032,-3491
2018,3,30,10,13294,14162,10649,-3513
2018,3,30,11,14369,15385,11894,-3491
2018,3,30,12,15277,16490,12725,-3765
2018,3,30,13,15984,17288,13007,-4281
2018,3,30,14,16578,17866,13525,-4341
2018,3,30,15,16701,18026,13637,-4389
2018,3,30,16,16611,17965,13417,-4548
2018,3,30,17,16373,17803,13370,-4433
2018,3,30,18,16185,17590,13291,-4299
2018,3,30,19,15954,17377,13321,-4056
2018,3,30,20,15815,17296,13183,-4113
2018,3,30,21,15828,17501,13396,-4105
2018,3,30,22,15814,17648,13883,-3765
2018,3,30,23,15885,17528,13851,-3677
2018,3,31,0,16235,17689,13601,-4088
2018,3,31,1,16286,17689,13671,-4018
2018,3,31,2,15915,17211,13558,-3653
2018,3,31,3,15189,16398,12715,-3683
2018,3,31,4,14372,15464,11715,-3749
2018,3,31,5,13935,14640,10799,-3841
2018,3,31,6,13472,14150,10135,-4015
2018,3,31,7,13186,13874,10154,-3720
2018,3,31,8,13064,13713,10170,-3543
2018,3,31,9,13104,13762,10005,-3757
2018,3,31,10,13362,14098,10555,-3543
2018,3,31,11,13824,14708,11249,-3459
2018,3,31,12,14203,15308,11420,-3888
2018,3,31,13,14641,15848,11875,-3973
2018,3,31,14,15040,16061,11771,-4290
2018,3,31,15,14985,16044,11847,-4197
2018,3,31,16,14781,15894,11904,-3990
2018,3,31,17,14525,15628,11908,-3720
2018,3,31,18,14295,15316,11835,-3481
2018,3,31,19,14140,15115,11869,-3246
2018,3,31,20,14136,15099,11793,-3306
2018,3,31,21,14291,15356,12085,-3271
2018,3,31,22,14566,15775,12106,-3669
2018,3,31,23,14946,16128,12574,-3554
2018,4,1,0,15509,16820,13098,-3722
2018,4,1,1,15724,17004,13426,-3578
2018,4,1,2,15545,16584,13211,-3373
2018,4,1,3,14988,15891,12745,-3146
2018,4,1,4,14301,14987,12088,-2899
2018,4,1,5,13547,14203,11559,-2644
2018,4,1,6,13061,13687,11349,-2338
2018,4,1,7,12759,13339,11267,-2072
2018,4,1,8,12605,13128,11111,-2017
2018,4,1,9,12628,13144,10879,-2265
2018,4,1,10,12928,13374,10833,-2541
2018,4,1,11,13395,13876,11123,-2753
2018,4,1,12,13675,14438,12039,-2399
2018,4,1,13,14181,15213,12128,-3085
2018,4,1,14,14507,15770,12264,-3506
2018,4,1,15,14672,16026,12461,-3565
2018,4,1,16,14654,16004,12577,-3427
2018,4,1,17,14552,15795,12280,-3515
2018,4,1,18,14428,15323,12073,-3250
2018,4,1,19,14332,14981,12138,-2843
2018,4,1,20,14404,14814,12191,-2623
2018,4,1,21,14646,14821,12006,-2815
2018,4,1,22,14976,15074,11914,-3160
2018,4,1,23,15311,15483,12035,-3448
2018,4,2,0,15953,16338,12586,-3752
2018,4,2,1,16459,16850,12984,-3866
2018,4,2,2,15856,16465,12948,-3517
2018,4,2,3,15073,15778,12015,-3763
2018,4,2,4,14226,14902,11202,-3700
2018,4,2,5,13640,14234,10196,-4038
2018,4,2,6,13275,13788,9923,-3865
2018,4,2,7,13086,13553,9561,-3992
2018,4,2,8,13073,13565,9429,-4136
2018,4,2,9,13367,13906,10043,-3863
2018,4,2,10,14358,14906,11128,-3778
2018,4,2,11,16047,16492,13262,-3230
2018,4,2,12,17152,17675,14568,-3107
2018,4,2,13,17580,18376,14927,-3449
2018,4,2,14,17615,18798,15208,-3590
2018,4,2,15,17531,18938,15635,-3303
2018,4,2,16,17295,18916,15672,-3244
2018,4,2,17,17005,18737,15449,-3288
2018,4,2,18,16838,18437,15207,-3230
2018,4,2,19,16711,18039,14658,-3381
2018,4,2,20,16754,17780,14502,-3278
2018,4,2,21,17028,17716,14606,-3110
2018,4,2,22,17313,17848,14637,-3211
2018,4,2,23,17502,17970,14825,-3145
2018,4,3,0,18005,18541,15069,-3472
2018,4,3,1,18260,18633,15043,-3590
2018,4,3,2,17352,17987,14784,-3203
2018,4,3,3,16180,16882,13765,-3117
2018,4,3,4,14989,15735,12427,-3308
2018,4,3,5,14046,14869,11291,-3578
2018,4,3,6,13567,14424,11006,-3418
2018,4,3,7,13301,14149,10698,-3451
2018,4,3,8,13230,14055,10526,-3529
2018,4,3,9,13475,14267,10658,-3609
2018,4,3,10,14425,15133,11660,-3473
2018,4,3,11,16096,16639,13341,-3298
2018,4,3,12,17205,17776,14661,-3115
2018,4,3,13,17630,18401,14969,-3432
2018,4,3,14,17690,18642,15083,-3559
2018,4,3,15,17781,18895,15619,-3276
2018,4,3,16,17761,19116,15750,-3366
2018,4,3,17,17673,19200,15739,-3461
2018,4,3,18,17622,19289,15794,-3495
2018,4,3,19,17517,19256,15417,-3839
2018,4,3,20,17497,19080,15488,-3592
2018,4,3,21,17630,19122,15678,-3444
2018,4,3,22,17711,19264,15607,-3657
2018,4,3,23,17682,19231,15668,-3563
2018,4,4,0,18002,19298,15692,-3606
2018,4,4,1,18128,18980,15610,-3370
2018,4,4,2,17144,18129,14838,-3291
2018,4,4,3,15893,16880,13948,-2932
2018,4,4,4,14654,15637,12769,-2868
2018,4,4,5,13838,14769,11457,-3312
2018,4,4,6,13295,14220,11055,-3165
2018,4,4,7,12955,13901,10777,-3124
2018,4,4,8,12820,13744,11027,-2717
2018,4,4,9,13001,13943,11263,-2680
2018,4,4,10,13886,14755,11669,-3086
2018,4,4,11,15551,16209,12968,-3241
2018,4,4,12,16659,17357,14577,-2780
2018,4,4,13,17154,18107,14551,-3556
2018,4,4,14,17253,18514,14764,-3750
2018,4,4,15,17343,18637,15139,-3498
2018,4,4,16,17323,18595,15048,-3547
2018,4,4,17,17236,18518,14670,-3848
2018,4,4,18,17207,18478,15111,-3367
2018,4,4,19,17140,18426,15200,-3226
2018,4,4,20,17142,18164,14812,-3352
2018,4,4,21,17312,18008,14603,-3405
2018,4,4,22,17488,18107,14408,-3699
2018,4,4,23,17560,18147,14230,-3917
2018,4,5,0,17924,18648,14751,-3897
2018,4,5,1,18137,18817,15038,-3779
2018,4,5,2,17237,18195,14564,-3631
2018,4,5,3,16069,17108,13772,-3336
2018,4,5,4,14891,16001,13021,-2980
2018,4,5,5,14439,15243,12158,-3085
2018,4,5,6,14018,14766,11889,-2877
2018,4,5,7,13788,14517,11709,-2808
2018,4,5,8,13757,14425,11524,-2901
2018,4,5,9,14031,14693,11746,-2947
2018,4,5,10,14980,15626,12361,-3265
2018,4,5,11,16546,17075,14201,-2874
2018,4,5,12,17559,18050,15802,-2248
2018,4,5,13,17837,18549,15497,-3052
2018,4,5,14,17787,18626,15145,-3481
2018,4,5,15,17670,18652,15325,-3327
2018,4,5,16,17515,18526,15225,-3301
2018,4,5,17,17360,18404,15361,-3043
2018,4,5,18,17306,18295,15429,-2866
2018,4,5,19,17278,18193,15357,-2836
2018,4,5,20,17375,18097,15293,-2804
2018,4,5,21,17657,18234,15407,-2827
2018,4,5,22,17914,18388,15547,-2841
2018,4,5,23,18055,18531,15483,-3048
2018,4,6,0,18480,18995,16129,-2866
2018,4,6,1,18758,19145,16448,-2697
2018,4,6,2,17961,18477,15262,-3215
2018,4,6,3,16827,17455,14211,-3244
2018,4,6,4,15657,16315,13220,-3095
2018,4,6,5,14622,15307,11827,-3480
2018,4,6,6,14117,14891,11494,-3397
2018,4,6,7,13842,14657,11299,-3358
2018,4,6,8,13760,14619,11308,-3311
2018,4,6,9,13979,14859,11521,-3338
2018,4,6,10,14857,15640,12114,-3526
2018,4,6,11,16426,17029,13647,-3382
2018,4,6,12,17503,18035,14465,-3570
2018,4,6,13,17951,18717,15081,-3636
2018,4,6,14,17979,19170,15220,-3950
2018,4,6,15,17988,19428,15528,-3900
2018,4,6,16,17867,19428,15479,-3949
2018,4,6,17,17683,19242,15346,-3896
2018,4,6,18,17546,19104,15217,-3887
2018,4,6,19,17388,18590,14580,-4010
2018,4,6,20,17329,18161,14056,-4105
2018,4,6,21,17425,18048,14036,-4012
2018,4,6,22,17489,18170,14329,-3841
2018,4,6,23,17444,18174,14478,-3696
2018,4,7,0,17682,18407,14634,-3773
2018,4,7,1,17822,18330,14815,-3515
2018,4,7,2,17078,17724,14397,-3327
2018,4,7,3,16133,16836,13658,-3178
2018,4,7,4,15117,15892,12474,-3418
2018,4,7,5,14237,15062,11297,-3765
2018,4,7,6,13741,14512,11003,-3509
2018,4,7,7,13445,14172,10801,-3371
2018,4,7,8,13323,14018,10682,-3336
2018,4,7,9,13405,14019,10762,-3257
2018,4,7,10,13791,14413,11264,-3149
2018,4,7,11,14356,15082,12178,-2904
2018,4,7,12,14818,15777,12942,-2835
2018,4,7,13,15482,16635,13839,-2796
2018,4,7,14,15839,17082,13889,-3193
2018,4,7,15,15990,17287,13767,-3520
2018,4,7,16,15904,17275,13504,-3771
2018,4,7,17,15725,16906,13145,-3761
2018,4,7,18,15519,16561,13225,-3336
2018,4,7,19,15386,16285,13034,-3251
2018,4,7,20,15390,16140,13086,-3054
2018,4,7,21,15546,16395,13287,-3108
2018,4,7,22,15805,16658,13411,-3247
2018,4,7,23,16061,16961,13880,-3081
2018,4,8,0,16520,17494,14354,-3140
2018,4,8,1,16922,17733,14631,-3102
2018,4,8,2,16458,17281,13920,-3361
2018,4,8,3,15781,16598,13315,-3283
2018,4,8,4,15016,15825,12561,-3264
2018,4,8,5,14268,15075,11831,-3244
2018,4,8,6,13795,14634,11614,-3020
2018,4,8,7,13491,14371,11143,-3228
2018,4,8,8,13355,14228,10974,-3254
2018,4,8,9,13399,14220,11137,-3083
2018,4,8,10,13688,14477,11684,-2793
2018,4,8,11,14068,14881,12235,-2646
2018,4,8,12,14342,15342,12728,-2614
2018,4,8,13,14814,15915,13160,-2755
2018,4,8,14,15061,16264,13214,-3050
2018,4,8,15,15145,16425,13556,-2869
2018,4,8,16,15111,16530,13590,-2940
2018,4,8,17,15057,16526,13410,-3116
2018,4,8,18,14982,16457,13161,-3296
2018,4,8,19,14961,16412,13185,-3227
2018,4,8,20,15092,16471,13414,-3057
2018,4,8,21,15414,16707,13670,-3037
2018,4,8,22,15794,17159,14238,-2921
2018,4,8,23,16126,17537,14557,-2980
2018,4,9,0,16684,18101,15056,-3045
2018,4,9,1,17173,18469,15666,-2803
2018,4,9,2,16619,17880,15106,-2774
2018,4,9,3,15761,16953,14351,-2602
2018,4,9,4,14873,15932,13018,-2914
2018,4,9,5,14305,15238,12302,-2936
2018,4,9,6,13950,14847,11749,-3098
2018,4,9,7,13764,14658,11632,-3026
2018,4,9,8,13757,14634,11759,-2875
2018,4,9,9,14046,14898,12261,-2637
2018,4,9,10,14962,15883,13634,-2249
2018,4,9,11,16443,17485,15205,-2280
2018,4,9,12,17478,18423,16269,-2154
2018,4,9,13,17867,18709,16274,-2435
2018,4,9,14,17882,18666,16365,-2301
2018,4,9,15,17796,18553,16201,-2352
2018,4,9,16,17570,18241,15762,-2479
2018,4,9,17,17344,17968,15441,-2527
2018,4,9,18,17219,17777,15167,-2610
2018,4,9,19,17116,17594,14821,-2773
2018,4,9,20,17156,17552,14980,-2572
2018,4,9,21,17409,17855,15409,-2446
2018,4,9,22,17709,18260,15789,-2471
2018,4,9,23,17892,18559,16322,-2237
2018,4,10,0,18252,18973,16594,-2379
2018,4,10,1,18450,19037,16873,-2164
2018,4,10,2,17674,18215,16056,-2159
2018,4,10,3,16530,17049,14434,-2615
2018,4,10,4,15364,15826,13313,-2513
2018,4,10,5,14496,14964,12437,-2527
2018,4,10,6,14004,14503,12422,-2081
2018,4,10,7,13745,14240,12212,-2028
2018,4,10,8,13680,14143,12238,-1905
2018,4,10,9,13925,14374,12424,-1950
2018,4,10,10,14808,15314,13540,-1774
2018,4,10,11,16364,17035,15572,-1463
2018,4,10,12,17459,18110,17188,-922
2018,4,10,13,17889,18620,16886,-1734
2018,4,10,14,17932,18758,16780,-1978
2018,4,10,15,17902,18766,16358,-2408
2018,4,10,16,17755,18657,16041,-2616
2018,4,10,17,17580,18511,16120,-2391
2018,4,10,18,17487,18361,15792,-2569
2018,4,10,19,17367,18059,15209,-2850
2018,4,10,20,17348,17992,15327,-2665
2018,4,10,21,17533,18027,15497,-2530
2018,4,10,22,17734,18230,15601,-2629
2018,4,10,23,17830,18295,15787,-2508
2018,4,11,0,18147,18667,15822,-2845
2018,4,11,1,18414,18918,16487,-2431
2018,4,11,2,17632,18215,16052,-2163
2018,4,11,3,16464,17047,14554,-2493
2018,4,11,4,15280,15808,13433,-2375
2018,4,11,5,14315,14976,12429,-2547
2018,4,11,6,13838,14498,11958,-2540
2018,4,11,7,13579,14277,12010,-2267
2018,4,11,8,13516,14216,12082,-2134
2018,4,11,9,13761,14464,12202,-2262
2018,4,11,10,14654,15474,13132,-2342
2018,4,11,11,16145,17173,15217,-1956
2018,4,11,12,17132,18120,16465,-1655
2018,4,11,13,17392,18271,16281,-1990
2018,4,11,14,17259,18244,15839,-2405
2018,4,11,15,17101,18049,15481,-2568
2018,4,11,16,16927,17889,14811,-3078
2018,4,11,17,16773,17732,14776,-2956
2018,4,11,18,16763,17673,14782,-2891
2018,4,11,19,16763,17591,14719,-2872
2018,4,11,20,16878,17609,14856,-2753
2018,4,11,21,17177,17783,15124,-2659
2018,4,11,22,17406,18050,15394,-2656
2018,4,11,23,17512,18048,15495,-2553
2018,4,12,0,17826,18434,15634,-2800
2018,4,12,1,18101,18678,15717,-2961
2018,4,12,2,17360,17985,15233,-2752
2018,4,12,3,16199,16752,13960,-2792
2018,4,12,4,14996,15449,12347,-3102
2018,4,12,5,13966,14603,11925,-2678
2018,4,12,6,13458,14116,11677,-2439
2018,4,12,7,13193,13843,11025,-2818
2018,4,12,8,13123,13777,11198,-2579
2018,4,12,9,13360,14054,11200,-2854
2018,4,12,10,14254,14965,12125,-2840
2018,4,12,11,15784,16606,13861,-2745
2018,4,12,12,16848,17648,15162,-2486
2018,4,12,13,17218,17914,15077,-2837
2018,4,12,14,17249,17989,14866,-3123
2018,4,12,15,17274,17974,14773,-3201
2018,4,12,16,17198,17933,14574,-3359
2018,4,12,17,17092,17756,14672,-3084
2018,4,12,18,17072,17713,14646,-3067
2018,4,12,19,16960,17714,14530,-3184
2018,4,12,20,16936,17761,14679,-3082
2018,4,12,21,17067,17915,15043,-2872
2018,4,12,22,17149,18272,15535,-2737
2018,4,12,23,17150,18231,15656,-2575
2018,4,13,0,17378,18312,15786,-2526
2018,4,13,1,17632,18333,16118,-2215
2018,4,13,2,16868,17563,15187,-2376
2018,4,13,3,15718,16318,13517,-2801
2018,4,13,4,14541,15047,12321,-2726
2018,4,13,5,13551,14116,11231,-2885
2018,4,13,6,13022,13568,10913,-2655
2018,4,13,7,12722,13246,11098,-2148
2018,4,13,8,12608,13158,11078,-2080
2018,4,13,9,12781,13368,11027,-2341
2018,4,13,10,13563,14234,11955,-2279
2018,4,13,11,14967,15911,13778,-2133
2018,4,13,12,16028,17096,14753,-2343
2018,4,13,13,16527,17682,14892,-2790
2018,4,13,14,16696,17849,14735,-3114
2018,4,13,15,16762,17873,14680,-3193
2018,4,13,16,16713,17767,14720,-3047
2018,4,13,17,16609,17638,14883,-2755
2018,4,13,18,16593,17555,14894,-2661
2018,4,13,19,16560,17400,14777,-2623
2018,4,13,20,16615,17358,14758,-2600
2018,4,13,21,16753,17466,14939,-2527
2018,4,13,22,16724,17507,14761,-2746
2018,4,13,23,16593,17406,14701,-2705
2018,4,14,0,16691,17486,14821,-2665
2018,4,14,1,16879,17536,14869,-2667
2018,4,14,2,16287,16973,13976,-2997
2018,4,14,3,15371,16020,12901,-3119
2018,4,14,4,14367,14931,11798,-3133
2018,4,14,5,13646,13962,11095,-2867
2018,4,14,6,13071,13294,10689,-2605
2018,4,14,7,12716,12903,10486,-2417
2018,4,14,8,12527,12731,10485,-2246
2018,4,14,9,12557,12764,10610,-2154
2018,4,14,10,12875,13086,10822,-2264
2018,4,14,11,13284,13756,11970,-1786
2018,4,14,12,13819,14535,12912,-1623
2018,4,14,13,14591,15355,13279,-2076
2018,4,14,14,15107,15926,13199,-2727
2018,4,14,15,15381,16181,13209,-2972
2018,4,14,16,15476,16290,13573,-2717
2018,4,14,17,15467,16258,13768,-2490
2018,4,14,18,15424,16120,13692,-2428
2018,4,14,19,15425,16039,13747,-2292
2018,4,14,20,15479,16069,13826,-2243
2018,4,14,21,15628,16222,14125,-2097
2018,4,14,22,15709,16409,14303,-2106
2018,4,14,23,15754,16506,14468,-2038
2018,4,15,0,16066,16828,15052,-1776
2018,4,15,1,16439,16988,14910,-2078
2018,4,15,2,15955,16541,14363,-2178
2018,4,15,3,15185,15773,13498,-2275
2018,4,15,4,14335,14887,12107,-2780
2018,4,15,5,13657,14140,11244,-2896
2018,4,15,6,13180,13646,10863,-2783
2018,4,15,7,12863,13214,10617,-2597
2018,4,15,8,12708,13059,10587,-2472
2018,4,15,9,12737,13095,10663,-2432
2018,4,15,10,12994,13311,10968,-2343
2018,4,15,11,13316,13786,11213,-2573
2018,4,15,12,13701,14428,12195,-2233
2018,4,15,13,14476,15330,12961,-2369
2018,4,15,14,15213,16164,13484,-2680
2018,4,15,15,15622,16702,14514,-2188
2018,4,15,16,15777,17000,14911,-2089
2018,4,15,17,15805,17124,15080,-2044
2018,4,15,18,15733,17064,14809,-2255
2018,4,15,19,15635,17053,14461,-2592
2018,4,15,20,15643,17171,14666,-2505
2018,4,15,21,15794,17416,14931,-2485
2018,4,15,22,15962,17859,15626,-2233
2018,4,15,23,16128,18053,15686,-2367
2018,4,16,0,16512,18332,16110,-2222
2018,4,16,1,16981,18203,16058,-2145
2018,4,16,2,16421,17496,15165,-2331
2018,4,16,3,15437,16425,13934,-2491
2018,4,16,4,14400,15336,12746,-2590
2018,4,16,5,13734,14526,11623,-2903
2018,4,16,6,13295,14083,10772,-3311
2018,4,16,7,13037,13843,10426,-3417
2018,4,16,8,12959,13773,10434,-3339
2018,4,16,9,13200,14024,10833,-3191
2018,4,16,10,14083,14914,11841,-3073
2018,4,16,11,15622,16563,14273,-2290
2018,4,16,12,16842,17933,15883,-2050
2018,4,16,13,17458,18678,16232,-2446
2018,4,16,14,17680,19207,16230,-2977
2018,4,16,15,17786,19498,16336,-3162
2018,4,16,16,17696,19534,16185,-3349
2018,4,16,17,17545,19349,16020,-3329
2018,4,16,18,17454,18985,16078,-2907
2018,4,16,19,17300,18634,15775,-2859
2018,4,16,20,17247,18380,15216,-3164
2018,4,16,21,17406,18306,15264,-3042
2018,4,16,22,17564,18514,15678,-2836
2018,4,16,23,17611,18610,15738,-2872
2018,4,17,0,17804,18801,15816,-2985
2018,4,17,1,18018,18784,15908,-2876
2018,4,17,2,17205,17920,15263,-2657
2018,4,17,3,15963,16678,14251,-2427
2018,4,17,4,14704,15411,12858,-2553
2018,4,17,5,13849,14543,11858,-2685
2018,4,17,6,13367,14039,11217,-2822
2018,4,17,7,13107,13759,10932,-2827
2018,4,17,8,13054,13687,11156,-2531
2018,4,17,9,13324,13951,11299,-2652
2018,4,17,10,14232,14900,12314,-2586
2018,4,17,11,15780,16515,13892,-2623
2018,4,17,12,16957,17720,15298,-2422
2018,4,17,13,17442,18243,15544,-2699
2018,4,17,14,17606,18357,15548,-2809
2018,4,17,15,17621,18324,15503,-2821
2018,4,17,16,17561,18232,15317,-2915
2018,4,17,17,17477,18254,15492,-2762
2018,4,17,18,17469,18278,15600,-2678
2018,4,17,19,17425,18265,15517,-2748
2018,4,17,20,17460,18479,15710,-2769
2018,4,17,21,17659,18632,15739,-2893
2018,4,17,22,17779,18845,15723,-3122
2018,4,17,23,17819,18947,15836,-3111
2018,4,18,0,18025,19103,15990,-3113
2018,4,18,1,18289,19162,16600,-2562
2018,4,18,2,17551,18322,16050,-2272
2018,4,18,3,16299,17055,15434,-1621
2018,4,18,4,15034,15826,14536,-1290
2018,4,18,5,14308,14894,12525,-2369
2018,4,18,6,13810,14391,11764,-2627
2018,4,18,7,13532,14121,11655,-2466
2018,4,18,8,13449,14060,11925,-2135
2018,4,18,9,13683,14302,12021,-2281
2018,4,18,10,14534,15232,12698,-2534
2018,4,18,11,15997,16859,14367,-2492
2018,4,18,12,17099,17994,15394,-2600
2018,4,18,13,17495,18412,15715,-2697
2018,4,18,14,17526,18487,15648,-2839
2018,4,18,15,17445,18374,15470,-2904
2018,4,18,16,17304,18197,15265,-2932
2018,4,18,17,17141,18023,15325,-2698
2018,4,18,18,17085,17877,15320,-2557
2018,4,18,19,17011,17669,14964,-2705
2018,4,18,20,17071,17614,14998,-2616
2018,4,18,21,17335,17783,15095,-2688
2018,4,18,22,17505,17965,15225,-2740
2018,4,18,23,17547,17949,15174,-2775
2018,4,19,0,17756,18207,15274,-2933
2018,4,19,1,18087,18504,15664,-2840
2018,4,19,2,17408,17769,15170,-2599
2018,4,19,3,16227,16517,13920,-2597
2018,4,19,4,14997,15286,12626,-2660
2018,4,19,5,14031,14373,11586,-2787
2018,4,19,6,13503,13847,10692,-3155
2018,4,19,7,13219,13565,10559,-3006
2018,4,19,8,13142,13482,10587,-2895
2018,4,19,9,13385,13738,10857,-2881
2018,4,19,10,14255,14680,11613,-3067
2018,4,19,11,15795,16415,13779,-2636
2018,4,19,12,17008,17706,14615,-3091
2018,4,19,13,17567,18241,14777,-3464
2018,4,19,14,17775,18481,14831,-3650
2018,4,19,15,17804,18677,14851,-3826
2018,4,19,16,17725,18733,15155,-3578
2018,4,19,17,17609,18619,14936,-3683
2018,4,19,18,17568,18609,14841,-3768
2018,4,19,19,17499,18479,14679,-3800
2018,4,19,20,17510,18260,14595,-3665
2018,4,19,21,17672,18278,14760,-3518
2018,4,19,22,17753,18562,14946,-3616
2018,4,19,23,17755,18548,15207,-3341
2018,4,20,0,17927,18774,15211,-3563
2018,4,20,1,18215,18995,15571,-3424
2018,4,20,2,17556,18303,15380,-2923
2018,4,20,3,16368,17092,14152,-2940
2018,4,20,4,15165,15844,12711,-3133
2018,4,20,5,14375,15003,12445,-2558
2018,4,20,6,13899,14497,11725,-2772
2018,4,20,7,13629,14282,11849,-2433
2018,4,20,8,13546,14183,11926,-2257
2018,4,20,9,13762,14425,12113,-2312
2018,4,20,10,14527,15303,12856,-2447
2018,4,20,11,15809,16762,14171,-2591
2018,4,20,12,16853,17828,14885,-2943
2018,4,20,13,17295,18216,14553,-3663
2018,4,20,14,17363,18367,14444,-3923
2018,4,20,15,17271,18267,14123,-4144
2018,4,20,16,17100,18030,13993,-4037
2018,4,20,17,16925,17725,13503,-4222
2018,4,20,18,16846,17526,13397,-4129
2018,4,20,19,16788,17257,13138,-4119
2018,4,20,20,16831,17103,13200,-3903
2018,4,20,21,17032,17158,13276,-3882
2018,4,20,22,17133,17256,13281,-3975
2018,4,20,23,17123,17270,13339,-3931
2018,4,21,0,17244,17533,13748,-3785
2018,4,21,1,17528,18002,14226,-3776
2018,4,21,2,17032,17560,14118,-3442
2018,4,21,3,16139,16640,12814,-3826
2018,4,21,4,15155,15584,11979,-3605
2018,4,21,5,14345,14750,10721,-4029
2018,4,21,6,13836,14254,10276,-3978
2018,4,21,7,13533,13939,10370,-3569
2018,4,21,8,13395,13800,10337,-3463
2018,4,21,9,13462,13874,10596,-3278
2018,4,21,10,13753,14215,10810,-3405
2018,4,21,11,14055,14676,11455,-3221
2018,4,21,12,14495,15235,11483,-3752
2018,4,21,13,15024,15642,11166,-4476
2018,4,21,14,15181,15798,11124,-4674
2018,4,21,15,15142,15745,11189,-4556
2018,4,21,16,14959,15558,11325,-4233
2018,4,21,17,14758,15302,11319,-3983
2018,4,21,18,14581,15064,11229,-3835
2018,4,21,19,14494,14787,10970,-3817
2018,4,21,20,14575,14681,11110,-3571
2018,4,21,21,14870,14855,11446,-3409
2018,4,21,22,15160,15159,11704,-3455
2018,4,21,23,15410,15349,12079,-3270
2018,4,22,0,15749,15721,12322,-3399
2018,4,22,1,16291,16268,12507,-3761
2018,4,22,2,15984,15998,12442,-3556
2018,4,22,3,15309,15327,11533,-3794
2018,4,22,4,14555,14498,10462,-4036
2018,4,22,5,13747,13812,9995,-3817
2018,4,22,6,13253,13304,9543,-3761
2018,4,22,7,12948,13035,9493,-3542
2018,4,22,8,12811,12932,9410,-3522
2018,4,22,9,12861,12947,9177,-3770
2018,4,22,10,13091,13212,9628,-3584
2018,4,22,11,13218,13521,10462,-3059
2018,4,22,12,13452,13972,11316,-2656
2018,4,22,13,13887,14384,11378,-3006
2018,4,22,14,14150,14582,11530,-3052
2018,4,22,15,14162,14692,11526,-3166
2018,4,22,16,14105,14622,11359,-3263
2018,4,22,17,14008,14498,11283,-3215
2018,4,22,18,13900,14334,10993,-3341
2018,4,22,19,13872,14224,10965,-3259
2018,4,22,20,14010,14226,11013,-3213
2018,4,22,21,14358,14495,11301,-3194
2018,4,22,22,14720,14924,11793,-3131
2018,4,22,23,15047,15256,12026,-3230
2018,4,23,0,15490,15674,12562,-3112
2018,4,23,1,16194,16334,13031,-3303
2018,4,23,2,15815,15922,12752,-3170
2018,4,23,3,14949,15025,11943,-3082
2018,4,23,4,14035,13993,10633,-3360
2018,4,23,5,13056,13281,9285,-3996
2018,4,23,6,12676,12917,8868,-4049
2018,4,23,7,12487,12757,8974,-3783
2018,4,23,8,12473,12762,9098,-3664
2018,4,23,9,12763,13079,9395,-3684
2018,4,23,10,13639,14110,10637,-3473
2018,4,23,11,14959,15662,12636,-3026
2018,4,23,12,15936,16733,13442,-3291
2018,4,23,13,16221,16914,13321,-3593
2018,4,23,14,16208,16900,13267,-3633
2018,4,23,15,16056,16886,13060,-3826
2018,4,23,16,15880,16783,13038,-3745
2018,4,23,17,15745,16636,12735,-3901
2018,4,23,18,15734,16557,12680,-3877
2018,4,23,19,15736,16475,12609,-3866
2018,4,23,20,15839,16432,12564,-3868
2018,4,23,21,16090,16562,12740,-3822
2018,4,23,22,16279,16749,12929,-3820
2018,4,23,23,16398,16803,13188,-3615
2018,4,24,0,16653,17034,13581,-3453
2018,4,24,1,17101,17413,13933,-3480
2018,4,24,2,16489,16723,13686,-3037
2018,4,24,3,15328,15453,12971,-2482
2018,4,24,4,14146,14180,11265,-2915
2018,4,24,5,13225,13292,10053,-3239
2018,4,24,6,12731,12828,10329,-2499
2018,4,24,7,12460,12585,10104,-2481
2018,4,24,8,12387,12541,10053,-2488
2018,4,24,9,12631,12802,10433,-2369
2018,4,24,10,13470,13767,11441,-2326
2018,4,24,11,14862,15199,12703,-2496
2018,4,24,12,15945,16258,13487,-2771
2018,4,24,13,16339,16579,13888,-2691
2018,4,24,14,16408,16619,14079,-2540
2018,4,24,15,16353,16696,14196,-2500
2018,4,24,16,16306,16627,14140,-2487
2018,4,24,17,16269,16566,13793,-2773
2018,4,24,18,16334,16546,13373,-3173
2018,4,24,19,16350,16519,13031,-3488
2018,4,24,20,16426,16626,13243,-3383
2018,4,24,21,16618,16742,13351,-3391
2018,4,24,22,16736,16948,13570,-3378
2018,4,24,23,16766,17032,13788,-3244
2018,4,25,0,16877,17249,14292,-2957
2018,4,25,1,17175,17358,14544,-2814
2018,4,25,2,16542,16573,13688,-2885
2018,4,25,3,15336,15299,12437,-2862
2018,4,25,4,14119,14042,10534,-3508
2018,4,25,5,13150,13210,9915,-3295
2018,4,25,6,12635,12787,9809,-2978
2018,4,25,7,12341,12493,9743,-2750
2018,4,25,8,12239,12359,9538,-2821
2018,4,25,9,12454,12575,9820,-2755
2018,4,25,10,13272,13442,10700,-2742
2018,4,25,11,14749,14985,12212,-2773
2018,4,25,12,16018,16362,13538,-2824
2018,4,25,13,16648,17104,13794,-3310
2018,4,25,14,16967,17527,14211,-3316
2018,4,25,15,17093,17770,14504,-3266
2018,4,25,16,17080,17817,14504,-3313
2018,4,25,17,16992,17747,14608,-3139
2018,4,25,18,16977,17674,14392,-3282
2018,4,25,19,16898,17578,14273,-3305
2018,4,25,20,16920,17556,14377,-3179
2018,4,25,21,17081,17687,14446,-3241
2018,4,25,22,17104,17807,14591,-3216
2018,4,25,23,17037,17685,14383,-3302
2018,4,26,0,17077,17701,14205,-3496
2018,4,26,1,17355,17677,14227,-3450
2018,4,26,2,16702,16863,13579,-3284
2018,4,26,3,15484,15671,12125,-3546
2018,4,26,4,14231,14410,10808,-3602
2018,4,26,5,13079,13526,10131,-3395
2018,4,26,6,12557,13053,10132,-2921
2018,4,26,7,12271,12740,9832,-2908
2018,4,26,8,12178,12661,10186,-2475
2018,4,26,9,12392,12875,10626,-2249
2018,4,26,10,13191,13763,11074,-2689
2018,4,26,11,14590,15327,12926,-2401
2018,4,26,12,15772,16498,13604,-2894
2018,4,26,13,16262,17009,14037,-2972
2018,4,26,14,16399,17153,14219,-2934
2018,4,26,15,16357,17151,14210,-2941
2018,4,26,16,16220,17090,14128,-2962
2018,4,26,17,16092,16997,14139,-2858
2018,4,26,18,16069,16951,14078,-2873
2018,4,26,19,16013,16975,14096,-2879
2018,4,26,20,16085,16914,13666,-3248
2018,4,26,21,16318,17030,13705,-3325
2018,4,26,22,16441,17146,13799,-3347
2018,4,26,23,16471,17117,13968,-3149
2018,4,27,0,16604,17184,13900,-3284
2018,4,27,1,17015,17617,14094,-3523
2018,4,27,2,16426,16958,13623,-3335
2018,4,27,3,15249,15755,12510,-3245
2018,4,27,4,14054,14498,10964,-3534
2018,4,27,5,13162,13651,10367,-3284
2018,4,27,6,12646,13138,9925,-3213
2018,4,27,7,12358,12812,9547,-3265
2018,4,27,8,12265,12708,9434,-3274
2018,4,27,9,12475,12946,9912,-3034
2018,4,27,10,13240,13746,10577,-3169
2018,4,27,11,14589,15149,11967,-3182
2018,4,27,12,15738,16402,13078,-3324
2018,4,27,13,16300,17087,13408,-3679
2018,4,27,14,16543,17531,13733,-3798
2018,4,27,15,16636,17663,13385,-4278
2018,4,27,16,16599,17778,13707,-4071
2018,4,27,17,16513,17641,13369,-4272
2018,4,27,18,16496,17571,13347,-4224
2018,4,27,19,16428,17407,13257,-4150
2018,4,27,20,16424,17301,13205,-4096
2018,4,27,21,16520,17292,13197,-4095
2018,4,27,22,16468,17221,13264,-3957
2018,4,27,23,16318,17107,13130,-3977
2018,4,28,0,16259,17058,13350,-3708
2018,4,28,1,16507,17106,13601,-3505
2018,4,28,2,16011,16561,13182,-3379
2018,4,28,3,15065,15627,12644,-2983
2018,4,28,4,14041,14519,11358,-3161
2018,4,28,5,13166,13659,11008,-2651
2018,4,28,6,12589,13123,10607,-2516
2018,4,28,7,12243,12734,9918,-2816
2018,4,28,8,12060,12552,9796,-2756
2018,4,28,9,12107,12597,9888,-2709
2018,4,28,10,12369,12936,10293,-2643
2018,4,28,11,12668,13367,10622,-2745
2018,4,28,12,13264,14149,11435,-2714
2018,4,28,13,14052,14924,12176,-2748
2018,4,28,14,14492,15302,12282,-3020
2018,4,28,15,14636,15416,12009,-3407
2018,4,28,16,14560,15327,11910,-3417
2018,4,28,17,14413,15248,11870,-3378
2018,4,28,18,14255,15147,11804,-3343
2018,4,28,19,14169,15050,11621,-3429
2018,4,28,20,14235,15065,11660,-3405
2018,4,28,21,14456,15221,11795,-3426
2018,4,28,22,14662,15477,12157,-3320
2018,4,28,23,14852,15685,12400,-3285
2018,4,29,0,15062,15938,12922,-3016
2018,4,29,1,15602,16228,13528,-2700
2018,4,29,2,15330,15781,13200,-2581
2018,4,29,3,14559,15040,12350,-2690
2018,4,29,4,13716,14145,11254,-2891
2018,4,29,5,13075,13390,10217,-3173
2018,4,29,6,12548,12844,9771,-3073
2018,4,29,7,12209,12517,9693,-2824
2018,4,29,8,12033,12329,9627,-2702
2018,4,29,9,12051,12323,9749,-2574
2018,4,29,10,12202,12534,9989,-2545
2018,4,29,11,12329,12875,10134,-2741
2018,4,29,12,12761,13507,10858,-2649
2018,4,29,13,13520,14358,11378,-2980
2018,4,29,14,14160,15057,11885,-3172
2018,4,29,15,14424,15406,11905,-3501
2018,4,29,16,14492,15433,11872,-3561
2018,4,29,17,14481,15376,11870,-3506
2018,4,29,18,14407,15273,11863,-3410
2018,4,29,19,14366,15187,12069,-3118
2018,4,29,20,14480,15240,12222,-3018
2018,4,29,21,14759,15426,12276,-3150
2018,4,29,22,15009,15778,12667,-3111
2018,4,29,23,15232,16114,13207,-2907
2018,4,30,0,15519,16409,13652,-2757
2018,4,30,1,16137,16825,14380,-2445
2018,4,30,2,15779,16271,13886,-2385
2018,4,30,3,14854,15354,12968,-2386
2018,4,30,4,13856,14294,11368,-2926
2018,4,30,5,13054,13541,10590,-2951
2018,4,30,6,12668,13102,10312,-2790
2018,4,30,7,12472,12874,10331,-2543
2018,4,30,8,12444,12822,10502,-2320
2018,4,30,9,12722,13114,10692,-2422
2018,4,30,10,13552,14009,11479,-2530
2018,4,30,11,14920,15590,13137,-2453
2018,4,30,12,16124,16785,14369,-2416
2018,4,30,13,16677,17242,14402,-2840
2018,4,30,14,16843,17439,14221,-3218
2018,4,30,15,16825,17555,14269,-3286
2018,4,30,16,16682,17563,14016,-3547
2018,4,30,17,16514,17398,13981,-3417
2018,4,30,18,16434,17281,13837,-3444
2018,4,30,19,16307,17144,13453,-3691
2018,4,30,20,16288,17126,13806,-3320
2018,4,30,21,16448,17187,14015,-3172
2018,4,30,22,16584,17337,14349,-2988
2018,4,30,23,16646,17418,14553,-2865
2018,5,1,0,16754,17527,14393,-3134
2018,5,1,1,17142,17771,14544,-3227
2018,5,1,2,16542,17084,14032,-3052
2018,5,1,3,15347,15796,12756,-3040
2018,5,1,4,14141,14565,11457,-3108
2018,5,1,5,13260,13728,11132,-2596
2018,5,1,6,12782,13198,10698,-2500
2018,5,1,7,12513,12908,10539,-2369
2018,5,1,8,12424,12819,10488,-2331
2018,5,1,9,12633,13068,10872,-2196
2018,5,1,10,13425,13936,11343,-2593
2018,5,1,11,14643,15380,12787,-2593
2018,5,1,12,15650,16409,14030,-2379
2018,5,1,13,15980,16587,14084,-2503
2018,5,1,14,16056,16575,14059,-2516
2018,5,1,15,16047,16561,13903,-2658
2018,5,1,16,16033,16551,13896,-2655
2018,5,1,17,16023,16525,13826,-2699
2018,5,1,18,16130,16604,14067,-2537
2018,5,1,19,16246,16655,14094,-2561
2018,5,1,20,16412,16852,14059,-2793
2018,5,1,21,16676,17122,14086,-3036
2018,5,1,22,16805,17268,14222,-3046
2018,5,1,23,16744,17169,14250,-2919
2018,5,2,0,16755,17200,14263,-2937
2018,5,2,1,17021,17520,14595,-2925
2018,5,2,2,16534,16918,14291,-2627
2018,5,2,3,15349,15591,13009,-2582
2018,5,2,4,14124,14257,12101,-2156
2018,5,2,5,13183,13351,11392,-1959
2018,5,2,6,12662,12780,11016,-1764
2018,5,2,7,12362,12436,10827,-1609
2018,5,2,8,12259,12319,10502,-1817
2018,5,2,9,12429,12494,10984,-1510
2018,5,2,10,13159,13275,11652,-1623
2018,5,2,11,14315,14624,12838,-1786
2018,5,2,12,15390,15873,14032,-1841
2018,5,2,13,15870,16516,15109,-1407
2018,5,2,14,16146,16969,15194,-1775
2018,5,2,15,16335,17305,15037,-2268
2018,5,2,16,16490,17576,15031,-2545
2018,5,2,17,16633,17838,15096,-2742
2018,5,2,18,16903,18236,15784,-2452
2018,5,2,19,17170,18638,16064,-2574
2018,5,2,20,17504,18962,16058,-2904
2018,5,2,21,17875,19196,16235,-2961
2018,5,2,22,17963,19333,16468,-2865
2018,5,2,23,17769,19121,16832,-2289
2018,5,3,0,17655,18993,16787,-2206
2018,5,3,1,17777,19210,17392,-1818
2018,5,3,2,17334,18471,16682,-1789
2018,5,3,3,16153,17091,15168,-1923
2018,5,3,4,14895,15632,13252,-2380
2018,5,3,5,14127,14506,12107,-2399
2018,5,3,6,13455,13790,11545,-2245
2018,5,3,7,13044,13336,11268,-2068
2018,5,3,8,12861,13141,11289,-1852
2018,5,3,9,13002,13251,11341,-1910
2018,5,3,10,13810,14005,12136,-1869
2018,5,3,11,15199,15454,13378,-2076
2018,5,3,12,16606,16888,14587,-2301
2018,5,3,13,17383,17827,15484,-2343
2018,5,3,14,17933,18667,16566,-2101
2018,5,3,15,18271,19356,17059,-2297
2018,5,3,16,18509,19903,17352,-2551
2018,5,3,17,18728,20410,17854,-2556
2018,5,3,18,19017,20829,18568,-2261
2018,5,3,19,19239,21171,19165,-2006
2018,5,3,20,19486,21457,19574,-1883
2018,5,3,21,19749,21743,19790,-1953
2018,5,3,22,19711,21753,19712,-2041
2018,5,3,23,19321,21294,19547,-1747
2018,5,4,0,19025,20894,18921,-1973
2018,5,4,1,19058,20837,18966,-1871
2018,5,4,2,18530,20086,17672,-2414
2018,5,4,3,17208,18593,16482,-2111
2018,5,4,4,15786,17095,14391,-2704
2018,5,4,5,14860,15919,12961,-2958
2018,5,4,6,14113,15127,12360,-2767
2018,5,4,7,13631,14579,11810,-2769
2018,5,4,8,13389,14342,11618,-2724
2018,5,4,9,13489,14462,11683,-2779
2018,5,4,10,14216,15221,12200,-3021
2018,5,4,11,15552,16636,13429,-3207
2018,5,4,12,16922,18191,15184,-3007
2018,5,4,13,17759,19192,15932,-3260
2018,5,4,14,18325,19741,16602,-3139
2018,5,4,15,18680,20040,17091,-2949
2018,5,4,16,18920,20342,17418,-2924
2018,5,4,17,19108,20345,17844,-2501
2018,5,4,18,19340,20476,18058,-2418
2018,5,4,19,19499,20762,18320,-2442
2018,5,4,20,19652,21056,18577,-2479
2018,5,4,21,19734,21058,18821,-2237
2018,5,4,22,19533,20662,18619,-2043
2018,5,4,23,19016,20055,18078,-1977
2018,5,5,0,18583,19649,18012,-1637
2018,5,5,1,18533,19491,17743,-1748
2018,5,5,2,18056,18874,17170,-1704
2018,5,5,3,16955,17791,15883,-1908
2018,5,5,4,15685,16480,14423,-2057
2018,5,5,5,14325,15144,12515,-2629
2018,5,5,6,13579,14367,11822,-2545
2018,5,5,7,13098,13728,11456,-2272
2018,5,5,8,12826,13373,11195,-2178
2018,5,5,9,12772,13183,11194,-1989
2018,5,5,10,12956,13257,11267,-1990
2018,5,5,11,13187,13496,11531,-1965
2018,5,5,12,13765,14171,11607,-2564
2018,5,5,13,14512,14951,12171,-2780
2018,5,5,14,15033,15422,12561,-2861
2018,5,5,15,15286,15723,12687,-3036
2018,5,5,16,15368,15929,12883,-3046
2018,5,5,17,15380,16043,12957,-3086
2018,5,5,18,15370,16066,13173,-2893
2018,5,5,19,15418,16209,13482,-2727
2018,5,5,20,15550,16305,13493,-2812
2018,5,5,21,15742,16385,13680,-2705
2018,5,5,22,15828,16406,13773,-2633
2018,5,5,23,15772,16305,13496,-2809
2018,5,6,0,15682,16290,13343,-2947
2018,5,6,1,15903,16603,13352,-3251
2018,5,6,2,15682,16298,13245,-3053
2018,5,6,3,14853,15504,12423,-3081
2018,5,6,4,13930,14590,11560,-3030
2018,5,6,5,13323,13748,10708,-3040
2018,5,6,6,12758,13167,10222,-2945
2018,5,6,7,12374,12748,9761,-2987
2018,5,6,8,12149,12478,9591,-2887
2018,5,6,9,12094,12362,9664,-2698
2018,5,6,10,12185,12490,9776,-2714
2018,5,6,11,12236,12649,9848,-2801
2018,5,6,12,12704,13245,10283,-2962
2018,5,6,13,13425,14136,10693,-3443
2018,5,6,14,14036,14859,11395,-3464
2018,5,6,15,14379,15302,11688,-3614
2018,5,6,16,14552,15533,12317,-3216
2018,5,6,17,14658,15572,12188,-3384
2018,5,6,18,14695,15568,12426,-3142
2018,5,6,19,14697,15518,12345,-3173
2018,5,6,20,14783,15569,12356,-3213
2018,5,6,21,14999,15752,12519,-3233
2018,5,6,22,15182,15980,12782,-3198
2018,5,6,23,15302,16125,12898,-3227
2018,5,7,0,15394,16231,12955,-3276
2018,5,7,1,15751,16408,13164,-3244
2018,5,7,2,15532,15861,12772,-3089
2018,5,7,3,14649,14865,11672,-3193
2018,5,7,4,13680,13801,10602,-3199
2018,5,7,5,12682,13058,9482,-3576
2018,5,7,6,12252,12583,9237,-3346
2018,5,7,7,12006,12316,9214,-3102
2018,5,7,8,11944,12216,9470,-2746
2018,5,7,9,12170,12479,9954,-2525
2018,5,7,10,12943,13360,10911,-2449
2018,5,7,11,14234,14801,12665,-2136
2018,5,7,12,15433,16129,14126,-2003
2018,5,7,13,15967,16771,14670,-2101
2018,5,7,14,16186,17085,14407,-2678
2018,5,7,15,16244,17287,14573,-2714
2018,5,7,16,16184,17464,14499,-2965
2018,5,7,17,16111,17510,14518,-2992
2018,5,7,18,16130,17571,14743,-2828
2018,5,7,19,16145,17694,14965,-2729
2018,5,7,20,16237,17799,14869,-2930
2018,5,7,21,16433,17837,15111,-2726
2018,5,7,22,16572,17819,15199,-2620
2018,5,7,23,16548,17636,15454,-2182
2018,5,8,0,16568,17490,15827,-1663
2018,5,8,1,16836,17659,15759,-1900
2018,5,8,2,16382,17053,15110,-1943
2018,5,8,3,15197,15731,13733,-1998
2018,5,8,4,13952,14381,12240,-2141
2018,5,8,5,12921,13408,10977,-2431
2018,5,8,6,12402,12853,10653,-2200
2018,5,8,7,12117,12495,10516,-1979
2018,5,8,8,12034,12379,10433,-1946
2018,5,8,9,12244,12573,10796,-1777
2018,5,8,10,12999,13382,11470,-1912
2018,5,8,11,14247,14785,12844,-1941
2018,5,8,12,15367,16063,13895,-2168
2018,5,8,13,15791,16596,14184,-2412
2018,5,8,14,15899,16887,14207,-2680
2018,5,8,15,15935,17148,14239,-2909
2018,5,8,16,15944,17342,14178,-3164
2018,5,8,17,15970,17445,14040,-3405
2018,5,8,18,16095,17599,14265,-3334
2018,5,8,19,16208,17709,14450,-3259
2018,5,8,20,16379,17867,14866,-3001
2018,5,8,21,16631,18040,15170,-2870
2018,5,8,22,16729,18165,15378,-2787
2018,5,8,23,16633,17926,15171,-2755
2018,5,9,0,16590,17677,15161,-2516
2018,5,9,1,16859,17773,14940,-2833
2018,5,9,2,16380,17179,14481,-2698
2018,5,9,3,15158,15841,13191,-2650
2018,5,9,4,13901,14486,11715,-2771
2018,5,9,5,12939,13515,10762,-2753
2018,5,9,6,12379,12898,10428,-2470
2018,5,9,7,12053,12608,10548,-2060
2018,5,9,8,11936,12482,10472,-2010
2018,5,9,9,12108,12688,10651,-2037
2018,5,9,10,12821,13413,11309,-2104
2018,5,9,11,14050,14754,12406,-2348
2018,5,9,12,15204,16051,13519,-2532
2018,5,9,13,15698,16697,13702,-2995
2018,5,9,14,15889,17144,13967,-3177
2018,5,9,15,16026,17441,13988,-3453
2018,5,9,16,16127,17750,14231,-3519
2018,5,9,17,16235,17935,14722,-3213
2018,5,9,18,16453,18048,14954,-3094
2018,5,9,19,16646,18147,14986,-3161
2018,5,9,20,16891,18384,14875,-3509
2018,5,9,21,17174,18589,15014,-3575
2018,5,9,22,17217,18675,15303,-3372
2018,5,9,23,16997,18408,15156,-3252
2018,5,10,0,16843,18088,15042,-3046
2018,5,10,1,17033,18158,14942,-3216
2018,5,10,2,16580,17581,14433,-3148
2018,5,10,3,15337,16265,13467,-2798
2018,5,10,4,14030,14845,12287,-2558
2018,5,10,5,13033,13811,11326,-2485
2018,5,10,6,12448,13174,10688,-2486
2018,5,10,7,12121,12842,10607,-2235
2018,5,10,8,11996,12689,10586,-2103
2018,5,10,9,12165,12814,10758,-2056
2018,5,10,10,12880,13505,11435,-2070
2018,5,10,11,14164,14853,12466,-2387
2018,5,10,12,15423,16179,13582,-2597
2018,5,10,13,16035,16793,13911,-2882
2018,5,10,14,16353,17311,14419,-2892
2018,5,10,15,16572,17593,14550,-3043
2018,5,10,16,16710,17741,14721,-3020
2018,5,10,17,16821,17765,14668,-3097
2018,5,10,18,17001,17790,14650,-3140
2018,5,10,19,17093,17690,14799,-2891
2018,5,10,20,17202,17573,14702,-2871
2018,5,10,21,17360,17676,14909,-2767
2018,5,10,22,17332,17837,15063,-2774
2018,5,10,23,17071,17652,14822,-2830
2018,5,11,0,16869,17572,14867,-2705
2018,5,11,1,16998,17610,14657,-2953
2018,5,11,2,16531,16988,13950,-3038
2018,5,11,3,15295,15776,12567,-3209
2018,5,11,4,14022,14519,11642,-2877
2018,5,11,5,13297,13574,10878,-2696
2018,5,11,6,12745,12987,10419,-2568
2018,5,11,7,12407,12619,10191,-2428
2018,5,11,8,12278,12471,9950,-2521
2018,5,11,9,12429,12628,10048,-2580
2018,5,11,10,13092,13315,10913,-2402
2018,5,11,11,14280,14719,12081,-2638
2018,5,11,12,15440,16042,13264,-2778
2018,5,11,13,15957,16607,13639,-2968
2018,5,11,14,16106,16861,13933,-2928
2018,5,11,15,16143,16915,13880,-3035
2018,5,11,16,16137,16871,13772,-3099
2018,5,11,17,16110,16819,13843,-2976
2018,5,11,18,16187,16904,14015,-2889
2018,5,11,19,16300,17020,14021,-2999
2018,5,11,20,16475,17144,14094,-3050
2018,5,11,21,16671,17236,14102,-3134
2018,5,11,22,16668,17321,14499,-2822
2018,5,11,23,16462,17108,14362,-2746
2018,5,12,0,16282,16958,14329,-2629
2018,5,12,1,16422,17120,14363,-2757
2018,5,12,2,16102,16627,13698,-2929
2018,5,12,3,15147,15661,12616,-3045
2018,5,12,4,14090,14514,11507,-3007
2018,5,12,5,13107,13601,10333,-3268
2018,5,12,6,12552,12988,9692,-3296
2018,5,12,7,12212,12583,9576,-3007
2018,5,12,8,12038,12344,9081,-3263
2018,5,12,9,12061,12305,9336,-2969
2018,5,12,10,12255,12500,9312,-3188
2018,5,12,11,12546,12947,9891,-3056
2018,5,12,12,13216,13792,11107,-2685
2018,5,12,13,14014,14811,12094,-2717
2018,5,12,14,14497,15482,12529,-2953
2018,5,12,15,14777,15919,12890,-3029
2018,5,12,16,14832,16015,13461,-2554
2018,5,12,17,14784,15971,13363,-2608
2018,5,12,18,14674,15850,12854,-2996
2018,5,12,19,14627,15708,12644,-3064
2018,5,12,20,14667,15618,12562,-3056
2018,5,12,21,14835,15620,12573,-3047
2018,5,12,22,14941,15810,12856,-2954
2018,5,12,23,14988,15906,12620,-3286
2018,5,13,0,14993,15906,12398,-3508
2018,5,13,1,15318,16066,12529,-3537
2018,5,13,2,15184,15748,12448,-3300
2018,5,13,3,14461,14963,11952,-3011
2018,5,13,4,13622,14028,10929,-3099
2018,5,13,5,12723,13235,9421,-3814
2018,5,13,6,12205,12681,8894,-3787
2018,5,13,7,11884,12294,8941,-3353
2018,5,13,8,11719,12108,8889,-3219
2018,5,13,9,11723,12077,8968,-3109
2018,5,13,10,11846,12203,8974,-3229
2018,5,13,11,11954,12443,8969,-3474
2018,5,13,12,12429,13111,10116,-2995
2018,5,13,13,13047,13944,10914,-3030
2018,5,13,14,13474,14618,11729,-2889
2018,5,13,15,13686,14921,11710,-3211
2018,5,13,16,13758,15049,11720,-3329
2018,5,13,17,13776,15105,11765,-3340
2018,5,13,18,13768,15039,11477,-3562
2018,5,13,19,13784,14973,11431,-3542
2018,5,13,20,13921,14989,11471,-3518
2018,5,13,21,14216,15153,11894,-3259
2018,5,13,22,14496,15384,12134,-3250
2018,5,13,23,14690,15512,12526,-2986
2018,5,14,0,14830,15756,12741,-3015
2018,5,14,1,15252,16110,12794,-3316
2018,5,14,2,15061,15776,12921,-2855
2018,5,14,3,14188,14774,12187,-2587
2018,5,14,4,13247,13736,10929,-2807
2018,5,14,5,12641,12961,9823,-3138
2018,5,14,6,12184,12498,9227,-3271
2018,5,14,7,11930,12256,9221,-3035
2018,5,14,8,11855,12172,9349,-2823
2018,5,14,9,12082,12368,9717,-2651
2018,5,14,10,12843,13076,10690,-2386
2018,5,14,11,14185,14584,12308,-2276
2018,5,14,12,15538,15985,13686,-2299
2018,5,14,13,16224,16711,14625,-2086
2018,5,14,14,16529,17107,15095,-2012
2018,5,14,15,16731,17218,15249,-1969
2018,5,14,16,16750,17317,14851,-2466
2018,5,14,17,16718,17401,14020,-3381
2018,5,14,18,16787,17414,13977,-3437
2018,5,14,19,16854,17425,14219,-3206
2018,5,14,20,17013,17556,14268,-3288
2018,5,14,21,17246,17839,14495,-3344
2018,5,14,22,17309,18028,14652,-3376
2018,5,14,23,17149,17863,14445,-3418
2018,5,15,0,17031,17670,14409,-3261
2018,5,15,1,17235,17860,14493,-3367
2018,5,15,2,16748,17327,14307,-3020
2018,5,15,3,15467,15982,13217,-2765
2018,5,15,4,14146,14656,12099,-2557
2018,5,15,5,13405,13650,10636,-3014
2018,5,15,6,12827,13063,10003,-3060
2018,5,15,7,12475,12695,9718,-2977
2018,5,15,8,12345,12582,9732,-2850
2018,5,15,9,12526,12762,9786,-2976
2018,5,15,10,13269,13530,10430,-3100
2018,5,15,11,14673,15004,12015,-2989
2018,5,15,12,16179,16563,13364,-3199
2018,5,15,13,17008,17476,14235,-3241
2018,5,15,14,17422,18031,14730,-3301
2018,5,15,15,17693,18384,14992,-3392
2018,5,15,16,17858,18746,15559,-3187
2018,5,15,17,17987,19086,15922,-3164
2018,5,15,18,18208,19587,16472,-3115
2018,5,15,19,18442,19966,16631,-3335
2018,5,15,20,18730,20399,17160,-3239
2018,5,15,21,19031,20490,18056,-2434
2018,5,15,22,19044,19858,18348,-1510
2018,5,15,23,18732,19187,17469,-1718
2018,5,16,0,18473,18722,16393,-2329
2018,5,16,1,18563,18459,16035,-2424
2018,5,16,2,18061,17874,14921,-2953
2018,5,16,3,16752,16536,13630,-2906
2018,5,16,4,15320,15109,12327,-2782
2018,5,16,5,13683,14022,11703,-2319
2018,5,16,6,13056,13342,11198,-2144
2018,5,16,7,12698,12950,10969,-1981
2018,5,16,8,12557,12736,10480,-2256
2018,5,16,9,12720,12878,10833,-2045
2018,5,16,10,13427,13581,11344,-2237
2018,5,16,11,14794,15007,12697,-2310
2018,5,16,12,16158,16397,13991,-2406
2018,5,16,13,16851,17093,14137,-2956
2018,5,16,14,17159,17496,14237,-3259
2018,5,16,15,17364,17776,14522,-3254
2018,5,16,16,17399,17897,14575,-3322
2018,5,16,17,17383,17907,15174,-2733
2018,5,16,18,17435,18006,15481,-2525
2018,5,16,19,17396,18028,15651,-2377
2018,5,16,20,17403,18049,15471,-2578
2018,5,16,21,17467,18083,15456,-2627
2018,5,16,22,17378,18104,15394,-2710
2018,5,16,23,17104,17829,15043,-2786
2018,5,17,0,16886,17663,14944,-2719
2018,5,17,1,17037,17635,15212,-2423
2018,5,17,2,16527,17018,14723,-2295
2018,5,17,3,15245,15779,13526,-2253
2018,5,17,4,13956,14508,12217,-2291
2018,5,17,5,13178,13570,11137,-2433
2018,5,17,6,12643,12986,10529,-2457
2018,5,17,7,12317,12626,10323,-2303
2018,5,17,8,12189,12534,10356,-2178
2018,5,17,9,12352,12677,10496,-2181
2018,5,17,10,13049,13397,11265,-2132
2018,5,17,11,14407,14800,12248,-2552
2018,5,17,12,15797,16210,13643,-2567
2018,5,17,13,16516,16972,14059,-2913
2018,5,17,14,16832,17462,14052,-3410
2018,5,17,15,17081,17812,14362,-3450
2018,5,17,16,17172,17960,14386,-3574
2018,5,17,17,17219,18012,14421,-3591
2018,5,17,18,17356,18204,14457,-3747
2018,5,17,19,17451,18214,14795,-3419
2018,5,17,20,17595,18379,14709,-3670
2018,5,17,21,17785,18616,14674,-3942
2018,5,17,22,17791,18688,14837,-3851
2018,5,17,23,17564,18504,15043,-3461
2018,5,18,0,17365,18259,15094,-3165
2018,5,18,1,17519,18279,15210,-3069
2018,5,18,2,17053,17808,14719,-3089
2018,5,18,3,15790,16519,13564,-2955
2018,5,18,4,14446,15100,12298,-2802
2018,5,18,5,13203,14056,11558,-2498
2018,5,18,6,12644,13370,11059,-2311
2018,5,18,7,12319,12977,10751,-2226
2018,5,18,8,12190,12837,10420,-2417
2018,5,18,9,12338,12965,10581,-2384
2018,5,18,10,12953,13630,11372,-2258
2018,5,18,11,14163,14972,12670,-2302
2018,5,18,12,15405,16270,13705,-2565
2018,5,18,13,16049,16915,13758,-3157
2018,5,18,14,16303,17245,13732,-3513
2018,5,18,15,16455,17363,13713,-3650
2018,5,18,16,16475,17375,14012,-3363
2018,5,18,17,16442,17317,13936,-3381
2018,5,18,18,16486,17311,13974,-3337
2018,5,18,19,16480,17261,13838,-3423
2018,5,18,20,16508,17247,13935,-3312
2018,5,18,21,16572,17264,14012,-3252
2018,5,18,22,16497,17248,13981,-3267
2018,5,18,23,16289,17000,13620,-3380
2018,5,19,0,16089,16819,13608,-3211
2018,5,19,1,16208,16912,13744,-3168
2018,5,19,2,15877,16549,13298,-3251
2018,5,19,3,14956,15510,12344,-3166
2018,5,19,4,13921,14396,11442,-2954
2018,5,19,5,13038,13483,10814,-2669
2018,5,19,6,12511,12863,10521,-2342
2018,5,19,7,12183,12479,10080,-2399
2018,5,19,8,12006,12301,9926,-2375
2018,5,19,9,12010,12309,9870,-2439
2018,5,19,10,12168,12529,10199,-2330
2018,5,19,11,12447,12990,10748,-2242
2018,5,19,12,13114,13846,11287,-2559
2018,5,19,13,13912,14823,11985,-2838
2018,5,19,14,14399,15641,12569,-3072
2018,5,19,15,14780,16138,13006,-3132
2018,5,19,16,14922,16339,13143,-3196
2018,5,19,17,14956,16379,13313,-3066
2018,5,19,18,14941,16334,13320,-3014
2018,5,19,19,14934,16198,13300,-2898
2018,5,19,20,15008,16047,13338,-2709
2018,5,19,21,15161,16050,13396,-2654
2018,5,19,22,15222,16223,13464,-2759
2018,5,19,23,15246,16270,13526,-2744
2018,5,20,0,15192,16255,13725,-2530
2018,5,20,1,15467,16362,13853,-2509
2018,5,20,2,15348,15981,13608,-2373
2018,5,20,3,14653,15209,13016,-2193
2018,5,20,4,13865,14328,12252,-2076
2018,5,20,5,13453,13503,11378,-2125
2018,5,20,6,12824,12914,10821,-2093
2018,5,20,7,12383,12558,10453,-2105
2018,5,20,8,12154,12405,10496,-1909
2018,5,20,9,12128,12328,10259,-2069
2018,5,20,10,12237,12436,10392,-2044
2018,5,20,11,12393,12638,10219,-2419
2018,5,20,12,13062,13294,10621,-2673
2018,5,20,13,13969,14242,11189,-3053
2018,5,20,14,14643,15042,11651,-3391
2018,5,20,15,15149,15650,12628,-3022
2018,5,20,16,15472,16153,13223,-2930
2018,5,20,17,15678,16448,13217,-3231
2018,5,20,18,15846,16701,13130,-3571
2018,5,20,19,16019,16881,13273,-3608
2018,5,20,20,16285,17078,13519,-3559
2018,5,20,21,16682,17384,13674,-3710
2018,5,20,22,16947,17686,14229,-3457
2018,5,20,23,17034,17647,14419,-3228
2018,5,21,0,17099,17452,14302,-3150
2018,5,21,1,17579,17583,14243,-3340
2018,5,21,2,17397,17260,14035,-3225
2018,5,21,3,16341,16172,12883,-3289
2018,5,21,4,15087,14869,12088,-2781
2018,5,21,5,12945,13884,10993,-2891
2018,5,21,6,12478,13257,10643,-2614
2018,5,21,7,12220,12876,10491,-2385
2018,5,21,8,12145,12688,10753,-1935
2018,5,21,9,12357,12815,10538,-2277
2018,5,21,10,13080,13541,10991,-2550
2018,5,21,11,14374,14986,12045,-2941
2018,5,21,12,15682,16314,13076,-3238
2018,5,21,13,16312,16987,13716,-3271
2018,5,21,14,16564,17353,14005,-3348
2018,5,21,15,16794,17634,14282,-3352
2018,5,21,16,16936,17917,14618,-3299
2018,5,21,17,17047,18095,14704,-3391
2018,5,21,18,17305,18312,14703,-3609
2018,5,21,19,17508,18529,14899,-3630
2018,5,21,20,17732,18808,15252,-3556
2018,5,21,21,17984,19134,15276,-3858
2018,5,21,22,17976,19255,15751,-3504
2018,5,21,23,17740,18936,15465,-3471
2018,5,22,0,17581,18525,15294,-3231
2018,5,22,1,17746,18445,15064,-3381
2018,5,22,2,17234,17803,14554,-3249
2018,5,22,3,15895,16496,13787,-2709
2018,5,22,4,14504,15072,12515,-2557
2018,5,22,5,13376,14004,11592,-2412
2018,5,22,6,12826,13373,11163,-2210
2018,5,22,7,12502,12971,10803,-2168
2018,5,22,8,12381,12808,10622,-2186
2018,5,22,9,12558,12942,10797,-2145
2018,5,22,10,13214,13678,12019,-1659
2018,5,22,11,14529,15155,13364,-1791
2018,5,22,12,15828,16583,14118,-2465
2018,5,22,13,16497,17438,14872,-2566
2018,5,22,14,16782,17897,15060,-2837
2018,5,22,15,17041,18194,15525,-2669
2018,5,22,16,17203,18350,15436,-2914
2018,5,22,17,17302,18332,15560,-2772
2018,5,22,18,17447,18405,15783,-2622
2018,5,22,19,17483,18348,15781,-2567
2018,5,22,20,17514,18293,15639,-2654
2018,5,22,21,17578,18315,15471,-2844
2018,5,22,22,17444,18266,15496,-2770
2018,5,22,23,17177,18030,15129,-2901
2018,5,23,0,17000,17813,15011,-2802
2018,5,23,1,17177,17684,14758,-2926
2018,5,23,2,16665,17130,14234,-2896
2018,5,23,3,15408,15889,13215,-2674
2018,5,23,4,14165,14594,12272,-2322
2018,5,23,5,13528,13703,11660,-2043
2018,5,23,6,12952,13154,11081,-2073
2018,5,23,7,12580,12816,11078,-1738
2018,5,23,8,12439,12695,10690,-2005
2018,5,23,9,12621,12838,11009,-1829
2018,5,23,10,13350,13531,11656,-1875
2018,5,23,11,14827,14962,13232,-1730
2018,5,23,12,16262,16422,14416,-2006
2018,5,23,13,16969,17210,14895,-2315
2018,5,23,14,17202,17721,15222,-2499
2018,5,23,15,17415,18059,15449,-2610
2018,5,23,16,17566,18284,15585,-2699
2018,5,23,17,17671,18414,15973,-2441
2018,5,23,18,17944,18684,15992,-2692
2018,5,23,19,18227,19002,15981,-3021
2018,5,23,20,18582,19463,16457,-3006
2018,5,23,21,18958,19904,16968,-2936
2018,5,23,22,18983,20082,17339,-2743
2018,5,23,23,18690,19802,16938,-2864
2018,5,24,0,18518,19410,16943,-2467
2018,5,24,1,18790,19207,16758,-2449
2018,5,24,2,18340,18723,16240,-2483
2018,5,24,3,16969,17268,15279,-1989
2018,5,24,4,15457,15759,13908,-1851
2018,5,24,5,13615,14580,12805,-1775
2018,5,24,6,12991,13807,11994,-1813
2018,5,24,7,12636,13347,11682,-1665
2018,5,24,8,12495,13116,11542,-1574
2018,5,24,9,12655,13224,11676,-1548
2018,5,24,10,13281,13836,12155,-1681
2018,5,24,11,14431,15302,13182,-2120
2018,5,24,12,15754,16806,14459,-2347
2018,5,24,13,16541,17596,14644,-2952
2018,5,24,14,17097,18065,15215,-2850
2018,5,24,15,17385,18421,15451,-2970
2018,5,24,16,17502,18716,15425,-3291
2018,5,24,17,17567,18990,15887,-3103
2018,5,24,18,17758,19328,16210,-3118
2018,5,24,19,17959,19716,16845,-2871
2018,5,24,20,18303,20155,17606,-2549
2018,5,24,21,18713,20582,18182,-2400
2018,5,24,22,18852,20701,18305,-2396
2018,5,24,23,18552,20215,17190,-3025
2018,5,25,0,18100,19617,16330,-3287
2018,5,25,1,17722,19327,16403,-2924
2018,5,25,2,17467,18816,16016,-2800
2018,5,25,3,16339,17460,15220,-2240
2018,5,25,4,15051,15930,13720,-2210
2018,5,25,5,14347,14751,12381,-2370
2018,5,25,6,13635,13992,11565,-2427
2018,5,25,7,13183,13521,11249,-2272
2018,5,25,8,12966,13324,10992,-2332
2018,5,25,9,13073,13420,11155,-2265
2018,5,25,10,13649,13942,12075,-1867
2018,5,25,11,14844,15301,12992,-2309
2018,5,25,12,16261,16917,14495,-2422
2018,5,25,13,17216,17988,14966,-3022
2018,5,25,14,17672,18798,15291,-3507
2018,5,25,15,18294,19462,15588,-3874
2018,5,25,16,18829,20004,16143,-3861
2018,5,25,17,19332,20430,16567,-3863
2018,5,25,18,19896,20874,17225,-3649
2018,5,25,19,20386,21164,17793,-3371
2018,5,25,20,20874,21564,18378,-3186
2018,5,25,21,21273,21996,18739,-3257
2018,5,25,22,21235,22145,19018,-3127
2018,5,25,23,20676,21723,18444,-3279
2018,5,26,0,19946,21108,18022,-3086
2018,5,26,1,19368,20701,17317,-3384
2018,5,26,2,19069,20225,16737,-3488
2018,5,26,3,17965,18980,15871,-3109
2018,5,26,4,16629,17574,14830,-2744
2018,5,26,5,15790,16328,13706,-2622
2018,5,26,6,14956,15468,12707,-2761
2018,5,26,7,14390,14849,12228,-2621
2018,5,26,8,14038,14489,12036,-2453
2018,5,26,9,13937,14340,11901,-2439
2018,5,26,10,14024,14326,12086,-2240
2018,5,26,11,14333,14724,12736,-1988
2018,5,26,12,15249,15780,13558,-2222
2018,5,26,13,16379,17181,14453,-2728
2018,5,26,14,17155,18461,15072,-3389
2018,5,26,15,18127,19443,15544,-3899
2018,5,26,16,18945,20219,16288,-3931
2018,5,26,17,19595,20836,16825,-4011
2018,5,26,18,20072,21164,17384,-3780
2018,5,26,19,20471,21417,17930,-3487
2018,5,26,20,20846,21630,18086,-3544
2018,5,26,21,21175,21797,18267,-3530
2018,5,26,22,21180,21805,18196,-3609
2018,5,26,23,20891,21501,17795,-3706
2018,5,27,0,20327,21003,17487,-3516
2018,5,27,1,19993,20785,17673,-3112
2018,5,27,2,19871,20409,17370,-3039
2018,5,27,3,18872,19420,16291,-3129
2018,5,27,4,17548,18235,15419,-2816
2018,5,27,5,16444,17131,13916,-3215
2018,5,27,6,15642,16251,13169,-3082
2018,5,27,7,15103,15652,12544,-3108
2018,5,27,8,14756,15090,12323,-2767
2018,5,27,9,14595,14761,11758,-3003
2018,5,27,10,14461,14549,11755,-2794
2018,5,27,11,14366,14560,12244,-2316
2018,5,27,12,14701,15022,12975,-2047
2018,5,27,13,15457,15756,13521,-2235
2018,5,27,14,16455,16467,13926,-2541
2018,5,27,15,16835,17076,14423,-2653
2018,5,27,16,17004,17381,14692,-2689
2018,5,27,17,17031,17455,14983,-2472
2018,5,27,18,16904,17357,14731,-2626
2018,5,27,19,16744,17127,14547,-2580
2018,5,27,20,16699,16952,14137,-2815
2018,5,27,21,16857,16952,14304,-2648
2018,5,27,22,17025,16991,14629,-2362
2018,5,27,23,17039,16907,14559,-2348
2018,5,28,0,16913,16733,14460,-2273
2018,5,28,1,16884,16736,14642,-2094
2018,5,28,2,16721,16504,14161,-2343
2018,5,28,3,15897,15712,13902,-1810
2018,5,28,4,14988,14699,12471,-2228
2018,5,28,5,14264,13811,11513,-2298
2018,5,28,6,13556,13191,10884,-2307
2018,5,28,7,13045,12779,10442,-2337
2018,5,28,8,12718,12609,10511,-2098
2018,5,28,9,12660,12576,10866,-1710
2018,5,28,10,12736,12683,11136,-1547
2018,5,28,11,12995,13008,11585,-1423
2018,5,28,12,13574,13703,12118,-1585
2018,5,28,13,14444,14662,12888,-1774
2018,5,28,14,15767,15534,13489,-2045
2018,5,28,15,16189,16141,13927,-2214
2018,5,28,16,16402,16549,13918,-2631
2018,5,28,17,16475,16784,13994,-2790
2018,5,28,18,16440,16846,14035,-2811
2018,5,28,19,16416,16957,13994,-2963
2018,5,28,20,16532,17156,14149,-3007
2018,5,28,21,16878,17558,14417,-3141
2018,5,28,22,17243,17889,14648,-3241
2018,5,28,23,17411,17956,14767,-3189
2018,5,29,0,17463,17927,14752,-3175
2018,5,29,1,17657,18045,14932,-3113
2018,5,29,2,17546,17768,14601,-3167
2018,5,29,3,16440,16529,13748,-2781
2018,5,29,4,15224,15268,12610,-2658
2018,5,29,5,14069,14284,11725,-2559
2018,5,29,6,13483,13725,11398,-2327
2018,5,29,7,13133,13389,11343,-2046
2018,5,29,8,12996,13316,11305,-2011
2018,5,29,9,13182,13524,11242,-2282
2018,5,29,10,13864,14250,11633,-2617
2018,5,29,11,15271,15857,13048,-2809
2018,5,29,12,16984,17535,14637,-2898
2018,5,29,13,18216,18666,15588,-3078
2018,5,29,14,19293,19582,16074,-3508
2018,5,29,15,19986,20385,16677,-3708
2018,5,29,16,20492,21192,17160,-4032
2018,5,29,17,20883,21920,17775,-4145
2018,5,29,18,21319,22625,18421,-4204
2018,5,29,19,21687,23188,19337,-3851
2018,5,29,20,22188,23772,19845,-3927
2018,5,29,21,22736,24313,20570,-3743
2018,5,29,22,22873,24441,20994,-3447
2018,5,29,23,22497,23866,20530,-3336
2018,5,30,0,22015,23044,20096,-2948
2018,5,30,1,21583,22370,19762,-2608
2018,5,30,2,21073,21596,18713,-2883
2018,5,30,3,19553,19819,16880,-2939
2018,5,30,4,17819,17984,15312,-2672
2018,5,30,5,15549,16573,14304,-2269
2018,5,30,6,14656,15662,13123,-2539
2018,5,30,7,14137,14996,12287,-2709
2018,5,30,8,13873,14643,11836,-2807
2018,5,30,9,13968,14644,12172,-2472
2018,5,30,10,14568,15230,12825,-2405
2018,5,30,11,15927,16688,14064,-2624
2018,5,30,12,17466,18220,15323,-2897
2018,5,30,13,18567,19178,16466,-2712
2018,5,30,14,19642,19841,17162,-2679
2018,5,30,15,20039,20411,16913,-3498
2018,5,30,16,20201,20980,17350,-3630
2018,5,30,17,20199,21484,17333,-4151
2018,5,30,18,20297,22104,17682,-4422
2018,5,30,19,20368,22507,18025,-4482
2018,5,30,20,20507,22909,18474,-4435
2018,5,30,21,20746,23174,19042,-4132
2018,5,30,22,20798,23039,18847,-4192
2018,5,30,23,20416,22353,18553,-3800
2018,5,31,0,19886,21467,17914,-3553
2018,5,31,1,19407,20951,17278,-3673
2018,5,31,2,18981,20362,16852,-3510
2018,5,31,3,17678,18892,15727,-3165
2018,5,31,4,16202,17282,14196,-3086
2018,5,31,5,15269,16074,13465,-2609
2018,5,31,6,14472,15228,13125,-2103
2018,5,31,7,13956,14715,12699,-2016
2018,5,31,8,13704,14497,12671,-1826
2018,5,31,9,13811,14565,12732,-1833
2018,5,31,10,14425,15191,13043,-2148
2018,5,31,11,15886,16718,14027,-2691
2018,5,31,12,17471,18224,14866,-3358
2018,5,31,13,18609,19105,15587,-3518
2018,5,31,14,19757,19661,15768,-3893
2018,5,31,15,20043,20119,15732,-4387
2018,5,31,16,20059,20562,16027,-4535
2018,5,31,17,19919,20867,16190,-4677
2018,5,31,18,19883,21090,16825,-4265
2018,5,31,19,19861,21216,16842,-4374
2018,5,31,20,19919,21376,17235,-4141
2018,5,31,21,20109,21523,17187,-4336
2018,5,31,22,20114,21452,17340,-4112
2018,5,31,23,19820,21027,17468,-3559
2018,6,1,0,19494,20601,17302,-3299
2018,6,1,1,19262,20383,17220,-3163
2018,6,1,2,18966,19848,16580,-3268
2018,6,1,3,17783,18530,15301,-3229
2018,6,1,4,16450,17147,14344,-2803
2018,6,1,5,15963,16035,13414,-2621
2018,6,1,6,15153,15307,12874,-2433
2018,6,1,7,14606,14854,12547,-2307
2018,6,1,8,14331,14643,12293,-2350
2018,6,1,9,14433,14723,12333,-2390
2018,6,1,10,15061,15394,13238,-2156
2018,6,1,11,16587,16914,14220,-2694
2018,6,1,12,18353,18492,14810,-3682
2018,6,1,13,19726,19595,15212,-4383
2018,6,1,14,21101,20332,15932,-4400
2018,6,1,15,21648,20935,16403,-4532
2018,6,1,16,21948,21537,17273,-4264
2018,6,1,17,22083,22067,17916,-4151
2018,6,1,18,22267,22536,18600,-3936
2018,6,1,19,22436,22829,19060,-3769
2018,6,1,20,22698,23180,19736,-3444
2018,6,1,21,22988,23531,20131,-3400
2018,6,1,22,22949,23492,20110,-3382
2018,6,1,23,22446,22897,19480,-3417
2018,6,2,0,21891,22153,18514,-3639
2018,6,2,1,21440,21663,18015,-3648
2018,6,2,2,21200,21054,17000,-4054
2018,6,2,3,20066,19757,15993,-3764
2018,6,2,4,18536,18449,14891,-3558
2018,6,2,5,16363,17251,13480,-3771
2018,6,2,6,15471,16219,12724,-3495
2018,6,2,7,14903,15579,12681,-2898
2018,6,2,8,14537,15156,12390,-2766
2018,6,2,9,14403,14977,11599,-3378
2018,6,2,10,14428,14974,11774,-3200
2018,6,2,11,14810,15418,12756,-2662
2018,6,2,12,15620,16490,14291,-2199
2018,6,2,13,16667,17775,15019,-2756
2018,6,2,14,18049,18917,15875,-3042
2018,6,2,15,18525,19834,16626,-3208
2018,6,2,16,18746,20545,17460,-3085
2018,6,2,17,18745,21069,17783,-3286
2018,6,2,18,18642,21390,17957,-3433
2018,6,2,19,18558,21497,18127,-3370
2018,6,2,20,18589,21641,18788,-2853
2018,6,2,21,18777,21782,19023,-2759
2018,6,2,22,18896,21910,18704,-3206
2018,6,2,23,18814,21665,18105,-3560
2018,6,3,0,18548,20904,17254,-3650
2018,6,3,1,18257,20550,16883,-3667
2018,6,3,2,18166,20199,16282,-3917
2018,6,3,3,17426,19044,15574,-3470
2018,6,3,4,16438,17616,14717,-2899
2018,6,3,5,15680,16311,13261,-3050
2018,6,3,6,14827,15251,11919,-3332
2018,6,3,7,14244,14505,10905,-3600
2018,6,3,8,13860,14019,10518,-3501
2018,6,3,9,13682,13740,10710,-3030
2018,6,3,10,13566,13545,10808,-2737
2018,6,3,11,13612,13608,11314,-2294
2018,6,3,12,14049,14108,11968,-2140
2018,6,3,13,14734,14965,12933,-2032
2018,6,3,14,15757,15647,13165,-2482
2018,6,3,15,15997,16152,13334,-2818
2018,6,3,16,16020,16441,13354,-3087
2018,6,3,17,15933,16542,13471,-3071
2018,6,3,18,15756,16506,13491,-3015
2018,6,3,19,15596,16424,13877,-2547
2018,6,3,20,15587,16457,14021,-2436
2018,6,3,21,15799,16624,14361,-2263
2018,6,3,22,16057,16899,14644,-2255
2018,6,3,23,16131,16937,14472,-2465
2018,6,4,0,16050,16914,14443,-2471
2018,6,4,1,15999,17065,14516,-2549
2018,6,4,2,15865,16676,14415,-2261
2018,6,4,3,15053,15631,13758,-1873
2018,6,4,4,14103,14451,12303,-2148
2018,6,4,5,13389,13561,10917,-2644
2018,6,4,6,12886,13050,10185,-2865
2018,6,4,7,12580,12768,9939,-2829
2018,6,4,8,12465,12659,9952,-2707
2018,6,4,9,12656,12829,10072,-2757
2018,6,4,10,13287,13569,10840,-2729
2018,6,4,11,14649,14990,12407,-2583
2018,6,4,12,16033,16407,13481,-2926
2018,6,4,13,16856,17197,14263,-2934
2018,6,4,14,17502,17655,14803,-2852
2018,6,4,15,17565,17886,14915,-2971
2018,6,4,16,17433,18073,15257,-2816
2018,6,4,17,17228,18101,15355,-2746
2018,6,4,18,17101,18135,15483,-2652
2018,6,4,19,16973,18161,16003,-2158
2018,6,4,20,17034,18381,16476,-1905
2018,6,4,21,17244,18624,16432,-2192
2018,6,4,22,17382,18852,16136,-2716
2018,6,4,23,17303,18691,16196,-2495
2018,6,5,0,17216,18387,16024,-2363
2018,6,5,1,17187,18185,15760,-2425
2018,6,5,2,16990,17724,15228,-2496
2018,6,5,3,15966,16464,13802,-2662
2018,6,5,4,14758,15117,12744,-2373
2018,6,5,5,13486,14089,11851,-2238
2018,6,5,6,12837,13374,10898,-2476
2018,6,5,7,12478,13042,10362,-2680
2018,6,5,8,12355,12897,10002,-2895
2018,6,5,9,12552,13011,10263,-2748
2018,6,5,10,13193,13669,10276,-3393
2018,6,5,11,14504,15142,11813,-3329
2018,6,5,12,15948,16646,13703,-2943
2018,6,5,13,16811,17440,14448,-2992
2018,6,5,14,17569,17958,15002,-2956
2018,6,5,15,17651,18373,15178,-3195
2018,6,5,16,17580,18640,15386,-3254
2018,6,5,17,17413,18710,15522,-3188
2018,6,5,18,17393,18695,15344,-3351
2018,6,5,19,17403,18774,15637,-3137
2018,6,5,20,17541,18674,15655,-3019
2018,6,5,21,17841,18820,15556,-3264
2018,6,5,22,17987,18887,15567,-3320
2018,6,5,23,17830,18588,15424,-3164
2018,6,6,0,17665,18257,15250,-3007
2018,6,6,1,17614,18165,15250,-2915
2018,6,6,2,17419,17655,14639,-3016
2018,6,6,3,16340,16324,13514,-2810
2018,6,6,4,15062,14963,12238,-2725
2018,6,6,5,13498,14022,11280,-2742
2018,6,6,6,12833,13441,10598,-2843
2018,6,6,7,12472,13025,10518,-2507
2018,6,6,8,12336,12860,10056,-2804
2018,6,6,9,12515,13008,10318,-2690
2018,6,6,10,13138,13652,11207,-2445
2018,6,6,11,14460,15060,12188,-2872
2018,6,6,12,15873,16395,13425,-2970
2018,6,6,13,16703,17142,13925,-3217
2018,6,6,14,17436,17542,14409,-3133
2018,6,6,15,17412,17847,14592,-3255
2018,6,6,16,17206,18017,14958,-3059
2018,6,6,17,16914,18154,14824,-3330
2018,6,6,18,16791,18350,14587,-3763
2018,6,6,19,16723,18447,14589,-3858
2018,6,6,20,16808,18454,14496,-3958
2018,6,6,21,17091,18498,14844,-3654
2018,6,6,22,17250,18477,14973,-3504
2018,6,6,23,17159,18096,14703,-3393
2018,6,7,0,17017,17811,14741,-3070
2018,6,7,1,16961,17808,14954,-2854
2018,6,7,2,16816,17489,14551,-2938
2018,6,7,3,15798,16255,13545,-2710
2018,6,7,4,14613,14962,12075,-2887
2018,6,7,5,13914,14014,11238,-2776
2018,6,7,6,13209,13397,10645,-2752
2018,6,7,7,12752,13051,10518,-2533
2018,6,7,8,12533,12920,10512,-2408
2018,6,7,9,12623,13084,10817,-2267
2018,6,7,10,13181,13785,11310,-2475
2018,6,7,11,14578,15176,12122,-3054
2018,6,7,12,16088,16538,13510,-3028
2018,6,7,13,16931,17310,14284,-3026
2018,6,7,14,17433,17755,14620,-3135
2018,6,7,15,17766,17983,14652,-3331
2018,6,7,16,17902,18154,14801,-3353
2018,6,7,17,17923,18272,14788,-3484
2018,6,7,18,18025,18401,14882,-3519
2018,6,7,19,18078,18546,14988,-3558
2018,6,7,20,18204,18772,15134,-3638
2018,6,7,21,18415,18976,15338,-3638
2018,6,7,22,18548,19002,15691,-3311
2018,6,7,23,18347,18763,15330,-3433
2018,6,8,0,18077,18379,14845,-3534
2018,6,8,1,17960,18232,15385,-2847
2018,6,8,2,17707,17965,14729,-3236
2018,6,8,3,16494,16752,13885,-2867
2018,6,8,4,15100,15406,12392,-3014
2018,6,8,5,14194,14345,11477,-2868
2018,6,8,6,13493,13692,10640,-3052
2018,6,8,7,13023,13255,10526,-2729
2018,6,8,8,12785,13082,10552,-2530
2018,6,8,9,12841,13209,10743,-2466
2018,6,8,10,13327,13796,10911,-2885
2018,6,8,11,14601,15214,12462,-2752
2018,6,8,12,16033,16707,13693,-3014
2018,6,8,13,16934,17732,14319,-3413
2018,6,8,14,17530,18439,14745,-3694
2018,6,8,15,18008,19015,15003,-4012
2018,6,8,16,18393,19561,15461,-4100
2018,6,8,17,18649,20011,15489,-4522
2018,6,8,18,18960,20466,15740,-4726
2018,6,8,19,19207,20748,16241,-4507
2018,6,8,20,19438,20980,16658,-4322
2018,6,8,21,19649,21201,17232,-3969
2018,6,8,22,19615,21217,17233,-3984
2018,6,8,23,19185,20745,16868,-3877
2018,6,9,0,18672,20234,16372,-3862
2018,6,9,1,18426,19690,16188,-3502
2018,6,9,2,18265,19319,15762,-3557
2018,6,9,3,17272,18203,14903,-3300
2018,6,9,4,15956,16894,13410,-3484
2018,6,9,5,14812,15724,12098,-3626
2018,6,9,6,14037,14884,11398,-3486
2018,6,9,7,13542,14300,11006,-3294
2018,6,9,8,13238,13939,10952,-2987
2018,6,9,9,13136,13727,10910,-2817
2018,6,9,10,13126,13646,10686,-2960
2018,6,9,11,13418,14072,11385,-2687
2018,6,9,12,14233,15021,12137,-2884
2018,6,9,13,15216,16087,12892,-3195
2018,6,9,14,15966,17031,13908,-3123
2018,6,9,15,16503,17724,13927,-3797
2018,6,9,16,16840,18216,14255,-3961
2018,6,9,17,17020,18517,14289,-4228
2018,6,9,18,17125,18768,15068,-3700
2018,6,9,19,17245,18968,15678,-3290
2018,6,9,20,17416,18926,15726,-3200
2018,6,9,21,17626,19039,15812,-3227
2018,6,9,22,17750,19193,16023,-3170
2018,6,9,23,17635,18923,15520,-3403
2018,6,10,0,17365,18460,15096,-3364
2018,6,10,1,17296,18313,14890,-3423
2018,6,10,2,17301,18144,14140,-4004
2018,6,10,3,16551,17265,13458,-3807
2018,6,10,4,15507,16217,12704,-3513
2018,6,10,5,14555,15291,11652,-3639
2018,6,10,6,13780,14557,10758,-3799
2018,6,10,7,13276,14063,10447,-3616
2018,6,10,8,12963,13729,10095,-3634
2018,6,10,9,12832,13580,9969,-3611
2018,6,10,10,12732,13451,10171,-3280
2018,6,10,11,12870,13597,10572,-3025
2018,6,10,12,13565,14137,11142,-2995
2018,6,10,13,14518,14934,11529,-3405
2018,6,10,14,15292,15826,12226,-3600
2018,6,10,15,15847,16442,12617,-3825
2018,6,10,16,16201,16752,12644,-4108
2018,6,10,17,16410,16951,13112,-3839
2018,6,10,18,16505,17051,13190,-3861
2018,6,10,19,16583,17062,13173,-3889
2018,6,10,20,16727,17068,13072,-3996
2018,6,10,21,16967,17231,13232,-3999
2018,6,10,22,17179,17402,13407,-3995
2018,6,10,23,17140,17391,13649,-3742
2018,6,11,0,16994,17342,13749,-3593
2018,6,11,1,16992,17426,14047,-3379
2018,6,11,2,16915,17221,13563,-3658
2018,6,11,3,16003,16215,12839,-3376
2018,6,11,4,14850,14956,11805,-3151
2018,6,11,5,13494,14042,11070,-2972
2018,6,11,6,12849,13469,10704,-2765
2018,6,11,7,12454,13121,10643,-2478
2018,6,11,8,12280,12966,10287,-2679
2018,6,11,9,12416,13142,10433,-2709
2018,6,11,10,13009,13812,10855,-2957
2018,6,11,11,14394,15256,12711,-2545
2018,6,11,12,15937,16675,14072,-2603
2018,6,11,13,16845,17496,14916,-2580
2018,6,11,14,17410,17967,15203,-2764
2018,6,11,15,17800,18334,15241,-3093
2018,6,11,16,17964,18559,15324,-3235
2018,6,11,17,18028,18654,15356,-3298
2018,6,11,18,18126,18884,15553,-3331
2018,6,11,19,18160,19090,15637,-3453
2018,6,11,20,18237,19280,15663,-3617
2018,6,11,21,18423,19595,15897,-3698
2018,6,11,22,18579,19766,15841,-3925
2018,6,11,23,18406,19433,15951,-3482
2018,6,12,0,18134,18930,15980,-2950
2018,6,12,1,17954,18470,15518,-2952
2018,6,12,2,17630,18035,15216,-2819
2018,6,12,3,16362,16738,14091,-2647
2018,6,12,4,14889,15281,12609,-2672
2018,6,12,5,13768,14193,11254,-2939
2018,6,12,6,13042,13544,10629,-2915
2018,6,12,7,12586,13151,10465,-2686
2018,6,12,8,12365,12984,10656,-2328
2018,6,12,9,12459,13138,11049,-2089
2018,6,12,10,12991,13727,11456,-2271
2018,6,12,11,14315,15198,13006,-2192
2018,6,12,12,15757,16607,14057,-2550
2018,6,12,13,16582,17438,14742,-2696
2018,6,12,14,17088,17979,15307,-2672
2018,6,12,15,17480,18423,15814,-2609
2018,6,12,16,17731,18733,16138,-2595
2018,6,12,17,17894,18980,16172,-2808
2018,6,12,18,18123,19281,16351,-2930
2018,6,12,19,18302,19654,16679,-2975
2018,6,12,20,18545,19986,17007,-2979
2018,6,12,21,18883,20368,17307,-3061
2018,6,12,22,19114,20513,17197,-3316
2018,6,12,23,18956,20132,16999,-3133
2018,6,13,0,18634,19571,16739,-2832
2018,6,13,1,18442,19232,16635,-2597
2018,6,13,2,18139,18893,16112,-2781
2018,6,13,3,16869,17593,15039,-2554
2018,6,13,4,15436,16129,13764,-2365
2018,6,13,5,14857,14965,12335,-2630
2018,6,13,6,14095,14266,11779,-2487
2018,6,13,7,13562,13842,11733,-2109
2018,6,13,8,13284,13664,11769,-1895
2018,6,13,9,13334,13810,11823,-1987
2018,6,13,10,13893,14512,12029,-2483
2018,6,13,11,15331,16011,13211,-2800
2018,6,13,12,16923,17539,14524,-3015
2018,6,13,13,17930,18580,15637,-2943
2018,6,13,14,18605,19277,16237,-3040
2018,6,13,15,19131,19707,16384,-3323
2018,6,13,16,19549,20001,16952,-3049
2018,6,13,17,19775,20147,17406,-2741
2018,6,13,18,20039,20383,17214,-3169
2018,6,13,19,20219,20465,16843,-3622
2018,6,13,20,20427,20763,17335,-3428
2018,6,13,21,20700,21057,17772,-3285
2018,6,13,22,20793,21203,17926,-3277
2018,6,13,23,20458,20992,17536,-3456
2018,6,14,0,20003,20753,17035,-3718
2018,6,14,1,19748,20475,16589,-3886
2018,6,14,2,19464,20178,16350,-3828
2018,6,14,3,18168,18939,15380,-3559
2018,6,14,4,16579,17474,13851,-3623
2018,6,14,5,15299,16285,12617,-3668
2018,6,14,6,14536,15453,11842,-3611
2018,6,14,7,14031,14853,11707,-3146
2018,6,14,8,13764,14523,11654,-2869
2018,6,14,9,13811,14465,11695,-2770
2018,6,14,10,14313,14893,11934,-2959
2018,6,14,11,15593,16349,12985,-3364
2018,6,14,12,17007,17944,14248,-3696
2018,6,14,13,17863,18929,14644,-4285
2018,6,14,14,18417,19559,15654,-3905
2018,6,14,15,18875,20030,16035,-3995
2018,6,14,16,19231,20423,16801,-3622
2018,6,14,17,19486,20690,16682,-4008
2018,6,14,18,19788,21097,16818,-4279
2018,6,14,19,20012,21337,17317,-4020
2018,6,14,20,20260,21757,18074,-3683
2018,6,14,21,20521,22084,18485,-3599
2018,6,14,22,20599,22125,18424,-3701
2018,6,14,23,20253,21633,17974,-3659
2018,6,15,0,19808,20951,17234,-3717
2018,6,15,1,19556,20408,16434,-3974
2018,6,15,2,19291,19947,15591,-4356
2018,6,15,3,18110,18598,14602,-3996
2018,6,15,4,16609,17045,13517,-3528
2018,6,15,5,14816,15790,12257,-3533
2018,6,15,6,14003,14906,11528,-3378
2018,6,15,7,13522,14347,11075,-3272
2018,6,15,8,13273,14046,10958,-3088
2018,6,15,9,13327,14031,10912,-3119
2018,6,15,10,13810,14477,11240,-3237
2018,6,15,11,15061,15736,12307,-3429
2018,6,15,12,16463,17191,13457,-3734
2018,6,15,13,17307,18216,14401,-3815
2018,6,15,14,17824,18889,15185,-3704
2018,6,15,15,18169,19233,14814,-4419
2018,6,15,16,18345,19439,14653,-4786
2018,6,15,17,18400,19607,14912,-4695
2018,6,15,18,18520,19766,15045,-4721
2018,6,15,19,18601,19926,15308,-4618
2018,6,15,20,18727,20100,15683,-4417
2018,6,15,21,18920,20220,15830,-4390
2018,6,15,22,18971,20150,16031,-4119
2018,6,15,23,18660,19785,15733,-4052
2018,6,16,0,18272,19318,15321,-3997
2018,6,16,1,18083,18815,15004,-3811
2018,6,16,2,17987,18579,14621,-3958
2018,6,16,3,17051,17540,13806,-3734
2018,6,16,4,15788,16207,12601,-3606
2018,6,16,5,14895,15059,11720,-3339
2018,6,16,6,14112,14296,10937,-3359
2018,6,16,7,13597,13821,10374,-3447
2018,6,16,8,13276,13514,10244,-3270
2018,6,16,9,13154,13413,10358,-3055
2018,6,16,10,13106,13369,10521,-2848
2018,6,16,11,13345,13850,11295,-2555
2018,6,16,12,14154,14773,12234,-2539
2018,6,16,13,15188,15953,13047,-2906
2018,6,16,14,16039,16921,13973,-2948
2018,6,16,15,16736,17645,14668,-2977
2018,6,16,16,17308,18248,15224,-3024
2018,6,16,17,17744,18639,15242,-3397
2018,6,16,18,18111,18985,15287,-3698
2018,6,16,19,18480,19382,16196,-3186
2018,6,16,20,18869,19843,16307,-3536
2018,6,16,21,19262,20319,16633,-3686
2018,6,16,22,19473,20704,16598,-4106
2018,6,16,23,19345,20542,16277,-4265
2018,6,17,0,18961,20036,16079,-3957
2018,6,17,1,18802,19606,15935,-3671
2018,6,17,2,18791,19348,15962,-3386
2018,6,17,3,17992,18365,15043,-3322
2018,6,17,4,16906,17098,13720,-3378
2018,6,17,5,15939,15942,12002,-3940
2018,6,17,6,15113,15097,11238,-3859
2018,6,17,7,14517,14492,10723,-3769
2018,6,17,8,14127,14099,10680,-3419
2018,6,17,9,13923,13854,10960,-2894
2018,6,17,10,13761,13686,10771,-2915
2018,6,17,11,13866,13981,11402,-2579
2018,6,17,12,14629,14926,12255,-2671
2018,6,17,13,15796,16238,13173,-3065
2018,6,17,14,16913,17571,14245,-3326
2018,6,17,15,17935,18819,15171,-3648
2018,6,17,16,18854,19896,15959,-3937
2018,6,17,17,19608,20675,16754,-3921
2018,6,17,18,20216,21384,17219,-4165
2018,6,17,19,20734,21984,18160,-3824
2018,6,17,20,21237,22464,18909,-3555
2018,6,17,21,21724,22941,19338,-3603
2018,6,17,22,21999,23090,19740,-3350
2018,6,17,23,21869,22944,19221,-3723
2018,6,18,0,21476,22567,18800,-3767
2018,6,18,1,21240,22252,18347,-3905
2018,6,18,2,21029,22080,17948,-4132
2018,6,18,3,19887,20889,16966,-3923
2018,6,18,4,18515,19265,15476,-3789
2018,6,18,5,17638,18058,14356,-3702
2018,6,18,6,16763,17221,13625,-3596
2018,6,18,7,16154,16686,13166,-3520
2018,6,18,8,15821,16412,13155,-3257
2018,6,18,9,15863,16530,13295,-3235
2018,6,18,10,16421,17153,13773,-3380
2018,6,18,11,17860,18721,15627,-3094
2018,6,18,12,19732,20686,16968,-3718
2018,6,18,13,21219,22387,18106,-4281
2018,6,18,14,22450,23896,19696,-4200
2018,6,18,15,23552,25155,21231,-3924
2018,6,18,16,24476,26314,22404,-3910
2018,6,18,17,25201,27167,23686,-3481
2018,6,18,18,25870,27893,24255,-3638
2018,6,18,19,26349,28137,24444,-3693
2018,6,18,20,26755,28166,24837,-3329
2018,6,18,21,27059,28126,24574,-3552
2018,6,18,22,27053,28023,24863,-3160
2018,6,18,23,26462,27397,24754,-2643
2018,6,19,0,25729,26597,24218,-2379
2018,6,19,1,25058,26001,23626,-2375
2018,6,19,2,24457,25053,22032,-3021
2018,6,19,3,22800,23444,19895,-3549
2018,6,19,4,20790,21640,18064,-3576
2018,6,19,5,18546,20143,15722,-4421
2018,6,19,6,17597,19229,14634,-4595
2018,6,19,7,16999,18544,14150,-4394
2018,6,19,8,16667,18147,13940,-4207
2018,6,19,9,16705,18141,14087,-4054
2018,6,19,10,17243,18656,14332,-4324
2018,6,19,11,18595,20108,15922,-4186
2018,6,19,12,20164,21765,17900,-3865
2018,6,19,13,21219,22883,19091,-3792
2018,6,19,14,21948,23643,19994,-3649
2018,6,19,15,22571,24175,21066,-3109
2018,6,19,16,22971,24478,21123,-3355
2018,6,19,17,23302,24661,21073,-3588
2018,6,19,18,23625,24902,22092,-2810
2018,6,19,19,23858,25196,22277,-2919
2018,6,19,20,24108,25646,22575,-3071
2018,6,19,21,24345,26050,23297,-2753
2018,6,19,22,24379,26110,23499,-2611
2018,6,19,23,23940,25531,23155,-2376
2018,6,20,0,23368,24534,21842,-2692
2018,6,20,1,22942,23597,20634,-2963
2018,6,20,2,22531,22947,19511,-3436
2018,6,20,3,21102,21374,17337,-4037
2018,6,20,4,19234,19526,15424,-4102
2018,6,20,5,16472,17977,13779,-4198
2018,6,20,6,15521,16964,12676,-4288
2018,6,20,7,14999,16246,12019,-4227
2018,6,20,8,14722,15829,11608,-4221
2018,6,20,9,14765,15761,11678,-4083
2018,6,20,10,15255,16177,12311,-3866
2018,6,20,11,16512,17505,13551,-3954
2018,6,20,12,17952,18862,14814,-4048
2018,6,20,13,18889,19713,15519,-4194
2018,6,20,14,19550,20332,15975,-4357
2018,6,20,15,20128,20878,16526,-4352
2018,6,20,16,20609,21502,16890,-4612
2018,6,20,17,20963,21960,17563,-4397
2018,6,20,18,21349,22397,18249,-4148
2018,6,20,19,21619,22850,19057,-3793
2018,6,20,20,21878,23253,19265,-3988
2018,6,20,21,22122,23576,19846,-3730
2018,6,20,22,22141,23531,20191,-3340
2018,6,20,23,21722,22977,19683,-3294
2018,6,21,0,21189,22476,18714,-3762
2018,6,21,1,20872,22066,18426,-3640
2018,6,21,2,20563,21739,17606,-4133
2018,6,21,3,19309,20462,16370,-4092
2018,6,21,4,17734,18916,14856,-4060
2018,6,21,5,16407,17593,13187,-4406
2018,6,21,6,15530,16677,12333,-4344
2018,6,21,7,14986,15979,12031,-3948
2018,6,21,8,14700,15593,11776,-3817
2018,6,21,9,14752,15592,12051,-3541
2018,6,21,10,15273,16151,12611,-3540
2018,6,21,11,16583,17456,13531,-3925
2018,6,21,12,18108,18861,14709,-4152
2018,6,21,13,19093,19802,15532,-4270
2018,6,21,14,19735,20525,16175,-4350
2018,6,21,15,20246,21186,17167,-4019
2018,6,21,16,20552,21669,17964,-3705
2018,6,21,17,20802,22122,17637,-4485
2018,6,21,18,21091,22732,18146,-4586
2018,6,21,19,21310,23216,18780,-4436
2018,6,21,20,21541,23685,19688,-3997
2018,6,21,21,21783,24107,19913,-4194
2018,6,21,22,21837,24242,19978,-4264
2018,6,21,23,21428,23742,19090,-4652
2018,6,22,0,20934,22922,18293,-4629
2018,6,22,1,20666,22155,18344,-3811
2018,6,22,2,20385,21692,17759,-3933
2018,6,22,3,19130,20325,16418,-3907
2018,6,22,4,17505,18684,15170,-3514
2018,6,22,5,15727,17224,12697,-4527
2018,6,22,6,14908,16246,11786,-4460
2018,6,22,7,14444,15564,11210,-4354
2018,6,22,8,14201,15228,11332,-3896
2018,6,22,9,14265,15191,11677,-3514
2018,6,22,10,14740,15612,11866,-3746
2018,6,22,11,15909,16873,12831,-4042
2018,6,22,12,17228,18224,13852,-4372
2018,6,22,13,18031,19190,14441,-4749
2018,6,22,14,18536,19905,15117,-4788
2018,6,22,15,18912,20429,15516,-4913
2018,6,22,16,19192,20866,15911,-4955
2018,6,22,17,19332,21007,16098,-4909
2018,6,22,18,19514,21242,16319,-4923
2018,6,22,19,19639,21398,16503,-4895
2018,6,22,20,19770,21491,16409,-5082
2018,6,22,21,19915,21425,16125,-5300
2018,6,22,22,19872,21081,16172,-4909
2018,6,22,23,19524,20465,16002,-4463
2018,6,23,0,19080,20006,15621,-4385
2018,6,23,1,18811,19777,15557,-4220
2018,6,23,2,18672,19480,15029,-4451
2018,6,23,3,17760,18448,14292,-4156
2018,6,23,4,16519,17162,13473,-3689
2018,6,23,5,15374,15987,12114,-3873
2018,6,23,6,14523,15161,11313,-3848
2018,6,23,7,13967,14576,10966,-3610
2018,6,23,8,13618,14253,10972,-3281
2018,6,23,9,13494,14077,10725,-3352
2018,6,23,10,13493,14166,11190,-2976
2018,6,23,11,13784,14486,11529,-2957
2018,6,23,12,14688,15301,12348,-2953
2018,6,23,13,15832,16344,13113,-3231
2018,6,23,14,16723,17122,14032,-3090
2018,6,23,15,17300,17647,14650,-2997
2018,6,23,16,17598,17813,14892,-2921
2018,6,23,17,17707,17780,14690,-3090
2018,6,23,18,17701,17706,14667,-3039
2018,6,23,19,17698,17633,14524,-3109
2018,6,23,20,17761,17558,14405,-3153
2018,6,23,21,17939,17605,14533,-3072
2018,6,23,22,18063,17694,14666,-3028
2018,6,23,23,17972,17665,14420,-3245
2018,6,24,0,17702,17610,14521,-3089
2018,6,24,1,17630,17625,14621,-3004
2018,6,24,2,17738,17572,14417,-3155
2018,6,24,3,17044,16867,13487,-3380
2018,6,24,4,16106,15928,12456,-3472
2018,6,24,5,15933,15083,11105,-3978
2018,6,24,6,15185,14450,10500,-3950
2018,6,24,7,14581,14026,10227,-3799
2018,6,24,8,14187,13769,10400,-3369
2018,6,24,9,13998,13704,10596,-3108
2018,6,24,10,13865,13723,10650,-3073
2018,6,24,11,13967,14001,10705,-3296
2018,6,24,12,14742,14683,11502,-3181
2018,6,24,13,15898,15822,12581,-3241
2018,6,24,14,16935,16753,13332,-3421
2018,6,24,15,17791,17661,14059,-3602
2018,6,24,16,18443,18546,14875,-3671
2018,6,24,17,18919,19277,15528,-3749
2018,6,24,18,19253,19735,15695,-4040
2018,6,24,19,19538,19928,15909,-4019
2018,6,24,20,19856,20093,16047,-4046
2018,6,24,21,20224,20366,16160,-4206
2018,6,24,22,20485,20499,16290,-4209
2018,6,24,23,20389,20578,16364,-4214
2018,6,25,0,20049,20395,16194,-4201
2018,6,25,1,19922,20252,15932,-4320
2018,6,25,2,19875,19929,15587,-4342
2018,6,25,3,18870,18777,14580,-4197
2018,6,25,4,17496,17530,13602,-3928
2018,6,25,5,15868,16480,12633,-3847
2018,6,25,6,15149,15691,11935,-3756
2018,6,25,7,14677,15160,11547,-3613
2018,6,25,8,14439,14909,11156,-3753
2018,6,25,9,14547,14934,11171,-3763
2018,6,25,10,15123,15422,11646,-3776
2018,6,25,11,16417,16760,13238,-3522
2018,6,25,12,17921,18299,14570,-3729
2018,6,25,13,18878,19404,15677,-3727
2018,6,25,14,19491,20148,16177,-3971
2018,6,25,15,19961,20634,16688,-3946
2018,6,25,16,20231,20925,16956,-3969
2018,6,25,17,20429,21081,17029,-4052
2018,6,25,18,20658,21308,17027,-4281
2018,6,25,19,20832,21583,17589,-3994
2018,6,25,20,21048,21865,17742,-4123
2018,6,25,21,21313,22154,18102,-4052
2018,6,25,22,21440,22283,18209,-4074
2018,6,25,23,21128,21921,17745,-4176
2018,6,26,0,20690,21213,17292,-3921
2018,6,26,1,20406,20466,16733,-3733
2018,6,26,2,20120,20032,16566,-3466
2018,6,26,3,18858,18673,15217,-3456
2018,6,26,4,17237,17006,13742,-3264
2018,6,26,5,15087,15748,12185,-3563
2018,6,26,6,14244,14889,11564,-3325
2018,6,26,7,13766,14340,11107,-3233
2018,6,26,8,13525,14051,10967,-3084
2018,6,26,9,13628,14116,11283,-2833
2018,6,26,10,14184,14586,11507,-3079
2018,6,26,11,15483,15875,12983,-2892
2018,6,26,12,16926,17366,14493,-2873
2018,6,26,13,17774,18416,15263,-3153
2018,6,26,14,18303,19150,15929,-3221
2018,6,26,15,18737,19682,15866,-3816
2018,6,26,16,19071,20022,16211,-3811
2018,6,26,17,19313,20302,16596,-3706
2018,6,26,18,19623,20668,16746,-3922
2018,6,26,19,19899,21019,16850,-4169
2018,6,26,20,20206,21408,17099,-4309
2018,6,26,21,20551,21833,17471,-4362
2018,6,26,22,20725,21992,17667,-4325
2018,6,26,23,20461,21574,17749,-3825
2018,6,27,0,20037,20892,17210,-3682
2018,6,27,1,19781,20453,16577,-3876
2018,6,27,2,19506,20149,16265,-3884
2018,6,27,3,18250,18869,15362,-3507
2018,6,27,4,16756,17345,14187,-3158
2018,6,27,5,16042,16126,12303,-3823
2018,6,27,6,15228,15308,11679,-3629
2018,6,27,7,14677,14804,11257,-3547
2018,6,27,8,14379,14548,11435,-3113
2018,6,27,9,14435,14606,11775,-2831
2018,6,27,10,14988,15233,12184,-3049
2018,6,27,11,16307,16471,13237,-3234
2018,6,27,12,17817,17921,14236,-3685
2018,6,27,13,18790,18998,14827,-4171
2018,6,27,14,19440,19783,15607,-4176
2018,6,27,15,19949,20355,16044,-4311
2018,6,27,16,20368,20689,16433,-4256
2018,6,27,17,20642,20853,16900,-3953
2018,6,27,18,20951,20938,16896,-4042
2018,6,27,19,21175,20803,16841,-3962
2018,6,27,20,21414,20658,16843,-3815
2018,6,27,21,21664,20610,16966,-3644
2018,6,27,22,21671,20506,17143,-3363
2018,6,27,23,21253,20188,16472,-3716
2018,6,28,0,20704,19967,16546,-3421
2018,6,28,1,20352,19768,16781,-2987
2018,6,28,2,20059,19472,16303,-3169
2018,6,28,3,18797,18346,15209,-3137
2018,6,28,4,17342,17144,14209,-2935
2018,6,28,5,17222,16177,12963,-3214
2018,6,28,6,16350,15521,12307,-3214
2018,6,28,7,15682,15118,11900,-3218
2018,6,28,8,15316,14975,11998,-2977
2018,6,28,9,15366,15150,12777,-2373
2018,6,28,10,15990,15889,13301,-2588
2018,6,28,11,17510,17239,14479,-2760
2018,6,28,12,19317,18697,15524,-3173
2018,6,28,13,20600,19796,15926,-3870
2018,6,28,14,21524,20743,16520,-4223
2018,6,28,15,22249,21635,17237,-4398
2018,6,28,16,22719,22401,18097,-4304
2018,6,28,17,23064,23064,18753,-4311
2018,6,28,18,23428,23678,19168,-4510
2018,6,28,19,23682,24040,19357,-4683
2018,6,28,20,23958,24256,19476,-4780
2018,6,28,21,24251,24611,19541,-5070
2018,6,28,22,24327,24603,19928,-4675
2018,6,28,23,23843,24023,19069,-4954
2018,6,29,0,23210,23477,18613,-4864
2018,6,29,1,22801,22939,18694,-4245
2018,6,29,2,22489,22621,18589,-4032
2018,6,29,3,21011,21316,17352,-3964
2018,6,29,4,19167,19594,16318,-3276
2018,6,29,5,17809,18137,14172,-3965
2018,6,29,6,16864,17100,13052,-4048
2018,6,29,7,16206,16471,12710,-3761
2018,6,29,8,15829,16050,12493,-3557
2018,6,29,9,15829,16006,12906,-3100
2018,6,29,10,16315,16384,13042,-3342
2018,6,29,11,17643,17753,14605,-3148
2018,6,29,12,19451,19626,16137,-3489
2018,6,29,13,20957,21177,17256,-3921
2018,6,29,14,22193,22468,18269,-4199
2018,6,29,15,23287,23682,19665,-4017
2018,6,29,16,24176,24667,20477,-4190
2018,6,29,17,24851,25349,21838,-3511
2018,6,29,18,25502,25907,22862,-3045
2018,6,29,19,25981,26441,23571,-2870
2018,6,29,20,26381,26914,23700,-3214
2018,6,29,21,26641,27295,24418,-2877
2018,6,29,22,26516,27372,24392,-2980
2018,6,29,23,25811,26820,23922,-2898
2018,6,30,0,24908,25916,23198,-2718
2018,6,30,1,24264,24830,22231,-2599
2018,6,30,2,23940,24188,20945,-3243
2018,6,30,3,22609,22762,19122,-3640
2018,6,30,4,20839,21011,17167,-3844
2018,6,30,5,19316,19311,14702,-4609
2018,6,30,6,18258,18159,13510,-4649
2018,6,30,7,17537,17273,13046,-4227
2018,6,30,8,17052,16696,12929,-3767
2018,6,30,9,16832,16376,12812,-3564
2018,6,30,10,16744,16247,13019,-3228
2018,6,30,11,17037,16684,13470,-3214
2018,6,30,12,18233,18014,15492,-2522
2018,6,30,13,19921,19710,17018,-2692
2018,6,30,14,21530,21414,18319,-3095
2018,6,30,15,22943,23010,19800,-3210
2018,6,30,16,24065,24263,20988,-3275
2018,6,30,17,24896,25065,21952,-3113
2018,6,30,18,25501,25637,22944,-2693
2018,6,30,19,25951,26160,23268,-2892
2018,6,30,20,26331,26651,23593,-3058
2018,6,30,21,26593,27126,24179,-2947
2018,6,30,22,26570,27400,24839,-2561
2018,6,30,23,26132,27248,24479,-2769
2018,7,1,0,25456,26538,23742,-2796
2018,7,1,1,24958,25774,22676,-3098
2018,7,1,2,24760,25372,21423,-3949
2018,7,1,3,23591,24187,20171,-4016
2018,7,1,4,22104,22677,18429,-4248
2018,7,1,5,21829,21187,16812,-4375
2018,7,1,6,20762,20007,15739,-4268
2018,7,1,7,19925,19141,14394,-4747
2018,7,1,8,19348,18529,13928,-4601
2018,7,1,9,18941,18124,13634,-4490
2018,7,1,10,18613,17886,13619,-4267
2018,7,1,11,18722,18149,14033,-4116
2018,7,1,12,19927,19375,15740,-3635
2018,7,1,13,21785,21146,16711,-4435
2018,7,1,14,23758,22943,18362,-4581
2018,7,1,15,25618,24654,20159,-4495
2018,7,1,16,27153,26080,22092,-3988
2018,7,1,17,28262,27155,23445,-3710
2018,7,1,18,29037,27960,24564,-3396
2018,7,1,19,29558,28473,25049,-3424
2018,7,1,20,29868,28942,26157,-2785
2018,7,1,21,30111,29308,26559,-2749
2018,7,1,22,30118,29601,26607,-2994
2018,7,1,23,29707,29499,26311,-3188
2018,7,2,0,29097,28954,25792,-3162
2018,7,2,1,28614,28242,25090,-3152
2018,7,2,2,28094,27932,24402,-3530
2018,7,2,3,26623,26478,22364,-4114
2018,7,2,4,24725,24667,20482,-4185
2018,7,2,5,21898,23037,19325,-3712
2018,7,2,6,20786,21835,17638,-4197
2018,7,2,7,20092,20940,16964,-3976
2018,7,2,8,19685,20397,16597,-3800
2018,7,2,9,19614,20214,16453,-3761
2018,7,2,10,20012,20519,16997,-3522
2018,7,2,11,21244,21800,18228,-3572
2018,7,2,12,23192,23931,19894,-4037
2018,7,2,13,24994,25726,21078,-4648
2018,7,2,14,26639,27469,22823,-4646
2018,7,2,15,28117,28943,24473,-4470
2018,7,2,16,29253,29983,25715,-4268
2018,7,2,17,30058,30628,26673,-3955
2018,7,2,18,30707,31111,27784,-3327
2018,7,2,19,31086,31290,27896,-3394
2018,7,2,20,31254,31293,27863,-3430
2018,7,2,21,31288,31191,28211,-2980
2018,7,2,22,30981,31017,28030,-2987
2018,7,2,23,30158,30445,27495,-2950
2018,7,3,0,29329,29655,26912,-2743
2018,7,3,1,28561,28810,26385,-2425
2018,7,3,2,27790,28161,25230,-2931
2018,7,3,3,26130,26490,22766,-3724
2018,7,3,4,24112,24519,20908,-3611
2018,7,3,5,21142,22859,19251,-3608
2018,7,3,6,19897,21612,17929,-3683
2018,7,3,7,19122,20836,17228,-3608
2018,7,3,8,18659,20319,16926,-3393
2018,7,3,9,18542,20241,16540,-3701
2018,7,3,10,18890,20649,17162,-3487
2018,7,3,11,20071,21815,18293,-3522
2018,7,3,12,21914,23571,19642,-3929
2018,7,3,13,23635,25196,21180,-4016
2018,7,3,14,25153,26668,22784,-3884
2018,7,3,15,26512,27984,23985,-3999
2018,7,3,16,27576,29070,25247,-3823
2018,7,3,17,28335,29845,26165,-3680
2018,7,3,18,28969,30450,27005,-3445
2018,7,3,19,29364,30438,27103,-3335
2018,7,3,20,29570,30017,27441,-2576
2018,7,3,21,29668,29694,27597,-2097
2018,7,3,22,29431,29278,27677,-1601
2018,7,3,23,28616,28451,26838,-1613
2018,7,4,0,27686,27545,25629,-1916
2018,7,4,1,26946,26672,24422,-2250
2018,7,4,2,26266,25992,23334,-2658
2018,7,4,3,24700,24487,21332,-3155
2018,7,4,4,22703,22803,19777,-3026
2018,7,4,5,19921,21275,17533,-3742
2018,7,4,6,18802,20055,16194,-3861
2018,7,4,7,18113,19226,15262,-3964
2018,7,4,8,17701,18723,14933,-3790
2018,7,4,9,17603,18483,14810,-3673
2018,7,4,10,17786,18332,14712,-3620
2018,7,4,11,18463,18792,15581,-3211
2018,7,4,12,19765,19878,17502,-2376
2018,7,4,13,21188,21380,18522,-2858
2018,7,4,14,22459,22990,19864,-3126
2018,7,4,15,23522,24487,21774,-2713
2018,7,4,16,24339,25751,23313,-2438
2018,7,4,17,24922,26565,24222,-2343
2018,7,4,18,25415,27022,24846,-2176
2018,7,4,19,25737,27070,25108,-1962
2018,7,4,20,26035,26929,25361,-1568
2018,7,4,21,26259,26866,25553,-1313
2018,7,4,22,26187,26608,25914,-694
2018,7,4,23,25639,26044,25515,-529
2018,7,5,0,24939,25433,24058,-1375
2018,7,5,1,24171,24929,23246,-1683
2018,7,5,2,23722,24627,22615,-2012
2018,7,5,3,22624,23872,21143,-2729
2018,7,5,4,21304,22798,20354,-2444
2018,7,5,5,20733,21498,18154,-3344
2018,7,5,6,19688,20492,17049,-3443
2018,7,5,7,18937,19790,15987,-3803
2018,7,5,8,18498,19436,15137,-4299
2018,7,5,9,18400,19376,14977,-4399
2018,7,5,10,18768,19737,15106,-4631
2018,7,5,11,19929,21023,16484,-4539
2018,7,5,12,21697,22870,18665,-4205
2018,7,5,13,23303,24520,20869,-3651
2018,7,5,14,24681,25958,22453,-3505
2018,7,5,15,25875,27230,24166,-3064
2018,7,5,16,26761,28272,25634,-2638
2018,7,5,17,27368,29075,26507,-2568
2018,7,5,18,27896,29794,27213,-2581
2018,7,5,19,28224,30078,27174,-2904
2018,7,5,20,28425,30245,27214,-3031
2018,7,5,21,28561,30501,27454,-3047
2018,7,5,22,28406,30474,27564,-2910
2018,7,5,23,27693,29912,27397,-2515
2018,7,6,0,26857,29083,26476,-2607
2018,7,6,1,26183,28394,25517,-2877
2018,7,6,2,25600,27767,24595,-3172
2018,7,6,3,24144,26140,22720,-3420
2018,7,6,4,22301,24282,20524,-3758
2018,7,6,5,20108,22733,18311,-4422
2018,7,6,6,19135,21582,16786,-4796
2018,7,6,7,18522,20884,16099,-4785
2018,7,6,8,18165,20387,15509,-4878
2018,7,6,9,18096,20271,15144,-5127
2018,7,6,10,18468,20649,15876,-4773
2018,7,6,11,19518,21678,17061,-4617
2018,7,6,12,20922,22959,17978,-4981
2018,7,6,13,22035,23808,19020,-4788
2018,7,6,14,22871,24336,19816,-4520
2018,7,6,15,23505,24745,20650,-4095
2018,7,6,16,23906,25046,21326,-3720
2018,7,6,17,24086,25124,21180,-3944
2018,7,6,18,24211,25260,21005,-4255
2018,7,6,19,24229,25282,21156,-4126
2018,7,6,20,24153,24940,21132,-3808
2018,7,6,21,24063,24636,20908,-3728
2018,7,6,22,23780,24374,21168,-3206
2018,7,6,23,23134,23693,20287,-3406
2018,7,7,0,22463,22822,19360,-3462
2018,7,7,1,22072,21806,18528,-3278
2018,7,7,2,21797,21194,17228,-3966
2018,7,7,3,20882,19847,15638,-4209
2018,7,7,4,19445,18316,14371,-3945
2018,7,7,5,16525,16924,13281,-3643
2018,7,7,6,15555,15893,12625,-3268
2018,7,7,7,15034,15138,11751,-3387
2018,7,7,8,14703,14623,11151,-3472
2018,7,7,9,14517,14375,11310,-3065
2018,7,7,10,14417,14243,11244,-2999
2018,7,7,11,14559,14499,11653,-2846
2018,7,7,12,15372,15357,12647,-2710
2018,7,7,13,16480,16330,13211,-3119
2018,7,7,14,17403,17017,13674,-3343
2018,7,7,15,18101,17626,14097,-3529
2018,7,7,16,18515,17980,14457,-3523
2018,7,7,17,18745,18213,15080,-3133
2018,7,7,18,18914,18495,14972,-3523
2018,7,7,19,19095,18803,14708,-4095
2018,7,7,20,19210,19131,15188,-3943
2018,7,7,21,19395,19504,15290,-4214
2018,7,7,22,19482,19804,15761,-4043
2018,7,7,23,19241,19762,15819,-3943
2018,7,8,0,18824,19274,15655,-3619
2018,7,8,1,18782,18666,15229,-3437
2018,7,8,2,18758,18436,15147,-3289
2018,7,8,3,18111,17557,14365,-3192
2018,7,8,4,17185,16461,13382,-3079
2018,7,8,5,16020,15492,12301,-3191
2018,7,8,6,15185,14790,11335,-3455
2018,7,8,7,14586,14252,10904,-3348
2018,7,8,8,14188,13880,10813,-3067
2018,7,8,9,13930,13700,10736,-2964
2018,7,8,10,13709,13565,10965,-2600
2018,7,8,11,13704,13793,11077,-2716
2018,7,8,12,14463,14553,11867,-2686
2018,7,8,13,15708,15570,12588,-2982
2018,7,8,14,16894,16619,13581,-3038
2018,7,8,15,17940,17565,14005,-3560
2018,7,8,16,18750,18355,14807,-3548
2018,7,8,17,19364,18972,14928,-4044
2018,7,8,18,19843,19492,15560,-3932
2018,7,8,19,20261,20026,15951,-4075
2018,7,8,20,20556,20630,16254,-4376
2018,7,8,21,20873,21298,17137,-4161
2018,7,8,22,21015,21755,17563,-4192
2018,7,8,23,20733,21788,18181,-3607
2018,7,9,0,20233,21365,17839,-3526
2018,7,9,1,20135,20740,17113,-3627
2018,7,9,2,19929,20437,16791,-3646
2018,7,9,3,18973,19270,15417,-3853
2018,7,9,4,17752,17852,14611,-3241
2018,7,9,5,16363,16701,13303,-3398
2018,7,9,6,15494,15878,12650,-3228
2018,7,9,7,14903,15315,12244,-3071
2018,7,9,8,14563,15019,11961,-3058
2018,7,9,9,14539,15086,12526,-2560
2018,7,9,10,15004,15629,13047,-2582
2018,7,9,11,16255,16880,13600,-3280
2018,7,9,12,18074,18566,15532,-3034
2018,7,9,13,19605,19945,16223,-3722
2018,7,9,14,20904,21120,17103,-4017
2018,7,9,15,22107,22271,17856,-4415
2018,7,9,16,23068,23182,18745,-4437
2018,7,9,17,23817,23935,19419,-4516
2018,7,9,18,24539,24722,19983,-4739
2018,7,9,19,25084,25416,20709,-4707
2018,7,9,20,25419,26046,21080,-4966
2018,7,9,21,25671,26559,22023,-4536
2018,7,9,22,25575,26769,22366,-4403
2018,7,9,23,24870,26271,22183,-4088
2018,7,10,0,23997,25328,21929,-3399
2018,7,10,1,23492,24315,20646,-3669
2018,7,10,2,22861,23648,19458,-4190
2018,7,10,3,21324,22036,18027,-4009
2018,7,10,4,19573,20182,16501,-3681
2018,7,10,5,18161,18608,14573,-4035
2018,7,10,6,17181,17558,13668,-3890
2018,7,10,7,16503,16854,12939,-3915
2018,7,10,8,16110,16443,12735,-3708
2018,7,10,9,16046,16436,13013,-3423
2018,7,10,10,16501,16867,13551,-3316
2018,7,10,11,17778,18149,14793,-3356
2018,7,10,12,19581,19928,16180,-3748
2018,7,10,13,21079,21532,17239,-4293
2018,7,10,14,22326,22876,18386,-4490
2018,7,10,15,23487,24097,19814,-4283
2018,7,10,16,24445,25180,21012,-4168
2018,7,10,17,25153,26017,22305,-3712
2018,7,10,18,25829,26903,23117,-3786
2018,7,10,19,26326,27608,24322,-3286
2018,7,10,20,26630,28140,24837,-3303
2018,7,10,21,26851,28544,25201,-3343
2018,7,10,22,26734,28602,25078,-3524
2018,7,10,23,26014,28132,24916,-3216
2018,7,11,0,25128,27184,23579,-3605
2018,7,11,1,24601,26277,22242,-4035
2018,7,11,2,23983,25582,21535,-4047
2018,7,11,3,22442,23897,19586,-4311
2018,7,11,4,20578,21955,17981,-3974
2018,7,11,5,18952,20409,15966,-4443
2018,7,11,6,17977,19311,15029,-4282
2018,7,11,7,17357,18520,14213,-4307
2018,7,11,8,16999,18028,13787,-4241
2018,7,11,9,16948,17888,13754,-4134
2018,7,11,10,17391,18251,13947,-4304
2018,7,11,11,18569,19359,15241,-4118
2018,7,11,12,20116,20970,17069,-3901
2018,7,11,13,21307,22219,18627,-3592
2018,7,11,14,22219,23174,19595,-3579
2018,7,11,15,23014,24035,20716,-3319
2018,7,11,16,23602,24690,21374,-3316
2018,7,11,17,24008,25167,21866,-3301
2018,7,11,18,24422,25701,22318,-3383
2018,7,11,19,24719,26110,23000,-3110
2018,7,11,20,24890,26426,23395,-3031
2018,7,11,21,25031,26626,23748,-2878
2018,7,11,22,24914,26471,23799,-2672
2018,7,11,23,24292,25807,22823,-2984
2018,7,12,0,23559,24812,21669,-3143
2018,7,12,1,23211,23897,20848,-3049
2018,7,12,2,22759,23283,19692,-3591
2018,7,12,3,21467,21725,17657,-4068
2018,7,12,4,19829,19901,15743,-4158
2018,7,12,5,17895,18505,14652,-3853
2018,7,12,6,16911,17528,13537,-3991
2018,7,12,7,16300,16826,12711,-4115
2018,7,12,8,15958,16453,12570,-3883
2018,7,12,9,15921,16450,12413,-4037
2018,7,12,10,16363,16822,12789,-4033
2018,7,12,11,17541,17889,14407,-3482
2018,7,12,12,19125,19241,15706,-3535
2018,7,12,13,20368,20349,16891,-3458
2018,7,12,14,21355,21208,17495,-3713
2018,7,12,15,22231,21925,18068,-3857
2018,7,12,16,22881,22586,18596,-3990
2018,7,12,17,23361,23168,19256,-3912
2018,7,12,18,23859,23863,19619,-4244
2018,7,12,19,24242,24482,19887,-4595
2018,7,12,20,24484,25055,20274,-4781
2018,7,12,21,24686,25470,20924,-4546
2018,7,12,22,24616,25556,21411,-4145
2018,7,12,23,24006,25002,21310,-3692
2018,7,13,0,23270,24135,20551,-3584
2018,7,13,1,22941,23298,19543,-3755
2018,7,13,2,22499,22727,18776,-3951
2018,7,13,3,21200,21293,17109,-4184
2018,7,13,4,19608,19548,15830,-3718
2018,7,13,5,17871,18121,14610,-3511
2018,7,13,6,16843,17144,13496,-3648
2018,7,13,7,16174,16460,12520,-3940
2018,7,13,8,15783,16067,12240,-3827
2018,7,13,9,15712,16031,12378,-3653
2018,7,13,10,16129,16431,12539,-3892
2018,7,13,11,17302,17600,14089,-3511
2018,7,13,12,18985,19314,15566,-3748
2018,7,13,13,20413,20727,16595,-4132
2018,7,13,14,21589,21841,17917,-3924
2018,7,13,15,22622,22934,18993,-3941
2018,7,13,16,23449,23902,19307,-4595
2018,7,13,17,24039,24558,19764,-4794
2018,7,13,18,24610,25118,20375,-4743
2018,7,13,19,25026,25639,21040,-4599
2018,7,13,20,25247,26059,21243,-4816
2018,7,13,21,25364,26324,21161,-5163
2018,7,13,22,25111,26201,21346,-4855
2018,7,13,23,24309,25398,20943,-4455
2018,7,14,0,23396,24398,19957,-4441
2018,7,14,1,22932,23516,18799,-4717
2018,7,14,2,22521,22989,18347,-4642
2018,7,14,3,21337,21678,17042,-4636
2018,7,14,4,19787,20188,16403,-3785
2018,7,14,5,18183,18747,14650,-4097
2018,7,14,6,17204,17727,13659,-4068
2018,7,14,7,16524,17001,12983,-4018
2018,7,14,8,16071,16564,12702,-3862
2018,7,14,9,15815,16332,12667,-3665
2018,7,14,10,15708,16325,12863,-3462
2018,7,14,11,15869,16628,13253,-3375
2018,7,14,12,16876,17711,13935,-3776
2018,7,14,13,18353,19138,15096,-4042
2018,7,14,14,19716,20525,15827,-4698
2018,7,14,15,20871,21860,16667,-5193
2018,7,14,16,21751,22961,17902,-5059
2018,7,14,17,22351,23851,18835,-5016
2018,7,14,18,22785,24382,19061,-5321
2018,7,14,19,23148,24743,19510,-5233
2018,7,14,20,23395,25055,19815,-5240
2018,7,14,21,23615,25248,20182,-5066
2018,7,14,22,23631,25126,20521,-4605
2018,7,14,23,23269,24752,20151,-4601
2018,7,15,0,22638,24182,19503,-4679
2018,7,15,1,22363,23786,18879,-4907
2018,7,15,2,22179,23469,18544,-4925
2018,7,15,3,21264,22457,17145,-5312
2018,7,15,4,20077,21150,16182,-4968
2018,7,15,5,19617,19721,14708,-5013
2018,7,15,6,18713,18577,14036,-4541
2018,7,15,7,17999,17894,13406,-4488
2018,7,15,8,17514,17385,13098,-4287
2018,7,15,9,17209,17105,12653,-4452
2018,7,15,10,17005,16978,12537,-4441
2018,7,15,11,16992,17030,13120,-3910
2018,7,15,12,17836,17610,13841,-3769
2018,7,15,13,19267,18720,14766,-3954
2018,7,15,14,20688,19909,15849,-4060
2018,7,15,15,21947,20981,16539,-4442
2018,7,15,16,22901,21775,17261,-4514
2018,7,15,17,23628,22386,18052,-4334
2018,7,15,18,24140,23015,18538,-4477
2018,7,15,19,24539,23681,19577,-4104
2018,7,15,20,24835,24259,20149,-4110
2018,7,15,21,25134,25047,20923,-4124
2018,7,15,22,25276,25685,21660,-4025
2018,7,15,23,24990,25689,21759,-3930
2018,7,16,0,24429,25221,21525,-3696
2018,7,16,1,24176,24682,20511,-4171
2018,7,16,2,23869,24435,20041,-4394
2018,7,16,3,22712,23168,18317,-4851
2018,7,16,4,21279,21550,17056,-4494
2018,7,16,5,20132,20166,15285,-4881
2018,7,16,6,19146,19211,14055,-5156
2018,7,16,7,18452,18509,13888,-4621
2018,7,16,8,18046,18138,13627,-4511
2018,7,16,9,18009,18146,13501,-4645
2018,7,16,10,18526,18707,14070,-4637
2018,7,16,11,19787,19968,15502,-4466
2018,7,16,12,21689,21918,17072,-4846
2018,7,16,13,23385,23792,18625,-5167
2018,7,16,14,24842,25458,20848,-4610
2018,7,16,15,26140,27049,22265,-4784
2018,7,16,16,27171,28351,23749,-4602
2018,7,16,17,27904,29388,24759,-4629
2018,7,16,18,28560,30126,25326,-4800
2018,7,16,19,29002,30321,25825,-4496
2018,7,16,20,29277,30524,26440,-4084
2018,7,16,21,29451,30838,26878,-3960
2018,7,16,22,29306,30486,26632,-3854
2018,7,16,23,28568,29589,26056,-3533
2018,7,17,0,27669,28766,25279,-3487
2018,7,17,1,27035,28096,24678,-3418
2018,7,17,2,26330,27302,23710,-3592
2018,7,17,3,24660,25559,21741,-3818
2018,7,17,4,22674,23658,19564,-4094
2018,7,17,5,20918,22135,17416,-4719
2018,7,17,6,19880,21040,16476,-4564
2018,7,17,7,19207,20250,15521,-4729
2018,7,17,8,18820,19751,15067,-4684
2018,7,17,9,18781,19743,15120,-4623
2018,7,17,10,19292,20308,15725,-4583
2018,7,17,11,20517,21522,17045,-4477
2018,7,17,12,22187,23231,18568,-4663
2018,7,17,13,23573,24661,20097,-4564
2018,7,17,14,24690,25784,21271,-4513
2018,7,17,15,25643,26918,22702,-4216
2018,7,17,16,26339,27735,23928,-3807
2018,7,17,17,26802,28262,24615,-3647
2018,7,17,18,27177,28513,25136,-3377
2018,7,17,19,27377,28211,25170,-3041
2018,7,17,20,27431,27021,24032,-2989
2018,7,17,21,27406,26479,23656,-2823
2018,7,17,22,27121,26092,23483,-2609
2018,7,17,23,26361,25341,22656,-2685
2018,7,18,0,25550,24560,21703,-2857
2018,7,18,1,25051,23851,20561,-3290
2018,7,18,2,24472,23265,19286,-3979
2018,7,18,3,23051,21853,17877,-3976
2018,7,18,4,21219,20313,16252,-4061
2018,7,18,5,18529,18884,14617,-4267
2018,7,18,6,17501,17904,13435,-4469
2018,7,18,7,16885,17301,12888,-4413
2018,7,18,8,16527,16836,12629,-4207
2018,7,18,9,16488,16720,12532,-4188
2018,7,18,10,16947,17084,12901,-4183
2018,7,18,11,18064,18148,14093,-4055
2018,7,18,12,19597,19675,15191,-4484
2018,7,18,13,20833,20788,15845,-4943
2018,7,18,14,21792,21622,16169,-5453
2018,7,18,15,22629,22359,17133,-5226
2018,7,18,16,23232,22978,17914,-5064
2018,7,18,17,23660,23402,18299,-5103
2018,7,18,18,24107,23829,19068,-4761
2018,7,18,19,24428,24146,19403,-4743
2018,7,18,20,24641,24547,20056,-4491
2018,7,18,21,24813,24910,20451,-4459
2018,7,18,22,24740,25021,20872,-4149
2018,7,18,23,24123,24481,20355,-4126
2018,7,19,0,23375,23585,19481,-4104
2018,7,19,1,23034,22673,18230,-4443
2018,7,19,2,22606,22055,17383,-4672
2018,7,19,3,21314,20548,16106,-4442
2018,7,19,4,19641,18877,14385,-4492
2018,7,19,5,16870,17459,12968,-4491
2018,7,19,6,15883,16516,11929,-4587
2018,7,19,7,15297,15839,11421,-4418
2018,7,19,8,14973,15451,11094,-4357
2018,7,19,9,14968,15436,11266,-4170
2018,7,19,10,15459,15866,11603,-4263
2018,7,19,11,16615,16928,13173,-3755
2018,7,19,12,18165,18398,14498,-3900
2018,7,19,13,19392,19487,15434,-4053
2018,7,19,14,20354,20339,15978,-4361
2018,7,19,15,21194,21017,16126,-4891
2018,7,19,16,21803,21646,16745,-4901
2018,7,19,17,22249,22124,17038,-5086
2018,7,19,18,22733,22689,17494,-5195
2018,7,19,19,23116,23251,18248,-5003
2018,7,19,20,23385,23835,19198,-4637
2018,7,19,21,23614,24353,19541,-4812
2018,7,19,22,23576,24585,19581,-5004
2018,7,19,23,22984,24170,19537,-4633
2018,7,20,0,22265,23286,18849,-4437
2018,7,20,1,21981,22436,17742,-4694
2018,7,20,2,21566,21868,16941,-4927
2018,7,20,3,20280,20437,15443,-4994
2018,7,20,4,18754,18869,14723,-4146
2018,7,20,5,17433,17573,13645,-3928
2018,7,20,6,16449,16671,12327,-4344
2018,7,20,7,15780,16095,11843,-4252
2018,7,20,8,15392,15758,11694,-4064
2018,7,20,9,15344,15764,11902,-3862
2018,7,20,10,15810,16255,12473,-3782
2018,7,20,11,16944,17418,14015,-3403
2018,7,20,12,18601,19106,15496,-3610
2018,7,20,13,20045,20545,16500,-4045
2018,7,20,14,21246,21695,17071,-4624
2018,7,20,15,22299,22598,17970,-4628
2018,7,20,16,23130,23380,18340,-5040
2018,7,20,17,23728,23922,18425,-5497
2018,7,20,18,24302,24475,19095,-5380
2018,7,20,19,24714,24797,19399,-5398
2018,7,20,20,24938,25172,20064,-5108
2018,7,20,21,25023,25461,20732,-4729
2018,7,20,22,24727,25378,20851,-4527
2018,7,20,23,23883,24684,20572,-4112
2018,7,21,0,22955,23693,19361,-4332
2018,7,21,1,22491,22757,18382,-4375
2018,7,21,2,22066,22135,17897,-4238
2018,7,21,3,20871,20805,16400,-4405
2018,7,21,4,19295,19326,15817,-3509
2018,7,21,5,17154,17994,13955,-4039
2018,7,21,6,16173,17073,12948,-4125
2018,7,21,7,15546,16354,12644,-3710
2018,7,21,8,15140,15862,12311,-3551
2018,7,21,9,14946,15594,12034,-3560
2018,7,21,10,14915,15553,12070,-3483
2018,7,21,11,15015,15880,12523,-3357
2018,7,21,12,15855,16850,13455,-3395
2018,7,21,13,17120,18072,14087,-3985
2018,7,21,14,18195,19033,14763,-4270
2018,7,21,15,19003,19782,15075,-4707
2018,7,21,16,19572,20310,15495,-4815
2018,7,21,17,19869,20560,15915,-4645
2018,7,21,18,20025,20803,16464,-4339
2018,7,21,19,20145,20954,16705,-4249
2018,7,21,20,20189,20963,16820,-4143
2018,7,21,21,20237,20913,16827,-4086
2018,7,21,22,20156,20724,16870,-3854
2018,7,21,23,19822,20294,16862,-3432
2018,7,22,0,19315,19869,16241,-3628
2018,7,22,1,19176,19707,16029,-3678
2018,7,22,2,19046,19347,15399,-3948
2018,7,22,3,18305,18529,14816,-3713
2018,7,22,4,17407,17562,13898,-3664
2018,7,22,5,17863,16731,12809,-3922
2018,7,22,6,16946,16116,12220,-3896
2018,7,22,7,16176,15750,12135,-3615
2018,7,22,8,15658,15572,11811,-3761
2018,7,22,9,15359,15567,11934,-3633
2018,7,22,10,15206,15658,12035,-3623
2018,7,22,11,15155,15803,12537,-3266
2018,7,22,12,15946,16344,13209,-3135
2018,7,22,13,17361,17307,13665,-3642
2018,7,22,14,18730,18383,14567,-3816
2018,7,22,15,19878,19342,15619,-3723
2018,7,22,16,20684,20229,16413,-3816
2018,7,22,17,21266,21097,17185,-3912
2018,7,22,18,21655,21584,17394,-4190
2018,7,22,19,21970,22034,17382,-4652
2018,7,22,20,22236,22460,18129,-4331
2018,7,22,21,22541,23009,18736,-4273
2018,7,22,22,22721,23277,18719,-4558
2018,7,22,23,22486,23011,18368,-4643
2018,7,23,0,21970,22722,18167,-4555
2018,7,23,1,21852,22614,18010,-4604
2018,7,23,2,21643,22449,17554,-4895
2018,7,23,3,20520,21486,16568,-4918
2018,7,23,4,19200,20267,15541,-4726
2018,7,23,5,19373,19198,15235,-3963
2018,7,23,6,18579,18458,14700,-3758
2018,7,23,7,17949,17962,13870,-4092
2018,7,23,8,17598,17738,13723,-4015
2018,7,23,9,17632,17860,13640,-4220
2018,7,23,10,18270,18581,14344,-4237
2018,7,23,11,19535,19815,15666,-4149
2018,7,23,12,21249,21305,17072,-4233
2018,7,23,13,22675,22496,17888,-4608
2018,7,23,14,23797,23434,18404,-5030
2018,7,23,15,24701,24323,19764,-4559
2018,7,23,16,25345,25085,20516,-4569
2018,7,23,17,25743,25492,21152,-4340
2018,7,23,18,26084,26050,22189,-3861
2018,7,23,19,26277,26588,22768,-3820
2018,7,23,20,26387,26865,23043,-3822
2018,7,23,21,26470,27032,23243,-3789
2018,7,23,22,26339,26879,23416,-3463
2018,7,23,23,25737,26216,22994,-3222
2018,7,24,0,24993,25490,22488,-3002
2018,7,24,1,24493,25024,21842,-3182
2018,7,24,2,23897,24394,20939,-3455
2018,7,24,3,22408,22963,18667,-4296
2018,7,24,4,20727,21357,17367,-3990
2018,7,24,5,20104,20048,15808,-4240
2018,7,24,6,19172,19170,15193,-3977
2018,7,24,7,18484,18570,14787,-3783
2018,7,24,8,18093,18275,14380,-3895
2018,7,24,9,18087,18343,14334,-4009
2018,7,24,10,18675,19022,15044,-3978
2018,7,24,11,19931,20387,16626,-3761
2018,7,24,12,21620,22128,18062,-4066
2018,7,24,13,23023,23551,19133,-4418
2018,7,24,14,24129,24727,20176,-4551
2018,7,24,15,25042,25673,21584,-4089
2018,7,24,16,25697,26396,22111,-4285
2018,7,24,17,26120,26858,22648,-4210
2018,7,24,18,26492,27258,23051,-4207
2018,7,24,19,26716,27539,23296,-4243
2018,7,24,20,26851,27745,23981,-3764
2018,7,24,21,26933,27947,24482,-3465
2018,7,24,22,26777,27899,24533,-3366
2018,7,24,23,26111,27183,23881,-3302
2018,7,25,0,25319,26307,23118,-3189
2018,7,25,1,24824,25777,22725,-3052
2018,7,25,2,24240,25198,22013,-3185
2018,7,25,3,22746,23782,19583,-4199
2018,7,25,4,21025,22022,17718,-4304
2018,7,25,5,19956,20635,16184,-4451
2018,7,25,6,19048,19754,15302,-4452
2018,7,25,7,18400,19154,14862,-4292
2018,7,25,8,18027,18822,14405,-4417
2018,7,25,9,18018,18905,14449,-4456
2018,7,25,10,18596,19540,14837,-4703
2018,7,25,11,19778,20705,16259,-4446
2018,7,25,12,21302,21968,17418,-4550
2018,7,25,13,22513,22998,18300,-4698
2018,7,25,14,23419,23741,19288,-4453
2018,7,25,15,24109,24319,20225,-4094
2018,7,25,16,24596,24657,20484,-4173
2018,7,25,17,24845,25003,20835,-4168
2018,7,25,18,25074,25287,21235,-4052
2018,7,25,19,25184,25555,21544,-4011
2018,7,25,20,25241,25580,21707,-3873
2018,7,25,21,25285,25546,21382,-4164
2018,7,25,22,25135,25434,21428,-4006
2018,7,25,23,24563,24898,21293,-3605
2018,7,26,0,23880,24359,20496,-3863
2018,7,26,1,23500,24026,19925,-4101
2018,7,26,2,23028,23466,19246,-4220
2018,7,26,3,21719,22042,17344,-4698
2018,7,26,4,20192,20439,15577,-4862
2018,7,26,5,19396,19117,14387,-4730
2018,7,26,6,18422,18143,13549,-4594
2018,7,26,7,17723,17586,13161,-4425
2018,7,26,8,17323,17267,12997,-4270
2018,7,26,9,17297,17298,12903,-4395
2018,7,26,10,17859,17981,13432,-4549
2018,7,26,11,19040,19218,14789,-4429
2018,7,26,12,20694,20803,15974,-4829
2018,7,26,13,22127,22028,16821,-5207
2018,7,26,14,23292,23003,17620,-5383
2018,7,26,15,24282,23846,18699,-5147
2018,7,26,16,24983,24477,19588,-4889
2018,7,26,17,25504,25000,20110,-4890
2018,7,26,18,25995,25769,20801,-4968
2018,7,26,19,26330,26486,21343,-5143
2018,7,26,20,26560,27112,21843,-5269
2018,7,26,21,26711,27668,22339,-5329
2018,7,26,22,26586,27808,22657,-5151
2018,7,26,23,25890,27294,22512,-4782
2018,7,27,0,25068,26361,21863,-4498
2018,7,27,1,24636,25685,21128,-4557
2018,7,27,2,24103,24985,20046,-4939
2018,7,27,3,22642,23352,18259,-5093
2018,7,27,4,20902,21551,16593,-4958
2018,7,27,5,19504,20016,15323,-4693
2018,7,27,6,18496,18917,14538,-4379
2018,7,27,7,17812,18175,14091,-4084
2018,7,27,8,17410,17720,13877,-3843
2018,7,27,9,17373,17661,13956,-3705
2018,7,27,10,17888,18183,14128,-4055
2018,7,27,11,18981,19389,15445,-3944
2018,7,27,12,20566,21071,16936,-4135
2018,7,27,13,21992,22688,18318,-4370
2018,7,27,14,23158,24077,19725,-4352
2018,7,27,15,24142,25317,20767,-4550
2018,7,27,16,24883,26201,21805,-4396
2018,7,27,17,25373,26725,22232,-4493
2018,7,27,18,25802,27179,22435,-4744
2018,7,27,19,26056,27368,22969,-4399
2018,7,27,20,26170,27122,23118,-4004
2018,7,27,21,26140,27016,23286,-3730
2018,7,27,22,25779,26531,22852,-3679
2018,7,27,23,24932,25463,22282,-3181
2018,7,28,0,24019,24439,21413,-3026
2018,7,28,1,23540,23547,20671,-2876
2018,7,28,2,23104,22636,19543,-3093
2018,7,28,3,21913,21326,17595,-3731
2018,7,28,4,20385,19927,16097,-3830
2018,7,28,5,19046,18626,14465,-4161
2018,7,28,6,18063,17730,13639,-4091
2018,7,28,7,17391,17038,13217,-3821
2018,7,28,8,16946,16587,12854,-3733
2018,7,28,9,16736,16325,12475,-3850
2018,7,28,10,16721,16368,12586,-3782
2018,7,28,11,16788,16648,12923,-3725
2018,7,28,12,17655,17743,14103,-3640
2018,7,28,13,19049,19178,15540,-3638
2018,7,28,14,20300,20487,16495,-3992
2018,7,28,15,21314,21507,17245,-4262
2018,7,28,16,21974,22307,17991,-4316
2018,7,28,17,22412,22892,18621,-4271
2018,7,28,18,22679,23369,19285,-4084
2018,7,28,19,22883,23822,20030,-3792
2018,7,28,20,23032,24007,20389,-3618
2018,7,28,21,23141,24214,20506,-3708
2018,7,28,22,23100,24239,20671,-3568
2018,7,28,23,22708,23927,20075,-3852
2018,7,29,0,22100,23231,19032,-4199
2018,7,29,1,21915,22896,18562,-4334
2018,7,29,2,21769,22514,18099,-4415
2018,7,29,3,20895,21338,17158,-4180
2018,7,29,4,19652,19975,15686,-4289
2018,7,29,5,17672,18666,14504,-4162
2018,7,29,6,16752,17624,14046,-3578
2018,7,29,7,16129,16822,13288,-3534
2018,7,29,8,15715,16314,12356,-3958
2018,7,29,9,15496,15993,12154,-3839
2018,7,29,10,15394,15800,11944,-3856
2018,7,29,11,15285,15766,12067,-3699
2018,7,29,12,15936,16449,12953,-3496
2018,7,29,13,17185,17498,13788,-3710
2018,7,29,14,18382,18523,14388,-4135
2018,7,29,15,19408,19367,15314,-4053
2018,7,29,16,20207,20053,15907,-4146
2018,7,29,17,20781,20501,16417,-4084
2018,7,29,18,21190,20947,16745,-4202
2018,7,29,19,21515,21450,17093,-4357
2018,7,29,20,21789,21915,17467,-4448
2018,7,29,21,22044,22397,18108,-4289
2018,7,29,22,22153,22751,18459,-4292
2018,7,29,23,21871,22606,18153,-4453
2018,7,30,0,21367,22051,17873,-4178
2018,7,30,1,21258,21821,17459,-4362
2018,7,30,2,21027,21522,17102,-4420
2018,7,30,3,20028,20337,16304,-4033
2018,7,30,4,18780,18959,15147,-3812
2018,7,30,5,17293,17811,13817,-3994
2018,7,30,6,16415,17003,13076,-3927
2018,7,30,7,15837,16395,12587,-3808
2018,7,30,8,15514,16062,12278,-3784
2018,7,30,9,15557,16094,12369,-3725
2018,7,30,10,16156,16647,12837,-3810
2018,7,30,11,17265,17730,13845,-3885
2018,7,30,12,18853,19266,15116,-4150
2018,7,30,13,20263,20599,16510,-4089
2018,7,30,14,21426,21643,17695,-3948
2018,7,30,15,22439,22486,18101,-4385
2018,7,30,16,23254,23015,18334,-4681
2018,7,30,17,23838,23328,18762,-4566
2018,7,30,18,24383,23544,19018,-4526
2018,7,30,19,24753,23469,18836,-4633
2018,7,30,20,25001,23507,18906,-4601
2018,7,30,21,25142,23601,18933,-4668
2018,7,30,22,24991,23640,19066,-4574
2018,7,30,23,24329,23212,18546,-4666
2018,7,31,0,23517,22613,17803,-4810
2018,7,31,1,23080,22286,17497,-4789
2018,7,31,2,22473,21726,16987,-4739
2018,7,31,3,21011,20307,15625,-4682
2018,7,31,4,19369,18834,14273,-4561
2018,7,31,5,17900,17546,13485,-4061
2018,7,31,6,16997,16732,12363,-4369
2018,7,31,7,16373,16180,12071,-4109
2018,7,31,8,16022,15863,12185,-3678
2018,7,31,9,16039,15977,12240,-3737
2018,7,31,10,16638,16641,12423,-4218
2018,7,31,11,17777,17859,13713,-4146
2018,7,31,12,19297,19492,15392,-4100
2018,7,31,13,20589,20796,16159,-4637
2018,7,31,14,21611,21797,16789,-5008
2018,7,31,15,22465,22709,17324,-5385
2018,7,31,16,23110,23485,18053,-5432
2018,7,31,17,23579,24101,18727,-5374
2018,7,31,18,24032,24715,19491,-5224
2018,7,31,19,24349,25123,20086,-5037
2018,7,31,20,24592,25466,20675,-4791
2018,7,31,21,24778,25680,20727,-4953
2018,7,31,22,24705,25493,20724,-4769
2018,7,31,23,24126,24693,20463,-4230
2018,8,1,0,23373,23936,20222,-3714
2018,8,1,1,22977,23642,19600,-4042
2018,8,1,2,22444,23028,18636,-4392
2018,8,1,3,21037,21624,16960,-4664
2018,8,1,4,19502,20050,15478,-4572
2018,8,1,5,18879,18814,14528,-4286
2018,8,1,6,17947,17982,13566,-4416
2018,8,1,7,17239,17513,12923,-4590
2018,8,1,8,16832,17320,12786,-4534
2018,8,1,9,16828,17426,12938,-4488
2018,8,1,10,17455,18217,13726,-4491
2018,8,1,11,18665,19541,15221,-4320
2018,8,1,12,20332,21103,16390,-4713
2018,8,1,13,21791,22386,17102,-5284
2018,8,1,14,22971,23472,18260,-5212
2018,8,1,15,23959,24311,19332,-4979
2018,8,1,16,24698,25044,20072,-4972
2018,8,1,17,25222,25699,20861,-4838
2018,8,1,18,25717,26318,21417,-4901
2018,8,1,19,26052,26634,21830,-4804
2018,8,1,20,26318,27157,22116,-5041
2018,8,1,21,26480,27709,22535,-5174
2018,8,1,22,26338,27876,22750,-5126
2018,8,1,23,25630,27367,22757,-4610
2018,8,2,0,24784,26565,22165,-4400
2018,8,2,1,24307,26204,21419,-4785
2018,8,2,2,23724,25616,20910,-4706
2018,8,2,3,22186,24097,18805,-5292
2018,8,2,4,20470,22360,16979,-5381
2018,8,2,5,20015,20921,15563,-5358
2018,8,2,6,19065,19855,14961,-4894
2018,8,2,7,18350,19151,14094,-5057
2018,8,2,8,17935,18742,13804,-4938
2018,8,2,9,17935,18696,14020,-4676
2018,8,2,10,18558,19294,14467,-4827
2018,8,2,11,19748,20479,15897,-4582
2018,8,2,12,21404,22015,17333,-4682
2018,8,2,13,22883,23469,19138,-4331
2018,8,2,14,24101,24683,20280,-4403
2018,8,2,15,25133,25785,21589,-4196
2018,8,2,16,25895,26753,22738,-4015
2018,8,2,17,26428,27417,23290,-4127
2018,8,2,18,26901,28026,23937,-4089
2018,8,2,19,27191,28473,24453,-4020
2018,8,2,20,27401,28436,24614,-3822
2018,8,2,21,27477,28419,24613,-3806
2018,8,2,22,27263,28287,24418,-3869
2018,8,2,23,26535,27762,24218,-3544
2018,8,3,0,25703,26830,23390,-3440
2018,8,3,1,25207,26346,22722,-3624
2018,8,3,2,24598,25651,21923,-3728
2018,8,3,3,23059,24077,19825,-4252
2018,8,3,4,21295,22386,17697,-4689
2018,8,3,5,20238,20875,16073,-4802
2018,8,3,6,19285,19828,15383,-4445
2018,8,3,7,18616,19148,14723,-4425
2018,8,3,8,18226,18794,14279,-4515
2018,8,3,9,18217,18806,14408,-4398
2018,8,3,10,18789,19418,14719,-4699
2018,8,3,11,19863,20630,16155,-4475
2018,8,3,12,21373,22148,17604,-4544
2018,8,3,13,22752,23431,19046,-4385
2018,8,3,14,23876,24613,20155,-4458
2018,8,3,15,24788,25582,21455,-4127
2018,8,3,16,25425,26351,22521,-3830
2018,8,3,17,25836,26885,23061,-3824
2018,8,3,18,26187,27297,23705,-3592
2018,8,3,19,26375,27266,24035,-3231
2018,8,3,20,26481,26493,23521,-2972
2018,8,3,21,26447,25937,23047,-2890
2018,8,3,22,26117,25850,23212,-2638
2018,8,3,23,25337,25446,22904,-2542
2018,8,4,0,24489,24859,22319,-2540
2018,8,4,1,24017,24469,21714,-2755
2018,8,4,2,23579,23927,20348,-3579
2018,8,4,3,22384,22694,18259,-4435
2018,8,4,4,20892,21247,16821,-4426
2018,8,4,5,19721,19924,15427,-4497
2018,8,4,6,18690,18966,14541,-4425
2018,8,4,7,17951,18231,13848,-4383
2018,8,4,8,17465,17848,13300,-4548
2018,8,4,9,17246,17690,12898,-4792
2018,8,4,10,17273,17777,13473,-4304
2018,8,4,11,17340,18066,14292,-3774
2018,8,4,12,18211,18981,15129,-3852
2018,8,4,13,19674,20255,16457,-3798
2018,8,4,14,21013,21261,17505,-3756
2018,8,4,15,22078,21997,18370,-3627
2018,8,4,16,22798,22650,19091,-3559
2018,8,4,17,23252,23205,20290,-2915
2018,8,4,18,23512,23685,20282,-3403
2018,8,4,19,23701,24090,20520,-3570
2018,8,4,20,23873,24625,21022,-3603
2018,8,4,21,23994,25206,21599,-3607
2018,8,4,22,23972,25564,21702,-3862
2018,8,4,23,23572,25337,21798,-3539
2018,8,5,0,22955,24610,21098,-3512
2018,8,5,1,22753,24079,20464,-3615
2018,8,5,2,22559,23567,19640,-3927
2018,8,5,3,21589,22307,17598,-4709
2018,8,5,4,20332,20916,16266,-4650
2018,8,5,5,19585,19569,15306,-4263
2018,8,5,6,18552,18452,14118,-4334
2018,8,5,7,17787,17619,13322,-4297
2018,8,5,8,17263,17079,12886,-4193
2018,8,5,9,16978,16771,12675,-4096
2018,8,5,10,16855,16686,12585,-4101
2018,8,5,11,16747,16717,12807,-3910
2018,8,5,12,17582,17626,13976,-3650
2018,8,5,13,19204,19204,15354,-3850
2018,8,5,14,20888,20901,16690,-4211
2018,8,5,15,22427,22449,17681,-4768
2018,8,5,16,23677,23807,18919,-4888
2018,8,5,17,24620,24828,20177,-4651
2018,8,5,18,25301,25613,21548,-4065
2018,8,5,19,25800,26234,22169,-4065
2018,8,5,20,26204,26845,22936,-3909
2018,8,5,21,26474,27352,23419,-3933
2018,8,5,22,26511,27636,24134,-3502
2018,8,5,23,26074,27428,23734,-3694
2018,8,6,0,25404,26766,22805,-3961
2018,8,6,1,25092,26477,22223,-4254
2018,8,6,2,24642,25880,21717,-4163
2018,8,6,3,23317,24350,19833,-4517
2018,8,6,4,21741,22716,17790,-4926
2018,8,6,5,20440,21355,16719,-4636
2018,8,6,6,19442,20372,15755,-4617
2018,8,6,7,18757,19635,14821,-4814
2018,8,6,8,18360,19209,14254,-4955
2018,8,6,9,18378,19193,14077,-5116
2018,8,6,10,19009,19773,14671,-5102
2018,8,6,11,20156,20887,16513,-4374
2018,8,6,12,21965,22720,17881,-4839
2018,8,6,13,23751,24493,19645,-4848
2018,8,6,14,25356,26091,21465,-4626
2018,8,6,15,26794,27623,23060,-4563
2018,8,6,16,27926,28851,24986,-3865
2018,8,6,17,28760,29809,26425,-3384
2018,8,6,18,29474,30538,26997,-3541
2018,8,6,19,29927,30889,27160,-3729
2018,8,6,20,30256,31077,27579,-3498
2018,8,6,21,30383,31248,27848,-3400
2018,8,6,22,30154,31166,27705,-3461
2018,8,6,23,29345,30565,27369,-3196
2018,8,7,0,28437,29753,26204,-3549
2018,8,7,1,27761,29194,25511,-3683
2018,8,7,2,26942,28118,24400,-3718
2018,8,7,3,25170,26165,21935,-4230
2018,8,7,4,23155,24115,19495,-4620
2018,8,7,5,21381,22500,17785,-4715
2018,8,7,6,20284,21355,16743,-4612
2018,8,7,7,19565,20565,15737,-4828
2018,8,7,8,19145,20062,15323,-4739
2018,8,7,9,19146,20001,15279,-4722
2018,8,7,10,19769,20545,16032,-4513
2018,8,7,11,20937,21673,17310,-4363
2018,8,7,12,22611,23336,19003,-4333
2018,8,7,13,24189,24824,20522,-4302
2018,8,7,14,25539,26105,21718,-4387
2018,8,7,15,26731,27287,23503,-3784
2018,8,7,16,27670,28165,24767,-3398
2018,8,7,17,28322,28934,25391,-3543
2018,8,7,18,28874,29588,26113,-3475
2018,8,7,19,29201,29905,26380,-3525
2018,8,7,20,29430,29931,26115,-3816
2018,8,7,21,29476,30103,26105,-3998
2018,8,7,22,29211,29791,26025,-3766
2018,8,7,23,28406,28925,25197,-3728
2018,8,8,0,27512,27718,24462,-3256
2018,8,8,1,26920,26662,23303,-3359
2018,8,8,2,26179,25686,22012,-3674
2018,8,8,3,24532,24078,20162,-3916
2018,8,8,4,22628,22356,18431,-3925
2018,8,8,5,21073,20920,16778,-4142
2018,8,8,6,20008,19933,15761,-4172
2018,8,8,7,19293,19196,14832,-4364
2018,8,8,8,18874,18835,14447,-4388
2018,8,8,9,18863,18835,14574,-4261
2018,8,8,10,19483,19439,15413,-4026
2018,8,8,11,20616,20502,16482,-4020
2018,8,8,12,22234,22162,18194,-3968
2018,8,8,13,23742,23692,20195,-3497
2018,8,8,14,25012,24810,20892,-3918
2018,8,8,15,26125,25997,21694,-4303
2018,8,8,16,26987,26972,22648,-4324
2018,8,8,17,27603,27691,23473,-4218
2018,8,8,18,28150,28524,24403,-4121
2018,8,8,19,28483,29095,25200,-3895
2018,8,8,20,28739,29368,25546,-3822
2018,8,8,21,28815,29577,25953,-3624
2018,8,8,22,28568,29537,25828,-3709
2018,8,8,23,27789,28645,24658,-3987
2018,8,9,0,26915,27832,24092,-3740
2018,8,9,1,26386,27514,23588,-3926
2018,8,9,2,25708,26702,22628,-4074
2018,8,9,3,24109,24988,20462,-4526
2018,8,9,4,22241,23175,18596,-4579
2018,8,9,5,20461,21652,16917,-4735
2018,8,9,6,19458,20641,16322,-4319
2018,8,9,7,18791,19684,15409,-4275
2018,8,9,8,18405,19208,14938,-4270
2018,8,9,9,18418,19133,14933,-4200
2018,8,9,10,19047,19804,15627,-4177
2018,8,9,11,20155,20911,16417,-4494
2018,8,9,12,21682,22452,17752,-4700
2018,8,9,13,23074,23774,19265,-4509
2018,8,9,14,24236,24896,20220,-4676
2018,8,9,15,25244,25866,21605,-4261
2018,8,9,16,25940,26674,22268,-4406
2018,8,9,17,26470,27305,23136,-4169
2018,8,9,18,26958,27925,24053,-3872
2018,8,9,19,27270,28426,24843,-3583
2018,8,9,20,27530,28946,25407,-3539
2018,8,9,21,27634,29166,25808,-3358
2018,8,9,22,27466,29138,25771,-3367
2018,8,9,23,26761,28363,24740,-3623
2018,8,10,0,25956,27204,23602,-3602
2018,8,10,1,25521,26488,22897,-3591
2018,8,10,2,24928,25385,21904,-3481
2018,8,10,3,23422,23591,19343,-4248
2018,8,10,4,21610,21683,17077,-4606
2018,8,10,5,19537,20044,15743,-4301
2018,8,10,6,18452,18907,14969,-3938
2018,8,10,7,17781,18114,13727,-4387
2018,8,10,8,17384,17679,13407,-4272
2018,8,10,9,17379,17556,13417,-4139
2018,8,10,10,17965,18133,13964,-4169
2018,8,10,11,19022,19157,15273,-3884
2018,8,10,12,20532,20678,16576,-4102
2018,8,10,13,21946,22079,17190,-4889
2018,8,10,14,23127,23343,17957,-5386
2018,8,10,15,24141,24433,19299,-5134
2018,8,10,16,24919,25285,20918,-4367
2018,8,10,17,25449,25957,22349,-3608
2018,8,10,18,25931,26577,23141,-3436
2018,8,10,19,26235,26962,23371,-3591
2018,8,10,20,26458,27267,23490,-3777
2018,8,10,21,26486,27462,23381,-4081
2018,8,10,22,26173,27113,23139,-3974
2018,8,10,23,25349,26155,22563,-3592
2018,8,11,0,24446,25256,21652,-3604
2018,8,11,1,23992,24736,20897,-3839
2018,8,11,2,23504,24012,20009,-4003
2018,8,11,3,22242,22644,18337,-4307
2018,8,11,4,20624,21146,16741,-4405
2018,8,11,5,18795,19879,15278,-4601
2018,8,11,6,17819,18902,14399,-4503
2018,8,11,7,17173,18154,13417,-4737
2018,8,11,8,16754,17615,12975,-4640
2018,8,11,9,16591,17355,12427,-4928
2018,8,11,10,16676,17372,12600,-4772
2018,8,11,11,16736,17651,12957,-4694
2018,8,11,12,17468,18405,14139,-4266
2018,8,11,13,18745,19338,15666,-3672
2018,8,11,14,19883,20148,16407,-3741
2018,8,11,15,20754,20798,16740,-4058
2018,8,11,16,21323,21253,17506,-3747
2018,8,11,17,21654,21576,17822,-3754
2018,8,11,18,21805,21658,17973,-3685
2018,8,11,19,21897,21618,18291,-3327
2018,8,11,20,21990,21681,18249,-3432
2018,8,11,21,22007,21727,18241,-3486
2018,8,11,22,21896,21784,18276,-3508
2018,8,11,23,21528,21650,18051,-3599
2018,8,12,0,21013,21445,17445,-4000
2018,8,12,1,20878,21389,17736,-3653
2018,8,12,2,20685,21038,17539,-3499
2018,8,12,3,19830,20099,15884,-4215
2018,8,12,4,18771,18998,14660,-4338
2018,8,12,5,18252,17985,13949,-4036
2018,8,12,6,17342,17171,13264,-3907
2018,8,12,7,16653,16620,12447,-4173
2018,8,12,8,16199,16279,12041,-4238
2018,8,12,9,15986,16065,11974,-4091
2018,8,12,10,15969,16102,12116,-3986
2018,8,12,11,15865,16207,12229,-3978
2018,8,12,12,16484,16832,13174,-3658
2018,8,12,13,17805,17957,14087,-3870
2018,8,12,14,19094,19206,15202,-4004
2018,8,12,15,20173,20415,16350,-4065
2018,8,12,16,20976,21423,17208,-4215
2018,8,12,17,21555,22129,17777,-4352
2018,8,12,18,21925,22500,18288,-4212
2018,8,12,19,22192,22708,18457,-4251
2018,8,12,20,22466,23222,18981,-4241
2018,8,12,21,22678,23813,19477,-4336
2018,8,12,22,22761,24079,19744,-4335
2018,8,12,23,22468,23840,19358,-4482
2018,8,13,0,21978,23389,18763,-4626
2018,8,13,1,21863,23363,18616,-4747
2018,8,13,2,21540,22875,18444,-4431
2018,8,13,3,20418,21677,16982,-4695
2018,8,13,4,19127,20294,15735,-4559
2018,8,13,5,18669,19082,14232,-4850
2018,8,13,6,17880,18277,13803,-4474
2018,8,13,7,17316,17708,12902,-4806
2018,8,13,8,17010,17430,12706,-4724
2018,8,13,9,17093,17476,12729,-4747
2018,8,13,10,17806,18181,13551,-4630
2018,8,13,11,18963,19388,14302,-5086
2018,8,13,12,20435,20730,15609,-5121
2018,8,13,13,21717,21752,16434,-5318
2018,8,13,14,22736,22479,17282,-5197
2018,8,13,15,23572,22973,17898,-5075
2018,8,13,16,24181,23316,18546,-4770
2018,8,13,17,24593,23406,18847,-4559
2018,8,13,18,24962,23530,19059,-4471
2018,8,13,19,25183,23538,19371,-4167
2018,8,13,20,25389,23591,19495,-4096
2018,8,13,21,25505,23654,19741,-3913
2018,8,13,22,25411,23721,19924,-3797
2018,8,13,23,24856,23421,19742,-3679
2018,8,14,0,24180,23208,19356,-3852
2018,8,14,1,23790,23115,18564,-4551
2018,8,14,2,23175,22366,17466,-4900
2018,8,14,3,21721,21049,16218,-4831
2018,8,14,4,20120,19567,15284,-4283
2018,8,14,5,18800,18394,14190,-4204
2018,8,14,6,17918,17580,13672,-3908
2018,8,14,7,17297,17065,13621,-3444
2018,8,14,8,16949,16777,13385,-3392
2018,8,14,9,16998,16867,13208,-3659
2018,8,14,10,17689,17615,13535,-4080
2018,8,14,11,18881,18905,14685,-4220
2018,8,14,12,20353,20397,16199,-4198
2018,8,14,13,21612,21612,17289,-4323
2018,8,14,14,22612,22670,18175,-4495
2018,8,14,15,23452,23453,19149,-4304
2018,8,14,16,24042,24109,19990,-4119
2018,8,14,17,24466,24557,20676,-3881
2018,8,14,18,24857,25060,21488,-3572
2018,8,14,19,25101,25490,21956,-3534
2018,8,14,20,25325,25555,22199,-3356
2018,8,14,21,25446,25267,22089,-3178
2018,8,14,22,25325,25016,21963,-3053
2018,8,14,23,24713,24366,21124,-3242
2018,8,15,0,24010,23776,20741,-3035
2018,8,15,1,23618,23494,20477,-3017
2018,8,15,2,23009,22618,19365,-3253
2018,8,15,3,21539,21167,17812,-3355
2018,8,15,4,19910,19660,16415,-3245
2018,8,15,5,18499,18279,14958,-3321
2018,8,15,6,17519,17362,14332,-3030
2018,8,15,7,16821,16828,13638,-3190
2018,8,15,8,16421,16515,13499,-3016
2018,8,15,9,16415,16561,13474,-3087
2018,8,15,10,17059,17261,13746,-3515
2018,8,15,11,18274,18441,15333,-3108
2018,8,15,12,19926,20073,16887,-3186
2018,8,15,13,21445,21524,18165,-3359
2018,8,15,14,22740,22631,18833,-3798
2018,8,15,15,23916,23784,19819,-3965
2018,8,15,16,24835,24851,21129,-3722
2018,8,15,17,25555,25760,21844,-3916
2018,8,15,18,26261,26685,22548,-4137
2018,8,15,19,26779,27383,23516,-3867
2018,8,15,20,27243,27924,24050,-3874
2018,8,15,21,27536,28328,24581,-3747
2018,8,15,22,27483,28407,24819,-3588
2018,8,15,23,26780,27772,24154,-3618
2018,8,16,0,25931,26904,23335,-3569
2018,8,16,1,25421,26508,23017,-3491
2018,8,16,2,24718,25547,21612,-3935
2018,8,16,3,23052,23851,19529,-4322
2018,8,16,4,21200,22080,17893,-4187
2018,8,16,5,19980,20597,16717,-3880
2018,8,16,6,18986,19545,15825,-3720
2018,8,16,7,18285,18771,15204,-3567
2018,8,16,8,17881,18309,15019,-3290
2018,8,16,9,17885,18253,14904,-3349
2018,8,16,10,18527,18837,15309,-3528
2018,8,16,11,19736,19912,16262,-3650
2018,8,16,12,21373,21402,17592,-3810
2018,8,16,13,22883,22790,18653,-4137
2018,8,16,14,24191,24013,19496,-4517
2018,8,16,15,25380,25238,20600,-4638
2018,8,16,16,26290,26449,21905,-4544
2018,8,16,17,26980,27350,23258,-4092
2018,8,16,18,27615,28197,24334,-3863
2018,8,16,19,28039,28810,24979,-3831
2018,8,16,20,28402,29315,25663,-3652
2018,8,16,21,28571,29620,25840,-3780
2018,8,16,22,28401,29492,25973,-3519
2018,8,16,23,27674,28776,25556,-3220
2018,8,17,0,26882,27869,24394,-3475
2018,8,17,1,26353,27446,23665,-3781
2018,8,17,2,25610,26331,22184,-4147
2018,8,17,3,23951,24598,20303,-4295
2018,8,17,4,22102,22779,18286,-4493
2018,8,17,5,20719,21288,16520,-4768
2018,8,17,6,19712,20177,15665,-4512
2018,8,17,7,19023,19433,14939,-4494
2018,8,17,8,18624,18945,14685,-4260
2018,8,17,9,18616,18899,14704,-4195
2018,8,17,10,19235,19476,15029,-4447
2018,8,17,11,20401,20661,16208,-4453
2018,8,17,12,21940,22122,17267,-4855
2018,8,17,13,23378,23623,18641,-4982
2018,8,17,14,24597,24860,19903,-4957
2018,8,17,15,25641,25912,21389,-4523
2018,8,17,16,26446,26743,22505,-4238
2018,8,17,17,26983,27268,23521,-3747
2018,8,17,18,27444,27786,24032,-3754
2018,8,17,19,27701,28346,24733,-3613
2018,8,17,20,27879,28729,24904,-3825
2018,8,17,21,27859,28868,24843,-4025
2018,8,17,22,27487,28516,24562,-3954
2018,8,17,23,26657,27650,23918,-3732
2018,8,18,0,25834,26886,23105,-3781
2018,8,18,1,25291,26446,22447,-3999
2018,8,18,2,24689,25477,21368,-4109
2018,8,18,3,23353,23613,19199,-4414
2018,8,18,4,21696,21909,17697,-4212
2018,8,18,5,20089,20490,15435,-5055
2018,8,18,6,19099,19499,14228,-5271
2018,8,18,7,18418,18823,13584,-5239
2018,8,18,8,17973,18336,13277,-5059
2018,8,18,9,17779,18119,13163,-4956
2018,8,18,10,17862,18207,13216,-4991
2018,8,18,11,18022,18544,13501,-5043
2018,8,18,12,18845,19240,14103,-5137
2018,8,18,13,20228,20332,15262,-5070
2018,8,18,14,21519,21330,16509,-4821
2018,8,18,15,22578,22230,17370,-4860
2018,8,18,16,23294,23047,18195,-4852
2018,8,18,17,23753,23799,19238,-4561
2018,8,18,18,23981,24125,19744,-4381
2018,8,18,19,24108,24251,19941,-4310
2018,8,18,20,24211,24403,20306,-4097
2018,8,18,21,24208,24429,20624,-3805
2018,8,18,22,24044,23983,19957,-4026
2018,8,18,23,23609,23097,18613,-4484
2018,8,19,0,23093,22464,17834,-4630
2018,8,19,1,22862,22230,17640,-4590
2018,8,19,2,22561,21542,17085,-4457
2018,8,19,3,21586,20432,15654,-4778
2018,8,19,4,20270,19126,14568,-4558
2018,8,19,5,17849,18005,13932,-4073
2018,8,19,6,16912,17105,12987,-4118
2018,8,19,7,16312,16481,12231,-4250
2018,8,19,8,15922,16076,11625,-4451
2018,8,19,9,15742,15897,11770,-4127
2018,8,19,10,15762,15892,11785,-4107
2018,8,19,11,15735,15969,12375,-3594
2018,8,19,12,16252,16308,12442,-3866
2018,8,19,13,17358,17059,13225,-3834
2018,8,19,14,18397,17843,14332,-3511
2018,8,19,15,19219,18490,14941,-3549
2018,8,19,16,19776,18950,15581,-3369
2018,8,19,17,20143,19146,15550,-3596
2018,8,19,18,20354,19265,15912,-3353
2018,8,19,19,20480,19443,16137,-3306
2018,8,19,20,20645,19632,16378,-3254
2018,8,19,21,20808,19898,16912,-2986
2018,8,19,22,20896,20153,17088,-3065
2018,8,19,23,20685,20165,17289,-2876
2018,8,20,0,20411,20104,16878,-3226
2018,8,20,1,20365,20276,16950,-3326
2018,8,20,2,20030,19760,16648,-3112
2018,8,20,3,19024,18686,15385,-3301
2018,8,20,4,17844,17467,14121,-3346
2018,8,20,5,16192,16417,12801,-3616
2018,8,20,6,15419,15737,12229,-3508
2018,8,20,7,14902,15319,11311,-4008
2018,8,20,8,14631,15131,11265,-3866
2018,8,20,9,14725,15271,11191,-4080
2018,8,20,10,15443,15969,11834,-4135
2018,8,20,11,16675,17167,13712,-3455
2018,8,20,12,18112,18447,14787,-3660
2018,8,20,13,19296,19539,15610,-3929
2018,8,20,14,20220,20364,16039,-4325
2018,8,20,15,20985,20915,16505,-4410
2018,8,20,16,21525,21486,17185,-4301
2018,8,20,17,21891,21841,17558,-4283
2018,8,20,18,22250,22182,17964,-4218
2018,8,20,19,22480,22328,18235,-4093
2018,8,20,20,22696,22448,18554,-3894
2018,8,20,21,22861,22628,20034,-2594
2018,8,20,22,22823,22700,18930,-3770
2018,8,20,23,22324,22292,18497,-3795
2018,8,21,0,21803,21908,18060,-3848
2018,8,21,1,21496,21761,17523,-4238
2018,8,21,2,20847,20993,16860,-4133
2018,8,21,3,19419,19510,15745,-3765
2018,8,21,4,17889,17956,14564,-3392
2018,8,21,5,17038,16823,13484,-3339
2018,8,21,6,16242,16204,12976,-3228
2018,8,21,7,15685,15617,12393,-3224
2018,8,21,8,15388,15345,11861,-3484
2018,8,21,9,15450,15409,12051,-3358
2018,8,21,10,16146,16062,12522,-3540
2018,8,21,11,17397,17279,13978,-3301
2018,8,21,12,18760,18625,14975,-3650
2018,8,21,13,19815,19713,15958,-3755
2018,8,21,14,20607,20496,16769,-3727
2018,8,21,15,21244,21134,17058,-4076
2018,8,21,16,21715,21657,17240,-4417
2018,8,21,17,22011,22163,17581,-4582
2018,8,21,18,22313,22586,17924,-4662
2018,8,21,19,22501,22985,18519,-4466
2018,8,21,20,22709,23287,19138,-4149
2018,8,21,21,22893,23415,19591,-3824
2018,8,21,22,22874,23301,19431,-3870
2018,8,21,23,22435,22710,18547,-4163
2018,8,22,0,21971,22311,18565,-3746
2018,8,22,1,21664,22253,18399,-3854
2018,8,22,2,21064,21552,17491,-4061
2018,8,22,3,19697,20369,16136,-4233
2018,8,22,4,18304,19011,15419,-3592
2018,8,22,5,18114,17895,14165,-3730
2018,8,22,6,17296,17141,13396,-3745
2018,8,22,7,16654,16678,13037,-3641
2018,8,22,8,16285,16497,13031,-3466
2018,8,22,9,16320,16619,12946,-3673
2018,8,22,10,17041,17356,13163,-4193
2018,8,22,11,18335,18635,14380,-4255
2018,8,22,12,19750,19950,15581,-4369
2018,8,22,13,21018,21117,16532,-4585
2018,8,22,14,22021,22057,17089,-4968
2018,8,22,15,22803,22793,17796,-4997
2018,8,22,16,23325,23348,18682,-4666
2018,8,22,17,23728,23822,19570,-4252
2018,8,22,18,24107,24330,19916,-4414
2018,8,22,19,24326,24616,19928,-4688
2018,8,22,20,24495,24773,20061,-4712
2018,8,22,21,24500,24933,20015,-4918
2018,8,22,22,24248,24742,19907,-4835
2018,8,22,23,23465,24011,19614,-4397
2018,8,23,0,22761,23281,18855,-4426
2018,8,23,1,22630,22937,18652,-4285
2018,8,23,2,21787,21755,17580,-4175
2018,8,23,3,20287,20218,15794,-4424
2018,8,23,4,18540,18639,14756,-3883
2018,8,23,5,16674,17332,13605,-3727
2018,8,23,6,15843,16446,12378,-4068
2018,8,23,7,15333,15828,12109,-3719
2018,8,23,8,15054,15496,11612,-3884
2018,8,23,9,15120,15522,11658,-3864
2018,8,23,10,15766,16104,12178,-3926
2018,8,23,11,16928,17192,13458,-3734
2018,8,23,12,18114,18293,14227,-4066
2018,8,23,13,19115,19163,15213,-3950
2018,8,23,14,19883,19803,15643,-4160
2018,8,23,15,20472,20322,16056,-4266
2018,8,23,16,20848,20738,16291,-4447
2018,8,23,17,21140,21020,16481,-4539
2018,8,23,18,21472,21431,17019,-4412
2018,8,23,19,21707,21804,17528,-4276
2018,8,23,20,21910,22118,17905,-4213
2018,8,23,21,22026,22448,18308,-4140
2018,8,23,22,21949,22488,18628,-3860
2018,8,23,23,21383,21940,18361,-3579
2018,8,24,0,20876,21250,17880,-3370
2018,8,24,1,20915,21029,17698,-3331
2018,8,24,2,20226,20219,16701,-3518
2018,8,24,3,18965,18935,15452,-3483
2018,8,24,4,17568,17516,13855,-3661
2018,8,24,5,16468,16383,13061,-3322
2018,8,24,6,15606,15560,11953,-3607
2018,8,24,7,15024,15027,11701,-3326
2018,8,24,8,14693,14752,11595,-3157
2018,8,24,9,14717,14812,11653,-3159
2018,8,24,10,15332,15425,11765,-3660
2018,8,24,11,16495,16498,12719,-3779
2018,8,24,12,17807,17762,13948,-3814
2018,8,24,13,19054,19014,15023,-3991
2018,8,24,14,20092,19940,15647,-4293
2018,8,24,15,20962,20778,15885,-4893
2018,8,24,16,21636,21575,16588,-4987
2018,8,24,17,22168,22196,16835,-5361
2018,8,24,18,22699,22802,17226,-5576
2018,8,24,19,23083,23304,17664,-5640
2018,8,24,20,23354,23770,18228,-5542
2018,8,24,21,23416,24124,18692,-5432
2018,8,24,22,23135,24020,18644,-5376
2018,8,24,23,22300,23222,18137,-5085
2018,8,25,0,21530,22331,17739,-4592
2018,8,25,1,21404,21894,17261,-4633
2018,8,25,2,20679,20913,16536,-4377
2018,8,25,3,19464,19587,14830,-4757
2018,8,25,4,18018,18245,13397,-4848
2018,8,25,5,16529,17054,12353,-4701
2018,8,25,6,15639,16222,12065,-4157
2018,8,25,7,15038,15605,11589,-4016
2018,8,25,8,14647,15211,11660,-3551
2018,8,25,9,14499,14984,11621,-3363
2018,8,25,10,14606,15122,11603,-3519
2018,8,25,11,14798,15373,11949,-3424
2018,8,25,12,15441,16141,12427,-3714
2018,8,25,13,16700,17367,12917,-4450
2018,8,25,14,17844,18433,13824,-4609
2018,8,25,15,18730,19375,14511,-4864
2018,8,25,16,19396,20052,15201,-4851
2018,8,25,17,19865,20594,15885,-4709
2018,8,25,18,20196,20926,16512,-4414
2018,8,25,19,20457,21162,17088,-4074
2018,8,25,20,20660,21214,17253,-3961
2018,8,25,21,20744,21303,17033,-4270
2018,8,25,22,20636,21337,16841,-4496
2018,8,25,23,20166,21019,16601,-4418
2018,8,26,0,19697,20537,16076,-4461
2018,8,26,1,19767,20444,15833,-4611
2018,8,26,2,19249,19811,15392,-4419
2018,8,26,3,18323,18827,14614,-4213
2018,8,26,4,17268,17696,13908,-3788
2018,8,26,5,16776,16637,12866,-3771
2018,8,26,6,15912,15841,12406,-3435
2018,8,26,7,15249,15292,11817,-3475
2018,8,26,8,14801,14890,11748,-3142
2018,8,26,9,14579,14762,11787,-2975
2018,8,26,10,14578,14830,11825,-3005
2018,8,26,11,14626,15049,11941,-3108
2018,8,26,12,15172,15648,12447,-3201
2018,8,26,13,16507,16842,13234,-3608
2018,8,26,14,17853,18052,14112,-3940
2018,8,26,15,19000,19135,14809,-4326
2018,8,26,16,19914,19975,15543,-4432
2018,8,26,17,20654,20837,16351,-4486
2018,8,26,18,21223,21538,16812,-4726
2018,8,26,19,21673,22204,17560,-4644
2018,8,26,20,22075,22822,18436,-4386
2018,8,26,21,22386,23258,18807,-4451
2018,8,26,22,22506,23479,19558,-3921
2018,8,26,23,22127,23395,19371,-4024
2018,8,27,0,21690,23248,19256,-3992
2018,8,27,1,21772,23355,19242,-4113
2018,8,27,2,21091,22648,18892,-3756
2018,8,27,3,19840,21471,17217,-4254
2018,8,27,4,18505,20089,15969,-4120
2018,8,27,5,18012,18935,14651,-4284
2018,8,27,6,17196,18081,13558,-4523
2018,8,27,7,16571,17506,12855,-4651
2018,8,27,8,16213,17210,12222,-4988
2018,8,27,9,16258,17262,12366,-4896
2018,8,27,10,16974,17940,12934,-5006
2018,8,27,11,18327,19190,14337,-4853
2018,8,27,12,19910,20663,15984,-4679
2018,8,27,13,21456,22019,17209,-4810
2018,8,27,14,22817,23323,18087,-5236
2018,8,27,15,24024,24560,19271,-5289
2018,8,27,16,25031,25719,20737,-4982
2018,8,27,17,25827,26695,21947,-4748
2018,8,27,18,26572,27590,23118,-4472
2018,8,27,19,27096,28154,23752,-4402
2018,8,27,20,27498,28632,24339,-4293
2018,8,27,21,27712,28912,24669,-4243
2018,8,27,22,27573,28935,24810,-4125
2018,8,27,23,26801,28312,24427,-3885
2018,8,28,0,26073,27720,23894,-3826
2018,8,28,1,25717,27467,23900,-3567
2018,8,28,2,24606,26315,22723,-3592
2018,8,28,3,22824,24645,20700,-3945
2018,8,28,4,20962,22862,18242,-4620
2018,8,28,5,20574,21425,16961,-4464
2018,8,28,6,19580,20435,16013,-4422
2018,8,28,7,18857,19788,14939,-4849
2018,8,28,8,18433,19413,14507,-4906
2018,8,28,9,18425,19409,14416,-4993
2018,8,28,10,19102,20106,15199,-4907
2018,8,28,11,20492,21398,16498,-4900
2018,8,28,12,22199,22999,17871,-5128
2018,8,28,13,23913,24853,19729,-5124
2018,8,28,14,25486,26549,21348,-5201
2018,8,28,15,26915,28104,23380,-4724
2018,8,28,16,28058,29331,24920,-4411
2018,8,28,17,28961,30251,26295,-3956
2018,8,28,18,29766,30978,26953,-4025
2018,8,28,19,30302,31233,27276,-3957
2018,8,28,20,30711,31541,27825,-3716
2018,8,28,21,30899,31825,28546,-3279
2018,8,28,22,30721,31766,28632,-3134
2018,8,28,23,29894,31386,28023,-3363
2018,8,29,0,29170,30678,26937,-3741
2018,8,29,1,28656,30237,26385,-3852
2018,8,29,2,27452,28914,24895,-4019
2018,8,29,3,25516,27009,22795,-4214
2018,8,29,4,23409,25008,20082,-4926
2018,8,29,5,21931,23357,18677,-4680
2018,8,29,6,20835,22239,17500,-4739
2018,8,29,7,20095,21423,16279,-5144
2018,8,29,8,19657,20971,15867,-5104
2018,8,29,9,19628,20895,15566,-5329
2018,8,29,10,20284,21463,16359,-5104
2018,8,29,11,21659,22670,17926,-4744
2018,8,29,12,23316,24264,19552,-4712
2018,8,29,13,24981,26039,21371,-4668
2018,8,29,14,26508,27710,23282,-4428
2018,8,29,15,27879,29221,25276,-3945
2018,8,29,16,28994,30405,26543,-3862
2018,8,29,17,29829,31225,27776,-3449
2018,8,29,18,30560,31644,28382,-3262
2018,8,29,19,31015,31735,28852,-2883
2018,8,29,20,31322,31858,28874,-2984
2018,8,29,21,31373,31861,28682,-3179
2018,8,29,22,31042,31605,28436,-3169
2018,8,29,23,30126,31033,28023,-3010
2018,8,30,0,29413,30283,27159,-3124
2018,8,30,1,28916,29677,26580,-3097
2018,8,30,2,27715,28327,24791,-3536
2018,8,30,3,25845,26454,22540,-3914
2018,8,30,4,23689,24556,20159,-4397
2018,8,30,5,21075,22987,18342,-4645
2018,8,30,6,19965,21913,17299,-4614
2018,8,30,7,19288,21153,16232,-4921
2018,8,30,8,18892,20653,15589,-5064
2018,8,30,9,18889,20582,15527,-5055
2018,8,30,10,19556,21113,16025,-5088
2018,8,30,11,20880,22244,17585,-4659
2018,8,30,12,22306,23526,19016,-4510
2018,8,30,13,23627,24710,20317,-4393
2018,8,30,14,24747,25645,21680,-3965
2018,8,30,15,25696,26541,22952,-3589
2018,8,30,16,26410,27200,23463,-3737
2018,8,30,17,26914,27554,24170,-3384
2018,8,30,18,27326,27775,25038,-2737
2018,8,30,19,27519,27932,25399,-2533
2018,8,30,20,27605,28133,25568,-2565
2018,8,30,21,27517,28260,25579,-2681
2018,8,30,22,27156,28229,25849,-2380
2018,8,30,23,26342,27386,24769,-2617
2018,8,31,0,25795,26504,23627,-2877
2018,8,31,1,25518,26013,23118,-2895
2018,8,31,2,24509,24815,21363,-3452
2018,8,31,3,22936,23182,19200,-3982
2018,8,31,4,21066,21378,17038,-4340
2018,8,31,5,18656,19903,15670,-4233
2018,8,31,6,17686,18896,14566,-4330
2018,8,31,7,17137,18131,13487,-4644
2018,8,31,8,16830,17694,13029,-4665
2018,8,31,9,16860,17628,13003,-4625
2018,8,31,10,17492,18214,13148,-5066
2018,8,31,11,18717,19303,14817,-4486
2018,8,31,12,19885,20313,16153,-4160
2018,8,31,13,20896,21166,16802,-4364
2018,8,31,14,21699,21803,17003,-4800
2018,8,31,15,22299,22222,17559,-4663
2018,8,31,16,22703,22577,17881,-4696
2018,8,31,17,22967,22767,17892,-4875
2018,8,31,18,23231,22868,18440,-4428
2018,8,31,19,23363,22864,18246,-4618
2018,8,31,20,23434,22666,18373,-4293
2018,8,31,21,23427,22504,18256,-4248
2018,8,31,22,23184,22250,18268,-3982
2018,8,31,23,22548,21751,18017,-3734
2018,9,1,0,22123,21480,17688,-3792
2018,9,1,1,21999,21212,17548,-3664
2018,9,1,2,21242,20496,16691,-3805
2018,9,1,3,20109,19422,15720,-3702
2018,9,1,4,18793,18207,14844,-3363
2018,9,1,5,17651,17214,13439,-3775
2018,9,1,6,16702,16476,12702,-3774
2018,9,1,7,16045,15922,12273,-3649
2018,9,1,8,15617,15612,11922,-3690
2018,9,1,9,15435,15459,11769,-3690
2018,9,1,10,15562,15589,11861,-3728
2018,9,1,11,15874,15958,12072,-3886
2018,9,1,12,16558,16559,13237,-3322
2018,9,1,13,17863,17641,13957,-3684
2018,9,1,14,19061,18609,14731,-3878
2018,9,1,15,19980,19390,15283,-4107
2018,9,1,16,20585,19932,15691,-4241
2018,9,1,17,21018,20260,15803,-4457
2018,9,1,18,21285,20583,16271,-4312
2018,9,1,19,21492,20927,16563,-4364
2018,9,1,20,21645,21286,16874,-4412
2018,9,1,21,21757,21609,17180,-4429
2018,9,1,22,21708,21532,16938,-4594
2018,9,1,23,21315,21203,16806,-4397
2018,9,2,0,21036,20921,16562,-4359
2018,9,2,1,21063,20860,16722,-4138
2018,9,2,2,20402,20258,16192,-4066
2018,9,2,3,19361,19294,15272,-4022
2018,9,2,4,18227,18263,14546,-3717
2018,9,2,5,17485,17242,13586,-3656
2018,9,2,6,16631,16485,12784,-3701
2018,9,2,7,15966,15933,12266,-3667
2018,9,2,8,15526,15558,12071,-3487
2018,9,2,9,15296,15386,12022,-3364
2018,9,2,10,15253,15380,12157,-3223
2018,9,2,11,15230,15594,12337,-3257
2018,9,2,12,15636,16160,13088,-3072
2018,9,2,13,16937,17370,13726,-3644
2018,9,2,14,18286,18670,14734,-3936
2018,9,2,15,19424,19703,15378,-4325
2018,9,2,16,20328,20649,16145,-4504
2018,9,2,17,21013,21382,16925,-4457
2018,9,2,18,21502,21802,17541,-4261
2018,9,2,19,21879,22180,17671,-4509
2018,9,2,20,22222,22670,18302,-4368
2018,9,2,21,22528,23181,18599,-4582
2018,9,2,22,22646,23396,19026,-4370
2018,9,2,23,22339,23110,18779,-4331
2018,9,3,0,22169,22788,18415,-4373
2018,9,3,1,22240,22791,18480,-4311
2018,9,3,2,21451,22204,17882,-4322
2018,9,3,3,20192,21266,16988,-4278
2018,9,3,4,18884,20131,16117,-4014
2018,9,3,5,18381,19053,14750,-4303
2018,9,3,6,17536,18269,13818,-4451
2018,9,3,7,16853,17733,13240,-4493
2018,9,3,8,16433,17441,13018,-4423
2018,9,3,9,16285,17399,13156,-4243
2018,9,3,10,16478,17627,13304,-4323
2018,9,3,11,16900,17989,14096,-3893
2018,9,3,12,17584,18688,14825,-3863
2018,9,3,13,18955,20169,15866,-4303
2018,9,3,14,20577,21975,17288,-4687
2018,9,3,15,22104,23755,18926,-4829
2018,9,3,16,23288,25324,21074,-4250
2018,9,3,17,24156,26475,22827,-3648
2018,9,3,18,24765,27234,23086,-4148
2018,9,3,19,25202,27809,23658,-4151
2018,9,3,20,25598,28020,24124,-3896
2018,9,3,21,25911,28125,24461,-3664
2018,9,3,22,25945,27984,24498,-3486
2018,9,3,23,25521,27413,24024,-3389
2018,9,4,0,25289,27068,23537,-3531
2018,9,4,1,25334,26893,23298,-3595
2018,9,4,2,24321,25838,22293,-3545
2018,9,4,3,22703,24246,20636,-3610
2018,9,4,4,21047,22590,18829,-3761
2018,9,4,5,20212,21305,16900,-4405
2018,9,4,6,19259,20334,15513,-4821
2018,9,4,7,18578,19656,14962,-4694
2018,9,4,8,18183,19214,14436,-4778
2018,9,4,9,18181,19152,14425,-4727
2018,9,4,10,18878,19778,15351,-4427
2018,9,4,11,20340,21116,17194,-3922
2018,9,4,12,21886,22581,18333,-4248
2018,9,4,13,23341,24186,20308,-3878
2018,9,4,14,24634,25589,21729,-3860
2018,9,4,15,25814,26903,22970,-3933
2018,9,4,16,26773,28030,24489,-3541
2018,9,4,17,27531,28927,25392,-3535
2018,9,4,18,28207,29718,26382,-3336
2018,9,4,19,28637,30335,26668,-3667
2018,9,4,20,28925,30795,26850,-3945
2018,9,4,21,29044,31156,27355,-3801
2018,9,4,22,28822,31127,27680,-3447
2018,9,4,23,28035,30420,27217,-3203
2018,9,5,0,27495,29625,26335,-3290
2018,9,5,1,27040,29033,25759,-3274
2018,9,5,2,25778,27407,23852,-3555
2018,9,5,3,23946,25236,21470,-3766
2018,9,5,4,21997,23176,19249,-3927
2018,9,5,5,20265,21573,17635,-3938
2018,9,5,6,19270,20471,16214,-4257
2018,9,5,7,18589,19728,15210,-4518
2018,9,5,8,18194,19324,15021,-4303
2018,9,5,9,18173,19331,15027,-4304
2018,9,5,10,18836,20101,16096,-4005
2018,9,5,11,20255,21643,18170,-3473
2018,9,5,12,21718,23093,19517,-3576
2018,9,5,13,23080,24459,20758,-3701
2018,9,5,14,24290,25881,21988,-3893
2018,9,5,15,25372,27261,23636,-3625
2018,9,5,16,26211,28458,25129,-3329
2018,9,5,17,26893,29425,26182,-3243
2018,9,5,18,27528,30161,27015,-3146
2018,9,5,19,27935,30507,27416,-3091
2018,9,5,20,28205,31085,27912,-3173
2018,9,5,21,28319,31456,27998,-3458
2018,9,5,22,28081,31323,28066,-3257
2018,9,5,23,27269,30631,27543,-3088
2018,9,6,0,26759,29973,26556,-3417
2018,9,6,1,26368,29376,26050,-3326
2018,9,6,2,25171,27874,24396,-3478
2018,9,6,3,23440,25823,21882,-3941
2018,9,6,4,21577,23868,19849,-4019
2018,9,6,5,20385,22292,19043,-3249
2018,9,6,6,19308,21228,18198,-3030
2018,9,6,7,18610,20577,17075,-3502
2018,9,6,8,18215,20184,16059,-4125
2018,9,6,9,18200,20235,16207,-4028
2018,9,6,10,18897,21028,17180,-3848
2018,9,6,11,20391,22595,19197,-3398
2018,9,6,12,21933,23883,20281,-3602
2018,9,6,13,23355,25082,21069,-4013
2018,9,6,14,24605,26343,22295,-4048
2018,9,6,15,25710,27504,23609,-3895
2018,9,6,16,26567,28565,24678,-3887
2018,9,6,17,27211,29426,25539,-3887
2018,9,6,18,27757,30033,26477,-3556
2018,9,6,19,28054,30258,27350,-2908
2018,9,6,20,28185,30609,27563,-3046
2018,9,6,21,28136,30607,27500,-3107
2018,9,6,22,27755,29976,27103,-2873
2018,9,6,23,26866,28486,25882,-2604
2018,9,7,0,26383,27208,24642,-2566
2018,9,7,1,25976,26538,23767,-2771
2018,9,7,2,24753,25191,21699,-3492
2018,9,7,3,23045,23377,19951,-3426
2018,9,7,4,21084,21525,17551,-3974
2018,9,7,5,18898,20138,15629,-4509
2018,9,7,6,17942,19211,14674,-4537
2018,9,7,7,17389,18563,13799,-4764
2018,9,7,8,17080,18210,13511,-4699
2018,9,7,9,17093,18224,13643,-4581
2018,9,7,10,17732,18875,14659,-4216
2018,9,7,11,19038,20370,16178,-4192
2018,9,7,12,20196,21500,17884,-3616
2018,9,7,13,21146,22222,18360,-3862
2018,9,7,14,21876,22752,18751,-4001
2018,9,7,15,22419,23096,18811,-4285
2018,9,7,16,22743,23202,18576,-4626
2018,9,7,17,22949,23179,18579,-4600
2018,9,7,18,23145,23123,18755,-4368
2018,9,7,19,23208,23047,19130,-3917
2018,9,7,20,23186,22972,18689,-4283
2018,9,7,21,23123,22897,18666,-4231
2018,9,7,22,22844,22543,18025,-4518
2018,9,7,23,22217,22041,17708,-4333
2018,9,8,0,21967,21803,17382,-4421
2018,9,8,1,21787,21350,16711,-4639
2018,9,8,2,20916,20507,15735,-4772
2018,9,8,3,19775,19396,14339,-5057
2018,9,8,4,18394,18158,13357,-4801
2018,9,8,5,16171,17139,12391,-4748
2018,9,8,6,15315,16460,11713,-4747
2018,9,8,7,14811,15945,11380,-4565
2018,9,8,8,14498,15589,10727,-4862
2018,9,8,9,14380,15439,10558,-4881
2018,9,8,10,14542,15544,11147,-4397
2018,9,8,11,14906,15896,11576,-4320
2018,9,8,12,15444,16384,12051,-4333
2018,9,8,13,16411,17136,12868,-4268
2018,9,8,14,17230,17683,13516,-4167
2018,9,8,15,17758,18031,13704,-4327
2018,9,8,16,17999,18151,13823,-4328
2018,9,8,17,18100,18110,13353,-4757
2018,9,8,18,18089,17946,13017,-4929
2018,9,8,19,18046,17802,12837,-4965
2018,9,8,20,17985,17652,12798,-4854
2018,9,8,21,17998,17494,12783,-4711
2018,9,8,22,17965,17460,12778,-4682
2018,9,8,23,17785,17433,12871,-4562
2018,9,9,0,17913,17645,13066,-4579
2018,9,9,1,18012,17546,12945,-4601
2018,9,9,2,17370,16985,13023,-3962
2018,9,9,3,16557,16157,12497,-3660
2018,9,9,4,15635,15189,11594,-3595
2018,9,9,5,14369,14372,10360,-4012
2018,9,9,6,13657,13788,9778,-4010
2018,9,9,7,13193,13348,9365,-3983
2018,9,9,8,12900,13067,9326,-3741
2018,9,9,9,12779,12961,9350,-3611
2018,9,9,10,12890,13063,9277,-3786
2018,9,9,11,13128,13376,9644,-3732
2018,9,9,12,13513,13824,10773,-3051
2018,9,9,13,14398,14668,11152,-3516
2018,9,9,14,15184,15409,11722,-3687
2018,9,9,15,15708,15942,12354,-3588
2018,9,9,16,15967,16219,12635,-3584
2018,9,9,17,16097,16322,12717,-3605
2018,9,9,18,16114,16351,12855,-3496
2018,9,9,19,16073,16357,13055,-3302
2018,9,9,20,16036,16428,12974,-3454
2018,9,9,21,16150,16649,13097,-3552
2018,9,9,22,16305,16900,13174,-3726
2018,9,9,23,16328,16991,12977,-4014
2018,9,10,0,16686,17241,12830,-4411
2018,9,10,1,16892,17010,12588,-4422
2018,9,10,2,16114,16298,12357,-3941
2018,9,10,3,15129,15347,11329,-4018
2018,9,10,4,14216,14371,10634,-3737
2018,9,10,5,14328,13610,9439,-4171
2018,9,10,6,13732,13137,8780,-4357
2018,9,10,7,13306,12874,8431,-4443
2018,9,10,8,13106,12807,8511,-4296
2018,9,10,9,13231,13036,8624,-4412
2018,9,10,10,14072,13849,9244,-4605
2018,9,10,11,15671,15345,11029,-4316
2018,9,10,12,17008,16587,12384,-4203
2018,9,10,13,17975,17537,13271,-4266
2018,9,10,14,18692,18141,13802,-4339
2018,9,10,15,19180,18557,13832,-4725
2018,9,10,16,19430,18717,14231,-4486
2018,9,10,17,19579,18782,14474,-4308
2018,9,10,18,19760,18749,14621,-4128
2018,9,10,19,19833,18637,14491,-4146
2018,9,10,20,19891,18600,14714,-3886
2018,9,10,21,20104,18682,14960,-3722
2018,9,10,22,20214,18748,14851,-3897
2018,9,10,23,19956,18693,14614,-4079
2018,9,11,0,20097,18775,14378,-4397
2018,9,11,1,20068,18417,14447,-3970
2018,9,11,2,18976,17531,13915,-3616
2018,9,11,3,17515,16346,12954,-3392
2018,9,11,4,16233,15153,12070,-3083
2018,9,11,5,16771,14306,10792,-3514
2018,9,11,6,16043,13773,10251,-3522
2018,9,11,7,15404,13406,10029,-3377
2018,9,11,8,15056,13263,9927,-3336
2018,9,11,9,15092,13466,10082,-3384
2018,9,11,10,15936,14243,10751,-3492
2018,9,11,11,17684,15784,11767,-4017
2018,9,11,12,19187,16936,12511,-4425
2018,9,11,13,20380,17848,12948,-4900
2018,9,11,14,21336,18519,13588,-4931
2018,9,11,15,22134,19025,14712,-4313
2018,9,11,16,22710,19309,15032,-4277
2018,9,11,17,23168,19528,15005,-4523
2018,9,11,18,23609,19821,15301,-4520
2018,9,11,19,23864,19929,15709,-4220
2018,9,11,20,24008,19973,15920,-4053
2018,9,11,21,24132,20247,16283,-3964
2018,9,11,22,23969,20440,16612,-3828
2018,9,11,23,23313,20354,16693,-3661
2018,9,12,0,23162,20587,16615,-3972
2018,9,12,1,22872,20335,16259,-4076
2018,9,12,2,21547,19395,15414,-3981
2018,9,12,3,19769,18126,13847,-4279
2018,9,12,4,18050,16794,12640,-4154
2018,9,12,5,17423,15829,11869,-3960
2018,9,12,6,16703,15211,11222,-3989
2018,9,12,7,16131,14840,10942,-3898
2018,9,12,8,15818,14703,10614,-4089
2018,9,12,9,15845,14892,10929,-3963
2018,9,12,10,16604,15836,11757,-4079
2018,9,12,11,18186,17655,13006,-4649
2018,9,12,12,19478,18959,14391,-4568
2018,9,12,13,20456,19984,14824,-5160
2018,9,12,14,21218,20628,15505,-5123
2018,9,12,15,21839,21009,16100,-4909
2018,9,12,16,22284,21255,16296,-4959
2018,9,12,17,22626,21474,16398,-5076
2018,9,12,18,22976,21783,17069,-4714
2018,9,12,19,23170,21950,17304,-4646
2018,9,12,20,23286,22095,17487,-4608
2018,9,12,21,23396,22331,17769,-4562
2018,9,12,22,23260,22363,17969,-4394
2018,9,12,23,22713,22071,17798,-4273
2018,9,13,0,22633,22090,17622,-4468
2018,9,13,1,22414,21727,17028,-4699
2018,9,13,2,21238,20739,16270,-4469
2018,9,13,3,19685,19328,14685,-4643
2018,9,13,4,18182,17874,13403,-4471
2018,9,13,5,17389,16696,11840,-4856
2018,9,13,6,16645,15924,11065,-4859
2018,9,13,7,16085,15424,10374,-5050
2018,9,13,8,15784,15198,10151,-5047
2018,9,13,9,15814,15327,10433,-4894
2018,9,13,10,16556,16159,11304,-4855
2018,9,13,11,18116,17917,13393,-4524
2018,9,13,12,19374,19210,14467,-4743
2018,9,13,13,20330,20044,14867,-5177
2018,9,13,14,21093,20667,15087,-5580
2018,9,13,15,21718,21135,15716,-5419
2018,9,13,16,22122,21433,15880,-5553
2018,9,13,17,22444,21808,16588,-5220
2018,9,13,18,22766,22256,16938,-5318
2018,9,13,19,22934,22527,17191,-5336
2018,9,13,20,23005,22834,17576,-5258
2018,9,13,21,23086,23129,17883,-5246
2018,9,13,22,22956,23153,17924,-5229
2018,9,13,23,22442,22819,17564,-5255
2018,9,14,0,22416,22760,17510,-5250
2018,9,14,1,22210,22364,17189,-5175
2018,9,14,2,21031,21242,15930,-5312
2018,9,14,3,19507,19764,14681,-5083
2018,9,14,4,18008,18232,13656,-4576
2018,9,14,5,17026,16942,12840,-4102
2018,9,14,6,16260,16127,12251,-3876
2018,9,14,7,15722,15609,11529,-4080
2018,9,14,8,15426,15377,11298,-4079
2018,9,14,9,15437,15474,11363,-4111
2018,9,14,10,16119,16297,12076,-4221
2018,9,14,11,17580,17970,13766,-4204
2018,9,14,12,18793,19315,14856,-4459
2018,9,14,13,19764,20239,15370,-4869
2018,9,14,14,20550,20964,15927,-5037
2018,9,14,15,21191,21512,16280,-5232
2018,9,14,16,21599,21903,16874,-5029
2018,9,14,17,21899,22190,17124,-5066
2018,9,14,18,22202,22487,17267,-5220
2018,9,14,19,22350,22609,17648,-4961
2018,9,14,20,22369,22832,17877,-4955
2018,9,14,21,22371,23051,18193,-4858
2018,9,14,22,22114,22921,18407,-4514
2018,9,14,23,21497,22469,18242,-4227
2018,9,15,0,21386,22245,17824,-4421
2018,9,15,1,21138,21682,17241,-4441
2018,9,15,2,20080,20714,15659,-5055
2018,9,15,3,18815,19511,14406,-5105
2018,9,15,4,17456,18192,13985,-4207
2018,9,15,5,16538,16972,12242,-4730
2018,9,15,6,15652,16053,10784,-5269
2018,9,15,7,15056,15500,10561,-4939
2018,9,15,8,14673,15181,10655,-4526
2018,9,15,9,14538,15027,10432,-4595
2018,9,15,10,14709,15195,10310,-4885
2018,9,15,11,15207,15672,11070,-4602
2018,9,15,12,15906,16452,11953,-4499
2018,9,15,13,17144,17780,13011,-4769
2018,9,15,14,18282,18881,13694,-5187
2018,9,15,15,19160,19839,14392,-5447
2018,9,15,16,19757,20623,15020,-5603
2018,9,15,17,20182,21218,15530,-5688
2018,9,15,18,20465,21599,15824,-5775
2018,9,15,19,20686,21968,16346,-5622
2018,9,15,20,20877,22264,16816,-5448
2018,9,15,21,20975,22609,17075,-5534
2018,9,15,22,20855,22674,17224,-5450
2018,9,15,23,20448,22178,16900,-5278
2018,9,16,0,20568,21793,16555,-5238
2018,9,16,1,20184,21358,16298,-5060
2018,9,16,2,19441,20388,15144,-5244
2018,9,16,3,18410,19267,13879,-5388
2018,9,16,4,17223,18056,12471,-5585
2018,9,16,5,16270,16956,11506,-5450
2018,9,16,6,15429,16099,10657,-5442
2018,9,16,7,14838,15496,10137,-5359
2018,9,16,8,14447,15112,9703,-5409
2018,9,16,9,14279,14895,9566,-5329
2018,9,16,10,14347,14904,9541,-5363
2018,9,16,11,14680,15141,10077,-5064
2018,9,16,12,15203,15683,10861,-4822
2018,9,16,13,16384,16889,12018,-4871
2018,9,16,14,17581,18191,12900,-5291
2018,9,16,15,18591,19446,13572,-5874
2018,9,16,16,19381,20692,14616,-6076
2018,9,16,17,20003,21768,15426,-6342
2018,9,16,18,20450,22607,16199,-6408
2018,9,16,19,20782,23255,16865,-6390
2018,9,16,20,21060,23777,17409,-6368
2018,9,16,21,21250,24213,18082,-6131
2018,9,16,22,21224,24310,18517,-5793
2018,9,16,23,20872,23817,18466,-5351
2018,9,17,0,21069,23551,17853,-5698
2018,9,17,1,20696,23041,17543,-5498
2018,9,17,2,19790,21855,16067,-5788
2018,9,17,3,18545,20361,14403,-5958
2018,9,17,4,17198,18855,13360,-5495
2018,9,17,5,15864,17566,11937,-5629
2018,9,17,6,15164,16696,11227,-5469
2018,9,17,7,14726,16107,10790,-5317
2018,9,17,8,14502,15771,10512,-5259
2018,9,17,9,14619,15900,11228,-4672
2018,9,17,10,15384,16700,11982,-4718
2018,9,17,11,16913,18346,13575,-4771
2018,9,17,12,18194,19612,14785,-4827
2018,9,17,13,19209,20639,15392,-5247
2018,9,17,14,20025,21419,16331,-5088
2018,9,17,15,20697,22185,16853,-5332
2018,9,17,16,21239,22815,17624,-5191
2018,9,17,17,21632,23317,18252,-5065
2018,9,17,18,22014,23756,19194,-4562
2018,9,17,19,22249,23906,20028,-3878
2018,9,17,20,22436,24115,20123,-3992
2018,9,17,21,22548,24171,19754,-4417
2018,9,17,22,22415,24085,20210,-3875
2018,9,17,23,21957,23753,19896,-3857
2018,9,18,0,22034,23805,20024,-3781
2018,9,18,1,21461,23302,19739,-3563
2018,9,18,2,20363,22136,18238,-3898
2018,9,18,3,18911,20685,16654,-4031
2018,9,18,4,17436,19191,15312,-3879
2018,9,18,5,16975,18065,14003,-4062
2018,9,18,6,16174,17304,13109,-4195
2018,9,18,7,15634,16890,12631,-4259
2018,9,18,8,15345,16721,12418,-4303
2018,9,18,9,15435,16885,12610,-4275
2018,9,18,10,16240,17818,13212,-4606
2018,9,18,11,17909,19706,14871,-4835
2018,9,18,12,19238,21170,16101,-5069
2018,9,18,13,20241,22097,17159,-4938
2018,9,18,14,21028,22891,18362,-4529
2018,9,18,15,21659,23512,19285,-4227
2018,9,18,16,22120,24036,19919,-4117
2018,9,18,17,22458,24203,20457,-3746
2018,9,18,18,22767,24186,20549,-3637
2018,9,18,19,22919,24077,19997,-4080
2018,9,18,20,23027,24055,20338,-3717
2018,9,18,21,23059,24084,20561,-3523
2018,9,18,22,22837,23991,20615,-3376
2018,9,18,23,22281,23510,20623,-2887
2018,9,19,0,22383,23370,20028,-3342
2018,9,19,1,21769,22771,18985,-3786
2018,9,19,2,20610,21584,16997,-4587
2018,9,19,3,19065,20080,15485,-4595
2018,9,19,4,17400,18584,13551,-5033
2018,9,19,5,16215,17328,12348,-4980
2018,9,19,6,15446,16522,11688,-4834
2018,9,19,7,14967,15981,11204,-4777
2018,9,19,8,14711,15661,10938,-4723
2018,9,19,9,14780,15726,10959,-4767
2018,9,19,10,15489,16413,11452,-4961
2018,9,19,11,17003,17862,12638,-5224
2018,9,19,12,18181,18936,14118,-4818
2018,9,19,13,19013,19968,15109,-4859
2018,9,19,14,19636,20707,15880,-4827
2018,9,19,15,20111,21295,16466,-4829
2018,9,19,16,20425,21749,16892,-4857
2018,9,19,17,20625,22139,17132,-5007
2018,9,19,18,20850,22561,17694,-4867
2018,9,19,19,20960,22840,18475,-4365
2018,9,19,20,21049,23077,18883,-4194
2018,9,19,21,21107,23161,19113,-4048
2018,9,19,22,20969,22918,18825,-4093
2018,9,19,23,20531,22282,18156,-4126
2018,9,20,0,20709,22216,18051,-4165
2018,9,20,1,20264,21623,17546,-4077
2018,9,20,2,19286,20536,16141,-4395
2018,9,20,3,17963,19043,14515,-4528
2018,9,20,4,16510,17457,13156,-4301
2018,9,20,5,15093,16281,11875,-4406
2018,9,20,6,14402,15476,10380,-5096
2018,9,20,7,14006,14930,9859,-5071
2018,9,20,8,13814,14624,9978,-4646
2018,9,20,9,13915,14707,9976,-4731
2018,9,20,10,14619,15463,11011,-4452
2018,9,20,11,16090,17059,12979,-4080
2018,9,20,12,17182,18143,13964,-4179
2018,9,20,13,17901,18768,14544,-4224
2018,9,20,14,18428,19135,15746,-3389
2018,9,20,15,18801,19383,15727,-3656
2018,9,20,16,18998,19578,15814,-3764
2018,9,20,17,19109,19760,15443,-4317
2018,9,20,18,19263,20107,15401,-4706
2018,9,20,19,19330,20281,15800,-4481
2018,9,20,20,19402,20525,16147,-4378
2018,9,20,21,19499,20720,16484,-4236
2018,9,20,22,19457,20609,16118,-4491
2018,9,20,23,19203,20337,15830,-4507
2018,9,21,0,19505,20515,16166,-4349
2018,9,21,1,19148,20132,15984,-4148
2018,9,21,2,18243,19231,15293,-3938
2018,9,21,3,17025,17988,14137,-3851
2018,9,21,4,15809,16759,13052,-3707
2018,9,21,5,15182,15672,12133,-3539
2018,9,21,6,14474,14998,11427,-3571
2018,9,21,7,14000,14625,10993,-3632
2018,9,21,8,13755,14465,10725,-3740
2018,9,21,9,13830,14642,10989,-3653
2018,9,21,10,14572,15507,11855,-3652
2018,9,21,11,16165,17259,13473,-3786
2018,9,21,12,17399,18555,14421,-4134
2018,9,21,13,18336,19420,14944,-4476
2018,9,21,14,19091,20050,15584,-4466
2018,9,21,15,19700,20520,15851,-4669
2018,9,21,16,20126,20843,16228,-4615
2018,9,21,17,20423,21061,16231,-4830
2018,9,21,18,20740,21348,16609,-4739
2018,9,21,19,20931,21423,16485,-4938
2018,9,21,20,21067,21489,16686,-4803
2018,9,21,21,21133,21560,17317,-4243
2018,9,21,22,20924,21401,17110,-4291
2018,9,21,23,20425,21098,16773,-4325
2018,9,22,0,20507,21044,16569,-4475
2018,9,22,1,19984,20580,16149,-4431
2018,9,22,2,19045,19762,15095,-4667
2018,9,22,3,17854,18689,13937,-4752
2018,9,22,4,16505,17453,12890,-4563
2018,9,22,5,15337,16353,12219,-4134
2018,9,22,6,14584,15627,11662,-3965
2018,9,22,7,14098,15134,11022,-4112
2018,9,22,8,13799,14832,10931,-3901
2018,9,22,9,13720,14726,10665,-4061
2018,9,22,10,13946,14910,10794,-4116
2018,9,22,11,14529,15419,11319,-4100
2018,9,22,12,15087,15939,11958,-3981
2018,9,22,13,15972,16651,12468,-4183
2018,9,22,14,16705,17186,12888,-4298
2018,9,22,15,17148,17539,12979,-4560
2018,9,22,16,17295,17648,13194,-4454
2018,9,22,17,17294,17645,13088,-4557
2018,9,22,18,17197,17587,12828,-4759
2018,9,22,19,17091,17426,12728,-4698
2018,9,22,20,17032,17311,12815,-4496
2018,9,22,21,17052,17226,12785,-4441
2018,9,22,22,17038,17241,12849,-4392
2018,9,22,23,16996,17314,12592,-4722
2018,9,23,0,17465,17578,12671,-4907
2018,9,23,1,17194,17278,12549,-4729
2018,9,23,2,16493,16696,12489,-4207
2018,9,23,3,15668,15909,11953,-3956
2018,9,23,4,14758,14986,11226,-3760
2018,9,23,5,13825,14103,10728,-3375
2018,9,23,6,13247,13541,10063,-3478
2018,9,23,7,12842,13140,9524,-3616
2018,9,23,8,12598,12915,9356,-3559
2018,9,23,9,12525,12867,9317,-3550
2018,9,23,10,12688,12979,9331,-3648
2018,9,23,11,13128,13335,9815,-3520
2018,9,23,12,13509,13773,10719,-3054
2018,9,23,13,14286,14571,10970,-3601
2018,9,23,14,14990,15265,11595,-3670
2018,9,23,15,15466,15666,11776,-3890
2018,9,23,16,15717,15901,11891,-4010
2018,9,23,17,15864,16038,12143,-3895
2018,9,23,18,15918,16106,12170,-3936
2018,9,23,19,15931,16221,12219,-4002
2018,9,23,20,15989,16345,12189,-4156
2018,9,23,21,16166,16644,12464,-4180
2018,9,23,22,16338,17012,12753,-4259
2018,9,23,23,16451,17290,13050,-4240
2018,9,24,0,17049,17646,13208,-4438
2018,9,24,1,16908,17338,13290,-4048
2018,9,24,2,16139,16586,12977,-3609
2018,9,24,3,15158,15560,12382,-3178
2018,9,24,4,14169,14546,11579,-2967
2018,9,24,5,13657,13795,10674,-3121
2018,9,24,6,13156,13306,10296,-3010
2018,9,24,7,12832,13007,9978,-3029
2018,9,24,8,12699,12868,9772,-3096
2018,9,24,9,12870,13066,10459,-2607
2018,9,24,10,13687,13891,11266,-2625
2018,9,24,11,15332,15486,12483,-3003
2018,9,24,12,16530,16577,13540,-3037
2018,9,24,13,17268,17115,13723,-3392
2018,9,24,14,17779,17434,13875,-3559
2018,9,24,15,18122,17721,14113,-3608
2018,9,24,16,18306,17910,14211,-3699
2018,9,24,17,18361,18103,14401,-3702
2018,9,24,18,18450,18206,14253,-3953
2018,9,24,19,18442,18249,14374,-3875
2018,9,24,20,18444,18327,14614,-3713
2018,9,24,21,18530,18423,14970,-3453
2018,9,24,22,18552,18442,15097,-3345
2018,9,24,23,18459,18469,15141,-3328
2018,9,25,0,18857,18741,15478,-3263
2018,9,25,1,18463,18175,15297,-2878
2018,9,25,2,17402,17193,14832,-2361
2018,9,25,3,16065,15905,14105,-1800
2018,9,25,4,14782,14653,12857,-1796
2018,9,25,5,14260,13768,12500,-1268
2018,9,25,6,13664,13231,12008,-1223
2018,9,25,7,13276,12919,12175,-744
2018,9,25,8,13093,12800,11648,-1152
2018,9,25,9,13213,12974,12083,-891
2018,9,25,10,14009,13854,12816,-1038
2018,9,25,11,15692,15588,13683,-1905
2018,9,25,12,16881,16897,14643,-2254
2018,9,25,13,17621,17713,15107,-2606
2018,9,25,14,18169,18324,15658,-2666
2018,9,25,15,18562,18787,16222,-2565
2018,9,25,16,18796,19057,16260,-2797
2018,9,25,17,18944,19224,16487,-2737
2018,9,25,18,19123,19391,16480,-2911
2018,9,25,19,19205,19473,16482,-2991
2018,9,25,20,19313,19610,16631,-2979
2018,9,25,21,19533,19844,17105,-2739
2018,9,25,22,19622,19954,17404,-2550
2018,9,25,23,19514,19958,17106,-2852
2018,9,26,0,19823,20076,16924,-3152
2018,9,26,1,19425,19514,16520,-2994
2018,9,26,2,18396,18570,15679,-2891
2018,9,26,3,17036,17340,14863,-2477
2018,9,26,4,15797,16180,14101,-2079
2018,9,26,5,16061,15252,13479,-1773
2018,9,26,6,15389,14688,13271,-1417
2018,9,26,7,14845,14382,13057,-1325
2018,9,26,8,14562,14256,12770,-1486
2018,9,26,9,14642,14491,12972,-1519
2018,9,26,10,15514,15467,13603,-1864
2018,9,26,11,17420,17479,15295,-2184
2018,9,26,12,18797,18931,16490,-2441
2018,9,26,13,19722,19781,16844,-2937
2018,9,26,14,20421,20402,17329,-3073
2018,9,26,15,20986,20932,17736,-3196
2018,9,26,16,21406,21417,18200,-3217
2018,9,26,17,21682,21758,18661,-3097
2018,9,26,18,21961,22037,18474,-3563
2018,9,26,19,22075,22298,18751,-3547
2018,9,26,20,22149,22504,18942,-3562
2018,9,26,21,22206,22739,19542,-3197
2018,9,26,22,22041,22571,19651,-2920
2018,9,26,23,21637,22220,19189,-3031
2018,9,27,0,21779,22193,19578,-2615
2018,9,27,1,21165,21460,18840,-2620
2018,9,27,2,19926,20422,17422,-3000
2018,9,27,3,18338,18820,15502,-3318
2018,9,27,4,16616,17297,14320,-2977
2018,9,27,5,14661,16016,12980,-3036
2018,9,27,6,14017,15057,12258,-2799
2018,9,27,7,13679,14393,11651,-2742
2018,9,27,8,13526,14004,11247,-2757
2018,9,27,9,13638,13993,11423,-2570
2018,9,27,10,14350,14622,12078,-2544
2018,9,27,11,15884,16152,13387,-2765
2018,9,27,12,16911,17118,14014,-3104
2018,9,27,13,17463,17633,14252,-3381
2018,9,27,14,17830,17897,14362,-3535
2018,9,27,15,18062,18094,14504,-3590
2018,9,27,16,18144,18328,14748,-3580
2018,9,27,17,18149,18505,14917,-3588
2018,9,27,18,18201,18882,14686,-4196
2018,9,27,19,18167,18989,14827,-4162
2018,9,27,20,18141,19149,15247,-3902
2018,9,27,21,18210,19263,15200,-4063
2018,9,27,22,18230,19260,15403,-3857
2018,9,27,23,18181,19278,15668,-3610
2018,9,28,0,18521,19426,16075,-3351
2018,9,28,1,18213,18837,15535,-3302
2018,9,28,2,17292,17898,14599,-3299
2018,9,28,3,16149,16669,13326,-3343
2018,9,28,4,15037,15413,12723,-2690
2018,9,28,5,14229,14410,12188,-2222
2018,9,28,6,13608,13821,11407,-2414
2018,9,28,7,13218,13475,10899,-2576
2018,9,28,8,13031,13341,10966,-2375
2018,9,28,9,13127,13498,11203,-2295
2018,9,28,10,13874,14271,11726,-2545
2018,9,28,11,15535,15951,13646,-2305
2018,9,28,12,16696,17071,14498,-2573
2018,9,28,13,17398,17619,14556,-3063
2018,9,28,14,17889,17982,14623,-3359
2018,9,28,15,18203,18185,14828,-3357
2018,9,28,16,18265,18191,14501,-3690
2018,9,28,17,18253,18087,14564,-3523
2018,9,28,18,18275,18051,14616,-3435
2018,9,28,19,18204,17916,14523,-3393
2018,9,28,20,18135,17890,14362,-3528
2018,9,28,21,18152,17974,14468,-3506
2018,9,28,22,18072,18015,14895,-3120
2018,9,28,23,17912,17902,14783,-3119
2018,9,29,0,18170,18028,14760,-3268
2018,9,29,1,17785,17490,14634,-2856
2018,9,29,2,16865,16787,14255,-2532
2018,9,29,3,15780,15774,13386,-2388
2018,9,29,4,14661,14679,12478,-2201
2018,9,29,5,14005,13723,11987,-1736
2018,9,29,6,13368,13158,11050,-2108
2018,9,29,7,12953,12772,11092,-1680
2018,9,29,8,12704,12535,11009,-1526
2018,9,29,9,12636,12513,10996,-1517
2018,9,29,10,12859,12764,11221,-1543
2018,9,29,11,13514,13405,11589,-1816
2018,9,29,12,14093,14049,11798,-2251
2018,9,29,13,14949,14943,12282,-2661
2018,9,29,14,15666,15481,12843,-2638
2018,9,29,15,16129,15798,13236,-2562
2018,9,29,16,16288,15970,13374,-2596
2018,9,29,17,16328,16020,13292,-2728
2018,9,29,18,16295,16090,13466,-2624
2018,9,29,19,16258,16163,13471,-2692
2018,9,29,20,16255,16258,13370,-2888
2018,9,29,21,16372,16453,13364,-3089
2018,9,29,22,16498,16661,13863,-2798
2018,9,29,23,16594,16810,14227,-2583
2018,9,30,0,16988,17121,14666,-2455
2018,9,30,1,16787,16787,14144,-2643
2018,9,30,2,16092,16202,13889,-2313
2018,9,30,3,15251,15336,13314,-2022
2018,9,30,4,14346,14391,12093,-2298
2018,9,30,5,13428,13605,11765,-1840
2018,9,30,6,12844,13029,11232,-1797
2018,9,30,7,12481,12623,11091,-1532
2018,9,30,8,12265,12374,10981,-1393
2018,9,30,9,12194,12291,10944,-1347
2018,9,30,10,12359,12438,11036,-1402
2018,9,30,11,12872,12811,11294,-1517
2018,9,30,12,13228,13258,11595,-1663
2018,9,30,13,13893,14054,12140,-1914
2018,9,30,14,14501,14696,12390,-2306
2018,9,30,15,14929,15094,12631,-2463
2018,9,30,16,15160,15371,13023,-2348
2018,9,30,17,15290,15563,13437,-2126
2018,9,30,18,15349,15648,13530,-2118
2018,9,30,19,15375,15802,13744,-2058
2018,9,30,20,15444,16063,14002,-2061
2018,9,30,21,15681,16353,13825,-2528
2018,9,30,22,15948,16739,13701,-3038
2018,9,30,23,16202,17084,14363,-2721
2018,10,1,0,16697,17466,14942,-2524
2018,10,1,1,16586,17098,15037,-2061
2018,10,1,2,15815,16335,14155,-2180
2018,10,1,3,14838,15390,13288,-2102
2018,10,1,4,13885,14364,12251,-2113
2018,10,1,5,13046,13616,11616,-2000
2018,10,1,6,12561,13157,11095,-2062
2018,10,1,7,12266,12878,10676,-2202
2018,10,1,8,12152,12725,10662,-2063
2018,10,1,9,12340,12971,11207,-1764
2018,10,1,10,13173,13900,12213,-1687
2018,10,1,11,14851,15762,14027,-1735
2018,10,1,12,16132,17079,15030,-2049
2018,10,1,13,16857,17799,14830,-2969
2018,10,1,14,17378,18272,15258,-3014
2018,10,1,15,17738,18632,15663,-2969
2018,10,1,16,17952,18891,15905,-2986
2018,10,1,17,18039,19093,16064,-3029
2018,10,1,18,18150,19212,16485,-2727
2018,10,1,19,18169,19220,16248,-2972
2018,10,1,20,18212,19299,16030,-3269
2018,10,1,21,18303,19546,16378,-3168
2018,10,1,22,18370,19731,16515,-3216
2018,10,1,23,18479,19806,16384,-3422
2018,10,2,0,18890,19948,16650,-3298
2018,10,2,1,18383,19293,16231,-3062
2018,10,2,2,17345,18252,15328,-2924
2018,10,2,3,16059,16958,14295,-2663
2018,10,2,4,14777,15700,13610,-2090
2018,10,2,5,14262,14723,12956,-1767
2018,10,2,6,13687,14145,12259,-1886
2018,10,2,7,13331,13762,12237,-1525
2018,10,2,8,13168,13600,12047,-1553
2018,10,2,9,13311,13780,12150,-1630
2018,10,2,10,14089,14656,12785,-1871
2018,10,2,11,15734,16454,14791,-1663
2018,10,2,12,16971,17768,15795,-1973
2018,10,2,13,17671,18460,16114,-2346
2018,10,2,14,18185,19049,16498,-2551
2018,10,2,15,18570,19525,16883,-2642
2018,10,2,16,18833,19923,17517,-2406
2018,10,2,17,18989,20221,17834,-2387
2018,10,2,18,19169,20383,18167,-2216
2018,10,2,19,19243,20440,18219,-2221
2018,10,2,20,19324,20547,18404,-2143
2018,10,2,21,19414,20666,18384,-2282
2018,10,2,22,19421,20743,18666,-2077
2018,10,2,23,19458,20756,18611,-2145
2018,10,3,0,19752,20788,18804,-1984
2018,10,3,1,19207,20112,18265,-1847
2018,10,3,2,18197,19021,17226,-1795
2018,10,3,3,16908,17585,16076,-1509
2018,10,3,4,15586,16035,14747,-1288
2018,10,3,5,14531,15009,13091,-1918
2018,10,3,6,13845,14349,12286,-2063
2018,10,3,7,13421,13901,12131,-1770
2018,10,3,8,13213,13694,12144,-1550
2018,10,3,9,13338,13821,12117,-1704
2018,10,3,10,14151,14666,12780,-1886
2018,10,3,11,15911,16464,14707,-1757
2018,10,3,12,17216,17659,15608,-2051
2018,10,3,13,17919,18332,16003,-2329
2018,10,3,14,18395,18823,16470,-2353
2018,10,3,15,18721,19140,17114,-2026
2018,10,3,16,18862,19374,17293,-2081
2018,10,3,17,18912,19508,17459,-2049
2018,10,3,18,19009,19656,17848,-1808
2018,10,3,19,19015,19722,17951,-1771
2018,10,3,20,19049,19844,18209,-1635
2018,10,3,21,19109,19982,18456,-1526
2018,10,3,22,19107,19967,18309,-1658
2018,10,3,23,19112,19845,18212,-1633
2018,10,4,0,19404,20005,18571,-1434
2018,10,4,1,18853,19369,17875,-1494
2018,10,4,2,17815,18368,16761,-1607
2018,10,4,3,16476,17040,15525,-1515
2018,10,4,4,15089,15701,14235,-1466
2018,10,4,5,14101,14624,12868,-1756
2018,10,4,6,13452,14024,12211,-1813
2018,10,4,7,13057,13617,12174,-1443
2018,10,4,8,12876,13486,12310,-1176
2018,10,4,9,13011,13641,12607,-1034
2018,10,4,10,13808,14472,13184,-1288
2018,10,4,11,15515,16250,15492,-758
2018,10,4,12,16803,17493,16805,-688
2018,10,4,13,17543,18305,16842,-1463
2018,10,4,14,18091,18889,17091,-1798
2018,10,4,15,18517,19310,17201,-2109
2018,10,4,16,18840,19686,17433,-2253
2018,10,4,17,19038,19937,17917,-2020
2018,10,4,18,19270,20103,18169,-1934
2018,10,4,19,19391,20132,18472,-1660
2018,10,4,20,19498,20173,18836,-1337
2018,10,4,21,19601,20272,19233,-1039
2018,10,4,22,19620,20326,19391,-935
2018,10,4,23,19647,20340,19086,-1254
2018,10,5,0,19915,20532,19270,-1262
2018,10,5,1,19374,19994,18450,-1544
2018,10,5,2,18394,19090,17588,-1502
2018,10,5,3,17114,17749,15933,-1816
2018,10,5,4,15696,16371,14639,-1732
2018,10,5,5,13997,15297,13189,-2108
2018,10,5,6,13362,14508,12575,-1933
2018,10,5,7,13012,13926,12149,-1777
2018,10,5,8,12855,13596,11994,-1602
2018,10,5,9,13008,13616,11970,-1646
2018,10,5,10,13791,14270,12938,-1332
2018,10,5,11,15434,15878,14420,-1458
2018,10,5,12,16620,16917,15079,-1838
2018,10,5,13,17191,17464,15308,-2156
2018,10,5,14,17538,17708,15241,-2467
2018,10,5,15,17720,17770,15177,-2593
2018,10,5,16,17735,17779,15192,-2587
2018,10,5,17,17638,17787,15147,-2640
2018,10,5,18,17602,17903,15216,-2687
2018,10,5,19,17501,17953,15409,-2544
2018,10,5,20,17431,18079,15831,-2248
2018,10,5,21,17425,18213,15589,-2624
2018,10,5,22,17423,18210,15950,-2260
2018,10,5,23,17583,18282,15591,-2691
2018,10,6,0,17913,18381,15772,-2609
2018,10,6,1,17447,17870,15692,-2178
2018,10,6,2,16627,17146,14977,-2169
2018,10,6,3,15651,16172,13852,-2320
2018,10,6,4,14566,15128,13175,-1953
2018,10,6,5,13458,14151,12662,-1489
2018,10,6,6,12838,13537,11847,-1690
2018,10,6,7,12469,13163,11086,-2077
2018,10,6,8,12256,12967,11022,-1945
2018,10,6,9,12237,12955,10992,-1963
2018,10,6,10,12489,13220,11289,-1931
2018,10,6,11,13118,13844,12041,-1803
2018,10,6,12,13764,14611,12737,-1874
2018,10,6,13,14575,15566,13257,-2309
2018,10,6,14,15236,16288,13724,-2564
2018,10,6,15,15639,16664,14016,-2648
2018,10,6,16,15782,16768,14123,-2645
2018,10,6,17,15792,16791,13998,-2793
2018,10,6,18,15744,16796,14299,-2497
2018,10,6,19,15697,16728,14202,-2526
2018,10,6,20,15706,16691,14102,-2589
2018,10,6,21,15805,16789,14630,-2159
2018,10,6,22,15952,17107,14624,-2483
2018,10,6,23,16315,17495,14641,-2854
2018,10,7,0,16719,17728,15154,-2574
2018,10,7,1,16381,17407,14658,-2749
2018,10,7,2,15757,16905,14345,-2560
2018,10,7,3,14980,16131,13589,-2542
2018,10,7,4,14154,15283,12809,-2474
2018,10,7,5,13777,14473,12298,-2175
2018,10,7,6,13165,13917,11743,-2174
2018,10,7,7,12725,13524,11127,-2397
2018,10,7,8,12452,13293,11023,-2270
2018,10,7,9,12363,13235,10951,-2284
2018,10,7,10,12518,13401,11123,-2278
2018,10,7,11,13023,13841,11492,-2349
2018,10,7,12,13547,14422,11997,-2425
2018,10,7,13,14391,15339,12599,-2740
2018,10,7,14,15204,16189,13409,-2780
2018,10,7,15,15826,16813,13605,-3208
2018,10,7,16,16274,17237,14238,-2999
2018,10,7,17,16574,17517,14299,-3218
2018,10,7,18,16764,17695,14748,-2947
2018,10,7,19,16885,17863,14779,-3084
2018,10,7,20,17029,18093,15390,-2703
2018,10,7,21,17239,18452,15832,-2620
2018,10,7,22,17461,18745,16356,-2389
2018,10,7,23,17817,19031,16061,-2970
2018,10,8,0,18184,19240,16429,-2811
2018,10,8,1,17791,18704,16126,-2578
2018,10,8,2,17011,17954,15340,-2614
2018,10,8,3,15982,17002,14152,-2850
2018,10,8,4,14903,16018,13324,-2694
2018,10,8,5,14380,15109,12140,-2969
2018,10,8,6,13826,14478,11568,-2910
2018,10,8,7,13498,14028,11411,-2617
2018,10,8,8,13356,13782,11176,-2606
2018,10,8,9,13528,13912,11461,-2451
2018,10,8,10,14344,14516,12431,-2085
2018,10,8,11,16019,15720,13512,-2208
2018,10,8,12,17308,16862,14499,-2363
2018,10,8,13,18008,17717,15165,-2552
2018,10,8,14,18502,18357,15945,-2412
2018,10,8,15,18819,18699,16252,-2447
2018,10,8,16,18953,18835,16675,-2160
2018,10,8,17,18957,18829,16562,-2267
2018,10,8,18,18977,18924,16963,-1961
2018,10,8,19,18907,18950,17486,-1464
2018,10,8,20,18876,19013,17431,-1582
2018,10,8,21,18941,19197,17386,-1811
2018,10,8,22,19030,19418,17597,-1821
2018,10,8,23,19266,19560,17420,-2140
2018,10,9,0,19515,19564,17769,-1795
2018,10,9,1,18922,18933,17333,-1600
2018,10,9,2,17903,18074,16399,-1675
2018,10,9,3,16614,16876,15026,-1850
2018,10,9,4,15342,15715,14217,-1498
2018,10,9,5,14882,14822,13164,-1658
2018,10,9,6,14214,14238,12621,-1617
2018,10,9,7,13763,13876,12437,-1439
2018,10,9,8,13550,13725,12211,-1514
2018,10,9,9,13694,13895,12501,-1394
2018,10,9,10,14565,14780,13411,-1369
2018,10,9,11,16416,16702,15325,-1377
2018,10,9,12,17824,18132,16239,-1893
2018,10,9,13,18636,18975,16991,-1984
2018,10,9,14,19250,19541,17330,-2211
2018,10,9,15,19751,20005,17818,-2187
2018,10,9,16,20094,20382,18287,-2095
2018,10,9,17,20345,20672,18499,-2173
2018,10,9,18,20613,21009,18885,-2124
2018,10,9,19,20761,21238,19235,-2003
2018,10,9,20,20891,21452,19164,-2288
2018,10,9,21,21028,21678,19479,-2199
2018,10,9,22,21060,21753,19573,-2180
2018,10,9,23,21118,21726,19110,-2616
2018,10,10,0,21171,21838,19388,-2450
2018,10,10,1,20432,21062,18582,-2480
2018,10,10,2,19295,19966,17710,-2256
2018,10,10,3,17797,18607,16331,-2276
2018,10,10,4,16274,17245,15308,-1937
2018,10,10,5,15581,16159,14235,-1924
2018,10,10,6,14903,15393,13517,-1876
2018,10,10,7,14442,14889,12959,-1930
2018,10,10,8,14210,14638,12987,-1651
2018,10,10,9,14324,14737,12981,-1756
2018,10,10,10,15148,15608,13887,-1721
2018,10,10,11,16931,17433,15467,-1966
2018,10,10,12,18297,18722,16503,-2219
2018,10,10,13,19082,19545,17058,-2487
2018,10,10,14,19677,20112,17695,-2417
2018,10,10,15,20173,20707,18313,-2394
2018,10,10,16,20556,21196,18870,-2326
2018,10,10,17,20825,21605,19482,-2123
2018,10,10,18,21124,22063,19787,-2276
2018,10,10,19,21301,22437,20225,-2212
2018,10,10,20,21463,22730,20729,-2001
2018,10,10,21,21609,22927,21131,-1796
2018,10,10,22,21623,22797,21314,-1483
2018,10,10,23,21668,22650,20667,-1983
2018,10,11,0,21655,22608,20939,-1669
2018,10,11,1,20915,21804,20098,-1706
2018,10,11,2,19836,20729,18927,-1802
2018,10,11,3,18397,19217,17281,-1936
2018,10,11,4,16899,17762,15871,-1891
2018,10,11,5,15996,16678,14657,-2021
2018,10,11,6,15252,15964,14156,-1808
2018,10,11,7,14758,15503,13753,-1750
2018,10,11,8,14512,15317,13629,-1688
2018,10,11,9,14635,15521,13906,-1615
2018,10,11,10,15507,16467,14807,-1660
2018,10,11,11,17379,18405,16682,-1723
2018,10,11,12,18796,19804,18086,-1718
2018,10,11,13,19561,20601,18580,-2021
2018,10,11,14,20107,21183,19182,-2001
2018,10,11,15,20475,21631,19821,-1810
2018,10,11,16,20702,21694,20093,-1601
2018,10,11,17,20780,21535,19778,-1757
2018,10,11,18,20870,21636,20485,-1151
2018,10,11,19,20827,21651,20510,-1141
2018,10,11,20,20794,21643,20662,-981
2018,10,11,21,20807,21468,20080,-1388
2018,10,11,22,20804,21381,19989,-1392
2018,10,11,23,20955,21381,19859,-1522
2018,10,12,0,21061,21177,19869,-1308
2018,10,12,1,20344,20466,18986,-1480
2018,10,12,2,19270,19503,17899,-1604
2018,10,12,3,17870,18176,16458,-1718
2018,10,12,4,16303,16748,14898,-1850
2018,10,12,5,14336,15674,13634,-2040
2018,10,12,6,13629,14830,12835,-1995
2018,10,12,7,13252,14238,12482,-1756
2018,10,12,8,13074,13931,12206,-1725
2018,10,12,9,13201,13930,12139,-1791
2018,10,12,10,13966,14538,13043,-1495
2018,10,12,11,15614,16057,14229,-1828
2018,10,12,12,16875,17204,15413,-1791
2018,10,12,13,17497,17484,15475,-2009
2018,10,12,14,17923,17617,15502,-2115
2018,10,12,15,18163,17699,15597,-2102
2018,10,12,16,18109,17584,15691,-1893
2018,10,12,17,18008,17431,15744,-1687
2018,10,12,18,17951,17408,15999,-1409
2018,10,12,19,17837,17313,15806,-1507
2018,10,12,20,17747,17373,16069,-1304
2018,10,12,21,17754,17528,16104,-1424
2018,10,12,22,17807,17618,16386,-1232
2018,10,12,23,18097,17820,16141,-1679
2018,10,13,0,18251,17799,16360,-1439
2018,10,13,1,17708,17252,15776,-1476
2018,10,13,2,16902,16509,14725,-1784
2018,10,13,3,15929,15533,13556,-1977
2018,10,13,4,14801,14406,12668,-1738
2018,10,13,5,13437,13509,12199,-1310
2018,10,13,6,12784,12941,11956,-985
2018,10,13,7,12407,12587,11599,-988
2018,10,13,8,12203,12384,11373,-1011
2018,10,13,9,12207,12364,11266,-1098
2018,10,13,10,12507,12613,11476,-1137
2018,10,13,11,13211,13277,12076,-1201
2018,10,13,12,13921,14064,12699,-1365
2018,10,13,13,14714,14963,13753,-1210
2018,10,13,14,15364,15641,14746,-895
2018,10,13,15,15735,15939,14942,-997
2018,10,13,16,15795,15944,14843,-1101
2018,10,13,17,15751,15817,14244,-1573
2018,10,13,18,15629,15590,14299,-1291
2018,10,13,19,15515,15379,13956,-1423
2018,10,13,20,15467,15358,14030,-1328
2018,10,13,21,15569,15537,14063,-1474
2018,10,13,22,15791,15796,14077,-1719
2018,10,13,23,16372,16361,14150,-2211
2018,10,14,0,16732,16592,14693,-1899
2018,10,14,1,16393,16274,14523,-1751
2018,10,14,2,15780,15749,14054,-1695
2018,10,14,3,15001,14995,13591,-1404
2018,10,14,4,14115,14114,12838,-1276
2018,10,14,5,13251,13360,12090,-1270
2018,10,14,6,12678,12778,11178,-1600
2018,10,14,7,12319,12406,10862,-1544
2018,10,14,8,12119,12210,10820,-1390
2018,10,14,9,12097,12182,10800,-1382
2018,10,14,10,12313,12367,10970,-1397
2018,10,14,11,12852,12881,11575,-1306
2018,10,14,12,13344,13450,11941,-1509
2018,10,14,13,13959,14103,12763,-1340
2018,10,14,14,14497,14610,13274,-1336
2018,10,14,15,14818,14871,13463,-1408
2018,10,14,16,14964,14903,13459,-1444
2018,10,14,17,14997,14955,13320,-1635
2018,10,14,18,14950,15013,13361,-1652
2018,10,14,19,14893,14949,13222,-1727
2018,10,14,20,14918,15007,13203,-1804
2018,10,14,21,15139,15368,13372,-1996
2018,10,14,22,15537,15873,14021,-1852
2018,10,14,23,16262,16581,14685,-1896
2018,10,15,0,16713,16872,15633,-1239
2018,10,15,1,16457,16490,15089,-1401
2018,10,15,2,15765,15789,14044,-1745
2018,10,15,3,14823,14817,13229,-1588
2018,10,15,4,13831,13806,12477,-1329
2018,10,15,5,13072,13037,11762,-1275
2018,10,15,6,12627,12590,10879,-1711
2018,10,15,7,12368,12380,10777,-1603
2018,10,15,8,12279,12313,10646,-1667
2018,10,15,9,12481,12542,10983,-1559
2018,10,15,10,13305,13439,12249,-1190
2018,10,15,11,14969,15235,14117,-1118
2018,10,15,12,16258,16719,15777,-942
2018,10,15,13,16865,17421,16448,-973
2018,10,15,14,17264,17863,16700,-1163
2018,10,15,15,17515,18216,16832,-1384
2018,10,15,16,17639,18378,16766,-1612
2018,10,15,17,17647,18356,16814,-1542
2018,10,15,18,17680,18268,16732,-1536
2018,10,15,19,17642,18229,16593,-1636
2018,10,15,20,17633,18279,16884,-1395
2018,10,15,21,17777,18423,17072,-1351
2018,10,15,22,17975,18702,17402,-1300
2018,10,15,23,18451,19061,17656,-1405
2018,10,16,0,18638,18872,18021,-851
2018,10,16,1,18104,18258,17484,-774
2018,10,16,2,17172,17289,16335,-954
2018,10,16,3,15953,16035,14595,-1440
2018,10,16,4,14665,14796,13784,-1012
2018,10,16,5,13347,13770,12952,-818
2018,10,16,6,12788,13138,12161,-977
2018,10,16,7,12489,12793,11721,-1072
2018,10,16,8,12375,12671,11593,-1078
2018,10,16,9,12563,12882,12004,-878
2018,10,16,10,13370,13781,13141,-640
2018,10,16,11,15040,15493,14484,-1009
2018,10,16,12,16274,16698,15841,-857
2018,10,16,13,16753,16998,15747,-1251
2018,10,16,14,17033,17183,15618,-1565
2018,10,16,15,17192,17277,15681,-1596
2018,10,16,16,17176,17224,15513,-1711
2018,10,16,17,17103,17009,15149,-1860
2018,10,16,18,17080,16907,15109,-1798
2018,10,16,19,17011,16872,15340,-1532
2018,10,16,20,16991,16930,15606,-1324
2018,10,16,21,17130,17203,15742,-1461
2018,10,16,22,17374,17605,16163,-1442
2018,10,16,23,17906,18264,16274,-1990
2018,10,17,0,18112,18403,16708,-1695
2018,10,17,1,17625,17894,16305,-1589
2018,10,17,2,16739,17007,15659,-1348
2018,10,17,3,15549,15766,14464,-1302
2018,10,17,4,14333,14576,13436,-1140
2018,10,17,5,13359,13650,12595,-1055
2018,10,17,6,12801,13119,11912,-1207
2018,10,17,7,12472,12811,11751,-1060
2018,10,17,8,12336,12696,11784,-912
2018,10,17,9,12495,12920,12143,-777
2018,10,17,10,13278,13836,12998,-838
2018,10,17,11,14947,15649,14416,-1233
2018,10,17,12,16204,16919,15181,-1738
2018,10,17,13,16690,17272,15031,-2241
2018,10,17,14,16956,17339,14739,-2600
2018,10,17,15,17081,17326,14986,-2340
2018,10,17,16,17105,17250,14950,-2300
2018,10,17,17,17038,17289,15118,-2171
2018,10,17,18,17027,17345,15165,-2180
2018,10,17,19,16975,17293,15395,-1898
2018,10,17,20,16979,17386,15498,-1888
2018,10,17,21,17134,17608,15530,-2078
2018,10,17,22,17411,18026,16062,-1964
2018,10,17,23,17971,18583,16634,-1949
2018,10,18,0,18164,18650,16727,-1923
2018,10,18,1,17716,18092,16286,-1806
2018,10,18,2,16886,17209,15419,-1790
2018,10,18,3,15739,16000,14598,-1402
2018,10,18,4,14534,14759,13753,-1006
2018,10,18,5,13605,13918,13008,-910
2018,10,18,6,13062,13449,12467,-982
2018,10,18,7,12746,13184,12063,-1121
2018,10,18,8,12634,13117,11798,-1319
2018,10,18,9,12828,13346,12073,-1273
2018,10,18,10,13659,14277,12942,-1335
2018,10,18,11,15391,16148,14785,-1363
2018,10,18,12,16690,17381,15852,-1529
2018,10,18,13,17184,17657,15611,-2046
2018,10,18,14,17467,17709,15067,-2642
2018,10,18,15,17597,17656,15122,-2534
2018,10,18,16,17539,17513,15102,-2411
2018,10,18,17,17429,17345,15003,-2342
2018,10,18,18,17385,17260,15076,-2184
2018,10,18,19,17307,17143,15040,-2103
2018,10,18,20,17292,17215,15007,-2208
2018,10,18,21,17453,17520,15307,-2213
2018,10,18,22,17775,18016,15782,-2234
2018,10,18,23,18384,18657,16161,-2496
2018,10,19,0,18578,18822,16813,-2009
2018,10,19,1,18123,18333,16278,-2055
2018,10,19,2,17279,17489,15286,-2203
2018,10,19,3,16101,16327,14434,-1893
2018,10,19,4,14873,15166,13676,-1490
2018,10,19,5,13795,14273,13075,-1198
2018,10,19,6,13236,13786,12326,-1460
2018,10,19,7,12912,13483,12079,-1404
2018,10,19,8,12779,13398,12077,-1321
2018,10,19,9,12940,13599,12354,-1245
2018,10,19,10,13726,14517,13169,-1348
2018,10,19,11,15384,16255,14988,-1267
2018,10,19,12,16620,17395,15861,-1534
2018,10,19,13,17060,17655,15648,-2007
2018,10,19,14,17277,17617,15267,-2350
2018,10,19,15,17332,17477,15114,-2363
2018,10,19,16,17229,17298,14787,-2511
2018,10,19,17,17060,17137,14757,-2380
2018,10,19,18,16964,16998,14627,-2371
2018,10,19,19,16845,16904,14661,-2243
2018,10,19,20,16771,17005,14853,-2152
2018,10,19,21,16836,17202,14785,-2417
2018,10,19,22,16996,17492,15147,-2345
2018,10,19,23,17492,17984,15416,-2568
2018,10,20,0,17563,17861,15512,-2349
2018,10,20,1,17061,17341,15149,-2192
2018,10,20,2,16332,16607,14511,-2096
2018,10,20,3,15380,15668,13851,-1817
2018,10,20,4,14308,14607,12898,-1709
2018,10,20,5,13301,13756,12182,-1574
2018,10,20,6,12688,13182,11256,-1926
2018,10,20,7,12303,12833,11008,-1825
2018,10,20,8,12088,12673,10746,-1927
2018,10,20,9,12053,12660,10774,-1886
2018,10,20,10,12298,12946,11225,-1721
2018,10,20,11,12947,13654,12247,-1407
2018,10,20,12,13695,14482,13400,-1082
2018,10,20,13,14464,15320,13660,-1660
2018,10,20,14,15108,15790,13868,-1922
2018,10,20,15,15471,15909,13960,-1949
2018,10,20,16,15531,15964,14209,-1755
2018,10,20,17,15490,15862,14094,-1768
2018,10,20,18,15370,15621,13818,-1803
2018,10,20,19,15260,15431,13639,-1792
2018,10,20,20,15209,15463,13799,-1664
2018,10,20,21,15320,15689,14096,-1593
2018,10,20,22,15603,16082,14339,-1743
2018,10,20,23,16312,16681,14881,-1800
2018,10,21,0,16508,16688,14921,-1767
2018,10,21,1,16108,16358,14634,-1724
2018,10,21,2,15547,15851,14028,-1823
2018,10,21,3,14824,15103,13336,-1767
2018,10,21,4,13987,14273,12702,-1571
2018,10,21,5,13122,13548,11860,-1688
2018,10,21,6,12585,13062,11354,-1708
2018,10,21,7,12244,12752,11219,-1533
2018,10,21,8,12057,12568,11088,-1480
2018,10,21,9,12028,12559,11403,-1156
2018,10,21,10,12215,12784,11656,-1128
2018,10,21,11,12719,13343,12316,-1027
2018,10,21,12,13287,14079,13335,-744
2018,10,21,13,13944,14848,13823,-1025
2018,10,21,14,14578,15424,14178,-1246
2018,10,21,15,14992,15734,14105,-1629
2018,10,21,16,15163,15870,14079,-1791
2018,10,21,17,15246,15875,14025,-1850
2018,10,21,18,15227,15832,13880,-1952
2018,10,21,19,15195,15765,13852,-1913
2018,10,21,20,15229,15824,13869,-1955
2018,10,21,21,15478,16239,14274,-1965
2018,10,21,22,15950,16864,14899,-1965
2018,10,21,23,16807,17654,15644,-2010
2018,10,22,0,17094,17733,15828,-1905
2018,10,22,1,16776,17308,15145,-2163
2018,10,22,2,16146,16585,14057,-2528
2018,10,22,3,15268,15566,13174,-2392
2018,10,22,4,14320,14544,12640,-1904
2018,10,22,5,13407,13802,12203,-1599
2018,10,22,6,12950,13417,11843,-1574
2018,10,22,7,12707,13185,11890,-1295
2018,10,22,8,12637,13142,11884,-1258
2018,10,22,9,12856,13407,12035,-1372
2018,10,22,10,13706,14359,12755,-1604
2018,10,22,11,15396,16127,14292,-1835
2018,10,22,12,16704,17404,15309,-2095
2018,10,22,13,17180,17806,15103,-2703
2018,10,22,14,17451,18019,15113,-2906
2018,10,22,15,17565,18105,14789,-3316
2018,10,22,16,17540,18071,14656,-3415
2018,10,22,17,17429,17988,14805,-3183
2018,10,22,18,17365,17919,14781,-3138
2018,10,22,19,17251,17698,14944,-2754
2018,10,22,20,17196,17823,15139,-2684
2018,10,22,21,17330,18015,15457,-2558
2018,10,22,22,17644,18404,16295,-2109
2018,10,22,23,18320,18964,16678,-2286
2018,10,23,0,18427,18844,16399,-2445
2018,10,23,1,17901,18273,16344,-1929
2018,10,23,2,17012,17357,15174,-2183
2018,10,23,3,15811,16100,14256,-1844
2018,10,23,4,14558,14874,13609,-1265
2018,10,23,5,13464,13996,12682,-1314
2018,10,23,6,12920,13524,12414,-1110
2018,10,23,7,12619,13236,12224,-1012
2018,10,23,8,12503,13130,12194,-936
2018,10,23,9,12668,13331,12553,-778
2018,10,23,10,13453,14218,13094,-1124
2018,10,23,11,15110,16020,14720,-1300
2018,10,23,12,16410,17274,15427,-1847
2018,10,23,13,16888,17618,15647,-1971
2018,10,23,14,17179,17685,15753,-1932
2018,10,23,15,17329,17629,15763,-1866
2018,10,23,16,17302,17472,15355,-2117
2018,10,23,17,17242,17265,15438,-1827
2018,10,23,18,17221,17226,15416,-1810
2018,10,23,19,17151,17151,15135,-2016
2018,10,23,20,17122,17281,15248,-2033
2018,10,23,21,17266,17636,15464,-2172
2018,10,23,22,17558,18087,16142,-1945
2018,10,23,23,18209,18629,16618,-2011
2018,10,24,0,18266,18423,17328,-1095
2018,10,24,1,17746,17827,17030,-797
2018,10,24,2,16906,16964,15498,-1466
2018,10,24,3,15743,15789,14241,-1548
2018,10,24,4,14523,14647,13303,-1344
2018,10,24,5,13525,13828,12811,-1017
2018,10,24,6,12958,13366,12114,-1252
2018,10,24,7,12628,13096,11580,-1516
2018,10,24,8,12491,12987,11460,-1527
2018,10,24,9,12647,13265,12036,-1229
2018,10,24,10,13439,14181,13445,-736
2018,10,24,11,15137,16002,14953,-1049
2018,10,24,12,16472,17270,16349,-921
2018,10,24,13,16953,17633,16301,-1332
2018,10,24,14,17245,17731,15978,-1753
2018,10,24,15,17384,17782,16015,-1767
2018,10,24,16,17410,17761,16016,-1745
2018,10,24,17,17345,17760,16047,-1713
2018,10,24,18,17330,17684,15772,-1912
2018,10,24,19,17266,17547,15691,-1856
2018,10,24,20,17256,17662,15613,-2049
2018,10,24,21,17426,17932,15930,-2002
2018,10,24,22,17752,18309,16524,-1785
2018,10,24,23,18425,18905,16897,-2008
2018,10,25,0,18474,18796,17335,-1461
2018,10,25,1,17965,18264,16858,-1406
2018,10,25,2,17149,17369,15814,-1555
2018,10,25,3,15987,16159,14437,-1722
2018,10,25,4,14765,14980,13869,-1111
2018,10,25,5,13746,14154,13028,-1126
2018,10,25,6,13196,13647,12547,-1100
2018,10,25,7,12878,13372,12254,-1118
2018,10,25,8,12760,13273,12348,-925
2018,10,25,9,12933,13541,12655,-886
2018,10,25,10,13745,14425,13574,-851
2018,10,25,11,15459,16289,14820,-1469
2018,10,25,12,16790,17541,16017,-1524
2018,10,25,13,17234,17842,15856,-1986
2018,10,25,14,17488,17977,15900,-2077
2018,10,25,15,17590,17918,15838,-2080
2018,10,25,16,17528,17749,15853,-1896
2018,10,25,17,17407,17595,15513,-2082
2018,10,25,18,17352,17531,15426,-2105
2018,10,25,19,17265,17405,15287,-2118
2018,10,25,20,17245,17472,15514,-1958
2018,10,25,21,17417,17780,15880,-1900
2018,10,25,22,17796,18241,16440,-1801
2018,10,25,23,18523,18928,17093,-1835
2018,10,26,0,18593,18829,17149,-1680
2018,10,26,1,18107,18296,16776,-1520
2018,10,26,2,17315,17471,15894,-1577
2018,10,26,3,16171,16282,14990,-1292
2018,10,26,4,14970,15136,13865,-1271
2018,10,26,5,13964,14290,12603,-1687
2018,10,26,6,13403,13774,12299,-1475
2018,10,26,7,13085,13486,12141,-1345
2018,10,26,8,12962,13400,12144,-1256
2018,10,26,9,13123,13654,12497,-1157
2018,10,26,10,13921,14544,13346,-1198
2018,10,26,11,15617,16353,14716,-1637
2018,10,26,12,16955,17622,15921,-1701
2018,10,26,13,17413,18007,16412,-1595
2018,10,26,14,17684,18196,16263,-1933
2018,10,26,15,17774,18164,15809,-2355
2018,10,26,16,17747,17959,15361,-2598
2018,10,26,17,17609,17720,15323,-2397
2018,10,26,18,17520,17632,15378,-2254
2018,10,26,19,17377,17518,15446,-2072
2018,10,26,20,17273,17481,15442,-2039
2018,10,26,21,17326,17634,15400,-2234
2018,10,26,22,17518,17996,15769,-2227
2018,10,26,23,18145,18496,16123,-2373
2018,10,27,0,18101,18220,15946,-2274
2018,10,27,1,17515,17731,16058,-1673
2018,10,27,2,16783,17061,15362,-1699
2018,10,27,3,15825,16117,14487,-1630
2018,10,27,4,14746,15115,13868,-1247
2018,10,27,5,14021,14295,12839,-1456
2018,10,27,6,13408,13797,12531,-1266
2018,10,27,7,13026,13451,12332,-1119
2018,10,27,8,12814,13255,12159,-1096
2018,10,27,9,12782,13269,11782,-1487
2018,10,27,10,13034,13594,12392,-1202
2018,10,27,11,13709,14256,13358,-898
2018,10,27,12,14541,15130,14368,-762
2018,10,27,13,15319,15956,14891,-1065
2018,10,27,14,16024,16783,15466,-1317
2018,10,27,15,16446,17319,15554,-1765
2018,10,27,16,16592,17548,15806,-1742
2018,10,27,17,16587,17567,15890,-1677
2018,10,27,18,16468,17428,15891,-1537
2018,10,27,19,16338,17274,15684,-1590
2018,10,27,20,16264,17191,15392,-1799
2018,10,27,21,16366,17259,15241,-2018
2018,10,27,22,16616,17473,15452,-2021
2018,10,27,23,17329,17807,16157,-1650
2018,10,28,0,17354,17530,16042,-1488
2018,10,28,1,16868,17075,15597,-1478
2018,10,28,2,16281,16466,14784,-1682
2018,10,28,3,15514,15636,14204,-1432
2018,10,28,4,14607,14758,13395,-1363
2018,10,28,5,13566,14024,12756,-1268
2018,10,28,6,12975,13455,12329,-1126
2018,10,28,7,12613,13061,11290,-1771
2018,10,28,8,12409,12857,11136,-1721
2018,10,28,9,12349,12837,11256,-1581
2018,10,28,10,12510,12987,11393,-1594
2018,10,28,11,13009,13483,12145,-1338
2018,10,28,12,13632,14083,13103,-980
2018,10,28,13,14272,14760,13807,-953
2018,10,28,14,14917,15396,14347,-1049
2018,10,28,15,15336,15805,14886,-919
2018,10,28,16,15517,15906,14937,-969
2018,10,28,17,15603,15986,14797,-1189
2018,10,28,18,15577,15959,14583,-1376
2018,10,28,19,15528,15950,14506,-1444
2018,10,28,20,15549,16073,14557,-1516
2018,10,28,21,15779,16487,14557,-1930
2018,10,28,22,16235,17021,14828,-2193
2018,10,28,23,17067,17621,15467,-2154
2018,10,29,0,17200,17512,15702,-1810
2018,10,29,1,16804,17109,15072,-2037
2018,10,29,2,16172,16344,14097,-2247
2018,10,29,3,15277,15383,13347,-2036
2018,10,29,4,14293,14373,12475,-1898
2018,10,29,5,13253,13592,11308,-2284
2018,10,29,6,12769,13149,10918,-2231
2018,10,29,7,12506,12901,10780,-2121
2018,10,29,8,12420,12802,10686,-2116
2018,10,29,9,12600,13076,10930,-2146
2018,10,29,10,13401,14023,11957,-2066
2018,10,29,11,15052,15850,14164,-1686
2018,10,29,12,16450,17280,15511,-1769
2018,10,29,13,16994,17682,15315,-2367
2018,10,29,14,17386,17963,15328,-2635
2018,10,29,15,17605,18196,15573,-2623
2018,10,29,16,17641,18246,15472,-2774
2018,10,29,17,17604,18084,15622,-2462
2018,10,29,18,17578,18083,15608,-2475
2018,10,29,19,17490,17904,15462,-2442
2018,10,29,20,17458,17903,15749,-2154
2018,10,29,21,17611,18092,15747,-2345
2018,10,29,22,17968,18504,16492,-2012
2018,10,29,23,18633,19113,17094,-2019
2018,10,30,0,18617,18922,17044,-1878
2018,10,30,1,18044,18341,16316,-2025
2018,10,30,2,17215,17425,15545,-1880
2018,10,30,3,16048,16179,14254,-1925
2018,10,30,4,14820,15010,12788,-2222
2018,10,30,5,13654,14143,11962,-2181
2018,10,30,6,13099,13663,11454,-2209
2018,10,30,7,12791,13393,11156,-2237
2018,10,30,8,12676,13313,11094,-2219
2018,10,30,9,12845,13559,11551,-2008
2018,10,30,10,13648,14469,12630,-1839
2018,10,30,11,15356,16305,14286,-2019
2018,10,30,12,16717,17691,15814,-1877
2018,10,30,13,17130,18005,16093,-1912
2018,10,30,14,17369,18003,15820,-2183
2018,10,30,15,17470,17887,15841,-2046
2018,10,30,16,17396,17711,15477,-2234
2018,10,30,17,17286,17455,15348,-2107
2018,10,30,18,17228,17286,14946,-2340
2018,10,30,19,17144,17152,14938,-2214
2018,10,30,20,17146,17231,15282,-1949
2018,10,30,21,17345,17523,15584,-1939
2018,10,30,22,17782,18073,15948,-2125
2018,10,30,23,18459,18855,16562,-2293
2018,10,31,0,18442,18809,16462,-2347
2018,10,31,1,17921,18327,15955,-2372
2018,10,31,2,17131,17529,15295,-2234
2018,10,31,3,15955,16305,13824,-2481
2018,10,31,4,14734,15160,12541,-2619
2018,10,31,5,13875,14294,11546,-2748
2018,10,31,6,13314,13800,11242,-2558
2018,10,31,7,12974,13525,11197,-2328
2018,10,31,8,12826,13453,11312,-2141
2018,10,31,9,12960,13685,11661,-2024
2018,10,31,10,13759,14626,12401,-2225
2018,10,31,11,15494,16424,14056,-2368
2018,10,31,12,16892,17729,15435,-2294
2018,10,31,13,17293,17999,15663,-2336
2018,10,31,14,17514,18032,15796,-2236
2018,10,31,15,17590,18046,15631,-2415
2018,10,31,16,17532,17826,15396,-2430
2018,10,31,17,17418,17595,15253,-2342
2018,10,31,18,17372,17568,14983,-2585
2018,10,31,19,17291,17515,14797,-2718
2018,10,31,20,17298,17648,14909,-2739
2018,10,31,21,17477,17907,15208,-2699
2018,10,31,22,17834,18102,15426,-2676
2018,10,31,23,18425,18301,15822,-2479
2018,11,1,0,18323,18070,15452,-2618
2018,11,1,1,17747,17668,14834,-2834
2018,11,1,2,16926,16892,14114,-2778
2018,11,1,3,15721,15758,12737,-3021
2018,11,1,4,14455,14676,11986,-2690
2018,11,1,5,13531,13868,11242,-2626
2018,11,1,6,12947,13368,11067,-2301
2018,11,1,7,12603,13031,10742,-2289
2018,11,1,8,12472,12949,10745,-2204
2018,11,1,9,12608,13165,10947,-2218
2018,11,1,10,13397,14042,11829,-2213
2018,11,1,11,15174,15729,13196,-2533
2018,11,1,12,16717,17021,14238,-2783
2018,11,1,13,17240,17484,14622,-2862
2018,11,1,14,17605,17725,14527,-3198
2018,11,1,15,17811,17870,14600,-3270
2018,11,1,16,17862,17918,14566,-3352
2018,11,1,17,17808,17943,14511,-3432
2018,11,1,18,17805,17998,14410,-3588
2018,11,1,19,17746,17995,14467,-3528
2018,11,1,20,17600,18113,14619,-3494
2018,11,1,21,17754,18258,14753,-3505
2018,11,1,22,18085,18754,15057,-3697
2018,11,1,23,18708,19165,15412,-3753
2018,11,2,0,18520,18869,15427,-3442
2018,11,2,1,17991,18247,14985,-3262
2018,11,2,2,17127,17358,14423,-2935
2018,11,2,3,15935,16156,13254,-2902
2018,11,2,4,14708,14955,12334,-2621
2018,11,2,5,13982,14084,11636,-2448
2018,11,2,6,13352,13592,11118,-2474
2018,11,2,7,12951,13302,11150,-2152
2018,11,2,8,12770,13246,11121,-2125
2018,11,2,9,12869,13419,11124,-2295
2018,11,2,10,13651,14249,11777,-2472
2018,11,2,11,15474,15976,13390,-2586
2018,11,2,12,17098,17451,14549,-2902
2018,11,2,13,17688,18008,14816,-3192
2018,11,2,14,18103,18382,14941,-3441
2018,11,2,15,18305,18565,15262,-3303
2018,11,2,16,18321,18627,15402,-3225
2018,11,2,17,18203,18497,15493,-3004
2018,11,2,18,18117,18474,15651,-2823
2018,11,2,19,17967,18293,15173,-3120
2018,11,2,20,17716,18248,15300,-2948
2018,11,2,21,17748,18329,15079,-3250
2018,11,2,22,17942,18585,15462,-3123
2018,11,2,23,18438,18745,15573,-3172
2018,11,3,0,18109,18306,15295,-3011
2018,11,3,1,17459,17736,14911,-2825
2018,11,3,2,16650,16984,14176,-2808
2018,11,3,3,15630,16006,13079,-2927
2018,11,3,4,14488,14986,12715,-2271
2018,11,3,5,13777,14128,12177,-1951
2018,11,3,6,13126,13594,11947,-1647
2018,11,3,7,12718,13164,11442,-1722
2018,11,3,8,12494,12896,11117,-1779
2018,11,3,9,12436,12896,11127,-1769
2018,11,3,10,12684,13161,11657,-1504
2018,11,3,11,13447,13817,12494,-1323
2018,11,3,12,14457,14720,13545,-1175
2018,11,3,13,15209,15559,14266,-1293
2018,11,3,14,15877,16197,14850,-1347
2018,11,3,15,16247,16477,15581,-896
2018,11,3,16,16281,16457,15337,-1120
2018,11,3,17,16182,16356,14674,-1682
2018,11,3,18,16002,16080,14089,-1991
2018,11,3,19,15853,16001,14043,-1958
2018,11,3,20,15659,16087,14322,-1765
2018,11,3,21,15814,16356,14677,-1679
2018,11,3,22,16282,16839,14933,-1906
2018,11,3,23,17106,17523,15622,-1901
2018,11,4,0,17025,17343,15625,-1718
2018,11,4,1,16650,16923,15490,-1433
2018,11,4,2,16098,16409,15024,-1385
2018,11,4,3,15338,15676,13855,-1821
2018,11,4,4,14426,14818,13046,-1772
2018,11,4,5,13479,14076,12375,-1701
2018,11,4,6,12914,13507,12074,-1433
2018,11,4,7,12914,13092,11634,-1458
2018,11,4,8,12581,12911,11259,-1652
2018,11,4,9,12414,12845,11296,-1549
2018,11,4,10,12449,12954,11276,-1678
2018,11,4,11,12733,13329,11585,-1744
2018,11,4,12,13190,13840,12055,-1785
2018,11,4,13,13600,14449,12684,-1765
2018,11,4,14,14240,14976,13499,-1477
2018,11,4,15,14743,15238,13781,-1457
2018,11,4,16,15013,15305,13457,-1848
2018,11,4,17,15112,15303,13199,-2104
2018,11,4,18,15109,15272,13116,-2156
2018,11,4,19,15066,15257,13357,-1900
2018,11,4,20,15076,15446,13614,-1832
2018,11,4,21,15262,15801,13854,-1947
2018,11,4,22,15924,16592,14074,-2518
2018,11,4,23,17194,17798,14833,-2965
2018,11,5,0,17435,17850,15431,-2419
2018,11,5,1,17220,17563,15357,-2206
2018,11,5,2,16851,17102,15035,-2067
2018,11,5,3,16171,16295,13912,-2383
2018,11,5,4,15197,15285,12967,-2318
2018,11,5,5,14192,14345,12317,-2028
2018,11,5,6,13268,13637,11966,-1671
2018,11,5,7,12828,13246,11800,-1446
2018,11,5,8,12605,13018,11558,-1460
2018,11,5,9,12555,12987,11908,-1079
2018,11,5,10,12811,13340,11734,-1606
2018,11,5,11,13698,14405,12456,-1949
2018,11,5,12,15260,16196,13580,-2616
2018,11,5,13,16445,17448,15049,-2399
2018,11,5,14,17050,18103,15878,-2225
2018,11,5,15,17402,18494,16201,-2293
2018,11,5,16,17588,18693,16265,-2428
2018,11,5,17,17645,18694,15913,-2781
2018,11,5,18,17602,18575,15910,-2665
2018,11,5,19,17605,18437,15897,-2540
2018,11,5,20,17566,18308,15803,-2505
2018,11,5,21,17647,18460,15758,-2702
2018,11,5,22,18126,18834,16090,-2744
2018,11,5,23,18999,19596,16817,-2779
2018,11,6,0,18880,19427,16954,-2473
2018,11,6,1,18424,18918,16427,-2491
2018,11,6,2,17784,18232,15830,-2402
2018,11,6,3,16850,17252,14834,-2418
2018,11,6,4,15620,16057,13890,-2167
2018,11,6,5,14390,14855,12786,-2069
2018,11,6,6,13369,13991,12033,-1958
2018,11,6,7,12831,13517,11765,-1752
2018,11,6,8,12553,13196,11758,-1438
2018,11,6,9,12458,13104,11839,-1265
2018,11,6,10,12676,13373,11986,-1387
2018,11,6,11,13516,14333,12669,-1664
2018,11,6,12,15072,15969,14067,-1902
2018,11,6,13,16227,17056,14935,-2121
2018,11,6,14,16801,17680,15247,-2433
2018,11,6,15,17110,18079,15513,-2566
2018,11,6,16,17277,18508,16100,-2408
2018,11,6,17,17317,18676,16139,-2537
2018,11,6,18,17284,18623,15964,-2659
2018,11,6,19,17307,18555,16152,-2403
2018,11,6,20,17303,18312,15831,-2481
2018,11,6,21,17420,18302,16050,-2252
2018,11,6,22,17934,18749,16369,-2380
2018,11,6,23,18813,19383,16785,-2598
2018,11,7,0,18645,19111,16920,-2191
2018,11,7,1,18162,18676,16478,-2198
2018,11,7,2,17537,18033,15821,-2212
2018,11,7,3,16637,17088,14748,-2340
2018,11,7,4,15419,15962,13901,-2061
2018,11,7,5,14202,14810,13002,-1808
2018,11,7,6,13308,13962,11994,-1968
2018,11,7,7,12747,13441,12122,-1319
2018,11,7,8,12428,13109,11810,-1299
2018,11,7,9,12312,13023,11785,-1238
2018,11,7,10,12516,13279,11930,-1349
2018,11,7,11,13360,14197,12390,-1807
2018,11,7,12,14968,15919,14026,-1893
2018,11,7,13,16136,16901,15000,-1901
2018,11,7,14,16669,17237,15269,-1968
2018,11,7,15,16921,17282,15082,-2200
2018,11,7,16,17031,17298,15146,-2152
2018,11,7,17,17034,17299,15064,-2235
2018,11,7,18,16941,17286,14952,-2334
2018,11,7,19,16951,17404,14959,-2445
2018,11,7,20,16957,17386,15121,-2265
2018,11,7,21,17118,17620,15302,-2318
2018,11,7,22,17705,18320,15994,-2326
2018,11,7,23,18688,19228,16428,-2800
2018,11,8,0,18586,19099,16994,-2105
2018,11,8,1,18129,18673,16652,-2021
2018,11,8,2,17543,18014,15839,-2175
2018,11,8,3,16669,17079,14850,-2229
2018,11,8,4,15465,15888,13653,-2235
2018,11,8,5,14263,14723,12509,-2214
2018,11,8,6,13536,13912,12352,-1560
2018,11,8,7,13022,13482,11947,-1535
2018,11,8,8,12730,13221,11763,-1458
2018,11,8,9,12647,13135,12035,-1100
2018,11,8,10,12885,13382,12397,-985
2018,11,8,11,13766,14390,13090,-1300
2018,11,8,12,15389,16131,14318,-1813
2018,11,8,13,16535,17125,14918,-2207
2018,11,8,14,17028,17541,15250,-2291
2018,11,8,15,17240,17625,14723,-2902
2018,11,8,16,17300,17641,15073,-2568
2018,11,8,17,17250,17538,14929,-2609
2018,11,8,18,17126,17486,14710,-2776
2018,11,8,19,17107,17528,14537,-2991
2018,11,8,20,17091,17561,14554,-3007
2018,11,8,21,17233,17759,14635,-3124
2018,11,8,22,17823,18361,15192,-3169
2018,11,8,23,18863,19273,16509,-2764
2018,11,9,0,18808,19159,16584,-2575
2018,11,9,1,18419,18789,15711,-3078
2018,11,9,2,17891,18209,15064,-3145
2018,11,9,3,17055,17363,14324,-3039
2018,11,9,4,15891,16184,12998,-3186
2018,11,9,5,14732,15000,11732,-3268
2018,11,9,6,13985,14203,11558,-2645
2018,11,9,7,13471,13754,11595,-2159
2018,11,9,8,13183,13525,11517,-2008
2018,11,9,9,13087,13427,11233,-2194
2018,11,9,10,13312,13718,11500,-2218
2018,11,9,11,14168,14690,12570,-2120
2018,11,9,12,15751,16379,14076,-2303
2018,11,9,13,16902,17401,15140,-2261
2018,11,9,14,17478,17758,15055,-2703
2018,11,9,15,17798,18255,15589,-2666
2018,11,9,16,17938,18517,15935,-2582
2018,11,9,17,17987,18636,16151,-2485
2018,11,9,18,17894,18637,16004,-2633
2018,11,9,19,17858,18645,15877,-2768
2018,11,9,20,17786,18698,15957,-2741
2018,11,9,21,17832,18866,16197,-2669
2018,11,9,22,18300,19323,16343,-2980
2018,11,9,23,19067,19694,16633,-3061
2018,11,10,0,18795,19425,16852,-2573
2018,11,10,1,18242,18941,16577,-2364
2018,11,10,2,17579,18270,15631,-2639
2018,11,10,3,16764,17425,14719,-2706
2018,11,10,4,15764,16371,13849,-2522
2018,11,10,5,14713,15269,12999,-2270
2018,11,10,6,14088,14364,12660,-1704
2018,11,10,7,13522,13795,12276,-1519
2018,11,10,8,13171,13435,11817,-1618
2018,11,10,9,12997,13309,11597,-1712
2018,11,10,10,13042,13412,11880,-1532
2018,11,10,11,13375,13820,12370,-1450
2018,11,10,12,13985,14509,13102,-1407
2018,11,10,13,14619,15180,13570,-1610
2018,11,10,14,15460,15821,13947,-1874
2018,11,10,15,16120,16261,14296,-1965
2018,11,10,16,16498,16547,14788,-1759
2018,11,10,17,16563,16568,14761,-1807
2018,11,10,18,16516,16498,14788,-1710
2018,11,10,19,16417,16579,14650,-1929
2018,11,10,20,16373,16677,14610,-2067
2018,11,10,21,16492,16964,14717,-2247
2018,11,10,22,17100,17670,15199,-2471
2018,11,10,23,18170,18555,16027,-2528
2018,11,11,0,18242,18477,16123,-2354
2018,11,11,1,17904,18144,15941,-2203
2018,11,11,2,17452,17725,15727,-1998
2018,11,11,3,16859,17081,15406,-1675
2018,11,11,4,16081,16239,14582,-1657
2018,11,11,5,15225,15437,14003,-1434
2018,11,11,6,14437,14735,13259,-1476
2018,11,11,7,13891,14081,12846,-1235
2018,11,11,8,13574,13748,12212,-1536
2018,11,11,9,13419,13690,12220,-1470
2018,11,11,10,13454,13670,12294,-1376
2018,11,11,11,13717,13936,12947,-989
2018,11,11,12,14168,14375,13169,-1206
2018,11,11,13,14558,14801,13462,-1339
2018,11,11,14,15188,15388,13704,-1684
2018,11,11,15,15697,15699,13634,-2065
2018,11,11,16,15988,15875,13405,-2470
2018,11,11,17,16088,15978,13305,-2673
2018,11,11,18,16083,15977,13243,-2734
2018,11,11,19,16029,15979,13378,-2601
2018,11,11,20,16020,16165,13594,-2571
2018,11,11,21,16198,16518,14308,-2210
2018,11,11,22,16923,17302,15157,-2145
2018,11,11,23,18174,18422,15931,-2491
2018,11,12,0,18385,18403,16062,-2341
2018,11,12,1,18182,18110,16121,-1989
2018,11,12,2,17818,17690,15836,-1854
2018,11,12,3,17129,17042,15077,-1965
2018,11,12,4,16188,16133,13993,-2140
2018,11,12,5,15187,15315,13282,-2033
2018,11,12,6,14121,14605,12512,-2093
2018,11,12,7,13678,14193,12093,-2100
2018,11,12,8,13472,13973,12025,-1948
2018,11,12,9,13442,13929,12083,-1846
2018,11,12,10,13727,14215,12468,-1747
2018,11,12,11,14638,15068,13485,-1583
2018,11,12,12,16242,16328,14873,-1455
2018,11,12,13,17374,17373,16195,-1178
2018,11,12,14,17866,17895,16306,-1589
2018,11,12,15,18072,18046,16110,-1936
2018,11,12,16,18118,18097,16093,-2004
2018,11,12,17,18071,18062,16132,-1930
2018,11,12,18,17933,18037,15844,-2193
2018,11,12,19,17876,18059,16079,-1980
2018,11,12,20,17817,18114,16134,-1980
2018,11,12,21,17918,18334,16624,-1710
2018,11,12,22,18526,19111,17276,-1835
2018,11,12,23,19563,19832,18389,-1443
2018,11,13,0,19555,19627,18582,-1045
2018,11,13,1,19186,19159,17984,-1175
2018,11,13,2,18596,18537,16952,-1585
2018,11,13,3,17668,17586,15786,-1800
2018,11,13,4,16467,16305,14358,-1947
2018,11,13,5,15239,15129,13122,-2007
2018,11,13,6,14035,14345,12294,-2051
2018,11,13,7,13507,13856,11656,-2200
2018,11,13,8,13237,13553,11369,-2184
2018,11,13,9,13161,13489,11394,-2095
2018,11,13,10,13389,13784,11771,-2013
2018,11,13,11,14233,14801,12962,-1839
2018,11,13,12,15806,16544,14916,-1628
2018,11,13,13,16954,17707,16115,-1592
2018,11,13,14,17523,18212,16414,-1798
2018,11,13,15,17838,18537,16043,-2494
2018,11,13,16,18002,18758,16804,-1954
2018,11,13,17,18045,18767,16561,-2206
2018,11,13,18,18020,18756,16888,-1868
2018,11,13,19,18037,18806,17052,-1754
2018,11,13,20,18023,18795,16646,-2149
2018,11,13,21,18148,18963,16524,-2439
2018,11,13,22,18761,19695,17509,-2186
2018,11,13,23,19751,20372,18247,-2125
2018,11,14,0,19708,20169,18262,-1907
2018,11,14,1,19321,19754,18061,-1693
2018,11,14,2,18736,19101,17558,-1543
2018,11,14,3,17850,18063,16157,-1906
2018,11,14,4,16690,16917,14828,-2089
2018,11,14,5,15517,15735,13806,-1929
2018,11,14,6,14487,14912,12859,-2053
2018,11,14,7,13976,14487,12665,-1822
2018,11,14,8,13699,14251,12405,-1846
2018,11,14,9,13627,14237,12447,-1790
2018,11,14,10,13880,14516,12879,-1637
2018,11,14,11,14784,15554,14341,-1213
2018,11,14,12,16456,17310,16364,-946
2018,11,14,13,17647,18371,17395,-976
2018,11,14,14,18193,18750,17223,-1527
2018,11,14,15,18443,18912,17196,-1716
2018,11,14,16,18531,18931,17309,-1622
2018,11,14,17,18492,18830,17176,-1654
2018,11,14,18,18377,18768,17165,-1603
2018,11,14,19,18349,18786,16978,-1808
2018,11,14,20,18321,18858,17010,-1848
2018,11,14,21,18471,19176,17025,-2151
2018,11,14,22,19169,19964,17570,-2394
2018,11,14,23,20291,20960,18500,-2460
2018,11,15,0,20275,20856,18619,-2237
2018,11,15,1,19883,20438,18043,-2395
2018,11,15,2,19303,19909,17719,-2190
2018,11,15,3,18394,18998,16752,-2246
2018,11,15,4,17167,17728,15417,-2311
2018,11,15,5,15933,16502,14336,-2166
2018,11,15,6,15101,15694,13115,-2579
2018,11,15,7,14615,15264,12915,-2349
2018,11,15,8,14359,15015,12950,-2065
2018,11,15,9,14300,14958,13154,-1804
2018,11,15,10,14555,15240,13551,-1689
2018,11,15,11,15424,16158,14377,-1781
2018,11,15,12,17028,17807,16048,-1759
2018,11,15,13,18176,18906,17371,-1535
2018,11,15,14,18705,19404,16747,-2657
2018,11,15,15,18975,19712,16439,-3273
2018,11,15,16,19082,19868,17192,-2676
2018,11,15,17,19079,19956,17302,-2654
2018,11,15,18,18976,20065,17234,-2831
2018,11,15,19,18940,20162,17133,-3029
2018,11,15,20,18870,20307,17298,-3009
2018,11,15,21,18952,20504,17464,-3040
2018,11,15,22,19551,21074,18447,-2627
2018,11,15,23,20500,21503,18999,-2504
2018,11,16,0,20409,21260,19152,-2108
2018,11,16,1,19996,20868,18693,-2175
2018,11,16,2,19382,20222,17653,-2569
2018,11,16,3,18453,19264,16544,-2720
2018,11,16,4,17265,18090,15571,-2519
2018,11,16,5,16031,16871,14500,-2371
2018,11,16,6,14674,16015,14150,-1865
2018,11,16,7,14127,15434,13466,-1968
2018,11,16,8,13854,15118,12894,-2224
2018,11,16,9,13765,15013,12905,-2108
2018,11,16,10,13974,15198,13242,-1956
2018,11,16,11,14779,16002,14037,-1965
2018,11,16,12,16287,17400,15438,-1962
2018,11,16,13,17399,18455,16114,-2341
2018,11,16,14,17991,19045,16388,-2657
2018,11,16,15,18349,19271,16397,-2874
2018,11,16,16,18518,19354,16468,-2886
2018,11,16,17,18455,19334,16401,-2933
2018,11,16,18,18357,19226,16474,-2752
2018,11,16,19,18327,19179,16890,-2289
2018,11,16,20,18278,19140,16742,-2398
2018,11,16,21,18358,19373,16627,-2746
2018,11,16,22,18915,19967,16910,-3057
2018,11,16,23,19746,20478,17853,-2625
2018,11,17,0,19522,20115,17461,-2654
2018,11,17,1,19024,19625,17242,-2383
2018,11,17,2,18420,18988,16472,-2516
2018,11,17,3,17664,18215,15898,-2317
2018,11,17,4,16741,17211,15295,-1916
2018,11,17,5,15714,16120,14465,-1655
2018,11,17,6,14590,15285,13962,-1323
2018,11,17,7,13982,14730,13407,-1323
2018,11,17,8,13636,14390,12956,-1434
2018,11,17,9,13466,14213,12841,-1372
2018,11,17,10,13509,14260,12907,-1353
2018,11,17,11,13836,14614,13176,-1438
2018,11,17,12,14454,15207,13688,-1519
2018,11,17,13,15037,15897,14570,-1327
2018,11,17,14,15766,16615,15510,-1105
2018,11,17,15,16303,17062,15643,-1419
2018,11,17,16,16579,17335,15723,-1612
2018,11,17,17,16639,17470,15874,-1596
2018,11,17,18,16556,17453,15669,-1784
2018,11,17,19,16419,17433,15106,-2327
2018,11,17,20,16343,17379,15092,-2287
2018,11,17,21,16445,17509,15308,-2201
2018,11,17,22,17097,18131,15718,-2413
2018,11,17,23,18148,18810,16312,-2498
2018,11,18,0,18208,18668,16424,-2244
2018,11,18,1,17901,18318,15911,-2407
2018,11,18,2,17461,17903,15981,-1922
2018,11,18,3,16861,17312,15482,-1830
2018,11,18,4,16118,16476,14331,-2145
2018,11,18,5,15262,15640,13532,-2108
2018,11,18,6,14356,14935,12903,-2032
2018,11,18,7,13778,14415,12172,-2243
2018,11,18,8,13443,14092,12138,-1954
2018,11,18,9,13281,13929,12206,-1723
2018,11,18,10,13311,13958,12118,-1840
2018,11,18,11,13580,14251,12252,-1999
2018,11,18,12,14073,14765,12865,-1900
2018,11,18,13,14499,15249,13432,-1817
2018,11,18,14,15189,16017,14231,-1786
2018,11,18,15,15779,16572,14870,-1702
2018,11,18,16,16135,16911,15196,-1715
2018,11,18,17,16338,17175,15193,-1982
2018,11,18,18,16382,17304,15086,-2218
2018,11,18,19,16337,17372,15037,-2335
2018,11,18,20,16303,17470,15252,-2218
2018,11,18,21,16452,17724,15500,-2224
2018,11,18,22,17230,18462,16174,-2288
2018,11,18,23,18430,19191,16815,-2376
2018,11,19,0,18539,19095,16905,-2190
2018,11,19,1,18275,18736,16422,-2314
2018,11,19,2,17809,18265,16092,-2173
2018,11,19,3,17017,17498,15456,-2042
2018,11,19,4,16016,16425,14666,-1759
2018,11,19,5,14958,15394,13644,-1750
2018,11,19,6,14002,14666,13031,-1635
2018,11,19,7,13558,14234,12836,-1398
2018,11,19,8,13351,13993,12543,-1450
2018,11,19,9,13315,13943,12576,-1367
2018,11,19,10,13584,14233,13055,-1178
2018,11,19,11,14466,15236,13891,-1345
2018,11,19,12,16047,16991,15537,-1454
2018,11,19,13,17195,18045,16182,-1863
2018,11,19,14,17752,18498,16426,-2072
2018,11,19,15,18056,18639,16218,-2421
2018,11,19,16,18193,18614,16455,-2159
2018,11,19,17,18195,18511,16280,-2231
2018,11,19,18,18124,18378,16141,-2237
2018,11,19,19,18100,18332,16013,-2319
2018,11,19,20,18062,18357,15974,-2383
2018,11,19,21,18177,18593,16222,-2371
2018,11,19,22,18842,19364,16453,-2911
2018,11,19,23,19852,20227,17325,-2902
2018,11,20,0,19796,20060,17432,-2628
2018,11,20,1,19430,19664,17386,-2278
2018,11,20,2,18839,19089,17014,-2075
2018,11,20,3,17932,18172,16037,-2135
2018,11,20,4,16783,16959,14835,-2124
2018,11,20,5,15602,15769,13824,-1945
2018,11,20,6,14336,14897,12943,-1954
2018,11,20,7,13818,14351,12409,-1942
2018,11,20,8,13556,14050,12263,-1787
2018,11,20,9,13487,13960,12185,-1775
2018,11,20,10,13728,14197,12698,-1499
2018,11,20,11,14584,15156,13655,-1501
2018,11,20,12,16188,16784,15412,-1372
2018,11,20,13,17351,17956,16659,-1297
2018,11,20,14,17909,18551,16478,-2073
2018,11,20,15,18221,18887,16472,-2415
2018,11,20,16,18387,19022,16669,-2353
2018,11,20,17,18409,19040,16328,-2712
2018,11,20,18,18365,18940,16134,-2806
2018,11,20,19,18372,18901,15815,-3086
2018,11,20,20,18356,18838,15805,-3033
2018,11,20,21,18493,18924,16092,-2832
2018,11,20,22,19183,19493,17275,-2218
2018,11,20,23,20186,20324,17981,-2343
2018,11,21,0,20089,20167,17722,-2445
2018,11,21,1,19690,19827,17389,-2438
2018,11,21,2,19098,19307,17010,-2297
2018,11,21,3,18203,18547,16227,-2320
2018,11,21,4,17044,17347,15247,-2100
2018,11,21,5,15874,16181,13847,-2334
2018,11,21,6,14962,15346,12640,-2706
2018,11,21,7,14444,14824,12142,-2682
2018,11,21,8,14161,14518,12104,-2414
2018,11,21,9,14083,14445,11954,-2491
2018,11,21,10,14325,14695,12227,-2468
2018,11,21,11,15204,15548,13359,-2189
2018,11,21,12,16872,17031,15335,-1696
2018,11,21,13,18057,18116,16360,-1756
2018,11,21,14,18558,18718,16467,-2251
2018,11,21,15,18767,19059,16351,-2708
2018,11,21,16,18817,19513,16709,-2804
2018,11,21,17,18797,19477,16663,-2814
2018,11,21,18,18676,19388,16603,-2785
2018,11,21,19,18644,19333,16542,-2791
2018,11,21,20,18613,19274,16337,-2937
2018,11,21,21,18771,19485,16576,-2909
2018,11,21,22,19523,20177,17602,-2575
2018,11,21,23,20644,20952,18423,-2529
2018,11,22,0,20631,20786,18276,-2510
2018,11,22,1,20259,20422,17949,-2473
2018,11,22,2,19681,19983,17397,-2586
2018,11,22,3,18772,19283,16896,-2387
2018,11,22,4,17585,18290,15861,-2429
2018,11,22,5,16419,17251,15206,-2045
2018,11,22,6,15986,16431,14742,-1689
2018,11,22,7,15359,15919,14162,-1757
2018,11,22,8,14959,15624,13661,-1963
2018,11,22,9,14779,15503,13720,-1783
2018,11,22,10,14847,15517,13647,-1870
2018,11,22,11,15195,15880,14002,-1878
2018,11,22,12,15763,16481,15019,-1462
2018,11,22,13,16370,17096,15717,-1379
2018,11,22,14,17271,17783,16180,-1603
2018,11,22,15,18054,18401,16373,-2028
2018,11,22,16,18572,18724,16221,-2503
2018,11,22,17,18748,18883,16376,-2507
2018,11,22,18,18603,18754,16506,-2248
2018,11,22,19,18184,18390,16228,-2162
2018,11,22,20,17708,18083,15712,-2371
2018,11,22,21,17376,18007,15778,-2229
2018,11,22,22,17603,18379,16266,-2113
2018,11,22,23,18235,18786,16577,-2209
2018,11,23,0,18239,18676,16586,-2090
2018,11,23,1,18139,18600,16318,-2282
2018,11,23,2,18047,18538,16362,-2176
2018,11,23,3,17776,18290,16027,-2263
2018,11,23,4,17193,17767,15077,-2690
2018,11,23,5,16431,17171,14585,-2586
2018,11,23,6,15904,16659,14364,-2295
2018,11,23,7,15515,16312,13767,-2545
2018,11,23,8,15303,16057,13439,-2618
2018,11,23,9,15252,15990,13349,-2641
2018,11,23,10,15429,16169,13793,-2376
2018,11,23,11,15944,16716,14474,-2242
2018,11,23,12,16734,17556,15178,-2378
2018,11,23,13,17342,18208,16178,-2030
2018,11,23,14,17918,18669,16599,-2070
2018,11,23,15,18270,18864,16403,-2461
2018,11,23,16,18379,18950,16337,-2613
2018,11,23,17,18307,18867,16321,-2546
2018,11,23,18,18157,18686,15583,-3103
2018,11,23,19,18006,18560,15332,-3228
2018,11,23,20,17928,18563,15259,-3304
2018,11,23,21,18043,18805,15833,-2972
2018,11,23,22,18785,19597,16633,-2964
2018,11,23,23,19854,20433,17194,-3239
2018,11,24,0,19854,20206,16950,-3256
2018,11,24,1,19547,19840,16834,-3006
2018,11,24,2,19178,19371,16710,-2661
2018,11,24,3,18573,18715,16129,-2586
2018,11,24,4,17727,17833,15473,-2360
2018,11,24,5,16734,16897,14978,-1919
2018,11,24,6,15717,16037,13770,-2267
2018,11,24,7,15122,15538,13376,-2162
2018,11,24,8,14781,15216,12956,-2260
2018,11,24,9,14609,15032,12984,-2048
2018,11,24,10,14638,15053,13063,-1990
2018,11,24,11,14904,15369,13419,-1950
2018,11,24,12,15379,15941,13876,-2065
2018,11,24,13,15862,16409,14465,-1944
2018,11,24,14,16577,17043,15276,-1767
2018,11,24,15,17128,17526,15446,-2080
2018,11,24,16,17408,17846,15595,-2251
2018,11,24,17,17477,18032,15573,-2459
2018,11,24,18,17405,18039,15302,-2737
2018,11,24,19,17250,17966,15071,-2895
2018,11,24,20,17152,17916,15124,-2792
2018,11,24,21,17226,18023,15328,-2695
2018,11,24,22,17895,18607,16146,-2461
2018,11,24,23,18827,19061,16883,-2178
2018,11,25,0,18761,18864,16643,-2221
2018,11,25,1,18413,18505,16230,-2275
2018,11,25,2,17946,18042,15519,-2523
2018,11,25,3,17321,17454,14728,-2726
2018,11,25,4,16548,16596,13835,-2761
2018,11,25,5,15621,15693,13390,-2303
2018,11,25,6,14330,14926,12742,-2184
2018,11,25,7,13671,14336,12063,-2273
2018,11,25,8,13294,14016,11961,-2055
2018,11,25,9,13092,13803,12323,-1480
2018,11,25,10,13098,13691,12290,-1401
2018,11,25,11,13356,13931,12515,-1416
2018,11,25,12,13865,14343,12906,-1437
2018,11,25,13,14320,14807,13319,-1488
2018,11,25,14,15021,15491,14112,-1379
2018,11,25,15,15642,16110,14500,-1610
2018,11,25,16,16048,16470,14426,-2044
2018,11,25,17,16206,16585,14629,-1956
2018,11,25,18,16300,16640,14436,-2204
2018,11,25,19,16309,16694,14345,-2349
2018,11,25,20,16349,16893,14517,-2376
2018,11,25,21,16580,17103,14838,-2265
2018,11,25,22,17461,17919,15523,-2396
2018,11,25,23,18670,18765,16817,-1948
2018,11,26,0,18740,18702,16601,-2101
2018,11,26,1,18471,18399,15975,-2424
2018,11,26,2,18041,17899,15409,-2490
2018,11,26,3,17330,17127,14441,-2686
2018,11,26,4,16367,16130,13775,-2355
2018,11,26,5,15276,15081,12883,-2198
2018,11,26,6,13984,14343,11596,-2747
2018,11,26,7,13469,13898,11328,-2570
2018,11,26,8,13225,13675,11086,-2589
2018,11,26,9,13170,13603,11073,-2530
2018,11,26,10,13446,13922,11373,-2549
2018,11,26,11,14385,14920,12343,-2577
2018,11,26,12,16083,16733,14209,-2524
2018,11,26,13,17325,17993,15441,-2552
2018,11,26,14,17907,18530,15890,-2640
2018,11,26,15,18248,18883,16386,-2497
2018,11,26,16,18435,19120,16462,-2658
2018,11,26,17,18494,19196,16390,-2806
2018,11,26,18,18456,19143,16286,-2857
2018,11,26,19,18456,19184,16140,-3044
2018,11,26,20,18425,19219,16278,-2941
2018,11,26,21,18555,19563,16522,-3041
2018,11,26,22,19302,20210,17252,-2958
2018,11,26,23,20238,20662,17793,-2869
2018,11,27,0,20010,20475,17614,-2861
2018,11,27,1,19538,19991,17304,-2687
2018,11,27,2,18838,19332,16587,-2745
2018,11,27,3,17842,18326,15600,-2726
2018,11,27,4,16565,16982,14439,-2543
2018,11,27,5,15260,15746,13089,-2657
2018,11,27,6,14148,14882,12374,-2508
2018,11,27,7,13602,14404,11782,-2622
2018,11,27,8,13307,14163,11713,-2450
2018,11,27,9,13220,14129,11757,-2372
2018,11,27,10,13466,14402,12058,-2344
2018,11,27,11,14367,15394,12829,-2565
2018,11,27,12,16068,17166,14400,-2766
2018,11,27,13,17287,18215,15670,-2545
2018,11,27,14,17832,18604,16218,-2386
2018,11,27,15,18138,18801,16170,-2631
2018,11,27,16,18305,18955,16574,-2381
2018,11,27,17,18352,19047,16036,-3011
2018,11,27,18,18322,19153,15838,-3315
2018,11,27,19,18340,19246,15940,-3306
2018,11,27,20,18347,19305,16140,-3165
2018,11,27,21,18526,19491,16272,-3219
2018,11,27,22,19327,20320,17424,-2896
2018,11,27,23,20362,20993,18332,-2661
2018,11,28,0,20219,20809,18036,-2773
2018,11,28,1,19783,20422,17865,-2557
2018,11,28,2,19140,19794,16868,-2926
2018,11,28,3,18210,18972,16250,-2722
2018,11,28,4,16979,17706,14621,-3085
2018,11,28,5,15706,16448,13259,-3189
2018,11,28,6,14686,15557,12649,-2908
2018,11,28,7,14133,15051,12431,-2620
2018,11,28,8,13834,14766,12121,-2645
2018,11,28,9,13740,14682,12031,-2651
2018,11,28,10,13977,14943,12084,-2859
2018,11,28,11,14871,15833,13412,-2421
2018,11,28,12,16560,17583,14719,-2864
2018,11,28,13,17767,18644,15782,-2862
2018,11,28,14,18293,19072,15902,-3170
2018,11,28,15,18571,19311,15944,-3367
2018,11,28,16,18703,19401,16055,-3346
2018,11,28,17,18706,19324,15842,-3482
2018,11,28,18,18653,19374,16183,-3191
2018,11,28,19,18659,19462,16128,-3334
2018,11,28,20,18658,19485,16405,-3080
2018,11,28,21,18836,19705,16371,-3334
2018,11,28,22,19633,20531,17901,-2630
2018,11,28,23,20627,21194,18562,-2632
2018,11,29,0,20443,21033,18350,-2683
2018,11,29,1,19991,20572,17782,-2790
2018,11,29,2,19351,19935,17136,-2799
2018,11,29,3,18438,19010,16000,-3010
2018,11,29,4,17208,17717,14678,-3039
2018,11,29,5,15913,16440,13241,-3199
2018,11,29,6,14905,15595,12820,-2775
2018,11,29,7,14335,15079,12558,-2521
2018,11,29,8,14033,14757,12191,-2566
2018,11,29,9,13941,14667,12304,-2363
2018,11,29,10,14178,14945,12711,-2234
2018,11,29,11,15061,15836,13684,-2152
2018,11,29,12,16734,17604,15322,-2282
2018,11,29,13,17915,18649,16667,-1982
2018,11,29,14,18402,18867,16168,-2699
2018,11,29,15,18643,18972,15970,-3002
2018,11,29,16,18748,19019,16126,-2893
2018,11,29,17,18719,18955,16070,-2885
2018,11,29,18,18636,18873,15780,-3093
2018,11,29,19,18624,18901,15569,-3332
2018,11,29,20,18619,18934,15644,-3290
2018,11,29,21,18803,19216,16039,-3177
2018,11,29,22,19605,20068,16960,-3108
2018,11,29,23,20640,20863,18267,-2596
2018,11,30,0,20505,20688,18115,-2573
2018,11,30,1,20104,20291,17399,-2892
2018,11,30,2,19518,19740,17002,-2738
2018,11,30,3,18660,18910,16048,-2862
2018,11,30,4,17491,17659,14645,-3014
2018,11,30,5,16247,16364,12987,-3377
2018,11,30,6,15154,15462,12471,-2991
2018,11,30,7,14574,14958,12246,-2712
2018,11,30,8,14273,14663,12217,-2446
2018,11,30,9,14176,14562,12083,-2479
2018,11,30,10,14415,14796,12332,-2464
2018,11,30,11,15301,15705,13297,-2408
2018,11,30,12,16977,17329,15057,-2272
2018,11,30,13,18169,18449,15827,-2622
2018,11,30,14,18686,18894,15769,-3125
2018,11,30,15,18948,19145,15902,-3243
2018,11,30,16,19043,19295,16174,-3121
2018,11,30,17,19050,19306,16051,-3255
2018,11,30,18,18942,19222,15851,-3371
2018,11,30,19,18891,19235,15766,-3469
2018,11,30,20,18834,19215,15691,-3524
2018,11,30,21,18946,19334,15691,-3643
2018,11,30,22,19669,19919,16046,-3873
2018,11,30,23,20555,20445,16927,-3518
2018,12,1,0,20300,20149,16270,-3879
2018,12,1,1,19786,19668,16173,-3495
2018,12,1,2,19106,19113,15772,-3341
2018,12,1,3,18304,18359,15029,-3330
2018,12,1,4,17298,17364,14072,-3292
2018,12,1,5,16184,16226,12903,-3323
2018,12,1,6,15266,15330,12019,-3311
2018,12,1,7,14605,14764,11749,-3015
2018,12,1,8,14203,14427,11741,-2686
2018,12,1,9,14005,14300,11808,-2492
2018,12,1,10,14043,14375,12102,-2273
2018,12,1,11,14395,14730,12335,-2395
2018,12,1,12,15107,15435,13177,-2258
2018,12,1,13,15770,16096,13736,-2360
2018,12,1,14,16470,16746,14321,-2425
2018,12,1,15,17002,17070,14376,-2694
2018,12,1,16,17249,17187,14164,-3023
2018,12,1,17,17296,17202,14048,-3154
2018,12,1,18,17164,17148,13681,-3467
2018,12,1,19,16997,17065,13623,-3442
2018,12,1,20,16887,17166,13835,-3331
2018,12,1,21,16993,17486,14335,-3151
2018,12,1,22,17883,18390,15126,-3264
2018,12,1,23,18995,19075,16157,-2918
2018,12,2,0,18997,18951,16020,-2931
2018,12,2,1,18696,18653,16024,-2629
2018,12,2,2,18272,18246,15579,-2667
2018,12,2,3,17580,17685,14581,-3104
2018,12,2,4,16666,16819,13783,-3036
2018,12,2,5,15596,15888,12970,-2918
2018,12,2,6,14468,15054,12093,-2961
2018,12,2,7,13797,14431,11598,-2833
2018,12,2,8,13404,14030,11134,-2896
2018,12,2,9,13191,13827,11063,-2764
2018,12,2,10,13178,13785,11252,-2533
2018,12,2,11,13420,13984,11361,-2623
2018,12,2,12,13937,14455,11561,-2894
2018,12,2,13,14418,15011,12611,-2400
2018,12,2,14,15043,15866,13595,-2271
2018,12,2,15,15613,16583,14166,-2417
2018,12,2,16,15967,17015,14291,-2724
2018,12,2,17,16122,17176,13972,-3204
2018,12,2,18,16176,17244,13693,-3551
2018,12,2,19,16167,17184,13663,-3521
2018,12,2,20,16170,17182,13914,-3268
2018,12,2,21,16369,17389,14101,-3288
2018,12,2,22,17318,18118,14573,-3545
2018,12,2,23,18428,18946,15539,-3407
2018,12,3,0,18393,18832,15648,-3184
2018,12,3,1,18150,18502,15682,-2820
2018,12,3,2,17790,18047,15242,-2805
2018,12,3,3,17068,17230,14369,-2861
2018,12,3,4,16032,16126,13409,-2717
2018,12,3,5,14874,15044,12347,-2697
2018,12,3,6,13906,14183,11798,-2385
2018,12,3,7,13334,13730,11198,-2532
2018,12,3,8,13037,13478,11354,-2124
2018,12,3,9,12946,13413,11284,-2129
2018,12,3,10,13195,13677,11542,-2135
2018,12,3,11,14102,14680,12585,-2095
2018,12,3,12,15817,16491,14685,-1806
2018,12,3,13,17119,17682,15624,-2058
2018,12,3,14,17686,18064,16210,-1854
2018,12,3,15,18025,18222,16461,-1761
2018,12,3,16,18201,18300,16408,-1892
2018,12,3,17,18225,18237,15858,-2379
2018,12,3,18,18155,18380,15808,-2572
2018,12,3,19,18161,18451,16031,-2420
2018,12,3,20,18160,18463,15963,-2500
2018,12,3,21,18344,18739,16014,-2725
2018,12,3,22,19285,19661,16326,-3335
2018,12,3,23,20396,20500,17416,-3084
2018,12,4,0,20289,20397,17227,-3170
2018,12,4,1,19930,20040,16861,-3179
2018,12,4,2,19375,19444,16445,-2999
2018,12,4,3,18428,18515,15334,-3181
2018,12,4,4,17115,17265,14382,-2883
2018,12,4,5,15733,15975,13132,-2843
2018,12,4,6,14852,15078,12315,-2763
2018,12,4,7,14268,14548,12176,-2372
2018,12,4,8,13955,14304,11934,-2370
2018,12,4,9,13869,14266,11899,-2367
2018,12,4,10,14130,14556,12087,-2469
2018,12,4,11,15061,15532,13059,-2473
2018,12,4,12,16833,17396,15019,-2377
2018,12,4,13,18102,18546,16196,-2350
2018,12,4,14,18567,18915,16131,-2784
2018,12,4,15,18792,19023,15693,-3330
2018,12,4,16,18872,18969,15621,-3348
2018,12,4,17,18762,18873,15636,-3237
2018,12,4,18,18625,18733,15479,-3254
2018,12,4,19,18597,18762,15396,-3366
2018,12,4,20,18592,18846,15508,-3338
2018,12,4,21,18802,19206,15897,-3309
2018,12,4,22,19817,20200,16983,-3217
2018,12,4,23,21050,21305,18650,-2655
2018,12,5,0,21014,21264,18349,-2915
2018,12,5,1,20680,20940,18105,-2835
2018,12,5,2,20180,20409,17578,-2831
2018,12,5,3,19266,19571,16612,-2959
2018,12,5,4,17922,18324,14654,-3670
2018,12,5,5,16527,17014,13511,-3503
2018,12,5,6,15694,16109,12914,-3195
2018,12,5,7,15139,15625,12525,-3100
2018,12,5,8,14830,15342,12499,-2843
2018,12,5,9,14739,15280,12489,-2791
2018,12,5,10,14980,15558,12642,-2916
2018,12,5,11,15867,16517,13772,-2745
2018,12,5,12,17560,18243,16161,-2082
2018,12,5,13,18759,19309,17330,-1979
2018,12,5,14,19138,19522,17423,-2099
2018,12,5,15,19263,19477,16774,-2703
2018,12,5,16,19243,19512,16749,-2763
2018,12,5,17,19214,19471,16682,-2789
2018,12,5,18,19050,19362,16154,-3208
2018,12,5,19,19000,19378,16590,-2788
2018,12,5,20,18955,19446,16772,-2674
2018,12,5,21,19124,19736,17322,-2414
2018,12,5,22,20054,20630,18140,-2490
2018,12,5,23,21185,21542,19464,-2078
2018,12,6,0,21141,21406,18999,-2407
2018,12,6,1,20827,21070,18666,-2404
2018,12,6,2,20333,20504,18000,-2504
2018,12,6,3,19454,19647,17084,-2563
2018,12,6,4,18164,18343,15688,-2655
2018,12,6,5,16795,17054,14367,-2687
2018,12,6,6,15811,16157,13316,-2841
2018,12,6,7,15214,15710,13263,-2447
2018,12,6,8,14888,15417,13013,-2404
2018,12,6,9,14785,15337,13098,-2239
2018,12,6,10,15014,15576,13395,-2181
2018,12,6,11,15883,16550,14416,-2134
2018,12,6,12,17572,18361,16507,-1854
2018,12,6,13,18794,19470,17616,-1854
2018,12,6,14,19214,19732,17656,-2076
2018,12,6,15,19405,19732,17087,-2645
2018,12,6,16,19447,19733,16867,-2866
2018,12,6,17,19416,19600,16566,-3034
2018,12,6,18,19270,19436,16552,-2884
2018,12,6,19,19230,19389,16551,-2838
2018,12,6,20,19186,19439,16511,-2928
2018,12,6,21,19337,19748,16868,-2880
2018,12,6,22,20234,20733,18018,-2715
2018,12,6,23,21306,21554,18719,-2835
2018,12,7,0,21210,21464,18889,-2575
2018,12,7,1,20867,21028,18653,-2375
2018,12,7,2,20360,20378,18218,-2160
2018,12,7,3,19473,19486,17218,-2268
2018,12,7,4,18201,18097,15433,-2664
2018,12,7,5,16836,16770,13791,-2979
2018,12,7,6,15699,15784,12378,-3406
2018,12,7,7,15090,15243,12502,-2741
2018,12,7,8,14756,14986,11802,-3184
2018,12,7,9,14648,14969,11954,-3015
2018,12,7,10,14864,15253,12078,-3175
2018,12,7,11,15711,16166,13626,-2540
2018,12,7,12,17358,17892,15792,-2100
2018,12,7,13,18604,19054,16568,-2486
2018,12,7,14,19100,19382,16691,-2691
2018,12,7,15,19374,19510,16633,-2877
2018,12,7,16,19465,19501,16284,-3217
2018,12,7,17,19424,19471,15907,-3564
2018,12,7,18,19272,19329,15606,-3723
2018,12,7,19,19220,19319,15870,-3449
2018,12,7,20,19174,19397,15892,-3505
2018,12,7,21,19314,19666,16580,-3086
2018,12,7,22,20188,20474,17543,-2931
2018,12,7,23,21242,21376,18732,-2644
2018,12,8,0,21111,21190,18161,-3029
2018,12,8,1,20714,20879,17858,-3021
2018,12,8,2,20207,20422,17412,-3010
2018,12,8,3,19468,19748,16767,-2981
2018,12,8,4,18419,18744,15397,-3347
2018,12,8,5,17222,17543,14469,-3074
2018,12,8,6,16256,16666,13637,-3029
2018,12,8,7,15594,16115,13217,-2898
2018,12,8,8,15207,15765,12825,-2940
2018,12,8,9,15023,15558,12828,-2730
2018,12,8,10,15063,15635,13106,-2529
2018,12,8,11,15410,15968,13519,-2449
2018,12,8,12,16109,16743,14276,-2467
2018,12,8,13,16784,17459,15611,-1848
2018,12,8,14,17422,18198,16759,-1439
2018,12,8,15,17905,18490,16913,-1577
2018,12,8,16,18115,18585,16630,-1955
2018,12,8,17,18111,18543,16222,-2321
2018,12,8,18,17958,18477,16107,-2370
2018,12,8,19,17776,18437,15899,-2538
2018,12,8,20,17671,18509,16024,-2485
2018,12,8,21,17795,18766,16427,-2339
2018,12,8,22,18718,19559,17132,-2427
2018,12,8,23,19917,20353,18106,-2247
2018,12,9,0,20005,20254,18028,-2226
2018,12,9,1,19757,19946,17770,-2176
2018,12,9,2,19387,19545,17665,-1880
2018,12,9,3,18774,19010,16989,-2021
2018,12,9,4,17878,18139,16354,-1785
2018,12,9,5,16814,17196,15449,-1747
2018,12,9,6,15817,16308,13734,-2574
2018,12,9,7,15172,15710,13329,-2381
2018,12,9,8,14795,15354,12773,-2581
2018,12,9,9,14610,15166,12839,-2327
2018,12,9,10,14619,15181,13076,-2105
2018,12,9,11,14875,15424,13191,-2233
2018,12,9,12,15413,15942,13963,-1979
2018,12,9,13,15914,16588,13972,-2616
2018,12,9,14,16473,17352,14357,-2995
2018,12,9,15,16971,17949,14775,-3174
2018,12,9,16,17249,18031,14664,-3367
2018,12,9,17,17328,17984,14545,-3439
2018,12,9,18,17304,17975,14273,-3702
2018,12,9,19,17228,17993,14572,-3421
2018,12,9,20,17202,18109,14863,-3246
2018,12,9,21,17413,18451,15417,-3034
2018,12,9,22,18459,19471,16549,-2922
2018,12,9,23,19826,20526,17689,-2837
2018,12,10,0,20023,20566,17474,-3092
2018,12,10,1,19867,20362,17035,-3327
2018,12,10,2,19550,19905,16758,-3147
2018,12,10,3,18842,19098,15720,-3378
2018,12,10,4,17768,17915,14555,-3360
2018,12,10,5,16550,16736,13590,-3146
2018,12,10,6,15391,15911,13006,-2905
2018,12,10,7,14864,15463,12810,-2653
2018,12,10,8,14612,15217,12768,-2449
2018,12,10,9,14562,15171,12912,-2259
2018,12,10,10,14832,15485,13497,-1988
2018,12,10,11,15736,16431,14310,-2121
2018,12,10,12,17417,18135,16051,-2084
2018,12,10,13,18692,19362,16852,-2510
2018,12,10,14,19155,19659,17160,-2499
2018,12,10,15,19389,19718,16785,-2933
2018,12,10,16,19459,19660,16241,-3419
2018,12,10,17,19335,19493,16141,-3352
2018,12,10,18,19171,19311,15479,-3832
2018,12,10,19,19110,19302,15633,-3669
2018,12,10,20,19070,19359,15899,-3460
2018,12,10,21,19250,19714,16638,-3076
2018,12,10,22,20196,20668,18018,-2650
2018,12,10,23,21401,21790,19102,-2688
2018,12,11,0,21405,21765,18938,-2827
2018,12,11,1,21104,21458,18877,-2581
2018,12,11,2,20610,20895,18143,-2752
2018,12,11,3,19729,19955,17092,-2863
2018,12,11,4,18435,18604,15524,-3080
2018,12,11,5,17036,17220,14163,-3057
2018,12,11,6,15848,16302,13653,-2649
2018,12,11,7,15255,15777,13128,-2649
2018,12,11,8,14960,15520,12921,-2599
2018,12,11,9,14877,15473,13018,-2455
2018,12,11,10,15119,15770,13280,-2490
2018,12,11,11,15997,16800,14245,-2555
2018,12,11,12,17690,18558,16755,-1803
2018,12,11,13,18921,19693,17787,-1906
2018,12,11,14,19296,19917,17821,-2096
2018,12,11,15,19437,19936,17015,-2921
2018,12,11,16,19439,19950,16837,-3113
2018,12,11,17,19310,19876,16954,-2922
2018,12,11,18,19136,19730,16598,-3132
2018,12,11,19,19072,19706,16676,-3030
2018,12,11,20,19032,19695,16758,-2937
2018,12,11,21,19212,19973,17321,-2652
2018,12,11,22,20151,20915,18437,-2478
2018,12,11,23,21317,21825,19604,-2221
2018,12,12,0,21298,21745,18955,-2790
2018,12,12,1,20971,21391,18796,-2595
2018,12,12,2,20471,20802,18491,-2311
2018,12,12,3,19589,19917,17559,-2358
2018,12,12,4,18297,18601,16035,-2566
2018,12,12,5,16898,17168,14456,-2712
2018,12,12,6,15686,16212,13863,-2349
2018,12,12,7,15081,15636,13553,-2083
2018,12,12,8,14758,15293,13062,-2231
2018,12,12,9,14654,15224,13255,-1969
2018,12,12,10,14870,15501,13417,-2084
2018,12,12,11,15732,16434,14612,-1822
2018,12,12,12,17415,18224,16673,-1551
2018,12,12,13,18670,19384,17608,-1776
2018,12,12,14,19065,19589,17507,-2082
2018,12,12,15,19230,19607,17454,-2153
2018,12,12,16,19250,19620,17181,-2439
2018,12,12,17,19132,19579,16782,-2797
2018,12,12,18,18968,19583,16942,-2641
2018,12,12,19,18925,19618,16949,-2669
2018,12,12,20,18904,19655,16720,-2935
2018,12,12,21,19110,19884,16979,-2905
2018,12,12,22,20062,20849,17685,-3164
2018,12,12,23,21233,21802,18814,-2988
2018,12,13,0,21212,21665,18552,-3113
2018,12,13,1,20889,21342,18785,-2557
2018,12,13,2,20406,20807,18459,-2348
2018,12,13,3,19568,19941,17755,-2186
2018,12,13,4,18308,18520,15940,-2580
2018,12,13,5,16935,17133,14485,-2648
2018,12,13,6,15650,16174,13516,-2658
2018,12,13,7,15035,15631,13040,-2591
2018,12,13,8,14715,15329,12981,-2348
2018,12,13,9,14622,15288,12941,-2347
2018,12,13,10,14845,15569,13389,-2180
2018,12,13,11,15726,16446,14802,-1644
2018,12,13,12,17432,18155,16485,-1670
2018,12,13,13,18715,19445,18367,-1078
2018,12,13,14,19139,19933,18958,-975
2018,12,13,15,19360,20225,18682,-1543
2018,12,13,16,19419,20426,18227,-2199
2018,12,13,17,19342,20404,17977,-2427
2018,12,13,18,19205,20289,17271,-3018
2018,12,13,19,19159,20238,17622,-2616
2018,12,13,20,19106,20152,17547,-2605
2018,12,13,21,19259,20295,17961,-2334
2018,12,13,22,20147,21067,19264,-1803
2018,12,13,23,21194,21807,19585,-2222
2018,12,14,0,21059,21581,19660,-1921
2018,12,14,1,20685,21124,19377,-1747
2018,12,14,2,20155,20518,18475,-2043
2018,12,14,3,19276,19575,17319,-2256
2018,12,14,4,17996,18217,15648,-2569
2018,12,14,5,16591,16830,14075,-2755
2018,12,14,6,15145,15821,13388,-2433
2018,12,14,7,14494,15282,13181,-2101
2018,12,14,8,14152,14874,12984,-1890
2018,12,14,9,14028,14741,13073,-1668
2018,12,14,10,14222,14990,13075,-1915
2018,12,14,11,15056,15910,13673,-2237
2018,12,14,12,16702,17588,15206,-2382
2018,12,14,13,17958,18795,16660,-2135
2018,12,14,14,18388,19208,16702,-2506
2018,12,14,15,18624,19475,17135,-2340
2018,12,14,16,18684,19509,17065,-2444
2018,12,14,17,18638,19362,16866,-2496
2018,12,14,18,18488,19213,16703,-2510
2018,12,14,19,18429,19187,16482,-2705
2018,12,14,20,18365,19100,16412,-2688
2018,12,14,21,18486,19248,16715,-2533
2018,12,14,22,19293,20013,17370,-2643
2018,12,14,23,20185,20537,18006,-2531
2018,12,15,0,19930,20197,18000,-2197
2018,12,15,1,19459,19689,17191,-2498
2018,12,15,2,18884,19140,16751,-2389
2018,12,15,3,18134,18466,15803,-2663
2018,12,15,4,17089,17396,14444,-2952
2018,12,15,5,15869,16223,13519,-2704
2018,12,15,6,14725,15181,12679,-2502
2018,12,15,7,14003,14529,11905,-2624
2018,12,15,8,13584,14075,11733,-2342
2018,12,15,9,13369,13868,11584,-2284
2018,12,15,10,13381,13905,12021,-1884
2018,12,15,11,13718,14276,12158,-2118
2018,12,15,12,14446,14940,12665,-2275
2018,12,15,13,15220,15805,13650,-2155
2018,12,15,14,15921,16690,14209,-2481
2018,12,15,15,16511,17283,14579,-2704
2018,12,15,16,16822,17646,14650,-2996
2018,12,15,17,16907,17725,14290,-3435
2018,12,15,18,16842,17654,14442,-3212
2018,12,15,19,16722,17539,13920,-3619
2018,12,15,20,16657,17502,14024,-3478
2018,12,15,21,16814,17581,14405,-3176
2018,12,15,22,17723,18391,15300,-3091
2018,12,15,23,18829,19071,15803,-3268
2018,12,16,0,18829,18965,15832,-3133
2018,12,16,1,18523,18628,15355,-3273
2018,12,16,2,18098,18250,14988,-3262
2018,12,16,3,17507,17733,14364,-3369
2018,12,16,4,16645,16921,13321,-3600
2018,12,16,5,15612,15982,12607,-3375
2018,12,16,6,14688,15191,12012,-3179
2018,12,16,7,14021,14555,11818,-2737
2018,12,16,8,13618,14151,11418,-2733
2018,12,16,9,13405,13905,11327,-2578
2018,12,16,10,13393,13926,11553,-2373
2018,12,16,11,13651,14212,12007,-2205
2018,12,16,12,14217,14788,12405,-2383
2018,12,16,13,14822,15520,13125,-2395
2018,12,16,14,15464,16388,13963,-2425
2018,12,16,15,16102,17141,14240,-2901
2018,12,16,16,16508,17674,14570,-3104
2018,12,16,17,16729,18001,14878,-3123
2018,12,16,18,16802,18166,15246,-2920
2018,12,16,19,16789,18288,15159,-3129
2018,12,16,20,16787,18371,15092,-3279
2018,12,16,21,17010,18555,15497,-3058
2018,12,16,22,18028,19365,16408,-2957
2018,12,16,23,19275,19986,16779,-3207
2018,12,17,0,19354,19927,16608,-3319
2018,12,17,1,19108,19694,16336,-3358
2018,12,17,2,18690,19264,16447,-2817
2018,12,17,3,17955,18492,15629,-2863
2018,12,17,4,16875,17318,14241,-3077
2018,12,17,5,15664,16113,12719,-3394
2018,12,17,6,14632,15159,11852,-3307
2018,12,17,7,14097,14597,11789,-2808
2018,12,17,8,13821,14303,11648,-2655
2018,12,17,9,13753,14177,11708,-2469
2018,12,17,10,14012,14479,12044,-2435
2018,12,17,11,14937,15465,12646,-2819
2018,12,17,12,16676,17241,14096,-3145
2018,12,17,13,18038,18539,15433,-3106
2018,12,17,14,18518,18899,15858,-3041
2018,12,17,15,18797,19041,15835,-3206
2018,12,17,16,18908,19160,15860,-3300
2018,12,17,17,18857,19274,15829,-3445
2018,12,17,18,18741,19367,16050,-3317
2018,12,17,19,18709,19540,16198,-3342
2018,12,17,20,18680,19523,16275,-3248
2018,12,17,21,18870,19782,16758,-3024
2018,12,17,22,19809,20717,17661,-3056
2018,12,17,23,20975,21468,18455,-3013
2018,12,18,0,20948,21307,18478,-2829
2018,12,18,1,20602,20952,18012,-2940
2018,12,18,2,20039,20433,17148,-3285
2018,12,18,3,19141,19589,16438,-3151
2018,12,18,4,17833,18289,15126,-3163
2018,12,18,5,16440,16897,13670,-3227
2018,12,18,6,15474,15976,13004,-2972
2018,12,18,7,14873,15433,12506,-2927
2018,12,18,8,14548,15164,12312,-2852
2018,12,18,9,14453,15149,12395,-2754
2018,12,18,10,14697,15446,12569,-2877
2018,12,18,11,15614,16396,13503,-2893
2018,12,18,12,17405,18280,15616,-2664
2018,12,18,13,18777,19549,17229,-2320
2018,12,18,14,19221,19845,17291,-2554
2018,12,18,15,19456,19828,17246,-2582
2018,12,18,16,19540,19764,16958,-2806
2018,12,18,17,19411,19599,16472,-3127
2018,12,18,18,19257,19418,15905,-3513
2018,12,18,19,19209,19426,15905,-3521
2018,12,18,20,19187,19514,15949,-3565
2018,12,18,21,19408,19872,16389,-3483
2018,12,18,22,20401,20877,17650,-3227
2018,12,18,23,21650,22080,18762,-3318
2018,12,19,0,21618,22061,18515,-3546
2018,12,19,1,21246,21742,18076,-3666
2018,12,19,2,20699,21297,17897,-3400
2018,12,19,3,19810,20399,17073,-3326
2018,12,19,4,18449,19122,15945,-3177
2018,12,19,5,16998,17723,14297,-3426
2018,12,19,6,15988,16687,13507,-3180
2018,12,19,7,15398,16139,13291,-2848
2018,12,19,8,15077,15811,12939,-2872
2018,12,19,9,14976,15719,12886,-2833
2018,12,19,10,15197,15982,13116,-2866
2018,12,19,11,16073,16899,14035,-2864
2018,12,19,12,17795,18672,15788,-2884
2018,12,19,13,19066,19867,16919,-2948
2018,12,19,14,19372,20037,17035,-3002
2018,12,19,15,19451,19868,16731,-3137
2018,12,19,16,19388,19598,16368,-3230
2018,12,19,17,19232,19287,15943,-3344
2018,12,19,18,19015,19071,15604,-3467
2018,12,19,19,18934,19054,15608,-3446
2018,12,19,20,18884,19068,15408,-3660
2018,12,19,21,19077,19398,15953,-3445
2018,12,19,22,19996,20346,17087,-3259
2018,12,19,23,21143,21442,18171,-3271
2018,12,20,0,21080,21333,17879,-3454
2018,12,20,1,20719,21072,17867,-3205
2018,12,20,2,20204,20623,17364,-3259
2018,12,20,3,19365,19826,16909,-2917
2018,12,20,4,18075,18547,15837,-2710
2018,12,20,5,16672,17136,14130,-3006
2018,12,20,6,15637,16140,13150,-2990
2018,12,20,7,14964,15516,12812,-2704
2018,12,20,8,14596,15196,12393,-2803
2018,12,20,9,14462,15158,12327,-2831
2018,12,20,10,14669,15436,12756,-2680
2018,12,20,11,15537,16363,13738,-2625
2018,12,20,12,17255,18184,15645,-2539
2018,12,20,13,18577,19400,16867,-2533
2018,12,20,14,18982,19523,16848,-2675
2018,12,20,15,19163,19364,16440,-2924
2018,12,20,16,19175,19215,15984,-3231
2018,12,20,17,19106,19076,15724,-3352
2018,12,20,18,18917,19033,15699,-3334
2018,12,20,19,18828,19107,15699,-3408
2018,12,20,20,18758,19213,15902,-3311
2018,12,20,21,18896,19522,16221,-3301
2018,12,20,22,19765,20338,17457,-2881
2018,12,20,23,20818,20963,18172,-2791
2018,12,21,0,20691,20785,17975,-2810
2018,12,21,1,20306,20414,17579,-2835
2018,12,21,2,19765,19885,17086,-2799
2018,12,21,3,18917,19031,15995,-3036
2018,12,21,4,17650,17711,14517,-3194
2018,12,21,5,16234,16319,13154,-3165
2018,12,21,6,15010,15215,12508,-2707
2018,12,21,7,14249,14578,12100,-2478
2018,12,21,8,13812,14190,11674,-2516
2018,12,21,9,13613,14047,11677,-2370
2018,12,21,10,13747,14207,11957,-2250
2018,12,21,11,14510,14973,12940,-2033
2018,12,21,12,16128,16578,14608,-1970
2018,12,21,13,17505,17949,15904,-2045
2018,12,21,14,18120,18477,16080,-2397
2018,12,21,15,18525,18837,16072,-2765
2018,12,21,16,18697,18949,16022,-2927
2018,12,21,17,18679,18932,15873,-3059
2018,12,21,18,18537,18790,15760,-3030
2018,12,21,19,18450,18631,15664,-2967
2018,12,21,20,18361,18582,15583,-2999
2018,12,21,21,18438,18667,15679,-2988
2018,12,21,22,19185,19315,16494,-2821
2018,12,21,23,20035,19908,17118,-2790
2018,12,22,0,19717,19636,16515,-3121
2018,12,22,1,19187,19168,15725,-3443
2018,12,22,2,18573,18608,14970,-3638
2018,12,22,3,17855,17949,14642,-3307
2018,12,22,4,16851,16920,13054,-3866
2018,12,22,5,15637,15785,12328,-3457
2018,12,22,6,14880,14760,11929,-2831
2018,12,22,7,14090,14151,11918,-2233
2018,12,22,8,13605,13753,11568,-2185
2018,12,22,9,13343,13587,11147,-2440
2018,12,22,10,13331,13626,11351,-2275
2018,12,22,11,13618,14024,11933,-2091
2018,12,22,12,14278,14791,12034,-2757
2018,12,22,13,15138,15645,13111,-2534
2018,12,22,14,16027,16468,13826,-2642
2018,12,22,15,16793,17090,14001,-3089
2018,12,22,16,17222,17435,14349,-3086
2018,12,22,17,17330,17688,14842,-2846
2018,12,22,18,17261,17754,14958,-2796
2018,12,22,19,17101,17770,15133,-2637
2018,12,22,20,17030,17780,14850,-2930
2018,12,22,21,17182,17914,15044,-2870
2018,12,22,22,18116,18697,15783,-2914
2018,12,22,23,19337,19545,16404,-3141
2018,12,23,0,19395,19511,16311,-3200
2018,12,23,1,19085,19281,16040,-3241
2018,12,23,2,18664,18929,15713,-3216
2018,12,23,3,18129,18403,15322,-3081
2018,12,23,4,17288,17603,14497,-3106
2018,12,23,5,16238,16617,13921,-2696
2018,12,23,6,15438,15698,13092,-2606
2018,12,23,7,14689,15093,12609,-2484
2018,12,23,8,14226,14690,12017,-2673
2018,12,23,9,13980,14504,11977,-2527
2018,12,23,10,13963,14483,12181,-2302
2018,12,23,11,14154,14729,12544,-2185
2018,12,23,12,14605,15252,13238,-2014
2018,12,23,13,15179,15895,13767,-2128
2018,12,23,14,15860,16570,13831,-2739
2018,12,23,15,16470,17000,13782,-3218
2018,12,23,16,16789,17204,13763,-3441
2018,12,23,17,16872,17291,13677,-3614
2018,12,23,18,16804,17292,13609,-3683
2018,12,23,19,16655,17230,13774,-3456
2018,12,23,20,16608,17120,13673,-3447
2018,12,23,21,16812,17382,14212,-3170
2018,12,23,22,17879,18307,15204,-3103
2018,12,23,23,19338,19302,16053,-3249
2018,12,24,0,19617,19313,16076,-3237
2018,12,24,1,19469,19100,15786,-3314
2018,12,24,2,19145,18795,15461,-3334
2018,12,24,3,18504,18192,14703,-3489
2018,12,24,4,17478,17266,13858,-3408
2018,12,24,5,16239,16194,13011,-3183
2018,12,24,6,14990,15250,12368,-2882
2018,12,24,7,14336,14612,12122,-2490
2018,12,24,8,13953,14283,12134,-2149
2018,12,24,9,13808,14153,12086,-2067
2018,12,24,10,13939,14270,12144,-2126
2018,12,24,11,14498,14828,12416,-2412
2018,12,24,12,15488,15818,12962,-2856
2018,12,24,13,16552,16793,13683,-3110
2018,12,24,14,17369,17644,14265,-3379
2018,12,24,15,18068,18416,14873,-3543
2018,12,24,16,18366,18754,14989,-3765
2018,12,24,17,18371,18696,15630,-3066
2018,12,24,18,18201,18473,15572,-2901
2018,12,24,19,18026,18355,15060,-3295
2018,12,24,20,17865,18270,14888,-3382
2018,12,24,21,17797,18407,15277,-3130
2018,12,24,22,18353,19040,16024,-3016
2018,12,24,23,19213,19514,16348,-3166
2018,12,25,0,18797,19024,15530,-3494
2018,12,25,1,18287,18490,15184,-3306
2018,12,25,2,17921,18042,15172,-2870
2018,12,25,3,17588,17639,14719,-2920
2018,12,25,4,17122,16972,13896,-3076
2018,12,25,5,16405,16199,13067,-3132
2018,12,25,6,15366,15410,12409,-3001
2018,12,25,7,14695,14799,12361,-2438
2018,12,25,8,14235,14404,12047,-2357
2018,12,25,9,13994,14227,12137,-2090
2018,12,25,10,13983,14217,12067,-2150
2018,12,25,11,14247,14507,12271,-2236
2018,12,25,12,14772,15073,12888,-2185
2018,12,25,13,15312,15617,13531,-2086
2018,12,25,14,15806,16126,13584,-2542
2018,12,25,15,16230,16483,13707,-2776
2018,12,25,16,16426,16539,13675,-2864
2018,12,25,17,16505,16541,13613,-2928
2018,12,25,18,16493,16475,13408,-3067
2018,12,25,19,16395,16435,13535,-2900
2018,12,25,20,16307,16463,13714,-2749
2018,12,25,21,16354,16657,13830,-2827
2018,12,25,22,16921,17436,14526,-2910
2018,12,25,23,17806,18132,15150,-2982
2018,12,26,0,17857,18028,14876,-3152
2018,12,26,1,17815,17934,14887,-3047
2018,12,26,2,17737,17802,14809,-2993
2018,12,26,3,17422,17459,14474,-2985
2018,12,26,4,16740,16784,13801,-2983
2018,12,26,5,15907,15944,13007,-2937
2018,12,26,6,15823,15207,11958,-3249
2018,12,26,7,0,14743,11688,-3055
2018,12,26,8,0,14518,11834,-2684
2018,12,26,9,0,14471,11759,-2712
2018,12,26,10,0,14702,12197,-2505
2018,12,26,11,0,15434,12718,-2716
2018,12,26,12,0,16617,13673,-2944
2018,12,26,13,0,17738,14877,-2861
2018,12,26,14,0,18505,15316,-3189
2018,12,26,15,0,19046,15510,-3536
2018,12,26,16,0,19195,15794,-3401
2018,12,26,17,0,19156,15778,-3378
2018,12,26,18,0,19124,15862,-3262
2018,12,26,19,0,19113,15662,-3451
2018,12,26,20,0,19044,15661,-3383
2018,12,26,21,0,19209,15462,-3747
2018,12,26,22,0,19909,15993,-3916
2018,12,26,23,0,20868,17144,-3724
2018,12,27,0,0,20693,16826,-3867
2018,12,27,1,0,20299,16786,-3513
2018,12,27,2,0,19695,16470,-3225
2018,12,27,3,0,18880,15454,-3426
2018,12,27,4,0,17786,14459,-3327
2018,12,27,5,0,16561,13211,-3350
2018,12,27,6,15736,15586,12493,-3093
2018,12,27,7,15069,14974,12026,-2948
2018,12,27,8,14706,14666,11966,-2700
2018,12,27,9,14566,14576,12116,-2460
2018,12,27,10,14739,14785,12201,-2584
2018,12,27,11,15481,15534,12781,-2753
2018,12,27,12,16902,16806,13783,-3023
2018,12,27,13,18093,17947,14582,-3365
2018,12,27,14,18656,18490,14963,-3527
2018,12,27,15,19070,18664,14854,-3810
2018,12,27,16,19286,18506,14529,-3977
2018,12,27,17,19310,18508,14394,-4114
2018,12,27,18,19182,18418,14592,-3826
2018,12,27,19,19116,18550,15131,-3419
2018,12,27,20,19062,18590,15614,-2976
2018,12,27,21,19213,18762,15819,-2943
2018,12,27,22,20035,19638,16545,-3093
2018,12,27,23,21202,20678,17163,-3515
2018,12,28,0,21108,20551,17073,-3478
2018,12,28,1,20681,20123,16933,-3190
2018,12,28,2,20122,19544,16501,-3043
2018,12,28,3,19299,18887,15825,-3062
2018,12,28,4,18068,17559,14877,-2682
2018,12,28,5,16687,16351,14096,-2255
2018,12,28,6,15276,15390,13583,-1807
2018,12,28,7,14610,14775,13335,-1440
2018,12,28,8,14243,14419,12750,-1669
2018,12,28,9,14078,14262,12466,-1796
2018,12,28,10,14190,14390,12788,-1602
2018,12,28,11,14825,15016,13145,-1871
2018,12,28,12,16073,16106,13829,-2277
2018,12,28,13,17180,17209,14568,-2641
2018,12,28,14,17788,17958,14989,-2969
2018,12,28,15,18293,18555,15401,-3154
2018,12,28,16,18598,18958,15584,-3374
2018,12,28,17,18682,19110,15871,-3239
2018,12,28,18,18626,19027,15767,-3260
2018,12,28,19,18590,18950,15701,-3249
2018,12,28,20,18527,18823,15298,-3525
2018,12,28,21,18605,18821,15760,-3061
2018,12,28,22,19217,19276,16223,-3053
2018,12,28,23,19977,19730,16372,-3358
2018,12,29,0,19606,19363,16190,-3173
2018,12,29,1,19038,18827,15641,-3186
2018,12,29,2,18423,18227,15317,-2910
2018,12,29,3,17751,17458,14322,-3136
2018,12,29,4,16818,16522,13680,-2842
2018,12,29,5,15717,15456,12912,-2544
2018,12,29,6,14713,14518,12007,-2511
2018,12,29,7,13985,13920,12001,-1919
2018,12,29,8,13538,13577,11741,-1836
2018,12,29,9,13289,13409,11799,-1610
2018,12,29,10,13252,13456,11783,-1673
2018,12,29,11,13460,13732,12022,-1710
2018,12,29,12,13952,14368,12659,-1709
2018,12,29,13,14667,15032,13185,-1847
2018,12,29,14,15477,15669,13250,-2419
2018,12,29,15,16225,16287,13353,-2934
2018,12,29,16,16688,16711,13584,-3127
2018,12,29,17,16883,16941,13565,-3376
2018,12,29,18,16858,16956,13640,-3316
2018,12,29,19,16752,16924,13753,-3171
2018,12,29,20,16718,16984,13890,-3094
2018,12,29,21,16894,17142,13981,-3161
2018,12,29,22,17709,17937,14334,-3603
2018,12,29,23,18889,18931,15064,-3867
2018,12,30,0,18978,18921,15252,-3669
2018,12,30,1,18655,18647,15113,-3534
2018,12,30,2,18230,18317,14780,-3537
2018,12,30,3,17752,17804,14334,-3470
2018,12,30,4,16991,17052,13569,-3483
2018,12,30,5,16055,16161,12608,-3553
2018,12,30,6,15180,15362,11940,-3422
2018,12,30,7,14515,14771,11800,-2971
2018,12,30,8,14106,14403,11676,-2727
2018,12,30,9,13888,14223,11795,-2428
2018,12,30,10,13844,14256,11879,-2377
2018,12,30,11,13979,14512,11839,-2673
2018,12,30,12,14260,14971,11956,-3015
2018,12,30,13,14717,15540,12813,-2727
2018,12,30,14,15391,16224,13490,-2734
2018,12,30,15,16093,16839,13866,-2973
2018,12,30,16,16531,17239,14150,-3089
2018,12,30,17,16670,17538,14380,-3158
2018,12,30,18,16672,17575,14034,-3541
2018,12,30,19,16592,17566,13918,-3648
2018,12,30,20,16563,17519,14042,-3477
2018,12,30,21,16776,17649,14380,-3269
2018,12,30,22,17694,18426,14841,-3585
2018,12,30,23,19080,19380,15666,-3714
2018,12,31,0,19274,19298,15597,-3701
2018,12,31,1,19036,18969,15575,-3394
2018,12,31,2,18654,18568,15488,-3080
2018,12,31,3,18035,17989,15024,-2965
2018,12,31,4,17044,17130,14407,-2723
2018,12,31,5,15897,16180,13398,-2782
2018,12,31,6,14833,15368,12964,-2404
2018,12,31,7,14232,14802,12575,-2227
2018,12,31,8,13871,14452,12354,-2098
2018,12,31,9,13704,14361,12453,-1908
2018,12,31,10,13829,14528,12599,-1929
2018,12,31,11,14459,15118,12869,-2249
2018,12,31,12,15572,16137,13550,-2587
2018,12,31,13,16557,17086,14476,-2610
2018,12,31,14,17190,17602,14917,-2685
2018,12,31,15,17685,18038,15040,-2998
2018,12,31,16,17924,18348,15151,-3197
2018,12,31,17,18031,18408,15318,-3090
2018,12,31,18,17942,18458,15280,-3178
2018,12,31,19,17858,18436,15234,-3202
2018,12,31,20,17781,18485,15220,-3265
2018,12,31,21,17842,18664,15556,-3108
2018,12,31,22,18560,19405,16272,-3133
2018,12,31,23,19730,19960,16829,-3131
2019,1,1,0,19468,19586,16454,-3132
2019,1,1,1,18752,18891,15841,-3050
2019,1,1,2,17925,18198,15150,-3048
2019,1,1,3,17091,17423,14718,-2705
2019,1,1,4,16306,16613,14103,-2510
2019,1,1,5,15617,15774,13191,-2583
2019,1,1,6,14858,15053,12725,-2328
2019,1,1,7,14216,14481,12473,-2008
2019,1,1,8,13691,13927,12262,-1665
2019,1,1,9,13356,13566,12054,-1512
2019,1,1,10,13230,13353,11927,-1426
2019,1,1,11,13345,13475,12173,-1302
2019,1,1,12,13690,13846,12430,-1416
2019,1,1,13,13973,14199,12548,-1651
2019,1,1,14,14346,14570,12784,-1786
2019,1,1,15,14904,15172,13136,-2036
2019,1,1,16,15429,15796,14049,-1747
2019,1,1,17,15765,16202,14326,-1876
2019,1,1,18,15971,16281,14284,-1997
2019,1,1,19,16038,16245,13941,-2304
2019,1,1,20,16088,16420,13808,-2612
2019,1,1,21,16266,16772,14257,-2515
2019,1,1,22,17020,17713,14900,-2813
2019,1,1,23,18285,18830,15583,-3247
2019,1,2,0,18337,18788,15428,-3360
2019,1,2,1,18116,18508,14839,-3669
2019,1,2,2,17734,18070,14502,-3568
2019,1,2,3,17117,17388,14035,-3353
2019,1,2,4,16241,16399,13088,-3311
2019,1,2,5,15396,15460,12442,-3018
2019,1,2,6,15473,14781,12132,-2649
2019,1,2,7,14998,14410,11858,-2552
2019,1,2,8,14688,14207,11492,-2715
2019,1,2,9,14583,14215,11611,-2604
2019,1,2,10,14773,14547,11827,-2720
2019,1,2,11,15531,15509,12967,-2542
2019,1,2,12,16966,17189,14344,-2845
2019,1,2,13,18096,18528,15695,-2833
2019,1,2,14,18568,18925,16266,-2659
2019,1,2,15,18906,19077,16073,-3004
2019,1,2,16,19095,19018,15666,-3352
2019,1,2,17,19126,18859,15246,-3613
2019,1,2,18,19012,18733,15284,-3449
2019,1,2,19,18928,18897,15503,-3394
2019,1,2,20,18843,19070,15923,-3147
2019,1,2,21,18933,19330,16326,-3004
2019,1,2,22,19704,20115,17449,-2666
2019,1,2,23,20927,21109,18229,-2880
2019,1,3,0,20905,20963,17688,-3275
2019,1,3,1,20524,20518,17304,-3214
2019,1,3,2,19969,19859,16548,-3311
2019,1,3,3,18956,18942,15537,-3405
2019,1,3,4,17707,17616,14468,-3148
2019,1,3,5,16450,16316,13426,-2890
2019,1,3,6,15170,15369,13152,-2217
2019,1,3,7,0,14858,13051,-1807
2019,1,3,8,0,14575,13015,-1560
2019,1,3,9,0,14453,12834,-1619
2019,1,3,10,0,14643,12991,-1652
2019,1,3,11,0,15482,13638,-1844
2019,1,3,12,0,17057,14774,-2283
2019,1,3,13,0,18333,15997,-2336
2019,1,3,14,0,18755,16316,-2439
2019,1,3,15,0,18975,16287,-2688
2019,1,3,16,0,19142,16153,-2989
2019,1,3,17,0,19158,16073,-3085
2019,1,3,18,0,19021,15883,-3138
2019,1,3,19,0,18993,15642,-3351
2019,1,3,20,0,19034,15533,-3501
2019,1,3,21,0,19276,15718,-3558
2019,1,3,22,0,20021,17029,-2992
2019,1,3,23,0,20888,17780,-3108
2019,1,4,0,0,20775,17817,-2958
2019,1,4,1,0,20340,17346,-2994
2019,1,4,2,0,19730,16794,-2936
2019,1,4,3,0,18835,15969,-2866
2019,1,4,4,0,17620,14884,-2736
2019,1,4,5,0,16376,13751,-2625
2019,1,4,6,15306,15497,12996,-2501
2019,1,4,7,14755,14960,12890,-2070
2019,1,4,8,14451,14684,12770,-1914
2019,1,4,9,14340,14594,12644,-1950
2019,1,4,10,14516,14858,13360,-1498
2019,1,4,11,15276,15749,13632,-2117
2019,1,4,12,16777,17441,14868,-2573
2019,1,4,13,17939,18698,15949,-2749
2019,1,4,14,18313,18980,16405,-2575
2019,1,4,15,18540,18973,16300,-2673
2019,1,4,16,18621,18855,16144,-2711
2019,1,4,17,18543,18700,15932,-2768
2019,1,4,18,18366,18456,15547,-2909
2019,1,4,19,18238,18441,15389,-3052
2019,1,4,20,18118,18442,15439,-3003
2019,1,4,21,18165,18611,15816,-2795
2019,1,4,22,18790,19223,16227,-2996
2019,1,4,23,19788,20078,17028,-3050
2019,1,5,0,19643,19891,16626,-3265
2019,1,5,1,19201,19379,16223,-3156
2019,1,5,2,18654,18874,16063,-2811
2019,1,5,3,17834,18184,15031,-3153
2019,1,5,4,16878,17166,14077,-3089
2019,1,5,5,15859,16064,12836,-3228
2019,1,5,6,14910,15127,12068,-3059
2019,1,5,7,14307,14519,12069,-2450
2019,1,5,8,13946,14201,11723,-2478
2019,1,5,9,13759,14038,11560,-2478
2019,1,5,10,13772,14083,11645,-2438
2019,1,5,11,14087,14382,11878,-2504
2019,1,5,12,14788,14998,12880,-2118
2019,1,5,13,15549,15740,13089,-2651
2019,1,5,14,16162,16472,13830,-2642
2019,1,5,15,16712,17205,14180,-3025
2019,1,5,16,17015,17624,14176,-3448
2019,1,5,17,17080,17812,14271,-3541
2019,1,5,18,16998,17795,14582,-3213
2019,1,5,19,16828,17724,14418,-3306
2019,1,5,20,16694,17675,14559,-3116
2019,1,5,21,16759,17753,14682,-3071
2019,1,5,22,17420,18268,15185,-3083
2019,1,5,23,18501,18996,15662,-3334
2019,1,6,0,18530,18949,15880,-3069
2019,1,6,1,18204,18560,15356,-3204
2019,1,6,2,17751,18139,15098,-3041
2019,1,6,3,17059,17532,14359,-3173
2019,1,6,4,16252,16720,13697,-3023
2019,1,6,5,15403,15844,12875,-2969
2019,1,6,6,14750,15023,11923,-3100
2019,1,6,7,14201,14433,11646,-2787
2019,1,6,8,13846,14041,11619,-2422
2019,1,6,9,13661,13853,11535,-2318
2019,1,6,10,13643,13851,11705,-2146
2019,1,6,11,13860,14064,12169,-1895
2019,1,6,12,14386,14553,12747,-1806
2019,1,6,13,14950,15162,13069,-2093
2019,1,6,14,15451,15826,13244,-2582
2019,1,6,15,15967,16478,13631,-2847
2019,1,6,16,16297,16938,14551,-2387
2019,1,6,17,16469,16933,14753,-2180
2019,1,6,18,16503,16950,14715,-2235
2019,1,6,19,16442,17056,14575,-2481
2019,1,6,20,16405,17194,14240,-2954
2019,1,6,21,16577,17502,14590,-2912
2019,1,6,22,17380,18363,15343,-3020
2019,1,6,23,18728,19540,16088,-3452
2019,1,7,0,18992,19712,16290,-3422
2019,1,7,1,18826,19443,15875,-3568
2019,1,7,2,18495,19056,15658,-3398
2019,1,7,3,17766,18346,15205,-3141
2019,1,7,4,16833,17394,14300,-3094
2019,1,7,5,15911,16406,13320,-3086
2019,1,7,6,15402,15724,12788,-2936
2019,1,7,7,14998,15326,12270,-3056
2019,1,7,8,14783,15155,12061,-3094
2019,1,7,9,14747,15158,12146,-3012
2019,1,7,10,15022,15498,12595,-2903
2019,1,7,11,15947,16546,13575,-2971
2019,1,7,12,17706,18377,15290,-3087
2019,1,7,13,19078,19652,15944,-3708
2019,1,7,14,19469,19968,16229,-3739
2019,1,7,15,19695,20120,16114,-4006
2019,1,7,16,19784,20188,16112,-4076
2019,1,7,17,19761,20106,15958,-4148
2019,1,7,18,19595,19962,15822,-4140
2019,1,7,19,19475,19986,16416,-3570
2019,1,7,20,19335,20061,16761,-3300
2019,1,7,21,19390,20406,17134,-3272
2019,1,7,22,20058,21196,18189,-3007
2019,1,7,23,21195,21993,19110,-2883
2019,1,8,0,21208,21814,19461,-2353
2019,1,8,1,20796,21380,18886,-2494
2019,1,8,2,20124,20622,18127,-2495
2019,1,8,3,19023,19642,16874,-2768
2019,1,8,4,17679,18291,15287,-3004
2019,1,8,5,16353,16982,14298,-2684
2019,1,8,6,15322,16011,13502,-2509
2019,1,8,7,14827,15447,12806,-2641
2019,1,8,8,14567,15131,12894,-2237
2019,1,8,9,14480,14999,12736,-2263
2019,1,8,10,14674,15174,13006,-2168
2019,1,8,11,15463,15995,13828,-2167
2019,1,8,12,17032,17564,14875,-2689
2019,1,8,13,18240,18852,16674,-2178
2019,1,8,14,18569,19302,17109,-2193
2019,1,8,15,18777,19455,17048,-2407
2019,1,8,16,18881,19524,16682,-2842
2019,1,8,17,18840,19493,16589,-2904
2019,1,8,18,18749,19422,16515,-2907
2019,1,8,19,18699,19348,16432,-2916
2019,1,8,20,18623,19254,16263,-2991
2019,1,8,21,18707,19276,16050,-3226
2019,1,8,22,19290,19835,16371,-3464
2019,1,8,23,20219,20561,17014,-3547
2019,1,9,0,20130,20401,17022,-3379
2019,1,9,1,19723,19908,16812,-3096
2019,1,9,2,19153,19276,16074,-3202
2019,1,9,3,18235,18321,14796,-3525
2019,1,9,4,17087,17136,14071,-3065
2019,1,9,5,15937,15928,13327,-2601
2019,1,9,6,14894,15038,12600,-2438
2019,1,9,7,14334,14545,11761,-2784
2019,1,9,8,14024,14293,12060,-2233
2019,1,9,9,13908,14250,11840,-2410
2019,1,9,10,14090,14518,12261,-2257
2019,1,9,11,14907,15453,13228,-2225
2019,1,9,12,16577,17251,14710,-2541
2019,1,9,13,17896,18467,15958,-2509
2019,1,9,14,18311,18776,15964,-2812
2019,1,9,15,18594,18931,15924,-3007
2019,1,9,16,18756,18999,15883,-3116
2019,1,9,17,18797,19043,16021,-3022
2019,1,9,18,18728,19009,15843,-3166
2019,1,9,19,18710,19091,16074,-3017
2019,1,9,20,18659,19117,16108,-3009
2019,1,9,21,18789,19404,16326,-3078
2019,1,9,22,19432,20105,16776,-3329
2019,1,9,23,20492,21046,17524,-3522
2019,1,10,0,20451,20950,17664,-3286
2019,1,10,1,20027,20564,17195,-3369
2019,1,10,2,19441,19943,16582,-3361
2019,1,10,3,18512,19056,15502,-3554
2019,1,10,4,17314,17853,14194,-3659
2019,1,10,5,16140,16693,13339,-3354
2019,1,10,6,15397,15879,12752,-3127
2019,1,10,7,14885,15420,12587,-2833
2019,1,10,8,14597,15149,12434,-2715
2019,1,10,9,14514,15107,12516,-2591
2019,1,10,10,14728,15385,12631,-2754
2019,1,10,11,15576,16339,13598,-2741
2019,1,10,12,17266,18069,15067,-3002
2019,1,10,13,18601,19384,16179,-3205
2019,1,10,14,19028,19719,16243,-3476
2019,1,10,15,19316,19904,16369,-3535
2019,1,10,16,19464,20012,16658,-3354
2019,1,10,17,19433,20177,17047,-3130
2019,1,10,18,19332,20046,17058,-2988
2019,1,10,19,19277,19949,16910,-3039
2019,1,10,20,19197,19967,16916,-3051
2019,1,10,21,19299,20224,17250,-2974
2019,1,10,22,19927,20879,17927,-2952
2019,1,10,23,21049,21968,18928,-3040
2019,1,11,0,21088,21959,19049,-2910
2019,1,11,1,20709,21561,18612,-2949
2019,1,11,2,20151,20951,18397,-2554
2019,1,11,3,19233,20021,17421,-2600
2019,1,11,4,18040,18813,16231,-2582
2019,1,11,5,16878,17590,14679,-2911
2019,1,11,6,16215,16777,13673,-3104
2019,1,11,7,15726,16317,13377,-2940
2019,1,11,8,15450,16103,13097,-3006
2019,1,11,9,15374,16090,13252,-2838
2019,1,11,10,15592,16357,13428,-2929
2019,1,11,11,16423,17337,14102,-3235
2019,1,11,12,18079,19175,15965,-3210
2019,1,11,13,19372,20451,17360,-3091
2019,1,11,14,19765,20729,17612,-3117
2019,1,11,15,19990,20749,17425,-3324
2019,1,11,16,20058,20623,17350,-3273
2019,1,11,17,19910,20434,16878,-3556
2019,1,11,18,19695,20197,16505,-3692
2019,1,11,19,19548,20114,16368,-3746
2019,1,11,20,19412,20124,16346,-3778
2019,1,11,21,19468,20376,16763,-3613
2019,1,11,22,20040,21033,17766,-3267
2019,1,11,23,21135,21997,18953,-3044
2019,1,12,0,21139,21990,19022,-2968
2019,1,12,1,20693,21579,18527,-3052
2019,1,12,2,20119,21032,17930,-3102
2019,1,12,3,19324,20328,17047,-3281
2019,1,12,4,18317,19332,15858,-3474
2019,1,12,5,17281,18249,14836,-3413
2019,1,12,6,16882,17366,13737,-3629
2019,1,12,7,16347,16850,13550,-3300
2019,1,12,8,16018,16509,13047,-3462
2019,1,12,9,15858,16314,12905,-3409
2019,1,12,10,15889,16297,13046,-3251
2019,1,12,11,16185,16678,13518,-3160
2019,1,12,12,16827,17336,14358,-2978
2019,1,12,13,17514,18109,15554,-2555
2019,1,12,14,18068,18815,16215,-2600
2019,1,12,15,18536,19277,16228,-3049
2019,1,12,16,18765,19245,15998,-3247
2019,1,12,17,18794,19135,15573,-3562
2019,1,12,18,18650,18910,14973,-3937
2019,1,12,19,18427,18732,14611,-4121
2019,1,12,20,18257,18759,14870,-3889
2019,1,12,21,18286,18968,15360,-3608
2019,1,12,22,18835,19564,16256,-3308
2019,1,12,23,19982,20537,17278,-3259
2019,1,13,0,20232,20590,17498,-3092
2019,1,13,1,19965,20200,17102,-3098
2019,1,13,2,19538,19762,16684,-3078
2019,1,13,3,18906,19161,15721,-3440
2019,1,13,4,18121,18385,14821,-3564
2019,1,13,5,17263,17535,13797,-3738
2019,1,13,6,16419,16743,13313,-3430
2019,1,13,7,15858,16203,12840,-3363
2019,1,13,8,15529,15882,12545,-3337
2019,1,13,9,15367,15726,12495,-3231
2019,1,13,10,15374,15753,12722,-3031
2019,1,13,11,15596,16035,13183,-2852
2019,1,13,12,16105,16559,13733,-2826
2019,1,13,13,16662,17225,14699,-2526
2019,1,13,14,17206,17921,15122,-2799
2019,1,13,15,17764,18382,15428,-2954
2019,1,13,16,18109,18481,15456,-3025
2019,1,13,17,18147,18495,15212,-3283
2019,1,13,18,18128,18487,15070,-3417
2019,1,13,19,18013,18466,15038,-3428
2019,1,13,20,17929,18557,15011,-3546
2019,1,13,21,18063,18808,15743,-3065
2019,1,13,22,18767,19596,17124,-2472
2019,1,13,23,20167,20785,18057,-2728
2019,1,14,0,20531,20893,17886,-3007
2019,1,14,1,20334,20620,17578,-3042
2019,1,14,2,19961,20219,17187,-3032
2019,1,14,3,19225,19404,16325,-3079
2019,1,14,4,18221,18396,15439,-2957
2019,1,14,5,17177,17425,14401,-3024
2019,1,14,6,16095,16749,13735,-3014
2019,1,14,7,15668,16394,13480,-2914
2019,1,14,8,15469,16196,13548,-2648
2019,1,14,9,15453,16157,13945,-2212
2019,1,14,10,15730,16427,14425,-2002
2019,1,14,11,16628,17411,15668,-1743
2019,1,14,12,18299,19197,17303,-1894
2019,1,14,13,19596,20514,18800,-1714
2019,1,14,14,19972,20836,18635,-2201
2019,1,14,15,20155,20955,18019,-2936
2019,1,14,16,20189,20819,17537,-3282
2019,1,14,17,20012,20556,17079,-3477
2019,1,14,18,19801,20178,16459,-3719
2019,1,14,19,19662,20025,16120,-3905
2019,1,14,20,19532,19969,16186,-3783
2019,1,14,21,19603,20243,16748,-3495
2019,1,14,22,20184,20844,18118,-2726
2019,1,14,23,21392,22064,19039,-3025
2019,1,15,0,21565,22139,19125,-3014
2019,1,15,1,21224,21779,18963,-2816
2019,1,15,2,20661,21160,18457,-2703
2019,1,15,3,19730,20286,17549,-2737
2019,1,15,4,18481,19007,16021,-2986
2019,1,15,5,17226,17723,14470,-3253
2019,1,15,6,16252,16750,14148,-2602
2019,1,15,7,15754,16309,13427,-2882
2019,1,15,8,15496,16050,13186,-2864
2019,1,15,9,15427,15986,13060,-2926
2019,1,15,10,15654,16176,13282,-2894
2019,1,15,11,16482,17139,14555,-2584
2019,1,15,12,18102,18935,16369,-2566
2019,1,15,13,19323,20226,17584,-2642
2019,1,15,14,19633,20507,17243,-3264
2019,1,15,15,19769,20541,17226,-3315
2019,1,15,16,19786,20487,16853,-3634
2019,1,15,17,19700,20342,16859,-3483
2019,1,15,18,19531,20162,16485,-3677
2019,1,15,19,19426,20113,16143,-3970
2019,1,15,20,19322,20080,16064,-4016
2019,1,15,21,19395,20239,16443,-3796
2019,1,15,22,19931,20792,17438,-3354
2019,1,15,23,21022,21748,18527,-3221
2019,1,16,0,21112,21701,18378,-3323
2019,1,16,1,20737,21330,18014,-3316
2019,1,16,2,20183,20692,17299,-3393
2019,1,16,3,19293,19752,16314,-3438
2019,1,16,4,18091,18459,15125,-3334
2019,1,16,5,16870,17213,14193,-3020
2019,1,16,6,15825,16291,13344,-2947
2019,1,16,7,15278,15829,12880,-2949
2019,1,16,8,14981,15559,12500,-3059
2019,1,16,9,14885,15482,12712,-2770
2019,1,16,10,15088,15744,13139,-2605
2019,1,16,11,15920,16634,14029,-2605
2019,1,16,12,17577,18357,16052,-2305
2019,1,16,13,18848,19661,17003,-2658
2019,1,16,14,19206,20042,17141,-2901
2019,1,16,15,19382,20287,17441,-2846
2019,1,16,16,19430,20353,17373,-2980
2019,1,16,17,19378,20148,17176,-2972
2019,1,16,18,19232,19939,16823,-3116
2019,1,16,19,19161,19872,16763,-3109
2019,1,16,20,19080,19826,16615,-3211
2019,1,16,21,19194,19948,16849,-3099
2019,1,16,22,19746,20526,17726,-2800
2019,1,16,23,20868,21514,18616,-2898
2019,1,17,0,20960,21535,18353,-3182
2019,1,17,1,20580,21150,18148,-3002
2019,1,17,2,20038,20541,17601,-2940
2019,1,17,3,19184,19653,16255,-3398
2019,1,17,4,17995,18441,15289,-3152
2019,1,17,5,16809,17244,13950,-3294
2019,1,17,6,16176,16456,13031,-3425
2019,1,17,7,15650,16061,12537,-3524
2019,1,17,8,15362,15878,12574,-3304
2019,1,17,9,15287,15878,12453,-3425
2019,1,17,10,15535,16197,12766,-3431
2019,1,17,11,16439,17190,14188,-3002
2019,1,17,12,18200,18971,16504,-2467
2019,1,17,13,19540,20270,18531,-1739
2019,1,17,14,19925,20526,18085,-2441
2019,1,17,15,20127,20549,17358,-3191
2019,1,17,16,20182,20411,17151,-3260
2019,1,17,17,20118,20231,16938,-3293
2019,1,17,18,19932,20025,16680,-3345
2019,1,17,19,19813,20080,16543,-3537
2019,1,17,20,19679,20191,16578,-3613
2019,1,17,21,19744,20509,17175,-3334
2019,1,17,22,20277,21050,18327,-2723
2019,1,17,23,21429,21986,19369,-2617
2019,1,18,0,21551,21945,19452,-2493
2019,1,18,1,21138,21559,18947,-2612
2019,1,18,2,20510,20939,18410,-2529
2019,1,18,3,19557,19985,17791,-2194
2019,1,18,4,18273,18709,16088,-2621
2019,1,18,5,16969,17442,14607,-2835
2019,1,18,6,15796,16504,13366,-3138
2019,1,18,7,15287,16004,13016,-2988
2019,1,18,8,15015,15707,12488,-3219
2019,1,18,9,14929,15592,12147,-3445
2019,1,18,10,15126,15847,12879,-2968
2019,1,18,11,15908,16743,14001,-2742
2019,1,18,12,17447,18357,15590,-2767
2019,1,18,13,18644,19570,16409,-3161
2019,1,18,14,19031,20018,16681,-3337
2019,1,18,15,19259,20348,16959,-3389
2019,1,18,16,19329,20443,17126,-3317
2019,1,18,17,19220,20315,17038,-3277
2019,1,18,18,19059,20175,16912,-3263
2019,1,18,19,18957,20064,16896,-3168
2019,1,18,20,18842,19964,16625,-3339
2019,1,18,21,18886,20004,16638,-3366
2019,1,18,22,19297,20484,17162,-3322
2019,1,18,23,20216,21034,18068,-2966
2019,1,19,0,20212,20850,17598,-3252
2019,1,19,1,19778,20383,17199,-3184
2019,1,19,2,19221,19829,16726,-3103
2019,1,19,3,18528,19080,16013,-3067
2019,1,19,4,17623,18040,14805,-3235
2019,1,19,5,16674,17026,13818,-3208
2019,1,19,6,16043,16133,12771,-3362
2019,1,19,7,15426,15597,12159,-3438
2019,1,19,8,15040,15346,12037,-3309
2019,1,19,9,14840,15257,12120,-3137
2019,1,19,10,14864,15348,12174,-3174
2019,1,19,11,15182,15718,12518,-3200
2019,1,19,12,15873,16385,13151,-3234
2019,1,19,13,16656,17175,14696,-2479
2019,1,19,14,17379,17977,15188,-2789
2019,1,19,15,18022,18581,15658,-2923
2019,1,19,16,18386,18948,16039,-2909
2019,1,19,17,18545,19069,16645,-2424
2019,1,19,18,18466,19183,17020,-2163
2019,1,19,19,18273,19223,16820,-2403
2019,1,19,20,18116,19292,16769,-2523
2019,1,19,21,18150,19473,16956,-2517
2019,1,19,22,18634,19944,17523,-2421
2019,1,19,23,19793,20670,18833,-1837
2019,1,20,0,20042,20636,18918,-1718
2019,1,20,1,19678,20260,18338,-1922
2019,1,20,2,19139,19825,17796,-2029
2019,1,20,3,18464,19180,16936,-2244
2019,1,20,4,17594,18363,16227,-2136
2019,1,20,5,16675,17444,15037,-2407
2019,1,20,6,15826,16675,14369,-2306
2019,1,20,7,15309,16115,13317,-2798
2019,1,20,8,14988,15731,12870,-2861
2019,1,20,9,14812,15539,12765,-2774
2019,1,20,10,14798,15518,12748,-2770
2019,1,20,11,14952,15725,13164,-2561
2019,1,20,12,15302,16143,13460,-2683
2019,1,20,13,15790,16661,14088,-2573
2019,1,20,14,16464,17361,14399,-2962
2019,1,20,15,17148,18250,15343,-2907
2019,1,20,16,17608,18966,15652,-3314
2019,1,20,17,17887,19452,16377,-3075
2019,1,20,18,18002,19568,15859,-3709
2019,1,20,19,17990,19584,16163,-3421
2019,1,20,20,17982,19643,16328,-3315
2019,1,20,21,18119,19839,16573,-3266
2019,1,20,22,18684,20382,17152,-3230
2019,1,20,23,19943,21565,18185,-3380
2019,1,21,0,20362,21791,18229,-3562
2019,1,21,1,20202,21543,17904,-3639
2019,1,21,2,19852,21138,17510,-3628
2019,1,21,3,19262,20510,17084,-3426
2019,1,21,4,18427,19712,16088,-3624
2019,1,21,5,17605,18835,15425,-3410
2019,1,21,6,17133,18118,14725,-3393
2019,1,21,7,16713,17748,14351,-3397
2019,1,21,8,16485,17573,14364,-3209
2019,1,21,9,16424,17540,14741,-2799
2019,1,21,10,16661,17821,15080,-2741
2019,1,21,11,17348,18487,15212,-3275
2019,1,21,12,18492,19643,17011,-2632
2019,1,21,13,19543,20724,18301,-2423
2019,1,21,14,20391,21649,18965,-2684
2019,1,21,15,21050,22349,18820,-3529
2019,1,21,16,21427,22826,19882,-2944
2019,1,21,17,21471,23072,20698,-2374
2019,1,21,18,21344,23061,20106,-2955
2019,1,21,19,21255,22952,19833,-3119
2019,1,21,20,21163,22877,20001,-2876
2019,1,21,21,21186,22924,19496,-3428
2019,1,21,22,21705,23487,20957,-2530
2019,1,21,23,22932,24615,21601,-3014
2019,1,22,0,23089,24728,22000,-2728
2019,1,22,1,22673,24269,21990,-2279
2019,1,22,2,22006,23639,21337,-2302
2019,1,22,3,21047,22581,19747,-2834
2019,1,22,4,19751,21174,18503,-2671
2019,1,22,5,18491,19885,16617,-3268
2019,1,22,6,17748,19013,15534,-3479
2019,1,22,7,17255,18482,14913,-3569
2019,1,22,8,17011,18201,15876,-2325
2019,1,22,9,16961,18110,16107,-2003
2019,1,22,10,17221,18332,16705,-1627
2019,1,22,11,18084,19213,17363,-1850
2019,1,22,12,19722,20789,19334,-1455
2019,1,22,13,20938,21909,20869,-1040
2019,1,22,14,21270,22260,20673,-1587
2019,1,22,15,21390,22338,19866,-2472
2019,1,22,16,21377,22221,19310,-2911
2019,1,22,17,21218,21984,19109,-2875
2019,1,22,18,20986,21608,18672,-2936
2019,1,22,19,20840,21523,18402,-3121
2019,1,22,20,20690,21387,17601,-3786
2019,1,22,21,20720,21503,17750,-3753
2019,1,22,22,21158,22022,18732,-3290
2019,1,22,23,22284,23114,20516,-2598
2019,1,23,0,22498,23135,21060,-2075
2019,1,23,1,22110,22761,20460,-2301
2019,1,23,2,21508,22082,19105,-2977
2019,1,23,3,20594,21005,17244,-3761
2019,1,23,4,19319,19574,15852,-3722
2019,1,23,5,17973,18303,14870,-3433
2019,1,23,6,16553,17409,13584,-3825
2019,1,23,7,15972,16903,13050,-3853
2019,1,23,8,15679,16591,12667,-3924
2019,1,23,9,15572,16427,12323,-4104
2019,1,23,10,15762,16631,13012,-3619
2019,1,23,11,16549,17499,13890,-3609
2019,1,23,12,18086,19103,15659,-3444
2019,1,23,13,19280,20246,17481,-2765
2019,1,23,14,19691,20656,17498,-3158
2019,1,23,15,19943,20923,17250,-3673
2019,1,23,16,20064,21067,17777,-3290
2019,1,23,17,20047,21009,17777,-3232
2019,1,23,18,19938,20834,17134,-3700
2019,1,23,19,19878,20597,16678,-3919
2019,1,23,20,19780,20430,16599,-3831
2019,1,23,21,19823,20404,16675,-3729
2019,1,23,22,20185,20778,17320,-3458
2019,1,23,23,21000,21504,18166,-3338
2019,1,24,0,20929,21379,18027,-3352
2019,1,24,1,20433,20925,17552,-3373
2019,1,24,2,19789,20213,16956,-3257
2019,1,24,3,18920,19199,15691,-3508
2019,1,24,4,17721,17909,14605,-3304
2019,1,24,5,16447,16571,13229,-3342
2019,1,24,6,14955,15669,12975,-2694
2019,1,24,7,14322,15113,12501,-2612
2019,1,24,8,13996,14743,12032,-2711
2019,1,24,9,13873,14658,11859,-2799
2019,1,24,10,14061,14849,11877,-2972
2019,1,24,11,14849,15715,12727,-2988
2019,1,24,12,16423,17350,14330,-3020
2019,1,24,13,17684,18675,15535,-3140
2019,1,24,14,18180,19119,15463,-3656
2019,1,24,15,18521,19478,15577,-3901
2019,1,24,16,18715,19787,15509,-4278
2019,1,24,17,18808,19894,15595,-4299
2019,1,24,18,18774,19906,15862,-4044
2019,1,24,19,18764,19915,15817,-4098
2019,1,24,20,18721,19843,15949,-3894
2019,1,24,21,18811,19859,16169,-3690
2019,1,24,22,19232,20190,16548,-3642
2019,1,24,23,20229,20804,17579,-3225
2019,1,25,0,20360,20899,17839,-3060
2019,1,25,1,19994,20538,17416,-3122
2019,1,25,2,19443,19970,16926,-3044
2019,1,25,3,18683,19092,15884,-3208
2019,1,25,4,17591,17987,15174,-2813
2019,1,25,5,16460,16833,13959,-2874
2019,1,25,6,15542,16041,12912,-3129
2019,1,25,7,14987,15571,12581,-2990
2019,1,25,8,14675,15292,12424,-2868
2019,1,25,9,14575,15218,12301,-2917
2019,1,25,10,14812,15466,12464,-3002
2019,1,25,11,15684,16379,13110,-3269
2019,1,25,12,17371,17984,15190,-2794
2019,1,25,13,18676,19219,16968,-2251
2019,1,25,14,19150,19627,17013,-2614
2019,1,25,15,19411,19767,16773,-2994
2019,1,25,16,19497,19683,17140,-2543
2019,1,25,17,19476,19512,17149,-2363
2019,1,25,18,19304,19297,16807,-2490
2019,1,25,19,19191,19292,16933,-2359
2019,1,25,20,19080,19395,17190,-2205
2019,1,25,21,19127,19583,17666,-1917
2019,1,25,22,19546,20156,18290,-1866
2019,1,25,23,20619,21122,18925,-2197
2019,1,26,0,20790,21209,19001,-2208
2019,1,26,1,20361,20818,18742,-2076
2019,1,26,2,19751,20308,18666,-1642
2019,1,26,3,19032,19627,17864,-1763
2019,1,26,4,18039,18700,16593,-2107
2019,1,26,5,17004,17665,15516,-2149
2019,1,26,6,16528,16898,13746,-3152
2019,1,26,7,15971,16432,13296,-3136
2019,1,26,8,15615,16110,13166,-2944
2019,1,26,9,15445,16003,12937,-3066
2019,1,26,10,15499,16066,13251,-2815
2019,1,26,11,15835,16408,13524,-2884
2019,1,26,12,16482,17150,14230,-2920
2019,1,26,13,17165,17895,15158,-2737
2019,1,26,14,17822,18531,15635,-2896
2019,1,26,15,18354,18922,15866,-3056
2019,1,26,16,18605,18857,15563,-3294
2019,1,26,17,18615,18698,15159,-3539
2019,1,26,18,18449,18460,14673,-3787
2019,1,26,19,18206,18255,14533,-3722
2019,1,26,20,18030,18201,14444,-3757
2019,1,26,21,18043,18401,14727,-3674
2019,1,26,22,18478,18988,15519,-3469
2019,1,26,23,19653,19995,16270,-3725
2019,1,27,0,20068,20227,16405,-3822
2019,1,27,1,19792,19884,16328,-3556
2019,1,27,2,19303,19466,16136,-3330
2019,1,27,3,18699,18908,15819,-3089
2019,1,27,4,17866,18138,14533,-3605
2019,1,27,5,16938,17274,13506,-3768
2019,1,27,6,15957,16465,12885,-3580
2019,1,27,7,15412,15951,12100,-3851
2019,1,27,8,15081,15635,12180,-3455
2019,1,27,9,14905,15470,12052,-3418
2019,1,27,10,14921,15459,11666,-3793
2019,1,27,11,15143,15650,11952,-3698
2019,1,27,12,15585,16064,12681,-3383
2019,1,27,13,16024,16605,13853,-2752
2019,1,27,14,16529,17096,14004,-3092
2019,1,27,15,16995,17462,14056,-3406
2019,1,27,16,17255,17679,14279,-3400
2019,1,27,17,17376,17782,14452,-3330
2019,1,27,18,17360,17867,14090,-3777
2019,1,27,19,17265,17855,14032,-3823
2019,1,27,20,17201,17892,13981,-3911
2019,1,27,21,17307,18111,14241,-3870
2019,1,27,22,17811,18716,14496,-4220
2019,1,27,23,19012,19752,15595,-4157
2019,1,28,0,19493,19972,15783,-4189
2019,1,28,1,19350,19680,15523,-4157
2019,1,28,2,18982,19176,15044,-4132
2019,1,28,3,18365,18410,14462,-3948
2019,1,28,4,17478,17405,13567,-3838
2019,1,28,5,16538,16430,12637,-3793
2019,1,28,6,15923,15764,12066,-3698
2019,1,28,7,15465,15421,11989,-3432
2019,1,28,8,15233,15273,11986,-3287
2019,1,28,9,15200,15336,12374,-2962
2019,1,28,10,15522,15699,12974,-2725
2019,1,28,11,16516,16759,13595,-3164
2019,1,28,12,18306,18594,15403,-3191
2019,1,28,13,19680,19845,17279,-2566
2019,1,28,14,20201,20295,17096,-3199
2019,1,28,15,20478,20433,16439,-3994
2019,1,28,16,20574,20373,15928,-4445
2019,1,28,17,20443,20277,15609,-4668
2019,1,28,18,20237,20171,15435,-4736
2019,1,28,19,20100,20099,15337,-4762
2019,1,28,20,19969,20045,15469,-4576
2019,1,28,21,20016,20255,15937,-4318
2019,1,28,22,20495,20793,17304,-3489
2019,1,28,23,21678,21908,18444,-3464
2019,1,29,0,22001,22163,18705,-3458
2019,1,29,1,21616,21923,18419,-3504
2019,1,29,2,20919,21324,18181,-3143
2019,1,29,3,19914,20397,16955,-3442
2019,1,29,4,18534,19056,15582,-3474
2019,1,29,5,17130,17758,14095,-3663
2019,1,29,6,16204,16888,12982,-3906
2019,1,29,7,15696,16425,12917,-3508
2019,1,29,8,15433,16131,12978,-3153
2019,1,29,9,15355,16078,13031,-3047
2019,1,29,10,15597,16316,13357,-2959
2019,1,29,11,16436,17245,14329,-2916
2019,1,29,12,18016,18920,16276,-2644
2019,1,29,13,19208,20108,17509,-2599
2019,1,29,14,19635,20620,17450,-3170
2019,1,29,15,19867,20945,17353,-3592
2019,1,29,16,19961,21006,17021,-3985
2019,1,29,17,19952,20956,17025,-3931
2019,1,29,18,19842,20863,16802,-4061
2019,1,29,19,19775,20848,16823,-4025
2019,1,29,20,19684,20668,16728,-3940
2019,1,29,21,19718,20732,16881,-3851
2019,1,29,22,20099,21177,17154,-4023
2019,1,29,23,20992,21968,17904,-4064
2019,1,30,0,21194,21905,17896,-4009
2019,1,30,1,20825,21443,17532,-3911
2019,1,30,2,20184,20817,17238,-3579
2019,1,30,3,19302,19846,16197,-3649
2019,1,30,4,18108,18537,15018,-3519
2019,1,30,5,16945,17283,13807,-3476
2019,1,30,6,16486,16506,13476,-3030
2019,1,30,7,15937,16119,13520,-2599
2019,1,30,8,15613,15935,12884,-3051
2019,1,30,9,15519,16005,13121,-2884
2019,1,30,10,15788,16417,13575,-2842
2019,1,30,11,16719,17392,14912,-2480
2019,1,30,12,18489,19128,16527,-2601
2019,1,30,13,19864,20430,18682,-1748
2019,1,30,14,20419,20817,18631,-2186
2019,1,30,15,20706,20906,18027,-2879
2019,1,30,16,20815,20877,17707,-3170
2019,1,30,17,20866,20765,17508,-3257
2019,1,30,18,20744,20697,17198,-3499
2019,1,30,19,20678,20758,16998,-3760
2019,1,30,20,20601,21091,17479,-3612
2019,1,30,21,20682,21617,18193,-3424
2019,1,30,22,21196,22365,18800,-3565
2019,1,30,23,22480,23469,19540,-3929
2019,1,31,0,22977,24062,20054,-4008
2019,1,31,1,22687,23880,19892,-3988
2019,1,31,2,22090,23338,19423,-3915
2019,1,31,3,21191,22525,18636,-3889
2019,1,31,4,19886,21319,17791,-3528
2019,1,31,5,18573,20163,16409,-3754
2019,1,31,6,18089,19378,15846,-3532
2019,1,31,7,17617,18989,15610,-3379
2019,1,31,8,17354,18745,15656,-3089
2019,1,31,9,17302,18702,16207,-2495
2019,1,31,10,17586,18917,16834,-2083
2019,1,31,11,18474,19750,16902,-2848
2019,1,31,12,20105,21275,18786,-2489
2019,1,31,13,21338,22529,20342,-2187
2019,1,31,14,21796,23056,20303,-2753
2019,1,31,15,22009,23172,19878,-3294
2019,1,31,16,22052,23031,19283,-3748
2019,1,31,17,21901,22815,18555,-4260
2019,1,31,18,21669,22608,18705,-3903
2019,1,31,19,21523,22455,18631,-3824
2019,1,31,20,21387,22368,18624,-3744
2019,1,31,21,21410,22519,18706,-3813
2019,1,31,22,21836,23067,20028,-3039
2019,1,31,23,22958,24206,21238,-2968
2019,2,1,0,23385,24580,21377,-3203
2019,2,1,1,23093,24246,21144,-3102
2019,2,1,2,22498,23640,20204,-3436
2019,2,1,3,21608,22694,19644,-3050
2019,2,1,4,20360,21378,18191,-3187
2019,2,1,5,19077,20142,16397,-3745
2019,2,1,6,18214,19374,15769,-3605
2019,2,1,7,17733,18938,15781,-3157
2019,2,1,8,17485,18629,15577,-3052
2019,2,1,9,17438,18548,15275,-3273
2019,2,1,10,17652,18780,15520,-3260
2019,2,1,11,18457,19666,16459,-3207
2019,2,1,12,20044,21360,18223,-3137
2019,2,1,13,21175,22454,19353,-3101
2019,2,1,14,21595,22661,19376,-3285
2019,2,1,15,21792,22671,18270,-4401
2019,2,1,16,21812,22578,18043,-4535
2019,2,1,17,21667,22416,18085,-4331
2019,2,1,18,21417,22003,17744,-4259
2019,2,1,19,21233,21647,17616,-4031
2019,2,1,20,21034,21524,17531,-3993
2019,2,1,21,21013,21615,17727,-3888
2019,2,1,22,21279,22082,17668,-4414
2019,2,1,23,22187,22949,18401,-4548
2019,2,2,0,22517,23158,18823,-4335
2019,2,2,1,22105,22811,18827,-3984
2019,2,2,2,21594,22289,18642,-3647
2019,2,2,3,20904,21586,17583,-4003
2019,2,2,4,19933,20606,16462,-4144
2019,2,2,5,18876,19606,15650,-3956
2019,2,2,6,17891,18749,14258,-4491
2019,2,2,7,17302,18258,13869,-4389
2019,2,2,8,16961,17932,14020,-3912
2019,2,2,9,16795,17768,13824,-3944
2019,2,2,10,16802,17788,13569,-4219
2019,2,2,11,17083,18170,14100,-4070
2019,2,2,12,17713,18853,14645,-4208
2019,2,2,13,18276,19527,15604,-3923
2019,2,2,14,18869,20170,16363,-3807
2019,2,2,15,19329,20426,15941,-4485
2019,2,2,16,19528,20450,16585,-3865
2019,2,2,17,19448,20187,16331,-3856
2019,2,2,18,19245,19968,16004,-3964
2019,2,2,19,18982,19662,15943,-3719
2019,2,2,20,18762,19463,15936,-3527
2019,2,2,21,18735,19448,16012,-3436
2019,2,2,22,19017,19840,16533,-3307
2019,2,2,23,19951,20685,17207,-3478
2019,2,3,0,20392,20870,17338,-3532
2019,2,3,1,20070,20471,16749,-3722
2019,2,3,2,19676,19978,16239,-3739
2019,2,3,3,19115,19291,14897,-4394
2019,2,3,4,18315,18365,14082,-4283
2019,2,3,5,17382,17487,13065,-4422
2019,2,3,6,16017,16610,12943,-3667
2019,2,3,7,15382,16025,12595,-3430
2019,2,3,8,15027,15685,12086,-3599
2019,2,3,9,14843,15478,11917,-3561
2019,2,3,10,14816,15478,11994,-3484
2019,2,3,11,15020,15692,12113,-3579
2019,2,3,12,15509,16151,12732,-3419
2019,2,3,13,15917,16642,13840,-2802
2019,2,3,14,16466,17255,14277,-2978
2019,2,3,15,16976,17637,14392,-3245
2019,2,3,16,17275,17730,14513,-3217
2019,2,3,17,17346,17694,14624,-3070
2019,2,3,18,17309,17495,14540,-2955
2019,2,3,19,17188,17305,14243,-3062
2019,2,3,20,17089,17199,14152,-3047
2019,2,3,21,17190,17439,14229,-3210
2019,2,3,22,17627,18103,15381,-2722
2019,2,3,23,18723,19080,16400,-2680
2019,2,4,0,19276,19221,16361,-2860
2019,2,4,1,19041,18675,15629,-3046
2019,2,4,2,18686,18260,15226,-3034
2019,2,4,3,18034,17736,14774,-2962
2019,2,4,4,17083,16976,13955,-3021
2019,2,4,5,16062,15967,12974,-2993
2019,2,4,6,14771,15150,12201,-2949
2019,2,4,7,14284,14714,11935,-2779
2019,2,4,8,14046,14473,11363,-3110
2019,2,4,9,13995,14393,11429,-2964
2019,2,4,10,14239,14682,11880,-2802
2019,2,4,11,15134,15650,13069,-2581
2019,2,4,12,16834,17360,14299,-3061
2019,2,4,13,18006,18473,15612,-2861
2019,2,4,14,18405,18643,15474,-3169
2019,2,4,15,18581,18560,15326,-3234
2019,2,4,16,18620,18374,14979,-3395
2019,2,4,17,18450,18118,14554,-3564
2019,2,4,18,18249,17941,14113,-3828
2019,2,4,19,18121,17826,13994,-3832
2019,2,4,20,17995,17821,14475,-3346
2019,2,4,21,18066,17984,14650,-3334
2019,2,4,22,18441,18437,15479,-2958
2019,2,4,23,19399,19487,15992,-3495
2019,2,5,0,19792,19898,16754,-3144
2019,2,5,1,19433,19605,16138,-3467
2019,2,5,2,18900,18996,15858,-3138
2019,2,5,3,18050,18069,15194,-2875
2019,2,5,4,16852,16830,13821,-3009
2019,2,5,5,15643,15660,13020,-2640
2019,2,5,6,14530,14834,12100,-2734
2019,2,5,7,14011,14358,11569,-2789
2019,2,5,8,13727,14044,11676,-2368
2019,2,5,9,13648,13964,11390,-2574
2019,2,5,10,13866,14205,11965,-2240
2019,2,5,11,14726,15125,12768,-2357
2019,2,5,12,16410,16828,14007,-2821
2019,2,5,13,17554,17912,15237,-2675
2019,2,5,14,17936,18293,15642,-2651
2019,2,5,15,18093,18464,15801,-2663
2019,2,5,16,18127,18497,15630,-2867
2019,2,5,17,17992,18260,15435,-2825
2019,2,5,18,17837,18008,15062,-2946
2019,2,5,19,17751,17919,15088,-2831
2019,2,5,20,17672,17940,15091,-2849
2019,2,5,21,17777,18154,15599,-2555
2019,2,5,22,18178,18653,16141,-2512
2019,2,5,23,19152,19567,16481,-3086
2019,2,6,0,19603,19841,16273,-3568
2019,2,6,1,19289,19520,16348,-3172
2019,2,6,2,18810,18963,15623,-3340
2019,2,6,3,18030,18086,14892,-3194
2019,2,6,4,16895,17029,13997,-3032
2019,2,6,5,15793,15887,12714,-3173
2019,2,6,6,15194,15073,11866,-3207
2019,2,6,7,14693,14652,11715,-2937
2019,2,6,8,14384,14439,11391,-3048
2019,2,6,9,14294,14458,11801,-2657
2019,2,6,10,14526,14769,11945,-2824
2019,2,6,11,15460,15757,13027,-2730
2019,2,6,12,17283,17565,15225,-2340
2019,2,6,13,18507,18617,16133,-2484
2019,2,6,14,18909,18801,16182,-2619
2019,2,6,15,19056,18762,16060,-2702
2019,2,6,16,19052,18716,16076,-2640
2019,2,6,17,18934,18780,16084,-2696
2019,2,6,18,18724,18757,16088,-2669
2019,2,6,19,18602,18921,16492,-2429
2019,2,6,20,18471,19067,16543,-2524
2019,2,6,21,18535,19306,16697,-2609
2019,2,6,22,18920,19812,17580,-2232
2019,2,6,23,19857,20528,18115,-2413
2019,2,7,0,20295,20594,18115,-2479
2019,2,7,1,19891,20189,18098,-2091
2019,2,7,2,19285,19525,17479,-2046
2019,2,7,3,18365,18587,16446,-2141
2019,2,7,4,17078,17394,14642,-2752
2019,2,7,5,15814,16146,13579,-2567
2019,2,7,6,14910,15305,12732,-2573
2019,2,7,7,14391,14838,12548,-2290
2019,2,7,8,14092,14573,12172,-2401
2019,2,7,9,13998,14517,12179,-2338
2019,2,7,10,14211,14753,12232,-2521
2019,2,7,11,15093,15653,13206,-2447
2019,2,7,12,16811,17389,15085,-2304
2019,2,7,13,17982,18557,15962,-2595
2019,2,7,14,18419,18926,15851,-3075
2019,2,7,15,18655,19178,15875,-3303
2019,2,7,16,18742,19272,16510,-2762
2019,2,7,17,18652,19215,16418,-2797
2019,2,7,18,18502,19111,16265,-2846
2019,2,7,19,18414,19030,16155,-2875
2019,2,7,20,18287,18941,16185,-2756
2019,2,7,21,18322,19043,16233,-2810
2019,2,7,22,18631,19440,16722,-2718
2019,2,7,23,19401,20143,17486,-2657
2019,2,8,0,19739,20235,17547,-2688
2019,2,8,1,19341,19831,17121,-2710
2019,2,8,2,18754,19188,16582,-2606
2019,2,8,3,17894,18238,15796,-2442
2019,2,8,4,16711,16965,14506,-2459
2019,2,8,5,15543,15761,13641,-2120
2019,2,8,6,14720,14965,13649,-1316
2019,2,8,7,14190,14460,13470,-990
2019,2,8,8,13877,14188,13391,-797
2019,2,8,9,13769,14155,13077,-1078
2019,2,8,10,13961,14396,13394,-1002
2019,2,8,11,14777,15290,13869,-1421
2019,2,8,12,16392,17018,15420,-1598
2019,2,8,13,17553,18234,16464,-1770
2019,2,8,14,18080,18830,16756,-2074
2019,2,8,15,18388,19112,16905,-2207
2019,2,8,16,18526,19292,17120,-2172
2019,2,8,17,18455,19223,16930,-2293
2019,2,8,18,18326,19023,16714,-2309
2019,2,8,19,18249,18749,16127,-2622
2019,2,8,20,18161,18532,16201,-2331
2019,2,8,21,18215,18715,16360,-2355
2019,2,8,22,18529,19246,16530,-2716
2019,2,8,23,19345,20091,16662,-3429
2019,2,9,0,19770,20427,16977,-3450
2019,2,9,1,19400,20120,16704,-3416
2019,2,9,2,18893,19741,16476,-3265
2019,2,9,3,18253,19138,16068,-3070
2019,2,9,4,17374,18292,15372,-2920
2019,2,9,5,16459,17340,14519,-2821
2019,2,9,6,16100,16627,14069,-2558
2019,2,9,7,15521,16173,13727,-2446
2019,2,9,8,15147,15916,13666,-2250
2019,2,9,9,14968,15850,13576,-2274
2019,2,9,10,15005,15920,13616,-2304
2019,2,9,11,15343,16291,14156,-2135
2019,2,9,12,16027,16989,14984,-2005
2019,2,9,13,16636,17735,15842,-1893
2019,2,9,14,17364,18367,16062,-2305
2019,2,9,15,17912,18722,15789,-2933
2019,2,9,16,18162,18893,15878,-3015
2019,2,9,17,18065,18848,15851,-2997
2019,2,9,18,17849,18584,15632,-2952
2019,2,9,19,17573,18351,15538,-2813
2019,2,9,20,17383,18265,15426,-2839
2019,2,9,21,17400,18362,15548,-2814
2019,2,9,22,17787,18878,16206,-2672
2019,2,9,23,18868,19767,17160,-2607
2019,2,10,0,19621,20275,17422,-2853
2019,2,10,1,19397,20067,17342,-2725
2019,2,10,2,18999,19691,17385,-2306
2019,2,10,3,18420,19169,16605,-2564
2019,2,10,4,17601,18381,15642,-2739
2019,2,10,5,16730,17513,14633,-2880
2019,2,10,6,16184,16767,14185,-2582
2019,2,10,7,15687,16276,13986,-2290
2019,2,10,8,15369,15976,13681,-2295
2019,2,10,9,15212,15790,13460,-2330
2019,2,10,10,15222,15818,13362,-2456
2019,2,10,11,15444,16075,13638,-2437
2019,2,10,12,15888,16570,13975,-2595
2019,2,10,13,16219,17030,14633,-2397
2019,2,10,14,16750,17470,15355,-2115
2019,2,10,15,17206,17645,15121,-2524
2019,2,10,16,17444,17706,15076,-2630
2019,2,10,17,17523,17701,15216,-2485
2019,2,10,18,17451,17770,15238,-2532
2019,2,10,19,17303,17703,14888,-2815
2019,2,10,20,17180,17691,14899,-2792
2019,2,10,21,17236,17841,15214,-2627
2019,2,10,22,17647,18472,16272,-2200
2019,2,10,23,18676,19604,17087,-2517
2019,2,11,0,19471,20051,17586,-2465
2019,2,11,1,19351,19794,17205,-2589
2019,2,11,2,18990,19317,16981,-2336
2019,2,11,3,18317,18583,16067,-2516
2019,2,11,4,17395,17623,15085,-2538
2019,2,11,5,16442,16585,13994,-2591
2019,2,11,6,15547,15825,12661,-3164
2019,2,11,7,15126,15403,12132,-3271
2019,2,11,8,14921,15179,12080,-3099
2019,2,11,9,14897,15142,12224,-2918
2019,2,11,10,15169,15439,12592,-2847
2019,2,11,11,16069,16346,13552,-2794
2019,2,11,12,17702,18113,15452,-2661
2019,2,11,13,18864,19420,16701,-2719
2019,2,11,14,19378,19876,17064,-2812
2019,2,11,15,19657,20029,16940,-3089
2019,2,11,16,19759,20038,16536,-3502
2019,2,11,17,19665,19921,16634,-3287
2019,2,11,18,19510,19723,16219,-3504
2019,2,11,19,19402,19633,16010,-3623
2019,2,11,20,19270,19512,16109,-3403
2019,2,11,21,19280,19646,16392,-3254
2019,2,11,22,19606,20138,17123,-3015
2019,2,11,23,20461,21000,17671,-3329
2019,2,12,0,21046,21367,18330,-3037
2019,2,12,1,20776,21050,17872,-3178
2019,2,12,2,20212,20433,17539,-2894
2019,2,12,3,19329,19551,16966,-2585
2019,2,12,4,18139,18328,15223,-3105
2019,2,12,5,16956,17121,14192,-2929
2019,2,12,6,16058,16318,12772,-3546
2019,2,12,7,15554,15881,12550,-3331
2019,2,12,8,15285,15642,12538,-3104
2019,2,12,9,15214,15623,12420,-3203
2019,2,12,10,15453,15935,12709,-3226
2019,2,12,11,16326,16805,13733,-3072
2019,2,12,12,17981,18373,15867,-2506
2019,2,12,13,19168,19588,17053,-2535
2019,2,12,14,19718,20296,17608,-2688
2019,2,12,15,20056,20881,17779,-3102
2019,2,12,16,20233,21297,17927,-3370
2019,2,12,17,20228,21502,18422,-3080
2019,2,12,18,20123,21504,18726,-2778
2019,2,12,19,20051,21475,18343,-3132
2019,2,12,20,19925,21345,18278,-3067
2019,2,12,21,19914,21288,18560,-2728
2019,2,12,22,20197,21474,19656,-1818
2019,2,12,23,20888,22146,20234,-1912
2019,2,13,0,21306,22186,20470,-1716
2019,2,13,1,20909,21608,19433,-2175
2019,2,13,2,20244,20858,18520,-2338
2019,2,13,3,19282,19748,17159,-2589
2019,2,13,4,18014,18427,15763,-2664
2019,2,13,5,16731,17161,14675,-2486
2019,2,13,6,15539,16246,13164,-3082
2019,2,13,7,14997,15763,12688,-3075
2019,2,13,8,14703,15492,12469,-3023
2019,2,13,9,14603,15396,12396,-3000
2019,2,13,10,14800,15634,12650,-2984
2019,2,13,11,15601,16489,13496,-2993
2019,2,13,12,17156,18031,15069,-2962
2019,2,13,13,18281,19057,16317,-2740
2019,2,13,14,18805,19519,16572,-2947
2019,2,13,15,19113,19562,16537,-3025
2019,2,13,16,19268,19512,16539,-2973
2019,2,13,17,19258,19523,16496,-3027
2019,2,13,18,19169,19533,16825,-2708
2019,2,13,19,19132,19644,17065,-2579
2019,2,13,20,19069,19754,17287,-2467
2019,2,13,21,19122,19882,17514,-2368
2019,2,13,22,19448,20196,17831,-2365
2019,2,13,23,20194,20977,18358,-2619
2019,2,14,0,20688,21405,18618,-2787
2019,2,14,1,20381,21113,18405,-2708
2019,2,14,2,19849,20561,17916,-2645
2019,2,14,3,19044,19607,16460,-3147
2019,2,14,4,17936,18368,15102,-3266
2019,2,14,5,16791,17131,13768,-3363
2019,2,14,6,15808,16331,12920,-3411
2019,2,14,7,15273,15857,12727,-3130
2019,2,14,8,14985,15572,12457,-3115
2019,2,14,9,14901,15504,12559,-2945
2019,2,14,10,15130,15787,12853,-2934
2019,2,14,11,16003,16711,14188,-2523
2019,2,14,12,17653,18412,16472,-1940
2019,2,14,13,18767,19423,17450,-1973
2019,2,14,14,19192,19702,17468,-2234
2019,2,14,15,19372,19582,17043,-2539
2019,2,14,16,19390,19354,16762,-2592
2019,2,14,17,19228,19022,16025,-2997
2019,2,14,18,19009,18727,15590,-3137
2019,2,14,19,18883,18605,15338,-3267
2019,2,14,20,18751,18486,15111,-3375
2019,2,14,21,18758,18561,15079,-3482
2019,2,14,22,19066,18998,16074,-2924
2019,2,14,23,19834,19866,16980,-2886
2019,2,15,0,20396,20365,17250,-3115
2019,2,15,1,20101,20050,17277,-2773
2019,2,15,2,19545,19535,16858,-2677
2019,2,15,3,18677,18697,16030,-2667
2019,2,15,4,17503,17560,14896,-2664
2019,2,15,5,16294,16379,13302,-3077
2019,2,15,6,15116,15480,12534,-2946
2019,2,15,7,0,14997,12110,-2887
2019,2,15,8,0,14712,12426,-2286
2019,2,15,9,0,14618,12282,-2336
2019,2,15,10,0,14832,12493,-2339
2019,2,15,11,0,15675,13166,-2509
2019,2,15,12,0,17265,15065,-2200
2019,2,15,13,0,18361,16338,-2023
2019,2,15,14,0,18874,16545,-2329
2019,2,15,15,0,19118,16590,-2528
2019,2,15,16,0,19251,16720,-2531
2019,2,15,17,0,19212,16750,-2462
2019,2,15,18,0,19020,16771,-2249
2019,2,15,19,0,18735,16607,-2128
2019,2,15,20,0,18455,16101,-2354
2019,2,15,21,0,18375,15912,-2463
2019,2,15,22,0,18715,16127,-2588
2019,2,15,23,0,19427,16686,-2741
2019,2,16,0,0,19647,17168,-2479
2019,2,16,1,0,19280,16881,-2399
2019,2,16,2,0,18724,16523,-2201
2019,2,16,3,0,17988,15931,-2057
2019,2,16,4,0,17039,14706,-2333
2019,2,16,5,0,16045,13728,-2317
2019,2,16,6,15327,15293,13181,-2112
2019,2,16,7,14707,14835,12886,-1949
2019,2,16,8,14327,14536,12770,-1766
2019,2,16,9,14143,14423,12562,-1861
2019,2,16,10,14188,14513,12849,-1664
2019,2,16,11,14540,14882,13063,-1819
2019,2,16,12,15192,15601,13639,-1962
2019,2,16,13,15800,16263,14633,-1630
2019,2,16,14,16591,16865,14891,-1974
2019,2,16,15,17192,17187,15007,-2180
2019,2,16,16,17474,17280,15015,-2265
2019,2,16,17,17421,17202,14612,-2590
2019,2,16,18,17255,17061,14452,-2609
2019,2,16,19,17023,16806,14255,-2551
2019,2,16,20,16866,16713,14270,-2443
2019,2,16,21,16865,16841,14596,-2245
2019,2,16,22,17222,17334,14950,-2384
2019,2,16,23,18155,18256,15997,-2259
2019,2,17,0,19010,18891,16490,-2401
2019,2,17,1,18839,18733,16537,-2196
2019,2,17,2,18410,18424,16162,-2262
2019,2,17,3,17816,17898,15282,-2616
2019,2,17,4,17025,17221,14076,-3145
2019,2,17,5,16188,16435,13313,-3122
2019,2,17,6,15815,15824,12731,-3093
2019,2,17,7,15306,15413,12456,-2957
2019,2,17,8,14970,15155,12319,-2836
2019,2,17,9,14796,15032,12260,-2772
2019,2,17,10,14797,15087,12306,-2781
2019,2,17,11,14979,15374,12466,-2908
2019,2,17,12,15275,15861,13274,-2587
2019,2,17,13,15535,16279,13743,-2536
2019,2,17,14,16157,16633,14010,-2623
2019,2,17,15,16686,16781,14135,-2646
2019,2,17,16,16970,16856,14083,-2773
2019,2,17,17,17102,16777,13816,-2961
2019,2,17,18,17042,16802,13726,-3076
2019,2,17,19,16891,16999,13806,-3193
2019,2,17,20,16775,17010,13807,-3203
2019,2,17,21,16802,17109,13983,-3126
2019,2,17,22,17197,17630,14840,-2790
2019,2,17,23,18160,18634,15730,-2904
2019,2,18,0,19112,19184,16331,-2853
2019,2,18,1,19040,18926,16373,-2553
2019,2,18,2,18646,18539,16020,-2519
2019,2,18,3,17950,17946,15244,-2702
2019,2,18,4,17035,17165,14124,-3041
2019,2,18,5,16109,16300,13333,-2967
2019,2,18,6,15306,15623,12366,-3257
2019,2,18,7,14900,15224,12172,-3052
2019,2,18,8,14663,14997,11964,-3033
2019,2,18,9,14571,14920,12055,-2865
2019,2,18,10,14721,15113,12002,-3111
2019,2,18,11,15294,15724,12402,-3322
2019,2,18,12,16234,16735,14006,-2729
2019,2,18,13,17017,17564,14992,-2572
2019,2,18,14,17751,18343,15339,-3004
2019,2,18,15,18278,19008,15906,-3102
2019,2,18,16,18609,19461,16646,-2815
2019,2,18,17,18747,19597,16527,-3070
2019,2,18,18,18687,19392,16376,-3016
2019,2,18,19,18584,19333,16162,-3171
2019,2,18,20,18467,19246,15960,-3286
2019,2,18,21,18437,19169,15780,-3389
2019,2,18,22,18682,19432,16436,-2996
2019,2,18,23,19385,20174,17116,-3058
2019,2,19,0,20042,20892,17793,-3099
2019,2,19,1,19787,20676,17468,-3208
2019,2,19,2,19249,20190,17151,-3039
2019,2,19,3,18532,19410,16276,-3134
2019,2,19,4,17564,18394,15093,-3301
2019,2,19,5,16610,17359,14337,-3022
2019,2,19,6,16173,16604,13361,-3243
2019,2,19,7,15719,16212,13151,-3061
2019,2,19,8,15470,16023,12985,-3038
2019,2,19,9,15419,15998,12973,-3025
2019,2,19,10,15685,16299,13068,-3231
2019,2,19,11,16579,17149,13869,-3280
2019,2,19,12,18198,18600,15820,-2780
2019,2,19,13,19309,19659,17006,-2653
2019,2,19,14,19755,20021,16803,-3218
2019,2,19,15,19916,20147,16664,-3483
2019,2,19,16,19905,20022,16438,-3584
2019,2,19,17,19742,19827,16177,-3650
2019,2,19,18,19513,19641,16146,-3495
2019,2,19,19,19374,19444,15869,-3575
2019,2,19,20,19246,19268,15815,-3453
2019,2,19,21,19241,19369,15987,-3382
2019,2,19,22,19575,19891,16189,-3702
2019,2,19,23,20416,20759,17200,-3559
2019,2,20,0,21203,21329,17597,-3732
2019,2,20,1,21009,21022,17014,-4008
2019,2,20,2,20467,20509,16742,-3767
2019,2,20,3,19573,19742,16069,-3673
2019,2,20,4,18362,18676,15063,-3613
2019,2,20,5,17151,17603,14487,-3116
2019,2,20,6,16324,16795,13298,-3497
2019,2,20,7,15832,16358,12977,-3381
2019,2,20,8,15560,16146,12733,-3413
2019,2,20,9,15489,16032,12643,-3389
2019,2,20,10,15722,16253,13097,-3156
2019,2,20,11,16582,17027,13935,-3092
2019,2,20,12,18157,18466,15557,-2909
2019,2,20,13,19270,19511,17215,-2296
2019,2,20,14,19765,20191,17479,-2712
2019,2,20,15,19996,20629,17710,-2919
2019,2,20,16,20048,20796,17594,-3202
2019,2,20,17,19998,20866,17495,-3371
2019,2,20,18,19834,20790,17407,-3383
2019,2,20,19,19738,20775,16789,-3986
2019,2,20,20,19604,20740,16546,-4194
2019,2,20,21,19558,20761,17226,-3535
2019,2,20,22,19811,20920,17709,-3211
2019,2,20,23,20437,21469,18947,-2522
2019,2,21,0,21070,21672,18897,-2775
2019,2,21,1,20796,21181,18523,-2658
2019,2,21,2,20183,20483,17815,-2668
2019,2,21,3,19255,19537,17014,-2523
2019,2,21,4,18046,18375,15689,-2686
2019,2,21,5,16771,17134,14643,-2491
2019,2,21,6,15214,16258,13752,-2506
2019,2,21,7,14663,15702,13611,-2091
2019,2,21,8,14385,15387,13324,-2063
2019,2,21,9,14294,15226,13187,-2039
2019,2,21,10,14500,15428,13542,-1886
2019,2,21,11,15291,16158,14196,-1962
2019,2,21,12,16752,17456,15615,-1841
2019,2,21,13,17794,18492,16734,-1758
2019,2,21,14,18254,19112,17092,-2020
2019,2,21,15,18482,19231,17197,-2034
2019,2,21,16,18547,19029,17111,-1918
2019,2,21,17,18417,18856,16919,-1937
2019,2,21,18,18269,18596,16311,-2285
2019,2,21,19,18198,18474,15923,-2551
2019,2,21,20,18123,18326,15764,-2562
2019,2,21,21,18129,18280,15906,-2374
2019,2,21,22,18405,18450,16145,-2305
2019,2,21,23,19033,18962,16589,-2373
2019,2,22,0,19645,19632,17241,-2391
2019,2,22,1,19443,19552,17158,-2394
2019,2,22,2,18958,19072,16795,-2277
2019,2,22,3,18187,18306,16239,-2067
2019,2,22,4,17157,17207,14741,-2466
2019,2,22,5,16079,16130,13801,-2329
2019,2,22,6,15053,15331,13221,-2110
2019,2,22,7,14493,14908,12864,-2044
2019,2,22,8,14195,14629,12665,-1964
2019,2,22,9,14104,14579,12613,-1966
2019,2,22,10,14339,14812,12825,-1987
2019,2,22,11,15210,15606,13723,-1883
2019,2,22,12,16802,17009,15049,-1960
2019,2,22,13,17943,18011,16106,-1905
2019,2,22,14,18475,18531,16320,-2211
2019,2,22,15,18732,18766,16453,-2313
2019,2,22,16,18780,18831,16638,-2193
2019,2,22,17,18646,18765,16589,-2176
2019,2,22,18,18433,18628,16091,-2537
2019,2,22,19,18299,18518,15554,-2964
2019,2,22,20,18162,18442,15466,-2976
2019,2,22,21,18104,18463,15340,-3123
2019,2,22,22,18335,18802,15789,-3013
2019,2,22,23,18933,19348,16561,-2787
2019,2,23,0,19587,19713,16869,-2844
2019,2,23,1,19305,19356,16570,-2786
2019,2,23,2,18718,18864,16284,-2580
2019,2,23,3,17957,18203,15213,-2990
2019,2,23,4,17009,17334,14242,-3092
2019,2,23,5,15985,16411,12959,-3452
2019,2,23,6,15202,15633,11923,-3710
2019,2,23,7,14635,15162,11675,-3487
2019,2,23,8,14289,14858,11344,-3514
2019,2,23,9,14122,14725,11413,-3312
2019,2,23,10,14182,14809,11576,-3233
2019,2,23,11,14527,15172,12137,-3035
2019,2,23,12,15092,15804,12950,-2854
2019,2,23,13,15617,16336,14032,-2304
2019,2,23,14,16306,16890,14203,-2687
2019,2,23,15,16780,17172,14218,-2954
2019,2,23,16,16937,17302,14425,-2877
2019,2,23,17,16872,17279,14283,-2996
2019,2,23,18,16657,17184,13904,-3280
2019,2,23,19,16399,17063,13748,-3315
2019,2,23,20,16211,17030,13698,-3332
2019,2,23,21,16131,17087,13799,-3288
2019,2,23,22,16392,17437,14420,-3017
2019,2,23,23,17106,18177,15520,-2657
2019,2,24,0,18037,18643,16250,-2393
2019,2,24,1,17933,18408,16177,-2231
2019,2,24,2,17474,18014,15575,-2439
2019,2,24,3,16841,17473,14859,-2614
2019,2,24,4,16083,16649,13670,-2979
2019,2,24,5,15230,15824,12721,-3103
2019,2,24,6,14386,15155,12237,-2918
2019,2,24,7,13846,14688,11926,-2762
2019,2,24,8,13510,14324,11943,-2381
2019,2,24,9,13332,14143,12013,-2130
2019,2,24,10,13333,14126,12116,-2010
2019,2,24,11,13547,14338,12266,-2072
2019,2,24,12,13897,14825,12650,-2175
2019,2,24,13,14263,15279,13360,-1919
2019,2,24,14,14914,16054,13639,-2415
2019,2,24,15,15486,16712,14178,-2534
2019,2,24,16,15824,17142,15110,-2032
2019,2,24,17,15964,17171,15371,-1800
2019,2,24,18,15993,17222,15469,-1753
2019,2,24,19,15941,17290,15352,-1938
2019,2,24,20,15886,17302,14974,-2328
2019,2,24,21,15903,17439,15406,-2033
2019,2,24,22,16235,17815,16182,-1633
2019,2,24,23,16924,18388,16528,-1860
2019,2,25,0,17752,18859,16732,-2127
2019,2,25,1,17693,18634,16495,-2139
2019,2,25,2,17318,18183,16089,-2094
2019,2,25,3,16659,17518,15800,-1718
2019,2,25,4,15818,16602,14519,-2083
2019,2,25,5,14959,15759,13726,-2033
2019,2,25,6,14456,15103,12659,-2444
2019,2,25,7,13999,14706,12239,-2467
2019,2,25,8,13749,14544,12204,-2340
2019,2,25,9,13693,14568,12266,-2302
2019,2,25,10,13982,14952,12483,-2469
2019,2,25,11,14928,15971,13604,-2367
2019,2,25,12,16569,17556,15249,-2307
2019,2,25,13,17851,18636,16447,-2189
2019,2,25,14,18546,19209,16947,-2262
2019,2,25,15,18973,19456,17255,-2201
2019,2,25,16,19184,19623,17243,-2380
2019,2,25,17,19205,19553,17012,-2541
2019,2,25,18,19097,19423,16440,-2983
2019,2,25,19,19033,19416,16421,-2995
2019,2,25,20,18936,19408,16285,-3123
2019,2,25,21,18898,19521,16325,-3196
2019,2,25,22,19210,19995,16651,-3344
2019,2,25,23,19943,20788,17455,-3333
2019,2,26,0,20787,21512,18441,-3071
2019,2,26,1,20587,21265,18574,-2691
2019,2,26,2,19957,20704,18306,-2398
2019,2,26,3,18961,19814,17690,-2124
2019,2,26,4,17684,18570,15880,-2690
2019,2,26,5,16423,17474,14955,-2519
2019,2,26,6,15775,16665,13764,-2901
2019,2,26,7,15311,16247,13221,-3026
2019,2,26,8,15062,15995,12919,-3076
2019,2,26,9,15009,15972,12780,-3192
2019,2,26,10,15270,16257,13161,-3096
2019,2,26,11,16130,17208,14294,-2914
2019,2,26,12,17648,18764,16406,-2358
2019,2,26,13,18763,19694,17713,-1981
2019,2,26,14,19273,19829,17110,-2719
2019,2,26,15,19507,19786,16795,-2991
2019,2,26,16,19559,19663,16895,-2768
2019,2,26,17,19454,19526,16507,-3019
2019,2,26,18,19271,19356,16237,-3119
2019,2,26,19,19165,19329,16128,-3201
2019,2,26,20,19063,19259,16032,-3227
2019,2,26,21,19036,19477,16460,-3017
2019,2,26,22,19345,20011,17042,-2969
2019,2,26,23,20062,20825,18275,-2550
2019,2,27,0,20918,21609,19060,-2549
2019,2,27,1,20774,21480,18746,-2734
2019,2,27,2,20230,20967,18194,-2773
2019,2,27,3,19336,20139,17246,-2893
2019,2,27,4,18167,18927,15789,-3138
2019,2,27,5,17010,17761,14536,-3225
2019,2,27,6,16354,16951,13385,-3566
2019,2,27,7,15887,16510,12868,-3642
2019,2,27,8,15632,16256,13012,-3244
2019,2,27,9,15570,16202,13346,-2856
2019,2,27,10,15820,16505,13677,-2828
2019,2,27,11,16676,17442,14251,-3191
2019,2,27,12,18189,19012,16004,-3008
2019,2,27,13,19328,20069,17340,-2729
2019,2,27,14,19880,20502,16994,-3508
2019,2,27,15,20157,20659,16539,-4120
2019,2,27,16,20233,20703,16321,-4382
2019,2,27,17,20198,20732,16903,-3829
2019,2,27,18,20039,20577,16859,-3718
2019,2,27,19,19948,20556,16729,-3827
2019,2,27,20,19822,20648,16998,-3650
2019,2,27,21,19752,20710,17024,-3686
2019,2,27,22,19999,21112,17822,-3290
2019,2,27,23,20577,21709,19027,-2682
2019,2,28,0,21367,22163,19464,-2699
2019,2,28,1,21168,21846,19238,-2608
2019,2,28,2,20551,21179,18631,-2548
2019,2,28,3,19597,20253,17490,-2763
2019,2,28,4,18393,18959,15820,-3139
2019,2,28,5,17145,17693,14479,-3214
2019,2,28,6,15941,16830,13467,-3363
2019,2,28,7,15434,16362,13053,-3309
2019,2,28,8,15185,16144,12839,-3305
2019,2,28,9,15125,16040,12567,-3473
2019,2,28,10,15363,16281,12679,-3602
2019,2,28,11,16185,17189,13915,-3274
2019,2,28,12,17620,18791,15770,-3021
2019,2,28,13,18694,19756,17614,-2142
2019,2,28,14,19204,20081,17445,-2636
2019,2,28,15,19451,20175,16803,-3372
2019,2,28,16,19499,19985,16177,-3808
2019,2,28,17,19311,19684,16079,-3605
2019,2,28,18,19127,19426,15624,-3802
2019,2,28,19,19031,19244,15564,-3680
2019,2,28,20,18933,19102,15491,-3611
2019,2,28,21,18895,19246,15376,-3870
2019,2,28,22,19165,19739,15851,-3888
2019,2,28,23,19801,20507,16694,-3813
2019,3,1,0,20648,21291,17455,-3836
2019,3,1,1,20541,21132,17286,-3846
2019,3,1,2,20044,20669,17117,-3552
2019,3,1,3,19222,19834,16243,-3591
2019,3,1,4,18158,18617,14964,-3653
2019,3,1,5,17038,17433,13439,-3994
2019,3,1,6,15983,16600,12646,-3954
2019,3,1,7,15476,16115,12330,-3785
2019,3,1,8,15239,15852,12235,-3617
2019,3,1,9,15190,15793,12332,-3461
2019,3,1,10,15409,16059,12718,-3341
2019,3,1,11,16240,17031,13618,-3413
2019,3,1,12,17752,18677,15702,-2975
2019,3,1,13,18792,19697,17077,-2620
2019,3,1,14,19220,20132,17101,-3031
2019,3,1,15,19362,20201,17256,-2945
2019,3,1,16,19345,20003,16811,-3192
2019,3,1,17,19144,19714,16267,-3447
2019,3,1,18,18906,19351,16029,-3322
2019,3,1,19,18738,19163,16150,-3013
2019,3,1,20,18555,19026,15909,-3117
2019,3,1,21,18489,19065,15885,-3180
2019,3,1,22,18666,19357,16004,-3353
2019,3,1,23,19148,19883,16790,-3093
2019,3,2,0,19815,20284,17115,-3169
2019,3,2,1,19637,19929,17003,-2926
2019,3,2,2,19133,19495,16409,-3086
2019,3,2,3,18448,18780,15644,-3136
2019,3,2,4,17527,17800,14248,-3552
2019,3,2,5,16518,16780,13020,-3760
2019,3,2,6,15491,15953,12222,-3731
2019,3,2,7,14915,15464,11742,-3722
2019,3,2,8,14595,15181,11786,-3395
2019,3,2,9,14439,15059,12039,-3020
2019,3,2,10,14474,15128,12211,-2917
2019,3,2,11,14812,15482,12571,-2911
2019,3,2,12,15389,16141,13200,-2941
2019,3,2,13,15953,16790,14177,-2613
2019,3,2,14,16677,17602,15017,-2585
2019,3,2,15,17220,18089,15346,-2743
2019,3,2,16,17498,18344,15474,-2870
2019,3,2,17,17514,18346,15284,-3062
2019,3,2,18,17394,18217,15166,-3051
2019,3,2,19,17193,18049,15250,-2799
2019,3,2,20,17014,17794,14877,-2917
2019,3,2,21,16959,17668,14772,-2896
2019,3,2,22,17189,17915,15016,-2899
2019,3,2,23,17754,18531,15703,-2828
2019,3,3,0,18601,19122,16520,-2602
2019,3,3,1,18538,18921,16333,-2588
2019,3,3,2,18128,18501,15869,-2632
2019,3,3,3,17563,17908,15307,-2601
2019,3,3,4,16800,17130,14429,-2701
2019,3,3,5,15956,16266,13185,-3081
2019,3,3,6,15099,15513,12143,-3370
2019,3,3,7,14570,14991,11477,-3514
2019,3,3,8,14260,14674,11232,-3442
2019,3,3,9,14109,14560,11361,-3199
2019,3,3,10,14121,14569,11193,-3376
2019,3,3,11,14372,14841,11345,-3496
2019,3,3,12,14779,15257,12161,-3096
2019,3,3,13,15132,15716,13312,-2404
2019,3,3,14,15726,16275,13645,-2630
2019,3,3,15,16214,16638,13876,-2762
2019,3,3,16,16498,16823,13951,-2872
2019,3,3,17,16642,16762,13606,-3156
2019,3,3,18,16628,16630,13383,-3247
2019,3,3,19,16515,16708,13535,-3173
2019,3,3,20,16409,16990,13751,-3239
2019,3,3,21,16434,17402,14019,-3383
2019,3,3,22,16783,18051,14925,-3126
2019,3,3,23,17523,18909,15641,-3268
2019,3,4,0,18553,19534,16354,-3180
2019,3,4,1,18621,19400,16031,-3369
2019,3,4,2,18275,18994,15845,-3149
2019,3,4,3,17599,18236,15146,-3090
2019,3,4,4,16671,17212,13962,-3250
2019,3,4,5,15719,16239,12805,-3434
2019,3,4,6,14863,15580,11561,-4019
2019,3,4,7,14472,15193,11199,-3994
2019,3,4,8,14288,14932,11084,-3848
2019,3,4,9,14280,14895,10897,-3998
2019,3,4,10,14558,15172,11394,-3778
2019,3,4,11,15470,16068,12317,-3751
2019,3,4,12,17034,17551,14370,-3181
2019,3,4,13,18189,18614,15286,-3328
2019,3,4,14,18725,19326,16103,-3223
2019,3,4,15,18987,19623,16406,-3217
2019,3,4,16,19091,19654,16102,-3552
2019,3,4,17,18963,19546,15802,-3744
2019,3,4,18,18813,19372,15202,-4170
2019,3,4,19,18712,19272,15394,-3878
2019,3,4,20,18595,19156,15462,-3694
2019,3,4,21,18593,19160,15461,-3699
2019,3,4,22,18894,19543,15967,-3576
2019,3,4,23,19578,20297,16361,-3936
2019,3,5,0,20474,21169,17122,-4047
2019,3,5,1,20437,21008,17479,-3529
2019,3,5,2,19955,20466,17218,-3248
2019,3,5,3,19111,19596,16463,-3133
2019,3,5,4,17935,18360,14808,-3552
2019,3,5,5,16788,17266,13684,-3582
2019,3,5,6,16160,16498,13228,-3270
2019,3,5,7,15723,16191,12905,-3286
2019,3,5,8,15495,16021,12725,-3296
2019,3,5,9,15463,16042,12680,-3362
2019,3,5,10,15728,16366,13195,-3171
2019,3,5,11,16628,17347,13899,-3448
2019,3,5,12,18210,18962,15539,-3423
2019,3,5,13,19330,19887,16687,-3200
2019,3,5,14,19776,20000,16351,-3649
2019,3,5,15,19921,19996,15973,-4023
2019,3,5,16,19927,19943,15762,-4181
2019,3,5,17,19827,19782,15671,-4111
2019,3,5,18,19625,19504,15264,-4240
2019,3,5,19,19486,19388,14913,-4475
2019,3,5,20,19338,19344,14824,-4520
2019,3,5,21,19299,19520,14964,-4556
2019,3,5,22,19572,20030,15532,-4498
2019,3,5,23,20208,20779,16627,-4152
2019,3,6,0,21097,21639,17586,-4053
2019,3,6,1,21030,21565,17708,-3857
2019,3,6,2,20510,21096,17554,-3542
2019,3,6,3,19613,20175,16849,-3326
2019,3,6,4,18377,18920,15182,-3738
2019,3,6,5,17170,17781,14004,-3777
2019,3,6,6,16510,17064,13572,-3492
2019,3,6,7,16063,16686,13249,-3437
2019,3,6,8,15816,16495,12883,-3612
2019,3,6,9,15767,16466,12981,-3485
2019,3,6,10,15999,16789,13778,-3011
2019,3,6,11,16863,17798,15227,-2571
2019,3,6,12,18397,19410,16776,-2634
2019,3,6,13,19524,20283,17765,-2518
2019,3,6,14,20001,20479,17041,-3438
2019,3,6,15,20180,20451,16664,-3787
2019,3,6,16,20211,20447,16685,-3762
2019,3,6,17,20169,20399,16283,-4116
2019,3,6,18,19993,20263,15953,-4310
2019,3,6,19,19878,20237,16184,-4053
2019,3,6,20,19743,20150,16156,-3994
2019,3,6,21,19713,20302,16605,-3697
2019,3,6,22,19980,20753,16965,-3788
2019,3,6,23,20597,21440,17738,-3702
2019,3,7,0,21464,22257,18426,-3831
2019,3,7,1,21406,22204,18816,-3388
2019,3,7,2,20919,21732,18403,-3329
2019,3,7,3,20069,20837,17720,-3117
2019,3,7,4,18874,19537,15852,-3685
2019,3,7,5,17662,18374,14372,-4002
2019,3,7,6,16639,17596,13837,-3759
2019,3,7,7,16166,17141,13580,-3561
2019,3,7,8,15934,16931,13347,-3584
2019,3,7,9,15897,16904,13395,-3509
2019,3,7,10,16140,17179,13778,-3401
2019,3,7,11,17007,18112,15094,-3018
2019,3,7,12,18522,19688,16788,-2900
2019,3,7,13,19615,20558,17843,-2715
2019,3,7,14,20050,20685,17285,-3400
2019,3,7,15,20194,20572,16886,-3686
2019,3,7,16,20178,20370,16535,-3835
2019,3,7,17,20058,20291,16393,-3898
2019,3,7,18,19847,20225,16228,-3997
2019,3,7,19,19704,20173,16281,-3892
2019,3,7,20,19544,20053,16062,-3991
2019,3,7,21,19478,20146,16378,-3768
2019,3,7,22,19702,20563,16522,-4041
2019,3,7,23,20266,21197,17045,-4152
2019,3,8,0,21102,21913,17689,-4224
2019,3,8,1,21066,21775,17858,-3917
2019,3,8,2,20609,21286,17571,-3715
2019,3,8,3,19778,20387,16438,-3949
2019,3,8,4,18615,19181,15184,-3997
2019,3,8,5,17419,17991,14011,-3980
2019,3,8,6,16360,17214,13751,-3463
2019,3,8,7,15858,16824,13393,-3431
2019,3,8,8,15616,16616,12964,-3652
2019,3,8,9,15561,16597,12927,-3670
2019,3,8,10,15788,16877,13084,-3793
2019,3,8,11,16632,17855,13975,-3880
2019,3,8,12,18107,19388,15526,-3862
2019,3,8,13,19179,20179,16700,-3479
2019,3,8,14,19619,20159,16513,-3646
2019,3,8,15,19752,20018,15951,-4067
2019,3,8,16,19715,19858,15547,-4311
2019,3,8,17,19601,19579,15308,-4271
2019,3,8,18,19354,19212,14971,-4241
2019,3,8,19,19178,18986,15033,-3953
2019,3,8,20,18976,18809,14778,-4031
2019,3,8,21,18854,18820,14823,-3997
2019,3,8,22,18989,19136,15385,-3751
2019,3,8,23,19394,19684,15686,-3998
2019,3,9,0,20136,20311,16209,-4102
2019,3,9,1,20022,20136,16229,-3907
2019,3,9,2,19506,19669,15750,-3919
2019,3,9,3,18760,19026,15081,-3945
2019,3,9,4,17796,18076,14287,-3789
2019,3,9,5,16736,17093,13433,-3660
2019,3,9,6,15866,16404,12995,-3409
2019,3,9,7,15305,15951,12895,-3056
2019,3,9,8,14995,15688,12735,-2953
2019,3,9,9,14856,15559,12645,-2914
2019,3,9,10,14906,15632,12646,-2986
2019,3,9,11,15252,16011,13097,-2914
2019,3,9,12,15775,16544,13636,-2908
2019,3,9,13,16288,17048,14227,-2821
2019,3,9,14,16906,17308,14237,-3071
2019,3,9,15,17282,17300,13954,-3346
2019,3,9,16,17385,17201,13702,-3499
2019,3,9,17,17224,17031,13617,-3414
2019,3,9,18,16970,16715,13296,-3419
2019,3,9,19,16693,16440,13206,-3234
2019,3,9,20,16499,16261,13084,-3177
2019,3,9,21,16429,16340,13280,-3060
2019,3,9,22,16685,16779,13717,-3062
2019,3,9,23,17316,17531,14534,-2997
2019,3,10,0,18372,18465,15398,-3067
2019,3,10,1,18455,18509,15774,-2735
2019,3,10,2,18128,18206,15733,-2473
2019,3,10,3,17560,17700,15231,-2469
2019,3,10,4,16803,16971,14682,-2289
2019,3,10,5,15947,16178,13517,-2661
2019,3,10,6,15047,15482,12598,-2884
2019,3,10,7,14520,14974,12371,-2603
2019,3,10,8,14039,14682,12266,-2416
2019,3,10,9,13994,14589,12380,-2209
2019,3,10,10,14168,14764,12482,-2282
2019,3,10,11,14662,15205,12805,-2400
2019,3,10,12,15221,15785,13529,-2256
2019,3,10,13,15767,16443,13950,-2493
2019,3,10,14,16291,17297,14306,-2991
2019,3,10,15,16622,17928,14777,-3151
2019,3,10,16,16735,18304,15085,-3219
2019,3,10,17,16727,18368,15338,-3030
2019,3,10,18,16603,18226,15313,-2913
2019,3,10,19,16450,18090,15409,-2681
2019,3,10,20,16382,17985,15536,-2449
2019,3,10,21,16506,18140,15390,-2750
2019,3,10,22,16739,18373,15514,-2859
2019,3,10,23,17059,18636,15659,-2977
2019,3,11,0,17751,18988,15753,-3235
2019,3,11,1,17768,18684,15624,-3060
2019,3,11,2,17168,18010,15313,-2697
2019,3,11,3,16319,17050,14574,-2476
2019,3,11,4,15367,16013,13583,-2430
2019,3,11,5,14259,15252,12735,-2517
2019,3,11,6,13794,14768,12224,-2544
2019,3,11,7,13553,14522,12294,-2228
2019,3,11,8,13496,14447,11953,-2494
2019,3,11,9,13710,14700,12051,-2649
2019,3,11,10,14562,15604,12991,-2613
2019,3,11,11,16279,17300,14590,-2710
2019,3,11,12,17635,18598,15946,-2652
2019,3,11,13,18092,18924,16091,-2833
2019,3,11,14,18345,18846,15896,-2950
2019,3,11,15,18455,18758,15286,-3472
2019,3,11,16,18404,18557,14897,-3660
2019,3,11,17,18247,18288,14532,-3756
2019,3,11,18,18113,18176,14490,-3686
2019,3,11,19,17939,18016,14425,-3591
2019,3,11,20,17852,18042,14503,-3539
2019,3,11,21,17951,18239,14662,-3577
2019,3,11,22,18173,18712,15275,-3437
2019,3,11,23,18404,19010,15687,-3323
2019,3,12,0,19031,19531,16058,-3473
2019,3,12,1,18914,19245,15938,-3307
2019,3,12,2,18096,18459,15568,-2891
2019,3,12,3,16948,17234,14483,-2751
2019,3,12,4,15739,16067,13001,-3066
2019,3,12,5,14899,15320,12212,-3108
2019,3,12,6,14385,14876,11929,-2947
2019,3,12,7,14107,14678,11737,-2941
2019,3,12,8,14030,14650,11548,-3102
2019,3,12,9,14235,14932,11932,-3000
2019,3,12,10,15086,15860,13013,-2847
2019,3,12,11,16840,17678,15199,-2479
2019,3,12,12,18166,18962,16033,-2929
2019,3,12,13,18558,19241,15669,-3572
2019,3,12,14,18721,19388,15976,-3412
2019,3,12,15,18759,19416,15993,-3423
2019,3,12,16,18652,19197,15501,-3696
2019,3,12,17,18457,18806,15010,-3796
2019,3,12,18,18307,18496,14795,-3701
2019,3,12,19,18127,18153,14566,-3587
2019,3,12,20,18047,18006,14446,-3560
2019,3,12,21,18159,18199,14871,-3328
2019,3,12,22,18414,18594,15389,-3205
2019,3,12,23,18644,19024,15736,-3288
2019,3,13,0,19302,19750,16200,-3550
2019,3,13,1,19233,19625,16098,-3527
2019,3,13,2,18439,18913,15643,-3270
2019,3,13,3,17269,17800,14615,-3185
2019,3,13,4,16038,16568,13071,-3497
2019,3,13,5,15223,15712,12520,-3192
2019,3,13,6,14748,15282,12476,-2806
2019,3,13,7,14478,15068,12317,-2751
2019,3,13,8,14398,15033,12305,-2728
2019,3,13,9,14584,15274,12590,-2684
2019,3,13,10,15387,16196,13608,-2588
2019,3,13,11,17048,18037,15490,-2547
2019,3,13,12,18248,19193,16743,-2450
2019,3,13,13,18537,19315,16137,-3178
2019,3,13,14,18571,19083,15576,-3507
2019,3,13,15,18488,18835,15344,-3491
2019,3,13,16,18368,18537,14784,-3753
2019,3,13,17,18123,18229,14630,-3599
2019,3,13,18,17952,18113,14550,-3563
2019,3,13,19,17749,17996,14487,-3509
2019,3,13,20,17648,18142,14749,-3393
2019,3,13,21,17719,18491,15501,-2990
2019,3,13,22,17892,18936,16092,-2844
2019,3,13,23,18100,19147,16453,-2694
2019,3,14,0,18735,19470,16573,-2897
2019,3,14,1,18660,19108,16675,-2433
2019,3,14,2,17895,18317,15798,-2519
2019,3,14,3,16797,17172,14462,-2710
2019,3,14,4,15608,15969,12667,-3302
2019,3,14,5,14562,15075,11877,-3198
2019,3,14,6,14032,14557,11290,-3267
2019,3,14,7,13737,14253,11278,-2975
2019,3,14,8,13639,14139,11197,-2942
2019,3,14,9,13816,14360,11458,-2902
2019,3,14,10,14635,15226,12523,-2703
2019,3,14,11,16324,16952,14258,-2694
2019,3,14,12,17560,18135,15118,-3017
2019,3,14,13,17914,18365,14866,-3499
2019,3,14,14,18048,18295,14853,-3442
2019,3,14,15,18059,18040,14488,-3552
2019,3,14,16,17912,17703,14207,-3496
2019,3,14,17,17716,17405,13981,-3424
2019,3,14,18,17579,17276,13637,-3639
2019,3,14,19,17394,17092,13401,-3691
2019,3,14,20,17288,17141,13705,-3436
2019,3,14,21,17329,17391,14377,-3014
2019,3,14,22,17413,17725,15097,-2628
2019,3,14,23,17504,18005,15421,-2584
2019,3,15,0,18113,18531,15551,-2980
2019,3,15,1,18046,18319,15539,-2780
2019,3,15,2,17284,17563,14631,-2932
2019,3,15,3,16193,16396,13354,-3042
2019,3,15,4,15026,15223,12106,-3117
2019,3,15,5,14155,14378,11597,-2781
2019,3,15,6,13587,13848,11138,-2710
2019,3,15,7,13251,13560,11059,-2501
2019,3,15,8,13111,13452,10765,-2687
2019,3,15,9,13254,13610,10932,-2678
2019,3,15,10,14019,14427,11925,-2502
2019,3,15,11,15671,16082,13227,-2855
2019,3,15,12,16947,17354,14007,-3347
2019,3,15,13,17440,17785,14164,-3621
2019,3,15,14,17713,17966,14248,-3718
2019,3,15,15,17829,17887,14441,-3446
2019,3,15,16,17786,17758,14591,-3167
2019,3,15,17,17612,17550,14319,-3231
2019,3,15,18,17468,17486,14158,-3328
2019,3,15,19,17268,17266,13795,-3471
2019,3,15,20,17131,17248,13451,-3797
2019,3,15,21,17115,17405,13502,-3903
2019,3,15,22,17094,17579,13513,-4066
2019,3,15,23,17098,17681,13451,-4230
2019,3,16,0,17616,18063,13882,-4181
2019,3,16,1,17491,17686,14478,-3208
2019,3,16,2,16830,17107,14164,-2943
2019,3,16,3,15946,16203,12989,-3214
2019,3,16,4,14929,15247,11907,-3340
2019,3,16,5,14298,14431,10369,-4062
2019,3,16,6,13738,13872,9823,-4049
2019,3,16,7,13387,13550,9785,-3765
2019,3,16,8,13205,13394,9856,-3538
2019,3,16,9,13219,13429,9898,-3531
2019,3,16,10,13522,13774,10250,-3524
2019,3,16,11,14219,14534,11111,-3423
2019,3,16,12,14928,15288,11939,-3349
2019,3,16,13,15608,15995,12484,-3511
2019,3,16,14,16117,16485,12953,-3532
2019,3,16,15,16369,16788,13011,-3777
2019,3,16,16,16410,16822,12754,-4068
2019,3,16,17,16260,16656,12315,-4341
2019,3,16,18,16035,16402,12170,-4232
2019,3,16,19,15836,16251,12059,-4192
2019,3,16,20,15750,16179,11887,-4292
2019,3,16,21,15850,16394,12173,-4221
2019,3,16,22,16087,16759,12510,-4249
2019,3,16,23,16405,17142,13031,-4111
2019,3,17,0,17135,17820,13122,-4698
2019,3,17,1,17232,17825,13269,-4556
2019,3,17,2,16763,17413,12902,-4511
2019,3,17,3,16082,16722,12324,-4398
2019,3,17,4,15293,15918,11075,-4843
2019,3,17,5,14745,15179,10312,-4867
2019,3,17,6,14259,14670,9992,-4678
2019,3,17,7,13950,14394,9970,-4424
2019,3,17,8,13795,14270,9760,-4510
2019,3,17,9,13800,14284,9822,-4462
2019,3,17,10,14013,14535,9806,-4729
2019,3,17,11,14515,15062,10533,-4529
2019,3,17,12,14969,15636,11752,-3884
2019,3,17,13,15501,16172,12409,-3763
2019,3,17,14,15937,16539,12497,-4042
2019,3,17,15,16169,16660,12434,-4226
2019,3,17,16,16187,16557,12230,-4327
2019,3,17,17,16091,16414,11946,-4468
2019,3,17,18,15919,16226,11585,-4641
2019,3,17,19,15766,16061,11596,-4465
2019,3,17,20,15738,16022,11601,-4421
2019,3,17,21,15935,16276,11833,-4443
2019,3,17,22,16332,16801,12228,-4573
2019,3,17,23,16759,17295,12557,-4738
2019,3,18,0,17571,18181,12994,-5187
2019,3,18,1,17738,18260,13262,-4998
2019,3,18,2,17181,17722,12512,-5210
2019,3,18,3,16323,16848,11623,-5225
2019,3,18,4,15402,15878,10459,-5419
2019,3,18,5,14783,15055,9358,-5697
2019,3,18,6,14412,14715,9219,-5496
2019,3,18,7,14215,14529,8920,-5609
2019,3,18,8,14192,14545,8989,-5556
2019,3,18,9,14453,14824,9568,-5256
2019,3,18,10,15326,15796,10750,-5046
2019,3,18,11,16979,17611,12938,-4673
2019,3,18,12,18181,18774,14814,-3960
2019,3,18,13,18596,18937,14827,-4110
2019,3,18,14,18737,18847,13930,-4917
2019,3,18,15,18735,18636,13444,-5192
2019,3,18,16,18595,18373,13193,-5180
2019,3,18,17,18368,18112,13055,-5057
2019,3,18,18,18195,18038,13034,-5004
2019,3,18,19,17994,17967,12879,-5088
2019,3,18,20,17894,18089,13211,-4878
2019,3,18,21,17981,18340,13395,-4945
2019,3,18,22,18231,18713,13665,-5048
2019,3,18,23,18480,18943,14049,-4894
2019,3,19,0,19127,19449,14559,-4890
2019,3,19,1,19113,19275,14604,-4671
2019,3,19,2,18351,18518,13530,-4988
2019,3,19,3,17229,17347,12319,-5028
2019,3,19,4,16049,16156,10994,-5162
2019,3,19,5,15069,15305,10350,-4955
2019,3,19,6,14590,14895,10049,-4846
2019,3,19,7,14338,14692,9901,-4791
2019,3,19,8,14271,14696,9883,-4813
2019,3,19,9,14498,14977,10207,-4770
2019,3,19,10,15344,15868,11472,-4396
2019,3,19,11,17015,17586,14410,-3176
2019,3,19,12,18177,18631,16392,-2239
2019,3,19,13,18544,18740,16043,-2697
2019,3,19,14,18629,18593,14573,-4020
2019,3,19,15,18589,18347,13896,-4451
2019,3,19,16,18428,17956,13457,-4499
2019,3,19,17,18201,17768,13220,-4548
2019,3,19,18,18042,17705,13119,-4586
2019,3,19,19,17859,17630,12942,-4688
2019,3,19,20,17776,17660,12953,-4707
2019,3,19,21,17869,17882,13210,-4672
2019,3,19,22,18105,18192,13426,-4766
2019,3,19,23,18318,18417,13895,-4522
2019,3,20,0,18924,19088,14402,-4686
2019,3,20,1,18928,19023,14594,-4429
2019,3,20,2,18189,18272,13485,-4787
2019,3,20,3,17066,17166,12403,-4763
2019,3,20,4,15867,15974,10766,-5208
2019,3,20,5,14798,15181,10123,-5058
2019,3,20,6,14290,14805,9906,-4899
2019,3,20,7,14013,14563,9791,-4772
2019,3,20,8,13927,14544,9814,-4730
2019,3,20,9,14129,14792,10360,-4432
2019,3,20,10,14947,15783,11027,-4756
2019,3,20,11,16587,17576,13327,-4249
2019,3,20,12,17707,18617,15250,-3367
2019,3,20,13,18027,18622,14404,-4218
2019,3,20,14,18047,18295,13557,-4738
2019,3,20,15,17943,17953,13001,-4952
2019,3,20,16,17746,17561,13017,-4544
2019,3,20,17,17482,17248,12731,-4517
2019,3,20,18,17314,17038,12392,-4646
2019,3,20,19,17137,16883,12398,-4485
2019,3,20,20,17073,16870,12060,-4810
2019,3,20,21,17173,17096,12227,-4869
2019,3,20,22,17397,17475,12709,-4766
2019,3,20,23,17588,17869,13077,-4792
2019,3,21,0,18174,18518,13902,-4616
2019,3,21,1,18216,18390,14589,-3801
2019,3,21,2,17524,17721,13130,-4591
2019,3,21,3,16441,16579,12103,-4476
2019,3,21,4,15267,15339,10763,-4576
2019,3,21,5,14280,14516,10313,-4203
2019,3,21,6,13756,14067,10291,-3776
2019,3,21,7,13461,13804,10209,-3595
2019,3,21,8,13362,13723,10401,-3322
2019,3,21,9,13567,13953,10367,-3586
2019,3,21,10,14414,14852,11030,-3822
2019,3,21,11,16100,16669,12604,-4065
2019,3,21,12,17319,17951,13414,-4537
2019,3,21,13,17788,18354,13428,-4926
2019,3,21,14,18019,18573,13377,-5196
2019,3,21,15,18109,18691,13397,-5294
2019,3,21,16,18088,18708,13605,-5103
2019,3,21,17,17952,18581,13270,-5311
2019,3,21,18,17851,18451,13250,-5201
2019,3,21,19,17676,18336,13291,-5045
2019,3,21,20,17573,18365,13347,-5018
2019,3,21,21,17612,18554,13726,-4828
2019,3,21,22,17688,18750,13723,-5027
2019,3,21,23,17763,18825,13805,-5020
2019,3,22,0,18298,19060,14611,-4449
2019,3,22,1,18282,18756,14176,-4580
2019,3,22,2,17533,17986,13051,-4935
2019,3,22,3,16420,16885,11643,-5242
2019,3,22,4,15222,15679,10660,-5019
2019,3,22,5,14089,14750,9880,-4870
2019,3,22,6,13560,14270,9463,-4807
2019,3,22,7,13266,14042,9334,-4708
2019,3,22,8,13165,13946,9298,-4648
2019,3,22,9,13360,14155,9414,-4741
2019,3,22,10,14180,15031,10339,-4692
2019,3,22,11,15811,16750,12041,-4709
2019,3,22,12,17023,17980,13504,-4476
2019,3,22,13,17556,18564,13822,-4742
2019,3,22,14,17851,18863,14034,-4829
2019,3,22,15,17976,19022,14162,-4860
2019,3,22,16,17940,18933,13881,-5052
2019,3,22,17,17796,18826,13934,-4892
2019,3,22,18,17678,18717,13610,-5107
2019,3,22,19,17499,18455,13266,-5189
2019,3,22,20,17379,18279,13021,-5258
2019,3,22,21,17376,18304,13107,-5197
2019,3,22,22,17397,18398,13111,-5287
2019,3,22,23,17433,18514,13319,-5195
2019,3,23,0,17896,18922,14161,-4761
2019,3,23,1,17868,18777,14159,-4618
2019,3,23,2,17256,18219,13251,-4968
2019,3,23,3,16371,17333,12187,-5146
2019,3,23,4,15363,16300,11168,-5132
2019,3,23,5,14753,15509,10846,-4663
2019,3,23,6,14155,15065,10874,-4191
2019,3,23,7,13802,14811,10720,-4091
2019,3,23,8,13629,14683,10557,-4126
2019,3,23,9,13673,14731,10443,-4288
2019,3,23,10,14024,15121,10745,-4376
2019,3,23,11,14729,15839,11806,-4033
2019,3,23,12,15420,16594,12911,-3683
2019,3,23,13,16199,17263,13681,-3582
2019,3,23,14,16750,17642,13853,-3789
2019,3,23,15,16993,17746,13639,-4107
2019,3,23,16,16837,17396,12901,-4495
2019,3,23,17,16612,16943,12035,-4908
2019,3,23,18,16318,16514,11550,-4964
2019,3,23,19,16076,16176,11392,-4784
2019,3,23,20,15965,16013,11487,-4526
2019,3,23,21,16063,16120,11435,-4685
2019,3,23,22,16338,16521,11788,-4733
2019,3,23,23,16631,17019,12395,-4624
2019,3,24,0,17321,17702,13175,-4527
2019,3,24,1,17527,17868,13666,-4202
2019,3,24,2,17066,17492,13155,-4337
2019,3,24,3,16280,16832,12762,-4070
2019,3,24,4,15354,16053,11649,-4404
2019,3,24,5,14607,15336,10760,-4576
2019,3,24,6,14106,14816,10381,-4435
2019,3,24,7,13792,14467,10095,-4372
2019,3,24,8,13632,14297,10002,-4295
2019,3,24,9,13641,14293,10013,-4280
2019,3,24,10,13861,14530,10594,-3936
2019,3,24,11,14309,15069,10871,-4198
2019,3,24,12,14681,15457,11674,-3783
2019,3,24,13,15163,15764,11935,-3829
2019,3,24,14,15508,15805,11924,-3881
2019,3,24,15,15652,15825,11757,-4068
2019,3,24,16,15702,15741,11793,-3948
2019,3,24,17,15588,15613,11713,-3900
2019,3,24,18,15418,15426,11639,-3787
2019,3,24,19,15254,15457,11473,-3984
2019,3,24,20,15208,15592,11585,-4007
2019,3,24,21,15349,15872,11390,-4482
2019,3,24,22,15654,16242,11650,-4592
2019,3,24,23,16007,16630,11858,-4772
2019,3,25,0,16704,17359,12716,-4643
2019,3,25,1,16918,17394,12908,-4486
2019,3,25,2,16391,16754,11977,-4777
2019,3,25,3,15549,15831,10931,-4900
2019,3,25,4,14615,14815,9903,-4912
2019,3,25,5,13639,14080,9350,-4730
2019,3,25,6,13213,13696,9245,-4451
2019,3,25,7,12994,13461,8851,-4610
2019,3,25,8,12958,13452,8866,-4586
2019,3,25,9,13238,13732,9447,-4285
2019,3,25,10,14171,14696,10441,-4255
2019,3,25,11,15899,16424,12254,-4170
2019,3,25,12,17176,17550,13347,-4203
2019,3,25,13,17729,17849,13261,-4588
2019,3,25,14,18002,17846,13066,-4780
2019,3,25,15,18105,17873,13221,-4652
2019,3,25,16,17956,17847,12593,-5254
2019,3,25,17,17776,17547,12229,-5318
2019,3,25,18,17641,17379,11683,-5696
2019,3,25,19,17469,17199,11705,-5494
2019,3,25,20,17401,17158,11788,-5370
2019,3,25,21,17519,17510,12446,-5064
2019,3,25,22,17778,17844,12778,-5066
2019,3,25,23,17969,18061,13054,-5007
2019,3,26,0,18529,18556,13905,-4651
2019,3,26,1,18586,18543,13935,-4608
2019,3,26,2,17824,17792,13388,-4404
2019,3,26,3,16629,16697,12375,-4322
2019,3,26,4,15394,15607,11379,-4228
2019,3,26,5,14588,14836,10569,-4267
2019,3,26,6,14121,14435,9622,-4813
2019,3,26,7,13875,14275,9389,-4886
2019,3,26,8,13815,14317,9437,-4880
2019,3,26,9,14061,14642,9666,-4976
2019,3,26,10,14925,15679,11112,-4567
2019,3,26,11,16568,17473,12896,-4577
2019,3,26,12,17727,18466,14208,-4258
2019,3,26,13,18138,18512,14119,-4393
2019,3,26,14,18244,18220,13476,-4744
2019,3,26,15,18213,18033,12859,-5174
2019,3,26,16,18013,17741,12770,-4971
2019,3,26,17,17769,17483,12630,-4853
2019,3,26,18,17602,17275,12423,-4852
2019,3,26,19,17431,17051,12099,-4952
2019,3,26,20,17378,17031,12125,-4906
2019,3,26,21,17504,17276,12544,-4732
2019,3,26,22,17790,17714,13027,-4687
2019,3,26,23,17998,18061,12882,-5179
2019,3,27,0,18534,18744,13516,-5228
2019,3,27,1,18620,18836,14028,-4808
2019,3,27,2,17925,18137,13317,-4820
2019,3,27,3,16778,17052,12168,-4884
2019,3,27,4,15576,15894,11170,-4724
2019,3,27,5,14700,15108,10299,-4809
2019,3,27,6,14239,14706,9645,-5061
2019,3,27,7,13982,14498,9308,-5190
2019,3,27,8,13912,14500,9393,-5107
2019,3,27,9,14126,14810,9520,-5290
2019,3,27,10,14942,15783,11185,-4598
2019,3,27,11,16510,17444,13780,-3664
2019,3,27,12,17596,18396,14626,-3770
2019,3,27,13,17934,18483,13949,-4534
2019,3,27,14,17960,18255,13041,-5214
2019,3,27,15,17846,17919,12360,-5559
2019,3,27,16,17623,17599,12134,-5465
2019,3,27,17,17348,17317,11935,-5382
2019,3,27,18,17178,17177,11828,-5349
2019,3,27,19,17003,17047,11711,-5336
2019,3,27,20,16949,16984,11679,-5305
2019,3,27,21,17054,17228,11900,-5328
2019,3,27,22,17309,17646,12310,-5336
2019,3,27,23,17492,17992,12748,-5244
2019,3,28,0,18002,18652,13233,-5419
2019,3,28,1,18124,18747,14162,-4585
2019,3,28,2,17485,18054,13116,-4938
2019,3,28,3,16408,16919,12108,-4811
2019,3,28,4,15258,15795,11118,-4677
2019,3,28,5,14435,14970,10469,-4501
2019,3,28,6,13941,14505,10181,-4324
2019,3,28,7,13659,14293,10099,-4194
2019,3,28,8,13569,14262,10151,-4111
2019,3,28,9,13782,14553,10332,-4221
2019,3,28,10,14609,15563,11404,-4159
2019,3,28,11,16200,17253,13052,-4201
2019,3,28,12,17317,18237,14077,-4160
2019,3,28,13,17695,18351,13981,-4370
2019,3,28,14,17789,18163,13278,-4885
2019,3,28,15,17746,17874,13169,-4705
2019,3,28,16,17608,17653,12878,-4775
2019,3,28,17,17382,17456,12535,-4921
2019,3,28,18,17239,17380,12548,-4832
2019,3,28,19,17062,17243,12525,-4718
2019,3,28,20,16979,17269,12377,-4892
2019,3,28,21,17032,17602,12566,-5036
2019,3,28,22,17165,17954,12954,-5000
2019,3,28,23,17262,18142,13439,-4703
2019,3,29,0,17727,18530,13846,-4684
2019,3,29,1,17812,18436,13602,-4834
2019,3,29,2,17130,17518,13059,-4459
2019,3,29,3,16040,16306,12216,-4090
2019,3,29,4,14860,15118,10431,-4687
2019,3,29,5,13819,14231,9706,-4525
2019,3,29,6,13281,13722,9437,-4285
2019,3,29,7,12977,13377,9389,-3988
2019,3,29,8,12866,13289,9438,-3851
2019,3,29,9,13056,13515,9634,-3881
2019,3,29,10,13866,14443,10615,-3828
2019,3,29,11,15442,16172,12226,-3946
2019,3,29,12,16613,17425,12758,-4667
2019,3,29,13,17136,17950,12645,-5305
2019,3,29,14,17397,18307,12770,-5537
2019,3,29,15,17489,18409,12868,-5541
2019,3,29,16,17431,18193,12792,-5401
2019,3,29,17,17271,18044,12648,-5396
2019,3,29,18,17147,17817,12576,-5241
2019,3,29,19,16969,17444,12351,-5093
2019,3,29,20,16851,17418,12390,-5028
2019,3,29,21,16831,17454,12573,-4881
2019,3,29,22,16791,17443,12456,-4987
2019,3,29,23,16728,17391,12472,-4919
2019,3,30,0,17069,17691,12565,-5126
2019,3,30,1,17099,17584,12639,-4945
2019,3,30,2,16515,16936,12139,-4797
2019,3,30,3,15618,16005,11473,-4532
2019,3,30,4,14589,14974,10342,-4632
2019,3,30,5,13889,14004,9372,-4632
2019,3,30,6,13293,13460,9312,-4148
2019,3,30,7,12932,13088,9020,-4068
2019,3,30,8,12739,12936,8759,-4177
2019,3,30,9,12756,12962,8755,-4207
2019,3,30,10,13070,13315,9000,-4315
2019,3,30,11,13677,14013,9830,-4183
2019,3,30,12,14318,14763,10940,-3823
2019,3,30,13,15054,15494,11830,-3664
2019,3,30,14,15561,15816,11754,-4062
2019,3,30,15,15779,15855,11789,-4066
2019,3,30,16,15748,15739,11937,-3802
2019,3,30,17,15590,15489,11840,-3649
2019,3,30,18,15370,15182,11783,-3399
2019,3,30,19,15172,15143,11742,-3401
2019,3,30,20,15080,15134,11640,-3494
2019,3,30,21,15129,15304,11853,-3451
2019,3,30,22,15256,15610,12148,-3462
2019,3,30,23,15426,15851,12382,-3469
2019,3,31,0,15942,16293,12490,-3803
2019,3,31,1,16155,16276,12395,-3881
2019,3,31,2,15743,15819,11984,-3835
2019,3,31,3,15031,15097,11001,-4096
2019,3,31,4,14176,14263,9866,-4397
2019,3,31,5,13386,13518,9622,-3896
2019,3,31,6,12847,12977,9307,-3670
2019,3,31,7,12507,12668,8925,-3743
2019,3,31,8,12317,12504,8743,-3761
2019,3,31,9,12300,12427,8807,-3620
2019,3,31,10,12485,12662,8975,-3687
2019,3,31,11,12882,13118,9376,-3742
2019,3,31,12,13365,13628,10248,-3380
2019,3,31,13,14090,14521,11012,-3509
2019,3,31,14,14708,15284,11687,-3597
2019,3,31,15,15099,15680,11908,-3772
2019,3,31,16,15351,16093,11723,-4370
2019,3,31,17,15395,16356,11971,-4385
2019,3,31,18,15321,16324,12048,-4276
2019,3,31,19,15214,16362,12192,-4170
2019,3,31,20,15205,16327,12321,-4006
2019,3,31,21,15360,16431,12492,-3939
2019,3,31,22,15649,16668,12526,-4142
2019,3,31,23,15948,16946,12626,-4320
2019,4,1,0,16527,17499,13228,-4271
2019,4,1,1,16780,17634,13611,-4023
2019,4,1,2,16297,17054,12465,-4589
2019,4,1,3,15469,16095,11287,-4808
2019,4,1,4,14548,15122,10509,-4613
2019,4,1,5,13620,14433,9889,-4544
2019,4,1,6,13215,14121,9703,-4418
2019,4,1,7,12994,13965,9455,-4510
2019,4,1,8,12951,13983,9388,-4595
2019,4,1,9,13220,14303,9728,-4575
2019,4,1,10,14122,15324,10804,-4520
2019,4,1,11,15756,17081,13053,-4028
2019,4,1,12,16954,18116,14525,-3591
2019,4,1,13,17499,18320,14035,-4285
2019,4,1,14,17727,18304,13291,-5013
2019,4,1,15,17800,18208,13239,-4969
2019,4,1,16,17671,17968,13145,-4823
2019,4,1,17,17465,17693,12670,-5023
2019,4,1,18,17300,17467,12294,-5173
2019,4,1,19,17113,17212,12174,-5038
2019,4,1,20,17004,17082,12249,-4833
2019,4,1,21,17103,17289,12407,-4882
2019,4,1,22,17343,17699,12695,-5004
2019,4,1,23,17510,17986,12879,-5107
2019,4,2,0,17999,18602,13325,-5277
2019,4,2,1,18187,18777,13685,-5092
2019,4,2,2,17433,18065,12875,-5190
2019,4,2,3,16247,16890,12438,-4452
2019,4,2,4,15012,15669,10986,-4683
2019,4,2,5,14174,14880,10524,-4356
2019,4,2,6,13712,14442,10225,-4217
2019,4,2,7,13456,14166,10071,-4095
2019,4,2,8,13378,14155,10243,-3912
2019,4,2,9,13594,14428,10678,-3750
2019,4,2,10,14410,15399,11477,-3922
2019,4,2,11,15945,17181,13766,-3415
2019,4,2,12,17017,18079,15206,-2873
2019,4,2,13,17429,18139,14347,-3792
2019,4,2,14,17522,17873,13475,-4398
2019,4,2,15,17492,17533,13096,-4437
2019,4,2,16,17385,17227,12894,-4333
2019,4,2,17,17188,16957,12665,-4292
2019,4,2,18,17042,16895,12321,-4574
2019,4,2,19,16863,16828,12219,-4609
2019,4,2,20,16744,17155,12336,-4819
2019,4,2,21,16797,17642,12996,-4646
2019,4,2,22,16963,18026,13338,-4688
2019,4,2,23,17114,18276,13640,-4636
2019,4,3,0,17550,18586,14316,-4270
2019,4,3,1,17728,18422,14304,-4118
2019,4,3,2,17019,17579,13208,-4371
2019,4,3,3,15922,16456,12211,-4245
2019,4,3,4,14744,15227,10785,-4442
2019,4,3,5,13753,14333,10122,-4211
2019,4,3,6,13211,13856,9779,-4077
2019,4,3,7,12905,13594,9734,-3860
2019,4,3,8,12798,13515,9717,-3798
2019,4,3,9,13002,13793,10281,-3512
2019,4,3,10,13867,14799,11372,-3427
2019,4,3,11,15504,16631,13356,-3275
2019,4,3,12,16674,17636,14212,-3424
2019,4,3,13,17147,17616,13785,-3831
2019,4,3,14,17287,17383,13635,-3748
2019,4,3,15,17285,17143,13469,-3674
2019,4,3,16,17087,16961,13385,-3576
2019,4,3,17,16880,16742,13219,-3523
2019,4,3,18,16747,16671,13137,-3534
2019,4,3,19,16590,16519,12775,-3744
2019,4,3,20,16510,16505,12735,-3770
2019,4,3,21,16597,16746,12755,-3991
2019,4,3,22,16768,17109,13046,-4063
2019,4,3,23,16824,17369,13507,-3862
2019,4,4,0,17247,17853,13662,-4191
2019,4,4,1,17500,18016,14047,-3969
2019,4,4,2,16808,17267,13270,-3997
2019,4,4,3,15654,16102,12299,-3803
2019,4,4,4,14430,14951,10982,-3969
2019,4,4,5,13797,14126,10249,-3877
2019,4,4,6,13299,13697,10121,-3576
2019,4,4,7,13004,13465,9812,-3653
2019,4,4,8,12908,13420,9828,-3592
2019,4,4,9,13118,13748,9900,-3848
2019,4,4,10,13962,14789,11075,-3714
2019,4,4,11,15551,16545,13103,-3442
2019,4,4,12,16694,17454,14373,-3081
2019,4,4,13,17160,17588,14150,-3438
2019,4,4,14,17310,17397,14075,-3322
2019,4,4,15,17320,17212,13351,-3861
2019,4,4,16,17228,17014,13113,-3901
2019,4,4,17,17033,16746,12559,-4187
2019,4,4,18,16894,16586,12525,-4061
2019,4,4,19,16721,16525,12691,-3834
2019,4,4,20,16618,16583,12600,-3983
2019,4,4,21,16678,16864,12975,-3889
2019,4,4,22,16832,17206,13240,-3966
2019,4,4,23,16926,17472,13349,-4123
2019,4,5,0,17354,17928,14246,-3682
2019,4,5,1,17603,18086,14521,-3565
2019,4,5,2,16933,17456,13460,-3996
2019,4,5,3,15833,16325,12243,-4082
2019,4,5,4,14681,15145,11122,-4023
2019,4,5,5,14026,14332,10189,-4143
2019,4,5,6,13560,13956,10007,-3949
2019,4,5,7,13282,13750,9878,-3872
2019,4,5,8,13185,13725,9918,-3807
2019,4,5,9,13379,13969,9738,-4231
2019,4,5,10,14169,14881,10787,-4094
2019,4,5,11,15652,16506,13544,-2962
2019,4,5,12,16797,17618,14588,-3030
2019,4,5,13,17373,17963,14547,-3416
2019,4,5,14,17661,18174,14184,-3990
2019,4,5,15,17779,18385,13520,-4865
2019,4,5,16,17766,18417,13490,-4927
2019,4,5,17,17616,18383,13458,-4925
2019,4,5,18,17481,18393,13393,-5000
2019,4,5,19,17280,18400,14006,-4394
2019,4,5,20,17104,18426,14331,-4095
2019,4,5,21,17054,18556,14765,-3791
2019,4,5,22,16990,18662,14904,-3758
2019,4,5,23,16926,18545,14726,-3819
2019,4,6,0,17199,18575,14960,-3615
2019,4,6,1,17324,18289,15072,-3217
2019,4,6,2,16710,17584,13981,-3603
2019,4,6,3,15802,16620,13074,-3546
2019,4,6,4,14743,15536,11753,-3783
2019,4,6,5,13705,14601,11608,-2993
2019,4,6,6,13123,14020,11064,-2956
2019,4,6,7,12789,13668,11093,-2575
2019,4,6,8,12611,13498,10754,-2744
2019,4,6,9,12630,13510,10725,-2785
2019,4,6,10,12931,13832,11127,-2705
2019,4,6,11,13462,14437,11731,-2706
2019,4,6,12,14050,15142,12053,-3089
2019,4,6,13,14771,15873,13055,-2818
2019,4,6,14,15245,16190,13013,-3177
2019,4,6,15,15452,16050,12682,-3368
2019,4,6,16,15379,15679,12171,-3508
2019,4,6,17,15222,15363,11840,-3523
2019,4,6,18,15001,15003,11399,-3604
2019,4,6,19,14807,14730,11286,-3444
2019,4,6,20,14698,14645,11448,-3197
2019,4,6,21,14743,14805,11656,-3149
2019,4,6,22,14871,15080,11676,-3404
2019,4,6,23,14992,15357,12070,-3287
2019,4,7,0,15422,15790,12068,-3722
2019,4,7,1,15786,16141,12259,-3882
2019,4,7,2,15419,15780,12210,-3570
2019,4,7,3,14755,15131,11931,-3200
2019,4,7,4,13939,14356,10988,-3368
2019,4,7,5,13163,13597,10507,-3090
2019,4,7,6,12598,13096,10314,-2782
2019,4,7,7,12247,12778,9962,-2816
2019,4,7,8,12051,12618,10054,-2564
2019,4,7,9,12041,12637,9968,-2669
2019,4,7,10,12261,12890,10092,-2798
2019,4,7,11,12643,13302,10452,-2850
2019,4,7,12,13060,13765,10770,-2995
2019,4,7,13,13709,14286,10882,-3404
2019,4,7,14,14181,14535,10972,-3563
2019,4,7,15,14429,14635,10898,-3737
2019,4,7,16,14537,14535,10964,-3571
2019,4,7,17,14498,14369,10962,-3407
2019,4,7,18,14380,14273,10844,-3429
2019,4,7,19,14246,14282,10985,-3297
2019,4,7,20,14199,14451,11102,-3349
2019,4,7,21,14339,14838,11392,-3446
2019,4,7,22,14594,15345,11527,-3818
2019,4,7,23,14842,15707,11834,-3873
2019,4,8,0,15384,16257,12012,-4245
2019,4,8,1,15821,16361,12417,-3944
2019,4,8,2,15313,15745,12140,-3605
2019,4,8,3,14409,14805,11354,-3451
2019,4,8,4,13417,13787,10694,-3093
2019,4,8,5,12723,13088,10422,-2666
2019,4,8,6,12268,12636,10352,-2284
2019,4,8,7,12008,12431,10206,-2225
2019,4,8,8,11925,12431,10199,-2232
2019,4,8,9,12151,12715,10367,-2348
2019,4,8,10,13028,13612,11378,-2234
2019,4,8,11,14617,15289,12491,-2798
2019,4,8,12,15912,16536,13395,-3141
2019,4,8,13,16621,17109,13628,-3481
2019,4,8,14,17017,17408,14125,-3283
2019,4,8,15,17241,17489,14189,-3300
2019,4,8,16,17258,17376,13952,-3424
2019,4,8,17,17178,17241,13780,-3461
2019,4,8,18,17100,17103,14193,-2910
2019,4,8,19,16951,16950,14597,-2353
2019,4,8,20,16845,17072,14475,-2597
2019,4,8,21,16885,17206,14732,-2474
2019,4,8,22,16957,17406,14674,-2732
2019,4,8,23,16918,17390,14954,-2436
2019,4,9,0,17205,17613,15309,-2304
2019,4,9,1,17366,17550,15525,-2025
2019,4,9,2,16569,16732,13930,-2802
2019,4,9,3,15325,15528,12784,-2744
2019,4,9,4,14032,14290,11665,-2625
2019,4,9,5,13214,13421,11213,-2208
2019,4,9,6,12694,12898,10428,-2470
2019,4,9,7,12392,12662,10468,-2194
2019,4,9,8,12282,12575,10472,-2103
2019,4,9,9,12475,12838,10889,-1949
2019,4,9,10,13291,13705,11507,-2198
2019,4,9,11,14823,15310,13450,-1860
2019,4,9,12,16007,16345,14451,-1894
2019,4,9,13,16559,16830,14904,-1926
2019,4,9,14,16804,17048,14896,-2152
2019,4,9,15,16918,17127,14622,-2505
2019,4,9,16,16923,17243,14309,-2934
2019,4,9,17,16812,17110,14292,-2818
2019,4,9,18,16725,17088,13712,-3376
2019,4,9,19,16576,17036,14111,-2925
2019,4,9,20,16472,17126,14063,-3063
2019,4,9,21,16514,17358,14781,-2577
2019,4,9,22,16614,17710,15067,-2643
2019,4,9,23,16657,17741,15005,-2736
2019,4,10,0,16976,17873,15357,-2516
2019,4,10,1,17190,17756,15748,-2008
2019,4,10,2,16482,17008,14588,-2420
2019,4,10,3,15349,15864,13512,-2352
2019,4,10,4,14158,14702,12389,-2313
2019,4,10,5,13339,13861,10925,-2936
2019,4,10,6,12834,13374,10351,-3023
2019,4,10,7,12534,13119,10033,-3086
2019,4,10,8,12426,13080,9936,-3144
2019,4,10,9,12629,13301,10223,-3078
2019,4,10,10,13472,14159,11406,-2753
2019,4,10,11,15032,15727,13486,-2241
2019,4,10,12,16209,16792,14432,-2360
2019,4,10,13,16724,16992,14236,-2756
2019,4,10,14,16919,17200,13702,-3498
2019,4,10,15,16969,17173,13648,-3525
2019,4,10,16,16888,16998,13628,-3370
2019,4,10,17,16722,16867,13594,-3273
2019,4,10,18,16617,16819,13684,-3135
2019,4,10,19,16480,16644,13691,-2953
2019,4,10,20,16417,16567,13521,-3046
2019,4,10,21,16513,16753,13877,-2876
2019,4,10,22,16666,17039,13891,-3148
2019,4,10,23,16700,17230,13996,-3234
2019,4,11,0,17020,17655,14094,-3561
2019,4,11,1,17315,17941,14121,-3820
2019,4,11,2,16658,17276,13690,-3586
2019,4,11,3,15520,16128,13063,-3065
2019,4,11,4,14340,14933,12260,-2673
2019,4,11,5,13690,14105,11258,-2847
2019,4,11,6,13205,13650,10926,-2724
2019,4,11,7,12922,13429,11067,-2362
2019,4,11,8,12830,13368,10978,-2390
2019,4,11,9,13042,13623,11350,-2273
2019,4,11,10,13879,14552,12060,-2492
2019,4,11,11,15404,16196,13709,-2487
2019,4,11,12,16551,17348,14452,-2896
2019,4,11,13,17015,17757,14510,-3247
2019,4,11,14,17154,17867,14251,-3616
2019,4,11,15,17145,17835,14035,-3800
2019,4,11,16,17000,17703,14039,-3664
2019,4,11,17,16788,17431,14046,-3385
2019,4,11,18,16649,17401,14152,-3249
2019,4,11,19,16483,17389,14167,-3222
2019,4,11,20,16391,17359,14024,-3335
2019,4,11,21,16455,17509,14097,-3412
2019,4,11,22,16603,17781,14250,-3531
2019,4,11,23,16679,17857,14112,-3745
2019,4,12,0,17015,18081,14393,-3688
2019,4,12,1,17324,18097,14430,-3667
2019,4,12,2,16679,17360,14319,-3041
2019,4,12,3,15573,16192,13079,-3113
2019,4,12,4,14400,14956,12649,-2307
2019,4,12,5,13584,14079,11644,-2435
2019,4,12,6,13078,13572,11182,-2390
2019,4,12,7,12787,13273,10896,-2377
2019,4,12,8,12673,13175,10916,-2259
2019,4,12,9,12835,13378,11204,-2174
2019,4,12,10,13581,14215,12024,-2191
2019,4,12,11,14961,15786,13511,-2275
2019,4,12,12,16087,16982,14778,-2204
2019,4,12,13,16665,17497,14396,-3101
2019,4,12,14,16956,17668,14492,-3176
2019,4,12,15,17079,17576,14812,-2764
2019,4,12,16,17037,17371,14463,-2908
2019,4,12,17,16904,16983,14427,-2556
2019,4,12,18,16802,16732,14294,-2438
2019,4,12,19,16639,16562,13901,-2661
2019,4,12,20,16503,16626,13903,-2723
2019,4,12,21,16459,16870,14136,-2734
2019,4,12,22,16368,17129,14193,-2936
2019,4,12,23,16219,17072,14239,-2833
2019,4,13,0,16369,17136,14276,-2860
2019,4,13,1,16574,17044,14423,-2621
2019,4,13,2,16031,16431,14077,-2354
2019,4,13,3,15148,15488,13321,-2167
2019,4,13,4,14131,14431,12717,-1714
2019,4,13,5,13339,13533,12137,-1396
2019,4,13,6,12699,13016,11953,-1063
2019,4,13,7,12303,12596,11952,-644
2019,4,13,8,12082,12365,11654,-711
2019,4,13,9,12072,12361,11650,-711
2019,4,13,10,12343,12633,11808,-825
2019,4,13,11,12828,13222,12534,-688
2019,4,13,12,13545,13989,12703,-1286
2019,4,13,13,14482,14735,12962,-1773
2019,4,13,14,15157,15154,13419,-1735
2019,4,13,15,15510,15361,13557,-1804
2019,4,13,16,15539,15207,13636,-1571
2019,4,13,17,15432,14900,13664,-1236
2019,4,13,18,15240,14676,13326,-1350
2019,4,13,19,15055,14653,13310,-1343
2019,4,13,20,14942,14738,13323,-1415
2019,4,13,21,14962,15018,13608,-1410
2019,4,13,22,15038,15277,13687,-1590
2019,4,13,23,15070,15443,13662,-1781
2019,4,14,0,15378,15749,13476,-2273
2019,4,14,1,15753,15985,13741,-2244
2019,4,14,2,15335,15598,13724,-1874
2019,4,14,3,14571,14866,13211,-1655
2019,4,14,4,13676,14022,12529,-1493
2019,4,14,5,13006,13260,11680,-1580
2019,4,14,6,12466,12761,10474,-2287
2019,4,14,7,12116,12411,10476,-1935
2019,4,14,8,11920,12246,10398,-1848
2019,4,14,9,11905,12218,10177,-2041
2019,4,14,10,12103,12424,10138,-2286
2019,4,14,11,12424,12759,10649,-2110
2019,4,14,12,12915,13284,11338,-1946
2019,4,14,13,13687,13990,11884,-2106
2019,4,14,14,14293,14549,12179,-2370
2019,4,14,15,14654,15009,12147,-2862
2019,4,14,16,14883,15165,12338,-2827
2019,4,14,17,14907,15340,12618,-2722
2019,4,14,18,14813,15565,12804,-2761
2019,4,14,19,14685,15634,13057,-2577
2019,4,14,20,14630,15739,13184,-2555
2019,4,14,21,14754,16018,13660,-2358
2019,4,14,22,14935,16309,13912,-2397
2019,4,14,23,15097,16352,13896,-2456
2019,4,15,0,15487,16555,14104,-2451
2019,4,15,1,15916,16586,14308,-2278
2019,4,15,2,15385,15818,13662,-2156
2019,4,15,3,14467,14929,12853,-2076
2019,4,15,4,13500,13990,12272,-1718
2019,4,15,5,12868,13282,11171,-2111
2019,4,15,6,12406,12841,10740,-2101
2019,4,15,7,12122,12586,10639,-1947
2019,4,15,8,12021,12519,10326,-2193
2019,4,15,9,12224,12781,10531,-2250
2019,4,15,10,13050,13563,11274,-2289
2019,4,15,11,14543,15071,12601,-2470
2019,4,15,12,15833,16349,13555,-2794
2019,4,15,13,16534,16919,14163,-2756
2019,4,15,14,16920,17337,14393,-2944
2019,4,15,15,17115,17614,14659,-2955
2019,4,15,16,17111,17730,14709,-3021
2019,4,15,17,16999,17733,14726,-3007
2019,4,15,18,16885,17613,14543,-3070
2019,4,15,19,16714,17360,14678,-2682
2019,4,15,20,16594,17336,14776,-2560
2019,4,15,21,16635,17403,14746,-2657
2019,4,15,22,16773,17567,14900,-2667
2019,4,15,23,16821,17519,15145,-2374
2019,4,16,0,17062,17710,15116,-2594
2019,4,16,1,17298,17865,15377,-2488
2019,4,16,2,16586,17158,14864,-2294
2019,4,16,3,15436,16014,14096,-1918
2019,4,16,4,14229,14862,12897,-1965
2019,4,16,5,13417,14048,12191,-1857
2019,4,16,6,12915,13602,11821,-1781
2019,4,16,7,12638,13336,11787,-1549
2019,4,16,8,12544,13253,11756,-1497
2019,4,16,9,12758,13504,11948,-1556
2019,4,16,10,13590,14401,12445,-1956
2019,4,16,11,15074,15810,13853,-1957
2019,4,16,12,16228,16756,14493,-2263
2019,4,16,13,16709,16901,14807,-2094
2019,4,16,14,16857,16812,14619,-2193
2019,4,16,15,16869,16687,14352,-2335
2019,4,16,16,16757,16526,14161,-2365
2019,4,16,17,16574,16365,14170,-2195
2019,4,16,18,16454,16303,14295,-2008
2019,4,16,19,16316,16180,14048,-2132
2019,4,16,20,16249,16246,14242,-2004
2019,4,16,21,16334,16524,14195,-2329
2019,4,16,22,16485,16910,14716,-2194
2019,4,16,23,16522,17089,14553,-2536
2019,4,17,0,16760,17349,14427,-2922
2019,4,17,1,17086,17410,14427,-2983
2019,4,17,2,16433,16671,13754,-2917
2019,4,17,3,15287,15512,12933,-2579
2019,4,17,4,14084,14350,12344,-2006
2019,4,17,5,13288,13474,11488,-1986
2019,4,17,6,12761,13058,11234,-1824
2019,4,17,7,12459,12782,11068,-1714
2019,4,17,8,12353,12717,10908,-1809
2019,4,17,9,12550,12971,10975,-1996
2019,4,17,10,13392,13855,11481,-2374
2019,4,17,11,14910,15265,12992,-2273
2019,4,17,12,16103,16291,14123,-2168
2019,4,17,13,16603,16570,14143,-2427
2019,4,17,14,16752,16486,16486,0
2019,4,17,15,16752,16337,16337,0
2019,4,17,16,16587,16155,16155,0
2019,4,17,17,16385,15972,12269,-3703
2019,4,17,18,16271,15840,12002,-3838
2019,4,17,19,16131,15732,12065,-3667
2019,4,17,20,16073,15724,11907,-3817
2019,4,17,21,16156,15917,15917,0
2019,4,17,22,16305,16191,16191,0
2019,4,17,23,16319,16377,16377,0
2019,4,18,0,16549,16714,16714,0
2019,4,18,1,16922,17025,17025,0
2019,4,18,2,16287,16370,16370,0
2019,4,18,3,15125,15289,15289,0
2019,4,18,4,13899,0,15289,0
2019,4,18,5,13132,13300,11307,-1993
2019,4,18,6,12613,12841,11167,-1674
2019,4,18,7,12306,12588,11141,-1447
2019,4,18,8,12189,12504,11129,-1375
2019,4,18,9,12376,12709,11339,-1370
2019,4,18,10,13196,13486,11652,-1834
2019,4,18,11,14674,14845,12826,-2019
2019,4,18,12,15914,16109,13659,-2450
2019,4,18,13,16547,16804,13883,-2921
2019,4,18,14,16888,17171,13816,-3355
2019,4,18,15,17073,17329,13915,-3414
2019,4,18,16,17082,17390,13972,-3418
2019,4,18,17,16990,17263,13835,-3428
2019,4,18,18,16940,17276,13909,-3367
2019,4,18,19,16803,17211,14002,-3209
2019,4,18,20,16717,17069,13952,-3117
2019,4,18,21,16739,17031,13981,-3050
2019,4,18,22,16729,16998,13507,-3491
2019,4,18,23,16601,16901,13749,-3152
2019,4,19,0,16744,17012,13858,-3154
2019,4,19,1,17046,17123,14322,-2801
2019,4,19,2,16375,16487,14013,-2474
2019,4,19,3,15191,15396,13378,-2018
2019,4,19,4,13965,14244,12854,-1390
2019,4,19,5,13116,13356,11793,-1563
2019,4,19,6,12499,12802,11641,-1161
2019,4,19,7,12110,12445,11183,-1262
2019,4,19,8,11930,12308,11059,-1249
2019,4,19,9,11992,12425,11289,-1136
2019,4,19,10,12526,13004,11391,-1613
2019,4,19,11,13435,13999,12124,-1875
2019,4,19,12,14454,14974,12326,-2648
2019,4,19,13,15377,15730,12198,-3532
2019,4,19,14,15994,16282,12346,-3936
2019,4,19,15,16310,16601,13092,-3509
2019,4,19,16,16395,16587,12922,-3665
2019,4,19,17,16305,16570,12896,-3674
2019,4,19,18,16190,16534,12936,-3598
2019,4,19,19,16040,16570,13011,-3559
2019,4,19,20,15905,16607,13068,-3539
2019,4,19,21,15899,16819,13115,-3704
2019,4,19,22,15888,16927,12970,-3957
2019,4,19,23,15685,16832,12855,-3977
2019,4,20,0,15646,16833,12842,-3991
2019,4,20,1,15893,16683,12563,-4120
2019,4,20,2,15416,16048,12224,-3824
2019,4,20,3,14571,15193,11876,-3317
2019,4,20,4,13648,14196,11401,-2795
2019,4,20,5,13270,13401,10820,-2581
2019,4,20,6,12638,12831,10453,-2378
2019,4,20,7,12206,12449,10332,-2117
2019,4,20,8,11955,12268,10178,-2090
2019,4,20,9,11925,12257,10388,-1869
2019,4,20,10,12208,12441,10558,-1883
2019,4,20,11,12675,12878,10920,-1958
2019,4,20,12,13429,13600,11273,-2327
2019,4,20,13,14380,14539,11875,-2664
2019,4,20,14,15048,15340,12442,-2898
2019,4,20,15,15383,15791,13039,-2752
2019,4,20,16,15442,15938,13110,-2828
2019,4,20,17,15311,15872,12812,-3060
2019,4,20,18,15079,15670,12582,-3088
2019,4,20,19,14834,15473,12779,-2694
2019,4,20,20,14656,15329,12754,-2575
2019,4,20,21,14615,15323,12619,-2704
2019,4,20,22,14656,15365,12898,-2467
2019,4,20,23,14680,15453,12868,-2585
2019,4,21,0,14912,15605,12877,-2728
2019,4,21,1,15347,15849,12956,-2893
2019,4,21,2,14936,15432,12871,-2561
2019,4,21,3,14148,14698,12783,-1915
2019,4,21,4,13234,13838,12148,-1690
2019,4,21,5,12612,13044,10835,-2209
2019,4,21,6,12067,12517,10012,-2505
2019,4,21,7,11720,12184,10178,-2006
2019,4,21,8,11529,11989,10212,-1777
2019,4,21,9,11503,11951,10068,-1883
2019,4,21,10,11678,12132,10182,-1950
2019,4,21,11,11923,12366,10169,-2197
2019,4,21,12,12425,12933,10911,-2022
2019,4,21,13,13213,13658,11597,-2061
2019,4,21,14,13829,14182,11892,-2290
2019,4,21,15,14186,14408,11847,-2561
2019,4,21,16,14335,14533,11871,-2662
2019,4,21,17,14343,14695,11809,-2886
2019,4,21,18,14256,14501,11722,-2779
2019,4,21,19,14139,14170,11545,-2625
2019,4,21,20,14103,13953,11491,-2462
2019,4,21,21,14225,14036,11613,-2423
2019,4,21,22,14453,14234,11932,-2302
2019,4,21,23,14618,14487,12050,-2437
2019,4,22,0,14950,14941,11883,-3058
2019,4,22,1,15467,15480,12430,-3050
2019,4,22,2,15004,15090,12125,-2965
2019,4,22,3,14105,14340,11723,-2617
2019,4,22,4,13135,13502,10957,-2545
2019,4,22,5,12460,12811,10455,-2356
2019,4,22,6,12022,12388,9872,-2516
2019,4,22,7,11782,12141,9676,-2465
2019,4,22,8,11711,12080,9798,-2282
2019,4,22,9,11945,12282,10001,-2281
2019,4,22,10,12806,13007,10564,-2443
2019,4,22,11,14271,14237,11424,-2813
2019,4,22,12,15552,15298,12097,-3201
2019,4,22,13,16218,15944,12690,-3254
2019,4,22,14,16556,16299,13058,-3241
2019,4,22,15,16718,16605,12687,-3918
2019,4,22,16,16734,16687,12926,-3761
2019,4,22,17,16638,16626,12658,-3968
2019,4,22,18,16572,16650,12852,-3798
2019,4,22,19,16439,16667,12731,-3936
2019,4,22,20,16357,16554,12697,-3857
2019,4,22,21,16400,16623,12658,-3965
2019,4,22,22,16485,16819,12637,-4182
2019,4,22,23,16419,16797,12927,-3870
2019,4,23,0,16557,16857,13174,-3683
2019,4,23,1,16902,16985,12978,-4007
2019,4,23,2,16212,16275,12484,-3791
2019,4,23,3,14986,15117,11811,-3306
2019,4,23,4,13720,14051,11310,-2741
2019,4,23,5,12867,13218,10509,-2709
2019,4,23,6,12348,12728,10041,-2687
2019,4,23,7,12047,12436,10014,-2422
2019,4,23,8,11935,12302,9725,-2577
2019,4,23,9,12119,12508,9887,-2621
2019,4,23,10,12906,13278,10698,-2580
2019,4,23,11,14318,14513,11646,-2867
2019,4,23,12,15554,15496,12056,-3440
2019,4,23,13,16217,15920,12034,-3886
2019,4,23,14,16571,16087,11755,-4332
2019,4,23,15,16770,16193,11668,-4525
2019,4,23,16,16816,16314,11706,-4608
2019,4,23,17,16779,16319,11953,-4366
2019,4,23,18,16794,16473,12319,-4154
2019,4,23,19,16742,16606,12553,-4053
2019,4,23,20,16713,16703,12722,-3981
2019,4,23,21,16757,16867,12689,-4178
2019,4,23,22,16795,17065,13021,-4044
2019,4,23,23,16655,17027,13728,-3299
2019,4,24,0,16721,17123,14195,-2928
2019,4,24,1,17022,17043,13797,-3246
2019,4,24,2,16347,16234,13087,-3147
2019,4,24,3,15131,15169,12275,-2894
2019,4,24,4,13858,14066,11777,-2289
2019,4,24,5,12897,13279,11170,-2109
2019,4,24,6,12338,12853,10853,-2000
2019,4,24,7,12007,12550,10736,-1814
2019,4,24,8,11872,12408,10785,-1623
2019,4,24,9,12041,12567,11149,-1418
2019,4,24,10,12846,13261,11554,-1707
2019,4,24,11,14303,14569,12726,-1843
2019,4,24,12,15583,15681,13130,-2551
2019,4,24,13,16233,16210,13400,-2810
2019,4,24,14,16560,16430,13117,-3313
2019,4,24,15,16725,16504,13085,-3419
2019,4,24,16,16703,16459,12777,-3682
2019,4,24,17,16594,16336,13054,-3282
2019,4,24,18,16541,16309,13264,-3045
2019,4,24,19,16437,16245,13262,-2983
2019,4,24,20,16389,16315,13644,-2671
2019,4,24,21,16454,16504,13840,-2664
2019,4,24,22,16529,16767,13859,-2908
2019,4,24,23,16393,16748,13658,-3090
2019,4,25,0,16454,16871,13508,-3363
2019,4,25,1,16817,17131,13418,-3713
2019,4,25,2,16173,16498,12904,-3594
2019,4,25,3,14980,15300,12378,-2922
2019,4,25,4,13726,14139,11922,-2217
2019,4,25,5,12775,13272,10753,-2519
2019,4,25,6,12261,12735,10055,-2680
2019,4,25,7,11966,12409,9803,-2606
2019,4,25,8,11860,12293,9782,-2511
2019,4,25,9,12047,12510,10015,-2495
2019,4,25,10,12846,13358,11021,-2337
2019,4,25,11,14252,14659,11718,-2941
2019,4,25,12,15433,15531,12492,-3039
2019,4,25,13,15958,15846,12583,-3263
2019,4,25,14,16157,15912,12286,-3626
2019,4,25,15,16195,15933,12122,-3811
2019,4,25,16,16143,15935,12064,-3871
2019,4,25,17,15989,15850,12079,-3771
2019,4,25,18,15899,15855,12274,-3581
2019,4,25,19,15754,15894,12389,-3505
2019,4,25,20,15671,15969,12222,-3747
2019,4,25,21,15704,16205,12671,-3534
2019,4,25,22,15785,16384,12708,-3676
2019,4,25,23,15728,16350,12704,-3646
2019,4,26,0,15868,16511,13225,-3286
2019,4,26,1,16311,16664,13186,-3478
2019,4,26,2,15734,16008,12911,-3097
2019,4,26,3,14618,14908,12177,-2731
2019,4,26,4,13458,13831,11533,-2298
2019,4,26,5,12718,13001,10666,-2335
2019,4,26,6,12198,12538,10480,-2058
2019,4,26,7,11889,12241,10137,-2104
2019,4,26,8,11756,12103,10420,-1683
2019,4,26,9,11907,12310,10648,-1662
2019,4,26,10,12640,13098,11461,-1637
2019,4,26,11,13979,14403,12660,-1743
2019,4,26,12,15208,15568,13272,-2296
2019,4,26,13,15902,16350,13688,-2662
2019,4,26,14,16288,16794,13700,-3094
2019,4,26,15,16472,17108,14125,-2983
2019,4,26,16,16497,17253,14148,-3105
2019,4,26,17,16383,17271,14656,-2615
2019,4,26,18,16290,17327,14552,-2775
2019,4,26,19,16128,17131,14242,-2889
2019,4,26,20,16003,16949,14127,-2822
2019,4,26,21,15964,16993,14358,-2635
2019,4,26,22,15901,17049,14458,-2591
2019,4,26,23,15738,16982,14459,-2523
2019,4,27,0,15733,16996,14236,-2760
2019,4,27,1,16058,16833,14240,-2593
2019,4,27,2,15534,16199,14199,-2000
2019,4,27,3,14614,15252,13349,-1903
2019,4,27,4,13578,14263,12560,-1703
2019,4,27,5,12909,13471,11801,-1670
2019,4,27,6,12377,12897,11522,-1375
2019,4,27,7,12046,12535,11018,-1517
2019,4,27,8,11870,12400,10738,-1662
2019,4,27,9,11881,12425,10895,-1530
2019,4,27,10,12140,12695,11332,-1363
2019,4,27,11,12545,13205,12014,-1191
2019,4,27,12,13226,13948,12527,-1421
2019,4,27,13,14080,14643,12738,-1905
2019,4,27,14,14702,15166,13155,-2011
2019,4,27,15,15039,15429,13303,-2126
2019,4,27,16,15157,15448,13474,-1974
2019,4,27,17,15088,15512,13670,-1842
2019,4,27,18,14929,15497,13359,-2138
2019,4,27,19,14768,15433,13337,-2096
2019,4,27,20,14674,15210,12985,-2225
2019,4,27,21,14707,15246,13262,-1984
2019,4,27,22,14786,15402,13724,-1678
2019,4,27,23,14815,15578,13942,-1636
2019,4,28,0,14972,15786,14309,-1477
2019,4,28,1,15451,16155,14257,-1898
2019,4,28,2,15118,15808,13785,-2023
2019,4,28,3,14413,15087,13230,-1857
2019,4,28,4,13597,14235,12274,-1961
2019,4,28,5,12787,13465,11589,-1876
2019,4,28,6,12295,12904,11359,-1545
2019,4,28,7,12000,12545,11000,-1545
2019,4,28,8,11840,12320,10861,-1459
2019,4,28,9,11832,12313,10716,-1597
2019,4,28,10,12015,12491,10413,-2078
2019,4,28,11,12265,12788,11135,-1653
2019,4,28,12,12746,13374,11537,-1837
2019,4,28,13,13452,14200,12306,-1894
2019,4,28,14,14006,14888,12545,-2343
2019,4,28,15,14341,15294,12350,-2944
2019,4,28,16,14541,15585,12266,-3319
2019,4,28,17,14576,15495,11886,-3609
2019,4,28,18,14513,15398,11927,-3471
2019,4,28,19,14416,15215,12022,-3193
2019,4,28,20,14394,15098,12217,-2881
2019,4,28,21,14521,15295,12459,-2836
2019,4,28,22,14758,15594,12831,-2763
2019,4,28,23,14889,15760,13043,-2717
2019,4,29,0,15148,15893,13266,-2627
2019,4,29,1,15717,16380,13572,-2808
2019,4,29,2,15337,15861,13140,-2721
2019,4,29,3,14508,14918,12641,-2277
2019,4,29,4,13611,14019,11472,-2547
2019,4,29,5,12754,13293,10791,-2502
2019,4,29,6,12353,12915,10635,-2280
2019,4,29,7,12146,12700,10666,-2034
2019,4,29,8,12099,12675,10314,-2361
2019,4,29,9,12329,13020,10546,-2474
2019,4,29,10,13141,13940,10957,-2983
2019,4,29,11,14551,15465,12524,-2941
2019,4,29,12,15749,16460,13336,-3124
2019,4,29,13,16284,16632,13078,-3554
2019,4,29,14,16484,16582,12679,-3903
2019,4,29,15,16524,16480,13018,-3462
2019,4,29,16,16501,16365,13021,-3344
2019,4,29,17,16346,16213,13053,-3160
2019,4,29,18,16243,16186,12736,-3450
2019,4,29,19,16092,16191,12696,-3495
2019,4,29,20,15998,16380,13116,-3264
2019,4,29,21,16050,16633,13111,-3522
2019,4,29,22,16209,16872,13016,-3856
2019,4,29,23,16262,17145,13377,-3768
2019,4,30,0,16399,17310,13416,-3894
2019,4,30,1,16818,17374,14249,-3125
2019,4,30,2,16186,16590,13194,-3396
2019,4,30,3,15049,15403,12777,-2626
2019,4,30,4,13848,14225,11747,-2478
2019,4,30,5,12754,13406,10821,-2585
2019,4,30,6,12255,12867,10546,-2321
2019,4,30,7,11991,12566,10367,-2199
2019,4,30,8,11901,12479,10526,-1953
2019,4,30,9,12081,12745,10836,-1909
2019,4,30,10,12852,13609,11348,-2261
2019,4,30,11,14275,15141,12919,-2222
2019,4,30,12,15516,16378,13579,-2799
2019,4,30,13,16125,16869,13744,-3125
2019,4,30,14,16425,17181,13711,-3470
2019,4,30,15,16586,17401,13279,-4122
2019,4,30,16,16596,17307,13300,-4007
2019,4,30,17,16539,17115,13016,-4099
2019,4,30,18,16508,16934,12885,-4049
2019,4,30,19,16410,16804,13141,-3663
2019,4,30,20,16347,16686,13181,-3505
2019,4,30,21,16399,16712,13176,-3536
2019,4,30,22,16465,16774,13374,-3400
2019,4,30,23,16370,16789,13615,-3174
2019,5,1,0,16411,16946,13775,-3171
2019,5,1,1,16801,17311,14011,-3300
2019,5,1,2,16171,16647,13406,-3241
2019,5,1,3,15013,15464,12332,-3132
2019,5,1,4,13806,14231,11302,-2929
2019,5,1,5,12897,13327,10663,-2664
2019,5,1,6,12367,12851,10696,-2155
2019,5,1,7,12062,12574,10447,-2127
2019,5,1,8,11945,12480,10346,-2134
2019,5,1,9,12135,12713,10563,-2150
2019,5,1,10,12931,13564,11284,-2280
2019,5,1,11,14289,15120,12668,-2452
2019,5,1,12,15560,16387,13652,-2735
2019,5,1,13,16193,17019,13402,-3617
2019,5,1,14,16527,17186,13546,-3640
2019,5,1,15,16705,17256,13868,-3388
2019,5,1,16,16772,17252,13436,-3816
2019,5,1,17,16728,17068,12731,-4337
2019,5,1,18,16717,16972,13109,-3863
2019,5,1,19,16607,16875,12807,-4068
2019,5,1,20,16564,16933,13208,-3725
2019,5,1,21,16608,17116,13357,-3759
2019,5,1,22,16611,17299,13906,-3393
2019,5,1,23,16477,17271,13919,-3352
2019,5,2,0,16481,17327,14319,-3008
2019,5,2,1,16759,17355,14149,-3206
2019,5,2,2,16236,16616,14233,-2383
2019,5,2,3,15002,15453,13546,-1907
2019,5,2,4,13725,14228,12271,-1957
2019,5,2,5,12943,13397,11739,-1658
2019,5,2,6,12370,12894,11332,-1562
2019,5,2,7,12037,12561,11393,-1168
2019,5,2,8,11913,12430,11305,-1125
2019,5,2,9,12086,12629,11637,-992
2019,5,2,10,12849,13438,12320,-1118
2019,5,2,11,14188,14916,13345,-1571
2019,5,2,12,15494,16129,13982,-2147
2019,5,2,13,16205,16680,14021,-2659
2019,5,2,14,16636,16929,14000,-2929
2019,5,2,15,16881,16907,13908,-2999
2019,5,2,16,16941,16897,13872,-3025
2019,5,2,17,16928,16885,13532,-3353
2019,5,2,18,16940,16944,13542,-3402
2019,5,2,19,16846,17005,13505,-3500
2019,5,2,20,16788,17142,13684,-3458
2019,5,2,21,16794,17220,13824,-3396
2019,5,2,22,16775,17138,13943,-3195
2019,5,2,23,16572,17016,14208,-2808
2019,5,3,0,16551,17055,14367,-2688
2019,5,3,1,16815,17148,14602,-2546
2019,5,3,2,16300,16453,13825,-2628
2019,5,3,3,15068,15228,13041,-2187
2019,5,3,4,13781,14002,12099,-1903
2019,5,3,5,12900,13153,11260,-1893
2019,5,3,6,12335,12669,11004,-1665
2019,5,3,7,12019,12398,11071,-1327
2019,5,3,8,11895,12253,10844,-1409
2019,5,3,9,12044,12451,11212,-1239
2019,5,3,10,12790,13282,11667,-1615
2019,5,3,11,14101,14760,12812,-1948
2019,5,3,12,15446,16029,13798,-2231
2019,5,3,13,16180,16677,13865,-2812
2019,5,3,14,16633,16997,14111,-2886
2019,5,3,15,16892,17135,13783,-3352
2019,5,3,16,16971,17192,13765,-3427
2019,5,3,17,16919,16977,13744,-3233
2019,5,3,18,16907,16864,13956,-2908
2019,5,3,19,16812,16699,13831,-2868
2019,5,3,20,16711,16695,14051,-2644
2019,5,3,21,16696,16750,14022,-2728
2019,5,3,22,16595,16801,14175,-2626
2019,5,3,23,16345,16733,13942,-2791
2019,5,4,0,16217,16664,13840,-2824
2019,5,4,1,16377,16702,13940,-2762
2019,5,4,2,15906,16098,13658,-2440
2019,5,4,3,14938,15152,12994,-2158
2019,5,4,4,13840,14094,11651,-2443
2019,5,4,5,13051,13302,10670,-2632
2019,5,4,6,12434,12770,10343,-2427
2019,5,4,7,12054,12414,10210,-2204
2019,5,4,8,11848,12209,10192,-2017
2019,5,4,9,11833,12197,10514,-1683
2019,5,4,10,12095,12437,10722,-1715
2019,5,4,11,12452,12876,11221,-1655
2019,5,4,12,13219,13624,11996,-1628
2019,5,4,13,14128,14444,12515,-1929
2019,5,4,14,14780,14956,12964,-1992
2019,5,4,15,15127,15225,13115,-2110
2019,5,4,16,15213,15396,13415,-1981
2019,5,4,17,15150,15345,13032,-2313
2019,5,4,18,14998,15126,12652,-2474
2019,5,4,19,14847,14931,12259,-2672
2019,5,4,20,14763,14917,12445,-2472
2019,5,4,21,14864,15046,12608,-2438
2019,5,4,22,15011,15224,12881,-2343
2019,5,4,23,15075,15309,13133,-2176
2019,5,5,0,15225,15392,13302,-2090
2019,5,5,1,15581,15683,13454,-2229
2019,5,5,2,15325,15387,13047,-2340
2019,5,5,3,14570,14653,12312,-2341
2019,5,5,4,13656,13799,11247,-2552
2019,5,5,5,12643,13055,10250,-2805
2019,5,5,6,12117,12481,10097,-2384
2019,5,5,7,11758,12122,10061,-2061
2019,5,5,8,11561,11926,10092,-1834
2019,5,5,9,11527,11894,10172,-1722
2019,5,5,10,11678,12061,10191,-1870
2019,5,5,11,11823,12358,10597,-1761
2019,5,5,12,12357,12921,11025,-1896
2019,5,5,13,13076,13655,11526,-2129
2019,5,5,14,13735,14344,11702,-2642
2019,5,5,15,14142,14802,11653,-3149
2019,5,5,16,14295,15119,11857,-3262
2019,5,5,17,14322,15230,12025,-3205
2019,5,5,18,14271,15227,12072,-3155
2019,5,5,19,14163,15168,12022,-3146
2019,5,5,20,14149,15212,12071,-3141
2019,5,5,21,14315,15471,12287,-3184
2019,5,5,22,14540,15768,12432,-3336
2019,5,5,23,14739,15943,12724,-3219
2019,5,6,0,14899,16044,12626,-3418
2019,5,6,1,15398,16137,12763,-3374
2019,5,6,2,15126,15568,12240,-3328
2019,5,6,3,14195,14580,11680,-2900
2019,5,6,4,13183,13581,10764,-2817
2019,5,6,5,12391,12838,10269,-2569
2019,5,6,6,11937,12396,10293,-2103
2019,5,6,7,11680,12164,10389,-1775
2019,5,6,8,11598,12092,10441,-1651
2019,5,6,9,11818,12326,10662,-1664
2019,5,6,10,12646,13141,11254,-1887
2019,5,6,11,14022,14510,12722,-1788
2019,5,6,12,15336,15652,13630,-2022
2019,5,6,13,15975,16098,13888,-2210
2019,5,6,14,16294,16175,13754,-2421
2019,5,6,15,16468,16234,13546,-2688
2019,5,6,16,16494,16255,13743,-2512
2019,5,6,17,16469,16239,13690,-2549
2019,5,6,18,16492,16280,13497,-2783
2019,5,6,19,16454,16323,13705,-2618
2019,5,6,20,16475,16346,13828,-2518
2019,5,6,21,16630,16593,14317,-2276
2019,5,6,22,16680,16851,14260,-2591
2019,5,6,23,16576,16784,14280,-2504
2019,5,7,0,16514,16772,14180,-2592
2019,5,7,1,16795,16984,14559,-2425
2019,5,7,2,16292,16339,14601,-1738
2019,5,7,3,15043,15107,13507,-1600
2019,5,7,4,13722,13862,12204,-1658
2019,5,7,5,12730,12992,11522,-1470
2019,5,7,6,12151,12473,10882,-1591
2019,5,7,7,11819,12147,10743,-1404
2019,5,7,8,11684,12042,10663,-1379
2019,5,7,9,11853,12201,10780,-1421
2019,5,7,10,12605,12998,11374,-1624
2019,5,7,11,13972,14433,12785,-1648
2019,5,7,12,15324,15639,13808,-1831
2019,5,7,13,16047,16209,14220,-1989
2019,5,7,14,16445,16430,14399,-2031
2019,5,7,15,16705,16641,14722,-1919
2019,5,7,16,16825,16586,14563,-2023
2019,5,7,17,16810,16581,14294,-2287
2019,5,7,18,16830,16664,14365,-2299
2019,5,7,19,16826,16706,14280,-2426
2019,5,7,20,16872,16770,14326,-2444
2019,5,7,21,16965,17006,14612,-2394
2019,5,7,22,16908,17202,14871,-2331
2019,5,7,23,16705,17111,14947,-2164
2019,5,8,0,16580,17077,14852,-2225
2019,5,8,1,16814,17244,14806,-2438
2019,5,8,2,16315,16598,14611,-1987
2019,5,8,3,15085,15398,13464,-1934
2019,5,8,4,13766,14095,12504,-1591
2019,5,8,5,12717,13269,11382,-1887
2019,5,8,6,12181,12750,10816,-1934
2019,5,8,7,11896,12471,10697,-1774
2019,5,8,8,11791,12371,10523,-1848
2019,5,8,9,11967,12538,10667,-1871
2019,5,8,10,12716,13325,11410,-1915
2019,5,8,11,14052,14676,12603,-2073
2019,5,8,12,15330,15766,13527,-2239
2019,5,8,13,15854,16165,13941,-2224
2019,5,8,14,16117,16309,13548,-2761
2019,5,8,15,16234,16289,13444,-2845
2019,5,8,16,16264,16217,13500,-2717
2019,5,8,17,16234,16133,13498,-2635
2019,5,8,18,16252,16162,13560,-2602
2019,5,8,19,16246,16146,13664,-2482
2019,5,8,20,16302,16229,13993,-2236
2019,5,8,21,16421,16479,14278,-2201
2019,5,8,22,16430,16697,14417,-2280
2019,5,8,23,16292,16720,14307,-2413
2019,5,9,0,16189,16718,14397,-2321
2019,5,9,1,16472,17002,14673,-2329
2019,5,9,2,16048,16514,14301,-2213
2019,5,9,3,14889,15307,12826,-2481
2019,5,9,4,13645,14079,11644,-2435
2019,5,9,5,12697,13243,10858,-2385
2019,5,9,6,12176,12697,10850,-1847
2019,5,9,7,11880,12417,10671,-1746
2019,5,9,8,11785,12309,10889,-1420
2019,5,9,9,11962,12510,11165,-1345
2019,5,9,10,12705,13249,11436,-1813
2019,5,9,11,14054,14626,12517,-2109
2019,5,9,12,15363,15759,13977,-1782
2019,5,9,13,15966,16267,13888,-2379
2019,5,9,14,16318,16455,14147,-2308
2019,5,9,15,16522,16513,14148,-2365
2019,5,9,16,16561,16577,14356,-2221
2019,5,9,17,16526,16536,14772,-1764
2019,5,9,18,16526,16547,14538,-2009
2019,5,9,19,16482,16603,14847,-1756
2019,5,9,20,16466,16682,14993,-1689
2019,5,9,21,16584,16853,15129,-1724
2019,5,9,22,16627,16962,15015,-1947
2019,5,9,23,16497,16942,15070,-1872
2019,5,10,0,16355,16975,15176,-1799
2019,5,10,1,16541,17024,15280,-1744
2019,5,10,2,16063,16390,14474,-1916
2019,5,10,3,14898,15219,13530,-1689
2019,5,10,4,13662,14066,12110,-1956
2019,5,10,5,12794,13198,11720,-1478
2019,5,10,6,12217,12712,11427,-1285
2019,5,10,7,11881,12389,11487,-902
2019,5,10,8,11740,12318,11617,-701
2019,5,10,9,11881,12504,11759,-745
2019,5,10,10,12574,13277,12224,-1053
2019,5,10,11,13945,14703,13140,-1563
2019,5,10,12,15413,15997,14184,-1813
2019,5,10,13,16297,16747,14534,-2213
2019,5,10,14,16756,17111,14935,-2176
2019,5,10,15,16996,17295,14887,-2408
2019,5,10,16,17045,17395,15009,-2386
2019,5,10,17,16966,17393,14856,-2537
2019,5,10,18,16930,17363,14624,-2739
2019,5,10,19,16817,17238,14578,-2660
2019,5,10,20,16704,17101,14528,-2573
2019,5,10,21,16695,17095,14659,-2436
2019,5,10,22,16646,17181,14887,-2294
2019,5,10,23,16411,17039,14693,-2346
2019,5,11,0,16257,16959,14725,-2234
2019,5,11,1,16368,17004,14668,-2336
2019,5,11,2,15998,16516,14247,-2269
2019,5,11,3,15068,15567,13300,-2267
2019,5,11,4,13959,14458,12608,-1850
2019,5,11,5,13070,13578,11635,-1943
2019,5,11,6,12476,12987,11264,-1723
2019,5,11,7,12100,12560,11006,-1554
2019,5,11,8,11899,12335,10777,-1558
2019,5,11,9,11878,12293,10995,-1298
2019,5,11,10,12070,12397,10877,-1520
2019,5,11,11,12393,12769,10860,-1909
2019,5,11,12,13113,13467,11203,-2264
2019,5,11,13,13839,14098,11706,-2392
2019,5,11,14,14381,14454,12174,-2280
2019,5,11,15,14591,14463,12204,-2259
2019,5,11,16,14607,14397,12131,-2266
2019,5,11,17,14512,14249,11972,-2277
2019,5,11,18,14368,14085,12343,-1742
2019,5,11,19,14260,13995,12515,-1480
2019,5,11,20,14213,14055,12484,-1571
2019,5,11,21,14375,14338,12805,-1533
2019,5,11,22,14612,14792,13136,-1656
2019,5,11,23,14780,15085,12903,-2182
2019,5,12,0,14928,15267,12952,-2315
2019,5,12,1,15298,15580,13146,-2434
2019,5,12,2,15129,15295,13065,-2230
2019,5,12,3,14386,14632,12587,-2045
2019,5,12,4,13488,13771,11957,-1814
2019,5,12,5,12711,13048,11089,-1959
2019,5,12,6,12131,12505,10598,-1907
2019,5,12,7,11791,12128,10664,-1464
2019,5,12,8,11612,11965,10697,-1268
2019,5,12,9,11601,11937,10816,-1121
2019,5,12,10,11717,12100,10992,-1108
2019,5,12,11,11922,12367,11042,-1325
2019,5,12,12,12568,13001,11368,-1633
2019,5,12,13,13372,13928,11922,-2006
2019,5,12,14,14109,14727,12421,-2306
2019,5,12,15,14596,15219,12850,-2369
2019,5,12,16,14847,15519,12976,-2543
2019,5,12,17,14936,15577,12955,-2622
2019,5,12,18,14925,15555,12665,-2890
2019,5,12,19,14863,15529,12731,-2798
2019,5,12,20,14886,15539,12707,-2832
2019,5,12,21,15041,15630,12987,-2643
2019,5,12,22,15245,15761,13261,-2500
2019,5,12,23,15306,15877,13400,-2477
2019,5,13,0,15388,16095,13662,-2433
2019,5,13,1,15743,16330,13848,-2482
2019,5,13,2,15424,15844,13468,-2376
2019,5,13,3,14486,14901,12843,-2058
2019,5,13,4,13483,13954,12111,-1843
2019,5,13,5,12612,13194,11548,-1646
2019,5,13,6,12147,12729,11543,-1186
2019,5,13,7,11892,12477,11534,-943
2019,5,13,8,11810,12443,11341,-1102
2019,5,13,9,12044,12654,11231,-1423
2019,5,13,10,12825,13487,11897,-1590
2019,5,13,11,14253,14978,12969,-2009
2019,5,13,12,15727,16346,14524,-1822
2019,5,13,13,16550,17082,15261,-1821
2019,5,13,14,17027,17429,15357,-2072
2019,5,13,15,17342,17629,15313,-2316
2019,5,13,16,17451,17726,15552,-2174
2019,5,13,17,17467,17773,15370,-2403
2019,5,13,18,17481,17834,15507,-2327
2019,5,13,19,17386,17813,15514,-2299
2019,5,13,20,17314,17787,15301,-2486
2019,5,13,21,17343,17960,15325,-2635
2019,5,13,22,17319,18234,15484,-2750
2019,5,13,23,17145,18158,15344,-2814
2019,5,14,0,16905,17906,15305,-2601
2019,5,14,1,17018,17771,15212,-2559
2019,5,14,2,16504,16966,15023,-1943
2019,5,14,3,15260,15739,13632,-2107
2019,5,14,4,13966,14569,12259,-2310
2019,5,14,5,13049,13711,11588,-2123
2019,5,14,6,12535,13221,11366,-1855
2019,5,14,7,12245,12913,11138,-1775
2019,5,14,8,12136,12827,11081,-1746
2019,5,14,9,12335,13046,11223,-1823
2019,5,14,10,13062,13875,11848,-2027
2019,5,14,11,14455,15336,13184,-2152
2019,5,14,12,15814,16532,14048,-2484
2019,5,14,13,16495,17118,14439,-2679
2019,5,14,14,16879,17429,14743,-2686
2019,5,14,15,17121,17552,14715,-2837
2019,5,14,16,17169,17507,14337,-3170
2019,5,14,17,17094,17405,14209,-3196
2019,5,14,18,17048,17369,14432,-2937
2019,5,14,19,16928,17280,14224,-3056
2019,5,14,20,16856,17284,14306,-2978
2019,5,14,21,16890,17479,14868,-2611
2019,5,14,22,16889,17673,14851,-2822
2019,5,14,23,16761,17673,14668,-3005
2019,5,15,0,16528,17644,14837,-2807
2019,5,15,1,16688,17636,15036,-2600
2019,5,15,2,16265,16989,14813,-2176
2019,5,15,3,15102,15753,13492,-2261
2019,5,15,4,13866,14531,12398,-2133
2019,5,15,5,13018,13680,11420,-2260
2019,5,15,6,12512,13168,11081,-2087
2019,5,15,7,12230,12899,11061,-1838
2019,5,15,8,12131,12814,11053,-1761
2019,5,15,9,12304,13044,11113,-1931
2019,5,15,10,12985,13828,11481,-2347
2019,5,15,11,14290,15216,12602,-2614
2019,5,15,12,15506,16193,13647,-2546
2019,5,15,13,15963,16451,13713,-2738
2019,5,15,14,16140,16475,13654,-2821
2019,5,15,15,16183,16392,13720,-2672
2019,5,15,16,16121,16285,13546,-2739
2019,5,15,17,16012,16196,13421,-2775
2019,5,15,18,15969,16207,12971,-3236
2019,5,15,19,15936,16180,12959,-3221
2019,5,15,20,15979,16343,13613,-2730
2019,5,15,21,16093,16568,13789,-2779
2019,5,15,22,16210,16796,14274,-2522
2019,5,15,23,16178,16806,14336,-2470
2019,5,16,0,16025,16773,14395,-2378
2019,5,16,1,16271,16962,14427,-2535
2019,5,16,2,15956,16498,14033,-2465
2019,5,16,3,14869,15360,12664,-2696
2019,5,16,4,13680,14169,11462,-2707
2019,5,16,5,12845,13285,10988,-2297
2019,5,16,6,12333,12766,10809,-1957
2019,5,16,7,12033,12455,10635,-1820
2019,5,16,8,11925,12381,10617,-1764
2019,5,16,9,12081,12574,10814,-1760
2019,5,16,10,12748,13318,11139,-2179
2019,5,16,11,14080,14696,12044,-2652
2019,5,16,12,15382,15820,13027,-2793
2019,5,16,13,15932,16215,13376,-2839
2019,5,16,14,16225,16326,13673,-2653
2019,5,16,15,16353,16371,13719,-2652
2019,5,16,16,16345,16349,13765,-2584
2019,5,16,17,16273,16355,13684,-2671
2019,5,16,18,16248,16405,13973,-2432
2019,5,16,19,16193,16363,13572,-2791
2019,5,16,20,16191,16439,13770,-2669
2019,5,16,21,16322,16695,14690,-2005
2019,5,16,22,16452,16867,14516,-2351
2019,5,16,23,16356,16805,14345,-2460
2019,5,17,0,16259,16792,14353,-2439
2019,5,17,1,16472,16978,14240,-2738
2019,5,17,2,16122,16511,14046,-2465
2019,5,17,3,15011,15390,12949,-2441
2019,5,17,4,13799,14194,11979,-2215
2019,5,17,5,12875,13297,11455,-1842
2019,5,17,6,12292,12740,11119,-1621
2019,5,17,7,11954,12436,11426,-1010
2019,5,17,8,11812,12335,11749,-586
2019,5,17,9,11950,12482,11720,-762
2019,5,17,10,12573,13185,12002,-1183
2019,5,17,11,13917,14515,12549,-1966
2019,5,17,12,15371,15771,13347,-2424
2019,5,17,13,16191,16430,14143,-2287
2019,5,17,14,16715,16689,14453,-2236
2019,5,17,15,17059,17009,14686,-2323
2019,5,17,16,17187,17276,14946,-2330
2019,5,17,17,17161,17424,14828,-2596
2019,5,17,18,17159,17442,15068,-2374
2019,5,17,19,17050,17250,15126,-2124
2019,5,17,20,16935,17175,14980,-2195
2019,5,17,21,16924,17293,15690,-1603
2019,5,17,22,16905,17275,15593,-1682
2019,5,17,23,16559,17071,15319,-1752
2019,5,18,0,16443,16938,15143,-1795
2019,5,18,1,16517,16985,14969,-2016
2019,5,18,2,16200,16659,14471,-2188
2019,5,18,3,15256,15691,13328,-2363
2019,5,18,4,14149,14582,12089,-2493
2019,5,18,5,12968,13548,11241,-2307
2019,5,18,6,12287,12867,10989,-1878
2019,5,18,7,11830,12422,10745,-1677
2019,5,18,8,11571,12181,10708,-1473
2019,5,18,9,11522,12154,10982,-1172
2019,5,18,10,11637,12230,10951,-1279
2019,5,18,11,11972,12645,10892,-1753
2019,5,18,12,12760,13327,11655,-1672
2019,5,18,13,13695,13996,12099,-1897
2019,5,18,14,14309,14318,11801,-2517
2019,5,18,15,14663,14491,12130,-2361
2019,5,18,16,14788,14636,12267,-2369
2019,5,18,17,14733,14602,12552,-2050
2019,5,18,18,14636,14583,12655,-1928
2019,5,18,19,14556,14603,12596,-2007
2019,5,18,20,14527,14747,13026,-1721
2019,5,18,21,14666,15033,12719,-2314
2019,5,18,22,14870,15301,12877,-2424
2019,5,18,23,14973,15415,13176,-2239
2019,5,19,0,15005,15374,13484,-1890
2019,5,19,1,15274,15622,13325,-2297
2019,5,19,2,15145,15466,12847,-2619
2019,5,19,3,14362,14747,12374,-2373
2019,5,19,4,13383,13859,12028,-1831
2019,5,19,5,12582,13030,11390,-1640
2019,5,19,6,11927,12440,11092,-1348
2019,5,19,7,11541,12087,10907,-1180
2019,5,19,8,11331,11905,11044,-861
2019,5,19,9,11293,11854,11189,-665
2019,5,19,10,11321,11922,10792,-1130
2019,5,19,11,11480,12125,11274,-851
2019,5,19,12,12112,12814,11662,-1152
2019,5,19,13,12970,13640,11547,-2093
2019,5,19,14,13772,14287,12124,-2163
2019,5,19,15,14386,14657,12202,-2455
2019,5,19,16,14772,14936,12561,-2375
2019,5,19,17,14976,15227,12258,-2969
2019,5,19,18,15078,15606,12680,-2926
2019,5,19,19,15165,15956,12963,-2993
2019,5,19,20,15357,16306,13265,-3041
2019,5,19,21,15677,16853,13462,-3391
2019,5,19,22,16048,17373,13834,-3539
2019,5,19,23,16121,17556,14076,-3480
2019,5,20,0,16217,17586,14530,-3056
2019,5,20,1,16497,17789,14780,-3009
2019,5,20,2,16238,17229,14014,-3215
2019,5,20,3,15233,16155,13137,-3018
2019,5,20,4,14108,15058,12839,-2219
2019,5,20,5,13298,14185,12454,-1731
2019,5,20,6,12802,13621,12180,-1441
2019,5,20,7,12509,13235,11810,-1425
2019,5,20,8,12389,13116,11518,-1598
2019,5,20,9,12598,13249,11872,-1377
2019,5,20,10,13353,13978,12506,-1472
2019,5,20,11,14873,15415,13865,-1550
2019,5,20,12,16514,16792,14451,-2341
2019,5,20,13,17538,17778,14939,-2839
2019,5,20,14,18158,18361,15475,-2886
2019,5,20,15,18617,18902,15812,-3090
2019,5,20,16,18924,19449,16393,-3056
2019,5,20,17,19072,19799,17030,-2769
2019,5,20,18,19214,20003,16966,-3037
2019,5,20,19,19248,20113,16909,-3204
2019,5,20,20,19262,20312,17306,-3006
2019,5,20,21,19263,20524,17587,-2937
2019,5,20,22,19202,20523,17801,-2722
2019,5,20,23,18813,20252,17567,-2685
2019,5,21,0,18423,19868,17556,-2312
2019,5,21,1,18315,19666,17134,-2532
2019,5,21,2,17771,18837,16248,-2589
2019,5,21,3,16408,17385,14932,-2453
2019,5,21,4,14920,15777,13744,-2033
2019,5,21,5,13831,14525,12707,-1818
2019,5,21,6,13058,13767,12252,-1515
2019,5,21,7,12502,13202,11795,-1407
2019,5,21,8,12199,12922,11795,-1127
2019,5,21,9,12265,13002,11906,-1096
2019,5,21,10,12866,13605,12464,-1141
2019,5,21,11,14233,14862,13110,-1752
2019,5,21,12,15591,15934,14024,-1910
2019,5,21,13,16362,16362,14532,-1830
2019,5,21,14,16615,16474,14370,-2104
2019,5,21,15,16768,16554,14313,-2241
2019,5,21,16,16827,16642,14250,-2392
2019,5,21,17,16823,16680,14799,-1881
2019,5,21,18,16911,16762,15093,-1669
2019,5,21,19,16940,16813,14995,-1818
2019,5,21,20,16979,17032,14740,-2292
2019,5,21,21,17112,17390,15054,-2336
2019,5,21,22,17208,17647,15226,-2421
2019,5,21,23,17099,17504,15140,-2364
2019,5,22,0,16829,17251,15213,-2038
2019,5,22,1,17054,17191,15058,-2133
2019,5,22,2,16673,16747,14479,-2268
2019,5,22,3,15325,15517,13705,-1812
2019,5,22,4,13810,14204,12459,-1745
2019,5,22,5,12920,13305,11834,-1471
2019,5,22,6,12227,12744,11589,-1155
2019,5,22,7,11896,12444,11509,-935
2019,5,22,8,11774,12306,11810,-496
2019,5,22,9,11945,12417,12059,-358
2019,5,22,10,12598,13085,12200,-885
2019,5,22,11,13960,14479,12658,-1821
2019,5,22,12,15311,15614,12964,-2650
2019,5,22,13,15904,16132,13299,-2833
2019,5,22,14,16208,16342,13441,-2901
2019,5,22,15,16395,16507,13485,-3022
2019,5,22,16,16537,16659,13640,-3019
2019,5,22,17,16588,16753,13872,-2881
2019,5,22,18,16679,16945,13996,-2949
2019,5,22,19,16721,17166,14360,-2806
2019,5,22,20,16809,17453,14872,-2581
2019,5,22,21,16972,17746,15115,-2631
2019,5,22,22,17116,17902,15181,-2721
2019,5,22,23,16897,17726,15355,-2371
2019,5,23,0,16785,17544,15399,-2145
2019,5,23,1,16958,17535,15882,-1653
2019,5,23,2,16578,16995,15208,-1787
2019,5,23,3,15353,15830,14352,-1478
2019,5,23,4,14005,14530,12703,-1827
2019,5,23,5,12896,13619,12180,-1439
2019,5,23,6,12291,13074,12118,-956
2019,5,23,7,11949,12715,11841,-874
2019,5,23,8,11823,12592,11822,-770
2019,5,23,9,11982,12726,11791,-935
2019,5,23,10,12646,13393,12363,-1030
2019,5,23,11,14058,14787,13199,-1588
2019,5,23,12,15507,16064,13800,-2264
2019,5,23,13,16278,16775,14286,-2489
2019,5,23,14,16769,17029,14302,-2727
2019,5,23,15,17123,17281,14125,-3156
2019,5,23,16,17317,17509,14498,-3011
2019,5,23,17,17390,17560,14383,-3177
2019,5,23,18,17486,17760,14587,-3173
2019,5,23,19,17523,17927,14398,-3529
2019,5,23,20,17550,18189,15193,-2996
2019,5,23,21,17662,18372,15620,-2752
2019,5,23,22,17721,18391,15935,-2456
2019,5,23,23,17407,18145,15647,-2498
2019,5,24,0,17326,17912,15499,-2413
2019,5,24,1,17442,17812,15503,-2309
2019,5,24,2,17077,17407,14886,-2521
2019,5,24,3,15904,16295,13763,-2532
2019,5,24,4,14610,15081,12853,-2228
2019,5,24,5,13672,14202,12836,-1366
2019,5,24,6,13040,13580,12294,-1286
2019,5,24,7,12616,13195,12100,-1095
2019,5,24,8,12381,12979,11756,-1223
2019,5,24,9,12428,13042,11921,-1121
2019,5,24,10,12932,13560,12575,-985
2019,5,24,11,14145,14752,13671,-1081
2019,5,24,12,15537,15986,14477,-1509
2019,5,24,13,16357,16752,14442,-2310
2019,5,24,14,16896,17253,14874,-2379
2019,5,24,15,17202,17478,15125,-2353
2019,5,24,16,17290,17670,15009,-2661
2019,5,24,17,17261,17724,14931,-2793
2019,5,24,18,17300,17775,14898,-2877
2019,5,24,19,17287,17707,14940,-2767
2019,5,24,20,17345,17719,14942,-2777
2019,5,24,21,17519,17829,15302,-2527
2019,5,24,22,17496,17845,15526,-2319
2019,5,24,23,17216,17604,15359,-2245
2019,5,25,0,16746,17280,15298,-1982
2019,5,25,1,16494,17133,15135,-1998
2019,5,25,2,16215,16739,14399,-2340
2019,5,25,3,15285,15774,13185,-2589
2019,5,25,4,14133,14742,12123,-2619
2019,5,25,5,13246,13733,11492,-2241
2019,5,25,6,12577,13086,11133,-1953
2019,5,25,7,12149,12689,11055,-1634
2019,5,25,8,11907,12484,11197,-1287
2019,5,25,9,11840,12364,11414,-950
2019,5,25,10,11890,12315,11425,-890
2019,5,25,11,12200,12607,11483,-1124
2019,5,25,12,12936,13314,11869,-1445
2019,5,25,13,13800,14040,12304,-1736
2019,5,25,14,14476,14602,12785,-1817
2019,5,25,15,14887,14922,12916,-2006
2019,5,25,16,15072,15127,12837,-2290
2019,5,25,17,15126,15256,12829,-2427
2019,5,25,18,15087,15261,12898,-2363
2019,5,25,19,15078,15351,12965,-2386
2019,5,25,20,15162,15452,12789,-2663
2019,5,25,21,15418,15720,13453,-2267
2019,5,25,22,15604,15928,13823,-2105
2019,5,25,23,15656,15941,13978,-1963
2019,5,26,0,15509,15953,14229,-1724
2019,5,26,1,15560,16090,14199,-1891
2019,5,26,2,15477,15824,13457,-2367
2019,5,26,3,14825,15102,12981,-2121
2019,5,26,4,13989,14213,12726,-1487
2019,5,26,5,13176,13444,11692,-1752
2019,5,26,6,12486,12861,11216,-1645
2019,5,26,7,12076,12475,11233,-1242
2019,5,26,8,11843,12266,10929,-1337
2019,5,26,9,11739,12202,10879,-1323
2019,5,26,10,11668,12168,11105,-1063
2019,5,26,11,11763,12398,11828,-570
2019,5,26,12,12343,13067,12085,-982
2019,5,26,13,13435,13981,12125,-1856
2019,5,26,14,14424,14863,12397,-2466
2019,5,26,15,15266,15673,12501,-3172
2019,5,26,16,16044,16424,12900,-3524
2019,5,26,17,16605,16959,13753,-3206
2019,5,26,18,16958,17396,14219,-3177
2019,5,26,19,17189,17763,14452,-3311
2019,5,26,20,17448,18146,14703,-3443
2019,5,26,21,17771,18327,14244,-4083
2019,5,26,22,17911,18388,14569,-3819
2019,5,26,23,17686,17908,14431,-3477
2019,5,27,0,17430,17564,14351,-3213
2019,5,27,1,17481,17510,14397,-3113
2019,5,27,2,17403,17320,13854,-3466
2019,5,27,3,16498,16530,13437,-3093
2019,5,27,4,15298,15516,12956,-2560
2019,5,27,5,13861,14611,12355,-2256
2019,5,27,6,13138,13878,12339,-1539
2019,5,27,7,12607,13354,12144,-1210
2019,5,27,8,12274,13026,11678,-1348
2019,5,27,9,12168,12857,11545,-1312
2019,5,27,10,12198,12827,11715,-1112
2019,5,27,11,12404,13142,11850,-1292
2019,5,27,12,13117,13949,12108,-1841
2019,5,27,13,14172,14770,12641,-2129
2019,5,27,14,15049,15434,12675,-2759
2019,5,27,15,15741,15959,12914,-3045
2019,5,27,16,16235,16429,13483,-2946
2019,5,27,17,16570,16747,14210,-2537
2019,5,27,18,16736,16968,14298,-2670
2019,5,27,19,16806,17179,14409,-2770
2019,5,27,20,16887,17492,14549,-2943
2019,5,27,21,17047,17842,14801,-3041
2019,5,27,22,17225,18196,15019,-3177
2019,5,27,23,17187,18263,15274,-2989
2019,5,28,0,16848,18093,15107,-2986
2019,5,28,1,16947,18088,15237,-2851
2019,5,28,2,16761,17701,14526,-3175
2019,5,28,3,15578,16494,13590,-2904
2019,5,28,4,14199,15311,12952,-2359
2019,5,28,5,13162,14342,11889,-2453
2019,5,28,6,12544,13718,11622,-2096
2019,5,28,7,12195,13394,11266,-2128
2019,5,28,8,12046,13249,11150,-2099
2019,5,28,9,12190,13363,11167,-2196
2019,5,28,10,12829,13967,11785,-2182
2019,5,28,11,14222,15264,13160,-2104
2019,5,28,12,15794,16569,14235,-2334
2019,5,28,13,16708,17490,15246,-2244
2019,5,28,14,17230,18175,15632,-2543
2019,5,28,15,17528,18599,15765,-2834
2019,5,28,16,17622,18700,15842,-2858
2019,5,28,17,17623,18575,16115,-2460
2019,5,28,18,17637,18672,16289,-2383
2019,5,28,19,17498,18580,15872,-2708
2019,5,28,20,17393,18524,16005,-2519
2019,5,28,21,17472,18602,15640,-2962
2019,5,28,22,17528,18757,15999,-2758
2019,5,28,23,17509,18510,16206,-2304
2019,5,29,0,17194,18323,16150,-2173
2019,5,29,1,17190,18256,16308,-1948
2019,5,29,2,16840,17681,15354,-2327
2019,5,29,3,15625,16480,13675,-2805
2019,5,29,4,14277,15293,13029,-2264
2019,5,29,5,13816,14367,12120,-2247
2019,5,29,6,13126,13831,12018,-1813
2019,5,29,7,12739,13459,11512,-1947
2019,5,29,8,12559,13304,11474,-1830
2019,5,29,9,12670,13400,11594,-1806
2019,5,29,10,13286,14089,12207,-1882
2019,5,29,11,14665,15466,13568,-1898
2019,5,29,12,16095,16734,14877,-1857
2019,5,29,13,16975,17313,15119,-2194
2019,5,29,14,17446,17541,15463,-2078
2019,5,29,15,17766,17782,15674,-2108
2019,5,29,16,17945,17878,16395,-1483
2019,5,29,17,18012,18046,15997,-2049
2019,5,29,18,18159,18089,15618,-2471
2019,5,29,19,18256,18024,15369,-2655
2019,5,29,20,18413,18007,15685,-2322
2019,5,29,21,18599,18086,15760,-2326
2019,5,29,22,18519,18161,16106,-2055
2019,5,29,23,18044,17979,15808,-2171
2019,5,30,0,17700,17626,15774,-1852
2019,5,30,1,17564,17383,15718,-1665
2019,5,30,2,17236,16824,15356,-1468
2019,5,30,3,16057,15701,14506,-1195
2019,5,30,4,14708,14517,13303,-1214
2019,5,30,5,13737,13515,12505,-1010
2019,5,30,6,13077,13011,12567,-444
2019,5,30,7,12699,12689,12350,-339
2019,5,30,8,12535,12553,12239,-314
2019,5,30,9,12667,12707,12165,-542
2019,5,30,10,13308,13392,12833,-559
2019,5,30,11,14729,14861,14071,-790
2019,5,30,12,16241,16211,14979,-1232
2019,5,30,13,17255,16945,14952,-1993
2019,5,30,14,17898,17427,15264,-2163
2019,5,30,15,18377,17699,15421,-2278
2019,5,30,16,18718,17717,15336,-2381
2019,5,30,17,18961,17776,15316,-2460
2019,5,30,18,19239,17801,15361,-2440
2019,5,30,19,19432,17847,15739,-2108
2019,5,30,20,19632,17917,16094,-1823
2019,5,30,21,19810,17990,15959,-2031
2019,5,30,22,19678,18158,16286,-1872
2019,5,30,23,19140,18133,16438,-1695
2019,5,31,0,18729,17961,16236,-1725
2019,5,31,1,18548,17746,15931,-1815
2019,5,31,2,18183,17188,15561,-1627
2019,5,31,3,16983,16056,14747,-1309
2019,5,31,4,15582,14862,13843,-1019
2019,5,31,5,13689,13891,12590,-1301
2019,5,31,6,13063,13311,12305,-1006
2019,5,31,7,12655,12954,12192,-762
2019,5,31,8,12450,12818,12101,-717
2019,5,31,9,12529,12957,12200,-757
2019,5,31,10,13082,13560,12619,-941
2019,5,31,11,14409,15092,13833,-1259
2019,5,31,12,15903,16478,14864,-1614
2019,5,31,13,16851,17346,15034,-2312
2019,5,31,14,17471,17817,15242,-2575
2019,5,31,15,17893,18165,15425,-2740
2019,5,31,16,18175,18428,15397,-3031
2019,5,31,17,18348,18635,15383,-3252
2019,5,31,18,18535,18997,15794,-3203
2019,5,31,19,18668,19218,16430,-2788
2019,5,31,20,18833,19453,16121,-3332
2019,5,31,21,19029,19619,16582,-3037
2019,5,31,22,19005,19626,16739,-2887
2019,5,31,23,18597,19236,16935,-2301
2019,6,1,0,18011,18778,16864,-1914
2019,6,1,1,17616,18495,16298,-2197
2019,6,1,2,17327,18088,15335,-2753
2019,6,1,3,16306,17076,13788,-3288
2019,6,1,4,15041,15848,12895,-2953
2019,6,1,5,13881,14816,12113,-2703
2019,6,1,6,13131,14058,11887,-2171
2019,6,1,7,12623,13536,11731,-1805
2019,6,1,8,12317,13248,11725,-1523
2019,6,1,9,12224,13155,11619,-1536
2019,6,1,10,12240,13199,11833,-1366
2019,6,1,11,12613,13541,11827,-1714
2019,6,1,12,13523,14344,11917,-2427
2019,6,1,13,14682,15303,12679,-2624
2019,6,1,14,15582,15997,13453,-2544
2019,6,1,15,16254,16471,13980,-2491
2019,6,1,16,16721,16811,14417,-2394
2019,6,1,17,16994,17077,14451,-2626
2019,6,1,18,17122,17239,14437,-2802
2019,6,1,19,17214,17414,14424,-2990
2019,6,1,20,17311,17584,14674,-2910
2019,6,1,21,17472,17825,15153,-2672
2019,6,1,22,17529,17981,15110,-2871
2019,6,1,23,17340,17842,14973,-2869
2019,6,2,0,16972,17609,14989,-2620
2019,6,2,1,16808,17591,14877,-2714
2019,6,2,2,16684,17310,14452,-2858
2019,6,2,3,15899,16495,14080,-2415
2019,6,2,4,14859,15528,13231,-2297
2019,6,2,5,14032,14621,12191,-2430
2019,6,2,6,13256,13958,12100,-1858
2019,6,2,7,12731,13473,12052,-1421
2019,6,2,8,12392,13145,12073,-1072
2019,6,2,9,12243,13036,12097,-939
2019,6,2,10,12178,12989,12160,-829
2019,6,2,11,12425,13162,12140,-1022
2019,6,2,12,13178,13822,12228,-1594
2019,6,2,13,14302,14695,12536,-2159
2019,6,2,14,15245,15622,12855,-2767
2019,6,2,15,16027,16348,13534,-2814
2019,6,2,16,16578,16937,14215,-2722
2019,6,2,17,16880,17384,13987,-3397
2019,6,2,18,17034,17604,13990,-3614
2019,6,2,19,17098,17749,14165,-3584
2019,6,2,20,17202,17878,14796,-3082
2019,6,2,21,17372,18169,15381,-2788
2019,6,2,22,17433,18382,15622,-2760
2019,6,2,23,17387,18342,15557,-2785
2019,6,3,0,17066,18209,15663,-2546
2019,6,3,1,17056,18182,15543,-2639
2019,6,3,2,16989,17905,15319,-2586
2019,6,3,3,16022,16624,14131,-2493
2019,6,3,4,14713,15312,13124,-2188
2019,6,3,5,13496,14214,12520,-1694
2019,6,3,6,12808,13533,12592,-941
2019,6,3,7,12385,13094,12417,-677
2019,6,3,8,12159,12888,12415,-473
2019,6,3,9,12242,13001,12421,-580
2019,6,3,10,12753,13636,13014,-622
2019,6,3,11,14021,15030,13566,-1464
2019,6,3,12,15476,16307,14906,-1401
2019,6,3,13,16408,16927,15126,-1801
2019,6,3,14,16928,17295,15476,-1819
2019,6,3,15,17220,17565,15872,-1693
2019,6,3,16,17327,17748,16050,-1698
2019,6,3,17,17369,17702,15831,-1871
2019,6,3,18,17485,17622,15770,-1852
2019,6,3,19,17575,17513,15880,-1633
2019,6,3,20,17706,17595,15930,-1665
2019,6,3,21,17934,17851,16339,-1512
2019,6,3,22,18003,18088,16706,-1382
2019,6,3,23,17878,17924,16563,-1361
2019,6,4,0,17359,17645,16342,-1303
2019,6,4,1,17124,17477,16205,-1272
2019,6,4,2,16775,17105,15724,-1381
2019,6,4,3,15539,15939,14456,-1483
2019,6,4,4,14065,14688,13284,-1404
2019,6,4,5,13141,13733,12355,-1378
2019,6,4,6,12418,13159,12034,-1125
2019,6,4,7,12044,12811,11838,-973
2019,6,4,8,11875,12635,11756,-879
2019,6,4,9,12006,12815,11860,-955
2019,6,4,10,12560,13450,12455,-995
2019,6,4,11,13906,14776,13668,-1108
2019,6,4,12,15409,15938,14674,-1264
2019,6,4,13,16283,16474,14787,-1687
2019,6,4,14,16773,16674,14817,-1857
2019,6,4,15,17059,16800,14651,-2149
2019,6,4,16,17241,16955,14885,-2070
2019,6,4,17,17354,17038,15088,-1950
2019,6,4,18,17517,17224,15084,-2140
2019,6,4,19,17609,17428,15389,-2039
2019,6,4,20,17722,17681,15484,-2197
2019,6,4,21,17923,17990,15668,-2322
2019,6,4,22,17940,18202,15798,-2404
2019,6,4,23,17659,18047,15668,-2379
2019,6,5,0,17253,17784,15437,-2347
2019,6,5,1,17131,17681,15468,-2213
2019,6,5,2,16820,17237,15190,-2047
2019,6,5,3,15660,15985,14211,-1774
2019,6,5,4,14315,14714,13137,-1577
2019,6,5,5,13258,13825,12079,-1746
2019,6,5,6,12654,13267,11739,-1528
2019,6,5,7,12297,12934,11862,-1072
2019,6,5,8,12144,12805,11769,-1036
2019,6,5,9,12283,13000,12146,-854
2019,6,5,10,12910,13731,12586,-1145
2019,6,5,11,14336,15199,14006,-1193
2019,6,5,12,15875,16595,15344,-1251
2019,6,5,13,16850,17451,15878,-1573
2019,6,5,14,17523,17948,15836,-2112
2019,6,5,15,18114,18235,15841,-2394
2019,6,5,16,18609,18494,16118,-2376
2019,6,5,17,18972,18845,16542,-2303
2019,6,5,18,19382,19369,16783,-2586
2019,6,5,19,19682,19696,17163,-2533
2019,6,5,20,20063,20111,17311,-2800
2019,6,5,21,20432,20519,17879,-2640
2019,6,5,22,20444,20642,17894,-2748
2019,6,5,23,19828,20332,17778,-2554
2019,6,6,0,19448,20072,17174,-2898
2019,6,6,1,19221,19890,17076,-2814
2019,6,6,2,18887,19232,16911,-2321
2019,6,6,3,17624,17999,15655,-2344
2019,6,6,4,16169,16587,14650,-1937
2019,6,6,5,14835,15571,13660,-1911
2019,6,6,6,14141,14852,12889,-1963
2019,6,6,7,13674,14399,12246,-2153
2019,6,6,8,13444,14202,12181,-2021
2019,6,6,9,13533,14316,12306,-2010
2019,6,6,10,14152,15011,12858,-2153
2019,6,6,11,15637,16556,14208,-2348
2019,6,6,12,17267,18132,15192,-2940
2019,6,6,13,18383,19216,15833,-3383
2019,6,6,14,19135,19913,16372,-3541
2019,6,6,15,19734,20424,17107,-3317
2019,6,6,16,20208,20768,17340,-3428
2019,6,6,17,20599,20963,17722,-3241
2019,6,6,18,20977,21093,17969,-3124
2019,6,6,19,21195,21246,18346,-2900
2019,6,6,20,21408,21536,18762,-2774
2019,6,6,21,21605,21808,18910,-2898
2019,6,6,22,21521,21914,19134,-2780
2019,6,6,23,20967,21562,18769,-2793
2019,6,7,0,20258,21137,18430,-2707
2019,6,7,1,19798,20714,18384,-2330
2019,6,7,2,19407,20203,17744,-2459
2019,6,7,3,18064,18824,16437,-2387
2019,6,7,4,16451,17200,14923,-2277
2019,6,7,5,15125,15889,13564,-2325
2019,6,7,6,14272,15014,13125,-1889
2019,6,7,7,13704,14437,12918,-1519
2019,6,7,8,13384,14113,12875,-1238
2019,6,7,9,13386,14118,13068,-1050
2019,6,7,10,13833,14649,13510,-1139
2019,6,7,11,15095,16106,14306,-1800
2019,6,7,12,16611,17537,15562,-1975
2019,6,7,13,17728,18362,16028,-2334
2019,6,7,14,18436,18918,16034,-2884
2019,6,7,15,18983,19345,15901,-3444
2019,6,7,16,19373,19665,16064,-3601
2019,6,7,17,19646,19918,16377,-3541
2019,6,7,18,19921,20220,16546,-3674
2019,6,7,19,20095,20482,17156,-3326
2019,6,7,20,20239,20824,17702,-3122
2019,6,7,21,20360,21083,18362,-2721
2019,6,7,22,20208,20819,18189,-2630
2019,6,7,23,19579,20238,17215,-3023
2019,6,8,0,18913,19721,16947,-2774
2019,6,8,1,18399,19303,16501,-2802
2019,6,8,2,18038,18864,16082,-2782
2019,6,8,3,16971,17689,14899,-2790
2019,6,8,4,15663,16352,13651,-2701
2019,6,8,5,14981,15224,12832,-2392
2019,6,8,6,14102,14421,12014,-2407
2019,6,8,7,13535,13855,11438,-2417
2019,6,8,8,13185,13540,11412,-2128
2019,6,8,9,13041,13465,11216,-2249
2019,6,8,10,12970,13444,11373,-2071
2019,6,8,11,13287,13863,12012,-1851
2019,6,8,12,14217,14746,12798,-1948
2019,6,8,13,15389,15703,13509,-2194
2019,6,8,14,16332,16476,13870,-2606
2019,6,8,15,17050,17017,14028,-2989
2019,6,8,16,17536,17436,13825,-3611
2019,6,8,17,17813,17702,14127,-3575
2019,6,8,18,17950,17884,14437,-3447
2019,6,8,19,18035,18089,14612,-3477
2019,6,8,20,18153,18330,14963,-3367
2019,6,8,21,18345,18608,14963,-3645
2019,6,8,22,18469,18760,15261,-3499
2019,6,8,23,18237,18664,15262,-3402
2019,6,9,0,17741,18124,15143,-2981
2019,6,9,1,17424,17655,14621,-3034
2019,6,9,2,17274,17384,14051,-3333
2019,6,9,3,16435,16470,13243,-3227
2019,6,9,4,15324,15356,12546,-2810
2019,6,9,5,13989,14418,11908,-2510
2019,6,9,6,13193,13702,11386,-2316
2019,6,9,7,12664,13220,10923,-2297
2019,6,9,8,12325,12901,10681,-2220
2019,6,9,9,12172,12777,10646,-2131
2019,6,9,10,12029,12667,10715,-1952
2019,6,9,11,12198,12909,11046,-1863
2019,6,9,12,12931,13592,12085,-1507
2019,6,9,13,14031,14525,12327,-2198
2019,6,9,14,14993,15312,12606,-2706
2019,6,9,15,15787,15937,13008,-2929
2019,6,9,16,16359,16391,13011,-3380
2019,6,9,17,16741,16765,13232,-3533
2019,6,9,18,16993,17063,13439,-3624
2019,6,9,19,17151,17370,13794,-3576
2019,6,9,20,17380,17707,14066,-3641
2019,6,9,21,17656,18153,15099,-3054
2019,6,9,22,17894,18481,15187,-3294
2019,6,9,23,17893,18521,15439,-3082
2019,6,10,0,17462,18186,15410,-2776
2019,6,10,1,17337,17931,14947,-2984
2019,6,10,2,17251,17684,14707,-2977
2019,6,10,3,16238,16534,13626,-2908
2019,6,10,4,14900,15293,12895,-2398
2019,6,10,5,13503,14314,12169,-2145
2019,6,10,6,12852,13692,11850,-1842
2019,6,10,7,12471,13294,11680,-1614
2019,6,10,8,12311,13133,11687,-1446
2019,6,10,9,12479,13320,11795,-1525
2019,6,10,10,13139,14008,12258,-1750
2019,6,10,11,14592,15387,13135,-2252
2019,6,10,12,16253,16750,14257,-2493
2019,6,10,13,17369,17510,14630,-2880
2019,6,10,14,18166,18064,14749,-3315
2019,6,10,15,18752,18485,14937,-3548
2019,6,10,16,19118,18875,15368,-3507
2019,6,10,17,19349,19018,15464,-3554
2019,6,10,18,19578,19159,15742,-3417
2019,6,10,19,19680,19217,15742,-3475
2019,6,10,20,19730,19362,15796,-3566
2019,6,10,21,19762,19534,15898,-3636
2019,6,10,22,19693,19649,16302,-3347
2019,6,10,23,19410,19393,16057,-3336
2019,6,11,0,19027,19208,15842,-3366
2019,6,11,1,18846,19069,15846,-3223
2019,6,11,2,18493,18490,15392,-3098
2019,6,11,3,17258,17299,14553,-2746
2019,6,11,4,15786,16032,13861,-2171
2019,6,11,5,14444,15002,12555,-2447
2019,6,11,6,13727,14350,12597,-1753
2019,6,11,7,13286,13963,12343,-1620
2019,6,11,8,13066,13793,12215,-1578
2019,6,11,9,13160,13969,12131,-1838
2019,6,11,10,13753,14711,12831,-1880
2019,6,11,11,15176,16120,13834,-2286
2019,6,11,12,16692,17316,15083,-2233
2019,6,11,13,17581,17890,15063,-2827
2019,6,11,14,18065,18183,15216,-2967
2019,6,11,15,18390,18393,18393,0
2019,6,11,16,18549,18433,15396,-3037
2019,6,11,17,18593,18367,15217,-3150
2019,6,11,18,18645,18527,15159,-3368
2019,6,11,19,18647,18769,15634,-3135
2019,6,11,20,18731,19112,15902,-3210
2019,6,11,21,18918,19474,16123,-3351
2019,6,11,22,19011,19667,16152,-3515
2019,6,11,23,18687,19428,16455,-2973
2019,6,12,0,18097,18918,15783,-3135
2019,6,12,1,17638,18439,15319,-3120
2019,6,12,2,17286,18006,14939,-3067
2019,6,12,3,16041,16764,13891,-2873
2019,6,12,4,14594,15348,12495,-2853
2019,6,12,5,13744,14297,11609,-2688
2019,6,12,6,13082,13534,11242,-2292
2019,6,12,7,12663,13119,11254,-1865
2019,6,12,8,12454,12959,11192,-1767
2019,6,12,9,12541,13097,11462,-1635
2019,6,12,10,13045,13659,11728,-1931
2019,6,12,11,14324,15055,12766,-2289
2019,6,12,12,15807,16395,13563,-2832
2019,6,12,13,16747,17124,14391,-2733
2019,6,12,14,17315,17571,14684,-2887
2019,6,12,15,17765,17975,14953,-3022
2019,6,12,16,18063,18210,14909,-3301
2019,6,12,17,18267,18381,15247,-3134
2019,6,12,18,18542,18594,15448,-3146
2019,6,12,19,18687,18815,15996,-2819
2019,6,12,20,18838,19122,16833,-2289
2019,6,12,21,18976,19449,17050,-2399
2019,6,12,22,18893,19561,16999,-2562
2019,6,12,23,18462,19187,16751,-2436
2019,6,13,0,17929,18591,16184,-2407
2019,6,13,1,17671,18397,15961,-2436
2019,6,13,2,17399,18021,15575,-2446
2019,6,13,3,16241,16814,14008,-2806
2019,6,13,4,14854,15491,12800,-2691
2019,6,13,5,13602,14430,11945,-2485
2019,6,13,6,12959,13722,11562,-2160
2019,6,13,7,12563,13323,11401,-1922
2019,6,13,8,12385,13170,11378,-1792
2019,6,13,9,12519,13292,11801,-1491
2019,6,13,10,13137,13951,11952,-1999
2019,6,13,11,14556,15346,13072,-2274
2019,6,13,12,16067,16743,13855,-2888
2019,6,13,13,16948,17554,14414,-3140
2019,6,13,14,17512,17923,14777,-3146
2019,6,13,15,17882,18091,14690,-3401
2019,6,13,16,18079,18102,14736,-3366
2019,6,13,17,18152,17903,14819,-3084
2019,6,13,18,18236,17822,14916,-2906
2019,6,13,19,18205,17874,15099,-2775
2019,6,13,20,18160,17964,15159,-2805
2019,6,13,21,18168,18075,15043,-3032
2019,6,13,22,18127,18095,15077,-3018
2019,6,13,23,17854,17877,14776,-3101
2019,6,14,0,17557,17640,14711,-2929
2019,6,14,1,17461,17558,14477,-3081
2019,6,14,2,17223,17171,14240,-2931
2019,6,14,3,16107,16091,13466,-2625
2019,6,14,4,14782,14902,12912,-1990
2019,6,14,5,13496,14030,12228,-1802
2019,6,14,6,12858,13439,11819,-1620
2019,6,14,7,12472,13071,11682,-1389
2019,6,14,8,12280,12880,11534,-1346
2019,6,14,9,12356,13041,11754,-1287
2019,6,14,10,12843,13597,12407,-1190
2019,6,14,11,14062,14921,13499,-1422
2019,6,14,12,15492,16218,14465,-1753
2019,6,14,13,16404,16953,14456,-2497
2019,6,14,14,16981,17333,14476,-2857
2019,6,14,15,17343,17597,14549,-3048
2019,6,14,16,17493,17829,15003,-2826
2019,6,14,17,17510,17800,14880,-2920
2019,6,14,18,17569,17747,14774,-2973
2019,6,14,19,17558,17750,14939,-2811
2019,6,14,20,17582,17651,15102,-2549
2019,6,14,21,17703,17820,15292,-2528
2019,6,14,22,17717,18068,15389,-2679
2019,6,14,23,17397,17885,15213,-2672
2019,6,15,0,17016,17536,14913,-2623
2019,6,15,1,16704,17259,14505,-2754
2019,6,15,2,16536,17028,14169,-2859
2019,6,15,3,15634,16133,13463,-2670
2019,6,15,4,14488,15022,12573,-2449
2019,6,15,5,13575,14064,12006,-2058
2019,6,15,6,12902,13424,11861,-1563
2019,6,15,7,12469,12985,11635,-1350
2019,6,15,8,12229,12734,11797,-937
2019,6,15,9,12167,12669,11782,-887
2019,6,15,10,12178,12685,11844,-841
2019,6,15,11,12514,13085,11702,-1383
2019,6,15,12,13387,13975,12455,-1520
2019,6,15,13,14392,14924,12802,-2122
2019,6,15,14,15266,15622,13117,-2505
2019,6,15,15,15909,16174,13167,-3007
2019,6,15,16,16349,16583,13373,-3210
2019,6,15,17,16576,16904,13699,-3205
2019,6,15,18,16698,17058,14394,-2664
2019,6,15,19,16811,17282,14694,-2588
2019,6,15,20,16944,17584,14809,-2775
2019,6,15,21,17178,17848,15186,-2662
2019,6,15,22,17371,17846,15328,-2518
2019,6,15,23,17245,17678,15060,-2618
2019,6,16,0,17068,17524,14574,-2950
2019,6,16,1,16951,17526,14612,-2914
2019,6,16,2,16945,17342,14033,-3309
2019,6,16,3,16248,16660,13688,-2972
2019,6,16,4,15301,15733,13187,-2546
2019,6,16,5,14292,14801,12125,-2676
2019,6,16,6,13609,14129,11983,-2146
2019,6,16,7,13122,13596,11863,-1733
2019,6,16,8,12818,13265,11945,-1320
2019,6,16,9,12686,13215,11518,-1697
2019,6,16,10,12614,13252,11189,-2063
2019,6,16,11,12840,13400,11095,-2305
2019,6,16,12,13550,14054,11188,-2866
2019,6,16,13,14495,14982,11612,-3370
2019,6,16,14,15440,15938,12237,-3701
2019,6,16,15,16218,16729,12994,-3735
2019,6,16,16,16806,17295,14092,-3203
2019,6,16,17,17189,17720,14330,-3390
2019,6,16,18,17389,17882,14312,-3570
2019,6,16,19,17477,17827,14341,-3486
2019,6,16,20,17572,18001,14644,-3357
2019,6,16,21,17773,18213,15010,-3203
2019,6,16,22,17979,18336,14437,-3899
2019,6,16,23,18003,18311,14090,-4221
2019,6,17,0,17828,18307,14093,-4214
2019,6,17,1,17875,18340,14071,-4269
2019,6,17,2,17920,18289,14105,-4184
2019,6,17,3,17031,17404,13800,-3604
2019,6,17,4,15826,16323,13310,-3013
2019,6,17,5,14874,15365,12406,-2959
2019,6,17,6,14173,14741,11902,-2839
2019,6,17,7,13736,14349,11814,-2535
2019,6,17,8,13520,14181,11819,-2362
2019,6,17,9,13626,14311,12036,-2275
2019,6,17,10,14188,14964,12609,-2355
2019,6,17,11,15523,16408,13988,-2420
2019,6,17,12,17126,17877,14814,-3063
2019,6,17,13,18317,18756,15484,-3272
2019,6,17,14,19126,19308,15497,-3811
2019,6,17,15,19755,19720,15359,-4361
2019,6,17,16,20257,20018,15491,-4527
2019,6,17,17,20621,20220,15756,-4464
2019,6,17,18,20984,20344,15752,-4592
2019,6,17,19,21277,20389,15989,-4400
2019,6,17,20,21571,20506,16241,-4265
2019,6,17,21,21814,20685,16434,-4251
2019,6,17,22,21828,20834,16777,-4057
2019,6,17,23,21273,20627,16664,-3963
2019,6,18,0,20750,20274,16583,-3691
2019,6,18,1,20307,20013,16555,-3458
2019,6,18,2,19869,19542,15882,-3660
2019,6,18,3,18525,18167,14919,-3248
2019,6,18,4,16950,16679,14566,-2113
2019,6,18,5,15463,15591,13159,-2432
2019,6,18,6,14663,14872,12759,-2113
2019,6,18,7,14173,14418,12348,-2070
2019,6,18,8,13921,14222,12368,-1854
2019,6,18,9,14002,14340,12550,-1790
2019,6,18,10,14564,15080,13080,-2000
2019,6,18,11,15929,16550,14202,-2348
2019,6,18,12,17480,18023,14915,-3108
2019,6,18,13,18503,18954,15212,-3742
2019,6,18,14,19219,19612,15789,-3823
2019,6,18,15,19784,20080,16005,-4075
2019,6,18,16,20213,20404,16589,-3815
2019,6,18,17,20492,20559,16966,-3593
2019,6,18,18,20758,20598,16974,-3624
2019,6,18,19,20883,20520,16995,-3525
2019,6,18,20,20957,20514,17242,-3272
2019,6,18,21,21022,20681,17315,-3366
2019,6,18,22,20917,20775,17427,-3348
2019,6,18,23,20428,20558,17236,-3322
2019,6,19,0,19934,20225,17052,-3173
2019,6,19,1,19566,19860,16691,-3169
2019,6,19,2,19197,19294,15994,-3300
2019,6,19,3,17920,18017,15023,-2994
2019,6,19,4,16427,16549,14033,-2516
2019,6,19,5,15110,15478,13165,-2313
2019,6,19,6,14380,14767,12721,-2046
2019,6,19,7,13912,14308,12647,-1661
2019,6,19,8,13677,14093,12490,-1603
2019,6,19,9,13763,14192,12617,-1575
2019,6,19,10,14322,14887,13022,-1865
2019,6,19,11,15665,16290,14030,-2260
2019,6,19,12,17219,17754,14898,-2856
2019,6,19,13,18275,18736,15772,-2964
2019,6,19,14,18958,19389,16213,-3176
2019,6,19,15,19522,19836,16690,-3146
2019,6,19,16,19946,20126,16810,-3316
2019,6,19,17,20237,20273,17051,-3222
2019,6,19,18,20557,20483,17319,-3164
2019,6,19,19,20761,20606,17513,-3093
2019,6,19,20,20978,20706,17309,-3397
2019,6,19,21,21178,20833,17647,-3186
2019,6,19,22,21154,20842,17788,-3054
2019,6,19,23,20658,20514,17229,-3285
2019,6,20,0,20191,20210,16798,-3412
2019,6,20,1,19844,19963,16604,-3359
2019,6,20,2,19527,19434,16046,-3388
2019,6,20,3,18277,18149,15011,-3138
2019,6,20,4,16779,16702,13836,-2866
2019,6,20,5,15261,15671,12310,-3361
2019,6,20,6,14498,14979,11962,-3017
2019,6,20,7,13996,14518,11738,-2780
2019,6,20,8,13741,14292,11695,-2597
2019,6,20,9,13821,14394,11767,-2627
2019,6,20,10,14402,15081,12355,-2726
2019,6,20,11,15792,16511,14165,-2346
2019,6,20,12,17400,17992,15486,-2506
2019,6,20,13,18552,18980,15916,-3064
2019,6,20,14,19311,19671,16461,-3210
2019,6,20,15,19920,20084,16785,-3299
2019,6,20,16,20410,20330,16967,-3363
2019,6,20,17,20752,20523,17315,-3208
2019,6,20,18,21072,20842,17618,-3224
2019,6,20,19,21236,21185,17708,-3477
2019,6,20,20,21379,21398,17978,-3420
2019,6,20,21,21507,21494,18039,-3455
2019,6,20,22,21411,21518,17914,-3604
2019,6,20,23,20835,21165,17663,-3502
2019,6,21,0,20337,20771,17582,-3189
2019,6,21,1,20018,20535,17572,-2963
2019,6,21,2,19703,20105,16961,-3144
2019,6,21,3,18487,18907,15768,-3139
2019,6,21,4,16993,17460,14972,-2488
2019,6,21,5,15676,16345,13433,-2912
2019,6,21,6,14877,15560,12818,-2742
2019,6,21,7,14341,14981,12510,-2471
2019,6,21,8,14033,14677,12282,-2395
2019,6,21,9,14030,14731,12446,-2285
2019,6,21,10,14481,15384,12923,-2461
2019,6,21,11,15704,16738,14066,-2672
2019,6,21,12,17177,18094,14953,-3141
2019,6,21,13,18228,18825,15181,-3644
2019,6,21,14,18882,19221,15459,-3762
2019,6,21,15,19344,19559,16009,-3550
2019,6,21,16,19557,19590,15929,-3661
2019,6,21,17,19631,19534,15831,-3703
2019,6,21,18,19719,19562,16193,-3369
2019,6,21,19,19750,19559,16547,-3012
2019,6,21,20,19819,19684,16162,-3522
2019,6,21,21,19930,19935,16104,-3831
2019,6,21,22,19875,20088,16099,-3989
2019,6,21,23,19335,19733,15917,-3816
2019,6,22,0,18700,19171,15518,-3653
2019,6,22,1,18166,18579,15022,-3557
2019,6,22,2,17886,18269,15332,-2937
2019,6,22,3,16878,17246,14489,-2757
2019,6,22,4,15623,15949,13466,-2483
2019,6,22,5,14888,14862,12252,-2610
2019,6,22,6,14116,14080,11551,-2529
2019,6,22,7,13618,13562,11214,-2348
2019,6,22,8,13304,13231,11098,-2133
2019,6,22,9,13175,13131,11043,-2088
2019,6,22,10,13089,13146,11450,-1696
2019,6,22,11,13276,13571,11681,-1890
2019,6,22,12,14019,14445,11576,-2869
2019,6,22,13,14931,15453,12003,-3450
2019,6,22,14,15668,16255,12964,-3291
2019,6,22,15,16217,16864,13984,-2880
2019,6,22,16,16577,17301,14110,-3191
2019,6,22,17,16729,17621,14227,-3394
2019,6,22,18,16789,17836,14298,-3538
2019,6,22,19,16906,18049,14587,-3462
2019,6,22,20,17140,18283,14867,-3416
2019,6,22,21,17502,18650,15371,-3279
2019,6,22,22,17849,18873,15532,-3341
2019,6,22,23,17814,18828,15606,-3222
2019,6,23,0,17542,18461,15257,-3204
2019,6,23,1,17295,18087,14668,-3419
2019,6,23,2,17246,17897,14299,-3598
2019,6,23,3,16553,17079,13187,-3892
2019,6,23,4,15614,16037,12691,-3346
2019,6,23,5,14603,15013,12078,-2935
2019,6,23,6,13833,14214,11692,-2522
2019,6,23,7,13311,13621,11254,-2367
2019,6,23,8,12970,13206,11129,-2077
2019,6,23,9,12802,13058,11025,-2033
2019,6,23,10,12635,12906,11098,-1808
2019,6,23,11,12716,13190,11696,-1494
2019,6,23,12,13368,13870,11840,-2030
2019,6,23,13,14314,14780,11847,-2933
2019,6,23,14,15225,15749,12333,-3416
2019,6,23,15,16025,16555,12619,-3936
2019,6,23,16,16686,17160,12962,-4198
2019,6,23,17,17128,17694,13624,-4070
2019,6,23,18,17444,18150,14223,-3927
2019,6,23,19,17751,18652,14663,-3989
2019,6,23,20,18182,19276,15051,-4225
2019,6,23,21,18705,19941,15452,-4489
2019,6,23,22,19155,20492,16155,-4337
2019,6,23,23,19178,20595,16321,-4274
2019,6,24,0,18844,20290,16528,-3762
2019,6,24,1,18684,19834,16350,-3484
2019,6,24,2,18641,19585,16207,-3378
2019,6,24,3,17682,18501,15545,-2956
2019,6,24,4,16409,17091,14387,-2704
2019,6,24,5,15146,15888,13324,-2564
2019,6,24,6,14330,15059,12591,-2468
2019,6,24,7,13806,14523,12134,-2389
2019,6,24,8,13525,14240,11992,-2248
2019,6,24,9,13601,14298,12300,-1998
2019,6,24,10,14138,14841,12717,-2124
2019,6,24,11,15468,16209,13737,-2472
2019,6,24,12,17185,17811,15087,-2724
2019,6,24,13,18541,18921,15441,-3480
2019,6,24,14,19520,19806,16367,-3439
2019,6,24,15,20348,20536,16961,-3575
2019,6,24,16,21089,21263,17184,-4079
2019,6,24,17,21684,21841,17454,-4387
2019,6,24,18,22255,22379,17772,-4607
2019,6,24,19,22688,22836,18597,-4239
2019,6,24,20,23060,23082,19069,-4013
2019,6,24,21,23352,23282,19237,-4045
2019,6,24,22,23386,23307,19397,-3910
2019,6,24,23,22903,22856,19076,-3780
2019,6,25,0,22270,22392,18924,-3468
2019,6,25,1,21826,22054,18619,-3435
2019,6,25,2,21366,21698,18125,-3573
2019,6,25,3,19906,20405,17265,-3140
2019,6,25,4,18130,18772,15776,-2996
2019,6,25,5,16666,17466,15141,-2325
2019,6,25,6,15743,16610,14425,-2185
2019,6,25,7,15173,16066,13878,-2188
2019,6,25,8,14873,15799,13334,-2465
2019,6,25,9,14941,15919,13441,-2478
2019,6,25,10,15533,16698,14053,-2645
2019,6,25,11,16942,18058,15327,-2731
2019,6,25,12,18577,19539,16183,-3356
2019,6,25,13,19699,20599,16509,-4090
2019,6,25,14,20495,21226,17256,-3970
2019,6,25,15,21160,21758,18047,-3711
2019,6,25,16,21710,22190,18401,-3789
2019,6,25,17,22109,22441,18285,-4156
2019,6,25,18,22494,22836,18749,-4087
2019,6,25,19,22736,23164,19152,-4012
2019,6,25,20,22989,23627,19835,-3792
2019,6,25,21,23250,24177,20295,-3882
2019,6,25,22,23322,24614,20181,-4433
2019,6,25,23,22920,24325,19703,-4622
2019,6,26,0,22297,23745,19270,-4475
2019,6,26,1,21831,23002,18900,-4102
2019,6,26,2,21428,22455,18547,-3908
2019,6,26,3,20029,20974,17079,-3895
2019,6,26,4,18327,19145,16486,-2659
2019,6,26,5,16996,17737,14982,-2755
2019,6,26,6,16018,16763,13830,-2933
2019,6,26,7,15381,16172,13635,-2537
2019,6,26,8,15012,15825,13579,-2246
2019,6,26,9,14995,15854,13545,-2309
2019,6,26,10,15444,16366,13738,-2628
2019,6,26,11,16686,17765,14850,-2915
2019,6,26,12,18309,19400,15901,-3499
2019,6,26,13,19583,20622,16547,-4075
2019,6,26,14,20443,21497,17044,-4453
2019,6,26,15,21224,22346,17894,-4452
2019,6,26,16,21951,23083,18536,-4547
2019,6,26,17,22513,23699,19346,-4353
2019,6,26,18,23127,24354,19572,-4782
2019,6,26,19,23639,24967,20393,-4574
2019,6,26,20,24220,25509,20826,-4683
2019,6,26,21,24741,25986,21041,-4945
2019,6,26,22,24889,26221,21652,-4569
2019,6,26,23,24285,25873,21006,-4867
2019,6,27,0,23566,24990,20466,-4524
2019,6,27,1,22980,24033,20078,-3955
2019,6,27,2,22527,23400,19421,-3979
2019,6,27,3,21021,21948,18019,-3929
2019,6,27,4,19225,20170,16220,-3950
2019,6,27,5,17644,18625,15436,-3189
2019,6,27,6,16539,17490,14794,-2696
2019,6,27,7,15822,16780,13792,-2988
2019,6,27,8,15405,16295,13062,-3233
2019,6,27,9,15365,16199,12862,-3337
2019,6,27,10,15814,16561,13525,-3036
2019,6,27,11,17103,17973,15091,-2882
2019,6,27,12,18865,19657,16151,-3506
2019,6,27,13,20310,20996,17029,-3967
2019,6,27,14,21336,22152,17593,-4559
2019,6,27,15,22245,23213,18275,-4938
2019,6,27,16,23040,24034,18632,-5402
2019,6,27,17,23663,24699,19212,-5487
2019,6,27,18,24262,25345,20189,-5156
2019,6,27,19,24744,25746,20664,-5082
2019,6,27,20,25246,26150,20924,-5226
2019,6,27,21,25696,26422,21096,-5326
2019,6,27,22,25770,26684,21586,-5098
2019,6,27,23,25112,26322,21420,-4902
2019,6,28,0,24283,25619,21000,-4619
2019,6,28,1,23630,24686,19963,-4723
2019,6,28,2,23108,23928,19566,-4362
2019,6,28,3,21534,22338,18588,-3750
2019,6,28,4,19649,20479,17244,-3235
2019,6,28,5,18078,18899,15818,-3081
2019,6,28,6,16893,17760,14467,-3293
2019,6,28,7,16122,16914,13943,-2971
2019,6,28,8,15668,16341,14315,-2026
2019,6,28,9,15609,16238,14183,-2055
2019,6,28,10,16031,16583,14730,-1853
2019,6,28,11,17331,17831,15732,-2099
2019,6,28,12,19164,19530,16907,-2623
2019,6,28,13,20744,21002,17972,-3030
2019,6,28,14,21962,22256,18472,-3784
2019,6,28,15,23046,23374,19543,-3831
2019,6,28,16,23936,24290,20233,-4057
2019,6,28,17,24604,25048,20709,-4339
2019,6,28,18,25242,25768,21117,-4651
2019,6,28,19,25729,26341,21713,-4628
2019,6,28,20,26173,26840,22011,-4829
2019,6,28,21,26487,27190,22575,-4615
2019,6,28,22,26422,27151,22719,-4432
2019,6,28,23,25652,26273,21870,-4403
2019,6,29,0,24730,25152,21165,-3987
2019,6,29,1,23944,24299,20308,-3991
2019,6,29,2,23436,23654,19553,-4101
2019,6,29,3,22067,22289,18508,-3781
2019,6,29,4,20318,20695,17894,-2801
2019,6,29,5,18817,19372,16040,-3332
2019,6,29,6,17622,18363,14997,-3366
2019,6,29,7,16835,17614,14040,-3574
2019,6,29,8,16328,17149,13823,-3326
2019,6,29,9,16083,16888,13275,-3613
2019,6,29,10,16000,16832,13223,-3609
2019,6,29,11,16331,17195,13560,-3635
2019,6,29,12,17462,18291,14458,-3833
2019,6,29,13,18868,19819,15283,-4536
2019,6,29,14,20341,21310,17022,-4288
2019,6,29,15,21609,22526,18248,-4278
2019,6,29,16,22533,23413,19036,-4377
2019,6,29,17,23104,23994,19502,-4492
2019,6,29,18,23380,24483,19881,-4602
2019,6,29,19,23539,24954,19749,-5205
2019,6,29,20,23678,25252,20064,-5188
2019,6,29,21,23835,25287,19595,-5692
2019,6,29,22,23865,24848,19401,-5447
2019,6,29,23,23541,24215,19572,-4643
2019,6,30,0,22928,23461,19230,-4231
2019,6,30,1,22437,22817,18739,-4078
2019,6,30,2,22201,22290,18302,-3988
2019,6,30,3,21149,21168,17363,-3805
2019,6,30,4,19700,19884,16376,-3508
2019,6,30,5,18249,18661,14159,-4502
2019,6,30,6,17186,17643,13368,-4275
2019,6,30,7,16435,16924,13198,-3726
2019,6,30,8,15903,16433,12454,-3979
2019,6,30,9,15591,16140,12759,-3381
2019,6,30,10,15332,15871,12862,-3009
2019,6,30,11,15335,16065,12889,-3176
2019,6,30,12,16027,16950,13791,-3159
2019,6,30,13,16990,18105,13994,-4111
2019,6,30,14,18021,19130,14389,-4741
2019,6,30,15,18884,19895,15062,-4833
2019,6,30,16,19472,20419,15917,-4502
2019,6,30,17,19740,20787,16425,-4362
2019,6,30,18,19834,20778,16602,-4176
2019,6,30,19,19823,20772,16500,-4272
2019,6,30,20,19860,20206,16285,-3921
2019,6,30,21,20027,20380,16608,-3772
2019,6,30,22,20221,20752,16997,-3755
2019,6,30,23,20041,20736,17089,-3647
2019,7,1,0,19636,20398,16466,-3932
2019,7,1,1,19346,19988,16044,-3944
2019,7,1,2,19188,19816,15820,-3996
2019,7,1,3,18179,18817,14981,-3836
2019,7,1,4,16916,17459,14103,-3356
2019,7,1,5,16232,16337,13585,-2752
2019,7,1,6,15505,15574,12804,-2770
2019,7,1,7,14989,15007,12396,-2611
2019,7,1,8,14703,14722,11896,-2826
2019,7,1,9,14745,14742,12159,-2583
2019,7,1,10,15122,15194,12669,-2525
2019,7,1,11,16136,16375,13582,-2793
2019,7,1,12,17660,17862,14427,-3435
2019,7,1,13,18891,19043,15277,-3766
2019,7,1,14,19834,19948,15740,-4208
2019,7,1,15,20635,20787,16240,-4547
2019,7,1,16,21263,21501,16612,-4889
2019,7,1,17,21760,22073,16962,-5111
2019,7,1,18,22340,22730,17468,-5262
2019,7,1,19,22863,23349,18220,-5129
2019,7,1,20,23385,23939,18869,-5070
2019,7,1,21,23834,24468,18917,-5551
2019,7,1,22,24061,24821,19414,-5407
2019,7,1,23,23567,24528,19635,-4893
2019,7,2,0,22903,23870,19446,-4424
2019,7,2,1,22314,23055,18993,-4062
2019,7,2,2,21954,22518,18219,-4299
2019,7,2,3,20656,21072,16959,-4113
2019,7,2,4,19093,19330,15594,-3736
2019,7,2,5,17422,17870,14294,-3576
2019,7,2,6,16429,16898,13991,-2907
2019,7,2,7,15799,16249,13605,-2644
2019,7,2,8,15440,15830,13333,-2497
2019,7,2,9,15446,15868,13282,-2586
2019,7,2,10,15869,16268,13887,-2381
2019,7,2,11,17035,17565,14799,-2766
2019,7,2,12,18747,19097,15768,-3329
2019,7,2,13,20110,20316,16697,-3619
2019,7,2,14,21224,21311,17657,-3654
2019,7,2,15,22248,22369,18269,-4100
2019,7,2,16,23069,23187,18948,-4239
2019,7,2,17,23726,23621,19402,-4219
2019,7,2,18,24402,23940,19902,-4038
2019,7,2,19,24943,24205,19952,-4253
2019,7,2,20,25378,24506,20134,-4372
2019,7,2,21,25795,25017,21085,-3932
2019,7,2,22,25989,25350,21215,-4135
2019,7,2,23,25446,25125,20866,-4259
2019,7,3,0,24778,24635,20250,-4385
2019,7,3,1,24229,24131,20023,-4108
2019,7,3,2,23857,23706,19201,-4505
2019,7,3,3,22426,22312,17803,-4509
2019,7,3,4,20615,20666,16378,-4288
2019,7,3,5,18583,19280,15035,-4245
2019,7,3,6,17400,18268,14543,-3725
2019,7,3,7,16636,17590,14119,-3471
2019,7,3,8,16179,17151,13563,-3588
2019,7,3,9,16103,17073,13568,-3505
2019,7,3,10,16427,17513,14151,-3362
2019,7,3,11,17525,18801,15180,-3621
2019,7,3,12,19227,20527,16426,-4101
2019,7,3,13,20846,21921,17176,-4745
2019,7,3,14,22092,23002,18303,-4699
2019,7,3,15,23227,24060,19400,-4660
2019,7,3,16,24171,24818,20369,-4449
2019,7,3,17,24858,25293,20714,-4579
2019,7,3,18,25484,25830,21242,-4588
2019,7,3,19,25929,26332,21965,-4367
2019,7,3,20,26289,26758,22203,-4555
2019,7,3,21,26584,26950,22297,-4653
2019,7,3,22,26668,27054,22833,-4221
2019,7,3,23,26089,26696,22524,-4172
2019,7,4,0,25256,25865,22077,-3788
2019,7,4,1,24545,24818,21057,-3761
2019,7,4,2,24082,24078,20174,-3904
2019,7,4,3,22664,22677,18363,-4314
2019,7,4,4,20860,21105,17109,-3996
2019,7,4,5,18861,19597,15468,-4129
2019,7,4,6,17594,18444,14458,-3986
2019,7,4,7,16746,17578,13598,-3980
2019,7,4,8,16192,17006,13318,-3688
2019,7,4,9,15906,16667,13050,-3617
2019,7,4,10,15762,16547,13414,-3133
2019,7,4,11,16004,16950,13953,-2997
2019,7,4,12,16918,18039,14820,-3219
2019,7,4,13,18230,19450,15730,-3720
2019,7,4,14,19668,20952,16676,-4276
2019,7,4,15,21009,22388,18083,-4305
2019,7,4,16,22172,23507,19395,-4112
2019,7,4,17,22948,24229,19963,-4266
2019,7,4,18,23390,24611,20714,-3897
2019,7,4,19,23642,24840,20830,-4010
2019,7,4,20,23843,25008,20832,-4176
2019,7,4,21,24031,25173,20579,-4594
2019,7,4,22,24086,25223,20436,-4787
2019,7,4,23,23689,24753,20342,-4411
2019,7,5,0,23074,23964,19660,-4304
2019,7,5,1,22450,23223,18829,-4394
2019,7,5,2,21980,22669,17942,-4727
2019,7,5,3,21031,21885,17142,-4743
2019,7,5,4,19830,20869,16614,-4255
2019,7,5,5,18346,19598,15491,-4107
2019,7,5,6,17296,18629,14828,-3801
2019,7,5,7,16620,17923,14437,-3486
2019,7,5,8,16236,17479,13893,-3586
2019,7,5,9,16214,17338,13845,-3493
2019,7,5,10,16628,17610,14285,-3325
2019,7,5,11,17724,18562,15532,-3030
2019,7,5,12,19375,19923,16104,-3819
2019,7,5,13,20886,21267,16937,-4330
2019,7,5,14,22120,22529,17633,-4896
2019,7,5,15,23200,23596,18523,-5073
2019,7,5,16,24044,24534,19603,-4931
2019,7,5,17,24639,25334,20651,-4683
2019,7,5,18,25228,25949,21365,-4584
2019,7,5,19,25598,26300,21367,-4933
2019,7,5,20,25879,26657,22053,-4604
2019,7,5,21,26093,26897,22269,-4628
2019,7,5,22,26048,26845,22202,-4643
2019,7,5,23,25320,26262,22135,-4127
2019,7,6,0,24565,25483,22026,-3457
2019,7,6,1,23865,24850,20930,-3920
2019,7,6,2,23344,24397,19917,-4480
2019,7,6,3,22148,23336,19188,-4148
2019,7,6,4,20711,21979,18010,-3969
2019,7,6,5,19858,20645,16673,-3972
2019,7,6,6,18730,19654,15759,-3895
2019,7,6,7,17947,18943,15034,-3909
2019,7,6,8,17443,18464,14760,-3704
2019,7,6,9,17172,18213,14229,-3984
2019,7,6,10,17101,18160,14434,-3726
2019,7,6,11,17443,18538,14824,-3714
2019,7,6,12,18630,19708,15749,-3959
2019,7,6,13,20346,21298,16891,-4407
2019,7,6,14,21898,22847,18016,-4831
2019,7,6,15,23250,24113,19635,-4478
2019,7,6,16,24275,25045,20793,-4252
2019,7,6,17,24959,25542,21372,-4170
2019,7,6,18,25301,25659,21411,-4248
2019,7,6,19,25469,25577,21553,-4024
2019,7,6,20,25535,25267,21184,-4083
2019,7,6,21,25571,25033,21218,-3815
2019,7,6,22,25521,24936,21125,-3811
2019,7,6,23,25104,24562,21039,-3523
2019,7,7,0,24523,23943,20415,-3528
2019,7,7,1,23983,23493,19782,-3711
2019,7,7,2,23625,23099,19197,-3902
2019,7,7,3,22544,22101,17973,-4128
2019,7,7,4,21134,20810,16276,-4534
2019,7,7,5,19817,19588,15052,-4536
2019,7,7,6,18757,18611,14167,-4444
2019,7,7,7,17967,17864,13657,-4207
2019,7,7,8,17407,17313,13238,-4075
2019,7,7,9,17057,16969,12987,-3982
2019,7,7,10,16775,16729,13203,-3526
2019,7,7,11,16739,16785,13359,-3426
2019,7,7,12,17341,17354,13782,-3572
2019,7,7,13,18383,18227,14249,-3978
2019,7,7,14,19326,19224,14970,-4254
2019,7,7,15,20188,20255,15751,-4504
2019,7,7,16,20866,21080,16384,-4696
2019,7,7,17,21288,21715,17084,-4631
2019,7,7,18,21547,22085,17598,-4487
2019,7,7,19,21767,22338,17941,-4397
2019,7,7,20,21981,22562,18157,-4405
2019,7,7,21,22301,22875,18624,-4251
2019,7,7,22,22621,23114,18800,-4314
2019,7,7,23,22380,22961,18980,-3981
2019,7,8,0,21773,22338,18422,-3916
2019,7,8,1,21290,21690,17884,-3806
2019,7,8,2,21077,21345,17273,-4072
2019,7,8,3,19969,20206,16160,-4046
2019,7,8,4,18594,18761,15206,-3555
2019,7,8,5,17431,17587,14179,-3408
2019,7,8,6,16548,16791,13400,-3391
2019,7,8,7,15954,16240,12658,-3582
2019,7,8,8,15623,15954,12548,-3406
2019,7,8,9,15639,16019,12411,-3608
2019,7,8,10,16059,16567,13273,-3294
2019,7,8,11,17088,17688,14565,-3123
2019,7,8,12,18605,19171,15685,-3486
2019,7,8,13,19798,20071,16501,-3570
2019,7,8,14,20734,20587,16604,-3983
2019,7,8,15,21503,21056,16718,-4338
2019,7,8,16,22015,21427,16947,-4480
2019,7,8,17,22376,21614,16942,-4672
2019,7,8,18,22788,21996,17375,-4621
2019,7,8,19,23133,22405,17669,-4736
2019,7,8,20,23463,22941,18140,-4801
2019,7,8,21,23781,23563,18419,-5144
2019,7,8,22,23911,23945,18573,-5372
2019,7,8,23,23389,23622,18817,-4805
2019,7,9,0,22666,22888,18637,-4251
2019,7,9,1,21993,22145,18233,-3912
2019,7,9,2,21559,21580,17493,-4087
2019,7,9,3,20218,20195,16510,-3685
2019,7,9,4,18638,18570,15591,-2979
2019,7,9,5,17197,17235,14441,-2794
2019,7,9,6,16244,16393,13663,-2730
2019,7,9,7,15621,15850,13257,-2593
2019,7,9,8,15267,15548,13014,-2534
2019,7,9,9,15276,15596,13097,-2499
2019,7,9,10,15681,16078,13662,-2416
2019,7,9,11,16769,17381,15261,-2120
2019,7,9,12,18471,19023,16176,-2847
2019,7,9,13,19897,20335,16800,-3535
2019,7,9,14,20997,21317,17187,-4130
2019,7,9,15,21989,22262,17770,-4492
2019,7,9,16,22793,23027,18291,-4736
2019,7,9,17,23423,23667,18779,-4888
2019,7,9,18,24080,24353,19756,-4597
2019,7,9,19,24637,25059,21154,-3905
2019,7,9,20,25089,25738,21507,-4231
2019,7,9,21,25546,26384,21762,-4622
2019,7,9,22,25789,26711,22260,-4451
2019,7,9,23,25264,26260,22274,-3986
2019,7,10,0,24456,25411,21973,-3438
2019,7,10,1,23797,24543,21230,-3313
2019,7,10,2,23385,23842,20575,-3267
2019,7,10,3,21922,22296,18792,-3504
2019,7,10,4,20091,20487,17402,-3085
2019,7,10,5,18160,18982,15744,-3238
2019,7,10,6,17056,17981,15170,-2811
2019,7,10,7,16318,17257,14361,-2896
2019,7,10,8,15878,16821,13935,-2886
2019,7,10,9,15828,16778,13993,-2785
2019,7,10,10,16234,17228,14538,-2690
2019,7,10,11,17375,18413,15829,-2584
2019,7,10,12,19173,20058,17019,-3039
2019,7,10,13,20746,21452,17874,-3578
2019,7,10,14,22029,22691,18744,-3947
2019,7,10,15,23209,23925,19865,-4060
2019,7,10,16,24217,25006,21104,-3902
2019,7,10,17,25022,25873,22451,-3422
2019,7,10,18,25847,26696,23391,-3305
2019,7,10,19,26501,27340,23679,-3661
2019,7,10,20,27038,27849,24269,-3580
2019,7,10,21,27469,28324,24685,-3639
2019,7,10,22,27613,28593,25030,-3563
2019,7,10,23,27087,28127,24779,-3348
2019,7,11,0,26268,27322,24357,-2965
2019,7,11,1,25598,26531,23644,-2887
2019,7,11,2,25092,25930,22539,-3391
2019,7,11,3,23498,24270,20266,-4004
2019,7,11,4,21545,22387,18301,-4086
2019,7,11,5,19837,20842,16715,-4127
2019,7,11,6,18644,19674,15547,-4127
2019,7,11,7,17846,18879,14375,-4504
2019,7,11,8,17374,18408,13969,-4439
2019,7,11,9,17323,18303,13892,-4411
2019,7,11,10,17798,18743,14650,-4093
2019,7,11,11,19013,19929,15676,-4253
2019,7,11,12,20845,21617,17461,-4156
2019,7,11,13,22400,22886,18336,-4550
2019,7,11,14,23639,23933,19082,-4851
2019,7,11,15,24711,24974,20540,-4434
2019,7,11,16,25515,25847,21704,-4143
2019,7,11,17,26037,26521,22467,-4054
2019,7,11,18,26548,27025,23047,-3978
2019,7,11,19,26856,27087,23307,-3780
2019,7,11,20,27052,26952,23459,-3493
2019,7,11,21,27131,26764,23274,-3490
2019,7,11,22,26987,26429,22930,-3499
2019,7,11,23,26326,25841,22138,-3703
2019,7,12,0,25518,25213,25213,0
2019,7,12,1,24912,24772,21258,-3514
2019,7,12,2,24396,23936,21228,-2708
2019,7,12,3,22923,22482,19677,-2805
2019,7,12,4,21122,20776,17830,-2946
2019,7,12,5,19290,19459,16498,-2961
2019,7,12,6,18167,18488,15112,-3376
2019,7,12,7,17441,17839,14485,-3354
2019,7,12,8,17006,17406,14111,-3295
2019,7,12,9,16959,17363,14065,-3298
2019,7,12,10,17429,17879,14463,-3416
2019,7,12,11,18603,19044,15615,-3429
2019,7,12,12,20333,20713,17302,-3411
2019,7,12,13,21856,21989,18043,-3946
2019,7,12,14,23007,23039,18899,-4140
2019,7,12,15,24000,23903,19943,-3960
2019,7,12,16,24735,24547,20645,-3902
2019,7,12,17,25217,24997,21153,-3844
2019,7,12,18,25669,25455,21825,-3630
2019,7,12,19,25973,25757,22314,-3443
2019,7,12,20,26159,25875,22457,-3418
2019,7,12,21,26313,25997,22556,-3441
2019,7,12,22,26236,25885,22791,-3094
2019,7,12,23,25440,25152,22039,-3113
2019,7,13,0,24506,24226,20829,-3397
2019,7,13,1,23592,23338,19980,-3358
2019,7,13,2,23054,22781,19150,-3631
2019,7,13,3,21669,21523,17761,-3762
2019,7,13,4,20028,19979,16265,-3714
2019,7,13,5,18507,18616,14763,-3853
2019,7,13,6,17478,17608,14105,-3503
2019,7,13,7,16724,16863,13506,-3357
2019,7,13,8,16205,16332,12795,-3537
2019,7,13,9,15904,16077,12568,-3509
2019,7,13,10,15744,16037,12699,-3338
2019,7,13,11,15889,16369,12922,-3447
2019,7,13,12,16835,17455,14484,-2971
2019,7,13,13,18153,18713,15458,-3255
2019,7,13,14,19363,19917,16185,-3732
2019,7,13,15,20415,20936,16932,-4004
2019,7,13,16,21229,21697,17583,-4114
2019,7,13,17,21792,22285,18177,-4108
2019,7,13,18,22213,22772,18820,-3952
2019,7,13,19,22629,23342,19631,-3711
2019,7,13,20,23088,23956,20476,-3480
2019,7,13,21,23555,24505,21197,-3308
2019,7,13,22,23856,24811,21686,-3125
2019,7,13,23,23640,24582,21606,-2976
2019,7,14,0,23088,23600,20646,-2954
2019,7,14,1,22616,23006,20068,-2938
2019,7,14,2,22434,22674,19595,-3079
2019,7,14,3,21522,21820,18224,-3596
2019,7,14,4,20271,20624,16646,-3978
2019,7,14,5,18680,19459,15307,-4152
2019,7,14,6,17678,18475,14196,-4279
2019,7,14,7,16960,17715,13583,-4132
2019,7,14,8,16464,17114,13056,-4058
2019,7,14,9,16160,16797,12796,-4001
2019,7,14,10,15936,16587,12599,-3988
2019,7,14,11,15929,16685,12360,-4325
2019,7,14,12,16665,17671,13740,-3931
2019,7,14,13,17858,19079,14887,-4192
2019,7,14,14,19097,20548,16139,-4409
2019,7,14,15,20217,21775,17541,-4234
2019,7,14,16,21085,22845,18737,-4108
2019,7,14,17,21639,23587,19865,-3722
2019,7,14,18,22010,24004,20290,-3714
2019,7,14,19,22317,24405,20462,-3943
2019,7,14,20,22664,24782,20546,-4236
2019,7,14,21,23088,25175,21242,-3933
2019,7,14,22,23437,25393,21623,-3770
2019,7,14,23,23305,25230,21500,-3730
2019,7,15,0,22779,24570,20967,-3603
2019,7,15,1,22366,23827,20296,-3531
2019,7,15,2,22176,23379,19605,-3774
2019,7,15,3,21046,22025,18312,-3713
2019,7,15,4,19569,20344,16558,-3786
2019,7,15,5,18381,18980,14844,-4136
2019,7,15,6,17321,17950,14089,-3861
2019,7,15,7,16612,17128,13113,-4015
2019,7,15,8,16182,16692,12649,-4043
2019,7,15,9,16128,16642,12453,-4189
2019,7,15,10,16505,17018,13058,-3960
2019,7,15,11,17494,18144,14105,-4039
2019,7,15,12,19094,19807,16110,-3697
2019,7,15,13,20474,21036,16933,-4103
2019,7,15,14,21563,21941,17308,-4633
2019,7,15,15,22488,22792,17833,-4959
2019,7,15,16,23171,23452,18549,-4903
2019,7,15,17,23698,24043,19106,-4937
2019,7,15,18,24264,24772,19577,-5195
2019,7,15,19,24728,25425,20368,-5057
2019,7,15,20,25196,26095,21016,-5079
2019,7,15,21,25620,26689,21777,-4912
2019,7,15,22,25762,26951,22543,-4408
2019,7,15,23,25242,26431,22580,-3851
2019,7,16,0,24477,25544,22089,-3455
2019,7,16,1,23823,24728,20694,-4034
2019,7,16,2,23338,24087,19955,-4132
2019,7,16,3,21866,22548,18077,-4471
2019,7,16,4,20123,20721,16392,-4329
2019,7,16,5,18541,19235,14744,-4491
2019,7,16,6,17423,18150,14479,-3671
2019,7,16,7,16721,17327,13826,-3501
2019,7,16,8,16311,17039,13578,-3461
2019,7,16,9,16281,17026,13539,-3487
2019,7,16,10,16735,17426,14085,-3341
2019,7,16,11,17840,18663,15137,-3526
2019,7,16,12,19542,20484,16758,-3726
2019,7,16,13,21033,21952,17682,-4270
2019,7,16,14,22254,23221,18669,-4552
2019,7,16,15,23382,24431,19409,-5022
2019,7,16,16,24330,25514,20456,-5058
2019,7,16,17,25107,26495,21606,-4889
2019,7,16,18,25904,27466,22792,-4674
2019,7,16,19,26530,28215,23896,-4319
2019,7,16,20,27063,28729,24428,-4301
2019,7,16,21,27586,29240,24339,-4901
2019,7,16,22,27762,29195,24547,-4648
2019,7,16,23,27251,28714,23938,-4776
2019,7,17,0,26471,27914,23375,-4539
2019,7,17,1,25918,27250,23039,-4211
2019,7,17,2,25450,26581,22426,-4155
2019,7,17,3,23909,25048,20741,-4307
2019,7,17,4,21993,23233,19183,-4050
2019,7,17,5,20370,21715,17612,-4103
2019,7,17,6,19183,20600,16498,-4102
2019,7,17,7,18427,19834,15892,-3942
2019,7,17,8,17991,19369,15433,-3936
2019,7,17,9,17967,19294,15179,-4115
2019,7,17,10,18521,19856,15703,-4153
2019,7,17,11,19808,21243,16927,-4316
2019,7,17,12,21680,22935,18722,-4213
2019,7,17,13,23276,24339,19791,-4548
2019,7,17,14,24632,25512,20994,-4518
2019,7,17,15,25828,26751,22500,-4251
2019,7,17,16,26762,27962,24017,-3945
2019,7,17,17,27404,28678,25004,-3674
2019,7,17,18,28012,29105,25808,-3297
2019,7,17,19,28404,29271,26340,-2931
2019,7,17,20,28695,29249,26929,-2320
2019,7,17,21,28911,29320,26708,-2612
2019,7,17,22,28852,29381,26639,-2742
2019,7,17,23,28296,28963,26370,-2593
2019,7,18,0,27582,28273,25860,-2413
2019,7,18,1,27014,27078,24861,-2217
2019,7,18,2,26483,25730,23039,-2691
2019,7,18,3,24858,23948,20822,-3126
2019,7,18,4,22862,22289,18812,-3477
2019,7,18,5,20963,20872,17226,-3646
2019,7,18,6,19709,19830,16166,-3664
2019,7,18,7,18888,19169,15557,-3612
2019,7,18,8,18405,18774,15045,-3729
2019,7,18,9,18337,18747,14801,-3946
2019,7,18,10,18880,19325,15649,-3676
2019,7,18,11,20090,20638,17183,-3455
2019,7,18,12,21804,22202,18631,-3571
2019,7,18,13,23268,23217,19439,-3778
2019,7,18,14,24384,23959,20317,-3642
2019,7,18,15,25355,24609,21026,-3583
2019,7,18,16,26116,25147,21894,-3253
2019,7,18,17,26631,25541,22110,-3431
2019,7,18,18,27132,25981,22519,-3462
2019,7,18,19,27471,26458,22579,-3879
2019,7,18,20,27718,26805,22898,-3907
2019,7,18,21,27889,26963,22561,-4402
2019,7,18,22,27781,26767,22356,-4411
2019,7,18,23,27078,25995,21874,-4121
2019,7,19,0,26257,25157,21301,-3856
2019,7,19,1,25594,24477,20760,-3717
2019,7,19,2,24983,23832,20481,-3351
2019,7,19,3,23392,22419,19272,-3147
2019,7,19,4,21489,20835,17899,-2936
2019,7,19,5,19927,19501,16062,-3439
2019,7,19,6,18758,18576,15351,-3225
2019,7,19,7,17992,17986,14793,-3193
2019,7,19,8,17544,17661,14504,-3157
2019,7,19,9,17487,17752,14724,-3028
2019,7,19,10,17987,18333,15318,-3015
2019,7,19,11,19166,19653,16523,-3130
2019,7,19,12,20976,21384,18286,-3098
2019,7,19,13,22775,22922,19130,-3792
2019,7,19,14,24170,24259,20601,-3658
2019,7,19,15,25415,25300,21311,-3989
2019,7,19,16,26435,26301,22475,-3826
2019,7,19,17,27151,27356,23527,-3829
2019,7,19,18,27915,28262,24490,-3772
2019,7,19,19,28480,28761,25083,-3678
2019,7,19,20,29005,29144,25969,-3175
2019,7,19,21,29454,29247,26021,-3226
2019,7,19,22,29511,29322,26200,-3122
2019,7,19,23,28863,29047,26147,-2900
2019,7,20,0,28124,28494,25771,-2723
2019,7,20,1,27425,28006,25317,-2689
2019,7,20,2,26889,27492,24865,-2627
2019,7,20,3,25476,26185,22880,-3305
2019,7,20,4,23726,24646,21358,-3288
2019,7,20,5,22038,23225,20177,-3048
2019,7,20,6,20806,22078,18877,-3201
2019,7,20,7,19923,21278,18110,-3168
2019,7,20,8,19330,20686,17409,-3277
2019,7,20,9,18967,20334,17234,-3100
2019,7,20,10,18896,20234,17079,-3155
2019,7,20,11,19200,20635,17525,-3110
2019,7,20,12,20485,21972,18954,-3018
2019,7,20,13,22429,23722,20524,-3198
2019,7,20,14,24308,25504,21765,-3739
2019,7,20,15,26015,27117,23391,-3726
2019,7,20,16,27282,28277,24826,-3451
2019,7,20,17,28088,29054,25749,-3305
2019,7,20,18,28602,29577,26331,-3246
2019,7,20,19,28951,29892,26260,-3632
2019,7,20,20,29323,30130,26500,-3630
2019,7,20,21,29687,30397,27280,-3117
2019,7,20,22,29871,30396,27622,-2774
2019,7,20,23,29752,30156,27406,-2750
2019,7,21,0,29336,29446,26560,-2886
2019,7,21,1,28895,28745,26143,-2602
2019,7,21,2,28471,28208,25523,-2685
2019,7,21,3,27139,26902,24078,-2824
2019,7,21,4,25444,25380,22609,-2771
2019,7,21,5,23930,23986,20777,-3209
2019,7,21,6,22679,22819,19417,-3402
2019,7,21,7,21771,21906,18588,-3318
2019,7,21,8,21121,21244,17779,-3465
2019,7,21,9,20674,20826,17514,-3312
2019,7,21,10,20436,20552,17290,-3262
2019,7,21,11,20422,20750,17868,-2882
2019,7,21,12,21261,21927,19108,-2819
2019,7,21,13,22634,23434,20407,-3027
2019,7,21,14,24316,25024,21699,-3325
2019,7,21,15,25896,26464,23109,-3355
2019,7,21,16,27111,27465,24294,-3171
2019,7,21,17,27908,28320,24878,-3442
2019,7,21,18,28371,29027,25732,-3295
2019,7,21,19,28675,29548,26311,-3237
2019,7,21,20,28947,29899,26626,-3273
2019,7,21,21,29244,30172,26978,-3194
2019,7,21,22,29387,30339,27482,-2857
2019,7,21,23,29083,29996,27432,-2564
2019,7,22,0,28562,29229,27103,-2126
2019,7,22,1,28032,28538,25833,-2705
2019,7,22,2,27535,27735,24878,-2857
2019,7,22,3,26050,26099,23333,-2766
2019,7,22,4,24245,24223,20636,-3587
2019,7,22,5,22585,22600,18649,-3951
2019,7,22,6,21387,21522,17539,-3983
2019,7,22,7,20518,20771,16832,-3939
2019,7,22,8,19964,20279,15903,-4376
2019,7,22,9,19812,20134,15672,-4462
2019,7,22,10,20189,20538,16065,-4473
2019,7,22,11,21118,21492,17377,-4115
2019,7,22,12,22611,22974,19192,-3782
2019,7,22,13,23657,23773,20046,-3727
2019,7,22,14,24727,24583,21179,-3404
2019,7,22,15,25628,25370,21878,-3492
2019,7,22,16,26097,26144,22628,-3516
2019,7,22,17,26437,26725,23478,-3247
2019,7,22,18,26752,27178,24071,-3107
2019,7,22,19,26931,27398,24236,-3162
2019,7,22,20,27021,27290,24132,-3158
2019,7,22,21,27059,27051,23592,-3459
2019,7,22,22,26784,26857,24326,-2531
2019,7,22,23,26160,25755,23224,-2531
2019,7,23,0,25395,24747,22246,-2501
2019,7,23,1,24823,24222,21708,-2514
2019,7,23,2,24196,23530,20708,-2822
2019,7,23,3,22706,22139,19484,-2655
2019,7,23,4,20980,20671,17822,-2849
2019,7,23,5,19548,19465,16036,-3429
2019,7,23,6,18393,18668,14925,-3743
2019,7,23,7,17649,18101,14459,-3642
2019,7,23,8,17203,17737,14197,-3540
2019,7,23,9,17121,17624,14194,-3430
2019,7,23,10,17582,18078,14659,-3419
2019,7,23,11,18600,19007,15694,-3313
2019,7,23,12,19992,20073,16444,-3629
2019,7,23,13,20978,20905,16890,-4015
2019,7,23,14,21739,21412,17175,-4237
2019,7,23,15,22316,21708,17504,-4204
2019,7,23,16,22681,22021,17616,-4405
2019,7,23,17,22864,22189,17703,-4486
2019,7,23,18,23113,22420,18194,-4226
2019,7,23,19,23318,22623,18198,-4425
2019,7,23,20,23433,22730,18396,-4334
2019,7,23,21,23634,22857,18670,-4187
2019,7,23,22,23639,22819,19004,-3815
2019,7,23,23,23171,22457,18487,-3970
2019,7,24,0,22534,22010,18156,-3854
2019,7,24,1,22106,21614,17939,-3675
2019,7,24,2,21761,20998,17094,-3904
2019,7,24,3,20513,19724,16268,-3456
2019,7,24,4,18950,18309,15279,-3030
2019,7,24,5,17410,17144,13963,-3181
2019,7,24,6,16507,16348,13246,-3102
2019,7,24,7,15928,15800,12953,-2847
2019,7,24,8,15604,15519,12674,-2845
2019,7,24,9,15611,15568,12706,-2862
2019,7,24,10,16120,16144,13441,-2703
2019,7,24,11,17163,17300,14684,-2616
2019,7,24,12,18582,18879,15922,-2957
2019,7,24,13,19661,20053,16462,-3591
2019,7,24,14,20511,20831,16741,-4090
2019,7,24,15,21199,21531,17183,-4348
2019,7,24,16,21683,22123,17612,-4511
2019,7,24,17,21994,22655,17948,-4707
2019,7,24,18,22389,23155,18447,-4708
2019,7,24,19,22775,23618,18688,-4930
2019,7,24,20,23161,23977,19331,-4646
2019,7,24,21,23526,24363,19892,-4471
2019,7,24,22,23596,24490,20020,-4470
2019,7,24,23,23111,24115,19886,-4229
2019,7,25,0,22444,23315,19798,-3517
2019,7,25,1,21999,22687,18754,-3933
2019,7,25,2,21644,22083,17987,-4096
2019,7,25,3,20377,20663,16837,-3826
2019,7,25,4,18806,19081,15556,-3525
2019,7,25,5,16961,17764,14054,-3710
2019,7,25,6,16000,16890,13435,-3455
2019,7,25,7,15373,16211,13135,-3076
2019,7,25,8,15018,15794,13022,-2772
2019,7,25,9,15021,15766,13273,-2493
2019,7,25,10,15561,16324,13872,-2452
2019,7,25,11,16646,17505,15156,-2349
2019,7,25,12,18239,18932,16432,-2500
2019,7,25,13,19619,20107,16949,-3158
2019,7,25,14,20608,20993,17179,-3814
2019,7,25,15,21435,21774,17694,-4080
2019,7,25,16,22069,22464,18053,-4411
2019,7,25,17,22539,23100,18580,-4520
2019,7,25,18,23097,23780,19503,-4277
2019,7,25,19,23577,24237,20666,-3571
2019,7,25,20,24063,24621,20977,-3644
2019,7,25,21,24479,24985,21064,-3921
2019,7,25,22,24537,25021,21317,-3704
2019,7,25,23,24054,24608,21291,-3317
2019,7,26,0,23313,23812,20593,-3219
2019,7,26,1,22876,23126,19287,-3839
2019,7,26,2,22457,22530,18567,-3963
2019,7,26,3,21077,21156,17569,-3587
2019,7,26,4,19376,19569,16411,-3158
2019,7,26,5,17582,18210,14916,-3294
2019,7,26,6,16528,17230,14093,-3137
2019,7,26,7,15843,16568,13439,-3129
2019,7,26,8,15431,16122,13121,-3001
2019,7,26,9,15402,16076,13331,-2745
2019,7,26,10,15904,16592,13722,-2870
2019,7,26,11,16984,17660,14743,-2917
2019,7,26,12,18686,19286,16454,-2832
2019,7,26,13,20317,20618,17082,-3536
2019,7,26,14,21541,21741,17642,-4099
2019,7,26,15,22587,22751,18349,-4402
2019,7,26,16,23446,23652,19142,-4510
2019,7,26,17,24089,24321,20080,-4241
2019,7,26,18,24743,25005,20715,-4290
2019,7,26,19,25270,25566,21259,-4307
2019,7,26,20,25703,25961,21828,-4133
2019,7,26,21,26058,26288,22495,-3793
2019,7,26,22,25988,26319,22644,-3675
2019,7,26,23,25288,25595,22822,-2773
2019,7,27,0,24311,24526,22373,-2153
2019,7,27,1,23607,23629,21341,-2288
2019,7,27,2,23029,22833,20212,-2621
2019,7,27,3,21643,21505,18597,-2908
2019,7,27,4,19941,20028,17641,-2387
2019,7,27,5,18470,18681,16416,-2265
2019,7,27,6,17311,17653,15324,-2329
2019,7,27,7,16497,16935,14575,-2360
2019,7,27,8,15960,16438,14003,-2435
2019,7,27,9,15689,16163,13935,-2228
2019,7,27,10,15705,16144,14074,-2070
2019,7,27,11,15939,16409,14308,-2101
2019,7,27,12,17053,17465,15189,-2276
2019,7,27,13,18725,18867,15955,-2912
2019,7,27,14,20209,20307,16963,-3344
2019,7,27,15,21435,21553,17970,-3583
2019,7,27,16,22381,22561,19194,-3367
2019,7,27,17,23036,23276,19989,-3287
2019,7,27,18,23425,23724,20681,-3043
2019,7,27,19,23728,24080,20753,-3327
2019,7,27,20,23977,24382,21042,-3340
2019,7,27,21,24215,24665,21772,-2893
2019,7,27,22,24160,24771,22092,-2679
2019,7,27,23,23826,24425,21878,-2547
2019,7,28,0,23058,23676,20230,-3446
2019,7,28,1,22617,23118,19117,-4001
2019,7,28,2,22263,22679,18716,-3963
2019,7,28,3,21142,21645,17850,-3795
2019,7,28,4,19670,20347,16939,-3408
2019,7,28,5,18439,19103,15691,-3412
2019,7,28,6,17418,18104,15240,-2864
2019,7,28,7,16674,17411,14616,-2795
2019,7,28,8,16179,16916,14489,-2427
2019,7,28,9,15908,16655,14258,-2397
2019,7,28,10,15835,16581,14329,-2252
2019,7,28,11,15897,16680,14431,-2249
2019,7,28,12,16766,17608,15112,-2496
2019,7,28,13,18251,19026,16484,-2542
2019,7,28,14,19804,20527,17584,-2943
2019,7,28,15,21214,21893,18116,-3777
2019,7,28,16,22390,23135,18766,-4369
2019,7,28,17,23280,24093,20047,-4046
2019,7,28,18,23948,24723,20531,-4192
2019,7,28,19,24474,25159,21463,-3696
2019,7,28,20,24986,25684,21770,-3914
2019,7,28,21,25487,26257,22330,-3927
2019,7,28,22,25699,26487,22481,-4006
2019,7,28,23,25556,26284,21865,-4419
2019,7,29,0,24994,25750,21700,-4050
2019,7,29,1,24715,25472,21164,-4308
2019,7,29,2,24442,25073,21053,-4020
2019,7,29,3,23153,23793,19962,-3831
2019,7,29,4,21484,22063,18544,-3519
2019,7,29,5,19537,20468,16535,-3933
2019,7,29,6,18524,19425,16005,-3420
2019,7,29,7,17837,18616,15299,-3317
2019,7,29,8,17440,18199,14877,-3322
2019,7,29,9,17432,18122,14826,-3296
2019,7,29,10,18030,18646,15449,-3197
2019,7,29,11,19163,19810,16492,-3318
2019,7,29,12,20979,21622,17625,-3997
2019,7,29,13,22754,23271,19451,-3820
2019,7,29,14,24227,24755,20287,-4468
2019,7,29,15,25518,26150,21686,-4464
2019,7,29,16,26553,27400,22922,-4478
2019,7,29,17,27334,28372,24045,-4327
2019,7,29,18,28054,29185,25058,-4127
2019,7,29,19,28544,29706,25653,-4053
2019,7,29,20,28950,30073,26094,-3979
2019,7,29,21,29253,30383,26076,-4307
2019,7,29,22,29141,30339,26101,-4238
2019,7,29,23,28560,29777,25896,-3881
2019,7,30,0,27811,28947,25406,-3541
2019,7,30,1,27236,28205,24513,-3692
2019,7,30,2,26522,27212,23826,-3386
2019,7,30,3,24788,25388,21753,-3635
2019,7,30,4,22758,23459,19707,-3752
2019,7,30,5,21044,21904,18293,-3611
2019,7,30,6,19793,20786,17536,-3250
2019,7,30,7,18979,20012,16819,-3193
2019,7,30,8,18491,19531,16118,-3413
2019,7,30,9,18413,19402,15926,-3476
2019,7,30,10,18957,19920,16371,-3549
2019,7,30,11,20098,21161,17385,-3776
2019,7,30,12,21899,22972,18854,-4118
2019,7,30,13,23508,24461,19738,-4723
2019,7,30,14,24930,25844,21038,-4806
2019,7,30,15,26187,27126,22809,-4317
2019,7,30,16,27187,28303,23948,-4355
2019,7,30,17,27904,29134,24961,-4173
2019,7,30,18,28518,29757,25685,-4072
2019,7,30,19,28919,29971,26047,-3924
2019,7,30,20,29148,29813,25676,-4137
2019,7,30,21,29356,30052,25898,-4154
2019,7,30,22,29167,30068,25848,-4220
2019,7,30,23,28402,29422,25338,-4084
2019,7,31,0,27467,28445,24705,-3740
2019,7,31,1,26800,27615,24062,-3553
2019,7,31,2,26072,26629,22958,-3671
2019,7,31,3,24359,24961,21115,-3846
2019,7,31,4,22308,23068,19467,-3601
2019,7,31,5,20872,21489,16882,-4607
2019,7,31,6,19632,20376,16127,-4249
2019,7,31,7,18790,19557,15606,-3951
2019,7,31,8,18271,19040,15311,-3729
2019,7,31,9,18174,18931,15164,-3767
2019,7,31,10,18716,19472,15831,-3641
2019,7,31,11,19852,20616,16791,-3825
2019,7,31,12,21580,22156,18064,-4092
2019,7,31,13,23007,23351,19263,-4088
2019,7,31,14,24267,24433,20370,-4063
2019,7,31,15,25343,25494,21617,-3877
2019,7,31,16,26202,26352,22450,-3902
2019,7,31,17,26770,27027,23428,-3599
2019,7,31,18,27307,27612,24222,-3390
2019,7,31,19,27671,27714,24490,-3224
2019,7,31,20,27894,27196,24120,-3076
2019,7,31,21,28018,26778,23581,-3197
2019,7,31,22,27705,26251,23334,-2917
2019,7,31,23,26975,25494,22661,-2833
2019,8,1,0,26101,24726,21862,-2864
2019,8,1,1,25568,24167,21100,-3067
2019,8,1,2,24909,23436,20178,-3258
2019,8,1,3,23287,21988,18821,-3167
2019,8,1,4,21341,20352,17117,-3235
2019,8,1,5,19653,19032,15404,-3628
2019,8,1,6,18485,18113,14626,-3487
2019,8,1,7,17694,17492,13971,-3521
2019,8,1,8,17221,17133,13536,-3597
2019,8,1,9,17150,17115,13539,-3576
2019,8,1,10,17669,17654,14237,-3417
2019,8,1,11,18737,18787,15466,-3321
2019,8,1,12,20265,20214,16810,-3404
2019,8,1,13,21718,21372,17452,-3920
2019,8,1,14,22856,22139,17940,-4199
2019,8,1,15,23877,22959,18923,-4036
2019,8,1,16,24687,23692,19685,-4007
2019,8,1,17,25324,24365,20176,-4189
2019,8,1,18,25915,25082,20898,-4184
2019,8,1,19,26362,25696,21336,-4360
2019,8,1,20,26734,26294,22098,-4196
2019,8,1,21,26989,26700,22438,-4262
2019,8,1,22,26991,26715,22505,-4210
2019,8,1,23,26214,26100,21977,-4123
2019,8,2,0,25217,25268,21274,-3994
2019,8,2,1,24729,24483,20626,-3857
2019,8,2,2,23985,23578,19759,-3819
2019,8,2,3,22369,21968,18040,-3928
2019,8,2,4,20547,20226,16250,-3976
2019,8,2,5,18516,18865,15200,-3665
2019,8,2,6,17449,17908,14738,-3170
2019,8,2,7,16709,17249,14292,-2957
2019,8,2,8,16262,16833,13628,-3205
2019,8,2,9,16199,16822,13709,-3113
2019,8,2,10,16672,17305,14417,-2888
2019,8,2,11,17667,18353,15442,-2911
2019,8,2,12,19127,19794,16672,-3122
2019,8,2,13,20518,20890,17453,-3437
2019,8,2,14,21629,21738,17716,-4022
2019,8,2,15,22591,22575,18864,-3711
2019,8,2,16,23359,23279,19563,-3716
2019,8,2,17,23975,23851,19932,-3919
2019,8,2,18,24586,24540,20859,-3681
2019,8,2,19,25086,25137,21368,-3769
2019,8,2,20,25451,25484,21650,-3834
2019,8,2,21,25665,25822,22033,-3789
2019,8,2,22,25577,25839,22386,-3453
2019,8,2,23,24839,25203,22103,-3100
2019,8,3,0,23908,24263,21107,-3156
2019,8,3,1,23510,23612,20561,-3051
2019,8,3,2,22918,22960,19823,-3137
2019,8,3,3,21580,21686,17957,-3729
2019,8,3,4,20007,20249,16479,-3770
2019,8,3,5,18734,18950,15341,-3609
2019,8,3,6,17672,17976,14244,-3732
2019,8,3,7,16924,17328,13897,-3431
2019,8,3,8,16442,16895,13482,-3413
2019,8,3,9,16231,16611,13623,-2988
2019,8,3,10,16263,16563,14196,-2367
2019,8,3,11,16416,16876,14729,-2147
2019,8,3,12,17367,17899,15464,-2435
2019,8,3,13,18904,19274,16484,-2790
2019,8,3,14,20310,20460,17456,-3004
2019,8,3,15,21535,21544,18797,-2747
2019,8,3,16,22466,22523,19357,-3166
2019,8,3,17,23106,23268,19897,-3371
2019,8,3,18,23514,23776,20410,-3366
2019,8,3,19,23835,24176,20902,-3274
2019,8,3,20,24131,24546,21198,-3348
2019,8,3,21,24318,24854,21353,-3501
2019,8,3,22,24367,24967,21487,-3480
2019,8,3,23,24016,24646,21236,-3410
2019,8,4,0,23288,23853,20627,-3226
2019,8,4,1,23080,23252,19888,-3364
2019,8,4,2,22674,22697,19723,-2974
2019,8,4,3,21540,21638,18752,-2886
2019,8,4,4,20116,20262,17175,-3087
2019,8,4,5,18660,18800,15208,-3592
2019,8,4,6,17669,17889,14540,-3349
2019,8,4,7,16926,17141,13832,-3309
2019,8,4,8,16405,16721,13163,-3558
2019,8,4,9,16126,16418,12782,-3636
2019,8,4,10,16024,16366,12885,-3481
2019,8,4,11,15944,16372,12948,-3424
2019,8,4,12,16668,17086,14341,-2745
2019,8,4,13,18053,18242,15082,-3160
2019,8,4,14,19355,19415,15800,-3615
2019,8,4,15,20529,20528,16737,-3791
2019,8,4,16,21485,21366,17487,-3879
2019,8,4,17,22167,22100,18352,-3748
2019,8,4,18,22626,22694,19123,-3571
2019,8,4,19,22965,23268,19528,-3740
2019,8,4,20,23294,23726,19964,-3762
2019,8,4,21,23585,24096,20228,-3868
2019,8,4,22,23768,24252,20673,-3579
2019,8,4,23,23460,23935,20540,-3395
2019,8,5,0,22828,23388,20283,-3105
2019,8,5,1,22696,23020,20038,-2982
2019,8,5,2,22214,22455,19418,-3037
2019,8,5,3,20923,21162,18285,-2877
2019,8,5,4,19406,19722,16941,-2781
2019,8,5,5,17820,18534,14982,-3552
2019,8,5,6,16830,17637,14047,-3590
2019,8,5,7,16155,16949,13626,-3323
2019,8,5,8,15748,16470,13267,-3203
2019,8,5,9,15703,16391,13234,-3157
2019,8,5,10,16182,16824,14031,-2793
2019,8,5,11,17088,17682,14973,-2709
2019,8,5,12,18477,19033,15830,-3203
2019,8,5,13,19833,20102,16264,-3838
2019,8,5,14,20836,20912,16696,-4216
2019,8,5,15,21696,21653,17231,-4422
2019,8,5,16,22429,22299,18205,-4094
2019,8,5,17,23000,22849,18975,-3874
2019,8,5,18,23612,23440,19911,-3529
2019,8,5,19,24096,23971,20345,-3626
2019,8,5,20,24556,24490,20818,-3672
2019,8,5,21,24958,25033,21501,-3532
2019,8,5,22,25095,25328,22061,-3267
2019,8,5,23,24586,24895,21496,-3399
2019,8,6,0,23800,24236,21039,-3197
2019,8,6,1,23570,23739,20381,-3358
2019,8,6,2,22908,22960,19395,-3565
2019,8,6,3,21390,21512,18078,-3434
2019,8,6,4,19694,19964,16669,-3295
2019,8,6,5,18506,18632,15175,-3457
2019,8,6,6,17476,17714,14814,-2900
2019,8,6,7,16835,17142,14577,-2565
2019,8,6,8,16483,16827,14211,-2616
2019,8,6,9,16514,16884,14252,-2632
2019,8,6,10,17153,17541,14934,-2607
2019,8,6,11,18328,18790,16199,-2591
2019,8,6,12,19908,20206,17170,-3036
2019,8,6,13,21381,21350,17545,-3805
2019,8,6,14,22548,22242,18102,-4140
2019,8,6,15,23567,23102,19325,-3777
2019,8,6,16,24382,23760,20425,-3335
2019,8,6,17,25017,24148,20665,-3483
2019,8,6,18,25616,24402,21348,-3054
2019,8,6,19,26083,24467,21229,-3238
2019,8,6,20,26459,24674,21504,-3170
2019,8,6,21,26723,25003,22113,-2890
2019,8,6,22,26725,25098,22015,-3083
2019,8,6,23,26133,24500,21573,-2927
2019,8,7,0,25282,23777,20918,-2859
2019,8,7,1,25010,23412,20580,-2832
2019,8,7,2,24259,22715,19592,-3123
2019,8,7,3,22665,21460,18466,-2994
2019,8,7,4,20837,20028,17182,-2846
2019,8,7,5,18940,18778,14969,-3809
2019,8,7,6,17925,17925,14684,-3241
2019,8,7,7,17263,17424,14656,-2768
2019,8,7,8,16903,17114,14275,-2839
2019,8,7,9,16935,17163,14247,-2916
2019,8,7,10,17644,17851,14981,-2870
2019,8,7,11,18881,19179,16135,-3044
2019,8,7,12,20513,20644,16994,-3650
2019,8,7,13,22001,21660,17629,-4031
2019,8,7,14,23233,22592,18249,-4343
2019,8,7,15,24326,23421,19529,-3892
2019,8,7,16,25189,24207,20408,-3799
2019,8,7,17,25826,24923,21371,-3552
2019,8,7,18,26383,25603,22405,-3198
2019,8,7,19,26739,25859,22579,-3280
2019,8,7,20,26985,25544,22292,-3252
2019,8,7,21,27063,25333,22191,-3142
2019,8,7,22,26837,25225,22381,-2844
2019,8,7,23,26078,24389,21763,-2626
2019,8,8,0,25314,23632,20956,-2676
2019,8,8,1,25111,22995,20378,-2617
2019,8,8,2,24342,22118,19451,-2667
2019,8,8,3,22723,20813,17776,-3037
2019,8,8,4,20923,19377,16801,-2576
2019,8,8,5,18811,18167,15008,-3159
2019,8,8,6,17774,17322,14493,-2829
2019,8,8,7,17063,16760,14052,-2708
2019,8,8,8,16657,16395,13874,-2521
2019,8,8,9,16640,16435,13998,-2437
2019,8,8,10,17272,17048,14599,-2449
2019,8,8,11,18419,18205,15663,-2542
2019,8,8,12,19958,19729,16375,-3354
2019,8,8,13,21505,21006,17320,-3686
2019,8,8,14,22637,21968,18099,-3869
2019,8,8,15,23628,22934,19176,-3758
2019,8,8,16,24446,23793,20124,-3669
2019,8,8,17,25074,24446,21011,-3435
2019,8,8,18,25657,25062,21931,-3131
2019,8,8,19,26056,25517,22284,-3233
2019,8,8,20,26396,25827,22894,-2933
2019,8,8,21,26647,26085,23202,-2883
2019,8,8,22,26578,26088,23107,-2981
2019,8,8,23,25840,25329,22475,-2854
2019,8,9,0,24980,24412,21686,-2726
2019,8,9,1,24686,23310,20513,-2797
2019,8,9,2,23915,22298,19418,-2880
2019,8,9,3,22318,20832,17778,-3054
2019,8,9,4,20520,19330,16828,-2502
2019,8,9,5,18471,18032,15399,-2633
2019,8,9,6,17417,17173,14722,-2451
2019,8,9,7,16673,16570,14051,-2519
2019,8,9,8,16205,16222,13704,-2518
2019,8,9,9,16108,16186,13763,-2423
2019,8,9,10,16582,16681,14396,-2285
2019,8,9,11,17552,17693,15604,-2089
2019,8,9,12,18940,19120,16587,-2533
2019,8,9,13,20246,20231,17612,-2619
2019,8,9,14,21240,21099,18119,-2980
2019,8,9,15,22036,21886,18775,-3111
2019,8,9,16,22617,22481,19364,-3117
2019,8,9,17,23005,23007,20019,-2988
2019,8,9,18,23403,23489,20744,-2745
2019,8,9,19,23706,23753,21082,-2671
2019,8,9,20,23911,23968,21402,-2566
2019,8,9,21,24019,23910,21537,-2373
2019,8,9,22,23801,23675,21272,-2403
2019,8,9,23,23021,23089,21071,-2018
2019,8,10,0,22057,22292,20170,-2122
2019,8,10,1,21741,21750,19339,-2411
2019,8,10,2,21126,20967,18449,-2518
2019,8,10,3,19842,19707,16961,-2746
2019,8,10,4,18370,18371,15947,-2424
2019,8,10,5,17237,17223,14153,-3070
2019,8,10,6,16280,16354,13132,-3222
2019,8,10,7,15587,15693,12799,-2894
2019,8,10,8,15121,15222,12403,-2819
2019,8,10,9,14892,14988,12319,-2669
2019,8,10,10,14894,15042,12595,-2447
2019,8,10,11,14935,15237,12754,-2483
2019,8,10,12,15662,16028,13584,-2444
2019,8,10,13,16871,17087,14286,-2801
2019,8,10,14,17908,18014,15488,-2526
2019,8,10,15,18701,18709,15960,-2749
2019,8,10,16,19230,19235,16562,-2673
2019,8,10,17,19541,19555,16855,-2700
2019,8,10,18,19759,19755,17081,-2674
2019,8,10,19,19969,19921,17217,-2704
2019,8,10,20,20179,20117,17483,-2634
2019,8,10,21,20350,20381,17672,-2709
2019,8,10,22,20397,20519,17658,-2861
2019,8,10,23,20105,20276,17401,-2875
2019,8,11,0,19549,19714,16852,-2862
2019,8,11,1,19558,19461,16451,-3010
2019,8,11,2,19250,18978,16248,-2730
2019,8,11,3,18324,18031,15212,-2819
2019,8,11,4,17168,16916,14155,-2761
2019,8,11,5,15768,15922,12910,-3012
2019,8,11,6,14988,15100,12407,-2693
2019,8,11,7,14417,14532,12085,-2447
2019,8,11,8,14034,14170,11861,-2309
2019,8,11,9,13850,13989,11687,-2302
2019,8,11,10,13814,13996,11725,-2271
2019,8,11,11,13727,14082,11733,-2349
2019,8,11,12,14227,14671,12092,-2579
2019,8,11,13,15204,15597,12864,-2733
2019,8,11,14,16170,16463,13593,-2870
2019,8,11,15,16976,17204,14379,-2825
2019,8,11,16,17634,17832,14885,-2947
2019,8,11,17,18151,18424,15406,-3018
2019,8,11,18,18578,18885,15784,-3101
2019,8,11,19,18966,19328,16111,-3217
2019,8,11,20,19400,19821,16424,-3397
2019,8,11,21,19866,20344,16917,-3427
2019,8,11,22,20197,20710,17201,-3509
2019,8,11,23,20182,20659,16952,-3707
2019,8,12,0,19772,20271,16904,-3367
2019,8,12,1,19948,20173,16506,-3667
2019,8,12,2,19650,19813,16613,-3200
2019,8,12,3,18656,18761,15205,-3556
2019,8,12,4,17446,17503,14291,-3212
2019,8,12,5,15984,16559,13611,-2948
2019,8,12,6,15239,15867,13473,-2394
2019,8,12,7,14748,15361,13025,-2336
2019,8,12,8,14489,15128,13203,-1925
2019,8,12,9,14569,15197,13250,-1947
2019,8,12,10,15198,15805,13867,-1938
2019,8,12,11,16233,16921,14961,-1960
2019,8,12,12,17670,18376,15842,-2534
2019,8,12,13,19010,19508,16370,-3138
2019,8,12,14,20073,20397,16881,-3516
2019,8,12,15,20987,21259,17458,-3801
2019,8,12,16,21791,22028,17932,-4096
2019,8,12,17,22454,22792,18718,-4074
2019,8,12,18,23157,23607,19426,-4181
2019,8,12,19,23692,24304,20049,-4255
2019,8,12,20,24165,24876,20584,-4292
2019,8,12,21,24570,25275,20877,-4398
2019,8,12,22,24630,25402,21203,-4199
2019,8,12,23,24127,24918,20967,-3951
2019,8,13,0,23399,24189,20230,-3959
2019,8,13,1,23323,23865,20114,-3751
2019,8,13,2,22639,23124,19330,-3794
2019,8,13,3,21153,21765,17929,-3836
2019,8,13,4,19481,20258,16781,-3477
2019,8,13,5,17943,18939,15694,-3245
2019,8,13,6,17022,18097,15051,-3046
2019,8,13,7,16414,17555,14662,-2893
2019,8,13,8,16090,17290,14405,-2885
2019,8,13,9,16150,17280,14349,-2931
2019,8,13,10,16879,17960,15105,-2855
2019,8,13,11,18133,19157,16047,-3110
2019,8,13,12,19676,20485,17147,-3338
2019,8,13,13,20980,21479,17874,-3605
2019,8,13,14,22081,22387,18308,-4079
2019,8,13,15,22974,23049,19195,-3854
2019,8,13,16,23648,23433,19733,-3700
2019,8,13,17,24093,23592,19837,-3755
2019,8,13,18,24495,23611,19831,-3780
2019,8,13,19,24672,23660,19714,-3946
2019,8,13,20,24710,23865,20059,-3806
2019,8,13,21,24716,24147,20406,-3741
2019,8,13,22,24507,24314,20649,-3665
2019,8,13,23,23933,23894,20532,-3362
2019,8,14,0,23296,23407,19994,-3413
2019,8,14,1,23229,23195,19747,-3448
2019,8,14,2,22475,22449,19075,-3374
2019,8,14,3,20990,21106,17623,-3483
2019,8,14,4,19308,19661,16167,-3494
2019,8,14,5,18097,18441,14914,-3527
2019,8,14,6,17147,17616,14359,-3257
2019,8,14,7,16501,17066,14170,-2896
2019,8,14,8,16132,16793,13995,-2798
2019,8,14,9,16121,16841,14112,-2729
2019,8,14,10,16760,17487,14780,-2707
2019,8,14,11,17875,18647,15996,-2651
2019,8,14,12,19199,20051,16523,-3528
2019,8,14,13,20390,21081,17127,-3954
2019,8,14,14,21221,21813,17680,-4133
2019,8,14,15,21903,22420,18472,-3948
2019,8,14,16,22440,23053,18504,-4549
2019,8,14,17,22863,23630,18931,-4699
2019,8,14,18,23311,24029,19019,-5010
2019,8,14,19,23667,24240,19379,-4861
2019,8,14,20,23986,24338,19417,-4921
2019,8,14,21,24215,24422,19667,-4755
2019,8,14,22,24119,24394,19638,-4756
2019,8,14,23,23408,23947,19523,-4424
2019,8,15,0,22714,23335,19068,-4267
2019,8,15,1,22521,22946,18669,-4277
2019,8,15,2,21750,22107,17965,-4142
2019,8,15,3,20250,20718,16750,-3968
2019,8,15,4,18636,19159,15944,-3215
2019,8,15,5,17415,17958,14596,-3362
2019,8,15,6,16509,17125,14002,-3123
2019,8,15,7,15895,16556,13791,-2765
2019,8,15,8,15553,16233,13436,-2797
2019,8,15,9,15570,16247,13514,-2733
2019,8,15,10,16193,16830,14080,-2750
2019,8,15,11,17302,17915,15071,-2844
2019,8,15,12,18602,19294,15665,-3629
2019,8,15,13,19717,20429,16163,-4266
2019,8,15,14,20576,21299,16751,-4548
2019,8,15,15,21283,22073,17291,-4782
2019,8,15,16,21826,22718,17832,-4886
2019,8,15,17,22266,23340,18230,-5110
2019,8,15,18,22732,23967,18891,-5076
2019,8,15,19,23073,24454,19624,-4830
2019,8,15,20,23353,24739,19855,-4884
2019,8,15,21,23586,25035,20158,-4877
2019,8,15,22,23495,24731,20212,-4519
2019,8,15,23,22817,23908,19771,-4137
2019,8,16,0,22118,23098,19346,-3752
2019,8,16,1,22000,22684,18935,-3749
2019,8,16,2,21274,21808,17983,-3825
2019,8,16,3,19892,20492,16692,-3800
2019,8,16,4,18388,19011,15845,-3166
2019,8,16,5,17202,17827,14370,-3457
2019,8,16,6,16307,16970,13491,-3479
2019,8,16,7,15723,16375,13127,-3248
2019,8,16,8,15399,16027,13046,-2981
2019,8,16,9,15429,16023,12866,-3157
2019,8,16,10,16083,16614,13554,-3060
2019,8,16,11,17203,17697,14775,-2922
2019,8,16,12,18512,18996,15532,-3464
2019,8,16,13,19701,20064,16107,-3957
2019,8,16,14,20621,20962,16587,-4375
2019,8,16,15,21371,21818,17290,-4528
2019,8,16,16,21956,22462,17753,-4709
2019,8,16,17,22424,22948,18406,-4542
2019,8,16,18,22908,23537,19301,-4236
2019,8,16,19,23278,23986,19975,-4011
2019,8,16,20,23526,24320,20612,-3708
2019,8,16,21,23702,24531,20909,-3622
2019,8,16,22,23543,24460,21001,-3459
2019,8,16,23,22906,23815,20286,-3529
2019,8,17,0,22169,23044,19213,-3831
2019,8,17,1,22005,22667,18587,-4080
2019,8,17,2,21370,21877,18412,-3465
2019,8,17,3,20145,20722,17133,-3589
2019,8,17,4,18736,19504,16227,-3277
2019,8,17,5,17892,18450,15028,-3422
2019,8,17,6,16927,17654,14222,-3432
2019,8,17,7,16266,17046,13517,-3529
2019,8,17,8,15853,16693,13208,-3485
2019,8,17,9,15690,16541,13141,-3400
2019,8,17,10,15854,16668,13310,-3358
2019,8,17,11,16122,17024,13943,-3081
2019,8,17,12,16962,17873,14591,-3282
2019,8,17,13,18381,19052,15726,-3326
2019,8,17,14,19667,20172,16874,-3298
2019,8,17,15,20778,21199,17735,-3464
2019,8,17,16,21648,22041,18318,-3723
2019,8,17,17,22276,22704,19104,-3600
2019,8,17,18,22695,23149,19372,-3777
2019,8,17,19,23011,23490,19396,-4094
2019,8,17,20,23290,23793,19935,-3858
2019,8,17,21,23508,24042,20447,-3595
2019,8,17,22,23493,24040,20631,-3409
2019,8,17,23,23162,23493,20348,-3145
2019,8,18,0,22583,22897,19488,-3409
2019,8,18,1,22550,22658,19221,-3437
2019,8,18,2,22052,22026,18661,-3365
2019,8,18,3,20972,21022,17473,-3549
2019,8,18,4,19644,19904,16277,-3627
2019,8,18,5,18324,18882,15389,-3493
2019,8,18,6,17356,18106,14834,-3272
2019,8,18,7,16643,17420,13925,-3495
2019,8,18,8,16168,16962,13544,-3418
2019,8,18,9,15932,16730,13448,-3282
2019,8,18,10,15975,16695,13621,-3074
2019,8,18,11,16069,16885,13977,-2908
2019,8,18,12,16801,17509,14517,-2992
2019,8,18,13,18303,18547,15316,-3231
2019,8,18,14,19781,19779,16470,-3309
2019,8,18,15,21177,21132,17507,-3625
2019,8,18,16,22375,22469,18652,-3817
2019,8,18,17,23346,23554,19575,-3979
2019,8,18,18,24039,24467,20527,-3940
2019,8,18,19,24514,25279,21324,-3955
2019,8,18,20,24874,25842,21742,-4100
2019,8,18,21,25159,26225,22283,-3942
2019,8,18,22,25177,25946,22497,-3449
2019,8,18,23,24853,25283,21972,-3311
2019,8,19,0,24285,24741,21533,-3208
2019,8,19,1,24297,24224,20975,-3249
2019,8,19,2,23612,23128,19827,-3301
2019,8,19,3,22251,21726,18406,-3320
2019,8,19,4,20684,20244,17281,-2963
2019,8,19,5,19484,19026,15815,-3211
2019,8,19,6,18526,18256,14821,-3435
2019,8,19,7,17880,17715,14476,-3239
2019,8,19,8,17524,17530,14445,-3085
2019,8,19,9,17572,17684,14619,-3065
2019,8,19,10,18295,18340,15008,-3332
2019,8,19,11,19528,19522,16381,-3141
2019,8,19,12,21158,21062,17403,-3659
2019,8,19,13,22897,22524,18698,-3826
2019,8,19,14,24261,23779,20031,-3748
2019,8,19,15,25510,24849,21326,-3523
2019,8,19,16,26587,25869,22588,-3281
2019,8,19,17,27413,26801,23656,-3145
2019,8,19,18,28108,27676,24659,-3017
2019,8,19,19,28496,28223,25125,-3098
2019,8,19,20,28730,28488,25973,-2515
2019,8,19,21,28879,28238,26080,-2158
2019,8,19,22,28684,27867,25683,-2184
2019,8,19,23,27904,27059,25121,-1938
2019,8,20,0,27094,26116,23915,-2201
2019,8,20,1,26708,25697,22674,-3023
2019,8,20,2,25608,24641,21694,-2947
2019,8,20,3,23788,23009,19702,-3307
2019,8,20,4,21823,21208,17868,-3340
2019,8,20,5,19611,19899,16317,-3582
2019,8,20,6,0,18805,15669,-3136
2019,8,20,7,0,18026,14928,-3098
2019,8,20,8,0,17612,14710,-2902
2019,8,20,9,0,17566,14737,-2829
2019,8,20,10,0,18119,15191,-2928
2019,8,20,11,0,19127,16207,-2920
2019,8,20,12,0,20542,17190,-3352
2019,8,20,13,0,21752,18206,-3546
2019,8,20,14,0,22727,19199,-3528
2019,8,20,15,0,23706,20677,-3029
2019,8,20,16,0,24625,21657,-2968
2019,8,20,17,0,25511,22587,-2924
2019,8,20,18,0,26347,23376,-2971
2019,8,20,19,0,27009,23919,-3090
2019,8,20,20,0,27434,24478,-2956
2019,8,20,21,0,27740,24569,-3171
2019,8,20,22,0,27882,24745,-3137
2019,8,20,23,0,27374,24968,-2406
2019,8,21,0,0,26397,24080,-2317
2019,8,21,1,0,25883,23452,-2431
2019,8,21,2,0,24713,21635,-3078
2019,8,21,3,0,23173,19743,-3430
2019,8,21,4,0,21441,18372,-3069
2019,8,21,5,19764,20102,16848,-3254
2019,8,21,6,18753,19223,16221,-3002
2019,8,21,7,18072,18718,15801,-2917
2019,8,21,8,17702,18452,15437,-3015
2019,8,21,9,17714,18525,15510,-3015
2019,8,21,10,18429,19175,16282,-2893
2019,8,21,11,19730,20410,17168,-3242
2019,8,21,12,21223,21799,17616,-4183
2019,8,21,13,22538,22940,18412,-4528
2019,8,21,14,23700,23947,19429,-4518
2019,8,21,15,24756,24935,20968,-3967
2019,8,21,16,25643,25758,22002,-3756
2019,8,21,17,26328,26111,22865,-3246
2019,8,21,18,26939,26775,23607,-3168
2019,8,21,19,27341,27446,24392,-3054
2019,8,21,20,27643,27952,24744,-3208
2019,8,21,21,27822,28182,24160,-4022
2019,8,21,22,27657,27905,24161,-3744
2019,8,21,23,26981,26857,23809,-3048
2019,8,22,0,26320,25961,23155,-2806
2019,8,22,1,26113,25665,22446,-3219
2019,8,22,2,25166,24769,21182,-3587
2019,8,22,3,23495,23365,19424,-3941
2019,8,22,4,21645,21706,18077,-3629
2019,8,22,5,19868,20371,17163,-3208
2019,8,22,6,18842,19393,16352,-3041
2019,8,22,7,18126,18695,15577,-3118
2019,8,22,8,17701,18252,15327,-2925
2019,8,22,9,17668,18173,15252,-2921
2019,8,22,10,18298,18761,15636,-3125
2019,8,22,11,19510,19933,16913,-3020
2019,8,22,12,20917,21242,17581,-3661
2019,8,22,13,22182,22446,18565,-3881
2019,8,22,14,23231,23520,19537,-3983
2019,8,22,15,24170,24432,20649,-3783
2019,8,22,16,24921,25160,21614,-3546
2019,8,22,17,25496,25733,22322,-3411
2019,8,22,18,25999,26279,22966,-3313
2019,8,22,19,26298,26626,23917,-2709
2019,8,22,20,26497,26748,24212,-2536
2019,8,22,21,26623,26896,24059,-2837
2019,8,22,22,26408,26815,23894,-2921
2019,8,22,23,25595,26052,23555,-2497
2019,8,23,0,24867,25338,22805,-2533
2019,8,23,1,24530,24803,22342,-2461
2019,8,23,2,23520,23197,20518,-2679
2019,8,23,3,21923,21591,18702,-2889
2019,8,23,4,20200,20038,17426,-2612
2019,8,23,5,18958,18749,15503,-3246
2019,8,23,6,17912,17843,14653,-3190
2019,8,23,7,17175,17231,14478,-2753
2019,8,23,8,16717,16770,14182,-2588
2019,8,23,9,16603,16651,13996,-2655
2019,8,23,10,17088,17093,14439,-2654
2019,8,23,11,18090,18058,15624,-2434
2019,8,23,12,19146,19098,16136,-2962
2019,8,23,13,19998,19786,16296,-3490
2019,8,23,14,20611,20208,16839,-3369
2019,8,23,15,21069,20477,17114,-3363
2019,8,23,16,21361,20685,17300,-3385
2019,8,23,17,21542,20850,17508,-3342
2019,8,23,18,21774,21032,17651,-3381
2019,8,23,19,21973,21182,18030,-3152
2019,8,23,20,22115,21284,18307,-2977
2019,8,23,21,22231,21213,18266,-2947
2019,8,23,22,22057,21019,18336,-2683
2019,8,23,23,21456,20523,17956,-2567
2019,8,24,0,20823,20040,17373,-2667
2019,8,24,1,20610,19874,17198,-2676
2019,8,24,2,19906,19110,16257,-2853
2019,8,24,3,18724,18067,15449,-2618
2019,8,24,4,17400,16885,14427,-2458
2019,8,24,5,16185,15854,12535,-3319
2019,8,24,6,15354,15044,12115,-2929
2019,8,24,7,14776,14495,11697,-2798
2019,8,24,8,14403,14178,11552,-2626
2019,8,24,9,14247,14052,11588,-2464
2019,8,24,10,14320,14169,11699,-2470
2019,8,24,11,14513,14426,12022,-2404
2019,8,24,12,15084,15089,12834,-2255
2019,8,24,13,15975,15967,13481,-2486
2019,8,24,14,16766,16654,14099,-2555
2019,8,24,15,17325,17149,14417,-2732
2019,8,24,16,17653,17462,14675,-2787
2019,8,24,17,17830,17616,14862,-2754
2019,8,24,18,17946,17709,14554,-3155
2019,8,24,19,18107,17882,14644,-3238
2019,8,24,20,18359,18091,15012,-3079
2019,8,24,21,18659,18355,15510,-2845
2019,8,24,22,18861,18538,15698,-2840
2019,8,24,23,18700,18398,15545,-2853
2019,8,25,0,18487,18164,15317,-2847
2019,8,25,1,18547,18207,15128,-3079
2019,8,25,2,18085,17678,14909,-2769
2019,8,25,3,17247,16879,14269,-2610
2019,8,25,4,16258,15932,13581,-2351
2019,8,25,5,14869,15101,12454,-2647
2019,8,25,6,14177,14483,11647,-2836
2019,8,25,7,13709,14046,11517,-2529
2019,8,25,8,13410,13749,11432,-2317
2019,8,25,9,13290,13596,11028,-2568
2019,8,25,10,13360,13665,11576,-2089
2019,8,25,11,13458,13765,11747,-2018
2019,8,25,12,13883,14229,12171,-2058
2019,8,25,13,14644,15030,12622,-2408
2019,8,25,14,15486,15750,13342,-2408
2019,8,25,15,16143,16299,13577,-2722
2019,8,25,16,16634,16791,14017,-2774
2019,8,25,17,16996,17209,14328,-2881
2019,8,25,18,17266,17441,14349,-3092
2019,8,25,19,17505,17608,14461,-3147
2019,8,25,20,17785,17919,15060,-2859
2019,8,25,21,18128,18307,15245,-3062
2019,8,25,22,18395,18619,15622,-2997
2019,8,25,23,18377,18549,15575,-2974
2019,8,26,0,18319,18401,15512,-2889
2019,8,26,1,18517,18486,15326,-3160
2019,8,26,2,17956,17896,15159,-2737
2019,8,26,3,16913,16925,14407,-2518
2019,8,26,4,15757,15766,13453,-2313
2019,8,26,5,14158,14796,12078,-2718
2019,8,26,6,13578,14151,11679,-2472
2019,8,26,7,13204,13746,11350,-2396
2019,8,26,8,13034,13591,11287,-2304
2019,8,26,9,13169,13716,11452,-2264
2019,8,26,10,13858,14353,12127,-2226
2019,8,26,11,15008,15432,13607,-1825
2019,8,26,12,16157,16542,14590,-1952
2019,8,26,13,16993,17398,15413,-1985
2019,8,26,14,17612,17956,15663,-2293
2019,8,26,15,18069,18350,15552,-2798
2019,8,26,16,18367,18707,15754,-2953
2019,8,26,17,18589,19010,15850,-3160
2019,8,26,18,18903,19389,15950,-3439
2019,8,26,19,19136,19741,15960,-3781
2019,8,26,20,19387,20083,16287,-3796
2019,8,26,21,19713,20412,16665,-3747
2019,8,26,22,19852,20528,16769,-3759
2019,8,26,23,19524,20137,16740,-3397
2019,8,27,0,19186,19652,16257,-3395
2019,8,27,1,19128,19513,16316,-3197
2019,8,27,2,18313,18620,15978,-2642
2019,8,27,3,17005,17375,15123,-2252
2019,8,27,4,15667,16079,14061,-2018
2019,8,27,5,14562,15082,13030,-2052
2019,8,27,6,13863,14455,12647,-1808
2019,8,27,7,13425,14060,12312,-1748
2019,8,27,8,13218,13858,12216,-1642
2019,8,27,9,13345,13964,12488,-1476
2019,8,27,10,14093,14589,12860,-1729
2019,8,27,11,15427,15715,13658,-2057
2019,8,27,12,16698,16924,14909,-2015
2019,8,27,13,17675,17895,15851,-2044
2019,8,27,14,18348,18486,16247,-2239
2019,8,27,15,18858,18874,16078,-2796
2019,8,27,16,19191,19158,16339,-2819
2019,8,27,17,19455,19377,16613,-2764
2019,8,27,18,19774,19670,17005,-2665
2019,8,27,19,19961,19784,17010,-2774
2019,8,27,20,20117,20149,17274,-2875
2019,8,27,21,20337,20400,17386,-3014
2019,8,27,22,20421,20331,17138,-3193
2019,8,27,23,20163,19956,16989,-2967
2019,8,28,0,19907,19768,16688,-3080
2019,8,28,1,19964,19717,17223,-2494
2019,8,28,2,19163,18919,16378,-2541
2019,8,28,3,17835,17783,15398,-2385
2019,8,28,4,16415,16601,14146,-2455
2019,8,28,5,15216,15697,12920,-2777
2019,8,28,6,14551,15097,12463,-2634
2019,8,28,7,14141,14733,12187,-2546
2019,8,28,8,13962,14597,12216,-2381
2019,8,28,9,14091,14735,12458,-2277
2019,8,28,10,14887,15528,13132,-2396
2019,8,28,11,16269,16904,14528,-2376
2019,8,28,12,17601,18170,15696,-2474
2019,8,28,13,18711,19200,16335,-2865
2019,8,28,14,19527,19929,16812,-3117
2019,8,28,15,20203,20502,20502,0
2019,8,28,16,20754,20967,17412,-3555
2019,8,28,17,21208,21244,17540,-3704
2019,8,28,18,21675,21433,17931,-3502
2019,8,28,19,22012,21671,18137,-3534
2019,8,28,20,22315,21704,18389,-3315
2019,8,28,21,22527,21721,18697,-3024
2019,8,28,22,22430,21689,18745,-2944
2019,8,28,23,21886,21308,18648,-2660
2019,8,29,0,21512,21026,18457,-2569
2019,8,29,1,21473,20846,18042,-2804
2019,8,29,2,20633,20063,17462,-2601
2019,8,29,3,19219,18821,16391,-2430
2019,8,29,4,17679,17492,15121,-2371
2019,8,29,5,16041,16460,13838,-2622
2019,8,29,6,15276,15665,13300,-2365
2019,8,29,7,14728,15127,12977,-2150
2019,8,29,8,14414,14837,12735,-2102
2019,8,29,9,14430,14817,12643,-2174
2019,8,29,10,15060,15372,12881,-2491
2019,8,29,11,16291,16459,14123,-2336
2019,8,29,12,17501,17622,15075,-2547
2019,8,29,13,18533,18638,15543,-3095
2019,8,29,14,19226,19334,16050,-3284
2019,8,29,15,19790,19915,16577,-3338
2019,8,29,16,20218,20476,16910,-3566
2019,8,29,17,20592,20872,17460,-3412
2019,8,29,18,21035,21350,18149,-3201
2019,8,29,19,21367,21712,18261,-3451
2019,8,29,20,21698,22052,18656,-3396
2019,8,29,21,22000,22343,18290,-4053
2019,8,29,22,22022,22349,18229,-4120
2019,8,29,23,21419,21734,18578,-3156
2019,8,30,0,20896,21048,17892,-3156
2019,8,30,1,20620,20728,17391,-3337
2019,8,30,2,19695,19789,16869,-2920
2019,8,30,3,18297,18506,15693,-2813
2019,8,30,4,16824,17111,14086,-3025
2019,8,30,5,15681,16027,13449,-2578
2019,8,30,6,14879,15235,13085,-2150
2019,8,30,7,14355,14764,12688,-2076
2019,8,30,8,14070,14511,12880,-1631
2019,8,30,9,14116,14568,12919,-1649
2019,8,30,10,14740,15191,13409,-1782
2019,8,30,11,15943,16293,14156,-2137
2019,8,30,12,17173,17351,14376,-2975
2019,8,30,13,18325,18486,15496,-2990
2019,8,30,14,19157,19471,16295,-3176
2019,8,30,15,19862,20194,16604,-3590
2019,8,30,16,20483,20795,16924,-3871
2019,8,30,17,21027,21415,17508,-3907
2019,8,30,18,21601,22030,18249,-3781
2019,8,30,19,22071,22573,18851,-3722
2019,8,30,20,22455,22978,19401,-3577
2019,8,30,21,22735,23302,19808,-3494
2019,8,30,22,22667,23376,19848,-3528
2019,8,30,23,22022,22735,19304,-3431
2019,8,31,0,21421,21997,18492,-3505
2019,8,31,1,21086,21623,18246,-3377
2019,8,31,2,20240,20757,17559,-3198
2019,8,31,3,19004,19605,16331,-3274
2019,8,31,4,17624,18259,15623,-2636
2019,8,31,5,16294,17085,13962,-3123
2019,8,31,6,15384,16215,13201,-3014
2019,8,31,7,14726,15586,12995,-2591
2019,8,31,8,14291,15145,12586,-2559
2019,8,31,9,14098,14869,12388,-2481
2019,8,31,10,14186,14873,12466,-2407
2019,8,31,11,14488,15046,12541,-2505
2019,8,31,12,15122,15633,13211,-2422
2019,8,31,13,16187,16496,13712,-2784
2019,8,31,14,17046,17188,14591,-2597
2019,8,31,15,17668,17841,15199,-2642
2019,8,31,16,18054,18218,15689,-2529
2019,8,31,17,18279,18541,15978,-2563
2019,8,31,18,18439,18804,16273,-2531
2019,8,31,19,18595,19093,16517,-2576
2019,8,31,20,18798,19322,16743,-2579
2019,8,31,21,19023,19531,17126,-2405
2019,8,31,22,19137,19701,17345,-2356
2019,8,31,23,18964,19358,17014,-2344
2019,9,1,0,18752,18972,16470,-2502
2019,9,1,1,18773,18790,16355,-2435
2019,9,1,2,18143,18162,15730,-2432
2019,9,1,3,17181,17317,14629,-2688
2019,9,1,4,16062,16244,13515,-2729
2019,9,1,5,15134,15291,12273,-3018
2019,9,1,6,14402,14585,11924,-2661
2019,9,1,7,13909,14057,11802,-2255
2019,9,1,8,13598,13735,11777,-1958
2019,9,1,9,13453,13581,11674,-1907
2019,9,1,10,13449,13618,11446,-2172
2019,9,1,11,13451,13730,11366,-2364
2019,9,1,12,13669,14167,12146,-2021
2019,9,1,13,14423,14990,13133,-1857
2019,9,1,14,15242,15822,13578,-2244
2019,9,1,15,15948,16513,13855,-2658
2019,9,1,16,16519,17042,14441,-2601
2019,9,1,17,16985,17419,14894,-2525
2019,9,1,18,17334,17703,15054,-2649
2019,9,1,19,17615,18002,15348,-2654
2019,9,1,20,17892,18160,15462,-2698
2019,9,1,21,18180,18302,15736,-2566
2019,9,1,22,18338,18437,16064,-2373
2019,9,1,23,18275,18286,16064,-2222
2019,9,2,0,18340,18290,16186,-2104
2019,9,2,1,18681,18328,16125,-2203
2019,9,2,2,18112,17852,15832,-2020
2019,9,2,3,17239,17114,15268,-1846
2019,9,2,4,16238,16190,14236,-1954
2019,9,2,5,14767,15390,13112,-2278
2019,9,2,6,14158,14802,12667,-2135
2019,9,2,7,13771,14380,12283,-2097
2019,9,2,8,13586,14180,12275,-1905
2019,9,2,9,13608,14155,12391,-1764
2019,9,2,10,13913,14361,12064,-2297
2019,9,2,11,14283,14776,12450,-2326
2019,9,2,12,14621,15339,13229,-2110
2019,9,2,13,15470,16240,13723,-2517
2019,9,2,14,16529,17160,14213,-2947
2019,9,2,15,17449,17980,14847,-3133
2019,9,2,16,18050,18484,15338,-3146
2019,9,2,17,18462,18684,15716,-2968
2019,9,2,18,18765,18816,15868,-2948
2019,9,2,19,18981,18958,15671,-3287
2019,9,2,20,19206,19168,15837,-3331
2019,9,2,21,19470,19505,16284,-3221
2019,9,2,22,19564,19786,16804,-2982
2019,9,2,23,19408,19848,17097,-2751
2019,9,3,0,19443,19902,16795,-3107
2019,9,3,1,19847,20040,16870,-3170
2019,9,3,2,19121,19297,16138,-3159
2019,9,3,3,17938,18173,15307,-2866
2019,9,3,4,16693,16954,14139,-2815
2019,9,3,5,15346,16014,13163,-2851
2019,9,3,6,14724,15369,12637,-2732
2019,9,3,7,14291,14902,12279,-2623
2019,9,3,8,14064,14658,12318,-2340
2019,9,3,9,14145,14732,12467,-2265
2019,9,3,10,14806,15357,12791,-2566
2019,9,3,11,16051,16663,14011,-2652
2019,9,3,12,17173,17885,15117,-2768
2019,9,3,13,18054,18913,16289,-2624
2019,9,3,14,18663,19567,17094,-2473
2019,9,3,15,19155,20059,17653,-2406
2019,9,3,16,19546,20581,17715,-2866
2019,9,3,17,19913,21060,18171,-2889
2019,9,3,18,20359,21614,18756,-2858
2019,9,3,19,20727,22078,19392,-2686
2019,9,3,20,21126,22448,19799,-2649
2019,9,3,21,21550,22851,20403,-2448
2019,9,3,22,21729,22990,20866,-2124
2019,9,3,23,21327,22513,20126,-2387
2019,9,4,0,21030,22062,19302,-2760
2019,9,4,1,20786,21720,18906,-2814
2019,9,4,2,19790,20554,18041,-2513
2019,9,4,3,18441,19126,16872,-2254
2019,9,4,4,17065,17709,15445,-2264
2019,9,4,5,16318,16583,14453,-2130
2019,9,4,6,15608,15886,13921,-1965
2019,9,4,7,15154,15404,13822,-1582
2019,9,4,8,14945,15196,13646,-1550
2019,9,4,9,15044,15306,13856,-1450
2019,9,4,10,15782,15946,14398,-1548
2019,9,4,11,17125,17585,15347,-2238
2019,9,4,12,18325,18895,16467,-2428
2019,9,4,13,19284,19839,17340,-2499
2019,9,4,14,20052,20560,17794,-2766
2019,9,4,15,20719,21390,18624,-2766
2019,9,4,16,21283,22137,19234,-2903
2019,9,4,17,21763,22616,19741,-2875
2019,9,4,18,22234,23229,20597,-2632
2019,9,4,19,22557,23695,21562,-2133
2019,9,4,20,22848,23889,20941,-2948
2019,9,4,21,23055,24159,21114,-3045
2019,9,4,22,22935,24222,21020,-3202
2019,9,4,23,22261,23698,20668,-3030
2019,9,5,0,21945,23389,20342,-3047
2019,9,5,1,21676,23064,20572,-2492
2019,9,5,2,20635,21720,19176,-2544
2019,9,5,3,19221,20109,17830,-2279
2019,9,5,4,17714,18396,16098,-2298
2019,9,5,5,16156,17071,14654,-2417
2019,9,5,6,15211,16091,13635,-2456
2019,9,5,7,14554,15363,12969,-2394
2019,9,5,8,14177,14914,12788,-2126
2019,9,5,9,14164,14878,12984,-1894
2019,9,5,10,14800,15489,13435,-2054
2019,9,5,11,16130,16803,14820,-1983
2019,9,5,12,17317,17726,15327,-2399
2019,9,5,13,18253,18279,15570,-2709
2019,9,5,14,18838,18705,15775,-2930
2019,9,5,15,19246,18961,16162,-2799
2019,9,5,16,19502,19235,16231,-3004
2019,9,5,17,19695,19440,16351,-3089
2019,9,5,18,19981,19728,16634,-3094
2019,9,5,19,20170,19919,16836,-3083
2019,9,5,20,20344,20174,17029,-3145
2019,9,5,21,20541,20343,17188,-3155
2019,9,5,22,20573,20406,17470,-2936
2019,9,5,23,20153,20093,17211,-2882
2019,9,6,0,19952,19951,17001,-2950
2019,9,6,1,19822,19718,16747,-2971
2019,9,6,2,18827,18729,16022,-2707
2019,9,6,3,17479,17406,14873,-2533
2019,9,6,4,16057,16083,13751,-2332
2019,9,6,5,15027,15101,12595,-2506
2019,9,6,6,14229,14445,12103,-2342
2019,9,6,7,13796,14027,11612,-2415
2019,9,6,8,13597,13823,11795,-2028
2019,9,6,9,13706,13916,11835,-2081
2019,9,6,10,14430,14639,12536,-2103
2019,9,6,11,15741,16179,13986,-2193
2019,9,6,12,16841,17299,14777,-2522
2019,9,6,13,17677,17934,15277,-2657
2019,9,6,14,18243,18351,15536,-2815
2019,9,6,15,18612,18596,15562,-3034
2019,9,6,16,18768,18765,15578,-3187
2019,9,6,17,18832,18767,15646,-3121
2019,9,6,18,18924,18757,15753,-3004
2019,9,6,19,18926,18613,15724,-2889
2019,9,6,20,18829,18538,15892,-2646
2019,9,6,21,18747,18585,16186,-2399
2019,9,6,22,18550,18449,16127,-2322
2019,9,6,23,18127,18169,16182,-1987
2019,9,7,0,18175,18004,15897,-2107
2019,9,7,1,18171,17663,15780,-1883
2019,9,7,2,17339,16912,14898,-2014
2019,9,7,3,16284,15926,13710,-2216
2019,9,7,4,15194,14846,12681,-2165
2019,9,7,5,13968,13972,12274,-1698
2019,9,7,6,13363,13382,11639,-1743
2019,9,7,7,12969,13008,11129,-1879
2019,9,7,8,12757,12820,10743,-2077
2019,9,7,9,12732,12777,10688,-2089
2019,9,7,10,12994,12963,11034,-1929
2019,9,7,11,13421,13388,11347,-2041
2019,9,7,12,13903,13985,12060,-1925
2019,9,7,13,14696,14811,13097,-1714
2019,9,7,14,15342,15401,13477,-1924
2019,9,7,15,15778,15762,13549,-2213
2019,9,7,16,16007,16012,13708,-2304
2019,9,7,17,16137,16270,13882,-2388
2019,9,7,18,16197,16518,13978,-2540
2019,9,7,19,16293,16705,14218,-2487
2019,9,7,20,16494,16878,14690,-2188
2019,9,7,21,16785,17112,15147,-1965
2019,9,7,22,17053,17281,15393,-1888
2019,9,7,23,16998,17243,15174,-2069
2019,9,8,0,17294,17400,15202,-2198
2019,9,8,1,17292,17345,15170,-2175
2019,9,8,2,16631,16760,14787,-1973
2019,9,8,3,15776,15982,13972,-2010
2019,9,8,4,14846,15078,12755,-2323
2019,9,8,5,13802,14288,12007,-2281
2019,9,8,6,13210,13674,11646,-2028
2019,9,8,7,12792,13300,11241,-2059
2019,9,8,8,12531,13007,10832,-2175
2019,9,8,9,12448,12897,10811,-2086
2019,9,8,10,12582,12990,10968,-2022
2019,9,8,11,12868,13208,10998,-2210
2019,9,8,12,13211,13674,11875,-1799
2019,9,8,13,13865,14459,12764,-1695
2019,9,8,14,14515,15160,13381,-1779
2019,9,8,15,15002,15560,13207,-2353
2019,9,8,16,15357,15913,13375,-2538
2019,9,8,17,15644,16317,13842,-2475
2019,9,8,18,15840,16680,14131,-2549
2019,9,8,19,16011,17070,14549,-2521
2019,9,8,20,16250,17400,14736,-2664
2019,9,8,21,16614,17685,15294,-2391
2019,9,8,22,16995,18017,16044,-1973
2019,9,8,23,17115,18114,16152,-1962
2019,9,9,0,17417,18404,16194,-2210
2019,9,9,1,17546,18361,16372,-1989
2019,9,9,2,16855,17634,15381,-2253
2019,9,9,3,15897,16625,14352,-2273
2019,9,9,4,14862,15579,13638,-1941
2019,9,9,5,14035,14670,12556,-2114
2019,9,9,6,13428,14015,12095,-1920
2019,9,9,7,13068,13627,11780,-1847
2019,9,9,8,12925,13486,11768,-1718
2019,9,9,9,13084,13630,12095,-1535
2019,9,9,10,13856,14436,12583,-1853
2019,9,9,11,15234,15966,13999,-1967
2019,9,9,12,16385,17053,14758,-2295
2019,9,9,13,17229,17753,15014,-2739
2019,9,9,14,17756,18248,15447,-2801
2019,9,9,15,18086,18623,15456,-3167
2019,9,9,16,18263,18924,15858,-3066
2019,9,9,17,18348,19220,16105,-3115
2019,9,9,18,18517,19488,16268,-3220
2019,9,9,19,18597,19715,16895,-2820
2019,9,9,20,18687,19985,17264,-2721
2019,9,9,21,18946,20273,17683,-2590
2019,9,9,22,19150,20413,18149,-2264
2019,9,9,23,18993,20171,18032,-2139
2019,9,10,0,19028,20077,17472,-2605
2019,9,10,1,18871,19796,17541,-2255
2019,9,10,2,17871,18778,16522,-2256
2019,9,10,3,16553,17456,15048,-2408
2019,9,10,4,15228,16120,13741,-2379
2019,9,10,5,14627,15081,12728,-2353
2019,9,10,6,13955,14445,12373,-2072
2019,9,10,7,13558,14069,12092,-1977
2019,9,10,8,13377,13903,12074,-1829
2019,9,10,9,13504,14032,12121,-1911
2019,9,10,10,14254,14878,12844,-2034
2019,9,10,11,15697,16533,14294,-2239
2019,9,10,12,16901,17759,15050,-2709
2019,9,10,13,17827,18479,15742,-2737
2019,9,10,14,18465,19013,16286,-2727
2019,9,10,15,18966,19326,16275,-3051
2019,9,10,16,19329,19600,16531,-3069
2019,9,10,17,19647,19772,16697,-3075
2019,9,10,18,20035,20019,17302,-2717
2019,9,10,19,20328,20225,17310,-2915
2019,9,10,20,20594,20686,17753,-2933
2019,9,10,21,20907,21137,18099,-3038
2019,9,10,22,21062,21329,18084,-3245
2019,9,10,23,20715,21119,18110,-3009
2019,9,11,0,20709,21193,18302,-2891
2019,9,11,1,20479,20950,18671,-2279
2019,9,11,2,19437,19974,17493,-2481
2019,9,11,3,18081,18663,16587,-2076
2019,9,11,4,16674,17323,15343,-1980
2019,9,11,5,15945,16301,14249,-2052
2019,9,11,6,15241,15591,13756,-1835
2019,9,11,7,14765,15163,13410,-1753
2019,9,11,8,14529,14927,13125,-1802
2019,9,11,9,14609,15066,13190,-1876
2019,9,11,10,15361,15865,13712,-2153
2019,9,11,11,16830,17537,14993,-2544
2019,9,11,12,18101,18765,15422,-3343
2019,9,11,13,19207,19708,16279,-3429
2019,9,11,14,20025,20465,16920,-3545
2019,9,11,15,20774,21156,17828,-3328
2019,9,11,16,21448,21932,18932,-3000
2019,9,11,17,22102,22667,19162,-3505
2019,9,11,18,22796,23613,20406,-3207
2019,9,11,19,23369,24394,21086,-3308
2019,9,11,20,23917,25212,21320,-3892
2019,9,11,21,24351,25850,22130,-3720
2019,9,11,22,24430,26080,22125,-3955
2019,9,11,23,23897,25515,21691,-3824
2019,9,12,0,23664,25158,21242,-3916
2019,9,12,1,23331,24574,20840,-3734
2019,9,12,2,22191,23237,18832,-4405
2019,9,12,3,20652,21582,16983,-4599
2019,9,12,4,19023,19947,15997,-3950
2019,9,12,5,17254,18601,15100,-3501
2019,9,12,6,16266,17690,14165,-3525
2019,9,12,7,15604,17060,13549,-3511
2019,9,12,8,15216,16697,13425,-3272
2019,9,12,9,15192,16665,13166,-3499
2019,9,12,10,15858,17386,13549,-3837
2019,9,12,11,17309,19009,15452,-3557
2019,9,12,12,18511,20078,16461,-3617
2019,9,12,13,19430,20863,16800,-4063
2019,9,12,14,20045,21411,17619,-3792
2019,9,12,15,20484,21836,18498,-3338
2019,9,12,16,20741,21998,18549,-3449
2019,9,12,17,20854,21995,18807,-3188
2019,9,12,18,21017,21833,18889,-2944
2019,9,12,19,21046,21537,18451,-3086
2019,9,12,20,21030,21342,18458,-2884
2019,9,12,21,21040,21301,18800,-2501
2019,9,12,22,20919,21179,18847,-2332
2019,9,12,23,20350,20710,18226,-2484
2019,9,13,0,20217,20493,17829,-2664
2019,9,13,1,19903,19914,17218,-2696
2019,9,13,2,18750,18769,15981,-2788
2019,9,13,3,17387,17348,14592,-2756
2019,9,13,4,15994,15947,13820,-2127
2019,9,13,5,14875,14923,12913,-2010
2019,9,13,6,14118,14227,12062,-2165
2019,9,13,7,13677,13733,11884,-1849
2019,9,13,8,13450,13497,11790,-1707
2019,9,13,9,13523,13545,11702,-1843
2019,9,13,10,14175,14238,12450,-1788
2019,9,13,11,15453,15674,13597,-2077
2019,9,13,12,16480,16701,14613,-2088
2019,9,13,13,17200,17273,14773,-2500
2019,9,13,14,17641,17595,14958,-2637
2019,9,13,15,17906,17887,15418,-2469
2019,9,13,16,18043,18064,15172,-2892
2019,9,13,17,18091,18216,15345,-2871
2019,9,13,18,18237,18338,15587,-2751
2019,9,13,19,18338,18383,15722,-2661
2019,9,13,20,18438,18485,16109,-2376
2019,9,13,21,18639,18606,16421,-2185
2019,9,13,22,18705,18549,16641,-1908
2019,9,13,23,18400,18190,16347,-1843
2019,9,14,0,18363,18139,15936,-2203
2019,9,14,1,18033,17831,15899,-1932
2019,9,14,2,17093,17083,15086,-1997
2019,9,14,3,16032,16105,14204,-1901
2019,9,14,4,14922,15051,13270,-1781
2019,9,14,5,13875,14180,12422,-1758
2019,9,14,6,13289,13649,12228,-1421
2019,9,14,7,12950,13285,11938,-1347
2019,9,14,8,12784,13097,11977,-1120
2019,9,14,9,12786,13108,11858,-1250
2019,9,14,10,13053,13373,12003,-1370
2019,9,14,11,13597,13938,12254,-1684
2019,9,14,12,14149,14666,12690,-1976
2019,9,14,13,14959,15590,13142,-2448
2019,9,14,14,15663,16386,13628,-2758
2019,9,14,15,16163,16936,13924,-3012
2019,9,14,16,16435,17284,14498,-2786
2019,9,14,17,16569,17465,14627,-2838
2019,9,14,18,16628,17557,14742,-2815
2019,9,14,19,16687,17616,14841,-2775
2019,9,14,20,16851,17709,15057,-2652
2019,9,14,21,17157,17882,15284,-2598
2019,9,14,22,17454,18081,15413,-2668
2019,9,14,23,17494,18188,15250,-2938
2019,9,15,0,17780,18409,15574,-2835
2019,9,15,1,17695,18300,15518,-2782
2019,9,15,2,17013,17809,15087,-2722
2019,9,15,3,16237,17030,14121,-2909
2019,9,15,4,15413,16165,13199,-2966
2019,9,15,5,14678,15377,12243,-3134
2019,9,15,6,14123,14768,11902,-2866
2019,9,15,7,13669,14270,11515,-2755
2019,9,15,8,13391,14001,11214,-2787
2019,9,15,9,13289,13821,11199,-2622
2019,9,15,10,13396,13879,11278,-2601
2019,9,15,11,13638,14168,11430,-2738
2019,9,15,12,13999,14617,12094,-2523
2019,9,15,13,14848,15564,13102,-2462
2019,9,15,14,15721,16435,13571,-2864
2019,9,15,15,16432,17101,13811,-3290
2019,9,15,16,16977,17609,14407,-3202
2019,9,15,17,17421,18105,15059,-3046
2019,9,15,18,17743,18575,15566,-3009
2019,9,15,19,18052,18961,15870,-3091
2019,9,15,20,18343,19286,16417,-2869
2019,9,15,21,18684,19717,16960,-2757
2019,9,15,22,18890,19913,17654,-2259
2019,9,15,23,18806,19739,17483,-2256
2019,9,16,0,19307,19879,17677,-2202
2019,9,16,1,19162,19594,17620,-1974
2019,9,16,2,18298,18729,16626,-2103
2019,9,16,3,17130,17620,15631,-1989
2019,9,16,4,15935,16413,14405,-2008
2019,9,16,5,14988,15474,13235,-2239
2019,9,16,6,14397,14836,12782,-2054
2019,9,16,7,14031,14443,12435,-2008
2019,9,16,8,13855,14291,12216,-2075
2019,9,16,9,14009,14472,12199,-2273
2019,9,16,10,14821,15305,13003,-2302
2019,9,16,11,16430,16955,14572,-2383
2019,9,16,12,17617,18124,15490,-2634
2019,9,16,13,18363,18845,15746,-3099
2019,9,16,14,18935,19244,15960,-3284
2019,9,16,15,19385,19453,15935,-3518
2019,9,16,16,19680,19699,16283,-3416
2019,9,16,17,19899,19822,16466,-3356
2019,9,16,18,20161,20014,16651,-3363
2019,9,16,19,20316,20268,17068,-3200
2019,9,16,20,20438,20386,17157,-3229
2019,9,16,21,20537,20661,17712,-2949
2019,9,16,22,20435,20767,18083,-2684
2019,9,16,23,19991,20525,18011,-2514
2019,9,17,0,20298,20527,18334,-2193
2019,9,17,1,19886,20027,17806,-2221
2019,9,17,2,18815,18930,16620,-2310
2019,9,17,3,17426,17549,15806,-1743
2019,9,17,4,16023,16098,14946,-1152
2019,9,17,5,14634,14974,13044,-1930
2019,9,17,6,13956,14265,12319,-1946
2019,9,17,7,13513,13835,11666,-2169
2019,9,17,8,13298,13560,11572,-1988
2019,9,17,9,13400,13630,11644,-1986
2019,9,17,10,14147,14322,12071,-2251
2019,9,17,11,15732,15801,13796,-2005
2019,9,17,12,16810,16841,15051,-1790
2019,9,17,13,17360,17408,15556,-1852
2019,9,17,14,17663,17757,15644,-2113
2019,9,17,15,17890,18057,15651,-2406
2019,9,17,16,18080,18264,15567,-2697
2019,9,17,17,18249,18471,15674,-2797
2019,9,17,18,18516,18734,15819,-2915
2019,9,17,19,18718,19022,16141,-2881
2019,9,17,20,18928,19397,16589,-2808
2019,9,17,21,19151,19781,17101,-2680
2019,9,17,22,19158,19874,17513,-2361
2019,9,17,23,18840,19487,17176,-2311
2019,9,18,0,19173,19387,16898,-2489
2019,9,18,1,18860,18913,16726,-2187
2019,9,18,2,17828,17844,15852,-1992
2019,9,18,3,16467,16517,14072,-2445
2019,9,18,4,15096,15262,12883,-2379
2019,9,18,5,14014,14351,11501,-2850
2019,9,18,6,13391,13774,11210,-2564
2019,9,18,7,13030,13398,10857,-2541
2019,9,18,8,12853,13230,10727,-2503
2019,9,18,9,13002,13313,10897,-2416
2019,9,18,10,13790,14037,11563,-2474
2019,9,18,11,15379,15578,13144,-2434
2019,9,18,12,16459,16611,13771,-2840
2019,9,18,13,16957,17093,13799,-3294
2019,9,18,14,17284,17296,14147,-3149
2019,9,18,15,17494,17489,14461,-3028
2019,9,18,16,17605,17622,14368,-3254
2019,9,18,17,17695,17687,14488,-3199
2019,9,18,18,17848,17876,14744,-3132
2019,9,18,19,17907,17966,14729,-3237
2019,9,18,20,17990,18165,14980,-3185
2019,9,18,21,18153,18466,15404,-3062
2019,9,18,22,18190,18607,15612,-2995
2019,9,18,23,18160,18406,15473,-2933
2019,9,19,0,18519,18469,15375,-3094
2019,9,19,1,18297,18012,15436,-2576
2019,9,19,2,17366,16989,14301,-2688
2019,9,19,3,16076,15742,13086,-2656
2019,9,19,4,14735,14527,11846,-2681
2019,9,19,5,13527,13640,11023,-2617
2019,9,19,6,12919,13116,10933,-2183
2019,9,19,7,12565,12777,10957,-1820
2019,9,19,8,12412,12650,10658,-1992
2019,9,19,9,12555,12801,11067,-1734
2019,9,19,10,13306,13543,11884,-1659
2019,9,19,11,14802,15062,13261,-1801
2019,9,19,12,15780,16029,13950,-2079
2019,9,19,13,16193,16492,14065,-2427
2019,9,19,14,16471,16670,14230,-2440
2019,9,19,15,16645,16813,14345,-2468
2019,9,19,16,16733,16931,14157,-2774
2019,9,19,17,16784,17048,14065,-2983
2019,9,19,18,16940,17250,14266,-2984
2019,9,19,19,17069,17438,14625,-2813
2019,9,19,20,17275,17722,15004,-2718
2019,9,19,21,17562,18082,16140,-1942
2019,9,19,22,17667,18367,15986,-2381
2019,9,19,23,17533,18190,15746,-2444
2019,9,20,0,18024,18347,15736,-2611
2019,9,20,1,17806,17923,15632,-2291
2019,9,20,2,16898,16948,14481,-2467
2019,9,20,3,15681,15729,13317,-2412
2019,9,20,4,14445,14534,12356,-2178
2019,9,20,5,13257,13651,11615,-2036
2019,9,20,6,12716,13084,11408,-1676
2019,9,20,7,12375,12761,11194,-1567
2019,9,20,8,12229,12633,11080,-1553
2019,9,20,9,12353,12790,11188,-1602
2019,9,20,10,13066,13530,11593,-1937
2019,9,20,11,14523,15054,13031,-2023
2019,9,20,12,15502,16059,14047,-2012
2019,9,20,13,16008,16603,13999,-2604
2019,9,20,14,16446,16860,13645,-3215
2019,9,20,15,16802,17154,14101,-3053
2019,9,20,16,17033,17372,14112,-3260
2019,9,20,17,17247,17597,14262,-3335
2019,9,20,18,17556,17881,14400,-3481
2019,9,20,19,17813,18155,14597,-3558
2019,9,20,20,18115,18576,15095,-3481
2019,9,20,21,18389,19056,15756,-3300
2019,9,20,22,18371,19269,16114,-3155
2019,9,20,23,17947,18941,16117,-2824
2019,9,21,0,18245,18812,15983,-2829
2019,9,21,1,17830,18322,15771,-2551
2019,9,21,2,17002,17457,14819,-2638
2019,9,21,3,15982,16372,13965,-2407
2019,9,21,4,14922,15258,12782,-2476
2019,9,21,5,14082,14332,11517,-2815
2019,9,21,6,13434,13711,10967,-2744
2019,9,21,7,13004,13277,10784,-2493
2019,9,21,8,12745,13011,10459,-2552
2019,9,21,9,12673,12935,10617,-2318
2019,9,21,10,12882,13091,11238,-1853
2019,9,21,11,13372,13619,11716,-1903
2019,9,21,12,13919,14257,12206,-2051
2019,9,21,13,14760,15127,13079,-2048
2019,9,21,14,15499,15818,13487,-2331
2019,9,21,15,16082,16329,13987,-2342
2019,9,21,16,16582,16805,14280,-2525
2019,9,21,17,16967,17284,14433,-2851
2019,9,21,18,17319,17695,14815,-2880
2019,9,21,19,17711,18147,15297,-2850
2019,9,21,20,18097,18647,15673,-2974
2019,9,21,21,18485,19150,16141,-3009
2019,9,21,22,18688,19403,16645,-2758
2019,9,21,23,18760,19225,16264,-2961
2019,9,22,0,19101,19161,15988,-3173
2019,9,22,1,18862,18743,15660,-3083
2019,9,22,2,18166,17976,14937,-3039
2019,9,22,3,17199,17050,14455,-2595
2019,9,22,4,16069,16007,13410,-2597
2019,9,22,5,14751,15093,12195,-2898
2019,9,22,6,13995,14359,11875,-2484
2019,9,22,7,13476,13866,11571,-2295
2019,9,22,8,13140,13581,11640,-1941
2019,9,22,9,12997,13431,11661,-1770
2019,9,22,10,13066,13536,11773,-1763
2019,9,22,11,13376,13832,11786,-2046
2019,9,22,12,13759,14282,12438,-1844
2019,9,22,13,14673,15235,13294,-1941
2019,9,22,14,15604,16159,13977,-2182
2019,9,22,15,16468,17077,14415,-2662
2019,9,22,16,17310,17989,14997,-2992
2019,9,22,17,18037,18879,15602,-3277
2019,9,22,18,18656,19655,16247,-3408
2019,9,22,19,19247,20294,16750,-3544
2019,9,22,20,19811,20854,17544,-3310
2019,9,22,21,20350,21382,17827,-3555
2019,9,22,22,20674,21661,18366,-3295
2019,9,22,23,20836,21503,18452,-3051
2019,9,23,0,21117,21696,18623,-3073
2019,9,23,1,20869,21348,18524,-2824
2019,9,23,2,19924,20400,17356,-3044
2019,9,23,3,18669,19179,16347,-2832
2019,9,23,4,17271,17847,15191,-2656
2019,9,23,5,15793,16870,14201,-2669
2019,9,23,6,15064,16213,13689,-2524
2019,9,23,7,14608,15757,13323,-2434
2019,9,23,8,14371,15548,13353,-2195
2019,9,23,9,14495,15654,13408,-2246
2019,9,23,10,15342,16450,14252,-2198
2019,9,23,11,17096,18155,15896,-2259
2019,9,23,12,18401,19394,16597,-2797
2019,9,23,13,19353,20249,17227,-3022
2019,9,23,14,20111,20952,17733,-3219
2019,9,23,15,20774,21700,18644,-3056
2019,9,23,16,21284,22392,19171,-3221
2019,9,23,17,21698,23014,19600,-3414
2019,9,23,18,22140,23643,19969,-3674
2019,9,23,19,22431,24111,20469,-3642
2019,9,23,20,22665,24482,20789,-3693
2019,9,23,21,22813,24587,21220,-3367
2019,9,23,22,22712,24369,21172,-3197
2019,9,23,23,22324,23920,20961,-2959
2019,9,24,0,22397,23873,21013,-2860
2019,9,24,1,21707,23119,20350,-2769
2019,9,24,2,20413,21894,19199,-2695
2019,9,24,3,18851,20368,17786,-2582
2019,9,24,4,17258,18732,16228,-2504
2019,9,24,5,16422,17438,14711,-2727
2019,9,24,6,15563,16436,14082,-2354
2019,9,24,7,14966,15698,13430,-2268
2019,9,24,8,14634,15281,12964,-2317
2019,9,24,9,14651,15206,13010,-2196
2019,9,24,10,15375,15806,13596,-2210
2019,9,24,11,17044,17365,15162,-2203
2019,9,24,12,18114,18359,16139,-2220
2019,9,24,13,18659,18782,16649,-2133
2019,9,24,14,19020,19282,16745,-2537
2019,9,24,15,19271,19521,16547,-2974
2019,9,24,16,19399,19682,16487,-3195
2019,9,24,17,19509,19811,16631,-3180
2019,9,24,18,19713,19902,16769,-3133
2019,9,24,19,19822,19887,16640,-3247
2019,9,24,20,19945,20026,16823,-3203
2019,9,24,21,20082,20196,17098,-3098
2019,9,24,22,20071,20221,17421,-2800
2019,9,24,23,19743,19935,17092,-2843
2019,9,25,0,19877,20009,17169,-2840
2019,9,25,1,19421,19322,16530,-2792
2019,9,25,2,18290,18167,15691,-2476
2019,9,25,3,16850,16912,14325,-2587
2019,9,25,4,15438,15601,13350,-2251
2019,9,25,5,14628,14640,12246,-2394
2019,9,25,6,13913,14016,11849,-2167
2019,9,25,7,13522,13597,11647,-1950
2019,9,25,8,13326,13373,11624,-1749
2019,9,25,9,13449,13457,11599,-1858
2019,9,25,10,14201,14188,11950,-2238
2019,9,25,11,15761,15720,13443,-2277
2019,9,25,12,16718,16781,14658,-2123
2019,9,25,13,17129,17344,15221,-2123
2019,9,25,14,17465,17670,15118,-2552
2019,9,25,15,17761,17991,14972,-3019
2019,9,25,16,18013,18284,15357,-2927
2019,9,25,17,18294,18602,15465,-3137
2019,9,25,18,18664,18986,15672,-3314
2019,9,25,19,18962,19367,16159,-3208
2019,9,25,20,19322,19833,16360,-3473
2019,9,25,21,19737,20345,16829,-3516
2019,9,25,22,19844,20520,17240,-3280
2019,9,25,23,19661,20211,17151,-3060
2019,9,26,0,19917,20324,17237,-3087
2019,9,26,1,19511,19793,16726,-3067
2019,9,26,2,18503,18875,15685,-3190
2019,9,26,3,17200,17527,14504,-3023
2019,9,26,4,15871,16189,13525,-2664
2019,9,26,5,14484,15154,12488,-2666
2019,9,26,6,13787,14450,12333,-2117
2019,9,26,7,13386,13993,12044,-1949
2019,9,26,8,13199,13792,11781,-2011
2019,9,26,9,13324,13890,11822,-2068
2019,9,26,10,14098,14658,12497,-2161
2019,9,26,11,15741,16310,14255,-2055
2019,9,26,12,16833,17418,15681,-1737
2019,9,26,13,17418,18184,15731,-2453
2019,9,26,14,17966,18793,15993,-2800
2019,9,26,15,18429,19315,16185,-3130
2019,9,26,16,18734,19854,16558,-3296
2019,9,26,17,18938,20255,16588,-3667
2019,9,26,18,19212,20651,17351,-3300
2019,9,26,19,19382,20864,17894,-2970
2019,9,26,20,19563,20744,17917,-2827
2019,9,26,21,19719,20445,17997,-2448
2019,9,26,22,19636,20043,17282,-2761
2019,9,26,23,19410,19704,17123,-2581
2019,9,27,0,19536,19711,16786,-2925
2019,9,27,1,19045,19091,16839,-2252
2019,9,27,2,18041,18047,15736,-2311
2019,9,27,3,16714,16774,14472,-2302
2019,9,27,4,15360,15536,13593,-1943
2019,9,27,5,14153,14573,12323,-2250
2019,9,27,6,13447,13954,11948,-2006
2019,9,27,7,12984,13502,11761,-1741
2019,9,27,8,12754,13323,11545,-1778
2019,9,27,9,12851,13410,11738,-1672
2019,9,27,10,13618,14135,12181,-1954
2019,9,27,11,15294,15666,13615,-2051
2019,9,27,12,16402,16700,14397,-2303
2019,9,27,13,17081,17218,14624,-2594
2019,9,27,14,17433,17488,14544,-2944
2019,9,27,15,17645,17693,14508,-3185
2019,9,27,16,17774,17878,14421,-3457
2019,9,27,17,17872,18009,14438,-3571
2019,9,27,18,18087,18255,14724,-3531
2019,9,27,19,18225,18462,15010,-3452
2019,9,27,20,18407,18753,15514,-3239
2019,9,27,21,18609,19054,15679,-3375
2019,9,27,22,18598,19049,15913,-3136
2019,9,27,23,18435,18698,15674,-3024
2019,9,28,0,18535,18770,15906,-2864
2019,9,28,1,18048,18165,15327,-2838
2019,9,28,2,17213,17390,14482,-2908
2019,9,28,3,16126,16493,13846,-2647
2019,9,28,4,14934,15411,12788,-2623
2019,9,28,5,14083,14492,11897,-2595
2019,9,28,6,13474,13871,11510,-2361
2019,9,28,7,13101,13476,11299,-2177
2019,9,28,8,12888,13250,11330,-1920
2019,9,28,9,12853,13230,11387,-1843
2019,9,28,10,13092,13516,11703,-1813
2019,9,28,11,13684,14104,11845,-2259
2019,9,28,12,14285,14797,12337,-2460
2019,9,28,13,15162,15773,13204,-2569
2019,9,28,14,15892,16499,14008,-2491
2019,9,28,15,16482,17032,13871,-3161
2019,9,28,16,16982,17446,14257,-3189
2019,9,28,17,17352,17874,14898,-2976
2019,9,28,18,17660,18272,15117,-3155
2019,9,28,19,17984,18736,15454,-3282
2019,9,28,20,18325,19078,15860,-3218
2019,9,28,21,18721,19477,16162,-3315
2019,9,28,22,18992,19653,16340,-3313
2019,9,28,23,19109,19640,16124,-3516
2019,9,29,0,19375,19792,16370,-3422
2019,9,29,1,18979,19406,15897,-3509
2019,9,29,2,18271,18769,14761,-4008
2019,9,29,3,17354,17962,14463,-3499
2019,9,29,4,16332,17012,13717,-3295
2019,9,29,5,15076,16108,12885,-3223
2019,9,29,6,14383,15366,12169,-3197
2019,9,29,7,13834,14851,11416,-3435
2019,9,29,8,13476,14454,11339,-3115
2019,9,29,9,13313,14221,11155,-3066
2019,9,29,10,13376,14221,11192,-3029
2019,9,29,11,13712,14513,11841,-2672
2019,9,29,12,14037,14911,11954,-2957
2019,9,29,13,14874,15660,12939,-2721
2019,9,29,14,15591,16196,13329,-2867
2019,9,29,15,16113,16622,13475,-3147
2019,9,29,16,16431,16933,13679,-3254
2019,9,29,17,16673,17256,14119,-3137
2019,9,29,18,16834,17496,14608,-2888
2019,9,29,19,16978,17774,15031,-2743
2019,9,29,20,17137,17992,14946,-3046
2019,9,29,21,17405,18360,15274,-3086
2019,9,29,22,17664,18496,15328,-3168
2019,9,29,23,17807,18404,15243,-3161
2019,9,30,0,18220,18540,15322,-3218
2019,9,30,1,17904,17926,14681,-3245
2019,9,30,2,16930,17105,13856,-3249
2019,9,30,3,15708,16091,12871,-3220
2019,9,30,4,14552,15027,11904,-3123
2019,9,30,5,13757,14240,11136,-3104
2019,9,30,6,13248,13675,10807,-2868
2019,9,30,7,12952,13290,10669,-2621
2019,9,30,8,12834,13103,10785,-2318
2019,9,30,9,13026,13280,11042,-2238
2019,9,30,10,13841,14125,11756,-2369
2019,9,30,11,15506,15520,12935,-2585
2019,9,30,12,16584,16526,13592,-2934
2019,9,30,13,17110,17084,13949,-3135
2019,9,30,14,17382,17409,14051,-3358
2019,9,30,15,17538,17622,14198,-3424
2019,9,30,16,17594,17776,14230,-3546
2019,9,30,17,17629,17979,14451,-3528
2019,9,30,18,17740,18219,14434,-3785
2019,9,30,19,17799,18446,14790,-3656
2019,9,30,20,17922,18498,14855,-3643
2019,9,30,21,18150,18585,14961,-3624
2019,9,30,22,18313,18715,15235,-3480
2019,9,30,23,18404,18786,15165,-3621
2019,10,1,0,18670,18844,15138,-3706
2019,10,1,1,18217,18255,14593,-3662
2019,10,1,2,17222,17285,13959,-3326
2019,10,1,3,16018,16211,13163,-3048
2019,10,1,4,14802,15092,12300,-2792
2019,10,1,5,13659,14276,11469,-2807
2019,10,1,6,13116,13714,11452,-2262
2019,10,1,7,12808,13407,11355,-2052
2019,10,1,8,12685,13287,11267,-2020
2019,10,1,9,12854,13446,11466,-1980
2019,10,1,10,13639,14275,11948,-2327
2019,10,1,11,15220,15935,13521,-2414
2019,10,1,12,16385,17130,14024,-3106
2019,10,1,13,16884,17980,14470,-3510
2019,10,1,14,17345,18569,14836,-3733
2019,10,1,15,17680,18884,15286,-3598
2019,10,1,16,17903,19168,15789,-3379
2019,10,1,17,18079,19549,16140,-3409
2019,10,1,18,18314,20058,16649,-3409
2019,10,1,19,18521,20643,17304,-3339
2019,10,1,20,18808,21329,17973,-3356
2019,10,1,21,19149,21816,18288,-3528
2019,10,1,22,19381,21982,18231,-3751
2019,10,1,23,19512,21798,18281,-3517
2019,10,2,0,19927,21878,18574,-3304
2019,10,2,1,19386,21215,18174,-3041
2019,10,2,2,18384,20138,16958,-3180
2019,10,2,3,17173,18823,15354,-3469
2019,10,2,4,15913,17491,14192,-3299
2019,10,2,5,15236,16421,12709,-3712
2019,10,2,6,14569,15696,12117,-3579
2019,10,2,7,14144,15299,11655,-3644
2019,10,2,8,13924,15088,11682,-3406
2019,10,2,9,14044,15172,11903,-3269
2019,10,2,10,14858,16062,12690,-3372
2019,10,2,11,16561,17854,14167,-3687
2019,10,2,12,17908,19141,15384,-3757
2019,10,2,13,18695,19961,15702,-4259
2019,10,2,14,19348,20706,16383,-4323
2019,10,2,15,19880,21498,17201,-4297
2019,10,2,16,20285,22144,18061,-4083
2019,10,2,17,20567,22709,19191,-3518
2019,10,2,18,20853,23292,19921,-3371
2019,10,2,19,21016,23576,20054,-3522
2019,10,2,20,21120,23774,20810,-2964
2019,10,2,21,21174,23649,20883,-2766
2019,10,2,22,21008,23369,20662,-2707
2019,10,2,23,20650,22898,20065,-2833
2019,10,3,0,20784,22483,19848,-2635
2019,10,3,1,19975,21505,18608,-2897
2019,10,3,2,18686,20151,16744,-3407
2019,10,3,3,17220,18462,15155,-3307
2019,10,3,4,15766,16859,13744,-3115
2019,10,3,5,14652,15637,12376,-3261
2019,10,3,6,13855,14729,11786,-2943
2019,10,3,7,13294,14111,11458,-2653
2019,10,3,8,12999,13781,11355,-2426
2019,10,3,9,13069,13743,11102,-2641
2019,10,3,10,13849,14418,11629,-2789
2019,10,3,11,15557,15947,13336,-2611
2019,10,3,12,16754,17016,13887,-3129
2019,10,3,13,17247,17509,14084,-3425
2019,10,3,14,17549,17801,14325,-3476
2019,10,3,15,17634,17931,14630,-3301
2019,10,3,16,17571,17916,14558,-3358
2019,10,3,17,17470,17844,14641,-3203
2019,10,3,18,17452,17775,15025,-2750
2019,10,3,19,17351,17683,15035,-2648
2019,10,3,20,17274,17642,14815,-2827
2019,10,3,21,17300,17824,15009,-2815
2019,10,3,22,17433,18065,15382,-2683
2019,10,3,23,17941,18209,15544,-2665
2019,10,4,0,18153,18184,15634,-2550
2019,10,4,1,17728,17727,14580,-3147
2019,10,4,2,16722,16859,13902,-2957
2019,10,4,3,15565,15753,12954,-2799
2019,10,4,4,14349,14579,12269,-2310
2019,10,4,5,13830,13700,11377,-2323
2019,10,4,6,13230,13199,11212,-1987
2019,10,4,7,12917,12904,10992,-1912
2019,10,4,8,12784,12777,10805,-1972
2019,10,4,9,12935,12902,11140,-1762
2019,10,4,10,13701,13699,11755,-1944
2019,10,4,11,15298,15336,12417,-2919
2019,10,4,12,16406,16540,13522,-3018
2019,10,4,13,16786,17034,13666,-3368
2019,10,4,14,17020,17318,13868,-3450
2019,10,4,15,17081,17505,14114,-3391
2019,10,4,16,17014,17422,14058,-3364
2019,10,4,17,16885,17258,13749,-3509
2019,10,4,18,16847,17204,13733,-3471
2019,10,4,19,16800,17033,13741,-3292
2019,10,4,20,16818,16952,13649,-3303
2019,10,4,21,16942,17022,13748,-3274
2019,10,4,22,17044,17193,13942,-3251
2019,10,4,23,17240,17308,14152,-3156
2019,10,5,0,17591,17485,14375,-3110
2019,10,5,1,17223,17008,14053,-2955
2019,10,5,2,16511,16332,13463,-2869
2019,10,5,3,15605,15372,12532,-2840
2019,10,5,4,14530,14326,11819,-2507
2019,10,5,5,13430,13514,11050,-2464
2019,10,5,6,12814,12939,10586,-2353
2019,10,5,7,12467,12596,10511,-2085
2019,10,5,8,12298,12434,10378,-2056
2019,10,5,9,12323,12493,10552,-1941
2019,10,5,10,12623,12801,10930,-1871
2019,10,5,11,13140,13435,11654,-1781
2019,10,5,12,13637,14114,12113,-2001
2019,10,5,13,14212,14706,12591,-2115
2019,10,5,14,14573,14905,12570,-2335
2019,10,5,15,14644,14821,12483,-2338
2019,10,5,16,14537,14687,12221,-2466
2019,10,5,17,14360,14565,12091,-2474
2019,10,5,18,14194,14431,12013,-2418
2019,10,5,19,14141,14378,11971,-2407
2019,10,5,20,14223,14496,12128,-2368
2019,10,5,21,14518,14876,12687,-2189
2019,10,5,22,14912,15358,13111,-2247
2019,10,5,23,15467,15884,13307,-2577
2019,10,6,0,16050,16331,13701,-2630
2019,10,6,1,15923,16091,13537,-2554
2019,10,6,2,15354,15557,13104,-2453
2019,10,6,3,14649,14810,12780,-2030
2019,10,6,4,13838,13936,12159,-1777
2019,10,6,5,13110,13272,11471,-1801
2019,10,6,6,12592,12783,11182,-1601
2019,10,6,7,12220,12457,10901,-1556
2019,10,6,8,12004,12306,11027,-1279
2019,10,6,9,11950,12288,11194,-1094
2019,10,6,10,12105,12484,11405,-1079
2019,10,6,11,12461,12926,11821,-1105
2019,10,6,12,12848,13439,12399,-1040
2019,10,6,13,13624,14270,13082,-1188
2019,10,6,14,14243,14959,13341,-1618
2019,10,6,15,14628,15533,14031,-1502
2019,10,6,16,14810,15757,13690,-2067
2019,10,6,17,14894,15892,13503,-2389
2019,10,6,18,14921,15955,13684,-2271
2019,10,6,19,14942,16012,13584,-2428
2019,10,6,20,15049,16169,14238,-1931
2019,10,6,21,15343,16515,14383,-2132
2019,10,6,22,15761,16932,14611,-2321
2019,10,6,23,16278,17299,14978,-2321
2019,10,7,0,16836,17393,14919,-2474
2019,10,7,1,16491,16966,14677,-2289
2019,10,7,2,15709,16249,13843,-2406
2019,10,7,3,14897,15331,12968,-2363
2019,10,7,4,14036,14307,12400,-1907
2019,10,7,5,13242,13619,11761,-1858
2019,10,7,6,12821,13183,11548,-1635
2019,10,7,7,12590,12913,11266,-1647
2019,10,7,8,12512,12813,11181,-1632
2019,10,7,9,12722,13056,11204,-1852
2019,10,7,10,13568,13954,11717,-2237
2019,10,7,11,15216,15702,13373,-2329
2019,10,7,12,16515,17035,14217,-2818
2019,10,7,13,17207,17742,14879,-2863
2019,10,7,14,17761,18120,14915,-3205
2019,10,7,15,18125,18328,14793,-3535
2019,10,7,16,18272,18577,15071,-3506
2019,10,7,17,18305,18665,15234,-3431
2019,10,7,18,18359,18810,15528,-3282
2019,10,7,19,18348,18847,15765,-3082
2019,10,7,20,18397,19002,16071,-2931
2019,10,7,21,18483,19170,16492,-2678
2019,10,7,22,18597,19308,16613,-2695
2019,10,7,23,18720,19451,16923,-2528
2019,10,8,0,18997,19422,16872,-2550
2019,10,8,1,18215,18607,16465,-2142
2019,10,8,2,17124,17527,15502,-2025
2019,10,8,3,15869,16183,14301,-1882
2019,10,8,4,14648,14917,13277,-1640
2019,10,8,5,13757,13975,12766,-1209
2019,10,8,6,13137,13381,12372,-1009
2019,10,8,7,12724,13012,12130,-882
2019,10,8,8,12527,12844,12148,-696
2019,10,8,9,12669,12963,12240,-723
2019,10,8,10,13489,13765,12596,-1169
2019,10,8,11,15206,15426,14080,-1346
2019,10,8,12,16420,16582,14745,-1837
2019,10,8,13,16994,16978,14885,-2093
2019,10,8,14,17193,17161,14884,-2277
2019,10,8,15,17223,17160,14796,-2364
2019,10,8,16,17145,17135,14820,-2315
2019,10,8,17,17050,17032,14518,-2514
2019,10,8,18,17032,17017,14554,-2463
2019,10,8,19,16966,16967,14363,-2604
2019,10,8,20,16965,16960,14339,-2621
2019,10,8,21,17092,17132,14557,-2575
2019,10,8,22,17260,17304,14840,-2464
2019,10,8,23,17728,17604,15324,-2280
2019,10,9,0,17995,17797,15710,-2087
2019,10,9,1,17464,17219,15251,-1968
2019,10,9,2,16489,16354,14538,-1816
2019,10,9,3,15284,15247,13610,-1637
2019,10,9,4,14048,14087,12794,-1293
2019,10,9,5,13178,13338,11876,-1462
2019,10,9,6,12672,12850,11593,-1257
2019,10,9,7,12373,12586,11503,-1083
2019,10,9,8,12258,12491,11486,-1005
2019,10,9,9,12434,12653,11643,-1010
2019,10,9,10,13245,13389,11971,-1418
2019,10,9,11,14904,14872,13214,-1658
2019,10,9,12,16048,15998,14123,-1875
2019,10,9,13,16421,16596,14289,-2307
2019,10,9,14,16642,16884,14400,-2484
2019,10,9,15,16746,16996,14351,-2645
2019,10,9,16,16729,17021,14543,-2478
2019,10,9,17,16676,16945,14502,-2443
2019,10,9,18,16700,16919,14327,-2592
2019,10,9,19,16684,16848,14392,-2456
2019,10,9,20,16718,16800,14243,-2557
2019,10,9,21,16888,16989,14378,-2611
2019,10,9,22,17115,17218,14887,-2331
2019,10,9,23,17498,17560,15257,-2303
2019,10,10,0,17815,17756,15304,-2452
2019,10,10,1,17364,17256,14841,-2415
2019,10,10,2,16398,16423,14435,-1988
2019,10,10,3,15213,15245,13566,-1679
2019,10,10,4,14025,14073,12557,-1516
2019,10,10,5,13036,13288,11657,-1631
2019,10,10,6,12515,12764,11164,-1600
2019,10,10,7,12230,12501,11006,-1495
2019,10,10,8,12134,12421,10900,-1521
2019,10,10,9,12319,12612,11042,-1570
2019,10,10,10,13136,13439,11718,-1721
2019,10,10,11,14849,15192,13325,-1867
2019,10,10,12,16021,16314,14168,-2146
2019,10,10,13,16382,16690,14522,-2168
2019,10,10,14,16622,16693,14509,-2184
2019,10,10,15,16739,16546,14176,-2370
2019,10,10,16,16719,16507,14120,-2387
2019,10,10,17,16642,16434,14220,-2214
2019,10,10,18,16640,16456,14135,-2321
2019,10,10,19,16581,16576,14282,-2294
2019,10,10,20,16585,16759,14566,-2193
2019,10,10,21,16694,17023,14756,-2267
2019,10,10,22,16889,17334,14881,-2453
2019,10,10,23,17286,17701,15097,-2604
2019,10,11,0,17636,17896,15641,-2255
2019,10,11,1,17169,17322,15331,-1991
2019,10,11,2,16233,16437,14604,-1833
2019,10,11,3,15077,15285,13567,-1718
2019,10,11,4,13920,14123,12848,-1275
2019,10,11,5,12927,13327,12061,-1266
2019,10,11,6,12415,12829,11907,-922
2019,10,11,7,12110,12540,11684,-856
2019,10,11,8,11992,12421,11722,-699
2019,10,11,9,12160,12624,11879,-745
2019,10,11,10,12960,13463,12330,-1133
2019,10,11,11,14620,15113,13402,-1711
2019,10,11,12,15778,16226,14160,-2066
2019,10,11,13,16198,16598,14175,-2423
2019,10,11,14,16468,16733,14145,-2588
2019,10,11,15,16586,16749,14071,-2678
2019,10,11,16,16571,16746,13912,-2834
2019,10,11,17,16465,16721,14098,-2623
2019,10,11,18,16420,16767,14259,-2508
2019,10,11,19,16340,16721,14296,-2425
2019,10,11,20,16298,16749,14470,-2279
2019,10,11,21,16377,16908,14440,-2468
2019,10,11,22,16490,17118,14585,-2533
2019,10,11,23,16811,17347,14907,-2440
2019,10,12,0,16996,17290,14893,-2397
2019,10,12,1,16519,16780,14961,-1819
2019,10,12,2,15774,16066,14615,-1451
2019,10,12,3,14860,15119,13524,-1595
2019,10,12,4,13841,14096,12783,-1313
2019,10,12,5,13189,13274,12199,-1075
2019,10,12,6,12609,12651,12027,-624
2019,10,12,7,12246,12328,11722,-606
2019,10,12,8,12056,12171,11410,-761
2019,10,12,9,12051,12204,11345,-859
2019,10,12,10,12322,12485,11680,-805
2019,10,12,11,12901,13109,12510,-599
2019,10,12,12,13512,13782,13268,-514
2019,10,12,13,14231,14565,14052,-513
2019,10,12,14,14774,15139,14253,-886
2019,10,12,15,15031,15376,14397,-979
2019,10,12,16,15084,15390,14410,-980
2019,10,12,17,15010,15292,13828,-1464
2019,10,12,18,14885,15096,13587,-1509
2019,10,12,19,14807,15041,13365,-1676
2019,10,12,20,14833,15122,13701,-1421
2019,10,12,21,15060,15389,14060,-1329
2019,10,12,22,15435,15717,14371,-1346
2019,10,12,23,16055,16155,14665,-1490
2019,10,13,0,16356,16352,15084,-1268
2019,10,13,1,16063,15985,14820,-1165
2019,10,13,2,15498,15487,14284,-1203
2019,10,13,3,14785,14792,13506,-1286
2019,10,13,4,13958,13969,12556,-1413
2019,10,13,5,13093,13174,11870,-1304
2019,10,13,6,12546,12662,11544,-1118
2019,10,13,7,12171,12343,11042,-1301
2019,10,13,8,11957,12154,10852,-1302
2019,10,13,9,11912,12110,10782,-1328
2019,10,13,10,12078,12311,11099,-1212
2019,10,13,11,12456,12767,11647,-1120
2019,10,13,12,12823,13215,11892,-1323
2019,10,13,13,13344,13776,12720,-1056
2019,10,13,14,13800,14106,12925,-1181
2019,10,13,15,14015,14285,13003,-1282
2019,10,13,16,14071,14298,12931,-1367
2019,10,13,17,14091,14275,12748,-1527
2019,10,13,18,14098,14233,12693,-1540
2019,10,13,19,14149,14304,12737,-1567
2019,10,13,20,14318,14537,12934,-1603
2019,10,13,21,14730,15005,13487,-1518
2019,10,13,22,15277,15508,13785,-1723
2019,10,13,23,16028,16117,14319,-1798
2019,10,14,0,16506,16307,14633,-1674
2019,10,14,1,16184,15942,14473,-1469
2019,10,14,2,15429,15348,14116,-1232
2019,10,14,3,14509,14588,13405,-1183
2019,10,14,4,13563,13755,12466,-1289
2019,10,14,5,12697,13105,12133,-972
2019,10,14,6,12242,12647,11429,-1218
2019,10,14,7,11981,12416,10988,-1428
2019,10,14,8,11889,12323,10875,-1448
2019,10,14,9,12092,12499,11249,-1250
2019,10,14,10,12911,13155,12077,-1078
2019,10,14,11,14527,14359,13402,-957
2019,10,14,12,15767,15441,14259,-1182
2019,10,14,13,16265,16162,14260,-1902
2019,10,14,14,16502,16627,14603,-2024
2019,10,14,15,16586,16737,14694,-2043
2019,10,14,16,16572,16732,14728,-2004
2019,10,14,17,16501,16685,14544,-2141
2019,10,14,18,16498,16766,14713,-2053
2019,10,14,19,16501,16936,14534,-2402
2019,10,14,20,16613,17168,14579,-2589
2019,10,14,21,16882,17473,14965,-2508
2019,10,14,22,17241,17711,15505,-2206
2019,10,14,23,17760,18040,16139,-1901
2019,10,15,0,17994,18093,16508,-1585
2019,10,15,1,17463,17455,15647,-1808
2019,10,15,2,16525,16546,14699,-1847
2019,10,15,3,15316,15430,13949,-1481
2019,10,15,4,14099,14251,12977,-1274
2019,10,15,5,13075,13357,11958,-1399
2019,10,15,6,12520,12862,11465,-1397
2019,10,15,7,12206,12563,11188,-1375
2019,10,15,8,12094,12466,11081,-1385
2019,10,15,9,12302,12716,11321,-1395
2019,10,15,10,13166,13577,12042,-1535
2019,10,15,11,14923,15323,13956,-1367
2019,10,15,12,16110,16410,14929,-1481
2019,10,15,13,16360,16599,15163,-1436
2019,10,15,14,16395,16570,14626,-1944
2019,10,15,15,16334,16468,14107,-2361
2019,10,15,16,16205,16368,14077,-2291
2019,10,15,17,16096,16262,14171,-2091
2019,10,15,18,16086,16264,14200,-2064
2019,10,15,19,16059,16269,14214,-2055
2019,10,15,20,16137,16440,14464,-1976
2019,10,15,21,16386,16802,14790,-2012
2019,10,15,22,16718,17199,15397,-1802
2019,10,15,23,17333,17706,15987,-1719
2019,10,16,0,17619,17804,16168,-1636
2019,10,16,1,17148,17197,15709,-1488
2019,10,16,2,16225,16402,14669,-1733
2019,10,16,3,15008,15325,13937,-1388
2019,10,16,4,13811,14172,13145,-1027
2019,10,16,5,13007,13360,12252,-1108
2019,10,16,6,12499,12882,11394,-1488
2019,10,16,7,12206,12613,11168,-1445
2019,10,16,8,12094,12530,11170,-1360
2019,10,16,9,12279,12731,11362,-1369
2019,10,16,10,13093,13575,12385,-1190
2019,10,16,11,14799,15314,14197,-1117
2019,10,16,12,16032,16489,15262,-1227
2019,10,16,13,16424,16893,15584,-1309
2019,10,16,14,16625,17182,15775,-1407
2019,10,16,15,16737,17465,16041,-1424
2019,10,16,16,16776,17563,15762,-1801
2019,10,16,17,16786,17671,15475,-2196
2019,10,16,18,16863,17691,15406,-2285
2019,10,16,19,16880,17752,15458,-2294
2019,10,16,20,16937,17909,15727,-2182
2019,10,16,21,17112,18131,16053,-2078
2019,10,16,22,17364,18474,16749,-1725
2019,10,16,23,17815,18602,16691,-1911
2019,10,17,0,17967,18316,16457,-1859
2019,10,17,1,17391,17648,16029,-1619
2019,10,17,2,16420,16770,15446,-1324
2019,10,17,3,15239,15621,14779,-842
2019,10,17,4,14056,14303,13657,-646
2019,10,17,5,13069,13355,12242,-1113
2019,10,17,6,12559,12818,11789,-1029
2019,10,17,7,12259,12508,11525,-983
2019,10,17,8,12142,12410,11506,-904
2019,10,17,9,12315,12589,11785,-804
2019,10,17,10,13104,13451,12965,-486
2019,10,17,11,14837,15192,14854,-338
2019,10,17,12,16072,16498,15980,-518
2019,10,17,13,16427,17028,15735,-1293
2019,10,17,14,16680,17325,15804,-1521
2019,10,17,15,16824,17432,15713,-1719
2019,10,17,16,16817,17440,15656,-1784
2019,10,17,17,16766,17385,15758,-1627
2019,10,17,18,16774,17388,15860,-1528
2019,10,17,19,16735,17336,16044,-1292
2019,10,17,20,16761,17335,16184,-1151
2019,10,17,21,16926,17534,16276,-1258
2019,10,17,22,17182,17893,16902,-991
2019,10,17,23,17660,18294,17507,-787
2019,10,18,0,17846,18162,17501,-661
2019,10,18,1,17281,17589,16898,-691
2019,10,18,2,16332,16789,16279,-510
2019,10,18,3,15138,15667,15367,-300
2019,10,18,4,13966,14466,14057,-409
2019,10,18,5,13216,13596,13191,-405
2019,10,18,6,12684,13089,12524,-565
2019,10,18,7,12361,12792,12171,-621
2019,10,18,8,12229,12690,11945,-745
2019,10,18,9,12397,12848,12119,-729
2019,10,18,10,13202,13664,13020,-644
2019,10,18,11,14924,15355,14869,-486
2019,10,18,12,16152,16513,16192,-321
2019,10,18,13,16532,16869,16310,-559
2019,10,18,14,16742,17042,15782,-1260
2019,10,18,15,16809,17052,15632,-1420
2019,10,18,16,16740,16869,15440,-1429
2019,10,18,17,16607,16716,15012,-1704
2019,10,18,18,16544,16667,15007,-1660
2019,10,18,19,16467,16661,14828,-1833
2019,10,18,20,16458,16606,14876,-1730
2019,10,18,21,16600,16706,15237,-1469
2019,10,18,22,16791,17014,15842,-1172
2019,10,18,23,17313,17445,16277,-1168
2019,10,19,0,17314,17453,16463,-990
2019,10,19,1,16829,16980,15658,-1322
2019,10,19,2,16164,16354,15008,-1346
2019,10,19,3,15247,15456,13645,-1811
2019,10,19,4,14227,14424,12853,-1571
2019,10,19,5,13437,13580,11653,-1927
2019,10,19,6,12869,13027,11179,-1848
2019,10,19,7,12515,12726,10864,-1862
2019,10,19,8,12342,12576,10785,-1791
2019,10,19,9,12375,12596,11096,-1500
2019,10,19,10,12704,12916,11516,-1400
2019,10,19,11,13360,13640,11877,-1763
2019,10,19,12,14033,14360,12421,-1939
2019,10,19,13,14626,14895,13401,-1494
2019,10,19,14,14948,15034,13391,-1643
2019,10,19,15,14965,14930,12787,-2143
2019,10,19,16,14766,14735,12528,-2207
2019,10,19,17,14535,14526,11998,-2528
2019,10,19,18,14312,14313,11900,-2413
2019,10,19,19,14189,14218,11866,-2352
2019,10,19,20,14227,14359,12057,-2302
2019,10,19,21,14544,14791,12619,-2172
2019,10,19,22,15043,15311,13010,-2301
2019,10,19,23,15906,16055,13888,-2167
2019,10,20,0,16181,16226,14319,-1907
2019,10,20,1,15934,15944,14373,-1571
2019,10,20,2,15448,15478,13917,-1561
2019,10,20,3,14705,14792,12996,-1796
2019,10,20,4,13852,14008,12421,-1587
2019,10,20,5,13151,13295,11848,-1447
2019,10,20,6,12668,12783,11613,-1170
2019,10,20,7,12334,12461,11173,-1288
2019,10,20,8,12149,12284,11039,-1245
2019,10,20,9,12129,12285,11208,-1077
2019,10,20,10,12306,12507,11762,-745
2019,10,20,11,12726,12989,11995,-994
2019,10,20,12,13150,13517,12749,-768
2019,10,20,13,13673,14156,13401,-755
2019,10,20,14,14152,14697,13586,-1111
2019,10,20,15,14430,15037,13772,-1265
2019,10,20,16,14533,15245,13687,-1558
2019,10,20,17,14572,15325,13576,-1749
2019,10,20,18,14566,15391,13651,-1740
2019,10,20,19,14543,15430,13682,-1748
2019,10,20,20,14612,15547,14015,-1532
2019,10,20,21,14912,15872,14319,-1553
2019,10,20,22,15402,16255,14868,-1387
2019,10,20,23,16128,16777,15757,-1020
2019,10,21,0,16469,16802,15805,-997
2019,10,21,1,16047,16368,15236,-1132
2019,10,21,2,15324,15655,14360,-1295
2019,10,21,3,14423,14715,13634,-1081
2019,10,21,4,13516,13712,12531,-1181
2019,10,21,5,12803,13038,12052,-986
2019,10,21,6,12397,12629,11622,-1007
2019,10,21,7,12165,12408,11492,-916
2019,10,21,8,12101,12379,11383,-996
2019,10,21,9,12333,12636,11578,-1058
2019,10,21,10,13183,13510,12775,-735
2019,10,21,11,14851,15233,14057,-1176
2019,10,21,12,16087,16444,15180,-1264
2019,10,21,13,16419,16762,15497,-1265
2019,10,21,14,16585,16878,15500,-1378
2019,10,21,15,16611,16814,15519,-1295
2019,10,21,16,16505,16628,15072,-1556
2019,10,21,17,16371,16452,14509,-1943
2019,10,21,18,16338,16383,14631,-1752
2019,10,21,19,16334,16352,14925,-1427
2019,10,21,20,16444,16503,15101,-1402
2019,10,21,21,16733,16835,15494,-1341
2019,10,21,22,17109,17290,15969,-1321
2019,10,21,23,17731,17908,16195,-1713
2019,10,22,0,17842,17896,16649,-1247
2019,10,22,1,17294,17270,16468,-802
2019,10,22,2,16400,16431,15814,-617
2019,10,22,3,15191,15252,14834,-418
2019,10,22,4,14003,14102,13473,-629
2019,10,22,5,13098,13293,13138,-155
2019,10,22,6,12573,12782,12421,-361
2019,10,22,7,12260,12498,12085,-413
2019,10,22,8,12138,12403,11903,-500
2019,10,22,9,12315,12559,11977,-582
2019,10,22,10,13111,13372,13270,-102
2019,10,22,11,14837,15075,14903,-172
2019,10,22,12,16123,16378,15785,-593
2019,10,22,13,16506,16849,16132,-717
2019,10,22,14,16767,17256,16254,-1002
2019,10,22,15,16912,17461,16062,-1399
2019,10,22,16,16928,17550,16113,-1437
2019,10,22,17,16916,17528,16001,-1527
2019,10,22,18,16940,17528,15959,-1569
2019,10,22,19,16870,17487,16009,-1478
2019,10,22,20,16862,17545,16166,-1379
2019,10,22,21,16981,17821,16263,-1558
2019,10,22,22,17219,18119,16611,-1508
2019,10,22,23,17868,18364,16897,-1467
2019,10,23,0,17899,18094,16599,-1495
2019,10,23,1,17259,17498,16421,-1077
2019,10,23,2,16334,16605,15482,-1123
2019,10,23,3,15159,15383,14535,-848
2019,10,23,4,14000,14234,13168,-1066
2019,10,23,5,13076,13504,12550,-954
2019,10,23,6,12576,13025,11891,-1134
2019,10,23,7,12269,12681,11596,-1085
2019,10,23,8,12145,12552,11629,-923
2019,10,23,9,12305,12732,11732,-1000
2019,10,23,10,13091,13541,12691,-850
2019,10,23,11,14806,15183,13895,-1288
2019,10,23,12,16052,16424,15253,-1171
2019,10,23,13,16243,16532,15348,-1184
2019,10,23,14,16328,16658,15388,-1270
2019,10,23,15,16306,16589,15385,-1204
2019,10,23,16,16207,16486,14874,-1612
2019,10,23,17,16135,16448,14929,-1519
2019,10,23,18,16192,16484,14831,-1653
2019,10,23,19,16247,16452,15454,-998
2019,10,23,20,16382,16555,15476,-1079
2019,10,23,21,16686,16884,16215,-669
2019,10,23,22,17033,17332,16512,-820
2019,10,23,23,17647,17898,16632,-1266
2019,10,24,0,17693,17909,16715,-1194
2019,10,24,1,17166,17386,16104,-1282
2019,10,24,2,16339,16545,15349,-1196
2019,10,24,3,15166,15385,14103,-1282
2019,10,24,4,13972,14203,12630,-1573
2019,10,24,5,13049,13392,11757,-1635
2019,10,24,6,12494,12911,10888,-2023
2019,10,24,7,12198,12660,10989,-1671
2019,10,24,8,12096,12574,10951,-1623
2019,10,24,9,12305,12772,11115,-1657
2019,10,24,10,13141,13694,12051,-1643
2019,10,24,11,14953,15472,13825,-1647
2019,10,24,12,16238,16650,15633,-1017
2019,10,24,13,16453,16979,15515,-1464
2019,10,24,14,16520,16909,15299,-1610
2019,10,24,15,16511,16781,14842,-1939
2019,10,24,16,16416,16719,14563,-2156
2019,10,24,17,16318,16661,14597,-2064
2019,10,24,18,16330,16669,14777,-1892
2019,10,24,19,16344,16630,14680,-1950
2019,10,24,20,16449,16745,14814,-1931
2019,10,24,21,16714,17054,15027,-2027
2019,10,24,22,17037,17414,15363,-2051
2019,10,24,23,17679,17889,15693,-2196
2019,10,25,0,17748,17814,15594,-2220
2019,10,25,1,17255,17305,15400,-1905
2019,10,25,2,16398,16449,14385,-2064
2019,10,25,3,15189,15291,13323,-1968
2019,10,25,4,13991,14182,12533,-1649
2019,10,25,5,12978,13375,11669,-1706
2019,10,25,6,12460,12879,10988,-1891
2019,10,25,7,12161,12613,10591,-2022
2019,10,25,8,12042,12515,10540,-1975
2019,10,25,9,12221,12696,10822,-1874
2019,10,25,10,13033,13571,12073,-1498
2019,10,25,11,14790,15266,13564,-1702
2019,10,25,12,16092,16510,14644,-1866
2019,10,25,13,16438,16997,14690,-2307
2019,10,25,14,16655,17124,14473,-2651
2019,10,25,15,16719,17157,14322,-2835
2019,10,25,16,16666,17072,14075,-2997
2019,10,25,17,16559,16943,13816,-3127
2019,10,25,18,16531,16965,14038,-2927
2019,10,25,19,16466,16881,14020,-2861
2019,10,25,20,16445,16955,14487,-2468
2019,10,25,21,16562,17136,14906,-2230
2019,10,25,22,16759,17344,14957,-2387
2019,10,25,23,17320,17685,15139,-2546
2019,10,26,0,17241,17412,15138,-2274
2019,10,26,1,16670,16957,14496,-2461
2019,10,26,2,15954,16246,13847,-2399
2019,10,26,3,15005,15301,13094,-2207
2019,10,26,4,13970,14315,11912,-2403
2019,10,26,5,13208,13510,11408,-2102
2019,10,26,6,12667,13006,11341,-1665
2019,10,26,7,12332,12641,11221,-1420
2019,10,26,8,12164,12459,11414,-1045
2019,10,26,9,12183,12457,11217,-1240
2019,10,26,10,12467,12718,11408,-1310
2019,10,26,11,13106,13354,11622,-1732
2019,10,26,12,13808,14091,12437,-1654
2019,10,26,13,14342,14684,12807,-1877
2019,10,26,14,14761,14975,12953,-2022
2019,10,26,15,14908,15046,12883,-2163
2019,10,26,16,14868,14984,12795,-2189
2019,10,26,17,14746,14772,12598,-2174
2019,10,26,18,14605,14657,12366,-2291
2019,10,26,19,14547,14619,12456,-2163
2019,10,26,20,14597,14768,12833,-1935
2019,10,26,21,14846,15101,13178,-1923
2019,10,26,22,15279,15597,13867,-1730
2019,10,26,23,16069,16332,14111,-2221
2019,10,27,0,16175,16276,14032,-2244
2019,10,27,1,15808,15929,13998,-1931
2019,10,27,2,15279,15422,13566,-1856
2019,10,27,3,14532,14698,12793,-1905
2019,10,27,4,13712,13895,12043,-1852
2019,10,27,5,13035,13215,11790,-1425
2019,10,27,6,12498,12700,11789,-911
2019,10,27,7,12134,12400,11640,-760
2019,10,27,8,11927,12213,11676,-537
2019,10,27,9,11885,12190,11714,-476
2019,10,27,10,12036,12398,11938,-460
2019,10,27,11,12505,12856,12111,-745
2019,10,27,12,13080,13493,12855,-638
2019,10,27,13,13775,14313,13311,-1002
2019,10,27,14,14432,15178,13805,-1373
2019,10,27,15,14855,15839,14365,-1474
2019,10,27,16,15069,16227,14280,-1947
2019,10,27,17,15173,16440,14471,-1969
2019,10,27,18,15178,16514,14677,-1837
2019,10,27,19,15134,16404,14523,-1881
2019,10,27,20,15168,16351,14331,-2020
2019,10,27,21,15432,16538,14536,-2002
2019,10,27,22,15914,16810,14911,-1899
2019,10,27,23,16670,17315,15214,-2101
2019,10,28,0,16786,17099,15192,-1907
2019,10,28,1,16279,16538,14871,-1667
2019,10,28,2,15568,15773,13954,-1819
2019,10,28,3,14653,14811,13136,-1675
2019,10,28,4,13719,13860,12205,-1655
2019,10,28,5,12819,13127,11809,-1318
2019,10,28,6,12347,12650,11611,-1039
2019,10,28,7,12057,12306,11262,-1044
2019,10,28,8,11937,12227,11276,-951
2019,10,28,9,12126,12470,11492,-978
2019,10,28,10,12921,13358,11956,-1402
2019,10,28,11,14590,15097,13064,-2033
2019,10,28,12,15954,16405,14079,-2326
2019,10,28,13,16379,16789,14302,-2487
2019,10,28,14,16611,16838,14262,-2576
2019,10,28,15,16714,16800,13973,-2827
2019,10,28,16,16675,16772,13773,-2999
2019,10,28,17,16602,16770,13806,-2964
2019,10,28,18,16602,16781,13821,-2960
2019,10,28,19,16592,16711,13891,-2820
2019,10,28,20,16683,16740,13896,-2844
2019,10,28,21,16940,17008,13899,-3109
2019,10,28,22,17333,17412,14307,-3105
2019,10,28,23,17989,17992,15082,-2910
2019,10,29,0,17932,17903,15268,-2635
2019,10,29,1,17291,17270,14745,-2525
2019,10,29,2,16415,16374,13779,-2595
2019,10,29,3,15160,15169,13294,-1875
2019,10,29,4,13932,14064,12403,-1661
2019,10,29,5,13060,13269,11527,-1742
2019,10,29,6,12527,12755,11505,-1250
2019,10,29,7,12206,12502,11475,-1027
2019,10,29,8,12077,12411,11479,-932
2019,10,29,9,12258,12639,11793,-846
2019,10,29,10,13062,13508,12416,-1092
2019,10,29,11,14847,15235,13875,-1360
2019,10,29,12,16229,16537,15055,-1482
2019,10,29,13,16570,16903,15141,-1762
2019,10,29,14,16794,17058,15166,-1892
2019,10,29,15,16917,17156,15059,-2097
2019,10,29,16,16895,17152,14900,-2252
2019,10,29,17,16848,17039,14534,-2505
2019,10,29,18,16847,16989,14561,-2428
2019,10,29,19,16774,16946,14510,-2436
2019,10,29,20,16789,16998,14450,-2548
2019,10,29,21,16966,17228,14770,-2458
2019,10,29,22,17299,17669,15027,-2642
2019,10,29,23,17980,18135,15532,-2603
2019,10,30,0,17918,17991,15879,-2112
2019,10,30,1,17259,17390,15325,-2065
2019,10,30,2,16369,16492,14404,-2088
2019,10,30,3,15156,15116,13247,-1869
2019,10,30,4,13971,13999,12322,-1677
2019,10,30,5,13072,13207,11517,-1690
2019,10,30,6,12571,12753,11107,-1646
2019,10,30,7,12263,12448,10994,-1454
2019,10,30,8,12140,12328,10839,-1489
2019,10,30,9,12315,12515,11315,-1200
2019,10,30,10,13119,13393,11940,-1453
2019,10,30,11,14914,15002,13251,-1751
2019,10,30,12,16355,16280,14272,-2008
2019,10,30,13,16768,16867,14530,-2337
2019,10,30,14,17031,17272,14757,-2515
2019,10,30,15,17161,17419,14855,-2564
2019,10,30,16,17152,17441,14587,-2854
2019,10,30,17,17097,17453,14789,-2664
2019,10,30,18,17099,17479,14799,-2680
2019,10,30,19,17056,17353,14873,-2480
2019,10,30,20,17095,17345,14829,-2516
2019,10,30,21,17293,17548,15184,-2364
2019,10,30,22,17644,17925,15366,-2559
2019,10,30,23,18188,18334,15710,-2624
2019,10,31,0,18096,18044,15538,-2506
2019,10,31,1,17428,17480,15547,-1933
2019,10,31,2,16562,16626,14700,-1926
2019,10,31,3,15385,15460,13684,-1776
2019,10,31,4,14209,14367,12789,-1578
2019,10,31,5,13154,13519,11634,-1885
2019,10,31,6,12655,12965,11343,-1622
2019,10,31,7,12376,12669,11332,-1337
2019,10,31,8,12277,12567,11189,-1378
2019,10,31,9,12472,12723,11315,-1408
2019,10,31,10,13279,13540,11941,-1599
2019,10,31,11,15109,15189,13094,-2095
2019,10,31,12,16585,16704,14962,-1742
2019,10,31,13,17045,17383,15714,-1669
2019,10,31,14,17407,17791,15715,-2076
2019,10,31,15,17642,18099,15608,-2491
2019,10,31,16,17687,18278,15616,-2662
2019,10,31,17,17642,18301,15932,-2369
2019,10,31,18,17628,18285,15957,-2328
2019,10,31,19,17543,18200,15510,-2690
2019,10,31,20,17538,18172,15496,-2676
2019,10,31,21,17675,18374,16016,-2358
2019,10,31,22,18019,18574,16336,-2238
2019,10,31,23,18567,18635,16254,-2381
2019,11,1,0,18521,18333,16117,-2216
2019,11,1,1,17827,17800,15771,-2029
2019,11,1,2,17020,16946,15041,-1905
2019,11,1,3,15867,15838,13868,-1970
2019,11,1,4,14687,14714,12919,-1795
2019,11,1,5,13485,13821,12323,-1498
2019,11,1,6,12903,13134,11993,-1141
2019,11,1,7,12483,12585,11875,-710
2019,11,1,8,12279,12337,11975,-362
2019,11,1,9,12391,12487,12218,-269
2019,11,1,10,13144,13278,12578,-700
2019,11,1,11,14798,14852,13235,-1617
2019,11,1,12,16230,16166,14338,-1828
2019,11,1,13,16640,16617,14457,-2160
2019,11,1,14,16710,16819,14701,-2118
2019,11,1,15,16638,16846,14729,-2117
2019,11,1,16,16485,16846,14349,-2497
2019,11,1,17,16334,16691,13893,-2798
2019,11,1,18,16320,16696,13978,-2718
2019,11,1,19,16294,16677,14056,-2621
2019,11,1,20,16443,16800,14506,-2294
2019,11,1,21,16940,17081,14771,-2310
2019,11,1,22,16944,17494,15046,-2448
2019,11,1,23,17444,17937,15530,-2407
2019,11,2,0,17295,17741,15633,-2108
2019,11,2,1,16819,17397,15443,-1954
2019,11,2,2,16070,16580,14202,-2378
2019,11,2,3,15030,15650,13437,-2213
2019,11,2,4,13956,14657,12666,-1991
2019,11,2,5,13596,13869,11714,-2155
2019,11,2,6,12925,13323,11386,-1937
2019,11,2,7,12617,12989,11151,-1838
2019,11,2,8,12509,12859,11218,-1641
2019,11,2,9,12607,12869,11247,-1622
2019,11,2,10,12945,13208,11767,-1441
2019,11,2,11,13614,13949,12314,-1635
2019,11,2,12,14567,14754,13008,-1746
2019,11,2,13,15150,15403,13924,-1479
2019,11,2,14,15415,15616,14224,-1392
2019,11,2,15,15418,15580,13910,-1670
2019,11,2,16,15343,15414,13519,-1895
2019,11,2,17,15113,15181,13510,-1671
2019,11,2,18,14917,15008,13378,-1630
2019,11,2,19,14838,14935,13577,-1358
2019,11,2,20,14959,15060,13585,-1475
2019,11,2,21,15504,15519,13896,-1623
2019,11,2,22,15718,16128,14501,-1627
2019,11,2,23,16529,16838,14909,-1929
2019,11,3,0,16542,16787,15025,-1762
2019,11,3,1,16269,16445,14597,-1848
2019,11,3,2,15787,15954,13925,-2029
2019,11,3,3,15070,15257,13107,-2150
2019,11,3,4,14241,14456,12393,-2063
2019,11,3,5,13373,13741,11672,-2069
2019,11,3,6,12791,13224,11577,-1647
2019,11,3,7,12791,12890,11100,-1790
2019,11,3,8,12506,12720,11115,-1605
2019,11,3,9,12385,12677,11369,-1308
2019,11,3,10,12461,12801,11623,-1178
2019,11,3,11,12769,13130,12084,-1046
2019,11,3,12,13170,13655,12642,-1013
2019,11,3,13,13523,14222,13213,-1009
2019,11,3,14,14056,14704,13493,-1211
2019,11,3,15,14327,14989,13799,-1190
2019,11,3,16,14439,15076,13546,-1530
2019,11,3,17,14578,15161,13357,-1804
2019,11,3,18,14593,15325,13534,-1791
2019,11,3,19,14635,15450,13728,-1722
2019,11,3,20,14785,15605,13999,-1606
2019,11,3,21,15148,15928,14220,-1708
2019,11,3,22,16055,16633,14710,-1923
2019,11,3,23,17248,17592,15290,-2302
2019,11,4,0,17335,17562,15438,-2124
2019,11,4,1,17060,17240,15258,-1982
2019,11,4,2,16527,16762,15012,-1750
2019,11,4,3,15881,15981,14210,-1771
2019,11,4,4,14988,15004,13313,-1691
2019,11,4,5,14129,14116,12275,-1841
2019,11,4,6,13274,13569,11541,-2028
2019,11,4,7,12929,13228,11621,-1607
2019,11,4,8,12752,13068,11376,-1692
2019,11,4,9,12735,13066,11355,-1711
2019,11,4,10,13052,13420,12048,-1372
2019,11,4,11,14016,14469,13241,-1228
2019,11,4,12,15608,16185,14597,-1588
2019,11,4,13,16556,17093,15172,-1921
2019,11,4,14,16822,17282,15280,-2002
2019,11,4,15,16856,17318,15281,-2037
2019,11,4,16,16819,17320,14964,-2356
2019,11,4,17,16728,17273,14905,-2368
2019,11,4,18,16637,17186,14831,-2355
2019,11,4,19,16674,17244,14828,-2416
2019,11,4,20,16723,17334,14958,-2376
2019,11,4,21,16951,17557,15149,-2408
2019,11,4,22,17663,18161,15657,-2504
2019,11,4,23,18647,19098,16585,-2513
2019,11,5,0,18549,18913,16847,-2066
2019,11,5,1,18111,18437,16589,-1848
2019,11,5,2,17387,17748,16142,-1606
2019,11,5,3,16504,16808,15455,-1353
2019,11,5,4,15322,15611,14222,-1389
2019,11,5,5,14177,14572,13156,-1416
2019,11,5,6,13257,13747,12416,-1331
2019,11,5,7,12765,13269,12344,-925
2019,11,5,8,12483,13037,12156,-881
2019,11,5,9,12389,12972,12005,-967
2019,11,5,10,12643,13216,12608,-608
2019,11,5,11,13560,14057,13406,-651
2019,11,5,12,15193,15596,14721,-875
2019,11,5,13,16263,16730,15717,-1013
2019,11,5,14,16720,17286,16032,-1254
2019,11,5,15,16904,17598,15985,-1613
2019,11,5,16,17001,17740,15839,-1901
2019,11,5,17,16991,17880,15733,-2147
2019,11,5,18,16927,17892,15707,-2185
2019,11,5,19,16911,17891,15786,-2105
2019,11,5,20,16876,17806,15483,-2323
2019,11,5,21,17002,17762,15140,-2622
2019,11,5,22,17611,18135,15454,-2681
2019,11,5,23,18520,18947,16690,-2257
2019,11,6,0,18483,18800,16746,-2054
2019,11,6,1,17966,18355,16405,-1950
2019,11,6,2,17277,17745,15818,-1927
2019,11,6,3,16468,16746,14966,-1780
2019,11,6,4,15357,15585,14061,-1524
2019,11,6,5,14265,14560,13219,-1341
2019,11,6,6,13364,13777,12622,-1155
2019,11,6,7,12894,13362,12220,-1142
2019,11,6,8,12644,13127,12062,-1065
2019,11,6,9,12585,13062,12043,-1019
2019,11,6,10,12849,13364,12470,-894
2019,11,6,11,13795,14265,13530,-735
2019,11,6,12,15416,15970,14936,-1034
2019,11,6,13,16388,16894,16238,-656
2019,11,6,14,16632,17026,16000,-1026
2019,11,6,15,16637,16976,15437,-1539
2019,11,6,16,16572,16904,14746,-2158
2019,11,6,17,16481,16763,14526,-2237
2019,11,6,18,16371,16664,14177,-2487
2019,11,6,19,16431,16706,14311,-2395
2019,11,6,20,16538,16885,14399,-2486
2019,11,6,21,16815,17296,14691,-2605
2019,11,6,22,17583,18000,15693,-2307
2019,11,6,23,18591,18946,16759,-2187
2019,11,7,0,18523,18884,17149,-1735
2019,11,7,1,18125,18494,16703,-1791
2019,11,7,2,17481,17893,15924,-1969
2019,11,7,3,16697,16993,15378,-1615
2019,11,7,4,15586,15804,14464,-1340
2019,11,7,5,14479,14735,13549,-1186
2019,11,7,6,13583,13928,12790,-1138
2019,11,7,7,13111,13463,12336,-1127
2019,11,7,8,12850,13229,12147,-1082
2019,11,7,9,12780,13164,12078,-1086
2019,11,7,10,13043,13416,12394,-1022
2019,11,7,11,13947,14312,13334,-978
2019,11,7,12,15576,15973,14865,-1108
2019,11,7,13,16602,17072,16031,-1041
2019,11,7,14,16981,17568,16294,-1274
2019,11,7,15,17110,17894,16259,-1635
2019,11,7,16,17156,18032,16481,-1551
2019,11,7,17,17115,18050,16206,-1844
2019,11,7,18,17037,18114,15891,-2223
2019,11,7,19,17062,18167,15799,-2368
2019,11,7,20,17099,18152,15525,-2627
2019,11,7,21,17283,18271,15498,-2773
2019,11,7,22,17887,18783,16346,-2437
2019,11,7,23,18814,19428,17208,-2220
2019,11,8,0,18759,19215,17369,-1846
2019,11,8,1,18312,18801,17034,-1767
2019,11,8,2,17641,18184,15780,-2404
2019,11,8,3,16819,17312,14953,-2359
2019,11,8,4,15718,16148,14229,-1919
2019,11,8,5,14672,15057,13716,-1341
2019,11,8,6,14079,14359,13000,-1359
2019,11,8,7,13670,13930,12638,-1292
2019,11,8,8,13439,13700,12455,-1245
2019,11,8,9,13409,13702,12314,-1388
2019,11,8,10,13688,14028,12801,-1227
2019,11,8,11,14620,14957,13891,-1066
2019,11,8,12,16240,16613,15251,-1362
2019,11,8,13,17252,17591,16315,-1276
2019,11,8,14,17520,17936,16340,-1596
2019,11,8,15,17594,18087,15866,-2221
2019,11,8,16,17550,18186,15860,-2326
2019,11,8,17,17449,18100,15397,-2703
2019,11,8,18,17291,17910,15133,-2777
2019,11,8,19,17295,17906,15522,-2384
2019,11,8,20,17354,17965,15975,-1990
2019,11,8,21,17617,18216,16505,-1711
2019,11,8,22,18294,18884,17087,-1797
2019,11,8,23,19252,19779,17967,-1812
2019,11,9,0,19131,19613,17761,-1852
2019,11,9,1,18712,19228,17459,-1769
2019,11,9,2,18174,18704,16953,-1751
2019,11,9,3,17537,18004,16231,-1773
2019,11,9,4,16616,17057,14867,-2190
2019,11,9,5,15649,16106,14129,-1977
2019,11,9,6,14954,15334,13668,-1666
2019,11,9,7,14449,14841,13262,-1579
2019,11,9,8,14126,14569,12790,-1779
2019,11,9,9,13969,14446,12702,-1744
2019,11,9,10,14036,14521,13195,-1326
2019,11,9,11,14408,14870,13757,-1113
2019,11,9,12,14989,15503,13976,-1527
2019,11,9,13,15499,16090,14480,-1610
2019,11,9,14,16076,16558,14685,-1873
2019,11,9,15,16402,16761,14872,-1889
2019,11,9,16,16485,16758,14866,-1892
2019,11,9,17,16440,16604,14744,-1860
2019,11,9,18,16271,16461,14401,-2060
2019,11,9,19,16142,16361,14381,-1980
2019,11,9,20,16133,16408,14704,-1704
2019,11,9,21,16343,16755,15021,-1734
2019,11,9,22,17022,17497,15317,-2180
2019,11,9,23,18000,18361,16335,-2026
2019,11,10,0,17990,18297,16483,-1814
2019,11,10,1,17642,17976,16391,-1585
2019,11,10,2,17145,17540,15610,-1930
2019,11,10,3,16642,16947,14777,-2170
2019,11,10,4,15893,16189,13850,-2339
2019,11,10,5,15105,15363,13086,-2277
2019,11,10,6,14535,14657,12524,-2133
2019,11,10,7,13970,14172,12254,-1918
2019,11,10,8,13647,13847,12240,-1607
2019,11,10,9,13497,13687,12197,-1490
2019,11,10,10,13518,13693,12237,-1456
2019,11,10,11,13757,13929,12698,-1231
2019,11,10,12,14119,14348,13008,-1340
2019,11,10,13,14492,14831,13674,-1157
2019,11,10,14,15013,15455,14111,-1344
2019,11,10,15,15384,15751,14428,-1323
2019,11,10,16,15533,16009,14821,-1188
2019,11,10,17,15598,16272,15057,-1215
2019,11,10,18,15589,16372,14930,-1442
2019,11,10,19,15597,16197,14649,-1548
2019,11,10,20,15715,16264,14881,-1383
2019,11,10,21,15994,16511,15088,-1423
2019,11,10,22,16785,17092,15153,-1939
2019,11,10,23,17853,17888,15817,-2071
2019,11,11,0,17858,17768,15768,-2000
2019,11,11,1,17534,17420,15344,-2076
2019,11,11,2,17044,16983,14908,-2075
2019,11,11,3,16295,16308,14551,-1757
2019,11,11,4,15326,15433,13816,-1617
2019,11,11,5,14405,14579,13062,-1517
2019,11,11,6,13841,13922,12195,-1727
2019,11,11,7,13473,13509,11933,-1576
2019,11,11,8,13279,13282,11783,-1499
2019,11,11,9,13245,13263,11901,-1362
2019,11,11,10,13538,13519,12527,-992
2019,11,11,11,14480,14326,13182,-1144
2019,11,11,12,16085,15570,13790,-1780
2019,11,11,13,17125,16605,14744,-1861
2019,11,11,14,17423,17234,14833,-2401
2019,11,11,15,17634,17588,15072,-2516
2019,11,11,16,17743,17818,15036,-2782
2019,11,11,17,17726,17876,14867,-3009
2019,11,11,18,17679,17891,15086,-2805
2019,11,11,19,17716,18004,15251,-2753
2019,11,11,20,17752,18127,15769,-2358
2019,11,11,21,17962,18272,15989,-2283
2019,11,11,22,18659,18885,16476,-2409
2019,11,11,23,19513,19667,17190,-2477
2019,11,12,0,19306,19478,17172,-2306
2019,11,12,1,18854,19037,16685,-2352
2019,11,12,2,18205,18372,16550,-1822
2019,11,12,3,17353,17473,16072,-1401
2019,11,12,4,16189,16297,14593,-1704
2019,11,12,5,15042,15234,13809,-1425
2019,11,12,6,14102,14469,12460,-2009
2019,11,12,7,13621,14016,12134,-1882
2019,11,12,8,13346,13731,12071,-1660
2019,11,12,9,13264,13670,11814,-1856
2019,11,12,10,13525,13931,12070,-1861
2019,11,12,11,14438,14833,13164,-1669
2019,11,12,12,16060,16440,15041,-1399
2019,11,12,13,17210,17608,15619,-1989
2019,11,12,14,17716,18316,16438,-1878
2019,11,12,15,18097,18738,16611,-2127
2019,11,12,16,18333,19051,16767,-2284
2019,11,12,17,18389,19206,16976,-2230
2019,11,12,18,18368,19255,17474,-1781
2019,11,12,19,18385,19361,17474,-1887
2019,11,12,20,18407,19404,17345,-2059
2019,11,12,21,18622,19553,17617,-1936
2019,11,12,22,19345,20130,18110,-2020
2019,11,12,23,20308,21085,18818,-2267
2019,11,13,0,20304,21017,19169,-1848
2019,11,13,1,19902,20651,18946,-1705
2019,11,13,2,19290,20086,18384,-1702
2019,11,13,3,18473,19217,17375,-1842
2019,11,13,4,17345,17961,15841,-2120
2019,11,13,5,16260,16802,14964,-1838
2019,11,13,6,15502,16063,13378,-2685
2019,11,13,7,15077,15636,13392,-2244
2019,11,13,8,14833,15366,13500,-1866
2019,11,13,9,14771,15318,13583,-1735
2019,11,13,10,15018,15659,14103,-1556
2019,11,13,11,15911,16666,14709,-1957
2019,11,13,12,17497,18387,16586,-1801
2019,11,13,13,18456,19342,18285,-1057
2019,11,13,14,18708,19572,17904,-1668
2019,11,13,15,18720,19543,17274,-2269
2019,11,13,16,18656,19433,16144,-3289
2019,11,13,17,18519,19292,15857,-3435
2019,11,13,18,18366,19100,15917,-3183
2019,11,13,19,18386,19028,19028,0
2019,11,13,20,18476,19092,15954,-3138
2019,11,13,21,18754,19502,16369,-3133
2019,11,13,22,19535,20305,16933,-3372
2019,11,13,23,20598,21324,18097,-3227
2019,11,14,0,20602,21291,18224,-3067
2019,11,14,1,20204,20881,17711,-3170
2019,11,14,2,19592,20218,16774,-3444
2019,11,14,3,18775,19339,16393,-2946
2019,11,14,4,17647,18122,15497,-2625
2019,11,14,5,16521,16972,14976,-1996
2019,11,14,6,15795,16140,14040,-2100
2019,11,14,7,15321,15682,13659,-2023
2019,11,14,8,15040,15421,13606,-1815
2019,11,14,9,14942,15371,13748,-1623
2019,11,14,10,15169,15648,14240,-1408
2019,11,14,11,16025,16621,14960,-1661
2019,11,14,12,17613,18269,16426,-1843
2019,11,14,13,18590,19150,17405,-1745
2019,11,14,14,18840,19463,17185,-2278
2019,11,14,15,18922,19597,16971,-2626
2019,11,14,16,18895,19499,17188,-2311
2019,11,14,17,18758,19325,17242,-2083
2019,11,14,18,18586,19099,16729,-2370
2019,11,14,19,18540,19077,16718,-2359
2019,11,14,20,18528,19174,16495,-2679
2019,11,14,21,18705,19353,16297,-3056
2019,11,14,22,19315,19953,16966,-2987
2019,11,14,23,20179,20631,17688,-2943
2019,11,15,0,20020,20439,17789,-2650
2019,11,15,1,19596,20004,17280,-2724
2019,11,15,2,19003,19371,16878,-2493
2019,11,15,3,18158,18448,16162,-2286
2019,11,15,4,16998,17268,15124,-2144
2019,11,15,5,15863,16088,14017,-2071
2019,11,15,6,15043,15325,13648,-1677
2019,11,15,7,14565,14847,13375,-1472
2019,11,15,8,14290,14596,13115,-1481
2019,11,15,9,14221,14558,12993,-1565
2019,11,15,10,14454,14812,13368,-1444
2019,11,15,11,15346,15750,14214,-1536
2019,11,15,12,16940,17359,15811,-1548
2019,11,15,13,17896,18328,17175,-1153
2019,11,15,14,18003,18576,17113,-1463
2019,11,15,15,17969,18550,16688,-1862
2019,11,15,16,17838,18375,16455,-1920
2019,11,15,17,17635,18194,16186,-2008
2019,11,15,18,17434,17976,15889,-2087
2019,11,15,19,17437,17996,15952,-2044
2019,11,15,20,17497,18131,16292,-1839
2019,11,15,21,17734,18392,16458,-1934
2019,11,15,22,18367,19027,17113,-1914
2019,11,15,23,19268,19690,17480,-2210
2019,11,16,0,19063,19404,16963,-2441
2019,11,16,1,18638,18916,16538,-2378
2019,11,16,2,18189,18409,16574,-1835
2019,11,16,3,17530,17703,16101,-1602
2019,11,16,4,16625,16762,14889,-1873
2019,11,16,5,15677,15812,14225,-1587
2019,11,16,6,14820,15081,13205,-1876
2019,11,16,7,14365,14642,12720,-1922
2019,11,16,8,14102,14362,12373,-1989
2019,11,16,9,14011,14298,12282,-2016
2019,11,16,10,14139,14446,12699,-1747
2019,11,16,11,14573,14916,13156,-1760
2019,11,16,12,15254,15619,13808,-1811
2019,11,16,13,15758,16235,14469,-1766
2019,11,16,14,16171,16682,14907,-1775
2019,11,16,15,16437,16851,14862,-1989
2019,11,16,16,16473,16904,14566,-2338
2019,11,16,17,16450,16833,14470,-2363
2019,11,16,18,16292,16674,14129,-2545
2019,11,16,19,16201,16592,14006,-2586
2019,11,16,20,16284,16741,14158,-2583
2019,11,16,21,16604,17133,14736,-2397
2019,11,16,22,17357,17981,15626,-2355
2019,11,16,23,18473,18997,16345,-2652
2019,11,17,0,18515,19001,16097,-2904
2019,11,17,1,18280,18740,15974,-2766
2019,11,17,2,17944,18346,15637,-2709
2019,11,17,3,17434,17796,15378,-2418
2019,11,17,4,16715,17115,14595,-2520
2019,11,17,5,15956,16354,14077,-2277
2019,11,17,6,15217,15738,13102,-2636
2019,11,17,7,14672,15276,12885,-2391
2019,11,17,8,14364,14989,12755,-2234
2019,11,17,9,14223,14854,12808,-2046
2019,11,17,10,14250,14897,13108,-1789
2019,11,17,11,14482,15153,13264,-1889
2019,11,17,12,14890,15593,13767,-1826
2019,11,17,13,15276,16064,14902,-1162
2019,11,17,14,15824,16555,15332,-1223
2019,11,17,15,16154,16772,15571,-1201
2019,11,17,16,16282,16890,15348,-1542
2019,11,17,17,16375,16919,14973,-1946
2019,11,17,18,16391,16989,15086,-1903
2019,11,17,19,16414,17056,15202,-1854
2019,11,17,20,16532,17154,15508,-1646
2019,11,17,21,16823,17509,15767,-1742
2019,11,17,22,17599,18318,16325,-1993
2019,11,17,23,18630,19196,17193,-2003
2019,11,18,0,18563,19135,17053,-2082
2019,11,18,1,18263,18823,16779,-2044
2019,11,18,2,17738,18315,16608,-1707
2019,11,18,3,16951,17489,16039,-1450
2019,11,18,4,15994,16487,14682,-1805
2019,11,18,5,15099,15505,13417,-2088
2019,11,18,6,14467,14802,12968,-1834
2019,11,18,7,14076,14411,12587,-1824
2019,11,18,8,13869,14189,12403,-1786
2019,11,18,9,13820,14117,12024,-2093
2019,11,18,10,14092,14425,12333,-2092
2019,11,18,11,14991,15383,13079,-2304
2019,11,18,12,16573,17019,14734,-2285
2019,11,18,13,17666,18132,16493,-1639
2019,11,18,14,18100,18573,16524,-2049
2019,11,18,15,18417,18856,16223,-2633
2019,11,18,16,18577,18948,16141,-2807
2019,11,18,17,18560,18919,15668,-3251
2019,11,18,18,18492,18862,15684,-3178
2019,11,18,19,18476,18851,15686,-3165
2019,11,18,20,18456,18833,15993,-2840
2019,11,18,21,18626,19019,16222,-2797
2019,11,18,22,19301,19654,16905,-2749
2019,11,18,23,20107,20307,17870,-2437
2019,11,19,0,19823,20071,17842,-2229
2019,11,19,1,19369,19637,17500,-2137
2019,11,19,2,18701,19016,16964,-2052
2019,11,19,3,17790,18082,15940,-2142
2019,11,19,4,16615,16840,14447,-2393
2019,11,19,5,15461,15656,13092,-2564
2019,11,19,6,14612,14804,11944,-2860
2019,11,19,7,14118,14367,11176,-3191
2019,11,19,8,13833,14073,11137,-2936
2019,11,19,9,13747,14044,11208,-2836
2019,11,19,10,13996,14321,11422,-2899
2019,11,19,11,14902,15233,12425,-2808
2019,11,19,12,16534,16850,14636,-2214
2019,11,19,13,17586,17894,15775,-2119
2019,11,19,14,17855,18266,15949,-2317
2019,11,19,15,17978,18397,15881,-2516
2019,11,19,16,17970,18472,15955,-2517
2019,11,19,17,17856,18410,15786,-2624
2019,11,19,18,17737,18319,15702,-2617
2019,11,19,19,17718,18290,15533,-2757
2019,11,19,20,17743,18351,15509,-2842
2019,11,19,21,17955,18576,15762,-2814
2019,11,19,22,18656,19268,16541,-2727
2019,11,19,23,19571,19932,17037,-2895
2019,11,20,0,19432,19763,17047,-2716
2019,11,20,1,19009,19305,16517,-2788
2019,11,20,2,18450,18708,16090,-2618
2019,11,20,3,17572,17834,15116,-2718
2019,11,20,4,16425,16613,13932,-2681
2019,11,20,5,15291,15501,12863,-2638
2019,11,20,6,14437,14695,11937,-2758
2019,11,20,7,13979,14253,11818,-2435
2019,11,20,8,13718,13988,11725,-2263
2019,11,20,9,13640,13902,11881,-2021
2019,11,20,10,13868,14121,11893,-2228
2019,11,20,11,14746,15038,12748,-2290
2019,11,20,12,16333,16741,14338,-2403
2019,11,20,13,17408,17920,15771,-2149
2019,11,20,14,17792,18389,15535,-2854
2019,11,20,15,18033,18635,15443,-3192
2019,11,20,16,18130,18706,15419,-3287
2019,11,20,17,18094,18713,15337,-3376
2019,11,20,18,17972,18644,15489,-3155
2019,11,20,19,17938,18545,15280,-3265
2019,11,20,20,17916,18440,15369,-3071
2019,11,20,21,18066,18590,15816,-2774
2019,11,20,22,18756,19269,16079,-3190
2019,11,20,23,19645,20051,16585,-3466
2019,11,21,0,19431,19900,16635,-3265
2019,11,21,1,18985,19492,16347,-3145
2019,11,21,2,18422,18909,15979,-2930
2019,11,21,3,17551,18031,15375,-2656
2019,11,21,4,16435,16823,14112,-2711
2019,11,21,5,15320,15723,13088,-2635
2019,11,21,6,14341,14927,12291,-2636
2019,11,21,7,13877,14475,11846,-2629
2019,11,21,8,13621,14204,11803,-2401
2019,11,21,9,13559,14136,11667,-2469
2019,11,21,10,13845,14387,11914,-2473
2019,11,21,11,14795,15324,12949,-2375
2019,11,21,12,16523,16981,14734,-2247
2019,11,21,13,17498,17987,15666,-2321
2019,11,21,14,17638,18101,15344,-2757
2019,11,21,15,17589,17942,15239,-2703
2019,11,21,16,17478,17834,14997,-2837
2019,11,21,17,17336,17683,14983,-2700
2019,11,21,18,17213,17561,14476,-3085
2019,11,21,19,17262,17602,14490,-3112
2019,11,21,20,17371,17773,14805,-2968
2019,11,21,21,17657,18106,15096,-3010
2019,11,21,22,18348,18924,15809,-3115
2019,11,21,23,19307,19673,16451,-3222
2019,11,22,0,19084,19497,16611,-2886
2019,11,22,1,18690,19083,16470,-2613
2019,11,22,2,18129,18474,15982,-2492
2019,11,22,3,17199,17520,15119,-2401
2019,11,22,4,16000,16341,13869,-2472
2019,11,22,5,14853,15268,13150,-2118
2019,11,22,6,13989,14394,12243,-2151
2019,11,22,7,13479,13841,12125,-1716
2019,11,22,8,13169,13541,12044,-1497
2019,11,22,9,13059,13430,12014,-1416
2019,11,22,10,13251,13626,12136,-1490
2019,11,22,11,14073,14558,13103,-1455
2019,11,22,12,15616,16190,14604,-1586
2019,11,22,13,16698,17364,15567,-1797
2019,11,22,14,17147,17879,15964,-1915
2019,11,22,15,17390,18111,16006,-2105
2019,11,22,16,17516,18417,16237,-2180
2019,11,22,17,17534,18579,16423,-2156
2019,11,22,18,17474,18629,16601,-2028
2019,11,22,19,17450,18697,16496,-2201
2019,11,22,20,17407,18632,16351,-2281
2019,11,22,21,17556,18711,16354,-2357
2019,11,22,22,18104,19193,16849,-2344
2019,11,22,23,18940,19729,17295,-2434
2019,11,23,0,18658,19472,17198,-2274
2019,11,23,1,18220,19058,17165,-1893
2019,11,23,2,17749,18522,16686,-1836
2019,11,23,3,17020,17781,16178,-1603
2019,11,23,4,16120,16780,14938,-1842
2019,11,23,5,15184,15813,13784,-2029
2019,11,23,6,14621,15070,12981,-2089
2019,11,23,7,14129,14567,12582,-1985
2019,11,23,8,13816,14275,12180,-2095
2019,11,23,9,13674,14132,11993,-2139
2019,11,23,10,13756,14225,11973,-2252
2019,11,23,11,14142,14642,12465,-2177
2019,11,23,12,14788,15373,13229,-2144
2019,11,23,13,15290,16025,13601,-2424
2019,11,23,14,15684,16463,14280,-2183
2019,11,23,15,15943,16656,14189,-2467
2019,11,23,16,16009,16620,14135,-2485
2019,11,23,17,16010,16439,13745,-2694
2019,11,23,18,15886,16276,13427,-2849
2019,11,23,19,15795,16274,13153,-3121
2019,11,23,20,15833,16447,13248,-3199
2019,11,23,21,16070,16824,13938,-2886
2019,11,23,22,16764,17671,15027,-2644
2019,11,23,23,17807,18403,15611,-2792
2019,11,24,0,17723,18299,15369,-2930
2019,11,24,1,17429,17980,15196,-2784
2019,11,24,2,17061,17528,14809,-2719
2019,11,24,3,16464,16908,14618,-2290
2019,11,24,4,15704,16101,13722,-2379
2019,11,24,5,14913,15244,12976,-2268
2019,11,24,6,14172,14580,12393,-2187
2019,11,24,7,13597,14071,11660,-2411
2019,11,24,8,13271,13747,11102,-2645
2019,11,24,9,13111,13575,10799,-2776
2019,11,24,10,13128,13573,11089,-2484
2019,11,24,11,13356,13859,11536,-2323
2019,11,24,12,13776,14332,11944,-2388
2019,11,24,13,14253,14900,12709,-2191
2019,11,24,14,14926,15708,13370,-2338
2019,11,24,15,15501,16455,13907,-2548
2019,11,24,16,15860,16914,14108,-2806
2019,11,24,17,16132,17215,14369,-2846
2019,11,24,18,16249,17355,14350,-3005
2019,11,24,19,16297,17319,14158,-3161
2019,11,24,20,16394,17347,14160,-3187
2019,11,24,21,16624,17525,14345,-3180
2019,11,24,22,17346,18199,14967,-3232
2019,11,24,23,18311,18962,15648,-3314
2019,11,25,0,18150,18891,15893,-2998
2019,11,25,1,17815,18559,15706,-2853
2019,11,25,2,17364,18056,15243,-2813
2019,11,25,3,16532,17289,14494,-2795
2019,11,25,4,15571,16263,13300,-2963
2019,11,25,5,14671,15255,12791,-2464
2019,11,25,6,13938,14476,11821,-2655
2019,11,25,7,13514,14014,11549,-2465
2019,11,25,8,13288,13773,11426,-2347
2019,11,25,9,13237,13749,11630,-2119
2019,11,25,10,13535,14029,11636,-2393
2019,11,25,11,14502,14968,12828,-2140
2019,11,25,12,16223,16698,14354,-2344
2019,11,25,13,17318,17776,15672,-2104
2019,11,25,14,17619,18030,15594,-2436
2019,11,25,15,17733,18040,15243,-2797
2019,11,25,16,17738,17959,15098,-2861
2019,11,25,17,17642,17768,14461,-3307
2019,11,25,18,17548,17647,13844,-3803
2019,11,25,19,17571,17677,13896,-3781
2019,11,25,20,17603,17814,14327,-3487
2019,11,25,21,17841,17992,14750,-3242
2019,11,25,22,18578,18724,15581,-3143
2019,11,25,23,19600,19529,16380,-3149
2019,11,26,0,19403,19418,16533,-2885
2019,11,26,1,18975,19052,16329,-2723
2019,11,26,2,18395,18462,16026,-2436
2019,11,26,3,17381,17646,15319,-2327
2019,11,26,4,16134,16458,13790,-2668
2019,11,26,5,14924,15315,12966,-2349
2019,11,26,6,14064,14532,11934,-2598
2019,11,26,7,13558,14039,11607,-2432
2019,11,26,8,13268,13766,11676,-2090
2019,11,26,9,13182,13730,12108,-1622
2019,11,26,10,13449,13961,12229,-1732
2019,11,26,11,14404,14896,12571,-2325
2019,11,26,12,16151,16595,13921,-2674
2019,11,26,13,17199,17672,15263,-2409
2019,11,26,14,17412,17829,15164,-2665
2019,11,26,15,17404,17626,15398,-2228
2019,11,26,16,17326,17390,15087,-2303
2019,11,26,17,17200,17271,15248,-2023
2019,11,26,18,17093,17128,14754,-2374
2019,11,26,19,17122,17082,14456,-2626
2019,11,26,20,17184,17159,14304,-2855
2019,11,26,21,17412,17461,14745,-2716
2019,11,26,22,18121,18231,15591,-2640
2019,11,26,23,19177,19027,16559,-2468
2019,11,27,0,19022,18874,16240,-2634
2019,11,27,1,18637,18562,16031,-2531
2019,11,27,2,18107,18109,15668,-2441
2019,11,27,3,17122,17308,14681,-2627
2019,11,27,4,15919,16241,13519,-2722
2019,11,27,5,14747,15179,12179,-3000
2019,11,27,6,13906,14326,11416,-2910
2019,11,27,7,13444,13827,11326,-2501
2019,11,27,8,13185,13577,11404,-2173
2019,11,27,9,13104,13496,11578,-1918
2019,11,27,10,13322,13689,11698,-1991
2019,11,27,11,14184,14464,12043,-2421
2019,11,27,12,15788,15911,13499,-2412
2019,11,27,13,16856,17154,14806,-2348
2019,11,27,14,17246,17817,15243,-2574
2019,11,27,15,17484,18127,15355,-2772
2019,11,27,16,17603,18186,15440,-2746
2019,11,27,17,17607,18262,15691,-2571
2019,11,27,18,17522,18157,15775,-2382
2019,11,27,19,17525,18097,15650,-2447
2019,11,27,20,17510,18059,15680,-2379
2019,11,27,21,17632,18135,15606,-2529
2019,11,27,22,18259,18648,15923,-2725
2019,11,27,23,19089,19112,15996,-3116
2019,11,28,0,18785,18822,15969,-2853
2019,11,28,1,18315,18279,15914,-2365
2019,11,28,2,17783,17687,15760,-1927
2019,11,28,3,16835,16921,15078,-1843
2019,11,28,4,15698,15935,14411,-1524
2019,11,28,5,14580,14929,13222,-1707
2019,11,28,6,13720,14121,11883,-2238
2019,11,28,7,13139,13545,11397,-2148
2019,11,28,8,12775,13207,11139,-2068
2019,11,28,9,12607,13040,11120,-1920
2019,11,28,10,12646,13103,11322,-1781
2019,11,28,11,12989,13442,11667,-1775
2019,11,28,12,13533,14057,12251,-1806
2019,11,28,13,14039,14708,13167,-1541
2019,11,28,14,14700,15564,13663,-1901
2019,11,28,15,15358,16259,14275,-1984
2019,11,28,16,15824,16736,14487,-2249
2019,11,28,17,16145,17133,14914,-2219
2019,11,28,18,16127,17215,15281,-1934
2019,11,28,19,15880,16977,14999,-1978
2019,11,28,20,15587,16606,14390,-2216
2019,11,28,21,15420,16335,14222,-2113
2019,11,28,22,15635,16544,14351,-2193
2019,11,28,23,15954,16707,14721,-1986
2019,11,29,0,15735,16479,14340,-2139
2019,11,29,1,15558,16325,14226,-2099
2019,11,29,2,15466,16231,14211,-2020
2019,11,29,3,15234,15992,13944,-2048
2019,11,29,4,14812,15527,13503,-2024
2019,11,29,5,14269,14911,12949,-1962
2019,11,29,6,13686,14402,12246,-2156
2019,11,29,7,13279,13999,11927,-2072
2019,11,29,8,13028,13811,12013,-1798
2019,11,29,9,12956,13747,12163,-1584
2019,11,29,10,13141,13929,12298,-1631
2019,11,29,11,13711,14509,12784,-1725
2019,11,29,12,14590,15370,13439,-1931
2019,11,29,13,15231,16107,14584,-1523
2019,11,29,14,15729,16727,14940,-1787
2019,11,29,15,16050,17042,15139,-1903
2019,11,29,16,16162,17208,15062,-2146
2019,11,29,17,16177,17310,14726,-2584
2019,11,29,18,16111,17169,14441,-2728
2019,11,29,19,16063,17106,14457,-2649
2019,11,29,20,16130,17213,14669,-2544
2019,11,29,21,16420,17559,14862,-2697
2019,11,29,22,17312,18388,15675,-2713
2019,11,29,23,18341,19092,16314,-2778
2019,11,30,0,18252,18910,16458,-2452
2019,11,30,1,17911,18575,16255,-2320
2019,11,30,2,17516,18168,15631,-2537
2019,11,30,3,16927,17568,15067,-2501
2019,11,30,4,16148,16769,14394,-2375
2019,11,30,5,15268,15860,13361,-2499
2019,11,30,6,14604,15050,13117,-1933
2019,11,30,7,14109,14573,12372,-2201
2019,11,30,8,13824,14287,12188,-2099
2019,11,30,9,13706,14150,12184,-1966
2019,11,30,10,13818,14254,12363,-1891
2019,11,30,11,14193,14624,12461,-2163
2019,11,30,12,14773,15268,13151,-2117
2019,11,30,13,15288,15879,14250,-1629
2019,11,30,14,15879,16407,14393,-2014
2019,11,30,15,16158,16638,14201,-2437
2019,11,30,16,16207,16647,13823,-2824
2019,11,30,17,16126,16611,13869,-2742
2019,11,30,18,15996,16475,13850,-2625
2019,11,30,19,15899,16401,13777,-2624
2019,11,30,20,15941,16577,13823,-2754
2019,11,30,21,16225,17038,14299,-2739
2019,11,30,22,17047,18016,14921,-3095
2019,11,30,23,18252,18869,15587,-3282
2019,12,1,0,18286,18864,15758,-3106
2019,12,1,1,18043,18674,15717,-2957
2019,12,1,2,17748,18360,15577,-2783
2019,12,1,3,17146,17899,14903,-2996
2019,12,1,4,16394,17166,13984,-3182
2019,12,1,5,15613,16356,13089,-3267
2019,12,1,6,15231,15610,12333,-3277
2019,12,1,7,14757,15089,12312,-2777
2019,12,1,8,14448,14765,12226,-2539
2019,12,1,9,14296,14627,12277,-2350
2019,12,1,10,14323,14637,12401,-2236
2019,12,1,11,14610,14941,12766,-2175
2019,12,1,12,15167,15445,12868,-2577
2019,12,1,13,15600,15996,13704,-2292
2019,12,1,14,16186,16740,14356,-2384
2019,12,1,15,16757,17492,14776,-2716
2019,12,1,16,17134,18073,15335,-2738
2019,12,1,17,17349,18537,15696,-2841
2019,12,1,18,17460,18881,15695,-3186
2019,12,1,19,17499,19128,15985,-3143
2019,12,1,20,17507,19299,16197,-3102
2019,12,1,21,17703,19392,16146,-3246
2019,12,1,22,18528,19973,17556,-2417
2019,12,1,23,19571,20399,18444,-1955
2019,12,2,0,19499,20099,17767,-2332
2019,12,2,1,19120,19678,16964,-2714
2019,12,2,2,18637,19050,16161,-2889
2019,12,2,3,17838,18220,15549,-2671
2019,12,2,4,16764,17170,14460,-2710
2019,12,2,5,15695,16108,13953,-2155
2019,12,2,6,14647,15392,13370,-2022
2019,12,2,7,14156,14930,12991,-1939
2019,12,2,8,13906,14694,12712,-1982
2019,12,2,9,13843,14631,12744,-1887
2019,12,2,10,14114,14872,12865,-2007
2019,12,2,11,15034,15709,13601,-2108
2019,12,2,12,16751,17200,14919,-2281
2019,12,2,13,18018,18375,16455,-1920
2019,12,2,14,18512,19060,16818,-2242
2019,12,2,15,18838,19559,17121,-2438
2019,12,2,16,19001,19919,17374,-2545
2019,12,2,17,19010,20067,17547,-2520
2019,12,2,18,18919,20145,17227,-2918
2019,12,2,19,18921,20190,17046,-3144
2019,12,2,20,18909,20173,16737,-3436
2019,12,2,21,19103,20303,17152,-3151
2019,12,2,22,19969,21006,17546,-3460
2019,12,2,23,20998,21653,17795,-3858
2019,12,3,0,20967,21432,17922,-3510
2019,12,3,1,20501,20950,17846,-3104
2019,12,3,2,19887,20271,17702,-2569
2019,12,3,3,18965,19324,16926,-2398
2019,12,3,4,17678,18036,15666,-2370
2019,12,3,5,16336,16779,14394,-2385
2019,12,3,6,15351,15971,13531,-2440
2019,12,3,7,14781,15477,13072,-2405
2019,12,3,8,14483,15228,13003,-2225
2019,12,3,9,14413,15135,13004,-2131
2019,12,3,10,14681,15413,13323,-2090
2019,12,3,11,15638,16375,14143,-2232
2019,12,3,12,17473,17971,15647,-2324
2019,12,3,13,18718,19081,16419,-2662
2019,12,3,14,18960,19554,16664,-2890
2019,12,3,15,18970,19680,16771,-2909
2019,12,3,16,18835,19612,16619,-2993
2019,12,3,17,18631,19441,16124,-3317
2019,12,3,18,18435,19243,15682,-3561
2019,12,3,19,18404,19146,15906,-3240
2019,12,3,20,18466,19140,15716,-3424
2019,12,3,21,18757,19413,16285,-3128
2019,12,3,22,19689,20391,17084,-3307
2019,12,3,23,20962,21345,18165,-3180
2019,12,4,0,20973,21258,20245,-1013
2019,12,4,1,20633,20903,17837,-3066
2019,12,4,2,20049,20279,17471,-2808
2019,12,4,3,19113,19358,16708,-2650
2019,12,4,4,17795,18038,15693,-2345
2019,12,4,5,16425,16767,14559,-2208
2019,12,4,6,15426,15859,13489,-2370
2019,12,4,7,14864,15328,12817,-2511
2019,12,4,8,14557,15046,12576,-2470
2019,12,4,9,14454,14944,12526,-2418
2019,12,4,10,14676,15143,12670,-2473
2019,12,4,11,15547,16056,13573,-2483
2019,12,4,12,17252,17736,15061,-2675
2019,12,4,13,18450,18942,16341,-2601
2019,12,4,14,18728,19394,16210,-3184
2019,12,4,15,18874,19616,16661,-2955
2019,12,4,16,18884,19681,16524,-3157
2019,12,4,17,18805,19723,16432,-3291
2019,12,4,18,18672,19708,16128,-3580
2019,12,4,19,18668,19702,15964,-3738
2019,12,4,20,18679,19593,15905,-3688
2019,12,4,21,18908,19657,15937,-3720
2019,12,4,22,19750,20405,16560,-3845
2019,12,4,23,20737,21128,17181,-3947
2019,12,5,0,20526,20937,17031,-3906
2019,12,5,1,20128,20529,16863,-3666
2019,12,5,2,19512,19936,16553,-3383
2019,12,5,3,18631,19037,15718,-3319
2019,12,5,4,17392,17698,14811,-2887
2019,12,5,5,16103,16443,13735,-2708
2019,12,5,6,15110,15540,12919,-2621
2019,12,5,7,14577,15014,12303,-2711
2019,12,5,8,14286,14707,12227,-2480
2019,12,5,9,14206,14638,12146,-2492
2019,12,5,10,14456,14870,12631,-2239
2019,12,5,11,15355,15783,13476,-2307
2019,12,5,12,17075,17523,15072,-2451
2019,12,5,13,18243,18679,16204,-2475
2019,12,5,14,18443,18969,16283,-2686
2019,12,5,15,18539,19063,16006,-3057
2019,12,5,16,18508,19107,16159,-2948
2019,12,5,17,18432,19175,16323,-2852
2019,12,5,18,18335,19079,16455,-2624
2019,12,5,19,18355,19191,16498,-2693
2019,12,5,20,18409,19328,16469,-2859
2019,12,5,21,18686,19627,16405,-3222
2019,12,5,22,19582,20456,16847,-3609
2019,12,5,23,20674,21166,17825,-3341
2019,12,6,0,20570,21017,17798,-3219
2019,12,6,1,20184,20636,17624,-3012
2019,12,6,2,19669,20144,17362,-2782
2019,12,6,3,18822,19224,16435,-2789
2019,12,6,4,17614,17993,15031,-2962
2019,12,6,5,16367,16715,13829,-2886
2019,12,6,6,15401,15821,13313,-2508
2019,12,6,7,14856,15272,13015,-2257
2019,12,6,8,14547,14970,12861,-2109
2019,12,6,9,14454,14879,12821,-2058
2019,12,6,10,14685,15116,13015,-2101
2019,12,6,11,15578,15962,13481,-2481
2019,12,6,12,17286,17565,14838,-2727
2019,12,6,13,18462,18687,15884,-2803
2019,12,6,14,18739,19083,15901,-3182
2019,12,6,15,18905,19256,16042,-3214
2019,12,6,16,18904,19364,15897,-3467
2019,12,6,17,18778,19507,16074,-3433
2019,12,6,18,18583,19473,16013,-3460
2019,12,6,19,18521,19435,16079,-3356
2019,12,6,20,18472,19372,16272,-3100
2019,12,6,21,18641,19482,16897,-2585
2019,12,6,22,19436,20045,17469,-2576
2019,12,6,23,20313,20459,17345,-3114
2019,12,7,0,20101,20207,17115,-3092
2019,12,7,1,19626,19796,16853,-2943
2019,12,7,2,19113,19319,16685,-2634
2019,12,7,3,18393,18680,16012,-2668
2019,12,7,4,17388,17700,15150,-2550
2019,12,7,5,16260,16603,14238,-2365
2019,12,7,6,15319,15787,13949,-1838
2019,12,7,7,14751,15264,13322,-1942
2019,12,7,8,14422,14980,12808,-2172
2019,12,7,9,14293,14850,12869,-1981
2019,12,7,10,14397,14898,12872,-2026
2019,12,7,11,14818,15293,13395,-1898
2019,12,7,12,15617,16023,14215,-1808
2019,12,7,13,16270,16764,14820,-1944
2019,12,7,14,16772,17465,15448,-2017
2019,12,7,15,17155,17793,15686,-2107
2019,12,7,16,17301,17902,15352,-2550
2019,12,7,17,17339,17794,15118,-2676
2019,12,7,18,17242,17696,15496,-2200
2019,12,7,19,17154,17616,15303,-2313
2019,12,7,20,17185,17667,15131,-2536
2019,12,7,21,17425,17959,15399,-2560
2019,12,7,22,18294,18865,16088,-2777
2019,12,7,23,19503,19808,16975,-2833
2019,12,8,0,19571,19787,17104,-2683
2019,12,8,1,19356,19542,16680,-2862
2019,12,8,2,19010,19242,16598,-2644
2019,12,8,3,18423,18786,16152,-2634
2019,12,8,4,17601,18013,15453,-2560
2019,12,8,5,16688,17136,14360,-2776
2019,12,8,6,15966,16339,13574,-2765
2019,12,8,7,15403,15841,13434,-2407
2019,12,8,8,15043,15528,13210,-2318
2019,12,8,9,14850,15370,12962,-2408
2019,12,8,10,14862,15407,13105,-2302
2019,12,8,11,15125,15658,13539,-2119
2019,12,8,12,15662,16194,14135,-2059
2019,12,8,13,16075,16648,14642,-2006
2019,12,8,14,16476,17239,15050,-2189
2019,12,8,15,16778,17563,15483,-2080
2019,12,8,16,16922,17607,15671,-1936
2019,12,8,17,16991,17619,15725,-1894
2019,12,8,18,17007,17671,15597,-2074
2019,12,8,19,17029,17705,15322,-2383
2019,12,8,20,17070,17768,15641,-2127
2019,12,8,21,17327,18032,16196,-1836
2019,12,8,22,18242,19035,16845,-2190
2019,12,8,23,19366,19979,17745,-2234
2019,12,9,0,19299,19918,17680,-2238
2019,12,9,1,19036,19608,17401,-2207
2019,12,9,2,18574,19102,17058,-2044
2019,12,9,3,17783,18213,16418,-1795
2019,12,9,4,16681,17059,15611,-1448
2019,12,9,5,15570,15869,14675,-1194
2019,12,9,6,14776,15022,13601,-1421
2019,12,9,7,14249,14512,13179,-1333
2019,12,9,8,13975,14237,13013,-1224
2019,12,9,9,13885,14152,13117,-1035
2019,12,9,10,14113,14407,13371,-1036
2019,12,9,11,14955,15330,14259,-1071
2019,12,9,12,16549,17012,15351,-1661
2019,12,9,13,17740,18318,16607,-1711
2019,12,9,14,18184,18858,16759,-2099
2019,12,9,15,18465,19223,17028,-2195
2019,12,9,16,18617,19305,17272,-2033
2019,12,9,17,18596,19229,17233,-1996
2019,12,9,18,18503,19155,16497,-2658
2019,12,9,19,18490,19124,16246,-2878
2019,12,9,20,18445,19088,16463,-2625
2019,12,9,21,18594,19232,16807,-2425
2019,12,9,22,19377,19988,17512,-2476
2019,12,9,23,20143,20586,18033,-2553
2019,12,10,0,19869,20387,18037,-2350
2019,12,10,1,19405,19807,17716,-2091
2019,12,10,2,18813,19211,17189,-2022
2019,12,10,3,17907,18194,16168,-2026
2019,12,10,4,16667,16849,14568,-2281
2019,12,10,5,15362,15533,13623,-1910
2019,12,10,6,14164,14577,12965,-1612
2019,12,10,7,13530,13993,12552,-1441
2019,12,10,8,13179,13665,12157,-1508
2019,12,10,9,13048,13531,12133,-1398
2019,12,10,10,13249,13756,12586,-1170
2019,12,10,11,14115,14615,13315,-1300
2019,12,10,12,15807,16327,14932,-1395
2019,12,10,13,17095,17560,16345,-1215
2019,12,10,14,17504,18035,16355,-1680
2019,12,10,15,17797,18314,16342,-1972
2019,12,10,16,17975,18547,16446,-2101
2019,12,10,17,18009,18684,16806,-1878
2019,12,10,18,17981,18715,16668,-2047
2019,12,10,19,18023,18778,16705,-2073
2019,12,10,20,18042,18757,16740,-2017
2019,12,10,21,18257,18951,16703,-2248
2019,12,10,22,19123,19770,17240,-2530
2019,12,10,23,20073,20345,17435,-2910
2019,12,11,0,19936,20195,17461,-2734
2019,12,11,1,19467,19813,17293,-2520
2019,12,11,2,18881,19271,16946,-2325
2019,12,11,3,18017,18434,16255,-2179
2019,12,11,4,16806,17233,15224,-2009
2019,12,11,5,15547,16051,14144,-1907
2019,12,11,6,14636,15205,13403,-1802
2019,12,11,7,14116,14764,12841,-1923
2019,12,11,8,13836,14579,12250,-2329
2019,12,11,9,13773,14542,12356,-2186
2019,12,11,10,14053,14885,12738,-2147
2019,12,11,11,15000,15875,13991,-1884
2019,12,11,12,16803,17628,15424,-2204
2019,12,11,13,18137,18964,17084,-1880
2019,12,11,14,18488,19506,17340,-2166
2019,12,11,15,18704,19762,17294,-2468
2019,12,11,16,18734,19689,17388,-2301
2019,12,11,17,18677,19572,17354,-2218
2019,12,11,18,18557,19372,16948,-2424
2019,12,11,19,18556,19356,16963,-2393
2019,12,11,20,18599,19419,17206,-2213
2019,12,11,21,18883,19711,17515,-2196
2019,12,11,22,19850,20655,18511,-2144
2019,12,11,23,20970,21641,19706,-1935
2019,12,12,0,20889,21523,19528,-1995
2019,12,12,1,20541,21171,19152,-2019
2019,12,12,2,20015,20671,18709,-1962
2019,12,12,3,19139,19860,18038,-1822
2019,12,12,4,17865,18616,16883,-1733
2019,12,12,5,16531,17321,15443,-1878
2019,12,12,6,15640,16460,14223,-2237
2019,12,12,7,15107,15908,13631,-2277
2019,12,12,8,14838,15650,13217,-2433
2019,12,12,9,14784,15643,13119,-2524
2019,12,12,10,15081,15923,13328,-2595
2019,12,12,11,16032,16932,14209,-2723
2019,12,12,12,17786,18702,16112,-2590
2019,12,12,13,18959,19830,17716,-2114
2019,12,12,14,19183,20073,17312,-2761
2019,12,12,15,19148,20006,17060,-2946
2019,12,12,16,19020,19762,16950,-2812
2019,12,12,17,18852,19571,16268,-3303
2019,12,12,18,18692,19334,15897,-3437
2019,12,12,19,18708,19394,15740,-3654
2019,12,12,20,18785,19521,15885,-3636
2019,12,12,21,19095,19830,16310,-3520
2019,12,12,22,20047,20712,17154,-3558
2019,12,12,23,21192,21748,18050,-3698
2019,12,13,0,21095,21595,18328,-3267
2019,12,13,1,20754,21158,18207,-2951
2019,12,13,2,20191,20634,18262,-2372
2019,12,13,3,19294,19813,17227,-2586
2019,12,13,4,18017,18584,16132,-2452
2019,12,13,5,16691,17200,14790,-2410
2019,12,13,6,15729,16267,14079,-2188
2019,12,13,7,15138,15687,13663,-2024
2019,12,13,8,14803,15387,13522,-1865
2019,12,13,9,14684,15258,13274,-1984
2019,12,13,10,14882,15472,13641,-1831
2019,12,13,11,15717,16349,14305,-2044
2019,12,13,12,17309,17970,16088,-1882
2019,12,13,13,18462,19151,17477,-1674
2019,12,13,14,18746,19473,17623,-1850
2019,12,13,15,18902,19555,17346,-2209
2019,12,13,16,18909,19571,17074,-2497
2019,12,13,17,18804,19561,17217,-2344
2019,12,13,18,18643,19435,17201,-2234
2019,12,13,19,18598,19451,17226,-2225
2019,12,13,20,18551,19427,17195,-2232
2019,12,13,21,18692,19592,17071,-2521
2019,12,13,22,19462,20243,17575,-2668
2019,12,13,23,20151,20578,17774,-2804
2019,12,14,0,19705,20238,17319,-2919
2019,12,14,1,19241,19756,17098,-2658
2019,12,14,2,18680,19154,16822,-2332
2019,12,14,3,17930,18415,16066,-2349
2019,12,14,4,16901,17369,14967,-2402
2019,12,14,5,15760,16233,13775,-2458
2019,12,14,6,14895,15270,12961,-2309
2019,12,14,7,14240,14580,12284,-2296
2019,12,14,8,13831,14179,12012,-2167
2019,12,14,9,13613,13965,11822,-2143
2019,12,14,10,13610,13931,11834,-2097
2019,12,14,11,13898,14277,12511,-1766
2019,12,14,12,14492,14977,13268,-1709
2019,12,14,13,15157,15793,14159,-1634
2019,12,14,14,15790,16559,14873,-1686
2019,12,14,15,16440,17127,15109,-2018
2019,12,14,16,16820,17346,15346,-2000
2019,12,14,17,17060,17420,15027,-2393
2019,12,14,18,17026,17411,15267,-2144
2019,12,14,19,16914,17437,15176,-2261
2019,12,14,20,16859,17500,15205,-2295
2019,12,14,21,16952,17717,15547,-2170
2019,12,14,22,17674,18334,15887,-2447
2019,12,14,23,18435,18803,16246,-2557
2019,12,15,0,18300,18678,16288,-2390
2019,12,15,1,17885,18359,16125,-2234
2019,12,15,2,17497,17965,15854,-2111
2019,12,15,3,16949,17451,15391,-2060
2019,12,15,4,16187,16678,14949,-1729
2019,12,15,5,15306,15832,14354,-1478
2019,12,15,6,14504,15023,13599,-1424
2019,12,15,7,13875,14445,13138,-1307
2019,12,15,8,13482,14075,12665,-1410
2019,12,15,9,13290,13868,12505,-1363
2019,12,15,10,13304,13855,12500,-1355
2019,12,15,11,13583,14101,13241,-860
2019,12,15,12,14123,14609,13478,-1131
2019,12,15,13,14658,15242,14148,-1094
2019,12,15,14,15188,15986,14919,-1067
2019,12,15,15,15740,16579,15410,-1169
2019,12,15,16,16081,16908,15208,-1700
2019,12,15,17,16332,17176,15233,-1943
2019,12,15,18,16473,17266,15234,-2032
2019,12,15,19,16579,17258,14992,-2266
2019,12,15,20,16718,17344,15201,-2143
2019,12,15,21,17033,17750,15721,-2029
2019,12,15,22,18067,18790,16622,-2168
2019,12,15,23,19256,19799,17452,-2347
2019,12,16,0,19279,19804,17587,-2217
2019,12,16,1,19017,19612,17334,-2278
2019,12,16,2,18661,19258,16952,-2306
2019,12,16,3,17954,18493,15927,-2566
2019,12,16,4,16924,17488,14926,-2562
2019,12,16,5,15852,16365,14206,-2159
2019,12,16,6,14987,15517,13392,-2125
2019,12,16,7,14506,15070,12989,-2081
2019,12,16,8,14261,14830,12716,-2114
2019,12,16,9,14206,14807,12601,-2206
2019,12,16,10,14498,15097,12885,-2212
2019,12,16,11,15436,16055,13719,-2336
2019,12,16,12,17137,17771,15622,-2149
2019,12,16,13,18440,19056,16965,-2091
2019,12,16,14,18803,19627,17551,-2076
2019,12,16,15,19007,19763,17298,-2465
2019,12,16,16,19083,19833,17179,-2654
2019,12,16,17,19013,19704,16734,-2970
2019,12,16,18,18904,19479,16452,-3027
2019,12,16,19,18903,19427,16424,-3003
2019,12,16,20,18926,19407,16365,-3042
2019,12,16,21,19153,19676,16617,-3059
2019,12,16,22,20131,20600,17582,-3018
2019,12,16,23,21120,21457,18542,-2915
2019,12,17,0,20988,21308,18051,-3257
2019,12,17,1,20605,20949,17888,-3061
2019,12,17,2,20036,20397,17573,-2824
2019,12,17,3,19128,19521,17006,-2515
2019,12,17,4,17827,18209,15697,-2512
2019,12,17,5,16447,16924,14462,-2462
2019,12,17,6,15425,15964,13630,-2334
2019,12,17,7,14807,15437,13181,-2256
2019,12,17,8,14473,15163,12979,-2184
2019,12,17,9,14356,15084,12832,-2252
2019,12,17,10,14586,15384,13344,-2040
2019,12,17,11,15465,16259,14379,-1880
2019,12,17,12,17126,17844,15601,-2243
2019,12,17,13,18438,19214,17377,-1837
2019,12,17,14,18910,19775,17517,-2258
2019,12,17,15,19218,20151,17360,-2791
2019,12,17,16,19391,20384,17452,-2932
2019,12,17,17,19394,20516,17444,-3072
2019,12,17,18,19299,20483,17074,-3409
2019,12,17,19,19271,20475,16967,-3508
2019,12,17,20,19233,20440,17225,-3215
2019,12,17,21,19404,20566,17268,-3298
2019,12,17,22,20327,21278,17850,-3428
2019,12,17,23,21235,21928,18556,-3372
2019,12,18,0,21039,21695,18418,-3277
2019,12,18,1,20580,21207,17770,-3437
2019,12,18,2,19988,20592,17626,-2966
2019,12,18,3,19100,19702,16846,-2856
2019,12,18,4,17834,18433,15577,-2856
2019,12,18,5,16502,17148,14537,-2611
2019,12,18,6,15573,16137,13045,-3092
2019,12,18,7,14980,15558,12403,-3155
2019,12,18,8,14666,15294,12233,-3061
2019,12,18,9,14581,15231,12260,-2971
2019,12,18,10,14847,15525,12555,-2970
2019,12,18,11,15779,16490,13315,-3175
2019,12,18,12,17540,18210,15144,-3066
2019,12,18,13,18818,19364,16820,-2544
2019,12,18,14,19093,19614,16713,-2901
2019,12,18,15,19170,19565,16441,-3124
2019,12,18,16,19170,19496,15897,-3599
2019,12,18,17,19097,19494,15599,-3895
2019,12,18,18,19039,19628,15846,-3782
2019,12,18,19,19103,19910,16241,-3669
2019,12,18,20,19189,19924,16205,-3719
2019,12,18,21,19509,20191,16409,-3782
2019,12,18,22,20564,21247,17340,-3907
2019,12,18,23,21736,22323,18784,-3539
2019,12,19,0,21789,22293,19146,-3147
2019,12,19,1,21475,22012,18940,-3072
2019,12,19,2,20999,21585,18052,-3533
2019,12,19,3,20199,20849,17374,-3475
2019,12,19,4,18965,19717,16392,-3325
2019,12,19,5,17640,18518,15548,-2970
2019,12,19,6,16920,17665,14797,-2868
2019,12,19,7,16402,17180,14635,-2545
2019,12,19,8,16124,16923,14667,-2256
2019,12,19,9,16066,16924,14578,-2346
2019,12,19,10,16342,17215,14368,-2847
2019,12,19,11,17238,18129,14362,-3767
2019,12,19,12,18903,19842,16409,-3433
2019,12,19,13,20140,21048,18123,-2925
2019,12,19,14,20383,21401,18234,-3167
2019,12,19,15,20502,21458,17905,-3553
2019,12,19,16,20482,21353,17435,-3918
2019,12,19,17,20358,21194,17197,-3997
2019,12,19,18,20224,21008,17004,-4004
2019,12,19,19,20217,20954,16852,-4102
2019,12,19,20,20257,20983,17062,-3921
2019,12,19,21,20522,21318,17504,-3814
2019,12,19,22,21496,22201,18716,-3485
2019,12,19,23,22585,23253,19571,-3682
2019,12,20,0,22500,23173,19322,-3851
2019,12,20,1,22157,22836,19287,-3549
2019,12,20,2,21662,22278,18982,-3296
2019,12,20,3,20800,21439,17892,-3547
2019,12,20,4,19535,20190,17060,-3130
2019,12,20,5,18217,18808,15759,-3049
2019,12,20,6,17132,17841,15268,-2573
2019,12,20,7,16493,17222,14477,-2745
2019,12,20,8,16156,16880,14051,-2829
2019,12,20,9,16056,16739,13467,-3272
2019,12,20,10,16294,16979,13545,-3434
2019,12,20,11,17185,17920,14754,-3166
2019,12,20,12,18856,19502,16708,-2794
2019,12,20,13,20065,20654,17918,-2736
2019,12,20,14,20251,20966,17686,-3280
2019,12,20,15,20208,21015,17044,-3971
2019,12,20,16,20003,20790,16195,-4595
2019,12,20,17,19697,20529,16054,-4475
2019,12,20,18,19441,20202,15960,-4242
2019,12,20,19,19338,20035,15639,-4396
2019,12,20,20,19293,20003,15817,-4186
2019,12,20,21,19521,20292,15842,-4450
2019,12,20,22,20434,21262,16978,-4284
2019,12,20,23,21541,22236,17975,-4261
2019,12,21,0,21469,22075,17593,-4482
2019,12,21,1,21183,21751,17146,-4605
2019,12,21,2,20726,21326,16592,-4734
2019,12,21,3,20073,20703,16159,-4544
2019,12,21,4,19090,19686,15496,-4190
2019,12,21,5,17945,18611,14764,-3847
2019,12,21,6,17171,17663,13861,-3802
2019,12,21,7,16535,17037,13802,-3235
2019,12,21,8,16148,16678,13469,-3209
2019,12,21,9,15941,16455,13374,-3081
2019,12,21,10,15955,16489,13641,-2848
2019,12,21,11,16204,16824,13760,-3064
2019,12,21,12,16747,17468,14528,-2940
2019,12,21,13,17417,18294,16007,-2287
2019,12,21,14,17994,18954,16232,-2722
2019,12,21,15,18440,19439,16562,-2877
2019,12,21,16,18570,19495,16148,-3347
2019,12,21,17,18654,19376,15951,-3425
2019,12,21,18,18441,19058,15557,-3501
2019,12,21,19,18207,18815,15059,-3756
2019,12,21,20,18111,18753,15213,-3540
2019,12,21,21,18243,18903,15422,-3481
2019,12,21,22,18982,19602,15967,-3635
2019,12,21,23,19964,20499,16724,-3775
2019,12,22,0,19873,20455,16372,-4083
2019,12,22,1,19669,20190,16391,-3799
2019,12,22,2,19298,19874,16242,-3632
2019,12,22,3,18774,19300,16033,-3267
2019,12,22,4,18026,18498,15424,-3074
2019,12,22,5,17147,17551,14912,-2639
2019,12,22,6,16405,16688,14223,-2465
2019,12,22,7,15745,16072,14097,-1975
2019,12,22,8,15337,15708,13705,-2003
2019,12,22,9,15108,15545,13446,-2099
2019,12,22,10,15088,15536,13453,-2083
2019,12,22,11,15281,15748,13792,-1956
2019,12,22,12,15673,16226,14161,-2065
2019,12,22,13,16114,16842,15137,-1705
2019,12,22,14,16486,17441,15788,-1653
2019,12,22,15,16779,17634,15783,-1851
2019,12,22,16,16824,17570,15990,-1580
2019,12,22,17,16878,17400,15753,-1647
2019,12,22,18,16782,17227,15444,-1783
2019,12,22,19,16731,17139,15200,-1939
2019,12,22,20,16806,17206,15414,-1792
2019,12,22,21,17117,17478,15424,-2054
2019,12,22,22,18078,18463,16141,-2322
2019,12,22,23,19294,19587,17141,-2446
2019,12,23,0,19322,19561,17038,-2523
2019,12,23,1,19175,19305,17114,-2191
2019,12,23,2,18891,18975,16817,-2158
2019,12,23,3,18256,18394,16197,-2197
2019,12,23,4,17297,17435,15646,-1789
2019,12,23,5,16265,16344,14786,-1558
2019,12,23,6,15442,15434,13784,-1650
2019,12,23,7,14891,14881,13514,-1367
2019,12,23,8,14614,14608,13062,-1546
2019,12,23,9,14536,14531,12945,-1586
2019,12,23,10,14803,14788,13429,-1359
2019,12,23,11,15659,15549,13967,-1582
2019,12,23,12,17260,16901,15386,-1515
2019,12,23,13,18489,17997,16554,-1443
2019,12,23,14,18696,18502,16938,-1564
2019,12,23,15,18674,18489,16957,-1532
2019,12,23,16,18484,18228,16690,-1538
2019,12,23,17,18155,17944,15990,-1954
2019,12,23,18,17902,17727,15772,-1955
2019,12,23,19,17806,17688,15702,-1986
2019,12,23,20,17817,17773,16300,-1473
2019,12,23,21,18079,18073,16511,-1562
2019,12,23,22,18929,18926,17108,-1818
2019,12,23,23,20084,19892,17984,-1908
2019,12,24,0,20072,19708,17802,-1906
2019,12,24,1,19882,19385,17577,-1808
2019,12,24,2,19486,18967,17357,-1610
2019,12,24,3,18761,18318,17058,-1260
2019,12,24,4,17656,17334,16047,-1287
2019,12,24,5,16387,16160,14891,-1269
2019,12,24,6,15162,15116,13345,-1771
2019,12,24,7,14463,14475,12922,-1553
2019,12,24,8,14081,14142,12502,-1640
2019,12,24,9,13930,14031,12565,-1466
2019,12,24,10,14060,14185,12619,-1566
2019,12,24,11,14631,14815,13128,-1687
2019,12,24,12,15674,15946,14224,-1722
2019,12,24,13,16629,16975,15557,-1418
2019,12,24,14,17086,17594,15790,-1804
2019,12,24,15,17422,17741,15749,-1992
2019,12,24,16,17433,17659,15538,-2121
2019,12,24,17,17406,17438,15492,-1946
2019,12,24,18,17172,17172,15336,-1836
2019,12,24,19,17021,17104,15173,-1931
2019,12,24,20,16987,17238,15332,-1906
2019,12,24,21,17103,17545,15326,-2219
2019,12,24,22,17686,18283,16124,-2159
2019,12,24,23,18563,19032,16689,-2343
2019,12,25,0,18068,18623,16491,-2132
2019,12,25,1,17639,18136,16024,-2112
2019,12,25,2,17329,17766,15927,-1839
2019,12,25,3,17037,17375,15465,-1910
2019,12,25,4,16630,16766,14823,-1943
2019,12,25,5,16041,16040,14337,-1703
2019,12,25,6,15106,15349,13700,-1649
2019,12,25,7,14559,14831,13090,-1741
2019,12,25,8,14173,14481,13063,-1418
2019,12,25,9,13983,14312,12945,-1367
2019,12,25,10,13993,14345,13284,-1061
2019,12,25,11,14273,14639,13951,-688
2019,12,25,12,14771,15194,14527,-667
2019,12,25,13,15193,15745,14838,-907
2019,12,25,14,15422,16141,15094,-1047
2019,12,25,15,15580,16254,15213,-1041
2019,12,25,16,15549,16120,15195,-925
2019,12,25,17,15559,15938,14777,-1161
2019,12,25,18,15469,15886,14663,-1223
2019,12,25,19,15362,15887,14656,-1231
2019,12,25,20,15294,15829,14670,-1159
2019,12,25,21,15424,16019,14644,-1375
2019,12,25,22,15967,16710,15119,-1591
2019,12,25,23,16689,17454,15494,-1960
2019,12,26,0,16593,17399,15378,-2021
2019,12,26,1,16569,17304,15298,-2006
2019,12,26,2,16537,17165,15287,-1878
2019,12,26,3,16302,16857,15260,-1597
2019,12,26,4,15767,16209,14644,-1565
2019,12,26,5,15067,15441,13843,-1598
2019,12,26,6,14522,14784,12764,-2020
2019,12,26,7,14128,14340,12522,-1818
2019,12,26,8,13912,14095,12348,-1747
2019,12,26,9,13851,14037,12365,-1672
2019,12,26,10,14057,14238,12445,-1793
2019,12,26,11,14684,14916,12964,-1952
2019,12,26,12,15645,16143,14517,-1626
2019,12,26,13,16421,17238,15327,-1911
2019,12,26,14,16811,17941,15781,-2160
2019,12,26,15,17209,18486,16198,-2288
2019,12,26,16,17387,18641,16067,-2574
2019,12,26,17,17436,18644,16023,-2621
2019,12,26,18,17350,18524,15718,-2806
2019,12,26,19,17300,18473,15628,-2845
2019,12,26,20,17283,18505,15980,-2525
2019,12,26,21,17444,18700,16345,-2355
2019,12,26,22,18161,19523,17131,-2392
2019,12,26,23,19001,20234,17847,-2387
2019,12,27,0,18709,19936,17900,-2036
2019,12,27,1,18335,19456,17623,-1833
2019,12,27,2,17918,18846,17246,-1600
2019,12,27,3,17228,18033,16376,-1657
2019,12,27,4,16298,16912,15445,-1467
2019,12,27,5,15352,15791,14654,-1137
2019,12,27,6,14527,14856,13640,-1216
2019,12,27,7,13957,14297,13205,-1092
2019,12,27,8,13618,13941,12896,-1045
2019,12,27,9,13478,13794,12819,-975
2019,12,27,10,13624,13924,13065,-859
2019,12,27,11,14277,14558,13585,-973
2019,12,27,12,15380,15699,14778,-921
2019,12,27,13,16354,16791,15896,-895
2019,12,27,14,16895,17468,16107,-1361
2019,12,27,15,17351,17890,16460,-1430
2019,12,27,16,17574,18162,16571,-1591
2019,12,27,17,17627,18323,16524,-1799
2019,12,27,18,17540,18295,16504,-1791
2019,12,27,19,17496,18239,16865,-1374
2019,12,27,20,17455,18142,16773,-1369
2019,12,27,21,17596,18235,16723,-1512
2019,12,27,22,18339,18827,17604,-1223
2019,12,27,23,19106,19366,17999,-1367
2019,12,28,0,18817,19063,17790,-1273
2019,12,28,1,18318,18592,17323,-1269
2019,12,28,2,17891,18126,16553,-1573
2019,12,28,3,17284,17410,16056,-1354
2019,12,28,4,16441,16511,14984,-1527
2019,12,28,5,15456,15506,14134,-1372
2019,12,28,6,14431,14609,13255,-1354
2019,12,28,7,13755,14061,12929,-1132
2019,12,28,8,13356,13747,12742,-1005
2019,12,28,9,13165,13631,12608,-1023
2019,12,28,10,13214,13686,12738,-948
2019,12,28,11,13529,13992,13281,-711
2019,12,28,12,14040,14585,14168,-417
2019,12,28,13,14719,15238,14729,-509
2019,12,28,14,15402,15842,15114,-728
2019,12,28,15,15896,16308,15431,-877
2019,12,28,16,16088,16558,15661,-897
2019,12,28,17,16108,16565,15678,-887
2019,12,28,18,15978,16393,15438,-955
2019,12,28,19,15887,16183,15243,-940
2019,12,28,20,15950,16220,15287,-933
2019,12,28,21,16230,16580,15562,-1018
2019,12,28,22,17216,17479,16085,-1394
2019,12,28,23,18321,18451,16762,-1689
2019,12,29,0,18307,18468,16827,-1641
2019,12,29,1,18079,18226,16769,-1457
2019,12,29,2,17767,17890,16392,-1498
2019,12,29,3,17295,17390,15990,-1400
2019,12,29,4,16535,16603,15206,-1397
2019,12,29,5,15614,15728,14084,-1644
2019,12,29,6,14678,14937,13388,-1549
2019,12,29,7,14046,14391,12956,-1435
2019,12,29,8,13656,14054,12809,-1245
2019,12,29,9,13457,13911,12190,-1721
2019,12,29,10,13469,13960,12213,-1747
2019,12,29,11,13695,14139,12316,-1823
2019,12,29,12,14044,14643,13152,-1491
2019,12,29,13,14519,15163,13711,-1452
2019,12,29,14,15110,15678,14309,-1369
2019,12,29,15,15599,16179,14846,-1333
2019,12,29,16,15892,16427,14972,-1455
2019,12,29,17,16063,16670,14752,-1918
2019,12,29,18,16157,16944,14716,-2228
2019,12,29,19,16243,17144,15055,-2089
2019,12,29,20,16364,17273,15381,-1892
2019,12,29,21,16682,17480,15787,-1693
2019,12,29,22,17758,18265,16364,-1901
2019,12,29,23,18736,18951,16846,-2105
2019,12,30,0,18639,18853,16794,-2059
2019,12,30,1,18367,18491,16888,-1603
2019,12,30,2,17969,18063,16315,-1748
2019,12,30,3,17303,17350,15626,-1724
2019,12,30,4,16269,16436,14961,-1475
2019,12,30,5,15176,15499,13907,-1592
2019,12,30,6,14237,14771,13000,-1771
2019,12,30,7,13619,14251,12622,-1629
2019,12,30,8,13269,13945,12308,-1637
2019,12,30,9,13105,13908,12407,-1501
2019,12,30,10,13233,14120,12586,-1534
2019,12,30,11,13778,14832,13046,-1786
2019,12,30,12,14702,15945,14365,-1580
2019,12,30,13,15744,17095,15485,-1610
2019,12,30,14,16729,17871,16296,-1575
2019,12,30,15,17572,18522,16596,-1926
2019,12,30,16,18146,18982,16581,-2401
2019,12,30,17,18460,19108,16458,-2650
2019,12,30,18,18494,19090,16295,-2795
2019,12,30,19,18494,19132,16524,-2608
2019,12,30,20,18456,19129,16984,-2145
2019,12,30,21,18580,19174,17208,-1966
2019,12,30,22,19366,19728,17512,-2216
2019,12,30,23,20389,20384,17871,-2513
2019,12,31,0,20241,20125,17522,-2603
2019,12,31,1,19726,19635,17222,-2413
2019,12,31,2,18981,19001,16846,-2155
2019,12,31,3,18123,18195,16246,-1949
2019,12,31,4,16956,17084,15268,-1816
2019,12,31,5,15692,16010,14729,-1281
2019,12,31,6,14589,15133,13263,-1870
2019,12,31,7,13897,14543,12875,-1668
2019,12,31,8,13481,14180,12809,-1371
2019,12,31,9,13305,14019,12912,-1107
2019,12,31,10,13421,14183,13064,-1119
2019,12,31,11,14051,14825,13410,-1415
2019,12,31,12,15147,15969,14488,-1481
2019,12,31,13,16114,16969,14880,-2089
2019,12,31,14,16717,17604,15177,-2427
2019,12,31,15,17121,18037,15531,-2506
2019,12,31,16,17298,18322,16098,-2224
2019,12,31,17,17363,18486,16212,-2274
2019,12,31,18,17274,18476,15979,-2497
2019,12,31,19,17262,18453,15745,-2708
2019,12,31,20,17355,18292,15534,-2758
2019,12,31,21,17575,18299,15458,-2841
2019,12,31,22,18381,19044,16146,-2898
2019,12,31,23,19510,19843,16923,-2920
2020,1,1,0,19255,19437,16734,-2703
2020,1,1,1,18526,18778,16564,-2214
2020,1,1,2,17738,18082,16012,-2070
2020,1,1,3,16983,17385,15757,-1628
2020,1,1,4,16272,16646,15230,-1416
2020,1,1,5,15662,15984,14632,-1352
2020,1,1,6,15097,15417,13187,-2230
2020,1,1,7,14535,14891,12698,-2193
2020,1,1,8,14029,14506,12493,-2013
2020,1,1,9,13732,14226,12259,-1967
2020,1,1,10,13648,14211,12359,-1852
2020,1,1,11,13849,14404,12553,-1851
2020,1,1,12,14273,14789,13254,-1535
2020,1,1,13,14526,15135,13994,-1141
2020,1,1,14,14723,15476,14408,-1068
2020,1,1,15,15099,15945,14664,-1281
2020,1,1,16,15465,16280,14968,-1312
2020,1,1,17,15759,16675,15223,-1452
2020,1,1,18,15959,17147,15377,-1770
2020,1,1,19,16028,17331,15257,-2074
2020,1,1,20,16109,17429,15197,-2232
2020,1,1,21,16370,17569,15283,-2286
2020,1,1,22,17244,18263,15703,-2560
2020,1,1,23,18591,19149,16576,-2573
2020,1,2,0,18609,19052,16449,-2603
2020,1,2,1,18351,18766,16280,-2486
2020,1,2,2,17980,18344,16064,-2280
2020,1,2,3,17278,17726,15491,-2235
2020,1,2,4,16283,16786,14654,-2132
2020,1,2,5,15303,15799,13721,-2078
2020,1,2,6,14644,15082,13045,-2037
2020,1,2,7,14253,14666,12700,-1966
2020,1,2,8,14036,14481,12767,-1714
2020,1,2,9,13986,14400,12875,-1525
2020,1,2,10,14239,14661,12716,-1945
2020,1,2,11,15062,15458,13116,-2342
2020,1,2,12,16485,16907,14762,-2145
2020,1,2,13,17446,18067,15763,-2304
2020,1,2,14,17555,18467,15889,-2578
2020,1,2,15,17558,18503,15718,-2785
2020,1,2,16,17447,18299,16070,-2229
2020,1,2,17,17315,18023,16136,-1887
2020,1,2,18,17136,17835,16228,-1607
2020,1,2,19,17127,18061,16133,-1928
2020,1,2,20,17162,18219,16216,-2003
2020,1,2,21,17349,18421,16357,-2064
2020,1,2,22,17966,19099,17132,-1967
2020,1,2,23,19310,19989,18050,-1939
2020,1,3,0,19246,19837,17853,-1984
2020,1,3,1,18878,19395,17579,-1816
2020,1,3,2,18383,18766,17178,-1588
2020,1,3,3,17484,17930,16630,-1300
2020,1,3,4,16389,16783,15265,-1518
2020,1,3,5,15296,15636,14431,-1205
2020,1,3,6,14437,14772,13623,-1149
2020,1,3,7,13965,14219,13051,-1168
2020,1,3,8,13692,13922,12841,-1081
2020,1,3,9,13594,13810,12716,-1094
2020,1,3,10,13802,13997,12881,-1116
2020,1,3,11,14594,14742,13186,-1556
2020,1,3,12,16034,16154,14694,-1460
2020,1,3,13,17107,17387,16179,-1208
2020,1,3,14,17458,17981,16382,-1599
2020,1,3,15,17764,18406,17283,-1123
2020,1,3,16,17923,18701,17494,-1207
2020,1,3,17,17930,18732,17013,-1719
2020,1,3,18,17815,18654,16443,-2211
2020,1,3,19,17741,18647,16652,-1995
2020,1,3,20,17661,18594,16894,-1700
2020,1,3,21,17731,18592,17009,-1583
2020,1,3,22,18238,19072,17358,-1714
2020,1,3,23,19103,19572,17292,-2280
2020,1,4,0,18811,19247,16865,-2382
2020,1,4,1,18326,18754,16279,-2475
2020,1,4,2,17812,18224,16235,-1989
2020,1,4,3,17115,17457,15348,-2109
2020,1,4,4,16252,16458,14525,-1933
2020,1,4,5,15314,15387,13223,-2164
2020,1,4,6,14352,14600,12235,-2365
2020,1,4,7,13756,14026,11866,-2160
2020,1,4,8,13412,13701,11759,-1942
2020,1,4,9,13244,13538,11574,-1964
2020,1,4,10,13290,13563,11611,-1952
2020,1,4,11,13622,13860,11723,-2137
2020,1,4,12,14259,14432,12455,-1977
2020,1,4,13,14926,15192,13434,-1758
2020,1,4,14,15556,15930,14105,-1825
2020,1,4,15,16204,16713,14595,-2118
2020,1,4,16,16601,17238,15324,-1914
2020,1,4,17,16772,17504,15198,-2306
2020,1,4,18,16730,17514,15138,-2376
2020,1,4,19,16607,17439,15288,-2151
2020,1,4,20,16536,17306,15172,-2134
2020,1,4,21,16611,17357,15021,-2336
2020,1,4,22,17172,17894,15276,-2618
2020,1,4,23,18121,18489,15776,-2713
2020,1,5,0,18067,18396,15615,-2781
2020,1,5,1,17665,18040,15398,-2642
2020,1,5,2,17228,17735,15095,-2640
2020,1,5,3,16668,17225,14813,-2412
2020,1,5,4,15950,16491,14050,-2441
2020,1,5,5,15154,15696,13220,-2476
2020,1,5,6,14435,14755,11617,-3138
2020,1,5,7,13879,14212,11406,-2806
2020,1,5,8,13539,14073,11539,-2534
2020,1,5,9,13381,13961,11521,-2440
2020,1,5,10,13422,13992,11551,-2441
2020,1,5,11,13736,14252,11700,-2552
2020,1,5,12,14321,14712,12368,-2344
2020,1,5,13,14851,15301,13191,-2110
2020,1,5,14,15355,15958,13907,-2051
2020,1,5,15,15837,16567,14190,-2377
2020,1,5,16,16145,16811,14488,-2323
2020,1,5,17,16272,16957,14399,-2558
2020,1,5,18,16328,17078,14153,-2925
2020,1,5,19,16352,17103,13900,-3203
2020,1,5,20,16453,17226,14177,-3049
2020,1,5,21,16739,17600,14480,-3120
2020,1,5,22,17546,18444,15553,-2891
2020,1,5,23,18936,19519,16286,-3233
2020,1,6,0,19043,19436,16147,-3289
2020,1,6,1,18753,19118,15826,-3292
2020,1,6,2,18288,18669,15376,-3293
2020,1,6,3,17531,17935,14959,-2976
2020,1,6,4,16569,16924,13943,-2981
2020,1,6,5,15574,15937,13232,-2705
2020,1,6,6,14787,15244,12591,-2653
2020,1,6,7,14319,14855,12460,-2395
2020,1,6,8,14076,14607,12486,-2121
2020,1,6,9,14007,14552,12328,-2224
2020,1,6,10,14286,14841,12469,-2372
2020,1,6,11,15239,15797,13334,-2463
2020,1,6,12,17000,17456,14980,-2476
2020,1,6,13,18315,18741,16241,-2500
2020,1,6,14,18673,19182,16497,-2685
2020,1,6,15,18816,19544,16963,-2581
2020,1,6,16,18822,19602,17328,-2274
2020,1,6,17,18705,19291,17087,-2204
2020,1,6,18,18550,18943,16534,-2409
2020,1,6,19,18525,18971,16644,-2327
2020,1,6,20,18468,18851,16891,-1960
2020,1,6,21,18635,19012,16964,-2048
2020,1,6,22,19331,19667,17735,-1932
2020,1,6,23,20521,20631,18280,-2351
2020,1,7,0,20457,20527,17897,-2630
2020,1,7,1,20059,20151,17251,-2900
2020,1,7,2,19429,19532,17284,-2248
2020,1,7,3,18475,18665,16619,-2046
2020,1,7,4,17222,17440,15616,-1824
2020,1,7,5,16013,16252,14550,-1702
2020,1,7,6,15166,15400,13587,-1813
2020,1,7,7,14665,14958,13118,-1840
2020,1,7,8,14398,14739,13407,-1332
2020,1,7,9,14338,14719,13588,-1131
2020,1,7,10,14614,14979,13782,-1197
2020,1,7,11,15572,15940,14559,-1381
2020,1,7,12,17349,17625,15910,-1715
2020,1,7,13,18585,18904,17517,-1387
2020,1,7,14,18726,19197,17219,-1978
2020,1,7,15,18745,19170,16960,-2210
2020,1,7,16,18687,19076,16952,-2124
2020,1,7,17,18576,19016,16914,-2102
2020,1,7,18,18452,19014,17062,-1952
2020,1,7,19,18464,19013,16910,-2103
2020,1,7,20,18445,18949,16802,-2147
2020,1,7,21,18641,19187,16907,-2280
2020,1,7,22,19308,19898,17360,-2538
2020,1,7,23,20433,20609,17684,-2925
2020,1,8,0,20319,20501,17659,-2842
2020,1,8,1,19936,20105,17458,-2647
2020,1,8,2,19288,19513,17238,-2275
2020,1,8,3,18346,18594,15896,-2698
2020,1,8,4,17137,17382,15189,-2193
2020,1,8,5,15961,16242,14419,-1823
2020,1,8,6,15045,15448,13977,-1471
2020,1,8,7,14572,15022,13716,-1306
2020,1,8,8,14305,14762,13480,-1282
2020,1,8,9,14243,14736,13301,-1435
2020,1,8,10,14507,14998,13328,-1670
2020,1,8,11,15411,15897,13924,-1973
2020,1,8,12,17143,17562,15366,-2196
2020,1,8,13,18419,18813,16494,-2319
2020,1,8,14,18689,19110,16835,-2275
2020,1,8,15,18772,19258,16866,-2392
2020,1,8,16,18778,19200,16858,-2342
2020,1,8,17,18696,19160,16736,-2424
2020,1,8,18,18604,19133,16867,-2266
2020,1,8,19,18611,19035,16636,-2399
2020,1,8,20,18612,19165,17205,-1960
2020,1,8,21,18841,19588,17374,-2214
2020,1,8,22,19523,20380,18291,-2089
2020,1,8,23,20746,21466,19570,-1896
2020,1,9,0,20764,21502,19396,-2106
2020,1,9,1,20443,21182,19553,-1629
2020,1,9,2,19878,20599,19174,-1425
2020,1,9,3,19002,19767,18362,-1405
2020,1,9,4,17828,18534,17181,-1353
2020,1,9,5,16688,17458,16343,-1115
2020,1,9,6,16069,16709,14865,-1844
2020,1,9,7,15640,16295,14332,-1963
2020,1,9,8,15408,16051,14158,-1893
2020,1,9,9,15366,16018,13887,-2131
2020,1,9,10,15654,16302,14140,-2162
2020,1,9,11,16569,17212,15108,-2104
2020,1,9,12,18301,18966,16311,-2655
2020,1,9,13,19549,20171,17285,-2886
2020,1,9,14,19632,20345,17133,-3212
2020,1,9,15,19551,20143,16869,-3274
2020,1,9,16,19406,19899,16901,-2998
2020,1,9,17,19214,19645,16928,-2717
2020,1,9,18,19037,19518,16921,-2597
2020,1,9,19,19032,19486,16281,-3205
2020,1,9,20,19026,19605,15958,-3647
2020,1,9,21,19245,19974,16722,-3252
2020,1,9,22,19877,20755,17570,-3185
2020,1,9,23,21000,21644,18910,-2734
2020,1,10,0,20943,21581,18999,-2582
2020,1,10,1,20570,21180,18744,-2436
2020,1,10,2,19962,20549,18265,-2284
2020,1,10,3,19030,19580,17498,-2082
2020,1,10,4,17826,18357,16482,-1875
2020,1,10,5,16653,17136,15281,-1855
2020,1,10,6,15749,16242,14344,-1898
2020,1,10,7,15221,15717,13920,-1797
2020,1,10,8,14907,15366,13633,-1733
2020,1,10,9,14777,15222,13725,-1497
2020,1,10,10,14971,15401,13720,-1681
2020,1,10,11,15781,16222,14539,-1683
2020,1,10,12,17353,17752,15518,-2234
2020,1,10,13,18529,18948,17096,-1852
2020,1,10,14,18741,19246,17351,-1895
2020,1,10,15,18853,19504,17113,-2391
2020,1,10,16,18867,19651,17207,-2444
2020,1,10,17,18746,19625,17200,-2425
2020,1,10,18,18604,19329,16989,-2340
2020,1,10,19,18557,18989,16807,-2182
2020,1,10,20,18469,18807,17099,-1708
2020,1,10,21,18551,18801,17137,-1664
2020,1,10,22,18992,19239,17365,-1874
2020,1,10,23,19714,19774,17337,-2437
2020,1,11,0,19414,19433,17327,-2106
2020,1,11,1,18898,18897,17141,-1756
2020,1,11,2,18334,18287,16641,-1646
2020,1,11,3,17572,17572,15500,-2072
2020,1,11,4,16596,16594,14263,-2331
2020,1,11,5,15571,15544,13704,-1840
2020,1,11,6,14753,14723,12806,-1917
2020,1,11,7,14141,14151,12353,-1798
2020,1,11,8,13771,13760,11970,-1790
2020,1,11,9,13575,13609,11828,-1781
2020,1,11,10,13577,13617,11736,-1881
2020,1,11,11,13840,13856,12002,-1854
2020,1,11,12,14399,14414,12621,-1793
2020,1,11,13,15024,15051,13232,-1819
2020,1,11,14,15564,15608,13594,-2014
2020,1,11,15,16081,16066,14124,-1942
2020,1,11,16,16369,16253,14420,-1833
2020,1,11,17,16529,16244,14349,-1895
2020,1,11,18,16454,16201,14241,-1960
2020,1,11,19,16346,16195,14512,-1683
2020,1,11,20,16328,16339,14607,-1732
2020,1,11,21,16436,16440,14258,-2182
2020,1,11,22,16881,16886,14709,-2177
2020,1,11,23,17671,17592,15187,-2405
2020,1,12,0,17632,17488,15109,-2379
2020,1,12,1,17194,17147,14295,-2852
2020,1,12,2,16753,16723,14489,-2234
2020,1,12,3,16198,16139,14012,-2127
2020,1,12,4,15490,15417,13520,-1897
2020,1,12,5,14719,14606,12598,-2008
2020,1,12,6,13709,13845,11800,-2045
2020,1,12,7,13126,13360,11612,-1748
2020,1,12,8,12766,13023,11251,-1772
2020,1,12,9,12582,12835,11298,-1537
2020,1,12,10,12579,12863,11282,-1581
2020,1,12,11,12803,13054,11528,-1526
2020,1,12,12,13306,13462,11949,-1513
2020,1,12,13,13874,14004,11970,-2034
2020,1,12,14,14417,14586,12688,-1898
2020,1,12,15,14945,15143,12962,-2181
2020,1,12,16,15270,15479,13315,-2164
2020,1,12,17,15530,15629,13753,-1876
2020,1,12,18,15593,15747,13776,-1971
2020,1,12,19,15634,15821,13383,-2438
2020,1,12,20,15760,15953,13436,-2517
2020,1,12,21,16047,16281,14075,-2206
2020,1,12,22,16711,16966,14744,-2222
2020,1,12,23,17902,18006,15833,-2173
2020,1,13,0,17965,18050,15866,-2184
2020,1,13,1,17707,17785,15278,-2507
2020,1,13,2,17284,17391,14781,-2610
2020,1,13,3,16566,16761,14151,-2610
2020,1,13,4,15671,15841,13416,-2425
2020,1,13,5,14793,14936,13095,-1841
2020,1,13,6,13979,14334,12695,-1639
2020,1,13,7,13627,13987,12570,-1417
2020,1,13,8,13458,13831,12348,-1483
2020,1,13,9,13453,13833,12394,-1439
2020,1,13,10,13761,14150,12802,-1348
2020,1,13,11,14710,15172,13523,-1649
2020,1,13,12,16428,16929,15191,-1738
2020,1,13,13,17692,18182,16575,-1607
2020,1,13,14,17937,18488,16401,-2087
2020,1,13,15,18027,18803,16350,-2453
2020,1,13,16,18035,19013,16781,-2232
2020,1,13,17,17986,19070,17070,-2000
2020,1,13,18,17887,18985,16951,-2034
2020,1,13,19,17890,18924,16601,-2323
2020,1,13,20,17885,18842,16369,-2473
2020,1,13,21,18069,18944,16498,-2446
2020,1,13,22,18688,19463,16892,-2571
2020,1,13,23,19686,20064,17897,-2167
2020,1,14,0,19655,19875,17750,-2125
2020,1,14,1,19213,19473,17265,-2208
2020,1,14,2,18608,18838,17386,-1452
2020,1,14,3,17684,17966,16211,-1755
2020,1,14,4,16474,16836,14948,-1888
2020,1,14,5,15328,15731,13741,-1990
2020,1,14,6,14382,14887,12780,-2107
2020,1,14,7,13930,14356,12583,-1773
2020,1,14,8,13693,14131,12670,-1461
2020,1,14,9,13645,14073,12446,-1627
2020,1,14,10,13923,14325,12794,-1531
2020,1,14,11,14879,15265,13509,-1756
2020,1,14,12,16650,16982,15371,-1611
2020,1,14,13,17934,18229,16319,-1910
2020,1,14,14,18194,18568,16209,-2359
2020,1,14,15,18197,18664,16499,-2165
2020,1,14,16,18100,18585,16481,-2104
2020,1,14,17,17967,18535,16258,-2277
2020,1,14,18,17832,18470,16572,-1898
2020,1,14,19,17857,18419,16622,-1797
2020,1,14,20,17887,18468,16554,-1914
2020,1,14,21,18067,18729,16851,-1878
2020,1,14,22,18621,19334,17474,-1860
2020,1,14,23,19589,20039,17812,-2227
2020,1,15,0,19466,19865,18140,-1725
2020,1,15,1,19033,19438,17622,-1816
2020,1,15,2,18365,18795,17201,-1594
2020,1,15,3,17381,17859,16204,-1655
2020,1,15,4,16138,16690,14816,-1874
2020,1,15,5,14969,15551,13889,-1662
2020,1,15,6,14314,14673,12507,-2166
2020,1,15,7,13862,14148,12508,-1640
2020,1,15,8,13609,13869,12299,-1570
2020,1,15,9,13546,13830,12447,-1383
2020,1,15,10,13815,14075,12481,-1594
2020,1,15,11,14749,15013,13579,-1434
2020,1,15,12,16514,16711,15247,-1464
2020,1,15,13,17789,17963,16121,-1842
2020,1,15,14,17979,18128,16410,-1718
2020,1,15,15,17900,18071,16184,-1887
2020,1,15,16,17755,17910,15765,-2145
2020,1,15,17,17536,17775,15642,-2133
2020,1,15,18,17349,17616,15569,-2047
2020,1,15,19,17322,17539,15737,-1802
2020,1,15,20,17360,17546,15699,-1847
2020,1,15,21,17619,17811,15744,-2067
2020,1,15,22,18243,18471,16630,-1841
2020,1,15,23,19365,19514,17214,-2300
2020,1,16,0,19379,19547,17307,-2240
2020,1,16,1,19005,19212,17333,-1879
2020,1,16,2,18442,18675,16690,-1985
2020,1,16,3,17520,17809,15881,-1928
2020,1,16,4,16312,16647,14939,-1708
2020,1,16,5,15155,15552,13863,-1689
2020,1,16,6,14433,14740,12550,-2190
2020,1,16,7,13951,14278,12094,-2184
2020,1,16,8,13666,13983,11828,-2155
2020,1,16,9,13580,13894,11702,-2192
2020,1,16,10,13807,14171,12207,-1964
2020,1,16,11,14658,15088,12966,-2122
2020,1,16,12,16322,16774,14899,-1875
2020,1,16,13,17669,18072,16522,-1550
2020,1,16,14,17973,18365,16606,-1759
2020,1,16,15,18055,18578,16708,-1870
2020,1,16,16,18054,18463,16508,-1955
2020,1,16,17,17983,18513,16407,-2106
2020,1,16,18,17895,18483,16331,-2152
2020,1,16,19,17932,18557,16471,-2086
2020,1,16,20,17998,18723,16649,-2074
2020,1,16,21,18255,18944,16900,-2044
2020,1,16,22,18864,19607,17731,-1876
2020,1,16,23,19891,20605,18415,-2190
2020,1,17,0,19907,20630,18068,-2562
2020,1,17,1,19565,20298,17768,-2530
2020,1,17,2,19002,19816,17747,-2069
2020,1,17,3,18173,19002,17158,-1844
2020,1,17,4,17063,17927,15973,-1954
2020,1,17,5,16017,16903,15043,-1860
2020,1,17,6,15401,16219,14453,-1766
2020,1,17,7,15053,15831,14023,-1808
2020,1,17,8,14861,15619,13943,-1676
2020,1,17,9,14850,15646,14105,-1541
2020,1,17,10,15152,16006,14743,-1263
2020,1,17,11,16074,17012,15457,-1555
2020,1,17,12,17765,18763,17195,-1568
2020,1,17,13,19043,20005,18277,-1728
2020,1,17,14,19310,20308,18142,-2166
2020,1,17,15,19295,20281,17889,-2392
2020,1,17,16,19160,20188,17540,-2648
2020,1,17,17,18953,20047,17173,-2874
2020,1,17,18,18754,19830,16752,-3078
2020,1,17,19,18714,19688,16599,-3089
2020,1,17,20,18763,19653,16644,-3009
2020,1,17,21,19013,19947,16945,-3002
2020,1,17,22,19597,20626,18158,-2468
2020,1,17,23,20592,21530,19306,-2224
2020,1,18,0,20665,21517,18882,-2635
2020,1,18,1,20303,21193,18392,-2801
2020,1,18,2,19846,20721,18190,-2531
2020,1,18,3,19149,20043,17358,-2685
2020,1,18,4,18217,19089,16477,-2612
2020,1,18,5,17266,18120,15651,-2469
2020,1,18,6,16561,17337,14098,-3239
2020,1,18,7,16028,16802,13457,-3345
2020,1,18,8,15697,16467,13211,-3256
2020,1,18,9,15525,16337,13450,-2887
2020,1,18,10,15545,16361,13394,-2967
2020,1,18,11,15805,16689,13459,-3230
2020,1,18,12,16354,17317,14260,-3057
2020,1,18,13,17015,18132,15850,-2282
2020,1,18,14,17713,18854,16255,-2599
2020,1,18,15,18236,19371,16739,-2632
2020,1,18,16,18512,19681,16740,-2941
2020,1,18,17,18612,19810,17037,-2773
2020,1,18,18,18543,19882,17534,-2348
2020,1,18,19,18440,20105,18128,-1977
2020,1,18,20,18377,20110,17963,-2147
2020,1,18,21,18431,20099,17707,-2392
2020,1,18,22,18819,20419,18011,-2408
2020,1,18,23,19557,20993,18671,-2322
2020,1,19,0,19492,20836,18408,-2428
2020,1,19,1,19032,20320,17959,-2361
2020,1,19,2,18449,19666,17489,-2177
2020,1,19,3,17784,18792,16426,-2366
2020,1,19,4,16950,17856,15722,-2134
2020,1,19,5,16072,16857,14751,-2106
2020,1,19,6,15458,16093,13582,-2511
2020,1,19,7,14836,15501,13209,-2292
2020,1,19,8,14448,15162,12916,-2246
2020,1,19,9,14234,14955,12851,-2104
2020,1,19,10,14202,14906,13061,-1845
2020,1,19,11,14373,15084,13252,-1832
2020,1,19,12,14709,15526,14070,-1456
2020,1,19,13,15137,16053,14562,-1491
2020,1,19,14,15696,16634,15047,-1587
2020,1,19,15,16230,17052,15313,-1739
2020,1,19,16,16588,17307,15082,-2225
2020,1,19,17,16828,17582,15559,-2023
2020,1,19,18,16938,17716,15789,-1927
2020,1,19,19,16994,17685,15549,-2136
2020,1,19,20,17108,17751,15382,-2369
2020,1,19,21,17379,18093,15902,-2191
2020,1,19,22,18066,18676,16228,-2448
2020,1,19,23,19272,19679,16987,-2692
2020,1,20,0,19597,19736,17156,-2580
2020,1,20,1,19238,19447,17241,-2206
2020,1,20,2,18841,19053,16886,-2167
2020,1,20,3,18160,18487,16463,-2024
2020,1,20,4,17256,17745,15899,-1846
2020,1,20,5,16357,16951,14964,-1987
2020,1,20,6,16022,16350,13917,-2433
2020,1,20,7,15639,15986,13428,-2558
2020,1,20,8,15434,15812,13410,-2402
2020,1,20,9,15373,15836,13489,-2347
2020,1,20,10,15635,16132,13877,-2255
2020,1,20,11,16350,16921,14946,-1975
2020,1,20,12,17505,18029,15897,-2132
2020,1,20,13,18468,19022,17129,-1893
2020,1,20,14,18962,19617,17132,-2485
2020,1,20,15,19293,19912,16763,-3149
2020,1,20,16,19408,19969,16326,-3643
2020,1,20,17,19337,19863,16302,-3561
2020,1,20,18,19162,19673,16243,-3430
2020,1,20,19,19118,19547,16068,-3479
2020,1,20,20,19183,19536,16164,-3372
2020,1,20,21,19417,19797,16561,-3236
2020,1,20,22,20110,20542,17639,-2903
2020,1,20,23,21359,21740,18457,-3283
2020,1,21,0,21536,21895,18741,-3154
2020,1,21,1,21208,21561,18398,-3163
2020,1,21,2,20661,20960,18262,-2698
2020,1,21,3,19772,20093,17550,-2543
2020,1,21,4,18596,18928,16163,-2765
2020,1,21,5,17474,17852,15131,-2721
2020,1,21,6,16609,17078,13964,-3114
2020,1,21,7,16175,16667,13457,-3210
2020,1,21,8,15958,16455,13300,-3155
2020,1,21,9,15922,16380,13650,-2730
2020,1,21,10,16203,16676,14154,-2522
2020,1,21,11,17136,17685,14867,-2818
2020,1,21,12,18819,19347,16039,-3308
2020,1,21,13,19984,20539,17126,-3413
2020,1,21,14,20031,20742,17036,-3706
2020,1,21,15,19845,20587,16860,-3727
2020,1,21,16,19603,20427,16318,-4109
2020,1,21,17,19344,20276,16315,-3961
2020,1,21,18,19118,20093,16280,-3813
2020,1,21,19,19090,19958,16257,-3701
2020,1,21,20,19112,19952,16585,-3367
2020,1,21,21,19373,20225,16958,-3267
2020,1,21,22,20009,20814,17591,-3223
2020,1,21,23,21050,21841,18081,-3760
2020,1,22,0,21162,21890,17753,-4137
2020,1,22,1,20823,21553,17673,-3880
2020,1,22,2,20264,20936,17276,-3660
2020,1,22,3,19370,19984,16793,-3191
2020,1,22,4,18174,18767,15826,-2941
2020,1,22,5,17046,17602,14913,-2689
2020,1,22,6,16332,16792,13331,-3461
2020,1,22,7,15883,16313,12659,-3654
2020,1,22,8,15637,16084,12441,-3643
2020,1,22,9,15573,16015,12584,-3431
2020,1,22,10,15839,16307,13180,-3127
2020,1,22,11,16761,17259,14137,-3122
2020,1,22,12,18478,18944,15805,-3139
2020,1,22,13,19666,20125,17393,-2732
2020,1,22,14,19687,20281,17235,-3046
2020,1,22,15,19460,20058,16714,-3344
2020,1,22,16,19159,19812,15832,-3980
2020,1,22,17,18831,19475,15564,-3911
2020,1,22,18,18552,19104,15263,-3841
2020,1,22,19,18460,18942,15479,-3463
2020,1,22,20,18452,18910,15733,-3177
2020,1,22,21,18723,19170,16031,-3139
2020,1,22,22,19389,19856,16702,-3154
2020,1,22,23,20509,20969,17475,-3494
2020,1,23,0,20656,21089,17363,-3726
2020,1,23,1,20381,20733,17160,-3573
2020,1,23,2,19851,20209,17080,-3129
2020,1,23,3,19004,19313,15901,-3412
2020,1,23,4,17811,18112,15077,-3035
2020,1,23,5,16664,16988,14782,-2206
2020,1,23,6,16017,16176,14079,-2097
2020,1,23,7,15566,15742,13471,-2271
2020,1,23,8,15321,15537,13502,-2035
2020,1,23,9,15272,15490,13412,-2078
2020,1,23,10,15534,15803,13798,-2005
2020,1,23,11,16446,16775,14575,-2200
2020,1,23,12,18136,18518,16295,-2223
2020,1,23,13,19349,19689,17445,-2244
2020,1,23,14,19361,19771,16942,-2829
2020,1,23,15,19190,19553,16510,-3043
2020,1,23,16,18931,19285,15896,-3389
2020,1,23,17,18663,19043,15554,-3489
2020,1,23,18,18414,18845,14850,-3995
2020,1,23,19,18345,18796,14838,-3958
2020,1,23,20,18334,18841,15155,-3686
2020,1,23,21,18581,19025,15657,-3368
2020,1,23,22,19212,19544,16381,-3163
2020,1,23,23,20155,20435,17250,-3185
2020,1,24,0,20224,20429,17344,-3085
2020,1,24,1,19913,20051,16932,-3119
2020,1,24,2,19356,19535,16659,-2876
2020,1,24,3,18549,18667,16003,-2664
2020,1,24,4,17413,17520,14819,-2701
2020,1,24,5,16305,16402,13908,-2494
2020,1,24,6,15567,15637,13072,-2565
2020,1,24,7,15140,15148,12856,-2292
2020,1,24,8,14893,14907,12553,-2354
2020,1,24,9,14821,14880,12318,-2562
2020,1,24,10,15056,15155,12814,-2341
2020,1,24,11,15906,16049,14207,-1842
2020,1,24,12,17469,17682,16039,-1643
2020,1,24,13,18620,18839,16913,-1926
2020,1,24,14,18730,19031,16720,-2311
2020,1,24,15,18639,18811,16500,-2311
2020,1,24,16,18399,18465,16149,-2316
2020,1,24,17,18101,18127,15754,-2373
2020,1,24,18,17857,17835,15487,-2348
2020,1,24,19,17795,17709,15330,-2379
2020,1,24,20,17807,17757,15289,-2468
2020,1,24,21,18025,18040,15761,-2279
2020,1,24,22,18569,18598,16225,-2373
2020,1,24,23,19306,19451,16807,-2644
2020,1,25,0,19228,19431,16825,-2606
2020,1,25,1,18886,19036,16800,-2236
2020,1,25,2,18429,18505,16537,-1968
2020,1,25,3,17806,17824,15741,-2083
2020,1,25,4,16927,16941,14728,-2213
2020,1,25,5,15993,16016,14230,-1786
2020,1,25,6,15046,15254,12981,-2273
2020,1,25,7,14519,14707,12570,-2137
2020,1,25,8,14206,14404,12573,-1831
2020,1,25,9,14053,14281,12471,-1810
2020,1,25,10,14090,14327,12531,-1796
2020,1,25,11,14385,14638,13050,-1588
2020,1,25,12,14920,15271,13489,-1782
2020,1,25,13,15543,16051,14460,-1591
2020,1,25,14,16176,16894,14753,-2141
2020,1,25,15,16770,17588,15046,-2542
2020,1,25,16,17114,18068,15314,-2754
2020,1,25,17,17305,18276,15524,-2752
2020,1,25,18,17248,18341,15804,-2537
2020,1,25,19,17111,18227,15853,-2374
2020,1,25,20,17031,18103,15603,-2500
2020,1,25,21,17090,18088,15459,-2629
2020,1,25,22,17487,18214,15527,-2687
2020,1,25,23,18073,18643,15847,-2796
2020,1,26,0,18050,18594,15964,-2630
2020,1,26,1,17672,18219,15806,-2413
2020,1,26,2,17236,17713,15698,-2015
2020,1,26,3,16678,17129,14915,-2214
2020,1,26,4,15961,16378,14206,-2172
2020,1,26,5,15209,15583,13637,-1946
2020,1,26,6,14456,14926,13055,-1871
2020,1,26,7,13920,14425,12408,-2017
2020,1,26,8,13583,14117,12167,-1950
2020,1,26,9,13423,13949,12214,-1735
2020,1,26,10,13451,13970,12329,-1641
2020,1,26,11,13742,14241,12563,-1678
2020,1,26,12,14231,14718,13413,-1305
2020,1,26,13,14706,15267,13861,-1406
2020,1,26,14,15247,15811,14050,-1761
2020,1,26,15,15715,16264,14250,-2014
2020,1,26,16,15992,16497,14669,-1828
2020,1,26,17,16139,16685,14851,-1834
2020,1,26,18,16169,16760,14868,-1892
2020,1,26,19,16177,16848,14621,-2227
2020,1,26,20,16262,16978,14848,-2130
2020,1,26,21,16525,17238,15106,-2132
2020,1,26,22,17209,17852,15508,-2344
2020,1,26,23,18207,18744,16389,-2355
2020,1,27,0,18477,18820,16306,-2514
2020,1,27,1,18180,18507,16359,-2148
2020,1,27,2,17738,18016,15924,-2092
2020,1,27,3,17027,17355,15486,-1869
2020,1,27,4,16085,16439,14758,-1681
2020,1,27,5,15142,15499,13957,-1542
2020,1,27,6,14348,14846,13275,-1571
2020,1,27,7,13937,14457,12931,-1526
2020,1,27,8,13729,14202,12763,-1439
2020,1,27,9,13693,14215,12756,-1459
2020,1,27,10,13993,14521,12995,-1526
2020,1,27,11,14971,15505,13909,-1596
2020,1,27,12,16697,17182,15479,-1703
2020,1,27,13,17970,18335,16428,-1907
2020,1,27,14,18340,18651,16242,-2409
2020,1,27,15,18452,18775,16062,-2713
2020,1,27,16,18465,18844,16093,-2751
2020,1,27,17,18395,18872,15978,-2894
2020,1,27,18,18283,18902,15820,-3082
2020,1,27,19,18268,18974,16225,-2749
2020,1,27,20,18235,18921,16270,-2651
2020,1,27,21,18417,18966,16532,-2434
2020,1,27,22,19033,19424,16958,-2466
2020,1,27,23,19884,20184,17667,-2517
2020,1,28,0,20011,20162,17620,-2542
2020,1,28,1,19615,19757,17078,-2679
2020,1,28,2,18980,19167,16530,-2637
2020,1,28,3,18073,18212,15499,-2713
2020,1,28,4,16854,16995,14313,-2682
2020,1,28,5,15692,15888,13392,-2496
2020,1,28,6,14887,15107,12557,-2550
2020,1,28,7,14420,14653,12347,-2306
2020,1,28,8,14161,14371,12173,-2198
2020,1,28,9,14100,14343,12022,-2321
2020,1,28,10,14366,14600,11994,-2606
2020,1,28,11,15312,15569,12833,-2736
2020,1,28,12,17021,17283,14998,-2285
2020,1,28,13,18258,18472,16228,-2244
2020,1,28,14,18534,18808,16233,-2575
2020,1,28,15,18594,18920,16385,-2535
2020,1,28,16,18562,18821,15970,-2851
2020,1,28,17,18452,18744,15759,-2985
2020,1,28,18,18322,18768,15771,-2997
2020,1,28,19,18317,18822,15840,-2982
2020,1,28,20,18320,18893,15787,-3106
2020,1,28,21,18525,19105,15984,-3121
2020,1,28,22,19133,19612,16849,-2763
2020,1,28,23,20001,20399,17520,-2879
2020,1,29,0,20159,20421,17279,-3142
2020,1,29,1,19788,20070,17393,-2677
2020,1,29,2,19170,19492,16915,-2577
2020,1,29,3,18257,18576,15976,-2600
2020,1,29,4,17067,17382,15075,-2307
2020,1,29,5,15932,16223,13908,-2315
2020,1,29,6,15088,15459,12944,-2515
2020,1,29,7,14660,15045,12771,-2274
2020,1,29,8,14431,14828,12664,-2164
2020,1,29,9,14396,14800,12682,-2118
2020,1,29,10,14685,15057,12806,-2251
2020,1,29,11,15637,16006,13490,-2516
2020,1,29,12,17362,17824,15283,-2541
2020,1,29,13,18591,18950,16479,-2471
2020,1,29,14,18789,19246,16390,-2856
2020,1,29,15,18698,19140,16198,-2942
2020,1,29,16,18495,18826,15515,-3311
2020,1,29,17,18211,18548,15371,-3177
2020,1,29,18,17957,18328,15319,-3009
2020,1,29,19,17874,18259,15132,-3127
2020,1,29,20,17907,18288,15130,-3158
2020,1,29,21,18224,18602,15405,-3197
2020,1,29,22,18922,19363,16039,-3324
2020,1,29,23,19967,20508,17155,-3353
2020,1,30,0,20307,20790,17589,-3201
2020,1,30,1,20048,20513,17508,-3005
2020,1,30,2,19546,20017,17235,-2782
2020,1,30,3,18682,19186,15991,-3195
2020,1,30,4,17528,18013,14965,-3048
2020,1,30,5,16426,16932,14336,-2596
2020,1,30,6,15689,16247,13659,-2588
2020,1,30,7,15281,15847,13406,-2441
2020,1,30,8,15065,15648,13305,-2343
2020,1,30,9,15035,15628,13316,-2312
2020,1,30,10,15329,15977,13499,-2478
2020,1,30,11,16278,16974,14080,-2894
2020,1,30,12,17980,18789,15767,-3022
2020,1,30,13,19164,19830,16795,-3035
2020,1,30,14,19283,19875,16716,-3159
2020,1,30,15,19155,19622,16198,-3424
2020,1,30,16,18958,19363,15789,-3574
2020,1,30,17,18713,19042,15400,-3642
2020,1,30,18,18467,18722,15351,-3371
2020,1,30,19,18412,18713,15227,-3486
2020,1,30,20,18434,18730,15371,-3359
2020,1,30,21,18692,19017,15725,-3292
2020,1,30,22,19322,19651,16662,-2989
2020,1,30,23,20176,20670,17266,-3404
2020,1,31,0,20428,20831,17450,-3381
2020,1,31,1,20150,20566,17294,-3272
2020,1,31,2,19578,20013,16937,-3076
2020,1,31,3,18695,19121,16330,-2791
2020,1,31,4,17545,17938,15338,-2600
2020,1,31,5,16421,16889,14616,-2273
2020,1,31,6,15583,16070,13775,-2295
2020,1,31,7,15145,15619,13574,-2045
2020,1,31,8,14894,15344,13426,-1918
2020,1,31,9,14821,15263,13197,-2066
2020,1,31,10,15061,15504,13218,-2286
2020,1,31,11,15930,16381,13880,-2501
2020,1,31,12,17482,18011,15378,-2633
2020,1,31,13,18582,19097,16913,-2184
2020,1,31,14,18820,19436,16837,-2599
2020,1,31,15,18847,19535,16983,-2552
2020,1,31,16,18758,19444,16682,-2762
2020,1,31,17,18566,19324,15881,-3443
2020,1,31,18,18349,19189,15723,-3466
2020,1,31,19,18261,19120,16033,-3087
2020,1,31,20,18196,18990,16180,-2810
2020,1,31,21,18330,19026,16207,-2819
2020,1,31,22,18815,19353,16777,-2576
2020,1,31,23,19348,19948,17342,-2606
2020,2,1,0,19380,19859,17374,-2485
2020,2,1,1,19025,19391,16867,-2524
2020,2,1,2,18501,18831,16388,-2443
2020,2,1,3,17817,18106,15507,-2599
2020,2,1,4,16923,17193,14326,-2867
2020,2,1,5,15979,16193,13327,-2866
2020,2,1,6,15253,15416,12452,-2964
2020,2,1,7,14743,14902,12207,-2695
2020,2,1,8,14427,14565,12010,-2555
2020,2,1,9,14285,14429,12159,-2270
2020,2,1,10,14331,14463,12108,-2355
2020,2,1,11,14666,14743,12119,-2624
2020,2,1,12,15330,15367,12595,-2772
2020,2,1,13,15955,16064,13486,-2578
2020,2,1,14,16477,16851,14319,-2532
2020,2,1,15,16923,17428,14595,-2833
2020,2,1,16,17129,17762,14629,-3133
2020,2,1,17,17138,17836,14638,-3198
2020,2,1,18,16991,17806,14704,-3102
2020,2,1,19,16799,17741,14451,-3290
2020,2,1,20,16693,17689,14192,-3497
2020,2,1,21,16723,17722,14330,-3392
2020,2,1,22,17079,18034,14753,-3281
2020,2,1,23,17962,18633,15219,-3414
2020,2,2,0,18235,18724,15530,-3194
2020,2,2,1,17914,18380,15264,-3116
2020,2,2,2,17557,17963,14718,-3245
2020,2,2,3,17101,17406,14075,-3331
2020,2,2,4,16357,16640,13381,-3259
2020,2,2,5,15593,15786,12462,-3324
2020,2,2,6,14872,15084,11583,-3501
2020,2,2,7,14364,14577,11353,-3224
2020,2,2,8,14037,14244,11190,-3054
2020,2,2,9,13872,14084,11103,-2981
2020,2,2,10,13902,14116,11153,-2963
2020,2,2,11,14168,14327,11283,-3044
2020,2,2,12,14714,14811,11897,-2914
2020,2,2,13,15193,15407,12495,-2912
2020,2,2,14,15713,16083,13114,-2969
2020,2,2,15,16114,16569,13475,-3094
2020,2,2,16,16327,16814,13481,-3333
2020,2,2,17,16393,17088,13670,-3418
2020,2,2,18,16381,17264,13840,-3424
2020,2,2,19,16365,17314,13981,-3333
2020,2,2,20,16403,17355,14071,-3284
2020,2,2,21,16591,17635,14107,-3528
2020,2,2,22,17070,18223,14634,-3589
2020,2,2,23,18063,18966,15345,-3621
2020,2,3,0,18381,18832,15438,-3394
2020,2,3,1,18012,18280,14999,-3281
2020,2,3,2,17591,17794,14632,-3162
2020,2,3,3,17024,17246,13821,-3425
2020,2,3,4,16165,16464,12998,-3466
2020,2,3,5,15269,15543,12611,-2932
2020,2,3,6,14333,14818,11816,-3002
2020,2,3,7,13896,14355,11609,-2746
2020,2,3,8,13678,14118,11619,-2499
2020,2,3,9,13628,14048,11745,-2303
2020,2,3,10,13916,14318,11762,-2556
2020,2,3,11,14875,15245,12358,-2887
2020,2,3,12,16616,16925,14103,-2822
2020,2,3,13,17732,18174,15191,-2983
2020,2,3,14,17948,18549,15945,-2604
2020,2,3,15,17921,18630,15801,-2829
2020,2,3,16,17821,18428,15597,-2831
2020,2,3,17,17604,18126,15020,-3106
2020,2,3,18,17378,17811,15019,-2792
2020,2,3,19,17277,17609,14742,-2867
2020,2,3,20,17234,17547,14892,-2655
2020,2,3,21,17403,17717,14953,-2764
2020,2,3,22,17898,18249,15556,-2693
2020,2,3,23,18933,19182,16465,-2717
2020,2,4,0,19337,19495,16751,-2744
2020,2,4,1,18977,19143,16454,-2689
2020,2,4,2,18430,18579,15708,-2871
2020,2,4,3,17597,17733,14901,-2832
2020,2,4,4,16387,16595,13947,-2648
2020,2,4,5,15250,15548,12846,-2702
2020,2,4,6,14485,14799,12023,-2776
2020,2,4,7,14031,14369,11876,-2493
2020,2,4,8,13782,14163,11912,-2251
2020,2,4,9,13718,14083,11910,-2173
2020,2,4,10,13960,14321,12081,-2240
2020,2,4,11,14855,15188,12655,-2533
2020,2,4,12,16506,16890,14395,-2495
2020,2,4,13,17619,18022,15459,-2563
2020,2,4,14,17993,18399,15718,-2681
2020,2,4,15,18183,18619,16172,-2447
2020,2,4,16,18255,18788,16045,-2743
2020,2,4,17,18211,18700,15958,-2742
2020,2,4,18,18077,18559,15355,-3204
2020,2,4,19,17994,18467,15623,-2844
2020,2,4,20,17876,18332,15181,-3151
2020,2,4,21,17906,18381,15666,-2715
2020,2,4,22,18243,18734,16111,-2623
2020,2,4,23,19036,19523,16301,-3222
2020,2,5,0,19207,19625,16248,-3377
2020,2,5,1,18811,19232,15921,-3311
2020,2,5,2,18224,18597,15390,-3207
2020,2,5,3,17407,17681,14446,-3235
2020,2,5,4,16242,16497,13474,-3023
2020,2,5,5,15131,15380,12390,-2990
2020,2,5,6,14297,14608,11571,-3037
2020,2,5,7,13897,14164,11389,-2775
2020,2,5,8,13686,13986,11311,-2675
2020,2,5,9,13662,13999,11355,-2644
2020,2,5,10,13958,14292,11440,-2852
2020,2,5,11,14883,15258,12267,-2991
2020,2,5,12,16568,17052,14013,-3039
2020,2,5,13,17689,18282,15686,-2596
2020,2,5,14,18049,18697,15696,-3001
2020,2,5,15,18204,18851,15668,-3183
2020,2,5,16,18214,18787,15488,-3299
2020,2,5,17,18116,18687,15029,-3658
2020,2,5,18,17966,18505,14848,-3657
2020,2,5,19,17931,18441,14938,-3503
2020,2,5,20,17884,18387,14790,-3597
2020,2,5,21,18004,18553,15105,-3448
2020,2,5,22,18424,19155,15690,-3465
2020,2,5,23,19286,20032,16523,-3509
2020,2,6,0,19610,20179,16521,-3658
2020,2,6,1,19259,19837,16307,-3530
2020,2,6,2,18728,19252,16279,-2973
2020,2,6,3,17945,18384,15551,-2833
2020,2,6,4,16824,17202,14058,-3144
2020,2,6,5,15750,16084,13601,-2483
2020,2,6,6,14776,15290,12650,-2640
2020,2,6,7,14263,14891,12460,-2431
2020,2,6,8,13980,14687,12423,-2264
2020,2,6,9,13885,14665,12250,-2415
2020,2,6,10,14134,14945,12171,-2774
2020,2,6,11,15025,15750,12629,-3121
2020,2,6,12,16698,17307,14347,-2960
2020,2,6,13,17844,18580,15791,-2789
2020,2,6,14,18373,19098,15831,-3267
2020,2,6,15,18622,19444,15841,-3603
2020,2,6,16,18710,19602,16317,-3285
2020,2,6,17,18657,19627,16190,-3437
2020,2,6,18,18519,19564,16168,-3396
2020,2,6,19,18440,19547,16161,-3386
2020,2,6,20,18316,19448,15871,-3577
2020,2,6,21,18320,19497,16036,-3461
2020,2,6,22,18589,19798,16348,-3450
2020,2,6,23,19220,20431,16575,-3856
2020,2,7,0,19490,20416,16475,-3941
2020,2,7,1,19062,19967,16354,-3613
2020,2,7,2,18467,19328,15735,-3593
2020,2,7,3,17625,18425,14852,-3573
2020,2,7,4,16447,17258,13901,-3357
2020,2,7,5,15309,16104,12523,-3581
2020,2,7,6,14575,15354,12106,-3248
2020,2,7,7,14069,14883,11794,-3089
2020,2,7,8,13778,14609,11657,-2952
2020,2,7,9,13691,14535,11479,-3056
2020,2,7,10,13920,14772,11678,-3094
2020,2,7,11,14760,15598,12878,-2720
2020,2,7,12,16338,17094,14411,-2683
2020,2,7,13,17462,18308,15663,-2645
2020,2,7,14,18014,18884,15666,-3218
2020,2,7,15,18322,19237,15917,-3320
2020,2,7,16,18443,19462,16023,-3439
2020,2,7,17,18394,19426,15889,-3537
2020,2,7,18,18240,19243,15614,-3629
2020,2,7,19,18115,19130,15584,-3546
2020,2,7,20,18034,19034,15516,-3518
2020,2,7,21,18085,19137,15660,-3477
2020,2,7,22,18426,19428,15880,-3548
2020,2,7,23,19136,20140,16175,-3965
2020,2,8,0,19462,20333,16540,-3793
2020,2,8,1,19070,19940,16309,-3631
2020,2,8,2,18565,19363,16194,-3169
2020,2,8,3,17969,18681,15714,-2967
2020,2,8,4,17091,17759,14428,-3331
2020,2,8,5,16183,16789,13723,-3066
2020,2,8,6,15763,16070,12981,-3089
2020,2,8,7,15289,15579,12587,-2992
2020,2,8,8,14996,15299,12297,-3002
2020,2,8,9,14881,15218,12351,-2867
2020,2,8,10,14952,15286,12541,-2745
2020,2,8,11,15326,15634,12814,-2820
2020,2,8,12,16044,16278,13469,-2809
2020,2,8,13,16640,16934,14062,-2872
2020,2,8,14,17106,17460,14548,-2912
2020,2,8,15,17410,17701,14766,-2935
2020,2,8,16,17503,17818,14706,-3112
2020,2,8,17,17454,17853,14839,-3014
2020,2,8,18,17306,17816,14649,-3167
2020,2,8,19,17177,17709,14530,-3179
2020,2,8,20,17140,17666,14569,-3097
2020,2,8,21,17246,17729,14651,-3078
2020,2,8,22,17644,18109,15429,-2680
2020,2,8,23,18544,18910,16395,-2515
2020,2,9,0,19127,19388,16686,-2702
2020,2,9,1,18882,19143,16399,-2744
2020,2,9,2,18593,18795,16388,-2407
2020,2,9,3,18095,18261,15896,-2365
2020,2,9,4,17353,17579,15251,-2328
2020,2,9,5,16608,16858,14761,-2097
2020,2,9,6,15940,16193,13696,-2497
2020,2,9,7,15466,15709,13322,-2387
2020,2,9,8,15146,15410,13179,-2231
2020,2,9,9,14973,15244,13123,-2121
2020,2,9,10,14983,15260,13177,-2083
2020,2,9,11,15217,15488,13591,-1897
2020,2,9,12,15685,15951,14305,-1646
2020,2,9,13,16067,16364,15158,-1206
2020,2,9,14,16566,16903,15374,-1529
2020,2,9,15,16883,17250,15333,-1917
2020,2,9,16,17014,17373,14954,-2419
2020,2,9,17,17017,17358,14789,-2569
2020,2,9,18,16922,17270,14405,-2865
2020,2,9,19,16828,17179,13946,-3233
2020,2,9,20,16796,17176,14152,-3024
2020,2,9,21,16950,17394,14542,-2852
2020,2,9,22,17400,17920,15257,-2663
2020,2,9,23,18276,18868,16164,-2704
2020,2,10,0,18689,19227,16482,-2745
2020,2,10,1,18427,18993,16428,-2565
2020,2,10,2,17980,18498,16166,-2332
2020,2,10,3,17373,17767,15502,-2265
2020,2,10,4,16528,16813,14566,-2247
2020,2,10,5,15647,15833,13437,-2396
2020,2,10,6,14818,15120,12164,-2956
2020,2,10,7,14371,14689,11990,-2699
2020,2,10,8,14142,14418,12037,-2381
2020,2,10,9,14073,14356,12073,-2283
2020,2,10,10,14325,14609,12575,-2034
2020,2,10,11,15228,15524,13519,-2005
2020,2,10,12,16847,17131,15291,-1840
2020,2,10,13,17956,18352,16515,-1837
2020,2,10,14,18382,18826,16884,-1942
2020,2,10,15,18663,19118,17041,-2077
2020,2,10,16,18816,19177,16542,-2635
2020,2,10,17,18775,19037,16349,-2688
2020,2,10,18,18658,19022,16418,-2604
2020,2,10,19,18569,19088,16200,-2888
2020,2,10,20,18459,19010,15717,-3293
2020,2,10,21,18512,19076,15895,-3181
2020,2,10,22,18846,19445,16386,-3059
2020,2,10,23,19478,20008,16707,-3301
2020,2,11,0,19810,20051,16711,-3340
2020,2,11,1,19451,19595,16587,-3008
2020,2,11,2,18834,18959,16513,-2446
2020,2,11,3,17951,18010,15335,-2675
2020,2,11,4,16771,16779,13945,-2834
2020,2,11,5,15668,15657,13224,-2433
2020,2,11,6,14803,14820,12439,-2381
2020,2,11,7,14329,14378,12110,-2268
2020,2,11,8,14065,14103,12045,-2058
2020,2,11,9,13991,14025,12030,-1995
2020,2,11,10,14222,14276,12329,-1947
2020,2,11,11,15101,15205,13019,-2186
2020,2,11,12,16708,16906,15005,-1901
2020,2,11,13,17807,18116,15958,-2158
2020,2,11,14,18226,18556,16088,-2468
2020,2,11,15,18470,18792,16029,-2763
2020,2,11,16,18564,18900,15675,-3225
2020,2,11,17,18525,18946,15949,-2997
2020,2,11,18,18408,18851,15747,-3104
2020,2,11,19,18349,18837,15813,-3024
2020,2,11,20,18243,18687,15447,-3240
2020,2,11,21,18273,18604,15291,-3313
2020,2,11,22,18597,18917,15772,-3145
2020,2,11,23,19254,19588,16599,-2989
2020,2,12,0,19628,19824,16782,-3042
2020,2,12,1,19232,19489,16523,-2966
2020,2,12,2,18631,18957,16469,-2488
2020,2,12,3,17784,18065,15603,-2462
2020,2,12,4,16645,16932,14751,-2181
2020,2,12,5,15555,15834,13869,-1965
2020,2,12,6,14744,15046,13349,-1697
2020,2,12,7,14306,14631,13268,-1363
2020,2,12,8,14072,14397,13099,-1298
2020,2,12,9,14031,14396,12929,-1467
2020,2,12,10,14326,14661,13034,-1627
2020,2,12,11,15268,15554,13824,-1730
2020,2,12,12,16962,17305,15294,-2011
2020,2,12,13,18008,18317,16293,-2024
2020,2,12,14,18257,18418,16199,-2219
2020,2,12,15,18281,18279,15952,-2327
2020,2,12,16,18172,18041,15301,-2740
2020,2,12,17,18010,17760,14781,-2979
2020,2,12,18,17824,17655,14561,-3094
2020,2,12,19,17795,17629,14482,-3147
2020,2,12,20,17801,17808,14791,-3017
2020,2,12,21,17988,18165,15531,-2634
2020,2,12,22,18437,18703,16385,-2318
2020,2,12,23,19169,19564,17549,-2015
2020,2,13,0,19627,19839,17306,-2533
2020,2,13,1,19298,19543,17414,-2129
2020,2,13,2,18740,18978,17133,-1845
2020,2,13,3,17884,18122,16246,-1876
2020,2,13,4,16726,16991,15079,-1912
2020,2,13,5,15605,15895,14454,-1441
2020,2,13,6,14605,15184,13232,-1952
2020,2,13,7,14105,14752,12624,-2128
2020,2,13,8,13822,14483,12541,-1942
2020,2,13,9,13733,14409,12560,-1849
2020,2,13,10,13976,14603,12518,-2085
2020,2,13,11,14861,15484,13175,-2309
2020,2,13,12,16480,17133,14694,-2439
2020,2,13,13,17591,18240,15767,-2473
2020,2,13,14,18117,18745,15781,-2964
2020,2,13,15,18354,19055,15968,-3087
2020,2,13,16,18411,19256,16599,-2657
2020,2,13,17,18318,19285,16755,-2530
2020,2,13,18,18136,19215,16657,-2558
2020,2,13,19,18032,19214,16441,-2773
2020,2,13,20,17926,19149,16596,-2553
2020,2,13,21,17967,19134,16571,-2563
2020,2,13,22,18282,19336,16833,-2503
2020,2,13,23,18928,19948,17190,-2758
2020,2,14,0,19477,20183,17544,-2639
2020,2,14,1,19166,19877,17550,-2327
2020,2,14,2,18666,19386,17086,-2300
2020,2,14,3,17887,18631,16358,-2273
2020,2,14,4,16814,17567,15256,-2311
2020,2,14,5,15759,16452,14266,-2186
2020,2,14,6,15033,15675,13511,-2164
2020,2,14,7,14640,15252,12970,-2282
2020,2,14,8,14447,15011,13143,-1868
2020,2,14,9,14466,15036,13130,-1906
2020,2,14,10,14781,15346,13464,-1882
2020,2,14,11,15718,16212,14440,-1772
2020,2,14,12,17325,17897,16691,-1206
2020,2,14,13,18373,19017,17300,-1717
2020,2,14,14,18749,19313,16918,-2395
2020,2,14,15,18861,19421,16299,-3122
2020,2,14,16,18811,19293,15758,-3535
2020,2,14,17,18691,19160,15440,-3720
2020,2,14,18,18536,18982,15183,-3799
2020,2,14,19,18436,18872,15323,-3549
2020,2,14,20,18415,18805,14953,-3852
2020,2,14,21,18590,19057,15479,-3578
2020,2,14,22,19056,19648,16611,-3037
2020,2,14,23,19877,20485,17885,-2600
2020,2,15,0,20433,21027,18360,-2667
2020,2,15,1,20201,20811,17672,-3139
2020,2,15,2,19755,20400,17638,-2762
2020,2,15,3,19082,19813,16787,-3026
2020,2,15,4,18206,19015,16159,-2856
2020,2,15,5,17333,18171,15165,-3006
2020,2,15,6,16890,17525,14794,-2731
2020,2,15,7,16456,17088,14613,-2475
2020,2,15,8,16175,16846,14318,-2528
2020,2,15,9,16041,16728,14207,-2521
2020,2,15,10,16097,16799,14742,-2057
2020,2,15,11,16407,17151,14905,-2246
2020,2,15,12,16973,17855,15637,-2218
2020,2,15,13,17427,18427,16036,-2391
2020,2,15,14,17847,18787,16277,-2510
2020,2,15,15,17965,18837,16415,-2422
2020,2,15,16,17869,18731,16035,-2696
2020,2,15,17,17701,18506,15649,-2857
2020,2,15,18,17479,18192,15110,-3082
2020,2,15,19,17318,17970,14609,-3361
2020,2,15,20,17323,17995,14690,-3305
2020,2,15,21,17507,18224,14957,-3267
2020,2,15,22,17923,18765,15927,-2838
2020,2,15,23,18682,19582,17082,-2500
2020,2,16,0,19217,20060,17334,-2726
2020,2,16,1,19021,19782,17176,-2606
2020,2,16,2,18600,19338,16941,-2397
2020,2,16,3,18015,18672,16110,-2562
2020,2,16,4,17268,17853,15307,-2546
2020,2,16,5,16507,16957,14937,-2020
2020,2,16,6,15812,16174,14512,-1662
2020,2,16,7,15251,15634,13932,-1702
2020,2,16,8,14876,15304,13501,-1803
2020,2,16,9,14668,15080,13518,-1562
2020,2,16,10,14632,15016,13461,-1555
2020,2,16,11,14782,15179,13931,-1248
2020,2,16,12,15041,15577,14404,-1173
2020,2,16,13,15333,15983,14919,-1064
2020,2,16,14,15898,16644,15353,-1291
2020,2,16,15,16350,17086,15406,-1680
2020,2,16,16,16542,17230,15261,-1969
2020,2,16,17,16705,17391,15122,-2269
2020,2,16,18,16622,17399,15026,-2373
2020,2,16,19,16530,17164,14818,-2346
2020,2,16,20,16510,17147,14754,-2393
2020,2,16,21,16676,17242,15111,-2131
2020,2,16,22,17133,17535,15336,-2199
2020,2,16,23,17932,18251,16418,-1833
2020,2,17,0,18501,18741,16843,-1898
2020,2,17,1,18231,18515,16646,-1869
2020,2,17,2,17824,18069,16324,-1745
2020,2,17,3,17213,17492,15819,-1673
2020,2,17,4,16437,16726,15231,-1495
2020,2,17,5,15629,15843,14357,-1486
2020,2,17,6,14921,15192,13582,-1610
2020,2,17,7,14498,14766,13297,-1469
2020,2,17,8,14265,14545,12998,-1547
2020,2,17,9,14197,14479,13237,-1242
2020,2,17,10,14394,14723,13343,-1380
2020,2,17,11,15051,15376,13956,-1420
2020,2,17,12,16076,16441,14882,-1559
2020,2,17,13,16773,17172,15489,-1683
2020,2,17,14,17142,17532,15880,-1652
2020,2,17,15,17400,17631,15847,-1784
2020,2,17,16,17463,17553,14998,-2555
2020,2,17,17,17369,17441,14634,-2807
2020,2,17,18,17148,17240,14538,-2702
2020,2,17,19,17024,17107,14708,-2399
2020,2,17,20,17014,17000,14850,-2150
2020,2,17,21,17172,17121,15001,-2120
2020,2,17,22,17665,17738,15730,-2008
2020,2,17,23,18568,18723,16782,-1941
2020,2,18,0,19292,19409,17185,-2224
2020,2,18,1,19089,19145,17172,-1973
2020,2,18,2,18629,18683,16891,-1792
2020,2,18,3,17934,17963,15744,-2219
2020,2,18,4,16963,17074,14828,-2246
2020,2,18,5,16001,16118,13949,-2169
2020,2,18,6,15207,15407,13461,-1946
2020,2,18,7,14807,15001,13299,-1702
2020,2,18,8,14572,14750,12996,-1754
2020,2,18,9,14500,14711,13242,-1469
2020,2,18,10,14722,14935,13783,-1152
2020,2,18,11,15550,15732,14144,-1588
2020,2,18,12,17006,17097,15736,-1361
2020,2,18,13,17990,18133,17245,-888
2020,2,18,14,18353,18755,18102,-653
2020,2,18,15,18568,19298,17930,-1368
2020,2,18,16,18653,19501,17809,-1692
2020,2,18,17,18622,19520,17520,-2000
2020,2,18,18,18497,19387,17280,-2107
2020,2,18,19,18424,19404,17351,-2053
2020,2,18,20,18312,19305,17400,-1905
2020,2,18,21,18317,19249,17056,-2193
2020,2,18,22,18575,19460,16954,-2506
2020,2,18,23,19004,19957,17703,-2254
2020,2,19,0,19344,20023,17862,-2161
2020,2,19,1,19006,19543,17835,-1708
2020,2,19,2,18436,18901,17291,-1610
2020,2,19,3,17555,18013,16608,-1405
2020,2,19,4,16465,16918,15292,-1626
2020,2,19,5,15428,15817,14501,-1316
2020,2,19,6,14532,15022,14007,-1015
2020,2,19,7,14114,14530,13996,-534
2020,2,19,8,13897,14303,13737,-566
2020,2,19,9,13863,14265,13554,-711
2020,2,19,10,14151,14524,13803,-721
2020,2,19,11,15066,15378,14374,-1004
2020,2,19,12,16659,16790,15630,-1160
2020,2,19,13,17667,17852,16746,-1106
2020,2,19,14,17928,18070,16805,-1265
2020,2,19,15,17969,18041,17001,-1040
2020,2,19,16,17889,17973,16617,-1356
2020,2,19,17,17733,17895,16798,-1097
2020,2,19,18,17576,17719,16329,-1390
2020,2,19,19,17566,17719,16405,-1314
2020,2,19,20,17576,17722,16069,-1653
2020,2,19,21,17789,17940,16144,-1796
2020,2,19,22,18339,18580,16874,-1706
2020,2,19,23,19183,19517,17902,-1615
2020,2,20,0,19896,20110,18378,-1732
2020,2,20,1,19691,19847,17820,-2027
2020,2,20,2,19233,19371,17951,-1420
2020,2,20,3,18415,18629,16848,-1781
2020,2,20,4,17356,17648,15707,-1941
2020,2,20,5,16336,16614,14778,-1836
2020,2,20,6,15564,15867,13587,-2280
2020,2,20,7,15149,15475,13079,-2396
2020,2,20,8,14918,15283,13082,-2201
2020,2,20,9,14868,15259,13066,-2193
2020,2,20,10,15149,15508,13377,-2131
2020,2,20,11,16044,16373,14314,-2059
2020,2,20,12,17618,17749,15627,-2122
2020,2,20,13,18618,18612,16934,-1678
2020,2,20,14,18868,18913,16374,-2539
2020,2,20,15,18945,18965,16076,-2889
2020,2,20,16,18924,19064,16050,-3014
2020,2,20,17,18816,19155,16389,-2766
2020,2,20,18,18675,19093,16257,-2836
2020,2,20,19,18630,19037,15798,-3239
2020,2,20,20,18576,19012,15662,-3350
2020,2,20,21,18697,19096,16104,-2992
2020,2,20,22,19098,19561,17310,-2251
2020,2,20,23,19760,20301,17963,-2338
2020,2,21,0,20476,20856,18168,-2688
2020,2,21,1,20298,20575,17875,-2700
2020,2,21,2,19829,20061,17400,-2661
2020,2,21,3,18998,19314,16517,-2797
2020,2,21,4,17923,18389,15317,-3072
2020,2,21,5,16896,17414,14630,-2784
2020,2,21,6,16130,16665,13898,-2767
2020,2,21,7,15744,16271,13800,-2471
2020,2,21,8,15534,16083,13728,-2355
2020,2,21,9,15507,16066,13864,-2202
2020,2,21,10,15772,16353,14015,-2338
2020,2,21,11,16621,17165,14980,-2185
2020,2,21,12,18080,18484,16575,-1909
2020,2,21,13,18951,19369,17449,-1920
2020,2,21,14,19085,19566,16976,-2590
2020,2,21,15,18959,19470,16518,-2952
2020,2,21,16,18730,19353,16063,-3290
2020,2,21,17,18448,19067,15712,-3355
2020,2,21,18,18159,18794,15501,-3293
2020,2,21,19,18001,18617,15210,-3407
2020,2,21,20,17929,18400,15138,-3262
2020,2,21,21,18061,18488,15854,-2634
2020,2,21,22,18487,18988,16727,-2261
2020,2,21,23,19118,19752,17675,-2077
2020,2,22,0,19667,20291,17880,-2411
2020,2,22,1,19473,20051,17568,-2483
2020,2,22,2,19017,19566,17748,-1818
2020,2,22,3,18320,18870,16717,-2153
2020,2,22,4,17452,17956,15662,-2294
2020,2,22,5,16577,17058,15322,-1736
2020,2,22,6,15878,16311,14536,-1775
2020,2,22,7,15365,15810,13904,-1906
2020,2,22,8,15044,15532,13886,-1646
2020,2,22,9,14891,15415,14084,-1331
2020,2,22,10,14936,15481,13924,-1557
2020,2,22,11,15261,15785,14114,-1671
2020,2,22,12,15801,16341,14513,-1828
2020,2,22,13,16206,16764,15172,-1592
2020,2,22,14,16540,16952,15131,-1821
2020,2,22,15,16650,17010,15059,-1951
2020,2,22,16,16577,16931,14819,-2112
2020,2,22,17,16405,16700,14705,-1995
2020,2,22,18,16151,16391,14308,-2083
2020,2,22,19,15953,16100,14298,-1802
2020,2,22,20,15914,15981,14249,-1732
2020,2,22,21,16070,16117,14392,-1725
2020,2,22,22,16560,16637,15002,-1635
2020,2,22,23,17383,17498,15662,-1836
2020,2,23,0,18131,18245,16452,-1793
2020,2,23,1,18052,18086,16126,-1960
2020,2,23,2,17723,17804,15916,-1888
2020,2,23,3,17132,17320,15346,-1974
2020,2,23,4,16424,16645,14527,-2118
2020,2,23,5,15688,15881,14506,-1375
2020,2,23,6,15046,15224,13531,-1693
2020,2,23,7,14562,14781,13212,-1569
2020,2,23,8,14253,14545,13281,-1264
2020,2,23,9,14103,14414,13227,-1187
2020,2,23,10,14140,14427,13346,-1081
2020,2,23,11,14404,14722,13502,-1220
2020,2,23,12,14813,15118,13858,-1260
2020,2,23,13,15064,15407,13933,-1474
2020,2,23,14,15314,15543,14057,-1486
2020,2,23,15,15418,15613,14104,-1509
2020,2,23,16,15391,15506,13819,-1687
2020,2,23,17,15342,15393,13218,-2175
2020,2,23,18,15219,15317,12878,-2439
2020,2,23,19,15125,15195,12795,-2400
2020,2,23,20,15160,15208,12733,-2475
2020,2,23,21,15442,15494,13202,-2292
2020,2,23,22,16051,16119,13761,-2358
2020,2,23,23,16986,17167,14933,-2234
2020,2,24,0,17710,18052,15497,-2555
2020,2,24,1,17641,17979,15442,-2537
2020,2,24,2,17276,17547,14909,-2638
2020,2,24,3,16616,16877,14459,-2418
2020,2,24,4,15840,15968,13846,-2122
2020,2,24,5,15036,15095,13725,-1370
2020,2,24,6,14387,14434,13407,-1027
2020,2,24,7,14017,14076,13126,-950
2020,2,24,8,13831,13892,12957,-935
2020,2,24,9,13805,13898,12919,-979
2020,2,24,10,14102,14233,13331,-902
2020,2,24,11,15046,15277,14506,-771
2020,2,24,12,16613,16971,16098,-873
2020,2,24,13,17526,17805,16609,-1196
2020,2,24,14,17610,17699,16374,-1325
2020,2,24,15,17551,17412,15716,-1696
2020,2,24,16,17459,17195,15259,-1936
2020,2,24,17,17284,16937,14855,-2082
2020,2,24,18,17114,16768,14744,-2024
2020,2,24,19,17106,16677,14725,-1952
2020,2,24,20,17134,16706,14701,-2005
2020,2,24,21,17324,17074,14978,-2096
2020,2,24,22,17773,17531,15177,-2354
2020,2,24,23,18374,18385,16351,-2034
2020,2,25,0,18953,18977,16970,-2007
2020,2,25,1,18798,18681,16879,-1802
2020,2,25,2,18200,18089,16182,-1907
2020,2,25,3,17267,17217,15464,-1753
2020,2,25,4,16143,16083,14503,-1580
2020,2,25,5,15092,14971,13439,-1532
2020,2,25,6,14321,14244,11942,-2302
2020,2,25,7,13899,13828,11720,-2108
2020,2,25,8,13662,13628,11710,-1918
2020,2,25,9,13601,13579,11678,-1901
2020,2,25,10,13840,13852,11781,-2071
2020,2,25,11,14705,14770,12395,-2375
2020,2,25,12,16172,16471,14156,-2315
2020,2,25,13,17218,17553,15104,-2449
2020,2,25,14,17638,17954,15478,-2476
2020,2,25,15,17869,18171,15402,-2769
2020,2,25,16,17963,18176,15312,-2864
2020,2,25,17,17914,18007,14887,-3120
2020,2,25,18,17776,18033,14879,-3154
2020,2,25,19,17733,17943,14657,-3286
2020,2,25,20,17679,17840,14767,-3073
2020,2,25,21,17755,17900,14849,-3051
2020,2,25,22,18064,18202,15526,-2676
2020,2,25,23,18493,18653,15854,-2799
2020,2,26,0,18957,19047,16354,-2693
2020,2,26,1,18721,18860,15939,-2921
2020,2,26,2,18088,18308,15467,-2841
2020,2,26,3,17184,17428,14493,-2935
2020,2,26,4,16105,16303,13541,-2762
2020,2,26,5,15073,15218,12825,-2393
2020,2,26,6,14134,14422,12464,-1958
2020,2,26,7,13696,13994,12176,-1818
2020,2,26,8,13444,13735,11974,-1761
2020,2,26,9,13370,13662,11862,-1800
2020,2,26,10,13623,13933,12108,-1825
2020,2,26,11,14483,14866,12802,-2064
2020,2,26,12,15976,16572,14220,-2352
2020,2,26,13,17046,17677,15384,-2293
2020,2,26,14,17536,18179,15487,-2692
2020,2,26,15,17814,18414,16148,-2266
2020,2,26,16,17936,18505,16119,-2386
2020,2,26,17,17929,18488,16287,-2201
2020,2,26,18,17826,18444,16363,-2081
2020,2,26,19,17804,18437,16434,-2003
2020,2,26,20,17742,18360,16148,-2212
2020,2,26,21,17803,18372,16247,-2125
2020,2,26,22,18094,18663,16400,-2263
2020,2,26,23,18430,19187,16753,-2434
2020,2,27,0,18964,19457,17114,-2343
2020,2,27,1,18674,19117,16821,-2296
2020,2,27,2,18035,18560,16402,-2158
2020,2,27,3,17095,17753,15546,-2207
2020,2,27,4,15992,16597,14659,-1938
2020,2,27,5,14931,15462,13901,-1561
2020,2,27,6,14020,14631,13177,-1454
2020,2,27,7,13530,14220,13090,-1130
2020,2,27,8,13243,13987,12921,-1066
2020,2,27,9,13156,13931,12954,-977
2020,2,27,10,13407,14193,13057,-1136
2020,2,27,11,14282,15147,13591,-1556
2020,2,27,12,15799,16866,15257,-1609
2020,2,27,13,16899,17901,16412,-1489
2020,2,27,14,17397,18317,16749,-1568
2020,2,27,15,17599,18471,16534,-1937
2020,2,27,16,17646,18586,15902,-2684
2020,2,27,17,17549,18507,16018,-2489
2020,2,27,18,17426,18348,15938,-2410
2020,2,27,19,17438,18408,16504,-1904
2020,2,27,20,17492,18357,16313,-2044
2020,2,27,21,17693,18522,16525,-1997
2020,2,27,22,18125,19127,17425,-1702
2020,2,27,23,18723,19960,18057,-1903
2020,2,28,0,19519,20687,18535,-2152
2020,2,28,1,19340,20496,18172,-2324
2020,2,28,2,18769,19973,17941,-2032
2020,2,28,3,17886,19131,17558,-1573
2020,2,28,4,16814,18035,16282,-1753
2020,2,28,5,15775,16953,15163,-1790
2020,2,28,6,15243,16162,14204,-1958
2020,2,28,7,14787,15716,13834,-1882
2020,2,28,8,14515,15466,13800,-1666
2020,2,28,9,14445,15441,13730,-1711
2020,2,28,10,14693,15741,14080,-1661
2020,2,28,11,15545,16624,15031,-1593
2020,2,28,12,17008,18144,17170,-974
2020,2,28,13,18014,19028,17671,-1357
2020,2,28,14,18401,19254,17444,-1810
2020,2,28,15,18493,19244,17148,-2096
2020,2,28,16,18463,19107,16489,-2618
2020,2,28,17,18367,18914,16478,-2436
2020,2,28,18,18223,18753,16250,-2503
2020,2,28,19,18155,18706,16092,-2614
2020,2,28,20,18120,18623,16034,-2589
2020,2,28,21,18220,18784,16766,-2018
2020,2,28,22,18591,19158,17289,-1869
2020,2,28,23,19023,19762,18056,-1706
2020,2,29,0,19699,20157,18036,-2121
2020,2,29,1,19442,19837,17887,-1950
2020,2,29,2,18870,19315,17568,-1747
2020,2,29,3,18108,18619,16668,-1951
2020,2,29,4,17220,17697,15386,-2311
2020,2,29,5,16284,16678,14588,-2090
2020,2,29,6,15531,15983,13871,-2112
2020,2,29,7,15045,15524,13659,-1865
2020,2,29,8,14750,15288,13505,-1783
2020,2,29,9,14622,15148,13368,-1780
2020,2,29,10,14680,15218,13499,-1719
2020,2,29,11,15011,15560,13528,-2032
2020,2,29,12,15526,16152,14479,-1673
2020,2,29,13,16043,16694,15415,-1279
2020,2,29,14,16623,17180,16067,-1113
2020,2,29,15,17030,17355,16002,-1353
2020,2,29,16,17240,17556,16188,-1368
2020,2,29,17,17284,17691,16190,-1501
2020,2,29,18,17190,17708,16191,-1517
2020,2,29,19,17066,17539,16079,-1460
2020,2,29,20,17026,17451,15945,-1506
2020,2,29,21,17131,17665,15776,-1889
2020,2,29,22,17509,18160,16390,-1770
2020,2,29,23,18085,18821,17230,-1591
2020,3,1,0,18935,19554,17495,-2059
2020,3,1,1,18838,19423,17592,-1831
2020,3,1,2,18397,19081,17580,-1501
2020,3,1,3,17759,18549,16456,-2093
2020,3,1,4,17054,17785,15689,-2096
2020,3,1,5,16315,16967,14854,-2113
2020,3,1,6,15775,16314,13917,-2397
2020,3,1,7,15259,15851,13643,-2208
2020,3,1,8,14959,15522,13567,-1955
2020,3,1,9,14845,15365,13492,-1873
2020,3,1,10,14852,15348,13351,-1997
2020,3,1,11,15110,15587,13457,-2130
2020,3,1,12,15491,15981,14041,-1940
2020,3,1,13,15698,16322,14421,-1901
2020,3,1,14,16035,16529,14455,-2074
2020,3,1,15,16206,16542,14531,-2011
2020,3,1,16,16180,16511,14227,-2284
2020,3,1,17,16066,16371,14283,-2088
2020,3,1,18,15902,16189,14139,-2050
2020,3,1,19,15751,15990,14013,-1977
2020,3,1,20,15722,15894,13885,-2009
2020,3,1,21,15947,16199,14293,-1906
2020,3,1,22,16557,16861,14530,-2331
2020,3,1,23,17422,17856,15455,-2401
2020,3,2,0,18482,18788,16047,-2741
2020,3,2,1,18611,18748,16232,-2516
2020,3,2,2,18297,18359,16423,-1936
2020,3,2,3,17582,17642,15754,-1888
2020,3,2,4,16582,16653,14820,-1833
2020,3,2,5,15607,15716,14239,-1477
2020,3,2,6,15030,15032,13269,-1763
2020,3,2,7,14643,14638,13457,-1181
2020,3,2,8,14431,14406,13266,-1140
2020,3,2,9,14382,14374,13275,-1099
2020,3,2,10,14645,14624,13464,-1160
2020,3,2,11,15551,15451,14152,-1299
2020,3,2,12,17090,17010,15765,-1245
2020,3,2,13,18048,17899,16670,-1229
2020,3,2,14,18187,18097,16657,-1440
2020,3,2,15,18139,18034,16770,-1264
2020,3,2,16,18024,17718,16205,-1513
2020,3,2,17,17813,17382,15757,-1625
2020,3,2,18,17580,17188,15785,-1403
2020,3,2,19,17486,17117,15767,-1350
2020,3,2,20,17453,17122,15780,-1342
2020,3,2,21,17609,17440,15930,-1510
2020,3,2,22,18039,17961,16381,-1580
2020,3,2,23,18500,18688,16730,-1958
2020,3,3,0,19048,19103,17302,-1801
2020,3,3,1,18937,18759,17788,-971
2020,3,3,2,18383,18107,17107,-1000
2020,3,3,3,17480,17176,15994,-1182
2020,3,3,4,16303,16015,15184,-831
2020,3,3,5,15193,14867,14021,-846
2020,3,3,6,14281,14077,13600,-477
2020,3,3,7,13842,13615,13160,-455
2020,3,3,8,13610,13356,12988,-368
2020,3,3,9,13556,13284,12578,-706
2020,3,3,10,13833,13527,12890,-637
2020,3,3,11,14751,14446,13705,-741
2020,3,3,12,16322,16031,15431,-600
2020,3,3,13,17294,16909,15723,-1186
2020,3,3,14,17471,17023,15558,-1465
2020,3,3,15,17503,16815,15406,-1409
2020,3,3,16,17473,16750,14988,-1762
2020,3,3,17,17404,17018,15225,-1793
2020,3,3,18,17305,17111,15247,-1864
2020,3,3,19,17322,17197,15330,-1867
2020,3,3,20,17331,17342,15385,-1957
2020,3,3,21,17480,17593,15712,-1881
2020,3,3,22,17850,18020,16183,-1837
2020,3,3,23,18150,18566,16821,-1745
2020,3,4,0,18692,18848,17030,-1818
2020,3,4,1,18529,18514,16871,-1643
2020,3,4,2,17977,17937,16826,-1111
2020,3,4,3,17105,17099,15789,-1310
2020,3,4,4,15963,15957,14190,-1767
2020,3,4,5,14880,14875,12837,-2038
2020,3,4,6,13864,14140,12714,-1426
2020,3,4,7,13424,13724,12738,-986
2020,3,4,8,13189,13508,12750,-758
2020,3,4,9,13142,13470,12845,-625
2020,3,4,10,13428,13726,12835,-891
2020,3,4,11,14392,14648,13429,-1219
2020,3,4,12,16020,16184,15254,-930
2020,3,4,13,16982,17128,15982,-1146
2020,3,4,14,17116,17330,15989,-1341
2020,3,4,15,17017,17290,16032,-1258
2020,3,4,16,16881,17079,15699,-1380
2020,3,4,17,16729,16865,15283,-1582
2020,3,4,18,16573,16727,15354,-1373
2020,3,4,19,16564,16841,15819,-1022
2020,3,4,20,16597,16955,15959,-996
2020,3,4,21,16838,17208,15797,-1411
2020,3,4,22,17401,17713,16251,-1462
2020,3,4,23,17965,18349,16875,-1474
2020,3,5,0,18731,18949,17636,-1313
2020,3,5,1,18566,18765,17105,-1660
2020,3,5,2,18090,18179,16391,-1788
2020,3,5,3,17230,17345,15519,-1826
2020,3,5,4,16071,16158,14137,-2021
2020,3,5,5,14971,15070,13443,-1627
2020,3,5,6,14037,14338,13280,-1058
2020,3,5,7,13628,13963,13001,-962
2020,3,5,8,13415,13795,12868,-927
2020,3,5,9,13394,13782,12801,-981
2020,3,5,10,13703,14074,13035,-1039
2020,3,5,11,14698,15048,13852,-1196
2020,3,5,12,16349,16625,15393,-1232
2020,3,5,13,17268,17428,15929,-1499
2020,3,5,14,17323,17538,15710,-1828
2020,3,5,15,17102,17348,15078,-2270
2020,3,5,16,16838,17121,14452,-2669
2020,3,5,17,16572,16872,14404,-2468
2020,3,5,18,16321,16611,14095,-2516
2020,3,5,19,16265,16489,14018,-2471
2020,3,5,20,16283,16451,14213,-2238
2020,3,5,21,16516,16663,14754,-1909
2020,3,5,22,17116,17181,15332,-1849
2020,3,5,23,17776,17939,15841,-2098
2020,3,6,0,18576,18713,16152,-2561
2020,3,6,1,18531,18631,16006,-2625
2020,3,6,2,18079,18203,15527,-2676
2020,3,6,3,17244,17385,14966,-2419
2020,3,6,4,16104,16322,14164,-2158
2020,3,6,5,15020,15293,13631,-1662
2020,3,6,6,14331,14525,12104,-2421
2020,3,6,7,13898,14111,12056,-2055
2020,3,6,8,13668,13885,11929,-1956
2020,3,6,9,13623,13873,12023,-1850
2020,3,6,10,13898,14195,12310,-1885
2020,3,6,11,14827,15118,13311,-1807
2020,3,6,12,16385,16625,15108,-1517
2020,3,6,13,17406,17484,15201,-2283
2020,3,6,14,17731,17704,14923,-2781
2020,3,6,15,17853,17821,14819,-3002
2020,3,6,16,17905,17897,14798,-3099
2020,3,6,17,17887,18017,15067,-2950
2020,3,6,18,17781,18110,14854,-3256
2020,3,6,19,17739,18248,15124,-3124
2020,3,6,20,17653,18265,15091,-3174
2020,3,6,21,17696,18386,14940,-3446
2020,3,6,22,17975,18681,15058,-3623
2020,3,6,23,18179,19076,15670,-3406
2020,3,7,0,18669,19277,16777,-2500
2020,3,7,1,18489,18930,16694,-2236
2020,3,7,2,17918,18397,16290,-2107
2020,3,7,3,17214,17668,15253,-2415
2020,3,7,4,16313,16745,14148,-2597
2020,3,7,5,15377,15713,13293,-2420
2020,3,7,6,14506,14969,12513,-2456
2020,3,7,7,14054,14493,12323,-2170
2020,3,7,8,13797,14171,12307,-1864
2020,3,7,9,13695,14098,12218,-1880
2020,3,7,10,13795,14186,12233,-1953
2020,3,7,11,14192,14622,12365,-2257
2020,3,7,12,14723,15256,13299,-1957
2020,3,7,13,15239,15861,13676,-2185
2020,3,7,14,15690,16274,13557,-2717
2020,3,7,15,15824,16325,13734,-2591
2020,3,7,16,15713,16268,13778,-2490
2020,3,7,17,15433,16117,13343,-2774
2020,3,7,18,15144,15814,13116,-2698
2020,3,7,19,14893,15544,13213,-2331
2020,3,7,20,14824,15427,13461,-1966
2020,3,7,21,15039,15597,13538,-2059
2020,3,7,22,15605,16193,13857,-2336
2020,3,7,23,16348,16994,14548,-2446
2020,3,8,0,17319,17894,15133,-2761
2020,3,8,1,17401,17934,15337,-2597
2020,3,8,2,17153,17636,15244,-2392
2020,3,8,3,16652,17105,14996,-2109
2020,3,8,4,15982,16391,14102,-2289
2020,3,8,5,15283,15605,13468,-2137
2020,3,8,6,14732,14935,12848,-2087
2020,3,8,7,14258,14499,12512,-1987
2020,3,8,8,13839,14264,12694,-1570
2020,3,8,9,13818,14143,12522,-1621
2020,3,8,10,13986,14276,12492,-1784
2020,3,8,11,14377,14648,13074,-1574
2020,3,8,12,14835,15046,13657,-1389
2020,3,8,13,15106,15402,13966,-1436
2020,3,8,14,15157,15473,13861,-1612
2020,3,8,15,15053,15384,13577,-1807
2020,3,8,16,14827,15239,13490,-1749
2020,3,8,17,14555,15155,13118,-2037
2020,3,8,18,14269,15006,13202,-1804
2020,3,8,19,14074,14814,13107,-1707
2020,3,8,20,14078,14727,12851,-1876
2020,3,8,21,14385,14987,12904,-2083
2020,3,8,22,14996,15563,13513,-2050
2020,3,8,23,15617,16237,13857,-2380
2020,3,9,0,16565,17107,14323,-2784
2020,3,9,1,16831,17081,14826,-2255
2020,3,9,2,16191,16453,14672,-1781
2020,3,9,3,15310,15597,14005,-1592
2020,3,9,4,14365,14653,12947,-1706
2020,3,9,5,13639,13911,12357,-1554
2020,3,9,6,13274,13458,12328,-1130
2020,3,9,7,13076,13210,12379,-831
2020,3,9,8,13045,13152,12282,-870
2020,3,9,9,13303,13353,12435,-918
2020,3,9,10,14168,14228,12989,-1239
2020,3,9,11,15815,15888,14577,-1311
2020,3,9,12,16993,17085,15810,-1275
2020,3,9,13,17074,17178,15765,-1413
2020,3,9,14,16831,16867,15520,-1347
2020,3,9,15,16561,16576,15094,-1482
2020,3,9,16,16251,16326,14684,-1642
2020,3,9,17,15958,16088,14079,-2009
2020,3,9,18,15785,15968,14106,-1862
2020,3,9,19,15657,15822,14045,-1777
2020,3,9,20,15725,15900,13928,-1972
2020,3,9,21,16031,16246,14128,-2118
2020,3,9,22,16435,16703,14761,-1942
2020,3,9,23,16658,17042,15038,-2004
2020,3,10,0,17347,17651,15486,-2165
2020,3,10,1,17307,17331,15474,-1857
2020,3,10,2,16483,16535,14840,-1695
2020,3,10,3,15398,15448,13950,-1498
2020,3,10,4,14339,14323,12863,-1460
2020,3,10,5,13486,13494,12032,-1462
2020,3,10,6,13008,13010,11509,-1501
2020,3,10,7,12734,12747,11545,-1202
2020,3,10,8,12644,12673,11578,-1095
2020,3,10,9,12856,12907,11712,-1195
2020,3,10,10,13673,13710,12471,-1239
2020,3,10,11,15315,15314,14110,-1204
2020,3,10,12,16572,16570,15401,-1169
2020,3,10,13,16855,17034,15610,-1424
2020,3,10,14,17009,17169,16024,-1145
2020,3,10,15,17085,17172,15914,-1258
2020,3,10,16,17063,17116,15938,-1178
2020,3,10,17,17006,17148,15602,-1546
2020,3,10,18,17003,17162,15366,-1796
2020,3,10,19,16912,17131,15168,-1963
2020,3,10,20,16898,17163,15394,-1769
2020,3,10,21,16996,17117,15607,-1510
2020,3,10,22,16966,17440,15823,-1617
2020,3,10,23,16992,17652,16263,-1389
2020,3,11,0,17557,17984,16569,-1415
2020,3,11,1,17464,17605,16389,-1216
2020,3,11,2,16607,16812,15711,-1101
2020,3,11,3,15496,15750,14921,-829
2020,3,11,4,14372,14546,13927,-619
2020,3,11,5,13389,13763,12708,-1055
2020,3,11,6,12953,13272,12382,-890
2020,3,11,7,12735,13046,12331,-715
2020,3,11,8,12705,12981,12181,-800
2020,3,11,9,12980,13241,12434,-807
2020,3,11,10,13896,14142,12857,-1285
2020,3,11,11,15641,15892,14405,-1487
2020,3,11,12,16843,17087,15455,-1632
2020,3,11,13,16957,17221,15672,-1549
2020,3,11,14,16816,17106,15692,-1414
2020,3,11,15,16633,16958,15309,-1649
2020,3,11,16,16403,16754,14990,-1764
2020,3,11,17,16217,16613,14893,-1720
2020,3,11,18,16197,16856,15215,-1641
2020,3,11,19,16165,16901,15418,-1483
2020,3,11,20,16253,16577,15121,-1456
2020,3,11,21,16522,16865,15048,-1817
2020,3,11,22,16716,17459,15530,-1929
2020,3,11,23,16930,17782,15888,-1894
2020,3,12,0,17556,18209,16440,-1769
2020,3,12,1,17529,17911,15833,-2078
2020,3,12,2,16714,17121,14758,-2363
2020,3,12,3,15602,16062,13664,-2398
2020,3,12,4,14504,14912,12895,-2017
2020,3,12,5,13638,14083,12030,-2053
2020,3,12,6,13190,13631,11675,-1956
2020,3,12,7,12943,13390,11492,-1898
2020,3,12,8,12890,13335,11581,-1754
2020,3,12,9,13137,13597,11876,-1721
2020,3,12,10,14042,14467,12851,-1616
2020,3,12,11,15785,16137,14306,-1831
2020,3,12,12,17010,17296,15444,-1852
2020,3,12,13,17282,17635,15301,-2334
2020,3,12,14,17202,17846,15595,-2251
2020,3,12,15,17021,17892,15663,-2229
2020,3,12,16,16822,17797,15747,-2050
2020,3,12,17,16609,17588,15318,-2270
2020,3,12,18,16506,17507,15213,-2294
2020,3,12,19,16376,17344,14696,-2648
2020,3,12,20,16376,17323,14599,-2724
2020,3,12,21,16570,17434,14700,-2734
2020,3,12,22,16708,17649,15080,-2569
2020,3,12,23,16782,17915,15487,-2428
2020,3,13,0,17477,18289,15570,-2719
2020,3,13,1,17448,17902,15852,-2050
2020,3,13,2,16610,17102,15434,-1668
2020,3,13,3,15478,16010,14583,-1427
2020,3,13,4,14334,14894,12728,-2166
2020,3,13,5,13621,14062,11471,-2591
2020,3,13,6,13147,13552,11650,-1902
2020,3,13,7,12854,13271,11633,-1638
2020,3,13,8,12743,13140,11493,-1647
2020,3,13,9,12928,13327,11436,-1891
2020,3,13,10,13717,14117,12034,-2083
2020,3,13,11,15308,15502,13635,-1867
2020,3,13,12,16540,16738,14788,-1950
2020,3,13,13,17017,17383,15158,-2225
2020,3,13,14,17274,17818,15602,-2216
2020,3,13,15,17400,17996,15470,-2526
2020,3,13,16,17318,17902,15359,-2543
2020,3,13,17,17084,17556,15089,-2467
2020,3,13,18,16843,16990,14758,-2232
2020,3,13,19,16501,16493,14473,-2020
2020,3,13,20,16297,16300,14208,-2092
2020,3,13,21,16296,16475,14560,-1915
2020,3,13,22,16387,16837,14939,-1898
2020,3,13,23,16465,17077,15276,-1801
2020,3,14,0,17017,17513,15721,-1792
2020,3,14,1,17014,17306,15290,-2016
2020,3,14,2,16380,16673,14805,-1868
2020,3,14,3,15535,15807,13862,-1945
2020,3,14,4,14596,14874,12741,-2133
2020,3,14,5,13877,14131,11912,-2219
2020,3,14,6,13388,13648,11296,-2352
2020,3,14,7,13096,13380,11238,-2142
2020,3,14,8,12968,13249,11149,-2100
2020,3,14,9,13017,13273,11082,-2191
2020,3,14,10,13354,13601,11529,-2072
2020,3,14,11,14008,14230,12608,-1622
2020,3,14,12,14699,14789,13182,-1607
2020,3,14,13,15154,15299,13436,-1863
2020,3,14,14,15361,15608,13565,-2043
2020,3,14,15,15372,15742,13477,-2265
2020,3,14,16,15248,15674,13329,-2345
2020,3,14,17,15029,15428,13221,-2207
2020,3,14,18,14831,15188,12987,-2201
2020,3,14,19,14718,15077,13073,-2004
2020,3,14,20,14772,15151,13191,-1960
2020,3,14,21,15006,15479,13489,-1990
2020,3,14,22,15249,16078,13986,-2092
2020,3,14,23,15519,16548,14340,-2208
2020,3,15,0,16214,17067,14584,-2483
2020,3,15,1,16402,16898,14298,-2600
2020,3,15,2,15932,16363,13769,-2594
2020,3,15,3,15273,15613,13084,-2529
2020,3,15,4,14506,14778,12065,-2713
2020,3,15,5,13712,14038,10925,-3113
2020,3,15,6,13254,13538,10717,-2821
2020,3,15,7,12988,13190,10759,-2431
2020,3,15,8,12904,13045,10705,-2340
2020,3,15,9,12913,13063,10813,-2250
2020,3,15,10,13138,13315,10927,-2388
2020,3,15,11,13585,13791,11514,-2277
2020,3,15,12,14024,14229,11914,-2315
2020,3,15,13,14439,14701,12172,-2529
2020,3,15,14,14604,15057,12390,-2667
2020,3,15,15,14550,15000,12386,-2614
2020,3,15,16,14424,14860,12280,-2580
2020,3,15,17,14232,14755,12374,-2381
2020,3,15,18,14033,14606,12206,-2400
2020,3,15,19,13921,14467,12437,-2030
2020,3,15,20,14000,14464,12086,-2378
2020,3,15,21,14346,14808,12859,-1949
2020,3,15,22,14953,15503,13589,-1914
2020,3,15,23,15574,16203,14035,-2168
2020,3,16,0,16514,17001,14347,-2654
2020,3,16,1,16772,17032,14628,-2404
2020,3,16,2,16231,16501,14346,-2155
2020,3,16,3,15427,15752,13952,-1800
2020,3,16,4,14601,14907,12656,-2251
2020,3,16,5,14045,14272,11664,-2608
2020,3,16,6,13725,13918,11329,-2589
2020,3,16,7,13560,13758,11223,-2535
2020,3,16,8,13560,13779,11250,-2529
2020,3,16,9,13854,14064,11567,-2497
2020,3,16,10,14774,14908,12501,-2407
2020,3,16,11,16453,16279,14678,-1601
2020,3,16,12,17570,17309,16024,-1285
2020,3,16,13,17731,17564,15762,-1802
2020,3,16,14,17521,17436,14683,-2753
2020,3,16,15,17260,17238,14287,-2951
2020,3,16,16,17012,17133,13699,-3434
2020,3,16,17,16751,16888,13753,-3135
2020,3,16,18,16626,16770,13824,-2946
2020,3,16,19,16546,16606,14112,-2494
2020,3,16,20,16614,16513,14266,-2247
2020,3,16,21,16884,16800,14693,-2107
2020,3,16,22,17194,17389,15237,-2152
2020,3,16,23,17360,17836,15590,-2246
2020,3,17,0,18031,18317,16237,-2080
2020,3,17,1,17986,17994,15923,-2071
2020,3,17,2,17207,17198,15633,-1565
2020,3,17,3,16091,16181,14566,-1615
2020,3,17,4,14963,15096,13834,-1262
2020,3,17,5,14066,14326,12522,-1804
2020,3,17,6,13599,13856,12055,-1801
2020,3,17,7,13337,13576,12081,-1495
2020,3,17,8,13252,13487,11861,-1626
2020,3,17,9,13479,13654,12141,-1513
2020,3,17,10,14325,14348,12613,-1735
2020,3,17,11,15941,15638,13793,-1845
2020,3,17,12,17089,16754,15667,-1087
2020,3,17,13,17489,17487,15967,-1520
2020,3,17,14,17664,17976,16178,-1798
2020,3,17,15,17723,18274,16536,-1738
2020,3,17,16,17648,18276,16318,-1958
2020,3,17,17,17480,18069,16081,-1988
2020,3,17,18,17343,17878,15974,-1904
2020,3,17,19,17147,17683,15479,-2204
2020,3,17,20,17051,17405,15262,-2143
2020,3,17,21,17100,17471,15607,-1864
2020,3,17,22,17121,17731,15859,-1872
2020,3,17,23,17161,17716,15847,-1869
2020,3,18,0,17754,17946,15803,-2143
2020,3,18,1,17709,17644,15637,-2007
2020,3,18,2,16918,16857,15328,-1529
2020,3,18,3,15808,15891,14515,-1376
2020,3,18,4,14692,14915,13324,-1591
2020,3,18,5,13865,14151,12004,-2147
2020,3,18,6,13456,13701,11654,-2047
2020,3,18,7,13235,13500,11589,-1911
2020,3,18,8,13199,13463,11478,-1985
2020,3,18,9,13482,13636,11532,-2104
2020,3,18,10,14432,14361,12206,-2155
2020,3,18,11,16179,15628,13411,-2217
2020,3,18,12,17217,16511,14436,-2075
2020,3,18,13,17226,16807,14973,-1834
2020,3,18,14,16936,16575,14145,-2430
2020,3,18,15,16628,16310,13712,-2598
2020,3,18,16,16342,16145,13604,-2541
2020,3,18,17,16092,16097,13922,-2175
2020,3,18,18,16020,16009,14143,-1866
2020,3,18,19,15968,15900,13980,-1920
2020,3,18,20,16062,15956,14034,-1922
2020,3,18,21,16348,16385,14561,-1824
2020,3,18,22,16659,16866,14918,-1948
2020,3,18,23,16928,17223,15168,-2055
2020,3,19,0,17539,17627,15797,-1830
2020,3,19,1,17592,17289,15536,-1753
2020,3,19,2,16848,16533,14666,-1867
2020,3,19,3,15733,15578,13824,-1754
2020,3,19,4,14599,14603,12846,-1757
2020,3,19,5,13701,13873,11679,-2194
2020,3,19,6,13250,13437,11430,-2007
2020,3,19,7,12989,13209,11373,-1836
2020,3,19,8,12916,13144,10985,-2159
2020,3,19,9,13138,13310,11101,-2209
2020,3,19,10,13994,13911,11487,-2424
2020,3,19,11,15647,15054,12994,-2060
2020,3,19,12,16795,16094,14462,-1632
2020,3,19,13,17217,16821,15213,-1608
2020,3,19,14,17399,17228,15607,-1621
2020,3,19,15,17439,17327,15600,-1727
2020,3,19,16,17354,17258,15665,-1593
2020,3,19,17,17192,17115,15716,-1399
2020,3,19,18,17088,17005,15708,-1297
2020,3,19,19,16921,16789,15223,-1566
2020,3,19,20,16839,16670,14921,-1749
2020,3,19,21,16896,16841,15226,-1615
2020,3,19,22,16878,17169,15567,-1602
2020,3,19,23,16796,17249,15456,-1793
2020,3,20,0,17339,17490,15585,-1905
2020,3,20,1,17295,17057,14930,-2127
2020,3,20,2,16544,16275,14378,-1897
2020,3,20,3,15442,15338,13689,-1649
2020,3,20,4,14336,14443,12328,-2115
2020,3,20,5,13400,13739,11336,-2403
2020,3,20,6,12917,13295,11186,-2109
2020,3,20,7,12617,12980,10840,-2140
2020,3,20,8,12507,12842,10756,-2086
2020,3,20,9,12688,12950,10966,-1984
2020,3,20,10,13499,13531,11750,-1781
2020,3,20,11,15112,14509,13043,-1466
2020,3,20,12,16292,15442,13972,-1470
2020,3,20,13,16794,16122,14501,-1621
2020,3,20,14,17091,16488,14984,-1504
2020,3,20,15,17224,16802,15000,-1802
2020,3,20,16,17202,16851,15478,-1373
2020,3,20,17,17071,16674,15200,-1474
2020,3,20,18,16936,16519,14916,-1603
2020,3,20,19,16730,16239,14434,-1805
2020,3,20,20,16592,15885,14091,-1794
2020,3,20,21,16536,15711,13714,-1997
2020,3,20,22,16443,16197,14064,-2133
2020,3,20,23,16359,16547,14444,-2103
2020,3,21,0,16722,16916,14968,-1948
2020,3,21,1,16727,16519,14900,-1619
2020,3,21,2,16185,15823,13890,-1933
2020,3,21,3,15373,15063,13166,-1897
2020,3,21,4,14420,14240,12698,-1542
2020,3,21,5,13566,13495,11669,-1826
2020,3,21,6,13048,13010,11412,-1598
2020,3,21,7,12758,12708,11280,-1428
2020,3,21,8,12636,12580,11054,-1526
2020,3,21,9,12697,12607,10769,-1838
2020,3,21,10,13046,12921,11198,-1723
2020,3,21,11,13700,13542,11463,-2079
2020,3,21,12,14353,14023,12042,-1981
2020,3,21,13,14897,14443,12357,-2086
2020,3,21,14,15211,14659,12548,-2111
2020,3,21,15,15242,14711,12572,-2139
2020,3,21,16,15051,14656,12577,-2079
2020,3,21,17,14758,14467,12274,-2193
2020,3,21,18,14466,14221,12023,-2198
2020,3,21,19,14291,14002,12145,-1857
2020,3,21,20,14291,13919,11842,-2077
2020,3,21,21,14521,14248,12344,-1904
2020,3,21,22,15016,14949,13093,-1856
2020,3,21,23,15475,15659,13879,-1780
2020,3,22,0,16203,16471,14154,-2317
2020,3,22,1,16407,16541,14432,-2109
2020,3,22,2,16033,16022,14205,-1817
2020,3,22,3,15401,15409,13928,-1481
2020,3,22,4,14678,14686,13099,-1587
2020,3,22,5,13983,14062,11431,-2631
2020,3,22,6,13509,13629,11140,-2489
2020,3,22,7,13273,13360,11102,-2258
2020,3,22,8,13222,13243,11050,-2193
2020,3,22,9,13264,13292,11072,-2220
2020,3,22,10,13540,13553,11162,-2391
2020,3,22,11,14029,14004,11866,-2138
2020,3,22,12,14391,14338,12309,-2029
2020,3,22,13,14787,14625,12608,-2017
2020,3,22,14,14861,14686,12554,-2132
2020,3,22,15,14750,14707,12530,-2177
2020,3,22,16,14546,14714,12097,-2617
2020,3,22,17,14341,14674,11875,-2799
2020,3,22,18,14130,14482,11474,-3008
2020,3,22,19,14025,14268,11594,-2674
2020,3,22,20,14118,14224,11659,-2565
2020,3,22,21,14480,14608,12310,-2298
2020,3,22,22,15089,15444,13233,-2211
2020,3,22,23,15730,16121,14129,-1992
2020,3,23,0,16629,16896,14828,-2068
2020,3,23,1,16902,16864,15196,-1668
2020,3,23,2,16402,16296,14745,-1551
2020,3,23,3,15549,15545,14445,-1100
2020,3,23,4,14638,14741,13399,-1342
2020,3,23,5,13538,14113,12537,-1576
2020,3,23,6,13152,13677,12345,-1332
2020,3,23,7,12945,13410,12343,-1067
2020,3,23,8,12903,13319,12348,-971
2020,3,23,9,13169,13452,12574,-878
2020,3,23,10,14079,14060,13220,-840
2020,3,23,11,15753,15070,14453,-617
2020,3,23,12,16945,15965,15725,-240
2020,3,23,13,17490,16807,16073,-734
2020,3,23,14,17661,17422,16210,-1212
2020,3,23,15,17765,17847,16084,-1763
2020,3,23,16,17769,18109,16273,-1836
2020,3,23,17,17644,18371,16364,-2007
2020,3,23,18,17539,18404,15624,-2780
2020,3,23,19,17375,18271,15291,-2980
2020,3,23,20,17290,18163,15265,-2898
2020,3,23,21,17363,18249,15340,-2909
2020,3,23,22,17477,18451,15590,-2861
2020,3,23,23,17432,18314,15543,-2771
2020,3,24,0,17929,18292,15527,-2765
2020,3,24,1,17730,17806,15167,-2639
2020,3,24,2,16895,17002,15007,-1995
2020,3,24,3,15748,16040,14186,-1854
2020,3,24,4,14615,15092,13376,-1716
2020,3,24,5,13795,14331,11772,-2559
2020,3,24,6,13336,13830,11446,-2384
2020,3,24,7,13087,13566,11120,-2446
2020,3,24,8,13017,13471,10988,-2483
2020,3,24,9,13261,13611,11077,-2534
2020,3,24,10,14152,14158,11661,-2497
2020,3,24,11,15825,15134,12707,-2427
2020,3,24,12,16878,15865,13927,-1938
2020,3,24,13,17099,16323,14266,-2057
2020,3,24,14,17022,16374,14623,-1751
2020,3,24,15,16831,16254,14476,-1778
2020,3,24,16,16568,16172,14228,-1944
2020,3,24,17,16284,16110,13798,-2312
2020,3,24,18,16107,15898,13795,-2103
2020,3,24,19,15942,15708,13725,-1983
2020,3,24,20,15898,15571,13679,-1892
2020,3,24,21,16036,15751,13831,-1920
2020,3,24,22,16374,16252,14183,-2069
2020,3,24,23,16740,16596,14380,-2216
2020,3,25,0,17226,17071,14760,-2311
2020,3,25,1,17277,16892,14847,-2045
2020,3,25,2,16573,16222,14325,-1897
2020,3,25,3,15497,15433,13304,-2129
2020,3,25,4,14393,14586,12340,-2246
2020,3,25,5,13693,13896,11093,-2803
2020,3,25,6,13297,13483,11047,-2436
2020,3,25,7,13071,13227,11039,-2188
2020,3,25,8,13020,13183,11110,-2073
2020,3,25,9,13268,13337,11030,-2307
2020,3,25,10,14151,13912,11434,-2478
2020,3,25,11,15801,14890,12693,-2197
2020,3,25,12,16872,15689,14178,-1511
2020,3,25,13,17177,16329,14894,-1435
2020,3,25,14,17233,16618,14970,-1648
2020,3,25,15,17199,16709,14984,-1725
2020,3,25,16,17084,16716,14867,-1849
2020,3,25,17,16907,16715,14765,-1950
2020,3,25,18,16799,16699,14563,-2136
2020,3,25,19,16638,16507,14403,-2104
2020,3,25,20,16571,16274,14328,-1946
2020,3,25,21,16675,16319,14341,-1978
2020,3,25,22,16947,16621,14516,-2105
2020,3,25,23,17087,16832,14767,-2065
2020,3,26,0,17553,17128,14914,-2214
2020,3,26,1,17508,16916,14969,-1947
2020,3,26,2,16767,16248,14330,-1918
2020,3,26,3,15680,15402,13496,-1906
2020,3,26,4,14561,14562,12729,-1833
2020,3,26,5,13516,13899,11523,-2376
2020,3,26,6,13134,13490,11306,-2184
2020,3,26,7,12926,13237,11313,-1924
2020,3,26,8,12892,13163,11266,-1897
2020,3,26,9,13143,13339,11080,-2259
2020,3,26,10,14018,13892,11290,-2602
2020,3,26,11,15620,14871,12644,-2227
2020,3,26,12,16577,15538,13522,-2016
2020,3,26,13,16699,15766,13796,-1970
2020,3,26,14,16493,15573,13528,-2045
2020,3,26,15,16182,15289,13117,-2172
2020,3,26,16,15852,15067,12779,-2288
2020,3,26,17,15574,14913,12583,-2330
2020,3,26,18,15438,14738,12479,-2259
2020,3,26,19,15301,14615,12804,-1811
2020,3,26,20,15295,14611,12866,-1745
2020,3,26,21,15493,14934,12801,-2133
2020,3,26,22,15894,15530,13296,-2234
2020,3,26,23,16166,15909,13821,-2088
2020,3,27,0,16672,16393,13726,-2667
2020,3,27,1,16768,16248,13756,-2492
2020,3,27,2,16129,15598,13240,-2358
2020,3,27,3,15121,14784,12562,-2222
2020,3,27,4,14079,13947,11927,-2020
2020,3,27,5,13115,13223,10760,-2463
2020,3,27,6,12745,12717,10445,-2272
2020,3,27,7,12534,12410,10434,-1976
2020,3,27,8,12491,12289,10179,-2110
2020,3,27,9,12719,12418,10258,-2160
2020,3,27,10,13545,12968,10443,-2525
2020,3,27,11,15076,13876,11302,-2574
2020,3,27,12,16068,14612,12660,-1952
2020,3,27,13,16326,15171,13293,-1878
2020,3,27,14,16360,15152,13098,-2054
2020,3,27,15,16253,14925,12711,-2214
2020,3,27,16,15978,14807,12397,-2410
2020,3,27,17,15640,14590,12233,-2357
2020,3,27,18,15384,14320,11900,-2420
2020,3,27,19,15146,14003,11820,-2183
2020,3,27,20,15034,13864,11950,-1914
2020,3,27,21,15089,14067,12438,-1629
2020,3,27,22,15368,14618,12911,-1707
2020,3,27,23,15508,15101,13344,-1757
2020,3,28,0,15924,15652,13552,-2100
2020,3,28,1,16065,15690,13708,-1982
2020,3,28,2,15649,15124,13275,-1849
2020,3,28,3,14914,14427,12448,-1979
2020,3,28,4,14072,13731,11327,-2404
2020,3,28,5,13195,13124,10144,-2980
2020,3,28,6,12764,12692,9814,-2878
2020,3,28,7,12504,12455,9715,-2740
2020,3,28,8,12382,12330,9569,-2761
2020,3,28,9,12447,12356,9772,-2584
2020,3,28,10,12785,12613,9894,-2719
2020,3,28,11,13387,13096,10379,-2717
2020,3,28,12,13935,13437,10776,-2661
2020,3,28,13,14452,13917,11203,-2714
2020,3,28,14,14750,14497,11578,-2919
2020,3,28,15,14880,14957,11824,-3133
2020,3,28,16,14832,15294,12322,-2972
2020,3,28,17,14756,15521,12014,-3507
2020,3,28,18,14640,15543,12168,-3375
2020,3,28,19,14532,15497,12149,-3348
2020,3,28,20,14490,15539,12342,-3197
2020,3,28,21,14554,15777,12552,-3225
2020,3,28,22,14840,16127,12814,-3313
2020,3,28,23,14975,16314,13220,-3094
2020,3,29,0,15496,16385,13231,-3154
2020,3,29,1,15608,16008,12939,-3069
2020,3,29,2,15182,15410,12344,-3066
2020,3,29,3,14537,14727,12044,-2683
2020,3,29,4,13810,13993,11480,-2513
2020,3,29,5,12813,13326,10369,-2957
2020,3,29,6,12317,12830,9965,-2865
2020,3,29,7,12014,12506,9535,-2971
2020,3,29,8,11881,12331,12331,0
2020,3,29,9,11858,12299,12299,0
2020,3,29,10,12077,12449,9903,-2546
2020,3,29,11,12515,12794,10424,-2370
2020,3,29,12,12915,13143,11178,-1965
2020,3,29,13,13648,13742,11095,-2647
2020,3,29,14,14222,14354,11384,-2970
2020,3,29,15,14600,14890,11644,-3246
2020,3,29,16,14761,15265,12152,-3113
2020,3,29,17,14791,15472,12877,-2595
2020,3,29,18,14680,15503,13104,-2399
2020,3,29,19,14531,15420,12933,-2487
2020,3,29,20,14425,15357,12757,-2600
2020,3,29,21,14447,15448,12622,-2826
2020,3,29,22,14768,15810,13395,-2415
2020,3,29,23,15135,15951,13264,-2687
2020,3,30,0,15672,16075,13332,-2743
2020,3,30,1,15797,15912,12835,-3077
2020,3,30,2,15239,15308,12206,-3102
2020,3,30,3,14368,14637,12188,-2449
2020,3,30,4,13427,13836,13836,0
2020,3,30,5,12664,13151,10487,-2664
2020,3,30,6,12244,12730,10045,-2685
2020,3,30,7,12024,12486,10002,-2484
2020,3,30,8,11974,12420,10389,-2031
2020,3,30,9,12250,12530,10402,-2128
2020,3,30,10,13196,13063,10724,-2339
2020,3,30,11,14937,13921,11233,-2688
2020,3,30,12,16125,14687,12211,-2476
2020,3,30,13,16556,15371,12492,-2879
2020,3,30,14,16660,15859,12866,-2993
2020,3,30,15,16700,16138,13073,-3065
2020,3,30,16,16651,16308,13126,-3182
2020,3,30,17,16504,16314,13058,-3256
2020,3,30,18,16426,16171,12730,-3441
2020,3,30,19,16319,16019,12857,-3162
2020,3,30,20,16268,16053,13232,-2821
2020,3,30,21,16383,16206,13406,-2800
2020,3,30,22,16760,16535,13665,-2870
2020,3,30,23,16976,16677,13827,-2850
2020,3,31,0,17313,16845,13873,-2972
2020,3,31,1,17160,16592,13377,-3215
2020,3,31,2,16377,15942,13102,-2840
2020,3,31,3,15236,15026,12767,-2259
2020,3,31,4,14093,14172,11664,-2508
2020,3,31,5,13110,13472,10740,-2732
2020,3,31,6,12671,13005,10218,-2787
2020,3,31,7,12436,12750,10343,-2407
2020,3,31,8,12379,12637,10482,-2155
2020,3,31,9,12656,12756,10524,-2232
2020,3,31,10,13602,13265,11125,-2140
2020,3,31,11,15340,14147,12041,-2106
2020,3,31,12,16519,14905,12998,-1907
2020,3,31,13,16876,15535,13576,-1959
2020,3,31,14,16965,15906,13909,-1997
2020,3,31,15,16936,16145,13988,-2157
2020,3,31,16,16821,16147,13663,-2484
2020,3,31,17,16625,16173,13583,-2590
2020,3,31,18,16478,16083,13552,-2531
2020,3,31,19,16291,15811,13421,-2390
2020,3,31,20,16212,15556,13223,-2333
2020,3,31,21,16305,15651,13493,-2158
2020,3,31,22,16631,16074,13767,-2307
2020,3,31,23,16867,16421,13993,-2428
2020,4,1,0,17227,16796,14096,-2700
2020,4,1,1,17177,16642,14159,-2483
2020,4,1,2,16464,15992,13989,-2003
2020,4,1,3,15355,15152,13591,-1561
2020,4,1,4,14227,14337,12626,-1711
2020,4,1,5,12796,13681,11443,-2238
2020,4,1,6,12427,13264,10665,-2599
2020,4,1,7,12230,13005,10547,-2458
2020,4,1,8,12193,12878,10323,-2555
2020,4,1,9,12444,13021,10404,-2617
2020,4,1,10,13299,13556,11314,-2242
2020,4,1,11,14826,14394,12287,-2107
2020,4,1,12,15752,15009,13213,-1796
2020,4,1,13,15953,15279,13850,-1429
2020,4,1,14,15834,15100,13506,-1594
2020,4,1,15,15615,14891,13071,-1820
2020,4,1,16,15356,14817,12588,-2229
2020,4,1,17,15090,14764,12726,-2038
2020,4,1,18,14950,14666,12585,-2081
2020,4,1,19,14814,14523,12500,-2023
2020,4,1,20,14824,14421,12585,-1836
2020,4,1,21,15099,14634,12979,-1655
2020,4,1,22,15426,15198,13600,-1598
2020,4,1,23,15678,15638,13884,-1754
2020,4,2,0,16205,16144,14183,-1961
2020,4,2,1,16546,16289,14470,-1819
2020,4,2,2,15785,15722,14077,-1645
2020,4,2,3,14720,14934,13426,-1508
2020,4,2,4,13659,14143,12346,-1797
2020,4,2,5,12806,13526,11392,-2134
2020,4,2,6,12438,13149,10917,-2232
2020,4,2,7,12231,12914,10664,-2250
2020,4,2,8,12185,12810,10513,-2297
2020,4,2,9,12435,12943,10706,-2237
2020,4,2,10,13281,13525,11072,-2453
2020,4,2,11,14765,14296,11704,-2592
2020,4,2,12,15677,14918,12420,-2498
2020,4,2,13,15906,15241,13002,-2239
2020,4,2,14,15821,15190,13034,-2156
2020,4,2,15,15677,15113,12916,-2197
2020,4,2,16,15483,15032,13006,-2026
2020,4,2,17,15272,14897,12486,-2411
2020,4,2,18,15168,14767,12346,-2421
2020,4,2,19,15067,14652,12253,-2399
2020,4,2,20,15060,14670,12234,-2436
2020,4,2,21,15291,15017,12380,-2637
2020,4,2,22,15572,15586,12792,-2794
2020,4,2,23,15704,15911,13090,-2821
2020,4,3,0,16199,16316,13383,-2933
2020,4,3,1,16458,16312,13849,-2463
2020,4,3,2,15669,15742,13256,-2486
2020,4,3,3,14609,14965,12275,-2690
2020,4,3,4,13552,14136,11425,-2711
2020,4,3,5,12538,13423,10928,-2495
2020,4,3,6,12149,12995,10718,-2277
2020,4,3,7,11933,12732,10686,-2046
2020,4,3,8,11875,12600,10614,-1986
2020,4,3,9,12097,12708,10679,-2029
2020,4,3,10,12905,13235,11024,-2211
2020,4,3,11,14383,14034,11732,-2302
2020,4,3,12,15394,14718,12331,-2387
2020,4,3,13,15833,15326,13025,-2301
2020,4,3,14,15980,15612,12712,-2900
2020,4,3,15,16016,15857,12847,-3010
2020,4,3,16,15931,15923,12953,-2970
2020,4,3,17,15769,15966,12902,-3064
2020,4,3,18,15670,15989,13017,-2972
2020,4,3,19,15491,15868,13007,-2861
2020,4,3,20,15373,15807,13023,-2784
2020,4,3,21,15429,15980,13199,-2781
2020,4,3,22,15482,16251,13629,-2622
2020,4,3,23,15452,16273,13707,-2566
2020,4,4,0,15752,16403,13657,-2746
2020,4,4,1,15875,16182,13591,-2591
2020,4,4,2,15180,15564,13244,-2320
2020,4,4,3,14324,14816,12574,-2242
2020,4,4,4,13401,14056,11600,-2456
2020,4,4,5,12859,13385,10760,-2625
2020,4,4,6,12375,12918,10507,-2411
2020,4,4,7,12079,12595,10382,-2213
2020,4,4,8,11934,12382,10326,-2056
2020,4,4,9,11983,12347,10514,-1833
2020,4,4,10,12284,12572,10598,-1974
2020,4,4,11,12838,12956,11082,-1874
2020,4,4,12,13386,13247,11502,-1745
2020,4,4,13,13965,13621,11738,-1883
2020,4,4,14,14270,13912,12028,-1884
2020,4,4,15,14341,13979,12121,-1858
2020,4,4,16,14210,13915,12067,-1848
2020,4,4,17,13961,13739,11609,-2130
2020,4,4,18,13684,13496,11109,-2387
2020,4,4,19,13467,13342,11298,-2044
2020,4,4,20,13404,13401,11730,-1671
2020,4,4,21,13583,13787,11902,-1885
2020,4,4,22,13884,14432,12146,-2286
2020,4,4,23,14256,14871,12909,-1962
2020,4,5,0,14749,15266,13074,-2192
2020,4,5,1,15195,15340,13404,-1936
2020,4,5,2,14713,14861,13022,-1839
2020,4,5,3,14040,14185,12438,-1747
2020,4,5,4,13289,13505,11323,-2182
2020,4,5,5,12487,12847,10454,-2393
2020,4,5,6,12057,12349,10383,-1966
2020,4,5,7,11786,12022,10240,-1782
2020,4,5,8,11644,11849,10055,-1794
2020,4,5,9,11658,11799,10035,-1764
2020,4,5,10,11866,11971,10302,-1669
2020,4,5,11,12199,12247,10639,-1608
2020,4,5,12,12549,12499,10806,-1693
2020,4,5,13,12988,12903,11097,-1806
2020,4,5,14,13262,13281,11283,-1998
2020,4,5,15,13391,13592,11383,-2209
2020,4,5,16,13401,13804,11616,-2188
2020,4,5,17,13328,13871,11953,-1918
2020,4,5,18,13197,13722,11996,-1726
2020,4,5,19,13096,13584,12078,-1506
2020,4,5,20,13121,13695,11820,-1875
2020,4,5,21,13384,13986,11919,-2067
2020,4,5,22,13757,14509,12236,-2273
2020,4,5,23,14111,14770,12537,-2233
2020,4,6,0,14729,15104,12935,-2169
2020,4,6,1,15204,15279,13505,-1774
2020,4,6,2,14613,14751,12829,-1922
2020,4,6,3,13780,14055,12277,-1778
2020,4,6,4,12940,13409,11222,-2187
2020,4,6,5,11952,12836,10426,-2410
2020,4,6,6,11623,12434,9970,-2464
2020,4,6,7,11461,12209,9993,-2216
2020,4,6,8,11452,12133,10170,-1963
2020,4,6,9,11720,12273,10470,-1803
2020,4,6,10,12575,12784,10569,-2215
2020,4,6,11,14027,13606,11597,-2009
2020,4,6,12,14960,14277,12323,-1954
2020,4,6,13,15123,14559,12237,-2322
2020,4,6,14,14995,14437,12057,-2380
2020,4,6,15,14780,14182,11439,-2743
2020,4,6,16,14536,14097,11544,-2553
2020,4,6,17,14320,14018,11678,-2340
2020,4,6,18,14218,13932,11314,-2618
2020,4,6,19,14136,13775,10949,-2826
2020,4,6,20,14202,13733,11162,-2571
2020,4,6,21,14499,14043,11708,-2335
2020,4,6,22,14875,14658,12474,-2184
2020,4,6,23,15164,15133,13039,-2094
2020,4,7,0,15663,15626,13407,-2219
2020,4,7,1,15981,15751,13368,-2383
2020,4,7,2,15206,15152,13089,-2063
2020,4,7,3,14136,14369,12554,-1815
2020,4,7,4,13084,13509,11793,-1716
2020,4,7,5,12236,12873,10858,-2015
2020,4,7,6,11835,12463,10498,-1965
2020,4,7,7,11616,12180,10222,-1958
2020,4,7,8,11557,12048,10092,-1956
2020,4,7,9,11787,12159,10225,-1934
2020,4,7,10,12602,12649,10588,-2061
2020,4,7,11,14067,13371,11005,-2366
2020,4,7,12,14990,13957,11117,-2840
2020,4,7,13,15169,14186,11488,-2698
2020,4,7,14,15035,14128,11190,-2938
2020,4,7,15,14839,13992,10626,-3366
2020,4,7,16,14645,13866,10590,-3276
2020,4,7,17,14498,13886,10802,-3084
2020,4,7,18,14478,13818,10699,-3119
2020,4,7,19,14444,13772,11204,-2568
2020,4,7,20,14522,13831,11616,-2215
2020,4,7,21,14796,14214,12269,-1945
2020,4,7,22,15103,14827,12542,-2285
2020,4,7,23,15261,15175,12975,-2200
2020,4,8,0,15659,15540,13072,-2468
2020,4,8,1,15942,15517,13119,-2398
2020,4,8,2,15179,14959,12255,-2704
2020,4,8,3,14109,14221,12160,-2061
2020,4,8,4,13039,13388,11495,-1893
2020,4,8,5,12068,12739,10460,-2279
2020,4,8,6,11682,12275,9926,-2349
2020,4,8,7,11464,12003,9736,-2267
2020,4,8,8,11402,11867,9654,-2213
2020,4,8,9,11616,11975,10041,-1934
2020,4,8,10,12414,12418,10426,-1992
2020,4,8,11,13866,13179,10868,-2311
2020,4,8,12,14905,13922,11644,-2278
2020,4,8,13,15288,14647,12191,-2456
2020,4,8,14,15413,15018,12406,-2612
2020,4,8,15,15409,15085,12523,-2562
2020,4,8,16,15295,15044,12627,-2417
2020,4,8,17,15132,14929,12526,-2403
2020,4,8,18,15054,14889,12355,-2534
2020,4,8,19,14919,14724,11658,-3066
2020,4,8,20,14877,14538,11823,-2715
2020,4,8,21,15025,14629,12079,-2550
2020,4,8,22,15207,15050,12551,-2499
2020,4,8,23,15278,15297,12660,-2637
2020,4,9,0,15672,15547,12945,-2602
2020,4,9,1,15987,15628,13078,-2550
2020,4,9,2,15247,15093,12617,-2476
2020,4,9,3,14184,14368,12122,-2246
2020,4,9,4,13121,13555,11444,-2111
2020,4,9,5,12141,12931,10440,-2491
2020,4,9,6,11741,12528,10116,-2412
2020,4,9,7,11506,12290,10051,-2239
2020,4,9,8,11430,12141,9989,-2152
2020,4,9,9,11653,12238,10162,-2076
2020,4,9,10,12459,12662,10469,-2193
2020,4,9,11,13897,13378,10895,-2483
2020,4,9,12,14948,14140,12003,-2137
2020,4,9,13,15423,14975,12315,-2660
2020,4,9,14,15616,15619,13001,-2618
2020,4,9,15,15697,15963,13023,-2940
2020,4,9,16,15650,16101,12907,-3194
2020,4,9,17,15513,16198,13053,-3145
2020,4,9,18,15415,16186,13276,-2910
2020,4,9,19,15196,16028,13241,-2787
2020,4,9,20,15008,15551,12740,-2811
2020,4,9,21,15070,15085,12485,-2600
2020,4,9,22,15267,15403,13036,-2367
2020,4,9,23,15433,15741,13418,-2323
2020,4,10,0,15855,16121,13891,-2230
2020,4,10,1,16190,16296,14313,-1983
2020,4,10,2,15506,15748,13288,-2460
2020,4,10,3,14460,15000,12599,-2401
2020,4,10,4,13408,14181,12048,-2133
2020,4,10,5,12475,13579,11890,-1689
2020,4,10,6,12028,13161,11574,-1587
2020,4,10,7,11750,12896,11407,-1489
2020,4,10,8,11662,12776,11273,-1503
2020,4,10,9,11826,12914,11246,-1668
2020,4,10,10,12442,13344,11483,-1861
2020,4,10,11,13405,13934,11951,-1983
2020,4,10,12,14207,14480,12540,-1940
2020,4,10,13,14787,14988,12527,-2461
2020,4,10,14,15053,15456,13010,-2446
2020,4,10,15,15126,15738,12920,-2818
2020,4,10,16,15050,15827,12650,-3177
2020,4,10,17,14863,15804,12360,-3444
2020,4,10,18,14728,15691,12422,-3269
2020,4,10,19,14605,15416,12424,-2992
2020,4,10,20,14530,15358,12492,-2866
2020,4,10,21,14761,15544,12897,-2647
2020,4,10,22,14978,16010,13278,-2732
2020,4,10,23,15094,16302,13596,-2706
2020,4,11,0,15334,16521,14172,-2349
2020,4,11,1,15594,16520,13924,-2596
2020,4,11,2,15061,15973,13343,-2630
2020,4,11,3,14287,15254,12837,-2417
2020,4,11,4,13439,14495,12373,-2122
2020,4,11,5,13032,13833,11626,-2207
2020,4,11,6,12612,13364,11214,-2150
2020,4,11,7,12362,13079,10994,-2085
2020,4,11,8,12249,12911,10953,-1958
2020,4,11,9,12338,12915,10976,-1939
2020,4,11,10,12677,13166,10980,-2186
2020,4,11,11,13165,13421,10884,-2537
2020,4,11,12,13611,13608,11151,-2457
2020,4,11,13,14005,13672,11599,-2073
2020,4,11,14,14128,13656,11379,-2277
2020,4,11,15,14064,13765,11599,-2166
2020,4,11,16,13837,13900,11575,-2325
2020,4,11,17,13561,13912,11638,-2274
2020,4,11,18,13274,13778,11755,-2023
2020,4,11,19,13091,13587,11791,-1796
2020,4,11,20,13079,13504,11923,-1581
2020,4,11,21,13347,13757,12107,-1650
2020,4,11,22,13734,14334,12782,-1552
2020,4,11,23,14199,14853,13001,-1852
2020,4,12,0,14716,15262,13868,-1394
2020,4,12,1,15290,15605,13927,-1678
2020,4,12,2,14958,15225,13434,-1791
2020,4,12,3,14322,14701,12644,-2057
2020,4,12,4,13598,14026,11810,-2216
2020,4,12,5,12943,13433,11067,-2366
2020,4,12,6,12534,13000,10888,-2112
2020,4,12,7,12274,12715,10584,-2131
2020,4,12,8,12142,12532,10315,-2217
2020,4,12,9,12168,12512,10400,-2112
2020,4,12,10,12369,12722,10702,-2020
2020,4,12,11,12607,12938,11267,-1671
2020,4,12,12,12861,13060,11312,-1748
2020,4,12,13,13208,13178,11220,-1958
2020,4,12,14,13421,13249,11327,-1922
2020,4,12,15,13503,13298,11424,-1874
2020,4,12,16,13462,13530,11680,-1850
2020,4,12,17,13374,13895,12041,-1854
2020,4,12,18,13226,14044,11991,-2053
2020,4,12,19,13120,13858,11737,-2121
2020,4,12,20,13150,13618,11236,-2382
2020,4,12,21,13412,13843,11676,-2167
2020,4,12,22,13812,14140,11994,-2146
2020,4,12,23,14168,14335,12045,-2290
2020,4,13,0,14709,14697,12770,-1927
2020,4,13,1,15211,14894,12888,-2006
2020,4,13,2,14699,14459,12335,-2124
2020,4,13,3,13877,13796,11493,-2303
2020,4,13,4,13027,13076,10836,-2240
2020,4,13,5,11926,12488,10585,-1903
2020,4,13,6,11546,12095,10405,-1690
2020,4,13,7,11335,11864,10496,-1368
2020,4,13,8,11278,11791,10481,-1310
2020,4,13,9,11501,11885,10610,-1275
2020,4,13,10,12303,12342,10860,-1482
2020,4,13,11,13718,13073,11726,-1347
2020,4,13,12,14869,13850,12608,-1242
2020,4,13,13,15499,14728,13645,-1083
2020,4,13,14,15838,15403,13960,-1443
2020,4,13,15,16014,15807,13614,-2193
2020,4,13,16,16016,16032,13697,-2335
2020,4,13,17,15912,16109,13992,-2117
2020,4,13,18,15828,16084,13765,-2319
2020,4,13,19,15657,15975,13586,-2389
2020,4,13,20,15542,15893,13474,-2419
2020,4,13,21,15559,15841,13429,-2412
2020,4,13,22,15674,15988,13209,-2779
2020,4,13,23,15669,15796,13235,-2561
2020,4,14,0,15963,15815,13610,-2205
2020,4,14,1,16153,15784,14081,-1703
2020,4,14,2,15407,15200,13481,-1719
2020,4,14,3,14316,14470,13265,-1205
2020,4,14,4,13212,13729,12628,-1101
2020,4,14,5,12210,13080,11774,-1306
2020,4,14,6,11785,12618,11411,-1207
2020,4,14,7,11550,12394,11316,-1078
2020,4,14,8,11480,12294,11330,-964
2020,4,14,9,11701,12405,11281,-1124
2020,4,14,10,12490,12914,11786,-1128
2020,4,14,11,13868,13608,12129,-1479
2020,4,14,12,14806,14186,12959,-1227
2020,4,14,13,15021,14445,13501,-944
2020,4,14,14,15043,14447,13462,-985
2020,4,14,15,14990,14541,12970,-1571
2020,4,14,16,14848,14706,12963,-1743
2020,4,14,17,14695,14744,12907,-1837
2020,4,14,18,14615,14538,12782,-1756
2020,4,14,19,14513,14428,12675,-1753
2020,4,14,20,14549,14241,12582,-1659
2020,4,14,21,14836,14471,12597,-1874
2020,4,14,22,15215,14986,13149,-1837
2020,4,14,23,15451,15496,13393,-2103
2020,4,15,0,15740,15907,13703,-2204
2020,4,15,1,16033,15999,13859,-2140
2020,4,15,2,15360,15456,13842,-1614
2020,4,15,3,14299,14710,13531,-1179
2020,4,15,4,13229,13917,12696,-1221
2020,4,15,5,12366,13253,11612,-1641
2020,4,15,6,11994,12869,11299,-1570
2020,4,15,7,11790,12642,11463,-1179
2020,4,15,8,11740,12567,11418,-1149
2020,4,15,9,11999,12677,11285,-1392
2020,4,15,10,12851,13129,11777,-1352
2020,4,15,11,14285,13848,12075,-1773
2020,4,15,12,15265,14508,12951,-1557
2020,4,15,13,15508,14957,13233,-1724
2020,4,15,14,15458,15085,13649,-1436
2020,4,15,15,15318,15106,13714,-1392
2020,4,15,16,15100,14920,13352,-1568
2020,4,15,17,14874,14791,13405,-1386
2020,4,15,18,14740,14681,13351,-1330
2020,4,15,19,14625,14557,13199,-1358
2020,4,15,20,14644,14397,13053,-1344
2020,4,15,21,14903,14581,13309,-1272
2020,4,15,22,15221,15111,13449,-1662
2020,4,15,23,15453,15484,13866,-1618
2020,4,16,0,15815,15894,13885,-2009
2020,4,16,1,16183,16138,14008,-2130
2020,4,16,2,15569,15648,13514,-2134
2020,4,16,3,14519,14925,13235,-1690
2020,4,16,4,13466,14161,12341,-1820
2020,4,16,5,13203,13537,11672,-1865
2020,4,16,6,12836,13125,11560,-1565
2020,4,16,7,12603,12885,11560,-1325
2020,4,16,8,12491,12762,11404,-1358
2020,4,16,9,12639,12879,11666,-1213
2020,4,16,10,13157,13356,11998,-1358
2020,4,16,11,13871,14018,12378,-1640
2020,4,16,12,14450,14652,13408,-1244
2020,4,16,13,14867,15033,13783,-1250
2020,4,16,14,14976,15072,13664,-1408
2020,4,16,15,14965,15049,13498,-1551
2020,4,16,16,14976,15185,13383,-1802
2020,4,16,17,14986,15289,13232,-2057
2020,4,16,18,14958,15222,13576,-1646
2020,4,16,19,14887,15054,13464,-1590
2020,4,16,20,14834,14990,13279,-1711
2020,4,16,21,14996,15171,13558,-1613
2020,4,16,22,15418,15643,14126,-1517
2020,4,16,23,15694,15983,14370,-1613
2020,4,17,0,15926,16368,14560,-1808
2020,4,17,1,16070,16595,15175,-1420
2020,4,17,2,15644,16101,14912,-1189
2020,4,17,3,14937,15332,14379,-953
2020,4,17,4,14199,14552,13083,-1469
2020,4,17,5,13564,13935,11806,-2129
2020,4,17,6,13228,13497,11376,-2121
2020,4,17,7,13010,13254,11502,-1752
2020,4,17,8,12915,13134,11683,-1451
2020,4,17,9,13019,13242,11886,-1356
2020,4,17,10,13443,13714,12673,-1041
2020,4,17,11,14018,14302,13294,-1008
2020,4,17,12,14510,14814,13287,-1527
2020,4,17,13,14883,14966,13916,-1050
2020,4,17,14,15061,14924,13581,-1343
2020,4,17,15,15162,14905,13850,-1055
2020,4,17,16,15227,14983,13733,-1250
2020,4,17,17,15259,14980,13370,-1610
2020,4,17,18,15254,15072,13185,-1887
2020,4,17,19,15155,15272,13277,-1995
2020,4,17,20,15043,15345,13389,-1956
2020,4,17,21,15096,15614,13502,-2112
2020,4,17,22,15377,16006,13968,-2038
2020,4,17,23,15509,16202,13851,-2351
2020,4,18,0,15607,16402,14142,-2260
2020,4,18,1,15604,16355,14352,-2003
2020,4,18,2,15263,15825,14070,-1755
2020,4,18,3,14798,15088,13565,-1523
2020,4,18,4,14210,14319,12584,-1735
2020,4,18,5,13471,13667,11489,-2178
2020,4,18,6,13023,13196,11332,-1864
2020,4,18,7,12739,12873,11104,-1769
2020,4,18,8,12562,12674,10945,-1729
2020,4,18,9,12545,12649,10970,-1679
2020,4,18,10,12741,12875,11433,-1442
2020,4,18,11,12943,13204,11750,-1454
2020,4,18,12,13319,13609,12117,-1492
2020,4,18,13,13728,14156,12321,-1835
2020,4,18,14,14109,14667,12464,-2203
2020,4,18,15,14335,15054,12208,-2846
2020,4,18,16,14520,15256,12037,-3219
2020,4,18,17,14484,15226,12365,-2861
2020,4,18,18,14389,15079,12400,-2679
2020,4,18,19,14199,14882,12656,-2226
2020,4,18,20,14060,14778,12486,-2292
2020,4,18,21,14141,14893,12568,-2325
2020,4,18,22,14373,15229,12822,-2407
2020,4,18,23,14570,15492,13206,-2286
2020,4,19,0,14814,15718,13443,-2275
2020,4,19,1,15047,16006,13898,-2108
2020,4,19,2,14804,15605,13203,-2402
2020,4,19,3,14355,14912,12967,-1945
2020,4,19,4,13795,14184,11802,-2382
2020,4,19,5,13340,13568,10630,-2938
2020,4,19,6,12901,13093,10507,-2586
2020,4,19,7,12610,12801,10191,-2610
2020,4,19,8,12420,12643,10286,-2357
2020,4,19,9,12363,12416,10153,-2263
2020,4,19,10,12437,12798,10495,-2303
2020,4,19,11,12357,12916,11032,-1884
2020,4,19,12,12390,12932,10997,-1935
2020,4,19,13,12511,12989,10785,-2204
2020,4,19,14,12652,13058,10814,-2244
2020,4,19,15,12757,13027,10683,-2344
2020,4,19,16,12920,13103,11133,-1970
2020,4,19,17,13045,13224,11253,-1971
2020,4,19,18,13116,13225,11393,-1832
2020,4,19,19,13140,13216,11380,-1836
2020,4,19,20,13189,13526,11636,-1890
2020,4,19,21,13469,14180,12031,-2149
2020,4,19,22,13925,14809,12581,-2228
2020,4,19,23,14285,15102,12904,-2198
2020,4,20,0,14644,15290,13255,-2035
2020,4,20,1,14903,15338,13135,-2203
2020,4,20,2,14477,14837,12676,-2161
2020,4,20,3,13837,14140,11804,-2336
2020,4,20,4,13153,13427,11163,-2264
2020,4,20,5,12750,12864,10472,-2392
2020,4,20,6,12423,12456,10469,-1987
2020,4,20,7,12241,12228,10778,-1450
2020,4,20,8,12180,12159,10592,-1567
2020,4,20,9,12328,12304,10418,-1886
2020,4,20,10,12853,12815,10481,-2334
2020,4,20,11,13555,13487,11112,-2375
2020,4,20,12,14249,14176,11790,-2386
2020,4,20,13,14697,14644,12240,-2404
2020,4,20,14,14960,14869,12002,-2867
2020,4,20,15,15106,15027,11883,-3144
2020,4,20,16,15191,15104,11809,-3295
2020,4,20,17,15220,14961,11821,-3140
2020,4,20,18,15141,14624,11810,-2814
2020,4,20,19,14975,14300,11500,-2800
2020,4,20,20,14823,14147,11372,-2775
2020,4,20,21,14939,14324,11723,-2601
2020,4,20,22,15318,14795,12022,-2773
2020,4,20,23,15620,15098,12344,-2754
2020,4,21,0,15832,15415,12662,-2753
2020,4,21,1,16032,15849,13200,-2649
2020,4,21,2,15550,15379,12818,-2561
2020,4,21,3,14761,14680,12566,-2114
2020,4,21,4,13946,13944,11904,-2040
2020,4,21,5,13196,13337,11167,-2170
2020,4,21,6,12764,12918,10824,-2094
2020,4,21,7,12489,12668,10759,-1909
2020,4,21,8,12345,12573,10744,-1829
2020,4,21,9,12441,12670,10914,-1756
2020,4,21,10,12891,13157,11372,-1785
2020,4,21,11,13551,13820,12032,-1788
2020,4,21,12,14212,14466,12758,-1708
2020,4,21,13,14719,15084,13102,-1982
2020,4,21,14,15010,15411,13149,-2262
2020,4,21,15,15267,15622,12891,-2731
2020,4,21,16,15477,15797,13294,-2503
2020,4,21,17,15638,16162,13746,-2416
2020,4,21,18,15645,16160,13789,-2371
2020,4,21,19,15523,15805,13614,-2191
2020,4,21,20,15411,15979,13753,-2226
2020,4,21,21,15537,15713,13353,-2360
2020,4,21,22,15933,15888,13500,-2388
2020,4,21,23,16113,16080,14080,-2000
2020,4,22,0,16270,16309,14600,-1709
2020,4,22,1,16387,16563,14827,-1736
2020,4,22,2,15926,16082,14224,-1858
2020,4,22,3,15136,15350,13419,-1931
2020,4,22,4,14298,14563,12659,-1904
2020,4,22,5,13552,13911,11646,-2265
2020,4,22,6,13198,13523,11656,-1867
2020,4,22,7,12972,13327,11706,-1621
2020,4,22,8,12871,13244,11831,-1413
2020,4,22,9,13000,13360,11643,-1717
2020,4,22,10,13484,13860,12324,-1536
2020,4,22,11,14132,14540,12955,-1585
2020,4,22,12,14744,15123,13715,-1408
2020,4,22,13,15057,15483,14099,-1384
2020,4,22,14,15148,15594,13985,-1609
2020,4,22,15,15162,15645,13743,-1902
2020,4,22,16,15157,15638,13445,-2193
2020,4,22,17,15089,15597,13327,-2270
2020,4,22,18,14927,15477,13316,-2161
2020,4,22,19,14754,15216,13291,-1925
2020,4,22,20,14707,15006,13317,-1689
2020,4,22,21,14965,15088,13406,-1682
2020,4,22,22,15491,15545,14043,-1502
2020,4,22,23,15772,15859,14765,-1094
2020,4,23,0,16075,16160,14731,-1429
2020,4,23,1,16363,16566,14735,-1831
2020,4,23,2,15966,16083,14369,-1714
2020,4,23,3,15199,15300,13919,-1381
2020,4,23,4,14369,14498,13172,-1326
2020,4,23,5,13741,13839,12400,-1439
2020,4,23,6,13358,13436,11688,-1748
2020,4,23,7,13114,13181,11680,-1501
2020,4,23,8,13007,13100,11570,-1530
2020,4,23,9,13134,13220,11580,-1640
2020,4,23,10,13610,13715,11836,-1879
2020,4,23,11,14226,14365,12007,-2358
2020,4,23,12,14821,15070,12736,-2334
2020,4,23,13,15202,15662,13300,-2362
2020,4,23,14,15354,16033,13115,-2918
2020,4,23,15,15460,16120,13013,-3107
2020,4,23,16,15573,16067,12844,-3223
2020,4,23,17,15633,15989,12580,-3409
2020,4,23,18,15564,15747,12581,-3166
2020,4,23,19,15420,15548,12222,-3326
2020,4,23,20,15357,15429,12570,-2859
2020,4,23,21,15490,15479,12946,-2533
2020,4,23,22,15868,15876,13466,-2410
2020,4,23,23,16023,16132,13577,-2555
2020,4,24,0,16143,16296,13465,-2831
2020,4,24,1,16324,16388,13781,-2607
2020,4,24,2,15837,15820,13630,-2190
2020,4,24,3,15053,15075,12910,-2165
2020,4,24,4,14217,14262,11575,-2687
2020,4,24,5,13343,13585,11067,-2518
2020,4,24,6,12916,13115,10665,-2450
2020,4,24,7,12650,12847,10694,-2153
2020,4,24,8,12520,12736,10801,-1935
2020,4,24,9,12601,12816,10915,-1901
2020,4,24,10,13048,13250,11163,-2087
2020,4,24,11,13708,13915,11689,-2226
2020,4,24,12,14463,14705,11814,-2891
2020,4,24,13,15065,15397,12654,-2743
2020,4,24,14,15400,15886,13295,-2591
2020,4,24,15,15638,16191,13649,-2542
2020,4,24,16,15783,16224,13920,-2304
2020,4,24,17,15825,16277,13803,-2474
2020,4,24,18,15724,16135,13478,-2657
2020,4,24,19,15502,15928,13255,-2673
2020,4,24,20,15301,15745,13097,-2648
2020,4,24,21,15233,15733,13365,-2368
2020,4,24,22,15414,15863,13356,-2507
2020,4,24,23,15432,15873,13671,-2202
2020,4,25,0,15430,15933,13578,-2355
2020,4,25,1,15573,15995,13877,-2118
2020,4,25,2,15225,15527,13321,-2206
2020,4,25,3,14636,14873,12341,-2532
2020,4,25,4,13937,14097,11317,-2780
2020,4,25,5,13200,13394,10291,-3103
2020,4,25,6,12727,12911,9706,-3205
2020,4,25,7,12415,12616,9454,-3162
2020,4,25,8,12242,12465,9390,-3075
2020,4,25,9,12229,12484,9388,-3096
2020,4,25,10,12379,12694,9735,-2959
2020,4,25,11,12506,12927,10128,-2799
2020,4,25,12,12734,13125,10354,-2771
2020,4,25,13,12985,13186,10067,-3119
2020,4,25,14,13145,13175,10050,-3125
2020,4,25,15,13217,13048,9941,-3107
2020,4,25,16,13247,12962,10162,-2800
2020,4,25,17,13232,12822,10123,-2699
2020,4,25,18,13099,12660,10085,-2575
2020,4,25,19,13009,12586,9890,-2696
2020,4,25,20,13029,12589,9699,-2890
2020,4,25,21,13305,12946,10118,-2828
2020,4,25,22,13842,13625,10408,-3217
2020,4,25,23,14260,14139,11287,-2852
2020,4,26,0,14405,14566,11508,-3058
2020,4,26,1,14700,14982,12095,-2887
2020,4,26,2,14433,14601,11836,-2765
2020,4,26,3,13909,14009,10878,-3131
2020,4,26,4,13301,13295,10801,-2494
2020,4,26,5,12578,12651,10188,-2463
2020,4,26,6,12135,12194,9985,-2209
2020,4,26,7,11835,11898,9913,-1985
2020,4,26,8,11654,11717,9858,-1859
2020,4,26,9,11606,11699,9912,-1787
2020,4,26,10,11675,11823,10150,-1673
2020,4,26,11,11719,11982,10581,-1401
2020,4,26,12,12024,12375,10725,-1650
2020,4,26,13,12543,12996,10833,-2163
2020,4,26,14,13108,13598,11396,-2202
2020,4,26,15,13590,14147,11531,-2616
2020,4,26,16,14017,14635,11942,-2693
2020,4,26,17,14252,14986,12122,-2864
2020,4,26,18,14268,15238,12300,-2938
2020,4,26,19,14214,15323,12404,-2919
2020,4,26,20,14213,15383,12717,-2666
2020,4,26,21,14392,15631,12831,-2800
2020,4,26,22,14779,15960,13100,-2860
2020,4,26,23,14912,15985,13402,-2583
2020,4,27,0,15056,15962,13402,-2560
2020,4,27,1,15245,15806,13335,-2471
2020,4,27,2,14747,15255,13108,-2147
2020,4,27,3,13991,14532,12486,-2046
2020,4,27,4,13238,13795,11812,-1983
2020,4,27,5,12586,13154,11075,-2079
2020,4,27,6,12185,12743,10490,-2253
2020,4,27,7,11947,12497,10010,-2487
2020,4,27,8,11849,12392,10193,-2199
2020,4,27,9,12002,12500,10571,-1929
2020,4,27,10,12540,12961,11041,-1920
2020,4,27,11,13342,13655,11533,-2122
2020,4,27,12,14281,14550,11866,-2684
2020,4,27,13,15075,15261,13081,-2180
2020,4,27,14,15555,15664,13190,-2474
2020,4,27,15,15875,15922,13168,-2754
2020,4,27,16,16051,16025,13452,-2573
2020,4,27,17,16137,16100,13522,-2578
2020,4,27,18,16030,16083,13187,-2896
2020,4,27,19,15830,15832,12833,-2999
2020,4,27,20,15650,15725,12722,-3003
2020,4,27,21,15617,15795,12742,-3053
2020,4,27,22,15862,16044,13002,-3042
2020,4,27,23,16011,16087,13002,-3085
2020,4,28,0,16000,16108,13112,-2996
2020,4,28,1,16168,16227,13699,-2528
2020,4,28,2,15580,15740,13647,-2093
2020,4,28,3,14686,14954,12267,-2687
2020,4,28,4,13790,14093,11212,-2881
2020,4,28,5,13104,13434,10173,-3261
2020,4,28,6,12656,12985,10229,-2756
2020,4,28,7,12369,12721,9539,-3182
2020,4,28,8,12233,12654,9637,-3017
2020,4,28,9,12351,12776,10330,-2446
2020,4,28,10,12842,13251,10769,-2482
2020,4,28,11,13591,13898,11077,-2821
2020,4,28,12,14256,14444,11939,-2505
2020,4,28,13,14652,14688,12459,-2229
2020,4,28,14,14741,14678,12399,-2279
2020,4,28,15,14787,14651,11991,-2660
2020,4,28,16,14778,14511,11695,-2816
2020,4,28,17,14785,14349,11608,-2741
2020,4,28,18,14694,14162,11505,-2657
2020,4,28,19,14534,13914,11231,-2683
2020,4,28,20,14443,13769,11007,-2762
2020,4,28,21,14577,13984,11314,-2670
2020,4,28,22,15073,14481,12388,-2093
2020,4,28,23,15394,14830,12257,-2573
2020,4,29,0,15506,15061,12708,-2353
2020,4,29,1,15813,15449,12983,-2466
2020,4,29,2,15327,15056,12394,-2662
2020,4,29,3,14450,14310,11692,-2618
2020,4,29,4,13527,13478,10948,-2530
2020,4,29,5,12832,12824,10409,-2415
2020,4,29,6,12463,12425,10205,-2220
2020,4,29,7,12217,12194,9831,-2363
2020,4,29,8,12111,12110,9942,-2168
2020,4,29,9,12216,12220,10197,-2023
2020,4,29,10,12665,12760,11096,-1664
2020,4,29,11,13378,13347,11820,-1527
2020,4,29,12,14106,14073,12107,-1966
2020,4,29,13,14608,14664,12983,-1681
2020,4,29,14,14948,15101,13036,-2065
2020,4,29,15,15204,15281,12680,-2601
2020,4,29,16,15355,15350,12592,-2758
2020,4,29,17,15490,15417,12705,-2712
2020,4,29,18,15503,15345,12619,-2726
2020,4,29,19,15384,15333,12872,-2461
2020,4,29,20,15284,15328,13020,-2308
2020,4,29,21,15315,15525,13218,-2307
2020,4,29,22,15569,15872,13488,-2384
2020,4,29,23,15549,15876,13617,-2259
2020,4,30,0,15606,15873,13830,-2043
2020,4,30,1,15803,15795,13972,-1823
2020,4,30,2,15251,15238,13648,-1590
2020,4,30,3,14401,14432,12493,-1939
2020,4,30,4,13532,13605,11336,-2269
2020,4,30,5,12652,12911,10766,-2145
2020,4,30,6,12196,12462,10470,-1992
2020,4,30,7,11901,12195,10479,-1716
2020,4,30,8,11749,12078,10305,-1773
2020,4,30,9,11842,12182,10250,-1932
2020,4,30,10,12281,12588,11013,-1575
2020,4,30,11,13062,13291,11801,-1490
2020,4,30,12,13962,14197,12537,-1660
2020,4,30,13,14707,15045,13710,-1335
2020,4,30,14,15139,15565,13580,-1985
2020,4,30,15,15440,15872,13859,-2013
2020,4,30,16,15591,16066,13854,-2212
2020,4,30,17,15653,16012,13847,-2165
2020,4,30,18,15581,15811,13657,-2154
2020,4,30,19,15413,15666,13508,-2158
2020,4,30,20,15221,15664,13571,-2093
2020,4,30,21,15203,15767,13579,-2188
2020,4,30,22,15428,16030,13727,-2303
2020,4,30,23,15419,16051,13575,-2476
2020,5,1,0,15394,16001,13537,-2464
2020,5,1,1,15565,15911,13564,-2347
2020,5,1,2,15058,15326,13006,-2320
2020,5,1,3,14212,14526,12705,-1821
2020,5,1,4,13322,13707,11495,-2212
2020,5,1,5,12581,12969,10547,-2422
2020,5,1,6,12100,12464,9829,-2635
2020,5,1,7,11796,12145,9396,-2749
2020,5,1,8,11643,11992,9217,-2775
2020,5,1,9,11701,12072,9417,-2655
2020,5,1,10,12154,12452,10232,-2220
2020,5,1,11,12840,13021,10808,-2213
2020,5,1,12,13753,13813,11086,-2727
2020,5,1,13,14495,14516,11458,-3058
2020,5,1,14,14964,14983,12126,-2857
2020,5,1,15,15242,15254,11907,-3347
2020,5,1,16,15368,15328,11821,-3507
2020,5,1,17,15425,15265,11890,-3375
2020,5,1,18,15353,15199,11780,-3419
2020,5,1,19,15204,14972,11758,-3214
2020,5,1,20,15056,14820,11706,-3114
2020,5,1,21,15136,14861,11988,-2873
2020,5,1,22,15285,15009,12196,-2813
2020,5,1,23,15191,15091,12502,-2589
2020,5,2,0,15194,15196,12616,-2580
2020,5,2,1,15300,15411,12752,-2659
2020,5,2,2,14868,15014,12411,-2603
2020,5,2,3,14167,14302,11495,-2807
2020,5,2,4,13342,13515,10682,-2833
2020,5,2,5,12462,12797,9959,-2838
2020,5,2,6,11984,12344,9756,-2588
2020,5,2,7,11677,12028,9231,-2797
2020,5,2,8,11498,11874,8999,-2875
2020,5,2,9,11484,11908,9009,-2899
2020,5,2,10,11643,12098,9389,-2709
2020,5,2,11,11722,12284,9637,-2647
2020,5,2,12,11983,12470,9624,-2846
2020,5,2,13,12333,12529,9638,-2891
2020,5,2,14,12629,12549,10154,-2395
2020,5,2,15,12803,12575,10234,-2341
2020,5,2,16,12939,12615,9914,-2701
2020,5,2,17,13030,12684,9674,-3010
2020,5,2,18,13033,12585,9651,-2934
2020,5,2,19,13022,12644,9950,-2694
2020,5,2,20,13115,12831,9926,-2905
2020,5,2,21,13456,13243,10306,-2937
2020,5,2,22,13907,13860,10804,-3056
2020,5,2,23,14184,14266,10915,-3351
2020,5,3,0,14357,14508,11550,-2958
2020,5,3,1,14531,14851,11736,-3115
2020,5,3,2,14196,14426,11417,-3009
2020,5,3,3,13606,13802,11035,-2767
2020,5,3,4,12942,13080,10751,-2329
2020,5,3,5,12094,12429,10193,-2236
2020,5,3,6,11652,11964,9863,-2101
2020,5,3,7,11335,11653,9445,-2208
2020,5,3,8,11145,11442,9115,-2327
2020,5,3,9,11082,11371,9265,-2106
2020,5,3,10,11132,11440,9813,-1627
2020,5,3,11,11074,11520,10395,-1125
2020,5,3,12,11288,11742,10227,-1515
2020,5,3,13,11707,12012,10431,-1581
2020,5,3,14,12121,12291,10839,-1452
2020,5,3,15,12401,12397,10660,-1737
2020,5,3,16,12646,12580,10715,-1865
2020,5,3,17,12814,12799,10400,-2399
2020,5,3,18,12875,12846,10387,-2459
2020,5,3,19,12916,12811,10352,-2459
2020,5,3,20,13080,12906,10486,-2420
2020,5,3,21,13488,13389,11337,-2052
2020,5,3,22,14043,14103,11778,-2325
2020,5,3,23,14327,14590,12225,-2365
2020,5,4,0,14601,14790,12400,-2390
2020,5,4,1,14800,15141,13037,-2104
2020,5,4,2,14379,14745,12493,-2252
2020,5,4,3,13619,13994,11905,-2089
2020,5,4,4,12836,13196,11367,-1829
2020,5,4,5,12226,12547,10179,-2368
2020,5,4,6,11816,12110,9982,-2128
2020,5,4,7,11573,11829,9659,-2170
2020,5,4,8,11467,11629,9333,-2296
2020,5,4,9,11596,11669,9817,-1852
2020,5,4,10,12091,12049,10188,-1861
2020,5,4,11,12760,12636,10653,-1983
2020,5,4,12,13540,13433,11522,-1911
2020,5,4,13,14120,14057,12197,-1860
2020,5,4,14,14444,14447,12275,-2172
2020,5,4,15,14679,14799,12486,-2313
2020,5,4,16,14894,15038,12744,-2294
2020,5,4,17,15043,15415,13241,-2174
2020,5,4,18,15045,15571,13460,-2111
2020,5,4,19,14966,15334,13534,-1800
2020,5,4,20,14885,15076,13188,-1888
2020,5,4,21,15077,15060,13373,-1687
2020,5,4,22,15381,15302,13193,-2109
2020,5,4,23,15530,15377,13088,-2289
2020,5,5,0,15456,15378,13157,-2221
2020,5,5,1,15660,15569,13201,-2368
2020,5,5,2,15207,15130,12748,-2382
2020,5,5,3,14276,14297,12650,-1647
2020,5,5,4,13300,13539,11708,-1831
2020,5,5,5,12603,12890,10692,-2198
2020,5,5,6,12095,12478,10335,-2143
2020,5,5,7,11857,12250,9997,-2253
2020,5,5,8,11784,12159,10061,-2098
2020,5,5,9,11935,12302,10185,-2117
2020,5,5,10,12438,12770,10639,-2131
2020,5,5,11,13115,13412,11369,-2043
2020,5,5,12,13786,13999,11854,-2145
2020,5,5,13,14168,14273,11988,-2285
2020,5,5,14,14239,14224,12048,-2176
2020,5,5,15,14227,14179,12192,-1987
2020,5,5,16,14264,14170,12213,-1957
2020,5,5,17,14288,14134,12055,-2079
2020,5,5,18,14225,14123,11817,-2306
2020,5,5,19,14202,14176,12209,-1967
2020,5,5,20,14259,14048,12355,-1693
2020,5,5,21,14589,13972,12149,-1823
2020,5,5,22,14972,14475,12533,-1942
2020,5,5,23,15171,14851,13110,-1741
2020,5,6,0,15195,15059,13288,-1771
2020,5,6,1,15475,15418,13635,-1783
2020,5,6,2,15064,15059,13246,-1813
2020,5,6,3,14195,14324,12181,-2143
2020,5,6,4,13305,13555,11162,-2393
2020,5,6,5,12548,12926,10505,-2421
2020,5,6,6,12168,12486,10200,-2286
2020,5,6,7,11962,12283,10161,-2122
2020,5,6,8,11874,12201,10137,-2064
2020,5,6,9,11978,12295,10239,-2056
2020,5,6,10,12397,12744,10519,-2225
2020,5,6,11,13008,13439,11170,-2269
2020,5,6,12,13740,14189,11866,-2323
2020,5,6,13,14270,14722,12176,-2546
2020,5,6,14,14505,15029,12611,-2418
2020,5,6,15,14742,15234,12719,-2515
2020,5,6,16,14897,15330,12754,-2576
2020,5,6,17,14974,15392,12737,-2655
2020,5,6,18,14910,15250,12582,-2668
2020,5,6,19,14833,15171,12883,-2288
2020,5,6,20,14792,15184,13227,-1957
2020,5,6,21,15006,15225,13517,-1708
2020,5,6,22,15325,15511,13968,-1543
2020,5,6,23,15352,15559,13757,-1802
2020,5,7,0,15319,15504,14178,-1326
2020,5,7,1,15457,15622,14363,-1259
2020,5,7,2,15005,15236,13850,-1386
2020,5,7,3,14189,14485,12661,-1824
2020,5,7,4,13376,13710,11575,-2135
2020,5,7,5,12760,13093,11132,-1961
2020,5,7,6,12411,12678,11041,-1637
2020,5,7,7,12181,12427,10970,-1457
2020,5,7,8,12095,12313,10781,-1532
2020,5,7,9,12195,12420,10831,-1589
2020,5,7,10,12611,12868,10996,-1872
2020,5,7,11,13214,13444,11084,-2360
2020,5,7,12,13861,13975,11605,-2370
2020,5,7,13,14219,14184,11807,-2377
2020,5,7,14,14319,14134,11815,-2319
2020,5,7,15,14351,14116,12012,-2104
2020,5,7,16,14407,14249,11942,-2307
2020,5,7,17,14466,14321,11953,-2368
2020,5,7,18,14399,14318,12069,-2249
2020,5,7,19,14344,14221,12319,-1902
2020,5,7,20,14329,14170,12326,-1844
2020,5,7,21,14560,14464,12422,-2042
2020,5,7,22,14966,14971,12562,-2409
2020,5,7,23,15186,15229,12541,-2688
2020,5,8,0,15202,15300,12753,-2547
2020,5,8,1,15425,15469,13169,-2300
2020,5,8,2,15058,15043,12778,-2265
2020,5,8,3,14299,14327,12180,-2147
2020,5,8,4,13517,13594,11467,-2127
2020,5,8,5,12767,12929,10832,-2097
2020,5,8,6,12397,12492,10569,-1923
2020,5,8,7,12172,12229,10232,-1997
2020,5,8,8,12069,12156,10362,-1794
2020,5,8,9,12164,12257,10572,-1685
2020,5,8,10,12539,12620,10737,-1883
2020,5,8,11,13119,13222,11185,-2037
2020,5,8,12,13793,13938,12045,-1893
2020,5,8,13,14230,14403,12357,-2046
2020,5,8,14,14447,14749,12669,-2080
2020,5,8,15,14559,15046,12163,-2883
2020,5,8,16,14690,15108,12402,-2706
2020,5,8,17,14807,15333,12348,-2985
2020,5,8,18,14790,15408,12341,-3067
2020,5,8,19,14750,15427,12566,-2861
2020,5,8,20,14736,15323,12799,-2524
2020,5,8,21,14879,15511,12992,-2519
2020,5,8,22,15185,15828,13306,-2522
2020,5,8,23,15211,15969,13296,-2673
2020,5,9,0,15204,15974,12940,-3034
2020,5,9,1,15304,15981,12954,-3027
2020,5,9,2,14965,15585,12427,-3158
2020,5,9,3,14401,14900,11910,-2990
2020,5,9,4,13764,14136,11512,-2624
2020,5,9,5,13067,13542,11100,-2442
2020,5,9,6,12697,13155,11035,-2120
2020,5,9,7,12432,12907,10809,-2098
2020,5,9,8,12291,12788,10646,-2142
2020,5,9,9,12325,12852,10702,-2150
2020,5,9,10,12437,13072,10904,-2168
2020,5,9,11,12611,13340,11233,-2107
2020,5,9,12,12976,13672,11112,-2560
2020,5,9,13,13315,13961,10991,-2970
2020,5,9,14,13501,14224,11398,-2826
2020,5,9,15,13582,14351,11700,-2651
2020,5,9,16,13684,14444,11863,-2581
2020,5,9,17,13740,14563,11782,-2781
2020,5,9,18,13604,14641,11783,-2858
2020,5,9,19,13487,14605,11850,-2755
2020,5,9,20,13524,14580,11981,-2599
2020,5,9,21,13819,14876,12201,-2675
2020,5,9,22,14330,15390,13127,-2263
2020,5,9,23,14726,15743,13556,-2187
2020,5,10,0,14782,15871,13712,-2159
2020,5,10,1,15092,16154,14264,-1890
2020,5,10,2,14853,15849,13555,-2294
2020,5,10,3,14347,15170,12973,-2197
2020,5,10,4,13752,14373,12092,-2281
2020,5,10,5,13137,13658,11160,-2498
2020,5,10,6,12744,13122,10759,-2363
2020,5,10,7,12411,12786,10503,-2283
2020,5,10,8,12209,12608,10395,-2213
2020,5,10,9,12178,12561,10536,-2025
2020,5,10,10,12166,12650,10780,-1870
2020,5,10,11,12123,12769,10933,-1836
2020,5,10,12,12288,12918,10993,-1925
2020,5,10,13,12595,13065,10867,-2198
2020,5,10,14,12809,13204,10937,-2267
2020,5,10,15,12952,13365,11392,-1973
2020,5,10,16,13045,13413,11280,-2133
2020,5,10,17,13153,13426,11296,-2130
2020,5,10,18,13068,13331,11172,-2159
2020,5,10,19,12980,13166,10855,-2311
2020,5,10,20,13063,13172,10678,-2494
2020,5,10,21,13426,13471,11022,-2449
2020,5,10,22,14078,13955,11451,-2504
2020,5,10,23,14587,14343,11573,-2770
2020,5,11,0,14689,14593,11986,-2607
2020,5,11,1,15068,14937,12229,-2708
2020,5,11,2,14714,14629,12072,-2557
2020,5,11,3,13922,13964,11384,-2580
2020,5,11,4,13095,13290,10857,-2433
2020,5,11,5,12702,12689,9984,-2705
2020,5,11,6,12387,12291,9644,-2647
2020,5,11,7,12163,12085,9676,-2409
2020,5,11,8,12055,12000,9333,-2667
2020,5,11,9,12188,12123,9420,-2703
2020,5,11,10,12616,12617,10188,-2429
2020,5,11,11,13346,13245,10786,-2459
2020,5,11,12,14205,14035,11587,-2448
2020,5,11,13,14758,14806,12523,-2283
2020,5,11,14,15094,15399,12919,-2480
2020,5,11,15,15318,15600,12985,-2615
2020,5,11,16,15402,15720,13173,-2547
2020,5,11,17,15489,15769,13427,-2342
2020,5,11,18,15404,15752,13395,-2357
2020,5,11,19,15313,15566,13016,-2550
2020,5,11,20,15272,15449,12688,-2761
2020,5,11,21,15391,15572,12833,-2739
2020,5,11,22,15825,16050,13622,-2428
2020,5,11,23,15929,15974,13587,-2387
2020,5,12,0,15898,15959,13619,-2340
2020,5,12,1,16052,16066,14039,-2027
2020,5,12,2,15650,15684,13854,-1830
2020,5,12,3,14793,14849,12947,-1902
2020,5,12,4,13932,14056,11721,-2335
2020,5,12,5,13100,13455,11206,-2249
2020,5,12,6,12704,13013,10904,-2109
2020,5,12,7,12445,12783,10760,-2023
2020,5,12,8,12324,12701,11021,-1680
2020,5,12,9,12436,12836,11124,-1712
2020,5,12,10,12816,13276,11479,-1797
2020,5,12,11,13473,13932,11895,-2037
2020,5,12,12,14136,14548,12863,-1685
2020,5,12,13,14447,14806,12860,-1946
2020,5,12,14,14533,14849,13100,-1749
2020,5,12,15,14566,14838,13328,-1510
2020,5,12,16,14546,14846,13162,-1684
2020,5,12,17,14574,14808,12755,-2053
2020,5,12,18,14519,14728,12618,-2110
2020,5,12,19,14464,14605,12250,-2355
2020,5,12,20,14483,14609,12232,-2377
2020,5,12,21,14706,14883,12408,-2475
2020,5,12,22,15213,15380,13036,-2344
2020,5,12,23,15482,15641,12999,-2642
2020,5,13,0,15495,15738,13116,-2622
2020,5,13,1,15718,15964,13203,-2761
2020,5,13,2,15410,15629,13630,-1999
2020,5,13,3,14639,14791,13224,-1567
2020,5,13,4,13833,13973,11990,-1983
2020,5,13,5,12980,13345,11260,-2085
2020,5,13,6,12617,12912,11014,-1898
2020,5,13,7,12395,12670,11102,-1568
2020,5,13,8,12309,12614,11045,-1569
2020,5,13,9,12425,12794,11161,-1633
2020,5,13,10,12792,13321,11492,-1829
2020,5,13,11,13374,13985,11830,-2155
2020,5,13,12,13926,14534,12632,-1902
2020,5,13,13,14139,14715,12782,-1933
2020,5,13,14,14116,14624,12531,-2093
2020,5,13,15,14163,14508,12572,-1936
2020,5,13,16,14195,14506,12386,-2120
2020,5,13,17,14211,14437,12287,-2150
2020,5,13,18,14158,14312,12174,-2138
2020,5,13,19,14070,14107,12016,-2091
2020,5,13,20,14060,14034,11550,-2484
2020,5,13,21,14249,14196,11944,-2252
2020,5,13,22,14770,14629,12810,-1819
2020,5,13,23,15039,14989,12817,-2172
2020,5,14,0,15115,15182,13410,-1772
2020,5,14,1,15415,15464,13941,-1523
2020,5,14,2,15171,15228,13623,-1605
2020,5,14,3,14419,14494,12680,-1814
2020,5,14,4,13605,13707,11414,-2293
2020,5,14,5,12874,13086,10716,-2370
2020,5,14,6,12503,12702,10514,-2188
2020,5,14,7,12276,12475,10407,-2068
2020,5,14,8,12194,12408,10327,-2081
2020,5,14,9,12306,12542,10383,-2159
2020,5,14,10,12686,12981,10854,-2127
2020,5,14,11,13311,13614,11388,-2226
2020,5,14,12,13938,14228,11813,-2415
2020,5,14,13,14232,14563,11718,-2845
2020,5,14,14,14332,14604,11543,-3061
2020,5,14,15,14386,14481,11349,-3132
2020,5,14,16,14487,14554,11352,-3202
2020,5,14,17,14578,14492,11545,-2947
2020,5,14,18,14603,14407,11453,-2954
2020,5,14,19,14604,14275,11485,-2790
2020,5,14,20,14631,14227,11533,-2694
2020,5,14,21,14835,14529,12011,-2518
2020,5,14,22,15245,15013,12837,-2176
2020,5,14,23,15345,15244,13062,-2182
2020,5,15,0,15296,15303,13412,-1891
2020,5,15,1,15416,15469,13562,-1907
2020,5,15,2,15065,15028,13373,-1655
2020,5,15,3,14280,14280,12537,-1743
2020,5,15,4,13469,13473,11411,-2062
2020,5,15,5,12659,12821,10701,-2120
2020,5,15,6,12225,12350,10392,-1958
2020,5,15,7,11956,12072,10069,-2003
2020,5,15,8,11831,11890,9925,-1965
2020,5,15,9,11926,11963,10054,-1909
2020,5,15,10,12304,12322,10414,-1908
2020,5,15,11,13039,12900,11211,-1689
2020,5,15,12,13952,13675,12414,-1261
2020,5,15,13,14629,14366,13231,-1135
2020,5,15,14,15061,14728,13223,-1505
2020,5,15,15,15371,14865,13284,-1581
2020,5,15,16,15665,15140,13655,-1485
2020,5,15,17,15857,15380,13536,-1844
2020,5,15,18,15943,15654,13389,-2265
2020,5,15,19,15940,15796,13699,-2097
2020,5,15,20,15928,16005,14211,-1794
2020,5,15,21,16044,16310,14544,-1766
2020,5,15,22,16332,16644,15416,-1228
2020,5,15,23,16184,16533,15187,-1346
2020,5,16,0,16119,16360,14696,-1664
2020,5,16,1,16085,16311,14443,-1868
2020,5,16,2,15753,15913,14383,-1530
2020,5,16,3,15096,15167,12988,-2179
2020,5,16,4,14340,14327,11841,-2486
2020,5,16,5,13530,13594,11000,-2594
2020,5,16,6,12947,12993,10552,-2441
2020,5,16,7,12517,12557,10418,-2139
2020,5,16,8,12246,12297,10019,-2278
2020,5,16,9,12156,12210,10134,-2076
2020,5,16,10,12151,12226,10205,-2021
2020,5,16,11,12310,12375,10320,-2055
2020,5,16,12,12828,12747,10360,-2387
2020,5,16,13,13301,13184,10646,-2538
2020,5,16,14,13788,13471,10912,-2559
2020,5,16,15,14148,13637,10975,-2662
2020,5,16,16,14359,13747,11303,-2444
2020,5,16,17,14403,13842,11319,-2523
2020,5,16,18,14332,13891,11098,-2793
2020,5,16,19,14242,13948,11020,-2928
2020,5,16,20,14157,14135,11175,-2960
2020,5,16,21,14318,14484,11658,-2826
2020,5,16,22,14720,15000,12200,-2800
2020,5,16,23,14813,15355,12543,-2812
2020,5,17,0,14892,15352,12479,-2873
2020,5,17,1,15119,15483,12571,-2912
2020,5,17,2,14889,15215,12465,-2750
2020,5,17,3,14245,14443,11647,-2796
2020,5,17,4,13475,13589,10674,-2915
2020,5,17,5,12583,12851,9974,-2877
2020,5,17,6,12096,12276,9439,-2837
2020,5,17,7,11730,11889,9077,-2812
2020,5,17,8,11505,11651,9077,-2574
2020,5,17,9,11421,11573,9082,-2491
2020,5,17,10,11349,11583,9302,-2281
2020,5,17,11,11308,11641,9294,-2347
2020,5,17,12,11605,11952,9530,-2422
2020,5,17,13,12040,12346,9662,-2684
2020,5,17,14,12435,12608,10079,-2529
2020,5,17,15,12730,12803,10150,-2653
2020,5,17,16,12979,13001,10292,-2709
2020,5,17,17,13101,13161,10310,-2851
2020,5,17,18,13116,13230,10170,-3060
2020,5,17,19,13115,13418,10288,-3130
2020,5,17,20,13148,13626,10581,-3045
2020,5,17,21,13406,14073,11194,-2879
2020,5,17,22,13927,14648,11609,-3039
2020,5,17,23,14320,14938,11765,-3173
2020,5,18,0,14408,15003,11829,-3174
2020,5,18,1,14769,15117,11874,-3243
2020,5,18,2,14489,14642,11537,-3105
2020,5,18,3,13721,13872,11171,-2701
2020,5,18,4,12875,13055,10713,-2342
2020,5,18,5,12108,12356,9830,-2526
2020,5,18,6,11668,11895,9693,-2202
2020,5,18,7,11437,11647,9516,-2131
2020,5,18,8,11334,11525,9559,-1966
2020,5,18,9,11480,11626,9589,-2037
2020,5,18,10,11948,12041,9758,-2283
2020,5,18,11,12777,12713,10453,-2260
2020,5,18,12,13757,13650,11397,-2253
2020,5,18,13,14448,14475,11944,-2531
2020,5,18,14,14820,14891,12021,-2870
2020,5,18,15,15019,15040,12233,-2807
2020,5,18,16,15191,15129,12416,-2713
2020,5,18,17,15261,15317,12381,-2936
2020,5,18,18,15264,15314,12342,-2972
2020,5,18,19,15158,15271,12341,-2930
2020,5,18,20,15076,15195,12486,-2709
2020,5,18,21,15210,15325,12156,-3169
2020,5,18,22,15605,15625,12267,-3358
2020,5,18,23,15635,15646,12368,-3278
2020,5,19,0,15597,15552,12300,-3252
2020,5,19,1,15650,15631,12484,-3147
2020,5,19,2,15234,15182,12391,-2791
2020,5,19,3,14274,14338,11687,-2651
2020,5,19,4,13276,13412,10684,-2728
2020,5,19,5,12470,12712,9980,-2732
2020,5,19,6,11941,12234,9676,-2558
2020,5,19,7,11637,11940,9473,-2467
2020,5,19,8,11489,11793,9373,-2420
2020,5,19,9,11592,11856,9435,-2421
2020,5,19,10,12021,12199,9685,-2514
2020,5,19,11,12796,12833,10109,-2724
2020,5,19,12,13646,13570,11185,-2385
2020,5,19,13,14179,14046,11392,-2654
2020,5,19,14,14425,14192,11304,-2888
2020,5,19,15,14559,14284,11324,-2960
2020,5,19,16,14705,14371,11490,-2881
2020,5,19,17,14790,14520,11637,-2883
2020,5,19,18,14829,14553,11600,-2953
2020,5,19,19,14767,14546,11777,-2769
2020,5,19,20,14737,14559,11897,-2662
2020,5,19,21,14928,14768,11941,-2827
2020,5,19,22,15331,15120,12156,-2964
2020,5,19,23,15401,15215,12260,-2955
2020,5,20,0,15393,15197,12292,-2905
2020,5,20,1,15498,15356,12521,-2835
2020,5,20,2,15131,15019,12361,-2658
2020,5,20,3,14183,14196,11601,-2595
2020,5,20,4,13185,13308,10767,-2541
2020,5,20,5,12259,12650,9922,-2728
2020,5,20,6,11781,12153,9620,-2533
2020,5,20,7,11514,11863,9312,-2551
2020,5,20,8,11385,11729,9312,-2417
2020,5,20,9,11493,11827,9445,-2382
2020,5,20,10,11897,12161,9823,-2338
2020,5,20,11,12623,12811,10369,-2442
2020,5,20,12,13421,13551,11072,-2479
2020,5,20,13,13883,14041,11409,-2632
2020,5,20,14,14029,14157,11409,-2748
2020,5,20,15,14195,14230,11533,-2697
2020,5,20,16,14324,14280,11713,-2567
2020,5,20,17,14369,14339,11160,-3179
2020,5,20,18,14371,14309,10962,-3347
2020,5,20,19,14272,14284,10859,-3425
2020,5,20,20,14247,14359,10890,-3469
2020,5,20,21,14455,14613,11238,-3375
2020,5,20,22,14893,15068,11795,-3273
2020,5,20,23,15016,15319,12171,-3148
2020,5,21,0,15074,15342,12152,-3190
2020,5,21,1,15251,15429,12209,-3220
2020,5,21,2,14940,15191,12277,-2914
2020,5,21,3,14032,14363,11454,-2909
2020,5,21,4,13057,13444,10521,-2923
2020,5,21,5,12277,12723,10194,-2529
2020,5,21,6,11824,12205,9805,-2400
2020,5,21,7,11542,11936,9483,-2453
2020,5,21,8,11416,11813,9355,-2458
2020,5,21,9,11526,11909,9529,-2380
2020,5,21,10,11956,12266,9959,-2307
2020,5,21,11,12701,12931,10447,-2484
2020,5,21,12,13491,13575,11139,-2436
2020,5,21,13,14003,13963,11257,-2706
2020,5,21,14,14141,14095,10969,-3126
2020,5,21,15,14170,14132,10805,-3327
2020,5,21,16,14268,14211,11116,-3095
2020,5,21,17,14331,14301,11517,-2784
2020,5,21,18,14365,14385,11656,-2729
2020,5,21,19,14334,14385,11512,-2873
2020,5,21,20,14353,14460,11304,-3156
2020,5,21,21,14615,14782,11400,-3382
2020,5,21,22,15039,15265,11834,-3431
2020,5,21,23,15185,15469,12481,-2988
2020,5,22,0,15196,15416,12596,-2820
2020,5,22,1,15387,15472,12701,-2771
2020,5,22,2,15061,15256,12804,-2452
2020,5,22,3,14162,14452,12097,-2355
2020,5,22,4,13192,13565,10786,-2779
2020,5,22,5,12557,12872,9948,-2924
2020,5,22,6,12063,12358,9538,-2820
2020,5,22,7,11737,12031,9541,-2490
2020,5,22,8,11567,11872,9489,-2383
2020,5,22,9,11642,11912,9580,-2332
2020,5,22,10,12024,12174,9691,-2483
2020,5,22,11,12757,12742,10493,-2249
2020,5,22,12,13634,13488,11382,-2106
2020,5,22,13,14406,14062,11830,-2232
2020,5,22,14,14770,14441,12024,-2417
2020,5,22,15,15039,14784,12249,-2535
2020,5,22,16,15372,15108,12490,-2618
2020,5,22,17,15618,15347,12492,-2855
2020,5,22,18,15785,15497,12080,-3417
2020,5,22,19,15885,15570,12505,-3065
2020,5,22,20,15915,15715,12707,-3008
2020,5,22,21,16027,16005,12891,-3114
2020,5,22,22,16239,16361,13316,-3045
2020,5,22,23,16041,16491,13499,-2992
2020,5,23,0,15936,16398,13435,-2963
2020,5,23,1,15944,16389,13412,-2977
2020,5,23,2,15610,16010,13182,-2828
2020,5,23,3,14886,15223,12608,-2615
2020,5,23,4,14000,14389,11076,-3313
2020,5,23,5,13124,13635,10362,-3273
2020,5,23,6,12555,13052,9883,-3169
2020,5,23,7,12172,12666,9453,-3213
2020,5,23,8,11954,12423,9334,-3089
2020,5,23,9,11901,12302,9533,-2769
2020,5,23,10,11960,12361,9756,-2605
2020,5,23,11,12147,12537,9971,-2566
2020,5,23,12,12677,12994,10206,-2788
2020,5,23,13,13497,13589,10430,-3159
2020,5,23,14,14103,14254,10910,-3344
2020,5,23,15,14527,14710,11599,-3111
2020,5,23,16,14877,15086,11852,-3234
2020,5,23,17,15128,15287,12072,-3215
2020,5,23,18,15139,15393,11995,-3398
2020,5,23,19,15090,15405,11803,-3602
2020,5,23,20,15017,15413,11744,-3669
2020,5,23,21,15066,15511,11930,-3581
2020,5,23,22,15273,15693,12556,-3137
2020,5,23,23,15204,15761,12732,-3029
2020,5,24,0,15233,15589,12639,-2950
2020,5,24,1,15334,15522,12690,-2832
2020,5,24,2,15082,15172,12519,-2653
2020,5,24,3,14363,14418,11851,-2567
2020,5,24,4,13524,13631,10613,-3018
2020,5,24,5,12452,12915,9613,-3302
2020,5,24,6,11904,12358,9272,-3086
2020,5,24,7,11548,11976,9134,-2842
2020,5,24,8,11304,11732,9101,-2631
2020,5,24,9,11148,11626,9038,-2588
2020,5,24,10,10946,11569,8998,-2571
2020,5,24,11,10716,11676,9339,-2337
2020,5,24,12,10809,12030,9487,-2543
2020,5,24,13,11357,12478,9570,-2908
2020,5,24,14,11841,12842,9667,-3175
2020,5,24,15,12251,13148,9851,-3297
2020,5,24,16,12655,13416,9929,-3487
2020,5,24,17,12949,13615,10363,-3252
2020,5,24,18,13057,13630,10452,-3178
2020,5,24,19,13139,13710,10536,-3174
2020,5,24,20,13368,13916,10824,-3092
2020,5,24,21,13878,14352,11197,-3155
2020,5,24,22,14447,14943,11828,-3115
2020,5,24,23,14651,15315,12138,-3177
2020,5,25,0,14607,15310,12433,-2877
2020,5,25,1,14597,15386,12587,-2799
2020,5,25,2,14459,15278,12407,-2871
2020,5,25,3,13889,14602,11864,-2738
2020,5,25,4,13168,13804,10941,-2863
2020,5,25,5,12469,13066,10220,-2846
2020,5,25,6,11900,12533,10078,-2455
2020,5,25,7,11535,12136,9754,-2382
2020,5,25,8,11297,11854,9860,-1994
2020,5,25,9,11189,11827,9846,-1981
2020,5,25,10,11067,11897,9915,-1982
2020,5,25,11,10834,12054,10294,-1760
2020,5,25,12,11078,12468,10745,-1723
2020,5,25,13,11929,13031,11058,-1973
2020,5,25,14,12699,13657,11692,-1965
2020,5,25,15,13245,14081,11867,-2214
2020,5,25,16,13686,14416,11949,-2467
2020,5,25,17,14016,14628,12378,-2250
2020,5,25,18,14090,14724,12394,-2330
2020,5,25,19,14114,14798,12389,-2409
2020,5,25,20,14223,15021,12559,-2462
2020,5,25,21,14602,15528,12793,-2735
2020,5,25,22,15212,16159,13523,-2636
2020,5,25,23,15545,16513,14096,-2417
2020,5,26,0,15460,16502,13814,-2688
2020,5,26,1,15517,16532,13845,-2687
2020,5,26,2,15409,16326,13882,-2444
2020,5,26,3,14649,15383,13132,-2251
2020,5,26,4,13747,14319,12088,-2231
2020,5,26,5,13337,13519,10991,-2528
2020,5,26,6,12779,12911,10478,-2433
2020,5,26,7,12410,12537,9997,-2540
2020,5,26,8,12213,12346,9747,-2599
2020,5,26,9,12226,12364,9874,-2490
2020,5,26,10,12539,12673,10081,-2592
2020,5,26,11,13227,13386,10593,-2793
2020,5,26,12,14326,14447,12089,-2358
2020,5,26,13,15489,15445,12760,-2685
2020,5,26,14,16354,16199,13279,-2920
2020,5,26,15,17062,16787,13744,-3043
2020,5,26,16,17700,17346,13847,-3499
2020,5,26,17,18247,17768,14210,-3558
2020,5,26,18,18634,18183,14527,-3656
2020,5,26,19,18859,18593,15015,-3578
2020,5,26,20,19145,18969,16214,-2755
2020,5,26,21,19626,19374,16962,-2412
2020,5,26,22,20084,19810,17602,-2208
2020,5,26,23,20037,19891,18050,-1841
2020,5,27,0,19410,19516,17467,-2049
2020,5,27,1,18900,19018,16623,-2395
2020,5,27,2,18325,18528,15864,-2664
2020,5,27,3,17127,17315,14659,-2656
2020,5,27,4,15814,15978,13200,-2778
2020,5,27,5,14732,14964,12108,-2856
2020,5,27,6,13954,14238,11508,-2730
2020,5,27,7,13409,13674,11097,-2577
2020,5,27,8,13083,13355,10892,-2463
2020,5,27,9,13021,13287,10776,-2511
2020,5,27,10,13294,13511,10551,-2960
2020,5,27,11,14012,14244,10910,-3334
2020,5,27,12,15084,15331,11878,-3453
2020,5,27,13,16340,16272,12811,-3461
2020,5,27,14,17175,16981,13246,-3735
2020,5,27,15,17850,17510,13926,-3584
2020,5,27,16,18465,18139,14328,-3811
2020,5,27,17,19012,18737,15270,-3467
2020,5,27,18,19443,19236,15995,-3241
2020,5,27,19,19731,19584,16392,-3192
2020,5,27,20,19984,19796,16443,-3353
2020,5,27,21,20292,19930,16051,-3879
2020,5,27,22,20476,20088,17045,-3043
2020,5,27,23,20331,19892,17517,-2375
2020,5,28,0,19599,19413,16923,-2490
2020,5,28,1,19091,18995,16248,-2747
2020,5,28,2,18621,18466,15961,-2505
2020,5,28,3,17485,17272,14737,-2535
2020,5,28,4,16135,16106,13311,-2795
2020,5,28,5,15156,15097,12538,-2559
2020,5,28,6,14353,14358,11769,-2589
2020,5,28,7,13790,13868,11664,-2204
2020,5,28,8,13452,13585,11502,-2083
2020,5,28,9,13394,13566,11189,-2377
2020,5,28,10,13682,13849,10936,-2913
2020,5,28,11,14417,14557,11704,-2853
2020,5,28,12,15480,15562,12669,-2893
2020,5,28,13,16527,16590,13558,-3032
2020,5,28,14,17341,17291,14354,-2937
2020,5,28,15,17910,17971,14608,-3363
2020,5,28,16,18321,18387,14980,-3407
2020,5,28,17,18672,18852,15334,-3518
2020,5,28,18,18898,19094,15626,-3468
2020,5,28,19,18975,19161,15961,-3200
2020,5,28,20,19051,19203,16242,-2961
2020,5,28,21,19252,19244,16236,-3008
2020,5,28,22,19437,19257,16519,-2738
2020,5,28,23,19518,19031,16678,-2353
2020,5,29,0,18919,18733,15940,-2793
2020,5,29,1,18573,18533,15843,-2690
2020,5,29,2,18264,18056,15415,-2641
2020,5,29,3,17286,17041,14525,-2516
2020,5,29,4,16050,15965,13398,-2567
2020,5,29,5,15232,15171,12444,-2727
2020,5,29,6,14633,14515,11719,-2796
2020,5,29,7,14167,14036,11263,-2773
2020,5,29,8,13893,13758,11547,-2211
2020,5,29,9,13828,13771,11377,-2394
2020,5,29,10,14061,14076,11527,-2549
2020,5,29,11,14700,14860,12272,-2588
2020,5,29,12,15732,15940,13062,-2878
2020,5,29,13,16828,17003,14395,-2608
2020,5,29,14,17640,17741,14612,-3129
2020,5,29,15,18240,18336,14959,-3377
2020,5,29,16,18739,18919,15388,-3531
2020,5,29,17,19062,19420,15714,-3706
2020,5,29,18,19331,19794,16232,-3562
2020,5,29,19,19464,20006,16238,-3768
2020,5,29,20,19512,19937,16513,-3424
2020,5,29,21,19601,20028,16389,-3639
2020,5,29,22,19683,20124,16378,-3746
2020,5,29,23,19482,19629,16104,-3525
2020,5,30,0,18913,18918,15671,-3247
2020,5,30,1,18400,18544,15436,-3108
2020,5,30,2,18058,17952,14795,-3157
2020,5,30,3,17293,16990,14173,-2817
2020,5,30,4,16268,15946,13445,-2501
2020,5,30,5,15237,14978,12819,-2159
2020,5,30,6,14508,14273,12298,-1975
2020,5,30,7,13941,13758,11963,-1795
2020,5,30,8,13542,13422,11751,-1671
2020,5,30,9,13247,13272,11704,-1568
2020,5,30,10,13018,13215,11821,-1394
2020,5,30,11,12947,13394,11796,-1598
2020,5,30,12,13400,13879,12151,-1728
2020,5,30,13,14249,14436,12350,-2086
2020,5,30,14,14982,14907,12596,-2311
2020,5,30,15,15568,15305,12537,-2768
2020,5,30,16,16029,15603,12823,-2780
2020,5,30,17,16362,15865,12923,-2942
2020,5,30,18,16599,16070,13289,-2781
2020,5,30,19,16832,16306,13505,-2801
2020,5,30,20,17189,16578,13563,-3015
2020,5,30,21,17686,17000,13981,-3019
2020,5,30,22,18048,17446,14341,-3105
2020,5,30,23,17991,17402,14440,-2962
2020,5,31,0,17387,17084,14711,-2373
2020,5,31,1,16875,16868,14156,-2712
2020,5,31,2,16596,16565,14216,-2349
2020,5,31,3,15959,15772,14137,-1635
2020,5,31,4,15150,14862,13074,-1788
2020,5,31,5,13936,13974,11957,-2017
2020,5,31,6,13287,13239,11345,-1894
2020,5,31,7,12758,12698,11210,-1488
2020,5,31,8,12355,12288,10822,-1466
2020,5,31,9,12031,12061,10736,-1325
2020,5,31,10,11683,11908,10584,-1324
2020,5,31,11,11407,11965,10548,-1417
2020,5,31,12,11586,12231,10733,-1498
2020,5,31,13,12074,12660,10985,-1675
2020,5,31,14,12574,13008,11627,-1381
2020,5,31,15,12959,13315,11532,-1783
2020,5,31,16,13244,13587,11665,-1922
2020,5,31,17,13393,13791,11765,-2026
2020,5,31,18,13512,13837,12000,-1837
2020,5,31,19,13643,13869,12162,-1707
2020,5,31,20,13991,14018,12697,-1321
2020,5,31,21,14566,14305,12990,-1315
2020,5,31,22,15169,14742,13352,-1390
2020,5,31,23,15563,14986,13661,-1325
2020,6,1,0,15284,14991,13526,-1465
2020,6,1,1,15146,15045,13580,-1465
2020,6,1,2,15025,14934,13622,-1312
2020,6,1,3,14388,14208,13085,-1123
2020,6,1,4,13534,13402,11849,-1553
2020,6,1,5,12748,12687,10997,-1690
2020,6,1,6,12190,12185,10736,-1449
2020,6,1,7,11906,11905,10477,-1428
2020,6,1,8,11746,11791,10409,-1382
2020,6,1,9,11798,11882,10145,-1737
2020,6,1,10,12029,12242,10635,-1607
2020,6,1,11,12626,12948,11557,-1391
2020,6,1,12,13492,13790,12551,-1239
2020,6,1,13,14139,14339,13013,-1326
2020,6,1,14,14526,14652,13240,-1412
2020,6,1,15,14761,14839,13187,-1652
2020,6,1,16,14888,15088,13388,-1700
2020,6,1,17,14963,15334,13534,-1800
2020,6,1,18,15034,15428,14002,-1426
2020,6,1,19,15126,15350,14269,-1081
2020,6,1,20,15258,15380,13991,-1389
2020,6,1,21,15531,15573,13959,-1614
2020,6,1,22,15920,15884,14371,-1513
2020,6,1,23,16032,15973,14381,-1592
2020,6,2,0,15896,15860,14370,-1490
2020,6,2,1,15845,15747,14271,-1476
2020,6,2,2,15523,15514,13909,-1605
2020,6,2,3,14664,14702,13060,-1642
2020,6,2,4,13706,13784,12058,-1726
2020,6,2,5,12847,13047,11151,-1896
2020,6,2,6,12291,12530,10903,-1627
2020,6,2,7,11916,12231,10539,-1692
2020,6,2,8,11706,12068,10260,-1808
2020,6,2,9,11746,12117,10237,-1880
2020,6,2,10,12059,12417,10725,-1692
2020,6,2,11,12862,13132,11489,-1643
2020,6,2,12,13909,14088,12479,-1609
2020,6,2,13,14815,14911,13169,-1742
2020,6,2,14,15250,15432,13826,-1606
2020,6,2,15,15537,15782,13963,-1819
2020,6,2,16,15765,16004,13989,-2015
2020,6,2,17,15894,16149,13930,-2219
2020,6,2,18,15971,16105,13687,-2418
2020,6,2,19,16012,16015,13628,-2387
2020,6,2,20,16056,16017,13641,-2376
2020,6,2,21,16205,16165,13980,-2185
2020,6,2,22,16468,16431,14347,-2084
2020,6,2,23,16422,16372,14388,-1984
2020,6,3,0,16286,16205,14488,-1717
2020,6,3,1,16298,16184,14468,-1716
2020,6,3,2,16000,15935,14427,-1508
2020,6,3,3,15104,15162,13627,-1535
2020,6,3,4,14088,14318,11975,-2343
2020,6,3,5,13307,13566,11541,-2025
2020,6,3,6,12876,12993,11054,-1939
2020,6,3,7,12559,12666,10595,-2071
2020,6,3,8,12397,12496,10532,-1964
2020,6,3,9,12444,12577,10338,-2239
2020,6,3,10,12761,12892,10685,-2207
2020,6,3,11,13521,13659,11612,-2047
2020,6,3,12,14536,14690,12406,-2284
2020,6,3,13,15393,15592,13571,-2021
2020,6,3,14,16042,16249,14064,-2185
2020,6,3,15,16664,16807,14334,-2473
2020,6,3,16,17304,17352,14982,-2370
2020,6,3,17,17824,17842,15499,-2343
2020,6,3,18,18353,18212,15675,-2537
2020,6,3,19,18660,18031,16021,-2010
2020,6,3,20,18886,17952,15789,-2163
2020,6,3,21,19109,18285,16000,-2285
2020,6,3,22,19323,18893,16677,-2216
2020,6,3,23,19021,18991,16706,-2285
2020,6,4,0,18771,18678,16453,-2225
2020,6,4,1,18528,18460,15895,-2565
2020,6,4,2,18211,17887,15393,-2494
2020,6,4,3,17216,16838,14698,-2140
2020,6,4,4,16063,15750,13526,-2224
2020,6,4,5,14702,14819,12487,-2332
2020,6,4,6,14082,14137,11808,-2329
2020,6,4,7,13577,13680,11388,-2292
2020,6,4,8,13264,13376,11016,-2360
2020,6,4,9,13213,13360,11348,-2012
2020,6,4,10,13418,13596,11476,-2120
2020,6,4,11,14110,14381,12174,-2207
2020,6,4,12,15187,15508,13592,-1916
2020,6,4,13,16270,16585,14796,-1789
2020,6,4,14,16984,17409,15476,-1933
2020,6,4,15,17659,18131,15588,-2543
2020,6,4,16,18364,18840,15868,-2972
2020,6,4,17,19017,19574,16423,-3151
2020,6,4,18,19539,20057,16999,-3058
2020,6,4,19,19904,20382,17378,-3004
2020,6,4,20,20202,20724,17590,-3134
2020,6,4,21,20524,21048,18081,-2967
2020,6,4,22,20761,21113,18313,-2800
2020,6,4,23,20343,20743,17785,-2958
2020,6,5,0,19886,20086,17089,-2997
2020,6,5,1,19499,19764,17142,-2622
2020,6,5,2,19025,19326,16742,-2584
2020,6,5,3,17903,18274,16264,-2010
2020,6,5,4,16651,17082,15087,-1995
2020,6,5,5,15434,16062,13626,-2436
2020,6,5,6,14672,15292,12936,-2356
2020,6,5,7,14130,14792,12532,-2260
2020,6,5,8,13800,14477,12106,-2371
2020,6,5,9,13754,14422,12127,-2295
2020,6,5,10,13962,14700,12347,-2353
2020,6,5,11,14649,15418,13225,-2193
2020,6,5,12,15796,16492,14380,-2112
2020,6,5,13,16994,17502,15094,-2408
2020,6,5,14,17799,18210,15959,-2251
2020,6,5,15,18651,18897,16337,-2560
2020,6,5,16,19475,19475,16679,-2796
2020,6,5,17,20208,19989,17110,-2879
2020,6,5,18,20768,20454,17441,-3013
2020,6,5,19,21174,20763,17477,-3286
2020,6,5,20,21516,20968,17745,-3223
2020,6,5,21,21798,21250,18289,-2961
2020,6,5,22,21888,21355,18368,-2987
2020,6,5,23,21482,21040,17816,-3224
2020,6,6,0,20709,20514,17063,-3451
2020,6,6,1,20112,20058,16956,-3102
2020,6,6,2,19654,19583,16404,-3179
2020,6,6,3,18742,18576,15618,-2958
2020,6,6,4,17562,17384,14558,-2826
2020,6,6,5,15728,16412,13219,-3193
2020,6,6,6,14923,15611,12768,-2843
2020,6,6,7,14332,15044,12469,-2575
2020,6,6,8,13920,14629,12116,-2513
2020,6,6,9,13713,14438,11826,-2612
2020,6,6,10,13584,14404,11921,-2483
2020,6,6,11,13765,14651,12020,-2631
2020,6,6,12,14419,15330,12380,-2950
2020,6,6,13,15347,16258,12795,-3463
2020,6,6,14,16106,17221,13725,-3496
2020,6,6,15,16786,18177,15048,-3129
2020,6,6,16,17408,19080,16390,-2690
2020,6,6,17,17917,19739,17341,-2398
2020,6,6,18,18184,20191,17368,-2823
2020,6,6,19,18410,20358,17880,-2478
2020,6,6,20,18605,20406,17838,-2568
2020,6,6,21,18859,20379,17966,-2413
2020,6,6,22,19061,20365,17542,-2823
2020,6,6,23,18678,20146,17160,-2986
2020,6,7,0,18234,19364,15796,-3568
2020,6,7,1,17703,18684,14877,-3807
2020,6,7,2,17328,18184,15033,-3151
2020,6,7,3,16496,17216,14335,-2881
2020,6,7,4,15536,16075,13123,-2952
2020,6,7,5,14805,15005,12175,-2830
2020,6,7,6,14056,14197,11348,-2849
2020,6,7,7,13471,13601,10583,-3018
2020,6,7,8,13016,13199,10212,-2987
2020,6,7,9,12753,12946,10050,-2896
2020,6,7,10,12467,12677,9925,-2752
2020,6,7,11,12422,12758,9985,-2773
2020,6,7,12,12788,13127,10458,-2669
2020,6,7,13,13434,13652,10767,-2885
2020,6,7,14,13982,14160,11211,-2949
2020,6,7,15,14470,14696,11916,-2780
2020,6,7,16,14888,15029,12154,-2875
2020,6,7,17,15224,15303,12420,-2883
2020,6,7,18,15413,15419,12705,-2714
2020,6,7,19,15594,15489,12956,-2533
2020,6,7,20,15845,15732,13210,-2522
2020,6,7,21,16198,16192,13574,-2618
2020,6,7,22,16637,16677,13965,-2712
2020,6,7,23,16651,16891,14045,-2846
2020,6,8,0,16460,16709,14322,-2387
2020,6,8,1,16293,16540,14414,-2126
2020,6,8,2,16093,16382,14227,-2155
2020,6,8,3,15296,15595,13602,-1993
2020,6,8,4,14350,14660,12083,-2577
2020,6,8,5,13757,13825,11204,-2621
2020,6,8,6,13186,13263,10991,-2272
2020,6,8,7,12822,12862,10408,-2454
2020,6,8,8,12596,12629,9880,-2749
2020,6,8,9,12618,12637,10025,-2612
2020,6,8,10,12867,12928,10606,-2322
2020,6,8,11,13535,13742,11466,-2276
2020,6,8,12,14492,14716,12689,-2027
2020,6,8,13,15338,15450,13346,-2104
2020,6,8,14,15876,15916,13514,-2402
2020,6,8,15,16345,16297,13718,-2579
2020,6,8,16,16752,16609,14026,-2583
2020,6,8,17,17111,16931,14305,-2626
2020,6,8,18,17352,17233,14791,-2442
2020,6,8,19,17575,17549,14750,-2799
2020,6,8,20,17843,17973,15160,-2813
2020,6,8,21,18219,18564,15515,-3049
2020,6,8,22,18607,19056,16025,-3031
2020,6,8,23,18487,18977,16717,-2260
2020,6,9,0,18120,18501,15783,-2718
2020,6,9,1,17778,17985,15397,-2588
2020,6,9,2,17355,17645,15242,-2403
2020,6,9,3,16340,16659,14302,-2357
2020,6,9,4,15186,15520,13152,-2368
2020,6,9,5,13948,14603,11957,-2646
2020,6,9,6,13325,13948,11504,-2444
2020,6,9,7,12908,13506,11283,-2223
2020,6,9,8,12649,13253,11057,-2196
2020,6,9,9,12651,13230,10986,-2244
2020,6,9,10,12886,13519,11180,-2339
2020,6,9,11,13572,14341,11857,-2484
2020,6,9,12,14622,15506,13330,-2176
2020,6,9,13,15567,16562,14403,-2159
2020,6,9,14,16255,17271,14760,-2511
2020,6,9,15,16985,17937,14978,-2959
2020,6,9,16,17728,18672,15724,-2948
2020,6,9,17,18451,19418,16410,-3008
2020,6,9,18,19029,20225,17050,-3175
2020,6,9,19,19522,20913,17158,-3755
2020,6,9,20,20033,21643,17997,-3646
2020,6,9,21,20582,22328,18736,-3592
2020,6,9,22,20996,22842,19178,-3664
2020,6,9,23,20928,22766,19166,-3600
2020,6,10,0,20343,22200,18782,-3418
2020,6,10,1,19876,21474,17673,-3801
2020,6,10,2,19442,21019,17197,-3822
2020,6,10,3,18285,19783,15798,-3985
2020,6,10,4,16942,18341,14357,-3984
2020,6,10,5,16176,17067,13339,-3728
2020,6,10,6,15317,16153,12894,-3259
2020,6,10,7,14721,15545,12517,-3028
2020,6,10,8,14333,15140,12326,-2814
2020,6,10,9,14255,15020,12271,-2749
2020,6,10,10,14485,15264,12588,-2676
2020,6,10,11,15341,16099,13342,-2757
2020,6,10,12,16625,17270,14397,-2873
2020,6,10,13,17858,18385,15260,-3125
2020,6,10,14,18803,19310,16012,-3298
2020,6,10,15,19784,20248,16779,-3469
2020,6,10,16,20768,21161,17964,-3197
2020,6,10,17,21628,22041,18811,-3230
2020,6,10,18,22305,22855,19622,-3233
2020,6,10,19,22782,23388,19966,-3422
2020,6,10,20,23177,23871,20514,-3357
2020,6,10,21,23536,24284,20861,-3423
2020,6,10,22,23677,24477,21464,-3013
2020,6,10,23,23382,24067,20806,-3261
2020,6,11,0,22682,23274,19817,-3457
2020,6,11,1,22186,22484,19127,-3357
2020,6,11,2,21620,22002,18389,-3613
2020,6,11,3,20334,20788,17669,-3119
2020,6,11,4,18852,19285,16196,-3089
2020,6,11,5,17743,18002,14789,-3213
2020,6,11,6,16843,17082,14396,-2686
2020,6,11,7,16221,16477,13753,-2724
2020,6,11,8,15803,16069,13461,-2608
2020,6,11,9,15681,15951,13340,-2611
2020,6,11,10,15881,16173,13787,-2386
2020,6,11,11,16684,16981,14583,-2398
2020,6,11,12,17889,18110,15556,-2554
2020,6,11,13,19041,19245,15969,-3276
2020,6,11,14,19777,19885,16628,-3257
2020,6,11,15,20418,20347,17351,-2996
2020,6,11,16,20902,20701,18140,-2561
2020,6,11,17,21320,21144,18340,-2804
2020,6,11,18,21552,21362,18396,-2966
2020,6,11,19,21654,21246,18071,-3175
2020,6,11,20,21724,21096,17702,-3394
2020,6,11,21,21858,21071,17730,-3341
2020,6,11,22,21982,21244,17934,-3310
2020,6,11,23,21710,21161,17423,-3738
2020,6,12,0,21151,20563,16734,-3829
2020,6,12,1,20597,19989,16432,-3557
2020,6,12,2,20121,19564,16363,-3201
2020,6,12,3,19004,18549,15508,-3041
2020,6,12,4,17683,17266,14774,-2492
2020,6,12,5,16388,16207,13627,-2580
2020,6,12,6,15515,15410,12925,-2485
2020,6,12,7,14921,14828,12714,-2114
2020,6,12,8,14522,14441,12371,-2070
2020,6,12,9,14384,14330,12247,-2083
2020,6,12,10,14504,14562,12669,-1893
2020,6,12,11,15154,15407,13647,-1760
2020,6,12,12,16203,16600,14651,-1949
2020,6,12,13,17242,17592,15341,-2251
2020,6,12,14,17902,18195,15442,-2753
2020,6,12,15,18529,18763,15800,-2963
2020,6,12,16,19087,19279,16115,-3164
2020,6,12,17,19588,19658,16139,-3519
2020,6,12,18,19982,19987,16311,-3676
2020,6,12,19,20334,20194,16570,-3624
2020,6,12,20,20703,20420,16516,-3904
2020,6,12,21,21063,20601,16968,-3633
2020,6,12,22,21187,20625,17216,-3409
2020,6,12,23,20660,20187,16774,-3413
2020,6,13,0,19956,19547,16315,-3232
2020,6,13,1,19120,18943,15762,-3181
2020,6,13,2,18731,18567,15706,-2861
2020,6,13,3,17868,17579,14871,-2708
2020,6,13,4,16792,16434,13602,-2832
2020,6,13,5,14798,15324,12349,-2975
2020,6,13,6,14039,14493,11498,-2995
2020,6,13,7,13508,13838,10755,-3083
2020,6,13,8,13131,13381,10074,-3307
2020,6,13,9,12920,13154,9886,-3268
2020,6,13,10,12720,12994,10074,-2920
2020,6,13,11,12791,13203,10521,-2682
2020,6,13,12,13296,13626,11292,-2334
2020,6,13,13,13959,14126,11307,-2819
2020,6,13,14,14469,14510,11551,-2959
2020,6,13,15,14859,14761,12297,-2464
2020,6,13,16,15168,14957,12551,-2406
2020,6,13,17,15386,15100,12737,-2363
2020,6,13,18,15486,15203,12835,-2368
2020,6,13,19,15578,15327,12909,-2418
2020,6,13,20,15737,15589,13373,-2216
2020,6,13,21,16101,16014,13874,-2140
2020,6,13,22,16494,16499,14365,-2134
2020,6,13,23,16609,16672,14565,-2107
2020,6,14,0,16325,16451,14319,-2132
2020,6,14,1,15993,16193,13809,-2384
2020,6,14,2,15828,16025,13688,-2337
2020,6,14,3,15207,15252,13088,-2164
2020,6,14,4,14412,14354,12473,-1881
2020,6,14,5,13176,13560,11253,-2307
2020,6,14,6,12545,12978,10663,-2315
2020,6,14,7,12136,12598,10071,-2527
2020,6,14,8,11851,12325,9962,-2363
2020,6,14,9,11713,12174,9796,-2378
2020,6,14,10,11545,12047,9676,-2371
2020,6,14,11,11550,12149,10002,-2147
2020,6,14,12,11960,12473,10839,-1634
2020,6,14,13,12557,12932,10930,-2002
2020,6,14,14,13111,13407,11248,-2159
2020,6,14,15,13573,13794,11162,-2632
2020,6,14,16,13958,14100,11364,-2736
2020,6,14,17,14253,14468,11788,-2680
2020,6,14,18,14415,14674,12009,-2665
2020,6,14,19,14529,14707,12010,-2697
2020,6,14,20,14780,14950,12225,-2725
2020,6,14,21,15216,15303,12815,-2488
2020,6,14,22,15709,15841,13271,-2570
2020,6,14,23,16040,16152,13258,-2894
2020,6,15,0,15805,16066,13480,-2586
2020,6,15,1,15647,15880,13540,-2340
2020,6,15,2,15537,15832,13653,-2179
2020,6,15,3,14736,15149,12867,-2282
2020,6,15,4,13758,14268,11752,-2516
2020,6,15,5,13075,13579,11134,-2445
2020,6,15,6,12568,13052,10698,-2354
2020,6,15,7,12256,12693,10698,-1995
2020,6,15,8,12068,12495,10547,-1948
2020,6,15,9,12124,12571,10406,-2165
2020,6,15,10,12479,12947,10847,-2100
2020,6,15,11,13375,13819,11520,-2299
2020,6,15,12,14470,14805,12237,-2568
2020,6,15,13,15398,15535,12918,-2617
2020,6,15,14,15913,15921,12897,-3024
2020,6,15,15,16338,16181,13151,-3030
2020,6,15,16,16691,16491,13781,-2710
2020,6,15,17,17068,16812,13742,-3070
2020,6,15,18,17358,16997,13638,-3359
2020,6,15,19,17542,17045,13599,-3446
2020,6,15,20,17772,17221,13736,-3485
2020,6,15,21,18096,17648,14433,-3215
2020,6,15,22,18427,18036,14612,-3424
2020,6,15,23,18281,17937,14795,-3142
2020,6,16,0,17867,17554,14697,-2857
2020,6,16,1,17367,17117,14654,-2463
2020,6,16,2,16916,16819,14477,-2342
2020,6,16,3,15837,15848,13670,-2178
2020,6,16,4,14631,14784,12377,-2407
2020,6,16,5,13459,13904,11304,-2600
2020,6,16,6,12877,13280,10810,-2470
2020,6,16,7,12487,12887,10412,-2475
2020,6,16,8,12248,12678,10259,-2419
2020,6,16,9,12285,12729,10217,-2512
2020,6,16,10,12627,13023,10751,-2272
2020,6,16,11,13538,13918,11434,-2484
2020,6,16,12,14689,14976,12737,-2239
2020,6,16,13,15643,15809,13637,-2172
2020,6,16,14,16166,16184,13865,-2319
2020,6,16,15,16643,16495,14479,-2016
2020,6,16,16,17095,16804,14447,-2357
2020,6,16,17,17584,17064,14511,-2553
2020,6,16,18,17976,17418,14584,-2834
2020,6,16,19,18194,17766,14503,-3263
2020,6,16,20,18447,18150,15135,-3015
2020,6,16,21,18802,18626,15541,-3085
2020,6,16,22,19143,19048,15858,-3190
2020,6,16,23,18982,19051,16110,-2941
2020,6,17,0,18451,18586,15576,-3010
2020,6,17,1,17800,18010,14931,-3079
2020,6,17,2,17345,17648,14757,-2891
2020,6,17,3,16167,16617,14177,-2440
2020,6,17,4,14886,15395,12927,-2468
2020,6,17,5,13851,14426,11370,-3056
2020,6,17,6,13277,13698,10929,-2769
2020,6,17,7,12858,13226,11030,-2196
2020,6,17,8,12606,12980,11187,-1793
2020,6,17,9,12613,12971,11059,-1912
2020,6,17,10,12903,13220,11266,-1954
2020,6,17,11,13752,14154,12031,-2123
2020,6,17,12,14870,15269,13096,-2173
2020,6,17,13,15828,16108,13977,-2131
2020,6,17,14,16421,16687,14481,-2206
2020,6,17,15,17003,17156,14434,-2722
2020,6,17,16,17624,17618,14796,-2822
2020,6,17,17,18254,18089,15222,-2867
2020,6,17,18,18828,18658,15543,-3115
2020,6,17,19,19180,19162,15582,-3580
2020,6,17,20,19549,19775,16217,-3558
2020,6,17,21,19960,20116,16862,-3254
2020,6,17,22,20230,20353,17359,-2994
2020,6,17,23,19999,20173,17311,-2862
2020,6,18,0,19395,19689,16499,-3190
2020,6,18,1,18768,19147,15873,-3274
2020,6,18,2,18350,18675,15529,-3146
2020,6,18,3,17145,17558,14747,-2811
2020,6,18,4,15822,16352,13615,-2737
2020,6,18,5,14621,15326,12012,-3314
2020,6,18,6,13930,14608,11635,-2973
2020,6,18,7,13449,14120,11348,-2772
2020,6,18,8,13163,13822,11131,-2691
2020,6,18,9,13156,13793,11192,-2601
2020,6,18,10,13485,14114,11705,-2409
2020,6,18,11,14418,15009,12282,-2727
2020,6,18,12,15653,16206,13604,-2602
2020,6,18,13,16818,17244,14620,-2624
2020,6,18,14,17540,17898,15106,-2792
2020,6,18,15,18235,18738,16040,-2698
2020,6,18,16,18978,19479,17086,-2393
2020,6,18,17,19711,20156,17416,-2740
2020,6,18,18,20347,20786,17613,-3173
2020,6,18,19,20768,21250,18076,-3174
2020,6,18,20,21144,21545,18451,-3094
2020,6,18,21,21540,21895,18789,-3106
2020,6,18,22,21807,22041,18849,-3192
2020,6,18,23,21628,21687,18400,-3287
2020,6,19,0,20913,21073,17581,-3492
2020,6,19,1,20275,20523,17213,-3310
2020,6,19,2,19832,20067,17262,-2805
2020,6,19,3,18586,18914,16641,-2273
2020,6,19,4,17102,17506,15355,-2151
2020,6,19,5,15868,16410,13762,-2648
2020,6,19,6,15074,15542,13119,-2423
2020,6,19,7,14519,14985,12700,-2285
2020,6,19,8,14170,14677,12563,-2114
2020,6,19,9,14118,14615,12516,-2099
2020,6,19,10,14397,14844,12691,-2153
2020,6,19,11,15272,15669,13590,-2079
2020,6,19,12,16513,16945,14899,-2046
2020,6,19,13,17748,18212,15902,-2310
2020,6,19,14,18475,19252,16488,-2764
2020,6,19,15,19149,20150,17281,-2869
2020,6,19,16,19851,20896,18172,-2724
2020,6,19,17,20531,21488,18787,-2701
2020,6,19,18,21141,21939,19519,-2420
2020,6,19,19,21583,22335,19012,-3323
2020,6,19,20,21991,22701,19114,-3587
2020,6,19,21,22357,22974,19391,-3583
2020,6,19,22,22510,22917,19219,-3698
2020,6,19,23,22150,22423,18706,-3717
2020,6,20,0,21313,21629,17976,-3653
2020,6,20,1,20468,20911,17522,-3389
2020,6,20,2,20032,20436,17278,-3158
2020,6,20,3,19017,19374,16460,-2914
2020,6,20,4,17743,18153,15692,-2461
2020,6,20,5,16397,16954,14299,-2655
2020,6,20,6,15568,16017,13650,-2367
2020,6,20,7,14892,15357,12771,-2586
2020,6,20,8,14423,14927,12332,-2595
2020,6,20,9,14184,14693,12263,-2430
2020,6,20,10,14009,14545,12171,-2374
2020,6,20,11,14204,14896,12973,-1923
2020,6,20,12,14992,15779,13936,-1843
2020,6,20,13,16226,16928,14696,-2232
2020,6,20,14,17303,18057,15581,-2476
2020,6,20,15,18293,19233,16149,-3084
2020,6,20,16,19188,20264,16771,-3493
2020,6,20,17,19998,21040,17634,-3406
2020,6,20,18,20592,21541,18145,-3396
2020,6,20,19,21032,21937,18658,-3279
2020,6,20,20,21372,22265,19128,-3137
2020,6,20,21,21802,22595,19791,-2804
2020,6,20,22,22041,22825,19877,-2948
2020,6,20,23,21810,22502,19271,-3231
2020,6,21,0,21230,21807,18495,-3312
2020,6,21,1,20580,21207,17903,-3304
2020,6,21,2,20245,20807,17749,-3058
2020,6,21,3,19298,19848,16968,-2880
2020,6,21,4,18105,18658,15903,-2755
2020,6,21,5,16909,17424,14545,-2879
2020,6,21,6,16117,16430,13475,-2955
2020,6,21,7,15436,15717,12505,-3212
2020,6,21,8,14929,15246,12108,-3138
2020,6,21,9,14617,14943,11568,-3375
2020,6,21,10,14291,14715,11840,-2875
2020,6,21,11,14312,14954,12003,-2951
2020,6,21,12,14811,15807,13001,-2806
2020,6,21,13,15846,17008,14119,-2889
2020,6,21,14,16923,18290,15412,-2878
2020,6,21,15,18008,19460,16474,-2986
2020,6,21,16,19002,20514,17200,-3314
2020,6,21,17,19899,21297,18192,-3105
2020,6,21,18,20550,21897,18110,-3787
2020,6,21,19,21008,22307,18393,-3914
2020,6,21,20,21358,22716,19080,-3636
2020,6,21,21,21883,23261,19839,-3422
2020,6,21,22,22295,23669,20223,-3446
2020,6,21,23,22215,23621,19900,-3721
2020,6,22,0,21665,23110,19607,-3503
2020,6,22,1,21050,22492,18791,-3701
2020,6,22,2,20834,22133,18519,-3614
2020,6,22,3,19873,20952,17166,-3786
2020,6,22,4,18603,19565,16208,-3357
2020,6,22,5,17891,18297,14926,-3371
2020,6,22,6,16944,17364,14376,-2988
2020,6,22,7,16299,16682,13640,-3042
2020,6,22,8,15901,16199,13139,-3060
2020,6,22,9,15805,16068,13110,-2958
2020,6,22,10,15956,16343,13585,-2758
2020,6,22,11,16714,17400,14714,-2686
2020,6,22,12,18086,19092,16065,-3027
2020,6,22,13,19734,20671,17222,-3449
2020,6,22,14,20989,22054,17936,-4118
2020,6,22,15,22112,23439,18780,-4659
2020,6,22,16,23134,24608,19630,-4978
2020,6,22,17,23998,25590,20505,-5085
2020,6,22,18,24700,26220,21057,-5163
2020,6,22,19,25219,26591,22223,-4368
2020,6,22,20,25548,26828,23070,-3758
2020,6,22,21,25872,26980,23409,-3571
2020,6,22,22,26012,26827,23399,-3428
2020,6,22,23,25538,26281,22746,-3535
2020,6,23,0,24741,25265,21170,-4095
2020,6,23,1,23796,24328,19974,-4354
2020,6,23,2,23255,23580,19051,-4529
2020,6,23,3,22000,22143,18048,-4095
2020,6,23,4,20519,20512,17023,-3489
2020,6,23,5,19157,19094,15123,-3971
2020,6,23,6,18055,18073,14393,-3680
2020,6,23,7,17296,17308,13638,-3670
2020,6,23,8,16811,16873,13508,-3365
2020,6,23,9,16645,16737,13745,-2992
2020,6,23,10,16737,17008,13686,-3322
2020,6,23,11,17459,18096,14640,-3456
2020,6,23,12,18799,19726,16743,-2983
2020,6,23,13,20325,21190,17582,-3608
2020,6,23,14,21512,22405,18110,-4295
2020,6,23,15,22561,23492,19017,-4475
2020,6,23,16,23511,24441,19618,-4823
2020,6,23,17,24255,25107,20820,-4287
2020,6,23,18,24830,25612,21353,-4259
2020,6,23,19,25225,25869,21855,-4014
2020,6,23,20,25452,26039,22365,-3674
2020,6,23,21,25776,26171,21984,-4187
2020,6,23,22,25938,26167,22507,-3660
2020,6,23,23,25460,25532,21717,-3815
2020,6,24,0,24663,24586,21262,-3324
2020,6,24,1,23747,23672,20564,-3108
2020,6,24,2,23266,23013,20009,-3004
2020,6,24,3,22050,21695,18189,-3506
2020,6,24,4,20582,20214,16596,-3618
2020,6,24,5,18925,18961,14461,-4500
2020,6,24,6,17913,17933,13760,-4173
2020,6,24,7,17186,17315,13244,-4071
2020,6,24,8,16707,16943,13080,-3863
2020,6,24,9,16535,16841,13108,-3733
2020,6,24,10,16655,17098,13277,-3821
2020,6,24,11,17394,18030,14516,-3514
2020,6,24,12,18651,19286,15890,-3396
2020,6,24,13,19997,20400,16848,-3552
2020,6,24,14,20909,21112,17621,-3491
2020,6,24,15,21711,21696,18179,-3517
2020,6,24,16,22415,22197,18812,-3385
2020,6,24,17,22979,22578,19388,-3190
2020,6,24,18,23420,22902,20046,-2856
2020,6,24,19,23729,23160,20436,-2724
2020,6,24,20,23891,23440,20448,-2992
2020,6,24,21,24119,23646,21158,-2488
2020,6,24,22,24241,23774,21381,-2393
2020,6,24,23,23819,23307,20869,-2438
2020,6,25,0,23012,22454,18978,-3476
2020,6,25,1,22112,21512,18504,-3008
2020,6,25,2,21636,21038,18045,-2993
2020,6,25,3,20467,19850,16771,-3079
2020,6,25,4,19097,18390,14866,-3524
2020,6,25,5,17503,17174,14216,-2958
2020,6,25,6,16616,16277,13442,-2835
2020,6,25,7,15940,15657,13032,-2625
2020,6,25,8,15503,15283,12671,-2612
2020,6,25,9,15345,15185,12677,-2508
2020,6,25,10,15463,15399,12915,-2484
2020,6,25,11,16125,16253,13840,-2413
2020,6,25,12,17294,17507,15655,-1852
2020,6,25,13,18455,18530,16763,-1767
2020,6,25,14,19304,19295,16946,-2349
2020,6,25,15,20051,19988,17532,-2456
2020,6,25,16,20719,20714,18324,-2390
2020,6,25,17,21305,21393,18912,-2481
2020,6,25,18,21795,22085,18981,-3104
2020,6,25,19,22177,22630,19107,-3523
2020,6,25,20,22514,22730,19518,-3212
2020,6,25,21,22842,22730,19785,-2945
2020,6,25,22,22989,22738,20110,-2628
2020,6,25,23,22521,22329,19535,-2794
2020,6,26,0,21885,21579,19048,-2531
2020,6,26,1,21189,20856,18492,-2364
2020,6,26,2,20797,20570,18189,-2381
2020,6,26,3,19781,19517,17340,-2177
2020,6,26,4,18577,18248,15847,-2401
2020,6,26,5,17236,17156,14425,-2731
2020,6,26,6,16364,16312,13756,-2556
2020,6,26,7,15733,15699,13566,-2133
2020,6,26,8,15320,15301,13205,-2096
2020,6,26,9,15175,15215,13211,-2004
2020,6,26,10,15302,15466,13334,-2132
2020,6,26,11,16000,16364,14060,-2304
2020,6,26,12,17261,17731,15411,-2320
2020,6,26,13,18466,18798,16374,-2424
2020,6,26,14,19432,19655,16857,-2798
2020,6,26,15,20301,20430,17326,-3104
2020,6,26,16,21057,21174,18303,-2871
2020,6,26,17,21637,21761,18957,-2804
2020,6,26,18,22085,22287,19602,-2685
2020,6,26,19,22436,22709,19905,-2804
2020,6,26,20,22753,23083,20198,-2885
2020,6,26,21,23099,23380,20292,-3088
2020,6,26,22,23190,23431,20014,-3417
2020,6,26,23,22643,22886,19619,-3267
2020,6,27,0,21908,22197,18778,-3419
2020,6,27,1,21104,21340,18078,-3262
2020,6,27,2,20682,20830,17939,-2891
2020,6,27,3,19720,19636,17028,-2608
2020,6,27,4,18542,18355,16004,-2351
2020,6,27,5,16949,17206,14437,-2769
2020,6,27,6,16041,16302,14159,-2143
2020,6,27,7,15384,15617,13875,-1742
2020,6,27,8,14945,15198,13620,-1578
2020,6,27,9,14689,14958,13348,-1610
2020,6,27,10,14558,14826,13304,-1522
2020,6,27,11,14867,15093,13641,-1452
2020,6,27,12,15760,15822,14633,-1189
2020,6,27,13,16834,16850,14839,-2011
2020,6,27,14,17943,17793,15688,-2105
2020,6,27,15,18976,18600,16484,-2116
2020,6,27,16,19821,19148,17202,-1946
2020,6,27,17,20415,19493,17585,-1908
2020,6,27,18,20766,19674,17790,-1884
2020,6,27,19,20999,19850,17931,-1919
2020,6,27,20,21201,19967,17753,-2214
2020,6,27,21,21502,20206,18255,-1951
2020,6,27,22,21688,20562,18757,-1805
2020,6,27,23,21530,20667,18582,-2085
2020,6,28,0,21177,20321,18346,-1975
2020,6,28,1,20729,20027,17782,-2245
2020,6,28,2,20560,19883,17791,-2092
2020,6,28,3,19852,19140,16950,-2190
2020,6,28,4,18882,18174,15830,-2344
2020,6,28,5,17395,17149,14454,-2695
2020,6,28,6,16533,16315,13959,-2356
2020,6,28,7,15895,15720,13724,-1996
2020,6,28,8,15452,15348,13297,-2051
2020,6,28,9,15156,15127,13188,-1939
2020,6,28,10,14921,14969,12935,-2034
2020,6,28,11,15047,15113,13132,-1981
2020,6,28,12,15741,15900,13913,-1987
2020,6,28,13,16848,17006,14718,-2288
2020,6,28,14,17996,18335,15653,-2682
2020,6,28,15,19172,19671,16163,-3508
2020,6,28,16,20217,20738,17236,-3502
2020,6,28,17,20987,21453,17773,-3680
2020,6,28,18,21458,21892,18300,-3592
2020,6,28,19,21816,22304,18932,-3372
2020,6,28,20,22141,22722,19311,-3411
2020,6,28,21,22594,22814,19288,-3526
2020,6,28,22,22903,22660,19514,-3146
2020,6,28,23,22709,22359,18961,-3398
2020,6,29,0,22312,21713,18402,-3311
2020,6,29,1,21746,21216,18279,-2937
2020,6,29,2,21475,20951,18212,-2739
2020,6,29,3,20447,19937,17417,-2520
2020,6,29,4,19148,18764,16444,-2320
2020,6,29,5,17574,17569,14520,-3049
2020,6,29,6,16692,16634,14213,-2421
2020,6,29,7,16046,16042,13751,-2291
2020,6,29,8,15649,15689,13677,-2012
2020,6,29,9,15552,15617,13574,-2043
2020,6,29,10,15825,15879,13774,-2105
2020,6,29,11,16721,16861,14597,-2264
2020,6,29,12,18146,18356,15677,-2679
2020,6,29,13,19573,19616,16726,-2890
2020,6,29,14,20570,20713,17027,-3686
2020,6,29,15,21520,21660,17896,-3764
2020,6,29,16,22377,22329,18142,-4187
2020,6,29,17,23136,22890,19064,-3826
2020,6,29,18,23788,23572,19894,-3678
2020,6,29,19,24284,24158,20455,-3703
2020,6,29,20,24669,24479,20777,-3702
2020,6,29,21,24944,24878,21144,-3734
2020,6,29,22,24995,24991,21242,-3749
2020,6,29,23,24479,24129,20208,-3921
2020,6,30,0,23728,22891,19049,-3842
2020,6,30,1,22886,22042,18368,-3674
2020,6,30,2,22248,21445,18167,-3278
2020,6,30,3,20869,20211,17229,-2982
2020,6,30,4,19324,18764,16229,-2535
2020,6,30,5,17431,17556,14811,-2745
2020,6,30,6,16499,16563,14426,-2137
2020,6,30,7,15815,15908,14102,-1806
2020,6,30,8,15394,15512,13940,-1572
2020,6,30,9,15285,15410,13958,-1452
2020,6,30,10,15552,15702,14211,-1491
2020,6,30,11,16455,16649,14955,-1694
2020,6,30,12,17796,17918,16526,-1392
2020,6,30,13,18988,19069,17166,-1903
2020,6,30,14,19812,19878,17118,-2760
2020,6,30,15,20572,20489,17158,-3331
2020,6,30,16,21260,20953,17189,-3764
2020,6,30,17,21848,21233,17430,-3803
2020,6,30,18,22382,21352,17631,-3721
2020,6,30,19,22778,21540,18173,-3367
2020,6,30,20,23063,21676,18690,-2986
2020,6,30,21,23309,21969,19238,-2731
2020,6,30,22,23368,22128,19522,-2606
2020,6,30,23,22945,21829,19064,-2765
2020,7,1,0,22194,21172,18379,-2793
2020,7,1,1,21486,20536,17761,-2775
2020,7,1,2,21010,20172,17757,-2415
2020,7,1,3,19796,19144,17104,-2040
2020,7,1,4,18356,17873,15545,-2328
2020,7,1,5,16645,16759,14191,-2568
2020,7,1,6,15810,15924,13423,-2501
2020,7,1,7,15225,15352,12842,-2510
2020,7,1,8,14877,15032,12425,-2607
2020,7,1,9,14822,15000,12157,-2843
2020,7,1,10,15127,15315,12641,-2674
2020,7,1,11,16074,16283,13521,-2762
2020,7,1,12,17440,17562,14657,-2905
2020,7,1,13,18627,18685,15020,-3665
2020,7,1,14,19453,19552,15676,-3876
2020,7,1,15,20213,20299,16319,-3980
2020,7,1,16,20915,21000,16928,-4072
2020,7,1,17,21524,21433,17212,-4221
2020,7,1,18,22121,21701,17468,-4233
2020,7,1,19,22592,22049,17995,-4054
2020,7,1,20,22971,22600,18637,-3963
2020,7,1,21,23264,23155,19349,-3806
2020,7,1,22,23370,23407,19665,-3742
2020,7,1,23,22973,22821,18900,-3921
2020,7,2,0,22163,22138,18268,-3870
2020,7,2,1,21470,21506,17683,-3823
2020,7,2,2,21032,21080,17541,-3539
2020,7,2,3,19852,19855,16671,-3184
2020,7,2,4,18429,18327,15556,-2771
2020,7,2,5,16974,17013,14122,-2891
2020,7,2,6,16078,16096,13323,-2773
2020,7,2,7,15457,15403,12734,-2669
2020,7,2,8,15092,15051,12414,-2637
2020,7,2,9,15013,14987,12409,-2578
2020,7,2,10,15301,15291,12799,-2492
2020,7,2,11,16237,16286,13553,-2733
2020,7,2,12,17672,17721,14780,-2941
2020,7,2,13,19134,19036,15840,-3196
2020,7,2,14,20173,20152,16302,-3850
2020,7,2,15,21199,21340,17062,-4278
2020,7,2,16,22155,22449,18077,-4372
2020,7,2,17,23024,23467,19089,-4378
2020,7,2,18,23854,24456,20096,-4360
2020,7,2,19,24553,25306,20850,-4456
2020,7,2,20,25170,25939,21394,-4545
2020,7,2,21,25660,26429,21867,-4562
2020,7,2,22,25859,26456,22319,-4137
2020,7,2,23,25423,25872,22278,-3594
2020,7,3,0,24567,25060,21490,-3570
2020,7,3,1,23768,24186,20165,-4021
2020,7,3,2,23229,23616,19366,-4250
2020,7,3,3,21915,22190,18158,-4032
2020,7,3,4,20354,20748,16991,-3757
2020,7,3,5,18552,19396,15439,-3957
2020,7,3,6,17462,18358,14391,-3967
2020,7,3,7,16705,17617,13663,-3954
2020,7,3,8,16203,17105,13380,-3725
2020,7,3,9,15964,16857,13102,-3755
2020,7,3,10,15941,16822,13141,-3681
2020,7,3,11,16489,17273,13697,-3576
2020,7,3,12,17689,18302,14893,-3409
2020,7,3,13,19239,19431,16073,-3358
2020,7,3,14,20625,20390,16745,-3645
2020,7,3,15,21955,21550,17750,-3800
2020,7,3,16,23062,22556,18521,-4035
2020,7,3,17,23914,23492,19612,-3880
2020,7,3,18,24488,24119,19859,-4260
2020,7,3,19,24852,24641,20487,-4154
2020,7,3,20,24942,25057,20789,-4268
2020,7,3,21,24902,25232,21155,-4077
2020,7,3,22,24549,25004,20865,-4139
2020,7,3,23,23712,24357,20096,-4261
2020,7,4,0,22718,23514,19478,-4036
2020,7,4,1,21720,22668,18662,-4006
2020,7,4,2,21122,22027,17795,-4232
2020,7,4,3,20314,20945,16892,-4053
2020,7,4,4,19312,19657,15904,-3753
2020,7,4,5,18251,18338,14146,-4192
2020,7,4,6,17254,17288,13396,-3892
2020,7,4,7,16462,16516,12322,-4194
2020,7,4,8,15925,15994,11625,-4369
2020,7,4,9,15576,15665,11734,-3931
2020,7,4,10,15332,15482,11892,-3590
2020,7,4,11,15272,15580,12289,-3291
2020,7,4,12,15967,16183,12987,-3196
2020,7,4,13,17047,17091,13794,-3297
2020,7,4,14,18127,17963,14892,-3071
2020,7,4,15,19201,18932,15789,-3143
2020,7,4,16,20072,19942,16503,-3439
2020,7,4,17,20786,20763,16999,-3764
2020,7,4,18,21294,21425,17475,-3950
2020,7,4,19,21729,21850,17430,-4420
2020,7,4,20,22134,22179,18253,-3926
2020,7,4,21,22418,22544,18569,-3975
2020,7,4,22,22427,22774,19247,-3527
2020,7,4,23,22156,22591,18877,-3714
2020,7,5,0,21363,21907,18126,-3781
2020,7,5,1,20655,21031,17433,-3598
2020,7,5,2,20276,20380,17257,-3123
2020,7,5,3,19412,19611,16873,-2738
2020,7,5,4,18372,18555,15849,-2706
2020,7,5,5,17358,17470,14206,-3264
2020,7,5,6,16440,16577,13499,-3078
2020,7,5,7,15749,15957,12686,-3271
2020,7,5,8,15289,15532,12414,-3118
2020,7,5,9,15002,15273,12037,-3236
2020,7,5,10,14752,15091,11991,-3100
2020,7,5,11,14702,15161,12470,-2691
2020,7,5,12,15406,15768,13415,-2353
2020,7,5,13,16619,16727,14461,-2266
2020,7,5,14,17899,17969,15858,-2111
2020,7,5,15,19225,19279,16454,-2825
2020,7,5,16,20384,20534,17092,-3442
2020,7,5,17,21396,21632,17498,-4134
2020,7,5,18,22206,22484,18148,-4336
2020,7,5,19,22885,23189,18487,-4702
2020,7,5,20,23533,23825,19651,-4174
2020,7,5,21,24037,24442,20254,-4188
2020,7,5,22,24280,24937,21106,-3831
2020,7,5,23,24187,24949,20896,-4053
2020,7,6,0,23544,24414,20550,-3864
2020,7,6,1,22974,23808,19966,-3842
2020,7,6,2,22627,23365,19230,-4135
2020,7,6,3,21486,22056,18283,-3773
2020,7,6,4,20072,20594,17118,-3476
2020,7,6,5,18739,19257,15291,-3966
2020,7,6,6,17744,18196,14389,-3807
2020,7,6,7,17042,17458,13512,-3946
2020,7,6,8,16619,17010,13081,-3929
2020,7,6,9,16518,16847,13272,-3575
2020,7,6,10,16779,17048,13633,-3415
2020,7,6,11,17691,17966,14437,-3529
2020,7,6,12,19203,19519,16381,-3138
2020,7,6,13,20782,21050,17160,-3890
2020,7,6,14,22102,22434,17743,-4691
2020,7,6,15,23371,23689,18546,-5143
2020,7,6,16,24447,24883,19636,-5247
2020,7,6,17,25295,25872,20890,-4982
2020,7,6,18,25949,26673,21898,-4775
2020,7,6,19,26566,27283,22942,-4341
2020,7,6,20,27093,27448,23073,-4375
2020,7,6,21,27517,26895,22901,-3994
2020,7,6,22,27502,26268,22945,-3323
2020,7,6,23,26772,25491,21973,-3518
2020,7,7,0,25823,24634,20941,-3693
2020,7,7,1,24918,23741,19835,-3906
2020,7,7,2,24213,23103,19125,-3978
2020,7,7,3,22751,21701,18056,-3645
2020,7,7,4,21066,20146,16829,-3317
2020,7,7,5,19206,18710,15463,-3247
2020,7,7,6,18126,17695,14432,-3263
2020,7,7,7,17369,17041,14047,-2994
2020,7,7,8,16920,16651,13664,-2987
2020,7,7,9,16801,16529,13225,-3304
2020,7,7,10,17079,16847,13453,-3394
2020,7,7,11,17978,17828,14303,-3525
2020,7,7,12,19429,19317,15642,-3675
2020,7,7,13,20800,20709,17005,-3704
2020,7,7,14,21963,21626,17092,-4534
2020,7,7,15,23019,22346,17696,-4650
2020,7,7,16,23946,23135,19300,-3835
2020,7,7,17,24630,23778,20191,-3587
2020,7,7,18,25158,24432,21070,-3362
2020,7,7,19,25645,24971,21629,-3342
2020,7,7,20,26028,25305,22015,-3290
2020,7,7,21,26515,25509,22409,-3100
2020,7,7,22,26630,25532,22274,-3258
2020,7,7,23,26006,25149,21805,-3344
2020,7,8,0,25099,24502,20928,-3574
2020,7,8,1,24322,23939,19706,-4233
2020,7,8,2,23734,23486,19115,-4371
2020,7,8,3,22379,22229,18185,-4044
2020,7,8,4,20760,20797,17322,-3475
2020,7,8,5,19118,19527,15607,-3920
2020,7,8,6,18177,18676,15057,-3619
2020,7,8,7,17491,18105,14478,-3627
2020,7,8,8,17077,17781,14271,-3510
2020,7,8,9,16988,17704,14051,-3653
2020,7,8,10,17299,18021,14536,-3485
2020,7,8,11,18265,18976,15539,-3437
2020,7,8,12,19778,20502,17000,-3502
2020,7,8,13,21315,22003,17937,-4066
2020,7,8,14,22533,23097,18827,-4270
2020,7,8,15,23631,24222,19931,-4291
2020,7,8,16,24605,25372,20895,-4477
2020,7,8,17,25293,26214,21942,-4272
2020,7,8,18,25799,26757,23367,-3390
2020,7,8,19,26295,26849,23773,-3076
2020,7,8,20,26593,26725,24085,-2640
2020,7,8,21,26736,26363,24005,-2358
2020,7,8,22,26667,26030,23524,-2506
2020,7,8,23,26121,25735,22841,-2894
2020,7,9,0,25475,25130,22027,-3103
2020,7,9,1,24674,24464,20760,-3704
2020,7,9,2,24114,23978,20402,-3576
2020,7,9,3,22754,22699,19251,-3448
2020,7,9,4,21132,21181,18199,-2982
2020,7,9,5,19772,19837,16302,-3535
2020,7,9,6,18708,18848,15614,-3234
2020,7,9,7,17943,18126,15106,-3020
2020,7,9,8,17491,17675,14632,-3043
2020,7,9,9,17338,17557,14230,-3327
2020,7,9,10,17578,17870,14413,-3457
2020,7,9,11,18516,18940,15310,-3630
2020,7,9,12,20152,20551,17071,-3480
2020,7,9,13,21956,22104,17952,-4152
2020,7,9,14,23287,23369,19095,-4274
2020,7,9,15,24506,24610,20334,-4276
2020,7,9,16,25646,25795,21354,-4441
2020,7,9,17,26520,26760,22948,-3812
2020,7,9,18,27242,27548,23885,-3663
2020,7,9,19,27810,28058,24659,-3399
2020,7,9,20,28169,28382,24984,-3398
2020,7,9,21,28262,28628,25306,-3322
2020,7,9,22,28128,28808,25548,-3260
2020,7,9,23,27433,28400,25536,-2864
2020,7,10,0,26752,27424,24450,-2974
2020,7,10,1,25976,26497,23757,-2740
2020,7,10,2,25323,25704,22763,-2941
2020,7,10,3,23845,24164,20758,-3406
2020,7,10,4,22169,22587,18970,-3617
2020,7,10,5,20363,21109,17365,-3744
2020,7,10,6,19262,19966,16137,-3829
2020,7,10,7,18507,19207,15437,-3770
2020,7,10,8,18033,18710,14832,-3878
2020,7,10,9,17860,18567,14784,-3783
2020,7,10,10,18066,18848,15406,-3442
2020,7,10,11,18937,19767,16747,-3020
2020,7,10,12,20444,21152,17648,-3504
2020,7,10,13,22052,22447,18668,-3779
2020,7,10,14,23231,23493,19530,-3963
2020,7,10,15,24271,24282,20557,-3725
2020,7,10,16,25225,24774,21110,-3664
2020,7,10,17,25892,25160,22223,-2937
2020,7,10,18,26413,25306,22339,-2967
2020,7,10,19,26559,25220,22394,-2826
2020,7,10,20,26384,25010,22290,-2720
2020,7,10,21,25998,24896,22097,-2799
2020,7,10,22,25640,24858,21942,-2916
2020,7,10,23,25013,24407,21689,-2718
2020,7,11,0,24454,23760,21222,-2538
2020,7,11,1,23710,23164,20472,-2692
2020,7,11,2,23195,22502,20038,-2464
2020,7,11,3,22117,21645,19397,-2248
2020,7,11,4,20834,20374,17492,-2882
2020,7,11,5,19653,19299,16188,-3111
2020,7,11,6,18672,18430,15499,-2931
2020,7,11,7,17935,17814,14714,-3100
2020,7,11,8,17427,17406,14081,-3325
2020,7,11,9,17067,17152,13951,-3201
2020,7,11,10,16822,17094,13738,-3356
2020,7,11,11,16832,17314,14291,-3023
2020,7,11,12,17791,18237,15481,-2756
2020,7,11,13,19309,19527,16745,-2782
2020,7,11,14,20678,20761,17464,-3297
2020,7,11,15,21911,21841,17896,-3945
2020,7,11,16,23024,22843,18640,-4203
2020,7,11,17,23810,23681,19420,-4261
2020,7,11,18,24231,24093,19449,-4644
2020,7,11,19,24460,24096,19408,-4688
2020,7,11,20,24495,24285,20248,-4037
2020,7,11,21,24379,24330,20319,-4011
2020,7,11,22,24271,24353,20551,-3802
2020,7,11,23,24006,24075,20111,-3964
2020,7,12,0,23492,23091,19622,-3469
2020,7,12,1,22886,22544,19143,-3401
2020,7,12,2,22599,22154,18609,-3545
2020,7,12,3,21712,21164,18234,-2930
2020,7,12,4,20595,19979,17293,-2686
2020,7,12,5,18834,18865,15874,-2991
2020,7,12,6,17908,17859,14934,-2925
2020,7,12,7,17180,17111,14018,-3093
2020,7,12,8,16620,16620,13518,-3102
2020,7,12,9,16186,16286,13308,-2978
2020,7,12,10,15749,16050,13228,-2822
2020,7,12,11,15539,16143,13466,-2677
2020,7,12,12,16168,16795,13816,-2979
2020,7,12,13,17454,17869,14922,-2947
2020,7,12,14,18604,18997,15829,-3168
2020,7,12,15,19727,20091,17061,-3030
2020,7,12,16,20783,21122,17809,-3313
2020,7,12,17,21659,21969,18531,-3438
2020,7,12,18,22282,22622,18812,-3810
2020,7,12,19,22759,23113,19042,-4071
2020,7,12,20,23116,23594,19754,-3840
2020,7,12,21,23404,24106,20280,-3826
2020,7,12,22,23710,24565,21320,-3245
2020,7,12,23,23661,24524,20989,-3535
2020,7,13,0,23226,23849,20350,-3499
2020,7,13,1,22829,23343,19701,-3642
2020,7,13,2,22594,23008,19089,-3919
2020,7,13,3,21577,21796,18380,-3416
2020,7,13,4,20327,20348,17165,-3183
2020,7,13,5,18654,19019,15763,-3256
2020,7,13,6,17712,18044,14696,-3348
2020,7,13,7,17088,17325,13580,-3745
2020,7,13,8,16710,16922,13242,-3680
2020,7,13,9,16638,16859,13304,-3555
2020,7,13,10,16969,17164,14152,-3012
2020,7,13,11,17862,18033,14976,-3057
2020,7,13,12,19280,19450,16485,-2965
2020,7,13,13,20739,20751,17582,-3169
2020,7,13,14,21762,21889,18466,-3423
2020,7,13,15,22662,22901,19207,-3694
2020,7,13,16,23425,23794,20178,-3616
2020,7,13,17,23996,24478,20565,-3913
2020,7,13,18,24415,24959,21386,-3573
2020,7,13,19,24586,25224,21988,-3236
2020,7,13,20,24543,25564,22623,-2941
2020,7,13,21,24386,25869,22945,-2924
2020,7,13,22,24281,26048,23677,-2371
2020,7,13,23,23924,25549,23288,-2261
2020,7,14,0,23305,24610,22144,-2466
2020,7,14,1,22730,23644,20779,-2865
2020,7,14,2,22214,23006,19844,-3162
2020,7,14,3,20916,21606,18227,-3379
2020,7,14,4,19441,20020,17174,-2846
2020,7,14,5,18298,18638,16125,-2513
2020,7,14,6,17277,17664,14911,-2753
2020,7,14,7,16585,16932,14013,-2919
2020,7,14,8,16143,16457,13674,-2783
2020,7,14,9,15989,16320,13578,-2742
2020,7,14,10,16209,16585,13877,-2708
2020,7,14,11,16966,17478,15040,-2438
2020,7,14,12,18220,18833,15809,-3024
2020,7,14,13,19459,20017,16712,-3305
2020,7,14,14,20339,20939,17405,-3534
2020,7,14,15,21173,21722,18056,-3666
2020,7,14,16,21992,22442,18858,-3584
2020,7,14,17,22705,23133,19392,-3741
2020,7,14,18,23358,23791,19845,-3946
2020,7,14,19,23819,24270,20571,-3699
2020,7,14,20,24119,24618,21208,-3410
2020,7,14,21,24319,25115,21555,-3560
2020,7,14,22,24431,25469,21942,-3527
2020,7,14,23,24054,25222,21395,-3827
2020,7,15,0,23345,24396,20637,-3759
2020,7,15,1,22730,23535,19795,-3740
2020,7,15,2,22241,22850,19071,-3779
2020,7,15,3,20963,21438,18324,-3114
2020,7,15,4,19476,19883,16904,-2979
2020,7,15,5,18059,18524,15082,-3442
2020,7,15,6,17068,17590,14118,-3472
2020,7,15,7,16381,16874,13592,-3282
2020,7,15,8,15953,16443,13314,-3129
2020,7,15,9,15825,16307,13209,-3098
2020,7,15,10,16084,16624,13545,-3079
2020,7,15,11,16883,17501,14530,-2971
2020,7,15,12,18213,18807,15854,-2953
2020,7,15,13,19401,19936,16828,-3108
2020,7,15,14,20308,20764,17537,-3227
2020,7,15,15,21195,21466,18092,-3374
2020,7,15,16,22062,22161,18790,-3371
2020,7,15,17,22764,22769,19193,-3576
2020,7,15,18,23401,23342,19986,-3356
2020,7,15,19,23839,23771,20750,-3021
2020,7,15,20,24175,24265,20833,-3432
2020,7,15,21,24414,24757,21789,-2968
2020,7,15,22,24514,24968,22043,-2925
2020,7,15,23,24127,24601,21111,-3490
2020,7,16,0,23253,23700,20128,-3572
2020,7,16,1,22543,22824,19506,-3318
2020,7,16,2,21990,22272,19274,-2998
2020,7,16,3,20668,20949,17644,-3305
2020,7,16,4,19159,19501,16150,-3351
2020,7,16,5,17657,18275,15143,-3132
2020,7,16,6,16720,17400,14459,-2941
2020,7,16,7,16072,16812,14061,-2751
2020,7,16,8,15686,16470,13814,-2656
2020,7,16,9,15612,16379,13850,-2529
2020,7,16,10,15964,16687,14126,-2561
2020,7,16,11,16844,17582,15322,-2260
2020,7,16,12,18153,18895,16057,-2838
2020,7,16,13,19304,19951,17086,-2865
2020,7,16,14,20194,20856,17572,-3284
2020,7,16,15,20977,21421,17992,-3429
2020,7,16,16,21661,21828,18384,-3444
2020,7,16,17,22236,22131,18665,-3466
2020,7,16,18,22707,22353,18617,-3736
2020,7,16,19,22968,22426,18957,-3469
2020,7,16,20,23167,22425,18958,-3467
2020,7,16,21,23279,22529,19030,-3499
2020,7,16,22,23258,22498,19305,-3193
2020,7,16,23,22876,21994,19091,-2903
2020,7,17,0,22066,21157,18558,-2599
2020,7,17,1,21455,20536,18133,-2403
2020,7,17,2,20924,20080,18084,-1996
2020,7,17,3,19741,19050,17388,-1662
2020,7,17,4,18358,17912,16127,-1785
2020,7,17,5,16966,16983,14997,-1986
2020,7,17,6,16192,16320,14231,-2089
2020,7,17,7,15637,15867,13651,-2216
2020,7,17,8,15304,15595,13387,-2208
2020,7,17,9,15282,15602,13623,-1979
2020,7,17,10,15704,16117,13628,-2489
2020,7,17,11,16583,17035,14872,-2163
2020,7,17,12,17918,18183,16145,-2038
2020,7,17,13,19173,19253,16838,-2415
2020,7,17,14,20158,20036,17201,-2835
2020,7,17,15,20978,20666,17430,-3236
2020,7,17,16,21719,21257,18077,-3180
2020,7,17,17,22344,21773,18515,-3258
2020,7,17,18,22901,22163,18904,-3259
2020,7,17,19,23291,22559,19277,-3282
2020,7,17,20,23647,23205,19863,-3342
2020,7,17,21,24010,24010,20420,-3590
2020,7,17,22,24193,24640,20543,-4097
2020,7,17,23,23909,24642,20513,-4129
2020,7,18,0,23168,24080,19874,-4206
2020,7,18,1,22513,23299,19218,-4081
2020,7,18,2,22083,22816,18873,-3943
2020,7,18,3,21016,21596,17982,-3614
2020,7,18,4,19707,20186,16726,-3460
2020,7,18,5,18074,18863,15532,-3331
2020,7,18,6,17144,17823,14324,-3499
2020,7,18,7,16431,17078,13591,-3487
2020,7,18,8,15947,16496,13124,-3372
2020,7,18,9,15650,16192,12919,-3273
2020,7,18,10,15565,16100,13020,-3080
2020,7,18,11,15704,16386,13523,-2863
2020,7,18,12,16645,17285,14288,-2997
2020,7,18,13,18064,18565,15354,-3211
2020,7,18,14,19396,19955,16524,-3431
2020,7,18,15,20645,21256,17682,-3574
2020,7,18,16,21849,22389,18595,-3794
2020,7,18,17,22906,23220,19616,-3604
2020,7,18,18,23598,23844,20133,-3711
2020,7,18,19,24061,24496,20804,-3692
2020,7,18,20,24625,25141,21665,-3476
2020,7,18,21,25111,25762,22539,-3223
2020,7,18,22,25354,26159,23090,-3069
2020,7,18,23,25179,26016,22542,-3474
2020,7,19,0,24386,25314,22001,-3313
2020,7,19,1,23794,24560,21395,-3165
2020,7,19,2,23320,23963,20500,-3463
2020,7,19,3,22208,22763,19633,-3130
2020,7,19,4,20890,21365,18415,-2950
2020,7,19,5,19165,20032,17071,-2961
2020,7,19,6,18122,18930,16169,-2761
2020,7,19,7,17368,18167,15237,-2930
2020,7,19,8,16859,17607,14519,-3088
2020,7,19,9,16514,17266,14452,-2814
2020,7,19,10,16318,17072,14218,-2854
2020,7,19,11,16345,17202,14720,-2482
2020,7,19,12,17206,18212,15693,-2519
2020,7,19,13,18717,19723,16688,-3035
2020,7,19,14,20342,21383,17797,-3586
2020,7,19,15,21964,23138,19050,-4088
2020,7,19,16,23556,24672,20256,-4416
2020,7,19,17,24959,25896,22202,-3694
2020,7,19,18,25884,26735,23502,-3233
2020,7,19,19,26431,27044,24149,-2895
2020,7,19,20,27028,27247,24409,-2838
2020,7,19,21,27546,27409,24685,-2724
2020,7,19,22,27845,27418,24547,-2871
2020,7,19,23,27746,27157,24413,-2744
2020,7,20,0,26880,26570,23563,-3007
2020,7,20,1,26344,26110,23049,-3061
2020,7,20,2,25781,25569,22465,-3104
2020,7,20,3,24342,24295,21388,-2907
2020,7,20,4,22648,22778,19888,-2890
2020,7,20,5,21144,21471,18350,-3121
2020,7,20,6,20222,20561,17403,-3158
2020,7,20,7,19514,19969,16848,-3121
2020,7,20,8,19066,19662,16369,-3293
2020,7,20,9,18957,19676,16256,-3420
2020,7,20,10,19324,20154,16649,-3505
2020,7,20,11,20260,21154,17394,-3760
2020,7,20,12,21872,22736,18760,-3976
2020,7,20,13,23598,24360,20025,-4335
2020,7,20,14,25029,25820,21796,-4024
2020,7,20,15,26335,26999,23434,-3565
2020,7,20,16,27463,28120,24528,-3592
2020,7,20,17,28361,28955,25599,-3356
2020,7,20,18,29005,29541,26454,-3087
2020,7,20,19,29426,29788,26842,-2946
2020,7,20,20,29744,29817,26954,-2863
2020,7,20,21,29933,29860,27531,-2329
2020,7,20,22,29864,29909,27621,-2288
2020,7,20,23,29304,29492,26801,-2691
2020,7,21,0,28293,28486,25811,-2675
2020,7,21,1,27265,27425,24844,-2581
2020,7,21,2,26314,26469,23729,-2740
2020,7,21,3,24575,24715,21683,-3032
2020,7,21,4,22675,22810,19727,-3083
2020,7,21,5,20759,21244,18093,-3151
2020,7,21,6,19697,20017,17018,-2999
2020,7,21,7,18866,19128,15886,-3242
2020,7,21,8,18309,18516,15321,-3195
2020,7,21,9,18102,18266,15071,-3195
2020,7,21,10,18343,18545,15374,-3171
2020,7,21,11,19115,19453,16436,-3017
2020,7,21,12,20495,20920,17897,-3023
2020,7,21,13,21844,22280,18982,-3298
2020,7,21,14,22992,23499,19718,-3781
2020,7,21,15,24047,24613,20435,-4178
2020,7,21,16,25014,25640,22064,-3576
2020,7,21,17,25814,26460,23028,-3432
2020,7,21,18,26476,27110,24035,-3075
2020,7,21,19,26962,27583,24841,-2742
2020,7,21,20,27400,28004,24988,-3016
2020,7,21,21,27887,28387,25266,-3121
2020,7,21,22,28105,28432,25313,-3119
2020,7,21,23,27615,27798,25211,-2587
2020,7,22,0,26589,26769,24427,-2342
2020,7,22,1,25638,25857,22979,-2878
2020,7,22,2,24833,25112,21810,-3302
2020,7,22,3,23240,23572,20211,-3361
2020,7,22,4,21493,21928,18848,-3080
2020,7,22,5,20254,20583,17321,-3262
2020,7,22,6,19308,19637,16444,-3193
2020,7,22,7,18640,18917,15631,-3286
2020,7,22,8,18222,18505,15280,-3225
2020,7,22,9,18119,18451,15033,-3418
2020,7,22,10,18489,18857,15750,-3107
2020,7,22,11,19288,19819,16526,-3293
2020,7,22,12,20642,21260,18170,-3090
2020,7,22,13,21874,22688,19303,-3385
2020,7,22,14,22971,23957,19972,-3985
2020,7,22,15,23959,25090,20792,-4298
2020,7,22,16,24878,26055,21818,-4237
2020,7,22,17,25673,26873,22628,-4245
2020,7,22,18,26369,27715,23612,-4103
2020,7,22,19,26889,28309,24031,-4278
2020,7,22,20,27386,28742,24510,-4232
2020,7,22,21,27914,29053,25063,-3990
2020,7,22,22,28176,28984,25181,-3803
2020,7,22,23,27853,28199,24881,-3318
2020,7,23,0,26919,26692,23413,-3279
2020,7,23,1,26105,25515,22666,-2849
2020,7,23,2,25399,24582,21604,-2978
2020,7,23,3,23909,23128,20075,-3053
2020,7,23,4,22245,21535,18605,-2930
2020,7,23,5,20634,20309,17142,-3167
2020,7,23,6,19634,19357,16051,-3306
2020,7,23,7,18929,18659,15531,-3128
2020,7,23,8,18490,18297,15169,-3128
2020,7,23,9,18370,18235,15000,-3235
2020,7,23,10,18796,18690,15517,-3173
2020,7,23,11,19726,19673,16117,-3556
2020,7,23,12,21233,21029,17124,-3905
2020,7,23,13,22765,22285,18377,-3908
2020,7,23,14,23974,23457,19389,-4068
2020,7,23,15,25025,24496,20396,-4100
2020,7,23,16,25948,25235,21148,-4087
2020,7,23,17,26711,25648,22161,-3487
2020,7,23,18,27295,26223,23261,-2962
2020,7,23,19,27650,26929,23687,-3242
2020,7,23,20,27965,27586,24340,-3246
2020,7,23,21,28233,28004,24817,-3187
2020,7,23,22,28254,28118,25288,-2830
2020,7,23,23,27765,27578,24484,-3094
2020,7,24,0,26808,26694,23353,-3341
2020,7,24,1,26035,25991,22448,-3543
2020,7,24,2,25266,25175,21661,-3514
2020,7,24,3,23731,23658,20490,-3168
2020,7,24,4,22028,22032,19186,-2846
2020,7,24,5,20080,20547,17287,-3260
2020,7,24,6,19047,19516,15932,-3584
2020,7,24,7,18292,18749,15072,-3677
2020,7,24,8,17791,18224,14601,-3623
2020,7,24,9,17644,18034,14257,-3777
2020,7,24,10,18009,18387,14495,-3892
2020,7,24,11,18837,19262,15493,-3769
2020,7,24,12,20227,20487,16517,-3970
2020,7,24,13,21664,21611,17494,-4117
2020,7,24,14,22744,22368,18051,-4317
2020,7,24,15,23670,22810,18991,-3819
2020,7,24,16,24460,23243,19354,-3889
2020,7,24,17,25061,23517,19781,-3736
2020,7,24,18,25618,23816,20019,-3797
2020,7,24,19,26020,24042,19982,-4060
2020,7,24,20,26364,24166,20274,-3892
2020,7,24,21,26716,24495,20955,-3540
2020,7,24,22,26790,24731,21353,-3378
2020,7,24,23,26284,24519,21269,-3250
2020,7,25,0,25144,23942,20683,-3259
2020,7,25,1,24218,23270,19949,-3321
2020,7,25,2,23502,22724,19473,-3251
2020,7,25,3,22186,21493,18602,-2891
2020,7,25,4,20691,20105,17218,-2887
2020,7,25,5,19327,18870,15644,-3226
2020,7,25,6,18237,17882,14940,-2942
2020,7,25,7,17473,17211,14327,-2884
2020,7,25,8,16918,16735,13712,-3023
2020,7,25,9,16604,16468,13531,-2937
2020,7,25,10,16537,16411,13553,-2858
2020,7,25,11,16663,16609,13884,-2725
2020,7,25,12,17658,17559,14760,-2799
2020,7,25,13,19080,18903,16029,-2874
2020,7,25,14,20418,20177,16879,-3298
2020,7,25,15,21681,21515,17774,-3741
2020,7,25,16,22734,22728,18916,-3812
2020,7,25,17,23548,23635,19797,-3838
2020,7,25,18,24119,24315,20490,-3825
2020,7,25,19,24503,24868,20551,-4317
2020,7,25,20,24862,25291,21368,-3923
2020,7,25,21,25228,25772,22293,-3479
2020,7,25,22,25415,26084,22660,-3424
2020,7,25,23,25157,25984,22599,-3385
2020,7,26,0,24460,25268,22105,-3163
2020,7,26,1,23780,24587,21370,-3217
2020,7,26,2,23165,24061,20727,-3334
2020,7,26,3,22035,22943,19240,-3703
2020,7,26,4,20709,21616,18443,-3173
2020,7,26,5,19442,20301,17515,-2786
2020,7,26,6,18464,19291,16794,-2497
2020,7,26,7,17754,18536,15980,-2556
2020,7,26,8,17223,17952,15088,-2864
2020,7,26,9,16891,17578,14783,-2795
2020,7,26,10,16717,17405,14734,-2671
2020,7,26,11,16746,17435,14908,-2527
2020,7,26,12,17529,18233,15761,-2472
2020,7,26,13,18876,19505,16979,-2526
2020,7,26,14,20308,21027,18240,-2787
2020,7,26,15,21725,22604,19392,-3212
2020,7,26,16,22974,23888,20540,-3348
2020,7,26,17,24000,24899,21586,-3313
2020,7,26,18,24769,25604,22588,-3016
2020,7,26,19,25280,26129,23387,-2742
2020,7,26,20,25748,26600,24364,-2236
2020,7,26,21,26262,27079,24984,-2095
2020,7,26,22,26641,27427,25077,-2350
2020,7,26,23,26530,27310,24975,-2335
2020,7,27,0,25984,26606,24326,-2280
2020,7,27,1,25477,25915,23192,-2723
2020,7,27,2,24859,25325,22562,-2763
2020,7,27,3,23518,23901,20980,-2921
2020,7,27,4,21971,22319,19651,-2668
2020,7,27,5,20517,20999,17744,-3255
2020,7,27,6,19585,19965,16277,-3688
2020,7,27,7,18904,19147,15826,-3321
2020,7,27,8,18497,18646,15463,-3183
2020,7,27,9,18411,18506,15347,-3159
2020,7,27,10,18801,18887,15700,-3187
2020,7,27,11,19723,19724,16458,-3266
2020,7,27,12,21244,21369,18192,-3177
2020,7,27,13,22929,23160,19711,-3449
2020,7,27,14,24358,24816,21118,-3698
2020,7,27,15,25627,26179,22479,-3700
2020,7,27,16,26732,27401,24457,-2944
2020,7,27,17,27661,28604,25872,-2732
2020,7,27,18,28496,29542,26940,-2602
2020,7,27,19,29191,30043,27322,-2721
2020,7,27,20,29743,30325,27964,-2361
2020,7,27,21,30215,30473,28262,-2211
2020,7,27,22,30403,30660,28836,-1824
2020,7,27,23,30020,30324,28438,-1886
2020,7,28,0,29143,29548,27311,-2237
2020,7,28,1,28340,28795,26032,-2763
2020,7,28,2,27449,27970,25175,-2795
2020,7,28,3,25744,26354,23303,-3051
2020,7,28,4,23920,24668,21585,-3083
2020,7,28,5,22182,23259,19818,-3441
2020,7,28,6,21111,22161,18547,-3614
2020,7,28,7,20328,21292,17371,-3921
2020,7,28,8,19818,20670,16702,-3968
2020,7,28,9,19639,20399,16327,-4072
2020,7,28,10,19975,20671,16635,-4036
2020,7,28,11,20796,21489,17617,-3872
2020,7,28,12,22148,22966,19228,-3738
2020,7,28,13,23476,24474,21246,-3228
2020,7,28,14,24689,25794,22625,-3169
2020,7,28,15,25751,26899,24082,-2817
2020,7,28,16,26637,27853,24821,-3032
2020,7,28,17,27363,28631,25892,-2739
2020,7,28,18,28026,29243,26783,-2460
2020,7,28,19,28586,29599,27507,-2092
2020,7,28,20,28917,29685,27428,-2257
2020,7,28,21,29252,29523,27430,-2093
2020,7,28,22,29310,29457,27550,-1907
2020,7,28,23,28756,28868,26891,-1977
2020,7,29,0,27704,27908,25758,-2150
2020,7,29,1,26824,26898,24113,-2785
2020,7,29,2,25920,25880,22977,-2903
2020,7,29,3,24264,24282,21660,-2622
2020,7,29,4,22460,22462,20081,-2381
2020,7,29,5,21067,20922,17852,-3070
2020,7,29,6,19989,19815,16816,-2999
2020,7,29,7,19206,19066,15848,-3218
2020,7,29,8,18698,18540,15441,-3099
2020,7,29,9,18525,18385,15140,-3245
2020,7,29,10,18845,18668,15333,-3335
2020,7,29,11,19592,19506,16457,-3049
2020,7,29,12,20890,20906,17891,-3015
2020,7,29,13,22080,22316,19589,-2727
2020,7,29,14,23171,23498,20367,-3131
2020,7,29,15,24113,24553,20610,-3943
2020,7,29,16,24933,25501,21430,-4071
2020,7,29,17,25681,26256,22791,-3465
2020,7,29,18,26422,26984,24156,-2828
2020,7,29,19,27059,27457,24961,-2496
2020,7,29,20,27519,27980,25157,-2823
2020,7,29,21,27941,28347,25535,-2812
2020,7,29,22,28094,28378,25606,-2772
2020,7,29,23,27621,27896,25955,-1941
2020,7,30,0,26609,26924,24725,-2199
2020,7,30,1,25784,26151,23103,-3048
2020,7,30,2,24995,25428,21718,-3710
2020,7,30,3,23462,23898,20526,-3372
2020,7,30,4,21822,22231,18811,-3420
2020,7,30,5,20291,20798,17100,-3698
2020,7,30,6,19260,19701,15588,-4113
2020,7,30,7,18507,18853,15120,-3733
2020,7,30,8,18030,18331,14748,-3583
2020,7,30,9,17883,18154,14820,-3334
2020,7,30,10,18255,18483,15303,-3180
2020,7,30,11,19057,19334,15969,-3365
2020,7,30,12,20388,20734,17527,-3207
2020,7,30,13,21756,22193,18857,-3336
2020,7,30,14,22894,23457,19690,-3767
2020,7,30,15,23853,24607,20552,-4055
2020,7,30,16,24665,25668,21698,-3970
2020,7,30,17,25463,26530,22862,-3668
2020,7,30,18,26218,27314,23782,-3532
2020,7,30,19,26830,27852,24481,-3371
2020,7,30,20,27244,28094,24638,-3456
2020,7,30,21,27552,28072,24705,-3367
2020,7,30,22,27631,27693,24643,-3050
2020,7,30,23,27076,27069,24179,-2890
2020,7,31,0,26182,26293,23089,-3204
2020,7,31,1,25419,25681,22290,-3391
2020,7,31,2,24573,24764,21453,-3311
2020,7,31,3,23095,23331,20243,-3088
2020,7,31,4,21499,21821,19145,-2676
2020,7,31,5,19700,20413,17290,-3123
2020,7,31,6,18613,19231,16230,-3001
2020,7,31,7,17837,18174,15309,-2865
2020,7,31,8,17313,17674,14616,-3058
2020,7,31,9,17134,17477,14285,-3192
2020,7,31,10,17491,17790,14767,-3023
2020,7,31,11,18263,18572,15673,-2899
2020,7,31,12,19492,19637,16610,-3027
2020,7,31,13,20692,20581,17141,-3440
2020,7,31,14,21603,21303,17807,-3496
2020,7,31,15,22255,21952,18277,-3675
2020,7,31,16,22809,22443,18769,-3674
2020,7,31,17,23299,22827,19001,-3826
2020,7,31,18,23824,23296,19048,-4248
2020,7,31,19,24233,23720,19442,-4278
2020,7,31,20,24494,24271,20282,-3989
2020,7,31,21,24720,24808,21003,-3805
2020,7,31,22,24776,25189,21457,-3732
2020,7,31,23,24285,24924,21288,-3636
2020,8,1,0,23429,24204,20669,-3535
2020,8,1,1,22722,23391,19737,-3654
2020,8,1,2,22022,22675,18926,-3749
2020,8,1,3,20768,21372,18087,-3285
2020,8,1,4,19384,20038,17140,-2898
2020,8,1,5,18194,18747,15795,-2952
2020,8,1,6,17217,17763,15002,-2761
2020,8,1,7,16539,17065,14112,-2953
2020,8,1,8,16056,16568,13399,-3169
2020,8,1,9,15794,16275,12885,-3390
2020,8,1,10,15712,16214,12950,-3264
2020,8,1,11,15801,16417,13184,-3233
2020,8,1,12,16627,17260,14018,-3242
2020,8,1,13,17999,18391,15798,-2593
2020,8,1,14,19262,19658,16894,-2764
2020,8,1,15,20420,20968,17825,-3143
2020,8,1,16,21435,22160,18982,-3178
2020,8,1,17,22255,23075,19877,-3198
2020,8,1,18,22878,23627,20213,-3414
2020,8,1,19,23443,24121,21299,-2822
2020,8,1,20,23948,24568,21793,-2775
2020,8,1,21,24363,24944,22208,-2736
2020,8,1,22,24598,25134,22513,-2621
2020,8,1,23,24353,24880,22574,-2306
2020,8,2,0,23518,24182,21357,-2825
2020,8,2,1,23000,23660,20618,-3042
2020,8,2,2,22407,23191,20023,-3168
2020,8,2,3,21257,22218,19375,-2843
2020,8,2,4,20008,21015,18300,-2715
2020,8,2,5,18763,19873,16586,-3287
2020,8,2,6,17916,18981,15883,-3098
2020,8,2,7,17268,18343,15521,-2822
2020,8,2,8,16817,17888,15072,-2816
2020,8,2,9,16566,17646,14740,-2906
2020,8,2,10,16485,17648,14524,-3124
2020,8,2,11,16487,17719,14687,-3032
2020,8,2,12,17170,18281,15404,-2877
2020,8,2,13,18361,19409,16632,-2777
2020,8,2,14,19730,20509,17949,-2560
2020,8,2,15,21033,21548,18424,-3124
2020,8,2,16,22185,22541,19481,-3060
2020,8,2,17,23104,23455,20383,-3072
2020,8,2,18,23770,24158,20783,-3375
2020,8,2,19,24253,24921,21818,-3103
2020,8,2,20,24658,25650,22262,-3388
2020,8,2,21,25037,26312,23025,-3287
2020,8,2,22,25417,26776,23308,-3468
2020,8,2,23,25467,26813,23047,-3766
2020,8,3,0,24904,26264,22624,-3640
2020,8,3,1,24613,25907,22142,-3765
2020,8,3,2,24122,25426,22051,-3375
2020,8,3,3,22892,24160,21020,-3140
2020,8,3,4,21523,22705,19590,-3115
2020,8,3,5,20313,21458,17819,-3639
2020,8,3,6,19499,20464,16881,-3583
2020,8,3,7,18791,19720,16398,-3322
2020,8,3,8,18358,19162,16008,-3154
2020,8,3,9,18241,18887,15442,-3445
2020,8,3,10,18532,19079,16047,-3032
2020,8,3,11,19197,19747,17076,-2671
2020,8,3,12,20422,20923,17893,-3030
2020,8,3,13,21819,22128,18998,-3130
2020,8,3,14,22922,23243,20002,-3241
2020,8,3,15,23857,24119,20492,-3627
2020,8,3,16,24717,24915,21013,-3902
2020,8,3,17,25508,25650,21563,-4087
2020,8,3,18,26183,26424,21956,-4468
2020,8,3,19,26650,27010,22302,-4708
2020,8,3,20,27069,27418,23028,-4390
2020,8,3,21,27340,27824,23512,-4312
2020,8,3,22,27493,27923,23965,-3958
2020,8,3,23,26979,27201,23161,-4040
2020,8,4,0,26172,26435,22350,-4085
2020,8,4,1,25622,25943,22055,-3888
2020,8,4,2,24672,24598,20704,-3894
2020,8,4,3,23080,22776,19073,-3703
2020,8,4,4,21535,21213,18093,-3120
2020,8,4,5,20543,19909,16652,-3257
2020,8,4,6,19605,18956,16095,-2861
2020,8,4,7,18885,18292,15656,-2636
2020,8,4,8,18460,17972,15096,-2876
2020,8,4,9,18337,17959,15258,-2701
2020,8,4,10,18670,18407,15451,-2956
2020,8,4,11,19397,19433,16380,-3053
2020,8,4,12,20481,20717,17472,-3245
2020,8,4,13,21526,21966,18334,-3632
2020,8,4,14,22414,22887,19328,-3559
2020,8,4,15,23086,23475,19942,-3533
2020,8,4,16,23668,23817,20535,-3282
2020,8,4,17,24147,23830,21425,-2405
2020,8,4,18,24491,23117,21128,-1989
2020,8,4,19,24674,21386,19634,-1752
2020,8,4,20,24758,20690,19112,-1578
2020,8,4,21,24750,20547,19049,-1498
2020,8,4,22,24718,20681,18992,-1689
2020,8,4,23,24211,20463,18599,-1864
2020,8,5,0,23502,19978,17906,-2072
2020,8,5,1,23061,19849,18165,-1684
2020,8,5,2,22313,19588,18157,-1431
2020,8,5,3,21070,18683,17291,-1392
2020,8,5,4,19793,17690,16790,-900
2020,8,5,5,18474,16757,15203,-1554
2020,8,5,6,17694,16069,14428,-1641
2020,8,5,7,17073,15684,13756,-1928
2020,8,5,8,16713,15469,13545,-1924
2020,8,5,9,16625,15479,13635,-1844
2020,8,5,10,16980,15876,13659,-2217
2020,8,5,11,17798,16624,14674,-1950
2020,8,5,12,18979,17873,16200,-1673
2020,8,5,13,20295,19074,17199,-1875
2020,8,5,14,21254,20052,18121,-1931
2020,8,5,15,22044,20803,18495,-2308
2020,8,5,16,22772,21484,18916,-2568
2020,8,5,17,23459,22105,19213,-2892
2020,8,5,18,24011,22586,19895,-2691
2020,8,5,19,24460,22917,20695,-2222
2020,8,5,20,24820,23264,20814,-2450
2020,8,5,21,25056,23609,21033,-2576
2020,8,5,22,25115,23762,21171,-2591
2020,8,5,23,24501,23327,20900,-2427
2020,8,6,0,23720,22440,20347,-2093
2020,8,6,1,23188,21824,19793,-2031
2020,8,6,2,22331,21161,19525,-1636
2020,8,6,3,20942,19888,18345,-1543
2020,8,6,4,19546,18479,17034,-1445
2020,8,6,5,17504,17310,15084,-2226
2020,8,6,6,16673,16427,14155,-2272
2020,8,6,7,15993,15836,13579,-2257
2020,8,6,8,15601,15477,13183,-2294
2020,8,6,9,15492,15399,13195,-2204
2020,8,6,10,15820,15781,13543,-2238
2020,8,6,11,16586,16565,14243,-2322
2020,8,6,12,17680,17683,15364,-2319
2020,8,6,13,18824,18569,16372,-2197
2020,8,6,14,19679,19289,16912,-2377
2020,8,6,15,20330,19657,17144,-2513
2020,8,6,16,20956,19993,17333,-2660
2020,8,6,17,21570,20414,17409,-3005
2020,8,6,18,22062,20861,17867,-2994
2020,8,6,19,22272,21294,18476,-2818
2020,8,6,20,22591,21851,19053,-2798
2020,8,6,21,22919,22435,19760,-2675
2020,8,6,22,23029,22657,19770,-2887
2020,8,6,23,22507,22204,19390,-2814
2020,8,7,0,21822,21447,18838,-2609
2020,8,7,1,21501,20941,18291,-2650
2020,8,7,2,20732,20359,18132,-2227
2020,8,7,3,19478,19168,17539,-1629
2020,8,7,4,18245,17909,16277,-1632
2020,8,7,5,16789,16878,14520,-2358
2020,8,7,6,16041,16191,13743,-2448
2020,8,7,7,15459,15676,13371,-2305
2020,8,7,8,15154,15402,12863,-2539
2020,8,7,9,15126,15380,12822,-2558
2020,8,7,10,15565,15574,13201,-2373
2020,8,7,11,16361,16426,14131,-2295
2020,8,7,12,17446,17417,14632,-2785
2020,8,7,13,18514,18357,16113,-2244
2020,8,7,14,19349,19083,16519,-2564
2020,8,7,15,19990,19571,17000,-2571
2020,8,7,16,20526,20108,17458,-2650
2020,8,7,17,21013,20691,18009,-2682
2020,8,7,18,21424,21255,18194,-3061
2020,8,7,19,21729,21706,18436,-3270
2020,8,7,20,21894,21957,18629,-3328
2020,8,7,21,21983,22136,19487,-2649
2020,8,7,22,21938,22182,19664,-2518
2020,8,7,23,21547,21769,19109,-2660
2020,8,8,0,20922,21344,18763,-2581
2020,8,8,1,20659,20999,17779,-3220
2020,8,8,2,19971,20414,17203,-3211
2020,8,8,3,18853,19387,16292,-3095
2020,8,8,4,17745,18249,15538,-2711
2020,8,8,5,16930,17178,13951,-3227
2020,8,8,6,16177,16431,13032,-3399
2020,8,8,7,15601,15913,12675,-3238
2020,8,8,8,15209,15544,12199,-3345
2020,8,8,9,15023,15354,11989,-3365
2020,8,8,10,15109,15440,12161,-3279
2020,8,8,11,15223,15638,12499,-3139
2020,8,8,12,15836,16270,12812,-3458
2020,8,8,13,16770,17162,14049,-3113
2020,8,8,14,17659,18080,15247,-2833
2020,8,8,15,18434,18922,16326,-2596
2020,8,8,16,19201,19765,16575,-3190
2020,8,8,17,19855,20535,17184,-3351
2020,8,8,18,20298,21105,17763,-3342
2020,8,8,19,20860,21609,18667,-2942
2020,8,8,20,21355,22061,19269,-2792
2020,8,8,21,21804,22566,19564,-3002
2020,8,8,22,21996,22966,19944,-3022
2020,8,8,23,21792,22926,20275,-2651
2020,8,9,0,21212,22221,19694,-2527
2020,8,9,1,20844,21695,18967,-2728
2020,8,9,2,20356,21111,18268,-2843
2020,8,9,3,19428,20062,16933,-3129
2020,8,9,4,18343,18862,15566,-3296
2020,8,9,5,17180,17766,13991,-3775
2020,8,9,6,16401,16898,13556,-3342
2020,8,9,7,15777,16292,13011,-3281
2020,8,9,8,15317,15850,12676,-3174
2020,8,9,9,15076,15593,12614,-2979
2020,8,9,10,15053,15554,12689,-2865
2020,8,9,11,15027,15553,12345,-3208
2020,8,9,12,15600,16117,13116,-3001
2020,8,9,13,16651,17275,14128,-3147
2020,8,9,14,17756,18435,15395,-3040
2020,8,9,15,18845,19698,16594,-3104
2020,8,9,16,19981,20943,17571,-3372
2020,8,9,17,20994,21918,18621,-3297
2020,8,9,18,21744,22721,19435,-3286
2020,8,9,19,22522,23308,19647,-3661
2020,8,9,20,23171,23892,20082,-3810
2020,8,9,21,23750,24411,20854,-3557
2020,8,9,22,24042,24777,21250,-3527
2020,8,9,23,23845,24655,21207,-3448
2020,8,10,0,23272,24055,20318,-3737
2020,8,10,1,22884,23765,19826,-3939
2020,8,10,2,22288,23207,19830,-3377
2020,8,10,3,21120,21959,18468,-3491
2020,8,10,4,19771,20673,17249,-3424
2020,8,10,5,18497,19525,15547,-3978
2020,8,10,6,17648,18626,14685,-3941
2020,8,10,7,17057,18001,14098,-3903
2020,8,10,8,16669,17652,13718,-3934
2020,8,10,9,16615,17626,13595,-4031
2020,8,10,10,17104,18140,14180,-3960
2020,8,10,11,18028,19078,15432,-3646
2020,8,10,12,19445,20616,16762,-3854
2020,8,10,13,21053,22231,18319,-3912
2020,8,10,14,22470,23631,19523,-4108
2020,8,10,15,23654,25048,20693,-4355
2020,8,10,16,24843,26411,22518,-3893
2020,8,10,17,26047,27511,23925,-3586
2020,8,10,18,27106,28396,24946,-3450
2020,8,10,19,27897,28910,25465,-3445
2020,8,10,20,28416,29328,25935,-3393
2020,8,10,21,28808,29654,26354,-3300
2020,8,10,22,28899,29685,26660,-3025
2020,8,10,23,28213,29022,26230,-2792
2020,8,11,0,27485,27993,25195,-2798
2020,8,11,1,26876,27212,23738,-3474
2020,8,11,2,25590,26100,22540,-3560
2020,8,11,3,23710,24454,21017,-3437
2020,8,11,4,21959,22760,19396,-3364
2020,8,11,5,20442,21299,17347,-3952
2020,8,11,6,19330,20193,16568,-3625
2020,8,11,7,18550,19446,15600,-3846
2020,8,11,8,18015,18965,15116,-3849
2020,8,11,9,17828,18766,14601,-4165
2020,8,11,10,18191,19186,15099,-4087
2020,8,11,11,19123,20054,16237,-3817
2020,8,11,12,20548,21529,17294,-4235
2020,8,11,13,22146,23022,19056,-3966
2020,8,11,14,23653,24372,20279,-4093
2020,8,11,15,24911,25663,21746,-3917
2020,8,11,16,26049,26823,22837,-3986
2020,8,11,17,27083,27733,24035,-3698
2020,8,11,18,27958,28370,24689,-3681
2020,8,11,19,28543,28731,25138,-3593
2020,8,11,20,28865,29011,25698,-3313
2020,8,11,21,29110,29024,25640,-3384
2020,8,11,22,29047,29061,25963,-3098
2020,8,11,23,28243,28457,25685,-2772
2020,8,12,0,27370,27435,24615,-2820
2020,8,12,1,26754,26773,23693,-3080
2020,8,12,2,25377,25780,22336,-3444
2020,8,12,3,23487,24214,20458,-3756
2020,8,12,4,21762,22557,18647,-3910
2020,8,12,5,20082,21179,17005,-4174
2020,8,12,6,19001,20129,16139,-3990
2020,8,12,7,18218,19375,15203,-4172
2020,8,12,8,17735,18890,14773,-4117
2020,8,12,9,17593,18775,14603,-4172
2020,8,12,10,18009,19190,15011,-4179
2020,8,12,11,18849,20016,16106,-3910
2020,8,12,12,20110,21370,17296,-4074
2020,8,12,13,21408,22639,18643,-3996
2020,8,12,14,22504,23838,19915,-3923
2020,8,12,15,23561,24926,21478,-3448
2020,8,12,16,24610,25927,22609,-3318
2020,8,12,17,25458,26825,23977,-2848
2020,8,12,18,26243,27648,24657,-2991
2020,8,12,19,26837,28013,25300,-2713
2020,8,12,20,27342,27887,25695,-2192
2020,8,12,21,27707,27586,25277,-2309
2020,8,12,22,27739,27486,25136,-2350
2020,8,12,23,27060,27031,24381,-2650
2020,8,13,0,26060,26195,23122,-3073
2020,8,13,1,25406,25559,22235,-3324
2020,8,13,2,24382,24514,21415,-3099
2020,8,13,3,22752,22915,19752,-3163
2020,8,13,4,21066,21292,18039,-3253
2020,8,13,5,19907,19962,16434,-3528
2020,8,13,6,18834,18983,15495,-3488
2020,8,13,7,18067,18327,14866,-3461
2020,8,13,8,17585,17899,14653,-3246
2020,8,13,9,17422,17784,14277,-3507
2020,8,13,10,17806,18173,14463,-3710
2020,8,13,11,18603,19004,15729,-3275
2020,8,13,12,19769,20011,16817,-3194
2020,8,13,13,21021,21137,17717,-3420
2020,8,13,14,22015,22090,18895,-3195
2020,8,13,15,22936,22874,19555,-3319
2020,8,13,16,23807,23520,20483,-3037
2020,8,13,17,24507,24039,21292,-2747
2020,8,13,18,25153,24436,21586,-2850
2020,8,13,19,25648,24632,22122,-2510
2020,8,13,20,26041,24779,22523,-2256
2020,8,13,21,26250,25011,23636,-1375
2020,8,13,22,26346,25169,23903,-1266
2020,8,13,23,25729,24900,22987,-1913
2020,8,14,0,24929,24333,21989,-2344
2020,8,14,1,24412,23923,21291,-2632
2020,8,14,2,23483,23100,20419,-2681
2020,8,14,3,22029,21737,18972,-2765
2020,8,14,4,20497,20298,17705,-2593
2020,8,14,5,19201,19010,15703,-3307
2020,8,14,6,18253,18117,14736,-3381
2020,8,14,7,17556,17448,14392,-3056
2020,8,14,8,17114,17061,13796,-3265
2020,8,14,9,17002,16964,14065,-2899
2020,8,14,10,17403,17386,14404,-2982
2020,8,14,11,18152,18217,15372,-2845
2020,8,14,12,19393,19372,16212,-3160
2020,8,14,13,20748,20692,17248,-3444
2020,8,14,14,21876,21802,17708,-4094
2020,8,14,15,22930,22939,18482,-4457
2020,8,14,16,23886,23973,19600,-4373
2020,8,14,17,24654,24768,20692,-4076
2020,8,14,18,25314,25313,21725,-3588
2020,8,14,19,25701,25600,21960,-3640
2020,8,14,20,25807,25910,22173,-3737
2020,8,14,21,25766,26082,22609,-3473
2020,8,14,22,25670,26040,22753,-3287
2020,8,14,23,24943,25484,22182,-3302
2020,8,15,0,24013,24441,20852,-3589
2020,8,15,1,23254,23729,20088,-3641
2020,8,15,2,22316,22798,18929,-3869
2020,8,15,3,21001,21460,18014,-3446
2020,8,15,4,19639,20026,16905,-3121
2020,8,15,5,18234,18693,15566,-3127
2020,8,15,6,17353,17674,14573,-3101
2020,8,15,7,16659,16955,13566,-3389
2020,8,15,8,16163,16400,12932,-3468
2020,8,15,9,15853,16049,12576,-3473
2020,8,15,10,15760,16020,12734,-3286
2020,8,15,11,15715,16145,12818,-3327
2020,8,15,12,16277,16714,13310,-3404
2020,8,15,13,17292,17510,14368,-3142
2020,8,15,14,18320,18470,15377,-3093
2020,8,15,15,19211,19434,16287,-3147
2020,8,15,16,20061,20419,17031,-3388
2020,8,15,17,20699,21301,18178,-3123
2020,8,15,18,21154,21942,18162,-3780
2020,8,15,19,21504,22345,18313,-4032
2020,8,15,20,21801,22484,18451,-4033
2020,8,15,21,22036,22537,18719,-3818
2020,8,15,22,22188,22458,18997,-3461
2020,8,15,23,21923,21985,18742,-3243
2020,8,16,0,21335,21332,18239,-3093
2020,8,16,1,20972,21074,18007,-3067
2020,8,16,2,20299,20412,17475,-2937
2020,8,16,3,19300,19468,16800,-2668
2020,8,16,4,18241,18384,15934,-2450
2020,8,16,5,17072,17378,13804,-3574
2020,8,16,6,16275,16594,13130,-3464
2020,8,16,7,15658,16044,12645,-3399
2020,8,16,8,15219,15643,12172,-3471
2020,8,16,9,14937,15387,12044,-3343
2020,8,16,10,14837,15348,12239,-3109
2020,8,16,11,14722,15379,11996,-3383
2020,8,16,12,15032,15717,12407,-3310
2020,8,16,13,15750,16414,13224,-3190
2020,8,16,14,16632,17171,14515,-2656
2020,8,16,15,17418,17793,15054,-2739
2020,8,16,16,18187,18346,15447,-2899
2020,8,16,17,18777,18693,15714,-2979
2020,8,16,18,19167,18766,16139,-2627
2020,8,16,19,19413,18873,16378,-2495
2020,8,16,20,19648,18952,16120,-2832
2020,8,16,21,19921,19084,16377,-2707
2020,8,16,22,20218,19287,17078,-2209
2020,8,16,23,20249,19261,16859,-2402
2020,8,17,0,19916,19070,16656,-2414
2020,8,17,1,19876,19042,16678,-2364
2020,8,17,2,19307,18470,16133,-2337
2020,8,17,3,18338,17532,15525,-2007
2020,8,17,4,17279,16540,14277,-2263
2020,8,17,5,16109,15673,12804,-2869
2020,8,17,6,15495,15047,11889,-3158
2020,8,17,7,15060,14637,11879,-2758
2020,8,17,8,14820,14417,11581,-2836
2020,8,17,9,14830,14434,11569,-2865
2020,8,17,10,15336,14964,12172,-2792
2020,8,17,11,16110,15850,13121,-2729
2020,8,17,12,17142,17058,14439,-2619
2020,8,17,13,18172,18119,15210,-2909
2020,8,17,14,18989,18966,16126,-2840
2020,8,17,15,19690,19665,16583,-3082
2020,8,17,16,20346,20334,16646,-3688
2020,8,17,17,20907,21004,17133,-3871
2020,8,17,18,21417,21704,17802,-3902
2020,8,17,19,21750,22283,18202,-4081
2020,8,17,20,22066,22573,18106,-4467
2020,8,17,21,22349,22608,18303,-4305
2020,8,17,22,22548,22380,18538,-3842
2020,8,17,23,22193,21878,18086,-3792
2020,8,18,0,21587,21240,17628,-3612
2020,8,18,1,21242,20899,17380,-3519
2020,8,18,2,20361,19930,16851,-3079
2020,8,18,3,19063,18788,15720,-3068
2020,8,18,4,17763,17600,14775,-2825
2020,8,18,5,16365,16587,13384,-3203
2020,8,18,6,15664,15888,12777,-3111
2020,8,18,7,15164,15425,12670,-2755
2020,8,18,8,14872,14991,11920,-3071
2020,8,18,9,14832,14869,11604,-3265
2020,8,18,10,15300,15302,12074,-3228
2020,8,18,11,16150,16079,12923,-3156
2020,8,18,12,17219,17193,14215,-2978
2020,8,18,13,18286,18274,15351,-2923
2020,8,18,14,19074,19061,15904,-3157
2020,8,18,15,19777,19776,16580,-3196
2020,8,18,16,20460,20472,17356,-3116
2020,8,18,17,21049,21091,17833,-3258
2020,8,18,18,21561,21669,18437,-3232
2020,8,18,19,21933,22119,19298,-2821
2020,8,18,20,22303,22492,19434,-3058
2020,8,18,21,22568,22745,19672,-3073
2020,8,18,22,22741,22855,19877,-2978
2020,8,18,23,22364,22408,19197,-3211
2020,8,19,0,21679,21623,18311,-3312
2020,8,19,1,21234,21249,17791,-3458
2020,8,19,2,20339,20427,17366,-3061
2020,8,19,3,19044,19211,16297,-2914
2020,8,19,4,17706,17956,14846,-3110
2020,8,19,5,16147,16893,13418,-3475
2020,8,19,6,15378,16123,12636,-3487
2020,8,19,7,14827,15545,12602,-2943
2020,8,19,8,14501,15189,12364,-2825
2020,8,19,9,14435,15103,12124,-2979
2020,8,19,10,14903,15530,12634,-2896
2020,8,19,11,15771,16317,13351,-2966
2020,8,19,12,16813,17328,14340,-2988
2020,8,19,13,17827,18216,15204,-3012
2020,8,19,14,18532,18793,15733,-3060
2020,8,19,15,19128,19214,15975,-3239
2020,8,19,16,19697,19434,16072,-3362
2020,8,19,17,20260,19535,16588,-2947
2020,8,19,18,20739,19594,16813,-2781
2020,8,19,19,21038,19698,17537,-2161
2020,8,19,20,21246,19865,17939,-1926
2020,8,19,21,21357,20253,18447,-1806
2020,8,19,22,21434,20690,18432,-2258
2020,8,19,23,21138,20546,18275,-2271
2020,8,20,0,20481,20000,17635,-2365
2020,8,20,1,20168,19723,17203,-2520
2020,8,20,2,19356,18979,16418,-2561
2020,8,20,3,18142,17873,15295,-2578
2020,8,20,4,16840,16707,13889,-2818
2020,8,20,5,15543,15628,12479,-3149
2020,8,20,6,14816,14872,11745,-3127
2020,8,20,7,14307,14329,11521,-2808
2020,8,20,8,13970,14028,11457,-2571
2020,8,20,9,13911,13949,11349,-2600
2020,8,20,10,14344,14372,11690,-2682
2020,8,20,11,15144,15130,12221,-2909
2020,8,20,12,16157,16151,13104,-3047
2020,8,20,13,17129,17045,13734,-3311
2020,8,20,14,17829,17639,14051,-3588
2020,8,20,15,18405,18212,14597,-3615
2020,8,20,16,18985,18761,15419,-3342
2020,8,20,17,19557,19282,16302,-2980
2020,8,20,18,20116,19814,16512,-3302
2020,8,20,19,20518,20262,16915,-3347
2020,8,20,20,20835,20765,17280,-3485
2020,8,20,21,21077,21343,18173,-3170
2020,8,20,22,21266,21671,18625,-3046
2020,8,20,23,21006,21382,18186,-3196
2020,8,21,0,20381,20618,17543,-3075
2020,8,21,1,20060,20204,17098,-3106
2020,8,21,2,19205,19376,16619,-2757
2020,8,21,3,18047,18250,15573,-2677
2020,8,21,4,16854,17082,14742,-2340
2020,8,21,5,15735,16078,13097,-2981
2020,8,21,6,15048,15367,12599,-2768
2020,8,21,7,14574,14879,12543,-2336
2020,8,21,8,14270,14596,12143,-2453
2020,8,21,9,14247,14599,12331,-2268
2020,8,21,10,14712,15101,12905,-2196
2020,8,21,11,15530,15922,13724,-2198
2020,8,21,12,16647,16933,14498,-2435
2020,8,21,13,17853,18008,15386,-2622
2020,8,21,14,18778,18974,16031,-2943
2020,8,21,15,19613,19893,16763,-3130
2020,8,21,16,20437,20813,17578,-3235
2020,8,21,17,21214,21630,18199,-3431
2020,8,21,18,21905,22362,19036,-3326
2020,8,21,19,22471,22957,19377,-3580
2020,8,21,20,22899,23532,20256,-3276
2020,8,21,21,23158,24002,20985,-3017
2020,8,21,22,23190,24157,21612,-2545
2020,8,21,23,22781,23630,21286,-2344
2020,8,22,0,21986,22845,20254,-2591
2020,8,22,1,21486,22412,19451,-2961
2020,8,22,2,20624,21601,18283,-3318
2020,8,22,3,19489,20438,16958,-3480
2020,8,22,4,18268,19203,15602,-3601
2020,8,22,5,17241,18077,14262,-3815
2020,8,22,6,16426,17142,13989,-3153
2020,8,22,7,15796,16525,13703,-2822
2020,8,22,8,15357,16111,12819,-3292
2020,8,22,9,15122,15898,12621,-3277
2020,8,22,10,15213,15956,12780,-3176
2020,8,22,11,15431,16144,13247,-2897
2020,8,22,12,16111,16780,13601,-3179
2020,8,22,13,17314,17871,14496,-3375
2020,8,22,14,18443,19076,15790,-3286
2020,8,22,15,19479,20293,16951,-3342
2020,8,22,16,20538,21408,17780,-3628
2020,8,22,17,21439,22378,18505,-3873
2020,8,22,18,22023,23232,19439,-3793
2020,8,22,19,22433,23708,20027,-3681
2020,8,22,20,22760,24172,20463,-3709
2020,8,22,21,23016,24437,21020,-3417
2020,8,22,22,23126,24570,21277,-3293
2020,8,22,23,22911,24335,21333,-3002
2020,8,23,0,22365,23637,20523,-3114
2020,8,23,1,22002,23260,19585,-3675
2020,8,23,2,21269,22411,18455,-3956
2020,8,23,3,20235,21211,17685,-3526
2020,8,23,4,19060,19913,16615,-3298
2020,8,23,5,18356,18669,14613,-4056
2020,8,23,6,17457,17653,13979,-3674
2020,8,23,7,16741,16902,13425,-3477
2020,8,23,8,16201,16409,12953,-3456
2020,8,23,9,15863,16114,12332,-3782
2020,8,23,10,15784,16061,12187,-3874
2020,8,23,11,15804,16078,12679,-3399
2020,8,23,12,16380,16618,13402,-3216
2020,8,23,13,17581,17678,14561,-3117
2020,8,23,14,18806,18970,15666,-3304
2020,8,23,15,20014,20385,16503,-3882
2020,8,23,16,21291,21552,17362,-4190
2020,8,23,17,22390,22493,18142,-4351
2020,8,23,18,23152,23303,19249,-4054
2020,8,23,19,23639,23918,20155,-3763
2020,8,23,20,24021,24261,20879,-3382
2020,8,23,21,24389,24755,21864,-2891
2020,8,23,22,24652,25043,22367,-2676
2020,8,23,23,24450,24749,22282,-2467
2020,8,24,0,23961,24053,20883,-3170
2020,8,24,1,23619,23761,20275,-3486
2020,8,24,2,22786,22907,19301,-3606
2020,8,24,3,21540,21660,17857,-3803
2020,8,24,4,20171,20358,16693,-3665
2020,8,24,5,18969,19188,15361,-3827
2020,8,24,6,18114,18370,14520,-3850
2020,8,24,7,17497,17777,14079,-3698
2020,8,24,8,17094,17397,13315,-4082
2020,8,24,9,17033,17338,13369,-3969
2020,8,24,10,17527,17860,13801,-4059
2020,8,24,11,18395,18740,15023,-3717
2020,8,24,12,19745,20054,16541,-3513
2020,8,24,13,21222,21483,17334,-4149
2020,8,24,14,22446,22926,18993,-3933
2020,8,24,15,23600,24202,19937,-4265
2020,8,24,16,24725,25445,21494,-3951
2020,8,24,17,25711,26625,22851,-3774
2020,8,24,18,26542,27495,23871,-3624
2020,8,24,19,27083,27874,24612,-3262
2020,8,24,20,27489,28204,25228,-2976
2020,8,24,21,27790,28739,25856,-2883
2020,8,24,22,27812,28885,26079,-2806
2020,8,24,23,27184,28006,25469,-2537
2020,8,25,0,26356,27124,24575,-2549
2020,8,25,1,25688,26491,23551,-2940
2020,8,25,2,24474,25131,21724,-3407
2020,8,25,3,22867,23420,19628,-3792
2020,8,25,4,21254,21704,18406,-3298
2020,8,25,5,20011,20309,16464,-3845
2020,8,25,6,19002,19283,15724,-3559
2020,8,25,7,18269,18518,15110,-3408
2020,8,25,8,17764,17987,14829,-3158
2020,8,25,9,17585,17830,14919,-2911
2020,8,25,10,17960,18256,15026,-3230
2020,8,25,11,18885,19159,15997,-3162
2020,8,25,12,20130,20360,16994,-3366
2020,8,25,13,21425,21634,17978,-3656
2020,8,25,14,22486,22868,19237,-3631
2020,8,25,15,23466,23944,20286,-3658
2020,8,25,16,24387,24897,21105,-3792
2020,8,25,17,25150,25725,22484,-3241
2020,8,25,18,25777,26510,23444,-3066
2020,8,25,19,26210,27118,24028,-3090
2020,8,25,20,26508,27423,24453,-2970
2020,8,25,21,26695,27535,24533,-3002
2020,8,25,22,26597,27298,24139,-3159
2020,8,25,23,25786,26099,23563,-2536
2020,8,26,0,24911,24696,22491,-2205
2020,8,26,1,24158,24056,21806,-2250
2020,8,26,2,22908,22742,20245,-2497
2020,8,26,3,21368,21024,18993,-2031
2020,8,26,4,19817,19405,17754,-1651
2020,8,26,5,18123,18035,15498,-2537
2020,8,26,6,17082,17021,14339,-2682
2020,8,26,7,16317,16267,13738,-2529
2020,8,26,8,15786,15769,13241,-2528
2020,8,26,9,15563,15598,13096,-2502
2020,8,26,10,15842,15898,13269,-2629
2020,8,26,11,16517,16580,14003,-2577
2020,8,26,12,17344,17507,15139,-2368
2020,8,26,13,17978,18293,16048,-2245
2020,8,26,14,18483,18673,16471,-2202
2020,8,26,15,18878,18996,16409,-2587
2020,8,26,16,19250,19278,16805,-2473
2020,8,26,17,19611,19613,17041,-2572
2020,8,26,18,19983,20054,17138,-2916
2020,8,26,19,20310,20420,17748,-2672
2020,8,26,20,20728,20668,17839,-2829
2020,8,26,21,21250,20885,18267,-2618
2020,8,26,22,21529,20894,18558,-2336
2020,8,26,23,21158,20435,18442,-1993
2020,8,27,0,20489,20061,17967,-2094
2020,8,27,1,20184,19994,17521,-2473
2020,8,27,2,19350,19217,16727,-2490
2020,8,27,3,18202,18158,15711,-2447
2020,8,27,4,17064,17111,14808,-2303
2020,8,27,5,16309,16279,13598,-2681
2020,8,27,6,15590,15628,12965,-2663
2020,8,27,7,15129,15252,12591,-2661
2020,8,27,8,14880,15037,12632,-2405
2020,8,27,9,14913,15114,12700,-2414
2020,8,27,10,15466,15665,13308,-2357
2020,8,27,11,16352,16727,14381,-2346
2020,8,27,12,17399,17908,15361,-2547
2020,8,27,13,18487,19022,15838,-3184
2020,8,27,14,19462,19888,16513,-3375
2020,8,27,15,20408,20768,17009,-3759
2020,8,27,16,21393,21866,18296,-3570
2020,8,27,17,22338,23044,19066,-3978
2020,8,27,18,23257,24136,20166,-3970
2020,8,27,19,24031,24711,21030,-3681
2020,8,27,20,24778,25367,22130,-3237
2020,8,27,21,25448,25809,22277,-3532
2020,8,27,22,25699,25879,21962,-3917
2020,8,27,23,25082,25270,21568,-3702
2020,8,28,0,24317,24352,20707,-3645
2020,8,28,1,23876,22997,19450,-3547
2020,8,28,2,22862,21789,18277,-3512
2020,8,28,3,21493,20480,17514,-2966
2020,8,28,4,20069,19233,16709,-2524
2020,8,28,5,18211,18116,15534,-2582
2020,8,28,6,17376,17198,14401,-2797
2020,8,28,7,16753,16586,13823,-2763
2020,8,28,8,16348,16105,13424,-2681
2020,8,28,9,16254,16051,13561,-2490
2020,8,28,10,16687,16507,13947,-2560
2020,8,28,11,17544,17385,14828,-2557
2020,8,28,12,18622,18466,15630,-2836
2020,8,28,13,19802,19630,16685,-2945
2020,8,28,14,20828,20511,17483,-3028
2020,8,28,15,21786,21213,17804,-3409
2020,8,28,16,22660,21688,18007,-3681
2020,8,28,17,23428,22342,18479,-3863
2020,8,28,18,24096,22989,18900,-4089
2020,8,28,19,24585,23450,19584,-3866
2020,8,28,20,24926,23863,20453,-3410
2020,8,28,21,25177,24117,20640,-3477
2020,8,28,22,25132,23873,20627,-3246
2020,8,28,23,24465,23159,20283,-2876
2020,8,29,0,23746,22580,19602,-2978
2020,8,29,1,23266,22281,19000,-3281
2020,8,29,2,22287,21437,17772,-3665
2020,8,29,3,21070,20270,16570,-3700
2020,8,29,4,19823,19054,15632,-3422
2020,8,29,5,18012,18136,14277,-3859
2020,8,29,6,17141,17233,13302,-3931
2020,8,29,7,16504,16630,13305,-3325
2020,8,29,8,16101,16285,13141,-3144
2020,8,29,9,15895,16158,13366,-2792
2020,8,29,10,15998,16303,13203,-3100
2020,8,29,11,16228,16723,13774,-2949
2020,8,29,12,16776,17328,14375,-2953
2020,8,29,13,17718,18390,15130,-3260
2020,8,29,14,18694,19359,16000,-3359
2020,8,29,15,19613,20101,16700,-3401
2020,8,29,16,20402,20733,17342,-3391
2020,8,29,17,21050,21064,17835,-3229
2020,8,29,18,21535,21121,18113,-3008
2020,8,29,19,21737,21289,18274,-3015
2020,8,29,20,21876,21601,18591,-3010
2020,8,29,21,22071,22083,18666,-3417
2020,8,29,22,22070,22468,18619,-3849
2020,8,29,23,21787,22306,18413,-3893
2020,8,30,0,21370,21760,18136,-3624
2020,8,30,1,21109,21538,18698,-2840
2020,8,30,2,20375,20814,18471,-2343
2020,8,30,3,19405,19870,17227,-2643
2020,8,30,4,18319,18705,15610,-3095
2020,8,30,5,16627,17432,14106,-3326
2020,8,30,6,15797,16404,13351,-3053
2020,8,30,7,15160,15572,12758,-2814
2020,8,30,8,14683,15013,12633,-2380
2020,8,30,9,14369,14649,12155,-2494
2020,8,30,10,14232,14516,11822,-2694
2020,8,30,11,14228,14483,11814,-2669
2020,8,30,12,14415,14817,12151,-2666
2020,8,30,13,14981,15570,13353,-2217
2020,8,30,14,15535,16182,14112,-2070
2020,8,30,15,16038,16672,14647,-2025
2020,8,30,16,16496,17072,14970,-2102
2020,8,30,17,16902,17460,15161,-2299
2020,8,30,18,17272,17725,15068,-2657
2020,8,30,19,17477,18062,15380,-2682
2020,8,30,20,17743,18399,15271,-3128
2020,8,30,21,18236,18864,15761,-3103
2020,8,30,22,18662,19344,16083,-3261
2020,8,30,23,18548,19258,15819,-3439
2020,8,31,0,18493,18887,15207,-3680
2020,8,31,1,18310,18769,15574,-3195
2020,8,31,2,17585,18019,15428,-2591
2020,8,31,3,16637,17021,14793,-2228
2020,8,31,4,15703,15961,13838,-2123
2020,8,31,5,15124,15032,12052,-2980
2020,8,31,6,14458,14376,11004,-3372
2020,8,31,7,14063,13952,10682,-3270
2020,8,31,8,13842,13714,10652,-3062
2020,8,31,9,13909,13733,10759,-2974
2020,8,31,10,14417,14252,11331,-2921
2020,8,31,11,15298,15182,12196,-2986
2020,8,31,12,16223,16167,13673,-2494
2020,8,31,13,17112,17013,14561,-2452
2020,8,31,14,17741,17590,14613,-2977
2020,8,31,15,18178,18062,15109,-2953
2020,8,31,16,18575,18589,15251,-3338
2020,8,31,17,18973,19017,15173,-3844
2020,8,31,18,19412,19405,15456,-3949
2020,8,31,19,19686,19634,15626,-4008
2020,8,31,20,19958,19892,15838,-4054
2020,8,31,21,20296,20061,16197,-3864
2020,8,31,22,20486,20289,16656,-3633
2020,8,31,23,20132,20065,16601,-3464
2020,9,1,0,19903,19883,16373,-3510
2020,9,1,1,19646,19729,16358,-3371
2020,9,1,2,18697,18988,16134,-2854
2020,9,1,3,17515,17968,15799,-2169
2020,9,1,4,16401,16847,15040,-1807
2020,9,1,5,15384,15965,13046,-2919
2020,9,1,6,14815,15364,12320,-3044
2020,9,1,7,14456,14974,11748,-3226
2020,9,1,8,14251,14713,11445,-3268
2020,9,1,9,14329,14758,11497,-3261
2020,9,1,10,14913,15295,12331,-2964
2020,9,1,11,15977,16364,13465,-2899
2020,9,1,12,16977,17447,14533,-2914
2020,9,1,13,17975,18456,15569,-2887
2020,9,1,14,18640,19145,15954,-3191
2020,9,1,15,19122,19765,16483,-3282
2020,9,1,16,19581,20340,16757,-3583
2020,9,1,17,20009,20717,17126,-3591
2020,9,1,18,20382,21038,17522,-3516
2020,9,1,19,20620,21426,17927,-3499
2020,9,1,20,20875,21642,18037,-3605
2020,9,1,21,21130,21841,17978,-3863
2020,9,1,22,21262,21872,18169,-3703
2020,9,1,23,20945,21372,18081,-3291
2020,9,2,0,20650,21030,17411,-3619
2020,9,2,1,20334,20748,17352,-3396
2020,9,2,2,19428,19941,16940,-3001
2020,9,2,3,18273,18837,16408,-2429
2020,9,2,4,17108,17654,15081,-2573
2020,9,2,5,16353,16720,13842,-2878
2020,9,2,6,15764,16059,13430,-2629
2020,9,2,7,15362,15632,13057,-2575
2020,9,2,8,15148,15346,12725,-2621
2020,9,2,9,15220,15416,13109,-2307
2020,9,2,10,15854,16046,13661,-2385
2020,9,2,11,16928,17265,14752,-2513
2020,9,2,12,17994,18429,15938,-2491
2020,9,2,13,19025,19523,16766,-2757
2020,9,2,14,19775,20326,17204,-3122
2020,9,2,15,20379,21051,17327,-3724
2020,9,2,16,20931,21628,17927,-3701
2020,9,2,17,21481,21932,18434,-3498
2020,9,2,18,21943,22319,18592,-3727
2020,9,2,19,22235,22637,19010,-3627
2020,9,2,20,22493,22921,18876,-4045
2020,9,2,21,22680,23203,19128,-4075
2020,9,2,22,22732,23262,19030,-4232
2020,9,2,23,22327,22917,18867,-4050
2020,9,3,0,22094,22702,18613,-4089
2020,9,3,1,21765,22449,18138,-4311
2020,9,3,2,20913,21575,17390,-4185
2020,9,3,3,19747,20446,16675,-3771
2020,9,3,4,18523,19204,15791,-3413
2020,9,3,5,17645,18108,14598,-3510
2020,9,3,6,16932,17325,13778,-3547
2020,9,3,7,16407,16757,13291,-3466
2020,9,3,8,16063,16445,12965,-3480
2020,9,3,9,16033,16421,13015,-3406
2020,9,3,10,16533,16903,13617,-3286
2020,9,3,11,17516,17721,14241,-3480
2020,9,3,12,18618,18436,15281,-3155
2020,9,3,13,19844,19298,15782,-3516
2020,9,3,14,20589,19958,16010,-3948
2020,9,3,15,21267,20700,16352,-4348
2020,9,3,16,21957,21540,17168,-4372
2020,9,3,17,22641,22172,17843,-4329
2020,9,3,18,23298,22757,18334,-4423
2020,9,3,19,23785,23399,18738,-4661
2020,9,3,20,24206,23900,18889,-5011
2020,9,3,21,24509,24072,19249,-4823
2020,9,3,22,24557,23962,19451,-4511
2020,9,3,23,23964,23277,18948,-4329
2020,9,4,0,23646,22733,18613,-4120
2020,9,4,1,23081,22156,18298,-3858
2020,9,4,2,22039,21200,17843,-3357
2020,9,4,3,20747,20160,17480,-2680
2020,9,4,4,19439,19041,16268,-2773
2020,9,4,5,18258,17944,14715,-3229
2020,9,4,6,17552,17095,14163,-2932
2020,9,4,7,17001,16456,13585,-2871
2020,9,4,8,16611,16050,13261,-2789
2020,9,4,9,16500,15917,13170,-2747
2020,9,4,10,16840,16270,13443,-2827
2020,9,4,11,17634,17105,14101,-3004
2020,9,4,12,18519,18176,15611,-2565
2020,9,4,13,19373,19230,16273,-2957
2020,9,4,14,19983,20072,16925,-3147
2020,9,4,15,20531,20873,17360,-3513
2020,9,4,16,21000,21623,18091,-3532
2020,9,4,17,21423,22248,18747,-3501
2020,9,4,18,21819,22775,19486,-3289
2020,9,4,19,22119,23080,19851,-3229
2020,9,4,20,22273,23118,20205,-2913
2020,9,4,21,22372,23236,20691,-2545
2020,9,4,22,22217,23111,20356,-2755
2020,9,4,23,21479,22313,19511,-2802
2020,9,5,0,20915,21347,18497,-2850
2020,9,5,1,20047,20731,18132,-2599
2020,9,5,2,19059,19695,17550,-2145
2020,9,5,3,18012,18525,16960,-1565
2020,9,5,4,16964,17333,15343,-1990
2020,9,5,5,15965,16278,13314,-2964
2020,9,5,6,15205,15495,12350,-3145
2020,9,5,7,14632,14872,11870,-3002
2020,9,5,8,14257,14443,11349,-3094
2020,9,5,9,14055,14227,11284,-2943
2020,9,5,10,14060,14220,11452,-2768
2020,9,5,11,14241,14350,11464,-2886
2020,9,5,12,14617,14768,11964,-2804
2020,9,5,13,15241,15432,12887,-2545
2020,9,5,14,15757,16018,13190,-2828
2020,9,5,15,16053,16512,13993,-2519
2020,9,5,16,16317,16930,14036,-2894
2020,9,5,17,16531,17329,14730,-2599
2020,9,5,18,16682,17628,15131,-2497
2020,9,5,19,17017,17903,15472,-2431
2020,9,5,20,17454,18144,15535,-2609
2020,9,5,21,17951,18547,16077,-2470
2020,9,5,22,18304,18835,16083,-2752
2020,9,5,23,18272,18627,15947,-2680
2020,9,6,0,17951,18390,15898,-2492
2020,9,6,1,17750,18188,15859,-2329
2020,9,6,2,17126,17540,15232,-2308
2020,9,6,3,16424,16758,14404,-2354
2020,9,6,4,15631,15887,13287,-2600
2020,9,6,5,14881,15117,12226,-2891
2020,9,6,6,14295,14491,11597,-2894
2020,9,6,7,13816,14042,11123,-2919
2020,9,6,8,13488,13738,10822,-2916
2020,9,6,9,13292,13575,10553,-3022
2020,9,6,10,13196,13602,10796,-2806
2020,9,6,11,13194,13679,10698,-2981
2020,9,6,12,13356,14014,11608,-2406
2020,9,6,13,13955,14707,12165,-2542
2020,9,6,14,14600,15385,12608,-2777
2020,9,6,15,15111,16105,13365,-2740
2020,9,6,16,15622,16726,14002,-2724
2020,9,6,17,16077,17358,14335,-3023
2020,9,6,18,16444,17858,15194,-2664
2020,9,6,19,16939,18251,15717,-2534
2020,9,6,20,17483,18716,16118,-2598
2020,9,6,21,18081,19201,16196,-3005
2020,9,6,22,18528,19535,16299,-3236
2020,9,6,23,18566,19271,16084,-3187
2020,9,7,0,18394,19100,16249,-2851
2020,9,7,1,18352,18935,16384,-2551
2020,9,7,2,17712,18272,16233,-2039
2020,9,7,3,16921,17366,15473,-1893
2020,9,7,4,16000,16464,14134,-2330
2020,9,7,5,15041,15579,13148,-2431
2020,9,7,6,14451,14977,12752,-2225
2020,9,7,7,14012,14525,12373,-2152
2020,9,7,8,13731,14216,12024,-2192
2020,9,7,9,13601,14132,11825,-2307
2020,9,7,10,13657,14310,12308,-2002
2020,9,7,11,13921,14601,12128,-2473
2020,9,7,12,14310,15091,12979,-2112
2020,9,7,13,15161,15990,13810,-2180
2020,9,7,14,16113,16897,14604,-2293
2020,9,7,15,17000,17517,15461,-2056
2020,9,7,16,17751,18142,16326,-1816
2020,9,7,17,18268,18639,16759,-1880
2020,9,7,18,18689,19094,16868,-2226
2020,9,7,19,19146,19429,17203,-2226
2020,9,7,20,19503,19736,17667,-2069
2020,9,7,21,19923,20070,17564,-2506
2020,9,7,22,20162,20202,17780,-2422
2020,9,7,23,20019,19968,17565,-2403
2020,9,8,0,19825,19933,17725,-2208
2020,9,8,1,19819,19780,17477,-2303
2020,9,8,2,18910,19019,16985,-2034
2020,9,8,3,17822,17986,16051,-1935
2020,9,8,4,16681,16919,15022,-1897
2020,9,8,5,15467,15998,13273,-2725
2020,9,8,6,14888,15312,12391,-2921
2020,9,8,7,14463,14836,12216,-2620
2020,9,8,8,14196,14600,11882,-2718
2020,9,8,9,14237,14659,11869,-2790
2020,9,8,10,14801,15247,12495,-2752
2020,9,8,11,15975,16438,13669,-2769
2020,9,8,12,17029,17644,15229,-2415
2020,9,8,13,18101,18817,16470,-2347
2020,9,8,14,18911,19521,17194,-2327
2020,9,8,15,19749,20281,17329,-2952
2020,9,8,16,20583,21204,17798,-3406
2020,9,8,17,21286,22020,18300,-3720
2020,9,8,18,22000,22856,19082,-3774
2020,9,8,19,22626,23521,20087,-3434
2020,9,8,20,23032,23987,20450,-3537
2020,9,8,21,23376,24219,21007,-3212
2020,9,8,22,23440,24155,20943,-3212
2020,9,8,23,22906,23380,20173,-3207
2020,9,9,0,22470,22763,19368,-3395
2020,9,9,1,21886,22144,18744,-3400
2020,9,9,2,20614,20965,17987,-2978
2020,9,9,3,19186,19577,17106,-2471
2020,9,9,4,17756,18223,15722,-2501
2020,9,9,5,16017,17121,14831,-2290
2020,9,9,6,15248,16315,14102,-2213
2020,9,9,7,14720,15731,13557,-2174
2020,9,9,8,14388,15387,13161,-2226
2020,9,9,9,14414,15377,13317,-2060
2020,9,9,10,15028,15923,13654,-2269
2020,9,9,11,16390,17066,14691,-2375
2020,9,9,12,17402,18152,16312,-1840
2020,9,9,13,18352,19157,17399,-1758
2020,9,9,14,19087,19870,17319,-2551
2020,9,9,15,19876,20647,17432,-3215
2020,9,9,16,20698,21421,18275,-3146
2020,9,9,17,21443,22156,19311,-2845
2020,9,9,18,22251,22805,19967,-2838
2020,9,9,19,22889,23188,20471,-2717
2020,9,9,20,23362,23401,20505,-2896
2020,9,9,21,23667,23612,20644,-2968
2020,9,9,22,23636,23661,20851,-2810
2020,9,9,23,23112,23178,20649,-2529
2020,9,10,0,22741,22914,20127,-2787
2020,9,10,1,22193,22401,19959,-2442
2020,9,10,2,20949,21369,18935,-2434
2020,9,10,3,19490,20101,17722,-2379
2020,9,10,4,18018,18840,16109,-2731
2020,9,10,5,16969,17743,15071,-2672
2020,9,10,6,16133,17012,14419,-2593
2020,9,10,7,15566,16506,13890,-2616
2020,9,10,8,15252,16231,13564,-2667
2020,9,10,9,15323,16256,13373,-2883
2020,9,10,10,16043,16867,14186,-2681
2020,9,10,11,17530,18190,15534,-2656
2020,9,10,12,18644,19372,16954,-2418
2020,9,10,13,19709,20473,17751,-2722
2020,9,10,14,20570,21151,18258,-2893
2020,9,10,15,21387,21786,18927,-2859
2020,9,10,16,22176,22514,19636,-2878
2020,9,10,17,22745,23113,20439,-2674
2020,9,10,18,23235,23727,20848,-2879
2020,9,10,19,23536,24039,21426,-2613
2020,9,10,20,23742,24208,21503,-2705
2020,9,10,21,23812,24237,21528,-2709
2020,9,10,22,23658,24133,21430,-2703
2020,9,10,23,23075,23692,20921,-2771
2020,9,11,0,22804,23420,20609,-2811
2020,9,11,1,22299,22756,20244,-2512
2020,9,11,2,21018,21632,19096,-2536
2020,9,11,3,19599,20275,17663,-2612
2020,9,11,4,18178,18927,16181,-2746
2020,9,11,5,17364,17859,15477,-2382
2020,9,11,6,16555,17114,13981,-3133
2020,9,11,7,15968,16560,13136,-3424
2020,9,11,8,15601,16233,12733,-3500
2020,9,11,9,15549,16169,12632,-3537
2020,9,11,10,16013,16559,12881,-3678
2020,9,11,11,17089,17590,14175,-3415
2020,9,11,12,17897,18471,15844,-2627
2020,9,11,13,18628,19241,16650,-2591
2020,9,11,14,19036,19661,17254,-2407
2020,9,11,15,19392,19907,17639,-2268
2020,9,11,16,19684,20123,17397,-2726
2020,9,11,17,19861,20062,17376,-2686
2020,9,11,18,20060,19971,17003,-2968
2020,9,11,19,20137,19973,17018,-2955
2020,9,11,20,20217,19978,17305,-2673
2020,9,11,21,20244,19990,17255,-2735
2020,9,11,22,20097,19894,17440,-2454
2020,9,11,23,19542,19431,16903,-2528
2020,9,12,0,19178,19001,16687,-2314
2020,9,12,1,18641,18518,16751,-1767
2020,9,12,2,17757,17642,16425,-1217
2020,9,12,3,16832,16627,15536,-1091
2020,9,12,4,15857,15577,14289,-1288
2020,9,12,5,14915,14769,12251,-2518
2020,9,12,6,14224,14178,11907,-2271
2020,9,12,7,13744,13763,11271,-2492
2020,9,12,8,13405,13459,10946,-2513
2020,9,12,9,13262,13311,10787,-2524
2020,9,12,10,13267,13426,10860,-2566
2020,9,12,11,13418,13756,11132,-2624
2020,9,12,12,13830,14173,12033,-2140
2020,9,12,13,14553,14706,12673,-2033
2020,9,12,14,15069,15101,12906,-2195
2020,9,12,15,15433,15384,13202,-2182
2020,9,12,16,15752,15640,13632,-2008
2020,9,12,17,16027,15879,14017,-1862
2020,9,12,18,16291,16050,14086,-1964
2020,9,12,19,16491,16275,14409,-1866
2020,9,12,20,16659,16525,14667,-1858
2020,9,12,21,16950,16923,14801,-2122
2020,9,12,22,17196,17201,15342,-1859
2020,9,12,23,17101,17147,15503,-1644
2020,9,13,0,17201,17192,15562,-1630
2020,9,13,1,16958,16930,15400,-1530
2020,9,13,2,16312,16265,15250,-1015
2020,9,13,3,15592,15555,14130,-1425
2020,9,13,4,14771,14795,13027,-1768
2020,9,13,5,13789,14068,11896,-2172
2020,9,13,6,13289,13547,11331,-2216
2020,9,13,7,12912,13218,11325,-1893
2020,9,13,8,12655,13035,11154,-1881
2020,9,13,9,12551,12970,10973,-1997
2020,9,13,10,12549,13105,11050,-2055
2020,9,13,11,12648,13369,11097,-2272
2020,9,13,12,12959,13703,11380,-2323
2020,9,13,13,13705,14421,12344,-2077
2020,9,13,14,14415,15167,13416,-1751
2020,9,13,15,15046,15883,14274,-1609
2020,9,13,16,15648,16458,14812,-1646
2020,9,13,17,16217,16882,14904,-1978
2020,9,13,18,16683,17165,15255,-1910
2020,9,13,19,17036,17442,15449,-1993
2020,9,13,20,17339,17713,15629,-2084
2020,9,13,21,17787,18181,16556,-1625
2020,9,13,22,18164,18552,16916,-1636
2020,9,13,23,18153,18592,16990,-1602
2020,9,14,0,18459,18798,16859,-1939
2020,9,14,1,18251,18589,17069,-1520
2020,9,14,2,17400,17874,16512,-1362
2020,9,14,3,16461,16989,15486,-1503
2020,9,14,4,15503,16103,14143,-1960
2020,9,14,5,14735,15303,13006,-2297
2020,9,14,6,14234,14808,12274,-2534
2020,9,14,7,13856,14454,11886,-2568
2020,9,14,8,13634,14270,11794,-2476
2020,9,14,9,13710,14355,11791,-2564
2020,9,14,10,14303,14960,12734,-2226
2020,9,14,11,15589,16153,14187,-1966
2020,9,14,12,16633,17157,14972,-2185
2020,9,14,13,17360,17875,15633,-2242
2020,9,14,14,17760,18173,15995,-2178
2020,9,14,15,18112,18323,16146,-2177
2020,9,14,16,18412,18437,16351,-2086
2020,9,14,17,18576,18599,16426,-2173
2020,9,14,18,18762,18780,16716,-2064
2020,9,14,19,18821,18843,16836,-2007
2020,9,14,20,18855,18949,16794,-2155
2020,9,14,21,18914,19099,16972,-2127
2020,9,14,22,18948,19125,17125,-2000
2020,9,14,23,18637,18693,16794,-1899
2020,9,15,0,18652,18569,16787,-1782
2020,9,15,1,18001,17889,16260,-1629
2020,9,15,2,16890,16834,15614,-1220
2020,9,15,3,15688,15651,14546,-1105
2020,9,15,4,14549,14509,13486,-1023
2020,9,15,5,13875,13674,12188,-1486
2020,9,15,6,13322,13127,11220,-1907
2020,9,15,7,12937,12782,10813,-1969
2020,9,15,8,12738,12623,10638,-1985
2020,9,15,9,12813,12710,10867,-1843
2020,9,15,10,13357,13292,11678,-1614
2020,9,15,11,14535,14467,12483,-1984
2020,9,15,12,15437,15409,13491,-1918
2020,9,15,13,15849,15943,14385,-1558
2020,9,15,14,15911,16076,14451,-1625
2020,9,15,15,15951,16062,14414,-1648
2020,9,15,16,16063,16083,14426,-1657
2020,9,15,17,16156,16100,14525,-1575
2020,9,15,18,16343,16193,14764,-1429
2020,9,15,19,16489,16346,14807,-1539
2020,9,15,20,16690,16580,14999,-1581
2020,9,15,21,16996,16948,15463,-1485
2020,9,15,22,17264,17261,15735,-1526
2020,9,15,23,17336,17233,15773,-1460
2020,9,16,0,17493,17380,15557,-1823
2020,9,16,1,17170,16936,15535,-1401
2020,9,16,2,16272,16046,14904,-1142
2020,9,16,3,15229,14971,14114,-857
2020,9,16,4,14196,14032,12821,-1211
2020,9,16,5,13378,13305,11694,-1611
2020,9,16,6,12872,12835,11089,-1746
2020,9,16,7,12562,12570,11308,-1262
2020,9,16,8,12405,12428,11305,-1123
2020,9,16,9,12508,12546,11451,-1095
2020,9,16,10,13080,13158,11997,-1161
2020,9,16,11,14278,14357,12405,-1952
2020,9,16,12,15203,15312,12958,-2354
2020,9,16,13,15842,15988,14153,-1835
2020,9,16,14,16094,16185,14264,-1921
2020,9,16,15,16315,16297,14418,-1879
2020,9,16,16,16589,16482,14800,-1682
2020,9,16,17,16840,16627,14606,-2021
2020,9,16,18,17173,16805,14522,-2283
2020,9,16,19,17402,16952,14821,-2131
2020,9,16,20,17696,17207,15193,-2014
2020,9,16,21,18070,17534,15234,-2300
2020,9,16,22,18297,17793,15528,-2265
2020,9,16,23,18009,17724,15831,-1893
2020,9,17,0,18220,17922,16159,-1763
2020,9,17,1,17705,17478,15839,-1639
2020,9,17,2,16740,16641,15146,-1495
2020,9,17,3,15682,15619,14316,-1303
2020,9,17,4,14685,14623,13734,-889
2020,9,17,5,13730,13861,12631,-1230
2020,9,17,6,13273,13348,11928,-1420
2020,9,17,7,12949,13030,11719,-1311
2020,9,17,8,12781,12871,11658,-1213
2020,9,17,9,12872,13021,11841,-1180
2020,9,17,10,13429,13615,12087,-1528
2020,9,17,11,14641,14910,12927,-1983
2020,9,17,12,15606,15984,14297,-1687
2020,9,17,13,16307,16821,14945,-1876
2020,9,17,14,16725,17310,15156,-2154
2020,9,17,15,17081,17590,15220,-2370
2020,9,17,16,17426,17835,15606,-2229
2020,9,17,17,17696,18098,16088,-2010
2020,9,17,18,17955,18412,16490,-1922
2020,9,17,19,18126,18504,16527,-1977
2020,9,17,20,18348,18562,16625,-1937
2020,9,17,21,18644,18728,17076,-1652
2020,9,17,22,18798,18846,17081,-1765
2020,9,17,23,18557,18678,16688,-1990
2020,9,18,0,18643,18785,16651,-2134
2020,9,18,1,18062,18339,16384,-1955
2020,9,18,2,17124,17495,15893,-1602
2020,9,18,3,16046,16484,14871,-1613
2020,9,18,4,14991,15437,13184,-2253
2020,9,18,5,14090,14567,12091,-2476
2020,9,18,6,13543,13961,11626,-2335
2020,9,18,7,13155,13547,11293,-2254
2020,9,18,8,12938,13290,11019,-2271
2020,9,18,9,12975,13326,11232,-2094
2020,9,18,10,13501,13900,11326,-2574
2020,9,18,11,14653,15089,12220,-2869
2020,9,18,12,15645,15957,13579,-2378
2020,9,18,13,16316,16510,14214,-2296
2020,9,18,14,16610,16694,14276,-2418
2020,9,18,15,16749,16771,14389,-2382
2020,9,18,16,16785,16825,14679,-2146
2020,9,18,17,16698,16827,14365,-2462
2020,9,18,18,16632,16862,13852,-3010
2020,9,18,19,16486,16787,13699,-3088
2020,9,18,20,16427,16776,13705,-3071
2020,9,18,21,16497,16976,14110,-2866
2020,9,18,22,16525,17142,14445,-2697
2020,9,18,23,16376,16994,14574,-2420
2020,9,19,0,16452,17041,14485,-2556
2020,9,19,1,15950,16640,14184,-2456
2020,9,19,2,15200,15883,13812,-2071
2020,9,19,3,14387,14947,12710,-2237
2020,9,19,4,13541,14013,11615,-2398
2020,9,19,5,13013,13215,10741,-2474
2020,9,19,6,12560,12677,10359,-2318
2020,9,19,7,12268,12342,10118,-2224
2020,9,19,8,12101,12178,9737,-2441
2020,9,19,9,12077,12184,9809,-2375
2020,9,19,10,12246,12417,10411,-2006
2020,9,19,11,12592,12896,10849,-2047
2020,9,19,12,13004,13349,11386,-1963
2020,9,19,13,13494,13755,11896,-1859
2020,9,19,14,13723,13885,11911,-1974
2020,9,19,15,13779,13889,11773,-2116
2020,9,19,16,13774,13884,11908,-1976
2020,9,19,17,13707,13851,11878,-1973
2020,9,19,18,13629,13754,11741,-2013
2020,9,19,19,13611,13721,11840,-1881
2020,9,19,20,13785,13858,11928,-1930
2020,9,19,21,14251,14275,12501,-1774
2020,9,19,22,14725,14852,13038,-1814
2020,9,19,23,14961,15239,13458,-1781
2020,9,20,0,15429,15683,13933,-1750
2020,9,20,1,15253,15512,13762,-1750
2020,9,20,2,14749,14943,13152,-1791
2020,9,20,3,14180,14260,12372,-1888
2020,9,20,4,13570,13523,11443,-2080
2020,9,20,5,12800,12933,10354,-2579
2020,9,20,6,12410,12443,9765,-2678
2020,9,20,7,12098,12166,9527,-2639
2020,9,20,8,11903,12017,9663,-2354
2020,9,20,9,11834,11969,9692,-2277
2020,9,20,10,11921,12123,9909,-2214
2020,9,20,11,12115,12467,10179,-2288
2020,9,20,12,12343,12804,10558,-2246
2020,9,20,13,12771,13320,11266,-2054
2020,9,20,14,13052,13537,11364,-2173
2020,9,20,15,13225,13588,11404,-2184
2020,9,20,16,13342,13573,11416,-2157
2020,9,20,17,13453,13564,10987,-2577
2020,9,20,18,13502,13552,10856,-2696
2020,9,20,19,13583,13595,11138,-2457
2020,9,20,20,13833,13753,11336,-2417
2020,9,20,21,14408,14228,12068,-2160
2020,9,20,22,14971,14956,12890,-2066
2020,9,20,23,15236,15447,13411,-2036
2020,9,21,0,15797,15958,13540,-2418
2020,9,21,1,15618,15774,13313,-2461
2020,9,21,2,14910,15111,12845,-2266
2020,9,21,3,14100,14265,12338,-1927
2020,9,21,4,13344,13408,10808,-2600
2020,9,21,5,12694,12794,10185,-2609
2020,9,21,6,12315,12426,9837,-2589
2020,9,21,7,12087,12223,9720,-2503
2020,9,21,8,12009,12181,9936,-2245
2020,9,21,9,12214,12377,10062,-2315
2020,9,21,10,12913,13113,10719,-2394
2020,9,21,11,14207,14424,11659,-2765
2020,9,21,12,15075,15444,12724,-2720
2020,9,21,13,15547,15969,13363,-2606
2020,9,21,14,15593,15940,13375,-2565
2020,9,21,15,15583,15846,13157,-2689
2020,9,21,16,15584,15820,12973,-2847
2020,9,21,17,15587,15744,12826,-2918
2020,9,21,18,15645,15722,12656,-3066
2020,9,21,19,15722,15690,12688,-3002
2020,9,21,20,15884,15819,12882,-2937
2020,9,21,21,16220,16197,12985,-3212
2020,9,21,22,16575,16704,13807,-2897
2020,9,21,23,16622,16884,13805,-3079
2020,9,22,0,16963,17132,14141,-2991
2020,9,22,1,16534,16686,13891,-2795
2020,9,22,2,15619,15819,13350,-2469
2020,9,22,3,14583,14761,12667,-2094
2020,9,22,4,13615,13738,11599,-2139
2020,9,22,5,12941,13043,10873,-2170
2020,9,22,6,12516,12669,10450,-2219
2020,9,22,7,12238,12441,10225,-2216
2020,9,22,8,12128,12387,9935,-2452
2020,9,22,9,12284,12568,10260,-2308
2020,9,22,10,12933,13230,11045,-2185
2020,9,22,11,14251,14568,12040,-2528
2020,9,22,12,15146,15544,13336,-2208
2020,9,22,13,15640,16046,13828,-2218
2020,9,22,14,15634,16014,13856,-2158
2020,9,22,15,15579,15858,13925,-1933
2020,9,22,16,15588,15803,14009,-1794
2020,9,22,17,15640,15798,13866,-1932
2020,9,22,18,15732,15813,13861,-1952
2020,9,22,19,15830,15837,14145,-1692
2020,9,22,20,16040,16003,14280,-1723
2020,9,22,21,16376,16446,14775,-1671
2020,9,22,22,16694,16917,15034,-1883
2020,9,22,23,16731,17015,15158,-1857
2020,9,23,0,17013,17270,15356,-1914
2020,9,23,1,16607,16776,14675,-2101
2020,9,23,2,15690,15918,14085,-1833
2020,9,23,3,14629,14895,13307,-1588
2020,9,23,4,13643,13934,12406,-1528
2020,9,23,5,12962,13201,11409,-1792
2020,9,23,6,12527,12750,10766,-1984
2020,9,23,7,12244,12449,10452,-1997
2020,9,23,8,12101,12362,10338,-2024
2020,9,23,9,12211,12499,10692,-1807
2020,9,23,10,12807,13142,11232,-1910
2020,9,23,11,14051,14385,12778,-1607
2020,9,23,12,14932,15407,14177,-1230
2020,9,23,13,15587,15992,14589,-1403
2020,9,23,14,15811,16199,14543,-1656
2020,9,23,15,16010,16301,14529,-1772
2020,9,23,16,16272,16499,14494,-2005
2020,9,23,17,16553,16683,14588,-2095
2020,9,23,18,16899,16930,14947,-1983
2020,9,23,19,17183,17186,15589,-1597
2020,9,23,20,17520,17519,15918,-1601
2020,9,23,21,17879,18001,16225,-1776
2020,9,23,22,18134,18412,16526,-1886
2020,9,23,23,17916,18322,16635,-1687
2020,9,24,0,18080,18479,16975,-1504
2020,9,24,1,17526,17939,16335,-1604
2020,9,24,2,16598,16981,15751,-1230
2020,9,24,3,15493,15855,14590,-1265
2020,9,24,4,14472,14749,13013,-1736
2020,9,24,5,13589,13912,11592,-2320
2020,9,24,6,13095,13335,10813,-2522
2020,9,24,7,12726,12979,10530,-2449
2020,9,24,8,12530,12840,10660,-2180
2020,9,24,9,12616,12909,10538,-2371
2020,9,24,10,13198,13507,11613,-1894
2020,9,24,11,14499,14722,12491,-2231
2020,9,24,12,15404,15741,13621,-2120
2020,9,24,13,16093,16434,14583,-1851
2020,9,24,14,16510,16796,14548,-2248
2020,9,24,15,16843,17083,14815,-2268
2020,9,24,16,17207,17378,14744,-2634
2020,9,24,17,17524,17641,14987,-2654
2020,9,24,18,17829,17838,14996,-2842
2020,9,24,19,18042,17934,15171,-2763
2020,9,24,20,18280,18038,15215,-2823
2020,9,24,21,18529,18178,15411,-2767
2020,9,24,22,18668,18331,15875,-2456
2020,9,24,23,18619,18294,15487,-2807
2020,9,25,0,18512,18476,15880,-2596
2020,9,25,1,17951,17924,15382,-2542
2020,9,25,2,17052,17045,14767,-2278
2020,9,25,3,15935,15971,14368,-1603
2020,9,25,4,14842,14916,13345,-1571
2020,9,25,5,14087,14108,11589,-2519
2020,9,25,6,13537,13521,11022,-2499
2020,9,25,7,13149,13132,10615,-2517
2020,9,25,8,12957,12956,10657,-2299
2020,9,25,9,13033,13021,10920,-2101
2020,9,25,10,13611,13616,11454,-2162
2020,9,25,11,14869,14847,12469,-2378
2020,9,25,12,15849,15821,13512,-2309
2020,9,25,13,16612,16540,14215,-2325
2020,9,25,14,17047,16901,14674,-2227
2020,9,25,15,17410,17222,14870,-2352
2020,9,25,16,17782,17573,15124,-2449
2020,9,25,17,18106,17926,15175,-2751
2020,9,25,18,18455,18312,15253,-3059
2020,9,25,19,18739,18515,15315,-3200
2020,9,25,20,19012,18662,15628,-3034
2020,9,25,21,19222,18954,15827,-3127
2020,9,25,22,19216,19026,16118,-2908
2020,9,25,23,18964,18821,15968,-2853
2020,9,26,0,18638,18784,16000,-2784
2020,9,26,1,17952,18180,15401,-2779
2020,9,26,2,17144,17317,14939,-2378
2020,9,26,3,16175,16323,13977,-2346
2020,9,26,4,15145,15296,12789,-2507
2020,9,26,5,14145,14465,11159,-3306
2020,9,26,6,13559,13837,10713,-3124
2020,9,26,7,13122,13407,10728,-2679
2020,9,26,8,12873,13150,10629,-2521
2020,9,26,9,12793,13068,10600,-2468
2020,9,26,10,12959,13249,10789,-2460
2020,9,26,11,13450,13679,10964,-2715
2020,9,26,12,14034,14135,11368,-2767
2020,9,26,13,14892,14781,12756,-2025
2020,9,26,14,15473,15281,13298,-1983
2020,9,26,15,15869,15573,13446,-2127
2020,9,26,16,16192,15916,13283,-2633
2020,9,26,17,16455,16157,13013,-3144
2020,9,26,18,16582,16341,13013,-3328
2020,9,26,19,16731,16608,13380,-3228
2020,9,26,20,16874,16983,13721,-3262
2020,9,26,21,17107,17379,14016,-3363
2020,9,26,22,17438,17695,14284,-3411
2020,9,26,23,17743,17813,14377,-3436
2020,9,27,0,17714,18037,14593,-3444
2020,9,27,1,17304,17660,14491,-3169
2020,9,27,2,16714,17083,14094,-2989
2020,9,27,3,15940,16348,13672,-2676
2020,9,27,4,15016,15488,13080,-2408
2020,9,27,5,14337,14721,11427,-3294
2020,9,27,6,13740,14088,11183,-2905
2020,9,27,7,13306,13658,10733,-2925
2020,9,27,8,13055,13408,10640,-2768
2020,9,27,9,12933,13294,10502,-2792
2020,9,27,10,13007,13391,10767,-2624
2020,9,27,11,13328,13688,10960,-2728
2020,9,27,12,13786,14015,11205,-2810
2020,9,27,13,14670,14785,12242,-2543
2020,9,27,14,15475,15570,13107,-2463
2020,9,27,15,16145,16199,13917,-2282
2020,9,27,16,16706,16747,14289,-2458
2020,9,27,17,17273,17345,14959,-2386
2020,9,27,18,17596,17738,14836,-2902
2020,9,27,19,17893,18074,15123,-2951
2020,9,27,20,18196,18492,15415,-3077
2020,9,27,21,18604,19046,15843,-3203
2020,9,27,22,19033,19368,16186,-3182
2020,9,27,23,19197,19495,16276,-3219
2020,9,28,0,19246,19704,16918,-2786
2020,9,28,1,18759,19267,16604,-2663
2020,9,28,2,17858,18477,15592,-2885
2020,9,28,3,16748,17562,14620,-2942
2020,9,28,4,15592,16499,13734,-2765
2020,9,28,5,14987,15667,13226,-2441
2020,9,28,6,14406,15013,12704,-2309
2020,9,28,7,14037,14623,12207,-2416
2020,9,28,8,13878,14451,11904,-2547
2020,9,28,9,13992,14541,12321,-2220
2020,9,28,10,14676,15162,12729,-2433
2020,9,28,11,16053,16383,14205,-2178
2020,9,28,12,17233,17397,14922,-2475
2020,9,28,13,18163,18215,15790,-2425
2020,9,28,14,18716,18782,16393,-2389
2020,9,28,15,19143,19139,16509,-2630
2020,9,28,16,19507,19525,16661,-2864
2020,9,28,17,19737,19871,17359,-2512
2020,9,28,18,19877,20187,17709,-2478
2020,9,28,19,19926,20362,18007,-2355
2020,9,28,20,20045,20560,18555,-2005
2020,9,28,21,20279,20799,18686,-2113
2020,9,28,22,20556,20901,18939,-1962
2020,9,28,23,20496,20501,18881,-1620
2020,9,29,0,20432,20484,18832,-1652
2020,9,29,1,19660,19806,18146,-1660
2020,9,29,2,18629,18788,16808,-1980
2020,9,29,3,17404,17667,15721,-1946
2020,9,29,4,16163,16483,14883,-1600
2020,9,29,5,15333,15548,13879,-1669
2020,9,29,6,14704,14867,13202,-1665
2020,9,29,7,14282,14394,12767,-1627
2020,9,29,8,14089,14114,12433,-1681
2020,9,29,9,14155,14170,12249,-1921
2020,9,29,10,14751,14836,13050,-1786
2020,9,29,11,16080,16221,13874,-2347
2020,9,29,12,17187,17349,14985,-2364
2020,9,29,13,17950,18084,16028,-2056
2020,9,29,14,18350,18631,16283,-2348
2020,9,29,15,18643,19039,16605,-2434
2020,9,29,16,18892,19338,16991,-2347
2020,9,29,17,19033,19442,16948,-2494
2020,9,29,18,19096,19534,16845,-2689
2020,9,29,19,19081,19535,17152,-2383
2020,9,29,20,19213,19441,16824,-2617
2020,9,29,21,19440,19478,16956,-2522
2020,9,29,22,19728,19642,17052,-2590
2020,9,29,23,19718,19634,16956,-2678
2020,9,30,0,19698,19514,17350,-2164
2020,9,30,1,19024,18881,16397,-2484
2020,9,30,2,18059,17912,15559,-2353
2020,9,30,3,16976,17034,14748,-2286
2020,9,30,4,15879,16214,14022,-2192
2020,9,30,5,15014,15377,12934,-2443
2020,9,30,6,14434,14732,12106,-2626
2020,9,30,7,14066,14340,11903,-2437
2020,9,30,8,13894,14195,11866,-2329
2020,9,30,9,13950,14068,11982,-2086
2020,9,30,10,14468,14343,11853,-2490
2020,9,30,11,15535,15419,12969,-2450
2020,9,30,12,16438,16415,14284,-2131
2020,9,30,13,16983,17040,15487,-1553
2020,9,30,14,17206,17206,15698,-1508
2020,9,30,15,17197,17174,15616,-1558
2020,9,30,16,17113,17092,16131,-961
2020,9,30,17,16971,17045,16141,-904
2020,9,30,18,16911,17107,16127,-980
2020,9,30,19,16863,17182,16150,-1032
2020,9,30,20,16954,17296,16121,-1175
2020,9,30,21,17198,17561,16482,-1079
2020,9,30,22,17490,17830,16456,-1374
2020,9,30,23,17545,17797,16474,-1323
2020,10,1,0,17603,17880,16566,-1314
2020,10,1,1,17017,17203,16090,-1113
2020,10,1,2,16230,16349,15315,-1034
2020,10,1,3,15310,15385,14158,-1227
2020,10,1,4,14411,14457,13250,-1207
2020,10,1,5,13668,13770,12259,-1511
2020,10,1,6,13176,13221,11822,-1399
2020,10,1,7,12895,12901,11462,-1439
2020,10,1,8,12798,12758,11308,-1450
2020,10,1,9,12921,12848,11334,-1514
2020,10,1,10,13504,13472,11891,-1581
2020,10,1,11,14572,14672,13263,-1409
2020,10,1,12,15516,15613,14477,-1136
2020,10,1,13,15926,16179,14850,-1329
2020,10,1,14,16045,16373,15013,-1360
2020,10,1,15,16073,16525,15181,-1344
2020,10,1,16,16133,16805,15365,-1440
2020,10,1,17,16148,16947,15532,-1415
2020,10,1,18,16196,17070,15532,-1538
2020,10,1,19,16231,17159,15764,-1395
2020,10,1,20,16388,17188,15779,-1409
2020,10,1,21,16662,17338,15816,-1522
2020,10,1,22,16945,17548,15916,-1632
2020,10,1,23,16914,17616,15611,-2005
2020,10,2,0,17257,17764,15645,-2119
2020,10,2,1,16770,17182,15378,-1804
2020,10,2,2,16084,16336,14753,-1583
2020,10,2,3,15221,15331,14175,-1156
2020,10,2,4,14318,14393,13341,-1052
2020,10,2,5,13269,13707,12119,-1588
2020,10,2,6,12781,13157,12033,-1124
2020,10,2,7,12477,12831,11609,-1222
2020,10,2,8,12369,12662,11194,-1468
2020,10,2,9,12460,12752,11259,-1493
2020,10,2,10,13013,13339,11964,-1375
2020,10,2,11,14104,14521,12716,-1805
2020,10,2,12,15092,15638,14079,-1559
2020,10,2,13,15572,16434,14929,-1505
2020,10,2,14,15787,16821,15442,-1379
2020,10,2,15,15862,16934,15460,-1474
2020,10,2,16,15903,16969,15304,-1665
2020,10,2,17,15830,16700,14910,-1790
2020,10,2,18,15761,16430,14413,-2017
2020,10,2,19,15578,16118,14612,-1506
2020,10,2,20,15476,16162,14640,-1522
2020,10,2,21,15578,16501,14780,-1721
2020,10,2,22,15723,16745,14936,-1809
2020,10,2,23,15783,16899,15084,-1815
2020,10,3,0,16066,16964,15287,-1677
2020,10,3,1,15691,16450,14865,-1585
2020,10,3,2,15154,15703,14388,-1315
2020,10,3,3,14471,14855,13605,-1250
2020,10,3,4,13687,13968,12981,-987
2020,10,3,5,12986,13237,11909,-1328
2020,10,3,6,12481,12753,11563,-1190
2020,10,3,7,12172,12436,11346,-1090
2020,10,3,8,12021,12290,11147,-1143
2020,10,3,9,12008,12290,11379,-911
2020,10,3,10,12229,12518,11478,-1040
2020,10,3,11,12569,13005,11981,-1024
2020,10,3,12,13060,13476,12456,-1020
2020,10,3,13,13563,14046,13021,-1025
2020,10,3,14,13868,14289,12987,-1302
2020,10,3,15,13936,14312,12828,-1484
2020,10,3,16,13934,14388,12860,-1528
2020,10,3,17,13845,14440,12821,-1619
2020,10,3,18,13713,14390,12940,-1450
2020,10,3,19,13666,14360,12787,-1573
2020,10,3,20,13849,14475,12787,-1688
2020,10,3,21,14218,14857,12928,-1929
2020,10,3,22,14492,15354,13243,-2111
2020,10,3,23,14763,15836,13567,-2269
2020,10,4,0,15221,16142,14402,-1740
2020,10,4,1,15035,15782,13999,-1783
2020,10,4,2,14677,15217,13731,-1486
2020,10,4,3,14166,14533,13086,-1447
2020,10,4,4,13497,13804,12719,-1085
2020,10,4,5,12841,13178,11728,-1450
2020,10,4,6,12392,12694,11576,-1118
2020,10,4,7,12062,12404,11475,-929
2020,10,4,8,11878,12249,11253,-996
2020,10,4,9,11817,12245,11115,-1130
2020,10,4,10,11939,12383,11276,-1107
2020,10,4,11,12115,12765,11609,-1156
2020,10,4,12,12422,13124,12063,-1061
2020,10,4,13,12907,13619,12643,-976
2020,10,4,14,13252,13957,12932,-1025
2020,10,4,15,13430,14083,13076,-1007
2020,10,4,16,13577,14323,12880,-1443
2020,10,4,17,13656,14516,12768,-1748
2020,10,4,18,13698,14437,12705,-1732
2020,10,4,19,13761,14406,12823,-1583
2020,10,4,20,14012,14584,13129,-1455
2020,10,4,21,14467,15077,13705,-1372
2020,10,4,22,14805,15583,13991,-1592
2020,10,4,23,15101,16083,14491,-1592
2020,10,5,0,15593,16335,14818,-1517
2020,10,5,1,15275,15909,14635,-1274
2020,10,5,2,14651,15221,14282,-939
2020,10,5,3,13907,14408,13510,-898
2020,10,5,4,13109,13557,12713,-844
2020,10,5,5,12568,12929,12028,-901
2020,10,5,6,12190,12522,11851,-671
2020,10,5,7,11943,12318,11622,-696
2020,10,5,8,11864,12228,11466,-762
2020,10,5,9,12038,12397,11514,-883
2020,10,5,10,12741,13060,12341,-719
2020,10,5,11,14048,14382,13326,-1056
2020,10,5,12,15138,15531,14308,-1223
2020,10,5,13,15746,16219,14542,-1677
2020,10,5,14,15943,16431,14397,-2034
2020,10,5,15,15962,16507,14434,-2073
2020,10,5,16,16011,16617,14701,-1916
2020,10,5,17,15981,16597,14748,-1849
2020,10,5,18,15992,16625,14732,-1893
2020,10,5,19,15953,16712,14822,-1890
2020,10,5,20,16047,16747,14818,-1929
2020,10,5,21,16312,17005,14652,-2353
2020,10,5,22,16615,17294,14873,-2421
2020,10,5,23,16875,17454,15085,-2369
2020,10,6,0,17094,17526,15298,-2228
2020,10,6,1,16536,16924,15084,-1840
2020,10,6,2,15674,16041,14593,-1448
2020,10,6,3,14665,15020,14200,-820
2020,10,6,4,13708,14034,13111,-923
2020,10,6,5,13066,13403,11989,-1414
2020,10,6,6,12610,12960,11627,-1333
2020,10,6,7,12294,12718,11446,-1272
2020,10,6,8,12174,12621,11355,-1266
2020,10,6,9,12304,12747,11480,-1267
2020,10,6,10,12962,13391,12178,-1213
2020,10,6,11,14267,14717,13110,-1607
2020,10,6,12,15325,15705,13831,-1874
2020,10,6,13,15871,16145,14503,-1642
2020,10,6,14,16036,16286,14135,-2151
2020,10,6,15,16044,16310,14166,-2144
2020,10,6,16,16119,16396,14316,-2080
2020,10,6,17,16117,16373,14445,-1928
2020,10,6,18,16153,16299,14476,-1823
2020,10,6,19,16110,16235,14626,-1609
2020,10,6,20,16202,16358,14754,-1604
2020,10,6,21,16457,16717,15209,-1508
2020,10,6,22,16705,17137,15354,-1783
2020,10,6,23,16939,17386,15577,-1809
2020,10,7,0,17145,17530,16061,-1469
2020,10,7,1,16579,16924,15742,-1182
2020,10,7,2,15708,16049,15237,-812
2020,10,7,3,14684,15058,14265,-793
2020,10,7,4,13728,14119,13223,-896
2020,10,7,5,13059,13395,12057,-1338
2020,10,7,6,12603,12950,11556,-1394
2020,10,7,7,12298,12669,11243,-1426
2020,10,7,8,12172,12510,11237,-1273
2020,10,7,9,12281,12654,11374,-1280
2020,10,7,10,12906,13310,11870,-1440
2020,10,7,11,14200,14576,13086,-1490
2020,10,7,12,15301,15615,13995,-1620
2020,10,7,13,15944,16242,14358,-1884
2020,10,7,14,16223,16541,14583,-1958
2020,10,7,15,16373,16740,14725,-2015
2020,10,7,16,16549,16943,14905,-2038
2020,10,7,17,16624,17155,14859,-2296
2020,10,7,18,16696,17226,14950,-2276
2020,10,7,19,16675,17157,15076,-2081
2020,10,7,20,16728,17054,15234,-1820
2020,10,7,21,16954,17176,15571,-1605
2020,10,7,22,17186,17413,15178,-2235
2020,10,7,23,17264,17496,15453,-2043
2020,10,8,0,17373,17446,15644,-1802
2020,10,8,1,16723,16757,14828,-1929
2020,10,8,2,15830,15854,14206,-1648
2020,10,8,3,14771,14903,13259,-1644
2020,10,8,4,13763,14020,12558,-1462
2020,10,8,5,13031,13201,11666,-1535
2020,10,8,6,12573,12696,10975,-1721
2020,10,8,7,12270,12383,10642,-1741
2020,10,8,8,12156,12258,10504,-1754
2020,10,8,9,12268,12392,10796,-1596
2020,10,8,10,12889,13065,11516,-1549
2020,10,8,11,14195,14323,12884,-1439
2020,10,8,12,15222,15267,14359,-908
2020,10,8,13,15689,15733,14688,-1045
2020,10,8,14,15775,15816,14498,-1318
2020,10,8,15,15735,15858,14525,-1333
2020,10,8,16,15784,15843,14744,-1099
2020,10,8,17,15730,15814,14657,-1157
2020,10,8,18,15704,15807,14712,-1095
2020,10,8,19,15677,15838,14479,-1359
2020,10,8,20,15767,15948,14728,-1220
2020,10,8,21,16048,16282,14942,-1340
2020,10,8,22,16383,16731,15181,-1550
2020,10,8,23,16763,16998,15207,-1791
2020,10,9,0,16920,17154,15323,-1831
2020,10,9,1,16460,16567,14767,-1800
2020,10,9,2,15651,15779,14335,-1444
2020,10,9,3,14622,14817,13638,-1179
2020,10,9,4,13630,13862,12541,-1321
2020,10,9,5,12882,13150,11856,-1294
2020,10,9,6,12416,12752,11342,-1410
2020,10,9,7,12151,12478,10910,-1568
2020,10,9,8,12039,12385,10732,-1653
2020,10,9,9,12183,12556,11031,-1525
2020,10,9,10,12832,13188,11815,-1373
2020,10,9,11,14103,14463,12769,-1694
2020,10,9,12,15054,15502,13795,-1707
2020,10,9,13,15568,15810,13924,-1886
2020,10,9,14,15640,15830,13664,-2166
2020,10,9,15,15590,15583,13597,-1986
2020,10,9,16,15603,15617,13799,-1818
2020,10,9,17,15509,15608,13623,-1985
2020,10,9,18,15453,15658,13464,-2194
2020,10,9,19,15373,15720,13617,-2103
2020,10,9,20,15379,15883,13759,-2124
2020,10,9,21,15587,16244,14205,-2039
2020,10,9,22,15817,16627,14256,-2371
2020,10,9,23,16042,16910,14829,-2081
2020,10,10,0,16078,16999,15174,-1825
2020,10,10,1,15591,16461,15105,-1356
2020,10,10,2,14969,15760,14323,-1437
2020,10,10,3,14226,14957,13133,-1824
2020,10,10,4,13440,14085,12232,-1853
2020,10,10,5,12869,13358,12123,-1235
2020,10,10,6,12454,12853,11847,-1006
2020,10,10,7,12165,12542,11723,-819
2020,10,10,8,12009,12373,11580,-793
2020,10,10,9,12004,12370,11616,-754
2020,10,10,10,12198,12610,11676,-934
2020,10,10,11,12673,13125,12193,-932
2020,10,10,12,13221,13616,12566,-1050
2020,10,10,13,13924,14170,12891,-1279
2020,10,10,14,14324,14488,13225,-1263
2020,10,10,15,14553,14644,13527,-1117
2020,10,10,16,14788,14755,13459,-1296
2020,10,10,17,14970,14848,13233,-1615
2020,10,10,18,15016,14808,13275,-1533
2020,10,10,19,15133,14952,13835,-1117
2020,10,10,20,15370,15185,13902,-1283
2020,10,10,21,15795,15519,14767,-752
2020,10,10,22,16181,15947,14777,-1170
2020,10,10,23,16487,16526,15112,-1414
2020,10,11,0,16590,16633,15172,-1461
2020,10,11,1,16107,16183,14709,-1474
2020,10,11,2,15590,15610,14045,-1565
2020,10,11,3,14986,14872,13632,-1240
2020,10,11,4,14305,14178,12803,-1375
2020,10,11,5,13490,13506,11900,-1606
2020,10,11,6,13044,13000,11476,-1524
2020,10,11,7,12659,12678,11050,-1628
2020,10,11,8,12410,12480,10779,-1701
2020,10,11,9,12312,12404,10865,-1539
2020,10,11,10,12357,12496,10916,-1580
2020,10,11,11,12573,12855,11691,-1164
2020,10,11,12,12937,13205,11833,-1372
2020,10,11,13,13543,13612,12243,-1369
2020,10,11,14,14011,13919,12351,-1568
2020,10,11,15,14257,14161,12509,-1652
2020,10,11,16,14425,14185,12346,-1839
2020,10,11,17,14528,14206,12196,-2010
2020,10,11,18,14498,14245,12186,-2059
2020,10,11,19,14476,14304,12400,-1904
2020,10,11,20,14546,14498,12731,-1767
2020,10,11,21,14843,14968,13371,-1597
2020,10,11,22,15255,15508,13678,-1830
2020,10,11,23,16035,16086,14085,-2001
2020,10,12,0,16122,16201,14435,-1766
2020,10,12,1,15645,15811,14085,-1726
2020,10,12,2,14939,15229,13357,-1872
2020,10,12,3,14091,14492,12726,-1766
2020,10,12,4,13214,13716,12109,-1607
2020,10,12,5,12707,13113,11577,-1536
2020,10,12,6,12358,12681,11310,-1371
2020,10,12,7,12143,12396,11217,-1179
2020,10,12,8,12066,12286,11215,-1071
2020,10,12,9,12208,12428,11280,-1148
2020,10,12,10,12613,12949,11435,-1514
2020,10,12,11,13353,13893,12543,-1350
2020,10,12,12,14207,14899,13481,-1418
2020,10,12,13,15043,15743,13930,-1813
2020,10,12,14,15616,16284,14352,-1932
2020,10,12,15,15892,16581,14530,-2051
2020,10,12,16,16113,16737,14395,-2342
2020,10,12,17,16152,16698,14513,-2185
2020,10,12,18,16174,16606,14632,-1974
2020,10,12,19,16166,16527,14787,-1740
2020,10,12,20,16190,16561,14725,-1836
2020,10,12,21,16463,16849,14941,-1908
2020,10,12,22,16800,17212,15110,-2102
2020,10,12,23,17066,17533,15528,-2005
2020,10,13,0,17180,17374,15704,-1670
2020,10,13,1,16379,16737,14964,-1773
2020,10,13,2,15477,15910,14219,-1691
2020,10,13,3,14535,14894,13418,-1476
2020,10,13,4,13660,13919,12795,-1124
2020,10,13,5,12958,13245,11890,-1355
2020,10,13,6,12515,12789,11783,-1006
2020,10,13,7,12269,12548,11600,-948
2020,10,13,8,12189,12449,11447,-1002
2020,10,13,9,12371,12599,11379,-1220
2020,10,13,10,13042,13253,11712,-1541
2020,10,13,11,14404,14539,13185,-1354
2020,10,13,12,15561,15716,14300,-1416
2020,10,13,13,16247,16499,14496,-2003
2020,10,13,14,16600,16941,14722,-2219
2020,10,13,15,16813,17071,14503,-2568
2020,10,13,16,16991,17096,14561,-2535
2020,10,13,17,16988,17043,14364,-2679
2020,10,13,18,16947,16902,14078,-2824
2020,10,13,19,16707,16754,14052,-2702
2020,10,13,20,16664,16634,14136,-2498
2020,10,13,21,16856,16830,14240,-2590
2020,10,13,22,17056,17164,14285,-2879
2020,10,13,23,17334,17500,14468,-3032
2020,10,14,0,17311,17406,14661,-2745
2020,10,14,1,16555,16768,13868,-2900
2020,10,14,2,15647,15983,13367,-2616
2020,10,14,3,14617,14953,13426,-1527
2020,10,14,4,13662,14029,12551,-1478
2020,10,14,5,12892,13329,11342,-1987
2020,10,14,6,12466,12859,11074,-1785
2020,10,14,7,12196,12597,11035,-1562
2020,10,14,8,12100,12489,10844,-1645
2020,10,14,9,12262,12647,11174,-1473
2020,10,14,10,12929,13345,11721,-1624
2020,10,14,11,14288,14595,12899,-1696
2020,10,14,12,15313,15612,14154,-1458
2020,10,14,13,15667,16026,14251,-1775
2020,10,14,14,15641,15918,13889,-2029
2020,10,14,15,15560,15803,13704,-2099
2020,10,14,16,15532,15769,13771,-1998
2020,10,14,17,15509,15770,13982,-1788
2020,10,14,18,15551,15789,13974,-1815
2020,10,14,19,15567,15838,13891,-1947
2020,10,14,20,15721,15977,14454,-1523
2020,10,14,21,16126,16363,14661,-1702
2020,10,14,22,16600,16852,14819,-2033
2020,10,14,23,17060,17337,14882,-2455
2020,10,15,0,17014,17366,15260,-2106
2020,10,15,1,16453,16766,14796,-1970
2020,10,15,2,15624,15991,14231,-1760
2020,10,15,3,14611,14989,12927,-2062
2020,10,15,4,13656,14035,12019,-2016
2020,10,15,5,12920,13287,10953,-2334
2020,10,15,6,12479,12841,10783,-2058
2020,10,15,7,12200,12578,10796,-1782
2020,10,15,8,12102,12501,10921,-1580
2020,10,15,9,12259,12651,11193,-1458
2020,10,15,10,12898,13291,11644,-1647
2020,10,15,11,14269,14635,13030,-1605
2020,10,15,12,15356,15701,14104,-1597
2020,10,15,13,15861,16187,14229,-1958
2020,10,15,14,15991,16287,13961,-2326
2020,10,15,15,16018,16274,13638,-2636
2020,10,15,16,16060,16356,13626,-2730
2020,10,15,17,16099,16399,13722,-2677
2020,10,15,18,16156,16486,13789,-2697
2020,10,15,19,16216,16599,13736,-2863
2020,10,15,20,16391,16755,14112,-2643
2020,10,15,21,16743,17075,14602,-2473
2020,10,15,22,17124,17398,14943,-2455
2020,10,15,23,17454,17694,15211,-2483
2020,10,16,0,17370,17590,15449,-2141
2020,10,16,1,16749,16962,14953,-2009
2020,10,16,2,15918,16179,14424,-1755
2020,10,16,3,14939,15175,13502,-1673
2020,10,16,4,13987,14237,11822,-2415
2020,10,16,5,13125,13558,10850,-2708
2020,10,16,6,12705,13061,10538,-2523
2020,10,16,7,12429,12771,10429,-2342
2020,10,16,8,12324,12652,10538,-2114
2020,10,16,9,12465,12791,10569,-2222
2020,10,16,10,13071,13427,10897,-2530
2020,10,16,11,14351,14743,12047,-2696
2020,10,16,12,15490,15844,13860,-1984
2020,10,16,13,16065,16599,14323,-2276
2020,10,16,14,16361,16993,14671,-2322
2020,10,16,15,16509,17264,15001,-2263
2020,10,16,16,16514,17390,15100,-2290
2020,10,16,17,16468,17390,15075,-2315
2020,10,16,18,16394,17349,15033,-2316
2020,10,16,19,16259,17190,14686,-2504
2020,10,16,20,16157,17048,14596,-2452
2020,10,16,21,16275,17077,14731,-2346
2020,10,16,22,16455,17264,14754,-2510
2020,10,16,23,16786,17411,15060,-2351
2020,10,17,0,16628,17176,14894,-2282
2020,10,17,1,15923,16572,14250,-2322
2020,10,17,2,15261,15905,13819,-2086
2020,10,17,3,14492,15057,13513,-1544
2020,10,17,4,13688,14193,12184,-2009
2020,10,17,5,13005,13564,10661,-2903
2020,10,17,6,12542,13066,10302,-2764
2020,10,17,7,12297,12720,10154,-2566
2020,10,17,8,12219,12571,10040,-2531
2020,10,17,9,12271,12609,9911,-2698
2020,10,17,10,12497,12888,10116,-2772
2020,10,17,11,12986,13482,10631,-2851
2020,10,17,12,13555,14104,11388,-2716
2020,10,17,13,13936,14503,11695,-2808
2020,10,17,14,14006,14550,11898,-2652
2020,10,17,15,13843,14458,11551,-2907
2020,10,17,16,13640,14337,11565,-2772
2020,10,17,17,13454,14214,11680,-2534
2020,10,17,18,13319,14077,11624,-2453
2020,10,17,19,13313,13971,11879,-2092
2020,10,17,20,13524,14072,12201,-1871
2020,10,17,21,14046,14531,12755,-1776
2020,10,17,22,14661,15188,13372,-1816
2020,10,17,23,15387,15995,13624,-2371
2020,10,18,0,15497,16182,13552,-2630
2020,10,18,1,15173,15852,13468,-2384
2020,10,18,2,14776,15387,12962,-2425
2020,10,18,3,14220,14763,12451,-2312
2020,10,18,4,13592,13999,11450,-2549
2020,10,18,5,12978,13398,10676,-2722
2020,10,18,6,12548,12940,10435,-2505
2020,10,18,7,12276,12623,10202,-2421
2020,10,18,8,12146,12480,10245,-2235
2020,10,18,9,12135,12478,10612,-1866
2020,10,18,10,12258,12664,10633,-2031
2020,10,18,11,12580,13086,11007,-2079
2020,10,18,12,12957,13512,11422,-2090
2020,10,18,13,13309,14006,11977,-2029
2020,10,18,14,13501,14210,12140,-2070
2020,10,18,15,13549,14342,11873,-2469
2020,10,18,16,13555,14312,11736,-2576
2020,10,18,17,13578,14335,11972,-2363
2020,10,18,18,13619,14357,12240,-2117
2020,10,18,19,13722,14425,12420,-2005
2020,10,18,20,13992,14630,12564,-2066
2020,10,18,21,14528,15080,13444,-1636
2020,10,18,22,15146,15653,13625,-2028
2020,10,18,23,15761,16368,14350,-2018
2020,10,19,0,15894,16385,14816,-1569
2020,10,19,1,15377,15920,14281,-1639
2020,10,19,2,14723,15251,13472,-1779
2020,10,19,3,13948,14434,12558,-1876
2020,10,19,4,13180,13619,11919,-1700
2020,10,19,5,12694,12944,11225,-1719
2020,10,19,6,12328,12544,10853,-1691
2020,10,19,7,12105,12316,10880,-1436
2020,10,19,8,12040,12226,10437,-1789
2020,10,19,9,12238,12425,10738,-1687
2020,10,19,10,12936,13139,11132,-2007
2020,10,19,11,14310,14498,12107,-2391
2020,10,19,12,15480,15677,13314,-2363
2020,10,19,13,16046,16286,13797,-2489
2020,10,19,14,16235,16535,13912,-2623
2020,10,19,15,16305,16740,14074,-2666
2020,10,19,16,16348,16927,14372,-2555
2020,10,19,17,16359,17058,14680,-2378
2020,10,19,18,16346,16976,14383,-2593
2020,10,19,19,16308,16871,14381,-2490
2020,10,19,20,16369,16872,14351,-2521
2020,10,19,21,16622,17113,14519,-2594
2020,10,19,22,17051,17458,14631,-2827
2020,10,19,23,17548,17812,15007,-2805
2020,10,20,0,17415,17469,15178,-2291
2020,10,20,1,16684,16822,14724,-2098
2020,10,20,2,15812,15953,14097,-1856
2020,10,20,3,14792,14929,13122,-1807
2020,10,20,4,13847,14020,12009,-2011
2020,10,20,5,13073,13310,10821,-2489
2020,10,20,6,12613,12845,10278,-2567
2020,10,20,7,12322,12593,9910,-2683
2020,10,20,8,12220,12511,9861,-2650
2020,10,20,9,12385,12614,10274,-2340
2020,10,20,10,13046,13300,10670,-2630
2020,10,20,11,14454,14653,11641,-3012
2020,10,20,12,15690,15921,13327,-2594
2020,10,20,13,16326,16622,14037,-2585
2020,10,20,14,16690,16994,14386,-2608
2020,10,20,15,16913,17190,14648,-2542
2020,10,20,16,17060,17331,14777,-2554
2020,10,20,17,17056,17296,15044,-2252
2020,10,20,18,17044,17243,14707,-2536
2020,10,20,19,16957,17206,14441,-2765
2020,10,20,20,16970,17282,14892,-2390
2020,10,20,21,17173,17502,15163,-2339
2020,10,20,22,17484,17769,15366,-2403
2020,10,20,23,17900,18052,15812,-2240
2020,10,21,0,17675,17741,15333,-2408
2020,10,21,1,16938,17091,14747,-2344
2020,10,21,2,16051,16273,13984,-2289
2020,10,21,3,15017,15272,12981,-2291
2020,10,21,4,14045,14321,11567,-2754
2020,10,21,5,13199,13597,10901,-2696
2020,10,21,6,12753,13141,10388,-2753
2020,10,21,7,12478,12843,10062,-2781
2020,10,21,8,12379,12684,10027,-2657
2020,10,21,9,12550,12788,10196,-2592
2020,10,21,10,13222,13428,10754,-2674
2020,10,21,11,14679,14731,11964,-2767
2020,10,21,12,15976,15964,13140,-2824
2020,10,21,13,16713,16675,13730,-2945
2020,10,21,14,17113,16992,13990,-3002
2020,10,21,15,17360,17111,14112,-2999
2020,10,21,16,17537,17150,14391,-2759
2020,10,21,17,17584,17066,13423,-3643
2020,10,21,18,17603,17155,14015,-3140
2020,10,21,19,17543,17175,13991,-3184
2020,10,21,20,17585,17378,14642,-2736
2020,10,21,21,17805,17601,15515,-2086
2020,10,21,22,18098,17895,15766,-2129
2020,10,21,23,18460,18200,16486,-1714
2020,10,22,0,18133,17931,16377,-1554
2020,10,22,1,17360,17238,15817,-1421
2020,10,22,2,16457,16429,14341,-2088
2020,10,22,3,15343,15380,13363,-2017
2020,10,22,4,14280,14445,12335,-2110
2020,10,22,5,13406,13694,11221,-2473
2020,10,22,6,12935,13222,10789,-2433
2020,10,22,7,12650,12925,10332,-2593
2020,10,22,8,12546,12794,9988,-2806
2020,10,22,9,12690,12928,10211,-2717
2020,10,22,10,13337,13574,10846,-2728
2020,10,22,11,14774,14940,12046,-2894
2020,10,22,12,16003,16101,13504,-2597
2020,10,22,13,16651,16809,14223,-2586
2020,10,22,14,16907,17149,14716,-2433
2020,10,22,15,17013,17279,14750,-2529
2020,10,22,16,17099,17390,14813,-2577
2020,10,22,17,17164,17353,14442,-2911
2020,10,22,18,17232,17349,14687,-2662
2020,10,22,19,17310,17338,14919,-2419
2020,10,22,20,17426,17377,15141,-2236
2020,10,22,21,17627,17577,15404,-2173
2020,10,22,22,17864,17890,15531,-2359
2020,10,22,23,18235,18222,16074,-2148
2020,10,23,0,17888,18017,16288,-1729
2020,10,23,1,17149,17400,15388,-2012
2020,10,23,2,16286,16517,13957,-2560
2020,10,23,3,15195,15596,12664,-2932
2020,10,23,4,14156,14705,12082,-2623
2020,10,23,5,13393,13860,11643,-2217
2020,10,23,6,12947,13292,10770,-2522
2020,10,23,7,12670,12925,10495,-2430
2020,10,23,8,12551,12792,10294,-2498
2020,10,23,9,12684,12927,10449,-2478
2020,10,23,10,13294,13553,10964,-2589
2020,10,23,11,14593,14808,12159,-2649
2020,10,23,12,15791,16033,13364,-2669
2020,10,23,13,16487,16726,13930,-2796
2020,10,23,14,16770,17013,14316,-2697
2020,10,23,15,16910,17112,14534,-2578
2020,10,23,16,16911,17093,14444,-2649
2020,10,23,17,16825,17063,14392,-2671
2020,10,23,18,16751,17137,14653,-2484
2020,10,23,19,16681,17146,14726,-2420
2020,10,23,20,16659,17185,14649,-2536
2020,10,23,21,16785,17362,14824,-2538
2020,10,23,22,16930,17583,15078,-2505
2020,10,23,23,17254,17837,15939,-1898
2020,10,24,0,16804,17539,15640,-1899
2020,10,24,1,16149,16926,14742,-2184
2020,10,24,2,15519,16243,14188,-2055
2020,10,24,3,14734,15414,13201,-2213
2020,10,24,4,13880,14551,12294,-2257
2020,10,24,5,13240,13817,11410,-2407
2020,10,24,6,12812,13253,10993,-2260
2020,10,24,7,12467,12842,10471,-2371
2020,10,24,8,12292,12615,10275,-2340
2020,10,24,9,12261,12561,10286,-2275
2020,10,24,10,12430,12743,10531,-2212
2020,10,24,11,12903,13242,11088,-2154
2020,10,24,12,13656,13830,12140,-1690
2020,10,24,13,14409,14514,12349,-2165
2020,10,24,14,14987,15130,12998,-2132
2020,10,24,15,15314,15536,13420,-2116
2020,10,24,16,15324,15713,13674,-2039
2020,10,24,17,15340,15636,13710,-1926
2020,10,24,18,15226,15374,13516,-1858
2020,10,24,19,15138,15279,13262,-2017
2020,10,24,20,15137,15363,13493,-1870
2020,10,24,21,15326,15596,14069,-1527
2020,10,24,22,15667,16002,14113,-1889
2020,10,24,23,16402,16446,14217,-2229
2020,10,25,0,16192,16282,14522,-1760
2020,10,25,1,15735,15833,13928,-1905
2020,10,25,2,15161,15234,13570,-1664
2020,10,25,3,14471,14564,13070,-1494
2020,10,25,4,13680,13838,12099,-1739
2020,10,25,5,12868,13197,11101,-2096
2020,10,25,6,12456,12726,10755,-1971
2020,10,25,7,12173,12435,10519,-1916
2020,10,25,8,12050,12283,10313,-1970
2020,10,25,9,12049,12285,10245,-2040
2020,10,25,10,12175,12480,10390,-2090
2020,10,25,11,12527,12872,11065,-1807
2020,10,25,12,13032,13407,11929,-1478
2020,10,25,13,13538,13991,12303,-1688
2020,10,25,14,13822,14304,12441,-1863
2020,10,25,15,13918,14498,12590,-1908
2020,10,25,16,13952,14679,12565,-2114
2020,10,25,17,14024,14659,12504,-2155
2020,10,25,18,14059,14624,12277,-2347
2020,10,25,19,14124,14689,12552,-2137
2020,10,25,20,14344,14962,13201,-1761
2020,10,25,21,14828,15542,13360,-2182
2020,10,25,22,15457,16181,13558,-2623
2020,10,25,23,16268,16797,14579,-2218
2020,10,26,0,16290,16672,14864,-1808
2020,10,26,1,15819,16205,14351,-1854
2020,10,26,2,15111,15577,13731,-1846
2020,10,26,3,14336,14724,13271,-1453
2020,10,26,4,13554,13891,12163,-1728
2020,10,26,5,12865,13258,11025,-2233
2020,10,26,6,12457,12826,10934,-1892
2020,10,26,7,12228,12587,10672,-1915
2020,10,26,8,12147,12495,10506,-1989
2020,10,26,9,12351,12693,10630,-2063
2020,10,26,10,13048,13416,11380,-2036
2020,10,26,11,14398,14796,12703,-2093
2020,10,26,12,15620,16125,13949,-2176
2020,10,26,13,16211,16886,14648,-2238
2020,10,26,14,16479,17337,15317,-2020
2020,10,26,15,16624,17585,15268,-2317
2020,10,26,16,16705,17741,15525,-2216
2020,10,26,17,16720,17790,15595,-2195
2020,10,26,18,16651,17722,15503,-2219
2020,10,26,19,16579,17606,15284,-2322
2020,10,26,20,16595,17579,14984,-2595
2020,10,26,21,16782,17670,15300,-2370
2020,10,26,22,17175,18006,15505,-2501
2020,10,26,23,17675,18181,15791,-2390
2020,10,27,0,17412,17808,15505,-2303
2020,10,27,1,16698,17116,14598,-2518
2020,10,27,2,15769,16275,13937,-2338
2020,10,27,3,14741,15243,12898,-2345
2020,10,27,4,13830,14247,12371,-1876
2020,10,27,5,13160,13535,10897,-2638
2020,10,27,6,12702,13047,10476,-2571
2020,10,27,7,12421,12809,10401,-2408
2020,10,27,8,12308,12742,10197,-2545
2020,10,27,9,12477,12907,10365,-2542
2020,10,27,10,13119,13583,11195,-2388
2020,10,27,11,14456,14861,11805,-3056
2020,10,27,12,15630,16108,13312,-2796
2020,10,27,13,16059,16807,14299,-2508
2020,10,27,14,16157,17157,14679,-2478
2020,10,27,15,16123,17146,14705,-2441
2020,10,27,16,16098,16804,14632,-2172
2020,10,27,17,16076,16643,14389,-2254
2020,10,27,18,16090,16685,14315,-2370
2020,10,27,19,16138,16817,15000,-1817
2020,10,27,20,16274,16894,14555,-2339
2020,10,27,21,16568,17204,14878,-2326
2020,10,27,22,17036,17704,15048,-2656
2020,10,27,23,17586,18054,15775,-2279
2020,10,28,0,17376,17727,15765,-1962
2020,10,28,1,16752,17070,15094,-1976
2020,10,28,2,15893,16261,14124,-2137
2020,10,28,3,14862,15270,13085,-2185
2020,10,28,4,13933,14321,12097,-2224
2020,10,28,5,13290,13591,10766,-2825
2020,10,28,6,12854,13114,10133,-2981
2020,10,28,7,12579,12808,9866,-2942
2020,10,28,8,12476,12710,9848,-2862
2020,10,28,9,12655,12874,9890,-2984
2020,10,28,10,13292,13588,10725,-2863
2020,10,28,11,14618,14872,11923,-2949
2020,10,28,12,15806,16112,13457,-2655
2020,10,28,13,16247,16939,13833,-3106
2020,10,28,14,16352,17380,14223,-3157
2020,10,28,15,16294,17638,14600,-3038
2020,10,28,16,16224,17756,14657,-3099
2020,10,28,17,16141,17650,14226,-3424
2020,10,28,18,16118,17492,14072,-3420
2020,10,28,19,16097,17189,14182,-3007
2020,10,28,20,16197,17023,13974,-3049
2020,10,28,21,16526,17167,14175,-2992
2020,10,28,22,17081,17626,14512,-3114
2020,10,28,23,17539,18101,15342,-2759
2020,10,29,0,17299,17764,15432,-2332
2020,10,29,1,16755,17135,14447,-2688
2020,10,29,2,15966,16329,13876,-2453
2020,10,29,3,14936,15328,13143,-2185
2020,10,29,4,13969,14350,12326,-2024
2020,10,29,5,13250,13643,11114,-2529
2020,10,29,6,12794,13190,10608,-2582
2020,10,29,7,12525,12920,10130,-2790
2020,10,29,8,12418,12809,9919,-2890
2020,10,29,9,12582,12975,10152,-2823
2020,10,29,10,13190,13630,10731,-2899
2020,10,29,11,14489,14938,12396,-2542
2020,10,29,12,15680,16262,14243,-2019
2020,10,29,13,16252,16994,14532,-2462
2020,10,29,14,16537,17439,15171,-2268
2020,10,29,15,16690,17757,15166,-2591
2020,10,29,16,16800,17996,15262,-2734
2020,10,29,17,16830,18089,15273,-2816
2020,10,29,18,16860,18041,15502,-2539
2020,10,29,19,16841,17978,15030,-2948
2020,10,29,20,16857,17961,15309,-2652
2020,10,29,21,17030,18102,15428,-2674
2020,10,29,22,17472,18446,15678,-2768
2020,10,29,23,17740,18591,15808,-2783
2020,10,30,0,17546,18157,15494,-2663
2020,10,30,1,16889,17495,15440,-2055
2020,10,30,2,16047,16699,14665,-2034
2020,10,30,3,15076,15678,13869,-1809
2020,10,30,4,14183,14718,12924,-1794
2020,10,30,5,13450,14000,11769,-2231
2020,10,30,6,13000,13534,11224,-2310
2020,10,30,7,12734,13266,10709,-2557
2020,10,30,8,12639,13180,10621,-2559
2020,10,30,9,12836,13381,10833,-2548
2020,10,30,10,13517,14083,11839,-2244
2020,10,30,11,14878,15416,13178,-2238
2020,10,30,12,16180,16771,15056,-1715
2020,10,30,13,16895,17610,16000,-1610
2020,10,30,14,17299,18071,16408,-1663
2020,10,30,15,17477,18328,16479,-1849
2020,10,30,16,17509,18461,16753,-1708
2020,10,30,17,17389,18276,16504,-1772
2020,10,30,18,17282,18064,15709,-2355
2020,10,30,19,17146,17845,15270,-2575
2020,10,30,20,17033,17695,15403,-2292
2020,10,30,21,17184,17823,15344,-2479
2020,10,30,22,17562,18293,16151,-2142
2020,10,30,23,17958,18700,16374,-2326
2020,10,31,0,17597,18385,16228,-2157
2020,10,31,1,17059,17830,15614,-2216
2020,10,31,2,16478,17195,15072,-2123
2020,10,31,3,15735,16321,14001,-2320
2020,10,31,4,14929,15461,13364,-2097
2020,10,31,5,14308,14731,11810,-2921
2020,10,31,6,13784,14238,11335,-2903
2020,10,31,7,13433,13918,11132,-2786
2020,10,31,8,13246,13789,10983,-2806
2020,10,31,9,13281,13827,11099,-2728
2020,10,31,10,13565,14134,11601,-2533
2020,10,31,11,14128,14724,12161,-2563
2020,10,31,12,14942,15384,12621,-2763
2020,10,31,13,15481,15936,13398,-2538
2020,10,31,14,15688,16045,13537,-2508
2020,10,31,15,15659,15941,13415,-2526
2020,10,31,16,15436,15774,13009,-2765
2020,10,31,17,15102,15496,13443,-2053
2020,10,31,18,14829,15276,13029,-2247
2020,10,31,19,14712,15103,12798,-2305
2020,10,31,20,14838,15149,13020,-2129
2020,10,31,21,15283,15589,13412,-2177
2020,10,31,22,15934,16304,13991,-2313
2020,10,31,23,16469,17087,14779,-2308
2020,11,1,0,16245,17032,14788,-2244
2020,11,1,1,15998,16729,14667,-2062
2020,11,1,2,15728,16269,14099,-2170
2020,11,1,3,15125,15622,13655,-1967
2020,11,1,4,14410,14882,13353,-1529
2020,11,1,5,13848,14252,12176,-2076
2020,11,1,6,13301,13780,12368,-1412
2020,11,1,7,13301,13449,11511,-1938
2020,11,1,8,12981,13279,11241,-2038
2020,11,1,9,12803,13200,10983,-2217
2020,11,1,10,12798,13246,11069,-2177
2020,11,1,11,12972,13501,11335,-2166
2020,11,1,12,13235,13895,12002,-1893
2020,11,1,13,13599,14373,12645,-1728
2020,11,1,14,14197,15007,12856,-2151
2020,11,1,15,14572,15456,12859,-2597
2020,11,1,16,14756,15614,12926,-2688
2020,11,1,17,14880,15963,13104,-2859
2020,11,1,18,14914,16478,13588,-2890
2020,11,1,19,14934,16668,13487,-3181
2020,11,1,20,15014,16713,13571,-3142
2020,11,1,21,15253,16859,14143,-2716
2020,11,1,22,16024,17262,14431,-2831
2020,11,1,23,17118,17751,14669,-3082
2020,11,2,0,16871,17714,14536,-3178
2020,11,2,1,16397,17210,14528,-2682
2020,11,2,2,15815,16621,14071,-2550
2020,11,2,3,15225,15901,13272,-2629
2020,11,2,4,14465,15140,12829,-2311
2020,11,2,5,13812,14427,12423,-2004
2020,11,2,6,13583,13868,11398,-2470
2020,11,2,7,13305,13548,11161,-2387
2020,11,2,8,13157,13397,11162,-2235
2020,11,2,9,13169,13399,11376,-2023
2020,11,2,10,13471,13694,11928,-1766
2020,11,2,11,14312,14550,12753,-1797
2020,11,2,12,15512,15938,13956,-1982
2020,11,2,13,16491,17164,15718,-1446
2020,11,2,14,17128,17760,16412,-1348
2020,11,2,15,17402,17997,16339,-1658
2020,11,2,16,17458,18066,15765,-2301
2020,11,2,17,17423,17979,15737,-2242
2020,11,2,18,17290,17865,15215,-2650
2020,11,2,19,17232,17784,15101,-2683
2020,11,2,20,17267,17873,15179,-2694
2020,11,2,21,17535,18236,15457,-2779
2020,11,2,22,18316,18968,15948,-3020
2020,11,2,23,19397,19944,16957,-2987
2020,11,3,0,19038,19754,17068,-2686
2020,11,3,1,18392,19165,16667,-2498
2020,11,3,2,17754,18403,16251,-2152
2020,11,3,3,17004,17497,15575,-1922
2020,11,3,4,15967,16337,14781,-1556
2020,11,3,5,14954,15344,13634,-1710
2020,11,3,6,14075,14624,12907,-1717
2020,11,3,7,13571,14171,12426,-1745
2020,11,3,8,13304,13936,12431,-1505
2020,11,3,9,13225,13846,12403,-1443
2020,11,3,10,13466,14080,12150,-1930
2020,11,3,11,14255,14846,13036,-1810
2020,11,3,12,15438,15999,14169,-1830
2020,11,3,13,16373,16924,15260,-1664
2020,11,3,14,17029,17368,15860,-1508
2020,11,3,15,17182,17499,16150,-1349
2020,11,3,16,17177,17601,16181,-1420
2020,11,3,17,17127,17542,16051,-1491
2020,11,3,18,17049,17409,15911,-1498
2020,11,3,19,17030,17402,15711,-1691
2020,11,3,20,17055,17432,15663,-1769
2020,11,3,21,17250,17554,15631,-1923
2020,11,3,22,17944,18128,15983,-2145
2020,11,3,23,19062,19125,16874,-2251
2020,11,4,0,18884,18993,16904,-2089
2020,11,4,1,18213,18469,16616,-1853
2020,11,4,2,17620,17770,15741,-2029
2020,11,4,3,16878,16937,14962,-1975
2020,11,4,4,15867,15990,13932,-2058
2020,11,4,5,14900,15181,13051,-2130
2020,11,4,6,14080,14547,12140,-2407
2020,11,4,7,13625,14046,11897,-2149
2020,11,4,8,13373,13784,11603,-2181
2020,11,4,9,13293,13693,11829,-1864
2020,11,4,10,13508,13935,11987,-1948
2020,11,4,11,14298,14709,12759,-1950
2020,11,4,12,15526,15954,14416,-1538
2020,11,4,13,16367,16805,15321,-1484
2020,11,4,14,16779,16919,15166,-1753
2020,11,4,15,16715,16719,14850,-1869
2020,11,4,16,16568,16581,14730,-1851
2020,11,4,17,16440,16528,14604,-1924
2020,11,4,18,16331,16481,14407,-2074
2020,11,4,19,16302,16514,14617,-1897
2020,11,4,20,16370,16678,14371,-2307
2020,11,4,21,16633,16994,14760,-2234
2020,11,4,22,17374,17498,15242,-2256
2020,11,4,23,18429,18341,15927,-2414
2020,11,5,0,18184,18221,16754,-1467
2020,11,5,1,17545,17694,16057,-1637
2020,11,5,2,17001,17035,15409,-1626
2020,11,5,3,16209,16160,14369,-1791
2020,11,5,4,15164,15112,13634,-1478
2020,11,5,5,14182,14159,12796,-1363
2020,11,5,6,13569,13498,12610,-888
2020,11,5,7,13127,13122,12610,-512
2020,11,5,8,12895,12943,12261,-682
2020,11,5,9,12828,12871,12282,-589
2020,11,5,10,13038,13109,12283,-826
2020,11,5,11,13769,13859,12964,-895
2020,11,5,12,14931,15167,13933,-1234
2020,11,5,13,15802,16080,14846,-1234
2020,11,5,14,16248,16381,14944,-1437
2020,11,5,15,16322,16443,14975,-1468
2020,11,5,16,16324,16219,14476,-1743
2020,11,5,17,16342,16143,14357,-1786
2020,11,5,18,16330,16264,14733,-1531
2020,11,5,19,16375,16350,14692,-1658
2020,11,5,20,16459,16518,15040,-1478
2020,11,5,21,16678,16712,15517,-1195
2020,11,5,22,17242,17267,15990,-1277
2020,11,5,23,18133,18289,16968,-1321
2020,11,6,0,17826,18044,16838,-1206
2020,11,6,1,17229,17458,16289,-1169
2020,11,6,2,16668,16776,15305,-1471
2020,11,6,3,15874,15966,14366,-1600
2020,11,6,4,14921,14995,13379,-1616
2020,11,6,5,14055,14080,12342,-1738
2020,11,6,6,13189,13366,11743,-1623
2020,11,6,7,12693,12929,11706,-1223
2020,11,6,8,12435,12672,11627,-1045
2020,11,6,9,12351,12587,11524,-1063
2020,11,6,10,12545,12798,11922,-876
2020,11,6,11,13252,13475,12450,-1025
2020,11,6,12,14382,14708,13278,-1430
2020,11,6,13,15312,15710,14208,-1502
2020,11,6,14,15804,16058,14667,-1391
2020,11,6,15,15904,16015,14649,-1366
2020,11,6,16,15863,15973,14258,-1715
2020,11,6,17,15822,15979,14164,-1815
2020,11,6,18,15780,15967,14395,-1572
2020,11,6,19,15827,16096,14526,-1570
2020,11,6,20,15947,16283,14637,-1646
2020,11,6,21,16216,16566,14647,-1919
2020,11,6,22,16736,17005,15248,-1757
2020,11,6,23,17601,17793,15886,-1907
2020,11,7,0,17222,17531,15915,-1616
2020,11,7,1,16568,16948,15221,-1727
2020,11,7,2,15999,16333,14671,-1662
2020,11,7,3,15324,15676,14150,-1526
2020,11,7,4,14530,14827,13274,-1553
2020,11,7,5,13750,13974,12188,-1786
2020,11,7,6,12939,13285,11567,-1718
2020,11,7,7,12332,12791,11156,-1635
2020,11,7,8,12084,12526,11160,-1366
2020,11,7,9,11958,12384,10816,-1568
2020,11,7,10,11995,12422,10940,-1482
2020,11,7,11,12288,12720,11433,-1287
2020,11,7,12,12750,13241,11418,-1823
2020,11,7,13,13179,13708,12250,-1458
2020,11,7,14,13704,13990,12570,-1420
2020,11,7,15,14015,14114,12574,-1540
2020,11,7,16,14133,14244,12189,-2055
2020,11,7,17,14209,14338,12077,-2261
2020,11,7,18,14307,14451,12465,-1986
2020,11,7,19,14368,14563,12555,-2008
2020,11,7,20,14498,14749,12752,-1997
2020,11,7,21,14772,15077,13099,-1978
2020,11,7,22,15381,15604,13459,-2145
2020,11,7,23,16183,16531,13865,-2666
2020,11,8,0,16109,16461,14111,-2350
2020,11,8,1,15647,16082,13741,-2341
2020,11,8,2,15222,15562,13642,-1920
2020,11,8,3,14693,15038,13342,-1696
2020,11,8,4,14086,14354,12526,-1828
2020,11,8,5,13442,13655,11700,-1955
2020,11,8,6,12681,13026,11168,-1858
2020,11,8,7,12050,12600,11047,-1553
2020,11,8,8,11826,12319,10453,-1866
2020,11,8,9,11721,12149,10336,-1813
2020,11,8,10,11747,12153,10458,-1695
2020,11,8,11,11938,12367,10899,-1468
2020,11,8,12,12250,12765,11218,-1547
2020,11,8,13,12545,13118,11816,-1302
2020,11,8,14,13000,13372,11662,-1710
2020,11,8,15,13294,13544,11716,-1828
2020,11,8,16,13425,13725,11755,-1970
2020,11,8,17,13579,13914,12038,-1876
2020,11,8,18,13815,14132,12445,-1687
2020,11,8,19,13992,14325,12564,-1761
2020,11,8,20,14242,14617,12729,-1888
2020,11,8,21,14620,15037,13376,-1661
2020,11,8,22,15361,15659,13904,-1755
2020,11,8,23,16280,16658,15050,-1608
2020,11,9,0,16285,16612,14900,-1712
2020,11,9,1,15873,16169,14450,-1719
2020,11,9,2,15414,15662,13980,-1682
2020,11,9,3,14641,15003,13315,-1688
2020,11,9,4,13810,14234,12535,-1699
2020,11,9,5,13050,13502,11591,-1911
2020,11,9,6,12396,12949,10905,-2044
2020,11,9,7,12021,12550,10552,-1998
2020,11,9,8,11851,12363,10494,-1869
2020,11,9,9,11824,12308,10483,-1825
2020,11,9,10,12100,12550,10756,-1794
2020,11,9,11,12903,13359,11252,-2107
2020,11,9,12,14222,14694,12076,-2618
2020,11,9,13,15161,15651,13481,-2170
2020,11,9,14,15547,15957,13801,-2156
2020,11,9,15,15603,15926,13693,-2233
2020,11,9,16,15588,15951,13646,-2305
2020,11,9,17,15587,16067,13521,-2546
2020,11,9,18,15620,16153,13406,-2747
2020,11,9,19,15730,16295,13760,-2535
2020,11,9,20,15906,16529,14206,-2323
2020,11,9,21,16206,16844,14707,-2137
2020,11,9,22,16864,17342,15246,-2096
2020,11,9,23,17901,18243,15795,-2448
2020,11,10,0,17683,17978,15516,-2462
2020,11,10,1,17087,17326,15141,-2185
2020,11,10,2,16362,16607,14781,-1826
2020,11,10,3,15442,15788,14133,-1655
2020,11,10,4,14399,14842,13192,-1650
2020,11,10,5,13463,13888,12168,-1720
2020,11,10,6,12808,13201,11536,-1665
2020,11,10,7,12367,12788,11551,-1237
2020,11,10,8,12126,12535,11393,-1142
2020,11,10,9,12056,12433,11106,-1327
2020,11,10,10,12294,12632,11254,-1378
2020,11,10,11,13053,13366,12068,-1298
2020,11,10,12,14326,14644,12771,-1873
2020,11,10,13,15280,15642,13893,-1749
2020,11,10,14,15776,15962,14321,-1641
2020,11,10,15,15899,15988,14306,-1682
2020,11,10,16,15950,16056,14272,-1784
2020,11,10,17,16012,16185,14358,-1827
2020,11,10,18,16071,16341,14706,-1635
2020,11,10,19,16146,16630,15053,-1577
2020,11,10,20,16276,16853,15333,-1520
2020,11,10,21,16484,17160,15752,-1408
2020,11,10,22,17029,17621,16109,-1512
2020,11,10,23,18025,18450,17058,-1392
2020,11,11,0,17818,18175,16936,-1239
2020,11,11,1,17221,17489,16476,-1013
2020,11,11,2,16519,16750,15645,-1105
2020,11,11,3,15592,15963,14725,-1238
2020,11,11,4,14592,15060,13845,-1215
2020,11,11,5,13685,14126,12697,-1429
2020,11,11,6,13086,13398,11850,-1548
2020,11,11,7,12645,12934,11731,-1203
2020,11,11,8,12386,12634,11258,-1376
2020,11,11,9,12278,12470,11095,-1375
2020,11,11,10,12469,12603,11214,-1389
2020,11,11,11,13068,13169,11755,-1414
2020,11,11,12,13987,14279,12894,-1385
2020,11,11,13,15065,15364,13907,-1457
2020,11,11,14,16061,16180,14862,-1318
2020,11,11,15,16593,16722,15532,-1190
2020,11,11,16,16934,17130,15897,-1233
2020,11,11,17,17097,17411,16258,-1153
2020,11,11,18,17138,17549,16294,-1255
2020,11,11,19,17102,17512,16366,-1146
2020,11,11,20,17106,17455,16322,-1133
2020,11,11,21,17073,17523,16502,-1021
2020,11,11,22,17487,17979,17216,-763
2020,11,11,23,18362,18514,17540,-974
2020,11,12,0,17976,18140,17290,-850
2020,11,12,1,17366,17507,16605,-902
2020,11,12,2,16514,16770,15887,-883
2020,11,12,3,15573,15947,15185,-762
2020,11,12,4,14606,14970,14156,-814
2020,11,12,5,13726,14097,12930,-1167
2020,11,12,6,13128,13441,12078,-1363
2020,11,12,7,12758,13046,11630,-1416
2020,11,12,8,12505,12769,11297,-1472
2020,11,12,9,12411,12654,10797,-1857
2020,11,12,10,12586,12876,10975,-1901
2020,11,12,11,13288,13589,11813,-1776
2020,11,12,12,14523,14907,12981,-1926
2020,11,12,13,15587,16038,14288,-1750
2020,11,12,14,16135,16698,14769,-1929
2020,11,12,15,16284,17027,15041,-1986
2020,11,12,16,16292,17093,15403,-1690
2020,11,12,17,16353,17120,15372,-1748
2020,11,12,18,16368,17065,15097,-1968
2020,11,12,19,16436,17012,15190,-1822
2020,11,12,20,16514,17015,15094,-1921
2020,11,12,21,16661,17118,15154,-1964
2020,11,12,22,17107,17723,15657,-2066
2020,11,12,23,18029,18552,16956,-1596
2020,11,13,0,17814,18317,16814,-1503
2020,11,13,1,17319,17782,15835,-1947
2020,11,13,2,16666,17149,15249,-1900
2020,11,13,3,15767,16326,14413,-1913
2020,11,13,4,14762,15360,13763,-1597
2020,11,13,5,13821,14458,12668,-1790
2020,11,13,6,13351,13841,11326,-2515
2020,11,13,7,12935,13408,10993,-2415
2020,11,13,8,12708,13161,11045,-2116
2020,11,13,9,12631,13075,11128,-1947
2020,11,13,10,12806,13274,11628,-1646
2020,11,13,11,13435,13999,12427,-1572
2020,11,13,12,14587,15244,13625,-1619
2020,11,13,13,15554,16296,14852,-1444
2020,11,13,14,16035,17004,15803,-1201
2020,11,13,15,16232,17462,16145,-1317
2020,11,13,16,16359,17649,16513,-1136
2020,11,13,17,16447,17709,16513,-1196
2020,11,13,18,16495,17644,16499,-1145
2020,11,13,19,16504,17481,16427,-1054
2020,11,13,20,16423,17253,16233,-1020
2020,11,13,21,16558,17269,15866,-1403
2020,11,13,22,16895,17746,16090,-1656
2020,11,13,23,17601,18442,16981,-1461
2020,11,14,0,17216,18088,16679,-1409
2020,11,14,1,16767,17533,16313,-1220
2020,11,14,2,16265,17017,15806,-1211
2020,11,14,3,15605,16281,15053,-1228
2020,11,14,4,14899,15374,13919,-1455
2020,11,14,5,14176,14547,12854,-1693
2020,11,14,6,13571,13923,11805,-2118
2020,11,14,7,13147,13436,11442,-1994
2020,11,14,8,12864,13121,11259,-1862
2020,11,14,9,12717,12985,10996,-1989
2020,11,14,10,12755,13023,10739,-2284
2020,11,14,11,13083,13351,10981,-2370
2020,11,14,12,13671,13893,11334,-2559
2020,11,14,13,14214,14356,12339,-2017
2020,11,14,14,14632,14737,12812,-1925
2020,11,14,15,14795,14915,12855,-2060
2020,11,14,16,14849,15087,13035,-2052
2020,11,14,17,14824,15159,12997,-2162
2020,11,14,18,14755,15079,12937,-2142
2020,11,14,19,14694,14974,13076,-1898
2020,11,14,20,14794,15055,13296,-1759
2020,11,14,21,15099,15427,13673,-1754
2020,11,14,22,15705,16289,14143,-2146
2020,11,14,23,16753,17351,15397,-1954
2020,11,15,0,16616,17339,15071,-2268
2020,11,15,1,16401,17018,14477,-2541
2020,11,15,2,16012,16650,13802,-2848
2020,11,15,3,15496,16156,13070,-3086
2020,11,15,4,14903,15443,12350,-3093
2020,11,15,5,14296,14698,11945,-2753
2020,11,15,6,13880,14049,11591,-2458
2020,11,15,7,13454,13501,11384,-2117
2020,11,15,8,13178,13187,11105,-2082
2020,11,15,9,13027,13024,10933,-2091
2020,11,15,10,13007,13055,11612,-1443
2020,11,15,11,13173,13271,11807,-1464
2020,11,15,12,13491,13619,12173,-1446
2020,11,15,13,13923,13989,12897,-1092
2020,11,15,14,14420,14515,13665,-850
2020,11,15,15,14729,14943,13924,-1019
2020,11,15,16,14942,15106,14004,-1102
2020,11,15,17,15110,15385,14380,-1005
2020,11,15,18,15280,15843,14804,-1039
2020,11,15,19,15387,16096,14934,-1162
2020,11,15,20,15535,16223,15050,-1173
2020,11,15,21,15766,16428,15299,-1129
2020,11,15,22,16347,17023,16303,-720
2020,11,15,23,17255,17470,16960,-510
2020,11,16,0,17042,17243,16169,-1074
2020,11,16,1,16675,16750,15566,-1184
2020,11,16,2,16108,16187,15148,-1039
2020,11,16,3,15326,15409,14341,-1068
2020,11,16,4,14475,14552,13178,-1374
2020,11,16,5,13704,13789,12672,-1117
2020,11,16,6,13136,13192,11566,-1626
2020,11,16,7,12802,12844,11043,-1801
2020,11,16,8,12620,12647,10731,-1916
2020,11,16,9,12582,12606,10606,-2000
2020,11,16,10,12838,12877,11338,-1539
2020,11,16,11,13654,13659,12308,-1351
2020,11,16,12,15085,14973,13802,-1171
2020,11,16,13,16087,16028,15301,-727
2020,11,16,14,16416,16539,15495,-1044
2020,11,16,15,16521,16803,15681,-1122
2020,11,16,16,16584,16940,15201,-1739
2020,11,16,17,16633,17074,15150,-1924
2020,11,16,18,16665,17154,15003,-2151
2020,11,16,19,16748,17183,15161,-2022
2020,11,16,20,16865,17245,15242,-2003
2020,11,16,21,17169,17419,15818,-1601
2020,11,16,22,17859,18069,16446,-1623
2020,11,16,23,18888,18946,17768,-1178
2020,11,17,0,18624,18656,17769,-887
2020,11,17,1,18186,18127,17502,-625
2020,11,17,2,17511,17478,16569,-909
2020,11,17,3,16630,16661,15198,-1463
2020,11,17,4,15591,15588,13673,-1915
2020,11,17,5,14607,14654,12649,-2005
2020,11,17,6,13843,13978,11555,-2423
2020,11,17,7,13412,13578,11310,-2268
2020,11,17,8,13150,13344,11291,-2053
2020,11,17,9,13065,13290,11388,-1902
2020,11,17,10,13293,13546,11891,-1655
2020,11,17,11,14069,14322,13038,-1284
2020,11,17,12,15480,15632,14517,-1115
2020,11,17,13,16522,16664,15685,-979
2020,11,17,14,17007,17317,16308,-1009
2020,11,17,15,17170,17658,16007,-1651
2020,11,17,16,17278,17751,15958,-1793
2020,11,17,17,17360,17808,15912,-1896
2020,11,17,18,17402,17866,16205,-1661
2020,11,17,19,17398,17913,16435,-1478
2020,11,17,20,17381,17974,16419,-1555
2020,11,17,21,17545,18106,16377,-1729
2020,11,17,22,18115,18715,17248,-1467
2020,11,17,23,19065,19643,18750,-893
2020,11,18,0,18915,19438,18907,-531
2020,11,18,1,18485,18909,18585,-324
2020,11,18,2,17882,18271,17963,-308
2020,11,18,3,17005,17469,16714,-755
2020,11,18,4,15975,16410,15332,-1078
2020,11,18,5,15019,15467,14635,-832
2020,11,18,6,14410,14804,13707,-1097
2020,11,18,7,14045,14382,13345,-1037
2020,11,18,8,13815,14164,13226,-938
2020,11,18,9,13755,14119,13424,-695
2020,11,18,10,13979,14370,13777,-593
2020,11,18,11,14752,15183,14771,-412
2020,11,18,12,16179,16545,15829,-716
2020,11,18,13,17178,17569,17132,-437
2020,11,18,14,17516,18036,17302,-734
2020,11,18,15,17506,18139,17227,-912
2020,11,18,16,17429,18164,17095,-1069
2020,11,18,17,17352,18206,16967,-1239
2020,11,18,18,17282,18196,16709,-1487
2020,11,18,19,17274,18203,16489,-1714
2020,11,18,20,17350,18365,16782,-1583
2020,11,18,21,17641,18737,17265,-1472
2020,11,18,22,18383,19533,18004,-1529
2020,11,18,23,19464,20470,18924,-1546
2020,11,19,0,19343,20237,19165,-1072
2020,11,19,1,18989,19713,18159,-1554
2020,11,19,2,18405,19053,17753,-1300
2020,11,19,3,17558,18124,16943,-1181
2020,11,19,4,16514,17035,15726,-1309
2020,11,19,5,15531,16017,14849,-1168
2020,11,19,6,15057,15324,14071,-1253
2020,11,19,7,14643,14923,13763,-1160
2020,11,19,8,14376,14656,13537,-1119
2020,11,19,9,14277,14546,13169,-1377
2020,11,19,10,14461,14760,13436,-1324
2020,11,19,11,15168,15531,14415,-1116
2020,11,19,12,16518,16811,16171,-640
2020,11,19,13,17436,17763,17222,-541
2020,11,19,14,17759,18100,17197,-903
2020,11,19,15,17739,18033,16827,-1206
2020,11,19,16,17650,17861,16752,-1109
2020,11,19,17,17559,17659,16396,-1263
2020,11,19,18,17477,17491,15991,-1500
2020,11,19,19,17447,17432,15721,-1711
2020,11,19,20,17467,17636,15895,-1741
2020,11,19,21,17647,17877,16239,-1638
2020,11,19,22,18226,18588,17178,-1410
2020,11,19,23,19098,19416,18360,-1056
2020,11,20,0,18842,19164,17878,-1286
2020,11,20,1,18361,18608,17060,-1548
2020,11,20,2,17792,17921,16618,-1303
2020,11,20,3,16924,16981,16065,-916
2020,11,20,4,15853,15925,15016,-909
2020,11,20,5,14849,14887,14134,-753
2020,11,20,6,14142,14110,13140,-970
2020,11,20,7,13680,13631,12407,-1224
2020,11,20,8,13387,13344,11935,-1409
2020,11,20,9,13285,13234,11734,-1500
2020,11,20,10,13469,13401,12126,-1275
2020,11,20,11,14180,14120,12964,-1156
2020,11,20,12,15479,15348,14141,-1207
2020,11,20,13,16400,16248,14748,-1500
2020,11,20,14,16749,16681,14639,-2042
2020,11,20,15,16737,16671,14631,-2040
2020,11,20,16,16641,16514,14821,-1693
2020,11,20,17,16582,16369,14464,-1905
2020,11,20,18,16507,16295,14498,-1797
2020,11,20,19,16508,16328,14684,-1644
2020,11,20,20,16563,16427,14945,-1482
2020,11,20,21,16750,16626,15311,-1315
2020,11,20,22,17240,17255,15626,-1629
2020,11,20,23,18027,18026,16155,-1871
2020,11,21,0,17672,17785,16068,-1717
2020,11,21,1,17158,17279,15701,-1578
2020,11,21,2,16628,16653,14897,-1756
2020,11,21,3,15899,15947,14361,-1586
2020,11,21,4,15067,15041,13244,-1797
2020,11,21,5,14225,14167,12780,-1387
2020,11,21,6,13312,13511,12075,-1436
2020,11,21,7,12904,13037,11676,-1361
2020,11,21,8,12584,12794,11374,-1420
2020,11,21,9,12448,12673,11161,-1512
2020,11,21,10,12483,12740,11290,-1450
2020,11,21,11,12782,13055,11697,-1358
2020,11,21,12,13350,13593,12625,-968
2020,11,21,13,13867,14081,13247,-834
2020,11,21,14,14374,14565,13727,-838
2020,11,21,15,14707,14862,13706,-1156
2020,11,21,16,14925,15037,13671,-1366
2020,11,21,17,15031,15050,13708,-1342
2020,11,21,18,15066,15134,14023,-1111
2020,11,21,19,15059,15278,14137,-1141
2020,11,21,20,15166,15466,14388,-1078
2020,11,21,21,15427,15689,14570,-1119
2020,11,21,22,16062,16470,15332,-1138
2020,11,21,23,16822,17187,15903,-1284
2020,11,22,0,16688,17064,15867,-1197
2020,11,22,1,16317,16660,15385,-1275
2020,11,22,2,15926,16213,15069,-1144
2020,11,22,3,15374,15622,14544,-1078
2020,11,22,4,14735,14912,13908,-1004
2020,11,22,5,14086,14220,12812,-1408
2020,11,22,6,13454,13637,11708,-1929
2020,11,22,7,13044,13250,11390,-1860
2020,11,22,8,12761,12961,10991,-1970
2020,11,22,9,12655,12870,10897,-1973
2020,11,22,10,12680,12924,11199,-1725
2020,11,22,11,12876,13220,11572,-1648
2020,11,22,12,13266,13663,12473,-1190
2020,11,22,13,13716,14135,13099,-1036
2020,11,22,14,14339,14746,13724,-1022
2020,11,22,15,14854,15396,14247,-1149
2020,11,22,16,15238,15937,14932,-1005
2020,11,22,17,15525,16311,15224,-1087
2020,11,22,18,15789,16608,15347,-1261
2020,11,22,19,15912,16742,15594,-1148
2020,11,22,20,16052,16782,15968,-814
2020,11,22,21,16271,16955,15945,-1010
2020,11,22,22,16954,17606,16526,-1080
2020,11,22,23,17611,18082,17488,-594
2020,11,23,0,17329,17799,17183,-616
2020,11,23,1,16940,17284,16764,-520
2020,11,23,2,16355,16655,16269,-386
2020,11,23,3,15485,15848,15286,-562
2020,11,23,4,14557,14975,14260,-715
2020,11,23,5,13715,14140,12830,-1310
2020,11,23,6,13042,13488,12072,-1416
2020,11,23,7,12647,13069,11870,-1199
2020,11,23,8,12409,12843,11681,-1162
2020,11,23,9,12340,12774,11752,-1022
2020,11,23,10,12572,12991,11717,-1274
2020,11,23,11,13359,13684,12470,-1214
2020,11,23,12,14700,14991,13884,-1107
2020,11,23,13,15871,16214,14907,-1307
2020,11,23,14,16609,17022,15741,-1281
2020,11,23,15,16961,17441,16112,-1329
2020,11,23,16,17054,17574,16637,-937
2020,11,23,17,17012,17469,16618,-851
2020,11,23,18,16940,17292,16116,-1176
2020,11,23,19,16915,17272,15985,-1287
2020,11,23,20,17001,17383,15751,-1632
2020,11,23,21,17243,17702,15895,-1807
2020,11,23,22,18058,18544,16682,-1862
2020,11,23,23,19000,19389,17444,-1945
2020,11,24,0,18779,19078,17581,-1497
2020,11,24,1,18207,18526,16813,-1713
2020,11,24,2,17519,17935,16393,-1542
2020,11,24,3,16636,17090,15877,-1213
2020,11,24,4,15568,16096,14776,-1320
2020,11,24,5,14566,15089,13763,-1326
2020,11,24,6,13942,14360,13260,-1100
2020,11,24,7,13492,13940,12715,-1225
2020,11,24,8,13230,13715,12300,-1415
2020,11,24,9,13161,13606,11961,-1645
2020,11,24,10,13397,13794,12248,-1546
2020,11,24,11,14176,14536,13113,-1423
2020,11,24,12,15517,15771,14296,-1475
2020,11,24,13,16555,16774,15206,-1568
2020,11,24,14,16996,17211,15556,-1655
2020,11,24,15,16978,17249,15539,-1710
2020,11,24,16,16862,17185,15496,-1689
2020,11,24,17,16761,17073,15058,-2015
2020,11,24,18,16676,17000,14850,-2150
2020,11,24,19,16701,17041,15060,-1981
2020,11,24,20,16873,17145,15577,-1568
2020,11,24,21,17184,17468,16118,-1350
2020,11,24,22,18063,18376,16959,-1417
2020,11,24,23,18932,19334,17841,-1493
2020,11,25,0,18750,19146,17874,-1272
2020,11,25,1,18333,18689,17196,-1493
2020,11,25,2,17744,18079,16675,-1404
2020,11,25,3,17021,17273,15732,-1541
2020,11,25,4,16037,16243,14738,-1505
2020,11,25,5,15062,15212,14046,-1166
2020,11,25,6,14337,14445,13713,-732
2020,11,25,7,13873,13965,12937,-1028
2020,11,25,8,13588,13701,12639,-1062
2020,11,25,9,13475,13547,12611,-936
2020,11,25,10,13602,13708,13084,-624
2020,11,25,11,14188,14376,13682,-694
2020,11,25,12,15201,15486,14574,-912
2020,11,25,13,16232,16434,15303,-1131
2020,11,25,14,16980,17104,15647,-1457
2020,11,25,15,17233,17384,16131,-1253
2020,11,25,16,17257,17441,16597,-844
2020,11,25,17,17236,17459,16591,-868
2020,11,25,18,17139,17559,16340,-1219
2020,11,25,19,17096,17684,16471,-1213
2020,11,25,20,17131,17668,16146,-1522
2020,11,25,21,17240,17677,16322,-1355
2020,11,25,22,17840,18180,16694,-1486
2020,11,25,23,18380,18703,17505,-1198
2020,11,26,0,17992,18403,17250,-1153
2020,11,26,1,17475,17861,16721,-1140
2020,11,26,2,16868,17299,16012,-1287
2020,11,26,3,16153,16513,15259,-1254
2020,11,26,4,15288,15538,14283,-1255
2020,11,26,5,14357,14558,13424,-1134
2020,11,26,6,13411,13814,12181,-1633
2020,11,26,7,12963,13283,11692,-1591
2020,11,26,8,12688,12887,11245,-1642
2020,11,26,9,12533,12713,11157,-1556
2020,11,26,10,12504,12677,11182,-1495
2020,11,26,11,12581,12899,11612,-1287
2020,11,26,12,12776,13407,12491,-916
2020,11,26,13,13255,14007,13220,-787
2020,11,26,14,14021,14781,13811,-970
2020,11,26,15,14631,15567,14342,-1225
2020,11,26,16,15018,16120,14637,-1483
2020,11,26,17,15267,16496,14806,-1690
2020,11,26,18,15242,16539,14815,-1724
2020,11,26,19,14980,16395,14894,-1501
2020,11,26,20,14678,16215,14497,-1718
2020,11,26,21,14418,16020,14326,-1694
2020,11,26,22,14511,16131,14310,-1821
2020,11,26,23,14472,16222,14735,-1487
2020,11,27,0,14114,15814,14147,-1667
2020,11,27,1,13895,15440,13791,-1649
2020,11,27,2,13733,15132,13725,-1407
2020,11,27,3,13565,14725,13585,-1140
2020,11,27,4,13277,14128,13024,-1104
2020,11,27,5,12907,13465,12073,-1392
2020,11,27,6,12596,12887,10900,-1987
2020,11,27,7,12256,12551,10650,-1901
2020,11,27,8,12024,12330,10312,-2018
2020,11,27,9,11921,12170,10088,-2082
2020,11,27,10,12035,12268,10305,-1963
2020,11,27,11,12388,12703,10927,-1776
2020,11,27,12,12874,13465,12264,-1201
2020,11,27,13,13385,14048,12944,-1104
2020,11,27,14,14044,14577,13243,-1334
2020,11,27,15,14429,14929,13558,-1371
2020,11,27,16,14664,15121,13515,-1606
2020,11,27,17,14833,15300,13838,-1462
2020,11,27,18,14909,15473,14005,-1468
2020,11,27,19,14976,15626,14067,-1559
2020,11,27,20,15117,15753,14195,-1558
2020,11,27,21,15370,15969,14364,-1605
2020,11,27,22,16159,16651,14680,-1971
2020,11,27,23,16735,17252,15366,-1886
2020,11,28,0,16417,17052,15086,-1966
2020,11,28,1,15938,16641,14792,-1849
2020,11,28,2,15426,16170,14158,-2012
2020,11,28,3,14905,15551,13850,-1701
2020,11,28,4,14255,14777,13094,-1683
2020,11,28,5,13539,14021,11947,-2074
2020,11,28,6,12950,13386,11058,-2328
2020,11,28,7,12524,12920,10847,-2073
2020,11,28,8,12264,12647,10346,-2301
2020,11,28,9,12139,12493,10370,-2123
2020,11,28,10,12205,12533,10352,-2181
2020,11,28,11,12481,12815,10711,-2104
2020,11,28,12,12872,13371,11558,-1813
2020,11,28,13,13383,13912,12193,-1719
2020,11,28,14,14046,14465,12590,-1875
2020,11,28,15,14411,14751,12952,-1799
2020,11,28,16,14635,14879,13367,-1512
2020,11,28,17,14699,15062,13554,-1508
2020,11,28,18,14695,15350,13549,-1801
2020,11,28,19,14678,15423,13626,-1797
2020,11,28,20,14773,15448,13665,-1783
2020,11,28,21,15084,15618,14035,-1583
2020,11,28,22,15919,16468,14698,-1770
2020,11,28,23,16785,17479,15575,-1904
2020,11,29,0,16657,17451,15319,-2132
2020,11,29,1,16308,17163,15250,-1913
2020,11,29,2,15934,16781,14718,-2063
2020,11,29,3,15377,16227,14021,-2206
2020,11,29,4,14706,15472,13665,-1807
2020,11,29,5,14011,14667,12762,-1905
2020,11,29,6,13342,14062,12241,-1821
2020,11,29,7,12891,13566,11830,-1736
2020,11,29,8,12665,13254,11335,-1919
2020,11,29,9,12572,13122,11274,-1848
2020,11,29,10,12639,13153,11298,-1855
2020,11,29,11,12884,13418,11666,-1752
2020,11,29,12,13288,13867,12187,-1680
2020,11,29,13,13696,14228,12585,-1643
2020,11,29,14,14071,14455,12760,-1695
2020,11,29,15,14154,14436,12662,-1774
2020,11,29,16,14194,14402,12598,-1804
2020,11,29,17,14186,14464,12595,-1869
2020,11,29,18,14240,14520,12535,-1985
2020,11,29,19,14332,14633,12656,-1977
2020,11,29,20,14552,14881,12971,-1910
2020,11,29,21,14982,15412,13293,-2119
2020,11,29,22,15957,16525,14150,-2375
2020,11,29,23,17065,17668,14865,-2803
2020,11,30,0,16982,17648,14966,-2682
2020,11,30,1,16721,17344,14952,-2392
2020,11,30,2,16325,16863,14670,-2193
2020,11,30,3,15463,16176,14145,-2031
2020,11,30,4,14524,15268,13312,-1956
2020,11,30,5,13694,14410,12535,-1875
2020,11,30,6,13329,13792,12285,-1507
2020,11,30,7,13016,13401,12001,-1400
2020,11,30,8,12834,13147,11862,-1285
2020,11,30,9,12782,13074,11722,-1352
2020,11,30,10,13030,13296,11790,-1506
2020,11,30,11,13751,14005,12382,-1623
2020,11,30,12,14993,15255,13430,-1825
2020,11,30,13,16025,16452,15151,-1301
2020,11,30,14,16690,17250,15656,-1594
2020,11,30,15,17088,17759,16028,-1731
2020,11,30,16,17382,18196,16192,-2004
2020,11,30,17,17592,18564,16369,-2195
2020,11,30,18,17658,18643,16742,-1901
2020,11,30,19,17687,18612,16952,-1660
2020,11,30,20,17711,18490,17088,-1402
2020,11,30,21,17779,18379,16913,-1466
2020,11,30,22,18366,18796,16910,-1886
2020,11,30,23,19074,19315,17253,-2062
2020,12,1,0,18625,18948,16623,-2325
2020,12,1,1,17954,18322,16105,-2217
2020,12,1,2,17235,17524,15379,-2145
2020,12,1,3,16189,16557,14398,-2159
2020,12,1,4,15078,15440,13425,-2015
2020,12,1,5,14066,14455,12708,-1747
2020,12,1,6,13540,13749,11995,-1754
2020,12,1,7,13057,13249,11547,-1702
2020,12,1,8,12780,12966,11328,-1638
2020,12,1,9,12671,12871,11133,-1738
2020,12,1,10,12870,13030,11286,-1744
2020,12,1,11,13614,13730,11728,-2002
2020,12,1,12,14889,14985,12723,-2262
2020,12,1,13,15929,16137,13912,-2225
2020,12,1,14,16394,16740,14208,-2532
2020,12,1,15,16608,16923,14570,-2353
2020,12,1,16,16694,16932,14375,-2557
2020,12,1,17,16792,17077,14490,-2587
2020,12,1,18,16857,17145,14432,-2713
2020,12,1,19,17017,17269,14601,-2668
2020,12,1,20,17168,17445,14703,-2742
2020,12,1,21,17461,17823,15079,-2744
2020,12,1,22,18366,18635,15709,-2926
2020,12,1,23,19296,19504,16850,-2654
2020,12,2,0,19073,19331,17095,-2236
2020,12,2,1,18590,18864,16322,-2542
2020,12,2,2,17919,18252,15782,-2470
2020,12,2,3,17089,17413,15617,-1796
2020,12,2,4,15952,16321,14495,-1826
2020,12,2,5,14841,15245,13225,-2020
2020,12,2,6,14120,14521,12462,-2059
2020,12,2,7,13648,14075,12018,-2057
2020,12,2,8,13384,13836,11835,-2001
2020,12,2,9,13304,13751,11847,-1904
2020,12,2,10,13548,13956,12093,-1863
2020,12,2,11,14377,14690,12965,-1725
2020,12,2,12,15834,15946,14285,-1661
2020,12,2,13,16919,17119,15455,-1664
2020,12,2,14,17430,17788,16180,-1608
2020,12,2,15,17607,18033,15996,-2037
2020,12,2,16,17633,18181,16059,-2122
2020,12,2,17,17695,18359,16397,-1962
2020,12,2,18,17653,18552,16431,-2121
2020,12,2,19,17693,18623,16868,-1755
2020,12,2,20,17708,18676,16751,-1925
2020,12,2,21,17889,18752,17059,-1693
2020,12,2,22,18703,19399,17340,-2059
2020,12,2,23,19591,20310,18403,-1907
2020,12,3,0,19476,20061,18209,-1852
2020,12,3,1,19016,19568,17716,-1852
2020,12,3,2,18376,18876,17595,-1281
2020,12,3,3,17554,17971,16341,-1630
2020,12,3,4,16374,16839,15095,-1744
2020,12,3,5,15207,15703,14178,-1525
2020,12,3,6,14415,14932,12857,-2075
2020,12,3,7,13914,14437,11936,-2501
2020,12,3,8,13644,14154,11950,-2204
2020,12,3,9,13573,14077,11809,-2268
2020,12,3,10,13803,14305,12286,-2019
2020,12,3,11,14614,15047,13172,-1875
2020,12,3,12,16096,16321,14293,-2028
2020,12,3,13,17101,17387,15395,-1992
2020,12,3,14,17375,17832,15989,-1843
2020,12,3,15,17287,17724,15706,-2018
2020,12,3,16,17059,17510,15411,-2099
2020,12,3,17,16934,17305,14968,-2337
2020,12,3,18,16787,17118,15082,-2036
2020,12,3,19,16841,17158,15074,-2084
2020,12,3,20,16980,17290,15360,-1930
2020,12,3,21,17312,17747,15714,-2033
2020,12,3,22,18173,18811,16571,-2240
2020,12,3,23,19085,19762,17532,-2230
2020,12,4,0,19007,19582,17557,-2025
2020,12,4,1,18605,19075,16893,-2182
2020,12,4,2,18029,18420,16118,-2302
2020,12,4,3,17241,17511,15400,-2111
2020,12,4,4,16109,16408,13832,-2576
2020,12,4,5,14989,15274,12688,-2586
2020,12,4,6,14363,14446,11990,-2456
2020,12,4,7,13878,13933,11595,-2338
2020,12,4,8,13587,13651,10987,-2664
2020,12,4,9,13474,13558,10935,-2623
2020,12,4,10,13624,13746,11214,-2532
2020,12,4,11,14283,14428,12100,-2328
2020,12,4,12,15554,15707,13497,-2210
2020,12,4,13,16608,16752,14556,-2196
2020,12,4,14,17137,17418,14853,-2565
2020,12,4,15,17283,17652,15000,-2652
2020,12,4,16,17268,17748,15141,-2607
2020,12,4,17,17331,17876,14961,-2915
2020,12,4,18,17302,17943,14981,-2962
2020,12,4,19,17308,18045,14968,-3077
2020,12,4,20,17323,18066,15224,-2842
2020,12,4,21,17491,18181,15485,-2696
2020,12,4,22,18136,18787,15833,-2954
2020,12,4,23,18719,19251,16165,-3086
2020,12,5,0,18364,18915,16072,-2843
2020,12,5,1,17952,18386,15793,-2593
2020,12,5,2,17365,17808,14993,-2815
2020,12,5,3,16732,17013,14179,-2834
2020,12,5,4,15883,16025,13139,-2886
2020,12,5,5,14967,15039,12093,-2946
2020,12,5,6,14265,14262,11772,-2490
2020,12,5,7,13703,13758,11276,-2482
2020,12,5,8,13326,13401,10974,-2427
2020,12,5,9,13140,13215,10734,-2481
2020,12,5,10,13139,13275,10776,-2499
2020,12,5,11,13474,13595,11118,-2477
2020,12,5,12,14044,14198,12105,-2093
2020,12,5,13,14698,14919,12691,-2228
2020,12,5,14,15370,15654,13400,-2254
2020,12,5,15,15993,16427,14404,-2023
2020,12,5,16,16325,17051,14934,-2117
2020,12,5,17,16483,17403,15399,-2004
2020,12,5,18,16487,17492,15175,-2317
2020,12,5,19,16434,17422,15164,-2258
2020,12,5,20,16465,17342,15098,-2244
2020,12,5,21,16697,17523,15485,-2038
2020,12,5,22,17613,18231,16076,-2155
2020,12,5,23,18368,18908,16840,-2068
2020,12,6,0,18326,18775,16980,-1795
2020,12,6,1,17828,18421,16680,-1741
2020,12,6,2,17325,17981,16659,-1322
2020,12,6,3,16956,17414,16060,-1354
2020,12,6,4,16272,16501,14986,-1515
2020,12,6,5,15440,15622,14049,-1573
2020,12,6,6,14673,14923,12375,-2548
2020,12,6,7,14119,14393,11892,-2501
2020,12,6,8,13744,14059,11421,-2638
2020,12,6,9,13555,13884,11391,-2493
2020,12,6,10,13532,13906,11456,-2450
2020,12,6,11,13803,14163,11865,-2298
2020,12,6,12,14256,14607,12956,-1651
2020,12,6,13,14697,15102,14143,-959
2020,12,6,14,15166,15605,14554,-1051
2020,12,6,15,15521,16076,14959,-1117
2020,12,6,16,15724,16314,15012,-1302
2020,12,6,17,15889,16406,14924,-1482
2020,12,6,18,16016,16532,14379,-2153
2020,12,6,19,16161,16629,14211,-2418
2020,12,6,20,16364,16897,14608,-2289
2020,12,6,21,16780,17386,15278,-2108
2020,12,6,22,17918,18505,16405,-2100
2020,12,6,23,18969,19597,17428,-2169
2020,12,7,0,19020,19549,17130,-2419
2020,12,7,1,18638,19225,16796,-2429
2020,12,7,2,18108,18715,16290,-2425
2020,12,7,3,17532,17954,15850,-2104
2020,12,7,4,16589,16905,14917,-1988
2020,12,7,5,15588,15894,13596,-2298
2020,12,7,6,14719,15164,12662,-2502
2020,12,7,7,14281,14715,11740,-2975
2020,12,7,8,14049,14453,11523,-2930
2020,12,7,9,13995,14409,11324,-3085
2020,12,7,10,14243,14663,11931,-2732
2020,12,7,11,14975,15471,13103,-2368
2020,12,7,12,16307,16881,14685,-2196
2020,12,7,13,17446,18065,15691,-2374
2020,12,7,14,17999,18686,16292,-2394
2020,12,7,15,18125,18745,16374,-2371
2020,12,7,16,18119,18685,16263,-2422
2020,12,7,17,18100,18557,16151,-2406
2020,12,7,18,18002,18479,15942,-2537
2020,12,7,19,18005,18515,15901,-2614
2020,12,7,20,18073,18558,15601,-2957
2020,12,7,21,18350,18919,16072,-2847
2020,12,7,22,19235,19955,17031,-2924
2020,12,7,23,20171,21026,18144,-2882
2020,12,8,0,20132,20795,17728,-3067
2020,12,8,1,19753,20296,17236,-3060
2020,12,8,2,19163,19652,16866,-2786
2020,12,8,3,18318,18773,16059,-2714
2020,12,8,4,17151,17625,15101,-2524
2020,12,8,5,15998,16451,13700,-2751
2020,12,8,6,15297,15608,12631,-2977
2020,12,8,7,14802,15097,12399,-2698
2020,12,8,8,14534,14820,12170,-2650
2020,12,8,9,14449,14773,12288,-2485
2020,12,8,10,14658,14984,12286,-2698
2020,12,8,11,15345,15774,13221,-2553
2020,12,8,12,16641,17138,14862,-2276
2020,12,8,13,17792,18373,15623,-2750
2020,12,8,14,18330,19136,15871,-3265
2020,12,8,15,18470,19521,16057,-3464
2020,12,8,16,18441,19669,16042,-3627
2020,12,8,17,18400,19644,16080,-3564
2020,12,8,18,18263,19523,15760,-3763
2020,12,8,19,18186,19342,15765,-3577
2020,12,8,20,18198,19293,16036,-3257
2020,12,8,21,18423,19484,16002,-3482
2020,12,8,22,19253,20399,16486,-3913
2020,12,8,23,20213,21424,17600,-3824
2020,12,9,0,20124,21178,17925,-3253
2020,12,9,1,19769,20655,17294,-3361
2020,12,9,2,19220,19961,16846,-3115
2020,12,9,3,18369,19039,15791,-3248
2020,12,9,4,17217,17816,14196,-3620
2020,12,9,5,16089,16635,12943,-3692
2020,12,9,6,15288,15852,12416,-3436
2020,12,9,7,14794,15316,11975,-3341
2020,12,9,8,14511,15015,11634,-3381
2020,12,9,9,14400,14892,11678,-3214
2020,12,9,10,14583,15089,11681,-3408
2020,12,9,11,15231,15812,12380,-3432
2020,12,9,12,16459,17057,13713,-3344
2020,12,9,13,17584,18209,15048,-3161
2020,12,9,14,18188,18933,15818,-3115
2020,12,9,15,18427,19292,15924,-3368
2020,12,9,16,18491,19390,15974,-3416
2020,12,9,17,18528,19429,15814,-3615
2020,12,9,18,18449,19575,15507,-4068
2020,12,9,19,18420,19700,15524,-4176
2020,12,9,20,18399,19647,15501,-4146
2020,12,9,21,18577,19750,15605,-4145
2020,12,9,22,19353,20523,16184,-4339
2020,12,9,23,20185,21281,16886,-4395
2020,12,10,0,19899,20934,16813,-4121
2020,12,10,1,19403,20310,16459,-3851
2020,12,10,2,18791,19524,15975,-3549
2020,12,10,3,17938,18578,15047,-3531
2020,12,10,4,16817,17320,14037,-3283
2020,12,10,5,15675,16118,12626,-3492
2020,12,10,6,14906,15271,12206,-3065
2020,12,10,7,14391,14791,11728,-3063
2020,12,10,8,14091,14454,11840,-2614
2020,12,10,9,13994,14330,11499,-2831
2020,12,10,10,14206,14548,11671,-2877
2020,12,10,11,14919,15263,12462,-2801
2020,12,10,12,16227,16530,13528,-3002
2020,12,10,13,17345,17662,14984,-2678
2020,12,10,14,17788,18087,15045,-3042
2020,12,10,15,17841,18201,15017,-3184
2020,12,10,16,17763,18088,14984,-3104
2020,12,10,17,17664,18079,15017,-3062
2020,12,10,18,17518,17928,14900,-3028
2020,12,10,19,17500,17953,14676,-3277
2020,12,10,20,17583,18081,14723,-3358
2020,12,10,21,17882,18314,14722,-3592
2020,12,10,22,18783,19258,15433,-3825
2020,12,10,23,19748,20418,16525,-3893
2020,12,11,0,19590,20215,16492,-3723
2020,12,11,1,19174,19732,16101,-3631
2020,12,11,2,18644,19013,15665,-3348
2020,12,11,3,17823,18183,14657,-3526
2020,12,11,4,16717,17035,13971,-3064
2020,12,11,5,15616,15984,12937,-3047
2020,12,11,6,14918,15186,12422,-2764
2020,12,11,7,14450,14714,11932,-2782
2020,12,11,8,14162,14452,11856,-2596
2020,12,11,9,14059,14357,11684,-2673
2020,12,11,10,14253,14611,12131,-2480
2020,12,11,11,14923,15338,12616,-2722
2020,12,11,12,16156,16597,14241,-2356
2020,12,11,13,17185,17628,15340,-2288
2020,12,11,14,17569,18018,15252,-2766
2020,12,11,15,17582,17913,15070,-2843
2020,12,11,16,17475,17623,14695,-2928
2020,12,11,17,17342,17333,14380,-2953
2020,12,11,18,17180,17158,14108,-3050
2020,12,11,19,17174,17144,14200,-2944
2020,12,11,20,17212,17216,14467,-2749
2020,12,11,21,17449,17456,14599,-2857
2020,12,11,22,18260,18357,14980,-3377
2020,12,11,23,18979,19357,15901,-3456
2020,12,12,0,18601,19131,15790,-3341
2020,12,12,1,18178,18646,15761,-2885
2020,12,12,2,17663,18074,14900,-3174
2020,12,12,3,16971,17353,13995,-3358
2020,12,12,4,16055,16433,12926,-3507
2020,12,12,5,15087,15444,12050,-3394
2020,12,12,6,14313,14689,11386,-3303
2020,12,12,7,13857,14133,10991,-3142
2020,12,12,8,13555,13820,10563,-3257
2020,12,12,9,13385,13671,10338,-3333
2020,12,12,10,13411,13710,10473,-3237
2020,12,12,11,13646,14018,10509,-3509
2020,12,12,12,14162,14530,11345,-3185
2020,12,12,13,14803,15130,12409,-2721
2020,12,12,14,15427,15827,13244,-2583
2020,12,12,15,16026,16440,13789,-2651
2020,12,12,16,16463,16860,13922,-2938
2020,12,12,17,16634,17023,14010,-3013
2020,12,12,18,16626,17077,14124,-2953
2020,12,12,19,16570,16987,14121,-2866
2020,12,12,20,16498,16912,14264,-2648
2020,12,12,21,16626,16985,14182,-2803
2020,12,12,22,17290,17622,14776,-2846
2020,12,12,23,17819,18365,15494,-2871
2020,12,13,0,17533,18174,15429,-2745
2020,12,13,1,17152,17770,15410,-2360
2020,12,13,2,16731,17211,15436,-1775
2020,12,13,3,16184,16594,14888,-1706
2020,12,13,4,15435,15717,13786,-1931
2020,12,13,5,14629,14854,12631,-2223
2020,12,13,6,13759,14127,11682,-2445
2020,12,13,7,13227,13560,11040,-2520
2020,12,13,8,12867,13216,10741,-2475
2020,12,13,9,12661,13033,10929,-2104
2020,12,13,10,12633,13015,10583,-2432
2020,12,13,11,12790,13237,11041,-2196
2020,12,13,12,13160,13688,11784,-1904
2020,12,13,13,13647,14129,12710,-1419
2020,12,13,14,14176,14591,13004,-1587
2020,12,13,15,14693,15018,13635,-1383
2020,12,13,16,15054,15325,13613,-1712
2020,12,13,17,15260,15608,13827,-1781
2020,12,13,18,15400,15807,13898,-1909
2020,12,13,19,15528,15830,14095,-1735
2020,12,13,20,15676,15953,13985,-1968
2020,12,13,21,16015,16409,14698,-1711
2020,12,13,22,16949,17454,15317,-2137
2020,12,13,23,17840,18450,16174,-2276
2020,12,14,0,17778,18368,15703,-2665
2020,12,14,1,17445,18034,15552,-2482
2020,12,14,2,17052,17541,15548,-1993
2020,12,14,3,16386,16805,14804,-2001
2020,12,14,4,15450,15902,14043,-1859
2020,12,14,5,14539,14936,12707,-2229
2020,12,14,6,13839,14235,11525,-2710
2020,12,14,7,13441,13781,11442,-2339
2020,12,14,8,13214,13540,10942,-2598
2020,12,14,9,13163,13489,11086,-2403
2020,12,14,10,13422,13735,11065,-2670
2020,12,14,11,14148,14508,12123,-2385
2020,12,14,12,15440,15848,13105,-2743
2020,12,14,13,16646,17201,14522,-2679
2020,12,14,14,17386,18102,15144,-2958
2020,12,14,15,17803,18620,15720,-2900
2020,12,14,16,18033,18911,15940,-2971
2020,12,14,17,18107,19109,16020,-3089
2020,12,14,18,18080,19239,15817,-3422
2020,12,14,19,18091,19285,16000,-3285
2020,12,14,20,18065,19295,15780,-3515
2020,12,14,21,18272,19423,16308,-3115
2020,12,14,22,19154,20058,17140,-2918
2020,12,14,23,19994,20910,17854,-3056
2020,12,15,0,19757,20648,17789,-2859
2020,12,15,1,19221,20137,17630,-2507
2020,12,15,2,18591,19445,17345,-2100
2020,12,15,3,17744,18564,16651,-1913
2020,12,15,4,16578,17428,15840,-1588
2020,12,15,5,15453,16261,14463,-1798
2020,12,15,6,14788,15482,13283,-2199
2020,12,15,7,14324,14959,12967,-1992
2020,12,15,8,14070,14719,12431,-2288
2020,12,15,9,14010,14662,12657,-2005
2020,12,15,10,14270,14919,12389,-2530
2020,12,15,11,15019,15702,13744,-1958
2020,12,15,12,16345,17098,15091,-2007
2020,12,15,13,17486,18266,16333,-1933
2020,12,15,14,18010,18699,16437,-2262
2020,12,15,15,18092,18872,16318,-2554
2020,12,15,16,18034,18715,15844,-2871
2020,12,15,17,17967,18593,15872,-2721
2020,12,15,18,17894,18488,15737,-2751
2020,12,15,19,17935,18515,15283,-3232
2020,12,15,20,18071,18742,15584,-3158
2020,12,15,21,18397,19159,16070,-3089
2020,12,15,22,19390,20231,17527,-2704
2020,12,15,23,20494,21268,18745,-2523
2020,12,16,0,20424,21247,18343,-2904
2020,12,16,1,19955,20812,18362,-2450
2020,12,16,2,19368,20229,17846,-2383
2020,12,16,3,18535,19331,17195,-2136
2020,12,16,4,17377,18147,16116,-2031
2020,12,16,5,16256,16977,14395,-2582
2020,12,16,6,15637,16193,12926,-3267
2020,12,16,7,15188,15744,12653,-3091
2020,12,16,8,14930,15523,11990,-3533
2020,12,16,9,14862,15506,12286,-3220
2020,12,16,10,15091,15789,12179,-3610
2020,12,16,11,15800,16541,13494,-3047
2020,12,16,12,17061,17886,14908,-2978
2020,12,16,13,18213,19090,15707,-3383
2020,12,16,14,18822,19653,15783,-3870
2020,12,16,15,19033,20193,15843,-4350
2020,12,16,16,19124,20433,16036,-4397
2020,12,16,17,19160,20510,16285,-4225
2020,12,16,18,19153,20671,16341,-4330
2020,12,16,19,19165,20812,16845,-3967
2020,12,16,20,19174,20845,17085,-3760
2020,12,16,21,19340,21035,17492,-3543
2020,12,16,22,20172,21834,18142,-3692
2020,12,16,23,21108,22541,19037,-3504
2020,12,17,0,20905,22242,18667,-3575
2020,12,17,1,20367,21719,18209,-3510
2020,12,17,2,19673,21031,17355,-3676
2020,12,17,3,18832,20148,16167,-3981
2020,12,17,4,17682,18967,15280,-3687
2020,12,17,5,16515,17833,14261,-3572
2020,12,17,6,15793,16956,13203,-3753
2020,12,17,7,15283,16390,12319,-4071
2020,12,17,8,14994,15981,12103,-3878
2020,12,17,9,14902,15882,12032,-3850
2020,12,17,10,15103,16075,12127,-3948
2020,12,17,11,15775,16640,12937,-3703
2020,12,17,12,16993,17575,13905,-3670
2020,12,17,13,18199,18456,14652,-3804
2020,12,17,14,18940,19171,15056,-4115
2020,12,17,15,19333,19795,15437,-4358
2020,12,17,16,19448,20107,15943,-4164
2020,12,17,17,19424,20225,15846,-4379
2020,12,17,18,19348,20238,15514,-4724
2020,12,17,19,19297,20130,14982,-5148
2020,12,17,20,19289,20067,15132,-4935
2020,12,17,21,19460,20116,15513,-4603
2020,12,17,22,20325,20971,16857,-4114
2020,12,17,23,21325,22023,18477,-3546
2020,12,18,0,21248,21779,18223,-3556
2020,12,18,1,20755,21291,16725,-4566
2020,12,18,2,20128,20694,15480,-5214
2020,12,18,3,19306,19824,14562,-5262
2020,12,18,4,18186,18618,13973,-4645
2020,12,18,5,17064,17502,13329,-4173
2020,12,18,6,16447,16625,12324,-4301
2020,12,18,7,15941,16128,11688,-4440
2020,12,18,8,15657,15860,11519,-4341
2020,12,18,9,15561,15796,11186,-4610
2020,12,18,10,15761,15987,11894,-4093
2020,12,18,11,16427,16668,12763,-3905
2020,12,18,12,17610,17893,13847,-4046
2020,12,18,13,18757,19041,14868,-4173
2020,12,18,14,19321,19854,15433,-4421
2020,12,18,15,19491,20366,15264,-5102
2020,12,18,16,19411,20525,15322,-5203
2020,12,18,17,19237,20513,15204,-5309
2020,12,18,18,19015,20348,15669,-4679
2020,12,18,19,18895,20157,15629,-4528
2020,12,18,20,18903,19975,15488,-4487
2020,12,18,21,19145,20056,15583,-4473
2020,12,18,22,19991,20867,16215,-4652
2020,12,18,23,20971,21900,17495,-4405
2020,12,19,0,20815,21768,17481,-4287
2020,12,19,1,20422,21353,16591,-4762
2020,12,19,2,19885,20872,15455,-5417
2020,12,19,3,19241,20165,14883,-5282
2020,12,19,4,18365,19193,14051,-5142
2020,12,19,5,17415,18082,13540,-4542
2020,12,19,6,16645,17274,12538,-4736
2020,12,19,7,16132,16685,11760,-4925
2020,12,19,8,15838,16384,11455,-4929
2020,12,19,9,15698,16238,11556,-4682
2020,12,19,10,15742,16306,11710,-4596
2020,12,19,11,15992,16635,12176,-4459
2020,12,19,12,16510,17292,13004,-4288
2020,12,19,13,17135,17951,13601,-4350
2020,12,19,14,17630,18563,14232,-4331
2020,12,19,15,17922,18956,14472,-4484
2020,12,19,16,18013,19060,14992,-4068
2020,12,19,17,17948,18992,15327,-3665
2020,12,19,18,17848,18833,14909,-3924
2020,12,19,19,17754,18780,14857,-3923
2020,12,19,20,17780,18767,14894,-3873
2020,12,19,21,18031,18970,15189,-3781
2020,12,19,22,18874,19847,15807,-4040
2020,12,19,23,19743,20648,16406,-4242
2020,12,20,0,19639,20551,16673,-3878
2020,12,20,1,19309,20188,16473,-3715
2020,12,20,2,18854,19739,15974,-3765
2020,12,20,3,18285,19019,15444,-3575
2020,12,20,4,17493,18177,14380,-3797
2020,12,20,5,16616,17137,13026,-4111
2020,12,20,6,15987,16287,12725,-3562
2020,12,20,7,15421,15694,12297,-3397
2020,12,20,8,15065,15329,11839,-3490
2020,12,20,9,14869,15017,11870,-3147
2020,12,20,10,14832,15005,11925,-3080
2020,12,20,11,14965,15235,12023,-3212
2020,12,20,12,15319,15668,12761,-2907
2020,12,20,13,15793,16260,13425,-2835
2020,12,20,14,16397,16977,14013,-2964
2020,12,20,15,16948,17664,14588,-3076
2020,12,20,16,17310,18167,15039,-3128
2020,12,20,17,17481,18447,15377,-3070
2020,12,20,18,17596,18667,15375,-3292
2020,12,20,19,17575,18782,15349,-3433
2020,12,20,20,17590,18797,15200,-3597
2020,12,20,21,17787,18789,15419,-3370
2020,12,20,22,18665,19473,15899,-3574
2020,12,20,23,19491,20321,16827,-3494
2020,12,21,0,19337,20133,16921,-3212
2020,12,21,1,18954,19692,16415,-3277
2020,12,21,2,18470,19178,15768,-3410
2020,12,21,3,17752,18322,14591,-3731
2020,12,21,4,16791,17245,13776,-3469
2020,12,21,5,15820,16205,12631,-3574
2020,12,21,6,15120,15413,12137,-3276
2020,12,21,7,14629,14953,11884,-3069
2020,12,21,8,14351,14671,11579,-3092
2020,12,21,9,14294,14600,11714,-2886
2020,12,21,10,14518,14820,11759,-3061
2020,12,21,11,15209,15483,11936,-3547
2020,12,21,12,16350,16748,13343,-3405
2020,12,21,13,17470,17992,14490,-3502
2020,12,21,14,18122,18712,15312,-3400
2020,12,21,15,18463,19072,15486,-3586
2020,12,21,16,18566,19239,15502,-3737
2020,12,21,17,18570,19257,15222,-4035
2020,12,21,18,18495,19015,14873,-4142
2020,12,21,19,18439,18760,14705,-4055
2020,12,21,20,18458,18668,14929,-3739
2020,12,21,21,18672,18905,15217,-3688
2020,12,21,22,19556,19808,15726,-4082
2020,12,21,23,20471,20771,16760,-4011
2020,12,22,0,20296,20567,16637,-3930
2020,12,22,1,19841,20130,16324,-3806
2020,12,22,2,19222,19517,15914,-3603
2020,12,22,3,18428,18653,15093,-3560
2020,12,22,4,17331,17461,13927,-3534
2020,12,22,5,16182,16280,13102,-3178
2020,12,22,6,15250,15348,12497,-2851
2020,12,22,7,14681,14816,11849,-2967
2020,12,22,8,14354,14517,11629,-2888
2020,12,22,9,14251,14410,11684,-2726
2020,12,22,10,14438,14611,11895,-2716
2020,12,22,11,15099,15283,12227,-3056
2020,12,22,12,16220,16559,13385,-3174
2020,12,22,13,17371,17766,14736,-3030
2020,12,22,14,18062,18410,15326,-3084
2020,12,22,15,18449,18634,15639,-2995
2020,12,22,16,18464,18556,15851,-2705
2020,12,22,17,18414,18559,15548,-3011
2020,12,22,18,18312,18592,15331,-3261
2020,12,22,19,18236,18714,15595,-3119
2020,12,22,20,18272,18769,15861,-2908
2020,12,22,21,18466,19058,16049,-3009
2020,12,22,22,19282,19886,16772,-3114
2020,12,22,23,20277,20745,17632,-3113
2020,12,23,0,20103,20514,17554,-2960
2020,12,23,1,19653,20082,17128,-2954
2020,12,23,2,19118,19488,16903,-2585
2020,12,23,3,18360,18546,15849,-2697
2020,12,23,4,17288,17567,15114,-2453
2020,12,23,5,16182,16436,13875,-2561
2020,12,23,6,15324,15621,12735,-2886
2020,12,23,7,14804,15098,11738,-3360
2020,12,23,8,14530,14805,11223,-3582
2020,12,23,9,14466,14713,11008,-3705
2020,12,23,10,14697,14927,11332,-3595
2020,12,23,11,15391,15631,12420,-3211
2020,12,23,12,16552,16852,13572,-3280
2020,12,23,13,17605,17964,14673,-3291
2020,12,23,14,18120,18442,14507,-3935
2020,12,23,15,18277,18505,14306,-4199
2020,12,23,16,18212,18455,14480,-3975
2020,12,23,17,18188,18347,14609,-3738
2020,12,23,18,18154,18145,14519,-3626
2020,12,23,19,18166,18130,14636,-3494
2020,12,23,20,18241,18228,14549,-3679
2020,12,23,21,18413,18474,15004,-3470
2020,12,23,22,19199,19381,15803,-3578
2020,12,23,23,20148,20402,16632,-3770
2020,12,24,0,19862,20220,16741,-3479
2020,12,24,1,19445,19815,16806,-3009
2020,12,24,2,18905,19261,16474,-2787
2020,12,24,3,18153,18482,15933,-2549
2020,12,24,4,17078,17407,15402,-2005
2020,12,24,5,15935,16305,14304,-2001
2020,12,24,6,14799,15410,13494,-1916
2020,12,24,7,14161,14760,12952,-1808
2020,12,24,8,13761,14330,12419,-1911
2020,12,24,9,13602,14151,12406,-1745
2020,12,24,10,13651,14182,12475,-1707
2020,12,24,11,14068,14581,13036,-1545
2020,12,24,12,14908,15382,13831,-1551
2020,12,24,13,15787,16169,14168,-2001
2020,12,24,14,16569,16726,14535,-2191
2020,12,24,15,17150,17129,14883,-2246
2020,12,24,16,17428,17268,15077,-2191
2020,12,24,17,17599,17477,15509,-1968
2020,12,24,18,17614,17482,15682,-1800
2020,12,24,19,17561,17486,15401,-2085
2020,12,24,20,17506,17538,15281,-2257
2020,12,24,21,17531,17713,15207,-2506
2020,12,24,22,18092,18414,16029,-2385
2020,12,24,23,18495,18718,16834,-1884
2020,12,25,0,17897,18210,16109,-2101
2020,12,25,1,17162,17665,15686,-1979
2020,12,25,2,16642,17121,14990,-2131
2020,12,25,3,16094,16552,14609,-1943
2020,12,25,4,15412,15826,13748,-2078
2020,12,25,5,14637,15048,12792,-2256
2020,12,25,6,13929,14277,12301,-1976
2020,12,25,7,13362,13673,11453,-2220
2020,12,25,8,12921,13286,11014,-2272
2020,12,25,9,12700,13063,10839,-2224
2020,12,25,10,12640,13022,11004,-2018
2020,12,25,11,12781,13190,11015,-2175
2020,12,25,12,13077,13622,11382,-2240
2020,12,25,13,13522,14213,11858,-2355
2020,12,25,14,14189,14877,12376,-2501
2020,12,25,15,14839,15548,12856,-2692
2020,12,25,16,15192,16006,13001,-3005
2020,12,25,17,15361,16378,13030,-3348
2020,12,25,18,15461,16582,13234,-3348
2020,12,25,19,15392,16631,13406,-3225
2020,12,25,20,15330,16657,12969,-3688
2020,12,25,21,15379,16719,13138,-3581
2020,12,25,22,15844,17236,13469,-3767
2020,12,25,23,16368,17877,13974,-3903
2020,12,26,0,16075,17726,13896,-3830
2020,12,26,1,15869,17531,13958,-3573
2020,12,26,2,15680,17332,13865,-3467
2020,12,26,3,15502,17037,13474,-3563
2020,12,26,4,15128,16520,13200,-3320
2020,12,26,5,14610,15828,12940,-2888
2020,12,26,6,14469,15262,12239,-3023
2020,12,26,7,14125,14889,12044,-2845
2020,12,26,8,13923,14690,12216,-2474
2020,12,26,9,13791,14613,12295,-2318
2020,12,26,10,13864,14719,12451,-2268
2020,12,26,11,14130,15058,12944,-2114
2020,12,26,12,14588,15653,13079,-2574
2020,12,26,13,15161,16294,13190,-3104
2020,12,26,14,15830,16835,13830,-3005
2020,12,26,15,16308,17245,14234,-3011
2020,12,26,16,16550,17539,14661,-2878
2020,12,26,17,16627,17674,14830,-2844
2020,12,26,18,16623,17757,14758,-2999
2020,12,26,19,16624,17838,14404,-3434
2020,12,26,20,16774,17942,14505,-3437
2020,12,26,21,16962,18291,14896,-3395
2020,12,26,22,17635,19194,15412,-3782
2020,12,26,23,18445,20172,16521,-3651
2020,12,27,0,18387,20144,16591,-3553
2020,12,27,1,18079,19837,16159,-3678
2020,12,27,2,17813,19405,15879,-3526
2020,12,27,3,17293,18774,15394,-3380
2020,12,27,4,16660,17938,14544,-3394
2020,12,27,5,15922,17013,13818,-3195
2020,12,27,6,15413,16263,12831,-3432
2020,12,27,7,14814,15716,12468,-3248
2020,12,27,8,14462,15391,12201,-3190
2020,12,27,9,14216,15189,12113,-3076
2020,12,27,10,14209,15179,12161,-3018
2020,12,27,11,14394,15378,12710,-2668
2020,12,27,12,14693,15775,12995,-2780
2020,12,27,13,15138,16250,13593,-2657
2020,12,27,14,15631,16661,13859,-2802
2020,12,27,15,15989,16956,14434,-2522
2020,12,27,16,16156,17091,14348,-2743
2020,12,27,17,16237,17129,14171,-2958
2020,12,27,18,16309,17102,13687,-3415
2020,12,27,19,16429,17057,13547,-3510
2020,12,27,20,16644,17178,13829,-3349
2020,12,27,21,16940,17569,14088,-3481
2020,12,27,22,17932,18562,15122,-3440
2020,12,27,23,19052,19744,16282,-3462
2020,12,28,0,19020,19687,16231,-3456
2020,12,28,1,18683,19304,15900,-3404
2020,12,28,2,18268,18867,15723,-3144
2020,12,28,3,17481,18126,15264,-2862
2020,12,28,4,16489,17174,14680,-2494
2020,12,28,5,15450,16234,14037,-2197
2020,12,28,6,14953,15502,13736,-1766
2020,12,28,7,14441,15009,13346,-1663
2020,12,28,8,14148,14710,13041,-1669
2020,12,28,9,13938,14605,12684,-1921
2020,12,28,10,14139,14753,12755,-1998
2020,12,28,11,14812,15297,13304,-1993
2020,12,28,12,15874,16248,13526,-2722
2020,12,28,13,16891,17203,14103,-3100
2020,12,28,14,17503,17796,14655,-3141
2020,12,28,15,17873,18280,15196,-3084
2020,12,28,16,18097,18633,15581,-3052
2020,12,28,17,18141,18762,15587,-3175
2020,12,28,18,18118,18542,14837,-3705
2020,12,28,19,18074,18307,14771,-3536
2020,12,28,20,18104,18268,15256,-3012
2020,12,28,21,18181,18459,15690,-2769
2020,12,28,22,18905,19187,16042,-3145
2020,12,28,23,19912,20133,16712,-3421
2020,12,29,0,19795,19904,16452,-3452
2020,12,29,1,19318,19437,16454,-2983
2020,12,29,2,18801,18786,16213,-2573
2020,12,29,3,17980,17989,15223,-2766
2020,12,29,4,16875,16964,14604,-2360
2020,12,29,5,15758,15949,13545,-2404
2020,12,29,6,15047,15217,12915,-2302
2020,12,29,7,14542,14722,12209,-2513
2020,12,29,8,14275,14461,12168,-2293
2020,12,29,9,14207,14427,12230,-2197
2020,12,29,10,14429,14633,12321,-2312
2020,12,29,11,15101,15267,12754,-2513
2020,12,29,12,16249,16319,13597,-2722
2020,12,29,13,17225,17283,14609,-2674
2020,12,29,14,17677,17848,15155,-2693
2020,12,29,15,17867,18066,15310,-2756
2020,12,29,16,17942,18247,15446,-2801
2020,12,29,17,17995,18262,15505,-2757
2020,12,29,18,17983,18351,15508,-2843
2020,12,29,19,18031,18422,15434,-2988
2020,12,29,20,18123,18564,15602,-2962
2020,12,29,21,18407,18918,15870,-3048
2020,12,29,22,19350,19853,16364,-3489
2020,12,29,23,20410,21029,17488,-3541
2020,12,30,0,20346,20918,17178,-3740
2020,12,30,1,19984,20518,17175,-3343
2020,12,30,2,19491,19928,16764,-3164
2020,12,30,3,18768,19138,16114,-3024
2020,12,30,4,17728,18064,15235,-2829
2020,12,30,5,16666,17042,14227,-2815
2020,12,30,6,15710,16232,13482,-2750
2020,12,30,7,15192,15738,13022,-2716
2020,12,30,8,14895,15434,12648,-2786
2020,12,30,9,14777,15342,12504,-2838
2020,12,30,10,14944,15506,12525,-2981
2020,12,30,11,15548,16086,13040,-3046
2020,12,30,12,16611,17054,13578,-3476
2020,12,30,13,17557,17940,14479,-3461
2020,12,30,14,18090,18580,15394,-3186
2020,12,30,15,18385,18951,16024,-2927
2020,12,30,16,18504,18950,15941,-3009
2020,12,30,17,18492,18834,15562,-3272
2020,12,30,18,18367,18830,15784,-3046
2020,12,30,19,18310,18859,15806,-3053
2020,12,30,20,18298,18948,15986,-2962
2020,12,30,21,18484,19089,16543,-2546
2020,12,30,22,19327,19739,16916,-2823
2020,12,30,23,20190,20657,17695,-2962
2020,12,31,0,19914,20376,17216,-3160
2020,12,31,1,19383,19867,17047,-2820
2020,12,31,2,18779,19137,16357,-2780
2020,12,31,3,18021,18243,15568,-2675
2020,12,31,4,16942,17136,14774,-2362
2020,12,31,5,15802,16127,14238,-1889
2020,12,31,6,14714,15310,13770,-1540
2020,12,31,7,14125,14711,12717,-1994
2020,12,31,8,13786,14332,12524,-1808
2020,12,31,9,13645,14187,12639,-1548
2020,12,31,10,13765,14277,12882,-1395
2020,12,31,11,14333,14727,13097,-1630
2020,12,31,12,15400,15571,13217,-2354
2020,12,31,13,16293,16500,14050,-2450
2020,12,31,14,16786,17212,14881,-2331
2020,12,31,15,17167,17778,15360,-2418
2020,12,31,16,17310,18126,15546,-2580
2020,12,31,17,17410,18233,16076,-2157
2020,12,31,18,17384,18161,15851,-2310
2020,12,31,19,17392,18114,15633,-2481
2020,12,31,20,17437,18136,15649,-2487
2020,12,31,21,17633,18368,15751,-2617
2020,12,31,22,18362,19070,16599,-2471
2020,12,31,23,19216,19765,17443,-2322
2021,1,1,0,18906,19408,17189,-2219
2021,1,1,1,18176,18815,16473,-2342
2021,1,1,2,17512,18210,15910,-2300
2021,1,1,3,16876,17584,14999,-2585
2021,1,1,4,16290,16933,14043,-2890
2021,1,1,5,15802,16276,13317,-2959
2021,1,1,6,15190,15592,12661,-2931
2021,1,1,7,14715,15016,12019,-2997
2021,1,1,8,14293,14603,11629,-2974
2021,1,1,9,14026,14358,11698,-2660
2021,1,1,10,13926,14371,11932,-2439
2021,1,1,11,14091,14611,12294,-2317
2021,1,1,12,14500,15014,12644,-2370
2021,1,1,13,14672,15315,13141,-2174
2021,1,1,14,14757,15505,13765,-1740
2021,1,1,15,14969,15695,13960,-1735
2021,1,1,16,15207,16014,14073,-1941
2021,1,1,17,15457,16570,14625,-1945
2021,1,1,18,15621,16883,14403,-2480
2021,1,1,19,15734,17053,14683,-2370
2021,1,1,20,15863,17253,14863,-2390
2021,1,1,21,16123,17598,15187,-2411
2021,1,1,22,16813,18395,16000,-2395
2021,1,1,23,17648,19006,17088,-1918
2021,1,2,0,17421,18837,16615,-2222
2021,1,2,1,17114,18516,16301,-2215
2021,1,2,2,16702,18095,15765,-2330
2021,1,2,3,16191,17560,15213,-2347
2021,1,2,4,15505,16744,14362,-2382
2021,1,2,5,14781,15854,13460,-2394
2021,1,2,6,14232,15101,12856,-2245
2021,1,2,7,13760,14587,12716,-1871
2021,1,2,8,13473,14212,12427,-1785
2021,1,2,9,13323,14039,12344,-1695
2021,1,2,10,13329,14031,12364,-1667
2021,1,2,11,13553,14217,12626,-1591
2021,1,2,12,13802,14703,12997,-1706
2021,1,2,13,14293,15218,13490,-1728
2021,1,2,14,14874,15692,13982,-1710
2021,1,2,15,15416,16059,14283,-1776
2021,1,2,16,15650,16260,14172,-2088
2021,1,2,17,15735,16426,14302,-2124
2021,1,2,18,15705,16361,13824,-2537
2021,1,2,19,15618,16347,13852,-2495
2021,1,2,20,15600,16320,14039,-2281
2021,1,2,21,15729,16691,14422,-2269
2021,1,2,22,16290,17597,15085,-2512
2021,1,2,23,17355,18634,16085,-2549
2021,1,3,0,17329,18597,16102,-2495
2021,1,3,1,17023,18266,15837,-2429
2021,1,3,2,16691,17855,15448,-2407
2021,1,3,3,16239,17305,15018,-2287
2021,1,3,4,15697,16529,14404,-2125
2021,1,3,5,15095,15710,13537,-2173
2021,1,3,6,14595,14992,13067,-1925
2021,1,3,7,14152,14511,12424,-2087
2021,1,3,8,13863,14241,12210,-2031
2021,1,3,9,13719,14074,11949,-2125
2021,1,3,10,13732,14070,12358,-1712
2021,1,3,11,13851,14301,12448,-1853
2021,1,3,12,14216,14677,12725,-1952
2021,1,3,13,14722,15129,13400,-1729
2021,1,3,14,15267,15714,14023,-1691
2021,1,3,15,15796,16469,14487,-1982
2021,1,3,16,16165,17152,15217,-1935
2021,1,3,17,16426,17590,15512,-2078
2021,1,3,18,16619,17914,15681,-2233
2021,1,3,19,16698,18055,16078,-1977
2021,1,3,20,16762,18137,15784,-2353
2021,1,3,21,17059,18323,16072,-2251
2021,1,3,22,17902,18972,16422,-2550
2021,1,3,23,18678,19655,16811,-2844
2021,1,4,0,18541,19453,16823,-2630
2021,1,4,1,18087,18967,16791,-2176
2021,1,4,2,17633,18388,16689,-1699
2021,1,4,3,16892,17612,15560,-2052
2021,1,4,4,15967,16649,14769,-1880
2021,1,4,5,15055,15728,13501,-2227
2021,1,4,6,14349,15021,12813,-2208
2021,1,4,7,13924,14585,12341,-2244
2021,1,4,8,13707,14341,12015,-2326
2021,1,4,9,13656,14279,12003,-2276
2021,1,4,10,13938,14522,12349,-2173
2021,1,4,11,14832,15215,12971,-2244
2021,1,4,12,16294,16498,14149,-2349
2021,1,4,13,17485,17673,15964,-1709
2021,1,4,14,18006,18332,16455,-1877
2021,1,4,15,18264,18624,16555,-2069
2021,1,4,16,18353,18618,16626,-1992
2021,1,4,17,18347,18559,16543,-2016
2021,1,4,18,18254,18462,16228,-2234
2021,1,4,19,18224,18520,15967,-2553
2021,1,4,20,18207,18660,16032,-2628
2021,1,4,21,18366,18825,15978,-2847
2021,1,4,22,19075,19432,16261,-3171
2021,1,4,23,20128,20357,17251,-3106
2021,1,5,0,19997,20127,17161,-2966
2021,1,5,1,19468,19577,17070,-2507
2021,1,5,2,18742,18879,16832,-2047
2021,1,5,3,17854,17991,15879,-2112
2021,1,5,4,16745,16891,14761,-2130
2021,1,5,5,15684,15866,13451,-2415
2021,1,5,6,14893,15094,12748,-2346
2021,1,5,7,14415,14619,12030,-2589
2021,1,5,8,14147,14361,12063,-2298
2021,1,5,9,14075,14293,11719,-2574
2021,1,5,10,14303,14502,11962,-2540
2021,1,5,11,15138,15227,12917,-2310
2021,1,5,12,16557,16467,14216,-2251
2021,1,5,13,17669,17663,15629,-2034
2021,1,5,14,18019,18219,16271,-1948
2021,1,5,15,18172,18449,16368,-2081
2021,1,5,16,18195,18545,16475,-2070
2021,1,5,17,18148,18662,16375,-2287
2021,1,5,18,18076,18649,16585,-2064
2021,1,5,19,18000,18673,16764,-1909
2021,1,5,20,17953,18743,16695,-2048
2021,1,5,21,18123,18974,16740,-2234
2021,1,5,22,18775,19618,17023,-2595
2021,1,5,23,19841,20416,17419,-2997
2021,1,6,0,19721,20155,17404,-2751
2021,1,6,1,19298,19615,16824,-2791
2021,1,6,2,18640,18987,16853,-2134
2021,1,6,3,17772,18094,15914,-2180
2021,1,6,4,16712,17009,15229,-1780
2021,1,6,5,15704,15982,13792,-2190
2021,1,6,6,15112,15236,12959,-2277
2021,1,6,7,14675,14768,12560,-2208
2021,1,6,8,14434,14455,12064,-2391
2021,1,6,9,14355,14395,11856,-2539
2021,1,6,10,14555,14646,12093,-2553
2021,1,6,11,15168,15359,12831,-2528
2021,1,6,12,16386,16641,14070,-2571
2021,1,6,13,17405,17812,15385,-2427
2021,1,6,14,17795,18451,15961,-2490
2021,1,6,15,17859,18696,15909,-2787
2021,1,6,16,17782,18766,15954,-2812
2021,1,6,17,17701,18730,15836,-2894
2021,1,6,18,17571,18656,15688,-2968
2021,1,6,19,17469,18644,15742,-2902
2021,1,6,20,17530,18738,15792,-2946
2021,1,6,21,17716,18984,16343,-2641
2021,1,6,22,18259,19682,16907,-2775
2021,1,6,23,19302,20721,17759,-2962
2021,1,7,0,19227,20494,17700,-2794
2021,1,7,1,18860,19965,17242,-2723
2021,1,7,2,18375,19311,16938,-2373
2021,1,7,3,17567,18422,16204,-2218
2021,1,7,4,16549,17365,15138,-2227
2021,1,7,5,15589,16292,14090,-2202
2021,1,7,6,15003,15568,13055,-2513
2021,1,7,7,14555,15132,12569,-2563
2021,1,7,8,14309,14846,12424,-2422
2021,1,7,9,14240,14760,12400,-2360
2021,1,7,10,14470,15019,12598,-2421
2021,1,7,11,15143,15744,13417,-2327
2021,1,7,12,16431,17048,14630,-2418
2021,1,7,13,17558,18259,15482,-2777
2021,1,7,14,18020,18880,16005,-2875
2021,1,7,15,18040,18976,15837,-3139
2021,1,7,16,17928,18878,15620,-3258
2021,1,7,17,17822,18726,15490,-3236
2021,1,7,18,17692,18612,15006,-3606
2021,1,7,19,17629,18573,15085,-3488
2021,1,7,20,17694,18606,15144,-3462
2021,1,7,21,17939,18907,15611,-3296
2021,1,7,22,18568,19652,16448,-3204
2021,1,7,23,19587,20641,17141,-3500
2021,1,8,0,19562,20511,17238,-3273
2021,1,8,1,19159,20081,17063,-3018
2021,1,8,2,18655,19480,16493,-2987
2021,1,8,3,17839,18651,15870,-2781
2021,1,8,4,16817,17576,14927,-2649
2021,1,8,5,15857,16565,14025,-2540
2021,1,8,6,15287,15862,13493,-2369
2021,1,8,7,14858,15423,12822,-2601
2021,1,8,8,14595,15177,12397,-2780
2021,1,8,9,14527,15121,12444,-2677
2021,1,8,10,14761,15343,12470,-2873
2021,1,8,11,15418,16083,13553,-2530
2021,1,8,12,16626,17353,14809,-2544
2021,1,8,13,17702,18525,16011,-2514
2021,1,8,14,18212,19150,16478,-2672
2021,1,8,15,18285,19294,16204,-3090
2021,1,8,16,18180,19293,16187,-3106
2021,1,8,17,18043,19171,15944,-3227
2021,1,8,18,17892,19193,16035,-3158
2021,1,8,19,17795,19210,15968,-3242
2021,1,8,20,17797,19195,15975,-3220
2021,1,8,21,17976,19420,16283,-3137
2021,1,8,22,18522,20020,16655,-3365
2021,1,8,23,19400,20757,17295,-3462
2021,1,9,0,19216,20518,17358,-3160
2021,1,9,1,18787,20115,16915,-3200
2021,1,9,2,18304,19537,16550,-2987
2021,1,9,3,17645,18837,16446,-2391
2021,1,9,4,16851,17939,15347,-2592
2021,1,9,5,16036,17117,14731,-2386
2021,1,9,6,15551,16417,13356,-3061
2021,1,9,7,15084,15938,12861,-3077
2021,1,9,8,14791,15663,12626,-3037
2021,1,9,9,14664,15532,12536,-2996
2021,1,9,10,14726,15559,12489,-3070
2021,1,9,11,14925,15858,12874,-2984
2021,1,9,12,15376,16450,13563,-2887
2021,1,9,13,16056,17084,14278,-2806
2021,1,9,14,16741,17535,14440,-3095
2021,1,9,15,17087,17738,14866,-2872
2021,1,9,16,17184,17870,14941,-2929
2021,1,9,17,17171,17848,14863,-2985
2021,1,9,18,17078,17634,14608,-3026
2021,1,9,19,16950,17406,14386,-3020
2021,1,9,20,16965,17421,14480,-2941
2021,1,9,21,17148,17777,14897,-2880
2021,1,9,22,17718,18545,16254,-2291
2021,1,9,23,18620,19591,16952,-2639
2021,1,10,0,18526,19556,16843,-2713
2021,1,10,1,18178,19145,16156,-2989
2021,1,10,2,17767,18709,16109,-2600
2021,1,10,3,17201,18116,15705,-2411
2021,1,10,4,16507,17357,14655,-2702
2021,1,10,5,15809,16548,13470,-3078
2021,1,10,6,15313,15852,12286,-3566
2021,1,10,7,14829,15426,11796,-3630
2021,1,10,8,14513,15135,11369,-3766
2021,1,10,9,14354,14978,11556,-3422
2021,1,10,10,14347,14996,11619,-3377
2021,1,10,11,14472,15189,11971,-3218
2021,1,10,12,14823,15604,12108,-3496
2021,1,10,13,15363,16153,13375,-2778
2021,1,10,14,15998,16612,13942,-2670
2021,1,10,15,16355,16928,14307,-2621
2021,1,10,16,16536,17066,14200,-2866
2021,1,10,17,16637,17124,14124,-3000
2021,1,10,18,16680,17093,14144,-2949
2021,1,10,19,16650,17001,14291,-2710
2021,1,10,20,16744,17074,14458,-2616
2021,1,10,21,17042,17506,15058,-2448
2021,1,10,22,17729,18433,15461,-2972
2021,1,10,23,18777,19600,15852,-3748
2021,1,11,0,18744,19604,16159,-3445
2021,1,11,1,18475,19263,16122,-3141
2021,1,11,2,18020,18805,15904,-2901
2021,1,11,3,17331,18116,15002,-3114
2021,1,11,4,16446,17231,14280,-2951
2021,1,11,5,15662,16377,13482,-2895
2021,1,11,6,15235,15706,12527,-3179
2021,1,11,7,14880,15333,12313,-3020
2021,1,11,8,14667,15088,12157,-2931
2021,1,11,9,14623,15056,12146,-2910
2021,1,11,10,14869,15317,12377,-2940
2021,1,11,11,15596,16120,13166,-2954
2021,1,11,12,16856,17441,14245,-3196
2021,1,11,13,18000,18714,15440,-3274
2021,1,11,14,18569,19385,16380,-3005
2021,1,11,15,18786,19655,16419,-3236
2021,1,11,16,18846,19883,16826,-3057
2021,1,11,17,18822,19848,16539,-3309
2021,1,11,18,18727,19754,16552,-3202
2021,1,11,19,18616,19550,16284,-3266
2021,1,11,20,18551,19373,16132,-3241
2021,1,11,21,18678,19532,16631,-2901
2021,1,11,22,19212,20090,16966,-3124
2021,1,11,23,20098,20916,18059,-2857
2021,1,12,0,19934,20658,17659,-2999
2021,1,12,1,19485,20090,16982,-3108
2021,1,12,2,18863,19427,16757,-2670
2021,1,12,3,17989,18592,16075,-2517
2021,1,12,4,16884,17497,14837,-2660
2021,1,12,5,15919,16464,13932,-2532
2021,1,12,6,15432,15747,13370,-2377
2021,1,12,7,15022,15292,12902,-2390
2021,1,12,8,14775,15070,12866,-2204
2021,1,12,9,14705,15012,12803,-2209
2021,1,12,10,14915,15219,13094,-2125
2021,1,12,11,15595,15968,13616,-2352
2021,1,12,12,16823,17283,14858,-2425
2021,1,12,13,17889,18499,15793,-2706
2021,1,12,14,18303,19051,16212,-2839
2021,1,12,15,18374,19163,16603,-2560
2021,1,12,16,18325,19088,16536,-2552
2021,1,12,17,18243,19017,16383,-2634
2021,1,12,18,18141,18925,16151,-2774
2021,1,12,19,18065,18882,16020,-2862
2021,1,12,20,18059,18843,15713,-3130
2021,1,12,21,18270,18938,16184,-2754
2021,1,12,22,18837,19574,16698,-2876
2021,1,12,23,19758,20537,17418,-3119
2021,1,13,0,19619,20335,17565,-2770
2021,1,13,1,19256,19779,17138,-2641
2021,1,13,2,18688,19097,16542,-2555
2021,1,13,3,17843,18274,16035,-2239
2021,1,13,4,16795,17195,14814,-2381
2021,1,13,5,15871,16194,13788,-2406
2021,1,13,6,15277,15488,13094,-2394
2021,1,13,7,14903,15004,12520,-2484
2021,1,13,8,14667,14761,12353,-2408
2021,1,13,9,14608,14689,12379,-2310
2021,1,13,10,14833,14909,12760,-2149
2021,1,13,11,15506,15630,13294,-2336
2021,1,13,12,16738,16917,14554,-2363
2021,1,13,13,17859,18192,15550,-2642
2021,1,13,14,18361,18895,15883,-3012
2021,1,13,15,18439,19280,16456,-2824
2021,1,13,16,18376,19383,16554,-2829
2021,1,13,17,18268,19312,16555,-2757
2021,1,13,18,18170,19168,16275,-2893
2021,1,13,19,18128,18979,15970,-3009
2021,1,13,20,18111,18903,15772,-3131
2021,1,13,21,18302,18986,15787,-3199
2021,1,13,22,18874,19510,16334,-3176
2021,1,13,23,19761,20451,17204,-3247
2021,1,14,0,19614,20245,16984,-3261
2021,1,14,1,19175,19682,16687,-2995
2021,1,14,2,18591,18994,16665,-2329
2021,1,14,3,17737,18164,16205,-1959
2021,1,14,4,16667,17015,14942,-2073
2021,1,14,5,15693,15978,14081,-1897
2021,1,14,6,14956,15250,13548,-1702
2021,1,14,7,14533,14788,13140,-1648
2021,1,14,8,14272,14511,12766,-1745
2021,1,14,9,14187,14455,12782,-1673
2021,1,14,10,14395,14657,12923,-1734
2021,1,14,11,15055,15346,13544,-1802
2021,1,14,12,16280,16580,14494,-2086
2021,1,14,13,17490,17799,15718,-2081
2021,1,14,14,18110,18409,15907,-2502
2021,1,14,15,18391,18498,16114,-2384
2021,1,14,16,18491,18509,16089,-2420
2021,1,14,17,18494,18563,16145,-2418
2021,1,14,18,18399,18613,15860,-2753
2021,1,14,19,18295,18529,15763,-2766
2021,1,14,20,18166,18335,15509,-2826
2021,1,14,21,18249,18331,15603,-2728
2021,1,14,22,18739,18856,16178,-2678
2021,1,14,23,19534,19810,17028,-2782
2021,1,15,0,19380,19625,16998,-2627
2021,1,15,1,18879,19086,16496,-2590
2021,1,15,2,18273,18492,15943,-2549
2021,1,15,3,17449,17725,15346,-2379
2021,1,15,4,16422,16658,14315,-2343
2021,1,15,5,15496,15628,13409,-2219
2021,1,15,6,14749,14944,13037,-1907
2021,1,15,7,14343,14547,12655,-1892
2021,1,15,8,14089,14302,12424,-1878
2021,1,15,9,14009,14252,12378,-1874
2021,1,15,10,14215,14491,12631,-1860
2021,1,15,11,14887,15201,13361,-1840
2021,1,15,12,16100,16498,14589,-1909
2021,1,15,13,17255,17739,15700,-2039
2021,1,15,14,17978,18407,16105,-2302
2021,1,15,15,18322,18723,16276,-2447
2021,1,15,16,18448,18893,16344,-2549
2021,1,15,17,18440,18935,16284,-2651
2021,1,15,18,18327,18899,16175,-2724
2021,1,15,19,18249,18843,16121,-2722
2021,1,15,20,18125,18838,16044,-2794
2021,1,15,21,18152,18893,16021,-2872
2021,1,15,22,18540,19269,16483,-2786
2021,1,15,23,19091,19771,16936,-2835
2021,1,16,0,18719,19449,16638,-2811
2021,1,16,1,18087,18868,16657,-2211
2021,1,16,2,17444,18294,16575,-1719
2021,1,16,3,16750,17567,15568,-1999
2021,1,16,4,15883,16675,14846,-1829
2021,1,16,5,15037,15794,13834,-1960
2021,1,16,6,14394,15015,12516,-2499
2021,1,16,7,13909,14479,12145,-2334
2021,1,16,8,13606,14195,11623,-2572
2021,1,16,9,13458,14079,11631,-2448
2021,1,16,10,13482,14112,11670,-2442
2021,1,16,11,13705,14404,11885,-2519
2021,1,16,12,14169,14944,12265,-2679
2021,1,16,13,14879,15585,13495,-2090
2021,1,16,14,15622,16210,14328,-1882
2021,1,16,15,16242,16724,14646,-2078
2021,1,16,16,16586,16997,14953,-2044
2021,1,16,17,16656,17069,14832,-2237
2021,1,16,18,16607,17076,14910,-2166
2021,1,16,19,16459,16922,14825,-2097
2021,1,16,20,16455,16958,14958,-2000
2021,1,16,21,16644,17131,15203,-1928
2021,1,16,22,17213,17657,15826,-1831
2021,1,16,23,17946,18577,16559,-2018
2021,1,17,0,17904,18589,16739,-1850
2021,1,17,1,17429,18164,16355,-1809
2021,1,17,2,16993,17727,15928,-1799
2021,1,17,3,16447,17141,15082,-2059
2021,1,17,4,15780,16387,13998,-2389
2021,1,17,5,15089,15696,13202,-2494
2021,1,17,6,14532,15010,12284,-2726
2021,1,17,7,14075,14533,12486,-2047
2021,1,17,8,13767,14222,12236,-1986
2021,1,17,9,13595,14073,12013,-2060
2021,1,17,10,13583,14065,12126,-1939
2021,1,17,11,13716,14301,12482,-1819
2021,1,17,12,14000,14692,12665,-2027
2021,1,17,13,14461,15116,13403,-1713
2021,1,17,14,15094,15588,13674,-1914
2021,1,17,15,15608,16025,13865,-2160
2021,1,17,16,15940,16396,14345,-2051
2021,1,17,17,16172,16605,14048,-2557
2021,1,17,18,16301,16820,14529,-2291
2021,1,17,19,16327,16935,14727,-2208
2021,1,17,20,16457,17067,14840,-2227
2021,1,17,21,16777,17266,14928,-2338
2021,1,17,22,17500,17872,15302,-2570
2021,1,17,23,18443,18659,15920,-2739
2021,1,18,0,18388,18600,15963,-2637
2021,1,18,1,17941,18119,15617,-2502
2021,1,18,2,17411,17634,15114,-2520
2021,1,18,3,16697,16998,14365,-2633
2021,1,18,4,15822,16188,13564,-2624
2021,1,18,5,15010,15358,12843,-2515
2021,1,18,6,14416,14771,12288,-2483
2021,1,18,7,14005,14370,11684,-2686
2021,1,18,8,13771,14134,11474,-2660
2021,1,18,9,13696,14089,11416,-2673
2021,1,18,10,13894,14282,11397,-2885
2021,1,18,11,14436,14902,12318,-2584
2021,1,18,12,15196,15886,14024,-1862
2021,1,18,13,16117,16804,15392,-1412
2021,1,18,14,17050,17280,15240,-2040
2021,1,18,15,17594,17562,15392,-2170
2021,1,18,16,17879,17722,15354,-2368
2021,1,18,17,18045,0,15354,-2408
2021,1,18,18,18021,17961,15066,-2895
2021,1,18,19,17988,18068,15174,-2894
2021,1,18,20,18019,18065,15508,-2557
2021,1,18,21,18132,18222,15403,-2819
2021,1,18,22,18713,18827,16195,-2632
2021,1,18,23,19704,19827,16771,-3056
2021,1,19,0,19607,19780,16578,-3202
2021,1,19,1,19056,19312,16124,-3188
2021,1,19,2,18395,18731,15993,-2738
2021,1,19,3,17594,17953,15267,-2686
2021,1,19,4,16572,16942,14367,-2575
2021,1,19,5,15662,16020,13463,-2557
2021,1,19,6,14823,15371,13040,-2331
2021,1,19,7,14413,14962,12668,-2294
2021,1,19,8,14185,14748,12447,-2301
2021,1,19,9,14129,14676,12416,-2260
2021,1,19,10,14361,14925,12745,-2180
2021,1,19,11,15104,15683,13260,-2423
2021,1,19,12,16406,17025,14154,-2871
2021,1,19,13,17616,18209,15273,-2936
2021,1,19,14,18286,18759,15594,-3165
2021,1,19,15,18467,18809,15430,-3379
2021,1,19,16,18473,18727,15079,-3648
2021,1,19,17,18457,18846,15198,-3648
2021,1,19,18,18412,18953,15372,-3581
2021,1,19,19,18399,19023,15438,-3585
2021,1,19,20,18395,18949,15274,-3675
2021,1,19,21,18559,18977,15315,-3662
2021,1,19,22,19140,19485,15798,-3687
2021,1,19,23,19969,20430,16484,-3946
2021,1,20,0,19845,20342,16481,-3861
2021,1,20,1,19281,19823,16140,-3683
2021,1,20,2,18618,19157,16080,-3077
2021,1,20,3,17776,18220,15145,-3075
2021,1,20,4,16670,17176,14315,-2861
2021,1,20,5,15680,16228,13531,-2697
2021,1,20,6,15021,15538,12918,-2620
2021,1,20,7,14612,15075,12311,-2764
2021,1,20,8,14380,14834,12432,-2402
2021,1,20,9,14329,14760,12342,-2418
2021,1,20,10,14539,14977,12269,-2708
2021,1,20,11,15225,15709,13305,-2404
2021,1,20,12,16456,16989,14093,-2896
2021,1,20,13,17650,18297,15173,-3124
2021,1,20,14,18378,18922,15704,-3218
2021,1,20,15,18661,19176,15792,-3384
2021,1,20,16,18709,18986,15691,-3295
2021,1,20,17,18670,18947,15935,-3012
2021,1,20,18,18588,18862,15686,-3176
2021,1,20,19,18511,19036,15844,-3192
2021,1,20,20,18516,18980,15740,-3240
2021,1,20,21,18690,19232,16068,-3164
2021,1,20,22,19277,19958,16498,-3460
2021,1,20,23,20303,21046,17446,-3600
2021,1,21,0,20295,21028,17361,-3667
2021,1,21,1,19828,20554,16671,-3883
2021,1,21,2,19214,19939,16385,-3554
2021,1,21,3,18421,19045,15453,-3592
2021,1,21,4,17351,17964,14734,-3230
2021,1,21,5,16396,16984,13859,-3125
2021,1,21,6,15804,16271,13518,-2753
2021,1,21,7,15404,15837,13029,-2808
2021,1,21,8,15154,15577,12516,-3061
2021,1,21,9,15067,15510,12466,-3044
2021,1,21,10,15258,15751,13071,-2680
2021,1,21,11,15921,16480,13684,-2796
2021,1,21,12,17125,17805,15297,-2508
2021,1,21,13,18261,19061,16659,-2402
2021,1,21,14,18817,19580,16320,-3260
2021,1,21,15,19011,19872,16410,-3462
2021,1,21,16,19017,19840,16476,-3364
2021,1,21,17,18964,19766,16275,-3491
2021,1,21,18,18831,19590,16127,-3463
2021,1,21,19,18671,19458,16044,-3414
2021,1,21,20,18561,19342,16037,-3305
2021,1,21,21,18630,19331,16038,-3293
2021,1,21,22,19086,19712,16478,-3234
2021,1,21,23,19955,20565,17422,-3143
2021,1,22,0,19890,20473,17147,-3326
2021,1,22,1,19374,19960,16722,-3238
2021,1,22,2,18751,19271,15945,-3326
2021,1,22,3,17940,18360,15176,-3184
2021,1,22,4,16905,17250,14444,-2806
2021,1,22,5,15948,16237,13431,-2806
2021,1,22,6,15295,15492,12789,-2703
2021,1,22,7,14859,15011,12323,-2688
2021,1,22,8,14601,14721,12047,-2674
2021,1,22,9,14523,14675,12016,-2659
2021,1,22,10,14730,14906,12270,-2636
2021,1,22,11,15428,15652,12718,-2934
2021,1,22,12,16644,16887,13861,-3026
2021,1,22,13,17749,18024,14656,-3368
2021,1,22,14,18216,18518,15459,-3059
2021,1,22,15,18300,18649,15047,-3602
2021,1,22,16,18217,18735,15159,-3576
2021,1,22,17,18165,18798,15419,-3379
2021,1,22,18,18100,18837,15287,-3550
2021,1,22,19,18113,18916,15296,-3620
2021,1,22,20,18126,18768,15092,-3676
2021,1,22,21,18272,18699,14999,-3700
2021,1,22,22,18755,19144,15518,-3626
2021,1,22,23,19505,19994,16142,-3852
2021,1,23,0,19410,19960,16137,-3823
2021,1,23,1,18930,19511,16274,-3237
2021,1,23,2,18437,18971,15421,-3550
2021,1,23,3,17829,18257,15087,-3170
2021,1,23,4,17056,17360,14134,-3226
2021,1,23,5,16271,16530,12982,-3548
2021,1,23,6,15754,15847,12429,-3418
2021,1,23,7,15327,15412,12011,-3401
2021,1,23,8,15076,15184,12059,-3125
2021,1,23,9,14981,15095,12250,-2845
2021,1,23,10,15043,15203,12385,-2818
2021,1,23,11,15333,15559,12896,-2663
2021,1,23,12,15883,16281,13520,-2761
2021,1,23,13,16510,16914,14277,-2637
2021,1,23,14,17065,17487,14481,-3006
2021,1,23,15,17508,17737,14689,-3048
2021,1,23,16,17740,17882,14774,-3108
2021,1,23,17,17780,18026,14735,-3291
2021,1,23,18,17764,17996,14707,-3289
2021,1,23,19,17702,17895,14512,-3383
2021,1,23,20,17732,17944,14314,-3630
2021,1,23,21,17975,18329,15045,-3284
2021,1,23,22,18509,19092,16066,-3026
2021,1,23,23,19455,20256,17125,-3131
2021,1,24,0,19567,20478,17353,-3125
2021,1,24,1,19206,20168,17151,-3017
2021,1,24,2,18790,19683,16754,-2929
2021,1,24,3,18196,19041,16084,-2957
2021,1,24,4,17506,18254,15583,-2671
2021,1,24,5,16834,17416,14598,-2818
2021,1,24,6,16223,16756,13784,-2972
2021,1,24,7,15732,16299,13650,-2649
2021,1,24,8,15423,16029,13312,-2717
2021,1,24,9,15275,15863,13264,-2599
2021,1,24,10,15263,15887,13366,-2521
2021,1,24,11,15463,16116,13834,-2282
2021,1,24,12,15872,16572,14042,-2530
2021,1,24,13,16302,17110,14573,-2537
2021,1,24,14,16732,17516,14838,-2678
2021,1,24,15,17001,17663,14883,-2780
2021,1,24,16,17147,17815,14509,-3306
2021,1,24,17,17220,17858,14471,-3387
2021,1,24,18,17309,17850,14627,-3223
2021,1,24,19,17382,17840,14643,-3197
2021,1,24,20,17482,17983,14728,-3255
2021,1,24,21,17756,18430,15162,-3268
2021,1,24,22,18389,19157,15842,-3315
2021,1,24,23,19482,20311,16545,-3766
2021,1,25,0,19699,20443,16931,-3512
2021,1,25,1,19316,20011,16640,-3371
2021,1,25,2,18806,19510,16166,-3344
2021,1,25,3,18047,18820,15510,-3310
2021,1,25,4,17168,17927,15006,-2921
2021,1,25,5,16394,17044,14221,-2823
2021,1,25,6,15882,16460,13640,-2820
2021,1,25,7,15512,16126,13197,-2929
2021,1,25,8,15310,15962,12796,-3166
2021,1,25,9,15286,15918,12888,-3030
2021,1,25,10,15573,16217,13227,-2990
2021,1,25,11,16418,16991,13797,-3194
2021,1,25,12,17777,18358,15209,-3149
2021,1,25,13,18901,19547,16515,-3032
2021,1,25,14,19289,19903,16559,-3344
2021,1,25,15,19249,19696,16124,-3572
2021,1,25,16,19074,19455,15612,-3843
2021,1,25,17,18979,19196,15104,-4092
2021,1,25,18,18782,19023,15017,-4006
2021,1,25,19,18713,19000,15073,-3927
2021,1,25,20,18687,19057,15005,-4052
2021,1,25,21,18851,19345,15406,-3939
2021,1,25,22,19425,20032,15922,-4110
2021,1,25,23,20425,21122,17015,-4107
2021,1,26,0,20532,21034,16772,-4262
2021,1,26,1,20103,20530,16384,-4146
2021,1,26,2,19443,19830,15689,-4141
2021,1,26,3,18514,18908,15123,-3785
2021,1,26,4,17388,17799,14531,-3268
2021,1,26,5,16401,16776,13322,-3454
2021,1,26,6,15947,16087,11977,-4110
2021,1,26,7,15524,15678,11812,-3866
2021,1,26,8,15270,15429,11609,-3820
2021,1,26,9,15193,15343,11542,-3801
2021,1,26,10,15392,15585,11706,-3879
2021,1,26,11,16098,16346,12785,-3561
2021,1,26,12,17295,17636,14168,-3468
2021,1,26,13,18381,18797,15008,-3789
2021,1,26,14,18922,19385,15538,-3847
2021,1,26,15,19227,19757,15782,-3975
2021,1,26,16,19367,20072,16156,-3916
2021,1,26,17,19495,20339,16679,-3660
2021,1,26,18,19484,20493,16921,-3572
2021,1,26,19,19470,20566,17047,-3519
2021,1,26,20,19344,20572,16766,-3806
2021,1,26,21,19337,20532,16639,-3893
2021,1,26,22,19696,20845,16917,-3928
2021,1,26,23,20408,21478,17274,-4204
2021,1,27,0,20282,21251,17025,-4226
2021,1,27,1,19778,20595,16897,-3698
2021,1,27,2,19093,19764,16132,-3632
2021,1,27,3,18147,18796,15400,-3396
2021,1,27,4,17081,17711,14979,-2732
2021,1,27,5,16136,16720,14179,-2541
2021,1,27,6,15377,16023,13574,-2449
2021,1,27,7,14942,15554,13262,-2292
2021,1,27,8,14686,15282,12495,-2787
2021,1,27,9,14598,15196,12217,-2979
2021,1,27,10,14813,15410,12253,-3157
2021,1,27,11,15521,16106,13147,-2959
2021,1,27,12,16752,17320,14751,-2569
2021,1,27,13,17906,18471,15743,-2728
2021,1,27,14,18519,19107,16213,-2894
2021,1,27,15,18816,19507,16715,-2792
2021,1,27,16,18865,19807,16881,-2926
2021,1,27,17,18898,19875,17110,-2765
2021,1,27,18,18823,19867,16657,-3210
2021,1,27,19,18780,19911,16525,-3386
2021,1,27,20,18715,19822,16298,-3524
2021,1,27,21,18795,19837,16807,-3030
2021,1,27,22,19255,20189,16848,-3341
2021,1,27,23,20059,20986,17460,-3526
2021,1,28,0,20178,20971,17523,-3448
2021,1,28,1,19650,20431,17330,-3101
2021,1,28,2,19027,19786,17289,-2497
2021,1,28,3,18138,18920,16281,-2639
2021,1,28,4,17087,17846,15267,-2579
2021,1,28,5,16131,16899,14342,-2557
2021,1,28,6,15649,16252,13144,-3108
2021,1,28,7,15244,15871,12556,-3315
2021,1,28,8,15012,15631,12477,-3154
2021,1,28,9,14963,15606,12690,-2916
2021,1,28,10,15217,15847,13055,-2792
2021,1,28,11,15950,16580,13716,-2864
2021,1,28,12,17226,17912,14901,-3011
2021,1,28,13,18432,19116,16237,-2879
2021,1,28,14,19053,19830,16725,-3105
2021,1,28,15,19268,20161,16982,-3179
2021,1,28,16,19303,20186,16370,-3816
2021,1,28,17,19281,20084,16156,-3928
2021,1,28,18,19159,19854,15837,-4017
2021,1,28,19,19135,19683,15256,-4427
2021,1,28,20,19141,19696,15224,-4472
2021,1,28,21,19328,20021,15828,-4193
2021,1,28,22,19928,20690,16831,-3859
2021,1,28,23,20950,21852,17842,-4010
2021,1,29,0,21152,22080,18127,-3953
2021,1,29,1,20749,21715,18263,-3452
2021,1,29,2,20150,21105,17694,-3411
2021,1,29,3,19272,20286,16418,-3868
2021,1,29,4,18210,19185,15500,-3685
2021,1,29,5,17258,18238,15088,-3150
2021,1,29,6,16725,17571,13501,-4070
2021,1,29,7,16324,17137,13674,-3463
2021,1,29,8,16083,16899,13540,-3359
2021,1,29,9,16024,16841,13445,-3396
2021,1,29,10,16278,17123,13375,-3748
2021,1,29,11,16985,17934,13686,-4248
2021,1,29,12,18214,19287,15224,-4063
2021,1,29,13,19339,20470,16095,-4375
2021,1,29,14,20015,21174,16410,-4764
2021,1,29,15,20210,21424,16122,-5302
2021,1,29,16,20276,21507,15880,-5627
2021,1,29,17,20254,21462,16021,-5441
2021,1,29,18,20139,21202,15849,-5353
2021,1,29,19,20103,20985,15591,-5394
2021,1,29,20,20062,20813,15165,-5648
2021,1,29,21,20153,20995,15349,-5646
2021,1,29,22,20578,21552,15912,-5640
2021,1,29,23,21388,22430,17233,-5197
2021,1,30,0,21480,22500,17305,-5195
2021,1,30,1,20960,22009,16758,-5251
2021,1,30,2,20344,21455,15549,-5906
2021,1,30,3,19570,20695,14658,-6037
2021,1,30,4,18693,19661,13893,-5768
2021,1,30,5,17849,18767,13144,-5623
2021,1,30,6,17202,18032,12727,-5305
2021,1,30,7,16736,17549,12713,-4836
2021,1,30,8,16472,17252,12758,-4494
2021,1,30,9,16333,17082,12878,-4204
2021,1,30,10,16390,17091,12631,-4460
2021,1,30,11,16660,17415,12626,-4789
2021,1,30,12,17228,18029,12870,-5159
2021,1,30,13,17852,18633,13810,-4823
2021,1,30,14,18456,19120,13851,-5269
2021,1,30,15,18666,19356,13761,-5595
2021,1,30,16,18687,19427,14014,-5413
2021,1,30,17,18602,19329,14000,-5329
2021,1,30,18,18390,19151,14148,-5003
2021,1,30,19,18192,18877,13638,-5239
2021,1,30,20,18129,18749,13352,-5397
2021,1,30,21,18376,18894,14099,-4795
2021,1,30,22,18981,19473,14960,-4513
2021,1,30,23,19957,20569,15914,-4655
2021,1,31,0,20356,20848,16131,-4717
2021,1,31,1,20035,20560,15822,-4738
2021,1,31,2,19620,20182,15300,-4882
2021,1,31,3,18970,19622,14833,-4789
2021,1,31,4,18235,18754,13878,-4876
2021,1,31,5,17508,18008,13021,-4987
2021,1,31,6,17030,17385,12767,-4618
2021,1,31,7,16610,16958,12320,-4638
2021,1,31,8,16337,16686,12081,-4605
2021,1,31,9,16183,16545,12262,-4283
2021,1,31,10,16185,16573,12412,-4161
2021,1,31,11,16371,16866,12659,-4207
2021,1,31,12,16772,17359,13344,-4015
2021,1,31,13,17202,17924,13287,-4637
2021,1,31,14,17818,18583,13922,-4661
2021,1,31,15,18223,19184,14332,-4852
2021,1,31,16,18486,19450,14380,-5070
2021,1,31,17,18652,19552,14366,-5186
2021,1,31,18,18670,19647,13952,-5695
2021,1,31,19,18591,19478,13623,-5855
2021,1,31,20,18563,19458,13759,-5699
2021,1,31,21,18792,19613,14707,-4906
2021,1,31,22,19359,20176,15586,-4590
2021,1,31,23,20203,21127,16830,-4297
2021,2,1,0,20399,21280,17437,-3843
2021,2,1,1,20059,20940,17140,-3800
2021,2,1,2,19478,20408,16179,-4229
2021,2,1,3,18660,19695,15377,-4318
2021,2,1,4,17728,18764,14910,-3854
2021,2,1,5,16873,17887,14059,-3828
2021,2,1,6,16265,17212,13254,-3958
2021,2,1,7,15871,16793,12602,-4191
2021,2,1,8,15639,16553,12532,-4021
2021,2,1,9,15569,16480,12472,-4008
2021,2,1,10,15814,16653,12711,-3942
2021,2,1,11,16581,17255,13710,-3545
2021,2,1,12,17883,18328,15293,-3035
2021,2,1,13,18999,19326,15698,-3628
2021,2,1,14,19723,20053,16211,-3842
2021,2,1,15,20167,20559,16596,-3963
2021,2,1,16,20425,20872,17062,-3810
2021,2,1,17,20573,21004,17485,-3519
2021,2,1,18,20541,21022,16928,-4094
2021,2,1,19,20433,20894,16911,-3983
2021,2,1,20,20261,20674,16564,-4110
2021,2,1,21,20174,20566,16540,-4026
2021,2,1,22,20325,20776,16475,-4301
2021,2,1,23,21174,21578,17083,-4495
2021,2,2,0,21178,21573,17143,-4430
2021,2,2,1,20624,20978,16548,-4430
2021,2,2,2,19827,20242,15864,-4378
2021,2,2,3,18882,19434,15514,-3920
2021,2,2,4,17674,18398,14799,-3599
2021,2,2,5,16658,17419,13985,-3434
2021,2,2,6,15989,16713,12979,-3734
2021,2,2,7,15510,16225,12025,-4200
2021,2,2,8,15219,15964,11713,-4251
2021,2,2,9,15134,15880,11721,-4159
2021,2,2,10,15335,16068,11965,-4103
2021,2,2,11,16050,16662,12369,-4293
2021,2,2,12,17333,17600,13415,-4185
2021,2,2,13,18419,18587,14635,-3952
2021,2,2,14,19098,19399,15360,-4039
2021,2,2,15,19509,19933,16181,-3752
2021,2,2,16,19774,20261,16174,-4087
2021,2,2,17,19901,20448,15769,-4679
2021,2,2,18,19910,20545,15592,-4953
2021,2,2,19,19781,20484,15503,-4981
2021,2,2,20,19669,20383,15663,-4720
2021,2,2,21,19609,20349,15665,-4684
2021,2,2,22,19766,20606,16171,-4435
2021,2,2,23,20677,21427,17157,-4270
2021,2,3,0,20755,21459,17261,-4198
2021,2,3,1,20151,20874,16945,-3929
2021,2,3,2,19464,20170,16462,-3708
2021,2,3,3,18627,19238,15512,-3726
2021,2,3,4,17533,18142,14399,-3743
2021,2,3,5,16569,17164,13504,-3660
2021,2,3,6,15859,16511,12326,-4185
2021,2,3,7,15426,16092,12118,-3974
2021,2,3,8,15178,15857,12113,-3744
2021,2,3,9,15125,15793,11978,-3815
2021,2,3,10,15352,15996,11966,-4030
2021,2,3,11,16060,16687,12930,-3757
2021,2,3,12,17304,17876,14011,-3865
2021,2,3,13,18321,18967,14963,-4004
2021,2,3,14,18916,19705,15646,-4059
2021,2,3,15,19220,20045,15813,-4232
2021,2,3,16,19335,20146,15692,-4454
2021,2,3,17,19355,20189,16053,-4136
2021,2,3,18,19290,20128,16119,-4009
2021,2,3,19,19228,20012,15809,-4203
2021,2,3,20,19111,19904,15762,-4142
2021,2,3,21,19119,19857,15811,-4046
2021,2,3,22,19360,20153,16158,-3995
2021,2,3,23,20293,21006,16562,-4444
2021,2,4,0,20515,21168,16575,-4593
2021,2,4,1,20015,20682,16439,-4243
2021,2,4,2,19458,20054,16140,-3914
2021,2,4,3,18684,19185,15332,-3853
2021,2,4,4,17644,18072,14294,-3778
2021,2,4,5,16718,17072,13316,-3756
2021,2,4,6,15991,-9999,-9999,-9999
2021,2,4,7,15564,-9999,-9999,-9999
2021,2,4,8,15328,-9999,-9999,-9999
2021,2,4,9,15281,-9999,-9999,-9999
2021,2,4,10,15514,-9999,-9999,-9999
2021,2,4,11,16232,-9999,-9999,-9999
2021,2,4,12,17466,-9999,-9999,-9999
2021,2,4,13,18380,-9999,-9999,-9999
2021,2,4,14,18799,-9999,-9999,-9999
2021,2,4,15,18816,-9999,-9999,-9999
2021,2,4,16,18658,-9999,-9999,-9999
2021,2,4,17,18433,-9999,-9999,-9999
2021,2,4,18,18186,-9999,-9999,-9999
2021,2,4,19,18038,-9999,-9999,-9999
2021,2,4,20,17954,-9999,-9999,-9999
2021,2,4,21,18096,-9999,-9999,-9999
2021,2,4,22,18499,-9999,-9999,-9999
2021,2,4,23,19602,-9999,-9999,-9999
2021,2,5,0,19964,-9999,-9999,-9999
2021,2,5,1,19690,-9999,-9999,-9999
2021,2,5,2,19268,-9999,-9999,-9999
2021,2,5,3,18556,-9999,-9999,-9999
2021,2,5,4,17574,-9999,-9999,-9999
2021,2,5,5,16686,-9999,-9999,-9999
